"location","date","new_suspected_cases_calc_owd","new_confirmed_cases_calc_owd","cum_confirmed_cases_calc_owd","cum_suspected_cases_calc_owd","all_new_confirmed_cases_owd","all_cum_confirmed_cases_owd","all_new_suspected_cases_owd","all_cum_suspected_cases_owd"
"Africa","2024-01-01",0,0,0,0,0,0,0,0
"Africa","2024-01-02",0,0,0,0,0,0,0,0
"Africa","2024-01-03",0,0,0,0,0,0,0,0
"Africa","2024-01-04",0,0,0,0,0,0,0,0
"Africa","2024-01-05",0,0,0,0,0,0,0,0
"Africa","2024-01-06",0,0,0,0,0,0,0,0
"Africa","2024-01-07",0,58,58,0,58,58,0,0
"Africa","2024-01-08",0,0,58,0,11,69,0,0
"Africa","2024-01-09",0,0,58,0,11,80,0,0
"Africa","2024-01-10",0,0,58,0,11,91,0,0
"Africa","2024-01-11",0,0,58,0,10,101,0,0
"Africa","2024-01-12",0,0,58,0,11,112,0,0
"Africa","2024-01-13",0,0,58,0,11,123,0,0
"Africa","2024-01-14",0,76,134,0,11,134,0,0
"Africa","2024-01-15",0,0,134,0,13,147,0,0
"Africa","2024-01-16",0,0,134,0,13,160,0,0
"Africa","2024-01-17",0,0,134,0,13,173,0,0
"Africa","2024-01-18",0,0,134,0,13,186,0,0
"Africa","2024-01-19",0,0,134,0,13,199,0,0
"Africa","2024-01-20",0,0,134,0,13,212,0,0
"Africa","2024-01-21",0,91,225,0,13,225,0,0
"Africa","2024-01-22",0,0,225,0,16,241,0,0
"Africa","2024-01-23",0,0,225,0,16,257,0,0
"Africa","2024-01-24",0,0,225,0,16,273,0,0
"Africa","2024-01-25",0,0,225,0,15,288,0,0
"Africa","2024-01-26",0,0,225,0,16,304,0,0
"Africa","2024-01-27",0,0,225,0,16,320,0,0
"Africa","2024-01-28",0,111,336,0,16,336,0,0
"Africa","2024-01-29",0,0,336,0,10,346,0,0
"Africa","2024-01-30",0,0,336,0,10,356,0,0
"Africa","2024-01-31",0,0,336,0,10,366,0,0
"Africa","2024-02-01",0,0,336,0,10,376,0,0
"Africa","2024-02-02",0,0,336,0,10,386,0,0
"Africa","2024-02-03",0,0,336,0,10,396,0,0
"Africa","2024-02-04",0,70,406,0,10,406,0,0
"Africa","2024-02-05",0,0,406,0,14,420,0,0
"Africa","2024-02-06",0,0,406,0,13,433,0,0
"Africa","2024-02-07",0,0,406,0,14,447,0,0
"Africa","2024-02-08",0,0,406,0,13,460,0,0
"Africa","2024-02-09",0,0,406,0,14,474,0,0
"Africa","2024-02-10",0,0,406,0,13,487,0,0
"Africa","2024-02-11",0,95,501,0,14,501,0,0
"Africa","2024-02-12",0,0,501,0,11,512,0,0
"Africa","2024-02-13",0,0,501,0,10,522,0,0
"Africa","2024-02-14",0,0,501,0,11,533,0,0
"Africa","2024-02-15",0,0,501,0,11,544,0,0
"Africa","2024-02-16",0,0,501,0,11,555,0,0
"Africa","2024-02-17",0,0,501,0,10,565,0,0
"Africa","2024-02-18",0,75,576,0,11,576,0,0
"Africa","2024-02-19",0,0,576,0,10,586,0,0
"Africa","2024-02-20",0,0,576,0,10,596,0,0
"Africa","2024-02-21",0,0,576,0,10,606,0,0
"Africa","2024-02-22",0,0,576,0,11,617,0,0
"Africa","2024-02-23",0,0,576,0,10,627,0,0
"Africa","2024-02-24",0,0,576,0,10,637,0,0
"Africa","2024-02-25",0,71,647,0,10,647,0,0
"Africa","2024-02-26",0,0,647,0,12,659,0,0
"Africa","2024-02-27",0,0,647,0,11,670,0,0
"Africa","2024-02-28",0,0,647,0,12,682,0,0
"Africa","2024-02-29",0,0,647,0,12,694,0,0
"Africa","2024-03-01",0,0,647,0,12,706,0,0
"Africa","2024-03-02",0,0,647,0,11,717,0,0
"Africa","2024-03-03",0,82,729,0,12,729,0,0
"Africa","2024-03-04",0,0,729,0,11,740,0,0
"Africa","2024-03-05",0,0,729,0,11,751,0,0
"Africa","2024-03-06",0,0,729,0,11,762,0,0
"Africa","2024-03-07",0,0,729,0,12,774,0,0
"Africa","2024-03-08",0,0,729,0,11,785,0,0
"Africa","2024-03-09",0,0,729,0,11,796,0,0
"Africa","2024-03-10",0,78,807,0,11,807,0,0
"Africa","2024-03-11",0,0,807,0,0,807,0,0
"Africa","2024-03-12",0,0,807,0,0,807,0,0
"Africa","2024-03-13",0,0,807,0,1,808,0,0
"Africa","2024-03-14",0,0,807,0,0,808,0,0
"Africa","2024-03-15",0,1,808,0,0,808,0,0
"Africa","2024-03-16",0,0,808,0,37,845,0,0
"Africa","2024-03-17",0,74,882,0,37,882,0,0
"Africa","2024-03-18",0,0,882,0,12,894,0,0
"Africa","2024-03-19",0,0,882,0,12,906,0,0
"Africa","2024-03-20",0,0,882,0,12,918,0,0
"Africa","2024-03-21",0,0,882,0,12,930,0,0
"Africa","2024-03-22",0,0,882,0,12,942,0,0
"Africa","2024-03-23",0,0,882,0,12,954,0,0
"Africa","2024-03-24",0,84,966,0,12,966,0,0
"Africa","2024-03-25",0,0,966,0,11,977,0,0
"Africa","2024-03-26",0,0,966,0,12,989,0,0
"Africa","2024-03-27",0,0,966,0,11,1000,0,0
"Africa","2024-03-28",0,0,966,0,12,1012,0,0
"Africa","2024-03-29",0,0,966,0,11,1023,0,0
"Africa","2024-03-30",0,0,966,0,12,1035,0,0
"Africa","2024-03-31",0,80,1046,0,11,1046,0,0
"Africa","2024-04-01",0,0,1046,0,13,1059,0,0
"Africa","2024-04-02",0,0,1046,0,12,1071,0,0
"Africa","2024-04-03",0,0,1046,0,13,1084,0,0
"Africa","2024-04-04",0,0,1046,0,13,1097,0,0
"Africa","2024-04-05",0,0,1046,0,13,1110,0,0
"Africa","2024-04-06",0,0,1046,0,12,1122,0,0
"Africa","2024-04-07",0,89,1135,0,13,1135,0,0
"Africa","2024-04-08",0,0,1135,0,20,1155,0,0
"Africa","2024-04-09",0,0,1135,0,19,1174,0,0
"Africa","2024-04-10",0,0,1135,0,20,1194,0,0
"Africa","2024-04-11",0,0,1135,0,19,1213,0,0
"Africa","2024-04-12",0,0,1135,0,20,1233,0,0
"Africa","2024-04-13",0,0,1135,0,19,1252,0,0
"Africa","2024-04-14",0,137,1272,0,20,1272,0,0
"Africa","2024-04-15",0,0,1272,0,21,1293,0,0
"Africa","2024-04-16",0,0,1272,0,21,1314,0,0
"Africa","2024-04-17",0,0,1272,0,21,1335,0,0
"Africa","2024-04-18",0,0,1272,0,22,1357,0,0
"Africa","2024-04-19",0,0,1272,0,21,1378,0,0
"Africa","2024-04-20",0,0,1272,0,21,1399,0,0
"Africa","2024-04-21",0,148,1420,0,21,1420,0,0
"Africa","2024-04-22",0,0,1420,0,24,1444,0,0
"Africa","2024-04-23",0,0,1420,0,25,1469,0,0
"Africa","2024-04-24",0,0,1420,0,24,1493,0,0
"Africa","2024-04-25",0,0,1420,0,24,1517,0,0
"Africa","2024-04-26",0,0,1420,0,24,1541,0,0
"Africa","2024-04-27",0,0,1420,0,25,1566,0,0
"Africa","2024-04-28",0,170,1590,0,24,1590,0,0
"Africa","2024-04-29",0,0,1590,0,29,1619,0,0
"Africa","2024-04-30",0,0,1590,0,30,1649,0,0
"Africa","2024-05-01",0,0,1590,0,29,1678,0,0
"Africa","2024-05-02",0,0,1590,0,29,1707,0,0
"Africa","2024-05-03",0,0,1590,0,29,1736,0,0
"Africa","2024-05-04",0,0,1590,0,30,1766,0,0
"Africa","2024-05-05",0,205,1795,0,29,1795,0,0
"Africa","2024-05-06",0,0,1795,0,25,1820,0,0
"Africa","2024-05-07",0,0,1795,0,26,1846,0,0
"Africa","2024-05-08",0,0,1795,0,25,1871,0,0
"Africa","2024-05-09",0,0,1795,0,25,1896,0,0
"Africa","2024-05-10",0,0,1795,0,25,1921,0,0
"Africa","2024-05-11",0,0,1795,0,26,1947,0,0
"Africa","2024-05-12",0,177,1972,0,25,1972,0,0
"Africa","2024-05-13",0,0,1972,0,29,2001,0,0
"Africa","2024-05-14",0,0,1972,0,29,2030,0,0
"Africa","2024-05-15",0,0,1972,0,29,2059,0,0
"Africa","2024-05-16",0,0,1972,0,28,2087,0,0
"Africa","2024-05-17",0,0,1972,0,29,2116,0,0
"Africa","2024-05-18",0,0,1972,0,29,2145,0,0
"Africa","2024-05-19",0,202,2174,0,29,2174,0,0
"Africa","2024-05-20",0,0,2174,0,27,2201,0,0
"Africa","2024-05-21",0,0,2174,0,27,2228,0,0
"Africa","2024-05-22",0,0,2174,0,27,2255,0,0
"Africa","2024-05-23",0,0,2174,0,28,2283,0,0
"Africa","2024-05-24",0,0,2174,0,27,2310,0,0
"Africa","2024-05-25",0,0,2174,0,27,2337,0,0
"Africa","2024-05-26",0,190,2364,0,27,2364,0,0
"Africa","2024-05-27",0,0,2364,0,28,2392,0,0
"Africa","2024-05-28",0,0,2364,0,28,2420,0,0
"Africa","2024-05-29",0,0,2364,0,28,2448,0,0
"Africa","2024-05-30",0,0,2364,0,27,2475,0,0
"Africa","2024-05-31",0,0,2364,0,28,2503,0,0
"Africa","2024-06-01",0,0,2364,0,28,2531,0,0
"Africa","2024-06-02",0,195,2559,0,28,2559,0,0
"Africa","2024-06-03",0,0,2559,0,33,2592,0,0
"Africa","2024-06-04",0,0,2559,0,32,2624,0,0
"Africa","2024-06-05",0,0,2559,0,33,2657,0,0
"Africa","2024-06-06",0,0,2559,0,33,2690,0,0
"Africa","2024-06-07",0,0,2559,0,33,2723,0,0
"Africa","2024-06-08",0,0,2559,0,32,2755,0,0
"Africa","2024-06-09",0,229,2788,0,33,2788,0,0
"Africa","2024-06-10",0,0,2788,0,37,2825,0,0
"Africa","2024-06-11",0,0,2788,0,37,2862,0,0
"Africa","2024-06-12",0,0,2788,0,37,2899,0,0
"Africa","2024-06-13",0,0,2788,0,38,2937,0,0
"Africa","2024-06-14",0,0,2788,0,37,2974,0,0
"Africa","2024-06-15",0,0,2788,0,37,3011,0,0
"Africa","2024-06-16",0,260,3048,0,37,3048,0,0
"Africa","2024-06-17",0,0,3048,0,40,3088,0,0
"Africa","2024-06-18",0,0,3048,0,41,3129,0,0
"Africa","2024-06-19",0,0,3048,0,40,3169,0,0
"Africa","2024-06-20",0,0,3048,0,41,3210,0,0
"Africa","2024-06-21",0,0,3048,0,40,3250,0,0
"Africa","2024-06-22",0,0,3048,0,41,3291,0,0
"Africa","2024-06-23",0,283,3331,0,40,3331,0,0
"Africa","2024-06-24",0,0,3331,0,35,3366,0,0
"Africa","2024-06-25",0,0,3331,0,36,3402,0,0
"Africa","2024-06-26",0,0,3331,0,35,3437,0,0
"Africa","2024-06-27",0,0,3331,0,35,3472,0,0
"Africa","2024-06-28",0,0,3331,0,35,3507,0,0
"Africa","2024-06-29",0,0,3331,0,36,3543,0,0
"Africa","2024-06-30",0,247,3578,0,35,3578,0,0
"Africa","2024-07-01",0,0,3578,0,38,3616,0,0
"Africa","2024-07-02",0,0,3578,0,37,3653,0,0
"Africa","2024-07-03",0,0,3578,0,38,3691,0,0
"Africa","2024-07-04",0,0,3578,0,38,3729,0,0
"Africa","2024-07-05",0,0,3578,0,38,3767,0,0
"Africa","2024-07-06",0,0,3578,0,37,3804,0,0
"Africa","2024-07-07",0,264,3842,0,38,3842,0,0
"Africa","2024-07-08",0,0,3842,0,48,3890,0,0
"Africa","2024-07-09",0,0,3842,0,48,3938,0,0
"Africa","2024-07-10",0,0,3842,0,48,3986,0,0
"Africa","2024-07-11",0,0,3842,0,49,4035,0,0
"Africa","2024-07-12",0,0,3842,0,48,4083,0,0
"Africa","2024-07-13",0,0,3842,0,48,4131,0,0
"Africa","2024-07-14",0,337,4179,0,48,4179,0,0
"Africa","2024-07-15",0,0,4179,0,62,4241,0,0
"Africa","2024-07-16",0,0,4179,0,63,4304,0,0
"Africa","2024-07-17",0,0,4179,0,62,4366,0,0
"Africa","2024-07-18",0,0,4179,0,63,4429,0,0
"Africa","2024-07-19",0,0,4179,0,62,4491,0,0
"Africa","2024-07-20",0,0,4179,0,63,4554,0,0
"Africa","2024-07-21",0,437,4616,0,62,4616,0,0
"Africa","2024-07-22",0,0,4616,0,58,4674,0,0
"Africa","2024-07-23",0,0,4616,0,58,4732,0,0
"Africa","2024-07-24",0,0,4616,0,58,4790,0,0
"Africa","2024-07-25",0,0,4616,0,57,4847,0,0
"Africa","2024-07-26",0,0,4616,0,58,4905,0,0
"Africa","2024-07-27",0,0,4616,0,58,4963,0,0
"Africa","2024-07-28",0,405,5021,0,58,5021,0,0
"Africa","2024-07-29",0,0,5021,0,52,5073,0,0
"Africa","2024-07-30",0,0,5021,0,53,5126,0,0
"Africa","2024-07-31",0,0,5021,0,52,5178,0,0
"Africa","2024-08-01",0,0,5021,0,53,5231,0,0
"Africa","2024-08-02",0,0,5021,0,52,5283,0,0
"Africa","2024-08-03",0,0,5021,0,53,5336,0,0
"Africa","2024-08-04",0,367,5388,0,52,5388,0,0
"Africa","2024-08-05",0,0,5388,0,54,5442,0,0
"Africa","2024-08-06",0,0,5388,0,55,5497,0,0
"Africa","2024-08-07",0,0,5388,0,54,5551,0,0
"Africa","2024-08-08",0,0,5388,0,55,5606,0,0
"Africa","2024-08-09",0,0,5388,0,54,5660,0,0
"Africa","2024-08-10",0,0,5388,0,55,5715,0,0
"Africa","2024-08-11",0,381,5769,0,54,5769,0,0
"Africa","2024-08-12",0,0,5769,0,59,5828,0,0
"Africa","2024-08-13",0,0,5769,0,59,5887,0,0
"Africa","2024-08-14",0,0,5769,0,59,5946,0,0
"Africa","2024-08-15",0,0,5769,0,58,6004,0,0
"Africa","2024-08-16",0,0,5769,0,59,6063,0,0
"Africa","2024-08-17",0,0,5769,0,59,6122,0,0
"Africa","2024-08-18",0,412,6181,0,59,6181,0,0
"Africa","2024-08-19",0,0,6181,0,62,6243,0,0
"Africa","2024-08-20",0,0,6181,0,62,6305,0,0
"Africa","2024-08-21",0,0,6181,0,62,6367,0,0
"Africa","2024-08-22",0,0,6181,0,63,6430,0,0
"Africa","2024-08-23",0,0,6181,0,62,6492,0,0
"Africa","2024-08-24",0,0,6181,0,62,6554,0,0
"Africa","2024-08-25",0,435,6616,0,62,6616,0,0
"Africa","2024-08-26",0,0,6616,0,63,6679,0,0
"Africa","2024-08-27",0,0,6616,0,62,6741,0,0
"Africa","2024-08-28",0,0,6616,0,63,6804,0,0
"Africa","2024-08-29",0,0,6616,0,62,6866,0,0
"Africa","2024-08-30",0,0,6616,0,63,6929,0,0
"Africa","2024-08-31",0,0,6616,0,62,6991,0,0
"Africa","2024-09-01",0,438,7054,0,63,7054,0,0
"Africa","2024-09-02",0,0,7054,0,58,7112,0,0
"Africa","2024-09-03",0,0,7054,0,57,7169,0,0
"Africa","2024-09-04",0,0,7054,0,58,7227,0,0
"Africa","2024-09-05",0,0,7054,0,58,7285,0,0
"Africa","2024-09-06",0,0,7054,0,58,7343,0,0
"Africa","2024-09-07",0,0,7054,0,57,7400,0,0
"Africa","2024-09-08",0,404,7458,0,58,7458,0,0
"Africa","2024-09-09",0,0,7458,0,0,7458,0,0
"Africa","2024-09-10",0,0,7458,0,0,7458,0,0
"Africa","2024-09-11",0,0,7458,0,1,7459,0,0
"Africa","2024-09-12",0,1,7459,0,0,7459,0,0
"Africa","2024-09-13",0,0,7459,0,168,7627,0,0
"Africa","2024-09-14",0,0,7459,0,169,7796,0,0
"Africa","2024-09-15",0,505,7964,0,168,7964,0,0
"Africa","2024-09-16",0,0,7964,0,69,8033,0,0
"Africa","2024-09-17",0,0,7964,0,68,8101,0,0
"Africa","2024-09-18",0,0,7964,0,69,8170,0,0
"Africa","2024-09-19",0,0,7964,0,68,8238,0,0
"Africa","2024-09-20",0,0,7964,0,69,8307,0,0
"Africa","2024-09-21",0,0,7964,0,68,8375,0,0
"Africa","2024-09-22",0,480,8444,0,69,8444,0,0
"Africa","2024-09-23",0,0,8444,0,0,8444,0,0
"Africa","2024-09-24",0,0,8444,0,1,8445,0,0
"Africa","2024-09-25",0,0,8444,0,1,8446,0,0
"Africa","2024-09-26",0,0,8444,0,0,8446,0,0
"Africa","2024-09-27",0,0,8444,0,0,8446,0,0
"Africa","2024-09-28",0,3,8447,0,1,8447,0,0
"Africa","2024-09-29",0,672,9119,0,672,9119,0,0
"Africa","2024-09-30",0,0,9119,0,0,9119,0,0
"Africa","2024-10-01",0,0,9119,0,0,9119,0,0
"Africa","2024-10-02",0,0,9119,0,1,9120,0,0
"Africa","2024-10-03",0,1,9120,0,0,9120,0,0
"Africa","2024-10-04",0,0,9120,0,175,9295,0,0
"Africa","2024-10-05",0,0,9120,0,176,9471,0,0
"Africa","2024-10-06",0,526,9646,0,175,9646,0,0
"Africa","2024-10-07",0,0,9646,0,0,9646,0,0
"Africa","2024-10-08",0,0,9646,0,1,9647,0,0
"Africa","2024-10-09",0,0,9646,0,0,9647,0,0
"Africa","2024-10-10",0,0,9646,0,0,9647,0,0
"Africa","2024-10-11",0,0,9646,0,1,9648,0,0
"Africa","2024-10-12",0,2,9648,0,0,9648,0,0
"Africa","2024-10-13",0,598,10246,0,598,10246,0,0
"Africa","2024-10-14",0,0,10246,0,73,10319,0,0
"Africa","2024-10-15",0,0,10246,0,73,10392,0,0
"Africa","2024-10-16",0,0,10246,0,73,10465,0,0
"Africa","2024-10-17",0,0,10246,0,73,10538,0,0
"Africa","2024-10-18",0,0,10246,0,73,10611,0,0
"Africa","2024-10-19",0,0,10246,0,73,10684,0,0
"Africa","2024-10-20",0,511,10757,0,73,10757,0,0
"Africa","2024-10-21",0,0,10757,0,0,10757,0,0
"Africa","2024-10-22",0,0,10757,0,1,10758,0,0
"Africa","2024-10-23",0,0,10757,0,0,10758,0,0
"Africa","2024-10-24",0,0,10757,0,0,10758,0,0
"Africa","2024-10-25",0,0,10757,0,1,10759,0,0
"Africa","2024-10-26",0,2,10759,0,0,10759,0,0
"Africa","2024-10-27",0,656,11415,0,656,11415,0,0
"Africa","2024-10-28",0,0,11415,0,1,11416,0,0
"Africa","2024-10-29",0,0,11415,0,0,11416,0,0
"Africa","2024-10-30",0,2,11417,0,1,11417,0,0
"Africa","2024-10-31",0,0,11417,0,120,11537,0,0
"Africa","2024-11-01",0,0,11417,0,119,11656,0,0
"Africa","2024-11-02",0,0,11417,0,119,11775,0,0
"Africa","2024-11-03",0,478,11895,0,120,11895,0,0
"Africa","2024-11-04",0,0,11895,0,2,11897,0,0
"Africa","2024-11-05",0,0,11895,0,2,11899,0,0
"Africa","2024-11-06",0,6,11901,0,2,11901,0,0
"Africa","2024-11-07",0,0,11901,0,19,11920,0,0
"Africa","2024-11-08",0,0,11901,0,18,11938,0,0
"Africa","2024-11-09",0,56,11957,0,19,11957,0,0
"Africa","2024-11-10",0,221,12178,0,221,12178,0,0
"Africa","2024-11-11",0,11,12189,0,11,12189,0,0
"Africa","2024-11-12",0,0,12189,0,0,12189,0,0
"Africa","2024-11-13",0,0,12189,0,0,12189,0,0
"Africa","2024-11-14",0,0,12189,0,0,12189,0,0
"Africa","2024-11-15",0,0,12189,0,0,12189,0,0
"Africa","2024-11-16",0,0,12189,0,0,12189,0,0
"Africa","2024-11-17",0,0,12189,0,0,12189,0,0
"Africa","2024-11-18",0,0,12189,0,0,12189,0,0
"Africa","2024-11-19",0,0,12189,0,0,12189,0,0
"Africa","2024-11-20",0,0,12189,0,0,12189,0,0
"Africa","2024-11-21",0,0,12189,0,0,12189,0,0
"Africa","2024-11-22",0,0,12189,0,0,12189,0,0
"Africa","2024-11-23",0,0,12189,0,0,12189,0,0
"Africa","2024-11-24",0,0,12189,0,0,12189,0,0
"Africa","2024-11-25",0,0,12189,0,0,12189,0,0
"Africa","2024-11-26",0,0,12189,0,0,12189,0,0
"Africa","2024-11-27",0,0,12189,0,0,12189,0,0
"Africa","2024-11-28",0,0,12189,0,0,12189,0,0
"Africa","2024-11-29",0,0,12189,0,0,12189,0,0
"Africa","2024-11-30",0,0,12189,0,0,12189,0,0
"Africa","2024-12-01",0,0,12189,0,0,12189,0,0
"Africa","2024-12-02",0,0,12189,0,0,12189,0,0
"Africa","2024-12-03",0,0,12189,0,0,12189,0,0
"Africa","2024-12-04",0,0,12189,0,0,12189,0,0
"Africa","2024-12-05",0,0,12189,0,0,12189,0,0
"Africa","2024-12-06",0,0,12189,0,0,12189,0,0
"Africa","2024-12-07",0,0,12189,0,0,12189,0,0
"Africa","2024-12-08",0,0,12189,0,0,12189,0,0
"Africa","2024-12-09",0,0,12189,0,0,12189,0,0
"Andorra","2024-01-01",0,0,0,0,0,0,0,0
"Andorra","2024-01-02",0,0,0,0,0,0,0,0
"Andorra","2024-01-03",0,0,0,0,0,0,0,0
"Andorra","2024-01-04",0,0,0,0,0,0,0,0
"Andorra","2024-01-05",0,0,0,0,0,0,0,0
"Andorra","2024-01-06",0,0,0,0,0,0,0,0
"Andorra","2024-01-07",0,0,0,0,0,0,0,0
"Andorra","2024-01-08",0,0,0,0,0,0,0,0
"Andorra","2024-01-09",0,0,0,0,0,0,0,0
"Andorra","2024-01-10",0,0,0,0,0,0,0,0
"Andorra","2024-01-11",0,0,0,0,0,0,0,0
"Andorra","2024-01-12",0,0,0,0,0,0,0,0
"Andorra","2024-01-13",0,0,0,0,0,0,0,0
"Andorra","2024-01-14",0,0,0,0,0,0,0,0
"Andorra","2024-01-15",0,0,0,0,0,0,0,0
"Andorra","2024-01-16",0,0,0,0,0,0,0,0
"Andorra","2024-01-17",0,0,0,0,0,0,0,0
"Andorra","2024-01-18",0,0,0,0,0,0,0,0
"Andorra","2024-01-19",0,0,0,0,0,0,0,0
"Andorra","2024-01-20",0,0,0,0,0,0,0,0
"Andorra","2024-01-21",0,0,0,0,0,0,0,0
"Andorra","2024-01-22",0,0,0,0,0,0,0,0
"Andorra","2024-01-23",0,0,0,0,0,0,0,0
"Andorra","2024-01-24",0,0,0,0,0,0,0,0
"Andorra","2024-01-25",0,0,0,0,0,0,0,0
"Andorra","2024-01-26",0,0,0,0,0,0,0,0
"Andorra","2024-01-27",0,0,0,0,0,0,0,0
"Andorra","2024-01-28",0,0,0,0,0,0,0,0
"Andorra","2024-01-29",0,0,0,0,0,0,0,0
"Andorra","2024-01-30",0,0,0,0,0,0,0,0
"Andorra","2024-01-31",0,0,0,0,0,0,0,0
"Andorra","2024-02-01",0,0,0,0,0,0,0,0
"Andorra","2024-02-02",0,0,0,0,0,0,0,0
"Andorra","2024-02-03",0,0,0,0,0,0,0,0
"Andorra","2024-02-04",0,0,0,0,0,0,0,0
"Andorra","2024-02-05",0,0,0,0,0,0,0,0
"Andorra","2024-02-06",0,0,0,0,0,0,0,0
"Andorra","2024-02-07",0,0,0,0,0,0,0,0
"Andorra","2024-02-08",0,0,0,0,0,0,0,0
"Andorra","2024-02-09",0,0,0,0,0,0,0,0
"Andorra","2024-02-10",0,0,0,0,0,0,0,0
"Andorra","2024-02-11",0,0,0,0,0,0,0,0
"Andorra","2024-02-12",0,0,0,0,0,0,0,0
"Andorra","2024-02-13",0,0,0,0,0,0,0,0
"Andorra","2024-02-14",0,0,0,0,0,0,0,0
"Andorra","2024-02-15",0,0,0,0,0,0,0,0
"Andorra","2024-02-16",0,0,0,0,0,0,0,0
"Andorra","2024-02-17",0,0,0,0,0,0,0,0
"Andorra","2024-02-18",0,0,0,0,0,0,0,0
"Andorra","2024-02-19",0,0,0,0,0,0,0,0
"Andorra","2024-02-20",0,0,0,0,0,0,0,0
"Andorra","2024-02-21",0,0,0,0,0,0,0,0
"Andorra","2024-02-22",0,0,0,0,0,0,0,0
"Andorra","2024-02-23",0,0,0,0,0,0,0,0
"Andorra","2024-02-24",0,0,0,0,0,0,0,0
"Andorra","2024-02-25",0,0,0,0,0,0,0,0
"Andorra","2024-02-26",0,0,0,0,0,0,0,0
"Andorra","2024-02-27",0,0,0,0,0,0,0,0
"Andorra","2024-02-28",0,0,0,0,0,0,0,0
"Andorra","2024-02-29",0,0,0,0,0,0,0,0
"Andorra","2024-03-01",0,0,0,0,0,0,0,0
"Andorra","2024-03-02",0,0,0,0,0,0,0,0
"Andorra","2024-03-03",0,0,0,0,0,0,0,0
"Andorra","2024-03-04",0,0,0,0,0,0,0,0
"Andorra","2024-03-05",0,0,0,0,0,0,0,0
"Andorra","2024-03-06",0,0,0,0,0,0,0,0
"Andorra","2024-03-07",0,0,0,0,0,0,0,0
"Andorra","2024-03-08",0,0,0,0,0,0,0,0
"Andorra","2024-03-09",0,0,0,0,0,0,0,0
"Andorra","2024-03-10",0,0,0,0,0,0,0,0
"Andorra","2024-03-11",0,0,0,0,0,0,0,0
"Andorra","2024-03-12",0,0,0,0,0,0,0,0
"Andorra","2024-03-13",0,0,0,0,0,0,0,0
"Andorra","2024-03-14",0,0,0,0,0,0,0,0
"Andorra","2024-03-15",0,0,0,0,0,0,0,0
"Andorra","2024-03-16",0,0,0,0,0,0,0,0
"Andorra","2024-03-17",0,0,0,0,0,0,0,0
"Andorra","2024-03-18",0,0,0,0,0,0,0,0
"Andorra","2024-03-19",0,0,0,0,0,0,0,0
"Andorra","2024-03-20",0,0,0,0,0,0,0,0
"Andorra","2024-03-21",0,0,0,0,0,0,0,0
"Andorra","2024-03-22",0,0,0,0,0,0,0,0
"Andorra","2024-03-23",0,0,0,0,0,0,0,0
"Andorra","2024-03-24",0,0,0,0,0,0,0,0
"Andorra","2024-03-25",0,0,0,0,0,0,0,0
"Andorra","2024-03-26",0,0,0,0,0,0,0,0
"Andorra","2024-03-27",0,0,0,0,0,0,0,0
"Andorra","2024-03-28",0,0,0,0,0,0,0,0
"Andorra","2024-03-29",0,0,0,0,0,0,0,0
"Andorra","2024-03-30",0,0,0,0,0,0,0,0
"Andorra","2024-03-31",0,0,0,0,0,0,0,0
"Andorra","2024-04-01",0,0,0,0,0,0,0,0
"Andorra","2024-04-02",0,0,0,0,0,0,0,0
"Andorra","2024-04-03",0,0,0,0,0,0,0,0
"Andorra","2024-04-04",0,0,0,0,0,0,0,0
"Andorra","2024-04-05",0,0,0,0,0,0,0,0
"Andorra","2024-04-06",0,0,0,0,0,0,0,0
"Andorra","2024-04-07",0,0,0,0,0,0,0,0
"Andorra","2024-04-08",0,0,0,0,0,0,0,0
"Andorra","2024-04-09",0,0,0,0,0,0,0,0
"Andorra","2024-04-10",0,0,0,0,0,0,0,0
"Andorra","2024-04-11",0,0,0,0,0,0,0,0
"Andorra","2024-04-12",0,0,0,0,0,0,0,0
"Andorra","2024-04-13",0,0,0,0,0,0,0,0
"Andorra","2024-04-14",0,0,0,0,0,0,0,0
"Andorra","2024-04-15",0,0,0,0,0,0,0,0
"Andorra","2024-04-16",0,0,0,0,0,0,0,0
"Andorra","2024-04-17",0,0,0,0,0,0,0,0
"Andorra","2024-04-18",0,0,0,0,0,0,0,0
"Andorra","2024-04-19",0,0,0,0,0,0,0,0
"Andorra","2024-04-20",0,0,0,0,0,0,0,0
"Andorra","2024-04-21",0,0,0,0,0,0,0,0
"Andorra","2024-04-22",0,0,0,0,0,0,0,0
"Andorra","2024-04-23",0,0,0,0,0,0,0,0
"Andorra","2024-04-24",0,0,0,0,0,0,0,0
"Andorra","2024-04-25",0,0,0,0,0,0,0,0
"Andorra","2024-04-26",0,0,0,0,0,0,0,0
"Andorra","2024-04-27",0,0,0,0,0,0,0,0
"Andorra","2024-04-28",0,0,0,0,0,0,0,0
"Andorra","2024-04-29",0,0,0,0,0,0,0,0
"Andorra","2024-04-30",0,0,0,0,0,0,0,0
"Andorra","2024-05-01",0,0,0,0,0,0,0,0
"Andorra","2024-05-02",0,0,0,0,0,0,0,0
"Andorra","2024-05-03",0,0,0,0,0,0,0,0
"Andorra","2024-05-04",0,0,0,0,0,0,0,0
"Andorra","2024-05-05",0,0,0,0,0,0,0,0
"Andorra","2024-05-06",0,0,0,0,0,0,0,0
"Andorra","2024-05-07",0,0,0,0,0,0,0,0
"Andorra","2024-05-08",0,0,0,0,0,0,0,0
"Andorra","2024-05-09",0,0,0,0,0,0,0,0
"Andorra","2024-05-10",0,0,0,0,0,0,0,0
"Andorra","2024-05-11",0,0,0,0,0,0,0,0
"Andorra","2024-05-12",0,0,0,0,0,0,0,0
"Andorra","2024-05-13",0,0,0,0,0,0,0,0
"Andorra","2024-05-14",0,0,0,0,0,0,0,0
"Andorra","2024-05-15",0,0,0,0,0,0,0,0
"Andorra","2024-05-16",0,0,0,0,0,0,0,0
"Andorra","2024-05-17",0,0,0,0,0,0,0,0
"Andorra","2024-05-18",0,0,0,0,0,0,0,0
"Andorra","2024-05-19",0,0,0,0,0,0,0,0
"Andorra","2024-05-20",0,0,0,0,0,0,0,0
"Andorra","2024-05-21",0,0,0,0,0,0,0,0
"Andorra","2024-05-22",0,0,0,0,0,0,0,0
"Andorra","2024-05-23",0,0,0,0,0,0,0,0
"Andorra","2024-05-24",0,0,0,0,0,0,0,0
"Andorra","2024-05-25",0,0,0,0,0,0,0,0
"Andorra","2024-05-26",0,0,0,0,0,0,0,0
"Andorra","2024-05-27",0,0,0,0,0,0,0,0
"Andorra","2024-05-28",0,0,0,0,0,0,0,0
"Andorra","2024-05-29",0,0,0,0,0,0,0,0
"Andorra","2024-05-30",0,0,0,0,0,0,0,0
"Andorra","2024-05-31",0,0,0,0,0,0,0,0
"Andorra","2024-06-01",0,0,0,0,0,0,0,0
"Andorra","2024-06-02",0,0,0,0,0,0,0,0
"Andorra","2024-06-03",0,0,0,0,0,0,0,0
"Andorra","2024-06-04",0,0,0,0,0,0,0,0
"Andorra","2024-06-05",0,0,0,0,0,0,0,0
"Andorra","2024-06-06",0,0,0,0,0,0,0,0
"Andorra","2024-06-07",0,0,0,0,0,0,0,0
"Andorra","2024-06-08",0,0,0,0,0,0,0,0
"Andorra","2024-06-09",0,0,0,0,0,0,0,0
"Andorra","2024-06-10",0,0,0,0,0,0,0,0
"Andorra","2024-06-11",0,0,0,0,0,0,0,0
"Andorra","2024-06-12",0,0,0,0,0,0,0,0
"Andorra","2024-06-13",0,0,0,0,0,0,0,0
"Andorra","2024-06-14",0,0,0,0,0,0,0,0
"Andorra","2024-06-15",0,0,0,0,0,0,0,0
"Andorra","2024-06-16",0,0,0,0,0,0,0,0
"Andorra","2024-06-17",0,0,0,0,0,0,0,0
"Andorra","2024-06-18",0,0,0,0,0,0,0,0
"Andorra","2024-06-19",0,0,0,0,0,0,0,0
"Andorra","2024-06-20",0,0,0,0,0,0,0,0
"Andorra","2024-06-21",0,0,0,0,0,0,0,0
"Andorra","2024-06-22",0,0,0,0,0,0,0,0
"Andorra","2024-06-23",0,0,0,0,0,0,0,0
"Andorra","2024-06-24",0,0,0,0,0,0,0,0
"Andorra","2024-06-25",0,0,0,0,0,0,0,0
"Andorra","2024-06-26",0,0,0,0,0,0,0,0
"Andorra","2024-06-27",0,0,0,0,0,0,0,0
"Andorra","2024-06-28",0,0,0,0,0,0,0,0
"Andorra","2024-06-29",0,0,0,0,0,0,0,0
"Andorra","2024-06-30",0,0,0,0,0,0,0,0
"Andorra","2024-07-01",0,0,0,0,0,0,0,0
"Andorra","2024-07-02",0,0,0,0,0,0,0,0
"Andorra","2024-07-03",0,0,0,0,0,0,0,0
"Andorra","2024-07-04",0,0,0,0,0,0,0,0
"Andorra","2024-07-05",0,0,0,0,0,0,0,0
"Andorra","2024-07-06",0,0,0,0,0,0,0,0
"Andorra","2024-07-07",0,0,0,0,0,0,0,0
"Andorra","2024-07-08",0,0,0,0,0,0,0,0
"Andorra","2024-07-09",0,0,0,0,0,0,0,0
"Andorra","2024-07-10",0,0,0,0,0,0,0,0
"Andorra","2024-07-11",0,0,0,0,0,0,0,0
"Andorra","2024-07-12",0,0,0,0,0,0,0,0
"Andorra","2024-07-13",0,0,0,0,0,0,0,0
"Andorra","2024-07-14",0,0,0,0,0,0,0,0
"Andorra","2024-07-15",0,0,0,0,0,0,0,0
"Andorra","2024-07-16",0,0,0,0,0,0,0,0
"Andorra","2024-07-17",0,0,0,0,0,0,0,0
"Andorra","2024-07-18",0,0,0,0,0,0,0,0
"Andorra","2024-07-19",0,0,0,0,0,0,0,0
"Andorra","2024-07-20",0,0,0,0,0,0,0,0
"Andorra","2024-07-21",0,0,0,0,0,0,0,0
"Andorra","2024-07-22",0,0,0,0,0,0,0,0
"Andorra","2024-07-23",0,0,0,0,0,0,0,0
"Andorra","2024-07-24",0,0,0,0,0,0,0,0
"Andorra","2024-07-25",0,0,0,0,0,0,0,0
"Andorra","2024-07-26",0,0,0,0,0,0,0,0
"Andorra","2024-07-27",0,0,0,0,0,0,0,0
"Andorra","2024-07-28",0,0,0,0,0,0,0,0
"Andorra","2024-07-29",0,0,0,0,0,0,0,0
"Andorra","2024-07-30",0,0,0,0,0,0,0,0
"Andorra","2024-07-31",0,0,0,0,0,0,0,0
"Andorra","2024-08-01",0,0,0,0,0,0,0,0
"Andorra","2024-08-02",0,0,0,0,0,0,0,0
"Andorra","2024-08-03",0,0,0,0,0,0,0,0
"Andorra","2024-08-04",0,0,0,0,0,0,0,0
"Andorra","2024-08-05",0,0,0,0,0,0,0,0
"Andorra","2024-08-06",0,0,0,0,0,0,0,0
"Andorra","2024-08-07",0,0,0,0,0,0,0,0
"Andorra","2024-08-08",0,0,0,0,0,0,0,0
"Andorra","2024-08-09",0,0,0,0,0,0,0,0
"Andorra","2024-08-10",0,0,0,0,0,0,0,0
"Andorra","2024-08-11",0,0,0,0,0,0,0,0
"Andorra","2024-08-12",0,0,0,0,0,0,0,0
"Andorra","2024-08-13",0,0,0,0,0,0,0,0
"Andorra","2024-08-14",0,0,0,0,0,0,0,0
"Andorra","2024-08-15",0,0,0,0,0,0,0,0
"Andorra","2024-08-16",0,0,0,0,0,0,0,0
"Andorra","2024-08-17",0,0,0,0,0,0,0,0
"Andorra","2024-08-18",0,0,0,0,0,0,0,0
"Andorra","2024-08-19",0,0,0,0,0,0,0,0
"Andorra","2024-08-20",0,0,0,0,0,0,0,0
"Andorra","2024-08-21",0,0,0,0,0,0,0,0
"Andorra","2024-08-22",0,0,0,0,0,0,0,0
"Andorra","2024-08-23",0,0,0,0,0,0,0,0
"Andorra","2024-08-24",0,0,0,0,0,0,0,0
"Andorra","2024-08-25",0,0,0,0,0,0,0,0
"Andorra","2024-08-26",0,0,0,0,0,0,0,0
"Andorra","2024-08-27",0,0,0,0,0,0,0,0
"Andorra","2024-08-28",0,0,0,0,0,0,0,0
"Andorra","2024-08-29",0,0,0,0,0,0,0,0
"Andorra","2024-08-30",0,0,0,0,0,0,0,0
"Andorra","2024-08-31",0,0,0,0,0,0,0,0
"Andorra","2024-09-01",0,0,0,0,0,0,0,0
"Andorra","2024-09-02",0,0,0,0,0,0,0,0
"Andorra","2024-09-03",0,0,0,0,0,0,0,0
"Andorra","2024-09-04",0,0,0,0,0,0,0,0
"Andorra","2024-09-05",0,0,0,0,0,0,0,0
"Andorra","2024-09-06",0,0,0,0,0,0,0,0
"Andorra","2024-09-07",0,0,0,0,0,0,0,0
"Andorra","2024-09-08",0,0,0,0,0,0,0,0
"Andorra","2024-09-09",0,0,0,0,0,0,0,0
"Andorra","2024-09-10",0,0,0,0,0,0,0,0
"Andorra","2024-09-11",0,0,0,0,0,0,0,0
"Andorra","2024-09-12",0,0,0,0,0,0,0,0
"Andorra","2024-09-13",0,0,0,0,0,0,0,0
"Andorra","2024-09-14",0,0,0,0,0,0,0,0
"Andorra","2024-09-15",0,0,0,0,0,0,0,0
"Andorra","2024-09-16",0,0,0,0,0,0,0,0
"Andorra","2024-09-17",0,0,0,0,0,0,0,0
"Andorra","2024-09-18",0,0,0,0,0,0,0,0
"Andorra","2024-09-19",0,0,0,0,0,0,0,0
"Andorra","2024-09-20",0,0,0,0,0,0,0,0
"Andorra","2024-09-21",0,0,0,0,0,0,0,0
"Andorra","2024-09-22",0,0,0,0,0,0,0,0
"Andorra","2024-09-23",0,0,0,0,0,0,0,0
"Andorra","2024-09-24",0,0,0,0,0,0,0,0
"Andorra","2024-09-25",0,0,0,0,0,0,0,0
"Andorra","2024-09-26",0,0,0,0,0,0,0,0
"Andorra","2024-09-27",0,0,0,0,0,0,0,0
"Andorra","2024-09-28",0,0,0,0,0,0,0,0
"Andorra","2024-09-29",0,0,0,0,0,0,0,0
"Andorra","2024-09-30",0,0,0,0,0,0,0,0
"Andorra","2024-10-01",0,0,0,0,0,0,0,0
"Andorra","2024-10-02",0,0,0,0,0,0,0,0
"Andorra","2024-10-03",0,0,0,0,0,0,0,0
"Andorra","2024-10-04",0,0,0,0,0,0,0,0
"Andorra","2024-10-05",0,0,0,0,0,0,0,0
"Andorra","2024-10-06",0,0,0,0,0,0,0,0
"Andorra","2024-10-07",0,0,0,0,0,0,0,0
"Andorra","2024-10-08",0,0,0,0,0,0,0,0
"Andorra","2024-10-09",0,0,0,0,0,0,0,0
"Andorra","2024-10-10",0,0,0,0,0,0,0,0
"Andorra","2024-10-11",0,0,0,0,0,0,0,0
"Andorra","2024-10-12",0,0,0,0,0,0,0,0
"Andorra","2024-10-13",0,0,0,0,0,0,0,0
"Andorra","2024-10-14",0,0,0,0,0,0,0,0
"Andorra","2024-10-15",0,0,0,0,0,0,0,0
"Andorra","2024-10-16",0,0,0,0,0,0,0,0
"Andorra","2024-10-17",0,0,0,0,0,0,0,0
"Andorra","2024-10-18",0,0,0,0,0,0,0,0
"Andorra","2024-10-19",0,0,0,0,0,0,0,0
"Andorra","2024-10-20",0,0,0,0,0,0,0,0
"Andorra","2024-10-21",0,0,0,0,0,0,0,0
"Andorra","2024-10-22",0,0,0,0,0,0,0,0
"Andorra","2024-10-23",0,0,0,0,0,0,0,0
"Andorra","2024-10-24",0,0,0,0,0,0,0,0
"Andorra","2024-10-25",0,0,0,0,0,0,0,0
"Andorra","2024-10-26",0,0,0,0,0,0,0,0
"Andorra","2024-10-27",0,0,0,0,0,0,0,0
"Andorra","2024-10-28",0,0,0,0,0,0,0,0
"Andorra","2024-10-29",0,0,0,0,0,0,0,0
"Andorra","2024-10-30",0,0,0,0,0,0,0,0
"Andorra","2024-10-31",0,0,0,0,0,0,0,0
"Andorra","2024-11-01",0,0,0,0,0,0,0,0
"Andorra","2024-11-02",0,0,0,0,0,0,0,0
"Andorra","2024-11-03",0,0,0,0,0,0,0,0
"Andorra","2024-11-04",0,0,0,0,0,0,0,0
"Andorra","2024-11-05",0,0,0,0,0,0,0,0
"Andorra","2024-11-06",0,0,0,0,0,0,0,0
"Andorra","2024-11-07",0,0,0,0,0,0,0,0
"Andorra","2024-11-08",0,0,0,0,0,0,0,0
"Andorra","2024-11-09",0,0,0,0,0,0,0,0
"Andorra","2024-11-10",0,0,0,0,0,0,0,0
"Andorra","2024-11-11",0,0,0,0,0,0,0,0
"Andorra","2024-11-12",0,0,0,0,0,0,0,0
"Andorra","2024-11-13",0,0,0,0,0,0,0,0
"Andorra","2024-11-14",0,0,0,0,0,0,0,0
"Andorra","2024-11-15",0,0,0,0,0,0,0,0
"Andorra","2024-11-16",0,0,0,0,0,0,0,0
"Andorra","2024-11-17",0,0,0,0,0,0,0,0
"Andorra","2024-11-18",0,0,0,0,0,0,0,0
"Andorra","2024-11-19",0,0,0,0,0,0,0,0
"Andorra","2024-11-20",0,0,0,0,0,0,0,0
"Andorra","2024-11-21",0,0,0,0,0,0,0,0
"Andorra","2024-11-22",0,0,0,0,0,0,0,0
"Andorra","2024-11-23",0,0,0,0,0,0,0,0
"Andorra","2024-11-24",0,0,0,0,0,0,0,0
"Andorra","2024-11-25",0,0,0,0,0,0,0,0
"Andorra","2024-11-26",0,0,0,0,0,0,0,0
"Andorra","2024-11-27",0,0,0,0,0,0,0,0
"Andorra","2024-11-28",0,0,0,0,0,0,0,0
"Andorra","2024-11-29",0,0,0,0,0,0,0,0
"Andorra","2024-11-30",0,0,0,0,0,0,0,0
"Andorra","2024-12-01",0,0,0,0,0,0,0,0
"Andorra","2024-12-02",0,0,0,0,0,0,0,0
"Andorra","2024-12-03",0,0,0,0,0,0,0,0
"Andorra","2024-12-04",0,0,0,0,0,0,0,0
"Andorra","2024-12-05",0,0,0,0,0,0,0,0
"Andorra","2024-12-06",0,0,0,0,0,0,0,0
"Andorra","2024-12-07",0,0,0,0,0,0,0,0
"Andorra","2024-12-08",0,0,0,0,0,0,0,0
"Andorra","2024-12-09",0,0,0,0,0,0,0,0
"Argentina","2024-01-01",0,0,0,0,0,0,0,0
"Argentina","2024-01-02",0,0,0,0,0,0,0,0
"Argentina","2024-01-03",0,0,0,0,0,0,0,0
"Argentina","2024-01-04",0,0,0,0,0,0,0,0
"Argentina","2024-01-05",0,0,0,0,0,0,0,0
"Argentina","2024-01-06",0,0,0,0,0,0,0,0
"Argentina","2024-01-07",0,0,0,0,0,0,0,0
"Argentina","2024-01-08",0,0,0,0,0,0,0,0
"Argentina","2024-01-09",0,0,0,0,0,0,0,0
"Argentina","2024-01-10",0,0,0,0,0,0,0,0
"Argentina","2024-01-11",0,0,0,0,0,0,0,0
"Argentina","2024-01-12",0,0,0,0,0,0,0,0
"Argentina","2024-01-13",0,0,0,0,0,0,0,0
"Argentina","2024-01-14",0,0,0,0,0,0,0,0
"Argentina","2024-01-15",0,0,0,0,0,0,0,0
"Argentina","2024-01-16",0,0,0,0,0,0,0,0
"Argentina","2024-01-17",0,0,0,0,0,0,0,0
"Argentina","2024-01-18",0,0,0,0,0,0,0,0
"Argentina","2024-01-19",0,0,0,0,0,0,0,0
"Argentina","2024-01-20",0,0,0,0,0,0,0,0
"Argentina","2024-01-21",0,0,0,0,0,0,0,0
"Argentina","2024-01-22",0,0,0,0,0,0,0,0
"Argentina","2024-01-23",0,1,1,0,1,1,0,0
"Argentina","2024-01-24",0,0,1,0,0,1,0,0
"Argentina","2024-01-25",0,0,1,0,0,1,0,0
"Argentina","2024-01-26",0,0,1,0,0,1,0,0
"Argentina","2024-01-27",0,0,1,0,0,1,0,0
"Argentina","2024-01-28",0,0,1,0,0,1,0,0
"Argentina","2024-01-29",0,0,1,0,0,1,0,0
"Argentina","2024-01-30",0,0,1,0,0,1,0,0
"Argentina","2024-01-31",0,0,1,0,0,1,0,0
"Argentina","2024-02-01",0,0,1,0,0,1,0,0
"Argentina","2024-02-02",0,0,1,0,0,1,0,0
"Argentina","2024-02-03",0,0,1,0,0,1,0,0
"Argentina","2024-02-04",0,0,1,0,0,1,0,0
"Argentina","2024-02-05",0,0,1,0,0,1,0,0
"Argentina","2024-02-06",0,0,1,0,0,1,0,0
"Argentina","2024-02-07",0,0,1,0,0,1,0,0
"Argentina","2024-02-08",0,0,1,0,0,1,0,0
"Argentina","2024-02-09",0,0,1,0,0,1,0,0
"Argentina","2024-02-10",0,0,1,0,0,1,0,0
"Argentina","2024-02-11",0,0,1,0,0,1,0,0
"Argentina","2024-02-12",0,0,1,0,0,1,0,0
"Argentina","2024-02-13",0,0,1,0,0,1,0,0
"Argentina","2024-02-14",0,0,1,0,0,1,0,0
"Argentina","2024-02-15",0,0,1,0,0,1,0,0
"Argentina","2024-02-16",0,0,1,0,0,1,0,0
"Argentina","2024-02-17",0,0,1,0,0,1,0,0
"Argentina","2024-02-18",0,0,1,0,0,1,0,0
"Argentina","2024-02-19",0,0,1,0,0,1,0,0
"Argentina","2024-02-20",0,0,1,0,0,1,0,0
"Argentina","2024-02-21",0,0,1,0,0,1,0,0
"Argentina","2024-02-22",0,0,1,0,0,1,0,0
"Argentina","2024-02-23",0,0,1,0,0,1,0,0
"Argentina","2024-02-24",0,0,1,0,0,1,0,0
"Argentina","2024-02-25",0,0,1,0,0,1,0,0
"Argentina","2024-02-26",0,0,1,0,0,1,0,0
"Argentina","2024-02-27",0,0,1,0,0,1,0,0
"Argentina","2024-02-28",0,0,1,0,0,1,0,0
"Argentina","2024-02-29",0,0,1,0,0,1,0,0
"Argentina","2024-03-01",0,0,1,0,0,1,0,0
"Argentina","2024-03-02",0,0,1,0,0,1,0,0
"Argentina","2024-03-03",0,0,1,0,0,1,0,0
"Argentina","2024-03-04",0,0,1,0,1,2,0,0
"Argentina","2024-03-05",0,0,1,0,0,2,0,0
"Argentina","2024-03-06",0,0,1,0,0,2,0,0
"Argentina","2024-03-07",0,0,1,0,0,2,0,0
"Argentina","2024-03-08",0,0,1,0,0,2,0,0
"Argentina","2024-03-09",0,0,1,0,0,2,0,0
"Argentina","2024-03-10",0,0,1,0,0,2,0,0
"Argentina","2024-03-11",0,0,1,0,0,2,0,0
"Argentina","2024-03-12",0,0,1,0,0,2,0,0
"Argentina","2024-03-13",0,0,1,0,0,2,0,0
"Argentina","2024-03-14",0,0,1,0,0,2,0,0
"Argentina","2024-03-15",0,0,1,0,0,2,0,0
"Argentina","2024-03-16",0,0,1,0,0,2,0,0
"Argentina","2024-03-17",0,0,1,0,0,2,0,0
"Argentina","2024-03-18",0,0,1,0,0,2,0,0
"Argentina","2024-03-19",0,0,1,0,0,2,0,0
"Argentina","2024-03-20",0,0,1,0,0,2,0,0
"Argentina","2024-03-21",0,0,1,0,0,2,0,0
"Argentina","2024-03-22",0,0,1,0,0,2,0,0
"Argentina","2024-03-23",0,0,1,0,0,2,0,0
"Argentina","2024-03-24",0,0,1,0,0,2,0,0
"Argentina","2024-03-25",0,0,1,0,0,2,0,0
"Argentina","2024-03-26",0,0,1,0,0,2,0,0
"Argentina","2024-03-27",0,0,1,0,0,2,0,0
"Argentina","2024-03-28",0,0,1,0,0,2,0,0
"Argentina","2024-03-29",0,0,1,0,0,2,0,0
"Argentina","2024-03-30",0,0,1,0,0,2,0,0
"Argentina","2024-03-31",0,0,1,0,0,2,0,0
"Argentina","2024-04-01",0,0,1,0,0,2,0,0
"Argentina","2024-04-02",0,0,1,0,0,2,0,0
"Argentina","2024-04-03",0,0,1,0,0,2,0,0
"Argentina","2024-04-04",0,0,1,0,0,2,0,0
"Argentina","2024-04-05",0,0,1,0,0,2,0,0
"Argentina","2024-04-06",0,0,1,0,0,2,0,0
"Argentina","2024-04-07",0,0,1,0,0,2,0,0
"Argentina","2024-04-08",0,0,1,0,0,2,0,0
"Argentina","2024-04-09",0,0,1,0,0,2,0,0
"Argentina","2024-04-10",0,0,1,0,0,2,0,0
"Argentina","2024-04-11",0,0,1,0,0,2,0,0
"Argentina","2024-04-12",0,0,1,0,0,2,0,0
"Argentina","2024-04-13",0,0,1,0,0,2,0,0
"Argentina","2024-04-14",0,0,1,0,0,2,0,0
"Argentina","2024-04-15",0,0,1,0,0,2,0,0
"Argentina","2024-04-16",0,0,1,0,0,2,0,0
"Argentina","2024-04-17",0,0,1,0,0,2,0,0
"Argentina","2024-04-18",0,0,1,0,0,2,0,0
"Argentina","2024-04-19",0,0,1,0,0,2,0,0
"Argentina","2024-04-20",0,0,1,0,0,2,0,0
"Argentina","2024-04-21",0,0,1,0,0,2,0,0
"Argentina","2024-04-22",0,0,1,0,0,2,0,0
"Argentina","2024-04-23",0,0,1,0,0,2,0,0
"Argentina","2024-04-24",0,0,1,0,0,2,0,0
"Argentina","2024-04-25",0,0,1,0,0,2,0,0
"Argentina","2024-04-26",0,0,1,0,0,2,0,0
"Argentina","2024-04-27",0,0,1,0,0,2,0,0
"Argentina","2024-04-28",0,0,1,0,0,2,0,0
"Argentina","2024-04-29",0,0,1,0,0,2,0,0
"Argentina","2024-04-30",0,0,1,0,0,2,0,0
"Argentina","2024-05-01",0,0,1,0,0,2,0,0
"Argentina","2024-05-02",0,0,1,0,0,2,0,0
"Argentina","2024-05-03",0,0,1,0,0,2,0,0
"Argentina","2024-05-04",0,0,1,0,0,2,0,0
"Argentina","2024-05-05",0,0,1,0,0,2,0,0
"Argentina","2024-05-06",0,0,1,0,0,2,0,0
"Argentina","2024-05-07",0,0,1,0,0,2,0,0
"Argentina","2024-05-08",0,0,1,0,0,2,0,0
"Argentina","2024-05-09",0,0,1,0,0,2,0,0
"Argentina","2024-05-10",0,0,1,0,0,2,0,0
"Argentina","2024-05-11",0,0,1,0,0,2,0,0
"Argentina","2024-05-12",0,0,1,0,0,2,0,0
"Argentina","2024-05-13",0,0,1,0,0,2,0,0
"Argentina","2024-05-14",0,0,1,0,0,2,0,0
"Argentina","2024-05-15",0,0,1,0,0,2,0,0
"Argentina","2024-05-16",0,0,1,0,0,2,0,0
"Argentina","2024-05-17",0,0,1,0,0,2,0,0
"Argentina","2024-05-18",0,0,1,0,0,2,0,0
"Argentina","2024-05-19",0,0,1,0,0,2,0,0
"Argentina","2024-05-20",0,0,1,0,0,2,0,0
"Argentina","2024-05-21",0,0,1,0,0,2,0,0
"Argentina","2024-05-22",0,0,1,0,0,2,0,0
"Argentina","2024-05-23",0,0,1,0,1,3,0,0
"Argentina","2024-05-24",0,0,1,0,0,3,0,0
"Argentina","2024-05-25",0,0,1,0,0,3,0,0
"Argentina","2024-05-26",0,0,1,0,0,3,0,0
"Argentina","2024-05-27",0,0,1,0,0,3,0,0
"Argentina","2024-05-28",0,0,1,0,0,3,0,0
"Argentina","2024-05-29",0,0,1,0,0,3,0,0
"Argentina","2024-05-30",0,0,1,0,0,3,0,0
"Argentina","2024-05-31",0,0,1,0,0,3,0,0
"Argentina","2024-06-01",0,0,1,0,0,3,0,0
"Argentina","2024-06-02",0,0,1,0,0,3,0,0
"Argentina","2024-06-03",0,0,1,0,0,3,0,0
"Argentina","2024-06-04",0,0,1,0,0,3,0,0
"Argentina","2024-06-05",0,0,1,0,0,3,0,0
"Argentina","2024-06-06",0,0,1,0,0,3,0,0
"Argentina","2024-06-07",0,0,1,0,0,3,0,0
"Argentina","2024-06-08",0,0,1,0,0,3,0,0
"Argentina","2024-06-09",0,0,1,0,0,3,0,0
"Argentina","2024-06-10",0,0,1,0,0,3,0,0
"Argentina","2024-06-11",0,0,1,0,0,3,0,0
"Argentina","2024-06-12",0,0,1,0,0,3,0,0
"Argentina","2024-06-13",0,0,1,0,0,3,0,0
"Argentina","2024-06-14",0,0,1,0,0,3,0,0
"Argentina","2024-06-15",0,0,1,0,0,3,0,0
"Argentina","2024-06-16",0,0,1,0,0,3,0,0
"Argentina","2024-06-17",0,0,1,0,0,3,0,0
"Argentina","2024-06-18",0,0,1,0,0,3,0,0
"Argentina","2024-06-19",0,0,1,0,0,3,0,0
"Argentina","2024-06-20",0,0,1,0,0,3,0,0
"Argentina","2024-06-21",0,0,1,0,0,3,0,0
"Argentina","2024-06-22",0,0,1,0,0,3,0,0
"Argentina","2024-06-23",0,0,1,0,0,3,0,0
"Argentina","2024-06-24",0,0,1,0,0,3,0,0
"Argentina","2024-06-25",0,0,1,0,0,3,0,0
"Argentina","2024-06-26",0,0,1,0,0,3,0,0
"Argentina","2024-06-27",0,0,1,0,0,3,0,0
"Argentina","2024-06-28",0,0,1,0,0,3,0,0
"Argentina","2024-06-29",0,0,1,0,0,3,0,0
"Argentina","2024-06-30",0,0,1,0,0,3,0,0
"Argentina","2024-07-01",0,0,1,0,0,3,0,0
"Argentina","2024-07-02",0,2,3,0,0,3,0,0
"Argentina","2024-07-03",0,0,3,0,0,3,0,0
"Argentina","2024-07-04",0,0,3,0,0,3,0,0
"Argentina","2024-07-05",0,0,3,0,0,3,0,0
"Argentina","2024-07-06",0,0,3,0,0,3,0,0
"Argentina","2024-07-07",0,0,3,0,0,3,0,0
"Argentina","2024-07-08",0,0,3,0,0,3,0,0
"Argentina","2024-07-09",0,0,3,0,0,3,0,0
"Argentina","2024-07-10",0,0,3,0,0,3,0,0
"Argentina","2024-07-11",0,0,3,0,0,3,0,0
"Argentina","2024-07-12",0,0,3,0,0,3,0,0
"Argentina","2024-07-13",0,0,3,0,1,4,0,0
"Argentina","2024-07-14",0,0,3,0,0,4,0,0
"Argentina","2024-07-15",0,0,3,0,0,4,0,0
"Argentina","2024-07-16",0,0,3,0,0,4,0,0
"Argentina","2024-07-17",0,0,3,0,0,4,0,0
"Argentina","2024-07-18",0,0,3,0,0,4,0,0
"Argentina","2024-07-19",0,0,3,0,0,4,0,0
"Argentina","2024-07-20",0,0,3,0,0,4,0,0
"Argentina","2024-07-21",0,0,3,0,0,4,0,0
"Argentina","2024-07-22",0,0,3,0,0,4,0,0
"Argentina","2024-07-23",0,1,4,0,0,4,0,0
"Argentina","2024-07-24",0,0,4,0,0,4,0,0
"Argentina","2024-07-25",0,0,4,0,1,5,0,0
"Argentina","2024-07-26",0,0,4,0,0,5,0,0
"Argentina","2024-07-27",0,0,4,0,0,5,0,0
"Argentina","2024-07-28",0,0,4,0,0,5,0,0
"Argentina","2024-07-29",0,0,4,0,1,6,0,0
"Argentina","2024-07-30",0,2,6,0,0,6,0,0
"Argentina","2024-07-31",0,0,6,0,0,6,0,0
"Argentina","2024-08-01",0,0,6,0,1,7,0,0
"Argentina","2024-08-02",0,0,6,0,0,7,0,0
"Argentina","2024-08-03",0,0,6,0,1,8,0,0
"Argentina","2024-08-04",0,0,6,0,0,8,0,0
"Argentina","2024-08-05",0,0,6,0,1,9,0,0
"Argentina","2024-08-06",0,3,9,0,0,9,0,0
"Argentina","2024-08-07",0,0,9,0,1,10,0,0
"Argentina","2024-08-08",0,0,9,0,0,10,0,0
"Argentina","2024-08-09",0,0,9,0,1,11,0,0
"Argentina","2024-08-10",0,0,9,0,0,11,0,0
"Argentina","2024-08-11",0,0,9,0,1,12,0,0
"Argentina","2024-08-12",0,0,9,0,0,12,0,0
"Argentina","2024-08-13",0,4,13,0,1,13,0,0
"Argentina","2024-08-14",0,0,13,0,2,15,0,0
"Argentina","2024-08-15",0,0,13,0,1,16,0,0
"Argentina","2024-08-16",0,0,13,0,2,18,0,0
"Argentina","2024-08-17",0,0,13,0,2,20,0,0
"Argentina","2024-08-18",0,0,13,0,2,22,0,0
"Argentina","2024-08-19",0,0,13,0,1,23,0,0
"Argentina","2024-08-20",0,12,25,0,2,25,0,0
"Argentina","2024-08-21",0,0,25,0,1,26,0,0
"Argentina","2024-08-22",0,0,25,0,1,27,0,0
"Argentina","2024-08-23",0,0,25,0,1,28,0,0
"Argentina","2024-08-24",0,0,25,0,1,29,0,0
"Argentina","2024-08-25",0,0,25,0,1,30,0,0
"Argentina","2024-08-26",0,0,25,0,1,31,0,0
"Argentina","2024-08-27",0,7,32,0,1,32,0,0
"Argentina","2024-08-28",0,0,32,0,2,34,0,0
"Argentina","2024-08-29",0,0,32,0,2,36,0,0
"Argentina","2024-08-30",0,0,32,0,2,38,0,0
"Argentina","2024-08-31",0,0,32,0,1,39,0,0
"Argentina","2024-09-01",0,0,32,0,2,41,0,0
"Argentina","2024-09-02",0,0,32,0,2,43,0,0
"Argentina","2024-09-03",0,13,45,0,2,45,0,0
"Argentina","2024-09-04",0,0,45,0,1,46,0,0
"Argentina","2024-09-05",0,0,45,0,2,48,0,0
"Argentina","2024-09-06",0,0,45,0,1,49,0,0
"Argentina","2024-09-07",0,0,45,0,1,50,0,0
"Argentina","2024-09-08",0,0,45,0,1,51,0,0
"Argentina","2024-09-09",0,0,45,0,2,53,0,0
"Argentina","2024-09-10",0,9,54,0,1,54,0,0
"Argentina","2024-09-11",0,0,54,0,2,56,0,0
"Argentina","2024-09-12",0,0,54,0,2,58,0,0
"Argentina","2024-09-13",0,0,54,0,2,60,0,0
"Argentina","2024-09-14",0,0,54,0,1,61,0,0
"Argentina","2024-09-15",0,0,54,0,2,63,0,0
"Argentina","2024-09-16",0,0,54,0,2,65,0,0
"Argentina","2024-09-17",0,13,67,0,2,67,0,0
"Argentina","2024-09-18",0,0,67,0,1,68,0,0
"Argentina","2024-09-19",0,0,67,0,0,68,0,0
"Argentina","2024-09-20",0,0,67,0,1,69,0,0
"Argentina","2024-09-21",0,0,67,0,1,70,0,0
"Argentina","2024-09-22",0,0,67,0,1,71,0,0
"Argentina","2024-09-23",0,0,67,0,0,71,0,0
"Argentina","2024-09-24",0,5,72,0,1,72,0,0
"Argentina","2024-09-25",0,0,72,0,1,73,0,0
"Argentina","2024-09-26",0,0,72,0,1,74,0,0
"Argentina","2024-09-27",0,0,72,0,1,75,0,0
"Argentina","2024-09-28",0,0,72,0,1,76,0,0
"Argentina","2024-09-29",0,0,72,0,1,77,0,0
"Argentina","2024-09-30",0,0,72,0,1,78,0,0
"Argentina","2024-10-01",0,7,79,0,1,79,0,0
"Argentina","2024-10-02",0,0,79,0,0,79,0,0
"Argentina","2024-10-03",0,0,79,0,1,80,0,0
"Argentina","2024-10-04",0,0,79,0,0,80,0,0
"Argentina","2024-10-05",0,0,79,0,1,81,0,0
"Argentina","2024-10-06",0,0,79,0,0,81,0,0
"Argentina","2024-10-07",0,0,79,0,1,82,0,0
"Argentina","2024-10-08",0,3,82,0,0,82,0,0
"Argentina","2024-10-09",0,0,82,0,0,82,0,0
"Argentina","2024-10-10",0,0,82,0,1,83,0,0
"Argentina","2024-10-11",0,0,82,0,0,83,0,0
"Argentina","2024-10-12",0,0,82,0,0,83,0,0
"Argentina","2024-10-13",0,0,82,0,0,83,0,0
"Argentina","2024-10-14",0,0,82,0,1,84,0,0
"Argentina","2024-10-15",0,2,84,0,0,84,0,0
"Argentina","2024-10-16",0,0,84,0,0,84,0,0
"Argentina","2024-10-17",0,0,84,0,0,84,0,0
"Argentina","2024-10-18",0,0,84,0,0,84,0,0
"Argentina","2024-10-19",0,0,84,0,1,85,0,0
"Argentina","2024-10-20",0,0,84,0,0,85,0,0
"Argentina","2024-10-21",0,0,84,0,0,85,0,0
"Argentina","2024-10-22",0,1,85,0,0,85,0,0
"Argentina","2024-10-23",0,0,85,0,0,85,0,0
"Argentina","2024-10-24",0,0,85,0,1,86,0,0
"Argentina","2024-10-25",0,0,85,0,0,86,0,0
"Argentina","2024-10-26",0,0,85,0,0,86,0,0
"Argentina","2024-10-27",0,0,85,0,0,86,0,0
"Argentina","2024-10-28",0,0,85,0,1,87,0,0
"Argentina","2024-10-29",0,2,87,0,0,87,0,0
"Argentina","2024-10-30",0,0,87,0,0,87,0,0
"Argentina","2024-10-31",0,0,87,0,0,87,0,0
"Argentina","2024-11-01",0,0,87,0,0,87,0,0
"Argentina","2024-11-02",0,0,87,0,0,87,0,0
"Argentina","2024-11-03",0,0,87,0,0,87,0,0
"Argentina","2024-11-04",0,0,87,0,0,87,0,0
"Argentina","2024-11-05",0,0,87,0,0,87,0,0
"Argentina","2024-11-06",0,0,87,0,0,87,0,0
"Argentina","2024-11-07",0,0,87,0,0,87,0,0
"Argentina","2024-11-08",0,0,87,0,0,87,0,0
"Argentina","2024-11-09",0,0,87,0,0,87,0,0
"Argentina","2024-11-10",0,0,87,0,0,87,0,0
"Argentina","2024-11-11",0,0,87,0,0,87,0,0
"Argentina","2024-11-12",0,0,87,0,0,87,0,0
"Argentina","2024-11-13",0,0,87,0,0,87,0,0
"Argentina","2024-11-14",0,0,87,0,0,87,0,0
"Argentina","2024-11-15",0,0,87,0,0,87,0,0
"Argentina","2024-11-16",0,0,87,0,0,87,0,0
"Argentina","2024-11-17",0,0,87,0,0,87,0,0
"Argentina","2024-11-18",0,0,87,0,0,87,0,0
"Argentina","2024-11-19",0,0,87,0,0,87,0,0
"Argentina","2024-11-20",0,0,87,0,0,87,0,0
"Argentina","2024-11-21",0,0,87,0,0,87,0,0
"Argentina","2024-11-22",0,0,87,0,0,87,0,0
"Argentina","2024-11-23",0,0,87,0,0,87,0,0
"Argentina","2024-11-24",0,0,87,0,0,87,0,0
"Argentina","2024-11-25",0,0,87,0,0,87,0,0
"Argentina","2024-11-26",0,0,87,0,0,87,0,0
"Argentina","2024-11-27",0,0,87,0,0,87,0,0
"Argentina","2024-11-28",0,0,87,0,0,87,0,0
"Argentina","2024-11-29",0,0,87,0,0,87,0,0
"Argentina","2024-11-30",0,0,87,0,0,87,0,0
"Argentina","2024-12-01",0,0,87,0,0,87,0,0
"Argentina","2024-12-02",0,0,87,0,0,87,0,0
"Argentina","2024-12-03",0,0,87,0,0,87,0,0
"Argentina","2024-12-04",0,0,87,0,0,87,0,0
"Argentina","2024-12-05",0,0,87,0,0,87,0,0
"Argentina","2024-12-06",0,0,87,0,0,87,0,0
"Argentina","2024-12-07",0,0,87,0,0,87,0,0
"Argentina","2024-12-08",0,0,87,0,0,87,0,0
"Argentina","2024-12-09",0,0,87,0,0,87,0,0
"Aruba","2024-01-01",0,0,0,0,0,0,0,0
"Aruba","2024-01-02",0,0,0,0,0,0,0,0
"Aruba","2024-01-03",0,0,0,0,0,0,0,0
"Aruba","2024-01-04",0,0,0,0,0,0,0,0
"Aruba","2024-01-05",0,0,0,0,0,0,0,0
"Aruba","2024-01-06",0,0,0,0,0,0,0,0
"Aruba","2024-01-07",0,0,0,0,0,0,0,0
"Aruba","2024-01-08",0,0,0,0,0,0,0,0
"Aruba","2024-01-09",0,0,0,0,0,0,0,0
"Aruba","2024-01-10",0,0,0,0,0,0,0,0
"Aruba","2024-01-11",0,0,0,0,0,0,0,0
"Aruba","2024-01-12",0,0,0,0,0,0,0,0
"Aruba","2024-01-13",0,0,0,0,0,0,0,0
"Aruba","2024-01-14",0,0,0,0,0,0,0,0
"Aruba","2024-01-15",0,0,0,0,0,0,0,0
"Aruba","2024-01-16",0,0,0,0,0,0,0,0
"Aruba","2024-01-17",0,0,0,0,0,0,0,0
"Aruba","2024-01-18",0,0,0,0,0,0,0,0
"Aruba","2024-01-19",0,0,0,0,0,0,0,0
"Aruba","2024-01-20",0,0,0,0,0,0,0,0
"Aruba","2024-01-21",0,0,0,0,0,0,0,0
"Aruba","2024-01-22",0,0,0,0,0,0,0,0
"Aruba","2024-01-23",0,0,0,0,0,0,0,0
"Aruba","2024-01-24",0,0,0,0,0,0,0,0
"Aruba","2024-01-25",0,0,0,0,0,0,0,0
"Aruba","2024-01-26",0,0,0,0,0,0,0,0
"Aruba","2024-01-27",0,0,0,0,0,0,0,0
"Aruba","2024-01-28",0,0,0,0,0,0,0,0
"Aruba","2024-01-29",0,0,0,0,0,0,0,0
"Aruba","2024-01-30",0,0,0,0,0,0,0,0
"Aruba","2024-01-31",0,0,0,0,0,0,0,0
"Aruba","2024-02-01",0,0,0,0,0,0,0,0
"Aruba","2024-02-02",0,0,0,0,0,0,0,0
"Aruba","2024-02-03",0,0,0,0,0,0,0,0
"Aruba","2024-02-04",0,0,0,0,0,0,0,0
"Aruba","2024-02-05",0,0,0,0,0,0,0,0
"Aruba","2024-02-06",0,0,0,0,0,0,0,0
"Aruba","2024-02-07",0,0,0,0,0,0,0,0
"Aruba","2024-02-08",0,0,0,0,0,0,0,0
"Aruba","2024-02-09",0,0,0,0,0,0,0,0
"Aruba","2024-02-10",0,0,0,0,0,0,0,0
"Aruba","2024-02-11",0,0,0,0,0,0,0,0
"Aruba","2024-02-12",0,0,0,0,0,0,0,0
"Aruba","2024-02-13",0,0,0,0,0,0,0,0
"Aruba","2024-02-14",0,0,0,0,0,0,0,0
"Aruba","2024-02-15",0,0,0,0,0,0,0,0
"Aruba","2024-02-16",0,0,0,0,0,0,0,0
"Aruba","2024-02-17",0,0,0,0,0,0,0,0
"Aruba","2024-02-18",0,0,0,0,0,0,0,0
"Aruba","2024-02-19",0,0,0,0,0,0,0,0
"Aruba","2024-02-20",0,0,0,0,0,0,0,0
"Aruba","2024-02-21",0,0,0,0,0,0,0,0
"Aruba","2024-02-22",0,0,0,0,0,0,0,0
"Aruba","2024-02-23",0,0,0,0,0,0,0,0
"Aruba","2024-02-24",0,0,0,0,0,0,0,0
"Aruba","2024-02-25",0,0,0,0,0,0,0,0
"Aruba","2024-02-26",0,0,0,0,0,0,0,0
"Aruba","2024-02-27",0,0,0,0,0,0,0,0
"Aruba","2024-02-28",0,0,0,0,0,0,0,0
"Aruba","2024-02-29",0,0,0,0,0,0,0,0
"Aruba","2024-03-01",0,0,0,0,0,0,0,0
"Aruba","2024-03-02",0,0,0,0,0,0,0,0
"Aruba","2024-03-03",0,0,0,0,0,0,0,0
"Aruba","2024-03-04",0,0,0,0,0,0,0,0
"Aruba","2024-03-05",0,0,0,0,0,0,0,0
"Aruba","2024-03-06",0,0,0,0,0,0,0,0
"Aruba","2024-03-07",0,0,0,0,0,0,0,0
"Aruba","2024-03-08",0,0,0,0,0,0,0,0
"Aruba","2024-03-09",0,0,0,0,0,0,0,0
"Aruba","2024-03-10",0,0,0,0,0,0,0,0
"Aruba","2024-03-11",0,0,0,0,0,0,0,0
"Aruba","2024-03-12",0,0,0,0,0,0,0,0
"Aruba","2024-03-13",0,0,0,0,0,0,0,0
"Aruba","2024-03-14",0,0,0,0,0,0,0,0
"Aruba","2024-03-15",0,0,0,0,0,0,0,0
"Aruba","2024-03-16",0,0,0,0,0,0,0,0
"Aruba","2024-03-17",0,0,0,0,0,0,0,0
"Aruba","2024-03-18",0,0,0,0,0,0,0,0
"Aruba","2024-03-19",0,0,0,0,0,0,0,0
"Aruba","2024-03-20",0,0,0,0,0,0,0,0
"Aruba","2024-03-21",0,0,0,0,0,0,0,0
"Aruba","2024-03-22",0,0,0,0,0,0,0,0
"Aruba","2024-03-23",0,0,0,0,0,0,0,0
"Aruba","2024-03-24",0,0,0,0,0,0,0,0
"Aruba","2024-03-25",0,0,0,0,0,0,0,0
"Aruba","2024-03-26",0,0,0,0,0,0,0,0
"Aruba","2024-03-27",0,0,0,0,0,0,0,0
"Aruba","2024-03-28",0,0,0,0,0,0,0,0
"Aruba","2024-03-29",0,0,0,0,0,0,0,0
"Aruba","2024-03-30",0,0,0,0,0,0,0,0
"Aruba","2024-03-31",0,0,0,0,0,0,0,0
"Aruba","2024-04-01",0,0,0,0,0,0,0,0
"Aruba","2024-04-02",0,0,0,0,0,0,0,0
"Aruba","2024-04-03",0,0,0,0,0,0,0,0
"Aruba","2024-04-04",0,0,0,0,0,0,0,0
"Aruba","2024-04-05",0,0,0,0,0,0,0,0
"Aruba","2024-04-06",0,0,0,0,0,0,0,0
"Aruba","2024-04-07",0,0,0,0,0,0,0,0
"Aruba","2024-04-08",0,0,0,0,0,0,0,0
"Aruba","2024-04-09",0,0,0,0,0,0,0,0
"Aruba","2024-04-10",0,0,0,0,0,0,0,0
"Aruba","2024-04-11",0,0,0,0,0,0,0,0
"Aruba","2024-04-12",0,0,0,0,0,0,0,0
"Aruba","2024-04-13",0,0,0,0,0,0,0,0
"Aruba","2024-04-14",0,0,0,0,0,0,0,0
"Aruba","2024-04-15",0,0,0,0,0,0,0,0
"Aruba","2024-04-16",0,0,0,0,0,0,0,0
"Aruba","2024-04-17",0,0,0,0,0,0,0,0
"Aruba","2024-04-18",0,0,0,0,0,0,0,0
"Aruba","2024-04-19",0,0,0,0,0,0,0,0
"Aruba","2024-04-20",0,0,0,0,0,0,0,0
"Aruba","2024-04-21",0,0,0,0,0,0,0,0
"Aruba","2024-04-22",0,0,0,0,0,0,0,0
"Aruba","2024-04-23",0,0,0,0,0,0,0,0
"Aruba","2024-04-24",0,0,0,0,0,0,0,0
"Aruba","2024-04-25",0,0,0,0,0,0,0,0
"Aruba","2024-04-26",0,0,0,0,0,0,0,0
"Aruba","2024-04-27",0,0,0,0,0,0,0,0
"Aruba","2024-04-28",0,0,0,0,0,0,0,0
"Aruba","2024-04-29",0,0,0,0,0,0,0,0
"Aruba","2024-04-30",0,0,0,0,0,0,0,0
"Aruba","2024-05-01",0,0,0,0,0,0,0,0
"Aruba","2024-05-02",0,0,0,0,0,0,0,0
"Aruba","2024-05-03",0,0,0,0,0,0,0,0
"Aruba","2024-05-04",0,0,0,0,0,0,0,0
"Aruba","2024-05-05",0,0,0,0,0,0,0,0
"Aruba","2024-05-06",0,0,0,0,0,0,0,0
"Aruba","2024-05-07",0,0,0,0,0,0,0,0
"Aruba","2024-05-08",0,0,0,0,0,0,0,0
"Aruba","2024-05-09",0,0,0,0,0,0,0,0
"Aruba","2024-05-10",0,0,0,0,0,0,0,0
"Aruba","2024-05-11",0,0,0,0,0,0,0,0
"Aruba","2024-05-12",0,0,0,0,0,0,0,0
"Aruba","2024-05-13",0,0,0,0,0,0,0,0
"Aruba","2024-05-14",0,0,0,0,0,0,0,0
"Aruba","2024-05-15",0,0,0,0,0,0,0,0
"Aruba","2024-05-16",0,0,0,0,0,0,0,0
"Aruba","2024-05-17",0,0,0,0,0,0,0,0
"Aruba","2024-05-18",0,0,0,0,0,0,0,0
"Aruba","2024-05-19",0,0,0,0,0,0,0,0
"Aruba","2024-05-20",0,0,0,0,0,0,0,0
"Aruba","2024-05-21",0,0,0,0,0,0,0,0
"Aruba","2024-05-22",0,0,0,0,0,0,0,0
"Aruba","2024-05-23",0,0,0,0,0,0,0,0
"Aruba","2024-05-24",0,0,0,0,0,0,0,0
"Aruba","2024-05-25",0,0,0,0,0,0,0,0
"Aruba","2024-05-26",0,0,0,0,0,0,0,0
"Aruba","2024-05-27",0,0,0,0,0,0,0,0
"Aruba","2024-05-28",0,0,0,0,0,0,0,0
"Aruba","2024-05-29",0,0,0,0,0,0,0,0
"Aruba","2024-05-30",0,0,0,0,0,0,0,0
"Aruba","2024-05-31",0,0,0,0,0,0,0,0
"Aruba","2024-06-01",0,0,0,0,0,0,0,0
"Aruba","2024-06-02",0,0,0,0,0,0,0,0
"Aruba","2024-06-03",0,0,0,0,0,0,0,0
"Aruba","2024-06-04",0,0,0,0,0,0,0,0
"Aruba","2024-06-05",0,0,0,0,0,0,0,0
"Aruba","2024-06-06",0,0,0,0,0,0,0,0
"Aruba","2024-06-07",0,0,0,0,0,0,0,0
"Aruba","2024-06-08",0,0,0,0,0,0,0,0
"Aruba","2024-06-09",0,0,0,0,0,0,0,0
"Aruba","2024-06-10",0,0,0,0,0,0,0,0
"Aruba","2024-06-11",0,0,0,0,0,0,0,0
"Aruba","2024-06-12",0,0,0,0,0,0,0,0
"Aruba","2024-06-13",0,0,0,0,0,0,0,0
"Aruba","2024-06-14",0,0,0,0,0,0,0,0
"Aruba","2024-06-15",0,0,0,0,0,0,0,0
"Aruba","2024-06-16",0,0,0,0,0,0,0,0
"Aruba","2024-06-17",0,0,0,0,0,0,0,0
"Aruba","2024-06-18",0,0,0,0,0,0,0,0
"Aruba","2024-06-19",0,0,0,0,0,0,0,0
"Aruba","2024-06-20",0,0,0,0,0,0,0,0
"Aruba","2024-06-21",0,0,0,0,0,0,0,0
"Aruba","2024-06-22",0,0,0,0,0,0,0,0
"Aruba","2024-06-23",0,0,0,0,0,0,0,0
"Aruba","2024-06-24",0,0,0,0,0,0,0,0
"Aruba","2024-06-25",0,0,0,0,0,0,0,0
"Aruba","2024-06-26",0,0,0,0,0,0,0,0
"Aruba","2024-06-27",0,0,0,0,0,0,0,0
"Aruba","2024-06-28",0,0,0,0,0,0,0,0
"Aruba","2024-06-29",0,0,0,0,0,0,0,0
"Aruba","2024-06-30",0,0,0,0,0,0,0,0
"Aruba","2024-07-01",0,0,0,0,0,0,0,0
"Aruba","2024-07-02",0,0,0,0,0,0,0,0
"Aruba","2024-07-03",0,0,0,0,0,0,0,0
"Aruba","2024-07-04",0,0,0,0,0,0,0,0
"Aruba","2024-07-05",0,0,0,0,0,0,0,0
"Aruba","2024-07-06",0,0,0,0,0,0,0,0
"Aruba","2024-07-07",0,0,0,0,0,0,0,0
"Aruba","2024-07-08",0,0,0,0,0,0,0,0
"Aruba","2024-07-09",0,0,0,0,0,0,0,0
"Aruba","2024-07-10",0,0,0,0,0,0,0,0
"Aruba","2024-07-11",0,0,0,0,0,0,0,0
"Aruba","2024-07-12",0,0,0,0,0,0,0,0
"Aruba","2024-07-13",0,0,0,0,0,0,0,0
"Aruba","2024-07-14",0,0,0,0,0,0,0,0
"Aruba","2024-07-15",0,0,0,0,0,0,0,0
"Aruba","2024-07-16",0,0,0,0,0,0,0,0
"Aruba","2024-07-17",0,0,0,0,0,0,0,0
"Aruba","2024-07-18",0,0,0,0,0,0,0,0
"Aruba","2024-07-19",0,0,0,0,0,0,0,0
"Aruba","2024-07-20",0,0,0,0,0,0,0,0
"Aruba","2024-07-21",0,0,0,0,0,0,0,0
"Aruba","2024-07-22",0,0,0,0,0,0,0,0
"Aruba","2024-07-23",0,0,0,0,0,0,0,0
"Aruba","2024-07-24",0,0,0,0,0,0,0,0
"Aruba","2024-07-25",0,0,0,0,0,0,0,0
"Aruba","2024-07-26",0,0,0,0,0,0,0,0
"Aruba","2024-07-27",0,0,0,0,0,0,0,0
"Aruba","2024-07-28",0,0,0,0,0,0,0,0
"Aruba","2024-07-29",0,0,0,0,0,0,0,0
"Aruba","2024-07-30",0,0,0,0,0,0,0,0
"Aruba","2024-07-31",0,0,0,0,0,0,0,0
"Aruba","2024-08-01",0,0,0,0,0,0,0,0
"Aruba","2024-08-02",0,0,0,0,0,0,0,0
"Aruba","2024-08-03",0,0,0,0,0,0,0,0
"Aruba","2024-08-04",0,0,0,0,0,0,0,0
"Aruba","2024-08-05",0,0,0,0,0,0,0,0
"Aruba","2024-08-06",0,0,0,0,0,0,0,0
"Aruba","2024-08-07",0,0,0,0,0,0,0,0
"Aruba","2024-08-08",0,0,0,0,0,0,0,0
"Aruba","2024-08-09",0,0,0,0,0,0,0,0
"Aruba","2024-08-10",0,0,0,0,0,0,0,0
"Aruba","2024-08-11",0,0,0,0,0,0,0,0
"Aruba","2024-08-12",0,0,0,0,0,0,0,0
"Aruba","2024-08-13",0,0,0,0,0,0,0,0
"Aruba","2024-08-14",0,0,0,0,0,0,0,0
"Aruba","2024-08-15",0,0,0,0,0,0,0,0
"Aruba","2024-08-16",0,0,0,0,0,0,0,0
"Aruba","2024-08-17",0,0,0,0,0,0,0,0
"Aruba","2024-08-18",0,0,0,0,0,0,0,0
"Aruba","2024-08-19",0,0,0,0,0,0,0,0
"Aruba","2024-08-20",0,0,0,0,0,0,0,0
"Aruba","2024-08-21",0,0,0,0,0,0,0,0
"Aruba","2024-08-22",0,0,0,0,0,0,0,0
"Aruba","2024-08-23",0,0,0,0,0,0,0,0
"Aruba","2024-08-24",0,0,0,0,0,0,0,0
"Aruba","2024-08-25",0,0,0,0,0,0,0,0
"Aruba","2024-08-26",0,0,0,0,0,0,0,0
"Aruba","2024-08-27",0,0,0,0,0,0,0,0
"Aruba","2024-08-28",0,0,0,0,0,0,0,0
"Aruba","2024-08-29",0,0,0,0,0,0,0,0
"Aruba","2024-08-30",0,0,0,0,0,0,0,0
"Aruba","2024-08-31",0,0,0,0,0,0,0,0
"Aruba","2024-09-01",0,0,0,0,0,0,0,0
"Aruba","2024-09-02",0,0,0,0,0,0,0,0
"Aruba","2024-09-03",0,0,0,0,0,0,0,0
"Aruba","2024-09-04",0,0,0,0,0,0,0,0
"Aruba","2024-09-05",0,0,0,0,0,0,0,0
"Aruba","2024-09-06",0,0,0,0,0,0,0,0
"Aruba","2024-09-07",0,0,0,0,0,0,0,0
"Aruba","2024-09-08",0,0,0,0,0,0,0,0
"Aruba","2024-09-09",0,0,0,0,0,0,0,0
"Aruba","2024-09-10",0,0,0,0,0,0,0,0
"Aruba","2024-09-11",0,0,0,0,0,0,0,0
"Aruba","2024-09-12",0,0,0,0,0,0,0,0
"Aruba","2024-09-13",0,0,0,0,0,0,0,0
"Aruba","2024-09-14",0,0,0,0,0,0,0,0
"Aruba","2024-09-15",0,0,0,0,0,0,0,0
"Aruba","2024-09-16",0,0,0,0,0,0,0,0
"Aruba","2024-09-17",0,0,0,0,0,0,0,0
"Aruba","2024-09-18",0,0,0,0,0,0,0,0
"Aruba","2024-09-19",0,0,0,0,0,0,0,0
"Aruba","2024-09-20",0,0,0,0,0,0,0,0
"Aruba","2024-09-21",0,0,0,0,0,0,0,0
"Aruba","2024-09-22",0,0,0,0,0,0,0,0
"Aruba","2024-09-23",0,0,0,0,0,0,0,0
"Aruba","2024-09-24",0,0,0,0,0,0,0,0
"Aruba","2024-09-25",0,0,0,0,0,0,0,0
"Aruba","2024-09-26",0,0,0,0,0,0,0,0
"Aruba","2024-09-27",0,0,0,0,0,0,0,0
"Aruba","2024-09-28",0,0,0,0,0,0,0,0
"Aruba","2024-09-29",0,0,0,0,0,0,0,0
"Aruba","2024-09-30",0,0,0,0,0,0,0,0
"Aruba","2024-10-01",0,0,0,0,0,0,0,0
"Aruba","2024-10-02",0,0,0,0,0,0,0,0
"Aruba","2024-10-03",0,0,0,0,0,0,0,0
"Aruba","2024-10-04",0,0,0,0,0,0,0,0
"Aruba","2024-10-05",0,0,0,0,0,0,0,0
"Aruba","2024-10-06",0,0,0,0,0,0,0,0
"Aruba","2024-10-07",0,0,0,0,0,0,0,0
"Aruba","2024-10-08",0,0,0,0,0,0,0,0
"Aruba","2024-10-09",0,0,0,0,0,0,0,0
"Aruba","2024-10-10",0,0,0,0,0,0,0,0
"Aruba","2024-10-11",0,0,0,0,0,0,0,0
"Aruba","2024-10-12",0,0,0,0,0,0,0,0
"Aruba","2024-10-13",0,0,0,0,0,0,0,0
"Aruba","2024-10-14",0,0,0,0,0,0,0,0
"Aruba","2024-10-15",0,0,0,0,0,0,0,0
"Aruba","2024-10-16",0,0,0,0,0,0,0,0
"Aruba","2024-10-17",0,0,0,0,0,0,0,0
"Aruba","2024-10-18",0,0,0,0,0,0,0,0
"Aruba","2024-10-19",0,0,0,0,0,0,0,0
"Aruba","2024-10-20",0,0,0,0,0,0,0,0
"Aruba","2024-10-21",0,0,0,0,0,0,0,0
"Aruba","2024-10-22",0,0,0,0,0,0,0,0
"Aruba","2024-10-23",0,0,0,0,0,0,0,0
"Aruba","2024-10-24",0,0,0,0,0,0,0,0
"Aruba","2024-10-25",0,0,0,0,0,0,0,0
"Aruba","2024-10-26",0,0,0,0,0,0,0,0
"Aruba","2024-10-27",0,0,0,0,0,0,0,0
"Aruba","2024-10-28",0,0,0,0,0,0,0,0
"Aruba","2024-10-29",0,0,0,0,0,0,0,0
"Aruba","2024-10-30",0,0,0,0,0,0,0,0
"Aruba","2024-10-31",0,0,0,0,0,0,0,0
"Aruba","2024-11-01",0,0,0,0,0,0,0,0
"Aruba","2024-11-02",0,0,0,0,0,0,0,0
"Aruba","2024-11-03",0,0,0,0,0,0,0,0
"Aruba","2024-11-04",0,0,0,0,0,0,0,0
"Aruba","2024-11-05",0,0,0,0,0,0,0,0
"Aruba","2024-11-06",0,0,0,0,0,0,0,0
"Aruba","2024-11-07",0,0,0,0,0,0,0,0
"Aruba","2024-11-08",0,0,0,0,0,0,0,0
"Aruba","2024-11-09",0,0,0,0,0,0,0,0
"Aruba","2024-11-10",0,0,0,0,0,0,0,0
"Aruba","2024-11-11",0,0,0,0,0,0,0,0
"Aruba","2024-11-12",0,0,0,0,0,0,0,0
"Aruba","2024-11-13",0,0,0,0,0,0,0,0
"Aruba","2024-11-14",0,0,0,0,0,0,0,0
"Aruba","2024-11-15",0,0,0,0,0,0,0,0
"Aruba","2024-11-16",0,0,0,0,0,0,0,0
"Aruba","2024-11-17",0,0,0,0,0,0,0,0
"Aruba","2024-11-18",0,0,0,0,0,0,0,0
"Aruba","2024-11-19",0,0,0,0,0,0,0,0
"Aruba","2024-11-20",0,0,0,0,0,0,0,0
"Aruba","2024-11-21",0,0,0,0,0,0,0,0
"Aruba","2024-11-22",0,0,0,0,0,0,0,0
"Aruba","2024-11-23",0,0,0,0,0,0,0,0
"Aruba","2024-11-24",0,0,0,0,0,0,0,0
"Aruba","2024-11-25",0,0,0,0,0,0,0,0
"Aruba","2024-11-26",0,0,0,0,0,0,0,0
"Aruba","2024-11-27",0,0,0,0,0,0,0,0
"Aruba","2024-11-28",0,0,0,0,0,0,0,0
"Aruba","2024-11-29",0,0,0,0,0,0,0,0
"Aruba","2024-11-30",0,0,0,0,0,0,0,0
"Aruba","2024-12-01",0,0,0,0,0,0,0,0
"Aruba","2024-12-02",0,0,0,0,0,0,0,0
"Aruba","2024-12-03",0,0,0,0,0,0,0,0
"Aruba","2024-12-04",0,0,0,0,0,0,0,0
"Aruba","2024-12-05",0,0,0,0,0,0,0,0
"Aruba","2024-12-06",0,0,0,0,0,0,0,0
"Aruba","2024-12-07",0,0,0,0,0,0,0,0
"Aruba","2024-12-08",0,0,0,0,0,0,0,0
"Aruba","2024-12-09",0,0,0,0,0,0,0,0
"Asia","2024-01-01",0,0,0,0,0,0,0,0
"Asia","2024-01-02",0,0,0,0,0,0,0,0
"Asia","2024-01-03",0,0,0,0,0,0,0,0
"Asia","2024-01-04",0,2,2,0,2,2,0,0
"Asia","2024-01-05",0,1,3,0,1,3,0,0
"Asia","2024-01-06",0,0,3,0,0,3,0,0
"Asia","2024-01-07",0,0,3,0,0,3,0,0
"Asia","2024-01-08",0,0,3,0,1,4,0,0
"Asia","2024-01-09",0,1,4,0,0,4,0,0
"Asia","2024-01-10",0,14,18,0,14,18,0,0
"Asia","2024-01-11",0,1,19,0,1,19,0,0
"Asia","2024-01-12",0,1,20,0,1,20,0,0
"Asia","2024-01-13",0,0,20,0,0,20,0,0
"Asia","2024-01-14",0,0,20,0,0,20,0,0
"Asia","2024-01-15",0,0,20,0,1,21,0,0
"Asia","2024-01-16",0,0,20,0,0,21,0,0
"Asia","2024-01-17",0,1,21,0,0,21,0,0
"Asia","2024-01-18",0,0,21,0,1,22,0,0
"Asia","2024-01-19",0,2,23,0,1,23,0,0
"Asia","2024-01-20",0,2,25,0,2,25,0,0
"Asia","2024-01-21",0,0,25,0,2,27,0,0
"Asia","2024-01-22",0,0,25,0,1,28,0,0
"Asia","2024-01-23",0,0,25,0,1,29,0,0
"Asia","2024-01-24",0,6,31,0,2,31,0,0
"Asia","2024-01-25",0,0,31,0,22,53,0,0
"Asia","2024-01-26",0,0,31,0,23,76,0,0
"Asia","2024-01-27",0,0,31,0,22,98,0,0
"Asia","2024-01-28",0,0,31,0,22,120,0,0
"Asia","2024-01-29",0,0,31,0,22,142,0,0
"Asia","2024-01-30",0,0,31,0,23,165,0,0
"Asia","2024-01-31",0,156,187,0,22,187,0,0
"Asia","2024-02-01",0,0,187,0,2,189,0,0
"Asia","2024-02-02",0,5,192,0,3,192,0,0
"Asia","2024-02-03",0,0,192,0,1,193,0,0
"Asia","2024-02-04",0,0,192,0,1,194,0,0
"Asia","2024-02-05",0,3,195,0,1,195,0,0
"Asia","2024-02-06",0,0,195,0,1,196,0,0
"Asia","2024-02-07",0,0,195,0,1,197,0,0
"Asia","2024-02-08",0,0,195,0,2,199,0,0
"Asia","2024-02-09",0,5,200,0,1,200,0,0
"Asia","2024-02-10",0,0,200,0,0,200,0,0
"Asia","2024-02-11",0,0,200,0,0,200,0,0
"Asia","2024-02-12",0,0,200,0,0,200,0,0
"Asia","2024-02-13",0,0,200,0,1,201,0,0
"Asia","2024-02-14",0,0,200,0,0,201,0,0
"Asia","2024-02-15",0,1,201,0,0,201,0,0
"Asia","2024-02-16",0,1,202,0,1,202,0,0
"Asia","2024-02-17",0,0,202,0,1,203,0,0
"Asia","2024-02-18",0,0,202,0,2,205,0,0
"Asia","2024-02-19",0,0,202,0,1,206,0,0
"Asia","2024-02-20",0,0,202,0,2,208,0,0
"Asia","2024-02-21",0,0,202,0,1,209,0,0
"Asia","2024-02-22",0,0,202,0,2,211,0,0
"Asia","2024-02-23",0,10,212,0,1,212,0,0
"Asia","2024-02-24",0,0,212,0,3,215,0,0
"Asia","2024-02-25",0,0,212,0,3,218,0,0
"Asia","2024-02-26",0,0,212,0,3,221,0,0
"Asia","2024-02-27",0,0,212,0,3,224,0,0
"Asia","2024-02-28",0,15,227,0,3,227,0,0
"Asia","2024-02-29",0,114,341,0,114,341,0,0
"Asia","2024-03-01",0,4,345,0,4,345,0,0
"Asia","2024-03-02",0,1,346,0,1,346,0,0
"Asia","2024-03-03",0,0,346,0,2,348,0,0
"Asia","2024-03-04",0,0,346,0,3,351,0,0
"Asia","2024-03-05",0,0,346,0,3,354,0,0
"Asia","2024-03-06",0,10,356,0,2,356,0,0
"Asia","2024-03-07",0,0,356,0,2,358,0,0
"Asia","2024-03-08",0,3,359,0,1,359,0,0
"Asia","2024-03-09",0,0,359,0,0,359,0,0
"Asia","2024-03-10",0,0,359,0,1,360,0,0
"Asia","2024-03-11",0,0,359,0,0,360,0,0
"Asia","2024-03-12",0,0,359,0,0,360,0,0
"Asia","2024-03-13",0,0,359,0,0,360,0,0
"Asia","2024-03-14",0,0,359,0,1,361,0,0
"Asia","2024-03-15",0,2,361,0,0,361,0,0
"Asia","2024-03-16",0,0,361,0,0,361,0,0
"Asia","2024-03-17",0,0,361,0,0,361,0,0
"Asia","2024-03-18",0,0,361,0,0,361,0,0
"Asia","2024-03-19",0,0,361,0,1,362,0,0
"Asia","2024-03-20",0,0,361,0,0,362,0,0
"Asia","2024-03-21",0,0,361,0,0,362,0,0
"Asia","2024-03-22",0,1,362,0,0,362,0,0
"Asia","2024-03-23",0,0,362,0,3,365,0,0
"Asia","2024-03-24",0,0,362,0,3,368,0,0
"Asia","2024-03-25",0,0,362,0,3,371,0,0
"Asia","2024-03-26",0,12,374,0,3,374,0,0
"Asia","2024-03-27",0,0,374,0,17,391,0,0
"Asia","2024-03-28",0,0,374,0,16,407,0,0
"Asia","2024-03-29",0,0,374,0,17,424,0,0
"Asia","2024-03-30",0,0,374,0,16,440,0,0
"Asia","2024-03-31",0,83,457,0,17,457,0,0
"Asia","2024-04-01",0,6,463,0,6,463,0,0
"Asia","2024-04-02",0,1,464,0,1,464,0,0
"Asia","2024-04-03",0,0,464,0,1,465,0,0
"Asia","2024-04-04",0,0,464,0,1,466,0,0
"Asia","2024-04-05",0,3,467,0,1,467,0,0
"Asia","2024-04-06",0,0,467,0,0,467,0,0
"Asia","2024-04-07",0,0,467,0,0,467,0,0
"Asia","2024-04-08",0,0,467,0,1,468,0,0
"Asia","2024-04-09",0,1,468,0,0,468,0,0
"Asia","2024-04-10",0,0,468,0,1,469,0,0
"Asia","2024-04-11",0,0,468,0,0,469,0,0
"Asia","2024-04-12",0,2,470,0,1,470,0,0
"Asia","2024-04-13",0,0,470,0,0,470,0,0
"Asia","2024-04-14",0,0,470,0,0,470,0,0
"Asia","2024-04-15",0,0,470,0,0,470,0,0
"Asia","2024-04-16",0,0,470,0,1,471,0,0
"Asia","2024-04-17",0,0,470,0,0,471,0,0
"Asia","2024-04-18",0,0,470,0,0,471,0,0
"Asia","2024-04-19",0,1,471,0,0,471,0,0
"Asia","2024-04-20",0,1,472,0,1,472,0,0
"Asia","2024-04-21",0,0,472,0,0,472,0,0
"Asia","2024-04-22",0,0,472,0,1,473,0,0
"Asia","2024-04-23",0,0,472,0,0,473,0,0
"Asia","2024-04-24",0,0,472,0,0,473,0,0
"Asia","2024-04-25",0,0,472,0,1,474,0,0
"Asia","2024-04-26",0,2,474,0,0,474,0,0
"Asia","2024-04-27",0,1,475,0,1,475,0,0
"Asia","2024-04-28",0,0,475,0,22,497,0,0
"Asia","2024-04-29",0,0,475,0,22,519,0,0
"Asia","2024-04-30",0,66,541,0,22,541,0,0
"Asia","2024-05-01",0,0,541,0,0,541,0,0
"Asia","2024-05-02",0,0,541,0,0,541,0,0
"Asia","2024-05-03",0,0,541,0,0,541,0,0
"Asia","2024-05-04",0,0,541,0,1,542,0,0
"Asia","2024-05-05",0,0,541,0,0,542,0,0
"Asia","2024-05-06",0,0,541,0,0,542,0,0
"Asia","2024-05-07",0,1,542,0,0,542,0,0
"Asia","2024-05-08",0,0,542,0,8,550,0,0
"Asia","2024-05-09",0,0,542,0,9,559,0,0
"Asia","2024-05-10",0,25,567,0,8,567,0,0
"Asia","2024-05-11",0,0,567,0,0,567,0,0
"Asia","2024-05-12",0,0,567,0,0,567,0,0
"Asia","2024-05-13",0,0,567,0,1,568,0,0
"Asia","2024-05-14",0,1,568,0,0,568,0,0
"Asia","2024-05-15",0,0,568,0,0,568,0,0
"Asia","2024-05-16",0,0,568,0,0,568,0,0
"Asia","2024-05-17",0,0,568,0,0,568,0,0
"Asia","2024-05-18",0,0,568,0,0,568,0,0
"Asia","2024-05-19",0,0,568,0,1,569,0,0
"Asia","2024-05-20",0,0,568,0,0,569,0,0
"Asia","2024-05-21",0,0,568,0,0,569,0,0
"Asia","2024-05-22",0,1,569,0,0,569,0,0
"Asia","2024-05-23",0,0,569,0,2,571,0,0
"Asia","2024-05-24",0,4,573,0,2,573,0,0
"Asia","2024-05-25",0,0,573,0,0,573,0,0
"Asia","2024-05-26",0,0,573,0,1,574,0,0
"Asia","2024-05-27",0,1,574,0,0,574,0,0
"Asia","2024-05-28",0,0,574,0,16,590,0,0
"Asia","2024-05-29",0,0,574,0,17,607,0,0
"Asia","2024-05-30",0,49,623,0,16,623,0,0
"Asia","2024-05-31",0,59,682,0,59,682,0,0
"Asia","2024-06-01",0,0,682,0,0,682,0,0
"Asia","2024-06-02",0,0,682,0,0,682,0,0
"Asia","2024-06-03",0,0,682,0,0,682,0,0
"Asia","2024-06-04",0,0,682,0,1,683,0,0
"Asia","2024-06-05",0,0,682,0,0,683,0,0
"Asia","2024-06-06",0,0,682,0,0,683,0,0
"Asia","2024-06-07",0,0,682,0,0,683,0,0
"Asia","2024-06-08",0,0,682,0,0,683,0,0
"Asia","2024-06-09",0,0,682,0,1,684,0,0
"Asia","2024-06-10",0,0,682,0,0,684,0,0
"Asia","2024-06-11",0,0,682,0,0,684,0,0
"Asia","2024-06-12",0,0,682,0,0,684,0,0
"Asia","2024-06-13",0,0,682,0,0,684,0,0
"Asia","2024-06-14",0,0,682,0,0,684,0,0
"Asia","2024-06-15",0,0,682,0,0,684,0,0
"Asia","2024-06-16",0,0,682,0,1,685,0,0
"Asia","2024-06-17",0,0,682,0,0,685,0,0
"Asia","2024-06-18",0,0,682,0,0,685,0,0
"Asia","2024-06-19",0,0,682,0,0,685,0,0
"Asia","2024-06-20",0,0,682,0,0,685,0,0
"Asia","2024-06-21",0,0,682,0,1,686,0,0
"Asia","2024-06-22",0,0,682,0,0,686,0,0
"Asia","2024-06-23",0,0,682,0,0,686,0,0
"Asia","2024-06-24",0,4,686,0,0,686,0,0
"Asia","2024-06-25",0,6,692,0,6,692,0,0
"Asia","2024-06-26",0,0,692,0,2,694,0,0
"Asia","2024-06-27",0,0,692,0,3,697,0,0
"Asia","2024-06-28",0,7,699,0,2,699,0,0
"Asia","2024-06-29",0,0,699,0,35,734,0,0
"Asia","2024-06-30",0,70,769,0,35,769,0,0
"Asia","2024-07-01",0,0,769,0,0,769,0,0
"Asia","2024-07-02",0,0,769,0,0,769,0,0
"Asia","2024-07-03",0,0,769,0,1,770,0,0
"Asia","2024-07-04",0,0,769,0,0,770,0,0
"Asia","2024-07-05",0,0,769,0,0,770,0,0
"Asia","2024-07-06",0,0,769,0,1,771,0,0
"Asia","2024-07-07",0,0,769,0,0,771,0,0
"Asia","2024-07-08",0,2,771,0,0,771,0,0
"Asia","2024-07-09",0,0,771,0,0,771,0,0
"Asia","2024-07-10",0,0,771,0,1,772,0,0
"Asia","2024-07-11",0,0,771,0,1,773,0,0
"Asia","2024-07-12",0,2,773,0,0,773,0,0
"Asia","2024-07-13",0,1,774,0,1,774,0,0
"Asia","2024-07-14",0,0,774,0,2,776,0,0
"Asia","2024-07-15",0,0,774,0,3,779,0,0
"Asia","2024-07-16",0,7,781,0,2,781,0,0
"Asia","2024-07-17",0,0,781,0,1,782,0,0
"Asia","2024-07-18",0,0,781,0,1,783,0,0
"Asia","2024-07-19",0,0,781,0,0,783,0,0
"Asia","2024-07-20",0,0,781,0,1,784,0,0
"Asia","2024-07-21",0,0,781,0,1,785,0,0
"Asia","2024-07-22",0,0,781,0,0,785,0,0
"Asia","2024-07-23",0,0,781,0,1,786,0,0
"Asia","2024-07-24",0,0,781,0,1,787,0,0
"Asia","2024-07-25",0,0,781,0,1,788,0,0
"Asia","2024-07-26",0,0,781,0,1,789,0,0
"Asia","2024-07-27",0,0,781,0,0,789,0,0
"Asia","2024-07-28",0,9,790,0,1,790,0,0
"Asia","2024-07-29",0,0,790,0,20,810,0,0
"Asia","2024-07-30",0,39,829,0,19,829,0,0
"Asia","2024-07-31",0,27,856,0,27,856,0,0
"Asia","2024-08-01",0,0,856,0,3,859,0,0
"Asia","2024-08-02",0,6,862,0,3,862,0,0
"Asia","2024-08-03",0,0,862,0,0,862,0,0
"Asia","2024-08-04",0,0,862,0,1,863,0,0
"Asia","2024-08-05",0,1,863,0,0,863,0,0
"Asia","2024-08-06",0,2,865,0,2,865,0,0
"Asia","2024-08-07",0,0,865,0,1,866,0,0
"Asia","2024-08-08",0,0,865,0,0,866,0,0
"Asia","2024-08-09",0,0,865,0,1,867,0,0
"Asia","2024-08-10",0,0,865,0,1,868,0,0
"Asia","2024-08-11",0,0,865,0,1,869,0,0
"Asia","2024-08-12",0,0,865,0,0,869,0,0
"Asia","2024-08-13",0,5,870,0,1,870,0,0
"Asia","2024-08-14",0,1,871,0,1,871,0,0
"Asia","2024-08-15",0,2,873,0,2,873,0,0
"Asia","2024-08-16",0,0,873,0,0,873,0,0
"Asia","2024-08-17",0,0,873,0,0,873,0,0
"Asia","2024-08-18",0,0,873,0,1,874,0,0
"Asia","2024-08-19",0,1,874,0,0,874,0,0
"Asia","2024-08-20",0,4,878,0,4,878,0,0
"Asia","2024-08-21",0,1,879,0,1,879,0,0
"Asia","2024-08-22",0,1,880,0,1,880,0,0
"Asia","2024-08-23",0,1,881,0,1,881,0,0
"Asia","2024-08-24",0,0,881,0,0,881,0,0
"Asia","2024-08-25",0,0,881,0,0,881,0,0
"Asia","2024-08-26",0,0,881,0,1,882,0,0
"Asia","2024-08-27",0,1,882,0,0,882,0,0
"Asia","2024-08-28",0,4,886,0,4,886,0,0
"Asia","2024-08-29",0,0,886,0,23,909,0,0
"Asia","2024-08-30",0,0,886,0,23,932,0,0
"Asia","2024-08-31",0,69,955,0,23,955,0,0
"Asia","2024-09-01",0,3,958,0,3,958,0,0
"Asia","2024-09-02",0,1,959,0,1,959,0,0
"Asia","2024-09-03",0,0,959,0,0,959,0,0
"Asia","2024-09-04",0,0,959,0,0,959,0,0
"Asia","2024-09-05",0,0,959,0,0,959,0,0
"Asia","2024-09-06",0,0,959,0,1,960,0,0
"Asia","2024-09-07",0,0,959,0,0,960,0,0
"Asia","2024-09-08",0,1,960,0,0,960,0,0
"Asia","2024-09-09",0,0,960,0,2,962,0,0
"Asia","2024-09-10",0,0,960,0,1,963,0,0
"Asia","2024-09-11",0,0,960,0,2,965,0,0
"Asia","2024-09-12",0,0,960,0,2,967,0,0
"Asia","2024-09-13",0,0,960,0,2,969,0,0
"Asia","2024-09-14",0,0,960,0,1,970,0,0
"Asia","2024-09-15",0,12,972,0,2,972,0,0
"Asia","2024-09-16",0,0,972,0,0,972,0,0
"Asia","2024-09-17",0,0,972,0,1,973,0,0
"Asia","2024-09-18",0,1,973,0,0,973,0,0
"Asia","2024-09-19",0,0,973,0,1,974,0,0
"Asia","2024-09-20",0,0,973,0,0,974,0,0
"Asia","2024-09-21",0,0,973,0,1,975,0,0
"Asia","2024-09-22",0,0,973,0,0,975,0,0
"Asia","2024-09-23",0,3,976,0,1,976,0,0
"Asia","2024-09-24",0,0,976,0,5,981,0,0
"Asia","2024-09-25",0,0,976,0,5,986,0,0
"Asia","2024-09-26",0,15,991,0,5,991,0,0
"Asia","2024-09-27",0,0,991,0,2,993,0,0
"Asia","2024-09-28",0,0,991,0,2,995,0,0
"Asia","2024-09-29",0,6,997,0,2,997,0,0
"Asia","2024-09-30",0,20,1017,0,20,1017,0,0
"Asia","2024-10-01",0,6,1023,0,6,1023,0,0
"Asia","2024-10-02",0,1,1024,0,1,1024,0,0
"Asia","2024-10-03",0,1,1025,0,1,1025,0,0
"Asia","2024-10-04",0,1,1026,0,1,1026,0,0
"Asia","2024-10-05",0,0,1026,0,0,1026,0,0
"Asia","2024-10-06",0,0,1026,0,1,1027,0,0
"Asia","2024-10-07",0,0,1026,0,0,1027,0,0
"Asia","2024-10-08",0,0,1026,0,0,1027,0,0
"Asia","2024-10-09",0,0,1026,0,1,1028,0,0
"Asia","2024-10-10",0,2,1028,0,0,1028,0,0
"Asia","2024-10-11",0,2,1030,0,2,1030,0,0
"Asia","2024-10-12",0,0,1030,0,0,1030,0,0
"Asia","2024-10-13",0,0,1030,0,1,1031,0,0
"Asia","2024-10-14",0,0,1030,0,0,1031,0,0
"Asia","2024-10-15",0,0,1030,0,0,1031,0,0
"Asia","2024-10-16",0,0,1030,0,0,1031,0,0
"Asia","2024-10-17",0,0,1030,0,1,1032,0,0
"Asia","2024-10-18",0,2,1032,0,0,1032,0,0
"Asia","2024-10-19",0,0,1032,0,15,1047,0,0
"Asia","2024-10-20",0,0,1032,0,16,1063,0,0
"Asia","2024-10-21",0,46,1078,0,15,1078,0,0
"Asia","2024-10-22",0,0,1078,0,1,1079,0,0
"Asia","2024-10-23",0,2,1080,0,1,1080,0,0
"Asia","2024-10-24",0,0,1080,0,1,1081,0,0
"Asia","2024-10-25",0,0,1080,0,0,1081,0,0
"Asia","2024-10-26",0,0,1080,0,1,1082,0,0
"Asia","2024-10-27",0,0,1080,0,1,1083,0,0
"Asia","2024-10-28",0,0,1080,0,0,1083,0,0
"Asia","2024-10-29",0,4,1084,0,1,1084,0,0
"Asia","2024-10-30",0,1,1085,0,1,1085,0,0
"Asia","2024-10-31",0,14,1099,0,14,1099,0,0
"Asia","2024-11-01",0,2,1101,0,2,1101,0,0
"Asia","2024-11-02",0,0,1101,0,1,1102,0,0
"Asia","2024-11-03",0,0,1101,0,0,1102,0,0
"Asia","2024-11-04",0,0,1101,0,1,1103,0,0
"Asia","2024-11-05",0,0,1101,0,0,1103,0,0
"Asia","2024-11-06",0,3,1104,0,1,1104,0,0
"Asia","2024-11-07",0,0,1104,0,0,1104,0,0
"Asia","2024-11-08",0,0,1104,0,0,1104,0,0
"Asia","2024-11-09",0,0,1104,0,0,1104,0,0
"Asia","2024-11-10",0,0,1104,0,0,1104,0,0
"Asia","2024-11-11",0,0,1104,0,0,1104,0,0
"Asia","2024-11-12",0,0,1104,0,0,1104,0,0
"Asia","2024-11-13",0,0,1104,0,0,1104,0,0
"Asia","2024-11-14",0,0,1104,0,0,1104,0,0
"Asia","2024-11-15",0,0,1104,0,0,1104,0,0
"Asia","2024-11-16",0,0,1104,0,0,1104,0,0
"Asia","2024-11-17",0,0,1104,0,0,1104,0,0
"Asia","2024-11-18",0,0,1104,0,0,1104,0,0
"Asia","2024-11-19",0,0,1104,0,0,1104,0,0
"Asia","2024-11-20",0,0,1104,0,0,1104,0,0
"Asia","2024-11-21",0,0,1104,0,0,1104,0,0
"Asia","2024-11-22",0,0,1104,0,0,1104,0,0
"Asia","2024-11-23",0,0,1104,0,0,1104,0,0
"Asia","2024-11-24",0,0,1104,0,0,1104,0,0
"Asia","2024-11-25",0,0,1104,0,0,1104,0,0
"Asia","2024-11-26",0,0,1104,0,0,1104,0,0
"Asia","2024-11-27",0,0,1104,0,0,1104,0,0
"Asia","2024-11-28",0,0,1104,0,0,1104,0,0
"Asia","2024-11-29",0,0,1104,0,0,1104,0,0
"Asia","2024-11-30",0,0,1104,0,0,1104,0,0
"Asia","2024-12-01",0,0,1104,0,0,1104,0,0
"Asia","2024-12-02",0,0,1104,0,0,1104,0,0
"Asia","2024-12-03",0,0,1104,0,0,1104,0,0
"Asia","2024-12-04",0,0,1104,0,0,1104,0,0
"Asia","2024-12-05",0,0,1104,0,0,1104,0,0
"Asia","2024-12-06",0,0,1104,0,0,1104,0,0
"Asia","2024-12-07",0,0,1104,0,0,1104,0,0
"Asia","2024-12-08",0,0,1104,0,0,1104,0,0
"Asia","2024-12-09",0,0,1104,0,0,1104,0,0
"Australia","2024-01-01",0,0,0,0,0,0,0,0
"Australia","2024-01-02",0,0,0,0,0,0,0,0
"Australia","2024-01-03",0,0,0,0,0,0,0,0
"Australia","2024-01-04",0,0,0,0,0,0,0,0
"Australia","2024-01-05",0,0,0,0,0,0,0,0
"Australia","2024-01-06",0,0,0,0,0,0,0,0
"Australia","2024-01-07",0,0,0,0,0,0,0,0
"Australia","2024-01-08",0,0,0,0,0,0,0,0
"Australia","2024-01-09",0,0,0,0,0,0,0,0
"Australia","2024-01-10",0,0,0,0,0,0,0,0
"Australia","2024-01-11",0,0,0,0,0,0,0,0
"Australia","2024-01-12",0,0,0,0,0,0,0,0
"Australia","2024-01-13",0,0,0,0,0,0,0,0
"Australia","2024-01-14",0,0,0,0,0,0,0,0
"Australia","2024-01-15",0,0,0,0,0,0,0,0
"Australia","2024-01-16",0,0,0,0,0,0,0,0
"Australia","2024-01-17",0,0,0,0,0,0,0,0
"Australia","2024-01-18",0,0,0,0,0,0,0,0
"Australia","2024-01-19",0,0,0,0,0,0,0,0
"Australia","2024-01-20",0,0,0,0,0,0,0,0
"Australia","2024-01-21",0,0,0,0,0,0,0,0
"Australia","2024-01-22",0,0,0,0,0,0,0,0
"Australia","2024-01-23",0,0,0,0,0,0,0,0
"Australia","2024-01-24",0,0,0,0,0,0,0,0
"Australia","2024-01-25",0,0,0,0,0,0,0,0
"Australia","2024-01-26",0,0,0,0,0,0,0,0
"Australia","2024-01-27",0,0,0,0,0,0,0,0
"Australia","2024-01-28",0,0,0,0,0,0,0,0
"Australia","2024-01-29",0,0,0,0,0,0,0,0
"Australia","2024-01-30",0,0,0,0,0,0,0,0
"Australia","2024-01-31",0,6,6,0,6,6,0,0
"Australia","2024-02-01",0,0,6,0,0,6,0,0
"Australia","2024-02-02",0,0,6,0,0,6,0,0
"Australia","2024-02-03",0,0,6,0,0,6,0,0
"Australia","2024-02-04",0,0,6,0,0,6,0,0
"Australia","2024-02-05",0,0,6,0,0,6,0,0
"Australia","2024-02-06",0,0,6,0,0,6,0,0
"Australia","2024-02-07",0,0,6,0,0,6,0,0
"Australia","2024-02-08",0,0,6,0,0,6,0,0
"Australia","2024-02-09",0,0,6,0,0,6,0,0
"Australia","2024-02-10",0,0,6,0,1,7,0,0
"Australia","2024-02-11",0,0,6,0,0,7,0,0
"Australia","2024-02-12",0,0,6,0,0,7,0,0
"Australia","2024-02-13",0,0,6,0,0,7,0,0
"Australia","2024-02-14",0,0,6,0,0,7,0,0
"Australia","2024-02-15",0,0,6,0,0,7,0,0
"Australia","2024-02-16",0,0,6,0,0,7,0,0
"Australia","2024-02-17",0,0,6,0,0,7,0,0
"Australia","2024-02-18",0,0,6,0,0,7,0,0
"Australia","2024-02-19",0,0,6,0,0,7,0,0
"Australia","2024-02-20",0,0,6,0,0,7,0,0
"Australia","2024-02-21",0,0,6,0,0,7,0,0
"Australia","2024-02-22",0,0,6,0,0,7,0,0
"Australia","2024-02-23",0,0,6,0,0,7,0,0
"Australia","2024-02-24",0,0,6,0,0,7,0,0
"Australia","2024-02-25",0,0,6,0,0,7,0,0
"Australia","2024-02-26",0,0,6,0,0,7,0,0
"Australia","2024-02-27",0,0,6,0,1,8,0,0
"Australia","2024-02-28",0,0,6,0,0,8,0,0
"Australia","2024-02-29",0,0,6,0,0,8,0,0
"Australia","2024-03-01",0,0,6,0,0,8,0,0
"Australia","2024-03-02",0,0,6,0,0,8,0,0
"Australia","2024-03-03",0,0,6,0,0,8,0,0
"Australia","2024-03-04",0,0,6,0,0,8,0,0
"Australia","2024-03-05",0,0,6,0,0,8,0,0
"Australia","2024-03-06",0,0,6,0,0,8,0,0
"Australia","2024-03-07",0,0,6,0,0,8,0,0
"Australia","2024-03-08",0,0,6,0,0,8,0,0
"Australia","2024-03-09",0,0,6,0,0,8,0,0
"Australia","2024-03-10",0,0,6,0,0,8,0,0
"Australia","2024-03-11",0,0,6,0,0,8,0,0
"Australia","2024-03-12",0,0,6,0,0,8,0,0
"Australia","2024-03-13",0,0,6,0,0,8,0,0
"Australia","2024-03-14",0,0,6,0,0,8,0,0
"Australia","2024-03-15",0,0,6,0,0,8,0,0
"Australia","2024-03-16",0,0,6,0,0,8,0,0
"Australia","2024-03-17",0,0,6,0,1,9,0,0
"Australia","2024-03-18",0,0,6,0,0,9,0,0
"Australia","2024-03-19",0,0,6,0,0,9,0,0
"Australia","2024-03-20",0,0,6,0,0,9,0,0
"Australia","2024-03-21",0,0,6,0,0,9,0,0
"Australia","2024-03-22",0,0,6,0,0,9,0,0
"Australia","2024-03-23",0,0,6,0,0,9,0,0
"Australia","2024-03-24",0,0,6,0,0,9,0,0
"Australia","2024-03-25",0,0,6,0,0,9,0,0
"Australia","2024-03-26",0,0,6,0,0,9,0,0
"Australia","2024-03-27",0,0,6,0,0,9,0,0
"Australia","2024-03-28",0,0,6,0,0,9,0,0
"Australia","2024-03-29",0,0,6,0,0,9,0,0
"Australia","2024-03-30",0,0,6,0,0,9,0,0
"Australia","2024-03-31",0,0,6,0,0,9,0,0
"Australia","2024-04-01",0,0,6,0,0,9,0,0
"Australia","2024-04-02",0,0,6,0,0,9,0,0
"Australia","2024-04-03",0,0,6,0,1,10,0,0
"Australia","2024-04-04",0,0,6,0,0,10,0,0
"Australia","2024-04-05",0,0,6,0,0,10,0,0
"Australia","2024-04-06",0,0,6,0,0,10,0,0
"Australia","2024-04-07",0,0,6,0,0,10,0,0
"Australia","2024-04-08",0,0,6,0,0,10,0,0
"Australia","2024-04-09",0,0,6,0,0,10,0,0
"Australia","2024-04-10",0,0,6,0,0,10,0,0
"Australia","2024-04-11",0,0,6,0,0,10,0,0
"Australia","2024-04-12",0,0,6,0,0,10,0,0
"Australia","2024-04-13",0,0,6,0,0,10,0,0
"Australia","2024-04-14",0,0,6,0,0,10,0,0
"Australia","2024-04-15",0,0,6,0,0,10,0,0
"Australia","2024-04-16",0,0,6,0,0,10,0,0
"Australia","2024-04-17",0,0,6,0,0,10,0,0
"Australia","2024-04-18",0,0,6,0,0,10,0,0
"Australia","2024-04-19",0,0,6,0,0,10,0,0
"Australia","2024-04-20",0,0,6,0,0,10,0,0
"Australia","2024-04-21",0,0,6,0,0,10,0,0
"Australia","2024-04-22",0,0,6,0,1,11,0,0
"Australia","2024-04-23",0,0,6,0,0,11,0,0
"Australia","2024-04-24",0,0,6,0,0,11,0,0
"Australia","2024-04-25",0,0,6,0,0,11,0,0
"Australia","2024-04-26",0,0,6,0,0,11,0,0
"Australia","2024-04-27",0,0,6,0,0,11,0,0
"Australia","2024-04-28",0,0,6,0,0,11,0,0
"Australia","2024-04-29",0,0,6,0,0,11,0,0
"Australia","2024-04-30",0,5,11,0,0,11,0,0
"Australia","2024-05-01",0,0,11,0,1,12,0,0
"Australia","2024-05-02",0,0,11,0,1,13,0,0
"Australia","2024-05-03",0,0,11,0,1,14,0,0
"Australia","2024-05-04",0,0,11,0,1,15,0,0
"Australia","2024-05-05",0,0,11,0,1,16,0,0
"Australia","2024-05-06",0,0,11,0,1,17,0,0
"Australia","2024-05-07",0,0,11,0,1,18,0,0
"Australia","2024-05-08",0,0,11,0,2,20,0,0
"Australia","2024-05-09",0,0,11,0,1,21,0,0
"Australia","2024-05-10",0,0,11,0,1,22,0,0
"Australia","2024-05-11",0,0,11,0,1,23,0,0
"Australia","2024-05-12",0,0,11,0,1,24,0,0
"Australia","2024-05-13",0,0,11,0,1,25,0,0
"Australia","2024-05-14",0,0,11,0,1,26,0,0
"Australia","2024-05-15",0,0,11,0,1,27,0,0
"Australia","2024-05-16",0,0,11,0,1,28,0,0
"Australia","2024-05-17",0,0,11,0,1,29,0,0
"Australia","2024-05-18",0,0,11,0,1,30,0,0
"Australia","2024-05-19",0,0,11,0,1,31,0,0
"Australia","2024-05-20",0,0,11,0,1,32,0,0
"Australia","2024-05-21",0,0,11,0,1,33,0,0
"Australia","2024-05-22",0,0,11,0,1,34,0,0
"Australia","2024-05-23",0,0,11,0,1,35,0,0
"Australia","2024-05-24",0,0,11,0,2,37,0,0
"Australia","2024-05-25",0,0,11,0,1,38,0,0
"Australia","2024-05-26",0,0,11,0,1,39,0,0
"Australia","2024-05-27",0,0,11,0,1,40,0,0
"Australia","2024-05-28",0,0,11,0,1,41,0,0
"Australia","2024-05-29",0,0,11,0,1,42,0,0
"Australia","2024-05-30",0,0,11,0,1,43,0,0
"Australia","2024-05-31",0,33,44,0,1,44,0,0
"Australia","2024-06-01",0,0,44,0,2,46,0,0
"Australia","2024-06-02",0,0,44,0,2,48,0,0
"Australia","2024-06-03",0,0,44,0,2,50,0,0
"Australia","2024-06-04",0,0,44,0,3,53,0,0
"Australia","2024-06-05",0,0,44,0,2,55,0,0
"Australia","2024-06-06",0,0,44,0,2,57,0,0
"Australia","2024-06-07",0,0,44,0,2,59,0,0
"Australia","2024-06-08",0,0,44,0,2,61,0,0
"Australia","2024-06-09",0,0,44,0,2,63,0,0
"Australia","2024-06-10",0,0,44,0,2,65,0,0
"Australia","2024-06-11",0,0,44,0,2,67,0,0
"Australia","2024-06-12",0,0,44,0,3,70,0,0
"Australia","2024-06-13",0,0,44,0,2,72,0,0
"Australia","2024-06-14",0,0,44,0,2,74,0,0
"Australia","2024-06-15",0,0,44,0,2,76,0,0
"Australia","2024-06-16",0,0,44,0,2,78,0,0
"Australia","2024-06-17",0,0,44,0,2,80,0,0
"Australia","2024-06-18",0,0,44,0,2,82,0,0
"Australia","2024-06-19",0,0,44,0,3,85,0,0
"Australia","2024-06-20",0,0,44,0,2,87,0,0
"Australia","2024-06-21",0,0,44,0,2,89,0,0
"Australia","2024-06-22",0,0,44,0,2,91,0,0
"Australia","2024-06-23",0,0,44,0,2,93,0,0
"Australia","2024-06-24",0,0,44,0,2,95,0,0
"Australia","2024-06-25",0,0,44,0,2,97,0,0
"Australia","2024-06-26",0,0,44,0,2,99,0,0
"Australia","2024-06-27",0,0,44,0,3,102,0,0
"Australia","2024-06-28",0,0,44,0,2,104,0,0
"Australia","2024-06-29",0,0,44,0,2,106,0,0
"Australia","2024-06-30",0,64,108,0,2,108,0,0
"Australia","2024-07-01",0,0,108,0,1,109,0,0
"Australia","2024-07-02",0,0,108,0,1,110,0,0
"Australia","2024-07-03",0,0,108,0,1,111,0,0
"Australia","2024-07-04",0,0,108,0,1,112,0,0
"Australia","2024-07-05",0,0,108,0,1,113,0,0
"Australia","2024-07-06",0,0,108,0,1,114,0,0
"Australia","2024-07-07",0,0,108,0,1,115,0,0
"Australia","2024-07-08",0,0,108,0,0,115,0,0
"Australia","2024-07-09",0,0,108,0,1,116,0,0
"Australia","2024-07-10",0,0,108,0,1,117,0,0
"Australia","2024-07-11",0,0,108,0,1,118,0,0
"Australia","2024-07-12",0,0,108,0,1,119,0,0
"Australia","2024-07-13",0,0,108,0,1,120,0,0
"Australia","2024-07-14",0,0,108,0,1,121,0,0
"Australia","2024-07-15",0,14,122,0,1,122,0,0
"Australia","2024-07-16",0,0,122,0,3,125,0,0
"Australia","2024-07-17",0,0,122,0,3,128,0,0
"Australia","2024-07-18",0,0,122,0,3,131,0,0
"Australia","2024-07-19",0,0,122,0,3,134,0,0
"Australia","2024-07-20",0,0,122,0,3,137,0,0
"Australia","2024-07-21",0,0,122,0,3,140,0,0
"Australia","2024-07-22",0,21,143,0,3,143,0,0
"Australia","2024-07-23",0,0,143,0,4,147,0,0
"Australia","2024-07-24",0,0,143,0,4,151,0,0
"Australia","2024-07-25",0,0,143,0,5,156,0,0
"Australia","2024-07-26",0,0,143,0,4,160,0,0
"Australia","2024-07-27",0,21,164,0,4,164,0,0
"Australia","2024-07-28",0,0,164,0,11,175,0,0
"Australia","2024-07-29",0,0,164,0,10,185,0,0
"Australia","2024-07-30",0,32,196,0,11,196,0,0
"Australia","2024-07-31",0,13,209,0,13,209,0,0
"Australia","2024-08-01",0,0,209,0,4,213,0,0
"Australia","2024-08-02",0,0,209,0,3,216,0,0
"Australia","2024-08-03",0,0,209,0,4,220,0,0
"Australia","2024-08-04",0,0,209,0,3,223,0,0
"Australia","2024-08-05",0,0,209,0,4,227,0,0
"Australia","2024-08-06",0,0,209,0,3,230,0,0
"Australia","2024-08-07",0,0,209,0,4,234,0,0
"Australia","2024-08-08",0,0,209,0,3,237,0,0
"Australia","2024-08-09",0,0,209,0,4,241,0,0
"Australia","2024-08-10",0,0,209,0,3,244,0,0
"Australia","2024-08-11",0,0,209,0,4,248,0,0
"Australia","2024-08-12",0,0,209,0,3,251,0,0
"Australia","2024-08-13",0,0,209,0,4,255,0,0
"Australia","2024-08-14",0,0,209,0,3,258,0,0
"Australia","2024-08-15",0,0,209,0,4,262,0,0
"Australia","2024-08-16",0,0,209,0,3,265,0,0
"Australia","2024-08-17",0,0,209,0,4,269,0,0
"Australia","2024-08-18",0,0,209,0,3,272,0,0
"Australia","2024-08-19",0,0,209,0,4,276,0,0
"Australia","2024-08-20",0,0,209,0,3,279,0,0
"Australia","2024-08-21",0,74,283,0,4,283,0,0
"Australia","2024-08-22",0,0,283,0,9,292,0,0
"Australia","2024-08-23",0,0,283,0,9,301,0,0
"Australia","2024-08-24",0,0,283,0,8,309,0,0
"Australia","2024-08-25",0,0,283,0,9,318,0,0
"Australia","2024-08-26",0,0,283,0,9,327,0,0
"Australia","2024-08-27",0,0,283,0,8,335,0,0
"Australia","2024-08-28",0,0,283,0,9,344,0,0
"Australia","2024-08-29",0,70,353,0,9,353,0,0
"Australia","2024-08-30",0,0,353,0,50,403,0,0
"Australia","2024-08-31",0,101,454,0,51,454,0,0
"Australia","2024-09-01",0,0,454,0,4,458,0,0
"Australia","2024-09-02",0,0,454,0,5,463,0,0
"Australia","2024-09-03",0,0,454,0,4,467,0,0
"Australia","2024-09-04",0,0,454,0,5,472,0,0
"Australia","2024-09-05",0,0,454,0,4,476,0,0
"Australia","2024-09-06",0,0,454,0,4,480,0,0
"Australia","2024-09-07",0,0,454,0,5,485,0,0
"Australia","2024-09-08",0,35,489,0,4,489,0,0
"Australia","2024-09-09",0,0,489,0,12,501,0,0
"Australia","2024-09-10",0,0,489,0,12,513,0,0
"Australia","2024-09-11",0,0,489,0,12,525,0,0
"Australia","2024-09-12",0,0,489,0,12,537,0,0
"Australia","2024-09-13",0,0,489,0,12,549,0,0
"Australia","2024-09-14",0,0,489,0,12,561,0,0
"Australia","2024-09-15",0,84,573,0,12,573,0,0
"Australia","2024-09-16",0,0,573,0,13,586,0,0
"Australia","2024-09-17",0,0,573,0,13,599,0,0
"Australia","2024-09-18",0,0,573,0,13,612,0,0
"Australia","2024-09-19",0,0,573,0,14,626,0,0
"Australia","2024-09-20",0,0,573,0,13,639,0,0
"Australia","2024-09-21",0,0,573,0,13,652,0,0
"Australia","2024-09-22",0,92,665,0,13,665,0,0
"Australia","2024-09-23",0,0,665,0,13,678,0,0
"Australia","2024-09-24",0,0,665,0,13,691,0,0
"Australia","2024-09-25",0,0,665,0,13,704,0,0
"Australia","2024-09-26",0,0,665,0,13,717,0,0
"Australia","2024-09-27",0,0,665,0,13,730,0,0
"Australia","2024-09-28",0,0,665,0,13,743,0,0
"Australia","2024-09-29",0,91,756,0,13,756,0,0
"Australia","2024-09-30",0,0,756,0,10,766,0,0
"Australia","2024-10-01",0,0,756,0,11,777,0,0
"Australia","2024-10-02",0,0,756,0,10,787,0,0
"Australia","2024-10-03",0,0,756,0,10,797,0,0
"Australia","2024-10-04",0,0,756,0,10,807,0,0
"Australia","2024-10-05",0,0,756,0,11,818,0,0
"Australia","2024-10-06",0,72,828,0,10,828,0,0
"Australia","2024-10-07",0,23,851,0,23,851,0,0
"Australia","2024-10-08",0,0,851,0,9,860,0,0
"Australia","2024-10-09",0,0,851,0,9,869,0,0
"Australia","2024-10-10",0,0,851,0,9,878,0,0
"Australia","2024-10-11",0,0,851,0,9,887,0,0
"Australia","2024-10-12",0,0,851,0,9,896,0,0
"Australia","2024-10-13",0,54,905,0,9,905,0,0
"Australia","2024-10-14",0,0,905,0,11,916,0,0
"Australia","2024-10-15",0,0,905,0,12,928,0,0
"Australia","2024-10-16",0,0,905,0,11,939,0,0
"Australia","2024-10-17",0,0,905,0,11,950,0,0
"Australia","2024-10-18",0,0,905,0,11,961,0,0
"Australia","2024-10-19",0,0,905,0,12,973,0,0
"Australia","2024-10-20",0,79,984,0,11,984,0,0
"Australia","2024-10-21",0,0,984,0,10,994,0,0
"Australia","2024-10-22",0,0,984,0,9,1003,0,0
"Australia","2024-10-23",0,0,984,0,10,1013,0,0
"Australia","2024-10-24",0,0,984,0,10,1023,0,0
"Australia","2024-10-25",0,0,984,0,10,1033,0,0
"Australia","2024-10-26",0,0,984,0,9,1042,0,0
"Australia","2024-10-27",0,68,1052,0,10,1052,0,0
"Australia","2024-10-28",0,0,1052,0,11,1063,0,0
"Australia","2024-10-29",0,0,1052,0,12,1075,0,0
"Australia","2024-10-30",0,0,1052,0,11,1086,0,0
"Australia","2024-10-31",0,0,1052,0,11,1097,0,0
"Australia","2024-11-01",0,0,1052,0,11,1108,0,0
"Australia","2024-11-02",0,0,1052,0,12,1120,0,0
"Australia","2024-11-03",0,79,1131,0,11,1131,0,0
"Australia","2024-11-04",0,0,1131,0,8,1139,0,0
"Australia","2024-11-05",0,0,1131,0,8,1147,0,0
"Australia","2024-11-06",0,0,1131,0,8,1155,0,0
"Australia","2024-11-07",0,0,1131,0,9,1164,0,0
"Australia","2024-11-08",0,0,1131,0,8,1172,0,0
"Australia","2024-11-09",0,0,1131,0,8,1180,0,0
"Australia","2024-11-10",0,57,1188,0,8,1188,0,0
"Australia","2024-11-11",0,0,1188,0,0,1188,0,0
"Australia","2024-11-12",0,0,1188,0,0,1188,0,0
"Australia","2024-11-13",0,0,1188,0,0,1188,0,0
"Australia","2024-11-14",0,0,1188,0,0,1188,0,0
"Australia","2024-11-15",0,0,1188,0,0,1188,0,0
"Australia","2024-11-16",0,0,1188,0,0,1188,0,0
"Australia","2024-11-17",0,0,1188,0,0,1188,0,0
"Australia","2024-11-18",0,0,1188,0,0,1188,0,0
"Australia","2024-11-19",0,0,1188,0,0,1188,0,0
"Australia","2024-11-20",0,0,1188,0,0,1188,0,0
"Australia","2024-11-21",0,0,1188,0,0,1188,0,0
"Australia","2024-11-22",0,0,1188,0,0,1188,0,0
"Australia","2024-11-23",0,0,1188,0,0,1188,0,0
"Australia","2024-11-24",0,0,1188,0,0,1188,0,0
"Australia","2024-11-25",0,0,1188,0,0,1188,0,0
"Australia","2024-11-26",0,0,1188,0,0,1188,0,0
"Australia","2024-11-27",0,0,1188,0,0,1188,0,0
"Australia","2024-11-28",0,0,1188,0,0,1188,0,0
"Australia","2024-11-29",0,0,1188,0,0,1188,0,0
"Australia","2024-11-30",0,0,1188,0,0,1188,0,0
"Australia","2024-12-01",0,0,1188,0,0,1188,0,0
"Australia","2024-12-02",0,0,1188,0,0,1188,0,0
"Australia","2024-12-03",0,0,1188,0,0,1188,0,0
"Australia","2024-12-04",0,0,1188,0,0,1188,0,0
"Australia","2024-12-05",0,0,1188,0,0,1188,0,0
"Australia","2024-12-06",0,0,1188,0,0,1188,0,0
"Australia","2024-12-07",0,0,1188,0,0,1188,0,0
"Australia","2024-12-08",0,0,1188,0,0,1188,0,0
"Australia","2024-12-09",0,0,1188,0,0,1188,0,0
"Austria","2024-01-01",0,0,0,0,0,0,0,0
"Austria","2024-01-02",0,0,0,0,0,0,0,0
"Austria","2024-01-03",0,0,0,0,0,0,0,0
"Austria","2024-01-04",0,0,0,0,0,0,0,0
"Austria","2024-01-05",0,0,0,0,0,0,0,0
"Austria","2024-01-06",0,0,0,0,0,0,0,0
"Austria","2024-01-07",0,0,0,0,0,0,0,0
"Austria","2024-01-08",0,0,0,0,0,0,0,0
"Austria","2024-01-09",0,0,0,0,0,0,0,0
"Austria","2024-01-10",0,0,0,0,0,0,0,0
"Austria","2024-01-11",0,0,0,0,0,0,0,0
"Austria","2024-01-12",0,0,0,0,0,0,0,0
"Austria","2024-01-13",0,0,0,0,0,0,0,0
"Austria","2024-01-14",0,0,0,0,0,0,0,0
"Austria","2024-01-15",0,0,0,0,0,0,0,0
"Austria","2024-01-16",0,0,0,0,0,0,0,0
"Austria","2024-01-17",0,0,0,0,0,0,0,0
"Austria","2024-01-18",0,0,0,0,0,0,0,0
"Austria","2024-01-19",0,0,0,0,0,0,0,0
"Austria","2024-01-20",0,0,0,0,0,0,0,0
"Austria","2024-01-21",0,0,0,0,0,0,0,0
"Austria","2024-01-22",0,0,0,0,0,0,0,0
"Austria","2024-01-23",0,0,0,0,0,0,0,0
"Austria","2024-01-24",0,0,0,0,0,0,0,0
"Austria","2024-01-25",0,0,0,0,0,0,0,0
"Austria","2024-01-26",0,0,0,0,0,0,0,0
"Austria","2024-01-27",0,0,0,0,0,0,0,0
"Austria","2024-01-28",0,0,0,0,0,0,0,0
"Austria","2024-01-29",0,0,0,0,0,0,0,0
"Austria","2024-01-30",0,0,0,0,0,0,0,0
"Austria","2024-01-31",0,3,3,0,3,3,0,0
"Austria","2024-02-01",0,0,3,0,0,3,0,0
"Austria","2024-02-02",0,0,3,0,0,3,0,0
"Austria","2024-02-03",0,0,3,0,0,3,0,0
"Austria","2024-02-04",0,0,3,0,1,4,0,0
"Austria","2024-02-05",0,0,3,0,0,4,0,0
"Austria","2024-02-06",0,0,3,0,0,4,0,0
"Austria","2024-02-07",0,0,3,0,0,4,0,0
"Austria","2024-02-08",0,0,3,0,0,4,0,0
"Austria","2024-02-09",0,0,3,0,0,4,0,0
"Austria","2024-02-10",0,0,3,0,0,4,0,0
"Austria","2024-02-11",0,0,3,0,1,5,0,0
"Austria","2024-02-12",0,0,3,0,0,5,0,0
"Austria","2024-02-13",0,0,3,0,0,5,0,0
"Austria","2024-02-14",0,0,3,0,0,5,0,0
"Austria","2024-02-15",0,0,3,0,0,5,0,0
"Austria","2024-02-16",0,0,3,0,0,5,0,0
"Austria","2024-02-17",0,0,3,0,0,5,0,0
"Austria","2024-02-18",0,0,3,0,0,5,0,0
"Austria","2024-02-19",0,0,3,0,1,6,0,0
"Austria","2024-02-20",0,0,3,0,0,6,0,0
"Austria","2024-02-21",0,0,3,0,0,6,0,0
"Austria","2024-02-22",0,0,3,0,0,6,0,0
"Austria","2024-02-23",0,0,3,0,0,6,0,0
"Austria","2024-02-24",0,0,3,0,0,6,0,0
"Austria","2024-02-25",0,0,3,0,0,6,0,0
"Austria","2024-02-26",0,0,3,0,1,7,0,0
"Austria","2024-02-27",0,0,3,0,0,7,0,0
"Austria","2024-02-28",0,0,3,0,0,7,0,0
"Austria","2024-02-29",0,4,7,0,0,7,0,0
"Austria","2024-03-01",0,0,7,0,0,7,0,0
"Austria","2024-03-02",0,0,7,0,0,7,0,0
"Austria","2024-03-03",0,0,7,0,0,7,0,0
"Austria","2024-03-04",0,0,7,0,0,7,0,0
"Austria","2024-03-05",0,0,7,0,0,7,0,0
"Austria","2024-03-06",0,0,7,0,0,7,0,0
"Austria","2024-03-07",0,0,7,0,0,7,0,0
"Austria","2024-03-08",0,0,7,0,0,7,0,0
"Austria","2024-03-09",0,0,7,0,0,7,0,0
"Austria","2024-03-10",0,0,7,0,0,7,0,0
"Austria","2024-03-11",0,0,7,0,0,7,0,0
"Austria","2024-03-12",0,0,7,0,0,7,0,0
"Austria","2024-03-13",0,0,7,0,0,7,0,0
"Austria","2024-03-14",0,0,7,0,0,7,0,0
"Austria","2024-03-15",0,0,7,0,0,7,0,0
"Austria","2024-03-16",0,0,7,0,0,7,0,0
"Austria","2024-03-17",0,0,7,0,0,7,0,0
"Austria","2024-03-18",0,0,7,0,0,7,0,0
"Austria","2024-03-19",0,0,7,0,0,7,0,0
"Austria","2024-03-20",0,0,7,0,0,7,0,0
"Austria","2024-03-21",0,0,7,0,0,7,0,0
"Austria","2024-03-22",0,0,7,0,0,7,0,0
"Austria","2024-03-23",0,0,7,0,0,7,0,0
"Austria","2024-03-24",0,0,7,0,0,7,0,0
"Austria","2024-03-25",0,0,7,0,0,7,0,0
"Austria","2024-03-26",0,0,7,0,0,7,0,0
"Austria","2024-03-27",0,0,7,0,0,7,0,0
"Austria","2024-03-28",0,0,7,0,0,7,0,0
"Austria","2024-03-29",0,0,7,0,0,7,0,0
"Austria","2024-03-30",0,0,7,0,0,7,0,0
"Austria","2024-03-31",0,0,7,0,1,8,0,0
"Austria","2024-04-01",0,0,7,0,0,8,0,0
"Austria","2024-04-02",0,0,7,0,0,8,0,0
"Austria","2024-04-03",0,0,7,0,0,8,0,0
"Austria","2024-04-04",0,0,7,0,0,8,0,0
"Austria","2024-04-05",0,0,7,0,0,8,0,0
"Austria","2024-04-06",0,0,7,0,0,8,0,0
"Austria","2024-04-07",0,0,7,0,0,8,0,0
"Austria","2024-04-08",0,0,7,0,0,8,0,0
"Austria","2024-04-09",0,0,7,0,0,8,0,0
"Austria","2024-04-10",0,0,7,0,0,8,0,0
"Austria","2024-04-11",0,0,7,0,0,8,0,0
"Austria","2024-04-12",0,0,7,0,0,8,0,0
"Austria","2024-04-13",0,0,7,0,0,8,0,0
"Austria","2024-04-14",0,0,7,0,0,8,0,0
"Austria","2024-04-15",0,0,7,0,0,8,0,0
"Austria","2024-04-16",0,0,7,0,0,8,0,0
"Austria","2024-04-17",0,0,7,0,0,8,0,0
"Austria","2024-04-18",0,0,7,0,0,8,0,0
"Austria","2024-04-19",0,0,7,0,0,8,0,0
"Austria","2024-04-20",0,0,7,0,0,8,0,0
"Austria","2024-04-21",0,0,7,0,0,8,0,0
"Austria","2024-04-22",0,0,7,0,0,8,0,0
"Austria","2024-04-23",0,0,7,0,0,8,0,0
"Austria","2024-04-24",0,0,7,0,0,8,0,0
"Austria","2024-04-25",0,0,7,0,0,8,0,0
"Austria","2024-04-26",0,0,7,0,0,8,0,0
"Austria","2024-04-27",0,0,7,0,0,8,0,0
"Austria","2024-04-28",0,0,7,0,0,8,0,0
"Austria","2024-04-29",0,0,7,0,0,8,0,0
"Austria","2024-04-30",0,1,8,0,0,8,0,0
"Austria","2024-05-01",0,0,8,0,0,8,0,0
"Austria","2024-05-02",0,0,8,0,0,8,0,0
"Austria","2024-05-03",0,0,8,0,0,8,0,0
"Austria","2024-05-04",0,0,8,0,0,8,0,0
"Austria","2024-05-05",0,0,8,0,0,8,0,0
"Austria","2024-05-06",0,0,8,0,0,8,0,0
"Austria","2024-05-07",0,0,8,0,0,8,0,0
"Austria","2024-05-08",0,0,8,0,1,9,0,0
"Austria","2024-05-09",0,0,8,0,0,9,0,0
"Austria","2024-05-10",0,0,8,0,0,9,0,0
"Austria","2024-05-11",0,0,8,0,0,9,0,0
"Austria","2024-05-12",0,0,8,0,0,9,0,0
"Austria","2024-05-13",0,0,8,0,0,9,0,0
"Austria","2024-05-14",0,0,8,0,0,9,0,0
"Austria","2024-05-15",0,0,8,0,0,9,0,0
"Austria","2024-05-16",0,0,8,0,0,9,0,0
"Austria","2024-05-17",0,0,8,0,0,9,0,0
"Austria","2024-05-18",0,0,8,0,0,9,0,0
"Austria","2024-05-19",0,0,8,0,0,9,0,0
"Austria","2024-05-20",0,0,8,0,0,9,0,0
"Austria","2024-05-21",0,0,8,0,0,9,0,0
"Austria","2024-05-22",0,0,8,0,0,9,0,0
"Austria","2024-05-23",0,0,8,0,0,9,0,0
"Austria","2024-05-24",0,0,8,0,1,10,0,0
"Austria","2024-05-25",0,0,8,0,0,10,0,0
"Austria","2024-05-26",0,0,8,0,0,10,0,0
"Austria","2024-05-27",0,0,8,0,0,10,0,0
"Austria","2024-05-28",0,0,8,0,0,10,0,0
"Austria","2024-05-29",0,0,8,0,0,10,0,0
"Austria","2024-05-30",0,0,8,0,0,10,0,0
"Austria","2024-05-31",0,2,10,0,0,10,0,0
"Austria","2024-06-01",0,0,10,0,0,10,0,0
"Austria","2024-06-02",0,0,10,0,0,10,0,0
"Austria","2024-06-03",0,0,10,0,0,10,0,0
"Austria","2024-06-04",0,0,10,0,0,10,0,0
"Austria","2024-06-05",0,0,10,0,0,10,0,0
"Austria","2024-06-06",0,0,10,0,0,10,0,0
"Austria","2024-06-07",0,0,10,0,0,10,0,0
"Austria","2024-06-08",0,0,10,0,0,10,0,0
"Austria","2024-06-09",0,0,10,0,0,10,0,0
"Austria","2024-06-10",0,0,10,0,0,10,0,0
"Austria","2024-06-11",0,0,10,0,0,10,0,0
"Austria","2024-06-12",0,0,10,0,0,10,0,0
"Austria","2024-06-13",0,0,10,0,0,10,0,0
"Austria","2024-06-14",0,0,10,0,0,10,0,0
"Austria","2024-06-15",0,0,10,0,0,10,0,0
"Austria","2024-06-16",0,0,10,0,0,10,0,0
"Austria","2024-06-17",0,0,10,0,0,10,0,0
"Austria","2024-06-18",0,0,10,0,0,10,0,0
"Austria","2024-06-19",0,0,10,0,0,10,0,0
"Austria","2024-06-20",0,0,10,0,0,10,0,0
"Austria","2024-06-21",0,0,10,0,0,10,0,0
"Austria","2024-06-22",0,0,10,0,0,10,0,0
"Austria","2024-06-23",0,0,10,0,0,10,0,0
"Austria","2024-06-24",0,0,10,0,1,11,0,0
"Austria","2024-06-25",0,0,10,0,0,11,0,0
"Austria","2024-06-26",0,0,10,0,0,11,0,0
"Austria","2024-06-27",0,0,10,0,0,11,0,0
"Austria","2024-06-28",0,0,10,0,0,11,0,0
"Austria","2024-06-29",0,0,10,0,0,11,0,0
"Austria","2024-06-30",0,0,10,0,0,11,0,0
"Austria","2024-07-01",0,0,10,0,0,11,0,0
"Austria","2024-07-02",0,0,10,0,0,11,0,0
"Austria","2024-07-03",0,0,10,0,0,11,0,0
"Austria","2024-07-04",0,0,10,0,0,11,0,0
"Austria","2024-07-05",0,0,10,0,0,11,0,0
"Austria","2024-07-06",0,0,10,0,0,11,0,0
"Austria","2024-07-07",0,0,10,0,0,11,0,0
"Austria","2024-07-08",0,0,10,0,0,11,0,0
"Austria","2024-07-09",0,0,10,0,0,11,0,0
"Austria","2024-07-10",0,0,10,0,0,11,0,0
"Austria","2024-07-11",0,0,10,0,0,11,0,0
"Austria","2024-07-12",0,0,10,0,0,11,0,0
"Austria","2024-07-13",0,0,10,0,0,11,0,0
"Austria","2024-07-14",0,0,10,0,0,11,0,0
"Austria","2024-07-15",0,0,10,0,0,11,0,0
"Austria","2024-07-16",0,0,10,0,0,11,0,0
"Austria","2024-07-17",0,0,10,0,0,11,0,0
"Austria","2024-07-18",0,0,10,0,0,11,0,0
"Austria","2024-07-19",0,0,10,0,0,11,0,0
"Austria","2024-07-20",0,0,10,0,0,11,0,0
"Austria","2024-07-21",0,0,10,0,0,11,0,0
"Austria","2024-07-22",0,0,10,0,0,11,0,0
"Austria","2024-07-23",0,0,10,0,0,11,0,0
"Austria","2024-07-24",0,0,10,0,0,11,0,0
"Austria","2024-07-25",0,0,10,0,0,11,0,0
"Austria","2024-07-26",0,0,10,0,0,11,0,0
"Austria","2024-07-27",0,0,10,0,0,11,0,0
"Austria","2024-07-28",0,0,10,0,0,11,0,0
"Austria","2024-07-29",0,0,10,0,0,11,0,0
"Austria","2024-07-30",0,0,10,0,0,11,0,0
"Austria","2024-07-31",0,0,10,0,0,11,0,0
"Austria","2024-08-01",0,0,10,0,0,11,0,0
"Austria","2024-08-02",0,0,10,0,0,11,0,0
"Austria","2024-08-03",0,0,10,0,0,11,0,0
"Austria","2024-08-04",0,0,10,0,0,11,0,0
"Austria","2024-08-05",0,0,10,0,0,11,0,0
"Austria","2024-08-06",0,0,10,0,0,11,0,0
"Austria","2024-08-07",0,0,10,0,0,11,0,0
"Austria","2024-08-08",0,0,10,0,1,12,0,0
"Austria","2024-08-09",0,0,10,0,0,12,0,0
"Austria","2024-08-10",0,0,10,0,0,12,0,0
"Austria","2024-08-11",0,0,10,0,0,12,0,0
"Austria","2024-08-12",0,0,10,0,0,12,0,0
"Austria","2024-08-13",0,0,10,0,0,12,0,0
"Austria","2024-08-14",0,0,10,0,0,12,0,0
"Austria","2024-08-15",0,0,10,0,0,12,0,0
"Austria","2024-08-16",0,0,10,0,0,12,0,0
"Austria","2024-08-17",0,0,10,0,0,12,0,0
"Austria","2024-08-18",0,0,10,0,0,12,0,0
"Austria","2024-08-19",0,0,10,0,0,12,0,0
"Austria","2024-08-20",0,0,10,0,0,12,0,0
"Austria","2024-08-21",0,0,10,0,0,12,0,0
"Austria","2024-08-22",0,0,10,0,0,12,0,0
"Austria","2024-08-23",0,0,10,0,0,12,0,0
"Austria","2024-08-24",0,0,10,0,0,12,0,0
"Austria","2024-08-25",0,0,10,0,0,12,0,0
"Austria","2024-08-26",0,0,10,0,0,12,0,0
"Austria","2024-08-27",0,0,10,0,0,12,0,0
"Austria","2024-08-28",0,0,10,0,0,12,0,0
"Austria","2024-08-29",0,0,10,0,0,12,0,0
"Austria","2024-08-30",0,0,10,0,0,12,0,0
"Austria","2024-08-31",0,2,12,0,0,12,0,0
"Austria","2024-09-01",0,0,12,0,0,12,0,0
"Austria","2024-09-02",0,0,12,0,0,12,0,0
"Austria","2024-09-03",0,0,12,0,0,12,0,0
"Austria","2024-09-04",0,0,12,0,0,12,0,0
"Austria","2024-09-05",0,0,12,0,0,12,0,0
"Austria","2024-09-06",0,0,12,0,1,13,0,0
"Austria","2024-09-07",0,0,12,0,0,13,0,0
"Austria","2024-09-08",0,0,12,0,0,13,0,0
"Austria","2024-09-09",0,0,12,0,0,13,0,0
"Austria","2024-09-10",0,0,12,0,0,13,0,0
"Austria","2024-09-11",0,0,12,0,0,13,0,0
"Austria","2024-09-12",0,0,12,0,0,13,0,0
"Austria","2024-09-13",0,0,12,0,0,13,0,0
"Austria","2024-09-14",0,0,12,0,0,13,0,0
"Austria","2024-09-15",0,0,12,0,1,14,0,0
"Austria","2024-09-16",0,0,12,0,0,14,0,0
"Austria","2024-09-17",0,0,12,0,0,14,0,0
"Austria","2024-09-18",0,0,12,0,0,14,0,0
"Austria","2024-09-19",0,0,12,0,0,14,0,0
"Austria","2024-09-20",0,0,12,0,0,14,0,0
"Austria","2024-09-21",0,0,12,0,0,14,0,0
"Austria","2024-09-22",0,0,12,0,0,14,0,0
"Austria","2024-09-23",0,0,12,0,0,14,0,0
"Austria","2024-09-24",0,0,12,0,0,14,0,0
"Austria","2024-09-25",0,0,12,0,0,14,0,0
"Austria","2024-09-26",0,0,12,0,1,15,0,0
"Austria","2024-09-27",0,0,12,0,0,15,0,0
"Austria","2024-09-28",0,0,12,0,0,15,0,0
"Austria","2024-09-29",0,0,12,0,0,15,0,0
"Austria","2024-09-30",0,3,15,0,0,15,0,0
"Austria","2024-10-01",0,0,15,0,0,15,0,0
"Austria","2024-10-02",0,0,15,0,0,15,0,0
"Austria","2024-10-03",0,0,15,0,0,15,0,0
"Austria","2024-10-04",0,0,15,0,0,15,0,0
"Austria","2024-10-05",0,0,15,0,0,15,0,0
"Austria","2024-10-06",0,0,15,0,1,16,0,0
"Austria","2024-10-07",0,0,15,0,0,16,0,0
"Austria","2024-10-08",0,0,15,0,0,16,0,0
"Austria","2024-10-09",0,0,15,0,0,16,0,0
"Austria","2024-10-10",0,0,15,0,0,16,0,0
"Austria","2024-10-11",0,0,15,0,0,16,0,0
"Austria","2024-10-12",0,0,15,0,0,16,0,0
"Austria","2024-10-13",0,0,15,0,0,16,0,0
"Austria","2024-10-14",0,0,15,0,0,16,0,0
"Austria","2024-10-15",0,0,15,0,0,16,0,0
"Austria","2024-10-16",0,0,15,0,1,17,0,0
"Austria","2024-10-17",0,0,15,0,0,17,0,0
"Austria","2024-10-18",0,0,15,0,0,17,0,0
"Austria","2024-10-19",0,0,15,0,0,17,0,0
"Austria","2024-10-20",0,0,15,0,0,17,0,0
"Austria","2024-10-21",0,0,15,0,0,17,0,0
"Austria","2024-10-22",0,0,15,0,0,17,0,0
"Austria","2024-10-23",0,0,15,0,0,17,0,0
"Austria","2024-10-24",0,0,15,0,0,17,0,0
"Austria","2024-10-25",0,0,15,0,0,17,0,0
"Austria","2024-10-26",0,0,15,0,1,18,0,0
"Austria","2024-10-27",0,0,15,0,0,18,0,0
"Austria","2024-10-28",0,0,15,0,0,18,0,0
"Austria","2024-10-29",0,0,15,0,0,18,0,0
"Austria","2024-10-30",0,0,15,0,0,18,0,0
"Austria","2024-10-31",0,3,18,0,0,18,0,0
"Austria","2024-11-01",0,0,18,0,0,18,0,0
"Austria","2024-11-02",0,0,18,0,0,18,0,0
"Austria","2024-11-03",0,0,18,0,0,18,0,0
"Austria","2024-11-04",0,0,18,0,0,18,0,0
"Austria","2024-11-05",0,0,18,0,0,18,0,0
"Austria","2024-11-06",0,0,18,0,0,18,0,0
"Austria","2024-11-07",0,0,18,0,0,18,0,0
"Austria","2024-11-08",0,0,18,0,0,18,0,0
"Austria","2024-11-09",0,0,18,0,0,18,0,0
"Austria","2024-11-10",0,0,18,0,0,18,0,0
"Austria","2024-11-11",0,0,18,0,0,18,0,0
"Austria","2024-11-12",0,0,18,0,0,18,0,0
"Austria","2024-11-13",0,0,18,0,0,18,0,0
"Austria","2024-11-14",0,0,18,0,0,18,0,0
"Austria","2024-11-15",0,0,18,0,0,18,0,0
"Austria","2024-11-16",0,0,18,0,0,18,0,0
"Austria","2024-11-17",0,0,18,0,0,18,0,0
"Austria","2024-11-18",0,0,18,0,0,18,0,0
"Austria","2024-11-19",0,0,18,0,0,18,0,0
"Austria","2024-11-20",0,0,18,0,0,18,0,0
"Austria","2024-11-21",0,0,18,0,0,18,0,0
"Austria","2024-11-22",0,0,18,0,0,18,0,0
"Austria","2024-11-23",0,0,18,0,0,18,0,0
"Austria","2024-11-24",0,0,18,0,0,18,0,0
"Austria","2024-11-25",0,0,18,0,0,18,0,0
"Austria","2024-11-26",0,0,18,0,0,18,0,0
"Austria","2024-11-27",0,0,18,0,0,18,0,0
"Austria","2024-11-28",0,0,18,0,0,18,0,0
"Austria","2024-11-29",0,0,18,0,0,18,0,0
"Austria","2024-11-30",0,0,18,0,0,18,0,0
"Austria","2024-12-01",0,0,18,0,0,18,0,0
"Austria","2024-12-02",0,0,18,0,0,18,0,0
"Austria","2024-12-03",0,0,18,0,0,18,0,0
"Austria","2024-12-04",0,0,18,0,0,18,0,0
"Austria","2024-12-05",0,0,18,0,0,18,0,0
"Austria","2024-12-06",0,0,18,0,0,18,0,0
"Austria","2024-12-07",0,0,18,0,0,18,0,0
"Austria","2024-12-08",0,0,18,0,0,18,0,0
"Austria","2024-12-09",0,0,18,0,0,18,0,0
"Bahamas","2024-01-01",0,0,0,0,0,0,0,0
"Bahamas","2024-01-02",0,0,0,0,0,0,0,0
"Bahamas","2024-01-03",0,0,0,0,0,0,0,0
"Bahamas","2024-01-04",0,0,0,0,0,0,0,0
"Bahamas","2024-01-05",0,0,0,0,0,0,0,0
"Bahamas","2024-01-06",0,0,0,0,0,0,0,0
"Bahamas","2024-01-07",0,0,0,0,0,0,0,0
"Bahamas","2024-01-08",0,0,0,0,0,0,0,0
"Bahamas","2024-01-09",0,0,0,0,0,0,0,0
"Bahamas","2024-01-10",0,0,0,0,0,0,0,0
"Bahamas","2024-01-11",0,0,0,0,0,0,0,0
"Bahamas","2024-01-12",0,0,0,0,0,0,0,0
"Bahamas","2024-01-13",0,0,0,0,0,0,0,0
"Bahamas","2024-01-14",0,0,0,0,0,0,0,0
"Bahamas","2024-01-15",0,0,0,0,0,0,0,0
"Bahamas","2024-01-16",0,0,0,0,0,0,0,0
"Bahamas","2024-01-17",0,0,0,0,0,0,0,0
"Bahamas","2024-01-18",0,0,0,0,0,0,0,0
"Bahamas","2024-01-19",0,0,0,0,0,0,0,0
"Bahamas","2024-01-20",0,0,0,0,0,0,0,0
"Bahamas","2024-01-21",0,0,0,0,0,0,0,0
"Bahamas","2024-01-22",0,0,0,0,0,0,0,0
"Bahamas","2024-01-23",0,0,0,0,0,0,0,0
"Bahamas","2024-01-24",0,0,0,0,0,0,0,0
"Bahamas","2024-01-25",0,0,0,0,0,0,0,0
"Bahamas","2024-01-26",0,0,0,0,0,0,0,0
"Bahamas","2024-01-27",0,0,0,0,0,0,0,0
"Bahamas","2024-01-28",0,0,0,0,0,0,0,0
"Bahamas","2024-01-29",0,0,0,0,0,0,0,0
"Bahamas","2024-01-30",0,0,0,0,0,0,0,0
"Bahamas","2024-01-31",0,0,0,0,0,0,0,0
"Bahamas","2024-02-01",0,0,0,0,0,0,0,0
"Bahamas","2024-02-02",0,0,0,0,0,0,0,0
"Bahamas","2024-02-03",0,0,0,0,0,0,0,0
"Bahamas","2024-02-04",0,0,0,0,0,0,0,0
"Bahamas","2024-02-05",0,0,0,0,0,0,0,0
"Bahamas","2024-02-06",0,0,0,0,0,0,0,0
"Bahamas","2024-02-07",0,0,0,0,0,0,0,0
"Bahamas","2024-02-08",0,0,0,0,0,0,0,0
"Bahamas","2024-02-09",0,0,0,0,0,0,0,0
"Bahamas","2024-02-10",0,0,0,0,0,0,0,0
"Bahamas","2024-02-11",0,0,0,0,0,0,0,0
"Bahamas","2024-02-12",0,0,0,0,0,0,0,0
"Bahamas","2024-02-13",0,0,0,0,0,0,0,0
"Bahamas","2024-02-14",0,0,0,0,0,0,0,0
"Bahamas","2024-02-15",0,0,0,0,0,0,0,0
"Bahamas","2024-02-16",0,0,0,0,0,0,0,0
"Bahamas","2024-02-17",0,0,0,0,0,0,0,0
"Bahamas","2024-02-18",0,0,0,0,0,0,0,0
"Bahamas","2024-02-19",0,0,0,0,0,0,0,0
"Bahamas","2024-02-20",0,0,0,0,0,0,0,0
"Bahamas","2024-02-21",0,0,0,0,0,0,0,0
"Bahamas","2024-02-22",0,0,0,0,0,0,0,0
"Bahamas","2024-02-23",0,0,0,0,0,0,0,0
"Bahamas","2024-02-24",0,0,0,0,0,0,0,0
"Bahamas","2024-02-25",0,0,0,0,0,0,0,0
"Bahamas","2024-02-26",0,0,0,0,0,0,0,0
"Bahamas","2024-02-27",0,0,0,0,0,0,0,0
"Bahamas","2024-02-28",0,0,0,0,0,0,0,0
"Bahamas","2024-02-29",0,0,0,0,0,0,0,0
"Bahamas","2024-03-01",0,0,0,0,0,0,0,0
"Bahamas","2024-03-02",0,0,0,0,0,0,0,0
"Bahamas","2024-03-03",0,0,0,0,0,0,0,0
"Bahamas","2024-03-04",0,0,0,0,0,0,0,0
"Bahamas","2024-03-05",0,0,0,0,0,0,0,0
"Bahamas","2024-03-06",0,0,0,0,0,0,0,0
"Bahamas","2024-03-07",0,0,0,0,0,0,0,0
"Bahamas","2024-03-08",0,0,0,0,0,0,0,0
"Bahamas","2024-03-09",0,0,0,0,0,0,0,0
"Bahamas","2024-03-10",0,0,0,0,0,0,0,0
"Bahamas","2024-03-11",0,0,0,0,0,0,0,0
"Bahamas","2024-03-12",0,0,0,0,0,0,0,0
"Bahamas","2024-03-13",0,0,0,0,0,0,0,0
"Bahamas","2024-03-14",0,0,0,0,0,0,0,0
"Bahamas","2024-03-15",0,0,0,0,0,0,0,0
"Bahamas","2024-03-16",0,0,0,0,0,0,0,0
"Bahamas","2024-03-17",0,0,0,0,0,0,0,0
"Bahamas","2024-03-18",0,0,0,0,0,0,0,0
"Bahamas","2024-03-19",0,0,0,0,0,0,0,0
"Bahamas","2024-03-20",0,0,0,0,0,0,0,0
"Bahamas","2024-03-21",0,0,0,0,0,0,0,0
"Bahamas","2024-03-22",0,0,0,0,0,0,0,0
"Bahamas","2024-03-23",0,0,0,0,0,0,0,0
"Bahamas","2024-03-24",0,0,0,0,0,0,0,0
"Bahamas","2024-03-25",0,0,0,0,0,0,0,0
"Bahamas","2024-03-26",0,0,0,0,0,0,0,0
"Bahamas","2024-03-27",0,0,0,0,0,0,0,0
"Bahamas","2024-03-28",0,0,0,0,0,0,0,0
"Bahamas","2024-03-29",0,0,0,0,0,0,0,0
"Bahamas","2024-03-30",0,0,0,0,0,0,0,0
"Bahamas","2024-03-31",0,0,0,0,0,0,0,0
"Bahamas","2024-04-01",0,0,0,0,0,0,0,0
"Bahamas","2024-04-02",0,0,0,0,0,0,0,0
"Bahamas","2024-04-03",0,0,0,0,0,0,0,0
"Bahamas","2024-04-04",0,0,0,0,0,0,0,0
"Bahamas","2024-04-05",0,0,0,0,0,0,0,0
"Bahamas","2024-04-06",0,0,0,0,0,0,0,0
"Bahamas","2024-04-07",0,0,0,0,0,0,0,0
"Bahamas","2024-04-08",0,0,0,0,0,0,0,0
"Bahamas","2024-04-09",0,0,0,0,0,0,0,0
"Bahamas","2024-04-10",0,0,0,0,0,0,0,0
"Bahamas","2024-04-11",0,0,0,0,0,0,0,0
"Bahamas","2024-04-12",0,0,0,0,0,0,0,0
"Bahamas","2024-04-13",0,0,0,0,0,0,0,0
"Bahamas","2024-04-14",0,0,0,0,0,0,0,0
"Bahamas","2024-04-15",0,0,0,0,0,0,0,0
"Bahamas","2024-04-16",0,0,0,0,0,0,0,0
"Bahamas","2024-04-17",0,0,0,0,0,0,0,0
"Bahamas","2024-04-18",0,0,0,0,0,0,0,0
"Bahamas","2024-04-19",0,0,0,0,0,0,0,0
"Bahamas","2024-04-20",0,0,0,0,0,0,0,0
"Bahamas","2024-04-21",0,0,0,0,0,0,0,0
"Bahamas","2024-04-22",0,0,0,0,0,0,0,0
"Bahamas","2024-04-23",0,0,0,0,0,0,0,0
"Bahamas","2024-04-24",0,0,0,0,0,0,0,0
"Bahamas","2024-04-25",0,0,0,0,0,0,0,0
"Bahamas","2024-04-26",0,0,0,0,0,0,0,0
"Bahamas","2024-04-27",0,0,0,0,0,0,0,0
"Bahamas","2024-04-28",0,0,0,0,0,0,0,0
"Bahamas","2024-04-29",0,0,0,0,0,0,0,0
"Bahamas","2024-04-30",0,0,0,0,0,0,0,0
"Bahamas","2024-05-01",0,0,0,0,0,0,0,0
"Bahamas","2024-05-02",0,0,0,0,0,0,0,0
"Bahamas","2024-05-03",0,0,0,0,0,0,0,0
"Bahamas","2024-05-04",0,0,0,0,0,0,0,0
"Bahamas","2024-05-05",0,0,0,0,0,0,0,0
"Bahamas","2024-05-06",0,0,0,0,0,0,0,0
"Bahamas","2024-05-07",0,0,0,0,0,0,0,0
"Bahamas","2024-05-08",0,0,0,0,0,0,0,0
"Bahamas","2024-05-09",0,0,0,0,0,0,0,0
"Bahamas","2024-05-10",0,0,0,0,0,0,0,0
"Bahamas","2024-05-11",0,0,0,0,0,0,0,0
"Bahamas","2024-05-12",0,0,0,0,0,0,0,0
"Bahamas","2024-05-13",0,0,0,0,0,0,0,0
"Bahamas","2024-05-14",0,0,0,0,0,0,0,0
"Bahamas","2024-05-15",0,0,0,0,0,0,0,0
"Bahamas","2024-05-16",0,0,0,0,0,0,0,0
"Bahamas","2024-05-17",0,0,0,0,0,0,0,0
"Bahamas","2024-05-18",0,0,0,0,0,0,0,0
"Bahamas","2024-05-19",0,0,0,0,0,0,0,0
"Bahamas","2024-05-20",0,0,0,0,0,0,0,0
"Bahamas","2024-05-21",0,0,0,0,0,0,0,0
"Bahamas","2024-05-22",0,0,0,0,0,0,0,0
"Bahamas","2024-05-23",0,0,0,0,0,0,0,0
"Bahamas","2024-05-24",0,0,0,0,0,0,0,0
"Bahamas","2024-05-25",0,0,0,0,0,0,0,0
"Bahamas","2024-05-26",0,0,0,0,0,0,0,0
"Bahamas","2024-05-27",0,0,0,0,0,0,0,0
"Bahamas","2024-05-28",0,0,0,0,0,0,0,0
"Bahamas","2024-05-29",0,0,0,0,0,0,0,0
"Bahamas","2024-05-30",0,0,0,0,0,0,0,0
"Bahamas","2024-05-31",0,0,0,0,0,0,0,0
"Bahamas","2024-06-01",0,0,0,0,0,0,0,0
"Bahamas","2024-06-02",0,0,0,0,0,0,0,0
"Bahamas","2024-06-03",0,0,0,0,0,0,0,0
"Bahamas","2024-06-04",0,0,0,0,0,0,0,0
"Bahamas","2024-06-05",0,0,0,0,0,0,0,0
"Bahamas","2024-06-06",0,0,0,0,0,0,0,0
"Bahamas","2024-06-07",0,0,0,0,0,0,0,0
"Bahamas","2024-06-08",0,0,0,0,0,0,0,0
"Bahamas","2024-06-09",0,0,0,0,0,0,0,0
"Bahamas","2024-06-10",0,0,0,0,0,0,0,0
"Bahamas","2024-06-11",0,0,0,0,0,0,0,0
"Bahamas","2024-06-12",0,0,0,0,0,0,0,0
"Bahamas","2024-06-13",0,0,0,0,0,0,0,0
"Bahamas","2024-06-14",0,0,0,0,0,0,0,0
"Bahamas","2024-06-15",0,0,0,0,0,0,0,0
"Bahamas","2024-06-16",0,0,0,0,0,0,0,0
"Bahamas","2024-06-17",0,0,0,0,0,0,0,0
"Bahamas","2024-06-18",0,0,0,0,0,0,0,0
"Bahamas","2024-06-19",0,0,0,0,0,0,0,0
"Bahamas","2024-06-20",0,0,0,0,0,0,0,0
"Bahamas","2024-06-21",0,0,0,0,0,0,0,0
"Bahamas","2024-06-22",0,0,0,0,0,0,0,0
"Bahamas","2024-06-23",0,0,0,0,0,0,0,0
"Bahamas","2024-06-24",0,0,0,0,0,0,0,0
"Bahamas","2024-06-25",0,0,0,0,0,0,0,0
"Bahamas","2024-06-26",0,0,0,0,0,0,0,0
"Bahamas","2024-06-27",0,0,0,0,0,0,0,0
"Bahamas","2024-06-28",0,0,0,0,0,0,0,0
"Bahamas","2024-06-29",0,0,0,0,0,0,0,0
"Bahamas","2024-06-30",0,0,0,0,0,0,0,0
"Bahamas","2024-07-01",0,0,0,0,0,0,0,0
"Bahamas","2024-07-02",0,0,0,0,0,0,0,0
"Bahamas","2024-07-03",0,0,0,0,0,0,0,0
"Bahamas","2024-07-04",0,0,0,0,0,0,0,0
"Bahamas","2024-07-05",0,0,0,0,0,0,0,0
"Bahamas","2024-07-06",0,0,0,0,0,0,0,0
"Bahamas","2024-07-07",0,0,0,0,0,0,0,0
"Bahamas","2024-07-08",0,0,0,0,0,0,0,0
"Bahamas","2024-07-09",0,0,0,0,0,0,0,0
"Bahamas","2024-07-10",0,0,0,0,0,0,0,0
"Bahamas","2024-07-11",0,0,0,0,0,0,0,0
"Bahamas","2024-07-12",0,0,0,0,0,0,0,0
"Bahamas","2024-07-13",0,0,0,0,0,0,0,0
"Bahamas","2024-07-14",0,0,0,0,0,0,0,0
"Bahamas","2024-07-15",0,0,0,0,0,0,0,0
"Bahamas","2024-07-16",0,0,0,0,0,0,0,0
"Bahamas","2024-07-17",0,0,0,0,0,0,0,0
"Bahamas","2024-07-18",0,0,0,0,0,0,0,0
"Bahamas","2024-07-19",0,0,0,0,0,0,0,0
"Bahamas","2024-07-20",0,0,0,0,0,0,0,0
"Bahamas","2024-07-21",0,0,0,0,0,0,0,0
"Bahamas","2024-07-22",0,0,0,0,0,0,0,0
"Bahamas","2024-07-23",0,0,0,0,0,0,0,0
"Bahamas","2024-07-24",0,0,0,0,0,0,0,0
"Bahamas","2024-07-25",0,0,0,0,0,0,0,0
"Bahamas","2024-07-26",0,0,0,0,0,0,0,0
"Bahamas","2024-07-27",0,0,0,0,0,0,0,0
"Bahamas","2024-07-28",0,0,0,0,0,0,0,0
"Bahamas","2024-07-29",0,0,0,0,0,0,0,0
"Bahamas","2024-07-30",0,0,0,0,0,0,0,0
"Bahamas","2024-07-31",0,0,0,0,0,0,0,0
"Bahamas","2024-08-01",0,0,0,0,0,0,0,0
"Bahamas","2024-08-02",0,0,0,0,0,0,0,0
"Bahamas","2024-08-03",0,0,0,0,0,0,0,0
"Bahamas","2024-08-04",0,0,0,0,0,0,0,0
"Bahamas","2024-08-05",0,0,0,0,0,0,0,0
"Bahamas","2024-08-06",0,0,0,0,0,0,0,0
"Bahamas","2024-08-07",0,0,0,0,0,0,0,0
"Bahamas","2024-08-08",0,0,0,0,0,0,0,0
"Bahamas","2024-08-09",0,0,0,0,0,0,0,0
"Bahamas","2024-08-10",0,0,0,0,0,0,0,0
"Bahamas","2024-08-11",0,0,0,0,0,0,0,0
"Bahamas","2024-08-12",0,0,0,0,0,0,0,0
"Bahamas","2024-08-13",0,0,0,0,0,0,0,0
"Bahamas","2024-08-14",0,0,0,0,0,0,0,0
"Bahamas","2024-08-15",0,0,0,0,0,0,0,0
"Bahamas","2024-08-16",0,0,0,0,0,0,0,0
"Bahamas","2024-08-17",0,0,0,0,0,0,0,0
"Bahamas","2024-08-18",0,0,0,0,0,0,0,0
"Bahamas","2024-08-19",0,0,0,0,0,0,0,0
"Bahamas","2024-08-20",0,0,0,0,0,0,0,0
"Bahamas","2024-08-21",0,0,0,0,0,0,0,0
"Bahamas","2024-08-22",0,0,0,0,0,0,0,0
"Bahamas","2024-08-23",0,0,0,0,0,0,0,0
"Bahamas","2024-08-24",0,0,0,0,0,0,0,0
"Bahamas","2024-08-25",0,0,0,0,0,0,0,0
"Bahamas","2024-08-26",0,0,0,0,0,0,0,0
"Bahamas","2024-08-27",0,0,0,0,0,0,0,0
"Bahamas","2024-08-28",0,0,0,0,0,0,0,0
"Bahamas","2024-08-29",0,0,0,0,0,0,0,0
"Bahamas","2024-08-30",0,0,0,0,0,0,0,0
"Bahamas","2024-08-31",0,0,0,0,0,0,0,0
"Bahamas","2024-09-01",0,0,0,0,0,0,0,0
"Bahamas","2024-09-02",0,0,0,0,0,0,0,0
"Bahamas","2024-09-03",0,0,0,0,0,0,0,0
"Bahamas","2024-09-04",0,0,0,0,0,0,0,0
"Bahamas","2024-09-05",0,0,0,0,0,0,0,0
"Bahamas","2024-09-06",0,0,0,0,0,0,0,0
"Bahamas","2024-09-07",0,0,0,0,0,0,0,0
"Bahamas","2024-09-08",0,0,0,0,0,0,0,0
"Bahamas","2024-09-09",0,0,0,0,0,0,0,0
"Bahamas","2024-09-10",0,0,0,0,0,0,0,0
"Bahamas","2024-09-11",0,0,0,0,0,0,0,0
"Bahamas","2024-09-12",0,0,0,0,0,0,0,0
"Bahamas","2024-09-13",0,0,0,0,0,0,0,0
"Bahamas","2024-09-14",0,0,0,0,0,0,0,0
"Bahamas","2024-09-15",0,0,0,0,0,0,0,0
"Bahamas","2024-09-16",0,0,0,0,0,0,0,0
"Bahamas","2024-09-17",0,0,0,0,0,0,0,0
"Bahamas","2024-09-18",0,0,0,0,0,0,0,0
"Bahamas","2024-09-19",0,0,0,0,0,0,0,0
"Bahamas","2024-09-20",0,0,0,0,0,0,0,0
"Bahamas","2024-09-21",0,0,0,0,0,0,0,0
"Bahamas","2024-09-22",0,0,0,0,0,0,0,0
"Bahamas","2024-09-23",0,0,0,0,0,0,0,0
"Bahamas","2024-09-24",0,0,0,0,0,0,0,0
"Bahamas","2024-09-25",0,0,0,0,0,0,0,0
"Bahamas","2024-09-26",0,0,0,0,0,0,0,0
"Bahamas","2024-09-27",0,0,0,0,0,0,0,0
"Bahamas","2024-09-28",0,0,0,0,0,0,0,0
"Bahamas","2024-09-29",0,0,0,0,0,0,0,0
"Bahamas","2024-09-30",0,0,0,0,0,0,0,0
"Bahamas","2024-10-01",0,0,0,0,0,0,0,0
"Bahamas","2024-10-02",0,0,0,0,0,0,0,0
"Bahamas","2024-10-03",0,0,0,0,0,0,0,0
"Bahamas","2024-10-04",0,0,0,0,0,0,0,0
"Bahamas","2024-10-05",0,0,0,0,0,0,0,0
"Bahamas","2024-10-06",0,0,0,0,0,0,0,0
"Bahamas","2024-10-07",0,0,0,0,0,0,0,0
"Bahamas","2024-10-08",0,0,0,0,0,0,0,0
"Bahamas","2024-10-09",0,0,0,0,0,0,0,0
"Bahamas","2024-10-10",0,0,0,0,0,0,0,0
"Bahamas","2024-10-11",0,0,0,0,0,0,0,0
"Bahamas","2024-10-12",0,0,0,0,0,0,0,0
"Bahamas","2024-10-13",0,0,0,0,0,0,0,0
"Bahamas","2024-10-14",0,0,0,0,0,0,0,0
"Bahamas","2024-10-15",0,0,0,0,0,0,0,0
"Bahamas","2024-10-16",0,0,0,0,0,0,0,0
"Bahamas","2024-10-17",0,0,0,0,0,0,0,0
"Bahamas","2024-10-18",0,0,0,0,0,0,0,0
"Bahamas","2024-10-19",0,0,0,0,0,0,0,0
"Bahamas","2024-10-20",0,0,0,0,0,0,0,0
"Bahamas","2024-10-21",0,0,0,0,0,0,0,0
"Bahamas","2024-10-22",0,0,0,0,0,0,0,0
"Bahamas","2024-10-23",0,0,0,0,0,0,0,0
"Bahamas","2024-10-24",0,0,0,0,0,0,0,0
"Bahamas","2024-10-25",0,0,0,0,0,0,0,0
"Bahamas","2024-10-26",0,0,0,0,0,0,0,0
"Bahamas","2024-10-27",0,0,0,0,0,0,0,0
"Bahamas","2024-10-28",0,0,0,0,0,0,0,0
"Bahamas","2024-10-29",0,0,0,0,0,0,0,0
"Bahamas","2024-10-30",0,0,0,0,0,0,0,0
"Bahamas","2024-10-31",0,0,0,0,0,0,0,0
"Bahamas","2024-11-01",0,0,0,0,0,0,0,0
"Bahamas","2024-11-02",0,0,0,0,0,0,0,0
"Bahamas","2024-11-03",0,0,0,0,0,0,0,0
"Bahamas","2024-11-04",0,0,0,0,0,0,0,0
"Bahamas","2024-11-05",0,0,0,0,0,0,0,0
"Bahamas","2024-11-06",0,0,0,0,0,0,0,0
"Bahamas","2024-11-07",0,0,0,0,0,0,0,0
"Bahamas","2024-11-08",0,0,0,0,0,0,0,0
"Bahamas","2024-11-09",0,0,0,0,0,0,0,0
"Bahamas","2024-11-10",0,0,0,0,0,0,0,0
"Bahamas","2024-11-11",0,0,0,0,0,0,0,0
"Bahamas","2024-11-12",0,0,0,0,0,0,0,0
"Bahamas","2024-11-13",0,0,0,0,0,0,0,0
"Bahamas","2024-11-14",0,0,0,0,0,0,0,0
"Bahamas","2024-11-15",0,0,0,0,0,0,0,0
"Bahamas","2024-11-16",0,0,0,0,0,0,0,0
"Bahamas","2024-11-17",0,0,0,0,0,0,0,0
"Bahamas","2024-11-18",0,0,0,0,0,0,0,0
"Bahamas","2024-11-19",0,0,0,0,0,0,0,0
"Bahamas","2024-11-20",0,0,0,0,0,0,0,0
"Bahamas","2024-11-21",0,0,0,0,0,0,0,0
"Bahamas","2024-11-22",0,0,0,0,0,0,0,0
"Bahamas","2024-11-23",0,0,0,0,0,0,0,0
"Bahamas","2024-11-24",0,0,0,0,0,0,0,0
"Bahamas","2024-11-25",0,0,0,0,0,0,0,0
"Bahamas","2024-11-26",0,0,0,0,0,0,0,0
"Bahamas","2024-11-27",0,0,0,0,0,0,0,0
"Bahamas","2024-11-28",0,0,0,0,0,0,0,0
"Bahamas","2024-11-29",0,0,0,0,0,0,0,0
"Bahamas","2024-11-30",0,0,0,0,0,0,0,0
"Bahamas","2024-12-01",0,0,0,0,0,0,0,0
"Bahamas","2024-12-02",0,0,0,0,0,0,0,0
"Bahamas","2024-12-03",0,0,0,0,0,0,0,0
"Bahamas","2024-12-04",0,0,0,0,0,0,0,0
"Bahamas","2024-12-05",0,0,0,0,0,0,0,0
"Bahamas","2024-12-06",0,0,0,0,0,0,0,0
"Bahamas","2024-12-07",0,0,0,0,0,0,0,0
"Bahamas","2024-12-08",0,0,0,0,0,0,0,0
"Bahamas","2024-12-09",0,0,0,0,0,0,0,0
"Barbados","2024-01-01",0,0,0,0,0,0,0,0
"Barbados","2024-01-02",0,0,0,0,0,0,0,0
"Barbados","2024-01-03",0,0,0,0,0,0,0,0
"Barbados","2024-01-04",0,0,0,0,0,0,0,0
"Barbados","2024-01-05",0,0,0,0,0,0,0,0
"Barbados","2024-01-06",0,0,0,0,0,0,0,0
"Barbados","2024-01-07",0,0,0,0,0,0,0,0
"Barbados","2024-01-08",0,0,0,0,0,0,0,0
"Barbados","2024-01-09",0,0,0,0,0,0,0,0
"Barbados","2024-01-10",0,0,0,0,0,0,0,0
"Barbados","2024-01-11",0,0,0,0,0,0,0,0
"Barbados","2024-01-12",0,0,0,0,0,0,0,0
"Barbados","2024-01-13",0,0,0,0,0,0,0,0
"Barbados","2024-01-14",0,0,0,0,0,0,0,0
"Barbados","2024-01-15",0,0,0,0,0,0,0,0
"Barbados","2024-01-16",0,0,0,0,0,0,0,0
"Barbados","2024-01-17",0,0,0,0,0,0,0,0
"Barbados","2024-01-18",0,0,0,0,0,0,0,0
"Barbados","2024-01-19",0,0,0,0,0,0,0,0
"Barbados","2024-01-20",0,0,0,0,0,0,0,0
"Barbados","2024-01-21",0,0,0,0,0,0,0,0
"Barbados","2024-01-22",0,0,0,0,0,0,0,0
"Barbados","2024-01-23",0,0,0,0,0,0,0,0
"Barbados","2024-01-24",0,0,0,0,0,0,0,0
"Barbados","2024-01-25",0,0,0,0,0,0,0,0
"Barbados","2024-01-26",0,0,0,0,0,0,0,0
"Barbados","2024-01-27",0,0,0,0,0,0,0,0
"Barbados","2024-01-28",0,0,0,0,0,0,0,0
"Barbados","2024-01-29",0,0,0,0,0,0,0,0
"Barbados","2024-01-30",0,0,0,0,0,0,0,0
"Barbados","2024-01-31",0,0,0,0,0,0,0,0
"Barbados","2024-02-01",0,0,0,0,0,0,0,0
"Barbados","2024-02-02",0,0,0,0,0,0,0,0
"Barbados","2024-02-03",0,0,0,0,0,0,0,0
"Barbados","2024-02-04",0,0,0,0,0,0,0,0
"Barbados","2024-02-05",0,0,0,0,0,0,0,0
"Barbados","2024-02-06",0,0,0,0,0,0,0,0
"Barbados","2024-02-07",0,0,0,0,0,0,0,0
"Barbados","2024-02-08",0,0,0,0,0,0,0,0
"Barbados","2024-02-09",0,0,0,0,0,0,0,0
"Barbados","2024-02-10",0,0,0,0,0,0,0,0
"Barbados","2024-02-11",0,0,0,0,0,0,0,0
"Barbados","2024-02-12",0,0,0,0,0,0,0,0
"Barbados","2024-02-13",0,0,0,0,0,0,0,0
"Barbados","2024-02-14",0,0,0,0,0,0,0,0
"Barbados","2024-02-15",0,0,0,0,0,0,0,0
"Barbados","2024-02-16",0,0,0,0,0,0,0,0
"Barbados","2024-02-17",0,0,0,0,0,0,0,0
"Barbados","2024-02-18",0,0,0,0,0,0,0,0
"Barbados","2024-02-19",0,0,0,0,0,0,0,0
"Barbados","2024-02-20",0,0,0,0,0,0,0,0
"Barbados","2024-02-21",0,0,0,0,0,0,0,0
"Barbados","2024-02-22",0,0,0,0,0,0,0,0
"Barbados","2024-02-23",0,0,0,0,0,0,0,0
"Barbados","2024-02-24",0,0,0,0,0,0,0,0
"Barbados","2024-02-25",0,0,0,0,0,0,0,0
"Barbados","2024-02-26",0,0,0,0,0,0,0,0
"Barbados","2024-02-27",0,0,0,0,0,0,0,0
"Barbados","2024-02-28",0,0,0,0,0,0,0,0
"Barbados","2024-02-29",0,0,0,0,0,0,0,0
"Barbados","2024-03-01",0,0,0,0,0,0,0,0
"Barbados","2024-03-02",0,0,0,0,0,0,0,0
"Barbados","2024-03-03",0,0,0,0,0,0,0,0
"Barbados","2024-03-04",0,0,0,0,0,0,0,0
"Barbados","2024-03-05",0,0,0,0,0,0,0,0
"Barbados","2024-03-06",0,0,0,0,0,0,0,0
"Barbados","2024-03-07",0,0,0,0,0,0,0,0
"Barbados","2024-03-08",0,0,0,0,0,0,0,0
"Barbados","2024-03-09",0,0,0,0,0,0,0,0
"Barbados","2024-03-10",0,0,0,0,0,0,0,0
"Barbados","2024-03-11",0,0,0,0,0,0,0,0
"Barbados","2024-03-12",0,0,0,0,0,0,0,0
"Barbados","2024-03-13",0,0,0,0,0,0,0,0
"Barbados","2024-03-14",0,0,0,0,0,0,0,0
"Barbados","2024-03-15",0,0,0,0,0,0,0,0
"Barbados","2024-03-16",0,0,0,0,0,0,0,0
"Barbados","2024-03-17",0,0,0,0,0,0,0,0
"Barbados","2024-03-18",0,0,0,0,0,0,0,0
"Barbados","2024-03-19",0,0,0,0,0,0,0,0
"Barbados","2024-03-20",0,0,0,0,0,0,0,0
"Barbados","2024-03-21",0,0,0,0,0,0,0,0
"Barbados","2024-03-22",0,0,0,0,0,0,0,0
"Barbados","2024-03-23",0,0,0,0,0,0,0,0
"Barbados","2024-03-24",0,0,0,0,0,0,0,0
"Barbados","2024-03-25",0,0,0,0,0,0,0,0
"Barbados","2024-03-26",0,0,0,0,0,0,0,0
"Barbados","2024-03-27",0,0,0,0,0,0,0,0
"Barbados","2024-03-28",0,0,0,0,0,0,0,0
"Barbados","2024-03-29",0,0,0,0,0,0,0,0
"Barbados","2024-03-30",0,0,0,0,0,0,0,0
"Barbados","2024-03-31",0,0,0,0,0,0,0,0
"Barbados","2024-04-01",0,0,0,0,0,0,0,0
"Barbados","2024-04-02",0,0,0,0,0,0,0,0
"Barbados","2024-04-03",0,0,0,0,0,0,0,0
"Barbados","2024-04-04",0,0,0,0,0,0,0,0
"Barbados","2024-04-05",0,0,0,0,0,0,0,0
"Barbados","2024-04-06",0,0,0,0,0,0,0,0
"Barbados","2024-04-07",0,0,0,0,0,0,0,0
"Barbados","2024-04-08",0,0,0,0,0,0,0,0
"Barbados","2024-04-09",0,0,0,0,0,0,0,0
"Barbados","2024-04-10",0,0,0,0,0,0,0,0
"Barbados","2024-04-11",0,0,0,0,0,0,0,0
"Barbados","2024-04-12",0,0,0,0,0,0,0,0
"Barbados","2024-04-13",0,0,0,0,0,0,0,0
"Barbados","2024-04-14",0,0,0,0,0,0,0,0
"Barbados","2024-04-15",0,0,0,0,0,0,0,0
"Barbados","2024-04-16",0,0,0,0,0,0,0,0
"Barbados","2024-04-17",0,0,0,0,0,0,0,0
"Barbados","2024-04-18",0,0,0,0,0,0,0,0
"Barbados","2024-04-19",0,0,0,0,0,0,0,0
"Barbados","2024-04-20",0,0,0,0,0,0,0,0
"Barbados","2024-04-21",0,0,0,0,0,0,0,0
"Barbados","2024-04-22",0,0,0,0,0,0,0,0
"Barbados","2024-04-23",0,0,0,0,0,0,0,0
"Barbados","2024-04-24",0,0,0,0,0,0,0,0
"Barbados","2024-04-25",0,0,0,0,0,0,0,0
"Barbados","2024-04-26",0,0,0,0,0,0,0,0
"Barbados","2024-04-27",0,0,0,0,0,0,0,0
"Barbados","2024-04-28",0,0,0,0,0,0,0,0
"Barbados","2024-04-29",0,0,0,0,0,0,0,0
"Barbados","2024-04-30",0,0,0,0,0,0,0,0
"Barbados","2024-05-01",0,0,0,0,0,0,0,0
"Barbados","2024-05-02",0,0,0,0,0,0,0,0
"Barbados","2024-05-03",0,0,0,0,0,0,0,0
"Barbados","2024-05-04",0,0,0,0,0,0,0,0
"Barbados","2024-05-05",0,0,0,0,0,0,0,0
"Barbados","2024-05-06",0,0,0,0,0,0,0,0
"Barbados","2024-05-07",0,0,0,0,0,0,0,0
"Barbados","2024-05-08",0,0,0,0,0,0,0,0
"Barbados","2024-05-09",0,0,0,0,0,0,0,0
"Barbados","2024-05-10",0,0,0,0,0,0,0,0
"Barbados","2024-05-11",0,0,0,0,0,0,0,0
"Barbados","2024-05-12",0,0,0,0,0,0,0,0
"Barbados","2024-05-13",0,0,0,0,0,0,0,0
"Barbados","2024-05-14",0,0,0,0,0,0,0,0
"Barbados","2024-05-15",0,0,0,0,0,0,0,0
"Barbados","2024-05-16",0,0,0,0,0,0,0,0
"Barbados","2024-05-17",0,0,0,0,0,0,0,0
"Barbados","2024-05-18",0,0,0,0,0,0,0,0
"Barbados","2024-05-19",0,0,0,0,0,0,0,0
"Barbados","2024-05-20",0,0,0,0,0,0,0,0
"Barbados","2024-05-21",0,0,0,0,0,0,0,0
"Barbados","2024-05-22",0,0,0,0,0,0,0,0
"Barbados","2024-05-23",0,0,0,0,0,0,0,0
"Barbados","2024-05-24",0,0,0,0,0,0,0,0
"Barbados","2024-05-25",0,0,0,0,0,0,0,0
"Barbados","2024-05-26",0,0,0,0,0,0,0,0
"Barbados","2024-05-27",0,0,0,0,0,0,0,0
"Barbados","2024-05-28",0,0,0,0,0,0,0,0
"Barbados","2024-05-29",0,0,0,0,0,0,0,0
"Barbados","2024-05-30",0,0,0,0,0,0,0,0
"Barbados","2024-05-31",0,0,0,0,0,0,0,0
"Barbados","2024-06-01",0,0,0,0,0,0,0,0
"Barbados","2024-06-02",0,0,0,0,0,0,0,0
"Barbados","2024-06-03",0,0,0,0,0,0,0,0
"Barbados","2024-06-04",0,0,0,0,0,0,0,0
"Barbados","2024-06-05",0,0,0,0,0,0,0,0
"Barbados","2024-06-06",0,0,0,0,0,0,0,0
"Barbados","2024-06-07",0,0,0,0,0,0,0,0
"Barbados","2024-06-08",0,0,0,0,0,0,0,0
"Barbados","2024-06-09",0,0,0,0,0,0,0,0
"Barbados","2024-06-10",0,0,0,0,0,0,0,0
"Barbados","2024-06-11",0,0,0,0,0,0,0,0
"Barbados","2024-06-12",0,0,0,0,0,0,0,0
"Barbados","2024-06-13",0,0,0,0,0,0,0,0
"Barbados","2024-06-14",0,0,0,0,0,0,0,0
"Barbados","2024-06-15",0,0,0,0,0,0,0,0
"Barbados","2024-06-16",0,0,0,0,0,0,0,0
"Barbados","2024-06-17",0,0,0,0,0,0,0,0
"Barbados","2024-06-18",0,0,0,0,0,0,0,0
"Barbados","2024-06-19",0,0,0,0,0,0,0,0
"Barbados","2024-06-20",0,0,0,0,0,0,0,0
"Barbados","2024-06-21",0,0,0,0,0,0,0,0
"Barbados","2024-06-22",0,0,0,0,0,0,0,0
"Barbados","2024-06-23",0,0,0,0,0,0,0,0
"Barbados","2024-06-24",0,0,0,0,0,0,0,0
"Barbados","2024-06-25",0,0,0,0,0,0,0,0
"Barbados","2024-06-26",0,0,0,0,0,0,0,0
"Barbados","2024-06-27",0,0,0,0,0,0,0,0
"Barbados","2024-06-28",0,0,0,0,0,0,0,0
"Barbados","2024-06-29",0,0,0,0,0,0,0,0
"Barbados","2024-06-30",0,0,0,0,0,0,0,0
"Barbados","2024-07-01",0,0,0,0,0,0,0,0
"Barbados","2024-07-02",0,0,0,0,0,0,0,0
"Barbados","2024-07-03",0,0,0,0,0,0,0,0
"Barbados","2024-07-04",0,0,0,0,0,0,0,0
"Barbados","2024-07-05",0,0,0,0,0,0,0,0
"Barbados","2024-07-06",0,0,0,0,0,0,0,0
"Barbados","2024-07-07",0,0,0,0,0,0,0,0
"Barbados","2024-07-08",0,0,0,0,0,0,0,0
"Barbados","2024-07-09",0,0,0,0,0,0,0,0
"Barbados","2024-07-10",0,0,0,0,0,0,0,0
"Barbados","2024-07-11",0,0,0,0,0,0,0,0
"Barbados","2024-07-12",0,0,0,0,0,0,0,0
"Barbados","2024-07-13",0,0,0,0,0,0,0,0
"Barbados","2024-07-14",0,0,0,0,0,0,0,0
"Barbados","2024-07-15",0,0,0,0,0,0,0,0
"Barbados","2024-07-16",0,0,0,0,0,0,0,0
"Barbados","2024-07-17",0,0,0,0,0,0,0,0
"Barbados","2024-07-18",0,0,0,0,0,0,0,0
"Barbados","2024-07-19",0,0,0,0,0,0,0,0
"Barbados","2024-07-20",0,0,0,0,0,0,0,0
"Barbados","2024-07-21",0,0,0,0,0,0,0,0
"Barbados","2024-07-22",0,0,0,0,0,0,0,0
"Barbados","2024-07-23",0,0,0,0,0,0,0,0
"Barbados","2024-07-24",0,0,0,0,0,0,0,0
"Barbados","2024-07-25",0,0,0,0,0,0,0,0
"Barbados","2024-07-26",0,0,0,0,0,0,0,0
"Barbados","2024-07-27",0,0,0,0,0,0,0,0
"Barbados","2024-07-28",0,0,0,0,0,0,0,0
"Barbados","2024-07-29",0,0,0,0,0,0,0,0
"Barbados","2024-07-30",0,0,0,0,0,0,0,0
"Barbados","2024-07-31",0,0,0,0,0,0,0,0
"Barbados","2024-08-01",0,0,0,0,0,0,0,0
"Barbados","2024-08-02",0,0,0,0,0,0,0,0
"Barbados","2024-08-03",0,0,0,0,0,0,0,0
"Barbados","2024-08-04",0,0,0,0,0,0,0,0
"Barbados","2024-08-05",0,0,0,0,0,0,0,0
"Barbados","2024-08-06",0,0,0,0,0,0,0,0
"Barbados","2024-08-07",0,0,0,0,0,0,0,0
"Barbados","2024-08-08",0,0,0,0,0,0,0,0
"Barbados","2024-08-09",0,0,0,0,0,0,0,0
"Barbados","2024-08-10",0,0,0,0,0,0,0,0
"Barbados","2024-08-11",0,0,0,0,0,0,0,0
"Barbados","2024-08-12",0,0,0,0,0,0,0,0
"Barbados","2024-08-13",0,0,0,0,0,0,0,0
"Barbados","2024-08-14",0,0,0,0,0,0,0,0
"Barbados","2024-08-15",0,0,0,0,0,0,0,0
"Barbados","2024-08-16",0,0,0,0,0,0,0,0
"Barbados","2024-08-17",0,0,0,0,0,0,0,0
"Barbados","2024-08-18",0,0,0,0,0,0,0,0
"Barbados","2024-08-19",0,0,0,0,0,0,0,0
"Barbados","2024-08-20",0,0,0,0,0,0,0,0
"Barbados","2024-08-21",0,0,0,0,0,0,0,0
"Barbados","2024-08-22",0,0,0,0,0,0,0,0
"Barbados","2024-08-23",0,0,0,0,0,0,0,0
"Barbados","2024-08-24",0,0,0,0,0,0,0,0
"Barbados","2024-08-25",0,0,0,0,0,0,0,0
"Barbados","2024-08-26",0,0,0,0,0,0,0,0
"Barbados","2024-08-27",0,0,0,0,0,0,0,0
"Barbados","2024-08-28",0,0,0,0,0,0,0,0
"Barbados","2024-08-29",0,0,0,0,0,0,0,0
"Barbados","2024-08-30",0,0,0,0,0,0,0,0
"Barbados","2024-08-31",0,0,0,0,0,0,0,0
"Barbados","2024-09-01",0,0,0,0,0,0,0,0
"Barbados","2024-09-02",0,0,0,0,0,0,0,0
"Barbados","2024-09-03",0,0,0,0,0,0,0,0
"Barbados","2024-09-04",0,0,0,0,0,0,0,0
"Barbados","2024-09-05",0,0,0,0,0,0,0,0
"Barbados","2024-09-06",0,0,0,0,0,0,0,0
"Barbados","2024-09-07",0,0,0,0,0,0,0,0
"Barbados","2024-09-08",0,0,0,0,0,0,0,0
"Barbados","2024-09-09",0,0,0,0,0,0,0,0
"Barbados","2024-09-10",0,0,0,0,0,0,0,0
"Barbados","2024-09-11",0,0,0,0,0,0,0,0
"Barbados","2024-09-12",0,0,0,0,0,0,0,0
"Barbados","2024-09-13",0,0,0,0,0,0,0,0
"Barbados","2024-09-14",0,0,0,0,0,0,0,0
"Barbados","2024-09-15",0,0,0,0,0,0,0,0
"Barbados","2024-09-16",0,0,0,0,0,0,0,0
"Barbados","2024-09-17",0,0,0,0,0,0,0,0
"Barbados","2024-09-18",0,0,0,0,0,0,0,0
"Barbados","2024-09-19",0,0,0,0,0,0,0,0
"Barbados","2024-09-20",0,0,0,0,0,0,0,0
"Barbados","2024-09-21",0,0,0,0,0,0,0,0
"Barbados","2024-09-22",0,0,0,0,0,0,0,0
"Barbados","2024-09-23",0,0,0,0,0,0,0,0
"Barbados","2024-09-24",0,0,0,0,0,0,0,0
"Barbados","2024-09-25",0,0,0,0,0,0,0,0
"Barbados","2024-09-26",0,0,0,0,0,0,0,0
"Barbados","2024-09-27",0,0,0,0,0,0,0,0
"Barbados","2024-09-28",0,0,0,0,0,0,0,0
"Barbados","2024-09-29",0,0,0,0,0,0,0,0
"Barbados","2024-09-30",0,0,0,0,0,0,0,0
"Barbados","2024-10-01",0,0,0,0,0,0,0,0
"Barbados","2024-10-02",0,0,0,0,0,0,0,0
"Barbados","2024-10-03",0,0,0,0,0,0,0,0
"Barbados","2024-10-04",0,0,0,0,0,0,0,0
"Barbados","2024-10-05",0,0,0,0,0,0,0,0
"Barbados","2024-10-06",0,0,0,0,0,0,0,0
"Barbados","2024-10-07",0,0,0,0,0,0,0,0
"Barbados","2024-10-08",0,0,0,0,0,0,0,0
"Barbados","2024-10-09",0,0,0,0,0,0,0,0
"Barbados","2024-10-10",0,0,0,0,0,0,0,0
"Barbados","2024-10-11",0,0,0,0,0,0,0,0
"Barbados","2024-10-12",0,0,0,0,0,0,0,0
"Barbados","2024-10-13",0,0,0,0,0,0,0,0
"Barbados","2024-10-14",0,0,0,0,0,0,0,0
"Barbados","2024-10-15",0,0,0,0,0,0,0,0
"Barbados","2024-10-16",0,0,0,0,0,0,0,0
"Barbados","2024-10-17",0,0,0,0,0,0,0,0
"Barbados","2024-10-18",0,0,0,0,0,0,0,0
"Barbados","2024-10-19",0,0,0,0,0,0,0,0
"Barbados","2024-10-20",0,0,0,0,0,0,0,0
"Barbados","2024-10-21",0,0,0,0,0,0,0,0
"Barbados","2024-10-22",0,0,0,0,0,0,0,0
"Barbados","2024-10-23",0,0,0,0,0,0,0,0
"Barbados","2024-10-24",0,0,0,0,0,0,0,0
"Barbados","2024-10-25",0,0,0,0,0,0,0,0
"Barbados","2024-10-26",0,0,0,0,0,0,0,0
"Barbados","2024-10-27",0,0,0,0,0,0,0,0
"Barbados","2024-10-28",0,0,0,0,0,0,0,0
"Barbados","2024-10-29",0,0,0,0,0,0,0,0
"Barbados","2024-10-30",0,0,0,0,0,0,0,0
"Barbados","2024-10-31",0,0,0,0,0,0,0,0
"Barbados","2024-11-01",0,0,0,0,0,0,0,0
"Barbados","2024-11-02",0,0,0,0,0,0,0,0
"Barbados","2024-11-03",0,0,0,0,0,0,0,0
"Barbados","2024-11-04",0,0,0,0,0,0,0,0
"Barbados","2024-11-05",0,0,0,0,0,0,0,0
"Barbados","2024-11-06",0,0,0,0,0,0,0,0
"Barbados","2024-11-07",0,0,0,0,0,0,0,0
"Barbados","2024-11-08",0,0,0,0,0,0,0,0
"Barbados","2024-11-09",0,0,0,0,0,0,0,0
"Barbados","2024-11-10",0,0,0,0,0,0,0,0
"Barbados","2024-11-11",0,0,0,0,0,0,0,0
"Barbados","2024-11-12",0,0,0,0,0,0,0,0
"Barbados","2024-11-13",0,0,0,0,0,0,0,0
"Barbados","2024-11-14",0,0,0,0,0,0,0,0
"Barbados","2024-11-15",0,0,0,0,0,0,0,0
"Barbados","2024-11-16",0,0,0,0,0,0,0,0
"Barbados","2024-11-17",0,0,0,0,0,0,0,0
"Barbados","2024-11-18",0,0,0,0,0,0,0,0
"Barbados","2024-11-19",0,0,0,0,0,0,0,0
"Barbados","2024-11-20",0,0,0,0,0,0,0,0
"Barbados","2024-11-21",0,0,0,0,0,0,0,0
"Barbados","2024-11-22",0,0,0,0,0,0,0,0
"Barbados","2024-11-23",0,0,0,0,0,0,0,0
"Barbados","2024-11-24",0,0,0,0,0,0,0,0
"Barbados","2024-11-25",0,0,0,0,0,0,0,0
"Barbados","2024-11-26",0,0,0,0,0,0,0,0
"Barbados","2024-11-27",0,0,0,0,0,0,0,0
"Barbados","2024-11-28",0,0,0,0,0,0,0,0
"Barbados","2024-11-29",0,0,0,0,0,0,0,0
"Barbados","2024-11-30",0,0,0,0,0,0,0,0
"Barbados","2024-12-01",0,0,0,0,0,0,0,0
"Barbados","2024-12-02",0,0,0,0,0,0,0,0
"Barbados","2024-12-03",0,0,0,0,0,0,0,0
"Barbados","2024-12-04",0,0,0,0,0,0,0,0
"Barbados","2024-12-05",0,0,0,0,0,0,0,0
"Barbados","2024-12-06",0,0,0,0,0,0,0,0
"Barbados","2024-12-07",0,0,0,0,0,0,0,0
"Barbados","2024-12-08",0,0,0,0,0,0,0,0
"Barbados","2024-12-09",0,0,0,0,0,0,0,0
"Belgium","2024-01-01",0,0,0,0,0,0,0,0
"Belgium","2024-01-02",0,0,0,0,0,0,0,0
"Belgium","2024-01-03",0,0,0,0,0,0,0,0
"Belgium","2024-01-04",0,0,0,0,0,0,0,0
"Belgium","2024-01-05",0,0,0,0,0,0,0,0
"Belgium","2024-01-06",0,0,0,0,0,0,0,0
"Belgium","2024-01-07",0,0,0,0,0,0,0,0
"Belgium","2024-01-08",0,0,0,0,0,0,0,0
"Belgium","2024-01-09",0,0,0,0,0,0,0,0
"Belgium","2024-01-10",0,0,0,0,0,0,0,0
"Belgium","2024-01-11",0,0,0,0,0,0,0,0
"Belgium","2024-01-12",0,0,0,0,0,0,0,0
"Belgium","2024-01-13",0,0,0,0,0,0,0,0
"Belgium","2024-01-14",0,0,0,0,0,0,0,0
"Belgium","2024-01-15",0,0,0,0,0,0,0,0
"Belgium","2024-01-16",0,0,0,0,0,0,0,0
"Belgium","2024-01-17",0,0,0,0,0,0,0,0
"Belgium","2024-01-18",0,0,0,0,0,0,0,0
"Belgium","2024-01-19",0,0,0,0,0,0,0,0
"Belgium","2024-01-20",0,0,0,0,0,0,0,0
"Belgium","2024-01-21",0,0,0,0,0,0,0,0
"Belgium","2024-01-22",0,0,0,0,0,0,0,0
"Belgium","2024-01-23",0,0,0,0,0,0,0,0
"Belgium","2024-01-24",0,0,0,0,0,0,0,0
"Belgium","2024-01-25",0,0,0,0,0,0,0,0
"Belgium","2024-01-26",0,0,0,0,0,0,0,0
"Belgium","2024-01-27",0,0,0,0,0,0,0,0
"Belgium","2024-01-28",0,0,0,0,0,0,0,0
"Belgium","2024-01-29",0,0,0,0,0,0,0,0
"Belgium","2024-01-30",0,0,0,0,0,0,0,0
"Belgium","2024-01-31",0,3,3,0,3,3,0,0
"Belgium","2024-02-01",0,0,3,0,0,3,0,0
"Belgium","2024-02-02",0,0,3,0,0,3,0,0
"Belgium","2024-02-03",0,0,3,0,0,3,0,0
"Belgium","2024-02-04",0,0,3,0,0,3,0,0
"Belgium","2024-02-05",0,0,3,0,0,3,0,0
"Belgium","2024-02-06",0,0,3,0,0,3,0,0
"Belgium","2024-02-07",0,0,3,0,0,3,0,0
"Belgium","2024-02-08",0,0,3,0,1,4,0,0
"Belgium","2024-02-09",0,0,3,0,0,4,0,0
"Belgium","2024-02-10",0,0,3,0,0,4,0,0
"Belgium","2024-02-11",0,0,3,0,0,4,0,0
"Belgium","2024-02-12",0,0,3,0,0,4,0,0
"Belgium","2024-02-13",0,0,3,0,0,4,0,0
"Belgium","2024-02-14",0,0,3,0,0,4,0,0
"Belgium","2024-02-15",0,0,3,0,0,4,0,0
"Belgium","2024-02-16",0,0,3,0,0,4,0,0
"Belgium","2024-02-17",0,0,3,0,0,4,0,0
"Belgium","2024-02-18",0,0,3,0,0,4,0,0
"Belgium","2024-02-19",0,0,3,0,0,4,0,0
"Belgium","2024-02-20",0,0,3,0,0,4,0,0
"Belgium","2024-02-21",0,0,3,0,0,4,0,0
"Belgium","2024-02-22",0,0,3,0,1,5,0,0
"Belgium","2024-02-23",0,0,3,0,0,5,0,0
"Belgium","2024-02-24",0,0,3,0,0,5,0,0
"Belgium","2024-02-25",0,0,3,0,0,5,0,0
"Belgium","2024-02-26",0,0,3,0,0,5,0,0
"Belgium","2024-02-27",0,0,3,0,0,5,0,0
"Belgium","2024-02-28",0,0,3,0,0,5,0,0
"Belgium","2024-02-29",0,2,5,0,0,5,0,0
"Belgium","2024-03-01",0,0,5,0,0,5,0,0
"Belgium","2024-03-02",0,0,5,0,0,5,0,0
"Belgium","2024-03-03",0,0,5,0,0,5,0,0
"Belgium","2024-03-04",0,0,5,0,0,5,0,0
"Belgium","2024-03-05",0,0,5,0,0,5,0,0
"Belgium","2024-03-06",0,0,5,0,0,5,0,0
"Belgium","2024-03-07",0,0,5,0,0,5,0,0
"Belgium","2024-03-08",0,0,5,0,0,5,0,0
"Belgium","2024-03-09",0,0,5,0,0,5,0,0
"Belgium","2024-03-10",0,0,5,0,0,5,0,0
"Belgium","2024-03-11",0,0,5,0,0,5,0,0
"Belgium","2024-03-12",0,0,5,0,0,5,0,0
"Belgium","2024-03-13",0,0,5,0,0,5,0,0
"Belgium","2024-03-14",0,0,5,0,0,5,0,0
"Belgium","2024-03-15",0,0,5,0,0,5,0,0
"Belgium","2024-03-16",0,0,5,0,1,6,0,0
"Belgium","2024-03-17",0,0,5,0,0,6,0,0
"Belgium","2024-03-18",0,0,5,0,0,6,0,0
"Belgium","2024-03-19",0,0,5,0,0,6,0,0
"Belgium","2024-03-20",0,0,5,0,0,6,0,0
"Belgium","2024-03-21",0,0,5,0,0,6,0,0
"Belgium","2024-03-22",0,0,5,0,0,6,0,0
"Belgium","2024-03-23",0,0,5,0,0,6,0,0
"Belgium","2024-03-24",0,0,5,0,0,6,0,0
"Belgium","2024-03-25",0,0,5,0,0,6,0,0
"Belgium","2024-03-26",0,0,5,0,0,6,0,0
"Belgium","2024-03-27",0,0,5,0,0,6,0,0
"Belgium","2024-03-28",0,0,5,0,0,6,0,0
"Belgium","2024-03-29",0,0,5,0,0,6,0,0
"Belgium","2024-03-30",0,0,5,0,0,6,0,0
"Belgium","2024-03-31",0,1,6,0,0,6,0,0
"Belgium","2024-04-01",0,0,6,0,0,6,0,0
"Belgium","2024-04-02",0,0,6,0,0,6,0,0
"Belgium","2024-04-03",0,0,6,0,0,6,0,0
"Belgium","2024-04-04",0,0,6,0,0,6,0,0
"Belgium","2024-04-05",0,0,6,0,0,6,0,0
"Belgium","2024-04-06",0,0,6,0,1,7,0,0
"Belgium","2024-04-07",0,0,6,0,0,7,0,0
"Belgium","2024-04-08",0,0,6,0,0,7,0,0
"Belgium","2024-04-09",0,0,6,0,0,7,0,0
"Belgium","2024-04-10",0,0,6,0,0,7,0,0
"Belgium","2024-04-11",0,0,6,0,0,7,0,0
"Belgium","2024-04-12",0,0,6,0,0,7,0,0
"Belgium","2024-04-13",0,0,6,0,0,7,0,0
"Belgium","2024-04-14",0,0,6,0,0,7,0,0
"Belgium","2024-04-15",0,0,6,0,1,8,0,0
"Belgium","2024-04-16",0,0,6,0,0,8,0,0
"Belgium","2024-04-17",0,0,6,0,0,8,0,0
"Belgium","2024-04-18",0,0,6,0,0,8,0,0
"Belgium","2024-04-19",0,0,6,0,0,8,0,0
"Belgium","2024-04-20",0,0,6,0,0,8,0,0
"Belgium","2024-04-21",0,0,6,0,0,8,0,0
"Belgium","2024-04-22",0,0,6,0,0,8,0,0
"Belgium","2024-04-23",0,0,6,0,0,8,0,0
"Belgium","2024-04-24",0,0,6,0,0,8,0,0
"Belgium","2024-04-25",0,0,6,0,0,8,0,0
"Belgium","2024-04-26",0,0,6,0,1,9,0,0
"Belgium","2024-04-27",0,0,6,0,0,9,0,0
"Belgium","2024-04-28",0,0,6,0,0,9,0,0
"Belgium","2024-04-29",0,0,6,0,0,9,0,0
"Belgium","2024-04-30",0,3,9,0,0,9,0,0
"Belgium","2024-05-01",0,0,9,0,0,9,0,0
"Belgium","2024-05-02",0,0,9,0,0,9,0,0
"Belgium","2024-05-03",0,0,9,0,0,9,0,0
"Belgium","2024-05-04",0,0,9,0,0,9,0,0
"Belgium","2024-05-05",0,0,9,0,0,9,0,0
"Belgium","2024-05-06",0,0,9,0,0,9,0,0
"Belgium","2024-05-07",0,0,9,0,0,9,0,0
"Belgium","2024-05-08",0,0,9,0,0,9,0,0
"Belgium","2024-05-09",0,0,9,0,0,9,0,0
"Belgium","2024-05-10",0,0,9,0,0,9,0,0
"Belgium","2024-05-11",0,0,9,0,0,9,0,0
"Belgium","2024-05-12",0,0,9,0,0,9,0,0
"Belgium","2024-05-13",0,0,9,0,0,9,0,0
"Belgium","2024-05-14",0,0,9,0,0,9,0,0
"Belgium","2024-05-15",0,0,9,0,0,9,0,0
"Belgium","2024-05-16",0,0,9,0,0,9,0,0
"Belgium","2024-05-17",0,0,9,0,0,9,0,0
"Belgium","2024-05-18",0,0,9,0,0,9,0,0
"Belgium","2024-05-19",0,0,9,0,0,9,0,0
"Belgium","2024-05-20",0,0,9,0,0,9,0,0
"Belgium","2024-05-21",0,0,9,0,0,9,0,0
"Belgium","2024-05-22",0,0,9,0,0,9,0,0
"Belgium","2024-05-23",0,0,9,0,0,9,0,0
"Belgium","2024-05-24",0,0,9,0,0,9,0,0
"Belgium","2024-05-25",0,0,9,0,0,9,0,0
"Belgium","2024-05-26",0,0,9,0,0,9,0,0
"Belgium","2024-05-27",0,0,9,0,0,9,0,0
"Belgium","2024-05-28",0,0,9,0,0,9,0,0
"Belgium","2024-05-29",0,0,9,0,0,9,0,0
"Belgium","2024-05-30",0,0,9,0,0,9,0,0
"Belgium","2024-05-31",0,0,9,0,1,10,0,0
"Belgium","2024-06-01",0,0,9,0,0,10,0,0
"Belgium","2024-06-02",0,0,9,0,0,10,0,0
"Belgium","2024-06-03",0,0,9,0,0,10,0,0
"Belgium","2024-06-04",0,0,9,0,0,10,0,0
"Belgium","2024-06-05",0,0,9,0,0,10,0,0
"Belgium","2024-06-06",0,0,9,0,0,10,0,0
"Belgium","2024-06-07",0,0,9,0,0,10,0,0
"Belgium","2024-06-08",0,0,9,0,0,10,0,0
"Belgium","2024-06-09",0,0,9,0,0,10,0,0
"Belgium","2024-06-10",0,0,9,0,0,10,0,0
"Belgium","2024-06-11",0,0,9,0,0,10,0,0
"Belgium","2024-06-12",0,0,9,0,0,10,0,0
"Belgium","2024-06-13",0,0,9,0,0,10,0,0
"Belgium","2024-06-14",0,0,9,0,0,10,0,0
"Belgium","2024-06-15",0,0,9,0,0,10,0,0
"Belgium","2024-06-16",0,0,9,0,0,10,0,0
"Belgium","2024-06-17",0,0,9,0,0,10,0,0
"Belgium","2024-06-18",0,0,9,0,0,10,0,0
"Belgium","2024-06-19",0,0,9,0,0,10,0,0
"Belgium","2024-06-20",0,0,9,0,0,10,0,0
"Belgium","2024-06-21",0,0,9,0,0,10,0,0
"Belgium","2024-06-22",0,0,9,0,0,10,0,0
"Belgium","2024-06-23",0,0,9,0,0,10,0,0
"Belgium","2024-06-24",0,0,9,0,0,10,0,0
"Belgium","2024-06-25",0,0,9,0,0,10,0,0
"Belgium","2024-06-26",0,0,9,0,0,10,0,0
"Belgium","2024-06-27",0,0,9,0,0,10,0,0
"Belgium","2024-06-28",0,0,9,0,0,10,0,0
"Belgium","2024-06-29",0,0,9,0,0,10,0,0
"Belgium","2024-06-30",0,1,10,0,0,10,0,0
"Belgium","2024-07-01",0,0,10,0,0,10,0,0
"Belgium","2024-07-02",0,0,10,0,0,10,0,0
"Belgium","2024-07-03",0,0,10,0,0,10,0,0
"Belgium","2024-07-04",0,0,10,0,0,10,0,0
"Belgium","2024-07-05",0,0,10,0,0,10,0,0
"Belgium","2024-07-06",0,0,10,0,0,10,0,0
"Belgium","2024-07-07",0,0,10,0,0,10,0,0
"Belgium","2024-07-08",0,0,10,0,0,10,0,0
"Belgium","2024-07-09",0,0,10,0,0,10,0,0
"Belgium","2024-07-10",0,0,10,0,0,10,0,0
"Belgium","2024-07-11",0,0,10,0,0,10,0,0
"Belgium","2024-07-12",0,0,10,0,0,10,0,0
"Belgium","2024-07-13",0,0,10,0,0,10,0,0
"Belgium","2024-07-14",0,0,10,0,0,10,0,0
"Belgium","2024-07-15",0,0,10,0,0,10,0,0
"Belgium","2024-07-16",0,0,10,0,1,11,0,0
"Belgium","2024-07-17",0,0,10,0,0,11,0,0
"Belgium","2024-07-18",0,0,10,0,0,11,0,0
"Belgium","2024-07-19",0,0,10,0,0,11,0,0
"Belgium","2024-07-20",0,0,10,0,0,11,0,0
"Belgium","2024-07-21",0,0,10,0,0,11,0,0
"Belgium","2024-07-22",0,0,10,0,0,11,0,0
"Belgium","2024-07-23",0,0,10,0,0,11,0,0
"Belgium","2024-07-24",0,0,10,0,0,11,0,0
"Belgium","2024-07-25",0,0,10,0,0,11,0,0
"Belgium","2024-07-26",0,0,10,0,0,11,0,0
"Belgium","2024-07-27",0,0,10,0,0,11,0,0
"Belgium","2024-07-28",0,0,10,0,0,11,0,0
"Belgium","2024-07-29",0,0,10,0,0,11,0,0
"Belgium","2024-07-30",0,0,10,0,0,11,0,0
"Belgium","2024-07-31",0,1,11,0,0,11,0,0
"Belgium","2024-08-01",0,0,11,0,0,11,0,0
"Belgium","2024-08-02",0,0,11,0,0,11,0,0
"Belgium","2024-08-03",0,0,11,0,0,11,0,0
"Belgium","2024-08-04",0,0,11,0,0,11,0,0
"Belgium","2024-08-05",0,0,11,0,0,11,0,0
"Belgium","2024-08-06",0,0,11,0,1,12,0,0
"Belgium","2024-08-07",0,0,11,0,0,12,0,0
"Belgium","2024-08-08",0,0,11,0,0,12,0,0
"Belgium","2024-08-09",0,0,11,0,0,12,0,0
"Belgium","2024-08-10",0,0,11,0,0,12,0,0
"Belgium","2024-08-11",0,0,11,0,0,12,0,0
"Belgium","2024-08-12",0,0,11,0,0,12,0,0
"Belgium","2024-08-13",0,0,11,0,0,12,0,0
"Belgium","2024-08-14",0,0,11,0,0,12,0,0
"Belgium","2024-08-15",0,0,11,0,0,12,0,0
"Belgium","2024-08-16",0,0,11,0,1,13,0,0
"Belgium","2024-08-17",0,0,11,0,0,13,0,0
"Belgium","2024-08-18",0,0,11,0,0,13,0,0
"Belgium","2024-08-19",0,0,11,0,0,13,0,0
"Belgium","2024-08-20",0,0,11,0,0,13,0,0
"Belgium","2024-08-21",0,0,11,0,0,13,0,0
"Belgium","2024-08-22",0,0,11,0,0,13,0,0
"Belgium","2024-08-23",0,0,11,0,0,13,0,0
"Belgium","2024-08-24",0,0,11,0,0,13,0,0
"Belgium","2024-08-25",0,0,11,0,0,13,0,0
"Belgium","2024-08-26",0,0,11,0,1,14,0,0
"Belgium","2024-08-27",0,0,11,0,0,14,0,0
"Belgium","2024-08-28",0,0,11,0,0,14,0,0
"Belgium","2024-08-29",0,0,11,0,0,14,0,0
"Belgium","2024-08-30",0,0,11,0,0,14,0,0
"Belgium","2024-08-31",0,3,14,0,0,14,0,0
"Belgium","2024-09-01",0,0,14,0,0,14,0,0
"Belgium","2024-09-02",0,0,14,0,1,15,0,0
"Belgium","2024-09-03",0,0,14,0,0,15,0,0
"Belgium","2024-09-04",0,0,14,0,0,15,0,0
"Belgium","2024-09-05",0,0,14,0,0,15,0,0
"Belgium","2024-09-06",0,0,14,0,1,16,0,0
"Belgium","2024-09-07",0,0,14,0,0,16,0,0
"Belgium","2024-09-08",0,0,14,0,0,16,0,0
"Belgium","2024-09-09",0,0,14,0,0,16,0,0
"Belgium","2024-09-10",0,0,14,0,1,17,0,0
"Belgium","2024-09-11",0,0,14,0,0,17,0,0
"Belgium","2024-09-12",0,0,14,0,0,17,0,0
"Belgium","2024-09-13",0,0,14,0,0,17,0,0
"Belgium","2024-09-14",0,0,14,0,1,18,0,0
"Belgium","2024-09-15",0,0,14,0,0,18,0,0
"Belgium","2024-09-16",0,0,14,0,0,18,0,0
"Belgium","2024-09-17",0,0,14,0,1,19,0,0
"Belgium","2024-09-18",0,0,14,0,0,19,0,0
"Belgium","2024-09-19",0,0,14,0,0,19,0,0
"Belgium","2024-09-20",0,0,14,0,0,19,0,0
"Belgium","2024-09-21",0,0,14,0,1,20,0,0
"Belgium","2024-09-22",0,0,14,0,0,20,0,0
"Belgium","2024-09-23",0,0,14,0,0,20,0,0
"Belgium","2024-09-24",0,0,14,0,0,20,0,0
"Belgium","2024-09-25",0,0,14,0,1,21,0,0
"Belgium","2024-09-26",0,0,14,0,0,21,0,0
"Belgium","2024-09-27",0,0,14,0,0,21,0,0
"Belgium","2024-09-28",0,0,14,0,0,21,0,0
"Belgium","2024-09-29",0,0,14,0,1,22,0,0
"Belgium","2024-09-30",0,8,22,0,0,22,0,0
"Belgium","2024-10-01",0,0,22,0,1,23,0,0
"Belgium","2024-10-02",0,0,22,0,0,23,0,0
"Belgium","2024-10-03",0,0,22,0,1,24,0,0
"Belgium","2024-10-04",0,0,22,0,0,24,0,0
"Belgium","2024-10-05",0,0,22,0,1,25,0,0
"Belgium","2024-10-06",0,0,22,0,0,25,0,0
"Belgium","2024-10-07",0,0,22,0,1,26,0,0
"Belgium","2024-10-08",0,0,22,0,0,26,0,0
"Belgium","2024-10-09",0,0,22,0,1,27,0,0
"Belgium","2024-10-10",0,0,22,0,0,27,0,0
"Belgium","2024-10-11",0,0,22,0,1,28,0,0
"Belgium","2024-10-12",0,0,22,0,1,29,0,0
"Belgium","2024-10-13",0,0,22,0,0,29,0,0
"Belgium","2024-10-14",0,0,22,0,1,30,0,0
"Belgium","2024-10-15",0,0,22,0,0,30,0,0
"Belgium","2024-10-16",0,0,22,0,1,31,0,0
"Belgium","2024-10-17",0,0,22,0,0,31,0,0
"Belgium","2024-10-18",0,0,22,0,1,32,0,0
"Belgium","2024-10-19",0,0,22,0,0,32,0,0
"Belgium","2024-10-20",0,0,22,0,1,33,0,0
"Belgium","2024-10-21",0,0,22,0,1,34,0,0
"Belgium","2024-10-22",0,0,22,0,0,34,0,0
"Belgium","2024-10-23",0,0,22,0,1,35,0,0
"Belgium","2024-10-24",0,0,22,0,0,35,0,0
"Belgium","2024-10-25",0,0,22,0,1,36,0,0
"Belgium","2024-10-26",0,0,22,0,0,36,0,0
"Belgium","2024-10-27",0,0,22,0,1,37,0,0
"Belgium","2024-10-28",0,0,22,0,0,37,0,0
"Belgium","2024-10-29",0,0,22,0,1,38,0,0
"Belgium","2024-10-30",0,0,22,0,0,38,0,0
"Belgium","2024-10-31",0,17,39,0,1,39,0,0
"Belgium","2024-11-01",0,0,39,0,0,39,0,0
"Belgium","2024-11-02",0,0,39,0,0,39,0,0
"Belgium","2024-11-03",0,0,39,0,0,39,0,0
"Belgium","2024-11-04",0,0,39,0,0,39,0,0
"Belgium","2024-11-05",0,0,39,0,0,39,0,0
"Belgium","2024-11-06",0,0,39,0,0,39,0,0
"Belgium","2024-11-07",0,0,39,0,0,39,0,0
"Belgium","2024-11-08",0,0,39,0,0,39,0,0
"Belgium","2024-11-09",0,0,39,0,0,39,0,0
"Belgium","2024-11-10",0,0,39,0,0,39,0,0
"Belgium","2024-11-11",0,0,39,0,0,39,0,0
"Belgium","2024-11-12",0,0,39,0,0,39,0,0
"Belgium","2024-11-13",0,0,39,0,0,39,0,0
"Belgium","2024-11-14",0,0,39,0,0,39,0,0
"Belgium","2024-11-15",0,0,39,0,0,39,0,0
"Belgium","2024-11-16",0,0,39,0,0,39,0,0
"Belgium","2024-11-17",0,0,39,0,0,39,0,0
"Belgium","2024-11-18",0,0,39,0,0,39,0,0
"Belgium","2024-11-19",0,0,39,0,0,39,0,0
"Belgium","2024-11-20",0,0,39,0,0,39,0,0
"Belgium","2024-11-21",0,0,39,0,0,39,0,0
"Belgium","2024-11-22",0,0,39,0,0,39,0,0
"Belgium","2024-11-23",0,0,39,0,0,39,0,0
"Belgium","2024-11-24",0,0,39,0,0,39,0,0
"Belgium","2024-11-25",0,0,39,0,0,39,0,0
"Belgium","2024-11-26",0,0,39,0,0,39,0,0
"Belgium","2024-11-27",0,0,39,0,0,39,0,0
"Belgium","2024-11-28",0,0,39,0,0,39,0,0
"Belgium","2024-11-29",0,0,39,0,0,39,0,0
"Belgium","2024-11-30",0,0,39,0,0,39,0,0
"Belgium","2024-12-01",0,0,39,0,0,39,0,0
"Belgium","2024-12-02",0,0,39,0,0,39,0,0
"Belgium","2024-12-03",0,0,39,0,0,39,0,0
"Belgium","2024-12-04",0,0,39,0,0,39,0,0
"Belgium","2024-12-05",0,0,39,0,0,39,0,0
"Belgium","2024-12-06",0,0,39,0,0,39,0,0
"Belgium","2024-12-07",0,0,39,0,0,39,0,0
"Belgium","2024-12-08",0,0,39,0,0,39,0,0
"Belgium","2024-12-09",0,0,39,0,0,39,0,0
"Benin","2024-01-01",0,0,0,0,0,0,0,0
"Benin","2024-01-02",0,0,0,0,0,0,0,0
"Benin","2024-01-03",0,0,0,0,0,0,0,0
"Benin","2024-01-04",0,0,0,0,0,0,0,0
"Benin","2024-01-05",0,0,0,0,0,0,0,0
"Benin","2024-01-06",0,0,0,0,0,0,0,0
"Benin","2024-01-07",0,0,0,0,0,0,0,0
"Benin","2024-01-08",0,0,0,0,0,0,0,0
"Benin","2024-01-09",0,0,0,0,0,0,0,0
"Benin","2024-01-10",0,0,0,0,0,0,0,0
"Benin","2024-01-11",0,0,0,0,0,0,0,0
"Benin","2024-01-12",0,0,0,0,0,0,0,0
"Benin","2024-01-13",0,0,0,0,0,0,0,0
"Benin","2024-01-14",0,0,0,0,0,0,0,0
"Benin","2024-01-15",0,0,0,0,0,0,0,0
"Benin","2024-01-16",0,0,0,0,0,0,0,0
"Benin","2024-01-17",0,0,0,0,0,0,0,0
"Benin","2024-01-18",0,0,0,0,0,0,0,0
"Benin","2024-01-19",0,0,0,0,0,0,0,0
"Benin","2024-01-20",0,0,0,0,0,0,0,0
"Benin","2024-01-21",0,0,0,0,0,0,0,0
"Benin","2024-01-22",0,0,0,0,0,0,0,0
"Benin","2024-01-23",0,0,0,0,0,0,0,0
"Benin","2024-01-24",0,0,0,0,0,0,0,0
"Benin","2024-01-25",0,0,0,0,0,0,0,0
"Benin","2024-01-26",0,0,0,0,0,0,0,0
"Benin","2024-01-27",0,0,0,0,0,0,0,0
"Benin","2024-01-28",0,0,0,0,0,0,0,0
"Benin","2024-01-29",0,0,0,0,0,0,0,0
"Benin","2024-01-30",0,0,0,0,0,0,0,0
"Benin","2024-01-31",0,0,0,0,0,0,0,0
"Benin","2024-02-01",0,0,0,0,0,0,0,0
"Benin","2024-02-02",0,0,0,0,0,0,0,0
"Benin","2024-02-03",0,0,0,0,0,0,0,0
"Benin","2024-02-04",0,0,0,0,0,0,0,0
"Benin","2024-02-05",0,0,0,0,0,0,0,0
"Benin","2024-02-06",0,0,0,0,0,0,0,0
"Benin","2024-02-07",0,0,0,0,0,0,0,0
"Benin","2024-02-08",0,0,0,0,0,0,0,0
"Benin","2024-02-09",0,0,0,0,0,0,0,0
"Benin","2024-02-10",0,0,0,0,0,0,0,0
"Benin","2024-02-11",0,0,0,0,0,0,0,0
"Benin","2024-02-12",0,0,0,0,0,0,0,0
"Benin","2024-02-13",0,0,0,0,0,0,0,0
"Benin","2024-02-14",0,0,0,0,0,0,0,0
"Benin","2024-02-15",0,0,0,0,0,0,0,0
"Benin","2024-02-16",0,0,0,0,0,0,0,0
"Benin","2024-02-17",0,0,0,0,0,0,0,0
"Benin","2024-02-18",0,0,0,0,0,0,0,0
"Benin","2024-02-19",0,0,0,0,0,0,0,0
"Benin","2024-02-20",0,0,0,0,0,0,0,0
"Benin","2024-02-21",0,0,0,0,0,0,0,0
"Benin","2024-02-22",0,0,0,0,0,0,0,0
"Benin","2024-02-23",0,0,0,0,0,0,0,0
"Benin","2024-02-24",0,0,0,0,0,0,0,0
"Benin","2024-02-25",0,0,0,0,0,0,0,0
"Benin","2024-02-26",0,0,0,0,0,0,0,0
"Benin","2024-02-27",0,0,0,0,0,0,0,0
"Benin","2024-02-28",0,0,0,0,0,0,0,0
"Benin","2024-02-29",0,0,0,0,0,0,0,0
"Benin","2024-03-01",0,0,0,0,0,0,0,0
"Benin","2024-03-02",0,0,0,0,0,0,0,0
"Benin","2024-03-03",0,0,0,0,0,0,0,0
"Benin","2024-03-04",0,0,0,0,0,0,0,0
"Benin","2024-03-05",0,0,0,0,0,0,0,0
"Benin","2024-03-06",0,0,0,0,0,0,0,0
"Benin","2024-03-07",0,0,0,0,0,0,0,0
"Benin","2024-03-08",0,0,0,0,0,0,0,0
"Benin","2024-03-09",0,0,0,0,0,0,0,0
"Benin","2024-03-10",0,0,0,0,0,0,0,0
"Benin","2024-03-11",0,0,0,0,0,0,0,0
"Benin","2024-03-12",0,0,0,0,0,0,0,0
"Benin","2024-03-13",0,0,0,0,0,0,0,0
"Benin","2024-03-14",0,0,0,0,0,0,0,0
"Benin","2024-03-15",0,0,0,0,0,0,0,0
"Benin","2024-03-16",0,0,0,0,0,0,0,0
"Benin","2024-03-17",0,0,0,0,0,0,0,0
"Benin","2024-03-18",0,0,0,0,0,0,0,0
"Benin","2024-03-19",0,0,0,0,0,0,0,0
"Benin","2024-03-20",0,0,0,0,0,0,0,0
"Benin","2024-03-21",0,0,0,0,0,0,0,0
"Benin","2024-03-22",0,0,0,0,0,0,0,0
"Benin","2024-03-23",0,0,0,0,0,0,0,0
"Benin","2024-03-24",0,0,0,0,0,0,0,0
"Benin","2024-03-25",0,0,0,0,0,0,0,0
"Benin","2024-03-26",0,0,0,0,0,0,0,0
"Benin","2024-03-27",0,0,0,0,0,0,0,0
"Benin","2024-03-28",0,0,0,0,0,0,0,0
"Benin","2024-03-29",0,0,0,0,0,0,0,0
"Benin","2024-03-30",0,0,0,0,0,0,0,0
"Benin","2024-03-31",0,0,0,0,0,0,0,0
"Benin","2024-04-01",0,0,0,0,0,0,0,0
"Benin","2024-04-02",0,0,0,0,0,0,0,0
"Benin","2024-04-03",0,0,0,0,0,0,0,0
"Benin","2024-04-04",0,0,0,0,0,0,0,0
"Benin","2024-04-05",0,0,0,0,0,0,0,0
"Benin","2024-04-06",0,0,0,0,0,0,0,0
"Benin","2024-04-07",0,0,0,0,0,0,0,0
"Benin","2024-04-08",0,0,0,0,0,0,0,0
"Benin","2024-04-09",0,0,0,0,0,0,0,0
"Benin","2024-04-10",0,0,0,0,0,0,0,0
"Benin","2024-04-11",0,0,0,0,0,0,0,0
"Benin","2024-04-12",0,0,0,0,0,0,0,0
"Benin","2024-04-13",0,0,0,0,0,0,0,0
"Benin","2024-04-14",0,0,0,0,0,0,0,0
"Benin","2024-04-15",0,0,0,0,0,0,0,0
"Benin","2024-04-16",0,0,0,0,0,0,0,0
"Benin","2024-04-17",0,0,0,0,0,0,0,0
"Benin","2024-04-18",0,0,0,0,0,0,0,0
"Benin","2024-04-19",0,0,0,0,0,0,0,0
"Benin","2024-04-20",0,0,0,0,0,0,0,0
"Benin","2024-04-21",0,0,0,0,0,0,0,0
"Benin","2024-04-22",0,0,0,0,0,0,0,0
"Benin","2024-04-23",0,0,0,0,0,0,0,0
"Benin","2024-04-24",0,0,0,0,0,0,0,0
"Benin","2024-04-25",0,0,0,0,0,0,0,0
"Benin","2024-04-26",0,0,0,0,0,0,0,0
"Benin","2024-04-27",0,0,0,0,0,0,0,0
"Benin","2024-04-28",0,0,0,0,0,0,0,0
"Benin","2024-04-29",0,0,0,0,0,0,0,0
"Benin","2024-04-30",0,0,0,0,0,0,0,0
"Benin","2024-05-01",0,0,0,0,0,0,0,0
"Benin","2024-05-02",0,0,0,0,0,0,0,0
"Benin","2024-05-03",0,0,0,0,0,0,0,0
"Benin","2024-05-04",0,0,0,0,0,0,0,0
"Benin","2024-05-05",0,0,0,0,0,0,0,0
"Benin","2024-05-06",0,0,0,0,0,0,0,0
"Benin","2024-05-07",0,0,0,0,0,0,0,0
"Benin","2024-05-08",0,0,0,0,0,0,0,0
"Benin","2024-05-09",0,0,0,0,0,0,0,0
"Benin","2024-05-10",0,0,0,0,0,0,0,0
"Benin","2024-05-11",0,0,0,0,0,0,0,0
"Benin","2024-05-12",0,0,0,0,0,0,0,0
"Benin","2024-05-13",0,0,0,0,0,0,0,0
"Benin","2024-05-14",0,0,0,0,0,0,0,0
"Benin","2024-05-15",0,0,0,0,0,0,0,0
"Benin","2024-05-16",0,0,0,0,0,0,0,0
"Benin","2024-05-17",0,0,0,0,0,0,0,0
"Benin","2024-05-18",0,0,0,0,0,0,0,0
"Benin","2024-05-19",0,0,0,0,0,0,0,0
"Benin","2024-05-20",0,0,0,0,0,0,0,0
"Benin","2024-05-21",0,0,0,0,0,0,0,0
"Benin","2024-05-22",0,0,0,0,0,0,0,0
"Benin","2024-05-23",0,0,0,0,0,0,0,0
"Benin","2024-05-24",0,0,0,0,0,0,0,0
"Benin","2024-05-25",0,0,0,0,0,0,0,0
"Benin","2024-05-26",0,0,0,0,0,0,0,0
"Benin","2024-05-27",0,0,0,0,0,0,0,0
"Benin","2024-05-28",0,0,0,0,0,0,0,0
"Benin","2024-05-29",0,0,0,0,0,0,0,0
"Benin","2024-05-30",0,0,0,0,0,0,0,0
"Benin","2024-05-31",0,0,0,0,0,0,0,0
"Benin","2024-06-01",0,0,0,0,0,0,0,0
"Benin","2024-06-02",0,0,0,0,0,0,0,0
"Benin","2024-06-03",0,0,0,0,0,0,0,0
"Benin","2024-06-04",0,0,0,0,0,0,0,0
"Benin","2024-06-05",0,0,0,0,0,0,0,0
"Benin","2024-06-06",0,0,0,0,0,0,0,0
"Benin","2024-06-07",0,0,0,0,0,0,0,0
"Benin","2024-06-08",0,0,0,0,0,0,0,0
"Benin","2024-06-09",0,0,0,0,0,0,0,0
"Benin","2024-06-10",0,0,0,0,0,0,0,0
"Benin","2024-06-11",0,0,0,0,0,0,0,0
"Benin","2024-06-12",0,0,0,0,0,0,0,0
"Benin","2024-06-13",0,0,0,0,0,0,0,0
"Benin","2024-06-14",0,0,0,0,0,0,0,0
"Benin","2024-06-15",0,0,0,0,0,0,0,0
"Benin","2024-06-16",0,0,0,0,0,0,0,0
"Benin","2024-06-17",0,0,0,0,0,0,0,0
"Benin","2024-06-18",0,0,0,0,0,0,0,0
"Benin","2024-06-19",0,0,0,0,0,0,0,0
"Benin","2024-06-20",0,0,0,0,0,0,0,0
"Benin","2024-06-21",0,0,0,0,0,0,0,0
"Benin","2024-06-22",0,0,0,0,0,0,0,0
"Benin","2024-06-23",0,0,0,0,0,0,0,0
"Benin","2024-06-24",0,0,0,0,0,0,0,0
"Benin","2024-06-25",0,0,0,0,0,0,0,0
"Benin","2024-06-26",0,0,0,0,0,0,0,0
"Benin","2024-06-27",0,0,0,0,0,0,0,0
"Benin","2024-06-28",0,0,0,0,0,0,0,0
"Benin","2024-06-29",0,0,0,0,0,0,0,0
"Benin","2024-06-30",0,0,0,0,0,0,0,0
"Benin","2024-07-01",0,0,0,0,0,0,0,0
"Benin","2024-07-02",0,0,0,0,0,0,0,0
"Benin","2024-07-03",0,0,0,0,0,0,0,0
"Benin","2024-07-04",0,0,0,0,0,0,0,0
"Benin","2024-07-05",0,0,0,0,0,0,0,0
"Benin","2024-07-06",0,0,0,0,0,0,0,0
"Benin","2024-07-07",0,0,0,0,0,0,0,0
"Benin","2024-07-08",0,0,0,0,0,0,0,0
"Benin","2024-07-09",0,0,0,0,0,0,0,0
"Benin","2024-07-10",0,0,0,0,0,0,0,0
"Benin","2024-07-11",0,0,0,0,0,0,0,0
"Benin","2024-07-12",0,0,0,0,0,0,0,0
"Benin","2024-07-13",0,0,0,0,0,0,0,0
"Benin","2024-07-14",0,0,0,0,0,0,0,0
"Benin","2024-07-15",0,0,0,0,0,0,0,0
"Benin","2024-07-16",0,0,0,0,0,0,0,0
"Benin","2024-07-17",0,0,0,0,0,0,0,0
"Benin","2024-07-18",0,0,0,0,0,0,0,0
"Benin","2024-07-19",0,0,0,0,0,0,0,0
"Benin","2024-07-20",0,0,0,0,0,0,0,0
"Benin","2024-07-21",0,0,0,0,0,0,0,0
"Benin","2024-07-22",0,0,0,0,0,0,0,0
"Benin","2024-07-23",0,0,0,0,0,0,0,0
"Benin","2024-07-24",0,0,0,0,0,0,0,0
"Benin","2024-07-25",0,0,0,0,0,0,0,0
"Benin","2024-07-26",0,0,0,0,0,0,0,0
"Benin","2024-07-27",0,0,0,0,0,0,0,0
"Benin","2024-07-28",0,0,0,0,0,0,0,0
"Benin","2024-07-29",0,0,0,0,0,0,0,0
"Benin","2024-07-30",0,0,0,0,0,0,0,0
"Benin","2024-07-31",0,0,0,0,0,0,0,0
"Benin","2024-08-01",0,0,0,0,0,0,0,0
"Benin","2024-08-02",0,0,0,0,0,0,0,0
"Benin","2024-08-03",0,0,0,0,0,0,0,0
"Benin","2024-08-04",0,0,0,0,0,0,0,0
"Benin","2024-08-05",0,0,0,0,0,0,0,0
"Benin","2024-08-06",0,0,0,0,0,0,0,0
"Benin","2024-08-07",0,0,0,0,0,0,0,0
"Benin","2024-08-08",0,0,0,0,0,0,0,0
"Benin","2024-08-09",0,0,0,0,0,0,0,0
"Benin","2024-08-10",0,0,0,0,0,0,0,0
"Benin","2024-08-11",0,0,0,0,0,0,0,0
"Benin","2024-08-12",0,0,0,0,0,0,0,0
"Benin","2024-08-13",0,0,0,0,0,0,0,0
"Benin","2024-08-14",0,0,0,0,0,0,0,0
"Benin","2024-08-15",0,0,0,0,0,0,0,0
"Benin","2024-08-16",0,0,0,0,0,0,0,0
"Benin","2024-08-17",0,0,0,0,0,0,0,0
"Benin","2024-08-18",0,0,0,0,0,0,0,0
"Benin","2024-08-19",0,0,0,0,0,0,0,0
"Benin","2024-08-20",0,0,0,0,0,0,0,0
"Benin","2024-08-21",0,0,0,0,0,0,0,0
"Benin","2024-08-22",0,0,0,0,0,0,0,0
"Benin","2024-08-23",0,0,0,0,0,0,0,0
"Benin","2024-08-24",0,0,0,0,0,0,0,0
"Benin","2024-08-25",0,0,0,0,0,0,0,0
"Benin","2024-08-26",0,0,0,0,0,0,0,0
"Benin","2024-08-27",0,0,0,0,0,0,0,0
"Benin","2024-08-28",0,0,0,0,0,0,0,0
"Benin","2024-08-29",0,0,0,0,0,0,0,0
"Benin","2024-08-30",0,0,0,0,0,0,0,0
"Benin","2024-08-31",0,0,0,0,0,0,0,0
"Benin","2024-09-01",0,0,0,0,0,0,0,0
"Benin","2024-09-02",0,0,0,0,0,0,0,0
"Benin","2024-09-03",0,0,0,0,0,0,0,0
"Benin","2024-09-04",0,0,0,0,0,0,0,0
"Benin","2024-09-05",0,0,0,0,0,0,0,0
"Benin","2024-09-06",0,0,0,0,0,0,0,0
"Benin","2024-09-07",0,0,0,0,0,0,0,0
"Benin","2024-09-08",0,0,0,0,0,0,0,0
"Benin","2024-09-09",0,0,0,0,0,0,0,0
"Benin","2024-09-10",0,0,0,0,0,0,0,0
"Benin","2024-09-11",0,0,0,0,0,0,0,0
"Benin","2024-09-12",0,0,0,0,0,0,0,0
"Benin","2024-09-13",0,0,0,0,0,0,0,0
"Benin","2024-09-14",0,0,0,0,0,0,0,0
"Benin","2024-09-15",0,0,0,0,0,0,0,0
"Benin","2024-09-16",0,0,0,0,0,0,0,0
"Benin","2024-09-17",0,0,0,0,0,0,0,0
"Benin","2024-09-18",0,0,0,0,0,0,0,0
"Benin","2024-09-19",0,0,0,0,0,0,0,0
"Benin","2024-09-20",0,0,0,0,0,0,0,0
"Benin","2024-09-21",0,0,0,0,0,0,0,0
"Benin","2024-09-22",0,0,0,0,0,0,0,0
"Benin","2024-09-23",0,0,0,0,0,0,0,0
"Benin","2024-09-24",0,0,0,0,0,0,0,0
"Benin","2024-09-25",0,0,0,0,0,0,0,0
"Benin","2024-09-26",0,0,0,0,0,0,0,0
"Benin","2024-09-27",0,0,0,0,0,0,0,0
"Benin","2024-09-28",0,0,0,0,0,0,0,0
"Benin","2024-09-29",0,0,0,0,0,0,0,0
"Benin","2024-09-30",0,0,0,0,0,0,0,0
"Benin","2024-10-01",0,0,0,0,0,0,0,0
"Benin","2024-10-02",0,0,0,0,0,0,0,0
"Benin","2024-10-03",0,0,0,0,0,0,0,0
"Benin","2024-10-04",0,0,0,0,0,0,0,0
"Benin","2024-10-05",0,0,0,0,0,0,0,0
"Benin","2024-10-06",0,0,0,0,0,0,0,0
"Benin","2024-10-07",0,0,0,0,0,0,0,0
"Benin","2024-10-08",0,0,0,0,0,0,0,0
"Benin","2024-10-09",0,0,0,0,0,0,0,0
"Benin","2024-10-10",0,0,0,0,0,0,0,0
"Benin","2024-10-11",0,0,0,0,0,0,0,0
"Benin","2024-10-12",0,0,0,0,0,0,0,0
"Benin","2024-10-13",0,0,0,0,0,0,0,0
"Benin","2024-10-14",0,0,0,0,0,0,0,0
"Benin","2024-10-15",0,0,0,0,0,0,0,0
"Benin","2024-10-16",0,0,0,0,0,0,0,0
"Benin","2024-10-17",0,0,0,0,0,0,0,0
"Benin","2024-10-18",0,0,0,0,0,0,0,0
"Benin","2024-10-19",0,0,0,0,0,0,0,0
"Benin","2024-10-20",0,0,0,0,0,0,0,0
"Benin","2024-10-21",0,0,0,0,0,0,0,0
"Benin","2024-10-22",0,0,0,0,0,0,0,0
"Benin","2024-10-23",0,0,0,0,0,0,0,0
"Benin","2024-10-24",0,0,0,0,0,0,0,0
"Benin","2024-10-25",0,0,0,0,0,0,0,0
"Benin","2024-10-26",0,0,0,0,0,0,0,0
"Benin","2024-10-27",0,0,0,0,0,0,0,0
"Benin","2024-10-28",0,0,0,0,0,0,0,0
"Benin","2024-10-29",0,0,0,0,0,0,0,0
"Benin","2024-10-30",0,0,0,0,0,0,0,0
"Benin","2024-10-31",0,0,0,0,0,0,0,0
"Benin","2024-11-01",0,0,0,0,0,0,0,0
"Benin","2024-11-02",0,0,0,0,0,0,0,0
"Benin","2024-11-03",0,0,0,0,0,0,0,0
"Benin","2024-11-04",0,0,0,0,0,0,0,0
"Benin","2024-11-05",0,0,0,0,0,0,0,0
"Benin","2024-11-06",0,0,0,0,0,0,0,0
"Benin","2024-11-07",0,0,0,0,0,0,0,0
"Benin","2024-11-08",0,0,0,0,0,0,0,0
"Benin","2024-11-09",0,0,0,0,0,0,0,0
"Benin","2024-11-10",0,0,0,0,0,0,0,0
"Benin","2024-11-11",0,0,0,0,0,0,0,0
"Benin","2024-11-12",0,0,0,0,0,0,0,0
"Benin","2024-11-13",0,0,0,0,0,0,0,0
"Benin","2024-11-14",0,0,0,0,0,0,0,0
"Benin","2024-11-15",0,0,0,0,0,0,0,0
"Benin","2024-11-16",0,0,0,0,0,0,0,0
"Benin","2024-11-17",0,0,0,0,0,0,0,0
"Benin","2024-11-18",0,0,0,0,0,0,0,0
"Benin","2024-11-19",0,0,0,0,0,0,0,0
"Benin","2024-11-20",0,0,0,0,0,0,0,0
"Benin","2024-11-21",0,0,0,0,0,0,0,0
"Benin","2024-11-22",0,0,0,0,0,0,0,0
"Benin","2024-11-23",0,0,0,0,0,0,0,0
"Benin","2024-11-24",0,0,0,0,0,0,0,0
"Benin","2024-11-25",0,0,0,0,0,0,0,0
"Benin","2024-11-26",0,0,0,0,0,0,0,0
"Benin","2024-11-27",0,0,0,0,0,0,0,0
"Benin","2024-11-28",0,0,0,0,0,0,0,0
"Benin","2024-11-29",0,0,0,0,0,0,0,0
"Benin","2024-11-30",0,0,0,0,0,0,0,0
"Benin","2024-12-01",0,0,0,0,0,0,0,0
"Benin","2024-12-02",0,0,0,0,0,0,0,0
"Benin","2024-12-03",0,0,0,0,0,0,0,0
"Benin","2024-12-04",0,0,0,0,0,0,0,0
"Benin","2024-12-05",0,0,0,0,0,0,0,0
"Benin","2024-12-06",0,0,0,0,0,0,0,0
"Benin","2024-12-07",0,0,0,0,0,0,0,0
"Benin","2024-12-08",0,0,0,0,0,0,0,0
"Benin","2024-12-09",0,0,0,0,0,0,0,0
"Bermuda","2024-01-01",0,0,0,0,0,0,0,0
"Bermuda","2024-01-02",0,0,0,0,0,0,0,0
"Bermuda","2024-01-03",0,0,0,0,0,0,0,0
"Bermuda","2024-01-04",0,0,0,0,0,0,0,0
"Bermuda","2024-01-05",0,0,0,0,0,0,0,0
"Bermuda","2024-01-06",0,0,0,0,0,0,0,0
"Bermuda","2024-01-07",0,0,0,0,0,0,0,0
"Bermuda","2024-01-08",0,0,0,0,0,0,0,0
"Bermuda","2024-01-09",0,0,0,0,0,0,0,0
"Bermuda","2024-01-10",0,0,0,0,0,0,0,0
"Bermuda","2024-01-11",0,0,0,0,0,0,0,0
"Bermuda","2024-01-12",0,0,0,0,0,0,0,0
"Bermuda","2024-01-13",0,0,0,0,0,0,0,0
"Bermuda","2024-01-14",0,0,0,0,0,0,0,0
"Bermuda","2024-01-15",0,0,0,0,0,0,0,0
"Bermuda","2024-01-16",0,0,0,0,0,0,0,0
"Bermuda","2024-01-17",0,0,0,0,0,0,0,0
"Bermuda","2024-01-18",0,0,0,0,0,0,0,0
"Bermuda","2024-01-19",0,0,0,0,0,0,0,0
"Bermuda","2024-01-20",0,0,0,0,0,0,0,0
"Bermuda","2024-01-21",0,0,0,0,0,0,0,0
"Bermuda","2024-01-22",0,0,0,0,0,0,0,0
"Bermuda","2024-01-23",0,0,0,0,0,0,0,0
"Bermuda","2024-01-24",0,0,0,0,0,0,0,0
"Bermuda","2024-01-25",0,0,0,0,0,0,0,0
"Bermuda","2024-01-26",0,0,0,0,0,0,0,0
"Bermuda","2024-01-27",0,0,0,0,0,0,0,0
"Bermuda","2024-01-28",0,0,0,0,0,0,0,0
"Bermuda","2024-01-29",0,0,0,0,0,0,0,0
"Bermuda","2024-01-30",0,0,0,0,0,0,0,0
"Bermuda","2024-01-31",0,0,0,0,0,0,0,0
"Bermuda","2024-02-01",0,0,0,0,0,0,0,0
"Bermuda","2024-02-02",0,0,0,0,0,0,0,0
"Bermuda","2024-02-03",0,0,0,0,0,0,0,0
"Bermuda","2024-02-04",0,0,0,0,0,0,0,0
"Bermuda","2024-02-05",0,0,0,0,0,0,0,0
"Bermuda","2024-02-06",0,0,0,0,0,0,0,0
"Bermuda","2024-02-07",0,0,0,0,0,0,0,0
"Bermuda","2024-02-08",0,0,0,0,0,0,0,0
"Bermuda","2024-02-09",0,0,0,0,0,0,0,0
"Bermuda","2024-02-10",0,0,0,0,0,0,0,0
"Bermuda","2024-02-11",0,0,0,0,0,0,0,0
"Bermuda","2024-02-12",0,0,0,0,0,0,0,0
"Bermuda","2024-02-13",0,0,0,0,0,0,0,0
"Bermuda","2024-02-14",0,0,0,0,0,0,0,0
"Bermuda","2024-02-15",0,0,0,0,0,0,0,0
"Bermuda","2024-02-16",0,0,0,0,0,0,0,0
"Bermuda","2024-02-17",0,0,0,0,0,0,0,0
"Bermuda","2024-02-18",0,0,0,0,0,0,0,0
"Bermuda","2024-02-19",0,0,0,0,0,0,0,0
"Bermuda","2024-02-20",0,0,0,0,0,0,0,0
"Bermuda","2024-02-21",0,0,0,0,0,0,0,0
"Bermuda","2024-02-22",0,0,0,0,0,0,0,0
"Bermuda","2024-02-23",0,0,0,0,0,0,0,0
"Bermuda","2024-02-24",0,0,0,0,0,0,0,0
"Bermuda","2024-02-25",0,0,0,0,0,0,0,0
"Bermuda","2024-02-26",0,0,0,0,0,0,0,0
"Bermuda","2024-02-27",0,0,0,0,0,0,0,0
"Bermuda","2024-02-28",0,0,0,0,0,0,0,0
"Bermuda","2024-02-29",0,0,0,0,0,0,0,0
"Bermuda","2024-03-01",0,0,0,0,0,0,0,0
"Bermuda","2024-03-02",0,0,0,0,0,0,0,0
"Bermuda","2024-03-03",0,0,0,0,0,0,0,0
"Bermuda","2024-03-04",0,0,0,0,0,0,0,0
"Bermuda","2024-03-05",0,0,0,0,0,0,0,0
"Bermuda","2024-03-06",0,0,0,0,0,0,0,0
"Bermuda","2024-03-07",0,0,0,0,0,0,0,0
"Bermuda","2024-03-08",0,0,0,0,0,0,0,0
"Bermuda","2024-03-09",0,0,0,0,0,0,0,0
"Bermuda","2024-03-10",0,0,0,0,0,0,0,0
"Bermuda","2024-03-11",0,0,0,0,0,0,0,0
"Bermuda","2024-03-12",0,0,0,0,0,0,0,0
"Bermuda","2024-03-13",0,0,0,0,0,0,0,0
"Bermuda","2024-03-14",0,0,0,0,0,0,0,0
"Bermuda","2024-03-15",0,0,0,0,0,0,0,0
"Bermuda","2024-03-16",0,0,0,0,0,0,0,0
"Bermuda","2024-03-17",0,0,0,0,0,0,0,0
"Bermuda","2024-03-18",0,0,0,0,0,0,0,0
"Bermuda","2024-03-19",0,0,0,0,0,0,0,0
"Bermuda","2024-03-20",0,0,0,0,0,0,0,0
"Bermuda","2024-03-21",0,0,0,0,0,0,0,0
"Bermuda","2024-03-22",0,0,0,0,0,0,0,0
"Bermuda","2024-03-23",0,0,0,0,0,0,0,0
"Bermuda","2024-03-24",0,0,0,0,0,0,0,0
"Bermuda","2024-03-25",0,0,0,0,0,0,0,0
"Bermuda","2024-03-26",0,0,0,0,0,0,0,0
"Bermuda","2024-03-27",0,0,0,0,0,0,0,0
"Bermuda","2024-03-28",0,0,0,0,0,0,0,0
"Bermuda","2024-03-29",0,0,0,0,0,0,0,0
"Bermuda","2024-03-30",0,0,0,0,0,0,0,0
"Bermuda","2024-03-31",0,0,0,0,0,0,0,0
"Bermuda","2024-04-01",0,0,0,0,0,0,0,0
"Bermuda","2024-04-02",0,0,0,0,0,0,0,0
"Bermuda","2024-04-03",0,0,0,0,0,0,0,0
"Bermuda","2024-04-04",0,0,0,0,0,0,0,0
"Bermuda","2024-04-05",0,0,0,0,0,0,0,0
"Bermuda","2024-04-06",0,0,0,0,0,0,0,0
"Bermuda","2024-04-07",0,0,0,0,0,0,0,0
"Bermuda","2024-04-08",0,0,0,0,0,0,0,0
"Bermuda","2024-04-09",0,0,0,0,0,0,0,0
"Bermuda","2024-04-10",0,0,0,0,0,0,0,0
"Bermuda","2024-04-11",0,0,0,0,0,0,0,0
"Bermuda","2024-04-12",0,0,0,0,0,0,0,0
"Bermuda","2024-04-13",0,0,0,0,0,0,0,0
"Bermuda","2024-04-14",0,0,0,0,0,0,0,0
"Bermuda","2024-04-15",0,0,0,0,0,0,0,0
"Bermuda","2024-04-16",0,0,0,0,0,0,0,0
"Bermuda","2024-04-17",0,0,0,0,0,0,0,0
"Bermuda","2024-04-18",0,0,0,0,0,0,0,0
"Bermuda","2024-04-19",0,0,0,0,0,0,0,0
"Bermuda","2024-04-20",0,0,0,0,0,0,0,0
"Bermuda","2024-04-21",0,0,0,0,0,0,0,0
"Bermuda","2024-04-22",0,0,0,0,0,0,0,0
"Bermuda","2024-04-23",0,0,0,0,0,0,0,0
"Bermuda","2024-04-24",0,0,0,0,0,0,0,0
"Bermuda","2024-04-25",0,0,0,0,0,0,0,0
"Bermuda","2024-04-26",0,0,0,0,0,0,0,0
"Bermuda","2024-04-27",0,0,0,0,0,0,0,0
"Bermuda","2024-04-28",0,0,0,0,0,0,0,0
"Bermuda","2024-04-29",0,0,0,0,0,0,0,0
"Bermuda","2024-04-30",0,0,0,0,0,0,0,0
"Bermuda","2024-05-01",0,0,0,0,0,0,0,0
"Bermuda","2024-05-02",0,0,0,0,0,0,0,0
"Bermuda","2024-05-03",0,0,0,0,0,0,0,0
"Bermuda","2024-05-04",0,0,0,0,0,0,0,0
"Bermuda","2024-05-05",0,0,0,0,0,0,0,0
"Bermuda","2024-05-06",0,0,0,0,0,0,0,0
"Bermuda","2024-05-07",0,0,0,0,0,0,0,0
"Bermuda","2024-05-08",0,0,0,0,0,0,0,0
"Bermuda","2024-05-09",0,0,0,0,0,0,0,0
"Bermuda","2024-05-10",0,0,0,0,0,0,0,0
"Bermuda","2024-05-11",0,0,0,0,0,0,0,0
"Bermuda","2024-05-12",0,0,0,0,0,0,0,0
"Bermuda","2024-05-13",0,0,0,0,0,0,0,0
"Bermuda","2024-05-14",0,0,0,0,0,0,0,0
"Bermuda","2024-05-15",0,0,0,0,0,0,0,0
"Bermuda","2024-05-16",0,0,0,0,0,0,0,0
"Bermuda","2024-05-17",0,0,0,0,0,0,0,0
"Bermuda","2024-05-18",0,0,0,0,0,0,0,0
"Bermuda","2024-05-19",0,0,0,0,0,0,0,0
"Bermuda","2024-05-20",0,0,0,0,0,0,0,0
"Bermuda","2024-05-21",0,0,0,0,0,0,0,0
"Bermuda","2024-05-22",0,0,0,0,0,0,0,0
"Bermuda","2024-05-23",0,0,0,0,0,0,0,0
"Bermuda","2024-05-24",0,0,0,0,0,0,0,0
"Bermuda","2024-05-25",0,0,0,0,0,0,0,0
"Bermuda","2024-05-26",0,0,0,0,0,0,0,0
"Bermuda","2024-05-27",0,0,0,0,0,0,0,0
"Bermuda","2024-05-28",0,0,0,0,0,0,0,0
"Bermuda","2024-05-29",0,0,0,0,0,0,0,0
"Bermuda","2024-05-30",0,0,0,0,0,0,0,0
"Bermuda","2024-05-31",0,0,0,0,0,0,0,0
"Bermuda","2024-06-01",0,0,0,0,0,0,0,0
"Bermuda","2024-06-02",0,0,0,0,0,0,0,0
"Bermuda","2024-06-03",0,0,0,0,0,0,0,0
"Bermuda","2024-06-04",0,0,0,0,0,0,0,0
"Bermuda","2024-06-05",0,0,0,0,0,0,0,0
"Bermuda","2024-06-06",0,0,0,0,0,0,0,0
"Bermuda","2024-06-07",0,0,0,0,0,0,0,0
"Bermuda","2024-06-08",0,0,0,0,0,0,0,0
"Bermuda","2024-06-09",0,0,0,0,0,0,0,0
"Bermuda","2024-06-10",0,0,0,0,0,0,0,0
"Bermuda","2024-06-11",0,0,0,0,0,0,0,0
"Bermuda","2024-06-12",0,0,0,0,0,0,0,0
"Bermuda","2024-06-13",0,0,0,0,0,0,0,0
"Bermuda","2024-06-14",0,0,0,0,0,0,0,0
"Bermuda","2024-06-15",0,0,0,0,0,0,0,0
"Bermuda","2024-06-16",0,0,0,0,0,0,0,0
"Bermuda","2024-06-17",0,0,0,0,0,0,0,0
"Bermuda","2024-06-18",0,0,0,0,0,0,0,0
"Bermuda","2024-06-19",0,0,0,0,0,0,0,0
"Bermuda","2024-06-20",0,0,0,0,0,0,0,0
"Bermuda","2024-06-21",0,0,0,0,0,0,0,0
"Bermuda","2024-06-22",0,0,0,0,0,0,0,0
"Bermuda","2024-06-23",0,0,0,0,0,0,0,0
"Bermuda","2024-06-24",0,0,0,0,0,0,0,0
"Bermuda","2024-06-25",0,0,0,0,0,0,0,0
"Bermuda","2024-06-26",0,0,0,0,0,0,0,0
"Bermuda","2024-06-27",0,0,0,0,0,0,0,0
"Bermuda","2024-06-28",0,0,0,0,0,0,0,0
"Bermuda","2024-06-29",0,0,0,0,0,0,0,0
"Bermuda","2024-06-30",0,0,0,0,0,0,0,0
"Bermuda","2024-07-01",0,0,0,0,0,0,0,0
"Bermuda","2024-07-02",0,0,0,0,0,0,0,0
"Bermuda","2024-07-03",0,0,0,0,0,0,0,0
"Bermuda","2024-07-04",0,0,0,0,0,0,0,0
"Bermuda","2024-07-05",0,0,0,0,0,0,0,0
"Bermuda","2024-07-06",0,0,0,0,0,0,0,0
"Bermuda","2024-07-07",0,0,0,0,0,0,0,0
"Bermuda","2024-07-08",0,0,0,0,0,0,0,0
"Bermuda","2024-07-09",0,0,0,0,0,0,0,0
"Bermuda","2024-07-10",0,0,0,0,0,0,0,0
"Bermuda","2024-07-11",0,0,0,0,0,0,0,0
"Bermuda","2024-07-12",0,0,0,0,0,0,0,0
"Bermuda","2024-07-13",0,0,0,0,0,0,0,0
"Bermuda","2024-07-14",0,0,0,0,0,0,0,0
"Bermuda","2024-07-15",0,0,0,0,0,0,0,0
"Bermuda","2024-07-16",0,0,0,0,0,0,0,0
"Bermuda","2024-07-17",0,0,0,0,0,0,0,0
"Bermuda","2024-07-18",0,0,0,0,0,0,0,0
"Bermuda","2024-07-19",0,0,0,0,0,0,0,0
"Bermuda","2024-07-20",0,0,0,0,0,0,0,0
"Bermuda","2024-07-21",0,0,0,0,0,0,0,0
"Bermuda","2024-07-22",0,0,0,0,0,0,0,0
"Bermuda","2024-07-23",0,0,0,0,0,0,0,0
"Bermuda","2024-07-24",0,0,0,0,0,0,0,0
"Bermuda","2024-07-25",0,0,0,0,0,0,0,0
"Bermuda","2024-07-26",0,0,0,0,0,0,0,0
"Bermuda","2024-07-27",0,0,0,0,0,0,0,0
"Bermuda","2024-07-28",0,0,0,0,0,0,0,0
"Bermuda","2024-07-29",0,0,0,0,0,0,0,0
"Bermuda","2024-07-30",0,0,0,0,0,0,0,0
"Bermuda","2024-07-31",0,0,0,0,0,0,0,0
"Bermuda","2024-08-01",0,0,0,0,0,0,0,0
"Bermuda","2024-08-02",0,0,0,0,0,0,0,0
"Bermuda","2024-08-03",0,0,0,0,0,0,0,0
"Bermuda","2024-08-04",0,0,0,0,0,0,0,0
"Bermuda","2024-08-05",0,0,0,0,0,0,0,0
"Bermuda","2024-08-06",0,0,0,0,0,0,0,0
"Bermuda","2024-08-07",0,0,0,0,0,0,0,0
"Bermuda","2024-08-08",0,0,0,0,0,0,0,0
"Bermuda","2024-08-09",0,0,0,0,0,0,0,0
"Bermuda","2024-08-10",0,0,0,0,0,0,0,0
"Bermuda","2024-08-11",0,0,0,0,0,0,0,0
"Bermuda","2024-08-12",0,0,0,0,0,0,0,0
"Bermuda","2024-08-13",0,0,0,0,0,0,0,0
"Bermuda","2024-08-14",0,0,0,0,0,0,0,0
"Bermuda","2024-08-15",0,0,0,0,0,0,0,0
"Bermuda","2024-08-16",0,0,0,0,0,0,0,0
"Bermuda","2024-08-17",0,0,0,0,0,0,0,0
"Bermuda","2024-08-18",0,0,0,0,0,0,0,0
"Bermuda","2024-08-19",0,0,0,0,0,0,0,0
"Bermuda","2024-08-20",0,0,0,0,0,0,0,0
"Bermuda","2024-08-21",0,0,0,0,0,0,0,0
"Bermuda","2024-08-22",0,0,0,0,0,0,0,0
"Bermuda","2024-08-23",0,0,0,0,0,0,0,0
"Bermuda","2024-08-24",0,0,0,0,0,0,0,0
"Bermuda","2024-08-25",0,0,0,0,0,0,0,0
"Bermuda","2024-08-26",0,0,0,0,0,0,0,0
"Bermuda","2024-08-27",0,0,0,0,0,0,0,0
"Bermuda","2024-08-28",0,0,0,0,0,0,0,0
"Bermuda","2024-08-29",0,0,0,0,0,0,0,0
"Bermuda","2024-08-30",0,0,0,0,0,0,0,0
"Bermuda","2024-08-31",0,0,0,0,0,0,0,0
"Bermuda","2024-09-01",0,0,0,0,0,0,0,0
"Bermuda","2024-09-02",0,0,0,0,0,0,0,0
"Bermuda","2024-09-03",0,0,0,0,0,0,0,0
"Bermuda","2024-09-04",0,0,0,0,0,0,0,0
"Bermuda","2024-09-05",0,0,0,0,0,0,0,0
"Bermuda","2024-09-06",0,0,0,0,0,0,0,0
"Bermuda","2024-09-07",0,0,0,0,0,0,0,0
"Bermuda","2024-09-08",0,0,0,0,0,0,0,0
"Bermuda","2024-09-09",0,0,0,0,0,0,0,0
"Bermuda","2024-09-10",0,0,0,0,0,0,0,0
"Bermuda","2024-09-11",0,0,0,0,0,0,0,0
"Bermuda","2024-09-12",0,0,0,0,0,0,0,0
"Bermuda","2024-09-13",0,0,0,0,0,0,0,0
"Bermuda","2024-09-14",0,0,0,0,0,0,0,0
"Bermuda","2024-09-15",0,0,0,0,0,0,0,0
"Bermuda","2024-09-16",0,0,0,0,0,0,0,0
"Bermuda","2024-09-17",0,0,0,0,0,0,0,0
"Bermuda","2024-09-18",0,0,0,0,0,0,0,0
"Bermuda","2024-09-19",0,0,0,0,0,0,0,0
"Bermuda","2024-09-20",0,0,0,0,0,0,0,0
"Bermuda","2024-09-21",0,0,0,0,0,0,0,0
"Bermuda","2024-09-22",0,0,0,0,0,0,0,0
"Bermuda","2024-09-23",0,0,0,0,0,0,0,0
"Bermuda","2024-09-24",0,0,0,0,0,0,0,0
"Bermuda","2024-09-25",0,0,0,0,0,0,0,0
"Bermuda","2024-09-26",0,0,0,0,0,0,0,0
"Bermuda","2024-09-27",0,0,0,0,0,0,0,0
"Bermuda","2024-09-28",0,0,0,0,0,0,0,0
"Bermuda","2024-09-29",0,0,0,0,0,0,0,0
"Bermuda","2024-09-30",0,0,0,0,0,0,0,0
"Bermuda","2024-10-01",0,0,0,0,0,0,0,0
"Bermuda","2024-10-02",0,0,0,0,0,0,0,0
"Bermuda","2024-10-03",0,0,0,0,0,0,0,0
"Bermuda","2024-10-04",0,0,0,0,0,0,0,0
"Bermuda","2024-10-05",0,0,0,0,0,0,0,0
"Bermuda","2024-10-06",0,0,0,0,0,0,0,0
"Bermuda","2024-10-07",0,0,0,0,0,0,0,0
"Bermuda","2024-10-08",0,0,0,0,0,0,0,0
"Bermuda","2024-10-09",0,0,0,0,0,0,0,0
"Bermuda","2024-10-10",0,0,0,0,0,0,0,0
"Bermuda","2024-10-11",0,0,0,0,0,0,0,0
"Bermuda","2024-10-12",0,0,0,0,0,0,0,0
"Bermuda","2024-10-13",0,0,0,0,0,0,0,0
"Bermuda","2024-10-14",0,0,0,0,0,0,0,0
"Bermuda","2024-10-15",0,0,0,0,0,0,0,0
"Bermuda","2024-10-16",0,0,0,0,0,0,0,0
"Bermuda","2024-10-17",0,0,0,0,0,0,0,0
"Bermuda","2024-10-18",0,0,0,0,0,0,0,0
"Bermuda","2024-10-19",0,0,0,0,0,0,0,0
"Bermuda","2024-10-20",0,0,0,0,0,0,0,0
"Bermuda","2024-10-21",0,0,0,0,0,0,0,0
"Bermuda","2024-10-22",0,0,0,0,0,0,0,0
"Bermuda","2024-10-23",0,0,0,0,0,0,0,0
"Bermuda","2024-10-24",0,0,0,0,0,0,0,0
"Bermuda","2024-10-25",0,0,0,0,0,0,0,0
"Bermuda","2024-10-26",0,0,0,0,0,0,0,0
"Bermuda","2024-10-27",0,0,0,0,0,0,0,0
"Bermuda","2024-10-28",0,0,0,0,0,0,0,0
"Bermuda","2024-10-29",0,0,0,0,0,0,0,0
"Bermuda","2024-10-30",0,0,0,0,0,0,0,0
"Bermuda","2024-10-31",0,0,0,0,0,0,0,0
"Bermuda","2024-11-01",0,0,0,0,0,0,0,0
"Bermuda","2024-11-02",0,0,0,0,0,0,0,0
"Bermuda","2024-11-03",0,0,0,0,0,0,0,0
"Bermuda","2024-11-04",0,0,0,0,0,0,0,0
"Bermuda","2024-11-05",0,0,0,0,0,0,0,0
"Bermuda","2024-11-06",0,0,0,0,0,0,0,0
"Bermuda","2024-11-07",0,0,0,0,0,0,0,0
"Bermuda","2024-11-08",0,0,0,0,0,0,0,0
"Bermuda","2024-11-09",0,0,0,0,0,0,0,0
"Bermuda","2024-11-10",0,0,0,0,0,0,0,0
"Bermuda","2024-11-11",0,0,0,0,0,0,0,0
"Bermuda","2024-11-12",0,0,0,0,0,0,0,0
"Bermuda","2024-11-13",0,0,0,0,0,0,0,0
"Bermuda","2024-11-14",0,0,0,0,0,0,0,0
"Bermuda","2024-11-15",0,0,0,0,0,0,0,0
"Bermuda","2024-11-16",0,0,0,0,0,0,0,0
"Bermuda","2024-11-17",0,0,0,0,0,0,0,0
"Bermuda","2024-11-18",0,0,0,0,0,0,0,0
"Bermuda","2024-11-19",0,0,0,0,0,0,0,0
"Bermuda","2024-11-20",0,0,0,0,0,0,0,0
"Bermuda","2024-11-21",0,0,0,0,0,0,0,0
"Bermuda","2024-11-22",0,0,0,0,0,0,0,0
"Bermuda","2024-11-23",0,0,0,0,0,0,0,0
"Bermuda","2024-11-24",0,0,0,0,0,0,0,0
"Bermuda","2024-11-25",0,0,0,0,0,0,0,0
"Bermuda","2024-11-26",0,0,0,0,0,0,0,0
"Bermuda","2024-11-27",0,0,0,0,0,0,0,0
"Bermuda","2024-11-28",0,0,0,0,0,0,0,0
"Bermuda","2024-11-29",0,0,0,0,0,0,0,0
"Bermuda","2024-11-30",0,0,0,0,0,0,0,0
"Bermuda","2024-12-01",0,0,0,0,0,0,0,0
"Bermuda","2024-12-02",0,0,0,0,0,0,0,0
"Bermuda","2024-12-03",0,0,0,0,0,0,0,0
"Bermuda","2024-12-04",0,0,0,0,0,0,0,0
"Bermuda","2024-12-05",0,0,0,0,0,0,0,0
"Bermuda","2024-12-06",0,0,0,0,0,0,0,0
"Bermuda","2024-12-07",0,0,0,0,0,0,0,0
"Bermuda","2024-12-08",0,0,0,0,0,0,0,0
"Bermuda","2024-12-09",0,0,0,0,0,0,0,0
"Bolivia (Plurinational State of)","2024-01-01",0,0,0,0,0,0,0,0
"Bolivia (Plurinational State of)","2024-01-02",0,0,0,0,0,0,0,0
"Bolivia (Plurinational State of)","2024-01-03",0,0,0,0,0,0,0,0
"Bolivia (Plurinational State of)","2024-01-04",0,0,0,0,0,0,0,0
"Bolivia (Plurinational State of)","2024-01-05",0,0,0,0,0,0,0,0
"Bolivia (Plurinational State of)","2024-01-06",0,0,0,0,0,0,0,0
"Bolivia (Plurinational State of)","2024-01-07",0,0,0,0,0,0,0,0
"Bolivia (Plurinational State of)","2024-01-08",0,0,0,0,0,0,0,0
"Bolivia (Plurinational State of)","2024-01-09",0,0,0,0,0,0,0,0
"Bolivia (Plurinational State of)","2024-01-10",0,0,0,0,0,0,0,0
"Bolivia (Plurinational State of)","2024-01-11",0,0,0,0,0,0,0,0
"Bolivia (Plurinational State of)","2024-01-12",0,0,0,0,0,0,0,0
"Bolivia (Plurinational State of)","2024-01-13",0,0,0,0,0,0,0,0
"Bolivia (Plurinational State of)","2024-01-14",0,0,0,0,0,0,0,0
"Bolivia (Plurinational State of)","2024-01-15",0,0,0,0,0,0,0,0
"Bolivia (Plurinational State of)","2024-01-16",0,0,0,0,0,0,0,0
"Bolivia (Plurinational State of)","2024-01-17",0,0,0,0,0,0,0,0
"Bolivia (Plurinational State of)","2024-01-18",0,0,0,0,0,0,0,0
"Bolivia (Plurinational State of)","2024-01-19",0,0,0,0,0,0,0,0
"Bolivia (Plurinational State of)","2024-01-20",0,0,0,0,0,0,0,0
"Bolivia (Plurinational State of)","2024-01-21",0,0,0,0,0,0,0,0
"Bolivia (Plurinational State of)","2024-01-22",0,0,0,0,0,0,0,0
"Bolivia (Plurinational State of)","2024-01-23",0,0,0,0,0,0,0,0
"Bolivia (Plurinational State of)","2024-01-24",0,0,0,0,0,0,0,0
"Bolivia (Plurinational State of)","2024-01-25",0,0,0,0,0,0,0,0
"Bolivia (Plurinational State of)","2024-01-26",0,0,0,0,0,0,0,0
"Bolivia (Plurinational State of)","2024-01-27",0,0,0,0,0,0,0,0
"Bolivia (Plurinational State of)","2024-01-28",0,0,0,0,0,0,0,0
"Bolivia (Plurinational State of)","2024-01-29",0,0,0,0,0,0,0,0
"Bolivia (Plurinational State of)","2024-01-30",0,0,0,0,0,0,0,0
"Bolivia (Plurinational State of)","2024-01-31",0,0,0,0,0,0,0,0
"Bolivia (Plurinational State of)","2024-02-01",0,0,0,0,0,0,0,0
"Bolivia (Plurinational State of)","2024-02-02",0,0,0,0,0,0,0,0
"Bolivia (Plurinational State of)","2024-02-03",0,0,0,0,0,0,0,0
"Bolivia (Plurinational State of)","2024-02-04",0,0,0,0,0,0,0,0
"Bolivia (Plurinational State of)","2024-02-05",0,0,0,0,0,0,0,0
"Bolivia (Plurinational State of)","2024-02-06",0,1,1,0,1,1,0,0
"Bolivia (Plurinational State of)","2024-02-07",0,0,1,0,0,1,0,0
"Bolivia (Plurinational State of)","2024-02-08",0,0,1,0,0,1,0,0
"Bolivia (Plurinational State of)","2024-02-09",0,0,1,0,0,1,0,0
"Bolivia (Plurinational State of)","2024-02-10",0,0,1,0,0,1,0,0
"Bolivia (Plurinational State of)","2024-02-11",0,0,1,0,0,1,0,0
"Bolivia (Plurinational State of)","2024-02-12",0,0,1,0,0,1,0,0
"Bolivia (Plurinational State of)","2024-02-13",0,0,1,0,0,1,0,0
"Bolivia (Plurinational State of)","2024-02-14",0,0,1,0,0,1,0,0
"Bolivia (Plurinational State of)","2024-02-15",0,0,1,0,0,1,0,0
"Bolivia (Plurinational State of)","2024-02-16",0,0,1,0,0,1,0,0
"Bolivia (Plurinational State of)","2024-02-17",0,0,1,0,0,1,0,0
"Bolivia (Plurinational State of)","2024-02-18",0,0,1,0,0,1,0,0
"Bolivia (Plurinational State of)","2024-02-19",0,0,1,0,0,1,0,0
"Bolivia (Plurinational State of)","2024-02-20",0,0,1,0,0,1,0,0
"Bolivia (Plurinational State of)","2024-02-21",0,0,1,0,0,1,0,0
"Bolivia (Plurinational State of)","2024-02-22",0,0,1,0,0,1,0,0
"Bolivia (Plurinational State of)","2024-02-23",0,0,1,0,0,1,0,0
"Bolivia (Plurinational State of)","2024-02-24",0,0,1,0,0,1,0,0
"Bolivia (Plurinational State of)","2024-02-25",0,0,1,0,0,1,0,0
"Bolivia (Plurinational State of)","2024-02-26",0,0,1,0,0,1,0,0
"Bolivia (Plurinational State of)","2024-02-27",0,0,1,0,0,1,0,0
"Bolivia (Plurinational State of)","2024-02-28",0,0,1,0,0,1,0,0
"Bolivia (Plurinational State of)","2024-02-29",0,0,1,0,0,1,0,0
"Bolivia (Plurinational State of)","2024-03-01",0,0,1,0,0,1,0,0
"Bolivia (Plurinational State of)","2024-03-02",0,0,1,0,0,1,0,0
"Bolivia (Plurinational State of)","2024-03-03",0,0,1,0,0,1,0,0
"Bolivia (Plurinational State of)","2024-03-04",0,0,1,0,0,1,0,0
"Bolivia (Plurinational State of)","2024-03-05",0,0,1,0,0,1,0,0
"Bolivia (Plurinational State of)","2024-03-06",0,0,1,0,0,1,0,0
"Bolivia (Plurinational State of)","2024-03-07",0,0,1,0,0,1,0,0
"Bolivia (Plurinational State of)","2024-03-08",0,0,1,0,0,1,0,0
"Bolivia (Plurinational State of)","2024-03-09",0,0,1,0,0,1,0,0
"Bolivia (Plurinational State of)","2024-03-10",0,0,1,0,0,1,0,0
"Bolivia (Plurinational State of)","2024-03-11",0,0,1,0,0,1,0,0
"Bolivia (Plurinational State of)","2024-03-12",0,0,1,0,0,1,0,0
"Bolivia (Plurinational State of)","2024-03-13",0,0,1,0,0,1,0,0
"Bolivia (Plurinational State of)","2024-03-14",0,0,1,0,0,1,0,0
"Bolivia (Plurinational State of)","2024-03-15",0,0,1,0,0,1,0,0
"Bolivia (Plurinational State of)","2024-03-16",0,0,1,0,0,1,0,0
"Bolivia (Plurinational State of)","2024-03-17",0,0,1,0,0,1,0,0
"Bolivia (Plurinational State of)","2024-03-18",0,0,1,0,0,1,0,0
"Bolivia (Plurinational State of)","2024-03-19",0,0,1,0,0,1,0,0
"Bolivia (Plurinational State of)","2024-03-20",0,0,1,0,0,1,0,0
"Bolivia (Plurinational State of)","2024-03-21",0,0,1,0,0,1,0,0
"Bolivia (Plurinational State of)","2024-03-22",0,0,1,0,0,1,0,0
"Bolivia (Plurinational State of)","2024-03-23",0,0,1,0,0,1,0,0
"Bolivia (Plurinational State of)","2024-03-24",0,0,1,0,0,1,0,0
"Bolivia (Plurinational State of)","2024-03-25",0,0,1,0,0,1,0,0
"Bolivia (Plurinational State of)","2024-03-26",0,0,1,0,0,1,0,0
"Bolivia (Plurinational State of)","2024-03-27",0,0,1,0,0,1,0,0
"Bolivia (Plurinational State of)","2024-03-28",0,0,1,0,0,1,0,0
"Bolivia (Plurinational State of)","2024-03-29",0,0,1,0,0,1,0,0
"Bolivia (Plurinational State of)","2024-03-30",0,0,1,0,0,1,0,0
"Bolivia (Plurinational State of)","2024-03-31",0,0,1,0,0,1,0,0
"Bolivia (Plurinational State of)","2024-04-01",0,0,1,0,0,1,0,0
"Bolivia (Plurinational State of)","2024-04-02",0,0,1,0,0,1,0,0
"Bolivia (Plurinational State of)","2024-04-03",0,0,1,0,0,1,0,0
"Bolivia (Plurinational State of)","2024-04-04",0,0,1,0,0,1,0,0
"Bolivia (Plurinational State of)","2024-04-05",0,0,1,0,0,1,0,0
"Bolivia (Plurinational State of)","2024-04-06",0,0,1,0,0,1,0,0
"Bolivia (Plurinational State of)","2024-04-07",0,0,1,0,0,1,0,0
"Bolivia (Plurinational State of)","2024-04-08",0,0,1,0,0,1,0,0
"Bolivia (Plurinational State of)","2024-04-09",0,0,1,0,0,1,0,0
"Bolivia (Plurinational State of)","2024-04-10",0,0,1,0,0,1,0,0
"Bolivia (Plurinational State of)","2024-04-11",0,0,1,0,0,1,0,0
"Bolivia (Plurinational State of)","2024-04-12",0,0,1,0,0,1,0,0
"Bolivia (Plurinational State of)","2024-04-13",0,0,1,0,0,1,0,0
"Bolivia (Plurinational State of)","2024-04-14",0,0,1,0,0,1,0,0
"Bolivia (Plurinational State of)","2024-04-15",0,0,1,0,0,1,0,0
"Bolivia (Plurinational State of)","2024-04-16",0,0,1,0,0,1,0,0
"Bolivia (Plurinational State of)","2024-04-17",0,0,1,0,0,1,0,0
"Bolivia (Plurinational State of)","2024-04-18",0,0,1,0,0,1,0,0
"Bolivia (Plurinational State of)","2024-04-19",0,0,1,0,0,1,0,0
"Bolivia (Plurinational State of)","2024-04-20",0,0,1,0,0,1,0,0
"Bolivia (Plurinational State of)","2024-04-21",0,0,1,0,0,1,0,0
"Bolivia (Plurinational State of)","2024-04-22",0,0,1,0,0,1,0,0
"Bolivia (Plurinational State of)","2024-04-23",0,0,1,0,0,1,0,0
"Bolivia (Plurinational State of)","2024-04-24",0,0,1,0,0,1,0,0
"Bolivia (Plurinational State of)","2024-04-25",0,0,1,0,0,1,0,0
"Bolivia (Plurinational State of)","2024-04-26",0,0,1,0,0,1,0,0
"Bolivia (Plurinational State of)","2024-04-27",0,0,1,0,0,1,0,0
"Bolivia (Plurinational State of)","2024-04-28",0,0,1,0,0,1,0,0
"Bolivia (Plurinational State of)","2024-04-29",0,0,1,0,0,1,0,0
"Bolivia (Plurinational State of)","2024-04-30",0,0,1,0,0,1,0,0
"Bolivia (Plurinational State of)","2024-05-01",0,0,1,0,0,1,0,0
"Bolivia (Plurinational State of)","2024-05-02",0,0,1,0,0,1,0,0
"Bolivia (Plurinational State of)","2024-05-03",0,0,1,0,0,1,0,0
"Bolivia (Plurinational State of)","2024-05-04",0,0,1,0,0,1,0,0
"Bolivia (Plurinational State of)","2024-05-05",0,0,1,0,0,1,0,0
"Bolivia (Plurinational State of)","2024-05-06",0,0,1,0,0,1,0,0
"Bolivia (Plurinational State of)","2024-05-07",0,0,1,0,0,1,0,0
"Bolivia (Plurinational State of)","2024-05-08",0,0,1,0,0,1,0,0
"Bolivia (Plurinational State of)","2024-05-09",0,0,1,0,0,1,0,0
"Bolivia (Plurinational State of)","2024-05-10",0,0,1,0,0,1,0,0
"Bolivia (Plurinational State of)","2024-05-11",0,0,1,0,0,1,0,0
"Bolivia (Plurinational State of)","2024-05-12",0,0,1,0,0,1,0,0
"Bolivia (Plurinational State of)","2024-05-13",0,0,1,0,0,1,0,0
"Bolivia (Plurinational State of)","2024-05-14",0,0,1,0,0,1,0,0
"Bolivia (Plurinational State of)","2024-05-15",0,0,1,0,0,1,0,0
"Bolivia (Plurinational State of)","2024-05-16",0,0,1,0,0,1,0,0
"Bolivia (Plurinational State of)","2024-05-17",0,0,1,0,0,1,0,0
"Bolivia (Plurinational State of)","2024-05-18",0,0,1,0,0,1,0,0
"Bolivia (Plurinational State of)","2024-05-19",0,0,1,0,0,1,0,0
"Bolivia (Plurinational State of)","2024-05-20",0,0,1,0,0,1,0,0
"Bolivia (Plurinational State of)","2024-05-21",0,0,1,0,0,1,0,0
"Bolivia (Plurinational State of)","2024-05-22",0,0,1,0,0,1,0,0
"Bolivia (Plurinational State of)","2024-05-23",0,0,1,0,0,1,0,0
"Bolivia (Plurinational State of)","2024-05-24",0,0,1,0,0,1,0,0
"Bolivia (Plurinational State of)","2024-05-25",0,0,1,0,0,1,0,0
"Bolivia (Plurinational State of)","2024-05-26",0,0,1,0,0,1,0,0
"Bolivia (Plurinational State of)","2024-05-27",0,0,1,0,0,1,0,0
"Bolivia (Plurinational State of)","2024-05-28",0,0,1,0,0,1,0,0
"Bolivia (Plurinational State of)","2024-05-29",0,0,1,0,0,1,0,0
"Bolivia (Plurinational State of)","2024-05-30",0,0,1,0,0,1,0,0
"Bolivia (Plurinational State of)","2024-05-31",0,0,1,0,0,1,0,0
"Bolivia (Plurinational State of)","2024-06-01",0,0,1,0,0,1,0,0
"Bolivia (Plurinational State of)","2024-06-02",0,0,1,0,0,1,0,0
"Bolivia (Plurinational State of)","2024-06-03",0,0,1,0,0,1,0,0
"Bolivia (Plurinational State of)","2024-06-04",0,0,1,0,0,1,0,0
"Bolivia (Plurinational State of)","2024-06-05",0,0,1,0,0,1,0,0
"Bolivia (Plurinational State of)","2024-06-06",0,0,1,0,0,1,0,0
"Bolivia (Plurinational State of)","2024-06-07",0,0,1,0,0,1,0,0
"Bolivia (Plurinational State of)","2024-06-08",0,0,1,0,0,1,0,0
"Bolivia (Plurinational State of)","2024-06-09",0,0,1,0,0,1,0,0
"Bolivia (Plurinational State of)","2024-06-10",0,0,1,0,0,1,0,0
"Bolivia (Plurinational State of)","2024-06-11",0,0,1,0,0,1,0,0
"Bolivia (Plurinational State of)","2024-06-12",0,0,1,0,0,1,0,0
"Bolivia (Plurinational State of)","2024-06-13",0,0,1,0,0,1,0,0
"Bolivia (Plurinational State of)","2024-06-14",0,0,1,0,0,1,0,0
"Bolivia (Plurinational State of)","2024-06-15",0,0,1,0,0,1,0,0
"Bolivia (Plurinational State of)","2024-06-16",0,0,1,0,0,1,0,0
"Bolivia (Plurinational State of)","2024-06-17",0,0,1,0,0,1,0,0
"Bolivia (Plurinational State of)","2024-06-18",0,0,1,0,0,1,0,0
"Bolivia (Plurinational State of)","2024-06-19",0,0,1,0,0,1,0,0
"Bolivia (Plurinational State of)","2024-06-20",0,0,1,0,0,1,0,0
"Bolivia (Plurinational State of)","2024-06-21",0,0,1,0,0,1,0,0
"Bolivia (Plurinational State of)","2024-06-22",0,0,1,0,0,1,0,0
"Bolivia (Plurinational State of)","2024-06-23",0,0,1,0,0,1,0,0
"Bolivia (Plurinational State of)","2024-06-24",0,0,1,0,0,1,0,0
"Bolivia (Plurinational State of)","2024-06-25",0,0,1,0,0,1,0,0
"Bolivia (Plurinational State of)","2024-06-26",0,0,1,0,0,1,0,0
"Bolivia (Plurinational State of)","2024-06-27",0,0,1,0,0,1,0,0
"Bolivia (Plurinational State of)","2024-06-28",0,0,1,0,0,1,0,0
"Bolivia (Plurinational State of)","2024-06-29",0,0,1,0,0,1,0,0
"Bolivia (Plurinational State of)","2024-06-30",0,0,1,0,0,1,0,0
"Bolivia (Plurinational State of)","2024-07-01",0,0,1,0,0,1,0,0
"Bolivia (Plurinational State of)","2024-07-02",0,0,1,0,0,1,0,0
"Bolivia (Plurinational State of)","2024-07-03",0,0,1,0,0,1,0,0
"Bolivia (Plurinational State of)","2024-07-04",0,0,1,0,0,1,0,0
"Bolivia (Plurinational State of)","2024-07-05",0,0,1,0,0,1,0,0
"Bolivia (Plurinational State of)","2024-07-06",0,0,1,0,0,1,0,0
"Bolivia (Plurinational State of)","2024-07-07",0,0,1,0,0,1,0,0
"Bolivia (Plurinational State of)","2024-07-08",0,0,1,0,0,1,0,0
"Bolivia (Plurinational State of)","2024-07-09",0,0,1,0,0,1,0,0
"Bolivia (Plurinational State of)","2024-07-10",0,0,1,0,0,1,0,0
"Bolivia (Plurinational State of)","2024-07-11",0,0,1,0,0,1,0,0
"Bolivia (Plurinational State of)","2024-07-12",0,0,1,0,0,1,0,0
"Bolivia (Plurinational State of)","2024-07-13",0,0,1,0,0,1,0,0
"Bolivia (Plurinational State of)","2024-07-14",0,0,1,0,0,1,0,0
"Bolivia (Plurinational State of)","2024-07-15",0,0,1,0,0,1,0,0
"Bolivia (Plurinational State of)","2024-07-16",0,0,1,0,0,1,0,0
"Bolivia (Plurinational State of)","2024-07-17",0,0,1,0,0,1,0,0
"Bolivia (Plurinational State of)","2024-07-18",0,0,1,0,0,1,0,0
"Bolivia (Plurinational State of)","2024-07-19",0,0,1,0,0,1,0,0
"Bolivia (Plurinational State of)","2024-07-20",0,0,1,0,0,1,0,0
"Bolivia (Plurinational State of)","2024-07-21",0,0,1,0,0,1,0,0
"Bolivia (Plurinational State of)","2024-07-22",0,0,1,0,0,1,0,0
"Bolivia (Plurinational State of)","2024-07-23",0,0,1,0,0,1,0,0
"Bolivia (Plurinational State of)","2024-07-24",0,0,1,0,0,1,0,0
"Bolivia (Plurinational State of)","2024-07-25",0,0,1,0,0,1,0,0
"Bolivia (Plurinational State of)","2024-07-26",0,0,1,0,0,1,0,0
"Bolivia (Plurinational State of)","2024-07-27",0,0,1,0,0,1,0,0
"Bolivia (Plurinational State of)","2024-07-28",0,0,1,0,0,1,0,0
"Bolivia (Plurinational State of)","2024-07-29",0,0,1,0,0,1,0,0
"Bolivia (Plurinational State of)","2024-07-30",0,0,1,0,0,1,0,0
"Bolivia (Plurinational State of)","2024-07-31",0,0,1,0,0,1,0,0
"Bolivia (Plurinational State of)","2024-08-01",0,0,1,0,0,1,0,0
"Bolivia (Plurinational State of)","2024-08-02",0,0,1,0,0,1,0,0
"Bolivia (Plurinational State of)","2024-08-03",0,0,1,0,0,1,0,0
"Bolivia (Plurinational State of)","2024-08-04",0,0,1,0,0,1,0,0
"Bolivia (Plurinational State of)","2024-08-05",0,0,1,0,0,1,0,0
"Bolivia (Plurinational State of)","2024-08-06",0,0,1,0,0,1,0,0
"Bolivia (Plurinational State of)","2024-08-07",0,0,1,0,0,1,0,0
"Bolivia (Plurinational State of)","2024-08-08",0,0,1,0,0,1,0,0
"Bolivia (Plurinational State of)","2024-08-09",0,0,1,0,0,1,0,0
"Bolivia (Plurinational State of)","2024-08-10",0,0,1,0,0,1,0,0
"Bolivia (Plurinational State of)","2024-08-11",0,0,1,0,0,1,0,0
"Bolivia (Plurinational State of)","2024-08-12",0,0,1,0,0,1,0,0
"Bolivia (Plurinational State of)","2024-08-13",0,0,1,0,0,1,0,0
"Bolivia (Plurinational State of)","2024-08-14",0,0,1,0,0,1,0,0
"Bolivia (Plurinational State of)","2024-08-15",0,0,1,0,0,1,0,0
"Bolivia (Plurinational State of)","2024-08-16",0,0,1,0,0,1,0,0
"Bolivia (Plurinational State of)","2024-08-17",0,0,1,0,0,1,0,0
"Bolivia (Plurinational State of)","2024-08-18",0,0,1,0,0,1,0,0
"Bolivia (Plurinational State of)","2024-08-19",0,0,1,0,0,1,0,0
"Bolivia (Plurinational State of)","2024-08-20",0,0,1,0,0,1,0,0
"Bolivia (Plurinational State of)","2024-08-21",0,0,1,0,0,1,0,0
"Bolivia (Plurinational State of)","2024-08-22",0,0,1,0,0,1,0,0
"Bolivia (Plurinational State of)","2024-08-23",0,0,1,0,0,1,0,0
"Bolivia (Plurinational State of)","2024-08-24",0,0,1,0,0,1,0,0
"Bolivia (Plurinational State of)","2024-08-25",0,0,1,0,0,1,0,0
"Bolivia (Plurinational State of)","2024-08-26",0,0,1,0,0,1,0,0
"Bolivia (Plurinational State of)","2024-08-27",0,0,1,0,0,1,0,0
"Bolivia (Plurinational State of)","2024-08-28",0,0,1,0,0,1,0,0
"Bolivia (Plurinational State of)","2024-08-29",0,0,1,0,0,1,0,0
"Bolivia (Plurinational State of)","2024-08-30",0,0,1,0,0,1,0,0
"Bolivia (Plurinational State of)","2024-08-31",0,0,1,0,0,1,0,0
"Bolivia (Plurinational State of)","2024-09-01",0,0,1,0,0,1,0,0
"Bolivia (Plurinational State of)","2024-09-02",0,0,1,0,0,1,0,0
"Bolivia (Plurinational State of)","2024-09-03",0,0,1,0,0,1,0,0
"Bolivia (Plurinational State of)","2024-09-04",0,0,1,0,0,1,0,0
"Bolivia (Plurinational State of)","2024-09-05",0,0,1,0,0,1,0,0
"Bolivia (Plurinational State of)","2024-09-06",0,0,1,0,0,1,0,0
"Bolivia (Plurinational State of)","2024-09-07",0,0,1,0,0,1,0,0
"Bolivia (Plurinational State of)","2024-09-08",0,0,1,0,0,1,0,0
"Bolivia (Plurinational State of)","2024-09-09",0,0,1,0,0,1,0,0
"Bolivia (Plurinational State of)","2024-09-10",0,0,1,0,0,1,0,0
"Bolivia (Plurinational State of)","2024-09-11",0,0,1,0,0,1,0,0
"Bolivia (Plurinational State of)","2024-09-12",0,0,1,0,0,1,0,0
"Bolivia (Plurinational State of)","2024-09-13",0,0,1,0,0,1,0,0
"Bolivia (Plurinational State of)","2024-09-14",0,0,1,0,0,1,0,0
"Bolivia (Plurinational State of)","2024-09-15",0,0,1,0,0,1,0,0
"Bolivia (Plurinational State of)","2024-09-16",0,0,1,0,0,1,0,0
"Bolivia (Plurinational State of)","2024-09-17",0,0,1,0,0,1,0,0
"Bolivia (Plurinational State of)","2024-09-18",0,0,1,0,0,1,0,0
"Bolivia (Plurinational State of)","2024-09-19",0,0,1,0,0,1,0,0
"Bolivia (Plurinational State of)","2024-09-20",0,0,1,0,0,1,0,0
"Bolivia (Plurinational State of)","2024-09-21",0,0,1,0,0,1,0,0
"Bolivia (Plurinational State of)","2024-09-22",0,0,1,0,0,1,0,0
"Bolivia (Plurinational State of)","2024-09-23",0,0,1,0,0,1,0,0
"Bolivia (Plurinational State of)","2024-09-24",0,0,1,0,0,1,0,0
"Bolivia (Plurinational State of)","2024-09-25",0,0,1,0,0,1,0,0
"Bolivia (Plurinational State of)","2024-09-26",0,0,1,0,0,1,0,0
"Bolivia (Plurinational State of)","2024-09-27",0,0,1,0,0,1,0,0
"Bolivia (Plurinational State of)","2024-09-28",0,0,1,0,0,1,0,0
"Bolivia (Plurinational State of)","2024-09-29",0,0,1,0,0,1,0,0
"Bolivia (Plurinational State of)","2024-09-30",0,0,1,0,0,1,0,0
"Bolivia (Plurinational State of)","2024-10-01",0,0,1,0,0,1,0,0
"Bolivia (Plurinational State of)","2024-10-02",0,0,1,0,0,1,0,0
"Bolivia (Plurinational State of)","2024-10-03",0,0,1,0,0,1,0,0
"Bolivia (Plurinational State of)","2024-10-04",0,0,1,0,0,1,0,0
"Bolivia (Plurinational State of)","2024-10-05",0,0,1,0,0,1,0,0
"Bolivia (Plurinational State of)","2024-10-06",0,0,1,0,0,1,0,0
"Bolivia (Plurinational State of)","2024-10-07",0,0,1,0,0,1,0,0
"Bolivia (Plurinational State of)","2024-10-08",0,0,1,0,0,1,0,0
"Bolivia (Plurinational State of)","2024-10-09",0,0,1,0,0,1,0,0
"Bolivia (Plurinational State of)","2024-10-10",0,0,1,0,0,1,0,0
"Bolivia (Plurinational State of)","2024-10-11",0,0,1,0,0,1,0,0
"Bolivia (Plurinational State of)","2024-10-12",0,0,1,0,0,1,0,0
"Bolivia (Plurinational State of)","2024-10-13",0,0,1,0,0,1,0,0
"Bolivia (Plurinational State of)","2024-10-14",0,0,1,0,0,1,0,0
"Bolivia (Plurinational State of)","2024-10-15",0,0,1,0,0,1,0,0
"Bolivia (Plurinational State of)","2024-10-16",0,0,1,0,0,1,0,0
"Bolivia (Plurinational State of)","2024-10-17",0,0,1,0,0,1,0,0
"Bolivia (Plurinational State of)","2024-10-18",0,0,1,0,0,1,0,0
"Bolivia (Plurinational State of)","2024-10-19",0,0,1,0,0,1,0,0
"Bolivia (Plurinational State of)","2024-10-20",0,0,1,0,0,1,0,0
"Bolivia (Plurinational State of)","2024-10-21",0,0,1,0,0,1,0,0
"Bolivia (Plurinational State of)","2024-10-22",0,0,1,0,0,1,0,0
"Bolivia (Plurinational State of)","2024-10-23",0,0,1,0,0,1,0,0
"Bolivia (Plurinational State of)","2024-10-24",0,0,1,0,0,1,0,0
"Bolivia (Plurinational State of)","2024-10-25",0,0,1,0,0,1,0,0
"Bolivia (Plurinational State of)","2024-10-26",0,0,1,0,0,1,0,0
"Bolivia (Plurinational State of)","2024-10-27",0,0,1,0,0,1,0,0
"Bolivia (Plurinational State of)","2024-10-28",0,0,1,0,0,1,0,0
"Bolivia (Plurinational State of)","2024-10-29",0,0,1,0,0,1,0,0
"Bolivia (Plurinational State of)","2024-10-30",0,0,1,0,0,1,0,0
"Bolivia (Plurinational State of)","2024-10-31",0,0,1,0,0,1,0,0
"Bolivia (Plurinational State of)","2024-11-01",0,0,1,0,0,1,0,0
"Bolivia (Plurinational State of)","2024-11-02",0,0,1,0,0,1,0,0
"Bolivia (Plurinational State of)","2024-11-03",0,0,1,0,0,1,0,0
"Bolivia (Plurinational State of)","2024-11-04",0,0,1,0,0,1,0,0
"Bolivia (Plurinational State of)","2024-11-05",0,0,1,0,0,1,0,0
"Bolivia (Plurinational State of)","2024-11-06",0,0,1,0,0,1,0,0
"Bolivia (Plurinational State of)","2024-11-07",0,0,1,0,0,1,0,0
"Bolivia (Plurinational State of)","2024-11-08",0,0,1,0,0,1,0,0
"Bolivia (Plurinational State of)","2024-11-09",0,0,1,0,0,1,0,0
"Bolivia (Plurinational State of)","2024-11-10",0,0,1,0,0,1,0,0
"Bolivia (Plurinational State of)","2024-11-11",0,0,1,0,0,1,0,0
"Bolivia (Plurinational State of)","2024-11-12",0,0,1,0,0,1,0,0
"Bolivia (Plurinational State of)","2024-11-13",0,0,1,0,0,1,0,0
"Bolivia (Plurinational State of)","2024-11-14",0,0,1,0,0,1,0,0
"Bolivia (Plurinational State of)","2024-11-15",0,0,1,0,0,1,0,0
"Bolivia (Plurinational State of)","2024-11-16",0,0,1,0,0,1,0,0
"Bolivia (Plurinational State of)","2024-11-17",0,0,1,0,0,1,0,0
"Bolivia (Plurinational State of)","2024-11-18",0,0,1,0,0,1,0,0
"Bolivia (Plurinational State of)","2024-11-19",0,0,1,0,0,1,0,0
"Bolivia (Plurinational State of)","2024-11-20",0,0,1,0,0,1,0,0
"Bolivia (Plurinational State of)","2024-11-21",0,0,1,0,0,1,0,0
"Bolivia (Plurinational State of)","2024-11-22",0,0,1,0,0,1,0,0
"Bolivia (Plurinational State of)","2024-11-23",0,0,1,0,0,1,0,0
"Bolivia (Plurinational State of)","2024-11-24",0,0,1,0,0,1,0,0
"Bolivia (Plurinational State of)","2024-11-25",0,0,1,0,0,1,0,0
"Bolivia (Plurinational State of)","2024-11-26",0,0,1,0,0,1,0,0
"Bolivia (Plurinational State of)","2024-11-27",0,0,1,0,0,1,0,0
"Bolivia (Plurinational State of)","2024-11-28",0,0,1,0,0,1,0,0
"Bolivia (Plurinational State of)","2024-11-29",0,0,1,0,0,1,0,0
"Bolivia (Plurinational State of)","2024-11-30",0,0,1,0,0,1,0,0
"Bolivia (Plurinational State of)","2024-12-01",0,0,1,0,0,1,0,0
"Bolivia (Plurinational State of)","2024-12-02",0,0,1,0,0,1,0,0
"Bolivia (Plurinational State of)","2024-12-03",0,0,1,0,0,1,0,0
"Bolivia (Plurinational State of)","2024-12-04",0,0,1,0,0,1,0,0
"Bolivia (Plurinational State of)","2024-12-05",0,0,1,0,0,1,0,0
"Bolivia (Plurinational State of)","2024-12-06",0,0,1,0,0,1,0,0
"Bolivia (Plurinational State of)","2024-12-07",0,0,1,0,0,1,0,0
"Bolivia (Plurinational State of)","2024-12-08",0,0,1,0,0,1,0,0
"Bolivia (Plurinational State of)","2024-12-09",0,0,1,0,0,1,0,0
"Bosnia and Herzegovina","2024-01-01",0,0,0,0,0,0,0,0
"Bosnia and Herzegovina","2024-01-02",0,0,0,0,0,0,0,0
"Bosnia and Herzegovina","2024-01-03",0,0,0,0,0,0,0,0
"Bosnia and Herzegovina","2024-01-04",0,0,0,0,0,0,0,0
"Bosnia and Herzegovina","2024-01-05",0,0,0,0,0,0,0,0
"Bosnia and Herzegovina","2024-01-06",0,0,0,0,0,0,0,0
"Bosnia and Herzegovina","2024-01-07",0,0,0,0,0,0,0,0
"Bosnia and Herzegovina","2024-01-08",0,0,0,0,0,0,0,0
"Bosnia and Herzegovina","2024-01-09",0,0,0,0,0,0,0,0
"Bosnia and Herzegovina","2024-01-10",0,0,0,0,0,0,0,0
"Bosnia and Herzegovina","2024-01-11",0,0,0,0,0,0,0,0
"Bosnia and Herzegovina","2024-01-12",0,0,0,0,0,0,0,0
"Bosnia and Herzegovina","2024-01-13",0,0,0,0,0,0,0,0
"Bosnia and Herzegovina","2024-01-14",0,0,0,0,0,0,0,0
"Bosnia and Herzegovina","2024-01-15",0,0,0,0,0,0,0,0
"Bosnia and Herzegovina","2024-01-16",0,0,0,0,0,0,0,0
"Bosnia and Herzegovina","2024-01-17",0,0,0,0,0,0,0,0
"Bosnia and Herzegovina","2024-01-18",0,0,0,0,0,0,0,0
"Bosnia and Herzegovina","2024-01-19",0,0,0,0,0,0,0,0
"Bosnia and Herzegovina","2024-01-20",0,0,0,0,0,0,0,0
"Bosnia and Herzegovina","2024-01-21",0,0,0,0,0,0,0,0
"Bosnia and Herzegovina","2024-01-22",0,0,0,0,0,0,0,0
"Bosnia and Herzegovina","2024-01-23",0,0,0,0,0,0,0,0
"Bosnia and Herzegovina","2024-01-24",0,0,0,0,0,0,0,0
"Bosnia and Herzegovina","2024-01-25",0,0,0,0,0,0,0,0
"Bosnia and Herzegovina","2024-01-26",0,0,0,0,0,0,0,0
"Bosnia and Herzegovina","2024-01-27",0,0,0,0,0,0,0,0
"Bosnia and Herzegovina","2024-01-28",0,0,0,0,0,0,0,0
"Bosnia and Herzegovina","2024-01-29",0,0,0,0,0,0,0,0
"Bosnia and Herzegovina","2024-01-30",0,0,0,0,0,0,0,0
"Bosnia and Herzegovina","2024-01-31",0,0,0,0,0,0,0,0
"Bosnia and Herzegovina","2024-02-01",0,0,0,0,0,0,0,0
"Bosnia and Herzegovina","2024-02-02",0,0,0,0,0,0,0,0
"Bosnia and Herzegovina","2024-02-03",0,0,0,0,0,0,0,0
"Bosnia and Herzegovina","2024-02-04",0,0,0,0,0,0,0,0
"Bosnia and Herzegovina","2024-02-05",0,0,0,0,0,0,0,0
"Bosnia and Herzegovina","2024-02-06",0,0,0,0,0,0,0,0
"Bosnia and Herzegovina","2024-02-07",0,0,0,0,0,0,0,0
"Bosnia and Herzegovina","2024-02-08",0,0,0,0,0,0,0,0
"Bosnia and Herzegovina","2024-02-09",0,0,0,0,0,0,0,0
"Bosnia and Herzegovina","2024-02-10",0,0,0,0,0,0,0,0
"Bosnia and Herzegovina","2024-02-11",0,0,0,0,0,0,0,0
"Bosnia and Herzegovina","2024-02-12",0,0,0,0,0,0,0,0
"Bosnia and Herzegovina","2024-02-13",0,0,0,0,0,0,0,0
"Bosnia and Herzegovina","2024-02-14",0,0,0,0,0,0,0,0
"Bosnia and Herzegovina","2024-02-15",0,0,0,0,0,0,0,0
"Bosnia and Herzegovina","2024-02-16",0,0,0,0,0,0,0,0
"Bosnia and Herzegovina","2024-02-17",0,0,0,0,0,0,0,0
"Bosnia and Herzegovina","2024-02-18",0,0,0,0,0,0,0,0
"Bosnia and Herzegovina","2024-02-19",0,0,0,0,0,0,0,0
"Bosnia and Herzegovina","2024-02-20",0,0,0,0,0,0,0,0
"Bosnia and Herzegovina","2024-02-21",0,0,0,0,0,0,0,0
"Bosnia and Herzegovina","2024-02-22",0,0,0,0,0,0,0,0
"Bosnia and Herzegovina","2024-02-23",0,0,0,0,0,0,0,0
"Bosnia and Herzegovina","2024-02-24",0,0,0,0,0,0,0,0
"Bosnia and Herzegovina","2024-02-25",0,0,0,0,0,0,0,0
"Bosnia and Herzegovina","2024-02-26",0,0,0,0,0,0,0,0
"Bosnia and Herzegovina","2024-02-27",0,0,0,0,0,0,0,0
"Bosnia and Herzegovina","2024-02-28",0,0,0,0,0,0,0,0
"Bosnia and Herzegovina","2024-02-29",0,0,0,0,0,0,0,0
"Bosnia and Herzegovina","2024-03-01",0,0,0,0,0,0,0,0
"Bosnia and Herzegovina","2024-03-02",0,0,0,0,0,0,0,0
"Bosnia and Herzegovina","2024-03-03",0,0,0,0,0,0,0,0
"Bosnia and Herzegovina","2024-03-04",0,0,0,0,0,0,0,0
"Bosnia and Herzegovina","2024-03-05",0,0,0,0,0,0,0,0
"Bosnia and Herzegovina","2024-03-06",0,0,0,0,0,0,0,0
"Bosnia and Herzegovina","2024-03-07",0,0,0,0,0,0,0,0
"Bosnia and Herzegovina","2024-03-08",0,0,0,0,0,0,0,0
"Bosnia and Herzegovina","2024-03-09",0,0,0,0,0,0,0,0
"Bosnia and Herzegovina","2024-03-10",0,0,0,0,0,0,0,0
"Bosnia and Herzegovina","2024-03-11",0,0,0,0,0,0,0,0
"Bosnia and Herzegovina","2024-03-12",0,0,0,0,0,0,0,0
"Bosnia and Herzegovina","2024-03-13",0,0,0,0,0,0,0,0
"Bosnia and Herzegovina","2024-03-14",0,0,0,0,0,0,0,0
"Bosnia and Herzegovina","2024-03-15",0,0,0,0,0,0,0,0
"Bosnia and Herzegovina","2024-03-16",0,0,0,0,0,0,0,0
"Bosnia and Herzegovina","2024-03-17",0,0,0,0,0,0,0,0
"Bosnia and Herzegovina","2024-03-18",0,0,0,0,0,0,0,0
"Bosnia and Herzegovina","2024-03-19",0,0,0,0,0,0,0,0
"Bosnia and Herzegovina","2024-03-20",0,0,0,0,0,0,0,0
"Bosnia and Herzegovina","2024-03-21",0,0,0,0,0,0,0,0
"Bosnia and Herzegovina","2024-03-22",0,0,0,0,0,0,0,0
"Bosnia and Herzegovina","2024-03-23",0,0,0,0,0,0,0,0
"Bosnia and Herzegovina","2024-03-24",0,0,0,0,0,0,0,0
"Bosnia and Herzegovina","2024-03-25",0,0,0,0,0,0,0,0
"Bosnia and Herzegovina","2024-03-26",0,0,0,0,0,0,0,0
"Bosnia and Herzegovina","2024-03-27",0,0,0,0,0,0,0,0
"Bosnia and Herzegovina","2024-03-28",0,0,0,0,0,0,0,0
"Bosnia and Herzegovina","2024-03-29",0,0,0,0,0,0,0,0
"Bosnia and Herzegovina","2024-03-30",0,0,0,0,0,0,0,0
"Bosnia and Herzegovina","2024-03-31",0,0,0,0,0,0,0,0
"Bosnia and Herzegovina","2024-04-01",0,0,0,0,0,0,0,0
"Bosnia and Herzegovina","2024-04-02",0,0,0,0,0,0,0,0
"Bosnia and Herzegovina","2024-04-03",0,0,0,0,0,0,0,0
"Bosnia and Herzegovina","2024-04-04",0,0,0,0,0,0,0,0
"Bosnia and Herzegovina","2024-04-05",0,0,0,0,0,0,0,0
"Bosnia and Herzegovina","2024-04-06",0,0,0,0,0,0,0,0
"Bosnia and Herzegovina","2024-04-07",0,0,0,0,0,0,0,0
"Bosnia and Herzegovina","2024-04-08",0,0,0,0,0,0,0,0
"Bosnia and Herzegovina","2024-04-09",0,0,0,0,0,0,0,0
"Bosnia and Herzegovina","2024-04-10",0,0,0,0,0,0,0,0
"Bosnia and Herzegovina","2024-04-11",0,0,0,0,0,0,0,0
"Bosnia and Herzegovina","2024-04-12",0,0,0,0,0,0,0,0
"Bosnia and Herzegovina","2024-04-13",0,0,0,0,0,0,0,0
"Bosnia and Herzegovina","2024-04-14",0,0,0,0,0,0,0,0
"Bosnia and Herzegovina","2024-04-15",0,0,0,0,0,0,0,0
"Bosnia and Herzegovina","2024-04-16",0,0,0,0,0,0,0,0
"Bosnia and Herzegovina","2024-04-17",0,0,0,0,0,0,0,0
"Bosnia and Herzegovina","2024-04-18",0,0,0,0,0,0,0,0
"Bosnia and Herzegovina","2024-04-19",0,0,0,0,0,0,0,0
"Bosnia and Herzegovina","2024-04-20",0,0,0,0,0,0,0,0
"Bosnia and Herzegovina","2024-04-21",0,0,0,0,0,0,0,0
"Bosnia and Herzegovina","2024-04-22",0,0,0,0,0,0,0,0
"Bosnia and Herzegovina","2024-04-23",0,0,0,0,0,0,0,0
"Bosnia and Herzegovina","2024-04-24",0,0,0,0,0,0,0,0
"Bosnia and Herzegovina","2024-04-25",0,0,0,0,0,0,0,0
"Bosnia and Herzegovina","2024-04-26",0,0,0,0,0,0,0,0
"Bosnia and Herzegovina","2024-04-27",0,0,0,0,0,0,0,0
"Bosnia and Herzegovina","2024-04-28",0,0,0,0,0,0,0,0
"Bosnia and Herzegovina","2024-04-29",0,0,0,0,0,0,0,0
"Bosnia and Herzegovina","2024-04-30",0,0,0,0,0,0,0,0
"Bosnia and Herzegovina","2024-05-01",0,0,0,0,0,0,0,0
"Bosnia and Herzegovina","2024-05-02",0,0,0,0,0,0,0,0
"Bosnia and Herzegovina","2024-05-03",0,0,0,0,0,0,0,0
"Bosnia and Herzegovina","2024-05-04",0,0,0,0,0,0,0,0
"Bosnia and Herzegovina","2024-05-05",0,0,0,0,0,0,0,0
"Bosnia and Herzegovina","2024-05-06",0,0,0,0,0,0,0,0
"Bosnia and Herzegovina","2024-05-07",0,0,0,0,0,0,0,0
"Bosnia and Herzegovina","2024-05-08",0,0,0,0,0,0,0,0
"Bosnia and Herzegovina","2024-05-09",0,0,0,0,0,0,0,0
"Bosnia and Herzegovina","2024-05-10",0,0,0,0,0,0,0,0
"Bosnia and Herzegovina","2024-05-11",0,0,0,0,0,0,0,0
"Bosnia and Herzegovina","2024-05-12",0,0,0,0,0,0,0,0
"Bosnia and Herzegovina","2024-05-13",0,0,0,0,0,0,0,0
"Bosnia and Herzegovina","2024-05-14",0,0,0,0,0,0,0,0
"Bosnia and Herzegovina","2024-05-15",0,0,0,0,0,0,0,0
"Bosnia and Herzegovina","2024-05-16",0,0,0,0,0,0,0,0
"Bosnia and Herzegovina","2024-05-17",0,0,0,0,0,0,0,0
"Bosnia and Herzegovina","2024-05-18",0,0,0,0,0,0,0,0
"Bosnia and Herzegovina","2024-05-19",0,0,0,0,0,0,0,0
"Bosnia and Herzegovina","2024-05-20",0,0,0,0,0,0,0,0
"Bosnia and Herzegovina","2024-05-21",0,0,0,0,0,0,0,0
"Bosnia and Herzegovina","2024-05-22",0,0,0,0,0,0,0,0
"Bosnia and Herzegovina","2024-05-23",0,0,0,0,0,0,0,0
"Bosnia and Herzegovina","2024-05-24",0,0,0,0,0,0,0,0
"Bosnia and Herzegovina","2024-05-25",0,0,0,0,0,0,0,0
"Bosnia and Herzegovina","2024-05-26",0,0,0,0,0,0,0,0
"Bosnia and Herzegovina","2024-05-27",0,0,0,0,0,0,0,0
"Bosnia and Herzegovina","2024-05-28",0,0,0,0,0,0,0,0
"Bosnia and Herzegovina","2024-05-29",0,0,0,0,0,0,0,0
"Bosnia and Herzegovina","2024-05-30",0,0,0,0,0,0,0,0
"Bosnia and Herzegovina","2024-05-31",0,0,0,0,0,0,0,0
"Bosnia and Herzegovina","2024-06-01",0,0,0,0,0,0,0,0
"Bosnia and Herzegovina","2024-06-02",0,0,0,0,0,0,0,0
"Bosnia and Herzegovina","2024-06-03",0,0,0,0,0,0,0,0
"Bosnia and Herzegovina","2024-06-04",0,0,0,0,0,0,0,0
"Bosnia and Herzegovina","2024-06-05",0,0,0,0,0,0,0,0
"Bosnia and Herzegovina","2024-06-06",0,0,0,0,0,0,0,0
"Bosnia and Herzegovina","2024-06-07",0,0,0,0,0,0,0,0
"Bosnia and Herzegovina","2024-06-08",0,0,0,0,0,0,0,0
"Bosnia and Herzegovina","2024-06-09",0,0,0,0,0,0,0,0
"Bosnia and Herzegovina","2024-06-10",0,0,0,0,0,0,0,0
"Bosnia and Herzegovina","2024-06-11",0,0,0,0,0,0,0,0
"Bosnia and Herzegovina","2024-06-12",0,0,0,0,0,0,0,0
"Bosnia and Herzegovina","2024-06-13",0,0,0,0,0,0,0,0
"Bosnia and Herzegovina","2024-06-14",0,0,0,0,0,0,0,0
"Bosnia and Herzegovina","2024-06-15",0,0,0,0,0,0,0,0
"Bosnia and Herzegovina","2024-06-16",0,0,0,0,0,0,0,0
"Bosnia and Herzegovina","2024-06-17",0,0,0,0,0,0,0,0
"Bosnia and Herzegovina","2024-06-18",0,0,0,0,0,0,0,0
"Bosnia and Herzegovina","2024-06-19",0,0,0,0,0,0,0,0
"Bosnia and Herzegovina","2024-06-20",0,0,0,0,0,0,0,0
"Bosnia and Herzegovina","2024-06-21",0,0,0,0,0,0,0,0
"Bosnia and Herzegovina","2024-06-22",0,0,0,0,0,0,0,0
"Bosnia and Herzegovina","2024-06-23",0,0,0,0,0,0,0,0
"Bosnia and Herzegovina","2024-06-24",0,0,0,0,0,0,0,0
"Bosnia and Herzegovina","2024-06-25",0,0,0,0,0,0,0,0
"Bosnia and Herzegovina","2024-06-26",0,0,0,0,0,0,0,0
"Bosnia and Herzegovina","2024-06-27",0,0,0,0,0,0,0,0
"Bosnia and Herzegovina","2024-06-28",0,0,0,0,0,0,0,0
"Bosnia and Herzegovina","2024-06-29",0,0,0,0,0,0,0,0
"Bosnia and Herzegovina","2024-06-30",0,0,0,0,0,0,0,0
"Bosnia and Herzegovina","2024-07-01",0,0,0,0,0,0,0,0
"Bosnia and Herzegovina","2024-07-02",0,0,0,0,0,0,0,0
"Bosnia and Herzegovina","2024-07-03",0,0,0,0,0,0,0,0
"Bosnia and Herzegovina","2024-07-04",0,0,0,0,0,0,0,0
"Bosnia and Herzegovina","2024-07-05",0,0,0,0,0,0,0,0
"Bosnia and Herzegovina","2024-07-06",0,0,0,0,0,0,0,0
"Bosnia and Herzegovina","2024-07-07",0,0,0,0,0,0,0,0
"Bosnia and Herzegovina","2024-07-08",0,0,0,0,0,0,0,0
"Bosnia and Herzegovina","2024-07-09",0,0,0,0,0,0,0,0
"Bosnia and Herzegovina","2024-07-10",0,0,0,0,0,0,0,0
"Bosnia and Herzegovina","2024-07-11",0,0,0,0,0,0,0,0
"Bosnia and Herzegovina","2024-07-12",0,0,0,0,0,0,0,0
"Bosnia and Herzegovina","2024-07-13",0,0,0,0,0,0,0,0
"Bosnia and Herzegovina","2024-07-14",0,0,0,0,0,0,0,0
"Bosnia and Herzegovina","2024-07-15",0,0,0,0,0,0,0,0
"Bosnia and Herzegovina","2024-07-16",0,0,0,0,0,0,0,0
"Bosnia and Herzegovina","2024-07-17",0,0,0,0,0,0,0,0
"Bosnia and Herzegovina","2024-07-18",0,0,0,0,0,0,0,0
"Bosnia and Herzegovina","2024-07-19",0,0,0,0,0,0,0,0
"Bosnia and Herzegovina","2024-07-20",0,0,0,0,0,0,0,0
"Bosnia and Herzegovina","2024-07-21",0,0,0,0,0,0,0,0
"Bosnia and Herzegovina","2024-07-22",0,0,0,0,0,0,0,0
"Bosnia and Herzegovina","2024-07-23",0,0,0,0,0,0,0,0
"Bosnia and Herzegovina","2024-07-24",0,0,0,0,0,0,0,0
"Bosnia and Herzegovina","2024-07-25",0,0,0,0,0,0,0,0
"Bosnia and Herzegovina","2024-07-26",0,0,0,0,0,0,0,0
"Bosnia and Herzegovina","2024-07-27",0,0,0,0,0,0,0,0
"Bosnia and Herzegovina","2024-07-28",0,0,0,0,0,0,0,0
"Bosnia and Herzegovina","2024-07-29",0,0,0,0,0,0,0,0
"Bosnia and Herzegovina","2024-07-30",0,0,0,0,0,0,0,0
"Bosnia and Herzegovina","2024-07-31",0,0,0,0,0,0,0,0
"Bosnia and Herzegovina","2024-08-01",0,0,0,0,0,0,0,0
"Bosnia and Herzegovina","2024-08-02",0,0,0,0,0,0,0,0
"Bosnia and Herzegovina","2024-08-03",0,0,0,0,0,0,0,0
"Bosnia and Herzegovina","2024-08-04",0,0,0,0,0,0,0,0
"Bosnia and Herzegovina","2024-08-05",0,0,0,0,0,0,0,0
"Bosnia and Herzegovina","2024-08-06",0,0,0,0,0,0,0,0
"Bosnia and Herzegovina","2024-08-07",0,0,0,0,0,0,0,0
"Bosnia and Herzegovina","2024-08-08",0,0,0,0,0,0,0,0
"Bosnia and Herzegovina","2024-08-09",0,0,0,0,0,0,0,0
"Bosnia and Herzegovina","2024-08-10",0,0,0,0,0,0,0,0
"Bosnia and Herzegovina","2024-08-11",0,0,0,0,0,0,0,0
"Bosnia and Herzegovina","2024-08-12",0,0,0,0,0,0,0,0
"Bosnia and Herzegovina","2024-08-13",0,0,0,0,0,0,0,0
"Bosnia and Herzegovina","2024-08-14",0,0,0,0,0,0,0,0
"Bosnia and Herzegovina","2024-08-15",0,0,0,0,0,0,0,0
"Bosnia and Herzegovina","2024-08-16",0,0,0,0,0,0,0,0
"Bosnia and Herzegovina","2024-08-17",0,0,0,0,0,0,0,0
"Bosnia and Herzegovina","2024-08-18",0,0,0,0,0,0,0,0
"Bosnia and Herzegovina","2024-08-19",0,0,0,0,0,0,0,0
"Bosnia and Herzegovina","2024-08-20",0,0,0,0,0,0,0,0
"Bosnia and Herzegovina","2024-08-21",0,0,0,0,0,0,0,0
"Bosnia and Herzegovina","2024-08-22",0,0,0,0,0,0,0,0
"Bosnia and Herzegovina","2024-08-23",0,0,0,0,0,0,0,0
"Bosnia and Herzegovina","2024-08-24",0,0,0,0,0,0,0,0
"Bosnia and Herzegovina","2024-08-25",0,0,0,0,0,0,0,0
"Bosnia and Herzegovina","2024-08-26",0,0,0,0,0,0,0,0
"Bosnia and Herzegovina","2024-08-27",0,0,0,0,0,0,0,0
"Bosnia and Herzegovina","2024-08-28",0,0,0,0,0,0,0,0
"Bosnia and Herzegovina","2024-08-29",0,0,0,0,0,0,0,0
"Bosnia and Herzegovina","2024-08-30",0,0,0,0,0,0,0,0
"Bosnia and Herzegovina","2024-08-31",0,0,0,0,0,0,0,0
"Bosnia and Herzegovina","2024-09-01",0,0,0,0,0,0,0,0
"Bosnia and Herzegovina","2024-09-02",0,0,0,0,0,0,0,0
"Bosnia and Herzegovina","2024-09-03",0,0,0,0,0,0,0,0
"Bosnia and Herzegovina","2024-09-04",0,0,0,0,0,0,0,0
"Bosnia and Herzegovina","2024-09-05",0,0,0,0,0,0,0,0
"Bosnia and Herzegovina","2024-09-06",0,0,0,0,0,0,0,0
"Bosnia and Herzegovina","2024-09-07",0,0,0,0,0,0,0,0
"Bosnia and Herzegovina","2024-09-08",0,0,0,0,0,0,0,0
"Bosnia and Herzegovina","2024-09-09",0,0,0,0,0,0,0,0
"Bosnia and Herzegovina","2024-09-10",0,0,0,0,0,0,0,0
"Bosnia and Herzegovina","2024-09-11",0,0,0,0,0,0,0,0
"Bosnia and Herzegovina","2024-09-12",0,0,0,0,0,0,0,0
"Bosnia and Herzegovina","2024-09-13",0,0,0,0,0,0,0,0
"Bosnia and Herzegovina","2024-09-14",0,0,0,0,0,0,0,0
"Bosnia and Herzegovina","2024-09-15",0,0,0,0,0,0,0,0
"Bosnia and Herzegovina","2024-09-16",0,0,0,0,0,0,0,0
"Bosnia and Herzegovina","2024-09-17",0,0,0,0,0,0,0,0
"Bosnia and Herzegovina","2024-09-18",0,0,0,0,0,0,0,0
"Bosnia and Herzegovina","2024-09-19",0,0,0,0,0,0,0,0
"Bosnia and Herzegovina","2024-09-20",0,0,0,0,0,0,0,0
"Bosnia and Herzegovina","2024-09-21",0,0,0,0,0,0,0,0
"Bosnia and Herzegovina","2024-09-22",0,0,0,0,0,0,0,0
"Bosnia and Herzegovina","2024-09-23",0,0,0,0,0,0,0,0
"Bosnia and Herzegovina","2024-09-24",0,0,0,0,0,0,0,0
"Bosnia and Herzegovina","2024-09-25",0,0,0,0,0,0,0,0
"Bosnia and Herzegovina","2024-09-26",0,0,0,0,0,0,0,0
"Bosnia and Herzegovina","2024-09-27",0,0,0,0,0,0,0,0
"Bosnia and Herzegovina","2024-09-28",0,0,0,0,0,0,0,0
"Bosnia and Herzegovina","2024-09-29",0,0,0,0,0,0,0,0
"Bosnia and Herzegovina","2024-09-30",0,0,0,0,0,0,0,0
"Bosnia and Herzegovina","2024-10-01",0,0,0,0,0,0,0,0
"Bosnia and Herzegovina","2024-10-02",0,0,0,0,0,0,0,0
"Bosnia and Herzegovina","2024-10-03",0,0,0,0,0,0,0,0
"Bosnia and Herzegovina","2024-10-04",0,0,0,0,0,0,0,0
"Bosnia and Herzegovina","2024-10-05",0,0,0,0,0,0,0,0
"Bosnia and Herzegovina","2024-10-06",0,0,0,0,0,0,0,0
"Bosnia and Herzegovina","2024-10-07",0,0,0,0,0,0,0,0
"Bosnia and Herzegovina","2024-10-08",0,0,0,0,0,0,0,0
"Bosnia and Herzegovina","2024-10-09",0,0,0,0,0,0,0,0
"Bosnia and Herzegovina","2024-10-10",0,0,0,0,0,0,0,0
"Bosnia and Herzegovina","2024-10-11",0,0,0,0,0,0,0,0
"Bosnia and Herzegovina","2024-10-12",0,0,0,0,0,0,0,0
"Bosnia and Herzegovina","2024-10-13",0,0,0,0,0,0,0,0
"Bosnia and Herzegovina","2024-10-14",0,0,0,0,0,0,0,0
"Bosnia and Herzegovina","2024-10-15",0,0,0,0,0,0,0,0
"Bosnia and Herzegovina","2024-10-16",0,0,0,0,0,0,0,0
"Bosnia and Herzegovina","2024-10-17",0,0,0,0,0,0,0,0
"Bosnia and Herzegovina","2024-10-18",0,0,0,0,0,0,0,0
"Bosnia and Herzegovina","2024-10-19",0,0,0,0,0,0,0,0
"Bosnia and Herzegovina","2024-10-20",0,0,0,0,0,0,0,0
"Bosnia and Herzegovina","2024-10-21",0,0,0,0,0,0,0,0
"Bosnia and Herzegovina","2024-10-22",0,0,0,0,0,0,0,0
"Bosnia and Herzegovina","2024-10-23",0,0,0,0,0,0,0,0
"Bosnia and Herzegovina","2024-10-24",0,0,0,0,0,0,0,0
"Bosnia and Herzegovina","2024-10-25",0,0,0,0,0,0,0,0
"Bosnia and Herzegovina","2024-10-26",0,0,0,0,0,0,0,0
"Bosnia and Herzegovina","2024-10-27",0,0,0,0,0,0,0,0
"Bosnia and Herzegovina","2024-10-28",0,0,0,0,0,0,0,0
"Bosnia and Herzegovina","2024-10-29",0,0,0,0,0,0,0,0
"Bosnia and Herzegovina","2024-10-30",0,0,0,0,0,0,0,0
"Bosnia and Herzegovina","2024-10-31",0,0,0,0,0,0,0,0
"Bosnia and Herzegovina","2024-11-01",0,0,0,0,0,0,0,0
"Bosnia and Herzegovina","2024-11-02",0,0,0,0,0,0,0,0
"Bosnia and Herzegovina","2024-11-03",0,0,0,0,0,0,0,0
"Bosnia and Herzegovina","2024-11-04",0,0,0,0,0,0,0,0
"Bosnia and Herzegovina","2024-11-05",0,0,0,0,0,0,0,0
"Bosnia and Herzegovina","2024-11-06",0,0,0,0,0,0,0,0
"Bosnia and Herzegovina","2024-11-07",0,0,0,0,0,0,0,0
"Bosnia and Herzegovina","2024-11-08",0,0,0,0,0,0,0,0
"Bosnia and Herzegovina","2024-11-09",0,0,0,0,0,0,0,0
"Bosnia and Herzegovina","2024-11-10",0,0,0,0,0,0,0,0
"Bosnia and Herzegovina","2024-11-11",0,0,0,0,0,0,0,0
"Bosnia and Herzegovina","2024-11-12",0,0,0,0,0,0,0,0
"Bosnia and Herzegovina","2024-11-13",0,0,0,0,0,0,0,0
"Bosnia and Herzegovina","2024-11-14",0,0,0,0,0,0,0,0
"Bosnia and Herzegovina","2024-11-15",0,0,0,0,0,0,0,0
"Bosnia and Herzegovina","2024-11-16",0,0,0,0,0,0,0,0
"Bosnia and Herzegovina","2024-11-17",0,0,0,0,0,0,0,0
"Bosnia and Herzegovina","2024-11-18",0,0,0,0,0,0,0,0
"Bosnia and Herzegovina","2024-11-19",0,0,0,0,0,0,0,0
"Bosnia and Herzegovina","2024-11-20",0,0,0,0,0,0,0,0
"Bosnia and Herzegovina","2024-11-21",0,0,0,0,0,0,0,0
"Bosnia and Herzegovina","2024-11-22",0,0,0,0,0,0,0,0
"Bosnia and Herzegovina","2024-11-23",0,0,0,0,0,0,0,0
"Bosnia and Herzegovina","2024-11-24",0,0,0,0,0,0,0,0
"Bosnia and Herzegovina","2024-11-25",0,0,0,0,0,0,0,0
"Bosnia and Herzegovina","2024-11-26",0,0,0,0,0,0,0,0
"Bosnia and Herzegovina","2024-11-27",0,0,0,0,0,0,0,0
"Bosnia and Herzegovina","2024-11-28",0,0,0,0,0,0,0,0
"Bosnia and Herzegovina","2024-11-29",0,0,0,0,0,0,0,0
"Bosnia and Herzegovina","2024-11-30",0,0,0,0,0,0,0,0
"Bosnia and Herzegovina","2024-12-01",0,0,0,0,0,0,0,0
"Bosnia and Herzegovina","2024-12-02",0,0,0,0,0,0,0,0
"Bosnia and Herzegovina","2024-12-03",0,0,0,0,0,0,0,0
"Bosnia and Herzegovina","2024-12-04",0,0,0,0,0,0,0,0
"Bosnia and Herzegovina","2024-12-05",0,0,0,0,0,0,0,0
"Bosnia and Herzegovina","2024-12-06",0,0,0,0,0,0,0,0
"Bosnia and Herzegovina","2024-12-07",0,0,0,0,0,0,0,0
"Bosnia and Herzegovina","2024-12-08",0,0,0,0,0,0,0,0
"Bosnia and Herzegovina","2024-12-09",0,0,0,0,0,0,0,0
"Brazil","2024-01-01",0,0,0,0,0,0,0,0
"Brazil","2024-01-02",0,47,47,0,47,47,0,0
"Brazil","2024-01-03",0,0,47,0,6,53,0,0
"Brazil","2024-01-04",0,0,47,0,6,59,0,0
"Brazil","2024-01-05",0,0,47,0,6,65,0,0
"Brazil","2024-01-06",0,0,47,0,5,70,0,0
"Brazil","2024-01-07",0,0,47,0,6,76,0,0
"Brazil","2024-01-08",0,0,47,0,6,82,0,0
"Brazil","2024-01-09",0,41,88,0,6,88,0,0
"Brazil","2024-01-10",0,0,88,0,6,94,0,0
"Brazil","2024-01-11",0,0,88,0,6,100,0,0
"Brazil","2024-01-12",0,0,88,0,6,106,0,0
"Brazil","2024-01-13",0,0,88,0,5,111,0,0
"Brazil","2024-01-14",0,0,88,0,6,117,0,0
"Brazil","2024-01-15",0,0,88,0,6,123,0,0
"Brazil","2024-01-16",0,41,129,0,6,129,0,0
"Brazil","2024-01-17",0,0,129,0,5,134,0,0
"Brazil","2024-01-18",0,0,129,0,4,138,0,0
"Brazil","2024-01-19",0,0,129,0,5,143,0,0
"Brazil","2024-01-20",0,0,129,0,5,148,0,0
"Brazil","2024-01-21",0,0,129,0,5,153,0,0
"Brazil","2024-01-22",0,0,129,0,4,157,0,0
"Brazil","2024-01-23",0,33,162,0,5,162,0,0
"Brazil","2024-01-24",0,0,162,0,5,167,0,0
"Brazil","2024-01-25",0,0,162,0,5,172,0,0
"Brazil","2024-01-26",0,0,162,0,5,177,0,0
"Brazil","2024-01-27",0,0,162,0,4,181,0,0
"Brazil","2024-01-28",0,0,162,0,5,186,0,0
"Brazil","2024-01-29",0,0,162,0,5,191,0,0
"Brazil","2024-01-30",0,34,196,0,5,196,0,0
"Brazil","2024-01-31",0,0,196,0,5,201,0,0
"Brazil","2024-02-01",0,0,196,0,4,205,0,0
"Brazil","2024-02-02",0,0,196,0,5,210,0,0
"Brazil","2024-02-03",0,0,196,0,4,214,0,0
"Brazil","2024-02-04",0,0,196,0,5,219,0,0
"Brazil","2024-02-05",0,0,196,0,4,223,0,0
"Brazil","2024-02-06",0,32,228,0,5,228,0,0
"Brazil","2024-02-07",0,0,228,0,5,233,0,0
"Brazil","2024-02-08",0,0,228,0,4,237,0,0
"Brazil","2024-02-09",0,0,228,0,5,242,0,0
"Brazil","2024-02-10",0,0,228,0,5,247,0,0
"Brazil","2024-02-11",0,0,228,0,5,252,0,0
"Brazil","2024-02-12",0,0,228,0,4,256,0,0
"Brazil","2024-02-13",0,33,261,0,5,261,0,0
"Brazil","2024-02-14",0,0,261,0,5,266,0,0
"Brazil","2024-02-15",0,0,261,0,5,271,0,0
"Brazil","2024-02-16",0,0,261,0,5,276,0,0
"Brazil","2024-02-17",0,0,261,0,6,282,0,0
"Brazil","2024-02-18",0,0,261,0,5,287,0,0
"Brazil","2024-02-19",0,0,261,0,5,292,0,0
"Brazil","2024-02-20",0,36,297,0,5,297,0,0
"Brazil","2024-02-21",0,0,297,0,4,301,0,0
"Brazil","2024-02-22",0,0,297,0,3,304,0,0
"Brazil","2024-02-23",0,0,297,0,4,308,0,0
"Brazil","2024-02-24",0,0,297,0,4,312,0,0
"Brazil","2024-02-25",0,0,297,0,4,316,0,0
"Brazil","2024-02-26",0,0,297,0,3,319,0,0
"Brazil","2024-02-27",0,26,323,0,4,323,0,0
"Brazil","2024-02-28",0,0,323,0,3,326,0,0
"Brazil","2024-02-29",0,0,323,0,3,329,0,0
"Brazil","2024-03-01",0,0,323,0,3,332,0,0
"Brazil","2024-03-02",0,0,323,0,3,335,0,0
"Brazil","2024-03-03",0,0,323,0,3,338,0,0
"Brazil","2024-03-04",0,0,323,0,3,341,0,0
"Brazil","2024-03-05",0,21,344,0,3,344,0,0
"Brazil","2024-03-06",0,0,344,0,3,347,0,0
"Brazil","2024-03-07",0,0,344,0,3,350,0,0
"Brazil","2024-03-08",0,0,344,0,3,353,0,0
"Brazil","2024-03-09",0,0,344,0,4,357,0,0
"Brazil","2024-03-10",0,0,344,0,3,360,0,0
"Brazil","2024-03-11",0,0,344,0,3,363,0,0
"Brazil","2024-03-12",0,22,366,0,3,366,0,0
"Brazil","2024-03-13",0,0,366,0,3,369,0,0
"Brazil","2024-03-14",0,0,366,0,3,372,0,0
"Brazil","2024-03-15",0,0,366,0,3,375,0,0
"Brazil","2024-03-16",0,0,366,0,4,379,0,0
"Brazil","2024-03-17",0,0,366,0,3,382,0,0
"Brazil","2024-03-18",0,0,366,0,3,385,0,0
"Brazil","2024-03-19",0,22,388,0,3,388,0,0
"Brazil","2024-03-20",0,0,388,0,3,391,0,0
"Brazil","2024-03-21",0,0,388,0,3,394,0,0
"Brazil","2024-03-22",0,0,388,0,3,397,0,0
"Brazil","2024-03-23",0,0,388,0,3,400,0,0
"Brazil","2024-03-24",0,0,388,0,3,403,0,0
"Brazil","2024-03-25",0,0,388,0,3,406,0,0
"Brazil","2024-03-26",0,21,409,0,3,409,0,0
"Brazil","2024-03-27",0,0,409,0,3,412,0,0
"Brazil","2024-03-28",0,0,409,0,4,416,0,0
"Brazil","2024-03-29",0,0,409,0,3,419,0,0
"Brazil","2024-03-30",0,0,409,0,4,423,0,0
"Brazil","2024-03-31",0,0,409,0,3,426,0,0
"Brazil","2024-04-01",0,0,409,0,4,430,0,0
"Brazil","2024-04-02",0,24,433,0,3,433,0,0
"Brazil","2024-04-03",0,0,433,0,3,436,0,0
"Brazil","2024-04-04",0,0,433,0,2,438,0,0
"Brazil","2024-04-05",0,0,433,0,3,441,0,0
"Brazil","2024-04-06",0,0,433,0,2,443,0,0
"Brazil","2024-04-07",0,0,433,0,3,446,0,0
"Brazil","2024-04-08",0,0,433,0,2,448,0,0
"Brazil","2024-04-09",0,18,451,0,3,451,0,0
"Brazil","2024-04-10",0,0,451,0,2,453,0,0
"Brazil","2024-04-11",0,0,451,0,1,454,0,0
"Brazil","2024-04-12",0,0,451,0,2,456,0,0
"Brazil","2024-04-13",0,0,451,0,1,457,0,0
"Brazil","2024-04-14",0,0,451,0,2,459,0,0
"Brazil","2024-04-15",0,0,451,0,1,460,0,0
"Brazil","2024-04-16",0,11,462,0,2,462,0,0
"Brazil","2024-04-17",0,0,462,0,3,465,0,0
"Brazil","2024-04-18",0,0,462,0,2,467,0,0
"Brazil","2024-04-19",0,0,462,0,3,470,0,0
"Brazil","2024-04-20",0,0,462,0,3,473,0,0
"Brazil","2024-04-21",0,0,462,0,3,476,0,0
"Brazil","2024-04-22",0,0,462,0,2,478,0,0
"Brazil","2024-04-23",0,19,481,0,3,481,0,0
"Brazil","2024-04-24",0,0,481,0,3,484,0,0
"Brazil","2024-04-25",0,0,481,0,2,486,0,0
"Brazil","2024-04-26",0,0,481,0,3,489,0,0
"Brazil","2024-04-27",0,0,481,0,3,492,0,0
"Brazil","2024-04-28",0,0,481,0,3,495,0,0
"Brazil","2024-04-29",0,0,481,0,2,497,0,0
"Brazil","2024-04-30",0,19,500,0,3,500,0,0
"Brazil","2024-05-01",0,0,500,0,2,502,0,0
"Brazil","2024-05-02",0,0,500,0,3,505,0,0
"Brazil","2024-05-03",0,0,500,0,2,507,0,0
"Brazil","2024-05-04",0,0,500,0,3,510,0,0
"Brazil","2024-05-05",0,0,500,0,2,512,0,0
"Brazil","2024-05-06",0,0,500,0,3,515,0,0
"Brazil","2024-05-07",0,17,517,0,2,517,0,0
"Brazil","2024-05-08",0,0,517,0,3,520,0,0
"Brazil","2024-05-09",0,0,517,0,2,522,0,0
"Brazil","2024-05-10",0,0,517,0,3,525,0,0
"Brazil","2024-05-11",0,0,517,0,2,527,0,0
"Brazil","2024-05-12",0,0,517,0,3,530,0,0
"Brazil","2024-05-13",0,0,517,0,2,532,0,0
"Brazil","2024-05-14",0,18,535,0,3,535,0,0
"Brazil","2024-05-15",0,0,535,0,1,536,0,0
"Brazil","2024-05-16",0,0,535,0,1,537,0,0
"Brazil","2024-05-17",0,0,535,0,1,538,0,0
"Brazil","2024-05-18",0,0,535,0,1,539,0,0
"Brazil","2024-05-19",0,0,535,0,1,540,0,0
"Brazil","2024-05-20",0,0,535,0,1,541,0,0
"Brazil","2024-05-21",0,7,542,0,1,542,0,0
"Brazil","2024-05-22",0,0,542,0,2,544,0,0
"Brazil","2024-05-23",0,0,542,0,2,546,0,0
"Brazil","2024-05-24",0,0,542,0,2,548,0,0
"Brazil","2024-05-25",0,0,542,0,3,551,0,0
"Brazil","2024-05-26",0,0,542,0,2,553,0,0
"Brazil","2024-05-27",0,0,542,0,2,555,0,0
"Brazil","2024-05-28",0,15,557,0,2,557,0,0
"Brazil","2024-05-29",0,0,557,0,2,559,0,0
"Brazil","2024-05-30",0,0,557,0,2,561,0,0
"Brazil","2024-05-31",0,0,557,0,2,563,0,0
"Brazil","2024-06-01",0,0,557,0,1,564,0,0
"Brazil","2024-06-02",0,0,557,0,2,566,0,0
"Brazil","2024-06-03",0,0,557,0,2,568,0,0
"Brazil","2024-06-04",0,13,570,0,2,570,0,0
"Brazil","2024-06-05",0,0,570,0,1,571,0,0
"Brazil","2024-06-06",0,0,570,0,1,572,0,0
"Brazil","2024-06-07",0,0,570,0,1,573,0,0
"Brazil","2024-06-08",0,0,570,0,2,575,0,0
"Brazil","2024-06-09",0,0,570,0,1,576,0,0
"Brazil","2024-06-10",0,0,570,0,1,577,0,0
"Brazil","2024-06-11",0,8,578,0,1,578,0,0
"Brazil","2024-06-12",0,0,578,0,1,579,0,0
"Brazil","2024-06-13",0,0,578,0,1,580,0,0
"Brazil","2024-06-14",0,0,578,0,1,581,0,0
"Brazil","2024-06-15",0,0,578,0,1,582,0,0
"Brazil","2024-06-16",0,0,578,0,1,583,0,0
"Brazil","2024-06-17",0,0,578,0,1,584,0,0
"Brazil","2024-06-18",0,7,585,0,1,585,0,0
"Brazil","2024-06-19",0,0,585,0,2,587,0,0
"Brazil","2024-06-20",0,0,585,0,2,589,0,0
"Brazil","2024-06-21",0,0,585,0,2,591,0,0
"Brazil","2024-06-22",0,0,585,0,2,593,0,0
"Brazil","2024-06-23",0,0,585,0,2,595,0,0
"Brazil","2024-06-24",0,0,585,0,2,597,0,0
"Brazil","2024-06-25",0,14,599,0,2,599,0,0
"Brazil","2024-06-26",0,0,599,0,2,601,0,0
"Brazil","2024-06-27",0,0,599,0,2,603,0,0
"Brazil","2024-06-28",0,0,599,0,2,605,0,0
"Brazil","2024-06-29",0,0,599,0,3,608,0,0
"Brazil","2024-06-30",0,0,599,0,2,610,0,0
"Brazil","2024-07-01",0,0,599,0,2,612,0,0
"Brazil","2024-07-02",0,15,614,0,2,614,0,0
"Brazil","2024-07-03",0,0,614,0,3,617,0,0
"Brazil","2024-07-04",0,0,614,0,3,620,0,0
"Brazil","2024-07-05",0,0,614,0,3,623,0,0
"Brazil","2024-07-06",0,0,614,0,4,627,0,0
"Brazil","2024-07-07",0,0,614,0,3,630,0,0
"Brazil","2024-07-08",0,0,614,0,3,633,0,0
"Brazil","2024-07-09",0,22,636,0,3,636,0,0
"Brazil","2024-07-10",0,0,636,0,4,640,0,0
"Brazil","2024-07-11",0,0,636,0,3,643,0,0
"Brazil","2024-07-12",0,0,636,0,4,647,0,0
"Brazil","2024-07-13",0,0,636,0,3,650,0,0
"Brazil","2024-07-14",0,0,636,0,4,654,0,0
"Brazil","2024-07-15",0,0,636,0,3,657,0,0
"Brazil","2024-07-16",0,25,661,0,4,661,0,0
"Brazil","2024-07-17",0,0,661,0,5,666,0,0
"Brazil","2024-07-18",0,0,661,0,4,670,0,0
"Brazil","2024-07-19",0,0,661,0,5,675,0,0
"Brazil","2024-07-20",0,0,661,0,4,679,0,0
"Brazil","2024-07-21",0,0,661,0,5,684,0,0
"Brazil","2024-07-22",0,0,661,0,4,688,0,0
"Brazil","2024-07-23",0,32,693,0,5,693,0,0
"Brazil","2024-07-24",0,0,693,0,5,698,0,0
"Brazil","2024-07-25",0,0,693,0,5,703,0,0
"Brazil","2024-07-26",0,0,693,0,5,708,0,0
"Brazil","2024-07-27",0,0,693,0,5,713,0,0
"Brazil","2024-07-28",0,0,693,0,5,718,0,0
"Brazil","2024-07-29",0,0,693,0,5,723,0,0
"Brazil","2024-07-30",0,35,728,0,5,728,0,0
"Brazil","2024-07-31",0,0,728,0,8,736,0,0
"Brazil","2024-08-01",0,0,728,0,9,745,0,0
"Brazil","2024-08-02",0,0,728,0,8,753,0,0
"Brazil","2024-08-03",0,0,728,0,8,761,0,0
"Brazil","2024-08-04",0,0,728,0,8,769,0,0
"Brazil","2024-08-05",0,0,728,0,9,778,0,0
"Brazil","2024-08-06",0,58,786,0,8,786,0,0
"Brazil","2024-08-07",0,0,786,0,9,795,0,0
"Brazil","2024-08-08",0,0,786,0,10,805,0,0
"Brazil","2024-08-09",0,0,786,0,9,814,0,0
"Brazil","2024-08-10",0,0,786,0,9,823,0,0
"Brazil","2024-08-11",0,0,786,0,9,832,0,0
"Brazil","2024-08-12",0,0,786,0,10,842,0,0
"Brazil","2024-08-13",0,65,851,0,9,851,0,0
"Brazil","2024-08-14",0,0,851,0,12,863,0,0
"Brazil","2024-08-15",0,0,851,0,12,875,0,0
"Brazil","2024-08-16",0,0,851,0,12,887,0,0
"Brazil","2024-08-17",0,0,851,0,12,899,0,0
"Brazil","2024-08-18",0,0,851,0,12,911,0,0
"Brazil","2024-08-19",0,0,851,0,12,923,0,0
"Brazil","2024-08-20",0,84,935,0,12,935,0,0
"Brazil","2024-08-21",0,0,935,0,12,947,0,0
"Brazil","2024-08-22",0,0,935,0,11,958,0,0
"Brazil","2024-08-23",0,0,935,0,12,970,0,0
"Brazil","2024-08-24",0,0,935,0,11,981,0,0
"Brazil","2024-08-25",0,0,935,0,12,993,0,0
"Brazil","2024-08-26",0,0,935,0,11,1004,0,0
"Brazil","2024-08-27",0,81,1016,0,12,1016,0,0
"Brazil","2024-08-28",0,0,1016,0,12,1028,0,0
"Brazil","2024-08-29",0,0,1016,0,13,1041,0,0
"Brazil","2024-08-30",0,0,1016,0,12,1053,0,0
"Brazil","2024-08-31",0,0,1016,0,13,1066,0,0
"Brazil","2024-09-01",0,0,1016,0,12,1078,0,0
"Brazil","2024-09-02",0,0,1016,0,13,1091,0,0
"Brazil","2024-09-03",0,87,1103,0,12,1103,0,0
"Brazil","2024-09-04",0,0,1103,0,9,1112,0,0
"Brazil","2024-09-05",0,0,1103,0,8,1120,0,0
"Brazil","2024-09-06",0,0,1103,0,9,1129,0,0
"Brazil","2024-09-07",0,0,1103,0,8,1137,0,0
"Brazil","2024-09-08",0,0,1103,0,9,1146,0,0
"Brazil","2024-09-09",0,0,1103,0,8,1154,0,0
"Brazil","2024-09-10",0,60,1163,0,9,1163,0,0
"Brazil","2024-09-11",0,0,1163,0,9,1172,0,0
"Brazil","2024-09-12",0,0,1163,0,8,1180,0,0
"Brazil","2024-09-13",0,0,1163,0,9,1189,0,0
"Brazil","2024-09-14",0,0,1163,0,8,1197,0,0
"Brazil","2024-09-15",0,0,1163,0,9,1206,0,0
"Brazil","2024-09-16",0,0,1163,0,8,1214,0,0
"Brazil","2024-09-17",0,60,1223,0,9,1223,0,0
"Brazil","2024-09-18",0,0,1223,0,9,1232,0,0
"Brazil","2024-09-19",0,0,1223,0,8,1240,0,0
"Brazil","2024-09-20",0,0,1223,0,9,1249,0,0
"Brazil","2024-09-21",0,0,1223,0,8,1257,0,0
"Brazil","2024-09-22",0,0,1223,0,9,1266,0,0
"Brazil","2024-09-23",0,0,1223,0,8,1274,0,0
"Brazil","2024-09-24",0,60,1283,0,9,1283,0,0
"Brazil","2024-09-25",0,0,1283,0,10,1293,0,0
"Brazil","2024-09-26",0,0,1283,0,11,1304,0,0
"Brazil","2024-09-27",0,0,1283,0,10,1314,0,0
"Brazil","2024-09-28",0,0,1283,0,10,1324,0,0
"Brazil","2024-09-29",0,0,1283,0,10,1334,0,0
"Brazil","2024-09-30",0,0,1283,0,11,1345,0,0
"Brazil","2024-10-01",0,72,1355,0,10,1355,0,0
"Brazil","2024-10-02",0,0,1355,0,8,1363,0,0
"Brazil","2024-10-03",0,0,1355,0,9,1372,0,0
"Brazil","2024-10-04",0,0,1355,0,8,1380,0,0
"Brazil","2024-10-05",0,0,1355,0,9,1389,0,0
"Brazil","2024-10-06",0,0,1355,0,8,1397,0,0
"Brazil","2024-10-07",0,0,1355,0,9,1406,0,0
"Brazil","2024-10-08",0,59,1414,0,8,1414,0,0
"Brazil","2024-10-09",0,0,1414,0,6,1420,0,0
"Brazil","2024-10-10",0,0,1414,0,7,1427,0,0
"Brazil","2024-10-11",0,0,1414,0,6,1433,0,0
"Brazil","2024-10-12",0,0,1414,0,6,1439,0,0
"Brazil","2024-10-13",0,0,1414,0,6,1445,0,0
"Brazil","2024-10-14",0,0,1414,0,7,1452,0,0
"Brazil","2024-10-15",0,44,1458,0,6,1458,0,0
"Brazil","2024-10-16",0,0,1458,0,4,1462,0,0
"Brazil","2024-10-17",0,0,1458,0,5,1467,0,0
"Brazil","2024-10-18",0,0,1458,0,4,1471,0,0
"Brazil","2024-10-19",0,0,1458,0,4,1475,0,0
"Brazil","2024-10-20",0,0,1458,0,4,1479,0,0
"Brazil","2024-10-21",0,0,1458,0,5,1484,0,0
"Brazil","2024-10-22",0,30,1488,0,4,1488,0,0
"Brazil","2024-10-23",0,0,1488,0,0,1488,0,0
"Brazil","2024-10-24",0,0,1488,0,1,1489,0,0
"Brazil","2024-10-25",0,0,1488,0,0,1489,0,0
"Brazil","2024-10-26",0,0,1488,0,0,1489,0,0
"Brazil","2024-10-27",0,0,1488,0,0,1489,0,0
"Brazil","2024-10-28",0,0,1488,0,1,1490,0,0
"Brazil","2024-10-29",0,2,1490,0,0,1490,0,0
"Brazil","2024-10-30",0,0,1490,0,0,1490,0,0
"Brazil","2024-10-31",0,0,1490,0,0,1490,0,0
"Brazil","2024-11-01",0,0,1490,0,0,1490,0,0
"Brazil","2024-11-02",0,0,1490,0,0,1490,0,0
"Brazil","2024-11-03",0,0,1490,0,0,1490,0,0
"Brazil","2024-11-04",0,0,1490,0,0,1490,0,0
"Brazil","2024-11-05",0,0,1490,0,0,1490,0,0
"Brazil","2024-11-06",0,0,1490,0,0,1490,0,0
"Brazil","2024-11-07",0,0,1490,0,0,1490,0,0
"Brazil","2024-11-08",0,0,1490,0,0,1490,0,0
"Brazil","2024-11-09",0,0,1490,0,0,1490,0,0
"Brazil","2024-11-10",0,0,1490,0,0,1490,0,0
"Brazil","2024-11-11",0,0,1490,0,0,1490,0,0
"Brazil","2024-11-12",0,0,1490,0,0,1490,0,0
"Brazil","2024-11-13",0,0,1490,0,0,1490,0,0
"Brazil","2024-11-14",0,0,1490,0,0,1490,0,0
"Brazil","2024-11-15",0,0,1490,0,0,1490,0,0
"Brazil","2024-11-16",0,0,1490,0,0,1490,0,0
"Brazil","2024-11-17",0,0,1490,0,0,1490,0,0
"Brazil","2024-11-18",0,0,1490,0,0,1490,0,0
"Brazil","2024-11-19",0,0,1490,0,0,1490,0,0
"Brazil","2024-11-20",0,0,1490,0,0,1490,0,0
"Brazil","2024-11-21",0,0,1490,0,0,1490,0,0
"Brazil","2024-11-22",0,0,1490,0,0,1490,0,0
"Brazil","2024-11-23",0,0,1490,0,0,1490,0,0
"Brazil","2024-11-24",0,0,1490,0,0,1490,0,0
"Brazil","2024-11-25",0,0,1490,0,0,1490,0,0
"Brazil","2024-11-26",0,0,1490,0,0,1490,0,0
"Brazil","2024-11-27",0,0,1490,0,0,1490,0,0
"Brazil","2024-11-28",0,0,1490,0,0,1490,0,0
"Brazil","2024-11-29",0,0,1490,0,0,1490,0,0
"Brazil","2024-11-30",0,0,1490,0,0,1490,0,0
"Brazil","2024-12-01",0,0,1490,0,0,1490,0,0
"Brazil","2024-12-02",0,0,1490,0,0,1490,0,0
"Brazil","2024-12-03",0,0,1490,0,0,1490,0,0
"Brazil","2024-12-04",0,0,1490,0,0,1490,0,0
"Brazil","2024-12-05",0,0,1490,0,0,1490,0,0
"Brazil","2024-12-06",0,0,1490,0,0,1490,0,0
"Brazil","2024-12-07",0,0,1490,0,0,1490,0,0
"Brazil","2024-12-08",0,0,1490,0,0,1490,0,0
"Brazil","2024-12-09",0,0,1490,0,0,1490,0,0
"Bulgaria","2024-01-01",0,0,0,0,0,0,0,0
"Bulgaria","2024-01-02",0,0,0,0,0,0,0,0
"Bulgaria","2024-01-03",0,0,0,0,0,0,0,0
"Bulgaria","2024-01-04",0,0,0,0,0,0,0,0
"Bulgaria","2024-01-05",0,0,0,0,0,0,0,0
"Bulgaria","2024-01-06",0,0,0,0,0,0,0,0
"Bulgaria","2024-01-07",0,0,0,0,0,0,0,0
"Bulgaria","2024-01-08",0,0,0,0,0,0,0,0
"Bulgaria","2024-01-09",0,0,0,0,0,0,0,0
"Bulgaria","2024-01-10",0,0,0,0,0,0,0,0
"Bulgaria","2024-01-11",0,0,0,0,0,0,0,0
"Bulgaria","2024-01-12",0,0,0,0,0,0,0,0
"Bulgaria","2024-01-13",0,0,0,0,0,0,0,0
"Bulgaria","2024-01-14",0,0,0,0,0,0,0,0
"Bulgaria","2024-01-15",0,0,0,0,0,0,0,0
"Bulgaria","2024-01-16",0,0,0,0,0,0,0,0
"Bulgaria","2024-01-17",0,0,0,0,0,0,0,0
"Bulgaria","2024-01-18",0,0,0,0,0,0,0,0
"Bulgaria","2024-01-19",0,0,0,0,0,0,0,0
"Bulgaria","2024-01-20",0,0,0,0,0,0,0,0
"Bulgaria","2024-01-21",0,0,0,0,0,0,0,0
"Bulgaria","2024-01-22",0,0,0,0,0,0,0,0
"Bulgaria","2024-01-23",0,0,0,0,0,0,0,0
"Bulgaria","2024-01-24",0,0,0,0,0,0,0,0
"Bulgaria","2024-01-25",0,0,0,0,0,0,0,0
"Bulgaria","2024-01-26",0,0,0,0,0,0,0,0
"Bulgaria","2024-01-27",0,0,0,0,0,0,0,0
"Bulgaria","2024-01-28",0,0,0,0,0,0,0,0
"Bulgaria","2024-01-29",0,0,0,0,0,0,0,0
"Bulgaria","2024-01-30",0,0,0,0,0,0,0,0
"Bulgaria","2024-01-31",0,0,0,0,0,0,0,0
"Bulgaria","2024-02-01",0,0,0,0,0,0,0,0
"Bulgaria","2024-02-02",0,0,0,0,0,0,0,0
"Bulgaria","2024-02-03",0,0,0,0,0,0,0,0
"Bulgaria","2024-02-04",0,0,0,0,0,0,0,0
"Bulgaria","2024-02-05",0,0,0,0,0,0,0,0
"Bulgaria","2024-02-06",0,0,0,0,0,0,0,0
"Bulgaria","2024-02-07",0,0,0,0,0,0,0,0
"Bulgaria","2024-02-08",0,0,0,0,0,0,0,0
"Bulgaria","2024-02-09",0,0,0,0,0,0,0,0
"Bulgaria","2024-02-10",0,0,0,0,0,0,0,0
"Bulgaria","2024-02-11",0,0,0,0,0,0,0,0
"Bulgaria","2024-02-12",0,0,0,0,0,0,0,0
"Bulgaria","2024-02-13",0,0,0,0,0,0,0,0
"Bulgaria","2024-02-14",0,0,0,0,0,0,0,0
"Bulgaria","2024-02-15",0,0,0,0,0,0,0,0
"Bulgaria","2024-02-16",0,0,0,0,0,0,0,0
"Bulgaria","2024-02-17",0,0,0,0,0,0,0,0
"Bulgaria","2024-02-18",0,0,0,0,0,0,0,0
"Bulgaria","2024-02-19",0,0,0,0,0,0,0,0
"Bulgaria","2024-02-20",0,0,0,0,0,0,0,0
"Bulgaria","2024-02-21",0,0,0,0,0,0,0,0
"Bulgaria","2024-02-22",0,0,0,0,0,0,0,0
"Bulgaria","2024-02-23",0,0,0,0,0,0,0,0
"Bulgaria","2024-02-24",0,0,0,0,0,0,0,0
"Bulgaria","2024-02-25",0,0,0,0,0,0,0,0
"Bulgaria","2024-02-26",0,0,0,0,0,0,0,0
"Bulgaria","2024-02-27",0,0,0,0,0,0,0,0
"Bulgaria","2024-02-28",0,0,0,0,0,0,0,0
"Bulgaria","2024-02-29",0,0,0,0,0,0,0,0
"Bulgaria","2024-03-01",0,0,0,0,0,0,0,0
"Bulgaria","2024-03-02",0,0,0,0,0,0,0,0
"Bulgaria","2024-03-03",0,0,0,0,0,0,0,0
"Bulgaria","2024-03-04",0,0,0,0,0,0,0,0
"Bulgaria","2024-03-05",0,0,0,0,0,0,0,0
"Bulgaria","2024-03-06",0,0,0,0,0,0,0,0
"Bulgaria","2024-03-07",0,0,0,0,0,0,0,0
"Bulgaria","2024-03-08",0,0,0,0,0,0,0,0
"Bulgaria","2024-03-09",0,0,0,0,0,0,0,0
"Bulgaria","2024-03-10",0,0,0,0,0,0,0,0
"Bulgaria","2024-03-11",0,0,0,0,0,0,0,0
"Bulgaria","2024-03-12",0,0,0,0,0,0,0,0
"Bulgaria","2024-03-13",0,0,0,0,0,0,0,0
"Bulgaria","2024-03-14",0,0,0,0,0,0,0,0
"Bulgaria","2024-03-15",0,0,0,0,0,0,0,0
"Bulgaria","2024-03-16",0,0,0,0,0,0,0,0
"Bulgaria","2024-03-17",0,0,0,0,0,0,0,0
"Bulgaria","2024-03-18",0,0,0,0,0,0,0,0
"Bulgaria","2024-03-19",0,0,0,0,0,0,0,0
"Bulgaria","2024-03-20",0,0,0,0,0,0,0,0
"Bulgaria","2024-03-21",0,0,0,0,0,0,0,0
"Bulgaria","2024-03-22",0,0,0,0,0,0,0,0
"Bulgaria","2024-03-23",0,0,0,0,0,0,0,0
"Bulgaria","2024-03-24",0,0,0,0,0,0,0,0
"Bulgaria","2024-03-25",0,0,0,0,0,0,0,0
"Bulgaria","2024-03-26",0,0,0,0,0,0,0,0
"Bulgaria","2024-03-27",0,0,0,0,0,0,0,0
"Bulgaria","2024-03-28",0,0,0,0,0,0,0,0
"Bulgaria","2024-03-29",0,0,0,0,0,0,0,0
"Bulgaria","2024-03-30",0,0,0,0,0,0,0,0
"Bulgaria","2024-03-31",0,0,0,0,0,0,0,0
"Bulgaria","2024-04-01",0,0,0,0,0,0,0,0
"Bulgaria","2024-04-02",0,0,0,0,0,0,0,0
"Bulgaria","2024-04-03",0,0,0,0,0,0,0,0
"Bulgaria","2024-04-04",0,0,0,0,0,0,0,0
"Bulgaria","2024-04-05",0,0,0,0,0,0,0,0
"Bulgaria","2024-04-06",0,0,0,0,0,0,0,0
"Bulgaria","2024-04-07",0,0,0,0,0,0,0,0
"Bulgaria","2024-04-08",0,0,0,0,0,0,0,0
"Bulgaria","2024-04-09",0,0,0,0,0,0,0,0
"Bulgaria","2024-04-10",0,0,0,0,0,0,0,0
"Bulgaria","2024-04-11",0,0,0,0,0,0,0,0
"Bulgaria","2024-04-12",0,0,0,0,0,0,0,0
"Bulgaria","2024-04-13",0,0,0,0,0,0,0,0
"Bulgaria","2024-04-14",0,0,0,0,0,0,0,0
"Bulgaria","2024-04-15",0,0,0,0,0,0,0,0
"Bulgaria","2024-04-16",0,0,0,0,0,0,0,0
"Bulgaria","2024-04-17",0,0,0,0,0,0,0,0
"Bulgaria","2024-04-18",0,0,0,0,0,0,0,0
"Bulgaria","2024-04-19",0,0,0,0,0,0,0,0
"Bulgaria","2024-04-20",0,0,0,0,0,0,0,0
"Bulgaria","2024-04-21",0,0,0,0,0,0,0,0
"Bulgaria","2024-04-22",0,0,0,0,0,0,0,0
"Bulgaria","2024-04-23",0,0,0,0,0,0,0,0
"Bulgaria","2024-04-24",0,0,0,0,0,0,0,0
"Bulgaria","2024-04-25",0,0,0,0,0,0,0,0
"Bulgaria","2024-04-26",0,0,0,0,0,0,0,0
"Bulgaria","2024-04-27",0,0,0,0,0,0,0,0
"Bulgaria","2024-04-28",0,0,0,0,0,0,0,0
"Bulgaria","2024-04-29",0,0,0,0,0,0,0,0
"Bulgaria","2024-04-30",0,0,0,0,0,0,0,0
"Bulgaria","2024-05-01",0,0,0,0,0,0,0,0
"Bulgaria","2024-05-02",0,0,0,0,0,0,0,0
"Bulgaria","2024-05-03",0,0,0,0,0,0,0,0
"Bulgaria","2024-05-04",0,0,0,0,0,0,0,0
"Bulgaria","2024-05-05",0,0,0,0,0,0,0,0
"Bulgaria","2024-05-06",0,0,0,0,0,0,0,0
"Bulgaria","2024-05-07",0,0,0,0,0,0,0,0
"Bulgaria","2024-05-08",0,0,0,0,0,0,0,0
"Bulgaria","2024-05-09",0,0,0,0,0,0,0,0
"Bulgaria","2024-05-10",0,0,0,0,0,0,0,0
"Bulgaria","2024-05-11",0,0,0,0,0,0,0,0
"Bulgaria","2024-05-12",0,0,0,0,0,0,0,0
"Bulgaria","2024-05-13",0,0,0,0,0,0,0,0
"Bulgaria","2024-05-14",0,0,0,0,0,0,0,0
"Bulgaria","2024-05-15",0,0,0,0,0,0,0,0
"Bulgaria","2024-05-16",0,0,0,0,0,0,0,0
"Bulgaria","2024-05-17",0,0,0,0,0,0,0,0
"Bulgaria","2024-05-18",0,0,0,0,0,0,0,0
"Bulgaria","2024-05-19",0,0,0,0,0,0,0,0
"Bulgaria","2024-05-20",0,0,0,0,0,0,0,0
"Bulgaria","2024-05-21",0,0,0,0,0,0,0,0
"Bulgaria","2024-05-22",0,0,0,0,0,0,0,0
"Bulgaria","2024-05-23",0,0,0,0,0,0,0,0
"Bulgaria","2024-05-24",0,0,0,0,0,0,0,0
"Bulgaria","2024-05-25",0,0,0,0,0,0,0,0
"Bulgaria","2024-05-26",0,0,0,0,0,0,0,0
"Bulgaria","2024-05-27",0,0,0,0,0,0,0,0
"Bulgaria","2024-05-28",0,0,0,0,0,0,0,0
"Bulgaria","2024-05-29",0,0,0,0,0,0,0,0
"Bulgaria","2024-05-30",0,0,0,0,0,0,0,0
"Bulgaria","2024-05-31",0,1,1,0,1,1,0,0
"Bulgaria","2024-06-01",0,0,1,0,0,1,0,0
"Bulgaria","2024-06-02",0,0,1,0,0,1,0,0
"Bulgaria","2024-06-03",0,0,1,0,0,1,0,0
"Bulgaria","2024-06-04",0,0,1,0,0,1,0,0
"Bulgaria","2024-06-05",0,0,1,0,0,1,0,0
"Bulgaria","2024-06-06",0,0,1,0,0,1,0,0
"Bulgaria","2024-06-07",0,0,1,0,0,1,0,0
"Bulgaria","2024-06-08",0,0,1,0,0,1,0,0
"Bulgaria","2024-06-09",0,0,1,0,0,1,0,0
"Bulgaria","2024-06-10",0,0,1,0,0,1,0,0
"Bulgaria","2024-06-11",0,0,1,0,0,1,0,0
"Bulgaria","2024-06-12",0,0,1,0,0,1,0,0
"Bulgaria","2024-06-13",0,0,1,0,0,1,0,0
"Bulgaria","2024-06-14",0,0,1,0,0,1,0,0
"Bulgaria","2024-06-15",0,0,1,0,0,1,0,0
"Bulgaria","2024-06-16",0,0,1,0,0,1,0,0
"Bulgaria","2024-06-17",0,0,1,0,0,1,0,0
"Bulgaria","2024-06-18",0,0,1,0,0,1,0,0
"Bulgaria","2024-06-19",0,0,1,0,0,1,0,0
"Bulgaria","2024-06-20",0,0,1,0,0,1,0,0
"Bulgaria","2024-06-21",0,0,1,0,0,1,0,0
"Bulgaria","2024-06-22",0,0,1,0,0,1,0,0
"Bulgaria","2024-06-23",0,0,1,0,0,1,0,0
"Bulgaria","2024-06-24",0,0,1,0,0,1,0,0
"Bulgaria","2024-06-25",0,0,1,0,0,1,0,0
"Bulgaria","2024-06-26",0,0,1,0,0,1,0,0
"Bulgaria","2024-06-27",0,0,1,0,0,1,0,0
"Bulgaria","2024-06-28",0,0,1,0,0,1,0,0
"Bulgaria","2024-06-29",0,0,1,0,0,1,0,0
"Bulgaria","2024-06-30",0,0,1,0,0,1,0,0
"Bulgaria","2024-07-01",0,0,1,0,0,1,0,0
"Bulgaria","2024-07-02",0,0,1,0,0,1,0,0
"Bulgaria","2024-07-03",0,0,1,0,0,1,0,0
"Bulgaria","2024-07-04",0,0,1,0,0,1,0,0
"Bulgaria","2024-07-05",0,0,1,0,0,1,0,0
"Bulgaria","2024-07-06",0,0,1,0,0,1,0,0
"Bulgaria","2024-07-07",0,0,1,0,0,1,0,0
"Bulgaria","2024-07-08",0,0,1,0,0,1,0,0
"Bulgaria","2024-07-09",0,0,1,0,0,1,0,0
"Bulgaria","2024-07-10",0,0,1,0,0,1,0,0
"Bulgaria","2024-07-11",0,0,1,0,0,1,0,0
"Bulgaria","2024-07-12",0,0,1,0,0,1,0,0
"Bulgaria","2024-07-13",0,0,1,0,0,1,0,0
"Bulgaria","2024-07-14",0,0,1,0,0,1,0,0
"Bulgaria","2024-07-15",0,0,1,0,0,1,0,0
"Bulgaria","2024-07-16",0,0,1,0,0,1,0,0
"Bulgaria","2024-07-17",0,0,1,0,0,1,0,0
"Bulgaria","2024-07-18",0,0,1,0,0,1,0,0
"Bulgaria","2024-07-19",0,0,1,0,0,1,0,0
"Bulgaria","2024-07-20",0,0,1,0,0,1,0,0
"Bulgaria","2024-07-21",0,0,1,0,0,1,0,0
"Bulgaria","2024-07-22",0,0,1,0,0,1,0,0
"Bulgaria","2024-07-23",0,0,1,0,0,1,0,0
"Bulgaria","2024-07-24",0,0,1,0,0,1,0,0
"Bulgaria","2024-07-25",0,0,1,0,0,1,0,0
"Bulgaria","2024-07-26",0,0,1,0,0,1,0,0
"Bulgaria","2024-07-27",0,0,1,0,0,1,0,0
"Bulgaria","2024-07-28",0,0,1,0,0,1,0,0
"Bulgaria","2024-07-29",0,0,1,0,0,1,0,0
"Bulgaria","2024-07-30",0,0,1,0,0,1,0,0
"Bulgaria","2024-07-31",0,0,1,0,0,1,0,0
"Bulgaria","2024-08-01",0,0,1,0,0,1,0,0
"Bulgaria","2024-08-02",0,0,1,0,0,1,0,0
"Bulgaria","2024-08-03",0,0,1,0,0,1,0,0
"Bulgaria","2024-08-04",0,0,1,0,0,1,0,0
"Bulgaria","2024-08-05",0,0,1,0,0,1,0,0
"Bulgaria","2024-08-06",0,0,1,0,0,1,0,0
"Bulgaria","2024-08-07",0,0,1,0,0,1,0,0
"Bulgaria","2024-08-08",0,0,1,0,0,1,0,0
"Bulgaria","2024-08-09",0,0,1,0,0,1,0,0
"Bulgaria","2024-08-10",0,0,1,0,0,1,0,0
"Bulgaria","2024-08-11",0,0,1,0,0,1,0,0
"Bulgaria","2024-08-12",0,0,1,0,0,1,0,0
"Bulgaria","2024-08-13",0,0,1,0,0,1,0,0
"Bulgaria","2024-08-14",0,0,1,0,0,1,0,0
"Bulgaria","2024-08-15",0,0,1,0,0,1,0,0
"Bulgaria","2024-08-16",0,0,1,0,0,1,0,0
"Bulgaria","2024-08-17",0,0,1,0,0,1,0,0
"Bulgaria","2024-08-18",0,0,1,0,0,1,0,0
"Bulgaria","2024-08-19",0,0,1,0,0,1,0,0
"Bulgaria","2024-08-20",0,0,1,0,0,1,0,0
"Bulgaria","2024-08-21",0,0,1,0,0,1,0,0
"Bulgaria","2024-08-22",0,0,1,0,0,1,0,0
"Bulgaria","2024-08-23",0,0,1,0,0,1,0,0
"Bulgaria","2024-08-24",0,0,1,0,0,1,0,0
"Bulgaria","2024-08-25",0,0,1,0,0,1,0,0
"Bulgaria","2024-08-26",0,0,1,0,0,1,0,0
"Bulgaria","2024-08-27",0,0,1,0,0,1,0,0
"Bulgaria","2024-08-28",0,0,1,0,0,1,0,0
"Bulgaria","2024-08-29",0,0,1,0,0,1,0,0
"Bulgaria","2024-08-30",0,0,1,0,0,1,0,0
"Bulgaria","2024-08-31",0,0,1,0,0,1,0,0
"Bulgaria","2024-09-01",0,0,1,0,0,1,0,0
"Bulgaria","2024-09-02",0,0,1,0,0,1,0,0
"Bulgaria","2024-09-03",0,0,1,0,0,1,0,0
"Bulgaria","2024-09-04",0,0,1,0,0,1,0,0
"Bulgaria","2024-09-05",0,0,1,0,0,1,0,0
"Bulgaria","2024-09-06",0,0,1,0,0,1,0,0
"Bulgaria","2024-09-07",0,0,1,0,0,1,0,0
"Bulgaria","2024-09-08",0,0,1,0,0,1,0,0
"Bulgaria","2024-09-09",0,0,1,0,0,1,0,0
"Bulgaria","2024-09-10",0,0,1,0,0,1,0,0
"Bulgaria","2024-09-11",0,0,1,0,0,1,0,0
"Bulgaria","2024-09-12",0,0,1,0,0,1,0,0
"Bulgaria","2024-09-13",0,0,1,0,0,1,0,0
"Bulgaria","2024-09-14",0,0,1,0,0,1,0,0
"Bulgaria","2024-09-15",0,0,1,0,0,1,0,0
"Bulgaria","2024-09-16",0,0,1,0,0,1,0,0
"Bulgaria","2024-09-17",0,0,1,0,0,1,0,0
"Bulgaria","2024-09-18",0,0,1,0,0,1,0,0
"Bulgaria","2024-09-19",0,0,1,0,0,1,0,0
"Bulgaria","2024-09-20",0,0,1,0,0,1,0,0
"Bulgaria","2024-09-21",0,0,1,0,0,1,0,0
"Bulgaria","2024-09-22",0,0,1,0,0,1,0,0
"Bulgaria","2024-09-23",0,0,1,0,0,1,0,0
"Bulgaria","2024-09-24",0,0,1,0,0,1,0,0
"Bulgaria","2024-09-25",0,0,1,0,0,1,0,0
"Bulgaria","2024-09-26",0,0,1,0,0,1,0,0
"Bulgaria","2024-09-27",0,0,1,0,0,1,0,0
"Bulgaria","2024-09-28",0,0,1,0,0,1,0,0
"Bulgaria","2024-09-29",0,0,1,0,0,1,0,0
"Bulgaria","2024-09-30",0,0,1,0,0,1,0,0
"Bulgaria","2024-10-01",0,0,1,0,0,1,0,0
"Bulgaria","2024-10-02",0,0,1,0,0,1,0,0
"Bulgaria","2024-10-03",0,0,1,0,0,1,0,0
"Bulgaria","2024-10-04",0,0,1,0,0,1,0,0
"Bulgaria","2024-10-05",0,0,1,0,0,1,0,0
"Bulgaria","2024-10-06",0,0,1,0,0,1,0,0
"Bulgaria","2024-10-07",0,0,1,0,0,1,0,0
"Bulgaria","2024-10-08",0,0,1,0,0,1,0,0
"Bulgaria","2024-10-09",0,0,1,0,0,1,0,0
"Bulgaria","2024-10-10",0,0,1,0,0,1,0,0
"Bulgaria","2024-10-11",0,0,1,0,0,1,0,0
"Bulgaria","2024-10-12",0,0,1,0,0,1,0,0
"Bulgaria","2024-10-13",0,0,1,0,0,1,0,0
"Bulgaria","2024-10-14",0,0,1,0,0,1,0,0
"Bulgaria","2024-10-15",0,0,1,0,0,1,0,0
"Bulgaria","2024-10-16",0,0,1,0,0,1,0,0
"Bulgaria","2024-10-17",0,0,1,0,0,1,0,0
"Bulgaria","2024-10-18",0,0,1,0,0,1,0,0
"Bulgaria","2024-10-19",0,0,1,0,0,1,0,0
"Bulgaria","2024-10-20",0,0,1,0,0,1,0,0
"Bulgaria","2024-10-21",0,0,1,0,0,1,0,0
"Bulgaria","2024-10-22",0,0,1,0,0,1,0,0
"Bulgaria","2024-10-23",0,0,1,0,0,1,0,0
"Bulgaria","2024-10-24",0,0,1,0,0,1,0,0
"Bulgaria","2024-10-25",0,0,1,0,0,1,0,0
"Bulgaria","2024-10-26",0,0,1,0,0,1,0,0
"Bulgaria","2024-10-27",0,0,1,0,0,1,0,0
"Bulgaria","2024-10-28",0,0,1,0,0,1,0,0
"Bulgaria","2024-10-29",0,0,1,0,0,1,0,0
"Bulgaria","2024-10-30",0,0,1,0,0,1,0,0
"Bulgaria","2024-10-31",0,0,1,0,0,1,0,0
"Bulgaria","2024-11-01",0,0,1,0,0,1,0,0
"Bulgaria","2024-11-02",0,0,1,0,0,1,0,0
"Bulgaria","2024-11-03",0,0,1,0,0,1,0,0
"Bulgaria","2024-11-04",0,0,1,0,0,1,0,0
"Bulgaria","2024-11-05",0,0,1,0,0,1,0,0
"Bulgaria","2024-11-06",0,0,1,0,0,1,0,0
"Bulgaria","2024-11-07",0,0,1,0,0,1,0,0
"Bulgaria","2024-11-08",0,0,1,0,0,1,0,0
"Bulgaria","2024-11-09",0,0,1,0,0,1,0,0
"Bulgaria","2024-11-10",0,0,1,0,0,1,0,0
"Bulgaria","2024-11-11",0,0,1,0,0,1,0,0
"Bulgaria","2024-11-12",0,0,1,0,0,1,0,0
"Bulgaria","2024-11-13",0,0,1,0,0,1,0,0
"Bulgaria","2024-11-14",0,0,1,0,0,1,0,0
"Bulgaria","2024-11-15",0,0,1,0,0,1,0,0
"Bulgaria","2024-11-16",0,0,1,0,0,1,0,0
"Bulgaria","2024-11-17",0,0,1,0,0,1,0,0
"Bulgaria","2024-11-18",0,0,1,0,0,1,0,0
"Bulgaria","2024-11-19",0,0,1,0,0,1,0,0
"Bulgaria","2024-11-20",0,0,1,0,0,1,0,0
"Bulgaria","2024-11-21",0,0,1,0,0,1,0,0
"Bulgaria","2024-11-22",0,0,1,0,0,1,0,0
"Bulgaria","2024-11-23",0,0,1,0,0,1,0,0
"Bulgaria","2024-11-24",0,0,1,0,0,1,0,0
"Bulgaria","2024-11-25",0,0,1,0,0,1,0,0
"Bulgaria","2024-11-26",0,0,1,0,0,1,0,0
"Bulgaria","2024-11-27",0,0,1,0,0,1,0,0
"Bulgaria","2024-11-28",0,0,1,0,0,1,0,0
"Bulgaria","2024-11-29",0,0,1,0,0,1,0,0
"Bulgaria","2024-11-30",0,0,1,0,0,1,0,0
"Bulgaria","2024-12-01",0,0,1,0,0,1,0,0
"Bulgaria","2024-12-02",0,0,1,0,0,1,0,0
"Bulgaria","2024-12-03",0,0,1,0,0,1,0,0
"Bulgaria","2024-12-04",0,0,1,0,0,1,0,0
"Bulgaria","2024-12-05",0,0,1,0,0,1,0,0
"Bulgaria","2024-12-06",0,0,1,0,0,1,0,0
"Bulgaria","2024-12-07",0,0,1,0,0,1,0,0
"Bulgaria","2024-12-08",0,0,1,0,0,1,0,0
"Bulgaria","2024-12-09",0,0,1,0,0,1,0,0
"Burundi","2024-01-01",0,0,0,0,0,0,0,0
"Burundi","2024-01-02",0,0,0,0,0,0,0,0
"Burundi","2024-01-03",0,0,0,0,0,0,0,0
"Burundi","2024-01-04",0,0,0,0,0,0,0,0
"Burundi","2024-01-05",0,0,0,0,0,0,0,0
"Burundi","2024-01-06",0,0,0,0,0,0,0,0
"Burundi","2024-01-07",0,0,0,0,0,0,0,0
"Burundi","2024-01-08",0,0,0,0,0,0,0,0
"Burundi","2024-01-09",0,0,0,0,0,0,0,0
"Burundi","2024-01-10",0,0,0,0,0,0,0,0
"Burundi","2024-01-11",0,0,0,0,0,0,0,0
"Burundi","2024-01-12",0,0,0,0,0,0,0,0
"Burundi","2024-01-13",0,0,0,0,0,0,0,0
"Burundi","2024-01-14",0,0,0,0,0,0,0,0
"Burundi","2024-01-15",0,0,0,0,0,0,0,0
"Burundi","2024-01-16",0,0,0,0,0,0,0,0
"Burundi","2024-01-17",0,0,0,0,0,0,0,0
"Burundi","2024-01-18",0,0,0,0,0,0,0,0
"Burundi","2024-01-19",0,0,0,0,0,0,0,0
"Burundi","2024-01-20",0,0,0,0,0,0,0,0
"Burundi","2024-01-21",0,0,0,0,0,0,0,0
"Burundi","2024-01-22",0,0,0,0,0,0,0,0
"Burundi","2024-01-23",0,0,0,0,0,0,0,0
"Burundi","2024-01-24",0,0,0,0,0,0,0,0
"Burundi","2024-01-25",0,0,0,0,0,0,0,0
"Burundi","2024-01-26",0,0,0,0,0,0,0,0
"Burundi","2024-01-27",0,0,0,0,0,0,0,0
"Burundi","2024-01-28",0,0,0,0,0,0,0,0
"Burundi","2024-01-29",0,0,0,0,0,0,0,0
"Burundi","2024-01-30",0,0,0,0,0,0,0,0
"Burundi","2024-01-31",0,0,0,0,0,0,0,0
"Burundi","2024-02-01",0,0,0,0,0,0,0,0
"Burundi","2024-02-02",0,0,0,0,0,0,0,0
"Burundi","2024-02-03",0,0,0,0,0,0,0,0
"Burundi","2024-02-04",0,0,0,0,0,0,0,0
"Burundi","2024-02-05",0,0,0,0,0,0,0,0
"Burundi","2024-02-06",0,0,0,0,0,0,0,0
"Burundi","2024-02-07",0,0,0,0,0,0,0,0
"Burundi","2024-02-08",0,0,0,0,0,0,0,0
"Burundi","2024-02-09",0,0,0,0,0,0,0,0
"Burundi","2024-02-10",0,0,0,0,0,0,0,0
"Burundi","2024-02-11",0,0,0,0,0,0,0,0
"Burundi","2024-02-12",0,0,0,0,0,0,0,0
"Burundi","2024-02-13",0,0,0,0,0,0,0,0
"Burundi","2024-02-14",0,0,0,0,0,0,0,0
"Burundi","2024-02-15",0,0,0,0,0,0,0,0
"Burundi","2024-02-16",0,0,0,0,0,0,0,0
"Burundi","2024-02-17",0,0,0,0,0,0,0,0
"Burundi","2024-02-18",0,0,0,0,0,0,0,0
"Burundi","2024-02-19",0,0,0,0,0,0,0,0
"Burundi","2024-02-20",0,0,0,0,0,0,0,0
"Burundi","2024-02-21",0,0,0,0,0,0,0,0
"Burundi","2024-02-22",0,0,0,0,0,0,0,0
"Burundi","2024-02-23",0,0,0,0,0,0,0,0
"Burundi","2024-02-24",0,0,0,0,0,0,0,0
"Burundi","2024-02-25",0,0,0,0,0,0,0,0
"Burundi","2024-02-26",0,0,0,0,0,0,0,0
"Burundi","2024-02-27",0,0,0,0,0,0,0,0
"Burundi","2024-02-28",0,0,0,0,0,0,0,0
"Burundi","2024-02-29",0,0,0,0,0,0,0,0
"Burundi","2024-03-01",0,0,0,0,0,0,0,0
"Burundi","2024-03-02",0,0,0,0,0,0,0,0
"Burundi","2024-03-03",0,0,0,0,0,0,0,0
"Burundi","2024-03-04",0,0,0,0,0,0,0,0
"Burundi","2024-03-05",0,0,0,0,0,0,0,0
"Burundi","2024-03-06",0,0,0,0,0,0,0,0
"Burundi","2024-03-07",0,0,0,0,0,0,0,0
"Burundi","2024-03-08",0,0,0,0,0,0,0,0
"Burundi","2024-03-09",0,0,0,0,0,0,0,0
"Burundi","2024-03-10",0,0,0,0,0,0,0,0
"Burundi","2024-03-11",0,0,0,0,0,0,0,0
"Burundi","2024-03-12",0,0,0,0,0,0,0,0
"Burundi","2024-03-13",0,0,0,0,0,0,0,0
"Burundi","2024-03-14",0,0,0,0,0,0,0,0
"Burundi","2024-03-15",0,0,0,0,0,0,0,0
"Burundi","2024-03-16",0,0,0,0,0,0,0,0
"Burundi","2024-03-17",0,0,0,0,0,0,0,0
"Burundi","2024-03-18",0,0,0,0,0,0,0,0
"Burundi","2024-03-19",0,0,0,0,0,0,0,0
"Burundi","2024-03-20",0,0,0,0,0,0,0,0
"Burundi","2024-03-21",0,0,0,0,0,0,0,0
"Burundi","2024-03-22",0,0,0,0,0,0,0,0
"Burundi","2024-03-23",0,0,0,0,0,0,0,0
"Burundi","2024-03-24",0,0,0,0,0,0,0,0
"Burundi","2024-03-25",0,0,0,0,0,0,0,0
"Burundi","2024-03-26",0,0,0,0,0,0,0,0
"Burundi","2024-03-27",0,0,0,0,0,0,0,0
"Burundi","2024-03-28",0,0,0,0,0,0,0,0
"Burundi","2024-03-29",0,0,0,0,0,0,0,0
"Burundi","2024-03-30",0,0,0,0,0,0,0,0
"Burundi","2024-03-31",0,0,0,0,0,0,0,0
"Burundi","2024-04-01",0,0,0,0,0,0,0,0
"Burundi","2024-04-02",0,0,0,0,0,0,0,0
"Burundi","2024-04-03",0,0,0,0,0,0,0,0
"Burundi","2024-04-04",0,0,0,0,0,0,0,0
"Burundi","2024-04-05",0,0,0,0,0,0,0,0
"Burundi","2024-04-06",0,0,0,0,0,0,0,0
"Burundi","2024-04-07",0,0,0,0,0,0,0,0
"Burundi","2024-04-08",0,0,0,0,0,0,0,0
"Burundi","2024-04-09",0,0,0,0,0,0,0,0
"Burundi","2024-04-10",0,0,0,0,0,0,0,0
"Burundi","2024-04-11",0,0,0,0,0,0,0,0
"Burundi","2024-04-12",0,0,0,0,0,0,0,0
"Burundi","2024-04-13",0,0,0,0,0,0,0,0
"Burundi","2024-04-14",0,0,0,0,0,0,0,0
"Burundi","2024-04-15",0,0,0,0,0,0,0,0
"Burundi","2024-04-16",0,0,0,0,0,0,0,0
"Burundi","2024-04-17",0,0,0,0,0,0,0,0
"Burundi","2024-04-18",0,0,0,0,0,0,0,0
"Burundi","2024-04-19",0,0,0,0,0,0,0,0
"Burundi","2024-04-20",0,0,0,0,0,0,0,0
"Burundi","2024-04-21",0,0,0,0,0,0,0,0
"Burundi","2024-04-22",0,0,0,0,0,0,0,0
"Burundi","2024-04-23",0,0,0,0,0,0,0,0
"Burundi","2024-04-24",0,0,0,0,0,0,0,0
"Burundi","2024-04-25",0,0,0,0,0,0,0,0
"Burundi","2024-04-26",0,0,0,0,0,0,0,0
"Burundi","2024-04-27",0,0,0,0,0,0,0,0
"Burundi","2024-04-28",0,0,0,0,0,0,0,0
"Burundi","2024-04-29",0,0,0,0,0,0,0,0
"Burundi","2024-04-30",0,0,0,0,0,0,0,0
"Burundi","2024-05-01",0,0,0,0,0,0,0,0
"Burundi","2024-05-02",0,0,0,0,0,0,0,0
"Burundi","2024-05-03",0,0,0,0,0,0,0,0
"Burundi","2024-05-04",0,0,0,0,0,0,0,0
"Burundi","2024-05-05",0,0,0,0,0,0,0,0
"Burundi","2024-05-06",0,0,0,0,0,0,0,0
"Burundi","2024-05-07",0,0,0,0,0,0,0,0
"Burundi","2024-05-08",0,0,0,0,0,0,0,0
"Burundi","2024-05-09",0,0,0,0,0,0,0,0
"Burundi","2024-05-10",0,0,0,0,0,0,0,0
"Burundi","2024-05-11",0,0,0,0,0,0,0,0
"Burundi","2024-05-12",0,0,0,0,0,0,0,0
"Burundi","2024-05-13",0,0,0,0,0,0,0,0
"Burundi","2024-05-14",0,0,0,0,0,0,0,0
"Burundi","2024-05-15",0,0,0,0,0,0,0,0
"Burundi","2024-05-16",0,0,0,0,0,0,0,0
"Burundi","2024-05-17",0,0,0,0,0,0,0,0
"Burundi","2024-05-18",0,0,0,0,0,0,0,0
"Burundi","2024-05-19",0,0,0,0,0,0,0,0
"Burundi","2024-05-20",0,0,0,0,0,0,0,0
"Burundi","2024-05-21",0,0,0,0,0,0,0,0
"Burundi","2024-05-22",0,0,0,0,0,0,0,0
"Burundi","2024-05-23",0,0,0,0,0,0,0,0
"Burundi","2024-05-24",0,0,0,0,0,0,0,0
"Burundi","2024-05-25",0,0,0,0,0,0,0,0
"Burundi","2024-05-26",0,0,0,0,0,0,0,0
"Burundi","2024-05-27",0,0,0,0,0,0,0,0
"Burundi","2024-05-28",0,0,0,0,0,0,0,0
"Burundi","2024-05-29",0,0,0,0,0,0,0,0
"Burundi","2024-05-30",0,0,0,0,0,0,0,0
"Burundi","2024-05-31",0,0,0,0,0,0,0,0
"Burundi","2024-06-01",0,0,0,0,0,0,0,0
"Burundi","2024-06-02",0,0,0,0,0,0,0,0
"Burundi","2024-06-03",0,0,0,0,0,0,0,0
"Burundi","2024-06-04",0,0,0,0,0,0,0,0
"Burundi","2024-06-05",0,0,0,0,0,0,0,0
"Burundi","2024-06-06",0,0,0,0,0,0,0,0
"Burundi","2024-06-07",0,0,0,0,0,0,0,0
"Burundi","2024-06-08",0,0,0,0,0,0,0,0
"Burundi","2024-06-09",0,0,0,0,0,0,0,0
"Burundi","2024-06-10",0,0,0,0,0,0,0,0
"Burundi","2024-06-11",0,0,0,0,0,0,0,0
"Burundi","2024-06-12",0,0,0,0,0,0,0,0
"Burundi","2024-06-13",0,0,0,0,0,0,0,0
"Burundi","2024-06-14",0,0,0,0,0,0,0,0
"Burundi","2024-06-15",0,0,0,0,0,0,0,0
"Burundi","2024-06-16",0,0,0,0,0,0,0,0
"Burundi","2024-06-17",0,0,0,0,0,0,0,0
"Burundi","2024-06-18",0,0,0,0,0,0,0,0
"Burundi","2024-06-19",0,0,0,0,0,0,0,0
"Burundi","2024-06-20",0,0,0,0,0,0,0,0
"Burundi","2024-06-21",0,0,0,0,0,0,0,0
"Burundi","2024-06-22",0,0,0,0,0,0,0,0
"Burundi","2024-06-23",0,0,0,0,0,0,0,0
"Burundi","2024-06-24",0,0,0,0,0,0,0,0
"Burundi","2024-06-25",0,0,0,0,0,0,0,0
"Burundi","2024-06-26",0,0,0,0,0,0,0,0
"Burundi","2024-06-27",0,0,0,0,0,0,0,0
"Burundi","2024-06-28",0,0,0,0,0,0,0,0
"Burundi","2024-06-29",0,0,0,0,0,0,0,0
"Burundi","2024-06-30",0,0,0,0,0,0,0,0
"Burundi","2024-07-01",0,0,0,0,0,0,0,0
"Burundi","2024-07-02",0,0,0,0,0,0,0,0
"Burundi","2024-07-03",0,0,0,0,0,0,0,0
"Burundi","2024-07-04",0,0,0,0,0,0,0,0
"Burundi","2024-07-05",0,0,0,0,0,0,0,0
"Burundi","2024-07-06",0,0,0,0,0,0,0,0
"Burundi","2024-07-07",0,0,0,0,0,0,0,0
"Burundi","2024-07-08",0,0,0,0,0,0,0,0
"Burundi","2024-07-09",0,0,0,0,0,0,0,0
"Burundi","2024-07-10",0,0,0,0,0,0,0,0
"Burundi","2024-07-11",0,0,0,0,0,0,0,0
"Burundi","2024-07-12",0,0,0,0,0,0,0,0
"Burundi","2024-07-13",0,0,0,0,0,0,0,0
"Burundi","2024-07-14",0,0,0,0,0,0,0,0
"Burundi","2024-07-15",0,0,0,0,0,0,0,0
"Burundi","2024-07-16",0,0,0,0,0,0,0,0
"Burundi","2024-07-17",0,0,0,0,0,0,0,0
"Burundi","2024-07-18",0,0,0,0,0,0,0,0
"Burundi","2024-07-19",5,0,0,5,0,0,5,5
"Burundi","2024-07-20",0,0,0,5,0,0,3,8
"Burundi","2024-07-21",0,0,0,5,0,0,4,12
"Burundi","2024-07-22",0,0,0,5,0,0,3,15
"Burundi","2024-07-23",0,0,0,5,0,0,3,18
"Burundi","2024-07-24",0,0,0,5,0,0,3,21
"Burundi","2024-07-25",0,0,0,5,0,0,4,25
"Burundi","2024-07-26",0,0,0,5,0,0,3,28
"Burundi","2024-07-27",0,0,0,5,0,0,3,31
"Burundi","2024-07-28",0,9,9,5,9,9,3,34
"Burundi","2024-07-29",0,0,9,5,4,13,4,38
"Burundi","2024-07-30",0,0,9,5,5,18,3,41
"Burundi","2024-07-31",0,0,9,5,4,22,3,44
"Burundi","2024-08-01",0,0,9,5,5,27,3,47
"Burundi","2024-08-02",0,0,9,5,4,31,4,51
"Burundi","2024-08-03",49,0,9,54,5,36,3,54
"Burundi","2024-08-04",0,31,40,54,4,40,10,64
"Burundi","2024-08-05",0,0,40,54,6,46,10,74
"Burundi","2024-08-06",0,0,40,54,6,52,10,84
"Burundi","2024-08-07",0,0,40,54,6,58,10,94
"Burundi","2024-08-08",0,0,40,54,7,65,10,104
"Burundi","2024-08-09",60,0,40,114,6,71,10,114
"Burundi","2024-08-10",0,0,40,114,6,77,19,133
"Burundi","2024-08-11",0,43,83,114,6,83,19,152
"Burundi","2024-08-12",0,0,83,114,10,93,19,171
"Burundi","2024-08-13",0,0,83,114,10,103,20,191
"Burundi","2024-08-14",0,0,83,114,10,113,19,210
"Burundi","2024-08-15",0,0,83,114,10,123,19,229
"Burundi","2024-08-16",134,0,83,248,10,133,19,248
"Burundi","2024-08-17",0,0,83,248,10,143,24,272
"Burundi","2024-08-18",0,70,153,248,10,153,23,295
"Burundi","2024-08-19",0,0,153,248,11,164,24,319
"Burundi","2024-08-20",0,0,153,248,11,175,24,343
"Burundi","2024-08-21",0,0,153,248,11,186,23,366
"Burundi","2024-08-22",0,0,153,248,12,198,24,390
"Burundi","2024-08-23",0,0,153,248,11,209,24,414
"Burundi","2024-08-24",0,0,153,248,11,220,23,437
"Burundi","2024-08-25",213,78,231,461,11,231,24,461
"Burundi","2024-08-26",0,0,231,461,14,245,39,500
"Burundi","2024-08-27",0,0,231,461,14,259,40,540
"Burundi","2024-08-28",0,0,231,461,14,273,39,579
"Burundi","2024-08-29",0,0,231,461,13,286,39,618
"Burundi","2024-08-30",0,0,231,461,14,300,40,658
"Burundi","2024-08-31",236,0,231,697,14,314,39,697
"Burundi","2024-09-01",0,97,328,697,14,328,8,705
"Burundi","2024-09-02",0,0,328,697,8,336,8,713
"Burundi","2024-09-03",0,0,328,697,8,344,8,721
"Burundi","2024-09-04",0,0,328,697,8,352,8,729
"Burundi","2024-09-05",0,0,328,697,9,361,7,736
"Burundi","2024-09-06",0,0,328,697,8,369,8,744
"Burundi","2024-09-07",0,0,328,697,8,377,8,752
"Burundi","2024-09-08",63,57,385,760,8,385,8,760
"Burundi","2024-09-09",0,0,385,760,26,411,40,800
"Burundi","2024-09-10",0,0,385,760,25,436,40,840
"Burundi","2024-09-11",0,0,385,760,26,462,40,880
"Burundi","2024-09-12",0,0,385,760,25,487,40,920
"Burundi","2024-09-13",0,0,385,760,26,513,41,961
"Burundi","2024-09-14",0,0,385,760,25,538,40,1001
"Burundi","2024-09-15",0,179,564,760,26,564,40,1041
"Burundi","2024-09-16",321,0,564,1081,19,583,40,1081
"Burundi","2024-09-17",0,0,564,1081,19,602,37,1118
"Burundi","2024-09-18",0,0,564,1081,19,621,37,1155
"Burundi","2024-09-19",0,0,564,1081,18,639,37,1192
"Burundi","2024-09-20",0,0,564,1081,19,658,37,1229
"Burundi","2024-09-21",0,0,564,1081,19,677,37,1266
"Burundi","2024-09-22",0,132,696,1081,19,696,37,1303
"Burundi","2024-09-23",259,0,696,1340,22,718,37,1340
"Burundi","2024-09-24",0,0,696,1340,23,741,10,1350
"Burundi","2024-09-25",0,0,696,1340,22,763,10,1360
"Burundi","2024-09-26",0,0,696,1340,23,786,9,1369
"Burundi","2024-09-27",0,0,696,1340,22,808,10,1379
"Burundi","2024-09-28",0,0,696,1340,23,831,10,1389
"Burundi","2024-09-29",0,157,853,1340,22,853,10,1399
"Burundi","2024-09-30",0,0,853,1340,19,872,10,1409
"Burundi","2024-10-01",0,0,853,1340,19,891,9,1418
"Burundi","2024-10-02",0,0,853,1340,19,910,10,1428
"Burundi","2024-10-03",0,0,853,1340,20,930,10,1438
"Burundi","2024-10-04",0,0,853,1340,19,949,10,1448
"Burundi","2024-10-05",0,0,853,1340,19,968,9,1457
"Burundi","2024-10-06",0,134,987,1340,19,987,10,1467
"Burundi","2024-10-07",0,0,987,1340,26,1013,10,1477
"Burundi","2024-10-08",0,0,987,1340,26,1039,10,1487
"Burundi","2024-10-09",0,0,987,1340,26,1065,10,1497
"Burundi","2024-10-10",0,0,987,1340,27,1092,9,1506
"Burundi","2024-10-11",0,0,987,1340,26,1118,10,1516
"Burundi","2024-10-12",186,0,987,1526,26,1144,10,1526
"Burundi","2024-10-13",98,183,1170,1624,26,1170,98,1624
"Burundi","2024-10-14",0,0,1170,1624,17,1187,16,1640
"Burundi","2024-10-15",0,0,1170,1624,16,1203,17,1657
"Burundi","2024-10-16",0,0,1170,1624,17,1220,16,1673
"Burundi","2024-10-17",0,0,1170,1624,17,1237,17,1690
"Burundi","2024-10-18",0,0,1170,1624,17,1254,16,1706
"Burundi","2024-10-19",0,0,1170,1624,16,1270,17,1723
"Burundi","2024-10-20",115,117,1287,1739,17,1287,16,1739
"Burundi","2024-10-21",0,0,1287,1739,32,1319,16,1755
"Burundi","2024-10-22",0,0,1287,1739,31,1350,16,1771
"Burundi","2024-10-23",0,0,1287,1739,32,1382,16,1787
"Burundi","2024-10-24",0,0,1287,1739,32,1414,17,1804
"Burundi","2024-10-25",0,0,1287,1739,32,1446,16,1820
"Burundi","2024-10-26",0,0,1287,1739,31,1477,16,1836
"Burundi","2024-10-27",113,222,1509,1852,32,1509,16,1852
"Burundi","2024-10-28",0,0,1509,1852,31,1540,14,1866
"Burundi","2024-10-29",0,0,1509,1852,31,1571,15,1881
"Burundi","2024-10-30",0,0,1509,1852,31,1602,14,1895
"Burundi","2024-10-31",0,0,1509,1852,31,1633,15,1910
"Burundi","2024-11-01",0,0,1509,1852,31,1664,14,1924
"Burundi","2024-11-02",0,0,1509,1852,31,1695,15,1939
"Burundi","2024-11-03",101,217,1726,1953,31,1726,14,1953
"Burundi","2024-11-04",0,0,1726,1953,20,1746,11,1964
"Burundi","2024-11-05",0,0,1726,1953,19,1765,11,1975
"Burundi","2024-11-06",0,0,1726,1953,20,1785,10,1985
"Burundi","2024-11-07",0,0,1726,1953,19,1804,11,1996
"Burundi","2024-11-08",0,0,1726,1953,20,1824,11,2007
"Burundi","2024-11-09",0,0,1726,1953,19,1843,11,2018
"Burundi","2024-11-10",0,137,1863,1953,20,1863,11,2029
"Burundi","2024-11-11",0,11,1874,1953,11,1874,10,2039
"Burundi","2024-11-12",0,0,1874,1953,0,1874,11,2050
"Burundi","2024-11-13",108,0,1874,2061,0,1874,11,2061
"Burundi","2024-11-14",0,0,1874,2061,0,1874,0,2061
"Burundi","2024-11-15",0,0,1874,2061,0,1874,0,2061
"Burundi","2024-11-16",0,0,1874,2061,0,1874,0,2061
"Burundi","2024-11-17",0,0,1874,2061,0,1874,0,2061
"Burundi","2024-11-18",0,0,1874,2061,0,1874,0,2061
"Burundi","2024-11-19",0,0,1874,2061,0,1874,0,2061
"Burundi","2024-11-20",0,0,1874,2061,0,1874,0,2061
"Burundi","2024-11-21",0,0,1874,2061,0,1874,0,2061
"Burundi","2024-11-22",0,0,1874,2061,0,1874,0,2061
"Burundi","2024-11-23",0,0,1874,2061,0,1874,0,2061
"Burundi","2024-11-24",0,0,1874,2061,0,1874,0,2061
"Burundi","2024-11-25",0,0,1874,2061,0,1874,0,2061
"Burundi","2024-11-26",0,0,1874,2061,0,1874,0,2061
"Burundi","2024-11-27",0,0,1874,2061,0,1874,0,2061
"Burundi","2024-11-28",0,0,1874,2061,0,1874,0,2061
"Burundi","2024-11-29",0,0,1874,2061,0,1874,0,2061
"Burundi","2024-11-30",0,0,1874,2061,0,1874,0,2061
"Burundi","2024-12-01",0,0,1874,2061,0,1874,0,2061
"Burundi","2024-12-02",0,0,1874,2061,0,1874,0,2061
"Burundi","2024-12-03",0,0,1874,2061,0,1874,0,2061
"Burundi","2024-12-04",0,0,1874,2061,0,1874,0,2061
"Burundi","2024-12-05",0,0,1874,2061,0,1874,0,2061
"Burundi","2024-12-06",0,0,1874,2061,0,1874,0,2061
"Burundi","2024-12-07",0,0,1874,2061,0,1874,0,2061
"Burundi","2024-12-08",0,0,1874,2061,0,1874,0,2061
"Burundi","2024-12-09",0,0,1874,2061,0,1874,0,2061
"Cambodia","2024-01-01",0,0,0,0,0,0,0,0
"Cambodia","2024-01-02",0,0,0,0,0,0,0,0
"Cambodia","2024-01-03",0,0,0,0,0,0,0,0
"Cambodia","2024-01-04",0,2,2,0,2,2,0,0
"Cambodia","2024-01-05",0,0,2,0,0,2,0,0
"Cambodia","2024-01-06",0,0,2,0,0,2,0,0
"Cambodia","2024-01-07",0,0,2,0,0,2,0,0
"Cambodia","2024-01-08",0,0,2,0,0,2,0,0
"Cambodia","2024-01-09",0,0,2,0,0,2,0,0
"Cambodia","2024-01-10",0,0,2,0,0,2,0,0
"Cambodia","2024-01-11",0,0,2,0,0,2,0,0
"Cambodia","2024-01-12",0,0,2,0,0,2,0,0
"Cambodia","2024-01-13",0,0,2,0,0,2,0,0
"Cambodia","2024-01-14",0,0,2,0,0,2,0,0
"Cambodia","2024-01-15",0,0,2,0,0,2,0,0
"Cambodia","2024-01-16",0,0,2,0,0,2,0,0
"Cambodia","2024-01-17",0,0,2,0,0,2,0,0
"Cambodia","2024-01-18",0,0,2,0,0,2,0,0
"Cambodia","2024-01-19",0,0,2,0,1,3,0,0
"Cambodia","2024-01-20",0,0,2,0,0,3,0,0
"Cambodia","2024-01-21",0,0,2,0,0,3,0,0
"Cambodia","2024-01-22",0,0,2,0,0,3,0,0
"Cambodia","2024-01-23",0,0,2,0,0,3,0,0
"Cambodia","2024-01-24",0,0,2,0,0,3,0,0
"Cambodia","2024-01-25",0,0,2,0,0,3,0,0
"Cambodia","2024-01-26",0,0,2,0,0,3,0,0
"Cambodia","2024-01-27",0,0,2,0,0,3,0,0
"Cambodia","2024-01-28",0,0,2,0,0,3,0,0
"Cambodia","2024-01-29",0,0,2,0,0,3,0,0
"Cambodia","2024-01-30",0,0,2,0,0,3,0,0
"Cambodia","2024-01-31",0,0,2,0,0,3,0,0
"Cambodia","2024-02-01",0,0,2,0,0,3,0,0
"Cambodia","2024-02-02",0,1,3,0,0,3,0,0
"Cambodia","2024-02-03",0,0,3,0,0,3,0,0
"Cambodia","2024-02-04",0,0,3,0,1,4,0,0
"Cambodia","2024-02-05",0,0,3,0,0,4,0,0
"Cambodia","2024-02-06",0,0,3,0,1,5,0,0
"Cambodia","2024-02-07",0,0,3,0,0,5,0,0
"Cambodia","2024-02-08",0,0,3,0,1,6,0,0
"Cambodia","2024-02-09",0,0,3,0,0,6,0,0
"Cambodia","2024-02-10",0,0,3,0,0,6,0,0
"Cambodia","2024-02-11",0,0,3,0,1,7,0,0
"Cambodia","2024-02-12",0,0,3,0,0,7,0,0
"Cambodia","2024-02-13",0,0,3,0,1,8,0,0
"Cambodia","2024-02-14",0,0,3,0,0,8,0,0
"Cambodia","2024-02-15",0,0,3,0,1,9,0,0
"Cambodia","2024-02-16",0,0,3,0,0,9,0,0
"Cambodia","2024-02-17",0,0,3,0,0,9,0,0
"Cambodia","2024-02-18",0,0,3,0,1,10,0,0
"Cambodia","2024-02-19",0,0,3,0,0,10,0,0
"Cambodia","2024-02-20",0,0,3,0,1,11,0,0
"Cambodia","2024-02-21",0,0,3,0,0,11,0,0
"Cambodia","2024-02-22",0,0,3,0,1,12,0,0
"Cambodia","2024-02-23",0,9,12,0,0,12,0,0
"Cambodia","2024-02-24",0,0,12,0,0,12,0,0
"Cambodia","2024-02-25",0,0,12,0,0,12,0,0
"Cambodia","2024-02-26",0,0,12,0,0,12,0,0
"Cambodia","2024-02-27",0,0,12,0,0,12,0,0
"Cambodia","2024-02-28",0,0,12,0,0,12,0,0
"Cambodia","2024-02-29",0,0,12,0,0,12,0,0
"Cambodia","2024-03-01",0,0,12,0,0,12,0,0
"Cambodia","2024-03-02",0,0,12,0,0,12,0,0
"Cambodia","2024-03-03",0,0,12,0,0,12,0,0
"Cambodia","2024-03-04",0,0,12,0,0,12,0,0
"Cambodia","2024-03-05",0,0,12,0,0,12,0,0
"Cambodia","2024-03-06",0,0,12,0,0,12,0,0
"Cambodia","2024-03-07",0,0,12,0,0,12,0,0
"Cambodia","2024-03-08",0,0,12,0,0,12,0,0
"Cambodia","2024-03-09",0,0,12,0,0,12,0,0
"Cambodia","2024-03-10",0,0,12,0,0,12,0,0
"Cambodia","2024-03-11",0,0,12,0,0,12,0,0
"Cambodia","2024-03-12",0,0,12,0,0,12,0,0
"Cambodia","2024-03-13",0,0,12,0,0,12,0,0
"Cambodia","2024-03-14",0,0,12,0,0,12,0,0
"Cambodia","2024-03-15",0,0,12,0,0,12,0,0
"Cambodia","2024-03-16",0,0,12,0,0,12,0,0
"Cambodia","2024-03-17",0,0,12,0,0,12,0,0
"Cambodia","2024-03-18",0,0,12,0,0,12,0,0
"Cambodia","2024-03-19",0,0,12,0,0,12,0,0
"Cambodia","2024-03-20",0,0,12,0,0,12,0,0
"Cambodia","2024-03-21",0,0,12,0,0,12,0,0
"Cambodia","2024-03-22",0,0,12,0,0,12,0,0
"Cambodia","2024-03-23",0,0,12,0,0,12,0,0
"Cambodia","2024-03-24",0,0,12,0,0,12,0,0
"Cambodia","2024-03-25",0,0,12,0,0,12,0,0
"Cambodia","2024-03-26",0,0,12,0,0,12,0,0
"Cambodia","2024-03-27",0,0,12,0,0,12,0,0
"Cambodia","2024-03-28",0,0,12,0,0,12,0,0
"Cambodia","2024-03-29",0,0,12,0,0,12,0,0
"Cambodia","2024-03-30",0,0,12,0,0,12,0,0
"Cambodia","2024-03-31",0,0,12,0,0,12,0,0
"Cambodia","2024-04-01",0,0,12,0,0,12,0,0
"Cambodia","2024-04-02",0,0,12,0,0,12,0,0
"Cambodia","2024-04-03",0,0,12,0,0,12,0,0
"Cambodia","2024-04-04",0,0,12,0,0,12,0,0
"Cambodia","2024-04-05",0,0,12,0,0,12,0,0
"Cambodia","2024-04-06",0,0,12,0,0,12,0,0
"Cambodia","2024-04-07",0,0,12,0,0,12,0,0
"Cambodia","2024-04-08",0,0,12,0,0,12,0,0
"Cambodia","2024-04-09",0,0,12,0,0,12,0,0
"Cambodia","2024-04-10",0,0,12,0,0,12,0,0
"Cambodia","2024-04-11",0,0,12,0,0,12,0,0
"Cambodia","2024-04-12",0,0,12,0,0,12,0,0
"Cambodia","2024-04-13",0,0,12,0,0,12,0,0
"Cambodia","2024-04-14",0,0,12,0,0,12,0,0
"Cambodia","2024-04-15",0,0,12,0,0,12,0,0
"Cambodia","2024-04-16",0,0,12,0,0,12,0,0
"Cambodia","2024-04-17",0,0,12,0,0,12,0,0
"Cambodia","2024-04-18",0,0,12,0,0,12,0,0
"Cambodia","2024-04-19",0,0,12,0,0,12,0,0
"Cambodia","2024-04-20",0,0,12,0,0,12,0,0
"Cambodia","2024-04-21",0,0,12,0,0,12,0,0
"Cambodia","2024-04-22",0,0,12,0,0,12,0,0
"Cambodia","2024-04-23",0,0,12,0,0,12,0,0
"Cambodia","2024-04-24",0,0,12,0,0,12,0,0
"Cambodia","2024-04-25",0,0,12,0,0,12,0,0
"Cambodia","2024-04-26",0,0,12,0,0,12,0,0
"Cambodia","2024-04-27",0,0,12,0,0,12,0,0
"Cambodia","2024-04-28",0,0,12,0,0,12,0,0
"Cambodia","2024-04-29",0,0,12,0,0,12,0,0
"Cambodia","2024-04-30",0,0,12,0,0,12,0,0
"Cambodia","2024-05-01",0,0,12,0,0,12,0,0
"Cambodia","2024-05-02",0,0,12,0,0,12,0,0
"Cambodia","2024-05-03",0,0,12,0,0,12,0,0
"Cambodia","2024-05-04",0,0,12,0,0,12,0,0
"Cambodia","2024-05-05",0,0,12,0,0,12,0,0
"Cambodia","2024-05-06",0,0,12,0,0,12,0,0
"Cambodia","2024-05-07",0,0,12,0,0,12,0,0
"Cambodia","2024-05-08",0,0,12,0,0,12,0,0
"Cambodia","2024-05-09",0,0,12,0,0,12,0,0
"Cambodia","2024-05-10",0,0,12,0,0,12,0,0
"Cambodia","2024-05-11",0,0,12,0,0,12,0,0
"Cambodia","2024-05-12",0,0,12,0,0,12,0,0
"Cambodia","2024-05-13",0,0,12,0,0,12,0,0
"Cambodia","2024-05-14",0,0,12,0,0,12,0,0
"Cambodia","2024-05-15",0,0,12,0,0,12,0,0
"Cambodia","2024-05-16",0,0,12,0,0,12,0,0
"Cambodia","2024-05-17",0,0,12,0,0,12,0,0
"Cambodia","2024-05-18",0,0,12,0,0,12,0,0
"Cambodia","2024-05-19",0,0,12,0,0,12,0,0
"Cambodia","2024-05-20",0,0,12,0,0,12,0,0
"Cambodia","2024-05-21",0,0,12,0,0,12,0,0
"Cambodia","2024-05-22",0,0,12,0,0,12,0,0
"Cambodia","2024-05-23",0,0,12,0,0,12,0,0
"Cambodia","2024-05-24",0,0,12,0,0,12,0,0
"Cambodia","2024-05-25",0,0,12,0,0,12,0,0
"Cambodia","2024-05-26",0,0,12,0,0,12,0,0
"Cambodia","2024-05-27",0,0,12,0,0,12,0,0
"Cambodia","2024-05-28",0,0,12,0,0,12,0,0
"Cambodia","2024-05-29",0,0,12,0,0,12,0,0
"Cambodia","2024-05-30",0,0,12,0,0,12,0,0
"Cambodia","2024-05-31",0,0,12,0,0,12,0,0
"Cambodia","2024-06-01",0,0,12,0,0,12,0,0
"Cambodia","2024-06-02",0,0,12,0,0,12,0,0
"Cambodia","2024-06-03",0,0,12,0,0,12,0,0
"Cambodia","2024-06-04",0,0,12,0,0,12,0,0
"Cambodia","2024-06-05",0,0,12,0,0,12,0,0
"Cambodia","2024-06-06",0,0,12,0,0,12,0,0
"Cambodia","2024-06-07",0,0,12,0,0,12,0,0
"Cambodia","2024-06-08",0,0,12,0,0,12,0,0
"Cambodia","2024-06-09",0,0,12,0,0,12,0,0
"Cambodia","2024-06-10",0,0,12,0,0,12,0,0
"Cambodia","2024-06-11",0,0,12,0,0,12,0,0
"Cambodia","2024-06-12",0,0,12,0,0,12,0,0
"Cambodia","2024-06-13",0,0,12,0,0,12,0,0
"Cambodia","2024-06-14",0,0,12,0,0,12,0,0
"Cambodia","2024-06-15",0,0,12,0,0,12,0,0
"Cambodia","2024-06-16",0,0,12,0,0,12,0,0
"Cambodia","2024-06-17",0,0,12,0,0,12,0,0
"Cambodia","2024-06-18",0,0,12,0,0,12,0,0
"Cambodia","2024-06-19",0,0,12,0,0,12,0,0
"Cambodia","2024-06-20",0,0,12,0,0,12,0,0
"Cambodia","2024-06-21",0,0,12,0,0,12,0,0
"Cambodia","2024-06-22",0,0,12,0,0,12,0,0
"Cambodia","2024-06-23",0,0,12,0,0,12,0,0
"Cambodia","2024-06-24",0,0,12,0,0,12,0,0
"Cambodia","2024-06-25",0,0,12,0,0,12,0,0
"Cambodia","2024-06-26",0,0,12,0,0,12,0,0
"Cambodia","2024-06-27",0,0,12,0,0,12,0,0
"Cambodia","2024-06-28",0,0,12,0,0,12,0,0
"Cambodia","2024-06-29",0,0,12,0,0,12,0,0
"Cambodia","2024-06-30",0,0,12,0,0,12,0,0
"Cambodia","2024-07-01",0,0,12,0,0,12,0,0
"Cambodia","2024-07-02",0,0,12,0,0,12,0,0
"Cambodia","2024-07-03",0,0,12,0,0,12,0,0
"Cambodia","2024-07-04",0,0,12,0,0,12,0,0
"Cambodia","2024-07-05",0,0,12,0,0,12,0,0
"Cambodia","2024-07-06",0,0,12,0,0,12,0,0
"Cambodia","2024-07-07",0,0,12,0,0,12,0,0
"Cambodia","2024-07-08",0,0,12,0,0,12,0,0
"Cambodia","2024-07-09",0,0,12,0,0,12,0,0
"Cambodia","2024-07-10",0,0,12,0,0,12,0,0
"Cambodia","2024-07-11",0,0,12,0,0,12,0,0
"Cambodia","2024-07-12",0,0,12,0,0,12,0,0
"Cambodia","2024-07-13",0,0,12,0,0,12,0,0
"Cambodia","2024-07-14",0,0,12,0,0,12,0,0
"Cambodia","2024-07-15",0,0,12,0,0,12,0,0
"Cambodia","2024-07-16",0,0,12,0,0,12,0,0
"Cambodia","2024-07-17",0,0,12,0,0,12,0,0
"Cambodia","2024-07-18",0,0,12,0,0,12,0,0
"Cambodia","2024-07-19",0,0,12,0,0,12,0,0
"Cambodia","2024-07-20",0,0,12,0,0,12,0,0
"Cambodia","2024-07-21",0,0,12,0,0,12,0,0
"Cambodia","2024-07-22",0,0,12,0,0,12,0,0
"Cambodia","2024-07-23",0,0,12,0,0,12,0,0
"Cambodia","2024-07-24",0,0,12,0,0,12,0,0
"Cambodia","2024-07-25",0,0,12,0,0,12,0,0
"Cambodia","2024-07-26",0,0,12,0,0,12,0,0
"Cambodia","2024-07-27",0,0,12,0,0,12,0,0
"Cambodia","2024-07-28",0,0,12,0,0,12,0,0
"Cambodia","2024-07-29",0,0,12,0,0,12,0,0
"Cambodia","2024-07-30",0,0,12,0,0,12,0,0
"Cambodia","2024-07-31",0,0,12,0,0,12,0,0
"Cambodia","2024-08-01",0,0,12,0,0,12,0,0
"Cambodia","2024-08-02",0,0,12,0,0,12,0,0
"Cambodia","2024-08-03",0,0,12,0,0,12,0,0
"Cambodia","2024-08-04",0,0,12,0,0,12,0,0
"Cambodia","2024-08-05",0,0,12,0,0,12,0,0
"Cambodia","2024-08-06",0,0,12,0,0,12,0,0
"Cambodia","2024-08-07",0,0,12,0,0,12,0,0
"Cambodia","2024-08-08",0,0,12,0,0,12,0,0
"Cambodia","2024-08-09",0,0,12,0,0,12,0,0
"Cambodia","2024-08-10",0,0,12,0,0,12,0,0
"Cambodia","2024-08-11",0,0,12,0,0,12,0,0
"Cambodia","2024-08-12",0,0,12,0,0,12,0,0
"Cambodia","2024-08-13",0,0,12,0,0,12,0,0
"Cambodia","2024-08-14",0,0,12,0,0,12,0,0
"Cambodia","2024-08-15",0,0,12,0,0,12,0,0
"Cambodia","2024-08-16",0,0,12,0,0,12,0,0
"Cambodia","2024-08-17",0,0,12,0,0,12,0,0
"Cambodia","2024-08-18",0,0,12,0,0,12,0,0
"Cambodia","2024-08-19",0,0,12,0,0,12,0,0
"Cambodia","2024-08-20",0,0,12,0,0,12,0,0
"Cambodia","2024-08-21",0,0,12,0,0,12,0,0
"Cambodia","2024-08-22",0,0,12,0,0,12,0,0
"Cambodia","2024-08-23",0,0,12,0,0,12,0,0
"Cambodia","2024-08-24",0,0,12,0,0,12,0,0
"Cambodia","2024-08-25",0,0,12,0,0,12,0,0
"Cambodia","2024-08-26",0,0,12,0,0,12,0,0
"Cambodia","2024-08-27",0,0,12,0,0,12,0,0
"Cambodia","2024-08-28",0,0,12,0,0,12,0,0
"Cambodia","2024-08-29",0,0,12,0,0,12,0,0
"Cambodia","2024-08-30",0,0,12,0,0,12,0,0
"Cambodia","2024-08-31",0,0,12,0,0,12,0,0
"Cambodia","2024-09-01",0,0,12,0,0,12,0,0
"Cambodia","2024-09-02",0,0,12,0,0,12,0,0
"Cambodia","2024-09-03",0,0,12,0,0,12,0,0
"Cambodia","2024-09-04",0,0,12,0,0,12,0,0
"Cambodia","2024-09-05",0,0,12,0,0,12,0,0
"Cambodia","2024-09-06",0,0,12,0,0,12,0,0
"Cambodia","2024-09-07",0,0,12,0,0,12,0,0
"Cambodia","2024-09-08",0,0,12,0,0,12,0,0
"Cambodia","2024-09-09",0,0,12,0,0,12,0,0
"Cambodia","2024-09-10",0,0,12,0,0,12,0,0
"Cambodia","2024-09-11",0,0,12,0,0,12,0,0
"Cambodia","2024-09-12",0,0,12,0,0,12,0,0
"Cambodia","2024-09-13",0,0,12,0,0,12,0,0
"Cambodia","2024-09-14",0,0,12,0,0,12,0,0
"Cambodia","2024-09-15",0,0,12,0,0,12,0,0
"Cambodia","2024-09-16",0,0,12,0,0,12,0,0
"Cambodia","2024-09-17",0,0,12,0,0,12,0,0
"Cambodia","2024-09-18",0,0,12,0,0,12,0,0
"Cambodia","2024-09-19",0,0,12,0,0,12,0,0
"Cambodia","2024-09-20",0,0,12,0,0,12,0,0
"Cambodia","2024-09-21",0,0,12,0,0,12,0,0
"Cambodia","2024-09-22",0,0,12,0,0,12,0,0
"Cambodia","2024-09-23",0,0,12,0,0,12,0,0
"Cambodia","2024-09-24",0,0,12,0,0,12,0,0
"Cambodia","2024-09-25",0,0,12,0,0,12,0,0
"Cambodia","2024-09-26",0,0,12,0,0,12,0,0
"Cambodia","2024-09-27",0,0,12,0,0,12,0,0
"Cambodia","2024-09-28",0,0,12,0,0,12,0,0
"Cambodia","2024-09-29",0,0,12,0,0,12,0,0
"Cambodia","2024-09-30",0,0,12,0,0,12,0,0
"Cambodia","2024-10-01",0,0,12,0,0,12,0,0
"Cambodia","2024-10-02",0,0,12,0,0,12,0,0
"Cambodia","2024-10-03",0,0,12,0,0,12,0,0
"Cambodia","2024-10-04",0,0,12,0,0,12,0,0
"Cambodia","2024-10-05",0,0,12,0,0,12,0,0
"Cambodia","2024-10-06",0,0,12,0,0,12,0,0
"Cambodia","2024-10-07",0,0,12,0,0,12,0,0
"Cambodia","2024-10-08",0,0,12,0,0,12,0,0
"Cambodia","2024-10-09",0,0,12,0,0,12,0,0
"Cambodia","2024-10-10",0,0,12,0,0,12,0,0
"Cambodia","2024-10-11",0,0,12,0,0,12,0,0
"Cambodia","2024-10-12",0,0,12,0,0,12,0,0
"Cambodia","2024-10-13",0,0,12,0,0,12,0,0
"Cambodia","2024-10-14",0,0,12,0,0,12,0,0
"Cambodia","2024-10-15",0,0,12,0,0,12,0,0
"Cambodia","2024-10-16",0,0,12,0,0,12,0,0
"Cambodia","2024-10-17",0,0,12,0,0,12,0,0
"Cambodia","2024-10-18",0,0,12,0,0,12,0,0
"Cambodia","2024-10-19",0,0,12,0,0,12,0,0
"Cambodia","2024-10-20",0,0,12,0,0,12,0,0
"Cambodia","2024-10-21",0,0,12,0,0,12,0,0
"Cambodia","2024-10-22",0,0,12,0,0,12,0,0
"Cambodia","2024-10-23",0,0,12,0,0,12,0,0
"Cambodia","2024-10-24",0,0,12,0,0,12,0,0
"Cambodia","2024-10-25",0,0,12,0,0,12,0,0
"Cambodia","2024-10-26",0,0,12,0,0,12,0,0
"Cambodia","2024-10-27",0,0,12,0,0,12,0,0
"Cambodia","2024-10-28",0,0,12,0,0,12,0,0
"Cambodia","2024-10-29",0,0,12,0,0,12,0,0
"Cambodia","2024-10-30",0,0,12,0,0,12,0,0
"Cambodia","2024-10-31",0,0,12,0,0,12,0,0
"Cambodia","2024-11-01",0,0,12,0,0,12,0,0
"Cambodia","2024-11-02",0,0,12,0,0,12,0,0
"Cambodia","2024-11-03",0,0,12,0,0,12,0,0
"Cambodia","2024-11-04",0,0,12,0,0,12,0,0
"Cambodia","2024-11-05",0,0,12,0,0,12,0,0
"Cambodia","2024-11-06",0,0,12,0,0,12,0,0
"Cambodia","2024-11-07",0,0,12,0,0,12,0,0
"Cambodia","2024-11-08",0,0,12,0,0,12,0,0
"Cambodia","2024-11-09",0,0,12,0,0,12,0,0
"Cambodia","2024-11-10",0,0,12,0,0,12,0,0
"Cambodia","2024-11-11",0,0,12,0,0,12,0,0
"Cambodia","2024-11-12",0,0,12,0,0,12,0,0
"Cambodia","2024-11-13",0,0,12,0,0,12,0,0
"Cambodia","2024-11-14",0,0,12,0,0,12,0,0
"Cambodia","2024-11-15",0,0,12,0,0,12,0,0
"Cambodia","2024-11-16",0,0,12,0,0,12,0,0
"Cambodia","2024-11-17",0,0,12,0,0,12,0,0
"Cambodia","2024-11-18",0,0,12,0,0,12,0,0
"Cambodia","2024-11-19",0,0,12,0,0,12,0,0
"Cambodia","2024-11-20",0,0,12,0,0,12,0,0
"Cambodia","2024-11-21",0,0,12,0,0,12,0,0
"Cambodia","2024-11-22",0,0,12,0,0,12,0,0
"Cambodia","2024-11-23",0,0,12,0,0,12,0,0
"Cambodia","2024-11-24",0,0,12,0,0,12,0,0
"Cambodia","2024-11-25",0,0,12,0,0,12,0,0
"Cambodia","2024-11-26",0,0,12,0,0,12,0,0
"Cambodia","2024-11-27",0,0,12,0,0,12,0,0
"Cambodia","2024-11-28",0,0,12,0,0,12,0,0
"Cambodia","2024-11-29",0,0,12,0,0,12,0,0
"Cambodia","2024-11-30",0,0,12,0,0,12,0,0
"Cambodia","2024-12-01",0,0,12,0,0,12,0,0
"Cambodia","2024-12-02",0,0,12,0,0,12,0,0
"Cambodia","2024-12-03",0,0,12,0,0,12,0,0
"Cambodia","2024-12-04",0,0,12,0,0,12,0,0
"Cambodia","2024-12-05",0,0,12,0,0,12,0,0
"Cambodia","2024-12-06",0,0,12,0,0,12,0,0
"Cambodia","2024-12-07",0,0,12,0,0,12,0,0
"Cambodia","2024-12-08",0,0,12,0,0,12,0,0
"Cambodia","2024-12-09",0,0,12,0,0,12,0,0
"Cameroon","2024-01-01",0,0,0,0,0,0,0,0
"Cameroon","2024-01-02",0,0,0,0,0,0,0,0
"Cameroon","2024-01-03",0,0,0,0,0,0,0,0
"Cameroon","2024-01-04",0,0,0,0,0,0,0,0
"Cameroon","2024-01-05",0,0,0,0,0,0,0,0
"Cameroon","2024-01-06",0,0,0,0,0,0,0,0
"Cameroon","2024-01-07",0,0,0,0,0,0,0,0
"Cameroon","2024-01-08",0,0,0,0,0,0,0,0
"Cameroon","2024-01-09",0,0,0,0,0,0,0,0
"Cameroon","2024-01-10",0,0,0,0,0,0,0,0
"Cameroon","2024-01-11",0,0,0,0,0,0,0,0
"Cameroon","2024-01-12",0,0,0,0,0,0,0,0
"Cameroon","2024-01-13",0,0,0,0,0,0,0,0
"Cameroon","2024-01-14",0,2,2,0,2,2,0,0
"Cameroon","2024-01-15",0,0,2,0,0,2,0,0
"Cameroon","2024-01-16",0,0,2,0,0,2,0,0
"Cameroon","2024-01-17",0,0,2,0,0,2,0,0
"Cameroon","2024-01-18",0,0,2,0,0,2,0,0
"Cameroon","2024-01-19",0,0,2,0,0,2,0,0
"Cameroon","2024-01-20",0,0,2,0,0,2,0,0
"Cameroon","2024-01-21",0,0,2,0,0,2,0,0
"Cameroon","2024-01-22",0,0,2,0,0,2,0,0
"Cameroon","2024-01-23",0,0,2,0,0,2,0,0
"Cameroon","2024-01-24",0,0,2,0,0,2,0,0
"Cameroon","2024-01-25",0,0,2,0,0,2,0,0
"Cameroon","2024-01-26",0,0,2,0,0,2,0,0
"Cameroon","2024-01-27",0,0,2,0,0,2,0,0
"Cameroon","2024-01-28",0,0,2,0,0,2,0,0
"Cameroon","2024-01-29",0,0,2,0,0,2,0,0
"Cameroon","2024-01-30",0,0,2,0,0,2,0,0
"Cameroon","2024-01-31",0,0,2,0,0,2,0,0
"Cameroon","2024-02-01",0,0,2,0,0,2,0,0
"Cameroon","2024-02-02",0,0,2,0,0,2,0,0
"Cameroon","2024-02-03",0,0,2,0,0,2,0,0
"Cameroon","2024-02-04",0,0,2,0,0,2,0,0
"Cameroon","2024-02-05",0,0,2,0,0,2,0,0
"Cameroon","2024-02-06",0,0,2,0,0,2,0,0
"Cameroon","2024-02-07",0,0,2,0,0,2,0,0
"Cameroon","2024-02-08",0,0,2,0,0,2,0,0
"Cameroon","2024-02-09",0,0,2,0,0,2,0,0
"Cameroon","2024-02-10",0,0,2,0,0,2,0,0
"Cameroon","2024-02-11",0,0,2,0,0,2,0,0
"Cameroon","2024-02-12",0,0,2,0,0,2,0,0
"Cameroon","2024-02-13",0,0,2,0,0,2,0,0
"Cameroon","2024-02-14",0,0,2,0,0,2,0,0
"Cameroon","2024-02-15",0,0,2,0,0,2,0,0
"Cameroon","2024-02-16",0,0,2,0,0,2,0,0
"Cameroon","2024-02-17",0,0,2,0,0,2,0,0
"Cameroon","2024-02-18",0,0,2,0,0,2,0,0
"Cameroon","2024-02-19",0,0,2,0,0,2,0,0
"Cameroon","2024-02-20",0,0,2,0,0,2,0,0
"Cameroon","2024-02-21",0,0,2,0,0,2,0,0
"Cameroon","2024-02-22",0,0,2,0,0,2,0,0
"Cameroon","2024-02-23",0,0,2,0,0,2,0,0
"Cameroon","2024-02-24",0,0,2,0,0,2,0,0
"Cameroon","2024-02-25",0,0,2,0,0,2,0,0
"Cameroon","2024-02-26",0,0,2,0,1,3,0,0
"Cameroon","2024-02-27",0,0,2,0,0,3,0,0
"Cameroon","2024-02-28",0,0,2,0,0,3,0,0
"Cameroon","2024-02-29",0,0,2,0,0,3,0,0
"Cameroon","2024-03-01",0,0,2,0,0,3,0,0
"Cameroon","2024-03-02",0,0,2,0,0,3,0,0
"Cameroon","2024-03-03",0,0,2,0,0,3,0,0
"Cameroon","2024-03-04",0,0,2,0,0,3,0,0
"Cameroon","2024-03-05",0,0,2,0,0,3,0,0
"Cameroon","2024-03-06",0,0,2,0,0,3,0,0
"Cameroon","2024-03-07",0,0,2,0,0,3,0,0
"Cameroon","2024-03-08",0,0,2,0,0,3,0,0
"Cameroon","2024-03-09",0,0,2,0,0,3,0,0
"Cameroon","2024-03-10",0,0,2,0,0,3,0,0
"Cameroon","2024-03-11",0,0,2,0,0,3,0,0
"Cameroon","2024-03-12",0,0,2,0,0,3,0,0
"Cameroon","2024-03-13",0,0,2,0,0,3,0,0
"Cameroon","2024-03-14",0,0,2,0,0,3,0,0
"Cameroon","2024-03-15",0,0,2,0,0,3,0,0
"Cameroon","2024-03-16",0,0,2,0,0,3,0,0
"Cameroon","2024-03-17",0,0,2,0,0,3,0,0
"Cameroon","2024-03-18",0,0,2,0,0,3,0,0
"Cameroon","2024-03-19",0,0,2,0,0,3,0,0
"Cameroon","2024-03-20",0,0,2,0,0,3,0,0
"Cameroon","2024-03-21",0,0,2,0,0,3,0,0
"Cameroon","2024-03-22",0,0,2,0,0,3,0,0
"Cameroon","2024-03-23",0,0,2,0,0,3,0,0
"Cameroon","2024-03-24",0,0,2,0,0,3,0,0
"Cameroon","2024-03-25",0,0,2,0,0,3,0,0
"Cameroon","2024-03-26",0,0,2,0,0,3,0,0
"Cameroon","2024-03-27",0,0,2,0,0,3,0,0
"Cameroon","2024-03-28",0,0,2,0,0,3,0,0
"Cameroon","2024-03-29",0,0,2,0,0,3,0,0
"Cameroon","2024-03-30",0,0,2,0,0,3,0,0
"Cameroon","2024-03-31",0,0,2,0,0,3,0,0
"Cameroon","2024-04-01",0,0,2,0,0,3,0,0
"Cameroon","2024-04-02",0,0,2,0,0,3,0,0
"Cameroon","2024-04-03",0,0,2,0,0,3,0,0
"Cameroon","2024-04-04",0,0,2,0,0,3,0,0
"Cameroon","2024-04-05",0,0,2,0,0,3,0,0
"Cameroon","2024-04-06",0,0,2,0,0,3,0,0
"Cameroon","2024-04-07",0,1,3,0,0,3,0,0
"Cameroon","2024-04-08",0,0,3,0,0,3,0,0
"Cameroon","2024-04-09",0,0,3,0,1,4,0,0
"Cameroon","2024-04-10",0,0,3,0,0,4,0,0
"Cameroon","2024-04-11",0,0,3,0,0,4,0,0
"Cameroon","2024-04-12",0,0,3,0,0,4,0,0
"Cameroon","2024-04-13",0,0,3,0,1,5,0,0
"Cameroon","2024-04-14",0,2,5,0,0,5,0,0
"Cameroon","2024-04-15",0,0,5,0,0,5,0,0
"Cameroon","2024-04-16",0,0,5,0,0,5,0,0
"Cameroon","2024-04-17",0,0,5,0,0,5,0,0
"Cameroon","2024-04-18",0,0,5,0,0,5,0,0
"Cameroon","2024-04-19",0,0,5,0,0,5,0,0
"Cameroon","2024-04-20",0,0,5,0,0,5,0,0
"Cameroon","2024-04-21",0,0,5,0,0,5,0,0
"Cameroon","2024-04-22",0,0,5,0,0,5,0,0
"Cameroon","2024-04-23",0,0,5,0,0,5,0,0
"Cameroon","2024-04-24",0,0,5,0,0,5,0,0
"Cameroon","2024-04-25",0,0,5,0,0,5,0,0
"Cameroon","2024-04-26",0,0,5,0,0,5,0,0
"Cameroon","2024-04-27",0,0,5,0,0,5,0,0
"Cameroon","2024-04-28",0,0,5,0,0,5,0,0
"Cameroon","2024-04-29",0,0,5,0,0,5,0,0
"Cameroon","2024-04-30",0,0,5,0,0,5,0,0
"Cameroon","2024-05-01",0,0,5,0,0,5,0,0
"Cameroon","2024-05-02",0,0,5,0,0,5,0,0
"Cameroon","2024-05-03",0,0,5,0,0,5,0,0
"Cameroon","2024-05-04",0,0,5,0,0,5,0,0
"Cameroon","2024-05-05",0,0,5,0,0,5,0,0
"Cameroon","2024-05-06",0,0,5,0,0,5,0,0
"Cameroon","2024-05-07",0,0,5,0,0,5,0,0
"Cameroon","2024-05-08",0,0,5,0,0,5,0,0
"Cameroon","2024-05-09",0,0,5,0,0,5,0,0
"Cameroon","2024-05-10",0,0,5,0,0,5,0,0
"Cameroon","2024-05-11",0,0,5,0,0,5,0,0
"Cameroon","2024-05-12",0,0,5,0,0,5,0,0
"Cameroon","2024-05-13",0,0,5,0,0,5,0,0
"Cameroon","2024-05-14",0,0,5,0,0,5,0,0
"Cameroon","2024-05-15",0,0,5,0,0,5,0,0
"Cameroon","2024-05-16",0,0,5,0,0,5,0,0
"Cameroon","2024-05-17",0,0,5,0,0,5,0,0
"Cameroon","2024-05-18",0,0,5,0,0,5,0,0
"Cameroon","2024-05-19",0,0,5,0,0,5,0,0
"Cameroon","2024-05-20",0,0,5,0,0,5,0,0
"Cameroon","2024-05-21",0,0,5,0,0,5,0,0
"Cameroon","2024-05-22",0,0,5,0,0,5,0,0
"Cameroon","2024-05-23",0,0,5,0,0,5,0,0
"Cameroon","2024-05-24",0,0,5,0,0,5,0,0
"Cameroon","2024-05-25",0,0,5,0,0,5,0,0
"Cameroon","2024-05-26",0,0,5,0,0,5,0,0
"Cameroon","2024-05-27",0,0,5,0,0,5,0,0
"Cameroon","2024-05-28",0,0,5,0,0,5,0,0
"Cameroon","2024-05-29",0,0,5,0,0,5,0,0
"Cameroon","2024-05-30",0,0,5,0,0,5,0,0
"Cameroon","2024-05-31",0,0,5,0,0,5,0,0
"Cameroon","2024-06-01",0,0,5,0,0,5,0,0
"Cameroon","2024-06-02",0,0,5,0,0,5,0,0
"Cameroon","2024-06-03",0,0,5,0,0,5,0,0
"Cameroon","2024-06-04",0,0,5,0,0,5,0,0
"Cameroon","2024-06-05",0,0,5,0,0,5,0,0
"Cameroon","2024-06-06",0,0,5,0,0,5,0,0
"Cameroon","2024-06-07",0,0,5,0,0,5,0,0
"Cameroon","2024-06-08",0,0,5,0,0,5,0,0
"Cameroon","2024-06-09",0,0,5,0,0,5,0,0
"Cameroon","2024-06-10",0,0,5,0,0,5,0,0
"Cameroon","2024-06-11",0,0,5,0,0,5,0,0
"Cameroon","2024-06-12",0,0,5,0,0,5,0,0
"Cameroon","2024-06-13",0,0,5,0,0,5,0,0
"Cameroon","2024-06-14",0,0,5,0,0,5,0,0
"Cameroon","2024-06-15",0,0,5,0,0,5,0,0
"Cameroon","2024-06-16",0,0,5,0,0,5,0,0
"Cameroon","2024-06-17",0,0,5,0,0,5,0,0
"Cameroon","2024-06-18",0,0,5,0,0,5,0,0
"Cameroon","2024-06-19",0,0,5,0,0,5,0,0
"Cameroon","2024-06-20",0,0,5,0,0,5,0,0
"Cameroon","2024-06-21",0,0,5,0,0,5,0,0
"Cameroon","2024-06-22",0,0,5,0,0,5,0,0
"Cameroon","2024-06-23",0,0,5,0,0,5,0,0
"Cameroon","2024-06-24",0,0,5,0,1,6,0,0
"Cameroon","2024-06-25",0,0,5,0,0,6,0,0
"Cameroon","2024-06-26",0,0,5,0,0,6,0,0
"Cameroon","2024-06-27",0,0,5,0,0,6,0,0
"Cameroon","2024-06-28",0,0,5,0,0,6,0,0
"Cameroon","2024-06-29",0,0,5,0,0,6,0,0
"Cameroon","2024-06-30",0,0,5,0,0,6,0,0
"Cameroon","2024-07-01",0,0,5,0,0,6,0,0
"Cameroon","2024-07-02",0,0,5,0,0,6,0,0
"Cameroon","2024-07-03",0,0,5,0,0,6,0,0
"Cameroon","2024-07-04",0,0,5,0,0,6,0,0
"Cameroon","2024-07-05",0,0,5,0,0,6,0,0
"Cameroon","2024-07-06",0,0,5,0,0,6,0,0
"Cameroon","2024-07-07",0,0,5,0,0,6,0,0
"Cameroon","2024-07-08",0,0,5,0,0,6,0,0
"Cameroon","2024-07-09",0,0,5,0,0,6,0,0
"Cameroon","2024-07-10",0,0,5,0,0,6,0,0
"Cameroon","2024-07-11",0,0,5,0,0,6,0,0
"Cameroon","2024-07-12",0,0,5,0,0,6,0,0
"Cameroon","2024-07-13",0,0,5,0,0,6,0,0
"Cameroon","2024-07-14",0,0,5,0,0,6,0,0
"Cameroon","2024-07-15",0,0,5,0,0,6,0,0
"Cameroon","2024-07-16",0,0,5,0,0,6,0,0
"Cameroon","2024-07-17",0,0,5,0,0,6,0,0
"Cameroon","2024-07-18",0,0,5,0,0,6,0,0
"Cameroon","2024-07-19",0,0,5,0,0,6,0,0
"Cameroon","2024-07-20",0,0,5,0,0,6,0,0
"Cameroon","2024-07-21",0,0,5,0,0,6,0,0
"Cameroon","2024-07-22",0,0,5,0,0,6,0,0
"Cameroon","2024-07-23",0,0,5,0,0,6,0,0
"Cameroon","2024-07-24",0,0,5,0,0,6,0,0
"Cameroon","2024-07-25",0,0,5,0,0,6,0,0
"Cameroon","2024-07-26",0,0,5,0,0,6,0,0
"Cameroon","2024-07-27",0,0,5,0,0,6,0,0
"Cameroon","2024-07-28",0,0,5,0,0,6,0,0
"Cameroon","2024-07-29",0,0,5,0,0,6,0,0
"Cameroon","2024-07-30",0,0,5,0,0,6,0,0
"Cameroon","2024-07-31",0,0,5,0,0,6,0,0
"Cameroon","2024-08-01",0,0,5,0,0,6,0,0
"Cameroon","2024-08-02",0,0,5,0,0,6,0,0
"Cameroon","2024-08-03",0,0,5,0,0,6,0,0
"Cameroon","2024-08-04",0,0,5,0,0,6,0,0
"Cameroon","2024-08-05",0,0,5,0,0,6,0,0
"Cameroon","2024-08-06",0,0,5,0,0,6,0,0
"Cameroon","2024-08-07",0,0,5,0,0,6,0,0
"Cameroon","2024-08-08",0,0,5,0,0,6,0,0
"Cameroon","2024-08-09",0,0,5,0,0,6,0,0
"Cameroon","2024-08-10",0,0,5,0,0,6,0,0
"Cameroon","2024-08-11",0,0,5,0,0,6,0,0
"Cameroon","2024-08-12",0,0,5,0,0,6,0,0
"Cameroon","2024-08-13",0,0,5,0,0,6,0,0
"Cameroon","2024-08-14",0,0,5,0,0,6,0,0
"Cameroon","2024-08-15",0,0,5,0,0,6,0,0
"Cameroon","2024-08-16",30,0,5,30,0,6,30,30
"Cameroon","2024-08-17",0,0,5,30,0,6,0,30
"Cameroon","2024-08-18",0,0,5,30,0,6,1,31
"Cameroon","2024-08-19",0,0,5,30,0,6,0,31
"Cameroon","2024-08-20",0,0,5,30,0,6,0,31
"Cameroon","2024-08-21",0,0,5,30,0,6,1,32
"Cameroon","2024-08-22",0,0,5,30,0,6,0,32
"Cameroon","2024-08-23",0,0,5,30,0,6,0,32
"Cameroon","2024-08-24",0,0,5,30,0,6,0,32
"Cameroon","2024-08-25",0,0,5,30,0,6,1,33
"Cameroon","2024-08-26",0,0,5,30,0,6,0,33
"Cameroon","2024-08-27",0,0,5,30,0,6,0,33
"Cameroon","2024-08-28",0,0,5,30,0,6,1,34
"Cameroon","2024-08-29",0,0,5,30,0,6,0,34
"Cameroon","2024-08-30",0,0,5,30,0,6,0,34
"Cameroon","2024-08-31",0,0,5,30,0,6,1,35
"Cameroon","2024-09-01",0,1,6,30,0,6,0,35
"Cameroon","2024-09-02",0,0,6,30,0,6,0,35
"Cameroon","2024-09-03",0,0,6,30,0,6,0,35
"Cameroon","2024-09-04",0,0,6,30,0,6,1,36
"Cameroon","2024-09-05",0,0,6,30,0,6,0,36
"Cameroon","2024-09-06",0,0,6,30,0,6,0,36
"Cameroon","2024-09-07",0,0,6,30,0,6,1,37
"Cameroon","2024-09-08",7,0,6,37,0,6,0,37
"Cameroon","2024-09-09",0,0,6,37,0,6,1,38
"Cameroon","2024-09-10",0,0,6,37,0,6,1,39
"Cameroon","2024-09-11",0,0,6,37,0,6,0,39
"Cameroon","2024-09-12",3,0,6,40,0,6,1,40
"Cameroon","2024-09-13",0,0,6,40,0,6,2,42
"Cameroon","2024-09-14",0,0,6,40,0,6,2,44
"Cameroon","2024-09-15",0,0,6,40,0,6,2,46
"Cameroon","2024-09-16",0,0,6,40,0,6,2,48
"Cameroon","2024-09-17",0,0,6,40,0,6,2,50
"Cameroon","2024-09-18",0,0,6,40,0,6,2,52
"Cameroon","2024-09-19",0,0,6,40,0,6,2,54
"Cameroon","2024-09-20",0,0,6,40,0,6,2,56
"Cameroon","2024-09-21",0,0,6,40,0,6,2,58
"Cameroon","2024-09-22",0,0,6,40,0,6,1,59
"Cameroon","2024-09-23",0,0,6,40,0,6,2,61
"Cameroon","2024-09-24",0,0,6,40,0,6,2,63
"Cameroon","2024-09-25",0,0,6,40,0,6,2,65
"Cameroon","2024-09-26",0,0,6,40,0,6,2,67
"Cameroon","2024-09-27",0,0,6,40,0,6,2,69
"Cameroon","2024-09-28",0,0,6,40,0,6,2,71
"Cameroon","2024-09-29",0,0,6,40,0,6,2,73
"Cameroon","2024-09-30",35,0,6,75,0,6,2,75
"Cameroon","2024-10-01",0,0,6,75,0,6,1,76
"Cameroon","2024-10-02",0,0,6,75,0,6,2,78
"Cameroon","2024-10-03",0,0,6,75,0,6,1,79
"Cameroon","2024-10-04",0,0,6,75,0,6,1,80
"Cameroon","2024-10-05",0,0,6,75,0,6,2,82
"Cameroon","2024-10-06",8,0,6,83,0,6,1,83
"Cameroon","2024-10-07",0,0,6,83,0,6,2,85
"Cameroon","2024-10-08",0,0,6,83,0,6,1,86
"Cameroon","2024-10-09",0,0,6,83,0,6,1,87
"Cameroon","2024-10-10",0,0,6,83,0,6,2,89
"Cameroon","2024-10-11",0,0,6,83,0,6,2,91
"Cameroon","2024-10-12",9,0,6,92,0,6,1,92
"Cameroon","2024-10-13",2,0,6,94,0,6,2,94
"Cameroon","2024-10-14",0,0,6,94,0,6,0,94
"Cameroon","2024-10-15",0,0,6,94,0,6,1,95
"Cameroon","2024-10-16",0,0,6,94,0,6,0,95
"Cameroon","2024-10-17",0,0,6,94,0,6,1,96
"Cameroon","2024-10-18",0,0,6,94,0,6,0,96
"Cameroon","2024-10-19",0,0,6,94,0,6,1,97
"Cameroon","2024-10-20",3,0,6,97,0,6,0,97
"Cameroon","2024-10-21",0,0,6,97,0,6,0,97
"Cameroon","2024-10-22",0,0,6,97,0,6,1,98
"Cameroon","2024-10-23",0,0,6,97,0,6,0,98
"Cameroon","2024-10-24",0,0,6,97,0,6,0,98
"Cameroon","2024-10-25",0,0,6,97,0,6,0,98
"Cameroon","2024-10-26",0,0,6,97,0,6,1,99
"Cameroon","2024-10-27",2,0,6,99,0,6,0,99
"Cameroon","2024-10-28",0,0,6,99,0,6,1,100
"Cameroon","2024-10-29",0,0,6,99,0,6,0,100
"Cameroon","2024-10-30",0,0,6,99,0,6,1,101
"Cameroon","2024-10-31",0,0,6,99,0,6,0,101
"Cameroon","2024-11-01",0,0,6,99,0,6,1,102
"Cameroon","2024-11-02",0,0,6,99,0,6,0,102
"Cameroon","2024-11-03",4,0,6,103,0,6,1,103
"Cameroon","2024-11-04",0,0,6,103,0,6,0,103
"Cameroon","2024-11-05",0,0,6,103,0,6,0,103
"Cameroon","2024-11-06",0,0,6,103,0,6,0,103
"Cameroon","2024-11-07",0,0,6,103,0,6,0,103
"Cameroon","2024-11-08",0,0,6,103,0,6,0,103
"Cameroon","2024-11-09",0,0,6,103,0,6,0,103
"Cameroon","2024-11-10",0,0,6,103,0,6,0,103
"Cameroon","2024-11-11",0,0,6,103,0,6,0,103
"Cameroon","2024-11-12",0,0,6,103,0,6,0,103
"Cameroon","2024-11-13",0,0,6,103,0,6,0,103
"Cameroon","2024-11-14",0,0,6,103,0,6,0,103
"Cameroon","2024-11-15",0,0,6,103,0,6,0,103
"Cameroon","2024-11-16",0,0,6,103,0,6,0,103
"Cameroon","2024-11-17",0,0,6,103,0,6,0,103
"Cameroon","2024-11-18",0,0,6,103,0,6,0,103
"Cameroon","2024-11-19",0,0,6,103,0,6,0,103
"Cameroon","2024-11-20",0,0,6,103,0,6,0,103
"Cameroon","2024-11-21",0,0,6,103,0,6,0,103
"Cameroon","2024-11-22",0,0,6,103,0,6,0,103
"Cameroon","2024-11-23",0,0,6,103,0,6,0,103
"Cameroon","2024-11-24",0,0,6,103,0,6,0,103
"Cameroon","2024-11-25",0,0,6,103,0,6,0,103
"Cameroon","2024-11-26",0,0,6,103,0,6,0,103
"Cameroon","2024-11-27",0,0,6,103,0,6,0,103
"Cameroon","2024-11-28",0,0,6,103,0,6,0,103
"Cameroon","2024-11-29",0,0,6,103,0,6,0,103
"Cameroon","2024-11-30",0,0,6,103,0,6,0,103
"Cameroon","2024-12-01",0,0,6,103,0,6,0,103
"Cameroon","2024-12-02",0,0,6,103,0,6,0,103
"Cameroon","2024-12-03",0,0,6,103,0,6,0,103
"Cameroon","2024-12-04",0,0,6,103,0,6,0,103
"Cameroon","2024-12-05",0,0,6,103,0,6,0,103
"Cameroon","2024-12-06",0,0,6,103,0,6,0,103
"Cameroon","2024-12-07",0,0,6,103,0,6,0,103
"Cameroon","2024-12-08",0,0,6,103,0,6,0,103
"Cameroon","2024-12-09",0,0,6,103,0,6,0,103
"Canada","2024-01-01",0,0,0,0,0,0,0,0
"Canada","2024-01-02",0,0,0,0,0,0,0,0
"Canada","2024-01-03",0,0,0,0,0,0,0,0
"Canada","2024-01-04",0,0,0,0,0,0,0,0
"Canada","2024-01-05",0,0,0,0,0,0,0,0
"Canada","2024-01-06",0,0,0,0,0,0,0,0
"Canada","2024-01-07",0,0,0,0,0,0,0,0
"Canada","2024-01-08",0,0,0,0,0,0,0,0
"Canada","2024-01-09",0,1,1,0,1,1,0,0
"Canada","2024-01-10",0,0,1,0,0,1,0,0
"Canada","2024-01-11",0,0,1,0,0,1,0,0
"Canada","2024-01-12",0,0,1,0,1,2,0,0
"Canada","2024-01-13",0,0,1,0,0,2,0,0
"Canada","2024-01-14",0,0,1,0,0,2,0,0
"Canada","2024-01-15",0,0,1,0,0,2,0,0
"Canada","2024-01-16",0,0,1,0,1,3,0,0
"Canada","2024-01-17",0,0,1,0,0,3,0,0
"Canada","2024-01-18",0,0,1,0,0,3,0,0
"Canada","2024-01-19",0,0,1,0,0,3,0,0
"Canada","2024-01-20",0,0,1,0,0,3,0,0
"Canada","2024-01-21",0,0,1,0,1,4,0,0
"Canada","2024-01-22",0,0,1,0,0,4,0,0
"Canada","2024-01-23",0,3,4,0,0,4,0,0
"Canada","2024-01-24",0,0,4,0,1,5,0,0
"Canada","2024-01-25",0,0,4,0,0,5,0,0
"Canada","2024-01-26",0,0,4,0,1,6,0,0
"Canada","2024-01-27",0,0,4,0,0,6,0,0
"Canada","2024-01-28",0,0,4,0,1,7,0,0
"Canada","2024-01-29",0,0,4,0,0,7,0,0
"Canada","2024-01-30",0,4,8,0,1,8,0,0
"Canada","2024-01-31",0,0,8,0,1,9,0,0
"Canada","2024-02-01",0,0,8,0,1,10,0,0
"Canada","2024-02-02",0,0,8,0,1,11,0,0
"Canada","2024-02-03",0,0,8,0,1,12,0,0
"Canada","2024-02-04",0,0,8,0,1,13,0,0
"Canada","2024-02-05",0,0,8,0,1,14,0,0
"Canada","2024-02-06",0,7,15,0,1,15,0,0
"Canada","2024-02-07",0,0,15,0,1,16,0,0
"Canada","2024-02-08",0,0,15,0,1,17,0,0
"Canada","2024-02-09",0,0,15,0,1,18,0,0
"Canada","2024-02-10",0,0,15,0,2,20,0,0
"Canada","2024-02-11",0,0,15,0,1,21,0,0
"Canada","2024-02-12",0,0,15,0,1,22,0,0
"Canada","2024-02-13",0,8,23,0,1,23,0,0
"Canada","2024-02-14",0,0,23,0,1,24,0,0
"Canada","2024-02-15",0,0,23,0,1,25,0,0
"Canada","2024-02-16",0,0,23,0,1,26,0,0
"Canada","2024-02-17",0,0,23,0,2,28,0,0
"Canada","2024-02-18",0,0,23,0,1,29,0,0
"Canada","2024-02-19",0,0,23,0,1,30,0,0
"Canada","2024-02-20",0,8,31,0,1,31,0,0
"Canada","2024-02-21",0,0,31,0,0,31,0,0
"Canada","2024-02-22",0,0,31,0,0,31,0,0
"Canada","2024-02-23",0,0,31,0,0,31,0,0
"Canada","2024-02-24",0,0,31,0,1,32,0,0
"Canada","2024-02-25",0,0,31,0,0,32,0,0
"Canada","2024-02-26",0,0,31,0,0,32,0,0
"Canada","2024-02-27",0,1,32,0,0,32,0,0
"Canada","2024-02-28",0,0,32,0,1,33,0,0
"Canada","2024-02-29",0,0,32,0,1,34,0,0
"Canada","2024-03-01",0,0,32,0,1,35,0,0
"Canada","2024-03-02",0,0,32,0,0,35,0,0
"Canada","2024-03-03",0,0,32,0,1,36,0,0
"Canada","2024-03-04",0,0,32,0,1,37,0,0
"Canada","2024-03-05",0,6,38,0,1,38,0,0
"Canada","2024-03-06",0,0,38,0,0,38,0,0
"Canada","2024-03-07",0,0,38,0,0,38,0,0
"Canada","2024-03-08",0,0,38,0,0,38,0,0
"Canada","2024-03-09",0,0,38,0,1,39,0,0
"Canada","2024-03-10",0,0,38,0,0,39,0,0
"Canada","2024-03-11",0,0,38,0,0,39,0,0
"Canada","2024-03-12",0,0,38,0,0,39,0,0
"Canada","2024-03-13",0,0,38,0,0,39,0,0
"Canada","2024-03-14",0,0,38,0,0,39,0,0
"Canada","2024-03-15",0,0,38,0,0,39,0,0
"Canada","2024-03-16",0,0,38,0,1,40,0,0
"Canada","2024-03-17",0,0,38,0,0,40,0,0
"Canada","2024-03-18",0,0,38,0,0,40,0,0
"Canada","2024-03-19",0,2,40,0,0,40,0,0
"Canada","2024-03-20",0,0,40,0,1,41,0,0
"Canada","2024-03-21",0,0,40,0,0,41,0,0
"Canada","2024-03-22",0,0,40,0,1,42,0,0
"Canada","2024-03-23",0,0,40,0,0,42,0,0
"Canada","2024-03-24",0,0,40,0,1,43,0,0
"Canada","2024-03-25",0,0,40,0,0,43,0,0
"Canada","2024-03-26",0,4,44,0,1,44,0,0
"Canada","2024-03-27",0,0,44,0,1,45,0,0
"Canada","2024-03-28",0,0,44,0,0,45,0,0
"Canada","2024-03-29",0,0,44,0,1,46,0,0
"Canada","2024-03-30",0,0,44,0,0,46,0,0
"Canada","2024-03-31",0,0,44,0,1,47,0,0
"Canada","2024-04-01",0,0,44,0,0,47,0,0
"Canada","2024-04-02",0,4,48,0,1,48,0,0
"Canada","2024-04-03",0,0,48,0,1,49,0,0
"Canada","2024-04-04",0,0,48,0,0,49,0,0
"Canada","2024-04-05",0,0,48,0,1,50,0,0
"Canada","2024-04-06",0,0,48,0,0,50,0,0
"Canada","2024-04-07",0,0,48,0,1,51,0,0
"Canada","2024-04-08",0,0,48,0,0,51,0,0
"Canada","2024-04-09",0,4,52,0,1,52,0,0
"Canada","2024-04-10",0,0,52,0,0,52,0,0
"Canada","2024-04-11",0,0,52,0,1,53,0,0
"Canada","2024-04-12",0,0,52,0,0,53,0,0
"Canada","2024-04-13",0,0,52,0,1,54,0,0
"Canada","2024-04-14",0,0,52,0,0,54,0,0
"Canada","2024-04-15",0,0,52,0,1,55,0,0
"Canada","2024-04-16",0,3,55,0,0,55,0,0
"Canada","2024-04-17",0,0,55,0,0,55,0,0
"Canada","2024-04-18",0,0,55,0,0,55,0,0
"Canada","2024-04-19",0,0,55,0,0,55,0,0
"Canada","2024-04-20",0,0,55,0,1,56,0,0
"Canada","2024-04-21",0,0,55,0,0,56,0,0
"Canada","2024-04-22",0,0,55,0,0,56,0,0
"Canada","2024-04-23",0,1,56,0,0,56,0,0
"Canada","2024-04-24",0,0,56,0,0,56,0,0
"Canada","2024-04-25",0,0,56,0,1,57,0,0
"Canada","2024-04-26",0,0,56,0,0,57,0,0
"Canada","2024-04-27",0,0,56,0,0,57,0,0
"Canada","2024-04-28",0,0,56,0,0,57,0,0
"Canada","2024-04-29",0,0,56,0,1,58,0,0
"Canada","2024-04-30",0,2,58,0,0,58,0,0
"Canada","2024-05-01",0,0,58,0,1,59,0,0
"Canada","2024-05-02",0,0,58,0,0,59,0,0
"Canada","2024-05-03",0,0,58,0,1,60,0,0
"Canada","2024-05-04",0,0,58,0,0,60,0,0
"Canada","2024-05-05",0,0,58,0,1,61,0,0
"Canada","2024-05-06",0,0,58,0,0,61,0,0
"Canada","2024-05-07",0,4,62,0,1,62,0,0
"Canada","2024-05-08",0,0,62,0,1,63,0,0
"Canada","2024-05-09",0,0,62,0,1,64,0,0
"Canada","2024-05-10",0,0,62,0,1,65,0,0
"Canada","2024-05-11",0,0,62,0,2,67,0,0
"Canada","2024-05-12",0,0,62,0,1,68,0,0
"Canada","2024-05-13",0,0,62,0,1,69,0,0
"Canada","2024-05-14",0,8,70,0,1,70,0,0
"Canada","2024-05-15",0,0,70,0,0,70,0,0
"Canada","2024-05-16",0,0,70,0,1,71,0,0
"Canada","2024-05-17",0,0,70,0,0,71,0,0
"Canada","2024-05-18",0,0,70,0,1,72,0,0
"Canada","2024-05-19",0,0,70,0,0,72,0,0
"Canada","2024-05-20",0,0,70,0,1,73,0,0
"Canada","2024-05-21",0,3,73,0,0,73,0,0
"Canada","2024-05-22",0,0,73,0,1,74,0,0
"Canada","2024-05-23",0,0,73,0,1,75,0,0
"Canada","2024-05-24",0,0,73,0,1,76,0,0
"Canada","2024-05-25",0,0,73,0,1,77,0,0
"Canada","2024-05-26",0,0,73,0,1,78,0,0
"Canada","2024-05-27",0,0,73,0,1,79,0,0
"Canada","2024-05-28",0,7,80,0,1,80,0,0
"Canada","2024-05-29",0,0,80,0,1,81,0,0
"Canada","2024-05-30",0,0,80,0,1,82,0,0
"Canada","2024-05-31",0,0,80,0,1,83,0,0
"Canada","2024-06-01",0,0,80,0,2,85,0,0
"Canada","2024-06-02",0,0,80,0,1,86,0,0
"Canada","2024-06-03",0,0,80,0,1,87,0,0
"Canada","2024-06-04",0,8,88,0,1,88,0,0
"Canada","2024-06-05",0,0,88,0,1,89,0,0
"Canada","2024-06-06",0,0,88,0,1,90,0,0
"Canada","2024-06-07",0,0,88,0,1,91,0,0
"Canada","2024-06-08",0,0,88,0,2,93,0,0
"Canada","2024-06-09",0,0,88,0,1,94,0,0
"Canada","2024-06-10",0,0,88,0,1,95,0,0
"Canada","2024-06-11",0,8,96,0,1,96,0,0
"Canada","2024-06-12",0,0,96,0,0,96,0,0
"Canada","2024-06-13",0,0,96,0,1,97,0,0
"Canada","2024-06-14",0,0,96,0,0,97,0,0
"Canada","2024-06-15",0,0,96,0,0,97,0,0
"Canada","2024-06-16",0,0,96,0,0,97,0,0
"Canada","2024-06-17",0,0,96,0,1,98,0,0
"Canada","2024-06-18",0,2,98,0,0,98,0,0
"Canada","2024-06-19",0,0,98,0,2,100,0,0
"Canada","2024-06-20",0,0,98,0,1,101,0,0
"Canada","2024-06-21",0,0,98,0,2,103,0,0
"Canada","2024-06-22",0,0,98,0,1,104,0,0
"Canada","2024-06-23",0,0,98,0,2,106,0,0
"Canada","2024-06-24",0,0,98,0,1,107,0,0
"Canada","2024-06-25",0,11,109,0,2,109,0,0
"Canada","2024-06-26",0,0,109,0,2,111,0,0
"Canada","2024-06-27",0,0,109,0,1,112,0,0
"Canada","2024-06-28",0,0,109,0,2,114,0,0
"Canada","2024-06-29",0,0,109,0,2,116,0,0
"Canada","2024-06-30",0,0,109,0,2,118,0,0
"Canada","2024-07-01",0,0,109,0,1,119,0,0
"Canada","2024-07-02",0,12,121,0,2,121,0,0
"Canada","2024-07-03",0,0,121,0,2,123,0,0
"Canada","2024-07-04",0,0,121,0,1,124,0,0
"Canada","2024-07-05",0,0,121,0,2,126,0,0
"Canada","2024-07-06",0,0,121,0,1,127,0,0
"Canada","2024-07-07",0,0,121,0,2,129,0,0
"Canada","2024-07-08",0,0,121,0,1,130,0,0
"Canada","2024-07-09",0,11,132,0,2,132,0,0
"Canada","2024-07-10",0,0,132,0,2,134,0,0
"Canada","2024-07-11",0,0,132,0,1,135,0,0
"Canada","2024-07-12",0,0,132,0,2,137,0,0
"Canada","2024-07-13",0,0,132,0,2,139,0,0
"Canada","2024-07-14",0,0,132,0,2,141,0,0
"Canada","2024-07-15",0,0,132,0,1,142,0,0
"Canada","2024-07-16",0,12,144,0,2,144,0,0
"Canada","2024-07-17",0,0,144,0,2,146,0,0
"Canada","2024-07-18",0,0,144,0,2,148,0,0
"Canada","2024-07-19",0,0,144,0,2,150,0,0
"Canada","2024-07-20",0,0,144,0,3,153,0,0
"Canada","2024-07-21",0,0,144,0,2,155,0,0
"Canada","2024-07-22",0,0,144,0,2,157,0,0
"Canada","2024-07-23",0,15,159,0,2,159,0,0
"Canada","2024-07-24",0,0,159,0,2,161,0,0
"Canada","2024-07-25",0,0,159,0,3,164,0,0
"Canada","2024-07-26",0,0,159,0,2,166,0,0
"Canada","2024-07-27",0,0,159,0,2,168,0,0
"Canada","2024-07-28",0,0,159,0,2,170,0,0
"Canada","2024-07-29",0,0,159,0,3,173,0,0
"Canada","2024-07-30",0,16,175,0,2,175,0,0
"Canada","2024-07-31",0,0,175,0,3,178,0,0
"Canada","2024-08-01",0,0,175,0,2,180,0,0
"Canada","2024-08-02",0,0,175,0,3,183,0,0
"Canada","2024-08-03",0,0,175,0,3,186,0,0
"Canada","2024-08-04",0,0,175,0,3,189,0,0
"Canada","2024-08-05",0,0,175,0,2,191,0,0
"Canada","2024-08-06",0,19,194,0,3,194,0,0
"Canada","2024-08-07",0,0,194,0,3,197,0,0
"Canada","2024-08-08",0,0,194,0,2,199,0,0
"Canada","2024-08-09",0,0,194,0,3,202,0,0
"Canada","2024-08-10",0,0,194,0,3,205,0,0
"Canada","2024-08-11",0,0,194,0,3,208,0,0
"Canada","2024-08-12",0,0,194,0,2,210,0,0
"Canada","2024-08-13",0,19,213,0,3,213,0,0
"Canada","2024-08-14",0,0,213,0,1,214,0,0
"Canada","2024-08-15",0,0,213,0,2,216,0,0
"Canada","2024-08-16",0,0,213,0,1,217,0,0
"Canada","2024-08-17",0,0,213,0,1,218,0,0
"Canada","2024-08-18",0,0,213,0,1,219,0,0
"Canada","2024-08-19",0,0,213,0,2,221,0,0
"Canada","2024-08-20",0,9,222,0,1,222,0,0
"Canada","2024-08-21",0,0,222,0,2,224,0,0
"Canada","2024-08-22",0,0,222,0,3,227,0,0
"Canada","2024-08-23",0,0,222,0,2,229,0,0
"Canada","2024-08-24",0,0,222,0,2,231,0,0
"Canada","2024-08-25",0,0,222,0,2,233,0,0
"Canada","2024-08-26",0,0,222,0,3,236,0,0
"Canada","2024-08-27",0,16,238,0,2,238,0,0
"Canada","2024-08-28",0,0,238,0,1,239,0,0
"Canada","2024-08-29",0,0,238,0,2,241,0,0
"Canada","2024-08-30",0,0,238,0,1,242,0,0
"Canada","2024-08-31",0,0,238,0,1,243,0,0
"Canada","2024-09-01",0,0,238,0,1,244,0,0
"Canada","2024-09-02",0,0,238,0,2,246,0,0
"Canada","2024-09-03",0,9,247,0,1,247,0,0
"Canada","2024-09-04",0,0,247,0,1,248,0,0
"Canada","2024-09-05",0,0,247,0,1,249,0,0
"Canada","2024-09-06",0,0,247,0,1,250,0,0
"Canada","2024-09-07",0,0,247,0,2,252,0,0
"Canada","2024-09-08",0,0,247,0,1,253,0,0
"Canada","2024-09-09",0,0,247,0,1,254,0,0
"Canada","2024-09-10",0,8,255,0,1,255,0,0
"Canada","2024-09-11",0,0,255,0,0,255,0,0
"Canada","2024-09-12",0,0,255,0,0,255,0,0
"Canada","2024-09-13",0,0,255,0,0,255,0,0
"Canada","2024-09-14",0,0,255,0,0,255,0,0
"Canada","2024-09-15",0,0,255,0,0,255,0,0
"Canada","2024-09-16",0,0,255,0,0,255,0,0
"Canada","2024-09-17",0,0,255,0,0,255,0,0
"Canada","2024-09-18",0,0,255,0,0,255,0,0
"Canada","2024-09-19",0,0,255,0,0,255,0,0
"Canada","2024-09-20",0,0,255,0,0,255,0,0
"Canada","2024-09-21",0,0,255,0,0,255,0,0
"Canada","2024-09-22",0,0,255,0,0,255,0,0
"Canada","2024-09-23",0,0,255,0,0,255,0,0
"Canada","2024-09-24",0,0,255,0,0,255,0,0
"Canada","2024-09-25",0,0,255,0,0,255,0,0
"Canada","2024-09-26",0,0,255,0,0,255,0,0
"Canada","2024-09-27",0,0,255,0,0,255,0,0
"Canada","2024-09-28",0,0,255,0,0,255,0,0
"Canada","2024-09-29",0,0,255,0,0,255,0,0
"Canada","2024-09-30",0,0,255,0,0,255,0,0
"Canada","2024-10-01",0,0,255,0,0,255,0,0
"Canada","2024-10-02",0,0,255,0,0,255,0,0
"Canada","2024-10-03",0,0,255,0,0,255,0,0
"Canada","2024-10-04",0,0,255,0,0,255,0,0
"Canada","2024-10-05",0,0,255,0,0,255,0,0
"Canada","2024-10-06",0,0,255,0,0,255,0,0
"Canada","2024-10-07",0,0,255,0,0,255,0,0
"Canada","2024-10-08",0,0,255,0,0,255,0,0
"Canada","2024-10-09",0,0,255,0,0,255,0,0
"Canada","2024-10-10",0,0,255,0,0,255,0,0
"Canada","2024-10-11",0,0,255,0,0,255,0,0
"Canada","2024-10-12",0,0,255,0,0,255,0,0
"Canada","2024-10-13",0,0,255,0,0,255,0,0
"Canada","2024-10-14",0,0,255,0,0,255,0,0
"Canada","2024-10-15",0,0,255,0,0,255,0,0
"Canada","2024-10-16",0,0,255,0,0,255,0,0
"Canada","2024-10-17",0,0,255,0,0,255,0,0
"Canada","2024-10-18",0,0,255,0,0,255,0,0
"Canada","2024-10-19",0,0,255,0,0,255,0,0
"Canada","2024-10-20",0,0,255,0,0,255,0,0
"Canada","2024-10-21",0,0,255,0,0,255,0,0
"Canada","2024-10-22",0,0,255,0,0,255,0,0
"Canada","2024-10-23",0,0,255,0,0,255,0,0
"Canada","2024-10-24",0,0,255,0,0,255,0,0
"Canada","2024-10-25",0,0,255,0,0,255,0,0
"Canada","2024-10-26",0,0,255,0,0,255,0,0
"Canada","2024-10-27",0,0,255,0,0,255,0,0
"Canada","2024-10-28",0,0,255,0,0,255,0,0
"Canada","2024-10-29",0,0,255,0,0,255,0,0
"Canada","2024-10-30",0,0,255,0,0,255,0,0
"Canada","2024-10-31",0,0,255,0,0,255,0,0
"Canada","2024-11-01",0,0,255,0,0,255,0,0
"Canada","2024-11-02",0,0,255,0,0,255,0,0
"Canada","2024-11-03",0,0,255,0,0,255,0,0
"Canada","2024-11-04",0,0,255,0,0,255,0,0
"Canada","2024-11-05",0,0,255,0,0,255,0,0
"Canada","2024-11-06",0,0,255,0,0,255,0,0
"Canada","2024-11-07",0,0,255,0,0,255,0,0
"Canada","2024-11-08",0,0,255,0,0,255,0,0
"Canada","2024-11-09",0,0,255,0,0,255,0,0
"Canada","2024-11-10",0,0,255,0,0,255,0,0
"Canada","2024-11-11",0,0,255,0,0,255,0,0
"Canada","2024-11-12",0,0,255,0,0,255,0,0
"Canada","2024-11-13",0,0,255,0,0,255,0,0
"Canada","2024-11-14",0,0,255,0,0,255,0,0
"Canada","2024-11-15",0,0,255,0,0,255,0,0
"Canada","2024-11-16",0,0,255,0,0,255,0,0
"Canada","2024-11-17",0,0,255,0,0,255,0,0
"Canada","2024-11-18",0,0,255,0,0,255,0,0
"Canada","2024-11-19",0,0,255,0,0,255,0,0
"Canada","2024-11-20",0,0,255,0,0,255,0,0
"Canada","2024-11-21",0,0,255,0,0,255,0,0
"Canada","2024-11-22",0,0,255,0,0,255,0,0
"Canada","2024-11-23",0,0,255,0,0,255,0,0
"Canada","2024-11-24",0,0,255,0,0,255,0,0
"Canada","2024-11-25",0,0,255,0,0,255,0,0
"Canada","2024-11-26",0,0,255,0,0,255,0,0
"Canada","2024-11-27",0,0,255,0,0,255,0,0
"Canada","2024-11-28",0,0,255,0,0,255,0,0
"Canada","2024-11-29",0,0,255,0,0,255,0,0
"Canada","2024-11-30",0,0,255,0,0,255,0,0
"Canada","2024-12-01",0,0,255,0,0,255,0,0
"Canada","2024-12-02",0,0,255,0,0,255,0,0
"Canada","2024-12-03",0,0,255,0,0,255,0,0
"Canada","2024-12-04",0,0,255,0,0,255,0,0
"Canada","2024-12-05",0,0,255,0,0,255,0,0
"Canada","2024-12-06",0,0,255,0,0,255,0,0
"Canada","2024-12-07",0,0,255,0,0,255,0,0
"Canada","2024-12-08",0,0,255,0,0,255,0,0
"Canada","2024-12-09",0,0,255,0,0,255,0,0
"Central African Republic","2024-01-01",0,0,0,0,0,0,0,0
"Central African Republic","2024-01-02",0,0,0,0,0,0,0,0
"Central African Republic","2024-01-03",0,0,0,0,0,0,0,0
"Central African Republic","2024-01-04",0,0,0,0,0,0,0,0
"Central African Republic","2024-01-05",0,0,0,0,0,0,0,0
"Central African Republic","2024-01-06",0,0,0,0,0,0,0,0
"Central African Republic","2024-01-07",0,0,0,0,0,0,0,0
"Central African Republic","2024-01-08",0,0,0,0,0,0,0,0
"Central African Republic","2024-01-09",0,0,0,0,0,0,0,0
"Central African Republic","2024-01-10",0,0,0,0,0,0,0,0
"Central African Republic","2024-01-11",0,0,0,0,0,0,0,0
"Central African Republic","2024-01-12",0,0,0,0,0,0,0,0
"Central African Republic","2024-01-13",0,0,0,0,0,0,0,0
"Central African Republic","2024-01-14",0,0,0,0,0,0,0,0
"Central African Republic","2024-01-15",0,0,0,0,0,0,0,0
"Central African Republic","2024-01-16",0,0,0,0,0,0,0,0
"Central African Republic","2024-01-17",0,0,0,0,0,0,0,0
"Central African Republic","2024-01-18",0,0,0,0,0,0,0,0
"Central African Republic","2024-01-19",0,0,0,0,0,0,0,0
"Central African Republic","2024-01-20",0,0,0,0,0,0,0,0
"Central African Republic","2024-01-21",0,4,4,0,4,4,0,0
"Central African Republic","2024-01-22",0,0,4,0,0,4,0,0
"Central African Republic","2024-01-23",0,0,4,0,0,4,0,0
"Central African Republic","2024-01-24",0,0,4,0,0,4,0,0
"Central African Republic","2024-01-25",0,0,4,0,1,5,0,0
"Central African Republic","2024-01-26",0,0,4,0,0,5,0,0
"Central African Republic","2024-01-27",0,0,4,0,0,5,0,0
"Central African Republic","2024-01-28",0,1,5,0,0,5,0,0
"Central African Republic","2024-01-29",0,0,5,0,0,5,0,0
"Central African Republic","2024-01-30",0,0,5,0,0,5,0,0
"Central African Republic","2024-01-31",0,0,5,0,0,5,0,0
"Central African Republic","2024-02-01",0,0,5,0,1,6,0,0
"Central African Republic","2024-02-02",0,0,5,0,0,6,0,0
"Central African Republic","2024-02-03",0,0,5,0,0,6,0,0
"Central African Republic","2024-02-04",0,1,6,0,0,6,0,0
"Central African Republic","2024-02-05",0,0,6,0,0,6,0,0
"Central African Republic","2024-02-06",0,0,6,0,0,6,0,0
"Central African Republic","2024-02-07",0,0,6,0,0,6,0,0
"Central African Republic","2024-02-08",0,0,6,0,1,7,0,0
"Central African Republic","2024-02-09",0,0,6,0,0,7,0,0
"Central African Republic","2024-02-10",0,0,6,0,0,7,0,0
"Central African Republic","2024-02-11",0,1,7,0,0,7,0,0
"Central African Republic","2024-02-12",0,0,7,0,0,7,0,0
"Central African Republic","2024-02-13",0,0,7,0,1,8,0,0
"Central African Republic","2024-02-14",0,0,7,0,0,8,0,0
"Central African Republic","2024-02-15",0,0,7,0,1,9,0,0
"Central African Republic","2024-02-16",0,0,7,0,0,9,0,0
"Central African Republic","2024-02-17",0,0,7,0,1,10,0,0
"Central African Republic","2024-02-18",0,3,10,0,0,10,0,0
"Central African Republic","2024-02-19",0,0,10,0,1,11,0,0
"Central African Republic","2024-02-20",0,0,10,0,0,11,0,0
"Central African Republic","2024-02-21",0,0,10,0,1,12,0,0
"Central African Republic","2024-02-22",0,0,10,0,0,12,0,0
"Central African Republic","2024-02-23",0,0,10,0,1,13,0,0
"Central African Republic","2024-02-24",0,0,10,0,0,13,0,0
"Central African Republic","2024-02-25",0,4,14,0,1,14,0,0
"Central African Republic","2024-02-26",0,0,14,0,0,14,0,0
"Central African Republic","2024-02-27",0,0,14,0,0,14,0,0
"Central African Republic","2024-02-28",0,0,14,0,0,14,0,0
"Central African Republic","2024-02-29",0,0,14,0,0,14,0,0
"Central African Republic","2024-03-01",0,0,14,0,0,14,0,0
"Central African Republic","2024-03-02",0,0,14,0,0,14,0,0
"Central African Republic","2024-03-03",0,0,14,0,0,14,0,0
"Central African Republic","2024-03-04",0,0,14,0,1,15,0,0
"Central African Republic","2024-03-05",0,0,14,0,0,15,0,0
"Central African Republic","2024-03-06",0,0,14,0,0,15,0,0
"Central African Republic","2024-03-07",0,0,14,0,0,15,0,0
"Central African Republic","2024-03-08",0,0,14,0,0,15,0,0
"Central African Republic","2024-03-09",0,0,14,0,0,15,0,0
"Central African Republic","2024-03-10",0,0,14,0,0,15,0,0
"Central African Republic","2024-03-11",0,0,14,0,0,15,0,0
"Central African Republic","2024-03-12",0,0,14,0,0,15,0,0
"Central African Republic","2024-03-13",0,0,14,0,0,15,0,0
"Central African Republic","2024-03-14",0,0,14,0,0,15,0,0
"Central African Republic","2024-03-15",0,0,14,0,0,15,0,0
"Central African Republic","2024-03-16",0,0,14,0,0,15,0,0
"Central African Republic","2024-03-17",45,0,14,45,1,16,45,45
"Central African Republic","2024-03-18",0,0,14,45,0,16,0,45
"Central African Republic","2024-03-19",0,0,14,45,0,16,1,46
"Central African Republic","2024-03-20",0,0,14,45,0,16,0,46
"Central African Republic","2024-03-21",0,0,14,45,0,16,0,46
"Central African Republic","2024-03-22",0,0,14,45,0,16,0,46
"Central African Republic","2024-03-23",0,0,14,45,0,16,1,47
"Central African Republic","2024-03-24",2,2,16,47,0,16,0,47
"Central African Republic","2024-03-25",0,0,16,47,0,16,1,48
"Central African Republic","2024-03-26",0,0,16,47,1,17,1,49
"Central African Republic","2024-03-27",0,0,16,47,0,17,2,51
"Central African Republic","2024-03-28",0,0,16,47,0,17,1,52
"Central African Republic","2024-03-29",0,0,16,47,0,17,1,53
"Central African Republic","2024-03-30",0,0,16,47,1,18,1,54
"Central African Republic","2024-03-31",0,2,18,47,0,18,2,56
"Central African Republic","2024-04-01",0,0,18,47,0,18,1,57
"Central African Republic","2024-04-02",0,0,18,47,0,18,1,58
"Central African Republic","2024-04-03",0,0,18,47,0,18,1,59
"Central African Republic","2024-04-04",0,0,18,47,1,19,2,61
"Central African Republic","2024-04-05",0,0,18,47,0,19,1,62
"Central African Republic","2024-04-06",0,0,18,47,0,19,1,63
"Central African Republic","2024-04-07",0,1,19,47,0,19,1,64
"Central African Republic","2024-04-08",0,0,19,47,0,19,2,66
"Central African Republic","2024-04-09",0,0,19,47,0,19,1,67
"Central African Republic","2024-04-10",0,0,19,47,0,19,1,68
"Central African Republic","2024-04-11",0,0,19,47,0,19,1,69
"Central African Republic","2024-04-12",0,0,19,47,0,19,2,71
"Central African Republic","2024-04-13",0,0,19,47,0,19,1,72
"Central African Republic","2024-04-14",26,0,19,73,0,19,1,73
"Central African Republic","2024-04-15",0,0,19,73,0,19,0,73
"Central African Republic","2024-04-16",0,0,19,73,0,19,1,74
"Central African Republic","2024-04-17",0,0,19,73,0,19,0,74
"Central African Republic","2024-04-18",0,0,19,73,0,19,1,75
"Central African Republic","2024-04-19",0,0,19,73,0,19,0,75
"Central African Republic","2024-04-20",0,0,19,73,0,19,1,76
"Central African Republic","2024-04-21",0,0,19,73,0,19,0,76
"Central African Republic","2024-04-22",0,0,19,73,0,19,1,77
"Central African Republic","2024-04-23",0,0,19,73,0,19,0,77
"Central African Republic","2024-04-24",0,0,19,73,0,19,0,77
"Central African Republic","2024-04-25",0,0,19,73,0,19,1,78
"Central African Republic","2024-04-26",0,0,19,73,0,19,0,78
"Central African Republic","2024-04-27",0,0,19,73,0,19,1,79
"Central African Republic","2024-04-28",0,0,19,73,0,19,0,79
"Central African Republic","2024-04-29",0,0,19,73,0,19,1,80
"Central African Republic","2024-04-30",0,0,19,73,0,19,0,80
"Central African Republic","2024-05-01",0,0,19,73,0,19,1,81
"Central African Republic","2024-05-02",0,0,19,73,0,19,0,81
"Central African Republic","2024-05-03",0,0,19,73,0,19,0,81
"Central African Republic","2024-05-04",0,0,19,73,0,19,1,82
"Central African Republic","2024-05-05",0,0,19,73,0,19,0,82
"Central African Republic","2024-05-06",0,0,19,73,0,19,1,83
"Central African Republic","2024-05-07",0,0,19,73,0,19,0,83
"Central African Republic","2024-05-08",0,0,19,73,0,19,1,84
"Central African Republic","2024-05-09",0,0,19,73,1,20,0,84
"Central African Republic","2024-05-10",0,0,19,73,0,20,0,84
"Central African Republic","2024-05-11",0,0,19,73,0,20,1,85
"Central African Republic","2024-05-12",0,0,19,73,0,20,0,85
"Central African Republic","2024-05-13",0,0,19,73,0,20,1,86
"Central African Republic","2024-05-14",0,0,19,73,0,20,0,86
"Central African Republic","2024-05-15",0,0,19,73,0,20,1,87
"Central African Republic","2024-05-16",0,0,19,73,0,20,0,87
"Central African Republic","2024-05-17",0,0,19,73,0,20,1,88
"Central African Republic","2024-05-18",15,0,19,88,0,20,0,88
"Central African Republic","2024-05-19",0,0,19,88,0,20,0,88
"Central African Republic","2024-05-20",0,0,19,88,0,20,0,88
"Central African Republic","2024-05-21",0,0,19,88,0,20,0,88
"Central African Republic","2024-05-22",0,0,19,88,0,20,1,89
"Central African Republic","2024-05-23",0,0,19,88,0,20,0,89
"Central African Republic","2024-05-24",0,0,19,88,0,20,0,89
"Central African Republic","2024-05-25",1,0,19,89,0,20,0,89
"Central African Republic","2024-05-26",0,0,19,89,0,20,4,93
"Central African Republic","2024-05-27",0,0,19,89,0,20,3,96
"Central African Republic","2024-05-28",0,0,19,89,0,20,3,99
"Central African Republic","2024-05-29",0,0,19,89,0,20,4,103
"Central African Republic","2024-05-30",0,0,19,89,0,20,4,107
"Central African Republic","2024-05-31",0,0,19,89,0,20,3,110
"Central African Republic","2024-06-01",0,0,19,89,0,20,3,113
"Central African Republic","2024-06-02",0,0,19,89,0,20,4,117
"Central African Republic","2024-06-03",0,0,19,89,0,20,4,121
"Central African Republic","2024-06-04",0,0,19,89,0,20,3,124
"Central African Republic","2024-06-05",0,0,19,89,0,20,3,127
"Central African Republic","2024-06-06",0,0,19,89,0,20,4,131
"Central African Republic","2024-06-07",0,0,19,89,0,20,4,135
"Central African Republic","2024-06-08",0,0,19,89,0,20,3,138
"Central African Republic","2024-06-09",0,1,20,89,0,20,3,141
"Central African Republic","2024-06-10",0,0,20,89,0,20,4,145
"Central African Republic","2024-06-11",0,0,20,89,0,20,4,149
"Central African Republic","2024-06-12",0,0,20,89,0,20,3,152
"Central African Republic","2024-06-13",0,0,20,89,1,21,3,155
"Central African Republic","2024-06-14",0,0,20,89,0,21,4,159
"Central African Republic","2024-06-15",0,0,20,89,0,21,4,163
"Central African Republic","2024-06-16",77,1,21,166,0,21,3,166
"Central African Republic","2024-06-17",0,0,21,166,0,21,0,166
"Central African Republic","2024-06-18",0,0,21,166,1,22,1,167
"Central African Republic","2024-06-19",0,0,21,166,0,22,0,167
"Central African Republic","2024-06-20",0,0,21,166,0,22,1,168
"Central African Republic","2024-06-21",0,0,21,166,0,22,0,168
"Central African Republic","2024-06-22",0,0,21,166,1,23,1,169
"Central African Republic","2024-06-23",0,2,23,166,0,23,0,169
"Central African Republic","2024-06-24",0,0,23,166,0,23,1,170
"Central African Republic","2024-06-25",0,0,23,166,0,23,0,170
"Central African Republic","2024-06-26",0,0,23,166,0,23,1,171
"Central African Republic","2024-06-27",0,0,23,166,1,24,0,171
"Central African Republic","2024-06-28",0,0,23,166,0,24,0,171
"Central African Republic","2024-06-29",0,0,23,166,0,24,1,172
"Central African Republic","2024-06-30",0,1,24,166,0,24,0,172
"Central African Republic","2024-07-01",0,0,24,166,0,24,1,173
"Central African Republic","2024-07-02",0,0,24,166,0,24,0,173
"Central African Republic","2024-07-03",0,0,24,166,0,24,1,174
"Central African Republic","2024-07-04",0,0,24,166,1,25,0,174
"Central African Republic","2024-07-05",0,0,24,166,0,25,1,175
"Central African Republic","2024-07-06",0,0,24,166,0,25,0,175
"Central African Republic","2024-07-07",0,1,25,166,0,25,1,176
"Central African Republic","2024-07-08",0,0,25,166,0,25,0,176
"Central African Republic","2024-07-09",0,0,25,166,0,25,0,176
"Central African Republic","2024-07-10",0,0,25,166,0,25,1,177
"Central African Republic","2024-07-11",0,0,25,166,1,26,0,177
"Central African Republic","2024-07-12",0,0,25,166,0,26,1,178
"Central African Republic","2024-07-13",0,0,25,166,0,26,0,178
"Central African Republic","2024-07-14",0,1,26,166,0,26,1,179
"Central African Republic","2024-07-15",0,0,26,166,1,27,0,179
"Central African Republic","2024-07-16",0,0,26,166,0,27,1,180
"Central African Republic","2024-07-17",0,0,26,166,1,28,0,180
"Central African Republic","2024-07-18",0,0,26,166,1,29,0,180
"Central African Republic","2024-07-19",0,0,26,166,1,30,1,181
"Central African Republic","2024-07-20",0,0,26,166,0,30,0,181
"Central African Republic","2024-07-21",0,5,31,166,1,31,1,182
"Central African Republic","2024-07-22",0,0,31,166,1,32,0,182
"Central African Republic","2024-07-23",0,0,31,166,2,34,1,183
"Central African Republic","2024-07-24",0,0,31,166,1,35,0,183
"Central African Republic","2024-07-25",0,0,31,166,2,37,1,184
"Central African Republic","2024-07-26",0,0,31,166,1,38,0,184
"Central African Republic","2024-07-27",0,0,31,166,2,40,1,185
"Central African Republic","2024-07-28",19,10,41,185,1,41,0,185
"Central African Republic","2024-07-29",0,0,41,185,0,41,2,187
"Central African Republic","2024-07-30",0,0,41,185,1,42,1,188
"Central African Republic","2024-07-31",0,0,41,185,0,42,2,190
"Central African Republic","2024-08-01",0,0,41,185,0,42,2,192
"Central African Republic","2024-08-02",0,0,41,185,0,42,1,193
"Central African Republic","2024-08-03",10,0,41,195,1,43,2,195
"Central African Republic","2024-08-04",0,2,43,195,0,43,5,200
"Central African Republic","2024-08-05",0,0,43,195,0,43,4,204
"Central African Republic","2024-08-06",0,0,43,195,1,44,5,209
"Central African Republic","2024-08-07",0,0,43,195,0,44,5,214
"Central African Republic","2024-08-08",0,0,43,195,0,44,4,218
"Central African Republic","2024-08-09",28,0,43,223,0,44,5,223
"Central African Republic","2024-08-10",0,0,43,223,1,45,1,224
"Central African Republic","2024-08-11",0,2,45,223,0,45,0,224
"Central African Republic","2024-08-12",0,0,45,223,0,45,1,225
"Central African Republic","2024-08-13",0,0,45,223,0,45,1,226
"Central African Republic","2024-08-14",0,0,45,223,0,45,0,226
"Central African Republic","2024-08-15",0,0,45,223,1,46,1,227
"Central African Republic","2024-08-16",0,0,45,223,0,46,1,228
"Central African Republic","2024-08-17",0,0,45,223,0,46,0,228
"Central African Republic","2024-08-18",0,0,45,223,0,46,1,229
"Central African Republic","2024-08-19",0,0,45,223,0,46,1,230
"Central African Republic","2024-08-20",0,0,45,223,0,46,0,230
"Central African Republic","2024-08-21",0,0,45,223,0,46,1,231
"Central African Republic","2024-08-22",0,0,45,223,1,47,1,232
"Central African Republic","2024-08-23",0,0,45,223,0,47,0,232
"Central African Republic","2024-08-24",0,0,45,223,0,47,1,233
"Central African Republic","2024-08-25",0,2,47,223,0,47,1,234
"Central African Republic","2024-08-26",0,0,47,223,0,47,0,234
"Central African Republic","2024-08-27",0,0,47,223,0,47,1,235
"Central African Republic","2024-08-28",0,0,47,223,1,48,1,236
"Central African Republic","2024-08-29",0,0,47,223,0,48,0,236
"Central African Republic","2024-08-30",0,0,47,223,0,48,1,237
"Central African Republic","2024-08-31",0,0,47,223,0,48,1,238
"Central African Republic","2024-09-01",0,0,47,223,1,49,0,238
"Central African Republic","2024-09-02",0,0,47,223,0,49,1,239
"Central African Republic","2024-09-03",0,0,47,223,0,49,1,240
"Central African Republic","2024-09-04",0,0,47,223,0,49,0,240
"Central African Republic","2024-09-05",0,0,47,223,1,50,1,241
"Central African Republic","2024-09-06",0,0,47,223,0,50,1,242
"Central African Republic","2024-09-07",0,0,47,223,0,50,0,242
"Central African Republic","2024-09-08",20,0,47,243,0,50,1,243
"Central African Republic","2024-09-09",0,0,47,243,1,51,1,244
"Central African Republic","2024-09-10",0,0,47,243,0,51,1,245
"Central African Republic","2024-09-11",0,0,47,243,0,51,0,245
"Central African Republic","2024-09-12",0,0,47,243,0,51,1,246
"Central African Republic","2024-09-13",0,0,47,243,1,52,1,247
"Central African Republic","2024-09-14",0,0,47,243,0,52,1,248
"Central African Republic","2024-09-15",0,5,52,243,0,52,1,249
"Central African Republic","2024-09-16",0,0,52,243,0,52,0,249
"Central African Republic","2024-09-17",0,0,52,243,1,53,1,250
"Central African Republic","2024-09-18",0,0,52,243,0,53,1,251
"Central African Republic","2024-09-19",0,0,52,243,1,54,1,252
"Central African Republic","2024-09-20",0,0,52,243,0,54,1,253
"Central African Republic","2024-09-21",0,0,52,243,1,55,0,253
"Central African Republic","2024-09-22",0,3,55,243,0,55,1,254
"Central African Republic","2024-09-23",12,0,55,255,0,55,1,255
"Central African Republic","2024-09-24",0,0,55,255,1,56,2,257
"Central African Republic","2024-09-25",0,0,55,255,0,56,2,259
"Central African Republic","2024-09-26",0,0,55,255,0,56,2,261
"Central African Republic","2024-09-27",0,0,55,255,0,56,2,263
"Central African Republic","2024-09-28",0,0,55,255,1,57,2,265
"Central African Republic","2024-09-29",0,2,57,255,0,57,2,267
"Central African Republic","2024-09-30",14,0,57,269,0,57,2,269
"Central African Republic","2024-10-01",0,0,57,269,0,57,2,271
"Central African Republic","2024-10-02",0,0,57,269,0,57,1,272
"Central African Republic","2024-10-03",0,0,57,269,0,57,2,274
"Central African Republic","2024-10-04",0,0,57,269,0,57,2,276
"Central African Republic","2024-10-05",0,0,57,269,0,57,1,277
"Central African Republic","2024-10-06",10,0,57,279,0,57,2,279
"Central African Republic","2024-10-07",0,0,57,279,1,58,3,282
"Central African Republic","2024-10-08",0,0,57,279,0,58,3,285
"Central African Republic","2024-10-09",0,0,57,279,0,58,2,287
"Central African Republic","2024-10-10",0,0,57,279,0,58,3,290
"Central African Republic","2024-10-11",0,0,57,279,0,58,3,293
"Central African Republic","2024-10-12",0,0,57,279,0,58,3,296
"Central African Republic","2024-10-13",0,1,58,279,0,58,3,299
"Central African Republic","2024-10-14",0,0,58,279,1,59,2,301
"Central African Republic","2024-10-15",0,0,58,279,0,59,3,304
"Central African Republic","2024-10-16",0,0,58,279,1,60,3,307
"Central African Republic","2024-10-17",0,0,58,279,0,60,3,310
"Central African Republic","2024-10-18",0,0,58,279,1,61,2,312
"Central African Republic","2024-10-19",0,0,58,279,0,61,3,315
"Central African Republic","2024-10-20",39,4,62,318,1,62,3,318
"Central African Republic","2024-10-21",0,0,62,318,0,62,1,319
"Central African Republic","2024-10-22",0,0,62,318,1,63,0,319
"Central African Republic","2024-10-23",0,0,62,318,0,63,1,320
"Central African Republic","2024-10-24",0,0,62,318,0,63,1,321
"Central African Republic","2024-10-25",0,0,62,318,1,64,1,322
"Central African Republic","2024-10-26",0,2,64,318,0,64,0,322
"Central African Republic","2024-10-27",5,0,64,323,1,65,1,323
"Central African Republic","2024-10-28",0,0,64,323,0,65,0,323
"Central African Republic","2024-10-29",0,0,64,323,1,66,1,324
"Central African Republic","2024-10-30",0,0,64,323,0,66,0,324
"Central African Republic","2024-10-31",0,0,64,323,1,67,0,324
"Central African Republic","2024-11-01",0,0,64,323,1,68,1,325
"Central African Republic","2024-11-02",0,0,64,323,0,68,0,325
"Central African Republic","2024-11-03",0,5,69,323,1,69,0,325
"Central African Republic","2024-11-04",0,0,69,323,0,69,1,326
"Central African Republic","2024-11-05",0,0,69,323,0,69,0,326
"Central African Republic","2024-11-06",0,0,69,323,0,69,1,327
"Central African Republic","2024-11-07",0,0,69,323,0,69,0,327
"Central African Republic","2024-11-08",0,0,69,323,0,69,0,327
"Central African Republic","2024-11-09",0,0,69,323,0,69,1,328
"Central African Republic","2024-11-10",0,0,69,323,0,69,0,328
"Central African Republic","2024-11-11",0,0,69,323,0,69,0,328
"Central African Republic","2024-11-12",0,0,69,323,0,69,1,329
"Central African Republic","2024-11-13",6,0,69,329,0,69,0,329
"Central African Republic","2024-11-14",0,0,69,329,0,69,0,329
"Central African Republic","2024-11-15",0,0,69,329,0,69,0,329
"Central African Republic","2024-11-16",0,0,69,329,0,69,0,329
"Central African Republic","2024-11-17",0,0,69,329,0,69,0,329
"Central African Republic","2024-11-18",0,0,69,329,0,69,0,329
"Central African Republic","2024-11-19",0,0,69,329,0,69,0,329
"Central African Republic","2024-11-20",0,0,69,329,0,69,0,329
"Central African Republic","2024-11-21",0,0,69,329,0,69,0,329
"Central African Republic","2024-11-22",0,0,69,329,0,69,0,329
"Central African Republic","2024-11-23",0,0,69,329,0,69,0,329
"Central African Republic","2024-11-24",0,0,69,329,0,69,0,329
"Central African Republic","2024-11-25",0,0,69,329,0,69,0,329
"Central African Republic","2024-11-26",0,0,69,329,0,69,0,329
"Central African Republic","2024-11-27",0,0,69,329,0,69,0,329
"Central African Republic","2024-11-28",0,0,69,329,0,69,0,329
"Central African Republic","2024-11-29",0,0,69,329,0,69,0,329
"Central African Republic","2024-11-30",0,0,69,329,0,69,0,329
"Central African Republic","2024-12-01",0,0,69,329,0,69,0,329
"Central African Republic","2024-12-02",0,0,69,329,0,69,0,329
"Central African Republic","2024-12-03",0,0,69,329,0,69,0,329
"Central African Republic","2024-12-04",0,0,69,329,0,69,0,329
"Central African Republic","2024-12-05",0,0,69,329,0,69,0,329
"Central African Republic","2024-12-06",0,0,69,329,0,69,0,329
"Central African Republic","2024-12-07",0,0,69,329,0,69,0,329
"Central African Republic","2024-12-08",0,0,69,329,0,69,0,329
"Central African Republic","2024-12-09",0,0,69,329,0,69,0,329
"Chile","2024-01-01",0,0,0,0,0,0,0,0
"Chile","2024-01-02",0,1,1,0,1,1,0,0
"Chile","2024-01-03",0,0,1,0,0,1,0,0
"Chile","2024-01-04",0,0,1,0,0,1,0,0
"Chile","2024-01-05",0,0,1,0,0,1,0,0
"Chile","2024-01-06",0,0,1,0,0,1,0,0
"Chile","2024-01-07",0,0,1,0,0,1,0,0
"Chile","2024-01-08",0,0,1,0,0,1,0,0
"Chile","2024-01-09",0,0,1,0,0,1,0,0
"Chile","2024-01-10",0,0,1,0,0,1,0,0
"Chile","2024-01-11",0,0,1,0,0,1,0,0
"Chile","2024-01-12",0,0,1,0,0,1,0,0
"Chile","2024-01-13",0,0,1,0,0,1,0,0
"Chile","2024-01-14",0,0,1,0,0,1,0,0
"Chile","2024-01-15",0,0,1,0,0,1,0,0
"Chile","2024-01-16",0,0,1,0,0,1,0,0
"Chile","2024-01-17",0,0,1,0,0,1,0,0
"Chile","2024-01-18",0,0,1,0,0,1,0,0
"Chile","2024-01-19",0,0,1,0,0,1,0,0
"Chile","2024-01-20",0,0,1,0,1,2,0,0
"Chile","2024-01-21",0,0,1,0,0,2,0,0
"Chile","2024-01-22",0,0,1,0,0,2,0,0
"Chile","2024-01-23",0,0,1,0,0,2,0,0
"Chile","2024-01-24",0,0,1,0,0,2,0,0
"Chile","2024-01-25",0,0,1,0,0,2,0,0
"Chile","2024-01-26",0,0,1,0,0,2,0,0
"Chile","2024-01-27",0,0,1,0,0,2,0,0
"Chile","2024-01-28",0,0,1,0,0,2,0,0
"Chile","2024-01-29",0,0,1,0,0,2,0,0
"Chile","2024-01-30",0,0,1,0,0,2,0,0
"Chile","2024-01-31",0,0,1,0,0,2,0,0
"Chile","2024-02-01",0,0,1,0,0,2,0,0
"Chile","2024-02-02",0,0,1,0,0,2,0,0
"Chile","2024-02-03",0,0,1,0,0,2,0,0
"Chile","2024-02-04",0,0,1,0,0,2,0,0
"Chile","2024-02-05",0,0,1,0,0,2,0,0
"Chile","2024-02-06",0,1,2,0,0,2,0,0
"Chile","2024-02-07",0,0,2,0,0,2,0,0
"Chile","2024-02-08",0,0,2,0,0,2,0,0
"Chile","2024-02-09",0,0,2,0,0,2,0,0
"Chile","2024-02-10",0,0,2,0,0,2,0,0
"Chile","2024-02-11",0,0,2,0,0,2,0,0
"Chile","2024-02-12",0,0,2,0,0,2,0,0
"Chile","2024-02-13",0,0,2,0,0,2,0,0
"Chile","2024-02-14",0,0,2,0,1,3,0,0
"Chile","2024-02-15",0,0,2,0,0,3,0,0
"Chile","2024-02-16",0,0,2,0,0,3,0,0
"Chile","2024-02-17",0,0,2,0,0,3,0,0
"Chile","2024-02-18",0,0,2,0,0,3,0,0
"Chile","2024-02-19",0,0,2,0,0,3,0,0
"Chile","2024-02-20",0,1,3,0,0,3,0,0
"Chile","2024-02-21",0,0,3,0,0,3,0,0
"Chile","2024-02-22",0,0,3,0,0,3,0,0
"Chile","2024-02-23",0,0,3,0,0,3,0,0
"Chile","2024-02-24",0,0,3,0,1,4,0,0
"Chile","2024-02-25",0,0,3,0,0,4,0,0
"Chile","2024-02-26",0,0,3,0,0,4,0,0
"Chile","2024-02-27",0,1,4,0,0,4,0,0
"Chile","2024-02-28",0,0,4,0,0,4,0,0
"Chile","2024-02-29",0,0,4,0,1,5,0,0
"Chile","2024-03-01",0,0,4,0,0,5,0,0
"Chile","2024-03-02",0,0,4,0,0,5,0,0
"Chile","2024-03-03",0,0,4,0,0,5,0,0
"Chile","2024-03-04",0,0,4,0,1,6,0,0
"Chile","2024-03-05",0,2,6,0,0,6,0,0
"Chile","2024-03-06",0,0,6,0,0,6,0,0
"Chile","2024-03-07",0,0,6,0,0,6,0,0
"Chile","2024-03-08",0,0,6,0,0,6,0,0
"Chile","2024-03-09",0,0,6,0,0,6,0,0
"Chile","2024-03-10",0,0,6,0,0,6,0,0
"Chile","2024-03-11",0,0,6,0,0,6,0,0
"Chile","2024-03-12",0,0,6,0,0,6,0,0
"Chile","2024-03-13",0,0,6,0,0,6,0,0
"Chile","2024-03-14",0,0,6,0,0,6,0,0
"Chile","2024-03-15",0,0,6,0,0,6,0,0
"Chile","2024-03-16",0,0,6,0,0,6,0,0
"Chile","2024-03-17",0,0,6,0,0,6,0,0
"Chile","2024-03-18",0,0,6,0,0,6,0,0
"Chile","2024-03-19",0,0,6,0,0,6,0,0
"Chile","2024-03-20",0,0,6,0,0,6,0,0
"Chile","2024-03-21",0,0,6,0,0,6,0,0
"Chile","2024-03-22",0,0,6,0,0,6,0,0
"Chile","2024-03-23",0,0,6,0,0,6,0,0
"Chile","2024-03-24",0,0,6,0,0,6,0,0
"Chile","2024-03-25",0,0,6,0,0,6,0,0
"Chile","2024-03-26",0,0,6,0,0,6,0,0
"Chile","2024-03-27",0,0,6,0,0,6,0,0
"Chile","2024-03-28",0,0,6,0,0,6,0,0
"Chile","2024-03-29",0,0,6,0,0,6,0,0
"Chile","2024-03-30",0,0,6,0,0,6,0,0
"Chile","2024-03-31",0,0,6,0,0,6,0,0
"Chile","2024-04-01",0,0,6,0,0,6,0,0
"Chile","2024-04-02",0,0,6,0,0,6,0,0
"Chile","2024-04-03",0,0,6,0,0,6,0,0
"Chile","2024-04-04",0,0,6,0,0,6,0,0
"Chile","2024-04-05",0,0,6,0,0,6,0,0
"Chile","2024-04-06",0,0,6,0,0,6,0,0
"Chile","2024-04-07",0,0,6,0,0,6,0,0
"Chile","2024-04-08",0,0,6,0,0,6,0,0
"Chile","2024-04-09",0,0,6,0,0,6,0,0
"Chile","2024-04-10",0,0,6,0,0,6,0,0
"Chile","2024-04-11",0,0,6,0,0,6,0,0
"Chile","2024-04-12",0,0,6,0,0,6,0,0
"Chile","2024-04-13",0,0,6,0,0,6,0,0
"Chile","2024-04-14",0,0,6,0,0,6,0,0
"Chile","2024-04-15",0,0,6,0,0,6,0,0
"Chile","2024-04-16",0,0,6,0,0,6,0,0
"Chile","2024-04-17",0,0,6,0,0,6,0,0
"Chile","2024-04-18",0,0,6,0,0,6,0,0
"Chile","2024-04-19",0,0,6,0,0,6,0,0
"Chile","2024-04-20",0,0,6,0,0,6,0,0
"Chile","2024-04-21",0,0,6,0,0,6,0,0
"Chile","2024-04-22",0,0,6,0,0,6,0,0
"Chile","2024-04-23",0,0,6,0,0,6,0,0
"Chile","2024-04-24",0,0,6,0,0,6,0,0
"Chile","2024-04-25",0,0,6,0,0,6,0,0
"Chile","2024-04-26",0,0,6,0,0,6,0,0
"Chile","2024-04-27",0,0,6,0,0,6,0,0
"Chile","2024-04-28",0,0,6,0,0,6,0,0
"Chile","2024-04-29",0,0,6,0,0,6,0,0
"Chile","2024-04-30",0,0,6,0,0,6,0,0
"Chile","2024-05-01",0,0,6,0,0,6,0,0
"Chile","2024-05-02",0,0,6,0,0,6,0,0
"Chile","2024-05-03",0,0,6,0,0,6,0,0
"Chile","2024-05-04",0,0,6,0,0,6,0,0
"Chile","2024-05-05",0,0,6,0,0,6,0,0
"Chile","2024-05-06",0,0,6,0,0,6,0,0
"Chile","2024-05-07",0,0,6,0,0,6,0,0
"Chile","2024-05-08",0,0,6,0,0,6,0,0
"Chile","2024-05-09",0,0,6,0,0,6,0,0
"Chile","2024-05-10",0,0,6,0,0,6,0,0
"Chile","2024-05-11",0,0,6,0,0,6,0,0
"Chile","2024-05-12",0,0,6,0,0,6,0,0
"Chile","2024-05-13",0,0,6,0,0,6,0,0
"Chile","2024-05-14",0,0,6,0,0,6,0,0
"Chile","2024-05-15",0,0,6,0,1,7,0,0
"Chile","2024-05-16",0,0,6,0,0,7,0,0
"Chile","2024-05-17",0,0,6,0,0,7,0,0
"Chile","2024-05-18",0,0,6,0,0,7,0,0
"Chile","2024-05-19",0,0,6,0,0,7,0,0
"Chile","2024-05-20",0,0,6,0,0,7,0,0
"Chile","2024-05-21",0,0,6,0,0,7,0,0
"Chile","2024-05-22",0,0,6,0,0,7,0,0
"Chile","2024-05-23",0,0,6,0,0,7,0,0
"Chile","2024-05-24",0,0,6,0,0,7,0,0
"Chile","2024-05-25",0,0,6,0,0,7,0,0
"Chile","2024-05-26",0,0,6,0,0,7,0,0
"Chile","2024-05-27",0,0,6,0,0,7,0,0
"Chile","2024-05-28",0,0,6,0,0,7,0,0
"Chile","2024-05-29",0,0,6,0,0,7,0,0
"Chile","2024-05-30",0,0,6,0,0,7,0,0
"Chile","2024-05-31",0,0,6,0,0,7,0,0
"Chile","2024-06-01",0,0,6,0,0,7,0,0
"Chile","2024-06-02",0,0,6,0,0,7,0,0
"Chile","2024-06-03",0,0,6,0,0,7,0,0
"Chile","2024-06-04",0,0,6,0,0,7,0,0
"Chile","2024-06-05",0,0,6,0,0,7,0,0
"Chile","2024-06-06",0,0,6,0,0,7,0,0
"Chile","2024-06-07",0,0,6,0,0,7,0,0
"Chile","2024-06-08",0,0,6,0,0,7,0,0
"Chile","2024-06-09",0,0,6,0,0,7,0,0
"Chile","2024-06-10",0,0,6,0,0,7,0,0
"Chile","2024-06-11",0,0,6,0,0,7,0,0
"Chile","2024-06-12",0,0,6,0,0,7,0,0
"Chile","2024-06-13",0,0,6,0,0,7,0,0
"Chile","2024-06-14",0,0,6,0,0,7,0,0
"Chile","2024-06-15",0,0,6,0,0,7,0,0
"Chile","2024-06-16",0,0,6,0,0,7,0,0
"Chile","2024-06-17",0,0,6,0,0,7,0,0
"Chile","2024-06-18",0,0,6,0,0,7,0,0
"Chile","2024-06-19",0,0,6,0,0,7,0,0
"Chile","2024-06-20",0,0,6,0,0,7,0,0
"Chile","2024-06-21",0,0,6,0,0,7,0,0
"Chile","2024-06-22",0,0,6,0,0,7,0,0
"Chile","2024-06-23",0,0,6,0,0,7,0,0
"Chile","2024-06-24",0,0,6,0,0,7,0,0
"Chile","2024-06-25",0,0,6,0,0,7,0,0
"Chile","2024-06-26",0,0,6,0,0,7,0,0
"Chile","2024-06-27",0,0,6,0,0,7,0,0
"Chile","2024-06-28",0,0,6,0,0,7,0,0
"Chile","2024-06-29",0,0,6,0,0,7,0,0
"Chile","2024-06-30",0,0,6,0,0,7,0,0
"Chile","2024-07-01",0,0,6,0,0,7,0,0
"Chile","2024-07-02",0,0,6,0,0,7,0,0
"Chile","2024-07-03",0,0,6,0,0,7,0,0
"Chile","2024-07-04",0,0,6,0,0,7,0,0
"Chile","2024-07-05",0,0,6,0,0,7,0,0
"Chile","2024-07-06",0,0,6,0,0,7,0,0
"Chile","2024-07-07",0,0,6,0,0,7,0,0
"Chile","2024-07-08",0,0,6,0,0,7,0,0
"Chile","2024-07-09",0,0,6,0,0,7,0,0
"Chile","2024-07-10",0,0,6,0,0,7,0,0
"Chile","2024-07-11",0,0,6,0,0,7,0,0
"Chile","2024-07-12",0,0,6,0,0,7,0,0
"Chile","2024-07-13",0,0,6,0,0,7,0,0
"Chile","2024-07-14",0,0,6,0,0,7,0,0
"Chile","2024-07-15",0,0,6,0,0,7,0,0
"Chile","2024-07-16",0,0,6,0,0,7,0,0
"Chile","2024-07-17",0,0,6,0,0,7,0,0
"Chile","2024-07-18",0,0,6,0,0,7,0,0
"Chile","2024-07-19",0,0,6,0,0,7,0,0
"Chile","2024-07-20",0,0,6,0,0,7,0,0
"Chile","2024-07-21",0,0,6,0,0,7,0,0
"Chile","2024-07-22",0,0,6,0,0,7,0,0
"Chile","2024-07-23",0,1,7,0,0,7,0,0
"Chile","2024-07-24",0,0,7,0,0,7,0,0
"Chile","2024-07-25",0,0,7,0,0,7,0,0
"Chile","2024-07-26",0,0,7,0,0,7,0,0
"Chile","2024-07-27",0,0,7,0,0,7,0,0
"Chile","2024-07-28",0,0,7,0,0,7,0,0
"Chile","2024-07-29",0,0,7,0,0,7,0,0
"Chile","2024-07-30",0,0,7,0,0,7,0,0
"Chile","2024-07-31",0,0,7,0,0,7,0,0
"Chile","2024-08-01",0,0,7,0,0,7,0,0
"Chile","2024-08-02",0,0,7,0,0,7,0,0
"Chile","2024-08-03",0,0,7,0,0,7,0,0
"Chile","2024-08-04",0,0,7,0,0,7,0,0
"Chile","2024-08-05",0,0,7,0,0,7,0,0
"Chile","2024-08-06",0,0,7,0,0,7,0,0
"Chile","2024-08-07",0,0,7,0,0,7,0,0
"Chile","2024-08-08",0,0,7,0,0,7,0,0
"Chile","2024-08-09",0,0,7,0,0,7,0,0
"Chile","2024-08-10",0,0,7,0,1,8,0,0
"Chile","2024-08-11",0,0,7,0,0,8,0,0
"Chile","2024-08-12",0,0,7,0,0,8,0,0
"Chile","2024-08-13",0,0,7,0,0,8,0,0
"Chile","2024-08-14",0,0,7,0,0,8,0,0
"Chile","2024-08-15",0,0,7,0,0,8,0,0
"Chile","2024-08-16",0,0,7,0,0,8,0,0
"Chile","2024-08-17",0,0,7,0,0,8,0,0
"Chile","2024-08-18",0,0,7,0,0,8,0,0
"Chile","2024-08-19",0,0,7,0,0,8,0,0
"Chile","2024-08-20",0,0,7,0,0,8,0,0
"Chile","2024-08-21",0,0,7,0,0,8,0,0
"Chile","2024-08-22",0,0,7,0,0,8,0,0
"Chile","2024-08-23",0,0,7,0,0,8,0,0
"Chile","2024-08-24",0,0,7,0,0,8,0,0
"Chile","2024-08-25",0,0,7,0,0,8,0,0
"Chile","2024-08-26",0,0,7,0,0,8,0,0
"Chile","2024-08-27",0,1,8,0,0,8,0,0
"Chile","2024-08-28",0,0,8,0,0,8,0,0
"Chile","2024-08-29",0,0,8,0,0,8,0,0
"Chile","2024-08-30",0,0,8,0,0,8,0,0
"Chile","2024-08-31",0,0,8,0,1,9,0,0
"Chile","2024-09-01",0,0,8,0,0,9,0,0
"Chile","2024-09-02",0,0,8,0,0,9,0,0
"Chile","2024-09-03",0,1,9,0,0,9,0,0
"Chile","2024-09-04",0,0,9,0,0,9,0,0
"Chile","2024-09-05",0,0,9,0,0,9,0,0
"Chile","2024-09-06",0,0,9,0,0,9,0,0
"Chile","2024-09-07",0,0,9,0,0,9,0,0
"Chile","2024-09-08",0,0,9,0,0,9,0,0
"Chile","2024-09-09",0,0,9,0,0,9,0,0
"Chile","2024-09-10",0,0,9,0,0,9,0,0
"Chile","2024-09-11",0,0,9,0,0,9,0,0
"Chile","2024-09-12",0,0,9,0,0,9,0,0
"Chile","2024-09-13",0,0,9,0,0,9,0,0
"Chile","2024-09-14",0,0,9,0,1,10,0,0
"Chile","2024-09-15",0,0,9,0,0,10,0,0
"Chile","2024-09-16",0,0,9,0,0,10,0,0
"Chile","2024-09-17",0,0,9,0,0,10,0,0
"Chile","2024-09-18",0,0,9,0,0,10,0,0
"Chile","2024-09-19",0,0,9,0,0,10,0,0
"Chile","2024-09-20",0,0,9,0,0,10,0,0
"Chile","2024-09-21",0,0,9,0,0,10,0,0
"Chile","2024-09-22",0,0,9,0,0,10,0,0
"Chile","2024-09-23",0,0,9,0,0,10,0,0
"Chile","2024-09-24",0,1,10,0,0,10,0,0
"Chile","2024-09-25",0,0,10,0,0,10,0,0
"Chile","2024-09-26",0,0,10,0,0,10,0,0
"Chile","2024-09-27",0,0,10,0,0,10,0,0
"Chile","2024-09-28",0,0,10,0,0,10,0,0
"Chile","2024-09-29",0,0,10,0,0,10,0,0
"Chile","2024-09-30",0,0,10,0,0,10,0,0
"Chile","2024-10-01",0,0,10,0,0,10,0,0
"Chile","2024-10-02",0,0,10,0,0,10,0,0
"Chile","2024-10-03",0,0,10,0,0,10,0,0
"Chile","2024-10-04",0,0,10,0,0,10,0,0
"Chile","2024-10-05",0,0,10,0,0,10,0,0
"Chile","2024-10-06",0,0,10,0,0,10,0,0
"Chile","2024-10-07",0,0,10,0,0,10,0,0
"Chile","2024-10-08",0,0,10,0,0,10,0,0
"Chile","2024-10-09",0,0,10,0,0,10,0,0
"Chile","2024-10-10",0,0,10,0,0,10,0,0
"Chile","2024-10-11",0,0,10,0,0,10,0,0
"Chile","2024-10-12",0,0,10,0,0,10,0,0
"Chile","2024-10-13",0,0,10,0,0,10,0,0
"Chile","2024-10-14",0,0,10,0,0,10,0,0
"Chile","2024-10-15",0,0,10,0,0,10,0,0
"Chile","2024-10-16",0,0,10,0,0,10,0,0
"Chile","2024-10-17",0,0,10,0,0,10,0,0
"Chile","2024-10-18",0,0,10,0,0,10,0,0
"Chile","2024-10-19",0,0,10,0,0,10,0,0
"Chile","2024-10-20",0,0,10,0,0,10,0,0
"Chile","2024-10-21",0,0,10,0,0,10,0,0
"Chile","2024-10-22",0,0,10,0,0,10,0,0
"Chile","2024-10-23",0,0,10,0,0,10,0,0
"Chile","2024-10-24",0,0,10,0,0,10,0,0
"Chile","2024-10-25",0,0,10,0,0,10,0,0
"Chile","2024-10-26",0,0,10,0,0,10,0,0
"Chile","2024-10-27",0,0,10,0,0,10,0,0
"Chile","2024-10-28",0,0,10,0,0,10,0,0
"Chile","2024-10-29",0,0,10,0,0,10,0,0
"Chile","2024-10-30",0,0,10,0,0,10,0,0
"Chile","2024-10-31",0,0,10,0,0,10,0,0
"Chile","2024-11-01",0,0,10,0,0,10,0,0
"Chile","2024-11-02",0,0,10,0,0,10,0,0
"Chile","2024-11-03",0,0,10,0,0,10,0,0
"Chile","2024-11-04",0,0,10,0,0,10,0,0
"Chile","2024-11-05",0,0,10,0,0,10,0,0
"Chile","2024-11-06",0,0,10,0,0,10,0,0
"Chile","2024-11-07",0,0,10,0,0,10,0,0
"Chile","2024-11-08",0,0,10,0,0,10,0,0
"Chile","2024-11-09",0,0,10,0,0,10,0,0
"Chile","2024-11-10",0,0,10,0,0,10,0,0
"Chile","2024-11-11",0,0,10,0,0,10,0,0
"Chile","2024-11-12",0,0,10,0,0,10,0,0
"Chile","2024-11-13",0,0,10,0,0,10,0,0
"Chile","2024-11-14",0,0,10,0,0,10,0,0
"Chile","2024-11-15",0,0,10,0,0,10,0,0
"Chile","2024-11-16",0,0,10,0,0,10,0,0
"Chile","2024-11-17",0,0,10,0,0,10,0,0
"Chile","2024-11-18",0,0,10,0,0,10,0,0
"Chile","2024-11-19",0,0,10,0,0,10,0,0
"Chile","2024-11-20",0,0,10,0,0,10,0,0
"Chile","2024-11-21",0,0,10,0,0,10,0,0
"Chile","2024-11-22",0,0,10,0,0,10,0,0
"Chile","2024-11-23",0,0,10,0,0,10,0,0
"Chile","2024-11-24",0,0,10,0,0,10,0,0
"Chile","2024-11-25",0,0,10,0,0,10,0,0
"Chile","2024-11-26",0,0,10,0,0,10,0,0
"Chile","2024-11-27",0,0,10,0,0,10,0,0
"Chile","2024-11-28",0,0,10,0,0,10,0,0
"Chile","2024-11-29",0,0,10,0,0,10,0,0
"Chile","2024-11-30",0,0,10,0,0,10,0,0
"Chile","2024-12-01",0,0,10,0,0,10,0,0
"Chile","2024-12-02",0,0,10,0,0,10,0,0
"Chile","2024-12-03",0,0,10,0,0,10,0,0
"Chile","2024-12-04",0,0,10,0,0,10,0,0
"Chile","2024-12-05",0,0,10,0,0,10,0,0
"Chile","2024-12-06",0,0,10,0,0,10,0,0
"Chile","2024-12-07",0,0,10,0,0,10,0,0
"Chile","2024-12-08",0,0,10,0,0,10,0,0
"Chile","2024-12-09",0,0,10,0,0,10,0,0
"China","2024-01-01",0,0,0,0,0,0,0,0
"China","2024-01-02",0,0,0,0,0,0,0,0
"China","2024-01-03",0,0,0,0,0,0,0,0
"China","2024-01-04",0,0,0,0,0,0,0,0
"China","2024-01-05",0,0,0,0,0,0,0,0
"China","2024-01-06",0,0,0,0,0,0,0,0
"China","2024-01-07",0,0,0,0,0,0,0,0
"China","2024-01-08",0,0,0,0,0,0,0,0
"China","2024-01-09",0,0,0,0,0,0,0,0
"China","2024-01-10",0,0,0,0,0,0,0,0
"China","2024-01-11",0,0,0,0,0,0,0,0
"China","2024-01-12",0,1,1,0,1,1,0,0
"China","2024-01-13",0,0,1,0,0,1,0,0
"China","2024-01-14",0,0,1,0,0,1,0,0
"China","2024-01-15",0,0,1,0,1,2,0,0
"China","2024-01-16",0,0,1,0,0,2,0,0
"China","2024-01-17",0,1,2,0,0,2,0,0
"China","2024-01-18",0,0,2,0,0,2,0,0
"China","2024-01-19",0,0,2,0,0,2,0,0
"China","2024-01-20",0,0,2,0,0,2,0,0
"China","2024-01-21",0,0,2,0,1,3,0,0
"China","2024-01-22",0,0,2,0,0,3,0,0
"China","2024-01-23",0,0,2,0,0,3,0,0
"China","2024-01-24",0,1,3,0,0,3,0,0
"China","2024-01-25",0,0,3,0,14,17,0,0
"China","2024-01-26",0,0,3,0,14,31,0,0
"China","2024-01-27",0,0,3,0,14,45,0,0
"China","2024-01-28",0,0,3,0,13,58,0,0
"China","2024-01-29",0,0,3,0,14,72,0,0
"China","2024-01-30",0,0,3,0,14,86,0,0
"China","2024-01-31",0,97,100,0,14,100,0,0
"China","2024-02-01",0,0,100,0,0,100,0,0
"China","2024-02-02",0,1,101,0,1,101,0,0
"China","2024-02-03",0,0,101,0,0,101,0,0
"China","2024-02-04",0,0,101,0,0,101,0,0
"China","2024-02-05",0,0,101,0,0,101,0,0
"China","2024-02-06",0,0,101,0,0,101,0,0
"China","2024-02-07",0,0,101,0,0,101,0,0
"China","2024-02-08",0,0,101,0,0,101,0,0
"China","2024-02-09",0,0,101,0,1,102,0,0
"China","2024-02-10",0,0,101,0,0,102,0,0
"China","2024-02-11",0,0,101,0,0,102,0,0
"China","2024-02-12",0,0,101,0,0,102,0,0
"China","2024-02-13",0,0,101,0,0,102,0,0
"China","2024-02-14",0,0,101,0,0,102,0,0
"China","2024-02-15",0,1,102,0,0,102,0,0
"China","2024-02-16",0,0,102,0,0,102,0,0
"China","2024-02-17",0,0,102,0,0,102,0,0
"China","2024-02-18",0,0,102,0,0,102,0,0
"China","2024-02-19",0,0,102,0,0,102,0,0
"China","2024-02-20",0,0,102,0,1,103,0,0
"China","2024-02-21",0,0,102,0,0,103,0,0
"China","2024-02-22",0,0,102,0,0,103,0,0
"China","2024-02-23",0,1,103,0,0,103,0,0
"China","2024-02-24",0,0,103,0,12,115,0,0
"China","2024-02-25",0,0,103,0,11,126,0,0
"China","2024-02-26",0,0,103,0,12,138,0,0
"China","2024-02-27",0,0,103,0,12,150,0,0
"China","2024-02-28",0,0,103,0,11,161,0,0
"China","2024-02-29",0,70,173,0,12,173,0,0
"China","2024-03-01",0,3,176,0,3,176,0,0
"China","2024-03-02",0,0,176,0,2,178,0,0
"China","2024-03-03",0,0,176,0,1,179,0,0
"China","2024-03-04",0,0,176,0,2,181,0,0
"China","2024-03-05",0,0,176,0,2,183,0,0
"China","2024-03-06",0,0,176,0,1,184,0,0
"China","2024-03-07",0,0,176,0,2,186,0,0
"China","2024-03-08",0,0,176,0,2,188,0,0
"China","2024-03-09",0,0,176,0,2,190,0,0
"China","2024-03-10",0,0,176,0,1,191,0,0
"China","2024-03-11",0,0,176,0,2,193,0,0
"China","2024-03-12",0,0,176,0,2,195,0,0
"China","2024-03-13",0,0,176,0,1,196,0,0
"China","2024-03-14",0,0,176,0,2,198,0,0
"China","2024-03-15",0,0,176,0,2,200,0,0
"China","2024-03-16",0,0,176,0,2,202,0,0
"China","2024-03-17",0,0,176,0,1,203,0,0
"China","2024-03-18",0,0,176,0,2,205,0,0
"China","2024-03-19",0,0,176,0,2,207,0,0
"China","2024-03-20",0,0,176,0,1,208,0,0
"China","2024-03-21",0,0,176,0,2,210,0,0
"China","2024-03-22",0,0,176,0,2,212,0,0
"China","2024-03-23",0,0,176,0,1,213,0,0
"China","2024-03-24",0,0,176,0,2,215,0,0
"China","2024-03-25",0,0,176,0,2,217,0,0
"China","2024-03-26",0,0,176,0,1,218,0,0
"China","2024-03-27",0,0,176,0,2,220,0,0
"China","2024-03-28",0,0,176,0,2,222,0,0
"China","2024-03-29",0,0,176,0,2,224,0,0
"China","2024-03-30",0,0,176,0,1,225,0,0
"China","2024-03-31",0,51,227,0,2,227,0,0
"China","2024-04-01",0,0,227,0,0,227,0,0
"China","2024-04-02",0,0,227,0,0,227,0,0
"China","2024-04-03",0,0,227,0,1,228,0,0
"China","2024-04-04",0,0,227,0,0,228,0,0
"China","2024-04-05",0,1,228,0,0,228,0,0
"China","2024-04-06",0,0,228,0,0,228,0,0
"China","2024-04-07",0,0,228,0,0,228,0,0
"China","2024-04-08",0,0,228,0,0,228,0,0
"China","2024-04-09",0,0,228,0,1,229,0,0
"China","2024-04-10",0,0,228,0,0,229,0,0
"China","2024-04-11",0,0,228,0,0,229,0,0
"China","2024-04-12",0,1,229,0,0,229,0,0
"China","2024-04-13",0,0,229,0,0,229,0,0
"China","2024-04-14",0,0,229,0,0,229,0,0
"China","2024-04-15",0,0,229,0,0,229,0,0
"China","2024-04-16",0,0,229,0,0,229,0,0
"China","2024-04-17",0,0,229,0,0,229,0,0
"China","2024-04-18",0,0,229,0,0,229,0,0
"China","2024-04-19",0,0,229,0,0,229,0,0
"China","2024-04-20",0,0,229,0,1,230,0,0
"China","2024-04-21",0,0,229,0,0,230,0,0
"China","2024-04-22",0,0,229,0,0,230,0,0
"China","2024-04-23",0,0,229,0,0,230,0,0
"China","2024-04-24",0,0,229,0,0,230,0,0
"China","2024-04-25",0,0,229,0,0,230,0,0
"China","2024-04-26",0,1,230,0,0,230,0,0
"China","2024-04-27",0,0,230,0,10,240,0,0
"China","2024-04-28",0,0,230,0,10,250,0,0
"China","2024-04-29",0,0,230,0,9,259,0,0
"China","2024-04-30",0,39,269,0,10,269,0,0
"China","2024-05-01",0,0,269,0,0,269,0,0
"China","2024-05-02",0,0,269,0,0,269,0,0
"China","2024-05-03",0,0,269,0,0,269,0,0
"China","2024-05-04",0,0,269,0,1,270,0,0
"China","2024-05-05",0,0,269,0,0,270,0,0
"China","2024-05-06",0,0,269,0,0,270,0,0
"China","2024-05-07",0,1,270,0,0,270,0,0
"China","2024-05-08",0,0,270,0,0,270,0,0
"China","2024-05-09",0,0,270,0,0,270,0,0
"China","2024-05-10",0,0,270,0,0,270,0,0
"China","2024-05-11",0,0,270,0,1,271,0,0
"China","2024-05-12",0,0,270,0,0,271,0,0
"China","2024-05-13",0,0,270,0,0,271,0,0
"China","2024-05-14",0,1,271,0,0,271,0,0
"China","2024-05-15",0,0,271,0,0,271,0,0
"China","2024-05-16",0,0,271,0,0,271,0,0
"China","2024-05-17",0,0,271,0,0,271,0,0
"China","2024-05-18",0,0,271,0,0,271,0,0
"China","2024-05-19",0,0,271,0,1,272,0,0
"China","2024-05-20",0,0,271,0,0,272,0,0
"China","2024-05-21",0,0,271,0,0,272,0,0
"China","2024-05-22",0,1,272,0,0,272,0,0
"China","2024-05-23",0,0,272,0,2,274,0,0
"China","2024-05-24",0,3,275,0,1,275,0,0
"China","2024-05-25",0,0,275,0,0,275,0,0
"China","2024-05-26",0,0,275,0,1,276,0,0
"China","2024-05-27",0,1,276,0,0,276,0,0
"China","2024-05-28",0,0,276,0,16,292,0,0
"China","2024-05-29",0,0,276,0,17,309,0,0
"China","2024-05-30",0,49,325,0,16,325,0,0
"China","2024-05-31",0,1,326,0,1,326,0,0
"China","2024-06-01",0,0,326,0,0,326,0,0
"China","2024-06-02",0,0,326,0,0,326,0,0
"China","2024-06-03",0,0,326,0,0,326,0,0
"China","2024-06-04",0,0,326,0,1,327,0,0
"China","2024-06-05",0,0,326,0,0,327,0,0
"China","2024-06-06",0,0,326,0,0,327,0,0
"China","2024-06-07",0,0,326,0,0,327,0,0
"China","2024-06-08",0,0,326,0,0,327,0,0
"China","2024-06-09",0,0,326,0,1,328,0,0
"China","2024-06-10",0,0,326,0,0,328,0,0
"China","2024-06-11",0,0,326,0,0,328,0,0
"China","2024-06-12",0,0,326,0,0,328,0,0
"China","2024-06-13",0,0,326,0,0,328,0,0
"China","2024-06-14",0,0,326,0,0,328,0,0
"China","2024-06-15",0,0,326,0,0,328,0,0
"China","2024-06-16",0,0,326,0,1,329,0,0
"China","2024-06-17",0,0,326,0,0,329,0,0
"China","2024-06-18",0,0,326,0,0,329,0,0
"China","2024-06-19",0,0,326,0,0,329,0,0
"China","2024-06-20",0,0,326,0,0,329,0,0
"China","2024-06-21",0,0,326,0,1,330,0,0
"China","2024-06-22",0,0,326,0,0,330,0,0
"China","2024-06-23",0,0,326,0,0,330,0,0
"China","2024-06-24",0,4,330,0,0,330,0,0
"China","2024-06-25",0,3,333,0,3,333,0,0
"China","2024-06-26",0,0,333,0,10,343,0,0
"China","2024-06-27",0,0,333,0,10,353,0,0
"China","2024-06-28",0,0,333,0,11,364,0,0
"China","2024-06-29",0,0,333,0,10,374,0,0
"China","2024-06-30",0,51,384,0,10,384,0,0
"China","2024-07-01",0,0,384,0,0,384,0,0
"China","2024-07-02",0,0,384,0,0,384,0,0
"China","2024-07-03",0,0,384,0,1,385,0,0
"China","2024-07-04",0,0,384,0,0,385,0,0
"China","2024-07-05",0,0,384,0,0,385,0,0
"China","2024-07-06",0,0,384,0,1,386,0,0
"China","2024-07-07",0,0,384,0,0,386,0,0
"China","2024-07-08",0,2,386,0,0,386,0,0
"China","2024-07-09",0,0,386,0,1,387,0,0
"China","2024-07-10",0,0,386,0,1,388,0,0
"China","2024-07-11",0,0,386,0,0,388,0,0
"China","2024-07-12",0,0,386,0,1,389,0,0
"China","2024-07-13",0,0,386,0,1,390,0,0
"China","2024-07-14",0,0,386,0,0,390,0,0
"China","2024-07-15",0,0,386,0,1,391,0,0
"China","2024-07-16",0,6,392,0,1,392,0,0
"China","2024-07-17",0,0,392,0,1,393,0,0
"China","2024-07-18",0,0,392,0,1,394,0,0
"China","2024-07-19",0,0,392,0,0,394,0,0
"China","2024-07-20",0,0,392,0,1,395,0,0
"China","2024-07-21",0,0,392,0,1,396,0,0
"China","2024-07-22",0,0,392,0,0,396,0,0
"China","2024-07-23",0,0,392,0,1,397,0,0
"China","2024-07-24",0,0,392,0,1,398,0,0
"China","2024-07-25",0,0,392,0,1,399,0,0
"China","2024-07-26",0,0,392,0,1,400,0,0
"China","2024-07-27",0,0,392,0,0,400,0,0
"China","2024-07-28",0,9,401,0,1,401,0,0
"China","2024-07-29",0,0,401,0,20,421,0,0
"China","2024-07-30",0,39,440,0,19,440,0,0
"China","2024-07-31",0,0,440,0,1,441,0,0
"China","2024-08-01",0,0,440,0,0,441,0,0
"China","2024-08-02",0,2,442,0,1,442,0,0
"China","2024-08-03",0,0,442,0,0,442,0,0
"China","2024-08-04",0,0,442,0,1,443,0,0
"China","2024-08-05",0,0,442,0,1,444,0,0
"China","2024-08-06",0,2,444,0,0,444,0,0
"China","2024-08-07",0,0,444,0,1,445,0,0
"China","2024-08-08",0,0,444,0,0,445,0,0
"China","2024-08-09",0,0,444,0,1,446,0,0
"China","2024-08-10",0,0,444,0,1,447,0,0
"China","2024-08-11",0,0,444,0,1,448,0,0
"China","2024-08-12",0,0,444,0,0,448,0,0
"China","2024-08-13",0,5,449,0,1,449,0,0
"China","2024-08-14",0,0,449,0,1,450,0,0
"China","2024-08-15",0,0,449,0,0,450,0,0
"China","2024-08-16",0,0,449,0,1,451,0,0
"China","2024-08-17",0,0,449,0,0,451,0,0
"China","2024-08-18",0,0,449,0,1,452,0,0
"China","2024-08-19",0,0,449,0,0,452,0,0
"China","2024-08-20",0,4,453,0,1,453,0,0
"China","2024-08-21",0,0,453,0,0,453,0,0
"China","2024-08-22",0,0,453,0,0,453,0,0
"China","2024-08-23",0,0,453,0,0,453,0,0
"China","2024-08-24",0,0,453,0,1,454,0,0
"China","2024-08-25",0,0,453,0,0,454,0,0
"China","2024-08-26",0,0,453,0,0,454,0,0
"China","2024-08-27",0,1,454,0,0,454,0,0
"China","2024-08-28",0,0,454,0,12,466,0,0
"China","2024-08-29",0,0,454,0,12,478,0,0
"China","2024-08-30",0,0,454,0,13,491,0,0
"China","2024-08-31",0,49,503,0,12,503,0,0
"China","2024-09-01",0,0,503,0,1,504,0,0
"China","2024-09-02",0,0,503,0,0,504,0,0
"China","2024-09-03",0,0,503,0,1,505,0,0
"China","2024-09-04",0,0,503,0,1,506,0,0
"China","2024-09-05",0,0,503,0,0,506,0,0
"China","2024-09-06",0,0,503,0,1,507,0,0
"China","2024-09-07",0,0,503,0,1,508,0,0
"China","2024-09-08",0,0,503,0,0,508,0,0
"China","2024-09-09",0,0,503,0,1,509,0,0
"China","2024-09-10",0,0,503,0,1,510,0,0
"China","2024-09-11",0,0,503,0,0,510,0,0
"China","2024-09-12",0,0,503,0,1,511,0,0
"China","2024-09-13",0,0,503,0,1,512,0,0
"China","2024-09-14",0,0,503,0,0,512,0,0
"China","2024-09-15",0,10,513,0,1,513,0,0
"China","2024-09-16",0,0,513,0,0,513,0,0
"China","2024-09-17",0,0,513,0,1,514,0,0
"China","2024-09-18",0,0,513,0,0,514,0,0
"China","2024-09-19",0,0,513,0,1,515,0,0
"China","2024-09-20",0,0,513,0,0,515,0,0
"China","2024-09-21",0,0,513,0,0,515,0,0
"China","2024-09-22",0,0,513,0,1,516,0,0
"China","2024-09-23",0,3,516,0,0,516,0,0
"China","2024-09-24",0,0,516,0,1,517,0,0
"China","2024-09-25",0,0,516,0,1,518,0,0
"China","2024-09-26",0,0,516,0,1,519,0,0
"China","2024-09-27",0,0,516,0,1,520,0,0
"China","2024-09-28",0,0,516,0,1,521,0,0
"China","2024-09-29",0,6,522,0,1,522,0,0
"China","2024-09-30",0,0,522,0,3,525,0,0
"China","2024-10-01",0,6,528,0,3,528,0,0
"China","2024-10-02",0,0,528,0,0,528,0,0
"China","2024-10-03",0,1,529,0,1,529,0,0
"China","2024-10-04",0,0,529,0,0,529,0,0
"China","2024-10-05",0,0,529,0,1,530,0,0
"China","2024-10-06",0,0,529,0,0,530,0,0
"China","2024-10-07",0,0,529,0,0,530,0,0
"China","2024-10-08",0,0,529,0,0,530,0,0
"China","2024-10-09",0,0,529,0,1,531,0,0
"China","2024-10-10",0,2,531,0,0,531,0,0
"China","2024-10-11",0,0,531,0,4,535,0,0
"China","2024-10-12",0,0,531,0,4,539,0,0
"China","2024-10-13",0,0,531,0,5,544,0,0
"China","2024-10-14",0,0,531,0,4,548,0,0
"China","2024-10-15",0,0,531,0,4,552,0,0
"China","2024-10-16",0,0,531,0,4,556,0,0
"China","2024-10-17",0,0,531,0,4,560,0,0
"China","2024-10-18",0,0,531,0,4,564,0,0
"China","2024-10-19",0,0,531,0,5,569,0,0
"China","2024-10-20",0,0,531,0,4,573,0,0
"China","2024-10-21",0,46,577,0,4,577,0,0
"China","2024-10-22",0,0,577,0,1,578,0,0
"China","2024-10-23",0,2,579,0,1,579,0,0
"China","2024-10-24",0,0,579,0,1,580,0,0
"China","2024-10-25",0,0,579,0,0,580,0,0
"China","2024-10-26",0,0,579,0,1,581,0,0
"China","2024-10-27",0,0,579,0,1,582,0,0
"China","2024-10-28",0,0,579,0,0,582,0,0
"China","2024-10-29",0,4,583,0,1,583,0,0
"China","2024-10-30",0,0,583,0,0,583,0,0
"China","2024-10-31",0,0,583,0,1,584,0,0
"China","2024-11-01",0,0,583,0,0,584,0,0
"China","2024-11-02",0,0,583,0,1,585,0,0
"China","2024-11-03",0,0,583,0,0,585,0,0
"China","2024-11-04",0,0,583,0,0,585,0,0
"China","2024-11-05",0,0,583,0,1,586,0,0
"China","2024-11-06",0,3,586,0,0,586,0,0
"China","2024-11-07",0,0,586,0,0,586,0,0
"China","2024-11-08",0,0,586,0,0,586,0,0
"China","2024-11-09",0,0,586,0,0,586,0,0
"China","2024-11-10",0,0,586,0,0,586,0,0
"China","2024-11-11",0,0,586,0,0,586,0,0
"China","2024-11-12",0,0,586,0,0,586,0,0
"China","2024-11-13",0,0,586,0,0,586,0,0
"China","2024-11-14",0,0,586,0,0,586,0,0
"China","2024-11-15",0,0,586,0,0,586,0,0
"China","2024-11-16",0,0,586,0,0,586,0,0
"China","2024-11-17",0,0,586,0,0,586,0,0
"China","2024-11-18",0,0,586,0,0,586,0,0
"China","2024-11-19",0,0,586,0,0,586,0,0
"China","2024-11-20",0,0,586,0,0,586,0,0
"China","2024-11-21",0,0,586,0,0,586,0,0
"China","2024-11-22",0,0,586,0,0,586,0,0
"China","2024-11-23",0,0,586,0,0,586,0,0
"China","2024-11-24",0,0,586,0,0,586,0,0
"China","2024-11-25",0,0,586,0,0,586,0,0
"China","2024-11-26",0,0,586,0,0,586,0,0
"China","2024-11-27",0,0,586,0,0,586,0,0
"China","2024-11-28",0,0,586,0,0,586,0,0
"China","2024-11-29",0,0,586,0,0,586,0,0
"China","2024-11-30",0,0,586,0,0,586,0,0
"China","2024-12-01",0,0,586,0,0,586,0,0
"China","2024-12-02",0,0,586,0,0,586,0,0
"China","2024-12-03",0,0,586,0,0,586,0,0
"China","2024-12-04",0,0,586,0,0,586,0,0
"China","2024-12-05",0,0,586,0,0,586,0,0
"China","2024-12-06",0,0,586,0,0,586,0,0
"China","2024-12-07",0,0,586,0,0,586,0,0
"China","2024-12-08",0,0,586,0,0,586,0,0
"China","2024-12-09",0,0,586,0,0,586,0,0
"Colombia","2024-01-01",0,0,0,0,0,0,0,0
"Colombia","2024-01-02",0,10,10,0,10,10,0,0
"Colombia","2024-01-03",0,0,10,0,1,11,0,0
"Colombia","2024-01-04",0,0,10,0,1,12,0,0
"Colombia","2024-01-05",0,0,10,0,1,13,0,0
"Colombia","2024-01-06",0,0,10,0,2,15,0,0
"Colombia","2024-01-07",0,0,10,0,1,16,0,0
"Colombia","2024-01-08",0,0,10,0,1,17,0,0
"Colombia","2024-01-09",0,8,18,0,1,18,0,0
"Colombia","2024-01-10",0,0,18,0,1,19,0,0
"Colombia","2024-01-11",0,0,18,0,1,20,0,0
"Colombia","2024-01-12",0,0,18,0,1,21,0,0
"Colombia","2024-01-13",0,0,18,0,2,23,0,0
"Colombia","2024-01-14",0,0,18,0,1,24,0,0
"Colombia","2024-01-15",0,0,18,0,1,25,0,0
"Colombia","2024-01-16",0,8,26,0,1,26,0,0
"Colombia","2024-01-17",0,0,26,0,1,27,0,0
"Colombia","2024-01-18",0,0,26,0,1,28,0,0
"Colombia","2024-01-19",0,0,26,0,1,29,0,0
"Colombia","2024-01-20",0,0,26,0,0,29,0,0
"Colombia","2024-01-21",0,0,26,0,1,30,0,0
"Colombia","2024-01-22",0,0,26,0,1,31,0,0
"Colombia","2024-01-23",0,6,32,0,1,32,0,0
"Colombia","2024-01-24",0,0,32,0,1,33,0,0
"Colombia","2024-01-25",0,0,32,0,1,34,0,0
"Colombia","2024-01-26",0,0,32,0,1,35,0,0
"Colombia","2024-01-27",0,0,32,0,2,37,0,0
"Colombia","2024-01-28",0,0,32,0,1,38,0,0
"Colombia","2024-01-29",0,0,32,0,1,39,0,0
"Colombia","2024-01-30",0,8,40,0,1,40,0,0
"Colombia","2024-01-31",0,0,40,0,0,40,0,0
"Colombia","2024-02-01",0,0,40,0,0,40,0,0
"Colombia","2024-02-02",0,0,40,0,0,40,0,0
"Colombia","2024-02-03",0,0,40,0,1,41,0,0
"Colombia","2024-02-04",0,0,40,0,0,41,0,0
"Colombia","2024-02-05",0,0,40,0,0,41,0,0
"Colombia","2024-02-06",0,1,41,0,0,41,0,0
"Colombia","2024-02-07",0,0,41,0,0,41,0,0
"Colombia","2024-02-08",0,0,41,0,0,41,0,0
"Colombia","2024-02-09",0,0,41,0,0,41,0,0
"Colombia","2024-02-10",0,0,41,0,1,42,0,0
"Colombia","2024-02-11",0,0,41,0,0,42,0,0
"Colombia","2024-02-12",0,0,41,0,0,42,0,0
"Colombia","2024-02-13",0,1,42,0,0,42,0,0
"Colombia","2024-02-14",0,0,42,0,1,43,0,0
"Colombia","2024-02-15",0,0,42,0,0,43,0,0
"Colombia","2024-02-16",0,0,42,0,1,44,0,0
"Colombia","2024-02-17",0,0,42,0,0,44,0,0
"Colombia","2024-02-18",0,0,42,0,1,45,0,0
"Colombia","2024-02-19",0,0,42,0,0,45,0,0
"Colombia","2024-02-20",0,4,46,0,1,46,0,0
"Colombia","2024-02-21",0,0,46,0,1,47,0,0
"Colombia","2024-02-22",0,0,46,0,2,49,0,0
"Colombia","2024-02-23",0,0,46,0,1,50,0,0
"Colombia","2024-02-24",0,0,46,0,1,51,0,0
"Colombia","2024-02-25",0,0,46,0,1,52,0,0
"Colombia","2024-02-26",0,0,46,0,2,54,0,0
"Colombia","2024-02-27",0,9,55,0,1,55,0,0
"Colombia","2024-02-28",0,0,55,0,0,55,0,0
"Colombia","2024-02-29",0,0,55,0,1,56,0,0
"Colombia","2024-03-01",0,0,55,0,0,56,0,0
"Colombia","2024-03-02",0,0,55,0,1,57,0,0
"Colombia","2024-03-03",0,0,55,0,0,57,0,0
"Colombia","2024-03-04",0,0,55,0,1,58,0,0
"Colombia","2024-03-05",0,3,58,0,0,58,0,0
"Colombia","2024-03-06",0,0,58,0,1,59,0,0
"Colombia","2024-03-07",0,0,58,0,0,59,0,0
"Colombia","2024-03-08",0,0,58,0,1,60,0,0
"Colombia","2024-03-09",0,0,58,0,0,60,0,0
"Colombia","2024-03-10",0,0,58,0,1,61,0,0
"Colombia","2024-03-11",0,0,58,0,0,61,0,0
"Colombia","2024-03-12",0,4,62,0,1,62,0,0
"Colombia","2024-03-13",0,0,62,0,1,63,0,0
"Colombia","2024-03-14",0,0,62,0,0,63,0,0
"Colombia","2024-03-15",0,0,62,0,1,64,0,0
"Colombia","2024-03-16",0,0,62,0,0,64,0,0
"Colombia","2024-03-17",0,0,62,0,1,65,0,0
"Colombia","2024-03-18",0,0,62,0,0,65,0,0
"Colombia","2024-03-19",0,4,66,0,1,66,0,0
"Colombia","2024-03-20",0,0,66,0,0,66,0,0
"Colombia","2024-03-21",0,0,66,0,1,67,0,0
"Colombia","2024-03-22",0,0,66,0,0,67,0,0
"Colombia","2024-03-23",0,0,66,0,0,67,0,0
"Colombia","2024-03-24",0,0,66,0,0,67,0,0
"Colombia","2024-03-25",0,0,66,0,1,68,0,0
"Colombia","2024-03-26",0,2,68,0,0,68,0,0
"Colombia","2024-03-27",0,0,68,0,1,69,0,0
"Colombia","2024-03-28",0,0,68,0,0,69,0,0
"Colombia","2024-03-29",0,0,68,0,1,70,0,0
"Colombia","2024-03-30",0,0,68,0,1,71,0,0
"Colombia","2024-03-31",0,0,68,0,1,72,0,0
"Colombia","2024-04-01",0,0,68,0,0,72,0,0
"Colombia","2024-04-02",0,5,73,0,1,73,0,0
"Colombia","2024-04-03",0,0,73,0,1,74,0,0
"Colombia","2024-04-04",0,0,73,0,0,74,0,0
"Colombia","2024-04-05",0,0,73,0,1,75,0,0
"Colombia","2024-04-06",0,0,73,0,1,76,0,0
"Colombia","2024-04-07",0,0,73,0,1,77,0,0
"Colombia","2024-04-08",0,0,73,0,0,77,0,0
"Colombia","2024-04-09",0,5,78,0,1,78,0,0
"Colombia","2024-04-10",0,0,78,0,0,78,0,0
"Colombia","2024-04-11",0,0,78,0,1,79,0,0
"Colombia","2024-04-12",0,0,78,0,0,79,0,0
"Colombia","2024-04-13",0,0,78,0,1,80,0,0
"Colombia","2024-04-14",0,0,78,0,0,80,0,0
"Colombia","2024-04-15",0,0,78,0,1,81,0,0
"Colombia","2024-04-16",0,3,81,0,0,81,0,0
"Colombia","2024-04-17",0,0,81,0,1,82,0,0
"Colombia","2024-04-18",0,0,81,0,2,84,0,0
"Colombia","2024-04-19",0,0,81,0,1,85,0,0
"Colombia","2024-04-20",0,0,81,0,1,86,0,0
"Colombia","2024-04-21",0,0,81,0,1,87,0,0
"Colombia","2024-04-22",0,0,81,0,2,89,0,0
"Colombia","2024-04-23",0,9,90,0,1,90,0,0
"Colombia","2024-04-24",0,0,90,0,0,90,0,0
"Colombia","2024-04-25",0,0,90,0,1,91,0,0
"Colombia","2024-04-26",0,0,90,0,0,91,0,0
"Colombia","2024-04-27",0,0,90,0,0,91,0,0
"Colombia","2024-04-28",0,0,90,0,0,91,0,0
"Colombia","2024-04-29",0,0,90,0,1,92,0,0
"Colombia","2024-04-30",0,2,92,0,0,92,0,0
"Colombia","2024-05-01",0,0,92,0,0,92,0,0
"Colombia","2024-05-02",0,0,92,0,0,92,0,0
"Colombia","2024-05-03",0,0,92,0,0,92,0,0
"Colombia","2024-05-04",0,0,92,0,1,93,0,0
"Colombia","2024-05-05",0,0,92,0,0,93,0,0
"Colombia","2024-05-06",0,0,92,0,0,93,0,0
"Colombia","2024-05-07",0,0,92,0,0,93,0,0
"Colombia","2024-05-08",0,0,92,0,0,93,0,0
"Colombia","2024-05-09",0,0,92,0,0,93,0,0
"Colombia","2024-05-10",0,0,92,0,0,93,0,0
"Colombia","2024-05-11",0,0,92,0,1,94,0,0
"Colombia","2024-05-12",0,0,92,0,0,94,0,0
"Colombia","2024-05-13",0,0,92,0,0,94,0,0
"Colombia","2024-05-14",0,2,94,0,0,94,0,0
"Colombia","2024-05-15",0,0,94,0,0,94,0,0
"Colombia","2024-05-16",0,0,94,0,1,95,0,0
"Colombia","2024-05-17",0,0,94,0,0,95,0,0
"Colombia","2024-05-18",0,0,94,0,0,95,0,0
"Colombia","2024-05-19",0,0,94,0,0,95,0,0
"Colombia","2024-05-20",0,0,94,0,1,96,0,0
"Colombia","2024-05-21",0,2,96,0,0,96,0,0
"Colombia","2024-05-22",0,0,96,0,0,96,0,0
"Colombia","2024-05-23",0,0,96,0,0,96,0,0
"Colombia","2024-05-24",0,0,96,0,0,96,0,0
"Colombia","2024-05-25",0,0,96,0,1,97,0,0
"Colombia","2024-05-26",0,0,96,0,0,97,0,0
"Colombia","2024-05-27",0,0,96,0,0,97,0,0
"Colombia","2024-05-28",0,0,96,0,0,97,0,0
"Colombia","2024-05-29",0,0,96,0,0,97,0,0
"Colombia","2024-05-30",0,0,96,0,0,97,0,0
"Colombia","2024-05-31",0,0,96,0,0,97,0,0
"Colombia","2024-06-01",0,0,96,0,1,98,0,0
"Colombia","2024-06-02",0,0,96,0,0,98,0,0
"Colombia","2024-06-03",0,0,96,0,0,98,0,0
"Colombia","2024-06-04",0,2,98,0,0,98,0,0
"Colombia","2024-06-05",0,0,98,0,1,99,0,0
"Colombia","2024-06-06",0,0,98,0,0,99,0,0
"Colombia","2024-06-07",0,0,98,0,1,100,0,0
"Colombia","2024-06-08",0,0,98,0,0,100,0,0
"Colombia","2024-06-09",0,0,98,0,1,101,0,0
"Colombia","2024-06-10",0,0,98,0,0,101,0,0
"Colombia","2024-06-11",0,4,102,0,1,102,0,0
"Colombia","2024-06-12",0,0,102,0,0,102,0,0
"Colombia","2024-06-13",0,0,102,0,1,103,0,0
"Colombia","2024-06-14",0,0,102,0,0,103,0,0
"Colombia","2024-06-15",0,0,102,0,0,103,0,0
"Colombia","2024-06-16",0,0,102,0,0,103,0,0
"Colombia","2024-06-17",0,0,102,0,1,104,0,0
"Colombia","2024-06-18",0,2,104,0,0,104,0,0
"Colombia","2024-06-19",0,0,104,0,0,104,0,0
"Colombia","2024-06-20",0,0,104,0,1,105,0,0
"Colombia","2024-06-21",0,0,104,0,0,105,0,0
"Colombia","2024-06-22",0,0,104,0,0,105,0,0
"Colombia","2024-06-23",0,0,104,0,0,105,0,0
"Colombia","2024-06-24",0,0,104,0,1,106,0,0
"Colombia","2024-06-25",0,0,104,0,0,106,0,0
"Colombia","2024-06-26",0,0,104,0,0,106,0,0
"Colombia","2024-06-27",0,0,104,0,1,107,0,0
"Colombia","2024-06-28",0,0,104,0,0,107,0,0
"Colombia","2024-06-29",0,0,104,0,0,107,0,0
"Colombia","2024-06-30",0,0,104,0,0,107,0,0
"Colombia","2024-07-01",0,0,104,0,1,108,0,0
"Colombia","2024-07-02",0,4,108,0,0,108,0,0
"Colombia","2024-07-03",0,0,108,0,0,108,0,0
"Colombia","2024-07-04",0,0,108,0,1,109,0,0
"Colombia","2024-07-05",0,0,108,0,0,109,0,0
"Colombia","2024-07-06",0,0,108,0,0,109,0,0
"Colombia","2024-07-07",0,0,108,0,0,109,0,0
"Colombia","2024-07-08",0,0,108,0,1,110,0,0
"Colombia","2024-07-09",0,2,110,0,0,110,0,0
"Colombia","2024-07-10",0,0,110,0,0,110,0,0
"Colombia","2024-07-11",0,0,110,0,1,111,0,0
"Colombia","2024-07-12",0,0,110,0,0,111,0,0
"Colombia","2024-07-13",0,0,110,0,1,112,0,0
"Colombia","2024-07-14",0,0,110,0,0,112,0,0
"Colombia","2024-07-15",0,0,110,0,1,113,0,0
"Colombia","2024-07-16",0,3,113,0,0,113,0,0
"Colombia","2024-07-17",0,0,113,0,0,113,0,0
"Colombia","2024-07-18",0,0,113,0,0,113,0,0
"Colombia","2024-07-19",0,0,113,0,0,113,0,0
"Colombia","2024-07-20",0,0,113,0,0,113,0,0
"Colombia","2024-07-21",0,0,113,0,0,113,0,0
"Colombia","2024-07-22",0,0,113,0,0,113,0,0
"Colombia","2024-07-23",0,0,113,0,0,113,0,0
"Colombia","2024-07-24",0,0,113,0,1,114,0,0
"Colombia","2024-07-25",0,0,113,0,0,114,0,0
"Colombia","2024-07-26",0,0,113,0,0,114,0,0
"Colombia","2024-07-27",0,0,113,0,0,114,0,0
"Colombia","2024-07-28",0,0,113,0,0,114,0,0
"Colombia","2024-07-29",0,0,113,0,0,114,0,0
"Colombia","2024-07-30",0,1,114,0,0,114,0,0
"Colombia","2024-07-31",0,0,114,0,0,114,0,0
"Colombia","2024-08-01",0,0,114,0,1,115,0,0
"Colombia","2024-08-02",0,0,114,0,0,115,0,0
"Colombia","2024-08-03",0,0,114,0,0,115,0,0
"Colombia","2024-08-04",0,0,114,0,0,115,0,0
"Colombia","2024-08-05",0,0,114,0,1,116,0,0
"Colombia","2024-08-06",0,2,116,0,0,116,0,0
"Colombia","2024-08-07",0,0,116,0,0,116,0,0
"Colombia","2024-08-08",0,0,116,0,0,116,0,0
"Colombia","2024-08-09",0,0,116,0,0,116,0,0
"Colombia","2024-08-10",0,0,116,0,1,117,0,0
"Colombia","2024-08-11",0,0,116,0,0,117,0,0
"Colombia","2024-08-12",0,0,116,0,0,117,0,0
"Colombia","2024-08-13",0,0,116,0,0,117,0,0
"Colombia","2024-08-14",0,0,116,0,0,117,0,0
"Colombia","2024-08-15",0,0,116,0,0,117,0,0
"Colombia","2024-08-16",0,0,116,0,0,117,0,0
"Colombia","2024-08-17",0,0,116,0,1,118,0,0
"Colombia","2024-08-18",0,0,116,0,0,118,0,0
"Colombia","2024-08-19",0,0,116,0,0,118,0,0
"Colombia","2024-08-20",0,2,118,0,0,118,0,0
"Colombia","2024-08-21",0,0,118,0,0,118,0,0
"Colombia","2024-08-22",0,0,118,0,1,119,0,0
"Colombia","2024-08-23",0,0,118,0,0,119,0,0
"Colombia","2024-08-24",0,0,118,0,1,120,0,0
"Colombia","2024-08-25",0,0,118,0,0,120,0,0
"Colombia","2024-08-26",0,0,118,0,1,121,0,0
"Colombia","2024-08-27",0,3,121,0,0,121,0,0
"Colombia","2024-08-28",0,0,121,0,0,121,0,0
"Colombia","2024-08-29",0,0,121,0,0,121,0,0
"Colombia","2024-08-30",0,0,121,0,0,121,0,0
"Colombia","2024-08-31",0,0,121,0,0,121,0,0
"Colombia","2024-09-01",0,0,121,0,0,121,0,0
"Colombia","2024-09-02",0,0,121,0,1,122,0,0
"Colombia","2024-09-03",0,0,121,0,0,122,0,0
"Colombia","2024-09-04",0,0,121,0,0,122,0,0
"Colombia","2024-09-05",0,0,121,0,0,122,0,0
"Colombia","2024-09-06",0,0,121,0,0,122,0,0
"Colombia","2024-09-07",0,0,121,0,0,122,0,0
"Colombia","2024-09-08",0,0,121,0,0,122,0,0
"Colombia","2024-09-09",0,0,121,0,0,122,0,0
"Colombia","2024-09-10",0,0,121,0,0,122,0,0
"Colombia","2024-09-11",0,0,121,0,0,122,0,0
"Colombia","2024-09-12",0,0,121,0,1,123,0,0
"Colombia","2024-09-13",0,0,121,0,0,123,0,0
"Colombia","2024-09-14",0,0,121,0,0,123,0,0
"Colombia","2024-09-15",0,0,121,0,0,123,0,0
"Colombia","2024-09-16",0,0,121,0,0,123,0,0
"Colombia","2024-09-17",0,2,123,0,0,123,0,0
"Colombia","2024-09-18",0,0,123,0,0,123,0,0
"Colombia","2024-09-19",0,0,123,0,0,123,0,0
"Colombia","2024-09-20",0,0,123,0,0,123,0,0
"Colombia","2024-09-21",0,0,123,0,1,124,0,0
"Colombia","2024-09-22",0,0,123,0,0,124,0,0
"Colombia","2024-09-23",0,0,123,0,0,124,0,0
"Colombia","2024-09-24",0,1,124,0,0,124,0,0
"Colombia","2024-09-25",0,0,124,0,0,124,0,0
"Colombia","2024-09-26",0,0,124,0,0,124,0,0
"Colombia","2024-09-27",0,0,124,0,1,125,0,0
"Colombia","2024-09-28",0,0,124,0,0,125,0,0
"Colombia","2024-09-29",0,0,124,0,0,125,0,0
"Colombia","2024-09-30",0,0,124,0,0,125,0,0
"Colombia","2024-10-01",0,0,124,0,1,126,0,0
"Colombia","2024-10-02",0,0,124,0,0,126,0,0
"Colombia","2024-10-03",0,0,124,0,0,126,0,0
"Colombia","2024-10-04",0,0,124,0,0,126,0,0
"Colombia","2024-10-05",0,0,124,0,0,126,0,0
"Colombia","2024-10-06",0,0,124,0,1,127,0,0
"Colombia","2024-10-07",0,0,124,0,0,127,0,0
"Colombia","2024-10-08",0,3,127,0,0,127,0,0
"Colombia","2024-10-09",0,0,127,0,0,127,0,0
"Colombia","2024-10-10",0,0,127,0,1,128,0,0
"Colombia","2024-10-11",0,0,127,0,0,128,0,0
"Colombia","2024-10-12",0,0,127,0,1,129,0,0
"Colombia","2024-10-13",0,0,127,0,0,129,0,0
"Colombia","2024-10-14",0,0,127,0,1,130,0,0
"Colombia","2024-10-15",0,3,130,0,0,130,0,0
"Colombia","2024-10-16",0,0,130,0,0,130,0,0
"Colombia","2024-10-17",0,0,130,0,0,130,0,0
"Colombia","2024-10-18",0,0,130,0,0,130,0,0
"Colombia","2024-10-19",0,0,130,0,1,131,0,0
"Colombia","2024-10-20",0,0,130,0,0,131,0,0
"Colombia","2024-10-21",0,0,130,0,0,131,0,0
"Colombia","2024-10-22",0,1,131,0,0,131,0,0
"Colombia","2024-10-23",0,0,131,0,0,131,0,0
"Colombia","2024-10-24",0,0,131,0,0,131,0,0
"Colombia","2024-10-25",0,0,131,0,0,131,0,0
"Colombia","2024-10-26",0,0,131,0,0,131,0,0
"Colombia","2024-10-27",0,0,131,0,0,131,0,0
"Colombia","2024-10-28",0,0,131,0,0,131,0,0
"Colombia","2024-10-29",0,0,131,0,0,131,0,0
"Colombia","2024-10-30",0,0,131,0,0,131,0,0
"Colombia","2024-10-31",0,0,131,0,0,131,0,0
"Colombia","2024-11-01",0,0,131,0,0,131,0,0
"Colombia","2024-11-02",0,0,131,0,0,131,0,0
"Colombia","2024-11-03",0,0,131,0,0,131,0,0
"Colombia","2024-11-04",0,0,131,0,0,131,0,0
"Colombia","2024-11-05",0,0,131,0,0,131,0,0
"Colombia","2024-11-06",0,0,131,0,0,131,0,0
"Colombia","2024-11-07",0,0,131,0,0,131,0,0
"Colombia","2024-11-08",0,0,131,0,0,131,0,0
"Colombia","2024-11-09",0,0,131,0,0,131,0,0
"Colombia","2024-11-10",0,0,131,0,0,131,0,0
"Colombia","2024-11-11",0,0,131,0,0,131,0,0
"Colombia","2024-11-12",0,0,131,0,0,131,0,0
"Colombia","2024-11-13",0,0,131,0,0,131,0,0
"Colombia","2024-11-14",0,0,131,0,0,131,0,0
"Colombia","2024-11-15",0,0,131,0,0,131,0,0
"Colombia","2024-11-16",0,0,131,0,0,131,0,0
"Colombia","2024-11-17",0,0,131,0,0,131,0,0
"Colombia","2024-11-18",0,0,131,0,0,131,0,0
"Colombia","2024-11-19",0,0,131,0,0,131,0,0
"Colombia","2024-11-20",0,0,131,0,0,131,0,0
"Colombia","2024-11-21",0,0,131,0,0,131,0,0
"Colombia","2024-11-22",0,0,131,0,0,131,0,0
"Colombia","2024-11-23",0,0,131,0,0,131,0,0
"Colombia","2024-11-24",0,0,131,0,0,131,0,0
"Colombia","2024-11-25",0,0,131,0,0,131,0,0
"Colombia","2024-11-26",0,0,131,0,0,131,0,0
"Colombia","2024-11-27",0,0,131,0,0,131,0,0
"Colombia","2024-11-28",0,0,131,0,0,131,0,0
"Colombia","2024-11-29",0,0,131,0,0,131,0,0
"Colombia","2024-11-30",0,0,131,0,0,131,0,0
"Colombia","2024-12-01",0,0,131,0,0,131,0,0
"Colombia","2024-12-02",0,0,131,0,0,131,0,0
"Colombia","2024-12-03",0,0,131,0,0,131,0,0
"Colombia","2024-12-04",0,0,131,0,0,131,0,0
"Colombia","2024-12-05",0,0,131,0,0,131,0,0
"Colombia","2024-12-06",0,0,131,0,0,131,0,0
"Colombia","2024-12-07",0,0,131,0,0,131,0,0
"Colombia","2024-12-08",0,0,131,0,0,131,0,0
"Colombia","2024-12-09",0,0,131,0,0,131,0,0
"Congo","2024-01-01",0,0,0,0,0,0,0,0
"Congo","2024-01-02",0,0,0,0,0,0,0,0
"Congo","2024-01-03",0,0,0,0,0,0,0,0
"Congo","2024-01-04",0,0,0,0,0,0,0,0
"Congo","2024-01-05",0,0,0,0,0,0,0,0
"Congo","2024-01-06",0,0,0,0,0,0,0,0
"Congo","2024-01-07",0,0,0,0,0,0,0,0
"Congo","2024-01-08",0,0,0,0,0,0,0,0
"Congo","2024-01-09",0,0,0,0,0,0,0,0
"Congo","2024-01-10",0,0,0,0,0,0,0,0
"Congo","2024-01-11",0,0,0,0,0,0,0,0
"Congo","2024-01-12",0,0,0,0,0,0,0,0
"Congo","2024-01-13",0,0,0,0,0,0,0,0
"Congo","2024-01-14",0,1,1,0,1,1,0,0
"Congo","2024-01-15",0,0,1,0,0,1,0,0
"Congo","2024-01-16",0,0,1,0,0,1,0,0
"Congo","2024-01-17",0,0,1,0,0,1,0,0
"Congo","2024-01-18",0,0,1,0,1,2,0,0
"Congo","2024-01-19",0,0,1,0,0,2,0,0
"Congo","2024-01-20",0,0,1,0,0,2,0,0
"Congo","2024-01-21",0,1,2,0,0,2,0,0
"Congo","2024-01-22",0,0,2,0,0,2,0,0
"Congo","2024-01-23",0,0,2,0,1,3,0,0
"Congo","2024-01-24",0,0,2,0,0,3,0,0
"Congo","2024-01-25",0,0,2,0,0,3,0,0
"Congo","2024-01-26",0,0,2,0,0,3,0,0
"Congo","2024-01-27",0,0,2,0,1,4,0,0
"Congo","2024-01-28",0,2,4,0,0,4,0,0
"Congo","2024-01-29",0,0,4,0,0,4,0,0
"Congo","2024-01-30",0,0,4,0,0,4,0,0
"Congo","2024-01-31",0,0,4,0,1,5,0,0
"Congo","2024-02-01",0,0,4,0,0,5,0,0
"Congo","2024-02-02",0,0,4,0,0,5,0,0
"Congo","2024-02-03",0,0,4,0,0,5,0,0
"Congo","2024-02-04",0,0,4,0,1,6,0,0
"Congo","2024-02-05",0,0,4,0,0,6,0,0
"Congo","2024-02-06",0,0,4,0,0,6,0,0
"Congo","2024-02-07",0,0,4,0,0,6,0,0
"Congo","2024-02-08",0,0,4,0,1,7,0,0
"Congo","2024-02-09",0,0,4,0,0,7,0,0
"Congo","2024-02-10",0,0,4,0,0,7,0,0
"Congo","2024-02-11",0,0,4,0,0,7,0,0
"Congo","2024-02-12",0,0,4,0,1,8,0,0
"Congo","2024-02-13",0,0,4,0,0,8,0,0
"Congo","2024-02-14",0,0,4,0,0,8,0,0
"Congo","2024-02-15",0,0,4,0,0,8,0,0
"Congo","2024-02-16",0,0,4,0,1,9,0,0
"Congo","2024-02-17",0,0,4,0,0,9,0,0
"Congo","2024-02-18",0,5,9,0,0,9,0,0
"Congo","2024-02-19",0,0,9,0,0,9,0,0
"Congo","2024-02-20",0,0,9,0,1,10,0,0
"Congo","2024-02-21",0,0,9,0,0,10,0,0
"Congo","2024-02-22",0,0,9,0,0,10,0,0
"Congo","2024-02-23",0,0,9,0,0,10,0,0
"Congo","2024-02-24",0,0,9,0,1,11,0,0
"Congo","2024-02-25",0,2,11,0,0,11,0,0
"Congo","2024-02-26",0,0,11,0,1,12,0,0
"Congo","2024-02-27",0,0,11,0,0,12,0,0
"Congo","2024-02-28",0,0,11,0,1,13,0,0
"Congo","2024-02-29",0,0,11,0,0,13,0,0
"Congo","2024-03-01",0,0,11,0,1,14,0,0
"Congo","2024-03-02",0,0,11,0,0,14,0,0
"Congo","2024-03-03",0,0,11,0,1,15,0,0
"Congo","2024-03-04",0,0,11,0,1,16,0,0
"Congo","2024-03-05",0,0,11,0,0,16,0,0
"Congo","2024-03-06",0,0,11,0,1,17,0,0
"Congo","2024-03-07",0,0,11,0,0,17,0,0
"Congo","2024-03-08",0,0,11,0,1,18,0,0
"Congo","2024-03-09",0,0,11,0,0,18,0,0
"Congo","2024-03-10",0,8,19,0,1,19,0,0
"Congo","2024-03-11",0,0,19,0,0,19,0,0
"Congo","2024-03-12",0,0,19,0,0,19,0,0
"Congo","2024-03-13",0,0,19,0,0,19,0,0
"Congo","2024-03-14",0,0,19,0,0,19,0,0
"Congo","2024-03-15",0,0,19,0,0,19,0,0
"Congo","2024-03-16",0,0,19,0,0,19,0,0
"Congo","2024-03-17",24,0,19,24,0,19,24,24
"Congo","2024-03-18",0,0,19,24,0,19,1,25
"Congo","2024-03-19",0,0,19,24,0,19,1,26
"Congo","2024-03-20",0,0,19,24,0,19,1,27
"Congo","2024-03-21",0,0,19,24,0,19,0,27
"Congo","2024-03-22",0,0,19,24,0,19,1,28
"Congo","2024-03-23",0,0,19,24,0,19,1,29
"Congo","2024-03-24",0,0,19,24,0,19,1,30
"Congo","2024-03-25",0,0,19,24,0,19,1,31
"Congo","2024-03-26",0,0,19,24,0,19,1,32
"Congo","2024-03-27",0,0,19,24,0,19,0,32
"Congo","2024-03-28",0,0,19,24,0,19,1,33
"Congo","2024-03-29",0,0,19,24,0,19,1,34
"Congo","2024-03-30",0,0,19,24,0,19,1,35
"Congo","2024-03-31",0,0,19,24,0,19,1,36
"Congo","2024-04-01",0,0,19,24,0,19,1,37
"Congo","2024-04-02",0,0,19,24,0,19,1,38
"Congo","2024-04-03",0,0,19,24,0,19,0,38
"Congo","2024-04-04",0,0,19,24,0,19,1,39
"Congo","2024-04-05",0,0,19,24,0,19,1,40
"Congo","2024-04-06",17,0,19,41,0,19,1,41
"Congo","2024-04-07",0,0,19,41,0,19,0,41
"Congo","2024-04-08",0,0,19,41,0,19,1,42
"Congo","2024-04-09",0,0,19,41,0,19,1,43
"Congo","2024-04-10",0,0,19,41,0,19,0,43
"Congo","2024-04-11",0,0,19,41,0,19,0,43
"Congo","2024-04-12",0,0,19,41,0,19,1,44
"Congo","2024-04-13",0,0,19,41,0,19,1,45
"Congo","2024-04-14",0,0,19,41,0,19,0,45
"Congo","2024-04-15",0,0,19,41,0,19,0,45
"Congo","2024-04-16",0,0,19,41,0,19,1,46
"Congo","2024-04-17",0,0,19,41,0,19,1,47
"Congo","2024-04-18",0,0,19,41,1,20,0,47
"Congo","2024-04-19",0,0,19,41,0,20,0,47
"Congo","2024-04-20",0,0,19,41,0,20,1,48
"Congo","2024-04-21",0,0,19,41,0,20,1,49
"Congo","2024-04-22",0,0,19,41,0,20,0,49
"Congo","2024-04-23",0,0,19,41,0,20,0,49
"Congo","2024-04-24",0,0,19,41,0,20,1,50
"Congo","2024-04-25",0,0,19,41,0,20,1,51
"Congo","2024-04-26",0,0,19,41,0,20,0,51
"Congo","2024-04-27",0,0,19,41,0,20,0,51
"Congo","2024-04-28",0,0,19,41,0,20,1,52
"Congo","2024-04-29",0,0,19,41,0,20,1,53
"Congo","2024-04-30",0,0,19,41,0,20,0,53
"Congo","2024-05-01",0,0,19,41,0,20,0,53
"Congo","2024-05-02",0,0,19,41,0,20,1,54
"Congo","2024-05-03",0,0,19,41,0,20,1,55
"Congo","2024-05-04",0,0,19,41,0,20,0,55
"Congo","2024-05-05",0,0,19,41,0,20,0,55
"Congo","2024-05-06",0,0,19,41,0,20,1,56
"Congo","2024-05-07",0,0,19,41,0,20,1,57
"Congo","2024-05-08",0,0,19,41,0,20,0,57
"Congo","2024-05-09",0,0,19,41,0,20,0,57
"Congo","2024-05-10",0,0,19,41,0,20,1,58
"Congo","2024-05-11",0,0,19,41,0,20,1,59
"Congo","2024-05-12",18,0,19,59,0,20,0,59
"Congo","2024-05-13",0,0,19,59,0,20,2,61
"Congo","2024-05-14",0,0,19,59,0,20,1,62
"Congo","2024-05-15",0,0,19,59,0,20,1,63
"Congo","2024-05-16",0,0,19,59,0,20,2,65
"Congo","2024-05-17",0,0,19,59,0,20,2,67
"Congo","2024-05-18",9,0,19,68,0,20,1,68
"Congo","2024-05-19",0,0,19,68,0,20,2,70
"Congo","2024-05-20",0,0,19,68,0,20,1,71
"Congo","2024-05-21",0,0,19,68,0,20,2,73
"Congo","2024-05-22",0,0,19,68,0,20,1,74
"Congo","2024-05-23",0,0,19,68,0,20,2,76
"Congo","2024-05-24",0,0,19,68,0,20,1,77
"Congo","2024-05-25",0,0,19,68,0,20,2,79
"Congo","2024-05-26",0,0,19,68,0,20,2,81
"Congo","2024-05-27",0,0,19,68,0,20,1,82
"Congo","2024-05-28",0,0,19,68,0,20,2,84
"Congo","2024-05-29",0,0,19,68,0,20,1,85
"Congo","2024-05-30",0,0,19,68,0,20,2,87
"Congo","2024-05-31",0,0,19,68,0,20,1,88
"Congo","2024-06-01",22,0,19,90,0,20,2,90
"Congo","2024-06-02",0,0,19,90,0,20,1,91
"Congo","2024-06-03",0,0,19,90,0,20,1,92
"Congo","2024-06-04",0,0,19,90,0,20,1,93
"Congo","2024-06-05",0,0,19,90,0,20,2,95
"Congo","2024-06-06",0,0,19,90,0,20,1,96
"Congo","2024-06-07",0,0,19,90,0,20,1,97
"Congo","2024-06-08",0,0,19,90,0,20,1,98
"Congo","2024-06-09",0,0,19,90,0,20,1,99
"Congo","2024-06-10",0,0,19,90,0,20,1,100
"Congo","2024-06-11",0,0,19,90,0,20,1,101
"Congo","2024-06-12",0,0,19,90,0,20,2,103
"Congo","2024-06-13",0,0,19,90,0,20,1,104
"Congo","2024-06-14",0,0,19,90,0,20,1,105
"Congo","2024-06-15",0,0,19,90,0,20,1,106
"Congo","2024-06-16",0,0,19,90,0,20,1,107
"Congo","2024-06-17",0,0,19,90,0,20,1,108
"Congo","2024-06-18",0,0,19,90,0,20,1,109
"Congo","2024-06-19",0,0,19,90,0,20,2,111
"Congo","2024-06-20",0,0,19,90,0,20,1,112
"Congo","2024-06-21",0,0,19,90,0,20,1,113
"Congo","2024-06-22",24,0,19,114,0,20,1,114
"Congo","2024-06-23",0,0,19,114,0,20,2,116
"Congo","2024-06-24",0,0,19,114,0,20,1,117
"Congo","2024-06-25",0,0,19,114,0,20,2,119
"Congo","2024-06-26",0,0,19,114,0,20,1,120
"Congo","2024-06-27",0,0,19,114,0,20,2,122
"Congo","2024-06-28",0,0,19,114,0,20,2,124
"Congo","2024-06-29",0,0,19,114,0,20,1,125
"Congo","2024-06-30",13,0,19,127,0,20,2,127
"Congo","2024-07-01",0,0,19,127,0,20,0,127
"Congo","2024-07-02",0,0,19,127,0,20,1,128
"Congo","2024-07-03",0,0,19,127,0,20,0,128
"Congo","2024-07-04",0,0,19,127,1,21,0,128
"Congo","2024-07-05",0,0,19,127,0,21,1,129
"Congo","2024-07-06",0,0,19,127,0,21,0,129
"Congo","2024-07-07",0,0,19,127,0,21,0,129
"Congo","2024-07-08",0,0,19,127,0,21,1,130
"Congo","2024-07-09",0,0,19,127,0,21,0,130
"Congo","2024-07-10",0,0,19,127,0,21,1,131
"Congo","2024-07-11",0,0,19,127,0,21,0,131
"Congo","2024-07-12",0,0,19,127,0,21,0,131
"Congo","2024-07-13",0,0,19,127,0,21,1,132
"Congo","2024-07-14",0,0,19,127,0,21,0,132
"Congo","2024-07-15",0,0,19,127,0,21,0,132
"Congo","2024-07-16",0,0,19,127,0,21,1,133
"Congo","2024-07-17",0,0,19,127,0,21,0,133
"Congo","2024-07-18",0,0,19,127,0,21,0,133
"Congo","2024-07-19",0,0,19,127,0,21,1,134
"Congo","2024-07-20",0,0,19,127,0,21,0,134
"Congo","2024-07-21",0,0,19,127,0,21,0,134
"Congo","2024-07-22",0,0,19,127,0,21,1,135
"Congo","2024-07-23",0,0,19,127,0,21,0,135
"Congo","2024-07-24",0,0,19,127,0,21,0,135
"Congo","2024-07-25",0,0,19,127,0,21,1,136
"Congo","2024-07-26",0,0,19,127,0,21,0,136
"Congo","2024-07-27",0,0,19,127,0,21,0,136
"Congo","2024-07-28",0,0,19,127,0,21,1,137
"Congo","2024-07-29",0,0,19,127,0,21,0,137
"Congo","2024-07-30",0,0,19,127,0,21,0,137
"Congo","2024-07-31",0,0,19,127,0,21,1,138
"Congo","2024-08-01",0,0,19,127,0,21,0,138
"Congo","2024-08-02",0,0,19,127,0,21,1,139
"Congo","2024-08-03",0,0,19,127,0,21,0,139
"Congo","2024-08-04",0,0,19,127,0,21,0,139
"Congo","2024-08-05",0,0,19,127,0,21,1,140
"Congo","2024-08-06",0,0,19,127,0,21,0,140
"Congo","2024-08-07",0,0,19,127,0,21,0,140
"Congo","2024-08-08",0,0,19,127,0,21,1,141
"Congo","2024-08-09",14,0,19,141,0,21,0,141
"Congo","2024-08-10",0,0,19,141,0,21,1,142
"Congo","2024-08-11",0,2,21,141,0,21,0,142
"Congo","2024-08-12",0,0,21,141,0,21,1,143
"Congo","2024-08-13",0,0,21,141,0,21,0,143
"Congo","2024-08-14",0,0,21,141,0,21,1,144
"Congo","2024-08-15",0,0,21,141,0,21,0,144
"Congo","2024-08-16",0,0,21,141,0,21,1,145
"Congo","2024-08-17",0,0,21,141,0,21,1,146
"Congo","2024-08-18",0,0,21,141,0,21,0,146
"Congo","2024-08-19",0,0,21,141,0,21,1,147
"Congo","2024-08-20",0,0,21,141,0,21,0,147
"Congo","2024-08-21",0,0,21,141,0,21,1,148
"Congo","2024-08-22",0,0,21,141,0,21,1,149
"Congo","2024-08-23",0,0,21,141,0,21,0,149
"Congo","2024-08-24",0,0,21,141,0,21,1,150
"Congo","2024-08-25",0,0,21,141,0,21,0,150
"Congo","2024-08-26",0,0,21,141,0,21,1,151
"Congo","2024-08-27",0,0,21,141,0,21,0,151
"Congo","2024-08-28",0,0,21,141,0,21,1,152
"Congo","2024-08-29",0,0,21,141,0,21,1,153
"Congo","2024-08-30",0,0,21,141,0,21,0,153
"Congo","2024-08-31",0,0,21,141,0,21,1,154
"Congo","2024-09-01",0,0,21,141,0,21,0,154
"Congo","2024-09-02",0,0,21,141,0,21,1,155
"Congo","2024-09-03",0,0,21,141,0,21,0,155
"Congo","2024-09-04",0,0,21,141,0,21,1,156
"Congo","2024-09-05",0,0,21,141,1,22,1,157
"Congo","2024-09-06",0,0,21,141,0,22,0,157
"Congo","2024-09-07",0,0,21,141,0,22,1,158
"Congo","2024-09-08",0,0,21,141,0,22,0,158
"Congo","2024-09-09",0,0,21,141,0,22,1,159
"Congo","2024-09-10",0,0,21,141,0,22,1,160
"Congo","2024-09-11",0,0,21,141,0,22,0,160
"Congo","2024-09-12",0,0,21,141,0,22,1,161
"Congo","2024-09-13",0,0,21,141,0,22,0,161
"Congo","2024-09-14",0,0,21,141,0,22,1,162
"Congo","2024-09-15",0,0,21,141,0,22,0,162
"Congo","2024-09-16",22,0,21,163,0,22,1,163
"Congo","2024-09-17",0,0,21,163,0,22,1,164
"Congo","2024-09-18",0,0,21,163,0,22,1,165
"Congo","2024-09-19",0,0,21,163,0,22,1,166
"Congo","2024-09-20",0,0,21,163,0,22,1,167
"Congo","2024-09-21",0,0,21,163,0,22,1,168
"Congo","2024-09-22",0,0,21,163,0,22,1,169
"Congo","2024-09-23",0,0,21,163,0,22,1,170
"Congo","2024-09-24",0,0,21,163,0,22,1,171
"Congo","2024-09-25",0,0,21,163,0,22,1,172
"Congo","2024-09-26",0,0,21,163,0,22,1,173
"Congo","2024-09-27",0,0,21,163,0,22,1,174
"Congo","2024-09-28",0,0,21,163,0,22,1,175
"Congo","2024-09-29",0,1,22,163,0,22,1,176
"Congo","2024-09-30",14,0,22,177,0,22,1,177
"Congo","2024-10-01",0,0,22,177,0,22,2,179
"Congo","2024-10-02",0,0,22,177,0,22,1,180
"Congo","2024-10-03",0,0,22,177,0,22,1,181
"Congo","2024-10-04",0,0,22,177,0,22,2,183
"Congo","2024-10-05",0,0,22,177,0,22,2,185
"Congo","2024-10-06",0,0,22,177,0,22,1,186
"Congo","2024-10-07",0,0,22,177,0,22,1,187
"Congo","2024-10-08",0,0,22,177,0,22,2,189
"Congo","2024-10-09",0,0,22,177,0,22,2,191
"Congo","2024-10-10",0,0,22,177,0,22,1,192
"Congo","2024-10-11",0,0,22,177,0,22,1,193
"Congo","2024-10-12",0,0,22,177,0,22,2,195
"Congo","2024-10-13",0,0,22,177,0,22,2,197
"Congo","2024-10-14",0,0,22,177,0,22,1,198
"Congo","2024-10-15",0,0,22,177,0,22,1,199
"Congo","2024-10-16",0,0,22,177,0,22,2,201
"Congo","2024-10-17",0,0,22,177,0,22,2,203
"Congo","2024-10-18",0,0,22,177,0,22,1,204
"Congo","2024-10-19",0,0,22,177,0,22,1,205
"Congo","2024-10-20",30,0,22,207,0,22,2,207
"Congo","2024-10-21",0,0,22,207,0,22,1,208
"Congo","2024-10-22",0,0,22,207,0,22,1,209
"Congo","2024-10-23",0,0,22,207,0,22,1,210
"Congo","2024-10-24",0,0,22,207,0,22,1,211
"Congo","2024-10-25",0,0,22,207,0,22,1,212
"Congo","2024-10-26",0,0,22,207,0,22,1,213
"Congo","2024-10-27",7,0,22,214,0,22,1,214
"Congo","2024-10-28",0,0,22,214,0,22,1,215
"Congo","2024-10-29",0,0,22,214,0,22,0,215
"Congo","2024-10-30",0,0,22,214,0,22,1,216
"Congo","2024-10-31",0,0,22,214,0,22,1,217
"Congo","2024-11-01",0,0,22,214,0,22,1,218
"Congo","2024-11-02",0,0,22,214,0,22,0,218
"Congo","2024-11-03",5,0,22,219,0,22,1,219
"Congo","2024-11-04",0,0,22,219,0,22,0,219
"Congo","2024-11-05",0,0,22,219,0,22,0,219
"Congo","2024-11-06",0,0,22,219,0,22,0,219
"Congo","2024-11-07",0,0,22,219,0,22,0,219
"Congo","2024-11-08",0,0,22,219,0,22,0,219
"Congo","2024-11-09",0,0,22,219,0,22,0,219
"Congo","2024-11-10",0,0,22,219,0,22,0,219
"Congo","2024-11-11",0,0,22,219,0,22,0,219
"Congo","2024-11-12",0,0,22,219,0,22,0,219
"Congo","2024-11-13",0,0,22,219,0,22,0,219
"Congo","2024-11-14",0,0,22,219,0,22,0,219
"Congo","2024-11-15",0,0,22,219,0,22,0,219
"Congo","2024-11-16",0,0,22,219,0,22,0,219
"Congo","2024-11-17",0,0,22,219,0,22,0,219
"Congo","2024-11-18",0,0,22,219,0,22,0,219
"Congo","2024-11-19",0,0,22,219,0,22,0,219
"Congo","2024-11-20",0,0,22,219,0,22,0,219
"Congo","2024-11-21",0,0,22,219,0,22,0,219
"Congo","2024-11-22",0,0,22,219,0,22,0,219
"Congo","2024-11-23",0,0,22,219,0,22,0,219
"Congo","2024-11-24",0,0,22,219,0,22,0,219
"Congo","2024-11-25",0,0,22,219,0,22,0,219
"Congo","2024-11-26",0,0,22,219,0,22,0,219
"Congo","2024-11-27",0,0,22,219,0,22,0,219
"Congo","2024-11-28",0,0,22,219,0,22,0,219
"Congo","2024-11-29",0,0,22,219,0,22,0,219
"Congo","2024-11-30",0,0,22,219,0,22,0,219
"Congo","2024-12-01",0,0,22,219,0,22,0,219
"Congo","2024-12-02",0,0,22,219,0,22,0,219
"Congo","2024-12-03",0,0,22,219,0,22,0,219
"Congo","2024-12-04",0,0,22,219,0,22,0,219
"Congo","2024-12-05",0,0,22,219,0,22,0,219
"Congo","2024-12-06",0,0,22,219,0,22,0,219
"Congo","2024-12-07",0,0,22,219,0,22,0,219
"Congo","2024-12-08",0,0,22,219,0,22,0,219
"Congo","2024-12-09",0,0,22,219,0,22,0,219
"Costa Rica","2024-01-01",0,0,0,0,0,0,0,0
"Costa Rica","2024-01-02",0,0,0,0,0,0,0,0
"Costa Rica","2024-01-03",0,0,0,0,0,0,0,0
"Costa Rica","2024-01-04",0,0,0,0,0,0,0,0
"Costa Rica","2024-01-05",0,0,0,0,0,0,0,0
"Costa Rica","2024-01-06",0,0,0,0,0,0,0,0
"Costa Rica","2024-01-07",0,0,0,0,0,0,0,0
"Costa Rica","2024-01-08",0,0,0,0,0,0,0,0
"Costa Rica","2024-01-09",0,0,0,0,0,0,0,0
"Costa Rica","2024-01-10",0,0,0,0,0,0,0,0
"Costa Rica","2024-01-11",0,0,0,0,0,0,0,0
"Costa Rica","2024-01-12",0,0,0,0,0,0,0,0
"Costa Rica","2024-01-13",0,0,0,0,0,0,0,0
"Costa Rica","2024-01-14",0,0,0,0,0,0,0,0
"Costa Rica","2024-01-15",0,0,0,0,0,0,0,0
"Costa Rica","2024-01-16",0,0,0,0,0,0,0,0
"Costa Rica","2024-01-17",0,0,0,0,0,0,0,0
"Costa Rica","2024-01-18",0,0,0,0,0,0,0,0
"Costa Rica","2024-01-19",0,0,0,0,0,0,0,0
"Costa Rica","2024-01-20",0,0,0,0,0,0,0,0
"Costa Rica","2024-01-21",0,0,0,0,0,0,0,0
"Costa Rica","2024-01-22",0,0,0,0,0,0,0,0
"Costa Rica","2024-01-23",0,0,0,0,0,0,0,0
"Costa Rica","2024-01-24",0,0,0,0,0,0,0,0
"Costa Rica","2024-01-25",0,0,0,0,0,0,0,0
"Costa Rica","2024-01-26",0,0,0,0,0,0,0,0
"Costa Rica","2024-01-27",0,0,0,0,0,0,0,0
"Costa Rica","2024-01-28",0,0,0,0,0,0,0,0
"Costa Rica","2024-01-29",0,0,0,0,0,0,0,0
"Costa Rica","2024-01-30",0,0,0,0,0,0,0,0
"Costa Rica","2024-01-31",0,0,0,0,0,0,0,0
"Costa Rica","2024-02-01",0,0,0,0,0,0,0,0
"Costa Rica","2024-02-02",0,0,0,0,0,0,0,0
"Costa Rica","2024-02-03",0,0,0,0,0,0,0,0
"Costa Rica","2024-02-04",0,0,0,0,0,0,0,0
"Costa Rica","2024-02-05",0,0,0,0,0,0,0,0
"Costa Rica","2024-02-06",0,0,0,0,0,0,0,0
"Costa Rica","2024-02-07",0,0,0,0,0,0,0,0
"Costa Rica","2024-02-08",0,0,0,0,0,0,0,0
"Costa Rica","2024-02-09",0,0,0,0,0,0,0,0
"Costa Rica","2024-02-10",0,0,0,0,0,0,0,0
"Costa Rica","2024-02-11",0,0,0,0,0,0,0,0
"Costa Rica","2024-02-12",0,0,0,0,0,0,0,0
"Costa Rica","2024-02-13",0,0,0,0,0,0,0,0
"Costa Rica","2024-02-14",0,0,0,0,0,0,0,0
"Costa Rica","2024-02-15",0,0,0,0,0,0,0,0
"Costa Rica","2024-02-16",0,0,0,0,0,0,0,0
"Costa Rica","2024-02-17",0,0,0,0,0,0,0,0
"Costa Rica","2024-02-18",0,0,0,0,0,0,0,0
"Costa Rica","2024-02-19",0,0,0,0,0,0,0,0
"Costa Rica","2024-02-20",0,0,0,0,0,0,0,0
"Costa Rica","2024-02-21",0,0,0,0,0,0,0,0
"Costa Rica","2024-02-22",0,0,0,0,0,0,0,0
"Costa Rica","2024-02-23",0,0,0,0,0,0,0,0
"Costa Rica","2024-02-24",0,0,0,0,0,0,0,0
"Costa Rica","2024-02-25",0,0,0,0,0,0,0,0
"Costa Rica","2024-02-26",0,0,0,0,0,0,0,0
"Costa Rica","2024-02-27",0,0,0,0,0,0,0,0
"Costa Rica","2024-02-28",0,0,0,0,0,0,0,0
"Costa Rica","2024-02-29",0,0,0,0,0,0,0,0
"Costa Rica","2024-03-01",0,0,0,0,0,0,0,0
"Costa Rica","2024-03-02",0,0,0,0,0,0,0,0
"Costa Rica","2024-03-03",0,0,0,0,0,0,0,0
"Costa Rica","2024-03-04",0,0,0,0,0,0,0,0
"Costa Rica","2024-03-05",0,1,1,0,1,1,0,0
"Costa Rica","2024-03-06",0,0,1,0,0,1,0,0
"Costa Rica","2024-03-07",0,0,1,0,0,1,0,0
"Costa Rica","2024-03-08",0,0,1,0,0,1,0,0
"Costa Rica","2024-03-09",0,0,1,0,0,1,0,0
"Costa Rica","2024-03-10",0,0,1,0,0,1,0,0
"Costa Rica","2024-03-11",0,0,1,0,0,1,0,0
"Costa Rica","2024-03-12",0,0,1,0,0,1,0,0
"Costa Rica","2024-03-13",0,0,1,0,0,1,0,0
"Costa Rica","2024-03-14",0,0,1,0,0,1,0,0
"Costa Rica","2024-03-15",0,0,1,0,0,1,0,0
"Costa Rica","2024-03-16",0,0,1,0,0,1,0,0
"Costa Rica","2024-03-17",0,0,1,0,0,1,0,0
"Costa Rica","2024-03-18",0,0,1,0,0,1,0,0
"Costa Rica","2024-03-19",0,0,1,0,0,1,0,0
"Costa Rica","2024-03-20",0,0,1,0,0,1,0,0
"Costa Rica","2024-03-21",0,0,1,0,0,1,0,0
"Costa Rica","2024-03-22",0,0,1,0,0,1,0,0
"Costa Rica","2024-03-23",0,0,1,0,0,1,0,0
"Costa Rica","2024-03-24",0,0,1,0,0,1,0,0
"Costa Rica","2024-03-25",0,0,1,0,0,1,0,0
"Costa Rica","2024-03-26",0,0,1,0,0,1,0,0
"Costa Rica","2024-03-27",0,0,1,0,0,1,0,0
"Costa Rica","2024-03-28",0,0,1,0,0,1,0,0
"Costa Rica","2024-03-29",0,0,1,0,0,1,0,0
"Costa Rica","2024-03-30",0,0,1,0,0,1,0,0
"Costa Rica","2024-03-31",0,0,1,0,0,1,0,0
"Costa Rica","2024-04-01",0,0,1,0,0,1,0,0
"Costa Rica","2024-04-02",0,0,1,0,0,1,0,0
"Costa Rica","2024-04-03",0,0,1,0,0,1,0,0
"Costa Rica","2024-04-04",0,0,1,0,0,1,0,0
"Costa Rica","2024-04-05",0,0,1,0,0,1,0,0
"Costa Rica","2024-04-06",0,0,1,0,0,1,0,0
"Costa Rica","2024-04-07",0,0,1,0,0,1,0,0
"Costa Rica","2024-04-08",0,0,1,0,0,1,0,0
"Costa Rica","2024-04-09",0,0,1,0,0,1,0,0
"Costa Rica","2024-04-10",0,0,1,0,0,1,0,0
"Costa Rica","2024-04-11",0,0,1,0,0,1,0,0
"Costa Rica","2024-04-12",0,0,1,0,0,1,0,0
"Costa Rica","2024-04-13",0,0,1,0,0,1,0,0
"Costa Rica","2024-04-14",0,0,1,0,0,1,0,0
"Costa Rica","2024-04-15",0,0,1,0,0,1,0,0
"Costa Rica","2024-04-16",0,0,1,0,0,1,0,0
"Costa Rica","2024-04-17",0,0,1,0,0,1,0,0
"Costa Rica","2024-04-18",0,0,1,0,0,1,0,0
"Costa Rica","2024-04-19",0,0,1,0,0,1,0,0
"Costa Rica","2024-04-20",0,0,1,0,0,1,0,0
"Costa Rica","2024-04-21",0,0,1,0,0,1,0,0
"Costa Rica","2024-04-22",0,0,1,0,0,1,0,0
"Costa Rica","2024-04-23",0,0,1,0,0,1,0,0
"Costa Rica","2024-04-24",0,0,1,0,0,1,0,0
"Costa Rica","2024-04-25",0,0,1,0,0,1,0,0
"Costa Rica","2024-04-26",0,0,1,0,0,1,0,0
"Costa Rica","2024-04-27",0,0,1,0,0,1,0,0
"Costa Rica","2024-04-28",0,0,1,0,0,1,0,0
"Costa Rica","2024-04-29",0,0,1,0,0,1,0,0
"Costa Rica","2024-04-30",0,0,1,0,0,1,0,0
"Costa Rica","2024-05-01",0,0,1,0,0,1,0,0
"Costa Rica","2024-05-02",0,0,1,0,0,1,0,0
"Costa Rica","2024-05-03",0,0,1,0,0,1,0,0
"Costa Rica","2024-05-04",0,0,1,0,0,1,0,0
"Costa Rica","2024-05-05",0,0,1,0,0,1,0,0
"Costa Rica","2024-05-06",0,0,1,0,0,1,0,0
"Costa Rica","2024-05-07",0,0,1,0,0,1,0,0
"Costa Rica","2024-05-08",0,0,1,0,0,1,0,0
"Costa Rica","2024-05-09",0,0,1,0,0,1,0,0
"Costa Rica","2024-05-10",0,0,1,0,0,1,0,0
"Costa Rica","2024-05-11",0,0,1,0,0,1,0,0
"Costa Rica","2024-05-12",0,0,1,0,0,1,0,0
"Costa Rica","2024-05-13",0,0,1,0,0,1,0,0
"Costa Rica","2024-05-14",0,0,1,0,0,1,0,0
"Costa Rica","2024-05-15",0,0,1,0,0,1,0,0
"Costa Rica","2024-05-16",0,0,1,0,0,1,0,0
"Costa Rica","2024-05-17",0,0,1,0,0,1,0,0
"Costa Rica","2024-05-18",0,0,1,0,0,1,0,0
"Costa Rica","2024-05-19",0,0,1,0,0,1,0,0
"Costa Rica","2024-05-20",0,0,1,0,0,1,0,0
"Costa Rica","2024-05-21",0,0,1,0,0,1,0,0
"Costa Rica","2024-05-22",0,0,1,0,0,1,0,0
"Costa Rica","2024-05-23",0,0,1,0,0,1,0,0
"Costa Rica","2024-05-24",0,0,1,0,0,1,0,0
"Costa Rica","2024-05-25",0,0,1,0,0,1,0,0
"Costa Rica","2024-05-26",0,0,1,0,0,1,0,0
"Costa Rica","2024-05-27",0,0,1,0,0,1,0,0
"Costa Rica","2024-05-28",0,0,1,0,0,1,0,0
"Costa Rica","2024-05-29",0,0,1,0,0,1,0,0
"Costa Rica","2024-05-30",0,0,1,0,0,1,0,0
"Costa Rica","2024-05-31",0,0,1,0,0,1,0,0
"Costa Rica","2024-06-01",0,0,1,0,0,1,0,0
"Costa Rica","2024-06-02",0,0,1,0,0,1,0,0
"Costa Rica","2024-06-03",0,0,1,0,0,1,0,0
"Costa Rica","2024-06-04",0,0,1,0,0,1,0,0
"Costa Rica","2024-06-05",0,0,1,0,0,1,0,0
"Costa Rica","2024-06-06",0,0,1,0,0,1,0,0
"Costa Rica","2024-06-07",0,0,1,0,0,1,0,0
"Costa Rica","2024-06-08",0,0,1,0,0,1,0,0
"Costa Rica","2024-06-09",0,0,1,0,0,1,0,0
"Costa Rica","2024-06-10",0,0,1,0,0,1,0,0
"Costa Rica","2024-06-11",0,0,1,0,0,1,0,0
"Costa Rica","2024-06-12",0,0,1,0,0,1,0,0
"Costa Rica","2024-06-13",0,0,1,0,0,1,0,0
"Costa Rica","2024-06-14",0,0,1,0,0,1,0,0
"Costa Rica","2024-06-15",0,0,1,0,0,1,0,0
"Costa Rica","2024-06-16",0,0,1,0,0,1,0,0
"Costa Rica","2024-06-17",0,0,1,0,0,1,0,0
"Costa Rica","2024-06-18",0,0,1,0,0,1,0,0
"Costa Rica","2024-06-19",0,0,1,0,0,1,0,0
"Costa Rica","2024-06-20",0,0,1,0,0,1,0,0
"Costa Rica","2024-06-21",0,0,1,0,0,1,0,0
"Costa Rica","2024-06-22",0,0,1,0,0,1,0,0
"Costa Rica","2024-06-23",0,0,1,0,0,1,0,0
"Costa Rica","2024-06-24",0,0,1,0,0,1,0,0
"Costa Rica","2024-06-25",0,0,1,0,0,1,0,0
"Costa Rica","2024-06-26",0,0,1,0,0,1,0,0
"Costa Rica","2024-06-27",0,0,1,0,0,1,0,0
"Costa Rica","2024-06-28",0,0,1,0,0,1,0,0
"Costa Rica","2024-06-29",0,0,1,0,0,1,0,0
"Costa Rica","2024-06-30",0,0,1,0,0,1,0,0
"Costa Rica","2024-07-01",0,0,1,0,0,1,0,0
"Costa Rica","2024-07-02",0,0,1,0,0,1,0,0
"Costa Rica","2024-07-03",0,0,1,0,0,1,0,0
"Costa Rica","2024-07-04",0,0,1,0,0,1,0,0
"Costa Rica","2024-07-05",0,0,1,0,0,1,0,0
"Costa Rica","2024-07-06",0,0,1,0,0,1,0,0
"Costa Rica","2024-07-07",0,0,1,0,0,1,0,0
"Costa Rica","2024-07-08",0,0,1,0,0,1,0,0
"Costa Rica","2024-07-09",0,0,1,0,0,1,0,0
"Costa Rica","2024-07-10",0,0,1,0,0,1,0,0
"Costa Rica","2024-07-11",0,0,1,0,0,1,0,0
"Costa Rica","2024-07-12",0,0,1,0,0,1,0,0
"Costa Rica","2024-07-13",0,0,1,0,0,1,0,0
"Costa Rica","2024-07-14",0,0,1,0,0,1,0,0
"Costa Rica","2024-07-15",0,0,1,0,0,1,0,0
"Costa Rica","2024-07-16",0,0,1,0,0,1,0,0
"Costa Rica","2024-07-17",0,0,1,0,0,1,0,0
"Costa Rica","2024-07-18",0,0,1,0,0,1,0,0
"Costa Rica","2024-07-19",0,0,1,0,0,1,0,0
"Costa Rica","2024-07-20",0,0,1,0,0,1,0,0
"Costa Rica","2024-07-21",0,0,1,0,0,1,0,0
"Costa Rica","2024-07-22",0,0,1,0,0,1,0,0
"Costa Rica","2024-07-23",0,0,1,0,0,1,0,0
"Costa Rica","2024-07-24",0,0,1,0,0,1,0,0
"Costa Rica","2024-07-25",0,0,1,0,0,1,0,0
"Costa Rica","2024-07-26",0,0,1,0,0,1,0,0
"Costa Rica","2024-07-27",0,0,1,0,0,1,0,0
"Costa Rica","2024-07-28",0,0,1,0,0,1,0,0
"Costa Rica","2024-07-29",0,0,1,0,0,1,0,0
"Costa Rica","2024-07-30",0,0,1,0,0,1,0,0
"Costa Rica","2024-07-31",0,0,1,0,0,1,0,0
"Costa Rica","2024-08-01",0,0,1,0,0,1,0,0
"Costa Rica","2024-08-02",0,0,1,0,0,1,0,0
"Costa Rica","2024-08-03",0,0,1,0,0,1,0,0
"Costa Rica","2024-08-04",0,0,1,0,0,1,0,0
"Costa Rica","2024-08-05",0,0,1,0,0,1,0,0
"Costa Rica","2024-08-06",0,0,1,0,0,1,0,0
"Costa Rica","2024-08-07",0,0,1,0,0,1,0,0
"Costa Rica","2024-08-08",0,0,1,0,0,1,0,0
"Costa Rica","2024-08-09",0,0,1,0,0,1,0,0
"Costa Rica","2024-08-10",0,0,1,0,0,1,0,0
"Costa Rica","2024-08-11",0,0,1,0,0,1,0,0
"Costa Rica","2024-08-12",0,0,1,0,0,1,0,0
"Costa Rica","2024-08-13",0,0,1,0,0,1,0,0
"Costa Rica","2024-08-14",0,0,1,0,0,1,0,0
"Costa Rica","2024-08-15",0,0,1,0,0,1,0,0
"Costa Rica","2024-08-16",0,0,1,0,0,1,0,0
"Costa Rica","2024-08-17",0,0,1,0,0,1,0,0
"Costa Rica","2024-08-18",0,0,1,0,0,1,0,0
"Costa Rica","2024-08-19",0,0,1,0,0,1,0,0
"Costa Rica","2024-08-20",0,0,1,0,0,1,0,0
"Costa Rica","2024-08-21",0,0,1,0,0,1,0,0
"Costa Rica","2024-08-22",0,0,1,0,0,1,0,0
"Costa Rica","2024-08-23",0,0,1,0,0,1,0,0
"Costa Rica","2024-08-24",0,0,1,0,0,1,0,0
"Costa Rica","2024-08-25",0,0,1,0,0,1,0,0
"Costa Rica","2024-08-26",0,0,1,0,0,1,0,0
"Costa Rica","2024-08-27",0,0,1,0,0,1,0,0
"Costa Rica","2024-08-28",0,0,1,0,0,1,0,0
"Costa Rica","2024-08-29",0,0,1,0,0,1,0,0
"Costa Rica","2024-08-30",0,0,1,0,0,1,0,0
"Costa Rica","2024-08-31",0,0,1,0,0,1,0,0
"Costa Rica","2024-09-01",0,0,1,0,0,1,0,0
"Costa Rica","2024-09-02",0,0,1,0,0,1,0,0
"Costa Rica","2024-09-03",0,0,1,0,0,1,0,0
"Costa Rica","2024-09-04",0,0,1,0,0,1,0,0
"Costa Rica","2024-09-05",0,0,1,0,0,1,0,0
"Costa Rica","2024-09-06",0,0,1,0,0,1,0,0
"Costa Rica","2024-09-07",0,0,1,0,0,1,0,0
"Costa Rica","2024-09-08",0,0,1,0,0,1,0,0
"Costa Rica","2024-09-09",0,0,1,0,0,1,0,0
"Costa Rica","2024-09-10",0,0,1,0,0,1,0,0
"Costa Rica","2024-09-11",0,0,1,0,0,1,0,0
"Costa Rica","2024-09-12",0,0,1,0,0,1,0,0
"Costa Rica","2024-09-13",0,0,1,0,0,1,0,0
"Costa Rica","2024-09-14",0,0,1,0,0,1,0,0
"Costa Rica","2024-09-15",0,0,1,0,0,1,0,0
"Costa Rica","2024-09-16",0,0,1,0,0,1,0,0
"Costa Rica","2024-09-17",0,0,1,0,0,1,0,0
"Costa Rica","2024-09-18",0,0,1,0,0,1,0,0
"Costa Rica","2024-09-19",0,0,1,0,0,1,0,0
"Costa Rica","2024-09-20",0,0,1,0,0,1,0,0
"Costa Rica","2024-09-21",0,0,1,0,0,1,0,0
"Costa Rica","2024-09-22",0,0,1,0,0,1,0,0
"Costa Rica","2024-09-23",0,0,1,0,0,1,0,0
"Costa Rica","2024-09-24",0,0,1,0,0,1,0,0
"Costa Rica","2024-09-25",0,0,1,0,0,1,0,0
"Costa Rica","2024-09-26",0,0,1,0,0,1,0,0
"Costa Rica","2024-09-27",0,0,1,0,0,1,0,0
"Costa Rica","2024-09-28",0,0,1,0,0,1,0,0
"Costa Rica","2024-09-29",0,0,1,0,0,1,0,0
"Costa Rica","2024-09-30",0,0,1,0,0,1,0,0
"Costa Rica","2024-10-01",0,0,1,0,0,1,0,0
"Costa Rica","2024-10-02",0,0,1,0,0,1,0,0
"Costa Rica","2024-10-03",0,0,1,0,0,1,0,0
"Costa Rica","2024-10-04",0,0,1,0,0,1,0,0
"Costa Rica","2024-10-05",0,0,1,0,0,1,0,0
"Costa Rica","2024-10-06",0,0,1,0,0,1,0,0
"Costa Rica","2024-10-07",0,0,1,0,0,1,0,0
"Costa Rica","2024-10-08",0,0,1,0,0,1,0,0
"Costa Rica","2024-10-09",0,0,1,0,0,1,0,0
"Costa Rica","2024-10-10",0,0,1,0,0,1,0,0
"Costa Rica","2024-10-11",0,0,1,0,0,1,0,0
"Costa Rica","2024-10-12",0,0,1,0,0,1,0,0
"Costa Rica","2024-10-13",0,0,1,0,0,1,0,0
"Costa Rica","2024-10-14",0,0,1,0,0,1,0,0
"Costa Rica","2024-10-15",0,0,1,0,0,1,0,0
"Costa Rica","2024-10-16",0,0,1,0,0,1,0,0
"Costa Rica","2024-10-17",0,0,1,0,0,1,0,0
"Costa Rica","2024-10-18",0,0,1,0,0,1,0,0
"Costa Rica","2024-10-19",0,0,1,0,0,1,0,0
"Costa Rica","2024-10-20",0,0,1,0,0,1,0,0
"Costa Rica","2024-10-21",0,0,1,0,0,1,0,0
"Costa Rica","2024-10-22",0,0,1,0,0,1,0,0
"Costa Rica","2024-10-23",0,0,1,0,0,1,0,0
"Costa Rica","2024-10-24",0,0,1,0,0,1,0,0
"Costa Rica","2024-10-25",0,0,1,0,0,1,0,0
"Costa Rica","2024-10-26",0,0,1,0,0,1,0,0
"Costa Rica","2024-10-27",0,0,1,0,0,1,0,0
"Costa Rica","2024-10-28",0,0,1,0,0,1,0,0
"Costa Rica","2024-10-29",0,0,1,0,0,1,0,0
"Costa Rica","2024-10-30",0,0,1,0,0,1,0,0
"Costa Rica","2024-10-31",0,0,1,0,0,1,0,0
"Costa Rica","2024-11-01",0,0,1,0,0,1,0,0
"Costa Rica","2024-11-02",0,0,1,0,0,1,0,0
"Costa Rica","2024-11-03",0,0,1,0,0,1,0,0
"Costa Rica","2024-11-04",0,0,1,0,0,1,0,0
"Costa Rica","2024-11-05",0,0,1,0,0,1,0,0
"Costa Rica","2024-11-06",0,0,1,0,0,1,0,0
"Costa Rica","2024-11-07",0,0,1,0,0,1,0,0
"Costa Rica","2024-11-08",0,0,1,0,0,1,0,0
"Costa Rica","2024-11-09",0,0,1,0,0,1,0,0
"Costa Rica","2024-11-10",0,0,1,0,0,1,0,0
"Costa Rica","2024-11-11",0,0,1,0,0,1,0,0
"Costa Rica","2024-11-12",0,0,1,0,0,1,0,0
"Costa Rica","2024-11-13",0,0,1,0,0,1,0,0
"Costa Rica","2024-11-14",0,0,1,0,0,1,0,0
"Costa Rica","2024-11-15",0,0,1,0,0,1,0,0
"Costa Rica","2024-11-16",0,0,1,0,0,1,0,0
"Costa Rica","2024-11-17",0,0,1,0,0,1,0,0
"Costa Rica","2024-11-18",0,0,1,0,0,1,0,0
"Costa Rica","2024-11-19",0,0,1,0,0,1,0,0
"Costa Rica","2024-11-20",0,0,1,0,0,1,0,0
"Costa Rica","2024-11-21",0,0,1,0,0,1,0,0
"Costa Rica","2024-11-22",0,0,1,0,0,1,0,0
"Costa Rica","2024-11-23",0,0,1,0,0,1,0,0
"Costa Rica","2024-11-24",0,0,1,0,0,1,0,0
"Costa Rica","2024-11-25",0,0,1,0,0,1,0,0
"Costa Rica","2024-11-26",0,0,1,0,0,1,0,0
"Costa Rica","2024-11-27",0,0,1,0,0,1,0,0
"Costa Rica","2024-11-28",0,0,1,0,0,1,0,0
"Costa Rica","2024-11-29",0,0,1,0,0,1,0,0
"Costa Rica","2024-11-30",0,0,1,0,0,1,0,0
"Costa Rica","2024-12-01",0,0,1,0,0,1,0,0
"Costa Rica","2024-12-02",0,0,1,0,0,1,0,0
"Costa Rica","2024-12-03",0,0,1,0,0,1,0,0
"Costa Rica","2024-12-04",0,0,1,0,0,1,0,0
"Costa Rica","2024-12-05",0,0,1,0,0,1,0,0
"Costa Rica","2024-12-06",0,0,1,0,0,1,0,0
"Costa Rica","2024-12-07",0,0,1,0,0,1,0,0
"Costa Rica","2024-12-08",0,0,1,0,0,1,0,0
"Costa Rica","2024-12-09",0,0,1,0,0,1,0,0
"Côte d’Ivoire","2024-01-01",0,0,0,0,0,0,0,0
"Côte d’Ivoire","2024-01-02",0,0,0,0,0,0,0,0
"Côte d’Ivoire","2024-01-03",0,0,0,0,0,0,0,0
"Côte d’Ivoire","2024-01-04",0,0,0,0,0,0,0,0
"Côte d’Ivoire","2024-01-05",0,0,0,0,0,0,0,0
"Côte d’Ivoire","2024-01-06",0,0,0,0,0,0,0,0
"Côte d’Ivoire","2024-01-07",0,0,0,0,0,0,0,0
"Côte d’Ivoire","2024-01-08",0,0,0,0,0,0,0,0
"Côte d’Ivoire","2024-01-09",0,0,0,0,0,0,0,0
"Côte d’Ivoire","2024-01-10",0,0,0,0,0,0,0,0
"Côte d’Ivoire","2024-01-11",0,0,0,0,0,0,0,0
"Côte d’Ivoire","2024-01-12",0,0,0,0,0,0,0,0
"Côte d’Ivoire","2024-01-13",0,0,0,0,0,0,0,0
"Côte d’Ivoire","2024-01-14",0,0,0,0,0,0,0,0
"Côte d’Ivoire","2024-01-15",0,0,0,0,0,0,0,0
"Côte d’Ivoire","2024-01-16",0,0,0,0,0,0,0,0
"Côte d’Ivoire","2024-01-17",0,0,0,0,0,0,0,0
"Côte d’Ivoire","2024-01-18",0,0,0,0,0,0,0,0
"Côte d’Ivoire","2024-01-19",0,0,0,0,0,0,0,0
"Côte d’Ivoire","2024-01-20",0,0,0,0,0,0,0,0
"Côte d’Ivoire","2024-01-21",0,0,0,0,0,0,0,0
"Côte d’Ivoire","2024-01-22",0,0,0,0,0,0,0,0
"Côte d’Ivoire","2024-01-23",0,0,0,0,0,0,0,0
"Côte d’Ivoire","2024-01-24",0,0,0,0,0,0,0,0
"Côte d’Ivoire","2024-01-25",0,0,0,0,0,0,0,0
"Côte d’Ivoire","2024-01-26",0,0,0,0,0,0,0,0
"Côte d’Ivoire","2024-01-27",0,0,0,0,0,0,0,0
"Côte d’Ivoire","2024-01-28",0,0,0,0,0,0,0,0
"Côte d’Ivoire","2024-01-29",0,0,0,0,0,0,0,0
"Côte d’Ivoire","2024-01-30",0,0,0,0,0,0,0,0
"Côte d’Ivoire","2024-01-31",0,0,0,0,0,0,0,0
"Côte d’Ivoire","2024-02-01",0,0,0,0,0,0,0,0
"Côte d’Ivoire","2024-02-02",0,0,0,0,0,0,0,0
"Côte d’Ivoire","2024-02-03",0,0,0,0,0,0,0,0
"Côte d’Ivoire","2024-02-04",0,0,0,0,0,0,0,0
"Côte d’Ivoire","2024-02-05",0,0,0,0,0,0,0,0
"Côte d’Ivoire","2024-02-06",0,0,0,0,0,0,0,0
"Côte d’Ivoire","2024-02-07",0,0,0,0,0,0,0,0
"Côte d’Ivoire","2024-02-08",0,0,0,0,0,0,0,0
"Côte d’Ivoire","2024-02-09",0,0,0,0,0,0,0,0
"Côte d’Ivoire","2024-02-10",0,0,0,0,0,0,0,0
"Côte d’Ivoire","2024-02-11",0,0,0,0,0,0,0,0
"Côte d’Ivoire","2024-02-12",0,0,0,0,0,0,0,0
"Côte d’Ivoire","2024-02-13",0,0,0,0,0,0,0,0
"Côte d’Ivoire","2024-02-14",0,0,0,0,0,0,0,0
"Côte d’Ivoire","2024-02-15",0,0,0,0,0,0,0,0
"Côte d’Ivoire","2024-02-16",0,0,0,0,0,0,0,0
"Côte d’Ivoire","2024-02-17",0,0,0,0,0,0,0,0
"Côte d’Ivoire","2024-02-18",0,0,0,0,0,0,0,0
"Côte d’Ivoire","2024-02-19",0,0,0,0,0,0,0,0
"Côte d’Ivoire","2024-02-20",0,0,0,0,0,0,0,0
"Côte d’Ivoire","2024-02-21",0,0,0,0,0,0,0,0
"Côte d’Ivoire","2024-02-22",0,0,0,0,0,0,0,0
"Côte d’Ivoire","2024-02-23",0,0,0,0,0,0,0,0
"Côte d’Ivoire","2024-02-24",0,0,0,0,0,0,0,0
"Côte d’Ivoire","2024-02-25",0,0,0,0,0,0,0,0
"Côte d’Ivoire","2024-02-26",0,0,0,0,0,0,0,0
"Côte d’Ivoire","2024-02-27",0,0,0,0,0,0,0,0
"Côte d’Ivoire","2024-02-28",0,0,0,0,0,0,0,0
"Côte d’Ivoire","2024-02-29",0,0,0,0,0,0,0,0
"Côte d’Ivoire","2024-03-01",0,0,0,0,0,0,0,0
"Côte d’Ivoire","2024-03-02",0,0,0,0,0,0,0,0
"Côte d’Ivoire","2024-03-03",0,0,0,0,0,0,0,0
"Côte d’Ivoire","2024-03-04",0,0,0,0,0,0,0,0
"Côte d’Ivoire","2024-03-05",0,0,0,0,0,0,0,0
"Côte d’Ivoire","2024-03-06",0,0,0,0,0,0,0,0
"Côte d’Ivoire","2024-03-07",0,0,0,0,0,0,0,0
"Côte d’Ivoire","2024-03-08",0,0,0,0,0,0,0,0
"Côte d’Ivoire","2024-03-09",0,0,0,0,0,0,0,0
"Côte d’Ivoire","2024-03-10",0,0,0,0,0,0,0,0
"Côte d’Ivoire","2024-03-11",0,0,0,0,0,0,0,0
"Côte d’Ivoire","2024-03-12",0,0,0,0,0,0,0,0
"Côte d’Ivoire","2024-03-13",0,0,0,0,0,0,0,0
"Côte d’Ivoire","2024-03-14",0,0,0,0,0,0,0,0
"Côte d’Ivoire","2024-03-15",0,0,0,0,0,0,0,0
"Côte d’Ivoire","2024-03-16",0,0,0,0,0,0,0,0
"Côte d’Ivoire","2024-03-17",0,0,0,0,0,0,0,0
"Côte d’Ivoire","2024-03-18",0,0,0,0,0,0,0,0
"Côte d’Ivoire","2024-03-19",0,0,0,0,0,0,0,0
"Côte d’Ivoire","2024-03-20",0,0,0,0,0,0,0,0
"Côte d’Ivoire","2024-03-21",0,0,0,0,0,0,0,0
"Côte d’Ivoire","2024-03-22",0,0,0,0,0,0,0,0
"Côte d’Ivoire","2024-03-23",0,0,0,0,0,0,0,0
"Côte d’Ivoire","2024-03-24",0,0,0,0,0,0,0,0
"Côte d’Ivoire","2024-03-25",0,0,0,0,0,0,0,0
"Côte d’Ivoire","2024-03-26",0,0,0,0,0,0,0,0
"Côte d’Ivoire","2024-03-27",0,0,0,0,0,0,0,0
"Côte d’Ivoire","2024-03-28",0,0,0,0,0,0,0,0
"Côte d’Ivoire","2024-03-29",0,0,0,0,0,0,0,0
"Côte d’Ivoire","2024-03-30",0,0,0,0,0,0,0,0
"Côte d’Ivoire","2024-03-31",0,0,0,0,0,0,0,0
"Côte d’Ivoire","2024-04-01",0,0,0,0,0,0,0,0
"Côte d’Ivoire","2024-04-02",0,0,0,0,0,0,0,0
"Côte d’Ivoire","2024-04-03",0,0,0,0,0,0,0,0
"Côte d’Ivoire","2024-04-04",0,0,0,0,0,0,0,0
"Côte d’Ivoire","2024-04-05",0,0,0,0,0,0,0,0
"Côte d’Ivoire","2024-04-06",0,0,0,0,0,0,0,0
"Côte d’Ivoire","2024-04-07",0,0,0,0,0,0,0,0
"Côte d’Ivoire","2024-04-08",0,0,0,0,0,0,0,0
"Côte d’Ivoire","2024-04-09",0,0,0,0,0,0,0,0
"Côte d’Ivoire","2024-04-10",0,0,0,0,0,0,0,0
"Côte d’Ivoire","2024-04-11",0,0,0,0,0,0,0,0
"Côte d’Ivoire","2024-04-12",0,0,0,0,0,0,0,0
"Côte d’Ivoire","2024-04-13",0,0,0,0,0,0,0,0
"Côte d’Ivoire","2024-04-14",0,0,0,0,0,0,0,0
"Côte d’Ivoire","2024-04-15",0,0,0,0,0,0,0,0
"Côte d’Ivoire","2024-04-16",0,0,0,0,0,0,0,0
"Côte d’Ivoire","2024-04-17",0,0,0,0,0,0,0,0
"Côte d’Ivoire","2024-04-18",0,0,0,0,0,0,0,0
"Côte d’Ivoire","2024-04-19",0,0,0,0,0,0,0,0
"Côte d’Ivoire","2024-04-20",0,0,0,0,0,0,0,0
"Côte d’Ivoire","2024-04-21",0,0,0,0,0,0,0,0
"Côte d’Ivoire","2024-04-22",0,0,0,0,0,0,0,0
"Côte d’Ivoire","2024-04-23",0,0,0,0,0,0,0,0
"Côte d’Ivoire","2024-04-24",0,0,0,0,0,0,0,0
"Côte d’Ivoire","2024-04-25",0,0,0,0,0,0,0,0
"Côte d’Ivoire","2024-04-26",0,0,0,0,0,0,0,0
"Côte d’Ivoire","2024-04-27",0,0,0,0,0,0,0,0
"Côte d’Ivoire","2024-04-28",0,0,0,0,0,0,0,0
"Côte d’Ivoire","2024-04-29",0,0,0,0,0,0,0,0
"Côte d’Ivoire","2024-04-30",0,0,0,0,0,0,0,0
"Côte d’Ivoire","2024-05-01",0,0,0,0,0,0,0,0
"Côte d’Ivoire","2024-05-02",0,0,0,0,0,0,0,0
"Côte d’Ivoire","2024-05-03",0,0,0,0,0,0,0,0
"Côte d’Ivoire","2024-05-04",0,0,0,0,0,0,0,0
"Côte d’Ivoire","2024-05-05",0,0,0,0,0,0,0,0
"Côte d’Ivoire","2024-05-06",0,0,0,0,0,0,0,0
"Côte d’Ivoire","2024-05-07",0,0,0,0,0,0,0,0
"Côte d’Ivoire","2024-05-08",0,0,0,0,0,0,0,0
"Côte d’Ivoire","2024-05-09",0,0,0,0,0,0,0,0
"Côte d’Ivoire","2024-05-10",0,0,0,0,0,0,0,0
"Côte d’Ivoire","2024-05-11",0,0,0,0,0,0,0,0
"Côte d’Ivoire","2024-05-12",0,0,0,0,0,0,0,0
"Côte d’Ivoire","2024-05-13",0,0,0,0,0,0,0,0
"Côte d’Ivoire","2024-05-14",0,0,0,0,0,0,0,0
"Côte d’Ivoire","2024-05-15",0,0,0,0,0,0,0,0
"Côte d’Ivoire","2024-05-16",0,0,0,0,0,0,0,0
"Côte d’Ivoire","2024-05-17",0,0,0,0,0,0,0,0
"Côte d’Ivoire","2024-05-18",0,0,0,0,0,0,0,0
"Côte d’Ivoire","2024-05-19",0,0,0,0,0,0,0,0
"Côte d’Ivoire","2024-05-20",0,0,0,0,0,0,0,0
"Côte d’Ivoire","2024-05-21",0,0,0,0,0,0,0,0
"Côte d’Ivoire","2024-05-22",0,0,0,0,0,0,0,0
"Côte d’Ivoire","2024-05-23",0,0,0,0,0,0,0,0
"Côte d’Ivoire","2024-05-24",0,0,0,0,0,0,0,0
"Côte d’Ivoire","2024-05-25",0,0,0,0,0,0,0,0
"Côte d’Ivoire","2024-05-26",0,0,0,0,0,0,0,0
"Côte d’Ivoire","2024-05-27",0,0,0,0,0,0,0,0
"Côte d’Ivoire","2024-05-28",0,0,0,0,0,0,0,0
"Côte d’Ivoire","2024-05-29",0,0,0,0,0,0,0,0
"Côte d’Ivoire","2024-05-30",0,0,0,0,0,0,0,0
"Côte d’Ivoire","2024-05-31",0,0,0,0,0,0,0,0
"Côte d’Ivoire","2024-06-01",0,0,0,0,0,0,0,0
"Côte d’Ivoire","2024-06-02",0,0,0,0,0,0,0,0
"Côte d’Ivoire","2024-06-03",0,0,0,0,0,0,0,0
"Côte d’Ivoire","2024-06-04",0,0,0,0,0,0,0,0
"Côte d’Ivoire","2024-06-05",0,0,0,0,0,0,0,0
"Côte d’Ivoire","2024-06-06",0,0,0,0,0,0,0,0
"Côte d’Ivoire","2024-06-07",0,0,0,0,0,0,0,0
"Côte d’Ivoire","2024-06-08",0,0,0,0,0,0,0,0
"Côte d’Ivoire","2024-06-09",0,0,0,0,0,0,0,0
"Côte d’Ivoire","2024-06-10",0,0,0,0,0,0,0,0
"Côte d’Ivoire","2024-06-11",0,0,0,0,0,0,0,0
"Côte d’Ivoire","2024-06-12",0,0,0,0,0,0,0,0
"Côte d’Ivoire","2024-06-13",0,0,0,0,0,0,0,0
"Côte d’Ivoire","2024-06-14",0,0,0,0,0,0,0,0
"Côte d’Ivoire","2024-06-15",0,0,0,0,0,0,0,0
"Côte d’Ivoire","2024-06-16",0,0,0,0,0,0,0,0
"Côte d’Ivoire","2024-06-17",0,0,0,0,0,0,0,0
"Côte d’Ivoire","2024-06-18",0,0,0,0,0,0,0,0
"Côte d’Ivoire","2024-06-19",0,0,0,0,0,0,0,0
"Côte d’Ivoire","2024-06-20",0,0,0,0,0,0,0,0
"Côte d’Ivoire","2024-06-21",0,0,0,0,0,0,0,0
"Côte d’Ivoire","2024-06-22",0,0,0,0,0,0,0,0
"Côte d’Ivoire","2024-06-23",0,0,0,0,0,0,0,0
"Côte d’Ivoire","2024-06-24",0,0,0,0,0,0,0,0
"Côte d’Ivoire","2024-06-25",0,0,0,0,0,0,0,0
"Côte d’Ivoire","2024-06-26",0,0,0,0,0,0,0,0
"Côte d’Ivoire","2024-06-27",0,0,0,0,0,0,0,0
"Côte d’Ivoire","2024-06-28",0,0,0,0,0,0,0,0
"Côte d’Ivoire","2024-06-29",0,0,0,0,0,0,0,0
"Côte d’Ivoire","2024-06-30",0,0,0,0,0,0,0,0
"Côte d’Ivoire","2024-07-01",0,0,0,0,0,0,0,0
"Côte d’Ivoire","2024-07-02",0,0,0,0,0,0,0,0
"Côte d’Ivoire","2024-07-03",0,0,0,0,0,0,0,0
"Côte d’Ivoire","2024-07-04",0,0,0,0,0,0,0,0
"Côte d’Ivoire","2024-07-05",0,0,0,0,0,0,0,0
"Côte d’Ivoire","2024-07-06",0,0,0,0,0,0,0,0
"Côte d’Ivoire","2024-07-07",0,1,1,0,1,1,0,0
"Côte d’Ivoire","2024-07-08",0,0,1,0,0,1,0,0
"Côte d’Ivoire","2024-07-09",0,0,1,0,0,1,0,0
"Côte d’Ivoire","2024-07-10",0,0,1,0,0,1,0,0
"Côte d’Ivoire","2024-07-11",0,0,1,0,1,2,0,0
"Côte d’Ivoire","2024-07-12",0,0,1,0,0,2,0,0
"Côte d’Ivoire","2024-07-13",0,0,1,0,0,2,0,0
"Côte d’Ivoire","2024-07-14",0,1,2,0,0,2,0,0
"Côte d’Ivoire","2024-07-15",0,0,2,0,0,2,0,0
"Côte d’Ivoire","2024-07-16",0,0,2,0,1,3,0,0
"Côte d’Ivoire","2024-07-17",0,0,2,0,0,3,0,0
"Côte d’Ivoire","2024-07-18",0,0,2,0,1,4,0,0
"Côte d’Ivoire","2024-07-19",0,0,2,0,0,4,0,0
"Côte d’Ivoire","2024-07-20",0,0,2,0,1,5,0,0
"Côte d’Ivoire","2024-07-21",0,3,5,0,0,5,0,0
"Côte d’Ivoire","2024-07-22",0,0,5,0,1,6,0,0
"Côte d’Ivoire","2024-07-23",0,0,5,0,0,6,0,0
"Côte d’Ivoire","2024-07-24",0,0,5,0,1,7,0,0
"Côte d’Ivoire","2024-07-25",0,0,5,0,0,7,0,0
"Côte d’Ivoire","2024-07-26",0,0,5,0,1,8,0,0
"Côte d’Ivoire","2024-07-27",0,0,5,0,0,8,0,0
"Côte d’Ivoire","2024-07-28",0,4,9,0,1,9,0,0
"Côte d’Ivoire","2024-07-29",0,0,9,0,1,10,0,0
"Côte d’Ivoire","2024-07-30",0,0,9,0,0,10,0,0
"Côte d’Ivoire","2024-07-31",0,0,9,0,1,11,0,0
"Côte d’Ivoire","2024-08-01",0,0,9,0,0,11,0,0
"Côte d’Ivoire","2024-08-02",0,0,9,0,1,12,0,0
"Côte d’Ivoire","2024-08-03",0,0,9,0,0,12,0,0
"Côte d’Ivoire","2024-08-04",0,4,13,0,1,13,0,0
"Côte d’Ivoire","2024-08-05",0,0,13,0,1,14,0,0
"Côte d’Ivoire","2024-08-06",0,0,13,0,1,15,0,0
"Côte d’Ivoire","2024-08-07",0,0,13,0,1,16,0,0
"Côte d’Ivoire","2024-08-08",0,0,13,0,1,17,0,0
"Côte d’Ivoire","2024-08-09",0,0,13,0,1,18,0,0
"Côte d’Ivoire","2024-08-10",0,0,13,0,1,19,0,0
"Côte d’Ivoire","2024-08-11",0,7,20,0,1,20,0,0
"Côte d’Ivoire","2024-08-12",0,0,20,0,2,22,0,0
"Côte d’Ivoire","2024-08-13",0,0,20,0,2,24,0,0
"Côte d’Ivoire","2024-08-14",0,0,20,0,2,26,0,0
"Côte d’Ivoire","2024-08-15",0,0,20,0,1,27,0,0
"Côte d’Ivoire","2024-08-16",0,0,20,0,2,29,0,0
"Côte d’Ivoire","2024-08-17",0,0,20,0,2,31,0,0
"Côte d’Ivoire","2024-08-18",0,13,33,0,2,33,0,0
"Côte d’Ivoire","2024-08-19",0,0,33,0,1,34,0,0
"Côte d’Ivoire","2024-08-20",0,0,33,0,2,36,0,0
"Côte d’Ivoire","2024-08-21",0,0,33,0,1,37,0,0
"Côte d’Ivoire","2024-08-22",0,0,33,0,2,39,0,0
"Côte d’Ivoire","2024-08-23",0,0,33,0,1,40,0,0
"Côte d’Ivoire","2024-08-24",0,0,33,0,2,42,0,0
"Côte d’Ivoire","2024-08-25",0,10,43,0,1,43,0,0
"Côte d’Ivoire","2024-08-26",0,0,43,0,1,44,0,0
"Côte d’Ivoire","2024-08-27",0,0,43,0,1,45,0,0
"Côte d’Ivoire","2024-08-28",0,0,43,0,1,46,0,0
"Côte d’Ivoire","2024-08-29",0,0,43,0,0,46,0,0
"Côte d’Ivoire","2024-08-30",0,0,43,0,1,47,0,0
"Côte d’Ivoire","2024-08-31",0,0,43,0,1,48,0,0
"Côte d’Ivoire","2024-09-01",0,6,49,0,1,49,0,0
"Côte d’Ivoire","2024-09-02",0,0,49,0,0,49,0,0
"Côte d’Ivoire","2024-09-03",0,0,49,0,1,50,0,0
"Côte d’Ivoire","2024-09-04",0,0,49,0,0,50,0,0
"Côte d’Ivoire","2024-09-05",0,0,49,0,1,51,0,0
"Côte d’Ivoire","2024-09-06",0,0,49,0,0,51,0,0
"Côte d’Ivoire","2024-09-07",0,0,49,0,1,52,0,0
"Côte d’Ivoire","2024-09-08",138,3,52,138,0,52,138,138
"Côte d’Ivoire","2024-09-09",0,0,52,138,1,53,6,144
"Côte d’Ivoire","2024-09-10",0,0,52,138,2,55,7,151
"Côte d’Ivoire","2024-09-11",0,0,52,138,1,56,6,157
"Côte d’Ivoire","2024-09-12",0,0,52,138,2,58,7,164
"Côte d’Ivoire","2024-09-13",0,0,52,138,1,59,6,170
"Côte d’Ivoire","2024-09-14",0,0,52,138,2,61,6,176
"Côte d’Ivoire","2024-09-15",0,10,62,138,1,62,7,183
"Côte d’Ivoire","2024-09-16",51,0,62,189,1,63,6,189
"Côte d’Ivoire","2024-09-17",0,0,62,189,1,64,2,191
"Côte d’Ivoire","2024-09-18",0,0,62,189,1,65,3,194
"Côte d’Ivoire","2024-09-19",0,0,62,189,2,67,2,196
"Côte d’Ivoire","2024-09-20",0,0,62,189,1,68,3,199
"Côte d’Ivoire","2024-09-21",0,0,62,189,1,69,2,201
"Côte d’Ivoire","2024-09-22",0,8,70,189,1,70,2,203
"Côte d’Ivoire","2024-09-23",0,0,70,189,0,70,3,206
"Côte d’Ivoire","2024-09-24",0,0,70,189,1,71,2,208
"Côte d’Ivoire","2024-09-25",0,0,70,189,0,71,3,211
"Côte d’Ivoire","2024-09-26",0,0,70,189,0,71,2,213
"Côte d’Ivoire","2024-09-27",0,0,70,189,0,71,2,215
"Côte d’Ivoire","2024-09-28",0,0,70,189,1,72,3,218
"Côte d’Ivoire","2024-09-29",0,2,72,189,0,72,2,220
"Côte d’Ivoire","2024-09-30",0,0,72,189,1,73,3,223
"Côte d’Ivoire","2024-10-01",0,0,72,189,1,74,2,225
"Côte d’Ivoire","2024-10-02",0,0,72,189,1,75,2,227
"Côte d’Ivoire","2024-10-03",0,0,72,189,1,76,3,230
"Côte d’Ivoire","2024-10-04",0,0,72,189,1,77,2,232
"Côte d’Ivoire","2024-10-05",0,0,72,189,1,78,3,235
"Côte d’Ivoire","2024-10-06",48,7,79,237,1,79,2,237
"Côte d’Ivoire","2024-10-07",0,0,79,237,0,79,5,242
"Côte d’Ivoire","2024-10-08",0,0,79,237,0,79,6,248
"Côte d’Ivoire","2024-10-09",0,0,79,237,0,79,5,253
"Côte d’Ivoire","2024-10-10",0,0,79,237,0,79,5,258
"Côte d’Ivoire","2024-10-11",0,0,79,237,0,79,6,264
"Côte d’Ivoire","2024-10-12",32,0,79,269,0,79,5,269
"Côte d’Ivoire","2024-10-13",0,0,79,269,0,79,3,272
"Côte d’Ivoire","2024-10-14",0,0,79,269,1,80,3,275
"Côte d’Ivoire","2024-10-15",0,0,79,269,0,80,2,277
"Côte d’Ivoire","2024-10-16",0,0,79,269,0,80,3,280
"Côte d’Ivoire","2024-10-17",0,0,79,269,0,80,3,283
"Côte d’Ivoire","2024-10-18",0,0,79,269,0,80,3,286
"Côte d’Ivoire","2024-10-19",0,0,79,269,0,80,3,289
"Côte d’Ivoire","2024-10-20",0,1,80,269,0,80,2,291
"Côte d’Ivoire","2024-10-21",0,0,80,269,1,81,3,294
"Côte d’Ivoire","2024-10-22",0,0,80,269,2,83,3,297
"Côte d’Ivoire","2024-10-23",0,0,80,269,1,84,3,300
"Côte d’Ivoire","2024-10-24",0,0,80,269,1,85,3,303
"Côte d’Ivoire","2024-10-25",0,0,80,269,1,86,2,305
"Côte d’Ivoire","2024-10-26",0,0,80,269,2,88,3,308
"Côte d’Ivoire","2024-10-27",42,9,89,311,1,89,3,311
"Côte d’Ivoire","2024-10-28",0,0,89,311,1,90,0,311
"Côte d’Ivoire","2024-10-29",0,0,89,311,0,90,0,311
"Côte d’Ivoire","2024-10-30",0,2,91,311,1,91,0,311
"Côte d’Ivoire","2024-10-31",0,0,91,311,0,91,0,311
"Côte d’Ivoire","2024-11-01",0,0,91,311,0,91,0,311
"Côte d’Ivoire","2024-11-02",0,0,91,311,0,91,0,311
"Côte d’Ivoire","2024-11-03",0,0,91,311,0,91,0,311
"Côte d’Ivoire","2024-11-04",0,0,91,311,0,91,0,311
"Côte d’Ivoire","2024-11-05",0,0,91,311,0,91,0,311
"Côte d’Ivoire","2024-11-06",0,0,91,311,0,91,0,311
"Côte d’Ivoire","2024-11-07",0,0,91,311,0,91,0,311
"Côte d’Ivoire","2024-11-08",0,0,91,311,0,91,0,311
"Côte d’Ivoire","2024-11-09",0,0,91,311,0,91,0,311
"Côte d’Ivoire","2024-11-10",0,0,91,311,0,91,0,311
"Côte d’Ivoire","2024-11-11",0,0,91,311,0,91,0,311
"Côte d’Ivoire","2024-11-12",0,0,91,311,0,91,0,311
"Côte d’Ivoire","2024-11-13",0,0,91,311,0,91,0,311
"Côte d’Ivoire","2024-11-14",0,0,91,311,0,91,0,311
"Côte d’Ivoire","2024-11-15",0,0,91,311,0,91,0,311
"Côte d’Ivoire","2024-11-16",0,0,91,311,0,91,0,311
"Côte d’Ivoire","2024-11-17",0,0,91,311,0,91,0,311
"Côte d’Ivoire","2024-11-18",0,0,91,311,0,91,0,311
"Côte d’Ivoire","2024-11-19",0,0,91,311,0,91,0,311
"Côte d’Ivoire","2024-11-20",0,0,91,311,0,91,0,311
"Côte d’Ivoire","2024-11-21",0,0,91,311,0,91,0,311
"Côte d’Ivoire","2024-11-22",0,0,91,311,0,91,0,311
"Côte d’Ivoire","2024-11-23",0,0,91,311,0,91,0,311
"Côte d’Ivoire","2024-11-24",0,0,91,311,0,91,0,311
"Côte d’Ivoire","2024-11-25",0,0,91,311,0,91,0,311
"Côte d’Ivoire","2024-11-26",0,0,91,311,0,91,0,311
"Côte d’Ivoire","2024-11-27",0,0,91,311,0,91,0,311
"Côte d’Ivoire","2024-11-28",0,0,91,311,0,91,0,311
"Côte d’Ivoire","2024-11-29",0,0,91,311,0,91,0,311
"Côte d’Ivoire","2024-11-30",0,0,91,311,0,91,0,311
"Côte d’Ivoire","2024-12-01",0,0,91,311,0,91,0,311
"Côte d’Ivoire","2024-12-02",0,0,91,311,0,91,0,311
"Côte d’Ivoire","2024-12-03",0,0,91,311,0,91,0,311
"Côte d’Ivoire","2024-12-04",0,0,91,311,0,91,0,311
"Côte d’Ivoire","2024-12-05",0,0,91,311,0,91,0,311
"Côte d’Ivoire","2024-12-06",0,0,91,311,0,91,0,311
"Côte d’Ivoire","2024-12-07",0,0,91,311,0,91,0,311
"Côte d’Ivoire","2024-12-08",0,0,91,311,0,91,0,311
"Côte d’Ivoire","2024-12-09",0,0,91,311,0,91,0,311
"Croatia","2024-01-01",0,0,0,0,0,0,0,0
"Croatia","2024-01-02",0,0,0,0,0,0,0,0
"Croatia","2024-01-03",0,0,0,0,0,0,0,0
"Croatia","2024-01-04",0,0,0,0,0,0,0,0
"Croatia","2024-01-05",0,0,0,0,0,0,0,0
"Croatia","2024-01-06",0,0,0,0,0,0,0,0
"Croatia","2024-01-07",0,0,0,0,0,0,0,0
"Croatia","2024-01-08",0,0,0,0,0,0,0,0
"Croatia","2024-01-09",0,0,0,0,0,0,0,0
"Croatia","2024-01-10",0,0,0,0,0,0,0,0
"Croatia","2024-01-11",0,0,0,0,0,0,0,0
"Croatia","2024-01-12",0,0,0,0,0,0,0,0
"Croatia","2024-01-13",0,0,0,0,0,0,0,0
"Croatia","2024-01-14",0,0,0,0,0,0,0,0
"Croatia","2024-01-15",0,0,0,0,0,0,0,0
"Croatia","2024-01-16",0,0,0,0,0,0,0,0
"Croatia","2024-01-17",0,0,0,0,0,0,0,0
"Croatia","2024-01-18",0,0,0,0,0,0,0,0
"Croatia","2024-01-19",0,0,0,0,0,0,0,0
"Croatia","2024-01-20",0,0,0,0,0,0,0,0
"Croatia","2024-01-21",0,0,0,0,0,0,0,0
"Croatia","2024-01-22",0,0,0,0,0,0,0,0
"Croatia","2024-01-23",0,0,0,0,0,0,0,0
"Croatia","2024-01-24",0,0,0,0,0,0,0,0
"Croatia","2024-01-25",0,0,0,0,0,0,0,0
"Croatia","2024-01-26",0,0,0,0,0,0,0,0
"Croatia","2024-01-27",0,0,0,0,0,0,0,0
"Croatia","2024-01-28",0,0,0,0,0,0,0,0
"Croatia","2024-01-29",0,0,0,0,0,0,0,0
"Croatia","2024-01-30",0,0,0,0,0,0,0,0
"Croatia","2024-01-31",0,0,0,0,0,0,0,0
"Croatia","2024-02-01",0,0,0,0,0,0,0,0
"Croatia","2024-02-02",0,0,0,0,0,0,0,0
"Croatia","2024-02-03",0,0,0,0,0,0,0,0
"Croatia","2024-02-04",0,0,0,0,0,0,0,0
"Croatia","2024-02-05",0,0,0,0,0,0,0,0
"Croatia","2024-02-06",0,0,0,0,0,0,0,0
"Croatia","2024-02-07",0,0,0,0,0,0,0,0
"Croatia","2024-02-08",0,0,0,0,0,0,0,0
"Croatia","2024-02-09",0,0,0,0,0,0,0,0
"Croatia","2024-02-10",0,0,0,0,0,0,0,0
"Croatia","2024-02-11",0,0,0,0,0,0,0,0
"Croatia","2024-02-12",0,0,0,0,0,0,0,0
"Croatia","2024-02-13",0,0,0,0,0,0,0,0
"Croatia","2024-02-14",0,0,0,0,0,0,0,0
"Croatia","2024-02-15",0,0,0,0,0,0,0,0
"Croatia","2024-02-16",0,0,0,0,0,0,0,0
"Croatia","2024-02-17",0,0,0,0,0,0,0,0
"Croatia","2024-02-18",0,0,0,0,0,0,0,0
"Croatia","2024-02-19",0,0,0,0,0,0,0,0
"Croatia","2024-02-20",0,0,0,0,0,0,0,0
"Croatia","2024-02-21",0,0,0,0,0,0,0,0
"Croatia","2024-02-22",0,0,0,0,0,0,0,0
"Croatia","2024-02-23",0,0,0,0,0,0,0,0
"Croatia","2024-02-24",0,0,0,0,0,0,0,0
"Croatia","2024-02-25",0,0,0,0,0,0,0,0
"Croatia","2024-02-26",0,0,0,0,0,0,0,0
"Croatia","2024-02-27",0,0,0,0,0,0,0,0
"Croatia","2024-02-28",0,0,0,0,0,0,0,0
"Croatia","2024-02-29",0,0,0,0,0,0,0,0
"Croatia","2024-03-01",0,0,0,0,0,0,0,0
"Croatia","2024-03-02",0,0,0,0,0,0,0,0
"Croatia","2024-03-03",0,0,0,0,0,0,0,0
"Croatia","2024-03-04",0,0,0,0,0,0,0,0
"Croatia","2024-03-05",0,0,0,0,0,0,0,0
"Croatia","2024-03-06",0,0,0,0,0,0,0,0
"Croatia","2024-03-07",0,0,0,0,0,0,0,0
"Croatia","2024-03-08",0,0,0,0,0,0,0,0
"Croatia","2024-03-09",0,0,0,0,0,0,0,0
"Croatia","2024-03-10",0,0,0,0,0,0,0,0
"Croatia","2024-03-11",0,0,0,0,0,0,0,0
"Croatia","2024-03-12",0,0,0,0,0,0,0,0
"Croatia","2024-03-13",0,0,0,0,0,0,0,0
"Croatia","2024-03-14",0,0,0,0,0,0,0,0
"Croatia","2024-03-15",0,0,0,0,0,0,0,0
"Croatia","2024-03-16",0,0,0,0,0,0,0,0
"Croatia","2024-03-17",0,0,0,0,0,0,0,0
"Croatia","2024-03-18",0,0,0,0,0,0,0,0
"Croatia","2024-03-19",0,0,0,0,0,0,0,0
"Croatia","2024-03-20",0,0,0,0,0,0,0,0
"Croatia","2024-03-21",0,0,0,0,0,0,0,0
"Croatia","2024-03-22",0,0,0,0,0,0,0,0
"Croatia","2024-03-23",0,0,0,0,0,0,0,0
"Croatia","2024-03-24",0,0,0,0,0,0,0,0
"Croatia","2024-03-25",0,0,0,0,0,0,0,0
"Croatia","2024-03-26",0,0,0,0,0,0,0,0
"Croatia","2024-03-27",0,0,0,0,0,0,0,0
"Croatia","2024-03-28",0,0,0,0,0,0,0,0
"Croatia","2024-03-29",0,0,0,0,0,0,0,0
"Croatia","2024-03-30",0,0,0,0,0,0,0,0
"Croatia","2024-03-31",0,0,0,0,0,0,0,0
"Croatia","2024-04-01",0,0,0,0,0,0,0,0
"Croatia","2024-04-02",0,0,0,0,0,0,0,0
"Croatia","2024-04-03",0,0,0,0,0,0,0,0
"Croatia","2024-04-04",0,0,0,0,0,0,0,0
"Croatia","2024-04-05",0,0,0,0,0,0,0,0
"Croatia","2024-04-06",0,0,0,0,0,0,0,0
"Croatia","2024-04-07",0,0,0,0,0,0,0,0
"Croatia","2024-04-08",0,0,0,0,0,0,0,0
"Croatia","2024-04-09",0,0,0,0,0,0,0,0
"Croatia","2024-04-10",0,0,0,0,0,0,0,0
"Croatia","2024-04-11",0,0,0,0,0,0,0,0
"Croatia","2024-04-12",0,0,0,0,0,0,0,0
"Croatia","2024-04-13",0,0,0,0,0,0,0,0
"Croatia","2024-04-14",0,0,0,0,0,0,0,0
"Croatia","2024-04-15",0,0,0,0,0,0,0,0
"Croatia","2024-04-16",0,0,0,0,0,0,0,0
"Croatia","2024-04-17",0,0,0,0,0,0,0,0
"Croatia","2024-04-18",0,0,0,0,0,0,0,0
"Croatia","2024-04-19",0,0,0,0,0,0,0,0
"Croatia","2024-04-20",0,0,0,0,0,0,0,0
"Croatia","2024-04-21",0,0,0,0,0,0,0,0
"Croatia","2024-04-22",0,0,0,0,0,0,0,0
"Croatia","2024-04-23",0,0,0,0,0,0,0,0
"Croatia","2024-04-24",0,0,0,0,0,0,0,0
"Croatia","2024-04-25",0,0,0,0,0,0,0,0
"Croatia","2024-04-26",0,0,0,0,0,0,0,0
"Croatia","2024-04-27",0,0,0,0,0,0,0,0
"Croatia","2024-04-28",0,0,0,0,0,0,0,0
"Croatia","2024-04-29",0,0,0,0,0,0,0,0
"Croatia","2024-04-30",0,1,1,0,1,1,0,0
"Croatia","2024-05-01",0,0,1,0,0,1,0,0
"Croatia","2024-05-02",0,0,1,0,0,1,0,0
"Croatia","2024-05-03",0,0,1,0,0,1,0,0
"Croatia","2024-05-04",0,0,1,0,0,1,0,0
"Croatia","2024-05-05",0,0,1,0,0,1,0,0
"Croatia","2024-05-06",0,0,1,0,0,1,0,0
"Croatia","2024-05-07",0,0,1,0,0,1,0,0
"Croatia","2024-05-08",0,0,1,0,0,1,0,0
"Croatia","2024-05-09",0,0,1,0,0,1,0,0
"Croatia","2024-05-10",0,0,1,0,0,1,0,0
"Croatia","2024-05-11",0,0,1,0,0,1,0,0
"Croatia","2024-05-12",0,0,1,0,0,1,0,0
"Croatia","2024-05-13",0,0,1,0,0,1,0,0
"Croatia","2024-05-14",0,0,1,0,0,1,0,0
"Croatia","2024-05-15",0,0,1,0,0,1,0,0
"Croatia","2024-05-16",0,0,1,0,0,1,0,0
"Croatia","2024-05-17",0,0,1,0,0,1,0,0
"Croatia","2024-05-18",0,0,1,0,0,1,0,0
"Croatia","2024-05-19",0,0,1,0,0,1,0,0
"Croatia","2024-05-20",0,0,1,0,0,1,0,0
"Croatia","2024-05-21",0,0,1,0,0,1,0,0
"Croatia","2024-05-22",0,0,1,0,0,1,0,0
"Croatia","2024-05-23",0,0,1,0,0,1,0,0
"Croatia","2024-05-24",0,0,1,0,0,1,0,0
"Croatia","2024-05-25",0,0,1,0,0,1,0,0
"Croatia","2024-05-26",0,0,1,0,0,1,0,0
"Croatia","2024-05-27",0,0,1,0,0,1,0,0
"Croatia","2024-05-28",0,0,1,0,0,1,0,0
"Croatia","2024-05-29",0,0,1,0,0,1,0,0
"Croatia","2024-05-30",0,0,1,0,0,1,0,0
"Croatia","2024-05-31",0,0,1,0,0,1,0,0
"Croatia","2024-06-01",0,0,1,0,0,1,0,0
"Croatia","2024-06-02",0,0,1,0,0,1,0,0
"Croatia","2024-06-03",0,0,1,0,0,1,0,0
"Croatia","2024-06-04",0,0,1,0,0,1,0,0
"Croatia","2024-06-05",0,0,1,0,0,1,0,0
"Croatia","2024-06-06",0,0,1,0,0,1,0,0
"Croatia","2024-06-07",0,0,1,0,0,1,0,0
"Croatia","2024-06-08",0,0,1,0,0,1,0,0
"Croatia","2024-06-09",0,0,1,0,0,1,0,0
"Croatia","2024-06-10",0,0,1,0,0,1,0,0
"Croatia","2024-06-11",0,0,1,0,0,1,0,0
"Croatia","2024-06-12",0,0,1,0,0,1,0,0
"Croatia","2024-06-13",0,0,1,0,0,1,0,0
"Croatia","2024-06-14",0,0,1,0,0,1,0,0
"Croatia","2024-06-15",0,0,1,0,0,1,0,0
"Croatia","2024-06-16",0,0,1,0,0,1,0,0
"Croatia","2024-06-17",0,0,1,0,0,1,0,0
"Croatia","2024-06-18",0,0,1,0,0,1,0,0
"Croatia","2024-06-19",0,0,1,0,0,1,0,0
"Croatia","2024-06-20",0,0,1,0,0,1,0,0
"Croatia","2024-06-21",0,0,1,0,0,1,0,0
"Croatia","2024-06-22",0,0,1,0,0,1,0,0
"Croatia","2024-06-23",0,0,1,0,0,1,0,0
"Croatia","2024-06-24",0,0,1,0,0,1,0,0
"Croatia","2024-06-25",0,0,1,0,0,1,0,0
"Croatia","2024-06-26",0,0,1,0,0,1,0,0
"Croatia","2024-06-27",0,0,1,0,0,1,0,0
"Croatia","2024-06-28",0,0,1,0,0,1,0,0
"Croatia","2024-06-29",0,0,1,0,0,1,0,0
"Croatia","2024-06-30",0,0,1,0,0,1,0,0
"Croatia","2024-07-01",0,0,1,0,0,1,0,0
"Croatia","2024-07-02",0,0,1,0,0,1,0,0
"Croatia","2024-07-03",0,0,1,0,0,1,0,0
"Croatia","2024-07-04",0,0,1,0,0,1,0,0
"Croatia","2024-07-05",0,0,1,0,0,1,0,0
"Croatia","2024-07-06",0,0,1,0,0,1,0,0
"Croatia","2024-07-07",0,0,1,0,0,1,0,0
"Croatia","2024-07-08",0,0,1,0,0,1,0,0
"Croatia","2024-07-09",0,0,1,0,0,1,0,0
"Croatia","2024-07-10",0,0,1,0,0,1,0,0
"Croatia","2024-07-11",0,0,1,0,0,1,0,0
"Croatia","2024-07-12",0,0,1,0,0,1,0,0
"Croatia","2024-07-13",0,0,1,0,0,1,0,0
"Croatia","2024-07-14",0,0,1,0,0,1,0,0
"Croatia","2024-07-15",0,0,1,0,0,1,0,0
"Croatia","2024-07-16",0,0,1,0,0,1,0,0
"Croatia","2024-07-17",0,0,1,0,0,1,0,0
"Croatia","2024-07-18",0,0,1,0,0,1,0,0
"Croatia","2024-07-19",0,0,1,0,0,1,0,0
"Croatia","2024-07-20",0,0,1,0,0,1,0,0
"Croatia","2024-07-21",0,0,1,0,0,1,0,0
"Croatia","2024-07-22",0,0,1,0,0,1,0,0
"Croatia","2024-07-23",0,0,1,0,0,1,0,0
"Croatia","2024-07-24",0,0,1,0,0,1,0,0
"Croatia","2024-07-25",0,0,1,0,0,1,0,0
"Croatia","2024-07-26",0,0,1,0,0,1,0,0
"Croatia","2024-07-27",0,0,1,0,0,1,0,0
"Croatia","2024-07-28",0,0,1,0,0,1,0,0
"Croatia","2024-07-29",0,0,1,0,0,1,0,0
"Croatia","2024-07-30",0,0,1,0,0,1,0,0
"Croatia","2024-07-31",0,0,1,0,0,1,0,0
"Croatia","2024-08-01",0,0,1,0,0,1,0,0
"Croatia","2024-08-02",0,0,1,0,0,1,0,0
"Croatia","2024-08-03",0,0,1,0,0,1,0,0
"Croatia","2024-08-04",0,0,1,0,0,1,0,0
"Croatia","2024-08-05",0,0,1,0,0,1,0,0
"Croatia","2024-08-06",0,0,1,0,0,1,0,0
"Croatia","2024-08-07",0,0,1,0,0,1,0,0
"Croatia","2024-08-08",0,0,1,0,0,1,0,0
"Croatia","2024-08-09",0,0,1,0,0,1,0,0
"Croatia","2024-08-10",0,0,1,0,0,1,0,0
"Croatia","2024-08-11",0,0,1,0,0,1,0,0
"Croatia","2024-08-12",0,0,1,0,0,1,0,0
"Croatia","2024-08-13",0,0,1,0,0,1,0,0
"Croatia","2024-08-14",0,0,1,0,0,1,0,0
"Croatia","2024-08-15",0,0,1,0,0,1,0,0
"Croatia","2024-08-16",0,0,1,0,0,1,0,0
"Croatia","2024-08-17",0,0,1,0,0,1,0,0
"Croatia","2024-08-18",0,0,1,0,0,1,0,0
"Croatia","2024-08-19",0,0,1,0,0,1,0,0
"Croatia","2024-08-20",0,0,1,0,0,1,0,0
"Croatia","2024-08-21",0,0,1,0,0,1,0,0
"Croatia","2024-08-22",0,0,1,0,0,1,0,0
"Croatia","2024-08-23",0,0,1,0,0,1,0,0
"Croatia","2024-08-24",0,0,1,0,0,1,0,0
"Croatia","2024-08-25",0,0,1,0,0,1,0,0
"Croatia","2024-08-26",0,0,1,0,0,1,0,0
"Croatia","2024-08-27",0,0,1,0,0,1,0,0
"Croatia","2024-08-28",0,0,1,0,0,1,0,0
"Croatia","2024-08-29",0,0,1,0,0,1,0,0
"Croatia","2024-08-30",0,0,1,0,0,1,0,0
"Croatia","2024-08-31",0,0,1,0,0,1,0,0
"Croatia","2024-09-01",0,0,1,0,0,1,0,0
"Croatia","2024-09-02",0,0,1,0,0,1,0,0
"Croatia","2024-09-03",0,0,1,0,0,1,0,0
"Croatia","2024-09-04",0,0,1,0,0,1,0,0
"Croatia","2024-09-05",0,0,1,0,0,1,0,0
"Croatia","2024-09-06",0,0,1,0,0,1,0,0
"Croatia","2024-09-07",0,0,1,0,0,1,0,0
"Croatia","2024-09-08",0,0,1,0,0,1,0,0
"Croatia","2024-09-09",0,0,1,0,0,1,0,0
"Croatia","2024-09-10",0,0,1,0,0,1,0,0
"Croatia","2024-09-11",0,0,1,0,0,1,0,0
"Croatia","2024-09-12",0,0,1,0,0,1,0,0
"Croatia","2024-09-13",0,0,1,0,0,1,0,0
"Croatia","2024-09-14",0,0,1,0,0,1,0,0
"Croatia","2024-09-15",0,0,1,0,0,1,0,0
"Croatia","2024-09-16",0,0,1,0,0,1,0,0
"Croatia","2024-09-17",0,0,1,0,0,1,0,0
"Croatia","2024-09-18",0,0,1,0,0,1,0,0
"Croatia","2024-09-19",0,0,1,0,0,1,0,0
"Croatia","2024-09-20",0,0,1,0,0,1,0,0
"Croatia","2024-09-21",0,0,1,0,0,1,0,0
"Croatia","2024-09-22",0,0,1,0,0,1,0,0
"Croatia","2024-09-23",0,0,1,0,0,1,0,0
"Croatia","2024-09-24",0,0,1,0,0,1,0,0
"Croatia","2024-09-25",0,0,1,0,0,1,0,0
"Croatia","2024-09-26",0,0,1,0,0,1,0,0
"Croatia","2024-09-27",0,0,1,0,0,1,0,0
"Croatia","2024-09-28",0,0,1,0,0,1,0,0
"Croatia","2024-09-29",0,0,1,0,0,1,0,0
"Croatia","2024-09-30",0,0,1,0,0,1,0,0
"Croatia","2024-10-01",0,0,1,0,0,1,0,0
"Croatia","2024-10-02",0,0,1,0,0,1,0,0
"Croatia","2024-10-03",0,0,1,0,0,1,0,0
"Croatia","2024-10-04",0,0,1,0,0,1,0,0
"Croatia","2024-10-05",0,0,1,0,0,1,0,0
"Croatia","2024-10-06",0,0,1,0,0,1,0,0
"Croatia","2024-10-07",0,0,1,0,0,1,0,0
"Croatia","2024-10-08",0,0,1,0,0,1,0,0
"Croatia","2024-10-09",0,0,1,0,0,1,0,0
"Croatia","2024-10-10",0,0,1,0,0,1,0,0
"Croatia","2024-10-11",0,0,1,0,0,1,0,0
"Croatia","2024-10-12",0,0,1,0,0,1,0,0
"Croatia","2024-10-13",0,0,1,0,0,1,0,0
"Croatia","2024-10-14",0,0,1,0,0,1,0,0
"Croatia","2024-10-15",0,0,1,0,0,1,0,0
"Croatia","2024-10-16",0,0,1,0,0,1,0,0
"Croatia","2024-10-17",0,0,1,0,0,1,0,0
"Croatia","2024-10-18",0,0,1,0,0,1,0,0
"Croatia","2024-10-19",0,0,1,0,0,1,0,0
"Croatia","2024-10-20",0,0,1,0,0,1,0,0
"Croatia","2024-10-21",0,0,1,0,0,1,0,0
"Croatia","2024-10-22",0,0,1,0,0,1,0,0
"Croatia","2024-10-23",0,0,1,0,0,1,0,0
"Croatia","2024-10-24",0,0,1,0,0,1,0,0
"Croatia","2024-10-25",0,0,1,0,0,1,0,0
"Croatia","2024-10-26",0,0,1,0,0,1,0,0
"Croatia","2024-10-27",0,0,1,0,0,1,0,0
"Croatia","2024-10-28",0,0,1,0,0,1,0,0
"Croatia","2024-10-29",0,0,1,0,0,1,0,0
"Croatia","2024-10-30",0,0,1,0,0,1,0,0
"Croatia","2024-10-31",0,0,1,0,0,1,0,0
"Croatia","2024-11-01",0,0,1,0,0,1,0,0
"Croatia","2024-11-02",0,0,1,0,0,1,0,0
"Croatia","2024-11-03",0,0,1,0,0,1,0,0
"Croatia","2024-11-04",0,0,1,0,0,1,0,0
"Croatia","2024-11-05",0,0,1,0,0,1,0,0
"Croatia","2024-11-06",0,0,1,0,0,1,0,0
"Croatia","2024-11-07",0,0,1,0,0,1,0,0
"Croatia","2024-11-08",0,0,1,0,0,1,0,0
"Croatia","2024-11-09",0,0,1,0,0,1,0,0
"Croatia","2024-11-10",0,0,1,0,0,1,0,0
"Croatia","2024-11-11",0,0,1,0,0,1,0,0
"Croatia","2024-11-12",0,0,1,0,0,1,0,0
"Croatia","2024-11-13",0,0,1,0,0,1,0,0
"Croatia","2024-11-14",0,0,1,0,0,1,0,0
"Croatia","2024-11-15",0,0,1,0,0,1,0,0
"Croatia","2024-11-16",0,0,1,0,0,1,0,0
"Croatia","2024-11-17",0,0,1,0,0,1,0,0
"Croatia","2024-11-18",0,0,1,0,0,1,0,0
"Croatia","2024-11-19",0,0,1,0,0,1,0,0
"Croatia","2024-11-20",0,0,1,0,0,1,0,0
"Croatia","2024-11-21",0,0,1,0,0,1,0,0
"Croatia","2024-11-22",0,0,1,0,0,1,0,0
"Croatia","2024-11-23",0,0,1,0,0,1,0,0
"Croatia","2024-11-24",0,0,1,0,0,1,0,0
"Croatia","2024-11-25",0,0,1,0,0,1,0,0
"Croatia","2024-11-26",0,0,1,0,0,1,0,0
"Croatia","2024-11-27",0,0,1,0,0,1,0,0
"Croatia","2024-11-28",0,0,1,0,0,1,0,0
"Croatia","2024-11-29",0,0,1,0,0,1,0,0
"Croatia","2024-11-30",0,0,1,0,0,1,0,0
"Croatia","2024-12-01",0,0,1,0,0,1,0,0
"Croatia","2024-12-02",0,0,1,0,0,1,0,0
"Croatia","2024-12-03",0,0,1,0,0,1,0,0
"Croatia","2024-12-04",0,0,1,0,0,1,0,0
"Croatia","2024-12-05",0,0,1,0,0,1,0,0
"Croatia","2024-12-06",0,0,1,0,0,1,0,0
"Croatia","2024-12-07",0,0,1,0,0,1,0,0
"Croatia","2024-12-08",0,0,1,0,0,1,0,0
"Croatia","2024-12-09",0,0,1,0,0,1,0,0
"Cuba","2024-01-01",0,0,0,0,0,0,0,0
"Cuba","2024-01-02",0,0,0,0,0,0,0,0
"Cuba","2024-01-03",0,0,0,0,0,0,0,0
"Cuba","2024-01-04",0,0,0,0,0,0,0,0
"Cuba","2024-01-05",0,0,0,0,0,0,0,0
"Cuba","2024-01-06",0,0,0,0,0,0,0,0
"Cuba","2024-01-07",0,0,0,0,0,0,0,0
"Cuba","2024-01-08",0,0,0,0,0,0,0,0
"Cuba","2024-01-09",0,0,0,0,0,0,0,0
"Cuba","2024-01-10",0,0,0,0,0,0,0,0
"Cuba","2024-01-11",0,0,0,0,0,0,0,0
"Cuba","2024-01-12",0,0,0,0,0,0,0,0
"Cuba","2024-01-13",0,0,0,0,0,0,0,0
"Cuba","2024-01-14",0,0,0,0,0,0,0,0
"Cuba","2024-01-15",0,0,0,0,0,0,0,0
"Cuba","2024-01-16",0,0,0,0,0,0,0,0
"Cuba","2024-01-17",0,0,0,0,0,0,0,0
"Cuba","2024-01-18",0,0,0,0,0,0,0,0
"Cuba","2024-01-19",0,0,0,0,0,0,0,0
"Cuba","2024-01-20",0,0,0,0,0,0,0,0
"Cuba","2024-01-21",0,0,0,0,0,0,0,0
"Cuba","2024-01-22",0,0,0,0,0,0,0,0
"Cuba","2024-01-23",0,0,0,0,0,0,0,0
"Cuba","2024-01-24",0,0,0,0,0,0,0,0
"Cuba","2024-01-25",0,0,0,0,0,0,0,0
"Cuba","2024-01-26",0,0,0,0,0,0,0,0
"Cuba","2024-01-27",0,0,0,0,0,0,0,0
"Cuba","2024-01-28",0,0,0,0,0,0,0,0
"Cuba","2024-01-29",0,0,0,0,0,0,0,0
"Cuba","2024-01-30",0,0,0,0,0,0,0,0
"Cuba","2024-01-31",0,0,0,0,0,0,0,0
"Cuba","2024-02-01",0,0,0,0,0,0,0,0
"Cuba","2024-02-02",0,0,0,0,0,0,0,0
"Cuba","2024-02-03",0,0,0,0,0,0,0,0
"Cuba","2024-02-04",0,0,0,0,0,0,0,0
"Cuba","2024-02-05",0,0,0,0,0,0,0,0
"Cuba","2024-02-06",0,0,0,0,0,0,0,0
"Cuba","2024-02-07",0,0,0,0,0,0,0,0
"Cuba","2024-02-08",0,0,0,0,0,0,0,0
"Cuba","2024-02-09",0,0,0,0,0,0,0,0
"Cuba","2024-02-10",0,0,0,0,0,0,0,0
"Cuba","2024-02-11",0,0,0,0,0,0,0,0
"Cuba","2024-02-12",0,0,0,0,0,0,0,0
"Cuba","2024-02-13",0,0,0,0,0,0,0,0
"Cuba","2024-02-14",0,0,0,0,0,0,0,0
"Cuba","2024-02-15",0,0,0,0,0,0,0,0
"Cuba","2024-02-16",0,0,0,0,0,0,0,0
"Cuba","2024-02-17",0,0,0,0,0,0,0,0
"Cuba","2024-02-18",0,0,0,0,0,0,0,0
"Cuba","2024-02-19",0,0,0,0,0,0,0,0
"Cuba","2024-02-20",0,0,0,0,0,0,0,0
"Cuba","2024-02-21",0,0,0,0,0,0,0,0
"Cuba","2024-02-22",0,0,0,0,0,0,0,0
"Cuba","2024-02-23",0,0,0,0,0,0,0,0
"Cuba","2024-02-24",0,0,0,0,0,0,0,0
"Cuba","2024-02-25",0,0,0,0,0,0,0,0
"Cuba","2024-02-26",0,0,0,0,0,0,0,0
"Cuba","2024-02-27",0,0,0,0,0,0,0,0
"Cuba","2024-02-28",0,0,0,0,0,0,0,0
"Cuba","2024-02-29",0,0,0,0,0,0,0,0
"Cuba","2024-03-01",0,0,0,0,0,0,0,0
"Cuba","2024-03-02",0,0,0,0,0,0,0,0
"Cuba","2024-03-03",0,0,0,0,0,0,0,0
"Cuba","2024-03-04",0,0,0,0,0,0,0,0
"Cuba","2024-03-05",0,0,0,0,0,0,0,0
"Cuba","2024-03-06",0,0,0,0,0,0,0,0
"Cuba","2024-03-07",0,0,0,0,0,0,0,0
"Cuba","2024-03-08",0,0,0,0,0,0,0,0
"Cuba","2024-03-09",0,0,0,0,0,0,0,0
"Cuba","2024-03-10",0,0,0,0,0,0,0,0
"Cuba","2024-03-11",0,0,0,0,0,0,0,0
"Cuba","2024-03-12",0,0,0,0,0,0,0,0
"Cuba","2024-03-13",0,0,0,0,0,0,0,0
"Cuba","2024-03-14",0,0,0,0,0,0,0,0
"Cuba","2024-03-15",0,0,0,0,0,0,0,0
"Cuba","2024-03-16",0,0,0,0,0,0,0,0
"Cuba","2024-03-17",0,0,0,0,0,0,0,0
"Cuba","2024-03-18",0,0,0,0,0,0,0,0
"Cuba","2024-03-19",0,0,0,0,0,0,0,0
"Cuba","2024-03-20",0,0,0,0,0,0,0,0
"Cuba","2024-03-21",0,0,0,0,0,0,0,0
"Cuba","2024-03-22",0,0,0,0,0,0,0,0
"Cuba","2024-03-23",0,0,0,0,0,0,0,0
"Cuba","2024-03-24",0,0,0,0,0,0,0,0
"Cuba","2024-03-25",0,0,0,0,0,0,0,0
"Cuba","2024-03-26",0,0,0,0,0,0,0,0
"Cuba","2024-03-27",0,0,0,0,0,0,0,0
"Cuba","2024-03-28",0,0,0,0,0,0,0,0
"Cuba","2024-03-29",0,0,0,0,0,0,0,0
"Cuba","2024-03-30",0,0,0,0,0,0,0,0
"Cuba","2024-03-31",0,0,0,0,0,0,0,0
"Cuba","2024-04-01",0,0,0,0,0,0,0,0
"Cuba","2024-04-02",0,0,0,0,0,0,0,0
"Cuba","2024-04-03",0,0,0,0,0,0,0,0
"Cuba","2024-04-04",0,0,0,0,0,0,0,0
"Cuba","2024-04-05",0,0,0,0,0,0,0,0
"Cuba","2024-04-06",0,0,0,0,0,0,0,0
"Cuba","2024-04-07",0,0,0,0,0,0,0,0
"Cuba","2024-04-08",0,0,0,0,0,0,0,0
"Cuba","2024-04-09",0,0,0,0,0,0,0,0
"Cuba","2024-04-10",0,0,0,0,0,0,0,0
"Cuba","2024-04-11",0,0,0,0,0,0,0,0
"Cuba","2024-04-12",0,0,0,0,0,0,0,0
"Cuba","2024-04-13",0,0,0,0,0,0,0,0
"Cuba","2024-04-14",0,0,0,0,0,0,0,0
"Cuba","2024-04-15",0,0,0,0,0,0,0,0
"Cuba","2024-04-16",0,0,0,0,0,0,0,0
"Cuba","2024-04-17",0,0,0,0,0,0,0,0
"Cuba","2024-04-18",0,0,0,0,0,0,0,0
"Cuba","2024-04-19",0,0,0,0,0,0,0,0
"Cuba","2024-04-20",0,0,0,0,0,0,0,0
"Cuba","2024-04-21",0,0,0,0,0,0,0,0
"Cuba","2024-04-22",0,0,0,0,0,0,0,0
"Cuba","2024-04-23",0,0,0,0,0,0,0,0
"Cuba","2024-04-24",0,0,0,0,0,0,0,0
"Cuba","2024-04-25",0,0,0,0,0,0,0,0
"Cuba","2024-04-26",0,0,0,0,0,0,0,0
"Cuba","2024-04-27",0,0,0,0,0,0,0,0
"Cuba","2024-04-28",0,0,0,0,0,0,0,0
"Cuba","2024-04-29",0,0,0,0,0,0,0,0
"Cuba","2024-04-30",0,0,0,0,0,0,0,0
"Cuba","2024-05-01",0,0,0,0,0,0,0,0
"Cuba","2024-05-02",0,0,0,0,0,0,0,0
"Cuba","2024-05-03",0,0,0,0,0,0,0,0
"Cuba","2024-05-04",0,0,0,0,0,0,0,0
"Cuba","2024-05-05",0,0,0,0,0,0,0,0
"Cuba","2024-05-06",0,0,0,0,0,0,0,0
"Cuba","2024-05-07",0,0,0,0,0,0,0,0
"Cuba","2024-05-08",0,0,0,0,0,0,0,0
"Cuba","2024-05-09",0,0,0,0,0,0,0,0
"Cuba","2024-05-10",0,0,0,0,0,0,0,0
"Cuba","2024-05-11",0,0,0,0,0,0,0,0
"Cuba","2024-05-12",0,0,0,0,0,0,0,0
"Cuba","2024-05-13",0,0,0,0,0,0,0,0
"Cuba","2024-05-14",0,0,0,0,0,0,0,0
"Cuba","2024-05-15",0,0,0,0,0,0,0,0
"Cuba","2024-05-16",0,0,0,0,0,0,0,0
"Cuba","2024-05-17",0,0,0,0,0,0,0,0
"Cuba","2024-05-18",0,0,0,0,0,0,0,0
"Cuba","2024-05-19",0,0,0,0,0,0,0,0
"Cuba","2024-05-20",0,0,0,0,0,0,0,0
"Cuba","2024-05-21",0,0,0,0,0,0,0,0
"Cuba","2024-05-22",0,0,0,0,0,0,0,0
"Cuba","2024-05-23",0,0,0,0,0,0,0,0
"Cuba","2024-05-24",0,0,0,0,0,0,0,0
"Cuba","2024-05-25",0,0,0,0,0,0,0,0
"Cuba","2024-05-26",0,0,0,0,0,0,0,0
"Cuba","2024-05-27",0,0,0,0,0,0,0,0
"Cuba","2024-05-28",0,0,0,0,0,0,0,0
"Cuba","2024-05-29",0,0,0,0,0,0,0,0
"Cuba","2024-05-30",0,0,0,0,0,0,0,0
"Cuba","2024-05-31",0,0,0,0,0,0,0,0
"Cuba","2024-06-01",0,0,0,0,0,0,0,0
"Cuba","2024-06-02",0,0,0,0,0,0,0,0
"Cuba","2024-06-03",0,0,0,0,0,0,0,0
"Cuba","2024-06-04",0,0,0,0,0,0,0,0
"Cuba","2024-06-05",0,0,0,0,0,0,0,0
"Cuba","2024-06-06",0,0,0,0,0,0,0,0
"Cuba","2024-06-07",0,0,0,0,0,0,0,0
"Cuba","2024-06-08",0,0,0,0,0,0,0,0
"Cuba","2024-06-09",0,0,0,0,0,0,0,0
"Cuba","2024-06-10",0,0,0,0,0,0,0,0
"Cuba","2024-06-11",0,0,0,0,0,0,0,0
"Cuba","2024-06-12",0,0,0,0,0,0,0,0
"Cuba","2024-06-13",0,0,0,0,0,0,0,0
"Cuba","2024-06-14",0,0,0,0,0,0,0,0
"Cuba","2024-06-15",0,0,0,0,0,0,0,0
"Cuba","2024-06-16",0,0,0,0,0,0,0,0
"Cuba","2024-06-17",0,0,0,0,0,0,0,0
"Cuba","2024-06-18",0,0,0,0,0,0,0,0
"Cuba","2024-06-19",0,0,0,0,0,0,0,0
"Cuba","2024-06-20",0,0,0,0,0,0,0,0
"Cuba","2024-06-21",0,0,0,0,0,0,0,0
"Cuba","2024-06-22",0,0,0,0,0,0,0,0
"Cuba","2024-06-23",0,0,0,0,0,0,0,0
"Cuba","2024-06-24",0,0,0,0,0,0,0,0
"Cuba","2024-06-25",0,0,0,0,0,0,0,0
"Cuba","2024-06-26",0,0,0,0,0,0,0,0
"Cuba","2024-06-27",0,0,0,0,0,0,0,0
"Cuba","2024-06-28",0,0,0,0,0,0,0,0
"Cuba","2024-06-29",0,0,0,0,0,0,0,0
"Cuba","2024-06-30",0,0,0,0,0,0,0,0
"Cuba","2024-07-01",0,0,0,0,0,0,0,0
"Cuba","2024-07-02",0,0,0,0,0,0,0,0
"Cuba","2024-07-03",0,0,0,0,0,0,0,0
"Cuba","2024-07-04",0,0,0,0,0,0,0,0
"Cuba","2024-07-05",0,0,0,0,0,0,0,0
"Cuba","2024-07-06",0,0,0,0,0,0,0,0
"Cuba","2024-07-07",0,0,0,0,0,0,0,0
"Cuba","2024-07-08",0,0,0,0,0,0,0,0
"Cuba","2024-07-09",0,0,0,0,0,0,0,0
"Cuba","2024-07-10",0,0,0,0,0,0,0,0
"Cuba","2024-07-11",0,0,0,0,0,0,0,0
"Cuba","2024-07-12",0,0,0,0,0,0,0,0
"Cuba","2024-07-13",0,0,0,0,0,0,0,0
"Cuba","2024-07-14",0,0,0,0,0,0,0,0
"Cuba","2024-07-15",0,0,0,0,0,0,0,0
"Cuba","2024-07-16",0,0,0,0,0,0,0,0
"Cuba","2024-07-17",0,0,0,0,0,0,0,0
"Cuba","2024-07-18",0,0,0,0,0,0,0,0
"Cuba","2024-07-19",0,0,0,0,0,0,0,0
"Cuba","2024-07-20",0,0,0,0,0,0,0,0
"Cuba","2024-07-21",0,0,0,0,0,0,0,0
"Cuba","2024-07-22",0,0,0,0,0,0,0,0
"Cuba","2024-07-23",0,0,0,0,0,0,0,0
"Cuba","2024-07-24",0,0,0,0,0,0,0,0
"Cuba","2024-07-25",0,0,0,0,0,0,0,0
"Cuba","2024-07-26",0,0,0,0,0,0,0,0
"Cuba","2024-07-27",0,0,0,0,0,0,0,0
"Cuba","2024-07-28",0,0,0,0,0,0,0,0
"Cuba","2024-07-29",0,0,0,0,0,0,0,0
"Cuba","2024-07-30",0,0,0,0,0,0,0,0
"Cuba","2024-07-31",0,0,0,0,0,0,0,0
"Cuba","2024-08-01",0,0,0,0,0,0,0,0
"Cuba","2024-08-02",0,0,0,0,0,0,0,0
"Cuba","2024-08-03",0,0,0,0,0,0,0,0
"Cuba","2024-08-04",0,0,0,0,0,0,0,0
"Cuba","2024-08-05",0,0,0,0,0,0,0,0
"Cuba","2024-08-06",0,0,0,0,0,0,0,0
"Cuba","2024-08-07",0,0,0,0,0,0,0,0
"Cuba","2024-08-08",0,0,0,0,0,0,0,0
"Cuba","2024-08-09",0,0,0,0,0,0,0,0
"Cuba","2024-08-10",0,0,0,0,0,0,0,0
"Cuba","2024-08-11",0,0,0,0,0,0,0,0
"Cuba","2024-08-12",0,0,0,0,0,0,0,0
"Cuba","2024-08-13",0,0,0,0,0,0,0,0
"Cuba","2024-08-14",0,0,0,0,0,0,0,0
"Cuba","2024-08-15",0,0,0,0,0,0,0,0
"Cuba","2024-08-16",0,0,0,0,0,0,0,0
"Cuba","2024-08-17",0,0,0,0,0,0,0,0
"Cuba","2024-08-18",0,0,0,0,0,0,0,0
"Cuba","2024-08-19",0,0,0,0,0,0,0,0
"Cuba","2024-08-20",0,0,0,0,0,0,0,0
"Cuba","2024-08-21",0,0,0,0,0,0,0,0
"Cuba","2024-08-22",0,0,0,0,0,0,0,0
"Cuba","2024-08-23",0,0,0,0,0,0,0,0
"Cuba","2024-08-24",0,0,0,0,0,0,0,0
"Cuba","2024-08-25",0,0,0,0,0,0,0,0
"Cuba","2024-08-26",0,0,0,0,0,0,0,0
"Cuba","2024-08-27",0,0,0,0,0,0,0,0
"Cuba","2024-08-28",0,0,0,0,0,0,0,0
"Cuba","2024-08-29",0,0,0,0,0,0,0,0
"Cuba","2024-08-30",0,0,0,0,0,0,0,0
"Cuba","2024-08-31",0,0,0,0,0,0,0,0
"Cuba","2024-09-01",0,0,0,0,0,0,0,0
"Cuba","2024-09-02",0,0,0,0,0,0,0,0
"Cuba","2024-09-03",0,0,0,0,0,0,0,0
"Cuba","2024-09-04",0,0,0,0,0,0,0,0
"Cuba","2024-09-05",0,0,0,0,0,0,0,0
"Cuba","2024-09-06",0,0,0,0,0,0,0,0
"Cuba","2024-09-07",0,0,0,0,0,0,0,0
"Cuba","2024-09-08",0,0,0,0,0,0,0,0
"Cuba","2024-09-09",0,0,0,0,0,0,0,0
"Cuba","2024-09-10",0,0,0,0,0,0,0,0
"Cuba","2024-09-11",0,0,0,0,0,0,0,0
"Cuba","2024-09-12",0,0,0,0,0,0,0,0
"Cuba","2024-09-13",0,0,0,0,0,0,0,0
"Cuba","2024-09-14",0,0,0,0,0,0,0,0
"Cuba","2024-09-15",0,0,0,0,0,0,0,0
"Cuba","2024-09-16",0,0,0,0,0,0,0,0
"Cuba","2024-09-17",0,0,0,0,0,0,0,0
"Cuba","2024-09-18",0,0,0,0,0,0,0,0
"Cuba","2024-09-19",0,0,0,0,0,0,0,0
"Cuba","2024-09-20",0,0,0,0,0,0,0,0
"Cuba","2024-09-21",0,0,0,0,0,0,0,0
"Cuba","2024-09-22",0,0,0,0,0,0,0,0
"Cuba","2024-09-23",0,0,0,0,0,0,0,0
"Cuba","2024-09-24",0,0,0,0,0,0,0,0
"Cuba","2024-09-25",0,0,0,0,0,0,0,0
"Cuba","2024-09-26",0,0,0,0,0,0,0,0
"Cuba","2024-09-27",0,0,0,0,0,0,0,0
"Cuba","2024-09-28",0,0,0,0,0,0,0,0
"Cuba","2024-09-29",0,0,0,0,0,0,0,0
"Cuba","2024-09-30",0,0,0,0,0,0,0,0
"Cuba","2024-10-01",0,0,0,0,0,0,0,0
"Cuba","2024-10-02",0,0,0,0,0,0,0,0
"Cuba","2024-10-03",0,0,0,0,0,0,0,0
"Cuba","2024-10-04",0,0,0,0,0,0,0,0
"Cuba","2024-10-05",0,0,0,0,0,0,0,0
"Cuba","2024-10-06",0,0,0,0,0,0,0,0
"Cuba","2024-10-07",0,0,0,0,0,0,0,0
"Cuba","2024-10-08",0,0,0,0,0,0,0,0
"Cuba","2024-10-09",0,0,0,0,0,0,0,0
"Cuba","2024-10-10",0,0,0,0,0,0,0,0
"Cuba","2024-10-11",0,0,0,0,0,0,0,0
"Cuba","2024-10-12",0,0,0,0,0,0,0,0
"Cuba","2024-10-13",0,0,0,0,0,0,0,0
"Cuba","2024-10-14",0,0,0,0,0,0,0,0
"Cuba","2024-10-15",0,0,0,0,0,0,0,0
"Cuba","2024-10-16",0,0,0,0,0,0,0,0
"Cuba","2024-10-17",0,0,0,0,0,0,0,0
"Cuba","2024-10-18",0,0,0,0,0,0,0,0
"Cuba","2024-10-19",0,0,0,0,0,0,0,0
"Cuba","2024-10-20",0,0,0,0,0,0,0,0
"Cuba","2024-10-21",0,0,0,0,0,0,0,0
"Cuba","2024-10-22",0,0,0,0,0,0,0,0
"Cuba","2024-10-23",0,0,0,0,0,0,0,0
"Cuba","2024-10-24",0,0,0,0,0,0,0,0
"Cuba","2024-10-25",0,0,0,0,0,0,0,0
"Cuba","2024-10-26",0,0,0,0,0,0,0,0
"Cuba","2024-10-27",0,0,0,0,0,0,0,0
"Cuba","2024-10-28",0,0,0,0,0,0,0,0
"Cuba","2024-10-29",0,0,0,0,0,0,0,0
"Cuba","2024-10-30",0,0,0,0,0,0,0,0
"Cuba","2024-10-31",0,0,0,0,0,0,0,0
"Cuba","2024-11-01",0,0,0,0,0,0,0,0
"Cuba","2024-11-02",0,0,0,0,0,0,0,0
"Cuba","2024-11-03",0,0,0,0,0,0,0,0
"Cuba","2024-11-04",0,0,0,0,0,0,0,0
"Cuba","2024-11-05",0,0,0,0,0,0,0,0
"Cuba","2024-11-06",0,0,0,0,0,0,0,0
"Cuba","2024-11-07",0,0,0,0,0,0,0,0
"Cuba","2024-11-08",0,0,0,0,0,0,0,0
"Cuba","2024-11-09",0,0,0,0,0,0,0,0
"Cuba","2024-11-10",0,0,0,0,0,0,0,0
"Cuba","2024-11-11",0,0,0,0,0,0,0,0
"Cuba","2024-11-12",0,0,0,0,0,0,0,0
"Cuba","2024-11-13",0,0,0,0,0,0,0,0
"Cuba","2024-11-14",0,0,0,0,0,0,0,0
"Cuba","2024-11-15",0,0,0,0,0,0,0,0
"Cuba","2024-11-16",0,0,0,0,0,0,0,0
"Cuba","2024-11-17",0,0,0,0,0,0,0,0
"Cuba","2024-11-18",0,0,0,0,0,0,0,0
"Cuba","2024-11-19",0,0,0,0,0,0,0,0
"Cuba","2024-11-20",0,0,0,0,0,0,0,0
"Cuba","2024-11-21",0,0,0,0,0,0,0,0
"Cuba","2024-11-22",0,0,0,0,0,0,0,0
"Cuba","2024-11-23",0,0,0,0,0,0,0,0
"Cuba","2024-11-24",0,0,0,0,0,0,0,0
"Cuba","2024-11-25",0,0,0,0,0,0,0,0
"Cuba","2024-11-26",0,0,0,0,0,0,0,0
"Cuba","2024-11-27",0,0,0,0,0,0,0,0
"Cuba","2024-11-28",0,0,0,0,0,0,0,0
"Cuba","2024-11-29",0,0,0,0,0,0,0,0
"Cuba","2024-11-30",0,0,0,0,0,0,0,0
"Cuba","2024-12-01",0,0,0,0,0,0,0,0
"Cuba","2024-12-02",0,0,0,0,0,0,0,0
"Cuba","2024-12-03",0,0,0,0,0,0,0,0
"Cuba","2024-12-04",0,0,0,0,0,0,0,0
"Cuba","2024-12-05",0,0,0,0,0,0,0,0
"Cuba","2024-12-06",0,0,0,0,0,0,0,0
"Cuba","2024-12-07",0,0,0,0,0,0,0,0
"Cuba","2024-12-08",0,0,0,0,0,0,0,0
"Cuba","2024-12-09",0,0,0,0,0,0,0,0
"Curaçao","2024-01-01",0,0,0,0,0,0,0,0
"Curaçao","2024-01-02",0,0,0,0,0,0,0,0
"Curaçao","2024-01-03",0,0,0,0,0,0,0,0
"Curaçao","2024-01-04",0,0,0,0,0,0,0,0
"Curaçao","2024-01-05",0,0,0,0,0,0,0,0
"Curaçao","2024-01-06",0,0,0,0,0,0,0,0
"Curaçao","2024-01-07",0,0,0,0,0,0,0,0
"Curaçao","2024-01-08",0,0,0,0,0,0,0,0
"Curaçao","2024-01-09",0,0,0,0,0,0,0,0
"Curaçao","2024-01-10",0,0,0,0,0,0,0,0
"Curaçao","2024-01-11",0,0,0,0,0,0,0,0
"Curaçao","2024-01-12",0,0,0,0,0,0,0,0
"Curaçao","2024-01-13",0,0,0,0,0,0,0,0
"Curaçao","2024-01-14",0,0,0,0,0,0,0,0
"Curaçao","2024-01-15",0,0,0,0,0,0,0,0
"Curaçao","2024-01-16",0,0,0,0,0,0,0,0
"Curaçao","2024-01-17",0,0,0,0,0,0,0,0
"Curaçao","2024-01-18",0,0,0,0,0,0,0,0
"Curaçao","2024-01-19",0,0,0,0,0,0,0,0
"Curaçao","2024-01-20",0,0,0,0,0,0,0,0
"Curaçao","2024-01-21",0,0,0,0,0,0,0,0
"Curaçao","2024-01-22",0,0,0,0,0,0,0,0
"Curaçao","2024-01-23",0,0,0,0,0,0,0,0
"Curaçao","2024-01-24",0,0,0,0,0,0,0,0
"Curaçao","2024-01-25",0,0,0,0,0,0,0,0
"Curaçao","2024-01-26",0,0,0,0,0,0,0,0
"Curaçao","2024-01-27",0,0,0,0,0,0,0,0
"Curaçao","2024-01-28",0,0,0,0,0,0,0,0
"Curaçao","2024-01-29",0,0,0,0,0,0,0,0
"Curaçao","2024-01-30",0,0,0,0,0,0,0,0
"Curaçao","2024-01-31",0,0,0,0,0,0,0,0
"Curaçao","2024-02-01",0,0,0,0,0,0,0,0
"Curaçao","2024-02-02",0,0,0,0,0,0,0,0
"Curaçao","2024-02-03",0,0,0,0,0,0,0,0
"Curaçao","2024-02-04",0,0,0,0,0,0,0,0
"Curaçao","2024-02-05",0,0,0,0,0,0,0,0
"Curaçao","2024-02-06",0,0,0,0,0,0,0,0
"Curaçao","2024-02-07",0,0,0,0,0,0,0,0
"Curaçao","2024-02-08",0,0,0,0,0,0,0,0
"Curaçao","2024-02-09",0,0,0,0,0,0,0,0
"Curaçao","2024-02-10",0,0,0,0,0,0,0,0
"Curaçao","2024-02-11",0,0,0,0,0,0,0,0
"Curaçao","2024-02-12",0,0,0,0,0,0,0,0
"Curaçao","2024-02-13",0,0,0,0,0,0,0,0
"Curaçao","2024-02-14",0,0,0,0,0,0,0,0
"Curaçao","2024-02-15",0,0,0,0,0,0,0,0
"Curaçao","2024-02-16",0,0,0,0,0,0,0,0
"Curaçao","2024-02-17",0,0,0,0,0,0,0,0
"Curaçao","2024-02-18",0,0,0,0,0,0,0,0
"Curaçao","2024-02-19",0,0,0,0,0,0,0,0
"Curaçao","2024-02-20",0,0,0,0,0,0,0,0
"Curaçao","2024-02-21",0,0,0,0,0,0,0,0
"Curaçao","2024-02-22",0,0,0,0,0,0,0,0
"Curaçao","2024-02-23",0,0,0,0,0,0,0,0
"Curaçao","2024-02-24",0,0,0,0,0,0,0,0
"Curaçao","2024-02-25",0,0,0,0,0,0,0,0
"Curaçao","2024-02-26",0,0,0,0,0,0,0,0
"Curaçao","2024-02-27",0,0,0,0,0,0,0,0
"Curaçao","2024-02-28",0,0,0,0,0,0,0,0
"Curaçao","2024-02-29",0,0,0,0,0,0,0,0
"Curaçao","2024-03-01",0,0,0,0,0,0,0,0
"Curaçao","2024-03-02",0,0,0,0,0,0,0,0
"Curaçao","2024-03-03",0,0,0,0,0,0,0,0
"Curaçao","2024-03-04",0,0,0,0,0,0,0,0
"Curaçao","2024-03-05",0,0,0,0,0,0,0,0
"Curaçao","2024-03-06",0,0,0,0,0,0,0,0
"Curaçao","2024-03-07",0,0,0,0,0,0,0,0
"Curaçao","2024-03-08",0,0,0,0,0,0,0,0
"Curaçao","2024-03-09",0,0,0,0,0,0,0,0
"Curaçao","2024-03-10",0,0,0,0,0,0,0,0
"Curaçao","2024-03-11",0,0,0,0,0,0,0,0
"Curaçao","2024-03-12",0,0,0,0,0,0,0,0
"Curaçao","2024-03-13",0,0,0,0,0,0,0,0
"Curaçao","2024-03-14",0,0,0,0,0,0,0,0
"Curaçao","2024-03-15",0,0,0,0,0,0,0,0
"Curaçao","2024-03-16",0,0,0,0,0,0,0,0
"Curaçao","2024-03-17",0,0,0,0,0,0,0,0
"Curaçao","2024-03-18",0,0,0,0,0,0,0,0
"Curaçao","2024-03-19",0,0,0,0,0,0,0,0
"Curaçao","2024-03-20",0,0,0,0,0,0,0,0
"Curaçao","2024-03-21",0,0,0,0,0,0,0,0
"Curaçao","2024-03-22",0,0,0,0,0,0,0,0
"Curaçao","2024-03-23",0,0,0,0,0,0,0,0
"Curaçao","2024-03-24",0,0,0,0,0,0,0,0
"Curaçao","2024-03-25",0,0,0,0,0,0,0,0
"Curaçao","2024-03-26",0,0,0,0,0,0,0,0
"Curaçao","2024-03-27",0,0,0,0,0,0,0,0
"Curaçao","2024-03-28",0,0,0,0,0,0,0,0
"Curaçao","2024-03-29",0,0,0,0,0,0,0,0
"Curaçao","2024-03-30",0,0,0,0,0,0,0,0
"Curaçao","2024-03-31",0,0,0,0,0,0,0,0
"Curaçao","2024-04-01",0,0,0,0,0,0,0,0
"Curaçao","2024-04-02",0,0,0,0,0,0,0,0
"Curaçao","2024-04-03",0,0,0,0,0,0,0,0
"Curaçao","2024-04-04",0,0,0,0,0,0,0,0
"Curaçao","2024-04-05",0,0,0,0,0,0,0,0
"Curaçao","2024-04-06",0,0,0,0,0,0,0,0
"Curaçao","2024-04-07",0,0,0,0,0,0,0,0
"Curaçao","2024-04-08",0,0,0,0,0,0,0,0
"Curaçao","2024-04-09",0,0,0,0,0,0,0,0
"Curaçao","2024-04-10",0,0,0,0,0,0,0,0
"Curaçao","2024-04-11",0,0,0,0,0,0,0,0
"Curaçao","2024-04-12",0,0,0,0,0,0,0,0
"Curaçao","2024-04-13",0,0,0,0,0,0,0,0
"Curaçao","2024-04-14",0,0,0,0,0,0,0,0
"Curaçao","2024-04-15",0,0,0,0,0,0,0,0
"Curaçao","2024-04-16",0,0,0,0,0,0,0,0
"Curaçao","2024-04-17",0,0,0,0,0,0,0,0
"Curaçao","2024-04-18",0,0,0,0,0,0,0,0
"Curaçao","2024-04-19",0,0,0,0,0,0,0,0
"Curaçao","2024-04-20",0,0,0,0,0,0,0,0
"Curaçao","2024-04-21",0,0,0,0,0,0,0,0
"Curaçao","2024-04-22",0,0,0,0,0,0,0,0
"Curaçao","2024-04-23",0,0,0,0,0,0,0,0
"Curaçao","2024-04-24",0,0,0,0,0,0,0,0
"Curaçao","2024-04-25",0,0,0,0,0,0,0,0
"Curaçao","2024-04-26",0,0,0,0,0,0,0,0
"Curaçao","2024-04-27",0,0,0,0,0,0,0,0
"Curaçao","2024-04-28",0,0,0,0,0,0,0,0
"Curaçao","2024-04-29",0,0,0,0,0,0,0,0
"Curaçao","2024-04-30",0,0,0,0,0,0,0,0
"Curaçao","2024-05-01",0,0,0,0,0,0,0,0
"Curaçao","2024-05-02",0,0,0,0,0,0,0,0
"Curaçao","2024-05-03",0,0,0,0,0,0,0,0
"Curaçao","2024-05-04",0,0,0,0,0,0,0,0
"Curaçao","2024-05-05",0,0,0,0,0,0,0,0
"Curaçao","2024-05-06",0,0,0,0,0,0,0,0
"Curaçao","2024-05-07",0,0,0,0,0,0,0,0
"Curaçao","2024-05-08",0,0,0,0,0,0,0,0
"Curaçao","2024-05-09",0,0,0,0,0,0,0,0
"Curaçao","2024-05-10",0,0,0,0,0,0,0,0
"Curaçao","2024-05-11",0,0,0,0,0,0,0,0
"Curaçao","2024-05-12",0,0,0,0,0,0,0,0
"Curaçao","2024-05-13",0,0,0,0,0,0,0,0
"Curaçao","2024-05-14",0,0,0,0,0,0,0,0
"Curaçao","2024-05-15",0,0,0,0,0,0,0,0
"Curaçao","2024-05-16",0,0,0,0,0,0,0,0
"Curaçao","2024-05-17",0,0,0,0,0,0,0,0
"Curaçao","2024-05-18",0,0,0,0,0,0,0,0
"Curaçao","2024-05-19",0,0,0,0,0,0,0,0
"Curaçao","2024-05-20",0,0,0,0,0,0,0,0
"Curaçao","2024-05-21",0,0,0,0,0,0,0,0
"Curaçao","2024-05-22",0,0,0,0,0,0,0,0
"Curaçao","2024-05-23",0,0,0,0,0,0,0,0
"Curaçao","2024-05-24",0,0,0,0,0,0,0,0
"Curaçao","2024-05-25",0,0,0,0,0,0,0,0
"Curaçao","2024-05-26",0,0,0,0,0,0,0,0
"Curaçao","2024-05-27",0,0,0,0,0,0,0,0
"Curaçao","2024-05-28",0,0,0,0,0,0,0,0
"Curaçao","2024-05-29",0,0,0,0,0,0,0,0
"Curaçao","2024-05-30",0,0,0,0,0,0,0,0
"Curaçao","2024-05-31",0,0,0,0,0,0,0,0
"Curaçao","2024-06-01",0,0,0,0,0,0,0,0
"Curaçao","2024-06-02",0,0,0,0,0,0,0,0
"Curaçao","2024-06-03",0,0,0,0,0,0,0,0
"Curaçao","2024-06-04",0,0,0,0,0,0,0,0
"Curaçao","2024-06-05",0,0,0,0,0,0,0,0
"Curaçao","2024-06-06",0,0,0,0,0,0,0,0
"Curaçao","2024-06-07",0,0,0,0,0,0,0,0
"Curaçao","2024-06-08",0,0,0,0,0,0,0,0
"Curaçao","2024-06-09",0,0,0,0,0,0,0,0
"Curaçao","2024-06-10",0,0,0,0,0,0,0,0
"Curaçao","2024-06-11",0,0,0,0,0,0,0,0
"Curaçao","2024-06-12",0,0,0,0,0,0,0,0
"Curaçao","2024-06-13",0,0,0,0,0,0,0,0
"Curaçao","2024-06-14",0,0,0,0,0,0,0,0
"Curaçao","2024-06-15",0,0,0,0,0,0,0,0
"Curaçao","2024-06-16",0,0,0,0,0,0,0,0
"Curaçao","2024-06-17",0,0,0,0,0,0,0,0
"Curaçao","2024-06-18",0,0,0,0,0,0,0,0
"Curaçao","2024-06-19",0,0,0,0,0,0,0,0
"Curaçao","2024-06-20",0,0,0,0,0,0,0,0
"Curaçao","2024-06-21",0,0,0,0,0,0,0,0
"Curaçao","2024-06-22",0,0,0,0,0,0,0,0
"Curaçao","2024-06-23",0,0,0,0,0,0,0,0
"Curaçao","2024-06-24",0,0,0,0,0,0,0,0
"Curaçao","2024-06-25",0,0,0,0,0,0,0,0
"Curaçao","2024-06-26",0,0,0,0,0,0,0,0
"Curaçao","2024-06-27",0,0,0,0,0,0,0,0
"Curaçao","2024-06-28",0,0,0,0,0,0,0,0
"Curaçao","2024-06-29",0,0,0,0,0,0,0,0
"Curaçao","2024-06-30",0,0,0,0,0,0,0,0
"Curaçao","2024-07-01",0,0,0,0,0,0,0,0
"Curaçao","2024-07-02",0,0,0,0,0,0,0,0
"Curaçao","2024-07-03",0,0,0,0,0,0,0,0
"Curaçao","2024-07-04",0,0,0,0,0,0,0,0
"Curaçao","2024-07-05",0,0,0,0,0,0,0,0
"Curaçao","2024-07-06",0,0,0,0,0,0,0,0
"Curaçao","2024-07-07",0,0,0,0,0,0,0,0
"Curaçao","2024-07-08",0,0,0,0,0,0,0,0
"Curaçao","2024-07-09",0,0,0,0,0,0,0,0
"Curaçao","2024-07-10",0,0,0,0,0,0,0,0
"Curaçao","2024-07-11",0,0,0,0,0,0,0,0
"Curaçao","2024-07-12",0,0,0,0,0,0,0,0
"Curaçao","2024-07-13",0,0,0,0,0,0,0,0
"Curaçao","2024-07-14",0,0,0,0,0,0,0,0
"Curaçao","2024-07-15",0,0,0,0,0,0,0,0
"Curaçao","2024-07-16",0,0,0,0,0,0,0,0
"Curaçao","2024-07-17",0,0,0,0,0,0,0,0
"Curaçao","2024-07-18",0,0,0,0,0,0,0,0
"Curaçao","2024-07-19",0,0,0,0,0,0,0,0
"Curaçao","2024-07-20",0,0,0,0,0,0,0,0
"Curaçao","2024-07-21",0,0,0,0,0,0,0,0
"Curaçao","2024-07-22",0,0,0,0,0,0,0,0
"Curaçao","2024-07-23",0,0,0,0,0,0,0,0
"Curaçao","2024-07-24",0,0,0,0,0,0,0,0
"Curaçao","2024-07-25",0,0,0,0,0,0,0,0
"Curaçao","2024-07-26",0,0,0,0,0,0,0,0
"Curaçao","2024-07-27",0,0,0,0,0,0,0,0
"Curaçao","2024-07-28",0,0,0,0,0,0,0,0
"Curaçao","2024-07-29",0,0,0,0,0,0,0,0
"Curaçao","2024-07-30",0,0,0,0,0,0,0,0
"Curaçao","2024-07-31",0,0,0,0,0,0,0,0
"Curaçao","2024-08-01",0,0,0,0,0,0,0,0
"Curaçao","2024-08-02",0,0,0,0,0,0,0,0
"Curaçao","2024-08-03",0,0,0,0,0,0,0,0
"Curaçao","2024-08-04",0,0,0,0,0,0,0,0
"Curaçao","2024-08-05",0,0,0,0,0,0,0,0
"Curaçao","2024-08-06",0,0,0,0,0,0,0,0
"Curaçao","2024-08-07",0,0,0,0,0,0,0,0
"Curaçao","2024-08-08",0,0,0,0,0,0,0,0
"Curaçao","2024-08-09",0,0,0,0,0,0,0,0
"Curaçao","2024-08-10",0,0,0,0,0,0,0,0
"Curaçao","2024-08-11",0,0,0,0,0,0,0,0
"Curaçao","2024-08-12",0,0,0,0,0,0,0,0
"Curaçao","2024-08-13",0,0,0,0,0,0,0,0
"Curaçao","2024-08-14",0,0,0,0,0,0,0,0
"Curaçao","2024-08-15",0,0,0,0,0,0,0,0
"Curaçao","2024-08-16",0,0,0,0,0,0,0,0
"Curaçao","2024-08-17",0,0,0,0,0,0,0,0
"Curaçao","2024-08-18",0,0,0,0,0,0,0,0
"Curaçao","2024-08-19",0,0,0,0,0,0,0,0
"Curaçao","2024-08-20",0,0,0,0,0,0,0,0
"Curaçao","2024-08-21",0,0,0,0,0,0,0,0
"Curaçao","2024-08-22",0,0,0,0,0,0,0,0
"Curaçao","2024-08-23",0,0,0,0,0,0,0,0
"Curaçao","2024-08-24",0,0,0,0,0,0,0,0
"Curaçao","2024-08-25",0,0,0,0,0,0,0,0
"Curaçao","2024-08-26",0,0,0,0,0,0,0,0
"Curaçao","2024-08-27",0,0,0,0,0,0,0,0
"Curaçao","2024-08-28",0,0,0,0,0,0,0,0
"Curaçao","2024-08-29",0,0,0,0,0,0,0,0
"Curaçao","2024-08-30",0,0,0,0,0,0,0,0
"Curaçao","2024-08-31",0,0,0,0,0,0,0,0
"Curaçao","2024-09-01",0,0,0,0,0,0,0,0
"Curaçao","2024-09-02",0,0,0,0,0,0,0,0
"Curaçao","2024-09-03",0,0,0,0,0,0,0,0
"Curaçao","2024-09-04",0,0,0,0,0,0,0,0
"Curaçao","2024-09-05",0,0,0,0,0,0,0,0
"Curaçao","2024-09-06",0,0,0,0,0,0,0,0
"Curaçao","2024-09-07",0,0,0,0,0,0,0,0
"Curaçao","2024-09-08",0,0,0,0,0,0,0,0
"Curaçao","2024-09-09",0,0,0,0,0,0,0,0
"Curaçao","2024-09-10",0,0,0,0,0,0,0,0
"Curaçao","2024-09-11",0,0,0,0,0,0,0,0
"Curaçao","2024-09-12",0,0,0,0,0,0,0,0
"Curaçao","2024-09-13",0,0,0,0,0,0,0,0
"Curaçao","2024-09-14",0,0,0,0,0,0,0,0
"Curaçao","2024-09-15",0,0,0,0,0,0,0,0
"Curaçao","2024-09-16",0,0,0,0,0,0,0,0
"Curaçao","2024-09-17",0,0,0,0,0,0,0,0
"Curaçao","2024-09-18",0,0,0,0,0,0,0,0
"Curaçao","2024-09-19",0,0,0,0,0,0,0,0
"Curaçao","2024-09-20",0,0,0,0,0,0,0,0
"Curaçao","2024-09-21",0,0,0,0,0,0,0,0
"Curaçao","2024-09-22",0,0,0,0,0,0,0,0
"Curaçao","2024-09-23",0,0,0,0,0,0,0,0
"Curaçao","2024-09-24",0,0,0,0,0,0,0,0
"Curaçao","2024-09-25",0,0,0,0,0,0,0,0
"Curaçao","2024-09-26",0,0,0,0,0,0,0,0
"Curaçao","2024-09-27",0,0,0,0,0,0,0,0
"Curaçao","2024-09-28",0,0,0,0,0,0,0,0
"Curaçao","2024-09-29",0,0,0,0,0,0,0,0
"Curaçao","2024-09-30",0,0,0,0,0,0,0,0
"Curaçao","2024-10-01",0,0,0,0,0,0,0,0
"Curaçao","2024-10-02",0,0,0,0,0,0,0,0
"Curaçao","2024-10-03",0,0,0,0,0,0,0,0
"Curaçao","2024-10-04",0,0,0,0,0,0,0,0
"Curaçao","2024-10-05",0,0,0,0,0,0,0,0
"Curaçao","2024-10-06",0,0,0,0,0,0,0,0
"Curaçao","2024-10-07",0,0,0,0,0,0,0,0
"Curaçao","2024-10-08",0,0,0,0,0,0,0,0
"Curaçao","2024-10-09",0,0,0,0,0,0,0,0
"Curaçao","2024-10-10",0,0,0,0,0,0,0,0
"Curaçao","2024-10-11",0,0,0,0,0,0,0,0
"Curaçao","2024-10-12",0,0,0,0,0,0,0,0
"Curaçao","2024-10-13",0,0,0,0,0,0,0,0
"Curaçao","2024-10-14",0,0,0,0,0,0,0,0
"Curaçao","2024-10-15",0,0,0,0,0,0,0,0
"Curaçao","2024-10-16",0,0,0,0,0,0,0,0
"Curaçao","2024-10-17",0,0,0,0,0,0,0,0
"Curaçao","2024-10-18",0,0,0,0,0,0,0,0
"Curaçao","2024-10-19",0,0,0,0,0,0,0,0
"Curaçao","2024-10-20",0,0,0,0,0,0,0,0
"Curaçao","2024-10-21",0,0,0,0,0,0,0,0
"Curaçao","2024-10-22",0,0,0,0,0,0,0,0
"Curaçao","2024-10-23",0,0,0,0,0,0,0,0
"Curaçao","2024-10-24",0,0,0,0,0,0,0,0
"Curaçao","2024-10-25",0,0,0,0,0,0,0,0
"Curaçao","2024-10-26",0,0,0,0,0,0,0,0
"Curaçao","2024-10-27",0,0,0,0,0,0,0,0
"Curaçao","2024-10-28",0,0,0,0,0,0,0,0
"Curaçao","2024-10-29",0,0,0,0,0,0,0,0
"Curaçao","2024-10-30",0,0,0,0,0,0,0,0
"Curaçao","2024-10-31",0,0,0,0,0,0,0,0
"Curaçao","2024-11-01",0,0,0,0,0,0,0,0
"Curaçao","2024-11-02",0,0,0,0,0,0,0,0
"Curaçao","2024-11-03",0,0,0,0,0,0,0,0
"Curaçao","2024-11-04",0,0,0,0,0,0,0,0
"Curaçao","2024-11-05",0,0,0,0,0,0,0,0
"Curaçao","2024-11-06",0,0,0,0,0,0,0,0
"Curaçao","2024-11-07",0,0,0,0,0,0,0,0
"Curaçao","2024-11-08",0,0,0,0,0,0,0,0
"Curaçao","2024-11-09",0,0,0,0,0,0,0,0
"Curaçao","2024-11-10",0,0,0,0,0,0,0,0
"Curaçao","2024-11-11",0,0,0,0,0,0,0,0
"Curaçao","2024-11-12",0,0,0,0,0,0,0,0
"Curaçao","2024-11-13",0,0,0,0,0,0,0,0
"Curaçao","2024-11-14",0,0,0,0,0,0,0,0
"Curaçao","2024-11-15",0,0,0,0,0,0,0,0
"Curaçao","2024-11-16",0,0,0,0,0,0,0,0
"Curaçao","2024-11-17",0,0,0,0,0,0,0,0
"Curaçao","2024-11-18",0,0,0,0,0,0,0,0
"Curaçao","2024-11-19",0,0,0,0,0,0,0,0
"Curaçao","2024-11-20",0,0,0,0,0,0,0,0
"Curaçao","2024-11-21",0,0,0,0,0,0,0,0
"Curaçao","2024-11-22",0,0,0,0,0,0,0,0
"Curaçao","2024-11-23",0,0,0,0,0,0,0,0
"Curaçao","2024-11-24",0,0,0,0,0,0,0,0
"Curaçao","2024-11-25",0,0,0,0,0,0,0,0
"Curaçao","2024-11-26",0,0,0,0,0,0,0,0
"Curaçao","2024-11-27",0,0,0,0,0,0,0,0
"Curaçao","2024-11-28",0,0,0,0,0,0,0,0
"Curaçao","2024-11-29",0,0,0,0,0,0,0,0
"Curaçao","2024-11-30",0,0,0,0,0,0,0,0
"Curaçao","2024-12-01",0,0,0,0,0,0,0,0
"Curaçao","2024-12-02",0,0,0,0,0,0,0,0
"Curaçao","2024-12-03",0,0,0,0,0,0,0,0
"Curaçao","2024-12-04",0,0,0,0,0,0,0,0
"Curaçao","2024-12-05",0,0,0,0,0,0,0,0
"Curaçao","2024-12-06",0,0,0,0,0,0,0,0
"Curaçao","2024-12-07",0,0,0,0,0,0,0,0
"Curaçao","2024-12-08",0,0,0,0,0,0,0,0
"Curaçao","2024-12-09",0,0,0,0,0,0,0,0
"Cyprus","2024-01-01",0,0,0,0,0,0,0,0
"Cyprus","2024-01-02",0,0,0,0,0,0,0,0
"Cyprus","2024-01-03",0,0,0,0,0,0,0,0
"Cyprus","2024-01-04",0,0,0,0,0,0,0,0
"Cyprus","2024-01-05",0,0,0,0,0,0,0,0
"Cyprus","2024-01-06",0,0,0,0,0,0,0,0
"Cyprus","2024-01-07",0,0,0,0,0,0,0,0
"Cyprus","2024-01-08",0,0,0,0,0,0,0,0
"Cyprus","2024-01-09",0,0,0,0,0,0,0,0
"Cyprus","2024-01-10",0,0,0,0,0,0,0,0
"Cyprus","2024-01-11",0,0,0,0,0,0,0,0
"Cyprus","2024-01-12",0,0,0,0,0,0,0,0
"Cyprus","2024-01-13",0,0,0,0,0,0,0,0
"Cyprus","2024-01-14",0,0,0,0,0,0,0,0
"Cyprus","2024-01-15",0,0,0,0,0,0,0,0
"Cyprus","2024-01-16",0,0,0,0,0,0,0,0
"Cyprus","2024-01-17",0,0,0,0,0,0,0,0
"Cyprus","2024-01-18",0,0,0,0,0,0,0,0
"Cyprus","2024-01-19",0,0,0,0,0,0,0,0
"Cyprus","2024-01-20",0,0,0,0,0,0,0,0
"Cyprus","2024-01-21",0,0,0,0,0,0,0,0
"Cyprus","2024-01-22",0,0,0,0,0,0,0,0
"Cyprus","2024-01-23",0,0,0,0,0,0,0,0
"Cyprus","2024-01-24",0,0,0,0,0,0,0,0
"Cyprus","2024-01-25",0,0,0,0,0,0,0,0
"Cyprus","2024-01-26",0,0,0,0,0,0,0,0
"Cyprus","2024-01-27",0,0,0,0,0,0,0,0
"Cyprus","2024-01-28",0,0,0,0,0,0,0,0
"Cyprus","2024-01-29",0,0,0,0,0,0,0,0
"Cyprus","2024-01-30",0,0,0,0,0,0,0,0
"Cyprus","2024-01-31",0,0,0,0,0,0,0,0
"Cyprus","2024-02-01",0,0,0,0,0,0,0,0
"Cyprus","2024-02-02",0,0,0,0,0,0,0,0
"Cyprus","2024-02-03",0,0,0,0,0,0,0,0
"Cyprus","2024-02-04",0,0,0,0,0,0,0,0
"Cyprus","2024-02-05",0,0,0,0,0,0,0,0
"Cyprus","2024-02-06",0,0,0,0,0,0,0,0
"Cyprus","2024-02-07",0,0,0,0,0,0,0,0
"Cyprus","2024-02-08",0,0,0,0,0,0,0,0
"Cyprus","2024-02-09",0,0,0,0,0,0,0,0
"Cyprus","2024-02-10",0,0,0,0,0,0,0,0
"Cyprus","2024-02-11",0,0,0,0,0,0,0,0
"Cyprus","2024-02-12",0,0,0,0,0,0,0,0
"Cyprus","2024-02-13",0,0,0,0,0,0,0,0
"Cyprus","2024-02-14",0,0,0,0,0,0,0,0
"Cyprus","2024-02-15",0,0,0,0,0,0,0,0
"Cyprus","2024-02-16",0,0,0,0,0,0,0,0
"Cyprus","2024-02-17",0,0,0,0,0,0,0,0
"Cyprus","2024-02-18",0,0,0,0,0,0,0,0
"Cyprus","2024-02-19",0,0,0,0,0,0,0,0
"Cyprus","2024-02-20",0,0,0,0,0,0,0,0
"Cyprus","2024-02-21",0,0,0,0,0,0,0,0
"Cyprus","2024-02-22",0,0,0,0,0,0,0,0
"Cyprus","2024-02-23",0,0,0,0,0,0,0,0
"Cyprus","2024-02-24",0,0,0,0,0,0,0,0
"Cyprus","2024-02-25",0,0,0,0,0,0,0,0
"Cyprus","2024-02-26",0,0,0,0,0,0,0,0
"Cyprus","2024-02-27",0,0,0,0,0,0,0,0
"Cyprus","2024-02-28",0,0,0,0,0,0,0,0
"Cyprus","2024-02-29",0,0,0,0,0,0,0,0
"Cyprus","2024-03-01",0,0,0,0,0,0,0,0
"Cyprus","2024-03-02",0,0,0,0,0,0,0,0
"Cyprus","2024-03-03",0,0,0,0,0,0,0,0
"Cyprus","2024-03-04",0,0,0,0,0,0,0,0
"Cyprus","2024-03-05",0,0,0,0,0,0,0,0
"Cyprus","2024-03-06",0,0,0,0,0,0,0,0
"Cyprus","2024-03-07",0,0,0,0,0,0,0,0
"Cyprus","2024-03-08",0,0,0,0,0,0,0,0
"Cyprus","2024-03-09",0,0,0,0,0,0,0,0
"Cyprus","2024-03-10",0,0,0,0,0,0,0,0
"Cyprus","2024-03-11",0,0,0,0,0,0,0,0
"Cyprus","2024-03-12",0,0,0,0,0,0,0,0
"Cyprus","2024-03-13",0,0,0,0,0,0,0,0
"Cyprus","2024-03-14",0,0,0,0,0,0,0,0
"Cyprus","2024-03-15",0,0,0,0,0,0,0,0
"Cyprus","2024-03-16",0,0,0,0,0,0,0,0
"Cyprus","2024-03-17",0,0,0,0,0,0,0,0
"Cyprus","2024-03-18",0,0,0,0,0,0,0,0
"Cyprus","2024-03-19",0,0,0,0,0,0,0,0
"Cyprus","2024-03-20",0,0,0,0,0,0,0,0
"Cyprus","2024-03-21",0,0,0,0,0,0,0,0
"Cyprus","2024-03-22",0,0,0,0,0,0,0,0
"Cyprus","2024-03-23",0,0,0,0,0,0,0,0
"Cyprus","2024-03-24",0,0,0,0,0,0,0,0
"Cyprus","2024-03-25",0,0,0,0,0,0,0,0
"Cyprus","2024-03-26",0,0,0,0,0,0,0,0
"Cyprus","2024-03-27",0,0,0,0,0,0,0,0
"Cyprus","2024-03-28",0,0,0,0,0,0,0,0
"Cyprus","2024-03-29",0,0,0,0,0,0,0,0
"Cyprus","2024-03-30",0,0,0,0,0,0,0,0
"Cyprus","2024-03-31",0,0,0,0,0,0,0,0
"Cyprus","2024-04-01",0,0,0,0,0,0,0,0
"Cyprus","2024-04-02",0,0,0,0,0,0,0,0
"Cyprus","2024-04-03",0,0,0,0,0,0,0,0
"Cyprus","2024-04-04",0,0,0,0,0,0,0,0
"Cyprus","2024-04-05",0,0,0,0,0,0,0,0
"Cyprus","2024-04-06",0,0,0,0,0,0,0,0
"Cyprus","2024-04-07",0,0,0,0,0,0,0,0
"Cyprus","2024-04-08",0,0,0,0,0,0,0,0
"Cyprus","2024-04-09",0,0,0,0,0,0,0,0
"Cyprus","2024-04-10",0,0,0,0,0,0,0,0
"Cyprus","2024-04-11",0,0,0,0,0,0,0,0
"Cyprus","2024-04-12",0,0,0,0,0,0,0,0
"Cyprus","2024-04-13",0,0,0,0,0,0,0,0
"Cyprus","2024-04-14",0,0,0,0,0,0,0,0
"Cyprus","2024-04-15",0,0,0,0,0,0,0,0
"Cyprus","2024-04-16",0,0,0,0,0,0,0,0
"Cyprus","2024-04-17",0,0,0,0,0,0,0,0
"Cyprus","2024-04-18",0,0,0,0,0,0,0,0
"Cyprus","2024-04-19",0,0,0,0,0,0,0,0
"Cyprus","2024-04-20",0,0,0,0,0,0,0,0
"Cyprus","2024-04-21",0,0,0,0,0,0,0,0
"Cyprus","2024-04-22",0,0,0,0,0,0,0,0
"Cyprus","2024-04-23",0,0,0,0,0,0,0,0
"Cyprus","2024-04-24",0,0,0,0,0,0,0,0
"Cyprus","2024-04-25",0,0,0,0,0,0,0,0
"Cyprus","2024-04-26",0,0,0,0,0,0,0,0
"Cyprus","2024-04-27",0,0,0,0,0,0,0,0
"Cyprus","2024-04-28",0,0,0,0,0,0,0,0
"Cyprus","2024-04-29",0,0,0,0,0,0,0,0
"Cyprus","2024-04-30",0,0,0,0,0,0,0,0
"Cyprus","2024-05-01",0,0,0,0,0,0,0,0
"Cyprus","2024-05-02",0,0,0,0,0,0,0,0
"Cyprus","2024-05-03",0,0,0,0,0,0,0,0
"Cyprus","2024-05-04",0,0,0,0,0,0,0,0
"Cyprus","2024-05-05",0,0,0,0,0,0,0,0
"Cyprus","2024-05-06",0,0,0,0,0,0,0,0
"Cyprus","2024-05-07",0,0,0,0,0,0,0,0
"Cyprus","2024-05-08",0,0,0,0,0,0,0,0
"Cyprus","2024-05-09",0,0,0,0,0,0,0,0
"Cyprus","2024-05-10",0,0,0,0,0,0,0,0
"Cyprus","2024-05-11",0,0,0,0,0,0,0,0
"Cyprus","2024-05-12",0,0,0,0,0,0,0,0
"Cyprus","2024-05-13",0,0,0,0,0,0,0,0
"Cyprus","2024-05-14",0,0,0,0,0,0,0,0
"Cyprus","2024-05-15",0,0,0,0,0,0,0,0
"Cyprus","2024-05-16",0,0,0,0,0,0,0,0
"Cyprus","2024-05-17",0,0,0,0,0,0,0,0
"Cyprus","2024-05-18",0,0,0,0,0,0,0,0
"Cyprus","2024-05-19",0,0,0,0,0,0,0,0
"Cyprus","2024-05-20",0,0,0,0,0,0,0,0
"Cyprus","2024-05-21",0,0,0,0,0,0,0,0
"Cyprus","2024-05-22",0,0,0,0,0,0,0,0
"Cyprus","2024-05-23",0,0,0,0,0,0,0,0
"Cyprus","2024-05-24",0,0,0,0,0,0,0,0
"Cyprus","2024-05-25",0,0,0,0,0,0,0,0
"Cyprus","2024-05-26",0,0,0,0,0,0,0,0
"Cyprus","2024-05-27",0,0,0,0,0,0,0,0
"Cyprus","2024-05-28",0,0,0,0,0,0,0,0
"Cyprus","2024-05-29",0,0,0,0,0,0,0,0
"Cyprus","2024-05-30",0,0,0,0,0,0,0,0
"Cyprus","2024-05-31",0,0,0,0,0,0,0,0
"Cyprus","2024-06-01",0,0,0,0,0,0,0,0
"Cyprus","2024-06-02",0,0,0,0,0,0,0,0
"Cyprus","2024-06-03",0,0,0,0,0,0,0,0
"Cyprus","2024-06-04",0,0,0,0,0,0,0,0
"Cyprus","2024-06-05",0,0,0,0,0,0,0,0
"Cyprus","2024-06-06",0,0,0,0,0,0,0,0
"Cyprus","2024-06-07",0,0,0,0,0,0,0,0
"Cyprus","2024-06-08",0,0,0,0,0,0,0,0
"Cyprus","2024-06-09",0,0,0,0,0,0,0,0
"Cyprus","2024-06-10",0,0,0,0,0,0,0,0
"Cyprus","2024-06-11",0,0,0,0,0,0,0,0
"Cyprus","2024-06-12",0,0,0,0,0,0,0,0
"Cyprus","2024-06-13",0,0,0,0,0,0,0,0
"Cyprus","2024-06-14",0,0,0,0,0,0,0,0
"Cyprus","2024-06-15",0,0,0,0,0,0,0,0
"Cyprus","2024-06-16",0,0,0,0,0,0,0,0
"Cyprus","2024-06-17",0,0,0,0,0,0,0,0
"Cyprus","2024-06-18",0,0,0,0,0,0,0,0
"Cyprus","2024-06-19",0,0,0,0,0,0,0,0
"Cyprus","2024-06-20",0,0,0,0,0,0,0,0
"Cyprus","2024-06-21",0,0,0,0,0,0,0,0
"Cyprus","2024-06-22",0,0,0,0,0,0,0,0
"Cyprus","2024-06-23",0,0,0,0,0,0,0,0
"Cyprus","2024-06-24",0,0,0,0,0,0,0,0
"Cyprus","2024-06-25",0,0,0,0,0,0,0,0
"Cyprus","2024-06-26",0,0,0,0,0,0,0,0
"Cyprus","2024-06-27",0,0,0,0,0,0,0,0
"Cyprus","2024-06-28",0,0,0,0,0,0,0,0
"Cyprus","2024-06-29",0,0,0,0,0,0,0,0
"Cyprus","2024-06-30",0,0,0,0,0,0,0,0
"Cyprus","2024-07-01",0,0,0,0,0,0,0,0
"Cyprus","2024-07-02",0,0,0,0,0,0,0,0
"Cyprus","2024-07-03",0,0,0,0,0,0,0,0
"Cyprus","2024-07-04",0,0,0,0,0,0,0,0
"Cyprus","2024-07-05",0,0,0,0,0,0,0,0
"Cyprus","2024-07-06",0,0,0,0,0,0,0,0
"Cyprus","2024-07-07",0,0,0,0,0,0,0,0
"Cyprus","2024-07-08",0,0,0,0,0,0,0,0
"Cyprus","2024-07-09",0,0,0,0,0,0,0,0
"Cyprus","2024-07-10",0,0,0,0,0,0,0,0
"Cyprus","2024-07-11",0,0,0,0,0,0,0,0
"Cyprus","2024-07-12",0,0,0,0,0,0,0,0
"Cyprus","2024-07-13",0,0,0,0,0,0,0,0
"Cyprus","2024-07-14",0,0,0,0,0,0,0,0
"Cyprus","2024-07-15",0,0,0,0,0,0,0,0
"Cyprus","2024-07-16",0,0,0,0,0,0,0,0
"Cyprus","2024-07-17",0,0,0,0,0,0,0,0
"Cyprus","2024-07-18",0,0,0,0,0,0,0,0
"Cyprus","2024-07-19",0,0,0,0,0,0,0,0
"Cyprus","2024-07-20",0,0,0,0,0,0,0,0
"Cyprus","2024-07-21",0,0,0,0,0,0,0,0
"Cyprus","2024-07-22",0,0,0,0,0,0,0,0
"Cyprus","2024-07-23",0,0,0,0,0,0,0,0
"Cyprus","2024-07-24",0,0,0,0,0,0,0,0
"Cyprus","2024-07-25",0,0,0,0,0,0,0,0
"Cyprus","2024-07-26",0,0,0,0,0,0,0,0
"Cyprus","2024-07-27",0,0,0,0,0,0,0,0
"Cyprus","2024-07-28",0,0,0,0,0,0,0,0
"Cyprus","2024-07-29",0,0,0,0,0,0,0,0
"Cyprus","2024-07-30",0,0,0,0,0,0,0,0
"Cyprus","2024-07-31",0,0,0,0,0,0,0,0
"Cyprus","2024-08-01",0,0,0,0,0,0,0,0
"Cyprus","2024-08-02",0,0,0,0,0,0,0,0
"Cyprus","2024-08-03",0,0,0,0,0,0,0,0
"Cyprus","2024-08-04",0,0,0,0,0,0,0,0
"Cyprus","2024-08-05",0,0,0,0,0,0,0,0
"Cyprus","2024-08-06",0,0,0,0,0,0,0,0
"Cyprus","2024-08-07",0,0,0,0,0,0,0,0
"Cyprus","2024-08-08",0,0,0,0,0,0,0,0
"Cyprus","2024-08-09",0,0,0,0,0,0,0,0
"Cyprus","2024-08-10",0,0,0,0,0,0,0,0
"Cyprus","2024-08-11",0,0,0,0,0,0,0,0
"Cyprus","2024-08-12",0,0,0,0,0,0,0,0
"Cyprus","2024-08-13",0,0,0,0,0,0,0,0
"Cyprus","2024-08-14",0,0,0,0,0,0,0,0
"Cyprus","2024-08-15",0,0,0,0,0,0,0,0
"Cyprus","2024-08-16",0,0,0,0,0,0,0,0
"Cyprus","2024-08-17",0,0,0,0,0,0,0,0
"Cyprus","2024-08-18",0,0,0,0,0,0,0,0
"Cyprus","2024-08-19",0,0,0,0,0,0,0,0
"Cyprus","2024-08-20",0,0,0,0,0,0,0,0
"Cyprus","2024-08-21",0,0,0,0,0,0,0,0
"Cyprus","2024-08-22",0,0,0,0,0,0,0,0
"Cyprus","2024-08-23",0,0,0,0,0,0,0,0
"Cyprus","2024-08-24",0,0,0,0,0,0,0,0
"Cyprus","2024-08-25",0,0,0,0,0,0,0,0
"Cyprus","2024-08-26",0,0,0,0,0,0,0,0
"Cyprus","2024-08-27",0,0,0,0,0,0,0,0
"Cyprus","2024-08-28",0,0,0,0,0,0,0,0
"Cyprus","2024-08-29",0,0,0,0,0,0,0,0
"Cyprus","2024-08-30",0,0,0,0,0,0,0,0
"Cyprus","2024-08-31",0,0,0,0,0,0,0,0
"Cyprus","2024-09-01",0,0,0,0,0,0,0,0
"Cyprus","2024-09-02",0,0,0,0,0,0,0,0
"Cyprus","2024-09-03",0,0,0,0,0,0,0,0
"Cyprus","2024-09-04",0,0,0,0,0,0,0,0
"Cyprus","2024-09-05",0,0,0,0,0,0,0,0
"Cyprus","2024-09-06",0,0,0,0,0,0,0,0
"Cyprus","2024-09-07",0,0,0,0,0,0,0,0
"Cyprus","2024-09-08",0,0,0,0,0,0,0,0
"Cyprus","2024-09-09",0,0,0,0,0,0,0,0
"Cyprus","2024-09-10",0,0,0,0,0,0,0,0
"Cyprus","2024-09-11",0,0,0,0,0,0,0,0
"Cyprus","2024-09-12",0,0,0,0,0,0,0,0
"Cyprus","2024-09-13",0,0,0,0,0,0,0,0
"Cyprus","2024-09-14",0,0,0,0,0,0,0,0
"Cyprus","2024-09-15",0,0,0,0,0,0,0,0
"Cyprus","2024-09-16",0,0,0,0,0,0,0,0
"Cyprus","2024-09-17",0,0,0,0,0,0,0,0
"Cyprus","2024-09-18",0,0,0,0,0,0,0,0
"Cyprus","2024-09-19",0,0,0,0,0,0,0,0
"Cyprus","2024-09-20",0,0,0,0,0,0,0,0
"Cyprus","2024-09-21",0,0,0,0,0,0,0,0
"Cyprus","2024-09-22",0,0,0,0,0,0,0,0
"Cyprus","2024-09-23",0,0,0,0,0,0,0,0
"Cyprus","2024-09-24",0,0,0,0,0,0,0,0
"Cyprus","2024-09-25",0,0,0,0,0,0,0,0
"Cyprus","2024-09-26",0,0,0,0,0,0,0,0
"Cyprus","2024-09-27",0,0,0,0,0,0,0,0
"Cyprus","2024-09-28",0,0,0,0,0,0,0,0
"Cyprus","2024-09-29",0,0,0,0,0,0,0,0
"Cyprus","2024-09-30",0,0,0,0,0,0,0,0
"Cyprus","2024-10-01",0,0,0,0,0,0,0,0
"Cyprus","2024-10-02",0,0,0,0,0,0,0,0
"Cyprus","2024-10-03",0,0,0,0,0,0,0,0
"Cyprus","2024-10-04",0,0,0,0,0,0,0,0
"Cyprus","2024-10-05",0,0,0,0,0,0,0,0
"Cyprus","2024-10-06",0,0,0,0,0,0,0,0
"Cyprus","2024-10-07",0,0,0,0,0,0,0,0
"Cyprus","2024-10-08",0,0,0,0,0,0,0,0
"Cyprus","2024-10-09",0,0,0,0,0,0,0,0
"Cyprus","2024-10-10",0,0,0,0,0,0,0,0
"Cyprus","2024-10-11",0,0,0,0,0,0,0,0
"Cyprus","2024-10-12",0,0,0,0,0,0,0,0
"Cyprus","2024-10-13",0,0,0,0,0,0,0,0
"Cyprus","2024-10-14",0,0,0,0,0,0,0,0
"Cyprus","2024-10-15",0,0,0,0,0,0,0,0
"Cyprus","2024-10-16",0,0,0,0,0,0,0,0
"Cyprus","2024-10-17",0,0,0,0,0,0,0,0
"Cyprus","2024-10-18",0,0,0,0,0,0,0,0
"Cyprus","2024-10-19",0,0,0,0,0,0,0,0
"Cyprus","2024-10-20",0,0,0,0,0,0,0,0
"Cyprus","2024-10-21",0,0,0,0,0,0,0,0
"Cyprus","2024-10-22",0,0,0,0,0,0,0,0
"Cyprus","2024-10-23",0,0,0,0,0,0,0,0
"Cyprus","2024-10-24",0,0,0,0,0,0,0,0
"Cyprus","2024-10-25",0,0,0,0,0,0,0,0
"Cyprus","2024-10-26",0,0,0,0,0,0,0,0
"Cyprus","2024-10-27",0,0,0,0,0,0,0,0
"Cyprus","2024-10-28",0,0,0,0,0,0,0,0
"Cyprus","2024-10-29",0,0,0,0,0,0,0,0
"Cyprus","2024-10-30",0,0,0,0,0,0,0,0
"Cyprus","2024-10-31",0,0,0,0,0,0,0,0
"Cyprus","2024-11-01",0,0,0,0,0,0,0,0
"Cyprus","2024-11-02",0,0,0,0,0,0,0,0
"Cyprus","2024-11-03",0,0,0,0,0,0,0,0
"Cyprus","2024-11-04",0,0,0,0,0,0,0,0
"Cyprus","2024-11-05",0,0,0,0,0,0,0,0
"Cyprus","2024-11-06",0,0,0,0,0,0,0,0
"Cyprus","2024-11-07",0,0,0,0,0,0,0,0
"Cyprus","2024-11-08",0,0,0,0,0,0,0,0
"Cyprus","2024-11-09",0,0,0,0,0,0,0,0
"Cyprus","2024-11-10",0,0,0,0,0,0,0,0
"Cyprus","2024-11-11",0,0,0,0,0,0,0,0
"Cyprus","2024-11-12",0,0,0,0,0,0,0,0
"Cyprus","2024-11-13",0,0,0,0,0,0,0,0
"Cyprus","2024-11-14",0,0,0,0,0,0,0,0
"Cyprus","2024-11-15",0,0,0,0,0,0,0,0
"Cyprus","2024-11-16",0,0,0,0,0,0,0,0
"Cyprus","2024-11-17",0,0,0,0,0,0,0,0
"Cyprus","2024-11-18",0,0,0,0,0,0,0,0
"Cyprus","2024-11-19",0,0,0,0,0,0,0,0
"Cyprus","2024-11-20",0,0,0,0,0,0,0,0
"Cyprus","2024-11-21",0,0,0,0,0,0,0,0
"Cyprus","2024-11-22",0,0,0,0,0,0,0,0
"Cyprus","2024-11-23",0,0,0,0,0,0,0,0
"Cyprus","2024-11-24",0,0,0,0,0,0,0,0
"Cyprus","2024-11-25",0,0,0,0,0,0,0,0
"Cyprus","2024-11-26",0,0,0,0,0,0,0,0
"Cyprus","2024-11-27",0,0,0,0,0,0,0,0
"Cyprus","2024-11-28",0,0,0,0,0,0,0,0
"Cyprus","2024-11-29",0,0,0,0,0,0,0,0
"Cyprus","2024-11-30",0,0,0,0,0,0,0,0
"Cyprus","2024-12-01",0,0,0,0,0,0,0,0
"Cyprus","2024-12-02",0,0,0,0,0,0,0,0
"Cyprus","2024-12-03",0,0,0,0,0,0,0,0
"Cyprus","2024-12-04",0,0,0,0,0,0,0,0
"Cyprus","2024-12-05",0,0,0,0,0,0,0,0
"Cyprus","2024-12-06",0,0,0,0,0,0,0,0
"Cyprus","2024-12-07",0,0,0,0,0,0,0,0
"Cyprus","2024-12-08",0,0,0,0,0,0,0,0
"Cyprus","2024-12-09",0,0,0,0,0,0,0,0
"Czechia","2024-01-01",0,0,0,0,0,0,0,0
"Czechia","2024-01-02",0,0,0,0,0,0,0,0
"Czechia","2024-01-03",0,0,0,0,0,0,0,0
"Czechia","2024-01-04",0,0,0,0,0,0,0,0
"Czechia","2024-01-05",0,0,0,0,0,0,0,0
"Czechia","2024-01-06",0,0,0,0,0,0,0,0
"Czechia","2024-01-07",0,0,0,0,0,0,0,0
"Czechia","2024-01-08",0,0,0,0,0,0,0,0
"Czechia","2024-01-09",0,0,0,0,0,0,0,0
"Czechia","2024-01-10",0,0,0,0,0,0,0,0
"Czechia","2024-01-11",0,0,0,0,0,0,0,0
"Czechia","2024-01-12",0,0,0,0,0,0,0,0
"Czechia","2024-01-13",0,0,0,0,0,0,0,0
"Czechia","2024-01-14",0,0,0,0,0,0,0,0
"Czechia","2024-01-15",0,0,0,0,0,0,0,0
"Czechia","2024-01-16",0,0,0,0,0,0,0,0
"Czechia","2024-01-17",0,0,0,0,0,0,0,0
"Czechia","2024-01-18",0,0,0,0,0,0,0,0
"Czechia","2024-01-19",0,0,0,0,0,0,0,0
"Czechia","2024-01-20",0,0,0,0,0,0,0,0
"Czechia","2024-01-21",0,0,0,0,0,0,0,0
"Czechia","2024-01-22",0,0,0,0,0,0,0,0
"Czechia","2024-01-23",0,0,0,0,0,0,0,0
"Czechia","2024-01-24",0,0,0,0,0,0,0,0
"Czechia","2024-01-25",0,0,0,0,0,0,0,0
"Czechia","2024-01-26",0,0,0,0,0,0,0,0
"Czechia","2024-01-27",0,0,0,0,0,0,0,0
"Czechia","2024-01-28",0,0,0,0,0,0,0,0
"Czechia","2024-01-29",0,0,0,0,0,0,0,0
"Czechia","2024-01-30",0,0,0,0,0,0,0,0
"Czechia","2024-01-31",0,1,1,0,1,1,0,0
"Czechia","2024-02-01",0,0,1,0,0,1,0,0
"Czechia","2024-02-02",0,0,1,0,0,1,0,0
"Czechia","2024-02-03",0,0,1,0,1,2,0,0
"Czechia","2024-02-04",0,0,1,0,0,2,0,0
"Czechia","2024-02-05",0,0,1,0,0,2,0,0
"Czechia","2024-02-06",0,0,1,0,0,2,0,0
"Czechia","2024-02-07",0,0,1,0,0,2,0,0
"Czechia","2024-02-08",0,0,1,0,1,3,0,0
"Czechia","2024-02-09",0,0,1,0,0,3,0,0
"Czechia","2024-02-10",0,0,1,0,0,3,0,0
"Czechia","2024-02-11",0,0,1,0,0,3,0,0
"Czechia","2024-02-12",0,0,1,0,0,3,0,0
"Czechia","2024-02-13",0,0,1,0,1,4,0,0
"Czechia","2024-02-14",0,0,1,0,0,4,0,0
"Czechia","2024-02-15",0,0,1,0,0,4,0,0
"Czechia","2024-02-16",0,0,1,0,0,4,0,0
"Czechia","2024-02-17",0,0,1,0,1,5,0,0
"Czechia","2024-02-18",0,0,1,0,0,5,0,0
"Czechia","2024-02-19",0,0,1,0,0,5,0,0
"Czechia","2024-02-20",0,0,1,0,0,5,0,0
"Czechia","2024-02-21",0,0,1,0,0,5,0,0
"Czechia","2024-02-22",0,0,1,0,1,6,0,0
"Czechia","2024-02-23",0,0,1,0,0,6,0,0
"Czechia","2024-02-24",0,0,1,0,0,6,0,0
"Czechia","2024-02-25",0,0,1,0,0,6,0,0
"Czechia","2024-02-26",0,0,1,0,0,6,0,0
"Czechia","2024-02-27",0,0,1,0,1,7,0,0
"Czechia","2024-02-28",0,0,1,0,0,7,0,0
"Czechia","2024-02-29",0,6,7,0,0,7,0,0
"Czechia","2024-03-01",0,0,7,0,0,7,0,0
"Czechia","2024-03-02",0,0,7,0,0,7,0,0
"Czechia","2024-03-03",0,0,7,0,0,7,0,0
"Czechia","2024-03-04",0,0,7,0,0,7,0,0
"Czechia","2024-03-05",0,0,7,0,0,7,0,0
"Czechia","2024-03-06",0,0,7,0,0,7,0,0
"Czechia","2024-03-07",0,0,7,0,0,7,0,0
"Czechia","2024-03-08",0,0,7,0,0,7,0,0
"Czechia","2024-03-09",0,0,7,0,0,7,0,0
"Czechia","2024-03-10",0,0,7,0,0,7,0,0
"Czechia","2024-03-11",0,0,7,0,1,8,0,0
"Czechia","2024-03-12",0,0,7,0,0,8,0,0
"Czechia","2024-03-13",0,0,7,0,0,8,0,0
"Czechia","2024-03-14",0,0,7,0,0,8,0,0
"Czechia","2024-03-15",0,0,7,0,0,8,0,0
"Czechia","2024-03-16",0,0,7,0,0,8,0,0
"Czechia","2024-03-17",0,0,7,0,0,8,0,0
"Czechia","2024-03-18",0,0,7,0,0,8,0,0
"Czechia","2024-03-19",0,0,7,0,0,8,0,0
"Czechia","2024-03-20",0,0,7,0,0,8,0,0
"Czechia","2024-03-21",0,0,7,0,0,8,0,0
"Czechia","2024-03-22",0,0,7,0,0,8,0,0
"Czechia","2024-03-23",0,0,7,0,0,8,0,0
"Czechia","2024-03-24",0,0,7,0,0,8,0,0
"Czechia","2024-03-25",0,0,7,0,0,8,0,0
"Czechia","2024-03-26",0,0,7,0,0,8,0,0
"Czechia","2024-03-27",0,0,7,0,0,8,0,0
"Czechia","2024-03-28",0,0,7,0,0,8,0,0
"Czechia","2024-03-29",0,0,7,0,0,8,0,0
"Czechia","2024-03-30",0,0,7,0,0,8,0,0
"Czechia","2024-03-31",0,0,7,0,1,9,0,0
"Czechia","2024-04-01",0,0,7,0,0,9,0,0
"Czechia","2024-04-02",0,0,7,0,0,9,0,0
"Czechia","2024-04-03",0,0,7,0,0,9,0,0
"Czechia","2024-04-04",0,0,7,0,0,9,0,0
"Czechia","2024-04-05",0,0,7,0,0,9,0,0
"Czechia","2024-04-06",0,0,7,0,0,9,0,0
"Czechia","2024-04-07",0,0,7,0,0,9,0,0
"Czechia","2024-04-08",0,0,7,0,0,9,0,0
"Czechia","2024-04-09",0,0,7,0,0,9,0,0
"Czechia","2024-04-10",0,0,7,0,0,9,0,0
"Czechia","2024-04-11",0,0,7,0,0,9,0,0
"Czechia","2024-04-12",0,0,7,0,0,9,0,0
"Czechia","2024-04-13",0,0,7,0,0,9,0,0
"Czechia","2024-04-14",0,0,7,0,0,9,0,0
"Czechia","2024-04-15",0,0,7,0,0,9,0,0
"Czechia","2024-04-16",0,0,7,0,0,9,0,0
"Czechia","2024-04-17",0,0,7,0,0,9,0,0
"Czechia","2024-04-18",0,0,7,0,0,9,0,0
"Czechia","2024-04-19",0,0,7,0,0,9,0,0
"Czechia","2024-04-20",0,0,7,0,1,10,0,0
"Czechia","2024-04-21",0,0,7,0,0,10,0,0
"Czechia","2024-04-22",0,0,7,0,0,10,0,0
"Czechia","2024-04-23",0,0,7,0,0,10,0,0
"Czechia","2024-04-24",0,0,7,0,0,10,0,0
"Czechia","2024-04-25",0,0,7,0,0,10,0,0
"Czechia","2024-04-26",0,0,7,0,0,10,0,0
"Czechia","2024-04-27",0,0,7,0,0,10,0,0
"Czechia","2024-04-28",0,0,7,0,0,10,0,0
"Czechia","2024-04-29",0,0,7,0,0,10,0,0
"Czechia","2024-04-30",0,3,10,0,0,10,0,0
"Czechia","2024-05-01",0,0,10,0,0,10,0,0
"Czechia","2024-05-02",0,0,10,0,0,10,0,0
"Czechia","2024-05-03",0,0,10,0,0,10,0,0
"Czechia","2024-05-04",0,0,10,0,0,10,0,0
"Czechia","2024-05-05",0,0,10,0,0,10,0,0
"Czechia","2024-05-06",0,0,10,0,0,10,0,0
"Czechia","2024-05-07",0,0,10,0,0,10,0,0
"Czechia","2024-05-08",0,0,10,0,0,10,0,0
"Czechia","2024-05-09",0,0,10,0,0,10,0,0
"Czechia","2024-05-10",0,0,10,0,0,10,0,0
"Czechia","2024-05-11",0,0,10,0,0,10,0,0
"Czechia","2024-05-12",0,0,10,0,0,10,0,0
"Czechia","2024-05-13",0,0,10,0,0,10,0,0
"Czechia","2024-05-14",0,0,10,0,0,10,0,0
"Czechia","2024-05-15",0,0,10,0,0,10,0,0
"Czechia","2024-05-16",0,0,10,0,1,11,0,0
"Czechia","2024-05-17",0,0,10,0,0,11,0,0
"Czechia","2024-05-18",0,0,10,0,0,11,0,0
"Czechia","2024-05-19",0,0,10,0,0,11,0,0
"Czechia","2024-05-20",0,0,10,0,0,11,0,0
"Czechia","2024-05-21",0,0,10,0,0,11,0,0
"Czechia","2024-05-22",0,0,10,0,0,11,0,0
"Czechia","2024-05-23",0,0,10,0,0,11,0,0
"Czechia","2024-05-24",0,0,10,0,0,11,0,0
"Czechia","2024-05-25",0,0,10,0,0,11,0,0
"Czechia","2024-05-26",0,0,10,0,0,11,0,0
"Czechia","2024-05-27",0,0,10,0,0,11,0,0
"Czechia","2024-05-28",0,0,10,0,0,11,0,0
"Czechia","2024-05-29",0,0,10,0,0,11,0,0
"Czechia","2024-05-30",0,0,10,0,0,11,0,0
"Czechia","2024-05-31",0,1,11,0,0,11,0,0
"Czechia","2024-06-01",0,0,11,0,0,11,0,0
"Czechia","2024-06-02",0,0,11,0,0,11,0,0
"Czechia","2024-06-03",0,0,11,0,0,11,0,0
"Czechia","2024-06-04",0,0,11,0,0,11,0,0
"Czechia","2024-06-05",0,0,11,0,0,11,0,0
"Czechia","2024-06-06",0,0,11,0,0,11,0,0
"Czechia","2024-06-07",0,0,11,0,0,11,0,0
"Czechia","2024-06-08",0,0,11,0,0,11,0,0
"Czechia","2024-06-09",0,0,11,0,0,11,0,0
"Czechia","2024-06-10",0,0,11,0,0,11,0,0
"Czechia","2024-06-11",0,0,11,0,0,11,0,0
"Czechia","2024-06-12",0,0,11,0,0,11,0,0
"Czechia","2024-06-13",0,0,11,0,0,11,0,0
"Czechia","2024-06-14",0,0,11,0,0,11,0,0
"Czechia","2024-06-15",0,0,11,0,0,11,0,0
"Czechia","2024-06-16",0,0,11,0,1,12,0,0
"Czechia","2024-06-17",0,0,11,0,0,12,0,0
"Czechia","2024-06-18",0,0,11,0,0,12,0,0
"Czechia","2024-06-19",0,0,11,0,0,12,0,0
"Czechia","2024-06-20",0,0,11,0,0,12,0,0
"Czechia","2024-06-21",0,0,11,0,0,12,0,0
"Czechia","2024-06-22",0,0,11,0,0,12,0,0
"Czechia","2024-06-23",0,0,11,0,0,12,0,0
"Czechia","2024-06-24",0,0,11,0,0,12,0,0
"Czechia","2024-06-25",0,0,11,0,0,12,0,0
"Czechia","2024-06-26",0,0,11,0,0,12,0,0
"Czechia","2024-06-27",0,0,11,0,0,12,0,0
"Czechia","2024-06-28",0,0,11,0,0,12,0,0
"Czechia","2024-06-29",0,0,11,0,0,12,0,0
"Czechia","2024-06-30",0,0,11,0,0,12,0,0
"Czechia","2024-07-01",0,0,11,0,0,12,0,0
"Czechia","2024-07-02",0,0,11,0,0,12,0,0
"Czechia","2024-07-03",0,0,11,0,0,12,0,0
"Czechia","2024-07-04",0,0,11,0,0,12,0,0
"Czechia","2024-07-05",0,0,11,0,0,12,0,0
"Czechia","2024-07-06",0,0,11,0,0,12,0,0
"Czechia","2024-07-07",0,0,11,0,0,12,0,0
"Czechia","2024-07-08",0,0,11,0,0,12,0,0
"Czechia","2024-07-09",0,0,11,0,0,12,0,0
"Czechia","2024-07-10",0,0,11,0,0,12,0,0
"Czechia","2024-07-11",0,0,11,0,0,12,0,0
"Czechia","2024-07-12",0,0,11,0,0,12,0,0
"Czechia","2024-07-13",0,0,11,0,0,12,0,0
"Czechia","2024-07-14",0,0,11,0,0,12,0,0
"Czechia","2024-07-15",0,0,11,0,0,12,0,0
"Czechia","2024-07-16",0,0,11,0,1,13,0,0
"Czechia","2024-07-17",0,0,11,0,0,13,0,0
"Czechia","2024-07-18",0,0,11,0,0,13,0,0
"Czechia","2024-07-19",0,0,11,0,0,13,0,0
"Czechia","2024-07-20",0,0,11,0,0,13,0,0
"Czechia","2024-07-21",0,0,11,0,0,13,0,0
"Czechia","2024-07-22",0,0,11,0,0,13,0,0
"Czechia","2024-07-23",0,0,11,0,0,13,0,0
"Czechia","2024-07-24",0,0,11,0,0,13,0,0
"Czechia","2024-07-25",0,0,11,0,0,13,0,0
"Czechia","2024-07-26",0,0,11,0,0,13,0,0
"Czechia","2024-07-27",0,0,11,0,0,13,0,0
"Czechia","2024-07-28",0,0,11,0,0,13,0,0
"Czechia","2024-07-29",0,0,11,0,0,13,0,0
"Czechia","2024-07-30",0,0,11,0,0,13,0,0
"Czechia","2024-07-31",0,0,11,0,0,13,0,0
"Czechia","2024-08-01",0,0,11,0,0,13,0,0
"Czechia","2024-08-02",0,0,11,0,0,13,0,0
"Czechia","2024-08-03",0,0,11,0,0,13,0,0
"Czechia","2024-08-04",0,0,11,0,0,13,0,0
"Czechia","2024-08-05",0,0,11,0,0,13,0,0
"Czechia","2024-08-06",0,0,11,0,0,13,0,0
"Czechia","2024-08-07",0,0,11,0,0,13,0,0
"Czechia","2024-08-08",0,0,11,0,0,13,0,0
"Czechia","2024-08-09",0,0,11,0,0,13,0,0
"Czechia","2024-08-10",0,0,11,0,0,13,0,0
"Czechia","2024-08-11",0,0,11,0,0,13,0,0
"Czechia","2024-08-12",0,0,11,0,0,13,0,0
"Czechia","2024-08-13",0,0,11,0,0,13,0,0
"Czechia","2024-08-14",0,0,11,0,0,13,0,0
"Czechia","2024-08-15",0,0,11,0,0,13,0,0
"Czechia","2024-08-16",0,0,11,0,1,14,0,0
"Czechia","2024-08-17",0,0,11,0,0,14,0,0
"Czechia","2024-08-18",0,0,11,0,0,14,0,0
"Czechia","2024-08-19",0,0,11,0,0,14,0,0
"Czechia","2024-08-20",0,0,11,0,0,14,0,0
"Czechia","2024-08-21",0,0,11,0,0,14,0,0
"Czechia","2024-08-22",0,0,11,0,0,14,0,0
"Czechia","2024-08-23",0,0,11,0,0,14,0,0
"Czechia","2024-08-24",0,0,11,0,0,14,0,0
"Czechia","2024-08-25",0,0,11,0,0,14,0,0
"Czechia","2024-08-26",0,0,11,0,0,14,0,0
"Czechia","2024-08-27",0,0,11,0,0,14,0,0
"Czechia","2024-08-28",0,0,11,0,0,14,0,0
"Czechia","2024-08-29",0,0,11,0,0,14,0,0
"Czechia","2024-08-30",0,0,11,0,0,14,0,0
"Czechia","2024-08-31",0,3,14,0,0,14,0,0
"Czechia","2024-09-01",0,0,14,0,0,14,0,0
"Czechia","2024-09-02",0,0,14,0,0,14,0,0
"Czechia","2024-09-03",0,0,14,0,0,14,0,0
"Czechia","2024-09-04",0,0,14,0,0,14,0,0
"Czechia","2024-09-05",0,0,14,0,0,14,0,0
"Czechia","2024-09-06",0,0,14,0,0,14,0,0
"Czechia","2024-09-07",0,0,14,0,0,14,0,0
"Czechia","2024-09-08",0,0,14,0,1,15,0,0
"Czechia","2024-09-09",0,0,14,0,0,15,0,0
"Czechia","2024-09-10",0,0,14,0,0,15,0,0
"Czechia","2024-09-11",0,0,14,0,0,15,0,0
"Czechia","2024-09-12",0,0,14,0,0,15,0,0
"Czechia","2024-09-13",0,0,14,0,0,15,0,0
"Czechia","2024-09-14",0,0,14,0,0,15,0,0
"Czechia","2024-09-15",0,0,14,0,0,15,0,0
"Czechia","2024-09-16",0,0,14,0,0,15,0,0
"Czechia","2024-09-17",0,0,14,0,0,15,0,0
"Czechia","2024-09-18",0,0,14,0,0,15,0,0
"Czechia","2024-09-19",0,0,14,0,0,15,0,0
"Czechia","2024-09-20",0,0,14,0,0,15,0,0
"Czechia","2024-09-21",0,0,14,0,0,15,0,0
"Czechia","2024-09-22",0,0,14,0,0,15,0,0
"Czechia","2024-09-23",0,0,14,0,1,16,0,0
"Czechia","2024-09-24",0,0,14,0,0,16,0,0
"Czechia","2024-09-25",0,0,14,0,0,16,0,0
"Czechia","2024-09-26",0,0,14,0,0,16,0,0
"Czechia","2024-09-27",0,0,14,0,0,16,0,0
"Czechia","2024-09-28",0,0,14,0,0,16,0,0
"Czechia","2024-09-29",0,0,14,0,0,16,0,0
"Czechia","2024-09-30",0,2,16,0,0,16,0,0
"Czechia","2024-10-01",0,0,16,0,0,16,0,0
"Czechia","2024-10-02",0,0,16,0,0,16,0,0
"Czechia","2024-10-03",0,0,16,0,0,16,0,0
"Czechia","2024-10-04",0,0,16,0,0,16,0,0
"Czechia","2024-10-05",0,0,16,0,0,16,0,0
"Czechia","2024-10-06",0,0,16,0,1,17,0,0
"Czechia","2024-10-07",0,0,16,0,0,17,0,0
"Czechia","2024-10-08",0,0,16,0,0,17,0,0
"Czechia","2024-10-09",0,0,16,0,0,17,0,0
"Czechia","2024-10-10",0,0,16,0,0,17,0,0
"Czechia","2024-10-11",0,0,16,0,0,17,0,0
"Czechia","2024-10-12",0,0,16,0,0,17,0,0
"Czechia","2024-10-13",0,0,16,0,0,17,0,0
"Czechia","2024-10-14",0,0,16,0,0,17,0,0
"Czechia","2024-10-15",0,0,16,0,0,17,0,0
"Czechia","2024-10-16",0,0,16,0,1,18,0,0
"Czechia","2024-10-17",0,0,16,0,0,18,0,0
"Czechia","2024-10-18",0,0,16,0,0,18,0,0
"Czechia","2024-10-19",0,0,16,0,0,18,0,0
"Czechia","2024-10-20",0,0,16,0,0,18,0,0
"Czechia","2024-10-21",0,0,16,0,0,18,0,0
"Czechia","2024-10-22",0,0,16,0,0,18,0,0
"Czechia","2024-10-23",0,0,16,0,0,18,0,0
"Czechia","2024-10-24",0,0,16,0,0,18,0,0
"Czechia","2024-10-25",0,0,16,0,0,18,0,0
"Czechia","2024-10-26",0,0,16,0,1,19,0,0
"Czechia","2024-10-27",0,0,16,0,0,19,0,0
"Czechia","2024-10-28",0,0,16,0,0,19,0,0
"Czechia","2024-10-29",0,0,16,0,0,19,0,0
"Czechia","2024-10-30",0,0,16,0,0,19,0,0
"Czechia","2024-10-31",0,3,19,0,0,19,0,0
"Czechia","2024-11-01",0,0,19,0,0,19,0,0
"Czechia","2024-11-02",0,0,19,0,0,19,0,0
"Czechia","2024-11-03",0,0,19,0,0,19,0,0
"Czechia","2024-11-04",0,0,19,0,0,19,0,0
"Czechia","2024-11-05",0,0,19,0,0,19,0,0
"Czechia","2024-11-06",0,0,19,0,0,19,0,0
"Czechia","2024-11-07",0,0,19,0,0,19,0,0
"Czechia","2024-11-08",0,0,19,0,0,19,0,0
"Czechia","2024-11-09",0,0,19,0,0,19,0,0
"Czechia","2024-11-10",0,0,19,0,0,19,0,0
"Czechia","2024-11-11",0,0,19,0,0,19,0,0
"Czechia","2024-11-12",0,0,19,0,0,19,0,0
"Czechia","2024-11-13",0,0,19,0,0,19,0,0
"Czechia","2024-11-14",0,0,19,0,0,19,0,0
"Czechia","2024-11-15",0,0,19,0,0,19,0,0
"Czechia","2024-11-16",0,0,19,0,0,19,0,0
"Czechia","2024-11-17",0,0,19,0,0,19,0,0
"Czechia","2024-11-18",0,0,19,0,0,19,0,0
"Czechia","2024-11-19",0,0,19,0,0,19,0,0
"Czechia","2024-11-20",0,0,19,0,0,19,0,0
"Czechia","2024-11-21",0,0,19,0,0,19,0,0
"Czechia","2024-11-22",0,0,19,0,0,19,0,0
"Czechia","2024-11-23",0,0,19,0,0,19,0,0
"Czechia","2024-11-24",0,0,19,0,0,19,0,0
"Czechia","2024-11-25",0,0,19,0,0,19,0,0
"Czechia","2024-11-26",0,0,19,0,0,19,0,0
"Czechia","2024-11-27",0,0,19,0,0,19,0,0
"Czechia","2024-11-28",0,0,19,0,0,19,0,0
"Czechia","2024-11-29",0,0,19,0,0,19,0,0
"Czechia","2024-11-30",0,0,19,0,0,19,0,0
"Czechia","2024-12-01",0,0,19,0,0,19,0,0
"Czechia","2024-12-02",0,0,19,0,0,19,0,0
"Czechia","2024-12-03",0,0,19,0,0,19,0,0
"Czechia","2024-12-04",0,0,19,0,0,19,0,0
"Czechia","2024-12-05",0,0,19,0,0,19,0,0
"Czechia","2024-12-06",0,0,19,0,0,19,0,0
"Czechia","2024-12-07",0,0,19,0,0,19,0,0
"Czechia","2024-12-08",0,0,19,0,0,19,0,0
"Czechia","2024-12-09",0,0,19,0,0,19,0,0
"Democratic Republic of the Congo","2024-01-01",0,0,0,0,0,0,0,0
"Democratic Republic of the Congo","2024-01-02",0,0,0,0,0,0,0,0
"Democratic Republic of the Congo","2024-01-03",0,0,0,0,0,0,0,0
"Democratic Republic of the Congo","2024-01-04",0,0,0,0,0,0,0,0
"Democratic Republic of the Congo","2024-01-05",0,0,0,0,0,0,0,0
"Democratic Republic of the Congo","2024-01-06",0,0,0,0,0,0,0,0
"Democratic Republic of the Congo","2024-01-07",0,58,58,0,58,58,0,0
"Democratic Republic of the Congo","2024-01-08",0,0,58,0,10,68,0,0
"Democratic Republic of the Congo","2024-01-09",0,0,58,0,11,79,0,0
"Democratic Republic of the Congo","2024-01-10",0,0,58,0,10,89,0,0
"Democratic Republic of the Congo","2024-01-11",0,0,58,0,10,99,0,0
"Democratic Republic of the Congo","2024-01-12",0,0,58,0,10,109,0,0
"Democratic Republic of the Congo","2024-01-13",0,0,58,0,11,120,0,0
"Democratic Republic of the Congo","2024-01-14",0,72,130,0,10,130,0,0
"Democratic Republic of the Congo","2024-01-15",0,0,130,0,12,142,0,0
"Democratic Republic of the Congo","2024-01-16",0,0,130,0,13,155,0,0
"Democratic Republic of the Congo","2024-01-17",0,0,130,0,12,167,0,0
"Democratic Republic of the Congo","2024-01-18",0,0,130,0,12,179,0,0
"Democratic Republic of the Congo","2024-01-19",0,0,130,0,12,191,0,0
"Democratic Republic of the Congo","2024-01-20",0,0,130,0,13,204,0,0
"Democratic Republic of the Congo","2024-01-21",0,86,216,0,12,216,0,0
"Democratic Republic of the Congo","2024-01-22",0,0,216,0,15,231,0,0
"Democratic Republic of the Congo","2024-01-23",0,0,216,0,15,246,0,0
"Democratic Republic of the Congo","2024-01-24",0,0,216,0,15,261,0,0
"Democratic Republic of the Congo","2024-01-25",0,0,216,0,16,277,0,0
"Democratic Republic of the Congo","2024-01-26",0,0,216,0,15,292,0,0
"Democratic Republic of the Congo","2024-01-27",0,0,216,0,15,307,0,0
"Democratic Republic of the Congo","2024-01-28",0,106,322,0,15,322,0,0
"Democratic Republic of the Congo","2024-01-29",0,0,322,0,10,332,0,0
"Democratic Republic of the Congo","2024-01-30",0,0,322,0,9,341,0,0
"Democratic Republic of the Congo","2024-01-31",0,0,322,0,10,351,0,0
"Democratic Republic of the Congo","2024-02-01",0,0,322,0,10,361,0,0
"Democratic Republic of the Congo","2024-02-02",0,0,322,0,10,371,0,0
"Democratic Republic of the Congo","2024-02-03",0,0,322,0,9,380,0,0
"Democratic Republic of the Congo","2024-02-04",0,68,390,0,10,390,0,0
"Democratic Republic of the Congo","2024-02-05",0,0,390,0,13,403,0,0
"Democratic Republic of the Congo","2024-02-06",0,0,390,0,13,416,0,0
"Democratic Republic of the Congo","2024-02-07",0,0,390,0,13,429,0,0
"Democratic Republic of the Congo","2024-02-08",0,0,390,0,14,443,0,0
"Democratic Republic of the Congo","2024-02-09",0,0,390,0,13,456,0,0
"Democratic Republic of the Congo","2024-02-10",1351,0,390,1351,13,469,1351,1351
"Democratic Republic of the Congo","2024-02-11",0,92,482,1351,13,482,44,1395
"Democratic Republic of the Congo","2024-02-12",0,0,482,1351,9,491,44,1439
"Democratic Republic of the Congo","2024-02-13",0,0,482,1351,9,500,45,1484
"Democratic Republic of the Congo","2024-02-14",0,0,482,1351,9,509,44,1528
"Democratic Republic of the Congo","2024-02-15",0,0,482,1351,10,519,44,1572
"Democratic Republic of the Congo","2024-02-16",0,0,482,1351,9,528,44,1616
"Democratic Republic of the Congo","2024-02-17",0,0,482,1351,9,537,45,1661
"Democratic Republic of the Congo","2024-02-18",0,64,546,1351,9,546,44,1705
"Democratic Republic of the Congo","2024-02-19",0,0,546,1351,9,555,44,1749
"Democratic Republic of the Congo","2024-02-20",0,0,546,1351,10,565,44,1793
"Democratic Republic of the Congo","2024-02-21",0,0,546,1351,9,574,44,1837
"Democratic Republic of the Congo","2024-02-22",0,0,546,1351,9,583,45,1882
"Democratic Republic of the Congo","2024-02-23",0,0,546,1351,9,592,44,1926
"Democratic Republic of the Congo","2024-02-24",0,0,546,1351,10,602,44,1970
"Democratic Republic of the Congo","2024-02-25",0,65,611,1351,9,611,44,2014
"Democratic Republic of the Congo","2024-02-26",0,0,611,1351,12,623,45,2059
"Democratic Republic of the Congo","2024-02-27",0,0,611,1351,11,634,44,2103
"Democratic Republic of the Congo","2024-02-28",0,0,611,1351,12,646,44,2147
"Democratic Republic of the Congo","2024-02-29",0,0,611,1351,12,658,44,2191
"Democratic Republic of the Congo","2024-03-01",0,0,611,1351,12,670,44,2235
"Democratic Republic of the Congo","2024-03-02",0,0,611,1351,11,681,45,2280
"Democratic Republic of the Congo","2024-03-03",0,82,693,1351,12,693,44,2324
"Democratic Republic of the Congo","2024-03-04",0,0,693,1351,9,702,44,2368
"Democratic Republic of the Congo","2024-03-05",0,0,693,1351,10,712,44,2412
"Democratic Republic of the Congo","2024-03-06",0,0,693,1351,9,721,45,2457
"Democratic Republic of the Congo","2024-03-07",0,0,693,1351,9,730,44,2501
"Democratic Republic of the Congo","2024-03-08",0,0,693,1351,9,739,44,2545
"Democratic Republic of the Congo","2024-03-09",0,0,693,1351,10,749,44,2589
"Democratic Republic of the Congo","2024-03-10",0,65,758,1351,9,758,44,2633
"Democratic Republic of the Congo","2024-03-11",0,0,758,1351,10,768,45,2678
"Democratic Republic of the Congo","2024-03-12",0,0,758,1351,11,779,44,2722
"Democratic Republic of the Congo","2024-03-13",0,0,758,1351,10,789,44,2766
"Democratic Republic of the Congo","2024-03-14",0,0,758,1351,10,799,44,2810
"Democratic Republic of the Congo","2024-03-15",0,0,758,1351,10,809,45,2855
"Democratic Republic of the Congo","2024-03-16",0,0,758,1351,11,820,44,2899
"Democratic Republic of the Congo","2024-03-17",1592,72,830,2943,10,830,44,2943
"Democratic Republic of the Congo","2024-03-18",0,0,830,2943,12,842,90,3033
"Democratic Republic of the Congo","2024-03-19",0,0,830,2943,11,853,91,3124
"Democratic Republic of the Congo","2024-03-20",0,0,830,2943,12,865,90,3214
"Democratic Republic of the Congo","2024-03-21",0,0,830,2943,12,877,91,3305
"Democratic Republic of the Congo","2024-03-22",0,0,830,2943,12,889,90,3395
"Democratic Republic of the Congo","2024-03-23",0,0,830,2943,11,900,91,3486
"Democratic Republic of the Congo","2024-03-24",633,82,912,3576,12,912,90,3576
"Democratic Republic of the Congo","2024-03-25",0,0,912,3576,10,922,119,3695
"Democratic Republic of the Congo","2024-03-26",0,0,912,3576,10,932,118,3813
"Democratic Republic of the Congo","2024-03-27",0,0,912,3576,10,942,119,3932
"Democratic Republic of the Congo","2024-03-28",0,0,912,3576,11,953,118,4050
"Democratic Republic of the Congo","2024-03-29",593,0,912,4169,10,963,119,4169
"Democratic Republic of the Congo","2024-03-30",0,0,912,4169,10,973,6,4175
"Democratic Republic of the Congo","2024-03-31",0,71,983,4169,10,983,6,4181
"Democratic Republic of the Congo","2024-04-01",0,0,983,4169,12,995,7,4188
"Democratic Republic of the Congo","2024-04-02",0,0,983,4169,13,1008,6,4194
"Democratic Republic of the Congo","2024-04-03",0,0,983,4169,12,1020,6,4200
"Democratic Republic of the Congo","2024-04-04",0,0,983,4169,12,1032,7,4207
"Democratic Republic of the Congo","2024-04-05",0,0,983,4169,12,1044,6,4213
"Democratic Republic of the Congo","2024-04-06",50,0,983,4219,13,1057,6,4219
"Democratic Republic of the Congo","2024-04-07",0,86,1069,4219,12,1069,48,4267
"Democratic Republic of the Congo","2024-04-08",0,0,1069,4219,19,1088,47,4314
"Democratic Republic of the Congo","2024-04-09",0,0,1069,4219,19,1107,48,4362
"Democratic Republic of the Congo","2024-04-10",0,0,1069,4219,19,1126,47,4409
"Democratic Republic of the Congo","2024-04-11",0,0,1069,4219,20,1146,48,4457
"Democratic Republic of the Congo","2024-04-12",0,0,1069,4219,19,1165,48,4505
"Democratic Republic of the Congo","2024-04-13",0,0,1069,4219,19,1184,47,4552
"Democratic Republic of the Congo","2024-04-14",381,134,1203,4600,19,1203,48,4600
"Democratic Republic of the Congo","2024-04-15",0,0,1203,4600,21,1224,28,4628
"Democratic Republic of the Congo","2024-04-16",0,0,1203,4600,21,1245,28,4656
"Democratic Republic of the Congo","2024-04-17",0,0,1203,4600,21,1266,28,4684
"Democratic Republic of the Congo","2024-04-18",0,0,1203,4600,22,1288,27,4711
"Democratic Republic of the Congo","2024-04-19",0,0,1203,4600,21,1309,28,4739
"Democratic Republic of the Congo","2024-04-20",167,0,1203,4767,21,1330,28,4767
"Democratic Republic of the Congo","2024-04-21",0,148,1351,4767,21,1351,25,4792
"Democratic Republic of the Congo","2024-04-22",0,0,1351,4767,24,1375,25,4817
"Democratic Republic of the Congo","2024-04-23",0,0,1351,4767,24,1399,24,4841
"Democratic Republic of the Congo","2024-04-24",0,0,1351,4767,24,1423,25,4866
"Democratic Republic of the Congo","2024-04-25",0,0,1351,4767,24,1447,25,4891
"Democratic Republic of the Congo","2024-04-26",0,0,1351,4767,24,1471,24,4915
"Democratic Republic of the Congo","2024-04-27",0,0,1351,4767,24,1495,25,4940
"Democratic Republic of the Congo","2024-04-28",198,168,1519,4965,24,1519,25,4965
"Democratic Republic of the Congo","2024-04-29",0,0,1519,4965,29,1548,69,5034
"Democratic Republic of the Congo","2024-04-30",0,0,1519,4965,29,1577,68,5102
"Democratic Republic of the Congo","2024-05-01",0,0,1519,4965,29,1606,69,5171
"Democratic Republic of the Congo","2024-05-02",0,0,1519,4965,29,1635,68,5239
"Democratic Republic of the Congo","2024-05-03",0,0,1519,4965,29,1664,69,5308
"Democratic Republic of the Congo","2024-05-04",0,0,1519,4965,29,1693,68,5376
"Democratic Republic of the Congo","2024-05-05",480,203,1722,5445,29,1722,69,5445
"Democratic Republic of the Congo","2024-05-06",0,0,1722,5445,25,1747,19,5464
"Democratic Republic of the Congo","2024-05-07",0,0,1722,5445,25,1772,20,5484
"Democratic Republic of the Congo","2024-05-08",0,0,1722,5445,25,1797,19,5503
"Democratic Republic of the Congo","2024-05-09",0,0,1722,5445,26,1823,20,5523
"Democratic Republic of the Congo","2024-05-10",0,0,1722,5445,25,1848,19,5542
"Democratic Republic of the Congo","2024-05-11",0,0,1722,5445,25,1873,20,5562
"Democratic Republic of the Congo","2024-05-12",136,176,1898,5581,25,1898,19,5581
"Democratic Republic of the Congo","2024-05-13",0,0,1898,5581,29,1927,78,5659
"Democratic Republic of the Congo","2024-05-14",0,0,1898,5581,29,1956,78,5737
"Democratic Republic of the Congo","2024-05-15",0,0,1898,5581,29,1985,78,5815
"Democratic Republic of the Congo","2024-05-16",0,0,1898,5581,28,2013,78,5893
"Democratic Republic of the Congo","2024-05-17",0,0,1898,5581,29,2042,78,5971
"Democratic Republic of the Congo","2024-05-18",468,0,1898,6049,29,2071,78,6049
"Democratic Republic of the Congo","2024-05-19",0,202,2100,6049,29,2100,50,6099
"Democratic Republic of the Congo","2024-05-20",0,0,2100,6049,27,2127,49,6148
"Democratic Republic of the Congo","2024-05-21",0,0,2100,6049,26,2153,50,6198
"Democratic Republic of the Congo","2024-05-22",0,0,2100,6049,27,2180,50,6248
"Democratic Republic of the Congo","2024-05-23",0,0,2100,6049,27,2207,50,6298
"Democratic Republic of the Congo","2024-05-24",0,0,2100,6049,27,2234,49,6347
"Democratic Republic of the Congo","2024-05-25",348,0,2100,6397,26,2260,50,6397
"Democratic Republic of the Congo","2024-05-26",0,187,2287,6397,27,2287,22,6419
"Democratic Republic of the Congo","2024-05-27",0,0,2287,6397,28,2315,22,6441
"Democratic Republic of the Congo","2024-05-28",0,0,2287,6397,27,2342,22,6463
"Democratic Republic of the Congo","2024-05-29",0,0,2287,6397,28,2370,23,6486
"Democratic Republic of the Congo","2024-05-30",0,0,2287,6397,27,2397,22,6508
"Democratic Republic of the Congo","2024-05-31",0,0,2287,6397,28,2425,22,6530
"Democratic Republic of the Congo","2024-06-01",0,0,2287,6397,27,2452,22,6552
"Democratic Republic of the Congo","2024-06-02",0,193,2480,6397,28,2480,22,6574
"Democratic Republic of the Congo","2024-06-03",0,0,2480,6397,32,2512,22,6596
"Democratic Republic of the Congo","2024-06-04",0,0,2480,6397,32,2544,22,6618
"Democratic Republic of the Congo","2024-06-05",0,0,2480,6397,32,2576,22,6640
"Democratic Republic of the Congo","2024-06-06",0,0,2480,6397,33,2609,23,6663
"Democratic Republic of the Congo","2024-06-07",0,0,2480,6397,32,2641,22,6685
"Democratic Republic of the Congo","2024-06-08",0,0,2480,6397,32,2673,22,6707
"Democratic Republic of the Congo","2024-06-09",332,225,2705,6729,32,2705,22,6729
"Democratic Republic of the Congo","2024-06-10",0,0,2705,6729,36,2741,39,6768
"Democratic Republic of the Congo","2024-06-11",0,0,2705,6729,35,2776,39,6807
"Democratic Republic of the Congo","2024-06-12",0,0,2705,6729,36,2812,39,6846
"Democratic Republic of the Congo","2024-06-13",0,0,2705,6729,36,2848,39,6885
"Democratic Republic of the Congo","2024-06-14",0,0,2705,6729,36,2884,39,6924
"Democratic Republic of the Congo","2024-06-15",0,0,2705,6729,35,2919,39,6963
"Democratic Republic of the Congo","2024-06-16",273,250,2955,7002,36,2955,39,7002
"Democratic Republic of the Congo","2024-06-17",0,0,2955,7002,39,2994,100,7102
"Democratic Republic of the Congo","2024-06-18",0,0,2955,7002,40,3034,99,7201
"Democratic Republic of the Congo","2024-06-19",0,0,2955,7002,39,3073,99,7300
"Democratic Republic of the Congo","2024-06-20",0,0,2955,7002,40,3113,100,7400
"Democratic Republic of the Congo","2024-06-21",0,0,2955,7002,39,3152,100,7500
"Democratic Republic of the Congo","2024-06-22",597,0,2955,7599,40,3192,99,7599
"Democratic Republic of the Congo","2024-06-23",0,276,3231,7599,39,3231,57,7656
"Democratic Republic of the Congo","2024-06-24",0,0,3231,7599,35,3266,57,7713
"Democratic Republic of the Congo","2024-06-25",0,0,3231,7599,34,3300,58,7771
"Democratic Republic of the Congo","2024-06-26",0,0,3231,7599,35,3335,57,7828
"Democratic Republic of the Congo","2024-06-27",0,0,3231,7599,35,3370,57,7885
"Democratic Republic of the Congo","2024-06-28",0,0,3231,7599,35,3405,58,7943
"Democratic Republic of the Congo","2024-06-29",0,0,3231,7599,34,3439,57,8000
"Democratic Republic of the Congo","2024-06-30",458,243,3474,8057,35,3474,57,8057
"Democratic Republic of the Congo","2024-07-01",0,0,3474,8057,36,3510,87,8144
"Democratic Republic of the Congo","2024-07-02",0,0,3474,8057,37,3547,88,8232
"Democratic Republic of the Congo","2024-07-03",0,0,3474,8057,36,3583,87,8319
"Democratic Republic of the Congo","2024-07-04",0,0,3474,8057,36,3619,87,8406
"Democratic Republic of the Congo","2024-07-05",0,0,3474,8057,36,3655,88,8494
"Democratic Republic of the Congo","2024-07-06",524,0,3474,8581,37,3692,87,8581
"Democratic Republic of the Congo","2024-07-07",0,254,3728,8581,36,3728,75,8656
"Democratic Republic of the Congo","2024-07-08",0,0,3728,8581,47,3775,76,8732
"Democratic Republic of the Congo","2024-07-09",0,0,3728,8581,48,3823,75,8807
"Democratic Republic of the Congo","2024-07-10",0,0,3728,8581,47,3870,75,8882
"Democratic Republic of the Congo","2024-07-11",0,0,3728,8581,48,3918,76,8958
"Democratic Republic of the Congo","2024-07-12",452,0,3728,9033,47,3965,75,9033
"Democratic Republic of the Congo","2024-07-13",0,0,3728,9033,48,4013,133,9166
"Democratic Republic of the Congo","2024-07-14",0,332,4060,9033,47,4060,133,9299
"Democratic Republic of the Congo","2024-07-15",0,0,4060,9033,61,4121,133,9432
"Democratic Republic of the Congo","2024-07-16",0,0,4060,9033,61,4182,133,9565
"Democratic Republic of the Congo","2024-07-17",0,0,4060,9033,61,4243,134,9699
"Democratic Republic of the Congo","2024-07-18",0,0,4060,9033,62,4305,133,9832
"Democratic Republic of the Congo","2024-07-19",0,0,4060,9033,61,4366,133,9965
"Democratic Republic of the Congo","2024-07-20",0,0,4060,9033,61,4427,133,10098
"Democratic Republic of the Congo","2024-07-21",0,428,4488,9033,61,4488,133,10231
"Democratic Republic of the Congo","2024-07-22",0,0,4488,9033,54,4542,133,10364
"Democratic Republic of the Congo","2024-07-23",0,0,4488,9033,54,4596,133,10497
"Democratic Republic of the Congo","2024-07-24",0,0,4488,9033,54,4650,134,10631
"Democratic Republic of the Congo","2024-07-25",0,0,4488,9033,53,4703,133,10764
"Democratic Republic of the Congo","2024-07-26",0,0,4488,9033,54,4757,133,10897
"Democratic Republic of the Congo","2024-07-27",0,0,4488,9033,54,4811,133,11030
"Democratic Republic of the Congo","2024-07-28",2130,377,4865,11163,54,4865,133,11163
"Democratic Republic of the Congo","2024-07-29",0,0,4865,11163,47,4912,100,11263
"Democratic Republic of the Congo","2024-07-30",0,0,4865,11163,47,4959,100,11363
"Democratic Republic of the Congo","2024-07-31",0,0,4865,11163,47,5006,100,11463
"Democratic Republic of the Congo","2024-08-01",0,0,4865,11163,46,5052,101,11564
"Democratic Republic of the Congo","2024-08-02",0,0,4865,11163,47,5099,100,11664
"Democratic Republic of the Congo","2024-08-03",601,0,4865,11764,47,5146,100,11764
"Democratic Republic of the Congo","2024-08-04",0,328,5193,11764,47,5193,398,12162
"Democratic Republic of the Congo","2024-08-05",0,0,5193,11764,46,5239,398,12560
"Democratic Republic of the Congo","2024-08-06",0,0,5193,11764,47,5286,398,12958
"Democratic Republic of the Congo","2024-08-07",0,0,5193,11764,46,5332,397,13355
"Democratic Republic of the Congo","2024-08-08",0,0,5193,11764,46,5378,398,13753
"Democratic Republic of the Congo","2024-08-09",2387,0,5193,14151,46,5424,398,14151
"Democratic Republic of the Congo","2024-08-10",0,0,5193,14151,47,5471,112,14263
"Democratic Republic of the Congo","2024-08-11",0,324,5517,14151,46,5517,112,14375
"Democratic Republic of the Congo","2024-08-12",0,0,5517,14151,47,5564,112,14487
"Democratic Republic of the Congo","2024-08-13",0,0,5517,14151,46,5610,111,14598
"Democratic Republic of the Congo","2024-08-14",0,0,5517,14151,47,5657,112,14710
"Democratic Republic of the Congo","2024-08-15",0,0,5517,14151,46,5703,112,14822
"Democratic Republic of the Congo","2024-08-16",783,0,5517,14934,47,5750,112,14934
"Democratic Republic of the Congo","2024-08-17",0,0,5517,14934,46,5796,197,15131
"Democratic Republic of the Congo","2024-08-18",0,326,5843,14934,47,5843,197,15328
"Democratic Republic of the Congo","2024-08-19",0,0,5843,14934,47,5890,197,15525
"Democratic Republic of the Congo","2024-08-20",0,0,5843,14934,46,5936,197,15722
"Democratic Republic of the Congo","2024-08-21",0,0,5843,14934,47,5983,196,15918
"Democratic Republic of the Congo","2024-08-22",0,0,5843,14934,47,6030,197,16115
"Democratic Republic of the Congo","2024-08-23",0,0,5843,14934,47,6077,197,16312
"Democratic Republic of the Congo","2024-08-24",0,0,5843,14934,46,6123,197,16509
"Democratic Republic of the Congo","2024-08-25",1772,327,6170,16706,47,6170,197,16706
"Democratic Republic of the Congo","2024-08-26",0,0,6170,16706,45,6215,182,16888
"Democratic Republic of the Congo","2024-08-27",0,0,6170,16706,46,6261,183,17071
"Democratic Republic of the Congo","2024-08-28",0,0,6170,16706,45,6306,183,17254
"Democratic Republic of the Congo","2024-08-29",0,0,6170,16706,45,6351,182,17436
"Democratic Republic of the Congo","2024-08-30",0,0,6170,16706,45,6396,182,17618
"Democratic Republic of the Congo","2024-08-31",1095,0,6170,17801,46,6442,183,17801
"Democratic Republic of the Congo","2024-09-01",0,317,6487,17801,45,6487,333,18134
"Democratic Republic of the Congo","2024-09-02",0,0,6487,17801,46,6533,333,18467
"Democratic Republic of the Congo","2024-09-03",0,0,6487,17801,46,6579,332,18799
"Democratic Republic of the Congo","2024-09-04",0,0,6487,17801,46,6625,333,19132
"Democratic Republic of the Congo","2024-09-05",0,0,6487,17801,47,6672,333,19465
"Democratic Republic of the Congo","2024-09-06",0,0,6487,17801,46,6718,332,19797
"Democratic Republic of the Congo","2024-09-07",0,0,6487,17801,46,6764,333,20130
"Democratic Republic of the Congo","2024-09-08",2662,323,6810,20463,46,6810,333,20463
"Democratic Republic of the Congo","2024-09-09",0,0,6810,20463,42,6852,14,20477
"Democratic Republic of the Congo","2024-09-10",0,0,6810,20463,42,6894,13,20490
"Democratic Republic of the Congo","2024-09-11",0,0,6810,20463,42,6936,14,20504
"Democratic Republic of the Congo","2024-09-12",0,0,6810,20463,42,6978,14,20518
"Democratic Republic of the Congo","2024-09-13",0,0,6810,20463,42,7020,13,20531
"Democratic Republic of the Congo","2024-09-14",0,0,6810,20463,42,7062,14,20545
"Democratic Republic of the Congo","2024-09-15",0,294,7104,20463,42,7104,14,20559
"Democratic Republic of the Congo","2024-09-16",0,0,7104,20463,47,7151,13,20572
"Democratic Republic of the Congo","2024-09-17",0,0,7104,20463,46,7197,14,20586
"Democratic Republic of the Congo","2024-09-18",0,0,7104,20463,47,7244,14,20600
"Democratic Republic of the Congo","2024-09-19",0,0,7104,20463,46,7290,13,20613
"Democratic Republic of the Congo","2024-09-20",0,0,7104,20463,47,7337,14,20627
"Democratic Republic of the Congo","2024-09-21",0,0,7104,20463,46,7383,14,20641
"Democratic Republic of the Congo","2024-09-22",0,326,7430,20463,47,7430,13,20654
"Democratic Republic of the Congo","2024-09-23",205,0,7430,20668,69,7499,14,20668
"Democratic Republic of the Congo","2024-09-24",0,0,7430,20668,69,7568,144,20812
"Democratic Republic of the Congo","2024-09-25",0,0,7430,20668,69,7637,144,20956
"Democratic Republic of the Congo","2024-09-26",0,0,7430,20668,70,7707,144,21100
"Democratic Republic of the Congo","2024-09-27",0,0,7430,20668,69,7776,143,21243
"Democratic Republic of the Congo","2024-09-28",0,0,7430,20668,69,7845,144,21387
"Democratic Republic of the Congo","2024-09-29",0,484,7914,20668,69,7914,144,21531
"Democratic Republic of the Congo","2024-09-30",1007,0,7914,21675,50,7964,144,21675
"Democratic Republic of the Congo","2024-10-01",0,0,7914,21675,50,8014,415,22090
"Democratic Republic of the Congo","2024-10-02",0,0,7914,21675,50,8064,415,22505
"Democratic Republic of the Congo","2024-10-03",0,0,7914,21675,50,8114,415,22920
"Democratic Republic of the Congo","2024-10-04",0,0,7914,21675,50,8164,414,23334
"Democratic Republic of the Congo","2024-10-05",0,0,7914,21675,50,8214,415,23749
"Democratic Republic of the Congo","2024-10-06",0,350,8264,21675,50,8264,415,24164
"Democratic Republic of the Congo","2024-10-07",0,0,8264,21675,51,8315,415,24579
"Democratic Republic of the Congo","2024-10-08",0,0,8264,21675,51,8366,415,24994
"Democratic Republic of the Congo","2024-10-09",0,0,8264,21675,51,8417,415,25409
"Democratic Republic of the Congo","2024-10-10",0,0,8264,21675,52,8469,414,25823
"Democratic Republic of the Congo","2024-10-11",0,0,8264,21675,51,8520,415,26238
"Democratic Republic of the Congo","2024-10-12",0,0,8264,21675,51,8571,415,26653
"Democratic Republic of the Congo","2024-10-13",5393,358,8622,27068,51,8622,415,27068
"Democratic Republic of the Congo","2024-10-14",0,0,8622,27068,47,8669,189,27257
"Democratic Republic of the Congo","2024-10-15",0,0,8622,27068,46,8715,189,27446
"Democratic Republic of the Congo","2024-10-16",0,0,8622,27068,47,8762,189,27635
"Democratic Republic of the Congo","2024-10-17",0,0,8622,27068,46,8808,189,27824
"Democratic Republic of the Congo","2024-10-18",0,0,8622,27068,47,8855,189,28013
"Democratic Republic of the Congo","2024-10-19",0,0,8622,27068,46,8901,189,28202
"Democratic Republic of the Congo","2024-10-20",1323,326,8948,28391,47,8948,189,28391
"Democratic Republic of the Congo","2024-10-21",0,0,8948,28391,39,8987,95,28486
"Democratic Republic of the Congo","2024-10-22",0,0,8948,28391,39,9026,96,28582
"Democratic Republic of the Congo","2024-10-23",0,0,8948,28391,39,9065,95,28677
"Democratic Republic of the Congo","2024-10-24",0,0,8948,28391,38,9103,95,28772
"Democratic Republic of the Congo","2024-10-25",0,0,8948,28391,39,9142,95,28867
"Democratic Republic of the Congo","2024-10-26",0,0,8948,28391,39,9181,96,28963
"Democratic Republic of the Congo","2024-10-27",667,272,9220,29058,39,9220,95,29058
"Democratic Republic of the Congo","2024-10-28",0,0,9220,29058,22,9242,68,29126
"Democratic Republic of the Congo","2024-10-29",0,0,9220,29058,23,9265,68,29194
"Democratic Republic of the Congo","2024-10-30",0,0,9220,29058,22,9287,68,29262
"Democratic Republic of the Congo","2024-10-31",0,0,9220,29058,22,9309,67,29329
"Democratic Republic of the Congo","2024-11-01",0,0,9220,29058,22,9331,68,29397
"Democratic Republic of the Congo","2024-11-02",0,0,9220,29058,23,9354,68,29465
"Democratic Republic of the Congo","2024-11-03",475,156,9376,29533,22,9376,68,29533
"Democratic Republic of the Congo","2024-11-04",0,0,9376,29533,12,9388,268,29801
"Democratic Republic of the Congo","2024-11-05",0,0,9376,29533,11,9399,267,30068
"Democratic Republic of the Congo","2024-11-06",0,0,9376,29533,12,9411,268,30336
"Democratic Republic of the Congo","2024-11-07",0,0,9376,29533,11,9422,267,30603
"Democratic Republic of the Congo","2024-11-08",0,0,9376,29533,12,9434,268,30871
"Democratic Republic of the Congo","2024-11-09",0,0,9376,29533,11,9445,267,31138
"Democratic Republic of the Congo","2024-11-10",0,81,9457,29533,12,9457,268,31406
"Democratic Republic of the Congo","2024-11-11",0,0,9457,29533,0,9457,267,31673
"Democratic Republic of the Congo","2024-11-12",0,0,9457,29533,0,9457,268,31941
"Democratic Republic of the Congo","2024-11-13",0,0,9457,29533,0,9457,268,32209
"Democratic Republic of the Congo","2024-11-14",0,0,9457,29533,0,9457,267,32476
"Democratic Republic of the Congo","2024-11-15",0,0,9457,29533,0,9457,268,32744
"Democratic Republic of the Congo","2024-11-16",0,0,9457,29533,0,9457,267,33011
"Democratic Republic of the Congo","2024-11-17",0,0,9457,29533,0,9457,268,33279
"Democratic Republic of the Congo","2024-11-18",0,0,9457,29533,0,9457,267,33546
"Democratic Republic of the Congo","2024-11-19",0,0,9457,29533,0,9457,268,33814
"Democratic Republic of the Congo","2024-11-20",0,0,9457,29533,0,9457,267,34081
"Democratic Republic of the Congo","2024-11-21",4816,0,9457,34349,0,9457,268,34349
"Democratic Republic of the Congo","2024-11-22",0,0,9457,34349,0,9457,0,34349
"Democratic Republic of the Congo","2024-11-23",0,0,9457,34349,0,9457,0,34349
"Democratic Republic of the Congo","2024-11-24",0,0,9457,34349,0,9457,0,34349
"Democratic Republic of the Congo","2024-11-25",0,0,9457,34349,0,9457,0,34349
"Democratic Republic of the Congo","2024-11-26",0,0,9457,34349,0,9457,0,34349
"Democratic Republic of the Congo","2024-11-27",0,0,9457,34349,0,9457,0,34349
"Democratic Republic of the Congo","2024-11-28",0,0,9457,34349,0,9457,0,34349
"Democratic Republic of the Congo","2024-11-29",0,0,9457,34349,0,9457,0,34349
"Democratic Republic of the Congo","2024-11-30",0,0,9457,34349,0,9457,0,34349
"Democratic Republic of the Congo","2024-12-01",0,0,9457,34349,0,9457,0,34349
"Democratic Republic of the Congo","2024-12-02",0,0,9457,34349,0,9457,0,34349
"Democratic Republic of the Congo","2024-12-03",0,0,9457,34349,0,9457,0,34349
"Democratic Republic of the Congo","2024-12-04",0,0,9457,34349,0,9457,0,34349
"Democratic Republic of the Congo","2024-12-05",0,0,9457,34349,0,9457,0,34349
"Democratic Republic of the Congo","2024-12-06",0,0,9457,34349,0,9457,0,34349
"Democratic Republic of the Congo","2024-12-07",0,0,9457,34349,0,9457,0,34349
"Democratic Republic of the Congo","2024-12-08",0,0,9457,34349,0,9457,0,34349
"Democratic Republic of the Congo","2024-12-09",0,0,9457,34349,0,9457,0,34349
"Denmark","2024-01-01",0,0,0,0,0,0,0,0
"Denmark","2024-01-02",0,0,0,0,0,0,0,0
"Denmark","2024-01-03",0,0,0,0,0,0,0,0
"Denmark","2024-01-04",0,0,0,0,0,0,0,0
"Denmark","2024-01-05",0,0,0,0,0,0,0,0
"Denmark","2024-01-06",0,0,0,0,0,0,0,0
"Denmark","2024-01-07",0,0,0,0,0,0,0,0
"Denmark","2024-01-08",0,0,0,0,0,0,0,0
"Denmark","2024-01-09",0,0,0,0,0,0,0,0
"Denmark","2024-01-10",0,0,0,0,0,0,0,0
"Denmark","2024-01-11",0,0,0,0,0,0,0,0
"Denmark","2024-01-12",0,0,0,0,0,0,0,0
"Denmark","2024-01-13",0,0,0,0,0,0,0,0
"Denmark","2024-01-14",0,0,0,0,0,0,0,0
"Denmark","2024-01-15",0,0,0,0,0,0,0,0
"Denmark","2024-01-16",0,0,0,0,0,0,0,0
"Denmark","2024-01-17",0,0,0,0,0,0,0,0
"Denmark","2024-01-18",0,0,0,0,0,0,0,0
"Denmark","2024-01-19",0,0,0,0,0,0,0,0
"Denmark","2024-01-20",0,0,0,0,0,0,0,0
"Denmark","2024-01-21",0,0,0,0,0,0,0,0
"Denmark","2024-01-22",0,0,0,0,0,0,0,0
"Denmark","2024-01-23",0,0,0,0,0,0,0,0
"Denmark","2024-01-24",0,0,0,0,0,0,0,0
"Denmark","2024-01-25",0,0,0,0,0,0,0,0
"Denmark","2024-01-26",0,0,0,0,0,0,0,0
"Denmark","2024-01-27",0,0,0,0,0,0,0,0
"Denmark","2024-01-28",0,0,0,0,0,0,0,0
"Denmark","2024-01-29",0,0,0,0,0,0,0,0
"Denmark","2024-01-30",0,0,0,0,0,0,0,0
"Denmark","2024-01-31",0,0,0,0,0,0,0,0
"Denmark","2024-02-01",0,0,0,0,0,0,0,0
"Denmark","2024-02-02",0,0,0,0,0,0,0,0
"Denmark","2024-02-03",0,0,0,0,0,0,0,0
"Denmark","2024-02-04",0,0,0,0,0,0,0,0
"Denmark","2024-02-05",0,0,0,0,0,0,0,0
"Denmark","2024-02-06",0,0,0,0,0,0,0,0
"Denmark","2024-02-07",0,0,0,0,0,0,0,0
"Denmark","2024-02-08",0,0,0,0,0,0,0,0
"Denmark","2024-02-09",0,0,0,0,0,0,0,0
"Denmark","2024-02-10",0,0,0,0,0,0,0,0
"Denmark","2024-02-11",0,0,0,0,0,0,0,0
"Denmark","2024-02-12",0,0,0,0,0,0,0,0
"Denmark","2024-02-13",0,0,0,0,0,0,0,0
"Denmark","2024-02-14",0,0,0,0,0,0,0,0
"Denmark","2024-02-15",0,0,0,0,0,0,0,0
"Denmark","2024-02-16",0,0,0,0,0,0,0,0
"Denmark","2024-02-17",0,0,0,0,0,0,0,0
"Denmark","2024-02-18",0,0,0,0,0,0,0,0
"Denmark","2024-02-19",0,0,0,0,0,0,0,0
"Denmark","2024-02-20",0,0,0,0,0,0,0,0
"Denmark","2024-02-21",0,0,0,0,0,0,0,0
"Denmark","2024-02-22",0,0,0,0,0,0,0,0
"Denmark","2024-02-23",0,0,0,0,0,0,0,0
"Denmark","2024-02-24",0,0,0,0,0,0,0,0
"Denmark","2024-02-25",0,0,0,0,0,0,0,0
"Denmark","2024-02-26",0,0,0,0,0,0,0,0
"Denmark","2024-02-27",0,0,0,0,0,0,0,0
"Denmark","2024-02-28",0,0,0,0,0,0,0,0
"Denmark","2024-02-29",0,0,0,0,0,0,0,0
"Denmark","2024-03-01",0,0,0,0,0,0,0,0
"Denmark","2024-03-02",0,0,0,0,0,0,0,0
"Denmark","2024-03-03",0,0,0,0,0,0,0,0
"Denmark","2024-03-04",0,0,0,0,0,0,0,0
"Denmark","2024-03-05",0,0,0,0,0,0,0,0
"Denmark","2024-03-06",0,0,0,0,0,0,0,0
"Denmark","2024-03-07",0,0,0,0,0,0,0,0
"Denmark","2024-03-08",0,0,0,0,0,0,0,0
"Denmark","2024-03-09",0,0,0,0,0,0,0,0
"Denmark","2024-03-10",0,0,0,0,0,0,0,0
"Denmark","2024-03-11",0,0,0,0,0,0,0,0
"Denmark","2024-03-12",0,0,0,0,0,0,0,0
"Denmark","2024-03-13",0,0,0,0,0,0,0,0
"Denmark","2024-03-14",0,0,0,0,0,0,0,0
"Denmark","2024-03-15",0,0,0,0,0,0,0,0
"Denmark","2024-03-16",0,0,0,0,0,0,0,0
"Denmark","2024-03-17",0,0,0,0,0,0,0,0
"Denmark","2024-03-18",0,0,0,0,0,0,0,0
"Denmark","2024-03-19",0,0,0,0,0,0,0,0
"Denmark","2024-03-20",0,0,0,0,0,0,0,0
"Denmark","2024-03-21",0,0,0,0,0,0,0,0
"Denmark","2024-03-22",0,0,0,0,0,0,0,0
"Denmark","2024-03-23",0,0,0,0,0,0,0,0
"Denmark","2024-03-24",0,0,0,0,0,0,0,0
"Denmark","2024-03-25",0,0,0,0,0,0,0,0
"Denmark","2024-03-26",0,0,0,0,0,0,0,0
"Denmark","2024-03-27",0,0,0,0,0,0,0,0
"Denmark","2024-03-28",0,0,0,0,0,0,0,0
"Denmark","2024-03-29",0,0,0,0,0,0,0,0
"Denmark","2024-03-30",0,0,0,0,0,0,0,0
"Denmark","2024-03-31",0,0,0,0,0,0,0,0
"Denmark","2024-04-01",0,0,0,0,0,0,0,0
"Denmark","2024-04-02",0,0,0,0,0,0,0,0
"Denmark","2024-04-03",0,0,0,0,0,0,0,0
"Denmark","2024-04-04",0,0,0,0,0,0,0,0
"Denmark","2024-04-05",0,0,0,0,0,0,0,0
"Denmark","2024-04-06",0,0,0,0,0,0,0,0
"Denmark","2024-04-07",0,0,0,0,0,0,0,0
"Denmark","2024-04-08",0,0,0,0,0,0,0,0
"Denmark","2024-04-09",0,0,0,0,0,0,0,0
"Denmark","2024-04-10",0,0,0,0,0,0,0,0
"Denmark","2024-04-11",0,0,0,0,0,0,0,0
"Denmark","2024-04-12",0,0,0,0,0,0,0,0
"Denmark","2024-04-13",0,0,0,0,0,0,0,0
"Denmark","2024-04-14",0,0,0,0,0,0,0,0
"Denmark","2024-04-15",0,0,0,0,0,0,0,0
"Denmark","2024-04-16",0,0,0,0,0,0,0,0
"Denmark","2024-04-17",0,0,0,0,0,0,0,0
"Denmark","2024-04-18",0,0,0,0,0,0,0,0
"Denmark","2024-04-19",0,0,0,0,0,0,0,0
"Denmark","2024-04-20",0,0,0,0,0,0,0,0
"Denmark","2024-04-21",0,0,0,0,0,0,0,0
"Denmark","2024-04-22",0,0,0,0,0,0,0,0
"Denmark","2024-04-23",0,0,0,0,0,0,0,0
"Denmark","2024-04-24",0,0,0,0,0,0,0,0
"Denmark","2024-04-25",0,0,0,0,0,0,0,0
"Denmark","2024-04-26",0,0,0,0,0,0,0,0
"Denmark","2024-04-27",0,0,0,0,0,0,0,0
"Denmark","2024-04-28",0,0,0,0,0,0,0,0
"Denmark","2024-04-29",0,0,0,0,0,0,0,0
"Denmark","2024-04-30",0,0,0,0,0,0,0,0
"Denmark","2024-05-01",0,0,0,0,0,0,0,0
"Denmark","2024-05-02",0,0,0,0,0,0,0,0
"Denmark","2024-05-03",0,0,0,0,0,0,0,0
"Denmark","2024-05-04",0,0,0,0,0,0,0,0
"Denmark","2024-05-05",0,0,0,0,0,0,0,0
"Denmark","2024-05-06",0,0,0,0,0,0,0,0
"Denmark","2024-05-07",0,0,0,0,0,0,0,0
"Denmark","2024-05-08",0,0,0,0,0,0,0,0
"Denmark","2024-05-09",0,0,0,0,0,0,0,0
"Denmark","2024-05-10",0,0,0,0,0,0,0,0
"Denmark","2024-05-11",0,0,0,0,0,0,0,0
"Denmark","2024-05-12",0,0,0,0,0,0,0,0
"Denmark","2024-05-13",0,0,0,0,0,0,0,0
"Denmark","2024-05-14",0,0,0,0,0,0,0,0
"Denmark","2024-05-15",0,0,0,0,0,0,0,0
"Denmark","2024-05-16",0,0,0,0,0,0,0,0
"Denmark","2024-05-17",0,0,0,0,0,0,0,0
"Denmark","2024-05-18",0,0,0,0,0,0,0,0
"Denmark","2024-05-19",0,0,0,0,0,0,0,0
"Denmark","2024-05-20",0,0,0,0,0,0,0,0
"Denmark","2024-05-21",0,0,0,0,0,0,0,0
"Denmark","2024-05-22",0,0,0,0,0,0,0,0
"Denmark","2024-05-23",0,0,0,0,0,0,0,0
"Denmark","2024-05-24",0,0,0,0,0,0,0,0
"Denmark","2024-05-25",0,0,0,0,0,0,0,0
"Denmark","2024-05-26",0,0,0,0,0,0,0,0
"Denmark","2024-05-27",0,0,0,0,0,0,0,0
"Denmark","2024-05-28",0,0,0,0,0,0,0,0
"Denmark","2024-05-29",0,0,0,0,0,0,0,0
"Denmark","2024-05-30",0,0,0,0,0,0,0,0
"Denmark","2024-05-31",0,0,0,0,0,0,0,0
"Denmark","2024-06-01",0,0,0,0,0,0,0,0
"Denmark","2024-06-02",0,0,0,0,0,0,0,0
"Denmark","2024-06-03",0,0,0,0,0,0,0,0
"Denmark","2024-06-04",0,0,0,0,0,0,0,0
"Denmark","2024-06-05",0,0,0,0,0,0,0,0
"Denmark","2024-06-06",0,0,0,0,0,0,0,0
"Denmark","2024-06-07",0,0,0,0,0,0,0,0
"Denmark","2024-06-08",0,0,0,0,0,0,0,0
"Denmark","2024-06-09",0,0,0,0,0,0,0,0
"Denmark","2024-06-10",0,0,0,0,0,0,0,0
"Denmark","2024-06-11",0,0,0,0,0,0,0,0
"Denmark","2024-06-12",0,0,0,0,0,0,0,0
"Denmark","2024-06-13",0,0,0,0,0,0,0,0
"Denmark","2024-06-14",0,0,0,0,0,0,0,0
"Denmark","2024-06-15",0,0,0,0,0,0,0,0
"Denmark","2024-06-16",0,0,0,0,0,0,0,0
"Denmark","2024-06-17",0,0,0,0,0,0,0,0
"Denmark","2024-06-18",0,0,0,0,0,0,0,0
"Denmark","2024-06-19",0,0,0,0,0,0,0,0
"Denmark","2024-06-20",0,0,0,0,0,0,0,0
"Denmark","2024-06-21",0,0,0,0,0,0,0,0
"Denmark","2024-06-22",0,0,0,0,0,0,0,0
"Denmark","2024-06-23",0,0,0,0,0,0,0,0
"Denmark","2024-06-24",0,0,0,0,0,0,0,0
"Denmark","2024-06-25",0,0,0,0,0,0,0,0
"Denmark","2024-06-26",0,0,0,0,0,0,0,0
"Denmark","2024-06-27",0,0,0,0,0,0,0,0
"Denmark","2024-06-28",0,0,0,0,0,0,0,0
"Denmark","2024-06-29",0,0,0,0,0,0,0,0
"Denmark","2024-06-30",0,0,0,0,0,0,0,0
"Denmark","2024-07-01",0,0,0,0,0,0,0,0
"Denmark","2024-07-02",0,0,0,0,0,0,0,0
"Denmark","2024-07-03",0,0,0,0,0,0,0,0
"Denmark","2024-07-04",0,0,0,0,0,0,0,0
"Denmark","2024-07-05",0,0,0,0,0,0,0,0
"Denmark","2024-07-06",0,0,0,0,0,0,0,0
"Denmark","2024-07-07",0,0,0,0,0,0,0,0
"Denmark","2024-07-08",0,0,0,0,0,0,0,0
"Denmark","2024-07-09",0,0,0,0,0,0,0,0
"Denmark","2024-07-10",0,0,0,0,0,0,0,0
"Denmark","2024-07-11",0,0,0,0,0,0,0,0
"Denmark","2024-07-12",0,0,0,0,0,0,0,0
"Denmark","2024-07-13",0,0,0,0,0,0,0,0
"Denmark","2024-07-14",0,0,0,0,0,0,0,0
"Denmark","2024-07-15",0,0,0,0,0,0,0,0
"Denmark","2024-07-16",0,0,0,0,0,0,0,0
"Denmark","2024-07-17",0,0,0,0,0,0,0,0
"Denmark","2024-07-18",0,0,0,0,0,0,0,0
"Denmark","2024-07-19",0,0,0,0,0,0,0,0
"Denmark","2024-07-20",0,0,0,0,0,0,0,0
"Denmark","2024-07-21",0,0,0,0,0,0,0,0
"Denmark","2024-07-22",0,0,0,0,0,0,0,0
"Denmark","2024-07-23",0,0,0,0,0,0,0,0
"Denmark","2024-07-24",0,0,0,0,0,0,0,0
"Denmark","2024-07-25",0,0,0,0,0,0,0,0
"Denmark","2024-07-26",0,0,0,0,0,0,0,0
"Denmark","2024-07-27",0,0,0,0,0,0,0,0
"Denmark","2024-07-28",0,0,0,0,0,0,0,0
"Denmark","2024-07-29",0,0,0,0,0,0,0,0
"Denmark","2024-07-30",0,0,0,0,0,0,0,0
"Denmark","2024-07-31",0,5,5,0,5,5,0,0
"Denmark","2024-08-01",0,0,5,0,0,5,0,0
"Denmark","2024-08-02",0,0,5,0,0,5,0,0
"Denmark","2024-08-03",0,0,5,0,0,5,0,0
"Denmark","2024-08-04",0,0,5,0,0,5,0,0
"Denmark","2024-08-05",0,0,5,0,0,5,0,0
"Denmark","2024-08-06",0,0,5,0,0,5,0,0
"Denmark","2024-08-07",0,0,5,0,0,5,0,0
"Denmark","2024-08-08",0,0,5,0,0,5,0,0
"Denmark","2024-08-09",0,0,5,0,0,5,0,0
"Denmark","2024-08-10",0,0,5,0,0,5,0,0
"Denmark","2024-08-11",0,0,5,0,0,5,0,0
"Denmark","2024-08-12",0,0,5,0,0,5,0,0
"Denmark","2024-08-13",0,0,5,0,0,5,0,0
"Denmark","2024-08-14",0,0,5,0,0,5,0,0
"Denmark","2024-08-15",0,0,5,0,0,5,0,0
"Denmark","2024-08-16",0,0,5,0,1,6,0,0
"Denmark","2024-08-17",0,0,5,0,0,6,0,0
"Denmark","2024-08-18",0,0,5,0,0,6,0,0
"Denmark","2024-08-19",0,0,5,0,0,6,0,0
"Denmark","2024-08-20",0,0,5,0,0,6,0,0
"Denmark","2024-08-21",0,0,5,0,0,6,0,0
"Denmark","2024-08-22",0,0,5,0,0,6,0,0
"Denmark","2024-08-23",0,0,5,0,0,6,0,0
"Denmark","2024-08-24",0,0,5,0,0,6,0,0
"Denmark","2024-08-25",0,0,5,0,0,6,0,0
"Denmark","2024-08-26",0,0,5,0,0,6,0,0
"Denmark","2024-08-27",0,0,5,0,0,6,0,0
"Denmark","2024-08-28",0,0,5,0,0,6,0,0
"Denmark","2024-08-29",0,0,5,0,0,6,0,0
"Denmark","2024-08-30",0,0,5,0,0,6,0,0
"Denmark","2024-08-31",0,1,6,0,0,6,0,0
"Denmark","2024-09-01",0,0,6,0,0,6,0,0
"Denmark","2024-09-02",0,0,6,0,0,6,0,0
"Denmark","2024-09-03",0,0,6,0,0,6,0,0
"Denmark","2024-09-04",0,0,6,0,1,7,0,0
"Denmark","2024-09-05",0,0,6,0,0,7,0,0
"Denmark","2024-09-06",0,0,6,0,0,7,0,0
"Denmark","2024-09-07",0,0,6,0,0,7,0,0
"Denmark","2024-09-08",0,0,6,0,0,7,0,0
"Denmark","2024-09-09",0,0,6,0,1,8,0,0
"Denmark","2024-09-10",0,0,6,0,0,8,0,0
"Denmark","2024-09-11",0,0,6,0,0,8,0,0
"Denmark","2024-09-12",0,0,6,0,0,8,0,0
"Denmark","2024-09-13",0,0,6,0,0,8,0,0
"Denmark","2024-09-14",0,0,6,0,0,8,0,0
"Denmark","2024-09-15",0,0,6,0,0,8,0,0
"Denmark","2024-09-16",0,0,6,0,1,9,0,0
"Denmark","2024-09-17",0,0,6,0,0,9,0,0
"Denmark","2024-09-18",0,0,6,0,0,9,0,0
"Denmark","2024-09-19",0,0,6,0,0,9,0,0
"Denmark","2024-09-20",0,0,6,0,0,9,0,0
"Denmark","2024-09-21",0,0,6,0,1,10,0,0
"Denmark","2024-09-22",0,0,6,0,0,10,0,0
"Denmark","2024-09-23",0,0,6,0,0,10,0,0
"Denmark","2024-09-24",0,0,6,0,0,10,0,0
"Denmark","2024-09-25",0,0,6,0,0,10,0,0
"Denmark","2024-09-26",0,0,6,0,0,10,0,0
"Denmark","2024-09-27",0,0,6,0,0,10,0,0
"Denmark","2024-09-28",0,0,6,0,1,11,0,0
"Denmark","2024-09-29",0,0,6,0,0,11,0,0
"Denmark","2024-09-30",0,5,11,0,0,11,0,0
"Denmark","2024-10-01",0,0,11,0,0,11,0,0
"Denmark","2024-10-02",0,0,11,0,0,11,0,0
"Denmark","2024-10-03",0,0,11,0,0,11,0,0
"Denmark","2024-10-04",0,0,11,0,0,11,0,0
"Denmark","2024-10-05",0,0,11,0,0,11,0,0
"Denmark","2024-10-06",0,0,11,0,0,11,0,0
"Denmark","2024-10-07",0,0,11,0,0,11,0,0
"Denmark","2024-10-08",0,0,11,0,0,11,0,0
"Denmark","2024-10-09",0,0,11,0,0,11,0,0
"Denmark","2024-10-10",0,0,11,0,0,11,0,0
"Denmark","2024-10-11",0,0,11,0,0,11,0,0
"Denmark","2024-10-12",0,0,11,0,0,11,0,0
"Denmark","2024-10-13",0,0,11,0,0,11,0,0
"Denmark","2024-10-14",0,0,11,0,0,11,0,0
"Denmark","2024-10-15",0,0,11,0,0,11,0,0
"Denmark","2024-10-16",0,0,11,0,0,11,0,0
"Denmark","2024-10-17",0,0,11,0,0,11,0,0
"Denmark","2024-10-18",0,0,11,0,0,11,0,0
"Denmark","2024-10-19",0,0,11,0,0,11,0,0
"Denmark","2024-10-20",0,0,11,0,0,11,0,0
"Denmark","2024-10-21",0,0,11,0,0,11,0,0
"Denmark","2024-10-22",0,0,11,0,0,11,0,0
"Denmark","2024-10-23",0,0,11,0,0,11,0,0
"Denmark","2024-10-24",0,0,11,0,0,11,0,0
"Denmark","2024-10-25",0,0,11,0,0,11,0,0
"Denmark","2024-10-26",0,0,11,0,0,11,0,0
"Denmark","2024-10-27",0,0,11,0,0,11,0,0
"Denmark","2024-10-28",0,0,11,0,0,11,0,0
"Denmark","2024-10-29",0,0,11,0,0,11,0,0
"Denmark","2024-10-30",0,0,11,0,0,11,0,0
"Denmark","2024-10-31",0,0,11,0,0,11,0,0
"Denmark","2024-11-01",0,0,11,0,0,11,0,0
"Denmark","2024-11-02",0,0,11,0,0,11,0,0
"Denmark","2024-11-03",0,0,11,0,0,11,0,0
"Denmark","2024-11-04",0,0,11,0,0,11,0,0
"Denmark","2024-11-05",0,0,11,0,0,11,0,0
"Denmark","2024-11-06",0,0,11,0,0,11,0,0
"Denmark","2024-11-07",0,0,11,0,0,11,0,0
"Denmark","2024-11-08",0,0,11,0,0,11,0,0
"Denmark","2024-11-09",0,0,11,0,0,11,0,0
"Denmark","2024-11-10",0,0,11,0,0,11,0,0
"Denmark","2024-11-11",0,0,11,0,0,11,0,0
"Denmark","2024-11-12",0,0,11,0,0,11,0,0
"Denmark","2024-11-13",0,0,11,0,0,11,0,0
"Denmark","2024-11-14",0,0,11,0,0,11,0,0
"Denmark","2024-11-15",0,0,11,0,0,11,0,0
"Denmark","2024-11-16",0,0,11,0,0,11,0,0
"Denmark","2024-11-17",0,0,11,0,0,11,0,0
"Denmark","2024-11-18",0,0,11,0,0,11,0,0
"Denmark","2024-11-19",0,0,11,0,0,11,0,0
"Denmark","2024-11-20",0,0,11,0,0,11,0,0
"Denmark","2024-11-21",0,0,11,0,0,11,0,0
"Denmark","2024-11-22",0,0,11,0,0,11,0,0
"Denmark","2024-11-23",0,0,11,0,0,11,0,0
"Denmark","2024-11-24",0,0,11,0,0,11,0,0
"Denmark","2024-11-25",0,0,11,0,0,11,0,0
"Denmark","2024-11-26",0,0,11,0,0,11,0,0
"Denmark","2024-11-27",0,0,11,0,0,11,0,0
"Denmark","2024-11-28",0,0,11,0,0,11,0,0
"Denmark","2024-11-29",0,0,11,0,0,11,0,0
"Denmark","2024-11-30",0,0,11,0,0,11,0,0
"Denmark","2024-12-01",0,0,11,0,0,11,0,0
"Denmark","2024-12-02",0,0,11,0,0,11,0,0
"Denmark","2024-12-03",0,0,11,0,0,11,0,0
"Denmark","2024-12-04",0,0,11,0,0,11,0,0
"Denmark","2024-12-05",0,0,11,0,0,11,0,0
"Denmark","2024-12-06",0,0,11,0,0,11,0,0
"Denmark","2024-12-07",0,0,11,0,0,11,0,0
"Denmark","2024-12-08",0,0,11,0,0,11,0,0
"Denmark","2024-12-09",0,0,11,0,0,11,0,0
"Dominican Republic","2024-01-01",0,0,0,0,0,0,0,0
"Dominican Republic","2024-01-02",0,0,0,0,0,0,0,0
"Dominican Republic","2024-01-03",0,0,0,0,0,0,0,0
"Dominican Republic","2024-01-04",0,0,0,0,0,0,0,0
"Dominican Republic","2024-01-05",0,0,0,0,0,0,0,0
"Dominican Republic","2024-01-06",0,0,0,0,0,0,0,0
"Dominican Republic","2024-01-07",0,0,0,0,0,0,0,0
"Dominican Republic","2024-01-08",0,0,0,0,0,0,0,0
"Dominican Republic","2024-01-09",0,0,0,0,0,0,0,0
"Dominican Republic","2024-01-10",0,0,0,0,0,0,0,0
"Dominican Republic","2024-01-11",0,0,0,0,0,0,0,0
"Dominican Republic","2024-01-12",0,0,0,0,0,0,0,0
"Dominican Republic","2024-01-13",0,0,0,0,0,0,0,0
"Dominican Republic","2024-01-14",0,0,0,0,0,0,0,0
"Dominican Republic","2024-01-15",0,0,0,0,0,0,0,0
"Dominican Republic","2024-01-16",0,0,0,0,0,0,0,0
"Dominican Republic","2024-01-17",0,0,0,0,0,0,0,0
"Dominican Republic","2024-01-18",0,0,0,0,0,0,0,0
"Dominican Republic","2024-01-19",0,0,0,0,0,0,0,0
"Dominican Republic","2024-01-20",0,0,0,0,0,0,0,0
"Dominican Republic","2024-01-21",0,0,0,0,0,0,0,0
"Dominican Republic","2024-01-22",0,0,0,0,0,0,0,0
"Dominican Republic","2024-01-23",0,0,0,0,0,0,0,0
"Dominican Republic","2024-01-24",0,0,0,0,0,0,0,0
"Dominican Republic","2024-01-25",0,0,0,0,0,0,0,0
"Dominican Republic","2024-01-26",0,0,0,0,0,0,0,0
"Dominican Republic","2024-01-27",0,0,0,0,0,0,0,0
"Dominican Republic","2024-01-28",0,0,0,0,0,0,0,0
"Dominican Republic","2024-01-29",0,0,0,0,0,0,0,0
"Dominican Republic","2024-01-30",0,0,0,0,0,0,0,0
"Dominican Republic","2024-01-31",0,0,0,0,0,0,0,0
"Dominican Republic","2024-02-01",0,0,0,0,0,0,0,0
"Dominican Republic","2024-02-02",0,0,0,0,0,0,0,0
"Dominican Republic","2024-02-03",0,0,0,0,0,0,0,0
"Dominican Republic","2024-02-04",0,0,0,0,0,0,0,0
"Dominican Republic","2024-02-05",0,0,0,0,0,0,0,0
"Dominican Republic","2024-02-06",0,0,0,0,0,0,0,0
"Dominican Republic","2024-02-07",0,0,0,0,0,0,0,0
"Dominican Republic","2024-02-08",0,0,0,0,0,0,0,0
"Dominican Republic","2024-02-09",0,0,0,0,0,0,0,0
"Dominican Republic","2024-02-10",0,0,0,0,0,0,0,0
"Dominican Republic","2024-02-11",0,0,0,0,0,0,0,0
"Dominican Republic","2024-02-12",0,0,0,0,0,0,0,0
"Dominican Republic","2024-02-13",0,0,0,0,0,0,0,0
"Dominican Republic","2024-02-14",0,0,0,0,0,0,0,0
"Dominican Republic","2024-02-15",0,0,0,0,0,0,0,0
"Dominican Republic","2024-02-16",0,0,0,0,0,0,0,0
"Dominican Republic","2024-02-17",0,0,0,0,0,0,0,0
"Dominican Republic","2024-02-18",0,0,0,0,0,0,0,0
"Dominican Republic","2024-02-19",0,0,0,0,0,0,0,0
"Dominican Republic","2024-02-20",0,2,2,0,2,2,0,0
"Dominican Republic","2024-02-21",0,0,2,0,0,2,0,0
"Dominican Republic","2024-02-22",0,0,2,0,1,3,0,0
"Dominican Republic","2024-02-23",0,0,2,0,0,3,0,0
"Dominican Republic","2024-02-24",0,0,2,0,0,3,0,0
"Dominican Republic","2024-02-25",0,0,2,0,0,3,0,0
"Dominican Republic","2024-02-26",0,0,2,0,1,4,0,0
"Dominican Republic","2024-02-27",0,2,4,0,0,4,0,0
"Dominican Republic","2024-02-28",0,0,4,0,0,4,0,0
"Dominican Republic","2024-02-29",0,0,4,0,0,4,0,0
"Dominican Republic","2024-03-01",0,0,4,0,0,4,0,0
"Dominican Republic","2024-03-02",0,0,4,0,0,4,0,0
"Dominican Republic","2024-03-03",0,0,4,0,0,4,0,0
"Dominican Republic","2024-03-04",0,0,4,0,0,4,0,0
"Dominican Republic","2024-03-05",0,0,4,0,0,4,0,0
"Dominican Republic","2024-03-06",0,0,4,0,1,5,0,0
"Dominican Republic","2024-03-07",0,0,4,0,0,5,0,0
"Dominican Republic","2024-03-08",0,0,4,0,0,5,0,0
"Dominican Republic","2024-03-09",0,0,4,0,0,5,0,0
"Dominican Republic","2024-03-10",0,0,4,0,0,5,0,0
"Dominican Republic","2024-03-11",0,0,4,0,0,5,0,0
"Dominican Republic","2024-03-12",0,1,5,0,0,5,0,0
"Dominican Republic","2024-03-13",0,0,5,0,0,5,0,0
"Dominican Republic","2024-03-14",0,0,5,0,0,5,0,0
"Dominican Republic","2024-03-15",0,0,5,0,0,5,0,0
"Dominican Republic","2024-03-16",0,0,5,0,1,6,0,0
"Dominican Republic","2024-03-17",0,0,5,0,0,6,0,0
"Dominican Republic","2024-03-18",0,0,5,0,0,6,0,0
"Dominican Republic","2024-03-19",0,1,6,0,0,6,0,0
"Dominican Republic","2024-03-20",0,0,6,0,0,6,0,0
"Dominican Republic","2024-03-21",0,0,6,0,0,6,0,0
"Dominican Republic","2024-03-22",0,0,6,0,0,6,0,0
"Dominican Republic","2024-03-23",0,0,6,0,0,6,0,0
"Dominican Republic","2024-03-24",0,0,6,0,0,6,0,0
"Dominican Republic","2024-03-25",0,0,6,0,0,6,0,0
"Dominican Republic","2024-03-26",0,0,6,0,0,6,0,0
"Dominican Republic","2024-03-27",0,0,6,0,0,6,0,0
"Dominican Republic","2024-03-28",0,0,6,0,0,6,0,0
"Dominican Republic","2024-03-29",0,0,6,0,0,6,0,0
"Dominican Republic","2024-03-30",0,0,6,0,0,6,0,0
"Dominican Republic","2024-03-31",0,0,6,0,0,6,0,0
"Dominican Republic","2024-04-01",0,0,6,0,0,6,0,0
"Dominican Republic","2024-04-02",0,0,6,0,0,6,0,0
"Dominican Republic","2024-04-03",0,0,6,0,1,7,0,0
"Dominican Republic","2024-04-04",0,0,6,0,0,7,0,0
"Dominican Republic","2024-04-05",0,0,6,0,0,7,0,0
"Dominican Republic","2024-04-06",0,0,6,0,0,7,0,0
"Dominican Republic","2024-04-07",0,0,6,0,0,7,0,0
"Dominican Republic","2024-04-08",0,0,6,0,0,7,0,0
"Dominican Republic","2024-04-09",0,0,6,0,0,7,0,0
"Dominican Republic","2024-04-10",0,0,6,0,0,7,0,0
"Dominican Republic","2024-04-11",0,0,6,0,0,7,0,0
"Dominican Republic","2024-04-12",0,0,6,0,0,7,0,0
"Dominican Republic","2024-04-13",0,0,6,0,0,7,0,0
"Dominican Republic","2024-04-14",0,0,6,0,0,7,0,0
"Dominican Republic","2024-04-15",0,0,6,0,0,7,0,0
"Dominican Republic","2024-04-16",0,1,7,0,0,7,0,0
"Dominican Republic","2024-04-17",0,0,7,0,0,7,0,0
"Dominican Republic","2024-04-18",0,0,7,0,0,7,0,0
"Dominican Republic","2024-04-19",0,0,7,0,0,7,0,0
"Dominican Republic","2024-04-20",0,0,7,0,1,8,0,0
"Dominican Republic","2024-04-21",0,0,7,0,0,8,0,0
"Dominican Republic","2024-04-22",0,0,7,0,0,8,0,0
"Dominican Republic","2024-04-23",0,1,8,0,0,8,0,0
"Dominican Republic","2024-04-24",0,0,8,0,0,8,0,0
"Dominican Republic","2024-04-25",0,0,8,0,0,8,0,0
"Dominican Republic","2024-04-26",0,0,8,0,0,8,0,0
"Dominican Republic","2024-04-27",0,0,8,0,0,8,0,0
"Dominican Republic","2024-04-28",0,0,8,0,0,8,0,0
"Dominican Republic","2024-04-29",0,0,8,0,0,8,0,0
"Dominican Republic","2024-04-30",0,0,8,0,0,8,0,0
"Dominican Republic","2024-05-01",0,0,8,0,0,8,0,0
"Dominican Republic","2024-05-02",0,0,8,0,0,8,0,0
"Dominican Republic","2024-05-03",0,0,8,0,0,8,0,0
"Dominican Republic","2024-05-04",0,0,8,0,0,8,0,0
"Dominican Republic","2024-05-05",0,0,8,0,0,8,0,0
"Dominican Republic","2024-05-06",0,0,8,0,0,8,0,0
"Dominican Republic","2024-05-07",0,0,8,0,0,8,0,0
"Dominican Republic","2024-05-08",0,0,8,0,0,8,0,0
"Dominican Republic","2024-05-09",0,0,8,0,0,8,0,0
"Dominican Republic","2024-05-10",0,0,8,0,0,8,0,0
"Dominican Republic","2024-05-11",0,0,8,0,0,8,0,0
"Dominican Republic","2024-05-12",0,0,8,0,0,8,0,0
"Dominican Republic","2024-05-13",0,0,8,0,0,8,0,0
"Dominican Republic","2024-05-14",0,0,8,0,0,8,0,0
"Dominican Republic","2024-05-15",0,0,8,0,0,8,0,0
"Dominican Republic","2024-05-16",0,0,8,0,0,8,0,0
"Dominican Republic","2024-05-17",0,0,8,0,0,8,0,0
"Dominican Republic","2024-05-18",0,0,8,0,0,8,0,0
"Dominican Republic","2024-05-19",0,0,8,0,0,8,0,0
"Dominican Republic","2024-05-20",0,0,8,0,0,8,0,0
"Dominican Republic","2024-05-21",0,0,8,0,0,8,0,0
"Dominican Republic","2024-05-22",0,0,8,0,0,8,0,0
"Dominican Republic","2024-05-23",0,0,8,0,0,8,0,0
"Dominican Republic","2024-05-24",0,0,8,0,0,8,0,0
"Dominican Republic","2024-05-25",0,0,8,0,0,8,0,0
"Dominican Republic","2024-05-26",0,0,8,0,0,8,0,0
"Dominican Republic","2024-05-27",0,0,8,0,0,8,0,0
"Dominican Republic","2024-05-28",0,0,8,0,0,8,0,0
"Dominican Republic","2024-05-29",0,0,8,0,0,8,0,0
"Dominican Republic","2024-05-30",0,0,8,0,0,8,0,0
"Dominican Republic","2024-05-31",0,0,8,0,0,8,0,0
"Dominican Republic","2024-06-01",0,0,8,0,0,8,0,0
"Dominican Republic","2024-06-02",0,0,8,0,0,8,0,0
"Dominican Republic","2024-06-03",0,0,8,0,0,8,0,0
"Dominican Republic","2024-06-04",0,0,8,0,0,8,0,0
"Dominican Republic","2024-06-05",0,0,8,0,0,8,0,0
"Dominican Republic","2024-06-06",0,0,8,0,0,8,0,0
"Dominican Republic","2024-06-07",0,0,8,0,0,8,0,0
"Dominican Republic","2024-06-08",0,0,8,0,0,8,0,0
"Dominican Republic","2024-06-09",0,0,8,0,0,8,0,0
"Dominican Republic","2024-06-10",0,0,8,0,0,8,0,0
"Dominican Republic","2024-06-11",0,0,8,0,0,8,0,0
"Dominican Republic","2024-06-12",0,0,8,0,0,8,0,0
"Dominican Republic","2024-06-13",0,0,8,0,0,8,0,0
"Dominican Republic","2024-06-14",0,0,8,0,0,8,0,0
"Dominican Republic","2024-06-15",0,0,8,0,0,8,0,0
"Dominican Republic","2024-06-16",0,0,8,0,0,8,0,0
"Dominican Republic","2024-06-17",0,0,8,0,0,8,0,0
"Dominican Republic","2024-06-18",0,0,8,0,0,8,0,0
"Dominican Republic","2024-06-19",0,0,8,0,0,8,0,0
"Dominican Republic","2024-06-20",0,0,8,0,0,8,0,0
"Dominican Republic","2024-06-21",0,0,8,0,0,8,0,0
"Dominican Republic","2024-06-22",0,0,8,0,0,8,0,0
"Dominican Republic","2024-06-23",0,0,8,0,0,8,0,0
"Dominican Republic","2024-06-24",0,0,8,0,0,8,0,0
"Dominican Republic","2024-06-25",0,0,8,0,0,8,0,0
"Dominican Republic","2024-06-26",0,0,8,0,0,8,0,0
"Dominican Republic","2024-06-27",0,0,8,0,0,8,0,0
"Dominican Republic","2024-06-28",0,0,8,0,0,8,0,0
"Dominican Republic","2024-06-29",0,0,8,0,0,8,0,0
"Dominican Republic","2024-06-30",0,0,8,0,0,8,0,0
"Dominican Republic","2024-07-01",0,0,8,0,0,8,0,0
"Dominican Republic","2024-07-02",0,0,8,0,0,8,0,0
"Dominican Republic","2024-07-03",0,0,8,0,0,8,0,0
"Dominican Republic","2024-07-04",0,0,8,0,0,8,0,0
"Dominican Republic","2024-07-05",0,0,8,0,0,8,0,0
"Dominican Republic","2024-07-06",0,0,8,0,0,8,0,0
"Dominican Republic","2024-07-07",0,0,8,0,0,8,0,0
"Dominican Republic","2024-07-08",0,0,8,0,0,8,0,0
"Dominican Republic","2024-07-09",0,0,8,0,0,8,0,0
"Dominican Republic","2024-07-10",0,0,8,0,0,8,0,0
"Dominican Republic","2024-07-11",0,0,8,0,0,8,0,0
"Dominican Republic","2024-07-12",0,0,8,0,0,8,0,0
"Dominican Republic","2024-07-13",0,0,8,0,0,8,0,0
"Dominican Republic","2024-07-14",0,0,8,0,0,8,0,0
"Dominican Republic","2024-07-15",0,0,8,0,0,8,0,0
"Dominican Republic","2024-07-16",0,0,8,0,0,8,0,0
"Dominican Republic","2024-07-17",0,0,8,0,0,8,0,0
"Dominican Republic","2024-07-18",0,0,8,0,0,8,0,0
"Dominican Republic","2024-07-19",0,0,8,0,0,8,0,0
"Dominican Republic","2024-07-20",0,0,8,0,0,8,0,0
"Dominican Republic","2024-07-21",0,0,8,0,0,8,0,0
"Dominican Republic","2024-07-22",0,0,8,0,0,8,0,0
"Dominican Republic","2024-07-23",0,0,8,0,0,8,0,0
"Dominican Republic","2024-07-24",0,0,8,0,0,8,0,0
"Dominican Republic","2024-07-25",0,0,8,0,0,8,0,0
"Dominican Republic","2024-07-26",0,0,8,0,0,8,0,0
"Dominican Republic","2024-07-27",0,0,8,0,0,8,0,0
"Dominican Republic","2024-07-28",0,0,8,0,0,8,0,0
"Dominican Republic","2024-07-29",0,0,8,0,0,8,0,0
"Dominican Republic","2024-07-30",0,0,8,0,0,8,0,0
"Dominican Republic","2024-07-31",0,0,8,0,0,8,0,0
"Dominican Republic","2024-08-01",0,0,8,0,0,8,0,0
"Dominican Republic","2024-08-02",0,0,8,0,0,8,0,0
"Dominican Republic","2024-08-03",0,0,8,0,0,8,0,0
"Dominican Republic","2024-08-04",0,0,8,0,0,8,0,0
"Dominican Republic","2024-08-05",0,0,8,0,0,8,0,0
"Dominican Republic","2024-08-06",0,0,8,0,0,8,0,0
"Dominican Republic","2024-08-07",0,0,8,0,0,8,0,0
"Dominican Republic","2024-08-08",0,0,8,0,0,8,0,0
"Dominican Republic","2024-08-09",0,0,8,0,0,8,0,0
"Dominican Republic","2024-08-10",0,0,8,0,0,8,0,0
"Dominican Republic","2024-08-11",0,0,8,0,0,8,0,0
"Dominican Republic","2024-08-12",0,0,8,0,0,8,0,0
"Dominican Republic","2024-08-13",0,0,8,0,0,8,0,0
"Dominican Republic","2024-08-14",0,0,8,0,0,8,0,0
"Dominican Republic","2024-08-15",0,0,8,0,0,8,0,0
"Dominican Republic","2024-08-16",0,0,8,0,0,8,0,0
"Dominican Republic","2024-08-17",0,0,8,0,0,8,0,0
"Dominican Republic","2024-08-18",0,0,8,0,0,8,0,0
"Dominican Republic","2024-08-19",0,0,8,0,0,8,0,0
"Dominican Republic","2024-08-20",0,0,8,0,0,8,0,0
"Dominican Republic","2024-08-21",0,0,8,0,0,8,0,0
"Dominican Republic","2024-08-22",0,0,8,0,0,8,0,0
"Dominican Republic","2024-08-23",0,0,8,0,0,8,0,0
"Dominican Republic","2024-08-24",0,0,8,0,0,8,0,0
"Dominican Republic","2024-08-25",0,0,8,0,0,8,0,0
"Dominican Republic","2024-08-26",0,0,8,0,0,8,0,0
"Dominican Republic","2024-08-27",0,0,8,0,0,8,0,0
"Dominican Republic","2024-08-28",0,0,8,0,0,8,0,0
"Dominican Republic","2024-08-29",0,0,8,0,0,8,0,0
"Dominican Republic","2024-08-30",0,0,8,0,0,8,0,0
"Dominican Republic","2024-08-31",0,0,8,0,0,8,0,0
"Dominican Republic","2024-09-01",0,0,8,0,0,8,0,0
"Dominican Republic","2024-09-02",0,0,8,0,0,8,0,0
"Dominican Republic","2024-09-03",0,0,8,0,0,8,0,0
"Dominican Republic","2024-09-04",0,0,8,0,0,8,0,0
"Dominican Republic","2024-09-05",0,0,8,0,0,8,0,0
"Dominican Republic","2024-09-06",0,0,8,0,0,8,0,0
"Dominican Republic","2024-09-07",0,0,8,0,0,8,0,0
"Dominican Republic","2024-09-08",0,0,8,0,0,8,0,0
"Dominican Republic","2024-09-09",0,0,8,0,0,8,0,0
"Dominican Republic","2024-09-10",0,0,8,0,0,8,0,0
"Dominican Republic","2024-09-11",0,0,8,0,0,8,0,0
"Dominican Republic","2024-09-12",0,0,8,0,0,8,0,0
"Dominican Republic","2024-09-13",0,0,8,0,0,8,0,0
"Dominican Republic","2024-09-14",0,0,8,0,0,8,0,0
"Dominican Republic","2024-09-15",0,0,8,0,0,8,0,0
"Dominican Republic","2024-09-16",0,0,8,0,0,8,0,0
"Dominican Republic","2024-09-17",0,0,8,0,0,8,0,0
"Dominican Republic","2024-09-18",0,0,8,0,0,8,0,0
"Dominican Republic","2024-09-19",0,0,8,0,0,8,0,0
"Dominican Republic","2024-09-20",0,0,8,0,0,8,0,0
"Dominican Republic","2024-09-21",0,0,8,0,0,8,0,0
"Dominican Republic","2024-09-22",0,0,8,0,0,8,0,0
"Dominican Republic","2024-09-23",0,0,8,0,0,8,0,0
"Dominican Republic","2024-09-24",0,0,8,0,0,8,0,0
"Dominican Republic","2024-09-25",0,0,8,0,0,8,0,0
"Dominican Republic","2024-09-26",0,0,8,0,0,8,0,0
"Dominican Republic","2024-09-27",0,0,8,0,0,8,0,0
"Dominican Republic","2024-09-28",0,0,8,0,0,8,0,0
"Dominican Republic","2024-09-29",0,0,8,0,0,8,0,0
"Dominican Republic","2024-09-30",0,0,8,0,0,8,0,0
"Dominican Republic","2024-10-01",0,0,8,0,0,8,0,0
"Dominican Republic","2024-10-02",0,0,8,0,0,8,0,0
"Dominican Republic","2024-10-03",0,0,8,0,0,8,0,0
"Dominican Republic","2024-10-04",0,0,8,0,0,8,0,0
"Dominican Republic","2024-10-05",0,0,8,0,0,8,0,0
"Dominican Republic","2024-10-06",0,0,8,0,0,8,0,0
"Dominican Republic","2024-10-07",0,0,8,0,0,8,0,0
"Dominican Republic","2024-10-08",0,0,8,0,0,8,0,0
"Dominican Republic","2024-10-09",0,0,8,0,0,8,0,0
"Dominican Republic","2024-10-10",0,0,8,0,0,8,0,0
"Dominican Republic","2024-10-11",0,0,8,0,0,8,0,0
"Dominican Republic","2024-10-12",0,0,8,0,0,8,0,0
"Dominican Republic","2024-10-13",0,0,8,0,0,8,0,0
"Dominican Republic","2024-10-14",0,0,8,0,0,8,0,0
"Dominican Republic","2024-10-15",0,0,8,0,0,8,0,0
"Dominican Republic","2024-10-16",0,0,8,0,0,8,0,0
"Dominican Republic","2024-10-17",0,0,8,0,0,8,0,0
"Dominican Republic","2024-10-18",0,0,8,0,0,8,0,0
"Dominican Republic","2024-10-19",0,0,8,0,0,8,0,0
"Dominican Republic","2024-10-20",0,0,8,0,0,8,0,0
"Dominican Republic","2024-10-21",0,0,8,0,0,8,0,0
"Dominican Republic","2024-10-22",0,0,8,0,0,8,0,0
"Dominican Republic","2024-10-23",0,0,8,0,0,8,0,0
"Dominican Republic","2024-10-24",0,0,8,0,0,8,0,0
"Dominican Republic","2024-10-25",0,0,8,0,0,8,0,0
"Dominican Republic","2024-10-26",0,0,8,0,0,8,0,0
"Dominican Republic","2024-10-27",0,0,8,0,0,8,0,0
"Dominican Republic","2024-10-28",0,0,8,0,0,8,0,0
"Dominican Republic","2024-10-29",0,0,8,0,0,8,0,0
"Dominican Republic","2024-10-30",0,0,8,0,0,8,0,0
"Dominican Republic","2024-10-31",0,0,8,0,0,8,0,0
"Dominican Republic","2024-11-01",0,0,8,0,0,8,0,0
"Dominican Republic","2024-11-02",0,0,8,0,0,8,0,0
"Dominican Republic","2024-11-03",0,0,8,0,0,8,0,0
"Dominican Republic","2024-11-04",0,0,8,0,0,8,0,0
"Dominican Republic","2024-11-05",0,0,8,0,0,8,0,0
"Dominican Republic","2024-11-06",0,0,8,0,0,8,0,0
"Dominican Republic","2024-11-07",0,0,8,0,0,8,0,0
"Dominican Republic","2024-11-08",0,0,8,0,0,8,0,0
"Dominican Republic","2024-11-09",0,0,8,0,0,8,0,0
"Dominican Republic","2024-11-10",0,0,8,0,0,8,0,0
"Dominican Republic","2024-11-11",0,0,8,0,0,8,0,0
"Dominican Republic","2024-11-12",0,0,8,0,0,8,0,0
"Dominican Republic","2024-11-13",0,0,8,0,0,8,0,0
"Dominican Republic","2024-11-14",0,0,8,0,0,8,0,0
"Dominican Republic","2024-11-15",0,0,8,0,0,8,0,0
"Dominican Republic","2024-11-16",0,0,8,0,0,8,0,0
"Dominican Republic","2024-11-17",0,0,8,0,0,8,0,0
"Dominican Republic","2024-11-18",0,0,8,0,0,8,0,0
"Dominican Republic","2024-11-19",0,0,8,0,0,8,0,0
"Dominican Republic","2024-11-20",0,0,8,0,0,8,0,0
"Dominican Republic","2024-11-21",0,0,8,0,0,8,0,0
"Dominican Republic","2024-11-22",0,0,8,0,0,8,0,0
"Dominican Republic","2024-11-23",0,0,8,0,0,8,0,0
"Dominican Republic","2024-11-24",0,0,8,0,0,8,0,0
"Dominican Republic","2024-11-25",0,0,8,0,0,8,0,0
"Dominican Republic","2024-11-26",0,0,8,0,0,8,0,0
"Dominican Republic","2024-11-27",0,0,8,0,0,8,0,0
"Dominican Republic","2024-11-28",0,0,8,0,0,8,0,0
"Dominican Republic","2024-11-29",0,0,8,0,0,8,0,0
"Dominican Republic","2024-11-30",0,0,8,0,0,8,0,0
"Dominican Republic","2024-12-01",0,0,8,0,0,8,0,0
"Dominican Republic","2024-12-02",0,0,8,0,0,8,0,0
"Dominican Republic","2024-12-03",0,0,8,0,0,8,0,0
"Dominican Republic","2024-12-04",0,0,8,0,0,8,0,0
"Dominican Republic","2024-12-05",0,0,8,0,0,8,0,0
"Dominican Republic","2024-12-06",0,0,8,0,0,8,0,0
"Dominican Republic","2024-12-07",0,0,8,0,0,8,0,0
"Dominican Republic","2024-12-08",0,0,8,0,0,8,0,0
"Dominican Republic","2024-12-09",0,0,8,0,0,8,0,0
"Ecuador","2024-01-01",0,0,0,0,0,0,0,0
"Ecuador","2024-01-02",0,1,1,0,1,1,0,0
"Ecuador","2024-01-03",0,0,1,0,0,1,0,0
"Ecuador","2024-01-04",0,0,1,0,0,1,0,0
"Ecuador","2024-01-05",0,0,1,0,0,1,0,0
"Ecuador","2024-01-06",0,0,1,0,0,1,0,0
"Ecuador","2024-01-07",0,0,1,0,0,1,0,0
"Ecuador","2024-01-08",0,0,1,0,0,1,0,0
"Ecuador","2024-01-09",0,0,1,0,0,1,0,0
"Ecuador","2024-01-10",0,0,1,0,0,1,0,0
"Ecuador","2024-01-11",0,0,1,0,0,1,0,0
"Ecuador","2024-01-12",0,0,1,0,0,1,0,0
"Ecuador","2024-01-13",0,0,1,0,0,1,0,0
"Ecuador","2024-01-14",0,0,1,0,0,1,0,0
"Ecuador","2024-01-15",0,0,1,0,0,1,0,0
"Ecuador","2024-01-16",0,0,1,0,0,1,0,0
"Ecuador","2024-01-17",0,0,1,0,0,1,0,0
"Ecuador","2024-01-18",0,0,1,0,0,1,0,0
"Ecuador","2024-01-19",0,0,1,0,0,1,0,0
"Ecuador","2024-01-20",0,0,1,0,0,1,0,0
"Ecuador","2024-01-21",0,0,1,0,0,1,0,0
"Ecuador","2024-01-22",0,0,1,0,0,1,0,0
"Ecuador","2024-01-23",0,0,1,0,0,1,0,0
"Ecuador","2024-01-24",0,0,1,0,0,1,0,0
"Ecuador","2024-01-25",0,0,1,0,0,1,0,0
"Ecuador","2024-01-26",0,0,1,0,0,1,0,0
"Ecuador","2024-01-27",0,0,1,0,0,1,0,0
"Ecuador","2024-01-28",0,0,1,0,0,1,0,0
"Ecuador","2024-01-29",0,0,1,0,0,1,0,0
"Ecuador","2024-01-30",0,0,1,0,0,1,0,0
"Ecuador","2024-01-31",0,0,1,0,0,1,0,0
"Ecuador","2024-02-01",0,0,1,0,0,1,0,0
"Ecuador","2024-02-02",0,0,1,0,0,1,0,0
"Ecuador","2024-02-03",0,0,1,0,0,1,0,0
"Ecuador","2024-02-04",0,0,1,0,0,1,0,0
"Ecuador","2024-02-05",0,0,1,0,0,1,0,0
"Ecuador","2024-02-06",0,0,1,0,0,1,0,0
"Ecuador","2024-02-07",0,0,1,0,1,2,0,0
"Ecuador","2024-02-08",0,0,1,0,0,2,0,0
"Ecuador","2024-02-09",0,0,1,0,0,2,0,0
"Ecuador","2024-02-10",0,0,1,0,0,2,0,0
"Ecuador","2024-02-11",0,0,1,0,0,2,0,0
"Ecuador","2024-02-12",0,0,1,0,0,2,0,0
"Ecuador","2024-02-13",0,0,1,0,0,2,0,0
"Ecuador","2024-02-14",0,0,1,0,0,2,0,0
"Ecuador","2024-02-15",0,0,1,0,0,2,0,0
"Ecuador","2024-02-16",0,0,1,0,0,2,0,0
"Ecuador","2024-02-17",0,0,1,0,0,2,0,0
"Ecuador","2024-02-18",0,0,1,0,0,2,0,0
"Ecuador","2024-02-19",0,0,1,0,0,2,0,0
"Ecuador","2024-02-20",0,0,1,0,0,2,0,0
"Ecuador","2024-02-21",0,0,1,0,0,2,0,0
"Ecuador","2024-02-22",0,0,1,0,0,2,0,0
"Ecuador","2024-02-23",0,0,1,0,0,2,0,0
"Ecuador","2024-02-24",0,0,1,0,0,2,0,0
"Ecuador","2024-02-25",0,0,1,0,0,2,0,0
"Ecuador","2024-02-26",0,0,1,0,0,2,0,0
"Ecuador","2024-02-27",0,0,1,0,0,2,0,0
"Ecuador","2024-02-28",0,0,1,0,0,2,0,0
"Ecuador","2024-02-29",0,0,1,0,0,2,0,0
"Ecuador","2024-03-01",0,0,1,0,0,2,0,0
"Ecuador","2024-03-02",0,0,1,0,0,2,0,0
"Ecuador","2024-03-03",0,0,1,0,0,2,0,0
"Ecuador","2024-03-04",0,0,1,0,0,2,0,0
"Ecuador","2024-03-05",0,0,1,0,0,2,0,0
"Ecuador","2024-03-06",0,0,1,0,0,2,0,0
"Ecuador","2024-03-07",0,0,1,0,0,2,0,0
"Ecuador","2024-03-08",0,0,1,0,0,2,0,0
"Ecuador","2024-03-09",0,0,1,0,0,2,0,0
"Ecuador","2024-03-10",0,0,1,0,0,2,0,0
"Ecuador","2024-03-11",0,0,1,0,0,2,0,0
"Ecuador","2024-03-12",0,1,2,0,0,2,0,0
"Ecuador","2024-03-13",0,0,2,0,0,2,0,0
"Ecuador","2024-03-14",0,0,2,0,0,2,0,0
"Ecuador","2024-03-15",0,0,2,0,0,2,0,0
"Ecuador","2024-03-16",0,0,2,0,0,2,0,0
"Ecuador","2024-03-17",0,0,2,0,0,2,0,0
"Ecuador","2024-03-18",0,0,2,0,0,2,0,0
"Ecuador","2024-03-19",0,0,2,0,0,2,0,0
"Ecuador","2024-03-20",0,0,2,0,0,2,0,0
"Ecuador","2024-03-21",0,0,2,0,0,2,0,0
"Ecuador","2024-03-22",0,0,2,0,0,2,0,0
"Ecuador","2024-03-23",0,0,2,0,0,2,0,0
"Ecuador","2024-03-24",0,0,2,0,0,2,0,0
"Ecuador","2024-03-25",0,0,2,0,0,2,0,0
"Ecuador","2024-03-26",0,0,2,0,0,2,0,0
"Ecuador","2024-03-27",0,0,2,0,0,2,0,0
"Ecuador","2024-03-28",0,0,2,0,0,2,0,0
"Ecuador","2024-03-29",0,0,2,0,0,2,0,0
"Ecuador","2024-03-30",0,0,2,0,0,2,0,0
"Ecuador","2024-03-31",0,0,2,0,0,2,0,0
"Ecuador","2024-04-01",0,0,2,0,0,2,0,0
"Ecuador","2024-04-02",0,0,2,0,0,2,0,0
"Ecuador","2024-04-03",0,0,2,0,1,3,0,0
"Ecuador","2024-04-04",0,0,2,0,0,3,0,0
"Ecuador","2024-04-05",0,0,2,0,0,3,0,0
"Ecuador","2024-04-06",0,0,2,0,0,3,0,0
"Ecuador","2024-04-07",0,0,2,0,0,3,0,0
"Ecuador","2024-04-08",0,0,2,0,0,3,0,0
"Ecuador","2024-04-09",0,0,2,0,0,3,0,0
"Ecuador","2024-04-10",0,0,2,0,0,3,0,0
"Ecuador","2024-04-11",0,0,2,0,0,3,0,0
"Ecuador","2024-04-12",0,0,2,0,0,3,0,0
"Ecuador","2024-04-13",0,0,2,0,0,3,0,0
"Ecuador","2024-04-14",0,0,2,0,0,3,0,0
"Ecuador","2024-04-15",0,0,2,0,0,3,0,0
"Ecuador","2024-04-16",0,0,2,0,0,3,0,0
"Ecuador","2024-04-17",0,0,2,0,0,3,0,0
"Ecuador","2024-04-18",0,0,2,0,0,3,0,0
"Ecuador","2024-04-19",0,0,2,0,0,3,0,0
"Ecuador","2024-04-20",0,0,2,0,0,3,0,0
"Ecuador","2024-04-21",0,0,2,0,0,3,0,0
"Ecuador","2024-04-22",0,0,2,0,0,3,0,0
"Ecuador","2024-04-23",0,1,3,0,0,3,0,0
"Ecuador","2024-04-24",0,0,3,0,0,3,0,0
"Ecuador","2024-04-25",0,0,3,0,0,3,0,0
"Ecuador","2024-04-26",0,0,3,0,0,3,0,0
"Ecuador","2024-04-27",0,0,3,0,0,3,0,0
"Ecuador","2024-04-28",0,0,3,0,0,3,0,0
"Ecuador","2024-04-29",0,0,3,0,0,3,0,0
"Ecuador","2024-04-30",0,0,3,0,0,3,0,0
"Ecuador","2024-05-01",0,0,3,0,1,4,0,0
"Ecuador","2024-05-02",0,0,3,0,0,4,0,0
"Ecuador","2024-05-03",0,0,3,0,0,4,0,0
"Ecuador","2024-05-04",0,0,3,0,0,4,0,0
"Ecuador","2024-05-05",0,0,3,0,0,4,0,0
"Ecuador","2024-05-06",0,0,3,0,0,4,0,0
"Ecuador","2024-05-07",0,1,4,0,0,4,0,0
"Ecuador","2024-05-08",0,0,4,0,0,4,0,0
"Ecuador","2024-05-09",0,0,4,0,0,4,0,0
"Ecuador","2024-05-10",0,0,4,0,0,4,0,0
"Ecuador","2024-05-11",0,0,4,0,0,4,0,0
"Ecuador","2024-05-12",0,0,4,0,0,4,0,0
"Ecuador","2024-05-13",0,0,4,0,0,4,0,0
"Ecuador","2024-05-14",0,0,4,0,0,4,0,0
"Ecuador","2024-05-15",0,0,4,0,0,4,0,0
"Ecuador","2024-05-16",0,0,4,0,0,4,0,0
"Ecuador","2024-05-17",0,0,4,0,0,4,0,0
"Ecuador","2024-05-18",0,0,4,0,0,4,0,0
"Ecuador","2024-05-19",0,0,4,0,0,4,0,0
"Ecuador","2024-05-20",0,0,4,0,0,4,0,0
"Ecuador","2024-05-21",0,0,4,0,0,4,0,0
"Ecuador","2024-05-22",0,0,4,0,0,4,0,0
"Ecuador","2024-05-23",0,0,4,0,0,4,0,0
"Ecuador","2024-05-24",0,0,4,0,0,4,0,0
"Ecuador","2024-05-25",0,0,4,0,0,4,0,0
"Ecuador","2024-05-26",0,0,4,0,0,4,0,0
"Ecuador","2024-05-27",0,0,4,0,0,4,0,0
"Ecuador","2024-05-28",0,0,4,0,0,4,0,0
"Ecuador","2024-05-29",0,0,4,0,0,4,0,0
"Ecuador","2024-05-30",0,0,4,0,0,4,0,0
"Ecuador","2024-05-31",0,0,4,0,0,4,0,0
"Ecuador","2024-06-01",0,0,4,0,0,4,0,0
"Ecuador","2024-06-02",0,0,4,0,0,4,0,0
"Ecuador","2024-06-03",0,0,4,0,0,4,0,0
"Ecuador","2024-06-04",0,0,4,0,0,4,0,0
"Ecuador","2024-06-05",0,0,4,0,0,4,0,0
"Ecuador","2024-06-06",0,0,4,0,0,4,0,0
"Ecuador","2024-06-07",0,0,4,0,0,4,0,0
"Ecuador","2024-06-08",0,0,4,0,0,4,0,0
"Ecuador","2024-06-09",0,0,4,0,0,4,0,0
"Ecuador","2024-06-10",0,0,4,0,0,4,0,0
"Ecuador","2024-06-11",0,0,4,0,0,4,0,0
"Ecuador","2024-06-12",0,0,4,0,0,4,0,0
"Ecuador","2024-06-13",0,0,4,0,0,4,0,0
"Ecuador","2024-06-14",0,0,4,0,0,4,0,0
"Ecuador","2024-06-15",0,0,4,0,0,4,0,0
"Ecuador","2024-06-16",0,0,4,0,0,4,0,0
"Ecuador","2024-06-17",0,0,4,0,0,4,0,0
"Ecuador","2024-06-18",0,0,4,0,0,4,0,0
"Ecuador","2024-06-19",0,0,4,0,1,5,0,0
"Ecuador","2024-06-20",0,0,4,0,0,5,0,0
"Ecuador","2024-06-21",0,0,4,0,0,5,0,0
"Ecuador","2024-06-22",0,0,4,0,0,5,0,0
"Ecuador","2024-06-23",0,0,4,0,0,5,0,0
"Ecuador","2024-06-24",0,0,4,0,0,5,0,0
"Ecuador","2024-06-25",0,0,4,0,0,5,0,0
"Ecuador","2024-06-26",0,0,4,0,0,5,0,0
"Ecuador","2024-06-27",0,0,4,0,0,5,0,0
"Ecuador","2024-06-28",0,0,4,0,0,5,0,0
"Ecuador","2024-06-29",0,0,4,0,0,5,0,0
"Ecuador","2024-06-30",0,0,4,0,0,5,0,0
"Ecuador","2024-07-01",0,0,4,0,0,5,0,0
"Ecuador","2024-07-02",0,0,4,0,0,5,0,0
"Ecuador","2024-07-03",0,0,4,0,0,5,0,0
"Ecuador","2024-07-04",0,0,4,0,0,5,0,0
"Ecuador","2024-07-05",0,0,4,0,0,5,0,0
"Ecuador","2024-07-06",0,0,4,0,0,5,0,0
"Ecuador","2024-07-07",0,0,4,0,0,5,0,0
"Ecuador","2024-07-08",0,0,4,0,0,5,0,0
"Ecuador","2024-07-09",0,0,4,0,0,5,0,0
"Ecuador","2024-07-10",0,0,4,0,0,5,0,0
"Ecuador","2024-07-11",0,0,4,0,0,5,0,0
"Ecuador","2024-07-12",0,0,4,0,0,5,0,0
"Ecuador","2024-07-13",0,0,4,0,0,5,0,0
"Ecuador","2024-07-14",0,0,4,0,0,5,0,0
"Ecuador","2024-07-15",0,0,4,0,0,5,0,0
"Ecuador","2024-07-16",0,0,4,0,0,5,0,0
"Ecuador","2024-07-17",0,0,4,0,0,5,0,0
"Ecuador","2024-07-18",0,0,4,0,0,5,0,0
"Ecuador","2024-07-19",0,0,4,0,0,5,0,0
"Ecuador","2024-07-20",0,0,4,0,0,5,0,0
"Ecuador","2024-07-21",0,0,4,0,0,5,0,0
"Ecuador","2024-07-22",0,0,4,0,0,5,0,0
"Ecuador","2024-07-23",0,0,4,0,0,5,0,0
"Ecuador","2024-07-24",0,0,4,0,0,5,0,0
"Ecuador","2024-07-25",0,0,4,0,0,5,0,0
"Ecuador","2024-07-26",0,0,4,0,0,5,0,0
"Ecuador","2024-07-27",0,0,4,0,0,5,0,0
"Ecuador","2024-07-28",0,0,4,0,0,5,0,0
"Ecuador","2024-07-29",0,0,4,0,0,5,0,0
"Ecuador","2024-07-30",0,1,5,0,0,5,0,0
"Ecuador","2024-07-31",0,0,5,0,0,5,0,0
"Ecuador","2024-08-01",0,0,5,0,0,5,0,0
"Ecuador","2024-08-02",0,0,5,0,0,5,0,0
"Ecuador","2024-08-03",0,0,5,0,1,6,0,0
"Ecuador","2024-08-04",0,0,5,0,0,6,0,0
"Ecuador","2024-08-05",0,0,5,0,0,6,0,0
"Ecuador","2024-08-06",0,1,6,0,0,6,0,0
"Ecuador","2024-08-07",0,0,6,0,0,6,0,0
"Ecuador","2024-08-08",0,0,6,0,0,6,0,0
"Ecuador","2024-08-09",0,0,6,0,0,6,0,0
"Ecuador","2024-08-10",0,0,6,0,1,7,0,0
"Ecuador","2024-08-11",0,0,6,0,0,7,0,0
"Ecuador","2024-08-12",0,0,6,0,0,7,0,0
"Ecuador","2024-08-13",0,1,7,0,0,7,0,0
"Ecuador","2024-08-14",0,0,7,0,0,7,0,0
"Ecuador","2024-08-15",0,0,7,0,0,7,0,0
"Ecuador","2024-08-16",0,0,7,0,0,7,0,0
"Ecuador","2024-08-17",0,0,7,0,1,8,0,0
"Ecuador","2024-08-18",0,0,7,0,0,8,0,0
"Ecuador","2024-08-19",0,0,7,0,0,8,0,0
"Ecuador","2024-08-20",0,1,8,0,0,8,0,0
"Ecuador","2024-08-21",0,0,8,0,1,9,0,0
"Ecuador","2024-08-22",0,0,8,0,0,9,0,0
"Ecuador","2024-08-23",0,0,8,0,1,10,0,0
"Ecuador","2024-08-24",0,0,8,0,1,11,0,0
"Ecuador","2024-08-25",0,0,8,0,1,12,0,0
"Ecuador","2024-08-26",0,0,8,0,0,12,0,0
"Ecuador","2024-08-27",0,5,13,0,1,13,0,0
"Ecuador","2024-08-28",0,0,13,0,0,13,0,0
"Ecuador","2024-08-29",0,0,13,0,0,13,0,0
"Ecuador","2024-08-30",0,0,13,0,1,14,0,0
"Ecuador","2024-08-31",0,0,13,0,0,14,0,0
"Ecuador","2024-09-01",0,0,13,0,0,14,0,0
"Ecuador","2024-09-02",0,0,13,0,0,14,0,0
"Ecuador","2024-09-03",0,0,13,0,1,15,0,0
"Ecuador","2024-09-04",0,0,13,0,0,15,0,0
"Ecuador","2024-09-05",0,0,13,0,0,15,0,0
"Ecuador","2024-09-06",0,0,13,0,0,15,0,0
"Ecuador","2024-09-07",0,0,13,0,0,15,0,0
"Ecuador","2024-09-08",0,0,13,0,1,16,0,0
"Ecuador","2024-09-09",0,0,13,0,0,16,0,0
"Ecuador","2024-09-10",0,3,16,0,0,16,0,0
"Ecuador","2024-09-11",0,0,16,0,1,17,0,0
"Ecuador","2024-09-12",0,0,16,0,0,17,0,0
"Ecuador","2024-09-13",0,0,16,0,1,18,0,0
"Ecuador","2024-09-14",0,0,16,0,0,18,0,0
"Ecuador","2024-09-15",0,0,16,0,1,19,0,0
"Ecuador","2024-09-16",0,0,16,0,0,19,0,0
"Ecuador","2024-09-17",0,4,20,0,1,20,0,0
"Ecuador","2024-09-18",0,0,20,0,0,20,0,0
"Ecuador","2024-09-19",0,0,20,0,1,21,0,0
"Ecuador","2024-09-20",0,0,20,0,0,21,0,0
"Ecuador","2024-09-21",0,0,20,0,1,22,0,0
"Ecuador","2024-09-22",0,0,20,0,0,22,0,0
"Ecuador","2024-09-23",0,0,20,0,1,23,0,0
"Ecuador","2024-09-24",0,3,23,0,0,23,0,0
"Ecuador","2024-09-25",0,0,23,0,0,23,0,0
"Ecuador","2024-09-26",0,0,23,0,0,23,0,0
"Ecuador","2024-09-27",0,0,23,0,0,23,0,0
"Ecuador","2024-09-28",0,0,23,0,1,24,0,0
"Ecuador","2024-09-29",0,0,23,0,0,24,0,0
"Ecuador","2024-09-30",0,0,23,0,0,24,0,0
"Ecuador","2024-10-01",0,1,24,0,0,24,0,0
"Ecuador","2024-10-02",0,0,24,0,0,24,0,0
"Ecuador","2024-10-03",0,0,24,0,0,24,0,0
"Ecuador","2024-10-04",0,0,24,0,0,24,0,0
"Ecuador","2024-10-05",0,0,24,0,0,24,0,0
"Ecuador","2024-10-06",0,0,24,0,0,24,0,0
"Ecuador","2024-10-07",0,0,24,0,0,24,0,0
"Ecuador","2024-10-08",0,0,24,0,0,24,0,0
"Ecuador","2024-10-09",0,0,24,0,0,24,0,0
"Ecuador","2024-10-10",0,0,24,0,0,24,0,0
"Ecuador","2024-10-11",0,0,24,0,0,24,0,0
"Ecuador","2024-10-12",0,0,24,0,0,24,0,0
"Ecuador","2024-10-13",0,0,24,0,0,24,0,0
"Ecuador","2024-10-14",0,0,24,0,0,24,0,0
"Ecuador","2024-10-15",0,0,24,0,0,24,0,0
"Ecuador","2024-10-16",0,0,24,0,0,24,0,0
"Ecuador","2024-10-17",0,0,24,0,0,24,0,0
"Ecuador","2024-10-18",0,0,24,0,0,24,0,0
"Ecuador","2024-10-19",0,0,24,0,0,24,0,0
"Ecuador","2024-10-20",0,0,24,0,0,24,0,0
"Ecuador","2024-10-21",0,0,24,0,0,24,0,0
"Ecuador","2024-10-22",0,0,24,0,0,24,0,0
"Ecuador","2024-10-23",0,0,24,0,0,24,0,0
"Ecuador","2024-10-24",0,0,24,0,0,24,0,0
"Ecuador","2024-10-25",0,0,24,0,0,24,0,0
"Ecuador","2024-10-26",0,0,24,0,0,24,0,0
"Ecuador","2024-10-27",0,0,24,0,0,24,0,0
"Ecuador","2024-10-28",0,0,24,0,0,24,0,0
"Ecuador","2024-10-29",0,0,24,0,0,24,0,0
"Ecuador","2024-10-30",0,0,24,0,0,24,0,0
"Ecuador","2024-10-31",0,0,24,0,0,24,0,0
"Ecuador","2024-11-01",0,0,24,0,0,24,0,0
"Ecuador","2024-11-02",0,0,24,0,0,24,0,0
"Ecuador","2024-11-03",0,0,24,0,0,24,0,0
"Ecuador","2024-11-04",0,0,24,0,0,24,0,0
"Ecuador","2024-11-05",0,0,24,0,0,24,0,0
"Ecuador","2024-11-06",0,0,24,0,0,24,0,0
"Ecuador","2024-11-07",0,0,24,0,0,24,0,0
"Ecuador","2024-11-08",0,0,24,0,0,24,0,0
"Ecuador","2024-11-09",0,0,24,0,0,24,0,0
"Ecuador","2024-11-10",0,0,24,0,0,24,0,0
"Ecuador","2024-11-11",0,0,24,0,0,24,0,0
"Ecuador","2024-11-12",0,0,24,0,0,24,0,0
"Ecuador","2024-11-13",0,0,24,0,0,24,0,0
"Ecuador","2024-11-14",0,0,24,0,0,24,0,0
"Ecuador","2024-11-15",0,0,24,0,0,24,0,0
"Ecuador","2024-11-16",0,0,24,0,0,24,0,0
"Ecuador","2024-11-17",0,0,24,0,0,24,0,0
"Ecuador","2024-11-18",0,0,24,0,0,24,0,0
"Ecuador","2024-11-19",0,0,24,0,0,24,0,0
"Ecuador","2024-11-20",0,0,24,0,0,24,0,0
"Ecuador","2024-11-21",0,0,24,0,0,24,0,0
"Ecuador","2024-11-22",0,0,24,0,0,24,0,0
"Ecuador","2024-11-23",0,0,24,0,0,24,0,0
"Ecuador","2024-11-24",0,0,24,0,0,24,0,0
"Ecuador","2024-11-25",0,0,24,0,0,24,0,0
"Ecuador","2024-11-26",0,0,24,0,0,24,0,0
"Ecuador","2024-11-27",0,0,24,0,0,24,0,0
"Ecuador","2024-11-28",0,0,24,0,0,24,0,0
"Ecuador","2024-11-29",0,0,24,0,0,24,0,0
"Ecuador","2024-11-30",0,0,24,0,0,24,0,0
"Ecuador","2024-12-01",0,0,24,0,0,24,0,0
"Ecuador","2024-12-02",0,0,24,0,0,24,0,0
"Ecuador","2024-12-03",0,0,24,0,0,24,0,0
"Ecuador","2024-12-04",0,0,24,0,0,24,0,0
"Ecuador","2024-12-05",0,0,24,0,0,24,0,0
"Ecuador","2024-12-06",0,0,24,0,0,24,0,0
"Ecuador","2024-12-07",0,0,24,0,0,24,0,0
"Ecuador","2024-12-08",0,0,24,0,0,24,0,0
"Ecuador","2024-12-09",0,0,24,0,0,24,0,0
"El Salvador","2024-01-01",0,0,0,0,0,0,0,0
"El Salvador","2024-01-02",0,0,0,0,0,0,0,0
"El Salvador","2024-01-03",0,0,0,0,0,0,0,0
"El Salvador","2024-01-04",0,0,0,0,0,0,0,0
"El Salvador","2024-01-05",0,0,0,0,0,0,0,0
"El Salvador","2024-01-06",0,0,0,0,0,0,0,0
"El Salvador","2024-01-07",0,0,0,0,0,0,0,0
"El Salvador","2024-01-08",0,0,0,0,0,0,0,0
"El Salvador","2024-01-09",0,0,0,0,0,0,0,0
"El Salvador","2024-01-10",0,0,0,0,0,0,0,0
"El Salvador","2024-01-11",0,0,0,0,0,0,0,0
"El Salvador","2024-01-12",0,0,0,0,0,0,0,0
"El Salvador","2024-01-13",0,0,0,0,0,0,0,0
"El Salvador","2024-01-14",0,0,0,0,0,0,0,0
"El Salvador","2024-01-15",0,0,0,0,0,0,0,0
"El Salvador","2024-01-16",0,0,0,0,0,0,0,0
"El Salvador","2024-01-17",0,0,0,0,0,0,0,0
"El Salvador","2024-01-18",0,0,0,0,0,0,0,0
"El Salvador","2024-01-19",0,0,0,0,0,0,0,0
"El Salvador","2024-01-20",0,0,0,0,0,0,0,0
"El Salvador","2024-01-21",0,0,0,0,0,0,0,0
"El Salvador","2024-01-22",0,0,0,0,0,0,0,0
"El Salvador","2024-01-23",0,0,0,0,0,0,0,0
"El Salvador","2024-01-24",0,0,0,0,0,0,0,0
"El Salvador","2024-01-25",0,0,0,0,0,0,0,0
"El Salvador","2024-01-26",0,0,0,0,0,0,0,0
"El Salvador","2024-01-27",0,0,0,0,0,0,0,0
"El Salvador","2024-01-28",0,0,0,0,0,0,0,0
"El Salvador","2024-01-29",0,0,0,0,0,0,0,0
"El Salvador","2024-01-30",0,0,0,0,0,0,0,0
"El Salvador","2024-01-31",0,0,0,0,0,0,0,0
"El Salvador","2024-02-01",0,0,0,0,0,0,0,0
"El Salvador","2024-02-02",0,0,0,0,0,0,0,0
"El Salvador","2024-02-03",0,0,0,0,0,0,0,0
"El Salvador","2024-02-04",0,0,0,0,0,0,0,0
"El Salvador","2024-02-05",0,0,0,0,0,0,0,0
"El Salvador","2024-02-06",0,0,0,0,0,0,0,0
"El Salvador","2024-02-07",0,0,0,0,0,0,0,0
"El Salvador","2024-02-08",0,0,0,0,0,0,0,0
"El Salvador","2024-02-09",0,0,0,0,0,0,0,0
"El Salvador","2024-02-10",0,0,0,0,0,0,0,0
"El Salvador","2024-02-11",0,0,0,0,0,0,0,0
"El Salvador","2024-02-12",0,0,0,0,0,0,0,0
"El Salvador","2024-02-13",0,0,0,0,0,0,0,0
"El Salvador","2024-02-14",0,0,0,0,0,0,0,0
"El Salvador","2024-02-15",0,0,0,0,0,0,0,0
"El Salvador","2024-02-16",0,0,0,0,0,0,0,0
"El Salvador","2024-02-17",0,0,0,0,0,0,0,0
"El Salvador","2024-02-18",0,0,0,0,0,0,0,0
"El Salvador","2024-02-19",0,0,0,0,0,0,0,0
"El Salvador","2024-02-20",0,0,0,0,0,0,0,0
"El Salvador","2024-02-21",0,0,0,0,0,0,0,0
"El Salvador","2024-02-22",0,0,0,0,0,0,0,0
"El Salvador","2024-02-23",0,0,0,0,0,0,0,0
"El Salvador","2024-02-24",0,0,0,0,0,0,0,0
"El Salvador","2024-02-25",0,0,0,0,0,0,0,0
"El Salvador","2024-02-26",0,0,0,0,0,0,0,0
"El Salvador","2024-02-27",0,0,0,0,0,0,0,0
"El Salvador","2024-02-28",0,0,0,0,0,0,0,0
"El Salvador","2024-02-29",0,0,0,0,0,0,0,0
"El Salvador","2024-03-01",0,0,0,0,0,0,0,0
"El Salvador","2024-03-02",0,0,0,0,0,0,0,0
"El Salvador","2024-03-03",0,0,0,0,0,0,0,0
"El Salvador","2024-03-04",0,0,0,0,0,0,0,0
"El Salvador","2024-03-05",0,0,0,0,0,0,0,0
"El Salvador","2024-03-06",0,0,0,0,0,0,0,0
"El Salvador","2024-03-07",0,0,0,0,0,0,0,0
"El Salvador","2024-03-08",0,0,0,0,0,0,0,0
"El Salvador","2024-03-09",0,0,0,0,0,0,0,0
"El Salvador","2024-03-10",0,0,0,0,0,0,0,0
"El Salvador","2024-03-11",0,0,0,0,0,0,0,0
"El Salvador","2024-03-12",0,0,0,0,0,0,0,0
"El Salvador","2024-03-13",0,0,0,0,0,0,0,0
"El Salvador","2024-03-14",0,0,0,0,0,0,0,0
"El Salvador","2024-03-15",0,0,0,0,0,0,0,0
"El Salvador","2024-03-16",0,0,0,0,0,0,0,0
"El Salvador","2024-03-17",0,0,0,0,0,0,0,0
"El Salvador","2024-03-18",0,0,0,0,0,0,0,0
"El Salvador","2024-03-19",0,0,0,0,0,0,0,0
"El Salvador","2024-03-20",0,0,0,0,0,0,0,0
"El Salvador","2024-03-21",0,0,0,0,0,0,0,0
"El Salvador","2024-03-22",0,0,0,0,0,0,0,0
"El Salvador","2024-03-23",0,0,0,0,0,0,0,0
"El Salvador","2024-03-24",0,0,0,0,0,0,0,0
"El Salvador","2024-03-25",0,0,0,0,0,0,0,0
"El Salvador","2024-03-26",0,0,0,0,0,0,0,0
"El Salvador","2024-03-27",0,0,0,0,0,0,0,0
"El Salvador","2024-03-28",0,0,0,0,0,0,0,0
"El Salvador","2024-03-29",0,0,0,0,0,0,0,0
"El Salvador","2024-03-30",0,0,0,0,0,0,0,0
"El Salvador","2024-03-31",0,0,0,0,0,0,0,0
"El Salvador","2024-04-01",0,0,0,0,0,0,0,0
"El Salvador","2024-04-02",0,0,0,0,0,0,0,0
"El Salvador","2024-04-03",0,0,0,0,0,0,0,0
"El Salvador","2024-04-04",0,0,0,0,0,0,0,0
"El Salvador","2024-04-05",0,0,0,0,0,0,0,0
"El Salvador","2024-04-06",0,0,0,0,0,0,0,0
"El Salvador","2024-04-07",0,0,0,0,0,0,0,0
"El Salvador","2024-04-08",0,0,0,0,0,0,0,0
"El Salvador","2024-04-09",0,0,0,0,0,0,0,0
"El Salvador","2024-04-10",0,0,0,0,0,0,0,0
"El Salvador","2024-04-11",0,0,0,0,0,0,0,0
"El Salvador","2024-04-12",0,0,0,0,0,0,0,0
"El Salvador","2024-04-13",0,0,0,0,0,0,0,0
"El Salvador","2024-04-14",0,0,0,0,0,0,0,0
"El Salvador","2024-04-15",0,0,0,0,0,0,0,0
"El Salvador","2024-04-16",0,0,0,0,0,0,0,0
"El Salvador","2024-04-17",0,0,0,0,0,0,0,0
"El Salvador","2024-04-18",0,0,0,0,0,0,0,0
"El Salvador","2024-04-19",0,0,0,0,0,0,0,0
"El Salvador","2024-04-20",0,0,0,0,0,0,0,0
"El Salvador","2024-04-21",0,0,0,0,0,0,0,0
"El Salvador","2024-04-22",0,0,0,0,0,0,0,0
"El Salvador","2024-04-23",0,0,0,0,0,0,0,0
"El Salvador","2024-04-24",0,0,0,0,0,0,0,0
"El Salvador","2024-04-25",0,0,0,0,0,0,0,0
"El Salvador","2024-04-26",0,0,0,0,0,0,0,0
"El Salvador","2024-04-27",0,0,0,0,0,0,0,0
"El Salvador","2024-04-28",0,0,0,0,0,0,0,0
"El Salvador","2024-04-29",0,0,0,0,0,0,0,0
"El Salvador","2024-04-30",0,0,0,0,0,0,0,0
"El Salvador","2024-05-01",0,0,0,0,0,0,0,0
"El Salvador","2024-05-02",0,0,0,0,0,0,0,0
"El Salvador","2024-05-03",0,0,0,0,0,0,0,0
"El Salvador","2024-05-04",0,0,0,0,0,0,0,0
"El Salvador","2024-05-05",0,0,0,0,0,0,0,0
"El Salvador","2024-05-06",0,0,0,0,0,0,0,0
"El Salvador","2024-05-07",0,0,0,0,0,0,0,0
"El Salvador","2024-05-08",0,0,0,0,0,0,0,0
"El Salvador","2024-05-09",0,0,0,0,0,0,0,0
"El Salvador","2024-05-10",0,0,0,0,0,0,0,0
"El Salvador","2024-05-11",0,0,0,0,0,0,0,0
"El Salvador","2024-05-12",0,0,0,0,0,0,0,0
"El Salvador","2024-05-13",0,0,0,0,0,0,0,0
"El Salvador","2024-05-14",0,0,0,0,0,0,0,0
"El Salvador","2024-05-15",0,0,0,0,0,0,0,0
"El Salvador","2024-05-16",0,0,0,0,0,0,0,0
"El Salvador","2024-05-17",0,0,0,0,0,0,0,0
"El Salvador","2024-05-18",0,0,0,0,0,0,0,0
"El Salvador","2024-05-19",0,0,0,0,0,0,0,0
"El Salvador","2024-05-20",0,0,0,0,0,0,0,0
"El Salvador","2024-05-21",0,0,0,0,0,0,0,0
"El Salvador","2024-05-22",0,0,0,0,0,0,0,0
"El Salvador","2024-05-23",0,0,0,0,0,0,0,0
"El Salvador","2024-05-24",0,0,0,0,0,0,0,0
"El Salvador","2024-05-25",0,0,0,0,0,0,0,0
"El Salvador","2024-05-26",0,0,0,0,0,0,0,0
"El Salvador","2024-05-27",0,0,0,0,0,0,0,0
"El Salvador","2024-05-28",0,0,0,0,0,0,0,0
"El Salvador","2024-05-29",0,0,0,0,0,0,0,0
"El Salvador","2024-05-30",0,0,0,0,0,0,0,0
"El Salvador","2024-05-31",0,0,0,0,0,0,0,0
"El Salvador","2024-06-01",0,0,0,0,0,0,0,0
"El Salvador","2024-06-02",0,0,0,0,0,0,0,0
"El Salvador","2024-06-03",0,0,0,0,0,0,0,0
"El Salvador","2024-06-04",0,0,0,0,0,0,0,0
"El Salvador","2024-06-05",0,0,0,0,0,0,0,0
"El Salvador","2024-06-06",0,0,0,0,0,0,0,0
"El Salvador","2024-06-07",0,0,0,0,0,0,0,0
"El Salvador","2024-06-08",0,0,0,0,0,0,0,0
"El Salvador","2024-06-09",0,0,0,0,0,0,0,0
"El Salvador","2024-06-10",0,0,0,0,0,0,0,0
"El Salvador","2024-06-11",0,0,0,0,0,0,0,0
"El Salvador","2024-06-12",0,0,0,0,0,0,0,0
"El Salvador","2024-06-13",0,0,0,0,0,0,0,0
"El Salvador","2024-06-14",0,0,0,0,0,0,0,0
"El Salvador","2024-06-15",0,0,0,0,0,0,0,0
"El Salvador","2024-06-16",0,0,0,0,0,0,0,0
"El Salvador","2024-06-17",0,0,0,0,0,0,0,0
"El Salvador","2024-06-18",0,0,0,0,0,0,0,0
"El Salvador","2024-06-19",0,0,0,0,0,0,0,0
"El Salvador","2024-06-20",0,0,0,0,0,0,0,0
"El Salvador","2024-06-21",0,0,0,0,0,0,0,0
"El Salvador","2024-06-22",0,0,0,0,0,0,0,0
"El Salvador","2024-06-23",0,0,0,0,0,0,0,0
"El Salvador","2024-06-24",0,0,0,0,0,0,0,0
"El Salvador","2024-06-25",0,0,0,0,0,0,0,0
"El Salvador","2024-06-26",0,0,0,0,0,0,0,0
"El Salvador","2024-06-27",0,0,0,0,0,0,0,0
"El Salvador","2024-06-28",0,0,0,0,0,0,0,0
"El Salvador","2024-06-29",0,0,0,0,0,0,0,0
"El Salvador","2024-06-30",0,0,0,0,0,0,0,0
"El Salvador","2024-07-01",0,0,0,0,0,0,0,0
"El Salvador","2024-07-02",0,0,0,0,0,0,0,0
"El Salvador","2024-07-03",0,0,0,0,0,0,0,0
"El Salvador","2024-07-04",0,0,0,0,0,0,0,0
"El Salvador","2024-07-05",0,0,0,0,0,0,0,0
"El Salvador","2024-07-06",0,0,0,0,0,0,0,0
"El Salvador","2024-07-07",0,0,0,0,0,0,0,0
"El Salvador","2024-07-08",0,0,0,0,0,0,0,0
"El Salvador","2024-07-09",0,0,0,0,0,0,0,0
"El Salvador","2024-07-10",0,0,0,0,0,0,0,0
"El Salvador","2024-07-11",0,0,0,0,0,0,0,0
"El Salvador","2024-07-12",0,0,0,0,0,0,0,0
"El Salvador","2024-07-13",0,0,0,0,0,0,0,0
"El Salvador","2024-07-14",0,0,0,0,0,0,0,0
"El Salvador","2024-07-15",0,0,0,0,0,0,0,0
"El Salvador","2024-07-16",0,0,0,0,0,0,0,0
"El Salvador","2024-07-17",0,0,0,0,0,0,0,0
"El Salvador","2024-07-18",0,0,0,0,0,0,0,0
"El Salvador","2024-07-19",0,0,0,0,0,0,0,0
"El Salvador","2024-07-20",0,0,0,0,0,0,0,0
"El Salvador","2024-07-21",0,0,0,0,0,0,0,0
"El Salvador","2024-07-22",0,0,0,0,0,0,0,0
"El Salvador","2024-07-23",0,0,0,0,0,0,0,0
"El Salvador","2024-07-24",0,0,0,0,0,0,0,0
"El Salvador","2024-07-25",0,0,0,0,0,0,0,0
"El Salvador","2024-07-26",0,0,0,0,0,0,0,0
"El Salvador","2024-07-27",0,0,0,0,0,0,0,0
"El Salvador","2024-07-28",0,0,0,0,0,0,0,0
"El Salvador","2024-07-29",0,0,0,0,0,0,0,0
"El Salvador","2024-07-30",0,0,0,0,0,0,0,0
"El Salvador","2024-07-31",0,0,0,0,0,0,0,0
"El Salvador","2024-08-01",0,0,0,0,0,0,0,0
"El Salvador","2024-08-02",0,0,0,0,0,0,0,0
"El Salvador","2024-08-03",0,0,0,0,0,0,0,0
"El Salvador","2024-08-04",0,0,0,0,0,0,0,0
"El Salvador","2024-08-05",0,0,0,0,0,0,0,0
"El Salvador","2024-08-06",0,0,0,0,0,0,0,0
"El Salvador","2024-08-07",0,0,0,0,0,0,0,0
"El Salvador","2024-08-08",0,0,0,0,0,0,0,0
"El Salvador","2024-08-09",0,0,0,0,0,0,0,0
"El Salvador","2024-08-10",0,0,0,0,0,0,0,0
"El Salvador","2024-08-11",0,0,0,0,0,0,0,0
"El Salvador","2024-08-12",0,0,0,0,0,0,0,0
"El Salvador","2024-08-13",0,0,0,0,0,0,0,0
"El Salvador","2024-08-14",0,0,0,0,0,0,0,0
"El Salvador","2024-08-15",0,0,0,0,0,0,0,0
"El Salvador","2024-08-16",0,0,0,0,0,0,0,0
"El Salvador","2024-08-17",0,0,0,0,0,0,0,0
"El Salvador","2024-08-18",0,0,0,0,0,0,0,0
"El Salvador","2024-08-19",0,0,0,0,0,0,0,0
"El Salvador","2024-08-20",0,0,0,0,0,0,0,0
"El Salvador","2024-08-21",0,0,0,0,0,0,0,0
"El Salvador","2024-08-22",0,0,0,0,0,0,0,0
"El Salvador","2024-08-23",0,0,0,0,0,0,0,0
"El Salvador","2024-08-24",0,0,0,0,0,0,0,0
"El Salvador","2024-08-25",0,0,0,0,0,0,0,0
"El Salvador","2024-08-26",0,0,0,0,0,0,0,0
"El Salvador","2024-08-27",0,0,0,0,0,0,0,0
"El Salvador","2024-08-28",0,0,0,0,0,0,0,0
"El Salvador","2024-08-29",0,0,0,0,0,0,0,0
"El Salvador","2024-08-30",0,0,0,0,0,0,0,0
"El Salvador","2024-08-31",0,0,0,0,0,0,0,0
"El Salvador","2024-09-01",0,0,0,0,0,0,0,0
"El Salvador","2024-09-02",0,0,0,0,0,0,0,0
"El Salvador","2024-09-03",0,0,0,0,0,0,0,0
"El Salvador","2024-09-04",0,0,0,0,0,0,0,0
"El Salvador","2024-09-05",0,0,0,0,0,0,0,0
"El Salvador","2024-09-06",0,0,0,0,0,0,0,0
"El Salvador","2024-09-07",0,0,0,0,0,0,0,0
"El Salvador","2024-09-08",0,0,0,0,0,0,0,0
"El Salvador","2024-09-09",0,0,0,0,0,0,0,0
"El Salvador","2024-09-10",0,0,0,0,0,0,0,0
"El Salvador","2024-09-11",0,0,0,0,0,0,0,0
"El Salvador","2024-09-12",0,0,0,0,0,0,0,0
"El Salvador","2024-09-13",0,0,0,0,0,0,0,0
"El Salvador","2024-09-14",0,0,0,0,0,0,0,0
"El Salvador","2024-09-15",0,0,0,0,0,0,0,0
"El Salvador","2024-09-16",0,0,0,0,0,0,0,0
"El Salvador","2024-09-17",0,0,0,0,0,0,0,0
"El Salvador","2024-09-18",0,0,0,0,0,0,0,0
"El Salvador","2024-09-19",0,0,0,0,0,0,0,0
"El Salvador","2024-09-20",0,0,0,0,0,0,0,0
"El Salvador","2024-09-21",0,0,0,0,0,0,0,0
"El Salvador","2024-09-22",0,0,0,0,0,0,0,0
"El Salvador","2024-09-23",0,0,0,0,0,0,0,0
"El Salvador","2024-09-24",0,0,0,0,0,0,0,0
"El Salvador","2024-09-25",0,0,0,0,0,0,0,0
"El Salvador","2024-09-26",0,0,0,0,0,0,0,0
"El Salvador","2024-09-27",0,0,0,0,0,0,0,0
"El Salvador","2024-09-28",0,0,0,0,0,0,0,0
"El Salvador","2024-09-29",0,0,0,0,0,0,0,0
"El Salvador","2024-09-30",0,0,0,0,0,0,0,0
"El Salvador","2024-10-01",0,0,0,0,0,0,0,0
"El Salvador","2024-10-02",0,0,0,0,0,0,0,0
"El Salvador","2024-10-03",0,0,0,0,0,0,0,0
"El Salvador","2024-10-04",0,0,0,0,0,0,0,0
"El Salvador","2024-10-05",0,0,0,0,0,0,0,0
"El Salvador","2024-10-06",0,0,0,0,0,0,0,0
"El Salvador","2024-10-07",0,0,0,0,0,0,0,0
"El Salvador","2024-10-08",0,0,0,0,0,0,0,0
"El Salvador","2024-10-09",0,0,0,0,0,0,0,0
"El Salvador","2024-10-10",0,0,0,0,0,0,0,0
"El Salvador","2024-10-11",0,0,0,0,0,0,0,0
"El Salvador","2024-10-12",0,0,0,0,0,0,0,0
"El Salvador","2024-10-13",0,0,0,0,0,0,0,0
"El Salvador","2024-10-14",0,0,0,0,0,0,0,0
"El Salvador","2024-10-15",0,0,0,0,0,0,0,0
"El Salvador","2024-10-16",0,0,0,0,0,0,0,0
"El Salvador","2024-10-17",0,0,0,0,0,0,0,0
"El Salvador","2024-10-18",0,0,0,0,0,0,0,0
"El Salvador","2024-10-19",0,0,0,0,0,0,0,0
"El Salvador","2024-10-20",0,0,0,0,0,0,0,0
"El Salvador","2024-10-21",0,0,0,0,0,0,0,0
"El Salvador","2024-10-22",0,0,0,0,0,0,0,0
"El Salvador","2024-10-23",0,0,0,0,0,0,0,0
"El Salvador","2024-10-24",0,0,0,0,0,0,0,0
"El Salvador","2024-10-25",0,0,0,0,0,0,0,0
"El Salvador","2024-10-26",0,0,0,0,0,0,0,0
"El Salvador","2024-10-27",0,0,0,0,0,0,0,0
"El Salvador","2024-10-28",0,0,0,0,0,0,0,0
"El Salvador","2024-10-29",0,0,0,0,0,0,0,0
"El Salvador","2024-10-30",0,0,0,0,0,0,0,0
"El Salvador","2024-10-31",0,0,0,0,0,0,0,0
"El Salvador","2024-11-01",0,0,0,0,0,0,0,0
"El Salvador","2024-11-02",0,0,0,0,0,0,0,0
"El Salvador","2024-11-03",0,0,0,0,0,0,0,0
"El Salvador","2024-11-04",0,0,0,0,0,0,0,0
"El Salvador","2024-11-05",0,0,0,0,0,0,0,0
"El Salvador","2024-11-06",0,0,0,0,0,0,0,0
"El Salvador","2024-11-07",0,0,0,0,0,0,0,0
"El Salvador","2024-11-08",0,0,0,0,0,0,0,0
"El Salvador","2024-11-09",0,0,0,0,0,0,0,0
"El Salvador","2024-11-10",0,0,0,0,0,0,0,0
"El Salvador","2024-11-11",0,0,0,0,0,0,0,0
"El Salvador","2024-11-12",0,0,0,0,0,0,0,0
"El Salvador","2024-11-13",0,0,0,0,0,0,0,0
"El Salvador","2024-11-14",0,0,0,0,0,0,0,0
"El Salvador","2024-11-15",0,0,0,0,0,0,0,0
"El Salvador","2024-11-16",0,0,0,0,0,0,0,0
"El Salvador","2024-11-17",0,0,0,0,0,0,0,0
"El Salvador","2024-11-18",0,0,0,0,0,0,0,0
"El Salvador","2024-11-19",0,0,0,0,0,0,0,0
"El Salvador","2024-11-20",0,0,0,0,0,0,0,0
"El Salvador","2024-11-21",0,0,0,0,0,0,0,0
"El Salvador","2024-11-22",0,0,0,0,0,0,0,0
"El Salvador","2024-11-23",0,0,0,0,0,0,0,0
"El Salvador","2024-11-24",0,0,0,0,0,0,0,0
"El Salvador","2024-11-25",0,0,0,0,0,0,0,0
"El Salvador","2024-11-26",0,0,0,0,0,0,0,0
"El Salvador","2024-11-27",0,0,0,0,0,0,0,0
"El Salvador","2024-11-28",0,0,0,0,0,0,0,0
"El Salvador","2024-11-29",0,0,0,0,0,0,0,0
"El Salvador","2024-11-30",0,0,0,0,0,0,0,0
"El Salvador","2024-12-01",0,0,0,0,0,0,0,0
"El Salvador","2024-12-02",0,0,0,0,0,0,0,0
"El Salvador","2024-12-03",0,0,0,0,0,0,0,0
"El Salvador","2024-12-04",0,0,0,0,0,0,0,0
"El Salvador","2024-12-05",0,0,0,0,0,0,0,0
"El Salvador","2024-12-06",0,0,0,0,0,0,0,0
"El Salvador","2024-12-07",0,0,0,0,0,0,0,0
"El Salvador","2024-12-08",0,0,0,0,0,0,0,0
"El Salvador","2024-12-09",0,0,0,0,0,0,0,0
"Estonia","2024-01-01",0,0,0,0,0,0,0,0
"Estonia","2024-01-02",0,0,0,0,0,0,0,0
"Estonia","2024-01-03",0,0,0,0,0,0,0,0
"Estonia","2024-01-04",0,0,0,0,0,0,0,0
"Estonia","2024-01-05",0,0,0,0,0,0,0,0
"Estonia","2024-01-06",0,0,0,0,0,0,0,0
"Estonia","2024-01-07",0,0,0,0,0,0,0,0
"Estonia","2024-01-08",0,0,0,0,0,0,0,0
"Estonia","2024-01-09",0,0,0,0,0,0,0,0
"Estonia","2024-01-10",0,0,0,0,0,0,0,0
"Estonia","2024-01-11",0,0,0,0,0,0,0,0
"Estonia","2024-01-12",0,0,0,0,0,0,0,0
"Estonia","2024-01-13",0,0,0,0,0,0,0,0
"Estonia","2024-01-14",0,0,0,0,0,0,0,0
"Estonia","2024-01-15",0,0,0,0,0,0,0,0
"Estonia","2024-01-16",0,0,0,0,0,0,0,0
"Estonia","2024-01-17",0,0,0,0,0,0,0,0
"Estonia","2024-01-18",0,0,0,0,0,0,0,0
"Estonia","2024-01-19",0,0,0,0,0,0,0,0
"Estonia","2024-01-20",0,0,0,0,0,0,0,0
"Estonia","2024-01-21",0,0,0,0,0,0,0,0
"Estonia","2024-01-22",0,0,0,0,0,0,0,0
"Estonia","2024-01-23",0,0,0,0,0,0,0,0
"Estonia","2024-01-24",0,0,0,0,0,0,0,0
"Estonia","2024-01-25",0,0,0,0,0,0,0,0
"Estonia","2024-01-26",0,0,0,0,0,0,0,0
"Estonia","2024-01-27",0,0,0,0,0,0,0,0
"Estonia","2024-01-28",0,0,0,0,0,0,0,0
"Estonia","2024-01-29",0,0,0,0,0,0,0,0
"Estonia","2024-01-30",0,0,0,0,0,0,0,0
"Estonia","2024-01-31",0,0,0,0,0,0,0,0
"Estonia","2024-02-01",0,0,0,0,0,0,0,0
"Estonia","2024-02-02",0,0,0,0,0,0,0,0
"Estonia","2024-02-03",0,0,0,0,0,0,0,0
"Estonia","2024-02-04",0,0,0,0,0,0,0,0
"Estonia","2024-02-05",0,0,0,0,0,0,0,0
"Estonia","2024-02-06",0,0,0,0,0,0,0,0
"Estonia","2024-02-07",0,0,0,0,0,0,0,0
"Estonia","2024-02-08",0,0,0,0,0,0,0,0
"Estonia","2024-02-09",0,0,0,0,0,0,0,0
"Estonia","2024-02-10",0,0,0,0,0,0,0,0
"Estonia","2024-02-11",0,0,0,0,0,0,0,0
"Estonia","2024-02-12",0,0,0,0,0,0,0,0
"Estonia","2024-02-13",0,0,0,0,0,0,0,0
"Estonia","2024-02-14",0,0,0,0,0,0,0,0
"Estonia","2024-02-15",0,0,0,0,0,0,0,0
"Estonia","2024-02-16",0,0,0,0,0,0,0,0
"Estonia","2024-02-17",0,0,0,0,0,0,0,0
"Estonia","2024-02-18",0,0,0,0,0,0,0,0
"Estonia","2024-02-19",0,0,0,0,0,0,0,0
"Estonia","2024-02-20",0,0,0,0,0,0,0,0
"Estonia","2024-02-21",0,0,0,0,0,0,0,0
"Estonia","2024-02-22",0,0,0,0,0,0,0,0
"Estonia","2024-02-23",0,0,0,0,0,0,0,0
"Estonia","2024-02-24",0,0,0,0,0,0,0,0
"Estonia","2024-02-25",0,0,0,0,0,0,0,0
"Estonia","2024-02-26",0,0,0,0,0,0,0,0
"Estonia","2024-02-27",0,0,0,0,0,0,0,0
"Estonia","2024-02-28",0,0,0,0,0,0,0,0
"Estonia","2024-02-29",0,0,0,0,0,0,0,0
"Estonia","2024-03-01",0,0,0,0,0,0,0,0
"Estonia","2024-03-02",0,0,0,0,0,0,0,0
"Estonia","2024-03-03",0,0,0,0,0,0,0,0
"Estonia","2024-03-04",0,0,0,0,0,0,0,0
"Estonia","2024-03-05",0,0,0,0,0,0,0,0
"Estonia","2024-03-06",0,0,0,0,0,0,0,0
"Estonia","2024-03-07",0,0,0,0,0,0,0,0
"Estonia","2024-03-08",0,0,0,0,0,0,0,0
"Estonia","2024-03-09",0,0,0,0,0,0,0,0
"Estonia","2024-03-10",0,0,0,0,0,0,0,0
"Estonia","2024-03-11",0,0,0,0,0,0,0,0
"Estonia","2024-03-12",0,0,0,0,0,0,0,0
"Estonia","2024-03-13",0,0,0,0,0,0,0,0
"Estonia","2024-03-14",0,0,0,0,0,0,0,0
"Estonia","2024-03-15",0,0,0,0,0,0,0,0
"Estonia","2024-03-16",0,0,0,0,0,0,0,0
"Estonia","2024-03-17",0,0,0,0,0,0,0,0
"Estonia","2024-03-18",0,0,0,0,0,0,0,0
"Estonia","2024-03-19",0,0,0,0,0,0,0,0
"Estonia","2024-03-20",0,0,0,0,0,0,0,0
"Estonia","2024-03-21",0,0,0,0,0,0,0,0
"Estonia","2024-03-22",0,0,0,0,0,0,0,0
"Estonia","2024-03-23",0,0,0,0,0,0,0,0
"Estonia","2024-03-24",0,0,0,0,0,0,0,0
"Estonia","2024-03-25",0,0,0,0,0,0,0,0
"Estonia","2024-03-26",0,0,0,0,0,0,0,0
"Estonia","2024-03-27",0,0,0,0,0,0,0,0
"Estonia","2024-03-28",0,0,0,0,0,0,0,0
"Estonia","2024-03-29",0,0,0,0,0,0,0,0
"Estonia","2024-03-30",0,0,0,0,0,0,0,0
"Estonia","2024-03-31",0,0,0,0,0,0,0,0
"Estonia","2024-04-01",0,0,0,0,0,0,0,0
"Estonia","2024-04-02",0,0,0,0,0,0,0,0
"Estonia","2024-04-03",0,0,0,0,0,0,0,0
"Estonia","2024-04-04",0,0,0,0,0,0,0,0
"Estonia","2024-04-05",0,0,0,0,0,0,0,0
"Estonia","2024-04-06",0,0,0,0,0,0,0,0
"Estonia","2024-04-07",0,0,0,0,0,0,0,0
"Estonia","2024-04-08",0,0,0,0,0,0,0,0
"Estonia","2024-04-09",0,0,0,0,0,0,0,0
"Estonia","2024-04-10",0,0,0,0,0,0,0,0
"Estonia","2024-04-11",0,0,0,0,0,0,0,0
"Estonia","2024-04-12",0,0,0,0,0,0,0,0
"Estonia","2024-04-13",0,0,0,0,0,0,0,0
"Estonia","2024-04-14",0,0,0,0,0,0,0,0
"Estonia","2024-04-15",0,0,0,0,0,0,0,0
"Estonia","2024-04-16",0,0,0,0,0,0,0,0
"Estonia","2024-04-17",0,0,0,0,0,0,0,0
"Estonia","2024-04-18",0,0,0,0,0,0,0,0
"Estonia","2024-04-19",0,0,0,0,0,0,0,0
"Estonia","2024-04-20",0,0,0,0,0,0,0,0
"Estonia","2024-04-21",0,0,0,0,0,0,0,0
"Estonia","2024-04-22",0,0,0,0,0,0,0,0
"Estonia","2024-04-23",0,0,0,0,0,0,0,0
"Estonia","2024-04-24",0,0,0,0,0,0,0,0
"Estonia","2024-04-25",0,0,0,0,0,0,0,0
"Estonia","2024-04-26",0,0,0,0,0,0,0,0
"Estonia","2024-04-27",0,0,0,0,0,0,0,0
"Estonia","2024-04-28",0,0,0,0,0,0,0,0
"Estonia","2024-04-29",0,0,0,0,0,0,0,0
"Estonia","2024-04-30",0,0,0,0,0,0,0,0
"Estonia","2024-05-01",0,0,0,0,0,0,0,0
"Estonia","2024-05-02",0,0,0,0,0,0,0,0
"Estonia","2024-05-03",0,0,0,0,0,0,0,0
"Estonia","2024-05-04",0,0,0,0,0,0,0,0
"Estonia","2024-05-05",0,0,0,0,0,0,0,0
"Estonia","2024-05-06",0,0,0,0,0,0,0,0
"Estonia","2024-05-07",0,0,0,0,0,0,0,0
"Estonia","2024-05-08",0,0,0,0,0,0,0,0
"Estonia","2024-05-09",0,0,0,0,0,0,0,0
"Estonia","2024-05-10",0,0,0,0,0,0,0,0
"Estonia","2024-05-11",0,0,0,0,0,0,0,0
"Estonia","2024-05-12",0,0,0,0,0,0,0,0
"Estonia","2024-05-13",0,0,0,0,0,0,0,0
"Estonia","2024-05-14",0,0,0,0,0,0,0,0
"Estonia","2024-05-15",0,0,0,0,0,0,0,0
"Estonia","2024-05-16",0,0,0,0,0,0,0,0
"Estonia","2024-05-17",0,0,0,0,0,0,0,0
"Estonia","2024-05-18",0,0,0,0,0,0,0,0
"Estonia","2024-05-19",0,0,0,0,0,0,0,0
"Estonia","2024-05-20",0,0,0,0,0,0,0,0
"Estonia","2024-05-21",0,0,0,0,0,0,0,0
"Estonia","2024-05-22",0,0,0,0,0,0,0,0
"Estonia","2024-05-23",0,0,0,0,0,0,0,0
"Estonia","2024-05-24",0,0,0,0,0,0,0,0
"Estonia","2024-05-25",0,0,0,0,0,0,0,0
"Estonia","2024-05-26",0,0,0,0,0,0,0,0
"Estonia","2024-05-27",0,0,0,0,0,0,0,0
"Estonia","2024-05-28",0,0,0,0,0,0,0,0
"Estonia","2024-05-29",0,0,0,0,0,0,0,0
"Estonia","2024-05-30",0,0,0,0,0,0,0,0
"Estonia","2024-05-31",0,0,0,0,0,0,0,0
"Estonia","2024-06-01",0,0,0,0,0,0,0,0
"Estonia","2024-06-02",0,0,0,0,0,0,0,0
"Estonia","2024-06-03",0,0,0,0,0,0,0,0
"Estonia","2024-06-04",0,0,0,0,0,0,0,0
"Estonia","2024-06-05",0,0,0,0,0,0,0,0
"Estonia","2024-06-06",0,0,0,0,0,0,0,0
"Estonia","2024-06-07",0,0,0,0,0,0,0,0
"Estonia","2024-06-08",0,0,0,0,0,0,0,0
"Estonia","2024-06-09",0,0,0,0,0,0,0,0
"Estonia","2024-06-10",0,0,0,0,0,0,0,0
"Estonia","2024-06-11",0,0,0,0,0,0,0,0
"Estonia","2024-06-12",0,0,0,0,0,0,0,0
"Estonia","2024-06-13",0,0,0,0,0,0,0,0
"Estonia","2024-06-14",0,0,0,0,0,0,0,0
"Estonia","2024-06-15",0,0,0,0,0,0,0,0
"Estonia","2024-06-16",0,0,0,0,0,0,0,0
"Estonia","2024-06-17",0,0,0,0,0,0,0,0
"Estonia","2024-06-18",0,0,0,0,0,0,0,0
"Estonia","2024-06-19",0,0,0,0,0,0,0,0
"Estonia","2024-06-20",0,0,0,0,0,0,0,0
"Estonia","2024-06-21",0,0,0,0,0,0,0,0
"Estonia","2024-06-22",0,0,0,0,0,0,0,0
"Estonia","2024-06-23",0,0,0,0,0,0,0,0
"Estonia","2024-06-24",0,0,0,0,0,0,0,0
"Estonia","2024-06-25",0,0,0,0,0,0,0,0
"Estonia","2024-06-26",0,0,0,0,0,0,0,0
"Estonia","2024-06-27",0,0,0,0,0,0,0,0
"Estonia","2024-06-28",0,0,0,0,0,0,0,0
"Estonia","2024-06-29",0,0,0,0,0,0,0,0
"Estonia","2024-06-30",0,0,0,0,0,0,0,0
"Estonia","2024-07-01",0,0,0,0,0,0,0,0
"Estonia","2024-07-02",0,0,0,0,0,0,0,0
"Estonia","2024-07-03",0,0,0,0,0,0,0,0
"Estonia","2024-07-04",0,0,0,0,0,0,0,0
"Estonia","2024-07-05",0,0,0,0,0,0,0,0
"Estonia","2024-07-06",0,0,0,0,0,0,0,0
"Estonia","2024-07-07",0,0,0,0,0,0,0,0
"Estonia","2024-07-08",0,0,0,0,0,0,0,0
"Estonia","2024-07-09",0,0,0,0,0,0,0,0
"Estonia","2024-07-10",0,0,0,0,0,0,0,0
"Estonia","2024-07-11",0,0,0,0,0,0,0,0
"Estonia","2024-07-12",0,0,0,0,0,0,0,0
"Estonia","2024-07-13",0,0,0,0,0,0,0,0
"Estonia","2024-07-14",0,0,0,0,0,0,0,0
"Estonia","2024-07-15",0,0,0,0,0,0,0,0
"Estonia","2024-07-16",0,0,0,0,0,0,0,0
"Estonia","2024-07-17",0,0,0,0,0,0,0,0
"Estonia","2024-07-18",0,0,0,0,0,0,0,0
"Estonia","2024-07-19",0,0,0,0,0,0,0,0
"Estonia","2024-07-20",0,0,0,0,0,0,0,0
"Estonia","2024-07-21",0,0,0,0,0,0,0,0
"Estonia","2024-07-22",0,0,0,0,0,0,0,0
"Estonia","2024-07-23",0,0,0,0,0,0,0,0
"Estonia","2024-07-24",0,0,0,0,0,0,0,0
"Estonia","2024-07-25",0,0,0,0,0,0,0,0
"Estonia","2024-07-26",0,0,0,0,0,0,0,0
"Estonia","2024-07-27",0,0,0,0,0,0,0,0
"Estonia","2024-07-28",0,0,0,0,0,0,0,0
"Estonia","2024-07-29",0,0,0,0,0,0,0,0
"Estonia","2024-07-30",0,0,0,0,0,0,0,0
"Estonia","2024-07-31",0,0,0,0,0,0,0,0
"Estonia","2024-08-01",0,0,0,0,0,0,0,0
"Estonia","2024-08-02",0,0,0,0,0,0,0,0
"Estonia","2024-08-03",0,0,0,0,0,0,0,0
"Estonia","2024-08-04",0,0,0,0,0,0,0,0
"Estonia","2024-08-05",0,0,0,0,0,0,0,0
"Estonia","2024-08-06",0,0,0,0,0,0,0,0
"Estonia","2024-08-07",0,0,0,0,0,0,0,0
"Estonia","2024-08-08",0,0,0,0,0,0,0,0
"Estonia","2024-08-09",0,0,0,0,0,0,0,0
"Estonia","2024-08-10",0,0,0,0,0,0,0,0
"Estonia","2024-08-11",0,0,0,0,0,0,0,0
"Estonia","2024-08-12",0,0,0,0,0,0,0,0
"Estonia","2024-08-13",0,0,0,0,0,0,0,0
"Estonia","2024-08-14",0,0,0,0,0,0,0,0
"Estonia","2024-08-15",0,0,0,0,0,0,0,0
"Estonia","2024-08-16",0,0,0,0,0,0,0,0
"Estonia","2024-08-17",0,0,0,0,0,0,0,0
"Estonia","2024-08-18",0,0,0,0,0,0,0,0
"Estonia","2024-08-19",0,0,0,0,0,0,0,0
"Estonia","2024-08-20",0,0,0,0,0,0,0,0
"Estonia","2024-08-21",0,0,0,0,0,0,0,0
"Estonia","2024-08-22",0,0,0,0,0,0,0,0
"Estonia","2024-08-23",0,0,0,0,0,0,0,0
"Estonia","2024-08-24",0,0,0,0,0,0,0,0
"Estonia","2024-08-25",0,0,0,0,0,0,0,0
"Estonia","2024-08-26",0,0,0,0,0,0,0,0
"Estonia","2024-08-27",0,0,0,0,0,0,0,0
"Estonia","2024-08-28",0,0,0,0,0,0,0,0
"Estonia","2024-08-29",0,0,0,0,0,0,0,0
"Estonia","2024-08-30",0,0,0,0,0,0,0,0
"Estonia","2024-08-31",0,0,0,0,0,0,0,0
"Estonia","2024-09-01",0,0,0,0,0,0,0,0
"Estonia","2024-09-02",0,0,0,0,0,0,0,0
"Estonia","2024-09-03",0,0,0,0,0,0,0,0
"Estonia","2024-09-04",0,0,0,0,0,0,0,0
"Estonia","2024-09-05",0,0,0,0,0,0,0,0
"Estonia","2024-09-06",0,0,0,0,0,0,0,0
"Estonia","2024-09-07",0,0,0,0,0,0,0,0
"Estonia","2024-09-08",0,0,0,0,0,0,0,0
"Estonia","2024-09-09",0,0,0,0,0,0,0,0
"Estonia","2024-09-10",0,0,0,0,0,0,0,0
"Estonia","2024-09-11",0,0,0,0,0,0,0,0
"Estonia","2024-09-12",0,0,0,0,0,0,0,0
"Estonia","2024-09-13",0,0,0,0,0,0,0,0
"Estonia","2024-09-14",0,0,0,0,0,0,0,0
"Estonia","2024-09-15",0,0,0,0,0,0,0,0
"Estonia","2024-09-16",0,0,0,0,0,0,0,0
"Estonia","2024-09-17",0,0,0,0,0,0,0,0
"Estonia","2024-09-18",0,0,0,0,0,0,0,0
"Estonia","2024-09-19",0,0,0,0,0,0,0,0
"Estonia","2024-09-20",0,0,0,0,0,0,0,0
"Estonia","2024-09-21",0,0,0,0,0,0,0,0
"Estonia","2024-09-22",0,0,0,0,0,0,0,0
"Estonia","2024-09-23",0,0,0,0,0,0,0,0
"Estonia","2024-09-24",0,0,0,0,0,0,0,0
"Estonia","2024-09-25",0,0,0,0,0,0,0,0
"Estonia","2024-09-26",0,0,0,0,0,0,0,0
"Estonia","2024-09-27",0,0,0,0,0,0,0,0
"Estonia","2024-09-28",0,0,0,0,0,0,0,0
"Estonia","2024-09-29",0,0,0,0,0,0,0,0
"Estonia","2024-09-30",0,0,0,0,0,0,0,0
"Estonia","2024-10-01",0,0,0,0,0,0,0,0
"Estonia","2024-10-02",0,0,0,0,0,0,0,0
"Estonia","2024-10-03",0,0,0,0,0,0,0,0
"Estonia","2024-10-04",0,0,0,0,0,0,0,0
"Estonia","2024-10-05",0,0,0,0,0,0,0,0
"Estonia","2024-10-06",0,0,0,0,0,0,0,0
"Estonia","2024-10-07",0,0,0,0,0,0,0,0
"Estonia","2024-10-08",0,0,0,0,0,0,0,0
"Estonia","2024-10-09",0,0,0,0,0,0,0,0
"Estonia","2024-10-10",0,0,0,0,0,0,0,0
"Estonia","2024-10-11",0,0,0,0,0,0,0,0
"Estonia","2024-10-12",0,0,0,0,0,0,0,0
"Estonia","2024-10-13",0,0,0,0,0,0,0,0
"Estonia","2024-10-14",0,0,0,0,0,0,0,0
"Estonia","2024-10-15",0,0,0,0,0,0,0,0
"Estonia","2024-10-16",0,0,0,0,0,0,0,0
"Estonia","2024-10-17",0,0,0,0,0,0,0,0
"Estonia","2024-10-18",0,0,0,0,0,0,0,0
"Estonia","2024-10-19",0,0,0,0,0,0,0,0
"Estonia","2024-10-20",0,0,0,0,0,0,0,0
"Estonia","2024-10-21",0,0,0,0,0,0,0,0
"Estonia","2024-10-22",0,0,0,0,0,0,0,0
"Estonia","2024-10-23",0,0,0,0,0,0,0,0
"Estonia","2024-10-24",0,0,0,0,0,0,0,0
"Estonia","2024-10-25",0,0,0,0,0,0,0,0
"Estonia","2024-10-26",0,0,0,0,0,0,0,0
"Estonia","2024-10-27",0,0,0,0,0,0,0,0
"Estonia","2024-10-28",0,0,0,0,0,0,0,0
"Estonia","2024-10-29",0,0,0,0,0,0,0,0
"Estonia","2024-10-30",0,0,0,0,0,0,0,0
"Estonia","2024-10-31",0,0,0,0,0,0,0,0
"Estonia","2024-11-01",0,0,0,0,0,0,0,0
"Estonia","2024-11-02",0,0,0,0,0,0,0,0
"Estonia","2024-11-03",0,0,0,0,0,0,0,0
"Estonia","2024-11-04",0,0,0,0,0,0,0,0
"Estonia","2024-11-05",0,0,0,0,0,0,0,0
"Estonia","2024-11-06",0,0,0,0,0,0,0,0
"Estonia","2024-11-07",0,0,0,0,0,0,0,0
"Estonia","2024-11-08",0,0,0,0,0,0,0,0
"Estonia","2024-11-09",0,0,0,0,0,0,0,0
"Estonia","2024-11-10",0,0,0,0,0,0,0,0
"Estonia","2024-11-11",0,0,0,0,0,0,0,0
"Estonia","2024-11-12",0,0,0,0,0,0,0,0
"Estonia","2024-11-13",0,0,0,0,0,0,0,0
"Estonia","2024-11-14",0,0,0,0,0,0,0,0
"Estonia","2024-11-15",0,0,0,0,0,0,0,0
"Estonia","2024-11-16",0,0,0,0,0,0,0,0
"Estonia","2024-11-17",0,0,0,0,0,0,0,0
"Estonia","2024-11-18",0,0,0,0,0,0,0,0
"Estonia","2024-11-19",0,0,0,0,0,0,0,0
"Estonia","2024-11-20",0,0,0,0,0,0,0,0
"Estonia","2024-11-21",0,0,0,0,0,0,0,0
"Estonia","2024-11-22",0,0,0,0,0,0,0,0
"Estonia","2024-11-23",0,0,0,0,0,0,0,0
"Estonia","2024-11-24",0,0,0,0,0,0,0,0
"Estonia","2024-11-25",0,0,0,0,0,0,0,0
"Estonia","2024-11-26",0,0,0,0,0,0,0,0
"Estonia","2024-11-27",0,0,0,0,0,0,0,0
"Estonia","2024-11-28",0,0,0,0,0,0,0,0
"Estonia","2024-11-29",0,0,0,0,0,0,0,0
"Estonia","2024-11-30",0,0,0,0,0,0,0,0
"Estonia","2024-12-01",0,0,0,0,0,0,0,0
"Estonia","2024-12-02",0,0,0,0,0,0,0,0
"Estonia","2024-12-03",0,0,0,0,0,0,0,0
"Estonia","2024-12-04",0,0,0,0,0,0,0,0
"Estonia","2024-12-05",0,0,0,0,0,0,0,0
"Estonia","2024-12-06",0,0,0,0,0,0,0,0
"Estonia","2024-12-07",0,0,0,0,0,0,0,0
"Estonia","2024-12-08",0,0,0,0,0,0,0,0
"Estonia","2024-12-09",0,0,0,0,0,0,0,0
"Europe","2024-01-01",0,0,0,0,0,0,0,0
"Europe","2024-01-02",0,0,0,0,0,0,0,0
"Europe","2024-01-03",0,0,0,0,0,0,0,0
"Europe","2024-01-04",0,0,0,0,0,0,0,0
"Europe","2024-01-05",0,0,0,0,0,0,0,0
"Europe","2024-01-06",0,0,0,0,0,0,0,0
"Europe","2024-01-07",0,0,0,0,0,0,0,0
"Europe","2024-01-08",0,0,0,0,0,0,0,0
"Europe","2024-01-09",0,0,0,0,0,0,0,0
"Europe","2024-01-10",0,0,0,0,0,0,0,0
"Europe","2024-01-11",0,0,0,0,0,0,0,0
"Europe","2024-01-12",0,0,0,0,0,0,0,0
"Europe","2024-01-13",0,0,0,0,0,0,0,0
"Europe","2024-01-14",0,0,0,0,0,0,0,0
"Europe","2024-01-15",0,0,0,0,0,0,0,0
"Europe","2024-01-16",0,0,0,0,0,0,0,0
"Europe","2024-01-17",0,0,0,0,0,0,0,0
"Europe","2024-01-18",0,0,0,0,0,0,0,0
"Europe","2024-01-19",0,0,0,0,0,0,0,0
"Europe","2024-01-20",0,0,0,0,0,0,0,0
"Europe","2024-01-21",0,0,0,0,0,0,0,0
"Europe","2024-01-22",0,0,0,0,0,0,0,0
"Europe","2024-01-23",0,0,0,0,0,0,0,0
"Europe","2024-01-24",0,0,0,0,0,0,0,0
"Europe","2024-01-25",0,0,0,0,0,0,0,0
"Europe","2024-01-26",0,0,0,0,0,0,0,0
"Europe","2024-01-27",0,0,0,0,0,0,0,0
"Europe","2024-01-28",0,0,0,0,0,0,0,0
"Europe","2024-01-29",0,0,0,0,0,0,0,0
"Europe","2024-01-30",0,0,0,0,0,0,0,0
"Europe","2024-01-31",0,141,141,0,141,141,0,0
"Europe","2024-02-01",0,0,141,0,7,148,0,0
"Europe","2024-02-02",0,0,141,0,6,154,0,0
"Europe","2024-02-03",0,0,141,0,7,161,0,0
"Europe","2024-02-04",0,0,141,0,7,168,0,0
"Europe","2024-02-05",0,0,141,0,7,175,0,0
"Europe","2024-02-06",0,0,141,0,6,181,0,0
"Europe","2024-02-07",0,0,141,0,7,188,0,0
"Europe","2024-02-08",0,0,141,0,7,195,0,0
"Europe","2024-02-09",0,0,141,0,7,202,0,0
"Europe","2024-02-10",0,0,141,0,6,208,0,0
"Europe","2024-02-11",0,0,141,0,7,215,0,0
"Europe","2024-02-12",0,0,141,0,7,222,0,0
"Europe","2024-02-13",0,0,141,0,6,228,0,0
"Europe","2024-02-14",0,0,141,0,7,235,0,0
"Europe","2024-02-15",0,0,141,0,7,242,0,0
"Europe","2024-02-16",0,0,141,0,7,249,0,0
"Europe","2024-02-17",0,0,141,0,6,255,0,0
"Europe","2024-02-18",0,0,141,0,7,262,0,0
"Europe","2024-02-19",0,0,141,0,7,269,0,0
"Europe","2024-02-20",0,0,141,0,6,275,0,0
"Europe","2024-02-21",0,0,141,0,7,282,0,0
"Europe","2024-02-22",0,0,141,0,7,289,0,0
"Europe","2024-02-23",0,0,141,0,7,296,0,0
"Europe","2024-02-24",0,0,141,0,6,302,0,0
"Europe","2024-02-25",0,0,141,0,7,309,0,0
"Europe","2024-02-26",0,0,141,0,7,316,0,0
"Europe","2024-02-27",0,0,141,0,7,323,0,0
"Europe","2024-02-28",0,0,141,0,6,329,0,0
"Europe","2024-02-29",0,195,336,0,7,336,0,0
"Europe","2024-03-01",0,0,336,0,4,340,0,0
"Europe","2024-03-02",0,0,336,0,4,344,0,0
"Europe","2024-03-03",0,0,336,0,4,348,0,0
"Europe","2024-03-04",0,0,336,0,4,352,0,0
"Europe","2024-03-05",0,0,336,0,4,356,0,0
"Europe","2024-03-06",0,0,336,0,4,360,0,0
"Europe","2024-03-07",0,0,336,0,4,364,0,0
"Europe","2024-03-08",0,0,336,0,4,368,0,0
"Europe","2024-03-09",0,0,336,0,4,372,0,0
"Europe","2024-03-10",0,0,336,0,4,376,0,0
"Europe","2024-03-11",0,0,336,0,4,380,0,0
"Europe","2024-03-12",0,0,336,0,4,384,0,0
"Europe","2024-03-13",0,0,336,0,4,388,0,0
"Europe","2024-03-14",0,0,336,0,4,392,0,0
"Europe","2024-03-15",0,0,336,0,4,396,0,0
"Europe","2024-03-16",0,0,336,0,3,399,0,0
"Europe","2024-03-17",0,0,336,0,4,403,0,0
"Europe","2024-03-18",0,0,336,0,4,407,0,0
"Europe","2024-03-19",0,0,336,0,4,411,0,0
"Europe","2024-03-20",0,0,336,0,4,415,0,0
"Europe","2024-03-21",0,0,336,0,4,419,0,0
"Europe","2024-03-22",0,0,336,0,4,423,0,0
"Europe","2024-03-23",0,0,336,0,4,427,0,0
"Europe","2024-03-24",0,0,336,0,4,431,0,0
"Europe","2024-03-25",0,0,336,0,4,435,0,0
"Europe","2024-03-26",0,0,336,0,4,439,0,0
"Europe","2024-03-27",0,0,336,0,4,443,0,0
"Europe","2024-03-28",0,0,336,0,4,447,0,0
"Europe","2024-03-29",0,0,336,0,4,451,0,0
"Europe","2024-03-30",0,0,336,0,4,455,0,0
"Europe","2024-03-31",0,123,459,0,4,459,0,0
"Europe","2024-04-01",0,0,459,0,4,463,0,0
"Europe","2024-04-02",0,0,459,0,3,466,0,0
"Europe","2024-04-03",0,0,459,0,4,470,0,0
"Europe","2024-04-04",0,0,459,0,3,473,0,0
"Europe","2024-04-05",0,0,459,0,4,477,0,0
"Europe","2024-04-06",0,0,459,0,4,481,0,0
"Europe","2024-04-07",0,0,459,0,3,484,0,0
"Europe","2024-04-08",0,0,459,0,4,488,0,0
"Europe","2024-04-09",0,0,459,0,3,491,0,0
"Europe","2024-04-10",0,0,459,0,4,495,0,0
"Europe","2024-04-11",0,0,459,0,4,499,0,0
"Europe","2024-04-12",0,0,459,0,3,502,0,0
"Europe","2024-04-13",0,0,459,0,4,506,0,0
"Europe","2024-04-14",0,0,459,0,3,509,0,0
"Europe","2024-04-15",0,0,459,0,4,513,0,0
"Europe","2024-04-16",0,0,459,0,4,517,0,0
"Europe","2024-04-17",0,0,459,0,3,520,0,0
"Europe","2024-04-18",0,0,459,0,4,524,0,0
"Europe","2024-04-19",0,0,459,0,3,527,0,0
"Europe","2024-04-20",0,0,459,0,4,531,0,0
"Europe","2024-04-21",0,0,459,0,4,535,0,0
"Europe","2024-04-22",0,0,459,0,3,538,0,0
"Europe","2024-04-23",0,0,459,0,4,542,0,0
"Europe","2024-04-24",0,0,459,0,3,545,0,0
"Europe","2024-04-25",0,0,459,0,4,549,0,0
"Europe","2024-04-26",0,0,459,0,4,553,0,0
"Europe","2024-04-27",0,0,459,0,3,556,0,0
"Europe","2024-04-28",0,0,459,0,4,560,0,0
"Europe","2024-04-29",0,0,459,0,3,563,0,0
"Europe","2024-04-30",0,108,567,0,4,567,0,0
"Europe","2024-05-01",0,0,567,0,4,571,0,0
"Europe","2024-05-02",0,0,567,0,4,575,0,0
"Europe","2024-05-03",0,0,567,0,4,579,0,0
"Europe","2024-05-04",0,0,567,0,4,583,0,0
"Europe","2024-05-05",0,0,567,0,4,587,0,0
"Europe","2024-05-06",0,0,567,0,4,591,0,0
"Europe","2024-05-07",0,0,567,0,4,595,0,0
"Europe","2024-05-08",0,0,567,0,4,599,0,0
"Europe","2024-05-09",0,0,567,0,4,603,0,0
"Europe","2024-05-10",0,0,567,0,4,607,0,0
"Europe","2024-05-11",0,0,567,0,4,611,0,0
"Europe","2024-05-12",0,0,567,0,4,615,0,0
"Europe","2024-05-13",0,0,567,0,4,619,0,0
"Europe","2024-05-14",0,0,567,0,4,623,0,0
"Europe","2024-05-15",0,0,567,0,4,627,0,0
"Europe","2024-05-16",0,0,567,0,3,630,0,0
"Europe","2024-05-17",0,0,567,0,4,634,0,0
"Europe","2024-05-18",0,0,567,0,4,638,0,0
"Europe","2024-05-19",0,0,567,0,4,642,0,0
"Europe","2024-05-20",0,0,567,0,4,646,0,0
"Europe","2024-05-21",0,0,567,0,4,650,0,0
"Europe","2024-05-22",0,0,567,0,4,654,0,0
"Europe","2024-05-23",0,0,567,0,4,658,0,0
"Europe","2024-05-24",0,0,567,0,4,662,0,0
"Europe","2024-05-25",0,0,567,0,4,666,0,0
"Europe","2024-05-26",0,0,567,0,4,670,0,0
"Europe","2024-05-27",0,0,567,0,4,674,0,0
"Europe","2024-05-28",0,0,567,0,4,678,0,0
"Europe","2024-05-29",0,0,567,0,4,682,0,0
"Europe","2024-05-30",0,0,567,0,4,686,0,0
"Europe","2024-05-31",0,123,690,0,4,690,0,0
"Europe","2024-06-01",0,0,690,0,3,693,0,0
"Europe","2024-06-02",0,0,690,0,4,697,0,0
"Europe","2024-06-03",0,0,690,0,3,700,0,0
"Europe","2024-06-04",0,0,690,0,3,703,0,0
"Europe","2024-06-05",0,0,690,0,3,706,0,0
"Europe","2024-06-06",0,0,690,0,4,710,0,0
"Europe","2024-06-07",0,0,690,0,3,713,0,0
"Europe","2024-06-08",0,0,690,0,3,716,0,0
"Europe","2024-06-09",0,0,690,0,3,719,0,0
"Europe","2024-06-10",0,0,690,0,4,723,0,0
"Europe","2024-06-11",0,0,690,0,3,726,0,0
"Europe","2024-06-12",0,0,690,0,3,729,0,0
"Europe","2024-06-13",0,0,690,0,3,732,0,0
"Europe","2024-06-14",0,0,690,0,4,736,0,0
"Europe","2024-06-15",0,0,690,0,3,739,0,0
"Europe","2024-06-16",0,0,690,0,3,742,0,0
"Europe","2024-06-17",0,0,690,0,4,746,0,0
"Europe","2024-06-18",0,0,690,0,3,749,0,0
"Europe","2024-06-19",0,0,690,0,3,752,0,0
"Europe","2024-06-20",0,0,690,0,3,755,0,0
"Europe","2024-06-21",0,0,690,0,4,759,0,0
"Europe","2024-06-22",0,0,690,0,3,762,0,0
"Europe","2024-06-23",0,0,690,0,3,765,0,0
"Europe","2024-06-24",0,0,690,0,3,768,0,0
"Europe","2024-06-25",0,0,690,0,4,772,0,0
"Europe","2024-06-26",0,0,690,0,3,775,0,0
"Europe","2024-06-27",0,0,690,0,3,778,0,0
"Europe","2024-06-28",0,0,690,0,3,781,0,0
"Europe","2024-06-29",0,0,690,0,4,785,0,0
"Europe","2024-06-30",0,98,788,0,3,788,0,0
"Europe","2024-07-01",0,0,788,0,5,793,0,0
"Europe","2024-07-02",0,0,788,0,5,798,0,0
"Europe","2024-07-03",0,0,788,0,4,802,0,0
"Europe","2024-07-04",0,0,788,0,5,807,0,0
"Europe","2024-07-05",0,0,788,0,5,812,0,0
"Europe","2024-07-06",0,0,788,0,5,817,0,0
"Europe","2024-07-07",0,0,788,0,4,821,0,0
"Europe","2024-07-08",0,0,788,0,5,826,0,0
"Europe","2024-07-09",0,0,788,0,5,831,0,0
"Europe","2024-07-10",0,0,788,0,5,836,0,0
"Europe","2024-07-11",0,0,788,0,5,841,0,0
"Europe","2024-07-12",0,0,788,0,4,845,0,0
"Europe","2024-07-13",0,0,788,0,5,850,0,0
"Europe","2024-07-14",0,0,788,0,5,855,0,0
"Europe","2024-07-15",0,0,788,0,5,860,0,0
"Europe","2024-07-16",0,0,788,0,4,864,0,0
"Europe","2024-07-17",0,0,788,0,5,869,0,0
"Europe","2024-07-18",0,0,788,0,5,874,0,0
"Europe","2024-07-19",0,0,788,0,5,879,0,0
"Europe","2024-07-20",0,0,788,0,4,883,0,0
"Europe","2024-07-21",0,0,788,0,5,888,0,0
"Europe","2024-07-22",0,0,788,0,5,893,0,0
"Europe","2024-07-23",0,0,788,0,5,898,0,0
"Europe","2024-07-24",0,0,788,0,5,903,0,0
"Europe","2024-07-25",0,0,788,0,4,907,0,0
"Europe","2024-07-26",0,0,788,0,5,912,0,0
"Europe","2024-07-27",0,0,788,0,5,917,0,0
"Europe","2024-07-28",0,0,788,0,5,922,0,0
"Europe","2024-07-29",0,0,788,0,4,926,0,0
"Europe","2024-07-30",0,0,788,0,5,931,0,0
"Europe","2024-07-31",0,148,936,0,5,936,0,0
"Europe","2024-08-01",0,0,936,0,9,945,0,0
"Europe","2024-08-02",0,0,936,0,9,954,0,0
"Europe","2024-08-03",0,0,936,0,9,963,0,0
"Europe","2024-08-04",0,0,936,0,9,972,0,0
"Europe","2024-08-05",0,0,936,0,9,981,0,0
"Europe","2024-08-06",0,0,936,0,9,990,0,0
"Europe","2024-08-07",0,0,936,0,9,999,0,0
"Europe","2024-08-08",0,0,936,0,10,1009,0,0
"Europe","2024-08-09",0,0,936,0,9,1018,0,0
"Europe","2024-08-10",0,0,936,0,9,1027,0,0
"Europe","2024-08-11",0,0,936,0,9,1036,0,0
"Europe","2024-08-12",0,0,936,0,9,1045,0,0
"Europe","2024-08-13",0,0,936,0,9,1054,0,0
"Europe","2024-08-14",0,0,936,0,9,1063,0,0
"Europe","2024-08-15",0,0,936,0,9,1072,0,0
"Europe","2024-08-16",0,0,936,0,9,1081,0,0
"Europe","2024-08-17",0,0,936,0,9,1090,0,0
"Europe","2024-08-18",0,0,936,0,9,1099,0,0
"Europe","2024-08-19",0,0,936,0,9,1108,0,0
"Europe","2024-08-20",0,0,936,0,9,1117,0,0
"Europe","2024-08-21",0,0,936,0,9,1126,0,0
"Europe","2024-08-22",0,0,936,0,9,1135,0,0
"Europe","2024-08-23",0,0,936,0,9,1144,0,0
"Europe","2024-08-24",0,0,936,0,10,1154,0,0
"Europe","2024-08-25",0,0,936,0,9,1163,0,0
"Europe","2024-08-26",0,0,936,0,9,1172,0,0
"Europe","2024-08-27",0,0,936,0,9,1181,0,0
"Europe","2024-08-28",0,0,936,0,9,1190,0,0
"Europe","2024-08-29",0,0,936,0,9,1199,0,0
"Europe","2024-08-30",0,0,936,0,9,1208,0,0
"Europe","2024-08-31",0,281,1217,0,9,1217,0,0
"Europe","2024-09-01",0,0,1217,0,7,1224,0,0
"Europe","2024-09-02",0,0,1217,0,7,1231,0,0
"Europe","2024-09-03",0,0,1217,0,7,1238,0,0
"Europe","2024-09-04",0,0,1217,0,7,1245,0,0
"Europe","2024-09-05",0,0,1217,0,6,1251,0,0
"Europe","2024-09-06",0,0,1217,0,7,1258,0,0
"Europe","2024-09-07",0,0,1217,0,7,1265,0,0
"Europe","2024-09-08",0,0,1217,0,7,1272,0,0
"Europe","2024-09-09",0,0,1217,0,7,1279,0,0
"Europe","2024-09-10",0,0,1217,0,7,1286,0,0
"Europe","2024-09-11",0,0,1217,0,7,1293,0,0
"Europe","2024-09-12",0,0,1217,0,7,1300,0,0
"Europe","2024-09-13",0,0,1217,0,7,1307,0,0
"Europe","2024-09-14",0,0,1217,0,7,1314,0,0
"Europe","2024-09-15",0,0,1217,0,7,1321,0,0
"Europe","2024-09-16",0,0,1217,0,6,1327,0,0
"Europe","2024-09-17",0,0,1217,0,7,1334,0,0
"Europe","2024-09-18",0,0,1217,0,7,1341,0,0
"Europe","2024-09-19",0,0,1217,0,7,1348,0,0
"Europe","2024-09-20",0,0,1217,0,7,1355,0,0
"Europe","2024-09-21",0,0,1217,0,7,1362,0,0
"Europe","2024-09-22",0,0,1217,0,7,1369,0,0
"Europe","2024-09-23",0,0,1217,0,7,1376,0,0
"Europe","2024-09-24",0,0,1217,0,7,1383,0,0
"Europe","2024-09-25",0,0,1217,0,6,1389,0,0
"Europe","2024-09-26",0,0,1217,0,7,1396,0,0
"Europe","2024-09-27",0,0,1217,0,7,1403,0,0
"Europe","2024-09-28",0,0,1217,0,7,1410,0,0
"Europe","2024-09-29",0,0,1217,0,7,1417,0,0
"Europe","2024-09-30",0,207,1424,0,7,1424,0,0
"Europe","2024-10-01",0,0,1424,0,7,1431,0,0
"Europe","2024-10-02",0,0,1424,0,8,1439,0,0
"Europe","2024-10-03",0,0,1424,0,7,1446,0,0
"Europe","2024-10-04",0,0,1424,0,8,1454,0,0
"Europe","2024-10-05",0,0,1424,0,7,1461,0,0
"Europe","2024-10-06",0,0,1424,0,7,1468,0,0
"Europe","2024-10-07",0,0,1424,0,8,1476,0,0
"Europe","2024-10-08",0,0,1424,0,7,1483,0,0
"Europe","2024-10-09",0,0,1424,0,7,1490,0,0
"Europe","2024-10-10",0,0,1424,0,8,1498,0,0
"Europe","2024-10-11",0,0,1424,0,7,1505,0,0
"Europe","2024-10-12",0,0,1424,0,8,1513,0,0
"Europe","2024-10-13",0,0,1424,0,7,1520,0,0
"Europe","2024-10-14",0,0,1424,0,7,1527,0,0
"Europe","2024-10-15",0,0,1424,0,8,1535,0,0
"Europe","2024-10-16",0,0,1424,0,7,1542,0,0
"Europe","2024-10-17",0,0,1424,0,8,1550,0,0
"Europe","2024-10-18",0,0,1424,0,7,1557,0,0
"Europe","2024-10-19",0,0,1424,0,7,1564,0,0
"Europe","2024-10-20",0,0,1424,0,8,1572,0,0
"Europe","2024-10-21",0,0,1424,0,7,1579,0,0
"Europe","2024-10-22",0,0,1424,0,8,1587,0,0
"Europe","2024-10-23",0,0,1424,0,7,1594,0,0
"Europe","2024-10-24",0,0,1424,0,7,1601,0,0
"Europe","2024-10-25",0,0,1424,0,8,1609,0,0
"Europe","2024-10-26",0,0,1424,0,7,1616,0,0
"Europe","2024-10-27",0,0,1424,0,7,1623,0,0
"Europe","2024-10-28",0,0,1424,0,8,1631,0,0
"Europe","2024-10-29",0,0,1424,0,7,1638,0,0
"Europe","2024-10-30",0,0,1424,0,8,1646,0,0
"Europe","2024-10-31",0,229,1653,0,7,1653,0,0
"Europe","2024-11-01",0,0,1653,0,0,1653,0,0
"Europe","2024-11-02",0,0,1653,0,0,1653,0,0
"Europe","2024-11-03",0,0,1653,0,0,1653,0,0
"Europe","2024-11-04",0,0,1653,0,0,1653,0,0
"Europe","2024-11-05",0,0,1653,0,0,1653,0,0
"Europe","2024-11-06",0,0,1653,0,0,1653,0,0
"Europe","2024-11-07",0,0,1653,0,0,1653,0,0
"Europe","2024-11-08",0,0,1653,0,0,1653,0,0
"Europe","2024-11-09",0,0,1653,0,0,1653,0,0
"Europe","2024-11-10",0,0,1653,0,0,1653,0,0
"Europe","2024-11-11",0,0,1653,0,0,1653,0,0
"Europe","2024-11-12",0,0,1653,0,0,1653,0,0
"Europe","2024-11-13",0,0,1653,0,0,1653,0,0
"Europe","2024-11-14",0,0,1653,0,0,1653,0,0
"Europe","2024-11-15",0,0,1653,0,0,1653,0,0
"Europe","2024-11-16",0,0,1653,0,0,1653,0,0
"Europe","2024-11-17",0,0,1653,0,0,1653,0,0
"Europe","2024-11-18",0,0,1653,0,0,1653,0,0
"Europe","2024-11-19",0,0,1653,0,0,1653,0,0
"Europe","2024-11-20",0,0,1653,0,0,1653,0,0
"Europe","2024-11-21",0,0,1653,0,0,1653,0,0
"Europe","2024-11-22",0,0,1653,0,0,1653,0,0
"Europe","2024-11-23",0,0,1653,0,0,1653,0,0
"Europe","2024-11-24",0,0,1653,0,0,1653,0,0
"Europe","2024-11-25",0,0,1653,0,0,1653,0,0
"Europe","2024-11-26",0,0,1653,0,0,1653,0,0
"Europe","2024-11-27",0,0,1653,0,0,1653,0,0
"Europe","2024-11-28",0,0,1653,0,0,1653,0,0
"Europe","2024-11-29",0,0,1653,0,0,1653,0,0
"Europe","2024-11-30",0,0,1653,0,0,1653,0,0
"Europe","2024-12-01",0,0,1653,0,0,1653,0,0
"Europe","2024-12-02",0,0,1653,0,0,1653,0,0
"Europe","2024-12-03",0,0,1653,0,0,1653,0,0
"Europe","2024-12-04",0,0,1653,0,0,1653,0,0
"Europe","2024-12-05",0,0,1653,0,0,1653,0,0
"Europe","2024-12-06",0,0,1653,0,0,1653,0,0
"Europe","2024-12-07",0,0,1653,0,0,1653,0,0
"Europe","2024-12-08",0,0,1653,0,0,1653,0,0
"Europe","2024-12-09",0,0,1653,0,0,1653,0,0
"Finland","2024-01-01",0,0,0,0,0,0,0,0
"Finland","2024-01-02",0,0,0,0,0,0,0,0
"Finland","2024-01-03",0,0,0,0,0,0,0,0
"Finland","2024-01-04",0,0,0,0,0,0,0,0
"Finland","2024-01-05",0,0,0,0,0,0,0,0
"Finland","2024-01-06",0,0,0,0,0,0,0,0
"Finland","2024-01-07",0,0,0,0,0,0,0,0
"Finland","2024-01-08",0,0,0,0,0,0,0,0
"Finland","2024-01-09",0,0,0,0,0,0,0,0
"Finland","2024-01-10",0,0,0,0,0,0,0,0
"Finland","2024-01-11",0,0,0,0,0,0,0,0
"Finland","2024-01-12",0,0,0,0,0,0,0,0
"Finland","2024-01-13",0,0,0,0,0,0,0,0
"Finland","2024-01-14",0,0,0,0,0,0,0,0
"Finland","2024-01-15",0,0,0,0,0,0,0,0
"Finland","2024-01-16",0,0,0,0,0,0,0,0
"Finland","2024-01-17",0,0,0,0,0,0,0,0
"Finland","2024-01-18",0,0,0,0,0,0,0,0
"Finland","2024-01-19",0,0,0,0,0,0,0,0
"Finland","2024-01-20",0,0,0,0,0,0,0,0
"Finland","2024-01-21",0,0,0,0,0,0,0,0
"Finland","2024-01-22",0,0,0,0,0,0,0,0
"Finland","2024-01-23",0,0,0,0,0,0,0,0
"Finland","2024-01-24",0,0,0,0,0,0,0,0
"Finland","2024-01-25",0,0,0,0,0,0,0,0
"Finland","2024-01-26",0,0,0,0,0,0,0,0
"Finland","2024-01-27",0,0,0,0,0,0,0,0
"Finland","2024-01-28",0,0,0,0,0,0,0,0
"Finland","2024-01-29",0,0,0,0,0,0,0,0
"Finland","2024-01-30",0,0,0,0,0,0,0,0
"Finland","2024-01-31",0,0,0,0,0,0,0,0
"Finland","2024-02-01",0,0,0,0,0,0,0,0
"Finland","2024-02-02",0,0,0,0,0,0,0,0
"Finland","2024-02-03",0,0,0,0,0,0,0,0
"Finland","2024-02-04",0,0,0,0,0,0,0,0
"Finland","2024-02-05",0,0,0,0,0,0,0,0
"Finland","2024-02-06",0,0,0,0,0,0,0,0
"Finland","2024-02-07",0,0,0,0,0,0,0,0
"Finland","2024-02-08",0,0,0,0,0,0,0,0
"Finland","2024-02-09",0,0,0,0,0,0,0,0
"Finland","2024-02-10",0,0,0,0,0,0,0,0
"Finland","2024-02-11",0,0,0,0,0,0,0,0
"Finland","2024-02-12",0,0,0,0,0,0,0,0
"Finland","2024-02-13",0,0,0,0,0,0,0,0
"Finland","2024-02-14",0,0,0,0,0,0,0,0
"Finland","2024-02-15",0,0,0,0,0,0,0,0
"Finland","2024-02-16",0,0,0,0,0,0,0,0
"Finland","2024-02-17",0,0,0,0,0,0,0,0
"Finland","2024-02-18",0,0,0,0,0,0,0,0
"Finland","2024-02-19",0,0,0,0,0,0,0,0
"Finland","2024-02-20",0,0,0,0,0,0,0,0
"Finland","2024-02-21",0,0,0,0,0,0,0,0
"Finland","2024-02-22",0,0,0,0,0,0,0,0
"Finland","2024-02-23",0,0,0,0,0,0,0,0
"Finland","2024-02-24",0,0,0,0,0,0,0,0
"Finland","2024-02-25",0,0,0,0,0,0,0,0
"Finland","2024-02-26",0,0,0,0,0,0,0,0
"Finland","2024-02-27",0,0,0,0,0,0,0,0
"Finland","2024-02-28",0,0,0,0,0,0,0,0
"Finland","2024-02-29",0,1,1,0,1,1,0,0
"Finland","2024-03-01",0,0,1,0,0,1,0,0
"Finland","2024-03-02",0,0,1,0,0,1,0,0
"Finland","2024-03-03",0,0,1,0,0,1,0,0
"Finland","2024-03-04",0,0,1,0,0,1,0,0
"Finland","2024-03-05",0,0,1,0,0,1,0,0
"Finland","2024-03-06",0,0,1,0,0,1,0,0
"Finland","2024-03-07",0,0,1,0,0,1,0,0
"Finland","2024-03-08",0,0,1,0,0,1,0,0
"Finland","2024-03-09",0,0,1,0,0,1,0,0
"Finland","2024-03-10",0,0,1,0,0,1,0,0
"Finland","2024-03-11",0,0,1,0,0,1,0,0
"Finland","2024-03-12",0,0,1,0,0,1,0,0
"Finland","2024-03-13",0,0,1,0,0,1,0,0
"Finland","2024-03-14",0,0,1,0,0,1,0,0
"Finland","2024-03-15",0,0,1,0,0,1,0,0
"Finland","2024-03-16",0,0,1,0,0,1,0,0
"Finland","2024-03-17",0,0,1,0,0,1,0,0
"Finland","2024-03-18",0,0,1,0,0,1,0,0
"Finland","2024-03-19",0,0,1,0,0,1,0,0
"Finland","2024-03-20",0,0,1,0,0,1,0,0
"Finland","2024-03-21",0,0,1,0,0,1,0,0
"Finland","2024-03-22",0,0,1,0,0,1,0,0
"Finland","2024-03-23",0,0,1,0,0,1,0,0
"Finland","2024-03-24",0,0,1,0,0,1,0,0
"Finland","2024-03-25",0,0,1,0,0,1,0,0
"Finland","2024-03-26",0,0,1,0,0,1,0,0
"Finland","2024-03-27",0,0,1,0,0,1,0,0
"Finland","2024-03-28",0,0,1,0,0,1,0,0
"Finland","2024-03-29",0,0,1,0,0,1,0,0
"Finland","2024-03-30",0,0,1,0,0,1,0,0
"Finland","2024-03-31",0,0,1,0,0,1,0,0
"Finland","2024-04-01",0,0,1,0,0,1,0,0
"Finland","2024-04-02",0,0,1,0,0,1,0,0
"Finland","2024-04-03",0,0,1,0,0,1,0,0
"Finland","2024-04-04",0,0,1,0,0,1,0,0
"Finland","2024-04-05",0,0,1,0,0,1,0,0
"Finland","2024-04-06",0,0,1,0,0,1,0,0
"Finland","2024-04-07",0,0,1,0,0,1,0,0
"Finland","2024-04-08",0,0,1,0,0,1,0,0
"Finland","2024-04-09",0,0,1,0,0,1,0,0
"Finland","2024-04-10",0,0,1,0,0,1,0,0
"Finland","2024-04-11",0,0,1,0,0,1,0,0
"Finland","2024-04-12",0,0,1,0,0,1,0,0
"Finland","2024-04-13",0,0,1,0,0,1,0,0
"Finland","2024-04-14",0,0,1,0,0,1,0,0
"Finland","2024-04-15",0,0,1,0,0,1,0,0
"Finland","2024-04-16",0,0,1,0,0,1,0,0
"Finland","2024-04-17",0,0,1,0,0,1,0,0
"Finland","2024-04-18",0,0,1,0,0,1,0,0
"Finland","2024-04-19",0,0,1,0,0,1,0,0
"Finland","2024-04-20",0,0,1,0,0,1,0,0
"Finland","2024-04-21",0,0,1,0,0,1,0,0
"Finland","2024-04-22",0,0,1,0,0,1,0,0
"Finland","2024-04-23",0,0,1,0,0,1,0,0
"Finland","2024-04-24",0,0,1,0,0,1,0,0
"Finland","2024-04-25",0,0,1,0,0,1,0,0
"Finland","2024-04-26",0,0,1,0,0,1,0,0
"Finland","2024-04-27",0,0,1,0,0,1,0,0
"Finland","2024-04-28",0,0,1,0,0,1,0,0
"Finland","2024-04-29",0,0,1,0,0,1,0,0
"Finland","2024-04-30",0,0,1,0,0,1,0,0
"Finland","2024-05-01",0,0,1,0,0,1,0,0
"Finland","2024-05-02",0,0,1,0,0,1,0,0
"Finland","2024-05-03",0,0,1,0,0,1,0,0
"Finland","2024-05-04",0,0,1,0,0,1,0,0
"Finland","2024-05-05",0,0,1,0,0,1,0,0
"Finland","2024-05-06",0,0,1,0,0,1,0,0
"Finland","2024-05-07",0,0,1,0,0,1,0,0
"Finland","2024-05-08",0,0,1,0,0,1,0,0
"Finland","2024-05-09",0,0,1,0,0,1,0,0
"Finland","2024-05-10",0,0,1,0,0,1,0,0
"Finland","2024-05-11",0,0,1,0,0,1,0,0
"Finland","2024-05-12",0,0,1,0,0,1,0,0
"Finland","2024-05-13",0,0,1,0,0,1,0,0
"Finland","2024-05-14",0,0,1,0,0,1,0,0
"Finland","2024-05-15",0,0,1,0,0,1,0,0
"Finland","2024-05-16",0,0,1,0,0,1,0,0
"Finland","2024-05-17",0,0,1,0,0,1,0,0
"Finland","2024-05-18",0,0,1,0,0,1,0,0
"Finland","2024-05-19",0,0,1,0,0,1,0,0
"Finland","2024-05-20",0,0,1,0,0,1,0,0
"Finland","2024-05-21",0,0,1,0,0,1,0,0
"Finland","2024-05-22",0,0,1,0,0,1,0,0
"Finland","2024-05-23",0,0,1,0,0,1,0,0
"Finland","2024-05-24",0,0,1,0,0,1,0,0
"Finland","2024-05-25",0,0,1,0,0,1,0,0
"Finland","2024-05-26",0,0,1,0,0,1,0,0
"Finland","2024-05-27",0,0,1,0,0,1,0,0
"Finland","2024-05-28",0,0,1,0,0,1,0,0
"Finland","2024-05-29",0,0,1,0,0,1,0,0
"Finland","2024-05-30",0,0,1,0,0,1,0,0
"Finland","2024-05-31",0,0,1,0,0,1,0,0
"Finland","2024-06-01",0,0,1,0,0,1,0,0
"Finland","2024-06-02",0,0,1,0,0,1,0,0
"Finland","2024-06-03",0,0,1,0,0,1,0,0
"Finland","2024-06-04",0,0,1,0,0,1,0,0
"Finland","2024-06-05",0,0,1,0,0,1,0,0
"Finland","2024-06-06",0,0,1,0,0,1,0,0
"Finland","2024-06-07",0,0,1,0,0,1,0,0
"Finland","2024-06-08",0,0,1,0,0,1,0,0
"Finland","2024-06-09",0,0,1,0,0,1,0,0
"Finland","2024-06-10",0,0,1,0,0,1,0,0
"Finland","2024-06-11",0,0,1,0,0,1,0,0
"Finland","2024-06-12",0,0,1,0,0,1,0,0
"Finland","2024-06-13",0,0,1,0,0,1,0,0
"Finland","2024-06-14",0,0,1,0,0,1,0,0
"Finland","2024-06-15",0,0,1,0,0,1,0,0
"Finland","2024-06-16",0,0,1,0,0,1,0,0
"Finland","2024-06-17",0,0,1,0,0,1,0,0
"Finland","2024-06-18",0,0,1,0,0,1,0,0
"Finland","2024-06-19",0,0,1,0,0,1,0,0
"Finland","2024-06-20",0,0,1,0,0,1,0,0
"Finland","2024-06-21",0,0,1,0,0,1,0,0
"Finland","2024-06-22",0,0,1,0,0,1,0,0
"Finland","2024-06-23",0,0,1,0,0,1,0,0
"Finland","2024-06-24",0,0,1,0,0,1,0,0
"Finland","2024-06-25",0,0,1,0,0,1,0,0
"Finland","2024-06-26",0,0,1,0,0,1,0,0
"Finland","2024-06-27",0,0,1,0,0,1,0,0
"Finland","2024-06-28",0,0,1,0,0,1,0,0
"Finland","2024-06-29",0,0,1,0,0,1,0,0
"Finland","2024-06-30",0,0,1,0,0,1,0,0
"Finland","2024-07-01",0,0,1,0,0,1,0,0
"Finland","2024-07-02",0,0,1,0,0,1,0,0
"Finland","2024-07-03",0,0,1,0,0,1,0,0
"Finland","2024-07-04",0,0,1,0,0,1,0,0
"Finland","2024-07-05",0,0,1,0,0,1,0,0
"Finland","2024-07-06",0,0,1,0,0,1,0,0
"Finland","2024-07-07",0,0,1,0,0,1,0,0
"Finland","2024-07-08",0,0,1,0,0,1,0,0
"Finland","2024-07-09",0,0,1,0,0,1,0,0
"Finland","2024-07-10",0,0,1,0,0,1,0,0
"Finland","2024-07-11",0,0,1,0,0,1,0,0
"Finland","2024-07-12",0,0,1,0,0,1,0,0
"Finland","2024-07-13",0,0,1,0,0,1,0,0
"Finland","2024-07-14",0,0,1,0,0,1,0,0
"Finland","2024-07-15",0,0,1,0,0,1,0,0
"Finland","2024-07-16",0,0,1,0,0,1,0,0
"Finland","2024-07-17",0,0,1,0,0,1,0,0
"Finland","2024-07-18",0,0,1,0,0,1,0,0
"Finland","2024-07-19",0,0,1,0,0,1,0,0
"Finland","2024-07-20",0,0,1,0,0,1,0,0
"Finland","2024-07-21",0,0,1,0,0,1,0,0
"Finland","2024-07-22",0,0,1,0,0,1,0,0
"Finland","2024-07-23",0,0,1,0,0,1,0,0
"Finland","2024-07-24",0,0,1,0,0,1,0,0
"Finland","2024-07-25",0,0,1,0,0,1,0,0
"Finland","2024-07-26",0,0,1,0,0,1,0,0
"Finland","2024-07-27",0,0,1,0,0,1,0,0
"Finland","2024-07-28",0,0,1,0,0,1,0,0
"Finland","2024-07-29",0,0,1,0,0,1,0,0
"Finland","2024-07-30",0,0,1,0,0,1,0,0
"Finland","2024-07-31",0,0,1,0,0,1,0,0
"Finland","2024-08-01",0,0,1,0,0,1,0,0
"Finland","2024-08-02",0,0,1,0,0,1,0,0
"Finland","2024-08-03",0,0,1,0,0,1,0,0
"Finland","2024-08-04",0,0,1,0,0,1,0,0
"Finland","2024-08-05",0,0,1,0,0,1,0,0
"Finland","2024-08-06",0,0,1,0,0,1,0,0
"Finland","2024-08-07",0,0,1,0,0,1,0,0
"Finland","2024-08-08",0,0,1,0,0,1,0,0
"Finland","2024-08-09",0,0,1,0,0,1,0,0
"Finland","2024-08-10",0,0,1,0,0,1,0,0
"Finland","2024-08-11",0,0,1,0,0,1,0,0
"Finland","2024-08-12",0,0,1,0,0,1,0,0
"Finland","2024-08-13",0,0,1,0,0,1,0,0
"Finland","2024-08-14",0,0,1,0,0,1,0,0
"Finland","2024-08-15",0,0,1,0,0,1,0,0
"Finland","2024-08-16",0,0,1,0,0,1,0,0
"Finland","2024-08-17",0,0,1,0,0,1,0,0
"Finland","2024-08-18",0,0,1,0,0,1,0,0
"Finland","2024-08-19",0,0,1,0,0,1,0,0
"Finland","2024-08-20",0,0,1,0,0,1,0,0
"Finland","2024-08-21",0,0,1,0,0,1,0,0
"Finland","2024-08-22",0,0,1,0,0,1,0,0
"Finland","2024-08-23",0,0,1,0,0,1,0,0
"Finland","2024-08-24",0,0,1,0,0,1,0,0
"Finland","2024-08-25",0,0,1,0,0,1,0,0
"Finland","2024-08-26",0,0,1,0,0,1,0,0
"Finland","2024-08-27",0,0,1,0,0,1,0,0
"Finland","2024-08-28",0,0,1,0,0,1,0,0
"Finland","2024-08-29",0,0,1,0,0,1,0,0
"Finland","2024-08-30",0,0,1,0,0,1,0,0
"Finland","2024-08-31",0,0,1,0,0,1,0,0
"Finland","2024-09-01",0,0,1,0,0,1,0,0
"Finland","2024-09-02",0,0,1,0,0,1,0,0
"Finland","2024-09-03",0,0,1,0,0,1,0,0
"Finland","2024-09-04",0,0,1,0,0,1,0,0
"Finland","2024-09-05",0,0,1,0,0,1,0,0
"Finland","2024-09-06",0,0,1,0,0,1,0,0
"Finland","2024-09-07",0,0,1,0,0,1,0,0
"Finland","2024-09-08",0,0,1,0,0,1,0,0
"Finland","2024-09-09",0,0,1,0,0,1,0,0
"Finland","2024-09-10",0,0,1,0,0,1,0,0
"Finland","2024-09-11",0,0,1,0,0,1,0,0
"Finland","2024-09-12",0,0,1,0,0,1,0,0
"Finland","2024-09-13",0,0,1,0,0,1,0,0
"Finland","2024-09-14",0,0,1,0,0,1,0,0
"Finland","2024-09-15",0,0,1,0,0,1,0,0
"Finland","2024-09-16",0,0,1,0,0,1,0,0
"Finland","2024-09-17",0,0,1,0,0,1,0,0
"Finland","2024-09-18",0,0,1,0,0,1,0,0
"Finland","2024-09-19",0,0,1,0,0,1,0,0
"Finland","2024-09-20",0,0,1,0,0,1,0,0
"Finland","2024-09-21",0,0,1,0,0,1,0,0
"Finland","2024-09-22",0,0,1,0,0,1,0,0
"Finland","2024-09-23",0,0,1,0,0,1,0,0
"Finland","2024-09-24",0,0,1,0,0,1,0,0
"Finland","2024-09-25",0,0,1,0,0,1,0,0
"Finland","2024-09-26",0,0,1,0,0,1,0,0
"Finland","2024-09-27",0,0,1,0,0,1,0,0
"Finland","2024-09-28",0,0,1,0,0,1,0,0
"Finland","2024-09-29",0,0,1,0,0,1,0,0
"Finland","2024-09-30",0,0,1,0,0,1,0,0
"Finland","2024-10-01",0,0,1,0,0,1,0,0
"Finland","2024-10-02",0,0,1,0,0,1,0,0
"Finland","2024-10-03",0,0,1,0,0,1,0,0
"Finland","2024-10-04",0,0,1,0,0,1,0,0
"Finland","2024-10-05",0,0,1,0,0,1,0,0
"Finland","2024-10-06",0,0,1,0,0,1,0,0
"Finland","2024-10-07",0,0,1,0,0,1,0,0
"Finland","2024-10-08",0,0,1,0,0,1,0,0
"Finland","2024-10-09",0,0,1,0,0,1,0,0
"Finland","2024-10-10",0,0,1,0,0,1,0,0
"Finland","2024-10-11",0,0,1,0,0,1,0,0
"Finland","2024-10-12",0,0,1,0,0,1,0,0
"Finland","2024-10-13",0,0,1,0,0,1,0,0
"Finland","2024-10-14",0,0,1,0,0,1,0,0
"Finland","2024-10-15",0,0,1,0,0,1,0,0
"Finland","2024-10-16",0,0,1,0,0,1,0,0
"Finland","2024-10-17",0,0,1,0,0,1,0,0
"Finland","2024-10-18",0,0,1,0,0,1,0,0
"Finland","2024-10-19",0,0,1,0,0,1,0,0
"Finland","2024-10-20",0,0,1,0,0,1,0,0
"Finland","2024-10-21",0,0,1,0,0,1,0,0
"Finland","2024-10-22",0,0,1,0,0,1,0,0
"Finland","2024-10-23",0,0,1,0,0,1,0,0
"Finland","2024-10-24",0,0,1,0,0,1,0,0
"Finland","2024-10-25",0,0,1,0,0,1,0,0
"Finland","2024-10-26",0,0,1,0,0,1,0,0
"Finland","2024-10-27",0,0,1,0,0,1,0,0
"Finland","2024-10-28",0,0,1,0,0,1,0,0
"Finland","2024-10-29",0,0,1,0,0,1,0,0
"Finland","2024-10-30",0,0,1,0,0,1,0,0
"Finland","2024-10-31",0,0,1,0,0,1,0,0
"Finland","2024-11-01",0,0,1,0,0,1,0,0
"Finland","2024-11-02",0,0,1,0,0,1,0,0
"Finland","2024-11-03",0,0,1,0,0,1,0,0
"Finland","2024-11-04",0,0,1,0,0,1,0,0
"Finland","2024-11-05",0,0,1,0,0,1,0,0
"Finland","2024-11-06",0,0,1,0,0,1,0,0
"Finland","2024-11-07",0,0,1,0,0,1,0,0
"Finland","2024-11-08",0,0,1,0,0,1,0,0
"Finland","2024-11-09",0,0,1,0,0,1,0,0
"Finland","2024-11-10",0,0,1,0,0,1,0,0
"Finland","2024-11-11",0,0,1,0,0,1,0,0
"Finland","2024-11-12",0,0,1,0,0,1,0,0
"Finland","2024-11-13",0,0,1,0,0,1,0,0
"Finland","2024-11-14",0,0,1,0,0,1,0,0
"Finland","2024-11-15",0,0,1,0,0,1,0,0
"Finland","2024-11-16",0,0,1,0,0,1,0,0
"Finland","2024-11-17",0,0,1,0,0,1,0,0
"Finland","2024-11-18",0,0,1,0,0,1,0,0
"Finland","2024-11-19",0,0,1,0,0,1,0,0
"Finland","2024-11-20",0,0,1,0,0,1,0,0
"Finland","2024-11-21",0,0,1,0,0,1,0,0
"Finland","2024-11-22",0,0,1,0,0,1,0,0
"Finland","2024-11-23",0,0,1,0,0,1,0,0
"Finland","2024-11-24",0,0,1,0,0,1,0,0
"Finland","2024-11-25",0,0,1,0,0,1,0,0
"Finland","2024-11-26",0,0,1,0,0,1,0,0
"Finland","2024-11-27",0,0,1,0,0,1,0,0
"Finland","2024-11-28",0,0,1,0,0,1,0,0
"Finland","2024-11-29",0,0,1,0,0,1,0,0
"Finland","2024-11-30",0,0,1,0,0,1,0,0
"Finland","2024-12-01",0,0,1,0,0,1,0,0
"Finland","2024-12-02",0,0,1,0,0,1,0,0
"Finland","2024-12-03",0,0,1,0,0,1,0,0
"Finland","2024-12-04",0,0,1,0,0,1,0,0
"Finland","2024-12-05",0,0,1,0,0,1,0,0
"Finland","2024-12-06",0,0,1,0,0,1,0,0
"Finland","2024-12-07",0,0,1,0,0,1,0,0
"Finland","2024-12-08",0,0,1,0,0,1,0,0
"Finland","2024-12-09",0,0,1,0,0,1,0,0
"France","2024-01-01",0,0,0,0,0,0,0,0
"France","2024-01-02",0,0,0,0,0,0,0,0
"France","2024-01-03",0,0,0,0,0,0,0,0
"France","2024-01-04",0,0,0,0,0,0,0,0
"France","2024-01-05",0,0,0,0,0,0,0,0
"France","2024-01-06",0,0,0,0,0,0,0,0
"France","2024-01-07",0,0,0,0,0,0,0,0
"France","2024-01-08",0,0,0,0,0,0,0,0
"France","2024-01-09",0,0,0,0,0,0,0,0
"France","2024-01-10",0,0,0,0,0,0,0,0
"France","2024-01-11",0,0,0,0,0,0,0,0
"France","2024-01-12",0,0,0,0,0,0,0,0
"France","2024-01-13",0,0,0,0,0,0,0,0
"France","2024-01-14",0,0,0,0,0,0,0,0
"France","2024-01-15",0,0,0,0,0,0,0,0
"France","2024-01-16",0,0,0,0,0,0,0,0
"France","2024-01-17",0,0,0,0,0,0,0,0
"France","2024-01-18",0,0,0,0,0,0,0,0
"France","2024-01-19",0,0,0,0,0,0,0,0
"France","2024-01-20",0,0,0,0,0,0,0,0
"France","2024-01-21",0,0,0,0,0,0,0,0
"France","2024-01-22",0,0,0,0,0,0,0,0
"France","2024-01-23",0,0,0,0,0,0,0,0
"France","2024-01-24",0,0,0,0,0,0,0,0
"France","2024-01-25",0,0,0,0,0,0,0,0
"France","2024-01-26",0,0,0,0,0,0,0,0
"France","2024-01-27",0,0,0,0,0,0,0,0
"France","2024-01-28",0,0,0,0,0,0,0,0
"France","2024-01-29",0,0,0,0,0,0,0,0
"France","2024-01-30",0,0,0,0,0,0,0,0
"France","2024-01-31",0,8,8,0,8,8,0,0
"France","2024-02-01",0,0,8,0,1,9,0,0
"France","2024-02-02",0,0,8,0,0,9,0,0
"France","2024-02-03",0,0,8,0,1,10,0,0
"France","2024-02-04",0,0,8,0,0,10,0,0
"France","2024-02-05",0,0,8,0,1,11,0,0
"France","2024-02-06",0,0,8,0,0,11,0,0
"France","2024-02-07",0,0,8,0,1,12,0,0
"France","2024-02-08",0,0,8,0,0,12,0,0
"France","2024-02-09",0,0,8,0,1,13,0,0
"France","2024-02-10",0,0,8,0,1,14,0,0
"France","2024-02-11",0,0,8,0,0,14,0,0
"France","2024-02-12",0,0,8,0,1,15,0,0
"France","2024-02-13",0,0,8,0,0,15,0,0
"France","2024-02-14",0,0,8,0,1,16,0,0
"France","2024-02-15",0,0,8,0,0,16,0,0
"France","2024-02-16",0,0,8,0,1,17,0,0
"France","2024-02-17",0,0,8,0,0,17,0,0
"France","2024-02-18",0,0,8,0,1,18,0,0
"France","2024-02-19",0,0,8,0,0,18,0,0
"France","2024-02-20",0,0,8,0,1,19,0,0
"France","2024-02-21",0,0,8,0,1,20,0,0
"France","2024-02-22",0,0,8,0,0,20,0,0
"France","2024-02-23",0,0,8,0,1,21,0,0
"France","2024-02-24",0,0,8,0,0,21,0,0
"France","2024-02-25",0,0,8,0,1,22,0,0
"France","2024-02-26",0,0,8,0,0,22,0,0
"France","2024-02-27",0,0,8,0,1,23,0,0
"France","2024-02-28",0,0,8,0,0,23,0,0
"France","2024-02-29",0,16,24,0,1,24,0,0
"France","2024-03-01",0,0,24,0,0,24,0,0
"France","2024-03-02",0,0,24,0,1,25,0,0
"France","2024-03-03",0,0,24,0,0,25,0,0
"France","2024-03-04",0,0,24,0,0,25,0,0
"France","2024-03-05",0,0,24,0,1,26,0,0
"France","2024-03-06",0,0,24,0,0,26,0,0
"France","2024-03-07",0,0,24,0,0,26,0,0
"France","2024-03-08",0,0,24,0,1,27,0,0
"France","2024-03-09",0,0,24,0,0,27,0,0
"France","2024-03-10",0,0,24,0,1,28,0,0
"France","2024-03-11",0,0,24,0,0,28,0,0
"France","2024-03-12",0,0,24,0,0,28,0,0
"France","2024-03-13",0,0,24,0,1,29,0,0
"France","2024-03-14",0,0,24,0,0,29,0,0
"France","2024-03-15",0,0,24,0,0,29,0,0
"France","2024-03-16",0,0,24,0,1,30,0,0
"France","2024-03-17",0,0,24,0,0,30,0,0
"France","2024-03-18",0,0,24,0,0,30,0,0
"France","2024-03-19",0,0,24,0,1,31,0,0
"France","2024-03-20",0,0,24,0,0,31,0,0
"France","2024-03-21",0,0,24,0,0,31,0,0
"France","2024-03-22",0,0,24,0,1,32,0,0
"France","2024-03-23",0,0,24,0,0,32,0,0
"France","2024-03-24",0,0,24,0,1,33,0,0
"France","2024-03-25",0,0,24,0,0,33,0,0
"France","2024-03-26",0,0,24,0,0,33,0,0
"France","2024-03-27",0,0,24,0,1,34,0,0
"France","2024-03-28",0,0,24,0,0,34,0,0
"France","2024-03-29",0,0,24,0,0,34,0,0
"France","2024-03-30",0,0,24,0,1,35,0,0
"France","2024-03-31",0,11,35,0,0,35,0,0
"France","2024-04-01",0,0,35,0,0,35,0,0
"France","2024-04-02",0,0,35,0,1,36,0,0
"France","2024-04-03",0,0,35,0,0,36,0,0
"France","2024-04-04",0,0,35,0,1,37,0,0
"France","2024-04-05",0,0,35,0,0,37,0,0
"France","2024-04-06",0,0,35,0,0,37,0,0
"France","2024-04-07",0,0,35,0,1,38,0,0
"France","2024-04-08",0,0,35,0,0,38,0,0
"France","2024-04-09",0,0,35,0,1,39,0,0
"France","2024-04-10",0,0,35,0,0,39,0,0
"France","2024-04-11",0,0,35,0,0,39,0,0
"France","2024-04-12",0,0,35,0,1,40,0,0
"France","2024-04-13",0,0,35,0,0,40,0,0
"France","2024-04-14",0,0,35,0,1,41,0,0
"France","2024-04-15",0,0,35,0,0,41,0,0
"France","2024-04-16",0,0,35,0,0,41,0,0
"France","2024-04-17",0,0,35,0,1,42,0,0
"France","2024-04-18",0,0,35,0,0,42,0,0
"France","2024-04-19",0,0,35,0,1,43,0,0
"France","2024-04-20",0,0,35,0,0,43,0,0
"France","2024-04-21",0,0,35,0,0,43,0,0
"France","2024-04-22",0,0,35,0,1,44,0,0
"France","2024-04-23",0,0,35,0,0,44,0,0
"France","2024-04-24",0,0,35,0,1,45,0,0
"France","2024-04-25",0,0,35,0,0,45,0,0
"France","2024-04-26",0,0,35,0,0,45,0,0
"France","2024-04-27",0,0,35,0,1,46,0,0
"France","2024-04-28",0,0,35,0,0,46,0,0
"France","2024-04-29",0,0,35,0,1,47,0,0
"France","2024-04-30",0,12,47,0,0,47,0,0
"France","2024-05-01",0,0,47,0,1,48,0,0
"France","2024-05-02",0,0,47,0,1,49,0,0
"France","2024-05-03",0,0,47,0,1,50,0,0
"France","2024-05-04",0,0,47,0,1,51,0,0
"France","2024-05-05",0,0,47,0,1,52,0,0
"France","2024-05-06",0,0,47,0,1,53,0,0
"France","2024-05-07",0,0,47,0,1,54,0,0
"France","2024-05-08",0,0,47,0,1,55,0,0
"France","2024-05-09",0,0,47,0,1,56,0,0
"France","2024-05-10",0,0,47,0,1,57,0,0
"France","2024-05-11",0,0,47,0,1,58,0,0
"France","2024-05-12",0,0,47,0,1,59,0,0
"France","2024-05-13",0,0,47,0,1,60,0,0
"France","2024-05-14",0,0,47,0,1,61,0,0
"France","2024-05-15",0,0,47,0,1,62,0,0
"France","2024-05-16",0,0,47,0,1,63,0,0
"France","2024-05-17",0,0,47,0,1,64,0,0
"France","2024-05-18",0,0,47,0,1,65,0,0
"France","2024-05-19",0,0,47,0,1,66,0,0
"France","2024-05-20",0,0,47,0,1,67,0,0
"France","2024-05-21",0,0,47,0,1,68,0,0
"France","2024-05-22",0,0,47,0,1,69,0,0
"France","2024-05-23",0,0,47,0,1,70,0,0
"France","2024-05-24",0,0,47,0,1,71,0,0
"France","2024-05-25",0,0,47,0,1,72,0,0
"France","2024-05-26",0,0,47,0,1,73,0,0
"France","2024-05-27",0,0,47,0,1,74,0,0
"France","2024-05-28",0,0,47,0,1,75,0,0
"France","2024-05-29",0,0,47,0,1,76,0,0
"France","2024-05-30",0,0,47,0,1,77,0,0
"France","2024-05-31",0,31,78,0,1,78,0,0
"France","2024-06-01",0,0,78,0,1,79,0,0
"France","2024-06-02",0,0,78,0,1,80,0,0
"France","2024-06-03",0,0,78,0,0,80,0,0
"France","2024-06-04",0,0,78,0,1,81,0,0
"France","2024-06-05",0,0,78,0,1,82,0,0
"France","2024-06-06",0,0,78,0,1,83,0,0
"France","2024-06-07",0,0,78,0,0,83,0,0
"France","2024-06-08",0,0,78,0,1,84,0,0
"France","2024-06-09",0,0,78,0,1,85,0,0
"France","2024-06-10",0,0,78,0,1,86,0,0
"France","2024-06-11",0,0,78,0,0,86,0,0
"France","2024-06-12",0,0,78,0,1,87,0,0
"France","2024-06-13",0,0,78,0,1,88,0,0
"France","2024-06-14",0,0,78,0,1,89,0,0
"France","2024-06-15",0,0,78,0,1,90,0,0
"France","2024-06-16",0,0,78,0,0,90,0,0
"France","2024-06-17",0,0,78,0,1,91,0,0
"France","2024-06-18",0,0,78,0,1,92,0,0
"France","2024-06-19",0,0,78,0,1,93,0,0
"France","2024-06-20",0,0,78,0,0,93,0,0
"France","2024-06-21",0,0,78,0,1,94,0,0
"France","2024-06-22",0,0,78,0,1,95,0,0
"France","2024-06-23",0,0,78,0,1,96,0,0
"France","2024-06-24",0,0,78,0,0,96,0,0
"France","2024-06-25",0,0,78,0,1,97,0,0
"France","2024-06-26",0,0,78,0,1,98,0,0
"France","2024-06-27",0,0,78,0,1,99,0,0
"France","2024-06-28",0,0,78,0,0,99,0,0
"France","2024-06-29",0,0,78,0,1,100,0,0
"France","2024-06-30",0,23,101,0,1,101,0,0
"France","2024-07-01",0,0,101,0,0,101,0,0
"France","2024-07-02",0,0,101,0,1,102,0,0
"France","2024-07-03",0,0,101,0,0,102,0,0
"France","2024-07-04",0,0,101,0,0,102,0,0
"France","2024-07-05",0,0,101,0,1,103,0,0
"France","2024-07-06",0,0,101,0,0,103,0,0
"France","2024-07-07",0,0,101,0,0,103,0,0
"France","2024-07-08",0,0,101,0,1,104,0,0
"France","2024-07-09",0,0,101,0,0,104,0,0
"France","2024-07-10",0,0,101,0,1,105,0,0
"France","2024-07-11",0,0,101,0,0,105,0,0
"France","2024-07-12",0,0,101,0,0,105,0,0
"France","2024-07-13",0,0,101,0,1,106,0,0
"France","2024-07-14",0,0,101,0,0,106,0,0
"France","2024-07-15",0,0,101,0,0,106,0,0
"France","2024-07-16",0,0,101,0,1,107,0,0
"France","2024-07-17",0,0,101,0,0,107,0,0
"France","2024-07-18",0,0,101,0,0,107,0,0
"France","2024-07-19",0,0,101,0,1,108,0,0
"France","2024-07-20",0,0,101,0,0,108,0,0
"France","2024-07-21",0,0,101,0,0,108,0,0
"France","2024-07-22",0,0,101,0,1,109,0,0
"France","2024-07-23",0,0,101,0,0,109,0,0
"France","2024-07-24",0,0,101,0,1,110,0,0
"France","2024-07-25",0,0,101,0,0,110,0,0
"France","2024-07-26",0,0,101,0,0,110,0,0
"France","2024-07-27",0,0,101,0,1,111,0,0
"France","2024-07-28",0,0,101,0,0,111,0,0
"France","2024-07-29",0,0,101,0,0,111,0,0
"France","2024-07-30",0,0,101,0,1,112,0,0
"France","2024-07-31",0,11,112,0,0,112,0,0
"France","2024-08-01",0,0,112,0,1,113,0,0
"France","2024-08-02",0,0,112,0,1,114,0,0
"France","2024-08-03",0,0,112,0,0,114,0,0
"France","2024-08-04",0,0,112,0,1,115,0,0
"France","2024-08-05",0,0,112,0,1,116,0,0
"France","2024-08-06",0,0,112,0,1,117,0,0
"France","2024-08-07",0,0,112,0,0,117,0,0
"France","2024-08-08",0,0,112,0,1,118,0,0
"France","2024-08-09",0,0,112,0,1,119,0,0
"France","2024-08-10",0,0,112,0,1,120,0,0
"France","2024-08-11",0,0,112,0,1,121,0,0
"France","2024-08-12",0,0,112,0,0,121,0,0
"France","2024-08-13",0,0,112,0,1,122,0,0
"France","2024-08-14",0,0,112,0,1,123,0,0
"France","2024-08-15",0,0,112,0,1,124,0,0
"France","2024-08-16",0,0,112,0,0,124,0,0
"France","2024-08-17",0,0,112,0,1,125,0,0
"France","2024-08-18",0,0,112,0,1,126,0,0
"France","2024-08-19",0,0,112,0,1,127,0,0
"France","2024-08-20",0,0,112,0,0,127,0,0
"France","2024-08-21",0,0,112,0,1,128,0,0
"France","2024-08-22",0,0,112,0,1,129,0,0
"France","2024-08-23",0,0,112,0,1,130,0,0
"France","2024-08-24",0,0,112,0,1,131,0,0
"France","2024-08-25",0,0,112,0,0,131,0,0
"France","2024-08-26",0,0,112,0,1,132,0,0
"France","2024-08-27",0,0,112,0,1,133,0,0
"France","2024-08-28",0,0,112,0,1,134,0,0
"France","2024-08-29",0,0,112,0,0,134,0,0
"France","2024-08-30",0,0,112,0,1,135,0,0
"France","2024-08-31",0,24,136,0,1,136,0,0
"France","2024-09-01",0,0,136,0,1,137,0,0
"France","2024-09-02",0,0,136,0,1,138,0,0
"France","2024-09-03",0,0,136,0,1,139,0,0
"France","2024-09-04",0,0,136,0,1,140,0,0
"France","2024-09-05",0,0,136,0,0,140,0,0
"France","2024-09-06",0,0,136,0,1,141,0,0
"France","2024-09-07",0,0,136,0,1,142,0,0
"France","2024-09-08",0,0,136,0,1,143,0,0
"France","2024-09-09",0,0,136,0,1,144,0,0
"France","2024-09-10",0,0,136,0,1,145,0,0
"France","2024-09-11",0,0,136,0,1,146,0,0
"France","2024-09-12",0,0,136,0,1,147,0,0
"France","2024-09-13",0,0,136,0,1,148,0,0
"France","2024-09-14",0,0,136,0,1,149,0,0
"France","2024-09-15",0,0,136,0,1,150,0,0
"France","2024-09-16",0,0,136,0,0,150,0,0
"France","2024-09-17",0,0,136,0,1,151,0,0
"France","2024-09-18",0,0,136,0,1,152,0,0
"France","2024-09-19",0,0,136,0,1,153,0,0
"France","2024-09-20",0,0,136,0,1,154,0,0
"France","2024-09-21",0,0,136,0,1,155,0,0
"France","2024-09-22",0,0,136,0,1,156,0,0
"France","2024-09-23",0,0,136,0,1,157,0,0
"France","2024-09-24",0,0,136,0,1,158,0,0
"France","2024-09-25",0,0,136,0,0,158,0,0
"France","2024-09-26",0,0,136,0,1,159,0,0
"France","2024-09-27",0,0,136,0,1,160,0,0
"France","2024-09-28",0,0,136,0,1,161,0,0
"France","2024-09-29",0,0,136,0,1,162,0,0
"France","2024-09-30",0,27,163,0,1,163,0,0
"France","2024-10-01",0,0,163,0,1,164,0,0
"France","2024-10-02",0,0,163,0,1,165,0,0
"France","2024-10-03",0,0,163,0,1,166,0,0
"France","2024-10-04",0,0,163,0,1,167,0,0
"France","2024-10-05",0,0,163,0,1,168,0,0
"France","2024-10-06",0,0,163,0,1,169,0,0
"France","2024-10-07",0,0,163,0,1,170,0,0
"France","2024-10-08",0,0,163,0,0,170,0,0
"France","2024-10-09",0,0,163,0,1,171,0,0
"France","2024-10-10",0,0,163,0,1,172,0,0
"France","2024-10-11",0,0,163,0,1,173,0,0
"France","2024-10-12",0,0,163,0,1,174,0,0
"France","2024-10-13",0,0,163,0,1,175,0,0
"France","2024-10-14",0,0,163,0,1,176,0,0
"France","2024-10-15",0,0,163,0,1,177,0,0
"France","2024-10-16",0,0,163,0,1,178,0,0
"France","2024-10-17",0,0,163,0,1,179,0,0
"France","2024-10-18",0,0,163,0,1,180,0,0
"France","2024-10-19",0,0,163,0,1,181,0,0
"France","2024-10-20",0,0,163,0,1,182,0,0
"France","2024-10-21",0,0,163,0,1,183,0,0
"France","2024-10-22",0,0,163,0,1,184,0,0
"France","2024-10-23",0,0,163,0,1,185,0,0
"France","2024-10-24",0,0,163,0,0,185,0,0
"France","2024-10-25",0,0,163,0,1,186,0,0
"France","2024-10-26",0,0,163,0,1,187,0,0
"France","2024-10-27",0,0,163,0,1,188,0,0
"France","2024-10-28",0,0,163,0,1,189,0,0
"France","2024-10-29",0,0,163,0,1,190,0,0
"France","2024-10-30",0,0,163,0,1,191,0,0
"France","2024-10-31",0,29,192,0,1,192,0,0
"France","2024-11-01",0,0,192,0,0,192,0,0
"France","2024-11-02",0,0,192,0,0,192,0,0
"France","2024-11-03",0,0,192,0,0,192,0,0
"France","2024-11-04",0,0,192,0,0,192,0,0
"France","2024-11-05",0,0,192,0,0,192,0,0
"France","2024-11-06",0,0,192,0,0,192,0,0
"France","2024-11-07",0,0,192,0,0,192,0,0
"France","2024-11-08",0,0,192,0,0,192,0,0
"France","2024-11-09",0,0,192,0,0,192,0,0
"France","2024-11-10",0,0,192,0,0,192,0,0
"France","2024-11-11",0,0,192,0,0,192,0,0
"France","2024-11-12",0,0,192,0,0,192,0,0
"France","2024-11-13",0,0,192,0,0,192,0,0
"France","2024-11-14",0,0,192,0,0,192,0,0
"France","2024-11-15",0,0,192,0,0,192,0,0
"France","2024-11-16",0,0,192,0,0,192,0,0
"France","2024-11-17",0,0,192,0,0,192,0,0
"France","2024-11-18",0,0,192,0,0,192,0,0
"France","2024-11-19",0,0,192,0,0,192,0,0
"France","2024-11-20",0,0,192,0,0,192,0,0
"France","2024-11-21",0,0,192,0,0,192,0,0
"France","2024-11-22",0,0,192,0,0,192,0,0
"France","2024-11-23",0,0,192,0,0,192,0,0
"France","2024-11-24",0,0,192,0,0,192,0,0
"France","2024-11-25",0,0,192,0,0,192,0,0
"France","2024-11-26",0,0,192,0,0,192,0,0
"France","2024-11-27",0,0,192,0,0,192,0,0
"France","2024-11-28",0,0,192,0,0,192,0,0
"France","2024-11-29",0,0,192,0,0,192,0,0
"France","2024-11-30",0,0,192,0,0,192,0,0
"France","2024-12-01",0,0,192,0,0,192,0,0
"France","2024-12-02",0,0,192,0,0,192,0,0
"France","2024-12-03",0,0,192,0,0,192,0,0
"France","2024-12-04",0,0,192,0,0,192,0,0
"France","2024-12-05",0,0,192,0,0,192,0,0
"France","2024-12-06",0,0,192,0,0,192,0,0
"France","2024-12-07",0,0,192,0,0,192,0,0
"France","2024-12-08",0,0,192,0,0,192,0,0
"France","2024-12-09",0,0,192,0,0,192,0,0
"Gabon","2024-01-01",0,0,0,0,0,0,0,0
"Gabon","2024-01-02",0,0,0,0,0,0,0,0
"Gabon","2024-01-03",0,0,0,0,0,0,0,0
"Gabon","2024-01-04",0,0,0,0,0,0,0,0
"Gabon","2024-01-05",0,0,0,0,0,0,0,0
"Gabon","2024-01-06",0,0,0,0,0,0,0,0
"Gabon","2024-01-07",0,0,0,0,0,0,0,0
"Gabon","2024-01-08",0,0,0,0,0,0,0,0
"Gabon","2024-01-09",0,0,0,0,0,0,0,0
"Gabon","2024-01-10",0,0,0,0,0,0,0,0
"Gabon","2024-01-11",0,0,0,0,0,0,0,0
"Gabon","2024-01-12",0,0,0,0,0,0,0,0
"Gabon","2024-01-13",0,0,0,0,0,0,0,0
"Gabon","2024-01-14",0,0,0,0,0,0,0,0
"Gabon","2024-01-15",0,0,0,0,0,0,0,0
"Gabon","2024-01-16",0,0,0,0,0,0,0,0
"Gabon","2024-01-17",0,0,0,0,0,0,0,0
"Gabon","2024-01-18",0,0,0,0,0,0,0,0
"Gabon","2024-01-19",0,0,0,0,0,0,0,0
"Gabon","2024-01-20",0,0,0,0,0,0,0,0
"Gabon","2024-01-21",0,0,0,0,0,0,0,0
"Gabon","2024-01-22",0,0,0,0,0,0,0,0
"Gabon","2024-01-23",0,0,0,0,0,0,0,0
"Gabon","2024-01-24",0,0,0,0,0,0,0,0
"Gabon","2024-01-25",0,0,0,0,0,0,0,0
"Gabon","2024-01-26",0,0,0,0,0,0,0,0
"Gabon","2024-01-27",0,0,0,0,0,0,0,0
"Gabon","2024-01-28",0,0,0,0,0,0,0,0
"Gabon","2024-01-29",0,0,0,0,0,0,0,0
"Gabon","2024-01-30",0,0,0,0,0,0,0,0
"Gabon","2024-01-31",0,0,0,0,0,0,0,0
"Gabon","2024-02-01",0,0,0,0,0,0,0,0
"Gabon","2024-02-02",0,0,0,0,0,0,0,0
"Gabon","2024-02-03",0,0,0,0,0,0,0,0
"Gabon","2024-02-04",0,0,0,0,0,0,0,0
"Gabon","2024-02-05",0,0,0,0,0,0,0,0
"Gabon","2024-02-06",0,0,0,0,0,0,0,0
"Gabon","2024-02-07",0,0,0,0,0,0,0,0
"Gabon","2024-02-08",0,0,0,0,0,0,0,0
"Gabon","2024-02-09",0,0,0,0,0,0,0,0
"Gabon","2024-02-10",0,0,0,0,0,0,0,0
"Gabon","2024-02-11",0,0,0,0,0,0,0,0
"Gabon","2024-02-12",0,0,0,0,0,0,0,0
"Gabon","2024-02-13",0,0,0,0,0,0,0,0
"Gabon","2024-02-14",0,0,0,0,0,0,0,0
"Gabon","2024-02-15",0,0,0,0,0,0,0,0
"Gabon","2024-02-16",0,0,0,0,0,0,0,0
"Gabon","2024-02-17",0,0,0,0,0,0,0,0
"Gabon","2024-02-18",0,0,0,0,0,0,0,0
"Gabon","2024-02-19",0,0,0,0,0,0,0,0
"Gabon","2024-02-20",0,0,0,0,0,0,0,0
"Gabon","2024-02-21",0,0,0,0,0,0,0,0
"Gabon","2024-02-22",0,0,0,0,0,0,0,0
"Gabon","2024-02-23",0,0,0,0,0,0,0,0
"Gabon","2024-02-24",0,0,0,0,0,0,0,0
"Gabon","2024-02-25",0,0,0,0,0,0,0,0
"Gabon","2024-02-26",0,0,0,0,0,0,0,0
"Gabon","2024-02-27",0,0,0,0,0,0,0,0
"Gabon","2024-02-28",0,0,0,0,0,0,0,0
"Gabon","2024-02-29",0,0,0,0,0,0,0,0
"Gabon","2024-03-01",0,0,0,0,0,0,0,0
"Gabon","2024-03-02",0,0,0,0,0,0,0,0
"Gabon","2024-03-03",0,0,0,0,0,0,0,0
"Gabon","2024-03-04",0,0,0,0,0,0,0,0
"Gabon","2024-03-05",0,0,0,0,0,0,0,0
"Gabon","2024-03-06",0,0,0,0,0,0,0,0
"Gabon","2024-03-07",0,0,0,0,0,0,0,0
"Gabon","2024-03-08",0,0,0,0,0,0,0,0
"Gabon","2024-03-09",0,0,0,0,0,0,0,0
"Gabon","2024-03-10",0,0,0,0,0,0,0,0
"Gabon","2024-03-11",0,0,0,0,0,0,0,0
"Gabon","2024-03-12",0,0,0,0,0,0,0,0
"Gabon","2024-03-13",0,0,0,0,0,0,0,0
"Gabon","2024-03-14",0,0,0,0,0,0,0,0
"Gabon","2024-03-15",0,0,0,0,0,0,0,0
"Gabon","2024-03-16",0,0,0,0,0,0,0,0
"Gabon","2024-03-17",0,0,0,0,0,0,0,0
"Gabon","2024-03-18",0,0,0,0,0,0,0,0
"Gabon","2024-03-19",0,0,0,0,0,0,0,0
"Gabon","2024-03-20",0,0,0,0,0,0,0,0
"Gabon","2024-03-21",0,0,0,0,0,0,0,0
"Gabon","2024-03-22",0,0,0,0,0,0,0,0
"Gabon","2024-03-23",0,0,0,0,0,0,0,0
"Gabon","2024-03-24",0,0,0,0,0,0,0,0
"Gabon","2024-03-25",0,0,0,0,0,0,0,0
"Gabon","2024-03-26",0,0,0,0,0,0,0,0
"Gabon","2024-03-27",0,0,0,0,0,0,0,0
"Gabon","2024-03-28",0,0,0,0,0,0,0,0
"Gabon","2024-03-29",0,0,0,0,0,0,0,0
"Gabon","2024-03-30",0,0,0,0,0,0,0,0
"Gabon","2024-03-31",0,0,0,0,0,0,0,0
"Gabon","2024-04-01",0,0,0,0,0,0,0,0
"Gabon","2024-04-02",0,0,0,0,0,0,0,0
"Gabon","2024-04-03",0,0,0,0,0,0,0,0
"Gabon","2024-04-04",0,0,0,0,0,0,0,0
"Gabon","2024-04-05",0,0,0,0,0,0,0,0
"Gabon","2024-04-06",0,0,0,0,0,0,0,0
"Gabon","2024-04-07",0,0,0,0,0,0,0,0
"Gabon","2024-04-08",0,0,0,0,0,0,0,0
"Gabon","2024-04-09",0,0,0,0,0,0,0,0
"Gabon","2024-04-10",0,0,0,0,0,0,0,0
"Gabon","2024-04-11",0,0,0,0,0,0,0,0
"Gabon","2024-04-12",0,0,0,0,0,0,0,0
"Gabon","2024-04-13",0,0,0,0,0,0,0,0
"Gabon","2024-04-14",0,0,0,0,0,0,0,0
"Gabon","2024-04-15",0,0,0,0,0,0,0,0
"Gabon","2024-04-16",0,0,0,0,0,0,0,0
"Gabon","2024-04-17",0,0,0,0,0,0,0,0
"Gabon","2024-04-18",0,0,0,0,0,0,0,0
"Gabon","2024-04-19",0,0,0,0,0,0,0,0
"Gabon","2024-04-20",0,0,0,0,0,0,0,0
"Gabon","2024-04-21",0,0,0,0,0,0,0,0
"Gabon","2024-04-22",0,0,0,0,0,0,0,0
"Gabon","2024-04-23",0,0,0,0,0,0,0,0
"Gabon","2024-04-24",0,0,0,0,0,0,0,0
"Gabon","2024-04-25",0,0,0,0,0,0,0,0
"Gabon","2024-04-26",0,0,0,0,0,0,0,0
"Gabon","2024-04-27",0,0,0,0,0,0,0,0
"Gabon","2024-04-28",0,0,0,0,0,0,0,0
"Gabon","2024-04-29",0,0,0,0,0,0,0,0
"Gabon","2024-04-30",0,0,0,0,0,0,0,0
"Gabon","2024-05-01",0,0,0,0,0,0,0,0
"Gabon","2024-05-02",0,0,0,0,0,0,0,0
"Gabon","2024-05-03",0,0,0,0,0,0,0,0
"Gabon","2024-05-04",0,0,0,0,0,0,0,0
"Gabon","2024-05-05",0,0,0,0,0,0,0,0
"Gabon","2024-05-06",0,0,0,0,0,0,0,0
"Gabon","2024-05-07",0,0,0,0,0,0,0,0
"Gabon","2024-05-08",0,0,0,0,0,0,0,0
"Gabon","2024-05-09",0,0,0,0,0,0,0,0
"Gabon","2024-05-10",0,0,0,0,0,0,0,0
"Gabon","2024-05-11",0,0,0,0,0,0,0,0
"Gabon","2024-05-12",0,0,0,0,0,0,0,0
"Gabon","2024-05-13",0,0,0,0,0,0,0,0
"Gabon","2024-05-14",0,0,0,0,0,0,0,0
"Gabon","2024-05-15",0,0,0,0,0,0,0,0
"Gabon","2024-05-16",0,0,0,0,0,0,0,0
"Gabon","2024-05-17",0,0,0,0,0,0,0,0
"Gabon","2024-05-18",0,0,0,0,0,0,0,0
"Gabon","2024-05-19",0,0,0,0,0,0,0,0
"Gabon","2024-05-20",0,0,0,0,0,0,0,0
"Gabon","2024-05-21",0,0,0,0,0,0,0,0
"Gabon","2024-05-22",0,0,0,0,0,0,0,0
"Gabon","2024-05-23",0,0,0,0,0,0,0,0
"Gabon","2024-05-24",0,0,0,0,0,0,0,0
"Gabon","2024-05-25",0,0,0,0,0,0,0,0
"Gabon","2024-05-26",0,0,0,0,0,0,0,0
"Gabon","2024-05-27",0,0,0,0,0,0,0,0
"Gabon","2024-05-28",0,0,0,0,0,0,0,0
"Gabon","2024-05-29",0,0,0,0,0,0,0,0
"Gabon","2024-05-30",0,0,0,0,0,0,0,0
"Gabon","2024-05-31",0,0,0,0,0,0,0,0
"Gabon","2024-06-01",0,0,0,0,0,0,0,0
"Gabon","2024-06-02",0,0,0,0,0,0,0,0
"Gabon","2024-06-03",0,0,0,0,0,0,0,0
"Gabon","2024-06-04",0,0,0,0,0,0,0,0
"Gabon","2024-06-05",0,0,0,0,0,0,0,0
"Gabon","2024-06-06",0,0,0,0,0,0,0,0
"Gabon","2024-06-07",0,0,0,0,0,0,0,0
"Gabon","2024-06-08",0,0,0,0,0,0,0,0
"Gabon","2024-06-09",0,0,0,0,0,0,0,0
"Gabon","2024-06-10",0,0,0,0,0,0,0,0
"Gabon","2024-06-11",0,0,0,0,0,0,0,0
"Gabon","2024-06-12",0,0,0,0,0,0,0,0
"Gabon","2024-06-13",0,0,0,0,0,0,0,0
"Gabon","2024-06-14",0,0,0,0,0,0,0,0
"Gabon","2024-06-15",0,0,0,0,0,0,0,0
"Gabon","2024-06-16",0,0,0,0,0,0,0,0
"Gabon","2024-06-17",0,0,0,0,0,0,0,0
"Gabon","2024-06-18",0,0,0,0,0,0,0,0
"Gabon","2024-06-19",0,0,0,0,0,0,0,0
"Gabon","2024-06-20",0,0,0,0,0,0,0,0
"Gabon","2024-06-21",0,0,0,0,0,0,0,0
"Gabon","2024-06-22",0,0,0,0,0,0,0,0
"Gabon","2024-06-23",0,0,0,0,0,0,0,0
"Gabon","2024-06-24",0,0,0,0,0,0,0,0
"Gabon","2024-06-25",0,0,0,0,0,0,0,0
"Gabon","2024-06-26",0,0,0,0,0,0,0,0
"Gabon","2024-06-27",0,0,0,0,0,0,0,0
"Gabon","2024-06-28",0,0,0,0,0,0,0,0
"Gabon","2024-06-29",0,0,0,0,0,0,0,0
"Gabon","2024-06-30",0,0,0,0,0,0,0,0
"Gabon","2024-07-01",0,0,0,0,0,0,0,0
"Gabon","2024-07-02",0,0,0,0,0,0,0,0
"Gabon","2024-07-03",0,0,0,0,0,0,0,0
"Gabon","2024-07-04",0,0,0,0,0,0,0,0
"Gabon","2024-07-05",0,0,0,0,0,0,0,0
"Gabon","2024-07-06",0,0,0,0,0,0,0,0
"Gabon","2024-07-07",0,0,0,0,0,0,0,0
"Gabon","2024-07-08",0,0,0,0,0,0,0,0
"Gabon","2024-07-09",0,0,0,0,0,0,0,0
"Gabon","2024-07-10",0,0,0,0,0,0,0,0
"Gabon","2024-07-11",0,0,0,0,0,0,0,0
"Gabon","2024-07-12",0,0,0,0,0,0,0,0
"Gabon","2024-07-13",0,0,0,0,0,0,0,0
"Gabon","2024-07-14",0,0,0,0,0,0,0,0
"Gabon","2024-07-15",0,0,0,0,0,0,0,0
"Gabon","2024-07-16",0,0,0,0,0,0,0,0
"Gabon","2024-07-17",0,0,0,0,0,0,0,0
"Gabon","2024-07-18",0,0,0,0,0,0,0,0
"Gabon","2024-07-19",0,0,0,0,0,0,0,0
"Gabon","2024-07-20",0,0,0,0,0,0,0,0
"Gabon","2024-07-21",0,0,0,0,0,0,0,0
"Gabon","2024-07-22",0,0,0,0,0,0,0,0
"Gabon","2024-07-23",0,0,0,0,0,0,0,0
"Gabon","2024-07-24",0,0,0,0,0,0,0,0
"Gabon","2024-07-25",0,0,0,0,0,0,0,0
"Gabon","2024-07-26",0,0,0,0,0,0,0,0
"Gabon","2024-07-27",0,0,0,0,0,0,0,0
"Gabon","2024-07-28",0,0,0,0,0,0,0,0
"Gabon","2024-07-29",0,0,0,0,0,0,0,0
"Gabon","2024-07-30",0,0,0,0,0,0,0,0
"Gabon","2024-07-31",0,0,0,0,0,0,0,0
"Gabon","2024-08-01",0,0,0,0,0,0,0,0
"Gabon","2024-08-02",0,0,0,0,0,0,0,0
"Gabon","2024-08-03",0,0,0,0,0,0,0,0
"Gabon","2024-08-04",0,0,0,0,0,0,0,0
"Gabon","2024-08-05",0,0,0,0,0,0,0,0
"Gabon","2024-08-06",0,0,0,0,0,0,0,0
"Gabon","2024-08-07",0,0,0,0,0,0,0,0
"Gabon","2024-08-08",0,0,0,0,0,0,0,0
"Gabon","2024-08-09",0,0,0,0,0,0,0,0
"Gabon","2024-08-10",0,0,0,0,0,0,0,0
"Gabon","2024-08-11",0,0,0,0,0,0,0,0
"Gabon","2024-08-12",0,0,0,0,0,0,0,0
"Gabon","2024-08-13",0,0,0,0,0,0,0,0
"Gabon","2024-08-14",0,0,0,0,0,0,0,0
"Gabon","2024-08-15",0,0,0,0,0,0,0,0
"Gabon","2024-08-16",0,0,0,0,0,0,0,0
"Gabon","2024-08-17",0,0,0,0,0,0,0,0
"Gabon","2024-08-18",0,0,0,0,0,0,0,0
"Gabon","2024-08-19",0,0,0,0,0,0,0,0
"Gabon","2024-08-20",0,0,0,0,0,0,0,0
"Gabon","2024-08-21",0,0,0,0,0,0,0,0
"Gabon","2024-08-22",0,0,0,0,0,0,0,0
"Gabon","2024-08-23",0,0,0,0,0,0,0,0
"Gabon","2024-08-24",0,0,0,0,0,0,0,0
"Gabon","2024-08-25",0,1,1,0,1,1,0,0
"Gabon","2024-08-26",0,0,1,0,0,1,0,0
"Gabon","2024-08-27",0,0,1,0,0,1,0,0
"Gabon","2024-08-28",0,0,1,0,0,1,0,0
"Gabon","2024-08-29",0,0,1,0,1,2,0,0
"Gabon","2024-08-30",0,0,1,0,0,2,0,0
"Gabon","2024-08-31",0,0,1,0,0,2,0,0
"Gabon","2024-09-01",0,1,2,0,0,2,0,0
"Gabon","2024-09-02",0,0,2,0,0,2,0,0
"Gabon","2024-09-03",0,0,2,0,0,2,0,0
"Gabon","2024-09-04",0,0,2,0,0,2,0,0
"Gabon","2024-09-05",0,0,2,0,0,2,0,0
"Gabon","2024-09-06",0,0,2,0,0,2,0,0
"Gabon","2024-09-07",0,0,2,0,0,2,0,0
"Gabon","2024-09-08",4,0,2,4,0,2,4,4
"Gabon","2024-09-09",0,0,2,4,0,2,0,4
"Gabon","2024-09-10",0,0,2,4,0,2,0,4
"Gabon","2024-09-11",0,0,2,4,0,2,0,4
"Gabon","2024-09-12",0,0,2,4,0,2,1,5
"Gabon","2024-09-13",0,0,2,4,0,2,0,5
"Gabon","2024-09-14",0,0,2,4,0,2,0,5
"Gabon","2024-09-15",0,0,2,4,0,2,0,5
"Gabon","2024-09-16",0,0,2,4,0,2,0,5
"Gabon","2024-09-17",0,0,2,4,0,2,0,5
"Gabon","2024-09-18",0,0,2,4,0,2,0,5
"Gabon","2024-09-19",0,0,2,4,0,2,1,6
"Gabon","2024-09-20",0,0,2,4,0,2,0,6
"Gabon","2024-09-21",0,0,2,4,0,2,0,6
"Gabon","2024-09-22",0,0,2,4,0,2,0,6
"Gabon","2024-09-23",0,0,2,4,0,2,0,6
"Gabon","2024-09-24",0,0,2,4,0,2,0,6
"Gabon","2024-09-25",0,0,2,4,0,2,0,6
"Gabon","2024-09-26",0,0,2,4,0,2,0,6
"Gabon","2024-09-27",0,0,2,4,0,2,1,7
"Gabon","2024-09-28",0,0,2,4,0,2,0,7
"Gabon","2024-09-29",0,0,2,4,0,2,0,7
"Gabon","2024-09-30",3,0,2,7,0,2,0,7
"Gabon","2024-10-01",0,0,2,7,0,2,0,7
"Gabon","2024-10-02",0,0,2,7,0,2,1,8
"Gabon","2024-10-03",0,0,2,7,0,2,0,8
"Gabon","2024-10-04",0,0,2,7,0,2,0,8
"Gabon","2024-10-05",0,0,2,7,0,2,1,9
"Gabon","2024-10-06",2,0,2,9,0,2,0,9
"Gabon","2024-10-07",0,0,2,9,0,2,0,9
"Gabon","2024-10-08",0,0,2,9,0,2,0,9
"Gabon","2024-10-09",0,0,2,9,0,2,0,9
"Gabon","2024-10-10",0,0,2,9,0,2,0,9
"Gabon","2024-10-11",0,0,2,9,0,2,0,9
"Gabon","2024-10-12",0,0,2,9,0,2,0,9
"Gabon","2024-10-13",0,0,2,9,0,2,0,9
"Gabon","2024-10-14",0,0,2,9,0,2,1,10
"Gabon","2024-10-15",0,0,2,9,0,2,0,10
"Gabon","2024-10-16",0,0,2,9,0,2,0,10
"Gabon","2024-10-17",0,0,2,9,0,2,0,10
"Gabon","2024-10-18",0,0,2,9,0,2,0,10
"Gabon","2024-10-19",0,0,2,9,0,2,0,10
"Gabon","2024-10-20",1,0,2,10,0,2,0,10
"Gabon","2024-10-21",3,0,2,13,0,2,3,13
"Gabon","2024-10-22",0,0,2,13,0,2,0,13
"Gabon","2024-10-23",0,0,2,13,0,2,0,13
"Gabon","2024-10-24",0,0,2,13,0,2,0,13
"Gabon","2024-10-25",0,0,2,13,0,2,0,13
"Gabon","2024-10-26",0,0,2,13,0,2,0,13
"Gabon","2024-10-27",0,0,2,13,0,2,0,13
"Gabon","2024-10-28",0,0,2,13,0,2,0,13
"Gabon","2024-10-29",0,0,2,13,0,2,0,13
"Gabon","2024-10-30",0,0,2,13,0,2,0,13
"Gabon","2024-10-31",0,0,2,13,0,2,0,13
"Gabon","2024-11-01",0,0,2,13,0,2,0,13
"Gabon","2024-11-02",0,0,2,13,0,2,0,13
"Gabon","2024-11-03",0,0,2,13,0,2,0,13
"Gabon","2024-11-04",0,0,2,13,0,2,0,13
"Gabon","2024-11-05",0,0,2,13,0,2,0,13
"Gabon","2024-11-06",0,0,2,13,0,2,0,13
"Gabon","2024-11-07",0,0,2,13,0,2,0,13
"Gabon","2024-11-08",0,0,2,13,0,2,0,13
"Gabon","2024-11-09",0,0,2,13,0,2,0,13
"Gabon","2024-11-10",0,0,2,13,0,2,0,13
"Gabon","2024-11-11",0,0,2,13,0,2,0,13
"Gabon","2024-11-12",0,0,2,13,0,2,0,13
"Gabon","2024-11-13",0,0,2,13,0,2,0,13
"Gabon","2024-11-14",0,0,2,13,0,2,0,13
"Gabon","2024-11-15",0,0,2,13,0,2,0,13
"Gabon","2024-11-16",0,0,2,13,0,2,0,13
"Gabon","2024-11-17",0,0,2,13,0,2,0,13
"Gabon","2024-11-18",0,0,2,13,0,2,0,13
"Gabon","2024-11-19",0,0,2,13,0,2,0,13
"Gabon","2024-11-20",0,0,2,13,0,2,0,13
"Gabon","2024-11-21",0,0,2,13,0,2,0,13
"Gabon","2024-11-22",0,0,2,13,0,2,0,13
"Gabon","2024-11-23",0,0,2,13,0,2,0,13
"Gabon","2024-11-24",0,0,2,13,0,2,0,13
"Gabon","2024-11-25",0,0,2,13,0,2,0,13
"Gabon","2024-11-26",0,0,2,13,0,2,0,13
"Gabon","2024-11-27",0,0,2,13,0,2,0,13
"Gabon","2024-11-28",0,0,2,13,0,2,0,13
"Gabon","2024-11-29",0,0,2,13,0,2,0,13
"Gabon","2024-11-30",0,0,2,13,0,2,0,13
"Gabon","2024-12-01",0,0,2,13,0,2,0,13
"Gabon","2024-12-02",0,0,2,13,0,2,0,13
"Gabon","2024-12-03",0,0,2,13,0,2,0,13
"Gabon","2024-12-04",0,0,2,13,0,2,0,13
"Gabon","2024-12-05",0,0,2,13,0,2,0,13
"Gabon","2024-12-06",0,0,2,13,0,2,0,13
"Gabon","2024-12-07",0,0,2,13,0,2,0,13
"Gabon","2024-12-08",0,0,2,13,0,2,0,13
"Gabon","2024-12-09",0,0,2,13,0,2,0,13
"Georgia","2024-01-01",0,0,0,0,0,0,0,0
"Georgia","2024-01-02",0,0,0,0,0,0,0,0
"Georgia","2024-01-03",0,0,0,0,0,0,0,0
"Georgia","2024-01-04",0,0,0,0,0,0,0,0
"Georgia","2024-01-05",0,0,0,0,0,0,0,0
"Georgia","2024-01-06",0,0,0,0,0,0,0,0
"Georgia","2024-01-07",0,0,0,0,0,0,0,0
"Georgia","2024-01-08",0,0,0,0,0,0,0,0
"Georgia","2024-01-09",0,0,0,0,0,0,0,0
"Georgia","2024-01-10",0,0,0,0,0,0,0,0
"Georgia","2024-01-11",0,0,0,0,0,0,0,0
"Georgia","2024-01-12",0,0,0,0,0,0,0,0
"Georgia","2024-01-13",0,0,0,0,0,0,0,0
"Georgia","2024-01-14",0,0,0,0,0,0,0,0
"Georgia","2024-01-15",0,0,0,0,0,0,0,0
"Georgia","2024-01-16",0,0,0,0,0,0,0,0
"Georgia","2024-01-17",0,0,0,0,0,0,0,0
"Georgia","2024-01-18",0,0,0,0,0,0,0,0
"Georgia","2024-01-19",0,0,0,0,0,0,0,0
"Georgia","2024-01-20",0,0,0,0,0,0,0,0
"Georgia","2024-01-21",0,0,0,0,0,0,0,0
"Georgia","2024-01-22",0,0,0,0,0,0,0,0
"Georgia","2024-01-23",0,0,0,0,0,0,0,0
"Georgia","2024-01-24",0,0,0,0,0,0,0,0
"Georgia","2024-01-25",0,0,0,0,0,0,0,0
"Georgia","2024-01-26",0,0,0,0,0,0,0,0
"Georgia","2024-01-27",0,0,0,0,0,0,0,0
"Georgia","2024-01-28",0,0,0,0,0,0,0,0
"Georgia","2024-01-29",0,0,0,0,0,0,0,0
"Georgia","2024-01-30",0,0,0,0,0,0,0,0
"Georgia","2024-01-31",0,0,0,0,0,0,0,0
"Georgia","2024-02-01",0,0,0,0,0,0,0,0
"Georgia","2024-02-02",0,0,0,0,0,0,0,0
"Georgia","2024-02-03",0,0,0,0,0,0,0,0
"Georgia","2024-02-04",0,0,0,0,0,0,0,0
"Georgia","2024-02-05",0,0,0,0,0,0,0,0
"Georgia","2024-02-06",0,0,0,0,0,0,0,0
"Georgia","2024-02-07",0,0,0,0,0,0,0,0
"Georgia","2024-02-08",0,0,0,0,0,0,0,0
"Georgia","2024-02-09",0,0,0,0,0,0,0,0
"Georgia","2024-02-10",0,0,0,0,0,0,0,0
"Georgia","2024-02-11",0,0,0,0,0,0,0,0
"Georgia","2024-02-12",0,0,0,0,0,0,0,0
"Georgia","2024-02-13",0,0,0,0,0,0,0,0
"Georgia","2024-02-14",0,0,0,0,0,0,0,0
"Georgia","2024-02-15",0,0,0,0,0,0,0,0
"Georgia","2024-02-16",0,0,0,0,0,0,0,0
"Georgia","2024-02-17",0,0,0,0,0,0,0,0
"Georgia","2024-02-18",0,0,0,0,0,0,0,0
"Georgia","2024-02-19",0,0,0,0,0,0,0,0
"Georgia","2024-02-20",0,0,0,0,0,0,0,0
"Georgia","2024-02-21",0,0,0,0,0,0,0,0
"Georgia","2024-02-22",0,0,0,0,0,0,0,0
"Georgia","2024-02-23",0,0,0,0,0,0,0,0
"Georgia","2024-02-24",0,0,0,0,0,0,0,0
"Georgia","2024-02-25",0,0,0,0,0,0,0,0
"Georgia","2024-02-26",0,0,0,0,0,0,0,0
"Georgia","2024-02-27",0,0,0,0,0,0,0,0
"Georgia","2024-02-28",0,0,0,0,0,0,0,0
"Georgia","2024-02-29",0,0,0,0,0,0,0,0
"Georgia","2024-03-01",0,0,0,0,0,0,0,0
"Georgia","2024-03-02",0,0,0,0,0,0,0,0
"Georgia","2024-03-03",0,0,0,0,0,0,0,0
"Georgia","2024-03-04",0,0,0,0,0,0,0,0
"Georgia","2024-03-05",0,0,0,0,0,0,0,0
"Georgia","2024-03-06",0,0,0,0,0,0,0,0
"Georgia","2024-03-07",0,0,0,0,0,0,0,0
"Georgia","2024-03-08",0,0,0,0,0,0,0,0
"Georgia","2024-03-09",0,0,0,0,0,0,0,0
"Georgia","2024-03-10",0,0,0,0,0,0,0,0
"Georgia","2024-03-11",0,0,0,0,0,0,0,0
"Georgia","2024-03-12",0,0,0,0,0,0,0,0
"Georgia","2024-03-13",0,0,0,0,0,0,0,0
"Georgia","2024-03-14",0,0,0,0,0,0,0,0
"Georgia","2024-03-15",0,0,0,0,0,0,0,0
"Georgia","2024-03-16",0,0,0,0,0,0,0,0
"Georgia","2024-03-17",0,0,0,0,0,0,0,0
"Georgia","2024-03-18",0,0,0,0,0,0,0,0
"Georgia","2024-03-19",0,0,0,0,0,0,0,0
"Georgia","2024-03-20",0,0,0,0,0,0,0,0
"Georgia","2024-03-21",0,0,0,0,0,0,0,0
"Georgia","2024-03-22",0,0,0,0,0,0,0,0
"Georgia","2024-03-23",0,0,0,0,0,0,0,0
"Georgia","2024-03-24",0,0,0,0,0,0,0,0
"Georgia","2024-03-25",0,0,0,0,0,0,0,0
"Georgia","2024-03-26",0,0,0,0,0,0,0,0
"Georgia","2024-03-27",0,0,0,0,0,0,0,0
"Georgia","2024-03-28",0,0,0,0,0,0,0,0
"Georgia","2024-03-29",0,0,0,0,0,0,0,0
"Georgia","2024-03-30",0,0,0,0,0,0,0,0
"Georgia","2024-03-31",0,0,0,0,0,0,0,0
"Georgia","2024-04-01",0,0,0,0,0,0,0,0
"Georgia","2024-04-02",0,0,0,0,0,0,0,0
"Georgia","2024-04-03",0,0,0,0,0,0,0,0
"Georgia","2024-04-04",0,0,0,0,0,0,0,0
"Georgia","2024-04-05",0,0,0,0,0,0,0,0
"Georgia","2024-04-06",0,0,0,0,0,0,0,0
"Georgia","2024-04-07",0,0,0,0,0,0,0,0
"Georgia","2024-04-08",0,0,0,0,0,0,0,0
"Georgia","2024-04-09",0,0,0,0,0,0,0,0
"Georgia","2024-04-10",0,0,0,0,0,0,0,0
"Georgia","2024-04-11",0,0,0,0,0,0,0,0
"Georgia","2024-04-12",0,0,0,0,0,0,0,0
"Georgia","2024-04-13",0,0,0,0,0,0,0,0
"Georgia","2024-04-14",0,0,0,0,0,0,0,0
"Georgia","2024-04-15",0,0,0,0,0,0,0,0
"Georgia","2024-04-16",0,0,0,0,0,0,0,0
"Georgia","2024-04-17",0,0,0,0,0,0,0,0
"Georgia","2024-04-18",0,0,0,0,0,0,0,0
"Georgia","2024-04-19",0,0,0,0,0,0,0,0
"Georgia","2024-04-20",0,0,0,0,0,0,0,0
"Georgia","2024-04-21",0,0,0,0,0,0,0,0
"Georgia","2024-04-22",0,0,0,0,0,0,0,0
"Georgia","2024-04-23",0,0,0,0,0,0,0,0
"Georgia","2024-04-24",0,0,0,0,0,0,0,0
"Georgia","2024-04-25",0,0,0,0,0,0,0,0
"Georgia","2024-04-26",0,0,0,0,0,0,0,0
"Georgia","2024-04-27",0,0,0,0,0,0,0,0
"Georgia","2024-04-28",0,0,0,0,0,0,0,0
"Georgia","2024-04-29",0,0,0,0,0,0,0,0
"Georgia","2024-04-30",0,0,0,0,0,0,0,0
"Georgia","2024-05-01",0,0,0,0,0,0,0,0
"Georgia","2024-05-02",0,0,0,0,0,0,0,0
"Georgia","2024-05-03",0,0,0,0,0,0,0,0
"Georgia","2024-05-04",0,0,0,0,0,0,0,0
"Georgia","2024-05-05",0,0,0,0,0,0,0,0
"Georgia","2024-05-06",0,0,0,0,0,0,0,0
"Georgia","2024-05-07",0,0,0,0,0,0,0,0
"Georgia","2024-05-08",0,0,0,0,0,0,0,0
"Georgia","2024-05-09",0,0,0,0,0,0,0,0
"Georgia","2024-05-10",0,0,0,0,0,0,0,0
"Georgia","2024-05-11",0,0,0,0,0,0,0,0
"Georgia","2024-05-12",0,0,0,0,0,0,0,0
"Georgia","2024-05-13",0,0,0,0,0,0,0,0
"Georgia","2024-05-14",0,0,0,0,0,0,0,0
"Georgia","2024-05-15",0,0,0,0,0,0,0,0
"Georgia","2024-05-16",0,0,0,0,0,0,0,0
"Georgia","2024-05-17",0,0,0,0,0,0,0,0
"Georgia","2024-05-18",0,0,0,0,0,0,0,0
"Georgia","2024-05-19",0,0,0,0,0,0,0,0
"Georgia","2024-05-20",0,0,0,0,0,0,0,0
"Georgia","2024-05-21",0,0,0,0,0,0,0,0
"Georgia","2024-05-22",0,0,0,0,0,0,0,0
"Georgia","2024-05-23",0,0,0,0,0,0,0,0
"Georgia","2024-05-24",0,0,0,0,0,0,0,0
"Georgia","2024-05-25",0,0,0,0,0,0,0,0
"Georgia","2024-05-26",0,0,0,0,0,0,0,0
"Georgia","2024-05-27",0,0,0,0,0,0,0,0
"Georgia","2024-05-28",0,0,0,0,0,0,0,0
"Georgia","2024-05-29",0,0,0,0,0,0,0,0
"Georgia","2024-05-30",0,0,0,0,0,0,0,0
"Georgia","2024-05-31",0,0,0,0,0,0,0,0
"Georgia","2024-06-01",0,0,0,0,0,0,0,0
"Georgia","2024-06-02",0,0,0,0,0,0,0,0
"Georgia","2024-06-03",0,0,0,0,0,0,0,0
"Georgia","2024-06-04",0,0,0,0,0,0,0,0
"Georgia","2024-06-05",0,0,0,0,0,0,0,0
"Georgia","2024-06-06",0,0,0,0,0,0,0,0
"Georgia","2024-06-07",0,0,0,0,0,0,0,0
"Georgia","2024-06-08",0,0,0,0,0,0,0,0
"Georgia","2024-06-09",0,0,0,0,0,0,0,0
"Georgia","2024-06-10",0,0,0,0,0,0,0,0
"Georgia","2024-06-11",0,0,0,0,0,0,0,0
"Georgia","2024-06-12",0,0,0,0,0,0,0,0
"Georgia","2024-06-13",0,0,0,0,0,0,0,0
"Georgia","2024-06-14",0,0,0,0,0,0,0,0
"Georgia","2024-06-15",0,0,0,0,0,0,0,0
"Georgia","2024-06-16",0,0,0,0,0,0,0,0
"Georgia","2024-06-17",0,0,0,0,0,0,0,0
"Georgia","2024-06-18",0,0,0,0,0,0,0,0
"Georgia","2024-06-19",0,0,0,0,0,0,0,0
"Georgia","2024-06-20",0,0,0,0,0,0,0,0
"Georgia","2024-06-21",0,0,0,0,0,0,0,0
"Georgia","2024-06-22",0,0,0,0,0,0,0,0
"Georgia","2024-06-23",0,0,0,0,0,0,0,0
"Georgia","2024-06-24",0,0,0,0,0,0,0,0
"Georgia","2024-06-25",0,0,0,0,0,0,0,0
"Georgia","2024-06-26",0,0,0,0,0,0,0,0
"Georgia","2024-06-27",0,0,0,0,0,0,0,0
"Georgia","2024-06-28",0,0,0,0,0,0,0,0
"Georgia","2024-06-29",0,0,0,0,0,0,0,0
"Georgia","2024-06-30",0,0,0,0,0,0,0,0
"Georgia","2024-07-01",0,0,0,0,0,0,0,0
"Georgia","2024-07-02",0,0,0,0,0,0,0,0
"Georgia","2024-07-03",0,0,0,0,0,0,0,0
"Georgia","2024-07-04",0,0,0,0,0,0,0,0
"Georgia","2024-07-05",0,0,0,0,0,0,0,0
"Georgia","2024-07-06",0,0,0,0,0,0,0,0
"Georgia","2024-07-07",0,0,0,0,0,0,0,0
"Georgia","2024-07-08",0,0,0,0,0,0,0,0
"Georgia","2024-07-09",0,0,0,0,0,0,0,0
"Georgia","2024-07-10",0,0,0,0,0,0,0,0
"Georgia","2024-07-11",0,0,0,0,0,0,0,0
"Georgia","2024-07-12",0,0,0,0,0,0,0,0
"Georgia","2024-07-13",0,0,0,0,0,0,0,0
"Georgia","2024-07-14",0,0,0,0,0,0,0,0
"Georgia","2024-07-15",0,0,0,0,0,0,0,0
"Georgia","2024-07-16",0,0,0,0,0,0,0,0
"Georgia","2024-07-17",0,0,0,0,0,0,0,0
"Georgia","2024-07-18",0,0,0,0,0,0,0,0
"Georgia","2024-07-19",0,0,0,0,0,0,0,0
"Georgia","2024-07-20",0,0,0,0,0,0,0,0
"Georgia","2024-07-21",0,0,0,0,0,0,0,0
"Georgia","2024-07-22",0,0,0,0,0,0,0,0
"Georgia","2024-07-23",0,0,0,0,0,0,0,0
"Georgia","2024-07-24",0,0,0,0,0,0,0,0
"Georgia","2024-07-25",0,0,0,0,0,0,0,0
"Georgia","2024-07-26",0,0,0,0,0,0,0,0
"Georgia","2024-07-27",0,0,0,0,0,0,0,0
"Georgia","2024-07-28",0,0,0,0,0,0,0,0
"Georgia","2024-07-29",0,0,0,0,0,0,0,0
"Georgia","2024-07-30",0,0,0,0,0,0,0,0
"Georgia","2024-07-31",0,0,0,0,0,0,0,0
"Georgia","2024-08-01",0,0,0,0,0,0,0,0
"Georgia","2024-08-02",0,0,0,0,0,0,0,0
"Georgia","2024-08-03",0,0,0,0,0,0,0,0
"Georgia","2024-08-04",0,0,0,0,0,0,0,0
"Georgia","2024-08-05",0,0,0,0,0,0,0,0
"Georgia","2024-08-06",0,0,0,0,0,0,0,0
"Georgia","2024-08-07",0,0,0,0,0,0,0,0
"Georgia","2024-08-08",0,0,0,0,0,0,0,0
"Georgia","2024-08-09",0,0,0,0,0,0,0,0
"Georgia","2024-08-10",0,0,0,0,0,0,0,0
"Georgia","2024-08-11",0,0,0,0,0,0,0,0
"Georgia","2024-08-12",0,0,0,0,0,0,0,0
"Georgia","2024-08-13",0,0,0,0,0,0,0,0
"Georgia","2024-08-14",0,0,0,0,0,0,0,0
"Georgia","2024-08-15",0,0,0,0,0,0,0,0
"Georgia","2024-08-16",0,0,0,0,0,0,0,0
"Georgia","2024-08-17",0,0,0,0,0,0,0,0
"Georgia","2024-08-18",0,0,0,0,0,0,0,0
"Georgia","2024-08-19",0,0,0,0,0,0,0,0
"Georgia","2024-08-20",0,0,0,0,0,0,0,0
"Georgia","2024-08-21",0,0,0,0,0,0,0,0
"Georgia","2024-08-22",0,0,0,0,0,0,0,0
"Georgia","2024-08-23",0,0,0,0,0,0,0,0
"Georgia","2024-08-24",0,0,0,0,0,0,0,0
"Georgia","2024-08-25",0,0,0,0,0,0,0,0
"Georgia","2024-08-26",0,0,0,0,0,0,0,0
"Georgia","2024-08-27",0,0,0,0,0,0,0,0
"Georgia","2024-08-28",0,0,0,0,0,0,0,0
"Georgia","2024-08-29",0,0,0,0,0,0,0,0
"Georgia","2024-08-30",0,0,0,0,0,0,0,0
"Georgia","2024-08-31",0,0,0,0,0,0,0,0
"Georgia","2024-09-01",0,0,0,0,0,0,0,0
"Georgia","2024-09-02",0,0,0,0,0,0,0,0
"Georgia","2024-09-03",0,0,0,0,0,0,0,0
"Georgia","2024-09-04",0,0,0,0,0,0,0,0
"Georgia","2024-09-05",0,0,0,0,0,0,0,0
"Georgia","2024-09-06",0,0,0,0,0,0,0,0
"Georgia","2024-09-07",0,0,0,0,0,0,0,0
"Georgia","2024-09-08",0,0,0,0,0,0,0,0
"Georgia","2024-09-09",0,0,0,0,0,0,0,0
"Georgia","2024-09-10",0,0,0,0,0,0,0,0
"Georgia","2024-09-11",0,0,0,0,0,0,0,0
"Georgia","2024-09-12",0,0,0,0,0,0,0,0
"Georgia","2024-09-13",0,0,0,0,0,0,0,0
"Georgia","2024-09-14",0,0,0,0,0,0,0,0
"Georgia","2024-09-15",0,0,0,0,0,0,0,0
"Georgia","2024-09-16",0,0,0,0,0,0,0,0
"Georgia","2024-09-17",0,0,0,0,0,0,0,0
"Georgia","2024-09-18",0,0,0,0,0,0,0,0
"Georgia","2024-09-19",0,0,0,0,0,0,0,0
"Georgia","2024-09-20",0,0,0,0,0,0,0,0
"Georgia","2024-09-21",0,0,0,0,0,0,0,0
"Georgia","2024-09-22",0,0,0,0,0,0,0,0
"Georgia","2024-09-23",0,0,0,0,0,0,0,0
"Georgia","2024-09-24",0,0,0,0,0,0,0,0
"Georgia","2024-09-25",0,0,0,0,0,0,0,0
"Georgia","2024-09-26",0,0,0,0,0,0,0,0
"Georgia","2024-09-27",0,0,0,0,0,0,0,0
"Georgia","2024-09-28",0,0,0,0,0,0,0,0
"Georgia","2024-09-29",0,0,0,0,0,0,0,0
"Georgia","2024-09-30",0,0,0,0,0,0,0,0
"Georgia","2024-10-01",0,0,0,0,0,0,0,0
"Georgia","2024-10-02",0,0,0,0,0,0,0,0
"Georgia","2024-10-03",0,0,0,0,0,0,0,0
"Georgia","2024-10-04",0,0,0,0,0,0,0,0
"Georgia","2024-10-05",0,0,0,0,0,0,0,0
"Georgia","2024-10-06",0,0,0,0,0,0,0,0
"Georgia","2024-10-07",0,0,0,0,0,0,0,0
"Georgia","2024-10-08",0,0,0,0,0,0,0,0
"Georgia","2024-10-09",0,0,0,0,0,0,0,0
"Georgia","2024-10-10",0,0,0,0,0,0,0,0
"Georgia","2024-10-11",0,0,0,0,0,0,0,0
"Georgia","2024-10-12",0,0,0,0,0,0,0,0
"Georgia","2024-10-13",0,0,0,0,0,0,0,0
"Georgia","2024-10-14",0,0,0,0,0,0,0,0
"Georgia","2024-10-15",0,0,0,0,0,0,0,0
"Georgia","2024-10-16",0,0,0,0,0,0,0,0
"Georgia","2024-10-17",0,0,0,0,0,0,0,0
"Georgia","2024-10-18",0,0,0,0,0,0,0,0
"Georgia","2024-10-19",0,0,0,0,0,0,0,0
"Georgia","2024-10-20",0,0,0,0,0,0,0,0
"Georgia","2024-10-21",0,0,0,0,0,0,0,0
"Georgia","2024-10-22",0,0,0,0,0,0,0,0
"Georgia","2024-10-23",0,0,0,0,0,0,0,0
"Georgia","2024-10-24",0,0,0,0,0,0,0,0
"Georgia","2024-10-25",0,0,0,0,0,0,0,0
"Georgia","2024-10-26",0,0,0,0,0,0,0,0
"Georgia","2024-10-27",0,0,0,0,0,0,0,0
"Georgia","2024-10-28",0,0,0,0,0,0,0,0
"Georgia","2024-10-29",0,0,0,0,0,0,0,0
"Georgia","2024-10-30",0,0,0,0,0,0,0,0
"Georgia","2024-10-31",0,0,0,0,0,0,0,0
"Georgia","2024-11-01",0,0,0,0,0,0,0,0
"Georgia","2024-11-02",0,0,0,0,0,0,0,0
"Georgia","2024-11-03",0,0,0,0,0,0,0,0
"Georgia","2024-11-04",0,0,0,0,0,0,0,0
"Georgia","2024-11-05",0,0,0,0,0,0,0,0
"Georgia","2024-11-06",0,0,0,0,0,0,0,0
"Georgia","2024-11-07",0,0,0,0,0,0,0,0
"Georgia","2024-11-08",0,0,0,0,0,0,0,0
"Georgia","2024-11-09",0,0,0,0,0,0,0,0
"Georgia","2024-11-10",0,0,0,0,0,0,0,0
"Georgia","2024-11-11",0,0,0,0,0,0,0,0
"Georgia","2024-11-12",0,0,0,0,0,0,0,0
"Georgia","2024-11-13",0,0,0,0,0,0,0,0
"Georgia","2024-11-14",0,0,0,0,0,0,0,0
"Georgia","2024-11-15",0,0,0,0,0,0,0,0
"Georgia","2024-11-16",0,0,0,0,0,0,0,0
"Georgia","2024-11-17",0,0,0,0,0,0,0,0
"Georgia","2024-11-18",0,0,0,0,0,0,0,0
"Georgia","2024-11-19",0,0,0,0,0,0,0,0
"Georgia","2024-11-20",0,0,0,0,0,0,0,0
"Georgia","2024-11-21",0,0,0,0,0,0,0,0
"Georgia","2024-11-22",0,0,0,0,0,0,0,0
"Georgia","2024-11-23",0,0,0,0,0,0,0,0
"Georgia","2024-11-24",0,0,0,0,0,0,0,0
"Georgia","2024-11-25",0,0,0,0,0,0,0,0
"Georgia","2024-11-26",0,0,0,0,0,0,0,0
"Georgia","2024-11-27",0,0,0,0,0,0,0,0
"Georgia","2024-11-28",0,0,0,0,0,0,0,0
"Georgia","2024-11-29",0,0,0,0,0,0,0,0
"Georgia","2024-11-30",0,0,0,0,0,0,0,0
"Georgia","2024-12-01",0,0,0,0,0,0,0,0
"Georgia","2024-12-02",0,0,0,0,0,0,0,0
"Georgia","2024-12-03",0,0,0,0,0,0,0,0
"Georgia","2024-12-04",0,0,0,0,0,0,0,0
"Georgia","2024-12-05",0,0,0,0,0,0,0,0
"Georgia","2024-12-06",0,0,0,0,0,0,0,0
"Georgia","2024-12-07",0,0,0,0,0,0,0,0
"Georgia","2024-12-08",0,0,0,0,0,0,0,0
"Georgia","2024-12-09",0,0,0,0,0,0,0,0
"Germany","2024-01-01",0,0,0,0,0,0,0,0
"Germany","2024-01-02",0,0,0,0,0,0,0,0
"Germany","2024-01-03",0,0,0,0,0,0,0,0
"Germany","2024-01-04",0,0,0,0,0,0,0,0
"Germany","2024-01-05",0,0,0,0,0,0,0,0
"Germany","2024-01-06",0,0,0,0,0,0,0,0
"Germany","2024-01-07",0,0,0,0,0,0,0,0
"Germany","2024-01-08",0,0,0,0,0,0,0,0
"Germany","2024-01-09",0,0,0,0,0,0,0,0
"Germany","2024-01-10",0,0,0,0,0,0,0,0
"Germany","2024-01-11",0,0,0,0,0,0,0,0
"Germany","2024-01-12",0,0,0,0,0,0,0,0
"Germany","2024-01-13",0,0,0,0,0,0,0,0
"Germany","2024-01-14",0,0,0,0,0,0,0,0
"Germany","2024-01-15",0,0,0,0,0,0,0,0
"Germany","2024-01-16",0,0,0,0,0,0,0,0
"Germany","2024-01-17",0,0,0,0,0,0,0,0
"Germany","2024-01-18",0,0,0,0,0,0,0,0
"Germany","2024-01-19",0,0,0,0,0,0,0,0
"Germany","2024-01-20",0,0,0,0,0,0,0,0
"Germany","2024-01-21",0,0,0,0,0,0,0,0
"Germany","2024-01-22",0,0,0,0,0,0,0,0
"Germany","2024-01-23",0,0,0,0,0,0,0,0
"Germany","2024-01-24",0,0,0,0,0,0,0,0
"Germany","2024-01-25",0,0,0,0,0,0,0,0
"Germany","2024-01-26",0,0,0,0,0,0,0,0
"Germany","2024-01-27",0,0,0,0,0,0,0,0
"Germany","2024-01-28",0,0,0,0,0,0,0,0
"Germany","2024-01-29",0,0,0,0,0,0,0,0
"Germany","2024-01-30",0,0,0,0,0,0,0,0
"Germany","2024-01-31",0,7,7,0,7,7,0,0
"Germany","2024-02-01",0,0,7,0,0,7,0,0
"Germany","2024-02-02",0,0,7,0,1,8,0,0
"Germany","2024-02-03",0,0,7,0,0,8,0,0
"Germany","2024-02-04",0,0,7,0,0,8,0,0
"Germany","2024-02-05",0,0,7,0,1,9,0,0
"Germany","2024-02-06",0,0,7,0,0,9,0,0
"Germany","2024-02-07",0,0,7,0,0,9,0,0
"Germany","2024-02-08",0,0,7,0,0,9,0,0
"Germany","2024-02-09",0,0,7,0,1,10,0,0
"Germany","2024-02-10",0,0,7,0,0,10,0,0
"Germany","2024-02-11",0,0,7,0,0,10,0,0
"Germany","2024-02-12",0,0,7,0,1,11,0,0
"Germany","2024-02-13",0,0,7,0,0,11,0,0
"Germany","2024-02-14",0,0,7,0,0,11,0,0
"Germany","2024-02-15",0,0,7,0,1,12,0,0
"Germany","2024-02-16",0,0,7,0,0,12,0,0
"Germany","2024-02-17",0,0,7,0,0,12,0,0
"Germany","2024-02-18",0,0,7,0,1,13,0,0
"Germany","2024-02-19",0,0,7,0,0,13,0,0
"Germany","2024-02-20",0,0,7,0,0,13,0,0
"Germany","2024-02-21",0,0,7,0,1,14,0,0
"Germany","2024-02-22",0,0,7,0,0,14,0,0
"Germany","2024-02-23",0,0,7,0,0,14,0,0
"Germany","2024-02-24",0,0,7,0,0,14,0,0
"Germany","2024-02-25",0,0,7,0,1,15,0,0
"Germany","2024-02-26",0,0,7,0,0,15,0,0
"Germany","2024-02-27",0,0,7,0,0,15,0,0
"Germany","2024-02-28",0,0,7,0,1,16,0,0
"Germany","2024-02-29",0,9,16,0,0,16,0,0
"Germany","2024-03-01",0,0,16,0,0,16,0,0
"Germany","2024-03-02",0,0,16,0,1,17,0,0
"Germany","2024-03-03",0,0,16,0,0,17,0,0
"Germany","2024-03-04",0,0,16,0,1,18,0,0
"Germany","2024-03-05",0,0,16,0,0,18,0,0
"Germany","2024-03-06",0,0,16,0,1,19,0,0
"Germany","2024-03-07",0,0,16,0,0,19,0,0
"Germany","2024-03-08",0,0,16,0,1,20,0,0
"Germany","2024-03-09",0,0,16,0,0,20,0,0
"Germany","2024-03-10",0,0,16,0,1,21,0,0
"Germany","2024-03-11",0,0,16,0,0,21,0,0
"Germany","2024-03-12",0,0,16,0,0,21,0,0
"Germany","2024-03-13",0,0,16,0,1,22,0,0
"Germany","2024-03-14",0,0,16,0,0,22,0,0
"Germany","2024-03-15",0,0,16,0,1,23,0,0
"Germany","2024-03-16",0,0,16,0,0,23,0,0
"Germany","2024-03-17",0,0,16,0,1,24,0,0
"Germany","2024-03-18",0,0,16,0,0,24,0,0
"Germany","2024-03-19",0,0,16,0,1,25,0,0
"Germany","2024-03-20",0,0,16,0,0,25,0,0
"Germany","2024-03-21",0,0,16,0,0,25,0,0
"Germany","2024-03-22",0,0,16,0,1,26,0,0
"Germany","2024-03-23",0,0,16,0,0,26,0,0
"Germany","2024-03-24",0,0,16,0,1,27,0,0
"Germany","2024-03-25",0,0,16,0,0,27,0,0
"Germany","2024-03-26",0,0,16,0,1,28,0,0
"Germany","2024-03-27",0,0,16,0,0,28,0,0
"Germany","2024-03-28",0,0,16,0,1,29,0,0
"Germany","2024-03-29",0,0,16,0,0,29,0,0
"Germany","2024-03-30",0,0,16,0,1,30,0,0
"Germany","2024-03-31",0,14,30,0,0,30,0,0
"Germany","2024-04-01",0,0,30,0,0,30,0,0
"Germany","2024-04-02",0,0,30,0,1,31,0,0
"Germany","2024-04-03",0,0,30,0,0,31,0,0
"Germany","2024-04-04",0,0,30,0,0,31,0,0
"Germany","2024-04-05",0,0,30,0,1,32,0,0
"Germany","2024-04-06",0,0,30,0,0,32,0,0
"Germany","2024-04-07",0,0,30,0,1,33,0,0
"Germany","2024-04-08",0,0,30,0,0,33,0,0
"Germany","2024-04-09",0,0,30,0,0,33,0,0
"Germany","2024-04-10",0,0,30,0,1,34,0,0
"Germany","2024-04-11",0,0,30,0,0,34,0,0
"Germany","2024-04-12",0,0,30,0,0,34,0,0
"Germany","2024-04-13",0,0,30,0,1,35,0,0
"Germany","2024-04-14",0,0,30,0,0,35,0,0
"Germany","2024-04-15",0,0,30,0,1,36,0,0
"Germany","2024-04-16",0,0,30,0,0,36,0,0
"Germany","2024-04-17",0,0,30,0,0,36,0,0
"Germany","2024-04-18",0,0,30,0,1,37,0,0
"Germany","2024-04-19",0,0,30,0,0,37,0,0
"Germany","2024-04-20",0,0,30,0,0,37,0,0
"Germany","2024-04-21",0,0,30,0,1,38,0,0
"Germany","2024-04-22",0,0,30,0,0,38,0,0
"Germany","2024-04-23",0,0,30,0,0,38,0,0
"Germany","2024-04-24",0,0,30,0,1,39,0,0
"Germany","2024-04-25",0,0,30,0,0,39,0,0
"Germany","2024-04-26",0,0,30,0,1,40,0,0
"Germany","2024-04-27",0,0,30,0,0,40,0,0
"Germany","2024-04-28",0,0,30,0,0,40,0,0
"Germany","2024-04-29",0,0,30,0,1,41,0,0
"Germany","2024-04-30",0,11,41,0,0,41,0,0
"Germany","2024-05-01",0,0,41,0,0,41,0,0
"Germany","2024-05-02",0,0,41,0,0,41,0,0
"Germany","2024-05-03",0,0,41,0,1,42,0,0
"Germany","2024-05-04",0,0,41,0,0,42,0,0
"Germany","2024-05-05",0,0,41,0,0,42,0,0
"Germany","2024-05-06",0,0,41,0,0,42,0,0
"Germany","2024-05-07",0,0,41,0,0,42,0,0
"Germany","2024-05-08",0,0,41,0,1,43,0,0
"Germany","2024-05-09",0,0,41,0,0,43,0,0
"Germany","2024-05-10",0,0,41,0,0,43,0,0
"Germany","2024-05-11",0,0,41,0,0,43,0,0
"Germany","2024-05-12",0,0,41,0,0,43,0,0
"Germany","2024-05-13",0,0,41,0,1,44,0,0
"Germany","2024-05-14",0,0,41,0,0,44,0,0
"Germany","2024-05-15",0,0,41,0,0,44,0,0
"Germany","2024-05-16",0,0,41,0,0,44,0,0
"Germany","2024-05-17",0,0,41,0,0,44,0,0
"Germany","2024-05-18",0,0,41,0,0,44,0,0
"Germany","2024-05-19",0,0,41,0,1,45,0,0
"Germany","2024-05-20",0,0,41,0,0,45,0,0
"Germany","2024-05-21",0,0,41,0,0,45,0,0
"Germany","2024-05-22",0,0,41,0,0,45,0,0
"Germany","2024-05-23",0,0,41,0,0,45,0,0
"Germany","2024-05-24",0,0,41,0,1,46,0,0
"Germany","2024-05-25",0,0,41,0,0,46,0,0
"Germany","2024-05-26",0,0,41,0,0,46,0,0
"Germany","2024-05-27",0,0,41,0,0,46,0,0
"Germany","2024-05-28",0,0,41,0,0,46,0,0
"Germany","2024-05-29",0,0,41,0,1,47,0,0
"Germany","2024-05-30",0,0,41,0,0,47,0,0
"Germany","2024-05-31",0,6,47,0,0,47,0,0
"Germany","2024-06-01",0,0,47,0,0,47,0,0
"Germany","2024-06-02",0,0,47,0,1,48,0,0
"Germany","2024-06-03",0,0,47,0,0,48,0,0
"Germany","2024-06-04",0,0,47,0,0,48,0,0
"Germany","2024-06-05",0,0,47,0,1,49,0,0
"Germany","2024-06-06",0,0,47,0,0,49,0,0
"Germany","2024-06-07",0,0,47,0,0,49,0,0
"Germany","2024-06-08",0,0,47,0,1,50,0,0
"Germany","2024-06-09",0,0,47,0,0,50,0,0
"Germany","2024-06-10",0,0,47,0,0,50,0,0
"Germany","2024-06-11",0,0,47,0,1,51,0,0
"Germany","2024-06-12",0,0,47,0,0,51,0,0
"Germany","2024-06-13",0,0,47,0,0,51,0,0
"Germany","2024-06-14",0,0,47,0,1,52,0,0
"Germany","2024-06-15",0,0,47,0,0,52,0,0
"Germany","2024-06-16",0,0,47,0,0,52,0,0
"Germany","2024-06-17",0,0,47,0,1,53,0,0
"Germany","2024-06-18",0,0,47,0,0,53,0,0
"Germany","2024-06-19",0,0,47,0,0,53,0,0
"Germany","2024-06-20",0,0,47,0,1,54,0,0
"Germany","2024-06-21",0,0,47,0,0,54,0,0
"Germany","2024-06-22",0,0,47,0,0,54,0,0
"Germany","2024-06-23",0,0,47,0,1,55,0,0
"Germany","2024-06-24",0,0,47,0,0,55,0,0
"Germany","2024-06-25",0,0,47,0,0,55,0,0
"Germany","2024-06-26",0,0,47,0,1,56,0,0
"Germany","2024-06-27",0,0,47,0,0,56,0,0
"Germany","2024-06-28",0,0,47,0,0,56,0,0
"Germany","2024-06-29",0,0,47,0,1,57,0,0
"Germany","2024-06-30",0,10,57,0,0,57,0,0
"Germany","2024-07-01",0,0,57,0,1,58,0,0
"Germany","2024-07-02",0,0,57,0,1,59,0,0
"Germany","2024-07-03",0,0,57,0,1,60,0,0
"Germany","2024-07-04",0,0,57,0,1,61,0,0
"Germany","2024-07-05",0,0,57,0,1,62,0,0
"Germany","2024-07-06",0,0,57,0,1,63,0,0
"Germany","2024-07-07",0,0,57,0,1,64,0,0
"Germany","2024-07-08",0,0,57,0,0,64,0,0
"Germany","2024-07-09",0,0,57,0,1,65,0,0
"Germany","2024-07-10",0,0,57,0,1,66,0,0
"Germany","2024-07-11",0,0,57,0,1,67,0,0
"Germany","2024-07-12",0,0,57,0,1,68,0,0
"Germany","2024-07-13",0,0,57,0,1,69,0,0
"Germany","2024-07-14",0,0,57,0,1,70,0,0
"Germany","2024-07-15",0,0,57,0,1,71,0,0
"Germany","2024-07-16",0,0,57,0,1,72,0,0
"Germany","2024-07-17",0,0,57,0,1,73,0,0
"Germany","2024-07-18",0,0,57,0,1,74,0,0
"Germany","2024-07-19",0,0,57,0,1,75,0,0
"Germany","2024-07-20",0,0,57,0,1,76,0,0
"Germany","2024-07-21",0,0,57,0,1,77,0,0
"Germany","2024-07-22",0,0,57,0,1,78,0,0
"Germany","2024-07-23",0,0,57,0,1,79,0,0
"Germany","2024-07-24",0,0,57,0,0,79,0,0
"Germany","2024-07-25",0,0,57,0,1,80,0,0
"Germany","2024-07-26",0,0,57,0,1,81,0,0
"Germany","2024-07-27",0,0,57,0,1,82,0,0
"Germany","2024-07-28",0,0,57,0,1,83,0,0
"Germany","2024-07-29",0,0,57,0,1,84,0,0
"Germany","2024-07-30",0,0,57,0,1,85,0,0
"Germany","2024-07-31",0,29,86,0,1,86,0,0
"Germany","2024-08-01",0,0,86,0,1,87,0,0
"Germany","2024-08-02",0,0,86,0,0,87,0,0
"Germany","2024-08-03",0,0,86,0,1,88,0,0
"Germany","2024-08-04",0,0,86,0,1,89,0,0
"Germany","2024-08-05",0,0,86,0,1,90,0,0
"Germany","2024-08-06",0,0,86,0,0,90,0,0
"Germany","2024-08-07",0,0,86,0,1,91,0,0
"Germany","2024-08-08",0,0,86,0,1,92,0,0
"Germany","2024-08-09",0,0,86,0,1,93,0,0
"Germany","2024-08-10",0,0,86,0,0,93,0,0
"Germany","2024-08-11",0,0,86,0,1,94,0,0
"Germany","2024-08-12",0,0,86,0,1,95,0,0
"Germany","2024-08-13",0,0,86,0,1,96,0,0
"Germany","2024-08-14",0,0,86,0,0,96,0,0
"Germany","2024-08-15",0,0,86,0,1,97,0,0
"Germany","2024-08-16",0,0,86,0,1,98,0,0
"Germany","2024-08-17",0,0,86,0,1,99,0,0
"Germany","2024-08-18",0,0,86,0,0,99,0,0
"Germany","2024-08-19",0,0,86,0,1,100,0,0
"Germany","2024-08-20",0,0,86,0,1,101,0,0
"Germany","2024-08-21",0,0,86,0,1,102,0,0
"Germany","2024-08-22",0,0,86,0,0,102,0,0
"Germany","2024-08-23",0,0,86,0,1,103,0,0
"Germany","2024-08-24",0,0,86,0,1,104,0,0
"Germany","2024-08-25",0,0,86,0,1,105,0,0
"Germany","2024-08-26",0,0,86,0,0,105,0,0
"Germany","2024-08-27",0,0,86,0,1,106,0,0
"Germany","2024-08-28",0,0,86,0,1,107,0,0
"Germany","2024-08-29",0,0,86,0,1,108,0,0
"Germany","2024-08-30",0,0,86,0,0,108,0,0
"Germany","2024-08-31",0,23,109,0,1,109,0,0
"Germany","2024-09-01",0,0,109,0,1,110,0,0
"Germany","2024-09-02",0,0,109,0,1,111,0,0
"Germany","2024-09-03",0,0,109,0,0,111,0,0
"Germany","2024-09-04",0,0,109,0,1,112,0,0
"Germany","2024-09-05",0,0,109,0,1,113,0,0
"Germany","2024-09-06",0,0,109,0,1,114,0,0
"Germany","2024-09-07",0,0,109,0,0,114,0,0
"Germany","2024-09-08",0,0,109,0,1,115,0,0
"Germany","2024-09-09",0,0,109,0,1,116,0,0
"Germany","2024-09-10",0,0,109,0,1,117,0,0
"Germany","2024-09-11",0,0,109,0,0,117,0,0
"Germany","2024-09-12",0,0,109,0,1,118,0,0
"Germany","2024-09-13",0,0,109,0,1,119,0,0
"Germany","2024-09-14",0,0,109,0,1,120,0,0
"Germany","2024-09-15",0,0,109,0,1,121,0,0
"Germany","2024-09-16",0,0,109,0,0,121,0,0
"Germany","2024-09-17",0,0,109,0,1,122,0,0
"Germany","2024-09-18",0,0,109,0,1,123,0,0
"Germany","2024-09-19",0,0,109,0,1,124,0,0
"Germany","2024-09-20",0,0,109,0,0,124,0,0
"Germany","2024-09-21",0,0,109,0,1,125,0,0
"Germany","2024-09-22",0,0,109,0,1,126,0,0
"Germany","2024-09-23",0,0,109,0,1,127,0,0
"Germany","2024-09-24",0,0,109,0,0,127,0,0
"Germany","2024-09-25",0,0,109,0,1,128,0,0
"Germany","2024-09-26",0,0,109,0,1,129,0,0
"Germany","2024-09-27",0,0,109,0,1,130,0,0
"Germany","2024-09-28",0,0,109,0,0,130,0,0
"Germany","2024-09-29",0,0,109,0,1,131,0,0
"Germany","2024-09-30",0,23,132,0,1,132,0,0
"Germany","2024-10-01",0,0,132,0,2,134,0,0
"Germany","2024-10-02",0,0,132,0,1,135,0,0
"Germany","2024-10-03",0,0,132,0,2,137,0,0
"Germany","2024-10-04",0,0,132,0,1,138,0,0
"Germany","2024-10-05",0,0,132,0,2,140,0,0
"Germany","2024-10-06",0,0,132,0,1,141,0,0
"Germany","2024-10-07",0,0,132,0,2,143,0,0
"Germany","2024-10-08",0,0,132,0,1,144,0,0
"Germany","2024-10-09",0,0,132,0,2,146,0,0
"Germany","2024-10-10",0,0,132,0,1,147,0,0
"Germany","2024-10-11",0,0,132,0,2,149,0,0
"Germany","2024-10-12",0,0,132,0,2,151,0,0
"Germany","2024-10-13",0,0,132,0,1,152,0,0
"Germany","2024-10-14",0,0,132,0,2,154,0,0
"Germany","2024-10-15",0,0,132,0,1,155,0,0
"Germany","2024-10-16",0,0,132,0,2,157,0,0
"Germany","2024-10-17",0,0,132,0,1,158,0,0
"Germany","2024-10-18",0,0,132,0,2,160,0,0
"Germany","2024-10-19",0,0,132,0,1,161,0,0
"Germany","2024-10-20",0,0,132,0,2,163,0,0
"Germany","2024-10-21",0,0,132,0,2,165,0,0
"Germany","2024-10-22",0,0,132,0,1,166,0,0
"Germany","2024-10-23",0,0,132,0,2,168,0,0
"Germany","2024-10-24",0,0,132,0,1,169,0,0
"Germany","2024-10-25",0,0,132,0,2,171,0,0
"Germany","2024-10-26",0,0,132,0,1,172,0,0
"Germany","2024-10-27",0,0,132,0,2,174,0,0
"Germany","2024-10-28",0,0,132,0,1,175,0,0
"Germany","2024-10-29",0,0,132,0,2,177,0,0
"Germany","2024-10-30",0,0,132,0,1,178,0,0
"Germany","2024-10-31",0,48,180,0,2,180,0,0
"Germany","2024-11-01",0,0,180,0,0,180,0,0
"Germany","2024-11-02",0,0,180,0,0,180,0,0
"Germany","2024-11-03",0,0,180,0,0,180,0,0
"Germany","2024-11-04",0,0,180,0,0,180,0,0
"Germany","2024-11-05",0,0,180,0,0,180,0,0
"Germany","2024-11-06",0,0,180,0,0,180,0,0
"Germany","2024-11-07",0,0,180,0,0,180,0,0
"Germany","2024-11-08",0,0,180,0,0,180,0,0
"Germany","2024-11-09",0,0,180,0,0,180,0,0
"Germany","2024-11-10",0,0,180,0,0,180,0,0
"Germany","2024-11-11",0,0,180,0,0,180,0,0
"Germany","2024-11-12",0,0,180,0,0,180,0,0
"Germany","2024-11-13",0,0,180,0,0,180,0,0
"Germany","2024-11-14",0,0,180,0,0,180,0,0
"Germany","2024-11-15",0,0,180,0,0,180,0,0
"Germany","2024-11-16",0,0,180,0,0,180,0,0
"Germany","2024-11-17",0,0,180,0,0,180,0,0
"Germany","2024-11-18",0,0,180,0,0,180,0,0
"Germany","2024-11-19",0,0,180,0,0,180,0,0
"Germany","2024-11-20",0,0,180,0,0,180,0,0
"Germany","2024-11-21",0,0,180,0,0,180,0,0
"Germany","2024-11-22",0,0,180,0,0,180,0,0
"Germany","2024-11-23",0,0,180,0,0,180,0,0
"Germany","2024-11-24",0,0,180,0,0,180,0,0
"Germany","2024-11-25",0,0,180,0,0,180,0,0
"Germany","2024-11-26",0,0,180,0,0,180,0,0
"Germany","2024-11-27",0,0,180,0,0,180,0,0
"Germany","2024-11-28",0,0,180,0,0,180,0,0
"Germany","2024-11-29",0,0,180,0,0,180,0,0
"Germany","2024-11-30",0,0,180,0,0,180,0,0
"Germany","2024-12-01",0,0,180,0,0,180,0,0
"Germany","2024-12-02",0,0,180,0,0,180,0,0
"Germany","2024-12-03",0,0,180,0,0,180,0,0
"Germany","2024-12-04",0,0,180,0,0,180,0,0
"Germany","2024-12-05",0,0,180,0,0,180,0,0
"Germany","2024-12-06",0,0,180,0,0,180,0,0
"Germany","2024-12-07",0,0,180,0,0,180,0,0
"Germany","2024-12-08",0,0,180,0,0,180,0,0
"Germany","2024-12-09",0,0,180,0,0,180,0,0
"Ghana","2024-01-01",0,0,0,0,0,0,0,0
"Ghana","2024-01-02",0,0,0,0,0,0,0,0
"Ghana","2024-01-03",0,0,0,0,0,0,0,0
"Ghana","2024-01-04",0,0,0,0,0,0,0,0
"Ghana","2024-01-05",0,0,0,0,0,0,0,0
"Ghana","2024-01-06",0,0,0,0,0,0,0,0
"Ghana","2024-01-07",0,0,0,0,0,0,0,0
"Ghana","2024-01-08",0,0,0,0,0,0,0,0
"Ghana","2024-01-09",0,0,0,0,0,0,0,0
"Ghana","2024-01-10",0,0,0,0,0,0,0,0
"Ghana","2024-01-11",0,0,0,0,0,0,0,0
"Ghana","2024-01-12",0,0,0,0,0,0,0,0
"Ghana","2024-01-13",0,0,0,0,0,0,0,0
"Ghana","2024-01-14",0,0,0,0,0,0,0,0
"Ghana","2024-01-15",0,0,0,0,0,0,0,0
"Ghana","2024-01-16",0,0,0,0,0,0,0,0
"Ghana","2024-01-17",0,0,0,0,0,0,0,0
"Ghana","2024-01-18",0,0,0,0,0,0,0,0
"Ghana","2024-01-19",0,0,0,0,0,0,0,0
"Ghana","2024-01-20",0,0,0,0,0,0,0,0
"Ghana","2024-01-21",0,0,0,0,0,0,0,0
"Ghana","2024-01-22",0,0,0,0,0,0,0,0
"Ghana","2024-01-23",0,0,0,0,0,0,0,0
"Ghana","2024-01-24",0,0,0,0,0,0,0,0
"Ghana","2024-01-25",0,0,0,0,0,0,0,0
"Ghana","2024-01-26",0,0,0,0,0,0,0,0
"Ghana","2024-01-27",0,0,0,0,0,0,0,0
"Ghana","2024-01-28",0,0,0,0,0,0,0,0
"Ghana","2024-01-29",0,0,0,0,0,0,0,0
"Ghana","2024-01-30",0,0,0,0,0,0,0,0
"Ghana","2024-01-31",0,0,0,0,0,0,0,0
"Ghana","2024-02-01",0,0,0,0,0,0,0,0
"Ghana","2024-02-02",0,0,0,0,0,0,0,0
"Ghana","2024-02-03",0,0,0,0,0,0,0,0
"Ghana","2024-02-04",0,0,0,0,0,0,0,0
"Ghana","2024-02-05",0,0,0,0,0,0,0,0
"Ghana","2024-02-06",0,0,0,0,0,0,0,0
"Ghana","2024-02-07",0,0,0,0,0,0,0,0
"Ghana","2024-02-08",0,0,0,0,0,0,0,0
"Ghana","2024-02-09",0,0,0,0,0,0,0,0
"Ghana","2024-02-10",0,0,0,0,0,0,0,0
"Ghana","2024-02-11",0,0,0,0,0,0,0,0
"Ghana","2024-02-12",0,0,0,0,0,0,0,0
"Ghana","2024-02-13",0,0,0,0,0,0,0,0
"Ghana","2024-02-14",0,0,0,0,0,0,0,0
"Ghana","2024-02-15",0,0,0,0,0,0,0,0
"Ghana","2024-02-16",0,0,0,0,0,0,0,0
"Ghana","2024-02-17",0,0,0,0,0,0,0,0
"Ghana","2024-02-18",0,0,0,0,0,0,0,0
"Ghana","2024-02-19",0,0,0,0,0,0,0,0
"Ghana","2024-02-20",0,0,0,0,0,0,0,0
"Ghana","2024-02-21",0,0,0,0,0,0,0,0
"Ghana","2024-02-22",0,0,0,0,0,0,0,0
"Ghana","2024-02-23",0,0,0,0,0,0,0,0
"Ghana","2024-02-24",0,0,0,0,0,0,0,0
"Ghana","2024-02-25",0,0,0,0,0,0,0,0
"Ghana","2024-02-26",0,0,0,0,0,0,0,0
"Ghana","2024-02-27",0,0,0,0,0,0,0,0
"Ghana","2024-02-28",0,0,0,0,0,0,0,0
"Ghana","2024-02-29",0,0,0,0,0,0,0,0
"Ghana","2024-03-01",0,0,0,0,0,0,0,0
"Ghana","2024-03-02",0,0,0,0,0,0,0,0
"Ghana","2024-03-03",0,0,0,0,0,0,0,0
"Ghana","2024-03-04",0,0,0,0,0,0,0,0
"Ghana","2024-03-05",0,0,0,0,0,0,0,0
"Ghana","2024-03-06",0,0,0,0,0,0,0,0
"Ghana","2024-03-07",0,0,0,0,0,0,0,0
"Ghana","2024-03-08",0,0,0,0,0,0,0,0
"Ghana","2024-03-09",0,0,0,0,0,0,0,0
"Ghana","2024-03-10",0,0,0,0,0,0,0,0
"Ghana","2024-03-11",0,0,0,0,0,0,0,0
"Ghana","2024-03-12",0,0,0,0,0,0,0,0
"Ghana","2024-03-13",0,0,0,0,0,0,0,0
"Ghana","2024-03-14",0,0,0,0,0,0,0,0
"Ghana","2024-03-15",0,0,0,0,0,0,0,0
"Ghana","2024-03-16",0,0,0,0,0,0,0,0
"Ghana","2024-03-17",0,0,0,0,0,0,0,0
"Ghana","2024-03-18",0,0,0,0,0,0,0,0
"Ghana","2024-03-19",0,0,0,0,0,0,0,0
"Ghana","2024-03-20",0,0,0,0,0,0,0,0
"Ghana","2024-03-21",0,0,0,0,0,0,0,0
"Ghana","2024-03-22",0,0,0,0,0,0,0,0
"Ghana","2024-03-23",0,0,0,0,0,0,0,0
"Ghana","2024-03-24",0,0,0,0,0,0,0,0
"Ghana","2024-03-25",0,0,0,0,0,0,0,0
"Ghana","2024-03-26",0,0,0,0,0,0,0,0
"Ghana","2024-03-27",0,0,0,0,0,0,0,0
"Ghana","2024-03-28",0,0,0,0,0,0,0,0
"Ghana","2024-03-29",0,0,0,0,0,0,0,0
"Ghana","2024-03-30",0,0,0,0,0,0,0,0
"Ghana","2024-03-31",0,0,0,0,0,0,0,0
"Ghana","2024-04-01",0,0,0,0,0,0,0,0
"Ghana","2024-04-02",0,0,0,0,0,0,0,0
"Ghana","2024-04-03",0,0,0,0,0,0,0,0
"Ghana","2024-04-04",0,0,0,0,0,0,0,0
"Ghana","2024-04-05",0,0,0,0,0,0,0,0
"Ghana","2024-04-06",0,0,0,0,0,0,0,0
"Ghana","2024-04-07",0,0,0,0,0,0,0,0
"Ghana","2024-04-08",0,0,0,0,0,0,0,0
"Ghana","2024-04-09",0,0,0,0,0,0,0,0
"Ghana","2024-04-10",0,0,0,0,0,0,0,0
"Ghana","2024-04-11",0,0,0,0,0,0,0,0
"Ghana","2024-04-12",0,0,0,0,0,0,0,0
"Ghana","2024-04-13",0,0,0,0,0,0,0,0
"Ghana","2024-04-14",0,0,0,0,0,0,0,0
"Ghana","2024-04-15",0,0,0,0,0,0,0,0
"Ghana","2024-04-16",0,0,0,0,0,0,0,0
"Ghana","2024-04-17",0,0,0,0,0,0,0,0
"Ghana","2024-04-18",0,0,0,0,0,0,0,0
"Ghana","2024-04-19",0,0,0,0,0,0,0,0
"Ghana","2024-04-20",0,0,0,0,0,0,0,0
"Ghana","2024-04-21",0,0,0,0,0,0,0,0
"Ghana","2024-04-22",0,0,0,0,0,0,0,0
"Ghana","2024-04-23",0,0,0,0,0,0,0,0
"Ghana","2024-04-24",0,0,0,0,0,0,0,0
"Ghana","2024-04-25",0,0,0,0,0,0,0,0
"Ghana","2024-04-26",0,0,0,0,0,0,0,0
"Ghana","2024-04-27",0,0,0,0,0,0,0,0
"Ghana","2024-04-28",0,0,0,0,0,0,0,0
"Ghana","2024-04-29",0,0,0,0,0,0,0,0
"Ghana","2024-04-30",0,0,0,0,0,0,0,0
"Ghana","2024-05-01",0,0,0,0,0,0,0,0
"Ghana","2024-05-02",0,0,0,0,0,0,0,0
"Ghana","2024-05-03",0,0,0,0,0,0,0,0
"Ghana","2024-05-04",0,0,0,0,0,0,0,0
"Ghana","2024-05-05",0,0,0,0,0,0,0,0
"Ghana","2024-05-06",0,0,0,0,0,0,0,0
"Ghana","2024-05-07",0,0,0,0,0,0,0,0
"Ghana","2024-05-08",0,0,0,0,0,0,0,0
"Ghana","2024-05-09",0,0,0,0,0,0,0,0
"Ghana","2024-05-10",0,0,0,0,0,0,0,0
"Ghana","2024-05-11",0,0,0,0,0,0,0,0
"Ghana","2024-05-12",0,0,0,0,0,0,0,0
"Ghana","2024-05-13",0,0,0,0,0,0,0,0
"Ghana","2024-05-14",0,0,0,0,0,0,0,0
"Ghana","2024-05-15",0,0,0,0,0,0,0,0
"Ghana","2024-05-16",0,0,0,0,0,0,0,0
"Ghana","2024-05-17",0,0,0,0,0,0,0,0
"Ghana","2024-05-18",0,0,0,0,0,0,0,0
"Ghana","2024-05-19",0,0,0,0,0,0,0,0
"Ghana","2024-05-20",0,0,0,0,0,0,0,0
"Ghana","2024-05-21",0,0,0,0,0,0,0,0
"Ghana","2024-05-22",0,0,0,0,0,0,0,0
"Ghana","2024-05-23",0,0,0,0,0,0,0,0
"Ghana","2024-05-24",0,0,0,0,0,0,0,0
"Ghana","2024-05-25",0,0,0,0,0,0,0,0
"Ghana","2024-05-26",0,0,0,0,0,0,0,0
"Ghana","2024-05-27",0,0,0,0,0,0,0,0
"Ghana","2024-05-28",0,0,0,0,0,0,0,0
"Ghana","2024-05-29",0,0,0,0,0,0,0,0
"Ghana","2024-05-30",0,0,0,0,0,0,0,0
"Ghana","2024-05-31",0,0,0,0,0,0,0,0
"Ghana","2024-06-01",0,0,0,0,0,0,0,0
"Ghana","2024-06-02",0,0,0,0,0,0,0,0
"Ghana","2024-06-03",0,0,0,0,0,0,0,0
"Ghana","2024-06-04",0,0,0,0,0,0,0,0
"Ghana","2024-06-05",0,0,0,0,0,0,0,0
"Ghana","2024-06-06",0,0,0,0,0,0,0,0
"Ghana","2024-06-07",0,0,0,0,0,0,0,0
"Ghana","2024-06-08",0,0,0,0,0,0,0,0
"Ghana","2024-06-09",0,0,0,0,0,0,0,0
"Ghana","2024-06-10",0,0,0,0,0,0,0,0
"Ghana","2024-06-11",0,0,0,0,0,0,0,0
"Ghana","2024-06-12",0,0,0,0,0,0,0,0
"Ghana","2024-06-13",0,0,0,0,0,0,0,0
"Ghana","2024-06-14",0,0,0,0,0,0,0,0
"Ghana","2024-06-15",0,0,0,0,0,0,0,0
"Ghana","2024-06-16",0,0,0,0,0,0,0,0
"Ghana","2024-06-17",0,0,0,0,0,0,0,0
"Ghana","2024-06-18",0,0,0,0,0,0,0,0
"Ghana","2024-06-19",0,0,0,0,0,0,0,0
"Ghana","2024-06-20",0,0,0,0,0,0,0,0
"Ghana","2024-06-21",0,0,0,0,0,0,0,0
"Ghana","2024-06-22",0,0,0,0,0,0,0,0
"Ghana","2024-06-23",0,0,0,0,0,0,0,0
"Ghana","2024-06-24",0,0,0,0,0,0,0,0
"Ghana","2024-06-25",0,0,0,0,0,0,0,0
"Ghana","2024-06-26",0,0,0,0,0,0,0,0
"Ghana","2024-06-27",0,0,0,0,0,0,0,0
"Ghana","2024-06-28",0,0,0,0,0,0,0,0
"Ghana","2024-06-29",0,0,0,0,0,0,0,0
"Ghana","2024-06-30",0,0,0,0,0,0,0,0
"Ghana","2024-07-01",0,0,0,0,0,0,0,0
"Ghana","2024-07-02",0,0,0,0,0,0,0,0
"Ghana","2024-07-03",0,0,0,0,0,0,0,0
"Ghana","2024-07-04",0,0,0,0,0,0,0,0
"Ghana","2024-07-05",0,0,0,0,0,0,0,0
"Ghana","2024-07-06",0,0,0,0,0,0,0,0
"Ghana","2024-07-07",0,0,0,0,0,0,0,0
"Ghana","2024-07-08",0,0,0,0,0,0,0,0
"Ghana","2024-07-09",0,0,0,0,0,0,0,0
"Ghana","2024-07-10",0,0,0,0,0,0,0,0
"Ghana","2024-07-11",0,0,0,0,0,0,0,0
"Ghana","2024-07-12",0,0,0,0,0,0,0,0
"Ghana","2024-07-13",0,0,0,0,0,0,0,0
"Ghana","2024-07-14",0,0,0,0,0,0,0,0
"Ghana","2024-07-15",0,0,0,0,0,0,0,0
"Ghana","2024-07-16",0,0,0,0,0,0,0,0
"Ghana","2024-07-17",0,0,0,0,0,0,0,0
"Ghana","2024-07-18",0,0,0,0,0,0,0,0
"Ghana","2024-07-19",0,0,0,0,0,0,0,0
"Ghana","2024-07-20",0,0,0,0,0,0,0,0
"Ghana","2024-07-21",0,0,0,0,0,0,0,0
"Ghana","2024-07-22",0,0,0,0,0,0,0,0
"Ghana","2024-07-23",0,0,0,0,0,0,0,0
"Ghana","2024-07-24",0,0,0,0,0,0,0,0
"Ghana","2024-07-25",0,0,0,0,0,0,0,0
"Ghana","2024-07-26",0,0,0,0,0,0,0,0
"Ghana","2024-07-27",0,0,0,0,0,0,0,0
"Ghana","2024-07-28",0,0,0,0,0,0,0,0
"Ghana","2024-07-29",0,0,0,0,0,0,0,0
"Ghana","2024-07-30",0,0,0,0,0,0,0,0
"Ghana","2024-07-31",0,0,0,0,0,0,0,0
"Ghana","2024-08-01",0,0,0,0,0,0,0,0
"Ghana","2024-08-02",0,0,0,0,0,0,0,0
"Ghana","2024-08-03",0,0,0,0,0,0,0,0
"Ghana","2024-08-04",0,0,0,0,0,0,0,0
"Ghana","2024-08-05",0,0,0,0,0,0,0,0
"Ghana","2024-08-06",0,0,0,0,0,0,0,0
"Ghana","2024-08-07",0,0,0,0,0,0,0,0
"Ghana","2024-08-08",0,0,0,0,0,0,0,0
"Ghana","2024-08-09",0,0,0,0,0,0,0,0
"Ghana","2024-08-10",0,0,0,0,0,0,0,0
"Ghana","2024-08-11",0,0,0,0,0,0,0,0
"Ghana","2024-08-12",0,0,0,0,0,0,0,0
"Ghana","2024-08-13",0,0,0,0,0,0,0,0
"Ghana","2024-08-14",0,0,0,0,0,0,0,0
"Ghana","2024-08-15",0,0,0,0,0,0,0,0
"Ghana","2024-08-16",0,0,0,0,0,0,0,0
"Ghana","2024-08-17",0,0,0,0,0,0,0,0
"Ghana","2024-08-18",0,0,0,0,0,0,0,0
"Ghana","2024-08-19",0,0,0,0,0,0,0,0
"Ghana","2024-08-20",0,0,0,0,0,0,0,0
"Ghana","2024-08-21",0,0,0,0,0,0,0,0
"Ghana","2024-08-22",0,0,0,0,0,0,0,0
"Ghana","2024-08-23",0,0,0,0,0,0,0,0
"Ghana","2024-08-24",0,0,0,0,0,0,0,0
"Ghana","2024-08-25",0,0,0,0,0,0,0,0
"Ghana","2024-08-26",0,0,0,0,0,0,0,0
"Ghana","2024-08-27",0,0,0,0,0,0,0,0
"Ghana","2024-08-28",0,0,0,0,0,0,0,0
"Ghana","2024-08-29",0,0,0,0,0,0,0,0
"Ghana","2024-08-30",0,0,0,0,0,0,0,0
"Ghana","2024-08-31",0,0,0,0,0,0,0,0
"Ghana","2024-09-01",0,0,0,0,0,0,0,0
"Ghana","2024-09-02",0,0,0,0,0,0,0,0
"Ghana","2024-09-03",0,0,0,0,0,0,0,0
"Ghana","2024-09-04",0,0,0,0,0,0,0,0
"Ghana","2024-09-05",0,0,0,0,0,0,0,0
"Ghana","2024-09-06",0,0,0,0,0,0,0,0
"Ghana","2024-09-07",0,0,0,0,0,0,0,0
"Ghana","2024-09-08",0,0,0,0,0,0,0,0
"Ghana","2024-09-09",0,0,0,0,0,0,0,0
"Ghana","2024-09-10",0,0,0,0,0,0,0,0
"Ghana","2024-09-11",0,0,0,0,0,0,0,0
"Ghana","2024-09-12",0,0,0,0,0,0,0,0
"Ghana","2024-09-13",0,0,0,0,0,0,0,0
"Ghana","2024-09-14",0,0,0,0,0,0,0,0
"Ghana","2024-09-15",0,0,0,0,0,0,0,0
"Ghana","2024-09-16",0,0,0,0,0,0,0,0
"Ghana","2024-09-17",0,0,0,0,0,0,0,0
"Ghana","2024-09-18",0,0,0,0,0,0,0,0
"Ghana","2024-09-19",0,0,0,0,0,0,0,0
"Ghana","2024-09-20",0,0,0,0,0,0,0,0
"Ghana","2024-09-21",0,0,0,0,0,0,0,0
"Ghana","2024-09-22",0,0,0,0,0,0,0,0
"Ghana","2024-09-23",0,0,0,0,0,0,0,0
"Ghana","2024-09-24",0,0,0,0,0,0,0,0
"Ghana","2024-09-25",0,0,0,0,0,0,0,0
"Ghana","2024-09-26",0,0,0,0,0,0,0,0
"Ghana","2024-09-27",0,0,0,0,0,0,0,0
"Ghana","2024-09-28",0,0,0,0,0,0,0,0
"Ghana","2024-09-29",0,0,0,0,0,0,0,0
"Ghana","2024-09-30",0,0,0,0,0,0,0,0
"Ghana","2024-10-01",0,0,0,0,0,0,0,0
"Ghana","2024-10-02",0,0,0,0,0,0,0,0
"Ghana","2024-10-03",0,0,0,0,0,0,0,0
"Ghana","2024-10-04",0,0,0,0,0,0,0,0
"Ghana","2024-10-05",0,0,0,0,0,0,0,0
"Ghana","2024-10-06",0,1,1,0,1,1,0,0
"Ghana","2024-10-07",0,0,1,0,0,1,0,0
"Ghana","2024-10-08",0,0,1,0,0,1,0,0
"Ghana","2024-10-09",0,0,1,0,0,1,0,0
"Ghana","2024-10-10",0,0,1,0,1,2,0,0
"Ghana","2024-10-11",0,0,1,0,0,2,0,0
"Ghana","2024-10-12",0,1,2,0,0,2,0,0
"Ghana","2024-10-13",0,0,2,0,0,2,0,0
"Ghana","2024-10-14",0,0,2,0,0,2,0,0
"Ghana","2024-10-15",0,0,2,0,0,2,0,0
"Ghana","2024-10-16",0,0,2,0,0,2,0,0
"Ghana","2024-10-17",0,0,2,0,0,2,0,0
"Ghana","2024-10-18",0,0,2,0,0,2,0,0
"Ghana","2024-10-19",0,0,2,0,0,2,0,0
"Ghana","2024-10-20",0,0,2,0,0,2,0,0
"Ghana","2024-10-21",0,0,2,0,0,2,0,0
"Ghana","2024-10-22",0,0,2,0,0,2,0,0
"Ghana","2024-10-23",0,0,2,0,0,2,0,0
"Ghana","2024-10-24",0,0,2,0,0,2,0,0
"Ghana","2024-10-25",0,0,2,0,0,2,0,0
"Ghana","2024-10-26",0,0,2,0,0,2,0,0
"Ghana","2024-10-27",0,0,2,0,0,2,0,0
"Ghana","2024-10-28",0,0,2,0,0,2,0,0
"Ghana","2024-10-29",0,0,2,0,0,2,0,0
"Ghana","2024-10-30",0,0,2,0,0,2,0,0
"Ghana","2024-10-31",0,0,2,0,0,2,0,0
"Ghana","2024-11-01",0,0,2,0,0,2,0,0
"Ghana","2024-11-02",0,0,2,0,0,2,0,0
"Ghana","2024-11-03",0,0,2,0,0,2,0,0
"Ghana","2024-11-04",0,0,2,0,0,2,0,0
"Ghana","2024-11-05",0,0,2,0,0,2,0,0
"Ghana","2024-11-06",0,0,2,0,0,2,0,0
"Ghana","2024-11-07",0,0,2,0,0,2,0,0
"Ghana","2024-11-08",0,0,2,0,0,2,0,0
"Ghana","2024-11-09",0,0,2,0,0,2,0,0
"Ghana","2024-11-10",0,0,2,0,0,2,0,0
"Ghana","2024-11-11",0,0,2,0,0,2,0,0
"Ghana","2024-11-12",0,0,2,0,0,2,0,0
"Ghana","2024-11-13",0,0,2,0,0,2,0,0
"Ghana","2024-11-14",0,0,2,0,0,2,0,0
"Ghana","2024-11-15",0,0,2,0,0,2,0,0
"Ghana","2024-11-16",0,0,2,0,0,2,0,0
"Ghana","2024-11-17",0,0,2,0,0,2,0,0
"Ghana","2024-11-18",0,0,2,0,0,2,0,0
"Ghana","2024-11-19",0,0,2,0,0,2,0,0
"Ghana","2024-11-20",0,0,2,0,0,2,0,0
"Ghana","2024-11-21",0,0,2,0,0,2,0,0
"Ghana","2024-11-22",0,0,2,0,0,2,0,0
"Ghana","2024-11-23",0,0,2,0,0,2,0,0
"Ghana","2024-11-24",0,0,2,0,0,2,0,0
"Ghana","2024-11-25",0,0,2,0,0,2,0,0
"Ghana","2024-11-26",0,0,2,0,0,2,0,0
"Ghana","2024-11-27",0,0,2,0,0,2,0,0
"Ghana","2024-11-28",0,0,2,0,0,2,0,0
"Ghana","2024-11-29",0,0,2,0,0,2,0,0
"Ghana","2024-11-30",0,0,2,0,0,2,0,0
"Ghana","2024-12-01",0,0,2,0,0,2,0,0
"Ghana","2024-12-02",0,0,2,0,0,2,0,0
"Ghana","2024-12-03",0,0,2,0,0,2,0,0
"Ghana","2024-12-04",0,0,2,0,0,2,0,0
"Ghana","2024-12-05",0,0,2,0,0,2,0,0
"Ghana","2024-12-06",0,0,2,0,0,2,0,0
"Ghana","2024-12-07",0,0,2,0,0,2,0,0
"Ghana","2024-12-08",0,0,2,0,0,2,0,0
"Ghana","2024-12-09",0,0,2,0,0,2,0,0
"Gibraltar","2024-01-01",0,0,0,0,0,0,0,0
"Gibraltar","2024-01-02",0,0,0,0,0,0,0,0
"Gibraltar","2024-01-03",0,0,0,0,0,0,0,0
"Gibraltar","2024-01-04",0,0,0,0,0,0,0,0
"Gibraltar","2024-01-05",0,0,0,0,0,0,0,0
"Gibraltar","2024-01-06",0,0,0,0,0,0,0,0
"Gibraltar","2024-01-07",0,0,0,0,0,0,0,0
"Gibraltar","2024-01-08",0,0,0,0,0,0,0,0
"Gibraltar","2024-01-09",0,0,0,0,0,0,0,0
"Gibraltar","2024-01-10",0,0,0,0,0,0,0,0
"Gibraltar","2024-01-11",0,0,0,0,0,0,0,0
"Gibraltar","2024-01-12",0,0,0,0,0,0,0,0
"Gibraltar","2024-01-13",0,0,0,0,0,0,0,0
"Gibraltar","2024-01-14",0,0,0,0,0,0,0,0
"Gibraltar","2024-01-15",0,0,0,0,0,0,0,0
"Gibraltar","2024-01-16",0,0,0,0,0,0,0,0
"Gibraltar","2024-01-17",0,0,0,0,0,0,0,0
"Gibraltar","2024-01-18",0,0,0,0,0,0,0,0
"Gibraltar","2024-01-19",0,0,0,0,0,0,0,0
"Gibraltar","2024-01-20",0,0,0,0,0,0,0,0
"Gibraltar","2024-01-21",0,0,0,0,0,0,0,0
"Gibraltar","2024-01-22",0,0,0,0,0,0,0,0
"Gibraltar","2024-01-23",0,0,0,0,0,0,0,0
"Gibraltar","2024-01-24",0,0,0,0,0,0,0,0
"Gibraltar","2024-01-25",0,0,0,0,0,0,0,0
"Gibraltar","2024-01-26",0,0,0,0,0,0,0,0
"Gibraltar","2024-01-27",0,0,0,0,0,0,0,0
"Gibraltar","2024-01-28",0,0,0,0,0,0,0,0
"Gibraltar","2024-01-29",0,0,0,0,0,0,0,0
"Gibraltar","2024-01-30",0,0,0,0,0,0,0,0
"Gibraltar","2024-01-31",0,0,0,0,0,0,0,0
"Gibraltar","2024-02-01",0,0,0,0,0,0,0,0
"Gibraltar","2024-02-02",0,0,0,0,0,0,0,0
"Gibraltar","2024-02-03",0,0,0,0,0,0,0,0
"Gibraltar","2024-02-04",0,0,0,0,0,0,0,0
"Gibraltar","2024-02-05",0,0,0,0,0,0,0,0
"Gibraltar","2024-02-06",0,0,0,0,0,0,0,0
"Gibraltar","2024-02-07",0,0,0,0,0,0,0,0
"Gibraltar","2024-02-08",0,0,0,0,0,0,0,0
"Gibraltar","2024-02-09",0,0,0,0,0,0,0,0
"Gibraltar","2024-02-10",0,0,0,0,0,0,0,0
"Gibraltar","2024-02-11",0,0,0,0,0,0,0,0
"Gibraltar","2024-02-12",0,0,0,0,0,0,0,0
"Gibraltar","2024-02-13",0,0,0,0,0,0,0,0
"Gibraltar","2024-02-14",0,0,0,0,0,0,0,0
"Gibraltar","2024-02-15",0,0,0,0,0,0,0,0
"Gibraltar","2024-02-16",0,0,0,0,0,0,0,0
"Gibraltar","2024-02-17",0,0,0,0,0,0,0,0
"Gibraltar","2024-02-18",0,0,0,0,0,0,0,0
"Gibraltar","2024-02-19",0,0,0,0,0,0,0,0
"Gibraltar","2024-02-20",0,0,0,0,0,0,0,0
"Gibraltar","2024-02-21",0,0,0,0,0,0,0,0
"Gibraltar","2024-02-22",0,0,0,0,0,0,0,0
"Gibraltar","2024-02-23",0,0,0,0,0,0,0,0
"Gibraltar","2024-02-24",0,0,0,0,0,0,0,0
"Gibraltar","2024-02-25",0,0,0,0,0,0,0,0
"Gibraltar","2024-02-26",0,0,0,0,0,0,0,0
"Gibraltar","2024-02-27",0,0,0,0,0,0,0,0
"Gibraltar","2024-02-28",0,0,0,0,0,0,0,0
"Gibraltar","2024-02-29",0,0,0,0,0,0,0,0
"Gibraltar","2024-03-01",0,0,0,0,0,0,0,0
"Gibraltar","2024-03-02",0,0,0,0,0,0,0,0
"Gibraltar","2024-03-03",0,0,0,0,0,0,0,0
"Gibraltar","2024-03-04",0,0,0,0,0,0,0,0
"Gibraltar","2024-03-05",0,0,0,0,0,0,0,0
"Gibraltar","2024-03-06",0,0,0,0,0,0,0,0
"Gibraltar","2024-03-07",0,0,0,0,0,0,0,0
"Gibraltar","2024-03-08",0,0,0,0,0,0,0,0
"Gibraltar","2024-03-09",0,0,0,0,0,0,0,0
"Gibraltar","2024-03-10",0,0,0,0,0,0,0,0
"Gibraltar","2024-03-11",0,0,0,0,0,0,0,0
"Gibraltar","2024-03-12",0,0,0,0,0,0,0,0
"Gibraltar","2024-03-13",0,0,0,0,0,0,0,0
"Gibraltar","2024-03-14",0,0,0,0,0,0,0,0
"Gibraltar","2024-03-15",0,0,0,0,0,0,0,0
"Gibraltar","2024-03-16",0,0,0,0,0,0,0,0
"Gibraltar","2024-03-17",0,0,0,0,0,0,0,0
"Gibraltar","2024-03-18",0,0,0,0,0,0,0,0
"Gibraltar","2024-03-19",0,0,0,0,0,0,0,0
"Gibraltar","2024-03-20",0,0,0,0,0,0,0,0
"Gibraltar","2024-03-21",0,0,0,0,0,0,0,0
"Gibraltar","2024-03-22",0,0,0,0,0,0,0,0
"Gibraltar","2024-03-23",0,0,0,0,0,0,0,0
"Gibraltar","2024-03-24",0,0,0,0,0,0,0,0
"Gibraltar","2024-03-25",0,0,0,0,0,0,0,0
"Gibraltar","2024-03-26",0,0,0,0,0,0,0,0
"Gibraltar","2024-03-27",0,0,0,0,0,0,0,0
"Gibraltar","2024-03-28",0,0,0,0,0,0,0,0
"Gibraltar","2024-03-29",0,0,0,0,0,0,0,0
"Gibraltar","2024-03-30",0,0,0,0,0,0,0,0
"Gibraltar","2024-03-31",0,0,0,0,0,0,0,0
"Gibraltar","2024-04-01",0,0,0,0,0,0,0,0
"Gibraltar","2024-04-02",0,0,0,0,0,0,0,0
"Gibraltar","2024-04-03",0,0,0,0,0,0,0,0
"Gibraltar","2024-04-04",0,0,0,0,0,0,0,0
"Gibraltar","2024-04-05",0,0,0,0,0,0,0,0
"Gibraltar","2024-04-06",0,0,0,0,0,0,0,0
"Gibraltar","2024-04-07",0,0,0,0,0,0,0,0
"Gibraltar","2024-04-08",0,0,0,0,0,0,0,0
"Gibraltar","2024-04-09",0,0,0,0,0,0,0,0
"Gibraltar","2024-04-10",0,0,0,0,0,0,0,0
"Gibraltar","2024-04-11",0,0,0,0,0,0,0,0
"Gibraltar","2024-04-12",0,0,0,0,0,0,0,0
"Gibraltar","2024-04-13",0,0,0,0,0,0,0,0
"Gibraltar","2024-04-14",0,0,0,0,0,0,0,0
"Gibraltar","2024-04-15",0,0,0,0,0,0,0,0
"Gibraltar","2024-04-16",0,0,0,0,0,0,0,0
"Gibraltar","2024-04-17",0,0,0,0,0,0,0,0
"Gibraltar","2024-04-18",0,0,0,0,0,0,0,0
"Gibraltar","2024-04-19",0,0,0,0,0,0,0,0
"Gibraltar","2024-04-20",0,0,0,0,0,0,0,0
"Gibraltar","2024-04-21",0,0,0,0,0,0,0,0
"Gibraltar","2024-04-22",0,0,0,0,0,0,0,0
"Gibraltar","2024-04-23",0,0,0,0,0,0,0,0
"Gibraltar","2024-04-24",0,0,0,0,0,0,0,0
"Gibraltar","2024-04-25",0,0,0,0,0,0,0,0
"Gibraltar","2024-04-26",0,0,0,0,0,0,0,0
"Gibraltar","2024-04-27",0,0,0,0,0,0,0,0
"Gibraltar","2024-04-28",0,0,0,0,0,0,0,0
"Gibraltar","2024-04-29",0,0,0,0,0,0,0,0
"Gibraltar","2024-04-30",0,0,0,0,0,0,0,0
"Gibraltar","2024-05-01",0,0,0,0,0,0,0,0
"Gibraltar","2024-05-02",0,0,0,0,0,0,0,0
"Gibraltar","2024-05-03",0,0,0,0,0,0,0,0
"Gibraltar","2024-05-04",0,0,0,0,0,0,0,0
"Gibraltar","2024-05-05",0,0,0,0,0,0,0,0
"Gibraltar","2024-05-06",0,0,0,0,0,0,0,0
"Gibraltar","2024-05-07",0,0,0,0,0,0,0,0
"Gibraltar","2024-05-08",0,0,0,0,0,0,0,0
"Gibraltar","2024-05-09",0,0,0,0,0,0,0,0
"Gibraltar","2024-05-10",0,0,0,0,0,0,0,0
"Gibraltar","2024-05-11",0,0,0,0,0,0,0,0
"Gibraltar","2024-05-12",0,0,0,0,0,0,0,0
"Gibraltar","2024-05-13",0,0,0,0,0,0,0,0
"Gibraltar","2024-05-14",0,0,0,0,0,0,0,0
"Gibraltar","2024-05-15",0,0,0,0,0,0,0,0
"Gibraltar","2024-05-16",0,0,0,0,0,0,0,0
"Gibraltar","2024-05-17",0,0,0,0,0,0,0,0
"Gibraltar","2024-05-18",0,0,0,0,0,0,0,0
"Gibraltar","2024-05-19",0,0,0,0,0,0,0,0
"Gibraltar","2024-05-20",0,0,0,0,0,0,0,0
"Gibraltar","2024-05-21",0,0,0,0,0,0,0,0
"Gibraltar","2024-05-22",0,0,0,0,0,0,0,0
"Gibraltar","2024-05-23",0,0,0,0,0,0,0,0
"Gibraltar","2024-05-24",0,0,0,0,0,0,0,0
"Gibraltar","2024-05-25",0,0,0,0,0,0,0,0
"Gibraltar","2024-05-26",0,0,0,0,0,0,0,0
"Gibraltar","2024-05-27",0,0,0,0,0,0,0,0
"Gibraltar","2024-05-28",0,0,0,0,0,0,0,0
"Gibraltar","2024-05-29",0,0,0,0,0,0,0,0
"Gibraltar","2024-05-30",0,0,0,0,0,0,0,0
"Gibraltar","2024-05-31",0,0,0,0,0,0,0,0
"Gibraltar","2024-06-01",0,0,0,0,0,0,0,0
"Gibraltar","2024-06-02",0,0,0,0,0,0,0,0
"Gibraltar","2024-06-03",0,0,0,0,0,0,0,0
"Gibraltar","2024-06-04",0,0,0,0,0,0,0,0
"Gibraltar","2024-06-05",0,0,0,0,0,0,0,0
"Gibraltar","2024-06-06",0,0,0,0,0,0,0,0
"Gibraltar","2024-06-07",0,0,0,0,0,0,0,0
"Gibraltar","2024-06-08",0,0,0,0,0,0,0,0
"Gibraltar","2024-06-09",0,0,0,0,0,0,0,0
"Gibraltar","2024-06-10",0,0,0,0,0,0,0,0
"Gibraltar","2024-06-11",0,0,0,0,0,0,0,0
"Gibraltar","2024-06-12",0,0,0,0,0,0,0,0
"Gibraltar","2024-06-13",0,0,0,0,0,0,0,0
"Gibraltar","2024-06-14",0,0,0,0,0,0,0,0
"Gibraltar","2024-06-15",0,0,0,0,0,0,0,0
"Gibraltar","2024-06-16",0,0,0,0,0,0,0,0
"Gibraltar","2024-06-17",0,0,0,0,0,0,0,0
"Gibraltar","2024-06-18",0,0,0,0,0,0,0,0
"Gibraltar","2024-06-19",0,0,0,0,0,0,0,0
"Gibraltar","2024-06-20",0,0,0,0,0,0,0,0
"Gibraltar","2024-06-21",0,0,0,0,0,0,0,0
"Gibraltar","2024-06-22",0,0,0,0,0,0,0,0
"Gibraltar","2024-06-23",0,0,0,0,0,0,0,0
"Gibraltar","2024-06-24",0,0,0,0,0,0,0,0
"Gibraltar","2024-06-25",0,0,0,0,0,0,0,0
"Gibraltar","2024-06-26",0,0,0,0,0,0,0,0
"Gibraltar","2024-06-27",0,0,0,0,0,0,0,0
"Gibraltar","2024-06-28",0,0,0,0,0,0,0,0
"Gibraltar","2024-06-29",0,0,0,0,0,0,0,0
"Gibraltar","2024-06-30",0,0,0,0,0,0,0,0
"Gibraltar","2024-07-01",0,0,0,0,0,0,0,0
"Gibraltar","2024-07-02",0,0,0,0,0,0,0,0
"Gibraltar","2024-07-03",0,0,0,0,0,0,0,0
"Gibraltar","2024-07-04",0,0,0,0,0,0,0,0
"Gibraltar","2024-07-05",0,0,0,0,0,0,0,0
"Gibraltar","2024-07-06",0,0,0,0,0,0,0,0
"Gibraltar","2024-07-07",0,0,0,0,0,0,0,0
"Gibraltar","2024-07-08",0,0,0,0,0,0,0,0
"Gibraltar","2024-07-09",0,0,0,0,0,0,0,0
"Gibraltar","2024-07-10",0,0,0,0,0,0,0,0
"Gibraltar","2024-07-11",0,0,0,0,0,0,0,0
"Gibraltar","2024-07-12",0,0,0,0,0,0,0,0
"Gibraltar","2024-07-13",0,0,0,0,0,0,0,0
"Gibraltar","2024-07-14",0,0,0,0,0,0,0,0
"Gibraltar","2024-07-15",0,0,0,0,0,0,0,0
"Gibraltar","2024-07-16",0,0,0,0,0,0,0,0
"Gibraltar","2024-07-17",0,0,0,0,0,0,0,0
"Gibraltar","2024-07-18",0,0,0,0,0,0,0,0
"Gibraltar","2024-07-19",0,0,0,0,0,0,0,0
"Gibraltar","2024-07-20",0,0,0,0,0,0,0,0
"Gibraltar","2024-07-21",0,0,0,0,0,0,0,0
"Gibraltar","2024-07-22",0,0,0,0,0,0,0,0
"Gibraltar","2024-07-23",0,0,0,0,0,0,0,0
"Gibraltar","2024-07-24",0,0,0,0,0,0,0,0
"Gibraltar","2024-07-25",0,0,0,0,0,0,0,0
"Gibraltar","2024-07-26",0,0,0,0,0,0,0,0
"Gibraltar","2024-07-27",0,0,0,0,0,0,0,0
"Gibraltar","2024-07-28",0,0,0,0,0,0,0,0
"Gibraltar","2024-07-29",0,0,0,0,0,0,0,0
"Gibraltar","2024-07-30",0,0,0,0,0,0,0,0
"Gibraltar","2024-07-31",0,0,0,0,0,0,0,0
"Gibraltar","2024-08-01",0,0,0,0,0,0,0,0
"Gibraltar","2024-08-02",0,0,0,0,0,0,0,0
"Gibraltar","2024-08-03",0,0,0,0,0,0,0,0
"Gibraltar","2024-08-04",0,0,0,0,0,0,0,0
"Gibraltar","2024-08-05",0,0,0,0,0,0,0,0
"Gibraltar","2024-08-06",0,0,0,0,0,0,0,0
"Gibraltar","2024-08-07",0,0,0,0,0,0,0,0
"Gibraltar","2024-08-08",0,0,0,0,0,0,0,0
"Gibraltar","2024-08-09",0,0,0,0,0,0,0,0
"Gibraltar","2024-08-10",0,0,0,0,0,0,0,0
"Gibraltar","2024-08-11",0,0,0,0,0,0,0,0
"Gibraltar","2024-08-12",0,0,0,0,0,0,0,0
"Gibraltar","2024-08-13",0,0,0,0,0,0,0,0
"Gibraltar","2024-08-14",0,0,0,0,0,0,0,0
"Gibraltar","2024-08-15",0,0,0,0,0,0,0,0
"Gibraltar","2024-08-16",0,0,0,0,0,0,0,0
"Gibraltar","2024-08-17",0,0,0,0,0,0,0,0
"Gibraltar","2024-08-18",0,0,0,0,0,0,0,0
"Gibraltar","2024-08-19",0,0,0,0,0,0,0,0
"Gibraltar","2024-08-20",0,0,0,0,0,0,0,0
"Gibraltar","2024-08-21",0,0,0,0,0,0,0,0
"Gibraltar","2024-08-22",0,0,0,0,0,0,0,0
"Gibraltar","2024-08-23",0,0,0,0,0,0,0,0
"Gibraltar","2024-08-24",0,0,0,0,0,0,0,0
"Gibraltar","2024-08-25",0,0,0,0,0,0,0,0
"Gibraltar","2024-08-26",0,0,0,0,0,0,0,0
"Gibraltar","2024-08-27",0,0,0,0,0,0,0,0
"Gibraltar","2024-08-28",0,0,0,0,0,0,0,0
"Gibraltar","2024-08-29",0,0,0,0,0,0,0,0
"Gibraltar","2024-08-30",0,0,0,0,0,0,0,0
"Gibraltar","2024-08-31",0,0,0,0,0,0,0,0
"Gibraltar","2024-09-01",0,0,0,0,0,0,0,0
"Gibraltar","2024-09-02",0,0,0,0,0,0,0,0
"Gibraltar","2024-09-03",0,0,0,0,0,0,0,0
"Gibraltar","2024-09-04",0,0,0,0,0,0,0,0
"Gibraltar","2024-09-05",0,0,0,0,0,0,0,0
"Gibraltar","2024-09-06",0,0,0,0,0,0,0,0
"Gibraltar","2024-09-07",0,0,0,0,0,0,0,0
"Gibraltar","2024-09-08",0,0,0,0,0,0,0,0
"Gibraltar","2024-09-09",0,0,0,0,0,0,0,0
"Gibraltar","2024-09-10",0,0,0,0,0,0,0,0
"Gibraltar","2024-09-11",0,0,0,0,0,0,0,0
"Gibraltar","2024-09-12",0,0,0,0,0,0,0,0
"Gibraltar","2024-09-13",0,0,0,0,0,0,0,0
"Gibraltar","2024-09-14",0,0,0,0,0,0,0,0
"Gibraltar","2024-09-15",0,0,0,0,0,0,0,0
"Gibraltar","2024-09-16",0,0,0,0,0,0,0,0
"Gibraltar","2024-09-17",0,0,0,0,0,0,0,0
"Gibraltar","2024-09-18",0,0,0,0,0,0,0,0
"Gibraltar","2024-09-19",0,0,0,0,0,0,0,0
"Gibraltar","2024-09-20",0,0,0,0,0,0,0,0
"Gibraltar","2024-09-21",0,0,0,0,0,0,0,0
"Gibraltar","2024-09-22",0,0,0,0,0,0,0,0
"Gibraltar","2024-09-23",0,0,0,0,0,0,0,0
"Gibraltar","2024-09-24",0,0,0,0,0,0,0,0
"Gibraltar","2024-09-25",0,0,0,0,0,0,0,0
"Gibraltar","2024-09-26",0,0,0,0,0,0,0,0
"Gibraltar","2024-09-27",0,0,0,0,0,0,0,0
"Gibraltar","2024-09-28",0,0,0,0,0,0,0,0
"Gibraltar","2024-09-29",0,0,0,0,0,0,0,0
"Gibraltar","2024-09-30",0,0,0,0,0,0,0,0
"Gibraltar","2024-10-01",0,0,0,0,0,0,0,0
"Gibraltar","2024-10-02",0,0,0,0,0,0,0,0
"Gibraltar","2024-10-03",0,0,0,0,0,0,0,0
"Gibraltar","2024-10-04",0,0,0,0,0,0,0,0
"Gibraltar","2024-10-05",0,0,0,0,0,0,0,0
"Gibraltar","2024-10-06",0,0,0,0,0,0,0,0
"Gibraltar","2024-10-07",0,0,0,0,0,0,0,0
"Gibraltar","2024-10-08",0,0,0,0,0,0,0,0
"Gibraltar","2024-10-09",0,0,0,0,0,0,0,0
"Gibraltar","2024-10-10",0,0,0,0,0,0,0,0
"Gibraltar","2024-10-11",0,0,0,0,0,0,0,0
"Gibraltar","2024-10-12",0,0,0,0,0,0,0,0
"Gibraltar","2024-10-13",0,0,0,0,0,0,0,0
"Gibraltar","2024-10-14",0,0,0,0,0,0,0,0
"Gibraltar","2024-10-15",0,0,0,0,0,0,0,0
"Gibraltar","2024-10-16",0,0,0,0,0,0,0,0
"Gibraltar","2024-10-17",0,0,0,0,0,0,0,0
"Gibraltar","2024-10-18",0,0,0,0,0,0,0,0
"Gibraltar","2024-10-19",0,0,0,0,0,0,0,0
"Gibraltar","2024-10-20",0,0,0,0,0,0,0,0
"Gibraltar","2024-10-21",0,0,0,0,0,0,0,0
"Gibraltar","2024-10-22",0,0,0,0,0,0,0,0
"Gibraltar","2024-10-23",0,0,0,0,0,0,0,0
"Gibraltar","2024-10-24",0,0,0,0,0,0,0,0
"Gibraltar","2024-10-25",0,0,0,0,0,0,0,0
"Gibraltar","2024-10-26",0,0,0,0,0,0,0,0
"Gibraltar","2024-10-27",0,0,0,0,0,0,0,0
"Gibraltar","2024-10-28",0,0,0,0,0,0,0,0
"Gibraltar","2024-10-29",0,0,0,0,0,0,0,0
"Gibraltar","2024-10-30",0,0,0,0,0,0,0,0
"Gibraltar","2024-10-31",0,0,0,0,0,0,0,0
"Gibraltar","2024-11-01",0,0,0,0,0,0,0,0
"Gibraltar","2024-11-02",0,0,0,0,0,0,0,0
"Gibraltar","2024-11-03",0,0,0,0,0,0,0,0
"Gibraltar","2024-11-04",0,0,0,0,0,0,0,0
"Gibraltar","2024-11-05",0,0,0,0,0,0,0,0
"Gibraltar","2024-11-06",0,0,0,0,0,0,0,0
"Gibraltar","2024-11-07",0,0,0,0,0,0,0,0
"Gibraltar","2024-11-08",0,0,0,0,0,0,0,0
"Gibraltar","2024-11-09",0,0,0,0,0,0,0,0
"Gibraltar","2024-11-10",0,0,0,0,0,0,0,0
"Gibraltar","2024-11-11",0,0,0,0,0,0,0,0
"Gibraltar","2024-11-12",0,0,0,0,0,0,0,0
"Gibraltar","2024-11-13",0,0,0,0,0,0,0,0
"Gibraltar","2024-11-14",0,0,0,0,0,0,0,0
"Gibraltar","2024-11-15",0,0,0,0,0,0,0,0
"Gibraltar","2024-11-16",0,0,0,0,0,0,0,0
"Gibraltar","2024-11-17",0,0,0,0,0,0,0,0
"Gibraltar","2024-11-18",0,0,0,0,0,0,0,0
"Gibraltar","2024-11-19",0,0,0,0,0,0,0,0
"Gibraltar","2024-11-20",0,0,0,0,0,0,0,0
"Gibraltar","2024-11-21",0,0,0,0,0,0,0,0
"Gibraltar","2024-11-22",0,0,0,0,0,0,0,0
"Gibraltar","2024-11-23",0,0,0,0,0,0,0,0
"Gibraltar","2024-11-24",0,0,0,0,0,0,0,0
"Gibraltar","2024-11-25",0,0,0,0,0,0,0,0
"Gibraltar","2024-11-26",0,0,0,0,0,0,0,0
"Gibraltar","2024-11-27",0,0,0,0,0,0,0,0
"Gibraltar","2024-11-28",0,0,0,0,0,0,0,0
"Gibraltar","2024-11-29",0,0,0,0,0,0,0,0
"Gibraltar","2024-11-30",0,0,0,0,0,0,0,0
"Gibraltar","2024-12-01",0,0,0,0,0,0,0,0
"Gibraltar","2024-12-02",0,0,0,0,0,0,0,0
"Gibraltar","2024-12-03",0,0,0,0,0,0,0,0
"Gibraltar","2024-12-04",0,0,0,0,0,0,0,0
"Gibraltar","2024-12-05",0,0,0,0,0,0,0,0
"Gibraltar","2024-12-06",0,0,0,0,0,0,0,0
"Gibraltar","2024-12-07",0,0,0,0,0,0,0,0
"Gibraltar","2024-12-08",0,0,0,0,0,0,0,0
"Gibraltar","2024-12-09",0,0,0,0,0,0,0,0
"Greece","2024-01-01",0,0,0,0,0,0,0,0
"Greece","2024-01-02",0,0,0,0,0,0,0,0
"Greece","2024-01-03",0,0,0,0,0,0,0,0
"Greece","2024-01-04",0,0,0,0,0,0,0,0
"Greece","2024-01-05",0,0,0,0,0,0,0,0
"Greece","2024-01-06",0,0,0,0,0,0,0,0
"Greece","2024-01-07",0,0,0,0,0,0,0,0
"Greece","2024-01-08",0,0,0,0,0,0,0,0
"Greece","2024-01-09",0,0,0,0,0,0,0,0
"Greece","2024-01-10",0,0,0,0,0,0,0,0
"Greece","2024-01-11",0,0,0,0,0,0,0,0
"Greece","2024-01-12",0,0,0,0,0,0,0,0
"Greece","2024-01-13",0,0,0,0,0,0,0,0
"Greece","2024-01-14",0,0,0,0,0,0,0,0
"Greece","2024-01-15",0,0,0,0,0,0,0,0
"Greece","2024-01-16",0,0,0,0,0,0,0,0
"Greece","2024-01-17",0,0,0,0,0,0,0,0
"Greece","2024-01-18",0,0,0,0,0,0,0,0
"Greece","2024-01-19",0,0,0,0,0,0,0,0
"Greece","2024-01-20",0,0,0,0,0,0,0,0
"Greece","2024-01-21",0,0,0,0,0,0,0,0
"Greece","2024-01-22",0,0,0,0,0,0,0,0
"Greece","2024-01-23",0,0,0,0,0,0,0,0
"Greece","2024-01-24",0,0,0,0,0,0,0,0
"Greece","2024-01-25",0,0,0,0,0,0,0,0
"Greece","2024-01-26",0,0,0,0,0,0,0,0
"Greece","2024-01-27",0,0,0,0,0,0,0,0
"Greece","2024-01-28",0,0,0,0,0,0,0,0
"Greece","2024-01-29",0,0,0,0,0,0,0,0
"Greece","2024-01-30",0,0,0,0,0,0,0,0
"Greece","2024-01-31",0,2,2,0,2,2,0,0
"Greece","2024-02-01",0,0,2,0,0,2,0,0
"Greece","2024-02-02",0,0,2,0,0,2,0,0
"Greece","2024-02-03",0,0,2,0,0,2,0,0
"Greece","2024-02-04",0,0,2,0,0,2,0,0
"Greece","2024-02-05",0,0,2,0,0,2,0,0
"Greece","2024-02-06",0,0,2,0,0,2,0,0
"Greece","2024-02-07",0,0,2,0,0,2,0,0
"Greece","2024-02-08",0,0,2,0,0,2,0,0
"Greece","2024-02-09",0,0,2,0,0,2,0,0
"Greece","2024-02-10",0,0,2,0,0,2,0,0
"Greece","2024-02-11",0,0,2,0,0,2,0,0
"Greece","2024-02-12",0,0,2,0,0,2,0,0
"Greece","2024-02-13",0,0,2,0,0,2,0,0
"Greece","2024-02-14",0,0,2,0,0,2,0,0
"Greece","2024-02-15",0,0,2,0,0,2,0,0
"Greece","2024-02-16",0,0,2,0,0,2,0,0
"Greece","2024-02-17",0,0,2,0,0,2,0,0
"Greece","2024-02-18",0,0,2,0,0,2,0,0
"Greece","2024-02-19",0,0,2,0,0,2,0,0
"Greece","2024-02-20",0,0,2,0,0,2,0,0
"Greece","2024-02-21",0,0,2,0,0,2,0,0
"Greece","2024-02-22",0,0,2,0,0,2,0,0
"Greece","2024-02-23",0,0,2,0,0,2,0,0
"Greece","2024-02-24",0,0,2,0,0,2,0,0
"Greece","2024-02-25",0,0,2,0,0,2,0,0
"Greece","2024-02-26",0,0,2,0,0,2,0,0
"Greece","2024-02-27",0,0,2,0,0,2,0,0
"Greece","2024-02-28",0,0,2,0,0,2,0,0
"Greece","2024-02-29",0,0,2,0,0,2,0,0
"Greece","2024-03-01",0,0,2,0,0,2,0,0
"Greece","2024-03-02",0,0,2,0,1,3,0,0
"Greece","2024-03-03",0,0,2,0,0,3,0,0
"Greece","2024-03-04",0,0,2,0,0,3,0,0
"Greece","2024-03-05",0,0,2,0,0,3,0,0
"Greece","2024-03-06",0,0,2,0,0,3,0,0
"Greece","2024-03-07",0,0,2,0,0,3,0,0
"Greece","2024-03-08",0,0,2,0,0,3,0,0
"Greece","2024-03-09",0,0,2,0,0,3,0,0
"Greece","2024-03-10",0,0,2,0,0,3,0,0
"Greece","2024-03-11",0,0,2,0,0,3,0,0
"Greece","2024-03-12",0,0,2,0,0,3,0,0
"Greece","2024-03-13",0,0,2,0,0,3,0,0
"Greece","2024-03-14",0,0,2,0,0,3,0,0
"Greece","2024-03-15",0,0,2,0,0,3,0,0
"Greece","2024-03-16",0,0,2,0,0,3,0,0
"Greece","2024-03-17",0,0,2,0,0,3,0,0
"Greece","2024-03-18",0,0,2,0,0,3,0,0
"Greece","2024-03-19",0,0,2,0,0,3,0,0
"Greece","2024-03-20",0,0,2,0,0,3,0,0
"Greece","2024-03-21",0,0,2,0,0,3,0,0
"Greece","2024-03-22",0,0,2,0,0,3,0,0
"Greece","2024-03-23",0,0,2,0,0,3,0,0
"Greece","2024-03-24",0,0,2,0,0,3,0,0
"Greece","2024-03-25",0,0,2,0,0,3,0,0
"Greece","2024-03-26",0,0,2,0,0,3,0,0
"Greece","2024-03-27",0,0,2,0,0,3,0,0
"Greece","2024-03-28",0,0,2,0,0,3,0,0
"Greece","2024-03-29",0,0,2,0,0,3,0,0
"Greece","2024-03-30",0,0,2,0,0,3,0,0
"Greece","2024-03-31",0,1,3,0,0,3,0,0
"Greece","2024-04-01",0,0,3,0,0,3,0,0
"Greece","2024-04-02",0,0,3,0,0,3,0,0
"Greece","2024-04-03",0,0,3,0,1,4,0,0
"Greece","2024-04-04",0,0,3,0,0,4,0,0
"Greece","2024-04-05",0,0,3,0,0,4,0,0
"Greece","2024-04-06",0,0,3,0,0,4,0,0
"Greece","2024-04-07",0,0,3,0,0,4,0,0
"Greece","2024-04-08",0,0,3,0,1,5,0,0
"Greece","2024-04-09",0,0,3,0,0,5,0,0
"Greece","2024-04-10",0,0,3,0,0,5,0,0
"Greece","2024-04-11",0,0,3,0,0,5,0,0
"Greece","2024-04-12",0,0,3,0,0,5,0,0
"Greece","2024-04-13",0,0,3,0,1,6,0,0
"Greece","2024-04-14",0,0,3,0,0,6,0,0
"Greece","2024-04-15",0,0,3,0,0,6,0,0
"Greece","2024-04-16",0,0,3,0,0,6,0,0
"Greece","2024-04-17",0,0,3,0,0,6,0,0
"Greece","2024-04-18",0,0,3,0,1,7,0,0
"Greece","2024-04-19",0,0,3,0,0,7,0,0
"Greece","2024-04-20",0,0,3,0,0,7,0,0
"Greece","2024-04-21",0,0,3,0,0,7,0,0
"Greece","2024-04-22",0,0,3,0,0,7,0,0
"Greece","2024-04-23",0,0,3,0,1,8,0,0
"Greece","2024-04-24",0,0,3,0,0,8,0,0
"Greece","2024-04-25",0,0,3,0,0,8,0,0
"Greece","2024-04-26",0,0,3,0,0,8,0,0
"Greece","2024-04-27",0,0,3,0,0,8,0,0
"Greece","2024-04-28",0,0,3,0,1,9,0,0
"Greece","2024-04-29",0,0,3,0,0,9,0,0
"Greece","2024-04-30",0,6,9,0,0,9,0,0
"Greece","2024-05-01",0,0,9,0,0,9,0,0
"Greece","2024-05-02",0,0,9,0,0,9,0,0
"Greece","2024-05-03",0,0,9,0,0,9,0,0
"Greece","2024-05-04",0,0,9,0,0,9,0,0
"Greece","2024-05-05",0,0,9,0,0,9,0,0
"Greece","2024-05-06",0,0,9,0,0,9,0,0
"Greece","2024-05-07",0,0,9,0,0,9,0,0
"Greece","2024-05-08",0,0,9,0,0,9,0,0
"Greece","2024-05-09",0,0,9,0,0,9,0,0
"Greece","2024-05-10",0,0,9,0,0,9,0,0
"Greece","2024-05-11",0,0,9,0,0,9,0,0
"Greece","2024-05-12",0,0,9,0,0,9,0,0
"Greece","2024-05-13",0,0,9,0,0,9,0,0
"Greece","2024-05-14",0,0,9,0,0,9,0,0
"Greece","2024-05-15",0,0,9,0,0,9,0,0
"Greece","2024-05-16",0,0,9,0,1,10,0,0
"Greece","2024-05-17",0,0,9,0,0,10,0,0
"Greece","2024-05-18",0,0,9,0,0,10,0,0
"Greece","2024-05-19",0,0,9,0,0,10,0,0
"Greece","2024-05-20",0,0,9,0,0,10,0,0
"Greece","2024-05-21",0,0,9,0,0,10,0,0
"Greece","2024-05-22",0,0,9,0,0,10,0,0
"Greece","2024-05-23",0,0,9,0,0,10,0,0
"Greece","2024-05-24",0,0,9,0,0,10,0,0
"Greece","2024-05-25",0,0,9,0,0,10,0,0
"Greece","2024-05-26",0,0,9,0,0,10,0,0
"Greece","2024-05-27",0,0,9,0,0,10,0,0
"Greece","2024-05-28",0,0,9,0,0,10,0,0
"Greece","2024-05-29",0,0,9,0,0,10,0,0
"Greece","2024-05-30",0,0,9,0,0,10,0,0
"Greece","2024-05-31",0,1,10,0,0,10,0,0
"Greece","2024-06-01",0,0,10,0,0,10,0,0
"Greece","2024-06-02",0,0,10,0,0,10,0,0
"Greece","2024-06-03",0,0,10,0,0,10,0,0
"Greece","2024-06-04",0,0,10,0,0,10,0,0
"Greece","2024-06-05",0,0,10,0,0,10,0,0
"Greece","2024-06-06",0,0,10,0,0,10,0,0
"Greece","2024-06-07",0,0,10,0,0,10,0,0
"Greece","2024-06-08",0,0,10,0,0,10,0,0
"Greece","2024-06-09",0,0,10,0,0,10,0,0
"Greece","2024-06-10",0,0,10,0,0,10,0,0
"Greece","2024-06-11",0,0,10,0,0,10,0,0
"Greece","2024-06-12",0,0,10,0,0,10,0,0
"Greece","2024-06-13",0,0,10,0,0,10,0,0
"Greece","2024-06-14",0,0,10,0,0,10,0,0
"Greece","2024-06-15",0,0,10,0,0,10,0,0
"Greece","2024-06-16",0,0,10,0,0,10,0,0
"Greece","2024-06-17",0,0,10,0,0,10,0,0
"Greece","2024-06-18",0,0,10,0,0,10,0,0
"Greece","2024-06-19",0,0,10,0,0,10,0,0
"Greece","2024-06-20",0,0,10,0,0,10,0,0
"Greece","2024-06-21",0,0,10,0,1,11,0,0
"Greece","2024-06-22",0,0,10,0,0,11,0,0
"Greece","2024-06-23",0,0,10,0,0,11,0,0
"Greece","2024-06-24",0,0,10,0,0,11,0,0
"Greece","2024-06-25",0,0,10,0,0,11,0,0
"Greece","2024-06-26",0,0,10,0,0,11,0,0
"Greece","2024-06-27",0,0,10,0,0,11,0,0
"Greece","2024-06-28",0,0,10,0,0,11,0,0
"Greece","2024-06-29",0,0,10,0,0,11,0,0
"Greece","2024-06-30",0,0,10,0,0,11,0,0
"Greece","2024-07-01",0,0,10,0,0,11,0,0
"Greece","2024-07-02",0,0,10,0,0,11,0,0
"Greece","2024-07-03",0,0,10,0,0,11,0,0
"Greece","2024-07-04",0,0,10,0,0,11,0,0
"Greece","2024-07-05",0,0,10,0,0,11,0,0
"Greece","2024-07-06",0,0,10,0,0,11,0,0
"Greece","2024-07-07",0,0,10,0,0,11,0,0
"Greece","2024-07-08",0,0,10,0,0,11,0,0
"Greece","2024-07-09",0,0,10,0,0,11,0,0
"Greece","2024-07-10",0,0,10,0,0,11,0,0
"Greece","2024-07-11",0,0,10,0,0,11,0,0
"Greece","2024-07-12",0,0,10,0,0,11,0,0
"Greece","2024-07-13",0,0,10,0,0,11,0,0
"Greece","2024-07-14",0,0,10,0,0,11,0,0
"Greece","2024-07-15",0,0,10,0,0,11,0,0
"Greece","2024-07-16",0,0,10,0,0,11,0,0
"Greece","2024-07-17",0,0,10,0,0,11,0,0
"Greece","2024-07-18",0,0,10,0,0,11,0,0
"Greece","2024-07-19",0,0,10,0,0,11,0,0
"Greece","2024-07-20",0,0,10,0,0,11,0,0
"Greece","2024-07-21",0,0,10,0,0,11,0,0
"Greece","2024-07-22",0,0,10,0,0,11,0,0
"Greece","2024-07-23",0,0,10,0,0,11,0,0
"Greece","2024-07-24",0,0,10,0,0,11,0,0
"Greece","2024-07-25",0,0,10,0,0,11,0,0
"Greece","2024-07-26",0,0,10,0,0,11,0,0
"Greece","2024-07-27",0,0,10,0,0,11,0,0
"Greece","2024-07-28",0,0,10,0,0,11,0,0
"Greece","2024-07-29",0,0,10,0,0,11,0,0
"Greece","2024-07-30",0,0,10,0,0,11,0,0
"Greece","2024-07-31",0,0,10,0,1,12,0,0
"Greece","2024-08-01",0,0,10,0,0,12,0,0
"Greece","2024-08-02",0,0,10,0,0,12,0,0
"Greece","2024-08-03",0,0,10,0,0,12,0,0
"Greece","2024-08-04",0,0,10,0,0,12,0,0
"Greece","2024-08-05",0,0,10,0,0,12,0,0
"Greece","2024-08-06",0,0,10,0,0,12,0,0
"Greece","2024-08-07",0,0,10,0,0,12,0,0
"Greece","2024-08-08",0,0,10,0,0,12,0,0
"Greece","2024-08-09",0,0,10,0,0,12,0,0
"Greece","2024-08-10",0,0,10,0,0,12,0,0
"Greece","2024-08-11",0,0,10,0,0,12,0,0
"Greece","2024-08-12",0,0,10,0,0,12,0,0
"Greece","2024-08-13",0,0,10,0,0,12,0,0
"Greece","2024-08-14",0,0,10,0,0,12,0,0
"Greece","2024-08-15",0,0,10,0,0,12,0,0
"Greece","2024-08-16",0,0,10,0,0,12,0,0
"Greece","2024-08-17",0,0,10,0,0,12,0,0
"Greece","2024-08-18",0,0,10,0,0,12,0,0
"Greece","2024-08-19",0,0,10,0,0,12,0,0
"Greece","2024-08-20",0,0,10,0,0,12,0,0
"Greece","2024-08-21",0,0,10,0,0,12,0,0
"Greece","2024-08-22",0,0,10,0,0,12,0,0
"Greece","2024-08-23",0,0,10,0,0,12,0,0
"Greece","2024-08-24",0,0,10,0,0,12,0,0
"Greece","2024-08-25",0,0,10,0,0,12,0,0
"Greece","2024-08-26",0,0,10,0,0,12,0,0
"Greece","2024-08-27",0,0,10,0,0,12,0,0
"Greece","2024-08-28",0,0,10,0,0,12,0,0
"Greece","2024-08-29",0,0,10,0,0,12,0,0
"Greece","2024-08-30",0,0,10,0,0,12,0,0
"Greece","2024-08-31",0,0,10,0,0,12,0,0
"Greece","2024-09-01",0,0,10,0,0,12,0,0
"Greece","2024-09-02",0,0,10,0,0,12,0,0
"Greece","2024-09-03",0,0,10,0,0,12,0,0
"Greece","2024-09-04",0,0,10,0,0,12,0,0
"Greece","2024-09-05",0,0,10,0,0,12,0,0
"Greece","2024-09-06",0,0,10,0,0,12,0,0
"Greece","2024-09-07",0,0,10,0,0,12,0,0
"Greece","2024-09-08",0,0,10,0,0,12,0,0
"Greece","2024-09-09",0,0,10,0,0,12,0,0
"Greece","2024-09-10",0,0,10,0,1,13,0,0
"Greece","2024-09-11",0,0,10,0,0,13,0,0
"Greece","2024-09-12",0,0,10,0,0,13,0,0
"Greece","2024-09-13",0,0,10,0,0,13,0,0
"Greece","2024-09-14",0,0,10,0,0,13,0,0
"Greece","2024-09-15",0,0,10,0,0,13,0,0
"Greece","2024-09-16",0,0,10,0,0,13,0,0
"Greece","2024-09-17",0,0,10,0,0,13,0,0
"Greece","2024-09-18",0,0,10,0,0,13,0,0
"Greece","2024-09-19",0,0,10,0,0,13,0,0
"Greece","2024-09-20",0,0,10,0,0,13,0,0
"Greece","2024-09-21",0,0,10,0,0,13,0,0
"Greece","2024-09-22",0,0,10,0,0,13,0,0
"Greece","2024-09-23",0,0,10,0,0,13,0,0
"Greece","2024-09-24",0,0,10,0,0,13,0,0
"Greece","2024-09-25",0,0,10,0,0,13,0,0
"Greece","2024-09-26",0,0,10,0,0,13,0,0
"Greece","2024-09-27",0,0,10,0,0,13,0,0
"Greece","2024-09-28",0,0,10,0,0,13,0,0
"Greece","2024-09-29",0,0,10,0,0,13,0,0
"Greece","2024-09-30",0,3,13,0,0,13,0,0
"Greece","2024-10-01",0,0,13,0,0,13,0,0
"Greece","2024-10-02",0,0,13,0,0,13,0,0
"Greece","2024-10-03",0,0,13,0,0,13,0,0
"Greece","2024-10-04",0,0,13,0,0,13,0,0
"Greece","2024-10-05",0,0,13,0,0,13,0,0
"Greece","2024-10-06",0,0,13,0,0,13,0,0
"Greece","2024-10-07",0,0,13,0,0,13,0,0
"Greece","2024-10-08",0,0,13,0,0,13,0,0
"Greece","2024-10-09",0,0,13,0,0,13,0,0
"Greece","2024-10-10",0,0,13,0,0,13,0,0
"Greece","2024-10-11",0,0,13,0,0,13,0,0
"Greece","2024-10-12",0,0,13,0,0,13,0,0
"Greece","2024-10-13",0,0,13,0,0,13,0,0
"Greece","2024-10-14",0,0,13,0,0,13,0,0
"Greece","2024-10-15",0,0,13,0,0,13,0,0
"Greece","2024-10-16",0,0,13,0,0,13,0,0
"Greece","2024-10-17",0,0,13,0,0,13,0,0
"Greece","2024-10-18",0,0,13,0,0,13,0,0
"Greece","2024-10-19",0,0,13,0,0,13,0,0
"Greece","2024-10-20",0,0,13,0,0,13,0,0
"Greece","2024-10-21",0,0,13,0,0,13,0,0
"Greece","2024-10-22",0,0,13,0,0,13,0,0
"Greece","2024-10-23",0,0,13,0,0,13,0,0
"Greece","2024-10-24",0,0,13,0,0,13,0,0
"Greece","2024-10-25",0,0,13,0,0,13,0,0
"Greece","2024-10-26",0,0,13,0,0,13,0,0
"Greece","2024-10-27",0,0,13,0,0,13,0,0
"Greece","2024-10-28",0,0,13,0,0,13,0,0
"Greece","2024-10-29",0,0,13,0,0,13,0,0
"Greece","2024-10-30",0,0,13,0,0,13,0,0
"Greece","2024-10-31",0,0,13,0,0,13,0,0
"Greece","2024-11-01",0,0,13,0,0,13,0,0
"Greece","2024-11-02",0,0,13,0,0,13,0,0
"Greece","2024-11-03",0,0,13,0,0,13,0,0
"Greece","2024-11-04",0,0,13,0,0,13,0,0
"Greece","2024-11-05",0,0,13,0,0,13,0,0
"Greece","2024-11-06",0,0,13,0,0,13,0,0
"Greece","2024-11-07",0,0,13,0,0,13,0,0
"Greece","2024-11-08",0,0,13,0,0,13,0,0
"Greece","2024-11-09",0,0,13,0,0,13,0,0
"Greece","2024-11-10",0,0,13,0,0,13,0,0
"Greece","2024-11-11",0,0,13,0,0,13,0,0
"Greece","2024-11-12",0,0,13,0,0,13,0,0
"Greece","2024-11-13",0,0,13,0,0,13,0,0
"Greece","2024-11-14",0,0,13,0,0,13,0,0
"Greece","2024-11-15",0,0,13,0,0,13,0,0
"Greece","2024-11-16",0,0,13,0,0,13,0,0
"Greece","2024-11-17",0,0,13,0,0,13,0,0
"Greece","2024-11-18",0,0,13,0,0,13,0,0
"Greece","2024-11-19",0,0,13,0,0,13,0,0
"Greece","2024-11-20",0,0,13,0,0,13,0,0
"Greece","2024-11-21",0,0,13,0,0,13,0,0
"Greece","2024-11-22",0,0,13,0,0,13,0,0
"Greece","2024-11-23",0,0,13,0,0,13,0,0
"Greece","2024-11-24",0,0,13,0,0,13,0,0
"Greece","2024-11-25",0,0,13,0,0,13,0,0
"Greece","2024-11-26",0,0,13,0,0,13,0,0
"Greece","2024-11-27",0,0,13,0,0,13,0,0
"Greece","2024-11-28",0,0,13,0,0,13,0,0
"Greece","2024-11-29",0,0,13,0,0,13,0,0
"Greece","2024-11-30",0,0,13,0,0,13,0,0
"Greece","2024-12-01",0,0,13,0,0,13,0,0
"Greece","2024-12-02",0,0,13,0,0,13,0,0
"Greece","2024-12-03",0,0,13,0,0,13,0,0
"Greece","2024-12-04",0,0,13,0,0,13,0,0
"Greece","2024-12-05",0,0,13,0,0,13,0,0
"Greece","2024-12-06",0,0,13,0,0,13,0,0
"Greece","2024-12-07",0,0,13,0,0,13,0,0
"Greece","2024-12-08",0,0,13,0,0,13,0,0
"Greece","2024-12-09",0,0,13,0,0,13,0,0
"Greenland","2024-01-01",0,0,0,0,0,0,0,0
"Greenland","2024-01-02",0,0,0,0,0,0,0,0
"Greenland","2024-01-03",0,0,0,0,0,0,0,0
"Greenland","2024-01-04",0,0,0,0,0,0,0,0
"Greenland","2024-01-05",0,0,0,0,0,0,0,0
"Greenland","2024-01-06",0,0,0,0,0,0,0,0
"Greenland","2024-01-07",0,0,0,0,0,0,0,0
"Greenland","2024-01-08",0,0,0,0,0,0,0,0
"Greenland","2024-01-09",0,0,0,0,0,0,0,0
"Greenland","2024-01-10",0,0,0,0,0,0,0,0
"Greenland","2024-01-11",0,0,0,0,0,0,0,0
"Greenland","2024-01-12",0,0,0,0,0,0,0,0
"Greenland","2024-01-13",0,0,0,0,0,0,0,0
"Greenland","2024-01-14",0,0,0,0,0,0,0,0
"Greenland","2024-01-15",0,0,0,0,0,0,0,0
"Greenland","2024-01-16",0,0,0,0,0,0,0,0
"Greenland","2024-01-17",0,0,0,0,0,0,0,0
"Greenland","2024-01-18",0,0,0,0,0,0,0,0
"Greenland","2024-01-19",0,0,0,0,0,0,0,0
"Greenland","2024-01-20",0,0,0,0,0,0,0,0
"Greenland","2024-01-21",0,0,0,0,0,0,0,0
"Greenland","2024-01-22",0,0,0,0,0,0,0,0
"Greenland","2024-01-23",0,0,0,0,0,0,0,0
"Greenland","2024-01-24",0,0,0,0,0,0,0,0
"Greenland","2024-01-25",0,0,0,0,0,0,0,0
"Greenland","2024-01-26",0,0,0,0,0,0,0,0
"Greenland","2024-01-27",0,0,0,0,0,0,0,0
"Greenland","2024-01-28",0,0,0,0,0,0,0,0
"Greenland","2024-01-29",0,0,0,0,0,0,0,0
"Greenland","2024-01-30",0,0,0,0,0,0,0,0
"Greenland","2024-01-31",0,0,0,0,0,0,0,0
"Greenland","2024-02-01",0,0,0,0,0,0,0,0
"Greenland","2024-02-02",0,0,0,0,0,0,0,0
"Greenland","2024-02-03",0,0,0,0,0,0,0,0
"Greenland","2024-02-04",0,0,0,0,0,0,0,0
"Greenland","2024-02-05",0,0,0,0,0,0,0,0
"Greenland","2024-02-06",0,0,0,0,0,0,0,0
"Greenland","2024-02-07",0,0,0,0,0,0,0,0
"Greenland","2024-02-08",0,0,0,0,0,0,0,0
"Greenland","2024-02-09",0,0,0,0,0,0,0,0
"Greenland","2024-02-10",0,0,0,0,0,0,0,0
"Greenland","2024-02-11",0,0,0,0,0,0,0,0
"Greenland","2024-02-12",0,0,0,0,0,0,0,0
"Greenland","2024-02-13",0,0,0,0,0,0,0,0
"Greenland","2024-02-14",0,0,0,0,0,0,0,0
"Greenland","2024-02-15",0,0,0,0,0,0,0,0
"Greenland","2024-02-16",0,0,0,0,0,0,0,0
"Greenland","2024-02-17",0,0,0,0,0,0,0,0
"Greenland","2024-02-18",0,0,0,0,0,0,0,0
"Greenland","2024-02-19",0,0,0,0,0,0,0,0
"Greenland","2024-02-20",0,0,0,0,0,0,0,0
"Greenland","2024-02-21",0,0,0,0,0,0,0,0
"Greenland","2024-02-22",0,0,0,0,0,0,0,0
"Greenland","2024-02-23",0,0,0,0,0,0,0,0
"Greenland","2024-02-24",0,0,0,0,0,0,0,0
"Greenland","2024-02-25",0,0,0,0,0,0,0,0
"Greenland","2024-02-26",0,0,0,0,0,0,0,0
"Greenland","2024-02-27",0,0,0,0,0,0,0,0
"Greenland","2024-02-28",0,0,0,0,0,0,0,0
"Greenland","2024-02-29",0,0,0,0,0,0,0,0
"Greenland","2024-03-01",0,0,0,0,0,0,0,0
"Greenland","2024-03-02",0,0,0,0,0,0,0,0
"Greenland","2024-03-03",0,0,0,0,0,0,0,0
"Greenland","2024-03-04",0,0,0,0,0,0,0,0
"Greenland","2024-03-05",0,0,0,0,0,0,0,0
"Greenland","2024-03-06",0,0,0,0,0,0,0,0
"Greenland","2024-03-07",0,0,0,0,0,0,0,0
"Greenland","2024-03-08",0,0,0,0,0,0,0,0
"Greenland","2024-03-09",0,0,0,0,0,0,0,0
"Greenland","2024-03-10",0,0,0,0,0,0,0,0
"Greenland","2024-03-11",0,0,0,0,0,0,0,0
"Greenland","2024-03-12",0,0,0,0,0,0,0,0
"Greenland","2024-03-13",0,0,0,0,0,0,0,0
"Greenland","2024-03-14",0,0,0,0,0,0,0,0
"Greenland","2024-03-15",0,0,0,0,0,0,0,0
"Greenland","2024-03-16",0,0,0,0,0,0,0,0
"Greenland","2024-03-17",0,0,0,0,0,0,0,0
"Greenland","2024-03-18",0,0,0,0,0,0,0,0
"Greenland","2024-03-19",0,0,0,0,0,0,0,0
"Greenland","2024-03-20",0,0,0,0,0,0,0,0
"Greenland","2024-03-21",0,0,0,0,0,0,0,0
"Greenland","2024-03-22",0,0,0,0,0,0,0,0
"Greenland","2024-03-23",0,0,0,0,0,0,0,0
"Greenland","2024-03-24",0,0,0,0,0,0,0,0
"Greenland","2024-03-25",0,0,0,0,0,0,0,0
"Greenland","2024-03-26",0,0,0,0,0,0,0,0
"Greenland","2024-03-27",0,0,0,0,0,0,0,0
"Greenland","2024-03-28",0,0,0,0,0,0,0,0
"Greenland","2024-03-29",0,0,0,0,0,0,0,0
"Greenland","2024-03-30",0,0,0,0,0,0,0,0
"Greenland","2024-03-31",0,0,0,0,0,0,0,0
"Greenland","2024-04-01",0,0,0,0,0,0,0,0
"Greenland","2024-04-02",0,0,0,0,0,0,0,0
"Greenland","2024-04-03",0,0,0,0,0,0,0,0
"Greenland","2024-04-04",0,0,0,0,0,0,0,0
"Greenland","2024-04-05",0,0,0,0,0,0,0,0
"Greenland","2024-04-06",0,0,0,0,0,0,0,0
"Greenland","2024-04-07",0,0,0,0,0,0,0,0
"Greenland","2024-04-08",0,0,0,0,0,0,0,0
"Greenland","2024-04-09",0,0,0,0,0,0,0,0
"Greenland","2024-04-10",0,0,0,0,0,0,0,0
"Greenland","2024-04-11",0,0,0,0,0,0,0,0
"Greenland","2024-04-12",0,0,0,0,0,0,0,0
"Greenland","2024-04-13",0,0,0,0,0,0,0,0
"Greenland","2024-04-14",0,0,0,0,0,0,0,0
"Greenland","2024-04-15",0,0,0,0,0,0,0,0
"Greenland","2024-04-16",0,0,0,0,0,0,0,0
"Greenland","2024-04-17",0,0,0,0,0,0,0,0
"Greenland","2024-04-18",0,0,0,0,0,0,0,0
"Greenland","2024-04-19",0,0,0,0,0,0,0,0
"Greenland","2024-04-20",0,0,0,0,0,0,0,0
"Greenland","2024-04-21",0,0,0,0,0,0,0,0
"Greenland","2024-04-22",0,0,0,0,0,0,0,0
"Greenland","2024-04-23",0,0,0,0,0,0,0,0
"Greenland","2024-04-24",0,0,0,0,0,0,0,0
"Greenland","2024-04-25",0,0,0,0,0,0,0,0
"Greenland","2024-04-26",0,0,0,0,0,0,0,0
"Greenland","2024-04-27",0,0,0,0,0,0,0,0
"Greenland","2024-04-28",0,0,0,0,0,0,0,0
"Greenland","2024-04-29",0,0,0,0,0,0,0,0
"Greenland","2024-04-30",0,0,0,0,0,0,0,0
"Greenland","2024-05-01",0,0,0,0,0,0,0,0
"Greenland","2024-05-02",0,0,0,0,0,0,0,0
"Greenland","2024-05-03",0,0,0,0,0,0,0,0
"Greenland","2024-05-04",0,0,0,0,0,0,0,0
"Greenland","2024-05-05",0,0,0,0,0,0,0,0
"Greenland","2024-05-06",0,0,0,0,0,0,0,0
"Greenland","2024-05-07",0,0,0,0,0,0,0,0
"Greenland","2024-05-08",0,0,0,0,0,0,0,0
"Greenland","2024-05-09",0,0,0,0,0,0,0,0
"Greenland","2024-05-10",0,0,0,0,0,0,0,0
"Greenland","2024-05-11",0,0,0,0,0,0,0,0
"Greenland","2024-05-12",0,0,0,0,0,0,0,0
"Greenland","2024-05-13",0,0,0,0,0,0,0,0
"Greenland","2024-05-14",0,0,0,0,0,0,0,0
"Greenland","2024-05-15",0,0,0,0,0,0,0,0
"Greenland","2024-05-16",0,0,0,0,0,0,0,0
"Greenland","2024-05-17",0,0,0,0,0,0,0,0
"Greenland","2024-05-18",0,0,0,0,0,0,0,0
"Greenland","2024-05-19",0,0,0,0,0,0,0,0
"Greenland","2024-05-20",0,0,0,0,0,0,0,0
"Greenland","2024-05-21",0,0,0,0,0,0,0,0
"Greenland","2024-05-22",0,0,0,0,0,0,0,0
"Greenland","2024-05-23",0,0,0,0,0,0,0,0
"Greenland","2024-05-24",0,0,0,0,0,0,0,0
"Greenland","2024-05-25",0,0,0,0,0,0,0,0
"Greenland","2024-05-26",0,0,0,0,0,0,0,0
"Greenland","2024-05-27",0,0,0,0,0,0,0,0
"Greenland","2024-05-28",0,0,0,0,0,0,0,0
"Greenland","2024-05-29",0,0,0,0,0,0,0,0
"Greenland","2024-05-30",0,0,0,0,0,0,0,0
"Greenland","2024-05-31",0,0,0,0,0,0,0,0
"Greenland","2024-06-01",0,0,0,0,0,0,0,0
"Greenland","2024-06-02",0,0,0,0,0,0,0,0
"Greenland","2024-06-03",0,0,0,0,0,0,0,0
"Greenland","2024-06-04",0,0,0,0,0,0,0,0
"Greenland","2024-06-05",0,0,0,0,0,0,0,0
"Greenland","2024-06-06",0,0,0,0,0,0,0,0
"Greenland","2024-06-07",0,0,0,0,0,0,0,0
"Greenland","2024-06-08",0,0,0,0,0,0,0,0
"Greenland","2024-06-09",0,0,0,0,0,0,0,0
"Greenland","2024-06-10",0,0,0,0,0,0,0,0
"Greenland","2024-06-11",0,0,0,0,0,0,0,0
"Greenland","2024-06-12",0,0,0,0,0,0,0,0
"Greenland","2024-06-13",0,0,0,0,0,0,0,0
"Greenland","2024-06-14",0,0,0,0,0,0,0,0
"Greenland","2024-06-15",0,0,0,0,0,0,0,0
"Greenland","2024-06-16",0,0,0,0,0,0,0,0
"Greenland","2024-06-17",0,0,0,0,0,0,0,0
"Greenland","2024-06-18",0,0,0,0,0,0,0,0
"Greenland","2024-06-19",0,0,0,0,0,0,0,0
"Greenland","2024-06-20",0,0,0,0,0,0,0,0
"Greenland","2024-06-21",0,0,0,0,0,0,0,0
"Greenland","2024-06-22",0,0,0,0,0,0,0,0
"Greenland","2024-06-23",0,0,0,0,0,0,0,0
"Greenland","2024-06-24",0,0,0,0,0,0,0,0
"Greenland","2024-06-25",0,0,0,0,0,0,0,0
"Greenland","2024-06-26",0,0,0,0,0,0,0,0
"Greenland","2024-06-27",0,0,0,0,0,0,0,0
"Greenland","2024-06-28",0,0,0,0,0,0,0,0
"Greenland","2024-06-29",0,0,0,0,0,0,0,0
"Greenland","2024-06-30",0,0,0,0,0,0,0,0
"Greenland","2024-07-01",0,0,0,0,0,0,0,0
"Greenland","2024-07-02",0,0,0,0,0,0,0,0
"Greenland","2024-07-03",0,0,0,0,0,0,0,0
"Greenland","2024-07-04",0,0,0,0,0,0,0,0
"Greenland","2024-07-05",0,0,0,0,0,0,0,0
"Greenland","2024-07-06",0,0,0,0,0,0,0,0
"Greenland","2024-07-07",0,0,0,0,0,0,0,0
"Greenland","2024-07-08",0,0,0,0,0,0,0,0
"Greenland","2024-07-09",0,0,0,0,0,0,0,0
"Greenland","2024-07-10",0,0,0,0,0,0,0,0
"Greenland","2024-07-11",0,0,0,0,0,0,0,0
"Greenland","2024-07-12",0,0,0,0,0,0,0,0
"Greenland","2024-07-13",0,0,0,0,0,0,0,0
"Greenland","2024-07-14",0,0,0,0,0,0,0,0
"Greenland","2024-07-15",0,0,0,0,0,0,0,0
"Greenland","2024-07-16",0,0,0,0,0,0,0,0
"Greenland","2024-07-17",0,0,0,0,0,0,0,0
"Greenland","2024-07-18",0,0,0,0,0,0,0,0
"Greenland","2024-07-19",0,0,0,0,0,0,0,0
"Greenland","2024-07-20",0,0,0,0,0,0,0,0
"Greenland","2024-07-21",0,0,0,0,0,0,0,0
"Greenland","2024-07-22",0,0,0,0,0,0,0,0
"Greenland","2024-07-23",0,0,0,0,0,0,0,0
"Greenland","2024-07-24",0,0,0,0,0,0,0,0
"Greenland","2024-07-25",0,0,0,0,0,0,0,0
"Greenland","2024-07-26",0,0,0,0,0,0,0,0
"Greenland","2024-07-27",0,0,0,0,0,0,0,0
"Greenland","2024-07-28",0,0,0,0,0,0,0,0
"Greenland","2024-07-29",0,0,0,0,0,0,0,0
"Greenland","2024-07-30",0,0,0,0,0,0,0,0
"Greenland","2024-07-31",0,0,0,0,0,0,0,0
"Greenland","2024-08-01",0,0,0,0,0,0,0,0
"Greenland","2024-08-02",0,0,0,0,0,0,0,0
"Greenland","2024-08-03",0,0,0,0,0,0,0,0
"Greenland","2024-08-04",0,0,0,0,0,0,0,0
"Greenland","2024-08-05",0,0,0,0,0,0,0,0
"Greenland","2024-08-06",0,0,0,0,0,0,0,0
"Greenland","2024-08-07",0,0,0,0,0,0,0,0
"Greenland","2024-08-08",0,0,0,0,0,0,0,0
"Greenland","2024-08-09",0,0,0,0,0,0,0,0
"Greenland","2024-08-10",0,0,0,0,0,0,0,0
"Greenland","2024-08-11",0,0,0,0,0,0,0,0
"Greenland","2024-08-12",0,0,0,0,0,0,0,0
"Greenland","2024-08-13",0,0,0,0,0,0,0,0
"Greenland","2024-08-14",0,0,0,0,0,0,0,0
"Greenland","2024-08-15",0,0,0,0,0,0,0,0
"Greenland","2024-08-16",0,0,0,0,0,0,0,0
"Greenland","2024-08-17",0,0,0,0,0,0,0,0
"Greenland","2024-08-18",0,0,0,0,0,0,0,0
"Greenland","2024-08-19",0,0,0,0,0,0,0,0
"Greenland","2024-08-20",0,0,0,0,0,0,0,0
"Greenland","2024-08-21",0,0,0,0,0,0,0,0
"Greenland","2024-08-22",0,0,0,0,0,0,0,0
"Greenland","2024-08-23",0,0,0,0,0,0,0,0
"Greenland","2024-08-24",0,0,0,0,0,0,0,0
"Greenland","2024-08-25",0,0,0,0,0,0,0,0
"Greenland","2024-08-26",0,0,0,0,0,0,0,0
"Greenland","2024-08-27",0,0,0,0,0,0,0,0
"Greenland","2024-08-28",0,0,0,0,0,0,0,0
"Greenland","2024-08-29",0,0,0,0,0,0,0,0
"Greenland","2024-08-30",0,0,0,0,0,0,0,0
"Greenland","2024-08-31",0,0,0,0,0,0,0,0
"Greenland","2024-09-01",0,0,0,0,0,0,0,0
"Greenland","2024-09-02",0,0,0,0,0,0,0,0
"Greenland","2024-09-03",0,0,0,0,0,0,0,0
"Greenland","2024-09-04",0,0,0,0,0,0,0,0
"Greenland","2024-09-05",0,0,0,0,0,0,0,0
"Greenland","2024-09-06",0,0,0,0,0,0,0,0
"Greenland","2024-09-07",0,0,0,0,0,0,0,0
"Greenland","2024-09-08",0,0,0,0,0,0,0,0
"Greenland","2024-09-09",0,0,0,0,0,0,0,0
"Greenland","2024-09-10",0,0,0,0,0,0,0,0
"Greenland","2024-09-11",0,0,0,0,0,0,0,0
"Greenland","2024-09-12",0,0,0,0,0,0,0,0
"Greenland","2024-09-13",0,0,0,0,0,0,0,0
"Greenland","2024-09-14",0,0,0,0,0,0,0,0
"Greenland","2024-09-15",0,0,0,0,0,0,0,0
"Greenland","2024-09-16",0,0,0,0,0,0,0,0
"Greenland","2024-09-17",0,0,0,0,0,0,0,0
"Greenland","2024-09-18",0,0,0,0,0,0,0,0
"Greenland","2024-09-19",0,0,0,0,0,0,0,0
"Greenland","2024-09-20",0,0,0,0,0,0,0,0
"Greenland","2024-09-21",0,0,0,0,0,0,0,0
"Greenland","2024-09-22",0,0,0,0,0,0,0,0
"Greenland","2024-09-23",0,0,0,0,0,0,0,0
"Greenland","2024-09-24",0,0,0,0,0,0,0,0
"Greenland","2024-09-25",0,0,0,0,0,0,0,0
"Greenland","2024-09-26",0,0,0,0,0,0,0,0
"Greenland","2024-09-27",0,0,0,0,0,0,0,0
"Greenland","2024-09-28",0,0,0,0,0,0,0,0
"Greenland","2024-09-29",0,0,0,0,0,0,0,0
"Greenland","2024-09-30",0,0,0,0,0,0,0,0
"Greenland","2024-10-01",0,0,0,0,0,0,0,0
"Greenland","2024-10-02",0,0,0,0,0,0,0,0
"Greenland","2024-10-03",0,0,0,0,0,0,0,0
"Greenland","2024-10-04",0,0,0,0,0,0,0,0
"Greenland","2024-10-05",0,0,0,0,0,0,0,0
"Greenland","2024-10-06",0,0,0,0,0,0,0,0
"Greenland","2024-10-07",0,0,0,0,0,0,0,0
"Greenland","2024-10-08",0,0,0,0,0,0,0,0
"Greenland","2024-10-09",0,0,0,0,0,0,0,0
"Greenland","2024-10-10",0,0,0,0,0,0,0,0
"Greenland","2024-10-11",0,0,0,0,0,0,0,0
"Greenland","2024-10-12",0,0,0,0,0,0,0,0
"Greenland","2024-10-13",0,0,0,0,0,0,0,0
"Greenland","2024-10-14",0,0,0,0,0,0,0,0
"Greenland","2024-10-15",0,0,0,0,0,0,0,0
"Greenland","2024-10-16",0,0,0,0,0,0,0,0
"Greenland","2024-10-17",0,0,0,0,0,0,0,0
"Greenland","2024-10-18",0,0,0,0,0,0,0,0
"Greenland","2024-10-19",0,0,0,0,0,0,0,0
"Greenland","2024-10-20",0,0,0,0,0,0,0,0
"Greenland","2024-10-21",0,0,0,0,0,0,0,0
"Greenland","2024-10-22",0,0,0,0,0,0,0,0
"Greenland","2024-10-23",0,0,0,0,0,0,0,0
"Greenland","2024-10-24",0,0,0,0,0,0,0,0
"Greenland","2024-10-25",0,0,0,0,0,0,0,0
"Greenland","2024-10-26",0,0,0,0,0,0,0,0
"Greenland","2024-10-27",0,0,0,0,0,0,0,0
"Greenland","2024-10-28",0,0,0,0,0,0,0,0
"Greenland","2024-10-29",0,0,0,0,0,0,0,0
"Greenland","2024-10-30",0,0,0,0,0,0,0,0
"Greenland","2024-10-31",0,0,0,0,0,0,0,0
"Greenland","2024-11-01",0,0,0,0,0,0,0,0
"Greenland","2024-11-02",0,0,0,0,0,0,0,0
"Greenland","2024-11-03",0,0,0,0,0,0,0,0
"Greenland","2024-11-04",0,0,0,0,0,0,0,0
"Greenland","2024-11-05",0,0,0,0,0,0,0,0
"Greenland","2024-11-06",0,0,0,0,0,0,0,0
"Greenland","2024-11-07",0,0,0,0,0,0,0,0
"Greenland","2024-11-08",0,0,0,0,0,0,0,0
"Greenland","2024-11-09",0,0,0,0,0,0,0,0
"Greenland","2024-11-10",0,0,0,0,0,0,0,0
"Greenland","2024-11-11",0,0,0,0,0,0,0,0
"Greenland","2024-11-12",0,0,0,0,0,0,0,0
"Greenland","2024-11-13",0,0,0,0,0,0,0,0
"Greenland","2024-11-14",0,0,0,0,0,0,0,0
"Greenland","2024-11-15",0,0,0,0,0,0,0,0
"Greenland","2024-11-16",0,0,0,0,0,0,0,0
"Greenland","2024-11-17",0,0,0,0,0,0,0,0
"Greenland","2024-11-18",0,0,0,0,0,0,0,0
"Greenland","2024-11-19",0,0,0,0,0,0,0,0
"Greenland","2024-11-20",0,0,0,0,0,0,0,0
"Greenland","2024-11-21",0,0,0,0,0,0,0,0
"Greenland","2024-11-22",0,0,0,0,0,0,0,0
"Greenland","2024-11-23",0,0,0,0,0,0,0,0
"Greenland","2024-11-24",0,0,0,0,0,0,0,0
"Greenland","2024-11-25",0,0,0,0,0,0,0,0
"Greenland","2024-11-26",0,0,0,0,0,0,0,0
"Greenland","2024-11-27",0,0,0,0,0,0,0,0
"Greenland","2024-11-28",0,0,0,0,0,0,0,0
"Greenland","2024-11-29",0,0,0,0,0,0,0,0
"Greenland","2024-11-30",0,0,0,0,0,0,0,0
"Greenland","2024-12-01",0,0,0,0,0,0,0,0
"Greenland","2024-12-02",0,0,0,0,0,0,0,0
"Greenland","2024-12-03",0,0,0,0,0,0,0,0
"Greenland","2024-12-04",0,0,0,0,0,0,0,0
"Greenland","2024-12-05",0,0,0,0,0,0,0,0
"Greenland","2024-12-06",0,0,0,0,0,0,0,0
"Greenland","2024-12-07",0,0,0,0,0,0,0,0
"Greenland","2024-12-08",0,0,0,0,0,0,0,0
"Greenland","2024-12-09",0,0,0,0,0,0,0,0
"Guadeloupe","2024-01-01",0,0,0,0,0,0,0,0
"Guadeloupe","2024-01-02",0,0,0,0,0,0,0,0
"Guadeloupe","2024-01-03",0,0,0,0,0,0,0,0
"Guadeloupe","2024-01-04",0,0,0,0,0,0,0,0
"Guadeloupe","2024-01-05",0,0,0,0,0,0,0,0
"Guadeloupe","2024-01-06",0,0,0,0,0,0,0,0
"Guadeloupe","2024-01-07",0,0,0,0,0,0,0,0
"Guadeloupe","2024-01-08",0,0,0,0,0,0,0,0
"Guadeloupe","2024-01-09",0,0,0,0,0,0,0,0
"Guadeloupe","2024-01-10",0,0,0,0,0,0,0,0
"Guadeloupe","2024-01-11",0,0,0,0,0,0,0,0
"Guadeloupe","2024-01-12",0,0,0,0,0,0,0,0
"Guadeloupe","2024-01-13",0,0,0,0,0,0,0,0
"Guadeloupe","2024-01-14",0,0,0,0,0,0,0,0
"Guadeloupe","2024-01-15",0,0,0,0,0,0,0,0
"Guadeloupe","2024-01-16",0,0,0,0,0,0,0,0
"Guadeloupe","2024-01-17",0,0,0,0,0,0,0,0
"Guadeloupe","2024-01-18",0,0,0,0,0,0,0,0
"Guadeloupe","2024-01-19",0,0,0,0,0,0,0,0
"Guadeloupe","2024-01-20",0,0,0,0,0,0,0,0
"Guadeloupe","2024-01-21",0,0,0,0,0,0,0,0
"Guadeloupe","2024-01-22",0,0,0,0,0,0,0,0
"Guadeloupe","2024-01-23",0,0,0,0,0,0,0,0
"Guadeloupe","2024-01-24",0,0,0,0,0,0,0,0
"Guadeloupe","2024-01-25",0,0,0,0,0,0,0,0
"Guadeloupe","2024-01-26",0,0,0,0,0,0,0,0
"Guadeloupe","2024-01-27",0,0,0,0,0,0,0,0
"Guadeloupe","2024-01-28",0,0,0,0,0,0,0,0
"Guadeloupe","2024-01-29",0,0,0,0,0,0,0,0
"Guadeloupe","2024-01-30",0,0,0,0,0,0,0,0
"Guadeloupe","2024-01-31",0,0,0,0,0,0,0,0
"Guadeloupe","2024-02-01",0,0,0,0,0,0,0,0
"Guadeloupe","2024-02-02",0,0,0,0,0,0,0,0
"Guadeloupe","2024-02-03",0,0,0,0,0,0,0,0
"Guadeloupe","2024-02-04",0,0,0,0,0,0,0,0
"Guadeloupe","2024-02-05",0,0,0,0,0,0,0,0
"Guadeloupe","2024-02-06",0,0,0,0,0,0,0,0
"Guadeloupe","2024-02-07",0,0,0,0,0,0,0,0
"Guadeloupe","2024-02-08",0,0,0,0,0,0,0,0
"Guadeloupe","2024-02-09",0,0,0,0,0,0,0,0
"Guadeloupe","2024-02-10",0,0,0,0,0,0,0,0
"Guadeloupe","2024-02-11",0,0,0,0,0,0,0,0
"Guadeloupe","2024-02-12",0,0,0,0,0,0,0,0
"Guadeloupe","2024-02-13",0,0,0,0,0,0,0,0
"Guadeloupe","2024-02-14",0,0,0,0,0,0,0,0
"Guadeloupe","2024-02-15",0,0,0,0,0,0,0,0
"Guadeloupe","2024-02-16",0,0,0,0,0,0,0,0
"Guadeloupe","2024-02-17",0,0,0,0,0,0,0,0
"Guadeloupe","2024-02-18",0,0,0,0,0,0,0,0
"Guadeloupe","2024-02-19",0,0,0,0,0,0,0,0
"Guadeloupe","2024-02-20",0,0,0,0,0,0,0,0
"Guadeloupe","2024-02-21",0,0,0,0,0,0,0,0
"Guadeloupe","2024-02-22",0,0,0,0,0,0,0,0
"Guadeloupe","2024-02-23",0,0,0,0,0,0,0,0
"Guadeloupe","2024-02-24",0,0,0,0,0,0,0,0
"Guadeloupe","2024-02-25",0,0,0,0,0,0,0,0
"Guadeloupe","2024-02-26",0,0,0,0,0,0,0,0
"Guadeloupe","2024-02-27",0,0,0,0,0,0,0,0
"Guadeloupe","2024-02-28",0,0,0,0,0,0,0,0
"Guadeloupe","2024-02-29",0,0,0,0,0,0,0,0
"Guadeloupe","2024-03-01",0,0,0,0,0,0,0,0
"Guadeloupe","2024-03-02",0,0,0,0,0,0,0,0
"Guadeloupe","2024-03-03",0,0,0,0,0,0,0,0
"Guadeloupe","2024-03-04",0,0,0,0,0,0,0,0
"Guadeloupe","2024-03-05",0,0,0,0,0,0,0,0
"Guadeloupe","2024-03-06",0,0,0,0,0,0,0,0
"Guadeloupe","2024-03-07",0,0,0,0,0,0,0,0
"Guadeloupe","2024-03-08",0,0,0,0,0,0,0,0
"Guadeloupe","2024-03-09",0,0,0,0,0,0,0,0
"Guadeloupe","2024-03-10",0,0,0,0,0,0,0,0
"Guadeloupe","2024-03-11",0,0,0,0,0,0,0,0
"Guadeloupe","2024-03-12",0,0,0,0,0,0,0,0
"Guadeloupe","2024-03-13",0,0,0,0,0,0,0,0
"Guadeloupe","2024-03-14",0,0,0,0,0,0,0,0
"Guadeloupe","2024-03-15",0,0,0,0,0,0,0,0
"Guadeloupe","2024-03-16",0,0,0,0,0,0,0,0
"Guadeloupe","2024-03-17",0,0,0,0,0,0,0,0
"Guadeloupe","2024-03-18",0,0,0,0,0,0,0,0
"Guadeloupe","2024-03-19",0,0,0,0,0,0,0,0
"Guadeloupe","2024-03-20",0,0,0,0,0,0,0,0
"Guadeloupe","2024-03-21",0,0,0,0,0,0,0,0
"Guadeloupe","2024-03-22",0,0,0,0,0,0,0,0
"Guadeloupe","2024-03-23",0,0,0,0,0,0,0,0
"Guadeloupe","2024-03-24",0,0,0,0,0,0,0,0
"Guadeloupe","2024-03-25",0,0,0,0,0,0,0,0
"Guadeloupe","2024-03-26",0,0,0,0,0,0,0,0
"Guadeloupe","2024-03-27",0,0,0,0,0,0,0,0
"Guadeloupe","2024-03-28",0,0,0,0,0,0,0,0
"Guadeloupe","2024-03-29",0,0,0,0,0,0,0,0
"Guadeloupe","2024-03-30",0,0,0,0,0,0,0,0
"Guadeloupe","2024-03-31",0,0,0,0,0,0,0,0
"Guadeloupe","2024-04-01",0,0,0,0,0,0,0,0
"Guadeloupe","2024-04-02",0,0,0,0,0,0,0,0
"Guadeloupe","2024-04-03",0,0,0,0,0,0,0,0
"Guadeloupe","2024-04-04",0,0,0,0,0,0,0,0
"Guadeloupe","2024-04-05",0,0,0,0,0,0,0,0
"Guadeloupe","2024-04-06",0,0,0,0,0,0,0,0
"Guadeloupe","2024-04-07",0,0,0,0,0,0,0,0
"Guadeloupe","2024-04-08",0,0,0,0,0,0,0,0
"Guadeloupe","2024-04-09",0,0,0,0,0,0,0,0
"Guadeloupe","2024-04-10",0,0,0,0,0,0,0,0
"Guadeloupe","2024-04-11",0,0,0,0,0,0,0,0
"Guadeloupe","2024-04-12",0,0,0,0,0,0,0,0
"Guadeloupe","2024-04-13",0,0,0,0,0,0,0,0
"Guadeloupe","2024-04-14",0,0,0,0,0,0,0,0
"Guadeloupe","2024-04-15",0,0,0,0,0,0,0,0
"Guadeloupe","2024-04-16",0,0,0,0,0,0,0,0
"Guadeloupe","2024-04-17",0,0,0,0,0,0,0,0
"Guadeloupe","2024-04-18",0,0,0,0,0,0,0,0
"Guadeloupe","2024-04-19",0,0,0,0,0,0,0,0
"Guadeloupe","2024-04-20",0,0,0,0,0,0,0,0
"Guadeloupe","2024-04-21",0,0,0,0,0,0,0,0
"Guadeloupe","2024-04-22",0,0,0,0,0,0,0,0
"Guadeloupe","2024-04-23",0,0,0,0,0,0,0,0
"Guadeloupe","2024-04-24",0,0,0,0,0,0,0,0
"Guadeloupe","2024-04-25",0,0,0,0,0,0,0,0
"Guadeloupe","2024-04-26",0,0,0,0,0,0,0,0
"Guadeloupe","2024-04-27",0,0,0,0,0,0,0,0
"Guadeloupe","2024-04-28",0,0,0,0,0,0,0,0
"Guadeloupe","2024-04-29",0,0,0,0,0,0,0,0
"Guadeloupe","2024-04-30",0,0,0,0,0,0,0,0
"Guadeloupe","2024-05-01",0,0,0,0,0,0,0,0
"Guadeloupe","2024-05-02",0,0,0,0,0,0,0,0
"Guadeloupe","2024-05-03",0,0,0,0,0,0,0,0
"Guadeloupe","2024-05-04",0,0,0,0,0,0,0,0
"Guadeloupe","2024-05-05",0,0,0,0,0,0,0,0
"Guadeloupe","2024-05-06",0,0,0,0,0,0,0,0
"Guadeloupe","2024-05-07",0,0,0,0,0,0,0,0
"Guadeloupe","2024-05-08",0,0,0,0,0,0,0,0
"Guadeloupe","2024-05-09",0,0,0,0,0,0,0,0
"Guadeloupe","2024-05-10",0,0,0,0,0,0,0,0
"Guadeloupe","2024-05-11",0,0,0,0,0,0,0,0
"Guadeloupe","2024-05-12",0,0,0,0,0,0,0,0
"Guadeloupe","2024-05-13",0,0,0,0,0,0,0,0
"Guadeloupe","2024-05-14",0,0,0,0,0,0,0,0
"Guadeloupe","2024-05-15",0,0,0,0,0,0,0,0
"Guadeloupe","2024-05-16",0,0,0,0,0,0,0,0
"Guadeloupe","2024-05-17",0,0,0,0,0,0,0,0
"Guadeloupe","2024-05-18",0,0,0,0,0,0,0,0
"Guadeloupe","2024-05-19",0,0,0,0,0,0,0,0
"Guadeloupe","2024-05-20",0,0,0,0,0,0,0,0
"Guadeloupe","2024-05-21",0,0,0,0,0,0,0,0
"Guadeloupe","2024-05-22",0,0,0,0,0,0,0,0
"Guadeloupe","2024-05-23",0,0,0,0,0,0,0,0
"Guadeloupe","2024-05-24",0,0,0,0,0,0,0,0
"Guadeloupe","2024-05-25",0,0,0,0,0,0,0,0
"Guadeloupe","2024-05-26",0,0,0,0,0,0,0,0
"Guadeloupe","2024-05-27",0,0,0,0,0,0,0,0
"Guadeloupe","2024-05-28",0,0,0,0,0,0,0,0
"Guadeloupe","2024-05-29",0,0,0,0,0,0,0,0
"Guadeloupe","2024-05-30",0,0,0,0,0,0,0,0
"Guadeloupe","2024-05-31",0,0,0,0,0,0,0,0
"Guadeloupe","2024-06-01",0,0,0,0,0,0,0,0
"Guadeloupe","2024-06-02",0,0,0,0,0,0,0,0
"Guadeloupe","2024-06-03",0,0,0,0,0,0,0,0
"Guadeloupe","2024-06-04",0,0,0,0,0,0,0,0
"Guadeloupe","2024-06-05",0,0,0,0,0,0,0,0
"Guadeloupe","2024-06-06",0,0,0,0,0,0,0,0
"Guadeloupe","2024-06-07",0,0,0,0,0,0,0,0
"Guadeloupe","2024-06-08",0,0,0,0,0,0,0,0
"Guadeloupe","2024-06-09",0,0,0,0,0,0,0,0
"Guadeloupe","2024-06-10",0,0,0,0,0,0,0,0
"Guadeloupe","2024-06-11",0,0,0,0,0,0,0,0
"Guadeloupe","2024-06-12",0,0,0,0,0,0,0,0
"Guadeloupe","2024-06-13",0,0,0,0,0,0,0,0
"Guadeloupe","2024-06-14",0,0,0,0,0,0,0,0
"Guadeloupe","2024-06-15",0,0,0,0,0,0,0,0
"Guadeloupe","2024-06-16",0,0,0,0,0,0,0,0
"Guadeloupe","2024-06-17",0,0,0,0,0,0,0,0
"Guadeloupe","2024-06-18",0,0,0,0,0,0,0,0
"Guadeloupe","2024-06-19",0,0,0,0,0,0,0,0
"Guadeloupe","2024-06-20",0,0,0,0,0,0,0,0
"Guadeloupe","2024-06-21",0,0,0,0,0,0,0,0
"Guadeloupe","2024-06-22",0,0,0,0,0,0,0,0
"Guadeloupe","2024-06-23",0,0,0,0,0,0,0,0
"Guadeloupe","2024-06-24",0,0,0,0,0,0,0,0
"Guadeloupe","2024-06-25",0,0,0,0,0,0,0,0
"Guadeloupe","2024-06-26",0,0,0,0,0,0,0,0
"Guadeloupe","2024-06-27",0,0,0,0,0,0,0,0
"Guadeloupe","2024-06-28",0,0,0,0,0,0,0,0
"Guadeloupe","2024-06-29",0,0,0,0,0,0,0,0
"Guadeloupe","2024-06-30",0,0,0,0,0,0,0,0
"Guadeloupe","2024-07-01",0,0,0,0,0,0,0,0
"Guadeloupe","2024-07-02",0,0,0,0,0,0,0,0
"Guadeloupe","2024-07-03",0,0,0,0,0,0,0,0
"Guadeloupe","2024-07-04",0,0,0,0,0,0,0,0
"Guadeloupe","2024-07-05",0,0,0,0,0,0,0,0
"Guadeloupe","2024-07-06",0,0,0,0,0,0,0,0
"Guadeloupe","2024-07-07",0,0,0,0,0,0,0,0
"Guadeloupe","2024-07-08",0,0,0,0,0,0,0,0
"Guadeloupe","2024-07-09",0,0,0,0,0,0,0,0
"Guadeloupe","2024-07-10",0,0,0,0,0,0,0,0
"Guadeloupe","2024-07-11",0,0,0,0,0,0,0,0
"Guadeloupe","2024-07-12",0,0,0,0,0,0,0,0
"Guadeloupe","2024-07-13",0,0,0,0,0,0,0,0
"Guadeloupe","2024-07-14",0,0,0,0,0,0,0,0
"Guadeloupe","2024-07-15",0,0,0,0,0,0,0,0
"Guadeloupe","2024-07-16",0,0,0,0,0,0,0,0
"Guadeloupe","2024-07-17",0,0,0,0,0,0,0,0
"Guadeloupe","2024-07-18",0,0,0,0,0,0,0,0
"Guadeloupe","2024-07-19",0,0,0,0,0,0,0,0
"Guadeloupe","2024-07-20",0,0,0,0,0,0,0,0
"Guadeloupe","2024-07-21",0,0,0,0,0,0,0,0
"Guadeloupe","2024-07-22",0,0,0,0,0,0,0,0
"Guadeloupe","2024-07-23",0,0,0,0,0,0,0,0
"Guadeloupe","2024-07-24",0,0,0,0,0,0,0,0
"Guadeloupe","2024-07-25",0,0,0,0,0,0,0,0
"Guadeloupe","2024-07-26",0,0,0,0,0,0,0,0
"Guadeloupe","2024-07-27",0,0,0,0,0,0,0,0
"Guadeloupe","2024-07-28",0,0,0,0,0,0,0,0
"Guadeloupe","2024-07-29",0,0,0,0,0,0,0,0
"Guadeloupe","2024-07-30",0,0,0,0,0,0,0,0
"Guadeloupe","2024-07-31",0,0,0,0,0,0,0,0
"Guadeloupe","2024-08-01",0,0,0,0,0,0,0,0
"Guadeloupe","2024-08-02",0,0,0,0,0,0,0,0
"Guadeloupe","2024-08-03",0,0,0,0,0,0,0,0
"Guadeloupe","2024-08-04",0,0,0,0,0,0,0,0
"Guadeloupe","2024-08-05",0,0,0,0,0,0,0,0
"Guadeloupe","2024-08-06",0,0,0,0,0,0,0,0
"Guadeloupe","2024-08-07",0,0,0,0,0,0,0,0
"Guadeloupe","2024-08-08",0,0,0,0,0,0,0,0
"Guadeloupe","2024-08-09",0,0,0,0,0,0,0,0
"Guadeloupe","2024-08-10",0,0,0,0,0,0,0,0
"Guadeloupe","2024-08-11",0,0,0,0,0,0,0,0
"Guadeloupe","2024-08-12",0,0,0,0,0,0,0,0
"Guadeloupe","2024-08-13",0,0,0,0,0,0,0,0
"Guadeloupe","2024-08-14",0,0,0,0,0,0,0,0
"Guadeloupe","2024-08-15",0,0,0,0,0,0,0,0
"Guadeloupe","2024-08-16",0,0,0,0,0,0,0,0
"Guadeloupe","2024-08-17",0,0,0,0,0,0,0,0
"Guadeloupe","2024-08-18",0,0,0,0,0,0,0,0
"Guadeloupe","2024-08-19",0,0,0,0,0,0,0,0
"Guadeloupe","2024-08-20",0,0,0,0,0,0,0,0
"Guadeloupe","2024-08-21",0,0,0,0,0,0,0,0
"Guadeloupe","2024-08-22",0,0,0,0,0,0,0,0
"Guadeloupe","2024-08-23",0,0,0,0,0,0,0,0
"Guadeloupe","2024-08-24",0,0,0,0,0,0,0,0
"Guadeloupe","2024-08-25",0,0,0,0,0,0,0,0
"Guadeloupe","2024-08-26",0,0,0,0,0,0,0,0
"Guadeloupe","2024-08-27",0,0,0,0,0,0,0,0
"Guadeloupe","2024-08-28",0,0,0,0,0,0,0,0
"Guadeloupe","2024-08-29",0,0,0,0,0,0,0,0
"Guadeloupe","2024-08-30",0,0,0,0,0,0,0,0
"Guadeloupe","2024-08-31",0,0,0,0,0,0,0,0
"Guadeloupe","2024-09-01",0,0,0,0,0,0,0,0
"Guadeloupe","2024-09-02",0,0,0,0,0,0,0,0
"Guadeloupe","2024-09-03",0,0,0,0,0,0,0,0
"Guadeloupe","2024-09-04",0,0,0,0,0,0,0,0
"Guadeloupe","2024-09-05",0,0,0,0,0,0,0,0
"Guadeloupe","2024-09-06",0,0,0,0,0,0,0,0
"Guadeloupe","2024-09-07",0,0,0,0,0,0,0,0
"Guadeloupe","2024-09-08",0,0,0,0,0,0,0,0
"Guadeloupe","2024-09-09",0,0,0,0,0,0,0,0
"Guadeloupe","2024-09-10",0,0,0,0,0,0,0,0
"Guadeloupe","2024-09-11",0,0,0,0,0,0,0,0
"Guadeloupe","2024-09-12",0,0,0,0,0,0,0,0
"Guadeloupe","2024-09-13",0,0,0,0,0,0,0,0
"Guadeloupe","2024-09-14",0,0,0,0,0,0,0,0
"Guadeloupe","2024-09-15",0,0,0,0,0,0,0,0
"Guadeloupe","2024-09-16",0,0,0,0,0,0,0,0
"Guadeloupe","2024-09-17",0,0,0,0,0,0,0,0
"Guadeloupe","2024-09-18",0,0,0,0,0,0,0,0
"Guadeloupe","2024-09-19",0,0,0,0,0,0,0,0
"Guadeloupe","2024-09-20",0,0,0,0,0,0,0,0
"Guadeloupe","2024-09-21",0,0,0,0,0,0,0,0
"Guadeloupe","2024-09-22",0,0,0,0,0,0,0,0
"Guadeloupe","2024-09-23",0,0,0,0,0,0,0,0
"Guadeloupe","2024-09-24",0,0,0,0,0,0,0,0
"Guadeloupe","2024-09-25",0,0,0,0,0,0,0,0
"Guadeloupe","2024-09-26",0,0,0,0,0,0,0,0
"Guadeloupe","2024-09-27",0,0,0,0,0,0,0,0
"Guadeloupe","2024-09-28",0,0,0,0,0,0,0,0
"Guadeloupe","2024-09-29",0,0,0,0,0,0,0,0
"Guadeloupe","2024-09-30",0,0,0,0,0,0,0,0
"Guadeloupe","2024-10-01",0,0,0,0,0,0,0,0
"Guadeloupe","2024-10-02",0,0,0,0,0,0,0,0
"Guadeloupe","2024-10-03",0,0,0,0,0,0,0,0
"Guadeloupe","2024-10-04",0,0,0,0,0,0,0,0
"Guadeloupe","2024-10-05",0,0,0,0,0,0,0,0
"Guadeloupe","2024-10-06",0,0,0,0,0,0,0,0
"Guadeloupe","2024-10-07",0,0,0,0,0,0,0,0
"Guadeloupe","2024-10-08",0,0,0,0,0,0,0,0
"Guadeloupe","2024-10-09",0,0,0,0,0,0,0,0
"Guadeloupe","2024-10-10",0,0,0,0,0,0,0,0
"Guadeloupe","2024-10-11",0,0,0,0,0,0,0,0
"Guadeloupe","2024-10-12",0,0,0,0,0,0,0,0
"Guadeloupe","2024-10-13",0,0,0,0,0,0,0,0
"Guadeloupe","2024-10-14",0,0,0,0,0,0,0,0
"Guadeloupe","2024-10-15",0,0,0,0,0,0,0,0
"Guadeloupe","2024-10-16",0,0,0,0,0,0,0,0
"Guadeloupe","2024-10-17",0,0,0,0,0,0,0,0
"Guadeloupe","2024-10-18",0,0,0,0,0,0,0,0
"Guadeloupe","2024-10-19",0,0,0,0,0,0,0,0
"Guadeloupe","2024-10-20",0,0,0,0,0,0,0,0
"Guadeloupe","2024-10-21",0,0,0,0,0,0,0,0
"Guadeloupe","2024-10-22",0,0,0,0,0,0,0,0
"Guadeloupe","2024-10-23",0,0,0,0,0,0,0,0
"Guadeloupe","2024-10-24",0,0,0,0,0,0,0,0
"Guadeloupe","2024-10-25",0,0,0,0,0,0,0,0
"Guadeloupe","2024-10-26",0,0,0,0,0,0,0,0
"Guadeloupe","2024-10-27",0,0,0,0,0,0,0,0
"Guadeloupe","2024-10-28",0,0,0,0,0,0,0,0
"Guadeloupe","2024-10-29",0,0,0,0,0,0,0,0
"Guadeloupe","2024-10-30",0,0,0,0,0,0,0,0
"Guadeloupe","2024-10-31",0,0,0,0,0,0,0,0
"Guadeloupe","2024-11-01",0,0,0,0,0,0,0,0
"Guadeloupe","2024-11-02",0,0,0,0,0,0,0,0
"Guadeloupe","2024-11-03",0,0,0,0,0,0,0,0
"Guadeloupe","2024-11-04",0,0,0,0,0,0,0,0
"Guadeloupe","2024-11-05",0,0,0,0,0,0,0,0
"Guadeloupe","2024-11-06",0,0,0,0,0,0,0,0
"Guadeloupe","2024-11-07",0,0,0,0,0,0,0,0
"Guadeloupe","2024-11-08",0,0,0,0,0,0,0,0
"Guadeloupe","2024-11-09",0,0,0,0,0,0,0,0
"Guadeloupe","2024-11-10",0,0,0,0,0,0,0,0
"Guadeloupe","2024-11-11",0,0,0,0,0,0,0,0
"Guadeloupe","2024-11-12",0,0,0,0,0,0,0,0
"Guadeloupe","2024-11-13",0,0,0,0,0,0,0,0
"Guadeloupe","2024-11-14",0,0,0,0,0,0,0,0
"Guadeloupe","2024-11-15",0,0,0,0,0,0,0,0
"Guadeloupe","2024-11-16",0,0,0,0,0,0,0,0
"Guadeloupe","2024-11-17",0,0,0,0,0,0,0,0
"Guadeloupe","2024-11-18",0,0,0,0,0,0,0,0
"Guadeloupe","2024-11-19",0,0,0,0,0,0,0,0
"Guadeloupe","2024-11-20",0,0,0,0,0,0,0,0
"Guadeloupe","2024-11-21",0,0,0,0,0,0,0,0
"Guadeloupe","2024-11-22",0,0,0,0,0,0,0,0
"Guadeloupe","2024-11-23",0,0,0,0,0,0,0,0
"Guadeloupe","2024-11-24",0,0,0,0,0,0,0,0
"Guadeloupe","2024-11-25",0,0,0,0,0,0,0,0
"Guadeloupe","2024-11-26",0,0,0,0,0,0,0,0
"Guadeloupe","2024-11-27",0,0,0,0,0,0,0,0
"Guadeloupe","2024-11-28",0,0,0,0,0,0,0,0
"Guadeloupe","2024-11-29",0,0,0,0,0,0,0,0
"Guadeloupe","2024-11-30",0,0,0,0,0,0,0,0
"Guadeloupe","2024-12-01",0,0,0,0,0,0,0,0
"Guadeloupe","2024-12-02",0,0,0,0,0,0,0,0
"Guadeloupe","2024-12-03",0,0,0,0,0,0,0,0
"Guadeloupe","2024-12-04",0,0,0,0,0,0,0,0
"Guadeloupe","2024-12-05",0,0,0,0,0,0,0,0
"Guadeloupe","2024-12-06",0,0,0,0,0,0,0,0
"Guadeloupe","2024-12-07",0,0,0,0,0,0,0,0
"Guadeloupe","2024-12-08",0,0,0,0,0,0,0,0
"Guadeloupe","2024-12-09",0,0,0,0,0,0,0,0
"Guatemala","2024-01-01",0,0,0,0,0,0,0,0
"Guatemala","2024-01-02",0,0,0,0,0,0,0,0
"Guatemala","2024-01-03",0,0,0,0,0,0,0,0
"Guatemala","2024-01-04",0,0,0,0,0,0,0,0
"Guatemala","2024-01-05",0,0,0,0,0,0,0,0
"Guatemala","2024-01-06",0,0,0,0,0,0,0,0
"Guatemala","2024-01-07",0,0,0,0,0,0,0,0
"Guatemala","2024-01-08",0,0,0,0,0,0,0,0
"Guatemala","2024-01-09",0,0,0,0,0,0,0,0
"Guatemala","2024-01-10",0,0,0,0,0,0,0,0
"Guatemala","2024-01-11",0,0,0,0,0,0,0,0
"Guatemala","2024-01-12",0,0,0,0,0,0,0,0
"Guatemala","2024-01-13",0,0,0,0,0,0,0,0
"Guatemala","2024-01-14",0,0,0,0,0,0,0,0
"Guatemala","2024-01-15",0,0,0,0,0,0,0,0
"Guatemala","2024-01-16",0,1,1,0,1,1,0,0
"Guatemala","2024-01-17",0,0,1,0,0,1,0,0
"Guatemala","2024-01-18",0,0,1,0,0,1,0,0
"Guatemala","2024-01-19",0,0,1,0,0,1,0,0
"Guatemala","2024-01-20",0,0,1,0,0,1,0,0
"Guatemala","2024-01-21",0,0,1,0,0,1,0,0
"Guatemala","2024-01-22",0,0,1,0,0,1,0,0
"Guatemala","2024-01-23",0,0,1,0,0,1,0,0
"Guatemala","2024-01-24",0,0,1,0,0,1,0,0
"Guatemala","2024-01-25",0,0,1,0,0,1,0,0
"Guatemala","2024-01-26",0,0,1,0,0,1,0,0
"Guatemala","2024-01-27",0,0,1,0,0,1,0,0
"Guatemala","2024-01-28",0,0,1,0,0,1,0,0
"Guatemala","2024-01-29",0,0,1,0,0,1,0,0
"Guatemala","2024-01-30",0,0,1,0,0,1,0,0
"Guatemala","2024-01-31",0,0,1,0,0,1,0,0
"Guatemala","2024-02-01",0,0,1,0,0,1,0,0
"Guatemala","2024-02-02",0,0,1,0,0,1,0,0
"Guatemala","2024-02-03",0,0,1,0,0,1,0,0
"Guatemala","2024-02-04",0,0,1,0,0,1,0,0
"Guatemala","2024-02-05",0,0,1,0,0,1,0,0
"Guatemala","2024-02-06",0,0,1,0,0,1,0,0
"Guatemala","2024-02-07",0,0,1,0,0,1,0,0
"Guatemala","2024-02-08",0,0,1,0,0,1,0,0
"Guatemala","2024-02-09",0,0,1,0,0,1,0,0
"Guatemala","2024-02-10",0,0,1,0,0,1,0,0
"Guatemala","2024-02-11",0,0,1,0,0,1,0,0
"Guatemala","2024-02-12",0,0,1,0,0,1,0,0
"Guatemala","2024-02-13",0,0,1,0,0,1,0,0
"Guatemala","2024-02-14",0,0,1,0,0,1,0,0
"Guatemala","2024-02-15",0,0,1,0,0,1,0,0
"Guatemala","2024-02-16",0,0,1,0,0,1,0,0
"Guatemala","2024-02-17",0,0,1,0,0,1,0,0
"Guatemala","2024-02-18",0,0,1,0,0,1,0,0
"Guatemala","2024-02-19",0,0,1,0,0,1,0,0
"Guatemala","2024-02-20",0,0,1,0,0,1,0,0
"Guatemala","2024-02-21",0,0,1,0,0,1,0,0
"Guatemala","2024-02-22",0,0,1,0,0,1,0,0
"Guatemala","2024-02-23",0,0,1,0,0,1,0,0
"Guatemala","2024-02-24",0,0,1,0,0,1,0,0
"Guatemala","2024-02-25",0,0,1,0,0,1,0,0
"Guatemala","2024-02-26",0,0,1,0,0,1,0,0
"Guatemala","2024-02-27",0,0,1,0,0,1,0,0
"Guatemala","2024-02-28",0,0,1,0,0,1,0,0
"Guatemala","2024-02-29",0,0,1,0,0,1,0,0
"Guatemala","2024-03-01",0,0,1,0,0,1,0,0
"Guatemala","2024-03-02",0,0,1,0,0,1,0,0
"Guatemala","2024-03-03",0,0,1,0,0,1,0,0
"Guatemala","2024-03-04",0,0,1,0,0,1,0,0
"Guatemala","2024-03-05",0,0,1,0,0,1,0,0
"Guatemala","2024-03-06",0,0,1,0,0,1,0,0
"Guatemala","2024-03-07",0,0,1,0,0,1,0,0
"Guatemala","2024-03-08",0,0,1,0,0,1,0,0
"Guatemala","2024-03-09",0,0,1,0,0,1,0,0
"Guatemala","2024-03-10",0,0,1,0,0,1,0,0
"Guatemala","2024-03-11",0,0,1,0,0,1,0,0
"Guatemala","2024-03-12",0,0,1,0,0,1,0,0
"Guatemala","2024-03-13",0,0,1,0,0,1,0,0
"Guatemala","2024-03-14",0,0,1,0,0,1,0,0
"Guatemala","2024-03-15",0,0,1,0,0,1,0,0
"Guatemala","2024-03-16",0,0,1,0,0,1,0,0
"Guatemala","2024-03-17",0,0,1,0,0,1,0,0
"Guatemala","2024-03-18",0,0,1,0,0,1,0,0
"Guatemala","2024-03-19",0,0,1,0,0,1,0,0
"Guatemala","2024-03-20",0,0,1,0,0,1,0,0
"Guatemala","2024-03-21",0,0,1,0,0,1,0,0
"Guatemala","2024-03-22",0,0,1,0,0,1,0,0
"Guatemala","2024-03-23",0,0,1,0,0,1,0,0
"Guatemala","2024-03-24",0,0,1,0,0,1,0,0
"Guatemala","2024-03-25",0,0,1,0,0,1,0,0
"Guatemala","2024-03-26",0,0,1,0,0,1,0,0
"Guatemala","2024-03-27",0,0,1,0,0,1,0,0
"Guatemala","2024-03-28",0,0,1,0,0,1,0,0
"Guatemala","2024-03-29",0,0,1,0,0,1,0,0
"Guatemala","2024-03-30",0,0,1,0,0,1,0,0
"Guatemala","2024-03-31",0,0,1,0,0,1,0,0
"Guatemala","2024-04-01",0,0,1,0,0,1,0,0
"Guatemala","2024-04-02",0,0,1,0,0,1,0,0
"Guatemala","2024-04-03",0,0,1,0,0,1,0,0
"Guatemala","2024-04-04",0,0,1,0,0,1,0,0
"Guatemala","2024-04-05",0,0,1,0,0,1,0,0
"Guatemala","2024-04-06",0,0,1,0,0,1,0,0
"Guatemala","2024-04-07",0,0,1,0,0,1,0,0
"Guatemala","2024-04-08",0,0,1,0,0,1,0,0
"Guatemala","2024-04-09",0,0,1,0,0,1,0,0
"Guatemala","2024-04-10",0,0,1,0,0,1,0,0
"Guatemala","2024-04-11",0,0,1,0,0,1,0,0
"Guatemala","2024-04-12",0,0,1,0,0,1,0,0
"Guatemala","2024-04-13",0,0,1,0,0,1,0,0
"Guatemala","2024-04-14",0,0,1,0,0,1,0,0
"Guatemala","2024-04-15",0,0,1,0,0,1,0,0
"Guatemala","2024-04-16",0,0,1,0,0,1,0,0
"Guatemala","2024-04-17",0,0,1,0,0,1,0,0
"Guatemala","2024-04-18",0,0,1,0,0,1,0,0
"Guatemala","2024-04-19",0,0,1,0,0,1,0,0
"Guatemala","2024-04-20",0,0,1,0,0,1,0,0
"Guatemala","2024-04-21",0,0,1,0,0,1,0,0
"Guatemala","2024-04-22",0,0,1,0,0,1,0,0
"Guatemala","2024-04-23",0,0,1,0,0,1,0,0
"Guatemala","2024-04-24",0,0,1,0,0,1,0,0
"Guatemala","2024-04-25",0,0,1,0,0,1,0,0
"Guatemala","2024-04-26",0,0,1,0,0,1,0,0
"Guatemala","2024-04-27",0,0,1,0,0,1,0,0
"Guatemala","2024-04-28",0,0,1,0,0,1,0,0
"Guatemala","2024-04-29",0,0,1,0,0,1,0,0
"Guatemala","2024-04-30",0,0,1,0,0,1,0,0
"Guatemala","2024-05-01",0,0,1,0,0,1,0,0
"Guatemala","2024-05-02",0,0,1,0,0,1,0,0
"Guatemala","2024-05-03",0,0,1,0,0,1,0,0
"Guatemala","2024-05-04",0,0,1,0,0,1,0,0
"Guatemala","2024-05-05",0,0,1,0,0,1,0,0
"Guatemala","2024-05-06",0,0,1,0,0,1,0,0
"Guatemala","2024-05-07",0,0,1,0,0,1,0,0
"Guatemala","2024-05-08",0,0,1,0,0,1,0,0
"Guatemala","2024-05-09",0,0,1,0,0,1,0,0
"Guatemala","2024-05-10",0,0,1,0,0,1,0,0
"Guatemala","2024-05-11",0,0,1,0,0,1,0,0
"Guatemala","2024-05-12",0,0,1,0,0,1,0,0
"Guatemala","2024-05-13",0,0,1,0,0,1,0,0
"Guatemala","2024-05-14",0,0,1,0,0,1,0,0
"Guatemala","2024-05-15",0,0,1,0,0,1,0,0
"Guatemala","2024-05-16",0,0,1,0,0,1,0,0
"Guatemala","2024-05-17",0,0,1,0,0,1,0,0
"Guatemala","2024-05-18",0,0,1,0,0,1,0,0
"Guatemala","2024-05-19",0,0,1,0,0,1,0,0
"Guatemala","2024-05-20",0,0,1,0,0,1,0,0
"Guatemala","2024-05-21",0,0,1,0,0,1,0,0
"Guatemala","2024-05-22",0,0,1,0,0,1,0,0
"Guatemala","2024-05-23",0,0,1,0,0,1,0,0
"Guatemala","2024-05-24",0,0,1,0,0,1,0,0
"Guatemala","2024-05-25",0,0,1,0,0,1,0,0
"Guatemala","2024-05-26",0,0,1,0,0,1,0,0
"Guatemala","2024-05-27",0,0,1,0,0,1,0,0
"Guatemala","2024-05-28",0,0,1,0,0,1,0,0
"Guatemala","2024-05-29",0,0,1,0,0,1,0,0
"Guatemala","2024-05-30",0,0,1,0,0,1,0,0
"Guatemala","2024-05-31",0,0,1,0,0,1,0,0
"Guatemala","2024-06-01",0,0,1,0,0,1,0,0
"Guatemala","2024-06-02",0,0,1,0,0,1,0,0
"Guatemala","2024-06-03",0,0,1,0,0,1,0,0
"Guatemala","2024-06-04",0,0,1,0,0,1,0,0
"Guatemala","2024-06-05",0,0,1,0,0,1,0,0
"Guatemala","2024-06-06",0,0,1,0,0,1,0,0
"Guatemala","2024-06-07",0,0,1,0,0,1,0,0
"Guatemala","2024-06-08",0,0,1,0,0,1,0,0
"Guatemala","2024-06-09",0,0,1,0,0,1,0,0
"Guatemala","2024-06-10",0,0,1,0,0,1,0,0
"Guatemala","2024-06-11",0,0,1,0,0,1,0,0
"Guatemala","2024-06-12",0,0,1,0,0,1,0,0
"Guatemala","2024-06-13",0,0,1,0,0,1,0,0
"Guatemala","2024-06-14",0,0,1,0,0,1,0,0
"Guatemala","2024-06-15",0,0,1,0,0,1,0,0
"Guatemala","2024-06-16",0,0,1,0,0,1,0,0
"Guatemala","2024-06-17",0,0,1,0,0,1,0,0
"Guatemala","2024-06-18",0,0,1,0,0,1,0,0
"Guatemala","2024-06-19",0,0,1,0,0,1,0,0
"Guatemala","2024-06-20",0,0,1,0,0,1,0,0
"Guatemala","2024-06-21",0,0,1,0,0,1,0,0
"Guatemala","2024-06-22",0,0,1,0,0,1,0,0
"Guatemala","2024-06-23",0,0,1,0,0,1,0,0
"Guatemala","2024-06-24",0,0,1,0,0,1,0,0
"Guatemala","2024-06-25",0,0,1,0,0,1,0,0
"Guatemala","2024-06-26",0,0,1,0,0,1,0,0
"Guatemala","2024-06-27",0,0,1,0,0,1,0,0
"Guatemala","2024-06-28",0,0,1,0,0,1,0,0
"Guatemala","2024-06-29",0,0,1,0,0,1,0,0
"Guatemala","2024-06-30",0,0,1,0,0,1,0,0
"Guatemala","2024-07-01",0,0,1,0,0,1,0,0
"Guatemala","2024-07-02",0,0,1,0,0,1,0,0
"Guatemala","2024-07-03",0,0,1,0,0,1,0,0
"Guatemala","2024-07-04",0,0,1,0,0,1,0,0
"Guatemala","2024-07-05",0,0,1,0,0,1,0,0
"Guatemala","2024-07-06",0,0,1,0,0,1,0,0
"Guatemala","2024-07-07",0,0,1,0,0,1,0,0
"Guatemala","2024-07-08",0,0,1,0,0,1,0,0
"Guatemala","2024-07-09",0,0,1,0,0,1,0,0
"Guatemala","2024-07-10",0,0,1,0,0,1,0,0
"Guatemala","2024-07-11",0,0,1,0,0,1,0,0
"Guatemala","2024-07-12",0,0,1,0,0,1,0,0
"Guatemala","2024-07-13",0,0,1,0,0,1,0,0
"Guatemala","2024-07-14",0,0,1,0,0,1,0,0
"Guatemala","2024-07-15",0,0,1,0,0,1,0,0
"Guatemala","2024-07-16",0,0,1,0,0,1,0,0
"Guatemala","2024-07-17",0,0,1,0,0,1,0,0
"Guatemala","2024-07-18",0,0,1,0,0,1,0,0
"Guatemala","2024-07-19",0,0,1,0,0,1,0,0
"Guatemala","2024-07-20",0,0,1,0,0,1,0,0
"Guatemala","2024-07-21",0,0,1,0,0,1,0,0
"Guatemala","2024-07-22",0,0,1,0,0,1,0,0
"Guatemala","2024-07-23",0,0,1,0,0,1,0,0
"Guatemala","2024-07-24",0,0,1,0,0,1,0,0
"Guatemala","2024-07-25",0,0,1,0,0,1,0,0
"Guatemala","2024-07-26",0,0,1,0,0,1,0,0
"Guatemala","2024-07-27",0,0,1,0,0,1,0,0
"Guatemala","2024-07-28",0,0,1,0,0,1,0,0
"Guatemala","2024-07-29",0,0,1,0,0,1,0,0
"Guatemala","2024-07-30",0,0,1,0,0,1,0,0
"Guatemala","2024-07-31",0,0,1,0,0,1,0,0
"Guatemala","2024-08-01",0,0,1,0,0,1,0,0
"Guatemala","2024-08-02",0,0,1,0,0,1,0,0
"Guatemala","2024-08-03",0,0,1,0,0,1,0,0
"Guatemala","2024-08-04",0,0,1,0,0,1,0,0
"Guatemala","2024-08-05",0,0,1,0,0,1,0,0
"Guatemala","2024-08-06",0,0,1,0,0,1,0,0
"Guatemala","2024-08-07",0,0,1,0,0,1,0,0
"Guatemala","2024-08-08",0,0,1,0,0,1,0,0
"Guatemala","2024-08-09",0,0,1,0,0,1,0,0
"Guatemala","2024-08-10",0,0,1,0,0,1,0,0
"Guatemala","2024-08-11",0,0,1,0,0,1,0,0
"Guatemala","2024-08-12",0,0,1,0,0,1,0,0
"Guatemala","2024-08-13",0,0,1,0,0,1,0,0
"Guatemala","2024-08-14",0,0,1,0,0,1,0,0
"Guatemala","2024-08-15",0,0,1,0,0,1,0,0
"Guatemala","2024-08-16",0,0,1,0,0,1,0,0
"Guatemala","2024-08-17",0,0,1,0,0,1,0,0
"Guatemala","2024-08-18",0,0,1,0,0,1,0,0
"Guatemala","2024-08-19",0,0,1,0,0,1,0,0
"Guatemala","2024-08-20",0,0,1,0,0,1,0,0
"Guatemala","2024-08-21",0,0,1,0,0,1,0,0
"Guatemala","2024-08-22",0,0,1,0,0,1,0,0
"Guatemala","2024-08-23",0,0,1,0,0,1,0,0
"Guatemala","2024-08-24",0,0,1,0,0,1,0,0
"Guatemala","2024-08-25",0,0,1,0,0,1,0,0
"Guatemala","2024-08-26",0,0,1,0,0,1,0,0
"Guatemala","2024-08-27",0,0,1,0,0,1,0,0
"Guatemala","2024-08-28",0,0,1,0,0,1,0,0
"Guatemala","2024-08-29",0,0,1,0,0,1,0,0
"Guatemala","2024-08-30",0,0,1,0,0,1,0,0
"Guatemala","2024-08-31",0,0,1,0,0,1,0,0
"Guatemala","2024-09-01",0,0,1,0,0,1,0,0
"Guatemala","2024-09-02",0,0,1,0,0,1,0,0
"Guatemala","2024-09-03",0,0,1,0,0,1,0,0
"Guatemala","2024-09-04",0,0,1,0,0,1,0,0
"Guatemala","2024-09-05",0,0,1,0,0,1,0,0
"Guatemala","2024-09-06",0,0,1,0,0,1,0,0
"Guatemala","2024-09-07",0,0,1,0,0,1,0,0
"Guatemala","2024-09-08",0,0,1,0,0,1,0,0
"Guatemala","2024-09-09",0,0,1,0,0,1,0,0
"Guatemala","2024-09-10",0,0,1,0,0,1,0,0
"Guatemala","2024-09-11",0,0,1,0,0,1,0,0
"Guatemala","2024-09-12",0,0,1,0,0,1,0,0
"Guatemala","2024-09-13",0,0,1,0,0,1,0,0
"Guatemala","2024-09-14",0,0,1,0,0,1,0,0
"Guatemala","2024-09-15",0,0,1,0,0,1,0,0
"Guatemala","2024-09-16",0,0,1,0,0,1,0,0
"Guatemala","2024-09-17",0,0,1,0,0,1,0,0
"Guatemala","2024-09-18",0,0,1,0,0,1,0,0
"Guatemala","2024-09-19",0,0,1,0,0,1,0,0
"Guatemala","2024-09-20",0,0,1,0,0,1,0,0
"Guatemala","2024-09-21",0,0,1,0,0,1,0,0
"Guatemala","2024-09-22",0,0,1,0,0,1,0,0
"Guatemala","2024-09-23",0,0,1,0,0,1,0,0
"Guatemala","2024-09-24",0,0,1,0,0,1,0,0
"Guatemala","2024-09-25",0,0,1,0,0,1,0,0
"Guatemala","2024-09-26",0,0,1,0,0,1,0,0
"Guatemala","2024-09-27",0,0,1,0,0,1,0,0
"Guatemala","2024-09-28",0,0,1,0,0,1,0,0
"Guatemala","2024-09-29",0,0,1,0,0,1,0,0
"Guatemala","2024-09-30",0,0,1,0,0,1,0,0
"Guatemala","2024-10-01",0,0,1,0,0,1,0,0
"Guatemala","2024-10-02",0,0,1,0,0,1,0,0
"Guatemala","2024-10-03",0,0,1,0,0,1,0,0
"Guatemala","2024-10-04",0,0,1,0,0,1,0,0
"Guatemala","2024-10-05",0,0,1,0,0,1,0,0
"Guatemala","2024-10-06",0,0,1,0,0,1,0,0
"Guatemala","2024-10-07",0,0,1,0,0,1,0,0
"Guatemala","2024-10-08",0,0,1,0,0,1,0,0
"Guatemala","2024-10-09",0,0,1,0,0,1,0,0
"Guatemala","2024-10-10",0,0,1,0,0,1,0,0
"Guatemala","2024-10-11",0,0,1,0,0,1,0,0
"Guatemala","2024-10-12",0,0,1,0,0,1,0,0
"Guatemala","2024-10-13",0,0,1,0,0,1,0,0
"Guatemala","2024-10-14",0,0,1,0,0,1,0,0
"Guatemala","2024-10-15",0,0,1,0,0,1,0,0
"Guatemala","2024-10-16",0,0,1,0,0,1,0,0
"Guatemala","2024-10-17",0,0,1,0,0,1,0,0
"Guatemala","2024-10-18",0,0,1,0,0,1,0,0
"Guatemala","2024-10-19",0,0,1,0,0,1,0,0
"Guatemala","2024-10-20",0,0,1,0,0,1,0,0
"Guatemala","2024-10-21",0,0,1,0,0,1,0,0
"Guatemala","2024-10-22",0,0,1,0,0,1,0,0
"Guatemala","2024-10-23",0,0,1,0,0,1,0,0
"Guatemala","2024-10-24",0,0,1,0,0,1,0,0
"Guatemala","2024-10-25",0,0,1,0,0,1,0,0
"Guatemala","2024-10-26",0,0,1,0,0,1,0,0
"Guatemala","2024-10-27",0,0,1,0,0,1,0,0
"Guatemala","2024-10-28",0,0,1,0,0,1,0,0
"Guatemala","2024-10-29",0,0,1,0,0,1,0,0
"Guatemala","2024-10-30",0,0,1,0,0,1,0,0
"Guatemala","2024-10-31",0,0,1,0,0,1,0,0
"Guatemala","2024-11-01",0,0,1,0,0,1,0,0
"Guatemala","2024-11-02",0,0,1,0,0,1,0,0
"Guatemala","2024-11-03",0,0,1,0,0,1,0,0
"Guatemala","2024-11-04",0,0,1,0,0,1,0,0
"Guatemala","2024-11-05",0,0,1,0,0,1,0,0
"Guatemala","2024-11-06",0,0,1,0,0,1,0,0
"Guatemala","2024-11-07",0,0,1,0,0,1,0,0
"Guatemala","2024-11-08",0,0,1,0,0,1,0,0
"Guatemala","2024-11-09",0,0,1,0,0,1,0,0
"Guatemala","2024-11-10",0,0,1,0,0,1,0,0
"Guatemala","2024-11-11",0,0,1,0,0,1,0,0
"Guatemala","2024-11-12",0,0,1,0,0,1,0,0
"Guatemala","2024-11-13",0,0,1,0,0,1,0,0
"Guatemala","2024-11-14",0,0,1,0,0,1,0,0
"Guatemala","2024-11-15",0,0,1,0,0,1,0,0
"Guatemala","2024-11-16",0,0,1,0,0,1,0,0
"Guatemala","2024-11-17",0,0,1,0,0,1,0,0
"Guatemala","2024-11-18",0,0,1,0,0,1,0,0
"Guatemala","2024-11-19",0,0,1,0,0,1,0,0
"Guatemala","2024-11-20",0,0,1,0,0,1,0,0
"Guatemala","2024-11-21",0,0,1,0,0,1,0,0
"Guatemala","2024-11-22",0,0,1,0,0,1,0,0
"Guatemala","2024-11-23",0,0,1,0,0,1,0,0
"Guatemala","2024-11-24",0,0,1,0,0,1,0,0
"Guatemala","2024-11-25",0,0,1,0,0,1,0,0
"Guatemala","2024-11-26",0,0,1,0,0,1,0,0
"Guatemala","2024-11-27",0,0,1,0,0,1,0,0
"Guatemala","2024-11-28",0,0,1,0,0,1,0,0
"Guatemala","2024-11-29",0,0,1,0,0,1,0,0
"Guatemala","2024-11-30",0,0,1,0,0,1,0,0
"Guatemala","2024-12-01",0,0,1,0,0,1,0,0
"Guatemala","2024-12-02",0,0,1,0,0,1,0,0
"Guatemala","2024-12-03",0,0,1,0,0,1,0,0
"Guatemala","2024-12-04",0,0,1,0,0,1,0,0
"Guatemala","2024-12-05",0,0,1,0,0,1,0,0
"Guatemala","2024-12-06",0,0,1,0,0,1,0,0
"Guatemala","2024-12-07",0,0,1,0,0,1,0,0
"Guatemala","2024-12-08",0,0,1,0,0,1,0,0
"Guatemala","2024-12-09",0,0,1,0,0,1,0,0
"Guinea","2024-01-01",0,0,0,0,0,0,0,0
"Guinea","2024-01-02",0,0,0,0,0,0,0,0
"Guinea","2024-01-03",0,0,0,0,0,0,0,0
"Guinea","2024-01-04",0,0,0,0,0,0,0,0
"Guinea","2024-01-05",0,0,0,0,0,0,0,0
"Guinea","2024-01-06",0,0,0,0,0,0,0,0
"Guinea","2024-01-07",0,0,0,0,0,0,0,0
"Guinea","2024-01-08",0,0,0,0,0,0,0,0
"Guinea","2024-01-09",0,0,0,0,0,0,0,0
"Guinea","2024-01-10",0,0,0,0,0,0,0,0
"Guinea","2024-01-11",0,0,0,0,0,0,0,0
"Guinea","2024-01-12",0,0,0,0,0,0,0,0
"Guinea","2024-01-13",0,0,0,0,0,0,0,0
"Guinea","2024-01-14",0,0,0,0,0,0,0,0
"Guinea","2024-01-15",0,0,0,0,0,0,0,0
"Guinea","2024-01-16",0,0,0,0,0,0,0,0
"Guinea","2024-01-17",0,0,0,0,0,0,0,0
"Guinea","2024-01-18",0,0,0,0,0,0,0,0
"Guinea","2024-01-19",0,0,0,0,0,0,0,0
"Guinea","2024-01-20",0,0,0,0,0,0,0,0
"Guinea","2024-01-21",0,0,0,0,0,0,0,0
"Guinea","2024-01-22",0,0,0,0,0,0,0,0
"Guinea","2024-01-23",0,0,0,0,0,0,0,0
"Guinea","2024-01-24",0,0,0,0,0,0,0,0
"Guinea","2024-01-25",0,0,0,0,0,0,0,0
"Guinea","2024-01-26",0,0,0,0,0,0,0,0
"Guinea","2024-01-27",0,0,0,0,0,0,0,0
"Guinea","2024-01-28",0,0,0,0,0,0,0,0
"Guinea","2024-01-29",0,0,0,0,0,0,0,0
"Guinea","2024-01-30",0,0,0,0,0,0,0,0
"Guinea","2024-01-31",0,0,0,0,0,0,0,0
"Guinea","2024-02-01",0,0,0,0,0,0,0,0
"Guinea","2024-02-02",0,0,0,0,0,0,0,0
"Guinea","2024-02-03",0,0,0,0,0,0,0,0
"Guinea","2024-02-04",0,0,0,0,0,0,0,0
"Guinea","2024-02-05",0,0,0,0,0,0,0,0
"Guinea","2024-02-06",0,0,0,0,0,0,0,0
"Guinea","2024-02-07",0,0,0,0,0,0,0,0
"Guinea","2024-02-08",0,0,0,0,0,0,0,0
"Guinea","2024-02-09",0,0,0,0,0,0,0,0
"Guinea","2024-02-10",0,0,0,0,0,0,0,0
"Guinea","2024-02-11",0,0,0,0,0,0,0,0
"Guinea","2024-02-12",0,0,0,0,0,0,0,0
"Guinea","2024-02-13",0,0,0,0,0,0,0,0
"Guinea","2024-02-14",0,0,0,0,0,0,0,0
"Guinea","2024-02-15",0,0,0,0,0,0,0,0
"Guinea","2024-02-16",0,0,0,0,0,0,0,0
"Guinea","2024-02-17",0,0,0,0,0,0,0,0
"Guinea","2024-02-18",0,0,0,0,0,0,0,0
"Guinea","2024-02-19",0,0,0,0,0,0,0,0
"Guinea","2024-02-20",0,0,0,0,0,0,0,0
"Guinea","2024-02-21",0,0,0,0,0,0,0,0
"Guinea","2024-02-22",0,0,0,0,0,0,0,0
"Guinea","2024-02-23",0,0,0,0,0,0,0,0
"Guinea","2024-02-24",0,0,0,0,0,0,0,0
"Guinea","2024-02-25",0,0,0,0,0,0,0,0
"Guinea","2024-02-26",0,0,0,0,0,0,0,0
"Guinea","2024-02-27",0,0,0,0,0,0,0,0
"Guinea","2024-02-28",0,0,0,0,0,0,0,0
"Guinea","2024-02-29",0,0,0,0,0,0,0,0
"Guinea","2024-03-01",0,0,0,0,0,0,0,0
"Guinea","2024-03-02",0,0,0,0,0,0,0,0
"Guinea","2024-03-03",0,0,0,0,0,0,0,0
"Guinea","2024-03-04",0,0,0,0,0,0,0,0
"Guinea","2024-03-05",0,0,0,0,0,0,0,0
"Guinea","2024-03-06",0,0,0,0,0,0,0,0
"Guinea","2024-03-07",0,0,0,0,0,0,0,0
"Guinea","2024-03-08",0,0,0,0,0,0,0,0
"Guinea","2024-03-09",0,0,0,0,0,0,0,0
"Guinea","2024-03-10",0,0,0,0,0,0,0,0
"Guinea","2024-03-11",0,0,0,0,0,0,0,0
"Guinea","2024-03-12",0,0,0,0,0,0,0,0
"Guinea","2024-03-13",0,0,0,0,0,0,0,0
"Guinea","2024-03-14",0,0,0,0,0,0,0,0
"Guinea","2024-03-15",0,0,0,0,0,0,0,0
"Guinea","2024-03-16",0,0,0,0,0,0,0,0
"Guinea","2024-03-17",0,0,0,0,0,0,0,0
"Guinea","2024-03-18",0,0,0,0,0,0,0,0
"Guinea","2024-03-19",0,0,0,0,0,0,0,0
"Guinea","2024-03-20",0,0,0,0,0,0,0,0
"Guinea","2024-03-21",0,0,0,0,0,0,0,0
"Guinea","2024-03-22",0,0,0,0,0,0,0,0
"Guinea","2024-03-23",0,0,0,0,0,0,0,0
"Guinea","2024-03-24",0,0,0,0,0,0,0,0
"Guinea","2024-03-25",0,0,0,0,0,0,0,0
"Guinea","2024-03-26",0,0,0,0,0,0,0,0
"Guinea","2024-03-27",0,0,0,0,0,0,0,0
"Guinea","2024-03-28",0,0,0,0,0,0,0,0
"Guinea","2024-03-29",0,0,0,0,0,0,0,0
"Guinea","2024-03-30",0,0,0,0,0,0,0,0
"Guinea","2024-03-31",0,0,0,0,0,0,0,0
"Guinea","2024-04-01",0,0,0,0,0,0,0,0
"Guinea","2024-04-02",0,0,0,0,0,0,0,0
"Guinea","2024-04-03",0,0,0,0,0,0,0,0
"Guinea","2024-04-04",0,0,0,0,0,0,0,0
"Guinea","2024-04-05",0,0,0,0,0,0,0,0
"Guinea","2024-04-06",0,0,0,0,0,0,0,0
"Guinea","2024-04-07",0,0,0,0,0,0,0,0
"Guinea","2024-04-08",0,0,0,0,0,0,0,0
"Guinea","2024-04-09",0,0,0,0,0,0,0,0
"Guinea","2024-04-10",0,0,0,0,0,0,0,0
"Guinea","2024-04-11",0,0,0,0,0,0,0,0
"Guinea","2024-04-12",0,0,0,0,0,0,0,0
"Guinea","2024-04-13",0,0,0,0,0,0,0,0
"Guinea","2024-04-14",0,0,0,0,0,0,0,0
"Guinea","2024-04-15",0,0,0,0,0,0,0,0
"Guinea","2024-04-16",0,0,0,0,0,0,0,0
"Guinea","2024-04-17",0,0,0,0,0,0,0,0
"Guinea","2024-04-18",0,0,0,0,0,0,0,0
"Guinea","2024-04-19",0,0,0,0,0,0,0,0
"Guinea","2024-04-20",0,0,0,0,0,0,0,0
"Guinea","2024-04-21",0,0,0,0,0,0,0,0
"Guinea","2024-04-22",0,0,0,0,0,0,0,0
"Guinea","2024-04-23",0,0,0,0,0,0,0,0
"Guinea","2024-04-24",0,0,0,0,0,0,0,0
"Guinea","2024-04-25",0,0,0,0,0,0,0,0
"Guinea","2024-04-26",0,0,0,0,0,0,0,0
"Guinea","2024-04-27",0,0,0,0,0,0,0,0
"Guinea","2024-04-28",0,0,0,0,0,0,0,0
"Guinea","2024-04-29",0,0,0,0,0,0,0,0
"Guinea","2024-04-30",0,0,0,0,0,0,0,0
"Guinea","2024-05-01",0,0,0,0,0,0,0,0
"Guinea","2024-05-02",0,0,0,0,0,0,0,0
"Guinea","2024-05-03",0,0,0,0,0,0,0,0
"Guinea","2024-05-04",0,0,0,0,0,0,0,0
"Guinea","2024-05-05",0,0,0,0,0,0,0,0
"Guinea","2024-05-06",0,0,0,0,0,0,0,0
"Guinea","2024-05-07",0,0,0,0,0,0,0,0
"Guinea","2024-05-08",0,0,0,0,0,0,0,0
"Guinea","2024-05-09",0,0,0,0,0,0,0,0
"Guinea","2024-05-10",0,0,0,0,0,0,0,0
"Guinea","2024-05-11",0,0,0,0,0,0,0,0
"Guinea","2024-05-12",0,0,0,0,0,0,0,0
"Guinea","2024-05-13",0,0,0,0,0,0,0,0
"Guinea","2024-05-14",0,0,0,0,0,0,0,0
"Guinea","2024-05-15",0,0,0,0,0,0,0,0
"Guinea","2024-05-16",0,0,0,0,0,0,0,0
"Guinea","2024-05-17",0,0,0,0,0,0,0,0
"Guinea","2024-05-18",0,0,0,0,0,0,0,0
"Guinea","2024-05-19",0,0,0,0,0,0,0,0
"Guinea","2024-05-20",0,0,0,0,0,0,0,0
"Guinea","2024-05-21",0,0,0,0,0,0,0,0
"Guinea","2024-05-22",0,0,0,0,0,0,0,0
"Guinea","2024-05-23",0,0,0,0,0,0,0,0
"Guinea","2024-05-24",0,0,0,0,0,0,0,0
"Guinea","2024-05-25",0,0,0,0,0,0,0,0
"Guinea","2024-05-26",0,0,0,0,0,0,0,0
"Guinea","2024-05-27",0,0,0,0,0,0,0,0
"Guinea","2024-05-28",0,0,0,0,0,0,0,0
"Guinea","2024-05-29",0,0,0,0,0,0,0,0
"Guinea","2024-05-30",0,0,0,0,0,0,0,0
"Guinea","2024-05-31",0,0,0,0,0,0,0,0
"Guinea","2024-06-01",0,0,0,0,0,0,0,0
"Guinea","2024-06-02",0,0,0,0,0,0,0,0
"Guinea","2024-06-03",0,0,0,0,0,0,0,0
"Guinea","2024-06-04",0,0,0,0,0,0,0,0
"Guinea","2024-06-05",0,0,0,0,0,0,0,0
"Guinea","2024-06-06",0,0,0,0,0,0,0,0
"Guinea","2024-06-07",0,0,0,0,0,0,0,0
"Guinea","2024-06-08",0,0,0,0,0,0,0,0
"Guinea","2024-06-09",0,0,0,0,0,0,0,0
"Guinea","2024-06-10",0,0,0,0,0,0,0,0
"Guinea","2024-06-11",0,0,0,0,0,0,0,0
"Guinea","2024-06-12",0,0,0,0,0,0,0,0
"Guinea","2024-06-13",0,0,0,0,0,0,0,0
"Guinea","2024-06-14",0,0,0,0,0,0,0,0
"Guinea","2024-06-15",0,0,0,0,0,0,0,0
"Guinea","2024-06-16",0,0,0,0,0,0,0,0
"Guinea","2024-06-17",0,0,0,0,0,0,0,0
"Guinea","2024-06-18",0,0,0,0,0,0,0,0
"Guinea","2024-06-19",0,0,0,0,0,0,0,0
"Guinea","2024-06-20",0,0,0,0,0,0,0,0
"Guinea","2024-06-21",0,0,0,0,0,0,0,0
"Guinea","2024-06-22",0,0,0,0,0,0,0,0
"Guinea","2024-06-23",0,0,0,0,0,0,0,0
"Guinea","2024-06-24",0,0,0,0,0,0,0,0
"Guinea","2024-06-25",0,0,0,0,0,0,0,0
"Guinea","2024-06-26",0,0,0,0,0,0,0,0
"Guinea","2024-06-27",0,0,0,0,0,0,0,0
"Guinea","2024-06-28",0,0,0,0,0,0,0,0
"Guinea","2024-06-29",0,0,0,0,0,0,0,0
"Guinea","2024-06-30",0,0,0,0,0,0,0,0
"Guinea","2024-07-01",0,0,0,0,0,0,0,0
"Guinea","2024-07-02",0,0,0,0,0,0,0,0
"Guinea","2024-07-03",0,0,0,0,0,0,0,0
"Guinea","2024-07-04",0,0,0,0,0,0,0,0
"Guinea","2024-07-05",0,0,0,0,0,0,0,0
"Guinea","2024-07-06",0,0,0,0,0,0,0,0
"Guinea","2024-07-07",0,0,0,0,0,0,0,0
"Guinea","2024-07-08",0,0,0,0,0,0,0,0
"Guinea","2024-07-09",0,0,0,0,0,0,0,0
"Guinea","2024-07-10",0,0,0,0,0,0,0,0
"Guinea","2024-07-11",0,0,0,0,0,0,0,0
"Guinea","2024-07-12",0,0,0,0,0,0,0,0
"Guinea","2024-07-13",0,0,0,0,0,0,0,0
"Guinea","2024-07-14",0,0,0,0,0,0,0,0
"Guinea","2024-07-15",0,0,0,0,0,0,0,0
"Guinea","2024-07-16",0,0,0,0,0,0,0,0
"Guinea","2024-07-17",0,0,0,0,0,0,0,0
"Guinea","2024-07-18",0,0,0,0,0,0,0,0
"Guinea","2024-07-19",0,0,0,0,0,0,0,0
"Guinea","2024-07-20",0,0,0,0,0,0,0,0
"Guinea","2024-07-21",0,0,0,0,0,0,0,0
"Guinea","2024-07-22",0,0,0,0,0,0,0,0
"Guinea","2024-07-23",0,0,0,0,0,0,0,0
"Guinea","2024-07-24",0,0,0,0,0,0,0,0
"Guinea","2024-07-25",0,0,0,0,0,0,0,0
"Guinea","2024-07-26",0,0,0,0,0,0,0,0
"Guinea","2024-07-27",0,0,0,0,0,0,0,0
"Guinea","2024-07-28",0,0,0,0,0,0,0,0
"Guinea","2024-07-29",0,0,0,0,0,0,0,0
"Guinea","2024-07-30",0,0,0,0,0,0,0,0
"Guinea","2024-07-31",0,0,0,0,0,0,0,0
"Guinea","2024-08-01",0,0,0,0,0,0,0,0
"Guinea","2024-08-02",0,0,0,0,0,0,0,0
"Guinea","2024-08-03",0,0,0,0,0,0,0,0
"Guinea","2024-08-04",0,0,0,0,0,0,0,0
"Guinea","2024-08-05",0,0,0,0,0,0,0,0
"Guinea","2024-08-06",0,0,0,0,0,0,0,0
"Guinea","2024-08-07",0,0,0,0,0,0,0,0
"Guinea","2024-08-08",0,0,0,0,0,0,0,0
"Guinea","2024-08-09",0,0,0,0,0,0,0,0
"Guinea","2024-08-10",0,0,0,0,0,0,0,0
"Guinea","2024-08-11",0,0,0,0,0,0,0,0
"Guinea","2024-08-12",0,0,0,0,0,0,0,0
"Guinea","2024-08-13",0,0,0,0,0,0,0,0
"Guinea","2024-08-14",0,0,0,0,0,0,0,0
"Guinea","2024-08-15",0,0,0,0,0,0,0,0
"Guinea","2024-08-16",0,0,0,0,0,0,0,0
"Guinea","2024-08-17",0,0,0,0,0,0,0,0
"Guinea","2024-08-18",0,0,0,0,0,0,0,0
"Guinea","2024-08-19",0,0,0,0,0,0,0,0
"Guinea","2024-08-20",0,0,0,0,0,0,0,0
"Guinea","2024-08-21",0,0,0,0,0,0,0,0
"Guinea","2024-08-22",0,0,0,0,0,0,0,0
"Guinea","2024-08-23",0,0,0,0,0,0,0,0
"Guinea","2024-08-24",0,0,0,0,0,0,0,0
"Guinea","2024-08-25",0,0,0,0,0,0,0,0
"Guinea","2024-08-26",0,0,0,0,0,0,0,0
"Guinea","2024-08-27",0,0,0,0,0,0,0,0
"Guinea","2024-08-28",0,0,0,0,0,0,0,0
"Guinea","2024-08-29",0,0,0,0,0,0,0,0
"Guinea","2024-08-30",0,0,0,0,0,0,0,0
"Guinea","2024-08-31",0,0,0,0,0,0,0,0
"Guinea","2024-09-01",0,1,1,0,1,1,0,0
"Guinea","2024-09-02",0,0,1,0,0,1,0,0
"Guinea","2024-09-03",0,0,1,0,0,1,0,0
"Guinea","2024-09-04",0,0,1,0,0,1,0,0
"Guinea","2024-09-05",0,0,1,0,0,1,0,0
"Guinea","2024-09-06",0,0,1,0,0,1,0,0
"Guinea","2024-09-07",0,0,1,0,0,1,0,0
"Guinea","2024-09-08",0,0,1,0,0,1,0,0
"Guinea","2024-09-09",0,0,1,0,0,1,0,0
"Guinea","2024-09-10",0,0,1,0,0,1,0,0
"Guinea","2024-09-11",0,0,1,0,0,1,0,0
"Guinea","2024-09-12",0,0,1,0,0,1,0,0
"Guinea","2024-09-13",0,0,1,0,0,1,0,0
"Guinea","2024-09-14",0,0,1,0,0,1,0,0
"Guinea","2024-09-15",0,0,1,0,0,1,0,0
"Guinea","2024-09-16",0,0,1,0,0,1,0,0
"Guinea","2024-09-17",0,0,1,0,0,1,0,0
"Guinea","2024-09-18",0,0,1,0,0,1,0,0
"Guinea","2024-09-19",0,0,1,0,0,1,0,0
"Guinea","2024-09-20",0,0,1,0,0,1,0,0
"Guinea","2024-09-21",0,0,1,0,0,1,0,0
"Guinea","2024-09-22",0,0,1,0,0,1,0,0
"Guinea","2024-09-23",0,0,1,0,0,1,0,0
"Guinea","2024-09-24",0,0,1,0,0,1,0,0
"Guinea","2024-09-25",0,0,1,0,0,1,0,0
"Guinea","2024-09-26",0,0,1,0,0,1,0,0
"Guinea","2024-09-27",0,0,1,0,0,1,0,0
"Guinea","2024-09-28",0,0,1,0,0,1,0,0
"Guinea","2024-09-29",0,0,1,0,0,1,0,0
"Guinea","2024-09-30",0,0,1,0,0,1,0,0
"Guinea","2024-10-01",0,0,1,0,0,1,0,0
"Guinea","2024-10-02",0,0,1,0,0,1,0,0
"Guinea","2024-10-03",0,0,1,0,0,1,0,0
"Guinea","2024-10-04",0,0,1,0,0,1,0,0
"Guinea","2024-10-05",0,0,1,0,0,1,0,0
"Guinea","2024-10-06",0,0,1,0,0,1,0,0
"Guinea","2024-10-07",0,0,1,0,0,1,0,0
"Guinea","2024-10-08",0,0,1,0,0,1,0,0
"Guinea","2024-10-09",0,0,1,0,0,1,0,0
"Guinea","2024-10-10",0,0,1,0,0,1,0,0
"Guinea","2024-10-11",0,0,1,0,0,1,0,0
"Guinea","2024-10-12",0,0,1,0,0,1,0,0
"Guinea","2024-10-13",0,0,1,0,0,1,0,0
"Guinea","2024-10-14",0,0,1,0,0,1,0,0
"Guinea","2024-10-15",0,0,1,0,0,1,0,0
"Guinea","2024-10-16",0,0,1,0,0,1,0,0
"Guinea","2024-10-17",0,0,1,0,0,1,0,0
"Guinea","2024-10-18",0,0,1,0,0,1,0,0
"Guinea","2024-10-19",0,0,1,0,0,1,0,0
"Guinea","2024-10-20",0,0,1,0,0,1,0,0
"Guinea","2024-10-21",0,0,1,0,0,1,0,0
"Guinea","2024-10-22",0,0,1,0,0,1,0,0
"Guinea","2024-10-23",0,0,1,0,0,1,0,0
"Guinea","2024-10-24",0,0,1,0,0,1,0,0
"Guinea","2024-10-25",0,0,1,0,0,1,0,0
"Guinea","2024-10-26",0,0,1,0,0,1,0,0
"Guinea","2024-10-27",0,0,1,0,0,1,0,0
"Guinea","2024-10-28",0,0,1,0,0,1,0,0
"Guinea","2024-10-29",0,0,1,0,0,1,0,0
"Guinea","2024-10-30",0,0,1,0,0,1,0,0
"Guinea","2024-10-31",0,0,1,0,0,1,0,0
"Guinea","2024-11-01",0,0,1,0,0,1,0,0
"Guinea","2024-11-02",0,0,1,0,0,1,0,0
"Guinea","2024-11-03",0,0,1,0,0,1,0,0
"Guinea","2024-11-04",0,0,1,0,0,1,0,0
"Guinea","2024-11-05",0,0,1,0,0,1,0,0
"Guinea","2024-11-06",0,0,1,0,0,1,0,0
"Guinea","2024-11-07",0,0,1,0,0,1,0,0
"Guinea","2024-11-08",0,0,1,0,0,1,0,0
"Guinea","2024-11-09",0,0,1,0,0,1,0,0
"Guinea","2024-11-10",0,0,1,0,0,1,0,0
"Guinea","2024-11-11",0,0,1,0,0,1,0,0
"Guinea","2024-11-12",0,0,1,0,0,1,0,0
"Guinea","2024-11-13",0,0,1,0,0,1,0,0
"Guinea","2024-11-14",0,0,1,0,0,1,0,0
"Guinea","2024-11-15",0,0,1,0,0,1,0,0
"Guinea","2024-11-16",0,0,1,0,0,1,0,0
"Guinea","2024-11-17",0,0,1,0,0,1,0,0
"Guinea","2024-11-18",0,0,1,0,0,1,0,0
"Guinea","2024-11-19",0,0,1,0,0,1,0,0
"Guinea","2024-11-20",0,0,1,0,0,1,0,0
"Guinea","2024-11-21",0,0,1,0,0,1,0,0
"Guinea","2024-11-22",0,0,1,0,0,1,0,0
"Guinea","2024-11-23",0,0,1,0,0,1,0,0
"Guinea","2024-11-24",0,0,1,0,0,1,0,0
"Guinea","2024-11-25",0,0,1,0,0,1,0,0
"Guinea","2024-11-26",0,0,1,0,0,1,0,0
"Guinea","2024-11-27",0,0,1,0,0,1,0,0
"Guinea","2024-11-28",0,0,1,0,0,1,0,0
"Guinea","2024-11-29",0,0,1,0,0,1,0,0
"Guinea","2024-11-30",0,0,1,0,0,1,0,0
"Guinea","2024-12-01",0,0,1,0,0,1,0,0
"Guinea","2024-12-02",0,0,1,0,0,1,0,0
"Guinea","2024-12-03",0,0,1,0,0,1,0,0
"Guinea","2024-12-04",0,0,1,0,0,1,0,0
"Guinea","2024-12-05",0,0,1,0,0,1,0,0
"Guinea","2024-12-06",0,0,1,0,0,1,0,0
"Guinea","2024-12-07",0,0,1,0,0,1,0,0
"Guinea","2024-12-08",0,0,1,0,0,1,0,0
"Guinea","2024-12-09",0,0,1,0,0,1,0,0
"Guyana","2024-01-01",0,0,0,0,0,0,0,0
"Guyana","2024-01-02",0,0,0,0,0,0,0,0
"Guyana","2024-01-03",0,0,0,0,0,0,0,0
"Guyana","2024-01-04",0,0,0,0,0,0,0,0
"Guyana","2024-01-05",0,0,0,0,0,0,0,0
"Guyana","2024-01-06",0,0,0,0,0,0,0,0
"Guyana","2024-01-07",0,0,0,0,0,0,0,0
"Guyana","2024-01-08",0,0,0,0,0,0,0,0
"Guyana","2024-01-09",0,0,0,0,0,0,0,0
"Guyana","2024-01-10",0,0,0,0,0,0,0,0
"Guyana","2024-01-11",0,0,0,0,0,0,0,0
"Guyana","2024-01-12",0,0,0,0,0,0,0,0
"Guyana","2024-01-13",0,0,0,0,0,0,0,0
"Guyana","2024-01-14",0,0,0,0,0,0,0,0
"Guyana","2024-01-15",0,0,0,0,0,0,0,0
"Guyana","2024-01-16",0,0,0,0,0,0,0,0
"Guyana","2024-01-17",0,0,0,0,0,0,0,0
"Guyana","2024-01-18",0,0,0,0,0,0,0,0
"Guyana","2024-01-19",0,0,0,0,0,0,0,0
"Guyana","2024-01-20",0,0,0,0,0,0,0,0
"Guyana","2024-01-21",0,0,0,0,0,0,0,0
"Guyana","2024-01-22",0,0,0,0,0,0,0,0
"Guyana","2024-01-23",0,0,0,0,0,0,0,0
"Guyana","2024-01-24",0,0,0,0,0,0,0,0
"Guyana","2024-01-25",0,0,0,0,0,0,0,0
"Guyana","2024-01-26",0,0,0,0,0,0,0,0
"Guyana","2024-01-27",0,0,0,0,0,0,0,0
"Guyana","2024-01-28",0,0,0,0,0,0,0,0
"Guyana","2024-01-29",0,0,0,0,0,0,0,0
"Guyana","2024-01-30",0,0,0,0,0,0,0,0
"Guyana","2024-01-31",0,0,0,0,0,0,0,0
"Guyana","2024-02-01",0,0,0,0,0,0,0,0
"Guyana","2024-02-02",0,0,0,0,0,0,0,0
"Guyana","2024-02-03",0,0,0,0,0,0,0,0
"Guyana","2024-02-04",0,0,0,0,0,0,0,0
"Guyana","2024-02-05",0,0,0,0,0,0,0,0
"Guyana","2024-02-06",0,0,0,0,0,0,0,0
"Guyana","2024-02-07",0,0,0,0,0,0,0,0
"Guyana","2024-02-08",0,0,0,0,0,0,0,0
"Guyana","2024-02-09",0,0,0,0,0,0,0,0
"Guyana","2024-02-10",0,0,0,0,0,0,0,0
"Guyana","2024-02-11",0,0,0,0,0,0,0,0
"Guyana","2024-02-12",0,0,0,0,0,0,0,0
"Guyana","2024-02-13",0,0,0,0,0,0,0,0
"Guyana","2024-02-14",0,0,0,0,0,0,0,0
"Guyana","2024-02-15",0,0,0,0,0,0,0,0
"Guyana","2024-02-16",0,0,0,0,0,0,0,0
"Guyana","2024-02-17",0,0,0,0,0,0,0,0
"Guyana","2024-02-18",0,0,0,0,0,0,0,0
"Guyana","2024-02-19",0,0,0,0,0,0,0,0
"Guyana","2024-02-20",0,0,0,0,0,0,0,0
"Guyana","2024-02-21",0,0,0,0,0,0,0,0
"Guyana","2024-02-22",0,0,0,0,0,0,0,0
"Guyana","2024-02-23",0,0,0,0,0,0,0,0
"Guyana","2024-02-24",0,0,0,0,0,0,0,0
"Guyana","2024-02-25",0,0,0,0,0,0,0,0
"Guyana","2024-02-26",0,0,0,0,0,0,0,0
"Guyana","2024-02-27",0,0,0,0,0,0,0,0
"Guyana","2024-02-28",0,0,0,0,0,0,0,0
"Guyana","2024-02-29",0,0,0,0,0,0,0,0
"Guyana","2024-03-01",0,0,0,0,0,0,0,0
"Guyana","2024-03-02",0,0,0,0,0,0,0,0
"Guyana","2024-03-03",0,0,0,0,0,0,0,0
"Guyana","2024-03-04",0,0,0,0,0,0,0,0
"Guyana","2024-03-05",0,0,0,0,0,0,0,0
"Guyana","2024-03-06",0,0,0,0,0,0,0,0
"Guyana","2024-03-07",0,0,0,0,0,0,0,0
"Guyana","2024-03-08",0,0,0,0,0,0,0,0
"Guyana","2024-03-09",0,0,0,0,0,0,0,0
"Guyana","2024-03-10",0,0,0,0,0,0,0,0
"Guyana","2024-03-11",0,0,0,0,0,0,0,0
"Guyana","2024-03-12",0,0,0,0,0,0,0,0
"Guyana","2024-03-13",0,0,0,0,0,0,0,0
"Guyana","2024-03-14",0,0,0,0,0,0,0,0
"Guyana","2024-03-15",0,0,0,0,0,0,0,0
"Guyana","2024-03-16",0,0,0,0,0,0,0,0
"Guyana","2024-03-17",0,0,0,0,0,0,0,0
"Guyana","2024-03-18",0,0,0,0,0,0,0,0
"Guyana","2024-03-19",0,0,0,0,0,0,0,0
"Guyana","2024-03-20",0,0,0,0,0,0,0,0
"Guyana","2024-03-21",0,0,0,0,0,0,0,0
"Guyana","2024-03-22",0,0,0,0,0,0,0,0
"Guyana","2024-03-23",0,0,0,0,0,0,0,0
"Guyana","2024-03-24",0,0,0,0,0,0,0,0
"Guyana","2024-03-25",0,0,0,0,0,0,0,0
"Guyana","2024-03-26",0,0,0,0,0,0,0,0
"Guyana","2024-03-27",0,0,0,0,0,0,0,0
"Guyana","2024-03-28",0,0,0,0,0,0,0,0
"Guyana","2024-03-29",0,0,0,0,0,0,0,0
"Guyana","2024-03-30",0,0,0,0,0,0,0,0
"Guyana","2024-03-31",0,0,0,0,0,0,0,0
"Guyana","2024-04-01",0,0,0,0,0,0,0,0
"Guyana","2024-04-02",0,0,0,0,0,0,0,0
"Guyana","2024-04-03",0,0,0,0,0,0,0,0
"Guyana","2024-04-04",0,0,0,0,0,0,0,0
"Guyana","2024-04-05",0,0,0,0,0,0,0,0
"Guyana","2024-04-06",0,0,0,0,0,0,0,0
"Guyana","2024-04-07",0,0,0,0,0,0,0,0
"Guyana","2024-04-08",0,0,0,0,0,0,0,0
"Guyana","2024-04-09",0,0,0,0,0,0,0,0
"Guyana","2024-04-10",0,0,0,0,0,0,0,0
"Guyana","2024-04-11",0,0,0,0,0,0,0,0
"Guyana","2024-04-12",0,0,0,0,0,0,0,0
"Guyana","2024-04-13",0,0,0,0,0,0,0,0
"Guyana","2024-04-14",0,0,0,0,0,0,0,0
"Guyana","2024-04-15",0,0,0,0,0,0,0,0
"Guyana","2024-04-16",0,0,0,0,0,0,0,0
"Guyana","2024-04-17",0,0,0,0,0,0,0,0
"Guyana","2024-04-18",0,0,0,0,0,0,0,0
"Guyana","2024-04-19",0,0,0,0,0,0,0,0
"Guyana","2024-04-20",0,0,0,0,0,0,0,0
"Guyana","2024-04-21",0,0,0,0,0,0,0,0
"Guyana","2024-04-22",0,0,0,0,0,0,0,0
"Guyana","2024-04-23",0,0,0,0,0,0,0,0
"Guyana","2024-04-24",0,0,0,0,0,0,0,0
"Guyana","2024-04-25",0,0,0,0,0,0,0,0
"Guyana","2024-04-26",0,0,0,0,0,0,0,0
"Guyana","2024-04-27",0,0,0,0,0,0,0,0
"Guyana","2024-04-28",0,0,0,0,0,0,0,0
"Guyana","2024-04-29",0,0,0,0,0,0,0,0
"Guyana","2024-04-30",0,0,0,0,0,0,0,0
"Guyana","2024-05-01",0,0,0,0,0,0,0,0
"Guyana","2024-05-02",0,0,0,0,0,0,0,0
"Guyana","2024-05-03",0,0,0,0,0,0,0,0
"Guyana","2024-05-04",0,0,0,0,0,0,0,0
"Guyana","2024-05-05",0,0,0,0,0,0,0,0
"Guyana","2024-05-06",0,0,0,0,0,0,0,0
"Guyana","2024-05-07",0,0,0,0,0,0,0,0
"Guyana","2024-05-08",0,0,0,0,0,0,0,0
"Guyana","2024-05-09",0,0,0,0,0,0,0,0
"Guyana","2024-05-10",0,0,0,0,0,0,0,0
"Guyana","2024-05-11",0,0,0,0,0,0,0,0
"Guyana","2024-05-12",0,0,0,0,0,0,0,0
"Guyana","2024-05-13",0,0,0,0,0,0,0,0
"Guyana","2024-05-14",0,0,0,0,0,0,0,0
"Guyana","2024-05-15",0,0,0,0,0,0,0,0
"Guyana","2024-05-16",0,0,0,0,0,0,0,0
"Guyana","2024-05-17",0,0,0,0,0,0,0,0
"Guyana","2024-05-18",0,0,0,0,0,0,0,0
"Guyana","2024-05-19",0,0,0,0,0,0,0,0
"Guyana","2024-05-20",0,0,0,0,0,0,0,0
"Guyana","2024-05-21",0,0,0,0,0,0,0,0
"Guyana","2024-05-22",0,0,0,0,0,0,0,0
"Guyana","2024-05-23",0,0,0,0,0,0,0,0
"Guyana","2024-05-24",0,0,0,0,0,0,0,0
"Guyana","2024-05-25",0,0,0,0,0,0,0,0
"Guyana","2024-05-26",0,0,0,0,0,0,0,0
"Guyana","2024-05-27",0,0,0,0,0,0,0,0
"Guyana","2024-05-28",0,0,0,0,0,0,0,0
"Guyana","2024-05-29",0,0,0,0,0,0,0,0
"Guyana","2024-05-30",0,0,0,0,0,0,0,0
"Guyana","2024-05-31",0,0,0,0,0,0,0,0
"Guyana","2024-06-01",0,0,0,0,0,0,0,0
"Guyana","2024-06-02",0,0,0,0,0,0,0,0
"Guyana","2024-06-03",0,0,0,0,0,0,0,0
"Guyana","2024-06-04",0,0,0,0,0,0,0,0
"Guyana","2024-06-05",0,0,0,0,0,0,0,0
"Guyana","2024-06-06",0,0,0,0,0,0,0,0
"Guyana","2024-06-07",0,0,0,0,0,0,0,0
"Guyana","2024-06-08",0,0,0,0,0,0,0,0
"Guyana","2024-06-09",0,0,0,0,0,0,0,0
"Guyana","2024-06-10",0,0,0,0,0,0,0,0
"Guyana","2024-06-11",0,0,0,0,0,0,0,0
"Guyana","2024-06-12",0,0,0,0,0,0,0,0
"Guyana","2024-06-13",0,0,0,0,0,0,0,0
"Guyana","2024-06-14",0,0,0,0,0,0,0,0
"Guyana","2024-06-15",0,0,0,0,0,0,0,0
"Guyana","2024-06-16",0,0,0,0,0,0,0,0
"Guyana","2024-06-17",0,0,0,0,0,0,0,0
"Guyana","2024-06-18",0,0,0,0,0,0,0,0
"Guyana","2024-06-19",0,0,0,0,0,0,0,0
"Guyana","2024-06-20",0,0,0,0,0,0,0,0
"Guyana","2024-06-21",0,0,0,0,0,0,0,0
"Guyana","2024-06-22",0,0,0,0,0,0,0,0
"Guyana","2024-06-23",0,0,0,0,0,0,0,0
"Guyana","2024-06-24",0,0,0,0,0,0,0,0
"Guyana","2024-06-25",0,0,0,0,0,0,0,0
"Guyana","2024-06-26",0,0,0,0,0,0,0,0
"Guyana","2024-06-27",0,0,0,0,0,0,0,0
"Guyana","2024-06-28",0,0,0,0,0,0,0,0
"Guyana","2024-06-29",0,0,0,0,0,0,0,0
"Guyana","2024-06-30",0,0,0,0,0,0,0,0
"Guyana","2024-07-01",0,0,0,0,0,0,0,0
"Guyana","2024-07-02",0,0,0,0,0,0,0,0
"Guyana","2024-07-03",0,0,0,0,0,0,0,0
"Guyana","2024-07-04",0,0,0,0,0,0,0,0
"Guyana","2024-07-05",0,0,0,0,0,0,0,0
"Guyana","2024-07-06",0,0,0,0,0,0,0,0
"Guyana","2024-07-07",0,0,0,0,0,0,0,0
"Guyana","2024-07-08",0,0,0,0,0,0,0,0
"Guyana","2024-07-09",0,0,0,0,0,0,0,0
"Guyana","2024-07-10",0,0,0,0,0,0,0,0
"Guyana","2024-07-11",0,0,0,0,0,0,0,0
"Guyana","2024-07-12",0,0,0,0,0,0,0,0
"Guyana","2024-07-13",0,0,0,0,0,0,0,0
"Guyana","2024-07-14",0,0,0,0,0,0,0,0
"Guyana","2024-07-15",0,0,0,0,0,0,0,0
"Guyana","2024-07-16",0,0,0,0,0,0,0,0
"Guyana","2024-07-17",0,0,0,0,0,0,0,0
"Guyana","2024-07-18",0,0,0,0,0,0,0,0
"Guyana","2024-07-19",0,0,0,0,0,0,0,0
"Guyana","2024-07-20",0,0,0,0,0,0,0,0
"Guyana","2024-07-21",0,0,0,0,0,0,0,0
"Guyana","2024-07-22",0,0,0,0,0,0,0,0
"Guyana","2024-07-23",0,0,0,0,0,0,0,0
"Guyana","2024-07-24",0,0,0,0,0,0,0,0
"Guyana","2024-07-25",0,0,0,0,0,0,0,0
"Guyana","2024-07-26",0,0,0,0,0,0,0,0
"Guyana","2024-07-27",0,0,0,0,0,0,0,0
"Guyana","2024-07-28",0,0,0,0,0,0,0,0
"Guyana","2024-07-29",0,0,0,0,0,0,0,0
"Guyana","2024-07-30",0,0,0,0,0,0,0,0
"Guyana","2024-07-31",0,0,0,0,0,0,0,0
"Guyana","2024-08-01",0,0,0,0,0,0,0,0
"Guyana","2024-08-02",0,0,0,0,0,0,0,0
"Guyana","2024-08-03",0,0,0,0,0,0,0,0
"Guyana","2024-08-04",0,0,0,0,0,0,0,0
"Guyana","2024-08-05",0,0,0,0,0,0,0,0
"Guyana","2024-08-06",0,0,0,0,0,0,0,0
"Guyana","2024-08-07",0,0,0,0,0,0,0,0
"Guyana","2024-08-08",0,0,0,0,0,0,0,0
"Guyana","2024-08-09",0,0,0,0,0,0,0,0
"Guyana","2024-08-10",0,0,0,0,0,0,0,0
"Guyana","2024-08-11",0,0,0,0,0,0,0,0
"Guyana","2024-08-12",0,0,0,0,0,0,0,0
"Guyana","2024-08-13",0,0,0,0,0,0,0,0
"Guyana","2024-08-14",0,0,0,0,0,0,0,0
"Guyana","2024-08-15",0,0,0,0,0,0,0,0
"Guyana","2024-08-16",0,0,0,0,0,0,0,0
"Guyana","2024-08-17",0,0,0,0,0,0,0,0
"Guyana","2024-08-18",0,0,0,0,0,0,0,0
"Guyana","2024-08-19",0,0,0,0,0,0,0,0
"Guyana","2024-08-20",0,0,0,0,0,0,0,0
"Guyana","2024-08-21",0,0,0,0,0,0,0,0
"Guyana","2024-08-22",0,0,0,0,0,0,0,0
"Guyana","2024-08-23",0,0,0,0,0,0,0,0
"Guyana","2024-08-24",0,0,0,0,0,0,0,0
"Guyana","2024-08-25",0,0,0,0,0,0,0,0
"Guyana","2024-08-26",0,0,0,0,0,0,0,0
"Guyana","2024-08-27",0,0,0,0,0,0,0,0
"Guyana","2024-08-28",0,0,0,0,0,0,0,0
"Guyana","2024-08-29",0,0,0,0,0,0,0,0
"Guyana","2024-08-30",0,0,0,0,0,0,0,0
"Guyana","2024-08-31",0,0,0,0,0,0,0,0
"Guyana","2024-09-01",0,0,0,0,0,0,0,0
"Guyana","2024-09-02",0,0,0,0,0,0,0,0
"Guyana","2024-09-03",0,0,0,0,0,0,0,0
"Guyana","2024-09-04",0,0,0,0,0,0,0,0
"Guyana","2024-09-05",0,0,0,0,0,0,0,0
"Guyana","2024-09-06",0,0,0,0,0,0,0,0
"Guyana","2024-09-07",0,0,0,0,0,0,0,0
"Guyana","2024-09-08",0,0,0,0,0,0,0,0
"Guyana","2024-09-09",0,0,0,0,0,0,0,0
"Guyana","2024-09-10",0,0,0,0,0,0,0,0
"Guyana","2024-09-11",0,0,0,0,0,0,0,0
"Guyana","2024-09-12",0,0,0,0,0,0,0,0
"Guyana","2024-09-13",0,0,0,0,0,0,0,0
"Guyana","2024-09-14",0,0,0,0,0,0,0,0
"Guyana","2024-09-15",0,0,0,0,0,0,0,0
"Guyana","2024-09-16",0,0,0,0,0,0,0,0
"Guyana","2024-09-17",0,0,0,0,0,0,0,0
"Guyana","2024-09-18",0,0,0,0,0,0,0,0
"Guyana","2024-09-19",0,0,0,0,0,0,0,0
"Guyana","2024-09-20",0,0,0,0,0,0,0,0
"Guyana","2024-09-21",0,0,0,0,0,0,0,0
"Guyana","2024-09-22",0,0,0,0,0,0,0,0
"Guyana","2024-09-23",0,0,0,0,0,0,0,0
"Guyana","2024-09-24",0,0,0,0,0,0,0,0
"Guyana","2024-09-25",0,0,0,0,0,0,0,0
"Guyana","2024-09-26",0,0,0,0,0,0,0,0
"Guyana","2024-09-27",0,0,0,0,0,0,0,0
"Guyana","2024-09-28",0,0,0,0,0,0,0,0
"Guyana","2024-09-29",0,0,0,0,0,0,0,0
"Guyana","2024-09-30",0,0,0,0,0,0,0,0
"Guyana","2024-10-01",0,0,0,0,0,0,0,0
"Guyana","2024-10-02",0,0,0,0,0,0,0,0
"Guyana","2024-10-03",0,0,0,0,0,0,0,0
"Guyana","2024-10-04",0,0,0,0,0,0,0,0
"Guyana","2024-10-05",0,0,0,0,0,0,0,0
"Guyana","2024-10-06",0,0,0,0,0,0,0,0
"Guyana","2024-10-07",0,0,0,0,0,0,0,0
"Guyana","2024-10-08",0,0,0,0,0,0,0,0
"Guyana","2024-10-09",0,0,0,0,0,0,0,0
"Guyana","2024-10-10",0,0,0,0,0,0,0,0
"Guyana","2024-10-11",0,0,0,0,0,0,0,0
"Guyana","2024-10-12",0,0,0,0,0,0,0,0
"Guyana","2024-10-13",0,0,0,0,0,0,0,0
"Guyana","2024-10-14",0,0,0,0,0,0,0,0
"Guyana","2024-10-15",0,0,0,0,0,0,0,0
"Guyana","2024-10-16",0,0,0,0,0,0,0,0
"Guyana","2024-10-17",0,0,0,0,0,0,0,0
"Guyana","2024-10-18",0,0,0,0,0,0,0,0
"Guyana","2024-10-19",0,0,0,0,0,0,0,0
"Guyana","2024-10-20",0,0,0,0,0,0,0,0
"Guyana","2024-10-21",0,0,0,0,0,0,0,0
"Guyana","2024-10-22",0,0,0,0,0,0,0,0
"Guyana","2024-10-23",0,0,0,0,0,0,0,0
"Guyana","2024-10-24",0,0,0,0,0,0,0,0
"Guyana","2024-10-25",0,0,0,0,0,0,0,0
"Guyana","2024-10-26",0,0,0,0,0,0,0,0
"Guyana","2024-10-27",0,0,0,0,0,0,0,0
"Guyana","2024-10-28",0,0,0,0,0,0,0,0
"Guyana","2024-10-29",0,0,0,0,0,0,0,0
"Guyana","2024-10-30",0,0,0,0,0,0,0,0
"Guyana","2024-10-31",0,0,0,0,0,0,0,0
"Guyana","2024-11-01",0,0,0,0,0,0,0,0
"Guyana","2024-11-02",0,0,0,0,0,0,0,0
"Guyana","2024-11-03",0,0,0,0,0,0,0,0
"Guyana","2024-11-04",0,0,0,0,0,0,0,0
"Guyana","2024-11-05",0,0,0,0,0,0,0,0
"Guyana","2024-11-06",0,0,0,0,0,0,0,0
"Guyana","2024-11-07",0,0,0,0,0,0,0,0
"Guyana","2024-11-08",0,0,0,0,0,0,0,0
"Guyana","2024-11-09",0,0,0,0,0,0,0,0
"Guyana","2024-11-10",0,0,0,0,0,0,0,0
"Guyana","2024-11-11",0,0,0,0,0,0,0,0
"Guyana","2024-11-12",0,0,0,0,0,0,0,0
"Guyana","2024-11-13",0,0,0,0,0,0,0,0
"Guyana","2024-11-14",0,0,0,0,0,0,0,0
"Guyana","2024-11-15",0,0,0,0,0,0,0,0
"Guyana","2024-11-16",0,0,0,0,0,0,0,0
"Guyana","2024-11-17",0,0,0,0,0,0,0,0
"Guyana","2024-11-18",0,0,0,0,0,0,0,0
"Guyana","2024-11-19",0,0,0,0,0,0,0,0
"Guyana","2024-11-20",0,0,0,0,0,0,0,0
"Guyana","2024-11-21",0,0,0,0,0,0,0,0
"Guyana","2024-11-22",0,0,0,0,0,0,0,0
"Guyana","2024-11-23",0,0,0,0,0,0,0,0
"Guyana","2024-11-24",0,0,0,0,0,0,0,0
"Guyana","2024-11-25",0,0,0,0,0,0,0,0
"Guyana","2024-11-26",0,0,0,0,0,0,0,0
"Guyana","2024-11-27",0,0,0,0,0,0,0,0
"Guyana","2024-11-28",0,0,0,0,0,0,0,0
"Guyana","2024-11-29",0,0,0,0,0,0,0,0
"Guyana","2024-11-30",0,0,0,0,0,0,0,0
"Guyana","2024-12-01",0,0,0,0,0,0,0,0
"Guyana","2024-12-02",0,0,0,0,0,0,0,0
"Guyana","2024-12-03",0,0,0,0,0,0,0,0
"Guyana","2024-12-04",0,0,0,0,0,0,0,0
"Guyana","2024-12-05",0,0,0,0,0,0,0,0
"Guyana","2024-12-06",0,0,0,0,0,0,0,0
"Guyana","2024-12-07",0,0,0,0,0,0,0,0
"Guyana","2024-12-08",0,0,0,0,0,0,0,0
"Guyana","2024-12-09",0,0,0,0,0,0,0,0
"Honduras","2024-01-01",0,0,0,0,0,0,0,0
"Honduras","2024-01-02",0,0,0,0,0,0,0,0
"Honduras","2024-01-03",0,0,0,0,0,0,0,0
"Honduras","2024-01-04",0,0,0,0,0,0,0,0
"Honduras","2024-01-05",0,0,0,0,0,0,0,0
"Honduras","2024-01-06",0,0,0,0,0,0,0,0
"Honduras","2024-01-07",0,0,0,0,0,0,0,0
"Honduras","2024-01-08",0,0,0,0,0,0,0,0
"Honduras","2024-01-09",0,0,0,0,0,0,0,0
"Honduras","2024-01-10",0,0,0,0,0,0,0,0
"Honduras","2024-01-11",0,0,0,0,0,0,0,0
"Honduras","2024-01-12",0,0,0,0,0,0,0,0
"Honduras","2024-01-13",0,0,0,0,0,0,0,0
"Honduras","2024-01-14",0,0,0,0,0,0,0,0
"Honduras","2024-01-15",0,0,0,0,0,0,0,0
"Honduras","2024-01-16",0,0,0,0,0,0,0,0
"Honduras","2024-01-17",0,0,0,0,0,0,0,0
"Honduras","2024-01-18",0,0,0,0,0,0,0,0
"Honduras","2024-01-19",0,0,0,0,0,0,0,0
"Honduras","2024-01-20",0,0,0,0,0,0,0,0
"Honduras","2024-01-21",0,0,0,0,0,0,0,0
"Honduras","2024-01-22",0,0,0,0,0,0,0,0
"Honduras","2024-01-23",0,0,0,0,0,0,0,0
"Honduras","2024-01-24",0,0,0,0,0,0,0,0
"Honduras","2024-01-25",0,0,0,0,0,0,0,0
"Honduras","2024-01-26",0,0,0,0,0,0,0,0
"Honduras","2024-01-27",0,0,0,0,0,0,0,0
"Honduras","2024-01-28",0,0,0,0,0,0,0,0
"Honduras","2024-01-29",0,0,0,0,0,0,0,0
"Honduras","2024-01-30",0,0,0,0,0,0,0,0
"Honduras","2024-01-31",0,0,0,0,0,0,0,0
"Honduras","2024-02-01",0,0,0,0,0,0,0,0
"Honduras","2024-02-02",0,0,0,0,0,0,0,0
"Honduras","2024-02-03",0,0,0,0,0,0,0,0
"Honduras","2024-02-04",0,0,0,0,0,0,0,0
"Honduras","2024-02-05",0,0,0,0,0,0,0,0
"Honduras","2024-02-06",0,0,0,0,0,0,0,0
"Honduras","2024-02-07",0,0,0,0,0,0,0,0
"Honduras","2024-02-08",0,0,0,0,0,0,0,0
"Honduras","2024-02-09",0,0,0,0,0,0,0,0
"Honduras","2024-02-10",0,0,0,0,0,0,0,0
"Honduras","2024-02-11",0,0,0,0,0,0,0,0
"Honduras","2024-02-12",0,0,0,0,0,0,0,0
"Honduras","2024-02-13",0,0,0,0,0,0,0,0
"Honduras","2024-02-14",0,0,0,0,0,0,0,0
"Honduras","2024-02-15",0,0,0,0,0,0,0,0
"Honduras","2024-02-16",0,0,0,0,0,0,0,0
"Honduras","2024-02-17",0,0,0,0,0,0,0,0
"Honduras","2024-02-18",0,0,0,0,0,0,0,0
"Honduras","2024-02-19",0,0,0,0,0,0,0,0
"Honduras","2024-02-20",0,0,0,0,0,0,0,0
"Honduras","2024-02-21",0,0,0,0,0,0,0,0
"Honduras","2024-02-22",0,0,0,0,0,0,0,0
"Honduras","2024-02-23",0,0,0,0,0,0,0,0
"Honduras","2024-02-24",0,0,0,0,0,0,0,0
"Honduras","2024-02-25",0,0,0,0,0,0,0,0
"Honduras","2024-02-26",0,0,0,0,0,0,0,0
"Honduras","2024-02-27",0,0,0,0,0,0,0,0
"Honduras","2024-02-28",0,0,0,0,0,0,0,0
"Honduras","2024-02-29",0,0,0,0,0,0,0,0
"Honduras","2024-03-01",0,0,0,0,0,0,0,0
"Honduras","2024-03-02",0,0,0,0,0,0,0,0
"Honduras","2024-03-03",0,0,0,0,0,0,0,0
"Honduras","2024-03-04",0,0,0,0,0,0,0,0
"Honduras","2024-03-05",0,0,0,0,0,0,0,0
"Honduras","2024-03-06",0,0,0,0,0,0,0,0
"Honduras","2024-03-07",0,0,0,0,0,0,0,0
"Honduras","2024-03-08",0,0,0,0,0,0,0,0
"Honduras","2024-03-09",0,0,0,0,0,0,0,0
"Honduras","2024-03-10",0,0,0,0,0,0,0,0
"Honduras","2024-03-11",0,0,0,0,0,0,0,0
"Honduras","2024-03-12",0,0,0,0,0,0,0,0
"Honduras","2024-03-13",0,0,0,0,0,0,0,0
"Honduras","2024-03-14",0,0,0,0,0,0,0,0
"Honduras","2024-03-15",0,0,0,0,0,0,0,0
"Honduras","2024-03-16",0,0,0,0,0,0,0,0
"Honduras","2024-03-17",0,0,0,0,0,0,0,0
"Honduras","2024-03-18",0,0,0,0,0,0,0,0
"Honduras","2024-03-19",0,0,0,0,0,0,0,0
"Honduras","2024-03-20",0,0,0,0,0,0,0,0
"Honduras","2024-03-21",0,0,0,0,0,0,0,0
"Honduras","2024-03-22",0,0,0,0,0,0,0,0
"Honduras","2024-03-23",0,0,0,0,0,0,0,0
"Honduras","2024-03-24",0,0,0,0,0,0,0,0
"Honduras","2024-03-25",0,0,0,0,0,0,0,0
"Honduras","2024-03-26",0,0,0,0,0,0,0,0
"Honduras","2024-03-27",0,0,0,0,0,0,0,0
"Honduras","2024-03-28",0,0,0,0,0,0,0,0
"Honduras","2024-03-29",0,0,0,0,0,0,0,0
"Honduras","2024-03-30",0,0,0,0,0,0,0,0
"Honduras","2024-03-31",0,0,0,0,0,0,0,0
"Honduras","2024-04-01",0,0,0,0,0,0,0,0
"Honduras","2024-04-02",0,0,0,0,0,0,0,0
"Honduras","2024-04-03",0,0,0,0,0,0,0,0
"Honduras","2024-04-04",0,0,0,0,0,0,0,0
"Honduras","2024-04-05",0,0,0,0,0,0,0,0
"Honduras","2024-04-06",0,0,0,0,0,0,0,0
"Honduras","2024-04-07",0,0,0,0,0,0,0,0
"Honduras","2024-04-08",0,0,0,0,0,0,0,0
"Honduras","2024-04-09",0,0,0,0,0,0,0,0
"Honduras","2024-04-10",0,0,0,0,0,0,0,0
"Honduras","2024-04-11",0,0,0,0,0,0,0,0
"Honduras","2024-04-12",0,0,0,0,0,0,0,0
"Honduras","2024-04-13",0,0,0,0,0,0,0,0
"Honduras","2024-04-14",0,0,0,0,0,0,0,0
"Honduras","2024-04-15",0,0,0,0,0,0,0,0
"Honduras","2024-04-16",0,0,0,0,0,0,0,0
"Honduras","2024-04-17",0,0,0,0,0,0,0,0
"Honduras","2024-04-18",0,0,0,0,0,0,0,0
"Honduras","2024-04-19",0,0,0,0,0,0,0,0
"Honduras","2024-04-20",0,0,0,0,0,0,0,0
"Honduras","2024-04-21",0,0,0,0,0,0,0,0
"Honduras","2024-04-22",0,0,0,0,0,0,0,0
"Honduras","2024-04-23",0,0,0,0,0,0,0,0
"Honduras","2024-04-24",0,0,0,0,0,0,0,0
"Honduras","2024-04-25",0,0,0,0,0,0,0,0
"Honduras","2024-04-26",0,0,0,0,0,0,0,0
"Honduras","2024-04-27",0,0,0,0,0,0,0,0
"Honduras","2024-04-28",0,0,0,0,0,0,0,0
"Honduras","2024-04-29",0,0,0,0,0,0,0,0
"Honduras","2024-04-30",0,0,0,0,0,0,0,0
"Honduras","2024-05-01",0,0,0,0,0,0,0,0
"Honduras","2024-05-02",0,0,0,0,0,0,0,0
"Honduras","2024-05-03",0,0,0,0,0,0,0,0
"Honduras","2024-05-04",0,0,0,0,0,0,0,0
"Honduras","2024-05-05",0,0,0,0,0,0,0,0
"Honduras","2024-05-06",0,0,0,0,0,0,0,0
"Honduras","2024-05-07",0,0,0,0,0,0,0,0
"Honduras","2024-05-08",0,0,0,0,0,0,0,0
"Honduras","2024-05-09",0,0,0,0,0,0,0,0
"Honduras","2024-05-10",0,0,0,0,0,0,0,0
"Honduras","2024-05-11",0,0,0,0,0,0,0,0
"Honduras","2024-05-12",0,0,0,0,0,0,0,0
"Honduras","2024-05-13",0,0,0,0,0,0,0,0
"Honduras","2024-05-14",0,0,0,0,0,0,0,0
"Honduras","2024-05-15",0,0,0,0,0,0,0,0
"Honduras","2024-05-16",0,0,0,0,0,0,0,0
"Honduras","2024-05-17",0,0,0,0,0,0,0,0
"Honduras","2024-05-18",0,0,0,0,0,0,0,0
"Honduras","2024-05-19",0,0,0,0,0,0,0,0
"Honduras","2024-05-20",0,0,0,0,0,0,0,0
"Honduras","2024-05-21",0,0,0,0,0,0,0,0
"Honduras","2024-05-22",0,0,0,0,0,0,0,0
"Honduras","2024-05-23",0,0,0,0,0,0,0,0
"Honduras","2024-05-24",0,0,0,0,0,0,0,0
"Honduras","2024-05-25",0,0,0,0,0,0,0,0
"Honduras","2024-05-26",0,0,0,0,0,0,0,0
"Honduras","2024-05-27",0,0,0,0,0,0,0,0
"Honduras","2024-05-28",0,0,0,0,0,0,0,0
"Honduras","2024-05-29",0,0,0,0,0,0,0,0
"Honduras","2024-05-30",0,0,0,0,0,0,0,0
"Honduras","2024-05-31",0,0,0,0,0,0,0,0
"Honduras","2024-06-01",0,0,0,0,0,0,0,0
"Honduras","2024-06-02",0,0,0,0,0,0,0,0
"Honduras","2024-06-03",0,0,0,0,0,0,0,0
"Honduras","2024-06-04",0,0,0,0,0,0,0,0
"Honduras","2024-06-05",0,0,0,0,0,0,0,0
"Honduras","2024-06-06",0,0,0,0,0,0,0,0
"Honduras","2024-06-07",0,0,0,0,0,0,0,0
"Honduras","2024-06-08",0,0,0,0,0,0,0,0
"Honduras","2024-06-09",0,0,0,0,0,0,0,0
"Honduras","2024-06-10",0,0,0,0,0,0,0,0
"Honduras","2024-06-11",0,0,0,0,0,0,0,0
"Honduras","2024-06-12",0,0,0,0,0,0,0,0
"Honduras","2024-06-13",0,0,0,0,0,0,0,0
"Honduras","2024-06-14",0,0,0,0,0,0,0,0
"Honduras","2024-06-15",0,0,0,0,0,0,0,0
"Honduras","2024-06-16",0,0,0,0,0,0,0,0
"Honduras","2024-06-17",0,0,0,0,0,0,0,0
"Honduras","2024-06-18",0,0,0,0,0,0,0,0
"Honduras","2024-06-19",0,0,0,0,0,0,0,0
"Honduras","2024-06-20",0,0,0,0,0,0,0,0
"Honduras","2024-06-21",0,0,0,0,0,0,0,0
"Honduras","2024-06-22",0,0,0,0,0,0,0,0
"Honduras","2024-06-23",0,0,0,0,0,0,0,0
"Honduras","2024-06-24",0,0,0,0,0,0,0,0
"Honduras","2024-06-25",0,0,0,0,0,0,0,0
"Honduras","2024-06-26",0,0,0,0,0,0,0,0
"Honduras","2024-06-27",0,0,0,0,0,0,0,0
"Honduras","2024-06-28",0,0,0,0,0,0,0,0
"Honduras","2024-06-29",0,0,0,0,0,0,0,0
"Honduras","2024-06-30",0,0,0,0,0,0,0,0
"Honduras","2024-07-01",0,0,0,0,0,0,0,0
"Honduras","2024-07-02",0,0,0,0,0,0,0,0
"Honduras","2024-07-03",0,0,0,0,0,0,0,0
"Honduras","2024-07-04",0,0,0,0,0,0,0,0
"Honduras","2024-07-05",0,0,0,0,0,0,0,0
"Honduras","2024-07-06",0,0,0,0,0,0,0,0
"Honduras","2024-07-07",0,0,0,0,0,0,0,0
"Honduras","2024-07-08",0,0,0,0,0,0,0,0
"Honduras","2024-07-09",0,0,0,0,0,0,0,0
"Honduras","2024-07-10",0,0,0,0,0,0,0,0
"Honduras","2024-07-11",0,0,0,0,0,0,0,0
"Honduras","2024-07-12",0,0,0,0,0,0,0,0
"Honduras","2024-07-13",0,0,0,0,0,0,0,0
"Honduras","2024-07-14",0,0,0,0,0,0,0,0
"Honduras","2024-07-15",0,0,0,0,0,0,0,0
"Honduras","2024-07-16",0,0,0,0,0,0,0,0
"Honduras","2024-07-17",0,0,0,0,0,0,0,0
"Honduras","2024-07-18",0,0,0,0,0,0,0,0
"Honduras","2024-07-19",0,0,0,0,0,0,0,0
"Honduras","2024-07-20",0,0,0,0,0,0,0,0
"Honduras","2024-07-21",0,0,0,0,0,0,0,0
"Honduras","2024-07-22",0,0,0,0,0,0,0,0
"Honduras","2024-07-23",0,0,0,0,0,0,0,0
"Honduras","2024-07-24",0,0,0,0,0,0,0,0
"Honduras","2024-07-25",0,0,0,0,0,0,0,0
"Honduras","2024-07-26",0,0,0,0,0,0,0,0
"Honduras","2024-07-27",0,0,0,0,0,0,0,0
"Honduras","2024-07-28",0,0,0,0,0,0,0,0
"Honduras","2024-07-29",0,0,0,0,0,0,0,0
"Honduras","2024-07-30",0,0,0,0,0,0,0,0
"Honduras","2024-07-31",0,0,0,0,0,0,0,0
"Honduras","2024-08-01",0,0,0,0,0,0,0,0
"Honduras","2024-08-02",0,0,0,0,0,0,0,0
"Honduras","2024-08-03",0,0,0,0,0,0,0,0
"Honduras","2024-08-04",0,0,0,0,0,0,0,0
"Honduras","2024-08-05",0,0,0,0,0,0,0,0
"Honduras","2024-08-06",0,0,0,0,0,0,0,0
"Honduras","2024-08-07",0,0,0,0,0,0,0,0
"Honduras","2024-08-08",0,0,0,0,0,0,0,0
"Honduras","2024-08-09",0,0,0,0,0,0,0,0
"Honduras","2024-08-10",0,0,0,0,0,0,0,0
"Honduras","2024-08-11",0,0,0,0,0,0,0,0
"Honduras","2024-08-12",0,0,0,0,0,0,0,0
"Honduras","2024-08-13",0,0,0,0,0,0,0,0
"Honduras","2024-08-14",0,0,0,0,0,0,0,0
"Honduras","2024-08-15",0,0,0,0,0,0,0,0
"Honduras","2024-08-16",0,0,0,0,0,0,0,0
"Honduras","2024-08-17",0,0,0,0,0,0,0,0
"Honduras","2024-08-18",0,0,0,0,0,0,0,0
"Honduras","2024-08-19",0,0,0,0,0,0,0,0
"Honduras","2024-08-20",0,0,0,0,0,0,0,0
"Honduras","2024-08-21",0,0,0,0,0,0,0,0
"Honduras","2024-08-22",0,0,0,0,0,0,0,0
"Honduras","2024-08-23",0,0,0,0,0,0,0,0
"Honduras","2024-08-24",0,0,0,0,0,0,0,0
"Honduras","2024-08-25",0,0,0,0,0,0,0,0
"Honduras","2024-08-26",0,0,0,0,0,0,0,0
"Honduras","2024-08-27",0,0,0,0,0,0,0,0
"Honduras","2024-08-28",0,0,0,0,0,0,0,0
"Honduras","2024-08-29",0,0,0,0,0,0,0,0
"Honduras","2024-08-30",0,0,0,0,0,0,0,0
"Honduras","2024-08-31",0,0,0,0,0,0,0,0
"Honduras","2024-09-01",0,0,0,0,0,0,0,0
"Honduras","2024-09-02",0,0,0,0,0,0,0,0
"Honduras","2024-09-03",0,0,0,0,0,0,0,0
"Honduras","2024-09-04",0,0,0,0,0,0,0,0
"Honduras","2024-09-05",0,0,0,0,0,0,0,0
"Honduras","2024-09-06",0,0,0,0,0,0,0,0
"Honduras","2024-09-07",0,0,0,0,0,0,0,0
"Honduras","2024-09-08",0,0,0,0,0,0,0,0
"Honduras","2024-09-09",0,0,0,0,0,0,0,0
"Honduras","2024-09-10",0,0,0,0,0,0,0,0
"Honduras","2024-09-11",0,0,0,0,0,0,0,0
"Honduras","2024-09-12",0,0,0,0,0,0,0,0
"Honduras","2024-09-13",0,0,0,0,0,0,0,0
"Honduras","2024-09-14",0,0,0,0,0,0,0,0
"Honduras","2024-09-15",0,0,0,0,0,0,0,0
"Honduras","2024-09-16",0,0,0,0,0,0,0,0
"Honduras","2024-09-17",0,0,0,0,0,0,0,0
"Honduras","2024-09-18",0,0,0,0,0,0,0,0
"Honduras","2024-09-19",0,0,0,0,0,0,0,0
"Honduras","2024-09-20",0,0,0,0,0,0,0,0
"Honduras","2024-09-21",0,0,0,0,0,0,0,0
"Honduras","2024-09-22",0,0,0,0,0,0,0,0
"Honduras","2024-09-23",0,0,0,0,0,0,0,0
"Honduras","2024-09-24",0,0,0,0,0,0,0,0
"Honduras","2024-09-25",0,0,0,0,0,0,0,0
"Honduras","2024-09-26",0,0,0,0,0,0,0,0
"Honduras","2024-09-27",0,0,0,0,0,0,0,0
"Honduras","2024-09-28",0,0,0,0,0,0,0,0
"Honduras","2024-09-29",0,0,0,0,0,0,0,0
"Honduras","2024-09-30",0,0,0,0,0,0,0,0
"Honduras","2024-10-01",0,0,0,0,0,0,0,0
"Honduras","2024-10-02",0,0,0,0,0,0,0,0
"Honduras","2024-10-03",0,0,0,0,0,0,0,0
"Honduras","2024-10-04",0,0,0,0,0,0,0,0
"Honduras","2024-10-05",0,0,0,0,0,0,0,0
"Honduras","2024-10-06",0,0,0,0,0,0,0,0
"Honduras","2024-10-07",0,0,0,0,0,0,0,0
"Honduras","2024-10-08",0,0,0,0,0,0,0,0
"Honduras","2024-10-09",0,0,0,0,0,0,0,0
"Honduras","2024-10-10",0,0,0,0,0,0,0,0
"Honduras","2024-10-11",0,0,0,0,0,0,0,0
"Honduras","2024-10-12",0,0,0,0,0,0,0,0
"Honduras","2024-10-13",0,0,0,0,0,0,0,0
"Honduras","2024-10-14",0,0,0,0,0,0,0,0
"Honduras","2024-10-15",0,0,0,0,0,0,0,0
"Honduras","2024-10-16",0,0,0,0,0,0,0,0
"Honduras","2024-10-17",0,0,0,0,0,0,0,0
"Honduras","2024-10-18",0,0,0,0,0,0,0,0
"Honduras","2024-10-19",0,0,0,0,0,0,0,0
"Honduras","2024-10-20",0,0,0,0,0,0,0,0
"Honduras","2024-10-21",0,0,0,0,0,0,0,0
"Honduras","2024-10-22",0,0,0,0,0,0,0,0
"Honduras","2024-10-23",0,0,0,0,0,0,0,0
"Honduras","2024-10-24",0,0,0,0,0,0,0,0
"Honduras","2024-10-25",0,0,0,0,0,0,0,0
"Honduras","2024-10-26",0,0,0,0,0,0,0,0
"Honduras","2024-10-27",0,0,0,0,0,0,0,0
"Honduras","2024-10-28",0,0,0,0,0,0,0,0
"Honduras","2024-10-29",0,0,0,0,0,0,0,0
"Honduras","2024-10-30",0,0,0,0,0,0,0,0
"Honduras","2024-10-31",0,0,0,0,0,0,0,0
"Honduras","2024-11-01",0,0,0,0,0,0,0,0
"Honduras","2024-11-02",0,0,0,0,0,0,0,0
"Honduras","2024-11-03",0,0,0,0,0,0,0,0
"Honduras","2024-11-04",0,0,0,0,0,0,0,0
"Honduras","2024-11-05",0,0,0,0,0,0,0,0
"Honduras","2024-11-06",0,0,0,0,0,0,0,0
"Honduras","2024-11-07",0,0,0,0,0,0,0,0
"Honduras","2024-11-08",0,0,0,0,0,0,0,0
"Honduras","2024-11-09",0,0,0,0,0,0,0,0
"Honduras","2024-11-10",0,0,0,0,0,0,0,0
"Honduras","2024-11-11",0,0,0,0,0,0,0,0
"Honduras","2024-11-12",0,0,0,0,0,0,0,0
"Honduras","2024-11-13",0,0,0,0,0,0,0,0
"Honduras","2024-11-14",0,0,0,0,0,0,0,0
"Honduras","2024-11-15",0,0,0,0,0,0,0,0
"Honduras","2024-11-16",0,0,0,0,0,0,0,0
"Honduras","2024-11-17",0,0,0,0,0,0,0,0
"Honduras","2024-11-18",0,0,0,0,0,0,0,0
"Honduras","2024-11-19",0,0,0,0,0,0,0,0
"Honduras","2024-11-20",0,0,0,0,0,0,0,0
"Honduras","2024-11-21",0,0,0,0,0,0,0,0
"Honduras","2024-11-22",0,0,0,0,0,0,0,0
"Honduras","2024-11-23",0,0,0,0,0,0,0,0
"Honduras","2024-11-24",0,0,0,0,0,0,0,0
"Honduras","2024-11-25",0,0,0,0,0,0,0,0
"Honduras","2024-11-26",0,0,0,0,0,0,0,0
"Honduras","2024-11-27",0,0,0,0,0,0,0,0
"Honduras","2024-11-28",0,0,0,0,0,0,0,0
"Honduras","2024-11-29",0,0,0,0,0,0,0,0
"Honduras","2024-11-30",0,0,0,0,0,0,0,0
"Honduras","2024-12-01",0,0,0,0,0,0,0,0
"Honduras","2024-12-02",0,0,0,0,0,0,0,0
"Honduras","2024-12-03",0,0,0,0,0,0,0,0
"Honduras","2024-12-04",0,0,0,0,0,0,0,0
"Honduras","2024-12-05",0,0,0,0,0,0,0,0
"Honduras","2024-12-06",0,0,0,0,0,0,0,0
"Honduras","2024-12-07",0,0,0,0,0,0,0,0
"Honduras","2024-12-08",0,0,0,0,0,0,0,0
"Honduras","2024-12-09",0,0,0,0,0,0,0,0
"Hungary","2024-01-01",0,0,0,0,0,0,0,0
"Hungary","2024-01-02",0,0,0,0,0,0,0,0
"Hungary","2024-01-03",0,0,0,0,0,0,0,0
"Hungary","2024-01-04",0,0,0,0,0,0,0,0
"Hungary","2024-01-05",0,0,0,0,0,0,0,0
"Hungary","2024-01-06",0,0,0,0,0,0,0,0
"Hungary","2024-01-07",0,0,0,0,0,0,0,0
"Hungary","2024-01-08",0,0,0,0,0,0,0,0
"Hungary","2024-01-09",0,0,0,0,0,0,0,0
"Hungary","2024-01-10",0,0,0,0,0,0,0,0
"Hungary","2024-01-11",0,0,0,0,0,0,0,0
"Hungary","2024-01-12",0,0,0,0,0,0,0,0
"Hungary","2024-01-13",0,0,0,0,0,0,0,0
"Hungary","2024-01-14",0,0,0,0,0,0,0,0
"Hungary","2024-01-15",0,0,0,0,0,0,0,0
"Hungary","2024-01-16",0,0,0,0,0,0,0,0
"Hungary","2024-01-17",0,0,0,0,0,0,0,0
"Hungary","2024-01-18",0,0,0,0,0,0,0,0
"Hungary","2024-01-19",0,0,0,0,0,0,0,0
"Hungary","2024-01-20",0,0,0,0,0,0,0,0
"Hungary","2024-01-21",0,0,0,0,0,0,0,0
"Hungary","2024-01-22",0,0,0,0,0,0,0,0
"Hungary","2024-01-23",0,0,0,0,0,0,0,0
"Hungary","2024-01-24",0,0,0,0,0,0,0,0
"Hungary","2024-01-25",0,0,0,0,0,0,0,0
"Hungary","2024-01-26",0,0,0,0,0,0,0,0
"Hungary","2024-01-27",0,0,0,0,0,0,0,0
"Hungary","2024-01-28",0,0,0,0,0,0,0,0
"Hungary","2024-01-29",0,0,0,0,0,0,0,0
"Hungary","2024-01-30",0,0,0,0,0,0,0,0
"Hungary","2024-01-31",0,1,1,0,1,1,0,0
"Hungary","2024-02-01",0,0,1,0,0,1,0,0
"Hungary","2024-02-02",0,0,1,0,0,1,0,0
"Hungary","2024-02-03",0,0,1,0,0,1,0,0
"Hungary","2024-02-04",0,0,1,0,0,1,0,0
"Hungary","2024-02-05",0,0,1,0,0,1,0,0
"Hungary","2024-02-06",0,0,1,0,0,1,0,0
"Hungary","2024-02-07",0,0,1,0,0,1,0,0
"Hungary","2024-02-08",0,0,1,0,0,1,0,0
"Hungary","2024-02-09",0,0,1,0,0,1,0,0
"Hungary","2024-02-10",0,0,1,0,0,1,0,0
"Hungary","2024-02-11",0,0,1,0,0,1,0,0
"Hungary","2024-02-12",0,0,1,0,0,1,0,0
"Hungary","2024-02-13",0,0,1,0,0,1,0,0
"Hungary","2024-02-14",0,0,1,0,0,1,0,0
"Hungary","2024-02-15",0,0,1,0,0,1,0,0
"Hungary","2024-02-16",0,0,1,0,0,1,0,0
"Hungary","2024-02-17",0,0,1,0,0,1,0,0
"Hungary","2024-02-18",0,0,1,0,0,1,0,0
"Hungary","2024-02-19",0,0,1,0,0,1,0,0
"Hungary","2024-02-20",0,0,1,0,0,1,0,0
"Hungary","2024-02-21",0,0,1,0,0,1,0,0
"Hungary","2024-02-22",0,0,1,0,0,1,0,0
"Hungary","2024-02-23",0,0,1,0,0,1,0,0
"Hungary","2024-02-24",0,0,1,0,0,1,0,0
"Hungary","2024-02-25",0,0,1,0,0,1,0,0
"Hungary","2024-02-26",0,0,1,0,0,1,0,0
"Hungary","2024-02-27",0,0,1,0,0,1,0,0
"Hungary","2024-02-28",0,0,1,0,0,1,0,0
"Hungary","2024-02-29",0,0,1,0,0,1,0,0
"Hungary","2024-03-01",0,0,1,0,0,1,0,0
"Hungary","2024-03-02",0,0,1,0,0,1,0,0
"Hungary","2024-03-03",0,0,1,0,0,1,0,0
"Hungary","2024-03-04",0,0,1,0,0,1,0,0
"Hungary","2024-03-05",0,0,1,0,0,1,0,0
"Hungary","2024-03-06",0,0,1,0,0,1,0,0
"Hungary","2024-03-07",0,0,1,0,0,1,0,0
"Hungary","2024-03-08",0,0,1,0,0,1,0,0
"Hungary","2024-03-09",0,0,1,0,1,2,0,0
"Hungary","2024-03-10",0,0,1,0,0,2,0,0
"Hungary","2024-03-11",0,0,1,0,0,2,0,0
"Hungary","2024-03-12",0,0,1,0,0,2,0,0
"Hungary","2024-03-13",0,0,1,0,0,2,0,0
"Hungary","2024-03-14",0,0,1,0,0,2,0,0
"Hungary","2024-03-15",0,0,1,0,0,2,0,0
"Hungary","2024-03-16",0,0,1,0,0,2,0,0
"Hungary","2024-03-17",0,0,1,0,0,2,0,0
"Hungary","2024-03-18",0,0,1,0,0,2,0,0
"Hungary","2024-03-19",0,0,1,0,0,2,0,0
"Hungary","2024-03-20",0,0,1,0,0,2,0,0
"Hungary","2024-03-21",0,0,1,0,0,2,0,0
"Hungary","2024-03-22",0,0,1,0,0,2,0,0
"Hungary","2024-03-23",0,0,1,0,0,2,0,0
"Hungary","2024-03-24",0,0,1,0,0,2,0,0
"Hungary","2024-03-25",0,0,1,0,0,2,0,0
"Hungary","2024-03-26",0,0,1,0,0,2,0,0
"Hungary","2024-03-27",0,0,1,0,0,2,0,0
"Hungary","2024-03-28",0,0,1,0,0,2,0,0
"Hungary","2024-03-29",0,0,1,0,0,2,0,0
"Hungary","2024-03-30",0,0,1,0,0,2,0,0
"Hungary","2024-03-31",0,0,1,0,0,2,0,0
"Hungary","2024-04-01",0,0,1,0,0,2,0,0
"Hungary","2024-04-02",0,0,1,0,0,2,0,0
"Hungary","2024-04-03",0,0,1,0,0,2,0,0
"Hungary","2024-04-04",0,0,1,0,0,2,0,0
"Hungary","2024-04-05",0,0,1,0,0,2,0,0
"Hungary","2024-04-06",0,0,1,0,0,2,0,0
"Hungary","2024-04-07",0,0,1,0,0,2,0,0
"Hungary","2024-04-08",0,0,1,0,0,2,0,0
"Hungary","2024-04-09",0,0,1,0,0,2,0,0
"Hungary","2024-04-10",0,0,1,0,0,2,0,0
"Hungary","2024-04-11",0,0,1,0,0,2,0,0
"Hungary","2024-04-12",0,0,1,0,0,2,0,0
"Hungary","2024-04-13",0,0,1,0,0,2,0,0
"Hungary","2024-04-14",0,0,1,0,0,2,0,0
"Hungary","2024-04-15",0,0,1,0,0,2,0,0
"Hungary","2024-04-16",0,0,1,0,0,2,0,0
"Hungary","2024-04-17",0,0,1,0,0,2,0,0
"Hungary","2024-04-18",0,0,1,0,0,2,0,0
"Hungary","2024-04-19",0,0,1,0,0,2,0,0
"Hungary","2024-04-20",0,0,1,0,0,2,0,0
"Hungary","2024-04-21",0,0,1,0,0,2,0,0
"Hungary","2024-04-22",0,0,1,0,0,2,0,0
"Hungary","2024-04-23",0,0,1,0,0,2,0,0
"Hungary","2024-04-24",0,0,1,0,0,2,0,0
"Hungary","2024-04-25",0,0,1,0,0,2,0,0
"Hungary","2024-04-26",0,0,1,0,0,2,0,0
"Hungary","2024-04-27",0,0,1,0,0,2,0,0
"Hungary","2024-04-28",0,0,1,0,0,2,0,0
"Hungary","2024-04-29",0,0,1,0,0,2,0,0
"Hungary","2024-04-30",0,0,1,0,0,2,0,0
"Hungary","2024-05-01",0,0,1,0,0,2,0,0
"Hungary","2024-05-02",0,0,1,0,0,2,0,0
"Hungary","2024-05-03",0,0,1,0,0,2,0,0
"Hungary","2024-05-04",0,0,1,0,0,2,0,0
"Hungary","2024-05-05",0,0,1,0,0,2,0,0
"Hungary","2024-05-06",0,0,1,0,0,2,0,0
"Hungary","2024-05-07",0,0,1,0,0,2,0,0
"Hungary","2024-05-08",0,0,1,0,0,2,0,0
"Hungary","2024-05-09",0,0,1,0,0,2,0,0
"Hungary","2024-05-10",0,0,1,0,0,2,0,0
"Hungary","2024-05-11",0,0,1,0,0,2,0,0
"Hungary","2024-05-12",0,0,1,0,0,2,0,0
"Hungary","2024-05-13",0,0,1,0,0,2,0,0
"Hungary","2024-05-14",0,0,1,0,0,2,0,0
"Hungary","2024-05-15",0,0,1,0,0,2,0,0
"Hungary","2024-05-16",0,0,1,0,0,2,0,0
"Hungary","2024-05-17",0,0,1,0,0,2,0,0
"Hungary","2024-05-18",0,0,1,0,0,2,0,0
"Hungary","2024-05-19",0,0,1,0,0,2,0,0
"Hungary","2024-05-20",0,0,1,0,0,2,0,0
"Hungary","2024-05-21",0,0,1,0,0,2,0,0
"Hungary","2024-05-22",0,0,1,0,0,2,0,0
"Hungary","2024-05-23",0,0,1,0,0,2,0,0
"Hungary","2024-05-24",0,0,1,0,1,3,0,0
"Hungary","2024-05-25",0,0,1,0,0,3,0,0
"Hungary","2024-05-26",0,0,1,0,0,3,0,0
"Hungary","2024-05-27",0,0,1,0,0,3,0,0
"Hungary","2024-05-28",0,0,1,0,0,3,0,0
"Hungary","2024-05-29",0,0,1,0,0,3,0,0
"Hungary","2024-05-30",0,0,1,0,0,3,0,0
"Hungary","2024-05-31",0,0,1,0,0,3,0,0
"Hungary","2024-06-01",0,0,1,0,0,3,0,0
"Hungary","2024-06-02",0,0,1,0,0,3,0,0
"Hungary","2024-06-03",0,0,1,0,0,3,0,0
"Hungary","2024-06-04",0,0,1,0,0,3,0,0
"Hungary","2024-06-05",0,0,1,0,0,3,0,0
"Hungary","2024-06-06",0,0,1,0,0,3,0,0
"Hungary","2024-06-07",0,0,1,0,0,3,0,0
"Hungary","2024-06-08",0,0,1,0,0,3,0,0
"Hungary","2024-06-09",0,0,1,0,0,3,0,0
"Hungary","2024-06-10",0,0,1,0,0,3,0,0
"Hungary","2024-06-11",0,0,1,0,0,3,0,0
"Hungary","2024-06-12",0,0,1,0,0,3,0,0
"Hungary","2024-06-13",0,0,1,0,0,3,0,0
"Hungary","2024-06-14",0,0,1,0,0,3,0,0
"Hungary","2024-06-15",0,0,1,0,0,3,0,0
"Hungary","2024-06-16",0,0,1,0,0,3,0,0
"Hungary","2024-06-17",0,0,1,0,0,3,0,0
"Hungary","2024-06-18",0,0,1,0,0,3,0,0
"Hungary","2024-06-19",0,0,1,0,0,3,0,0
"Hungary","2024-06-20",0,0,1,0,0,3,0,0
"Hungary","2024-06-21",0,0,1,0,0,3,0,0
"Hungary","2024-06-22",0,0,1,0,0,3,0,0
"Hungary","2024-06-23",0,0,1,0,0,3,0,0
"Hungary","2024-06-24",0,0,1,0,0,3,0,0
"Hungary","2024-06-25",0,0,1,0,0,3,0,0
"Hungary","2024-06-26",0,0,1,0,0,3,0,0
"Hungary","2024-06-27",0,0,1,0,0,3,0,0
"Hungary","2024-06-28",0,0,1,0,0,3,0,0
"Hungary","2024-06-29",0,0,1,0,0,3,0,0
"Hungary","2024-06-30",0,2,3,0,0,3,0,0
"Hungary","2024-07-01",0,0,3,0,0,3,0,0
"Hungary","2024-07-02",0,0,3,0,0,3,0,0
"Hungary","2024-07-03",0,0,3,0,0,3,0,0
"Hungary","2024-07-04",0,0,3,0,0,3,0,0
"Hungary","2024-07-05",0,0,3,0,0,3,0,0
"Hungary","2024-07-06",0,0,3,0,0,3,0,0
"Hungary","2024-07-07",0,0,3,0,0,3,0,0
"Hungary","2024-07-08",0,0,3,0,0,3,0,0
"Hungary","2024-07-09",0,0,3,0,0,3,0,0
"Hungary","2024-07-10",0,0,3,0,0,3,0,0
"Hungary","2024-07-11",0,0,3,0,0,3,0,0
"Hungary","2024-07-12",0,0,3,0,0,3,0,0
"Hungary","2024-07-13",0,0,3,0,0,3,0,0
"Hungary","2024-07-14",0,0,3,0,0,3,0,0
"Hungary","2024-07-15",0,0,3,0,0,3,0,0
"Hungary","2024-07-16",0,0,3,0,0,3,0,0
"Hungary","2024-07-17",0,0,3,0,0,3,0,0
"Hungary","2024-07-18",0,0,3,0,0,3,0,0
"Hungary","2024-07-19",0,0,3,0,0,3,0,0
"Hungary","2024-07-20",0,0,3,0,0,3,0,0
"Hungary","2024-07-21",0,0,3,0,0,3,0,0
"Hungary","2024-07-22",0,0,3,0,0,3,0,0
"Hungary","2024-07-23",0,0,3,0,0,3,0,0
"Hungary","2024-07-24",0,0,3,0,0,3,0,0
"Hungary","2024-07-25",0,0,3,0,0,3,0,0
"Hungary","2024-07-26",0,0,3,0,0,3,0,0
"Hungary","2024-07-27",0,0,3,0,0,3,0,0
"Hungary","2024-07-28",0,0,3,0,0,3,0,0
"Hungary","2024-07-29",0,0,3,0,0,3,0,0
"Hungary","2024-07-30",0,0,3,0,0,3,0,0
"Hungary","2024-07-31",0,0,3,0,0,3,0,0
"Hungary","2024-08-01",0,0,3,0,0,3,0,0
"Hungary","2024-08-02",0,0,3,0,0,3,0,0
"Hungary","2024-08-03",0,0,3,0,0,3,0,0
"Hungary","2024-08-04",0,0,3,0,0,3,0,0
"Hungary","2024-08-05",0,0,3,0,0,3,0,0
"Hungary","2024-08-06",0,0,3,0,0,3,0,0
"Hungary","2024-08-07",0,0,3,0,0,3,0,0
"Hungary","2024-08-08",0,0,3,0,0,3,0,0
"Hungary","2024-08-09",0,0,3,0,0,3,0,0
"Hungary","2024-08-10",0,0,3,0,0,3,0,0
"Hungary","2024-08-11",0,0,3,0,0,3,0,0
"Hungary","2024-08-12",0,0,3,0,0,3,0,0
"Hungary","2024-08-13",0,0,3,0,0,3,0,0
"Hungary","2024-08-14",0,0,3,0,0,3,0,0
"Hungary","2024-08-15",0,0,3,0,0,3,0,0
"Hungary","2024-08-16",0,0,3,0,0,3,0,0
"Hungary","2024-08-17",0,0,3,0,0,3,0,0
"Hungary","2024-08-18",0,0,3,0,0,3,0,0
"Hungary","2024-08-19",0,0,3,0,0,3,0,0
"Hungary","2024-08-20",0,0,3,0,0,3,0,0
"Hungary","2024-08-21",0,0,3,0,0,3,0,0
"Hungary","2024-08-22",0,0,3,0,0,3,0,0
"Hungary","2024-08-23",0,0,3,0,0,3,0,0
"Hungary","2024-08-24",0,0,3,0,0,3,0,0
"Hungary","2024-08-25",0,0,3,0,0,3,0,0
"Hungary","2024-08-26",0,0,3,0,0,3,0,0
"Hungary","2024-08-27",0,0,3,0,0,3,0,0
"Hungary","2024-08-28",0,0,3,0,0,3,0,0
"Hungary","2024-08-29",0,0,3,0,0,3,0,0
"Hungary","2024-08-30",0,0,3,0,0,3,0,0
"Hungary","2024-08-31",0,0,3,0,0,3,0,0
"Hungary","2024-09-01",0,0,3,0,0,3,0,0
"Hungary","2024-09-02",0,0,3,0,0,3,0,0
"Hungary","2024-09-03",0,0,3,0,0,3,0,0
"Hungary","2024-09-04",0,0,3,0,0,3,0,0
"Hungary","2024-09-05",0,0,3,0,0,3,0,0
"Hungary","2024-09-06",0,0,3,0,0,3,0,0
"Hungary","2024-09-07",0,0,3,0,0,3,0,0
"Hungary","2024-09-08",0,0,3,0,0,3,0,0
"Hungary","2024-09-09",0,0,3,0,0,3,0,0
"Hungary","2024-09-10",0,0,3,0,0,3,0,0
"Hungary","2024-09-11",0,0,3,0,0,3,0,0
"Hungary","2024-09-12",0,0,3,0,0,3,0,0
"Hungary","2024-09-13",0,0,3,0,0,3,0,0
"Hungary","2024-09-14",0,0,3,0,0,3,0,0
"Hungary","2024-09-15",0,0,3,0,0,3,0,0
"Hungary","2024-09-16",0,0,3,0,0,3,0,0
"Hungary","2024-09-17",0,0,3,0,0,3,0,0
"Hungary","2024-09-18",0,0,3,0,0,3,0,0
"Hungary","2024-09-19",0,0,3,0,0,3,0,0
"Hungary","2024-09-20",0,0,3,0,0,3,0,0
"Hungary","2024-09-21",0,0,3,0,0,3,0,0
"Hungary","2024-09-22",0,0,3,0,0,3,0,0
"Hungary","2024-09-23",0,0,3,0,0,3,0,0
"Hungary","2024-09-24",0,0,3,0,0,3,0,0
"Hungary","2024-09-25",0,0,3,0,0,3,0,0
"Hungary","2024-09-26",0,0,3,0,0,3,0,0
"Hungary","2024-09-27",0,0,3,0,0,3,0,0
"Hungary","2024-09-28",0,0,3,0,0,3,0,0
"Hungary","2024-09-29",0,0,3,0,0,3,0,0
"Hungary","2024-09-30",0,0,3,0,0,3,0,0
"Hungary","2024-10-01",0,0,3,0,0,3,0,0
"Hungary","2024-10-02",0,0,3,0,0,3,0,0
"Hungary","2024-10-03",0,0,3,0,0,3,0,0
"Hungary","2024-10-04",0,0,3,0,0,3,0,0
"Hungary","2024-10-05",0,0,3,0,0,3,0,0
"Hungary","2024-10-06",0,0,3,0,0,3,0,0
"Hungary","2024-10-07",0,0,3,0,0,3,0,0
"Hungary","2024-10-08",0,0,3,0,0,3,0,0
"Hungary","2024-10-09",0,0,3,0,0,3,0,0
"Hungary","2024-10-10",0,0,3,0,0,3,0,0
"Hungary","2024-10-11",0,0,3,0,0,3,0,0
"Hungary","2024-10-12",0,0,3,0,0,3,0,0
"Hungary","2024-10-13",0,0,3,0,0,3,0,0
"Hungary","2024-10-14",0,0,3,0,0,3,0,0
"Hungary","2024-10-15",0,0,3,0,0,3,0,0
"Hungary","2024-10-16",0,0,3,0,0,3,0,0
"Hungary","2024-10-17",0,0,3,0,0,3,0,0
"Hungary","2024-10-18",0,0,3,0,0,3,0,0
"Hungary","2024-10-19",0,0,3,0,0,3,0,0
"Hungary","2024-10-20",0,0,3,0,0,3,0,0
"Hungary","2024-10-21",0,0,3,0,0,3,0,0
"Hungary","2024-10-22",0,0,3,0,0,3,0,0
"Hungary","2024-10-23",0,0,3,0,0,3,0,0
"Hungary","2024-10-24",0,0,3,0,0,3,0,0
"Hungary","2024-10-25",0,0,3,0,0,3,0,0
"Hungary","2024-10-26",0,0,3,0,0,3,0,0
"Hungary","2024-10-27",0,0,3,0,0,3,0,0
"Hungary","2024-10-28",0,0,3,0,0,3,0,0
"Hungary","2024-10-29",0,0,3,0,0,3,0,0
"Hungary","2024-10-30",0,0,3,0,0,3,0,0
"Hungary","2024-10-31",0,0,3,0,0,3,0,0
"Hungary","2024-11-01",0,0,3,0,0,3,0,0
"Hungary","2024-11-02",0,0,3,0,0,3,0,0
"Hungary","2024-11-03",0,0,3,0,0,3,0,0
"Hungary","2024-11-04",0,0,3,0,0,3,0,0
"Hungary","2024-11-05",0,0,3,0,0,3,0,0
"Hungary","2024-11-06",0,0,3,0,0,3,0,0
"Hungary","2024-11-07",0,0,3,0,0,3,0,0
"Hungary","2024-11-08",0,0,3,0,0,3,0,0
"Hungary","2024-11-09",0,0,3,0,0,3,0,0
"Hungary","2024-11-10",0,0,3,0,0,3,0,0
"Hungary","2024-11-11",0,0,3,0,0,3,0,0
"Hungary","2024-11-12",0,0,3,0,0,3,0,0
"Hungary","2024-11-13",0,0,3,0,0,3,0,0
"Hungary","2024-11-14",0,0,3,0,0,3,0,0
"Hungary","2024-11-15",0,0,3,0,0,3,0,0
"Hungary","2024-11-16",0,0,3,0,0,3,0,0
"Hungary","2024-11-17",0,0,3,0,0,3,0,0
"Hungary","2024-11-18",0,0,3,0,0,3,0,0
"Hungary","2024-11-19",0,0,3,0,0,3,0,0
"Hungary","2024-11-20",0,0,3,0,0,3,0,0
"Hungary","2024-11-21",0,0,3,0,0,3,0,0
"Hungary","2024-11-22",0,0,3,0,0,3,0,0
"Hungary","2024-11-23",0,0,3,0,0,3,0,0
"Hungary","2024-11-24",0,0,3,0,0,3,0,0
"Hungary","2024-11-25",0,0,3,0,0,3,0,0
"Hungary","2024-11-26",0,0,3,0,0,3,0,0
"Hungary","2024-11-27",0,0,3,0,0,3,0,0
"Hungary","2024-11-28",0,0,3,0,0,3,0,0
"Hungary","2024-11-29",0,0,3,0,0,3,0,0
"Hungary","2024-11-30",0,0,3,0,0,3,0,0
"Hungary","2024-12-01",0,0,3,0,0,3,0,0
"Hungary","2024-12-02",0,0,3,0,0,3,0,0
"Hungary","2024-12-03",0,0,3,0,0,3,0,0
"Hungary","2024-12-04",0,0,3,0,0,3,0,0
"Hungary","2024-12-05",0,0,3,0,0,3,0,0
"Hungary","2024-12-06",0,0,3,0,0,3,0,0
"Hungary","2024-12-07",0,0,3,0,0,3,0,0
"Hungary","2024-12-08",0,0,3,0,0,3,0,0
"Hungary","2024-12-09",0,0,3,0,0,3,0,0
"Iceland","2024-01-01",0,0,0,0,0,0,0,0
"Iceland","2024-01-02",0,0,0,0,0,0,0,0
"Iceland","2024-01-03",0,0,0,0,0,0,0,0
"Iceland","2024-01-04",0,0,0,0,0,0,0,0
"Iceland","2024-01-05",0,0,0,0,0,0,0,0
"Iceland","2024-01-06",0,0,0,0,0,0,0,0
"Iceland","2024-01-07",0,0,0,0,0,0,0,0
"Iceland","2024-01-08",0,0,0,0,0,0,0,0
"Iceland","2024-01-09",0,0,0,0,0,0,0,0
"Iceland","2024-01-10",0,0,0,0,0,0,0,0
"Iceland","2024-01-11",0,0,0,0,0,0,0,0
"Iceland","2024-01-12",0,0,0,0,0,0,0,0
"Iceland","2024-01-13",0,0,0,0,0,0,0,0
"Iceland","2024-01-14",0,0,0,0,0,0,0,0
"Iceland","2024-01-15",0,0,0,0,0,0,0,0
"Iceland","2024-01-16",0,0,0,0,0,0,0,0
"Iceland","2024-01-17",0,0,0,0,0,0,0,0
"Iceland","2024-01-18",0,0,0,0,0,0,0,0
"Iceland","2024-01-19",0,0,0,0,0,0,0,0
"Iceland","2024-01-20",0,0,0,0,0,0,0,0
"Iceland","2024-01-21",0,0,0,0,0,0,0,0
"Iceland","2024-01-22",0,0,0,0,0,0,0,0
"Iceland","2024-01-23",0,0,0,0,0,0,0,0
"Iceland","2024-01-24",0,0,0,0,0,0,0,0
"Iceland","2024-01-25",0,0,0,0,0,0,0,0
"Iceland","2024-01-26",0,0,0,0,0,0,0,0
"Iceland","2024-01-27",0,0,0,0,0,0,0,0
"Iceland","2024-01-28",0,0,0,0,0,0,0,0
"Iceland","2024-01-29",0,0,0,0,0,0,0,0
"Iceland","2024-01-30",0,0,0,0,0,0,0,0
"Iceland","2024-01-31",0,0,0,0,0,0,0,0
"Iceland","2024-02-01",0,0,0,0,0,0,0,0
"Iceland","2024-02-02",0,0,0,0,0,0,0,0
"Iceland","2024-02-03",0,0,0,0,0,0,0,0
"Iceland","2024-02-04",0,0,0,0,0,0,0,0
"Iceland","2024-02-05",0,0,0,0,0,0,0,0
"Iceland","2024-02-06",0,0,0,0,0,0,0,0
"Iceland","2024-02-07",0,0,0,0,0,0,0,0
"Iceland","2024-02-08",0,0,0,0,0,0,0,0
"Iceland","2024-02-09",0,0,0,0,0,0,0,0
"Iceland","2024-02-10",0,0,0,0,0,0,0,0
"Iceland","2024-02-11",0,0,0,0,0,0,0,0
"Iceland","2024-02-12",0,0,0,0,0,0,0,0
"Iceland","2024-02-13",0,0,0,0,0,0,0,0
"Iceland","2024-02-14",0,0,0,0,0,0,0,0
"Iceland","2024-02-15",0,0,0,0,0,0,0,0
"Iceland","2024-02-16",0,0,0,0,0,0,0,0
"Iceland","2024-02-17",0,0,0,0,0,0,0,0
"Iceland","2024-02-18",0,0,0,0,0,0,0,0
"Iceland","2024-02-19",0,0,0,0,0,0,0,0
"Iceland","2024-02-20",0,0,0,0,0,0,0,0
"Iceland","2024-02-21",0,0,0,0,0,0,0,0
"Iceland","2024-02-22",0,0,0,0,0,0,0,0
"Iceland","2024-02-23",0,0,0,0,0,0,0,0
"Iceland","2024-02-24",0,0,0,0,0,0,0,0
"Iceland","2024-02-25",0,0,0,0,0,0,0,0
"Iceland","2024-02-26",0,0,0,0,0,0,0,0
"Iceland","2024-02-27",0,0,0,0,0,0,0,0
"Iceland","2024-02-28",0,0,0,0,0,0,0,0
"Iceland","2024-02-29",0,0,0,0,0,0,0,0
"Iceland","2024-03-01",0,0,0,0,0,0,0,0
"Iceland","2024-03-02",0,0,0,0,0,0,0,0
"Iceland","2024-03-03",0,0,0,0,0,0,0,0
"Iceland","2024-03-04",0,0,0,0,0,0,0,0
"Iceland","2024-03-05",0,0,0,0,0,0,0,0
"Iceland","2024-03-06",0,0,0,0,0,0,0,0
"Iceland","2024-03-07",0,0,0,0,0,0,0,0
"Iceland","2024-03-08",0,0,0,0,0,0,0,0
"Iceland","2024-03-09",0,0,0,0,0,0,0,0
"Iceland","2024-03-10",0,0,0,0,0,0,0,0
"Iceland","2024-03-11",0,0,0,0,0,0,0,0
"Iceland","2024-03-12",0,0,0,0,0,0,0,0
"Iceland","2024-03-13",0,0,0,0,0,0,0,0
"Iceland","2024-03-14",0,0,0,0,0,0,0,0
"Iceland","2024-03-15",0,0,0,0,0,0,0,0
"Iceland","2024-03-16",0,0,0,0,0,0,0,0
"Iceland","2024-03-17",0,0,0,0,0,0,0,0
"Iceland","2024-03-18",0,0,0,0,0,0,0,0
"Iceland","2024-03-19",0,0,0,0,0,0,0,0
"Iceland","2024-03-20",0,0,0,0,0,0,0,0
"Iceland","2024-03-21",0,0,0,0,0,0,0,0
"Iceland","2024-03-22",0,0,0,0,0,0,0,0
"Iceland","2024-03-23",0,0,0,0,0,0,0,0
"Iceland","2024-03-24",0,0,0,0,0,0,0,0
"Iceland","2024-03-25",0,0,0,0,0,0,0,0
"Iceland","2024-03-26",0,0,0,0,0,0,0,0
"Iceland","2024-03-27",0,0,0,0,0,0,0,0
"Iceland","2024-03-28",0,0,0,0,0,0,0,0
"Iceland","2024-03-29",0,0,0,0,0,0,0,0
"Iceland","2024-03-30",0,0,0,0,0,0,0,0
"Iceland","2024-03-31",0,0,0,0,0,0,0,0
"Iceland","2024-04-01",0,0,0,0,0,0,0,0
"Iceland","2024-04-02",0,0,0,0,0,0,0,0
"Iceland","2024-04-03",0,0,0,0,0,0,0,0
"Iceland","2024-04-04",0,0,0,0,0,0,0,0
"Iceland","2024-04-05",0,0,0,0,0,0,0,0
"Iceland","2024-04-06",0,0,0,0,0,0,0,0
"Iceland","2024-04-07",0,0,0,0,0,0,0,0
"Iceland","2024-04-08",0,0,0,0,0,0,0,0
"Iceland","2024-04-09",0,0,0,0,0,0,0,0
"Iceland","2024-04-10",0,0,0,0,0,0,0,0
"Iceland","2024-04-11",0,0,0,0,0,0,0,0
"Iceland","2024-04-12",0,0,0,0,0,0,0,0
"Iceland","2024-04-13",0,0,0,0,0,0,0,0
"Iceland","2024-04-14",0,0,0,0,0,0,0,0
"Iceland","2024-04-15",0,0,0,0,0,0,0,0
"Iceland","2024-04-16",0,0,0,0,0,0,0,0
"Iceland","2024-04-17",0,0,0,0,0,0,0,0
"Iceland","2024-04-18",0,0,0,0,0,0,0,0
"Iceland","2024-04-19",0,0,0,0,0,0,0,0
"Iceland","2024-04-20",0,0,0,0,0,0,0,0
"Iceland","2024-04-21",0,0,0,0,0,0,0,0
"Iceland","2024-04-22",0,0,0,0,0,0,0,0
"Iceland","2024-04-23",0,0,0,0,0,0,0,0
"Iceland","2024-04-24",0,0,0,0,0,0,0,0
"Iceland","2024-04-25",0,0,0,0,0,0,0,0
"Iceland","2024-04-26",0,0,0,0,0,0,0,0
"Iceland","2024-04-27",0,0,0,0,0,0,0,0
"Iceland","2024-04-28",0,0,0,0,0,0,0,0
"Iceland","2024-04-29",0,0,0,0,0,0,0,0
"Iceland","2024-04-30",0,0,0,0,0,0,0,0
"Iceland","2024-05-01",0,0,0,0,0,0,0,0
"Iceland","2024-05-02",0,0,0,0,0,0,0,0
"Iceland","2024-05-03",0,0,0,0,0,0,0,0
"Iceland","2024-05-04",0,0,0,0,0,0,0,0
"Iceland","2024-05-05",0,0,0,0,0,0,0,0
"Iceland","2024-05-06",0,0,0,0,0,0,0,0
"Iceland","2024-05-07",0,0,0,0,0,0,0,0
"Iceland","2024-05-08",0,0,0,0,0,0,0,0
"Iceland","2024-05-09",0,0,0,0,0,0,0,0
"Iceland","2024-05-10",0,0,0,0,0,0,0,0
"Iceland","2024-05-11",0,0,0,0,0,0,0,0
"Iceland","2024-05-12",0,0,0,0,0,0,0,0
"Iceland","2024-05-13",0,0,0,0,0,0,0,0
"Iceland","2024-05-14",0,0,0,0,0,0,0,0
"Iceland","2024-05-15",0,0,0,0,0,0,0,0
"Iceland","2024-05-16",0,0,0,0,0,0,0,0
"Iceland","2024-05-17",0,0,0,0,0,0,0,0
"Iceland","2024-05-18",0,0,0,0,0,0,0,0
"Iceland","2024-05-19",0,0,0,0,0,0,0,0
"Iceland","2024-05-20",0,0,0,0,0,0,0,0
"Iceland","2024-05-21",0,0,0,0,0,0,0,0
"Iceland","2024-05-22",0,0,0,0,0,0,0,0
"Iceland","2024-05-23",0,0,0,0,0,0,0,0
"Iceland","2024-05-24",0,0,0,0,0,0,0,0
"Iceland","2024-05-25",0,0,0,0,0,0,0,0
"Iceland","2024-05-26",0,0,0,0,0,0,0,0
"Iceland","2024-05-27",0,0,0,0,0,0,0,0
"Iceland","2024-05-28",0,0,0,0,0,0,0,0
"Iceland","2024-05-29",0,0,0,0,0,0,0,0
"Iceland","2024-05-30",0,0,0,0,0,0,0,0
"Iceland","2024-05-31",0,0,0,0,0,0,0,0
"Iceland","2024-06-01",0,0,0,0,0,0,0,0
"Iceland","2024-06-02",0,0,0,0,0,0,0,0
"Iceland","2024-06-03",0,0,0,0,0,0,0,0
"Iceland","2024-06-04",0,0,0,0,0,0,0,0
"Iceland","2024-06-05",0,0,0,0,0,0,0,0
"Iceland","2024-06-06",0,0,0,0,0,0,0,0
"Iceland","2024-06-07",0,0,0,0,0,0,0,0
"Iceland","2024-06-08",0,0,0,0,0,0,0,0
"Iceland","2024-06-09",0,0,0,0,0,0,0,0
"Iceland","2024-06-10",0,0,0,0,0,0,0,0
"Iceland","2024-06-11",0,0,0,0,0,0,0,0
"Iceland","2024-06-12",0,0,0,0,0,0,0,0
"Iceland","2024-06-13",0,0,0,0,0,0,0,0
"Iceland","2024-06-14",0,0,0,0,0,0,0,0
"Iceland","2024-06-15",0,0,0,0,0,0,0,0
"Iceland","2024-06-16",0,0,0,0,0,0,0,0
"Iceland","2024-06-17",0,0,0,0,0,0,0,0
"Iceland","2024-06-18",0,0,0,0,0,0,0,0
"Iceland","2024-06-19",0,0,0,0,0,0,0,0
"Iceland","2024-06-20",0,0,0,0,0,0,0,0
"Iceland","2024-06-21",0,0,0,0,0,0,0,0
"Iceland","2024-06-22",0,0,0,0,0,0,0,0
"Iceland","2024-06-23",0,0,0,0,0,0,0,0
"Iceland","2024-06-24",0,0,0,0,0,0,0,0
"Iceland","2024-06-25",0,0,0,0,0,0,0,0
"Iceland","2024-06-26",0,0,0,0,0,0,0,0
"Iceland","2024-06-27",0,0,0,0,0,0,0,0
"Iceland","2024-06-28",0,0,0,0,0,0,0,0
"Iceland","2024-06-29",0,0,0,0,0,0,0,0
"Iceland","2024-06-30",0,0,0,0,0,0,0,0
"Iceland","2024-07-01",0,0,0,0,0,0,0,0
"Iceland","2024-07-02",0,0,0,0,0,0,0,0
"Iceland","2024-07-03",0,0,0,0,0,0,0,0
"Iceland","2024-07-04",0,0,0,0,0,0,0,0
"Iceland","2024-07-05",0,0,0,0,0,0,0,0
"Iceland","2024-07-06",0,0,0,0,0,0,0,0
"Iceland","2024-07-07",0,0,0,0,0,0,0,0
"Iceland","2024-07-08",0,0,0,0,0,0,0,0
"Iceland","2024-07-09",0,0,0,0,0,0,0,0
"Iceland","2024-07-10",0,0,0,0,0,0,0,0
"Iceland","2024-07-11",0,0,0,0,0,0,0,0
"Iceland","2024-07-12",0,0,0,0,0,0,0,0
"Iceland","2024-07-13",0,0,0,0,0,0,0,0
"Iceland","2024-07-14",0,0,0,0,0,0,0,0
"Iceland","2024-07-15",0,0,0,0,0,0,0,0
"Iceland","2024-07-16",0,0,0,0,0,0,0,0
"Iceland","2024-07-17",0,0,0,0,0,0,0,0
"Iceland","2024-07-18",0,0,0,0,0,0,0,0
"Iceland","2024-07-19",0,0,0,0,0,0,0,0
"Iceland","2024-07-20",0,0,0,0,0,0,0,0
"Iceland","2024-07-21",0,0,0,0,0,0,0,0
"Iceland","2024-07-22",0,0,0,0,0,0,0,0
"Iceland","2024-07-23",0,0,0,0,0,0,0,0
"Iceland","2024-07-24",0,0,0,0,0,0,0,0
"Iceland","2024-07-25",0,0,0,0,0,0,0,0
"Iceland","2024-07-26",0,0,0,0,0,0,0,0
"Iceland","2024-07-27",0,0,0,0,0,0,0,0
"Iceland","2024-07-28",0,0,0,0,0,0,0,0
"Iceland","2024-07-29",0,0,0,0,0,0,0,0
"Iceland","2024-07-30",0,0,0,0,0,0,0,0
"Iceland","2024-07-31",0,0,0,0,0,0,0,0
"Iceland","2024-08-01",0,0,0,0,0,0,0,0
"Iceland","2024-08-02",0,0,0,0,0,0,0,0
"Iceland","2024-08-03",0,0,0,0,0,0,0,0
"Iceland","2024-08-04",0,0,0,0,0,0,0,0
"Iceland","2024-08-05",0,0,0,0,0,0,0,0
"Iceland","2024-08-06",0,0,0,0,0,0,0,0
"Iceland","2024-08-07",0,0,0,0,0,0,0,0
"Iceland","2024-08-08",0,0,0,0,0,0,0,0
"Iceland","2024-08-09",0,0,0,0,0,0,0,0
"Iceland","2024-08-10",0,0,0,0,0,0,0,0
"Iceland","2024-08-11",0,0,0,0,0,0,0,0
"Iceland","2024-08-12",0,0,0,0,0,0,0,0
"Iceland","2024-08-13",0,0,0,0,0,0,0,0
"Iceland","2024-08-14",0,0,0,0,0,0,0,0
"Iceland","2024-08-15",0,0,0,0,0,0,0,0
"Iceland","2024-08-16",0,0,0,0,0,0,0,0
"Iceland","2024-08-17",0,0,0,0,0,0,0,0
"Iceland","2024-08-18",0,0,0,0,0,0,0,0
"Iceland","2024-08-19",0,0,0,0,0,0,0,0
"Iceland","2024-08-20",0,0,0,0,0,0,0,0
"Iceland","2024-08-21",0,0,0,0,0,0,0,0
"Iceland","2024-08-22",0,0,0,0,0,0,0,0
"Iceland","2024-08-23",0,0,0,0,0,0,0,0
"Iceland","2024-08-24",0,0,0,0,0,0,0,0
"Iceland","2024-08-25",0,0,0,0,0,0,0,0
"Iceland","2024-08-26",0,0,0,0,0,0,0,0
"Iceland","2024-08-27",0,0,0,0,0,0,0,0
"Iceland","2024-08-28",0,0,0,0,0,0,0,0
"Iceland","2024-08-29",0,0,0,0,0,0,0,0
"Iceland","2024-08-30",0,0,0,0,0,0,0,0
"Iceland","2024-08-31",0,0,0,0,0,0,0,0
"Iceland","2024-09-01",0,0,0,0,0,0,0,0
"Iceland","2024-09-02",0,0,0,0,0,0,0,0
"Iceland","2024-09-03",0,0,0,0,0,0,0,0
"Iceland","2024-09-04",0,0,0,0,0,0,0,0
"Iceland","2024-09-05",0,0,0,0,0,0,0,0
"Iceland","2024-09-06",0,0,0,0,0,0,0,0
"Iceland","2024-09-07",0,0,0,0,0,0,0,0
"Iceland","2024-09-08",0,0,0,0,0,0,0,0
"Iceland","2024-09-09",0,0,0,0,0,0,0,0
"Iceland","2024-09-10",0,0,0,0,0,0,0,0
"Iceland","2024-09-11",0,0,0,0,0,0,0,0
"Iceland","2024-09-12",0,0,0,0,0,0,0,0
"Iceland","2024-09-13",0,0,0,0,0,0,0,0
"Iceland","2024-09-14",0,0,0,0,0,0,0,0
"Iceland","2024-09-15",0,0,0,0,0,0,0,0
"Iceland","2024-09-16",0,0,0,0,0,0,0,0
"Iceland","2024-09-17",0,0,0,0,0,0,0,0
"Iceland","2024-09-18",0,0,0,0,0,0,0,0
"Iceland","2024-09-19",0,0,0,0,0,0,0,0
"Iceland","2024-09-20",0,0,0,0,0,0,0,0
"Iceland","2024-09-21",0,0,0,0,0,0,0,0
"Iceland","2024-09-22",0,0,0,0,0,0,0,0
"Iceland","2024-09-23",0,0,0,0,0,0,0,0
"Iceland","2024-09-24",0,0,0,0,0,0,0,0
"Iceland","2024-09-25",0,0,0,0,0,0,0,0
"Iceland","2024-09-26",0,0,0,0,0,0,0,0
"Iceland","2024-09-27",0,0,0,0,0,0,0,0
"Iceland","2024-09-28",0,0,0,0,0,0,0,0
"Iceland","2024-09-29",0,0,0,0,0,0,0,0
"Iceland","2024-09-30",0,0,0,0,0,0,0,0
"Iceland","2024-10-01",0,0,0,0,0,0,0,0
"Iceland","2024-10-02",0,0,0,0,0,0,0,0
"Iceland","2024-10-03",0,0,0,0,0,0,0,0
"Iceland","2024-10-04",0,0,0,0,0,0,0,0
"Iceland","2024-10-05",0,0,0,0,0,0,0,0
"Iceland","2024-10-06",0,0,0,0,0,0,0,0
"Iceland","2024-10-07",0,0,0,0,0,0,0,0
"Iceland","2024-10-08",0,0,0,0,0,0,0,0
"Iceland","2024-10-09",0,0,0,0,0,0,0,0
"Iceland","2024-10-10",0,0,0,0,0,0,0,0
"Iceland","2024-10-11",0,0,0,0,0,0,0,0
"Iceland","2024-10-12",0,0,0,0,0,0,0,0
"Iceland","2024-10-13",0,0,0,0,0,0,0,0
"Iceland","2024-10-14",0,0,0,0,0,0,0,0
"Iceland","2024-10-15",0,0,0,0,0,0,0,0
"Iceland","2024-10-16",0,0,0,0,0,0,0,0
"Iceland","2024-10-17",0,0,0,0,0,0,0,0
"Iceland","2024-10-18",0,0,0,0,0,0,0,0
"Iceland","2024-10-19",0,0,0,0,0,0,0,0
"Iceland","2024-10-20",0,0,0,0,0,0,0,0
"Iceland","2024-10-21",0,0,0,0,0,0,0,0
"Iceland","2024-10-22",0,0,0,0,0,0,0,0
"Iceland","2024-10-23",0,0,0,0,0,0,0,0
"Iceland","2024-10-24",0,0,0,0,0,0,0,0
"Iceland","2024-10-25",0,0,0,0,0,0,0,0
"Iceland","2024-10-26",0,0,0,0,0,0,0,0
"Iceland","2024-10-27",0,0,0,0,0,0,0,0
"Iceland","2024-10-28",0,0,0,0,0,0,0,0
"Iceland","2024-10-29",0,0,0,0,0,0,0,0
"Iceland","2024-10-30",0,0,0,0,0,0,0,0
"Iceland","2024-10-31",0,0,0,0,0,0,0,0
"Iceland","2024-11-01",0,0,0,0,0,0,0,0
"Iceland","2024-11-02",0,0,0,0,0,0,0,0
"Iceland","2024-11-03",0,0,0,0,0,0,0,0
"Iceland","2024-11-04",0,0,0,0,0,0,0,0
"Iceland","2024-11-05",0,0,0,0,0,0,0,0
"Iceland","2024-11-06",0,0,0,0,0,0,0,0
"Iceland","2024-11-07",0,0,0,0,0,0,0,0
"Iceland","2024-11-08",0,0,0,0,0,0,0,0
"Iceland","2024-11-09",0,0,0,0,0,0,0,0
"Iceland","2024-11-10",0,0,0,0,0,0,0,0
"Iceland","2024-11-11",0,0,0,0,0,0,0,0
"Iceland","2024-11-12",0,0,0,0,0,0,0,0
"Iceland","2024-11-13",0,0,0,0,0,0,0,0
"Iceland","2024-11-14",0,0,0,0,0,0,0,0
"Iceland","2024-11-15",0,0,0,0,0,0,0,0
"Iceland","2024-11-16",0,0,0,0,0,0,0,0
"Iceland","2024-11-17",0,0,0,0,0,0,0,0
"Iceland","2024-11-18",0,0,0,0,0,0,0,0
"Iceland","2024-11-19",0,0,0,0,0,0,0,0
"Iceland","2024-11-20",0,0,0,0,0,0,0,0
"Iceland","2024-11-21",0,0,0,0,0,0,0,0
"Iceland","2024-11-22",0,0,0,0,0,0,0,0
"Iceland","2024-11-23",0,0,0,0,0,0,0,0
"Iceland","2024-11-24",0,0,0,0,0,0,0,0
"Iceland","2024-11-25",0,0,0,0,0,0,0,0
"Iceland","2024-11-26",0,0,0,0,0,0,0,0
"Iceland","2024-11-27",0,0,0,0,0,0,0,0
"Iceland","2024-11-28",0,0,0,0,0,0,0,0
"Iceland","2024-11-29",0,0,0,0,0,0,0,0
"Iceland","2024-11-30",0,0,0,0,0,0,0,0
"Iceland","2024-12-01",0,0,0,0,0,0,0,0
"Iceland","2024-12-02",0,0,0,0,0,0,0,0
"Iceland","2024-12-03",0,0,0,0,0,0,0,0
"Iceland","2024-12-04",0,0,0,0,0,0,0,0
"Iceland","2024-12-05",0,0,0,0,0,0,0,0
"Iceland","2024-12-06",0,0,0,0,0,0,0,0
"Iceland","2024-12-07",0,0,0,0,0,0,0,0
"Iceland","2024-12-08",0,0,0,0,0,0,0,0
"Iceland","2024-12-09",0,0,0,0,0,0,0,0
"India","2024-01-01",0,0,0,0,0,0,0,0
"India","2024-01-02",0,0,0,0,0,0,0,0
"India","2024-01-03",0,0,0,0,0,0,0,0
"India","2024-01-04",0,0,0,0,0,0,0,0
"India","2024-01-05",0,0,0,0,0,0,0,0
"India","2024-01-06",0,0,0,0,0,0,0,0
"India","2024-01-07",0,0,0,0,0,0,0,0
"India","2024-01-08",0,0,0,0,0,0,0,0
"India","2024-01-09",0,0,0,0,0,0,0,0
"India","2024-01-10",0,0,0,0,0,0,0,0
"India","2024-01-11",0,0,0,0,0,0,0,0
"India","2024-01-12",0,0,0,0,0,0,0,0
"India","2024-01-13",0,0,0,0,0,0,0,0
"India","2024-01-14",0,0,0,0,0,0,0,0
"India","2024-01-15",0,0,0,0,0,0,0,0
"India","2024-01-16",0,0,0,0,0,0,0,0
"India","2024-01-17",0,0,0,0,0,0,0,0
"India","2024-01-18",0,0,0,0,0,0,0,0
"India","2024-01-19",0,0,0,0,0,0,0,0
"India","2024-01-20",0,0,0,0,0,0,0,0
"India","2024-01-21",0,0,0,0,0,0,0,0
"India","2024-01-22",0,0,0,0,0,0,0,0
"India","2024-01-23",0,0,0,0,0,0,0,0
"India","2024-01-24",0,0,0,0,0,0,0,0
"India","2024-01-25",0,0,0,0,0,0,0,0
"India","2024-01-26",0,0,0,0,0,0,0,0
"India","2024-01-27",0,0,0,0,0,0,0,0
"India","2024-01-28",0,0,0,0,0,0,0,0
"India","2024-01-29",0,0,0,0,0,0,0,0
"India","2024-01-30",0,0,0,0,0,0,0,0
"India","2024-01-31",0,0,0,0,0,0,0,0
"India","2024-02-01",0,0,0,0,0,0,0,0
"India","2024-02-02",0,0,0,0,0,0,0,0
"India","2024-02-03",0,0,0,0,0,0,0,0
"India","2024-02-04",0,0,0,0,0,0,0,0
"India","2024-02-05",0,0,0,0,0,0,0,0
"India","2024-02-06",0,0,0,0,0,0,0,0
"India","2024-02-07",0,0,0,0,0,0,0,0
"India","2024-02-08",0,0,0,0,0,0,0,0
"India","2024-02-09",0,0,0,0,0,0,0,0
"India","2024-02-10",0,0,0,0,0,0,0,0
"India","2024-02-11",0,0,0,0,0,0,0,0
"India","2024-02-12",0,0,0,0,0,0,0,0
"India","2024-02-13",0,0,0,0,0,0,0,0
"India","2024-02-14",0,0,0,0,0,0,0,0
"India","2024-02-15",0,0,0,0,0,0,0,0
"India","2024-02-16",0,0,0,0,0,0,0,0
"India","2024-02-17",0,0,0,0,0,0,0,0
"India","2024-02-18",0,0,0,0,0,0,0,0
"India","2024-02-19",0,0,0,0,0,0,0,0
"India","2024-02-20",0,0,0,0,0,0,0,0
"India","2024-02-21",0,0,0,0,0,0,0,0
"India","2024-02-22",0,0,0,0,0,0,0,0
"India","2024-02-23",0,0,0,0,0,0,0,0
"India","2024-02-24",0,0,0,0,0,0,0,0
"India","2024-02-25",0,0,0,0,0,0,0,0
"India","2024-02-26",0,0,0,0,0,0,0,0
"India","2024-02-27",0,0,0,0,0,0,0,0
"India","2024-02-28",0,0,0,0,0,0,0,0
"India","2024-02-29",0,0,0,0,0,0,0,0
"India","2024-03-01",0,0,0,0,0,0,0,0
"India","2024-03-02",0,0,0,0,0,0,0,0
"India","2024-03-03",0,0,0,0,0,0,0,0
"India","2024-03-04",0,0,0,0,0,0,0,0
"India","2024-03-05",0,0,0,0,0,0,0,0
"India","2024-03-06",0,0,0,0,0,0,0,0
"India","2024-03-07",0,0,0,0,0,0,0,0
"India","2024-03-08",0,0,0,0,0,0,0,0
"India","2024-03-09",0,0,0,0,0,0,0,0
"India","2024-03-10",0,0,0,0,0,0,0,0
"India","2024-03-11",0,0,0,0,0,0,0,0
"India","2024-03-12",0,0,0,0,0,0,0,0
"India","2024-03-13",0,0,0,0,0,0,0,0
"India","2024-03-14",0,0,0,0,0,0,0,0
"India","2024-03-15",0,0,0,0,0,0,0,0
"India","2024-03-16",0,0,0,0,0,0,0,0
"India","2024-03-17",0,0,0,0,0,0,0,0
"India","2024-03-18",0,0,0,0,0,0,0,0
"India","2024-03-19",0,0,0,0,0,0,0,0
"India","2024-03-20",0,0,0,0,0,0,0,0
"India","2024-03-21",0,0,0,0,0,0,0,0
"India","2024-03-22",0,0,0,0,0,0,0,0
"India","2024-03-23",0,0,0,0,0,0,0,0
"India","2024-03-24",0,0,0,0,0,0,0,0
"India","2024-03-25",0,0,0,0,0,0,0,0
"India","2024-03-26",0,0,0,0,0,0,0,0
"India","2024-03-27",0,0,0,0,0,0,0,0
"India","2024-03-28",0,0,0,0,0,0,0,0
"India","2024-03-29",0,0,0,0,0,0,0,0
"India","2024-03-30",0,0,0,0,0,0,0,0
"India","2024-03-31",0,0,0,0,0,0,0,0
"India","2024-04-01",0,0,0,0,0,0,0,0
"India","2024-04-02",0,0,0,0,0,0,0,0
"India","2024-04-03",0,0,0,0,0,0,0,0
"India","2024-04-04",0,0,0,0,0,0,0,0
"India","2024-04-05",0,0,0,0,0,0,0,0
"India","2024-04-06",0,0,0,0,0,0,0,0
"India","2024-04-07",0,0,0,0,0,0,0,0
"India","2024-04-08",0,0,0,0,0,0,0,0
"India","2024-04-09",0,0,0,0,0,0,0,0
"India","2024-04-10",0,0,0,0,0,0,0,0
"India","2024-04-11",0,0,0,0,0,0,0,0
"India","2024-04-12",0,0,0,0,0,0,0,0
"India","2024-04-13",0,0,0,0,0,0,0,0
"India","2024-04-14",0,0,0,0,0,0,0,0
"India","2024-04-15",0,0,0,0,0,0,0,0
"India","2024-04-16",0,0,0,0,0,0,0,0
"India","2024-04-17",0,0,0,0,0,0,0,0
"India","2024-04-18",0,0,0,0,0,0,0,0
"India","2024-04-19",0,0,0,0,0,0,0,0
"India","2024-04-20",0,0,0,0,0,0,0,0
"India","2024-04-21",0,0,0,0,0,0,0,0
"India","2024-04-22",0,0,0,0,0,0,0,0
"India","2024-04-23",0,0,0,0,0,0,0,0
"India","2024-04-24",0,0,0,0,0,0,0,0
"India","2024-04-25",0,0,0,0,0,0,0,0
"India","2024-04-26",0,0,0,0,0,0,0,0
"India","2024-04-27",0,0,0,0,0,0,0,0
"India","2024-04-28",0,0,0,0,0,0,0,0
"India","2024-04-29",0,0,0,0,0,0,0,0
"India","2024-04-30",0,0,0,0,0,0,0,0
"India","2024-05-01",0,0,0,0,0,0,0,0
"India","2024-05-02",0,0,0,0,0,0,0,0
"India","2024-05-03",0,0,0,0,0,0,0,0
"India","2024-05-04",0,0,0,0,0,0,0,0
"India","2024-05-05",0,0,0,0,0,0,0,0
"India","2024-05-06",0,0,0,0,0,0,0,0
"India","2024-05-07",0,0,0,0,0,0,0,0
"India","2024-05-08",0,0,0,0,0,0,0,0
"India","2024-05-09",0,0,0,0,0,0,0,0
"India","2024-05-10",0,0,0,0,0,0,0,0
"India","2024-05-11",0,0,0,0,0,0,0,0
"India","2024-05-12",0,0,0,0,0,0,0,0
"India","2024-05-13",0,0,0,0,0,0,0,0
"India","2024-05-14",0,0,0,0,0,0,0,0
"India","2024-05-15",0,0,0,0,0,0,0,0
"India","2024-05-16",0,0,0,0,0,0,0,0
"India","2024-05-17",0,0,0,0,0,0,0,0
"India","2024-05-18",0,0,0,0,0,0,0,0
"India","2024-05-19",0,0,0,0,0,0,0,0
"India","2024-05-20",0,0,0,0,0,0,0,0
"India","2024-05-21",0,0,0,0,0,0,0,0
"India","2024-05-22",0,0,0,0,0,0,0,0
"India","2024-05-23",0,0,0,0,0,0,0,0
"India","2024-05-24",0,0,0,0,0,0,0,0
"India","2024-05-25",0,0,0,0,0,0,0,0
"India","2024-05-26",0,0,0,0,0,0,0,0
"India","2024-05-27",0,0,0,0,0,0,0,0
"India","2024-05-28",0,0,0,0,0,0,0,0
"India","2024-05-29",0,0,0,0,0,0,0,0
"India","2024-05-30",0,0,0,0,0,0,0,0
"India","2024-05-31",0,0,0,0,0,0,0,0
"India","2024-06-01",0,0,0,0,0,0,0,0
"India","2024-06-02",0,0,0,0,0,0,0,0
"India","2024-06-03",0,0,0,0,0,0,0,0
"India","2024-06-04",0,0,0,0,0,0,0,0
"India","2024-06-05",0,0,0,0,0,0,0,0
"India","2024-06-06",0,0,0,0,0,0,0,0
"India","2024-06-07",0,0,0,0,0,0,0,0
"India","2024-06-08",0,0,0,0,0,0,0,0
"India","2024-06-09",0,0,0,0,0,0,0,0
"India","2024-06-10",0,0,0,0,0,0,0,0
"India","2024-06-11",0,0,0,0,0,0,0,0
"India","2024-06-12",0,0,0,0,0,0,0,0
"India","2024-06-13",0,0,0,0,0,0,0,0
"India","2024-06-14",0,0,0,0,0,0,0,0
"India","2024-06-15",0,0,0,0,0,0,0,0
"India","2024-06-16",0,0,0,0,0,0,0,0
"India","2024-06-17",0,0,0,0,0,0,0,0
"India","2024-06-18",0,0,0,0,0,0,0,0
"India","2024-06-19",0,0,0,0,0,0,0,0
"India","2024-06-20",0,0,0,0,0,0,0,0
"India","2024-06-21",0,0,0,0,0,0,0,0
"India","2024-06-22",0,0,0,0,0,0,0,0
"India","2024-06-23",0,0,0,0,0,0,0,0
"India","2024-06-24",0,0,0,0,0,0,0,0
"India","2024-06-25",0,0,0,0,0,0,0,0
"India","2024-06-26",0,0,0,0,0,0,0,0
"India","2024-06-27",0,0,0,0,0,0,0,0
"India","2024-06-28",0,0,0,0,0,0,0,0
"India","2024-06-29",0,0,0,0,0,0,0,0
"India","2024-06-30",0,0,0,0,0,0,0,0
"India","2024-07-01",0,0,0,0,0,0,0,0
"India","2024-07-02",0,0,0,0,0,0,0,0
"India","2024-07-03",0,0,0,0,0,0,0,0
"India","2024-07-04",0,0,0,0,0,0,0,0
"India","2024-07-05",0,0,0,0,0,0,0,0
"India","2024-07-06",0,0,0,0,0,0,0,0
"India","2024-07-07",0,0,0,0,0,0,0,0
"India","2024-07-08",0,0,0,0,0,0,0,0
"India","2024-07-09",0,0,0,0,0,0,0,0
"India","2024-07-10",0,0,0,0,0,0,0,0
"India","2024-07-11",0,0,0,0,0,0,0,0
"India","2024-07-12",0,0,0,0,0,0,0,0
"India","2024-07-13",0,0,0,0,0,0,0,0
"India","2024-07-14",0,0,0,0,0,0,0,0
"India","2024-07-15",0,0,0,0,0,0,0,0
"India","2024-07-16",0,0,0,0,0,0,0,0
"India","2024-07-17",0,0,0,0,0,0,0,0
"India","2024-07-18",0,0,0,0,0,0,0,0
"India","2024-07-19",0,0,0,0,0,0,0,0
"India","2024-07-20",0,0,0,0,0,0,0,0
"India","2024-07-21",0,0,0,0,0,0,0,0
"India","2024-07-22",0,0,0,0,0,0,0,0
"India","2024-07-23",0,0,0,0,0,0,0,0
"India","2024-07-24",0,0,0,0,0,0,0,0
"India","2024-07-25",0,0,0,0,0,0,0,0
"India","2024-07-26",0,0,0,0,0,0,0,0
"India","2024-07-27",0,0,0,0,0,0,0,0
"India","2024-07-28",0,0,0,0,0,0,0,0
"India","2024-07-29",0,0,0,0,0,0,0,0
"India","2024-07-30",0,0,0,0,0,0,0,0
"India","2024-07-31",0,0,0,0,0,0,0,0
"India","2024-08-01",0,0,0,0,0,0,0,0
"India","2024-08-02",0,0,0,0,0,0,0,0
"India","2024-08-03",0,0,0,0,0,0,0,0
"India","2024-08-04",0,0,0,0,0,0,0,0
"India","2024-08-05",0,0,0,0,0,0,0,0
"India","2024-08-06",0,0,0,0,0,0,0,0
"India","2024-08-07",0,0,0,0,0,0,0,0
"India","2024-08-08",0,0,0,0,0,0,0,0
"India","2024-08-09",0,0,0,0,0,0,0,0
"India","2024-08-10",0,0,0,0,0,0,0,0
"India","2024-08-11",0,0,0,0,0,0,0,0
"India","2024-08-12",0,0,0,0,0,0,0,0
"India","2024-08-13",0,0,0,0,0,0,0,0
"India","2024-08-14",0,0,0,0,0,0,0,0
"India","2024-08-15",0,0,0,0,0,0,0,0
"India","2024-08-16",0,0,0,0,0,0,0,0
"India","2024-08-17",0,0,0,0,0,0,0,0
"India","2024-08-18",0,0,0,0,0,0,0,0
"India","2024-08-19",0,0,0,0,0,0,0,0
"India","2024-08-20",0,0,0,0,0,0,0,0
"India","2024-08-21",0,0,0,0,0,0,0,0
"India","2024-08-22",0,0,0,0,0,0,0,0
"India","2024-08-23",0,0,0,0,0,0,0,0
"India","2024-08-24",0,0,0,0,0,0,0,0
"India","2024-08-25",0,0,0,0,0,0,0,0
"India","2024-08-26",0,0,0,0,0,0,0,0
"India","2024-08-27",0,0,0,0,0,0,0,0
"India","2024-08-28",0,0,0,0,0,0,0,0
"India","2024-08-29",0,0,0,0,0,0,0,0
"India","2024-08-30",0,0,0,0,0,0,0,0
"India","2024-08-31",0,3,3,0,3,3,0,0
"India","2024-09-01",0,0,3,0,0,3,0,0
"India","2024-09-02",0,0,3,0,0,3,0,0
"India","2024-09-03",0,0,3,0,0,3,0,0
"India","2024-09-04",0,0,3,0,0,3,0,0
"India","2024-09-05",0,0,3,0,0,3,0,0
"India","2024-09-06",0,0,3,0,1,4,0,0
"India","2024-09-07",0,0,3,0,0,4,0,0
"India","2024-09-08",0,0,3,0,0,4,0,0
"India","2024-09-09",0,0,3,0,0,4,0,0
"India","2024-09-10",0,0,3,0,0,4,0,0
"India","2024-09-11",0,0,3,0,0,4,0,0
"India","2024-09-12",0,0,3,0,0,4,0,0
"India","2024-09-13",0,0,3,0,0,4,0,0
"India","2024-09-14",0,0,3,0,0,4,0,0
"India","2024-09-15",0,0,3,0,1,5,0,0
"India","2024-09-16",0,0,3,0,0,5,0,0
"India","2024-09-17",0,0,3,0,0,5,0,0
"India","2024-09-18",0,0,3,0,0,5,0,0
"India","2024-09-19",0,0,3,0,0,5,0,0
"India","2024-09-20",0,0,3,0,0,5,0,0
"India","2024-09-21",0,0,3,0,0,5,0,0
"India","2024-09-22",0,0,3,0,0,5,0,0
"India","2024-09-23",0,0,3,0,0,5,0,0
"India","2024-09-24",0,0,3,0,0,5,0,0
"India","2024-09-25",0,0,3,0,0,5,0,0
"India","2024-09-26",0,0,3,0,1,6,0,0
"India","2024-09-27",0,0,3,0,0,6,0,0
"India","2024-09-28",0,0,3,0,0,6,0,0
"India","2024-09-29",0,0,3,0,0,6,0,0
"India","2024-09-30",0,3,6,0,0,6,0,0
"India","2024-10-01",0,0,6,0,0,6,0,0
"India","2024-10-02",0,0,6,0,0,6,0,0
"India","2024-10-03",0,0,6,0,0,6,0,0
"India","2024-10-04",0,0,6,0,0,6,0,0
"India","2024-10-05",0,0,6,0,0,6,0,0
"India","2024-10-06",0,0,6,0,0,6,0,0
"India","2024-10-07",0,0,6,0,0,6,0,0
"India","2024-10-08",0,0,6,0,0,6,0,0
"India","2024-10-09",0,0,6,0,0,6,0,0
"India","2024-10-10",0,0,6,0,0,6,0,0
"India","2024-10-11",0,0,6,0,0,6,0,0
"India","2024-10-12",0,0,6,0,0,6,0,0
"India","2024-10-13",0,0,6,0,0,6,0,0
"India","2024-10-14",0,0,6,0,0,6,0,0
"India","2024-10-15",0,0,6,0,0,6,0,0
"India","2024-10-16",0,0,6,0,0,6,0,0
"India","2024-10-17",0,0,6,0,0,6,0,0
"India","2024-10-18",0,0,6,0,0,6,0,0
"India","2024-10-19",0,0,6,0,0,6,0,0
"India","2024-10-20",0,0,6,0,0,6,0,0
"India","2024-10-21",0,0,6,0,0,6,0,0
"India","2024-10-22",0,0,6,0,0,6,0,0
"India","2024-10-23",0,0,6,0,0,6,0,0
"India","2024-10-24",0,0,6,0,0,6,0,0
"India","2024-10-25",0,0,6,0,0,6,0,0
"India","2024-10-26",0,0,6,0,0,6,0,0
"India","2024-10-27",0,0,6,0,0,6,0,0
"India","2024-10-28",0,0,6,0,0,6,0,0
"India","2024-10-29",0,0,6,0,0,6,0,0
"India","2024-10-30",0,0,6,0,0,6,0,0
"India","2024-10-31",0,0,6,0,0,6,0,0
"India","2024-11-01",0,0,6,0,0,6,0,0
"India","2024-11-02",0,0,6,0,0,6,0,0
"India","2024-11-03",0,0,6,0,0,6,0,0
"India","2024-11-04",0,0,6,0,0,6,0,0
"India","2024-11-05",0,0,6,0,0,6,0,0
"India","2024-11-06",0,0,6,0,0,6,0,0
"India","2024-11-07",0,0,6,0,0,6,0,0
"India","2024-11-08",0,0,6,0,0,6,0,0
"India","2024-11-09",0,0,6,0,0,6,0,0
"India","2024-11-10",0,0,6,0,0,6,0,0
"India","2024-11-11",0,0,6,0,0,6,0,0
"India","2024-11-12",0,0,6,0,0,6,0,0
"India","2024-11-13",0,0,6,0,0,6,0,0
"India","2024-11-14",0,0,6,0,0,6,0,0
"India","2024-11-15",0,0,6,0,0,6,0,0
"India","2024-11-16",0,0,6,0,0,6,0,0
"India","2024-11-17",0,0,6,0,0,6,0,0
"India","2024-11-18",0,0,6,0,0,6,0,0
"India","2024-11-19",0,0,6,0,0,6,0,0
"India","2024-11-20",0,0,6,0,0,6,0,0
"India","2024-11-21",0,0,6,0,0,6,0,0
"India","2024-11-22",0,0,6,0,0,6,0,0
"India","2024-11-23",0,0,6,0,0,6,0,0
"India","2024-11-24",0,0,6,0,0,6,0,0
"India","2024-11-25",0,0,6,0,0,6,0,0
"India","2024-11-26",0,0,6,0,0,6,0,0
"India","2024-11-27",0,0,6,0,0,6,0,0
"India","2024-11-28",0,0,6,0,0,6,0,0
"India","2024-11-29",0,0,6,0,0,6,0,0
"India","2024-11-30",0,0,6,0,0,6,0,0
"India","2024-12-01",0,0,6,0,0,6,0,0
"India","2024-12-02",0,0,6,0,0,6,0,0
"India","2024-12-03",0,0,6,0,0,6,0,0
"India","2024-12-04",0,0,6,0,0,6,0,0
"India","2024-12-05",0,0,6,0,0,6,0,0
"India","2024-12-06",0,0,6,0,0,6,0,0
"India","2024-12-07",0,0,6,0,0,6,0,0
"India","2024-12-08",0,0,6,0,0,6,0,0
"India","2024-12-09",0,0,6,0,0,6,0,0
"Indonesia","2024-01-01",0,0,0,0,0,0,0,0
"Indonesia","2024-01-02",0,0,0,0,0,0,0,0
"Indonesia","2024-01-03",0,0,0,0,0,0,0,0
"Indonesia","2024-01-04",0,0,0,0,0,0,0,0
"Indonesia","2024-01-05",0,0,0,0,0,0,0,0
"Indonesia","2024-01-06",0,0,0,0,0,0,0,0
"Indonesia","2024-01-07",0,0,0,0,0,0,0,0
"Indonesia","2024-01-08",0,0,0,0,0,0,0,0
"Indonesia","2024-01-09",0,0,0,0,0,0,0,0
"Indonesia","2024-01-10",0,0,0,0,0,0,0,0
"Indonesia","2024-01-11",0,0,0,0,0,0,0,0
"Indonesia","2024-01-12",0,0,0,0,0,0,0,0
"Indonesia","2024-01-13",0,0,0,0,0,0,0,0
"Indonesia","2024-01-14",0,0,0,0,0,0,0,0
"Indonesia","2024-01-15",0,0,0,0,0,0,0,0
"Indonesia","2024-01-16",0,0,0,0,0,0,0,0
"Indonesia","2024-01-17",0,0,0,0,0,0,0,0
"Indonesia","2024-01-18",0,0,0,0,0,0,0,0
"Indonesia","2024-01-19",0,0,0,0,0,0,0,0
"Indonesia","2024-01-20",0,0,0,0,0,0,0,0
"Indonesia","2024-01-21",0,0,0,0,0,0,0,0
"Indonesia","2024-01-22",0,0,0,0,0,0,0,0
"Indonesia","2024-01-23",0,0,0,0,0,0,0,0
"Indonesia","2024-01-24",0,0,0,0,0,0,0,0
"Indonesia","2024-01-25",0,0,0,0,0,0,0,0
"Indonesia","2024-01-26",0,0,0,0,0,0,0,0
"Indonesia","2024-01-27",0,0,0,0,0,0,0,0
"Indonesia","2024-01-28",0,0,0,0,0,0,0,0
"Indonesia","2024-01-29",0,0,0,0,0,0,0,0
"Indonesia","2024-01-30",0,0,0,0,0,0,0,0
"Indonesia","2024-01-31",0,7,7,0,7,7,0,0
"Indonesia","2024-02-01",0,0,7,0,0,7,0,0
"Indonesia","2024-02-02",0,0,7,0,0,7,0,0
"Indonesia","2024-02-03",0,0,7,0,0,7,0,0
"Indonesia","2024-02-04",0,0,7,0,1,8,0,0
"Indonesia","2024-02-05",0,0,7,0,0,8,0,0
"Indonesia","2024-02-06",0,0,7,0,0,8,0,0
"Indonesia","2024-02-07",0,0,7,0,0,8,0,0
"Indonesia","2024-02-08",0,0,7,0,0,8,0,0
"Indonesia","2024-02-09",0,0,7,0,0,8,0,0
"Indonesia","2024-02-10",0,0,7,0,0,8,0,0
"Indonesia","2024-02-11",0,0,7,0,1,9,0,0
"Indonesia","2024-02-12",0,0,7,0,0,9,0,0
"Indonesia","2024-02-13",0,0,7,0,0,9,0,0
"Indonesia","2024-02-14",0,0,7,0,0,9,0,0
"Indonesia","2024-02-15",0,0,7,0,0,9,0,0
"Indonesia","2024-02-16",0,0,7,0,0,9,0,0
"Indonesia","2024-02-17",0,0,7,0,0,9,0,0
"Indonesia","2024-02-18",0,0,7,0,0,9,0,0
"Indonesia","2024-02-19",0,0,7,0,1,10,0,0
"Indonesia","2024-02-20",0,0,7,0,0,10,0,0
"Indonesia","2024-02-21",0,0,7,0,0,10,0,0
"Indonesia","2024-02-22",0,0,7,0,0,10,0,0
"Indonesia","2024-02-23",0,0,7,0,0,10,0,0
"Indonesia","2024-02-24",0,0,7,0,0,10,0,0
"Indonesia","2024-02-25",0,0,7,0,0,10,0,0
"Indonesia","2024-02-26",0,0,7,0,1,11,0,0
"Indonesia","2024-02-27",0,0,7,0,0,11,0,0
"Indonesia","2024-02-28",0,0,7,0,0,11,0,0
"Indonesia","2024-02-29",0,4,11,0,0,11,0,0
"Indonesia","2024-03-01",0,0,11,0,0,11,0,0
"Indonesia","2024-03-02",0,0,11,0,0,11,0,0
"Indonesia","2024-03-03",0,0,11,0,0,11,0,0
"Indonesia","2024-03-04",0,0,11,0,0,11,0,0
"Indonesia","2024-03-05",0,0,11,0,0,11,0,0
"Indonesia","2024-03-06",0,0,11,0,0,11,0,0
"Indonesia","2024-03-07",0,0,11,0,0,11,0,0
"Indonesia","2024-03-08",0,0,11,0,0,11,0,0
"Indonesia","2024-03-09",0,0,11,0,0,11,0,0
"Indonesia","2024-03-10",0,0,11,0,0,11,0,0
"Indonesia","2024-03-11",0,0,11,0,0,11,0,0
"Indonesia","2024-03-12",0,0,11,0,0,11,0,0
"Indonesia","2024-03-13",0,0,11,0,0,11,0,0
"Indonesia","2024-03-14",0,0,11,0,0,11,0,0
"Indonesia","2024-03-15",0,0,11,0,0,11,0,0
"Indonesia","2024-03-16",0,0,11,0,0,11,0,0
"Indonesia","2024-03-17",0,0,11,0,1,12,0,0
"Indonesia","2024-03-18",0,0,11,0,0,12,0,0
"Indonesia","2024-03-19",0,0,11,0,0,12,0,0
"Indonesia","2024-03-20",0,0,11,0,0,12,0,0
"Indonesia","2024-03-21",0,0,11,0,0,12,0,0
"Indonesia","2024-03-22",0,0,11,0,0,12,0,0
"Indonesia","2024-03-23",0,0,11,0,0,12,0,0
"Indonesia","2024-03-24",0,0,11,0,0,12,0,0
"Indonesia","2024-03-25",0,0,11,0,0,12,0,0
"Indonesia","2024-03-26",0,0,11,0,0,12,0,0
"Indonesia","2024-03-27",0,0,11,0,0,12,0,0
"Indonesia","2024-03-28",0,0,11,0,0,12,0,0
"Indonesia","2024-03-29",0,0,11,0,0,12,0,0
"Indonesia","2024-03-30",0,0,11,0,0,12,0,0
"Indonesia","2024-03-31",0,0,11,0,0,12,0,0
"Indonesia","2024-04-01",0,0,11,0,0,12,0,0
"Indonesia","2024-04-02",0,1,12,0,0,12,0,0
"Indonesia","2024-04-03",0,0,12,0,0,12,0,0
"Indonesia","2024-04-04",0,0,12,0,0,12,0,0
"Indonesia","2024-04-05",0,0,12,0,0,12,0,0
"Indonesia","2024-04-06",0,0,12,0,0,12,0,0
"Indonesia","2024-04-07",0,0,12,0,0,12,0,0
"Indonesia","2024-04-08",0,0,12,0,0,12,0,0
"Indonesia","2024-04-09",0,0,12,0,0,12,0,0
"Indonesia","2024-04-10",0,0,12,0,0,12,0,0
"Indonesia","2024-04-11",0,0,12,0,0,12,0,0
"Indonesia","2024-04-12",0,0,12,0,0,12,0,0
"Indonesia","2024-04-13",0,0,12,0,0,12,0,0
"Indonesia","2024-04-14",0,0,12,0,0,12,0,0
"Indonesia","2024-04-15",0,0,12,0,0,12,0,0
"Indonesia","2024-04-16",0,0,12,0,0,12,0,0
"Indonesia","2024-04-17",0,0,12,0,1,13,0,0
"Indonesia","2024-04-18",0,0,12,0,0,13,0,0
"Indonesia","2024-04-19",0,0,12,0,0,13,0,0
"Indonesia","2024-04-20",0,0,12,0,0,13,0,0
"Indonesia","2024-04-21",0,0,12,0,0,13,0,0
"Indonesia","2024-04-22",0,0,12,0,0,13,0,0
"Indonesia","2024-04-23",0,0,12,0,0,13,0,0
"Indonesia","2024-04-24",0,0,12,0,0,13,0,0
"Indonesia","2024-04-25",0,0,12,0,0,13,0,0
"Indonesia","2024-04-26",0,0,12,0,0,13,0,0
"Indonesia","2024-04-27",0,0,12,0,0,13,0,0
"Indonesia","2024-04-28",0,0,12,0,0,13,0,0
"Indonesia","2024-04-29",0,0,12,0,0,13,0,0
"Indonesia","2024-04-30",0,1,13,0,0,13,0,0
"Indonesia","2024-05-01",0,0,13,0,0,13,0,0
"Indonesia","2024-05-02",0,0,13,0,0,13,0,0
"Indonesia","2024-05-03",0,0,13,0,0,13,0,0
"Indonesia","2024-05-04",0,0,13,0,0,13,0,0
"Indonesia","2024-05-05",0,0,13,0,0,13,0,0
"Indonesia","2024-05-06",0,0,13,0,0,13,0,0
"Indonesia","2024-05-07",0,0,13,0,0,13,0,0
"Indonesia","2024-05-08",0,0,13,0,0,13,0,0
"Indonesia","2024-05-09",0,0,13,0,0,13,0,0
"Indonesia","2024-05-10",0,0,13,0,0,13,0,0
"Indonesia","2024-05-11",0,0,13,0,0,13,0,0
"Indonesia","2024-05-12",0,0,13,0,0,13,0,0
"Indonesia","2024-05-13",0,0,13,0,0,13,0,0
"Indonesia","2024-05-14",0,0,13,0,0,13,0,0
"Indonesia","2024-05-15",0,0,13,0,0,13,0,0
"Indonesia","2024-05-16",0,0,13,0,1,14,0,0
"Indonesia","2024-05-17",0,0,13,0,0,14,0,0
"Indonesia","2024-05-18",0,0,13,0,0,14,0,0
"Indonesia","2024-05-19",0,0,13,0,0,14,0,0
"Indonesia","2024-05-20",0,0,13,0,0,14,0,0
"Indonesia","2024-05-21",0,0,13,0,0,14,0,0
"Indonesia","2024-05-22",0,0,13,0,0,14,0,0
"Indonesia","2024-05-23",0,0,13,0,0,14,0,0
"Indonesia","2024-05-24",0,0,13,0,0,14,0,0
"Indonesia","2024-05-25",0,0,13,0,0,14,0,0
"Indonesia","2024-05-26",0,0,13,0,0,14,0,0
"Indonesia","2024-05-27",0,0,13,0,0,14,0,0
"Indonesia","2024-05-28",0,0,13,0,0,14,0,0
"Indonesia","2024-05-29",0,0,13,0,0,14,0,0
"Indonesia","2024-05-30",0,0,13,0,0,14,0,0
"Indonesia","2024-05-31",0,1,14,0,0,14,0,0
"Indonesia","2024-06-01",0,0,14,0,0,14,0,0
"Indonesia","2024-06-02",0,0,14,0,0,14,0,0
"Indonesia","2024-06-03",0,0,14,0,0,14,0,0
"Indonesia","2024-06-04",0,0,14,0,0,14,0,0
"Indonesia","2024-06-05",0,0,14,0,0,14,0,0
"Indonesia","2024-06-06",0,0,14,0,0,14,0,0
"Indonesia","2024-06-07",0,0,14,0,0,14,0,0
"Indonesia","2024-06-08",0,0,14,0,0,14,0,0
"Indonesia","2024-06-09",0,0,14,0,0,14,0,0
"Indonesia","2024-06-10",0,0,14,0,0,14,0,0
"Indonesia","2024-06-11",0,0,14,0,0,14,0,0
"Indonesia","2024-06-12",0,0,14,0,0,14,0,0
"Indonesia","2024-06-13",0,0,14,0,0,14,0,0
"Indonesia","2024-06-14",0,0,14,0,0,14,0,0
"Indonesia","2024-06-15",0,0,14,0,0,14,0,0
"Indonesia","2024-06-16",0,0,14,0,1,15,0,0
"Indonesia","2024-06-17",0,0,14,0,0,15,0,0
"Indonesia","2024-06-18",0,0,14,0,0,15,0,0
"Indonesia","2024-06-19",0,0,14,0,0,15,0,0
"Indonesia","2024-06-20",0,0,14,0,0,15,0,0
"Indonesia","2024-06-21",0,0,14,0,0,15,0,0
"Indonesia","2024-06-22",0,0,14,0,0,15,0,0
"Indonesia","2024-06-23",0,0,14,0,0,15,0,0
"Indonesia","2024-06-24",0,0,14,0,0,15,0,0
"Indonesia","2024-06-25",0,0,14,0,0,15,0,0
"Indonesia","2024-06-26",0,0,14,0,0,15,0,0
"Indonesia","2024-06-27",0,0,14,0,0,15,0,0
"Indonesia","2024-06-28",0,0,14,0,0,15,0,0
"Indonesia","2024-06-29",0,0,14,0,0,15,0,0
"Indonesia","2024-06-30",0,1,15,0,0,15,0,0
"Indonesia","2024-07-01",0,0,15,0,0,15,0,0
"Indonesia","2024-07-02",0,0,15,0,0,15,0,0
"Indonesia","2024-07-03",0,0,15,0,0,15,0,0
"Indonesia","2024-07-04",0,0,15,0,0,15,0,0
"Indonesia","2024-07-05",0,0,15,0,0,15,0,0
"Indonesia","2024-07-06",0,0,15,0,0,15,0,0
"Indonesia","2024-07-07",0,0,15,0,0,15,0,0
"Indonesia","2024-07-08",0,0,15,0,0,15,0,0
"Indonesia","2024-07-09",0,0,15,0,0,15,0,0
"Indonesia","2024-07-10",0,0,15,0,0,15,0,0
"Indonesia","2024-07-11",0,0,15,0,0,15,0,0
"Indonesia","2024-07-12",0,0,15,0,0,15,0,0
"Indonesia","2024-07-13",0,0,15,0,0,15,0,0
"Indonesia","2024-07-14",0,0,15,0,0,15,0,0
"Indonesia","2024-07-15",0,0,15,0,0,15,0,0
"Indonesia","2024-07-16",0,0,15,0,0,15,0,0
"Indonesia","2024-07-17",0,0,15,0,0,15,0,0
"Indonesia","2024-07-18",0,0,15,0,0,15,0,0
"Indonesia","2024-07-19",0,0,15,0,0,15,0,0
"Indonesia","2024-07-20",0,0,15,0,0,15,0,0
"Indonesia","2024-07-21",0,0,15,0,0,15,0,0
"Indonesia","2024-07-22",0,0,15,0,0,15,0,0
"Indonesia","2024-07-23",0,0,15,0,0,15,0,0
"Indonesia","2024-07-24",0,0,15,0,0,15,0,0
"Indonesia","2024-07-25",0,0,15,0,0,15,0,0
"Indonesia","2024-07-26",0,0,15,0,0,15,0,0
"Indonesia","2024-07-27",0,0,15,0,0,15,0,0
"Indonesia","2024-07-28",0,0,15,0,0,15,0,0
"Indonesia","2024-07-29",0,0,15,0,0,15,0,0
"Indonesia","2024-07-30",0,0,15,0,0,15,0,0
"Indonesia","2024-07-31",0,0,15,0,0,15,0,0
"Indonesia","2024-08-01",0,0,15,0,0,15,0,0
"Indonesia","2024-08-02",0,0,15,0,0,15,0,0
"Indonesia","2024-08-03",0,0,15,0,0,15,0,0
"Indonesia","2024-08-04",0,0,15,0,0,15,0,0
"Indonesia","2024-08-05",0,0,15,0,0,15,0,0
"Indonesia","2024-08-06",0,0,15,0,0,15,0,0
"Indonesia","2024-08-07",0,0,15,0,0,15,0,0
"Indonesia","2024-08-08",0,0,15,0,0,15,0,0
"Indonesia","2024-08-09",0,0,15,0,0,15,0,0
"Indonesia","2024-08-10",0,0,15,0,0,15,0,0
"Indonesia","2024-08-11",0,0,15,0,0,15,0,0
"Indonesia","2024-08-12",0,0,15,0,0,15,0,0
"Indonesia","2024-08-13",0,0,15,0,0,15,0,0
"Indonesia","2024-08-14",0,0,15,0,0,15,0,0
"Indonesia","2024-08-15",0,0,15,0,0,15,0,0
"Indonesia","2024-08-16",0,0,15,0,0,15,0,0
"Indonesia","2024-08-17",0,0,15,0,0,15,0,0
"Indonesia","2024-08-18",0,0,15,0,0,15,0,0
"Indonesia","2024-08-19",0,0,15,0,0,15,0,0
"Indonesia","2024-08-20",0,0,15,0,0,15,0,0
"Indonesia","2024-08-21",0,0,15,0,0,15,0,0
"Indonesia","2024-08-22",0,0,15,0,0,15,0,0
"Indonesia","2024-08-23",0,0,15,0,0,15,0,0
"Indonesia","2024-08-24",0,0,15,0,0,15,0,0
"Indonesia","2024-08-25",0,0,15,0,0,15,0,0
"Indonesia","2024-08-26",0,0,15,0,0,15,0,0
"Indonesia","2024-08-27",0,0,15,0,0,15,0,0
"Indonesia","2024-08-28",0,0,15,0,0,15,0,0
"Indonesia","2024-08-29",0,0,15,0,0,15,0,0
"Indonesia","2024-08-30",0,0,15,0,0,15,0,0
"Indonesia","2024-08-31",0,0,15,0,0,15,0,0
"Indonesia","2024-09-01",0,0,15,0,0,15,0,0
"Indonesia","2024-09-02",0,0,15,0,0,15,0,0
"Indonesia","2024-09-03",0,0,15,0,0,15,0,0
"Indonesia","2024-09-04",0,0,15,0,0,15,0,0
"Indonesia","2024-09-05",0,0,15,0,0,15,0,0
"Indonesia","2024-09-06",0,0,15,0,0,15,0,0
"Indonesia","2024-09-07",0,0,15,0,0,15,0,0
"Indonesia","2024-09-08",0,0,15,0,0,15,0,0
"Indonesia","2024-09-09",0,0,15,0,0,15,0,0
"Indonesia","2024-09-10",0,0,15,0,0,15,0,0
"Indonesia","2024-09-11",0,0,15,0,0,15,0,0
"Indonesia","2024-09-12",0,0,15,0,0,15,0,0
"Indonesia","2024-09-13",0,0,15,0,0,15,0,0
"Indonesia","2024-09-14",0,0,15,0,0,15,0,0
"Indonesia","2024-09-15",0,0,15,0,0,15,0,0
"Indonesia","2024-09-16",0,0,15,0,0,15,0,0
"Indonesia","2024-09-17",0,0,15,0,0,15,0,0
"Indonesia","2024-09-18",0,0,15,0,0,15,0,0
"Indonesia","2024-09-19",0,0,15,0,0,15,0,0
"Indonesia","2024-09-20",0,0,15,0,0,15,0,0
"Indonesia","2024-09-21",0,0,15,0,0,15,0,0
"Indonesia","2024-09-22",0,0,15,0,0,15,0,0
"Indonesia","2024-09-23",0,0,15,0,0,15,0,0
"Indonesia","2024-09-24",0,0,15,0,0,15,0,0
"Indonesia","2024-09-25",0,0,15,0,0,15,0,0
"Indonesia","2024-09-26",0,0,15,0,0,15,0,0
"Indonesia","2024-09-27",0,0,15,0,0,15,0,0
"Indonesia","2024-09-28",0,0,15,0,0,15,0,0
"Indonesia","2024-09-29",0,0,15,0,0,15,0,0
"Indonesia","2024-09-30",0,0,15,0,0,15,0,0
"Indonesia","2024-10-01",0,0,15,0,0,15,0,0
"Indonesia","2024-10-02",0,0,15,0,0,15,0,0
"Indonesia","2024-10-03",0,0,15,0,0,15,0,0
"Indonesia","2024-10-04",0,0,15,0,0,15,0,0
"Indonesia","2024-10-05",0,0,15,0,0,15,0,0
"Indonesia","2024-10-06",0,0,15,0,0,15,0,0
"Indonesia","2024-10-07",0,0,15,0,0,15,0,0
"Indonesia","2024-10-08",0,0,15,0,0,15,0,0
"Indonesia","2024-10-09",0,0,15,0,0,15,0,0
"Indonesia","2024-10-10",0,0,15,0,0,15,0,0
"Indonesia","2024-10-11",0,0,15,0,0,15,0,0
"Indonesia","2024-10-12",0,0,15,0,0,15,0,0
"Indonesia","2024-10-13",0,0,15,0,0,15,0,0
"Indonesia","2024-10-14",0,0,15,0,0,15,0,0
"Indonesia","2024-10-15",0,0,15,0,0,15,0,0
"Indonesia","2024-10-16",0,0,15,0,0,15,0,0
"Indonesia","2024-10-17",0,0,15,0,0,15,0,0
"Indonesia","2024-10-18",0,0,15,0,0,15,0,0
"Indonesia","2024-10-19",0,0,15,0,0,15,0,0
"Indonesia","2024-10-20",0,0,15,0,0,15,0,0
"Indonesia","2024-10-21",0,0,15,0,0,15,0,0
"Indonesia","2024-10-22",0,0,15,0,0,15,0,0
"Indonesia","2024-10-23",0,0,15,0,0,15,0,0
"Indonesia","2024-10-24",0,0,15,0,0,15,0,0
"Indonesia","2024-10-25",0,0,15,0,0,15,0,0
"Indonesia","2024-10-26",0,0,15,0,0,15,0,0
"Indonesia","2024-10-27",0,0,15,0,0,15,0,0
"Indonesia","2024-10-28",0,0,15,0,0,15,0,0
"Indonesia","2024-10-29",0,0,15,0,0,15,0,0
"Indonesia","2024-10-30",0,0,15,0,0,15,0,0
"Indonesia","2024-10-31",0,0,15,0,0,15,0,0
"Indonesia","2024-11-01",0,0,15,0,0,15,0,0
"Indonesia","2024-11-02",0,0,15,0,0,15,0,0
"Indonesia","2024-11-03",0,0,15,0,0,15,0,0
"Indonesia","2024-11-04",0,0,15,0,0,15,0,0
"Indonesia","2024-11-05",0,0,15,0,0,15,0,0
"Indonesia","2024-11-06",0,0,15,0,0,15,0,0
"Indonesia","2024-11-07",0,0,15,0,0,15,0,0
"Indonesia","2024-11-08",0,0,15,0,0,15,0,0
"Indonesia","2024-11-09",0,0,15,0,0,15,0,0
"Indonesia","2024-11-10",0,0,15,0,0,15,0,0
"Indonesia","2024-11-11",0,0,15,0,0,15,0,0
"Indonesia","2024-11-12",0,0,15,0,0,15,0,0
"Indonesia","2024-11-13",0,0,15,0,0,15,0,0
"Indonesia","2024-11-14",0,0,15,0,0,15,0,0
"Indonesia","2024-11-15",0,0,15,0,0,15,0,0
"Indonesia","2024-11-16",0,0,15,0,0,15,0,0
"Indonesia","2024-11-17",0,0,15,0,0,15,0,0
"Indonesia","2024-11-18",0,0,15,0,0,15,0,0
"Indonesia","2024-11-19",0,0,15,0,0,15,0,0
"Indonesia","2024-11-20",0,0,15,0,0,15,0,0
"Indonesia","2024-11-21",0,0,15,0,0,15,0,0
"Indonesia","2024-11-22",0,0,15,0,0,15,0,0
"Indonesia","2024-11-23",0,0,15,0,0,15,0,0
"Indonesia","2024-11-24",0,0,15,0,0,15,0,0
"Indonesia","2024-11-25",0,0,15,0,0,15,0,0
"Indonesia","2024-11-26",0,0,15,0,0,15,0,0
"Indonesia","2024-11-27",0,0,15,0,0,15,0,0
"Indonesia","2024-11-28",0,0,15,0,0,15,0,0
"Indonesia","2024-11-29",0,0,15,0,0,15,0,0
"Indonesia","2024-11-30",0,0,15,0,0,15,0,0
"Indonesia","2024-12-01",0,0,15,0,0,15,0,0
"Indonesia","2024-12-02",0,0,15,0,0,15,0,0
"Indonesia","2024-12-03",0,0,15,0,0,15,0,0
"Indonesia","2024-12-04",0,0,15,0,0,15,0,0
"Indonesia","2024-12-05",0,0,15,0,0,15,0,0
"Indonesia","2024-12-06",0,0,15,0,0,15,0,0
"Indonesia","2024-12-07",0,0,15,0,0,15,0,0
"Indonesia","2024-12-08",0,0,15,0,0,15,0,0
"Indonesia","2024-12-09",0,0,15,0,0,15,0,0
"Ireland","2024-01-01",0,0,0,0,0,0,0,0
"Ireland","2024-01-02",0,0,0,0,0,0,0,0
"Ireland","2024-01-03",0,0,0,0,0,0,0,0
"Ireland","2024-01-04",0,0,0,0,0,0,0,0
"Ireland","2024-01-05",0,0,0,0,0,0,0,0
"Ireland","2024-01-06",0,0,0,0,0,0,0,0
"Ireland","2024-01-07",0,0,0,0,0,0,0,0
"Ireland","2024-01-08",0,0,0,0,0,0,0,0
"Ireland","2024-01-09",0,0,0,0,0,0,0,0
"Ireland","2024-01-10",0,0,0,0,0,0,0,0
"Ireland","2024-01-11",0,0,0,0,0,0,0,0
"Ireland","2024-01-12",0,0,0,0,0,0,0,0
"Ireland","2024-01-13",0,0,0,0,0,0,0,0
"Ireland","2024-01-14",0,0,0,0,0,0,0,0
"Ireland","2024-01-15",0,0,0,0,0,0,0,0
"Ireland","2024-01-16",0,0,0,0,0,0,0,0
"Ireland","2024-01-17",0,0,0,0,0,0,0,0
"Ireland","2024-01-18",0,0,0,0,0,0,0,0
"Ireland","2024-01-19",0,0,0,0,0,0,0,0
"Ireland","2024-01-20",0,0,0,0,0,0,0,0
"Ireland","2024-01-21",0,0,0,0,0,0,0,0
"Ireland","2024-01-22",0,0,0,0,0,0,0,0
"Ireland","2024-01-23",0,0,0,0,0,0,0,0
"Ireland","2024-01-24",0,0,0,0,0,0,0,0
"Ireland","2024-01-25",0,0,0,0,0,0,0,0
"Ireland","2024-01-26",0,0,0,0,0,0,0,0
"Ireland","2024-01-27",0,0,0,0,0,0,0,0
"Ireland","2024-01-28",0,0,0,0,0,0,0,0
"Ireland","2024-01-29",0,0,0,0,0,0,0,0
"Ireland","2024-01-30",0,0,0,0,0,0,0,0
"Ireland","2024-01-31",0,0,0,0,0,0,0,0
"Ireland","2024-02-01",0,0,0,0,0,0,0,0
"Ireland","2024-02-02",0,0,0,0,0,0,0,0
"Ireland","2024-02-03",0,0,0,0,0,0,0,0
"Ireland","2024-02-04",0,0,0,0,0,0,0,0
"Ireland","2024-02-05",0,0,0,0,0,0,0,0
"Ireland","2024-02-06",0,0,0,0,0,0,0,0
"Ireland","2024-02-07",0,0,0,0,0,0,0,0
"Ireland","2024-02-08",0,0,0,0,0,0,0,0
"Ireland","2024-02-09",0,0,0,0,0,0,0,0
"Ireland","2024-02-10",0,0,0,0,0,0,0,0
"Ireland","2024-02-11",0,0,0,0,0,0,0,0
"Ireland","2024-02-12",0,0,0,0,0,0,0,0
"Ireland","2024-02-13",0,0,0,0,0,0,0,0
"Ireland","2024-02-14",0,0,0,0,0,0,0,0
"Ireland","2024-02-15",0,0,0,0,0,0,0,0
"Ireland","2024-02-16",0,0,0,0,0,0,0,0
"Ireland","2024-02-17",0,0,0,0,0,0,0,0
"Ireland","2024-02-18",0,0,0,0,0,0,0,0
"Ireland","2024-02-19",0,0,0,0,0,0,0,0
"Ireland","2024-02-20",0,0,0,0,0,0,0,0
"Ireland","2024-02-21",0,0,0,0,0,0,0,0
"Ireland","2024-02-22",0,0,0,0,0,0,0,0
"Ireland","2024-02-23",0,0,0,0,0,0,0,0
"Ireland","2024-02-24",0,0,0,0,0,0,0,0
"Ireland","2024-02-25",0,0,0,0,0,0,0,0
"Ireland","2024-02-26",0,0,0,0,0,0,0,0
"Ireland","2024-02-27",0,0,0,0,0,0,0,0
"Ireland","2024-02-28",0,0,0,0,0,0,0,0
"Ireland","2024-02-29",0,1,1,0,1,1,0,0
"Ireland","2024-03-01",0,0,1,0,0,1,0,0
"Ireland","2024-03-02",0,0,1,0,0,1,0,0
"Ireland","2024-03-03",0,0,1,0,0,1,0,0
"Ireland","2024-03-04",0,0,1,0,0,1,0,0
"Ireland","2024-03-05",0,0,1,0,0,1,0,0
"Ireland","2024-03-06",0,0,1,0,0,1,0,0
"Ireland","2024-03-07",0,0,1,0,0,1,0,0
"Ireland","2024-03-08",0,0,1,0,0,1,0,0
"Ireland","2024-03-09",0,0,1,0,0,1,0,0
"Ireland","2024-03-10",0,0,1,0,0,1,0,0
"Ireland","2024-03-11",0,0,1,0,0,1,0,0
"Ireland","2024-03-12",0,0,1,0,0,1,0,0
"Ireland","2024-03-13",0,0,1,0,0,1,0,0
"Ireland","2024-03-14",0,0,1,0,0,1,0,0
"Ireland","2024-03-15",0,0,1,0,0,1,0,0
"Ireland","2024-03-16",0,0,1,0,0,1,0,0
"Ireland","2024-03-17",0,0,1,0,0,1,0,0
"Ireland","2024-03-18",0,0,1,0,0,1,0,0
"Ireland","2024-03-19",0,0,1,0,0,1,0,0
"Ireland","2024-03-20",0,0,1,0,0,1,0,0
"Ireland","2024-03-21",0,0,1,0,0,1,0,0
"Ireland","2024-03-22",0,0,1,0,0,1,0,0
"Ireland","2024-03-23",0,0,1,0,0,1,0,0
"Ireland","2024-03-24",0,0,1,0,0,1,0,0
"Ireland","2024-03-25",0,0,1,0,0,1,0,0
"Ireland","2024-03-26",0,0,1,0,0,1,0,0
"Ireland","2024-03-27",0,0,1,0,0,1,0,0
"Ireland","2024-03-28",0,0,1,0,0,1,0,0
"Ireland","2024-03-29",0,0,1,0,0,1,0,0
"Ireland","2024-03-30",0,0,1,0,0,1,0,0
"Ireland","2024-03-31",0,0,1,0,1,2,0,0
"Ireland","2024-04-01",0,0,1,0,0,2,0,0
"Ireland","2024-04-02",0,0,1,0,0,2,0,0
"Ireland","2024-04-03",0,0,1,0,0,2,0,0
"Ireland","2024-04-04",0,0,1,0,0,2,0,0
"Ireland","2024-04-05",0,0,1,0,0,2,0,0
"Ireland","2024-04-06",0,0,1,0,0,2,0,0
"Ireland","2024-04-07",0,0,1,0,0,2,0,0
"Ireland","2024-04-08",0,0,1,0,0,2,0,0
"Ireland","2024-04-09",0,0,1,0,0,2,0,0
"Ireland","2024-04-10",0,0,1,0,0,2,0,0
"Ireland","2024-04-11",0,0,1,0,0,2,0,0
"Ireland","2024-04-12",0,0,1,0,0,2,0,0
"Ireland","2024-04-13",0,0,1,0,0,2,0,0
"Ireland","2024-04-14",0,0,1,0,0,2,0,0
"Ireland","2024-04-15",0,0,1,0,0,2,0,0
"Ireland","2024-04-16",0,0,1,0,0,2,0,0
"Ireland","2024-04-17",0,0,1,0,0,2,0,0
"Ireland","2024-04-18",0,0,1,0,0,2,0,0
"Ireland","2024-04-19",0,0,1,0,0,2,0,0
"Ireland","2024-04-20",0,0,1,0,0,2,0,0
"Ireland","2024-04-21",0,0,1,0,0,2,0,0
"Ireland","2024-04-22",0,0,1,0,0,2,0,0
"Ireland","2024-04-23",0,0,1,0,0,2,0,0
"Ireland","2024-04-24",0,0,1,0,0,2,0,0
"Ireland","2024-04-25",0,0,1,0,0,2,0,0
"Ireland","2024-04-26",0,0,1,0,0,2,0,0
"Ireland","2024-04-27",0,0,1,0,0,2,0,0
"Ireland","2024-04-28",0,0,1,0,0,2,0,0
"Ireland","2024-04-29",0,0,1,0,0,2,0,0
"Ireland","2024-04-30",0,1,2,0,0,2,0,0
"Ireland","2024-05-01",0,0,2,0,0,2,0,0
"Ireland","2024-05-02",0,0,2,0,0,2,0,0
"Ireland","2024-05-03",0,0,2,0,0,2,0,0
"Ireland","2024-05-04",0,0,2,0,0,2,0,0
"Ireland","2024-05-05",0,0,2,0,0,2,0,0
"Ireland","2024-05-06",0,0,2,0,0,2,0,0
"Ireland","2024-05-07",0,0,2,0,0,2,0,0
"Ireland","2024-05-08",0,0,2,0,0,2,0,0
"Ireland","2024-05-09",0,0,2,0,0,2,0,0
"Ireland","2024-05-10",0,0,2,0,0,2,0,0
"Ireland","2024-05-11",0,0,2,0,0,2,0,0
"Ireland","2024-05-12",0,0,2,0,0,2,0,0
"Ireland","2024-05-13",0,0,2,0,0,2,0,0
"Ireland","2024-05-14",0,0,2,0,0,2,0,0
"Ireland","2024-05-15",0,0,2,0,0,2,0,0
"Ireland","2024-05-16",0,0,2,0,1,3,0,0
"Ireland","2024-05-17",0,0,2,0,0,3,0,0
"Ireland","2024-05-18",0,0,2,0,0,3,0,0
"Ireland","2024-05-19",0,0,2,0,0,3,0,0
"Ireland","2024-05-20",0,0,2,0,0,3,0,0
"Ireland","2024-05-21",0,0,2,0,0,3,0,0
"Ireland","2024-05-22",0,0,2,0,0,3,0,0
"Ireland","2024-05-23",0,0,2,0,0,3,0,0
"Ireland","2024-05-24",0,0,2,0,0,3,0,0
"Ireland","2024-05-25",0,0,2,0,0,3,0,0
"Ireland","2024-05-26",0,0,2,0,0,3,0,0
"Ireland","2024-05-27",0,0,2,0,0,3,0,0
"Ireland","2024-05-28",0,0,2,0,0,3,0,0
"Ireland","2024-05-29",0,0,2,0,0,3,0,0
"Ireland","2024-05-30",0,0,2,0,0,3,0,0
"Ireland","2024-05-31",0,1,3,0,0,3,0,0
"Ireland","2024-06-01",0,0,3,0,0,3,0,0
"Ireland","2024-06-02",0,0,3,0,0,3,0,0
"Ireland","2024-06-03",0,0,3,0,0,3,0,0
"Ireland","2024-06-04",0,0,3,0,0,3,0,0
"Ireland","2024-06-05",0,0,3,0,0,3,0,0
"Ireland","2024-06-06",0,0,3,0,0,3,0,0
"Ireland","2024-06-07",0,0,3,0,0,3,0,0
"Ireland","2024-06-08",0,0,3,0,1,4,0,0
"Ireland","2024-06-09",0,0,3,0,0,4,0,0
"Ireland","2024-06-10",0,0,3,0,0,4,0,0
"Ireland","2024-06-11",0,0,3,0,0,4,0,0
"Ireland","2024-06-12",0,0,3,0,0,4,0,0
"Ireland","2024-06-13",0,0,3,0,0,4,0,0
"Ireland","2024-06-14",0,0,3,0,0,4,0,0
"Ireland","2024-06-15",0,0,3,0,0,4,0,0
"Ireland","2024-06-16",0,0,3,0,0,4,0,0
"Ireland","2024-06-17",0,0,3,0,0,4,0,0
"Ireland","2024-06-18",0,0,3,0,0,4,0,0
"Ireland","2024-06-19",0,0,3,0,0,4,0,0
"Ireland","2024-06-20",0,0,3,0,0,4,0,0
"Ireland","2024-06-21",0,0,3,0,0,4,0,0
"Ireland","2024-06-22",0,0,3,0,0,4,0,0
"Ireland","2024-06-23",0,0,3,0,1,5,0,0
"Ireland","2024-06-24",0,0,3,0,0,5,0,0
"Ireland","2024-06-25",0,0,3,0,0,5,0,0
"Ireland","2024-06-26",0,0,3,0,0,5,0,0
"Ireland","2024-06-27",0,0,3,0,0,5,0,0
"Ireland","2024-06-28",0,0,3,0,0,5,0,0
"Ireland","2024-06-29",0,0,3,0,0,5,0,0
"Ireland","2024-06-30",0,2,5,0,0,5,0,0
"Ireland","2024-07-01",0,0,5,0,0,5,0,0
"Ireland","2024-07-02",0,0,5,0,0,5,0,0
"Ireland","2024-07-03",0,0,5,0,0,5,0,0
"Ireland","2024-07-04",0,0,5,0,0,5,0,0
"Ireland","2024-07-05",0,0,5,0,0,5,0,0
"Ireland","2024-07-06",0,0,5,0,0,5,0,0
"Ireland","2024-07-07",0,0,5,0,0,5,0,0
"Ireland","2024-07-08",0,0,5,0,0,5,0,0
"Ireland","2024-07-09",0,0,5,0,0,5,0,0
"Ireland","2024-07-10",0,0,5,0,0,5,0,0
"Ireland","2024-07-11",0,0,5,0,0,5,0,0
"Ireland","2024-07-12",0,0,5,0,0,5,0,0
"Ireland","2024-07-13",0,0,5,0,0,5,0,0
"Ireland","2024-07-14",0,0,5,0,0,5,0,0
"Ireland","2024-07-15",0,0,5,0,0,5,0,0
"Ireland","2024-07-16",0,0,5,0,0,5,0,0
"Ireland","2024-07-17",0,0,5,0,0,5,0,0
"Ireland","2024-07-18",0,0,5,0,0,5,0,0
"Ireland","2024-07-19",0,0,5,0,0,5,0,0
"Ireland","2024-07-20",0,0,5,0,0,5,0,0
"Ireland","2024-07-21",0,0,5,0,0,5,0,0
"Ireland","2024-07-22",0,0,5,0,0,5,0,0
"Ireland","2024-07-23",0,0,5,0,0,5,0,0
"Ireland","2024-07-24",0,0,5,0,0,5,0,0
"Ireland","2024-07-25",0,0,5,0,0,5,0,0
"Ireland","2024-07-26",0,0,5,0,0,5,0,0
"Ireland","2024-07-27",0,0,5,0,0,5,0,0
"Ireland","2024-07-28",0,0,5,0,0,5,0,0
"Ireland","2024-07-29",0,0,5,0,0,5,0,0
"Ireland","2024-07-30",0,0,5,0,0,5,0,0
"Ireland","2024-07-31",0,0,5,0,0,5,0,0
"Ireland","2024-08-01",0,0,5,0,1,6,0,0
"Ireland","2024-08-02",0,0,5,0,0,6,0,0
"Ireland","2024-08-03",0,0,5,0,0,6,0,0
"Ireland","2024-08-04",0,0,5,0,0,6,0,0
"Ireland","2024-08-05",0,0,5,0,0,6,0,0
"Ireland","2024-08-06",0,0,5,0,0,6,0,0
"Ireland","2024-08-07",0,0,5,0,0,6,0,0
"Ireland","2024-08-08",0,0,5,0,0,6,0,0
"Ireland","2024-08-09",0,0,5,0,0,6,0,0
"Ireland","2024-08-10",0,0,5,0,0,6,0,0
"Ireland","2024-08-11",0,0,5,0,0,6,0,0
"Ireland","2024-08-12",0,0,5,0,0,6,0,0
"Ireland","2024-08-13",0,0,5,0,0,6,0,0
"Ireland","2024-08-14",0,0,5,0,0,6,0,0
"Ireland","2024-08-15",0,0,5,0,0,6,0,0
"Ireland","2024-08-16",0,0,5,0,0,6,0,0
"Ireland","2024-08-17",0,0,5,0,0,6,0,0
"Ireland","2024-08-18",0,0,5,0,0,6,0,0
"Ireland","2024-08-19",0,0,5,0,0,6,0,0
"Ireland","2024-08-20",0,0,5,0,0,6,0,0
"Ireland","2024-08-21",0,0,5,0,0,6,0,0
"Ireland","2024-08-22",0,0,5,0,0,6,0,0
"Ireland","2024-08-23",0,0,5,0,0,6,0,0
"Ireland","2024-08-24",0,0,5,0,0,6,0,0
"Ireland","2024-08-25",0,0,5,0,0,6,0,0
"Ireland","2024-08-26",0,0,5,0,0,6,0,0
"Ireland","2024-08-27",0,0,5,0,0,6,0,0
"Ireland","2024-08-28",0,0,5,0,0,6,0,0
"Ireland","2024-08-29",0,0,5,0,0,6,0,0
"Ireland","2024-08-30",0,0,5,0,0,6,0,0
"Ireland","2024-08-31",0,1,6,0,0,6,0,0
"Ireland","2024-09-01",0,0,6,0,0,6,0,0
"Ireland","2024-09-02",0,0,6,0,0,6,0,0
"Ireland","2024-09-03",0,0,6,0,0,6,0,0
"Ireland","2024-09-04",0,0,6,0,0,6,0,0
"Ireland","2024-09-05",0,0,6,0,0,6,0,0
"Ireland","2024-09-06",0,0,6,0,1,7,0,0
"Ireland","2024-09-07",0,0,6,0,0,7,0,0
"Ireland","2024-09-08",0,0,6,0,0,7,0,0
"Ireland","2024-09-09",0,0,6,0,0,7,0,0
"Ireland","2024-09-10",0,0,6,0,0,7,0,0
"Ireland","2024-09-11",0,0,6,0,0,7,0,0
"Ireland","2024-09-12",0,0,6,0,0,7,0,0
"Ireland","2024-09-13",0,0,6,0,0,7,0,0
"Ireland","2024-09-14",0,0,6,0,0,7,0,0
"Ireland","2024-09-15",0,0,6,0,1,8,0,0
"Ireland","2024-09-16",0,0,6,0,0,8,0,0
"Ireland","2024-09-17",0,0,6,0,0,8,0,0
"Ireland","2024-09-18",0,0,6,0,0,8,0,0
"Ireland","2024-09-19",0,0,6,0,0,8,0,0
"Ireland","2024-09-20",0,0,6,0,0,8,0,0
"Ireland","2024-09-21",0,0,6,0,0,8,0,0
"Ireland","2024-09-22",0,0,6,0,0,8,0,0
"Ireland","2024-09-23",0,0,6,0,0,8,0,0
"Ireland","2024-09-24",0,0,6,0,0,8,0,0
"Ireland","2024-09-25",0,0,6,0,0,8,0,0
"Ireland","2024-09-26",0,0,6,0,1,9,0,0
"Ireland","2024-09-27",0,0,6,0,0,9,0,0
"Ireland","2024-09-28",0,0,6,0,0,9,0,0
"Ireland","2024-09-29",0,0,6,0,0,9,0,0
"Ireland","2024-09-30",0,3,9,0,0,9,0,0
"Ireland","2024-10-01",0,0,9,0,0,9,0,0
"Ireland","2024-10-02",0,0,9,0,1,10,0,0
"Ireland","2024-10-03",0,0,9,0,0,10,0,0
"Ireland","2024-10-04",0,0,9,0,0,10,0,0
"Ireland","2024-10-05",0,0,9,0,0,10,0,0
"Ireland","2024-10-06",0,0,9,0,1,11,0,0
"Ireland","2024-10-07",0,0,9,0,0,11,0,0
"Ireland","2024-10-08",0,0,9,0,0,11,0,0
"Ireland","2024-10-09",0,0,9,0,0,11,0,0
"Ireland","2024-10-10",0,0,9,0,1,12,0,0
"Ireland","2024-10-11",0,0,9,0,0,12,0,0
"Ireland","2024-10-12",0,0,9,0,0,12,0,0
"Ireland","2024-10-13",0,0,9,0,0,12,0,0
"Ireland","2024-10-14",0,0,9,0,1,13,0,0
"Ireland","2024-10-15",0,0,9,0,0,13,0,0
"Ireland","2024-10-16",0,0,9,0,0,13,0,0
"Ireland","2024-10-17",0,0,9,0,0,13,0,0
"Ireland","2024-10-18",0,0,9,0,1,14,0,0
"Ireland","2024-10-19",0,0,9,0,0,14,0,0
"Ireland","2024-10-20",0,0,9,0,0,14,0,0
"Ireland","2024-10-21",0,0,9,0,0,14,0,0
"Ireland","2024-10-22",0,0,9,0,1,15,0,0
"Ireland","2024-10-23",0,0,9,0,0,15,0,0
"Ireland","2024-10-24",0,0,9,0,0,15,0,0
"Ireland","2024-10-25",0,0,9,0,0,15,0,0
"Ireland","2024-10-26",0,0,9,0,1,16,0,0
"Ireland","2024-10-27",0,0,9,0,0,16,0,0
"Ireland","2024-10-28",0,0,9,0,0,16,0,0
"Ireland","2024-10-29",0,0,9,0,0,16,0,0
"Ireland","2024-10-30",0,0,9,0,1,17,0,0
"Ireland","2024-10-31",0,8,17,0,0,17,0,0
"Ireland","2024-11-01",0,0,17,0,0,17,0,0
"Ireland","2024-11-02",0,0,17,0,0,17,0,0
"Ireland","2024-11-03",0,0,17,0,0,17,0,0
"Ireland","2024-11-04",0,0,17,0,0,17,0,0
"Ireland","2024-11-05",0,0,17,0,0,17,0,0
"Ireland","2024-11-06",0,0,17,0,0,17,0,0
"Ireland","2024-11-07",0,0,17,0,0,17,0,0
"Ireland","2024-11-08",0,0,17,0,0,17,0,0
"Ireland","2024-11-09",0,0,17,0,0,17,0,0
"Ireland","2024-11-10",0,0,17,0,0,17,0,0
"Ireland","2024-11-11",0,0,17,0,0,17,0,0
"Ireland","2024-11-12",0,0,17,0,0,17,0,0
"Ireland","2024-11-13",0,0,17,0,0,17,0,0
"Ireland","2024-11-14",0,0,17,0,0,17,0,0
"Ireland","2024-11-15",0,0,17,0,0,17,0,0
"Ireland","2024-11-16",0,0,17,0,0,17,0,0
"Ireland","2024-11-17",0,0,17,0,0,17,0,0
"Ireland","2024-11-18",0,0,17,0,0,17,0,0
"Ireland","2024-11-19",0,0,17,0,0,17,0,0
"Ireland","2024-11-20",0,0,17,0,0,17,0,0
"Ireland","2024-11-21",0,0,17,0,0,17,0,0
"Ireland","2024-11-22",0,0,17,0,0,17,0,0
"Ireland","2024-11-23",0,0,17,0,0,17,0,0
"Ireland","2024-11-24",0,0,17,0,0,17,0,0
"Ireland","2024-11-25",0,0,17,0,0,17,0,0
"Ireland","2024-11-26",0,0,17,0,0,17,0,0
"Ireland","2024-11-27",0,0,17,0,0,17,0,0
"Ireland","2024-11-28",0,0,17,0,0,17,0,0
"Ireland","2024-11-29",0,0,17,0,0,17,0,0
"Ireland","2024-11-30",0,0,17,0,0,17,0,0
"Ireland","2024-12-01",0,0,17,0,0,17,0,0
"Ireland","2024-12-02",0,0,17,0,0,17,0,0
"Ireland","2024-12-03",0,0,17,0,0,17,0,0
"Ireland","2024-12-04",0,0,17,0,0,17,0,0
"Ireland","2024-12-05",0,0,17,0,0,17,0,0
"Ireland","2024-12-06",0,0,17,0,0,17,0,0
"Ireland","2024-12-07",0,0,17,0,0,17,0,0
"Ireland","2024-12-08",0,0,17,0,0,17,0,0
"Ireland","2024-12-09",0,0,17,0,0,17,0,0
"Israel","2024-01-01",0,0,0,0,0,0,0,0
"Israel","2024-01-02",0,0,0,0,0,0,0,0
"Israel","2024-01-03",0,0,0,0,0,0,0,0
"Israel","2024-01-04",0,0,0,0,0,0,0,0
"Israel","2024-01-05",0,0,0,0,0,0,0,0
"Israel","2024-01-06",0,0,0,0,0,0,0,0
"Israel","2024-01-07",0,0,0,0,0,0,0,0
"Israel","2024-01-08",0,0,0,0,0,0,0,0
"Israel","2024-01-09",0,0,0,0,0,0,0,0
"Israel","2024-01-10",0,0,0,0,0,0,0,0
"Israel","2024-01-11",0,0,0,0,0,0,0,0
"Israel","2024-01-12",0,0,0,0,0,0,0,0
"Israel","2024-01-13",0,0,0,0,0,0,0,0
"Israel","2024-01-14",0,0,0,0,0,0,0,0
"Israel","2024-01-15",0,0,0,0,0,0,0,0
"Israel","2024-01-16",0,0,0,0,0,0,0,0
"Israel","2024-01-17",0,0,0,0,0,0,0,0
"Israel","2024-01-18",0,0,0,0,0,0,0,0
"Israel","2024-01-19",0,0,0,0,0,0,0,0
"Israel","2024-01-20",0,0,0,0,0,0,0,0
"Israel","2024-01-21",0,0,0,0,0,0,0,0
"Israel","2024-01-22",0,0,0,0,0,0,0,0
"Israel","2024-01-23",0,0,0,0,0,0,0,0
"Israel","2024-01-24",0,0,0,0,0,0,0,0
"Israel","2024-01-25",0,0,0,0,0,0,0,0
"Israel","2024-01-26",0,0,0,0,0,0,0,0
"Israel","2024-01-27",0,0,0,0,0,0,0,0
"Israel","2024-01-28",0,0,0,0,0,0,0,0
"Israel","2024-01-29",0,0,0,0,0,0,0,0
"Israel","2024-01-30",0,0,0,0,0,0,0,0
"Israel","2024-01-31",0,0,0,0,0,0,0,0
"Israel","2024-02-01",0,0,0,0,0,0,0,0
"Israel","2024-02-02",0,0,0,0,0,0,0,0
"Israel","2024-02-03",0,0,0,0,0,0,0,0
"Israel","2024-02-04",0,0,0,0,0,0,0,0
"Israel","2024-02-05",0,0,0,0,0,0,0,0
"Israel","2024-02-06",0,0,0,0,0,0,0,0
"Israel","2024-02-07",0,0,0,0,0,0,0,0
"Israel","2024-02-08",0,0,0,0,0,0,0,0
"Israel","2024-02-09",0,0,0,0,0,0,0,0
"Israel","2024-02-10",0,0,0,0,0,0,0,0
"Israel","2024-02-11",0,0,0,0,0,0,0,0
"Israel","2024-02-12",0,0,0,0,0,0,0,0
"Israel","2024-02-13",0,0,0,0,0,0,0,0
"Israel","2024-02-14",0,0,0,0,0,0,0,0
"Israel","2024-02-15",0,0,0,0,0,0,0,0
"Israel","2024-02-16",0,0,0,0,0,0,0,0
"Israel","2024-02-17",0,0,0,0,0,0,0,0
"Israel","2024-02-18",0,0,0,0,0,0,0,0
"Israel","2024-02-19",0,0,0,0,0,0,0,0
"Israel","2024-02-20",0,0,0,0,0,0,0,0
"Israel","2024-02-21",0,0,0,0,0,0,0,0
"Israel","2024-02-22",0,0,0,0,0,0,0,0
"Israel","2024-02-23",0,0,0,0,0,0,0,0
"Israel","2024-02-24",0,0,0,0,0,0,0,0
"Israel","2024-02-25",0,0,0,0,0,0,0,0
"Israel","2024-02-26",0,0,0,0,0,0,0,0
"Israel","2024-02-27",0,0,0,0,0,0,0,0
"Israel","2024-02-28",0,0,0,0,0,0,0,0
"Israel","2024-02-29",0,18,18,0,18,18,0,0
"Israel","2024-03-01",0,0,18,0,0,18,0,0
"Israel","2024-03-02",0,0,18,0,0,18,0,0
"Israel","2024-03-03",0,0,18,0,0,18,0,0
"Israel","2024-03-04",0,0,18,0,0,18,0,0
"Israel","2024-03-05",0,0,18,0,0,18,0,0
"Israel","2024-03-06",0,0,18,0,0,18,0,0
"Israel","2024-03-07",0,0,18,0,0,18,0,0
"Israel","2024-03-08",0,0,18,0,0,18,0,0
"Israel","2024-03-09",0,0,18,0,0,18,0,0
"Israel","2024-03-10",0,0,18,0,0,18,0,0
"Israel","2024-03-11",0,0,18,0,0,18,0,0
"Israel","2024-03-12",0,0,18,0,0,18,0,0
"Israel","2024-03-13",0,0,18,0,0,18,0,0
"Israel","2024-03-14",0,0,18,0,0,18,0,0
"Israel","2024-03-15",0,0,18,0,0,18,0,0
"Israel","2024-03-16",0,0,18,0,0,18,0,0
"Israel","2024-03-17",0,0,18,0,0,18,0,0
"Israel","2024-03-18",0,0,18,0,0,18,0,0
"Israel","2024-03-19",0,0,18,0,0,18,0,0
"Israel","2024-03-20",0,0,18,0,0,18,0,0
"Israel","2024-03-21",0,0,18,0,1,19,0,0
"Israel","2024-03-22",0,0,18,0,0,19,0,0
"Israel","2024-03-23",0,0,18,0,0,19,0,0
"Israel","2024-03-24",0,0,18,0,0,19,0,0
"Israel","2024-03-25",0,0,18,0,0,19,0,0
"Israel","2024-03-26",0,0,18,0,0,19,0,0
"Israel","2024-03-27",0,0,18,0,0,19,0,0
"Israel","2024-03-28",0,0,18,0,0,19,0,0
"Israel","2024-03-29",0,0,18,0,0,19,0,0
"Israel","2024-03-30",0,0,18,0,0,19,0,0
"Israel","2024-03-31",0,0,18,0,0,19,0,0
"Israel","2024-04-01",0,0,18,0,0,19,0,0
"Israel","2024-04-02",0,0,18,0,0,19,0,0
"Israel","2024-04-03",0,0,18,0,0,19,0,0
"Israel","2024-04-04",0,0,18,0,0,19,0,0
"Israel","2024-04-05",0,0,18,0,0,19,0,0
"Israel","2024-04-06",0,0,18,0,0,19,0,0
"Israel","2024-04-07",0,0,18,0,0,19,0,0
"Israel","2024-04-08",0,0,18,0,0,19,0,0
"Israel","2024-04-09",0,1,19,0,0,19,0,0
"Israel","2024-04-10",0,0,19,0,0,19,0,0
"Israel","2024-04-11",0,0,19,0,1,20,0,0
"Israel","2024-04-12",0,0,19,0,0,20,0,0
"Israel","2024-04-13",0,0,19,0,0,20,0,0
"Israel","2024-04-14",0,0,19,0,1,21,0,0
"Israel","2024-04-15",0,0,19,0,0,21,0,0
"Israel","2024-04-16",0,0,19,0,0,21,0,0
"Israel","2024-04-17",0,0,19,0,1,22,0,0
"Israel","2024-04-18",0,0,19,0,0,22,0,0
"Israel","2024-04-19",0,0,19,0,0,22,0,0
"Israel","2024-04-20",0,0,19,0,1,23,0,0
"Israel","2024-04-21",0,0,19,0,0,23,0,0
"Israel","2024-04-22",0,0,19,0,0,23,0,0
"Israel","2024-04-23",0,0,19,0,1,24,0,0
"Israel","2024-04-24",0,0,19,0,0,24,0,0
"Israel","2024-04-25",0,0,19,0,1,25,0,0
"Israel","2024-04-26",0,0,19,0,0,25,0,0
"Israel","2024-04-27",0,0,19,0,0,25,0,0
"Israel","2024-04-28",0,0,19,0,1,26,0,0
"Israel","2024-04-29",0,0,19,0,0,26,0,0
"Israel","2024-04-30",0,0,19,0,0,26,0,0
"Israel","2024-05-01",0,0,19,0,1,27,0,0
"Israel","2024-05-02",0,0,19,0,0,27,0,0
"Israel","2024-05-03",0,0,19,0,0,27,0,0
"Israel","2024-05-04",0,0,19,0,1,28,0,0
"Israel","2024-05-05",0,0,19,0,0,28,0,0
"Israel","2024-05-06",0,0,19,0,0,28,0,0
"Israel","2024-05-07",0,0,19,0,1,29,0,0
"Israel","2024-05-08",0,0,19,0,0,29,0,0
"Israel","2024-05-09",0,0,19,0,0,29,0,0
"Israel","2024-05-10",0,0,19,0,1,30,0,0
"Israel","2024-05-11",0,0,19,0,0,30,0,0
"Israel","2024-05-12",0,0,19,0,0,30,0,0
"Israel","2024-05-13",0,0,19,0,1,31,0,0
"Israel","2024-05-14",0,0,19,0,0,31,0,0
"Israel","2024-05-15",0,0,19,0,0,31,0,0
"Israel","2024-05-16",0,0,19,0,1,32,0,0
"Israel","2024-05-17",0,0,19,0,0,32,0,0
"Israel","2024-05-18",0,0,19,0,1,33,0,0
"Israel","2024-05-19",0,0,19,0,0,33,0,0
"Israel","2024-05-20",0,0,19,0,0,33,0,0
"Israel","2024-05-21",0,0,19,0,1,34,0,0
"Israel","2024-05-22",0,0,19,0,0,34,0,0
"Israel","2024-05-23",0,0,19,0,0,34,0,0
"Israel","2024-05-24",0,0,19,0,1,35,0,0
"Israel","2024-05-25",0,0,19,0,0,35,0,0
"Israel","2024-05-26",0,0,19,0,0,35,0,0
"Israel","2024-05-27",0,0,19,0,1,36,0,0
"Israel","2024-05-28",0,0,19,0,0,36,0,0
"Israel","2024-05-29",0,0,19,0,0,36,0,0
"Israel","2024-05-30",0,0,19,0,1,37,0,0
"Israel","2024-05-31",0,18,37,0,0,37,0,0
"Israel","2024-06-01",0,0,37,0,0,37,0,0
"Israel","2024-06-02",0,0,37,0,0,37,0,0
"Israel","2024-06-03",0,0,37,0,0,37,0,0
"Israel","2024-06-04",0,0,37,0,0,37,0,0
"Israel","2024-06-05",0,0,37,0,0,37,0,0
"Israel","2024-06-06",0,0,37,0,0,37,0,0
"Israel","2024-06-07",0,0,37,0,0,37,0,0
"Israel","2024-06-08",0,0,37,0,1,38,0,0
"Israel","2024-06-09",0,0,37,0,0,38,0,0
"Israel","2024-06-10",0,0,37,0,0,38,0,0
"Israel","2024-06-11",0,0,37,0,0,38,0,0
"Israel","2024-06-12",0,0,37,0,0,38,0,0
"Israel","2024-06-13",0,0,37,0,0,38,0,0
"Israel","2024-06-14",0,0,37,0,0,38,0,0
"Israel","2024-06-15",0,0,37,0,0,38,0,0
"Israel","2024-06-16",0,0,37,0,0,38,0,0
"Israel","2024-06-17",0,0,37,0,0,38,0,0
"Israel","2024-06-18",0,0,37,0,0,38,0,0
"Israel","2024-06-19",0,0,37,0,0,38,0,0
"Israel","2024-06-20",0,0,37,0,0,38,0,0
"Israel","2024-06-21",0,0,37,0,0,38,0,0
"Israel","2024-06-22",0,0,37,0,0,38,0,0
"Israel","2024-06-23",0,0,37,0,1,39,0,0
"Israel","2024-06-24",0,0,37,0,0,39,0,0
"Israel","2024-06-25",0,0,37,0,0,39,0,0
"Israel","2024-06-26",0,0,37,0,0,39,0,0
"Israel","2024-06-27",0,0,37,0,0,39,0,0
"Israel","2024-06-28",0,0,37,0,0,39,0,0
"Israel","2024-06-29",0,0,37,0,0,39,0,0
"Israel","2024-06-30",0,2,39,0,0,39,0,0
"Israel","2024-07-01",0,0,39,0,0,39,0,0
"Israel","2024-07-02",0,0,39,0,0,39,0,0
"Israel","2024-07-03",0,0,39,0,0,39,0,0
"Israel","2024-07-04",0,0,39,0,0,39,0,0
"Israel","2024-07-05",0,0,39,0,0,39,0,0
"Israel","2024-07-06",0,0,39,0,1,40,0,0
"Israel","2024-07-07",0,0,39,0,0,40,0,0
"Israel","2024-07-08",0,0,39,0,0,40,0,0
"Israel","2024-07-09",0,0,39,0,0,40,0,0
"Israel","2024-07-10",0,0,39,0,0,40,0,0
"Israel","2024-07-11",0,0,39,0,0,40,0,0
"Israel","2024-07-12",0,0,39,0,0,40,0,0
"Israel","2024-07-13",0,0,39,0,0,40,0,0
"Israel","2024-07-14",0,0,39,0,0,40,0,0
"Israel","2024-07-15",0,0,39,0,0,40,0,0
"Israel","2024-07-16",0,0,39,0,1,41,0,0
"Israel","2024-07-17",0,0,39,0,0,41,0,0
"Israel","2024-07-18",0,0,39,0,0,41,0,0
"Israel","2024-07-19",0,0,39,0,0,41,0,0
"Israel","2024-07-20",0,0,39,0,0,41,0,0
"Israel","2024-07-21",0,0,39,0,0,41,0,0
"Israel","2024-07-22",0,0,39,0,0,41,0,0
"Israel","2024-07-23",0,0,39,0,0,41,0,0
"Israel","2024-07-24",0,0,39,0,0,41,0,0
"Israel","2024-07-25",0,0,39,0,0,41,0,0
"Israel","2024-07-26",0,0,39,0,1,42,0,0
"Israel","2024-07-27",0,0,39,0,0,42,0,0
"Israel","2024-07-28",0,0,39,0,0,42,0,0
"Israel","2024-07-29",0,0,39,0,0,42,0,0
"Israel","2024-07-30",0,0,39,0,0,42,0,0
"Israel","2024-07-31",0,3,42,0,0,42,0,0
"Israel","2024-08-01",0,0,42,0,0,42,0,0
"Israel","2024-08-02",0,0,42,0,0,42,0,0
"Israel","2024-08-03",0,0,42,0,0,42,0,0
"Israel","2024-08-04",0,0,42,0,1,43,0,0
"Israel","2024-08-05",0,0,42,0,0,43,0,0
"Israel","2024-08-06",0,0,42,0,0,43,0,0
"Israel","2024-08-07",0,0,42,0,0,43,0,0
"Israel","2024-08-08",0,0,42,0,0,43,0,0
"Israel","2024-08-09",0,0,42,0,0,43,0,0
"Israel","2024-08-10",0,0,42,0,0,43,0,0
"Israel","2024-08-11",0,0,42,0,0,43,0,0
"Israel","2024-08-12",0,0,42,0,1,44,0,0
"Israel","2024-08-13",0,0,42,0,0,44,0,0
"Israel","2024-08-14",0,0,42,0,0,44,0,0
"Israel","2024-08-15",0,0,42,0,0,44,0,0
"Israel","2024-08-16",0,0,42,0,0,44,0,0
"Israel","2024-08-17",0,0,42,0,0,44,0,0
"Israel","2024-08-18",0,0,42,0,0,44,0,0
"Israel","2024-08-19",0,0,42,0,0,44,0,0
"Israel","2024-08-20",0,0,42,0,1,45,0,0
"Israel","2024-08-21",0,0,42,0,0,45,0,0
"Israel","2024-08-22",0,0,42,0,0,45,0,0
"Israel","2024-08-23",0,0,42,0,0,45,0,0
"Israel","2024-08-24",0,0,42,0,0,45,0,0
"Israel","2024-08-25",0,0,42,0,0,45,0,0
"Israel","2024-08-26",0,0,42,0,0,45,0,0
"Israel","2024-08-27",0,0,42,0,0,45,0,0
"Israel","2024-08-28",0,0,42,0,1,46,0,0
"Israel","2024-08-29",0,0,42,0,0,46,0,0
"Israel","2024-08-30",0,0,42,0,0,46,0,0
"Israel","2024-08-31",0,4,46,0,0,46,0,0
"Israel","2024-09-01",0,0,46,0,0,46,0,0
"Israel","2024-09-02",0,0,46,0,0,46,0,0
"Israel","2024-09-03",0,0,46,0,0,46,0,0
"Israel","2024-09-04",0,0,46,0,1,47,0,0
"Israel","2024-09-05",0,0,46,0,0,47,0,0
"Israel","2024-09-06",0,0,46,0,0,47,0,0
"Israel","2024-09-07",0,0,46,0,0,47,0,0
"Israel","2024-09-08",0,0,46,0,0,47,0,0
"Israel","2024-09-09",0,0,46,0,0,47,0,0
"Israel","2024-09-10",0,0,46,0,0,47,0,0
"Israel","2024-09-11",0,0,46,0,0,47,0,0
"Israel","2024-09-12",0,0,46,0,1,48,0,0
"Israel","2024-09-13",0,0,46,0,0,48,0,0
"Israel","2024-09-14",0,0,46,0,0,48,0,0
"Israel","2024-09-15",0,0,46,0,0,48,0,0
"Israel","2024-09-16",0,0,46,0,0,48,0,0
"Israel","2024-09-17",0,0,46,0,0,48,0,0
"Israel","2024-09-18",0,0,46,0,0,48,0,0
"Israel","2024-09-19",0,0,46,0,1,49,0,0
"Israel","2024-09-20",0,0,46,0,0,49,0,0
"Israel","2024-09-21",0,0,46,0,0,49,0,0
"Israel","2024-09-22",0,0,46,0,0,49,0,0
"Israel","2024-09-23",0,0,46,0,0,49,0,0
"Israel","2024-09-24",0,0,46,0,0,49,0,0
"Israel","2024-09-25",0,0,46,0,0,49,0,0
"Israel","2024-09-26",0,0,46,0,0,49,0,0
"Israel","2024-09-27",0,0,46,0,1,50,0,0
"Israel","2024-09-28",0,0,46,0,0,50,0,0
"Israel","2024-09-29",0,0,46,0,0,50,0,0
"Israel","2024-09-30",0,4,50,0,0,50,0,0
"Israel","2024-10-01",0,0,50,0,0,50,0,0
"Israel","2024-10-02",0,0,50,0,0,50,0,0
"Israel","2024-10-03",0,0,50,0,0,50,0,0
"Israel","2024-10-04",0,0,50,0,0,50,0,0
"Israel","2024-10-05",0,0,50,0,0,50,0,0
"Israel","2024-10-06",0,0,50,0,0,50,0,0
"Israel","2024-10-07",0,0,50,0,0,50,0,0
"Israel","2024-10-08",0,0,50,0,0,50,0,0
"Israel","2024-10-09",0,0,50,0,0,50,0,0
"Israel","2024-10-10",0,0,50,0,0,50,0,0
"Israel","2024-10-11",0,0,50,0,0,50,0,0
"Israel","2024-10-12",0,0,50,0,0,50,0,0
"Israel","2024-10-13",0,0,50,0,0,50,0,0
"Israel","2024-10-14",0,0,50,0,0,50,0,0
"Israel","2024-10-15",0,0,50,0,0,50,0,0
"Israel","2024-10-16",0,0,50,0,0,50,0,0
"Israel","2024-10-17",0,0,50,0,0,50,0,0
"Israel","2024-10-18",0,0,50,0,0,50,0,0
"Israel","2024-10-19",0,0,50,0,0,50,0,0
"Israel","2024-10-20",0,0,50,0,0,50,0,0
"Israel","2024-10-21",0,0,50,0,0,50,0,0
"Israel","2024-10-22",0,0,50,0,0,50,0,0
"Israel","2024-10-23",0,0,50,0,0,50,0,0
"Israel","2024-10-24",0,0,50,0,0,50,0,0
"Israel","2024-10-25",0,0,50,0,0,50,0,0
"Israel","2024-10-26",0,0,50,0,0,50,0,0
"Israel","2024-10-27",0,0,50,0,0,50,0,0
"Israel","2024-10-28",0,0,50,0,0,50,0,0
"Israel","2024-10-29",0,0,50,0,0,50,0,0
"Israel","2024-10-30",0,0,50,0,0,50,0,0
"Israel","2024-10-31",0,0,50,0,0,50,0,0
"Israel","2024-11-01",0,0,50,0,0,50,0,0
"Israel","2024-11-02",0,0,50,0,0,50,0,0
"Israel","2024-11-03",0,0,50,0,0,50,0,0
"Israel","2024-11-04",0,0,50,0,0,50,0,0
"Israel","2024-11-05",0,0,50,0,0,50,0,0
"Israel","2024-11-06",0,0,50,0,0,50,0,0
"Israel","2024-11-07",0,0,50,0,0,50,0,0
"Israel","2024-11-08",0,0,50,0,0,50,0,0
"Israel","2024-11-09",0,0,50,0,0,50,0,0
"Israel","2024-11-10",0,0,50,0,0,50,0,0
"Israel","2024-11-11",0,0,50,0,0,50,0,0
"Israel","2024-11-12",0,0,50,0,0,50,0,0
"Israel","2024-11-13",0,0,50,0,0,50,0,0
"Israel","2024-11-14",0,0,50,0,0,50,0,0
"Israel","2024-11-15",0,0,50,0,0,50,0,0
"Israel","2024-11-16",0,0,50,0,0,50,0,0
"Israel","2024-11-17",0,0,50,0,0,50,0,0
"Israel","2024-11-18",0,0,50,0,0,50,0,0
"Israel","2024-11-19",0,0,50,0,0,50,0,0
"Israel","2024-11-20",0,0,50,0,0,50,0,0
"Israel","2024-11-21",0,0,50,0,0,50,0,0
"Israel","2024-11-22",0,0,50,0,0,50,0,0
"Israel","2024-11-23",0,0,50,0,0,50,0,0
"Israel","2024-11-24",0,0,50,0,0,50,0,0
"Israel","2024-11-25",0,0,50,0,0,50,0,0
"Israel","2024-11-26",0,0,50,0,0,50,0,0
"Israel","2024-11-27",0,0,50,0,0,50,0,0
"Israel","2024-11-28",0,0,50,0,0,50,0,0
"Israel","2024-11-29",0,0,50,0,0,50,0,0
"Israel","2024-11-30",0,0,50,0,0,50,0,0
"Israel","2024-12-01",0,0,50,0,0,50,0,0
"Israel","2024-12-02",0,0,50,0,0,50,0,0
"Israel","2024-12-03",0,0,50,0,0,50,0,0
"Israel","2024-12-04",0,0,50,0,0,50,0,0
"Israel","2024-12-05",0,0,50,0,0,50,0,0
"Israel","2024-12-06",0,0,50,0,0,50,0,0
"Israel","2024-12-07",0,0,50,0,0,50,0,0
"Israel","2024-12-08",0,0,50,0,0,50,0,0
"Israel","2024-12-09",0,0,50,0,0,50,0,0
"Italy","2024-01-01",0,0,0,0,0,0,0,0
"Italy","2024-01-02",0,0,0,0,0,0,0,0
"Italy","2024-01-03",0,0,0,0,0,0,0,0
"Italy","2024-01-04",0,0,0,0,0,0,0,0
"Italy","2024-01-05",0,0,0,0,0,0,0,0
"Italy","2024-01-06",0,0,0,0,0,0,0,0
"Italy","2024-01-07",0,0,0,0,0,0,0,0
"Italy","2024-01-08",0,0,0,0,0,0,0,0
"Italy","2024-01-09",0,0,0,0,0,0,0,0
"Italy","2024-01-10",0,0,0,0,0,0,0,0
"Italy","2024-01-11",0,0,0,0,0,0,0,0
"Italy","2024-01-12",0,0,0,0,0,0,0,0
"Italy","2024-01-13",0,0,0,0,0,0,0,0
"Italy","2024-01-14",0,0,0,0,0,0,0,0
"Italy","2024-01-15",0,0,0,0,0,0,0,0
"Italy","2024-01-16",0,0,0,0,0,0,0,0
"Italy","2024-01-17",0,0,0,0,0,0,0,0
"Italy","2024-01-18",0,0,0,0,0,0,0,0
"Italy","2024-01-19",0,0,0,0,0,0,0,0
"Italy","2024-01-20",0,0,0,0,0,0,0,0
"Italy","2024-01-21",0,0,0,0,0,0,0,0
"Italy","2024-01-22",0,0,0,0,0,0,0,0
"Italy","2024-01-23",0,0,0,0,0,0,0,0
"Italy","2024-01-24",0,0,0,0,0,0,0,0
"Italy","2024-01-25",0,0,0,0,0,0,0,0
"Italy","2024-01-26",0,0,0,0,0,0,0,0
"Italy","2024-01-27",0,0,0,0,0,0,0,0
"Italy","2024-01-28",0,0,0,0,0,0,0,0
"Italy","2024-01-29",0,0,0,0,0,0,0,0
"Italy","2024-01-30",0,0,0,0,0,0,0,0
"Italy","2024-01-31",0,26,26,0,26,26,0,0
"Italy","2024-02-01",0,0,26,0,0,26,0,0
"Italy","2024-02-02",0,0,26,0,1,27,0,0
"Italy","2024-02-03",0,0,26,0,0,27,0,0
"Italy","2024-02-04",0,0,26,0,1,28,0,0
"Italy","2024-02-05",0,0,26,0,0,28,0,0
"Italy","2024-02-06",0,0,26,0,1,29,0,0
"Italy","2024-02-07",0,0,26,0,0,29,0,0
"Italy","2024-02-08",0,0,26,0,1,30,0,0
"Italy","2024-02-09",0,0,26,0,0,30,0,0
"Italy","2024-02-10",0,0,26,0,0,30,0,0
"Italy","2024-02-11",0,0,26,0,1,31,0,0
"Italy","2024-02-12",0,0,26,0,0,31,0,0
"Italy","2024-02-13",0,0,26,0,1,32,0,0
"Italy","2024-02-14",0,0,26,0,0,32,0,0
"Italy","2024-02-15",0,0,26,0,1,33,0,0
"Italy","2024-02-16",0,0,26,0,0,33,0,0
"Italy","2024-02-17",0,0,26,0,1,34,0,0
"Italy","2024-02-18",0,0,26,0,0,34,0,0
"Italy","2024-02-19",0,0,26,0,1,35,0,0
"Italy","2024-02-20",0,0,26,0,0,35,0,0
"Italy","2024-02-21",0,0,26,0,0,35,0,0
"Italy","2024-02-22",0,0,26,0,1,36,0,0
"Italy","2024-02-23",0,0,26,0,0,36,0,0
"Italy","2024-02-24",0,0,26,0,1,37,0,0
"Italy","2024-02-25",0,0,26,0,0,37,0,0
"Italy","2024-02-26",0,0,26,0,1,38,0,0
"Italy","2024-02-27",0,0,26,0,0,38,0,0
"Italy","2024-02-28",0,0,26,0,1,39,0,0
"Italy","2024-02-29",0,13,39,0,0,39,0,0
"Italy","2024-03-01",0,0,39,0,0,39,0,0
"Italy","2024-03-02",0,0,39,0,1,40,0,0
"Italy","2024-03-03",0,0,39,0,0,40,0,0
"Italy","2024-03-04",0,0,39,0,1,41,0,0
"Italy","2024-03-05",0,0,39,0,0,41,0,0
"Italy","2024-03-06",0,0,39,0,1,42,0,0
"Italy","2024-03-07",0,0,39,0,0,42,0,0
"Italy","2024-03-08",0,0,39,0,1,43,0,0
"Italy","2024-03-09",0,0,39,0,0,43,0,0
"Italy","2024-03-10",0,0,39,0,1,44,0,0
"Italy","2024-03-11",0,0,39,0,0,44,0,0
"Italy","2024-03-12",0,0,39,0,0,44,0,0
"Italy","2024-03-13",0,0,39,0,1,45,0,0
"Italy","2024-03-14",0,0,39,0,0,45,0,0
"Italy","2024-03-15",0,0,39,0,1,46,0,0
"Italy","2024-03-16",0,0,39,0,0,46,0,0
"Italy","2024-03-17",0,0,39,0,1,47,0,0
"Italy","2024-03-18",0,0,39,0,0,47,0,0
"Italy","2024-03-19",0,0,39,0,1,48,0,0
"Italy","2024-03-20",0,0,39,0,0,48,0,0
"Italy","2024-03-21",0,0,39,0,0,48,0,0
"Italy","2024-03-22",0,0,39,0,1,49,0,0
"Italy","2024-03-23",0,0,39,0,0,49,0,0
"Italy","2024-03-24",0,0,39,0,1,50,0,0
"Italy","2024-03-25",0,0,39,0,0,50,0,0
"Italy","2024-03-26",0,0,39,0,1,51,0,0
"Italy","2024-03-27",0,0,39,0,0,51,0,0
"Italy","2024-03-28",0,0,39,0,1,52,0,0
"Italy","2024-03-29",0,0,39,0,0,52,0,0
"Italy","2024-03-30",0,0,39,0,1,53,0,0
"Italy","2024-03-31",0,14,53,0,0,53,0,0
"Italy","2024-04-01",0,0,53,0,0,53,0,0
"Italy","2024-04-02",0,0,53,0,0,53,0,0
"Italy","2024-04-03",0,0,53,0,0,53,0,0
"Italy","2024-04-04",0,0,53,0,0,53,0,0
"Italy","2024-04-05",0,0,53,0,0,53,0,0
"Italy","2024-04-06",0,0,53,0,0,53,0,0
"Italy","2024-04-07",0,0,53,0,0,53,0,0
"Italy","2024-04-08",0,0,53,0,0,53,0,0
"Italy","2024-04-09",0,0,53,0,0,53,0,0
"Italy","2024-04-10",0,0,53,0,0,53,0,0
"Italy","2024-04-11",0,0,53,0,0,53,0,0
"Italy","2024-04-12",0,0,53,0,0,53,0,0
"Italy","2024-04-13",0,0,53,0,0,53,0,0
"Italy","2024-04-14",0,0,53,0,0,53,0,0
"Italy","2024-04-15",0,0,53,0,0,53,0,0
"Italy","2024-04-16",0,0,53,0,1,54,0,0
"Italy","2024-04-17",0,0,53,0,0,54,0,0
"Italy","2024-04-18",0,0,53,0,0,54,0,0
"Italy","2024-04-19",0,0,53,0,0,54,0,0
"Italy","2024-04-20",0,0,53,0,0,54,0,0
"Italy","2024-04-21",0,0,53,0,0,54,0,0
"Italy","2024-04-22",0,0,53,0,0,54,0,0
"Italy","2024-04-23",0,0,53,0,0,54,0,0
"Italy","2024-04-24",0,0,53,0,0,54,0,0
"Italy","2024-04-25",0,0,53,0,0,54,0,0
"Italy","2024-04-26",0,0,53,0,0,54,0,0
"Italy","2024-04-27",0,0,53,0,0,54,0,0
"Italy","2024-04-28",0,0,53,0,0,54,0,0
"Italy","2024-04-29",0,0,53,0,0,54,0,0
"Italy","2024-04-30",0,1,54,0,0,54,0,0
"Italy","2024-05-01",0,0,54,0,0,54,0,0
"Italy","2024-05-02",0,0,54,0,0,54,0,0
"Italy","2024-05-03",0,0,54,0,0,54,0,0
"Italy","2024-05-04",0,0,54,0,1,55,0,0
"Italy","2024-05-05",0,0,54,0,0,55,0,0
"Italy","2024-05-06",0,0,54,0,0,55,0,0
"Italy","2024-05-07",0,0,54,0,0,55,0,0
"Italy","2024-05-08",0,0,54,0,0,55,0,0
"Italy","2024-05-09",0,0,54,0,0,55,0,0
"Italy","2024-05-10",0,0,54,0,0,55,0,0
"Italy","2024-05-11",0,0,54,0,0,55,0,0
"Italy","2024-05-12",0,0,54,0,1,56,0,0
"Italy","2024-05-13",0,0,54,0,0,56,0,0
"Italy","2024-05-14",0,0,54,0,0,56,0,0
"Italy","2024-05-15",0,0,54,0,0,56,0,0
"Italy","2024-05-16",0,0,54,0,0,56,0,0
"Italy","2024-05-17",0,0,54,0,0,56,0,0
"Italy","2024-05-18",0,0,54,0,0,56,0,0
"Italy","2024-05-19",0,0,54,0,0,56,0,0
"Italy","2024-05-20",0,0,54,0,1,57,0,0
"Italy","2024-05-21",0,0,54,0,0,57,0,0
"Italy","2024-05-22",0,0,54,0,0,57,0,0
"Italy","2024-05-23",0,0,54,0,0,57,0,0
"Italy","2024-05-24",0,0,54,0,0,57,0,0
"Italy","2024-05-25",0,0,54,0,0,57,0,0
"Italy","2024-05-26",0,0,54,0,0,57,0,0
"Italy","2024-05-27",0,0,54,0,0,57,0,0
"Italy","2024-05-28",0,0,54,0,1,58,0,0
"Italy","2024-05-29",0,0,54,0,0,58,0,0
"Italy","2024-05-30",0,0,54,0,0,58,0,0
"Italy","2024-05-31",0,4,58,0,0,58,0,0
"Italy","2024-06-01",0,0,58,0,0,58,0,0
"Italy","2024-06-02",0,0,58,0,0,58,0,0
"Italy","2024-06-03",0,0,58,0,0,58,0,0
"Italy","2024-06-04",0,0,58,0,0,58,0,0
"Italy","2024-06-05",0,0,58,0,0,58,0,0
"Italy","2024-06-06",0,0,58,0,0,58,0,0
"Italy","2024-06-07",0,0,58,0,0,58,0,0
"Italy","2024-06-08",0,0,58,0,1,59,0,0
"Italy","2024-06-09",0,0,58,0,0,59,0,0
"Italy","2024-06-10",0,0,58,0,0,59,0,0
"Italy","2024-06-11",0,0,58,0,0,59,0,0
"Italy","2024-06-12",0,0,58,0,0,59,0,0
"Italy","2024-06-13",0,0,58,0,0,59,0,0
"Italy","2024-06-14",0,0,58,0,0,59,0,0
"Italy","2024-06-15",0,0,58,0,0,59,0,0
"Italy","2024-06-16",0,0,58,0,0,59,0,0
"Italy","2024-06-17",0,0,58,0,0,59,0,0
"Italy","2024-06-18",0,0,58,0,0,59,0,0
"Italy","2024-06-19",0,0,58,0,0,59,0,0
"Italy","2024-06-20",0,0,58,0,0,59,0,0
"Italy","2024-06-21",0,0,58,0,0,59,0,0
"Italy","2024-06-22",0,0,58,0,0,59,0,0
"Italy","2024-06-23",0,0,58,0,1,60,0,0
"Italy","2024-06-24",0,0,58,0,0,60,0,0
"Italy","2024-06-25",0,0,58,0,0,60,0,0
"Italy","2024-06-26",0,0,58,0,0,60,0,0
"Italy","2024-06-27",0,0,58,0,0,60,0,0
"Italy","2024-06-28",0,0,58,0,0,60,0,0
"Italy","2024-06-29",0,0,58,0,0,60,0,0
"Italy","2024-06-30",0,2,60,0,0,60,0,0
"Italy","2024-07-01",0,0,60,0,0,60,0,0
"Italy","2024-07-02",0,0,60,0,0,60,0,0
"Italy","2024-07-03",0,0,60,0,1,61,0,0
"Italy","2024-07-04",0,0,60,0,0,61,0,0
"Italy","2024-07-05",0,0,60,0,0,61,0,0
"Italy","2024-07-06",0,0,60,0,0,61,0,0
"Italy","2024-07-07",0,0,60,0,1,62,0,0
"Italy","2024-07-08",0,0,60,0,0,62,0,0
"Italy","2024-07-09",0,0,60,0,0,62,0,0
"Italy","2024-07-10",0,0,60,0,0,62,0,0
"Italy","2024-07-11",0,0,60,0,0,62,0,0
"Italy","2024-07-12",0,0,60,0,1,63,0,0
"Italy","2024-07-13",0,0,60,0,0,63,0,0
"Italy","2024-07-14",0,0,60,0,0,63,0,0
"Italy","2024-07-15",0,0,60,0,0,63,0,0
"Italy","2024-07-16",0,0,60,0,1,64,0,0
"Italy","2024-07-17",0,0,60,0,0,64,0,0
"Italy","2024-07-18",0,0,60,0,0,64,0,0
"Italy","2024-07-19",0,0,60,0,0,64,0,0
"Italy","2024-07-20",0,0,60,0,1,65,0,0
"Italy","2024-07-21",0,0,60,0,0,65,0,0
"Italy","2024-07-22",0,0,60,0,0,65,0,0
"Italy","2024-07-23",0,0,60,0,0,65,0,0
"Italy","2024-07-24",0,0,60,0,0,65,0,0
"Italy","2024-07-25",0,0,60,0,1,66,0,0
"Italy","2024-07-26",0,0,60,0,0,66,0,0
"Italy","2024-07-27",0,0,60,0,0,66,0,0
"Italy","2024-07-28",0,0,60,0,0,66,0,0
"Italy","2024-07-29",0,0,60,0,1,67,0,0
"Italy","2024-07-30",0,0,60,0,0,67,0,0
"Italy","2024-07-31",0,7,67,0,0,67,0,0
"Italy","2024-08-01",0,0,67,0,0,67,0,0
"Italy","2024-08-02",0,0,67,0,0,67,0,0
"Italy","2024-08-03",0,0,67,0,0,67,0,0
"Italy","2024-08-04",0,0,67,0,0,67,0,0
"Italy","2024-08-05",0,0,67,0,0,67,0,0
"Italy","2024-08-06",0,0,67,0,0,67,0,0
"Italy","2024-08-07",0,0,67,0,0,67,0,0
"Italy","2024-08-08",0,0,67,0,0,67,0,0
"Italy","2024-08-09",0,0,67,0,0,67,0,0
"Italy","2024-08-10",0,0,67,0,0,67,0,0
"Italy","2024-08-11",0,0,67,0,0,67,0,0
"Italy","2024-08-12",0,0,67,0,0,67,0,0
"Italy","2024-08-13",0,0,67,0,0,67,0,0
"Italy","2024-08-14",0,0,67,0,0,67,0,0
"Italy","2024-08-15",0,0,67,0,0,67,0,0
"Italy","2024-08-16",0,0,67,0,1,68,0,0
"Italy","2024-08-17",0,0,67,0,0,68,0,0
"Italy","2024-08-18",0,0,67,0,0,68,0,0
"Italy","2024-08-19",0,0,67,0,0,68,0,0
"Italy","2024-08-20",0,0,67,0,0,68,0,0
"Italy","2024-08-21",0,0,67,0,0,68,0,0
"Italy","2024-08-22",0,0,67,0,0,68,0,0
"Italy","2024-08-23",0,0,67,0,0,68,0,0
"Italy","2024-08-24",0,0,67,0,0,68,0,0
"Italy","2024-08-25",0,0,67,0,0,68,0,0
"Italy","2024-08-26",0,0,67,0,0,68,0,0
"Italy","2024-08-27",0,0,67,0,0,68,0,0
"Italy","2024-08-28",0,0,67,0,0,68,0,0
"Italy","2024-08-29",0,0,67,0,0,68,0,0
"Italy","2024-08-30",0,0,67,0,0,68,0,0
"Italy","2024-08-31",0,1,68,0,0,68,0,0
"Italy","2024-09-01",0,0,68,0,0,68,0,0
"Italy","2024-09-02",0,0,68,0,0,68,0,0
"Italy","2024-09-03",0,0,68,0,0,68,0,0
"Italy","2024-09-04",0,0,68,0,1,69,0,0
"Italy","2024-09-05",0,0,68,0,0,69,0,0
"Italy","2024-09-06",0,0,68,0,0,69,0,0
"Italy","2024-09-07",0,0,68,0,0,69,0,0
"Italy","2024-09-08",0,0,68,0,0,69,0,0
"Italy","2024-09-09",0,0,68,0,1,70,0,0
"Italy","2024-09-10",0,0,68,0,0,70,0,0
"Italy","2024-09-11",0,0,68,0,0,70,0,0
"Italy","2024-09-12",0,0,68,0,0,70,0,0
"Italy","2024-09-13",0,0,68,0,0,70,0,0
"Italy","2024-09-14",0,0,68,0,0,70,0,0
"Italy","2024-09-15",0,0,68,0,0,70,0,0
"Italy","2024-09-16",0,0,68,0,1,71,0,0
"Italy","2024-09-17",0,0,68,0,0,71,0,0
"Italy","2024-09-18",0,0,68,0,0,71,0,0
"Italy","2024-09-19",0,0,68,0,0,71,0,0
"Italy","2024-09-20",0,0,68,0,0,71,0,0
"Italy","2024-09-21",0,0,68,0,1,72,0,0
"Italy","2024-09-22",0,0,68,0,0,72,0,0
"Italy","2024-09-23",0,0,68,0,0,72,0,0
"Italy","2024-09-24",0,0,68,0,0,72,0,0
"Italy","2024-09-25",0,0,68,0,0,72,0,0
"Italy","2024-09-26",0,0,68,0,0,72,0,0
"Italy","2024-09-27",0,0,68,0,0,72,0,0
"Italy","2024-09-28",0,0,68,0,1,73,0,0
"Italy","2024-09-29",0,0,68,0,0,73,0,0
"Italy","2024-09-30",0,5,73,0,0,73,0,0
"Italy","2024-10-01",0,0,73,0,0,73,0,0
"Italy","2024-10-02",0,0,73,0,1,74,0,0
"Italy","2024-10-03",0,0,73,0,0,74,0,0
"Italy","2024-10-04",0,0,73,0,0,74,0,0
"Italy","2024-10-05",0,0,73,0,1,75,0,0
"Italy","2024-10-06",0,0,73,0,0,75,0,0
"Italy","2024-10-07",0,0,73,0,0,75,0,0
"Italy","2024-10-08",0,0,73,0,1,76,0,0
"Italy","2024-10-09",0,0,73,0,0,76,0,0
"Italy","2024-10-10",0,0,73,0,0,76,0,0
"Italy","2024-10-11",0,0,73,0,1,77,0,0
"Italy","2024-10-12",0,0,73,0,0,77,0,0
"Italy","2024-10-13",0,0,73,0,0,77,0,0
"Italy","2024-10-14",0,0,73,0,1,78,0,0
"Italy","2024-10-15",0,0,73,0,0,78,0,0
"Italy","2024-10-16",0,0,73,0,0,78,0,0
"Italy","2024-10-17",0,0,73,0,0,78,0,0
"Italy","2024-10-18",0,0,73,0,1,79,0,0
"Italy","2024-10-19",0,0,73,0,0,79,0,0
"Italy","2024-10-20",0,0,73,0,0,79,0,0
"Italy","2024-10-21",0,0,73,0,1,80,0,0
"Italy","2024-10-22",0,0,73,0,0,80,0,0
"Italy","2024-10-23",0,0,73,0,0,80,0,0
"Italy","2024-10-24",0,0,73,0,1,81,0,0
"Italy","2024-10-25",0,0,73,0,0,81,0,0
"Italy","2024-10-26",0,0,73,0,0,81,0,0
"Italy","2024-10-27",0,0,73,0,1,82,0,0
"Italy","2024-10-28",0,0,73,0,0,82,0,0
"Italy","2024-10-29",0,0,73,0,0,82,0,0
"Italy","2024-10-30",0,0,73,0,1,83,0,0
"Italy","2024-10-31",0,10,83,0,0,83,0,0
"Italy","2024-11-01",0,0,83,0,0,83,0,0
"Italy","2024-11-02",0,0,83,0,0,83,0,0
"Italy","2024-11-03",0,0,83,0,0,83,0,0
"Italy","2024-11-04",0,0,83,0,0,83,0,0
"Italy","2024-11-05",0,0,83,0,0,83,0,0
"Italy","2024-11-06",0,0,83,0,0,83,0,0
"Italy","2024-11-07",0,0,83,0,0,83,0,0
"Italy","2024-11-08",0,0,83,0,0,83,0,0
"Italy","2024-11-09",0,0,83,0,0,83,0,0
"Italy","2024-11-10",0,0,83,0,0,83,0,0
"Italy","2024-11-11",0,0,83,0,0,83,0,0
"Italy","2024-11-12",0,0,83,0,0,83,0,0
"Italy","2024-11-13",0,0,83,0,0,83,0,0
"Italy","2024-11-14",0,0,83,0,0,83,0,0
"Italy","2024-11-15",0,0,83,0,0,83,0,0
"Italy","2024-11-16",0,0,83,0,0,83,0,0
"Italy","2024-11-17",0,0,83,0,0,83,0,0
"Italy","2024-11-18",0,0,83,0,0,83,0,0
"Italy","2024-11-19",0,0,83,0,0,83,0,0
"Italy","2024-11-20",0,0,83,0,0,83,0,0
"Italy","2024-11-21",0,0,83,0,0,83,0,0
"Italy","2024-11-22",0,0,83,0,0,83,0,0
"Italy","2024-11-23",0,0,83,0,0,83,0,0
"Italy","2024-11-24",0,0,83,0,0,83,0,0
"Italy","2024-11-25",0,0,83,0,0,83,0,0
"Italy","2024-11-26",0,0,83,0,0,83,0,0
"Italy","2024-11-27",0,0,83,0,0,83,0,0
"Italy","2024-11-28",0,0,83,0,0,83,0,0
"Italy","2024-11-29",0,0,83,0,0,83,0,0
"Italy","2024-11-30",0,0,83,0,0,83,0,0
"Italy","2024-12-01",0,0,83,0,0,83,0,0
"Italy","2024-12-02",0,0,83,0,0,83,0,0
"Italy","2024-12-03",0,0,83,0,0,83,0,0
"Italy","2024-12-04",0,0,83,0,0,83,0,0
"Italy","2024-12-05",0,0,83,0,0,83,0,0
"Italy","2024-12-06",0,0,83,0,0,83,0,0
"Italy","2024-12-07",0,0,83,0,0,83,0,0
"Italy","2024-12-08",0,0,83,0,0,83,0,0
"Italy","2024-12-09",0,0,83,0,0,83,0,0
"Jamaica","2024-01-01",0,0,0,0,0,0,0,0
"Jamaica","2024-01-02",0,0,0,0,0,0,0,0
"Jamaica","2024-01-03",0,0,0,0,0,0,0,0
"Jamaica","2024-01-04",0,0,0,0,0,0,0,0
"Jamaica","2024-01-05",0,0,0,0,0,0,0,0
"Jamaica","2024-01-06",0,0,0,0,0,0,0,0
"Jamaica","2024-01-07",0,0,0,0,0,0,0,0
"Jamaica","2024-01-08",0,0,0,0,0,0,0,0
"Jamaica","2024-01-09",0,0,0,0,0,0,0,0
"Jamaica","2024-01-10",0,0,0,0,0,0,0,0
"Jamaica","2024-01-11",0,0,0,0,0,0,0,0
"Jamaica","2024-01-12",0,0,0,0,0,0,0,0
"Jamaica","2024-01-13",0,0,0,0,0,0,0,0
"Jamaica","2024-01-14",0,0,0,0,0,0,0,0
"Jamaica","2024-01-15",0,0,0,0,0,0,0,0
"Jamaica","2024-01-16",0,0,0,0,0,0,0,0
"Jamaica","2024-01-17",0,0,0,0,0,0,0,0
"Jamaica","2024-01-18",0,0,0,0,0,0,0,0
"Jamaica","2024-01-19",0,0,0,0,0,0,0,0
"Jamaica","2024-01-20",0,0,0,0,0,0,0,0
"Jamaica","2024-01-21",0,0,0,0,0,0,0,0
"Jamaica","2024-01-22",0,0,0,0,0,0,0,0
"Jamaica","2024-01-23",0,0,0,0,0,0,0,0
"Jamaica","2024-01-24",0,0,0,0,0,0,0,0
"Jamaica","2024-01-25",0,0,0,0,0,0,0,0
"Jamaica","2024-01-26",0,0,0,0,0,0,0,0
"Jamaica","2024-01-27",0,0,0,0,0,0,0,0
"Jamaica","2024-01-28",0,0,0,0,0,0,0,0
"Jamaica","2024-01-29",0,0,0,0,0,0,0,0
"Jamaica","2024-01-30",0,0,0,0,0,0,0,0
"Jamaica","2024-01-31",0,0,0,0,0,0,0,0
"Jamaica","2024-02-01",0,0,0,0,0,0,0,0
"Jamaica","2024-02-02",0,0,0,0,0,0,0,0
"Jamaica","2024-02-03",0,0,0,0,0,0,0,0
"Jamaica","2024-02-04",0,0,0,0,0,0,0,0
"Jamaica","2024-02-05",0,0,0,0,0,0,0,0
"Jamaica","2024-02-06",0,0,0,0,0,0,0,0
"Jamaica","2024-02-07",0,0,0,0,0,0,0,0
"Jamaica","2024-02-08",0,0,0,0,0,0,0,0
"Jamaica","2024-02-09",0,0,0,0,0,0,0,0
"Jamaica","2024-02-10",0,0,0,0,0,0,0,0
"Jamaica","2024-02-11",0,0,0,0,0,0,0,0
"Jamaica","2024-02-12",0,0,0,0,0,0,0,0
"Jamaica","2024-02-13",0,0,0,0,0,0,0,0
"Jamaica","2024-02-14",0,0,0,0,0,0,0,0
"Jamaica","2024-02-15",0,0,0,0,0,0,0,0
"Jamaica","2024-02-16",0,0,0,0,0,0,0,0
"Jamaica","2024-02-17",0,0,0,0,0,0,0,0
"Jamaica","2024-02-18",0,0,0,0,0,0,0,0
"Jamaica","2024-02-19",0,0,0,0,0,0,0,0
"Jamaica","2024-02-20",0,0,0,0,0,0,0,0
"Jamaica","2024-02-21",0,0,0,0,0,0,0,0
"Jamaica","2024-02-22",0,0,0,0,0,0,0,0
"Jamaica","2024-02-23",0,0,0,0,0,0,0,0
"Jamaica","2024-02-24",0,0,0,0,0,0,0,0
"Jamaica","2024-02-25",0,0,0,0,0,0,0,0
"Jamaica","2024-02-26",0,0,0,0,0,0,0,0
"Jamaica","2024-02-27",0,0,0,0,0,0,0,0
"Jamaica","2024-02-28",0,0,0,0,0,0,0,0
"Jamaica","2024-02-29",0,0,0,0,0,0,0,0
"Jamaica","2024-03-01",0,0,0,0,0,0,0,0
"Jamaica","2024-03-02",0,0,0,0,0,0,0,0
"Jamaica","2024-03-03",0,0,0,0,0,0,0,0
"Jamaica","2024-03-04",0,0,0,0,0,0,0,0
"Jamaica","2024-03-05",0,0,0,0,0,0,0,0
"Jamaica","2024-03-06",0,0,0,0,0,0,0,0
"Jamaica","2024-03-07",0,0,0,0,0,0,0,0
"Jamaica","2024-03-08",0,0,0,0,0,0,0,0
"Jamaica","2024-03-09",0,0,0,0,0,0,0,0
"Jamaica","2024-03-10",0,0,0,0,0,0,0,0
"Jamaica","2024-03-11",0,0,0,0,0,0,0,0
"Jamaica","2024-03-12",0,0,0,0,0,0,0,0
"Jamaica","2024-03-13",0,0,0,0,0,0,0,0
"Jamaica","2024-03-14",0,0,0,0,0,0,0,0
"Jamaica","2024-03-15",0,0,0,0,0,0,0,0
"Jamaica","2024-03-16",0,0,0,0,0,0,0,0
"Jamaica","2024-03-17",0,0,0,0,0,0,0,0
"Jamaica","2024-03-18",0,0,0,0,0,0,0,0
"Jamaica","2024-03-19",0,0,0,0,0,0,0,0
"Jamaica","2024-03-20",0,0,0,0,0,0,0,0
"Jamaica","2024-03-21",0,0,0,0,0,0,0,0
"Jamaica","2024-03-22",0,0,0,0,0,0,0,0
"Jamaica","2024-03-23",0,0,0,0,0,0,0,0
"Jamaica","2024-03-24",0,0,0,0,0,0,0,0
"Jamaica","2024-03-25",0,0,0,0,0,0,0,0
"Jamaica","2024-03-26",0,0,0,0,0,0,0,0
"Jamaica","2024-03-27",0,0,0,0,0,0,0,0
"Jamaica","2024-03-28",0,0,0,0,0,0,0,0
"Jamaica","2024-03-29",0,0,0,0,0,0,0,0
"Jamaica","2024-03-30",0,0,0,0,0,0,0,0
"Jamaica","2024-03-31",0,0,0,0,0,0,0,0
"Jamaica","2024-04-01",0,0,0,0,0,0,0,0
"Jamaica","2024-04-02",0,0,0,0,0,0,0,0
"Jamaica","2024-04-03",0,0,0,0,0,0,0,0
"Jamaica","2024-04-04",0,0,0,0,0,0,0,0
"Jamaica","2024-04-05",0,0,0,0,0,0,0,0
"Jamaica","2024-04-06",0,0,0,0,0,0,0,0
"Jamaica","2024-04-07",0,0,0,0,0,0,0,0
"Jamaica","2024-04-08",0,0,0,0,0,0,0,0
"Jamaica","2024-04-09",0,0,0,0,0,0,0,0
"Jamaica","2024-04-10",0,0,0,0,0,0,0,0
"Jamaica","2024-04-11",0,0,0,0,0,0,0,0
"Jamaica","2024-04-12",0,0,0,0,0,0,0,0
"Jamaica","2024-04-13",0,0,0,0,0,0,0,0
"Jamaica","2024-04-14",0,0,0,0,0,0,0,0
"Jamaica","2024-04-15",0,0,0,0,0,0,0,0
"Jamaica","2024-04-16",0,0,0,0,0,0,0,0
"Jamaica","2024-04-17",0,0,0,0,0,0,0,0
"Jamaica","2024-04-18",0,0,0,0,0,0,0,0
"Jamaica","2024-04-19",0,0,0,0,0,0,0,0
"Jamaica","2024-04-20",0,0,0,0,0,0,0,0
"Jamaica","2024-04-21",0,0,0,0,0,0,0,0
"Jamaica","2024-04-22",0,0,0,0,0,0,0,0
"Jamaica","2024-04-23",0,0,0,0,0,0,0,0
"Jamaica","2024-04-24",0,0,0,0,0,0,0,0
"Jamaica","2024-04-25",0,0,0,0,0,0,0,0
"Jamaica","2024-04-26",0,0,0,0,0,0,0,0
"Jamaica","2024-04-27",0,0,0,0,0,0,0,0
"Jamaica","2024-04-28",0,0,0,0,0,0,0,0
"Jamaica","2024-04-29",0,0,0,0,0,0,0,0
"Jamaica","2024-04-30",0,0,0,0,0,0,0,0
"Jamaica","2024-05-01",0,0,0,0,0,0,0,0
"Jamaica","2024-05-02",0,0,0,0,0,0,0,0
"Jamaica","2024-05-03",0,0,0,0,0,0,0,0
"Jamaica","2024-05-04",0,0,0,0,0,0,0,0
"Jamaica","2024-05-05",0,0,0,0,0,0,0,0
"Jamaica","2024-05-06",0,0,0,0,0,0,0,0
"Jamaica","2024-05-07",0,0,0,0,0,0,0,0
"Jamaica","2024-05-08",0,0,0,0,0,0,0,0
"Jamaica","2024-05-09",0,0,0,0,0,0,0,0
"Jamaica","2024-05-10",0,0,0,0,0,0,0,0
"Jamaica","2024-05-11",0,0,0,0,0,0,0,0
"Jamaica","2024-05-12",0,0,0,0,0,0,0,0
"Jamaica","2024-05-13",0,0,0,0,0,0,0,0
"Jamaica","2024-05-14",0,0,0,0,0,0,0,0
"Jamaica","2024-05-15",0,0,0,0,0,0,0,0
"Jamaica","2024-05-16",0,0,0,0,0,0,0,0
"Jamaica","2024-05-17",0,0,0,0,0,0,0,0
"Jamaica","2024-05-18",0,0,0,0,0,0,0,0
"Jamaica","2024-05-19",0,0,0,0,0,0,0,0
"Jamaica","2024-05-20",0,0,0,0,0,0,0,0
"Jamaica","2024-05-21",0,0,0,0,0,0,0,0
"Jamaica","2024-05-22",0,0,0,0,0,0,0,0
"Jamaica","2024-05-23",0,0,0,0,0,0,0,0
"Jamaica","2024-05-24",0,0,0,0,0,0,0,0
"Jamaica","2024-05-25",0,0,0,0,0,0,0,0
"Jamaica","2024-05-26",0,0,0,0,0,0,0,0
"Jamaica","2024-05-27",0,0,0,0,0,0,0,0
"Jamaica","2024-05-28",0,0,0,0,0,0,0,0
"Jamaica","2024-05-29",0,0,0,0,0,0,0,0
"Jamaica","2024-05-30",0,0,0,0,0,0,0,0
"Jamaica","2024-05-31",0,0,0,0,0,0,0,0
"Jamaica","2024-06-01",0,0,0,0,0,0,0,0
"Jamaica","2024-06-02",0,0,0,0,0,0,0,0
"Jamaica","2024-06-03",0,0,0,0,0,0,0,0
"Jamaica","2024-06-04",0,0,0,0,0,0,0,0
"Jamaica","2024-06-05",0,0,0,0,0,0,0,0
"Jamaica","2024-06-06",0,0,0,0,0,0,0,0
"Jamaica","2024-06-07",0,0,0,0,0,0,0,0
"Jamaica","2024-06-08",0,0,0,0,0,0,0,0
"Jamaica","2024-06-09",0,0,0,0,0,0,0,0
"Jamaica","2024-06-10",0,0,0,0,0,0,0,0
"Jamaica","2024-06-11",0,0,0,0,0,0,0,0
"Jamaica","2024-06-12",0,0,0,0,0,0,0,0
"Jamaica","2024-06-13",0,0,0,0,0,0,0,0
"Jamaica","2024-06-14",0,0,0,0,0,0,0,0
"Jamaica","2024-06-15",0,0,0,0,0,0,0,0
"Jamaica","2024-06-16",0,0,0,0,0,0,0,0
"Jamaica","2024-06-17",0,0,0,0,0,0,0,0
"Jamaica","2024-06-18",0,0,0,0,0,0,0,0
"Jamaica","2024-06-19",0,0,0,0,0,0,0,0
"Jamaica","2024-06-20",0,0,0,0,0,0,0,0
"Jamaica","2024-06-21",0,0,0,0,0,0,0,0
"Jamaica","2024-06-22",0,0,0,0,0,0,0,0
"Jamaica","2024-06-23",0,0,0,0,0,0,0,0
"Jamaica","2024-06-24",0,0,0,0,0,0,0,0
"Jamaica","2024-06-25",0,0,0,0,0,0,0,0
"Jamaica","2024-06-26",0,0,0,0,0,0,0,0
"Jamaica","2024-06-27",0,0,0,0,0,0,0,0
"Jamaica","2024-06-28",0,0,0,0,0,0,0,0
"Jamaica","2024-06-29",0,0,0,0,0,0,0,0
"Jamaica","2024-06-30",0,0,0,0,0,0,0,0
"Jamaica","2024-07-01",0,0,0,0,0,0,0,0
"Jamaica","2024-07-02",0,0,0,0,0,0,0,0
"Jamaica","2024-07-03",0,0,0,0,0,0,0,0
"Jamaica","2024-07-04",0,0,0,0,0,0,0,0
"Jamaica","2024-07-05",0,0,0,0,0,0,0,0
"Jamaica","2024-07-06",0,0,0,0,0,0,0,0
"Jamaica","2024-07-07",0,0,0,0,0,0,0,0
"Jamaica","2024-07-08",0,0,0,0,0,0,0,0
"Jamaica","2024-07-09",0,0,0,0,0,0,0,0
"Jamaica","2024-07-10",0,0,0,0,0,0,0,0
"Jamaica","2024-07-11",0,0,0,0,0,0,0,0
"Jamaica","2024-07-12",0,0,0,0,0,0,0,0
"Jamaica","2024-07-13",0,0,0,0,0,0,0,0
"Jamaica","2024-07-14",0,0,0,0,0,0,0,0
"Jamaica","2024-07-15",0,0,0,0,0,0,0,0
"Jamaica","2024-07-16",0,0,0,0,0,0,0,0
"Jamaica","2024-07-17",0,0,0,0,0,0,0,0
"Jamaica","2024-07-18",0,0,0,0,0,0,0,0
"Jamaica","2024-07-19",0,0,0,0,0,0,0,0
"Jamaica","2024-07-20",0,0,0,0,0,0,0,0
"Jamaica","2024-07-21",0,0,0,0,0,0,0,0
"Jamaica","2024-07-22",0,0,0,0,0,0,0,0
"Jamaica","2024-07-23",0,0,0,0,0,0,0,0
"Jamaica","2024-07-24",0,0,0,0,0,0,0,0
"Jamaica","2024-07-25",0,0,0,0,0,0,0,0
"Jamaica","2024-07-26",0,0,0,0,0,0,0,0
"Jamaica","2024-07-27",0,0,0,0,0,0,0,0
"Jamaica","2024-07-28",0,0,0,0,0,0,0,0
"Jamaica","2024-07-29",0,0,0,0,0,0,0,0
"Jamaica","2024-07-30",0,0,0,0,0,0,0,0
"Jamaica","2024-07-31",0,0,0,0,0,0,0,0
"Jamaica","2024-08-01",0,0,0,0,0,0,0,0
"Jamaica","2024-08-02",0,0,0,0,0,0,0,0
"Jamaica","2024-08-03",0,0,0,0,0,0,0,0
"Jamaica","2024-08-04",0,0,0,0,0,0,0,0
"Jamaica","2024-08-05",0,0,0,0,0,0,0,0
"Jamaica","2024-08-06",0,0,0,0,0,0,0,0
"Jamaica","2024-08-07",0,0,0,0,0,0,0,0
"Jamaica","2024-08-08",0,0,0,0,0,0,0,0
"Jamaica","2024-08-09",0,0,0,0,0,0,0,0
"Jamaica","2024-08-10",0,0,0,0,0,0,0,0
"Jamaica","2024-08-11",0,0,0,0,0,0,0,0
"Jamaica","2024-08-12",0,0,0,0,0,0,0,0
"Jamaica","2024-08-13",0,0,0,0,0,0,0,0
"Jamaica","2024-08-14",0,0,0,0,0,0,0,0
"Jamaica","2024-08-15",0,0,0,0,0,0,0,0
"Jamaica","2024-08-16",0,0,0,0,0,0,0,0
"Jamaica","2024-08-17",0,0,0,0,0,0,0,0
"Jamaica","2024-08-18",0,0,0,0,0,0,0,0
"Jamaica","2024-08-19",0,0,0,0,0,0,0,0
"Jamaica","2024-08-20",0,0,0,0,0,0,0,0
"Jamaica","2024-08-21",0,0,0,0,0,0,0,0
"Jamaica","2024-08-22",0,0,0,0,0,0,0,0
"Jamaica","2024-08-23",0,0,0,0,0,0,0,0
"Jamaica","2024-08-24",0,0,0,0,0,0,0,0
"Jamaica","2024-08-25",0,0,0,0,0,0,0,0
"Jamaica","2024-08-26",0,0,0,0,0,0,0,0
"Jamaica","2024-08-27",0,0,0,0,0,0,0,0
"Jamaica","2024-08-28",0,0,0,0,0,0,0,0
"Jamaica","2024-08-29",0,0,0,0,0,0,0,0
"Jamaica","2024-08-30",0,0,0,0,0,0,0,0
"Jamaica","2024-08-31",0,0,0,0,0,0,0,0
"Jamaica","2024-09-01",0,0,0,0,0,0,0,0
"Jamaica","2024-09-02",0,0,0,0,0,0,0,0
"Jamaica","2024-09-03",0,0,0,0,0,0,0,0
"Jamaica","2024-09-04",0,0,0,0,0,0,0,0
"Jamaica","2024-09-05",0,0,0,0,0,0,0,0
"Jamaica","2024-09-06",0,0,0,0,0,0,0,0
"Jamaica","2024-09-07",0,0,0,0,0,0,0,0
"Jamaica","2024-09-08",0,0,0,0,0,0,0,0
"Jamaica","2024-09-09",0,0,0,0,0,0,0,0
"Jamaica","2024-09-10",0,0,0,0,0,0,0,0
"Jamaica","2024-09-11",0,0,0,0,0,0,0,0
"Jamaica","2024-09-12",0,0,0,0,0,0,0,0
"Jamaica","2024-09-13",0,0,0,0,0,0,0,0
"Jamaica","2024-09-14",0,0,0,0,0,0,0,0
"Jamaica","2024-09-15",0,0,0,0,0,0,0,0
"Jamaica","2024-09-16",0,0,0,0,0,0,0,0
"Jamaica","2024-09-17",0,0,0,0,0,0,0,0
"Jamaica","2024-09-18",0,0,0,0,0,0,0,0
"Jamaica","2024-09-19",0,0,0,0,0,0,0,0
"Jamaica","2024-09-20",0,0,0,0,0,0,0,0
"Jamaica","2024-09-21",0,0,0,0,0,0,0,0
"Jamaica","2024-09-22",0,0,0,0,0,0,0,0
"Jamaica","2024-09-23",0,0,0,0,0,0,0,0
"Jamaica","2024-09-24",0,0,0,0,0,0,0,0
"Jamaica","2024-09-25",0,0,0,0,0,0,0,0
"Jamaica","2024-09-26",0,0,0,0,0,0,0,0
"Jamaica","2024-09-27",0,0,0,0,0,0,0,0
"Jamaica","2024-09-28",0,0,0,0,0,0,0,0
"Jamaica","2024-09-29",0,0,0,0,0,0,0,0
"Jamaica","2024-09-30",0,0,0,0,0,0,0,0
"Jamaica","2024-10-01",0,0,0,0,0,0,0,0
"Jamaica","2024-10-02",0,0,0,0,0,0,0,0
"Jamaica","2024-10-03",0,0,0,0,0,0,0,0
"Jamaica","2024-10-04",0,0,0,0,0,0,0,0
"Jamaica","2024-10-05",0,0,0,0,0,0,0,0
"Jamaica","2024-10-06",0,0,0,0,0,0,0,0
"Jamaica","2024-10-07",0,0,0,0,0,0,0,0
"Jamaica","2024-10-08",0,0,0,0,0,0,0,0
"Jamaica","2024-10-09",0,0,0,0,0,0,0,0
"Jamaica","2024-10-10",0,0,0,0,0,0,0,0
"Jamaica","2024-10-11",0,0,0,0,0,0,0,0
"Jamaica","2024-10-12",0,0,0,0,0,0,0,0
"Jamaica","2024-10-13",0,0,0,0,0,0,0,0
"Jamaica","2024-10-14",0,0,0,0,0,0,0,0
"Jamaica","2024-10-15",0,0,0,0,0,0,0,0
"Jamaica","2024-10-16",0,0,0,0,0,0,0,0
"Jamaica","2024-10-17",0,0,0,0,0,0,0,0
"Jamaica","2024-10-18",0,0,0,0,0,0,0,0
"Jamaica","2024-10-19",0,0,0,0,0,0,0,0
"Jamaica","2024-10-20",0,0,0,0,0,0,0,0
"Jamaica","2024-10-21",0,0,0,0,0,0,0,0
"Jamaica","2024-10-22",0,0,0,0,0,0,0,0
"Jamaica","2024-10-23",0,0,0,0,0,0,0,0
"Jamaica","2024-10-24",0,0,0,0,0,0,0,0
"Jamaica","2024-10-25",0,0,0,0,0,0,0,0
"Jamaica","2024-10-26",0,0,0,0,0,0,0,0
"Jamaica","2024-10-27",0,0,0,0,0,0,0,0
"Jamaica","2024-10-28",0,0,0,0,0,0,0,0
"Jamaica","2024-10-29",0,0,0,0,0,0,0,0
"Jamaica","2024-10-30",0,0,0,0,0,0,0,0
"Jamaica","2024-10-31",0,0,0,0,0,0,0,0
"Jamaica","2024-11-01",0,0,0,0,0,0,0,0
"Jamaica","2024-11-02",0,0,0,0,0,0,0,0
"Jamaica","2024-11-03",0,0,0,0,0,0,0,0
"Jamaica","2024-11-04",0,0,0,0,0,0,0,0
"Jamaica","2024-11-05",0,0,0,0,0,0,0,0
"Jamaica","2024-11-06",0,0,0,0,0,0,0,0
"Jamaica","2024-11-07",0,0,0,0,0,0,0,0
"Jamaica","2024-11-08",0,0,0,0,0,0,0,0
"Jamaica","2024-11-09",0,0,0,0,0,0,0,0
"Jamaica","2024-11-10",0,0,0,0,0,0,0,0
"Jamaica","2024-11-11",0,0,0,0,0,0,0,0
"Jamaica","2024-11-12",0,0,0,0,0,0,0,0
"Jamaica","2024-11-13",0,0,0,0,0,0,0,0
"Jamaica","2024-11-14",0,0,0,0,0,0,0,0
"Jamaica","2024-11-15",0,0,0,0,0,0,0,0
"Jamaica","2024-11-16",0,0,0,0,0,0,0,0
"Jamaica","2024-11-17",0,0,0,0,0,0,0,0
"Jamaica","2024-11-18",0,0,0,0,0,0,0,0
"Jamaica","2024-11-19",0,0,0,0,0,0,0,0
"Jamaica","2024-11-20",0,0,0,0,0,0,0,0
"Jamaica","2024-11-21",0,0,0,0,0,0,0,0
"Jamaica","2024-11-22",0,0,0,0,0,0,0,0
"Jamaica","2024-11-23",0,0,0,0,0,0,0,0
"Jamaica","2024-11-24",0,0,0,0,0,0,0,0
"Jamaica","2024-11-25",0,0,0,0,0,0,0,0
"Jamaica","2024-11-26",0,0,0,0,0,0,0,0
"Jamaica","2024-11-27",0,0,0,0,0,0,0,0
"Jamaica","2024-11-28",0,0,0,0,0,0,0,0
"Jamaica","2024-11-29",0,0,0,0,0,0,0,0
"Jamaica","2024-11-30",0,0,0,0,0,0,0,0
"Jamaica","2024-12-01",0,0,0,0,0,0,0,0
"Jamaica","2024-12-02",0,0,0,0,0,0,0,0
"Jamaica","2024-12-03",0,0,0,0,0,0,0,0
"Jamaica","2024-12-04",0,0,0,0,0,0,0,0
"Jamaica","2024-12-05",0,0,0,0,0,0,0,0
"Jamaica","2024-12-06",0,0,0,0,0,0,0,0
"Jamaica","2024-12-07",0,0,0,0,0,0,0,0
"Jamaica","2024-12-08",0,0,0,0,0,0,0,0
"Jamaica","2024-12-09",0,0,0,0,0,0,0,0
"Japan","2024-01-01",0,0,0,0,0,0,0,0
"Japan","2024-01-02",0,0,0,0,0,0,0,0
"Japan","2024-01-03",0,0,0,0,0,0,0,0
"Japan","2024-01-04",0,0,0,0,0,0,0,0
"Japan","2024-01-05",0,0,0,0,0,0,0,0
"Japan","2024-01-06",0,0,0,0,0,0,0,0
"Japan","2024-01-07",0,0,0,0,0,0,0,0
"Japan","2024-01-08",0,0,0,0,0,0,0,0
"Japan","2024-01-09",0,1,1,0,1,1,0,0
"Japan","2024-01-10",0,0,1,0,0,1,0,0
"Japan","2024-01-11",0,0,1,0,0,1,0,0
"Japan","2024-01-12",0,0,1,0,0,1,0,0
"Japan","2024-01-13",0,0,1,0,0,1,0,0
"Japan","2024-01-14",0,0,1,0,0,1,0,0
"Japan","2024-01-15",0,0,1,0,1,2,0,0
"Japan","2024-01-16",0,0,1,0,0,2,0,0
"Japan","2024-01-17",0,0,1,0,0,2,0,0
"Japan","2024-01-18",0,0,1,0,0,2,0,0
"Japan","2024-01-19",0,1,2,0,0,2,0,0
"Japan","2024-01-20",0,0,2,0,0,2,0,0
"Japan","2024-01-21",0,0,2,0,0,2,0,0
"Japan","2024-01-22",0,0,2,0,1,3,0,0
"Japan","2024-01-23",0,0,2,0,0,3,0,0
"Japan","2024-01-24",0,0,2,0,0,3,0,0
"Japan","2024-01-25",0,0,2,0,0,3,0,0
"Japan","2024-01-26",0,0,2,0,1,4,0,0
"Japan","2024-01-27",0,0,2,0,0,4,0,0
"Japan","2024-01-28",0,0,2,0,0,4,0,0
"Japan","2024-01-29",0,0,2,0,0,4,0,0
"Japan","2024-01-30",0,0,2,0,0,4,0,0
"Japan","2024-01-31",0,0,2,0,1,5,0,0
"Japan","2024-02-01",0,0,2,0,0,5,0,0
"Japan","2024-02-02",0,3,5,0,0,5,0,0
"Japan","2024-02-03",0,0,5,0,1,6,0,0
"Japan","2024-02-04",0,0,5,0,1,7,0,0
"Japan","2024-02-05",0,3,8,0,1,8,0,0
"Japan","2024-02-06",0,0,8,0,0,8,0,0
"Japan","2024-02-07",0,0,8,0,0,8,0,0
"Japan","2024-02-08",0,0,8,0,0,8,0,0
"Japan","2024-02-09",0,0,8,0,0,8,0,0
"Japan","2024-02-10",0,0,8,0,0,8,0,0
"Japan","2024-02-11",0,0,8,0,0,8,0,0
"Japan","2024-02-12",0,0,8,0,0,8,0,0
"Japan","2024-02-13",0,0,8,0,0,8,0,0
"Japan","2024-02-14",0,0,8,0,0,8,0,0
"Japan","2024-02-15",0,0,8,0,0,8,0,0
"Japan","2024-02-16",0,0,8,0,0,8,0,0
"Japan","2024-02-17",0,0,8,0,0,8,0,0
"Japan","2024-02-18",0,0,8,0,1,9,0,0
"Japan","2024-02-19",0,0,8,0,0,9,0,0
"Japan","2024-02-20",0,0,8,0,0,9,0,0
"Japan","2024-02-21",0,0,8,0,0,9,0,0
"Japan","2024-02-22",0,0,8,0,0,9,0,0
"Japan","2024-02-23",0,0,8,0,0,9,0,0
"Japan","2024-02-24",0,0,8,0,0,9,0,0
"Japan","2024-02-25",0,0,8,0,0,9,0,0
"Japan","2024-02-26",0,0,8,0,0,9,0,0
"Japan","2024-02-27",0,0,8,0,0,9,0,0
"Japan","2024-02-28",0,0,8,0,0,9,0,0
"Japan","2024-02-29",0,0,8,0,0,9,0,0
"Japan","2024-03-01",0,1,9,0,0,9,0,0
"Japan","2024-03-02",0,0,9,0,0,9,0,0
"Japan","2024-03-03",0,0,9,0,0,9,0,0
"Japan","2024-03-04",0,0,9,0,0,9,0,0
"Japan","2024-03-05",0,0,9,0,1,10,0,0
"Japan","2024-03-06",0,0,9,0,0,10,0,0
"Japan","2024-03-07",0,0,9,0,0,10,0,0
"Japan","2024-03-08",0,1,10,0,0,10,0,0
"Japan","2024-03-09",0,0,10,0,0,10,0,0
"Japan","2024-03-10",0,0,10,0,0,10,0,0
"Japan","2024-03-11",0,0,10,0,0,10,0,0
"Japan","2024-03-12",0,0,10,0,0,10,0,0
"Japan","2024-03-13",0,0,10,0,0,10,0,0
"Japan","2024-03-14",0,0,10,0,0,10,0,0
"Japan","2024-03-15",0,0,10,0,0,10,0,0
"Japan","2024-03-16",0,0,10,0,0,10,0,0
"Japan","2024-03-17",0,0,10,0,0,10,0,0
"Japan","2024-03-18",0,0,10,0,0,10,0,0
"Japan","2024-03-19",0,0,10,0,0,10,0,0
"Japan","2024-03-20",0,0,10,0,0,10,0,0
"Japan","2024-03-21",0,0,10,0,0,10,0,0
"Japan","2024-03-22",0,0,10,0,0,10,0,0
"Japan","2024-03-23",0,0,10,0,1,11,0,0
"Japan","2024-03-24",0,0,10,0,0,11,0,0
"Japan","2024-03-25",0,0,10,0,0,11,0,0
"Japan","2024-03-26",0,0,10,0,0,11,0,0
"Japan","2024-03-27",0,0,10,0,0,11,0,0
"Japan","2024-03-28",0,0,10,0,0,11,0,0
"Japan","2024-03-29",0,0,10,0,0,11,0,0
"Japan","2024-03-30",0,0,10,0,0,11,0,0
"Japan","2024-03-31",0,0,10,0,0,11,0,0
"Japan","2024-04-01",0,0,10,0,0,11,0,0
"Japan","2024-04-02",0,0,10,0,0,11,0,0
"Japan","2024-04-03",0,0,10,0,0,11,0,0
"Japan","2024-04-04",0,0,10,0,0,11,0,0
"Japan","2024-04-05",0,1,11,0,0,11,0,0
"Japan","2024-04-06",0,0,11,0,0,11,0,0
"Japan","2024-04-07",0,0,11,0,0,11,0,0
"Japan","2024-04-08",0,0,11,0,0,11,0,0
"Japan","2024-04-09",0,0,11,0,1,12,0,0
"Japan","2024-04-10",0,0,11,0,0,12,0,0
"Japan","2024-04-11",0,0,11,0,0,12,0,0
"Japan","2024-04-12",0,1,12,0,0,12,0,0
"Japan","2024-04-13",0,0,12,0,0,12,0,0
"Japan","2024-04-14",0,0,12,0,0,12,0,0
"Japan","2024-04-15",0,0,12,0,0,12,0,0
"Japan","2024-04-16",0,0,12,0,1,13,0,0
"Japan","2024-04-17",0,0,12,0,0,13,0,0
"Japan","2024-04-18",0,0,12,0,0,13,0,0
"Japan","2024-04-19",0,1,13,0,0,13,0,0
"Japan","2024-04-20",0,0,13,0,0,13,0,0
"Japan","2024-04-21",0,0,13,0,0,13,0,0
"Japan","2024-04-22",0,0,13,0,0,13,0,0
"Japan","2024-04-23",0,0,13,0,0,13,0,0
"Japan","2024-04-24",0,0,13,0,0,13,0,0
"Japan","2024-04-25",0,0,13,0,0,13,0,0
"Japan","2024-04-26",0,0,13,0,0,13,0,0
"Japan","2024-04-27",0,0,13,0,0,13,0,0
"Japan","2024-04-28",0,0,13,0,0,13,0,0
"Japan","2024-04-29",0,0,13,0,0,13,0,0
"Japan","2024-04-30",0,0,13,0,1,14,0,0
"Japan","2024-05-01",0,0,13,0,0,14,0,0
"Japan","2024-05-02",0,0,13,0,0,14,0,0
"Japan","2024-05-03",0,0,13,0,0,14,0,0
"Japan","2024-05-04",0,0,13,0,0,14,0,0
"Japan","2024-05-05",0,0,13,0,0,14,0,0
"Japan","2024-05-06",0,0,13,0,0,14,0,0
"Japan","2024-05-07",0,0,13,0,0,14,0,0
"Japan","2024-05-08",0,0,13,0,0,14,0,0
"Japan","2024-05-09",0,0,13,0,0,14,0,0
"Japan","2024-05-10",0,1,14,0,0,14,0,0
"Japan","2024-05-11",0,0,14,0,0,14,0,0
"Japan","2024-05-12",0,0,14,0,0,14,0,0
"Japan","2024-05-13",0,0,14,0,0,14,0,0
"Japan","2024-05-14",0,0,14,0,0,14,0,0
"Japan","2024-05-15",0,0,14,0,0,14,0,0
"Japan","2024-05-16",0,0,14,0,0,14,0,0
"Japan","2024-05-17",0,0,14,0,0,14,0,0
"Japan","2024-05-18",0,0,14,0,1,15,0,0
"Japan","2024-05-19",0,0,14,0,0,15,0,0
"Japan","2024-05-20",0,0,14,0,0,15,0,0
"Japan","2024-05-21",0,0,14,0,0,15,0,0
"Japan","2024-05-22",0,0,14,0,0,15,0,0
"Japan","2024-05-23",0,0,14,0,0,15,0,0
"Japan","2024-05-24",0,1,15,0,0,15,0,0
"Japan","2024-05-25",0,0,15,0,0,15,0,0
"Japan","2024-05-26",0,0,15,0,0,15,0,0
"Japan","2024-05-27",0,0,15,0,0,15,0,0
"Japan","2024-05-28",0,0,15,0,0,15,0,0
"Japan","2024-05-29",0,0,15,0,0,15,0,0
"Japan","2024-05-30",0,0,15,0,0,15,0,0
"Japan","2024-05-31",0,0,15,0,0,15,0,0
"Japan","2024-06-01",0,0,15,0,0,15,0,0
"Japan","2024-06-02",0,0,15,0,0,15,0,0
"Japan","2024-06-03",0,0,15,0,0,15,0,0
"Japan","2024-06-04",0,0,15,0,0,15,0,0
"Japan","2024-06-05",0,0,15,0,0,15,0,0
"Japan","2024-06-06",0,0,15,0,0,15,0,0
"Japan","2024-06-07",0,0,15,0,0,15,0,0
"Japan","2024-06-08",0,0,15,0,0,15,0,0
"Japan","2024-06-09",0,0,15,0,0,15,0,0
"Japan","2024-06-10",0,0,15,0,0,15,0,0
"Japan","2024-06-11",0,0,15,0,0,15,0,0
"Japan","2024-06-12",0,0,15,0,0,15,0,0
"Japan","2024-06-13",0,0,15,0,0,15,0,0
"Japan","2024-06-14",0,0,15,0,0,15,0,0
"Japan","2024-06-15",0,0,15,0,0,15,0,0
"Japan","2024-06-16",0,0,15,0,0,15,0,0
"Japan","2024-06-17",0,0,15,0,0,15,0,0
"Japan","2024-06-18",0,0,15,0,0,15,0,0
"Japan","2024-06-19",0,0,15,0,0,15,0,0
"Japan","2024-06-20",0,0,15,0,0,15,0,0
"Japan","2024-06-21",0,0,15,0,0,15,0,0
"Japan","2024-06-22",0,0,15,0,0,15,0,0
"Japan","2024-06-23",0,0,15,0,0,15,0,0
"Japan","2024-06-24",0,0,15,0,0,15,0,0
"Japan","2024-06-25",0,0,15,0,0,15,0,0
"Japan","2024-06-26",0,0,15,0,0,15,0,0
"Japan","2024-06-27",0,0,15,0,0,15,0,0
"Japan","2024-06-28",0,0,15,0,0,15,0,0
"Japan","2024-06-29",0,0,15,0,0,15,0,0
"Japan","2024-06-30",0,0,15,0,1,16,0,0
"Japan","2024-07-01",0,0,15,0,0,16,0,0
"Japan","2024-07-02",0,0,15,0,0,16,0,0
"Japan","2024-07-03",0,0,15,0,0,16,0,0
"Japan","2024-07-04",0,0,15,0,0,16,0,0
"Japan","2024-07-05",0,0,15,0,0,16,0,0
"Japan","2024-07-06",0,0,15,0,0,16,0,0
"Japan","2024-07-07",0,0,15,0,0,16,0,0
"Japan","2024-07-08",0,0,15,0,0,16,0,0
"Japan","2024-07-09",0,0,15,0,0,16,0,0
"Japan","2024-07-10",0,0,15,0,0,16,0,0
"Japan","2024-07-11",0,0,15,0,0,16,0,0
"Japan","2024-07-12",0,0,15,0,0,16,0,0
"Japan","2024-07-13",0,0,15,0,0,16,0,0
"Japan","2024-07-14",0,0,15,0,0,16,0,0
"Japan","2024-07-15",0,0,15,0,0,16,0,0
"Japan","2024-07-16",0,0,15,0,0,16,0,0
"Japan","2024-07-17",0,0,15,0,0,16,0,0
"Japan","2024-07-18",0,0,15,0,0,16,0,0
"Japan","2024-07-19",0,0,15,0,0,16,0,0
"Japan","2024-07-20",0,0,15,0,0,16,0,0
"Japan","2024-07-21",0,0,15,0,0,16,0,0
"Japan","2024-07-22",0,0,15,0,0,16,0,0
"Japan","2024-07-23",0,0,15,0,0,16,0,0
"Japan","2024-07-24",0,0,15,0,0,16,0,0
"Japan","2024-07-25",0,0,15,0,0,16,0,0
"Japan","2024-07-26",0,0,15,0,0,16,0,0
"Japan","2024-07-27",0,0,15,0,0,16,0,0
"Japan","2024-07-28",0,0,15,0,0,16,0,0
"Japan","2024-07-29",0,0,15,0,0,16,0,0
"Japan","2024-07-30",0,0,15,0,0,16,0,0
"Japan","2024-07-31",0,0,15,0,0,16,0,0
"Japan","2024-08-01",0,0,15,0,0,16,0,0
"Japan","2024-08-02",0,0,15,0,0,16,0,0
"Japan","2024-08-03",0,0,15,0,0,16,0,0
"Japan","2024-08-04",0,0,15,0,0,16,0,0
"Japan","2024-08-05",0,1,16,0,0,16,0,0
"Japan","2024-08-06",0,0,16,0,0,16,0,0
"Japan","2024-08-07",0,0,16,0,0,16,0,0
"Japan","2024-08-08",0,0,16,0,0,16,0,0
"Japan","2024-08-09",0,0,16,0,0,16,0,0
"Japan","2024-08-10",0,0,16,0,0,16,0,0
"Japan","2024-08-11",0,0,16,0,0,16,0,0
"Japan","2024-08-12",0,0,16,0,0,16,0,0
"Japan","2024-08-13",0,0,16,0,0,16,0,0
"Japan","2024-08-14",0,0,16,0,0,16,0,0
"Japan","2024-08-15",0,0,16,0,0,16,0,0
"Japan","2024-08-16",0,0,16,0,0,16,0,0
"Japan","2024-08-17",0,0,16,0,0,16,0,0
"Japan","2024-08-18",0,0,16,0,0,16,0,0
"Japan","2024-08-19",0,0,16,0,0,16,0,0
"Japan","2024-08-20",0,0,16,0,0,16,0,0
"Japan","2024-08-21",0,0,16,0,0,16,0,0
"Japan","2024-08-22",0,0,16,0,0,16,0,0
"Japan","2024-08-23",0,0,16,0,0,16,0,0
"Japan","2024-08-24",0,0,16,0,0,16,0,0
"Japan","2024-08-25",0,0,16,0,0,16,0,0
"Japan","2024-08-26",0,0,16,0,0,16,0,0
"Japan","2024-08-27",0,0,16,0,0,16,0,0
"Japan","2024-08-28",0,0,16,0,0,16,0,0
"Japan","2024-08-29",0,0,16,0,0,16,0,0
"Japan","2024-08-30",0,0,16,0,0,16,0,0
"Japan","2024-08-31",0,0,16,0,0,16,0,0
"Japan","2024-09-01",0,0,16,0,0,16,0,0
"Japan","2024-09-02",0,0,16,0,0,16,0,0
"Japan","2024-09-03",0,0,16,0,0,16,0,0
"Japan","2024-09-04",0,0,16,0,0,16,0,0
"Japan","2024-09-05",0,0,16,0,1,17,0,0
"Japan","2024-09-06",0,0,16,0,0,17,0,0
"Japan","2024-09-07",0,0,16,0,0,17,0,0
"Japan","2024-09-08",0,0,16,0,0,17,0,0
"Japan","2024-09-09",0,0,16,0,0,17,0,0
"Japan","2024-09-10",0,0,16,0,0,17,0,0
"Japan","2024-09-11",0,0,16,0,0,17,0,0
"Japan","2024-09-12",0,0,16,0,0,17,0,0
"Japan","2024-09-13",0,0,16,0,0,17,0,0
"Japan","2024-09-14",0,0,16,0,0,17,0,0
"Japan","2024-09-15",0,0,16,0,0,17,0,0
"Japan","2024-09-16",0,0,16,0,0,17,0,0
"Japan","2024-09-17",0,0,16,0,0,17,0,0
"Japan","2024-09-18",0,0,16,0,0,17,0,0
"Japan","2024-09-19",0,0,16,0,0,17,0,0
"Japan","2024-09-20",0,0,16,0,0,17,0,0
"Japan","2024-09-21",0,0,16,0,0,17,0,0
"Japan","2024-09-22",0,0,16,0,0,17,0,0
"Japan","2024-09-23",0,0,16,0,0,17,0,0
"Japan","2024-09-24",0,0,16,0,0,17,0,0
"Japan","2024-09-25",0,0,16,0,0,17,0,0
"Japan","2024-09-26",0,0,16,0,0,17,0,0
"Japan","2024-09-27",0,0,16,0,0,17,0,0
"Japan","2024-09-28",0,0,16,0,0,17,0,0
"Japan","2024-09-29",0,0,16,0,0,17,0,0
"Japan","2024-09-30",0,0,16,0,0,17,0,0
"Japan","2024-10-01",0,0,16,0,0,17,0,0
"Japan","2024-10-02",0,0,16,0,0,17,0,0
"Japan","2024-10-03",0,0,16,0,0,17,0,0
"Japan","2024-10-04",0,1,17,0,0,17,0,0
"Japan","2024-10-05",0,0,17,0,0,17,0,0
"Japan","2024-10-06",0,0,17,0,0,17,0,0
"Japan","2024-10-07",0,0,17,0,0,17,0,0
"Japan","2024-10-08",0,0,17,0,1,18,0,0
"Japan","2024-10-09",0,0,17,0,0,18,0,0
"Japan","2024-10-10",0,0,17,0,0,18,0,0
"Japan","2024-10-11",0,0,17,0,0,18,0,0
"Japan","2024-10-12",0,0,17,0,0,18,0,0
"Japan","2024-10-13",0,0,17,0,0,18,0,0
"Japan","2024-10-14",0,0,17,0,0,18,0,0
"Japan","2024-10-15",0,0,17,0,1,19,0,0
"Japan","2024-10-16",0,0,17,0,0,19,0,0
"Japan","2024-10-17",0,0,17,0,0,19,0,0
"Japan","2024-10-18",0,2,19,0,0,19,0,0
"Japan","2024-10-19",0,0,19,0,0,19,0,0
"Japan","2024-10-20",0,0,19,0,0,19,0,0
"Japan","2024-10-21",0,0,19,0,0,19,0,0
"Japan","2024-10-22",0,0,19,0,0,19,0,0
"Japan","2024-10-23",0,0,19,0,0,19,0,0
"Japan","2024-10-24",0,0,19,0,0,19,0,0
"Japan","2024-10-25",0,0,19,0,0,19,0,0
"Japan","2024-10-26",0,0,19,0,0,19,0,0
"Japan","2024-10-27",0,0,19,0,0,19,0,0
"Japan","2024-10-28",0,0,19,0,0,19,0,0
"Japan","2024-10-29",0,0,19,0,0,19,0,0
"Japan","2024-10-30",0,0,19,0,0,19,0,0
"Japan","2024-10-31",0,0,19,0,0,19,0,0
"Japan","2024-11-01",0,0,19,0,0,19,0,0
"Japan","2024-11-02",0,0,19,0,0,19,0,0
"Japan","2024-11-03",0,0,19,0,0,19,0,0
"Japan","2024-11-04",0,0,19,0,0,19,0,0
"Japan","2024-11-05",0,0,19,0,0,19,0,0
"Japan","2024-11-06",0,0,19,0,0,19,0,0
"Japan","2024-11-07",0,0,19,0,0,19,0,0
"Japan","2024-11-08",0,0,19,0,0,19,0,0
"Japan","2024-11-09",0,0,19,0,0,19,0,0
"Japan","2024-11-10",0,0,19,0,0,19,0,0
"Japan","2024-11-11",0,0,19,0,0,19,0,0
"Japan","2024-11-12",0,0,19,0,0,19,0,0
"Japan","2024-11-13",0,0,19,0,0,19,0,0
"Japan","2024-11-14",0,0,19,0,0,19,0,0
"Japan","2024-11-15",0,0,19,0,0,19,0,0
"Japan","2024-11-16",0,0,19,0,0,19,0,0
"Japan","2024-11-17",0,0,19,0,0,19,0,0
"Japan","2024-11-18",0,0,19,0,0,19,0,0
"Japan","2024-11-19",0,0,19,0,0,19,0,0
"Japan","2024-11-20",0,0,19,0,0,19,0,0
"Japan","2024-11-21",0,0,19,0,0,19,0,0
"Japan","2024-11-22",0,0,19,0,0,19,0,0
"Japan","2024-11-23",0,0,19,0,0,19,0,0
"Japan","2024-11-24",0,0,19,0,0,19,0,0
"Japan","2024-11-25",0,0,19,0,0,19,0,0
"Japan","2024-11-26",0,0,19,0,0,19,0,0
"Japan","2024-11-27",0,0,19,0,0,19,0,0
"Japan","2024-11-28",0,0,19,0,0,19,0,0
"Japan","2024-11-29",0,0,19,0,0,19,0,0
"Japan","2024-11-30",0,0,19,0,0,19,0,0
"Japan","2024-12-01",0,0,19,0,0,19,0,0
"Japan","2024-12-02",0,0,19,0,0,19,0,0
"Japan","2024-12-03",0,0,19,0,0,19,0,0
"Japan","2024-12-04",0,0,19,0,0,19,0,0
"Japan","2024-12-05",0,0,19,0,0,19,0,0
"Japan","2024-12-06",0,0,19,0,0,19,0,0
"Japan","2024-12-07",0,0,19,0,0,19,0,0
"Japan","2024-12-08",0,0,19,0,0,19,0,0
"Japan","2024-12-09",0,0,19,0,0,19,0,0
"Jordan","2024-01-01",0,0,0,0,0,0,0,0
"Jordan","2024-01-02",0,0,0,0,0,0,0,0
"Jordan","2024-01-03",0,0,0,0,0,0,0,0
"Jordan","2024-01-04",0,0,0,0,0,0,0,0
"Jordan","2024-01-05",0,0,0,0,0,0,0,0
"Jordan","2024-01-06",0,0,0,0,0,0,0,0
"Jordan","2024-01-07",0,0,0,0,0,0,0,0
"Jordan","2024-01-08",0,0,0,0,0,0,0,0
"Jordan","2024-01-09",0,0,0,0,0,0,0,0
"Jordan","2024-01-10",0,0,0,0,0,0,0,0
"Jordan","2024-01-11",0,0,0,0,0,0,0,0
"Jordan","2024-01-12",0,0,0,0,0,0,0,0
"Jordan","2024-01-13",0,0,0,0,0,0,0,0
"Jordan","2024-01-14",0,0,0,0,0,0,0,0
"Jordan","2024-01-15",0,0,0,0,0,0,0,0
"Jordan","2024-01-16",0,0,0,0,0,0,0,0
"Jordan","2024-01-17",0,0,0,0,0,0,0,0
"Jordan","2024-01-18",0,0,0,0,0,0,0,0
"Jordan","2024-01-19",0,0,0,0,0,0,0,0
"Jordan","2024-01-20",0,0,0,0,0,0,0,0
"Jordan","2024-01-21",0,0,0,0,0,0,0,0
"Jordan","2024-01-22",0,0,0,0,0,0,0,0
"Jordan","2024-01-23",0,0,0,0,0,0,0,0
"Jordan","2024-01-24",0,0,0,0,0,0,0,0
"Jordan","2024-01-25",0,0,0,0,0,0,0,0
"Jordan","2024-01-26",0,0,0,0,0,0,0,0
"Jordan","2024-01-27",0,0,0,0,0,0,0,0
"Jordan","2024-01-28",0,0,0,0,0,0,0,0
"Jordan","2024-01-29",0,0,0,0,0,0,0,0
"Jordan","2024-01-30",0,0,0,0,0,0,0,0
"Jordan","2024-01-31",0,0,0,0,0,0,0,0
"Jordan","2024-02-01",0,0,0,0,0,0,0,0
"Jordan","2024-02-02",0,0,0,0,0,0,0,0
"Jordan","2024-02-03",0,0,0,0,0,0,0,0
"Jordan","2024-02-04",0,0,0,0,0,0,0,0
"Jordan","2024-02-05",0,0,0,0,0,0,0,0
"Jordan","2024-02-06",0,0,0,0,0,0,0,0
"Jordan","2024-02-07",0,0,0,0,0,0,0,0
"Jordan","2024-02-08",0,0,0,0,0,0,0,0
"Jordan","2024-02-09",0,0,0,0,0,0,0,0
"Jordan","2024-02-10",0,0,0,0,0,0,0,0
"Jordan","2024-02-11",0,0,0,0,0,0,0,0
"Jordan","2024-02-12",0,0,0,0,0,0,0,0
"Jordan","2024-02-13",0,0,0,0,0,0,0,0
"Jordan","2024-02-14",0,0,0,0,0,0,0,0
"Jordan","2024-02-15",0,0,0,0,0,0,0,0
"Jordan","2024-02-16",0,0,0,0,0,0,0,0
"Jordan","2024-02-17",0,0,0,0,0,0,0,0
"Jordan","2024-02-18",0,0,0,0,0,0,0,0
"Jordan","2024-02-19",0,0,0,0,0,0,0,0
"Jordan","2024-02-20",0,0,0,0,0,0,0,0
"Jordan","2024-02-21",0,0,0,0,0,0,0,0
"Jordan","2024-02-22",0,0,0,0,0,0,0,0
"Jordan","2024-02-23",0,0,0,0,0,0,0,0
"Jordan","2024-02-24",0,0,0,0,0,0,0,0
"Jordan","2024-02-25",0,0,0,0,0,0,0,0
"Jordan","2024-02-26",0,0,0,0,0,0,0,0
"Jordan","2024-02-27",0,0,0,0,0,0,0,0
"Jordan","2024-02-28",0,0,0,0,0,0,0,0
"Jordan","2024-02-29",0,0,0,0,0,0,0,0
"Jordan","2024-03-01",0,0,0,0,0,0,0,0
"Jordan","2024-03-02",0,0,0,0,0,0,0,0
"Jordan","2024-03-03",0,0,0,0,0,0,0,0
"Jordan","2024-03-04",0,0,0,0,0,0,0,0
"Jordan","2024-03-05",0,0,0,0,0,0,0,0
"Jordan","2024-03-06",0,0,0,0,0,0,0,0
"Jordan","2024-03-07",0,0,0,0,0,0,0,0
"Jordan","2024-03-08",0,0,0,0,0,0,0,0
"Jordan","2024-03-09",0,0,0,0,0,0,0,0
"Jordan","2024-03-10",0,0,0,0,0,0,0,0
"Jordan","2024-03-11",0,0,0,0,0,0,0,0
"Jordan","2024-03-12",0,0,0,0,0,0,0,0
"Jordan","2024-03-13",0,0,0,0,0,0,0,0
"Jordan","2024-03-14",0,0,0,0,0,0,0,0
"Jordan","2024-03-15",0,0,0,0,0,0,0,0
"Jordan","2024-03-16",0,0,0,0,0,0,0,0
"Jordan","2024-03-17",0,0,0,0,0,0,0,0
"Jordan","2024-03-18",0,0,0,0,0,0,0,0
"Jordan","2024-03-19",0,0,0,0,0,0,0,0
"Jordan","2024-03-20",0,0,0,0,0,0,0,0
"Jordan","2024-03-21",0,0,0,0,0,0,0,0
"Jordan","2024-03-22",0,0,0,0,0,0,0,0
"Jordan","2024-03-23",0,0,0,0,0,0,0,0
"Jordan","2024-03-24",0,0,0,0,0,0,0,0
"Jordan","2024-03-25",0,0,0,0,0,0,0,0
"Jordan","2024-03-26",0,0,0,0,0,0,0,0
"Jordan","2024-03-27",0,0,0,0,0,0,0,0
"Jordan","2024-03-28",0,0,0,0,0,0,0,0
"Jordan","2024-03-29",0,0,0,0,0,0,0,0
"Jordan","2024-03-30",0,0,0,0,0,0,0,0
"Jordan","2024-03-31",0,0,0,0,0,0,0,0
"Jordan","2024-04-01",0,0,0,0,0,0,0,0
"Jordan","2024-04-02",0,0,0,0,0,0,0,0
"Jordan","2024-04-03",0,0,0,0,0,0,0,0
"Jordan","2024-04-04",0,0,0,0,0,0,0,0
"Jordan","2024-04-05",0,0,0,0,0,0,0,0
"Jordan","2024-04-06",0,0,0,0,0,0,0,0
"Jordan","2024-04-07",0,0,0,0,0,0,0,0
"Jordan","2024-04-08",0,0,0,0,0,0,0,0
"Jordan","2024-04-09",0,0,0,0,0,0,0,0
"Jordan","2024-04-10",0,0,0,0,0,0,0,0
"Jordan","2024-04-11",0,0,0,0,0,0,0,0
"Jordan","2024-04-12",0,0,0,0,0,0,0,0
"Jordan","2024-04-13",0,0,0,0,0,0,0,0
"Jordan","2024-04-14",0,0,0,0,0,0,0,0
"Jordan","2024-04-15",0,0,0,0,0,0,0,0
"Jordan","2024-04-16",0,0,0,0,0,0,0,0
"Jordan","2024-04-17",0,0,0,0,0,0,0,0
"Jordan","2024-04-18",0,0,0,0,0,0,0,0
"Jordan","2024-04-19",0,0,0,0,0,0,0,0
"Jordan","2024-04-20",0,0,0,0,0,0,0,0
"Jordan","2024-04-21",0,0,0,0,0,0,0,0
"Jordan","2024-04-22",0,0,0,0,0,0,0,0
"Jordan","2024-04-23",0,0,0,0,0,0,0,0
"Jordan","2024-04-24",0,0,0,0,0,0,0,0
"Jordan","2024-04-25",0,0,0,0,0,0,0,0
"Jordan","2024-04-26",0,0,0,0,0,0,0,0
"Jordan","2024-04-27",0,0,0,0,0,0,0,0
"Jordan","2024-04-28",0,0,0,0,0,0,0,0
"Jordan","2024-04-29",0,0,0,0,0,0,0,0
"Jordan","2024-04-30",0,0,0,0,0,0,0,0
"Jordan","2024-05-01",0,0,0,0,0,0,0,0
"Jordan","2024-05-02",0,0,0,0,0,0,0,0
"Jordan","2024-05-03",0,0,0,0,0,0,0,0
"Jordan","2024-05-04",0,0,0,0,0,0,0,0
"Jordan","2024-05-05",0,0,0,0,0,0,0,0
"Jordan","2024-05-06",0,0,0,0,0,0,0,0
"Jordan","2024-05-07",0,0,0,0,0,0,0,0
"Jordan","2024-05-08",0,0,0,0,0,0,0,0
"Jordan","2024-05-09",0,0,0,0,0,0,0,0
"Jordan","2024-05-10",0,0,0,0,0,0,0,0
"Jordan","2024-05-11",0,0,0,0,0,0,0,0
"Jordan","2024-05-12",0,0,0,0,0,0,0,0
"Jordan","2024-05-13",0,0,0,0,0,0,0,0
"Jordan","2024-05-14",0,0,0,0,0,0,0,0
"Jordan","2024-05-15",0,0,0,0,0,0,0,0
"Jordan","2024-05-16",0,0,0,0,0,0,0,0
"Jordan","2024-05-17",0,0,0,0,0,0,0,0
"Jordan","2024-05-18",0,0,0,0,0,0,0,0
"Jordan","2024-05-19",0,0,0,0,0,0,0,0
"Jordan","2024-05-20",0,0,0,0,0,0,0,0
"Jordan","2024-05-21",0,0,0,0,0,0,0,0
"Jordan","2024-05-22",0,0,0,0,0,0,0,0
"Jordan","2024-05-23",0,0,0,0,0,0,0,0
"Jordan","2024-05-24",0,0,0,0,0,0,0,0
"Jordan","2024-05-25",0,0,0,0,0,0,0,0
"Jordan","2024-05-26",0,0,0,0,0,0,0,0
"Jordan","2024-05-27",0,0,0,0,0,0,0,0
"Jordan","2024-05-28",0,0,0,0,0,0,0,0
"Jordan","2024-05-29",0,0,0,0,0,0,0,0
"Jordan","2024-05-30",0,0,0,0,0,0,0,0
"Jordan","2024-05-31",0,0,0,0,0,0,0,0
"Jordan","2024-06-01",0,0,0,0,0,0,0,0
"Jordan","2024-06-02",0,0,0,0,0,0,0,0
"Jordan","2024-06-03",0,0,0,0,0,0,0,0
"Jordan","2024-06-04",0,0,0,0,0,0,0,0
"Jordan","2024-06-05",0,0,0,0,0,0,0,0
"Jordan","2024-06-06",0,0,0,0,0,0,0,0
"Jordan","2024-06-07",0,0,0,0,0,0,0,0
"Jordan","2024-06-08",0,0,0,0,0,0,0,0
"Jordan","2024-06-09",0,0,0,0,0,0,0,0
"Jordan","2024-06-10",0,0,0,0,0,0,0,0
"Jordan","2024-06-11",0,0,0,0,0,0,0,0
"Jordan","2024-06-12",0,0,0,0,0,0,0,0
"Jordan","2024-06-13",0,0,0,0,0,0,0,0
"Jordan","2024-06-14",0,0,0,0,0,0,0,0
"Jordan","2024-06-15",0,0,0,0,0,0,0,0
"Jordan","2024-06-16",0,0,0,0,0,0,0,0
"Jordan","2024-06-17",0,0,0,0,0,0,0,0
"Jordan","2024-06-18",0,0,0,0,0,0,0,0
"Jordan","2024-06-19",0,0,0,0,0,0,0,0
"Jordan","2024-06-20",0,0,0,0,0,0,0,0
"Jordan","2024-06-21",0,0,0,0,0,0,0,0
"Jordan","2024-06-22",0,0,0,0,0,0,0,0
"Jordan","2024-06-23",0,0,0,0,0,0,0,0
"Jordan","2024-06-24",0,0,0,0,0,0,0,0
"Jordan","2024-06-25",0,0,0,0,0,0,0,0
"Jordan","2024-06-26",0,0,0,0,0,0,0,0
"Jordan","2024-06-27",0,0,0,0,0,0,0,0
"Jordan","2024-06-28",0,0,0,0,0,0,0,0
"Jordan","2024-06-29",0,0,0,0,0,0,0,0
"Jordan","2024-06-30",0,0,0,0,0,0,0,0
"Jordan","2024-07-01",0,0,0,0,0,0,0,0
"Jordan","2024-07-02",0,0,0,0,0,0,0,0
"Jordan","2024-07-03",0,0,0,0,0,0,0,0
"Jordan","2024-07-04",0,0,0,0,0,0,0,0
"Jordan","2024-07-05",0,0,0,0,0,0,0,0
"Jordan","2024-07-06",0,0,0,0,0,0,0,0
"Jordan","2024-07-07",0,0,0,0,0,0,0,0
"Jordan","2024-07-08",0,0,0,0,0,0,0,0
"Jordan","2024-07-09",0,0,0,0,0,0,0,0
"Jordan","2024-07-10",0,0,0,0,0,0,0,0
"Jordan","2024-07-11",0,0,0,0,0,0,0,0
"Jordan","2024-07-12",0,0,0,0,0,0,0,0
"Jordan","2024-07-13",0,0,0,0,0,0,0,0
"Jordan","2024-07-14",0,0,0,0,0,0,0,0
"Jordan","2024-07-15",0,0,0,0,0,0,0,0
"Jordan","2024-07-16",0,0,0,0,0,0,0,0
"Jordan","2024-07-17",0,0,0,0,0,0,0,0
"Jordan","2024-07-18",0,0,0,0,0,0,0,0
"Jordan","2024-07-19",0,0,0,0,0,0,0,0
"Jordan","2024-07-20",0,0,0,0,0,0,0,0
"Jordan","2024-07-21",0,0,0,0,0,0,0,0
"Jordan","2024-07-22",0,0,0,0,0,0,0,0
"Jordan","2024-07-23",0,0,0,0,0,0,0,0
"Jordan","2024-07-24",0,0,0,0,0,0,0,0
"Jordan","2024-07-25",0,0,0,0,0,0,0,0
"Jordan","2024-07-26",0,0,0,0,0,0,0,0
"Jordan","2024-07-27",0,0,0,0,0,0,0,0
"Jordan","2024-07-28",0,0,0,0,0,0,0,0
"Jordan","2024-07-29",0,0,0,0,0,0,0,0
"Jordan","2024-07-30",0,0,0,0,0,0,0,0
"Jordan","2024-07-31",0,0,0,0,0,0,0,0
"Jordan","2024-08-01",0,0,0,0,0,0,0,0
"Jordan","2024-08-02",0,0,0,0,0,0,0,0
"Jordan","2024-08-03",0,0,0,0,0,0,0,0
"Jordan","2024-08-04",0,0,0,0,0,0,0,0
"Jordan","2024-08-05",0,0,0,0,0,0,0,0
"Jordan","2024-08-06",0,0,0,0,0,0,0,0
"Jordan","2024-08-07",0,0,0,0,0,0,0,0
"Jordan","2024-08-08",0,0,0,0,0,0,0,0
"Jordan","2024-08-09",0,0,0,0,0,0,0,0
"Jordan","2024-08-10",0,0,0,0,0,0,0,0
"Jordan","2024-08-11",0,0,0,0,0,0,0,0
"Jordan","2024-08-12",0,0,0,0,0,0,0,0
"Jordan","2024-08-13",0,0,0,0,0,0,0,0
"Jordan","2024-08-14",0,0,0,0,0,0,0,0
"Jordan","2024-08-15",0,0,0,0,0,0,0,0
"Jordan","2024-08-16",0,0,0,0,0,0,0,0
"Jordan","2024-08-17",0,0,0,0,0,0,0,0
"Jordan","2024-08-18",0,0,0,0,0,0,0,0
"Jordan","2024-08-19",0,0,0,0,0,0,0,0
"Jordan","2024-08-20",0,0,0,0,0,0,0,0
"Jordan","2024-08-21",0,0,0,0,0,0,0,0
"Jordan","2024-08-22",0,0,0,0,0,0,0,0
"Jordan","2024-08-23",0,0,0,0,0,0,0,0
"Jordan","2024-08-24",0,0,0,0,0,0,0,0
"Jordan","2024-08-25",0,0,0,0,0,0,0,0
"Jordan","2024-08-26",0,0,0,0,0,0,0,0
"Jordan","2024-08-27",0,0,0,0,0,0,0,0
"Jordan","2024-08-28",0,0,0,0,0,0,0,0
"Jordan","2024-08-29",0,0,0,0,0,0,0,0
"Jordan","2024-08-30",0,0,0,0,0,0,0,0
"Jordan","2024-08-31",0,0,0,0,0,0,0,0
"Jordan","2024-09-01",0,0,0,0,0,0,0,0
"Jordan","2024-09-02",0,1,1,0,1,1,0,0
"Jordan","2024-09-03",0,0,1,0,0,1,0,0
"Jordan","2024-09-04",0,0,1,0,0,1,0,0
"Jordan","2024-09-05",0,0,1,0,0,1,0,0
"Jordan","2024-09-06",0,0,1,0,0,1,0,0
"Jordan","2024-09-07",0,0,1,0,0,1,0,0
"Jordan","2024-09-08",0,0,1,0,0,1,0,0
"Jordan","2024-09-09",0,0,1,0,0,1,0,0
"Jordan","2024-09-10",0,0,1,0,0,1,0,0
"Jordan","2024-09-11",0,0,1,0,0,1,0,0
"Jordan","2024-09-12",0,0,1,0,0,1,0,0
"Jordan","2024-09-13",0,0,1,0,0,1,0,0
"Jordan","2024-09-14",0,0,1,0,0,1,0,0
"Jordan","2024-09-15",0,0,1,0,0,1,0,0
"Jordan","2024-09-16",0,0,1,0,0,1,0,0
"Jordan","2024-09-17",0,0,1,0,0,1,0,0
"Jordan","2024-09-18",0,0,1,0,0,1,0,0
"Jordan","2024-09-19",0,0,1,0,0,1,0,0
"Jordan","2024-09-20",0,0,1,0,0,1,0,0
"Jordan","2024-09-21",0,0,1,0,0,1,0,0
"Jordan","2024-09-22",0,0,1,0,0,1,0,0
"Jordan","2024-09-23",0,0,1,0,0,1,0,0
"Jordan","2024-09-24",0,0,1,0,0,1,0,0
"Jordan","2024-09-25",0,0,1,0,0,1,0,0
"Jordan","2024-09-26",0,0,1,0,0,1,0,0
"Jordan","2024-09-27",0,0,1,0,0,1,0,0
"Jordan","2024-09-28",0,0,1,0,0,1,0,0
"Jordan","2024-09-29",0,0,1,0,0,1,0,0
"Jordan","2024-09-30",0,0,1,0,0,1,0,0
"Jordan","2024-10-01",0,0,1,0,0,1,0,0
"Jordan","2024-10-02",0,0,1,0,0,1,0,0
"Jordan","2024-10-03",0,0,1,0,0,1,0,0
"Jordan","2024-10-04",0,0,1,0,0,1,0,0
"Jordan","2024-10-05",0,0,1,0,0,1,0,0
"Jordan","2024-10-06",0,0,1,0,0,1,0,0
"Jordan","2024-10-07",0,0,1,0,0,1,0,0
"Jordan","2024-10-08",0,0,1,0,0,1,0,0
"Jordan","2024-10-09",0,0,1,0,0,1,0,0
"Jordan","2024-10-10",0,0,1,0,0,1,0,0
"Jordan","2024-10-11",0,0,1,0,0,1,0,0
"Jordan","2024-10-12",0,0,1,0,0,1,0,0
"Jordan","2024-10-13",0,0,1,0,0,1,0,0
"Jordan","2024-10-14",0,0,1,0,0,1,0,0
"Jordan","2024-10-15",0,0,1,0,0,1,0,0
"Jordan","2024-10-16",0,0,1,0,0,1,0,0
"Jordan","2024-10-17",0,0,1,0,0,1,0,0
"Jordan","2024-10-18",0,0,1,0,0,1,0,0
"Jordan","2024-10-19",0,0,1,0,0,1,0,0
"Jordan","2024-10-20",0,0,1,0,0,1,0,0
"Jordan","2024-10-21",0,0,1,0,0,1,0,0
"Jordan","2024-10-22",0,0,1,0,0,1,0,0
"Jordan","2024-10-23",0,0,1,0,0,1,0,0
"Jordan","2024-10-24",0,0,1,0,0,1,0,0
"Jordan","2024-10-25",0,0,1,0,0,1,0,0
"Jordan","2024-10-26",0,0,1,0,0,1,0,0
"Jordan","2024-10-27",0,0,1,0,0,1,0,0
"Jordan","2024-10-28",0,0,1,0,0,1,0,0
"Jordan","2024-10-29",0,0,1,0,0,1,0,0
"Jordan","2024-10-30",0,0,1,0,0,1,0,0
"Jordan","2024-10-31",0,0,1,0,0,1,0,0
"Jordan","2024-11-01",0,0,1,0,0,1,0,0
"Jordan","2024-11-02",0,0,1,0,0,1,0,0
"Jordan","2024-11-03",0,0,1,0,0,1,0,0
"Jordan","2024-11-04",0,0,1,0,0,1,0,0
"Jordan","2024-11-05",0,0,1,0,0,1,0,0
"Jordan","2024-11-06",0,0,1,0,0,1,0,0
"Jordan","2024-11-07",0,0,1,0,0,1,0,0
"Jordan","2024-11-08",0,0,1,0,0,1,0,0
"Jordan","2024-11-09",0,0,1,0,0,1,0,0
"Jordan","2024-11-10",0,0,1,0,0,1,0,0
"Jordan","2024-11-11",0,0,1,0,0,1,0,0
"Jordan","2024-11-12",0,0,1,0,0,1,0,0
"Jordan","2024-11-13",0,0,1,0,0,1,0,0
"Jordan","2024-11-14",0,0,1,0,0,1,0,0
"Jordan","2024-11-15",0,0,1,0,0,1,0,0
"Jordan","2024-11-16",0,0,1,0,0,1,0,0
"Jordan","2024-11-17",0,0,1,0,0,1,0,0
"Jordan","2024-11-18",0,0,1,0,0,1,0,0
"Jordan","2024-11-19",0,0,1,0,0,1,0,0
"Jordan","2024-11-20",0,0,1,0,0,1,0,0
"Jordan","2024-11-21",0,0,1,0,0,1,0,0
"Jordan","2024-11-22",0,0,1,0,0,1,0,0
"Jordan","2024-11-23",0,0,1,0,0,1,0,0
"Jordan","2024-11-24",0,0,1,0,0,1,0,0
"Jordan","2024-11-25",0,0,1,0,0,1,0,0
"Jordan","2024-11-26",0,0,1,0,0,1,0,0
"Jordan","2024-11-27",0,0,1,0,0,1,0,0
"Jordan","2024-11-28",0,0,1,0,0,1,0,0
"Jordan","2024-11-29",0,0,1,0,0,1,0,0
"Jordan","2024-11-30",0,0,1,0,0,1,0,0
"Jordan","2024-12-01",0,0,1,0,0,1,0,0
"Jordan","2024-12-02",0,0,1,0,0,1,0,0
"Jordan","2024-12-03",0,0,1,0,0,1,0,0
"Jordan","2024-12-04",0,0,1,0,0,1,0,0
"Jordan","2024-12-05",0,0,1,0,0,1,0,0
"Jordan","2024-12-06",0,0,1,0,0,1,0,0
"Jordan","2024-12-07",0,0,1,0,0,1,0,0
"Jordan","2024-12-08",0,0,1,0,0,1,0,0
"Jordan","2024-12-09",0,0,1,0,0,1,0,0
"Kenya","2024-01-01",0,0,0,0,0,0,0,0
"Kenya","2024-01-02",0,0,0,0,0,0,0,0
"Kenya","2024-01-03",0,0,0,0,0,0,0,0
"Kenya","2024-01-04",0,0,0,0,0,0,0,0
"Kenya","2024-01-05",0,0,0,0,0,0,0,0
"Kenya","2024-01-06",0,0,0,0,0,0,0,0
"Kenya","2024-01-07",0,0,0,0,0,0,0,0
"Kenya","2024-01-08",0,0,0,0,0,0,0,0
"Kenya","2024-01-09",0,0,0,0,0,0,0,0
"Kenya","2024-01-10",0,0,0,0,0,0,0,0
"Kenya","2024-01-11",0,0,0,0,0,0,0,0
"Kenya","2024-01-12",0,0,0,0,0,0,0,0
"Kenya","2024-01-13",0,0,0,0,0,0,0,0
"Kenya","2024-01-14",0,0,0,0,0,0,0,0
"Kenya","2024-01-15",0,0,0,0,0,0,0,0
"Kenya","2024-01-16",0,0,0,0,0,0,0,0
"Kenya","2024-01-17",0,0,0,0,0,0,0,0
"Kenya","2024-01-18",0,0,0,0,0,0,0,0
"Kenya","2024-01-19",0,0,0,0,0,0,0,0
"Kenya","2024-01-20",0,0,0,0,0,0,0,0
"Kenya","2024-01-21",0,0,0,0,0,0,0,0
"Kenya","2024-01-22",0,0,0,0,0,0,0,0
"Kenya","2024-01-23",0,0,0,0,0,0,0,0
"Kenya","2024-01-24",0,0,0,0,0,0,0,0
"Kenya","2024-01-25",0,0,0,0,0,0,0,0
"Kenya","2024-01-26",0,0,0,0,0,0,0,0
"Kenya","2024-01-27",0,0,0,0,0,0,0,0
"Kenya","2024-01-28",0,0,0,0,0,0,0,0
"Kenya","2024-01-29",0,0,0,0,0,0,0,0
"Kenya","2024-01-30",0,0,0,0,0,0,0,0
"Kenya","2024-01-31",0,0,0,0,0,0,0,0
"Kenya","2024-02-01",0,0,0,0,0,0,0,0
"Kenya","2024-02-02",0,0,0,0,0,0,0,0
"Kenya","2024-02-03",0,0,0,0,0,0,0,0
"Kenya","2024-02-04",0,0,0,0,0,0,0,0
"Kenya","2024-02-05",0,0,0,0,0,0,0,0
"Kenya","2024-02-06",0,0,0,0,0,0,0,0
"Kenya","2024-02-07",0,0,0,0,0,0,0,0
"Kenya","2024-02-08",0,0,0,0,0,0,0,0
"Kenya","2024-02-09",0,0,0,0,0,0,0,0
"Kenya","2024-02-10",0,0,0,0,0,0,0,0
"Kenya","2024-02-11",0,0,0,0,0,0,0,0
"Kenya","2024-02-12",0,0,0,0,0,0,0,0
"Kenya","2024-02-13",0,0,0,0,0,0,0,0
"Kenya","2024-02-14",0,0,0,0,0,0,0,0
"Kenya","2024-02-15",0,0,0,0,0,0,0,0
"Kenya","2024-02-16",0,0,0,0,0,0,0,0
"Kenya","2024-02-17",0,0,0,0,0,0,0,0
"Kenya","2024-02-18",0,0,0,0,0,0,0,0
"Kenya","2024-02-19",0,0,0,0,0,0,0,0
"Kenya","2024-02-20",0,0,0,0,0,0,0,0
"Kenya","2024-02-21",0,0,0,0,0,0,0,0
"Kenya","2024-02-22",0,0,0,0,0,0,0,0
"Kenya","2024-02-23",0,0,0,0,0,0,0,0
"Kenya","2024-02-24",0,0,0,0,0,0,0,0
"Kenya","2024-02-25",0,0,0,0,0,0,0,0
"Kenya","2024-02-26",0,0,0,0,0,0,0,0
"Kenya","2024-02-27",0,0,0,0,0,0,0,0
"Kenya","2024-02-28",0,0,0,0,0,0,0,0
"Kenya","2024-02-29",0,0,0,0,0,0,0,0
"Kenya","2024-03-01",0,0,0,0,0,0,0,0
"Kenya","2024-03-02",0,0,0,0,0,0,0,0
"Kenya","2024-03-03",0,0,0,0,0,0,0,0
"Kenya","2024-03-04",0,0,0,0,0,0,0,0
"Kenya","2024-03-05",0,0,0,0,0,0,0,0
"Kenya","2024-03-06",0,0,0,0,0,0,0,0
"Kenya","2024-03-07",0,0,0,0,0,0,0,0
"Kenya","2024-03-08",0,0,0,0,0,0,0,0
"Kenya","2024-03-09",0,0,0,0,0,0,0,0
"Kenya","2024-03-10",0,0,0,0,0,0,0,0
"Kenya","2024-03-11",0,0,0,0,0,0,0,0
"Kenya","2024-03-12",0,0,0,0,0,0,0,0
"Kenya","2024-03-13",0,0,0,0,0,0,0,0
"Kenya","2024-03-14",0,0,0,0,0,0,0,0
"Kenya","2024-03-15",0,0,0,0,0,0,0,0
"Kenya","2024-03-16",0,0,0,0,0,0,0,0
"Kenya","2024-03-17",0,0,0,0,0,0,0,0
"Kenya","2024-03-18",0,0,0,0,0,0,0,0
"Kenya","2024-03-19",0,0,0,0,0,0,0,0
"Kenya","2024-03-20",0,0,0,0,0,0,0,0
"Kenya","2024-03-21",0,0,0,0,0,0,0,0
"Kenya","2024-03-22",0,0,0,0,0,0,0,0
"Kenya","2024-03-23",0,0,0,0,0,0,0,0
"Kenya","2024-03-24",0,0,0,0,0,0,0,0
"Kenya","2024-03-25",0,0,0,0,0,0,0,0
"Kenya","2024-03-26",0,0,0,0,0,0,0,0
"Kenya","2024-03-27",0,0,0,0,0,0,0,0
"Kenya","2024-03-28",0,0,0,0,0,0,0,0
"Kenya","2024-03-29",0,0,0,0,0,0,0,0
"Kenya","2024-03-30",0,0,0,0,0,0,0,0
"Kenya","2024-03-31",0,0,0,0,0,0,0,0
"Kenya","2024-04-01",0,0,0,0,0,0,0,0
"Kenya","2024-04-02",0,0,0,0,0,0,0,0
"Kenya","2024-04-03",0,0,0,0,0,0,0,0
"Kenya","2024-04-04",0,0,0,0,0,0,0,0
"Kenya","2024-04-05",0,0,0,0,0,0,0,0
"Kenya","2024-04-06",0,0,0,0,0,0,0,0
"Kenya","2024-04-07",0,0,0,0,0,0,0,0
"Kenya","2024-04-08",0,0,0,0,0,0,0,0
"Kenya","2024-04-09",0,0,0,0,0,0,0,0
"Kenya","2024-04-10",0,0,0,0,0,0,0,0
"Kenya","2024-04-11",0,0,0,0,0,0,0,0
"Kenya","2024-04-12",0,0,0,0,0,0,0,0
"Kenya","2024-04-13",0,0,0,0,0,0,0,0
"Kenya","2024-04-14",0,0,0,0,0,0,0,0
"Kenya","2024-04-15",0,0,0,0,0,0,0,0
"Kenya","2024-04-16",0,0,0,0,0,0,0,0
"Kenya","2024-04-17",0,0,0,0,0,0,0,0
"Kenya","2024-04-18",0,0,0,0,0,0,0,0
"Kenya","2024-04-19",0,0,0,0,0,0,0,0
"Kenya","2024-04-20",0,0,0,0,0,0,0,0
"Kenya","2024-04-21",0,0,0,0,0,0,0,0
"Kenya","2024-04-22",0,0,0,0,0,0,0,0
"Kenya","2024-04-23",0,0,0,0,0,0,0,0
"Kenya","2024-04-24",0,0,0,0,0,0,0,0
"Kenya","2024-04-25",0,0,0,0,0,0,0,0
"Kenya","2024-04-26",0,0,0,0,0,0,0,0
"Kenya","2024-04-27",0,0,0,0,0,0,0,0
"Kenya","2024-04-28",0,0,0,0,0,0,0,0
"Kenya","2024-04-29",0,0,0,0,0,0,0,0
"Kenya","2024-04-30",0,0,0,0,0,0,0,0
"Kenya","2024-05-01",0,0,0,0,0,0,0,0
"Kenya","2024-05-02",0,0,0,0,0,0,0,0
"Kenya","2024-05-03",0,0,0,0,0,0,0,0
"Kenya","2024-05-04",0,0,0,0,0,0,0,0
"Kenya","2024-05-05",0,0,0,0,0,0,0,0
"Kenya","2024-05-06",0,0,0,0,0,0,0,0
"Kenya","2024-05-07",0,0,0,0,0,0,0,0
"Kenya","2024-05-08",0,0,0,0,0,0,0,0
"Kenya","2024-05-09",0,0,0,0,0,0,0,0
"Kenya","2024-05-10",0,0,0,0,0,0,0,0
"Kenya","2024-05-11",0,0,0,0,0,0,0,0
"Kenya","2024-05-12",0,0,0,0,0,0,0,0
"Kenya","2024-05-13",0,0,0,0,0,0,0,0
"Kenya","2024-05-14",0,0,0,0,0,0,0,0
"Kenya","2024-05-15",0,0,0,0,0,0,0,0
"Kenya","2024-05-16",0,0,0,0,0,0,0,0
"Kenya","2024-05-17",0,0,0,0,0,0,0,0
"Kenya","2024-05-18",0,0,0,0,0,0,0,0
"Kenya","2024-05-19",0,0,0,0,0,0,0,0
"Kenya","2024-05-20",0,0,0,0,0,0,0,0
"Kenya","2024-05-21",0,0,0,0,0,0,0,0
"Kenya","2024-05-22",0,0,0,0,0,0,0,0
"Kenya","2024-05-23",0,0,0,0,0,0,0,0
"Kenya","2024-05-24",0,0,0,0,0,0,0,0
"Kenya","2024-05-25",0,0,0,0,0,0,0,0
"Kenya","2024-05-26",0,0,0,0,0,0,0,0
"Kenya","2024-05-27",0,0,0,0,0,0,0,0
"Kenya","2024-05-28",0,0,0,0,0,0,0,0
"Kenya","2024-05-29",0,0,0,0,0,0,0,0
"Kenya","2024-05-30",0,0,0,0,0,0,0,0
"Kenya","2024-05-31",0,0,0,0,0,0,0,0
"Kenya","2024-06-01",0,0,0,0,0,0,0,0
"Kenya","2024-06-02",0,0,0,0,0,0,0,0
"Kenya","2024-06-03",0,0,0,0,0,0,0,0
"Kenya","2024-06-04",0,0,0,0,0,0,0,0
"Kenya","2024-06-05",0,0,0,0,0,0,0,0
"Kenya","2024-06-06",0,0,0,0,0,0,0,0
"Kenya","2024-06-07",0,0,0,0,0,0,0,0
"Kenya","2024-06-08",0,0,0,0,0,0,0,0
"Kenya","2024-06-09",0,0,0,0,0,0,0,0
"Kenya","2024-06-10",0,0,0,0,0,0,0,0
"Kenya","2024-06-11",0,0,0,0,0,0,0,0
"Kenya","2024-06-12",0,0,0,0,0,0,0,0
"Kenya","2024-06-13",0,0,0,0,0,0,0,0
"Kenya","2024-06-14",0,0,0,0,0,0,0,0
"Kenya","2024-06-15",0,0,0,0,0,0,0,0
"Kenya","2024-06-16",0,0,0,0,0,0,0,0
"Kenya","2024-06-17",0,0,0,0,0,0,0,0
"Kenya","2024-06-18",0,0,0,0,0,0,0,0
"Kenya","2024-06-19",0,0,0,0,0,0,0,0
"Kenya","2024-06-20",0,0,0,0,0,0,0,0
"Kenya","2024-06-21",0,0,0,0,0,0,0,0
"Kenya","2024-06-22",0,0,0,0,0,0,0,0
"Kenya","2024-06-23",0,0,0,0,0,0,0,0
"Kenya","2024-06-24",0,0,0,0,0,0,0,0
"Kenya","2024-06-25",0,0,0,0,0,0,0,0
"Kenya","2024-06-26",0,0,0,0,0,0,0,0
"Kenya","2024-06-27",0,0,0,0,0,0,0,0
"Kenya","2024-06-28",0,0,0,0,0,0,0,0
"Kenya","2024-06-29",0,0,0,0,0,0,0,0
"Kenya","2024-06-30",0,0,0,0,0,0,0,0
"Kenya","2024-07-01",0,0,0,0,0,0,0,0
"Kenya","2024-07-02",0,0,0,0,0,0,0,0
"Kenya","2024-07-03",0,0,0,0,0,0,0,0
"Kenya","2024-07-04",0,0,0,0,0,0,0,0
"Kenya","2024-07-05",0,0,0,0,0,0,0,0
"Kenya","2024-07-06",0,0,0,0,0,0,0,0
"Kenya","2024-07-07",0,0,0,0,0,0,0,0
"Kenya","2024-07-08",0,0,0,0,0,0,0,0
"Kenya","2024-07-09",0,0,0,0,0,0,0,0
"Kenya","2024-07-10",0,0,0,0,0,0,0,0
"Kenya","2024-07-11",0,0,0,0,0,0,0,0
"Kenya","2024-07-12",0,0,0,0,0,0,0,0
"Kenya","2024-07-13",0,0,0,0,0,0,0,0
"Kenya","2024-07-14",0,0,0,0,0,0,0,0
"Kenya","2024-07-15",0,0,0,0,0,0,0,0
"Kenya","2024-07-16",0,0,0,0,0,0,0,0
"Kenya","2024-07-17",0,0,0,0,0,0,0,0
"Kenya","2024-07-18",0,0,0,0,0,0,0,0
"Kenya","2024-07-19",0,0,0,0,0,0,0,0
"Kenya","2024-07-20",0,0,0,0,0,0,0,0
"Kenya","2024-07-21",0,0,0,0,0,0,0,0
"Kenya","2024-07-22",0,0,0,0,0,0,0,0
"Kenya","2024-07-23",0,0,0,0,0,0,0,0
"Kenya","2024-07-24",0,0,0,0,0,0,0,0
"Kenya","2024-07-25",0,0,0,0,0,0,0,0
"Kenya","2024-07-26",0,0,0,0,0,0,0,0
"Kenya","2024-07-27",0,0,0,0,0,0,0,0
"Kenya","2024-07-28",0,1,1,0,1,1,0,0
"Kenya","2024-07-29",0,0,1,0,0,1,0,0
"Kenya","2024-07-30",0,0,1,0,0,1,0,0
"Kenya","2024-07-31",0,0,1,0,0,1,0,0
"Kenya","2024-08-01",0,0,1,0,0,1,0,0
"Kenya","2024-08-02",0,0,1,0,0,1,0,0
"Kenya","2024-08-03",0,0,1,0,0,1,0,0
"Kenya","2024-08-04",0,0,1,0,0,1,0,0
"Kenya","2024-08-05",0,0,1,0,0,1,0,0
"Kenya","2024-08-06",0,0,1,0,0,1,0,0
"Kenya","2024-08-07",0,0,1,0,0,1,0,0
"Kenya","2024-08-08",0,0,1,0,0,1,0,0
"Kenya","2024-08-09",0,0,1,0,0,1,0,0
"Kenya","2024-08-10",0,0,1,0,0,1,0,0
"Kenya","2024-08-11",0,0,1,0,0,1,0,0
"Kenya","2024-08-12",0,0,1,0,1,2,0,0
"Kenya","2024-08-13",0,0,1,0,0,2,0,0
"Kenya","2024-08-14",0,0,1,0,0,2,0,0
"Kenya","2024-08-15",0,0,1,0,0,2,0,0
"Kenya","2024-08-16",0,0,1,0,0,2,0,0
"Kenya","2024-08-17",0,0,1,0,0,2,0,0
"Kenya","2024-08-18",0,0,1,0,0,2,0,0
"Kenya","2024-08-19",0,0,1,0,0,2,0,0
"Kenya","2024-08-20",0,0,1,0,0,2,0,0
"Kenya","2024-08-21",0,0,1,0,0,2,0,0
"Kenya","2024-08-22",0,0,1,0,0,2,0,0
"Kenya","2024-08-23",0,0,1,0,0,2,0,0
"Kenya","2024-08-24",0,0,1,0,0,2,0,0
"Kenya","2024-08-25",0,1,2,0,0,2,0,0
"Kenya","2024-08-26",0,0,2,0,0,2,0,0
"Kenya","2024-08-27",0,0,2,0,1,3,0,0
"Kenya","2024-08-28",0,0,2,0,0,3,0,0
"Kenya","2024-08-29",0,0,2,0,0,3,0,0
"Kenya","2024-08-30",0,0,2,0,0,3,0,0
"Kenya","2024-08-31",0,0,2,0,1,4,0,0
"Kenya","2024-09-01",0,2,4,0,0,4,0,0
"Kenya","2024-09-02",0,0,4,0,0,4,0,0
"Kenya","2024-09-03",0,0,4,0,0,4,0,0
"Kenya","2024-09-04",0,0,4,0,0,4,0,0
"Kenya","2024-09-05",0,0,4,0,1,5,0,0
"Kenya","2024-09-06",0,0,4,0,0,5,0,0
"Kenya","2024-09-07",0,0,4,0,0,5,0,0
"Kenya","2024-09-08",110,1,5,110,0,5,110,110
"Kenya","2024-09-09",0,0,5,110,0,5,4,114
"Kenya","2024-09-10",0,0,5,110,0,5,4,118
"Kenya","2024-09-11",0,0,5,110,0,5,4,122
"Kenya","2024-09-12",0,0,5,110,1,6,4,126
"Kenya","2024-09-13",0,0,5,110,0,6,5,131
"Kenya","2024-09-14",0,0,5,110,0,6,4,135
"Kenya","2024-09-15",0,0,5,110,0,6,4,139
"Kenya","2024-09-16",0,0,5,110,0,6,4,143
"Kenya","2024-09-17",0,0,5,110,0,6,4,147
"Kenya","2024-09-18",0,0,5,110,1,7,4,151
"Kenya","2024-09-19",0,0,5,110,0,7,4,155
"Kenya","2024-09-20",0,0,5,110,0,7,4,159
"Kenya","2024-09-21",0,0,5,110,0,7,5,164
"Kenya","2024-09-22",0,0,5,110,0,7,4,168
"Kenya","2024-09-23",0,0,5,110,0,7,4,172
"Kenya","2024-09-24",0,0,5,110,0,7,4,176
"Kenya","2024-09-25",0,0,5,110,1,8,4,180
"Kenya","2024-09-26",0,0,5,110,0,8,4,184
"Kenya","2024-09-27",0,0,5,110,0,8,4,188
"Kenya","2024-09-28",0,3,8,110,0,8,4,192
"Kenya","2024-09-29",0,0,8,110,0,8,4,196
"Kenya","2024-09-30",0,0,8,110,1,9,5,201
"Kenya","2024-10-01",0,0,8,110,1,10,4,205
"Kenya","2024-10-02",0,0,8,110,0,10,4,209
"Kenya","2024-10-03",0,0,8,110,0,10,4,213
"Kenya","2024-10-04",107,0,8,217,1,11,4,217
"Kenya","2024-10-05",0,0,8,217,1,12,1,218
"Kenya","2024-10-06",0,4,12,217,0,12,1,219
"Kenya","2024-10-07",0,0,12,217,0,12,0,219
"Kenya","2024-10-08",0,0,12,217,0,12,1,220
"Kenya","2024-10-09",0,0,12,217,0,12,1,221
"Kenya","2024-10-10",0,0,12,217,1,13,1,222
"Kenya","2024-10-11",0,0,12,217,0,13,1,223
"Kenya","2024-10-12",0,0,12,217,0,13,0,223
"Kenya","2024-10-13",0,1,13,217,0,13,1,224
"Kenya","2024-10-14",8,0,13,225,0,13,1,225
"Kenya","2024-10-15",0,0,13,225,0,13,1,226
"Kenya","2024-10-16",0,0,13,225,0,13,1,227
"Kenya","2024-10-17",0,0,13,225,1,14,0,227
"Kenya","2024-10-18",0,0,13,225,0,14,1,228
"Kenya","2024-10-19",0,0,13,225,0,14,1,229
"Kenya","2024-10-20",5,1,14,230,0,14,1,230
"Kenya","2024-10-21",0,0,14,230,0,14,0,230
"Kenya","2024-10-22",0,0,14,230,0,14,0,230
"Kenya","2024-10-23",0,0,14,230,0,14,0,230
"Kenya","2024-10-24",0,0,14,230,1,15,0,230
"Kenya","2024-10-25",0,0,14,230,0,15,0,230
"Kenya","2024-10-26",0,0,14,230,0,15,0,230
"Kenya","2024-10-27",0,0,14,230,0,15,0,230
"Kenya","2024-10-28",0,0,14,230,0,15,0,230
"Kenya","2024-10-29",0,0,14,230,0,15,0,230
"Kenya","2024-10-30",0,0,14,230,0,15,0,230
"Kenya","2024-10-31",0,0,14,230,1,16,0,230
"Kenya","2024-11-01",0,0,14,230,0,16,0,230
"Kenya","2024-11-02",0,0,14,230,0,16,0,230
"Kenya","2024-11-03",0,0,14,230,0,16,0,230
"Kenya","2024-11-04",0,0,14,230,0,16,0,230
"Kenya","2024-11-05",0,0,14,230,0,16,0,230
"Kenya","2024-11-06",0,0,14,230,0,16,0,230
"Kenya","2024-11-07",0,0,14,230,1,17,0,230
"Kenya","2024-11-08",0,0,14,230,0,17,0,230
"Kenya","2024-11-09",0,0,14,230,0,17,0,230
"Kenya","2024-11-10",0,3,17,230,0,17,0,230
"Kenya","2024-11-11",0,0,17,230,0,17,0,230
"Kenya","2024-11-12",0,0,17,230,0,17,0,230
"Kenya","2024-11-13",0,0,17,230,0,17,0,230
"Kenya","2024-11-14",0,0,17,230,0,17,0,230
"Kenya","2024-11-15",0,0,17,230,0,17,0,230
"Kenya","2024-11-16",0,0,17,230,0,17,0,230
"Kenya","2024-11-17",0,0,17,230,0,17,0,230
"Kenya","2024-11-18",0,0,17,230,0,17,0,230
"Kenya","2024-11-19",0,0,17,230,0,17,0,230
"Kenya","2024-11-20",0,0,17,230,0,17,0,230
"Kenya","2024-11-21",0,0,17,230,0,17,0,230
"Kenya","2024-11-22",0,0,17,230,0,17,0,230
"Kenya","2024-11-23",0,0,17,230,0,17,0,230
"Kenya","2024-11-24",0,0,17,230,0,17,0,230
"Kenya","2024-11-25",0,0,17,230,0,17,0,230
"Kenya","2024-11-26",0,0,17,230,0,17,0,230
"Kenya","2024-11-27",0,0,17,230,0,17,0,230
"Kenya","2024-11-28",0,0,17,230,0,17,0,230
"Kenya","2024-11-29",0,0,17,230,0,17,0,230
"Kenya","2024-11-30",0,0,17,230,0,17,0,230
"Kenya","2024-12-01",0,0,17,230,0,17,0,230
"Kenya","2024-12-02",0,0,17,230,0,17,0,230
"Kenya","2024-12-03",0,0,17,230,0,17,0,230
"Kenya","2024-12-04",0,0,17,230,0,17,0,230
"Kenya","2024-12-05",0,0,17,230,0,17,0,230
"Kenya","2024-12-06",0,0,17,230,0,17,0,230
"Kenya","2024-12-07",0,0,17,230,0,17,0,230
"Kenya","2024-12-08",0,0,17,230,0,17,0,230
"Kenya","2024-12-09",0,0,17,230,0,17,0,230
"Latvia","2024-01-01",0,0,0,0,0,0,0,0
"Latvia","2024-01-02",0,0,0,0,0,0,0,0
"Latvia","2024-01-03",0,0,0,0,0,0,0,0
"Latvia","2024-01-04",0,0,0,0,0,0,0,0
"Latvia","2024-01-05",0,0,0,0,0,0,0,0
"Latvia","2024-01-06",0,0,0,0,0,0,0,0
"Latvia","2024-01-07",0,0,0,0,0,0,0,0
"Latvia","2024-01-08",0,0,0,0,0,0,0,0
"Latvia","2024-01-09",0,0,0,0,0,0,0,0
"Latvia","2024-01-10",0,0,0,0,0,0,0,0
"Latvia","2024-01-11",0,0,0,0,0,0,0,0
"Latvia","2024-01-12",0,0,0,0,0,0,0,0
"Latvia","2024-01-13",0,0,0,0,0,0,0,0
"Latvia","2024-01-14",0,0,0,0,0,0,0,0
"Latvia","2024-01-15",0,0,0,0,0,0,0,0
"Latvia","2024-01-16",0,0,0,0,0,0,0,0
"Latvia","2024-01-17",0,0,0,0,0,0,0,0
"Latvia","2024-01-18",0,0,0,0,0,0,0,0
"Latvia","2024-01-19",0,0,0,0,0,0,0,0
"Latvia","2024-01-20",0,0,0,0,0,0,0,0
"Latvia","2024-01-21",0,0,0,0,0,0,0,0
"Latvia","2024-01-22",0,0,0,0,0,0,0,0
"Latvia","2024-01-23",0,0,0,0,0,0,0,0
"Latvia","2024-01-24",0,0,0,0,0,0,0,0
"Latvia","2024-01-25",0,0,0,0,0,0,0,0
"Latvia","2024-01-26",0,0,0,0,0,0,0,0
"Latvia","2024-01-27",0,0,0,0,0,0,0,0
"Latvia","2024-01-28",0,0,0,0,0,0,0,0
"Latvia","2024-01-29",0,0,0,0,0,0,0,0
"Latvia","2024-01-30",0,0,0,0,0,0,0,0
"Latvia","2024-01-31",0,0,0,0,0,0,0,0
"Latvia","2024-02-01",0,0,0,0,0,0,0,0
"Latvia","2024-02-02",0,0,0,0,0,0,0,0
"Latvia","2024-02-03",0,0,0,0,0,0,0,0
"Latvia","2024-02-04",0,0,0,0,0,0,0,0
"Latvia","2024-02-05",0,0,0,0,0,0,0,0
"Latvia","2024-02-06",0,0,0,0,0,0,0,0
"Latvia","2024-02-07",0,0,0,0,0,0,0,0
"Latvia","2024-02-08",0,0,0,0,0,0,0,0
"Latvia","2024-02-09",0,0,0,0,0,0,0,0
"Latvia","2024-02-10",0,0,0,0,0,0,0,0
"Latvia","2024-02-11",0,0,0,0,0,0,0,0
"Latvia","2024-02-12",0,0,0,0,0,0,0,0
"Latvia","2024-02-13",0,0,0,0,0,0,0,0
"Latvia","2024-02-14",0,0,0,0,0,0,0,0
"Latvia","2024-02-15",0,0,0,0,0,0,0,0
"Latvia","2024-02-16",0,0,0,0,0,0,0,0
"Latvia","2024-02-17",0,0,0,0,0,0,0,0
"Latvia","2024-02-18",0,0,0,0,0,0,0,0
"Latvia","2024-02-19",0,0,0,0,0,0,0,0
"Latvia","2024-02-20",0,0,0,0,0,0,0,0
"Latvia","2024-02-21",0,0,0,0,0,0,0,0
"Latvia","2024-02-22",0,0,0,0,0,0,0,0
"Latvia","2024-02-23",0,0,0,0,0,0,0,0
"Latvia","2024-02-24",0,0,0,0,0,0,0,0
"Latvia","2024-02-25",0,0,0,0,0,0,0,0
"Latvia","2024-02-26",0,0,0,0,0,0,0,0
"Latvia","2024-02-27",0,0,0,0,0,0,0,0
"Latvia","2024-02-28",0,0,0,0,0,0,0,0
"Latvia","2024-02-29",0,0,0,0,0,0,0,0
"Latvia","2024-03-01",0,0,0,0,0,0,0,0
"Latvia","2024-03-02",0,0,0,0,0,0,0,0
"Latvia","2024-03-03",0,0,0,0,0,0,0,0
"Latvia","2024-03-04",0,0,0,0,0,0,0,0
"Latvia","2024-03-05",0,0,0,0,0,0,0,0
"Latvia","2024-03-06",0,0,0,0,0,0,0,0
"Latvia","2024-03-07",0,0,0,0,0,0,0,0
"Latvia","2024-03-08",0,0,0,0,0,0,0,0
"Latvia","2024-03-09",0,0,0,0,0,0,0,0
"Latvia","2024-03-10",0,0,0,0,0,0,0,0
"Latvia","2024-03-11",0,0,0,0,0,0,0,0
"Latvia","2024-03-12",0,0,0,0,0,0,0,0
"Latvia","2024-03-13",0,0,0,0,0,0,0,0
"Latvia","2024-03-14",0,0,0,0,0,0,0,0
"Latvia","2024-03-15",0,0,0,0,0,0,0,0
"Latvia","2024-03-16",0,0,0,0,0,0,0,0
"Latvia","2024-03-17",0,0,0,0,0,0,0,0
"Latvia","2024-03-18",0,0,0,0,0,0,0,0
"Latvia","2024-03-19",0,0,0,0,0,0,0,0
"Latvia","2024-03-20",0,0,0,0,0,0,0,0
"Latvia","2024-03-21",0,0,0,0,0,0,0,0
"Latvia","2024-03-22",0,0,0,0,0,0,0,0
"Latvia","2024-03-23",0,0,0,0,0,0,0,0
"Latvia","2024-03-24",0,0,0,0,0,0,0,0
"Latvia","2024-03-25",0,0,0,0,0,0,0,0
"Latvia","2024-03-26",0,0,0,0,0,0,0,0
"Latvia","2024-03-27",0,0,0,0,0,0,0,0
"Latvia","2024-03-28",0,0,0,0,0,0,0,0
"Latvia","2024-03-29",0,0,0,0,0,0,0,0
"Latvia","2024-03-30",0,0,0,0,0,0,0,0
"Latvia","2024-03-31",0,0,0,0,0,0,0,0
"Latvia","2024-04-01",0,0,0,0,0,0,0,0
"Latvia","2024-04-02",0,0,0,0,0,0,0,0
"Latvia","2024-04-03",0,0,0,0,0,0,0,0
"Latvia","2024-04-04",0,0,0,0,0,0,0,0
"Latvia","2024-04-05",0,0,0,0,0,0,0,0
"Latvia","2024-04-06",0,0,0,0,0,0,0,0
"Latvia","2024-04-07",0,0,0,0,0,0,0,0
"Latvia","2024-04-08",0,0,0,0,0,0,0,0
"Latvia","2024-04-09",0,0,0,0,0,0,0,0
"Latvia","2024-04-10",0,0,0,0,0,0,0,0
"Latvia","2024-04-11",0,0,0,0,0,0,0,0
"Latvia","2024-04-12",0,0,0,0,0,0,0,0
"Latvia","2024-04-13",0,0,0,0,0,0,0,0
"Latvia","2024-04-14",0,0,0,0,0,0,0,0
"Latvia","2024-04-15",0,0,0,0,0,0,0,0
"Latvia","2024-04-16",0,0,0,0,0,0,0,0
"Latvia","2024-04-17",0,0,0,0,0,0,0,0
"Latvia","2024-04-18",0,0,0,0,0,0,0,0
"Latvia","2024-04-19",0,0,0,0,0,0,0,0
"Latvia","2024-04-20",0,0,0,0,0,0,0,0
"Latvia","2024-04-21",0,0,0,0,0,0,0,0
"Latvia","2024-04-22",0,0,0,0,0,0,0,0
"Latvia","2024-04-23",0,0,0,0,0,0,0,0
"Latvia","2024-04-24",0,0,0,0,0,0,0,0
"Latvia","2024-04-25",0,0,0,0,0,0,0,0
"Latvia","2024-04-26",0,0,0,0,0,0,0,0
"Latvia","2024-04-27",0,0,0,0,0,0,0,0
"Latvia","2024-04-28",0,0,0,0,0,0,0,0
"Latvia","2024-04-29",0,0,0,0,0,0,0,0
"Latvia","2024-04-30",0,0,0,0,0,0,0,0
"Latvia","2024-05-01",0,0,0,0,0,0,0,0
"Latvia","2024-05-02",0,0,0,0,0,0,0,0
"Latvia","2024-05-03",0,0,0,0,0,0,0,0
"Latvia","2024-05-04",0,0,0,0,0,0,0,0
"Latvia","2024-05-05",0,0,0,0,0,0,0,0
"Latvia","2024-05-06",0,0,0,0,0,0,0,0
"Latvia","2024-05-07",0,0,0,0,0,0,0,0
"Latvia","2024-05-08",0,0,0,0,0,0,0,0
"Latvia","2024-05-09",0,0,0,0,0,0,0,0
"Latvia","2024-05-10",0,0,0,0,0,0,0,0
"Latvia","2024-05-11",0,0,0,0,0,0,0,0
"Latvia","2024-05-12",0,0,0,0,0,0,0,0
"Latvia","2024-05-13",0,0,0,0,0,0,0,0
"Latvia","2024-05-14",0,0,0,0,0,0,0,0
"Latvia","2024-05-15",0,0,0,0,0,0,0,0
"Latvia","2024-05-16",0,0,0,0,0,0,0,0
"Latvia","2024-05-17",0,0,0,0,0,0,0,0
"Latvia","2024-05-18",0,0,0,0,0,0,0,0
"Latvia","2024-05-19",0,0,0,0,0,0,0,0
"Latvia","2024-05-20",0,0,0,0,0,0,0,0
"Latvia","2024-05-21",0,0,0,0,0,0,0,0
"Latvia","2024-05-22",0,0,0,0,0,0,0,0
"Latvia","2024-05-23",0,0,0,0,0,0,0,0
"Latvia","2024-05-24",0,0,0,0,0,0,0,0
"Latvia","2024-05-25",0,0,0,0,0,0,0,0
"Latvia","2024-05-26",0,0,0,0,0,0,0,0
"Latvia","2024-05-27",0,0,0,0,0,0,0,0
"Latvia","2024-05-28",0,0,0,0,0,0,0,0
"Latvia","2024-05-29",0,0,0,0,0,0,0,0
"Latvia","2024-05-30",0,0,0,0,0,0,0,0
"Latvia","2024-05-31",0,0,0,0,0,0,0,0
"Latvia","2024-06-01",0,0,0,0,0,0,0,0
"Latvia","2024-06-02",0,0,0,0,0,0,0,0
"Latvia","2024-06-03",0,0,0,0,0,0,0,0
"Latvia","2024-06-04",0,0,0,0,0,0,0,0
"Latvia","2024-06-05",0,0,0,0,0,0,0,0
"Latvia","2024-06-06",0,0,0,0,0,0,0,0
"Latvia","2024-06-07",0,0,0,0,0,0,0,0
"Latvia","2024-06-08",0,0,0,0,0,0,0,0
"Latvia","2024-06-09",0,0,0,0,0,0,0,0
"Latvia","2024-06-10",0,0,0,0,0,0,0,0
"Latvia","2024-06-11",0,0,0,0,0,0,0,0
"Latvia","2024-06-12",0,0,0,0,0,0,0,0
"Latvia","2024-06-13",0,0,0,0,0,0,0,0
"Latvia","2024-06-14",0,0,0,0,0,0,0,0
"Latvia","2024-06-15",0,0,0,0,0,0,0,0
"Latvia","2024-06-16",0,0,0,0,0,0,0,0
"Latvia","2024-06-17",0,0,0,0,0,0,0,0
"Latvia","2024-06-18",0,0,0,0,0,0,0,0
"Latvia","2024-06-19",0,0,0,0,0,0,0,0
"Latvia","2024-06-20",0,0,0,0,0,0,0,0
"Latvia","2024-06-21",0,0,0,0,0,0,0,0
"Latvia","2024-06-22",0,0,0,0,0,0,0,0
"Latvia","2024-06-23",0,0,0,0,0,0,0,0
"Latvia","2024-06-24",0,0,0,0,0,0,0,0
"Latvia","2024-06-25",0,0,0,0,0,0,0,0
"Latvia","2024-06-26",0,0,0,0,0,0,0,0
"Latvia","2024-06-27",0,0,0,0,0,0,0,0
"Latvia","2024-06-28",0,0,0,0,0,0,0,0
"Latvia","2024-06-29",0,0,0,0,0,0,0,0
"Latvia","2024-06-30",0,0,0,0,0,0,0,0
"Latvia","2024-07-01",0,0,0,0,0,0,0,0
"Latvia","2024-07-02",0,0,0,0,0,0,0,0
"Latvia","2024-07-03",0,0,0,0,0,0,0,0
"Latvia","2024-07-04",0,0,0,0,0,0,0,0
"Latvia","2024-07-05",0,0,0,0,0,0,0,0
"Latvia","2024-07-06",0,0,0,0,0,0,0,0
"Latvia","2024-07-07",0,0,0,0,0,0,0,0
"Latvia","2024-07-08",0,0,0,0,0,0,0,0
"Latvia","2024-07-09",0,0,0,0,0,0,0,0
"Latvia","2024-07-10",0,0,0,0,0,0,0,0
"Latvia","2024-07-11",0,0,0,0,0,0,0,0
"Latvia","2024-07-12",0,0,0,0,0,0,0,0
"Latvia","2024-07-13",0,0,0,0,0,0,0,0
"Latvia","2024-07-14",0,0,0,0,0,0,0,0
"Latvia","2024-07-15",0,0,0,0,0,0,0,0
"Latvia","2024-07-16",0,0,0,0,0,0,0,0
"Latvia","2024-07-17",0,0,0,0,0,0,0,0
"Latvia","2024-07-18",0,0,0,0,0,0,0,0
"Latvia","2024-07-19",0,0,0,0,0,0,0,0
"Latvia","2024-07-20",0,0,0,0,0,0,0,0
"Latvia","2024-07-21",0,0,0,0,0,0,0,0
"Latvia","2024-07-22",0,0,0,0,0,0,0,0
"Latvia","2024-07-23",0,0,0,0,0,0,0,0
"Latvia","2024-07-24",0,0,0,0,0,0,0,0
"Latvia","2024-07-25",0,0,0,0,0,0,0,0
"Latvia","2024-07-26",0,0,0,0,0,0,0,0
"Latvia","2024-07-27",0,0,0,0,0,0,0,0
"Latvia","2024-07-28",0,0,0,0,0,0,0,0
"Latvia","2024-07-29",0,0,0,0,0,0,0,0
"Latvia","2024-07-30",0,0,0,0,0,0,0,0
"Latvia","2024-07-31",0,0,0,0,0,0,0,0
"Latvia","2024-08-01",0,0,0,0,0,0,0,0
"Latvia","2024-08-02",0,0,0,0,0,0,0,0
"Latvia","2024-08-03",0,0,0,0,0,0,0,0
"Latvia","2024-08-04",0,0,0,0,0,0,0,0
"Latvia","2024-08-05",0,0,0,0,0,0,0,0
"Latvia","2024-08-06",0,0,0,0,0,0,0,0
"Latvia","2024-08-07",0,0,0,0,0,0,0,0
"Latvia","2024-08-08",0,0,0,0,0,0,0,0
"Latvia","2024-08-09",0,0,0,0,0,0,0,0
"Latvia","2024-08-10",0,0,0,0,0,0,0,0
"Latvia","2024-08-11",0,0,0,0,0,0,0,0
"Latvia","2024-08-12",0,0,0,0,0,0,0,0
"Latvia","2024-08-13",0,0,0,0,0,0,0,0
"Latvia","2024-08-14",0,0,0,0,0,0,0,0
"Latvia","2024-08-15",0,0,0,0,0,0,0,0
"Latvia","2024-08-16",0,0,0,0,0,0,0,0
"Latvia","2024-08-17",0,0,0,0,0,0,0,0
"Latvia","2024-08-18",0,0,0,0,0,0,0,0
"Latvia","2024-08-19",0,0,0,0,0,0,0,0
"Latvia","2024-08-20",0,0,0,0,0,0,0,0
"Latvia","2024-08-21",0,0,0,0,0,0,0,0
"Latvia","2024-08-22",0,0,0,0,0,0,0,0
"Latvia","2024-08-23",0,0,0,0,0,0,0,0
"Latvia","2024-08-24",0,0,0,0,0,0,0,0
"Latvia","2024-08-25",0,0,0,0,0,0,0,0
"Latvia","2024-08-26",0,0,0,0,0,0,0,0
"Latvia","2024-08-27",0,0,0,0,0,0,0,0
"Latvia","2024-08-28",0,0,0,0,0,0,0,0
"Latvia","2024-08-29",0,0,0,0,0,0,0,0
"Latvia","2024-08-30",0,0,0,0,0,0,0,0
"Latvia","2024-08-31",0,0,0,0,0,0,0,0
"Latvia","2024-09-01",0,0,0,0,0,0,0,0
"Latvia","2024-09-02",0,0,0,0,0,0,0,0
"Latvia","2024-09-03",0,0,0,0,0,0,0,0
"Latvia","2024-09-04",0,0,0,0,0,0,0,0
"Latvia","2024-09-05",0,0,0,0,0,0,0,0
"Latvia","2024-09-06",0,0,0,0,0,0,0,0
"Latvia","2024-09-07",0,0,0,0,0,0,0,0
"Latvia","2024-09-08",0,0,0,0,0,0,0,0
"Latvia","2024-09-09",0,0,0,0,0,0,0,0
"Latvia","2024-09-10",0,0,0,0,0,0,0,0
"Latvia","2024-09-11",0,0,0,0,0,0,0,0
"Latvia","2024-09-12",0,0,0,0,0,0,0,0
"Latvia","2024-09-13",0,0,0,0,0,0,0,0
"Latvia","2024-09-14",0,0,0,0,0,0,0,0
"Latvia","2024-09-15",0,0,0,0,0,0,0,0
"Latvia","2024-09-16",0,0,0,0,0,0,0,0
"Latvia","2024-09-17",0,0,0,0,0,0,0,0
"Latvia","2024-09-18",0,0,0,0,0,0,0,0
"Latvia","2024-09-19",0,0,0,0,0,0,0,0
"Latvia","2024-09-20",0,0,0,0,0,0,0,0
"Latvia","2024-09-21",0,0,0,0,0,0,0,0
"Latvia","2024-09-22",0,0,0,0,0,0,0,0
"Latvia","2024-09-23",0,0,0,0,0,0,0,0
"Latvia","2024-09-24",0,0,0,0,0,0,0,0
"Latvia","2024-09-25",0,0,0,0,0,0,0,0
"Latvia","2024-09-26",0,0,0,0,0,0,0,0
"Latvia","2024-09-27",0,0,0,0,0,0,0,0
"Latvia","2024-09-28",0,0,0,0,0,0,0,0
"Latvia","2024-09-29",0,0,0,0,0,0,0,0
"Latvia","2024-09-30",0,0,0,0,0,0,0,0
"Latvia","2024-10-01",0,0,0,0,0,0,0,0
"Latvia","2024-10-02",0,0,0,0,0,0,0,0
"Latvia","2024-10-03",0,0,0,0,0,0,0,0
"Latvia","2024-10-04",0,0,0,0,0,0,0,0
"Latvia","2024-10-05",0,0,0,0,0,0,0,0
"Latvia","2024-10-06",0,0,0,0,0,0,0,0
"Latvia","2024-10-07",0,0,0,0,0,0,0,0
"Latvia","2024-10-08",0,0,0,0,0,0,0,0
"Latvia","2024-10-09",0,0,0,0,0,0,0,0
"Latvia","2024-10-10",0,0,0,0,0,0,0,0
"Latvia","2024-10-11",0,0,0,0,0,0,0,0
"Latvia","2024-10-12",0,0,0,0,0,0,0,0
"Latvia","2024-10-13",0,0,0,0,0,0,0,0
"Latvia","2024-10-14",0,0,0,0,0,0,0,0
"Latvia","2024-10-15",0,0,0,0,0,0,0,0
"Latvia","2024-10-16",0,0,0,0,0,0,0,0
"Latvia","2024-10-17",0,0,0,0,0,0,0,0
"Latvia","2024-10-18",0,0,0,0,0,0,0,0
"Latvia","2024-10-19",0,0,0,0,0,0,0,0
"Latvia","2024-10-20",0,0,0,0,0,0,0,0
"Latvia","2024-10-21",0,0,0,0,0,0,0,0
"Latvia","2024-10-22",0,0,0,0,0,0,0,0
"Latvia","2024-10-23",0,0,0,0,0,0,0,0
"Latvia","2024-10-24",0,0,0,0,0,0,0,0
"Latvia","2024-10-25",0,0,0,0,0,0,0,0
"Latvia","2024-10-26",0,0,0,0,0,0,0,0
"Latvia","2024-10-27",0,0,0,0,0,0,0,0
"Latvia","2024-10-28",0,0,0,0,0,0,0,0
"Latvia","2024-10-29",0,0,0,0,0,0,0,0
"Latvia","2024-10-30",0,0,0,0,0,0,0,0
"Latvia","2024-10-31",0,0,0,0,0,0,0,0
"Latvia","2024-11-01",0,0,0,0,0,0,0,0
"Latvia","2024-11-02",0,0,0,0,0,0,0,0
"Latvia","2024-11-03",0,0,0,0,0,0,0,0
"Latvia","2024-11-04",0,0,0,0,0,0,0,0
"Latvia","2024-11-05",0,0,0,0,0,0,0,0
"Latvia","2024-11-06",0,0,0,0,0,0,0,0
"Latvia","2024-11-07",0,0,0,0,0,0,0,0
"Latvia","2024-11-08",0,0,0,0,0,0,0,0
"Latvia","2024-11-09",0,0,0,0,0,0,0,0
"Latvia","2024-11-10",0,0,0,0,0,0,0,0
"Latvia","2024-11-11",0,0,0,0,0,0,0,0
"Latvia","2024-11-12",0,0,0,0,0,0,0,0
"Latvia","2024-11-13",0,0,0,0,0,0,0,0
"Latvia","2024-11-14",0,0,0,0,0,0,0,0
"Latvia","2024-11-15",0,0,0,0,0,0,0,0
"Latvia","2024-11-16",0,0,0,0,0,0,0,0
"Latvia","2024-11-17",0,0,0,0,0,0,0,0
"Latvia","2024-11-18",0,0,0,0,0,0,0,0
"Latvia","2024-11-19",0,0,0,0,0,0,0,0
"Latvia","2024-11-20",0,0,0,0,0,0,0,0
"Latvia","2024-11-21",0,0,0,0,0,0,0,0
"Latvia","2024-11-22",0,0,0,0,0,0,0,0
"Latvia","2024-11-23",0,0,0,0,0,0,0,0
"Latvia","2024-11-24",0,0,0,0,0,0,0,0
"Latvia","2024-11-25",0,0,0,0,0,0,0,0
"Latvia","2024-11-26",0,0,0,0,0,0,0,0
"Latvia","2024-11-27",0,0,0,0,0,0,0,0
"Latvia","2024-11-28",0,0,0,0,0,0,0,0
"Latvia","2024-11-29",0,0,0,0,0,0,0,0
"Latvia","2024-11-30",0,0,0,0,0,0,0,0
"Latvia","2024-12-01",0,0,0,0,0,0,0,0
"Latvia","2024-12-02",0,0,0,0,0,0,0,0
"Latvia","2024-12-03",0,0,0,0,0,0,0,0
"Latvia","2024-12-04",0,0,0,0,0,0,0,0
"Latvia","2024-12-05",0,0,0,0,0,0,0,0
"Latvia","2024-12-06",0,0,0,0,0,0,0,0
"Latvia","2024-12-07",0,0,0,0,0,0,0,0
"Latvia","2024-12-08",0,0,0,0,0,0,0,0
"Latvia","2024-12-09",0,0,0,0,0,0,0,0
"Liberia","2024-01-01",0,0,0,0,0,0,0,0
"Liberia","2024-01-02",0,0,0,0,0,0,0,0
"Liberia","2024-01-03",0,0,0,0,0,0,0,0
"Liberia","2024-01-04",0,0,0,0,0,0,0,0
"Liberia","2024-01-05",0,0,0,0,0,0,0,0
"Liberia","2024-01-06",0,0,0,0,0,0,0,0
"Liberia","2024-01-07",0,0,0,0,0,0,0,0
"Liberia","2024-01-08",0,0,0,0,0,0,0,0
"Liberia","2024-01-09",0,0,0,0,0,0,0,0
"Liberia","2024-01-10",0,0,0,0,0,0,0,0
"Liberia","2024-01-11",0,0,0,0,0,0,0,0
"Liberia","2024-01-12",0,0,0,0,0,0,0,0
"Liberia","2024-01-13",0,0,0,0,0,0,0,0
"Liberia","2024-01-14",0,1,1,0,1,1,0,0
"Liberia","2024-01-15",0,0,1,0,0,1,0,0
"Liberia","2024-01-16",0,0,1,0,0,1,0,0
"Liberia","2024-01-17",0,0,1,0,0,1,0,0
"Liberia","2024-01-18",0,0,1,0,0,1,0,0
"Liberia","2024-01-19",0,0,1,0,0,1,0,0
"Liberia","2024-01-20",0,0,1,0,0,1,0,0
"Liberia","2024-01-21",0,0,1,0,0,1,0,0
"Liberia","2024-01-22",0,0,1,0,0,1,0,0
"Liberia","2024-01-23",0,0,1,0,0,1,0,0
"Liberia","2024-01-24",0,0,1,0,0,1,0,0
"Liberia","2024-01-25",0,0,1,0,1,2,0,0
"Liberia","2024-01-26",0,0,1,0,0,2,0,0
"Liberia","2024-01-27",0,0,1,0,0,2,0,0
"Liberia","2024-01-28",0,0,1,0,0,2,0,0
"Liberia","2024-01-29",0,0,1,0,0,2,0,0
"Liberia","2024-01-30",0,0,1,0,0,2,0,0
"Liberia","2024-01-31",0,0,1,0,0,2,0,0
"Liberia","2024-02-01",0,0,1,0,0,2,0,0
"Liberia","2024-02-02",0,0,1,0,0,2,0,0
"Liberia","2024-02-03",0,0,1,0,0,2,0,0
"Liberia","2024-02-04",0,1,2,0,0,2,0,0
"Liberia","2024-02-05",0,0,2,0,0,2,0,0
"Liberia","2024-02-06",0,0,2,0,0,2,0,0
"Liberia","2024-02-07",0,0,2,0,0,2,0,0
"Liberia","2024-02-08",0,0,2,0,0,2,0,0
"Liberia","2024-02-09",0,0,2,0,0,2,0,0
"Liberia","2024-02-10",0,0,2,0,0,2,0,0
"Liberia","2024-02-11",0,0,2,0,0,2,0,0
"Liberia","2024-02-12",0,0,2,0,1,3,0,0
"Liberia","2024-02-13",0,0,2,0,0,3,0,0
"Liberia","2024-02-14",0,0,2,0,0,3,0,0
"Liberia","2024-02-15",0,0,2,0,0,3,0,0
"Liberia","2024-02-16",0,0,2,0,0,3,0,0
"Liberia","2024-02-17",0,0,2,0,0,3,0,0
"Liberia","2024-02-18",0,1,3,0,0,3,0,0
"Liberia","2024-02-19",0,0,3,0,0,3,0,0
"Liberia","2024-02-20",0,0,3,0,0,3,0,0
"Liberia","2024-02-21",0,0,3,0,0,3,0,0
"Liberia","2024-02-22",0,0,3,0,0,3,0,0
"Liberia","2024-02-23",0,0,3,0,0,3,0,0
"Liberia","2024-02-24",0,0,3,0,0,3,0,0
"Liberia","2024-02-25",0,0,3,0,0,3,0,0
"Liberia","2024-02-26",0,0,3,0,0,3,0,0
"Liberia","2024-02-27",0,0,3,0,0,3,0,0
"Liberia","2024-02-28",0,0,3,0,0,3,0,0
"Liberia","2024-02-29",0,0,3,0,1,4,0,0
"Liberia","2024-03-01",0,0,3,0,0,4,0,0
"Liberia","2024-03-02",0,0,3,0,0,4,0,0
"Liberia","2024-03-03",0,0,3,0,0,4,0,0
"Liberia","2024-03-04",0,0,3,0,0,4,0,0
"Liberia","2024-03-05",0,0,3,0,0,4,0,0
"Liberia","2024-03-06",0,0,3,0,0,4,0,0
"Liberia","2024-03-07",0,0,3,0,0,4,0,0
"Liberia","2024-03-08",0,0,3,0,0,4,0,0
"Liberia","2024-03-09",0,0,3,0,0,4,0,0
"Liberia","2024-03-10",0,1,4,0,0,4,0,0
"Liberia","2024-03-11",0,0,4,0,0,4,0,0
"Liberia","2024-03-12",0,0,4,0,0,4,0,0
"Liberia","2024-03-13",0,0,4,0,0,4,0,0
"Liberia","2024-03-14",0,0,4,0,0,4,0,0
"Liberia","2024-03-15",0,0,4,0,0,4,0,0
"Liberia","2024-03-16",0,0,4,0,0,4,0,0
"Liberia","2024-03-17",0,0,4,0,0,4,0,0
"Liberia","2024-03-18",0,0,4,0,0,4,0,0
"Liberia","2024-03-19",0,0,4,0,0,4,0,0
"Liberia","2024-03-20",0,0,4,0,0,4,0,0
"Liberia","2024-03-21",0,0,4,0,1,5,0,0
"Liberia","2024-03-22",0,0,4,0,0,5,0,0
"Liberia","2024-03-23",0,0,4,0,0,5,0,0
"Liberia","2024-03-24",0,0,4,0,0,5,0,0
"Liberia","2024-03-25",0,0,4,0,0,5,0,0
"Liberia","2024-03-26",0,0,4,0,0,5,0,0
"Liberia","2024-03-27",0,0,4,0,0,5,0,0
"Liberia","2024-03-28",0,0,4,0,0,5,0,0
"Liberia","2024-03-29",0,0,4,0,0,5,0,0
"Liberia","2024-03-30",0,0,4,0,0,5,0,0
"Liberia","2024-03-31",0,1,5,0,0,5,0,0
"Liberia","2024-04-01",0,0,5,0,0,5,0,0
"Liberia","2024-04-02",0,0,5,0,0,5,0,0
"Liberia","2024-04-03",0,0,5,0,0,5,0,0
"Liberia","2024-04-04",0,0,5,0,0,5,0,0
"Liberia","2024-04-05",0,0,5,0,0,5,0,0
"Liberia","2024-04-06",0,0,5,0,0,5,0,0
"Liberia","2024-04-07",0,0,5,0,0,5,0,0
"Liberia","2024-04-08",0,0,5,0,0,5,0,0
"Liberia","2024-04-09",0,0,5,0,0,5,0,0
"Liberia","2024-04-10",0,0,5,0,0,5,0,0
"Liberia","2024-04-11",0,0,5,0,0,5,0,0
"Liberia","2024-04-12",0,0,5,0,0,5,0,0
"Liberia","2024-04-13",0,0,5,0,0,5,0,0
"Liberia","2024-04-14",0,0,5,0,0,5,0,0
"Liberia","2024-04-15",0,0,5,0,0,5,0,0
"Liberia","2024-04-16",0,0,5,0,0,5,0,0
"Liberia","2024-04-17",0,0,5,0,0,5,0,0
"Liberia","2024-04-18",0,0,5,0,0,5,0,0
"Liberia","2024-04-19",0,0,5,0,0,5,0,0
"Liberia","2024-04-20",0,0,5,0,0,5,0,0
"Liberia","2024-04-21",0,0,5,0,0,5,0,0
"Liberia","2024-04-22",0,0,5,0,0,5,0,0
"Liberia","2024-04-23",0,0,5,0,0,5,0,0
"Liberia","2024-04-24",0,0,5,0,0,5,0,0
"Liberia","2024-04-25",0,0,5,0,0,5,0,0
"Liberia","2024-04-26",0,0,5,0,0,5,0,0
"Liberia","2024-04-27",0,0,5,0,0,5,0,0
"Liberia","2024-04-28",0,0,5,0,0,5,0,0
"Liberia","2024-04-29",0,0,5,0,0,5,0,0
"Liberia","2024-04-30",0,0,5,0,0,5,0,0
"Liberia","2024-05-01",0,0,5,0,0,5,0,0
"Liberia","2024-05-02",0,0,5,0,0,5,0,0
"Liberia","2024-05-03",0,0,5,0,0,5,0,0
"Liberia","2024-05-04",0,0,5,0,0,5,0,0
"Liberia","2024-05-05",0,0,5,0,0,5,0,0
"Liberia","2024-05-06",0,0,5,0,0,5,0,0
"Liberia","2024-05-07",0,0,5,0,0,5,0,0
"Liberia","2024-05-08",0,0,5,0,0,5,0,0
"Liberia","2024-05-09",0,0,5,0,0,5,0,0
"Liberia","2024-05-10",0,0,5,0,0,5,0,0
"Liberia","2024-05-11",0,0,5,0,0,5,0,0
"Liberia","2024-05-12",0,0,5,0,0,5,0,0
"Liberia","2024-05-13",0,0,5,0,0,5,0,0
"Liberia","2024-05-14",0,0,5,0,0,5,0,0
"Liberia","2024-05-15",0,0,5,0,0,5,0,0
"Liberia","2024-05-16",0,0,5,0,0,5,0,0
"Liberia","2024-05-17",0,0,5,0,0,5,0,0
"Liberia","2024-05-18",0,0,5,0,0,5,0,0
"Liberia","2024-05-19",0,0,5,0,0,5,0,0
"Liberia","2024-05-20",0,0,5,0,0,5,0,0
"Liberia","2024-05-21",0,0,5,0,0,5,0,0
"Liberia","2024-05-22",0,0,5,0,0,5,0,0
"Liberia","2024-05-23",0,0,5,0,0,5,0,0
"Liberia","2024-05-24",0,0,5,0,0,5,0,0
"Liberia","2024-05-25",0,0,5,0,0,5,0,0
"Liberia","2024-05-26",0,0,5,0,0,5,0,0
"Liberia","2024-05-27",0,0,5,0,0,5,0,0
"Liberia","2024-05-28",0,0,5,0,0,5,0,0
"Liberia","2024-05-29",0,0,5,0,0,5,0,0
"Liberia","2024-05-30",0,0,5,0,0,5,0,0
"Liberia","2024-05-31",0,0,5,0,0,5,0,0
"Liberia","2024-06-01",0,0,5,0,0,5,0,0
"Liberia","2024-06-02",0,0,5,0,0,5,0,0
"Liberia","2024-06-03",0,0,5,0,0,5,0,0
"Liberia","2024-06-04",0,0,5,0,0,5,0,0
"Liberia","2024-06-05",0,0,5,0,0,5,0,0
"Liberia","2024-06-06",0,0,5,0,1,6,0,0
"Liberia","2024-06-07",0,0,5,0,0,6,0,0
"Liberia","2024-06-08",0,0,5,0,0,6,0,0
"Liberia","2024-06-09",0,0,5,0,0,6,0,0
"Liberia","2024-06-10",0,0,5,0,0,6,0,0
"Liberia","2024-06-11",0,0,5,0,0,6,0,0
"Liberia","2024-06-12",0,0,5,0,0,6,0,0
"Liberia","2024-06-13",0,0,5,0,0,6,0,0
"Liberia","2024-06-14",0,0,5,0,0,6,0,0
"Liberia","2024-06-15",0,0,5,0,0,6,0,0
"Liberia","2024-06-16",0,0,5,0,0,6,0,0
"Liberia","2024-06-17",0,0,5,0,0,6,0,0
"Liberia","2024-06-18",0,0,5,0,0,6,0,0
"Liberia","2024-06-19",0,0,5,0,0,6,0,0
"Liberia","2024-06-20",0,0,5,0,0,6,0,0
"Liberia","2024-06-21",0,0,5,0,0,6,0,0
"Liberia","2024-06-22",0,0,5,0,0,6,0,0
"Liberia","2024-06-23",0,0,5,0,0,6,0,0
"Liberia","2024-06-24",0,0,5,0,0,6,0,0
"Liberia","2024-06-25",0,0,5,0,0,6,0,0
"Liberia","2024-06-26",0,0,5,0,0,6,0,0
"Liberia","2024-06-27",0,0,5,0,0,6,0,0
"Liberia","2024-06-28",0,0,5,0,0,6,0,0
"Liberia","2024-06-29",0,0,5,0,0,6,0,0
"Liberia","2024-06-30",0,0,5,0,0,6,0,0
"Liberia","2024-07-01",0,0,5,0,0,6,0,0
"Liberia","2024-07-02",0,0,5,0,0,6,0,0
"Liberia","2024-07-03",0,0,5,0,0,6,0,0
"Liberia","2024-07-04",0,0,5,0,0,6,0,0
"Liberia","2024-07-05",0,0,5,0,0,6,0,0
"Liberia","2024-07-06",0,0,5,0,0,6,0,0
"Liberia","2024-07-07",0,0,5,0,0,6,0,0
"Liberia","2024-07-08",0,0,5,0,0,6,0,0
"Liberia","2024-07-09",0,0,5,0,0,6,0,0
"Liberia","2024-07-10",0,0,5,0,0,6,0,0
"Liberia","2024-07-11",0,0,5,0,0,6,0,0
"Liberia","2024-07-12",0,0,5,0,0,6,0,0
"Liberia","2024-07-13",0,0,5,0,0,6,0,0
"Liberia","2024-07-14",0,0,5,0,0,6,0,0
"Liberia","2024-07-15",0,0,5,0,0,6,0,0
"Liberia","2024-07-16",0,0,5,0,0,6,0,0
"Liberia","2024-07-17",0,0,5,0,0,6,0,0
"Liberia","2024-07-18",0,0,5,0,0,6,0,0
"Liberia","2024-07-19",0,0,5,0,0,6,0,0
"Liberia","2024-07-20",0,0,5,0,0,6,0,0
"Liberia","2024-07-21",0,0,5,0,0,6,0,0
"Liberia","2024-07-22",0,0,5,0,0,6,0,0
"Liberia","2024-07-23",0,0,5,0,0,6,0,0
"Liberia","2024-07-24",0,0,5,0,0,6,0,0
"Liberia","2024-07-25",0,0,5,0,0,6,0,0
"Liberia","2024-07-26",0,0,5,0,0,6,0,0
"Liberia","2024-07-27",0,0,5,0,0,6,0,0
"Liberia","2024-07-28",0,0,5,0,0,6,0,0
"Liberia","2024-07-29",0,0,5,0,0,6,0,0
"Liberia","2024-07-30",0,0,5,0,0,6,0,0
"Liberia","2024-07-31",0,0,5,0,0,6,0,0
"Liberia","2024-08-01",0,0,5,0,0,6,0,0
"Liberia","2024-08-02",0,0,5,0,0,6,0,0
"Liberia","2024-08-03",0,0,5,0,0,6,0,0
"Liberia","2024-08-04",0,0,5,0,0,6,0,0
"Liberia","2024-08-05",0,0,5,0,0,6,0,0
"Liberia","2024-08-06",0,0,5,0,0,6,0,0
"Liberia","2024-08-07",0,0,5,0,0,6,0,0
"Liberia","2024-08-08",0,0,5,0,0,6,0,0
"Liberia","2024-08-09",0,0,5,0,0,6,0,0
"Liberia","2024-08-10",0,0,5,0,0,6,0,0
"Liberia","2024-08-11",0,1,6,0,0,6,0,0
"Liberia","2024-08-12",0,0,6,0,0,6,0,0
"Liberia","2024-08-13",0,0,6,0,0,6,0,0
"Liberia","2024-08-14",0,0,6,0,0,6,0,0
"Liberia","2024-08-15",0,0,6,0,0,6,0,0
"Liberia","2024-08-16",0,0,6,0,0,6,0,0
"Liberia","2024-08-17",0,0,6,0,0,6,0,0
"Liberia","2024-08-18",0,0,6,0,0,6,0,0
"Liberia","2024-08-19",0,0,6,0,0,6,0,0
"Liberia","2024-08-20",0,0,6,0,0,6,0,0
"Liberia","2024-08-21",0,0,6,0,0,6,0,0
"Liberia","2024-08-22",0,0,6,0,1,7,0,0
"Liberia","2024-08-23",0,0,6,0,0,7,0,0
"Liberia","2024-08-24",0,0,6,0,0,7,0,0
"Liberia","2024-08-25",0,0,6,0,0,7,0,0
"Liberia","2024-08-26",0,0,6,0,0,7,0,0
"Liberia","2024-08-27",0,0,6,0,0,7,0,0
"Liberia","2024-08-28",0,0,6,0,0,7,0,0
"Liberia","2024-08-29",0,0,6,0,0,7,0,0
"Liberia","2024-08-30",0,0,6,0,0,7,0,0
"Liberia","2024-08-31",0,0,6,0,0,7,0,0
"Liberia","2024-09-01",0,1,7,0,0,7,0,0
"Liberia","2024-09-02",0,0,7,0,0,7,0,0
"Liberia","2024-09-03",0,0,7,0,1,8,0,0
"Liberia","2024-09-04",0,0,7,0,0,8,0,0
"Liberia","2024-09-05",0,0,7,0,0,8,0,0
"Liberia","2024-09-06",0,0,7,0,0,8,0,0
"Liberia","2024-09-07",0,0,7,0,1,9,0,0
"Liberia","2024-09-08",85,2,9,85,0,9,85,85
"Liberia","2024-09-09",0,0,9,85,0,9,6,91
"Liberia","2024-09-10",0,0,9,85,1,10,5,96
"Liberia","2024-09-11",0,0,9,85,0,10,6,102
"Liberia","2024-09-12",0,0,9,85,1,11,6,108
"Liberia","2024-09-13",0,0,9,85,0,11,5,113
"Liberia","2024-09-14",0,0,9,85,1,12,6,119
"Liberia","2024-09-15",0,3,12,85,0,12,6,125
"Liberia","2024-09-16",0,0,12,85,0,12,5,130
"Liberia","2024-09-17",0,0,12,85,0,12,6,136
"Liberia","2024-09-18",0,0,12,85,0,12,5,141
"Liberia","2024-09-19",0,0,12,85,1,13,6,147
"Liberia","2024-09-20",0,0,12,85,0,13,6,153
"Liberia","2024-09-21",0,0,12,85,0,13,5,158
"Liberia","2024-09-22",79,0,12,164,0,13,6,164
"Liberia","2024-09-23",0,0,12,164,0,13,1,165
"Liberia","2024-09-24",0,0,12,164,0,13,1,166
"Liberia","2024-09-25",0,0,12,164,0,13,0,166
"Liberia","2024-09-26",0,0,12,164,1,14,1,167
"Liberia","2024-09-27",0,0,12,164,0,14,1,168
"Liberia","2024-09-28",0,0,12,164,0,14,1,169
"Liberia","2024-09-29",0,2,14,164,0,14,1,170
"Liberia","2024-09-30",0,0,14,164,0,14,1,171
"Liberia","2024-10-01",0,0,14,164,1,15,0,171
"Liberia","2024-10-02",0,0,14,164,0,15,1,172
"Liberia","2024-10-03",0,0,14,164,0,15,1,173
"Liberia","2024-10-04",0,0,14,164,0,15,1,174
"Liberia","2024-10-05",0,0,14,164,1,16,1,175
"Liberia","2024-10-06",0,0,14,164,0,16,1,176
"Liberia","2024-10-07",0,0,14,164,0,16,0,176
"Liberia","2024-10-08",0,0,14,164,1,17,1,177
"Liberia","2024-10-09",0,0,14,164,0,17,1,178
"Liberia","2024-10-10",0,0,14,164,0,17,1,179
"Liberia","2024-10-11",0,0,14,164,0,17,1,180
"Liberia","2024-10-12",0,0,14,164,1,18,0,180
"Liberia","2024-10-13",0,4,18,164,0,18,1,181
"Liberia","2024-10-14",0,0,18,164,0,18,1,182
"Liberia","2024-10-15",0,0,18,164,0,18,1,183
"Liberia","2024-10-16",0,0,18,164,0,18,1,184
"Liberia","2024-10-17",0,0,18,164,1,19,1,185
"Liberia","2024-10-18",0,0,18,164,0,19,0,185
"Liberia","2024-10-19",0,0,18,164,0,19,1,186
"Liberia","2024-10-20",23,1,19,187,0,19,1,187
"Liberia","2024-10-21",47,0,19,234,0,19,47,234
"Liberia","2024-10-22",0,0,19,234,0,19,1,235
"Liberia","2024-10-23",0,0,19,234,0,19,2,237
"Liberia","2024-10-24",0,0,19,234,1,20,1,238
"Liberia","2024-10-25",0,0,19,234,0,20,1,239
"Liberia","2024-10-26",0,0,19,234,0,20,2,241
"Liberia","2024-10-27",0,1,20,234,0,20,1,242
"Liberia","2024-10-28",0,0,20,234,0,20,1,243
"Liberia","2024-10-29",0,0,20,234,1,21,1,244
"Liberia","2024-10-30",0,0,20,234,0,21,2,246
"Liberia","2024-10-31",0,0,20,234,1,22,1,247
"Liberia","2024-11-01",0,0,20,234,0,22,1,248
"Liberia","2024-11-02",0,0,20,234,1,23,2,250
"Liberia","2024-11-03",17,3,23,251,0,23,1,251
"Liberia","2024-11-04",0,0,23,251,2,25,2,253
"Liberia","2024-11-05",0,0,23,251,2,27,3,256
"Liberia","2024-11-06",0,6,29,251,2,29,2,258
"Liberia","2024-11-07",0,0,29,251,0,29,2,260
"Liberia","2024-11-08",0,0,29,251,0,29,3,263
"Liberia","2024-11-09",0,0,29,251,0,29,2,265
"Liberia","2024-11-10",0,0,29,251,0,29,2,267
"Liberia","2024-11-11",0,0,29,251,0,29,2,269
"Liberia","2024-11-12",0,0,29,251,0,29,3,272
"Liberia","2024-11-13",23,0,29,274,0,29,2,274
"Liberia","2024-11-14",0,0,29,274,0,29,0,274
"Liberia","2024-11-15",0,0,29,274,0,29,0,274
"Liberia","2024-11-16",0,0,29,274,0,29,0,274
"Liberia","2024-11-17",0,0,29,274,0,29,0,274
"Liberia","2024-11-18",0,0,29,274,0,29,0,274
"Liberia","2024-11-19",0,0,29,274,0,29,0,274
"Liberia","2024-11-20",0,0,29,274,0,29,0,274
"Liberia","2024-11-21",0,0,29,274,0,29,0,274
"Liberia","2024-11-22",0,0,29,274,0,29,0,274
"Liberia","2024-11-23",0,0,29,274,0,29,0,274
"Liberia","2024-11-24",0,0,29,274,0,29,0,274
"Liberia","2024-11-25",0,0,29,274,0,29,0,274
"Liberia","2024-11-26",0,0,29,274,0,29,0,274
"Liberia","2024-11-27",0,0,29,274,0,29,0,274
"Liberia","2024-11-28",0,0,29,274,0,29,0,274
"Liberia","2024-11-29",0,0,29,274,0,29,0,274
"Liberia","2024-11-30",0,0,29,274,0,29,0,274
"Liberia","2024-12-01",0,0,29,274,0,29,0,274
"Liberia","2024-12-02",0,0,29,274,0,29,0,274
"Liberia","2024-12-03",0,0,29,274,0,29,0,274
"Liberia","2024-12-04",0,0,29,274,0,29,0,274
"Liberia","2024-12-05",0,0,29,274,0,29,0,274
"Liberia","2024-12-06",0,0,29,274,0,29,0,274
"Liberia","2024-12-07",0,0,29,274,0,29,0,274
"Liberia","2024-12-08",0,0,29,274,0,29,0,274
"Liberia","2024-12-09",0,0,29,274,0,29,0,274
"Lithuania","2024-01-01",0,0,0,0,0,0,0,0
"Lithuania","2024-01-02",0,0,0,0,0,0,0,0
"Lithuania","2024-01-03",0,0,0,0,0,0,0,0
"Lithuania","2024-01-04",0,0,0,0,0,0,0,0
"Lithuania","2024-01-05",0,0,0,0,0,0,0,0
"Lithuania","2024-01-06",0,0,0,0,0,0,0,0
"Lithuania","2024-01-07",0,0,0,0,0,0,0,0
"Lithuania","2024-01-08",0,0,0,0,0,0,0,0
"Lithuania","2024-01-09",0,0,0,0,0,0,0,0
"Lithuania","2024-01-10",0,0,0,0,0,0,0,0
"Lithuania","2024-01-11",0,0,0,0,0,0,0,0
"Lithuania","2024-01-12",0,0,0,0,0,0,0,0
"Lithuania","2024-01-13",0,0,0,0,0,0,0,0
"Lithuania","2024-01-14",0,0,0,0,0,0,0,0
"Lithuania","2024-01-15",0,0,0,0,0,0,0,0
"Lithuania","2024-01-16",0,0,0,0,0,0,0,0
"Lithuania","2024-01-17",0,0,0,0,0,0,0,0
"Lithuania","2024-01-18",0,0,0,0,0,0,0,0
"Lithuania","2024-01-19",0,0,0,0,0,0,0,0
"Lithuania","2024-01-20",0,0,0,0,0,0,0,0
"Lithuania","2024-01-21",0,0,0,0,0,0,0,0
"Lithuania","2024-01-22",0,0,0,0,0,0,0,0
"Lithuania","2024-01-23",0,0,0,0,0,0,0,0
"Lithuania","2024-01-24",0,0,0,0,0,0,0,0
"Lithuania","2024-01-25",0,0,0,0,0,0,0,0
"Lithuania","2024-01-26",0,0,0,0,0,0,0,0
"Lithuania","2024-01-27",0,0,0,0,0,0,0,0
"Lithuania","2024-01-28",0,0,0,0,0,0,0,0
"Lithuania","2024-01-29",0,0,0,0,0,0,0,0
"Lithuania","2024-01-30",0,0,0,0,0,0,0,0
"Lithuania","2024-01-31",0,0,0,0,0,0,0,0
"Lithuania","2024-02-01",0,0,0,0,0,0,0,0
"Lithuania","2024-02-02",0,0,0,0,0,0,0,0
"Lithuania","2024-02-03",0,0,0,0,0,0,0,0
"Lithuania","2024-02-04",0,0,0,0,0,0,0,0
"Lithuania","2024-02-05",0,0,0,0,0,0,0,0
"Lithuania","2024-02-06",0,0,0,0,0,0,0,0
"Lithuania","2024-02-07",0,0,0,0,0,0,0,0
"Lithuania","2024-02-08",0,0,0,0,0,0,0,0
"Lithuania","2024-02-09",0,0,0,0,0,0,0,0
"Lithuania","2024-02-10",0,0,0,0,0,0,0,0
"Lithuania","2024-02-11",0,0,0,0,0,0,0,0
"Lithuania","2024-02-12",0,0,0,0,0,0,0,0
"Lithuania","2024-02-13",0,0,0,0,0,0,0,0
"Lithuania","2024-02-14",0,0,0,0,0,0,0,0
"Lithuania","2024-02-15",0,0,0,0,0,0,0,0
"Lithuania","2024-02-16",0,0,0,0,0,0,0,0
"Lithuania","2024-02-17",0,0,0,0,0,0,0,0
"Lithuania","2024-02-18",0,0,0,0,0,0,0,0
"Lithuania","2024-02-19",0,0,0,0,0,0,0,0
"Lithuania","2024-02-20",0,0,0,0,0,0,0,0
"Lithuania","2024-02-21",0,0,0,0,0,0,0,0
"Lithuania","2024-02-22",0,0,0,0,0,0,0,0
"Lithuania","2024-02-23",0,0,0,0,0,0,0,0
"Lithuania","2024-02-24",0,0,0,0,0,0,0,0
"Lithuania","2024-02-25",0,0,0,0,0,0,0,0
"Lithuania","2024-02-26",0,0,0,0,0,0,0,0
"Lithuania","2024-02-27",0,0,0,0,0,0,0,0
"Lithuania","2024-02-28",0,0,0,0,0,0,0,0
"Lithuania","2024-02-29",0,0,0,0,0,0,0,0
"Lithuania","2024-03-01",0,0,0,0,0,0,0,0
"Lithuania","2024-03-02",0,0,0,0,0,0,0,0
"Lithuania","2024-03-03",0,0,0,0,0,0,0,0
"Lithuania","2024-03-04",0,0,0,0,0,0,0,0
"Lithuania","2024-03-05",0,0,0,0,0,0,0,0
"Lithuania","2024-03-06",0,0,0,0,0,0,0,0
"Lithuania","2024-03-07",0,0,0,0,0,0,0,0
"Lithuania","2024-03-08",0,0,0,0,0,0,0,0
"Lithuania","2024-03-09",0,0,0,0,0,0,0,0
"Lithuania","2024-03-10",0,0,0,0,0,0,0,0
"Lithuania","2024-03-11",0,0,0,0,0,0,0,0
"Lithuania","2024-03-12",0,0,0,0,0,0,0,0
"Lithuania","2024-03-13",0,0,0,0,0,0,0,0
"Lithuania","2024-03-14",0,0,0,0,0,0,0,0
"Lithuania","2024-03-15",0,0,0,0,0,0,0,0
"Lithuania","2024-03-16",0,0,0,0,0,0,0,0
"Lithuania","2024-03-17",0,0,0,0,0,0,0,0
"Lithuania","2024-03-18",0,0,0,0,0,0,0,0
"Lithuania","2024-03-19",0,0,0,0,0,0,0,0
"Lithuania","2024-03-20",0,0,0,0,0,0,0,0
"Lithuania","2024-03-21",0,0,0,0,0,0,0,0
"Lithuania","2024-03-22",0,0,0,0,0,0,0,0
"Lithuania","2024-03-23",0,0,0,0,0,0,0,0
"Lithuania","2024-03-24",0,0,0,0,0,0,0,0
"Lithuania","2024-03-25",0,0,0,0,0,0,0,0
"Lithuania","2024-03-26",0,0,0,0,0,0,0,0
"Lithuania","2024-03-27",0,0,0,0,0,0,0,0
"Lithuania","2024-03-28",0,0,0,0,0,0,0,0
"Lithuania","2024-03-29",0,0,0,0,0,0,0,0
"Lithuania","2024-03-30",0,0,0,0,0,0,0,0
"Lithuania","2024-03-31",0,0,0,0,0,0,0,0
"Lithuania","2024-04-01",0,0,0,0,0,0,0,0
"Lithuania","2024-04-02",0,0,0,0,0,0,0,0
"Lithuania","2024-04-03",0,0,0,0,0,0,0,0
"Lithuania","2024-04-04",0,0,0,0,0,0,0,0
"Lithuania","2024-04-05",0,0,0,0,0,0,0,0
"Lithuania","2024-04-06",0,0,0,0,0,0,0,0
"Lithuania","2024-04-07",0,0,0,0,0,0,0,0
"Lithuania","2024-04-08",0,0,0,0,0,0,0,0
"Lithuania","2024-04-09",0,0,0,0,0,0,0,0
"Lithuania","2024-04-10",0,0,0,0,0,0,0,0
"Lithuania","2024-04-11",0,0,0,0,0,0,0,0
"Lithuania","2024-04-12",0,0,0,0,0,0,0,0
"Lithuania","2024-04-13",0,0,0,0,0,0,0,0
"Lithuania","2024-04-14",0,0,0,0,0,0,0,0
"Lithuania","2024-04-15",0,0,0,0,0,0,0,0
"Lithuania","2024-04-16",0,0,0,0,0,0,0,0
"Lithuania","2024-04-17",0,0,0,0,0,0,0,0
"Lithuania","2024-04-18",0,0,0,0,0,0,0,0
"Lithuania","2024-04-19",0,0,0,0,0,0,0,0
"Lithuania","2024-04-20",0,0,0,0,0,0,0,0
"Lithuania","2024-04-21",0,0,0,0,0,0,0,0
"Lithuania","2024-04-22",0,0,0,0,0,0,0,0
"Lithuania","2024-04-23",0,0,0,0,0,0,0,0
"Lithuania","2024-04-24",0,0,0,0,0,0,0,0
"Lithuania","2024-04-25",0,0,0,0,0,0,0,0
"Lithuania","2024-04-26",0,0,0,0,0,0,0,0
"Lithuania","2024-04-27",0,0,0,0,0,0,0,0
"Lithuania","2024-04-28",0,0,0,0,0,0,0,0
"Lithuania","2024-04-29",0,0,0,0,0,0,0,0
"Lithuania","2024-04-30",0,0,0,0,0,0,0,0
"Lithuania","2024-05-01",0,0,0,0,0,0,0,0
"Lithuania","2024-05-02",0,0,0,0,0,0,0,0
"Lithuania","2024-05-03",0,0,0,0,0,0,0,0
"Lithuania","2024-05-04",0,0,0,0,0,0,0,0
"Lithuania","2024-05-05",0,0,0,0,0,0,0,0
"Lithuania","2024-05-06",0,0,0,0,0,0,0,0
"Lithuania","2024-05-07",0,0,0,0,0,0,0,0
"Lithuania","2024-05-08",0,0,0,0,0,0,0,0
"Lithuania","2024-05-09",0,0,0,0,0,0,0,0
"Lithuania","2024-05-10",0,0,0,0,0,0,0,0
"Lithuania","2024-05-11",0,0,0,0,0,0,0,0
"Lithuania","2024-05-12",0,0,0,0,0,0,0,0
"Lithuania","2024-05-13",0,0,0,0,0,0,0,0
"Lithuania","2024-05-14",0,0,0,0,0,0,0,0
"Lithuania","2024-05-15",0,0,0,0,0,0,0,0
"Lithuania","2024-05-16",0,0,0,0,0,0,0,0
"Lithuania","2024-05-17",0,0,0,0,0,0,0,0
"Lithuania","2024-05-18",0,0,0,0,0,0,0,0
"Lithuania","2024-05-19",0,0,0,0,0,0,0,0
"Lithuania","2024-05-20",0,0,0,0,0,0,0,0
"Lithuania","2024-05-21",0,0,0,0,0,0,0,0
"Lithuania","2024-05-22",0,0,0,0,0,0,0,0
"Lithuania","2024-05-23",0,0,0,0,0,0,0,0
"Lithuania","2024-05-24",0,0,0,0,0,0,0,0
"Lithuania","2024-05-25",0,0,0,0,0,0,0,0
"Lithuania","2024-05-26",0,0,0,0,0,0,0,0
"Lithuania","2024-05-27",0,0,0,0,0,0,0,0
"Lithuania","2024-05-28",0,0,0,0,0,0,0,0
"Lithuania","2024-05-29",0,0,0,0,0,0,0,0
"Lithuania","2024-05-30",0,0,0,0,0,0,0,0
"Lithuania","2024-05-31",0,0,0,0,0,0,0,0
"Lithuania","2024-06-01",0,0,0,0,0,0,0,0
"Lithuania","2024-06-02",0,0,0,0,0,0,0,0
"Lithuania","2024-06-03",0,0,0,0,0,0,0,0
"Lithuania","2024-06-04",0,0,0,0,0,0,0,0
"Lithuania","2024-06-05",0,0,0,0,0,0,0,0
"Lithuania","2024-06-06",0,0,0,0,0,0,0,0
"Lithuania","2024-06-07",0,0,0,0,0,0,0,0
"Lithuania","2024-06-08",0,0,0,0,0,0,0,0
"Lithuania","2024-06-09",0,0,0,0,0,0,0,0
"Lithuania","2024-06-10",0,0,0,0,0,0,0,0
"Lithuania","2024-06-11",0,0,0,0,0,0,0,0
"Lithuania","2024-06-12",0,0,0,0,0,0,0,0
"Lithuania","2024-06-13",0,0,0,0,0,0,0,0
"Lithuania","2024-06-14",0,0,0,0,0,0,0,0
"Lithuania","2024-06-15",0,0,0,0,0,0,0,0
"Lithuania","2024-06-16",0,0,0,0,0,0,0,0
"Lithuania","2024-06-17",0,0,0,0,0,0,0,0
"Lithuania","2024-06-18",0,0,0,0,0,0,0,0
"Lithuania","2024-06-19",0,0,0,0,0,0,0,0
"Lithuania","2024-06-20",0,0,0,0,0,0,0,0
"Lithuania","2024-06-21",0,0,0,0,0,0,0,0
"Lithuania","2024-06-22",0,0,0,0,0,0,0,0
"Lithuania","2024-06-23",0,0,0,0,0,0,0,0
"Lithuania","2024-06-24",0,0,0,0,0,0,0,0
"Lithuania","2024-06-25",0,0,0,0,0,0,0,0
"Lithuania","2024-06-26",0,0,0,0,0,0,0,0
"Lithuania","2024-06-27",0,0,0,0,0,0,0,0
"Lithuania","2024-06-28",0,0,0,0,0,0,0,0
"Lithuania","2024-06-29",0,0,0,0,0,0,0,0
"Lithuania","2024-06-30",0,0,0,0,0,0,0,0
"Lithuania","2024-07-01",0,0,0,0,0,0,0,0
"Lithuania","2024-07-02",0,0,0,0,0,0,0,0
"Lithuania","2024-07-03",0,0,0,0,0,0,0,0
"Lithuania","2024-07-04",0,0,0,0,0,0,0,0
"Lithuania","2024-07-05",0,0,0,0,0,0,0,0
"Lithuania","2024-07-06",0,0,0,0,0,0,0,0
"Lithuania","2024-07-07",0,0,0,0,0,0,0,0
"Lithuania","2024-07-08",0,0,0,0,0,0,0,0
"Lithuania","2024-07-09",0,0,0,0,0,0,0,0
"Lithuania","2024-07-10",0,0,0,0,0,0,0,0
"Lithuania","2024-07-11",0,0,0,0,0,0,0,0
"Lithuania","2024-07-12",0,0,0,0,0,0,0,0
"Lithuania","2024-07-13",0,0,0,0,0,0,0,0
"Lithuania","2024-07-14",0,0,0,0,0,0,0,0
"Lithuania","2024-07-15",0,0,0,0,0,0,0,0
"Lithuania","2024-07-16",0,0,0,0,0,0,0,0
"Lithuania","2024-07-17",0,0,0,0,0,0,0,0
"Lithuania","2024-07-18",0,0,0,0,0,0,0,0
"Lithuania","2024-07-19",0,0,0,0,0,0,0,0
"Lithuania","2024-07-20",0,0,0,0,0,0,0,0
"Lithuania","2024-07-21",0,0,0,0,0,0,0,0
"Lithuania","2024-07-22",0,0,0,0,0,0,0,0
"Lithuania","2024-07-23",0,0,0,0,0,0,0,0
"Lithuania","2024-07-24",0,0,0,0,0,0,0,0
"Lithuania","2024-07-25",0,0,0,0,0,0,0,0
"Lithuania","2024-07-26",0,0,0,0,0,0,0,0
"Lithuania","2024-07-27",0,0,0,0,0,0,0,0
"Lithuania","2024-07-28",0,0,0,0,0,0,0,0
"Lithuania","2024-07-29",0,0,0,0,0,0,0,0
"Lithuania","2024-07-30",0,0,0,0,0,0,0,0
"Lithuania","2024-07-31",0,0,0,0,0,0,0,0
"Lithuania","2024-08-01",0,0,0,0,0,0,0,0
"Lithuania","2024-08-02",0,0,0,0,0,0,0,0
"Lithuania","2024-08-03",0,0,0,0,0,0,0,0
"Lithuania","2024-08-04",0,0,0,0,0,0,0,0
"Lithuania","2024-08-05",0,0,0,0,0,0,0,0
"Lithuania","2024-08-06",0,0,0,0,0,0,0,0
"Lithuania","2024-08-07",0,0,0,0,0,0,0,0
"Lithuania","2024-08-08",0,0,0,0,0,0,0,0
"Lithuania","2024-08-09",0,0,0,0,0,0,0,0
"Lithuania","2024-08-10",0,0,0,0,0,0,0,0
"Lithuania","2024-08-11",0,0,0,0,0,0,0,0
"Lithuania","2024-08-12",0,0,0,0,0,0,0,0
"Lithuania","2024-08-13",0,0,0,0,0,0,0,0
"Lithuania","2024-08-14",0,0,0,0,0,0,0,0
"Lithuania","2024-08-15",0,0,0,0,0,0,0,0
"Lithuania","2024-08-16",0,0,0,0,0,0,0,0
"Lithuania","2024-08-17",0,0,0,0,0,0,0,0
"Lithuania","2024-08-18",0,0,0,0,0,0,0,0
"Lithuania","2024-08-19",0,0,0,0,0,0,0,0
"Lithuania","2024-08-20",0,0,0,0,0,0,0,0
"Lithuania","2024-08-21",0,0,0,0,0,0,0,0
"Lithuania","2024-08-22",0,0,0,0,0,0,0,0
"Lithuania","2024-08-23",0,0,0,0,0,0,0,0
"Lithuania","2024-08-24",0,0,0,0,0,0,0,0
"Lithuania","2024-08-25",0,0,0,0,0,0,0,0
"Lithuania","2024-08-26",0,0,0,0,0,0,0,0
"Lithuania","2024-08-27",0,0,0,0,0,0,0,0
"Lithuania","2024-08-28",0,0,0,0,0,0,0,0
"Lithuania","2024-08-29",0,0,0,0,0,0,0,0
"Lithuania","2024-08-30",0,0,0,0,0,0,0,0
"Lithuania","2024-08-31",0,0,0,0,0,0,0,0
"Lithuania","2024-09-01",0,0,0,0,0,0,0,0
"Lithuania","2024-09-02",0,0,0,0,0,0,0,0
"Lithuania","2024-09-03",0,0,0,0,0,0,0,0
"Lithuania","2024-09-04",0,0,0,0,0,0,0,0
"Lithuania","2024-09-05",0,0,0,0,0,0,0,0
"Lithuania","2024-09-06",0,0,0,0,0,0,0,0
"Lithuania","2024-09-07",0,0,0,0,0,0,0,0
"Lithuania","2024-09-08",0,0,0,0,0,0,0,0
"Lithuania","2024-09-09",0,0,0,0,0,0,0,0
"Lithuania","2024-09-10",0,0,0,0,0,0,0,0
"Lithuania","2024-09-11",0,0,0,0,0,0,0,0
"Lithuania","2024-09-12",0,0,0,0,0,0,0,0
"Lithuania","2024-09-13",0,0,0,0,0,0,0,0
"Lithuania","2024-09-14",0,0,0,0,0,0,0,0
"Lithuania","2024-09-15",0,0,0,0,0,0,0,0
"Lithuania","2024-09-16",0,0,0,0,0,0,0,0
"Lithuania","2024-09-17",0,0,0,0,0,0,0,0
"Lithuania","2024-09-18",0,0,0,0,0,0,0,0
"Lithuania","2024-09-19",0,0,0,0,0,0,0,0
"Lithuania","2024-09-20",0,0,0,0,0,0,0,0
"Lithuania","2024-09-21",0,0,0,0,0,0,0,0
"Lithuania","2024-09-22",0,0,0,0,0,0,0,0
"Lithuania","2024-09-23",0,0,0,0,0,0,0,0
"Lithuania","2024-09-24",0,0,0,0,0,0,0,0
"Lithuania","2024-09-25",0,0,0,0,0,0,0,0
"Lithuania","2024-09-26",0,0,0,0,0,0,0,0
"Lithuania","2024-09-27",0,0,0,0,0,0,0,0
"Lithuania","2024-09-28",0,0,0,0,0,0,0,0
"Lithuania","2024-09-29",0,0,0,0,0,0,0,0
"Lithuania","2024-09-30",0,1,1,0,1,1,0,0
"Lithuania","2024-10-01",0,0,1,0,0,1,0,0
"Lithuania","2024-10-02",0,0,1,0,0,1,0,0
"Lithuania","2024-10-03",0,0,1,0,0,1,0,0
"Lithuania","2024-10-04",0,0,1,0,0,1,0,0
"Lithuania","2024-10-05",0,0,1,0,0,1,0,0
"Lithuania","2024-10-06",0,0,1,0,0,1,0,0
"Lithuania","2024-10-07",0,0,1,0,0,1,0,0
"Lithuania","2024-10-08",0,0,1,0,0,1,0,0
"Lithuania","2024-10-09",0,0,1,0,0,1,0,0
"Lithuania","2024-10-10",0,0,1,0,0,1,0,0
"Lithuania","2024-10-11",0,0,1,0,0,1,0,0
"Lithuania","2024-10-12",0,0,1,0,0,1,0,0
"Lithuania","2024-10-13",0,0,1,0,0,1,0,0
"Lithuania","2024-10-14",0,0,1,0,0,1,0,0
"Lithuania","2024-10-15",0,0,1,0,0,1,0,0
"Lithuania","2024-10-16",0,0,1,0,0,1,0,0
"Lithuania","2024-10-17",0,0,1,0,0,1,0,0
"Lithuania","2024-10-18",0,0,1,0,0,1,0,0
"Lithuania","2024-10-19",0,0,1,0,0,1,0,0
"Lithuania","2024-10-20",0,0,1,0,0,1,0,0
"Lithuania","2024-10-21",0,0,1,0,0,1,0,0
"Lithuania","2024-10-22",0,0,1,0,0,1,0,0
"Lithuania","2024-10-23",0,0,1,0,0,1,0,0
"Lithuania","2024-10-24",0,0,1,0,0,1,0,0
"Lithuania","2024-10-25",0,0,1,0,0,1,0,0
"Lithuania","2024-10-26",0,0,1,0,0,1,0,0
"Lithuania","2024-10-27",0,0,1,0,0,1,0,0
"Lithuania","2024-10-28",0,0,1,0,0,1,0,0
"Lithuania","2024-10-29",0,0,1,0,0,1,0,0
"Lithuania","2024-10-30",0,0,1,0,0,1,0,0
"Lithuania","2024-10-31",0,0,1,0,0,1,0,0
"Lithuania","2024-11-01",0,0,1,0,0,1,0,0
"Lithuania","2024-11-02",0,0,1,0,0,1,0,0
"Lithuania","2024-11-03",0,0,1,0,0,1,0,0
"Lithuania","2024-11-04",0,0,1,0,0,1,0,0
"Lithuania","2024-11-05",0,0,1,0,0,1,0,0
"Lithuania","2024-11-06",0,0,1,0,0,1,0,0
"Lithuania","2024-11-07",0,0,1,0,0,1,0,0
"Lithuania","2024-11-08",0,0,1,0,0,1,0,0
"Lithuania","2024-11-09",0,0,1,0,0,1,0,0
"Lithuania","2024-11-10",0,0,1,0,0,1,0,0
"Lithuania","2024-11-11",0,0,1,0,0,1,0,0
"Lithuania","2024-11-12",0,0,1,0,0,1,0,0
"Lithuania","2024-11-13",0,0,1,0,0,1,0,0
"Lithuania","2024-11-14",0,0,1,0,0,1,0,0
"Lithuania","2024-11-15",0,0,1,0,0,1,0,0
"Lithuania","2024-11-16",0,0,1,0,0,1,0,0
"Lithuania","2024-11-17",0,0,1,0,0,1,0,0
"Lithuania","2024-11-18",0,0,1,0,0,1,0,0
"Lithuania","2024-11-19",0,0,1,0,0,1,0,0
"Lithuania","2024-11-20",0,0,1,0,0,1,0,0
"Lithuania","2024-11-21",0,0,1,0,0,1,0,0
"Lithuania","2024-11-22",0,0,1,0,0,1,0,0
"Lithuania","2024-11-23",0,0,1,0,0,1,0,0
"Lithuania","2024-11-24",0,0,1,0,0,1,0,0
"Lithuania","2024-11-25",0,0,1,0,0,1,0,0
"Lithuania","2024-11-26",0,0,1,0,0,1,0,0
"Lithuania","2024-11-27",0,0,1,0,0,1,0,0
"Lithuania","2024-11-28",0,0,1,0,0,1,0,0
"Lithuania","2024-11-29",0,0,1,0,0,1,0,0
"Lithuania","2024-11-30",0,0,1,0,0,1,0,0
"Lithuania","2024-12-01",0,0,1,0,0,1,0,0
"Lithuania","2024-12-02",0,0,1,0,0,1,0,0
"Lithuania","2024-12-03",0,0,1,0,0,1,0,0
"Lithuania","2024-12-04",0,0,1,0,0,1,0,0
"Lithuania","2024-12-05",0,0,1,0,0,1,0,0
"Lithuania","2024-12-06",0,0,1,0,0,1,0,0
"Lithuania","2024-12-07",0,0,1,0,0,1,0,0
"Lithuania","2024-12-08",0,0,1,0,0,1,0,0
"Lithuania","2024-12-09",0,0,1,0,0,1,0,0
"Luxembourg","2024-01-01",0,0,0,0,0,0,0,0
"Luxembourg","2024-01-02",0,0,0,0,0,0,0,0
"Luxembourg","2024-01-03",0,0,0,0,0,0,0,0
"Luxembourg","2024-01-04",0,0,0,0,0,0,0,0
"Luxembourg","2024-01-05",0,0,0,0,0,0,0,0
"Luxembourg","2024-01-06",0,0,0,0,0,0,0,0
"Luxembourg","2024-01-07",0,0,0,0,0,0,0,0
"Luxembourg","2024-01-08",0,0,0,0,0,0,0,0
"Luxembourg","2024-01-09",0,0,0,0,0,0,0,0
"Luxembourg","2024-01-10",0,0,0,0,0,0,0,0
"Luxembourg","2024-01-11",0,0,0,0,0,0,0,0
"Luxembourg","2024-01-12",0,0,0,0,0,0,0,0
"Luxembourg","2024-01-13",0,0,0,0,0,0,0,0
"Luxembourg","2024-01-14",0,0,0,0,0,0,0,0
"Luxembourg","2024-01-15",0,0,0,0,0,0,0,0
"Luxembourg","2024-01-16",0,0,0,0,0,0,0,0
"Luxembourg","2024-01-17",0,0,0,0,0,0,0,0
"Luxembourg","2024-01-18",0,0,0,0,0,0,0,0
"Luxembourg","2024-01-19",0,0,0,0,0,0,0,0
"Luxembourg","2024-01-20",0,0,0,0,0,0,0,0
"Luxembourg","2024-01-21",0,0,0,0,0,0,0,0
"Luxembourg","2024-01-22",0,0,0,0,0,0,0,0
"Luxembourg","2024-01-23",0,0,0,0,0,0,0,0
"Luxembourg","2024-01-24",0,0,0,0,0,0,0,0
"Luxembourg","2024-01-25",0,0,0,0,0,0,0,0
"Luxembourg","2024-01-26",0,0,0,0,0,0,0,0
"Luxembourg","2024-01-27",0,0,0,0,0,0,0,0
"Luxembourg","2024-01-28",0,0,0,0,0,0,0,0
"Luxembourg","2024-01-29",0,0,0,0,0,0,0,0
"Luxembourg","2024-01-30",0,0,0,0,0,0,0,0
"Luxembourg","2024-01-31",0,0,0,0,0,0,0,0
"Luxembourg","2024-02-01",0,0,0,0,0,0,0,0
"Luxembourg","2024-02-02",0,0,0,0,0,0,0,0
"Luxembourg","2024-02-03",0,0,0,0,0,0,0,0
"Luxembourg","2024-02-04",0,0,0,0,0,0,0,0
"Luxembourg","2024-02-05",0,0,0,0,0,0,0,0
"Luxembourg","2024-02-06",0,0,0,0,0,0,0,0
"Luxembourg","2024-02-07",0,0,0,0,0,0,0,0
"Luxembourg","2024-02-08",0,0,0,0,0,0,0,0
"Luxembourg","2024-02-09",0,0,0,0,0,0,0,0
"Luxembourg","2024-02-10",0,0,0,0,0,0,0,0
"Luxembourg","2024-02-11",0,0,0,0,0,0,0,0
"Luxembourg","2024-02-12",0,0,0,0,0,0,0,0
"Luxembourg","2024-02-13",0,0,0,0,0,0,0,0
"Luxembourg","2024-02-14",0,0,0,0,0,0,0,0
"Luxembourg","2024-02-15",0,0,0,0,0,0,0,0
"Luxembourg","2024-02-16",0,0,0,0,0,0,0,0
"Luxembourg","2024-02-17",0,0,0,0,0,0,0,0
"Luxembourg","2024-02-18",0,0,0,0,0,0,0,0
"Luxembourg","2024-02-19",0,0,0,0,0,0,0,0
"Luxembourg","2024-02-20",0,0,0,0,0,0,0,0
"Luxembourg","2024-02-21",0,0,0,0,0,0,0,0
"Luxembourg","2024-02-22",0,0,0,0,0,0,0,0
"Luxembourg","2024-02-23",0,0,0,0,0,0,0,0
"Luxembourg","2024-02-24",0,0,0,0,0,0,0,0
"Luxembourg","2024-02-25",0,0,0,0,0,0,0,0
"Luxembourg","2024-02-26",0,0,0,0,0,0,0,0
"Luxembourg","2024-02-27",0,0,0,0,0,0,0,0
"Luxembourg","2024-02-28",0,0,0,0,0,0,0,0
"Luxembourg","2024-02-29",0,1,1,0,1,1,0,0
"Luxembourg","2024-03-01",0,0,1,0,0,1,0,0
"Luxembourg","2024-03-02",0,0,1,0,0,1,0,0
"Luxembourg","2024-03-03",0,0,1,0,0,1,0,0
"Luxembourg","2024-03-04",0,0,1,0,0,1,0,0
"Luxembourg","2024-03-05",0,0,1,0,0,1,0,0
"Luxembourg","2024-03-06",0,0,1,0,0,1,0,0
"Luxembourg","2024-03-07",0,0,1,0,0,1,0,0
"Luxembourg","2024-03-08",0,0,1,0,0,1,0,0
"Luxembourg","2024-03-09",0,0,1,0,0,1,0,0
"Luxembourg","2024-03-10",0,0,1,0,0,1,0,0
"Luxembourg","2024-03-11",0,0,1,0,0,1,0,0
"Luxembourg","2024-03-12",0,0,1,0,0,1,0,0
"Luxembourg","2024-03-13",0,0,1,0,0,1,0,0
"Luxembourg","2024-03-14",0,0,1,0,0,1,0,0
"Luxembourg","2024-03-15",0,0,1,0,0,1,0,0
"Luxembourg","2024-03-16",0,0,1,0,0,1,0,0
"Luxembourg","2024-03-17",0,0,1,0,0,1,0,0
"Luxembourg","2024-03-18",0,0,1,0,0,1,0,0
"Luxembourg","2024-03-19",0,0,1,0,0,1,0,0
"Luxembourg","2024-03-20",0,0,1,0,0,1,0,0
"Luxembourg","2024-03-21",0,0,1,0,0,1,0,0
"Luxembourg","2024-03-22",0,0,1,0,0,1,0,0
"Luxembourg","2024-03-23",0,0,1,0,0,1,0,0
"Luxembourg","2024-03-24",0,0,1,0,0,1,0,0
"Luxembourg","2024-03-25",0,0,1,0,0,1,0,0
"Luxembourg","2024-03-26",0,0,1,0,0,1,0,0
"Luxembourg","2024-03-27",0,0,1,0,0,1,0,0
"Luxembourg","2024-03-28",0,0,1,0,0,1,0,0
"Luxembourg","2024-03-29",0,0,1,0,0,1,0,0
"Luxembourg","2024-03-30",0,0,1,0,0,1,0,0
"Luxembourg","2024-03-31",0,0,1,0,0,1,0,0
"Luxembourg","2024-04-01",0,0,1,0,0,1,0,0
"Luxembourg","2024-04-02",0,0,1,0,0,1,0,0
"Luxembourg","2024-04-03",0,0,1,0,0,1,0,0
"Luxembourg","2024-04-04",0,0,1,0,0,1,0,0
"Luxembourg","2024-04-05",0,0,1,0,0,1,0,0
"Luxembourg","2024-04-06",0,0,1,0,0,1,0,0
"Luxembourg","2024-04-07",0,0,1,0,0,1,0,0
"Luxembourg","2024-04-08",0,0,1,0,0,1,0,0
"Luxembourg","2024-04-09",0,0,1,0,0,1,0,0
"Luxembourg","2024-04-10",0,0,1,0,0,1,0,0
"Luxembourg","2024-04-11",0,0,1,0,0,1,0,0
"Luxembourg","2024-04-12",0,0,1,0,0,1,0,0
"Luxembourg","2024-04-13",0,0,1,0,0,1,0,0
"Luxembourg","2024-04-14",0,0,1,0,0,1,0,0
"Luxembourg","2024-04-15",0,0,1,0,0,1,0,0
"Luxembourg","2024-04-16",0,0,1,0,0,1,0,0
"Luxembourg","2024-04-17",0,0,1,0,0,1,0,0
"Luxembourg","2024-04-18",0,0,1,0,0,1,0,0
"Luxembourg","2024-04-19",0,0,1,0,0,1,0,0
"Luxembourg","2024-04-20",0,0,1,0,0,1,0,0
"Luxembourg","2024-04-21",0,0,1,0,0,1,0,0
"Luxembourg","2024-04-22",0,0,1,0,0,1,0,0
"Luxembourg","2024-04-23",0,0,1,0,0,1,0,0
"Luxembourg","2024-04-24",0,0,1,0,0,1,0,0
"Luxembourg","2024-04-25",0,0,1,0,0,1,0,0
"Luxembourg","2024-04-26",0,0,1,0,0,1,0,0
"Luxembourg","2024-04-27",0,0,1,0,0,1,0,0
"Luxembourg","2024-04-28",0,0,1,0,0,1,0,0
"Luxembourg","2024-04-29",0,0,1,0,0,1,0,0
"Luxembourg","2024-04-30",0,0,1,0,0,1,0,0
"Luxembourg","2024-05-01",0,0,1,0,0,1,0,0
"Luxembourg","2024-05-02",0,0,1,0,0,1,0,0
"Luxembourg","2024-05-03",0,0,1,0,0,1,0,0
"Luxembourg","2024-05-04",0,0,1,0,0,1,0,0
"Luxembourg","2024-05-05",0,0,1,0,0,1,0,0
"Luxembourg","2024-05-06",0,0,1,0,0,1,0,0
"Luxembourg","2024-05-07",0,0,1,0,0,1,0,0
"Luxembourg","2024-05-08",0,0,1,0,0,1,0,0
"Luxembourg","2024-05-09",0,0,1,0,0,1,0,0
"Luxembourg","2024-05-10",0,0,1,0,0,1,0,0
"Luxembourg","2024-05-11",0,0,1,0,0,1,0,0
"Luxembourg","2024-05-12",0,0,1,0,0,1,0,0
"Luxembourg","2024-05-13",0,0,1,0,0,1,0,0
"Luxembourg","2024-05-14",0,0,1,0,0,1,0,0
"Luxembourg","2024-05-15",0,0,1,0,0,1,0,0
"Luxembourg","2024-05-16",0,0,1,0,0,1,0,0
"Luxembourg","2024-05-17",0,0,1,0,0,1,0,0
"Luxembourg","2024-05-18",0,0,1,0,0,1,0,0
"Luxembourg","2024-05-19",0,0,1,0,0,1,0,0
"Luxembourg","2024-05-20",0,0,1,0,0,1,0,0
"Luxembourg","2024-05-21",0,0,1,0,0,1,0,0
"Luxembourg","2024-05-22",0,0,1,0,0,1,0,0
"Luxembourg","2024-05-23",0,0,1,0,0,1,0,0
"Luxembourg","2024-05-24",0,0,1,0,0,1,0,0
"Luxembourg","2024-05-25",0,0,1,0,0,1,0,0
"Luxembourg","2024-05-26",0,0,1,0,0,1,0,0
"Luxembourg","2024-05-27",0,0,1,0,0,1,0,0
"Luxembourg","2024-05-28",0,0,1,0,0,1,0,0
"Luxembourg","2024-05-29",0,0,1,0,0,1,0,0
"Luxembourg","2024-05-30",0,0,1,0,0,1,0,0
"Luxembourg","2024-05-31",0,0,1,0,0,1,0,0
"Luxembourg","2024-06-01",0,0,1,0,0,1,0,0
"Luxembourg","2024-06-02",0,0,1,0,0,1,0,0
"Luxembourg","2024-06-03",0,0,1,0,0,1,0,0
"Luxembourg","2024-06-04",0,0,1,0,0,1,0,0
"Luxembourg","2024-06-05",0,0,1,0,0,1,0,0
"Luxembourg","2024-06-06",0,0,1,0,0,1,0,0
"Luxembourg","2024-06-07",0,0,1,0,0,1,0,0
"Luxembourg","2024-06-08",0,0,1,0,0,1,0,0
"Luxembourg","2024-06-09",0,0,1,0,0,1,0,0
"Luxembourg","2024-06-10",0,0,1,0,0,1,0,0
"Luxembourg","2024-06-11",0,0,1,0,0,1,0,0
"Luxembourg","2024-06-12",0,0,1,0,0,1,0,0
"Luxembourg","2024-06-13",0,0,1,0,0,1,0,0
"Luxembourg","2024-06-14",0,0,1,0,0,1,0,0
"Luxembourg","2024-06-15",0,0,1,0,0,1,0,0
"Luxembourg","2024-06-16",0,0,1,0,0,1,0,0
"Luxembourg","2024-06-17",0,0,1,0,0,1,0,0
"Luxembourg","2024-06-18",0,0,1,0,0,1,0,0
"Luxembourg","2024-06-19",0,0,1,0,0,1,0,0
"Luxembourg","2024-06-20",0,0,1,0,0,1,0,0
"Luxembourg","2024-06-21",0,0,1,0,0,1,0,0
"Luxembourg","2024-06-22",0,0,1,0,0,1,0,0
"Luxembourg","2024-06-23",0,0,1,0,0,1,0,0
"Luxembourg","2024-06-24",0,0,1,0,0,1,0,0
"Luxembourg","2024-06-25",0,0,1,0,0,1,0,0
"Luxembourg","2024-06-26",0,0,1,0,0,1,0,0
"Luxembourg","2024-06-27",0,0,1,0,0,1,0,0
"Luxembourg","2024-06-28",0,0,1,0,0,1,0,0
"Luxembourg","2024-06-29",0,0,1,0,0,1,0,0
"Luxembourg","2024-06-30",0,0,1,0,0,1,0,0
"Luxembourg","2024-07-01",0,0,1,0,1,2,0,0
"Luxembourg","2024-07-02",0,0,1,0,0,2,0,0
"Luxembourg","2024-07-03",0,0,1,0,0,2,0,0
"Luxembourg","2024-07-04",0,0,1,0,0,2,0,0
"Luxembourg","2024-07-05",0,0,1,0,0,2,0,0
"Luxembourg","2024-07-06",0,0,1,0,0,2,0,0
"Luxembourg","2024-07-07",0,0,1,0,0,2,0,0
"Luxembourg","2024-07-08",0,0,1,0,0,2,0,0
"Luxembourg","2024-07-09",0,0,1,0,0,2,0,0
"Luxembourg","2024-07-10",0,0,1,0,0,2,0,0
"Luxembourg","2024-07-11",0,0,1,0,0,2,0,0
"Luxembourg","2024-07-12",0,0,1,0,0,2,0,0
"Luxembourg","2024-07-13",0,0,1,0,0,2,0,0
"Luxembourg","2024-07-14",0,0,1,0,0,2,0,0
"Luxembourg","2024-07-15",0,0,1,0,0,2,0,0
"Luxembourg","2024-07-16",0,0,1,0,0,2,0,0
"Luxembourg","2024-07-17",0,0,1,0,0,2,0,0
"Luxembourg","2024-07-18",0,0,1,0,0,2,0,0
"Luxembourg","2024-07-19",0,0,1,0,0,2,0,0
"Luxembourg","2024-07-20",0,0,1,0,0,2,0,0
"Luxembourg","2024-07-21",0,0,1,0,0,2,0,0
"Luxembourg","2024-07-22",0,0,1,0,0,2,0,0
"Luxembourg","2024-07-23",0,0,1,0,0,2,0,0
"Luxembourg","2024-07-24",0,0,1,0,0,2,0,0
"Luxembourg","2024-07-25",0,0,1,0,0,2,0,0
"Luxembourg","2024-07-26",0,0,1,0,0,2,0,0
"Luxembourg","2024-07-27",0,0,1,0,0,2,0,0
"Luxembourg","2024-07-28",0,0,1,0,0,2,0,0
"Luxembourg","2024-07-29",0,0,1,0,0,2,0,0
"Luxembourg","2024-07-30",0,0,1,0,0,2,0,0
"Luxembourg","2024-07-31",0,0,1,0,0,2,0,0
"Luxembourg","2024-08-01",0,0,1,0,0,2,0,0
"Luxembourg","2024-08-02",0,0,1,0,0,2,0,0
"Luxembourg","2024-08-03",0,0,1,0,0,2,0,0
"Luxembourg","2024-08-04",0,0,1,0,0,2,0,0
"Luxembourg","2024-08-05",0,0,1,0,0,2,0,0
"Luxembourg","2024-08-06",0,0,1,0,0,2,0,0
"Luxembourg","2024-08-07",0,0,1,0,0,2,0,0
"Luxembourg","2024-08-08",0,0,1,0,0,2,0,0
"Luxembourg","2024-08-09",0,0,1,0,0,2,0,0
"Luxembourg","2024-08-10",0,0,1,0,0,2,0,0
"Luxembourg","2024-08-11",0,0,1,0,0,2,0,0
"Luxembourg","2024-08-12",0,0,1,0,0,2,0,0
"Luxembourg","2024-08-13",0,0,1,0,0,2,0,0
"Luxembourg","2024-08-14",0,0,1,0,0,2,0,0
"Luxembourg","2024-08-15",0,0,1,0,0,2,0,0
"Luxembourg","2024-08-16",0,0,1,0,0,2,0,0
"Luxembourg","2024-08-17",0,0,1,0,0,2,0,0
"Luxembourg","2024-08-18",0,0,1,0,0,2,0,0
"Luxembourg","2024-08-19",0,0,1,0,0,2,0,0
"Luxembourg","2024-08-20",0,0,1,0,0,2,0,0
"Luxembourg","2024-08-21",0,0,1,0,0,2,0,0
"Luxembourg","2024-08-22",0,0,1,0,0,2,0,0
"Luxembourg","2024-08-23",0,0,1,0,0,2,0,0
"Luxembourg","2024-08-24",0,0,1,0,0,2,0,0
"Luxembourg","2024-08-25",0,0,1,0,0,2,0,0
"Luxembourg","2024-08-26",0,0,1,0,0,2,0,0
"Luxembourg","2024-08-27",0,0,1,0,0,2,0,0
"Luxembourg","2024-08-28",0,0,1,0,0,2,0,0
"Luxembourg","2024-08-29",0,0,1,0,0,2,0,0
"Luxembourg","2024-08-30",0,0,1,0,0,2,0,0
"Luxembourg","2024-08-31",0,0,1,0,0,2,0,0
"Luxembourg","2024-09-01",0,0,1,0,0,2,0,0
"Luxembourg","2024-09-02",0,0,1,0,0,2,0,0
"Luxembourg","2024-09-03",0,0,1,0,0,2,0,0
"Luxembourg","2024-09-04",0,0,1,0,0,2,0,0
"Luxembourg","2024-09-05",0,0,1,0,0,2,0,0
"Luxembourg","2024-09-06",0,0,1,0,0,2,0,0
"Luxembourg","2024-09-07",0,0,1,0,0,2,0,0
"Luxembourg","2024-09-08",0,0,1,0,0,2,0,0
"Luxembourg","2024-09-09",0,0,1,0,0,2,0,0
"Luxembourg","2024-09-10",0,0,1,0,0,2,0,0
"Luxembourg","2024-09-11",0,0,1,0,0,2,0,0
"Luxembourg","2024-09-12",0,0,1,0,0,2,0,0
"Luxembourg","2024-09-13",0,0,1,0,0,2,0,0
"Luxembourg","2024-09-14",0,0,1,0,0,2,0,0
"Luxembourg","2024-09-15",0,0,1,0,0,2,0,0
"Luxembourg","2024-09-16",0,0,1,0,0,2,0,0
"Luxembourg","2024-09-17",0,0,1,0,0,2,0,0
"Luxembourg","2024-09-18",0,0,1,0,0,2,0,0
"Luxembourg","2024-09-19",0,0,1,0,0,2,0,0
"Luxembourg","2024-09-20",0,0,1,0,0,2,0,0
"Luxembourg","2024-09-21",0,0,1,0,0,2,0,0
"Luxembourg","2024-09-22",0,0,1,0,0,2,0,0
"Luxembourg","2024-09-23",0,0,1,0,0,2,0,0
"Luxembourg","2024-09-24",0,0,1,0,0,2,0,0
"Luxembourg","2024-09-25",0,0,1,0,0,2,0,0
"Luxembourg","2024-09-26",0,0,1,0,0,2,0,0
"Luxembourg","2024-09-27",0,0,1,0,0,2,0,0
"Luxembourg","2024-09-28",0,0,1,0,0,2,0,0
"Luxembourg","2024-09-29",0,0,1,0,0,2,0,0
"Luxembourg","2024-09-30",0,0,1,0,0,2,0,0
"Luxembourg","2024-10-01",0,0,1,0,0,2,0,0
"Luxembourg","2024-10-02",0,0,1,0,0,2,0,0
"Luxembourg","2024-10-03",0,0,1,0,0,2,0,0
"Luxembourg","2024-10-04",0,0,1,0,0,2,0,0
"Luxembourg","2024-10-05",0,0,1,0,0,2,0,0
"Luxembourg","2024-10-06",0,0,1,0,0,2,0,0
"Luxembourg","2024-10-07",0,0,1,0,0,2,0,0
"Luxembourg","2024-10-08",0,0,1,0,0,2,0,0
"Luxembourg","2024-10-09",0,0,1,0,0,2,0,0
"Luxembourg","2024-10-10",0,0,1,0,0,2,0,0
"Luxembourg","2024-10-11",0,0,1,0,0,2,0,0
"Luxembourg","2024-10-12",0,0,1,0,0,2,0,0
"Luxembourg","2024-10-13",0,0,1,0,0,2,0,0
"Luxembourg","2024-10-14",0,0,1,0,0,2,0,0
"Luxembourg","2024-10-15",0,0,1,0,0,2,0,0
"Luxembourg","2024-10-16",0,0,1,0,0,2,0,0
"Luxembourg","2024-10-17",0,0,1,0,0,2,0,0
"Luxembourg","2024-10-18",0,0,1,0,0,2,0,0
"Luxembourg","2024-10-19",0,0,1,0,0,2,0,0
"Luxembourg","2024-10-20",0,0,1,0,0,2,0,0
"Luxembourg","2024-10-21",0,0,1,0,0,2,0,0
"Luxembourg","2024-10-22",0,0,1,0,0,2,0,0
"Luxembourg","2024-10-23",0,0,1,0,0,2,0,0
"Luxembourg","2024-10-24",0,0,1,0,0,2,0,0
"Luxembourg","2024-10-25",0,0,1,0,0,2,0,0
"Luxembourg","2024-10-26",0,0,1,0,0,2,0,0
"Luxembourg","2024-10-27",0,0,1,0,0,2,0,0
"Luxembourg","2024-10-28",0,0,1,0,0,2,0,0
"Luxembourg","2024-10-29",0,0,1,0,0,2,0,0
"Luxembourg","2024-10-30",0,0,1,0,0,2,0,0
"Luxembourg","2024-10-31",0,1,2,0,0,2,0,0
"Luxembourg","2024-11-01",0,0,2,0,0,2,0,0
"Luxembourg","2024-11-02",0,0,2,0,0,2,0,0
"Luxembourg","2024-11-03",0,0,2,0,0,2,0,0
"Luxembourg","2024-11-04",0,0,2,0,0,2,0,0
"Luxembourg","2024-11-05",0,0,2,0,0,2,0,0
"Luxembourg","2024-11-06",0,0,2,0,0,2,0,0
"Luxembourg","2024-11-07",0,0,2,0,0,2,0,0
"Luxembourg","2024-11-08",0,0,2,0,0,2,0,0
"Luxembourg","2024-11-09",0,0,2,0,0,2,0,0
"Luxembourg","2024-11-10",0,0,2,0,0,2,0,0
"Luxembourg","2024-11-11",0,0,2,0,0,2,0,0
"Luxembourg","2024-11-12",0,0,2,0,0,2,0,0
"Luxembourg","2024-11-13",0,0,2,0,0,2,0,0
"Luxembourg","2024-11-14",0,0,2,0,0,2,0,0
"Luxembourg","2024-11-15",0,0,2,0,0,2,0,0
"Luxembourg","2024-11-16",0,0,2,0,0,2,0,0
"Luxembourg","2024-11-17",0,0,2,0,0,2,0,0
"Luxembourg","2024-11-18",0,0,2,0,0,2,0,0
"Luxembourg","2024-11-19",0,0,2,0,0,2,0,0
"Luxembourg","2024-11-20",0,0,2,0,0,2,0,0
"Luxembourg","2024-11-21",0,0,2,0,0,2,0,0
"Luxembourg","2024-11-22",0,0,2,0,0,2,0,0
"Luxembourg","2024-11-23",0,0,2,0,0,2,0,0
"Luxembourg","2024-11-24",0,0,2,0,0,2,0,0
"Luxembourg","2024-11-25",0,0,2,0,0,2,0,0
"Luxembourg","2024-11-26",0,0,2,0,0,2,0,0
"Luxembourg","2024-11-27",0,0,2,0,0,2,0,0
"Luxembourg","2024-11-28",0,0,2,0,0,2,0,0
"Luxembourg","2024-11-29",0,0,2,0,0,2,0,0
"Luxembourg","2024-11-30",0,0,2,0,0,2,0,0
"Luxembourg","2024-12-01",0,0,2,0,0,2,0,0
"Luxembourg","2024-12-02",0,0,2,0,0,2,0,0
"Luxembourg","2024-12-03",0,0,2,0,0,2,0,0
"Luxembourg","2024-12-04",0,0,2,0,0,2,0,0
"Luxembourg","2024-12-05",0,0,2,0,0,2,0,0
"Luxembourg","2024-12-06",0,0,2,0,0,2,0,0
"Luxembourg","2024-12-07",0,0,2,0,0,2,0,0
"Luxembourg","2024-12-08",0,0,2,0,0,2,0,0
"Luxembourg","2024-12-09",0,0,2,0,0,2,0,0
"Malaysia","2024-01-01",0,0,0,0,0,0,0,0
"Malaysia","2024-01-02",0,0,0,0,0,0,0,0
"Malaysia","2024-01-03",0,0,0,0,0,0,0,0
"Malaysia","2024-01-04",0,0,0,0,0,0,0,0
"Malaysia","2024-01-05",0,0,0,0,0,0,0,0
"Malaysia","2024-01-06",0,0,0,0,0,0,0,0
"Malaysia","2024-01-07",0,0,0,0,0,0,0,0
"Malaysia","2024-01-08",0,0,0,0,0,0,0,0
"Malaysia","2024-01-09",0,0,0,0,0,0,0,0
"Malaysia","2024-01-10",0,0,0,0,0,0,0,0
"Malaysia","2024-01-11",0,0,0,0,0,0,0,0
"Malaysia","2024-01-12",0,0,0,0,0,0,0,0
"Malaysia","2024-01-13",0,0,0,0,0,0,0,0
"Malaysia","2024-01-14",0,0,0,0,0,0,0,0
"Malaysia","2024-01-15",0,0,0,0,0,0,0,0
"Malaysia","2024-01-16",0,0,0,0,0,0,0,0
"Malaysia","2024-01-17",0,0,0,0,0,0,0,0
"Malaysia","2024-01-18",0,0,0,0,0,0,0,0
"Malaysia","2024-01-19",0,0,0,0,0,0,0,0
"Malaysia","2024-01-20",0,0,0,0,0,0,0,0
"Malaysia","2024-01-21",0,0,0,0,0,0,0,0
"Malaysia","2024-01-22",0,0,0,0,0,0,0,0
"Malaysia","2024-01-23",0,0,0,0,0,0,0,0
"Malaysia","2024-01-24",0,0,0,0,0,0,0,0
"Malaysia","2024-01-25",0,0,0,0,0,0,0,0
"Malaysia","2024-01-26",0,0,0,0,0,0,0,0
"Malaysia","2024-01-27",0,0,0,0,0,0,0,0
"Malaysia","2024-01-28",0,0,0,0,0,0,0,0
"Malaysia","2024-01-29",0,0,0,0,0,0,0,0
"Malaysia","2024-01-30",0,0,0,0,0,0,0,0
"Malaysia","2024-01-31",0,0,0,0,0,0,0,0
"Malaysia","2024-02-01",0,0,0,0,0,0,0,0
"Malaysia","2024-02-02",0,0,0,0,0,0,0,0
"Malaysia","2024-02-03",0,0,0,0,0,0,0,0
"Malaysia","2024-02-04",0,0,0,0,0,0,0,0
"Malaysia","2024-02-05",0,0,0,0,0,0,0,0
"Malaysia","2024-02-06",0,0,0,0,0,0,0,0
"Malaysia","2024-02-07",0,0,0,0,0,0,0,0
"Malaysia","2024-02-08",0,0,0,0,0,0,0,0
"Malaysia","2024-02-09",0,0,0,0,0,0,0,0
"Malaysia","2024-02-10",0,0,0,0,0,0,0,0
"Malaysia","2024-02-11",0,0,0,0,0,0,0,0
"Malaysia","2024-02-12",0,0,0,0,0,0,0,0
"Malaysia","2024-02-13",0,0,0,0,0,0,0,0
"Malaysia","2024-02-14",0,0,0,0,0,0,0,0
"Malaysia","2024-02-15",0,0,0,0,0,0,0,0
"Malaysia","2024-02-16",0,0,0,0,0,0,0,0
"Malaysia","2024-02-17",0,0,0,0,0,0,0,0
"Malaysia","2024-02-18",0,0,0,0,0,0,0,0
"Malaysia","2024-02-19",0,0,0,0,0,0,0,0
"Malaysia","2024-02-20",0,0,0,0,0,0,0,0
"Malaysia","2024-02-21",0,0,0,0,0,0,0,0
"Malaysia","2024-02-22",0,0,0,0,0,0,0,0
"Malaysia","2024-02-23",0,0,0,0,0,0,0,0
"Malaysia","2024-02-24",0,0,0,0,0,0,0,0
"Malaysia","2024-02-25",0,0,0,0,0,0,0,0
"Malaysia","2024-02-26",0,0,0,0,0,0,0,0
"Malaysia","2024-02-27",0,0,0,0,0,0,0,0
"Malaysia","2024-02-28",0,0,0,0,0,0,0,0
"Malaysia","2024-02-29",0,0,0,0,0,0,0,0
"Malaysia","2024-03-01",0,0,0,0,0,0,0,0
"Malaysia","2024-03-02",0,0,0,0,0,0,0,0
"Malaysia","2024-03-03",0,0,0,0,0,0,0,0
"Malaysia","2024-03-04",0,0,0,0,0,0,0,0
"Malaysia","2024-03-05",0,0,0,0,0,0,0,0
"Malaysia","2024-03-06",0,0,0,0,0,0,0,0
"Malaysia","2024-03-07",0,0,0,0,0,0,0,0
"Malaysia","2024-03-08",0,0,0,0,0,0,0,0
"Malaysia","2024-03-09",0,0,0,0,0,0,0,0
"Malaysia","2024-03-10",0,0,0,0,0,0,0,0
"Malaysia","2024-03-11",0,0,0,0,0,0,0,0
"Malaysia","2024-03-12",0,0,0,0,0,0,0,0
"Malaysia","2024-03-13",0,0,0,0,0,0,0,0
"Malaysia","2024-03-14",0,0,0,0,0,0,0,0
"Malaysia","2024-03-15",0,0,0,0,0,0,0,0
"Malaysia","2024-03-16",0,0,0,0,0,0,0,0
"Malaysia","2024-03-17",0,0,0,0,0,0,0,0
"Malaysia","2024-03-18",0,0,0,0,0,0,0,0
"Malaysia","2024-03-19",0,0,0,0,0,0,0,0
"Malaysia","2024-03-20",0,0,0,0,0,0,0,0
"Malaysia","2024-03-21",0,0,0,0,0,0,0,0
"Malaysia","2024-03-22",0,0,0,0,0,0,0,0
"Malaysia","2024-03-23",0,0,0,0,0,0,0,0
"Malaysia","2024-03-24",0,0,0,0,0,0,0,0
"Malaysia","2024-03-25",0,0,0,0,0,0,0,0
"Malaysia","2024-03-26",0,0,0,0,0,0,0,0
"Malaysia","2024-03-27",0,0,0,0,0,0,0,0
"Malaysia","2024-03-28",0,0,0,0,0,0,0,0
"Malaysia","2024-03-29",0,0,0,0,0,0,0,0
"Malaysia","2024-03-30",0,0,0,0,0,0,0,0
"Malaysia","2024-03-31",0,0,0,0,0,0,0,0
"Malaysia","2024-04-01",0,0,0,0,0,0,0,0
"Malaysia","2024-04-02",0,0,0,0,0,0,0,0
"Malaysia","2024-04-03",0,0,0,0,0,0,0,0
"Malaysia","2024-04-04",0,0,0,0,0,0,0,0
"Malaysia","2024-04-05",0,0,0,0,0,0,0,0
"Malaysia","2024-04-06",0,0,0,0,0,0,0,0
"Malaysia","2024-04-07",0,0,0,0,0,0,0,0
"Malaysia","2024-04-08",0,0,0,0,0,0,0,0
"Malaysia","2024-04-09",0,0,0,0,0,0,0,0
"Malaysia","2024-04-10",0,0,0,0,0,0,0,0
"Malaysia","2024-04-11",0,0,0,0,0,0,0,0
"Malaysia","2024-04-12",0,0,0,0,0,0,0,0
"Malaysia","2024-04-13",0,0,0,0,0,0,0,0
"Malaysia","2024-04-14",0,0,0,0,0,0,0,0
"Malaysia","2024-04-15",0,0,0,0,0,0,0,0
"Malaysia","2024-04-16",0,0,0,0,0,0,0,0
"Malaysia","2024-04-17",0,0,0,0,0,0,0,0
"Malaysia","2024-04-18",0,0,0,0,0,0,0,0
"Malaysia","2024-04-19",0,0,0,0,0,0,0,0
"Malaysia","2024-04-20",0,0,0,0,0,0,0,0
"Malaysia","2024-04-21",0,0,0,0,0,0,0,0
"Malaysia","2024-04-22",0,0,0,0,0,0,0,0
"Malaysia","2024-04-23",0,0,0,0,0,0,0,0
"Malaysia","2024-04-24",0,0,0,0,0,0,0,0
"Malaysia","2024-04-25",0,0,0,0,0,0,0,0
"Malaysia","2024-04-26",0,0,0,0,0,0,0,0
"Malaysia","2024-04-27",0,0,0,0,0,0,0,0
"Malaysia","2024-04-28",0,0,0,0,0,0,0,0
"Malaysia","2024-04-29",0,0,0,0,0,0,0,0
"Malaysia","2024-04-30",0,0,0,0,0,0,0,0
"Malaysia","2024-05-01",0,0,0,0,0,0,0,0
"Malaysia","2024-05-02",0,0,0,0,0,0,0,0
"Malaysia","2024-05-03",0,0,0,0,0,0,0,0
"Malaysia","2024-05-04",0,0,0,0,0,0,0,0
"Malaysia","2024-05-05",0,0,0,0,0,0,0,0
"Malaysia","2024-05-06",0,0,0,0,0,0,0,0
"Malaysia","2024-05-07",0,0,0,0,0,0,0,0
"Malaysia","2024-05-08",0,0,0,0,0,0,0,0
"Malaysia","2024-05-09",0,0,0,0,0,0,0,0
"Malaysia","2024-05-10",0,0,0,0,0,0,0,0
"Malaysia","2024-05-11",0,0,0,0,0,0,0,0
"Malaysia","2024-05-12",0,0,0,0,0,0,0,0
"Malaysia","2024-05-13",0,0,0,0,0,0,0,0
"Malaysia","2024-05-14",0,0,0,0,0,0,0,0
"Malaysia","2024-05-15",0,0,0,0,0,0,0,0
"Malaysia","2024-05-16",0,0,0,0,0,0,0,0
"Malaysia","2024-05-17",0,0,0,0,0,0,0,0
"Malaysia","2024-05-18",0,0,0,0,0,0,0,0
"Malaysia","2024-05-19",0,0,0,0,0,0,0,0
"Malaysia","2024-05-20",0,0,0,0,0,0,0,0
"Malaysia","2024-05-21",0,0,0,0,0,0,0,0
"Malaysia","2024-05-22",0,0,0,0,0,0,0,0
"Malaysia","2024-05-23",0,0,0,0,0,0,0,0
"Malaysia","2024-05-24",0,0,0,0,0,0,0,0
"Malaysia","2024-05-25",0,0,0,0,0,0,0,0
"Malaysia","2024-05-26",0,0,0,0,0,0,0,0
"Malaysia","2024-05-27",0,0,0,0,0,0,0,0
"Malaysia","2024-05-28",0,0,0,0,0,0,0,0
"Malaysia","2024-05-29",0,0,0,0,0,0,0,0
"Malaysia","2024-05-30",0,0,0,0,0,0,0,0
"Malaysia","2024-05-31",0,0,0,0,0,0,0,0
"Malaysia","2024-06-01",0,0,0,0,0,0,0,0
"Malaysia","2024-06-02",0,0,0,0,0,0,0,0
"Malaysia","2024-06-03",0,0,0,0,0,0,0,0
"Malaysia","2024-06-04",0,0,0,0,0,0,0,0
"Malaysia","2024-06-05",0,0,0,0,0,0,0,0
"Malaysia","2024-06-06",0,0,0,0,0,0,0,0
"Malaysia","2024-06-07",0,0,0,0,0,0,0,0
"Malaysia","2024-06-08",0,0,0,0,0,0,0,0
"Malaysia","2024-06-09",0,0,0,0,0,0,0,0
"Malaysia","2024-06-10",0,0,0,0,0,0,0,0
"Malaysia","2024-06-11",0,0,0,0,0,0,0,0
"Malaysia","2024-06-12",0,0,0,0,0,0,0,0
"Malaysia","2024-06-13",0,0,0,0,0,0,0,0
"Malaysia","2024-06-14",0,0,0,0,0,0,0,0
"Malaysia","2024-06-15",0,0,0,0,0,0,0,0
"Malaysia","2024-06-16",0,0,0,0,0,0,0,0
"Malaysia","2024-06-17",0,0,0,0,0,0,0,0
"Malaysia","2024-06-18",0,0,0,0,0,0,0,0
"Malaysia","2024-06-19",0,0,0,0,0,0,0,0
"Malaysia","2024-06-20",0,0,0,0,0,0,0,0
"Malaysia","2024-06-21",0,0,0,0,0,0,0,0
"Malaysia","2024-06-22",0,0,0,0,0,0,0,0
"Malaysia","2024-06-23",0,0,0,0,0,0,0,0
"Malaysia","2024-06-24",0,0,0,0,0,0,0,0
"Malaysia","2024-06-25",0,0,0,0,0,0,0,0
"Malaysia","2024-06-26",0,0,0,0,0,0,0,0
"Malaysia","2024-06-27",0,0,0,0,0,0,0,0
"Malaysia","2024-06-28",0,0,0,0,0,0,0,0
"Malaysia","2024-06-29",0,0,0,0,0,0,0,0
"Malaysia","2024-06-30",0,0,0,0,0,0,0,0
"Malaysia","2024-07-01",0,0,0,0,0,0,0,0
"Malaysia","2024-07-02",0,0,0,0,0,0,0,0
"Malaysia","2024-07-03",0,0,0,0,0,0,0,0
"Malaysia","2024-07-04",0,0,0,0,0,0,0,0
"Malaysia","2024-07-05",0,0,0,0,0,0,0,0
"Malaysia","2024-07-06",0,0,0,0,0,0,0,0
"Malaysia","2024-07-07",0,0,0,0,0,0,0,0
"Malaysia","2024-07-08",0,0,0,0,0,0,0,0
"Malaysia","2024-07-09",0,0,0,0,0,0,0,0
"Malaysia","2024-07-10",0,0,0,0,0,0,0,0
"Malaysia","2024-07-11",0,0,0,0,0,0,0,0
"Malaysia","2024-07-12",0,0,0,0,0,0,0,0
"Malaysia","2024-07-13",0,0,0,0,0,0,0,0
"Malaysia","2024-07-14",0,0,0,0,0,0,0,0
"Malaysia","2024-07-15",0,0,0,0,0,0,0,0
"Malaysia","2024-07-16",0,0,0,0,0,0,0,0
"Malaysia","2024-07-17",0,0,0,0,0,0,0,0
"Malaysia","2024-07-18",0,0,0,0,0,0,0,0
"Malaysia","2024-07-19",0,0,0,0,0,0,0,0
"Malaysia","2024-07-20",0,0,0,0,0,0,0,0
"Malaysia","2024-07-21",0,0,0,0,0,0,0,0
"Malaysia","2024-07-22",0,0,0,0,0,0,0,0
"Malaysia","2024-07-23",0,0,0,0,0,0,0,0
"Malaysia","2024-07-24",0,0,0,0,0,0,0,0
"Malaysia","2024-07-25",0,0,0,0,0,0,0,0
"Malaysia","2024-07-26",0,0,0,0,0,0,0,0
"Malaysia","2024-07-27",0,0,0,0,0,0,0,0
"Malaysia","2024-07-28",0,0,0,0,0,0,0,0
"Malaysia","2024-07-29",0,0,0,0,0,0,0,0
"Malaysia","2024-07-30",0,0,0,0,0,0,0,0
"Malaysia","2024-07-31",0,0,0,0,0,0,0,0
"Malaysia","2024-08-01",0,0,0,0,0,0,0,0
"Malaysia","2024-08-02",0,0,0,0,0,0,0,0
"Malaysia","2024-08-03",0,0,0,0,0,0,0,0
"Malaysia","2024-08-04",0,0,0,0,0,0,0,0
"Malaysia","2024-08-05",0,0,0,0,0,0,0,0
"Malaysia","2024-08-06",0,0,0,0,0,0,0,0
"Malaysia","2024-08-07",0,0,0,0,0,0,0,0
"Malaysia","2024-08-08",0,0,0,0,0,0,0,0
"Malaysia","2024-08-09",0,0,0,0,0,0,0,0
"Malaysia","2024-08-10",0,0,0,0,0,0,0,0
"Malaysia","2024-08-11",0,0,0,0,0,0,0,0
"Malaysia","2024-08-12",0,0,0,0,0,0,0,0
"Malaysia","2024-08-13",0,0,0,0,0,0,0,0
"Malaysia","2024-08-14",0,0,0,0,0,0,0,0
"Malaysia","2024-08-15",0,0,0,0,0,0,0,0
"Malaysia","2024-08-16",0,0,0,0,0,0,0,0
"Malaysia","2024-08-17",0,0,0,0,0,0,0,0
"Malaysia","2024-08-18",0,0,0,0,0,0,0,0
"Malaysia","2024-08-19",0,0,0,0,0,0,0,0
"Malaysia","2024-08-20",0,0,0,0,0,0,0,0
"Malaysia","2024-08-21",0,0,0,0,0,0,0,0
"Malaysia","2024-08-22",0,0,0,0,0,0,0,0
"Malaysia","2024-08-23",0,0,0,0,0,0,0,0
"Malaysia","2024-08-24",0,0,0,0,0,0,0,0
"Malaysia","2024-08-25",0,0,0,0,0,0,0,0
"Malaysia","2024-08-26",0,0,0,0,0,0,0,0
"Malaysia","2024-08-27",0,0,0,0,0,0,0,0
"Malaysia","2024-08-28",0,0,0,0,0,0,0,0
"Malaysia","2024-08-29",0,0,0,0,0,0,0,0
"Malaysia","2024-08-30",0,0,0,0,0,0,0,0
"Malaysia","2024-08-31",0,0,0,0,0,0,0,0
"Malaysia","2024-09-01",0,0,0,0,0,0,0,0
"Malaysia","2024-09-02",0,0,0,0,0,0,0,0
"Malaysia","2024-09-03",0,0,0,0,0,0,0,0
"Malaysia","2024-09-04",0,0,0,0,0,0,0,0
"Malaysia","2024-09-05",0,0,0,0,0,0,0,0
"Malaysia","2024-09-06",0,0,0,0,0,0,0,0
"Malaysia","2024-09-07",0,0,0,0,0,0,0,0
"Malaysia","2024-09-08",0,0,0,0,0,0,0,0
"Malaysia","2024-09-09",0,0,0,0,0,0,0,0
"Malaysia","2024-09-10",0,0,0,0,0,0,0,0
"Malaysia","2024-09-11",0,0,0,0,0,0,0,0
"Malaysia","2024-09-12",0,0,0,0,0,0,0,0
"Malaysia","2024-09-13",0,0,0,0,0,0,0,0
"Malaysia","2024-09-14",0,0,0,0,0,0,0,0
"Malaysia","2024-09-15",0,0,0,0,0,0,0,0
"Malaysia","2024-09-16",0,0,0,0,0,0,0,0
"Malaysia","2024-09-17",0,0,0,0,0,0,0,0
"Malaysia","2024-09-18",0,1,1,0,1,1,0,0
"Malaysia","2024-09-19",0,0,1,0,0,1,0,0
"Malaysia","2024-09-20",0,0,1,0,0,1,0,0
"Malaysia","2024-09-21",0,0,1,0,0,1,0,0
"Malaysia","2024-09-22",0,0,1,0,0,1,0,0
"Malaysia","2024-09-23",0,0,1,0,0,1,0,0
"Malaysia","2024-09-24",0,0,1,0,0,1,0,0
"Malaysia","2024-09-25",0,0,1,0,0,1,0,0
"Malaysia","2024-09-26",0,0,1,0,0,1,0,0
"Malaysia","2024-09-27",0,0,1,0,0,1,0,0
"Malaysia","2024-09-28",0,0,1,0,0,1,0,0
"Malaysia","2024-09-29",0,0,1,0,0,1,0,0
"Malaysia","2024-09-30",0,0,1,0,0,1,0,0
"Malaysia","2024-10-01",0,0,1,0,0,1,0,0
"Malaysia","2024-10-02",0,0,1,0,0,1,0,0
"Malaysia","2024-10-03",0,0,1,0,0,1,0,0
"Malaysia","2024-10-04",0,0,1,0,0,1,0,0
"Malaysia","2024-10-05",0,0,1,0,0,1,0,0
"Malaysia","2024-10-06",0,0,1,0,0,1,0,0
"Malaysia","2024-10-07",0,0,1,0,0,1,0,0
"Malaysia","2024-10-08",0,0,1,0,0,1,0,0
"Malaysia","2024-10-09",0,0,1,0,0,1,0,0
"Malaysia","2024-10-10",0,0,1,0,0,1,0,0
"Malaysia","2024-10-11",0,0,1,0,0,1,0,0
"Malaysia","2024-10-12",0,0,1,0,0,1,0,0
"Malaysia","2024-10-13",0,0,1,0,0,1,0,0
"Malaysia","2024-10-14",0,0,1,0,0,1,0,0
"Malaysia","2024-10-15",0,0,1,0,0,1,0,0
"Malaysia","2024-10-16",0,0,1,0,0,1,0,0
"Malaysia","2024-10-17",0,0,1,0,0,1,0,0
"Malaysia","2024-10-18",0,0,1,0,0,1,0,0
"Malaysia","2024-10-19",0,0,1,0,0,1,0,0
"Malaysia","2024-10-20",0,0,1,0,0,1,0,0
"Malaysia","2024-10-21",0,0,1,0,0,1,0,0
"Malaysia","2024-10-22",0,0,1,0,0,1,0,0
"Malaysia","2024-10-23",0,0,1,0,0,1,0,0
"Malaysia","2024-10-24",0,0,1,0,0,1,0,0
"Malaysia","2024-10-25",0,0,1,0,0,1,0,0
"Malaysia","2024-10-26",0,0,1,0,0,1,0,0
"Malaysia","2024-10-27",0,0,1,0,0,1,0,0
"Malaysia","2024-10-28",0,0,1,0,0,1,0,0
"Malaysia","2024-10-29",0,0,1,0,0,1,0,0
"Malaysia","2024-10-30",0,0,1,0,0,1,0,0
"Malaysia","2024-10-31",0,0,1,0,0,1,0,0
"Malaysia","2024-11-01",0,0,1,0,0,1,0,0
"Malaysia","2024-11-02",0,0,1,0,0,1,0,0
"Malaysia","2024-11-03",0,0,1,0,0,1,0,0
"Malaysia","2024-11-04",0,0,1,0,0,1,0,0
"Malaysia","2024-11-05",0,0,1,0,0,1,0,0
"Malaysia","2024-11-06",0,0,1,0,0,1,0,0
"Malaysia","2024-11-07",0,0,1,0,0,1,0,0
"Malaysia","2024-11-08",0,0,1,0,0,1,0,0
"Malaysia","2024-11-09",0,0,1,0,0,1,0,0
"Malaysia","2024-11-10",0,0,1,0,0,1,0,0
"Malaysia","2024-11-11",0,0,1,0,0,1,0,0
"Malaysia","2024-11-12",0,0,1,0,0,1,0,0
"Malaysia","2024-11-13",0,0,1,0,0,1,0,0
"Malaysia","2024-11-14",0,0,1,0,0,1,0,0
"Malaysia","2024-11-15",0,0,1,0,0,1,0,0
"Malaysia","2024-11-16",0,0,1,0,0,1,0,0
"Malaysia","2024-11-17",0,0,1,0,0,1,0,0
"Malaysia","2024-11-18",0,0,1,0,0,1,0,0
"Malaysia","2024-11-19",0,0,1,0,0,1,0,0
"Malaysia","2024-11-20",0,0,1,0,0,1,0,0
"Malaysia","2024-11-21",0,0,1,0,0,1,0,0
"Malaysia","2024-11-22",0,0,1,0,0,1,0,0
"Malaysia","2024-11-23",0,0,1,0,0,1,0,0
"Malaysia","2024-11-24",0,0,1,0,0,1,0,0
"Malaysia","2024-11-25",0,0,1,0,0,1,0,0
"Malaysia","2024-11-26",0,0,1,0,0,1,0,0
"Malaysia","2024-11-27",0,0,1,0,0,1,0,0
"Malaysia","2024-11-28",0,0,1,0,0,1,0,0
"Malaysia","2024-11-29",0,0,1,0,0,1,0,0
"Malaysia","2024-11-30",0,0,1,0,0,1,0,0
"Malaysia","2024-12-01",0,0,1,0,0,1,0,0
"Malaysia","2024-12-02",0,0,1,0,0,1,0,0
"Malaysia","2024-12-03",0,0,1,0,0,1,0,0
"Malaysia","2024-12-04",0,0,1,0,0,1,0,0
"Malaysia","2024-12-05",0,0,1,0,0,1,0,0
"Malaysia","2024-12-06",0,0,1,0,0,1,0,0
"Malaysia","2024-12-07",0,0,1,0,0,1,0,0
"Malaysia","2024-12-08",0,0,1,0,0,1,0,0
"Malaysia","2024-12-09",0,0,1,0,0,1,0,0
"Malta","2024-01-01",0,0,0,0,0,0,0,0
"Malta","2024-01-02",0,0,0,0,0,0,0,0
"Malta","2024-01-03",0,0,0,0,0,0,0,0
"Malta","2024-01-04",0,0,0,0,0,0,0,0
"Malta","2024-01-05",0,0,0,0,0,0,0,0
"Malta","2024-01-06",0,0,0,0,0,0,0,0
"Malta","2024-01-07",0,0,0,0,0,0,0,0
"Malta","2024-01-08",0,0,0,0,0,0,0,0
"Malta","2024-01-09",0,0,0,0,0,0,0,0
"Malta","2024-01-10",0,0,0,0,0,0,0,0
"Malta","2024-01-11",0,0,0,0,0,0,0,0
"Malta","2024-01-12",0,0,0,0,0,0,0,0
"Malta","2024-01-13",0,0,0,0,0,0,0,0
"Malta","2024-01-14",0,0,0,0,0,0,0,0
"Malta","2024-01-15",0,0,0,0,0,0,0,0
"Malta","2024-01-16",0,0,0,0,0,0,0,0
"Malta","2024-01-17",0,0,0,0,0,0,0,0
"Malta","2024-01-18",0,0,0,0,0,0,0,0
"Malta","2024-01-19",0,0,0,0,0,0,0,0
"Malta","2024-01-20",0,0,0,0,0,0,0,0
"Malta","2024-01-21",0,0,0,0,0,0,0,0
"Malta","2024-01-22",0,0,0,0,0,0,0,0
"Malta","2024-01-23",0,0,0,0,0,0,0,0
"Malta","2024-01-24",0,0,0,0,0,0,0,0
"Malta","2024-01-25",0,0,0,0,0,0,0,0
"Malta","2024-01-26",0,0,0,0,0,0,0,0
"Malta","2024-01-27",0,0,0,0,0,0,0,0
"Malta","2024-01-28",0,0,0,0,0,0,0,0
"Malta","2024-01-29",0,0,0,0,0,0,0,0
"Malta","2024-01-30",0,0,0,0,0,0,0,0
"Malta","2024-01-31",0,0,0,0,0,0,0,0
"Malta","2024-02-01",0,0,0,0,0,0,0,0
"Malta","2024-02-02",0,0,0,0,0,0,0,0
"Malta","2024-02-03",0,0,0,0,0,0,0,0
"Malta","2024-02-04",0,0,0,0,0,0,0,0
"Malta","2024-02-05",0,0,0,0,0,0,0,0
"Malta","2024-02-06",0,0,0,0,0,0,0,0
"Malta","2024-02-07",0,0,0,0,0,0,0,0
"Malta","2024-02-08",0,0,0,0,0,0,0,0
"Malta","2024-02-09",0,0,0,0,0,0,0,0
"Malta","2024-02-10",0,0,0,0,0,0,0,0
"Malta","2024-02-11",0,0,0,0,0,0,0,0
"Malta","2024-02-12",0,0,0,0,0,0,0,0
"Malta","2024-02-13",0,0,0,0,0,0,0,0
"Malta","2024-02-14",0,0,0,0,0,0,0,0
"Malta","2024-02-15",0,0,0,0,0,0,0,0
"Malta","2024-02-16",0,0,0,0,0,0,0,0
"Malta","2024-02-17",0,0,0,0,0,0,0,0
"Malta","2024-02-18",0,0,0,0,0,0,0,0
"Malta","2024-02-19",0,0,0,0,0,0,0,0
"Malta","2024-02-20",0,0,0,0,0,0,0,0
"Malta","2024-02-21",0,0,0,0,0,0,0,0
"Malta","2024-02-22",0,0,0,0,0,0,0,0
"Malta","2024-02-23",0,0,0,0,0,0,0,0
"Malta","2024-02-24",0,0,0,0,0,0,0,0
"Malta","2024-02-25",0,0,0,0,0,0,0,0
"Malta","2024-02-26",0,0,0,0,0,0,0,0
"Malta","2024-02-27",0,0,0,0,0,0,0,0
"Malta","2024-02-28",0,0,0,0,0,0,0,0
"Malta","2024-02-29",0,0,0,0,0,0,0,0
"Malta","2024-03-01",0,0,0,0,0,0,0,0
"Malta","2024-03-02",0,0,0,0,0,0,0,0
"Malta","2024-03-03",0,0,0,0,0,0,0,0
"Malta","2024-03-04",0,0,0,0,0,0,0,0
"Malta","2024-03-05",0,0,0,0,0,0,0,0
"Malta","2024-03-06",0,0,0,0,0,0,0,0
"Malta","2024-03-07",0,0,0,0,0,0,0,0
"Malta","2024-03-08",0,0,0,0,0,0,0,0
"Malta","2024-03-09",0,0,0,0,0,0,0,0
"Malta","2024-03-10",0,0,0,0,0,0,0,0
"Malta","2024-03-11",0,0,0,0,0,0,0,0
"Malta","2024-03-12",0,0,0,0,0,0,0,0
"Malta","2024-03-13",0,0,0,0,0,0,0,0
"Malta","2024-03-14",0,0,0,0,0,0,0,0
"Malta","2024-03-15",0,0,0,0,0,0,0,0
"Malta","2024-03-16",0,0,0,0,0,0,0,0
"Malta","2024-03-17",0,0,0,0,0,0,0,0
"Malta","2024-03-18",0,0,0,0,0,0,0,0
"Malta","2024-03-19",0,0,0,0,0,0,0,0
"Malta","2024-03-20",0,0,0,0,0,0,0,0
"Malta","2024-03-21",0,0,0,0,0,0,0,0
"Malta","2024-03-22",0,0,0,0,0,0,0,0
"Malta","2024-03-23",0,0,0,0,0,0,0,0
"Malta","2024-03-24",0,0,0,0,0,0,0,0
"Malta","2024-03-25",0,0,0,0,0,0,0,0
"Malta","2024-03-26",0,0,0,0,0,0,0,0
"Malta","2024-03-27",0,0,0,0,0,0,0,0
"Malta","2024-03-28",0,0,0,0,0,0,0,0
"Malta","2024-03-29",0,0,0,0,0,0,0,0
"Malta","2024-03-30",0,0,0,0,0,0,0,0
"Malta","2024-03-31",0,0,0,0,0,0,0,0
"Malta","2024-04-01",0,0,0,0,0,0,0,0
"Malta","2024-04-02",0,0,0,0,0,0,0,0
"Malta","2024-04-03",0,0,0,0,0,0,0,0
"Malta","2024-04-04",0,0,0,0,0,0,0,0
"Malta","2024-04-05",0,0,0,0,0,0,0,0
"Malta","2024-04-06",0,0,0,0,0,0,0,0
"Malta","2024-04-07",0,0,0,0,0,0,0,0
"Malta","2024-04-08",0,0,0,0,0,0,0,0
"Malta","2024-04-09",0,0,0,0,0,0,0,0
"Malta","2024-04-10",0,0,0,0,0,0,0,0
"Malta","2024-04-11",0,0,0,0,0,0,0,0
"Malta","2024-04-12",0,0,0,0,0,0,0,0
"Malta","2024-04-13",0,0,0,0,0,0,0,0
"Malta","2024-04-14",0,0,0,0,0,0,0,0
"Malta","2024-04-15",0,0,0,0,0,0,0,0
"Malta","2024-04-16",0,0,0,0,0,0,0,0
"Malta","2024-04-17",0,0,0,0,0,0,0,0
"Malta","2024-04-18",0,0,0,0,0,0,0,0
"Malta","2024-04-19",0,0,0,0,0,0,0,0
"Malta","2024-04-20",0,0,0,0,0,0,0,0
"Malta","2024-04-21",0,0,0,0,0,0,0,0
"Malta","2024-04-22",0,0,0,0,0,0,0,0
"Malta","2024-04-23",0,0,0,0,0,0,0,0
"Malta","2024-04-24",0,0,0,0,0,0,0,0
"Malta","2024-04-25",0,0,0,0,0,0,0,0
"Malta","2024-04-26",0,0,0,0,0,0,0,0
"Malta","2024-04-27",0,0,0,0,0,0,0,0
"Malta","2024-04-28",0,0,0,0,0,0,0,0
"Malta","2024-04-29",0,0,0,0,0,0,0,0
"Malta","2024-04-30",0,0,0,0,0,0,0,0
"Malta","2024-05-01",0,0,0,0,0,0,0,0
"Malta","2024-05-02",0,0,0,0,0,0,0,0
"Malta","2024-05-03",0,0,0,0,0,0,0,0
"Malta","2024-05-04",0,0,0,0,0,0,0,0
"Malta","2024-05-05",0,0,0,0,0,0,0,0
"Malta","2024-05-06",0,0,0,0,0,0,0,0
"Malta","2024-05-07",0,0,0,0,0,0,0,0
"Malta","2024-05-08",0,0,0,0,0,0,0,0
"Malta","2024-05-09",0,0,0,0,0,0,0,0
"Malta","2024-05-10",0,0,0,0,0,0,0,0
"Malta","2024-05-11",0,0,0,0,0,0,0,0
"Malta","2024-05-12",0,0,0,0,0,0,0,0
"Malta","2024-05-13",0,0,0,0,0,0,0,0
"Malta","2024-05-14",0,0,0,0,0,0,0,0
"Malta","2024-05-15",0,0,0,0,0,0,0,0
"Malta","2024-05-16",0,0,0,0,0,0,0,0
"Malta","2024-05-17",0,0,0,0,0,0,0,0
"Malta","2024-05-18",0,0,0,0,0,0,0,0
"Malta","2024-05-19",0,0,0,0,0,0,0,0
"Malta","2024-05-20",0,0,0,0,0,0,0,0
"Malta","2024-05-21",0,0,0,0,0,0,0,0
"Malta","2024-05-22",0,0,0,0,0,0,0,0
"Malta","2024-05-23",0,0,0,0,0,0,0,0
"Malta","2024-05-24",0,0,0,0,0,0,0,0
"Malta","2024-05-25",0,0,0,0,0,0,0,0
"Malta","2024-05-26",0,0,0,0,0,0,0,0
"Malta","2024-05-27",0,0,0,0,0,0,0,0
"Malta","2024-05-28",0,0,0,0,0,0,0,0
"Malta","2024-05-29",0,0,0,0,0,0,0,0
"Malta","2024-05-30",0,0,0,0,0,0,0,0
"Malta","2024-05-31",0,0,0,0,0,0,0,0
"Malta","2024-06-01",0,0,0,0,0,0,0,0
"Malta","2024-06-02",0,0,0,0,0,0,0,0
"Malta","2024-06-03",0,0,0,0,0,0,0,0
"Malta","2024-06-04",0,0,0,0,0,0,0,0
"Malta","2024-06-05",0,0,0,0,0,0,0,0
"Malta","2024-06-06",0,0,0,0,0,0,0,0
"Malta","2024-06-07",0,0,0,0,0,0,0,0
"Malta","2024-06-08",0,0,0,0,0,0,0,0
"Malta","2024-06-09",0,0,0,0,0,0,0,0
"Malta","2024-06-10",0,0,0,0,0,0,0,0
"Malta","2024-06-11",0,0,0,0,0,0,0,0
"Malta","2024-06-12",0,0,0,0,0,0,0,0
"Malta","2024-06-13",0,0,0,0,0,0,0,0
"Malta","2024-06-14",0,0,0,0,0,0,0,0
"Malta","2024-06-15",0,0,0,0,0,0,0,0
"Malta","2024-06-16",0,0,0,0,0,0,0,0
"Malta","2024-06-17",0,0,0,0,0,0,0,0
"Malta","2024-06-18",0,0,0,0,0,0,0,0
"Malta","2024-06-19",0,0,0,0,0,0,0,0
"Malta","2024-06-20",0,0,0,0,0,0,0,0
"Malta","2024-06-21",0,0,0,0,0,0,0,0
"Malta","2024-06-22",0,0,0,0,0,0,0,0
"Malta","2024-06-23",0,0,0,0,0,0,0,0
"Malta","2024-06-24",0,0,0,0,0,0,0,0
"Malta","2024-06-25",0,0,0,0,0,0,0,0
"Malta","2024-06-26",0,0,0,0,0,0,0,0
"Malta","2024-06-27",0,0,0,0,0,0,0,0
"Malta","2024-06-28",0,0,0,0,0,0,0,0
"Malta","2024-06-29",0,0,0,0,0,0,0,0
"Malta","2024-06-30",0,0,0,0,0,0,0,0
"Malta","2024-07-01",0,0,0,0,0,0,0,0
"Malta","2024-07-02",0,0,0,0,0,0,0,0
"Malta","2024-07-03",0,0,0,0,0,0,0,0
"Malta","2024-07-04",0,0,0,0,0,0,0,0
"Malta","2024-07-05",0,0,0,0,0,0,0,0
"Malta","2024-07-06",0,0,0,0,0,0,0,0
"Malta","2024-07-07",0,0,0,0,0,0,0,0
"Malta","2024-07-08",0,0,0,0,0,0,0,0
"Malta","2024-07-09",0,0,0,0,0,0,0,0
"Malta","2024-07-10",0,0,0,0,0,0,0,0
"Malta","2024-07-11",0,0,0,0,0,0,0,0
"Malta","2024-07-12",0,0,0,0,0,0,0,0
"Malta","2024-07-13",0,0,0,0,0,0,0,0
"Malta","2024-07-14",0,0,0,0,0,0,0,0
"Malta","2024-07-15",0,0,0,0,0,0,0,0
"Malta","2024-07-16",0,0,0,0,0,0,0,0
"Malta","2024-07-17",0,0,0,0,0,0,0,0
"Malta","2024-07-18",0,0,0,0,0,0,0,0
"Malta","2024-07-19",0,0,0,0,0,0,0,0
"Malta","2024-07-20",0,0,0,0,0,0,0,0
"Malta","2024-07-21",0,0,0,0,0,0,0,0
"Malta","2024-07-22",0,0,0,0,0,0,0,0
"Malta","2024-07-23",0,0,0,0,0,0,0,0
"Malta","2024-07-24",0,0,0,0,0,0,0,0
"Malta","2024-07-25",0,0,0,0,0,0,0,0
"Malta","2024-07-26",0,0,0,0,0,0,0,0
"Malta","2024-07-27",0,0,0,0,0,0,0,0
"Malta","2024-07-28",0,0,0,0,0,0,0,0
"Malta","2024-07-29",0,0,0,0,0,0,0,0
"Malta","2024-07-30",0,0,0,0,0,0,0,0
"Malta","2024-07-31",0,0,0,0,0,0,0,0
"Malta","2024-08-01",0,0,0,0,0,0,0,0
"Malta","2024-08-02",0,0,0,0,0,0,0,0
"Malta","2024-08-03",0,0,0,0,0,0,0,0
"Malta","2024-08-04",0,0,0,0,0,0,0,0
"Malta","2024-08-05",0,0,0,0,0,0,0,0
"Malta","2024-08-06",0,0,0,0,0,0,0,0
"Malta","2024-08-07",0,0,0,0,0,0,0,0
"Malta","2024-08-08",0,0,0,0,0,0,0,0
"Malta","2024-08-09",0,0,0,0,0,0,0,0
"Malta","2024-08-10",0,0,0,0,0,0,0,0
"Malta","2024-08-11",0,0,0,0,0,0,0,0
"Malta","2024-08-12",0,0,0,0,0,0,0,0
"Malta","2024-08-13",0,0,0,0,0,0,0,0
"Malta","2024-08-14",0,0,0,0,0,0,0,0
"Malta","2024-08-15",0,0,0,0,0,0,0,0
"Malta","2024-08-16",0,0,0,0,0,0,0,0
"Malta","2024-08-17",0,0,0,0,0,0,0,0
"Malta","2024-08-18",0,0,0,0,0,0,0,0
"Malta","2024-08-19",0,0,0,0,0,0,0,0
"Malta","2024-08-20",0,0,0,0,0,0,0,0
"Malta","2024-08-21",0,0,0,0,0,0,0,0
"Malta","2024-08-22",0,0,0,0,0,0,0,0
"Malta","2024-08-23",0,0,0,0,0,0,0,0
"Malta","2024-08-24",0,0,0,0,0,0,0,0
"Malta","2024-08-25",0,0,0,0,0,0,0,0
"Malta","2024-08-26",0,0,0,0,0,0,0,0
"Malta","2024-08-27",0,0,0,0,0,0,0,0
"Malta","2024-08-28",0,0,0,0,0,0,0,0
"Malta","2024-08-29",0,0,0,0,0,0,0,0
"Malta","2024-08-30",0,0,0,0,0,0,0,0
"Malta","2024-08-31",0,2,2,0,2,2,0,0
"Malta","2024-09-01",0,0,2,0,0,2,0,0
"Malta","2024-09-02",0,0,2,0,0,2,0,0
"Malta","2024-09-03",0,0,2,0,0,2,0,0
"Malta","2024-09-04",0,0,2,0,0,2,0,0
"Malta","2024-09-05",0,0,2,0,0,2,0,0
"Malta","2024-09-06",0,0,2,0,0,2,0,0
"Malta","2024-09-07",0,0,2,0,0,2,0,0
"Malta","2024-09-08",0,0,2,0,0,2,0,0
"Malta","2024-09-09",0,0,2,0,0,2,0,0
"Malta","2024-09-10",0,0,2,0,0,2,0,0
"Malta","2024-09-11",0,0,2,0,0,2,0,0
"Malta","2024-09-12",0,0,2,0,0,2,0,0
"Malta","2024-09-13",0,0,2,0,0,2,0,0
"Malta","2024-09-14",0,0,2,0,0,2,0,0
"Malta","2024-09-15",0,0,2,0,0,2,0,0
"Malta","2024-09-16",0,0,2,0,0,2,0,0
"Malta","2024-09-17",0,0,2,0,0,2,0,0
"Malta","2024-09-18",0,0,2,0,0,2,0,0
"Malta","2024-09-19",0,0,2,0,0,2,0,0
"Malta","2024-09-20",0,0,2,0,0,2,0,0
"Malta","2024-09-21",0,0,2,0,0,2,0,0
"Malta","2024-09-22",0,0,2,0,0,2,0,0
"Malta","2024-09-23",0,0,2,0,0,2,0,0
"Malta","2024-09-24",0,0,2,0,0,2,0,0
"Malta","2024-09-25",0,0,2,0,0,2,0,0
"Malta","2024-09-26",0,0,2,0,0,2,0,0
"Malta","2024-09-27",0,0,2,0,0,2,0,0
"Malta","2024-09-28",0,0,2,0,0,2,0,0
"Malta","2024-09-29",0,0,2,0,0,2,0,0
"Malta","2024-09-30",0,0,2,0,0,2,0,0
"Malta","2024-10-01",0,0,2,0,1,3,0,0
"Malta","2024-10-02",0,0,2,0,0,3,0,0
"Malta","2024-10-03",0,0,2,0,0,3,0,0
"Malta","2024-10-04",0,0,2,0,0,3,0,0
"Malta","2024-10-05",0,0,2,0,0,3,0,0
"Malta","2024-10-06",0,0,2,0,0,3,0,0
"Malta","2024-10-07",0,0,2,0,0,3,0,0
"Malta","2024-10-08",0,0,2,0,0,3,0,0
"Malta","2024-10-09",0,0,2,0,0,3,0,0
"Malta","2024-10-10",0,0,2,0,0,3,0,0
"Malta","2024-10-11",0,0,2,0,0,3,0,0
"Malta","2024-10-12",0,0,2,0,0,3,0,0
"Malta","2024-10-13",0,0,2,0,0,3,0,0
"Malta","2024-10-14",0,0,2,0,0,3,0,0
"Malta","2024-10-15",0,0,2,0,0,3,0,0
"Malta","2024-10-16",0,0,2,0,0,3,0,0
"Malta","2024-10-17",0,0,2,0,0,3,0,0
"Malta","2024-10-18",0,0,2,0,0,3,0,0
"Malta","2024-10-19",0,0,2,0,0,3,0,0
"Malta","2024-10-20",0,0,2,0,0,3,0,0
"Malta","2024-10-21",0,0,2,0,0,3,0,0
"Malta","2024-10-22",0,0,2,0,0,3,0,0
"Malta","2024-10-23",0,0,2,0,0,3,0,0
"Malta","2024-10-24",0,0,2,0,0,3,0,0
"Malta","2024-10-25",0,0,2,0,0,3,0,0
"Malta","2024-10-26",0,0,2,0,0,3,0,0
"Malta","2024-10-27",0,0,2,0,0,3,0,0
"Malta","2024-10-28",0,0,2,0,0,3,0,0
"Malta","2024-10-29",0,0,2,0,0,3,0,0
"Malta","2024-10-30",0,0,2,0,0,3,0,0
"Malta","2024-10-31",0,1,3,0,0,3,0,0
"Malta","2024-11-01",0,0,3,0,0,3,0,0
"Malta","2024-11-02",0,0,3,0,0,3,0,0
"Malta","2024-11-03",0,0,3,0,0,3,0,0
"Malta","2024-11-04",0,0,3,0,0,3,0,0
"Malta","2024-11-05",0,0,3,0,0,3,0,0
"Malta","2024-11-06",0,0,3,0,0,3,0,0
"Malta","2024-11-07",0,0,3,0,0,3,0,0
"Malta","2024-11-08",0,0,3,0,0,3,0,0
"Malta","2024-11-09",0,0,3,0,0,3,0,0
"Malta","2024-11-10",0,0,3,0,0,3,0,0
"Malta","2024-11-11",0,0,3,0,0,3,0,0
"Malta","2024-11-12",0,0,3,0,0,3,0,0
"Malta","2024-11-13",0,0,3,0,0,3,0,0
"Malta","2024-11-14",0,0,3,0,0,3,0,0
"Malta","2024-11-15",0,0,3,0,0,3,0,0
"Malta","2024-11-16",0,0,3,0,0,3,0,0
"Malta","2024-11-17",0,0,3,0,0,3,0,0
"Malta","2024-11-18",0,0,3,0,0,3,0,0
"Malta","2024-11-19",0,0,3,0,0,3,0,0
"Malta","2024-11-20",0,0,3,0,0,3,0,0
"Malta","2024-11-21",0,0,3,0,0,3,0,0
"Malta","2024-11-22",0,0,3,0,0,3,0,0
"Malta","2024-11-23",0,0,3,0,0,3,0,0
"Malta","2024-11-24",0,0,3,0,0,3,0,0
"Malta","2024-11-25",0,0,3,0,0,3,0,0
"Malta","2024-11-26",0,0,3,0,0,3,0,0
"Malta","2024-11-27",0,0,3,0,0,3,0,0
"Malta","2024-11-28",0,0,3,0,0,3,0,0
"Malta","2024-11-29",0,0,3,0,0,3,0,0
"Malta","2024-11-30",0,0,3,0,0,3,0,0
"Malta","2024-12-01",0,0,3,0,0,3,0,0
"Malta","2024-12-02",0,0,3,0,0,3,0,0
"Malta","2024-12-03",0,0,3,0,0,3,0,0
"Malta","2024-12-04",0,0,3,0,0,3,0,0
"Malta","2024-12-05",0,0,3,0,0,3,0,0
"Malta","2024-12-06",0,0,3,0,0,3,0,0
"Malta","2024-12-07",0,0,3,0,0,3,0,0
"Malta","2024-12-08",0,0,3,0,0,3,0,0
"Malta","2024-12-09",0,0,3,0,0,3,0,0
"Martinique","2024-01-01",0,0,0,0,0,0,0,0
"Martinique","2024-01-02",0,0,0,0,0,0,0,0
"Martinique","2024-01-03",0,0,0,0,0,0,0,0
"Martinique","2024-01-04",0,0,0,0,0,0,0,0
"Martinique","2024-01-05",0,0,0,0,0,0,0,0
"Martinique","2024-01-06",0,0,0,0,0,0,0,0
"Martinique","2024-01-07",0,0,0,0,0,0,0,0
"Martinique","2024-01-08",0,0,0,0,0,0,0,0
"Martinique","2024-01-09",0,0,0,0,0,0,0,0
"Martinique","2024-01-10",0,0,0,0,0,0,0,0
"Martinique","2024-01-11",0,0,0,0,0,0,0,0
"Martinique","2024-01-12",0,0,0,0,0,0,0,0
"Martinique","2024-01-13",0,0,0,0,0,0,0,0
"Martinique","2024-01-14",0,0,0,0,0,0,0,0
"Martinique","2024-01-15",0,0,0,0,0,0,0,0
"Martinique","2024-01-16",0,0,0,0,0,0,0,0
"Martinique","2024-01-17",0,0,0,0,0,0,0,0
"Martinique","2024-01-18",0,0,0,0,0,0,0,0
"Martinique","2024-01-19",0,0,0,0,0,0,0,0
"Martinique","2024-01-20",0,0,0,0,0,0,0,0
"Martinique","2024-01-21",0,0,0,0,0,0,0,0
"Martinique","2024-01-22",0,0,0,0,0,0,0,0
"Martinique","2024-01-23",0,0,0,0,0,0,0,0
"Martinique","2024-01-24",0,0,0,0,0,0,0,0
"Martinique","2024-01-25",0,0,0,0,0,0,0,0
"Martinique","2024-01-26",0,0,0,0,0,0,0,0
"Martinique","2024-01-27",0,0,0,0,0,0,0,0
"Martinique","2024-01-28",0,0,0,0,0,0,0,0
"Martinique","2024-01-29",0,0,0,0,0,0,0,0
"Martinique","2024-01-30",0,0,0,0,0,0,0,0
"Martinique","2024-01-31",0,0,0,0,0,0,0,0
"Martinique","2024-02-01",0,0,0,0,0,0,0,0
"Martinique","2024-02-02",0,0,0,0,0,0,0,0
"Martinique","2024-02-03",0,0,0,0,0,0,0,0
"Martinique","2024-02-04",0,0,0,0,0,0,0,0
"Martinique","2024-02-05",0,0,0,0,0,0,0,0
"Martinique","2024-02-06",0,0,0,0,0,0,0,0
"Martinique","2024-02-07",0,0,0,0,0,0,0,0
"Martinique","2024-02-08",0,0,0,0,0,0,0,0
"Martinique","2024-02-09",0,0,0,0,0,0,0,0
"Martinique","2024-02-10",0,0,0,0,0,0,0,0
"Martinique","2024-02-11",0,0,0,0,0,0,0,0
"Martinique","2024-02-12",0,0,0,0,0,0,0,0
"Martinique","2024-02-13",0,0,0,0,0,0,0,0
"Martinique","2024-02-14",0,0,0,0,0,0,0,0
"Martinique","2024-02-15",0,0,0,0,0,0,0,0
"Martinique","2024-02-16",0,0,0,0,0,0,0,0
"Martinique","2024-02-17",0,0,0,0,0,0,0,0
"Martinique","2024-02-18",0,0,0,0,0,0,0,0
"Martinique","2024-02-19",0,0,0,0,0,0,0,0
"Martinique","2024-02-20",0,0,0,0,0,0,0,0
"Martinique","2024-02-21",0,0,0,0,0,0,0,0
"Martinique","2024-02-22",0,0,0,0,0,0,0,0
"Martinique","2024-02-23",0,0,0,0,0,0,0,0
"Martinique","2024-02-24",0,0,0,0,0,0,0,0
"Martinique","2024-02-25",0,0,0,0,0,0,0,0
"Martinique","2024-02-26",0,0,0,0,0,0,0,0
"Martinique","2024-02-27",0,0,0,0,0,0,0,0
"Martinique","2024-02-28",0,0,0,0,0,0,0,0
"Martinique","2024-02-29",0,0,0,0,0,0,0,0
"Martinique","2024-03-01",0,0,0,0,0,0,0,0
"Martinique","2024-03-02",0,0,0,0,0,0,0,0
"Martinique","2024-03-03",0,0,0,0,0,0,0,0
"Martinique","2024-03-04",0,0,0,0,0,0,0,0
"Martinique","2024-03-05",0,0,0,0,0,0,0,0
"Martinique","2024-03-06",0,0,0,0,0,0,0,0
"Martinique","2024-03-07",0,0,0,0,0,0,0,0
"Martinique","2024-03-08",0,0,0,0,0,0,0,0
"Martinique","2024-03-09",0,0,0,0,0,0,0,0
"Martinique","2024-03-10",0,0,0,0,0,0,0,0
"Martinique","2024-03-11",0,0,0,0,0,0,0,0
"Martinique","2024-03-12",0,0,0,0,0,0,0,0
"Martinique","2024-03-13",0,0,0,0,0,0,0,0
"Martinique","2024-03-14",0,0,0,0,0,0,0,0
"Martinique","2024-03-15",0,0,0,0,0,0,0,0
"Martinique","2024-03-16",0,0,0,0,0,0,0,0
"Martinique","2024-03-17",0,0,0,0,0,0,0,0
"Martinique","2024-03-18",0,0,0,0,0,0,0,0
"Martinique","2024-03-19",0,0,0,0,0,0,0,0
"Martinique","2024-03-20",0,0,0,0,0,0,0,0
"Martinique","2024-03-21",0,0,0,0,0,0,0,0
"Martinique","2024-03-22",0,0,0,0,0,0,0,0
"Martinique","2024-03-23",0,0,0,0,0,0,0,0
"Martinique","2024-03-24",0,0,0,0,0,0,0,0
"Martinique","2024-03-25",0,0,0,0,0,0,0,0
"Martinique","2024-03-26",0,0,0,0,0,0,0,0
"Martinique","2024-03-27",0,0,0,0,0,0,0,0
"Martinique","2024-03-28",0,0,0,0,0,0,0,0
"Martinique","2024-03-29",0,0,0,0,0,0,0,0
"Martinique","2024-03-30",0,0,0,0,0,0,0,0
"Martinique","2024-03-31",0,0,0,0,0,0,0,0
"Martinique","2024-04-01",0,0,0,0,0,0,0,0
"Martinique","2024-04-02",0,0,0,0,0,0,0,0
"Martinique","2024-04-03",0,0,0,0,0,0,0,0
"Martinique","2024-04-04",0,0,0,0,0,0,0,0
"Martinique","2024-04-05",0,0,0,0,0,0,0,0
"Martinique","2024-04-06",0,0,0,0,0,0,0,0
"Martinique","2024-04-07",0,0,0,0,0,0,0,0
"Martinique","2024-04-08",0,0,0,0,0,0,0,0
"Martinique","2024-04-09",0,0,0,0,0,0,0,0
"Martinique","2024-04-10",0,0,0,0,0,0,0,0
"Martinique","2024-04-11",0,0,0,0,0,0,0,0
"Martinique","2024-04-12",0,0,0,0,0,0,0,0
"Martinique","2024-04-13",0,0,0,0,0,0,0,0
"Martinique","2024-04-14",0,0,0,0,0,0,0,0
"Martinique","2024-04-15",0,0,0,0,0,0,0,0
"Martinique","2024-04-16",0,0,0,0,0,0,0,0
"Martinique","2024-04-17",0,0,0,0,0,0,0,0
"Martinique","2024-04-18",0,0,0,0,0,0,0,0
"Martinique","2024-04-19",0,0,0,0,0,0,0,0
"Martinique","2024-04-20",0,0,0,0,0,0,0,0
"Martinique","2024-04-21",0,0,0,0,0,0,0,0
"Martinique","2024-04-22",0,0,0,0,0,0,0,0
"Martinique","2024-04-23",0,0,0,0,0,0,0,0
"Martinique","2024-04-24",0,0,0,0,0,0,0,0
"Martinique","2024-04-25",0,0,0,0,0,0,0,0
"Martinique","2024-04-26",0,0,0,0,0,0,0,0
"Martinique","2024-04-27",0,0,0,0,0,0,0,0
"Martinique","2024-04-28",0,0,0,0,0,0,0,0
"Martinique","2024-04-29",0,0,0,0,0,0,0,0
"Martinique","2024-04-30",0,0,0,0,0,0,0,0
"Martinique","2024-05-01",0,0,0,0,0,0,0,0
"Martinique","2024-05-02",0,0,0,0,0,0,0,0
"Martinique","2024-05-03",0,0,0,0,0,0,0,0
"Martinique","2024-05-04",0,0,0,0,0,0,0,0
"Martinique","2024-05-05",0,0,0,0,0,0,0,0
"Martinique","2024-05-06",0,0,0,0,0,0,0,0
"Martinique","2024-05-07",0,0,0,0,0,0,0,0
"Martinique","2024-05-08",0,0,0,0,0,0,0,0
"Martinique","2024-05-09",0,0,0,0,0,0,0,0
"Martinique","2024-05-10",0,0,0,0,0,0,0,0
"Martinique","2024-05-11",0,0,0,0,0,0,0,0
"Martinique","2024-05-12",0,0,0,0,0,0,0,0
"Martinique","2024-05-13",0,0,0,0,0,0,0,0
"Martinique","2024-05-14",0,0,0,0,0,0,0,0
"Martinique","2024-05-15",0,0,0,0,0,0,0,0
"Martinique","2024-05-16",0,0,0,0,0,0,0,0
"Martinique","2024-05-17",0,0,0,0,0,0,0,0
"Martinique","2024-05-18",0,0,0,0,0,0,0,0
"Martinique","2024-05-19",0,0,0,0,0,0,0,0
"Martinique","2024-05-20",0,0,0,0,0,0,0,0
"Martinique","2024-05-21",0,0,0,0,0,0,0,0
"Martinique","2024-05-22",0,0,0,0,0,0,0,0
"Martinique","2024-05-23",0,0,0,0,0,0,0,0
"Martinique","2024-05-24",0,0,0,0,0,0,0,0
"Martinique","2024-05-25",0,0,0,0,0,0,0,0
"Martinique","2024-05-26",0,0,0,0,0,0,0,0
"Martinique","2024-05-27",0,0,0,0,0,0,0,0
"Martinique","2024-05-28",0,0,0,0,0,0,0,0
"Martinique","2024-05-29",0,0,0,0,0,0,0,0
"Martinique","2024-05-30",0,0,0,0,0,0,0,0
"Martinique","2024-05-31",0,0,0,0,0,0,0,0
"Martinique","2024-06-01",0,0,0,0,0,0,0,0
"Martinique","2024-06-02",0,0,0,0,0,0,0,0
"Martinique","2024-06-03",0,0,0,0,0,0,0,0
"Martinique","2024-06-04",0,0,0,0,0,0,0,0
"Martinique","2024-06-05",0,0,0,0,0,0,0,0
"Martinique","2024-06-06",0,0,0,0,0,0,0,0
"Martinique","2024-06-07",0,0,0,0,0,0,0,0
"Martinique","2024-06-08",0,0,0,0,0,0,0,0
"Martinique","2024-06-09",0,0,0,0,0,0,0,0
"Martinique","2024-06-10",0,0,0,0,0,0,0,0
"Martinique","2024-06-11",0,0,0,0,0,0,0,0
"Martinique","2024-06-12",0,0,0,0,0,0,0,0
"Martinique","2024-06-13",0,0,0,0,0,0,0,0
"Martinique","2024-06-14",0,0,0,0,0,0,0,0
"Martinique","2024-06-15",0,0,0,0,0,0,0,0
"Martinique","2024-06-16",0,0,0,0,0,0,0,0
"Martinique","2024-06-17",0,0,0,0,0,0,0,0
"Martinique","2024-06-18",0,0,0,0,0,0,0,0
"Martinique","2024-06-19",0,0,0,0,0,0,0,0
"Martinique","2024-06-20",0,0,0,0,0,0,0,0
"Martinique","2024-06-21",0,0,0,0,0,0,0,0
"Martinique","2024-06-22",0,0,0,0,0,0,0,0
"Martinique","2024-06-23",0,0,0,0,0,0,0,0
"Martinique","2024-06-24",0,0,0,0,0,0,0,0
"Martinique","2024-06-25",0,0,0,0,0,0,0,0
"Martinique","2024-06-26",0,0,0,0,0,0,0,0
"Martinique","2024-06-27",0,0,0,0,0,0,0,0
"Martinique","2024-06-28",0,0,0,0,0,0,0,0
"Martinique","2024-06-29",0,0,0,0,0,0,0,0
"Martinique","2024-06-30",0,0,0,0,0,0,0,0
"Martinique","2024-07-01",0,0,0,0,0,0,0,0
"Martinique","2024-07-02",0,0,0,0,0,0,0,0
"Martinique","2024-07-03",0,0,0,0,0,0,0,0
"Martinique","2024-07-04",0,0,0,0,0,0,0,0
"Martinique","2024-07-05",0,0,0,0,0,0,0,0
"Martinique","2024-07-06",0,0,0,0,0,0,0,0
"Martinique","2024-07-07",0,0,0,0,0,0,0,0
"Martinique","2024-07-08",0,0,0,0,0,0,0,0
"Martinique","2024-07-09",0,0,0,0,0,0,0,0
"Martinique","2024-07-10",0,0,0,0,0,0,0,0
"Martinique","2024-07-11",0,0,0,0,0,0,0,0
"Martinique","2024-07-12",0,0,0,0,0,0,0,0
"Martinique","2024-07-13",0,0,0,0,0,0,0,0
"Martinique","2024-07-14",0,0,0,0,0,0,0,0
"Martinique","2024-07-15",0,0,0,0,0,0,0,0
"Martinique","2024-07-16",0,0,0,0,0,0,0,0
"Martinique","2024-07-17",0,0,0,0,0,0,0,0
"Martinique","2024-07-18",0,0,0,0,0,0,0,0
"Martinique","2024-07-19",0,0,0,0,0,0,0,0
"Martinique","2024-07-20",0,0,0,0,0,0,0,0
"Martinique","2024-07-21",0,0,0,0,0,0,0,0
"Martinique","2024-07-22",0,0,0,0,0,0,0,0
"Martinique","2024-07-23",0,0,0,0,0,0,0,0
"Martinique","2024-07-24",0,0,0,0,0,0,0,0
"Martinique","2024-07-25",0,0,0,0,0,0,0,0
"Martinique","2024-07-26",0,0,0,0,0,0,0,0
"Martinique","2024-07-27",0,0,0,0,0,0,0,0
"Martinique","2024-07-28",0,0,0,0,0,0,0,0
"Martinique","2024-07-29",0,0,0,0,0,0,0,0
"Martinique","2024-07-30",0,0,0,0,0,0,0,0
"Martinique","2024-07-31",0,0,0,0,0,0,0,0
"Martinique","2024-08-01",0,0,0,0,0,0,0,0
"Martinique","2024-08-02",0,0,0,0,0,0,0,0
"Martinique","2024-08-03",0,0,0,0,0,0,0,0
"Martinique","2024-08-04",0,0,0,0,0,0,0,0
"Martinique","2024-08-05",0,0,0,0,0,0,0,0
"Martinique","2024-08-06",0,0,0,0,0,0,0,0
"Martinique","2024-08-07",0,0,0,0,0,0,0,0
"Martinique","2024-08-08",0,0,0,0,0,0,0,0
"Martinique","2024-08-09",0,0,0,0,0,0,0,0
"Martinique","2024-08-10",0,0,0,0,0,0,0,0
"Martinique","2024-08-11",0,0,0,0,0,0,0,0
"Martinique","2024-08-12",0,0,0,0,0,0,0,0
"Martinique","2024-08-13",0,0,0,0,0,0,0,0
"Martinique","2024-08-14",0,0,0,0,0,0,0,0
"Martinique","2024-08-15",0,0,0,0,0,0,0,0
"Martinique","2024-08-16",0,0,0,0,0,0,0,0
"Martinique","2024-08-17",0,0,0,0,0,0,0,0
"Martinique","2024-08-18",0,0,0,0,0,0,0,0
"Martinique","2024-08-19",0,0,0,0,0,0,0,0
"Martinique","2024-08-20",0,0,0,0,0,0,0,0
"Martinique","2024-08-21",0,0,0,0,0,0,0,0
"Martinique","2024-08-22",0,0,0,0,0,0,0,0
"Martinique","2024-08-23",0,0,0,0,0,0,0,0
"Martinique","2024-08-24",0,0,0,0,0,0,0,0
"Martinique","2024-08-25",0,0,0,0,0,0,0,0
"Martinique","2024-08-26",0,0,0,0,0,0,0,0
"Martinique","2024-08-27",0,0,0,0,0,0,0,0
"Martinique","2024-08-28",0,0,0,0,0,0,0,0
"Martinique","2024-08-29",0,0,0,0,0,0,0,0
"Martinique","2024-08-30",0,0,0,0,0,0,0,0
"Martinique","2024-08-31",0,0,0,0,0,0,0,0
"Martinique","2024-09-01",0,0,0,0,0,0,0,0
"Martinique","2024-09-02",0,0,0,0,0,0,0,0
"Martinique","2024-09-03",0,0,0,0,0,0,0,0
"Martinique","2024-09-04",0,0,0,0,0,0,0,0
"Martinique","2024-09-05",0,0,0,0,0,0,0,0
"Martinique","2024-09-06",0,0,0,0,0,0,0,0
"Martinique","2024-09-07",0,0,0,0,0,0,0,0
"Martinique","2024-09-08",0,0,0,0,0,0,0,0
"Martinique","2024-09-09",0,0,0,0,0,0,0,0
"Martinique","2024-09-10",0,0,0,0,0,0,0,0
"Martinique","2024-09-11",0,0,0,0,0,0,0,0
"Martinique","2024-09-12",0,0,0,0,0,0,0,0
"Martinique","2024-09-13",0,0,0,0,0,0,0,0
"Martinique","2024-09-14",0,0,0,0,0,0,0,0
"Martinique","2024-09-15",0,0,0,0,0,0,0,0
"Martinique","2024-09-16",0,0,0,0,0,0,0,0
"Martinique","2024-09-17",0,0,0,0,0,0,0,0
"Martinique","2024-09-18",0,0,0,0,0,0,0,0
"Martinique","2024-09-19",0,0,0,0,0,0,0,0
"Martinique","2024-09-20",0,0,0,0,0,0,0,0
"Martinique","2024-09-21",0,0,0,0,0,0,0,0
"Martinique","2024-09-22",0,0,0,0,0,0,0,0
"Martinique","2024-09-23",0,0,0,0,0,0,0,0
"Martinique","2024-09-24",0,0,0,0,0,0,0,0
"Martinique","2024-09-25",0,0,0,0,0,0,0,0
"Martinique","2024-09-26",0,0,0,0,0,0,0,0
"Martinique","2024-09-27",0,0,0,0,0,0,0,0
"Martinique","2024-09-28",0,0,0,0,0,0,0,0
"Martinique","2024-09-29",0,0,0,0,0,0,0,0
"Martinique","2024-09-30",0,0,0,0,0,0,0,0
"Martinique","2024-10-01",0,0,0,0,0,0,0,0
"Martinique","2024-10-02",0,0,0,0,0,0,0,0
"Martinique","2024-10-03",0,0,0,0,0,0,0,0
"Martinique","2024-10-04",0,0,0,0,0,0,0,0
"Martinique","2024-10-05",0,0,0,0,0,0,0,0
"Martinique","2024-10-06",0,0,0,0,0,0,0,0
"Martinique","2024-10-07",0,0,0,0,0,0,0,0
"Martinique","2024-10-08",0,0,0,0,0,0,0,0
"Martinique","2024-10-09",0,0,0,0,0,0,0,0
"Martinique","2024-10-10",0,0,0,0,0,0,0,0
"Martinique","2024-10-11",0,0,0,0,0,0,0,0
"Martinique","2024-10-12",0,0,0,0,0,0,0,0
"Martinique","2024-10-13",0,0,0,0,0,0,0,0
"Martinique","2024-10-14",0,0,0,0,0,0,0,0
"Martinique","2024-10-15",0,0,0,0,0,0,0,0
"Martinique","2024-10-16",0,0,0,0,0,0,0,0
"Martinique","2024-10-17",0,0,0,0,0,0,0,0
"Martinique","2024-10-18",0,0,0,0,0,0,0,0
"Martinique","2024-10-19",0,0,0,0,0,0,0,0
"Martinique","2024-10-20",0,0,0,0,0,0,0,0
"Martinique","2024-10-21",0,0,0,0,0,0,0,0
"Martinique","2024-10-22",0,0,0,0,0,0,0,0
"Martinique","2024-10-23",0,0,0,0,0,0,0,0
"Martinique","2024-10-24",0,0,0,0,0,0,0,0
"Martinique","2024-10-25",0,0,0,0,0,0,0,0
"Martinique","2024-10-26",0,0,0,0,0,0,0,0
"Martinique","2024-10-27",0,0,0,0,0,0,0,0
"Martinique","2024-10-28",0,0,0,0,0,0,0,0
"Martinique","2024-10-29",0,0,0,0,0,0,0,0
"Martinique","2024-10-30",0,0,0,0,0,0,0,0
"Martinique","2024-10-31",0,0,0,0,0,0,0,0
"Martinique","2024-11-01",0,0,0,0,0,0,0,0
"Martinique","2024-11-02",0,0,0,0,0,0,0,0
"Martinique","2024-11-03",0,0,0,0,0,0,0,0
"Martinique","2024-11-04",0,0,0,0,0,0,0,0
"Martinique","2024-11-05",0,0,0,0,0,0,0,0
"Martinique","2024-11-06",0,0,0,0,0,0,0,0
"Martinique","2024-11-07",0,0,0,0,0,0,0,0
"Martinique","2024-11-08",0,0,0,0,0,0,0,0
"Martinique","2024-11-09",0,0,0,0,0,0,0,0
"Martinique","2024-11-10",0,0,0,0,0,0,0,0
"Martinique","2024-11-11",0,0,0,0,0,0,0,0
"Martinique","2024-11-12",0,0,0,0,0,0,0,0
"Martinique","2024-11-13",0,0,0,0,0,0,0,0
"Martinique","2024-11-14",0,0,0,0,0,0,0,0
"Martinique","2024-11-15",0,0,0,0,0,0,0,0
"Martinique","2024-11-16",0,0,0,0,0,0,0,0
"Martinique","2024-11-17",0,0,0,0,0,0,0,0
"Martinique","2024-11-18",0,0,0,0,0,0,0,0
"Martinique","2024-11-19",0,0,0,0,0,0,0,0
"Martinique","2024-11-20",0,0,0,0,0,0,0,0
"Martinique","2024-11-21",0,0,0,0,0,0,0,0
"Martinique","2024-11-22",0,0,0,0,0,0,0,0
"Martinique","2024-11-23",0,0,0,0,0,0,0,0
"Martinique","2024-11-24",0,0,0,0,0,0,0,0
"Martinique","2024-11-25",0,0,0,0,0,0,0,0
"Martinique","2024-11-26",0,0,0,0,0,0,0,0
"Martinique","2024-11-27",0,0,0,0,0,0,0,0
"Martinique","2024-11-28",0,0,0,0,0,0,0,0
"Martinique","2024-11-29",0,0,0,0,0,0,0,0
"Martinique","2024-11-30",0,0,0,0,0,0,0,0
"Martinique","2024-12-01",0,0,0,0,0,0,0,0
"Martinique","2024-12-02",0,0,0,0,0,0,0,0
"Martinique","2024-12-03",0,0,0,0,0,0,0,0
"Martinique","2024-12-04",0,0,0,0,0,0,0,0
"Martinique","2024-12-05",0,0,0,0,0,0,0,0
"Martinique","2024-12-06",0,0,0,0,0,0,0,0
"Martinique","2024-12-07",0,0,0,0,0,0,0,0
"Martinique","2024-12-08",0,0,0,0,0,0,0,0
"Martinique","2024-12-09",0,0,0,0,0,0,0,0
"Mauritius","2024-01-01",0,0,0,0,0,0,0,0
"Mauritius","2024-01-02",0,0,0,0,0,0,0,0
"Mauritius","2024-01-03",0,0,0,0,0,0,0,0
"Mauritius","2024-01-04",0,0,0,0,0,0,0,0
"Mauritius","2024-01-05",0,0,0,0,0,0,0,0
"Mauritius","2024-01-06",0,0,0,0,0,0,0,0
"Mauritius","2024-01-07",0,0,0,0,0,0,0,0
"Mauritius","2024-01-08",0,0,0,0,0,0,0,0
"Mauritius","2024-01-09",0,0,0,0,0,0,0,0
"Mauritius","2024-01-10",0,0,0,0,0,0,0,0
"Mauritius","2024-01-11",0,0,0,0,0,0,0,0
"Mauritius","2024-01-12",0,0,0,0,0,0,0,0
"Mauritius","2024-01-13",0,0,0,0,0,0,0,0
"Mauritius","2024-01-14",0,0,0,0,0,0,0,0
"Mauritius","2024-01-15",0,0,0,0,0,0,0,0
"Mauritius","2024-01-16",0,0,0,0,0,0,0,0
"Mauritius","2024-01-17",0,0,0,0,0,0,0,0
"Mauritius","2024-01-18",0,0,0,0,0,0,0,0
"Mauritius","2024-01-19",0,0,0,0,0,0,0,0
"Mauritius","2024-01-20",0,0,0,0,0,0,0,0
"Mauritius","2024-01-21",0,0,0,0,0,0,0,0
"Mauritius","2024-01-22",0,0,0,0,0,0,0,0
"Mauritius","2024-01-23",0,0,0,0,0,0,0,0
"Mauritius","2024-01-24",0,0,0,0,0,0,0,0
"Mauritius","2024-01-25",0,0,0,0,0,0,0,0
"Mauritius","2024-01-26",0,0,0,0,0,0,0,0
"Mauritius","2024-01-27",0,0,0,0,0,0,0,0
"Mauritius","2024-01-28",0,0,0,0,0,0,0,0
"Mauritius","2024-01-29",0,0,0,0,0,0,0,0
"Mauritius","2024-01-30",0,0,0,0,0,0,0,0
"Mauritius","2024-01-31",0,0,0,0,0,0,0,0
"Mauritius","2024-02-01",0,0,0,0,0,0,0,0
"Mauritius","2024-02-02",0,0,0,0,0,0,0,0
"Mauritius","2024-02-03",0,0,0,0,0,0,0,0
"Mauritius","2024-02-04",0,0,0,0,0,0,0,0
"Mauritius","2024-02-05",0,0,0,0,0,0,0,0
"Mauritius","2024-02-06",0,0,0,0,0,0,0,0
"Mauritius","2024-02-07",0,0,0,0,0,0,0,0
"Mauritius","2024-02-08",0,0,0,0,0,0,0,0
"Mauritius","2024-02-09",0,0,0,0,0,0,0,0
"Mauritius","2024-02-10",0,0,0,0,0,0,0,0
"Mauritius","2024-02-11",0,0,0,0,0,0,0,0
"Mauritius","2024-02-12",0,0,0,0,0,0,0,0
"Mauritius","2024-02-13",0,0,0,0,0,0,0,0
"Mauritius","2024-02-14",0,0,0,0,0,0,0,0
"Mauritius","2024-02-15",0,0,0,0,0,0,0,0
"Mauritius","2024-02-16",0,0,0,0,0,0,0,0
"Mauritius","2024-02-17",0,0,0,0,0,0,0,0
"Mauritius","2024-02-18",0,0,0,0,0,0,0,0
"Mauritius","2024-02-19",0,0,0,0,0,0,0,0
"Mauritius","2024-02-20",0,0,0,0,0,0,0,0
"Mauritius","2024-02-21",0,0,0,0,0,0,0,0
"Mauritius","2024-02-22",0,0,0,0,0,0,0,0
"Mauritius","2024-02-23",0,0,0,0,0,0,0,0
"Mauritius","2024-02-24",0,0,0,0,0,0,0,0
"Mauritius","2024-02-25",0,0,0,0,0,0,0,0
"Mauritius","2024-02-26",0,0,0,0,0,0,0,0
"Mauritius","2024-02-27",0,0,0,0,0,0,0,0
"Mauritius","2024-02-28",0,0,0,0,0,0,0,0
"Mauritius","2024-02-29",0,0,0,0,0,0,0,0
"Mauritius","2024-03-01",0,0,0,0,0,0,0,0
"Mauritius","2024-03-02",0,0,0,0,0,0,0,0
"Mauritius","2024-03-03",0,0,0,0,0,0,0,0
"Mauritius","2024-03-04",0,0,0,0,0,0,0,0
"Mauritius","2024-03-05",0,0,0,0,0,0,0,0
"Mauritius","2024-03-06",0,0,0,0,0,0,0,0
"Mauritius","2024-03-07",0,0,0,0,0,0,0,0
"Mauritius","2024-03-08",0,0,0,0,0,0,0,0
"Mauritius","2024-03-09",0,0,0,0,0,0,0,0
"Mauritius","2024-03-10",0,0,0,0,0,0,0,0
"Mauritius","2024-03-11",0,0,0,0,0,0,0,0
"Mauritius","2024-03-12",0,0,0,0,0,0,0,0
"Mauritius","2024-03-13",0,0,0,0,0,0,0,0
"Mauritius","2024-03-14",0,0,0,0,0,0,0,0
"Mauritius","2024-03-15",0,0,0,0,0,0,0,0
"Mauritius","2024-03-16",0,0,0,0,0,0,0,0
"Mauritius","2024-03-17",0,0,0,0,0,0,0,0
"Mauritius","2024-03-18",0,0,0,0,0,0,0,0
"Mauritius","2024-03-19",0,0,0,0,0,0,0,0
"Mauritius","2024-03-20",0,0,0,0,0,0,0,0
"Mauritius","2024-03-21",0,0,0,0,0,0,0,0
"Mauritius","2024-03-22",0,0,0,0,0,0,0,0
"Mauritius","2024-03-23",0,0,0,0,0,0,0,0
"Mauritius","2024-03-24",0,0,0,0,0,0,0,0
"Mauritius","2024-03-25",0,0,0,0,0,0,0,0
"Mauritius","2024-03-26",0,0,0,0,0,0,0,0
"Mauritius","2024-03-27",0,0,0,0,0,0,0,0
"Mauritius","2024-03-28",0,0,0,0,0,0,0,0
"Mauritius","2024-03-29",0,0,0,0,0,0,0,0
"Mauritius","2024-03-30",0,0,0,0,0,0,0,0
"Mauritius","2024-03-31",0,0,0,0,0,0,0,0
"Mauritius","2024-04-01",0,0,0,0,0,0,0,0
"Mauritius","2024-04-02",0,0,0,0,0,0,0,0
"Mauritius","2024-04-03",0,0,0,0,0,0,0,0
"Mauritius","2024-04-04",0,0,0,0,0,0,0,0
"Mauritius","2024-04-05",0,0,0,0,0,0,0,0
"Mauritius","2024-04-06",0,0,0,0,0,0,0,0
"Mauritius","2024-04-07",0,0,0,0,0,0,0,0
"Mauritius","2024-04-08",0,0,0,0,0,0,0,0
"Mauritius","2024-04-09",0,0,0,0,0,0,0,0
"Mauritius","2024-04-10",0,0,0,0,0,0,0,0
"Mauritius","2024-04-11",0,0,0,0,0,0,0,0
"Mauritius","2024-04-12",0,0,0,0,0,0,0,0
"Mauritius","2024-04-13",0,0,0,0,0,0,0,0
"Mauritius","2024-04-14",0,0,0,0,0,0,0,0
"Mauritius","2024-04-15",0,0,0,0,0,0,0,0
"Mauritius","2024-04-16",0,0,0,0,0,0,0,0
"Mauritius","2024-04-17",0,0,0,0,0,0,0,0
"Mauritius","2024-04-18",0,0,0,0,0,0,0,0
"Mauritius","2024-04-19",0,0,0,0,0,0,0,0
"Mauritius","2024-04-20",0,0,0,0,0,0,0,0
"Mauritius","2024-04-21",0,0,0,0,0,0,0,0
"Mauritius","2024-04-22",0,0,0,0,0,0,0,0
"Mauritius","2024-04-23",0,0,0,0,0,0,0,0
"Mauritius","2024-04-24",0,0,0,0,0,0,0,0
"Mauritius","2024-04-25",0,0,0,0,0,0,0,0
"Mauritius","2024-04-26",0,0,0,0,0,0,0,0
"Mauritius","2024-04-27",0,0,0,0,0,0,0,0
"Mauritius","2024-04-28",0,0,0,0,0,0,0,0
"Mauritius","2024-04-29",0,0,0,0,0,0,0,0
"Mauritius","2024-04-30",0,0,0,0,0,0,0,0
"Mauritius","2024-05-01",0,0,0,0,0,0,0,0
"Mauritius","2024-05-02",0,0,0,0,0,0,0,0
"Mauritius","2024-05-03",0,0,0,0,0,0,0,0
"Mauritius","2024-05-04",0,0,0,0,0,0,0,0
"Mauritius","2024-05-05",0,0,0,0,0,0,0,0
"Mauritius","2024-05-06",0,0,0,0,0,0,0,0
"Mauritius","2024-05-07",0,0,0,0,0,0,0,0
"Mauritius","2024-05-08",0,0,0,0,0,0,0,0
"Mauritius","2024-05-09",0,0,0,0,0,0,0,0
"Mauritius","2024-05-10",0,0,0,0,0,0,0,0
"Mauritius","2024-05-11",0,0,0,0,0,0,0,0
"Mauritius","2024-05-12",0,0,0,0,0,0,0,0
"Mauritius","2024-05-13",0,0,0,0,0,0,0,0
"Mauritius","2024-05-14",0,0,0,0,0,0,0,0
"Mauritius","2024-05-15",0,0,0,0,0,0,0,0
"Mauritius","2024-05-16",0,0,0,0,0,0,0,0
"Mauritius","2024-05-17",0,0,0,0,0,0,0,0
"Mauritius","2024-05-18",0,0,0,0,0,0,0,0
"Mauritius","2024-05-19",0,0,0,0,0,0,0,0
"Mauritius","2024-05-20",0,0,0,0,0,0,0,0
"Mauritius","2024-05-21",0,0,0,0,0,0,0,0
"Mauritius","2024-05-22",0,0,0,0,0,0,0,0
"Mauritius","2024-05-23",0,0,0,0,0,0,0,0
"Mauritius","2024-05-24",0,0,0,0,0,0,0,0
"Mauritius","2024-05-25",0,0,0,0,0,0,0,0
"Mauritius","2024-05-26",0,0,0,0,0,0,0,0
"Mauritius","2024-05-27",0,0,0,0,0,0,0,0
"Mauritius","2024-05-28",0,0,0,0,0,0,0,0
"Mauritius","2024-05-29",0,0,0,0,0,0,0,0
"Mauritius","2024-05-30",0,0,0,0,0,0,0,0
"Mauritius","2024-05-31",0,0,0,0,0,0,0,0
"Mauritius","2024-06-01",0,0,0,0,0,0,0,0
"Mauritius","2024-06-02",0,0,0,0,0,0,0,0
"Mauritius","2024-06-03",0,0,0,0,0,0,0,0
"Mauritius","2024-06-04",0,0,0,0,0,0,0,0
"Mauritius","2024-06-05",0,0,0,0,0,0,0,0
"Mauritius","2024-06-06",0,0,0,0,0,0,0,0
"Mauritius","2024-06-07",0,0,0,0,0,0,0,0
"Mauritius","2024-06-08",0,0,0,0,0,0,0,0
"Mauritius","2024-06-09",0,0,0,0,0,0,0,0
"Mauritius","2024-06-10",0,0,0,0,0,0,0,0
"Mauritius","2024-06-11",0,0,0,0,0,0,0,0
"Mauritius","2024-06-12",0,0,0,0,0,0,0,0
"Mauritius","2024-06-13",0,0,0,0,0,0,0,0
"Mauritius","2024-06-14",0,0,0,0,0,0,0,0
"Mauritius","2024-06-15",0,0,0,0,0,0,0,0
"Mauritius","2024-06-16",0,0,0,0,0,0,0,0
"Mauritius","2024-06-17",0,0,0,0,0,0,0,0
"Mauritius","2024-06-18",0,0,0,0,0,0,0,0
"Mauritius","2024-06-19",0,0,0,0,0,0,0,0
"Mauritius","2024-06-20",0,0,0,0,0,0,0,0
"Mauritius","2024-06-21",0,0,0,0,0,0,0,0
"Mauritius","2024-06-22",0,0,0,0,0,0,0,0
"Mauritius","2024-06-23",0,0,0,0,0,0,0,0
"Mauritius","2024-06-24",0,0,0,0,0,0,0,0
"Mauritius","2024-06-25",0,0,0,0,0,0,0,0
"Mauritius","2024-06-26",0,0,0,0,0,0,0,0
"Mauritius","2024-06-27",0,0,0,0,0,0,0,0
"Mauritius","2024-06-28",0,0,0,0,0,0,0,0
"Mauritius","2024-06-29",0,0,0,0,0,0,0,0
"Mauritius","2024-06-30",0,0,0,0,0,0,0,0
"Mauritius","2024-07-01",0,0,0,0,0,0,0,0
"Mauritius","2024-07-02",0,0,0,0,0,0,0,0
"Mauritius","2024-07-03",0,0,0,0,0,0,0,0
"Mauritius","2024-07-04",0,0,0,0,0,0,0,0
"Mauritius","2024-07-05",0,0,0,0,0,0,0,0
"Mauritius","2024-07-06",0,0,0,0,0,0,0,0
"Mauritius","2024-07-07",0,0,0,0,0,0,0,0
"Mauritius","2024-07-08",0,0,0,0,0,0,0,0
"Mauritius","2024-07-09",0,0,0,0,0,0,0,0
"Mauritius","2024-07-10",0,0,0,0,0,0,0,0
"Mauritius","2024-07-11",0,0,0,0,0,0,0,0
"Mauritius","2024-07-12",0,0,0,0,0,0,0,0
"Mauritius","2024-07-13",0,0,0,0,0,0,0,0
"Mauritius","2024-07-14",0,0,0,0,0,0,0,0
"Mauritius","2024-07-15",0,0,0,0,0,0,0,0
"Mauritius","2024-07-16",0,0,0,0,0,0,0,0
"Mauritius","2024-07-17",0,0,0,0,0,0,0,0
"Mauritius","2024-07-18",0,0,0,0,0,0,0,0
"Mauritius","2024-07-19",0,0,0,0,0,0,0,0
"Mauritius","2024-07-20",0,0,0,0,0,0,0,0
"Mauritius","2024-07-21",0,0,0,0,0,0,0,0
"Mauritius","2024-07-22",0,0,0,0,0,0,0,0
"Mauritius","2024-07-23",0,0,0,0,0,0,0,0
"Mauritius","2024-07-24",0,0,0,0,0,0,0,0
"Mauritius","2024-07-25",0,0,0,0,0,0,0,0
"Mauritius","2024-07-26",0,0,0,0,0,0,0,0
"Mauritius","2024-07-27",0,0,0,0,0,0,0,0
"Mauritius","2024-07-28",0,0,0,0,0,0,0,0
"Mauritius","2024-07-29",0,0,0,0,0,0,0,0
"Mauritius","2024-07-30",0,0,0,0,0,0,0,0
"Mauritius","2024-07-31",0,0,0,0,0,0,0,0
"Mauritius","2024-08-01",0,0,0,0,0,0,0,0
"Mauritius","2024-08-02",0,0,0,0,0,0,0,0
"Mauritius","2024-08-03",0,0,0,0,0,0,0,0
"Mauritius","2024-08-04",0,0,0,0,0,0,0,0
"Mauritius","2024-08-05",0,0,0,0,0,0,0,0
"Mauritius","2024-08-06",0,0,0,0,0,0,0,0
"Mauritius","2024-08-07",0,0,0,0,0,0,0,0
"Mauritius","2024-08-08",0,0,0,0,0,0,0,0
"Mauritius","2024-08-09",0,0,0,0,0,0,0,0
"Mauritius","2024-08-10",0,0,0,0,0,0,0,0
"Mauritius","2024-08-11",0,0,0,0,0,0,0,0
"Mauritius","2024-08-12",0,0,0,0,0,0,0,0
"Mauritius","2024-08-13",0,0,0,0,0,0,0,0
"Mauritius","2024-08-14",0,0,0,0,0,0,0,0
"Mauritius","2024-08-15",0,0,0,0,0,0,0,0
"Mauritius","2024-08-16",0,0,0,0,0,0,0,0
"Mauritius","2024-08-17",0,0,0,0,0,0,0,0
"Mauritius","2024-08-18",0,0,0,0,0,0,0,0
"Mauritius","2024-08-19",0,0,0,0,0,0,0,0
"Mauritius","2024-08-20",0,0,0,0,0,0,0,0
"Mauritius","2024-08-21",0,0,0,0,0,0,0,0
"Mauritius","2024-08-22",0,0,0,0,0,0,0,0
"Mauritius","2024-08-23",0,0,0,0,0,0,0,0
"Mauritius","2024-08-24",0,0,0,0,0,0,0,0
"Mauritius","2024-08-25",0,0,0,0,0,0,0,0
"Mauritius","2024-08-26",0,0,0,0,0,0,0,0
"Mauritius","2024-08-27",0,0,0,0,0,0,0,0
"Mauritius","2024-08-28",0,0,0,0,0,0,0,0
"Mauritius","2024-08-29",0,0,0,0,0,0,0,0
"Mauritius","2024-08-30",0,0,0,0,0,0,0,0
"Mauritius","2024-08-31",0,0,0,0,0,0,0,0
"Mauritius","2024-09-01",0,0,0,0,0,0,0,0
"Mauritius","2024-09-02",0,0,0,0,0,0,0,0
"Mauritius","2024-09-03",0,0,0,0,0,0,0,0
"Mauritius","2024-09-04",0,0,0,0,0,0,0,0
"Mauritius","2024-09-05",0,0,0,0,0,0,0,0
"Mauritius","2024-09-06",0,0,0,0,0,0,0,0
"Mauritius","2024-09-07",0,0,0,0,0,0,0,0
"Mauritius","2024-09-08",0,0,0,0,0,0,0,0
"Mauritius","2024-09-09",0,0,0,0,0,0,0,0
"Mauritius","2024-09-10",0,0,0,0,0,0,0,0
"Mauritius","2024-09-11",0,0,0,0,0,0,0,0
"Mauritius","2024-09-12",0,0,0,0,0,0,0,0
"Mauritius","2024-09-13",0,0,0,0,0,0,0,0
"Mauritius","2024-09-14",0,0,0,0,0,0,0,0
"Mauritius","2024-09-15",0,0,0,0,0,0,0,0
"Mauritius","2024-09-16",0,0,0,0,0,0,0,0
"Mauritius","2024-09-17",0,0,0,0,0,0,0,0
"Mauritius","2024-09-18",0,0,0,0,0,0,0,0
"Mauritius","2024-09-19",0,0,0,0,0,0,0,0
"Mauritius","2024-09-20",0,0,0,0,0,0,0,0
"Mauritius","2024-09-21",0,0,0,0,0,0,0,0
"Mauritius","2024-09-22",0,0,0,0,0,0,0,0
"Mauritius","2024-09-23",0,0,0,0,0,0,0,0
"Mauritius","2024-09-24",0,0,0,0,0,0,0,0
"Mauritius","2024-09-25",0,0,0,0,0,0,0,0
"Mauritius","2024-09-26",0,0,0,0,0,0,0,0
"Mauritius","2024-09-27",0,0,0,0,0,0,0,0
"Mauritius","2024-09-28",0,0,0,0,0,0,0,0
"Mauritius","2024-09-29",0,0,0,0,0,0,0,0
"Mauritius","2024-09-30",0,0,0,0,0,0,0,0
"Mauritius","2024-10-01",0,0,0,0,0,0,0,0
"Mauritius","2024-10-02",0,0,0,0,0,0,0,0
"Mauritius","2024-10-03",0,0,0,0,0,0,0,0
"Mauritius","2024-10-04",0,0,0,0,0,0,0,0
"Mauritius","2024-10-05",0,0,0,0,0,0,0,0
"Mauritius","2024-10-06",0,0,0,0,0,0,0,0
"Mauritius","2024-10-07",0,0,0,0,0,0,0,0
"Mauritius","2024-10-08",0,0,0,0,0,0,0,0
"Mauritius","2024-10-09",0,0,0,0,0,0,0,0
"Mauritius","2024-10-10",0,0,0,0,0,0,0,0
"Mauritius","2024-10-11",0,0,0,0,0,0,0,0
"Mauritius","2024-10-12",0,0,0,0,0,0,0,0
"Mauritius","2024-10-13",0,0,0,0,0,0,0,0
"Mauritius","2024-10-14",0,0,0,0,0,0,0,0
"Mauritius","2024-10-15",0,0,0,0,0,0,0,0
"Mauritius","2024-10-16",0,0,0,0,0,0,0,0
"Mauritius","2024-10-17",0,0,0,0,0,0,0,0
"Mauritius","2024-10-18",0,0,0,0,0,0,0,0
"Mauritius","2024-10-19",0,0,0,0,0,0,0,0
"Mauritius","2024-10-20",0,0,0,0,0,0,0,0
"Mauritius","2024-10-21",0,0,0,0,0,0,0,0
"Mauritius","2024-10-22",0,0,0,0,0,0,0,0
"Mauritius","2024-10-23",0,0,0,0,0,0,0,0
"Mauritius","2024-10-24",0,0,0,0,0,0,0,0
"Mauritius","2024-10-25",0,0,0,0,0,0,0,0
"Mauritius","2024-10-26",0,0,0,0,0,0,0,0
"Mauritius","2024-10-27",0,1,1,0,1,1,0,0
"Mauritius","2024-10-28",0,0,1,0,0,1,0,0
"Mauritius","2024-10-29",0,0,1,0,0,1,0,0
"Mauritius","2024-10-30",0,0,1,0,0,1,0,0
"Mauritius","2024-10-31",0,0,1,0,0,1,0,0
"Mauritius","2024-11-01",0,0,1,0,0,1,0,0
"Mauritius","2024-11-02",0,0,1,0,0,1,0,0
"Mauritius","2024-11-03",0,0,1,0,0,1,0,0
"Mauritius","2024-11-04",0,0,1,0,0,1,0,0
"Mauritius","2024-11-05",0,0,1,0,0,1,0,0
"Mauritius","2024-11-06",0,0,1,0,0,1,0,0
"Mauritius","2024-11-07",0,0,1,0,0,1,0,0
"Mauritius","2024-11-08",0,0,1,0,0,1,0,0
"Mauritius","2024-11-09",0,0,1,0,0,1,0,0
"Mauritius","2024-11-10",0,0,1,0,0,1,0,0
"Mauritius","2024-11-11",0,0,1,0,0,1,0,0
"Mauritius","2024-11-12",0,0,1,0,0,1,0,0
"Mauritius","2024-11-13",0,0,1,0,0,1,0,0
"Mauritius","2024-11-14",0,0,1,0,0,1,0,0
"Mauritius","2024-11-15",0,0,1,0,0,1,0,0
"Mauritius","2024-11-16",0,0,1,0,0,1,0,0
"Mauritius","2024-11-17",0,0,1,0,0,1,0,0
"Mauritius","2024-11-18",0,0,1,0,0,1,0,0
"Mauritius","2024-11-19",0,0,1,0,0,1,0,0
"Mauritius","2024-11-20",0,0,1,0,0,1,0,0
"Mauritius","2024-11-21",0,0,1,0,0,1,0,0
"Mauritius","2024-11-22",0,0,1,0,0,1,0,0
"Mauritius","2024-11-23",0,0,1,0,0,1,0,0
"Mauritius","2024-11-24",0,0,1,0,0,1,0,0
"Mauritius","2024-11-25",0,0,1,0,0,1,0,0
"Mauritius","2024-11-26",0,0,1,0,0,1,0,0
"Mauritius","2024-11-27",0,0,1,0,0,1,0,0
"Mauritius","2024-11-28",0,0,1,0,0,1,0,0
"Mauritius","2024-11-29",0,0,1,0,0,1,0,0
"Mauritius","2024-11-30",0,0,1,0,0,1,0,0
"Mauritius","2024-12-01",0,0,1,0,0,1,0,0
"Mauritius","2024-12-02",0,0,1,0,0,1,0,0
"Mauritius","2024-12-03",0,0,1,0,0,1,0,0
"Mauritius","2024-12-04",0,0,1,0,0,1,0,0
"Mauritius","2024-12-05",0,0,1,0,0,1,0,0
"Mauritius","2024-12-06",0,0,1,0,0,1,0,0
"Mauritius","2024-12-07",0,0,1,0,0,1,0,0
"Mauritius","2024-12-08",0,0,1,0,0,1,0,0
"Mauritius","2024-12-09",0,0,1,0,0,1,0,0
"Mexico","2024-01-01",0,0,0,0,0,0,0,0
"Mexico","2024-01-02",0,0,0,0,0,0,0,0
"Mexico","2024-01-03",0,0,0,0,0,0,0,0
"Mexico","2024-01-04",0,0,0,0,0,0,0,0
"Mexico","2024-01-05",0,0,0,0,0,0,0,0
"Mexico","2024-01-06",0,0,0,0,0,0,0,0
"Mexico","2024-01-07",0,0,0,0,0,0,0,0
"Mexico","2024-01-08",0,0,0,0,0,0,0,0
"Mexico","2024-01-09",0,1,1,0,1,1,0,0
"Mexico","2024-01-10",0,0,1,0,0,1,0,0
"Mexico","2024-01-11",0,0,1,0,0,1,0,0
"Mexico","2024-01-12",0,0,1,0,0,1,0,0
"Mexico","2024-01-13",0,0,1,0,1,2,0,0
"Mexico","2024-01-14",0,0,1,0,0,2,0,0
"Mexico","2024-01-15",0,0,1,0,0,2,0,0
"Mexico","2024-01-16",0,1,2,0,0,2,0,0
"Mexico","2024-01-17",0,0,2,0,0,2,0,0
"Mexico","2024-01-18",0,0,2,0,0,2,0,0
"Mexico","2024-01-19",0,0,2,0,0,2,0,0
"Mexico","2024-01-20",0,0,2,0,1,3,0,0
"Mexico","2024-01-21",0,0,2,0,0,3,0,0
"Mexico","2024-01-22",0,0,2,0,0,3,0,0
"Mexico","2024-01-23",0,0,2,0,0,3,0,0
"Mexico","2024-01-24",0,0,2,0,0,3,0,0
"Mexico","2024-01-25",0,0,2,0,0,3,0,0
"Mexico","2024-01-26",0,0,2,0,0,3,0,0
"Mexico","2024-01-27",0,0,2,0,1,4,0,0
"Mexico","2024-01-28",0,0,2,0,0,4,0,0
"Mexico","2024-01-29",0,0,2,0,0,4,0,0
"Mexico","2024-01-30",0,2,4,0,0,4,0,0
"Mexico","2024-01-31",0,0,4,0,0,4,0,0
"Mexico","2024-02-01",0,0,4,0,0,4,0,0
"Mexico","2024-02-02",0,0,4,0,0,4,0,0
"Mexico","2024-02-03",0,0,4,0,0,4,0,0
"Mexico","2024-02-04",0,0,4,0,0,4,0,0
"Mexico","2024-02-05",0,0,4,0,0,4,0,0
"Mexico","2024-02-06",0,0,4,0,0,4,0,0
"Mexico","2024-02-07",0,0,4,0,1,5,0,0
"Mexico","2024-02-08",0,0,4,0,0,5,0,0
"Mexico","2024-02-09",0,0,4,0,0,5,0,0
"Mexico","2024-02-10",0,0,4,0,0,5,0,0
"Mexico","2024-02-11",0,0,4,0,0,5,0,0
"Mexico","2024-02-12",0,0,4,0,0,5,0,0
"Mexico","2024-02-13",0,1,5,0,0,5,0,0
"Mexico","2024-02-14",0,0,5,0,0,5,0,0
"Mexico","2024-02-15",0,0,5,0,0,5,0,0
"Mexico","2024-02-16",0,0,5,0,0,5,0,0
"Mexico","2024-02-17",0,0,5,0,0,5,0,0
"Mexico","2024-02-18",0,0,5,0,0,5,0,0
"Mexico","2024-02-19",0,0,5,0,0,5,0,0
"Mexico","2024-02-20",0,0,5,0,0,5,0,0
"Mexico","2024-02-21",0,0,5,0,1,6,0,0
"Mexico","2024-02-22",0,0,5,0,0,6,0,0
"Mexico","2024-02-23",0,0,5,0,0,6,0,0
"Mexico","2024-02-24",0,0,5,0,0,6,0,0
"Mexico","2024-02-25",0,0,5,0,0,6,0,0
"Mexico","2024-02-26",0,0,5,0,0,6,0,0
"Mexico","2024-02-27",0,0,5,0,0,6,0,0
"Mexico","2024-02-28",0,0,5,0,0,6,0,0
"Mexico","2024-02-29",0,0,5,0,0,6,0,0
"Mexico","2024-03-01",0,0,5,0,0,6,0,0
"Mexico","2024-03-02",0,0,5,0,0,6,0,0
"Mexico","2024-03-03",0,0,5,0,0,6,0,0
"Mexico","2024-03-04",0,0,5,0,0,6,0,0
"Mexico","2024-03-05",0,0,5,0,1,7,0,0
"Mexico","2024-03-06",0,0,5,0,0,7,0,0
"Mexico","2024-03-07",0,0,5,0,0,7,0,0
"Mexico","2024-03-08",0,0,5,0,0,7,0,0
"Mexico","2024-03-09",0,0,5,0,0,7,0,0
"Mexico","2024-03-10",0,0,5,0,0,7,0,0
"Mexico","2024-03-11",0,0,5,0,0,7,0,0
"Mexico","2024-03-12",0,2,7,0,0,7,0,0
"Mexico","2024-03-13",0,0,7,0,0,7,0,0
"Mexico","2024-03-14",0,0,7,0,0,7,0,0
"Mexico","2024-03-15",0,0,7,0,0,7,0,0
"Mexico","2024-03-16",0,0,7,0,1,8,0,0
"Mexico","2024-03-17",0,0,7,0,0,8,0,0
"Mexico","2024-03-18",0,0,7,0,0,8,0,0
"Mexico","2024-03-19",0,0,7,0,0,8,0,0
"Mexico","2024-03-20",0,0,7,0,0,8,0,0
"Mexico","2024-03-21",0,0,7,0,0,8,0,0
"Mexico","2024-03-22",0,0,7,0,0,8,0,0
"Mexico","2024-03-23",0,0,7,0,1,9,0,0
"Mexico","2024-03-24",0,0,7,0,0,9,0,0
"Mexico","2024-03-25",0,0,7,0,0,9,0,0
"Mexico","2024-03-26",0,2,9,0,0,9,0,0
"Mexico","2024-03-27",0,0,9,0,0,9,0,0
"Mexico","2024-03-28",0,0,9,0,0,9,0,0
"Mexico","2024-03-29",0,0,9,0,0,9,0,0
"Mexico","2024-03-30",0,0,9,0,1,10,0,0
"Mexico","2024-03-31",0,0,9,0,0,10,0,0
"Mexico","2024-04-01",0,0,9,0,0,10,0,0
"Mexico","2024-04-02",0,1,10,0,0,10,0,0
"Mexico","2024-04-03",0,0,10,0,0,10,0,0
"Mexico","2024-04-04",0,0,10,0,0,10,0,0
"Mexico","2024-04-05",0,0,10,0,0,10,0,0
"Mexico","2024-04-06",0,0,10,0,1,11,0,0
"Mexico","2024-04-07",0,0,10,0,0,11,0,0
"Mexico","2024-04-08",0,0,10,0,0,11,0,0
"Mexico","2024-04-09",0,0,10,0,0,11,0,0
"Mexico","2024-04-10",0,0,10,0,0,11,0,0
"Mexico","2024-04-11",0,0,10,0,0,11,0,0
"Mexico","2024-04-12",0,0,10,0,0,11,0,0
"Mexico","2024-04-13",0,0,10,0,1,12,0,0
"Mexico","2024-04-14",0,0,10,0,0,12,0,0
"Mexico","2024-04-15",0,0,10,0,0,12,0,0
"Mexico","2024-04-16",0,2,12,0,0,12,0,0
"Mexico","2024-04-17",0,0,12,0,1,13,0,0
"Mexico","2024-04-18",0,0,12,0,0,13,0,0
"Mexico","2024-04-19",0,0,12,0,1,14,0,0
"Mexico","2024-04-20",0,0,12,0,1,15,0,0
"Mexico","2024-04-21",0,0,12,0,1,16,0,0
"Mexico","2024-04-22",0,0,12,0,0,16,0,0
"Mexico","2024-04-23",0,5,17,0,1,17,0,0
"Mexico","2024-04-24",0,0,17,0,0,17,0,0
"Mexico","2024-04-25",0,0,17,0,0,17,0,0
"Mexico","2024-04-26",0,0,17,0,0,17,0,0
"Mexico","2024-04-27",0,0,17,0,1,18,0,0
"Mexico","2024-04-28",0,0,17,0,0,18,0,0
"Mexico","2024-04-29",0,0,17,0,0,18,0,0
"Mexico","2024-04-30",0,1,18,0,0,18,0,0
"Mexico","2024-05-01",0,0,18,0,0,18,0,0
"Mexico","2024-05-02",0,0,18,0,1,19,0,0
"Mexico","2024-05-03",0,0,18,0,0,19,0,0
"Mexico","2024-05-04",0,0,18,0,1,20,0,0
"Mexico","2024-05-05",0,0,18,0,0,20,0,0
"Mexico","2024-05-06",0,0,18,0,1,21,0,0
"Mexico","2024-05-07",0,0,18,0,0,21,0,0
"Mexico","2024-05-08",0,0,18,0,0,21,0,0
"Mexico","2024-05-09",0,0,18,0,1,22,0,0
"Mexico","2024-05-10",0,0,18,0,0,22,0,0
"Mexico","2024-05-11",0,0,18,0,1,23,0,0
"Mexico","2024-05-12",0,0,18,0,0,23,0,0
"Mexico","2024-05-13",0,0,18,0,1,24,0,0
"Mexico","2024-05-14",0,6,24,0,0,24,0,0
"Mexico","2024-05-15",0,0,24,0,0,24,0,0
"Mexico","2024-05-16",0,0,24,0,1,25,0,0
"Mexico","2024-05-17",0,0,24,0,0,25,0,0
"Mexico","2024-05-18",0,0,24,0,1,26,0,0
"Mexico","2024-05-19",0,0,24,0,0,26,0,0
"Mexico","2024-05-20",0,0,24,0,1,27,0,0
"Mexico","2024-05-21",0,3,27,0,0,27,0,0
"Mexico","2024-05-22",0,0,27,0,1,28,0,0
"Mexico","2024-05-23",0,0,27,0,1,29,0,0
"Mexico","2024-05-24",0,0,27,0,1,30,0,0
"Mexico","2024-05-25",0,0,27,0,2,32,0,0
"Mexico","2024-05-26",0,0,27,0,1,33,0,0
"Mexico","2024-05-27",0,0,27,0,1,34,0,0
"Mexico","2024-05-28",0,8,35,0,1,35,0,0
"Mexico","2024-05-29",0,0,35,0,0,35,0,0
"Mexico","2024-05-30",0,0,35,0,1,36,0,0
"Mexico","2024-05-31",0,0,35,0,0,36,0,0
"Mexico","2024-06-01",0,0,35,0,1,37,0,0
"Mexico","2024-06-02",0,0,35,0,0,37,0,0
"Mexico","2024-06-03",0,0,35,0,1,38,0,0
"Mexico","2024-06-04",0,3,38,0,0,38,0,0
"Mexico","2024-06-05",0,0,38,0,0,38,0,0
"Mexico","2024-06-06",0,0,38,0,1,39,0,0
"Mexico","2024-06-07",0,0,38,0,0,39,0,0
"Mexico","2024-06-08",0,0,38,0,0,39,0,0
"Mexico","2024-06-09",0,0,38,0,0,39,0,0
"Mexico","2024-06-10",0,0,38,0,1,40,0,0
"Mexico","2024-06-11",0,2,40,0,0,40,0,0
"Mexico","2024-06-12",0,0,40,0,1,41,0,0
"Mexico","2024-06-13",0,0,40,0,0,41,0,0
"Mexico","2024-06-14",0,0,40,0,1,42,0,0
"Mexico","2024-06-15",0,0,40,0,0,42,0,0
"Mexico","2024-06-16",0,0,40,0,1,43,0,0
"Mexico","2024-06-17",0,0,40,0,0,43,0,0
"Mexico","2024-06-18",0,4,44,0,1,44,0,0
"Mexico","2024-06-19",0,0,44,0,0,44,0,0
"Mexico","2024-06-20",0,0,44,0,1,45,0,0
"Mexico","2024-06-21",0,0,44,0,0,45,0,0
"Mexico","2024-06-22",0,0,44,0,0,45,0,0
"Mexico","2024-06-23",0,0,44,0,0,45,0,0
"Mexico","2024-06-24",0,0,44,0,1,46,0,0
"Mexico","2024-06-25",0,2,46,0,0,46,0,0
"Mexico","2024-06-26",0,0,46,0,0,46,0,0
"Mexico","2024-06-27",0,0,46,0,0,46,0,0
"Mexico","2024-06-28",0,0,46,0,0,46,0,0
"Mexico","2024-06-29",0,0,46,0,1,47,0,0
"Mexico","2024-06-30",0,0,46,0,0,47,0,0
"Mexico","2024-07-01",0,0,46,0,0,47,0,0
"Mexico","2024-07-02",0,1,47,0,0,47,0,0
"Mexico","2024-07-03",0,0,47,0,0,47,0,0
"Mexico","2024-07-04",0,0,47,0,1,48,0,0
"Mexico","2024-07-05",0,0,47,0,0,48,0,0
"Mexico","2024-07-06",0,0,47,0,0,48,0,0
"Mexico","2024-07-07",0,0,47,0,0,48,0,0
"Mexico","2024-07-08",0,0,47,0,1,49,0,0
"Mexico","2024-07-09",0,2,49,0,0,49,0,0
"Mexico","2024-07-10",0,0,49,0,0,49,0,0
"Mexico","2024-07-11",0,0,49,0,0,49,0,0
"Mexico","2024-07-12",0,0,49,0,1,50,0,0
"Mexico","2024-07-13",0,0,49,0,0,50,0,0
"Mexico","2024-07-14",0,0,49,0,0,50,0,0
"Mexico","2024-07-15",0,0,49,0,0,50,0,0
"Mexico","2024-07-16",0,0,49,0,1,51,0,0
"Mexico","2024-07-17",0,0,49,0,0,51,0,0
"Mexico","2024-07-18",0,0,49,0,0,51,0,0
"Mexico","2024-07-19",0,0,49,0,0,51,0,0
"Mexico","2024-07-20",0,0,49,0,0,51,0,0
"Mexico","2024-07-21",0,0,49,0,1,52,0,0
"Mexico","2024-07-22",0,0,49,0,0,52,0,0
"Mexico","2024-07-23",0,3,52,0,0,52,0,0
"Mexico","2024-07-24",0,0,52,0,0,52,0,0
"Mexico","2024-07-25",0,0,52,0,1,53,0,0
"Mexico","2024-07-26",0,0,52,0,0,53,0,0
"Mexico","2024-07-27",0,0,52,0,0,53,0,0
"Mexico","2024-07-28",0,0,52,0,0,53,0,0
"Mexico","2024-07-29",0,0,52,0,1,54,0,0
"Mexico","2024-07-30",0,2,54,0,0,54,0,0
"Mexico","2024-07-31",0,0,54,0,1,55,0,0
"Mexico","2024-08-01",0,0,54,0,0,55,0,0
"Mexico","2024-08-02",0,0,54,0,1,56,0,0
"Mexico","2024-08-03",0,0,54,0,1,57,0,0
"Mexico","2024-08-04",0,0,54,0,1,58,0,0
"Mexico","2024-08-05",0,0,54,0,0,58,0,0
"Mexico","2024-08-06",0,5,59,0,1,59,0,0
"Mexico","2024-08-07",0,0,59,0,2,61,0,0
"Mexico","2024-08-08",0,0,59,0,1,62,0,0
"Mexico","2024-08-09",0,0,59,0,2,64,0,0
"Mexico","2024-08-10",0,0,59,0,1,65,0,0
"Mexico","2024-08-11",0,0,59,0,2,67,0,0
"Mexico","2024-08-12",0,0,59,0,1,68,0,0
"Mexico","2024-08-13",0,11,70,0,2,70,0,0
"Mexico","2024-08-14",0,0,70,0,1,71,0,0
"Mexico","2024-08-15",0,0,70,0,0,71,0,0
"Mexico","2024-08-16",0,0,70,0,1,72,0,0
"Mexico","2024-08-17",0,0,70,0,1,73,0,0
"Mexico","2024-08-18",0,0,70,0,1,74,0,0
"Mexico","2024-08-19",0,0,70,0,0,74,0,0
"Mexico","2024-08-20",0,5,75,0,1,75,0,0
"Mexico","2024-08-21",0,0,75,0,1,76,0,0
"Mexico","2024-08-22",0,0,75,0,2,78,0,0
"Mexico","2024-08-23",0,0,75,0,1,79,0,0
"Mexico","2024-08-24",0,0,75,0,2,81,0,0
"Mexico","2024-08-25",0,0,75,0,1,82,0,0
"Mexico","2024-08-26",0,0,75,0,2,84,0,0
"Mexico","2024-08-27",0,10,85,0,1,85,0,0
"Mexico","2024-08-28",0,0,85,0,1,86,0,0
"Mexico","2024-08-29",0,0,85,0,0,86,0,0
"Mexico","2024-08-30",0,0,85,0,1,87,0,0
"Mexico","2024-08-31",0,0,85,0,0,87,0,0
"Mexico","2024-09-01",0,0,85,0,1,88,0,0
"Mexico","2024-09-02",0,0,85,0,0,88,0,0
"Mexico","2024-09-03",0,4,89,0,1,89,0,0
"Mexico","2024-09-04",0,0,89,0,0,89,0,0
"Mexico","2024-09-05",0,0,89,0,1,90,0,0
"Mexico","2024-09-06",0,0,89,0,0,90,0,0
"Mexico","2024-09-07",0,0,89,0,1,91,0,0
"Mexico","2024-09-08",0,0,89,0,0,91,0,0
"Mexico","2024-09-09",0,0,89,0,1,92,0,0
"Mexico","2024-09-10",0,3,92,0,0,92,0,0
"Mexico","2024-09-11",0,0,92,0,1,93,0,0
"Mexico","2024-09-12",0,0,92,0,1,94,0,0
"Mexico","2024-09-13",0,0,92,0,1,95,0,0
"Mexico","2024-09-14",0,0,92,0,0,95,0,0
"Mexico","2024-09-15",0,0,92,0,1,96,0,0
"Mexico","2024-09-16",0,0,92,0,1,97,0,0
"Mexico","2024-09-17",0,6,98,0,1,98,0,0
"Mexico","2024-09-18",0,0,98,0,1,99,0,0
"Mexico","2024-09-19",0,0,98,0,0,99,0,0
"Mexico","2024-09-20",0,0,98,0,1,100,0,0
"Mexico","2024-09-21",0,0,98,0,0,100,0,0
"Mexico","2024-09-22",0,0,98,0,1,101,0,0
"Mexico","2024-09-23",0,0,98,0,0,101,0,0
"Mexico","2024-09-24",0,4,102,0,1,102,0,0
"Mexico","2024-09-25",0,0,102,0,0,102,0,0
"Mexico","2024-09-26",0,0,102,0,1,103,0,0
"Mexico","2024-09-27",0,0,102,0,0,103,0,0
"Mexico","2024-09-28",0,0,102,0,0,103,0,0
"Mexico","2024-09-29",0,0,102,0,0,103,0,0
"Mexico","2024-09-30",0,0,102,0,1,104,0,0
"Mexico","2024-10-01",0,2,104,0,0,104,0,0
"Mexico","2024-10-02",0,0,104,0,0,104,0,0
"Mexico","2024-10-03",0,0,104,0,0,104,0,0
"Mexico","2024-10-04",0,0,104,0,0,104,0,0
"Mexico","2024-10-05",0,0,104,0,1,105,0,0
"Mexico","2024-10-06",0,0,104,0,0,105,0,0
"Mexico","2024-10-07",0,0,104,0,0,105,0,0
"Mexico","2024-10-08",0,1,105,0,0,105,0,0
"Mexico","2024-10-09",0,0,105,0,0,105,0,0
"Mexico","2024-10-10",0,0,105,0,0,105,0,0
"Mexico","2024-10-11",0,0,105,0,0,105,0,0
"Mexico","2024-10-12",0,0,105,0,0,105,0,0
"Mexico","2024-10-13",0,0,105,0,0,105,0,0
"Mexico","2024-10-14",0,0,105,0,0,105,0,0
"Mexico","2024-10-15",0,0,105,0,0,105,0,0
"Mexico","2024-10-16",0,0,105,0,0,105,0,0
"Mexico","2024-10-17",0,0,105,0,0,105,0,0
"Mexico","2024-10-18",0,0,105,0,0,105,0,0
"Mexico","2024-10-19",0,0,105,0,0,105,0,0
"Mexico","2024-10-20",0,0,105,0,0,105,0,0
"Mexico","2024-10-21",0,0,105,0,0,105,0,0
"Mexico","2024-10-22",0,0,105,0,0,105,0,0
"Mexico","2024-10-23",0,0,105,0,0,105,0,0
"Mexico","2024-10-24",0,0,105,0,0,105,0,0
"Mexico","2024-10-25",0,0,105,0,0,105,0,0
"Mexico","2024-10-26",0,0,105,0,0,105,0,0
"Mexico","2024-10-27",0,0,105,0,0,105,0,0
"Mexico","2024-10-28",0,0,105,0,0,105,0,0
"Mexico","2024-10-29",0,0,105,0,0,105,0,0
"Mexico","2024-10-30",0,0,105,0,0,105,0,0
"Mexico","2024-10-31",0,0,105,0,0,105,0,0
"Mexico","2024-11-01",0,0,105,0,0,105,0,0
"Mexico","2024-11-02",0,0,105,0,0,105,0,0
"Mexico","2024-11-03",0,0,105,0,0,105,0,0
"Mexico","2024-11-04",0,0,105,0,0,105,0,0
"Mexico","2024-11-05",0,0,105,0,0,105,0,0
"Mexico","2024-11-06",0,0,105,0,0,105,0,0
"Mexico","2024-11-07",0,0,105,0,0,105,0,0
"Mexico","2024-11-08",0,0,105,0,0,105,0,0
"Mexico","2024-11-09",0,0,105,0,0,105,0,0
"Mexico","2024-11-10",0,0,105,0,0,105,0,0
"Mexico","2024-11-11",0,0,105,0,0,105,0,0
"Mexico","2024-11-12",0,0,105,0,0,105,0,0
"Mexico","2024-11-13",0,0,105,0,0,105,0,0
"Mexico","2024-11-14",0,0,105,0,0,105,0,0
"Mexico","2024-11-15",0,0,105,0,0,105,0,0
"Mexico","2024-11-16",0,0,105,0,0,105,0,0
"Mexico","2024-11-17",0,0,105,0,0,105,0,0
"Mexico","2024-11-18",0,0,105,0,0,105,0,0
"Mexico","2024-11-19",0,0,105,0,0,105,0,0
"Mexico","2024-11-20",0,0,105,0,0,105,0,0
"Mexico","2024-11-21",0,0,105,0,0,105,0,0
"Mexico","2024-11-22",0,0,105,0,0,105,0,0
"Mexico","2024-11-23",0,0,105,0,0,105,0,0
"Mexico","2024-11-24",0,0,105,0,0,105,0,0
"Mexico","2024-11-25",0,0,105,0,0,105,0,0
"Mexico","2024-11-26",0,0,105,0,0,105,0,0
"Mexico","2024-11-27",0,0,105,0,0,105,0,0
"Mexico","2024-11-28",0,0,105,0,0,105,0,0
"Mexico","2024-11-29",0,0,105,0,0,105,0,0
"Mexico","2024-11-30",0,0,105,0,0,105,0,0
"Mexico","2024-12-01",0,0,105,0,0,105,0,0
"Mexico","2024-12-02",0,0,105,0,0,105,0,0
"Mexico","2024-12-03",0,0,105,0,0,105,0,0
"Mexico","2024-12-04",0,0,105,0,0,105,0,0
"Mexico","2024-12-05",0,0,105,0,0,105,0,0
"Mexico","2024-12-06",0,0,105,0,0,105,0,0
"Mexico","2024-12-07",0,0,105,0,0,105,0,0
"Mexico","2024-12-08",0,0,105,0,0,105,0,0
"Mexico","2024-12-09",0,0,105,0,0,105,0,0
"Republic of Moldova","2024-01-01",0,0,0,0,0,0,0,0
"Republic of Moldova","2024-01-02",0,0,0,0,0,0,0,0
"Republic of Moldova","2024-01-03",0,0,0,0,0,0,0,0
"Republic of Moldova","2024-01-04",0,0,0,0,0,0,0,0
"Republic of Moldova","2024-01-05",0,0,0,0,0,0,0,0
"Republic of Moldova","2024-01-06",0,0,0,0,0,0,0,0
"Republic of Moldova","2024-01-07",0,0,0,0,0,0,0,0
"Republic of Moldova","2024-01-08",0,0,0,0,0,0,0,0
"Republic of Moldova","2024-01-09",0,0,0,0,0,0,0,0
"Republic of Moldova","2024-01-10",0,0,0,0,0,0,0,0
"Republic of Moldova","2024-01-11",0,0,0,0,0,0,0,0
"Republic of Moldova","2024-01-12",0,0,0,0,0,0,0,0
"Republic of Moldova","2024-01-13",0,0,0,0,0,0,0,0
"Republic of Moldova","2024-01-14",0,0,0,0,0,0,0,0
"Republic of Moldova","2024-01-15",0,0,0,0,0,0,0,0
"Republic of Moldova","2024-01-16",0,0,0,0,0,0,0,0
"Republic of Moldova","2024-01-17",0,0,0,0,0,0,0,0
"Republic of Moldova","2024-01-18",0,0,0,0,0,0,0,0
"Republic of Moldova","2024-01-19",0,0,0,0,0,0,0,0
"Republic of Moldova","2024-01-20",0,0,0,0,0,0,0,0
"Republic of Moldova","2024-01-21",0,0,0,0,0,0,0,0
"Republic of Moldova","2024-01-22",0,0,0,0,0,0,0,0
"Republic of Moldova","2024-01-23",0,0,0,0,0,0,0,0
"Republic of Moldova","2024-01-24",0,0,0,0,0,0,0,0
"Republic of Moldova","2024-01-25",0,0,0,0,0,0,0,0
"Republic of Moldova","2024-01-26",0,0,0,0,0,0,0,0
"Republic of Moldova","2024-01-27",0,0,0,0,0,0,0,0
"Republic of Moldova","2024-01-28",0,0,0,0,0,0,0,0
"Republic of Moldova","2024-01-29",0,0,0,0,0,0,0,0
"Republic of Moldova","2024-01-30",0,0,0,0,0,0,0,0
"Republic of Moldova","2024-01-31",0,0,0,0,0,0,0,0
"Republic of Moldova","2024-02-01",0,0,0,0,0,0,0,0
"Republic of Moldova","2024-02-02",0,0,0,0,0,0,0,0
"Republic of Moldova","2024-02-03",0,0,0,0,0,0,0,0
"Republic of Moldova","2024-02-04",0,0,0,0,0,0,0,0
"Republic of Moldova","2024-02-05",0,0,0,0,0,0,0,0
"Republic of Moldova","2024-02-06",0,0,0,0,0,0,0,0
"Republic of Moldova","2024-02-07",0,0,0,0,0,0,0,0
"Republic of Moldova","2024-02-08",0,0,0,0,0,0,0,0
"Republic of Moldova","2024-02-09",0,0,0,0,0,0,0,0
"Republic of Moldova","2024-02-10",0,0,0,0,0,0,0,0
"Republic of Moldova","2024-02-11",0,0,0,0,0,0,0,0
"Republic of Moldova","2024-02-12",0,0,0,0,0,0,0,0
"Republic of Moldova","2024-02-13",0,0,0,0,0,0,0,0
"Republic of Moldova","2024-02-14",0,0,0,0,0,0,0,0
"Republic of Moldova","2024-02-15",0,0,0,0,0,0,0,0
"Republic of Moldova","2024-02-16",0,0,0,0,0,0,0,0
"Republic of Moldova","2024-02-17",0,0,0,0,0,0,0,0
"Republic of Moldova","2024-02-18",0,0,0,0,0,0,0,0
"Republic of Moldova","2024-02-19",0,0,0,0,0,0,0,0
"Republic of Moldova","2024-02-20",0,0,0,0,0,0,0,0
"Republic of Moldova","2024-02-21",0,0,0,0,0,0,0,0
"Republic of Moldova","2024-02-22",0,0,0,0,0,0,0,0
"Republic of Moldova","2024-02-23",0,0,0,0,0,0,0,0
"Republic of Moldova","2024-02-24",0,0,0,0,0,0,0,0
"Republic of Moldova","2024-02-25",0,0,0,0,0,0,0,0
"Republic of Moldova","2024-02-26",0,0,0,0,0,0,0,0
"Republic of Moldova","2024-02-27",0,0,0,0,0,0,0,0
"Republic of Moldova","2024-02-28",0,0,0,0,0,0,0,0
"Republic of Moldova","2024-02-29",0,0,0,0,0,0,0,0
"Republic of Moldova","2024-03-01",0,0,0,0,0,0,0,0
"Republic of Moldova","2024-03-02",0,0,0,0,0,0,0,0
"Republic of Moldova","2024-03-03",0,0,0,0,0,0,0,0
"Republic of Moldova","2024-03-04",0,0,0,0,0,0,0,0
"Republic of Moldova","2024-03-05",0,0,0,0,0,0,0,0
"Republic of Moldova","2024-03-06",0,0,0,0,0,0,0,0
"Republic of Moldova","2024-03-07",0,0,0,0,0,0,0,0
"Republic of Moldova","2024-03-08",0,0,0,0,0,0,0,0
"Republic of Moldova","2024-03-09",0,0,0,0,0,0,0,0
"Republic of Moldova","2024-03-10",0,0,0,0,0,0,0,0
"Republic of Moldova","2024-03-11",0,0,0,0,0,0,0,0
"Republic of Moldova","2024-03-12",0,0,0,0,0,0,0,0
"Republic of Moldova","2024-03-13",0,0,0,0,0,0,0,0
"Republic of Moldova","2024-03-14",0,0,0,0,0,0,0,0
"Republic of Moldova","2024-03-15",0,0,0,0,0,0,0,0
"Republic of Moldova","2024-03-16",0,0,0,0,0,0,0,0
"Republic of Moldova","2024-03-17",0,0,0,0,0,0,0,0
"Republic of Moldova","2024-03-18",0,0,0,0,0,0,0,0
"Republic of Moldova","2024-03-19",0,0,0,0,0,0,0,0
"Republic of Moldova","2024-03-20",0,0,0,0,0,0,0,0
"Republic of Moldova","2024-03-21",0,0,0,0,0,0,0,0
"Republic of Moldova","2024-03-22",0,0,0,0,0,0,0,0
"Republic of Moldova","2024-03-23",0,0,0,0,0,0,0,0
"Republic of Moldova","2024-03-24",0,0,0,0,0,0,0,0
"Republic of Moldova","2024-03-25",0,0,0,0,0,0,0,0
"Republic of Moldova","2024-03-26",0,0,0,0,0,0,0,0
"Republic of Moldova","2024-03-27",0,0,0,0,0,0,0,0
"Republic of Moldova","2024-03-28",0,0,0,0,0,0,0,0
"Republic of Moldova","2024-03-29",0,0,0,0,0,0,0,0
"Republic of Moldova","2024-03-30",0,0,0,0,0,0,0,0
"Republic of Moldova","2024-03-31",0,0,0,0,0,0,0,0
"Republic of Moldova","2024-04-01",0,0,0,0,0,0,0,0
"Republic of Moldova","2024-04-02",0,0,0,0,0,0,0,0
"Republic of Moldova","2024-04-03",0,0,0,0,0,0,0,0
"Republic of Moldova","2024-04-04",0,0,0,0,0,0,0,0
"Republic of Moldova","2024-04-05",0,0,0,0,0,0,0,0
"Republic of Moldova","2024-04-06",0,0,0,0,0,0,0,0
"Republic of Moldova","2024-04-07",0,0,0,0,0,0,0,0
"Republic of Moldova","2024-04-08",0,0,0,0,0,0,0,0
"Republic of Moldova","2024-04-09",0,0,0,0,0,0,0,0
"Republic of Moldova","2024-04-10",0,0,0,0,0,0,0,0
"Republic of Moldova","2024-04-11",0,0,0,0,0,0,0,0
"Republic of Moldova","2024-04-12",0,0,0,0,0,0,0,0
"Republic of Moldova","2024-04-13",0,0,0,0,0,0,0,0
"Republic of Moldova","2024-04-14",0,0,0,0,0,0,0,0
"Republic of Moldova","2024-04-15",0,0,0,0,0,0,0,0
"Republic of Moldova","2024-04-16",0,0,0,0,0,0,0,0
"Republic of Moldova","2024-04-17",0,0,0,0,0,0,0,0
"Republic of Moldova","2024-04-18",0,0,0,0,0,0,0,0
"Republic of Moldova","2024-04-19",0,0,0,0,0,0,0,0
"Republic of Moldova","2024-04-20",0,0,0,0,0,0,0,0
"Republic of Moldova","2024-04-21",0,0,0,0,0,0,0,0
"Republic of Moldova","2024-04-22",0,0,0,0,0,0,0,0
"Republic of Moldova","2024-04-23",0,0,0,0,0,0,0,0
"Republic of Moldova","2024-04-24",0,0,0,0,0,0,0,0
"Republic of Moldova","2024-04-25",0,0,0,0,0,0,0,0
"Republic of Moldova","2024-04-26",0,0,0,0,0,0,0,0
"Republic of Moldova","2024-04-27",0,0,0,0,0,0,0,0
"Republic of Moldova","2024-04-28",0,0,0,0,0,0,0,0
"Republic of Moldova","2024-04-29",0,0,0,0,0,0,0,0
"Republic of Moldova","2024-04-30",0,0,0,0,0,0,0,0
"Republic of Moldova","2024-05-01",0,0,0,0,0,0,0,0
"Republic of Moldova","2024-05-02",0,0,0,0,0,0,0,0
"Republic of Moldova","2024-05-03",0,0,0,0,0,0,0,0
"Republic of Moldova","2024-05-04",0,0,0,0,0,0,0,0
"Republic of Moldova","2024-05-05",0,0,0,0,0,0,0,0
"Republic of Moldova","2024-05-06",0,0,0,0,0,0,0,0
"Republic of Moldova","2024-05-07",0,0,0,0,0,0,0,0
"Republic of Moldova","2024-05-08",0,0,0,0,0,0,0,0
"Republic of Moldova","2024-05-09",0,0,0,0,0,0,0,0
"Republic of Moldova","2024-05-10",0,0,0,0,0,0,0,0
"Republic of Moldova","2024-05-11",0,0,0,0,0,0,0,0
"Republic of Moldova","2024-05-12",0,0,0,0,0,0,0,0
"Republic of Moldova","2024-05-13",0,0,0,0,0,0,0,0
"Republic of Moldova","2024-05-14",0,0,0,0,0,0,0,0
"Republic of Moldova","2024-05-15",0,0,0,0,0,0,0,0
"Republic of Moldova","2024-05-16",0,0,0,0,0,0,0,0
"Republic of Moldova","2024-05-17",0,0,0,0,0,0,0,0
"Republic of Moldova","2024-05-18",0,0,0,0,0,0,0,0
"Republic of Moldova","2024-05-19",0,0,0,0,0,0,0,0
"Republic of Moldova","2024-05-20",0,0,0,0,0,0,0,0
"Republic of Moldova","2024-05-21",0,0,0,0,0,0,0,0
"Republic of Moldova","2024-05-22",0,0,0,0,0,0,0,0
"Republic of Moldova","2024-05-23",0,0,0,0,0,0,0,0
"Republic of Moldova","2024-05-24",0,0,0,0,0,0,0,0
"Republic of Moldova","2024-05-25",0,0,0,0,0,0,0,0
"Republic of Moldova","2024-05-26",0,0,0,0,0,0,0,0
"Republic of Moldova","2024-05-27",0,0,0,0,0,0,0,0
"Republic of Moldova","2024-05-28",0,0,0,0,0,0,0,0
"Republic of Moldova","2024-05-29",0,0,0,0,0,0,0,0
"Republic of Moldova","2024-05-30",0,0,0,0,0,0,0,0
"Republic of Moldova","2024-05-31",0,0,0,0,0,0,0,0
"Republic of Moldova","2024-06-01",0,0,0,0,0,0,0,0
"Republic of Moldova","2024-06-02",0,0,0,0,0,0,0,0
"Republic of Moldova","2024-06-03",0,0,0,0,0,0,0,0
"Republic of Moldova","2024-06-04",0,0,0,0,0,0,0,0
"Republic of Moldova","2024-06-05",0,0,0,0,0,0,0,0
"Republic of Moldova","2024-06-06",0,0,0,0,0,0,0,0
"Republic of Moldova","2024-06-07",0,0,0,0,0,0,0,0
"Republic of Moldova","2024-06-08",0,0,0,0,0,0,0,0
"Republic of Moldova","2024-06-09",0,0,0,0,0,0,0,0
"Republic of Moldova","2024-06-10",0,0,0,0,0,0,0,0
"Republic of Moldova","2024-06-11",0,0,0,0,0,0,0,0
"Republic of Moldova","2024-06-12",0,0,0,0,0,0,0,0
"Republic of Moldova","2024-06-13",0,0,0,0,0,0,0,0
"Republic of Moldova","2024-06-14",0,0,0,0,0,0,0,0
"Republic of Moldova","2024-06-15",0,0,0,0,0,0,0,0
"Republic of Moldova","2024-06-16",0,0,0,0,0,0,0,0
"Republic of Moldova","2024-06-17",0,0,0,0,0,0,0,0
"Republic of Moldova","2024-06-18",0,0,0,0,0,0,0,0
"Republic of Moldova","2024-06-19",0,0,0,0,0,0,0,0
"Republic of Moldova","2024-06-20",0,0,0,0,0,0,0,0
"Republic of Moldova","2024-06-21",0,0,0,0,0,0,0,0
"Republic of Moldova","2024-06-22",0,0,0,0,0,0,0,0
"Republic of Moldova","2024-06-23",0,0,0,0,0,0,0,0
"Republic of Moldova","2024-06-24",0,0,0,0,0,0,0,0
"Republic of Moldova","2024-06-25",0,0,0,0,0,0,0,0
"Republic of Moldova","2024-06-26",0,0,0,0,0,0,0,0
"Republic of Moldova","2024-06-27",0,0,0,0,0,0,0,0
"Republic of Moldova","2024-06-28",0,0,0,0,0,0,0,0
"Republic of Moldova","2024-06-29",0,0,0,0,0,0,0,0
"Republic of Moldova","2024-06-30",0,0,0,0,0,0,0,0
"Republic of Moldova","2024-07-01",0,0,0,0,0,0,0,0
"Republic of Moldova","2024-07-02",0,0,0,0,0,0,0,0
"Republic of Moldova","2024-07-03",0,0,0,0,0,0,0,0
"Republic of Moldova","2024-07-04",0,0,0,0,0,0,0,0
"Republic of Moldova","2024-07-05",0,0,0,0,0,0,0,0
"Republic of Moldova","2024-07-06",0,0,0,0,0,0,0,0
"Republic of Moldova","2024-07-07",0,0,0,0,0,0,0,0
"Republic of Moldova","2024-07-08",0,0,0,0,0,0,0,0
"Republic of Moldova","2024-07-09",0,0,0,0,0,0,0,0
"Republic of Moldova","2024-07-10",0,0,0,0,0,0,0,0
"Republic of Moldova","2024-07-11",0,0,0,0,0,0,0,0
"Republic of Moldova","2024-07-12",0,0,0,0,0,0,0,0
"Republic of Moldova","2024-07-13",0,0,0,0,0,0,0,0
"Republic of Moldova","2024-07-14",0,0,0,0,0,0,0,0
"Republic of Moldova","2024-07-15",0,0,0,0,0,0,0,0
"Republic of Moldova","2024-07-16",0,0,0,0,0,0,0,0
"Republic of Moldova","2024-07-17",0,0,0,0,0,0,0,0
"Republic of Moldova","2024-07-18",0,0,0,0,0,0,0,0
"Republic of Moldova","2024-07-19",0,0,0,0,0,0,0,0
"Republic of Moldova","2024-07-20",0,0,0,0,0,0,0,0
"Republic of Moldova","2024-07-21",0,0,0,0,0,0,0,0
"Republic of Moldova","2024-07-22",0,0,0,0,0,0,0,0
"Republic of Moldova","2024-07-23",0,0,0,0,0,0,0,0
"Republic of Moldova","2024-07-24",0,0,0,0,0,0,0,0
"Republic of Moldova","2024-07-25",0,0,0,0,0,0,0,0
"Republic of Moldova","2024-07-26",0,0,0,0,0,0,0,0
"Republic of Moldova","2024-07-27",0,0,0,0,0,0,0,0
"Republic of Moldova","2024-07-28",0,0,0,0,0,0,0,0
"Republic of Moldova","2024-07-29",0,0,0,0,0,0,0,0
"Republic of Moldova","2024-07-30",0,0,0,0,0,0,0,0
"Republic of Moldova","2024-07-31",0,0,0,0,0,0,0,0
"Republic of Moldova","2024-08-01",0,0,0,0,0,0,0,0
"Republic of Moldova","2024-08-02",0,0,0,0,0,0,0,0
"Republic of Moldova","2024-08-03",0,0,0,0,0,0,0,0
"Republic of Moldova","2024-08-04",0,0,0,0,0,0,0,0
"Republic of Moldova","2024-08-05",0,0,0,0,0,0,0,0
"Republic of Moldova","2024-08-06",0,0,0,0,0,0,0,0
"Republic of Moldova","2024-08-07",0,0,0,0,0,0,0,0
"Republic of Moldova","2024-08-08",0,0,0,0,0,0,0,0
"Republic of Moldova","2024-08-09",0,0,0,0,0,0,0,0
"Republic of Moldova","2024-08-10",0,0,0,0,0,0,0,0
"Republic of Moldova","2024-08-11",0,0,0,0,0,0,0,0
"Republic of Moldova","2024-08-12",0,0,0,0,0,0,0,0
"Republic of Moldova","2024-08-13",0,0,0,0,0,0,0,0
"Republic of Moldova","2024-08-14",0,0,0,0,0,0,0,0
"Republic of Moldova","2024-08-15",0,0,0,0,0,0,0,0
"Republic of Moldova","2024-08-16",0,0,0,0,0,0,0,0
"Republic of Moldova","2024-08-17",0,0,0,0,0,0,0,0
"Republic of Moldova","2024-08-18",0,0,0,0,0,0,0,0
"Republic of Moldova","2024-08-19",0,0,0,0,0,0,0,0
"Republic of Moldova","2024-08-20",0,0,0,0,0,0,0,0
"Republic of Moldova","2024-08-21",0,0,0,0,0,0,0,0
"Republic of Moldova","2024-08-22",0,0,0,0,0,0,0,0
"Republic of Moldova","2024-08-23",0,0,0,0,0,0,0,0
"Republic of Moldova","2024-08-24",0,0,0,0,0,0,0,0
"Republic of Moldova","2024-08-25",0,0,0,0,0,0,0,0
"Republic of Moldova","2024-08-26",0,0,0,0,0,0,0,0
"Republic of Moldova","2024-08-27",0,0,0,0,0,0,0,0
"Republic of Moldova","2024-08-28",0,0,0,0,0,0,0,0
"Republic of Moldova","2024-08-29",0,0,0,0,0,0,0,0
"Republic of Moldova","2024-08-30",0,0,0,0,0,0,0,0
"Republic of Moldova","2024-08-31",0,0,0,0,0,0,0,0
"Republic of Moldova","2024-09-01",0,0,0,0,0,0,0,0
"Republic of Moldova","2024-09-02",0,0,0,0,0,0,0,0
"Republic of Moldova","2024-09-03",0,0,0,0,0,0,0,0
"Republic of Moldova","2024-09-04",0,0,0,0,0,0,0,0
"Republic of Moldova","2024-09-05",0,0,0,0,0,0,0,0
"Republic of Moldova","2024-09-06",0,0,0,0,0,0,0,0
"Republic of Moldova","2024-09-07",0,0,0,0,0,0,0,0
"Republic of Moldova","2024-09-08",0,0,0,0,0,0,0,0
"Republic of Moldova","2024-09-09",0,0,0,0,0,0,0,0
"Republic of Moldova","2024-09-10",0,0,0,0,0,0,0,0
"Republic of Moldova","2024-09-11",0,0,0,0,0,0,0,0
"Republic of Moldova","2024-09-12",0,0,0,0,0,0,0,0
"Republic of Moldova","2024-09-13",0,0,0,0,0,0,0,0
"Republic of Moldova","2024-09-14",0,0,0,0,0,0,0,0
"Republic of Moldova","2024-09-15",0,0,0,0,0,0,0,0
"Republic of Moldova","2024-09-16",0,0,0,0,0,0,0,0
"Republic of Moldova","2024-09-17",0,0,0,0,0,0,0,0
"Republic of Moldova","2024-09-18",0,0,0,0,0,0,0,0
"Republic of Moldova","2024-09-19",0,0,0,0,0,0,0,0
"Republic of Moldova","2024-09-20",0,0,0,0,0,0,0,0
"Republic of Moldova","2024-09-21",0,0,0,0,0,0,0,0
"Republic of Moldova","2024-09-22",0,0,0,0,0,0,0,0
"Republic of Moldova","2024-09-23",0,0,0,0,0,0,0,0
"Republic of Moldova","2024-09-24",0,0,0,0,0,0,0,0
"Republic of Moldova","2024-09-25",0,0,0,0,0,0,0,0
"Republic of Moldova","2024-09-26",0,0,0,0,0,0,0,0
"Republic of Moldova","2024-09-27",0,0,0,0,0,0,0,0
"Republic of Moldova","2024-09-28",0,0,0,0,0,0,0,0
"Republic of Moldova","2024-09-29",0,0,0,0,0,0,0,0
"Republic of Moldova","2024-09-30",0,0,0,0,0,0,0,0
"Republic of Moldova","2024-10-01",0,0,0,0,0,0,0,0
"Republic of Moldova","2024-10-02",0,0,0,0,0,0,0,0
"Republic of Moldova","2024-10-03",0,0,0,0,0,0,0,0
"Republic of Moldova","2024-10-04",0,0,0,0,0,0,0,0
"Republic of Moldova","2024-10-05",0,0,0,0,0,0,0,0
"Republic of Moldova","2024-10-06",0,0,0,0,0,0,0,0
"Republic of Moldova","2024-10-07",0,0,0,0,0,0,0,0
"Republic of Moldova","2024-10-08",0,0,0,0,0,0,0,0
"Republic of Moldova","2024-10-09",0,0,0,0,0,0,0,0
"Republic of Moldova","2024-10-10",0,0,0,0,0,0,0,0
"Republic of Moldova","2024-10-11",0,0,0,0,0,0,0,0
"Republic of Moldova","2024-10-12",0,0,0,0,0,0,0,0
"Republic of Moldova","2024-10-13",0,0,0,0,0,0,0,0
"Republic of Moldova","2024-10-14",0,0,0,0,0,0,0,0
"Republic of Moldova","2024-10-15",0,0,0,0,0,0,0,0
"Republic of Moldova","2024-10-16",0,0,0,0,0,0,0,0
"Republic of Moldova","2024-10-17",0,0,0,0,0,0,0,0
"Republic of Moldova","2024-10-18",0,0,0,0,0,0,0,0
"Republic of Moldova","2024-10-19",0,0,0,0,0,0,0,0
"Republic of Moldova","2024-10-20",0,0,0,0,0,0,0,0
"Republic of Moldova","2024-10-21",0,0,0,0,0,0,0,0
"Republic of Moldova","2024-10-22",0,0,0,0,0,0,0,0
"Republic of Moldova","2024-10-23",0,0,0,0,0,0,0,0
"Republic of Moldova","2024-10-24",0,0,0,0,0,0,0,0
"Republic of Moldova","2024-10-25",0,0,0,0,0,0,0,0
"Republic of Moldova","2024-10-26",0,0,0,0,0,0,0,0
"Republic of Moldova","2024-10-27",0,0,0,0,0,0,0,0
"Republic of Moldova","2024-10-28",0,0,0,0,0,0,0,0
"Republic of Moldova","2024-10-29",0,0,0,0,0,0,0,0
"Republic of Moldova","2024-10-30",0,0,0,0,0,0,0,0
"Republic of Moldova","2024-10-31",0,0,0,0,0,0,0,0
"Republic of Moldova","2024-11-01",0,0,0,0,0,0,0,0
"Republic of Moldova","2024-11-02",0,0,0,0,0,0,0,0
"Republic of Moldova","2024-11-03",0,0,0,0,0,0,0,0
"Republic of Moldova","2024-11-04",0,0,0,0,0,0,0,0
"Republic of Moldova","2024-11-05",0,0,0,0,0,0,0,0
"Republic of Moldova","2024-11-06",0,0,0,0,0,0,0,0
"Republic of Moldova","2024-11-07",0,0,0,0,0,0,0,0
"Republic of Moldova","2024-11-08",0,0,0,0,0,0,0,0
"Republic of Moldova","2024-11-09",0,0,0,0,0,0,0,0
"Republic of Moldova","2024-11-10",0,0,0,0,0,0,0,0
"Republic of Moldova","2024-11-11",0,0,0,0,0,0,0,0
"Republic of Moldova","2024-11-12",0,0,0,0,0,0,0,0
"Republic of Moldova","2024-11-13",0,0,0,0,0,0,0,0
"Republic of Moldova","2024-11-14",0,0,0,0,0,0,0,0
"Republic of Moldova","2024-11-15",0,0,0,0,0,0,0,0
"Republic of Moldova","2024-11-16",0,0,0,0,0,0,0,0
"Republic of Moldova","2024-11-17",0,0,0,0,0,0,0,0
"Republic of Moldova","2024-11-18",0,0,0,0,0,0,0,0
"Republic of Moldova","2024-11-19",0,0,0,0,0,0,0,0
"Republic of Moldova","2024-11-20",0,0,0,0,0,0,0,0
"Republic of Moldova","2024-11-21",0,0,0,0,0,0,0,0
"Republic of Moldova","2024-11-22",0,0,0,0,0,0,0,0
"Republic of Moldova","2024-11-23",0,0,0,0,0,0,0,0
"Republic of Moldova","2024-11-24",0,0,0,0,0,0,0,0
"Republic of Moldova","2024-11-25",0,0,0,0,0,0,0,0
"Republic of Moldova","2024-11-26",0,0,0,0,0,0,0,0
"Republic of Moldova","2024-11-27",0,0,0,0,0,0,0,0
"Republic of Moldova","2024-11-28",0,0,0,0,0,0,0,0
"Republic of Moldova","2024-11-29",0,0,0,0,0,0,0,0
"Republic of Moldova","2024-11-30",0,0,0,0,0,0,0,0
"Republic of Moldova","2024-12-01",0,0,0,0,0,0,0,0
"Republic of Moldova","2024-12-02",0,0,0,0,0,0,0,0
"Republic of Moldova","2024-12-03",0,0,0,0,0,0,0,0
"Republic of Moldova","2024-12-04",0,0,0,0,0,0,0,0
"Republic of Moldova","2024-12-05",0,0,0,0,0,0,0,0
"Republic of Moldova","2024-12-06",0,0,0,0,0,0,0,0
"Republic of Moldova","2024-12-07",0,0,0,0,0,0,0,0
"Republic of Moldova","2024-12-08",0,0,0,0,0,0,0,0
"Republic of Moldova","2024-12-09",0,0,0,0,0,0,0,0
"Monaco","2024-01-01",0,0,0,0,0,0,0,0
"Monaco","2024-01-02",0,0,0,0,0,0,0,0
"Monaco","2024-01-03",0,0,0,0,0,0,0,0
"Monaco","2024-01-04",0,0,0,0,0,0,0,0
"Monaco","2024-01-05",0,0,0,0,0,0,0,0
"Monaco","2024-01-06",0,0,0,0,0,0,0,0
"Monaco","2024-01-07",0,0,0,0,0,0,0,0
"Monaco","2024-01-08",0,0,0,0,0,0,0,0
"Monaco","2024-01-09",0,0,0,0,0,0,0,0
"Monaco","2024-01-10",0,0,0,0,0,0,0,0
"Monaco","2024-01-11",0,0,0,0,0,0,0,0
"Monaco","2024-01-12",0,0,0,0,0,0,0,0
"Monaco","2024-01-13",0,0,0,0,0,0,0,0
"Monaco","2024-01-14",0,0,0,0,0,0,0,0
"Monaco","2024-01-15",0,0,0,0,0,0,0,0
"Monaco","2024-01-16",0,0,0,0,0,0,0,0
"Monaco","2024-01-17",0,0,0,0,0,0,0,0
"Monaco","2024-01-18",0,0,0,0,0,0,0,0
"Monaco","2024-01-19",0,0,0,0,0,0,0,0
"Monaco","2024-01-20",0,0,0,0,0,0,0,0
"Monaco","2024-01-21",0,0,0,0,0,0,0,0
"Monaco","2024-01-22",0,0,0,0,0,0,0,0
"Monaco","2024-01-23",0,0,0,0,0,0,0,0
"Monaco","2024-01-24",0,0,0,0,0,0,0,0
"Monaco","2024-01-25",0,0,0,0,0,0,0,0
"Monaco","2024-01-26",0,0,0,0,0,0,0,0
"Monaco","2024-01-27",0,0,0,0,0,0,0,0
"Monaco","2024-01-28",0,0,0,0,0,0,0,0
"Monaco","2024-01-29",0,0,0,0,0,0,0,0
"Monaco","2024-01-30",0,0,0,0,0,0,0,0
"Monaco","2024-01-31",0,0,0,0,0,0,0,0
"Monaco","2024-02-01",0,0,0,0,0,0,0,0
"Monaco","2024-02-02",0,0,0,0,0,0,0,0
"Monaco","2024-02-03",0,0,0,0,0,0,0,0
"Monaco","2024-02-04",0,0,0,0,0,0,0,0
"Monaco","2024-02-05",0,0,0,0,0,0,0,0
"Monaco","2024-02-06",0,0,0,0,0,0,0,0
"Monaco","2024-02-07",0,0,0,0,0,0,0,0
"Monaco","2024-02-08",0,0,0,0,0,0,0,0
"Monaco","2024-02-09",0,0,0,0,0,0,0,0
"Monaco","2024-02-10",0,0,0,0,0,0,0,0
"Monaco","2024-02-11",0,0,0,0,0,0,0,0
"Monaco","2024-02-12",0,0,0,0,0,0,0,0
"Monaco","2024-02-13",0,0,0,0,0,0,0,0
"Monaco","2024-02-14",0,0,0,0,0,0,0,0
"Monaco","2024-02-15",0,0,0,0,0,0,0,0
"Monaco","2024-02-16",0,0,0,0,0,0,0,0
"Monaco","2024-02-17",0,0,0,0,0,0,0,0
"Monaco","2024-02-18",0,0,0,0,0,0,0,0
"Monaco","2024-02-19",0,0,0,0,0,0,0,0
"Monaco","2024-02-20",0,0,0,0,0,0,0,0
"Monaco","2024-02-21",0,0,0,0,0,0,0,0
"Monaco","2024-02-22",0,0,0,0,0,0,0,0
"Monaco","2024-02-23",0,0,0,0,0,0,0,0
"Monaco","2024-02-24",0,0,0,0,0,0,0,0
"Monaco","2024-02-25",0,0,0,0,0,0,0,0
"Monaco","2024-02-26",0,0,0,0,0,0,0,0
"Monaco","2024-02-27",0,0,0,0,0,0,0,0
"Monaco","2024-02-28",0,0,0,0,0,0,0,0
"Monaco","2024-02-29",0,0,0,0,0,0,0,0
"Monaco","2024-03-01",0,0,0,0,0,0,0,0
"Monaco","2024-03-02",0,0,0,0,0,0,0,0
"Monaco","2024-03-03",0,0,0,0,0,0,0,0
"Monaco","2024-03-04",0,0,0,0,0,0,0,0
"Monaco","2024-03-05",0,0,0,0,0,0,0,0
"Monaco","2024-03-06",0,0,0,0,0,0,0,0
"Monaco","2024-03-07",0,0,0,0,0,0,0,0
"Monaco","2024-03-08",0,0,0,0,0,0,0,0
"Monaco","2024-03-09",0,0,0,0,0,0,0,0
"Monaco","2024-03-10",0,0,0,0,0,0,0,0
"Monaco","2024-03-11",0,0,0,0,0,0,0,0
"Monaco","2024-03-12",0,0,0,0,0,0,0,0
"Monaco","2024-03-13",0,0,0,0,0,0,0,0
"Monaco","2024-03-14",0,0,0,0,0,0,0,0
"Monaco","2024-03-15",0,0,0,0,0,0,0,0
"Monaco","2024-03-16",0,0,0,0,0,0,0,0
"Monaco","2024-03-17",0,0,0,0,0,0,0,0
"Monaco","2024-03-18",0,0,0,0,0,0,0,0
"Monaco","2024-03-19",0,0,0,0,0,0,0,0
"Monaco","2024-03-20",0,0,0,0,0,0,0,0
"Monaco","2024-03-21",0,0,0,0,0,0,0,0
"Monaco","2024-03-22",0,0,0,0,0,0,0,0
"Monaco","2024-03-23",0,0,0,0,0,0,0,0
"Monaco","2024-03-24",0,0,0,0,0,0,0,0
"Monaco","2024-03-25",0,0,0,0,0,0,0,0
"Monaco","2024-03-26",0,0,0,0,0,0,0,0
"Monaco","2024-03-27",0,0,0,0,0,0,0,0
"Monaco","2024-03-28",0,0,0,0,0,0,0,0
"Monaco","2024-03-29",0,0,0,0,0,0,0,0
"Monaco","2024-03-30",0,0,0,0,0,0,0,0
"Monaco","2024-03-31",0,0,0,0,0,0,0,0
"Monaco","2024-04-01",0,0,0,0,0,0,0,0
"Monaco","2024-04-02",0,0,0,0,0,0,0,0
"Monaco","2024-04-03",0,0,0,0,0,0,0,0
"Monaco","2024-04-04",0,0,0,0,0,0,0,0
"Monaco","2024-04-05",0,0,0,0,0,0,0,0
"Monaco","2024-04-06",0,0,0,0,0,0,0,0
"Monaco","2024-04-07",0,0,0,0,0,0,0,0
"Monaco","2024-04-08",0,0,0,0,0,0,0,0
"Monaco","2024-04-09",0,0,0,0,0,0,0,0
"Monaco","2024-04-10",0,0,0,0,0,0,0,0
"Monaco","2024-04-11",0,0,0,0,0,0,0,0
"Monaco","2024-04-12",0,0,0,0,0,0,0,0
"Monaco","2024-04-13",0,0,0,0,0,0,0,0
"Monaco","2024-04-14",0,0,0,0,0,0,0,0
"Monaco","2024-04-15",0,0,0,0,0,0,0,0
"Monaco","2024-04-16",0,0,0,0,0,0,0,0
"Monaco","2024-04-17",0,0,0,0,0,0,0,0
"Monaco","2024-04-18",0,0,0,0,0,0,0,0
"Monaco","2024-04-19",0,0,0,0,0,0,0,0
"Monaco","2024-04-20",0,0,0,0,0,0,0,0
"Monaco","2024-04-21",0,0,0,0,0,0,0,0
"Monaco","2024-04-22",0,0,0,0,0,0,0,0
"Monaco","2024-04-23",0,0,0,0,0,0,0,0
"Monaco","2024-04-24",0,0,0,0,0,0,0,0
"Monaco","2024-04-25",0,0,0,0,0,0,0,0
"Monaco","2024-04-26",0,0,0,0,0,0,0,0
"Monaco","2024-04-27",0,0,0,0,0,0,0,0
"Monaco","2024-04-28",0,0,0,0,0,0,0,0
"Monaco","2024-04-29",0,0,0,0,0,0,0,0
"Monaco","2024-04-30",0,0,0,0,0,0,0,0
"Monaco","2024-05-01",0,0,0,0,0,0,0,0
"Monaco","2024-05-02",0,0,0,0,0,0,0,0
"Monaco","2024-05-03",0,0,0,0,0,0,0,0
"Monaco","2024-05-04",0,0,0,0,0,0,0,0
"Monaco","2024-05-05",0,0,0,0,0,0,0,0
"Monaco","2024-05-06",0,0,0,0,0,0,0,0
"Monaco","2024-05-07",0,0,0,0,0,0,0,0
"Monaco","2024-05-08",0,0,0,0,0,0,0,0
"Monaco","2024-05-09",0,0,0,0,0,0,0,0
"Monaco","2024-05-10",0,0,0,0,0,0,0,0
"Monaco","2024-05-11",0,0,0,0,0,0,0,0
"Monaco","2024-05-12",0,0,0,0,0,0,0,0
"Monaco","2024-05-13",0,0,0,0,0,0,0,0
"Monaco","2024-05-14",0,0,0,0,0,0,0,0
"Monaco","2024-05-15",0,0,0,0,0,0,0,0
"Monaco","2024-05-16",0,0,0,0,0,0,0,0
"Monaco","2024-05-17",0,0,0,0,0,0,0,0
"Monaco","2024-05-18",0,0,0,0,0,0,0,0
"Monaco","2024-05-19",0,0,0,0,0,0,0,0
"Monaco","2024-05-20",0,0,0,0,0,0,0,0
"Monaco","2024-05-21",0,0,0,0,0,0,0,0
"Monaco","2024-05-22",0,0,0,0,0,0,0,0
"Monaco","2024-05-23",0,0,0,0,0,0,0,0
"Monaco","2024-05-24",0,0,0,0,0,0,0,0
"Monaco","2024-05-25",0,0,0,0,0,0,0,0
"Monaco","2024-05-26",0,0,0,0,0,0,0,0
"Monaco","2024-05-27",0,0,0,0,0,0,0,0
"Monaco","2024-05-28",0,0,0,0,0,0,0,0
"Monaco","2024-05-29",0,0,0,0,0,0,0,0
"Monaco","2024-05-30",0,0,0,0,0,0,0,0
"Monaco","2024-05-31",0,0,0,0,0,0,0,0
"Monaco","2024-06-01",0,0,0,0,0,0,0,0
"Monaco","2024-06-02",0,0,0,0,0,0,0,0
"Monaco","2024-06-03",0,0,0,0,0,0,0,0
"Monaco","2024-06-04",0,0,0,0,0,0,0,0
"Monaco","2024-06-05",0,0,0,0,0,0,0,0
"Monaco","2024-06-06",0,0,0,0,0,0,0,0
"Monaco","2024-06-07",0,0,0,0,0,0,0,0
"Monaco","2024-06-08",0,0,0,0,0,0,0,0
"Monaco","2024-06-09",0,0,0,0,0,0,0,0
"Monaco","2024-06-10",0,0,0,0,0,0,0,0
"Monaco","2024-06-11",0,0,0,0,0,0,0,0
"Monaco","2024-06-12",0,0,0,0,0,0,0,0
"Monaco","2024-06-13",0,0,0,0,0,0,0,0
"Monaco","2024-06-14",0,0,0,0,0,0,0,0
"Monaco","2024-06-15",0,0,0,0,0,0,0,0
"Monaco","2024-06-16",0,0,0,0,0,0,0,0
"Monaco","2024-06-17",0,0,0,0,0,0,0,0
"Monaco","2024-06-18",0,0,0,0,0,0,0,0
"Monaco","2024-06-19",0,0,0,0,0,0,0,0
"Monaco","2024-06-20",0,0,0,0,0,0,0,0
"Monaco","2024-06-21",0,0,0,0,0,0,0,0
"Monaco","2024-06-22",0,0,0,0,0,0,0,0
"Monaco","2024-06-23",0,0,0,0,0,0,0,0
"Monaco","2024-06-24",0,0,0,0,0,0,0,0
"Monaco","2024-06-25",0,0,0,0,0,0,0,0
"Monaco","2024-06-26",0,0,0,0,0,0,0,0
"Monaco","2024-06-27",0,0,0,0,0,0,0,0
"Monaco","2024-06-28",0,0,0,0,0,0,0,0
"Monaco","2024-06-29",0,0,0,0,0,0,0,0
"Monaco","2024-06-30",0,0,0,0,0,0,0,0
"Monaco","2024-07-01",0,0,0,0,0,0,0,0
"Monaco","2024-07-02",0,0,0,0,0,0,0,0
"Monaco","2024-07-03",0,0,0,0,0,0,0,0
"Monaco","2024-07-04",0,0,0,0,0,0,0,0
"Monaco","2024-07-05",0,0,0,0,0,0,0,0
"Monaco","2024-07-06",0,0,0,0,0,0,0,0
"Monaco","2024-07-07",0,0,0,0,0,0,0,0
"Monaco","2024-07-08",0,0,0,0,0,0,0,0
"Monaco","2024-07-09",0,0,0,0,0,0,0,0
"Monaco","2024-07-10",0,0,0,0,0,0,0,0
"Monaco","2024-07-11",0,0,0,0,0,0,0,0
"Monaco","2024-07-12",0,0,0,0,0,0,0,0
"Monaco","2024-07-13",0,0,0,0,0,0,0,0
"Monaco","2024-07-14",0,0,0,0,0,0,0,0
"Monaco","2024-07-15",0,0,0,0,0,0,0,0
"Monaco","2024-07-16",0,0,0,0,0,0,0,0
"Monaco","2024-07-17",0,0,0,0,0,0,0,0
"Monaco","2024-07-18",0,0,0,0,0,0,0,0
"Monaco","2024-07-19",0,0,0,0,0,0,0,0
"Monaco","2024-07-20",0,0,0,0,0,0,0,0
"Monaco","2024-07-21",0,0,0,0,0,0,0,0
"Monaco","2024-07-22",0,0,0,0,0,0,0,0
"Monaco","2024-07-23",0,0,0,0,0,0,0,0
"Monaco","2024-07-24",0,0,0,0,0,0,0,0
"Monaco","2024-07-25",0,0,0,0,0,0,0,0
"Monaco","2024-07-26",0,0,0,0,0,0,0,0
"Monaco","2024-07-27",0,0,0,0,0,0,0,0
"Monaco","2024-07-28",0,0,0,0,0,0,0,0
"Monaco","2024-07-29",0,0,0,0,0,0,0,0
"Monaco","2024-07-30",0,0,0,0,0,0,0,0
"Monaco","2024-07-31",0,0,0,0,0,0,0,0
"Monaco","2024-08-01",0,0,0,0,0,0,0,0
"Monaco","2024-08-02",0,0,0,0,0,0,0,0
"Monaco","2024-08-03",0,0,0,0,0,0,0,0
"Monaco","2024-08-04",0,0,0,0,0,0,0,0
"Monaco","2024-08-05",0,0,0,0,0,0,0,0
"Monaco","2024-08-06",0,0,0,0,0,0,0,0
"Monaco","2024-08-07",0,0,0,0,0,0,0,0
"Monaco","2024-08-08",0,0,0,0,0,0,0,0
"Monaco","2024-08-09",0,0,0,0,0,0,0,0
"Monaco","2024-08-10",0,0,0,0,0,0,0,0
"Monaco","2024-08-11",0,0,0,0,0,0,0,0
"Monaco","2024-08-12",0,0,0,0,0,0,0,0
"Monaco","2024-08-13",0,0,0,0,0,0,0,0
"Monaco","2024-08-14",0,0,0,0,0,0,0,0
"Monaco","2024-08-15",0,0,0,0,0,0,0,0
"Monaco","2024-08-16",0,0,0,0,0,0,0,0
"Monaco","2024-08-17",0,0,0,0,0,0,0,0
"Monaco","2024-08-18",0,0,0,0,0,0,0,0
"Monaco","2024-08-19",0,0,0,0,0,0,0,0
"Monaco","2024-08-20",0,0,0,0,0,0,0,0
"Monaco","2024-08-21",0,0,0,0,0,0,0,0
"Monaco","2024-08-22",0,0,0,0,0,0,0,0
"Monaco","2024-08-23",0,0,0,0,0,0,0,0
"Monaco","2024-08-24",0,0,0,0,0,0,0,0
"Monaco","2024-08-25",0,0,0,0,0,0,0,0
"Monaco","2024-08-26",0,0,0,0,0,0,0,0
"Monaco","2024-08-27",0,0,0,0,0,0,0,0
"Monaco","2024-08-28",0,0,0,0,0,0,0,0
"Monaco","2024-08-29",0,0,0,0,0,0,0,0
"Monaco","2024-08-30",0,0,0,0,0,0,0,0
"Monaco","2024-08-31",0,0,0,0,0,0,0,0
"Monaco","2024-09-01",0,0,0,0,0,0,0,0
"Monaco","2024-09-02",0,0,0,0,0,0,0,0
"Monaco","2024-09-03",0,0,0,0,0,0,0,0
"Monaco","2024-09-04",0,0,0,0,0,0,0,0
"Monaco","2024-09-05",0,0,0,0,0,0,0,0
"Monaco","2024-09-06",0,0,0,0,0,0,0,0
"Monaco","2024-09-07",0,0,0,0,0,0,0,0
"Monaco","2024-09-08",0,0,0,0,0,0,0,0
"Monaco","2024-09-09",0,0,0,0,0,0,0,0
"Monaco","2024-09-10",0,0,0,0,0,0,0,0
"Monaco","2024-09-11",0,0,0,0,0,0,0,0
"Monaco","2024-09-12",0,0,0,0,0,0,0,0
"Monaco","2024-09-13",0,0,0,0,0,0,0,0
"Monaco","2024-09-14",0,0,0,0,0,0,0,0
"Monaco","2024-09-15",0,0,0,0,0,0,0,0
"Monaco","2024-09-16",0,0,0,0,0,0,0,0
"Monaco","2024-09-17",0,0,0,0,0,0,0,0
"Monaco","2024-09-18",0,0,0,0,0,0,0,0
"Monaco","2024-09-19",0,0,0,0,0,0,0,0
"Monaco","2024-09-20",0,0,0,0,0,0,0,0
"Monaco","2024-09-21",0,0,0,0,0,0,0,0
"Monaco","2024-09-22",0,0,0,0,0,0,0,0
"Monaco","2024-09-23",0,0,0,0,0,0,0,0
"Monaco","2024-09-24",0,0,0,0,0,0,0,0
"Monaco","2024-09-25",0,0,0,0,0,0,0,0
"Monaco","2024-09-26",0,0,0,0,0,0,0,0
"Monaco","2024-09-27",0,0,0,0,0,0,0,0
"Monaco","2024-09-28",0,0,0,0,0,0,0,0
"Monaco","2024-09-29",0,0,0,0,0,0,0,0
"Monaco","2024-09-30",0,0,0,0,0,0,0,0
"Monaco","2024-10-01",0,0,0,0,0,0,0,0
"Monaco","2024-10-02",0,0,0,0,0,0,0,0
"Monaco","2024-10-03",0,0,0,0,0,0,0,0
"Monaco","2024-10-04",0,0,0,0,0,0,0,0
"Monaco","2024-10-05",0,0,0,0,0,0,0,0
"Monaco","2024-10-06",0,0,0,0,0,0,0,0
"Monaco","2024-10-07",0,0,0,0,0,0,0,0
"Monaco","2024-10-08",0,0,0,0,0,0,0,0
"Monaco","2024-10-09",0,0,0,0,0,0,0,0
"Monaco","2024-10-10",0,0,0,0,0,0,0,0
"Monaco","2024-10-11",0,0,0,0,0,0,0,0
"Monaco","2024-10-12",0,0,0,0,0,0,0,0
"Monaco","2024-10-13",0,0,0,0,0,0,0,0
"Monaco","2024-10-14",0,0,0,0,0,0,0,0
"Monaco","2024-10-15",0,0,0,0,0,0,0,0
"Monaco","2024-10-16",0,0,0,0,0,0,0,0
"Monaco","2024-10-17",0,0,0,0,0,0,0,0
"Monaco","2024-10-18",0,0,0,0,0,0,0,0
"Monaco","2024-10-19",0,0,0,0,0,0,0,0
"Monaco","2024-10-20",0,0,0,0,0,0,0,0
"Monaco","2024-10-21",0,0,0,0,0,0,0,0
"Monaco","2024-10-22",0,0,0,0,0,0,0,0
"Monaco","2024-10-23",0,0,0,0,0,0,0,0
"Monaco","2024-10-24",0,0,0,0,0,0,0,0
"Monaco","2024-10-25",0,0,0,0,0,0,0,0
"Monaco","2024-10-26",0,0,0,0,0,0,0,0
"Monaco","2024-10-27",0,0,0,0,0,0,0,0
"Monaco","2024-10-28",0,0,0,0,0,0,0,0
"Monaco","2024-10-29",0,0,0,0,0,0,0,0
"Monaco","2024-10-30",0,0,0,0,0,0,0,0
"Monaco","2024-10-31",0,0,0,0,0,0,0,0
"Monaco","2024-11-01",0,0,0,0,0,0,0,0
"Monaco","2024-11-02",0,0,0,0,0,0,0,0
"Monaco","2024-11-03",0,0,0,0,0,0,0,0
"Monaco","2024-11-04",0,0,0,0,0,0,0,0
"Monaco","2024-11-05",0,0,0,0,0,0,0,0
"Monaco","2024-11-06",0,0,0,0,0,0,0,0
"Monaco","2024-11-07",0,0,0,0,0,0,0,0
"Monaco","2024-11-08",0,0,0,0,0,0,0,0
"Monaco","2024-11-09",0,0,0,0,0,0,0,0
"Monaco","2024-11-10",0,0,0,0,0,0,0,0
"Monaco","2024-11-11",0,0,0,0,0,0,0,0
"Monaco","2024-11-12",0,0,0,0,0,0,0,0
"Monaco","2024-11-13",0,0,0,0,0,0,0,0
"Monaco","2024-11-14",0,0,0,0,0,0,0,0
"Monaco","2024-11-15",0,0,0,0,0,0,0,0
"Monaco","2024-11-16",0,0,0,0,0,0,0,0
"Monaco","2024-11-17",0,0,0,0,0,0,0,0
"Monaco","2024-11-18",0,0,0,0,0,0,0,0
"Monaco","2024-11-19",0,0,0,0,0,0,0,0
"Monaco","2024-11-20",0,0,0,0,0,0,0,0
"Monaco","2024-11-21",0,0,0,0,0,0,0,0
"Monaco","2024-11-22",0,0,0,0,0,0,0,0
"Monaco","2024-11-23",0,0,0,0,0,0,0,0
"Monaco","2024-11-24",0,0,0,0,0,0,0,0
"Monaco","2024-11-25",0,0,0,0,0,0,0,0
"Monaco","2024-11-26",0,0,0,0,0,0,0,0
"Monaco","2024-11-27",0,0,0,0,0,0,0,0
"Monaco","2024-11-28",0,0,0,0,0,0,0,0
"Monaco","2024-11-29",0,0,0,0,0,0,0,0
"Monaco","2024-11-30",0,0,0,0,0,0,0,0
"Monaco","2024-12-01",0,0,0,0,0,0,0,0
"Monaco","2024-12-02",0,0,0,0,0,0,0,0
"Monaco","2024-12-03",0,0,0,0,0,0,0,0
"Monaco","2024-12-04",0,0,0,0,0,0,0,0
"Monaco","2024-12-05",0,0,0,0,0,0,0,0
"Monaco","2024-12-06",0,0,0,0,0,0,0,0
"Monaco","2024-12-07",0,0,0,0,0,0,0,0
"Monaco","2024-12-08",0,0,0,0,0,0,0,0
"Monaco","2024-12-09",0,0,0,0,0,0,0,0
"Montenegro","2024-01-01",0,0,0,0,0,0,0,0
"Montenegro","2024-01-02",0,0,0,0,0,0,0,0
"Montenegro","2024-01-03",0,0,0,0,0,0,0,0
"Montenegro","2024-01-04",0,0,0,0,0,0,0,0
"Montenegro","2024-01-05",0,0,0,0,0,0,0,0
"Montenegro","2024-01-06",0,0,0,0,0,0,0,0
"Montenegro","2024-01-07",0,0,0,0,0,0,0,0
"Montenegro","2024-01-08",0,0,0,0,0,0,0,0
"Montenegro","2024-01-09",0,0,0,0,0,0,0,0
"Montenegro","2024-01-10",0,0,0,0,0,0,0,0
"Montenegro","2024-01-11",0,0,0,0,0,0,0,0
"Montenegro","2024-01-12",0,0,0,0,0,0,0,0
"Montenegro","2024-01-13",0,0,0,0,0,0,0,0
"Montenegro","2024-01-14",0,0,0,0,0,0,0,0
"Montenegro","2024-01-15",0,0,0,0,0,0,0,0
"Montenegro","2024-01-16",0,0,0,0,0,0,0,0
"Montenegro","2024-01-17",0,0,0,0,0,0,0,0
"Montenegro","2024-01-18",0,0,0,0,0,0,0,0
"Montenegro","2024-01-19",0,0,0,0,0,0,0,0
"Montenegro","2024-01-20",0,0,0,0,0,0,0,0
"Montenegro","2024-01-21",0,0,0,0,0,0,0,0
"Montenegro","2024-01-22",0,0,0,0,0,0,0,0
"Montenegro","2024-01-23",0,0,0,0,0,0,0,0
"Montenegro","2024-01-24",0,0,0,0,0,0,0,0
"Montenegro","2024-01-25",0,0,0,0,0,0,0,0
"Montenegro","2024-01-26",0,0,0,0,0,0,0,0
"Montenegro","2024-01-27",0,0,0,0,0,0,0,0
"Montenegro","2024-01-28",0,0,0,0,0,0,0,0
"Montenegro","2024-01-29",0,0,0,0,0,0,0,0
"Montenegro","2024-01-30",0,0,0,0,0,0,0,0
"Montenegro","2024-01-31",0,0,0,0,0,0,0,0
"Montenegro","2024-02-01",0,0,0,0,0,0,0,0
"Montenegro","2024-02-02",0,0,0,0,0,0,0,0
"Montenegro","2024-02-03",0,0,0,0,0,0,0,0
"Montenegro","2024-02-04",0,0,0,0,0,0,0,0
"Montenegro","2024-02-05",0,0,0,0,0,0,0,0
"Montenegro","2024-02-06",0,0,0,0,0,0,0,0
"Montenegro","2024-02-07",0,0,0,0,0,0,0,0
"Montenegro","2024-02-08",0,0,0,0,0,0,0,0
"Montenegro","2024-02-09",0,0,0,0,0,0,0,0
"Montenegro","2024-02-10",0,0,0,0,0,0,0,0
"Montenegro","2024-02-11",0,0,0,0,0,0,0,0
"Montenegro","2024-02-12",0,0,0,0,0,0,0,0
"Montenegro","2024-02-13",0,0,0,0,0,0,0,0
"Montenegro","2024-02-14",0,0,0,0,0,0,0,0
"Montenegro","2024-02-15",0,0,0,0,0,0,0,0
"Montenegro","2024-02-16",0,0,0,0,0,0,0,0
"Montenegro","2024-02-17",0,0,0,0,0,0,0,0
"Montenegro","2024-02-18",0,0,0,0,0,0,0,0
"Montenegro","2024-02-19",0,0,0,0,0,0,0,0
"Montenegro","2024-02-20",0,0,0,0,0,0,0,0
"Montenegro","2024-02-21",0,0,0,0,0,0,0,0
"Montenegro","2024-02-22",0,0,0,0,0,0,0,0
"Montenegro","2024-02-23",0,0,0,0,0,0,0,0
"Montenegro","2024-02-24",0,0,0,0,0,0,0,0
"Montenegro","2024-02-25",0,0,0,0,0,0,0,0
"Montenegro","2024-02-26",0,0,0,0,0,0,0,0
"Montenegro","2024-02-27",0,0,0,0,0,0,0,0
"Montenegro","2024-02-28",0,0,0,0,0,0,0,0
"Montenegro","2024-02-29",0,0,0,0,0,0,0,0
"Montenegro","2024-03-01",0,0,0,0,0,0,0,0
"Montenegro","2024-03-02",0,0,0,0,0,0,0,0
"Montenegro","2024-03-03",0,0,0,0,0,0,0,0
"Montenegro","2024-03-04",0,0,0,0,0,0,0,0
"Montenegro","2024-03-05",0,0,0,0,0,0,0,0
"Montenegro","2024-03-06",0,0,0,0,0,0,0,0
"Montenegro","2024-03-07",0,0,0,0,0,0,0,0
"Montenegro","2024-03-08",0,0,0,0,0,0,0,0
"Montenegro","2024-03-09",0,0,0,0,0,0,0,0
"Montenegro","2024-03-10",0,0,0,0,0,0,0,0
"Montenegro","2024-03-11",0,0,0,0,0,0,0,0
"Montenegro","2024-03-12",0,0,0,0,0,0,0,0
"Montenegro","2024-03-13",0,0,0,0,0,0,0,0
"Montenegro","2024-03-14",0,0,0,0,0,0,0,0
"Montenegro","2024-03-15",0,0,0,0,0,0,0,0
"Montenegro","2024-03-16",0,0,0,0,0,0,0,0
"Montenegro","2024-03-17",0,0,0,0,0,0,0,0
"Montenegro","2024-03-18",0,0,0,0,0,0,0,0
"Montenegro","2024-03-19",0,0,0,0,0,0,0,0
"Montenegro","2024-03-20",0,0,0,0,0,0,0,0
"Montenegro","2024-03-21",0,0,0,0,0,0,0,0
"Montenegro","2024-03-22",0,0,0,0,0,0,0,0
"Montenegro","2024-03-23",0,0,0,0,0,0,0,0
"Montenegro","2024-03-24",0,0,0,0,0,0,0,0
"Montenegro","2024-03-25",0,0,0,0,0,0,0,0
"Montenegro","2024-03-26",0,0,0,0,0,0,0,0
"Montenegro","2024-03-27",0,0,0,0,0,0,0,0
"Montenegro","2024-03-28",0,0,0,0,0,0,0,0
"Montenegro","2024-03-29",0,0,0,0,0,0,0,0
"Montenegro","2024-03-30",0,0,0,0,0,0,0,0
"Montenegro","2024-03-31",0,0,0,0,0,0,0,0
"Montenegro","2024-04-01",0,0,0,0,0,0,0,0
"Montenegro","2024-04-02",0,0,0,0,0,0,0,0
"Montenegro","2024-04-03",0,0,0,0,0,0,0,0
"Montenegro","2024-04-04",0,0,0,0,0,0,0,0
"Montenegro","2024-04-05",0,0,0,0,0,0,0,0
"Montenegro","2024-04-06",0,0,0,0,0,0,0,0
"Montenegro","2024-04-07",0,0,0,0,0,0,0,0
"Montenegro","2024-04-08",0,0,0,0,0,0,0,0
"Montenegro","2024-04-09",0,0,0,0,0,0,0,0
"Montenegro","2024-04-10",0,0,0,0,0,0,0,0
"Montenegro","2024-04-11",0,0,0,0,0,0,0,0
"Montenegro","2024-04-12",0,0,0,0,0,0,0,0
"Montenegro","2024-04-13",0,0,0,0,0,0,0,0
"Montenegro","2024-04-14",0,0,0,0,0,0,0,0
"Montenegro","2024-04-15",0,0,0,0,0,0,0,0
"Montenegro","2024-04-16",0,0,0,0,0,0,0,0
"Montenegro","2024-04-17",0,0,0,0,0,0,0,0
"Montenegro","2024-04-18",0,0,0,0,0,0,0,0
"Montenegro","2024-04-19",0,0,0,0,0,0,0,0
"Montenegro","2024-04-20",0,0,0,0,0,0,0,0
"Montenegro","2024-04-21",0,0,0,0,0,0,0,0
"Montenegro","2024-04-22",0,0,0,0,0,0,0,0
"Montenegro","2024-04-23",0,0,0,0,0,0,0,0
"Montenegro","2024-04-24",0,0,0,0,0,0,0,0
"Montenegro","2024-04-25",0,0,0,0,0,0,0,0
"Montenegro","2024-04-26",0,0,0,0,0,0,0,0
"Montenegro","2024-04-27",0,0,0,0,0,0,0,0
"Montenegro","2024-04-28",0,0,0,0,0,0,0,0
"Montenegro","2024-04-29",0,0,0,0,0,0,0,0
"Montenegro","2024-04-30",0,0,0,0,0,0,0,0
"Montenegro","2024-05-01",0,0,0,0,0,0,0,0
"Montenegro","2024-05-02",0,0,0,0,0,0,0,0
"Montenegro","2024-05-03",0,0,0,0,0,0,0,0
"Montenegro","2024-05-04",0,0,0,0,0,0,0,0
"Montenegro","2024-05-05",0,0,0,0,0,0,0,0
"Montenegro","2024-05-06",0,0,0,0,0,0,0,0
"Montenegro","2024-05-07",0,0,0,0,0,0,0,0
"Montenegro","2024-05-08",0,0,0,0,0,0,0,0
"Montenegro","2024-05-09",0,0,0,0,0,0,0,0
"Montenegro","2024-05-10",0,0,0,0,0,0,0,0
"Montenegro","2024-05-11",0,0,0,0,0,0,0,0
"Montenegro","2024-05-12",0,0,0,0,0,0,0,0
"Montenegro","2024-05-13",0,0,0,0,0,0,0,0
"Montenegro","2024-05-14",0,0,0,0,0,0,0,0
"Montenegro","2024-05-15",0,0,0,0,0,0,0,0
"Montenegro","2024-05-16",0,0,0,0,0,0,0,0
"Montenegro","2024-05-17",0,0,0,0,0,0,0,0
"Montenegro","2024-05-18",0,0,0,0,0,0,0,0
"Montenegro","2024-05-19",0,0,0,0,0,0,0,0
"Montenegro","2024-05-20",0,0,0,0,0,0,0,0
"Montenegro","2024-05-21",0,0,0,0,0,0,0,0
"Montenegro","2024-05-22",0,0,0,0,0,0,0,0
"Montenegro","2024-05-23",0,0,0,0,0,0,0,0
"Montenegro","2024-05-24",0,0,0,0,0,0,0,0
"Montenegro","2024-05-25",0,0,0,0,0,0,0,0
"Montenegro","2024-05-26",0,0,0,0,0,0,0,0
"Montenegro","2024-05-27",0,0,0,0,0,0,0,0
"Montenegro","2024-05-28",0,0,0,0,0,0,0,0
"Montenegro","2024-05-29",0,0,0,0,0,0,0,0
"Montenegro","2024-05-30",0,0,0,0,0,0,0,0
"Montenegro","2024-05-31",0,0,0,0,0,0,0,0
"Montenegro","2024-06-01",0,0,0,0,0,0,0,0
"Montenegro","2024-06-02",0,0,0,0,0,0,0,0
"Montenegro","2024-06-03",0,0,0,0,0,0,0,0
"Montenegro","2024-06-04",0,0,0,0,0,0,0,0
"Montenegro","2024-06-05",0,0,0,0,0,0,0,0
"Montenegro","2024-06-06",0,0,0,0,0,0,0,0
"Montenegro","2024-06-07",0,0,0,0,0,0,0,0
"Montenegro","2024-06-08",0,0,0,0,0,0,0,0
"Montenegro","2024-06-09",0,0,0,0,0,0,0,0
"Montenegro","2024-06-10",0,0,0,0,0,0,0,0
"Montenegro","2024-06-11",0,0,0,0,0,0,0,0
"Montenegro","2024-06-12",0,0,0,0,0,0,0,0
"Montenegro","2024-06-13",0,0,0,0,0,0,0,0
"Montenegro","2024-06-14",0,0,0,0,0,0,0,0
"Montenegro","2024-06-15",0,0,0,0,0,0,0,0
"Montenegro","2024-06-16",0,0,0,0,0,0,0,0
"Montenegro","2024-06-17",0,0,0,0,0,0,0,0
"Montenegro","2024-06-18",0,0,0,0,0,0,0,0
"Montenegro","2024-06-19",0,0,0,0,0,0,0,0
"Montenegro","2024-06-20",0,0,0,0,0,0,0,0
"Montenegro","2024-06-21",0,0,0,0,0,0,0,0
"Montenegro","2024-06-22",0,0,0,0,0,0,0,0
"Montenegro","2024-06-23",0,0,0,0,0,0,0,0
"Montenegro","2024-06-24",0,0,0,0,0,0,0,0
"Montenegro","2024-06-25",0,0,0,0,0,0,0,0
"Montenegro","2024-06-26",0,0,0,0,0,0,0,0
"Montenegro","2024-06-27",0,0,0,0,0,0,0,0
"Montenegro","2024-06-28",0,0,0,0,0,0,0,0
"Montenegro","2024-06-29",0,0,0,0,0,0,0,0
"Montenegro","2024-06-30",0,0,0,0,0,0,0,0
"Montenegro","2024-07-01",0,0,0,0,0,0,0,0
"Montenegro","2024-07-02",0,0,0,0,0,0,0,0
"Montenegro","2024-07-03",0,0,0,0,0,0,0,0
"Montenegro","2024-07-04",0,0,0,0,0,0,0,0
"Montenegro","2024-07-05",0,0,0,0,0,0,0,0
"Montenegro","2024-07-06",0,0,0,0,0,0,0,0
"Montenegro","2024-07-07",0,0,0,0,0,0,0,0
"Montenegro","2024-07-08",0,0,0,0,0,0,0,0
"Montenegro","2024-07-09",0,0,0,0,0,0,0,0
"Montenegro","2024-07-10",0,0,0,0,0,0,0,0
"Montenegro","2024-07-11",0,0,0,0,0,0,0,0
"Montenegro","2024-07-12",0,0,0,0,0,0,0,0
"Montenegro","2024-07-13",0,0,0,0,0,0,0,0
"Montenegro","2024-07-14",0,0,0,0,0,0,0,0
"Montenegro","2024-07-15",0,0,0,0,0,0,0,0
"Montenegro","2024-07-16",0,0,0,0,0,0,0,0
"Montenegro","2024-07-17",0,0,0,0,0,0,0,0
"Montenegro","2024-07-18",0,0,0,0,0,0,0,0
"Montenegro","2024-07-19",0,0,0,0,0,0,0,0
"Montenegro","2024-07-20",0,0,0,0,0,0,0,0
"Montenegro","2024-07-21",0,0,0,0,0,0,0,0
"Montenegro","2024-07-22",0,0,0,0,0,0,0,0
"Montenegro","2024-07-23",0,0,0,0,0,0,0,0
"Montenegro","2024-07-24",0,0,0,0,0,0,0,0
"Montenegro","2024-07-25",0,0,0,0,0,0,0,0
"Montenegro","2024-07-26",0,0,0,0,0,0,0,0
"Montenegro","2024-07-27",0,0,0,0,0,0,0,0
"Montenegro","2024-07-28",0,0,0,0,0,0,0,0
"Montenegro","2024-07-29",0,0,0,0,0,0,0,0
"Montenegro","2024-07-30",0,0,0,0,0,0,0,0
"Montenegro","2024-07-31",0,0,0,0,0,0,0,0
"Montenegro","2024-08-01",0,0,0,0,0,0,0,0
"Montenegro","2024-08-02",0,0,0,0,0,0,0,0
"Montenegro","2024-08-03",0,0,0,0,0,0,0,0
"Montenegro","2024-08-04",0,0,0,0,0,0,0,0
"Montenegro","2024-08-05",0,0,0,0,0,0,0,0
"Montenegro","2024-08-06",0,0,0,0,0,0,0,0
"Montenegro","2024-08-07",0,0,0,0,0,0,0,0
"Montenegro","2024-08-08",0,0,0,0,0,0,0,0
"Montenegro","2024-08-09",0,0,0,0,0,0,0,0
"Montenegro","2024-08-10",0,0,0,0,0,0,0,0
"Montenegro","2024-08-11",0,0,0,0,0,0,0,0
"Montenegro","2024-08-12",0,0,0,0,0,0,0,0
"Montenegro","2024-08-13",0,0,0,0,0,0,0,0
"Montenegro","2024-08-14",0,0,0,0,0,0,0,0
"Montenegro","2024-08-15",0,0,0,0,0,0,0,0
"Montenegro","2024-08-16",0,0,0,0,0,0,0,0
"Montenegro","2024-08-17",0,0,0,0,0,0,0,0
"Montenegro","2024-08-18",0,0,0,0,0,0,0,0
"Montenegro","2024-08-19",0,0,0,0,0,0,0,0
"Montenegro","2024-08-20",0,0,0,0,0,0,0,0
"Montenegro","2024-08-21",0,0,0,0,0,0,0,0
"Montenegro","2024-08-22",0,0,0,0,0,0,0,0
"Montenegro","2024-08-23",0,0,0,0,0,0,0,0
"Montenegro","2024-08-24",0,0,0,0,0,0,0,0
"Montenegro","2024-08-25",0,0,0,0,0,0,0,0
"Montenegro","2024-08-26",0,0,0,0,0,0,0,0
"Montenegro","2024-08-27",0,0,0,0,0,0,0,0
"Montenegro","2024-08-28",0,0,0,0,0,0,0,0
"Montenegro","2024-08-29",0,0,0,0,0,0,0,0
"Montenegro","2024-08-30",0,0,0,0,0,0,0,0
"Montenegro","2024-08-31",0,0,0,0,0,0,0,0
"Montenegro","2024-09-01",0,0,0,0,0,0,0,0
"Montenegro","2024-09-02",0,0,0,0,0,0,0,0
"Montenegro","2024-09-03",0,0,0,0,0,0,0,0
"Montenegro","2024-09-04",0,0,0,0,0,0,0,0
"Montenegro","2024-09-05",0,0,0,0,0,0,0,0
"Montenegro","2024-09-06",0,0,0,0,0,0,0,0
"Montenegro","2024-09-07",0,0,0,0,0,0,0,0
"Montenegro","2024-09-08",0,0,0,0,0,0,0,0
"Montenegro","2024-09-09",0,0,0,0,0,0,0,0
"Montenegro","2024-09-10",0,0,0,0,0,0,0,0
"Montenegro","2024-09-11",0,0,0,0,0,0,0,0
"Montenegro","2024-09-12",0,0,0,0,0,0,0,0
"Montenegro","2024-09-13",0,0,0,0,0,0,0,0
"Montenegro","2024-09-14",0,0,0,0,0,0,0,0
"Montenegro","2024-09-15",0,0,0,0,0,0,0,0
"Montenegro","2024-09-16",0,0,0,0,0,0,0,0
"Montenegro","2024-09-17",0,0,0,0,0,0,0,0
"Montenegro","2024-09-18",0,0,0,0,0,0,0,0
"Montenegro","2024-09-19",0,0,0,0,0,0,0,0
"Montenegro","2024-09-20",0,0,0,0,0,0,0,0
"Montenegro","2024-09-21",0,0,0,0,0,0,0,0
"Montenegro","2024-09-22",0,0,0,0,0,0,0,0
"Montenegro","2024-09-23",0,0,0,0,0,0,0,0
"Montenegro","2024-09-24",0,0,0,0,0,0,0,0
"Montenegro","2024-09-25",0,0,0,0,0,0,0,0
"Montenegro","2024-09-26",0,0,0,0,0,0,0,0
"Montenegro","2024-09-27",0,0,0,0,0,0,0,0
"Montenegro","2024-09-28",0,0,0,0,0,0,0,0
"Montenegro","2024-09-29",0,0,0,0,0,0,0,0
"Montenegro","2024-09-30",0,0,0,0,0,0,0,0
"Montenegro","2024-10-01",0,0,0,0,0,0,0,0
"Montenegro","2024-10-02",0,0,0,0,0,0,0,0
"Montenegro","2024-10-03",0,0,0,0,0,0,0,0
"Montenegro","2024-10-04",0,0,0,0,0,0,0,0
"Montenegro","2024-10-05",0,0,0,0,0,0,0,0
"Montenegro","2024-10-06",0,0,0,0,0,0,0,0
"Montenegro","2024-10-07",0,0,0,0,0,0,0,0
"Montenegro","2024-10-08",0,0,0,0,0,0,0,0
"Montenegro","2024-10-09",0,0,0,0,0,0,0,0
"Montenegro","2024-10-10",0,0,0,0,0,0,0,0
"Montenegro","2024-10-11",0,0,0,0,0,0,0,0
"Montenegro","2024-10-12",0,0,0,0,0,0,0,0
"Montenegro","2024-10-13",0,0,0,0,0,0,0,0
"Montenegro","2024-10-14",0,0,0,0,0,0,0,0
"Montenegro","2024-10-15",0,0,0,0,0,0,0,0
"Montenegro","2024-10-16",0,0,0,0,0,0,0,0
"Montenegro","2024-10-17",0,0,0,0,0,0,0,0
"Montenegro","2024-10-18",0,0,0,0,0,0,0,0
"Montenegro","2024-10-19",0,0,0,0,0,0,0,0
"Montenegro","2024-10-20",0,0,0,0,0,0,0,0
"Montenegro","2024-10-21",0,0,0,0,0,0,0,0
"Montenegro","2024-10-22",0,0,0,0,0,0,0,0
"Montenegro","2024-10-23",0,0,0,0,0,0,0,0
"Montenegro","2024-10-24",0,0,0,0,0,0,0,0
"Montenegro","2024-10-25",0,0,0,0,0,0,0,0
"Montenegro","2024-10-26",0,0,0,0,0,0,0,0
"Montenegro","2024-10-27",0,0,0,0,0,0,0,0
"Montenegro","2024-10-28",0,0,0,0,0,0,0,0
"Montenegro","2024-10-29",0,0,0,0,0,0,0,0
"Montenegro","2024-10-30",0,0,0,0,0,0,0,0
"Montenegro","2024-10-31",0,0,0,0,0,0,0,0
"Montenegro","2024-11-01",0,0,0,0,0,0,0,0
"Montenegro","2024-11-02",0,0,0,0,0,0,0,0
"Montenegro","2024-11-03",0,0,0,0,0,0,0,0
"Montenegro","2024-11-04",0,0,0,0,0,0,0,0
"Montenegro","2024-11-05",0,0,0,0,0,0,0,0
"Montenegro","2024-11-06",0,0,0,0,0,0,0,0
"Montenegro","2024-11-07",0,0,0,0,0,0,0,0
"Montenegro","2024-11-08",0,0,0,0,0,0,0,0
"Montenegro","2024-11-09",0,0,0,0,0,0,0,0
"Montenegro","2024-11-10",0,0,0,0,0,0,0,0
"Montenegro","2024-11-11",0,0,0,0,0,0,0,0
"Montenegro","2024-11-12",0,0,0,0,0,0,0,0
"Montenegro","2024-11-13",0,0,0,0,0,0,0,0
"Montenegro","2024-11-14",0,0,0,0,0,0,0,0
"Montenegro","2024-11-15",0,0,0,0,0,0,0,0
"Montenegro","2024-11-16",0,0,0,0,0,0,0,0
"Montenegro","2024-11-17",0,0,0,0,0,0,0,0
"Montenegro","2024-11-18",0,0,0,0,0,0,0,0
"Montenegro","2024-11-19",0,0,0,0,0,0,0,0
"Montenegro","2024-11-20",0,0,0,0,0,0,0,0
"Montenegro","2024-11-21",0,0,0,0,0,0,0,0
"Montenegro","2024-11-22",0,0,0,0,0,0,0,0
"Montenegro","2024-11-23",0,0,0,0,0,0,0,0
"Montenegro","2024-11-24",0,0,0,0,0,0,0,0
"Montenegro","2024-11-25",0,0,0,0,0,0,0,0
"Montenegro","2024-11-26",0,0,0,0,0,0,0,0
"Montenegro","2024-11-27",0,0,0,0,0,0,0,0
"Montenegro","2024-11-28",0,0,0,0,0,0,0,0
"Montenegro","2024-11-29",0,0,0,0,0,0,0,0
"Montenegro","2024-11-30",0,0,0,0,0,0,0,0
"Montenegro","2024-12-01",0,0,0,0,0,0,0,0
"Montenegro","2024-12-02",0,0,0,0,0,0,0,0
"Montenegro","2024-12-03",0,0,0,0,0,0,0,0
"Montenegro","2024-12-04",0,0,0,0,0,0,0,0
"Montenegro","2024-12-05",0,0,0,0,0,0,0,0
"Montenegro","2024-12-06",0,0,0,0,0,0,0,0
"Montenegro","2024-12-07",0,0,0,0,0,0,0,0
"Montenegro","2024-12-08",0,0,0,0,0,0,0,0
"Montenegro","2024-12-09",0,0,0,0,0,0,0,0
"Morocco","2024-01-01",0,0,0,0,0,0,0,0
"Morocco","2024-01-02",0,0,0,0,0,0,0,0
"Morocco","2024-01-03",0,0,0,0,0,0,0,0
"Morocco","2024-01-04",0,0,0,0,0,0,0,0
"Morocco","2024-01-05",0,0,0,0,0,0,0,0
"Morocco","2024-01-06",0,0,0,0,0,0,0,0
"Morocco","2024-01-07",0,0,0,0,0,0,0,0
"Morocco","2024-01-08",0,0,0,0,0,0,0,0
"Morocco","2024-01-09",0,0,0,0,0,0,0,0
"Morocco","2024-01-10",0,0,0,0,0,0,0,0
"Morocco","2024-01-11",0,0,0,0,0,0,0,0
"Morocco","2024-01-12",0,0,0,0,0,0,0,0
"Morocco","2024-01-13",0,0,0,0,0,0,0,0
"Morocco","2024-01-14",0,0,0,0,0,0,0,0
"Morocco","2024-01-15",0,0,0,0,0,0,0,0
"Morocco","2024-01-16",0,0,0,0,0,0,0,0
"Morocco","2024-01-17",0,0,0,0,0,0,0,0
"Morocco","2024-01-18",0,0,0,0,0,0,0,0
"Morocco","2024-01-19",0,0,0,0,0,0,0,0
"Morocco","2024-01-20",0,0,0,0,0,0,0,0
"Morocco","2024-01-21",0,0,0,0,0,0,0,0
"Morocco","2024-01-22",0,0,0,0,0,0,0,0
"Morocco","2024-01-23",0,0,0,0,0,0,0,0
"Morocco","2024-01-24",0,0,0,0,0,0,0,0
"Morocco","2024-01-25",0,0,0,0,0,0,0,0
"Morocco","2024-01-26",0,0,0,0,0,0,0,0
"Morocco","2024-01-27",0,0,0,0,0,0,0,0
"Morocco","2024-01-28",0,0,0,0,0,0,0,0
"Morocco","2024-01-29",0,0,0,0,0,0,0,0
"Morocco","2024-01-30",0,0,0,0,0,0,0,0
"Morocco","2024-01-31",0,0,0,0,0,0,0,0
"Morocco","2024-02-01",0,0,0,0,0,0,0,0
"Morocco","2024-02-02",0,0,0,0,0,0,0,0
"Morocco","2024-02-03",0,0,0,0,0,0,0,0
"Morocco","2024-02-04",0,0,0,0,0,0,0,0
"Morocco","2024-02-05",0,0,0,0,0,0,0,0
"Morocco","2024-02-06",0,0,0,0,0,0,0,0
"Morocco","2024-02-07",0,0,0,0,0,0,0,0
"Morocco","2024-02-08",0,0,0,0,0,0,0,0
"Morocco","2024-02-09",0,0,0,0,0,0,0,0
"Morocco","2024-02-10",0,0,0,0,0,0,0,0
"Morocco","2024-02-11",0,0,0,0,0,0,0,0
"Morocco","2024-02-12",0,0,0,0,0,0,0,0
"Morocco","2024-02-13",0,0,0,0,0,0,0,0
"Morocco","2024-02-14",0,0,0,0,0,0,0,0
"Morocco","2024-02-15",0,0,0,0,0,0,0,0
"Morocco","2024-02-16",0,0,0,0,0,0,0,0
"Morocco","2024-02-17",0,0,0,0,0,0,0,0
"Morocco","2024-02-18",0,0,0,0,0,0,0,0
"Morocco","2024-02-19",0,0,0,0,0,0,0,0
"Morocco","2024-02-20",0,0,0,0,0,0,0,0
"Morocco","2024-02-21",0,0,0,0,0,0,0,0
"Morocco","2024-02-22",0,0,0,0,0,0,0,0
"Morocco","2024-02-23",0,0,0,0,0,0,0,0
"Morocco","2024-02-24",0,0,0,0,0,0,0,0
"Morocco","2024-02-25",0,0,0,0,0,0,0,0
"Morocco","2024-02-26",0,0,0,0,0,0,0,0
"Morocco","2024-02-27",0,0,0,0,0,0,0,0
"Morocco","2024-02-28",0,0,0,0,0,0,0,0
"Morocco","2024-02-29",0,0,0,0,0,0,0,0
"Morocco","2024-03-01",0,0,0,0,0,0,0,0
"Morocco","2024-03-02",0,0,0,0,0,0,0,0
"Morocco","2024-03-03",0,0,0,0,0,0,0,0
"Morocco","2024-03-04",0,0,0,0,0,0,0,0
"Morocco","2024-03-05",0,0,0,0,0,0,0,0
"Morocco","2024-03-06",0,0,0,0,0,0,0,0
"Morocco","2024-03-07",0,0,0,0,0,0,0,0
"Morocco","2024-03-08",0,0,0,0,0,0,0,0
"Morocco","2024-03-09",0,0,0,0,0,0,0,0
"Morocco","2024-03-10",0,0,0,0,0,0,0,0
"Morocco","2024-03-11",0,0,0,0,0,0,0,0
"Morocco","2024-03-12",0,0,0,0,0,0,0,0
"Morocco","2024-03-13",0,0,0,0,0,0,0,0
"Morocco","2024-03-14",0,0,0,0,0,0,0,0
"Morocco","2024-03-15",0,1,1,0,1,1,0,0
"Morocco","2024-03-16",0,0,1,0,0,1,0,0
"Morocco","2024-03-17",0,0,1,0,0,1,0,0
"Morocco","2024-03-18",0,0,1,0,0,1,0,0
"Morocco","2024-03-19",0,0,1,0,0,1,0,0
"Morocco","2024-03-20",0,0,1,0,0,1,0,0
"Morocco","2024-03-21",0,0,1,0,0,1,0,0
"Morocco","2024-03-22",0,0,1,0,0,1,0,0
"Morocco","2024-03-23",0,0,1,0,0,1,0,0
"Morocco","2024-03-24",0,0,1,0,0,1,0,0
"Morocco","2024-03-25",0,0,1,0,0,1,0,0
"Morocco","2024-03-26",0,0,1,0,0,1,0,0
"Morocco","2024-03-27",0,0,1,0,0,1,0,0
"Morocco","2024-03-28",0,0,1,0,0,1,0,0
"Morocco","2024-03-29",0,0,1,0,0,1,0,0
"Morocco","2024-03-30",0,0,1,0,0,1,0,0
"Morocco","2024-03-31",0,0,1,0,0,1,0,0
"Morocco","2024-04-01",0,0,1,0,0,1,0,0
"Morocco","2024-04-02",0,0,1,0,0,1,0,0
"Morocco","2024-04-03",0,0,1,0,0,1,0,0
"Morocco","2024-04-04",0,0,1,0,0,1,0,0
"Morocco","2024-04-05",0,0,1,0,0,1,0,0
"Morocco","2024-04-06",0,0,1,0,0,1,0,0
"Morocco","2024-04-07",0,0,1,0,0,1,0,0
"Morocco","2024-04-08",0,0,1,0,0,1,0,0
"Morocco","2024-04-09",0,0,1,0,0,1,0,0
"Morocco","2024-04-10",0,0,1,0,0,1,0,0
"Morocco","2024-04-11",0,0,1,0,0,1,0,0
"Morocco","2024-04-12",0,0,1,0,0,1,0,0
"Morocco","2024-04-13",0,0,1,0,0,1,0,0
"Morocco","2024-04-14",0,0,1,0,0,1,0,0
"Morocco","2024-04-15",0,0,1,0,0,1,0,0
"Morocco","2024-04-16",0,0,1,0,0,1,0,0
"Morocco","2024-04-17",0,0,1,0,0,1,0,0
"Morocco","2024-04-18",0,0,1,0,0,1,0,0
"Morocco","2024-04-19",0,0,1,0,0,1,0,0
"Morocco","2024-04-20",0,0,1,0,0,1,0,0
"Morocco","2024-04-21",0,0,1,0,0,1,0,0
"Morocco","2024-04-22",0,0,1,0,0,1,0,0
"Morocco","2024-04-23",0,0,1,0,0,1,0,0
"Morocco","2024-04-24",0,0,1,0,0,1,0,0
"Morocco","2024-04-25",0,0,1,0,0,1,0,0
"Morocco","2024-04-26",0,0,1,0,0,1,0,0
"Morocco","2024-04-27",0,0,1,0,0,1,0,0
"Morocco","2024-04-28",0,0,1,0,0,1,0,0
"Morocco","2024-04-29",0,0,1,0,0,1,0,0
"Morocco","2024-04-30",0,0,1,0,0,1,0,0
"Morocco","2024-05-01",0,0,1,0,0,1,0,0
"Morocco","2024-05-02",0,0,1,0,0,1,0,0
"Morocco","2024-05-03",0,0,1,0,0,1,0,0
"Morocco","2024-05-04",0,0,1,0,0,1,0,0
"Morocco","2024-05-05",0,0,1,0,0,1,0,0
"Morocco","2024-05-06",0,0,1,0,0,1,0,0
"Morocco","2024-05-07",0,0,1,0,0,1,0,0
"Morocco","2024-05-08",0,0,1,0,0,1,0,0
"Morocco","2024-05-09",0,0,1,0,0,1,0,0
"Morocco","2024-05-10",0,0,1,0,0,1,0,0
"Morocco","2024-05-11",0,0,1,0,0,1,0,0
"Morocco","2024-05-12",0,0,1,0,0,1,0,0
"Morocco","2024-05-13",0,0,1,0,0,1,0,0
"Morocco","2024-05-14",0,0,1,0,0,1,0,0
"Morocco","2024-05-15",0,0,1,0,0,1,0,0
"Morocco","2024-05-16",0,0,1,0,0,1,0,0
"Morocco","2024-05-17",0,0,1,0,0,1,0,0
"Morocco","2024-05-18",0,0,1,0,0,1,0,0
"Morocco","2024-05-19",0,0,1,0,0,1,0,0
"Morocco","2024-05-20",0,0,1,0,0,1,0,0
"Morocco","2024-05-21",0,0,1,0,0,1,0,0
"Morocco","2024-05-22",0,0,1,0,0,1,0,0
"Morocco","2024-05-23",0,0,1,0,0,1,0,0
"Morocco","2024-05-24",0,0,1,0,0,1,0,0
"Morocco","2024-05-25",0,0,1,0,0,1,0,0
"Morocco","2024-05-26",0,0,1,0,0,1,0,0
"Morocco","2024-05-27",0,0,1,0,0,1,0,0
"Morocco","2024-05-28",0,0,1,0,0,1,0,0
"Morocco","2024-05-29",0,0,1,0,0,1,0,0
"Morocco","2024-05-30",0,0,1,0,0,1,0,0
"Morocco","2024-05-31",0,0,1,0,0,1,0,0
"Morocco","2024-06-01",0,0,1,0,0,1,0,0
"Morocco","2024-06-02",0,0,1,0,0,1,0,0
"Morocco","2024-06-03",0,0,1,0,0,1,0,0
"Morocco","2024-06-04",0,0,1,0,0,1,0,0
"Morocco","2024-06-05",0,0,1,0,0,1,0,0
"Morocco","2024-06-06",0,0,1,0,0,1,0,0
"Morocco","2024-06-07",0,0,1,0,0,1,0,0
"Morocco","2024-06-08",0,0,1,0,0,1,0,0
"Morocco","2024-06-09",0,0,1,0,0,1,0,0
"Morocco","2024-06-10",0,0,1,0,0,1,0,0
"Morocco","2024-06-11",0,0,1,0,0,1,0,0
"Morocco","2024-06-12",0,0,1,0,0,1,0,0
"Morocco","2024-06-13",0,0,1,0,0,1,0,0
"Morocco","2024-06-14",0,0,1,0,1,2,0,0
"Morocco","2024-06-15",0,0,1,0,0,2,0,0
"Morocco","2024-06-16",0,0,1,0,0,2,0,0
"Morocco","2024-06-17",0,0,1,0,0,2,0,0
"Morocco","2024-06-18",0,0,1,0,0,2,0,0
"Morocco","2024-06-19",0,0,1,0,0,2,0,0
"Morocco","2024-06-20",0,0,1,0,0,2,0,0
"Morocco","2024-06-21",0,0,1,0,0,2,0,0
"Morocco","2024-06-22",0,0,1,0,0,2,0,0
"Morocco","2024-06-23",0,0,1,0,0,2,0,0
"Morocco","2024-06-24",0,0,1,0,0,2,0,0
"Morocco","2024-06-25",0,0,1,0,0,2,0,0
"Morocco","2024-06-26",0,0,1,0,0,2,0,0
"Morocco","2024-06-27",0,0,1,0,0,2,0,0
"Morocco","2024-06-28",0,0,1,0,0,2,0,0
"Morocco","2024-06-29",0,0,1,0,0,2,0,0
"Morocco","2024-06-30",0,0,1,0,0,2,0,0
"Morocco","2024-07-01",0,0,1,0,0,2,0,0
"Morocco","2024-07-02",0,0,1,0,0,2,0,0
"Morocco","2024-07-03",0,0,1,0,0,2,0,0
"Morocco","2024-07-04",0,0,1,0,0,2,0,0
"Morocco","2024-07-05",0,0,1,0,0,2,0,0
"Morocco","2024-07-06",0,0,1,0,0,2,0,0
"Morocco","2024-07-07",0,0,1,0,0,2,0,0
"Morocco","2024-07-08",0,0,1,0,0,2,0,0
"Morocco","2024-07-09",0,0,1,0,0,2,0,0
"Morocco","2024-07-10",0,0,1,0,0,2,0,0
"Morocco","2024-07-11",0,0,1,0,0,2,0,0
"Morocco","2024-07-12",0,0,1,0,0,2,0,0
"Morocco","2024-07-13",0,0,1,0,0,2,0,0
"Morocco","2024-07-14",0,0,1,0,0,2,0,0
"Morocco","2024-07-15",0,0,1,0,0,2,0,0
"Morocco","2024-07-16",0,0,1,0,0,2,0,0
"Morocco","2024-07-17",0,0,1,0,0,2,0,0
"Morocco","2024-07-18",0,0,1,0,0,2,0,0
"Morocco","2024-07-19",0,0,1,0,0,2,0,0
"Morocco","2024-07-20",0,0,1,0,0,2,0,0
"Morocco","2024-07-21",0,0,1,0,0,2,0,0
"Morocco","2024-07-22",0,0,1,0,0,2,0,0
"Morocco","2024-07-23",0,0,1,0,0,2,0,0
"Morocco","2024-07-24",0,0,1,0,0,2,0,0
"Morocco","2024-07-25",0,0,1,0,0,2,0,0
"Morocco","2024-07-26",0,0,1,0,0,2,0,0
"Morocco","2024-07-27",0,0,1,0,0,2,0,0
"Morocco","2024-07-28",0,0,1,0,0,2,0,0
"Morocco","2024-07-29",0,0,1,0,0,2,0,0
"Morocco","2024-07-30",0,0,1,0,0,2,0,0
"Morocco","2024-07-31",0,0,1,0,0,2,0,0
"Morocco","2024-08-01",0,0,1,0,0,2,0,0
"Morocco","2024-08-02",0,0,1,0,0,2,0,0
"Morocco","2024-08-03",0,0,1,0,0,2,0,0
"Morocco","2024-08-04",0,0,1,0,0,2,0,0
"Morocco","2024-08-05",0,0,1,0,0,2,0,0
"Morocco","2024-08-06",0,0,1,0,0,2,0,0
"Morocco","2024-08-07",0,0,1,0,0,2,0,0
"Morocco","2024-08-08",0,0,1,0,0,2,0,0
"Morocco","2024-08-09",0,0,1,0,0,2,0,0
"Morocco","2024-08-10",0,0,1,0,0,2,0,0
"Morocco","2024-08-11",0,0,1,0,0,2,0,0
"Morocco","2024-08-12",0,0,1,0,0,2,0,0
"Morocco","2024-08-13",0,0,1,0,0,2,0,0
"Morocco","2024-08-14",0,0,1,0,0,2,0,0
"Morocco","2024-08-15",0,0,1,0,0,2,0,0
"Morocco","2024-08-16",0,0,1,0,0,2,0,0
"Morocco","2024-08-17",0,0,1,0,0,2,0,0
"Morocco","2024-08-18",0,0,1,0,0,2,0,0
"Morocco","2024-08-19",0,0,1,0,0,2,0,0
"Morocco","2024-08-20",0,0,1,0,0,2,0,0
"Morocco","2024-08-21",0,0,1,0,0,2,0,0
"Morocco","2024-08-22",0,0,1,0,0,2,0,0
"Morocco","2024-08-23",0,0,1,0,0,2,0,0
"Morocco","2024-08-24",0,0,1,0,0,2,0,0
"Morocco","2024-08-25",0,0,1,0,0,2,0,0
"Morocco","2024-08-26",0,0,1,0,0,2,0,0
"Morocco","2024-08-27",0,0,1,0,0,2,0,0
"Morocco","2024-08-28",0,0,1,0,0,2,0,0
"Morocco","2024-08-29",0,0,1,0,0,2,0,0
"Morocco","2024-08-30",0,0,1,0,0,2,0,0
"Morocco","2024-08-31",0,0,1,0,0,2,0,0
"Morocco","2024-09-01",0,0,1,0,0,2,0,0
"Morocco","2024-09-02",0,0,1,0,0,2,0,0
"Morocco","2024-09-03",0,0,1,0,0,2,0,0
"Morocco","2024-09-04",0,0,1,0,0,2,0,0
"Morocco","2024-09-05",0,0,1,0,0,2,0,0
"Morocco","2024-09-06",0,0,1,0,0,2,0,0
"Morocco","2024-09-07",0,0,1,0,0,2,0,0
"Morocco","2024-09-08",0,0,1,0,0,2,0,0
"Morocco","2024-09-09",0,0,1,0,0,2,0,0
"Morocco","2024-09-10",0,0,1,0,0,2,0,0
"Morocco","2024-09-11",0,0,1,0,0,2,0,0
"Morocco","2024-09-12",0,1,2,0,0,2,0,0
"Morocco","2024-09-13",0,0,2,0,0,2,0,0
"Morocco","2024-09-14",0,0,2,0,0,2,0,0
"Morocco","2024-09-15",0,0,2,0,0,2,0,0
"Morocco","2024-09-16",0,0,2,0,0,2,0,0
"Morocco","2024-09-17",0,0,2,0,0,2,0,0
"Morocco","2024-09-18",0,0,2,0,0,2,0,0
"Morocco","2024-09-19",0,0,2,0,0,2,0,0
"Morocco","2024-09-20",0,0,2,0,0,2,0,0
"Morocco","2024-09-21",0,0,2,0,0,2,0,0
"Morocco","2024-09-22",0,0,2,0,0,2,0,0
"Morocco","2024-09-23",0,0,2,0,1,3,0,0
"Morocco","2024-09-24",0,0,2,0,0,3,0,0
"Morocco","2024-09-25",0,0,2,0,0,3,0,0
"Morocco","2024-09-26",0,0,2,0,0,3,0,0
"Morocco","2024-09-27",0,0,2,0,0,3,0,0
"Morocco","2024-09-28",0,0,2,0,0,3,0,0
"Morocco","2024-09-29",0,0,2,0,0,3,0,0
"Morocco","2024-09-30",0,0,2,0,0,3,0,0
"Morocco","2024-10-01",0,0,2,0,0,3,0,0
"Morocco","2024-10-02",0,0,2,0,0,3,0,0
"Morocco","2024-10-03",0,1,3,0,0,3,0,0
"Morocco","2024-10-04",0,0,3,0,0,3,0,0
"Morocco","2024-10-05",0,0,3,0,0,3,0,0
"Morocco","2024-10-06",0,0,3,0,0,3,0,0
"Morocco","2024-10-07",0,0,3,0,0,3,0,0
"Morocco","2024-10-08",0,0,3,0,0,3,0,0
"Morocco","2024-10-09",0,0,3,0,0,3,0,0
"Morocco","2024-10-10",0,0,3,0,0,3,0,0
"Morocco","2024-10-11",0,0,3,0,0,3,0,0
"Morocco","2024-10-12",0,0,3,0,0,3,0,0
"Morocco","2024-10-13",0,0,3,0,0,3,0,0
"Morocco","2024-10-14",0,0,3,0,0,3,0,0
"Morocco","2024-10-15",0,0,3,0,0,3,0,0
"Morocco","2024-10-16",0,0,3,0,0,3,0,0
"Morocco","2024-10-17",0,0,3,0,0,3,0,0
"Morocco","2024-10-18",0,0,3,0,0,3,0,0
"Morocco","2024-10-19",0,0,3,0,0,3,0,0
"Morocco","2024-10-20",0,0,3,0,0,3,0,0
"Morocco","2024-10-21",0,0,3,0,0,3,0,0
"Morocco","2024-10-22",0,0,3,0,0,3,0,0
"Morocco","2024-10-23",0,0,3,0,0,3,0,0
"Morocco","2024-10-24",0,0,3,0,0,3,0,0
"Morocco","2024-10-25",0,0,3,0,0,3,0,0
"Morocco","2024-10-26",0,0,3,0,0,3,0,0
"Morocco","2024-10-27",0,0,3,0,0,3,0,0
"Morocco","2024-10-28",0,0,3,0,0,3,0,0
"Morocco","2024-10-29",0,0,3,0,0,3,0,0
"Morocco","2024-10-30",0,0,3,0,0,3,0,0
"Morocco","2024-10-31",0,0,3,0,0,3,0,0
"Morocco","2024-11-01",0,0,3,0,0,3,0,0
"Morocco","2024-11-02",0,0,3,0,0,3,0,0
"Morocco","2024-11-03",0,0,3,0,0,3,0,0
"Morocco","2024-11-04",0,0,3,0,0,3,0,0
"Morocco","2024-11-05",0,0,3,0,0,3,0,0
"Morocco","2024-11-06",0,0,3,0,0,3,0,0
"Morocco","2024-11-07",0,0,3,0,0,3,0,0
"Morocco","2024-11-08",0,0,3,0,0,3,0,0
"Morocco","2024-11-09",0,0,3,0,0,3,0,0
"Morocco","2024-11-10",0,0,3,0,0,3,0,0
"Morocco","2024-11-11",0,0,3,0,0,3,0,0
"Morocco","2024-11-12",0,0,3,0,0,3,0,0
"Morocco","2024-11-13",0,0,3,0,0,3,0,0
"Morocco","2024-11-14",0,0,3,0,0,3,0,0
"Morocco","2024-11-15",0,0,3,0,0,3,0,0
"Morocco","2024-11-16",0,0,3,0,0,3,0,0
"Morocco","2024-11-17",0,0,3,0,0,3,0,0
"Morocco","2024-11-18",0,0,3,0,0,3,0,0
"Morocco","2024-11-19",0,0,3,0,0,3,0,0
"Morocco","2024-11-20",0,0,3,0,0,3,0,0
"Morocco","2024-11-21",0,0,3,0,0,3,0,0
"Morocco","2024-11-22",0,0,3,0,0,3,0,0
"Morocco","2024-11-23",0,0,3,0,0,3,0,0
"Morocco","2024-11-24",0,0,3,0,0,3,0,0
"Morocco","2024-11-25",0,0,3,0,0,3,0,0
"Morocco","2024-11-26",0,0,3,0,0,3,0,0
"Morocco","2024-11-27",0,0,3,0,0,3,0,0
"Morocco","2024-11-28",0,0,3,0,0,3,0,0
"Morocco","2024-11-29",0,0,3,0,0,3,0,0
"Morocco","2024-11-30",0,0,3,0,0,3,0,0
"Morocco","2024-12-01",0,0,3,0,0,3,0,0
"Morocco","2024-12-02",0,0,3,0,0,3,0,0
"Morocco","2024-12-03",0,0,3,0,0,3,0,0
"Morocco","2024-12-04",0,0,3,0,0,3,0,0
"Morocco","2024-12-05",0,0,3,0,0,3,0,0
"Morocco","2024-12-06",0,0,3,0,0,3,0,0
"Morocco","2024-12-07",0,0,3,0,0,3,0,0
"Morocco","2024-12-08",0,0,3,0,0,3,0,0
"Morocco","2024-12-09",0,0,3,0,0,3,0,0
"Mozambique","2024-01-01",0,0,0,0,0,0,0,0
"Mozambique","2024-01-02",0,0,0,0,0,0,0,0
"Mozambique","2024-01-03",0,0,0,0,0,0,0,0
"Mozambique","2024-01-04",0,0,0,0,0,0,0,0
"Mozambique","2024-01-05",0,0,0,0,0,0,0,0
"Mozambique","2024-01-06",0,0,0,0,0,0,0,0
"Mozambique","2024-01-07",0,0,0,0,0,0,0,0
"Mozambique","2024-01-08",0,0,0,0,0,0,0,0
"Mozambique","2024-01-09",0,0,0,0,0,0,0,0
"Mozambique","2024-01-10",0,0,0,0,0,0,0,0
"Mozambique","2024-01-11",0,0,0,0,0,0,0,0
"Mozambique","2024-01-12",0,0,0,0,0,0,0,0
"Mozambique","2024-01-13",0,0,0,0,0,0,0,0
"Mozambique","2024-01-14",0,0,0,0,0,0,0,0
"Mozambique","2024-01-15",0,0,0,0,0,0,0,0
"Mozambique","2024-01-16",0,0,0,0,0,0,0,0
"Mozambique","2024-01-17",0,0,0,0,0,0,0,0
"Mozambique","2024-01-18",0,0,0,0,0,0,0,0
"Mozambique","2024-01-19",0,0,0,0,0,0,0,0
"Mozambique","2024-01-20",0,0,0,0,0,0,0,0
"Mozambique","2024-01-21",0,0,0,0,0,0,0,0
"Mozambique","2024-01-22",0,0,0,0,0,0,0,0
"Mozambique","2024-01-23",0,0,0,0,0,0,0,0
"Mozambique","2024-01-24",0,0,0,0,0,0,0,0
"Mozambique","2024-01-25",0,0,0,0,0,0,0,0
"Mozambique","2024-01-26",0,0,0,0,0,0,0,0
"Mozambique","2024-01-27",0,0,0,0,0,0,0,0
"Mozambique","2024-01-28",0,0,0,0,0,0,0,0
"Mozambique","2024-01-29",0,0,0,0,0,0,0,0
"Mozambique","2024-01-30",0,0,0,0,0,0,0,0
"Mozambique","2024-01-31",0,0,0,0,0,0,0,0
"Mozambique","2024-02-01",0,0,0,0,0,0,0,0
"Mozambique","2024-02-02",0,0,0,0,0,0,0,0
"Mozambique","2024-02-03",0,0,0,0,0,0,0,0
"Mozambique","2024-02-04",0,0,0,0,0,0,0,0
"Mozambique","2024-02-05",0,0,0,0,0,0,0,0
"Mozambique","2024-02-06",0,0,0,0,0,0,0,0
"Mozambique","2024-02-07",0,0,0,0,0,0,0,0
"Mozambique","2024-02-08",0,0,0,0,0,0,0,0
"Mozambique","2024-02-09",0,0,0,0,0,0,0,0
"Mozambique","2024-02-10",0,0,0,0,0,0,0,0
"Mozambique","2024-02-11",0,0,0,0,0,0,0,0
"Mozambique","2024-02-12",0,0,0,0,0,0,0,0
"Mozambique","2024-02-13",0,0,0,0,0,0,0,0
"Mozambique","2024-02-14",0,0,0,0,0,0,0,0
"Mozambique","2024-02-15",0,0,0,0,0,0,0,0
"Mozambique","2024-02-16",0,0,0,0,0,0,0,0
"Mozambique","2024-02-17",0,0,0,0,0,0,0,0
"Mozambique","2024-02-18",0,0,0,0,0,0,0,0
"Mozambique","2024-02-19",0,0,0,0,0,0,0,0
"Mozambique","2024-02-20",0,0,0,0,0,0,0,0
"Mozambique","2024-02-21",0,0,0,0,0,0,0,0
"Mozambique","2024-02-22",0,0,0,0,0,0,0,0
"Mozambique","2024-02-23",0,0,0,0,0,0,0,0
"Mozambique","2024-02-24",0,0,0,0,0,0,0,0
"Mozambique","2024-02-25",0,0,0,0,0,0,0,0
"Mozambique","2024-02-26",0,0,0,0,0,0,0,0
"Mozambique","2024-02-27",0,0,0,0,0,0,0,0
"Mozambique","2024-02-28",0,0,0,0,0,0,0,0
"Mozambique","2024-02-29",0,0,0,0,0,0,0,0
"Mozambique","2024-03-01",0,0,0,0,0,0,0,0
"Mozambique","2024-03-02",0,0,0,0,0,0,0,0
"Mozambique","2024-03-03",0,0,0,0,0,0,0,0
"Mozambique","2024-03-04",0,0,0,0,0,0,0,0
"Mozambique","2024-03-05",0,0,0,0,0,0,0,0
"Mozambique","2024-03-06",0,0,0,0,0,0,0,0
"Mozambique","2024-03-07",0,0,0,0,0,0,0,0
"Mozambique","2024-03-08",0,0,0,0,0,0,0,0
"Mozambique","2024-03-09",0,0,0,0,0,0,0,0
"Mozambique","2024-03-10",0,0,0,0,0,0,0,0
"Mozambique","2024-03-11",0,0,0,0,0,0,0,0
"Mozambique","2024-03-12",0,0,0,0,0,0,0,0
"Mozambique","2024-03-13",0,0,0,0,0,0,0,0
"Mozambique","2024-03-14",0,0,0,0,0,0,0,0
"Mozambique","2024-03-15",0,0,0,0,0,0,0,0
"Mozambique","2024-03-16",0,0,0,0,0,0,0,0
"Mozambique","2024-03-17",0,0,0,0,0,0,0,0
"Mozambique","2024-03-18",0,0,0,0,0,0,0,0
"Mozambique","2024-03-19",0,0,0,0,0,0,0,0
"Mozambique","2024-03-20",0,0,0,0,0,0,0,0
"Mozambique","2024-03-21",0,0,0,0,0,0,0,0
"Mozambique","2024-03-22",0,0,0,0,0,0,0,0
"Mozambique","2024-03-23",0,0,0,0,0,0,0,0
"Mozambique","2024-03-24",0,0,0,0,0,0,0,0
"Mozambique","2024-03-25",0,0,0,0,0,0,0,0
"Mozambique","2024-03-26",0,0,0,0,0,0,0,0
"Mozambique","2024-03-27",0,0,0,0,0,0,0,0
"Mozambique","2024-03-28",0,0,0,0,0,0,0,0
"Mozambique","2024-03-29",0,0,0,0,0,0,0,0
"Mozambique","2024-03-30",0,0,0,0,0,0,0,0
"Mozambique","2024-03-31",0,0,0,0,0,0,0,0
"Mozambique","2024-04-01",0,0,0,0,0,0,0,0
"Mozambique","2024-04-02",0,0,0,0,0,0,0,0
"Mozambique","2024-04-03",0,0,0,0,0,0,0,0
"Mozambique","2024-04-04",0,0,0,0,0,0,0,0
"Mozambique","2024-04-05",0,0,0,0,0,0,0,0
"Mozambique","2024-04-06",0,0,0,0,0,0,0,0
"Mozambique","2024-04-07",0,0,0,0,0,0,0,0
"Mozambique","2024-04-08",0,0,0,0,0,0,0,0
"Mozambique","2024-04-09",0,0,0,0,0,0,0,0
"Mozambique","2024-04-10",0,0,0,0,0,0,0,0
"Mozambique","2024-04-11",0,0,0,0,0,0,0,0
"Mozambique","2024-04-12",0,0,0,0,0,0,0,0
"Mozambique","2024-04-13",0,0,0,0,0,0,0,0
"Mozambique","2024-04-14",0,0,0,0,0,0,0,0
"Mozambique","2024-04-15",0,0,0,0,0,0,0,0
"Mozambique","2024-04-16",0,0,0,0,0,0,0,0
"Mozambique","2024-04-17",0,0,0,0,0,0,0,0
"Mozambique","2024-04-18",0,0,0,0,0,0,0,0
"Mozambique","2024-04-19",0,0,0,0,0,0,0,0
"Mozambique","2024-04-20",0,0,0,0,0,0,0,0
"Mozambique","2024-04-21",0,0,0,0,0,0,0,0
"Mozambique","2024-04-22",0,0,0,0,0,0,0,0
"Mozambique","2024-04-23",0,0,0,0,0,0,0,0
"Mozambique","2024-04-24",0,0,0,0,0,0,0,0
"Mozambique","2024-04-25",0,0,0,0,0,0,0,0
"Mozambique","2024-04-26",0,0,0,0,0,0,0,0
"Mozambique","2024-04-27",0,0,0,0,0,0,0,0
"Mozambique","2024-04-28",0,0,0,0,0,0,0,0
"Mozambique","2024-04-29",0,0,0,0,0,0,0,0
"Mozambique","2024-04-30",0,0,0,0,0,0,0,0
"Mozambique","2024-05-01",0,0,0,0,0,0,0,0
"Mozambique","2024-05-02",0,0,0,0,0,0,0,0
"Mozambique","2024-05-03",0,0,0,0,0,0,0,0
"Mozambique","2024-05-04",0,0,0,0,0,0,0,0
"Mozambique","2024-05-05",0,0,0,0,0,0,0,0
"Mozambique","2024-05-06",0,0,0,0,0,0,0,0
"Mozambique","2024-05-07",0,0,0,0,0,0,0,0
"Mozambique","2024-05-08",0,0,0,0,0,0,0,0
"Mozambique","2024-05-09",0,0,0,0,0,0,0,0
"Mozambique","2024-05-10",0,0,0,0,0,0,0,0
"Mozambique","2024-05-11",0,0,0,0,0,0,0,0
"Mozambique","2024-05-12",0,0,0,0,0,0,0,0
"Mozambique","2024-05-13",0,0,0,0,0,0,0,0
"Mozambique","2024-05-14",0,0,0,0,0,0,0,0
"Mozambique","2024-05-15",0,0,0,0,0,0,0,0
"Mozambique","2024-05-16",0,0,0,0,0,0,0,0
"Mozambique","2024-05-17",0,0,0,0,0,0,0,0
"Mozambique","2024-05-18",0,0,0,0,0,0,0,0
"Mozambique","2024-05-19",0,0,0,0,0,0,0,0
"Mozambique","2024-05-20",0,0,0,0,0,0,0,0
"Mozambique","2024-05-21",0,0,0,0,0,0,0,0
"Mozambique","2024-05-22",0,0,0,0,0,0,0,0
"Mozambique","2024-05-23",0,0,0,0,0,0,0,0
"Mozambique","2024-05-24",0,0,0,0,0,0,0,0
"Mozambique","2024-05-25",0,0,0,0,0,0,0,0
"Mozambique","2024-05-26",0,0,0,0,0,0,0,0
"Mozambique","2024-05-27",0,0,0,0,0,0,0,0
"Mozambique","2024-05-28",0,0,0,0,0,0,0,0
"Mozambique","2024-05-29",0,0,0,0,0,0,0,0
"Mozambique","2024-05-30",0,0,0,0,0,0,0,0
"Mozambique","2024-05-31",0,0,0,0,0,0,0,0
"Mozambique","2024-06-01",0,0,0,0,0,0,0,0
"Mozambique","2024-06-02",0,0,0,0,0,0,0,0
"Mozambique","2024-06-03",0,0,0,0,0,0,0,0
"Mozambique","2024-06-04",0,0,0,0,0,0,0,0
"Mozambique","2024-06-05",0,0,0,0,0,0,0,0
"Mozambique","2024-06-06",0,0,0,0,0,0,0,0
"Mozambique","2024-06-07",0,0,0,0,0,0,0,0
"Mozambique","2024-06-08",0,0,0,0,0,0,0,0
"Mozambique","2024-06-09",0,0,0,0,0,0,0,0
"Mozambique","2024-06-10",0,0,0,0,0,0,0,0
"Mozambique","2024-06-11",0,0,0,0,0,0,0,0
"Mozambique","2024-06-12",0,0,0,0,0,0,0,0
"Mozambique","2024-06-13",0,0,0,0,0,0,0,0
"Mozambique","2024-06-14",0,0,0,0,0,0,0,0
"Mozambique","2024-06-15",0,0,0,0,0,0,0,0
"Mozambique","2024-06-16",0,0,0,0,0,0,0,0
"Mozambique","2024-06-17",0,0,0,0,0,0,0,0
"Mozambique","2024-06-18",0,0,0,0,0,0,0,0
"Mozambique","2024-06-19",0,0,0,0,0,0,0,0
"Mozambique","2024-06-20",0,0,0,0,0,0,0,0
"Mozambique","2024-06-21",0,0,0,0,0,0,0,0
"Mozambique","2024-06-22",0,0,0,0,0,0,0,0
"Mozambique","2024-06-23",0,0,0,0,0,0,0,0
"Mozambique","2024-06-24",0,0,0,0,0,0,0,0
"Mozambique","2024-06-25",0,0,0,0,0,0,0,0
"Mozambique","2024-06-26",0,0,0,0,0,0,0,0
"Mozambique","2024-06-27",0,0,0,0,0,0,0,0
"Mozambique","2024-06-28",0,0,0,0,0,0,0,0
"Mozambique","2024-06-29",0,0,0,0,0,0,0,0
"Mozambique","2024-06-30",0,0,0,0,0,0,0,0
"Mozambique","2024-07-01",0,0,0,0,0,0,0,0
"Mozambique","2024-07-02",0,0,0,0,0,0,0,0
"Mozambique","2024-07-03",0,0,0,0,0,0,0,0
"Mozambique","2024-07-04",0,0,0,0,0,0,0,0
"Mozambique","2024-07-05",0,0,0,0,0,0,0,0
"Mozambique","2024-07-06",0,0,0,0,0,0,0,0
"Mozambique","2024-07-07",0,0,0,0,0,0,0,0
"Mozambique","2024-07-08",0,0,0,0,0,0,0,0
"Mozambique","2024-07-09",0,0,0,0,0,0,0,0
"Mozambique","2024-07-10",0,0,0,0,0,0,0,0
"Mozambique","2024-07-11",0,0,0,0,0,0,0,0
"Mozambique","2024-07-12",0,0,0,0,0,0,0,0
"Mozambique","2024-07-13",0,0,0,0,0,0,0,0
"Mozambique","2024-07-14",0,0,0,0,0,0,0,0
"Mozambique","2024-07-15",0,0,0,0,0,0,0,0
"Mozambique","2024-07-16",0,0,0,0,0,0,0,0
"Mozambique","2024-07-17",0,0,0,0,0,0,0,0
"Mozambique","2024-07-18",0,0,0,0,0,0,0,0
"Mozambique","2024-07-19",0,0,0,0,0,0,0,0
"Mozambique","2024-07-20",0,0,0,0,0,0,0,0
"Mozambique","2024-07-21",0,0,0,0,0,0,0,0
"Mozambique","2024-07-22",0,0,0,0,0,0,0,0
"Mozambique","2024-07-23",0,0,0,0,0,0,0,0
"Mozambique","2024-07-24",0,0,0,0,0,0,0,0
"Mozambique","2024-07-25",0,0,0,0,0,0,0,0
"Mozambique","2024-07-26",0,0,0,0,0,0,0,0
"Mozambique","2024-07-27",0,0,0,0,0,0,0,0
"Mozambique","2024-07-28",0,0,0,0,0,0,0,0
"Mozambique","2024-07-29",0,0,0,0,0,0,0,0
"Mozambique","2024-07-30",0,0,0,0,0,0,0,0
"Mozambique","2024-07-31",0,0,0,0,0,0,0,0
"Mozambique","2024-08-01",0,0,0,0,0,0,0,0
"Mozambique","2024-08-02",0,0,0,0,0,0,0,0
"Mozambique","2024-08-03",0,0,0,0,0,0,0,0
"Mozambique","2024-08-04",0,0,0,0,0,0,0,0
"Mozambique","2024-08-05",0,0,0,0,0,0,0,0
"Mozambique","2024-08-06",0,0,0,0,0,0,0,0
"Mozambique","2024-08-07",0,0,0,0,0,0,0,0
"Mozambique","2024-08-08",0,0,0,0,0,0,0,0
"Mozambique","2024-08-09",0,0,0,0,0,0,0,0
"Mozambique","2024-08-10",0,0,0,0,0,0,0,0
"Mozambique","2024-08-11",0,0,0,0,0,0,0,0
"Mozambique","2024-08-12",0,0,0,0,0,0,0,0
"Mozambique","2024-08-13",0,0,0,0,0,0,0,0
"Mozambique","2024-08-14",0,0,0,0,0,0,0,0
"Mozambique","2024-08-15",0,0,0,0,0,0,0,0
"Mozambique","2024-08-16",0,0,0,0,0,0,0,0
"Mozambique","2024-08-17",0,0,0,0,0,0,0,0
"Mozambique","2024-08-18",0,0,0,0,0,0,0,0
"Mozambique","2024-08-19",0,0,0,0,0,0,0,0
"Mozambique","2024-08-20",0,0,0,0,0,0,0,0
"Mozambique","2024-08-21",0,0,0,0,0,0,0,0
"Mozambique","2024-08-22",0,0,0,0,0,0,0,0
"Mozambique","2024-08-23",0,0,0,0,0,0,0,0
"Mozambique","2024-08-24",0,0,0,0,0,0,0,0
"Mozambique","2024-08-25",0,0,0,0,0,0,0,0
"Mozambique","2024-08-26",0,0,0,0,0,0,0,0
"Mozambique","2024-08-27",0,0,0,0,0,0,0,0
"Mozambique","2024-08-28",0,0,0,0,0,0,0,0
"Mozambique","2024-08-29",0,0,0,0,0,0,0,0
"Mozambique","2024-08-30",0,0,0,0,0,0,0,0
"Mozambique","2024-08-31",0,0,0,0,0,0,0,0
"Mozambique","2024-09-01",0,0,0,0,0,0,0,0
"Mozambique","2024-09-02",0,0,0,0,0,0,0,0
"Mozambique","2024-09-03",0,0,0,0,0,0,0,0
"Mozambique","2024-09-04",0,0,0,0,0,0,0,0
"Mozambique","2024-09-05",0,0,0,0,0,0,0,0
"Mozambique","2024-09-06",0,0,0,0,0,0,0,0
"Mozambique","2024-09-07",0,0,0,0,0,0,0,0
"Mozambique","2024-09-08",0,0,0,0,0,0,0,0
"Mozambique","2024-09-09",0,0,0,0,0,0,0,0
"Mozambique","2024-09-10",0,0,0,0,0,0,0,0
"Mozambique","2024-09-11",0,0,0,0,0,0,0,0
"Mozambique","2024-09-12",0,0,0,0,0,0,0,0
"Mozambique","2024-09-13",0,0,0,0,0,0,0,0
"Mozambique","2024-09-14",0,0,0,0,0,0,0,0
"Mozambique","2024-09-15",0,0,0,0,0,0,0,0
"Mozambique","2024-09-16",0,0,0,0,0,0,0,0
"Mozambique","2024-09-17",0,0,0,0,0,0,0,0
"Mozambique","2024-09-18",0,0,0,0,0,0,0,0
"Mozambique","2024-09-19",0,0,0,0,0,0,0,0
"Mozambique","2024-09-20",0,0,0,0,0,0,0,0
"Mozambique","2024-09-21",0,0,0,0,0,0,0,0
"Mozambique","2024-09-22",0,0,0,0,0,0,0,0
"Mozambique","2024-09-23",0,0,0,0,0,0,0,0
"Mozambique","2024-09-24",0,0,0,0,0,0,0,0
"Mozambique","2024-09-25",0,0,0,0,0,0,0,0
"Mozambique","2024-09-26",0,0,0,0,0,0,0,0
"Mozambique","2024-09-27",0,0,0,0,0,0,0,0
"Mozambique","2024-09-28",0,0,0,0,0,0,0,0
"Mozambique","2024-09-29",0,0,0,0,0,0,0,0
"Mozambique","2024-09-30",0,0,0,0,0,0,0,0
"Mozambique","2024-10-01",0,0,0,0,0,0,0,0
"Mozambique","2024-10-02",0,0,0,0,0,0,0,0
"Mozambique","2024-10-03",0,0,0,0,0,0,0,0
"Mozambique","2024-10-04",0,0,0,0,0,0,0,0
"Mozambique","2024-10-05",0,0,0,0,0,0,0,0
"Mozambique","2024-10-06",0,0,0,0,0,0,0,0
"Mozambique","2024-10-07",0,0,0,0,0,0,0,0
"Mozambique","2024-10-08",0,0,0,0,0,0,0,0
"Mozambique","2024-10-09",0,0,0,0,0,0,0,0
"Mozambique","2024-10-10",0,0,0,0,0,0,0,0
"Mozambique","2024-10-11",0,0,0,0,0,0,0,0
"Mozambique","2024-10-12",0,0,0,0,0,0,0,0
"Mozambique","2024-10-13",0,0,0,0,0,0,0,0
"Mozambique","2024-10-14",0,0,0,0,0,0,0,0
"Mozambique","2024-10-15",0,0,0,0,0,0,0,0
"Mozambique","2024-10-16",0,0,0,0,0,0,0,0
"Mozambique","2024-10-17",0,0,0,0,0,0,0,0
"Mozambique","2024-10-18",0,0,0,0,0,0,0,0
"Mozambique","2024-10-19",0,0,0,0,0,0,0,0
"Mozambique","2024-10-20",0,0,0,0,0,0,0,0
"Mozambique","2024-10-21",0,0,0,0,0,0,0,0
"Mozambique","2024-10-22",0,0,0,0,0,0,0,0
"Mozambique","2024-10-23",0,0,0,0,0,0,0,0
"Mozambique","2024-10-24",0,0,0,0,0,0,0,0
"Mozambique","2024-10-25",0,0,0,0,0,0,0,0
"Mozambique","2024-10-26",0,0,0,0,0,0,0,0
"Mozambique","2024-10-27",0,0,0,0,0,0,0,0
"Mozambique","2024-10-28",0,0,0,0,0,0,0,0
"Mozambique","2024-10-29",0,0,0,0,0,0,0,0
"Mozambique","2024-10-30",0,0,0,0,0,0,0,0
"Mozambique","2024-10-31",0,0,0,0,0,0,0,0
"Mozambique","2024-11-01",0,0,0,0,0,0,0,0
"Mozambique","2024-11-02",0,0,0,0,0,0,0,0
"Mozambique","2024-11-03",0,0,0,0,0,0,0,0
"Mozambique","2024-11-04",0,0,0,0,0,0,0,0
"Mozambique","2024-11-05",0,0,0,0,0,0,0,0
"Mozambique","2024-11-06",0,0,0,0,0,0,0,0
"Mozambique","2024-11-07",0,0,0,0,0,0,0,0
"Mozambique","2024-11-08",0,0,0,0,0,0,0,0
"Mozambique","2024-11-09",0,0,0,0,0,0,0,0
"Mozambique","2024-11-10",0,0,0,0,0,0,0,0
"Mozambique","2024-11-11",0,0,0,0,0,0,0,0
"Mozambique","2024-11-12",0,0,0,0,0,0,0,0
"Mozambique","2024-11-13",0,0,0,0,0,0,0,0
"Mozambique","2024-11-14",0,0,0,0,0,0,0,0
"Mozambique","2024-11-15",0,0,0,0,0,0,0,0
"Mozambique","2024-11-16",0,0,0,0,0,0,0,0
"Mozambique","2024-11-17",0,0,0,0,0,0,0,0
"Mozambique","2024-11-18",0,0,0,0,0,0,0,0
"Mozambique","2024-11-19",0,0,0,0,0,0,0,0
"Mozambique","2024-11-20",0,0,0,0,0,0,0,0
"Mozambique","2024-11-21",0,0,0,0,0,0,0,0
"Mozambique","2024-11-22",0,0,0,0,0,0,0,0
"Mozambique","2024-11-23",0,0,0,0,0,0,0,0
"Mozambique","2024-11-24",0,0,0,0,0,0,0,0
"Mozambique","2024-11-25",0,0,0,0,0,0,0,0
"Mozambique","2024-11-26",0,0,0,0,0,0,0,0
"Mozambique","2024-11-27",0,0,0,0,0,0,0,0
"Mozambique","2024-11-28",0,0,0,0,0,0,0,0
"Mozambique","2024-11-29",0,0,0,0,0,0,0,0
"Mozambique","2024-11-30",0,0,0,0,0,0,0,0
"Mozambique","2024-12-01",0,0,0,0,0,0,0,0
"Mozambique","2024-12-02",0,0,0,0,0,0,0,0
"Mozambique","2024-12-03",0,0,0,0,0,0,0,0
"Mozambique","2024-12-04",0,0,0,0,0,0,0,0
"Mozambique","2024-12-05",0,0,0,0,0,0,0,0
"Mozambique","2024-12-06",0,0,0,0,0,0,0,0
"Mozambique","2024-12-07",0,0,0,0,0,0,0,0
"Mozambique","2024-12-08",0,0,0,0,0,0,0,0
"Mozambique","2024-12-09",0,0,0,0,0,0,0,0
"Nepal","2024-01-01",0,0,0,0,0,0,0,0
"Nepal","2024-01-02",0,0,0,0,0,0,0,0
"Nepal","2024-01-03",0,0,0,0,0,0,0,0
"Nepal","2024-01-04",0,0,0,0,0,0,0,0
"Nepal","2024-01-05",0,0,0,0,0,0,0,0
"Nepal","2024-01-06",0,0,0,0,0,0,0,0
"Nepal","2024-01-07",0,0,0,0,0,0,0,0
"Nepal","2024-01-08",0,0,0,0,0,0,0,0
"Nepal","2024-01-09",0,0,0,0,0,0,0,0
"Nepal","2024-01-10",0,0,0,0,0,0,0,0
"Nepal","2024-01-11",0,0,0,0,0,0,0,0
"Nepal","2024-01-12",0,0,0,0,0,0,0,0
"Nepal","2024-01-13",0,0,0,0,0,0,0,0
"Nepal","2024-01-14",0,0,0,0,0,0,0,0
"Nepal","2024-01-15",0,0,0,0,0,0,0,0
"Nepal","2024-01-16",0,0,0,0,0,0,0,0
"Nepal","2024-01-17",0,0,0,0,0,0,0,0
"Nepal","2024-01-18",0,0,0,0,0,0,0,0
"Nepal","2024-01-19",0,0,0,0,0,0,0,0
"Nepal","2024-01-20",0,0,0,0,0,0,0,0
"Nepal","2024-01-21",0,0,0,0,0,0,0,0
"Nepal","2024-01-22",0,0,0,0,0,0,0,0
"Nepal","2024-01-23",0,0,0,0,0,0,0,0
"Nepal","2024-01-24",0,0,0,0,0,0,0,0
"Nepal","2024-01-25",0,0,0,0,0,0,0,0
"Nepal","2024-01-26",0,0,0,0,0,0,0,0
"Nepal","2024-01-27",0,0,0,0,0,0,0,0
"Nepal","2024-01-28",0,0,0,0,0,0,0,0
"Nepal","2024-01-29",0,0,0,0,0,0,0,0
"Nepal","2024-01-30",0,0,0,0,0,0,0,0
"Nepal","2024-01-31",0,0,0,0,0,0,0,0
"Nepal","2024-02-01",0,0,0,0,0,0,0,0
"Nepal","2024-02-02",0,0,0,0,0,0,0,0
"Nepal","2024-02-03",0,0,0,0,0,0,0,0
"Nepal","2024-02-04",0,0,0,0,0,0,0,0
"Nepal","2024-02-05",0,0,0,0,0,0,0,0
"Nepal","2024-02-06",0,0,0,0,0,0,0,0
"Nepal","2024-02-07",0,0,0,0,0,0,0,0
"Nepal","2024-02-08",0,0,0,0,0,0,0,0
"Nepal","2024-02-09",0,0,0,0,0,0,0,0
"Nepal","2024-02-10",0,0,0,0,0,0,0,0
"Nepal","2024-02-11",0,0,0,0,0,0,0,0
"Nepal","2024-02-12",0,0,0,0,0,0,0,0
"Nepal","2024-02-13",0,0,0,0,0,0,0,0
"Nepal","2024-02-14",0,0,0,0,0,0,0,0
"Nepal","2024-02-15",0,0,0,0,0,0,0,0
"Nepal","2024-02-16",0,0,0,0,0,0,0,0
"Nepal","2024-02-17",0,0,0,0,0,0,0,0
"Nepal","2024-02-18",0,0,0,0,0,0,0,0
"Nepal","2024-02-19",0,0,0,0,0,0,0,0
"Nepal","2024-02-20",0,0,0,0,0,0,0,0
"Nepal","2024-02-21",0,0,0,0,0,0,0,0
"Nepal","2024-02-22",0,0,0,0,0,0,0,0
"Nepal","2024-02-23",0,0,0,0,0,0,0,0
"Nepal","2024-02-24",0,0,0,0,0,0,0,0
"Nepal","2024-02-25",0,0,0,0,0,0,0,0
"Nepal","2024-02-26",0,0,0,0,0,0,0,0
"Nepal","2024-02-27",0,0,0,0,0,0,0,0
"Nepal","2024-02-28",0,0,0,0,0,0,0,0
"Nepal","2024-02-29",0,0,0,0,0,0,0,0
"Nepal","2024-03-01",0,0,0,0,0,0,0,0
"Nepal","2024-03-02",0,0,0,0,0,0,0,0
"Nepal","2024-03-03",0,0,0,0,0,0,0,0
"Nepal","2024-03-04",0,0,0,0,0,0,0,0
"Nepal","2024-03-05",0,0,0,0,0,0,0,0
"Nepal","2024-03-06",0,0,0,0,0,0,0,0
"Nepal","2024-03-07",0,0,0,0,0,0,0,0
"Nepal","2024-03-08",0,0,0,0,0,0,0,0
"Nepal","2024-03-09",0,0,0,0,0,0,0,0
"Nepal","2024-03-10",0,0,0,0,0,0,0,0
"Nepal","2024-03-11",0,0,0,0,0,0,0,0
"Nepal","2024-03-12",0,0,0,0,0,0,0,0
"Nepal","2024-03-13",0,0,0,0,0,0,0,0
"Nepal","2024-03-14",0,0,0,0,0,0,0,0
"Nepal","2024-03-15",0,0,0,0,0,0,0,0
"Nepal","2024-03-16",0,0,0,0,0,0,0,0
"Nepal","2024-03-17",0,0,0,0,0,0,0,0
"Nepal","2024-03-18",0,0,0,0,0,0,0,0
"Nepal","2024-03-19",0,0,0,0,0,0,0,0
"Nepal","2024-03-20",0,0,0,0,0,0,0,0
"Nepal","2024-03-21",0,0,0,0,0,0,0,0
"Nepal","2024-03-22",0,0,0,0,0,0,0,0
"Nepal","2024-03-23",0,0,0,0,0,0,0,0
"Nepal","2024-03-24",0,0,0,0,0,0,0,0
"Nepal","2024-03-25",0,0,0,0,0,0,0,0
"Nepal","2024-03-26",0,0,0,0,0,0,0,0
"Nepal","2024-03-27",0,0,0,0,0,0,0,0
"Nepal","2024-03-28",0,0,0,0,0,0,0,0
"Nepal","2024-03-29",0,0,0,0,0,0,0,0
"Nepal","2024-03-30",0,0,0,0,0,0,0,0
"Nepal","2024-03-31",0,0,0,0,0,0,0,0
"Nepal","2024-04-01",0,0,0,0,0,0,0,0
"Nepal","2024-04-02",0,0,0,0,0,0,0,0
"Nepal","2024-04-03",0,0,0,0,0,0,0,0
"Nepal","2024-04-04",0,0,0,0,0,0,0,0
"Nepal","2024-04-05",0,0,0,0,0,0,0,0
"Nepal","2024-04-06",0,0,0,0,0,0,0,0
"Nepal","2024-04-07",0,0,0,0,0,0,0,0
"Nepal","2024-04-08",0,0,0,0,0,0,0,0
"Nepal","2024-04-09",0,0,0,0,0,0,0,0
"Nepal","2024-04-10",0,0,0,0,0,0,0,0
"Nepal","2024-04-11",0,0,0,0,0,0,0,0
"Nepal","2024-04-12",0,0,0,0,0,0,0,0
"Nepal","2024-04-13",0,0,0,0,0,0,0,0
"Nepal","2024-04-14",0,0,0,0,0,0,0,0
"Nepal","2024-04-15",0,0,0,0,0,0,0,0
"Nepal","2024-04-16",0,0,0,0,0,0,0,0
"Nepal","2024-04-17",0,0,0,0,0,0,0,0
"Nepal","2024-04-18",0,0,0,0,0,0,0,0
"Nepal","2024-04-19",0,0,0,0,0,0,0,0
"Nepal","2024-04-20",0,0,0,0,0,0,0,0
"Nepal","2024-04-21",0,0,0,0,0,0,0,0
"Nepal","2024-04-22",0,0,0,0,0,0,0,0
"Nepal","2024-04-23",0,0,0,0,0,0,0,0
"Nepal","2024-04-24",0,0,0,0,0,0,0,0
"Nepal","2024-04-25",0,0,0,0,0,0,0,0
"Nepal","2024-04-26",0,0,0,0,0,0,0,0
"Nepal","2024-04-27",0,0,0,0,0,0,0,0
"Nepal","2024-04-28",0,0,0,0,0,0,0,0
"Nepal","2024-04-29",0,0,0,0,0,0,0,0
"Nepal","2024-04-30",0,0,0,0,0,0,0,0
"Nepal","2024-05-01",0,0,0,0,0,0,0,0
"Nepal","2024-05-02",0,0,0,0,0,0,0,0
"Nepal","2024-05-03",0,0,0,0,0,0,0,0
"Nepal","2024-05-04",0,0,0,0,0,0,0,0
"Nepal","2024-05-05",0,0,0,0,0,0,0,0
"Nepal","2024-05-06",0,0,0,0,0,0,0,0
"Nepal","2024-05-07",0,0,0,0,0,0,0,0
"Nepal","2024-05-08",0,0,0,0,0,0,0,0
"Nepal","2024-05-09",0,0,0,0,0,0,0,0
"Nepal","2024-05-10",0,0,0,0,0,0,0,0
"Nepal","2024-05-11",0,0,0,0,0,0,0,0
"Nepal","2024-05-12",0,0,0,0,0,0,0,0
"Nepal","2024-05-13",0,0,0,0,0,0,0,0
"Nepal","2024-05-14",0,0,0,0,0,0,0,0
"Nepal","2024-05-15",0,0,0,0,0,0,0,0
"Nepal","2024-05-16",0,0,0,0,0,0,0,0
"Nepal","2024-05-17",0,0,0,0,0,0,0,0
"Nepal","2024-05-18",0,0,0,0,0,0,0,0
"Nepal","2024-05-19",0,0,0,0,0,0,0,0
"Nepal","2024-05-20",0,0,0,0,0,0,0,0
"Nepal","2024-05-21",0,0,0,0,0,0,0,0
"Nepal","2024-05-22",0,0,0,0,0,0,0,0
"Nepal","2024-05-23",0,0,0,0,0,0,0,0
"Nepal","2024-05-24",0,0,0,0,0,0,0,0
"Nepal","2024-05-25",0,0,0,0,0,0,0,0
"Nepal","2024-05-26",0,0,0,0,0,0,0,0
"Nepal","2024-05-27",0,0,0,0,0,0,0,0
"Nepal","2024-05-28",0,0,0,0,0,0,0,0
"Nepal","2024-05-29",0,0,0,0,0,0,0,0
"Nepal","2024-05-30",0,0,0,0,0,0,0,0
"Nepal","2024-05-31",0,0,0,0,0,0,0,0
"Nepal","2024-06-01",0,0,0,0,0,0,0,0
"Nepal","2024-06-02",0,0,0,0,0,0,0,0
"Nepal","2024-06-03",0,0,0,0,0,0,0,0
"Nepal","2024-06-04",0,0,0,0,0,0,0,0
"Nepal","2024-06-05",0,0,0,0,0,0,0,0
"Nepal","2024-06-06",0,0,0,0,0,0,0,0
"Nepal","2024-06-07",0,0,0,0,0,0,0,0
"Nepal","2024-06-08",0,0,0,0,0,0,0,0
"Nepal","2024-06-09",0,0,0,0,0,0,0,0
"Nepal","2024-06-10",0,0,0,0,0,0,0,0
"Nepal","2024-06-11",0,0,0,0,0,0,0,0
"Nepal","2024-06-12",0,0,0,0,0,0,0,0
"Nepal","2024-06-13",0,0,0,0,0,0,0,0
"Nepal","2024-06-14",0,0,0,0,0,0,0,0
"Nepal","2024-06-15",0,0,0,0,0,0,0,0
"Nepal","2024-06-16",0,0,0,0,0,0,0,0
"Nepal","2024-06-17",0,0,0,0,0,0,0,0
"Nepal","2024-06-18",0,0,0,0,0,0,0,0
"Nepal","2024-06-19",0,0,0,0,0,0,0,0
"Nepal","2024-06-20",0,0,0,0,0,0,0,0
"Nepal","2024-06-21",0,0,0,0,0,0,0,0
"Nepal","2024-06-22",0,0,0,0,0,0,0,0
"Nepal","2024-06-23",0,0,0,0,0,0,0,0
"Nepal","2024-06-24",0,0,0,0,0,0,0,0
"Nepal","2024-06-25",0,0,0,0,0,0,0,0
"Nepal","2024-06-26",0,0,0,0,0,0,0,0
"Nepal","2024-06-27",0,0,0,0,0,0,0,0
"Nepal","2024-06-28",0,0,0,0,0,0,0,0
"Nepal","2024-06-29",0,0,0,0,0,0,0,0
"Nepal","2024-06-30",0,0,0,0,0,0,0,0
"Nepal","2024-07-01",0,0,0,0,0,0,0,0
"Nepal","2024-07-02",0,0,0,0,0,0,0,0
"Nepal","2024-07-03",0,0,0,0,0,0,0,0
"Nepal","2024-07-04",0,0,0,0,0,0,0,0
"Nepal","2024-07-05",0,0,0,0,0,0,0,0
"Nepal","2024-07-06",0,0,0,0,0,0,0,0
"Nepal","2024-07-07",0,0,0,0,0,0,0,0
"Nepal","2024-07-08",0,0,0,0,0,0,0,0
"Nepal","2024-07-09",0,0,0,0,0,0,0,0
"Nepal","2024-07-10",0,0,0,0,0,0,0,0
"Nepal","2024-07-11",0,0,0,0,0,0,0,0
"Nepal","2024-07-12",0,0,0,0,0,0,0,0
"Nepal","2024-07-13",0,0,0,0,0,0,0,0
"Nepal","2024-07-14",0,0,0,0,0,0,0,0
"Nepal","2024-07-15",0,0,0,0,0,0,0,0
"Nepal","2024-07-16",0,0,0,0,0,0,0,0
"Nepal","2024-07-17",0,0,0,0,0,0,0,0
"Nepal","2024-07-18",0,0,0,0,0,0,0,0
"Nepal","2024-07-19",0,0,0,0,0,0,0,0
"Nepal","2024-07-20",0,0,0,0,0,0,0,0
"Nepal","2024-07-21",0,0,0,0,0,0,0,0
"Nepal","2024-07-22",0,0,0,0,0,0,0,0
"Nepal","2024-07-23",0,0,0,0,0,0,0,0
"Nepal","2024-07-24",0,0,0,0,0,0,0,0
"Nepal","2024-07-25",0,0,0,0,0,0,0,0
"Nepal","2024-07-26",0,0,0,0,0,0,0,0
"Nepal","2024-07-27",0,0,0,0,0,0,0,0
"Nepal","2024-07-28",0,0,0,0,0,0,0,0
"Nepal","2024-07-29",0,0,0,0,0,0,0,0
"Nepal","2024-07-30",0,0,0,0,0,0,0,0
"Nepal","2024-07-31",0,0,0,0,0,0,0,0
"Nepal","2024-08-01",0,0,0,0,0,0,0,0
"Nepal","2024-08-02",0,0,0,0,0,0,0,0
"Nepal","2024-08-03",0,0,0,0,0,0,0,0
"Nepal","2024-08-04",0,0,0,0,0,0,0,0
"Nepal","2024-08-05",0,0,0,0,0,0,0,0
"Nepal","2024-08-06",0,0,0,0,0,0,0,0
"Nepal","2024-08-07",0,0,0,0,0,0,0,0
"Nepal","2024-08-08",0,0,0,0,0,0,0,0
"Nepal","2024-08-09",0,0,0,0,0,0,0,0
"Nepal","2024-08-10",0,0,0,0,0,0,0,0
"Nepal","2024-08-11",0,0,0,0,0,0,0,0
"Nepal","2024-08-12",0,0,0,0,0,0,0,0
"Nepal","2024-08-13",0,0,0,0,0,0,0,0
"Nepal","2024-08-14",0,0,0,0,0,0,0,0
"Nepal","2024-08-15",0,0,0,0,0,0,0,0
"Nepal","2024-08-16",0,0,0,0,0,0,0,0
"Nepal","2024-08-17",0,0,0,0,0,0,0,0
"Nepal","2024-08-18",0,0,0,0,0,0,0,0
"Nepal","2024-08-19",0,0,0,0,0,0,0,0
"Nepal","2024-08-20",0,0,0,0,0,0,0,0
"Nepal","2024-08-21",0,0,0,0,0,0,0,0
"Nepal","2024-08-22",0,0,0,0,0,0,0,0
"Nepal","2024-08-23",0,0,0,0,0,0,0,0
"Nepal","2024-08-24",0,0,0,0,0,0,0,0
"Nepal","2024-08-25",0,0,0,0,0,0,0,0
"Nepal","2024-08-26",0,0,0,0,0,0,0,0
"Nepal","2024-08-27",0,0,0,0,0,0,0,0
"Nepal","2024-08-28",0,0,0,0,0,0,0,0
"Nepal","2024-08-29",0,0,0,0,0,0,0,0
"Nepal","2024-08-30",0,0,0,0,0,0,0,0
"Nepal","2024-08-31",0,0,0,0,0,0,0,0
"Nepal","2024-09-01",0,0,0,0,0,0,0,0
"Nepal","2024-09-02",0,0,0,0,0,0,0,0
"Nepal","2024-09-03",0,0,0,0,0,0,0,0
"Nepal","2024-09-04",0,0,0,0,0,0,0,0
"Nepal","2024-09-05",0,0,0,0,0,0,0,0
"Nepal","2024-09-06",0,0,0,0,0,0,0,0
"Nepal","2024-09-07",0,0,0,0,0,0,0,0
"Nepal","2024-09-08",0,0,0,0,0,0,0,0
"Nepal","2024-09-09",0,0,0,0,0,0,0,0
"Nepal","2024-09-10",0,0,0,0,0,0,0,0
"Nepal","2024-09-11",0,0,0,0,0,0,0,0
"Nepal","2024-09-12",0,0,0,0,0,0,0,0
"Nepal","2024-09-13",0,0,0,0,0,0,0,0
"Nepal","2024-09-14",0,0,0,0,0,0,0,0
"Nepal","2024-09-15",0,0,0,0,0,0,0,0
"Nepal","2024-09-16",0,0,0,0,0,0,0,0
"Nepal","2024-09-17",0,0,0,0,0,0,0,0
"Nepal","2024-09-18",0,0,0,0,0,0,0,0
"Nepal","2024-09-19",0,0,0,0,0,0,0,0
"Nepal","2024-09-20",0,0,0,0,0,0,0,0
"Nepal","2024-09-21",0,0,0,0,0,0,0,0
"Nepal","2024-09-22",0,0,0,0,0,0,0,0
"Nepal","2024-09-23",0,0,0,0,0,0,0,0
"Nepal","2024-09-24",0,0,0,0,0,0,0,0
"Nepal","2024-09-25",0,0,0,0,0,0,0,0
"Nepal","2024-09-26",0,0,0,0,0,0,0,0
"Nepal","2024-09-27",0,0,0,0,0,0,0,0
"Nepal","2024-09-28",0,0,0,0,0,0,0,0
"Nepal","2024-09-29",0,0,0,0,0,0,0,0
"Nepal","2024-09-30",0,0,0,0,0,0,0,0
"Nepal","2024-10-01",0,0,0,0,0,0,0,0
"Nepal","2024-10-02",0,0,0,0,0,0,0,0
"Nepal","2024-10-03",0,0,0,0,0,0,0,0
"Nepal","2024-10-04",0,0,0,0,0,0,0,0
"Nepal","2024-10-05",0,0,0,0,0,0,0,0
"Nepal","2024-10-06",0,0,0,0,0,0,0,0
"Nepal","2024-10-07",0,0,0,0,0,0,0,0
"Nepal","2024-10-08",0,0,0,0,0,0,0,0
"Nepal","2024-10-09",0,0,0,0,0,0,0,0
"Nepal","2024-10-10",0,0,0,0,0,0,0,0
"Nepal","2024-10-11",0,0,0,0,0,0,0,0
"Nepal","2024-10-12",0,0,0,0,0,0,0,0
"Nepal","2024-10-13",0,0,0,0,0,0,0,0
"Nepal","2024-10-14",0,0,0,0,0,0,0,0
"Nepal","2024-10-15",0,0,0,0,0,0,0,0
"Nepal","2024-10-16",0,0,0,0,0,0,0,0
"Nepal","2024-10-17",0,0,0,0,0,0,0,0
"Nepal","2024-10-18",0,0,0,0,0,0,0,0
"Nepal","2024-10-19",0,0,0,0,0,0,0,0
"Nepal","2024-10-20",0,0,0,0,0,0,0,0
"Nepal","2024-10-21",0,0,0,0,0,0,0,0
"Nepal","2024-10-22",0,0,0,0,0,0,0,0
"Nepal","2024-10-23",0,0,0,0,0,0,0,0
"Nepal","2024-10-24",0,0,0,0,0,0,0,0
"Nepal","2024-10-25",0,0,0,0,0,0,0,0
"Nepal","2024-10-26",0,0,0,0,0,0,0,0
"Nepal","2024-10-27",0,0,0,0,0,0,0,0
"Nepal","2024-10-28",0,0,0,0,0,0,0,0
"Nepal","2024-10-29",0,0,0,0,0,0,0,0
"Nepal","2024-10-30",0,0,0,0,0,0,0,0
"Nepal","2024-10-31",0,0,0,0,0,0,0,0
"Nepal","2024-11-01",0,0,0,0,0,0,0,0
"Nepal","2024-11-02",0,0,0,0,0,0,0,0
"Nepal","2024-11-03",0,0,0,0,0,0,0,0
"Nepal","2024-11-04",0,0,0,0,0,0,0,0
"Nepal","2024-11-05",0,0,0,0,0,0,0,0
"Nepal","2024-11-06",0,0,0,0,0,0,0,0
"Nepal","2024-11-07",0,0,0,0,0,0,0,0
"Nepal","2024-11-08",0,0,0,0,0,0,0,0
"Nepal","2024-11-09",0,0,0,0,0,0,0,0
"Nepal","2024-11-10",0,0,0,0,0,0,0,0
"Nepal","2024-11-11",0,0,0,0,0,0,0,0
"Nepal","2024-11-12",0,0,0,0,0,0,0,0
"Nepal","2024-11-13",0,0,0,0,0,0,0,0
"Nepal","2024-11-14",0,0,0,0,0,0,0,0
"Nepal","2024-11-15",0,0,0,0,0,0,0,0
"Nepal","2024-11-16",0,0,0,0,0,0,0,0
"Nepal","2024-11-17",0,0,0,0,0,0,0,0
"Nepal","2024-11-18",0,0,0,0,0,0,0,0
"Nepal","2024-11-19",0,0,0,0,0,0,0,0
"Nepal","2024-11-20",0,0,0,0,0,0,0,0
"Nepal","2024-11-21",0,0,0,0,0,0,0,0
"Nepal","2024-11-22",0,0,0,0,0,0,0,0
"Nepal","2024-11-23",0,0,0,0,0,0,0,0
"Nepal","2024-11-24",0,0,0,0,0,0,0,0
"Nepal","2024-11-25",0,0,0,0,0,0,0,0
"Nepal","2024-11-26",0,0,0,0,0,0,0,0
"Nepal","2024-11-27",0,0,0,0,0,0,0,0
"Nepal","2024-11-28",0,0,0,0,0,0,0,0
"Nepal","2024-11-29",0,0,0,0,0,0,0,0
"Nepal","2024-11-30",0,0,0,0,0,0,0,0
"Nepal","2024-12-01",0,0,0,0,0,0,0,0
"Nepal","2024-12-02",0,0,0,0,0,0,0,0
"Nepal","2024-12-03",0,0,0,0,0,0,0,0
"Nepal","2024-12-04",0,0,0,0,0,0,0,0
"Nepal","2024-12-05",0,0,0,0,0,0,0,0
"Nepal","2024-12-06",0,0,0,0,0,0,0,0
"Nepal","2024-12-07",0,0,0,0,0,0,0,0
"Nepal","2024-12-08",0,0,0,0,0,0,0,0
"Nepal","2024-12-09",0,0,0,0,0,0,0,0
"Netherlands (Kingdom of the)","2024-01-01",0,0,0,0,0,0,0,0
"Netherlands (Kingdom of the)","2024-01-02",0,0,0,0,0,0,0,0
"Netherlands (Kingdom of the)","2024-01-03",0,0,0,0,0,0,0,0
"Netherlands (Kingdom of the)","2024-01-04",0,0,0,0,0,0,0,0
"Netherlands (Kingdom of the)","2024-01-05",0,0,0,0,0,0,0,0
"Netherlands (Kingdom of the)","2024-01-06",0,0,0,0,0,0,0,0
"Netherlands (Kingdom of the)","2024-01-07",0,0,0,0,0,0,0,0
"Netherlands (Kingdom of the)","2024-01-08",0,0,0,0,0,0,0,0
"Netherlands (Kingdom of the)","2024-01-09",0,0,0,0,0,0,0,0
"Netherlands (Kingdom of the)","2024-01-10",0,0,0,0,0,0,0,0
"Netherlands (Kingdom of the)","2024-01-11",0,0,0,0,0,0,0,0
"Netherlands (Kingdom of the)","2024-01-12",0,0,0,0,0,0,0,0
"Netherlands (Kingdom of the)","2024-01-13",0,0,0,0,0,0,0,0
"Netherlands (Kingdom of the)","2024-01-14",0,0,0,0,0,0,0,0
"Netherlands (Kingdom of the)","2024-01-15",0,0,0,0,0,0,0,0
"Netherlands (Kingdom of the)","2024-01-16",0,0,0,0,0,0,0,0
"Netherlands (Kingdom of the)","2024-01-17",0,0,0,0,0,0,0,0
"Netherlands (Kingdom of the)","2024-01-18",0,0,0,0,0,0,0,0
"Netherlands (Kingdom of the)","2024-01-19",0,0,0,0,0,0,0,0
"Netherlands (Kingdom of the)","2024-01-20",0,0,0,0,0,0,0,0
"Netherlands (Kingdom of the)","2024-01-21",0,0,0,0,0,0,0,0
"Netherlands (Kingdom of the)","2024-01-22",0,0,0,0,0,0,0,0
"Netherlands (Kingdom of the)","2024-01-23",0,0,0,0,0,0,0,0
"Netherlands (Kingdom of the)","2024-01-24",0,0,0,0,0,0,0,0
"Netherlands (Kingdom of the)","2024-01-25",0,0,0,0,0,0,0,0
"Netherlands (Kingdom of the)","2024-01-26",0,0,0,0,0,0,0,0
"Netherlands (Kingdom of the)","2024-01-27",0,0,0,0,0,0,0,0
"Netherlands (Kingdom of the)","2024-01-28",0,0,0,0,0,0,0,0
"Netherlands (Kingdom of the)","2024-01-29",0,0,0,0,0,0,0,0
"Netherlands (Kingdom of the)","2024-01-30",0,0,0,0,0,0,0,0
"Netherlands (Kingdom of the)","2024-01-31",0,5,5,0,5,5,0,0
"Netherlands (Kingdom of the)","2024-02-01",0,0,5,0,0,5,0,0
"Netherlands (Kingdom of the)","2024-02-02",0,0,5,0,0,5,0,0
"Netherlands (Kingdom of the)","2024-02-03",0,0,5,0,1,6,0,0
"Netherlands (Kingdom of the)","2024-02-04",0,0,5,0,0,6,0,0
"Netherlands (Kingdom of the)","2024-02-05",0,0,5,0,0,6,0,0
"Netherlands (Kingdom of the)","2024-02-06",0,0,5,0,0,6,0,0
"Netherlands (Kingdom of the)","2024-02-07",0,0,5,0,1,7,0,0
"Netherlands (Kingdom of the)","2024-02-08",0,0,5,0,0,7,0,0
"Netherlands (Kingdom of the)","2024-02-09",0,0,5,0,0,7,0,0
"Netherlands (Kingdom of the)","2024-02-10",0,0,5,0,0,7,0,0
"Netherlands (Kingdom of the)","2024-02-11",0,0,5,0,1,8,0,0
"Netherlands (Kingdom of the)","2024-02-12",0,0,5,0,0,8,0,0
"Netherlands (Kingdom of the)","2024-02-13",0,0,5,0,0,8,0,0
"Netherlands (Kingdom of the)","2024-02-14",0,0,5,0,0,8,0,0
"Netherlands (Kingdom of the)","2024-02-15",0,0,5,0,1,9,0,0
"Netherlands (Kingdom of the)","2024-02-16",0,0,5,0,0,9,0,0
"Netherlands (Kingdom of the)","2024-02-17",0,0,5,0,0,9,0,0
"Netherlands (Kingdom of the)","2024-02-18",0,0,5,0,0,9,0,0
"Netherlands (Kingdom of the)","2024-02-19",0,0,5,0,1,10,0,0
"Netherlands (Kingdom of the)","2024-02-20",0,0,5,0,0,10,0,0
"Netherlands (Kingdom of the)","2024-02-21",0,0,5,0,0,10,0,0
"Netherlands (Kingdom of the)","2024-02-22",0,0,5,0,0,10,0,0
"Netherlands (Kingdom of the)","2024-02-23",0,0,5,0,1,11,0,0
"Netherlands (Kingdom of the)","2024-02-24",0,0,5,0,0,11,0,0
"Netherlands (Kingdom of the)","2024-02-25",0,0,5,0,0,11,0,0
"Netherlands (Kingdom of the)","2024-02-26",0,0,5,0,0,11,0,0
"Netherlands (Kingdom of the)","2024-02-27",0,0,5,0,1,12,0,0
"Netherlands (Kingdom of the)","2024-02-28",0,0,5,0,0,12,0,0
"Netherlands (Kingdom of the)","2024-02-29",0,7,12,0,0,12,0,0
"Netherlands (Kingdom of the)","2024-03-01",0,0,12,0,0,12,0,0
"Netherlands (Kingdom of the)","2024-03-02",0,0,12,0,0,12,0,0
"Netherlands (Kingdom of the)","2024-03-03",0,0,12,0,0,12,0,0
"Netherlands (Kingdom of the)","2024-03-04",0,0,12,0,0,12,0,0
"Netherlands (Kingdom of the)","2024-03-05",0,0,12,0,0,12,0,0
"Netherlands (Kingdom of the)","2024-03-06",0,0,12,0,0,12,0,0
"Netherlands (Kingdom of the)","2024-03-07",0,0,12,0,0,12,0,0
"Netherlands (Kingdom of the)","2024-03-08",0,0,12,0,0,12,0,0
"Netherlands (Kingdom of the)","2024-03-09",0,0,12,0,0,12,0,0
"Netherlands (Kingdom of the)","2024-03-10",0,0,12,0,0,12,0,0
"Netherlands (Kingdom of the)","2024-03-11",0,0,12,0,0,12,0,0
"Netherlands (Kingdom of the)","2024-03-12",0,0,12,0,0,12,0,0
"Netherlands (Kingdom of the)","2024-03-13",0,0,12,0,0,12,0,0
"Netherlands (Kingdom of the)","2024-03-14",0,0,12,0,0,12,0,0
"Netherlands (Kingdom of the)","2024-03-15",0,0,12,0,0,12,0,0
"Netherlands (Kingdom of the)","2024-03-16",0,0,12,0,1,13,0,0
"Netherlands (Kingdom of the)","2024-03-17",0,0,12,0,0,13,0,0
"Netherlands (Kingdom of the)","2024-03-18",0,0,12,0,0,13,0,0
"Netherlands (Kingdom of the)","2024-03-19",0,0,12,0,0,13,0,0
"Netherlands (Kingdom of the)","2024-03-20",0,0,12,0,0,13,0,0
"Netherlands (Kingdom of the)","2024-03-21",0,0,12,0,0,13,0,0
"Netherlands (Kingdom of the)","2024-03-22",0,0,12,0,0,13,0,0
"Netherlands (Kingdom of the)","2024-03-23",0,0,12,0,0,13,0,0
"Netherlands (Kingdom of the)","2024-03-24",0,0,12,0,0,13,0,0
"Netherlands (Kingdom of the)","2024-03-25",0,0,12,0,0,13,0,0
"Netherlands (Kingdom of the)","2024-03-26",0,0,12,0,0,13,0,0
"Netherlands (Kingdom of the)","2024-03-27",0,0,12,0,0,13,0,0
"Netherlands (Kingdom of the)","2024-03-28",0,0,12,0,0,13,0,0
"Netherlands (Kingdom of the)","2024-03-29",0,0,12,0,0,13,0,0
"Netherlands (Kingdom of the)","2024-03-30",0,0,12,0,0,13,0,0
"Netherlands (Kingdom of the)","2024-03-31",0,0,12,0,0,13,0,0
"Netherlands (Kingdom of the)","2024-04-01",0,0,12,0,0,13,0,0
"Netherlands (Kingdom of the)","2024-04-02",0,0,12,0,0,13,0,0
"Netherlands (Kingdom of the)","2024-04-03",0,0,12,0,0,13,0,0
"Netherlands (Kingdom of the)","2024-04-04",0,0,12,0,0,13,0,0
"Netherlands (Kingdom of the)","2024-04-05",0,0,12,0,0,13,0,0
"Netherlands (Kingdom of the)","2024-04-06",0,0,12,0,0,13,0,0
"Netherlands (Kingdom of the)","2024-04-07",0,0,12,0,0,13,0,0
"Netherlands (Kingdom of the)","2024-04-08",0,0,12,0,0,13,0,0
"Netherlands (Kingdom of the)","2024-04-09",0,0,12,0,0,13,0,0
"Netherlands (Kingdom of the)","2024-04-10",0,0,12,0,0,13,0,0
"Netherlands (Kingdom of the)","2024-04-11",0,0,12,0,0,13,0,0
"Netherlands (Kingdom of the)","2024-04-12",0,0,12,0,0,13,0,0
"Netherlands (Kingdom of the)","2024-04-13",0,0,12,0,0,13,0,0
"Netherlands (Kingdom of the)","2024-04-14",0,0,12,0,0,13,0,0
"Netherlands (Kingdom of the)","2024-04-15",0,0,12,0,1,14,0,0
"Netherlands (Kingdom of the)","2024-04-16",0,0,12,0,0,14,0,0
"Netherlands (Kingdom of the)","2024-04-17",0,0,12,0,0,14,0,0
"Netherlands (Kingdom of the)","2024-04-18",0,0,12,0,0,14,0,0
"Netherlands (Kingdom of the)","2024-04-19",0,0,12,0,0,14,0,0
"Netherlands (Kingdom of the)","2024-04-20",0,0,12,0,0,14,0,0
"Netherlands (Kingdom of the)","2024-04-21",0,0,12,0,0,14,0,0
"Netherlands (Kingdom of the)","2024-04-22",0,0,12,0,0,14,0,0
"Netherlands (Kingdom of the)","2024-04-23",0,0,12,0,0,14,0,0
"Netherlands (Kingdom of the)","2024-04-24",0,0,12,0,0,14,0,0
"Netherlands (Kingdom of the)","2024-04-25",0,0,12,0,0,14,0,0
"Netherlands (Kingdom of the)","2024-04-26",0,0,12,0,0,14,0,0
"Netherlands (Kingdom of the)","2024-04-27",0,0,12,0,0,14,0,0
"Netherlands (Kingdom of the)","2024-04-28",0,0,12,0,0,14,0,0
"Netherlands (Kingdom of the)","2024-04-29",0,0,12,0,0,14,0,0
"Netherlands (Kingdom of the)","2024-04-30",0,2,14,0,0,14,0,0
"Netherlands (Kingdom of the)","2024-05-01",0,0,14,0,0,14,0,0
"Netherlands (Kingdom of the)","2024-05-02",0,0,14,0,0,14,0,0
"Netherlands (Kingdom of the)","2024-05-03",0,0,14,0,0,14,0,0
"Netherlands (Kingdom of the)","2024-05-04",0,0,14,0,0,14,0,0
"Netherlands (Kingdom of the)","2024-05-05",0,0,14,0,0,14,0,0
"Netherlands (Kingdom of the)","2024-05-06",0,0,14,0,0,14,0,0
"Netherlands (Kingdom of the)","2024-05-07",0,0,14,0,0,14,0,0
"Netherlands (Kingdom of the)","2024-05-08",0,0,14,0,0,14,0,0
"Netherlands (Kingdom of the)","2024-05-09",0,0,14,0,0,14,0,0
"Netherlands (Kingdom of the)","2024-05-10",0,0,14,0,0,14,0,0
"Netherlands (Kingdom of the)","2024-05-11",0,0,14,0,0,14,0,0
"Netherlands (Kingdom of the)","2024-05-12",0,0,14,0,0,14,0,0
"Netherlands (Kingdom of the)","2024-05-13",0,0,14,0,0,14,0,0
"Netherlands (Kingdom of the)","2024-05-14",0,0,14,0,0,14,0,0
"Netherlands (Kingdom of the)","2024-05-15",0,0,14,0,0,14,0,0
"Netherlands (Kingdom of the)","2024-05-16",0,0,14,0,1,15,0,0
"Netherlands (Kingdom of the)","2024-05-17",0,0,14,0,0,15,0,0
"Netherlands (Kingdom of the)","2024-05-18",0,0,14,0,0,15,0,0
"Netherlands (Kingdom of the)","2024-05-19",0,0,14,0,0,15,0,0
"Netherlands (Kingdom of the)","2024-05-20",0,0,14,0,0,15,0,0
"Netherlands (Kingdom of the)","2024-05-21",0,0,14,0,0,15,0,0
"Netherlands (Kingdom of the)","2024-05-22",0,0,14,0,0,15,0,0
"Netherlands (Kingdom of the)","2024-05-23",0,0,14,0,0,15,0,0
"Netherlands (Kingdom of the)","2024-05-24",0,0,14,0,0,15,0,0
"Netherlands (Kingdom of the)","2024-05-25",0,0,14,0,0,15,0,0
"Netherlands (Kingdom of the)","2024-05-26",0,0,14,0,0,15,0,0
"Netherlands (Kingdom of the)","2024-05-27",0,0,14,0,0,15,0,0
"Netherlands (Kingdom of the)","2024-05-28",0,0,14,0,0,15,0,0
"Netherlands (Kingdom of the)","2024-05-29",0,0,14,0,0,15,0,0
"Netherlands (Kingdom of the)","2024-05-30",0,0,14,0,0,15,0,0
"Netherlands (Kingdom of the)","2024-05-31",0,1,15,0,0,15,0,0
"Netherlands (Kingdom of the)","2024-06-01",0,0,15,0,0,15,0,0
"Netherlands (Kingdom of the)","2024-06-02",0,0,15,0,0,15,0,0
"Netherlands (Kingdom of the)","2024-06-03",0,0,15,0,0,15,0,0
"Netherlands (Kingdom of the)","2024-06-04",0,0,15,0,0,15,0,0
"Netherlands (Kingdom of the)","2024-06-05",0,0,15,0,0,15,0,0
"Netherlands (Kingdom of the)","2024-06-06",0,0,15,0,0,15,0,0
"Netherlands (Kingdom of the)","2024-06-07",0,0,15,0,0,15,0,0
"Netherlands (Kingdom of the)","2024-06-08",0,0,15,0,1,16,0,0
"Netherlands (Kingdom of the)","2024-06-09",0,0,15,0,0,16,0,0
"Netherlands (Kingdom of the)","2024-06-10",0,0,15,0,0,16,0,0
"Netherlands (Kingdom of the)","2024-06-11",0,0,15,0,0,16,0,0
"Netherlands (Kingdom of the)","2024-06-12",0,0,15,0,0,16,0,0
"Netherlands (Kingdom of the)","2024-06-13",0,0,15,0,0,16,0,0
"Netherlands (Kingdom of the)","2024-06-14",0,0,15,0,0,16,0,0
"Netherlands (Kingdom of the)","2024-06-15",0,0,15,0,0,16,0,0
"Netherlands (Kingdom of the)","2024-06-16",0,0,15,0,0,16,0,0
"Netherlands (Kingdom of the)","2024-06-17",0,0,15,0,0,16,0,0
"Netherlands (Kingdom of the)","2024-06-18",0,0,15,0,0,16,0,0
"Netherlands (Kingdom of the)","2024-06-19",0,0,15,0,0,16,0,0
"Netherlands (Kingdom of the)","2024-06-20",0,0,15,0,0,16,0,0
"Netherlands (Kingdom of the)","2024-06-21",0,0,15,0,0,16,0,0
"Netherlands (Kingdom of the)","2024-06-22",0,0,15,0,0,16,0,0
"Netherlands (Kingdom of the)","2024-06-23",0,0,15,0,1,17,0,0
"Netherlands (Kingdom of the)","2024-06-24",0,0,15,0,0,17,0,0
"Netherlands (Kingdom of the)","2024-06-25",0,0,15,0,0,17,0,0
"Netherlands (Kingdom of the)","2024-06-26",0,0,15,0,0,17,0,0
"Netherlands (Kingdom of the)","2024-06-27",0,0,15,0,0,17,0,0
"Netherlands (Kingdom of the)","2024-06-28",0,0,15,0,0,17,0,0
"Netherlands (Kingdom of the)","2024-06-29",0,0,15,0,0,17,0,0
"Netherlands (Kingdom of the)","2024-06-30",0,2,17,0,0,17,0,0
"Netherlands (Kingdom of the)","2024-07-01",0,0,17,0,0,17,0,0
"Netherlands (Kingdom of the)","2024-07-02",0,0,17,0,0,17,0,0
"Netherlands (Kingdom of the)","2024-07-03",0,0,17,0,0,17,0,0
"Netherlands (Kingdom of the)","2024-07-04",0,0,17,0,1,18,0,0
"Netherlands (Kingdom of the)","2024-07-05",0,0,17,0,0,18,0,0
"Netherlands (Kingdom of the)","2024-07-06",0,0,17,0,0,18,0,0
"Netherlands (Kingdom of the)","2024-07-07",0,0,17,0,0,18,0,0
"Netherlands (Kingdom of the)","2024-07-08",0,0,17,0,0,18,0,0
"Netherlands (Kingdom of the)","2024-07-09",0,0,17,0,0,18,0,0
"Netherlands (Kingdom of the)","2024-07-10",0,0,17,0,0,18,0,0
"Netherlands (Kingdom of the)","2024-07-11",0,0,17,0,0,18,0,0
"Netherlands (Kingdom of the)","2024-07-12",0,0,17,0,1,19,0,0
"Netherlands (Kingdom of the)","2024-07-13",0,0,17,0,0,19,0,0
"Netherlands (Kingdom of the)","2024-07-14",0,0,17,0,0,19,0,0
"Netherlands (Kingdom of the)","2024-07-15",0,0,17,0,0,19,0,0
"Netherlands (Kingdom of the)","2024-07-16",0,0,17,0,0,19,0,0
"Netherlands (Kingdom of the)","2024-07-17",0,0,17,0,0,19,0,0
"Netherlands (Kingdom of the)","2024-07-18",0,0,17,0,0,19,0,0
"Netherlands (Kingdom of the)","2024-07-19",0,0,17,0,0,19,0,0
"Netherlands (Kingdom of the)","2024-07-20",0,0,17,0,1,20,0,0
"Netherlands (Kingdom of the)","2024-07-21",0,0,17,0,0,20,0,0
"Netherlands (Kingdom of the)","2024-07-22",0,0,17,0,0,20,0,0
"Netherlands (Kingdom of the)","2024-07-23",0,0,17,0,0,20,0,0
"Netherlands (Kingdom of the)","2024-07-24",0,0,17,0,0,20,0,0
"Netherlands (Kingdom of the)","2024-07-25",0,0,17,0,0,20,0,0
"Netherlands (Kingdom of the)","2024-07-26",0,0,17,0,0,20,0,0
"Netherlands (Kingdom of the)","2024-07-27",0,0,17,0,0,20,0,0
"Netherlands (Kingdom of the)","2024-07-28",0,0,17,0,1,21,0,0
"Netherlands (Kingdom of the)","2024-07-29",0,0,17,0,0,21,0,0
"Netherlands (Kingdom of the)","2024-07-30",0,0,17,0,0,21,0,0
"Netherlands (Kingdom of the)","2024-07-31",0,4,21,0,0,21,0,0
"Netherlands (Kingdom of the)","2024-08-01",0,0,21,0,1,22,0,0
"Netherlands (Kingdom of the)","2024-08-02",0,0,21,0,0,22,0,0
"Netherlands (Kingdom of the)","2024-08-03",0,0,21,0,1,23,0,0
"Netherlands (Kingdom of the)","2024-08-04",0,0,21,0,0,23,0,0
"Netherlands (Kingdom of the)","2024-08-05",0,0,21,0,1,24,0,0
"Netherlands (Kingdom of the)","2024-08-06",0,0,21,0,1,25,0,0
"Netherlands (Kingdom of the)","2024-08-07",0,0,21,0,0,25,0,0
"Netherlands (Kingdom of the)","2024-08-08",0,0,21,0,1,26,0,0
"Netherlands (Kingdom of the)","2024-08-09",0,0,21,0,1,27,0,0
"Netherlands (Kingdom of the)","2024-08-10",0,0,21,0,0,27,0,0
"Netherlands (Kingdom of the)","2024-08-11",0,0,21,0,1,28,0,0
"Netherlands (Kingdom of the)","2024-08-12",0,0,21,0,0,28,0,0
"Netherlands (Kingdom of the)","2024-08-13",0,0,21,0,1,29,0,0
"Netherlands (Kingdom of the)","2024-08-14",0,0,21,0,1,30,0,0
"Netherlands (Kingdom of the)","2024-08-15",0,0,21,0,0,30,0,0
"Netherlands (Kingdom of the)","2024-08-16",0,0,21,0,1,31,0,0
"Netherlands (Kingdom of the)","2024-08-17",0,0,21,0,0,31,0,0
"Netherlands (Kingdom of the)","2024-08-18",0,0,21,0,1,32,0,0
"Netherlands (Kingdom of the)","2024-08-19",0,0,21,0,1,33,0,0
"Netherlands (Kingdom of the)","2024-08-20",0,0,21,0,0,33,0,0
"Netherlands (Kingdom of the)","2024-08-21",0,0,21,0,1,34,0,0
"Netherlands (Kingdom of the)","2024-08-22",0,0,21,0,0,34,0,0
"Netherlands (Kingdom of the)","2024-08-23",0,0,21,0,1,35,0,0
"Netherlands (Kingdom of the)","2024-08-24",0,0,21,0,1,36,0,0
"Netherlands (Kingdom of the)","2024-08-25",0,0,21,0,0,36,0,0
"Netherlands (Kingdom of the)","2024-08-26",0,0,21,0,1,37,0,0
"Netherlands (Kingdom of the)","2024-08-27",0,0,21,0,1,38,0,0
"Netherlands (Kingdom of the)","2024-08-28",0,0,21,0,0,38,0,0
"Netherlands (Kingdom of the)","2024-08-29",0,0,21,0,1,39,0,0
"Netherlands (Kingdom of the)","2024-08-30",0,0,21,0,0,39,0,0
"Netherlands (Kingdom of the)","2024-08-31",0,19,40,0,1,40,0,0
"Netherlands (Kingdom of the)","2024-09-01",0,0,40,0,1,41,0,0
"Netherlands (Kingdom of the)","2024-09-02",0,0,40,0,0,41,0,0
"Netherlands (Kingdom of the)","2024-09-03",0,0,40,0,1,42,0,0
"Netherlands (Kingdom of the)","2024-09-04",0,0,40,0,1,43,0,0
"Netherlands (Kingdom of the)","2024-09-05",0,0,40,0,1,44,0,0
"Netherlands (Kingdom of the)","2024-09-06",0,0,40,0,0,44,0,0
"Netherlands (Kingdom of the)","2024-09-07",0,0,40,0,1,45,0,0
"Netherlands (Kingdom of the)","2024-09-08",0,0,40,0,1,46,0,0
"Netherlands (Kingdom of the)","2024-09-09",0,0,40,0,1,47,0,0
"Netherlands (Kingdom of the)","2024-09-10",0,0,40,0,0,47,0,0
"Netherlands (Kingdom of the)","2024-09-11",0,0,40,0,1,48,0,0
"Netherlands (Kingdom of the)","2024-09-12",0,0,40,0,1,49,0,0
"Netherlands (Kingdom of the)","2024-09-13",0,0,40,0,1,50,0,0
"Netherlands (Kingdom of the)","2024-09-14",0,0,40,0,0,50,0,0
"Netherlands (Kingdom of the)","2024-09-15",0,0,40,0,1,51,0,0
"Netherlands (Kingdom of the)","2024-09-16",0,0,40,0,1,52,0,0
"Netherlands (Kingdom of the)","2024-09-17",0,0,40,0,0,52,0,0
"Netherlands (Kingdom of the)","2024-09-18",0,0,40,0,1,53,0,0
"Netherlands (Kingdom of the)","2024-09-19",0,0,40,0,1,54,0,0
"Netherlands (Kingdom of the)","2024-09-20",0,0,40,0,1,55,0,0
"Netherlands (Kingdom of the)","2024-09-21",0,0,40,0,0,55,0,0
"Netherlands (Kingdom of the)","2024-09-22",0,0,40,0,1,56,0,0
"Netherlands (Kingdom of the)","2024-09-23",0,0,40,0,1,57,0,0
"Netherlands (Kingdom of the)","2024-09-24",0,0,40,0,1,58,0,0
"Netherlands (Kingdom of the)","2024-09-25",0,0,40,0,0,58,0,0
"Netherlands (Kingdom of the)","2024-09-26",0,0,40,0,1,59,0,0
"Netherlands (Kingdom of the)","2024-09-27",0,0,40,0,1,60,0,0
"Netherlands (Kingdom of the)","2024-09-28",0,0,40,0,1,61,0,0
"Netherlands (Kingdom of the)","2024-09-29",0,0,40,0,0,61,0,0
"Netherlands (Kingdom of the)","2024-09-30",0,22,62,0,1,62,0,0
"Netherlands (Kingdom of the)","2024-10-01",0,0,62,0,1,63,0,0
"Netherlands (Kingdom of the)","2024-10-02",0,0,62,0,1,64,0,0
"Netherlands (Kingdom of the)","2024-10-03",0,0,62,0,0,64,0,0
"Netherlands (Kingdom of the)","2024-10-04",0,0,62,0,1,65,0,0
"Netherlands (Kingdom of the)","2024-10-05",0,0,62,0,1,66,0,0
"Netherlands (Kingdom of the)","2024-10-06",0,0,62,0,1,67,0,0
"Netherlands (Kingdom of the)","2024-10-07",0,0,62,0,1,68,0,0
"Netherlands (Kingdom of the)","2024-10-08",0,0,62,0,0,68,0,0
"Netherlands (Kingdom of the)","2024-10-09",0,0,62,0,1,69,0,0
"Netherlands (Kingdom of the)","2024-10-10",0,0,62,0,1,70,0,0
"Netherlands (Kingdom of the)","2024-10-11",0,0,62,0,1,71,0,0
"Netherlands (Kingdom of the)","2024-10-12",0,0,62,0,1,72,0,0
"Netherlands (Kingdom of the)","2024-10-13",0,0,62,0,0,72,0,0
"Netherlands (Kingdom of the)","2024-10-14",0,0,62,0,1,73,0,0
"Netherlands (Kingdom of the)","2024-10-15",0,0,62,0,1,74,0,0
"Netherlands (Kingdom of the)","2024-10-16",0,0,62,0,1,75,0,0
"Netherlands (Kingdom of the)","2024-10-17",0,0,62,0,1,76,0,0
"Netherlands (Kingdom of the)","2024-10-18",0,0,62,0,1,77,0,0
"Netherlands (Kingdom of the)","2024-10-19",0,0,62,0,0,77,0,0
"Netherlands (Kingdom of the)","2024-10-20",0,0,62,0,1,78,0,0
"Netherlands (Kingdom of the)","2024-10-21",0,0,62,0,1,79,0,0
"Netherlands (Kingdom of the)","2024-10-22",0,0,62,0,1,80,0,0
"Netherlands (Kingdom of the)","2024-10-23",0,0,62,0,1,81,0,0
"Netherlands (Kingdom of the)","2024-10-24",0,0,62,0,0,81,0,0
"Netherlands (Kingdom of the)","2024-10-25",0,0,62,0,1,82,0,0
"Netherlands (Kingdom of the)","2024-10-26",0,0,62,0,1,83,0,0
"Netherlands (Kingdom of the)","2024-10-27",0,0,62,0,1,84,0,0
"Netherlands (Kingdom of the)","2024-10-28",0,0,62,0,1,85,0,0
"Netherlands (Kingdom of the)","2024-10-29",0,0,62,0,0,85,0,0
"Netherlands (Kingdom of the)","2024-10-30",0,0,62,0,1,86,0,0
"Netherlands (Kingdom of the)","2024-10-31",0,25,87,0,1,87,0,0
"Netherlands (Kingdom of the)","2024-11-01",0,0,87,0,0,87,0,0
"Netherlands (Kingdom of the)","2024-11-02",0,0,87,0,0,87,0,0
"Netherlands (Kingdom of the)","2024-11-03",0,0,87,0,0,87,0,0
"Netherlands (Kingdom of the)","2024-11-04",0,0,87,0,0,87,0,0
"Netherlands (Kingdom of the)","2024-11-05",0,0,87,0,0,87,0,0
"Netherlands (Kingdom of the)","2024-11-06",0,0,87,0,0,87,0,0
"Netherlands (Kingdom of the)","2024-11-07",0,0,87,0,0,87,0,0
"Netherlands (Kingdom of the)","2024-11-08",0,0,87,0,0,87,0,0
"Netherlands (Kingdom of the)","2024-11-09",0,0,87,0,0,87,0,0
"Netherlands (Kingdom of the)","2024-11-10",0,0,87,0,0,87,0,0
"Netherlands (Kingdom of the)","2024-11-11",0,0,87,0,0,87,0,0
"Netherlands (Kingdom of the)","2024-11-12",0,0,87,0,0,87,0,0
"Netherlands (Kingdom of the)","2024-11-13",0,0,87,0,0,87,0,0
"Netherlands (Kingdom of the)","2024-11-14",0,0,87,0,0,87,0,0
"Netherlands (Kingdom of the)","2024-11-15",0,0,87,0,0,87,0,0
"Netherlands (Kingdom of the)","2024-11-16",0,0,87,0,0,87,0,0
"Netherlands (Kingdom of the)","2024-11-17",0,0,87,0,0,87,0,0
"Netherlands (Kingdom of the)","2024-11-18",0,0,87,0,0,87,0,0
"Netherlands (Kingdom of the)","2024-11-19",0,0,87,0,0,87,0,0
"Netherlands (Kingdom of the)","2024-11-20",0,0,87,0,0,87,0,0
"Netherlands (Kingdom of the)","2024-11-21",0,0,87,0,0,87,0,0
"Netherlands (Kingdom of the)","2024-11-22",0,0,87,0,0,87,0,0
"Netherlands (Kingdom of the)","2024-11-23",0,0,87,0,0,87,0,0
"Netherlands (Kingdom of the)","2024-11-24",0,0,87,0,0,87,0,0
"Netherlands (Kingdom of the)","2024-11-25",0,0,87,0,0,87,0,0
"Netherlands (Kingdom of the)","2024-11-26",0,0,87,0,0,87,0,0
"Netherlands (Kingdom of the)","2024-11-27",0,0,87,0,0,87,0,0
"Netherlands (Kingdom of the)","2024-11-28",0,0,87,0,0,87,0,0
"Netherlands (Kingdom of the)","2024-11-29",0,0,87,0,0,87,0,0
"Netherlands (Kingdom of the)","2024-11-30",0,0,87,0,0,87,0,0
"Netherlands (Kingdom of the)","2024-12-01",0,0,87,0,0,87,0,0
"Netherlands (Kingdom of the)","2024-12-02",0,0,87,0,0,87,0,0
"Netherlands (Kingdom of the)","2024-12-03",0,0,87,0,0,87,0,0
"Netherlands (Kingdom of the)","2024-12-04",0,0,87,0,0,87,0,0
"Netherlands (Kingdom of the)","2024-12-05",0,0,87,0,0,87,0,0
"Netherlands (Kingdom of the)","2024-12-06",0,0,87,0,0,87,0,0
"Netherlands (Kingdom of the)","2024-12-07",0,0,87,0,0,87,0,0
"Netherlands (Kingdom of the)","2024-12-08",0,0,87,0,0,87,0,0
"Netherlands (Kingdom of the)","2024-12-09",0,0,87,0,0,87,0,0
"New Zealand","2024-01-01",0,0,0,0,0,0,0,0
"New Zealand","2024-01-02",0,0,0,0,0,0,0,0
"New Zealand","2024-01-03",0,0,0,0,0,0,0,0
"New Zealand","2024-01-04",0,0,0,0,0,0,0,0
"New Zealand","2024-01-05",0,0,0,0,0,0,0,0
"New Zealand","2024-01-06",0,0,0,0,0,0,0,0
"New Zealand","2024-01-07",0,0,0,0,0,0,0,0
"New Zealand","2024-01-08",0,0,0,0,0,0,0,0
"New Zealand","2024-01-09",0,0,0,0,0,0,0,0
"New Zealand","2024-01-10",0,0,0,0,0,0,0,0
"New Zealand","2024-01-11",0,0,0,0,0,0,0,0
"New Zealand","2024-01-12",0,0,0,0,0,0,0,0
"New Zealand","2024-01-13",0,0,0,0,0,0,0,0
"New Zealand","2024-01-14",0,0,0,0,0,0,0,0
"New Zealand","2024-01-15",0,0,0,0,0,0,0,0
"New Zealand","2024-01-16",0,8,8,0,8,8,0,0
"New Zealand","2024-01-17",0,0,8,0,0,8,0,0
"New Zealand","2024-01-18",0,0,8,0,0,8,0,0
"New Zealand","2024-01-19",0,0,8,0,0,8,0,0
"New Zealand","2024-01-20",0,0,8,0,0,8,0,0
"New Zealand","2024-01-21",0,0,8,0,0,8,0,0
"New Zealand","2024-01-22",0,0,8,0,0,8,0,0
"New Zealand","2024-01-23",0,0,8,0,0,8,0,0
"New Zealand","2024-01-24",0,0,8,0,0,8,0,0
"New Zealand","2024-01-25",0,0,8,0,0,8,0,0
"New Zealand","2024-01-26",0,0,8,0,0,8,0,0
"New Zealand","2024-01-27",0,0,8,0,0,8,0,0
"New Zealand","2024-01-28",0,0,8,0,0,8,0,0
"New Zealand","2024-01-29",0,0,8,0,0,8,0,0
"New Zealand","2024-01-30",0,0,8,0,0,8,0,0
"New Zealand","2024-01-31",0,0,8,0,0,8,0,0
"New Zealand","2024-02-01",0,0,8,0,0,8,0,0
"New Zealand","2024-02-02",0,0,8,0,0,8,0,0
"New Zealand","2024-02-03",0,0,8,0,0,8,0,0
"New Zealand","2024-02-04",0,0,8,0,0,8,0,0
"New Zealand","2024-02-05",0,0,8,0,0,8,0,0
"New Zealand","2024-02-06",0,0,8,0,0,8,0,0
"New Zealand","2024-02-07",0,0,8,0,0,8,0,0
"New Zealand","2024-02-08",0,0,8,0,0,8,0,0
"New Zealand","2024-02-09",0,0,8,0,0,8,0,0
"New Zealand","2024-02-10",0,0,8,0,0,8,0,0
"New Zealand","2024-02-11",0,0,8,0,0,8,0,0
"New Zealand","2024-02-12",0,0,8,0,0,8,0,0
"New Zealand","2024-02-13",0,0,8,0,0,8,0,0
"New Zealand","2024-02-14",0,0,8,0,0,8,0,0
"New Zealand","2024-02-15",0,0,8,0,0,8,0,0
"New Zealand","2024-02-16",0,0,8,0,0,8,0,0
"New Zealand","2024-02-17",0,0,8,0,0,8,0,0
"New Zealand","2024-02-18",0,0,8,0,0,8,0,0
"New Zealand","2024-02-19",0,0,8,0,0,8,0,0
"New Zealand","2024-02-20",0,0,8,0,0,8,0,0
"New Zealand","2024-02-21",0,0,8,0,0,8,0,0
"New Zealand","2024-02-22",0,0,8,0,0,8,0,0
"New Zealand","2024-02-23",0,0,8,0,0,8,0,0
"New Zealand","2024-02-24",0,0,8,0,0,8,0,0
"New Zealand","2024-02-25",0,0,8,0,0,8,0,0
"New Zealand","2024-02-26",0,0,8,0,0,8,0,0
"New Zealand","2024-02-27",0,0,8,0,0,8,0,0
"New Zealand","2024-02-28",0,0,8,0,0,8,0,0
"New Zealand","2024-02-29",0,0,8,0,0,8,0,0
"New Zealand","2024-03-01",0,0,8,0,0,8,0,0
"New Zealand","2024-03-02",0,0,8,0,0,8,0,0
"New Zealand","2024-03-03",0,0,8,0,0,8,0,0
"New Zealand","2024-03-04",0,0,8,0,0,8,0,0
"New Zealand","2024-03-05",0,0,8,0,0,8,0,0
"New Zealand","2024-03-06",0,0,8,0,0,8,0,0
"New Zealand","2024-03-07",0,0,8,0,0,8,0,0
"New Zealand","2024-03-08",0,0,8,0,0,8,0,0
"New Zealand","2024-03-09",0,0,8,0,0,8,0,0
"New Zealand","2024-03-10",0,0,8,0,0,8,0,0
"New Zealand","2024-03-11",0,0,8,0,0,8,0,0
"New Zealand","2024-03-12",0,0,8,0,0,8,0,0
"New Zealand","2024-03-13",0,0,8,0,0,8,0,0
"New Zealand","2024-03-14",0,0,8,0,1,9,0,0
"New Zealand","2024-03-15",0,0,8,0,0,9,0,0
"New Zealand","2024-03-16",0,0,8,0,0,9,0,0
"New Zealand","2024-03-17",0,0,8,0,0,9,0,0
"New Zealand","2024-03-18",0,0,8,0,0,9,0,0
"New Zealand","2024-03-19",0,0,8,0,0,9,0,0
"New Zealand","2024-03-20",0,0,8,0,0,9,0,0
"New Zealand","2024-03-21",0,0,8,0,0,9,0,0
"New Zealand","2024-03-22",0,0,8,0,0,9,0,0
"New Zealand","2024-03-23",0,0,8,0,0,9,0,0
"New Zealand","2024-03-24",0,0,8,0,0,9,0,0
"New Zealand","2024-03-25",0,0,8,0,0,9,0,0
"New Zealand","2024-03-26",0,0,8,0,0,9,0,0
"New Zealand","2024-03-27",0,0,8,0,0,9,0,0
"New Zealand","2024-03-28",0,0,8,0,0,9,0,0
"New Zealand","2024-03-29",0,0,8,0,0,9,0,0
"New Zealand","2024-03-30",0,0,8,0,0,9,0,0
"New Zealand","2024-03-31",0,0,8,0,0,9,0,0
"New Zealand","2024-04-01",0,0,8,0,0,9,0,0
"New Zealand","2024-04-02",0,0,8,0,0,9,0,0
"New Zealand","2024-04-03",0,0,8,0,0,9,0,0
"New Zealand","2024-04-04",0,0,8,0,0,9,0,0
"New Zealand","2024-04-05",0,0,8,0,0,9,0,0
"New Zealand","2024-04-06",0,0,8,0,0,9,0,0
"New Zealand","2024-04-07",0,0,8,0,0,9,0,0
"New Zealand","2024-04-08",0,0,8,0,0,9,0,0
"New Zealand","2024-04-09",0,0,8,0,0,9,0,0
"New Zealand","2024-04-10",0,0,8,0,0,9,0,0
"New Zealand","2024-04-11",0,0,8,0,0,9,0,0
"New Zealand","2024-04-12",0,0,8,0,0,9,0,0
"New Zealand","2024-04-13",0,0,8,0,0,9,0,0
"New Zealand","2024-04-14",0,0,8,0,0,9,0,0
"New Zealand","2024-04-15",0,0,8,0,0,9,0,0
"New Zealand","2024-04-16",0,0,8,0,0,9,0,0
"New Zealand","2024-04-17",0,0,8,0,0,9,0,0
"New Zealand","2024-04-18",0,0,8,0,0,9,0,0
"New Zealand","2024-04-19",0,0,8,0,0,9,0,0
"New Zealand","2024-04-20",0,0,8,0,0,9,0,0
"New Zealand","2024-04-21",0,0,8,0,0,9,0,0
"New Zealand","2024-04-22",0,0,8,0,0,9,0,0
"New Zealand","2024-04-23",0,0,8,0,0,9,0,0
"New Zealand","2024-04-24",0,0,8,0,0,9,0,0
"New Zealand","2024-04-25",0,0,8,0,0,9,0,0
"New Zealand","2024-04-26",0,0,8,0,0,9,0,0
"New Zealand","2024-04-27",0,0,8,0,0,9,0,0
"New Zealand","2024-04-28",0,0,8,0,0,9,0,0
"New Zealand","2024-04-29",0,0,8,0,0,9,0,0
"New Zealand","2024-04-30",0,0,8,0,0,9,0,0
"New Zealand","2024-05-01",0,0,8,0,0,9,0,0
"New Zealand","2024-05-02",0,0,8,0,0,9,0,0
"New Zealand","2024-05-03",0,0,8,0,0,9,0,0
"New Zealand","2024-05-04",0,0,8,0,0,9,0,0
"New Zealand","2024-05-05",0,0,8,0,0,9,0,0
"New Zealand","2024-05-06",0,0,8,0,0,9,0,0
"New Zealand","2024-05-07",0,0,8,0,0,9,0,0
"New Zealand","2024-05-08",0,0,8,0,0,9,0,0
"New Zealand","2024-05-09",0,1,9,0,0,9,0,0
"New Zealand","2024-05-10",0,0,9,0,0,9,0,0
"New Zealand","2024-05-11",0,0,9,0,0,9,0,0
"New Zealand","2024-05-12",0,0,9,0,0,9,0,0
"New Zealand","2024-05-13",0,0,9,0,0,9,0,0
"New Zealand","2024-05-14",0,0,9,0,0,9,0,0
"New Zealand","2024-05-15",0,0,9,0,0,9,0,0
"New Zealand","2024-05-16",0,0,9,0,0,9,0,0
"New Zealand","2024-05-17",0,0,9,0,0,9,0,0
"New Zealand","2024-05-18",0,0,9,0,0,9,0,0
"New Zealand","2024-05-19",0,0,9,0,0,9,0,0
"New Zealand","2024-05-20",0,0,9,0,0,9,0,0
"New Zealand","2024-05-21",0,0,9,0,0,9,0,0
"New Zealand","2024-05-22",0,0,9,0,0,9,0,0
"New Zealand","2024-05-23",0,0,9,0,1,10,0,0
"New Zealand","2024-05-24",0,0,9,0,0,10,0,0
"New Zealand","2024-05-25",0,0,9,0,0,10,0,0
"New Zealand","2024-05-26",0,0,9,0,0,10,0,0
"New Zealand","2024-05-27",0,0,9,0,0,10,0,0
"New Zealand","2024-05-28",0,0,9,0,0,10,0,0
"New Zealand","2024-05-29",0,0,9,0,0,10,0,0
"New Zealand","2024-05-30",0,0,9,0,0,10,0,0
"New Zealand","2024-05-31",0,0,9,0,0,10,0,0
"New Zealand","2024-06-01",0,0,9,0,0,10,0,0
"New Zealand","2024-06-02",0,0,9,0,0,10,0,0
"New Zealand","2024-06-03",0,0,9,0,0,10,0,0
"New Zealand","2024-06-04",0,0,9,0,0,10,0,0
"New Zealand","2024-06-05",0,0,9,0,0,10,0,0
"New Zealand","2024-06-06",0,0,9,0,0,10,0,0
"New Zealand","2024-06-07",0,0,9,0,0,10,0,0
"New Zealand","2024-06-08",0,0,9,0,0,10,0,0
"New Zealand","2024-06-09",0,0,9,0,0,10,0,0
"New Zealand","2024-06-10",0,0,9,0,0,10,0,0
"New Zealand","2024-06-11",0,0,9,0,0,10,0,0
"New Zealand","2024-06-12",0,0,9,0,0,10,0,0
"New Zealand","2024-06-13",0,0,9,0,0,10,0,0
"New Zealand","2024-06-14",0,0,9,0,0,10,0,0
"New Zealand","2024-06-15",0,0,9,0,0,10,0,0
"New Zealand","2024-06-16",0,0,9,0,0,10,0,0
"New Zealand","2024-06-17",0,0,9,0,0,10,0,0
"New Zealand","2024-06-18",0,0,9,0,1,11,0,0
"New Zealand","2024-06-19",0,0,9,0,0,11,0,0
"New Zealand","2024-06-20",0,0,9,0,0,11,0,0
"New Zealand","2024-06-21",0,0,9,0,0,11,0,0
"New Zealand","2024-06-22",0,0,9,0,0,11,0,0
"New Zealand","2024-06-23",0,0,9,0,0,11,0,0
"New Zealand","2024-06-24",0,0,9,0,0,11,0,0
"New Zealand","2024-06-25",0,0,9,0,0,11,0,0
"New Zealand","2024-06-26",0,0,9,0,0,11,0,0
"New Zealand","2024-06-27",0,0,9,0,0,11,0,0
"New Zealand","2024-06-28",0,0,9,0,0,11,0,0
"New Zealand","2024-06-29",0,0,9,0,0,11,0,0
"New Zealand","2024-06-30",0,0,9,0,0,11,0,0
"New Zealand","2024-07-01",0,2,11,0,0,11,0,0
"New Zealand","2024-07-02",0,0,11,0,0,11,0,0
"New Zealand","2024-07-03",0,0,11,0,0,11,0,0
"New Zealand","2024-07-04",0,0,11,0,0,11,0,0
"New Zealand","2024-07-05",0,0,11,0,0,11,0,0
"New Zealand","2024-07-06",0,0,11,0,1,12,0,0
"New Zealand","2024-07-07",0,0,11,0,0,12,0,0
"New Zealand","2024-07-08",0,0,11,0,0,12,0,0
"New Zealand","2024-07-09",0,0,11,0,0,12,0,0
"New Zealand","2024-07-10",0,0,11,0,0,12,0,0
"New Zealand","2024-07-11",0,0,11,0,0,12,0,0
"New Zealand","2024-07-12",0,0,11,0,0,12,0,0
"New Zealand","2024-07-13",0,0,11,0,0,12,0,0
"New Zealand","2024-07-14",0,0,11,0,0,12,0,0
"New Zealand","2024-07-15",0,0,11,0,1,13,0,0
"New Zealand","2024-07-16",0,0,11,0,0,13,0,0
"New Zealand","2024-07-17",0,0,11,0,0,13,0,0
"New Zealand","2024-07-18",0,0,11,0,0,13,0,0
"New Zealand","2024-07-19",0,0,11,0,0,13,0,0
"New Zealand","2024-07-20",0,0,11,0,0,13,0,0
"New Zealand","2024-07-21",0,0,11,0,0,13,0,0
"New Zealand","2024-07-22",0,0,11,0,0,13,0,0
"New Zealand","2024-07-23",0,0,11,0,0,13,0,0
"New Zealand","2024-07-24",0,0,11,0,1,14,0,0
"New Zealand","2024-07-25",0,0,11,0,0,14,0,0
"New Zealand","2024-07-26",0,0,11,0,0,14,0,0
"New Zealand","2024-07-27",0,0,11,0,0,14,0,0
"New Zealand","2024-07-28",0,0,11,0,0,14,0,0
"New Zealand","2024-07-29",0,0,11,0,0,14,0,0
"New Zealand","2024-07-30",0,0,11,0,0,14,0,0
"New Zealand","2024-07-31",0,0,11,0,0,14,0,0
"New Zealand","2024-08-01",0,0,11,0,1,15,0,0
"New Zealand","2024-08-02",0,0,11,0,0,15,0,0
"New Zealand","2024-08-03",0,0,11,0,0,15,0,0
"New Zealand","2024-08-04",0,0,11,0,0,15,0,0
"New Zealand","2024-08-05",0,0,11,0,0,15,0,0
"New Zealand","2024-08-06",0,0,11,0,0,15,0,0
"New Zealand","2024-08-07",0,0,11,0,0,15,0,0
"New Zealand","2024-08-08",0,0,11,0,0,15,0,0
"New Zealand","2024-08-09",0,0,11,0,0,15,0,0
"New Zealand","2024-08-10",0,0,11,0,1,16,0,0
"New Zealand","2024-08-11",0,0,11,0,0,16,0,0
"New Zealand","2024-08-12",0,0,11,0,0,16,0,0
"New Zealand","2024-08-13",0,0,11,0,0,16,0,0
"New Zealand","2024-08-14",0,0,11,0,0,16,0,0
"New Zealand","2024-08-15",0,0,11,0,0,16,0,0
"New Zealand","2024-08-16",0,0,11,0,0,16,0,0
"New Zealand","2024-08-17",0,0,11,0,0,16,0,0
"New Zealand","2024-08-18",0,0,11,0,0,16,0,0
"New Zealand","2024-08-19",0,0,11,0,1,17,0,0
"New Zealand","2024-08-20",0,0,11,0,0,17,0,0
"New Zealand","2024-08-21",0,0,11,0,0,17,0,0
"New Zealand","2024-08-22",0,0,11,0,0,17,0,0
"New Zealand","2024-08-23",0,0,11,0,0,17,0,0
"New Zealand","2024-08-24",0,0,11,0,0,17,0,0
"New Zealand","2024-08-25",0,0,11,0,0,17,0,0
"New Zealand","2024-08-26",0,0,11,0,0,17,0,0
"New Zealand","2024-08-27",0,0,11,0,0,17,0,0
"New Zealand","2024-08-28",0,0,11,0,1,18,0,0
"New Zealand","2024-08-29",0,0,11,0,0,18,0,0
"New Zealand","2024-08-30",0,0,11,0,0,18,0,0
"New Zealand","2024-08-31",0,0,11,0,0,18,0,0
"New Zealand","2024-09-01",0,0,11,0,0,18,0,0
"New Zealand","2024-09-02",0,0,11,0,0,18,0,0
"New Zealand","2024-09-03",0,0,11,0,0,18,0,0
"New Zealand","2024-09-04",0,0,11,0,0,18,0,0
"New Zealand","2024-09-05",0,0,11,0,0,18,0,0
"New Zealand","2024-09-06",0,0,11,0,1,19,0,0
"New Zealand","2024-09-07",0,0,11,0,0,19,0,0
"New Zealand","2024-09-08",0,0,11,0,0,19,0,0
"New Zealand","2024-09-09",0,0,11,0,0,19,0,0
"New Zealand","2024-09-10",0,0,11,0,0,19,0,0
"New Zealand","2024-09-11",0,0,11,0,0,19,0,0
"New Zealand","2024-09-12",0,0,11,0,0,19,0,0
"New Zealand","2024-09-13",0,0,11,0,0,19,0,0
"New Zealand","2024-09-14",0,0,11,0,0,19,0,0
"New Zealand","2024-09-15",0,0,11,0,1,20,0,0
"New Zealand","2024-09-16",0,0,11,0,0,20,0,0
"New Zealand","2024-09-17",0,0,11,0,0,20,0,0
"New Zealand","2024-09-18",0,0,11,0,0,20,0,0
"New Zealand","2024-09-19",0,0,11,0,0,20,0,0
"New Zealand","2024-09-20",0,0,11,0,0,20,0,0
"New Zealand","2024-09-21",0,0,11,0,0,20,0,0
"New Zealand","2024-09-22",0,0,11,0,0,20,0,0
"New Zealand","2024-09-23",0,0,11,0,1,21,0,0
"New Zealand","2024-09-24",0,0,11,0,0,21,0,0
"New Zealand","2024-09-25",0,0,11,0,0,21,0,0
"New Zealand","2024-09-26",0,0,11,0,0,21,0,0
"New Zealand","2024-09-27",0,0,11,0,0,21,0,0
"New Zealand","2024-09-28",0,0,11,0,0,21,0,0
"New Zealand","2024-09-29",0,0,11,0,0,21,0,0
"New Zealand","2024-09-30",0,0,11,0,0,21,0,0
"New Zealand","2024-10-01",0,0,11,0,0,21,0,0
"New Zealand","2024-10-02",0,0,11,0,1,22,0,0
"New Zealand","2024-10-03",0,0,11,0,0,22,0,0
"New Zealand","2024-10-04",0,0,11,0,0,22,0,0
"New Zealand","2024-10-05",0,0,11,0,0,22,0,0
"New Zealand","2024-10-06",0,0,11,0,0,22,0,0
"New Zealand","2024-10-07",0,0,11,0,0,22,0,0
"New Zealand","2024-10-08",0,0,11,0,0,22,0,0
"New Zealand","2024-10-09",0,0,11,0,0,22,0,0
"New Zealand","2024-10-10",0,0,11,0,0,22,0,0
"New Zealand","2024-10-11",0,0,11,0,1,23,0,0
"New Zealand","2024-10-12",0,0,11,0,0,23,0,0
"New Zealand","2024-10-13",0,0,11,0,0,23,0,0
"New Zealand","2024-10-14",0,0,11,0,0,23,0,0
"New Zealand","2024-10-15",0,12,23,0,0,23,0,0
"New Zealand","2024-10-16",0,0,23,0,0,23,0,0
"New Zealand","2024-10-17",0,0,23,0,0,23,0,0
"New Zealand","2024-10-18",0,0,23,0,0,23,0,0
"New Zealand","2024-10-19",0,0,23,0,0,23,0,0
"New Zealand","2024-10-20",0,0,23,0,0,23,0,0
"New Zealand","2024-10-21",0,0,23,0,0,23,0,0
"New Zealand","2024-10-22",0,0,23,0,0,23,0,0
"New Zealand","2024-10-23",0,0,23,0,0,23,0,0
"New Zealand","2024-10-24",0,0,23,0,0,23,0,0
"New Zealand","2024-10-25",0,0,23,0,0,23,0,0
"New Zealand","2024-10-26",0,0,23,0,1,24,0,0
"New Zealand","2024-10-27",0,0,23,0,0,24,0,0
"New Zealand","2024-10-28",0,0,23,0,0,24,0,0
"New Zealand","2024-10-29",0,0,23,0,0,24,0,0
"New Zealand","2024-10-30",0,0,23,0,0,24,0,0
"New Zealand","2024-10-31",0,0,23,0,0,24,0,0
"New Zealand","2024-11-01",0,0,23,0,0,24,0,0
"New Zealand","2024-11-02",0,0,23,0,0,24,0,0
"New Zealand","2024-11-03",0,0,23,0,0,24,0,0
"New Zealand","2024-11-04",0,1,24,0,0,24,0,0
"New Zealand","2024-11-05",0,0,24,0,0,24,0,0
"New Zealand","2024-11-06",0,0,24,0,0,24,0,0
"New Zealand","2024-11-07",0,0,24,0,0,24,0,0
"New Zealand","2024-11-08",0,0,24,0,0,24,0,0
"New Zealand","2024-11-09",0,0,24,0,0,24,0,0
"New Zealand","2024-11-10",0,0,24,0,0,24,0,0
"New Zealand","2024-11-11",0,0,24,0,0,24,0,0
"New Zealand","2024-11-12",0,0,24,0,0,24,0,0
"New Zealand","2024-11-13",0,0,24,0,0,24,0,0
"New Zealand","2024-11-14",0,0,24,0,0,24,0,0
"New Zealand","2024-11-15",0,0,24,0,0,24,0,0
"New Zealand","2024-11-16",0,0,24,0,0,24,0,0
"New Zealand","2024-11-17",0,0,24,0,0,24,0,0
"New Zealand","2024-11-18",0,0,24,0,0,24,0,0
"New Zealand","2024-11-19",0,0,24,0,0,24,0,0
"New Zealand","2024-11-20",0,0,24,0,0,24,0,0
"New Zealand","2024-11-21",0,0,24,0,0,24,0,0
"New Zealand","2024-11-22",0,0,24,0,0,24,0,0
"New Zealand","2024-11-23",0,0,24,0,0,24,0,0
"New Zealand","2024-11-24",0,0,24,0,0,24,0,0
"New Zealand","2024-11-25",0,0,24,0,0,24,0,0
"New Zealand","2024-11-26",0,0,24,0,0,24,0,0
"New Zealand","2024-11-27",0,0,24,0,0,24,0,0
"New Zealand","2024-11-28",0,0,24,0,0,24,0,0
"New Zealand","2024-11-29",0,0,24,0,0,24,0,0
"New Zealand","2024-11-30",0,0,24,0,0,24,0,0
"New Zealand","2024-12-01",0,0,24,0,0,24,0,0
"New Zealand","2024-12-02",0,0,24,0,0,24,0,0
"New Zealand","2024-12-03",0,0,24,0,0,24,0,0
"New Zealand","2024-12-04",0,0,24,0,0,24,0,0
"New Zealand","2024-12-05",0,0,24,0,0,24,0,0
"New Zealand","2024-12-06",0,0,24,0,0,24,0,0
"New Zealand","2024-12-07",0,0,24,0,0,24,0,0
"New Zealand","2024-12-08",0,0,24,0,0,24,0,0
"New Zealand","2024-12-09",0,0,24,0,0,24,0,0
"Nigeria","2024-01-01",0,0,0,0,0,0,0,0
"Nigeria","2024-01-02",0,0,0,0,0,0,0,0
"Nigeria","2024-01-03",0,0,0,0,0,0,0,0
"Nigeria","2024-01-04",0,0,0,0,0,0,0,0
"Nigeria","2024-01-05",0,0,0,0,0,0,0,0
"Nigeria","2024-01-06",0,0,0,0,0,0,0,0
"Nigeria","2024-01-07",0,0,0,0,0,0,0,0
"Nigeria","2024-01-08",0,0,0,0,0,0,0,0
"Nigeria","2024-01-09",0,0,0,0,0,0,0,0
"Nigeria","2024-01-10",0,0,0,0,0,0,0,0
"Nigeria","2024-01-11",0,0,0,0,0,0,0,0
"Nigeria","2024-01-12",0,0,0,0,0,0,0,0
"Nigeria","2024-01-13",0,0,0,0,0,0,0,0
"Nigeria","2024-01-14",0,0,0,0,0,0,0,0
"Nigeria","2024-01-15",0,0,0,0,0,0,0,0
"Nigeria","2024-01-16",0,0,0,0,0,0,0,0
"Nigeria","2024-01-17",0,0,0,0,0,0,0,0
"Nigeria","2024-01-18",0,0,0,0,0,0,0,0
"Nigeria","2024-01-19",0,0,0,0,0,0,0,0
"Nigeria","2024-01-20",0,0,0,0,0,0,0,0
"Nigeria","2024-01-21",0,0,0,0,0,0,0,0
"Nigeria","2024-01-22",0,0,0,0,0,0,0,0
"Nigeria","2024-01-23",0,0,0,0,0,0,0,0
"Nigeria","2024-01-24",0,0,0,0,0,0,0,0
"Nigeria","2024-01-25",0,0,0,0,0,0,0,0
"Nigeria","2024-01-26",0,0,0,0,0,0,0,0
"Nigeria","2024-01-27",0,0,0,0,0,0,0,0
"Nigeria","2024-01-28",0,2,2,0,2,2,0,0
"Nigeria","2024-01-29",0,0,2,0,0,2,0,0
"Nigeria","2024-01-30",0,0,2,0,0,2,0,0
"Nigeria","2024-01-31",0,0,2,0,0,2,0,0
"Nigeria","2024-02-01",0,0,2,0,1,3,0,0
"Nigeria","2024-02-02",0,0,2,0,0,3,0,0
"Nigeria","2024-02-03",0,0,2,0,0,3,0,0
"Nigeria","2024-02-04",0,0,2,0,0,3,0,0
"Nigeria","2024-02-05",0,0,2,0,0,3,0,0
"Nigeria","2024-02-06",0,0,2,0,0,3,0,0
"Nigeria","2024-02-07",0,0,2,0,0,3,0,0
"Nigeria","2024-02-08",0,0,2,0,1,4,0,0
"Nigeria","2024-02-09",0,0,2,0,0,4,0,0
"Nigeria","2024-02-10",0,0,2,0,0,4,0,0
"Nigeria","2024-02-11",0,2,4,0,0,4,0,0
"Nigeria","2024-02-12",0,0,4,0,0,4,0,0
"Nigeria","2024-02-13",0,0,4,0,1,5,0,0
"Nigeria","2024-02-14",0,0,4,0,0,5,0,0
"Nigeria","2024-02-15",0,0,4,0,0,5,0,0
"Nigeria","2024-02-16",0,0,4,0,0,5,0,0
"Nigeria","2024-02-17",0,0,4,0,1,6,0,0
"Nigeria","2024-02-18",0,2,6,0,0,6,0,0
"Nigeria","2024-02-19",0,0,6,0,0,6,0,0
"Nigeria","2024-02-20",0,0,6,0,0,6,0,0
"Nigeria","2024-02-21",0,0,6,0,1,7,0,0
"Nigeria","2024-02-22",0,0,6,0,0,7,0,0
"Nigeria","2024-02-23",0,0,6,0,0,7,0,0
"Nigeria","2024-02-24",0,0,6,0,0,7,0,0
"Nigeria","2024-02-25",0,0,6,0,0,7,0,0
"Nigeria","2024-02-26",0,0,6,0,1,8,0,0
"Nigeria","2024-02-27",0,0,6,0,0,8,0,0
"Nigeria","2024-02-28",0,0,6,0,0,8,0,0
"Nigeria","2024-02-29",0,0,6,0,0,8,0,0
"Nigeria","2024-03-01",0,0,6,0,0,8,0,0
"Nigeria","2024-03-02",0,0,6,0,0,8,0,0
"Nigeria","2024-03-03",0,0,6,0,1,9,0,0
"Nigeria","2024-03-04",0,0,6,0,0,9,0,0
"Nigeria","2024-03-05",0,0,6,0,0,9,0,0
"Nigeria","2024-03-06",0,0,6,0,0,9,0,0
"Nigeria","2024-03-07",0,0,6,0,0,9,0,0
"Nigeria","2024-03-08",0,0,6,0,1,10,0,0
"Nigeria","2024-03-09",0,0,6,0,0,10,0,0
"Nigeria","2024-03-10",0,4,10,0,0,10,0,0
"Nigeria","2024-03-11",0,0,10,0,0,10,0,0
"Nigeria","2024-03-12",0,0,10,0,1,11,0,0
"Nigeria","2024-03-13",0,0,10,0,0,11,0,0
"Nigeria","2024-03-14",0,0,10,0,0,11,0,0
"Nigeria","2024-03-15",0,0,10,0,0,11,0,0
"Nigeria","2024-03-16",0,0,10,0,1,12,0,0
"Nigeria","2024-03-17",0,2,12,0,0,12,0,0
"Nigeria","2024-03-18",0,0,12,0,0,12,0,0
"Nigeria","2024-03-19",0,0,12,0,1,13,0,0
"Nigeria","2024-03-20",0,0,12,0,0,13,0,0
"Nigeria","2024-03-21",0,0,12,0,1,14,0,0
"Nigeria","2024-03-22",0,0,12,0,0,14,0,0
"Nigeria","2024-03-23",0,0,12,0,1,15,0,0
"Nigeria","2024-03-24",0,0,12,0,0,15,0,0
"Nigeria","2024-03-25",0,0,12,0,0,15,0,0
"Nigeria","2024-03-26",0,0,12,0,1,16,0,0
"Nigeria","2024-03-27",0,0,12,0,0,16,0,0
"Nigeria","2024-03-28",0,0,12,0,1,17,0,0
"Nigeria","2024-03-29",0,0,12,0,0,17,0,0
"Nigeria","2024-03-30",0,0,12,0,1,18,0,0
"Nigeria","2024-03-31",0,6,18,0,0,18,0,0
"Nigeria","2024-04-01",0,0,18,0,0,18,0,0
"Nigeria","2024-04-02",0,0,18,0,0,18,0,0
"Nigeria","2024-04-03",0,0,18,0,0,18,0,0
"Nigeria","2024-04-04",0,0,18,0,1,19,0,0
"Nigeria","2024-04-05",0,0,18,0,0,19,0,0
"Nigeria","2024-04-06",0,0,18,0,0,19,0,0
"Nigeria","2024-04-07",0,1,19,0,0,19,0,0
"Nigeria","2024-04-08",0,0,19,0,0,19,0,0
"Nigeria","2024-04-09",0,0,19,0,0,19,0,0
"Nigeria","2024-04-10",0,0,19,0,0,19,0,0
"Nigeria","2024-04-11",0,0,19,0,1,20,0,0
"Nigeria","2024-04-12",0,0,19,0,0,20,0,0
"Nigeria","2024-04-13",0,0,19,0,0,20,0,0
"Nigeria","2024-04-14",0,1,20,0,0,20,0,0
"Nigeria","2024-04-15",0,0,20,0,0,20,0,0
"Nigeria","2024-04-16",0,0,20,0,0,20,0,0
"Nigeria","2024-04-17",0,0,20,0,0,20,0,0
"Nigeria","2024-04-18",0,0,20,0,1,21,0,0
"Nigeria","2024-04-19",0,0,20,0,0,21,0,0
"Nigeria","2024-04-20",0,0,20,0,0,21,0,0
"Nigeria","2024-04-21",0,0,20,0,0,21,0,0
"Nigeria","2024-04-22",0,0,20,0,0,21,0,0
"Nigeria","2024-04-23",0,0,20,0,0,21,0,0
"Nigeria","2024-04-24",0,0,20,0,0,21,0,0
"Nigeria","2024-04-25",0,0,20,0,1,22,0,0
"Nigeria","2024-04-26",0,0,20,0,0,22,0,0
"Nigeria","2024-04-27",0,0,20,0,0,22,0,0
"Nigeria","2024-04-28",0,2,22,0,0,22,0,0
"Nigeria","2024-04-29",0,0,22,0,0,22,0,0
"Nigeria","2024-04-30",0,0,22,0,1,23,0,0
"Nigeria","2024-05-01",0,0,22,0,0,23,0,0
"Nigeria","2024-05-02",0,0,22,0,0,23,0,0
"Nigeria","2024-05-03",0,0,22,0,0,23,0,0
"Nigeria","2024-05-04",0,0,22,0,1,24,0,0
"Nigeria","2024-05-05",0,2,24,0,0,24,0,0
"Nigeria","2024-05-06",0,0,24,0,0,24,0,0
"Nigeria","2024-05-07",0,0,24,0,0,24,0,0
"Nigeria","2024-05-08",0,0,24,0,0,24,0,0
"Nigeria","2024-05-09",0,0,24,0,0,24,0,0
"Nigeria","2024-05-10",0,0,24,0,0,24,0,0
"Nigeria","2024-05-11",0,0,24,0,1,25,0,0
"Nigeria","2024-05-12",0,0,24,0,0,25,0,0
"Nigeria","2024-05-13",0,0,24,0,0,25,0,0
"Nigeria","2024-05-14",0,0,24,0,0,25,0,0
"Nigeria","2024-05-15",0,0,24,0,0,25,0,0
"Nigeria","2024-05-16",0,0,24,0,0,25,0,0
"Nigeria","2024-05-17",0,0,24,0,0,25,0,0
"Nigeria","2024-05-18",0,0,24,0,0,25,0,0
"Nigeria","2024-05-19",0,0,24,0,0,25,0,0
"Nigeria","2024-05-20",0,0,24,0,0,25,0,0
"Nigeria","2024-05-21",0,0,24,0,1,26,0,0
"Nigeria","2024-05-22",0,0,24,0,0,26,0,0
"Nigeria","2024-05-23",0,0,24,0,0,26,0,0
"Nigeria","2024-05-24",0,0,24,0,0,26,0,0
"Nigeria","2024-05-25",0,0,24,0,0,26,0,0
"Nigeria","2024-05-26",0,2,26,0,0,26,0,0
"Nigeria","2024-05-27",0,0,26,0,0,26,0,0
"Nigeria","2024-05-28",0,0,26,0,0,26,0,0
"Nigeria","2024-05-29",0,0,26,0,0,26,0,0
"Nigeria","2024-05-30",0,0,26,0,1,27,0,0
"Nigeria","2024-05-31",0,0,26,0,0,27,0,0
"Nigeria","2024-06-01",0,0,26,0,0,27,0,0
"Nigeria","2024-06-02",0,1,27,0,0,27,0,0
"Nigeria","2024-06-03",0,0,27,0,0,27,0,0
"Nigeria","2024-06-04",0,0,27,0,0,27,0,0
"Nigeria","2024-06-05",0,0,27,0,0,27,0,0
"Nigeria","2024-06-06",0,0,27,0,1,28,0,0
"Nigeria","2024-06-07",0,0,27,0,0,28,0,0
"Nigeria","2024-06-08",0,0,27,0,0,28,0,0
"Nigeria","2024-06-09",0,1,28,0,0,28,0,0
"Nigeria","2024-06-10",0,0,28,0,0,28,0,0
"Nigeria","2024-06-11",0,0,28,0,1,29,0,0
"Nigeria","2024-06-12",0,0,28,0,0,29,0,0
"Nigeria","2024-06-13",0,0,28,0,0,29,0,0
"Nigeria","2024-06-14",0,0,28,0,0,29,0,0
"Nigeria","2024-06-15",0,0,28,0,1,30,0,0
"Nigeria","2024-06-16",0,2,30,0,0,30,0,0
"Nigeria","2024-06-17",0,0,30,0,0,30,0,0
"Nigeria","2024-06-18",0,0,30,0,0,30,0,0
"Nigeria","2024-06-19",0,0,30,0,0,30,0,0
"Nigeria","2024-06-20",0,0,30,0,1,31,0,0
"Nigeria","2024-06-21",0,0,30,0,0,31,0,0
"Nigeria","2024-06-22",0,0,30,0,0,31,0,0
"Nigeria","2024-06-23",0,1,31,0,0,31,0,0
"Nigeria","2024-06-24",0,0,31,0,0,31,0,0
"Nigeria","2024-06-25",0,0,31,0,1,32,0,0
"Nigeria","2024-06-26",0,0,31,0,0,32,0,0
"Nigeria","2024-06-27",0,0,31,0,1,33,0,0
"Nigeria","2024-06-28",0,0,31,0,0,33,0,0
"Nigeria","2024-06-29",0,0,31,0,1,34,0,0
"Nigeria","2024-06-30",0,3,34,0,0,34,0,0
"Nigeria","2024-07-01",0,0,34,0,0,34,0,0
"Nigeria","2024-07-02",0,0,34,0,1,35,0,0
"Nigeria","2024-07-03",0,0,34,0,0,35,0,0
"Nigeria","2024-07-04",0,0,34,0,1,36,0,0
"Nigeria","2024-07-05",0,0,34,0,0,36,0,0
"Nigeria","2024-07-06",0,0,34,0,1,37,0,0
"Nigeria","2024-07-07",0,3,37,0,0,37,0,0
"Nigeria","2024-07-08",0,0,37,0,0,37,0,0
"Nigeria","2024-07-09",0,0,37,0,0,37,0,0
"Nigeria","2024-07-10",0,0,37,0,0,37,0,0
"Nigeria","2024-07-11",0,0,37,0,0,37,0,0
"Nigeria","2024-07-12",0,0,37,0,0,37,0,0
"Nigeria","2024-07-13",0,0,37,0,0,37,0,0
"Nigeria","2024-07-14",0,0,37,0,0,37,0,0
"Nigeria","2024-07-15",0,0,37,0,1,38,0,0
"Nigeria","2024-07-16",0,0,37,0,0,38,0,0
"Nigeria","2024-07-17",0,0,37,0,0,38,0,0
"Nigeria","2024-07-18",0,0,37,0,0,38,0,0
"Nigeria","2024-07-19",0,0,37,0,0,38,0,0
"Nigeria","2024-07-20",0,0,37,0,0,38,0,0
"Nigeria","2024-07-21",0,1,38,0,0,38,0,0
"Nigeria","2024-07-22",0,0,38,0,0,38,0,0
"Nigeria","2024-07-23",0,0,38,0,0,38,0,0
"Nigeria","2024-07-24",0,0,38,0,0,38,0,0
"Nigeria","2024-07-25",0,0,38,0,0,38,0,0
"Nigeria","2024-07-26",0,0,38,0,0,38,0,0
"Nigeria","2024-07-27",0,0,38,0,0,38,0,0
"Nigeria","2024-07-28",0,0,38,0,0,38,0,0
"Nigeria","2024-07-29",0,0,38,0,0,38,0,0
"Nigeria","2024-07-30",0,0,38,0,0,38,0,0
"Nigeria","2024-07-31",0,0,38,0,0,38,0,0
"Nigeria","2024-08-01",0,0,38,0,1,39,0,0
"Nigeria","2024-08-02",0,0,38,0,0,39,0,0
"Nigeria","2024-08-03",0,0,38,0,0,39,0,0
"Nigeria","2024-08-04",0,0,38,0,0,39,0,0
"Nigeria","2024-08-05",0,0,38,0,0,39,0,0
"Nigeria","2024-08-06",0,0,38,0,0,39,0,0
"Nigeria","2024-08-07",0,0,38,0,0,39,0,0
"Nigeria","2024-08-08",0,0,38,0,0,39,0,0
"Nigeria","2024-08-09",0,0,38,0,0,39,0,0
"Nigeria","2024-08-10",0,0,38,0,0,39,0,0
"Nigeria","2024-08-11",0,1,39,0,0,39,0,0
"Nigeria","2024-08-12",0,0,39,0,0,39,0,0
"Nigeria","2024-08-13",0,0,39,0,0,39,0,0
"Nigeria","2024-08-14",0,0,39,0,0,39,0,0
"Nigeria","2024-08-15",0,0,39,0,1,40,0,0
"Nigeria","2024-08-16",0,0,39,0,0,40,0,0
"Nigeria","2024-08-17",0,0,39,0,0,40,0,0
"Nigeria","2024-08-18",802,1,40,802,0,40,802,802
"Nigeria","2024-08-19",0,0,40,802,1,41,9,811
"Nigeria","2024-08-20",0,0,40,802,2,43,10,821
"Nigeria","2024-08-21",0,0,40,802,1,44,9,830
"Nigeria","2024-08-22",0,0,40,802,2,46,9,839
"Nigeria","2024-08-23",0,0,40,802,1,47,9,848
"Nigeria","2024-08-24",0,0,40,802,2,49,10,858
"Nigeria","2024-08-25",65,10,50,867,1,50,9,867
"Nigeria","2024-08-26",0,0,50,867,1,51,8,875
"Nigeria","2024-08-27",0,0,50,867,1,52,7,882
"Nigeria","2024-08-28",0,0,50,867,1,53,8,890
"Nigeria","2024-08-29",0,0,50,867,2,55,7,897
"Nigeria","2024-08-30",0,0,50,867,1,56,8,905
"Nigeria","2024-08-31",0,0,50,867,1,57,7,912
"Nigeria","2024-09-01",53,8,58,920,1,58,8,920
"Nigeria","2024-09-02",0,0,58,920,1,59,10,930
"Nigeria","2024-09-03",0,0,58,920,2,61,11,941
"Nigeria","2024-09-04",0,0,58,920,1,62,10,951
"Nigeria","2024-09-05",0,0,58,920,1,63,10,961
"Nigeria","2024-09-06",0,0,58,920,1,64,10,971
"Nigeria","2024-09-07",0,0,58,920,2,66,11,982
"Nigeria","2024-09-08",72,9,67,992,1,67,10,992
"Nigeria","2024-09-09",0,0,67,992,1,68,9,1001
"Nigeria","2024-09-10",0,0,67,992,1,69,9,1010
"Nigeria","2024-09-11",0,0,67,992,1,70,9,1019
"Nigeria","2024-09-12",0,0,67,992,0,70,9,1028
"Nigeria","2024-09-13",0,0,67,992,1,71,9,1037
"Nigeria","2024-09-14",0,0,67,992,1,72,9,1046
"Nigeria","2024-09-15",63,6,73,1055,1,73,9,1055
"Nigeria","2024-09-16",0,0,73,1055,1,74,10,1065
"Nigeria","2024-09-17",0,0,73,1055,0,74,11,1076
"Nigeria","2024-09-18",0,0,73,1055,1,75,10,1086
"Nigeria","2024-09-19",0,0,73,1055,1,76,10,1096
"Nigeria","2024-09-20",0,0,73,1055,1,77,10,1106
"Nigeria","2024-09-21",0,0,73,1055,0,77,11,1117
"Nigeria","2024-09-22",72,5,78,1127,1,78,10,1127
"Nigeria","2024-09-23",0,0,78,1127,1,79,8,1135
"Nigeria","2024-09-24",0,0,78,1127,2,81,7,1142
"Nigeria","2024-09-25",0,0,78,1127,1,82,8,1150
"Nigeria","2024-09-26",0,0,78,1127,2,84,8,1158
"Nigeria","2024-09-27",0,0,78,1127,1,85,8,1166
"Nigeria","2024-09-28",0,0,78,1127,2,87,7,1173
"Nigeria","2024-09-29",54,10,88,1181,1,88,8,1181
"Nigeria","2024-09-30",0,0,88,1181,1,89,8,1189
"Nigeria","2024-10-01",0,0,88,1181,1,90,8,1197
"Nigeria","2024-10-02",0,0,88,1181,1,91,8,1205
"Nigeria","2024-10-03",0,0,88,1181,0,91,8,1213
"Nigeria","2024-10-04",0,0,88,1181,1,92,8,1221
"Nigeria","2024-10-05",0,0,88,1181,1,93,8,1229
"Nigeria","2024-10-06",56,6,94,1237,1,94,8,1237
"Nigeria","2024-10-07",0,0,94,1237,1,95,2,1239
"Nigeria","2024-10-08",0,0,94,1237,1,96,3,1242
"Nigeria","2024-10-09",0,0,94,1237,1,97,2,1244
"Nigeria","2024-10-10",0,0,94,1237,2,99,3,1247
"Nigeria","2024-10-11",0,0,94,1237,1,100,2,1249
"Nigeria","2024-10-12",0,0,94,1237,1,101,2,1251
"Nigeria","2024-10-13",0,8,102,1237,1,102,3,1254
"Nigeria","2024-10-14",0,0,102,1237,1,103,2,1256
"Nigeria","2024-10-15",0,0,102,1237,1,104,2,1258
"Nigeria","2024-10-16",0,0,102,1237,1,105,3,1261
"Nigeria","2024-10-17",0,0,102,1237,0,105,2,1263
"Nigeria","2024-10-18",0,0,102,1237,1,106,3,1266
"Nigeria","2024-10-19",0,0,102,1237,1,107,2,1268
"Nigeria","2024-10-20",0,6,108,1237,1,108,2,1270
"Nigeria","2024-10-21",0,0,108,1237,1,109,3,1273
"Nigeria","2024-10-22",0,0,108,1237,2,111,2,1275
"Nigeria","2024-10-23",0,0,108,1237,1,112,2,1277
"Nigeria","2024-10-24",0,0,108,1237,2,114,3,1280
"Nigeria","2024-10-25",0,0,108,1237,1,115,2,1282
"Nigeria","2024-10-26",0,0,108,1237,2,117,3,1285
"Nigeria","2024-10-27",50,10,118,1287,1,118,2,1287
"Nigeria","2024-10-28",0,0,118,1287,0,118,5,1292
"Nigeria","2024-10-29",0,0,118,1287,0,118,6,1298
"Nigeria","2024-10-30",0,0,118,1287,0,118,5,1303
"Nigeria","2024-10-31",0,0,118,1287,0,118,5,1308
"Nigeria","2024-11-01",0,0,118,1287,0,118,5,1313
"Nigeria","2024-11-02",0,0,118,1287,0,118,6,1319
"Nigeria","2024-11-03",37,0,118,1324,0,118,5,1324
"Nigeria","2024-11-04",0,0,118,1324,0,118,0,1324
"Nigeria","2024-11-05",0,0,118,1324,0,118,0,1324
"Nigeria","2024-11-06",0,0,118,1324,0,118,0,1324
"Nigeria","2024-11-07",0,0,118,1324,0,118,0,1324
"Nigeria","2024-11-08",0,0,118,1324,0,118,0,1324
"Nigeria","2024-11-09",0,0,118,1324,0,118,0,1324
"Nigeria","2024-11-10",0,0,118,1324,0,118,0,1324
"Nigeria","2024-11-11",0,0,118,1324,0,118,0,1324
"Nigeria","2024-11-12",0,0,118,1324,0,118,0,1324
"Nigeria","2024-11-13",0,0,118,1324,0,118,0,1324
"Nigeria","2024-11-14",0,0,118,1324,0,118,0,1324
"Nigeria","2024-11-15",0,0,118,1324,0,118,0,1324
"Nigeria","2024-11-16",0,0,118,1324,0,118,0,1324
"Nigeria","2024-11-17",0,0,118,1324,0,118,0,1324
"Nigeria","2024-11-18",0,0,118,1324,0,118,0,1324
"Nigeria","2024-11-19",0,0,118,1324,0,118,0,1324
"Nigeria","2024-11-20",0,0,118,1324,0,118,0,1324
"Nigeria","2024-11-21",0,0,118,1324,0,118,0,1324
"Nigeria","2024-11-22",0,0,118,1324,0,118,0,1324
"Nigeria","2024-11-23",0,0,118,1324,0,118,0,1324
"Nigeria","2024-11-24",0,0,118,1324,0,118,0,1324
"Nigeria","2024-11-25",0,0,118,1324,0,118,0,1324
"Nigeria","2024-11-26",0,0,118,1324,0,118,0,1324
"Nigeria","2024-11-27",0,0,118,1324,0,118,0,1324
"Nigeria","2024-11-28",0,0,118,1324,0,118,0,1324
"Nigeria","2024-11-29",0,0,118,1324,0,118,0,1324
"Nigeria","2024-11-30",0,0,118,1324,0,118,0,1324
"Nigeria","2024-12-01",0,0,118,1324,0,118,0,1324
"Nigeria","2024-12-02",0,0,118,1324,0,118,0,1324
"Nigeria","2024-12-03",0,0,118,1324,0,118,0,1324
"Nigeria","2024-12-04",0,0,118,1324,0,118,0,1324
"Nigeria","2024-12-05",0,0,118,1324,0,118,0,1324
"Nigeria","2024-12-06",0,0,118,1324,0,118,0,1324
"Nigeria","2024-12-07",0,0,118,1324,0,118,0,1324
"Nigeria","2024-12-08",0,0,118,1324,0,118,0,1324
"Nigeria","2024-12-09",0,0,118,1324,0,118,0,1324
"North America","2024-01-01",0,0,0,0,0,0,0,0
"North America","2024-01-02",0,50,50,0,50,50,0,0
"North America","2024-01-03",0,0,50,0,8,58,0,0
"North America","2024-01-04",0,0,50,0,9,67,0,0
"North America","2024-01-05",0,0,50,0,8,75,0,0
"North America","2024-01-06",0,0,50,0,8,83,0,0
"North America","2024-01-07",0,0,50,0,8,91,0,0
"North America","2024-01-08",0,0,50,0,9,100,0,0
"North America","2024-01-09",0,58,108,0,8,108,0,0
"North America","2024-01-10",0,0,108,0,11,119,0,0
"North America","2024-01-11",0,0,108,0,10,129,0,0
"North America","2024-01-12",0,0,108,0,11,140,0,0
"North America","2024-01-13",0,0,108,0,10,150,0,0
"North America","2024-01-14",0,0,108,0,11,161,0,0
"North America","2024-01-15",0,0,108,0,10,171,0,0
"North America","2024-01-16",0,74,182,0,11,182,0,0
"North America","2024-01-17",0,0,182,0,7,189,0,0
"North America","2024-01-18",0,0,182,0,8,197,0,0
"North America","2024-01-19",0,0,182,0,7,204,0,0
"North America","2024-01-20",0,0,182,0,8,212,0,0
"North America","2024-01-21",0,0,182,0,7,219,0,0
"North America","2024-01-22",0,0,182,0,8,227,0,0
"North America","2024-01-23",0,52,234,0,7,234,0,0
"North America","2024-01-24",0,0,234,0,13,247,0,0
"North America","2024-01-25",0,0,234,0,12,259,0,0
"North America","2024-01-26",0,0,234,0,13,272,0,0
"North America","2024-01-27",0,0,234,0,13,285,0,0
"North America","2024-01-28",0,0,234,0,13,298,0,0
"North America","2024-01-29",0,0,234,0,12,310,0,0
"North America","2024-01-30",0,89,323,0,13,323,0,0
"North America","2024-01-31",0,0,323,0,10,333,0,0
"North America","2024-02-01",0,0,323,0,9,342,0,0
"North America","2024-02-02",0,0,323,0,10,352,0,0
"North America","2024-02-03",0,0,323,0,10,362,0,0
"North America","2024-02-04",0,0,323,0,10,372,0,0
"North America","2024-02-05",0,0,323,0,9,381,0,0
"North America","2024-02-06",0,68,391,0,10,391,0,0
"North America","2024-02-07",0,0,391,0,10,401,0,0
"North America","2024-02-08",0,0,391,0,9,410,0,0
"North America","2024-02-09",0,0,391,0,10,420,0,0
"North America","2024-02-10",0,0,391,0,9,429,0,0
"North America","2024-02-11",0,0,391,0,10,439,0,0
"North America","2024-02-12",0,0,391,0,9,448,0,0
"North America","2024-02-13",0,67,458,0,10,458,0,0
"North America","2024-02-14",0,0,458,0,10,468,0,0
"North America","2024-02-15",0,0,458,0,9,477,0,0
"North America","2024-02-16",0,0,458,0,10,487,0,0
"North America","2024-02-17",0,0,458,0,9,496,0,0
"North America","2024-02-18",0,0,458,0,10,506,0,0
"North America","2024-02-19",0,0,458,0,9,515,0,0
"North America","2024-02-20",0,67,525,0,10,525,0,0
"North America","2024-02-21",0,0,525,0,11,536,0,0
"North America","2024-02-22",0,0,525,0,11,547,0,0
"North America","2024-02-23",0,0,525,0,11,558,0,0
"North America","2024-02-24",0,0,525,0,11,569,0,0
"North America","2024-02-25",0,0,525,0,11,580,0,0
"North America","2024-02-26",0,0,525,0,11,591,0,0
"North America","2024-02-27",0,77,602,0,11,602,0,0
"North America","2024-02-28",0,0,602,0,11,613,0,0
"North America","2024-02-29",0,0,602,0,11,624,0,0
"North America","2024-03-01",0,0,602,0,11,635,0,0
"North America","2024-03-02",0,0,602,0,10,645,0,0
"North America","2024-03-03",0,0,602,0,11,656,0,0
"North America","2024-03-04",0,0,602,0,11,667,0,0
"North America","2024-03-05",0,76,678,0,11,678,0,0
"North America","2024-03-06",0,0,678,0,12,690,0,0
"North America","2024-03-07",0,0,678,0,11,701,0,0
"North America","2024-03-08",0,0,678,0,12,713,0,0
"North America","2024-03-09",0,0,678,0,12,725,0,0
"North America","2024-03-10",0,0,678,0,12,737,0,0
"North America","2024-03-11",0,0,678,0,11,748,0,0
"North America","2024-03-12",0,82,760,0,12,760,0,0
"North America","2024-03-13",0,0,760,0,8,768,0,0
"North America","2024-03-14",0,0,760,0,9,777,0,0
"North America","2024-03-15",0,0,760,0,8,785,0,0
"North America","2024-03-16",0,0,760,0,8,793,0,0
"North America","2024-03-17",0,0,760,0,8,801,0,0
"North America","2024-03-18",0,0,760,0,9,810,0,0
"North America","2024-03-19",0,58,818,0,8,818,0,0
"North America","2024-03-20",0,0,818,0,10,828,0,0
"North America","2024-03-21",0,0,818,0,10,838,0,0
"North America","2024-03-22",0,0,818,0,10,848,0,0
"North America","2024-03-23",0,0,818,0,9,857,0,0
"North America","2024-03-24",0,0,818,0,10,867,0,0
"North America","2024-03-25",0,0,818,0,10,877,0,0
"North America","2024-03-26",0,69,887,0,10,887,0,0
"North America","2024-03-27",0,0,887,0,7,894,0,0
"North America","2024-03-28",0,0,887,0,8,902,0,0
"North America","2024-03-29",0,0,887,0,7,909,0,0
"North America","2024-03-30",0,0,887,0,8,917,0,0
"North America","2024-03-31",0,0,887,0,7,924,0,0
"North America","2024-04-01",0,0,887,0,8,932,0,0
"North America","2024-04-02",0,52,939,0,7,939,0,0
"North America","2024-04-03",0,0,939,0,10,949,0,0
"North America","2024-04-04",0,0,939,0,11,960,0,0
"North America","2024-04-05",0,0,939,0,10,970,0,0
"North America","2024-04-06",0,0,939,0,10,980,0,0
"North America","2024-04-07",0,0,939,0,10,990,0,0
"North America","2024-04-08",0,0,939,0,11,1001,0,0
"North America","2024-04-09",0,72,1011,0,10,1011,0,0
"North America","2024-04-10",0,0,1011,0,12,1023,0,0
"North America","2024-04-11",0,0,1011,0,12,1035,0,0
"North America","2024-04-12",0,0,1011,0,12,1047,0,0
"North America","2024-04-13",0,0,1011,0,11,1058,0,0
"North America","2024-04-14",0,0,1011,0,12,1070,0,0
"North America","2024-04-15",0,0,1011,0,12,1082,0,0
"North America","2024-04-16",0,83,1094,0,12,1094,0,0
"North America","2024-04-17",0,0,1094,0,12,1106,0,0
"North America","2024-04-18",0,0,1094,0,13,1119,0,0
"North America","2024-04-19",0,0,1094,0,12,1131,0,0
"North America","2024-04-20",0,0,1094,0,12,1143,0,0
"North America","2024-04-21",0,0,1094,0,12,1155,0,0
"North America","2024-04-22",0,0,1094,0,13,1168,0,0
"North America","2024-04-23",0,86,1180,0,12,1180,0,0
"North America","2024-04-24",0,0,1180,0,8,1188,0,0
"North America","2024-04-25",0,0,1180,0,8,1196,0,0
"North America","2024-04-26",0,0,1180,0,8,1204,0,0
"North America","2024-04-27",0,0,1180,0,7,1211,0,0
"North America","2024-04-28",0,0,1180,0,8,1219,0,0
"North America","2024-04-29",0,0,1180,0,8,1227,0,0
"North America","2024-04-30",0,55,1235,0,8,1235,0,0
"North America","2024-05-01",0,0,1235,0,8,1243,0,0
"North America","2024-05-02",0,0,1235,0,9,1252,0,0
"North America","2024-05-03",0,0,1235,0,8,1260,0,0
"North America","2024-05-04",0,0,1235,0,8,1268,0,0
"North America","2024-05-05",0,0,1235,0,8,1276,0,0
"North America","2024-05-06",0,0,1235,0,9,1285,0,0
"North America","2024-05-07",0,58,1293,0,8,1293,0,0
"North America","2024-05-08",0,0,1293,0,9,1302,0,0
"North America","2024-05-09",0,0,1293,0,9,1311,0,0
"North America","2024-05-10",0,0,1293,0,9,1320,0,0
"North America","2024-05-11",0,0,1293,0,9,1329,0,0
"North America","2024-05-12",0,0,1293,0,9,1338,0,0
"North America","2024-05-13",0,0,1293,0,9,1347,0,0
"North America","2024-05-14",0,63,1356,0,9,1356,0,0
"North America","2024-05-15",0,0,1356,0,9,1365,0,0
"North America","2024-05-16",0,0,1356,0,9,1374,0,0
"North America","2024-05-17",0,0,1356,0,9,1383,0,0
"North America","2024-05-18",0,0,1356,0,10,1393,0,0
"North America","2024-05-19",0,0,1356,0,9,1402,0,0
"North America","2024-05-20",0,0,1356,0,9,1411,0,0
"North America","2024-05-21",0,64,1420,0,9,1420,0,0
"North America","2024-05-22",0,0,1420,0,10,1430,0,0
"North America","2024-05-23",0,0,1420,0,11,1441,0,0
"North America","2024-05-24",0,0,1420,0,10,1451,0,0
"North America","2024-05-25",0,0,1420,0,11,1462,0,0
"North America","2024-05-26",0,0,1420,0,10,1472,0,0
"North America","2024-05-27",0,0,1420,0,11,1483,0,0
"North America","2024-05-28",0,73,1493,0,10,1493,0,0
"North America","2024-05-29",0,0,1493,0,10,1503,0,0
"North America","2024-05-30",0,0,1493,0,9,1512,0,0
"North America","2024-05-31",0,0,1493,0,10,1522,0,0
"North America","2024-06-01",0,0,1493,0,9,1531,0,0
"North America","2024-06-02",0,0,1493,0,10,1541,0,0
"North America","2024-06-03",0,0,1493,0,9,1550,0,0
"North America","2024-06-04",0,67,1560,0,10,1560,0,0
"North America","2024-06-05",0,0,1560,0,12,1572,0,0
"North America","2024-06-06",0,0,1560,0,11,1583,0,0
"North America","2024-06-07",0,0,1560,0,12,1595,0,0
"North America","2024-06-08",0,0,1560,0,12,1607,0,0
"North America","2024-06-09",0,0,1560,0,12,1619,0,0
"North America","2024-06-10",0,0,1560,0,11,1630,0,0
"North America","2024-06-11",0,82,1642,0,12,1642,0,0
"North America","2024-06-12",0,0,1642,0,8,1650,0,0
"North America","2024-06-13",0,0,1642,0,8,1658,0,0
"North America","2024-06-14",0,0,1642,0,8,1666,0,0
"North America","2024-06-15",0,0,1642,0,7,1673,0,0
"North America","2024-06-16",0,0,1642,0,8,1681,0,0
"North America","2024-06-17",0,0,1642,0,8,1689,0,0
"North America","2024-06-18",0,55,1697,0,8,1697,0,0
"North America","2024-06-19",0,0,1697,0,8,1705,0,0
"North America","2024-06-20",0,0,1697,0,9,1714,0,0
"North America","2024-06-21",0,0,1697,0,8,1722,0,0
"North America","2024-06-22",0,0,1697,0,8,1730,0,0
"North America","2024-06-23",0,0,1697,0,8,1738,0,0
"North America","2024-06-24",0,0,1697,0,9,1747,0,0
"North America","2024-06-25",0,58,1755,0,8,1755,0,0
"North America","2024-06-26",0,0,1755,0,9,1764,0,0
"North America","2024-06-27",0,0,1755,0,9,1773,0,0
"North America","2024-06-28",0,0,1755,0,9,1782,0,0
"North America","2024-06-29",0,0,1755,0,10,1792,0,0
"North America","2024-06-30",0,0,1755,0,9,1801,0,0
"North America","2024-07-01",0,0,1755,0,9,1810,0,0
"North America","2024-07-02",0,64,1819,0,9,1819,0,0
"North America","2024-07-03",0,0,1819,0,9,1828,0,0
"North America","2024-07-04",0,0,1819,0,10,1838,0,0
"North America","2024-07-05",0,0,1819,0,9,1847,0,0
"North America","2024-07-06",0,0,1819,0,9,1856,0,0
"North America","2024-07-07",0,0,1819,0,9,1865,0,0
"North America","2024-07-08",0,0,1819,0,10,1875,0,0
"North America","2024-07-09",0,65,1884,0,9,1884,0,0
"North America","2024-07-10",0,0,1884,0,11,1895,0,0
"North America","2024-07-11",0,0,1884,0,11,1906,0,0
"North America","2024-07-12",0,0,1884,0,11,1917,0,0
"North America","2024-07-13",0,0,1884,0,10,1927,0,0
"North America","2024-07-14",0,0,1884,0,11,1938,0,0
"North America","2024-07-15",0,0,1884,0,11,1949,0,0
"North America","2024-07-16",0,76,1960,0,11,1960,0,0
"North America","2024-07-17",0,0,1960,0,8,1968,0,0
"North America","2024-07-18",0,0,1960,0,8,1976,0,0
"North America","2024-07-19",0,0,1960,0,8,1984,0,0
"North America","2024-07-20",0,0,1960,0,9,1993,0,0
"North America","2024-07-21",0,0,1960,0,8,2001,0,0
"North America","2024-07-22",0,0,1960,0,8,2009,0,0
"North America","2024-07-23",0,57,2017,0,8,2017,0,0
"North America","2024-07-24",0,0,2017,0,10,2027,0,0
"North America","2024-07-25",0,0,2017,0,10,2037,0,0
"North America","2024-07-26",0,0,2017,0,10,2047,0,0
"North America","2024-07-27",0,0,2017,0,9,2056,0,0
"North America","2024-07-28",0,0,2017,0,10,2066,0,0
"North America","2024-07-29",0,0,2017,0,10,2076,0,0
"North America","2024-07-30",0,69,2086,0,10,2086,0,0
"North America","2024-07-31",0,0,2086,0,11,2097,0,0
"North America","2024-08-01",0,0,2086,0,10,2107,0,0
"North America","2024-08-02",0,0,2086,0,11,2118,0,0
"North America","2024-08-03",0,0,2086,0,10,2128,0,0
"North America","2024-08-04",0,0,2086,0,11,2139,0,0
"North America","2024-08-05",0,0,2086,0,10,2149,0,0
"North America","2024-08-06",0,74,2160,0,11,2160,0,0
"North America","2024-08-07",0,0,2160,0,14,2174,0,0
"North America","2024-08-08",0,0,2160,0,13,2187,0,0
"North America","2024-08-09",0,0,2160,0,14,2201,0,0
"North America","2024-08-10",0,0,2160,0,13,2214,0,0
"North America","2024-08-11",0,0,2160,0,14,2228,0,0
"North America","2024-08-12",0,0,2160,0,13,2241,0,0
"North America","2024-08-13",0,95,2255,0,14,2255,0,0
"North America","2024-08-14",0,0,2255,0,11,2266,0,0
"North America","2024-08-15",0,0,2255,0,11,2277,0,0
"North America","2024-08-16",0,0,2255,0,11,2288,0,0
"North America","2024-08-17",0,0,2255,0,10,2298,0,0
"North America","2024-08-18",0,0,2255,0,11,2309,0,0
"North America","2024-08-19",0,0,2255,0,11,2320,0,0
"North America","2024-08-20",0,76,2331,0,11,2331,0,0
"North America","2024-08-21",0,0,2331,0,12,2343,0,0
"North America","2024-08-22",0,0,2331,0,11,2354,0,0
"North America","2024-08-23",0,0,2331,0,12,2366,0,0
"North America","2024-08-24",0,0,2331,0,11,2377,0,0
"North America","2024-08-25",0,0,2331,0,12,2389,0,0
"North America","2024-08-26",0,0,2331,0,11,2400,0,0
"North America","2024-08-27",0,81,2412,0,12,2412,0,0
"North America","2024-08-28",0,0,2412,0,11,2423,0,0
"North America","2024-08-29",0,0,2412,0,10,2433,0,0
"North America","2024-08-30",0,0,2412,0,11,2444,0,0
"North America","2024-08-31",0,0,2412,0,11,2455,0,0
"North America","2024-09-01",0,0,2412,0,11,2466,0,0
"North America","2024-09-02",0,0,2412,0,10,2476,0,0
"North America","2024-09-03",0,75,2487,0,11,2487,0,0
"North America","2024-09-04",0,0,2487,0,11,2498,0,0
"North America","2024-09-05",0,0,2487,0,10,2508,0,0
"North America","2024-09-06",0,0,2487,0,11,2519,0,0
"North America","2024-09-07",0,0,2487,0,11,2530,0,0
"North America","2024-09-08",0,0,2487,0,11,2541,0,0
"North America","2024-09-09",0,0,2487,0,10,2551,0,0
"North America","2024-09-10",0,75,2562,0,11,2562,0,0
"North America","2024-09-11",0,0,2562,0,7,2569,0,0
"North America","2024-09-12",0,0,2562,0,7,2576,0,0
"North America","2024-09-13",0,0,2562,0,7,2583,0,0
"North America","2024-09-14",0,0,2562,0,6,2589,0,0
"North America","2024-09-15",0,0,2562,0,7,2596,0,0
"North America","2024-09-16",0,0,2562,0,7,2603,0,0
"North America","2024-09-17",0,48,2610,0,7,2610,0,0
"North America","2024-09-18",0,0,2610,0,7,2617,0,0
"North America","2024-09-19",0,0,2610,0,8,2625,0,0
"North America","2024-09-20",0,0,2610,0,7,2632,0,0
"North America","2024-09-21",0,0,2610,0,7,2639,0,0
"North America","2024-09-22",0,0,2610,0,7,2646,0,0
"North America","2024-09-23",0,0,2610,0,8,2654,0,0
"North America","2024-09-24",0,51,2661,0,7,2661,0,0
"North America","2024-09-25",0,0,2661,0,6,2667,0,0
"North America","2024-09-26",0,0,2661,0,5,2672,0,0
"North America","2024-09-27",0,0,2661,0,6,2678,0,0
"North America","2024-09-28",0,0,2661,0,5,2683,0,0
"North America","2024-09-29",0,0,2661,0,6,2689,0,0
"North America","2024-09-30",0,0,2661,0,5,2694,0,0
"North America","2024-10-01",0,39,2700,0,6,2700,0,0
"North America","2024-10-02",0,0,2700,0,4,2704,0,0
"North America","2024-10-03",0,0,2700,0,3,2707,0,0
"North America","2024-10-04",0,0,2700,0,4,2711,0,0
"North America","2024-10-05",0,0,2700,0,3,2714,0,0
"North America","2024-10-06",0,0,2700,0,4,2718,0,0
"North America","2024-10-07",0,0,2700,0,3,2721,0,0
"North America","2024-10-08",0,25,2725,0,4,2725,0,0
"North America","2024-10-09",0,0,2725,0,1,2726,0,0
"North America","2024-10-10",0,0,2725,0,1,2727,0,0
"North America","2024-10-11",0,0,2725,0,1,2728,0,0
"North America","2024-10-12",0,0,2725,0,2,2730,0,0
"North America","2024-10-13",0,0,2725,0,1,2731,0,0
"North America","2024-10-14",0,0,2725,0,1,2732,0,0
"North America","2024-10-15",0,8,2733,0,1,2733,0,0
"North America","2024-10-16",0,0,2733,0,1,2734,0,0
"North America","2024-10-17",0,0,2733,0,2,2736,0,0
"North America","2024-10-18",0,0,2733,0,1,2737,0,0
"North America","2024-10-19",0,0,2733,0,2,2739,0,0
"North America","2024-10-20",0,0,2733,0,1,2740,0,0
"North America","2024-10-21",0,0,2733,0,2,2742,0,0
"North America","2024-10-22",0,10,2743,0,1,2743,0,0
"North America","2024-10-23",0,0,2743,0,0,2743,0,0
"North America","2024-10-24",0,0,2743,0,1,2744,0,0
"North America","2024-10-25",0,0,2743,0,0,2744,0,0
"North America","2024-10-26",0,0,2743,0,1,2745,0,0
"North America","2024-10-27",0,0,2743,0,0,2745,0,0
"North America","2024-10-28",0,0,2743,0,1,2746,0,0
"North America","2024-10-29",0,3,2746,0,0,2746,0,0
"North America","2024-10-30",0,0,2746,0,0,2746,0,0
"North America","2024-10-31",0,0,2746,0,0,2746,0,0
"North America","2024-11-01",0,0,2746,0,0,2746,0,0
"North America","2024-11-02",0,0,2746,0,0,2746,0,0
"North America","2024-11-03",0,0,2746,0,0,2746,0,0
"North America","2024-11-04",0,0,2746,0,0,2746,0,0
"North America","2024-11-05",0,0,2746,0,0,2746,0,0
"North America","2024-11-06",0,0,2746,0,0,2746,0,0
"North America","2024-11-07",0,0,2746,0,0,2746,0,0
"North America","2024-11-08",0,0,2746,0,0,2746,0,0
"North America","2024-11-09",0,0,2746,0,0,2746,0,0
"North America","2024-11-10",0,0,2746,0,0,2746,0,0
"North America","2024-11-11",0,0,2746,0,0,2746,0,0
"North America","2024-11-12",0,0,2746,0,0,2746,0,0
"North America","2024-11-13",0,0,2746,0,0,2746,0,0
"North America","2024-11-14",0,0,2746,0,0,2746,0,0
"North America","2024-11-15",0,0,2746,0,0,2746,0,0
"North America","2024-11-16",0,0,2746,0,0,2746,0,0
"North America","2024-11-17",0,0,2746,0,0,2746,0,0
"North America","2024-11-18",0,0,2746,0,0,2746,0,0
"North America","2024-11-19",0,0,2746,0,0,2746,0,0
"North America","2024-11-20",0,0,2746,0,0,2746,0,0
"North America","2024-11-21",0,0,2746,0,0,2746,0,0
"North America","2024-11-22",0,0,2746,0,0,2746,0,0
"North America","2024-11-23",0,0,2746,0,0,2746,0,0
"North America","2024-11-24",0,0,2746,0,0,2746,0,0
"North America","2024-11-25",0,0,2746,0,0,2746,0,0
"North America","2024-11-26",0,0,2746,0,0,2746,0,0
"North America","2024-11-27",0,0,2746,0,0,2746,0,0
"North America","2024-11-28",0,0,2746,0,0,2746,0,0
"North America","2024-11-29",0,0,2746,0,0,2746,0,0
"North America","2024-11-30",0,0,2746,0,0,2746,0,0
"North America","2024-12-01",0,0,2746,0,0,2746,0,0
"North America","2024-12-02",0,0,2746,0,0,2746,0,0
"North America","2024-12-03",0,0,2746,0,0,2746,0,0
"North America","2024-12-04",0,0,2746,0,0,2746,0,0
"North America","2024-12-05",0,0,2746,0,0,2746,0,0
"North America","2024-12-06",0,0,2746,0,0,2746,0,0
"North America","2024-12-07",0,0,2746,0,0,2746,0,0
"North America","2024-12-08",0,0,2746,0,0,2746,0,0
"North America","2024-12-09",0,0,2746,0,0,2746,0,0
"Norway","2024-01-01",0,0,0,0,0,0,0,0
"Norway","2024-01-02",0,0,0,0,0,0,0,0
"Norway","2024-01-03",0,0,0,0,0,0,0,0
"Norway","2024-01-04",0,0,0,0,0,0,0,0
"Norway","2024-01-05",0,0,0,0,0,0,0,0
"Norway","2024-01-06",0,0,0,0,0,0,0,0
"Norway","2024-01-07",0,0,0,0,0,0,0,0
"Norway","2024-01-08",0,0,0,0,0,0,0,0
"Norway","2024-01-09",0,0,0,0,0,0,0,0
"Norway","2024-01-10",0,0,0,0,0,0,0,0
"Norway","2024-01-11",0,0,0,0,0,0,0,0
"Norway","2024-01-12",0,0,0,0,0,0,0,0
"Norway","2024-01-13",0,0,0,0,0,0,0,0
"Norway","2024-01-14",0,0,0,0,0,0,0,0
"Norway","2024-01-15",0,0,0,0,0,0,0,0
"Norway","2024-01-16",0,0,0,0,0,0,0,0
"Norway","2024-01-17",0,0,0,0,0,0,0,0
"Norway","2024-01-18",0,0,0,0,0,0,0,0
"Norway","2024-01-19",0,0,0,0,0,0,0,0
"Norway","2024-01-20",0,0,0,0,0,0,0,0
"Norway","2024-01-21",0,0,0,0,0,0,0,0
"Norway","2024-01-22",0,0,0,0,0,0,0,0
"Norway","2024-01-23",0,0,0,0,0,0,0,0
"Norway","2024-01-24",0,0,0,0,0,0,0,0
"Norway","2024-01-25",0,0,0,0,0,0,0,0
"Norway","2024-01-26",0,0,0,0,0,0,0,0
"Norway","2024-01-27",0,0,0,0,0,0,0,0
"Norway","2024-01-28",0,0,0,0,0,0,0,0
"Norway","2024-01-29",0,0,0,0,0,0,0,0
"Norway","2024-01-30",0,0,0,0,0,0,0,0
"Norway","2024-01-31",0,1,1,0,1,1,0,0
"Norway","2024-02-01",0,0,1,0,0,1,0,0
"Norway","2024-02-02",0,0,1,0,0,1,0,0
"Norway","2024-02-03",0,0,1,0,0,1,0,0
"Norway","2024-02-04",0,0,1,0,0,1,0,0
"Norway","2024-02-05",0,0,1,0,0,1,0,0
"Norway","2024-02-06",0,0,1,0,0,1,0,0
"Norway","2024-02-07",0,0,1,0,0,1,0,0
"Norway","2024-02-08",0,0,1,0,0,1,0,0
"Norway","2024-02-09",0,0,1,0,0,1,0,0
"Norway","2024-02-10",0,0,1,0,0,1,0,0
"Norway","2024-02-11",0,0,1,0,0,1,0,0
"Norway","2024-02-12",0,0,1,0,0,1,0,0
"Norway","2024-02-13",0,0,1,0,0,1,0,0
"Norway","2024-02-14",0,0,1,0,0,1,0,0
"Norway","2024-02-15",0,0,1,0,0,1,0,0
"Norway","2024-02-16",0,0,1,0,0,1,0,0
"Norway","2024-02-17",0,0,1,0,0,1,0,0
"Norway","2024-02-18",0,0,1,0,0,1,0,0
"Norway","2024-02-19",0,0,1,0,0,1,0,0
"Norway","2024-02-20",0,0,1,0,0,1,0,0
"Norway","2024-02-21",0,0,1,0,0,1,0,0
"Norway","2024-02-22",0,0,1,0,0,1,0,0
"Norway","2024-02-23",0,0,1,0,0,1,0,0
"Norway","2024-02-24",0,0,1,0,0,1,0,0
"Norway","2024-02-25",0,0,1,0,0,1,0,0
"Norway","2024-02-26",0,0,1,0,0,1,0,0
"Norway","2024-02-27",0,0,1,0,0,1,0,0
"Norway","2024-02-28",0,0,1,0,0,1,0,0
"Norway","2024-02-29",0,0,1,0,0,1,0,0
"Norway","2024-03-01",0,0,1,0,0,1,0,0
"Norway","2024-03-02",0,0,1,0,0,1,0,0
"Norway","2024-03-03",0,0,1,0,0,1,0,0
"Norway","2024-03-04",0,0,1,0,0,1,0,0
"Norway","2024-03-05",0,0,1,0,0,1,0,0
"Norway","2024-03-06",0,0,1,0,0,1,0,0
"Norway","2024-03-07",0,0,1,0,0,1,0,0
"Norway","2024-03-08",0,0,1,0,0,1,0,0
"Norway","2024-03-09",0,0,1,0,0,1,0,0
"Norway","2024-03-10",0,0,1,0,0,1,0,0
"Norway","2024-03-11",0,0,1,0,0,1,0,0
"Norway","2024-03-12",0,0,1,0,0,1,0,0
"Norway","2024-03-13",0,0,1,0,0,1,0,0
"Norway","2024-03-14",0,0,1,0,0,1,0,0
"Norway","2024-03-15",0,0,1,0,0,1,0,0
"Norway","2024-03-16",0,0,1,0,0,1,0,0
"Norway","2024-03-17",0,0,1,0,1,2,0,0
"Norway","2024-03-18",0,0,1,0,0,2,0,0
"Norway","2024-03-19",0,0,1,0,0,2,0,0
"Norway","2024-03-20",0,0,1,0,0,2,0,0
"Norway","2024-03-21",0,0,1,0,0,2,0,0
"Norway","2024-03-22",0,0,1,0,0,2,0,0
"Norway","2024-03-23",0,0,1,0,0,2,0,0
"Norway","2024-03-24",0,0,1,0,0,2,0,0
"Norway","2024-03-25",0,0,1,0,0,2,0,0
"Norway","2024-03-26",0,0,1,0,0,2,0,0
"Norway","2024-03-27",0,0,1,0,0,2,0,0
"Norway","2024-03-28",0,0,1,0,0,2,0,0
"Norway","2024-03-29",0,0,1,0,0,2,0,0
"Norway","2024-03-30",0,0,1,0,0,2,0,0
"Norway","2024-03-31",0,0,1,0,0,2,0,0
"Norway","2024-04-01",0,0,1,0,0,2,0,0
"Norway","2024-04-02",0,0,1,0,0,2,0,0
"Norway","2024-04-03",0,0,1,0,0,2,0,0
"Norway","2024-04-04",0,0,1,0,0,2,0,0
"Norway","2024-04-05",0,0,1,0,0,2,0,0
"Norway","2024-04-06",0,0,1,0,0,2,0,0
"Norway","2024-04-07",0,0,1,0,0,2,0,0
"Norway","2024-04-08",0,0,1,0,0,2,0,0
"Norway","2024-04-09",0,0,1,0,0,2,0,0
"Norway","2024-04-10",0,0,1,0,0,2,0,0
"Norway","2024-04-11",0,0,1,0,0,2,0,0
"Norway","2024-04-12",0,0,1,0,0,2,0,0
"Norway","2024-04-13",0,0,1,0,0,2,0,0
"Norway","2024-04-14",0,0,1,0,0,2,0,0
"Norway","2024-04-15",0,0,1,0,0,2,0,0
"Norway","2024-04-16",0,0,1,0,0,2,0,0
"Norway","2024-04-17",0,0,1,0,0,2,0,0
"Norway","2024-04-18",0,0,1,0,0,2,0,0
"Norway","2024-04-19",0,0,1,0,0,2,0,0
"Norway","2024-04-20",0,0,1,0,0,2,0,0
"Norway","2024-04-21",0,0,1,0,0,2,0,0
"Norway","2024-04-22",0,0,1,0,0,2,0,0
"Norway","2024-04-23",0,0,1,0,0,2,0,0
"Norway","2024-04-24",0,0,1,0,0,2,0,0
"Norway","2024-04-25",0,0,1,0,0,2,0,0
"Norway","2024-04-26",0,0,1,0,0,2,0,0
"Norway","2024-04-27",0,0,1,0,0,2,0,0
"Norway","2024-04-28",0,0,1,0,0,2,0,0
"Norway","2024-04-29",0,0,1,0,0,2,0,0
"Norway","2024-04-30",0,1,2,0,0,2,0,0
"Norway","2024-05-01",0,0,2,0,0,2,0,0
"Norway","2024-05-02",0,0,2,0,0,2,0,0
"Norway","2024-05-03",0,0,2,0,0,2,0,0
"Norway","2024-05-04",0,0,2,0,0,2,0,0
"Norway","2024-05-05",0,0,2,0,0,2,0,0
"Norway","2024-05-06",0,0,2,0,0,2,0,0
"Norway","2024-05-07",0,0,2,0,0,2,0,0
"Norway","2024-05-08",0,0,2,0,0,2,0,0
"Norway","2024-05-09",0,0,2,0,0,2,0,0
"Norway","2024-05-10",0,0,2,0,0,2,0,0
"Norway","2024-05-11",0,0,2,0,0,2,0,0
"Norway","2024-05-12",0,0,2,0,0,2,0,0
"Norway","2024-05-13",0,0,2,0,0,2,0,0
"Norway","2024-05-14",0,0,2,0,0,2,0,0
"Norway","2024-05-15",0,0,2,0,0,2,0,0
"Norway","2024-05-16",0,0,2,0,0,2,0,0
"Norway","2024-05-17",0,0,2,0,0,2,0,0
"Norway","2024-05-18",0,0,2,0,0,2,0,0
"Norway","2024-05-19",0,0,2,0,0,2,0,0
"Norway","2024-05-20",0,0,2,0,0,2,0,0
"Norway","2024-05-21",0,0,2,0,0,2,0,0
"Norway","2024-05-22",0,0,2,0,0,2,0,0
"Norway","2024-05-23",0,0,2,0,0,2,0,0
"Norway","2024-05-24",0,0,2,0,0,2,0,0
"Norway","2024-05-25",0,0,2,0,0,2,0,0
"Norway","2024-05-26",0,0,2,0,0,2,0,0
"Norway","2024-05-27",0,0,2,0,0,2,0,0
"Norway","2024-05-28",0,0,2,0,0,2,0,0
"Norway","2024-05-29",0,0,2,0,0,2,0,0
"Norway","2024-05-30",0,0,2,0,0,2,0,0
"Norway","2024-05-31",0,0,2,0,0,2,0,0
"Norway","2024-06-01",0,0,2,0,0,2,0,0
"Norway","2024-06-02",0,0,2,0,0,2,0,0
"Norway","2024-06-03",0,0,2,0,0,2,0,0
"Norway","2024-06-04",0,0,2,0,0,2,0,0
"Norway","2024-06-05",0,0,2,0,0,2,0,0
"Norway","2024-06-06",0,0,2,0,0,2,0,0
"Norway","2024-06-07",0,0,2,0,0,2,0,0
"Norway","2024-06-08",0,0,2,0,0,2,0,0
"Norway","2024-06-09",0,0,2,0,0,2,0,0
"Norway","2024-06-10",0,0,2,0,0,2,0,0
"Norway","2024-06-11",0,0,2,0,0,2,0,0
"Norway","2024-06-12",0,0,2,0,0,2,0,0
"Norway","2024-06-13",0,0,2,0,0,2,0,0
"Norway","2024-06-14",0,0,2,0,0,2,0,0
"Norway","2024-06-15",0,0,2,0,0,2,0,0
"Norway","2024-06-16",0,0,2,0,1,3,0,0
"Norway","2024-06-17",0,0,2,0,0,3,0,0
"Norway","2024-06-18",0,0,2,0,0,3,0,0
"Norway","2024-06-19",0,0,2,0,0,3,0,0
"Norway","2024-06-20",0,0,2,0,0,3,0,0
"Norway","2024-06-21",0,0,2,0,0,3,0,0
"Norway","2024-06-22",0,0,2,0,0,3,0,0
"Norway","2024-06-23",0,0,2,0,0,3,0,0
"Norway","2024-06-24",0,0,2,0,0,3,0,0
"Norway","2024-06-25",0,0,2,0,0,3,0,0
"Norway","2024-06-26",0,0,2,0,0,3,0,0
"Norway","2024-06-27",0,0,2,0,0,3,0,0
"Norway","2024-06-28",0,0,2,0,0,3,0,0
"Norway","2024-06-29",0,0,2,0,0,3,0,0
"Norway","2024-06-30",0,0,2,0,0,3,0,0
"Norway","2024-07-01",0,0,2,0,0,3,0,0
"Norway","2024-07-02",0,0,2,0,0,3,0,0
"Norway","2024-07-03",0,0,2,0,0,3,0,0
"Norway","2024-07-04",0,0,2,0,0,3,0,0
"Norway","2024-07-05",0,0,2,0,0,3,0,0
"Norway","2024-07-06",0,0,2,0,0,3,0,0
"Norway","2024-07-07",0,0,2,0,0,3,0,0
"Norway","2024-07-08",0,0,2,0,0,3,0,0
"Norway","2024-07-09",0,0,2,0,0,3,0,0
"Norway","2024-07-10",0,0,2,0,0,3,0,0
"Norway","2024-07-11",0,0,2,0,0,3,0,0
"Norway","2024-07-12",0,0,2,0,0,3,0,0
"Norway","2024-07-13",0,0,2,0,0,3,0,0
"Norway","2024-07-14",0,0,2,0,0,3,0,0
"Norway","2024-07-15",0,0,2,0,0,3,0,0
"Norway","2024-07-16",0,0,2,0,0,3,0,0
"Norway","2024-07-17",0,0,2,0,0,3,0,0
"Norway","2024-07-18",0,0,2,0,0,3,0,0
"Norway","2024-07-19",0,0,2,0,0,3,0,0
"Norway","2024-07-20",0,0,2,0,0,3,0,0
"Norway","2024-07-21",0,0,2,0,0,3,0,0
"Norway","2024-07-22",0,0,2,0,0,3,0,0
"Norway","2024-07-23",0,0,2,0,0,3,0,0
"Norway","2024-07-24",0,0,2,0,0,3,0,0
"Norway","2024-07-25",0,0,2,0,0,3,0,0
"Norway","2024-07-26",0,0,2,0,0,3,0,0
"Norway","2024-07-27",0,0,2,0,0,3,0,0
"Norway","2024-07-28",0,0,2,0,0,3,0,0
"Norway","2024-07-29",0,0,2,0,0,3,0,0
"Norway","2024-07-30",0,0,2,0,0,3,0,0
"Norway","2024-07-31",0,1,3,0,0,3,0,0
"Norway","2024-08-01",0,0,3,0,0,3,0,0
"Norway","2024-08-02",0,0,3,0,0,3,0,0
"Norway","2024-08-03",0,0,3,0,0,3,0,0
"Norway","2024-08-04",0,0,3,0,0,3,0,0
"Norway","2024-08-05",0,0,3,0,0,3,0,0
"Norway","2024-08-06",0,0,3,0,0,3,0,0
"Norway","2024-08-07",0,0,3,0,0,3,0,0
"Norway","2024-08-08",0,0,3,0,1,4,0,0
"Norway","2024-08-09",0,0,3,0,0,4,0,0
"Norway","2024-08-10",0,0,3,0,0,4,0,0
"Norway","2024-08-11",0,0,3,0,0,4,0,0
"Norway","2024-08-12",0,0,3,0,0,4,0,0
"Norway","2024-08-13",0,0,3,0,0,4,0,0
"Norway","2024-08-14",0,0,3,0,0,4,0,0
"Norway","2024-08-15",0,0,3,0,0,4,0,0
"Norway","2024-08-16",0,0,3,0,0,4,0,0
"Norway","2024-08-17",0,0,3,0,0,4,0,0
"Norway","2024-08-18",0,0,3,0,0,4,0,0
"Norway","2024-08-19",0,0,3,0,0,4,0,0
"Norway","2024-08-20",0,0,3,0,0,4,0,0
"Norway","2024-08-21",0,0,3,0,0,4,0,0
"Norway","2024-08-22",0,0,3,0,0,4,0,0
"Norway","2024-08-23",0,0,3,0,0,4,0,0
"Norway","2024-08-24",0,0,3,0,1,5,0,0
"Norway","2024-08-25",0,0,3,0,0,5,0,0
"Norway","2024-08-26",0,0,3,0,0,5,0,0
"Norway","2024-08-27",0,0,3,0,0,5,0,0
"Norway","2024-08-28",0,0,3,0,0,5,0,0
"Norway","2024-08-29",0,0,3,0,0,5,0,0
"Norway","2024-08-30",0,0,3,0,0,5,0,0
"Norway","2024-08-31",0,2,5,0,0,5,0,0
"Norway","2024-09-01",0,0,5,0,0,5,0,0
"Norway","2024-09-02",0,0,5,0,0,5,0,0
"Norway","2024-09-03",0,0,5,0,0,5,0,0
"Norway","2024-09-04",0,0,5,0,0,5,0,0
"Norway","2024-09-05",0,0,5,0,1,6,0,0
"Norway","2024-09-06",0,0,5,0,0,6,0,0
"Norway","2024-09-07",0,0,5,0,0,6,0,0
"Norway","2024-09-08",0,0,5,0,0,6,0,0
"Norway","2024-09-09",0,0,5,0,0,6,0,0
"Norway","2024-09-10",0,0,5,0,0,6,0,0
"Norway","2024-09-11",0,0,5,0,0,6,0,0
"Norway","2024-09-12",0,0,5,0,0,6,0,0
"Norway","2024-09-13",0,0,5,0,0,6,0,0
"Norway","2024-09-14",0,0,5,0,1,7,0,0
"Norway","2024-09-15",0,0,5,0,0,7,0,0
"Norway","2024-09-16",0,0,5,0,0,7,0,0
"Norway","2024-09-17",0,0,5,0,0,7,0,0
"Norway","2024-09-18",0,0,5,0,0,7,0,0
"Norway","2024-09-19",0,0,5,0,0,7,0,0
"Norway","2024-09-20",0,0,5,0,0,7,0,0
"Norway","2024-09-21",0,0,5,0,0,7,0,0
"Norway","2024-09-22",0,0,5,0,1,8,0,0
"Norway","2024-09-23",0,0,5,0,0,8,0,0
"Norway","2024-09-24",0,0,5,0,0,8,0,0
"Norway","2024-09-25",0,0,5,0,0,8,0,0
"Norway","2024-09-26",0,0,5,0,0,8,0,0
"Norway","2024-09-27",0,0,5,0,0,8,0,0
"Norway","2024-09-28",0,0,5,0,0,8,0,0
"Norway","2024-09-29",0,0,5,0,0,8,0,0
"Norway","2024-09-30",0,0,5,0,0,8,0,0
"Norway","2024-10-01",0,0,5,0,1,9,0,0
"Norway","2024-10-02",0,0,5,0,0,9,0,0
"Norway","2024-10-03",0,0,5,0,0,9,0,0
"Norway","2024-10-04",0,0,5,0,0,9,0,0
"Norway","2024-10-05",0,0,5,0,0,9,0,0
"Norway","2024-10-06",0,0,5,0,0,9,0,0
"Norway","2024-10-07",0,0,5,0,0,9,0,0
"Norway","2024-10-08",0,0,5,0,0,9,0,0
"Norway","2024-10-09",0,0,5,0,0,9,0,0
"Norway","2024-10-10",0,0,5,0,1,10,0,0
"Norway","2024-10-11",0,0,5,0,0,10,0,0
"Norway","2024-10-12",0,0,5,0,0,10,0,0
"Norway","2024-10-13",0,0,5,0,0,10,0,0
"Norway","2024-10-14",0,0,5,0,0,10,0,0
"Norway","2024-10-15",0,0,5,0,0,10,0,0
"Norway","2024-10-16",0,0,5,0,0,10,0,0
"Norway","2024-10-17",0,0,5,0,0,10,0,0
"Norway","2024-10-18",0,0,5,0,1,11,0,0
"Norway","2024-10-19",0,0,5,0,0,11,0,0
"Norway","2024-10-20",0,0,5,0,0,11,0,0
"Norway","2024-10-21",0,0,5,0,0,11,0,0
"Norway","2024-10-22",0,0,5,0,0,11,0,0
"Norway","2024-10-23",0,0,5,0,0,11,0,0
"Norway","2024-10-24",0,0,5,0,0,11,0,0
"Norway","2024-10-25",0,0,5,0,0,11,0,0
"Norway","2024-10-26",0,0,5,0,0,11,0,0
"Norway","2024-10-27",0,0,5,0,1,12,0,0
"Norway","2024-10-28",0,0,5,0,0,12,0,0
"Norway","2024-10-29",0,0,5,0,0,12,0,0
"Norway","2024-10-30",0,0,5,0,0,12,0,0
"Norway","2024-10-31",0,7,12,0,0,12,0,0
"Norway","2024-11-01",0,0,12,0,0,12,0,0
"Norway","2024-11-02",0,0,12,0,0,12,0,0
"Norway","2024-11-03",0,0,12,0,0,12,0,0
"Norway","2024-11-04",0,0,12,0,0,12,0,0
"Norway","2024-11-05",0,0,12,0,0,12,0,0
"Norway","2024-11-06",0,0,12,0,0,12,0,0
"Norway","2024-11-07",0,0,12,0,0,12,0,0
"Norway","2024-11-08",0,0,12,0,0,12,0,0
"Norway","2024-11-09",0,0,12,0,0,12,0,0
"Norway","2024-11-10",0,0,12,0,0,12,0,0
"Norway","2024-11-11",0,0,12,0,0,12,0,0
"Norway","2024-11-12",0,0,12,0,0,12,0,0
"Norway","2024-11-13",0,0,12,0,0,12,0,0
"Norway","2024-11-14",0,0,12,0,0,12,0,0
"Norway","2024-11-15",0,0,12,0,0,12,0,0
"Norway","2024-11-16",0,0,12,0,0,12,0,0
"Norway","2024-11-17",0,0,12,0,0,12,0,0
"Norway","2024-11-18",0,0,12,0,0,12,0,0
"Norway","2024-11-19",0,0,12,0,0,12,0,0
"Norway","2024-11-20",0,0,12,0,0,12,0,0
"Norway","2024-11-21",0,0,12,0,0,12,0,0
"Norway","2024-11-22",0,0,12,0,0,12,0,0
"Norway","2024-11-23",0,0,12,0,0,12,0,0
"Norway","2024-11-24",0,0,12,0,0,12,0,0
"Norway","2024-11-25",0,0,12,0,0,12,0,0
"Norway","2024-11-26",0,0,12,0,0,12,0,0
"Norway","2024-11-27",0,0,12,0,0,12,0,0
"Norway","2024-11-28",0,0,12,0,0,12,0,0
"Norway","2024-11-29",0,0,12,0,0,12,0,0
"Norway","2024-11-30",0,0,12,0,0,12,0,0
"Norway","2024-12-01",0,0,12,0,0,12,0,0
"Norway","2024-12-02",0,0,12,0,0,12,0,0
"Norway","2024-12-03",0,0,12,0,0,12,0,0
"Norway","2024-12-04",0,0,12,0,0,12,0,0
"Norway","2024-12-05",0,0,12,0,0,12,0,0
"Norway","2024-12-06",0,0,12,0,0,12,0,0
"Norway","2024-12-07",0,0,12,0,0,12,0,0
"Norway","2024-12-08",0,0,12,0,0,12,0,0
"Norway","2024-12-09",0,0,12,0,0,12,0,0
"Oceania","2024-01-01",0,0,0,0,0,0,0,0
"Oceania","2024-01-02",0,0,0,0,0,0,0,0
"Oceania","2024-01-03",0,0,0,0,0,0,0,0
"Oceania","2024-01-04",0,0,0,0,0,0,0,0
"Oceania","2024-01-05",0,0,0,0,0,0,0,0
"Oceania","2024-01-06",0,0,0,0,0,0,0,0
"Oceania","2024-01-07",0,0,0,0,0,0,0,0
"Oceania","2024-01-08",0,0,0,0,0,0,0,0
"Oceania","2024-01-09",0,0,0,0,0,0,0,0
"Oceania","2024-01-10",0,0,0,0,0,0,0,0
"Oceania","2024-01-11",0,0,0,0,0,0,0,0
"Oceania","2024-01-12",0,0,0,0,0,0,0,0
"Oceania","2024-01-13",0,0,0,0,0,0,0,0
"Oceania","2024-01-14",0,0,0,0,0,0,0,0
"Oceania","2024-01-15",0,0,0,0,0,0,0,0
"Oceania","2024-01-16",0,8,8,0,8,8,0,0
"Oceania","2024-01-17",0,0,8,0,0,8,0,0
"Oceania","2024-01-18",0,0,8,0,1,9,0,0
"Oceania","2024-01-19",0,0,8,0,0,9,0,0
"Oceania","2024-01-20",0,0,8,0,1,10,0,0
"Oceania","2024-01-21",0,0,8,0,0,10,0,0
"Oceania","2024-01-22",0,0,8,0,0,10,0,0
"Oceania","2024-01-23",0,0,8,0,1,11,0,0
"Oceania","2024-01-24",0,0,8,0,0,11,0,0
"Oceania","2024-01-25",0,0,8,0,1,12,0,0
"Oceania","2024-01-26",0,0,8,0,0,12,0,0
"Oceania","2024-01-27",0,0,8,0,0,12,0,0
"Oceania","2024-01-28",0,0,8,0,1,13,0,0
"Oceania","2024-01-29",0,0,8,0,0,13,0,0
"Oceania","2024-01-30",0,0,8,0,1,14,0,0
"Oceania","2024-01-31",0,6,14,0,0,14,0,0
"Oceania","2024-02-01",0,0,14,0,0,14,0,0
"Oceania","2024-02-02",0,0,14,0,0,14,0,0
"Oceania","2024-02-03",0,0,14,0,0,14,0,0
"Oceania","2024-02-04",0,0,14,0,0,14,0,0
"Oceania","2024-02-05",0,0,14,0,0,14,0,0
"Oceania","2024-02-06",0,0,14,0,0,14,0,0
"Oceania","2024-02-07",0,0,14,0,0,14,0,0
"Oceania","2024-02-08",0,0,14,0,0,14,0,0
"Oceania","2024-02-09",0,0,14,0,0,14,0,0
"Oceania","2024-02-10",0,0,14,0,1,15,0,0
"Oceania","2024-02-11",0,0,14,0,0,15,0,0
"Oceania","2024-02-12",0,0,14,0,0,15,0,0
"Oceania","2024-02-13",0,0,14,0,0,15,0,0
"Oceania","2024-02-14",0,0,14,0,0,15,0,0
"Oceania","2024-02-15",0,0,14,0,0,15,0,0
"Oceania","2024-02-16",0,0,14,0,0,15,0,0
"Oceania","2024-02-17",0,0,14,0,0,15,0,0
"Oceania","2024-02-18",0,0,14,0,0,15,0,0
"Oceania","2024-02-19",0,0,14,0,0,15,0,0
"Oceania","2024-02-20",0,0,14,0,0,15,0,0
"Oceania","2024-02-21",0,0,14,0,0,15,0,0
"Oceania","2024-02-22",0,0,14,0,0,15,0,0
"Oceania","2024-02-23",0,0,14,0,0,15,0,0
"Oceania","2024-02-24",0,0,14,0,0,15,0,0
"Oceania","2024-02-25",0,0,14,0,0,15,0,0
"Oceania","2024-02-26",0,0,14,0,0,15,0,0
"Oceania","2024-02-27",0,0,14,0,1,16,0,0
"Oceania","2024-02-28",0,0,14,0,0,16,0,0
"Oceania","2024-02-29",0,0,14,0,0,16,0,0
"Oceania","2024-03-01",0,0,14,0,0,16,0,0
"Oceania","2024-03-02",0,0,14,0,0,16,0,0
"Oceania","2024-03-03",0,0,14,0,0,16,0,0
"Oceania","2024-03-04",0,0,14,0,0,16,0,0
"Oceania","2024-03-05",0,0,14,0,0,16,0,0
"Oceania","2024-03-06",0,0,14,0,0,16,0,0
"Oceania","2024-03-07",0,0,14,0,0,16,0,0
"Oceania","2024-03-08",0,0,14,0,0,16,0,0
"Oceania","2024-03-09",0,0,14,0,0,16,0,0
"Oceania","2024-03-10",0,0,14,0,0,16,0,0
"Oceania","2024-03-11",0,0,14,0,0,16,0,0
"Oceania","2024-03-12",0,0,14,0,0,16,0,0
"Oceania","2024-03-13",0,0,14,0,0,16,0,0
"Oceania","2024-03-14",0,0,14,0,0,16,0,0
"Oceania","2024-03-15",0,0,14,0,0,16,0,0
"Oceania","2024-03-16",0,0,14,0,0,16,0,0
"Oceania","2024-03-17",0,0,14,0,1,17,0,0
"Oceania","2024-03-18",0,0,14,0,0,17,0,0
"Oceania","2024-03-19",0,0,14,0,0,17,0,0
"Oceania","2024-03-20",0,0,14,0,0,17,0,0
"Oceania","2024-03-21",0,0,14,0,0,17,0,0
"Oceania","2024-03-22",0,0,14,0,0,17,0,0
"Oceania","2024-03-23",0,0,14,0,0,17,0,0
"Oceania","2024-03-24",0,0,14,0,0,17,0,0
"Oceania","2024-03-25",0,0,14,0,0,17,0,0
"Oceania","2024-03-26",0,0,14,0,0,17,0,0
"Oceania","2024-03-27",0,0,14,0,0,17,0,0
"Oceania","2024-03-28",0,0,14,0,0,17,0,0
"Oceania","2024-03-29",0,0,14,0,0,17,0,0
"Oceania","2024-03-30",0,0,14,0,0,17,0,0
"Oceania","2024-03-31",0,0,14,0,0,17,0,0
"Oceania","2024-04-01",0,0,14,0,0,17,0,0
"Oceania","2024-04-02",0,0,14,0,0,17,0,0
"Oceania","2024-04-03",0,0,14,0,1,18,0,0
"Oceania","2024-04-04",0,0,14,0,0,18,0,0
"Oceania","2024-04-05",0,0,14,0,0,18,0,0
"Oceania","2024-04-06",0,0,14,0,0,18,0,0
"Oceania","2024-04-07",0,0,14,0,0,18,0,0
"Oceania","2024-04-08",0,0,14,0,0,18,0,0
"Oceania","2024-04-09",0,0,14,0,0,18,0,0
"Oceania","2024-04-10",0,0,14,0,0,18,0,0
"Oceania","2024-04-11",0,0,14,0,0,18,0,0
"Oceania","2024-04-12",0,0,14,0,0,18,0,0
"Oceania","2024-04-13",0,0,14,0,0,18,0,0
"Oceania","2024-04-14",0,0,14,0,0,18,0,0
"Oceania","2024-04-15",0,0,14,0,0,18,0,0
"Oceania","2024-04-16",0,0,14,0,0,18,0,0
"Oceania","2024-04-17",0,0,14,0,0,18,0,0
"Oceania","2024-04-18",0,0,14,0,0,18,0,0
"Oceania","2024-04-19",0,0,14,0,0,18,0,0
"Oceania","2024-04-20",0,0,14,0,0,18,0,0
"Oceania","2024-04-21",0,0,14,0,0,18,0,0
"Oceania","2024-04-22",0,0,14,0,1,19,0,0
"Oceania","2024-04-23",0,0,14,0,0,19,0,0
"Oceania","2024-04-24",0,0,14,0,0,19,0,0
"Oceania","2024-04-25",0,0,14,0,0,19,0,0
"Oceania","2024-04-26",0,0,14,0,0,19,0,0
"Oceania","2024-04-27",0,0,14,0,0,19,0,0
"Oceania","2024-04-28",0,0,14,0,0,19,0,0
"Oceania","2024-04-29",0,0,14,0,0,19,0,0
"Oceania","2024-04-30",0,5,19,0,0,19,0,0
"Oceania","2024-05-01",0,0,19,0,0,19,0,0
"Oceania","2024-05-02",0,0,19,0,0,19,0,0
"Oceania","2024-05-03",0,0,19,0,0,19,0,0
"Oceania","2024-05-04",0,0,19,0,0,19,0,0
"Oceania","2024-05-05",0,0,19,0,1,20,0,0
"Oceania","2024-05-06",0,0,19,0,0,20,0,0
"Oceania","2024-05-07",0,0,19,0,0,20,0,0
"Oceania","2024-05-08",0,0,19,0,0,20,0,0
"Oceania","2024-05-09",0,1,20,0,0,20,0,0
"Oceania","2024-05-10",0,0,20,0,2,22,0,0
"Oceania","2024-05-11",0,0,20,0,1,23,0,0
"Oceania","2024-05-12",0,0,20,0,1,24,0,0
"Oceania","2024-05-13",0,0,20,0,2,26,0,0
"Oceania","2024-05-14",0,0,20,0,2,28,0,0
"Oceania","2024-05-15",0,0,20,0,1,29,0,0
"Oceania","2024-05-16",0,0,20,0,1,30,0,0
"Oceania","2024-05-17",0,0,20,0,2,32,0,0
"Oceania","2024-05-18",0,0,20,0,2,34,0,0
"Oceania","2024-05-19",0,0,20,0,1,35,0,0
"Oceania","2024-05-20",0,0,20,0,1,36,0,0
"Oceania","2024-05-21",0,0,20,0,2,38,0,0
"Oceania","2024-05-22",0,0,20,0,2,40,0,0
"Oceania","2024-05-23",0,0,20,0,1,41,0,0
"Oceania","2024-05-24",0,0,20,0,1,42,0,0
"Oceania","2024-05-25",0,0,20,0,2,44,0,0
"Oceania","2024-05-26",0,0,20,0,2,46,0,0
"Oceania","2024-05-27",0,0,20,0,1,47,0,0
"Oceania","2024-05-28",0,0,20,0,1,48,0,0
"Oceania","2024-05-29",0,0,20,0,2,50,0,0
"Oceania","2024-05-30",0,0,20,0,2,52,0,0
"Oceania","2024-05-31",0,33,53,0,1,53,0,0
"Oceania","2024-06-01",0,0,53,0,2,55,0,0
"Oceania","2024-06-02",0,0,53,0,2,57,0,0
"Oceania","2024-06-03",0,0,53,0,2,59,0,0
"Oceania","2024-06-04",0,0,53,0,3,62,0,0
"Oceania","2024-06-05",0,0,53,0,2,64,0,0
"Oceania","2024-06-06",0,0,53,0,2,66,0,0
"Oceania","2024-06-07",0,0,53,0,2,68,0,0
"Oceania","2024-06-08",0,0,53,0,2,70,0,0
"Oceania","2024-06-09",0,0,53,0,2,72,0,0
"Oceania","2024-06-10",0,0,53,0,2,74,0,0
"Oceania","2024-06-11",0,0,53,0,2,76,0,0
"Oceania","2024-06-12",0,0,53,0,3,79,0,0
"Oceania","2024-06-13",0,0,53,0,2,81,0,0
"Oceania","2024-06-14",0,0,53,0,2,83,0,0
"Oceania","2024-06-15",0,0,53,0,2,85,0,0
"Oceania","2024-06-16",0,0,53,0,2,87,0,0
"Oceania","2024-06-17",0,0,53,0,2,89,0,0
"Oceania","2024-06-18",0,0,53,0,2,91,0,0
"Oceania","2024-06-19",0,0,53,0,3,94,0,0
"Oceania","2024-06-20",0,0,53,0,2,96,0,0
"Oceania","2024-06-21",0,0,53,0,2,98,0,0
"Oceania","2024-06-22",0,0,53,0,2,100,0,0
"Oceania","2024-06-23",0,0,53,0,2,102,0,0
"Oceania","2024-06-24",0,0,53,0,2,104,0,0
"Oceania","2024-06-25",0,0,53,0,2,106,0,0
"Oceania","2024-06-26",0,0,53,0,2,108,0,0
"Oceania","2024-06-27",0,0,53,0,3,111,0,0
"Oceania","2024-06-28",0,0,53,0,2,113,0,0
"Oceania","2024-06-29",0,0,53,0,2,115,0,0
"Oceania","2024-06-30",0,64,117,0,2,117,0,0
"Oceania","2024-07-01",0,2,119,0,2,119,0,0
"Oceania","2024-07-02",0,0,119,0,1,120,0,0
"Oceania","2024-07-03",0,0,119,0,1,121,0,0
"Oceania","2024-07-04",0,0,119,0,1,122,0,0
"Oceania","2024-07-05",0,0,119,0,1,123,0,0
"Oceania","2024-07-06",0,0,119,0,1,124,0,0
"Oceania","2024-07-07",0,0,119,0,1,125,0,0
"Oceania","2024-07-08",0,0,119,0,1,126,0,0
"Oceania","2024-07-09",0,0,119,0,1,127,0,0
"Oceania","2024-07-10",0,0,119,0,1,128,0,0
"Oceania","2024-07-11",0,0,119,0,1,129,0,0
"Oceania","2024-07-12",0,0,119,0,1,130,0,0
"Oceania","2024-07-13",0,0,119,0,1,131,0,0
"Oceania","2024-07-14",0,0,119,0,1,132,0,0
"Oceania","2024-07-15",0,14,133,0,1,133,0,0
"Oceania","2024-07-16",0,0,133,0,3,136,0,0
"Oceania","2024-07-17",0,0,133,0,3,139,0,0
"Oceania","2024-07-18",0,0,133,0,3,142,0,0
"Oceania","2024-07-19",0,0,133,0,3,145,0,0
"Oceania","2024-07-20",0,0,133,0,3,148,0,0
"Oceania","2024-07-21",0,0,133,0,3,151,0,0
"Oceania","2024-07-22",0,21,154,0,3,154,0,0
"Oceania","2024-07-23",0,0,154,0,4,158,0,0
"Oceania","2024-07-24",0,0,154,0,4,162,0,0
"Oceania","2024-07-25",0,0,154,0,5,167,0,0
"Oceania","2024-07-26",0,0,154,0,4,171,0,0
"Oceania","2024-07-27",0,21,175,0,4,175,0,0
"Oceania","2024-07-28",0,0,175,0,11,186,0,0
"Oceania","2024-07-29",0,0,175,0,10,196,0,0
"Oceania","2024-07-30",0,32,207,0,11,207,0,0
"Oceania","2024-07-31",0,13,220,0,13,220,0,0
"Oceania","2024-08-01",0,0,220,0,4,224,0,0
"Oceania","2024-08-02",0,0,220,0,3,227,0,0
"Oceania","2024-08-03",0,0,220,0,4,231,0,0
"Oceania","2024-08-04",0,0,220,0,3,234,0,0
"Oceania","2024-08-05",0,0,220,0,4,238,0,0
"Oceania","2024-08-06",0,0,220,0,3,241,0,0
"Oceania","2024-08-07",0,0,220,0,4,245,0,0
"Oceania","2024-08-08",0,0,220,0,3,248,0,0
"Oceania","2024-08-09",0,0,220,0,4,252,0,0
"Oceania","2024-08-10",0,0,220,0,3,255,0,0
"Oceania","2024-08-11",0,0,220,0,4,259,0,0
"Oceania","2024-08-12",0,0,220,0,3,262,0,0
"Oceania","2024-08-13",0,0,220,0,4,266,0,0
"Oceania","2024-08-14",0,0,220,0,3,269,0,0
"Oceania","2024-08-15",0,0,220,0,4,273,0,0
"Oceania","2024-08-16",0,0,220,0,3,276,0,0
"Oceania","2024-08-17",0,0,220,0,4,280,0,0
"Oceania","2024-08-18",0,0,220,0,3,283,0,0
"Oceania","2024-08-19",0,0,220,0,4,287,0,0
"Oceania","2024-08-20",0,0,220,0,3,290,0,0
"Oceania","2024-08-21",0,74,294,0,4,294,0,0
"Oceania","2024-08-22",0,0,294,0,9,303,0,0
"Oceania","2024-08-23",0,0,294,0,9,312,0,0
"Oceania","2024-08-24",0,0,294,0,8,320,0,0
"Oceania","2024-08-25",0,0,294,0,9,329,0,0
"Oceania","2024-08-26",0,0,294,0,9,338,0,0
"Oceania","2024-08-27",0,0,294,0,8,346,0,0
"Oceania","2024-08-28",0,0,294,0,9,355,0,0
"Oceania","2024-08-29",0,70,364,0,9,364,0,0
"Oceania","2024-08-30",0,0,364,0,50,414,0,0
"Oceania","2024-08-31",0,101,465,0,51,465,0,0
"Oceania","2024-09-01",0,0,465,0,4,469,0,0
"Oceania","2024-09-02",0,0,465,0,5,474,0,0
"Oceania","2024-09-03",0,0,465,0,4,478,0,0
"Oceania","2024-09-04",0,0,465,0,5,483,0,0
"Oceania","2024-09-05",0,0,465,0,4,487,0,0
"Oceania","2024-09-06",0,0,465,0,4,491,0,0
"Oceania","2024-09-07",0,0,465,0,5,496,0,0
"Oceania","2024-09-08",0,35,500,0,4,500,0,0
"Oceania","2024-09-09",0,0,500,0,12,512,0,0
"Oceania","2024-09-10",0,0,500,0,12,524,0,0
"Oceania","2024-09-11",0,0,500,0,12,536,0,0
"Oceania","2024-09-12",0,0,500,0,12,548,0,0
"Oceania","2024-09-13",0,0,500,0,12,560,0,0
"Oceania","2024-09-14",0,0,500,0,12,572,0,0
"Oceania","2024-09-15",0,84,584,0,12,584,0,0
"Oceania","2024-09-16",0,0,584,0,13,597,0,0
"Oceania","2024-09-17",0,0,584,0,13,610,0,0
"Oceania","2024-09-18",0,0,584,0,13,623,0,0
"Oceania","2024-09-19",0,0,584,0,14,637,0,0
"Oceania","2024-09-20",0,0,584,0,13,650,0,0
"Oceania","2024-09-21",0,0,584,0,13,663,0,0
"Oceania","2024-09-22",0,92,676,0,13,676,0,0
"Oceania","2024-09-23",0,0,676,0,13,689,0,0
"Oceania","2024-09-24",0,0,676,0,13,702,0,0
"Oceania","2024-09-25",0,0,676,0,13,715,0,0
"Oceania","2024-09-26",0,0,676,0,13,728,0,0
"Oceania","2024-09-27",0,0,676,0,13,741,0,0
"Oceania","2024-09-28",0,0,676,0,13,754,0,0
"Oceania","2024-09-29",0,91,767,0,13,767,0,0
"Oceania","2024-09-30",0,0,767,0,10,777,0,0
"Oceania","2024-10-01",0,0,767,0,11,788,0,0
"Oceania","2024-10-02",0,0,767,0,10,798,0,0
"Oceania","2024-10-03",0,0,767,0,10,808,0,0
"Oceania","2024-10-04",0,0,767,0,10,818,0,0
"Oceania","2024-10-05",0,0,767,0,11,829,0,0
"Oceania","2024-10-06",0,72,839,0,10,839,0,0
"Oceania","2024-10-07",0,23,862,0,23,862,0,0
"Oceania","2024-10-08",0,0,862,0,9,871,0,0
"Oceania","2024-10-09",0,0,862,0,9,880,0,0
"Oceania","2024-10-10",0,0,862,0,9,889,0,0
"Oceania","2024-10-11",0,0,862,0,9,898,0,0
"Oceania","2024-10-12",0,0,862,0,9,907,0,0
"Oceania","2024-10-13",0,54,916,0,9,916,0,0
"Oceania","2024-10-14",0,0,916,0,6,922,0,0
"Oceania","2024-10-15",0,12,928,0,6,928,0,0
"Oceania","2024-10-16",0,0,928,0,16,944,0,0
"Oceania","2024-10-17",0,0,928,0,16,960,0,0
"Oceania","2024-10-18",0,0,928,0,15,975,0,0
"Oceania","2024-10-19",0,0,928,0,16,991,0,0
"Oceania","2024-10-20",0,79,1007,0,16,1007,0,0
"Oceania","2024-10-21",0,0,1007,0,10,1017,0,0
"Oceania","2024-10-22",0,0,1007,0,9,1026,0,0
"Oceania","2024-10-23",0,0,1007,0,10,1036,0,0
"Oceania","2024-10-24",0,0,1007,0,10,1046,0,0
"Oceania","2024-10-25",0,0,1007,0,10,1056,0,0
"Oceania","2024-10-26",0,0,1007,0,9,1065,0,0
"Oceania","2024-10-27",0,68,1075,0,10,1075,0,0
"Oceania","2024-10-28",0,0,1075,0,11,1086,0,0
"Oceania","2024-10-29",0,0,1075,0,12,1098,0,0
"Oceania","2024-10-30",0,0,1075,0,11,1109,0,0
"Oceania","2024-10-31",0,0,1075,0,11,1120,0,0
"Oceania","2024-11-01",0,0,1075,0,11,1131,0,0
"Oceania","2024-11-02",0,0,1075,0,12,1143,0,0
"Oceania","2024-11-03",0,79,1154,0,11,1154,0,0
"Oceania","2024-11-04",0,1,1155,0,1,1155,0,0
"Oceania","2024-11-05",0,0,1155,0,10,1165,0,0
"Oceania","2024-11-06",0,0,1155,0,9,1174,0,0
"Oceania","2024-11-07",0,0,1155,0,9,1183,0,0
"Oceania","2024-11-08",0,0,1155,0,10,1193,0,0
"Oceania","2024-11-09",0,0,1155,0,10,1203,0,0
"Oceania","2024-11-10",0,57,1212,0,9,1212,0,0
"Oceania","2024-11-11",0,0,1212,0,0,1212,0,0
"Oceania","2024-11-12",0,0,1212,0,0,1212,0,0
"Oceania","2024-11-13",0,0,1212,0,0,1212,0,0
"Oceania","2024-11-14",0,0,1212,0,0,1212,0,0
"Oceania","2024-11-15",0,0,1212,0,0,1212,0,0
"Oceania","2024-11-16",0,0,1212,0,0,1212,0,0
"Oceania","2024-11-17",0,0,1212,0,0,1212,0,0
"Oceania","2024-11-18",0,0,1212,0,0,1212,0,0
"Oceania","2024-11-19",0,0,1212,0,0,1212,0,0
"Oceania","2024-11-20",0,0,1212,0,0,1212,0,0
"Oceania","2024-11-21",0,0,1212,0,0,1212,0,0
"Oceania","2024-11-22",0,0,1212,0,0,1212,0,0
"Oceania","2024-11-23",0,0,1212,0,0,1212,0,0
"Oceania","2024-11-24",0,0,1212,0,0,1212,0,0
"Oceania","2024-11-25",0,0,1212,0,0,1212,0,0
"Oceania","2024-11-26",0,0,1212,0,0,1212,0,0
"Oceania","2024-11-27",0,0,1212,0,0,1212,0,0
"Oceania","2024-11-28",0,0,1212,0,0,1212,0,0
"Oceania","2024-11-29",0,0,1212,0,0,1212,0,0
"Oceania","2024-11-30",0,0,1212,0,0,1212,0,0
"Oceania","2024-12-01",0,0,1212,0,0,1212,0,0
"Oceania","2024-12-02",0,0,1212,0,0,1212,0,0
"Oceania","2024-12-03",0,0,1212,0,0,1212,0,0
"Oceania","2024-12-04",0,0,1212,0,0,1212,0,0
"Oceania","2024-12-05",0,0,1212,0,0,1212,0,0
"Oceania","2024-12-06",0,0,1212,0,0,1212,0,0
"Oceania","2024-12-07",0,0,1212,0,0,1212,0,0
"Oceania","2024-12-08",0,0,1212,0,0,1212,0,0
"Oceania","2024-12-09",0,0,1212,0,0,1212,0,0
"Oman","2024-01-01",0,0,0,0,0,0,0,0
"Oman","2024-01-02",0,0,0,0,0,0,0,0
"Oman","2024-01-03",0,0,0,0,0,0,0,0
"Oman","2024-01-04",0,0,0,0,0,0,0,0
"Oman","2024-01-05",0,0,0,0,0,0,0,0
"Oman","2024-01-06",0,0,0,0,0,0,0,0
"Oman","2024-01-07",0,0,0,0,0,0,0,0
"Oman","2024-01-08",0,0,0,0,0,0,0,0
"Oman","2024-01-09",0,0,0,0,0,0,0,0
"Oman","2024-01-10",0,0,0,0,0,0,0,0
"Oman","2024-01-11",0,0,0,0,0,0,0,0
"Oman","2024-01-12",0,0,0,0,0,0,0,0
"Oman","2024-01-13",0,0,0,0,0,0,0,0
"Oman","2024-01-14",0,0,0,0,0,0,0,0
"Oman","2024-01-15",0,0,0,0,0,0,0,0
"Oman","2024-01-16",0,0,0,0,0,0,0,0
"Oman","2024-01-17",0,0,0,0,0,0,0,0
"Oman","2024-01-18",0,0,0,0,0,0,0,0
"Oman","2024-01-19",0,0,0,0,0,0,0,0
"Oman","2024-01-20",0,0,0,0,0,0,0,0
"Oman","2024-01-21",0,0,0,0,0,0,0,0
"Oman","2024-01-22",0,0,0,0,0,0,0,0
"Oman","2024-01-23",0,0,0,0,0,0,0,0
"Oman","2024-01-24",0,0,0,0,0,0,0,0
"Oman","2024-01-25",0,0,0,0,0,0,0,0
"Oman","2024-01-26",0,0,0,0,0,0,0,0
"Oman","2024-01-27",0,0,0,0,0,0,0,0
"Oman","2024-01-28",0,0,0,0,0,0,0,0
"Oman","2024-01-29",0,0,0,0,0,0,0,0
"Oman","2024-01-30",0,0,0,0,0,0,0,0
"Oman","2024-01-31",0,0,0,0,0,0,0,0
"Oman","2024-02-01",0,0,0,0,0,0,0,0
"Oman","2024-02-02",0,0,0,0,0,0,0,0
"Oman","2024-02-03",0,0,0,0,0,0,0,0
"Oman","2024-02-04",0,0,0,0,0,0,0,0
"Oman","2024-02-05",0,0,0,0,0,0,0,0
"Oman","2024-02-06",0,0,0,0,0,0,0,0
"Oman","2024-02-07",0,0,0,0,0,0,0,0
"Oman","2024-02-08",0,0,0,0,0,0,0,0
"Oman","2024-02-09",0,0,0,0,0,0,0,0
"Oman","2024-02-10",0,0,0,0,0,0,0,0
"Oman","2024-02-11",0,0,0,0,0,0,0,0
"Oman","2024-02-12",0,0,0,0,0,0,0,0
"Oman","2024-02-13",0,0,0,0,0,0,0,0
"Oman","2024-02-14",0,0,0,0,0,0,0,0
"Oman","2024-02-15",0,0,0,0,0,0,0,0
"Oman","2024-02-16",0,0,0,0,0,0,0,0
"Oman","2024-02-17",0,0,0,0,0,0,0,0
"Oman","2024-02-18",0,0,0,0,0,0,0,0
"Oman","2024-02-19",0,0,0,0,0,0,0,0
"Oman","2024-02-20",0,0,0,0,0,0,0,0
"Oman","2024-02-21",0,0,0,0,0,0,0,0
"Oman","2024-02-22",0,0,0,0,0,0,0,0
"Oman","2024-02-23",0,0,0,0,0,0,0,0
"Oman","2024-02-24",0,0,0,0,0,0,0,0
"Oman","2024-02-25",0,0,0,0,0,0,0,0
"Oman","2024-02-26",0,0,0,0,0,0,0,0
"Oman","2024-02-27",0,0,0,0,0,0,0,0
"Oman","2024-02-28",0,0,0,0,0,0,0,0
"Oman","2024-02-29",0,0,0,0,0,0,0,0
"Oman","2024-03-01",0,0,0,0,0,0,0,0
"Oman","2024-03-02",0,0,0,0,0,0,0,0
"Oman","2024-03-03",0,0,0,0,0,0,0,0
"Oman","2024-03-04",0,0,0,0,0,0,0,0
"Oman","2024-03-05",0,0,0,0,0,0,0,0
"Oman","2024-03-06",0,0,0,0,0,0,0,0
"Oman","2024-03-07",0,0,0,0,0,0,0,0
"Oman","2024-03-08",0,0,0,0,0,0,0,0
"Oman","2024-03-09",0,0,0,0,0,0,0,0
"Oman","2024-03-10",0,0,0,0,0,0,0,0
"Oman","2024-03-11",0,0,0,0,0,0,0,0
"Oman","2024-03-12",0,0,0,0,0,0,0,0
"Oman","2024-03-13",0,0,0,0,0,0,0,0
"Oman","2024-03-14",0,0,0,0,0,0,0,0
"Oman","2024-03-15",0,0,0,0,0,0,0,0
"Oman","2024-03-16",0,0,0,0,0,0,0,0
"Oman","2024-03-17",0,0,0,0,0,0,0,0
"Oman","2024-03-18",0,0,0,0,0,0,0,0
"Oman","2024-03-19",0,0,0,0,0,0,0,0
"Oman","2024-03-20",0,0,0,0,0,0,0,0
"Oman","2024-03-21",0,0,0,0,0,0,0,0
"Oman","2024-03-22",0,0,0,0,0,0,0,0
"Oman","2024-03-23",0,0,0,0,0,0,0,0
"Oman","2024-03-24",0,0,0,0,0,0,0,0
"Oman","2024-03-25",0,0,0,0,0,0,0,0
"Oman","2024-03-26",0,0,0,0,0,0,0,0
"Oman","2024-03-27",0,0,0,0,0,0,0,0
"Oman","2024-03-28",0,0,0,0,0,0,0,0
"Oman","2024-03-29",0,0,0,0,0,0,0,0
"Oman","2024-03-30",0,0,0,0,0,0,0,0
"Oman","2024-03-31",0,0,0,0,0,0,0,0
"Oman","2024-04-01",0,0,0,0,0,0,0,0
"Oman","2024-04-02",0,0,0,0,0,0,0,0
"Oman","2024-04-03",0,0,0,0,0,0,0,0
"Oman","2024-04-04",0,0,0,0,0,0,0,0
"Oman","2024-04-05",0,0,0,0,0,0,0,0
"Oman","2024-04-06",0,0,0,0,0,0,0,0
"Oman","2024-04-07",0,0,0,0,0,0,0,0
"Oman","2024-04-08",0,0,0,0,0,0,0,0
"Oman","2024-04-09",0,0,0,0,0,0,0,0
"Oman","2024-04-10",0,0,0,0,0,0,0,0
"Oman","2024-04-11",0,0,0,0,0,0,0,0
"Oman","2024-04-12",0,0,0,0,0,0,0,0
"Oman","2024-04-13",0,0,0,0,0,0,0,0
"Oman","2024-04-14",0,0,0,0,0,0,0,0
"Oman","2024-04-15",0,0,0,0,0,0,0,0
"Oman","2024-04-16",0,0,0,0,0,0,0,0
"Oman","2024-04-17",0,0,0,0,0,0,0,0
"Oman","2024-04-18",0,0,0,0,0,0,0,0
"Oman","2024-04-19",0,0,0,0,0,0,0,0
"Oman","2024-04-20",0,0,0,0,0,0,0,0
"Oman","2024-04-21",0,0,0,0,0,0,0,0
"Oman","2024-04-22",0,0,0,0,0,0,0,0
"Oman","2024-04-23",0,0,0,0,0,0,0,0
"Oman","2024-04-24",0,0,0,0,0,0,0,0
"Oman","2024-04-25",0,0,0,0,0,0,0,0
"Oman","2024-04-26",0,0,0,0,0,0,0,0
"Oman","2024-04-27",0,0,0,0,0,0,0,0
"Oman","2024-04-28",0,0,0,0,0,0,0,0
"Oman","2024-04-29",0,0,0,0,0,0,0,0
"Oman","2024-04-30",0,0,0,0,0,0,0,0
"Oman","2024-05-01",0,0,0,0,0,0,0,0
"Oman","2024-05-02",0,0,0,0,0,0,0,0
"Oman","2024-05-03",0,0,0,0,0,0,0,0
"Oman","2024-05-04",0,0,0,0,0,0,0,0
"Oman","2024-05-05",0,0,0,0,0,0,0,0
"Oman","2024-05-06",0,0,0,0,0,0,0,0
"Oman","2024-05-07",0,0,0,0,0,0,0,0
"Oman","2024-05-08",0,0,0,0,0,0,0,0
"Oman","2024-05-09",0,0,0,0,0,0,0,0
"Oman","2024-05-10",0,0,0,0,0,0,0,0
"Oman","2024-05-11",0,0,0,0,0,0,0,0
"Oman","2024-05-12",0,0,0,0,0,0,0,0
"Oman","2024-05-13",0,0,0,0,0,0,0,0
"Oman","2024-05-14",0,0,0,0,0,0,0,0
"Oman","2024-05-15",0,0,0,0,0,0,0,0
"Oman","2024-05-16",0,0,0,0,0,0,0,0
"Oman","2024-05-17",0,0,0,0,0,0,0,0
"Oman","2024-05-18",0,0,0,0,0,0,0,0
"Oman","2024-05-19",0,0,0,0,0,0,0,0
"Oman","2024-05-20",0,0,0,0,0,0,0,0
"Oman","2024-05-21",0,0,0,0,0,0,0,0
"Oman","2024-05-22",0,0,0,0,0,0,0,0
"Oman","2024-05-23",0,0,0,0,0,0,0,0
"Oman","2024-05-24",0,0,0,0,0,0,0,0
"Oman","2024-05-25",0,0,0,0,0,0,0,0
"Oman","2024-05-26",0,0,0,0,0,0,0,0
"Oman","2024-05-27",0,0,0,0,0,0,0,0
"Oman","2024-05-28",0,0,0,0,0,0,0,0
"Oman","2024-05-29",0,0,0,0,0,0,0,0
"Oman","2024-05-30",0,0,0,0,0,0,0,0
"Oman","2024-05-31",0,0,0,0,0,0,0,0
"Oman","2024-06-01",0,0,0,0,0,0,0,0
"Oman","2024-06-02",0,0,0,0,0,0,0,0
"Oman","2024-06-03",0,0,0,0,0,0,0,0
"Oman","2024-06-04",0,0,0,0,0,0,0,0
"Oman","2024-06-05",0,0,0,0,0,0,0,0
"Oman","2024-06-06",0,0,0,0,0,0,0,0
"Oman","2024-06-07",0,0,0,0,0,0,0,0
"Oman","2024-06-08",0,0,0,0,0,0,0,0
"Oman","2024-06-09",0,0,0,0,0,0,0,0
"Oman","2024-06-10",0,0,0,0,0,0,0,0
"Oman","2024-06-11",0,0,0,0,0,0,0,0
"Oman","2024-06-12",0,0,0,0,0,0,0,0
"Oman","2024-06-13",0,0,0,0,0,0,0,0
"Oman","2024-06-14",0,0,0,0,0,0,0,0
"Oman","2024-06-15",0,0,0,0,0,0,0,0
"Oman","2024-06-16",0,0,0,0,0,0,0,0
"Oman","2024-06-17",0,0,0,0,0,0,0,0
"Oman","2024-06-18",0,0,0,0,0,0,0,0
"Oman","2024-06-19",0,0,0,0,0,0,0,0
"Oman","2024-06-20",0,0,0,0,0,0,0,0
"Oman","2024-06-21",0,0,0,0,0,0,0,0
"Oman","2024-06-22",0,0,0,0,0,0,0,0
"Oman","2024-06-23",0,0,0,0,0,0,0,0
"Oman","2024-06-24",0,0,0,0,0,0,0,0
"Oman","2024-06-25",0,0,0,0,0,0,0,0
"Oman","2024-06-26",0,0,0,0,0,0,0,0
"Oman","2024-06-27",0,0,0,0,0,0,0,0
"Oman","2024-06-28",0,0,0,0,0,0,0,0
"Oman","2024-06-29",0,0,0,0,0,0,0,0
"Oman","2024-06-30",0,0,0,0,0,0,0,0
"Oman","2024-07-01",0,0,0,0,0,0,0,0
"Oman","2024-07-02",0,0,0,0,0,0,0,0
"Oman","2024-07-03",0,0,0,0,0,0,0,0
"Oman","2024-07-04",0,0,0,0,0,0,0,0
"Oman","2024-07-05",0,0,0,0,0,0,0,0
"Oman","2024-07-06",0,0,0,0,0,0,0,0
"Oman","2024-07-07",0,0,0,0,0,0,0,0
"Oman","2024-07-08",0,0,0,0,0,0,0,0
"Oman","2024-07-09",0,0,0,0,0,0,0,0
"Oman","2024-07-10",0,0,0,0,0,0,0,0
"Oman","2024-07-11",0,0,0,0,0,0,0,0
"Oman","2024-07-12",0,0,0,0,0,0,0,0
"Oman","2024-07-13",0,0,0,0,0,0,0,0
"Oman","2024-07-14",0,0,0,0,0,0,0,0
"Oman","2024-07-15",0,0,0,0,0,0,0,0
"Oman","2024-07-16",0,0,0,0,0,0,0,0
"Oman","2024-07-17",0,0,0,0,0,0,0,0
"Oman","2024-07-18",0,0,0,0,0,0,0,0
"Oman","2024-07-19",0,0,0,0,0,0,0,0
"Oman","2024-07-20",0,0,0,0,0,0,0,0
"Oman","2024-07-21",0,0,0,0,0,0,0,0
"Oman","2024-07-22",0,0,0,0,0,0,0,0
"Oman","2024-07-23",0,0,0,0,0,0,0,0
"Oman","2024-07-24",0,0,0,0,0,0,0,0
"Oman","2024-07-25",0,0,0,0,0,0,0,0
"Oman","2024-07-26",0,0,0,0,0,0,0,0
"Oman","2024-07-27",0,0,0,0,0,0,0,0
"Oman","2024-07-28",0,0,0,0,0,0,0,0
"Oman","2024-07-29",0,0,0,0,0,0,0,0
"Oman","2024-07-30",0,0,0,0,0,0,0,0
"Oman","2024-07-31",0,0,0,0,0,0,0,0
"Oman","2024-08-01",0,0,0,0,0,0,0,0
"Oman","2024-08-02",0,0,0,0,0,0,0,0
"Oman","2024-08-03",0,0,0,0,0,0,0,0
"Oman","2024-08-04",0,0,0,0,0,0,0,0
"Oman","2024-08-05",0,0,0,0,0,0,0,0
"Oman","2024-08-06",0,0,0,0,0,0,0,0
"Oman","2024-08-07",0,0,0,0,0,0,0,0
"Oman","2024-08-08",0,0,0,0,0,0,0,0
"Oman","2024-08-09",0,0,0,0,0,0,0,0
"Oman","2024-08-10",0,0,0,0,0,0,0,0
"Oman","2024-08-11",0,0,0,0,0,0,0,0
"Oman","2024-08-12",0,0,0,0,0,0,0,0
"Oman","2024-08-13",0,0,0,0,0,0,0,0
"Oman","2024-08-14",0,0,0,0,0,0,0,0
"Oman","2024-08-15",0,0,0,0,0,0,0,0
"Oman","2024-08-16",0,0,0,0,0,0,0,0
"Oman","2024-08-17",0,0,0,0,0,0,0,0
"Oman","2024-08-18",0,0,0,0,0,0,0,0
"Oman","2024-08-19",0,0,0,0,0,0,0,0
"Oman","2024-08-20",0,0,0,0,0,0,0,0
"Oman","2024-08-21",0,0,0,0,0,0,0,0
"Oman","2024-08-22",0,0,0,0,0,0,0,0
"Oman","2024-08-23",0,0,0,0,0,0,0,0
"Oman","2024-08-24",0,0,0,0,0,0,0,0
"Oman","2024-08-25",0,0,0,0,0,0,0,0
"Oman","2024-08-26",0,0,0,0,0,0,0,0
"Oman","2024-08-27",0,0,0,0,0,0,0,0
"Oman","2024-08-28",0,0,0,0,0,0,0,0
"Oman","2024-08-29",0,0,0,0,0,0,0,0
"Oman","2024-08-30",0,0,0,0,0,0,0,0
"Oman","2024-08-31",0,0,0,0,0,0,0,0
"Oman","2024-09-01",0,0,0,0,0,0,0,0
"Oman","2024-09-02",0,0,0,0,0,0,0,0
"Oman","2024-09-03",0,0,0,0,0,0,0,0
"Oman","2024-09-04",0,0,0,0,0,0,0,0
"Oman","2024-09-05",0,0,0,0,0,0,0,0
"Oman","2024-09-06",0,0,0,0,0,0,0,0
"Oman","2024-09-07",0,0,0,0,0,0,0,0
"Oman","2024-09-08",0,0,0,0,0,0,0,0
"Oman","2024-09-09",0,0,0,0,0,0,0,0
"Oman","2024-09-10",0,0,0,0,0,0,0,0
"Oman","2024-09-11",0,0,0,0,0,0,0,0
"Oman","2024-09-12",0,0,0,0,0,0,0,0
"Oman","2024-09-13",0,0,0,0,0,0,0,0
"Oman","2024-09-14",0,0,0,0,0,0,0,0
"Oman","2024-09-15",0,0,0,0,0,0,0,0
"Oman","2024-09-16",0,0,0,0,0,0,0,0
"Oman","2024-09-17",0,0,0,0,0,0,0,0
"Oman","2024-09-18",0,0,0,0,0,0,0,0
"Oman","2024-09-19",0,0,0,0,0,0,0,0
"Oman","2024-09-20",0,0,0,0,0,0,0,0
"Oman","2024-09-21",0,0,0,0,0,0,0,0
"Oman","2024-09-22",0,0,0,0,0,0,0,0
"Oman","2024-09-23",0,0,0,0,0,0,0,0
"Oman","2024-09-24",0,0,0,0,0,0,0,0
"Oman","2024-09-25",0,0,0,0,0,0,0,0
"Oman","2024-09-26",0,0,0,0,0,0,0,0
"Oman","2024-09-27",0,0,0,0,0,0,0,0
"Oman","2024-09-28",0,0,0,0,0,0,0,0
"Oman","2024-09-29",0,0,0,0,0,0,0,0
"Oman","2024-09-30",0,0,0,0,0,0,0,0
"Oman","2024-10-01",0,0,0,0,0,0,0,0
"Oman","2024-10-02",0,1,1,0,1,1,0,0
"Oman","2024-10-03",0,0,1,0,0,1,0,0
"Oman","2024-10-04",0,0,1,0,0,1,0,0
"Oman","2024-10-05",0,0,1,0,0,1,0,0
"Oman","2024-10-06",0,0,1,0,0,1,0,0
"Oman","2024-10-07",0,0,1,0,0,1,0,0
"Oman","2024-10-08",0,0,1,0,0,1,0,0
"Oman","2024-10-09",0,0,1,0,0,1,0,0
"Oman","2024-10-10",0,0,1,0,0,1,0,0
"Oman","2024-10-11",0,0,1,0,0,1,0,0
"Oman","2024-10-12",0,0,1,0,0,1,0,0
"Oman","2024-10-13",0,0,1,0,0,1,0,0
"Oman","2024-10-14",0,0,1,0,0,1,0,0
"Oman","2024-10-15",0,0,1,0,0,1,0,0
"Oman","2024-10-16",0,0,1,0,0,1,0,0
"Oman","2024-10-17",0,0,1,0,0,1,0,0
"Oman","2024-10-18",0,0,1,0,0,1,0,0
"Oman","2024-10-19",0,0,1,0,0,1,0,0
"Oman","2024-10-20",0,0,1,0,0,1,0,0
"Oman","2024-10-21",0,0,1,0,0,1,0,0
"Oman","2024-10-22",0,0,1,0,0,1,0,0
"Oman","2024-10-23",0,0,1,0,0,1,0,0
"Oman","2024-10-24",0,0,1,0,0,1,0,0
"Oman","2024-10-25",0,0,1,0,0,1,0,0
"Oman","2024-10-26",0,0,1,0,0,1,0,0
"Oman","2024-10-27",0,0,1,0,0,1,0,0
"Oman","2024-10-28",0,0,1,0,0,1,0,0
"Oman","2024-10-29",0,0,1,0,0,1,0,0
"Oman","2024-10-30",0,0,1,0,0,1,0,0
"Oman","2024-10-31",0,0,1,0,0,1,0,0
"Oman","2024-11-01",0,0,1,0,0,1,0,0
"Oman","2024-11-02",0,0,1,0,0,1,0,0
"Oman","2024-11-03",0,0,1,0,0,1,0,0
"Oman","2024-11-04",0,0,1,0,0,1,0,0
"Oman","2024-11-05",0,0,1,0,0,1,0,0
"Oman","2024-11-06",0,0,1,0,0,1,0,0
"Oman","2024-11-07",0,0,1,0,0,1,0,0
"Oman","2024-11-08",0,0,1,0,0,1,0,0
"Oman","2024-11-09",0,0,1,0,0,1,0,0
"Oman","2024-11-10",0,0,1,0,0,1,0,0
"Oman","2024-11-11",0,0,1,0,0,1,0,0
"Oman","2024-11-12",0,0,1,0,0,1,0,0
"Oman","2024-11-13",0,0,1,0,0,1,0,0
"Oman","2024-11-14",0,0,1,0,0,1,0,0
"Oman","2024-11-15",0,0,1,0,0,1,0,0
"Oman","2024-11-16",0,0,1,0,0,1,0,0
"Oman","2024-11-17",0,0,1,0,0,1,0,0
"Oman","2024-11-18",0,0,1,0,0,1,0,0
"Oman","2024-11-19",0,0,1,0,0,1,0,0
"Oman","2024-11-20",0,0,1,0,0,1,0,0
"Oman","2024-11-21",0,0,1,0,0,1,0,0
"Oman","2024-11-22",0,0,1,0,0,1,0,0
"Oman","2024-11-23",0,0,1,0,0,1,0,0
"Oman","2024-11-24",0,0,1,0,0,1,0,0
"Oman","2024-11-25",0,0,1,0,0,1,0,0
"Oman","2024-11-26",0,0,1,0,0,1,0,0
"Oman","2024-11-27",0,0,1,0,0,1,0,0
"Oman","2024-11-28",0,0,1,0,0,1,0,0
"Oman","2024-11-29",0,0,1,0,0,1,0,0
"Oman","2024-11-30",0,0,1,0,0,1,0,0
"Oman","2024-12-01",0,0,1,0,0,1,0,0
"Oman","2024-12-02",0,0,1,0,0,1,0,0
"Oman","2024-12-03",0,0,1,0,0,1,0,0
"Oman","2024-12-04",0,0,1,0,0,1,0,0
"Oman","2024-12-05",0,0,1,0,0,1,0,0
"Oman","2024-12-06",0,0,1,0,0,1,0,0
"Oman","2024-12-07",0,0,1,0,0,1,0,0
"Oman","2024-12-08",0,0,1,0,0,1,0,0
"Oman","2024-12-09",0,0,1,0,0,1,0,0
"Pakistan","2024-01-01",0,0,0,0,0,0,0,0
"Pakistan","2024-01-02",0,0,0,0,0,0,0,0
"Pakistan","2024-01-03",0,0,0,0,0,0,0,0
"Pakistan","2024-01-04",0,0,0,0,0,0,0,0
"Pakistan","2024-01-05",0,0,0,0,0,0,0,0
"Pakistan","2024-01-06",0,0,0,0,0,0,0,0
"Pakistan","2024-01-07",0,0,0,0,0,0,0,0
"Pakistan","2024-01-08",0,0,0,0,0,0,0,0
"Pakistan","2024-01-09",0,0,0,0,0,0,0,0
"Pakistan","2024-01-10",0,0,0,0,0,0,0,0
"Pakistan","2024-01-11",0,0,0,0,0,0,0,0
"Pakistan","2024-01-12",0,0,0,0,0,0,0,0
"Pakistan","2024-01-13",0,0,0,0,0,0,0,0
"Pakistan","2024-01-14",0,0,0,0,0,0,0,0
"Pakistan","2024-01-15",0,0,0,0,0,0,0,0
"Pakistan","2024-01-16",0,0,0,0,0,0,0,0
"Pakistan","2024-01-17",0,0,0,0,0,0,0,0
"Pakistan","2024-01-18",0,0,0,0,0,0,0,0
"Pakistan","2024-01-19",0,1,1,0,1,1,0,0
"Pakistan","2024-01-20",0,0,1,0,0,1,0,0
"Pakistan","2024-01-21",0,0,1,0,0,1,0,0
"Pakistan","2024-01-22",0,0,1,0,0,1,0,0
"Pakistan","2024-01-23",0,0,1,0,0,1,0,0
"Pakistan","2024-01-24",0,0,1,0,0,1,0,0
"Pakistan","2024-01-25",0,0,1,0,0,1,0,0
"Pakistan","2024-01-26",0,0,1,0,0,1,0,0
"Pakistan","2024-01-27",0,0,1,0,0,1,0,0
"Pakistan","2024-01-28",0,0,1,0,0,1,0,0
"Pakistan","2024-01-29",0,0,1,0,0,1,0,0
"Pakistan","2024-01-30",0,0,1,0,0,1,0,0
"Pakistan","2024-01-31",0,0,1,0,0,1,0,0
"Pakistan","2024-02-01",0,0,1,0,0,1,0,0
"Pakistan","2024-02-02",0,0,1,0,0,1,0,0
"Pakistan","2024-02-03",0,0,1,0,0,1,0,0
"Pakistan","2024-02-04",0,0,1,0,0,1,0,0
"Pakistan","2024-02-05",0,0,1,0,0,1,0,0
"Pakistan","2024-02-06",0,0,1,0,0,1,0,0
"Pakistan","2024-02-07",0,0,1,0,0,1,0,0
"Pakistan","2024-02-08",0,0,1,0,0,1,0,0
"Pakistan","2024-02-09",0,0,1,0,0,1,0,0
"Pakistan","2024-02-10",0,0,1,0,0,1,0,0
"Pakistan","2024-02-11",0,0,1,0,0,1,0,0
"Pakistan","2024-02-12",0,0,1,0,0,1,0,0
"Pakistan","2024-02-13",0,0,1,0,0,1,0,0
"Pakistan","2024-02-14",0,0,1,0,0,1,0,0
"Pakistan","2024-02-15",0,0,1,0,0,1,0,0
"Pakistan","2024-02-16",0,0,1,0,0,1,0,0
"Pakistan","2024-02-17",0,0,1,0,0,1,0,0
"Pakistan","2024-02-18",0,0,1,0,0,1,0,0
"Pakistan","2024-02-19",0,0,1,0,0,1,0,0
"Pakistan","2024-02-20",0,0,1,0,0,1,0,0
"Pakistan","2024-02-21",0,0,1,0,0,1,0,0
"Pakistan","2024-02-22",0,0,1,0,0,1,0,0
"Pakistan","2024-02-23",0,0,1,0,0,1,0,0
"Pakistan","2024-02-24",0,0,1,0,0,1,0,0
"Pakistan","2024-02-25",0,0,1,0,0,1,0,0
"Pakistan","2024-02-26",0,0,1,0,0,1,0,0
"Pakistan","2024-02-27",0,0,1,0,0,1,0,0
"Pakistan","2024-02-28",0,0,1,0,0,1,0,0
"Pakistan","2024-02-29",0,0,1,0,0,1,0,0
"Pakistan","2024-03-01",0,0,1,0,0,1,0,0
"Pakistan","2024-03-02",0,0,1,0,0,1,0,0
"Pakistan","2024-03-03",0,0,1,0,0,1,0,0
"Pakistan","2024-03-04",0,0,1,0,0,1,0,0
"Pakistan","2024-03-05",0,0,1,0,0,1,0,0
"Pakistan","2024-03-06",0,0,1,0,0,1,0,0
"Pakistan","2024-03-07",0,0,1,0,0,1,0,0
"Pakistan","2024-03-08",0,0,1,0,0,1,0,0
"Pakistan","2024-03-09",0,0,1,0,0,1,0,0
"Pakistan","2024-03-10",0,0,1,0,0,1,0,0
"Pakistan","2024-03-11",0,0,1,0,0,1,0,0
"Pakistan","2024-03-12",0,0,1,0,0,1,0,0
"Pakistan","2024-03-13",0,0,1,0,0,1,0,0
"Pakistan","2024-03-14",0,0,1,0,0,1,0,0
"Pakistan","2024-03-15",0,0,1,0,0,1,0,0
"Pakistan","2024-03-16",0,0,1,0,0,1,0,0
"Pakistan","2024-03-17",0,0,1,0,0,1,0,0
"Pakistan","2024-03-18",0,0,1,0,0,1,0,0
"Pakistan","2024-03-19",0,0,1,0,0,1,0,0
"Pakistan","2024-03-20",0,0,1,0,0,1,0,0
"Pakistan","2024-03-21",0,0,1,0,0,1,0,0
"Pakistan","2024-03-22",0,0,1,0,0,1,0,0
"Pakistan","2024-03-23",0,0,1,0,0,1,0,0
"Pakistan","2024-03-24",0,0,1,0,0,1,0,0
"Pakistan","2024-03-25",0,0,1,0,0,1,0,0
"Pakistan","2024-03-26",0,0,1,0,0,1,0,0
"Pakistan","2024-03-27",0,0,1,0,0,1,0,0
"Pakistan","2024-03-28",0,0,1,0,0,1,0,0
"Pakistan","2024-03-29",0,0,1,0,0,1,0,0
"Pakistan","2024-03-30",0,0,1,0,0,1,0,0
"Pakistan","2024-03-31",0,0,1,0,0,1,0,0
"Pakistan","2024-04-01",0,0,1,0,0,1,0,0
"Pakistan","2024-04-02",0,0,1,0,0,1,0,0
"Pakistan","2024-04-03",0,0,1,0,0,1,0,0
"Pakistan","2024-04-04",0,0,1,0,0,1,0,0
"Pakistan","2024-04-05",0,0,1,0,0,1,0,0
"Pakistan","2024-04-06",0,0,1,0,0,1,0,0
"Pakistan","2024-04-07",0,0,1,0,0,1,0,0
"Pakistan","2024-04-08",0,0,1,0,0,1,0,0
"Pakistan","2024-04-09",0,0,1,0,0,1,0,0
"Pakistan","2024-04-10",0,0,1,0,0,1,0,0
"Pakistan","2024-04-11",0,0,1,0,0,1,0,0
"Pakistan","2024-04-12",0,0,1,0,0,1,0,0
"Pakistan","2024-04-13",0,0,1,0,0,1,0,0
"Pakistan","2024-04-14",0,0,1,0,0,1,0,0
"Pakistan","2024-04-15",0,0,1,0,0,1,0,0
"Pakistan","2024-04-16",0,0,1,0,0,1,0,0
"Pakistan","2024-04-17",0,0,1,0,0,1,0,0
"Pakistan","2024-04-18",0,0,1,0,0,1,0,0
"Pakistan","2024-04-19",0,0,1,0,0,1,0,0
"Pakistan","2024-04-20",0,0,1,0,0,1,0,0
"Pakistan","2024-04-21",0,0,1,0,0,1,0,0
"Pakistan","2024-04-22",0,0,1,0,0,1,0,0
"Pakistan","2024-04-23",0,0,1,0,0,1,0,0
"Pakistan","2024-04-24",0,0,1,0,0,1,0,0
"Pakistan","2024-04-25",0,0,1,0,0,1,0,0
"Pakistan","2024-04-26",0,0,1,0,0,1,0,0
"Pakistan","2024-04-27",0,0,1,0,0,1,0,0
"Pakistan","2024-04-28",0,0,1,0,0,1,0,0
"Pakistan","2024-04-29",0,0,1,0,0,1,0,0
"Pakistan","2024-04-30",0,0,1,0,0,1,0,0
"Pakistan","2024-05-01",0,0,1,0,0,1,0,0
"Pakistan","2024-05-02",0,0,1,0,0,1,0,0
"Pakistan","2024-05-03",0,0,1,0,1,2,0,0
"Pakistan","2024-05-04",0,0,1,0,0,2,0,0
"Pakistan","2024-05-05",0,0,1,0,0,2,0,0
"Pakistan","2024-05-06",0,0,1,0,0,2,0,0
"Pakistan","2024-05-07",0,0,1,0,0,2,0,0
"Pakistan","2024-05-08",0,0,1,0,0,2,0,0
"Pakistan","2024-05-09",0,0,1,0,0,2,0,0
"Pakistan","2024-05-10",0,0,1,0,0,2,0,0
"Pakistan","2024-05-11",0,0,1,0,0,2,0,0
"Pakistan","2024-05-12",0,0,1,0,0,2,0,0
"Pakistan","2024-05-13",0,0,1,0,0,2,0,0
"Pakistan","2024-05-14",0,0,1,0,0,2,0,0
"Pakistan","2024-05-15",0,0,1,0,0,2,0,0
"Pakistan","2024-05-16",0,0,1,0,0,2,0,0
"Pakistan","2024-05-17",0,0,1,0,0,2,0,0
"Pakistan","2024-05-18",0,0,1,0,0,2,0,0
"Pakistan","2024-05-19",0,0,1,0,0,2,0,0
"Pakistan","2024-05-20",0,0,1,0,0,2,0,0
"Pakistan","2024-05-21",0,0,1,0,0,2,0,0
"Pakistan","2024-05-22",0,0,1,0,0,2,0,0
"Pakistan","2024-05-23",0,0,1,0,0,2,0,0
"Pakistan","2024-05-24",0,0,1,0,0,2,0,0
"Pakistan","2024-05-25",0,0,1,0,0,2,0,0
"Pakistan","2024-05-26",0,0,1,0,0,2,0,0
"Pakistan","2024-05-27",0,0,1,0,0,2,0,0
"Pakistan","2024-05-28",0,0,1,0,0,2,0,0
"Pakistan","2024-05-29",0,0,1,0,0,2,0,0
"Pakistan","2024-05-30",0,0,1,0,0,2,0,0
"Pakistan","2024-05-31",0,0,1,0,0,2,0,0
"Pakistan","2024-06-01",0,0,1,0,0,2,0,0
"Pakistan","2024-06-02",0,0,1,0,0,2,0,0
"Pakistan","2024-06-03",0,0,1,0,0,2,0,0
"Pakistan","2024-06-04",0,0,1,0,0,2,0,0
"Pakistan","2024-06-05",0,0,1,0,0,2,0,0
"Pakistan","2024-06-06",0,0,1,0,0,2,0,0
"Pakistan","2024-06-07",0,0,1,0,0,2,0,0
"Pakistan","2024-06-08",0,0,1,0,0,2,0,0
"Pakistan","2024-06-09",0,0,1,0,0,2,0,0
"Pakistan","2024-06-10",0,0,1,0,0,2,0,0
"Pakistan","2024-06-11",0,0,1,0,0,2,0,0
"Pakistan","2024-06-12",0,0,1,0,0,2,0,0
"Pakistan","2024-06-13",0,0,1,0,0,2,0,0
"Pakistan","2024-06-14",0,0,1,0,0,2,0,0
"Pakistan","2024-06-15",0,0,1,0,0,2,0,0
"Pakistan","2024-06-16",0,0,1,0,0,2,0,0
"Pakistan","2024-06-17",0,0,1,0,0,2,0,0
"Pakistan","2024-06-18",0,0,1,0,0,2,0,0
"Pakistan","2024-06-19",0,0,1,0,0,2,0,0
"Pakistan","2024-06-20",0,0,1,0,0,2,0,0
"Pakistan","2024-06-21",0,0,1,0,0,2,0,0
"Pakistan","2024-06-22",0,0,1,0,0,2,0,0
"Pakistan","2024-06-23",0,0,1,0,0,2,0,0
"Pakistan","2024-06-24",0,0,1,0,0,2,0,0
"Pakistan","2024-06-25",0,0,1,0,0,2,0,0
"Pakistan","2024-06-26",0,0,1,0,0,2,0,0
"Pakistan","2024-06-27",0,0,1,0,0,2,0,0
"Pakistan","2024-06-28",0,0,1,0,0,2,0,0
"Pakistan","2024-06-29",0,0,1,0,0,2,0,0
"Pakistan","2024-06-30",0,0,1,0,0,2,0,0
"Pakistan","2024-07-01",0,0,1,0,0,2,0,0
"Pakistan","2024-07-02",0,0,1,0,0,2,0,0
"Pakistan","2024-07-03",0,0,1,0,0,2,0,0
"Pakistan","2024-07-04",0,0,1,0,0,2,0,0
"Pakistan","2024-07-05",0,0,1,0,0,2,0,0
"Pakistan","2024-07-06",0,0,1,0,0,2,0,0
"Pakistan","2024-07-07",0,0,1,0,0,2,0,0
"Pakistan","2024-07-08",0,0,1,0,0,2,0,0
"Pakistan","2024-07-09",0,0,1,0,0,2,0,0
"Pakistan","2024-07-10",0,0,1,0,0,2,0,0
"Pakistan","2024-07-11",0,0,1,0,0,2,0,0
"Pakistan","2024-07-12",0,0,1,0,0,2,0,0
"Pakistan","2024-07-13",0,0,1,0,0,2,0,0
"Pakistan","2024-07-14",0,0,1,0,0,2,0,0
"Pakistan","2024-07-15",0,0,1,0,0,2,0,0
"Pakistan","2024-07-16",0,0,1,0,0,2,0,0
"Pakistan","2024-07-17",0,0,1,0,0,2,0,0
"Pakistan","2024-07-18",0,0,1,0,0,2,0,0
"Pakistan","2024-07-19",0,0,1,0,0,2,0,0
"Pakistan","2024-07-20",0,0,1,0,0,2,0,0
"Pakistan","2024-07-21",0,0,1,0,0,2,0,0
"Pakistan","2024-07-22",0,0,1,0,0,2,0,0
"Pakistan","2024-07-23",0,0,1,0,0,2,0,0
"Pakistan","2024-07-24",0,0,1,0,0,2,0,0
"Pakistan","2024-07-25",0,0,1,0,0,2,0,0
"Pakistan","2024-07-26",0,0,1,0,0,2,0,0
"Pakistan","2024-07-27",0,0,1,0,0,2,0,0
"Pakistan","2024-07-28",0,0,1,0,0,2,0,0
"Pakistan","2024-07-29",0,0,1,0,0,2,0,0
"Pakistan","2024-07-30",0,0,1,0,0,2,0,0
"Pakistan","2024-07-31",0,0,1,0,0,2,0,0
"Pakistan","2024-08-01",0,0,1,0,0,2,0,0
"Pakistan","2024-08-02",0,0,1,0,0,2,0,0
"Pakistan","2024-08-03",0,0,1,0,0,2,0,0
"Pakistan","2024-08-04",0,0,1,0,0,2,0,0
"Pakistan","2024-08-05",0,0,1,0,0,2,0,0
"Pakistan","2024-08-06",0,0,1,0,0,2,0,0
"Pakistan","2024-08-07",0,0,1,0,0,2,0,0
"Pakistan","2024-08-08",0,0,1,0,0,2,0,0
"Pakistan","2024-08-09",0,0,1,0,0,2,0,0
"Pakistan","2024-08-10",0,0,1,0,0,2,0,0
"Pakistan","2024-08-11",0,0,1,0,0,2,0,0
"Pakistan","2024-08-12",0,0,1,0,0,2,0,0
"Pakistan","2024-08-13",0,0,1,0,0,2,0,0
"Pakistan","2024-08-14",0,1,2,0,0,2,0,0
"Pakistan","2024-08-15",0,0,2,0,0,2,0,0
"Pakistan","2024-08-16",0,0,2,0,0,2,0,0
"Pakistan","2024-08-17",0,0,2,0,0,2,0,0
"Pakistan","2024-08-18",0,0,2,0,0,2,0,0
"Pakistan","2024-08-19",0,0,2,0,0,2,0,0
"Pakistan","2024-08-20",0,0,2,0,0,2,0,0
"Pakistan","2024-08-21",0,0,2,0,0,2,0,0
"Pakistan","2024-08-22",0,0,2,0,0,2,0,0
"Pakistan","2024-08-23",0,0,2,0,0,2,0,0
"Pakistan","2024-08-24",0,0,2,0,0,2,0,0
"Pakistan","2024-08-25",0,0,2,0,0,2,0,0
"Pakistan","2024-08-26",0,0,2,0,0,2,0,0
"Pakistan","2024-08-27",0,0,2,0,0,2,0,0
"Pakistan","2024-08-28",0,0,2,0,0,2,0,0
"Pakistan","2024-08-29",0,0,2,0,0,2,0,0
"Pakistan","2024-08-30",0,0,2,0,0,2,0,0
"Pakistan","2024-08-31",0,0,2,0,0,2,0,0
"Pakistan","2024-09-01",0,0,2,0,0,2,0,0
"Pakistan","2024-09-02",0,0,2,0,0,2,0,0
"Pakistan","2024-09-03",0,0,2,0,0,2,0,0
"Pakistan","2024-09-04",0,0,2,0,0,2,0,0
"Pakistan","2024-09-05",0,0,2,0,0,2,0,0
"Pakistan","2024-09-06",0,0,2,0,0,2,0,0
"Pakistan","2024-09-07",0,0,2,0,0,2,0,0
"Pakistan","2024-09-08",0,0,2,0,0,2,0,0
"Pakistan","2024-09-09",0,0,2,0,0,2,0,0
"Pakistan","2024-09-10",0,0,2,0,0,2,0,0
"Pakistan","2024-09-11",0,0,2,0,0,2,0,0
"Pakistan","2024-09-12",0,0,2,0,0,2,0,0
"Pakistan","2024-09-13",0,0,2,0,0,2,0,0
"Pakistan","2024-09-14",0,0,2,0,0,2,0,0
"Pakistan","2024-09-15",0,0,2,0,0,2,0,0
"Pakistan","2024-09-16",0,0,2,0,0,2,0,0
"Pakistan","2024-09-17",0,0,2,0,0,2,0,0
"Pakistan","2024-09-18",0,0,2,0,0,2,0,0
"Pakistan","2024-09-19",0,0,2,0,0,2,0,0
"Pakistan","2024-09-20",0,0,2,0,0,2,0,0
"Pakistan","2024-09-21",0,0,2,0,0,2,0,0
"Pakistan","2024-09-22",0,0,2,0,0,2,0,0
"Pakistan","2024-09-23",0,0,2,0,0,2,0,0
"Pakistan","2024-09-24",0,0,2,0,0,2,0,0
"Pakistan","2024-09-25",0,0,2,0,0,2,0,0
"Pakistan","2024-09-26",0,0,2,0,0,2,0,0
"Pakistan","2024-09-27",0,0,2,0,0,2,0,0
"Pakistan","2024-09-28",0,0,2,0,0,2,0,0
"Pakistan","2024-09-29",0,0,2,0,0,2,0,0
"Pakistan","2024-09-30",0,0,2,0,0,2,0,0
"Pakistan","2024-10-01",0,0,2,0,0,2,0,0
"Pakistan","2024-10-02",0,0,2,0,0,2,0,0
"Pakistan","2024-10-03",0,0,2,0,0,2,0,0
"Pakistan","2024-10-04",0,0,2,0,0,2,0,0
"Pakistan","2024-10-05",0,0,2,0,0,2,0,0
"Pakistan","2024-10-06",0,0,2,0,0,2,0,0
"Pakistan","2024-10-07",0,0,2,0,0,2,0,0
"Pakistan","2024-10-08",0,0,2,0,0,2,0,0
"Pakistan","2024-10-09",0,0,2,0,0,2,0,0
"Pakistan","2024-10-10",0,0,2,0,0,2,0,0
"Pakistan","2024-10-11",0,0,2,0,0,2,0,0
"Pakistan","2024-10-12",0,0,2,0,0,2,0,0
"Pakistan","2024-10-13",0,0,2,0,0,2,0,0
"Pakistan","2024-10-14",0,0,2,0,0,2,0,0
"Pakistan","2024-10-15",0,0,2,0,0,2,0,0
"Pakistan","2024-10-16",0,0,2,0,0,2,0,0
"Pakistan","2024-10-17",0,0,2,0,0,2,0,0
"Pakistan","2024-10-18",0,0,2,0,0,2,0,0
"Pakistan","2024-10-19",0,0,2,0,0,2,0,0
"Pakistan","2024-10-20",0,0,2,0,0,2,0,0
"Pakistan","2024-10-21",0,0,2,0,0,2,0,0
"Pakistan","2024-10-22",0,0,2,0,0,2,0,0
"Pakistan","2024-10-23",0,0,2,0,0,2,0,0
"Pakistan","2024-10-24",0,0,2,0,0,2,0,0
"Pakistan","2024-10-25",0,0,2,0,0,2,0,0
"Pakistan","2024-10-26",0,0,2,0,0,2,0,0
"Pakistan","2024-10-27",0,0,2,0,0,2,0,0
"Pakistan","2024-10-28",0,0,2,0,0,2,0,0
"Pakistan","2024-10-29",0,0,2,0,0,2,0,0
"Pakistan","2024-10-30",0,0,2,0,0,2,0,0
"Pakistan","2024-10-31",0,0,2,0,0,2,0,0
"Pakistan","2024-11-01",0,0,2,0,0,2,0,0
"Pakistan","2024-11-02",0,0,2,0,0,2,0,0
"Pakistan","2024-11-03",0,0,2,0,0,2,0,0
"Pakistan","2024-11-04",0,0,2,0,0,2,0,0
"Pakistan","2024-11-05",0,0,2,0,0,2,0,0
"Pakistan","2024-11-06",0,0,2,0,0,2,0,0
"Pakistan","2024-11-07",0,0,2,0,0,2,0,0
"Pakistan","2024-11-08",0,0,2,0,0,2,0,0
"Pakistan","2024-11-09",0,0,2,0,0,2,0,0
"Pakistan","2024-11-10",0,0,2,0,0,2,0,0
"Pakistan","2024-11-11",0,0,2,0,0,2,0,0
"Pakistan","2024-11-12",0,0,2,0,0,2,0,0
"Pakistan","2024-11-13",0,0,2,0,0,2,0,0
"Pakistan","2024-11-14",0,0,2,0,0,2,0,0
"Pakistan","2024-11-15",0,0,2,0,0,2,0,0
"Pakistan","2024-11-16",0,0,2,0,0,2,0,0
"Pakistan","2024-11-17",0,0,2,0,0,2,0,0
"Pakistan","2024-11-18",0,0,2,0,0,2,0,0
"Pakistan","2024-11-19",0,0,2,0,0,2,0,0
"Pakistan","2024-11-20",0,0,2,0,0,2,0,0
"Pakistan","2024-11-21",0,0,2,0,0,2,0,0
"Pakistan","2024-11-22",0,0,2,0,0,2,0,0
"Pakistan","2024-11-23",0,0,2,0,0,2,0,0
"Pakistan","2024-11-24",0,0,2,0,0,2,0,0
"Pakistan","2024-11-25",0,0,2,0,0,2,0,0
"Pakistan","2024-11-26",0,0,2,0,0,2,0,0
"Pakistan","2024-11-27",0,0,2,0,0,2,0,0
"Pakistan","2024-11-28",0,0,2,0,0,2,0,0
"Pakistan","2024-11-29",0,0,2,0,0,2,0,0
"Pakistan","2024-11-30",0,0,2,0,0,2,0,0
"Pakistan","2024-12-01",0,0,2,0,0,2,0,0
"Pakistan","2024-12-02",0,0,2,0,0,2,0,0
"Pakistan","2024-12-03",0,0,2,0,0,2,0,0
"Pakistan","2024-12-04",0,0,2,0,0,2,0,0
"Pakistan","2024-12-05",0,0,2,0,0,2,0,0
"Pakistan","2024-12-06",0,0,2,0,0,2,0,0
"Pakistan","2024-12-07",0,0,2,0,0,2,0,0
"Pakistan","2024-12-08",0,0,2,0,0,2,0,0
"Pakistan","2024-12-09",0,0,2,0,0,2,0,0
"Panama","2024-01-01",0,0,0,0,0,0,0,0
"Panama","2024-01-02",0,0,0,0,0,0,0,0
"Panama","2024-01-03",0,0,0,0,0,0,0,0
"Panama","2024-01-04",0,0,0,0,0,0,0,0
"Panama","2024-01-05",0,0,0,0,0,0,0,0
"Panama","2024-01-06",0,0,0,0,0,0,0,0
"Panama","2024-01-07",0,0,0,0,0,0,0,0
"Panama","2024-01-08",0,0,0,0,0,0,0,0
"Panama","2024-01-09",0,0,0,0,0,0,0,0
"Panama","2024-01-10",0,0,0,0,0,0,0,0
"Panama","2024-01-11",0,0,0,0,0,0,0,0
"Panama","2024-01-12",0,0,0,0,0,0,0,0
"Panama","2024-01-13",0,0,0,0,0,0,0,0
"Panama","2024-01-14",0,0,0,0,0,0,0,0
"Panama","2024-01-15",0,0,0,0,0,0,0,0
"Panama","2024-01-16",0,1,1,0,1,1,0,0
"Panama","2024-01-17",0,0,1,0,0,1,0,0
"Panama","2024-01-18",0,0,1,0,0,1,0,0
"Panama","2024-01-19",0,0,1,0,0,1,0,0
"Panama","2024-01-20",0,0,1,0,0,1,0,0
"Panama","2024-01-21",0,0,1,0,0,1,0,0
"Panama","2024-01-22",0,0,1,0,0,1,0,0
"Panama","2024-01-23",0,0,1,0,0,1,0,0
"Panama","2024-01-24",0,0,1,0,0,1,0,0
"Panama","2024-01-25",0,0,1,0,0,1,0,0
"Panama","2024-01-26",0,0,1,0,0,1,0,0
"Panama","2024-01-27",0,0,1,0,1,2,0,0
"Panama","2024-01-28",0,0,1,0,0,2,0,0
"Panama","2024-01-29",0,0,1,0,0,2,0,0
"Panama","2024-01-30",0,0,1,0,0,2,0,0
"Panama","2024-01-31",0,0,1,0,0,2,0,0
"Panama","2024-02-01",0,0,1,0,0,2,0,0
"Panama","2024-02-02",0,0,1,0,0,2,0,0
"Panama","2024-02-03",0,0,1,0,0,2,0,0
"Panama","2024-02-04",0,0,1,0,0,2,0,0
"Panama","2024-02-05",0,0,1,0,0,2,0,0
"Panama","2024-02-06",0,1,2,0,0,2,0,0
"Panama","2024-02-07",0,0,2,0,0,2,0,0
"Panama","2024-02-08",0,0,2,0,0,2,0,0
"Panama","2024-02-09",0,0,2,0,0,2,0,0
"Panama","2024-02-10",0,0,2,0,0,2,0,0
"Panama","2024-02-11",0,0,2,0,0,2,0,0
"Panama","2024-02-12",0,0,2,0,0,2,0,0
"Panama","2024-02-13",0,0,2,0,0,2,0,0
"Panama","2024-02-14",0,0,2,0,0,2,0,0
"Panama","2024-02-15",0,0,2,0,0,2,0,0
"Panama","2024-02-16",0,0,2,0,0,2,0,0
"Panama","2024-02-17",0,0,2,0,0,2,0,0
"Panama","2024-02-18",0,0,2,0,0,2,0,0
"Panama","2024-02-19",0,0,2,0,0,2,0,0
"Panama","2024-02-20",0,0,2,0,0,2,0,0
"Panama","2024-02-21",0,0,2,0,0,2,0,0
"Panama","2024-02-22",0,0,2,0,0,2,0,0
"Panama","2024-02-23",0,0,2,0,0,2,0,0
"Panama","2024-02-24",0,0,2,0,0,2,0,0
"Panama","2024-02-25",0,0,2,0,0,2,0,0
"Panama","2024-02-26",0,0,2,0,0,2,0,0
"Panama","2024-02-27",0,0,2,0,0,2,0,0
"Panama","2024-02-28",0,0,2,0,0,2,0,0
"Panama","2024-02-29",0,0,2,0,0,2,0,0
"Panama","2024-03-01",0,0,2,0,0,2,0,0
"Panama","2024-03-02",0,0,2,0,0,2,0,0
"Panama","2024-03-03",0,0,2,0,0,2,0,0
"Panama","2024-03-04",0,0,2,0,0,2,0,0
"Panama","2024-03-05",0,0,2,0,0,2,0,0
"Panama","2024-03-06",0,0,2,0,0,2,0,0
"Panama","2024-03-07",0,0,2,0,0,2,0,0
"Panama","2024-03-08",0,0,2,0,0,2,0,0
"Panama","2024-03-09",0,0,2,0,0,2,0,0
"Panama","2024-03-10",0,0,2,0,0,2,0,0
"Panama","2024-03-11",0,0,2,0,0,2,0,0
"Panama","2024-03-12",0,0,2,0,0,2,0,0
"Panama","2024-03-13",0,0,2,0,0,2,0,0
"Panama","2024-03-14",0,0,2,0,0,2,0,0
"Panama","2024-03-15",0,0,2,0,0,2,0,0
"Panama","2024-03-16",0,0,2,0,0,2,0,0
"Panama","2024-03-17",0,0,2,0,0,2,0,0
"Panama","2024-03-18",0,0,2,0,0,2,0,0
"Panama","2024-03-19",0,0,2,0,0,2,0,0
"Panama","2024-03-20",0,0,2,0,0,2,0,0
"Panama","2024-03-21",0,0,2,0,0,2,0,0
"Panama","2024-03-22",0,0,2,0,0,2,0,0
"Panama","2024-03-23",0,0,2,0,0,2,0,0
"Panama","2024-03-24",0,0,2,0,0,2,0,0
"Panama","2024-03-25",0,0,2,0,0,2,0,0
"Panama","2024-03-26",0,0,2,0,0,2,0,0
"Panama","2024-03-27",0,0,2,0,0,2,0,0
"Panama","2024-03-28",0,0,2,0,0,2,0,0
"Panama","2024-03-29",0,0,2,0,0,2,0,0
"Panama","2024-03-30",0,0,2,0,0,2,0,0
"Panama","2024-03-31",0,0,2,0,0,2,0,0
"Panama","2024-04-01",0,0,2,0,0,2,0,0
"Panama","2024-04-02",0,0,2,0,0,2,0,0
"Panama","2024-04-03",0,0,2,0,0,2,0,0
"Panama","2024-04-04",0,0,2,0,0,2,0,0
"Panama","2024-04-05",0,0,2,0,0,2,0,0
"Panama","2024-04-06",0,0,2,0,0,2,0,0
"Panama","2024-04-07",0,0,2,0,0,2,0,0
"Panama","2024-04-08",0,0,2,0,0,2,0,0
"Panama","2024-04-09",0,0,2,0,0,2,0,0
"Panama","2024-04-10",0,0,2,0,0,2,0,0
"Panama","2024-04-11",0,0,2,0,0,2,0,0
"Panama","2024-04-12",0,0,2,0,0,2,0,0
"Panama","2024-04-13",0,0,2,0,0,2,0,0
"Panama","2024-04-14",0,0,2,0,0,2,0,0
"Panama","2024-04-15",0,0,2,0,0,2,0,0
"Panama","2024-04-16",0,0,2,0,0,2,0,0
"Panama","2024-04-17",0,0,2,0,1,3,0,0
"Panama","2024-04-18",0,0,2,0,0,3,0,0
"Panama","2024-04-19",0,0,2,0,0,3,0,0
"Panama","2024-04-20",0,0,2,0,0,3,0,0
"Panama","2024-04-21",0,0,2,0,0,3,0,0
"Panama","2024-04-22",0,0,2,0,0,3,0,0
"Panama","2024-04-23",0,0,2,0,0,3,0,0
"Panama","2024-04-24",0,0,2,0,0,3,0,0
"Panama","2024-04-25",0,0,2,0,0,3,0,0
"Panama","2024-04-26",0,0,2,0,0,3,0,0
"Panama","2024-04-27",0,0,2,0,0,3,0,0
"Panama","2024-04-28",0,0,2,0,0,3,0,0
"Panama","2024-04-29",0,0,2,0,0,3,0,0
"Panama","2024-04-30",0,0,2,0,0,3,0,0
"Panama","2024-05-01",0,0,2,0,0,3,0,0
"Panama","2024-05-02",0,0,2,0,0,3,0,0
"Panama","2024-05-03",0,0,2,0,0,3,0,0
"Panama","2024-05-04",0,0,2,0,0,3,0,0
"Panama","2024-05-05",0,0,2,0,0,3,0,0
"Panama","2024-05-06",0,0,2,0,0,3,0,0
"Panama","2024-05-07",0,0,2,0,0,3,0,0
"Panama","2024-05-08",0,0,2,0,0,3,0,0
"Panama","2024-05-09",0,0,2,0,0,3,0,0
"Panama","2024-05-10",0,0,2,0,0,3,0,0
"Panama","2024-05-11",0,0,2,0,0,3,0,0
"Panama","2024-05-12",0,0,2,0,0,3,0,0
"Panama","2024-05-13",0,0,2,0,0,3,0,0
"Panama","2024-05-14",0,0,2,0,0,3,0,0
"Panama","2024-05-15",0,0,2,0,0,3,0,0
"Panama","2024-05-16",0,0,2,0,0,3,0,0
"Panama","2024-05-17",0,0,2,0,0,3,0,0
"Panama","2024-05-18",0,0,2,0,0,3,0,0
"Panama","2024-05-19",0,0,2,0,0,3,0,0
"Panama","2024-05-20",0,0,2,0,0,3,0,0
"Panama","2024-05-21",0,0,2,0,0,3,0,0
"Panama","2024-05-22",0,0,2,0,0,3,0,0
"Panama","2024-05-23",0,0,2,0,0,3,0,0
"Panama","2024-05-24",0,0,2,0,0,3,0,0
"Panama","2024-05-25",0,0,2,0,0,3,0,0
"Panama","2024-05-26",0,0,2,0,0,3,0,0
"Panama","2024-05-27",0,0,2,0,0,3,0,0
"Panama","2024-05-28",0,0,2,0,0,3,0,0
"Panama","2024-05-29",0,0,2,0,0,3,0,0
"Panama","2024-05-30",0,0,2,0,0,3,0,0
"Panama","2024-05-31",0,0,2,0,0,3,0,0
"Panama","2024-06-01",0,0,2,0,0,3,0,0
"Panama","2024-06-02",0,0,2,0,0,3,0,0
"Panama","2024-06-03",0,0,2,0,0,3,0,0
"Panama","2024-06-04",0,0,2,0,0,3,0,0
"Panama","2024-06-05",0,0,2,0,0,3,0,0
"Panama","2024-06-06",0,0,2,0,0,3,0,0
"Panama","2024-06-07",0,0,2,0,0,3,0,0
"Panama","2024-06-08",0,0,2,0,0,3,0,0
"Panama","2024-06-09",0,0,2,0,0,3,0,0
"Panama","2024-06-10",0,0,2,0,0,3,0,0
"Panama","2024-06-11",0,0,2,0,0,3,0,0
"Panama","2024-06-12",0,0,2,0,0,3,0,0
"Panama","2024-06-13",0,0,2,0,0,3,0,0
"Panama","2024-06-14",0,0,2,0,0,3,0,0
"Panama","2024-06-15",0,0,2,0,0,3,0,0
"Panama","2024-06-16",0,0,2,0,0,3,0,0
"Panama","2024-06-17",0,0,2,0,0,3,0,0
"Panama","2024-06-18",0,0,2,0,0,3,0,0
"Panama","2024-06-19",0,0,2,0,0,3,0,0
"Panama","2024-06-20",0,0,2,0,0,3,0,0
"Panama","2024-06-21",0,0,2,0,0,3,0,0
"Panama","2024-06-22",0,0,2,0,0,3,0,0
"Panama","2024-06-23",0,0,2,0,0,3,0,0
"Panama","2024-06-24",0,0,2,0,0,3,0,0
"Panama","2024-06-25",0,1,3,0,0,3,0,0
"Panama","2024-06-26",0,0,3,0,0,3,0,0
"Panama","2024-06-27",0,0,3,0,0,3,0,0
"Panama","2024-06-28",0,0,3,0,0,3,0,0
"Panama","2024-06-29",0,0,3,0,0,3,0,0
"Panama","2024-06-30",0,0,3,0,0,3,0,0
"Panama","2024-07-01",0,0,3,0,0,3,0,0
"Panama","2024-07-02",0,0,3,0,0,3,0,0
"Panama","2024-07-03",0,0,3,0,0,3,0,0
"Panama","2024-07-04",0,0,3,0,0,3,0,0
"Panama","2024-07-05",0,0,3,0,0,3,0,0
"Panama","2024-07-06",0,0,3,0,0,3,0,0
"Panama","2024-07-07",0,0,3,0,0,3,0,0
"Panama","2024-07-08",0,0,3,0,0,3,0,0
"Panama","2024-07-09",0,0,3,0,0,3,0,0
"Panama","2024-07-10",0,0,3,0,0,3,0,0
"Panama","2024-07-11",0,0,3,0,0,3,0,0
"Panama","2024-07-12",0,0,3,0,0,3,0,0
"Panama","2024-07-13",0,0,3,0,1,4,0,0
"Panama","2024-07-14",0,0,3,0,0,4,0,0
"Panama","2024-07-15",0,0,3,0,0,4,0,0
"Panama","2024-07-16",0,0,3,0,0,4,0,0
"Panama","2024-07-17",0,0,3,0,0,4,0,0
"Panama","2024-07-18",0,0,3,0,0,4,0,0
"Panama","2024-07-19",0,0,3,0,0,4,0,0
"Panama","2024-07-20",0,0,3,0,0,4,0,0
"Panama","2024-07-21",0,0,3,0,0,4,0,0
"Panama","2024-07-22",0,0,3,0,0,4,0,0
"Panama","2024-07-23",0,0,3,0,0,4,0,0
"Panama","2024-07-24",0,0,3,0,0,4,0,0
"Panama","2024-07-25",0,0,3,0,0,4,0,0
"Panama","2024-07-26",0,0,3,0,0,4,0,0
"Panama","2024-07-27",0,0,3,0,0,4,0,0
"Panama","2024-07-28",0,0,3,0,0,4,0,0
"Panama","2024-07-29",0,0,3,0,0,4,0,0
"Panama","2024-07-30",0,1,4,0,0,4,0,0
"Panama","2024-07-31",0,0,4,0,0,4,0,0
"Panama","2024-08-01",0,0,4,0,0,4,0,0
"Panama","2024-08-02",0,0,4,0,0,4,0,0
"Panama","2024-08-03",0,0,4,0,0,4,0,0
"Panama","2024-08-04",0,0,4,0,0,4,0,0
"Panama","2024-08-05",0,0,4,0,0,4,0,0
"Panama","2024-08-06",0,0,4,0,0,4,0,0
"Panama","2024-08-07",0,0,4,0,0,4,0,0
"Panama","2024-08-08",0,0,4,0,0,4,0,0
"Panama","2024-08-09",0,0,4,0,0,4,0,0
"Panama","2024-08-10",0,0,4,0,0,4,0,0
"Panama","2024-08-11",0,0,4,0,0,4,0,0
"Panama","2024-08-12",0,0,4,0,0,4,0,0
"Panama","2024-08-13",0,0,4,0,0,4,0,0
"Panama","2024-08-14",0,0,4,0,0,4,0,0
"Panama","2024-08-15",0,0,4,0,0,4,0,0
"Panama","2024-08-16",0,0,4,0,0,4,0,0
"Panama","2024-08-17",0,0,4,0,0,4,0,0
"Panama","2024-08-18",0,0,4,0,0,4,0,0
"Panama","2024-08-19",0,0,4,0,0,4,0,0
"Panama","2024-08-20",0,0,4,0,0,4,0,0
"Panama","2024-08-21",0,0,4,0,0,4,0,0
"Panama","2024-08-22",0,0,4,0,0,4,0,0
"Panama","2024-08-23",0,0,4,0,0,4,0,0
"Panama","2024-08-24",0,0,4,0,1,5,0,0
"Panama","2024-08-25",0,0,4,0,0,5,0,0
"Panama","2024-08-26",0,0,4,0,0,5,0,0
"Panama","2024-08-27",0,0,4,0,0,5,0,0
"Panama","2024-08-28",0,0,4,0,0,5,0,0
"Panama","2024-08-29",0,0,4,0,0,5,0,0
"Panama","2024-08-30",0,0,4,0,0,5,0,0
"Panama","2024-08-31",0,0,4,0,0,5,0,0
"Panama","2024-09-01",0,0,4,0,0,5,0,0
"Panama","2024-09-02",0,0,4,0,0,5,0,0
"Panama","2024-09-03",0,0,4,0,0,5,0,0
"Panama","2024-09-04",0,0,4,0,0,5,0,0
"Panama","2024-09-05",0,0,4,0,0,5,0,0
"Panama","2024-09-06",0,0,4,0,0,5,0,0
"Panama","2024-09-07",0,0,4,0,0,5,0,0
"Panama","2024-09-08",0,0,4,0,0,5,0,0
"Panama","2024-09-09",0,0,4,0,0,5,0,0
"Panama","2024-09-10",0,0,4,0,0,5,0,0
"Panama","2024-09-11",0,0,4,0,0,5,0,0
"Panama","2024-09-12",0,0,4,0,0,5,0,0
"Panama","2024-09-13",0,0,4,0,0,5,0,0
"Panama","2024-09-14",0,0,4,0,0,5,0,0
"Panama","2024-09-15",0,0,4,0,0,5,0,0
"Panama","2024-09-16",0,0,4,0,0,5,0,0
"Panama","2024-09-17",0,1,5,0,0,5,0,0
"Panama","2024-09-18",0,0,5,0,0,5,0,0
"Panama","2024-09-19",0,0,5,0,0,5,0,0
"Panama","2024-09-20",0,0,5,0,0,5,0,0
"Panama","2024-09-21",0,0,5,0,0,5,0,0
"Panama","2024-09-22",0,0,5,0,0,5,0,0
"Panama","2024-09-23",0,0,5,0,0,5,0,0
"Panama","2024-09-24",0,0,5,0,0,5,0,0
"Panama","2024-09-25",0,0,5,0,0,5,0,0
"Panama","2024-09-26",0,0,5,0,0,5,0,0
"Panama","2024-09-27",0,0,5,0,0,5,0,0
"Panama","2024-09-28",0,0,5,0,0,5,0,0
"Panama","2024-09-29",0,0,5,0,0,5,0,0
"Panama","2024-09-30",0,0,5,0,0,5,0,0
"Panama","2024-10-01",0,0,5,0,0,5,0,0
"Panama","2024-10-02",0,0,5,0,0,5,0,0
"Panama","2024-10-03",0,0,5,0,0,5,0,0
"Panama","2024-10-04",0,0,5,0,0,5,0,0
"Panama","2024-10-05",0,0,5,0,0,5,0,0
"Panama","2024-10-06",0,0,5,0,0,5,0,0
"Panama","2024-10-07",0,0,5,0,0,5,0,0
"Panama","2024-10-08",0,0,5,0,0,5,0,0
"Panama","2024-10-09",0,0,5,0,0,5,0,0
"Panama","2024-10-10",0,0,5,0,0,5,0,0
"Panama","2024-10-11",0,0,5,0,0,5,0,0
"Panama","2024-10-12",0,0,5,0,0,5,0,0
"Panama","2024-10-13",0,0,5,0,0,5,0,0
"Panama","2024-10-14",0,0,5,0,0,5,0,0
"Panama","2024-10-15",0,0,5,0,0,5,0,0
"Panama","2024-10-16",0,0,5,0,0,5,0,0
"Panama","2024-10-17",0,0,5,0,0,5,0,0
"Panama","2024-10-18",0,0,5,0,0,5,0,0
"Panama","2024-10-19",0,0,5,0,0,5,0,0
"Panama","2024-10-20",0,0,5,0,0,5,0,0
"Panama","2024-10-21",0,0,5,0,0,5,0,0
"Panama","2024-10-22",0,0,5,0,0,5,0,0
"Panama","2024-10-23",0,0,5,0,0,5,0,0
"Panama","2024-10-24",0,0,5,0,0,5,0,0
"Panama","2024-10-25",0,0,5,0,0,5,0,0
"Panama","2024-10-26",0,0,5,0,0,5,0,0
"Panama","2024-10-27",0,0,5,0,0,5,0,0
"Panama","2024-10-28",0,0,5,0,0,5,0,0
"Panama","2024-10-29",0,0,5,0,0,5,0,0
"Panama","2024-10-30",0,0,5,0,0,5,0,0
"Panama","2024-10-31",0,0,5,0,0,5,0,0
"Panama","2024-11-01",0,0,5,0,0,5,0,0
"Panama","2024-11-02",0,0,5,0,0,5,0,0
"Panama","2024-11-03",0,0,5,0,0,5,0,0
"Panama","2024-11-04",0,0,5,0,0,5,0,0
"Panama","2024-11-05",0,0,5,0,0,5,0,0
"Panama","2024-11-06",0,0,5,0,0,5,0,0
"Panama","2024-11-07",0,0,5,0,0,5,0,0
"Panama","2024-11-08",0,0,5,0,0,5,0,0
"Panama","2024-11-09",0,0,5,0,0,5,0,0
"Panama","2024-11-10",0,0,5,0,0,5,0,0
"Panama","2024-11-11",0,0,5,0,0,5,0,0
"Panama","2024-11-12",0,0,5,0,0,5,0,0
"Panama","2024-11-13",0,0,5,0,0,5,0,0
"Panama","2024-11-14",0,0,5,0,0,5,0,0
"Panama","2024-11-15",0,0,5,0,0,5,0,0
"Panama","2024-11-16",0,0,5,0,0,5,0,0
"Panama","2024-11-17",0,0,5,0,0,5,0,0
"Panama","2024-11-18",0,0,5,0,0,5,0,0
"Panama","2024-11-19",0,0,5,0,0,5,0,0
"Panama","2024-11-20",0,0,5,0,0,5,0,0
"Panama","2024-11-21",0,0,5,0,0,5,0,0
"Panama","2024-11-22",0,0,5,0,0,5,0,0
"Panama","2024-11-23",0,0,5,0,0,5,0,0
"Panama","2024-11-24",0,0,5,0,0,5,0,0
"Panama","2024-11-25",0,0,5,0,0,5,0,0
"Panama","2024-11-26",0,0,5,0,0,5,0,0
"Panama","2024-11-27",0,0,5,0,0,5,0,0
"Panama","2024-11-28",0,0,5,0,0,5,0,0
"Panama","2024-11-29",0,0,5,0,0,5,0,0
"Panama","2024-11-30",0,0,5,0,0,5,0,0
"Panama","2024-12-01",0,0,5,0,0,5,0,0
"Panama","2024-12-02",0,0,5,0,0,5,0,0
"Panama","2024-12-03",0,0,5,0,0,5,0,0
"Panama","2024-12-04",0,0,5,0,0,5,0,0
"Panama","2024-12-05",0,0,5,0,0,5,0,0
"Panama","2024-12-06",0,0,5,0,0,5,0,0
"Panama","2024-12-07",0,0,5,0,0,5,0,0
"Panama","2024-12-08",0,0,5,0,0,5,0,0
"Panama","2024-12-09",0,0,5,0,0,5,0,0
"Paraguay","2024-01-01",0,0,0,0,0,0,0,0
"Paraguay","2024-01-02",0,0,0,0,0,0,0,0
"Paraguay","2024-01-03",0,0,0,0,0,0,0,0
"Paraguay","2024-01-04",0,0,0,0,0,0,0,0
"Paraguay","2024-01-05",0,0,0,0,0,0,0,0
"Paraguay","2024-01-06",0,0,0,0,0,0,0,0
"Paraguay","2024-01-07",0,0,0,0,0,0,0,0
"Paraguay","2024-01-08",0,0,0,0,0,0,0,0
"Paraguay","2024-01-09",0,0,0,0,0,0,0,0
"Paraguay","2024-01-10",0,0,0,0,0,0,0,0
"Paraguay","2024-01-11",0,0,0,0,0,0,0,0
"Paraguay","2024-01-12",0,0,0,0,0,0,0,0
"Paraguay","2024-01-13",0,0,0,0,0,0,0,0
"Paraguay","2024-01-14",0,0,0,0,0,0,0,0
"Paraguay","2024-01-15",0,0,0,0,0,0,0,0
"Paraguay","2024-01-16",0,0,0,0,0,0,0,0
"Paraguay","2024-01-17",0,0,0,0,0,0,0,0
"Paraguay","2024-01-18",0,0,0,0,0,0,0,0
"Paraguay","2024-01-19",0,0,0,0,0,0,0,0
"Paraguay","2024-01-20",0,0,0,0,0,0,0,0
"Paraguay","2024-01-21",0,0,0,0,0,0,0,0
"Paraguay","2024-01-22",0,0,0,0,0,0,0,0
"Paraguay","2024-01-23",0,0,0,0,0,0,0,0
"Paraguay","2024-01-24",0,0,0,0,0,0,0,0
"Paraguay","2024-01-25",0,0,0,0,0,0,0,0
"Paraguay","2024-01-26",0,0,0,0,0,0,0,0
"Paraguay","2024-01-27",0,0,0,0,0,0,0,0
"Paraguay","2024-01-28",0,0,0,0,0,0,0,0
"Paraguay","2024-01-29",0,0,0,0,0,0,0,0
"Paraguay","2024-01-30",0,0,0,0,0,0,0,0
"Paraguay","2024-01-31",0,0,0,0,0,0,0,0
"Paraguay","2024-02-01",0,0,0,0,0,0,0,0
"Paraguay","2024-02-02",0,0,0,0,0,0,0,0
"Paraguay","2024-02-03",0,0,0,0,0,0,0,0
"Paraguay","2024-02-04",0,0,0,0,0,0,0,0
"Paraguay","2024-02-05",0,0,0,0,0,0,0,0
"Paraguay","2024-02-06",0,0,0,0,0,0,0,0
"Paraguay","2024-02-07",0,0,0,0,0,0,0,0
"Paraguay","2024-02-08",0,0,0,0,0,0,0,0
"Paraguay","2024-02-09",0,0,0,0,0,0,0,0
"Paraguay","2024-02-10",0,0,0,0,0,0,0,0
"Paraguay","2024-02-11",0,0,0,0,0,0,0,0
"Paraguay","2024-02-12",0,0,0,0,0,0,0,0
"Paraguay","2024-02-13",0,0,0,0,0,0,0,0
"Paraguay","2024-02-14",0,0,0,0,0,0,0,0
"Paraguay","2024-02-15",0,0,0,0,0,0,0,0
"Paraguay","2024-02-16",0,0,0,0,0,0,0,0
"Paraguay","2024-02-17",0,0,0,0,0,0,0,0
"Paraguay","2024-02-18",0,0,0,0,0,0,0,0
"Paraguay","2024-02-19",0,0,0,0,0,0,0,0
"Paraguay","2024-02-20",0,0,0,0,0,0,0,0
"Paraguay","2024-02-21",0,0,0,0,0,0,0,0
"Paraguay","2024-02-22",0,0,0,0,0,0,0,0
"Paraguay","2024-02-23",0,0,0,0,0,0,0,0
"Paraguay","2024-02-24",0,0,0,0,0,0,0,0
"Paraguay","2024-02-25",0,0,0,0,0,0,0,0
"Paraguay","2024-02-26",0,0,0,0,0,0,0,0
"Paraguay","2024-02-27",0,0,0,0,0,0,0,0
"Paraguay","2024-02-28",0,0,0,0,0,0,0,0
"Paraguay","2024-02-29",0,0,0,0,0,0,0,0
"Paraguay","2024-03-01",0,0,0,0,0,0,0,0
"Paraguay","2024-03-02",0,0,0,0,0,0,0,0
"Paraguay","2024-03-03",0,0,0,0,0,0,0,0
"Paraguay","2024-03-04",0,0,0,0,0,0,0,0
"Paraguay","2024-03-05",0,0,0,0,0,0,0,0
"Paraguay","2024-03-06",0,0,0,0,0,0,0,0
"Paraguay","2024-03-07",0,0,0,0,0,0,0,0
"Paraguay","2024-03-08",0,0,0,0,0,0,0,0
"Paraguay","2024-03-09",0,0,0,0,0,0,0,0
"Paraguay","2024-03-10",0,0,0,0,0,0,0,0
"Paraguay","2024-03-11",0,0,0,0,0,0,0,0
"Paraguay","2024-03-12",0,0,0,0,0,0,0,0
"Paraguay","2024-03-13",0,0,0,0,0,0,0,0
"Paraguay","2024-03-14",0,0,0,0,0,0,0,0
"Paraguay","2024-03-15",0,0,0,0,0,0,0,0
"Paraguay","2024-03-16",0,0,0,0,0,0,0,0
"Paraguay","2024-03-17",0,0,0,0,0,0,0,0
"Paraguay","2024-03-18",0,0,0,0,0,0,0,0
"Paraguay","2024-03-19",0,0,0,0,0,0,0,0
"Paraguay","2024-03-20",0,0,0,0,0,0,0,0
"Paraguay","2024-03-21",0,0,0,0,0,0,0,0
"Paraguay","2024-03-22",0,0,0,0,0,0,0,0
"Paraguay","2024-03-23",0,0,0,0,0,0,0,0
"Paraguay","2024-03-24",0,0,0,0,0,0,0,0
"Paraguay","2024-03-25",0,0,0,0,0,0,0,0
"Paraguay","2024-03-26",0,0,0,0,0,0,0,0
"Paraguay","2024-03-27",0,0,0,0,0,0,0,0
"Paraguay","2024-03-28",0,0,0,0,0,0,0,0
"Paraguay","2024-03-29",0,0,0,0,0,0,0,0
"Paraguay","2024-03-30",0,0,0,0,0,0,0,0
"Paraguay","2024-03-31",0,0,0,0,0,0,0,0
"Paraguay","2024-04-01",0,0,0,0,0,0,0,0
"Paraguay","2024-04-02",0,0,0,0,0,0,0,0
"Paraguay","2024-04-03",0,0,0,0,0,0,0,0
"Paraguay","2024-04-04",0,0,0,0,0,0,0,0
"Paraguay","2024-04-05",0,0,0,0,0,0,0,0
"Paraguay","2024-04-06",0,0,0,0,0,0,0,0
"Paraguay","2024-04-07",0,0,0,0,0,0,0,0
"Paraguay","2024-04-08",0,0,0,0,0,0,0,0
"Paraguay","2024-04-09",0,0,0,0,0,0,0,0
"Paraguay","2024-04-10",0,0,0,0,0,0,0,0
"Paraguay","2024-04-11",0,0,0,0,0,0,0,0
"Paraguay","2024-04-12",0,0,0,0,0,0,0,0
"Paraguay","2024-04-13",0,0,0,0,0,0,0,0
"Paraguay","2024-04-14",0,0,0,0,0,0,0,0
"Paraguay","2024-04-15",0,0,0,0,0,0,0,0
"Paraguay","2024-04-16",0,0,0,0,0,0,0,0
"Paraguay","2024-04-17",0,0,0,0,0,0,0,0
"Paraguay","2024-04-18",0,0,0,0,0,0,0,0
"Paraguay","2024-04-19",0,0,0,0,0,0,0,0
"Paraguay","2024-04-20",0,0,0,0,0,0,0,0
"Paraguay","2024-04-21",0,0,0,0,0,0,0,0
"Paraguay","2024-04-22",0,0,0,0,0,0,0,0
"Paraguay","2024-04-23",0,0,0,0,0,0,0,0
"Paraguay","2024-04-24",0,0,0,0,0,0,0,0
"Paraguay","2024-04-25",0,0,0,0,0,0,0,0
"Paraguay","2024-04-26",0,0,0,0,0,0,0,0
"Paraguay","2024-04-27",0,0,0,0,0,0,0,0
"Paraguay","2024-04-28",0,0,0,0,0,0,0,0
"Paraguay","2024-04-29",0,0,0,0,0,0,0,0
"Paraguay","2024-04-30",0,0,0,0,0,0,0,0
"Paraguay","2024-05-01",0,0,0,0,0,0,0,0
"Paraguay","2024-05-02",0,0,0,0,0,0,0,0
"Paraguay","2024-05-03",0,0,0,0,0,0,0,0
"Paraguay","2024-05-04",0,0,0,0,0,0,0,0
"Paraguay","2024-05-05",0,0,0,0,0,0,0,0
"Paraguay","2024-05-06",0,0,0,0,0,0,0,0
"Paraguay","2024-05-07",0,0,0,0,0,0,0,0
"Paraguay","2024-05-08",0,0,0,0,0,0,0,0
"Paraguay","2024-05-09",0,0,0,0,0,0,0,0
"Paraguay","2024-05-10",0,0,0,0,0,0,0,0
"Paraguay","2024-05-11",0,0,0,0,0,0,0,0
"Paraguay","2024-05-12",0,0,0,0,0,0,0,0
"Paraguay","2024-05-13",0,0,0,0,0,0,0,0
"Paraguay","2024-05-14",0,0,0,0,0,0,0,0
"Paraguay","2024-05-15",0,0,0,0,0,0,0,0
"Paraguay","2024-05-16",0,0,0,0,0,0,0,0
"Paraguay","2024-05-17",0,0,0,0,0,0,0,0
"Paraguay","2024-05-18",0,0,0,0,0,0,0,0
"Paraguay","2024-05-19",0,0,0,0,0,0,0,0
"Paraguay","2024-05-20",0,0,0,0,0,0,0,0
"Paraguay","2024-05-21",0,0,0,0,0,0,0,0
"Paraguay","2024-05-22",0,0,0,0,0,0,0,0
"Paraguay","2024-05-23",0,0,0,0,0,0,0,0
"Paraguay","2024-05-24",0,0,0,0,0,0,0,0
"Paraguay","2024-05-25",0,0,0,0,0,0,0,0
"Paraguay","2024-05-26",0,0,0,0,0,0,0,0
"Paraguay","2024-05-27",0,0,0,0,0,0,0,0
"Paraguay","2024-05-28",0,0,0,0,0,0,0,0
"Paraguay","2024-05-29",0,0,0,0,0,0,0,0
"Paraguay","2024-05-30",0,0,0,0,0,0,0,0
"Paraguay","2024-05-31",0,0,0,0,0,0,0,0
"Paraguay","2024-06-01",0,0,0,0,0,0,0,0
"Paraguay","2024-06-02",0,0,0,0,0,0,0,0
"Paraguay","2024-06-03",0,0,0,0,0,0,0,0
"Paraguay","2024-06-04",0,0,0,0,0,0,0,0
"Paraguay","2024-06-05",0,0,0,0,0,0,0,0
"Paraguay","2024-06-06",0,0,0,0,0,0,0,0
"Paraguay","2024-06-07",0,0,0,0,0,0,0,0
"Paraguay","2024-06-08",0,0,0,0,0,0,0,0
"Paraguay","2024-06-09",0,0,0,0,0,0,0,0
"Paraguay","2024-06-10",0,0,0,0,0,0,0,0
"Paraguay","2024-06-11",0,0,0,0,0,0,0,0
"Paraguay","2024-06-12",0,0,0,0,0,0,0,0
"Paraguay","2024-06-13",0,0,0,0,0,0,0,0
"Paraguay","2024-06-14",0,0,0,0,0,0,0,0
"Paraguay","2024-06-15",0,0,0,0,0,0,0,0
"Paraguay","2024-06-16",0,0,0,0,0,0,0,0
"Paraguay","2024-06-17",0,0,0,0,0,0,0,0
"Paraguay","2024-06-18",0,0,0,0,0,0,0,0
"Paraguay","2024-06-19",0,0,0,0,0,0,0,0
"Paraguay","2024-06-20",0,0,0,0,0,0,0,0
"Paraguay","2024-06-21",0,0,0,0,0,0,0,0
"Paraguay","2024-06-22",0,0,0,0,0,0,0,0
"Paraguay","2024-06-23",0,0,0,0,0,0,0,0
"Paraguay","2024-06-24",0,0,0,0,0,0,0,0
"Paraguay","2024-06-25",0,0,0,0,0,0,0,0
"Paraguay","2024-06-26",0,0,0,0,0,0,0,0
"Paraguay","2024-06-27",0,0,0,0,0,0,0,0
"Paraguay","2024-06-28",0,0,0,0,0,0,0,0
"Paraguay","2024-06-29",0,0,0,0,0,0,0,0
"Paraguay","2024-06-30",0,0,0,0,0,0,0,0
"Paraguay","2024-07-01",0,0,0,0,0,0,0,0
"Paraguay","2024-07-02",0,0,0,0,0,0,0,0
"Paraguay","2024-07-03",0,0,0,0,0,0,0,0
"Paraguay","2024-07-04",0,0,0,0,0,0,0,0
"Paraguay","2024-07-05",0,0,0,0,0,0,0,0
"Paraguay","2024-07-06",0,0,0,0,0,0,0,0
"Paraguay","2024-07-07",0,0,0,0,0,0,0,0
"Paraguay","2024-07-08",0,0,0,0,0,0,0,0
"Paraguay","2024-07-09",0,0,0,0,0,0,0,0
"Paraguay","2024-07-10",0,0,0,0,0,0,0,0
"Paraguay","2024-07-11",0,0,0,0,0,0,0,0
"Paraguay","2024-07-12",0,0,0,0,0,0,0,0
"Paraguay","2024-07-13",0,0,0,0,0,0,0,0
"Paraguay","2024-07-14",0,0,0,0,0,0,0,0
"Paraguay","2024-07-15",0,0,0,0,0,0,0,0
"Paraguay","2024-07-16",0,0,0,0,0,0,0,0
"Paraguay","2024-07-17",0,0,0,0,0,0,0,0
"Paraguay","2024-07-18",0,0,0,0,0,0,0,0
"Paraguay","2024-07-19",0,0,0,0,0,0,0,0
"Paraguay","2024-07-20",0,0,0,0,0,0,0,0
"Paraguay","2024-07-21",0,0,0,0,0,0,0,0
"Paraguay","2024-07-22",0,0,0,0,0,0,0,0
"Paraguay","2024-07-23",0,0,0,0,0,0,0,0
"Paraguay","2024-07-24",0,0,0,0,0,0,0,0
"Paraguay","2024-07-25",0,0,0,0,0,0,0,0
"Paraguay","2024-07-26",0,0,0,0,0,0,0,0
"Paraguay","2024-07-27",0,0,0,0,0,0,0,0
"Paraguay","2024-07-28",0,0,0,0,0,0,0,0
"Paraguay","2024-07-29",0,0,0,0,0,0,0,0
"Paraguay","2024-07-30",0,0,0,0,0,0,0,0
"Paraguay","2024-07-31",0,0,0,0,0,0,0,0
"Paraguay","2024-08-01",0,0,0,0,0,0,0,0
"Paraguay","2024-08-02",0,0,0,0,0,0,0,0
"Paraguay","2024-08-03",0,0,0,0,0,0,0,0
"Paraguay","2024-08-04",0,0,0,0,0,0,0,0
"Paraguay","2024-08-05",0,0,0,0,0,0,0,0
"Paraguay","2024-08-06",0,0,0,0,0,0,0,0
"Paraguay","2024-08-07",0,0,0,0,0,0,0,0
"Paraguay","2024-08-08",0,0,0,0,0,0,0,0
"Paraguay","2024-08-09",0,0,0,0,0,0,0,0
"Paraguay","2024-08-10",0,0,0,0,0,0,0,0
"Paraguay","2024-08-11",0,0,0,0,0,0,0,0
"Paraguay","2024-08-12",0,0,0,0,0,0,0,0
"Paraguay","2024-08-13",0,0,0,0,0,0,0,0
"Paraguay","2024-08-14",0,0,0,0,0,0,0,0
"Paraguay","2024-08-15",0,0,0,0,0,0,0,0
"Paraguay","2024-08-16",0,0,0,0,0,0,0,0
"Paraguay","2024-08-17",0,0,0,0,0,0,0,0
"Paraguay","2024-08-18",0,0,0,0,0,0,0,0
"Paraguay","2024-08-19",0,0,0,0,0,0,0,0
"Paraguay","2024-08-20",0,0,0,0,0,0,0,0
"Paraguay","2024-08-21",0,0,0,0,0,0,0,0
"Paraguay","2024-08-22",0,0,0,0,0,0,0,0
"Paraguay","2024-08-23",0,0,0,0,0,0,0,0
"Paraguay","2024-08-24",0,0,0,0,0,0,0,0
"Paraguay","2024-08-25",0,0,0,0,0,0,0,0
"Paraguay","2024-08-26",0,0,0,0,0,0,0,0
"Paraguay","2024-08-27",0,0,0,0,0,0,0,0
"Paraguay","2024-08-28",0,0,0,0,0,0,0,0
"Paraguay","2024-08-29",0,0,0,0,0,0,0,0
"Paraguay","2024-08-30",0,0,0,0,0,0,0,0
"Paraguay","2024-08-31",0,0,0,0,0,0,0,0
"Paraguay","2024-09-01",0,0,0,0,0,0,0,0
"Paraguay","2024-09-02",0,0,0,0,0,0,0,0
"Paraguay","2024-09-03",0,0,0,0,0,0,0,0
"Paraguay","2024-09-04",0,0,0,0,0,0,0,0
"Paraguay","2024-09-05",0,0,0,0,0,0,0,0
"Paraguay","2024-09-06",0,0,0,0,0,0,0,0
"Paraguay","2024-09-07",0,0,0,0,0,0,0,0
"Paraguay","2024-09-08",0,0,0,0,0,0,0,0
"Paraguay","2024-09-09",0,0,0,0,0,0,0,0
"Paraguay","2024-09-10",0,0,0,0,0,0,0,0
"Paraguay","2024-09-11",0,0,0,0,0,0,0,0
"Paraguay","2024-09-12",0,0,0,0,0,0,0,0
"Paraguay","2024-09-13",0,0,0,0,0,0,0,0
"Paraguay","2024-09-14",0,0,0,0,0,0,0,0
"Paraguay","2024-09-15",0,0,0,0,0,0,0,0
"Paraguay","2024-09-16",0,0,0,0,0,0,0,0
"Paraguay","2024-09-17",0,0,0,0,0,0,0,0
"Paraguay","2024-09-18",0,0,0,0,0,0,0,0
"Paraguay","2024-09-19",0,0,0,0,0,0,0,0
"Paraguay","2024-09-20",0,0,0,0,0,0,0,0
"Paraguay","2024-09-21",0,0,0,0,0,0,0,0
"Paraguay","2024-09-22",0,0,0,0,0,0,0,0
"Paraguay","2024-09-23",0,0,0,0,0,0,0,0
"Paraguay","2024-09-24",0,0,0,0,0,0,0,0
"Paraguay","2024-09-25",0,0,0,0,0,0,0,0
"Paraguay","2024-09-26",0,0,0,0,0,0,0,0
"Paraguay","2024-09-27",0,0,0,0,0,0,0,0
"Paraguay","2024-09-28",0,0,0,0,0,0,0,0
"Paraguay","2024-09-29",0,0,0,0,0,0,0,0
"Paraguay","2024-09-30",0,0,0,0,0,0,0,0
"Paraguay","2024-10-01",0,0,0,0,0,0,0,0
"Paraguay","2024-10-02",0,0,0,0,0,0,0,0
"Paraguay","2024-10-03",0,0,0,0,0,0,0,0
"Paraguay","2024-10-04",0,0,0,0,0,0,0,0
"Paraguay","2024-10-05",0,0,0,0,0,0,0,0
"Paraguay","2024-10-06",0,0,0,0,0,0,0,0
"Paraguay","2024-10-07",0,0,0,0,0,0,0,0
"Paraguay","2024-10-08",0,0,0,0,0,0,0,0
"Paraguay","2024-10-09",0,0,0,0,0,0,0,0
"Paraguay","2024-10-10",0,0,0,0,0,0,0,0
"Paraguay","2024-10-11",0,0,0,0,0,0,0,0
"Paraguay","2024-10-12",0,0,0,0,0,0,0,0
"Paraguay","2024-10-13",0,0,0,0,0,0,0,0
"Paraguay","2024-10-14",0,0,0,0,0,0,0,0
"Paraguay","2024-10-15",0,0,0,0,0,0,0,0
"Paraguay","2024-10-16",0,0,0,0,0,0,0,0
"Paraguay","2024-10-17",0,0,0,0,0,0,0,0
"Paraguay","2024-10-18",0,0,0,0,0,0,0,0
"Paraguay","2024-10-19",0,0,0,0,0,0,0,0
"Paraguay","2024-10-20",0,0,0,0,0,0,0,0
"Paraguay","2024-10-21",0,0,0,0,0,0,0,0
"Paraguay","2024-10-22",0,0,0,0,0,0,0,0
"Paraguay","2024-10-23",0,0,0,0,0,0,0,0
"Paraguay","2024-10-24",0,0,0,0,0,0,0,0
"Paraguay","2024-10-25",0,0,0,0,0,0,0,0
"Paraguay","2024-10-26",0,0,0,0,0,0,0,0
"Paraguay","2024-10-27",0,0,0,0,0,0,0,0
"Paraguay","2024-10-28",0,0,0,0,0,0,0,0
"Paraguay","2024-10-29",0,0,0,0,0,0,0,0
"Paraguay","2024-10-30",0,0,0,0,0,0,0,0
"Paraguay","2024-10-31",0,0,0,0,0,0,0,0
"Paraguay","2024-11-01",0,0,0,0,0,0,0,0
"Paraguay","2024-11-02",0,0,0,0,0,0,0,0
"Paraguay","2024-11-03",0,0,0,0,0,0,0,0
"Paraguay","2024-11-04",0,0,0,0,0,0,0,0
"Paraguay","2024-11-05",0,0,0,0,0,0,0,0
"Paraguay","2024-11-06",0,0,0,0,0,0,0,0
"Paraguay","2024-11-07",0,0,0,0,0,0,0,0
"Paraguay","2024-11-08",0,0,0,0,0,0,0,0
"Paraguay","2024-11-09",0,0,0,0,0,0,0,0
"Paraguay","2024-11-10",0,0,0,0,0,0,0,0
"Paraguay","2024-11-11",0,0,0,0,0,0,0,0
"Paraguay","2024-11-12",0,0,0,0,0,0,0,0
"Paraguay","2024-11-13",0,0,0,0,0,0,0,0
"Paraguay","2024-11-14",0,0,0,0,0,0,0,0
"Paraguay","2024-11-15",0,0,0,0,0,0,0,0
"Paraguay","2024-11-16",0,0,0,0,0,0,0,0
"Paraguay","2024-11-17",0,0,0,0,0,0,0,0
"Paraguay","2024-11-18",0,0,0,0,0,0,0,0
"Paraguay","2024-11-19",0,0,0,0,0,0,0,0
"Paraguay","2024-11-20",0,0,0,0,0,0,0,0
"Paraguay","2024-11-21",0,0,0,0,0,0,0,0
"Paraguay","2024-11-22",0,0,0,0,0,0,0,0
"Paraguay","2024-11-23",0,0,0,0,0,0,0,0
"Paraguay","2024-11-24",0,0,0,0,0,0,0,0
"Paraguay","2024-11-25",0,0,0,0,0,0,0,0
"Paraguay","2024-11-26",0,0,0,0,0,0,0,0
"Paraguay","2024-11-27",0,0,0,0,0,0,0,0
"Paraguay","2024-11-28",0,0,0,0,0,0,0,0
"Paraguay","2024-11-29",0,0,0,0,0,0,0,0
"Paraguay","2024-11-30",0,0,0,0,0,0,0,0
"Paraguay","2024-12-01",0,0,0,0,0,0,0,0
"Paraguay","2024-12-02",0,0,0,0,0,0,0,0
"Paraguay","2024-12-03",0,0,0,0,0,0,0,0
"Paraguay","2024-12-04",0,0,0,0,0,0,0,0
"Paraguay","2024-12-05",0,0,0,0,0,0,0,0
"Paraguay","2024-12-06",0,0,0,0,0,0,0,0
"Paraguay","2024-12-07",0,0,0,0,0,0,0,0
"Paraguay","2024-12-08",0,0,0,0,0,0,0,0
"Paraguay","2024-12-09",0,0,0,0,0,0,0,0
"Peru","2024-01-01",0,0,0,0,0,0,0,0
"Peru","2024-01-02",0,2,2,0,2,2,0,0
"Peru","2024-01-03",0,0,2,0,0,2,0,0
"Peru","2024-01-04",0,0,2,0,0,2,0,0
"Peru","2024-01-05",0,0,2,0,0,2,0,0
"Peru","2024-01-06",0,0,2,0,1,3,0,0
"Peru","2024-01-07",0,0,2,0,0,3,0,0
"Peru","2024-01-08",0,0,2,0,0,3,0,0
"Peru","2024-01-09",0,1,3,0,0,3,0,0
"Peru","2024-01-10",0,0,3,0,0,3,0,0
"Peru","2024-01-11",0,0,3,0,1,4,0,0
"Peru","2024-01-12",0,0,3,0,0,4,0,0
"Peru","2024-01-13",0,0,3,0,0,4,0,0
"Peru","2024-01-14",0,0,3,0,0,4,0,0
"Peru","2024-01-15",0,0,3,0,1,5,0,0
"Peru","2024-01-16",0,2,5,0,0,5,0,0
"Peru","2024-01-17",0,0,5,0,0,5,0,0
"Peru","2024-01-18",0,0,5,0,0,5,0,0
"Peru","2024-01-19",0,0,5,0,1,6,0,0
"Peru","2024-01-20",0,0,5,0,0,6,0,0
"Peru","2024-01-21",0,0,5,0,0,6,0,0
"Peru","2024-01-22",0,0,5,0,0,6,0,0
"Peru","2024-01-23",0,0,5,0,1,7,0,0
"Peru","2024-01-24",0,0,5,0,0,7,0,0
"Peru","2024-01-25",0,0,5,0,0,7,0,0
"Peru","2024-01-26",0,0,5,0,0,7,0,0
"Peru","2024-01-27",0,0,5,0,0,7,0,0
"Peru","2024-01-28",0,0,5,0,1,8,0,0
"Peru","2024-01-29",0,0,5,0,0,8,0,0
"Peru","2024-01-30",0,3,8,0,0,8,0,0
"Peru","2024-01-31",0,0,8,0,0,8,0,0
"Peru","2024-02-01",0,0,8,0,0,8,0,0
"Peru","2024-02-02",0,0,8,0,0,8,0,0
"Peru","2024-02-03",0,0,8,0,1,9,0,0
"Peru","2024-02-04",0,0,8,0,0,9,0,0
"Peru","2024-02-05",0,0,8,0,0,9,0,0
"Peru","2024-02-06",0,1,9,0,0,9,0,0
"Peru","2024-02-07",0,0,9,0,0,9,0,0
"Peru","2024-02-08",0,0,9,0,1,10,0,0
"Peru","2024-02-09",0,0,9,0,0,10,0,0
"Peru","2024-02-10",0,0,9,0,0,10,0,0
"Peru","2024-02-11",0,0,9,0,0,10,0,0
"Peru","2024-02-12",0,0,9,0,1,11,0,0
"Peru","2024-02-13",0,2,11,0,0,11,0,0
"Peru","2024-02-14",0,0,11,0,0,11,0,0
"Peru","2024-02-15",0,0,11,0,1,12,0,0
"Peru","2024-02-16",0,0,11,0,0,12,0,0
"Peru","2024-02-17",0,0,11,0,0,12,0,0
"Peru","2024-02-18",0,0,11,0,0,12,0,0
"Peru","2024-02-19",0,0,11,0,1,13,0,0
"Peru","2024-02-20",0,2,13,0,0,13,0,0
"Peru","2024-02-21",0,0,13,0,1,14,0,0
"Peru","2024-02-22",0,0,13,0,0,14,0,0
"Peru","2024-02-23",0,0,13,0,1,15,0,0
"Peru","2024-02-24",0,0,13,0,1,16,0,0
"Peru","2024-02-25",0,0,13,0,1,17,0,0
"Peru","2024-02-26",0,0,13,0,0,17,0,0
"Peru","2024-02-27",0,5,18,0,1,18,0,0
"Peru","2024-02-28",0,0,18,0,0,18,0,0
"Peru","2024-02-29",0,0,18,0,1,19,0,0
"Peru","2024-03-01",0,0,18,0,0,19,0,0
"Peru","2024-03-02",0,0,18,0,0,19,0,0
"Peru","2024-03-03",0,0,18,0,0,19,0,0
"Peru","2024-03-04",0,0,18,0,1,20,0,0
"Peru","2024-03-05",0,2,20,0,0,20,0,0
"Peru","2024-03-06",0,0,20,0,0,20,0,0
"Peru","2024-03-07",0,0,20,0,1,21,0,0
"Peru","2024-03-08",0,0,20,0,0,21,0,0
"Peru","2024-03-09",0,0,20,0,0,21,0,0
"Peru","2024-03-10",0,0,20,0,0,21,0,0
"Peru","2024-03-11",0,0,20,0,1,22,0,0
"Peru","2024-03-12",0,2,22,0,0,22,0,0
"Peru","2024-03-13",0,0,22,0,1,23,0,0
"Peru","2024-03-14",0,0,22,0,0,23,0,0
"Peru","2024-03-15",0,0,22,0,1,24,0,0
"Peru","2024-03-16",0,0,22,0,1,25,0,0
"Peru","2024-03-17",0,0,22,0,1,26,0,0
"Peru","2024-03-18",0,0,22,0,0,26,0,0
"Peru","2024-03-19",0,5,27,0,1,27,0,0
"Peru","2024-03-20",0,0,27,0,1,28,0,0
"Peru","2024-03-21",0,0,27,0,0,28,0,0
"Peru","2024-03-22",0,0,27,0,1,29,0,0
"Peru","2024-03-23",0,0,27,0,1,30,0,0
"Peru","2024-03-24",0,0,27,0,1,31,0,0
"Peru","2024-03-25",0,0,27,0,0,31,0,0
"Peru","2024-03-26",0,5,32,0,1,32,0,0
"Peru","2024-03-27",0,0,32,0,0,32,0,0
"Peru","2024-03-28",0,0,32,0,0,32,0,0
"Peru","2024-03-29",0,0,32,0,0,32,0,0
"Peru","2024-03-30",0,0,32,0,0,32,0,0
"Peru","2024-03-31",0,0,32,0,0,32,0,0
"Peru","2024-04-01",0,0,32,0,0,32,0,0
"Peru","2024-04-02",0,0,32,0,0,32,0,0
"Peru","2024-04-03",0,0,32,0,1,33,0,0
"Peru","2024-04-04",0,0,32,0,0,33,0,0
"Peru","2024-04-05",0,0,32,0,0,33,0,0
"Peru","2024-04-06",0,0,32,0,0,33,0,0
"Peru","2024-04-07",0,0,32,0,0,33,0,0
"Peru","2024-04-08",0,0,32,0,0,33,0,0
"Peru","2024-04-09",0,1,33,0,0,33,0,0
"Peru","2024-04-10",0,0,33,0,1,34,0,0
"Peru","2024-04-11",0,0,33,0,1,35,0,0
"Peru","2024-04-12",0,0,33,0,1,36,0,0
"Peru","2024-04-13",0,0,33,0,0,36,0,0
"Peru","2024-04-14",0,0,33,0,1,37,0,0
"Peru","2024-04-15",0,0,33,0,1,38,0,0
"Peru","2024-04-16",0,6,39,0,1,39,0,0
"Peru","2024-04-17",0,0,39,0,0,39,0,0
"Peru","2024-04-18",0,0,39,0,1,40,0,0
"Peru","2024-04-19",0,0,39,0,0,40,0,0
"Peru","2024-04-20",0,0,39,0,1,41,0,0
"Peru","2024-04-21",0,0,39,0,0,41,0,0
"Peru","2024-04-22",0,0,39,0,1,42,0,0
"Peru","2024-04-23",0,3,42,0,0,42,0,0
"Peru","2024-04-24",0,0,42,0,1,43,0,0
"Peru","2024-04-25",0,0,42,0,0,43,0,0
"Peru","2024-04-26",0,0,42,0,1,44,0,0
"Peru","2024-04-27",0,0,42,0,0,44,0,0
"Peru","2024-04-28",0,0,42,0,1,45,0,0
"Peru","2024-04-29",0,0,42,0,0,45,0,0
"Peru","2024-04-30",0,4,46,0,1,46,0,0
"Peru","2024-05-01",0,0,46,0,0,46,0,0
"Peru","2024-05-02",0,0,46,0,1,47,0,0
"Peru","2024-05-03",0,0,46,0,0,47,0,0
"Peru","2024-05-04",0,0,46,0,1,48,0,0
"Peru","2024-05-05",0,0,46,0,0,48,0,0
"Peru","2024-05-06",0,0,46,0,1,49,0,0
"Peru","2024-05-07",0,3,49,0,0,49,0,0
"Peru","2024-05-08",0,0,49,0,0,49,0,0
"Peru","2024-05-09",0,0,49,0,1,50,0,0
"Peru","2024-05-10",0,0,49,0,0,50,0,0
"Peru","2024-05-11",0,0,49,0,0,50,0,0
"Peru","2024-05-12",0,0,49,0,0,50,0,0
"Peru","2024-05-13",0,0,49,0,1,51,0,0
"Peru","2024-05-14",0,2,51,0,0,51,0,0
"Peru","2024-05-15",0,0,51,0,0,51,0,0
"Peru","2024-05-16",0,0,51,0,0,51,0,0
"Peru","2024-05-17",0,0,51,0,0,51,0,0
"Peru","2024-05-18",0,0,51,0,1,52,0,0
"Peru","2024-05-19",0,0,51,0,0,52,0,0
"Peru","2024-05-20",0,0,51,0,0,52,0,0
"Peru","2024-05-21",0,1,52,0,0,52,0,0
"Peru","2024-05-22",0,0,52,0,1,53,0,0
"Peru","2024-05-23",0,0,52,0,0,53,0,0
"Peru","2024-05-24",0,0,52,0,1,54,0,0
"Peru","2024-05-25",0,0,52,0,1,55,0,0
"Peru","2024-05-26",0,0,52,0,1,56,0,0
"Peru","2024-05-27",0,0,52,0,0,56,0,0
"Peru","2024-05-28",0,5,57,0,1,57,0,0
"Peru","2024-05-29",0,0,57,0,0,57,0,0
"Peru","2024-05-30",0,0,57,0,1,58,0,0
"Peru","2024-05-31",0,0,57,0,0,58,0,0
"Peru","2024-06-01",0,0,57,0,0,58,0,0
"Peru","2024-06-02",0,0,57,0,0,58,0,0
"Peru","2024-06-03",0,0,57,0,1,59,0,0
"Peru","2024-06-04",0,2,59,0,0,59,0,0
"Peru","2024-06-05",0,0,59,0,1,60,0,0
"Peru","2024-06-06",0,0,59,0,0,60,0,0
"Peru","2024-06-07",0,0,59,0,1,61,0,0
"Peru","2024-06-08",0,0,59,0,0,61,0,0
"Peru","2024-06-09",0,0,59,0,1,62,0,0
"Peru","2024-06-10",0,0,59,0,0,62,0,0
"Peru","2024-06-11",0,4,63,0,1,63,0,0
"Peru","2024-06-12",0,0,63,0,0,63,0,0
"Peru","2024-06-13",0,0,63,0,1,64,0,0
"Peru","2024-06-14",0,0,63,0,0,64,0,0
"Peru","2024-06-15",0,0,63,0,0,64,0,0
"Peru","2024-06-16",0,0,63,0,0,64,0,0
"Peru","2024-06-17",0,0,63,0,1,65,0,0
"Peru","2024-06-18",0,2,65,0,0,65,0,0
"Peru","2024-06-19",0,0,65,0,0,65,0,0
"Peru","2024-06-20",0,0,65,0,0,65,0,0
"Peru","2024-06-21",0,0,65,0,0,65,0,0
"Peru","2024-06-22",0,0,65,0,1,66,0,0
"Peru","2024-06-23",0,0,65,0,0,66,0,0
"Peru","2024-06-24",0,0,65,0,0,66,0,0
"Peru","2024-06-25",0,1,66,0,0,66,0,0
"Peru","2024-06-26",0,0,66,0,1,67,0,0
"Peru","2024-06-27",0,0,66,0,1,68,0,0
"Peru","2024-06-28",0,0,66,0,1,69,0,0
"Peru","2024-06-29",0,0,66,0,0,69,0,0
"Peru","2024-06-30",0,0,66,0,1,70,0,0
"Peru","2024-07-01",0,0,66,0,1,71,0,0
"Peru","2024-07-02",0,6,72,0,1,72,0,0
"Peru","2024-07-03",0,0,72,0,1,73,0,0
"Peru","2024-07-04",0,0,72,0,0,73,0,0
"Peru","2024-07-05",0,0,72,0,1,74,0,0
"Peru","2024-07-06",0,0,72,0,0,74,0,0
"Peru","2024-07-07",0,0,72,0,1,75,0,0
"Peru","2024-07-08",0,0,72,0,0,75,0,0
"Peru","2024-07-09",0,4,76,0,1,76,0,0
"Peru","2024-07-10",0,0,76,0,0,76,0,0
"Peru","2024-07-11",0,0,76,0,1,77,0,0
"Peru","2024-07-12",0,0,76,0,0,77,0,0
"Peru","2024-07-13",0,0,76,0,1,78,0,0
"Peru","2024-07-14",0,0,76,0,0,78,0,0
"Peru","2024-07-15",0,0,76,0,1,79,0,0
"Peru","2024-07-16",0,3,79,0,0,79,0,0
"Peru","2024-07-17",0,0,79,0,0,79,0,0
"Peru","2024-07-18",0,0,79,0,1,80,0,0
"Peru","2024-07-19",0,0,79,0,0,80,0,0
"Peru","2024-07-20",0,0,79,0,0,80,0,0
"Peru","2024-07-21",0,0,79,0,0,80,0,0
"Peru","2024-07-22",0,0,79,0,1,81,0,0
"Peru","2024-07-23",0,2,81,0,0,81,0,0
"Peru","2024-07-24",0,0,81,0,0,81,0,0
"Peru","2024-07-25",0,0,81,0,1,82,0,0
"Peru","2024-07-26",0,0,81,0,0,82,0,0
"Peru","2024-07-27",0,0,81,0,0,82,0,0
"Peru","2024-07-28",0,0,81,0,0,82,0,0
"Peru","2024-07-29",0,0,81,0,1,83,0,0
"Peru","2024-07-30",0,2,83,0,0,83,0,0
"Peru","2024-07-31",0,0,83,0,0,83,0,0
"Peru","2024-08-01",0,0,83,0,0,83,0,0
"Peru","2024-08-02",0,0,83,0,0,83,0,0
"Peru","2024-08-03",0,0,83,0,0,83,0,0
"Peru","2024-08-04",0,0,83,0,0,83,0,0
"Peru","2024-08-05",0,0,83,0,0,83,0,0
"Peru","2024-08-06",0,0,83,0,0,83,0,0
"Peru","2024-08-07",0,0,83,0,1,84,0,0
"Peru","2024-08-08",0,0,83,0,0,84,0,0
"Peru","2024-08-09",0,0,83,0,0,84,0,0
"Peru","2024-08-10",0,0,83,0,0,84,0,0
"Peru","2024-08-11",0,0,83,0,0,84,0,0
"Peru","2024-08-12",0,0,83,0,0,84,0,0
"Peru","2024-08-13",0,1,84,0,0,84,0,0
"Peru","2024-08-14",0,0,84,0,0,84,0,0
"Peru","2024-08-15",0,0,84,0,0,84,0,0
"Peru","2024-08-16",0,0,84,0,0,84,0,0
"Peru","2024-08-17",0,0,84,0,1,85,0,0
"Peru","2024-08-18",0,0,84,0,0,85,0,0
"Peru","2024-08-19",0,0,84,0,0,85,0,0
"Peru","2024-08-20",0,1,85,0,0,85,0,0
"Peru","2024-08-21",0,0,85,0,0,85,0,0
"Peru","2024-08-22",0,0,85,0,0,85,0,0
"Peru","2024-08-23",0,0,85,0,0,85,0,0
"Peru","2024-08-24",0,0,85,0,1,86,0,0
"Peru","2024-08-25",0,0,85,0,0,86,0,0
"Peru","2024-08-26",0,0,85,0,0,86,0,0
"Peru","2024-08-27",0,1,86,0,0,86,0,0
"Peru","2024-08-28",0,0,86,0,0,86,0,0
"Peru","2024-08-29",0,0,86,0,0,86,0,0
"Peru","2024-08-30",0,0,86,0,0,86,0,0
"Peru","2024-08-31",0,0,86,0,0,86,0,0
"Peru","2024-09-01",0,0,86,0,0,86,0,0
"Peru","2024-09-02",0,0,86,0,0,86,0,0
"Peru","2024-09-03",0,0,86,0,0,86,0,0
"Peru","2024-09-04",0,0,86,0,1,87,0,0
"Peru","2024-09-05",0,0,86,0,0,87,0,0
"Peru","2024-09-06",0,0,86,0,0,87,0,0
"Peru","2024-09-07",0,0,86,0,0,87,0,0
"Peru","2024-09-08",0,0,86,0,0,87,0,0
"Peru","2024-09-09",0,0,86,0,0,87,0,0
"Peru","2024-09-10",0,1,87,0,0,87,0,0
"Peru","2024-09-11",0,0,87,0,0,87,0,0
"Peru","2024-09-12",0,0,87,0,1,88,0,0
"Peru","2024-09-13",0,0,87,0,0,88,0,0
"Peru","2024-09-14",0,0,87,0,0,88,0,0
"Peru","2024-09-15",0,0,87,0,0,88,0,0
"Peru","2024-09-16",0,0,87,0,1,89,0,0
"Peru","2024-09-17",0,2,89,0,0,89,0,0
"Peru","2024-09-18",0,0,89,0,0,89,0,0
"Peru","2024-09-19",0,0,89,0,0,89,0,0
"Peru","2024-09-20",0,0,89,0,0,89,0,0
"Peru","2024-09-21",0,0,89,0,0,89,0,0
"Peru","2024-09-22",0,0,89,0,0,89,0,0
"Peru","2024-09-23",0,0,89,0,0,89,0,0
"Peru","2024-09-24",0,0,89,0,0,89,0,0
"Peru","2024-09-25",0,0,89,0,1,90,0,0
"Peru","2024-09-26",0,0,89,0,0,90,0,0
"Peru","2024-09-27",0,0,89,0,0,90,0,0
"Peru","2024-09-28",0,0,89,0,0,90,0,0
"Peru","2024-09-29",0,0,89,0,0,90,0,0
"Peru","2024-09-30",0,0,89,0,0,90,0,0
"Peru","2024-10-01",0,1,90,0,0,90,0,0
"Peru","2024-10-02",0,0,90,0,0,90,0,0
"Peru","2024-10-03",0,0,90,0,0,90,0,0
"Peru","2024-10-04",0,0,90,0,0,90,0,0
"Peru","2024-10-05",0,0,90,0,0,90,0,0
"Peru","2024-10-06",0,0,90,0,0,90,0,0
"Peru","2024-10-07",0,0,90,0,0,90,0,0
"Peru","2024-10-08",0,0,90,0,0,90,0,0
"Peru","2024-10-09",0,0,90,0,0,90,0,0
"Peru","2024-10-10",0,0,90,0,0,90,0,0
"Peru","2024-10-11",0,0,90,0,0,90,0,0
"Peru","2024-10-12",0,0,90,0,0,90,0,0
"Peru","2024-10-13",0,0,90,0,0,90,0,0
"Peru","2024-10-14",0,0,90,0,0,90,0,0
"Peru","2024-10-15",0,0,90,0,0,90,0,0
"Peru","2024-10-16",0,0,90,0,0,90,0,0
"Peru","2024-10-17",0,0,90,0,0,90,0,0
"Peru","2024-10-18",0,0,90,0,0,90,0,0
"Peru","2024-10-19",0,0,90,0,0,90,0,0
"Peru","2024-10-20",0,0,90,0,0,90,0,0
"Peru","2024-10-21",0,0,90,0,0,90,0,0
"Peru","2024-10-22",0,0,90,0,0,90,0,0
"Peru","2024-10-23",0,0,90,0,0,90,0,0
"Peru","2024-10-24",0,0,90,0,0,90,0,0
"Peru","2024-10-25",0,0,90,0,0,90,0,0
"Peru","2024-10-26",0,0,90,0,0,90,0,0
"Peru","2024-10-27",0,0,90,0,0,90,0,0
"Peru","2024-10-28",0,0,90,0,0,90,0,0
"Peru","2024-10-29",0,0,90,0,0,90,0,0
"Peru","2024-10-30",0,0,90,0,0,90,0,0
"Peru","2024-10-31",0,0,90,0,0,90,0,0
"Peru","2024-11-01",0,0,90,0,0,90,0,0
"Peru","2024-11-02",0,0,90,0,0,90,0,0
"Peru","2024-11-03",0,0,90,0,0,90,0,0
"Peru","2024-11-04",0,0,90,0,0,90,0,0
"Peru","2024-11-05",0,0,90,0,0,90,0,0
"Peru","2024-11-06",0,0,90,0,0,90,0,0
"Peru","2024-11-07",0,0,90,0,0,90,0,0
"Peru","2024-11-08",0,0,90,0,0,90,0,0
"Peru","2024-11-09",0,0,90,0,0,90,0,0
"Peru","2024-11-10",0,0,90,0,0,90,0,0
"Peru","2024-11-11",0,0,90,0,0,90,0,0
"Peru","2024-11-12",0,0,90,0,0,90,0,0
"Peru","2024-11-13",0,0,90,0,0,90,0,0
"Peru","2024-11-14",0,0,90,0,0,90,0,0
"Peru","2024-11-15",0,0,90,0,0,90,0,0
"Peru","2024-11-16",0,0,90,0,0,90,0,0
"Peru","2024-11-17",0,0,90,0,0,90,0,0
"Peru","2024-11-18",0,0,90,0,0,90,0,0
"Peru","2024-11-19",0,0,90,0,0,90,0,0
"Peru","2024-11-20",0,0,90,0,0,90,0,0
"Peru","2024-11-21",0,0,90,0,0,90,0,0
"Peru","2024-11-22",0,0,90,0,0,90,0,0
"Peru","2024-11-23",0,0,90,0,0,90,0,0
"Peru","2024-11-24",0,0,90,0,0,90,0,0
"Peru","2024-11-25",0,0,90,0,0,90,0,0
"Peru","2024-11-26",0,0,90,0,0,90,0,0
"Peru","2024-11-27",0,0,90,0,0,90,0,0
"Peru","2024-11-28",0,0,90,0,0,90,0,0
"Peru","2024-11-29",0,0,90,0,0,90,0,0
"Peru","2024-11-30",0,0,90,0,0,90,0,0
"Peru","2024-12-01",0,0,90,0,0,90,0,0
"Peru","2024-12-02",0,0,90,0,0,90,0,0
"Peru","2024-12-03",0,0,90,0,0,90,0,0
"Peru","2024-12-04",0,0,90,0,0,90,0,0
"Peru","2024-12-05",0,0,90,0,0,90,0,0
"Peru","2024-12-06",0,0,90,0,0,90,0,0
"Peru","2024-12-07",0,0,90,0,0,90,0,0
"Peru","2024-12-08",0,0,90,0,0,90,0,0
"Peru","2024-12-09",0,0,90,0,0,90,0,0
"Philippines","2024-01-01",0,0,0,0,0,0,0,0
"Philippines","2024-01-02",0,0,0,0,0,0,0,0
"Philippines","2024-01-03",0,0,0,0,0,0,0,0
"Philippines","2024-01-04",0,0,0,0,0,0,0,0
"Philippines","2024-01-05",0,0,0,0,0,0,0,0
"Philippines","2024-01-06",0,0,0,0,0,0,0,0
"Philippines","2024-01-07",0,0,0,0,0,0,0,0
"Philippines","2024-01-08",0,0,0,0,0,0,0,0
"Philippines","2024-01-09",0,0,0,0,0,0,0,0
"Philippines","2024-01-10",0,0,0,0,0,0,0,0
"Philippines","2024-01-11",0,0,0,0,0,0,0,0
"Philippines","2024-01-12",0,0,0,0,0,0,0,0
"Philippines","2024-01-13",0,0,0,0,0,0,0,0
"Philippines","2024-01-14",0,0,0,0,0,0,0,0
"Philippines","2024-01-15",0,0,0,0,0,0,0,0
"Philippines","2024-01-16",0,0,0,0,0,0,0,0
"Philippines","2024-01-17",0,0,0,0,0,0,0,0
"Philippines","2024-01-18",0,0,0,0,0,0,0,0
"Philippines","2024-01-19",0,0,0,0,0,0,0,0
"Philippines","2024-01-20",0,0,0,0,0,0,0,0
"Philippines","2024-01-21",0,0,0,0,0,0,0,0
"Philippines","2024-01-22",0,0,0,0,0,0,0,0
"Philippines","2024-01-23",0,0,0,0,0,0,0,0
"Philippines","2024-01-24",0,0,0,0,0,0,0,0
"Philippines","2024-01-25",0,0,0,0,0,0,0,0
"Philippines","2024-01-26",0,0,0,0,0,0,0,0
"Philippines","2024-01-27",0,0,0,0,0,0,0,0
"Philippines","2024-01-28",0,0,0,0,0,0,0,0
"Philippines","2024-01-29",0,0,0,0,0,0,0,0
"Philippines","2024-01-30",0,0,0,0,0,0,0,0
"Philippines","2024-01-31",0,0,0,0,0,0,0,0
"Philippines","2024-02-01",0,0,0,0,0,0,0,0
"Philippines","2024-02-02",0,0,0,0,0,0,0,0
"Philippines","2024-02-03",0,0,0,0,0,0,0,0
"Philippines","2024-02-04",0,0,0,0,0,0,0,0
"Philippines","2024-02-05",0,0,0,0,0,0,0,0
"Philippines","2024-02-06",0,0,0,0,0,0,0,0
"Philippines","2024-02-07",0,0,0,0,0,0,0,0
"Philippines","2024-02-08",0,0,0,0,0,0,0,0
"Philippines","2024-02-09",0,0,0,0,0,0,0,0
"Philippines","2024-02-10",0,0,0,0,0,0,0,0
"Philippines","2024-02-11",0,0,0,0,0,0,0,0
"Philippines","2024-02-12",0,0,0,0,0,0,0,0
"Philippines","2024-02-13",0,0,0,0,0,0,0,0
"Philippines","2024-02-14",0,0,0,0,0,0,0,0
"Philippines","2024-02-15",0,0,0,0,0,0,0,0
"Philippines","2024-02-16",0,0,0,0,0,0,0,0
"Philippines","2024-02-17",0,0,0,0,0,0,0,0
"Philippines","2024-02-18",0,0,0,0,0,0,0,0
"Philippines","2024-02-19",0,0,0,0,0,0,0,0
"Philippines","2024-02-20",0,0,0,0,0,0,0,0
"Philippines","2024-02-21",0,0,0,0,0,0,0,0
"Philippines","2024-02-22",0,0,0,0,0,0,0,0
"Philippines","2024-02-23",0,0,0,0,0,0,0,0
"Philippines","2024-02-24",0,0,0,0,0,0,0,0
"Philippines","2024-02-25",0,0,0,0,0,0,0,0
"Philippines","2024-02-26",0,0,0,0,0,0,0,0
"Philippines","2024-02-27",0,0,0,0,0,0,0,0
"Philippines","2024-02-28",0,0,0,0,0,0,0,0
"Philippines","2024-02-29",0,0,0,0,0,0,0,0
"Philippines","2024-03-01",0,0,0,0,0,0,0,0
"Philippines","2024-03-02",0,0,0,0,0,0,0,0
"Philippines","2024-03-03",0,0,0,0,0,0,0,0
"Philippines","2024-03-04",0,0,0,0,0,0,0,0
"Philippines","2024-03-05",0,0,0,0,0,0,0,0
"Philippines","2024-03-06",0,0,0,0,0,0,0,0
"Philippines","2024-03-07",0,0,0,0,0,0,0,0
"Philippines","2024-03-08",0,0,0,0,0,0,0,0
"Philippines","2024-03-09",0,0,0,0,0,0,0,0
"Philippines","2024-03-10",0,0,0,0,0,0,0,0
"Philippines","2024-03-11",0,0,0,0,0,0,0,0
"Philippines","2024-03-12",0,0,0,0,0,0,0,0
"Philippines","2024-03-13",0,0,0,0,0,0,0,0
"Philippines","2024-03-14",0,0,0,0,0,0,0,0
"Philippines","2024-03-15",0,0,0,0,0,0,0,0
"Philippines","2024-03-16",0,0,0,0,0,0,0,0
"Philippines","2024-03-17",0,0,0,0,0,0,0,0
"Philippines","2024-03-18",0,0,0,0,0,0,0,0
"Philippines","2024-03-19",0,0,0,0,0,0,0,0
"Philippines","2024-03-20",0,0,0,0,0,0,0,0
"Philippines","2024-03-21",0,0,0,0,0,0,0,0
"Philippines","2024-03-22",0,0,0,0,0,0,0,0
"Philippines","2024-03-23",0,0,0,0,0,0,0,0
"Philippines","2024-03-24",0,0,0,0,0,0,0,0
"Philippines","2024-03-25",0,0,0,0,0,0,0,0
"Philippines","2024-03-26",0,0,0,0,0,0,0,0
"Philippines","2024-03-27",0,0,0,0,0,0,0,0
"Philippines","2024-03-28",0,0,0,0,0,0,0,0
"Philippines","2024-03-29",0,0,0,0,0,0,0,0
"Philippines","2024-03-30",0,0,0,0,0,0,0,0
"Philippines","2024-03-31",0,0,0,0,0,0,0,0
"Philippines","2024-04-01",0,0,0,0,0,0,0,0
"Philippines","2024-04-02",0,0,0,0,0,0,0,0
"Philippines","2024-04-03",0,0,0,0,0,0,0,0
"Philippines","2024-04-04",0,0,0,0,0,0,0,0
"Philippines","2024-04-05",0,0,0,0,0,0,0,0
"Philippines","2024-04-06",0,0,0,0,0,0,0,0
"Philippines","2024-04-07",0,0,0,0,0,0,0,0
"Philippines","2024-04-08",0,0,0,0,0,0,0,0
"Philippines","2024-04-09",0,0,0,0,0,0,0,0
"Philippines","2024-04-10",0,0,0,0,0,0,0,0
"Philippines","2024-04-11",0,0,0,0,0,0,0,0
"Philippines","2024-04-12",0,0,0,0,0,0,0,0
"Philippines","2024-04-13",0,0,0,0,0,0,0,0
"Philippines","2024-04-14",0,0,0,0,0,0,0,0
"Philippines","2024-04-15",0,0,0,0,0,0,0,0
"Philippines","2024-04-16",0,0,0,0,0,0,0,0
"Philippines","2024-04-17",0,0,0,0,0,0,0,0
"Philippines","2024-04-18",0,0,0,0,0,0,0,0
"Philippines","2024-04-19",0,0,0,0,0,0,0,0
"Philippines","2024-04-20",0,0,0,0,0,0,0,0
"Philippines","2024-04-21",0,0,0,0,0,0,0,0
"Philippines","2024-04-22",0,0,0,0,0,0,0,0
"Philippines","2024-04-23",0,0,0,0,0,0,0,0
"Philippines","2024-04-24",0,0,0,0,0,0,0,0
"Philippines","2024-04-25",0,0,0,0,0,0,0,0
"Philippines","2024-04-26",0,0,0,0,0,0,0,0
"Philippines","2024-04-27",0,0,0,0,0,0,0,0
"Philippines","2024-04-28",0,0,0,0,0,0,0,0
"Philippines","2024-04-29",0,0,0,0,0,0,0,0
"Philippines","2024-04-30",0,0,0,0,0,0,0,0
"Philippines","2024-05-01",0,0,0,0,0,0,0,0
"Philippines","2024-05-02",0,0,0,0,0,0,0,0
"Philippines","2024-05-03",0,0,0,0,0,0,0,0
"Philippines","2024-05-04",0,0,0,0,0,0,0,0
"Philippines","2024-05-05",0,0,0,0,0,0,0,0
"Philippines","2024-05-06",0,0,0,0,0,0,0,0
"Philippines","2024-05-07",0,0,0,0,0,0,0,0
"Philippines","2024-05-08",0,0,0,0,0,0,0,0
"Philippines","2024-05-09",0,0,0,0,0,0,0,0
"Philippines","2024-05-10",0,0,0,0,0,0,0,0
"Philippines","2024-05-11",0,0,0,0,0,0,0,0
"Philippines","2024-05-12",0,0,0,0,0,0,0,0
"Philippines","2024-05-13",0,0,0,0,0,0,0,0
"Philippines","2024-05-14",0,0,0,0,0,0,0,0
"Philippines","2024-05-15",0,0,0,0,0,0,0,0
"Philippines","2024-05-16",0,0,0,0,0,0,0,0
"Philippines","2024-05-17",0,0,0,0,0,0,0,0
"Philippines","2024-05-18",0,0,0,0,0,0,0,0
"Philippines","2024-05-19",0,0,0,0,0,0,0,0
"Philippines","2024-05-20",0,0,0,0,0,0,0,0
"Philippines","2024-05-21",0,0,0,0,0,0,0,0
"Philippines","2024-05-22",0,0,0,0,0,0,0,0
"Philippines","2024-05-23",0,0,0,0,0,0,0,0
"Philippines","2024-05-24",0,0,0,0,0,0,0,0
"Philippines","2024-05-25",0,0,0,0,0,0,0,0
"Philippines","2024-05-26",0,0,0,0,0,0,0,0
"Philippines","2024-05-27",0,0,0,0,0,0,0,0
"Philippines","2024-05-28",0,0,0,0,0,0,0,0
"Philippines","2024-05-29",0,0,0,0,0,0,0,0
"Philippines","2024-05-30",0,0,0,0,0,0,0,0
"Philippines","2024-05-31",0,0,0,0,0,0,0,0
"Philippines","2024-06-01",0,0,0,0,0,0,0,0
"Philippines","2024-06-02",0,0,0,0,0,0,0,0
"Philippines","2024-06-03",0,0,0,0,0,0,0,0
"Philippines","2024-06-04",0,0,0,0,0,0,0,0
"Philippines","2024-06-05",0,0,0,0,0,0,0,0
"Philippines","2024-06-06",0,0,0,0,0,0,0,0
"Philippines","2024-06-07",0,0,0,0,0,0,0,0
"Philippines","2024-06-08",0,0,0,0,0,0,0,0
"Philippines","2024-06-09",0,0,0,0,0,0,0,0
"Philippines","2024-06-10",0,0,0,0,0,0,0,0
"Philippines","2024-06-11",0,0,0,0,0,0,0,0
"Philippines","2024-06-12",0,0,0,0,0,0,0,0
"Philippines","2024-06-13",0,0,0,0,0,0,0,0
"Philippines","2024-06-14",0,0,0,0,0,0,0,0
"Philippines","2024-06-15",0,0,0,0,0,0,0,0
"Philippines","2024-06-16",0,0,0,0,0,0,0,0
"Philippines","2024-06-17",0,0,0,0,0,0,0,0
"Philippines","2024-06-18",0,0,0,0,0,0,0,0
"Philippines","2024-06-19",0,0,0,0,0,0,0,0
"Philippines","2024-06-20",0,0,0,0,0,0,0,0
"Philippines","2024-06-21",0,0,0,0,0,0,0,0
"Philippines","2024-06-22",0,0,0,0,0,0,0,0
"Philippines","2024-06-23",0,0,0,0,0,0,0,0
"Philippines","2024-06-24",0,0,0,0,0,0,0,0
"Philippines","2024-06-25",0,0,0,0,0,0,0,0
"Philippines","2024-06-26",0,0,0,0,0,0,0,0
"Philippines","2024-06-27",0,0,0,0,0,0,0,0
"Philippines","2024-06-28",0,0,0,0,0,0,0,0
"Philippines","2024-06-29",0,0,0,0,0,0,0,0
"Philippines","2024-06-30",0,0,0,0,0,0,0,0
"Philippines","2024-07-01",0,0,0,0,0,0,0,0
"Philippines","2024-07-02",0,0,0,0,0,0,0,0
"Philippines","2024-07-03",0,0,0,0,0,0,0,0
"Philippines","2024-07-04",0,0,0,0,0,0,0,0
"Philippines","2024-07-05",0,0,0,0,0,0,0,0
"Philippines","2024-07-06",0,0,0,0,0,0,0,0
"Philippines","2024-07-07",0,0,0,0,0,0,0,0
"Philippines","2024-07-08",0,0,0,0,0,0,0,0
"Philippines","2024-07-09",0,0,0,0,0,0,0,0
"Philippines","2024-07-10",0,0,0,0,0,0,0,0
"Philippines","2024-07-11",0,0,0,0,0,0,0,0
"Philippines","2024-07-12",0,0,0,0,0,0,0,0
"Philippines","2024-07-13",0,0,0,0,0,0,0,0
"Philippines","2024-07-14",0,0,0,0,0,0,0,0
"Philippines","2024-07-15",0,0,0,0,0,0,0,0
"Philippines","2024-07-16",0,0,0,0,0,0,0,0
"Philippines","2024-07-17",0,0,0,0,0,0,0,0
"Philippines","2024-07-18",0,0,0,0,0,0,0,0
"Philippines","2024-07-19",0,0,0,0,0,0,0,0
"Philippines","2024-07-20",0,0,0,0,0,0,0,0
"Philippines","2024-07-21",0,0,0,0,0,0,0,0
"Philippines","2024-07-22",0,0,0,0,0,0,0,0
"Philippines","2024-07-23",0,0,0,0,0,0,0,0
"Philippines","2024-07-24",0,0,0,0,0,0,0,0
"Philippines","2024-07-25",0,0,0,0,0,0,0,0
"Philippines","2024-07-26",0,0,0,0,0,0,0,0
"Philippines","2024-07-27",0,0,0,0,0,0,0,0
"Philippines","2024-07-28",0,0,0,0,0,0,0,0
"Philippines","2024-07-29",0,0,0,0,0,0,0,0
"Philippines","2024-07-30",0,0,0,0,0,0,0,0
"Philippines","2024-07-31",0,0,0,0,0,0,0,0
"Philippines","2024-08-01",0,0,0,0,0,0,0,0
"Philippines","2024-08-02",0,0,0,0,0,0,0,0
"Philippines","2024-08-03",0,0,0,0,0,0,0,0
"Philippines","2024-08-04",0,0,0,0,0,0,0,0
"Philippines","2024-08-05",0,0,0,0,0,0,0,0
"Philippines","2024-08-06",0,0,0,0,0,0,0,0
"Philippines","2024-08-07",0,0,0,0,0,0,0,0
"Philippines","2024-08-08",0,0,0,0,0,0,0,0
"Philippines","2024-08-09",0,0,0,0,0,0,0,0
"Philippines","2024-08-10",0,0,0,0,0,0,0,0
"Philippines","2024-08-11",0,0,0,0,0,0,0,0
"Philippines","2024-08-12",0,0,0,0,0,0,0,0
"Philippines","2024-08-13",0,0,0,0,0,0,0,0
"Philippines","2024-08-14",0,0,0,0,0,0,0,0
"Philippines","2024-08-15",0,0,0,0,0,0,0,0
"Philippines","2024-08-16",0,0,0,0,0,0,0,0
"Philippines","2024-08-17",0,0,0,0,0,0,0,0
"Philippines","2024-08-18",0,0,0,0,0,0,0,0
"Philippines","2024-08-19",0,1,1,0,1,1,0,0
"Philippines","2024-08-20",0,0,1,0,0,1,0,0
"Philippines","2024-08-21",0,0,1,0,1,2,0,0
"Philippines","2024-08-22",0,0,1,0,0,2,0,0
"Philippines","2024-08-23",0,0,1,0,1,3,0,0
"Philippines","2024-08-24",0,0,1,0,0,3,0,0
"Philippines","2024-08-25",0,0,1,0,1,4,0,0
"Philippines","2024-08-26",0,0,1,0,0,4,0,0
"Philippines","2024-08-27",0,0,1,0,1,5,0,0
"Philippines","2024-08-28",0,4,5,0,0,5,0,0
"Philippines","2024-08-29",0,0,5,0,1,6,0,0
"Philippines","2024-08-30",0,0,5,0,1,7,0,0
"Philippines","2024-08-31",0,0,5,0,0,7,0,0
"Philippines","2024-09-01",0,3,8,0,1,8,0,0
"Philippines","2024-09-02",0,0,8,0,1,9,0,0
"Philippines","2024-09-03",0,0,8,0,0,9,0,0
"Philippines","2024-09-04",0,0,8,0,1,10,0,0
"Philippines","2024-09-05",0,0,8,0,0,10,0,0
"Philippines","2024-09-06",0,0,8,0,1,11,0,0
"Philippines","2024-09-07",0,0,8,0,1,12,0,0
"Philippines","2024-09-08",0,0,8,0,0,12,0,0
"Philippines","2024-09-09",0,0,8,0,1,13,0,0
"Philippines","2024-09-10",0,0,8,0,0,13,0,0
"Philippines","2024-09-11",0,0,8,0,1,14,0,0
"Philippines","2024-09-12",0,0,8,0,1,15,0,0
"Philippines","2024-09-13",0,0,8,0,0,15,0,0
"Philippines","2024-09-14",0,0,8,0,1,16,0,0
"Philippines","2024-09-15",0,0,8,0,0,16,0,0
"Philippines","2024-09-16",0,0,8,0,1,17,0,0
"Philippines","2024-09-17",0,0,8,0,1,18,0,0
"Philippines","2024-09-18",0,0,8,0,0,18,0,0
"Philippines","2024-09-19",0,0,8,0,1,19,0,0
"Philippines","2024-09-20",0,0,8,0,0,19,0,0
"Philippines","2024-09-21",0,0,8,0,1,20,0,0
"Philippines","2024-09-22",0,0,8,0,1,21,0,0
"Philippines","2024-09-23",0,0,8,0,0,21,0,0
"Philippines","2024-09-24",0,0,8,0,1,22,0,0
"Philippines","2024-09-25",0,0,8,0,0,22,0,0
"Philippines","2024-09-26",0,15,23,0,1,23,0,0
"Philippines","2024-09-27",0,0,23,0,0,23,0,0
"Philippines","2024-09-28",0,0,23,0,0,23,0,0
"Philippines","2024-09-29",0,0,23,0,0,23,0,0
"Philippines","2024-09-30",0,0,23,0,0,23,0,0
"Philippines","2024-10-01",0,0,23,0,0,23,0,0
"Philippines","2024-10-02",0,0,23,0,0,23,0,0
"Philippines","2024-10-03",0,0,23,0,0,23,0,0
"Philippines","2024-10-04",0,0,23,0,0,23,0,0
"Philippines","2024-10-05",0,0,23,0,0,23,0,0
"Philippines","2024-10-06",0,0,23,0,0,23,0,0
"Philippines","2024-10-07",0,0,23,0,0,23,0,0
"Philippines","2024-10-08",0,0,23,0,0,23,0,0
"Philippines","2024-10-09",0,0,23,0,0,23,0,0
"Philippines","2024-10-10",0,0,23,0,0,23,0,0
"Philippines","2024-10-11",0,0,23,0,0,23,0,0
"Philippines","2024-10-12",0,0,23,0,0,23,0,0
"Philippines","2024-10-13",0,0,23,0,0,23,0,0
"Philippines","2024-10-14",0,0,23,0,0,23,0,0
"Philippines","2024-10-15",0,0,23,0,0,23,0,0
"Philippines","2024-10-16",0,0,23,0,0,23,0,0
"Philippines","2024-10-17",0,0,23,0,0,23,0,0
"Philippines","2024-10-18",0,0,23,0,0,23,0,0
"Philippines","2024-10-19",0,0,23,0,0,23,0,0
"Philippines","2024-10-20",0,0,23,0,0,23,0,0
"Philippines","2024-10-21",0,0,23,0,0,23,0,0
"Philippines","2024-10-22",0,0,23,0,0,23,0,0
"Philippines","2024-10-23",0,0,23,0,0,23,0,0
"Philippines","2024-10-24",0,0,23,0,0,23,0,0
"Philippines","2024-10-25",0,0,23,0,0,23,0,0
"Philippines","2024-10-26",0,0,23,0,0,23,0,0
"Philippines","2024-10-27",0,0,23,0,0,23,0,0
"Philippines","2024-10-28",0,0,23,0,0,23,0,0
"Philippines","2024-10-29",0,0,23,0,0,23,0,0
"Philippines","2024-10-30",0,0,23,0,0,23,0,0
"Philippines","2024-10-31",0,0,23,0,0,23,0,0
"Philippines","2024-11-01",0,0,23,0,0,23,0,0
"Philippines","2024-11-02",0,0,23,0,0,23,0,0
"Philippines","2024-11-03",0,0,23,0,0,23,0,0
"Philippines","2024-11-04",0,0,23,0,0,23,0,0
"Philippines","2024-11-05",0,0,23,0,0,23,0,0
"Philippines","2024-11-06",0,0,23,0,0,23,0,0
"Philippines","2024-11-07",0,0,23,0,0,23,0,0
"Philippines","2024-11-08",0,0,23,0,0,23,0,0
"Philippines","2024-11-09",0,0,23,0,0,23,0,0
"Philippines","2024-11-10",0,0,23,0,0,23,0,0
"Philippines","2024-11-11",0,0,23,0,0,23,0,0
"Philippines","2024-11-12",0,0,23,0,0,23,0,0
"Philippines","2024-11-13",0,0,23,0,0,23,0,0
"Philippines","2024-11-14",0,0,23,0,0,23,0,0
"Philippines","2024-11-15",0,0,23,0,0,23,0,0
"Philippines","2024-11-16",0,0,23,0,0,23,0,0
"Philippines","2024-11-17",0,0,23,0,0,23,0,0
"Philippines","2024-11-18",0,0,23,0,0,23,0,0
"Philippines","2024-11-19",0,0,23,0,0,23,0,0
"Philippines","2024-11-20",0,0,23,0,0,23,0,0
"Philippines","2024-11-21",0,0,23,0,0,23,0,0
"Philippines","2024-11-22",0,0,23,0,0,23,0,0
"Philippines","2024-11-23",0,0,23,0,0,23,0,0
"Philippines","2024-11-24",0,0,23,0,0,23,0,0
"Philippines","2024-11-25",0,0,23,0,0,23,0,0
"Philippines","2024-11-26",0,0,23,0,0,23,0,0
"Philippines","2024-11-27",0,0,23,0,0,23,0,0
"Philippines","2024-11-28",0,0,23,0,0,23,0,0
"Philippines","2024-11-29",0,0,23,0,0,23,0,0
"Philippines","2024-11-30",0,0,23,0,0,23,0,0
"Philippines","2024-12-01",0,0,23,0,0,23,0,0
"Philippines","2024-12-02",0,0,23,0,0,23,0,0
"Philippines","2024-12-03",0,0,23,0,0,23,0,0
"Philippines","2024-12-04",0,0,23,0,0,23,0,0
"Philippines","2024-12-05",0,0,23,0,0,23,0,0
"Philippines","2024-12-06",0,0,23,0,0,23,0,0
"Philippines","2024-12-07",0,0,23,0,0,23,0,0
"Philippines","2024-12-08",0,0,23,0,0,23,0,0
"Philippines","2024-12-09",0,0,23,0,0,23,0,0
"Poland","2024-01-01",0,0,0,0,0,0,0,0
"Poland","2024-01-02",0,0,0,0,0,0,0,0
"Poland","2024-01-03",0,0,0,0,0,0,0,0
"Poland","2024-01-04",0,0,0,0,0,0,0,0
"Poland","2024-01-05",0,0,0,0,0,0,0,0
"Poland","2024-01-06",0,0,0,0,0,0,0,0
"Poland","2024-01-07",0,0,0,0,0,0,0,0
"Poland","2024-01-08",0,0,0,0,0,0,0,0
"Poland","2024-01-09",0,0,0,0,0,0,0,0
"Poland","2024-01-10",0,0,0,0,0,0,0,0
"Poland","2024-01-11",0,0,0,0,0,0,0,0
"Poland","2024-01-12",0,0,0,0,0,0,0,0
"Poland","2024-01-13",0,0,0,0,0,0,0,0
"Poland","2024-01-14",0,0,0,0,0,0,0,0
"Poland","2024-01-15",0,0,0,0,0,0,0,0
"Poland","2024-01-16",0,0,0,0,0,0,0,0
"Poland","2024-01-17",0,0,0,0,0,0,0,0
"Poland","2024-01-18",0,0,0,0,0,0,0,0
"Poland","2024-01-19",0,0,0,0,0,0,0,0
"Poland","2024-01-20",0,0,0,0,0,0,0,0
"Poland","2024-01-21",0,0,0,0,0,0,0,0
"Poland","2024-01-22",0,0,0,0,0,0,0,0
"Poland","2024-01-23",0,0,0,0,0,0,0,0
"Poland","2024-01-24",0,0,0,0,0,0,0,0
"Poland","2024-01-25",0,0,0,0,0,0,0,0
"Poland","2024-01-26",0,0,0,0,0,0,0,0
"Poland","2024-01-27",0,0,0,0,0,0,0,0
"Poland","2024-01-28",0,0,0,0,0,0,0,0
"Poland","2024-01-29",0,0,0,0,0,0,0,0
"Poland","2024-01-30",0,0,0,0,0,0,0,0
"Poland","2024-01-31",0,3,3,0,3,3,0,0
"Poland","2024-02-01",0,0,3,0,0,3,0,0
"Poland","2024-02-02",0,0,3,0,0,3,0,0
"Poland","2024-02-03",0,0,3,0,0,3,0,0
"Poland","2024-02-04",0,0,3,0,0,3,0,0
"Poland","2024-02-05",0,0,3,0,0,3,0,0
"Poland","2024-02-06",0,0,3,0,0,3,0,0
"Poland","2024-02-07",0,0,3,0,0,3,0,0
"Poland","2024-02-08",0,0,3,0,0,3,0,0
"Poland","2024-02-09",0,0,3,0,0,3,0,0
"Poland","2024-02-10",0,0,3,0,0,3,0,0
"Poland","2024-02-11",0,0,3,0,0,3,0,0
"Poland","2024-02-12",0,0,3,0,0,3,0,0
"Poland","2024-02-13",0,0,3,0,0,3,0,0
"Poland","2024-02-14",0,0,3,0,0,3,0,0
"Poland","2024-02-15",0,0,3,0,0,3,0,0
"Poland","2024-02-16",0,0,3,0,0,3,0,0
"Poland","2024-02-17",0,0,3,0,0,3,0,0
"Poland","2024-02-18",0,0,3,0,0,3,0,0
"Poland","2024-02-19",0,0,3,0,0,3,0,0
"Poland","2024-02-20",0,0,3,0,0,3,0,0
"Poland","2024-02-21",0,0,3,0,0,3,0,0
"Poland","2024-02-22",0,0,3,0,0,3,0,0
"Poland","2024-02-23",0,0,3,0,0,3,0,0
"Poland","2024-02-24",0,0,3,0,0,3,0,0
"Poland","2024-02-25",0,0,3,0,0,3,0,0
"Poland","2024-02-26",0,0,3,0,0,3,0,0
"Poland","2024-02-27",0,0,3,0,0,3,0,0
"Poland","2024-02-28",0,0,3,0,0,3,0,0
"Poland","2024-02-29",0,0,3,0,0,3,0,0
"Poland","2024-03-01",0,0,3,0,0,3,0,0
"Poland","2024-03-02",0,0,3,0,1,4,0,0
"Poland","2024-03-03",0,0,3,0,0,4,0,0
"Poland","2024-03-04",0,0,3,0,0,4,0,0
"Poland","2024-03-05",0,0,3,0,0,4,0,0
"Poland","2024-03-06",0,0,3,0,0,4,0,0
"Poland","2024-03-07",0,0,3,0,0,4,0,0
"Poland","2024-03-08",0,0,3,0,0,4,0,0
"Poland","2024-03-09",0,0,3,0,0,4,0,0
"Poland","2024-03-10",0,0,3,0,0,4,0,0
"Poland","2024-03-11",0,0,3,0,0,4,0,0
"Poland","2024-03-12",0,0,3,0,0,4,0,0
"Poland","2024-03-13",0,0,3,0,0,4,0,0
"Poland","2024-03-14",0,0,3,0,0,4,0,0
"Poland","2024-03-15",0,0,3,0,0,4,0,0
"Poland","2024-03-16",0,0,3,0,0,4,0,0
"Poland","2024-03-17",0,0,3,0,0,4,0,0
"Poland","2024-03-18",0,0,3,0,0,4,0,0
"Poland","2024-03-19",0,0,3,0,0,4,0,0
"Poland","2024-03-20",0,0,3,0,0,4,0,0
"Poland","2024-03-21",0,0,3,0,0,4,0,0
"Poland","2024-03-22",0,0,3,0,0,4,0,0
"Poland","2024-03-23",0,0,3,0,0,4,0,0
"Poland","2024-03-24",0,0,3,0,0,4,0,0
"Poland","2024-03-25",0,0,3,0,0,4,0,0
"Poland","2024-03-26",0,0,3,0,0,4,0,0
"Poland","2024-03-27",0,0,3,0,0,4,0,0
"Poland","2024-03-28",0,0,3,0,0,4,0,0
"Poland","2024-03-29",0,0,3,0,0,4,0,0
"Poland","2024-03-30",0,0,3,0,0,4,0,0
"Poland","2024-03-31",0,1,4,0,0,4,0,0
"Poland","2024-04-01",0,0,4,0,0,4,0,0
"Poland","2024-04-02",0,0,4,0,0,4,0,0
"Poland","2024-04-03",0,0,4,0,0,4,0,0
"Poland","2024-04-04",0,0,4,0,0,4,0,0
"Poland","2024-04-05",0,0,4,0,0,4,0,0
"Poland","2024-04-06",0,0,4,0,0,4,0,0
"Poland","2024-04-07",0,0,4,0,0,4,0,0
"Poland","2024-04-08",0,0,4,0,0,4,0,0
"Poland","2024-04-09",0,0,4,0,0,4,0,0
"Poland","2024-04-10",0,0,4,0,0,4,0,0
"Poland","2024-04-11",0,0,4,0,0,4,0,0
"Poland","2024-04-12",0,0,4,0,0,4,0,0
"Poland","2024-04-13",0,0,4,0,0,4,0,0
"Poland","2024-04-14",0,0,4,0,0,4,0,0
"Poland","2024-04-15",0,0,4,0,0,4,0,0
"Poland","2024-04-16",0,0,4,0,1,5,0,0
"Poland","2024-04-17",0,0,4,0,0,5,0,0
"Poland","2024-04-18",0,0,4,0,0,5,0,0
"Poland","2024-04-19",0,0,4,0,0,5,0,0
"Poland","2024-04-20",0,0,4,0,0,5,0,0
"Poland","2024-04-21",0,0,4,0,0,5,0,0
"Poland","2024-04-22",0,0,4,0,0,5,0,0
"Poland","2024-04-23",0,0,4,0,0,5,0,0
"Poland","2024-04-24",0,0,4,0,0,5,0,0
"Poland","2024-04-25",0,0,4,0,0,5,0,0
"Poland","2024-04-26",0,0,4,0,0,5,0,0
"Poland","2024-04-27",0,0,4,0,0,5,0,0
"Poland","2024-04-28",0,0,4,0,0,5,0,0
"Poland","2024-04-29",0,0,4,0,0,5,0,0
"Poland","2024-04-30",0,0,4,0,0,5,0,0
"Poland","2024-05-01",0,0,4,0,0,5,0,0
"Poland","2024-05-02",0,0,4,0,0,5,0,0
"Poland","2024-05-03",0,0,4,0,0,5,0,0
"Poland","2024-05-04",0,0,4,0,0,5,0,0
"Poland","2024-05-05",0,0,4,0,0,5,0,0
"Poland","2024-05-06",0,0,4,0,0,5,0,0
"Poland","2024-05-07",0,0,4,0,0,5,0,0
"Poland","2024-05-08",0,0,4,0,0,5,0,0
"Poland","2024-05-09",0,0,4,0,0,5,0,0
"Poland","2024-05-10",0,0,4,0,0,5,0,0
"Poland","2024-05-11",0,0,4,0,0,5,0,0
"Poland","2024-05-12",0,0,4,0,0,5,0,0
"Poland","2024-05-13",0,0,4,0,0,5,0,0
"Poland","2024-05-14",0,0,4,0,0,5,0,0
"Poland","2024-05-15",0,0,4,0,0,5,0,0
"Poland","2024-05-16",0,0,4,0,1,6,0,0
"Poland","2024-05-17",0,0,4,0,0,6,0,0
"Poland","2024-05-18",0,0,4,0,0,6,0,0
"Poland","2024-05-19",0,0,4,0,0,6,0,0
"Poland","2024-05-20",0,0,4,0,0,6,0,0
"Poland","2024-05-21",0,0,4,0,0,6,0,0
"Poland","2024-05-22",0,0,4,0,0,6,0,0
"Poland","2024-05-23",0,0,4,0,0,6,0,0
"Poland","2024-05-24",0,0,4,0,0,6,0,0
"Poland","2024-05-25",0,0,4,0,0,6,0,0
"Poland","2024-05-26",0,0,4,0,0,6,0,0
"Poland","2024-05-27",0,0,4,0,0,6,0,0
"Poland","2024-05-28",0,0,4,0,0,6,0,0
"Poland","2024-05-29",0,0,4,0,0,6,0,0
"Poland","2024-05-30",0,0,4,0,0,6,0,0
"Poland","2024-05-31",0,2,6,0,0,6,0,0
"Poland","2024-06-01",0,0,6,0,0,6,0,0
"Poland","2024-06-02",0,0,6,0,0,6,0,0
"Poland","2024-06-03",0,0,6,0,0,6,0,0
"Poland","2024-06-04",0,0,6,0,0,6,0,0
"Poland","2024-06-05",0,0,6,0,0,6,0,0
"Poland","2024-06-06",0,0,6,0,0,6,0,0
"Poland","2024-06-07",0,0,6,0,0,6,0,0
"Poland","2024-06-08",0,0,6,0,0,6,0,0
"Poland","2024-06-09",0,0,6,0,0,6,0,0
"Poland","2024-06-10",0,0,6,0,0,6,0,0
"Poland","2024-06-11",0,0,6,0,0,6,0,0
"Poland","2024-06-12",0,0,6,0,0,6,0,0
"Poland","2024-06-13",0,0,6,0,0,6,0,0
"Poland","2024-06-14",0,0,6,0,0,6,0,0
"Poland","2024-06-15",0,0,6,0,0,6,0,0
"Poland","2024-06-16",0,0,6,0,0,6,0,0
"Poland","2024-06-17",0,0,6,0,0,6,0,0
"Poland","2024-06-18",0,0,6,0,0,6,0,0
"Poland","2024-06-19",0,0,6,0,0,6,0,0
"Poland","2024-06-20",0,0,6,0,0,6,0,0
"Poland","2024-06-21",0,0,6,0,0,6,0,0
"Poland","2024-06-22",0,0,6,0,0,6,0,0
"Poland","2024-06-23",0,0,6,0,0,6,0,0
"Poland","2024-06-24",0,0,6,0,1,7,0,0
"Poland","2024-06-25",0,0,6,0,0,7,0,0
"Poland","2024-06-26",0,0,6,0,0,7,0,0
"Poland","2024-06-27",0,0,6,0,0,7,0,0
"Poland","2024-06-28",0,0,6,0,0,7,0,0
"Poland","2024-06-29",0,0,6,0,0,7,0,0
"Poland","2024-06-30",0,0,6,0,0,7,0,0
"Poland","2024-07-01",0,0,6,0,0,7,0,0
"Poland","2024-07-02",0,0,6,0,0,7,0,0
"Poland","2024-07-03",0,0,6,0,0,7,0,0
"Poland","2024-07-04",0,0,6,0,0,7,0,0
"Poland","2024-07-05",0,0,6,0,0,7,0,0
"Poland","2024-07-06",0,0,6,0,0,7,0,0
"Poland","2024-07-07",0,0,6,0,0,7,0,0
"Poland","2024-07-08",0,0,6,0,0,7,0,0
"Poland","2024-07-09",0,0,6,0,0,7,0,0
"Poland","2024-07-10",0,0,6,0,0,7,0,0
"Poland","2024-07-11",0,0,6,0,0,7,0,0
"Poland","2024-07-12",0,0,6,0,0,7,0,0
"Poland","2024-07-13",0,0,6,0,0,7,0,0
"Poland","2024-07-14",0,0,6,0,0,7,0,0
"Poland","2024-07-15",0,0,6,0,0,7,0,0
"Poland","2024-07-16",0,0,6,0,0,7,0,0
"Poland","2024-07-17",0,0,6,0,0,7,0,0
"Poland","2024-07-18",0,0,6,0,0,7,0,0
"Poland","2024-07-19",0,0,6,0,0,7,0,0
"Poland","2024-07-20",0,0,6,0,0,7,0,0
"Poland","2024-07-21",0,0,6,0,0,7,0,0
"Poland","2024-07-22",0,0,6,0,0,7,0,0
"Poland","2024-07-23",0,0,6,0,0,7,0,0
"Poland","2024-07-24",0,0,6,0,0,7,0,0
"Poland","2024-07-25",0,0,6,0,0,7,0,0
"Poland","2024-07-26",0,0,6,0,0,7,0,0
"Poland","2024-07-27",0,0,6,0,0,7,0,0
"Poland","2024-07-28",0,0,6,0,0,7,0,0
"Poland","2024-07-29",0,0,6,0,0,7,0,0
"Poland","2024-07-30",0,0,6,0,0,7,0,0
"Poland","2024-07-31",0,0,6,0,0,7,0,0
"Poland","2024-08-01",0,0,6,0,0,7,0,0
"Poland","2024-08-02",0,0,6,0,0,7,0,0
"Poland","2024-08-03",0,0,6,0,0,7,0,0
"Poland","2024-08-04",0,0,6,0,0,7,0,0
"Poland","2024-08-05",0,0,6,0,0,7,0,0
"Poland","2024-08-06",0,0,6,0,0,7,0,0
"Poland","2024-08-07",0,0,6,0,0,7,0,0
"Poland","2024-08-08",0,0,6,0,1,8,0,0
"Poland","2024-08-09",0,0,6,0,0,8,0,0
"Poland","2024-08-10",0,0,6,0,0,8,0,0
"Poland","2024-08-11",0,0,6,0,0,8,0,0
"Poland","2024-08-12",0,0,6,0,0,8,0,0
"Poland","2024-08-13",0,0,6,0,0,8,0,0
"Poland","2024-08-14",0,0,6,0,0,8,0,0
"Poland","2024-08-15",0,0,6,0,0,8,0,0
"Poland","2024-08-16",0,0,6,0,0,8,0,0
"Poland","2024-08-17",0,0,6,0,0,8,0,0
"Poland","2024-08-18",0,0,6,0,0,8,0,0
"Poland","2024-08-19",0,0,6,0,0,8,0,0
"Poland","2024-08-20",0,0,6,0,0,8,0,0
"Poland","2024-08-21",0,0,6,0,0,8,0,0
"Poland","2024-08-22",0,0,6,0,0,8,0,0
"Poland","2024-08-23",0,0,6,0,0,8,0,0
"Poland","2024-08-24",0,0,6,0,0,8,0,0
"Poland","2024-08-25",0,0,6,0,0,8,0,0
"Poland","2024-08-26",0,0,6,0,0,8,0,0
"Poland","2024-08-27",0,0,6,0,0,8,0,0
"Poland","2024-08-28",0,0,6,0,0,8,0,0
"Poland","2024-08-29",0,0,6,0,0,8,0,0
"Poland","2024-08-30",0,0,6,0,0,8,0,0
"Poland","2024-08-31",0,2,8,0,0,8,0,0
"Poland","2024-09-01",0,0,8,0,0,8,0,0
"Poland","2024-09-02",0,0,8,0,0,8,0,0
"Poland","2024-09-03",0,0,8,0,0,8,0,0
"Poland","2024-09-04",0,0,8,0,0,8,0,0
"Poland","2024-09-05",0,0,8,0,0,8,0,0
"Poland","2024-09-06",0,0,8,0,0,8,0,0
"Poland","2024-09-07",0,0,8,0,0,8,0,0
"Poland","2024-09-08",0,0,8,0,0,8,0,0
"Poland","2024-09-09",0,0,8,0,0,8,0,0
"Poland","2024-09-10",0,0,8,0,0,8,0,0
"Poland","2024-09-11",0,0,8,0,0,8,0,0
"Poland","2024-09-12",0,0,8,0,0,8,0,0
"Poland","2024-09-13",0,0,8,0,0,8,0,0
"Poland","2024-09-14",0,0,8,0,0,8,0,0
"Poland","2024-09-15",0,0,8,0,0,8,0,0
"Poland","2024-09-16",0,0,8,0,0,8,0,0
"Poland","2024-09-17",0,0,8,0,0,8,0,0
"Poland","2024-09-18",0,0,8,0,0,8,0,0
"Poland","2024-09-19",0,0,8,0,0,8,0,0
"Poland","2024-09-20",0,0,8,0,0,8,0,0
"Poland","2024-09-21",0,0,8,0,0,8,0,0
"Poland","2024-09-22",0,0,8,0,0,8,0,0
"Poland","2024-09-23",0,0,8,0,0,8,0,0
"Poland","2024-09-24",0,0,8,0,0,8,0,0
"Poland","2024-09-25",0,0,8,0,0,8,0,0
"Poland","2024-09-26",0,0,8,0,0,8,0,0
"Poland","2024-09-27",0,0,8,0,0,8,0,0
"Poland","2024-09-28",0,0,8,0,0,8,0,0
"Poland","2024-09-29",0,0,8,0,0,8,0,0
"Poland","2024-09-30",0,0,8,0,0,8,0,0
"Poland","2024-10-01",0,0,8,0,0,8,0,0
"Poland","2024-10-02",0,0,8,0,0,8,0,0
"Poland","2024-10-03",0,0,8,0,0,8,0,0
"Poland","2024-10-04",0,0,8,0,0,8,0,0
"Poland","2024-10-05",0,0,8,0,0,8,0,0
"Poland","2024-10-06",0,0,8,0,0,8,0,0
"Poland","2024-10-07",0,0,8,0,0,8,0,0
"Poland","2024-10-08",0,0,8,0,0,8,0,0
"Poland","2024-10-09",0,0,8,0,0,8,0,0
"Poland","2024-10-10",0,0,8,0,0,8,0,0
"Poland","2024-10-11",0,0,8,0,0,8,0,0
"Poland","2024-10-12",0,0,8,0,0,8,0,0
"Poland","2024-10-13",0,0,8,0,0,8,0,0
"Poland","2024-10-14",0,0,8,0,0,8,0,0
"Poland","2024-10-15",0,0,8,0,0,8,0,0
"Poland","2024-10-16",0,0,8,0,0,8,0,0
"Poland","2024-10-17",0,0,8,0,0,8,0,0
"Poland","2024-10-18",0,0,8,0,0,8,0,0
"Poland","2024-10-19",0,0,8,0,0,8,0,0
"Poland","2024-10-20",0,0,8,0,0,8,0,0
"Poland","2024-10-21",0,0,8,0,0,8,0,0
"Poland","2024-10-22",0,0,8,0,0,8,0,0
"Poland","2024-10-23",0,0,8,0,0,8,0,0
"Poland","2024-10-24",0,0,8,0,0,8,0,0
"Poland","2024-10-25",0,0,8,0,0,8,0,0
"Poland","2024-10-26",0,0,8,0,0,8,0,0
"Poland","2024-10-27",0,0,8,0,0,8,0,0
"Poland","2024-10-28",0,0,8,0,0,8,0,0
"Poland","2024-10-29",0,0,8,0,0,8,0,0
"Poland","2024-10-30",0,0,8,0,0,8,0,0
"Poland","2024-10-31",0,0,8,0,0,8,0,0
"Poland","2024-11-01",0,0,8,0,0,8,0,0
"Poland","2024-11-02",0,0,8,0,0,8,0,0
"Poland","2024-11-03",0,0,8,0,0,8,0,0
"Poland","2024-11-04",0,0,8,0,0,8,0,0
"Poland","2024-11-05",0,0,8,0,0,8,0,0
"Poland","2024-11-06",0,0,8,0,0,8,0,0
"Poland","2024-11-07",0,0,8,0,0,8,0,0
"Poland","2024-11-08",0,0,8,0,0,8,0,0
"Poland","2024-11-09",0,0,8,0,0,8,0,0
"Poland","2024-11-10",0,0,8,0,0,8,0,0
"Poland","2024-11-11",0,0,8,0,0,8,0,0
"Poland","2024-11-12",0,0,8,0,0,8,0,0
"Poland","2024-11-13",0,0,8,0,0,8,0,0
"Poland","2024-11-14",0,0,8,0,0,8,0,0
"Poland","2024-11-15",0,0,8,0,0,8,0,0
"Poland","2024-11-16",0,0,8,0,0,8,0,0
"Poland","2024-11-17",0,0,8,0,0,8,0,0
"Poland","2024-11-18",0,0,8,0,0,8,0,0
"Poland","2024-11-19",0,0,8,0,0,8,0,0
"Poland","2024-11-20",0,0,8,0,0,8,0,0
"Poland","2024-11-21",0,0,8,0,0,8,0,0
"Poland","2024-11-22",0,0,8,0,0,8,0,0
"Poland","2024-11-23",0,0,8,0,0,8,0,0
"Poland","2024-11-24",0,0,8,0,0,8,0,0
"Poland","2024-11-25",0,0,8,0,0,8,0,0
"Poland","2024-11-26",0,0,8,0,0,8,0,0
"Poland","2024-11-27",0,0,8,0,0,8,0,0
"Poland","2024-11-28",0,0,8,0,0,8,0,0
"Poland","2024-11-29",0,0,8,0,0,8,0,0
"Poland","2024-11-30",0,0,8,0,0,8,0,0
"Poland","2024-12-01",0,0,8,0,0,8,0,0
"Poland","2024-12-02",0,0,8,0,0,8,0,0
"Poland","2024-12-03",0,0,8,0,0,8,0,0
"Poland","2024-12-04",0,0,8,0,0,8,0,0
"Poland","2024-12-05",0,0,8,0,0,8,0,0
"Poland","2024-12-06",0,0,8,0,0,8,0,0
"Poland","2024-12-07",0,0,8,0,0,8,0,0
"Poland","2024-12-08",0,0,8,0,0,8,0,0
"Poland","2024-12-09",0,0,8,0,0,8,0,0
"Portugal","2024-01-01",0,0,0,0,0,0,0,0
"Portugal","2024-01-02",0,0,0,0,0,0,0,0
"Portugal","2024-01-03",0,0,0,0,0,0,0,0
"Portugal","2024-01-04",0,0,0,0,0,0,0,0
"Portugal","2024-01-05",0,0,0,0,0,0,0,0
"Portugal","2024-01-06",0,0,0,0,0,0,0,0
"Portugal","2024-01-07",0,0,0,0,0,0,0,0
"Portugal","2024-01-08",0,0,0,0,0,0,0,0
"Portugal","2024-01-09",0,0,0,0,0,0,0,0
"Portugal","2024-01-10",0,0,0,0,0,0,0,0
"Portugal","2024-01-11",0,0,0,0,0,0,0,0
"Portugal","2024-01-12",0,0,0,0,0,0,0,0
"Portugal","2024-01-13",0,0,0,0,0,0,0,0
"Portugal","2024-01-14",0,0,0,0,0,0,0,0
"Portugal","2024-01-15",0,0,0,0,0,0,0,0
"Portugal","2024-01-16",0,0,0,0,0,0,0,0
"Portugal","2024-01-17",0,0,0,0,0,0,0,0
"Portugal","2024-01-18",0,0,0,0,0,0,0,0
"Portugal","2024-01-19",0,0,0,0,0,0,0,0
"Portugal","2024-01-20",0,0,0,0,0,0,0,0
"Portugal","2024-01-21",0,0,0,0,0,0,0,0
"Portugal","2024-01-22",0,0,0,0,0,0,0,0
"Portugal","2024-01-23",0,0,0,0,0,0,0,0
"Portugal","2024-01-24",0,0,0,0,0,0,0,0
"Portugal","2024-01-25",0,0,0,0,0,0,0,0
"Portugal","2024-01-26",0,0,0,0,0,0,0,0
"Portugal","2024-01-27",0,0,0,0,0,0,0,0
"Portugal","2024-01-28",0,0,0,0,0,0,0,0
"Portugal","2024-01-29",0,0,0,0,0,0,0,0
"Portugal","2024-01-30",0,0,0,0,0,0,0,0
"Portugal","2024-01-31",0,24,24,0,24,24,0,0
"Portugal","2024-02-01",0,0,24,0,0,24,0,0
"Portugal","2024-02-02",0,0,24,0,0,24,0,0
"Portugal","2024-02-03",0,0,24,0,0,24,0,0
"Portugal","2024-02-04",0,0,24,0,1,25,0,0
"Portugal","2024-02-05",0,0,24,0,0,25,0,0
"Portugal","2024-02-06",0,0,24,0,0,25,0,0
"Portugal","2024-02-07",0,0,24,0,0,25,0,0
"Portugal","2024-02-08",0,0,24,0,0,25,0,0
"Portugal","2024-02-09",0,0,24,0,0,25,0,0
"Portugal","2024-02-10",0,0,24,0,0,25,0,0
"Portugal","2024-02-11",0,0,24,0,1,26,0,0
"Portugal","2024-02-12",0,0,24,0,0,26,0,0
"Portugal","2024-02-13",0,0,24,0,0,26,0,0
"Portugal","2024-02-14",0,0,24,0,0,26,0,0
"Portugal","2024-02-15",0,0,24,0,0,26,0,0
"Portugal","2024-02-16",0,0,24,0,0,26,0,0
"Portugal","2024-02-17",0,0,24,0,0,26,0,0
"Portugal","2024-02-18",0,0,24,0,0,26,0,0
"Portugal","2024-02-19",0,0,24,0,1,27,0,0
"Portugal","2024-02-20",0,0,24,0,0,27,0,0
"Portugal","2024-02-21",0,0,24,0,0,27,0,0
"Portugal","2024-02-22",0,0,24,0,0,27,0,0
"Portugal","2024-02-23",0,0,24,0,0,27,0,0
"Portugal","2024-02-24",0,0,24,0,0,27,0,0
"Portugal","2024-02-25",0,0,24,0,0,27,0,0
"Portugal","2024-02-26",0,0,24,0,1,28,0,0
"Portugal","2024-02-27",0,0,24,0,0,28,0,0
"Portugal","2024-02-28",0,0,24,0,0,28,0,0
"Portugal","2024-02-29",0,4,28,0,0,28,0,0
"Portugal","2024-03-01",0,0,28,0,0,28,0,0
"Portugal","2024-03-02",0,0,28,0,0,28,0,0
"Portugal","2024-03-03",0,0,28,0,0,28,0,0
"Portugal","2024-03-04",0,0,28,0,0,28,0,0
"Portugal","2024-03-05",0,0,28,0,0,28,0,0
"Portugal","2024-03-06",0,0,28,0,1,29,0,0
"Portugal","2024-03-07",0,0,28,0,0,29,0,0
"Portugal","2024-03-08",0,0,28,0,0,29,0,0
"Portugal","2024-03-09",0,0,28,0,0,29,0,0
"Portugal","2024-03-10",0,0,28,0,0,29,0,0
"Portugal","2024-03-11",0,0,28,0,0,29,0,0
"Portugal","2024-03-12",0,0,28,0,0,29,0,0
"Portugal","2024-03-13",0,0,28,0,0,29,0,0
"Portugal","2024-03-14",0,0,28,0,0,29,0,0
"Portugal","2024-03-15",0,0,28,0,0,29,0,0
"Portugal","2024-03-16",0,0,28,0,1,30,0,0
"Portugal","2024-03-17",0,0,28,0,0,30,0,0
"Portugal","2024-03-18",0,0,28,0,0,30,0,0
"Portugal","2024-03-19",0,0,28,0,0,30,0,0
"Portugal","2024-03-20",0,0,28,0,0,30,0,0
"Portugal","2024-03-21",0,0,28,0,0,30,0,0
"Portugal","2024-03-22",0,0,28,0,0,30,0,0
"Portugal","2024-03-23",0,0,28,0,0,30,0,0
"Portugal","2024-03-24",0,0,28,0,0,30,0,0
"Portugal","2024-03-25",0,0,28,0,0,30,0,0
"Portugal","2024-03-26",0,0,28,0,1,31,0,0
"Portugal","2024-03-27",0,0,28,0,0,31,0,0
"Portugal","2024-03-28",0,0,28,0,0,31,0,0
"Portugal","2024-03-29",0,0,28,0,0,31,0,0
"Portugal","2024-03-30",0,0,28,0,0,31,0,0
"Portugal","2024-03-31",0,3,31,0,0,31,0,0
"Portugal","2024-04-01",0,0,31,0,0,31,0,0
"Portugal","2024-04-02",0,0,31,0,0,31,0,0
"Portugal","2024-04-03",0,0,31,0,0,31,0,0
"Portugal","2024-04-04",0,0,31,0,0,31,0,0
"Portugal","2024-04-05",0,0,31,0,0,31,0,0
"Portugal","2024-04-06",0,0,31,0,0,31,0,0
"Portugal","2024-04-07",0,0,31,0,0,31,0,0
"Portugal","2024-04-08",0,0,31,0,0,31,0,0
"Portugal","2024-04-09",0,0,31,0,0,31,0,0
"Portugal","2024-04-10",0,0,31,0,0,31,0,0
"Portugal","2024-04-11",0,0,31,0,0,31,0,0
"Portugal","2024-04-12",0,0,31,0,0,31,0,0
"Portugal","2024-04-13",0,0,31,0,0,31,0,0
"Portugal","2024-04-14",0,0,31,0,0,31,0,0
"Portugal","2024-04-15",0,0,31,0,0,31,0,0
"Portugal","2024-04-16",0,0,31,0,0,31,0,0
"Portugal","2024-04-17",0,0,31,0,0,31,0,0
"Portugal","2024-04-18",0,0,31,0,0,31,0,0
"Portugal","2024-04-19",0,0,31,0,0,31,0,0
"Portugal","2024-04-20",0,0,31,0,0,31,0,0
"Portugal","2024-04-21",0,0,31,0,1,32,0,0
"Portugal","2024-04-22",0,0,31,0,0,32,0,0
"Portugal","2024-04-23",0,0,31,0,0,32,0,0
"Portugal","2024-04-24",0,0,31,0,0,32,0,0
"Portugal","2024-04-25",0,0,31,0,0,32,0,0
"Portugal","2024-04-26",0,0,31,0,0,32,0,0
"Portugal","2024-04-27",0,0,31,0,0,32,0,0
"Portugal","2024-04-28",0,0,31,0,0,32,0,0
"Portugal","2024-04-29",0,0,31,0,0,32,0,0
"Portugal","2024-04-30",0,0,31,0,0,32,0,0
"Portugal","2024-05-01",0,0,31,0,0,32,0,0
"Portugal","2024-05-02",0,0,31,0,0,32,0,0
"Portugal","2024-05-03",0,0,31,0,0,32,0,0
"Portugal","2024-05-04",0,0,31,0,0,32,0,0
"Portugal","2024-05-05",0,0,31,0,0,32,0,0
"Portugal","2024-05-06",0,0,31,0,0,32,0,0
"Portugal","2024-05-07",0,0,31,0,0,32,0,0
"Portugal","2024-05-08",0,0,31,0,0,32,0,0
"Portugal","2024-05-09",0,0,31,0,0,32,0,0
"Portugal","2024-05-10",0,0,31,0,0,32,0,0
"Portugal","2024-05-11",0,0,31,0,0,32,0,0
"Portugal","2024-05-12",0,0,31,0,0,32,0,0
"Portugal","2024-05-13",0,0,31,0,0,32,0,0
"Portugal","2024-05-14",0,0,31,0,0,32,0,0
"Portugal","2024-05-15",0,0,31,0,0,32,0,0
"Portugal","2024-05-16",0,0,31,0,0,32,0,0
"Portugal","2024-05-17",0,0,31,0,0,32,0,0
"Portugal","2024-05-18",0,0,31,0,0,32,0,0
"Portugal","2024-05-19",0,0,31,0,0,32,0,0
"Portugal","2024-05-20",0,0,31,0,0,32,0,0
"Portugal","2024-05-21",0,0,31,0,0,32,0,0
"Portugal","2024-05-22",0,0,31,0,0,32,0,0
"Portugal","2024-05-23",0,0,31,0,0,32,0,0
"Portugal","2024-05-24",0,0,31,0,0,32,0,0
"Portugal","2024-05-25",0,0,31,0,0,32,0,0
"Portugal","2024-05-26",0,0,31,0,0,32,0,0
"Portugal","2024-05-27",0,0,31,0,0,32,0,0
"Portugal","2024-05-28",0,0,31,0,0,32,0,0
"Portugal","2024-05-29",0,0,31,0,0,32,0,0
"Portugal","2024-05-30",0,0,31,0,0,32,0,0
"Portugal","2024-05-31",0,0,31,0,1,33,0,0
"Portugal","2024-06-01",0,0,31,0,0,33,0,0
"Portugal","2024-06-02",0,0,31,0,0,33,0,0
"Portugal","2024-06-03",0,0,31,0,0,33,0,0
"Portugal","2024-06-04",0,0,31,0,0,33,0,0
"Portugal","2024-06-05",0,0,31,0,0,33,0,0
"Portugal","2024-06-06",0,0,31,0,0,33,0,0
"Portugal","2024-06-07",0,0,31,0,0,33,0,0
"Portugal","2024-06-08",0,0,31,0,0,33,0,0
"Portugal","2024-06-09",0,0,31,0,0,33,0,0
"Portugal","2024-06-10",0,0,31,0,0,33,0,0
"Portugal","2024-06-11",0,0,31,0,0,33,0,0
"Portugal","2024-06-12",0,0,31,0,0,33,0,0
"Portugal","2024-06-13",0,0,31,0,0,33,0,0
"Portugal","2024-06-14",0,0,31,0,0,33,0,0
"Portugal","2024-06-15",0,0,31,0,0,33,0,0
"Portugal","2024-06-16",0,0,31,0,0,33,0,0
"Portugal","2024-06-17",0,0,31,0,0,33,0,0
"Portugal","2024-06-18",0,0,31,0,0,33,0,0
"Portugal","2024-06-19",0,0,31,0,0,33,0,0
"Portugal","2024-06-20",0,0,31,0,0,33,0,0
"Portugal","2024-06-21",0,0,31,0,0,33,0,0
"Portugal","2024-06-22",0,0,31,0,0,33,0,0
"Portugal","2024-06-23",0,0,31,0,0,33,0,0
"Portugal","2024-06-24",0,0,31,0,0,33,0,0
"Portugal","2024-06-25",0,0,31,0,0,33,0,0
"Portugal","2024-06-26",0,0,31,0,0,33,0,0
"Portugal","2024-06-27",0,0,31,0,0,33,0,0
"Portugal","2024-06-28",0,0,31,0,0,33,0,0
"Portugal","2024-06-29",0,0,31,0,0,33,0,0
"Portugal","2024-06-30",0,0,31,0,0,33,0,0
"Portugal","2024-07-01",0,0,31,0,0,33,0,0
"Portugal","2024-07-02",0,0,31,0,0,33,0,0
"Portugal","2024-07-03",0,0,31,0,0,33,0,0
"Portugal","2024-07-04",0,0,31,0,0,33,0,0
"Portugal","2024-07-05",0,0,31,0,0,33,0,0
"Portugal","2024-07-06",0,0,31,0,0,33,0,0
"Portugal","2024-07-07",0,0,31,0,0,33,0,0
"Portugal","2024-07-08",0,0,31,0,0,33,0,0
"Portugal","2024-07-09",0,0,31,0,0,33,0,0
"Portugal","2024-07-10",0,0,31,0,0,33,0,0
"Portugal","2024-07-11",0,0,31,0,1,34,0,0
"Portugal","2024-07-12",0,0,31,0,0,34,0,0
"Portugal","2024-07-13",0,0,31,0,0,34,0,0
"Portugal","2024-07-14",0,0,31,0,0,34,0,0
"Portugal","2024-07-15",0,0,31,0,0,34,0,0
"Portugal","2024-07-16",0,0,31,0,0,34,0,0
"Portugal","2024-07-17",0,0,31,0,0,34,0,0
"Portugal","2024-07-18",0,0,31,0,0,34,0,0
"Portugal","2024-07-19",0,0,31,0,0,34,0,0
"Portugal","2024-07-20",0,0,31,0,0,34,0,0
"Portugal","2024-07-21",0,0,31,0,0,34,0,0
"Portugal","2024-07-22",0,0,31,0,0,34,0,0
"Portugal","2024-07-23",0,0,31,0,0,34,0,0
"Portugal","2024-07-24",0,0,31,0,0,34,0,0
"Portugal","2024-07-25",0,0,31,0,0,34,0,0
"Portugal","2024-07-26",0,0,31,0,0,34,0,0
"Portugal","2024-07-27",0,0,31,0,0,34,0,0
"Portugal","2024-07-28",0,0,31,0,0,34,0,0
"Portugal","2024-07-29",0,0,31,0,0,34,0,0
"Portugal","2024-07-30",0,0,31,0,0,34,0,0
"Portugal","2024-07-31",0,3,34,0,0,34,0,0
"Portugal","2024-08-01",0,0,34,0,0,34,0,0
"Portugal","2024-08-02",0,0,34,0,1,35,0,0
"Portugal","2024-08-03",0,0,34,0,0,35,0,0
"Portugal","2024-08-04",0,0,34,0,0,35,0,0
"Portugal","2024-08-05",0,0,34,0,1,36,0,0
"Portugal","2024-08-06",0,0,34,0,0,36,0,0
"Portugal","2024-08-07",0,0,34,0,0,36,0,0
"Portugal","2024-08-08",0,0,34,0,1,37,0,0
"Portugal","2024-08-09",0,0,34,0,0,37,0,0
"Portugal","2024-08-10",0,0,34,0,0,37,0,0
"Portugal","2024-08-11",0,0,34,0,1,38,0,0
"Portugal","2024-08-12",0,0,34,0,0,38,0,0
"Portugal","2024-08-13",0,0,34,0,0,38,0,0
"Portugal","2024-08-14",0,0,34,0,1,39,0,0
"Portugal","2024-08-15",0,0,34,0,0,39,0,0
"Portugal","2024-08-16",0,0,34,0,0,39,0,0
"Portugal","2024-08-17",0,0,34,0,0,39,0,0
"Portugal","2024-08-18",0,0,34,0,1,40,0,0
"Portugal","2024-08-19",0,0,34,0,0,40,0,0
"Portugal","2024-08-20",0,0,34,0,0,40,0,0
"Portugal","2024-08-21",0,0,34,0,1,41,0,0
"Portugal","2024-08-22",0,0,34,0,0,41,0,0
"Portugal","2024-08-23",0,0,34,0,0,41,0,0
"Portugal","2024-08-24",0,0,34,0,1,42,0,0
"Portugal","2024-08-25",0,0,34,0,0,42,0,0
"Portugal","2024-08-26",0,0,34,0,0,42,0,0
"Portugal","2024-08-27",0,0,34,0,1,43,0,0
"Portugal","2024-08-28",0,0,34,0,0,43,0,0
"Portugal","2024-08-29",0,0,34,0,0,43,0,0
"Portugal","2024-08-30",0,0,34,0,1,44,0,0
"Portugal","2024-08-31",0,10,44,0,0,44,0,0
"Portugal","2024-09-01",0,0,44,0,1,45,0,0
"Portugal","2024-09-02",0,0,44,0,0,45,0,0
"Portugal","2024-09-03",0,0,44,0,1,46,0,0
"Portugal","2024-09-04",0,0,44,0,1,47,0,0
"Portugal","2024-09-05",0,0,44,0,1,48,0,0
"Portugal","2024-09-06",0,0,44,0,0,48,0,0
"Portugal","2024-09-07",0,0,44,0,1,49,0,0
"Portugal","2024-09-08",0,0,44,0,1,50,0,0
"Portugal","2024-09-09",0,0,44,0,0,50,0,0
"Portugal","2024-09-10",0,0,44,0,1,51,0,0
"Portugal","2024-09-11",0,0,44,0,1,52,0,0
"Portugal","2024-09-12",0,0,44,0,0,52,0,0
"Portugal","2024-09-13",0,0,44,0,1,53,0,0
"Portugal","2024-09-14",0,0,44,0,1,54,0,0
"Portugal","2024-09-15",0,0,44,0,0,54,0,0
"Portugal","2024-09-16",0,0,44,0,1,55,0,0
"Portugal","2024-09-17",0,0,44,0,1,56,0,0
"Portugal","2024-09-18",0,0,44,0,1,57,0,0
"Portugal","2024-09-19",0,0,44,0,0,57,0,0
"Portugal","2024-09-20",0,0,44,0,1,58,0,0
"Portugal","2024-09-21",0,0,44,0,1,59,0,0
"Portugal","2024-09-22",0,0,44,0,0,59,0,0
"Portugal","2024-09-23",0,0,44,0,1,60,0,0
"Portugal","2024-09-24",0,0,44,0,1,61,0,0
"Portugal","2024-09-25",0,0,44,0,1,62,0,0
"Portugal","2024-09-26",0,0,44,0,0,62,0,0
"Portugal","2024-09-27",0,0,44,0,1,63,0,0
"Portugal","2024-09-28",0,0,44,0,1,64,0,0
"Portugal","2024-09-29",0,0,44,0,0,64,0,0
"Portugal","2024-09-30",0,21,65,0,1,65,0,0
"Portugal","2024-10-01",0,0,65,0,0,65,0,0
"Portugal","2024-10-02",0,0,65,0,0,65,0,0
"Portugal","2024-10-03",0,0,65,0,0,65,0,0
"Portugal","2024-10-04",0,0,65,0,0,65,0,0
"Portugal","2024-10-05",0,0,65,0,0,65,0,0
"Portugal","2024-10-06",0,0,65,0,0,65,0,0
"Portugal","2024-10-07",0,0,65,0,0,65,0,0
"Portugal","2024-10-08",0,0,65,0,0,65,0,0
"Portugal","2024-10-09",0,0,65,0,0,65,0,0
"Portugal","2024-10-10",0,0,65,0,0,65,0,0
"Portugal","2024-10-11",0,0,65,0,0,65,0,0
"Portugal","2024-10-12",0,0,65,0,0,65,0,0
"Portugal","2024-10-13",0,0,65,0,0,65,0,0
"Portugal","2024-10-14",0,0,65,0,0,65,0,0
"Portugal","2024-10-15",0,0,65,0,0,65,0,0
"Portugal","2024-10-16",0,0,65,0,0,65,0,0
"Portugal","2024-10-17",0,0,65,0,0,65,0,0
"Portugal","2024-10-18",0,0,65,0,0,65,0,0
"Portugal","2024-10-19",0,0,65,0,0,65,0,0
"Portugal","2024-10-20",0,0,65,0,0,65,0,0
"Portugal","2024-10-21",0,0,65,0,0,65,0,0
"Portugal","2024-10-22",0,0,65,0,0,65,0,0
"Portugal","2024-10-23",0,0,65,0,0,65,0,0
"Portugal","2024-10-24",0,0,65,0,0,65,0,0
"Portugal","2024-10-25",0,0,65,0,0,65,0,0
"Portugal","2024-10-26",0,0,65,0,0,65,0,0
"Portugal","2024-10-27",0,0,65,0,0,65,0,0
"Portugal","2024-10-28",0,0,65,0,0,65,0,0
"Portugal","2024-10-29",0,0,65,0,0,65,0,0
"Portugal","2024-10-30",0,0,65,0,0,65,0,0
"Portugal","2024-10-31",0,0,65,0,0,65,0,0
"Portugal","2024-11-01",0,0,65,0,0,65,0,0
"Portugal","2024-11-02",0,0,65,0,0,65,0,0
"Portugal","2024-11-03",0,0,65,0,0,65,0,0
"Portugal","2024-11-04",0,0,65,0,0,65,0,0
"Portugal","2024-11-05",0,0,65,0,0,65,0,0
"Portugal","2024-11-06",0,0,65,0,0,65,0,0
"Portugal","2024-11-07",0,0,65,0,0,65,0,0
"Portugal","2024-11-08",0,0,65,0,0,65,0,0
"Portugal","2024-11-09",0,0,65,0,0,65,0,0
"Portugal","2024-11-10",0,0,65,0,0,65,0,0
"Portugal","2024-11-11",0,0,65,0,0,65,0,0
"Portugal","2024-11-12",0,0,65,0,0,65,0,0
"Portugal","2024-11-13",0,0,65,0,0,65,0,0
"Portugal","2024-11-14",0,0,65,0,0,65,0,0
"Portugal","2024-11-15",0,0,65,0,0,65,0,0
"Portugal","2024-11-16",0,0,65,0,0,65,0,0
"Portugal","2024-11-17",0,0,65,0,0,65,0,0
"Portugal","2024-11-18",0,0,65,0,0,65,0,0
"Portugal","2024-11-19",0,0,65,0,0,65,0,0
"Portugal","2024-11-20",0,0,65,0,0,65,0,0
"Portugal","2024-11-21",0,0,65,0,0,65,0,0
"Portugal","2024-11-22",0,0,65,0,0,65,0,0
"Portugal","2024-11-23",0,0,65,0,0,65,0,0
"Portugal","2024-11-24",0,0,65,0,0,65,0,0
"Portugal","2024-11-25",0,0,65,0,0,65,0,0
"Portugal","2024-11-26",0,0,65,0,0,65,0,0
"Portugal","2024-11-27",0,0,65,0,0,65,0,0
"Portugal","2024-11-28",0,0,65,0,0,65,0,0
"Portugal","2024-11-29",0,0,65,0,0,65,0,0
"Portugal","2024-11-30",0,0,65,0,0,65,0,0
"Portugal","2024-12-01",0,0,65,0,0,65,0,0
"Portugal","2024-12-02",0,0,65,0,0,65,0,0
"Portugal","2024-12-03",0,0,65,0,0,65,0,0
"Portugal","2024-12-04",0,0,65,0,0,65,0,0
"Portugal","2024-12-05",0,0,65,0,0,65,0,0
"Portugal","2024-12-06",0,0,65,0,0,65,0,0
"Portugal","2024-12-07",0,0,65,0,0,65,0,0
"Portugal","2024-12-08",0,0,65,0,0,65,0,0
"Portugal","2024-12-09",0,0,65,0,0,65,0,0
"Romania","2024-01-01",0,0,0,0,0,0,0,0
"Romania","2024-01-02",0,0,0,0,0,0,0,0
"Romania","2024-01-03",0,0,0,0,0,0,0,0
"Romania","2024-01-04",0,0,0,0,0,0,0,0
"Romania","2024-01-05",0,0,0,0,0,0,0,0
"Romania","2024-01-06",0,0,0,0,0,0,0,0
"Romania","2024-01-07",0,0,0,0,0,0,0,0
"Romania","2024-01-08",0,0,0,0,0,0,0,0
"Romania","2024-01-09",0,0,0,0,0,0,0,0
"Romania","2024-01-10",0,0,0,0,0,0,0,0
"Romania","2024-01-11",0,0,0,0,0,0,0,0
"Romania","2024-01-12",0,0,0,0,0,0,0,0
"Romania","2024-01-13",0,0,0,0,0,0,0,0
"Romania","2024-01-14",0,0,0,0,0,0,0,0
"Romania","2024-01-15",0,0,0,0,0,0,0,0
"Romania","2024-01-16",0,0,0,0,0,0,0,0
"Romania","2024-01-17",0,0,0,0,0,0,0,0
"Romania","2024-01-18",0,0,0,0,0,0,0,0
"Romania","2024-01-19",0,0,0,0,0,0,0,0
"Romania","2024-01-20",0,0,0,0,0,0,0,0
"Romania","2024-01-21",0,0,0,0,0,0,0,0
"Romania","2024-01-22",0,0,0,0,0,0,0,0
"Romania","2024-01-23",0,0,0,0,0,0,0,0
"Romania","2024-01-24",0,0,0,0,0,0,0,0
"Romania","2024-01-25",0,0,0,0,0,0,0,0
"Romania","2024-01-26",0,0,0,0,0,0,0,0
"Romania","2024-01-27",0,0,0,0,0,0,0,0
"Romania","2024-01-28",0,0,0,0,0,0,0,0
"Romania","2024-01-29",0,0,0,0,0,0,0,0
"Romania","2024-01-30",0,0,0,0,0,0,0,0
"Romania","2024-01-31",0,0,0,0,0,0,0,0
"Romania","2024-02-01",0,0,0,0,0,0,0,0
"Romania","2024-02-02",0,0,0,0,0,0,0,0
"Romania","2024-02-03",0,0,0,0,0,0,0,0
"Romania","2024-02-04",0,0,0,0,0,0,0,0
"Romania","2024-02-05",0,0,0,0,0,0,0,0
"Romania","2024-02-06",0,0,0,0,0,0,0,0
"Romania","2024-02-07",0,0,0,0,0,0,0,0
"Romania","2024-02-08",0,0,0,0,0,0,0,0
"Romania","2024-02-09",0,0,0,0,0,0,0,0
"Romania","2024-02-10",0,0,0,0,0,0,0,0
"Romania","2024-02-11",0,0,0,0,0,0,0,0
"Romania","2024-02-12",0,0,0,0,0,0,0,0
"Romania","2024-02-13",0,0,0,0,0,0,0,0
"Romania","2024-02-14",0,0,0,0,0,0,0,0
"Romania","2024-02-15",0,0,0,0,0,0,0,0
"Romania","2024-02-16",0,0,0,0,0,0,0,0
"Romania","2024-02-17",0,0,0,0,0,0,0,0
"Romania","2024-02-18",0,0,0,0,0,0,0,0
"Romania","2024-02-19",0,0,0,0,0,0,0,0
"Romania","2024-02-20",0,0,0,0,0,0,0,0
"Romania","2024-02-21",0,0,0,0,0,0,0,0
"Romania","2024-02-22",0,0,0,0,0,0,0,0
"Romania","2024-02-23",0,0,0,0,0,0,0,0
"Romania","2024-02-24",0,0,0,0,0,0,0,0
"Romania","2024-02-25",0,0,0,0,0,0,0,0
"Romania","2024-02-26",0,0,0,0,0,0,0,0
"Romania","2024-02-27",0,0,0,0,0,0,0,0
"Romania","2024-02-28",0,0,0,0,0,0,0,0
"Romania","2024-02-29",0,0,0,0,0,0,0,0
"Romania","2024-03-01",0,0,0,0,0,0,0,0
"Romania","2024-03-02",0,0,0,0,0,0,0,0
"Romania","2024-03-03",0,0,0,0,0,0,0,0
"Romania","2024-03-04",0,0,0,0,0,0,0,0
"Romania","2024-03-05",0,0,0,0,0,0,0,0
"Romania","2024-03-06",0,0,0,0,0,0,0,0
"Romania","2024-03-07",0,0,0,0,0,0,0,0
"Romania","2024-03-08",0,0,0,0,0,0,0,0
"Romania","2024-03-09",0,0,0,0,0,0,0,0
"Romania","2024-03-10",0,0,0,0,0,0,0,0
"Romania","2024-03-11",0,0,0,0,0,0,0,0
"Romania","2024-03-12",0,0,0,0,0,0,0,0
"Romania","2024-03-13",0,0,0,0,0,0,0,0
"Romania","2024-03-14",0,0,0,0,0,0,0,0
"Romania","2024-03-15",0,0,0,0,0,0,0,0
"Romania","2024-03-16",0,0,0,0,0,0,0,0
"Romania","2024-03-17",0,0,0,0,0,0,0,0
"Romania","2024-03-18",0,0,0,0,0,0,0,0
"Romania","2024-03-19",0,0,0,0,0,0,0,0
"Romania","2024-03-20",0,0,0,0,0,0,0,0
"Romania","2024-03-21",0,0,0,0,0,0,0,0
"Romania","2024-03-22",0,0,0,0,0,0,0,0
"Romania","2024-03-23",0,0,0,0,0,0,0,0
"Romania","2024-03-24",0,0,0,0,0,0,0,0
"Romania","2024-03-25",0,0,0,0,0,0,0,0
"Romania","2024-03-26",0,0,0,0,0,0,0,0
"Romania","2024-03-27",0,0,0,0,0,0,0,0
"Romania","2024-03-28",0,0,0,0,0,0,0,0
"Romania","2024-03-29",0,0,0,0,0,0,0,0
"Romania","2024-03-30",0,0,0,0,0,0,0,0
"Romania","2024-03-31",0,0,0,0,0,0,0,0
"Romania","2024-04-01",0,0,0,0,0,0,0,0
"Romania","2024-04-02",0,0,0,0,0,0,0,0
"Romania","2024-04-03",0,0,0,0,0,0,0,0
"Romania","2024-04-04",0,0,0,0,0,0,0,0
"Romania","2024-04-05",0,0,0,0,0,0,0,0
"Romania","2024-04-06",0,0,0,0,0,0,0,0
"Romania","2024-04-07",0,0,0,0,0,0,0,0
"Romania","2024-04-08",0,0,0,0,0,0,0,0
"Romania","2024-04-09",0,0,0,0,0,0,0,0
"Romania","2024-04-10",0,0,0,0,0,0,0,0
"Romania","2024-04-11",0,0,0,0,0,0,0,0
"Romania","2024-04-12",0,0,0,0,0,0,0,0
"Romania","2024-04-13",0,0,0,0,0,0,0,0
"Romania","2024-04-14",0,0,0,0,0,0,0,0
"Romania","2024-04-15",0,0,0,0,0,0,0,0
"Romania","2024-04-16",0,0,0,0,0,0,0,0
"Romania","2024-04-17",0,0,0,0,0,0,0,0
"Romania","2024-04-18",0,0,0,0,0,0,0,0
"Romania","2024-04-19",0,0,0,0,0,0,0,0
"Romania","2024-04-20",0,0,0,0,0,0,0,0
"Romania","2024-04-21",0,0,0,0,0,0,0,0
"Romania","2024-04-22",0,0,0,0,0,0,0,0
"Romania","2024-04-23",0,0,0,0,0,0,0,0
"Romania","2024-04-24",0,0,0,0,0,0,0,0
"Romania","2024-04-25",0,0,0,0,0,0,0,0
"Romania","2024-04-26",0,0,0,0,0,0,0,0
"Romania","2024-04-27",0,0,0,0,0,0,0,0
"Romania","2024-04-28",0,0,0,0,0,0,0,0
"Romania","2024-04-29",0,0,0,0,0,0,0,0
"Romania","2024-04-30",0,0,0,0,0,0,0,0
"Romania","2024-05-01",0,0,0,0,0,0,0,0
"Romania","2024-05-02",0,0,0,0,0,0,0,0
"Romania","2024-05-03",0,0,0,0,0,0,0,0
"Romania","2024-05-04",0,0,0,0,0,0,0,0
"Romania","2024-05-05",0,0,0,0,0,0,0,0
"Romania","2024-05-06",0,0,0,0,0,0,0,0
"Romania","2024-05-07",0,0,0,0,0,0,0,0
"Romania","2024-05-08",0,0,0,0,0,0,0,0
"Romania","2024-05-09",0,0,0,0,0,0,0,0
"Romania","2024-05-10",0,0,0,0,0,0,0,0
"Romania","2024-05-11",0,0,0,0,0,0,0,0
"Romania","2024-05-12",0,0,0,0,0,0,0,0
"Romania","2024-05-13",0,0,0,0,0,0,0,0
"Romania","2024-05-14",0,0,0,0,0,0,0,0
"Romania","2024-05-15",0,0,0,0,0,0,0,0
"Romania","2024-05-16",0,0,0,0,0,0,0,0
"Romania","2024-05-17",0,0,0,0,0,0,0,0
"Romania","2024-05-18",0,0,0,0,0,0,0,0
"Romania","2024-05-19",0,0,0,0,0,0,0,0
"Romania","2024-05-20",0,0,0,0,0,0,0,0
"Romania","2024-05-21",0,0,0,0,0,0,0,0
"Romania","2024-05-22",0,0,0,0,0,0,0,0
"Romania","2024-05-23",0,0,0,0,0,0,0,0
"Romania","2024-05-24",0,0,0,0,0,0,0,0
"Romania","2024-05-25",0,0,0,0,0,0,0,0
"Romania","2024-05-26",0,0,0,0,0,0,0,0
"Romania","2024-05-27",0,0,0,0,0,0,0,0
"Romania","2024-05-28",0,0,0,0,0,0,0,0
"Romania","2024-05-29",0,0,0,0,0,0,0,0
"Romania","2024-05-30",0,0,0,0,0,0,0,0
"Romania","2024-05-31",0,0,0,0,0,0,0,0
"Romania","2024-06-01",0,0,0,0,0,0,0,0
"Romania","2024-06-02",0,0,0,0,0,0,0,0
"Romania","2024-06-03",0,0,0,0,0,0,0,0
"Romania","2024-06-04",0,0,0,0,0,0,0,0
"Romania","2024-06-05",0,0,0,0,0,0,0,0
"Romania","2024-06-06",0,0,0,0,0,0,0,0
"Romania","2024-06-07",0,0,0,0,0,0,0,0
"Romania","2024-06-08",0,0,0,0,0,0,0,0
"Romania","2024-06-09",0,0,0,0,0,0,0,0
"Romania","2024-06-10",0,0,0,0,0,0,0,0
"Romania","2024-06-11",0,0,0,0,0,0,0,0
"Romania","2024-06-12",0,0,0,0,0,0,0,0
"Romania","2024-06-13",0,0,0,0,0,0,0,0
"Romania","2024-06-14",0,0,0,0,0,0,0,0
"Romania","2024-06-15",0,0,0,0,0,0,0,0
"Romania","2024-06-16",0,0,0,0,0,0,0,0
"Romania","2024-06-17",0,0,0,0,0,0,0,0
"Romania","2024-06-18",0,0,0,0,0,0,0,0
"Romania","2024-06-19",0,0,0,0,0,0,0,0
"Romania","2024-06-20",0,0,0,0,0,0,0,0
"Romania","2024-06-21",0,0,0,0,0,0,0,0
"Romania","2024-06-22",0,0,0,0,0,0,0,0
"Romania","2024-06-23",0,0,0,0,0,0,0,0
"Romania","2024-06-24",0,0,0,0,0,0,0,0
"Romania","2024-06-25",0,0,0,0,0,0,0,0
"Romania","2024-06-26",0,0,0,0,0,0,0,0
"Romania","2024-06-27",0,0,0,0,0,0,0,0
"Romania","2024-06-28",0,0,0,0,0,0,0,0
"Romania","2024-06-29",0,0,0,0,0,0,0,0
"Romania","2024-06-30",0,0,0,0,0,0,0,0
"Romania","2024-07-01",0,0,0,0,0,0,0,0
"Romania","2024-07-02",0,0,0,0,0,0,0,0
"Romania","2024-07-03",0,0,0,0,0,0,0,0
"Romania","2024-07-04",0,0,0,0,0,0,0,0
"Romania","2024-07-05",0,0,0,0,0,0,0,0
"Romania","2024-07-06",0,0,0,0,0,0,0,0
"Romania","2024-07-07",0,0,0,0,0,0,0,0
"Romania","2024-07-08",0,0,0,0,0,0,0,0
"Romania","2024-07-09",0,0,0,0,0,0,0,0
"Romania","2024-07-10",0,0,0,0,0,0,0,0
"Romania","2024-07-11",0,0,0,0,0,0,0,0
"Romania","2024-07-12",0,0,0,0,0,0,0,0
"Romania","2024-07-13",0,0,0,0,0,0,0,0
"Romania","2024-07-14",0,0,0,0,0,0,0,0
"Romania","2024-07-15",0,0,0,0,0,0,0,0
"Romania","2024-07-16",0,0,0,0,0,0,0,0
"Romania","2024-07-17",0,0,0,0,0,0,0,0
"Romania","2024-07-18",0,0,0,0,0,0,0,0
"Romania","2024-07-19",0,0,0,0,0,0,0,0
"Romania","2024-07-20",0,0,0,0,0,0,0,0
"Romania","2024-07-21",0,0,0,0,0,0,0,0
"Romania","2024-07-22",0,0,0,0,0,0,0,0
"Romania","2024-07-23",0,0,0,0,0,0,0,0
"Romania","2024-07-24",0,0,0,0,0,0,0,0
"Romania","2024-07-25",0,0,0,0,0,0,0,0
"Romania","2024-07-26",0,0,0,0,0,0,0,0
"Romania","2024-07-27",0,0,0,0,0,0,0,0
"Romania","2024-07-28",0,0,0,0,0,0,0,0
"Romania","2024-07-29",0,0,0,0,0,0,0,0
"Romania","2024-07-30",0,0,0,0,0,0,0,0
"Romania","2024-07-31",0,0,0,0,0,0,0,0
"Romania","2024-08-01",0,0,0,0,0,0,0,0
"Romania","2024-08-02",0,0,0,0,0,0,0,0
"Romania","2024-08-03",0,0,0,0,0,0,0,0
"Romania","2024-08-04",0,0,0,0,0,0,0,0
"Romania","2024-08-05",0,0,0,0,0,0,0,0
"Romania","2024-08-06",0,0,0,0,0,0,0,0
"Romania","2024-08-07",0,0,0,0,0,0,0,0
"Romania","2024-08-08",0,0,0,0,0,0,0,0
"Romania","2024-08-09",0,0,0,0,0,0,0,0
"Romania","2024-08-10",0,0,0,0,0,0,0,0
"Romania","2024-08-11",0,0,0,0,0,0,0,0
"Romania","2024-08-12",0,0,0,0,0,0,0,0
"Romania","2024-08-13",0,0,0,0,0,0,0,0
"Romania","2024-08-14",0,0,0,0,0,0,0,0
"Romania","2024-08-15",0,0,0,0,0,0,0,0
"Romania","2024-08-16",0,0,0,0,0,0,0,0
"Romania","2024-08-17",0,0,0,0,0,0,0,0
"Romania","2024-08-18",0,0,0,0,0,0,0,0
"Romania","2024-08-19",0,0,0,0,0,0,0,0
"Romania","2024-08-20",0,0,0,0,0,0,0,0
"Romania","2024-08-21",0,0,0,0,0,0,0,0
"Romania","2024-08-22",0,0,0,0,0,0,0,0
"Romania","2024-08-23",0,0,0,0,0,0,0,0
"Romania","2024-08-24",0,0,0,0,0,0,0,0
"Romania","2024-08-25",0,0,0,0,0,0,0,0
"Romania","2024-08-26",0,0,0,0,0,0,0,0
"Romania","2024-08-27",0,0,0,0,0,0,0,0
"Romania","2024-08-28",0,0,0,0,0,0,0,0
"Romania","2024-08-29",0,0,0,0,0,0,0,0
"Romania","2024-08-30",0,0,0,0,0,0,0,0
"Romania","2024-08-31",0,1,1,0,1,1,0,0
"Romania","2024-09-01",0,0,1,0,0,1,0,0
"Romania","2024-09-02",0,0,1,0,0,1,0,0
"Romania","2024-09-03",0,0,1,0,0,1,0,0
"Romania","2024-09-04",0,0,1,0,0,1,0,0
"Romania","2024-09-05",0,0,1,0,0,1,0,0
"Romania","2024-09-06",0,0,1,0,0,1,0,0
"Romania","2024-09-07",0,0,1,0,0,1,0,0
"Romania","2024-09-08",0,0,1,0,0,1,0,0
"Romania","2024-09-09",0,0,1,0,0,1,0,0
"Romania","2024-09-10",0,0,1,0,0,1,0,0
"Romania","2024-09-11",0,0,1,0,0,1,0,0
"Romania","2024-09-12",0,0,1,0,0,1,0,0
"Romania","2024-09-13",0,0,1,0,0,1,0,0
"Romania","2024-09-14",0,0,1,0,0,1,0,0
"Romania","2024-09-15",0,0,1,0,0,1,0,0
"Romania","2024-09-16",0,0,1,0,0,1,0,0
"Romania","2024-09-17",0,0,1,0,0,1,0,0
"Romania","2024-09-18",0,0,1,0,0,1,0,0
"Romania","2024-09-19",0,0,1,0,0,1,0,0
"Romania","2024-09-20",0,0,1,0,0,1,0,0
"Romania","2024-09-21",0,0,1,0,0,1,0,0
"Romania","2024-09-22",0,0,1,0,0,1,0,0
"Romania","2024-09-23",0,0,1,0,0,1,0,0
"Romania","2024-09-24",0,0,1,0,0,1,0,0
"Romania","2024-09-25",0,0,1,0,0,1,0,0
"Romania","2024-09-26",0,0,1,0,0,1,0,0
"Romania","2024-09-27",0,0,1,0,0,1,0,0
"Romania","2024-09-28",0,0,1,0,0,1,0,0
"Romania","2024-09-29",0,0,1,0,0,1,0,0
"Romania","2024-09-30",0,0,1,0,0,1,0,0
"Romania","2024-10-01",0,0,1,0,0,1,0,0
"Romania","2024-10-02",0,0,1,0,0,1,0,0
"Romania","2024-10-03",0,0,1,0,0,1,0,0
"Romania","2024-10-04",0,0,1,0,0,1,0,0
"Romania","2024-10-05",0,0,1,0,0,1,0,0
"Romania","2024-10-06",0,0,1,0,0,1,0,0
"Romania","2024-10-07",0,0,1,0,0,1,0,0
"Romania","2024-10-08",0,0,1,0,0,1,0,0
"Romania","2024-10-09",0,0,1,0,0,1,0,0
"Romania","2024-10-10",0,0,1,0,0,1,0,0
"Romania","2024-10-11",0,0,1,0,0,1,0,0
"Romania","2024-10-12",0,0,1,0,0,1,0,0
"Romania","2024-10-13",0,0,1,0,0,1,0,0
"Romania","2024-10-14",0,0,1,0,0,1,0,0
"Romania","2024-10-15",0,0,1,0,0,1,0,0
"Romania","2024-10-16",0,0,1,0,0,1,0,0
"Romania","2024-10-17",0,0,1,0,0,1,0,0
"Romania","2024-10-18",0,0,1,0,0,1,0,0
"Romania","2024-10-19",0,0,1,0,0,1,0,0
"Romania","2024-10-20",0,0,1,0,0,1,0,0
"Romania","2024-10-21",0,0,1,0,0,1,0,0
"Romania","2024-10-22",0,0,1,0,0,1,0,0
"Romania","2024-10-23",0,0,1,0,0,1,0,0
"Romania","2024-10-24",0,0,1,0,0,1,0,0
"Romania","2024-10-25",0,0,1,0,0,1,0,0
"Romania","2024-10-26",0,0,1,0,0,1,0,0
"Romania","2024-10-27",0,0,1,0,0,1,0,0
"Romania","2024-10-28",0,0,1,0,0,1,0,0
"Romania","2024-10-29",0,0,1,0,0,1,0,0
"Romania","2024-10-30",0,0,1,0,0,1,0,0
"Romania","2024-10-31",0,0,1,0,0,1,0,0
"Romania","2024-11-01",0,0,1,0,0,1,0,0
"Romania","2024-11-02",0,0,1,0,0,1,0,0
"Romania","2024-11-03",0,0,1,0,0,1,0,0
"Romania","2024-11-04",0,0,1,0,0,1,0,0
"Romania","2024-11-05",0,0,1,0,0,1,0,0
"Romania","2024-11-06",0,0,1,0,0,1,0,0
"Romania","2024-11-07",0,0,1,0,0,1,0,0
"Romania","2024-11-08",0,0,1,0,0,1,0,0
"Romania","2024-11-09",0,0,1,0,0,1,0,0
"Romania","2024-11-10",0,0,1,0,0,1,0,0
"Romania","2024-11-11",0,0,1,0,0,1,0,0
"Romania","2024-11-12",0,0,1,0,0,1,0,0
"Romania","2024-11-13",0,0,1,0,0,1,0,0
"Romania","2024-11-14",0,0,1,0,0,1,0,0
"Romania","2024-11-15",0,0,1,0,0,1,0,0
"Romania","2024-11-16",0,0,1,0,0,1,0,0
"Romania","2024-11-17",0,0,1,0,0,1,0,0
"Romania","2024-11-18",0,0,1,0,0,1,0,0
"Romania","2024-11-19",0,0,1,0,0,1,0,0
"Romania","2024-11-20",0,0,1,0,0,1,0,0
"Romania","2024-11-21",0,0,1,0,0,1,0,0
"Romania","2024-11-22",0,0,1,0,0,1,0,0
"Romania","2024-11-23",0,0,1,0,0,1,0,0
"Romania","2024-11-24",0,0,1,0,0,1,0,0
"Romania","2024-11-25",0,0,1,0,0,1,0,0
"Romania","2024-11-26",0,0,1,0,0,1,0,0
"Romania","2024-11-27",0,0,1,0,0,1,0,0
"Romania","2024-11-28",0,0,1,0,0,1,0,0
"Romania","2024-11-29",0,0,1,0,0,1,0,0
"Romania","2024-11-30",0,0,1,0,0,1,0,0
"Romania","2024-12-01",0,0,1,0,0,1,0,0
"Romania","2024-12-02",0,0,1,0,0,1,0,0
"Romania","2024-12-03",0,0,1,0,0,1,0,0
"Romania","2024-12-04",0,0,1,0,0,1,0,0
"Romania","2024-12-05",0,0,1,0,0,1,0,0
"Romania","2024-12-06",0,0,1,0,0,1,0,0
"Romania","2024-12-07",0,0,1,0,0,1,0,0
"Romania","2024-12-08",0,0,1,0,0,1,0,0
"Romania","2024-12-09",0,0,1,0,0,1,0,0
"Russian Federation","2024-01-01",0,0,0,0,0,0,0,0
"Russian Federation","2024-01-02",0,0,0,0,0,0,0,0
"Russian Federation","2024-01-03",0,0,0,0,0,0,0,0
"Russian Federation","2024-01-04",0,0,0,0,0,0,0,0
"Russian Federation","2024-01-05",0,0,0,0,0,0,0,0
"Russian Federation","2024-01-06",0,0,0,0,0,0,0,0
"Russian Federation","2024-01-07",0,0,0,0,0,0,0,0
"Russian Federation","2024-01-08",0,0,0,0,0,0,0,0
"Russian Federation","2024-01-09",0,0,0,0,0,0,0,0
"Russian Federation","2024-01-10",0,0,0,0,0,0,0,0
"Russian Federation","2024-01-11",0,0,0,0,0,0,0,0
"Russian Federation","2024-01-12",0,0,0,0,0,0,0,0
"Russian Federation","2024-01-13",0,0,0,0,0,0,0,0
"Russian Federation","2024-01-14",0,0,0,0,0,0,0,0
"Russian Federation","2024-01-15",0,0,0,0,0,0,0,0
"Russian Federation","2024-01-16",0,0,0,0,0,0,0,0
"Russian Federation","2024-01-17",0,0,0,0,0,0,0,0
"Russian Federation","2024-01-18",0,0,0,0,0,0,0,0
"Russian Federation","2024-01-19",0,0,0,0,0,0,0,0
"Russian Federation","2024-01-20",0,0,0,0,0,0,0,0
"Russian Federation","2024-01-21",0,0,0,0,0,0,0,0
"Russian Federation","2024-01-22",0,0,0,0,0,0,0,0
"Russian Federation","2024-01-23",0,0,0,0,0,0,0,0
"Russian Federation","2024-01-24",0,0,0,0,0,0,0,0
"Russian Federation","2024-01-25",0,0,0,0,0,0,0,0
"Russian Federation","2024-01-26",0,0,0,0,0,0,0,0
"Russian Federation","2024-01-27",0,0,0,0,0,0,0,0
"Russian Federation","2024-01-28",0,0,0,0,0,0,0,0
"Russian Federation","2024-01-29",0,0,0,0,0,0,0,0
"Russian Federation","2024-01-30",0,0,0,0,0,0,0,0
"Russian Federation","2024-01-31",0,2,2,0,2,2,0,0
"Russian Federation","2024-02-01",0,0,2,0,0,2,0,0
"Russian Federation","2024-02-02",0,0,2,0,0,2,0,0
"Russian Federation","2024-02-03",0,0,2,0,0,2,0,0
"Russian Federation","2024-02-04",0,0,2,0,0,2,0,0
"Russian Federation","2024-02-05",0,0,2,0,0,2,0,0
"Russian Federation","2024-02-06",0,0,2,0,0,2,0,0
"Russian Federation","2024-02-07",0,0,2,0,0,2,0,0
"Russian Federation","2024-02-08",0,0,2,0,0,2,0,0
"Russian Federation","2024-02-09",0,0,2,0,0,2,0,0
"Russian Federation","2024-02-10",0,0,2,0,0,2,0,0
"Russian Federation","2024-02-11",0,0,2,0,0,2,0,0
"Russian Federation","2024-02-12",0,0,2,0,0,2,0,0
"Russian Federation","2024-02-13",0,0,2,0,0,2,0,0
"Russian Federation","2024-02-14",0,0,2,0,0,2,0,0
"Russian Federation","2024-02-15",0,0,2,0,0,2,0,0
"Russian Federation","2024-02-16",0,0,2,0,0,2,0,0
"Russian Federation","2024-02-17",0,0,2,0,0,2,0,0
"Russian Federation","2024-02-18",0,0,2,0,0,2,0,0
"Russian Federation","2024-02-19",0,0,2,0,0,2,0,0
"Russian Federation","2024-02-20",0,0,2,0,0,2,0,0
"Russian Federation","2024-02-21",0,0,2,0,0,2,0,0
"Russian Federation","2024-02-22",0,0,2,0,0,2,0,0
"Russian Federation","2024-02-23",0,0,2,0,0,2,0,0
"Russian Federation","2024-02-24",0,0,2,0,0,2,0,0
"Russian Federation","2024-02-25",0,0,2,0,0,2,0,0
"Russian Federation","2024-02-26",0,0,2,0,0,2,0,0
"Russian Federation","2024-02-27",0,0,2,0,0,2,0,0
"Russian Federation","2024-02-28",0,0,2,0,0,2,0,0
"Russian Federation","2024-02-29",0,0,2,0,0,2,0,0
"Russian Federation","2024-03-01",0,0,2,0,0,2,0,0
"Russian Federation","2024-03-02",0,0,2,0,0,2,0,0
"Russian Federation","2024-03-03",0,0,2,0,0,2,0,0
"Russian Federation","2024-03-04",0,0,2,0,0,2,0,0
"Russian Federation","2024-03-05",0,0,2,0,0,2,0,0
"Russian Federation","2024-03-06",0,0,2,0,0,2,0,0
"Russian Federation","2024-03-07",0,0,2,0,0,2,0,0
"Russian Federation","2024-03-08",0,0,2,0,0,2,0,0
"Russian Federation","2024-03-09",0,0,2,0,0,2,0,0
"Russian Federation","2024-03-10",0,0,2,0,0,2,0,0
"Russian Federation","2024-03-11",0,0,2,0,0,2,0,0
"Russian Federation","2024-03-12",0,0,2,0,0,2,0,0
"Russian Federation","2024-03-13",0,0,2,0,0,2,0,0
"Russian Federation","2024-03-14",0,0,2,0,0,2,0,0
"Russian Federation","2024-03-15",0,0,2,0,0,2,0,0
"Russian Federation","2024-03-16",0,0,2,0,0,2,0,0
"Russian Federation","2024-03-17",0,0,2,0,0,2,0,0
"Russian Federation","2024-03-18",0,0,2,0,0,2,0,0
"Russian Federation","2024-03-19",0,0,2,0,0,2,0,0
"Russian Federation","2024-03-20",0,0,2,0,0,2,0,0
"Russian Federation","2024-03-21",0,0,2,0,0,2,0,0
"Russian Federation","2024-03-22",0,0,2,0,0,2,0,0
"Russian Federation","2024-03-23",0,0,2,0,0,2,0,0
"Russian Federation","2024-03-24",0,0,2,0,0,2,0,0
"Russian Federation","2024-03-25",0,0,2,0,0,2,0,0
"Russian Federation","2024-03-26",0,0,2,0,0,2,0,0
"Russian Federation","2024-03-27",0,0,2,0,0,2,0,0
"Russian Federation","2024-03-28",0,0,2,0,0,2,0,0
"Russian Federation","2024-03-29",0,0,2,0,0,2,0,0
"Russian Federation","2024-03-30",0,0,2,0,0,2,0,0
"Russian Federation","2024-03-31",0,0,2,0,0,2,0,0
"Russian Federation","2024-04-01",0,0,2,0,0,2,0,0
"Russian Federation","2024-04-02",0,0,2,0,0,2,0,0
"Russian Federation","2024-04-03",0,0,2,0,0,2,0,0
"Russian Federation","2024-04-04",0,0,2,0,0,2,0,0
"Russian Federation","2024-04-05",0,0,2,0,0,2,0,0
"Russian Federation","2024-04-06",0,0,2,0,0,2,0,0
"Russian Federation","2024-04-07",0,0,2,0,0,2,0,0
"Russian Federation","2024-04-08",0,0,2,0,0,2,0,0
"Russian Federation","2024-04-09",0,0,2,0,0,2,0,0
"Russian Federation","2024-04-10",0,0,2,0,0,2,0,0
"Russian Federation","2024-04-11",0,0,2,0,0,2,0,0
"Russian Federation","2024-04-12",0,0,2,0,0,2,0,0
"Russian Federation","2024-04-13",0,0,2,0,0,2,0,0
"Russian Federation","2024-04-14",0,0,2,0,0,2,0,0
"Russian Federation","2024-04-15",0,0,2,0,0,2,0,0
"Russian Federation","2024-04-16",0,0,2,0,0,2,0,0
"Russian Federation","2024-04-17",0,0,2,0,0,2,0,0
"Russian Federation","2024-04-18",0,0,2,0,0,2,0,0
"Russian Federation","2024-04-19",0,0,2,0,0,2,0,0
"Russian Federation","2024-04-20",0,0,2,0,0,2,0,0
"Russian Federation","2024-04-21",0,0,2,0,0,2,0,0
"Russian Federation","2024-04-22",0,0,2,0,0,2,0,0
"Russian Federation","2024-04-23",0,0,2,0,0,2,0,0
"Russian Federation","2024-04-24",0,0,2,0,0,2,0,0
"Russian Federation","2024-04-25",0,0,2,0,0,2,0,0
"Russian Federation","2024-04-26",0,0,2,0,0,2,0,0
"Russian Federation","2024-04-27",0,0,2,0,0,2,0,0
"Russian Federation","2024-04-28",0,0,2,0,0,2,0,0
"Russian Federation","2024-04-29",0,0,2,0,0,2,0,0
"Russian Federation","2024-04-30",0,0,2,0,0,2,0,0
"Russian Federation","2024-05-01",0,0,2,0,0,2,0,0
"Russian Federation","2024-05-02",0,0,2,0,0,2,0,0
"Russian Federation","2024-05-03",0,0,2,0,0,2,0,0
"Russian Federation","2024-05-04",0,0,2,0,0,2,0,0
"Russian Federation","2024-05-05",0,0,2,0,0,2,0,0
"Russian Federation","2024-05-06",0,0,2,0,0,2,0,0
"Russian Federation","2024-05-07",0,0,2,0,0,2,0,0
"Russian Federation","2024-05-08",0,0,2,0,0,2,0,0
"Russian Federation","2024-05-09",0,0,2,0,0,2,0,0
"Russian Federation","2024-05-10",0,0,2,0,0,2,0,0
"Russian Federation","2024-05-11",0,0,2,0,0,2,0,0
"Russian Federation","2024-05-12",0,0,2,0,0,2,0,0
"Russian Federation","2024-05-13",0,0,2,0,0,2,0,0
"Russian Federation","2024-05-14",0,0,2,0,0,2,0,0
"Russian Federation","2024-05-15",0,0,2,0,0,2,0,0
"Russian Federation","2024-05-16",0,0,2,0,0,2,0,0
"Russian Federation","2024-05-17",0,0,2,0,0,2,0,0
"Russian Federation","2024-05-18",0,0,2,0,0,2,0,0
"Russian Federation","2024-05-19",0,0,2,0,0,2,0,0
"Russian Federation","2024-05-20",0,0,2,0,0,2,0,0
"Russian Federation","2024-05-21",0,0,2,0,0,2,0,0
"Russian Federation","2024-05-22",0,0,2,0,0,2,0,0
"Russian Federation","2024-05-23",0,0,2,0,0,2,0,0
"Russian Federation","2024-05-24",0,0,2,0,0,2,0,0
"Russian Federation","2024-05-25",0,0,2,0,0,2,0,0
"Russian Federation","2024-05-26",0,0,2,0,0,2,0,0
"Russian Federation","2024-05-27",0,0,2,0,0,2,0,0
"Russian Federation","2024-05-28",0,0,2,0,0,2,0,0
"Russian Federation","2024-05-29",0,0,2,0,0,2,0,0
"Russian Federation","2024-05-30",0,0,2,0,0,2,0,0
"Russian Federation","2024-05-31",0,0,2,0,0,2,0,0
"Russian Federation","2024-06-01",0,0,2,0,0,2,0,0
"Russian Federation","2024-06-02",0,0,2,0,0,2,0,0
"Russian Federation","2024-06-03",0,0,2,0,0,2,0,0
"Russian Federation","2024-06-04",0,0,2,0,0,2,0,0
"Russian Federation","2024-06-05",0,0,2,0,0,2,0,0
"Russian Federation","2024-06-06",0,0,2,0,0,2,0,0
"Russian Federation","2024-06-07",0,0,2,0,0,2,0,0
"Russian Federation","2024-06-08",0,0,2,0,0,2,0,0
"Russian Federation","2024-06-09",0,0,2,0,0,2,0,0
"Russian Federation","2024-06-10",0,0,2,0,0,2,0,0
"Russian Federation","2024-06-11",0,0,2,0,0,2,0,0
"Russian Federation","2024-06-12",0,0,2,0,0,2,0,0
"Russian Federation","2024-06-13",0,0,2,0,0,2,0,0
"Russian Federation","2024-06-14",0,0,2,0,0,2,0,0
"Russian Federation","2024-06-15",0,0,2,0,0,2,0,0
"Russian Federation","2024-06-16",0,0,2,0,0,2,0,0
"Russian Federation","2024-06-17",0,0,2,0,0,2,0,0
"Russian Federation","2024-06-18",0,0,2,0,0,2,0,0
"Russian Federation","2024-06-19",0,0,2,0,0,2,0,0
"Russian Federation","2024-06-20",0,0,2,0,0,2,0,0
"Russian Federation","2024-06-21",0,0,2,0,0,2,0,0
"Russian Federation","2024-06-22",0,0,2,0,0,2,0,0
"Russian Federation","2024-06-23",0,0,2,0,0,2,0,0
"Russian Federation","2024-06-24",0,0,2,0,0,2,0,0
"Russian Federation","2024-06-25",0,0,2,0,0,2,0,0
"Russian Federation","2024-06-26",0,0,2,0,0,2,0,0
"Russian Federation","2024-06-27",0,0,2,0,0,2,0,0
"Russian Federation","2024-06-28",0,0,2,0,0,2,0,0
"Russian Federation","2024-06-29",0,0,2,0,0,2,0,0
"Russian Federation","2024-06-30",0,0,2,0,0,2,0,0
"Russian Federation","2024-07-01",0,0,2,0,0,2,0,0
"Russian Federation","2024-07-02",0,0,2,0,0,2,0,0
"Russian Federation","2024-07-03",0,0,2,0,0,2,0,0
"Russian Federation","2024-07-04",0,0,2,0,0,2,0,0
"Russian Federation","2024-07-05",0,0,2,0,0,2,0,0
"Russian Federation","2024-07-06",0,0,2,0,0,2,0,0
"Russian Federation","2024-07-07",0,0,2,0,0,2,0,0
"Russian Federation","2024-07-08",0,0,2,0,0,2,0,0
"Russian Federation","2024-07-09",0,0,2,0,0,2,0,0
"Russian Federation","2024-07-10",0,0,2,0,0,2,0,0
"Russian Federation","2024-07-11",0,0,2,0,0,2,0,0
"Russian Federation","2024-07-12",0,0,2,0,0,2,0,0
"Russian Federation","2024-07-13",0,0,2,0,0,2,0,0
"Russian Federation","2024-07-14",0,0,2,0,0,2,0,0
"Russian Federation","2024-07-15",0,0,2,0,0,2,0,0
"Russian Federation","2024-07-16",0,0,2,0,0,2,0,0
"Russian Federation","2024-07-17",0,0,2,0,0,2,0,0
"Russian Federation","2024-07-18",0,0,2,0,0,2,0,0
"Russian Federation","2024-07-19",0,0,2,0,0,2,0,0
"Russian Federation","2024-07-20",0,0,2,0,0,2,0,0
"Russian Federation","2024-07-21",0,0,2,0,0,2,0,0
"Russian Federation","2024-07-22",0,0,2,0,0,2,0,0
"Russian Federation","2024-07-23",0,0,2,0,0,2,0,0
"Russian Federation","2024-07-24",0,0,2,0,0,2,0,0
"Russian Federation","2024-07-25",0,0,2,0,0,2,0,0
"Russian Federation","2024-07-26",0,0,2,0,0,2,0,0
"Russian Federation","2024-07-27",0,0,2,0,0,2,0,0
"Russian Federation","2024-07-28",0,0,2,0,0,2,0,0
"Russian Federation","2024-07-29",0,0,2,0,0,2,0,0
"Russian Federation","2024-07-30",0,0,2,0,0,2,0,0
"Russian Federation","2024-07-31",0,0,2,0,0,2,0,0
"Russian Federation","2024-08-01",0,0,2,0,0,2,0,0
"Russian Federation","2024-08-02",0,0,2,0,0,2,0,0
"Russian Federation","2024-08-03",0,0,2,0,0,2,0,0
"Russian Federation","2024-08-04",0,0,2,0,0,2,0,0
"Russian Federation","2024-08-05",0,0,2,0,0,2,0,0
"Russian Federation","2024-08-06",0,0,2,0,0,2,0,0
"Russian Federation","2024-08-07",0,0,2,0,0,2,0,0
"Russian Federation","2024-08-08",0,0,2,0,0,2,0,0
"Russian Federation","2024-08-09",0,0,2,0,0,2,0,0
"Russian Federation","2024-08-10",0,0,2,0,0,2,0,0
"Russian Federation","2024-08-11",0,0,2,0,0,2,0,0
"Russian Federation","2024-08-12",0,0,2,0,0,2,0,0
"Russian Federation","2024-08-13",0,0,2,0,0,2,0,0
"Russian Federation","2024-08-14",0,0,2,0,0,2,0,0
"Russian Federation","2024-08-15",0,0,2,0,0,2,0,0
"Russian Federation","2024-08-16",0,0,2,0,0,2,0,0
"Russian Federation","2024-08-17",0,0,2,0,0,2,0,0
"Russian Federation","2024-08-18",0,0,2,0,0,2,0,0
"Russian Federation","2024-08-19",0,0,2,0,0,2,0,0
"Russian Federation","2024-08-20",0,0,2,0,0,2,0,0
"Russian Federation","2024-08-21",0,0,2,0,0,2,0,0
"Russian Federation","2024-08-22",0,0,2,0,0,2,0,0
"Russian Federation","2024-08-23",0,0,2,0,0,2,0,0
"Russian Federation","2024-08-24",0,0,2,0,0,2,0,0
"Russian Federation","2024-08-25",0,0,2,0,0,2,0,0
"Russian Federation","2024-08-26",0,0,2,0,0,2,0,0
"Russian Federation","2024-08-27",0,0,2,0,0,2,0,0
"Russian Federation","2024-08-28",0,0,2,0,0,2,0,0
"Russian Federation","2024-08-29",0,0,2,0,0,2,0,0
"Russian Federation","2024-08-30",0,0,2,0,0,2,0,0
"Russian Federation","2024-08-31",0,0,2,0,0,2,0,0
"Russian Federation","2024-09-01",0,0,2,0,0,2,0,0
"Russian Federation","2024-09-02",0,0,2,0,0,2,0,0
"Russian Federation","2024-09-03",0,0,2,0,0,2,0,0
"Russian Federation","2024-09-04",0,0,2,0,0,2,0,0
"Russian Federation","2024-09-05",0,0,2,0,0,2,0,0
"Russian Federation","2024-09-06",0,0,2,0,0,2,0,0
"Russian Federation","2024-09-07",0,0,2,0,0,2,0,0
"Russian Federation","2024-09-08",0,0,2,0,0,2,0,0
"Russian Federation","2024-09-09",0,0,2,0,0,2,0,0
"Russian Federation","2024-09-10",0,0,2,0,0,2,0,0
"Russian Federation","2024-09-11",0,0,2,0,0,2,0,0
"Russian Federation","2024-09-12",0,0,2,0,0,2,0,0
"Russian Federation","2024-09-13",0,0,2,0,0,2,0,0
"Russian Federation","2024-09-14",0,0,2,0,0,2,0,0
"Russian Federation","2024-09-15",0,0,2,0,0,2,0,0
"Russian Federation","2024-09-16",0,0,2,0,0,2,0,0
"Russian Federation","2024-09-17",0,0,2,0,0,2,0,0
"Russian Federation","2024-09-18",0,0,2,0,0,2,0,0
"Russian Federation","2024-09-19",0,0,2,0,0,2,0,0
"Russian Federation","2024-09-20",0,0,2,0,0,2,0,0
"Russian Federation","2024-09-21",0,0,2,0,0,2,0,0
"Russian Federation","2024-09-22",0,0,2,0,0,2,0,0
"Russian Federation","2024-09-23",0,0,2,0,0,2,0,0
"Russian Federation","2024-09-24",0,0,2,0,0,2,0,0
"Russian Federation","2024-09-25",0,0,2,0,0,2,0,0
"Russian Federation","2024-09-26",0,0,2,0,0,2,0,0
"Russian Federation","2024-09-27",0,0,2,0,0,2,0,0
"Russian Federation","2024-09-28",0,0,2,0,0,2,0,0
"Russian Federation","2024-09-29",0,0,2,0,0,2,0,0
"Russian Federation","2024-09-30",0,0,2,0,0,2,0,0
"Russian Federation","2024-10-01",0,0,2,0,0,2,0,0
"Russian Federation","2024-10-02",0,0,2,0,0,2,0,0
"Russian Federation","2024-10-03",0,0,2,0,0,2,0,0
"Russian Federation","2024-10-04",0,0,2,0,0,2,0,0
"Russian Federation","2024-10-05",0,0,2,0,0,2,0,0
"Russian Federation","2024-10-06",0,0,2,0,0,2,0,0
"Russian Federation","2024-10-07",0,0,2,0,0,2,0,0
"Russian Federation","2024-10-08",0,0,2,0,0,2,0,0
"Russian Federation","2024-10-09",0,0,2,0,0,2,0,0
"Russian Federation","2024-10-10",0,0,2,0,0,2,0,0
"Russian Federation","2024-10-11",0,0,2,0,0,2,0,0
"Russian Federation","2024-10-12",0,0,2,0,0,2,0,0
"Russian Federation","2024-10-13",0,0,2,0,0,2,0,0
"Russian Federation","2024-10-14",0,0,2,0,0,2,0,0
"Russian Federation","2024-10-15",0,0,2,0,0,2,0,0
"Russian Federation","2024-10-16",0,0,2,0,0,2,0,0
"Russian Federation","2024-10-17",0,0,2,0,0,2,0,0
"Russian Federation","2024-10-18",0,0,2,0,0,2,0,0
"Russian Federation","2024-10-19",0,0,2,0,0,2,0,0
"Russian Federation","2024-10-20",0,0,2,0,0,2,0,0
"Russian Federation","2024-10-21",0,0,2,0,0,2,0,0
"Russian Federation","2024-10-22",0,0,2,0,0,2,0,0
"Russian Federation","2024-10-23",0,0,2,0,0,2,0,0
"Russian Federation","2024-10-24",0,0,2,0,0,2,0,0
"Russian Federation","2024-10-25",0,0,2,0,0,2,0,0
"Russian Federation","2024-10-26",0,0,2,0,0,2,0,0
"Russian Federation","2024-10-27",0,0,2,0,0,2,0,0
"Russian Federation","2024-10-28",0,0,2,0,0,2,0,0
"Russian Federation","2024-10-29",0,0,2,0,0,2,0,0
"Russian Federation","2024-10-30",0,0,2,0,0,2,0,0
"Russian Federation","2024-10-31",0,0,2,0,0,2,0,0
"Russian Federation","2024-11-01",0,0,2,0,0,2,0,0
"Russian Federation","2024-11-02",0,0,2,0,0,2,0,0
"Russian Federation","2024-11-03",0,0,2,0,0,2,0,0
"Russian Federation","2024-11-04",0,0,2,0,0,2,0,0
"Russian Federation","2024-11-05",0,0,2,0,0,2,0,0
"Russian Federation","2024-11-06",0,0,2,0,0,2,0,0
"Russian Federation","2024-11-07",0,0,2,0,0,2,0,0
"Russian Federation","2024-11-08",0,0,2,0,0,2,0,0
"Russian Federation","2024-11-09",0,0,2,0,0,2,0,0
"Russian Federation","2024-11-10",0,0,2,0,0,2,0,0
"Russian Federation","2024-11-11",0,0,2,0,0,2,0,0
"Russian Federation","2024-11-12",0,0,2,0,0,2,0,0
"Russian Federation","2024-11-13",0,0,2,0,0,2,0,0
"Russian Federation","2024-11-14",0,0,2,0,0,2,0,0
"Russian Federation","2024-11-15",0,0,2,0,0,2,0,0
"Russian Federation","2024-11-16",0,0,2,0,0,2,0,0
"Russian Federation","2024-11-17",0,0,2,0,0,2,0,0
"Russian Federation","2024-11-18",0,0,2,0,0,2,0,0
"Russian Federation","2024-11-19",0,0,2,0,0,2,0,0
"Russian Federation","2024-11-20",0,0,2,0,0,2,0,0
"Russian Federation","2024-11-21",0,0,2,0,0,2,0,0
"Russian Federation","2024-11-22",0,0,2,0,0,2,0,0
"Russian Federation","2024-11-23",0,0,2,0,0,2,0,0
"Russian Federation","2024-11-24",0,0,2,0,0,2,0,0
"Russian Federation","2024-11-25",0,0,2,0,0,2,0,0
"Russian Federation","2024-11-26",0,0,2,0,0,2,0,0
"Russian Federation","2024-11-27",0,0,2,0,0,2,0,0
"Russian Federation","2024-11-28",0,0,2,0,0,2,0,0
"Russian Federation","2024-11-29",0,0,2,0,0,2,0,0
"Russian Federation","2024-11-30",0,0,2,0,0,2,0,0
"Russian Federation","2024-12-01",0,0,2,0,0,2,0,0
"Russian Federation","2024-12-02",0,0,2,0,0,2,0,0
"Russian Federation","2024-12-03",0,0,2,0,0,2,0,0
"Russian Federation","2024-12-04",0,0,2,0,0,2,0,0
"Russian Federation","2024-12-05",0,0,2,0,0,2,0,0
"Russian Federation","2024-12-06",0,0,2,0,0,2,0,0
"Russian Federation","2024-12-07",0,0,2,0,0,2,0,0
"Russian Federation","2024-12-08",0,0,2,0,0,2,0,0
"Russian Federation","2024-12-09",0,0,2,0,0,2,0,0
"Rwanda","2024-01-01",0,0,0,0,0,0,0,0
"Rwanda","2024-01-02",0,0,0,0,0,0,0,0
"Rwanda","2024-01-03",0,0,0,0,0,0,0,0
"Rwanda","2024-01-04",0,0,0,0,0,0,0,0
"Rwanda","2024-01-05",0,0,0,0,0,0,0,0
"Rwanda","2024-01-06",0,0,0,0,0,0,0,0
"Rwanda","2024-01-07",0,0,0,0,0,0,0,0
"Rwanda","2024-01-08",0,0,0,0,0,0,0,0
"Rwanda","2024-01-09",0,0,0,0,0,0,0,0
"Rwanda","2024-01-10",0,0,0,0,0,0,0,0
"Rwanda","2024-01-11",0,0,0,0,0,0,0,0
"Rwanda","2024-01-12",0,0,0,0,0,0,0,0
"Rwanda","2024-01-13",0,0,0,0,0,0,0,0
"Rwanda","2024-01-14",0,0,0,0,0,0,0,0
"Rwanda","2024-01-15",0,0,0,0,0,0,0,0
"Rwanda","2024-01-16",0,0,0,0,0,0,0,0
"Rwanda","2024-01-17",0,0,0,0,0,0,0,0
"Rwanda","2024-01-18",0,0,0,0,0,0,0,0
"Rwanda","2024-01-19",0,0,0,0,0,0,0,0
"Rwanda","2024-01-20",0,0,0,0,0,0,0,0
"Rwanda","2024-01-21",0,0,0,0,0,0,0,0
"Rwanda","2024-01-22",0,0,0,0,0,0,0,0
"Rwanda","2024-01-23",0,0,0,0,0,0,0,0
"Rwanda","2024-01-24",0,0,0,0,0,0,0,0
"Rwanda","2024-01-25",0,0,0,0,0,0,0,0
"Rwanda","2024-01-26",0,0,0,0,0,0,0,0
"Rwanda","2024-01-27",0,0,0,0,0,0,0,0
"Rwanda","2024-01-28",0,0,0,0,0,0,0,0
"Rwanda","2024-01-29",0,0,0,0,0,0,0,0
"Rwanda","2024-01-30",0,0,0,0,0,0,0,0
"Rwanda","2024-01-31",0,0,0,0,0,0,0,0
"Rwanda","2024-02-01",0,0,0,0,0,0,0,0
"Rwanda","2024-02-02",0,0,0,0,0,0,0,0
"Rwanda","2024-02-03",0,0,0,0,0,0,0,0
"Rwanda","2024-02-04",0,0,0,0,0,0,0,0
"Rwanda","2024-02-05",0,0,0,0,0,0,0,0
"Rwanda","2024-02-06",0,0,0,0,0,0,0,0
"Rwanda","2024-02-07",0,0,0,0,0,0,0,0
"Rwanda","2024-02-08",0,0,0,0,0,0,0,0
"Rwanda","2024-02-09",0,0,0,0,0,0,0,0
"Rwanda","2024-02-10",0,0,0,0,0,0,0,0
"Rwanda","2024-02-11",0,0,0,0,0,0,0,0
"Rwanda","2024-02-12",0,0,0,0,0,0,0,0
"Rwanda","2024-02-13",0,0,0,0,0,0,0,0
"Rwanda","2024-02-14",0,0,0,0,0,0,0,0
"Rwanda","2024-02-15",0,0,0,0,0,0,0,0
"Rwanda","2024-02-16",0,0,0,0,0,0,0,0
"Rwanda","2024-02-17",0,0,0,0,0,0,0,0
"Rwanda","2024-02-18",0,0,0,0,0,0,0,0
"Rwanda","2024-02-19",0,0,0,0,0,0,0,0
"Rwanda","2024-02-20",0,0,0,0,0,0,0,0
"Rwanda","2024-02-21",0,0,0,0,0,0,0,0
"Rwanda","2024-02-22",0,0,0,0,0,0,0,0
"Rwanda","2024-02-23",0,0,0,0,0,0,0,0
"Rwanda","2024-02-24",0,0,0,0,0,0,0,0
"Rwanda","2024-02-25",0,0,0,0,0,0,0,0
"Rwanda","2024-02-26",0,0,0,0,0,0,0,0
"Rwanda","2024-02-27",0,0,0,0,0,0,0,0
"Rwanda","2024-02-28",0,0,0,0,0,0,0,0
"Rwanda","2024-02-29",0,0,0,0,0,0,0,0
"Rwanda","2024-03-01",0,0,0,0,0,0,0,0
"Rwanda","2024-03-02",0,0,0,0,0,0,0,0
"Rwanda","2024-03-03",0,0,0,0,0,0,0,0
"Rwanda","2024-03-04",0,0,0,0,0,0,0,0
"Rwanda","2024-03-05",0,0,0,0,0,0,0,0
"Rwanda","2024-03-06",0,0,0,0,0,0,0,0
"Rwanda","2024-03-07",0,0,0,0,0,0,0,0
"Rwanda","2024-03-08",0,0,0,0,0,0,0,0
"Rwanda","2024-03-09",0,0,0,0,0,0,0,0
"Rwanda","2024-03-10",0,0,0,0,0,0,0,0
"Rwanda","2024-03-11",0,0,0,0,0,0,0,0
"Rwanda","2024-03-12",0,0,0,0,0,0,0,0
"Rwanda","2024-03-13",0,0,0,0,0,0,0,0
"Rwanda","2024-03-14",0,0,0,0,0,0,0,0
"Rwanda","2024-03-15",0,0,0,0,0,0,0,0
"Rwanda","2024-03-16",0,0,0,0,0,0,0,0
"Rwanda","2024-03-17",0,0,0,0,0,0,0,0
"Rwanda","2024-03-18",0,0,0,0,0,0,0,0
"Rwanda","2024-03-19",0,0,0,0,0,0,0,0
"Rwanda","2024-03-20",0,0,0,0,0,0,0,0
"Rwanda","2024-03-21",0,0,0,0,0,0,0,0
"Rwanda","2024-03-22",0,0,0,0,0,0,0,0
"Rwanda","2024-03-23",0,0,0,0,0,0,0,0
"Rwanda","2024-03-24",0,0,0,0,0,0,0,0
"Rwanda","2024-03-25",0,0,0,0,0,0,0,0
"Rwanda","2024-03-26",0,0,0,0,0,0,0,0
"Rwanda","2024-03-27",0,0,0,0,0,0,0,0
"Rwanda","2024-03-28",0,0,0,0,0,0,0,0
"Rwanda","2024-03-29",0,0,0,0,0,0,0,0
"Rwanda","2024-03-30",0,0,0,0,0,0,0,0
"Rwanda","2024-03-31",0,0,0,0,0,0,0,0
"Rwanda","2024-04-01",0,0,0,0,0,0,0,0
"Rwanda","2024-04-02",0,0,0,0,0,0,0,0
"Rwanda","2024-04-03",0,0,0,0,0,0,0,0
"Rwanda","2024-04-04",0,0,0,0,0,0,0,0
"Rwanda","2024-04-05",0,0,0,0,0,0,0,0
"Rwanda","2024-04-06",0,0,0,0,0,0,0,0
"Rwanda","2024-04-07",0,0,0,0,0,0,0,0
"Rwanda","2024-04-08",0,0,0,0,0,0,0,0
"Rwanda","2024-04-09",0,0,0,0,0,0,0,0
"Rwanda","2024-04-10",0,0,0,0,0,0,0,0
"Rwanda","2024-04-11",0,0,0,0,0,0,0,0
"Rwanda","2024-04-12",0,0,0,0,0,0,0,0
"Rwanda","2024-04-13",0,0,0,0,0,0,0,0
"Rwanda","2024-04-14",0,0,0,0,0,0,0,0
"Rwanda","2024-04-15",0,0,0,0,0,0,0,0
"Rwanda","2024-04-16",0,0,0,0,0,0,0,0
"Rwanda","2024-04-17",0,0,0,0,0,0,0,0
"Rwanda","2024-04-18",0,0,0,0,0,0,0,0
"Rwanda","2024-04-19",0,0,0,0,0,0,0,0
"Rwanda","2024-04-20",0,0,0,0,0,0,0,0
"Rwanda","2024-04-21",0,0,0,0,0,0,0,0
"Rwanda","2024-04-22",0,0,0,0,0,0,0,0
"Rwanda","2024-04-23",0,0,0,0,0,0,0,0
"Rwanda","2024-04-24",0,0,0,0,0,0,0,0
"Rwanda","2024-04-25",0,0,0,0,0,0,0,0
"Rwanda","2024-04-26",0,0,0,0,0,0,0,0
"Rwanda","2024-04-27",0,0,0,0,0,0,0,0
"Rwanda","2024-04-28",0,0,0,0,0,0,0,0
"Rwanda","2024-04-29",0,0,0,0,0,0,0,0
"Rwanda","2024-04-30",0,0,0,0,0,0,0,0
"Rwanda","2024-05-01",0,0,0,0,0,0,0,0
"Rwanda","2024-05-02",0,0,0,0,0,0,0,0
"Rwanda","2024-05-03",0,0,0,0,0,0,0,0
"Rwanda","2024-05-04",0,0,0,0,0,0,0,0
"Rwanda","2024-05-05",0,0,0,0,0,0,0,0
"Rwanda","2024-05-06",0,0,0,0,0,0,0,0
"Rwanda","2024-05-07",0,0,0,0,0,0,0,0
"Rwanda","2024-05-08",0,0,0,0,0,0,0,0
"Rwanda","2024-05-09",0,0,0,0,0,0,0,0
"Rwanda","2024-05-10",0,0,0,0,0,0,0,0
"Rwanda","2024-05-11",0,0,0,0,0,0,0,0
"Rwanda","2024-05-12",0,0,0,0,0,0,0,0
"Rwanda","2024-05-13",0,0,0,0,0,0,0,0
"Rwanda","2024-05-14",0,0,0,0,0,0,0,0
"Rwanda","2024-05-15",0,0,0,0,0,0,0,0
"Rwanda","2024-05-16",0,0,0,0,0,0,0,0
"Rwanda","2024-05-17",0,0,0,0,0,0,0,0
"Rwanda","2024-05-18",0,0,0,0,0,0,0,0
"Rwanda","2024-05-19",0,0,0,0,0,0,0,0
"Rwanda","2024-05-20",0,0,0,0,0,0,0,0
"Rwanda","2024-05-21",0,0,0,0,0,0,0,0
"Rwanda","2024-05-22",0,0,0,0,0,0,0,0
"Rwanda","2024-05-23",0,0,0,0,0,0,0,0
"Rwanda","2024-05-24",0,0,0,0,0,0,0,0
"Rwanda","2024-05-25",0,0,0,0,0,0,0,0
"Rwanda","2024-05-26",0,0,0,0,0,0,0,0
"Rwanda","2024-05-27",0,0,0,0,0,0,0,0
"Rwanda","2024-05-28",0,0,0,0,0,0,0,0
"Rwanda","2024-05-29",0,0,0,0,0,0,0,0
"Rwanda","2024-05-30",0,0,0,0,0,0,0,0
"Rwanda","2024-05-31",0,0,0,0,0,0,0,0
"Rwanda","2024-06-01",0,0,0,0,0,0,0,0
"Rwanda","2024-06-02",0,0,0,0,0,0,0,0
"Rwanda","2024-06-03",0,0,0,0,0,0,0,0
"Rwanda","2024-06-04",0,0,0,0,0,0,0,0
"Rwanda","2024-06-05",0,0,0,0,0,0,0,0
"Rwanda","2024-06-06",0,0,0,0,0,0,0,0
"Rwanda","2024-06-07",0,0,0,0,0,0,0,0
"Rwanda","2024-06-08",0,0,0,0,0,0,0,0
"Rwanda","2024-06-09",0,0,0,0,0,0,0,0
"Rwanda","2024-06-10",0,0,0,0,0,0,0,0
"Rwanda","2024-06-11",0,0,0,0,0,0,0,0
"Rwanda","2024-06-12",0,0,0,0,0,0,0,0
"Rwanda","2024-06-13",0,0,0,0,0,0,0,0
"Rwanda","2024-06-14",0,0,0,0,0,0,0,0
"Rwanda","2024-06-15",0,0,0,0,0,0,0,0
"Rwanda","2024-06-16",0,0,0,0,0,0,0,0
"Rwanda","2024-06-17",0,0,0,0,0,0,0,0
"Rwanda","2024-06-18",0,0,0,0,0,0,0,0
"Rwanda","2024-06-19",0,0,0,0,0,0,0,0
"Rwanda","2024-06-20",0,0,0,0,0,0,0,0
"Rwanda","2024-06-21",0,0,0,0,0,0,0,0
"Rwanda","2024-06-22",0,0,0,0,0,0,0,0
"Rwanda","2024-06-23",0,0,0,0,0,0,0,0
"Rwanda","2024-06-24",0,0,0,0,0,0,0,0
"Rwanda","2024-06-25",0,0,0,0,0,0,0,0
"Rwanda","2024-06-26",0,0,0,0,0,0,0,0
"Rwanda","2024-06-27",0,0,0,0,0,0,0,0
"Rwanda","2024-06-28",0,0,0,0,0,0,0,0
"Rwanda","2024-06-29",0,0,0,0,0,0,0,0
"Rwanda","2024-06-30",0,0,0,0,0,0,0,0
"Rwanda","2024-07-01",0,0,0,0,0,0,0,0
"Rwanda","2024-07-02",0,0,0,0,0,0,0,0
"Rwanda","2024-07-03",0,0,0,0,0,0,0,0
"Rwanda","2024-07-04",0,0,0,0,0,0,0,0
"Rwanda","2024-07-05",0,0,0,0,0,0,0,0
"Rwanda","2024-07-06",0,0,0,0,0,0,0,0
"Rwanda","2024-07-07",0,0,0,0,0,0,0,0
"Rwanda","2024-07-08",0,0,0,0,0,0,0,0
"Rwanda","2024-07-09",0,0,0,0,0,0,0,0
"Rwanda","2024-07-10",0,0,0,0,0,0,0,0
"Rwanda","2024-07-11",0,0,0,0,0,0,0,0
"Rwanda","2024-07-12",0,0,0,0,0,0,0,0
"Rwanda","2024-07-13",0,0,0,0,0,0,0,0
"Rwanda","2024-07-14",8,0,0,8,0,0,8,8
"Rwanda","2024-07-15",0,0,0,8,0,0,1,9
"Rwanda","2024-07-16",0,0,0,8,0,0,1,10
"Rwanda","2024-07-17",0,0,0,8,0,0,1,11
"Rwanda","2024-07-18",0,0,0,8,0,0,1,12
"Rwanda","2024-07-19",0,0,0,8,0,0,1,13
"Rwanda","2024-07-20",0,0,0,8,0,0,1,14
"Rwanda","2024-07-21",0,0,0,8,0,0,2,16
"Rwanda","2024-07-22",0,0,0,8,0,0,1,17
"Rwanda","2024-07-23",0,0,0,8,0,0,1,18
"Rwanda","2024-07-24",0,0,0,8,0,0,1,19
"Rwanda","2024-07-25",0,0,0,8,0,0,1,20
"Rwanda","2024-07-26",0,0,0,8,0,0,1,21
"Rwanda","2024-07-27",0,0,0,8,0,0,1,22
"Rwanda","2024-07-28",15,4,4,23,4,4,1,23
"Rwanda","2024-07-29",0,0,4,23,0,4,30,53
"Rwanda","2024-07-30",0,0,4,23,0,4,29,82
"Rwanda","2024-07-31",0,0,4,23,0,4,30,112
"Rwanda","2024-08-01",0,0,4,23,0,4,30,142
"Rwanda","2024-08-02",0,0,4,23,0,4,30,172
"Rwanda","2024-08-03",0,0,4,23,0,4,29,201
"Rwanda","2024-08-04",208,0,4,231,0,4,30,231
"Rwanda","2024-08-05",0,0,4,231,0,4,24,255
"Rwanda","2024-08-06",0,0,4,231,0,4,25,280
"Rwanda","2024-08-07",0,0,4,231,0,4,24,304
"Rwanda","2024-08-08",0,0,4,231,0,4,24,328
"Rwanda","2024-08-09",0,0,4,231,0,4,24,352
"Rwanda","2024-08-10",0,0,4,231,1,5,25,377
"Rwanda","2024-08-11",170,0,4,401,0,5,24,401
"Rwanda","2024-08-12",0,0,4,401,0,5,20,421
"Rwanda","2024-08-13",0,0,4,401,0,5,19,440
"Rwanda","2024-08-14",0,0,4,401,0,5,20,460
"Rwanda","2024-08-15",0,0,4,401,0,5,20,480
"Rwanda","2024-08-16",0,0,4,401,0,5,20,500
"Rwanda","2024-08-17",0,0,4,401,0,5,19,519
"Rwanda","2024-08-18",138,0,4,539,0,5,20,539
"Rwanda","2024-08-19",0,0,4,539,0,5,30,569
"Rwanda","2024-08-20",0,0,4,539,0,5,30,599
"Rwanda","2024-08-21",0,0,4,539,0,5,30,629
"Rwanda","2024-08-22",0,0,4,539,0,5,29,658
"Rwanda","2024-08-23",0,0,4,539,0,5,30,688
"Rwanda","2024-08-24",0,0,4,539,0,5,30,718
"Rwanda","2024-08-25",209,0,4,748,0,5,30,748
"Rwanda","2024-08-26",0,0,4,748,0,5,53,801
"Rwanda","2024-08-27",0,0,4,748,0,5,52,853
"Rwanda","2024-08-28",0,0,4,748,0,5,53,906
"Rwanda","2024-08-29",0,0,4,748,0,5,52,958
"Rwanda","2024-08-30",0,0,4,748,0,5,53,1011
"Rwanda","2024-08-31",0,0,4,748,0,5,52,1063
"Rwanda","2024-09-01",368,0,4,1116,0,5,53,1116
"Rwanda","2024-09-02",0,0,4,1116,0,5,38,1154
"Rwanda","2024-09-03",0,0,4,1116,1,6,37,1191
"Rwanda","2024-09-04",0,0,4,1116,0,6,38,1229
"Rwanda","2024-09-05",0,0,4,1116,0,6,37,1266
"Rwanda","2024-09-06",0,0,4,1116,0,6,38,1304
"Rwanda","2024-09-07",0,0,4,1116,0,6,37,1341
"Rwanda","2024-09-08",263,0,4,1379,0,6,38,1379
"Rwanda","2024-09-09",0,0,4,1379,0,6,51,1430
"Rwanda","2024-09-10",0,0,4,1379,0,6,52,1482
"Rwanda","2024-09-11",0,0,4,1379,0,6,51,1533
"Rwanda","2024-09-12",0,0,4,1379,0,6,52,1585
"Rwanda","2024-09-13",0,0,4,1379,0,6,51,1636
"Rwanda","2024-09-14",0,0,4,1379,0,6,52,1688
"Rwanda","2024-09-15",360,2,6,1739,0,6,51,1739
"Rwanda","2024-09-16",0,0,6,1739,0,6,72,1811
"Rwanda","2024-09-17",0,0,6,1739,0,6,73,1884
"Rwanda","2024-09-18",0,0,6,1739,1,7,72,1956
"Rwanda","2024-09-19",0,0,6,1739,0,7,72,2028
"Rwanda","2024-09-20",0,0,6,1739,0,7,72,2100
"Rwanda","2024-09-21",0,0,6,1739,0,7,73,2173
"Rwanda","2024-09-22",506,0,6,2245,0,7,72,2245
"Rwanda","2024-09-23",0,0,6,2245,1,8,78,2323
"Rwanda","2024-09-24",0,0,6,2245,0,8,77,2400
"Rwanda","2024-09-25",0,0,6,2245,0,8,78,2478
"Rwanda","2024-09-26",0,0,6,2245,0,8,78,2556
"Rwanda","2024-09-27",0,0,6,2245,0,8,78,2634
"Rwanda","2024-09-28",0,0,6,2245,0,8,77,2711
"Rwanda","2024-09-29",544,0,6,2789,1,9,78,2789
"Rwanda","2024-09-30",0,0,6,2789,0,9,1,2790
"Rwanda","2024-10-01",0,0,6,2789,0,9,2,2792
"Rwanda","2024-10-02",0,0,6,2789,0,9,1,2793
"Rwanda","2024-10-03",0,0,6,2789,0,9,1,2794
"Rwanda","2024-10-04",0,0,6,2789,1,10,1,2795
"Rwanda","2024-10-05",0,0,6,2789,0,10,2,2797
"Rwanda","2024-10-06",9,4,10,2798,0,10,1,2798
"Rwanda","2024-10-07",0,0,10,2798,1,11,76,2874
"Rwanda","2024-10-08",0,0,10,2798,0,11,76,2950
"Rwanda","2024-10-09",0,0,10,2798,1,12,76,3026
"Rwanda","2024-10-10",0,0,10,2798,0,12,75,3101
"Rwanda","2024-10-11",0,0,10,2798,1,13,76,3177
"Rwanda","2024-10-12",0,0,10,2798,0,13,76,3253
"Rwanda","2024-10-13",531,4,14,3329,1,14,76,3329
"Rwanda","2024-10-14",0,0,14,3329,1,15,25,3354
"Rwanda","2024-10-15",0,0,14,3329,1,16,26,3380
"Rwanda","2024-10-16",0,0,14,3329,1,17,25,3405
"Rwanda","2024-10-17",0,0,14,3329,2,19,26,3431
"Rwanda","2024-10-18",0,0,14,3329,1,20,25,3456
"Rwanda","2024-10-19",0,0,14,3329,1,21,26,3482
"Rwanda","2024-10-20",178,8,22,3507,1,22,25,3507
"Rwanda","2024-10-21",0,0,22,3507,1,23,27,3534
"Rwanda","2024-10-22",0,0,22,3507,0,23,27,3561
"Rwanda","2024-10-23",0,0,22,3507,1,24,27,3588
"Rwanda","2024-10-24",0,0,22,3507,0,24,28,3616
"Rwanda","2024-10-25",0,0,22,3507,1,25,27,3643
"Rwanda","2024-10-26",0,0,22,3507,0,25,27,3670
"Rwanda","2024-10-27",190,4,26,3697,1,26,27,3697
"Rwanda","2024-10-28",0,0,26,3697,0,26,33,3730
"Rwanda","2024-10-29",0,0,26,3697,0,26,32,3762
"Rwanda","2024-10-30",0,0,26,3697,0,26,33,3795
"Rwanda","2024-10-31",0,0,26,3697,0,26,32,3827
"Rwanda","2024-11-01",0,0,26,3697,0,26,33,3860
"Rwanda","2024-11-02",0,0,26,3697,0,26,32,3892
"Rwanda","2024-11-03",228,0,26,3925,0,26,33,3925
"Rwanda","2024-11-04",0,0,26,3925,0,26,22,3947
"Rwanda","2024-11-05",0,0,26,3925,0,26,22,3969
"Rwanda","2024-11-06",0,0,26,3925,0,26,22,3991
"Rwanda","2024-11-07",0,0,26,3925,0,26,21,4012
"Rwanda","2024-11-08",0,0,26,3925,0,26,22,4034
"Rwanda","2024-11-09",0,0,26,3925,0,26,22,4056
"Rwanda","2024-11-10",153,0,26,4078,0,26,22,4078
"Rwanda","2024-11-11",0,0,26,4078,0,26,0,4078
"Rwanda","2024-11-12",0,0,26,4078,0,26,0,4078
"Rwanda","2024-11-13",0,0,26,4078,0,26,0,4078
"Rwanda","2024-11-14",0,0,26,4078,0,26,0,4078
"Rwanda","2024-11-15",0,0,26,4078,0,26,0,4078
"Rwanda","2024-11-16",0,0,26,4078,0,26,0,4078
"Rwanda","2024-11-17",0,0,26,4078,0,26,0,4078
"Rwanda","2024-11-18",0,0,26,4078,0,26,0,4078
"Rwanda","2024-11-19",0,0,26,4078,0,26,0,4078
"Rwanda","2024-11-20",0,0,26,4078,0,26,0,4078
"Rwanda","2024-11-21",0,0,26,4078,0,26,0,4078
"Rwanda","2024-11-22",0,0,26,4078,0,26,0,4078
"Rwanda","2024-11-23",0,0,26,4078,0,26,0,4078
"Rwanda","2024-11-24",0,0,26,4078,0,26,0,4078
"Rwanda","2024-11-25",0,0,26,4078,0,26,0,4078
"Rwanda","2024-11-26",0,0,26,4078,0,26,0,4078
"Rwanda","2024-11-27",0,0,26,4078,0,26,0,4078
"Rwanda","2024-11-28",0,0,26,4078,0,26,0,4078
"Rwanda","2024-11-29",0,0,26,4078,0,26,0,4078
"Rwanda","2024-11-30",0,0,26,4078,0,26,0,4078
"Rwanda","2024-12-01",0,0,26,4078,0,26,0,4078
"Rwanda","2024-12-02",0,0,26,4078,0,26,0,4078
"Rwanda","2024-12-03",0,0,26,4078,0,26,0,4078
"Rwanda","2024-12-04",0,0,26,4078,0,26,0,4078
"Rwanda","2024-12-05",0,0,26,4078,0,26,0,4078
"Rwanda","2024-12-06",0,0,26,4078,0,26,0,4078
"Rwanda","2024-12-07",0,0,26,4078,0,26,0,4078
"Rwanda","2024-12-08",0,0,26,4078,0,26,0,4078
"Rwanda","2024-12-09",0,0,26,4078,0,26,0,4078
"Saint Martin (French Part)","2024-01-01",0,0,0,0,0,0,0,0
"Saint Martin (French Part)","2024-01-02",0,0,0,0,0,0,0,0
"Saint Martin (French Part)","2024-01-03",0,0,0,0,0,0,0,0
"Saint Martin (French Part)","2024-01-04",0,0,0,0,0,0,0,0
"Saint Martin (French Part)","2024-01-05",0,0,0,0,0,0,0,0
"Saint Martin (French Part)","2024-01-06",0,0,0,0,0,0,0,0
"Saint Martin (French Part)","2024-01-07",0,0,0,0,0,0,0,0
"Saint Martin (French Part)","2024-01-08",0,0,0,0,0,0,0,0
"Saint Martin (French Part)","2024-01-09",0,0,0,0,0,0,0,0
"Saint Martin (French Part)","2024-01-10",0,0,0,0,0,0,0,0
"Saint Martin (French Part)","2024-01-11",0,0,0,0,0,0,0,0
"Saint Martin (French Part)","2024-01-12",0,0,0,0,0,0,0,0
"Saint Martin (French Part)","2024-01-13",0,0,0,0,0,0,0,0
"Saint Martin (French Part)","2024-01-14",0,0,0,0,0,0,0,0
"Saint Martin (French Part)","2024-01-15",0,0,0,0,0,0,0,0
"Saint Martin (French Part)","2024-01-16",0,0,0,0,0,0,0,0
"Saint Martin (French Part)","2024-01-17",0,0,0,0,0,0,0,0
"Saint Martin (French Part)","2024-01-18",0,0,0,0,0,0,0,0
"Saint Martin (French Part)","2024-01-19",0,0,0,0,0,0,0,0
"Saint Martin (French Part)","2024-01-20",0,0,0,0,0,0,0,0
"Saint Martin (French Part)","2024-01-21",0,0,0,0,0,0,0,0
"Saint Martin (French Part)","2024-01-22",0,0,0,0,0,0,0,0
"Saint Martin (French Part)","2024-01-23",0,0,0,0,0,0,0,0
"Saint Martin (French Part)","2024-01-24",0,0,0,0,0,0,0,0
"Saint Martin (French Part)","2024-01-25",0,0,0,0,0,0,0,0
"Saint Martin (French Part)","2024-01-26",0,0,0,0,0,0,0,0
"Saint Martin (French Part)","2024-01-27",0,0,0,0,0,0,0,0
"Saint Martin (French Part)","2024-01-28",0,0,0,0,0,0,0,0
"Saint Martin (French Part)","2024-01-29",0,0,0,0,0,0,0,0
"Saint Martin (French Part)","2024-01-30",0,0,0,0,0,0,0,0
"Saint Martin (French Part)","2024-01-31",0,0,0,0,0,0,0,0
"Saint Martin (French Part)","2024-02-01",0,0,0,0,0,0,0,0
"Saint Martin (French Part)","2024-02-02",0,0,0,0,0,0,0,0
"Saint Martin (French Part)","2024-02-03",0,0,0,0,0,0,0,0
"Saint Martin (French Part)","2024-02-04",0,0,0,0,0,0,0,0
"Saint Martin (French Part)","2024-02-05",0,0,0,0,0,0,0,0
"Saint Martin (French Part)","2024-02-06",0,0,0,0,0,0,0,0
"Saint Martin (French Part)","2024-02-07",0,0,0,0,0,0,0,0
"Saint Martin (French Part)","2024-02-08",0,0,0,0,0,0,0,0
"Saint Martin (French Part)","2024-02-09",0,0,0,0,0,0,0,0
"Saint Martin (French Part)","2024-02-10",0,0,0,0,0,0,0,0
"Saint Martin (French Part)","2024-02-11",0,0,0,0,0,0,0,0
"Saint Martin (French Part)","2024-02-12",0,0,0,0,0,0,0,0
"Saint Martin (French Part)","2024-02-13",0,0,0,0,0,0,0,0
"Saint Martin (French Part)","2024-02-14",0,0,0,0,0,0,0,0
"Saint Martin (French Part)","2024-02-15",0,0,0,0,0,0,0,0
"Saint Martin (French Part)","2024-02-16",0,0,0,0,0,0,0,0
"Saint Martin (French Part)","2024-02-17",0,0,0,0,0,0,0,0
"Saint Martin (French Part)","2024-02-18",0,0,0,0,0,0,0,0
"Saint Martin (French Part)","2024-02-19",0,0,0,0,0,0,0,0
"Saint Martin (French Part)","2024-02-20",0,0,0,0,0,0,0,0
"Saint Martin (French Part)","2024-02-21",0,0,0,0,0,0,0,0
"Saint Martin (French Part)","2024-02-22",0,0,0,0,0,0,0,0
"Saint Martin (French Part)","2024-02-23",0,0,0,0,0,0,0,0
"Saint Martin (French Part)","2024-02-24",0,0,0,0,0,0,0,0
"Saint Martin (French Part)","2024-02-25",0,0,0,0,0,0,0,0
"Saint Martin (French Part)","2024-02-26",0,0,0,0,0,0,0,0
"Saint Martin (French Part)","2024-02-27",0,0,0,0,0,0,0,0
"Saint Martin (French Part)","2024-02-28",0,0,0,0,0,0,0,0
"Saint Martin (French Part)","2024-02-29",0,0,0,0,0,0,0,0
"Saint Martin (French Part)","2024-03-01",0,0,0,0,0,0,0,0
"Saint Martin (French Part)","2024-03-02",0,0,0,0,0,0,0,0
"Saint Martin (French Part)","2024-03-03",0,0,0,0,0,0,0,0
"Saint Martin (French Part)","2024-03-04",0,0,0,0,0,0,0,0
"Saint Martin (French Part)","2024-03-05",0,0,0,0,0,0,0,0
"Saint Martin (French Part)","2024-03-06",0,0,0,0,0,0,0,0
"Saint Martin (French Part)","2024-03-07",0,0,0,0,0,0,0,0
"Saint Martin (French Part)","2024-03-08",0,0,0,0,0,0,0,0
"Saint Martin (French Part)","2024-03-09",0,0,0,0,0,0,0,0
"Saint Martin (French Part)","2024-03-10",0,0,0,0,0,0,0,0
"Saint Martin (French Part)","2024-03-11",0,0,0,0,0,0,0,0
"Saint Martin (French Part)","2024-03-12",0,0,0,0,0,0,0,0
"Saint Martin (French Part)","2024-03-13",0,0,0,0,0,0,0,0
"Saint Martin (French Part)","2024-03-14",0,0,0,0,0,0,0,0
"Saint Martin (French Part)","2024-03-15",0,0,0,0,0,0,0,0
"Saint Martin (French Part)","2024-03-16",0,0,0,0,0,0,0,0
"Saint Martin (French Part)","2024-03-17",0,0,0,0,0,0,0,0
"Saint Martin (French Part)","2024-03-18",0,0,0,0,0,0,0,0
"Saint Martin (French Part)","2024-03-19",0,0,0,0,0,0,0,0
"Saint Martin (French Part)","2024-03-20",0,0,0,0,0,0,0,0
"Saint Martin (French Part)","2024-03-21",0,0,0,0,0,0,0,0
"Saint Martin (French Part)","2024-03-22",0,0,0,0,0,0,0,0
"Saint Martin (French Part)","2024-03-23",0,0,0,0,0,0,0,0
"Saint Martin (French Part)","2024-03-24",0,0,0,0,0,0,0,0
"Saint Martin (French Part)","2024-03-25",0,0,0,0,0,0,0,0
"Saint Martin (French Part)","2024-03-26",0,0,0,0,0,0,0,0
"Saint Martin (French Part)","2024-03-27",0,0,0,0,0,0,0,0
"Saint Martin (French Part)","2024-03-28",0,0,0,0,0,0,0,0
"Saint Martin (French Part)","2024-03-29",0,0,0,0,0,0,0,0
"Saint Martin (French Part)","2024-03-30",0,0,0,0,0,0,0,0
"Saint Martin (French Part)","2024-03-31",0,0,0,0,0,0,0,0
"Saint Martin (French Part)","2024-04-01",0,0,0,0,0,0,0,0
"Saint Martin (French Part)","2024-04-02",0,0,0,0,0,0,0,0
"Saint Martin (French Part)","2024-04-03",0,0,0,0,0,0,0,0
"Saint Martin (French Part)","2024-04-04",0,0,0,0,0,0,0,0
"Saint Martin (French Part)","2024-04-05",0,0,0,0,0,0,0,0
"Saint Martin (French Part)","2024-04-06",0,0,0,0,0,0,0,0
"Saint Martin (French Part)","2024-04-07",0,0,0,0,0,0,0,0
"Saint Martin (French Part)","2024-04-08",0,0,0,0,0,0,0,0
"Saint Martin (French Part)","2024-04-09",0,0,0,0,0,0,0,0
"Saint Martin (French Part)","2024-04-10",0,0,0,0,0,0,0,0
"Saint Martin (French Part)","2024-04-11",0,0,0,0,0,0,0,0
"Saint Martin (French Part)","2024-04-12",0,0,0,0,0,0,0,0
"Saint Martin (French Part)","2024-04-13",0,0,0,0,0,0,0,0
"Saint Martin (French Part)","2024-04-14",0,0,0,0,0,0,0,0
"Saint Martin (French Part)","2024-04-15",0,0,0,0,0,0,0,0
"Saint Martin (French Part)","2024-04-16",0,0,0,0,0,0,0,0
"Saint Martin (French Part)","2024-04-17",0,0,0,0,0,0,0,0
"Saint Martin (French Part)","2024-04-18",0,0,0,0,0,0,0,0
"Saint Martin (French Part)","2024-04-19",0,0,0,0,0,0,0,0
"Saint Martin (French Part)","2024-04-20",0,0,0,0,0,0,0,0
"Saint Martin (French Part)","2024-04-21",0,0,0,0,0,0,0,0
"Saint Martin (French Part)","2024-04-22",0,0,0,0,0,0,0,0
"Saint Martin (French Part)","2024-04-23",0,0,0,0,0,0,0,0
"Saint Martin (French Part)","2024-04-24",0,0,0,0,0,0,0,0
"Saint Martin (French Part)","2024-04-25",0,0,0,0,0,0,0,0
"Saint Martin (French Part)","2024-04-26",0,0,0,0,0,0,0,0
"Saint Martin (French Part)","2024-04-27",0,0,0,0,0,0,0,0
"Saint Martin (French Part)","2024-04-28",0,0,0,0,0,0,0,0
"Saint Martin (French Part)","2024-04-29",0,0,0,0,0,0,0,0
"Saint Martin (French Part)","2024-04-30",0,0,0,0,0,0,0,0
"Saint Martin (French Part)","2024-05-01",0,0,0,0,0,0,0,0
"Saint Martin (French Part)","2024-05-02",0,0,0,0,0,0,0,0
"Saint Martin (French Part)","2024-05-03",0,0,0,0,0,0,0,0
"Saint Martin (French Part)","2024-05-04",0,0,0,0,0,0,0,0
"Saint Martin (French Part)","2024-05-05",0,0,0,0,0,0,0,0
"Saint Martin (French Part)","2024-05-06",0,0,0,0,0,0,0,0
"Saint Martin (French Part)","2024-05-07",0,0,0,0,0,0,0,0
"Saint Martin (French Part)","2024-05-08",0,0,0,0,0,0,0,0
"Saint Martin (French Part)","2024-05-09",0,0,0,0,0,0,0,0
"Saint Martin (French Part)","2024-05-10",0,0,0,0,0,0,0,0
"Saint Martin (French Part)","2024-05-11",0,0,0,0,0,0,0,0
"Saint Martin (French Part)","2024-05-12",0,0,0,0,0,0,0,0
"Saint Martin (French Part)","2024-05-13",0,0,0,0,0,0,0,0
"Saint Martin (French Part)","2024-05-14",0,0,0,0,0,0,0,0
"Saint Martin (French Part)","2024-05-15",0,0,0,0,0,0,0,0
"Saint Martin (French Part)","2024-05-16",0,0,0,0,0,0,0,0
"Saint Martin (French Part)","2024-05-17",0,0,0,0,0,0,0,0
"Saint Martin (French Part)","2024-05-18",0,0,0,0,0,0,0,0
"Saint Martin (French Part)","2024-05-19",0,0,0,0,0,0,0,0
"Saint Martin (French Part)","2024-05-20",0,0,0,0,0,0,0,0
"Saint Martin (French Part)","2024-05-21",0,0,0,0,0,0,0,0
"Saint Martin (French Part)","2024-05-22",0,0,0,0,0,0,0,0
"Saint Martin (French Part)","2024-05-23",0,0,0,0,0,0,0,0
"Saint Martin (French Part)","2024-05-24",0,0,0,0,0,0,0,0
"Saint Martin (French Part)","2024-05-25",0,0,0,0,0,0,0,0
"Saint Martin (French Part)","2024-05-26",0,0,0,0,0,0,0,0
"Saint Martin (French Part)","2024-05-27",0,0,0,0,0,0,0,0
"Saint Martin (French Part)","2024-05-28",0,0,0,0,0,0,0,0
"Saint Martin (French Part)","2024-05-29",0,0,0,0,0,0,0,0
"Saint Martin (French Part)","2024-05-30",0,0,0,0,0,0,0,0
"Saint Martin (French Part)","2024-05-31",0,0,0,0,0,0,0,0
"Saint Martin (French Part)","2024-06-01",0,0,0,0,0,0,0,0
"Saint Martin (French Part)","2024-06-02",0,0,0,0,0,0,0,0
"Saint Martin (French Part)","2024-06-03",0,0,0,0,0,0,0,0
"Saint Martin (French Part)","2024-06-04",0,0,0,0,0,0,0,0
"Saint Martin (French Part)","2024-06-05",0,0,0,0,0,0,0,0
"Saint Martin (French Part)","2024-06-06",0,0,0,0,0,0,0,0
"Saint Martin (French Part)","2024-06-07",0,0,0,0,0,0,0,0
"Saint Martin (French Part)","2024-06-08",0,0,0,0,0,0,0,0
"Saint Martin (French Part)","2024-06-09",0,0,0,0,0,0,0,0
"Saint Martin (French Part)","2024-06-10",0,0,0,0,0,0,0,0
"Saint Martin (French Part)","2024-06-11",0,0,0,0,0,0,0,0
"Saint Martin (French Part)","2024-06-12",0,0,0,0,0,0,0,0
"Saint Martin (French Part)","2024-06-13",0,0,0,0,0,0,0,0
"Saint Martin (French Part)","2024-06-14",0,0,0,0,0,0,0,0
"Saint Martin (French Part)","2024-06-15",0,0,0,0,0,0,0,0
"Saint Martin (French Part)","2024-06-16",0,0,0,0,0,0,0,0
"Saint Martin (French Part)","2024-06-17",0,0,0,0,0,0,0,0
"Saint Martin (French Part)","2024-06-18",0,0,0,0,0,0,0,0
"Saint Martin (French Part)","2024-06-19",0,0,0,0,0,0,0,0
"Saint Martin (French Part)","2024-06-20",0,0,0,0,0,0,0,0
"Saint Martin (French Part)","2024-06-21",0,0,0,0,0,0,0,0
"Saint Martin (French Part)","2024-06-22",0,0,0,0,0,0,0,0
"Saint Martin (French Part)","2024-06-23",0,0,0,0,0,0,0,0
"Saint Martin (French Part)","2024-06-24",0,0,0,0,0,0,0,0
"Saint Martin (French Part)","2024-06-25",0,0,0,0,0,0,0,0
"Saint Martin (French Part)","2024-06-26",0,0,0,0,0,0,0,0
"Saint Martin (French Part)","2024-06-27",0,0,0,0,0,0,0,0
"Saint Martin (French Part)","2024-06-28",0,0,0,0,0,0,0,0
"Saint Martin (French Part)","2024-06-29",0,0,0,0,0,0,0,0
"Saint Martin (French Part)","2024-06-30",0,0,0,0,0,0,0,0
"Saint Martin (French Part)","2024-07-01",0,0,0,0,0,0,0,0
"Saint Martin (French Part)","2024-07-02",0,0,0,0,0,0,0,0
"Saint Martin (French Part)","2024-07-03",0,0,0,0,0,0,0,0
"Saint Martin (French Part)","2024-07-04",0,0,0,0,0,0,0,0
"Saint Martin (French Part)","2024-07-05",0,0,0,0,0,0,0,0
"Saint Martin (French Part)","2024-07-06",0,0,0,0,0,0,0,0
"Saint Martin (French Part)","2024-07-07",0,0,0,0,0,0,0,0
"Saint Martin (French Part)","2024-07-08",0,0,0,0,0,0,0,0
"Saint Martin (French Part)","2024-07-09",0,0,0,0,0,0,0,0
"Saint Martin (French Part)","2024-07-10",0,0,0,0,0,0,0,0
"Saint Martin (French Part)","2024-07-11",0,0,0,0,0,0,0,0
"Saint Martin (French Part)","2024-07-12",0,0,0,0,0,0,0,0
"Saint Martin (French Part)","2024-07-13",0,0,0,0,0,0,0,0
"Saint Martin (French Part)","2024-07-14",0,0,0,0,0,0,0,0
"Saint Martin (French Part)","2024-07-15",0,0,0,0,0,0,0,0
"Saint Martin (French Part)","2024-07-16",0,0,0,0,0,0,0,0
"Saint Martin (French Part)","2024-07-17",0,0,0,0,0,0,0,0
"Saint Martin (French Part)","2024-07-18",0,0,0,0,0,0,0,0
"Saint Martin (French Part)","2024-07-19",0,0,0,0,0,0,0,0
"Saint Martin (French Part)","2024-07-20",0,0,0,0,0,0,0,0
"Saint Martin (French Part)","2024-07-21",0,0,0,0,0,0,0,0
"Saint Martin (French Part)","2024-07-22",0,0,0,0,0,0,0,0
"Saint Martin (French Part)","2024-07-23",0,0,0,0,0,0,0,0
"Saint Martin (French Part)","2024-07-24",0,0,0,0,0,0,0,0
"Saint Martin (French Part)","2024-07-25",0,0,0,0,0,0,0,0
"Saint Martin (French Part)","2024-07-26",0,0,0,0,0,0,0,0
"Saint Martin (French Part)","2024-07-27",0,0,0,0,0,0,0,0
"Saint Martin (French Part)","2024-07-28",0,0,0,0,0,0,0,0
"Saint Martin (French Part)","2024-07-29",0,0,0,0,0,0,0,0
"Saint Martin (French Part)","2024-07-30",0,0,0,0,0,0,0,0
"Saint Martin (French Part)","2024-07-31",0,0,0,0,0,0,0,0
"Saint Martin (French Part)","2024-08-01",0,0,0,0,0,0,0,0
"Saint Martin (French Part)","2024-08-02",0,0,0,0,0,0,0,0
"Saint Martin (French Part)","2024-08-03",0,0,0,0,0,0,0,0
"Saint Martin (French Part)","2024-08-04",0,0,0,0,0,0,0,0
"Saint Martin (French Part)","2024-08-05",0,0,0,0,0,0,0,0
"Saint Martin (French Part)","2024-08-06",0,0,0,0,0,0,0,0
"Saint Martin (French Part)","2024-08-07",0,0,0,0,0,0,0,0
"Saint Martin (French Part)","2024-08-08",0,0,0,0,0,0,0,0
"Saint Martin (French Part)","2024-08-09",0,0,0,0,0,0,0,0
"Saint Martin (French Part)","2024-08-10",0,0,0,0,0,0,0,0
"Saint Martin (French Part)","2024-08-11",0,0,0,0,0,0,0,0
"Saint Martin (French Part)","2024-08-12",0,0,0,0,0,0,0,0
"Saint Martin (French Part)","2024-08-13",0,0,0,0,0,0,0,0
"Saint Martin (French Part)","2024-08-14",0,0,0,0,0,0,0,0
"Saint Martin (French Part)","2024-08-15",0,0,0,0,0,0,0,0
"Saint Martin (French Part)","2024-08-16",0,0,0,0,0,0,0,0
"Saint Martin (French Part)","2024-08-17",0,0,0,0,0,0,0,0
"Saint Martin (French Part)","2024-08-18",0,0,0,0,0,0,0,0
"Saint Martin (French Part)","2024-08-19",0,0,0,0,0,0,0,0
"Saint Martin (French Part)","2024-08-20",0,0,0,0,0,0,0,0
"Saint Martin (French Part)","2024-08-21",0,0,0,0,0,0,0,0
"Saint Martin (French Part)","2024-08-22",0,0,0,0,0,0,0,0
"Saint Martin (French Part)","2024-08-23",0,0,0,0,0,0,0,0
"Saint Martin (French Part)","2024-08-24",0,0,0,0,0,0,0,0
"Saint Martin (French Part)","2024-08-25",0,0,0,0,0,0,0,0
"Saint Martin (French Part)","2024-08-26",0,0,0,0,0,0,0,0
"Saint Martin (French Part)","2024-08-27",0,0,0,0,0,0,0,0
"Saint Martin (French Part)","2024-08-28",0,0,0,0,0,0,0,0
"Saint Martin (French Part)","2024-08-29",0,0,0,0,0,0,0,0
"Saint Martin (French Part)","2024-08-30",0,0,0,0,0,0,0,0
"Saint Martin (French Part)","2024-08-31",0,0,0,0,0,0,0,0
"Saint Martin (French Part)","2024-09-01",0,0,0,0,0,0,0,0
"Saint Martin (French Part)","2024-09-02",0,0,0,0,0,0,0,0
"Saint Martin (French Part)","2024-09-03",0,0,0,0,0,0,0,0
"Saint Martin (French Part)","2024-09-04",0,0,0,0,0,0,0,0
"Saint Martin (French Part)","2024-09-05",0,0,0,0,0,0,0,0
"Saint Martin (French Part)","2024-09-06",0,0,0,0,0,0,0,0
"Saint Martin (French Part)","2024-09-07",0,0,0,0,0,0,0,0
"Saint Martin (French Part)","2024-09-08",0,0,0,0,0,0,0,0
"Saint Martin (French Part)","2024-09-09",0,0,0,0,0,0,0,0
"Saint Martin (French Part)","2024-09-10",0,0,0,0,0,0,0,0
"Saint Martin (French Part)","2024-09-11",0,0,0,0,0,0,0,0
"Saint Martin (French Part)","2024-09-12",0,0,0,0,0,0,0,0
"Saint Martin (French Part)","2024-09-13",0,0,0,0,0,0,0,0
"Saint Martin (French Part)","2024-09-14",0,0,0,0,0,0,0,0
"Saint Martin (French Part)","2024-09-15",0,0,0,0,0,0,0,0
"Saint Martin (French Part)","2024-09-16",0,0,0,0,0,0,0,0
"Saint Martin (French Part)","2024-09-17",0,0,0,0,0,0,0,0
"Saint Martin (French Part)","2024-09-18",0,0,0,0,0,0,0,0
"Saint Martin (French Part)","2024-09-19",0,0,0,0,0,0,0,0
"Saint Martin (French Part)","2024-09-20",0,0,0,0,0,0,0,0
"Saint Martin (French Part)","2024-09-21",0,0,0,0,0,0,0,0
"Saint Martin (French Part)","2024-09-22",0,0,0,0,0,0,0,0
"Saint Martin (French Part)","2024-09-23",0,0,0,0,0,0,0,0
"Saint Martin (French Part)","2024-09-24",0,0,0,0,0,0,0,0
"Saint Martin (French Part)","2024-09-25",0,0,0,0,0,0,0,0
"Saint Martin (French Part)","2024-09-26",0,0,0,0,0,0,0,0
"Saint Martin (French Part)","2024-09-27",0,0,0,0,0,0,0,0
"Saint Martin (French Part)","2024-09-28",0,0,0,0,0,0,0,0
"Saint Martin (French Part)","2024-09-29",0,0,0,0,0,0,0,0
"Saint Martin (French Part)","2024-09-30",0,0,0,0,0,0,0,0
"Saint Martin (French Part)","2024-10-01",0,0,0,0,0,0,0,0
"Saint Martin (French Part)","2024-10-02",0,0,0,0,0,0,0,0
"Saint Martin (French Part)","2024-10-03",0,0,0,0,0,0,0,0
"Saint Martin (French Part)","2024-10-04",0,0,0,0,0,0,0,0
"Saint Martin (French Part)","2024-10-05",0,0,0,0,0,0,0,0
"Saint Martin (French Part)","2024-10-06",0,0,0,0,0,0,0,0
"Saint Martin (French Part)","2024-10-07",0,0,0,0,0,0,0,0
"Saint Martin (French Part)","2024-10-08",0,0,0,0,0,0,0,0
"Saint Martin (French Part)","2024-10-09",0,0,0,0,0,0,0,0
"Saint Martin (French Part)","2024-10-10",0,0,0,0,0,0,0,0
"Saint Martin (French Part)","2024-10-11",0,0,0,0,0,0,0,0
"Saint Martin (French Part)","2024-10-12",0,0,0,0,0,0,0,0
"Saint Martin (French Part)","2024-10-13",0,0,0,0,0,0,0,0
"Saint Martin (French Part)","2024-10-14",0,0,0,0,0,0,0,0
"Saint Martin (French Part)","2024-10-15",0,0,0,0,0,0,0,0
"Saint Martin (French Part)","2024-10-16",0,0,0,0,0,0,0,0
"Saint Martin (French Part)","2024-10-17",0,0,0,0,0,0,0,0
"Saint Martin (French Part)","2024-10-18",0,0,0,0,0,0,0,0
"Saint Martin (French Part)","2024-10-19",0,0,0,0,0,0,0,0
"Saint Martin (French Part)","2024-10-20",0,0,0,0,0,0,0,0
"Saint Martin (French Part)","2024-10-21",0,0,0,0,0,0,0,0
"Saint Martin (French Part)","2024-10-22",0,0,0,0,0,0,0,0
"Saint Martin (French Part)","2024-10-23",0,0,0,0,0,0,0,0
"Saint Martin (French Part)","2024-10-24",0,0,0,0,0,0,0,0
"Saint Martin (French Part)","2024-10-25",0,0,0,0,0,0,0,0
"Saint Martin (French Part)","2024-10-26",0,0,0,0,0,0,0,0
"Saint Martin (French Part)","2024-10-27",0,0,0,0,0,0,0,0
"Saint Martin (French Part)","2024-10-28",0,0,0,0,0,0,0,0
"Saint Martin (French Part)","2024-10-29",0,0,0,0,0,0,0,0
"Saint Martin (French Part)","2024-10-30",0,0,0,0,0,0,0,0
"Saint Martin (French Part)","2024-10-31",0,0,0,0,0,0,0,0
"Saint Martin (French Part)","2024-11-01",0,0,0,0,0,0,0,0
"Saint Martin (French Part)","2024-11-02",0,0,0,0,0,0,0,0
"Saint Martin (French Part)","2024-11-03",0,0,0,0,0,0,0,0
"Saint Martin (French Part)","2024-11-04",0,0,0,0,0,0,0,0
"Saint Martin (French Part)","2024-11-05",0,0,0,0,0,0,0,0
"Saint Martin (French Part)","2024-11-06",0,0,0,0,0,0,0,0
"Saint Martin (French Part)","2024-11-07",0,0,0,0,0,0,0,0
"Saint Martin (French Part)","2024-11-08",0,0,0,0,0,0,0,0
"Saint Martin (French Part)","2024-11-09",0,0,0,0,0,0,0,0
"Saint Martin (French Part)","2024-11-10",0,0,0,0,0,0,0,0
"Saint Martin (French Part)","2024-11-11",0,0,0,0,0,0,0,0
"Saint Martin (French Part)","2024-11-12",0,0,0,0,0,0,0,0
"Saint Martin (French Part)","2024-11-13",0,0,0,0,0,0,0,0
"Saint Martin (French Part)","2024-11-14",0,0,0,0,0,0,0,0
"Saint Martin (French Part)","2024-11-15",0,0,0,0,0,0,0,0
"Saint Martin (French Part)","2024-11-16",0,0,0,0,0,0,0,0
"Saint Martin (French Part)","2024-11-17",0,0,0,0,0,0,0,0
"Saint Martin (French Part)","2024-11-18",0,0,0,0,0,0,0,0
"Saint Martin (French Part)","2024-11-19",0,0,0,0,0,0,0,0
"Saint Martin (French Part)","2024-11-20",0,0,0,0,0,0,0,0
"Saint Martin (French Part)","2024-11-21",0,0,0,0,0,0,0,0
"Saint Martin (French Part)","2024-11-22",0,0,0,0,0,0,0,0
"Saint Martin (French Part)","2024-11-23",0,0,0,0,0,0,0,0
"Saint Martin (French Part)","2024-11-24",0,0,0,0,0,0,0,0
"Saint Martin (French Part)","2024-11-25",0,0,0,0,0,0,0,0
"Saint Martin (French Part)","2024-11-26",0,0,0,0,0,0,0,0
"Saint Martin (French Part)","2024-11-27",0,0,0,0,0,0,0,0
"Saint Martin (French Part)","2024-11-28",0,0,0,0,0,0,0,0
"Saint Martin (French Part)","2024-11-29",0,0,0,0,0,0,0,0
"Saint Martin (French Part)","2024-11-30",0,0,0,0,0,0,0,0
"Saint Martin (French Part)","2024-12-01",0,0,0,0,0,0,0,0
"Saint Martin (French Part)","2024-12-02",0,0,0,0,0,0,0,0
"Saint Martin (French Part)","2024-12-03",0,0,0,0,0,0,0,0
"Saint Martin (French Part)","2024-12-04",0,0,0,0,0,0,0,0
"Saint Martin (French Part)","2024-12-05",0,0,0,0,0,0,0,0
"Saint Martin (French Part)","2024-12-06",0,0,0,0,0,0,0,0
"Saint Martin (French Part)","2024-12-07",0,0,0,0,0,0,0,0
"Saint Martin (French Part)","2024-12-08",0,0,0,0,0,0,0,0
"Saint Martin (French Part)","2024-12-09",0,0,0,0,0,0,0,0
"San Marino","2024-01-01",0,0,0,0,0,0,0,0
"San Marino","2024-01-02",0,0,0,0,0,0,0,0
"San Marino","2024-01-03",0,0,0,0,0,0,0,0
"San Marino","2024-01-04",0,0,0,0,0,0,0,0
"San Marino","2024-01-05",0,0,0,0,0,0,0,0
"San Marino","2024-01-06",0,0,0,0,0,0,0,0
"San Marino","2024-01-07",0,0,0,0,0,0,0,0
"San Marino","2024-01-08",0,0,0,0,0,0,0,0
"San Marino","2024-01-09",0,0,0,0,0,0,0,0
"San Marino","2024-01-10",0,0,0,0,0,0,0,0
"San Marino","2024-01-11",0,0,0,0,0,0,0,0
"San Marino","2024-01-12",0,0,0,0,0,0,0,0
"San Marino","2024-01-13",0,0,0,0,0,0,0,0
"San Marino","2024-01-14",0,0,0,0,0,0,0,0
"San Marino","2024-01-15",0,0,0,0,0,0,0,0
"San Marino","2024-01-16",0,0,0,0,0,0,0,0
"San Marino","2024-01-17",0,0,0,0,0,0,0,0
"San Marino","2024-01-18",0,0,0,0,0,0,0,0
"San Marino","2024-01-19",0,0,0,0,0,0,0,0
"San Marino","2024-01-20",0,0,0,0,0,0,0,0
"San Marino","2024-01-21",0,0,0,0,0,0,0,0
"San Marino","2024-01-22",0,0,0,0,0,0,0,0
"San Marino","2024-01-23",0,0,0,0,0,0,0,0
"San Marino","2024-01-24",0,0,0,0,0,0,0,0
"San Marino","2024-01-25",0,0,0,0,0,0,0,0
"San Marino","2024-01-26",0,0,0,0,0,0,0,0
"San Marino","2024-01-27",0,0,0,0,0,0,0,0
"San Marino","2024-01-28",0,0,0,0,0,0,0,0
"San Marino","2024-01-29",0,0,0,0,0,0,0,0
"San Marino","2024-01-30",0,0,0,0,0,0,0,0
"San Marino","2024-01-31",0,0,0,0,0,0,0,0
"San Marino","2024-02-01",0,0,0,0,0,0,0,0
"San Marino","2024-02-02",0,0,0,0,0,0,0,0
"San Marino","2024-02-03",0,0,0,0,0,0,0,0
"San Marino","2024-02-04",0,0,0,0,0,0,0,0
"San Marino","2024-02-05",0,0,0,0,0,0,0,0
"San Marino","2024-02-06",0,0,0,0,0,0,0,0
"San Marino","2024-02-07",0,0,0,0,0,0,0,0
"San Marino","2024-02-08",0,0,0,0,0,0,0,0
"San Marino","2024-02-09",0,0,0,0,0,0,0,0
"San Marino","2024-02-10",0,0,0,0,0,0,0,0
"San Marino","2024-02-11",0,0,0,0,0,0,0,0
"San Marino","2024-02-12",0,0,0,0,0,0,0,0
"San Marino","2024-02-13",0,0,0,0,0,0,0,0
"San Marino","2024-02-14",0,0,0,0,0,0,0,0
"San Marino","2024-02-15",0,0,0,0,0,0,0,0
"San Marino","2024-02-16",0,0,0,0,0,0,0,0
"San Marino","2024-02-17",0,0,0,0,0,0,0,0
"San Marino","2024-02-18",0,0,0,0,0,0,0,0
"San Marino","2024-02-19",0,0,0,0,0,0,0,0
"San Marino","2024-02-20",0,0,0,0,0,0,0,0
"San Marino","2024-02-21",0,0,0,0,0,0,0,0
"San Marino","2024-02-22",0,0,0,0,0,0,0,0
"San Marino","2024-02-23",0,0,0,0,0,0,0,0
"San Marino","2024-02-24",0,0,0,0,0,0,0,0
"San Marino","2024-02-25",0,0,0,0,0,0,0,0
"San Marino","2024-02-26",0,0,0,0,0,0,0,0
"San Marino","2024-02-27",0,0,0,0,0,0,0,0
"San Marino","2024-02-28",0,0,0,0,0,0,0,0
"San Marino","2024-02-29",0,0,0,0,0,0,0,0
"San Marino","2024-03-01",0,0,0,0,0,0,0,0
"San Marino","2024-03-02",0,0,0,0,0,0,0,0
"San Marino","2024-03-03",0,0,0,0,0,0,0,0
"San Marino","2024-03-04",0,0,0,0,0,0,0,0
"San Marino","2024-03-05",0,0,0,0,0,0,0,0
"San Marino","2024-03-06",0,0,0,0,0,0,0,0
"San Marino","2024-03-07",0,0,0,0,0,0,0,0
"San Marino","2024-03-08",0,0,0,0,0,0,0,0
"San Marino","2024-03-09",0,0,0,0,0,0,0,0
"San Marino","2024-03-10",0,0,0,0,0,0,0,0
"San Marino","2024-03-11",0,0,0,0,0,0,0,0
"San Marino","2024-03-12",0,0,0,0,0,0,0,0
"San Marino","2024-03-13",0,0,0,0,0,0,0,0
"San Marino","2024-03-14",0,0,0,0,0,0,0,0
"San Marino","2024-03-15",0,0,0,0,0,0,0,0
"San Marino","2024-03-16",0,0,0,0,0,0,0,0
"San Marino","2024-03-17",0,0,0,0,0,0,0,0
"San Marino","2024-03-18",0,0,0,0,0,0,0,0
"San Marino","2024-03-19",0,0,0,0,0,0,0,0
"San Marino","2024-03-20",0,0,0,0,0,0,0,0
"San Marino","2024-03-21",0,0,0,0,0,0,0,0
"San Marino","2024-03-22",0,0,0,0,0,0,0,0
"San Marino","2024-03-23",0,0,0,0,0,0,0,0
"San Marino","2024-03-24",0,0,0,0,0,0,0,0
"San Marino","2024-03-25",0,0,0,0,0,0,0,0
"San Marino","2024-03-26",0,0,0,0,0,0,0,0
"San Marino","2024-03-27",0,0,0,0,0,0,0,0
"San Marino","2024-03-28",0,0,0,0,0,0,0,0
"San Marino","2024-03-29",0,0,0,0,0,0,0,0
"San Marino","2024-03-30",0,0,0,0,0,0,0,0
"San Marino","2024-03-31",0,0,0,0,0,0,0,0
"San Marino","2024-04-01",0,0,0,0,0,0,0,0
"San Marino","2024-04-02",0,0,0,0,0,0,0,0
"San Marino","2024-04-03",0,0,0,0,0,0,0,0
"San Marino","2024-04-04",0,0,0,0,0,0,0,0
"San Marino","2024-04-05",0,0,0,0,0,0,0,0
"San Marino","2024-04-06",0,0,0,0,0,0,0,0
"San Marino","2024-04-07",0,0,0,0,0,0,0,0
"San Marino","2024-04-08",0,0,0,0,0,0,0,0
"San Marino","2024-04-09",0,0,0,0,0,0,0,0
"San Marino","2024-04-10",0,0,0,0,0,0,0,0
"San Marino","2024-04-11",0,0,0,0,0,0,0,0
"San Marino","2024-04-12",0,0,0,0,0,0,0,0
"San Marino","2024-04-13",0,0,0,0,0,0,0,0
"San Marino","2024-04-14",0,0,0,0,0,0,0,0
"San Marino","2024-04-15",0,0,0,0,0,0,0,0
"San Marino","2024-04-16",0,0,0,0,0,0,0,0
"San Marino","2024-04-17",0,0,0,0,0,0,0,0
"San Marino","2024-04-18",0,0,0,0,0,0,0,0
"San Marino","2024-04-19",0,0,0,0,0,0,0,0
"San Marino","2024-04-20",0,0,0,0,0,0,0,0
"San Marino","2024-04-21",0,0,0,0,0,0,0,0
"San Marino","2024-04-22",0,0,0,0,0,0,0,0
"San Marino","2024-04-23",0,0,0,0,0,0,0,0
"San Marino","2024-04-24",0,0,0,0,0,0,0,0
"San Marino","2024-04-25",0,0,0,0,0,0,0,0
"San Marino","2024-04-26",0,0,0,0,0,0,0,0
"San Marino","2024-04-27",0,0,0,0,0,0,0,0
"San Marino","2024-04-28",0,0,0,0,0,0,0,0
"San Marino","2024-04-29",0,0,0,0,0,0,0,0
"San Marino","2024-04-30",0,0,0,0,0,0,0,0
"San Marino","2024-05-01",0,0,0,0,0,0,0,0
"San Marino","2024-05-02",0,0,0,0,0,0,0,0
"San Marino","2024-05-03",0,0,0,0,0,0,0,0
"San Marino","2024-05-04",0,0,0,0,0,0,0,0
"San Marino","2024-05-05",0,0,0,0,0,0,0,0
"San Marino","2024-05-06",0,0,0,0,0,0,0,0
"San Marino","2024-05-07",0,0,0,0,0,0,0,0
"San Marino","2024-05-08",0,0,0,0,0,0,0,0
"San Marino","2024-05-09",0,0,0,0,0,0,0,0
"San Marino","2024-05-10",0,0,0,0,0,0,0,0
"San Marino","2024-05-11",0,0,0,0,0,0,0,0
"San Marino","2024-05-12",0,0,0,0,0,0,0,0
"San Marino","2024-05-13",0,0,0,0,0,0,0,0
"San Marino","2024-05-14",0,0,0,0,0,0,0,0
"San Marino","2024-05-15",0,0,0,0,0,0,0,0
"San Marino","2024-05-16",0,0,0,0,0,0,0,0
"San Marino","2024-05-17",0,0,0,0,0,0,0,0
"San Marino","2024-05-18",0,0,0,0,0,0,0,0
"San Marino","2024-05-19",0,0,0,0,0,0,0,0
"San Marino","2024-05-20",0,0,0,0,0,0,0,0
"San Marino","2024-05-21",0,0,0,0,0,0,0,0
"San Marino","2024-05-22",0,0,0,0,0,0,0,0
"San Marino","2024-05-23",0,0,0,0,0,0,0,0
"San Marino","2024-05-24",0,0,0,0,0,0,0,0
"San Marino","2024-05-25",0,0,0,0,0,0,0,0
"San Marino","2024-05-26",0,0,0,0,0,0,0,0
"San Marino","2024-05-27",0,0,0,0,0,0,0,0
"San Marino","2024-05-28",0,0,0,0,0,0,0,0
"San Marino","2024-05-29",0,0,0,0,0,0,0,0
"San Marino","2024-05-30",0,0,0,0,0,0,0,0
"San Marino","2024-05-31",0,0,0,0,0,0,0,0
"San Marino","2024-06-01",0,0,0,0,0,0,0,0
"San Marino","2024-06-02",0,0,0,0,0,0,0,0
"San Marino","2024-06-03",0,0,0,0,0,0,0,0
"San Marino","2024-06-04",0,0,0,0,0,0,0,0
"San Marino","2024-06-05",0,0,0,0,0,0,0,0
"San Marino","2024-06-06",0,0,0,0,0,0,0,0
"San Marino","2024-06-07",0,0,0,0,0,0,0,0
"San Marino","2024-06-08",0,0,0,0,0,0,0,0
"San Marino","2024-06-09",0,0,0,0,0,0,0,0
"San Marino","2024-06-10",0,0,0,0,0,0,0,0
"San Marino","2024-06-11",0,0,0,0,0,0,0,0
"San Marino","2024-06-12",0,0,0,0,0,0,0,0
"San Marino","2024-06-13",0,0,0,0,0,0,0,0
"San Marino","2024-06-14",0,0,0,0,0,0,0,0
"San Marino","2024-06-15",0,0,0,0,0,0,0,0
"San Marino","2024-06-16",0,0,0,0,0,0,0,0
"San Marino","2024-06-17",0,0,0,0,0,0,0,0
"San Marino","2024-06-18",0,0,0,0,0,0,0,0
"San Marino","2024-06-19",0,0,0,0,0,0,0,0
"San Marino","2024-06-20",0,0,0,0,0,0,0,0
"San Marino","2024-06-21",0,0,0,0,0,0,0,0
"San Marino","2024-06-22",0,0,0,0,0,0,0,0
"San Marino","2024-06-23",0,0,0,0,0,0,0,0
"San Marino","2024-06-24",0,0,0,0,0,0,0,0
"San Marino","2024-06-25",0,0,0,0,0,0,0,0
"San Marino","2024-06-26",0,0,0,0,0,0,0,0
"San Marino","2024-06-27",0,0,0,0,0,0,0,0
"San Marino","2024-06-28",0,0,0,0,0,0,0,0
"San Marino","2024-06-29",0,0,0,0,0,0,0,0
"San Marino","2024-06-30",0,0,0,0,0,0,0,0
"San Marino","2024-07-01",0,0,0,0,0,0,0,0
"San Marino","2024-07-02",0,0,0,0,0,0,0,0
"San Marino","2024-07-03",0,0,0,0,0,0,0,0
"San Marino","2024-07-04",0,0,0,0,0,0,0,0
"San Marino","2024-07-05",0,0,0,0,0,0,0,0
"San Marino","2024-07-06",0,0,0,0,0,0,0,0
"San Marino","2024-07-07",0,0,0,0,0,0,0,0
"San Marino","2024-07-08",0,0,0,0,0,0,0,0
"San Marino","2024-07-09",0,0,0,0,0,0,0,0
"San Marino","2024-07-10",0,0,0,0,0,0,0,0
"San Marino","2024-07-11",0,0,0,0,0,0,0,0
"San Marino","2024-07-12",0,0,0,0,0,0,0,0
"San Marino","2024-07-13",0,0,0,0,0,0,0,0
"San Marino","2024-07-14",0,0,0,0,0,0,0,0
"San Marino","2024-07-15",0,0,0,0,0,0,0,0
"San Marino","2024-07-16",0,0,0,0,0,0,0,0
"San Marino","2024-07-17",0,0,0,0,0,0,0,0
"San Marino","2024-07-18",0,0,0,0,0,0,0,0
"San Marino","2024-07-19",0,0,0,0,0,0,0,0
"San Marino","2024-07-20",0,0,0,0,0,0,0,0
"San Marino","2024-07-21",0,0,0,0,0,0,0,0
"San Marino","2024-07-22",0,0,0,0,0,0,0,0
"San Marino","2024-07-23",0,0,0,0,0,0,0,0
"San Marino","2024-07-24",0,0,0,0,0,0,0,0
"San Marino","2024-07-25",0,0,0,0,0,0,0,0
"San Marino","2024-07-26",0,0,0,0,0,0,0,0
"San Marino","2024-07-27",0,0,0,0,0,0,0,0
"San Marino","2024-07-28",0,0,0,0,0,0,0,0
"San Marino","2024-07-29",0,0,0,0,0,0,0,0
"San Marino","2024-07-30",0,0,0,0,0,0,0,0
"San Marino","2024-07-31",0,0,0,0,0,0,0,0
"San Marino","2024-08-01",0,0,0,0,0,0,0,0
"San Marino","2024-08-02",0,0,0,0,0,0,0,0
"San Marino","2024-08-03",0,0,0,0,0,0,0,0
"San Marino","2024-08-04",0,0,0,0,0,0,0,0
"San Marino","2024-08-05",0,0,0,0,0,0,0,0
"San Marino","2024-08-06",0,0,0,0,0,0,0,0
"San Marino","2024-08-07",0,0,0,0,0,0,0,0
"San Marino","2024-08-08",0,0,0,0,0,0,0,0
"San Marino","2024-08-09",0,0,0,0,0,0,0,0
"San Marino","2024-08-10",0,0,0,0,0,0,0,0
"San Marino","2024-08-11",0,0,0,0,0,0,0,0
"San Marino","2024-08-12",0,0,0,0,0,0,0,0
"San Marino","2024-08-13",0,0,0,0,0,0,0,0
"San Marino","2024-08-14",0,0,0,0,0,0,0,0
"San Marino","2024-08-15",0,0,0,0,0,0,0,0
"San Marino","2024-08-16",0,0,0,0,0,0,0,0
"San Marino","2024-08-17",0,0,0,0,0,0,0,0
"San Marino","2024-08-18",0,0,0,0,0,0,0,0
"San Marino","2024-08-19",0,0,0,0,0,0,0,0
"San Marino","2024-08-20",0,0,0,0,0,0,0,0
"San Marino","2024-08-21",0,0,0,0,0,0,0,0
"San Marino","2024-08-22",0,0,0,0,0,0,0,0
"San Marino","2024-08-23",0,0,0,0,0,0,0,0
"San Marino","2024-08-24",0,0,0,0,0,0,0,0
"San Marino","2024-08-25",0,0,0,0,0,0,0,0
"San Marino","2024-08-26",0,0,0,0,0,0,0,0
"San Marino","2024-08-27",0,0,0,0,0,0,0,0
"San Marino","2024-08-28",0,0,0,0,0,0,0,0
"San Marino","2024-08-29",0,0,0,0,0,0,0,0
"San Marino","2024-08-30",0,0,0,0,0,0,0,0
"San Marino","2024-08-31",0,0,0,0,0,0,0,0
"San Marino","2024-09-01",0,0,0,0,0,0,0,0
"San Marino","2024-09-02",0,0,0,0,0,0,0,0
"San Marino","2024-09-03",0,0,0,0,0,0,0,0
"San Marino","2024-09-04",0,0,0,0,0,0,0,0
"San Marino","2024-09-05",0,0,0,0,0,0,0,0
"San Marino","2024-09-06",0,0,0,0,0,0,0,0
"San Marino","2024-09-07",0,0,0,0,0,0,0,0
"San Marino","2024-09-08",0,0,0,0,0,0,0,0
"San Marino","2024-09-09",0,0,0,0,0,0,0,0
"San Marino","2024-09-10",0,0,0,0,0,0,0,0
"San Marino","2024-09-11",0,0,0,0,0,0,0,0
"San Marino","2024-09-12",0,0,0,0,0,0,0,0
"San Marino","2024-09-13",0,0,0,0,0,0,0,0
"San Marino","2024-09-14",0,0,0,0,0,0,0,0
"San Marino","2024-09-15",0,0,0,0,0,0,0,0
"San Marino","2024-09-16",0,0,0,0,0,0,0,0
"San Marino","2024-09-17",0,0,0,0,0,0,0,0
"San Marino","2024-09-18",0,0,0,0,0,0,0,0
"San Marino","2024-09-19",0,0,0,0,0,0,0,0
"San Marino","2024-09-20",0,0,0,0,0,0,0,0
"San Marino","2024-09-21",0,0,0,0,0,0,0,0
"San Marino","2024-09-22",0,0,0,0,0,0,0,0
"San Marino","2024-09-23",0,0,0,0,0,0,0,0
"San Marino","2024-09-24",0,0,0,0,0,0,0,0
"San Marino","2024-09-25",0,0,0,0,0,0,0,0
"San Marino","2024-09-26",0,0,0,0,0,0,0,0
"San Marino","2024-09-27",0,0,0,0,0,0,0,0
"San Marino","2024-09-28",0,0,0,0,0,0,0,0
"San Marino","2024-09-29",0,0,0,0,0,0,0,0
"San Marino","2024-09-30",0,0,0,0,0,0,0,0
"San Marino","2024-10-01",0,0,0,0,0,0,0,0
"San Marino","2024-10-02",0,0,0,0,0,0,0,0
"San Marino","2024-10-03",0,0,0,0,0,0,0,0
"San Marino","2024-10-04",0,0,0,0,0,0,0,0
"San Marino","2024-10-05",0,0,0,0,0,0,0,0
"San Marino","2024-10-06",0,0,0,0,0,0,0,0
"San Marino","2024-10-07",0,0,0,0,0,0,0,0
"San Marino","2024-10-08",0,0,0,0,0,0,0,0
"San Marino","2024-10-09",0,0,0,0,0,0,0,0
"San Marino","2024-10-10",0,0,0,0,0,0,0,0
"San Marino","2024-10-11",0,0,0,0,0,0,0,0
"San Marino","2024-10-12",0,0,0,0,0,0,0,0
"San Marino","2024-10-13",0,0,0,0,0,0,0,0
"San Marino","2024-10-14",0,0,0,0,0,0,0,0
"San Marino","2024-10-15",0,0,0,0,0,0,0,0
"San Marino","2024-10-16",0,0,0,0,0,0,0,0
"San Marino","2024-10-17",0,0,0,0,0,0,0,0
"San Marino","2024-10-18",0,0,0,0,0,0,0,0
"San Marino","2024-10-19",0,0,0,0,0,0,0,0
"San Marino","2024-10-20",0,0,0,0,0,0,0,0
"San Marino","2024-10-21",0,0,0,0,0,0,0,0
"San Marino","2024-10-22",0,0,0,0,0,0,0,0
"San Marino","2024-10-23",0,0,0,0,0,0,0,0
"San Marino","2024-10-24",0,0,0,0,0,0,0,0
"San Marino","2024-10-25",0,0,0,0,0,0,0,0
"San Marino","2024-10-26",0,0,0,0,0,0,0,0
"San Marino","2024-10-27",0,0,0,0,0,0,0,0
"San Marino","2024-10-28",0,0,0,0,0,0,0,0
"San Marino","2024-10-29",0,0,0,0,0,0,0,0
"San Marino","2024-10-30",0,0,0,0,0,0,0,0
"San Marino","2024-10-31",0,0,0,0,0,0,0,0
"San Marino","2024-11-01",0,0,0,0,0,0,0,0
"San Marino","2024-11-02",0,0,0,0,0,0,0,0
"San Marino","2024-11-03",0,0,0,0,0,0,0,0
"San Marino","2024-11-04",0,0,0,0,0,0,0,0
"San Marino","2024-11-05",0,0,0,0,0,0,0,0
"San Marino","2024-11-06",0,0,0,0,0,0,0,0
"San Marino","2024-11-07",0,0,0,0,0,0,0,0
"San Marino","2024-11-08",0,0,0,0,0,0,0,0
"San Marino","2024-11-09",0,0,0,0,0,0,0,0
"San Marino","2024-11-10",0,0,0,0,0,0,0,0
"San Marino","2024-11-11",0,0,0,0,0,0,0,0
"San Marino","2024-11-12",0,0,0,0,0,0,0,0
"San Marino","2024-11-13",0,0,0,0,0,0,0,0
"San Marino","2024-11-14",0,0,0,0,0,0,0,0
"San Marino","2024-11-15",0,0,0,0,0,0,0,0
"San Marino","2024-11-16",0,0,0,0,0,0,0,0
"San Marino","2024-11-17",0,0,0,0,0,0,0,0
"San Marino","2024-11-18",0,0,0,0,0,0,0,0
"San Marino","2024-11-19",0,0,0,0,0,0,0,0
"San Marino","2024-11-20",0,0,0,0,0,0,0,0
"San Marino","2024-11-21",0,0,0,0,0,0,0,0
"San Marino","2024-11-22",0,0,0,0,0,0,0,0
"San Marino","2024-11-23",0,0,0,0,0,0,0,0
"San Marino","2024-11-24",0,0,0,0,0,0,0,0
"San Marino","2024-11-25",0,0,0,0,0,0,0,0
"San Marino","2024-11-26",0,0,0,0,0,0,0,0
"San Marino","2024-11-27",0,0,0,0,0,0,0,0
"San Marino","2024-11-28",0,0,0,0,0,0,0,0
"San Marino","2024-11-29",0,0,0,0,0,0,0,0
"San Marino","2024-11-30",0,0,0,0,0,0,0,0
"San Marino","2024-12-01",0,0,0,0,0,0,0,0
"San Marino","2024-12-02",0,0,0,0,0,0,0,0
"San Marino","2024-12-03",0,0,0,0,0,0,0,0
"San Marino","2024-12-04",0,0,0,0,0,0,0,0
"San Marino","2024-12-05",0,0,0,0,0,0,0,0
"San Marino","2024-12-06",0,0,0,0,0,0,0,0
"San Marino","2024-12-07",0,0,0,0,0,0,0,0
"San Marino","2024-12-08",0,0,0,0,0,0,0,0
"San Marino","2024-12-09",0,0,0,0,0,0,0,0
"Saudi Arabia","2024-01-01",0,0,0,0,0,0,0,0
"Saudi Arabia","2024-01-02",0,0,0,0,0,0,0,0
"Saudi Arabia","2024-01-03",0,0,0,0,0,0,0,0
"Saudi Arabia","2024-01-04",0,0,0,0,0,0,0,0
"Saudi Arabia","2024-01-05",0,0,0,0,0,0,0,0
"Saudi Arabia","2024-01-06",0,0,0,0,0,0,0,0
"Saudi Arabia","2024-01-07",0,0,0,0,0,0,0,0
"Saudi Arabia","2024-01-08",0,0,0,0,0,0,0,0
"Saudi Arabia","2024-01-09",0,0,0,0,0,0,0,0
"Saudi Arabia","2024-01-10",0,0,0,0,0,0,0,0
"Saudi Arabia","2024-01-11",0,0,0,0,0,0,0,0
"Saudi Arabia","2024-01-12",0,0,0,0,0,0,0,0
"Saudi Arabia","2024-01-13",0,0,0,0,0,0,0,0
"Saudi Arabia","2024-01-14",0,0,0,0,0,0,0,0
"Saudi Arabia","2024-01-15",0,0,0,0,0,0,0,0
"Saudi Arabia","2024-01-16",0,0,0,0,0,0,0,0
"Saudi Arabia","2024-01-17",0,0,0,0,0,0,0,0
"Saudi Arabia","2024-01-18",0,0,0,0,0,0,0,0
"Saudi Arabia","2024-01-19",0,0,0,0,0,0,0,0
"Saudi Arabia","2024-01-20",0,0,0,0,0,0,0,0
"Saudi Arabia","2024-01-21",0,0,0,0,0,0,0,0
"Saudi Arabia","2024-01-22",0,0,0,0,0,0,0,0
"Saudi Arabia","2024-01-23",0,0,0,0,0,0,0,0
"Saudi Arabia","2024-01-24",0,0,0,0,0,0,0,0
"Saudi Arabia","2024-01-25",0,0,0,0,0,0,0,0
"Saudi Arabia","2024-01-26",0,0,0,0,0,0,0,0
"Saudi Arabia","2024-01-27",0,0,0,0,0,0,0,0
"Saudi Arabia","2024-01-28",0,0,0,0,0,0,0,0
"Saudi Arabia","2024-01-29",0,0,0,0,0,0,0,0
"Saudi Arabia","2024-01-30",0,0,0,0,0,0,0,0
"Saudi Arabia","2024-01-31",0,16,16,0,16,16,0,0
"Saudi Arabia","2024-02-01",0,0,16,0,1,17,0,0
"Saudi Arabia","2024-02-02",0,0,16,0,0,17,0,0
"Saudi Arabia","2024-02-03",0,0,16,0,1,18,0,0
"Saudi Arabia","2024-02-04",0,0,16,0,0,18,0,0
"Saudi Arabia","2024-02-05",0,0,16,0,1,19,0,0
"Saudi Arabia","2024-02-06",0,0,16,0,0,19,0,0
"Saudi Arabia","2024-02-07",0,0,16,0,1,20,0,0
"Saudi Arabia","2024-02-08",0,0,16,0,0,20,0,0
"Saudi Arabia","2024-02-09",0,0,16,0,1,21,0,0
"Saudi Arabia","2024-02-10",0,0,16,0,0,21,0,0
"Saudi Arabia","2024-02-11",0,0,16,0,1,22,0,0
"Saudi Arabia","2024-02-12",0,0,16,0,0,22,0,0
"Saudi Arabia","2024-02-13",0,0,16,0,1,23,0,0
"Saudi Arabia","2024-02-14",0,0,16,0,1,24,0,0
"Saudi Arabia","2024-02-15",0,0,16,0,0,24,0,0
"Saudi Arabia","2024-02-16",0,0,16,0,1,25,0,0
"Saudi Arabia","2024-02-17",0,0,16,0,0,25,0,0
"Saudi Arabia","2024-02-18",0,0,16,0,1,26,0,0
"Saudi Arabia","2024-02-19",0,0,16,0,0,26,0,0
"Saudi Arabia","2024-02-20",0,0,16,0,1,27,0,0
"Saudi Arabia","2024-02-21",0,0,16,0,0,27,0,0
"Saudi Arabia","2024-02-22",0,0,16,0,1,28,0,0
"Saudi Arabia","2024-02-23",0,0,16,0,0,28,0,0
"Saudi Arabia","2024-02-24",0,0,16,0,1,29,0,0
"Saudi Arabia","2024-02-25",0,0,16,0,0,29,0,0
"Saudi Arabia","2024-02-26",0,0,16,0,1,30,0,0
"Saudi Arabia","2024-02-27",0,0,16,0,0,30,0,0
"Saudi Arabia","2024-02-28",0,15,31,0,1,31,0,0
"Saudi Arabia","2024-02-29",0,0,31,0,1,32,0,0
"Saudi Arabia","2024-03-01",0,0,31,0,0,32,0,0
"Saudi Arabia","2024-03-02",0,0,31,0,1,33,0,0
"Saudi Arabia","2024-03-03",0,0,31,0,0,33,0,0
"Saudi Arabia","2024-03-04",0,0,31,0,1,34,0,0
"Saudi Arabia","2024-03-05",0,0,31,0,1,35,0,0
"Saudi Arabia","2024-03-06",0,0,31,0,0,35,0,0
"Saudi Arabia","2024-03-07",0,0,31,0,1,36,0,0
"Saudi Arabia","2024-03-08",0,0,31,0,1,37,0,0
"Saudi Arabia","2024-03-09",0,0,31,0,0,37,0,0
"Saudi Arabia","2024-03-10",0,0,31,0,1,38,0,0
"Saudi Arabia","2024-03-11",0,0,31,0,1,39,0,0
"Saudi Arabia","2024-03-12",0,0,31,0,0,39,0,0
"Saudi Arabia","2024-03-13",0,0,31,0,1,40,0,0
"Saudi Arabia","2024-03-14",0,0,31,0,0,40,0,0
"Saudi Arabia","2024-03-15",0,0,31,0,1,41,0,0
"Saudi Arabia","2024-03-16",0,0,31,0,1,42,0,0
"Saudi Arabia","2024-03-17",0,0,31,0,0,42,0,0
"Saudi Arabia","2024-03-18",0,0,31,0,1,43,0,0
"Saudi Arabia","2024-03-19",0,0,31,0,0,43,0,0
"Saudi Arabia","2024-03-20",0,0,31,0,1,44,0,0
"Saudi Arabia","2024-03-21",0,0,31,0,1,45,0,0
"Saudi Arabia","2024-03-22",0,0,31,0,0,45,0,0
"Saudi Arabia","2024-03-23",0,0,31,0,1,46,0,0
"Saudi Arabia","2024-03-24",0,0,31,0,1,47,0,0
"Saudi Arabia","2024-03-25",0,0,31,0,0,47,0,0
"Saudi Arabia","2024-03-26",0,0,31,0,1,48,0,0
"Saudi Arabia","2024-03-27",0,0,31,0,1,49,0,0
"Saudi Arabia","2024-03-28",0,0,31,0,0,49,0,0
"Saudi Arabia","2024-03-29",0,0,31,0,1,50,0,0
"Saudi Arabia","2024-03-30",0,0,31,0,0,50,0,0
"Saudi Arabia","2024-03-31",0,20,51,0,1,51,0,0
"Saudi Arabia","2024-04-01",0,0,51,0,0,51,0,0
"Saudi Arabia","2024-04-02",0,0,51,0,1,52,0,0
"Saudi Arabia","2024-04-03",0,0,51,0,0,52,0,0
"Saudi Arabia","2024-04-04",0,0,51,0,1,53,0,0
"Saudi Arabia","2024-04-05",0,0,51,0,0,53,0,0
"Saudi Arabia","2024-04-06",0,0,51,0,1,54,0,0
"Saudi Arabia","2024-04-07",0,0,51,0,0,54,0,0
"Saudi Arabia","2024-04-08",0,0,51,0,0,54,0,0
"Saudi Arabia","2024-04-09",0,0,51,0,1,55,0,0
"Saudi Arabia","2024-04-10",0,0,51,0,0,55,0,0
"Saudi Arabia","2024-04-11",0,0,51,0,1,56,0,0
"Saudi Arabia","2024-04-12",0,0,51,0,0,56,0,0
"Saudi Arabia","2024-04-13",0,0,51,0,1,57,0,0
"Saudi Arabia","2024-04-14",0,0,51,0,0,57,0,0
"Saudi Arabia","2024-04-15",0,0,51,0,0,57,0,0
"Saudi Arabia","2024-04-16",0,0,51,0,1,58,0,0
"Saudi Arabia","2024-04-17",0,0,51,0,0,58,0,0
"Saudi Arabia","2024-04-18",0,0,51,0,1,59,0,0
"Saudi Arabia","2024-04-19",0,0,51,0,0,59,0,0
"Saudi Arabia","2024-04-20",0,0,51,0,1,60,0,0
"Saudi Arabia","2024-04-21",0,0,51,0,0,60,0,0
"Saudi Arabia","2024-04-22",0,0,51,0,1,61,0,0
"Saudi Arabia","2024-04-23",0,0,51,0,0,61,0,0
"Saudi Arabia","2024-04-24",0,0,51,0,0,61,0,0
"Saudi Arabia","2024-04-25",0,0,51,0,1,62,0,0
"Saudi Arabia","2024-04-26",0,0,51,0,0,62,0,0
"Saudi Arabia","2024-04-27",0,0,51,0,1,63,0,0
"Saudi Arabia","2024-04-28",0,0,51,0,0,63,0,0
"Saudi Arabia","2024-04-29",0,0,51,0,1,64,0,0
"Saudi Arabia","2024-04-30",0,13,64,0,0,64,0,0
"Saudi Arabia","2024-05-01",0,0,64,0,0,64,0,0
"Saudi Arabia","2024-05-02",0,0,64,0,1,65,0,0
"Saudi Arabia","2024-05-03",0,0,64,0,0,65,0,0
"Saudi Arabia","2024-05-04",0,0,64,0,1,66,0,0
"Saudi Arabia","2024-05-05",0,0,64,0,0,66,0,0
"Saudi Arabia","2024-05-06",0,0,64,0,1,67,0,0
"Saudi Arabia","2024-05-07",0,0,64,0,0,67,0,0
"Saudi Arabia","2024-05-08",0,0,64,0,1,68,0,0
"Saudi Arabia","2024-05-09",0,0,64,0,0,68,0,0
"Saudi Arabia","2024-05-10",0,0,64,0,1,69,0,0
"Saudi Arabia","2024-05-11",0,0,64,0,0,69,0,0
"Saudi Arabia","2024-05-12",0,0,64,0,1,70,0,0
"Saudi Arabia","2024-05-13",0,0,64,0,0,70,0,0
"Saudi Arabia","2024-05-14",0,0,64,0,1,71,0,0
"Saudi Arabia","2024-05-15",0,0,64,0,0,71,0,0
"Saudi Arabia","2024-05-16",0,0,64,0,1,72,0,0
"Saudi Arabia","2024-05-17",0,0,64,0,0,72,0,0
"Saudi Arabia","2024-05-18",0,0,64,0,1,73,0,0
"Saudi Arabia","2024-05-19",0,0,64,0,0,73,0,0
"Saudi Arabia","2024-05-20",0,0,64,0,1,74,0,0
"Saudi Arabia","2024-05-21",0,0,64,0,0,74,0,0
"Saudi Arabia","2024-05-22",0,0,64,0,1,75,0,0
"Saudi Arabia","2024-05-23",0,0,64,0,0,75,0,0
"Saudi Arabia","2024-05-24",0,0,64,0,1,76,0,0
"Saudi Arabia","2024-05-25",0,0,64,0,0,76,0,0
"Saudi Arabia","2024-05-26",0,0,64,0,1,77,0,0
"Saudi Arabia","2024-05-27",0,0,64,0,0,77,0,0
"Saudi Arabia","2024-05-28",0,0,64,0,1,78,0,0
"Saudi Arabia","2024-05-29",0,0,64,0,0,78,0,0
"Saudi Arabia","2024-05-30",0,0,64,0,1,79,0,0
"Saudi Arabia","2024-05-31",0,15,79,0,0,79,0,0
"Saudi Arabia","2024-06-01",0,0,79,0,0,79,0,0
"Saudi Arabia","2024-06-02",0,0,79,0,0,79,0,0
"Saudi Arabia","2024-06-03",0,0,79,0,1,80,0,0
"Saudi Arabia","2024-06-04",0,0,79,0,0,80,0,0
"Saudi Arabia","2024-06-05",0,0,79,0,0,80,0,0
"Saudi Arabia","2024-06-06",0,0,79,0,0,80,0,0
"Saudi Arabia","2024-06-07",0,0,79,0,0,80,0,0
"Saudi Arabia","2024-06-08",0,0,79,0,1,81,0,0
"Saudi Arabia","2024-06-09",0,0,79,0,0,81,0,0
"Saudi Arabia","2024-06-10",0,0,79,0,0,81,0,0
"Saudi Arabia","2024-06-11",0,0,79,0,0,81,0,0
"Saudi Arabia","2024-06-12",0,0,79,0,0,81,0,0
"Saudi Arabia","2024-06-13",0,0,79,0,1,82,0,0
"Saudi Arabia","2024-06-14",0,0,79,0,0,82,0,0
"Saudi Arabia","2024-06-15",0,0,79,0,0,82,0,0
"Saudi Arabia","2024-06-16",0,0,79,0,0,82,0,0
"Saudi Arabia","2024-06-17",0,0,79,0,0,82,0,0
"Saudi Arabia","2024-06-18",0,0,79,0,1,83,0,0
"Saudi Arabia","2024-06-19",0,0,79,0,0,83,0,0
"Saudi Arabia","2024-06-20",0,0,79,0,0,83,0,0
"Saudi Arabia","2024-06-21",0,0,79,0,0,83,0,0
"Saudi Arabia","2024-06-22",0,0,79,0,0,83,0,0
"Saudi Arabia","2024-06-23",0,0,79,0,1,84,0,0
"Saudi Arabia","2024-06-24",0,0,79,0,0,84,0,0
"Saudi Arabia","2024-06-25",0,0,79,0,0,84,0,0
"Saudi Arabia","2024-06-26",0,0,79,0,0,84,0,0
"Saudi Arabia","2024-06-27",0,0,79,0,0,84,0,0
"Saudi Arabia","2024-06-28",0,0,79,0,1,85,0,0
"Saudi Arabia","2024-06-29",0,0,79,0,0,85,0,0
"Saudi Arabia","2024-06-30",0,6,85,0,0,85,0,0
"Saudi Arabia","2024-07-01",0,0,85,0,0,85,0,0
"Saudi Arabia","2024-07-02",0,0,85,0,1,86,0,0
"Saudi Arabia","2024-07-03",0,0,85,0,0,86,0,0
"Saudi Arabia","2024-07-04",0,0,85,0,0,86,0,0
"Saudi Arabia","2024-07-05",0,0,85,0,0,86,0,0
"Saudi Arabia","2024-07-06",0,0,85,0,1,87,0,0
"Saudi Arabia","2024-07-07",0,0,85,0,0,87,0,0
"Saudi Arabia","2024-07-08",0,0,85,0,0,87,0,0
"Saudi Arabia","2024-07-09",0,0,85,0,1,88,0,0
"Saudi Arabia","2024-07-10",0,0,85,0,0,88,0,0
"Saudi Arabia","2024-07-11",0,0,85,0,0,88,0,0
"Saudi Arabia","2024-07-12",0,0,85,0,0,88,0,0
"Saudi Arabia","2024-07-13",0,0,85,0,1,89,0,0
"Saudi Arabia","2024-07-14",0,0,85,0,0,89,0,0
"Saudi Arabia","2024-07-15",0,0,85,0,0,89,0,0
"Saudi Arabia","2024-07-16",0,0,85,0,1,90,0,0
"Saudi Arabia","2024-07-17",0,0,85,0,0,90,0,0
"Saudi Arabia","2024-07-18",0,0,85,0,0,90,0,0
"Saudi Arabia","2024-07-19",0,0,85,0,1,91,0,0
"Saudi Arabia","2024-07-20",0,0,85,0,0,91,0,0
"Saudi Arabia","2024-07-21",0,0,85,0,0,91,0,0
"Saudi Arabia","2024-07-22",0,0,85,0,0,91,0,0
"Saudi Arabia","2024-07-23",0,0,85,0,1,92,0,0
"Saudi Arabia","2024-07-24",0,0,85,0,0,92,0,0
"Saudi Arabia","2024-07-25",0,0,85,0,0,92,0,0
"Saudi Arabia","2024-07-26",0,0,85,0,1,93,0,0
"Saudi Arabia","2024-07-27",0,0,85,0,0,93,0,0
"Saudi Arabia","2024-07-28",0,0,85,0,0,93,0,0
"Saudi Arabia","2024-07-29",0,0,85,0,0,93,0,0
"Saudi Arabia","2024-07-30",0,0,85,0,1,94,0,0
"Saudi Arabia","2024-07-31",0,9,94,0,0,94,0,0
"Saudi Arabia","2024-08-01",0,0,94,0,0,94,0,0
"Saudi Arabia","2024-08-02",0,0,94,0,0,94,0,0
"Saudi Arabia","2024-08-03",0,0,94,0,0,94,0,0
"Saudi Arabia","2024-08-04",0,0,94,0,0,94,0,0
"Saudi Arabia","2024-08-05",0,0,94,0,0,94,0,0
"Saudi Arabia","2024-08-06",0,0,94,0,0,94,0,0
"Saudi Arabia","2024-08-07",0,0,94,0,0,94,0,0
"Saudi Arabia","2024-08-08",0,0,94,0,0,94,0,0
"Saudi Arabia","2024-08-09",0,0,94,0,0,94,0,0
"Saudi Arabia","2024-08-10",0,0,94,0,0,94,0,0
"Saudi Arabia","2024-08-11",0,0,94,0,1,95,0,0
"Saudi Arabia","2024-08-12",0,0,94,0,0,95,0,0
"Saudi Arabia","2024-08-13",0,0,94,0,0,95,0,0
"Saudi Arabia","2024-08-14",0,0,94,0,0,95,0,0
"Saudi Arabia","2024-08-15",0,0,94,0,0,95,0,0
"Saudi Arabia","2024-08-16",0,0,94,0,0,95,0,0
"Saudi Arabia","2024-08-17",0,0,94,0,0,95,0,0
"Saudi Arabia","2024-08-18",0,0,94,0,0,95,0,0
"Saudi Arabia","2024-08-19",0,0,94,0,0,95,0,0
"Saudi Arabia","2024-08-20",0,0,94,0,0,95,0,0
"Saudi Arabia","2024-08-21",0,1,95,0,0,95,0,0
"Saudi Arabia","2024-08-22",0,0,95,0,0,95,0,0
"Saudi Arabia","2024-08-23",0,0,95,0,0,95,0,0
"Saudi Arabia","2024-08-24",0,0,95,0,0,95,0,0
"Saudi Arabia","2024-08-25",0,0,95,0,0,95,0,0
"Saudi Arabia","2024-08-26",0,0,95,0,0,95,0,0
"Saudi Arabia","2024-08-27",0,0,95,0,0,95,0,0
"Saudi Arabia","2024-08-28",0,0,95,0,0,95,0,0
"Saudi Arabia","2024-08-29",0,0,95,0,0,95,0,0
"Saudi Arabia","2024-08-30",0,0,95,0,0,95,0,0
"Saudi Arabia","2024-08-31",0,0,95,0,0,95,0,0
"Saudi Arabia","2024-09-01",0,0,95,0,0,95,0,0
"Saudi Arabia","2024-09-02",0,0,95,0,0,95,0,0
"Saudi Arabia","2024-09-03",0,0,95,0,0,95,0,0
"Saudi Arabia","2024-09-04",0,0,95,0,0,95,0,0
"Saudi Arabia","2024-09-05",0,0,95,0,0,95,0,0
"Saudi Arabia","2024-09-06",0,0,95,0,0,95,0,0
"Saudi Arabia","2024-09-07",0,0,95,0,0,95,0,0
"Saudi Arabia","2024-09-08",0,0,95,0,0,95,0,0
"Saudi Arabia","2024-09-09",0,0,95,0,0,95,0,0
"Saudi Arabia","2024-09-10",0,0,95,0,0,95,0,0
"Saudi Arabia","2024-09-11",0,0,95,0,0,95,0,0
"Saudi Arabia","2024-09-12",0,0,95,0,0,95,0,0
"Saudi Arabia","2024-09-13",0,0,95,0,0,95,0,0
"Saudi Arabia","2024-09-14",0,0,95,0,0,95,0,0
"Saudi Arabia","2024-09-15",0,0,95,0,0,95,0,0
"Saudi Arabia","2024-09-16",0,0,95,0,0,95,0,0
"Saudi Arabia","2024-09-17",0,0,95,0,0,95,0,0
"Saudi Arabia","2024-09-18",0,0,95,0,0,95,0,0
"Saudi Arabia","2024-09-19",0,0,95,0,0,95,0,0
"Saudi Arabia","2024-09-20",0,0,95,0,0,95,0,0
"Saudi Arabia","2024-09-21",0,0,95,0,0,95,0,0
"Saudi Arabia","2024-09-22",0,0,95,0,0,95,0,0
"Saudi Arabia","2024-09-23",0,0,95,0,0,95,0,0
"Saudi Arabia","2024-09-24",0,0,95,0,0,95,0,0
"Saudi Arabia","2024-09-25",0,0,95,0,0,95,0,0
"Saudi Arabia","2024-09-26",0,0,95,0,0,95,0,0
"Saudi Arabia","2024-09-27",0,0,95,0,0,95,0,0
"Saudi Arabia","2024-09-28",0,0,95,0,0,95,0,0
"Saudi Arabia","2024-09-29",0,0,95,0,0,95,0,0
"Saudi Arabia","2024-09-30",0,0,95,0,0,95,0,0
"Saudi Arabia","2024-10-01",0,0,95,0,0,95,0,0
"Saudi Arabia","2024-10-02",0,0,95,0,0,95,0,0
"Saudi Arabia","2024-10-03",0,0,95,0,0,95,0,0
"Saudi Arabia","2024-10-04",0,0,95,0,0,95,0,0
"Saudi Arabia","2024-10-05",0,0,95,0,0,95,0,0
"Saudi Arabia","2024-10-06",0,0,95,0,0,95,0,0
"Saudi Arabia","2024-10-07",0,0,95,0,0,95,0,0
"Saudi Arabia","2024-10-08",0,0,95,0,0,95,0,0
"Saudi Arabia","2024-10-09",0,0,95,0,0,95,0,0
"Saudi Arabia","2024-10-10",0,0,95,0,0,95,0,0
"Saudi Arabia","2024-10-11",0,0,95,0,0,95,0,0
"Saudi Arabia","2024-10-12",0,0,95,0,0,95,0,0
"Saudi Arabia","2024-10-13",0,0,95,0,0,95,0,0
"Saudi Arabia","2024-10-14",0,0,95,0,0,95,0,0
"Saudi Arabia","2024-10-15",0,0,95,0,0,95,0,0
"Saudi Arabia","2024-10-16",0,0,95,0,0,95,0,0
"Saudi Arabia","2024-10-17",0,0,95,0,0,95,0,0
"Saudi Arabia","2024-10-18",0,0,95,0,0,95,0,0
"Saudi Arabia","2024-10-19",0,0,95,0,0,95,0,0
"Saudi Arabia","2024-10-20",0,0,95,0,0,95,0,0
"Saudi Arabia","2024-10-21",0,0,95,0,0,95,0,0
"Saudi Arabia","2024-10-22",0,0,95,0,0,95,0,0
"Saudi Arabia","2024-10-23",0,0,95,0,0,95,0,0
"Saudi Arabia","2024-10-24",0,0,95,0,0,95,0,0
"Saudi Arabia","2024-10-25",0,0,95,0,0,95,0,0
"Saudi Arabia","2024-10-26",0,0,95,0,0,95,0,0
"Saudi Arabia","2024-10-27",0,0,95,0,0,95,0,0
"Saudi Arabia","2024-10-28",0,0,95,0,0,95,0,0
"Saudi Arabia","2024-10-29",0,0,95,0,0,95,0,0
"Saudi Arabia","2024-10-30",0,0,95,0,0,95,0,0
"Saudi Arabia","2024-10-31",0,0,95,0,0,95,0,0
"Saudi Arabia","2024-11-01",0,0,95,0,0,95,0,0
"Saudi Arabia","2024-11-02",0,0,95,0,0,95,0,0
"Saudi Arabia","2024-11-03",0,0,95,0,0,95,0,0
"Saudi Arabia","2024-11-04",0,0,95,0,0,95,0,0
"Saudi Arabia","2024-11-05",0,0,95,0,0,95,0,0
"Saudi Arabia","2024-11-06",0,0,95,0,0,95,0,0
"Saudi Arabia","2024-11-07",0,0,95,0,0,95,0,0
"Saudi Arabia","2024-11-08",0,0,95,0,0,95,0,0
"Saudi Arabia","2024-11-09",0,0,95,0,0,95,0,0
"Saudi Arabia","2024-11-10",0,0,95,0,0,95,0,0
"Saudi Arabia","2024-11-11",0,0,95,0,0,95,0,0
"Saudi Arabia","2024-11-12",0,0,95,0,0,95,0,0
"Saudi Arabia","2024-11-13",0,0,95,0,0,95,0,0
"Saudi Arabia","2024-11-14",0,0,95,0,0,95,0,0
"Saudi Arabia","2024-11-15",0,0,95,0,0,95,0,0
"Saudi Arabia","2024-11-16",0,0,95,0,0,95,0,0
"Saudi Arabia","2024-11-17",0,0,95,0,0,95,0,0
"Saudi Arabia","2024-11-18",0,0,95,0,0,95,0,0
"Saudi Arabia","2024-11-19",0,0,95,0,0,95,0,0
"Saudi Arabia","2024-11-20",0,0,95,0,0,95,0,0
"Saudi Arabia","2024-11-21",0,0,95,0,0,95,0,0
"Saudi Arabia","2024-11-22",0,0,95,0,0,95,0,0
"Saudi Arabia","2024-11-23",0,0,95,0,0,95,0,0
"Saudi Arabia","2024-11-24",0,0,95,0,0,95,0,0
"Saudi Arabia","2024-11-25",0,0,95,0,0,95,0,0
"Saudi Arabia","2024-11-26",0,0,95,0,0,95,0,0
"Saudi Arabia","2024-11-27",0,0,95,0,0,95,0,0
"Saudi Arabia","2024-11-28",0,0,95,0,0,95,0,0
"Saudi Arabia","2024-11-29",0,0,95,0,0,95,0,0
"Saudi Arabia","2024-11-30",0,0,95,0,0,95,0,0
"Saudi Arabia","2024-12-01",0,0,95,0,0,95,0,0
"Saudi Arabia","2024-12-02",0,0,95,0,0,95,0,0
"Saudi Arabia","2024-12-03",0,0,95,0,0,95,0,0
"Saudi Arabia","2024-12-04",0,0,95,0,0,95,0,0
"Saudi Arabia","2024-12-05",0,0,95,0,0,95,0,0
"Saudi Arabia","2024-12-06",0,0,95,0,0,95,0,0
"Saudi Arabia","2024-12-07",0,0,95,0,0,95,0,0
"Saudi Arabia","2024-12-08",0,0,95,0,0,95,0,0
"Saudi Arabia","2024-12-09",0,0,95,0,0,95,0,0
"Serbia","2024-01-01",0,0,0,0,0,0,0,0
"Serbia","2024-01-02",0,0,0,0,0,0,0,0
"Serbia","2024-01-03",0,0,0,0,0,0,0,0
"Serbia","2024-01-04",0,0,0,0,0,0,0,0
"Serbia","2024-01-05",0,0,0,0,0,0,0,0
"Serbia","2024-01-06",0,0,0,0,0,0,0,0
"Serbia","2024-01-07",0,0,0,0,0,0,0,0
"Serbia","2024-01-08",0,0,0,0,0,0,0,0
"Serbia","2024-01-09",0,0,0,0,0,0,0,0
"Serbia","2024-01-10",0,0,0,0,0,0,0,0
"Serbia","2024-01-11",0,0,0,0,0,0,0,0
"Serbia","2024-01-12",0,0,0,0,0,0,0,0
"Serbia","2024-01-13",0,0,0,0,0,0,0,0
"Serbia","2024-01-14",0,0,0,0,0,0,0,0
"Serbia","2024-01-15",0,0,0,0,0,0,0,0
"Serbia","2024-01-16",0,0,0,0,0,0,0,0
"Serbia","2024-01-17",0,0,0,0,0,0,0,0
"Serbia","2024-01-18",0,0,0,0,0,0,0,0
"Serbia","2024-01-19",0,0,0,0,0,0,0,0
"Serbia","2024-01-20",0,0,0,0,0,0,0,0
"Serbia","2024-01-21",0,0,0,0,0,0,0,0
"Serbia","2024-01-22",0,0,0,0,0,0,0,0
"Serbia","2024-01-23",0,0,0,0,0,0,0,0
"Serbia","2024-01-24",0,0,0,0,0,0,0,0
"Serbia","2024-01-25",0,0,0,0,0,0,0,0
"Serbia","2024-01-26",0,0,0,0,0,0,0,0
"Serbia","2024-01-27",0,0,0,0,0,0,0,0
"Serbia","2024-01-28",0,0,0,0,0,0,0,0
"Serbia","2024-01-29",0,0,0,0,0,0,0,0
"Serbia","2024-01-30",0,0,0,0,0,0,0,0
"Serbia","2024-01-31",0,0,0,0,0,0,0,0
"Serbia","2024-02-01",0,0,0,0,0,0,0,0
"Serbia","2024-02-02",0,0,0,0,0,0,0,0
"Serbia","2024-02-03",0,0,0,0,0,0,0,0
"Serbia","2024-02-04",0,0,0,0,0,0,0,0
"Serbia","2024-02-05",0,0,0,0,0,0,0,0
"Serbia","2024-02-06",0,0,0,0,0,0,0,0
"Serbia","2024-02-07",0,0,0,0,0,0,0,0
"Serbia","2024-02-08",0,0,0,0,0,0,0,0
"Serbia","2024-02-09",0,0,0,0,0,0,0,0
"Serbia","2024-02-10",0,0,0,0,0,0,0,0
"Serbia","2024-02-11",0,0,0,0,0,0,0,0
"Serbia","2024-02-12",0,0,0,0,0,0,0,0
"Serbia","2024-02-13",0,0,0,0,0,0,0,0
"Serbia","2024-02-14",0,0,0,0,0,0,0,0
"Serbia","2024-02-15",0,0,0,0,0,0,0,0
"Serbia","2024-02-16",0,0,0,0,0,0,0,0
"Serbia","2024-02-17",0,0,0,0,0,0,0,0
"Serbia","2024-02-18",0,0,0,0,0,0,0,0
"Serbia","2024-02-19",0,0,0,0,0,0,0,0
"Serbia","2024-02-20",0,0,0,0,0,0,0,0
"Serbia","2024-02-21",0,0,0,0,0,0,0,0
"Serbia","2024-02-22",0,0,0,0,0,0,0,0
"Serbia","2024-02-23",0,0,0,0,0,0,0,0
"Serbia","2024-02-24",0,0,0,0,0,0,0,0
"Serbia","2024-02-25",0,0,0,0,0,0,0,0
"Serbia","2024-02-26",0,0,0,0,0,0,0,0
"Serbia","2024-02-27",0,0,0,0,0,0,0,0
"Serbia","2024-02-28",0,0,0,0,0,0,0,0
"Serbia","2024-02-29",0,0,0,0,0,0,0,0
"Serbia","2024-03-01",0,0,0,0,0,0,0,0
"Serbia","2024-03-02",0,0,0,0,0,0,0,0
"Serbia","2024-03-03",0,0,0,0,0,0,0,0
"Serbia","2024-03-04",0,0,0,0,0,0,0,0
"Serbia","2024-03-05",0,0,0,0,0,0,0,0
"Serbia","2024-03-06",0,0,0,0,0,0,0,0
"Serbia","2024-03-07",0,0,0,0,0,0,0,0
"Serbia","2024-03-08",0,0,0,0,0,0,0,0
"Serbia","2024-03-09",0,0,0,0,0,0,0,0
"Serbia","2024-03-10",0,0,0,0,0,0,0,0
"Serbia","2024-03-11",0,0,0,0,0,0,0,0
"Serbia","2024-03-12",0,0,0,0,0,0,0,0
"Serbia","2024-03-13",0,0,0,0,0,0,0,0
"Serbia","2024-03-14",0,0,0,0,0,0,0,0
"Serbia","2024-03-15",0,0,0,0,0,0,0,0
"Serbia","2024-03-16",0,0,0,0,0,0,0,0
"Serbia","2024-03-17",0,0,0,0,0,0,0,0
"Serbia","2024-03-18",0,0,0,0,0,0,0,0
"Serbia","2024-03-19",0,0,0,0,0,0,0,0
"Serbia","2024-03-20",0,0,0,0,0,0,0,0
"Serbia","2024-03-21",0,0,0,0,0,0,0,0
"Serbia","2024-03-22",0,0,0,0,0,0,0,0
"Serbia","2024-03-23",0,0,0,0,0,0,0,0
"Serbia","2024-03-24",0,0,0,0,0,0,0,0
"Serbia","2024-03-25",0,0,0,0,0,0,0,0
"Serbia","2024-03-26",0,0,0,0,0,0,0,0
"Serbia","2024-03-27",0,0,0,0,0,0,0,0
"Serbia","2024-03-28",0,0,0,0,0,0,0,0
"Serbia","2024-03-29",0,0,0,0,0,0,0,0
"Serbia","2024-03-30",0,0,0,0,0,0,0,0
"Serbia","2024-03-31",0,0,0,0,0,0,0,0
"Serbia","2024-04-01",0,0,0,0,0,0,0,0
"Serbia","2024-04-02",0,0,0,0,0,0,0,0
"Serbia","2024-04-03",0,0,0,0,0,0,0,0
"Serbia","2024-04-04",0,0,0,0,0,0,0,0
"Serbia","2024-04-05",0,0,0,0,0,0,0,0
"Serbia","2024-04-06",0,0,0,0,0,0,0,0
"Serbia","2024-04-07",0,0,0,0,0,0,0,0
"Serbia","2024-04-08",0,0,0,0,0,0,0,0
"Serbia","2024-04-09",0,0,0,0,0,0,0,0
"Serbia","2024-04-10",0,0,0,0,0,0,0,0
"Serbia","2024-04-11",0,0,0,0,0,0,0,0
"Serbia","2024-04-12",0,0,0,0,0,0,0,0
"Serbia","2024-04-13",0,0,0,0,0,0,0,0
"Serbia","2024-04-14",0,0,0,0,0,0,0,0
"Serbia","2024-04-15",0,0,0,0,0,0,0,0
"Serbia","2024-04-16",0,0,0,0,0,0,0,0
"Serbia","2024-04-17",0,0,0,0,0,0,0,0
"Serbia","2024-04-18",0,0,0,0,0,0,0,0
"Serbia","2024-04-19",0,0,0,0,0,0,0,0
"Serbia","2024-04-20",0,0,0,0,0,0,0,0
"Serbia","2024-04-21",0,0,0,0,0,0,0,0
"Serbia","2024-04-22",0,0,0,0,0,0,0,0
"Serbia","2024-04-23",0,0,0,0,0,0,0,0
"Serbia","2024-04-24",0,0,0,0,0,0,0,0
"Serbia","2024-04-25",0,0,0,0,0,0,0,0
"Serbia","2024-04-26",0,0,0,0,0,0,0,0
"Serbia","2024-04-27",0,0,0,0,0,0,0,0
"Serbia","2024-04-28",0,0,0,0,0,0,0,0
"Serbia","2024-04-29",0,0,0,0,0,0,0,0
"Serbia","2024-04-30",0,0,0,0,0,0,0,0
"Serbia","2024-05-01",0,0,0,0,0,0,0,0
"Serbia","2024-05-02",0,0,0,0,0,0,0,0
"Serbia","2024-05-03",0,0,0,0,0,0,0,0
"Serbia","2024-05-04",0,0,0,0,0,0,0,0
"Serbia","2024-05-05",0,0,0,0,0,0,0,0
"Serbia","2024-05-06",0,0,0,0,0,0,0,0
"Serbia","2024-05-07",0,0,0,0,0,0,0,0
"Serbia","2024-05-08",0,0,0,0,0,0,0,0
"Serbia","2024-05-09",0,0,0,0,0,0,0,0
"Serbia","2024-05-10",0,0,0,0,0,0,0,0
"Serbia","2024-05-11",0,0,0,0,0,0,0,0
"Serbia","2024-05-12",0,0,0,0,0,0,0,0
"Serbia","2024-05-13",0,0,0,0,0,0,0,0
"Serbia","2024-05-14",0,0,0,0,0,0,0,0
"Serbia","2024-05-15",0,0,0,0,0,0,0,0
"Serbia","2024-05-16",0,0,0,0,0,0,0,0
"Serbia","2024-05-17",0,0,0,0,0,0,0,0
"Serbia","2024-05-18",0,0,0,0,0,0,0,0
"Serbia","2024-05-19",0,0,0,0,0,0,0,0
"Serbia","2024-05-20",0,0,0,0,0,0,0,0
"Serbia","2024-05-21",0,0,0,0,0,0,0,0
"Serbia","2024-05-22",0,0,0,0,0,0,0,0
"Serbia","2024-05-23",0,0,0,0,0,0,0,0
"Serbia","2024-05-24",0,0,0,0,0,0,0,0
"Serbia","2024-05-25",0,0,0,0,0,0,0,0
"Serbia","2024-05-26",0,0,0,0,0,0,0,0
"Serbia","2024-05-27",0,0,0,0,0,0,0,0
"Serbia","2024-05-28",0,0,0,0,0,0,0,0
"Serbia","2024-05-29",0,0,0,0,0,0,0,0
"Serbia","2024-05-30",0,0,0,0,0,0,0,0
"Serbia","2024-05-31",0,0,0,0,0,0,0,0
"Serbia","2024-06-01",0,0,0,0,0,0,0,0
"Serbia","2024-06-02",0,0,0,0,0,0,0,0
"Serbia","2024-06-03",0,0,0,0,0,0,0,0
"Serbia","2024-06-04",0,0,0,0,0,0,0,0
"Serbia","2024-06-05",0,0,0,0,0,0,0,0
"Serbia","2024-06-06",0,0,0,0,0,0,0,0
"Serbia","2024-06-07",0,0,0,0,0,0,0,0
"Serbia","2024-06-08",0,0,0,0,0,0,0,0
"Serbia","2024-06-09",0,0,0,0,0,0,0,0
"Serbia","2024-06-10",0,0,0,0,0,0,0,0
"Serbia","2024-06-11",0,0,0,0,0,0,0,0
"Serbia","2024-06-12",0,0,0,0,0,0,0,0
"Serbia","2024-06-13",0,0,0,0,0,0,0,0
"Serbia","2024-06-14",0,0,0,0,0,0,0,0
"Serbia","2024-06-15",0,0,0,0,0,0,0,0
"Serbia","2024-06-16",0,0,0,0,0,0,0,0
"Serbia","2024-06-17",0,0,0,0,0,0,0,0
"Serbia","2024-06-18",0,0,0,0,0,0,0,0
"Serbia","2024-06-19",0,0,0,0,0,0,0,0
"Serbia","2024-06-20",0,0,0,0,0,0,0,0
"Serbia","2024-06-21",0,0,0,0,0,0,0,0
"Serbia","2024-06-22",0,0,0,0,0,0,0,0
"Serbia","2024-06-23",0,0,0,0,0,0,0,0
"Serbia","2024-06-24",0,0,0,0,0,0,0,0
"Serbia","2024-06-25",0,0,0,0,0,0,0,0
"Serbia","2024-06-26",0,0,0,0,0,0,0,0
"Serbia","2024-06-27",0,0,0,0,0,0,0,0
"Serbia","2024-06-28",0,0,0,0,0,0,0,0
"Serbia","2024-06-29",0,0,0,0,0,0,0,0
"Serbia","2024-06-30",0,0,0,0,0,0,0,0
"Serbia","2024-07-01",0,0,0,0,0,0,0,0
"Serbia","2024-07-02",0,0,0,0,0,0,0,0
"Serbia","2024-07-03",0,0,0,0,0,0,0,0
"Serbia","2024-07-04",0,0,0,0,0,0,0,0
"Serbia","2024-07-05",0,0,0,0,0,0,0,0
"Serbia","2024-07-06",0,0,0,0,0,0,0,0
"Serbia","2024-07-07",0,0,0,0,0,0,0,0
"Serbia","2024-07-08",0,0,0,0,0,0,0,0
"Serbia","2024-07-09",0,0,0,0,0,0,0,0
"Serbia","2024-07-10",0,0,0,0,0,0,0,0
"Serbia","2024-07-11",0,0,0,0,0,0,0,0
"Serbia","2024-07-12",0,0,0,0,0,0,0,0
"Serbia","2024-07-13",0,0,0,0,0,0,0,0
"Serbia","2024-07-14",0,0,0,0,0,0,0,0
"Serbia","2024-07-15",0,0,0,0,0,0,0,0
"Serbia","2024-07-16",0,0,0,0,0,0,0,0
"Serbia","2024-07-17",0,0,0,0,0,0,0,0
"Serbia","2024-07-18",0,0,0,0,0,0,0,0
"Serbia","2024-07-19",0,0,0,0,0,0,0,0
"Serbia","2024-07-20",0,0,0,0,0,0,0,0
"Serbia","2024-07-21",0,0,0,0,0,0,0,0
"Serbia","2024-07-22",0,0,0,0,0,0,0,0
"Serbia","2024-07-23",0,0,0,0,0,0,0,0
"Serbia","2024-07-24",0,0,0,0,0,0,0,0
"Serbia","2024-07-25",0,0,0,0,0,0,0,0
"Serbia","2024-07-26",0,0,0,0,0,0,0,0
"Serbia","2024-07-27",0,0,0,0,0,0,0,0
"Serbia","2024-07-28",0,0,0,0,0,0,0,0
"Serbia","2024-07-29",0,0,0,0,0,0,0,0
"Serbia","2024-07-30",0,0,0,0,0,0,0,0
"Serbia","2024-07-31",0,0,0,0,0,0,0,0
"Serbia","2024-08-01",0,0,0,0,0,0,0,0
"Serbia","2024-08-02",0,0,0,0,0,0,0,0
"Serbia","2024-08-03",0,0,0,0,0,0,0,0
"Serbia","2024-08-04",0,0,0,0,0,0,0,0
"Serbia","2024-08-05",0,0,0,0,0,0,0,0
"Serbia","2024-08-06",0,0,0,0,0,0,0,0
"Serbia","2024-08-07",0,0,0,0,0,0,0,0
"Serbia","2024-08-08",0,0,0,0,0,0,0,0
"Serbia","2024-08-09",0,0,0,0,0,0,0,0
"Serbia","2024-08-10",0,0,0,0,0,0,0,0
"Serbia","2024-08-11",0,0,0,0,0,0,0,0
"Serbia","2024-08-12",0,0,0,0,0,0,0,0
"Serbia","2024-08-13",0,0,0,0,0,0,0,0
"Serbia","2024-08-14",0,0,0,0,0,0,0,0
"Serbia","2024-08-15",0,0,0,0,0,0,0,0
"Serbia","2024-08-16",0,0,0,0,0,0,0,0
"Serbia","2024-08-17",0,0,0,0,0,0,0,0
"Serbia","2024-08-18",0,0,0,0,0,0,0,0
"Serbia","2024-08-19",0,0,0,0,0,0,0,0
"Serbia","2024-08-20",0,0,0,0,0,0,0,0
"Serbia","2024-08-21",0,0,0,0,0,0,0,0
"Serbia","2024-08-22",0,0,0,0,0,0,0,0
"Serbia","2024-08-23",0,0,0,0,0,0,0,0
"Serbia","2024-08-24",0,0,0,0,0,0,0,0
"Serbia","2024-08-25",0,0,0,0,0,0,0,0
"Serbia","2024-08-26",0,0,0,0,0,0,0,0
"Serbia","2024-08-27",0,0,0,0,0,0,0,0
"Serbia","2024-08-28",0,0,0,0,0,0,0,0
"Serbia","2024-08-29",0,0,0,0,0,0,0,0
"Serbia","2024-08-30",0,0,0,0,0,0,0,0
"Serbia","2024-08-31",0,0,0,0,0,0,0,0
"Serbia","2024-09-01",0,0,0,0,0,0,0,0
"Serbia","2024-09-02",0,0,0,0,0,0,0,0
"Serbia","2024-09-03",0,0,0,0,0,0,0,0
"Serbia","2024-09-04",0,0,0,0,0,0,0,0
"Serbia","2024-09-05",0,0,0,0,0,0,0,0
"Serbia","2024-09-06",0,0,0,0,0,0,0,0
"Serbia","2024-09-07",0,0,0,0,0,0,0,0
"Serbia","2024-09-08",0,0,0,0,0,0,0,0
"Serbia","2024-09-09",0,0,0,0,0,0,0,0
"Serbia","2024-09-10",0,0,0,0,0,0,0,0
"Serbia","2024-09-11",0,0,0,0,0,0,0,0
"Serbia","2024-09-12",0,0,0,0,0,0,0,0
"Serbia","2024-09-13",0,0,0,0,0,0,0,0
"Serbia","2024-09-14",0,0,0,0,0,0,0,0
"Serbia","2024-09-15",0,0,0,0,0,0,0,0
"Serbia","2024-09-16",0,0,0,0,0,0,0,0
"Serbia","2024-09-17",0,0,0,0,0,0,0,0
"Serbia","2024-09-18",0,0,0,0,0,0,0,0
"Serbia","2024-09-19",0,0,0,0,0,0,0,0
"Serbia","2024-09-20",0,0,0,0,0,0,0,0
"Serbia","2024-09-21",0,0,0,0,0,0,0,0
"Serbia","2024-09-22",0,0,0,0,0,0,0,0
"Serbia","2024-09-23",0,0,0,0,0,0,0,0
"Serbia","2024-09-24",0,0,0,0,0,0,0,0
"Serbia","2024-09-25",0,0,0,0,0,0,0,0
"Serbia","2024-09-26",0,0,0,0,0,0,0,0
"Serbia","2024-09-27",0,0,0,0,0,0,0,0
"Serbia","2024-09-28",0,0,0,0,0,0,0,0
"Serbia","2024-09-29",0,0,0,0,0,0,0,0
"Serbia","2024-09-30",0,0,0,0,0,0,0,0
"Serbia","2024-10-01",0,0,0,0,0,0,0,0
"Serbia","2024-10-02",0,0,0,0,0,0,0,0
"Serbia","2024-10-03",0,0,0,0,0,0,0,0
"Serbia","2024-10-04",0,0,0,0,0,0,0,0
"Serbia","2024-10-05",0,0,0,0,0,0,0,0
"Serbia","2024-10-06",0,0,0,0,0,0,0,0
"Serbia","2024-10-07",0,0,0,0,0,0,0,0
"Serbia","2024-10-08",0,0,0,0,0,0,0,0
"Serbia","2024-10-09",0,0,0,0,0,0,0,0
"Serbia","2024-10-10",0,0,0,0,0,0,0,0
"Serbia","2024-10-11",0,0,0,0,0,0,0,0
"Serbia","2024-10-12",0,0,0,0,0,0,0,0
"Serbia","2024-10-13",0,0,0,0,0,0,0,0
"Serbia","2024-10-14",0,0,0,0,0,0,0,0
"Serbia","2024-10-15",0,0,0,0,0,0,0,0
"Serbia","2024-10-16",0,0,0,0,0,0,0,0
"Serbia","2024-10-17",0,0,0,0,0,0,0,0
"Serbia","2024-10-18",0,0,0,0,0,0,0,0
"Serbia","2024-10-19",0,0,0,0,0,0,0,0
"Serbia","2024-10-20",0,0,0,0,0,0,0,0
"Serbia","2024-10-21",0,0,0,0,0,0,0,0
"Serbia","2024-10-22",0,0,0,0,0,0,0,0
"Serbia","2024-10-23",0,0,0,0,0,0,0,0
"Serbia","2024-10-24",0,0,0,0,0,0,0,0
"Serbia","2024-10-25",0,0,0,0,0,0,0,0
"Serbia","2024-10-26",0,0,0,0,0,0,0,0
"Serbia","2024-10-27",0,0,0,0,0,0,0,0
"Serbia","2024-10-28",0,0,0,0,0,0,0,0
"Serbia","2024-10-29",0,0,0,0,0,0,0,0
"Serbia","2024-10-30",0,0,0,0,0,0,0,0
"Serbia","2024-10-31",0,0,0,0,0,0,0,0
"Serbia","2024-11-01",0,0,0,0,0,0,0,0
"Serbia","2024-11-02",0,0,0,0,0,0,0,0
"Serbia","2024-11-03",0,0,0,0,0,0,0,0
"Serbia","2024-11-04",0,0,0,0,0,0,0,0
"Serbia","2024-11-05",0,0,0,0,0,0,0,0
"Serbia","2024-11-06",0,0,0,0,0,0,0,0
"Serbia","2024-11-07",0,0,0,0,0,0,0,0
"Serbia","2024-11-08",0,0,0,0,0,0,0,0
"Serbia","2024-11-09",0,0,0,0,0,0,0,0
"Serbia","2024-11-10",0,0,0,0,0,0,0,0
"Serbia","2024-11-11",0,0,0,0,0,0,0,0
"Serbia","2024-11-12",0,0,0,0,0,0,0,0
"Serbia","2024-11-13",0,0,0,0,0,0,0,0
"Serbia","2024-11-14",0,0,0,0,0,0,0,0
"Serbia","2024-11-15",0,0,0,0,0,0,0,0
"Serbia","2024-11-16",0,0,0,0,0,0,0,0
"Serbia","2024-11-17",0,0,0,0,0,0,0,0
"Serbia","2024-11-18",0,0,0,0,0,0,0,0
"Serbia","2024-11-19",0,0,0,0,0,0,0,0
"Serbia","2024-11-20",0,0,0,0,0,0,0,0
"Serbia","2024-11-21",0,0,0,0,0,0,0,0
"Serbia","2024-11-22",0,0,0,0,0,0,0,0
"Serbia","2024-11-23",0,0,0,0,0,0,0,0
"Serbia","2024-11-24",0,0,0,0,0,0,0,0
"Serbia","2024-11-25",0,0,0,0,0,0,0,0
"Serbia","2024-11-26",0,0,0,0,0,0,0,0
"Serbia","2024-11-27",0,0,0,0,0,0,0,0
"Serbia","2024-11-28",0,0,0,0,0,0,0,0
"Serbia","2024-11-29",0,0,0,0,0,0,0,0
"Serbia","2024-11-30",0,0,0,0,0,0,0,0
"Serbia","2024-12-01",0,0,0,0,0,0,0,0
"Serbia","2024-12-02",0,0,0,0,0,0,0,0
"Serbia","2024-12-03",0,0,0,0,0,0,0,0
"Serbia","2024-12-04",0,0,0,0,0,0,0,0
"Serbia","2024-12-05",0,0,0,0,0,0,0,0
"Serbia","2024-12-06",0,0,0,0,0,0,0,0
"Serbia","2024-12-07",0,0,0,0,0,0,0,0
"Serbia","2024-12-08",0,0,0,0,0,0,0,0
"Serbia","2024-12-09",0,0,0,0,0,0,0,0
"Singapore","2024-01-01",0,0,0,0,0,0,0,0
"Singapore","2024-01-02",0,0,0,0,0,0,0,0
"Singapore","2024-01-03",0,0,0,0,0,0,0,0
"Singapore","2024-01-04",0,0,0,0,0,0,0,0
"Singapore","2024-01-05",0,1,1,0,1,1,0,0
"Singapore","2024-01-06",0,0,1,0,0,1,0,0
"Singapore","2024-01-07",0,0,1,0,0,1,0,0
"Singapore","2024-01-08",0,0,1,0,0,1,0,0
"Singapore","2024-01-09",0,0,1,0,0,1,0,0
"Singapore","2024-01-10",0,0,1,0,0,1,0,0
"Singapore","2024-01-11",0,0,1,0,0,1,0,0
"Singapore","2024-01-12",0,0,1,0,0,1,0,0
"Singapore","2024-01-13",0,0,1,0,0,1,0,0
"Singapore","2024-01-14",0,0,1,0,0,1,0,0
"Singapore","2024-01-15",0,0,1,0,0,1,0,0
"Singapore","2024-01-16",0,0,1,0,0,1,0,0
"Singapore","2024-01-17",0,0,1,0,0,1,0,0
"Singapore","2024-01-18",0,0,1,0,0,1,0,0
"Singapore","2024-01-19",0,0,1,0,0,1,0,0
"Singapore","2024-01-20",0,0,1,0,0,1,0,0
"Singapore","2024-01-21",0,0,1,0,0,1,0,0
"Singapore","2024-01-22",0,0,1,0,0,1,0,0
"Singapore","2024-01-23",0,0,1,0,0,1,0,0
"Singapore","2024-01-24",0,0,1,0,0,1,0,0
"Singapore","2024-01-25",0,0,1,0,0,1,0,0
"Singapore","2024-01-26",0,0,1,0,0,1,0,0
"Singapore","2024-01-27",0,0,1,0,1,2,0,0
"Singapore","2024-01-28",0,0,1,0,0,2,0,0
"Singapore","2024-01-29",0,0,1,0,0,2,0,0
"Singapore","2024-01-30",0,0,1,0,0,2,0,0
"Singapore","2024-01-31",0,0,1,0,0,2,0,0
"Singapore","2024-02-01",0,0,1,0,0,2,0,0
"Singapore","2024-02-02",0,0,1,0,0,2,0,0
"Singapore","2024-02-03",0,0,1,0,0,2,0,0
"Singapore","2024-02-04",0,0,1,0,0,2,0,0
"Singapore","2024-02-05",0,0,1,0,0,2,0,0
"Singapore","2024-02-06",0,0,1,0,0,2,0,0
"Singapore","2024-02-07",0,0,1,0,0,2,0,0
"Singapore","2024-02-08",0,0,1,0,0,2,0,0
"Singapore","2024-02-09",0,0,1,0,0,2,0,0
"Singapore","2024-02-10",0,0,1,0,0,2,0,0
"Singapore","2024-02-11",0,0,1,0,0,2,0,0
"Singapore","2024-02-12",0,0,1,0,0,2,0,0
"Singapore","2024-02-13",0,0,1,0,0,2,0,0
"Singapore","2024-02-14",0,0,1,0,0,2,0,0
"Singapore","2024-02-15",0,0,1,0,0,2,0,0
"Singapore","2024-02-16",0,1,2,0,0,2,0,0
"Singapore","2024-02-17",0,0,2,0,0,2,0,0
"Singapore","2024-02-18",0,0,2,0,0,2,0,0
"Singapore","2024-02-19",0,0,2,0,0,2,0,0
"Singapore","2024-02-20",0,0,2,0,0,2,0,0
"Singapore","2024-02-21",0,0,2,0,0,2,0,0
"Singapore","2024-02-22",0,0,2,0,1,3,0,0
"Singapore","2024-02-23",0,0,2,0,0,3,0,0
"Singapore","2024-02-24",0,0,2,0,0,3,0,0
"Singapore","2024-02-25",0,0,2,0,0,3,0,0
"Singapore","2024-02-26",0,0,2,0,0,3,0,0
"Singapore","2024-02-27",0,0,2,0,0,3,0,0
"Singapore","2024-02-28",0,0,2,0,0,3,0,0
"Singapore","2024-02-29",0,0,2,0,0,3,0,0
"Singapore","2024-03-01",0,0,2,0,0,3,0,0
"Singapore","2024-03-02",0,0,2,0,0,3,0,0
"Singapore","2024-03-03",0,0,2,0,1,4,0,0
"Singapore","2024-03-04",0,0,2,0,0,4,0,0
"Singapore","2024-03-05",0,0,2,0,0,4,0,0
"Singapore","2024-03-06",0,0,2,0,0,4,0,0
"Singapore","2024-03-07",0,0,2,0,0,4,0,0
"Singapore","2024-03-08",0,2,4,0,0,4,0,0
"Singapore","2024-03-09",0,0,4,0,0,4,0,0
"Singapore","2024-03-10",0,0,4,0,1,5,0,0
"Singapore","2024-03-11",0,0,4,0,0,5,0,0
"Singapore","2024-03-12",0,0,4,0,0,5,0,0
"Singapore","2024-03-13",0,0,4,0,0,5,0,0
"Singapore","2024-03-14",0,0,4,0,1,6,0,0
"Singapore","2024-03-15",0,2,6,0,0,6,0,0
"Singapore","2024-03-16",0,0,6,0,0,6,0,0
"Singapore","2024-03-17",0,0,6,0,0,6,0,0
"Singapore","2024-03-18",0,0,6,0,0,6,0,0
"Singapore","2024-03-19",0,0,6,0,1,7,0,0
"Singapore","2024-03-20",0,0,6,0,0,7,0,0
"Singapore","2024-03-21",0,0,6,0,0,7,0,0
"Singapore","2024-03-22",0,1,7,0,0,7,0,0
"Singapore","2024-03-23",0,0,7,0,0,7,0,0
"Singapore","2024-03-24",0,0,7,0,0,7,0,0
"Singapore","2024-03-25",0,0,7,0,0,7,0,0
"Singapore","2024-03-26",0,0,7,0,0,7,0,0
"Singapore","2024-03-27",0,0,7,0,0,7,0,0
"Singapore","2024-03-28",0,0,7,0,0,7,0,0
"Singapore","2024-03-29",0,0,7,0,0,7,0,0
"Singapore","2024-03-30",0,0,7,0,1,8,0,0
"Singapore","2024-03-31",0,0,7,0,0,8,0,0
"Singapore","2024-04-01",0,0,7,0,0,8,0,0
"Singapore","2024-04-02",0,0,7,0,0,8,0,0
"Singapore","2024-04-03",0,0,7,0,0,8,0,0
"Singapore","2024-04-04",0,0,7,0,0,8,0,0
"Singapore","2024-04-05",0,1,8,0,0,8,0,0
"Singapore","2024-04-06",0,0,8,0,0,8,0,0
"Singapore","2024-04-07",0,0,8,0,0,8,0,0
"Singapore","2024-04-08",0,0,8,0,0,8,0,0
"Singapore","2024-04-09",0,0,8,0,0,8,0,0
"Singapore","2024-04-10",0,0,8,0,0,8,0,0
"Singapore","2024-04-11",0,0,8,0,0,8,0,0
"Singapore","2024-04-12",0,0,8,0,0,8,0,0
"Singapore","2024-04-13",0,0,8,0,0,8,0,0
"Singapore","2024-04-14",0,0,8,0,0,8,0,0
"Singapore","2024-04-15",0,0,8,0,0,8,0,0
"Singapore","2024-04-16",0,0,8,0,1,9,0,0
"Singapore","2024-04-17",0,0,8,0,0,9,0,0
"Singapore","2024-04-18",0,0,8,0,0,9,0,0
"Singapore","2024-04-19",0,0,8,0,0,9,0,0
"Singapore","2024-04-20",0,0,8,0,0,9,0,0
"Singapore","2024-04-21",0,0,8,0,0,9,0,0
"Singapore","2024-04-22",0,0,8,0,0,9,0,0
"Singapore","2024-04-23",0,0,8,0,0,9,0,0
"Singapore","2024-04-24",0,0,8,0,0,9,0,0
"Singapore","2024-04-25",0,0,8,0,0,9,0,0
"Singapore","2024-04-26",0,1,9,0,0,9,0,0
"Singapore","2024-04-27",0,0,9,0,0,9,0,0
"Singapore","2024-04-28",0,0,9,0,0,9,0,0
"Singapore","2024-04-29",0,0,9,0,0,9,0,0
"Singapore","2024-04-30",0,0,9,0,0,9,0,0
"Singapore","2024-05-01",0,0,9,0,0,9,0,0
"Singapore","2024-05-02",0,0,9,0,0,9,0,0
"Singapore","2024-05-03",0,0,9,0,0,9,0,0
"Singapore","2024-05-04",0,0,9,0,0,9,0,0
"Singapore","2024-05-05",0,0,9,0,0,9,0,0
"Singapore","2024-05-06",0,0,9,0,0,9,0,0
"Singapore","2024-05-07",0,0,9,0,0,9,0,0
"Singapore","2024-05-08",0,0,9,0,0,9,0,0
"Singapore","2024-05-09",0,0,9,0,0,9,0,0
"Singapore","2024-05-10",0,0,9,0,0,9,0,0
"Singapore","2024-05-11",0,0,9,0,0,9,0,0
"Singapore","2024-05-12",0,0,9,0,0,9,0,0
"Singapore","2024-05-13",0,0,9,0,0,9,0,0
"Singapore","2024-05-14",0,0,9,0,0,9,0,0
"Singapore","2024-05-15",0,0,9,0,0,9,0,0
"Singapore","2024-05-16",0,0,9,0,0,9,0,0
"Singapore","2024-05-17",0,0,9,0,0,9,0,0
"Singapore","2024-05-18",0,0,9,0,0,9,0,0
"Singapore","2024-05-19",0,0,9,0,0,9,0,0
"Singapore","2024-05-20",0,0,9,0,0,9,0,0
"Singapore","2024-05-21",0,0,9,0,0,9,0,0
"Singapore","2024-05-22",0,0,9,0,0,9,0,0
"Singapore","2024-05-23",0,0,9,0,0,9,0,0
"Singapore","2024-05-24",0,0,9,0,0,9,0,0
"Singapore","2024-05-25",0,0,9,0,0,9,0,0
"Singapore","2024-05-26",0,0,9,0,0,9,0,0
"Singapore","2024-05-27",0,0,9,0,1,10,0,0
"Singapore","2024-05-28",0,0,9,0,0,10,0,0
"Singapore","2024-05-29",0,0,9,0,0,10,0,0
"Singapore","2024-05-30",0,0,9,0,0,10,0,0
"Singapore","2024-05-31",0,0,9,0,0,10,0,0
"Singapore","2024-06-01",0,0,9,0,0,10,0,0
"Singapore","2024-06-02",0,0,9,0,0,10,0,0
"Singapore","2024-06-03",0,0,9,0,0,10,0,0
"Singapore","2024-06-04",0,0,9,0,0,10,0,0
"Singapore","2024-06-05",0,0,9,0,0,10,0,0
"Singapore","2024-06-06",0,0,9,0,0,10,0,0
"Singapore","2024-06-07",0,0,9,0,0,10,0,0
"Singapore","2024-06-08",0,0,9,0,0,10,0,0
"Singapore","2024-06-09",0,0,9,0,0,10,0,0
"Singapore","2024-06-10",0,0,9,0,0,10,0,0
"Singapore","2024-06-11",0,0,9,0,0,10,0,0
"Singapore","2024-06-12",0,0,9,0,0,10,0,0
"Singapore","2024-06-13",0,0,9,0,0,10,0,0
"Singapore","2024-06-14",0,0,9,0,0,10,0,0
"Singapore","2024-06-15",0,0,9,0,0,10,0,0
"Singapore","2024-06-16",0,0,9,0,0,10,0,0
"Singapore","2024-06-17",0,0,9,0,0,10,0,0
"Singapore","2024-06-18",0,0,9,0,0,10,0,0
"Singapore","2024-06-19",0,0,9,0,0,10,0,0
"Singapore","2024-06-20",0,0,9,0,0,10,0,0
"Singapore","2024-06-21",0,0,9,0,0,10,0,0
"Singapore","2024-06-22",0,0,9,0,0,10,0,0
"Singapore","2024-06-23",0,0,9,0,0,10,0,0
"Singapore","2024-06-24",0,0,9,0,0,10,0,0
"Singapore","2024-06-25",0,1,10,0,0,10,0,0
"Singapore","2024-06-26",0,0,10,0,0,10,0,0
"Singapore","2024-06-27",0,0,10,0,0,10,0,0
"Singapore","2024-06-28",0,0,10,0,0,10,0,0
"Singapore","2024-06-29",0,0,10,0,0,10,0,0
"Singapore","2024-06-30",0,0,10,0,0,10,0,0
"Singapore","2024-07-01",0,0,10,0,0,10,0,0
"Singapore","2024-07-02",0,0,10,0,0,10,0,0
"Singapore","2024-07-03",0,0,10,0,0,10,0,0
"Singapore","2024-07-04",0,0,10,0,0,10,0,0
"Singapore","2024-07-05",0,0,10,0,1,11,0,0
"Singapore","2024-07-06",0,0,10,0,0,11,0,0
"Singapore","2024-07-07",0,0,10,0,0,11,0,0
"Singapore","2024-07-08",0,0,10,0,0,11,0,0
"Singapore","2024-07-09",0,0,10,0,0,11,0,0
"Singapore","2024-07-10",0,0,10,0,0,11,0,0
"Singapore","2024-07-11",0,0,10,0,0,11,0,0
"Singapore","2024-07-12",0,0,10,0,0,11,0,0
"Singapore","2024-07-13",0,1,11,0,0,11,0,0
"Singapore","2024-07-14",0,0,11,0,0,11,0,0
"Singapore","2024-07-15",0,0,11,0,0,11,0,0
"Singapore","2024-07-16",0,0,11,0,0,11,0,0
"Singapore","2024-07-17",0,0,11,0,0,11,0,0
"Singapore","2024-07-18",0,0,11,0,0,11,0,0
"Singapore","2024-07-19",0,0,11,0,0,11,0,0
"Singapore","2024-07-20",0,0,11,0,0,11,0,0
"Singapore","2024-07-21",0,0,11,0,0,11,0,0
"Singapore","2024-07-22",0,0,11,0,1,12,0,0
"Singapore","2024-07-23",0,0,11,0,0,12,0,0
"Singapore","2024-07-24",0,0,11,0,0,12,0,0
"Singapore","2024-07-25",0,0,11,0,0,12,0,0
"Singapore","2024-07-26",0,0,11,0,0,12,0,0
"Singapore","2024-07-27",0,0,11,0,0,12,0,0
"Singapore","2024-07-28",0,0,11,0,0,12,0,0
"Singapore","2024-07-29",0,0,11,0,0,12,0,0
"Singapore","2024-07-30",0,0,11,0,0,12,0,0
"Singapore","2024-07-31",0,0,11,0,0,12,0,0
"Singapore","2024-08-01",0,0,11,0,0,12,0,0
"Singapore","2024-08-02",0,0,11,0,0,12,0,0
"Singapore","2024-08-03",0,0,11,0,0,12,0,0
"Singapore","2024-08-04",0,0,11,0,0,12,0,0
"Singapore","2024-08-05",0,0,11,0,0,12,0,0
"Singapore","2024-08-06",0,0,11,0,0,12,0,0
"Singapore","2024-08-07",0,0,11,0,1,13,0,0
"Singapore","2024-08-08",0,0,11,0,0,13,0,0
"Singapore","2024-08-09",0,0,11,0,0,13,0,0
"Singapore","2024-08-10",0,0,11,0,0,13,0,0
"Singapore","2024-08-11",0,0,11,0,0,13,0,0
"Singapore","2024-08-12",0,0,11,0,0,13,0,0
"Singapore","2024-08-13",0,0,11,0,0,13,0,0
"Singapore","2024-08-14",0,0,11,0,0,13,0,0
"Singapore","2024-08-15",0,2,13,0,0,13,0,0
"Singapore","2024-08-16",0,0,13,0,0,13,0,0
"Singapore","2024-08-17",0,0,13,0,0,13,0,0
"Singapore","2024-08-18",0,0,13,0,0,13,0,0
"Singapore","2024-08-19",0,0,13,0,0,13,0,0
"Singapore","2024-08-20",0,0,13,0,1,14,0,0
"Singapore","2024-08-21",0,0,13,0,0,14,0,0
"Singapore","2024-08-22",0,0,13,0,0,14,0,0
"Singapore","2024-08-23",0,1,14,0,0,14,0,0
"Singapore","2024-08-24",0,0,14,0,0,14,0,0
"Singapore","2024-08-25",0,0,14,0,0,14,0,0
"Singapore","2024-08-26",0,0,14,0,0,14,0,0
"Singapore","2024-08-27",0,0,14,0,0,14,0,0
"Singapore","2024-08-28",0,0,14,0,0,14,0,0
"Singapore","2024-08-29",0,0,14,0,0,14,0,0
"Singapore","2024-08-30",0,0,14,0,0,14,0,0
"Singapore","2024-08-31",0,0,14,0,0,14,0,0
"Singapore","2024-09-01",0,0,14,0,1,15,0,0
"Singapore","2024-09-02",0,0,14,0,0,15,0,0
"Singapore","2024-09-03",0,0,14,0,0,15,0,0
"Singapore","2024-09-04",0,0,14,0,0,15,0,0
"Singapore","2024-09-05",0,0,14,0,0,15,0,0
"Singapore","2024-09-06",0,0,14,0,0,15,0,0
"Singapore","2024-09-07",0,0,14,0,0,15,0,0
"Singapore","2024-09-08",0,1,15,0,0,15,0,0
"Singapore","2024-09-09",0,0,15,0,0,15,0,0
"Singapore","2024-09-10",0,0,15,0,0,15,0,0
"Singapore","2024-09-11",0,0,15,0,0,15,0,0
"Singapore","2024-09-12",0,0,15,0,0,15,0,0
"Singapore","2024-09-13",0,0,15,0,0,15,0,0
"Singapore","2024-09-14",0,0,15,0,0,15,0,0
"Singapore","2024-09-15",0,0,15,0,0,15,0,0
"Singapore","2024-09-16",0,0,15,0,0,15,0,0
"Singapore","2024-09-17",0,0,15,0,1,16,0,0
"Singapore","2024-09-18",0,0,15,0,0,16,0,0
"Singapore","2024-09-19",0,0,15,0,0,16,0,0
"Singapore","2024-09-20",0,0,15,0,0,16,0,0
"Singapore","2024-09-21",0,0,15,0,0,16,0,0
"Singapore","2024-09-22",0,0,15,0,0,16,0,0
"Singapore","2024-09-23",0,0,15,0,0,16,0,0
"Singapore","2024-09-24",0,0,15,0,0,16,0,0
"Singapore","2024-09-25",0,0,15,0,0,16,0,0
"Singapore","2024-09-26",0,0,15,0,0,16,0,0
"Singapore","2024-09-27",0,0,15,0,0,16,0,0
"Singapore","2024-09-28",0,0,15,0,0,16,0,0
"Singapore","2024-09-29",0,0,15,0,0,16,0,0
"Singapore","2024-09-30",0,0,15,0,0,16,0,0
"Singapore","2024-10-01",0,0,15,0,0,16,0,0
"Singapore","2024-10-02",0,0,15,0,0,16,0,0
"Singapore","2024-10-03",0,0,15,0,1,17,0,0
"Singapore","2024-10-04",0,0,15,0,0,17,0,0
"Singapore","2024-10-05",0,0,15,0,0,17,0,0
"Singapore","2024-10-06",0,0,15,0,0,17,0,0
"Singapore","2024-10-07",0,0,15,0,0,17,0,0
"Singapore","2024-10-08",0,0,15,0,0,17,0,0
"Singapore","2024-10-09",0,0,15,0,0,17,0,0
"Singapore","2024-10-10",0,0,15,0,0,17,0,0
"Singapore","2024-10-11",0,2,17,0,0,17,0,0
"Singapore","2024-10-12",0,0,17,0,0,17,0,0
"Singapore","2024-10-13",0,0,17,0,0,17,0,0
"Singapore","2024-10-14",0,0,17,0,0,17,0,0
"Singapore","2024-10-15",0,0,17,0,0,17,0,0
"Singapore","2024-10-16",0,0,17,0,0,17,0,0
"Singapore","2024-10-17",0,0,17,0,0,17,0,0
"Singapore","2024-10-18",0,0,17,0,0,17,0,0
"Singapore","2024-10-19",0,0,17,0,0,17,0,0
"Singapore","2024-10-20",0,0,17,0,0,17,0,0
"Singapore","2024-10-21",0,0,17,0,0,17,0,0
"Singapore","2024-10-22",0,0,17,0,0,17,0,0
"Singapore","2024-10-23",0,0,17,0,0,17,0,0
"Singapore","2024-10-24",0,0,17,0,0,17,0,0
"Singapore","2024-10-25",0,0,17,0,0,17,0,0
"Singapore","2024-10-26",0,0,17,0,0,17,0,0
"Singapore","2024-10-27",0,0,17,0,0,17,0,0
"Singapore","2024-10-28",0,0,17,0,0,17,0,0
"Singapore","2024-10-29",0,0,17,0,0,17,0,0
"Singapore","2024-10-30",0,0,17,0,0,17,0,0
"Singapore","2024-10-31",0,0,17,0,0,17,0,0
"Singapore","2024-11-01",0,0,17,0,0,17,0,0
"Singapore","2024-11-02",0,0,17,0,0,17,0,0
"Singapore","2024-11-03",0,0,17,0,0,17,0,0
"Singapore","2024-11-04",0,0,17,0,0,17,0,0
"Singapore","2024-11-05",0,0,17,0,0,17,0,0
"Singapore","2024-11-06",0,0,17,0,0,17,0,0
"Singapore","2024-11-07",0,0,17,0,0,17,0,0
"Singapore","2024-11-08",0,0,17,0,0,17,0,0
"Singapore","2024-11-09",0,0,17,0,0,17,0,0
"Singapore","2024-11-10",0,0,17,0,0,17,0,0
"Singapore","2024-11-11",0,0,17,0,0,17,0,0
"Singapore","2024-11-12",0,0,17,0,0,17,0,0
"Singapore","2024-11-13",0,0,17,0,0,17,0,0
"Singapore","2024-11-14",0,0,17,0,0,17,0,0
"Singapore","2024-11-15",0,0,17,0,0,17,0,0
"Singapore","2024-11-16",0,0,17,0,0,17,0,0
"Singapore","2024-11-17",0,0,17,0,0,17,0,0
"Singapore","2024-11-18",0,0,17,0,0,17,0,0
"Singapore","2024-11-19",0,0,17,0,0,17,0,0
"Singapore","2024-11-20",0,0,17,0,0,17,0,0
"Singapore","2024-11-21",0,0,17,0,0,17,0,0
"Singapore","2024-11-22",0,0,17,0,0,17,0,0
"Singapore","2024-11-23",0,0,17,0,0,17,0,0
"Singapore","2024-11-24",0,0,17,0,0,17,0,0
"Singapore","2024-11-25",0,0,17,0,0,17,0,0
"Singapore","2024-11-26",0,0,17,0,0,17,0,0
"Singapore","2024-11-27",0,0,17,0,0,17,0,0
"Singapore","2024-11-28",0,0,17,0,0,17,0,0
"Singapore","2024-11-29",0,0,17,0,0,17,0,0
"Singapore","2024-11-30",0,0,17,0,0,17,0,0
"Singapore","2024-12-01",0,0,17,0,0,17,0,0
"Singapore","2024-12-02",0,0,17,0,0,17,0,0
"Singapore","2024-12-03",0,0,17,0,0,17,0,0
"Singapore","2024-12-04",0,0,17,0,0,17,0,0
"Singapore","2024-12-05",0,0,17,0,0,17,0,0
"Singapore","2024-12-06",0,0,17,0,0,17,0,0
"Singapore","2024-12-07",0,0,17,0,0,17,0,0
"Singapore","2024-12-08",0,0,17,0,0,17,0,0
"Singapore","2024-12-09",0,0,17,0,0,17,0,0
"Slovakia","2024-01-01",0,0,0,0,0,0,0,0
"Slovakia","2024-01-02",0,0,0,0,0,0,0,0
"Slovakia","2024-01-03",0,0,0,0,0,0,0,0
"Slovakia","2024-01-04",0,0,0,0,0,0,0,0
"Slovakia","2024-01-05",0,0,0,0,0,0,0,0
"Slovakia","2024-01-06",0,0,0,0,0,0,0,0
"Slovakia","2024-01-07",0,0,0,0,0,0,0,0
"Slovakia","2024-01-08",0,0,0,0,0,0,0,0
"Slovakia","2024-01-09",0,0,0,0,0,0,0,0
"Slovakia","2024-01-10",0,0,0,0,0,0,0,0
"Slovakia","2024-01-11",0,0,0,0,0,0,0,0
"Slovakia","2024-01-12",0,0,0,0,0,0,0,0
"Slovakia","2024-01-13",0,0,0,0,0,0,0,0
"Slovakia","2024-01-14",0,0,0,0,0,0,0,0
"Slovakia","2024-01-15",0,0,0,0,0,0,0,0
"Slovakia","2024-01-16",0,0,0,0,0,0,0,0
"Slovakia","2024-01-17",0,0,0,0,0,0,0,0
"Slovakia","2024-01-18",0,0,0,0,0,0,0,0
"Slovakia","2024-01-19",0,0,0,0,0,0,0,0
"Slovakia","2024-01-20",0,0,0,0,0,0,0,0
"Slovakia","2024-01-21",0,0,0,0,0,0,0,0
"Slovakia","2024-01-22",0,0,0,0,0,0,0,0
"Slovakia","2024-01-23",0,0,0,0,0,0,0,0
"Slovakia","2024-01-24",0,0,0,0,0,0,0,0
"Slovakia","2024-01-25",0,0,0,0,0,0,0,0
"Slovakia","2024-01-26",0,0,0,0,0,0,0,0
"Slovakia","2024-01-27",0,0,0,0,0,0,0,0
"Slovakia","2024-01-28",0,0,0,0,0,0,0,0
"Slovakia","2024-01-29",0,0,0,0,0,0,0,0
"Slovakia","2024-01-30",0,0,0,0,0,0,0,0
"Slovakia","2024-01-31",0,2,2,0,2,2,0,0
"Slovakia","2024-02-01",0,0,2,0,0,2,0,0
"Slovakia","2024-02-02",0,0,2,0,0,2,0,0
"Slovakia","2024-02-03",0,0,2,0,0,2,0,0
"Slovakia","2024-02-04",0,0,2,0,0,2,0,0
"Slovakia","2024-02-05",0,0,2,0,0,2,0,0
"Slovakia","2024-02-06",0,0,2,0,0,2,0,0
"Slovakia","2024-02-07",0,0,2,0,0,2,0,0
"Slovakia","2024-02-08",0,0,2,0,0,2,0,0
"Slovakia","2024-02-09",0,0,2,0,0,2,0,0
"Slovakia","2024-02-10",0,0,2,0,0,2,0,0
"Slovakia","2024-02-11",0,0,2,0,0,2,0,0
"Slovakia","2024-02-12",0,0,2,0,0,2,0,0
"Slovakia","2024-02-13",0,0,2,0,0,2,0,0
"Slovakia","2024-02-14",0,0,2,0,0,2,0,0
"Slovakia","2024-02-15",0,0,2,0,0,2,0,0
"Slovakia","2024-02-16",0,0,2,0,0,2,0,0
"Slovakia","2024-02-17",0,0,2,0,0,2,0,0
"Slovakia","2024-02-18",0,0,2,0,0,2,0,0
"Slovakia","2024-02-19",0,0,2,0,0,2,0,0
"Slovakia","2024-02-20",0,0,2,0,0,2,0,0
"Slovakia","2024-02-21",0,0,2,0,0,2,0,0
"Slovakia","2024-02-22",0,0,2,0,0,2,0,0
"Slovakia","2024-02-23",0,0,2,0,0,2,0,0
"Slovakia","2024-02-24",0,0,2,0,0,2,0,0
"Slovakia","2024-02-25",0,0,2,0,0,2,0,0
"Slovakia","2024-02-26",0,0,2,0,0,2,0,0
"Slovakia","2024-02-27",0,0,2,0,0,2,0,0
"Slovakia","2024-02-28",0,0,2,0,0,2,0,0
"Slovakia","2024-02-29",0,0,2,0,0,2,0,0
"Slovakia","2024-03-01",0,0,2,0,0,2,0,0
"Slovakia","2024-03-02",0,0,2,0,0,2,0,0
"Slovakia","2024-03-03",0,0,2,0,0,2,0,0
"Slovakia","2024-03-04",0,0,2,0,0,2,0,0
"Slovakia","2024-03-05",0,0,2,0,0,2,0,0
"Slovakia","2024-03-06",0,0,2,0,0,2,0,0
"Slovakia","2024-03-07",0,0,2,0,0,2,0,0
"Slovakia","2024-03-08",0,0,2,0,0,2,0,0
"Slovakia","2024-03-09",0,0,2,0,0,2,0,0
"Slovakia","2024-03-10",0,0,2,0,0,2,0,0
"Slovakia","2024-03-11",0,0,2,0,0,2,0,0
"Slovakia","2024-03-12",0,0,2,0,0,2,0,0
"Slovakia","2024-03-13",0,0,2,0,0,2,0,0
"Slovakia","2024-03-14",0,0,2,0,0,2,0,0
"Slovakia","2024-03-15",0,0,2,0,0,2,0,0
"Slovakia","2024-03-16",0,0,2,0,0,2,0,0
"Slovakia","2024-03-17",0,0,2,0,0,2,0,0
"Slovakia","2024-03-18",0,0,2,0,0,2,0,0
"Slovakia","2024-03-19",0,0,2,0,0,2,0,0
"Slovakia","2024-03-20",0,0,2,0,0,2,0,0
"Slovakia","2024-03-21",0,0,2,0,0,2,0,0
"Slovakia","2024-03-22",0,0,2,0,0,2,0,0
"Slovakia","2024-03-23",0,0,2,0,0,2,0,0
"Slovakia","2024-03-24",0,0,2,0,0,2,0,0
"Slovakia","2024-03-25",0,0,2,0,0,2,0,0
"Slovakia","2024-03-26",0,0,2,0,0,2,0,0
"Slovakia","2024-03-27",0,0,2,0,0,2,0,0
"Slovakia","2024-03-28",0,0,2,0,0,2,0,0
"Slovakia","2024-03-29",0,0,2,0,0,2,0,0
"Slovakia","2024-03-30",0,0,2,0,0,2,0,0
"Slovakia","2024-03-31",0,0,2,0,0,2,0,0
"Slovakia","2024-04-01",0,0,2,0,0,2,0,0
"Slovakia","2024-04-02",0,0,2,0,0,2,0,0
"Slovakia","2024-04-03",0,0,2,0,0,2,0,0
"Slovakia","2024-04-04",0,0,2,0,0,2,0,0
"Slovakia","2024-04-05",0,0,2,0,0,2,0,0
"Slovakia","2024-04-06",0,0,2,0,0,2,0,0
"Slovakia","2024-04-07",0,0,2,0,0,2,0,0
"Slovakia","2024-04-08",0,0,2,0,0,2,0,0
"Slovakia","2024-04-09",0,0,2,0,0,2,0,0
"Slovakia","2024-04-10",0,0,2,0,0,2,0,0
"Slovakia","2024-04-11",0,0,2,0,0,2,0,0
"Slovakia","2024-04-12",0,0,2,0,0,2,0,0
"Slovakia","2024-04-13",0,0,2,0,0,2,0,0
"Slovakia","2024-04-14",0,0,2,0,0,2,0,0
"Slovakia","2024-04-15",0,0,2,0,0,2,0,0
"Slovakia","2024-04-16",0,0,2,0,0,2,0,0
"Slovakia","2024-04-17",0,0,2,0,0,2,0,0
"Slovakia","2024-04-18",0,0,2,0,0,2,0,0
"Slovakia","2024-04-19",0,0,2,0,0,2,0,0
"Slovakia","2024-04-20",0,0,2,0,0,2,0,0
"Slovakia","2024-04-21",0,0,2,0,0,2,0,0
"Slovakia","2024-04-22",0,0,2,0,0,2,0,0
"Slovakia","2024-04-23",0,0,2,0,0,2,0,0
"Slovakia","2024-04-24",0,0,2,0,0,2,0,0
"Slovakia","2024-04-25",0,0,2,0,0,2,0,0
"Slovakia","2024-04-26",0,0,2,0,0,2,0,0
"Slovakia","2024-04-27",0,0,2,0,0,2,0,0
"Slovakia","2024-04-28",0,0,2,0,0,2,0,0
"Slovakia","2024-04-29",0,0,2,0,0,2,0,0
"Slovakia","2024-04-30",0,0,2,0,0,2,0,0
"Slovakia","2024-05-01",0,0,2,0,0,2,0,0
"Slovakia","2024-05-02",0,0,2,0,0,2,0,0
"Slovakia","2024-05-03",0,0,2,0,0,2,0,0
"Slovakia","2024-05-04",0,0,2,0,0,2,0,0
"Slovakia","2024-05-05",0,0,2,0,0,2,0,0
"Slovakia","2024-05-06",0,0,2,0,0,2,0,0
"Slovakia","2024-05-07",0,0,2,0,0,2,0,0
"Slovakia","2024-05-08",0,0,2,0,0,2,0,0
"Slovakia","2024-05-09",0,0,2,0,0,2,0,0
"Slovakia","2024-05-10",0,0,2,0,0,2,0,0
"Slovakia","2024-05-11",0,0,2,0,0,2,0,0
"Slovakia","2024-05-12",0,0,2,0,0,2,0,0
"Slovakia","2024-05-13",0,0,2,0,0,2,0,0
"Slovakia","2024-05-14",0,0,2,0,0,2,0,0
"Slovakia","2024-05-15",0,0,2,0,0,2,0,0
"Slovakia","2024-05-16",0,0,2,0,0,2,0,0
"Slovakia","2024-05-17",0,0,2,0,0,2,0,0
"Slovakia","2024-05-18",0,0,2,0,0,2,0,0
"Slovakia","2024-05-19",0,0,2,0,0,2,0,0
"Slovakia","2024-05-20",0,0,2,0,0,2,0,0
"Slovakia","2024-05-21",0,0,2,0,0,2,0,0
"Slovakia","2024-05-22",0,0,2,0,0,2,0,0
"Slovakia","2024-05-23",0,0,2,0,0,2,0,0
"Slovakia","2024-05-24",0,0,2,0,0,2,0,0
"Slovakia","2024-05-25",0,0,2,0,0,2,0,0
"Slovakia","2024-05-26",0,0,2,0,0,2,0,0
"Slovakia","2024-05-27",0,0,2,0,0,2,0,0
"Slovakia","2024-05-28",0,0,2,0,0,2,0,0
"Slovakia","2024-05-29",0,0,2,0,0,2,0,0
"Slovakia","2024-05-30",0,0,2,0,0,2,0,0
"Slovakia","2024-05-31",0,0,2,0,0,2,0,0
"Slovakia","2024-06-01",0,0,2,0,0,2,0,0
"Slovakia","2024-06-02",0,0,2,0,0,2,0,0
"Slovakia","2024-06-03",0,0,2,0,0,2,0,0
"Slovakia","2024-06-04",0,0,2,0,0,2,0,0
"Slovakia","2024-06-05",0,0,2,0,0,2,0,0
"Slovakia","2024-06-06",0,0,2,0,0,2,0,0
"Slovakia","2024-06-07",0,0,2,0,0,2,0,0
"Slovakia","2024-06-08",0,0,2,0,0,2,0,0
"Slovakia","2024-06-09",0,0,2,0,0,2,0,0
"Slovakia","2024-06-10",0,0,2,0,0,2,0,0
"Slovakia","2024-06-11",0,0,2,0,0,2,0,0
"Slovakia","2024-06-12",0,0,2,0,0,2,0,0
"Slovakia","2024-06-13",0,0,2,0,0,2,0,0
"Slovakia","2024-06-14",0,0,2,0,0,2,0,0
"Slovakia","2024-06-15",0,0,2,0,0,2,0,0
"Slovakia","2024-06-16",0,0,2,0,0,2,0,0
"Slovakia","2024-06-17",0,0,2,0,0,2,0,0
"Slovakia","2024-06-18",0,0,2,0,0,2,0,0
"Slovakia","2024-06-19",0,0,2,0,0,2,0,0
"Slovakia","2024-06-20",0,0,2,0,0,2,0,0
"Slovakia","2024-06-21",0,0,2,0,0,2,0,0
"Slovakia","2024-06-22",0,0,2,0,0,2,0,0
"Slovakia","2024-06-23",0,0,2,0,0,2,0,0
"Slovakia","2024-06-24",0,0,2,0,0,2,0,0
"Slovakia","2024-06-25",0,0,2,0,0,2,0,0
"Slovakia","2024-06-26",0,0,2,0,0,2,0,0
"Slovakia","2024-06-27",0,0,2,0,0,2,0,0
"Slovakia","2024-06-28",0,0,2,0,0,2,0,0
"Slovakia","2024-06-29",0,0,2,0,0,2,0,0
"Slovakia","2024-06-30",0,0,2,0,0,2,0,0
"Slovakia","2024-07-01",0,0,2,0,0,2,0,0
"Slovakia","2024-07-02",0,0,2,0,0,2,0,0
"Slovakia","2024-07-03",0,0,2,0,0,2,0,0
"Slovakia","2024-07-04",0,0,2,0,0,2,0,0
"Slovakia","2024-07-05",0,0,2,0,0,2,0,0
"Slovakia","2024-07-06",0,0,2,0,0,2,0,0
"Slovakia","2024-07-07",0,0,2,0,0,2,0,0
"Slovakia","2024-07-08",0,0,2,0,0,2,0,0
"Slovakia","2024-07-09",0,0,2,0,0,2,0,0
"Slovakia","2024-07-10",0,0,2,0,0,2,0,0
"Slovakia","2024-07-11",0,0,2,0,0,2,0,0
"Slovakia","2024-07-12",0,0,2,0,0,2,0,0
"Slovakia","2024-07-13",0,0,2,0,0,2,0,0
"Slovakia","2024-07-14",0,0,2,0,0,2,0,0
"Slovakia","2024-07-15",0,0,2,0,0,2,0,0
"Slovakia","2024-07-16",0,0,2,0,0,2,0,0
"Slovakia","2024-07-17",0,0,2,0,0,2,0,0
"Slovakia","2024-07-18",0,0,2,0,0,2,0,0
"Slovakia","2024-07-19",0,0,2,0,0,2,0,0
"Slovakia","2024-07-20",0,0,2,0,0,2,0,0
"Slovakia","2024-07-21",0,0,2,0,0,2,0,0
"Slovakia","2024-07-22",0,0,2,0,0,2,0,0
"Slovakia","2024-07-23",0,0,2,0,0,2,0,0
"Slovakia","2024-07-24",0,0,2,0,0,2,0,0
"Slovakia","2024-07-25",0,0,2,0,0,2,0,0
"Slovakia","2024-07-26",0,0,2,0,0,2,0,0
"Slovakia","2024-07-27",0,0,2,0,0,2,0,0
"Slovakia","2024-07-28",0,0,2,0,0,2,0,0
"Slovakia","2024-07-29",0,0,2,0,0,2,0,0
"Slovakia","2024-07-30",0,0,2,0,0,2,0,0
"Slovakia","2024-07-31",0,0,2,0,0,2,0,0
"Slovakia","2024-08-01",0,0,2,0,0,2,0,0
"Slovakia","2024-08-02",0,0,2,0,0,2,0,0
"Slovakia","2024-08-03",0,0,2,0,0,2,0,0
"Slovakia","2024-08-04",0,0,2,0,0,2,0,0
"Slovakia","2024-08-05",0,0,2,0,0,2,0,0
"Slovakia","2024-08-06",0,0,2,0,0,2,0,0
"Slovakia","2024-08-07",0,0,2,0,0,2,0,0
"Slovakia","2024-08-08",0,0,2,0,0,2,0,0
"Slovakia","2024-08-09",0,0,2,0,0,2,0,0
"Slovakia","2024-08-10",0,0,2,0,0,2,0,0
"Slovakia","2024-08-11",0,0,2,0,0,2,0,0
"Slovakia","2024-08-12",0,0,2,0,0,2,0,0
"Slovakia","2024-08-13",0,0,2,0,0,2,0,0
"Slovakia","2024-08-14",0,0,2,0,0,2,0,0
"Slovakia","2024-08-15",0,0,2,0,0,2,0,0
"Slovakia","2024-08-16",0,0,2,0,0,2,0,0
"Slovakia","2024-08-17",0,0,2,0,0,2,0,0
"Slovakia","2024-08-18",0,0,2,0,0,2,0,0
"Slovakia","2024-08-19",0,0,2,0,0,2,0,0
"Slovakia","2024-08-20",0,0,2,0,0,2,0,0
"Slovakia","2024-08-21",0,0,2,0,0,2,0,0
"Slovakia","2024-08-22",0,0,2,0,0,2,0,0
"Slovakia","2024-08-23",0,0,2,0,0,2,0,0
"Slovakia","2024-08-24",0,0,2,0,0,2,0,0
"Slovakia","2024-08-25",0,0,2,0,0,2,0,0
"Slovakia","2024-08-26",0,0,2,0,0,2,0,0
"Slovakia","2024-08-27",0,0,2,0,0,2,0,0
"Slovakia","2024-08-28",0,0,2,0,0,2,0,0
"Slovakia","2024-08-29",0,0,2,0,0,2,0,0
"Slovakia","2024-08-30",0,0,2,0,0,2,0,0
"Slovakia","2024-08-31",0,0,2,0,0,2,0,0
"Slovakia","2024-09-01",0,0,2,0,0,2,0,0
"Slovakia","2024-09-02",0,0,2,0,0,2,0,0
"Slovakia","2024-09-03",0,0,2,0,0,2,0,0
"Slovakia","2024-09-04",0,0,2,0,0,2,0,0
"Slovakia","2024-09-05",0,0,2,0,0,2,0,0
"Slovakia","2024-09-06",0,0,2,0,0,2,0,0
"Slovakia","2024-09-07",0,0,2,0,0,2,0,0
"Slovakia","2024-09-08",0,0,2,0,0,2,0,0
"Slovakia","2024-09-09",0,0,2,0,0,2,0,0
"Slovakia","2024-09-10",0,0,2,0,0,2,0,0
"Slovakia","2024-09-11",0,0,2,0,0,2,0,0
"Slovakia","2024-09-12",0,0,2,0,0,2,0,0
"Slovakia","2024-09-13",0,0,2,0,0,2,0,0
"Slovakia","2024-09-14",0,0,2,0,0,2,0,0
"Slovakia","2024-09-15",0,0,2,0,0,2,0,0
"Slovakia","2024-09-16",0,0,2,0,0,2,0,0
"Slovakia","2024-09-17",0,0,2,0,0,2,0,0
"Slovakia","2024-09-18",0,0,2,0,0,2,0,0
"Slovakia","2024-09-19",0,0,2,0,0,2,0,0
"Slovakia","2024-09-20",0,0,2,0,0,2,0,0
"Slovakia","2024-09-21",0,0,2,0,0,2,0,0
"Slovakia","2024-09-22",0,0,2,0,0,2,0,0
"Slovakia","2024-09-23",0,0,2,0,0,2,0,0
"Slovakia","2024-09-24",0,0,2,0,0,2,0,0
"Slovakia","2024-09-25",0,0,2,0,0,2,0,0
"Slovakia","2024-09-26",0,0,2,0,0,2,0,0
"Slovakia","2024-09-27",0,0,2,0,0,2,0,0
"Slovakia","2024-09-28",0,0,2,0,0,2,0,0
"Slovakia","2024-09-29",0,0,2,0,0,2,0,0
"Slovakia","2024-09-30",0,0,2,0,0,2,0,0
"Slovakia","2024-10-01",0,0,2,0,0,2,0,0
"Slovakia","2024-10-02",0,0,2,0,0,2,0,0
"Slovakia","2024-10-03",0,0,2,0,0,2,0,0
"Slovakia","2024-10-04",0,0,2,0,0,2,0,0
"Slovakia","2024-10-05",0,0,2,0,0,2,0,0
"Slovakia","2024-10-06",0,0,2,0,0,2,0,0
"Slovakia","2024-10-07",0,0,2,0,0,2,0,0
"Slovakia","2024-10-08",0,0,2,0,0,2,0,0
"Slovakia","2024-10-09",0,0,2,0,0,2,0,0
"Slovakia","2024-10-10",0,0,2,0,0,2,0,0
"Slovakia","2024-10-11",0,0,2,0,0,2,0,0
"Slovakia","2024-10-12",0,0,2,0,0,2,0,0
"Slovakia","2024-10-13",0,0,2,0,0,2,0,0
"Slovakia","2024-10-14",0,0,2,0,0,2,0,0
"Slovakia","2024-10-15",0,0,2,0,0,2,0,0
"Slovakia","2024-10-16",0,0,2,0,0,2,0,0
"Slovakia","2024-10-17",0,0,2,0,0,2,0,0
"Slovakia","2024-10-18",0,0,2,0,0,2,0,0
"Slovakia","2024-10-19",0,0,2,0,0,2,0,0
"Slovakia","2024-10-20",0,0,2,0,0,2,0,0
"Slovakia","2024-10-21",0,0,2,0,0,2,0,0
"Slovakia","2024-10-22",0,0,2,0,0,2,0,0
"Slovakia","2024-10-23",0,0,2,0,0,2,0,0
"Slovakia","2024-10-24",0,0,2,0,0,2,0,0
"Slovakia","2024-10-25",0,0,2,0,0,2,0,0
"Slovakia","2024-10-26",0,0,2,0,0,2,0,0
"Slovakia","2024-10-27",0,0,2,0,0,2,0,0
"Slovakia","2024-10-28",0,0,2,0,0,2,0,0
"Slovakia","2024-10-29",0,0,2,0,0,2,0,0
"Slovakia","2024-10-30",0,0,2,0,0,2,0,0
"Slovakia","2024-10-31",0,0,2,0,0,2,0,0
"Slovakia","2024-11-01",0,0,2,0,0,2,0,0
"Slovakia","2024-11-02",0,0,2,0,0,2,0,0
"Slovakia","2024-11-03",0,0,2,0,0,2,0,0
"Slovakia","2024-11-04",0,0,2,0,0,2,0,0
"Slovakia","2024-11-05",0,0,2,0,0,2,0,0
"Slovakia","2024-11-06",0,0,2,0,0,2,0,0
"Slovakia","2024-11-07",0,0,2,0,0,2,0,0
"Slovakia","2024-11-08",0,0,2,0,0,2,0,0
"Slovakia","2024-11-09",0,0,2,0,0,2,0,0
"Slovakia","2024-11-10",0,0,2,0,0,2,0,0
"Slovakia","2024-11-11",0,0,2,0,0,2,0,0
"Slovakia","2024-11-12",0,0,2,0,0,2,0,0
"Slovakia","2024-11-13",0,0,2,0,0,2,0,0
"Slovakia","2024-11-14",0,0,2,0,0,2,0,0
"Slovakia","2024-11-15",0,0,2,0,0,2,0,0
"Slovakia","2024-11-16",0,0,2,0,0,2,0,0
"Slovakia","2024-11-17",0,0,2,0,0,2,0,0
"Slovakia","2024-11-18",0,0,2,0,0,2,0,0
"Slovakia","2024-11-19",0,0,2,0,0,2,0,0
"Slovakia","2024-11-20",0,0,2,0,0,2,0,0
"Slovakia","2024-11-21",0,0,2,0,0,2,0,0
"Slovakia","2024-11-22",0,0,2,0,0,2,0,0
"Slovakia","2024-11-23",0,0,2,0,0,2,0,0
"Slovakia","2024-11-24",0,0,2,0,0,2,0,0
"Slovakia","2024-11-25",0,0,2,0,0,2,0,0
"Slovakia","2024-11-26",0,0,2,0,0,2,0,0
"Slovakia","2024-11-27",0,0,2,0,0,2,0,0
"Slovakia","2024-11-28",0,0,2,0,0,2,0,0
"Slovakia","2024-11-29",0,0,2,0,0,2,0,0
"Slovakia","2024-11-30",0,0,2,0,0,2,0,0
"Slovakia","2024-12-01",0,0,2,0,0,2,0,0
"Slovakia","2024-12-02",0,0,2,0,0,2,0,0
"Slovakia","2024-12-03",0,0,2,0,0,2,0,0
"Slovakia","2024-12-04",0,0,2,0,0,2,0,0
"Slovakia","2024-12-05",0,0,2,0,0,2,0,0
"Slovakia","2024-12-06",0,0,2,0,0,2,0,0
"Slovakia","2024-12-07",0,0,2,0,0,2,0,0
"Slovakia","2024-12-08",0,0,2,0,0,2,0,0
"Slovakia","2024-12-09",0,0,2,0,0,2,0,0
"Slovenia","2024-01-01",0,0,0,0,0,0,0,0
"Slovenia","2024-01-02",0,0,0,0,0,0,0,0
"Slovenia","2024-01-03",0,0,0,0,0,0,0,0
"Slovenia","2024-01-04",0,0,0,0,0,0,0,0
"Slovenia","2024-01-05",0,0,0,0,0,0,0,0
"Slovenia","2024-01-06",0,0,0,0,0,0,0,0
"Slovenia","2024-01-07",0,0,0,0,0,0,0,0
"Slovenia","2024-01-08",0,0,0,0,0,0,0,0
"Slovenia","2024-01-09",0,0,0,0,0,0,0,0
"Slovenia","2024-01-10",0,0,0,0,0,0,0,0
"Slovenia","2024-01-11",0,0,0,0,0,0,0,0
"Slovenia","2024-01-12",0,0,0,0,0,0,0,0
"Slovenia","2024-01-13",0,0,0,0,0,0,0,0
"Slovenia","2024-01-14",0,0,0,0,0,0,0,0
"Slovenia","2024-01-15",0,0,0,0,0,0,0,0
"Slovenia","2024-01-16",0,0,0,0,0,0,0,0
"Slovenia","2024-01-17",0,0,0,0,0,0,0,0
"Slovenia","2024-01-18",0,0,0,0,0,0,0,0
"Slovenia","2024-01-19",0,0,0,0,0,0,0,0
"Slovenia","2024-01-20",0,0,0,0,0,0,0,0
"Slovenia","2024-01-21",0,0,0,0,0,0,0,0
"Slovenia","2024-01-22",0,0,0,0,0,0,0,0
"Slovenia","2024-01-23",0,0,0,0,0,0,0,0
"Slovenia","2024-01-24",0,0,0,0,0,0,0,0
"Slovenia","2024-01-25",0,0,0,0,0,0,0,0
"Slovenia","2024-01-26",0,0,0,0,0,0,0,0
"Slovenia","2024-01-27",0,0,0,0,0,0,0,0
"Slovenia","2024-01-28",0,0,0,0,0,0,0,0
"Slovenia","2024-01-29",0,0,0,0,0,0,0,0
"Slovenia","2024-01-30",0,0,0,0,0,0,0,0
"Slovenia","2024-01-31",0,0,0,0,0,0,0,0
"Slovenia","2024-02-01",0,0,0,0,0,0,0,0
"Slovenia","2024-02-02",0,0,0,0,0,0,0,0
"Slovenia","2024-02-03",0,0,0,0,0,0,0,0
"Slovenia","2024-02-04",0,0,0,0,0,0,0,0
"Slovenia","2024-02-05",0,0,0,0,0,0,0,0
"Slovenia","2024-02-06",0,0,0,0,0,0,0,0
"Slovenia","2024-02-07",0,0,0,0,0,0,0,0
"Slovenia","2024-02-08",0,0,0,0,0,0,0,0
"Slovenia","2024-02-09",0,0,0,0,0,0,0,0
"Slovenia","2024-02-10",0,0,0,0,0,0,0,0
"Slovenia","2024-02-11",0,0,0,0,0,0,0,0
"Slovenia","2024-02-12",0,0,0,0,0,0,0,0
"Slovenia","2024-02-13",0,0,0,0,0,0,0,0
"Slovenia","2024-02-14",0,0,0,0,0,0,0,0
"Slovenia","2024-02-15",0,0,0,0,0,0,0,0
"Slovenia","2024-02-16",0,0,0,0,0,0,0,0
"Slovenia","2024-02-17",0,0,0,0,0,0,0,0
"Slovenia","2024-02-18",0,0,0,0,0,0,0,0
"Slovenia","2024-02-19",0,0,0,0,0,0,0,0
"Slovenia","2024-02-20",0,0,0,0,0,0,0,0
"Slovenia","2024-02-21",0,0,0,0,0,0,0,0
"Slovenia","2024-02-22",0,0,0,0,0,0,0,0
"Slovenia","2024-02-23",0,0,0,0,0,0,0,0
"Slovenia","2024-02-24",0,0,0,0,0,0,0,0
"Slovenia","2024-02-25",0,0,0,0,0,0,0,0
"Slovenia","2024-02-26",0,0,0,0,0,0,0,0
"Slovenia","2024-02-27",0,0,0,0,0,0,0,0
"Slovenia","2024-02-28",0,0,0,0,0,0,0,0
"Slovenia","2024-02-29",0,0,0,0,0,0,0,0
"Slovenia","2024-03-01",0,0,0,0,0,0,0,0
"Slovenia","2024-03-02",0,0,0,0,0,0,0,0
"Slovenia","2024-03-03",0,0,0,0,0,0,0,0
"Slovenia","2024-03-04",0,0,0,0,0,0,0,0
"Slovenia","2024-03-05",0,0,0,0,0,0,0,0
"Slovenia","2024-03-06",0,0,0,0,0,0,0,0
"Slovenia","2024-03-07",0,0,0,0,0,0,0,0
"Slovenia","2024-03-08",0,0,0,0,0,0,0,0
"Slovenia","2024-03-09",0,0,0,0,0,0,0,0
"Slovenia","2024-03-10",0,0,0,0,0,0,0,0
"Slovenia","2024-03-11",0,0,0,0,0,0,0,0
"Slovenia","2024-03-12",0,0,0,0,0,0,0,0
"Slovenia","2024-03-13",0,0,0,0,0,0,0,0
"Slovenia","2024-03-14",0,0,0,0,0,0,0,0
"Slovenia","2024-03-15",0,0,0,0,0,0,0,0
"Slovenia","2024-03-16",0,0,0,0,0,0,0,0
"Slovenia","2024-03-17",0,0,0,0,0,0,0,0
"Slovenia","2024-03-18",0,0,0,0,0,0,0,0
"Slovenia","2024-03-19",0,0,0,0,0,0,0,0
"Slovenia","2024-03-20",0,0,0,0,0,0,0,0
"Slovenia","2024-03-21",0,0,0,0,0,0,0,0
"Slovenia","2024-03-22",0,0,0,0,0,0,0,0
"Slovenia","2024-03-23",0,0,0,0,0,0,0,0
"Slovenia","2024-03-24",0,0,0,0,0,0,0,0
"Slovenia","2024-03-25",0,0,0,0,0,0,0,0
"Slovenia","2024-03-26",0,0,0,0,0,0,0,0
"Slovenia","2024-03-27",0,0,0,0,0,0,0,0
"Slovenia","2024-03-28",0,0,0,0,0,0,0,0
"Slovenia","2024-03-29",0,0,0,0,0,0,0,0
"Slovenia","2024-03-30",0,0,0,0,0,0,0,0
"Slovenia","2024-03-31",0,0,0,0,0,0,0,0
"Slovenia","2024-04-01",0,0,0,0,0,0,0,0
"Slovenia","2024-04-02",0,0,0,0,0,0,0,0
"Slovenia","2024-04-03",0,0,0,0,0,0,0,0
"Slovenia","2024-04-04",0,0,0,0,0,0,0,0
"Slovenia","2024-04-05",0,0,0,0,0,0,0,0
"Slovenia","2024-04-06",0,0,0,0,0,0,0,0
"Slovenia","2024-04-07",0,0,0,0,0,0,0,0
"Slovenia","2024-04-08",0,0,0,0,0,0,0,0
"Slovenia","2024-04-09",0,0,0,0,0,0,0,0
"Slovenia","2024-04-10",0,0,0,0,0,0,0,0
"Slovenia","2024-04-11",0,0,0,0,0,0,0,0
"Slovenia","2024-04-12",0,0,0,0,0,0,0,0
"Slovenia","2024-04-13",0,0,0,0,0,0,0,0
"Slovenia","2024-04-14",0,0,0,0,0,0,0,0
"Slovenia","2024-04-15",0,0,0,0,0,0,0,0
"Slovenia","2024-04-16",0,0,0,0,0,0,0,0
"Slovenia","2024-04-17",0,0,0,0,0,0,0,0
"Slovenia","2024-04-18",0,0,0,0,0,0,0,0
"Slovenia","2024-04-19",0,0,0,0,0,0,0,0
"Slovenia","2024-04-20",0,0,0,0,0,0,0,0
"Slovenia","2024-04-21",0,0,0,0,0,0,0,0
"Slovenia","2024-04-22",0,0,0,0,0,0,0,0
"Slovenia","2024-04-23",0,0,0,0,0,0,0,0
"Slovenia","2024-04-24",0,0,0,0,0,0,0,0
"Slovenia","2024-04-25",0,0,0,0,0,0,0,0
"Slovenia","2024-04-26",0,0,0,0,0,0,0,0
"Slovenia","2024-04-27",0,0,0,0,0,0,0,0
"Slovenia","2024-04-28",0,0,0,0,0,0,0,0
"Slovenia","2024-04-29",0,0,0,0,0,0,0,0
"Slovenia","2024-04-30",0,0,0,0,0,0,0,0
"Slovenia","2024-05-01",0,0,0,0,0,0,0,0
"Slovenia","2024-05-02",0,0,0,0,0,0,0,0
"Slovenia","2024-05-03",0,0,0,0,0,0,0,0
"Slovenia","2024-05-04",0,0,0,0,0,0,0,0
"Slovenia","2024-05-05",0,0,0,0,0,0,0,0
"Slovenia","2024-05-06",0,0,0,0,0,0,0,0
"Slovenia","2024-05-07",0,0,0,0,0,0,0,0
"Slovenia","2024-05-08",0,0,0,0,0,0,0,0
"Slovenia","2024-05-09",0,0,0,0,0,0,0,0
"Slovenia","2024-05-10",0,0,0,0,0,0,0,0
"Slovenia","2024-05-11",0,0,0,0,0,0,0,0
"Slovenia","2024-05-12",0,0,0,0,0,0,0,0
"Slovenia","2024-05-13",0,0,0,0,0,0,0,0
"Slovenia","2024-05-14",0,0,0,0,0,0,0,0
"Slovenia","2024-05-15",0,0,0,0,0,0,0,0
"Slovenia","2024-05-16",0,0,0,0,0,0,0,0
"Slovenia","2024-05-17",0,0,0,0,0,0,0,0
"Slovenia","2024-05-18",0,0,0,0,0,0,0,0
"Slovenia","2024-05-19",0,0,0,0,0,0,0,0
"Slovenia","2024-05-20",0,0,0,0,0,0,0,0
"Slovenia","2024-05-21",0,0,0,0,0,0,0,0
"Slovenia","2024-05-22",0,0,0,0,0,0,0,0
"Slovenia","2024-05-23",0,0,0,0,0,0,0,0
"Slovenia","2024-05-24",0,0,0,0,0,0,0,0
"Slovenia","2024-05-25",0,0,0,0,0,0,0,0
"Slovenia","2024-05-26",0,0,0,0,0,0,0,0
"Slovenia","2024-05-27",0,0,0,0,0,0,0,0
"Slovenia","2024-05-28",0,0,0,0,0,0,0,0
"Slovenia","2024-05-29",0,0,0,0,0,0,0,0
"Slovenia","2024-05-30",0,0,0,0,0,0,0,0
"Slovenia","2024-05-31",0,0,0,0,0,0,0,0
"Slovenia","2024-06-01",0,0,0,0,0,0,0,0
"Slovenia","2024-06-02",0,0,0,0,0,0,0,0
"Slovenia","2024-06-03",0,0,0,0,0,0,0,0
"Slovenia","2024-06-04",0,0,0,0,0,0,0,0
"Slovenia","2024-06-05",0,0,0,0,0,0,0,0
"Slovenia","2024-06-06",0,0,0,0,0,0,0,0
"Slovenia","2024-06-07",0,0,0,0,0,0,0,0
"Slovenia","2024-06-08",0,0,0,0,0,0,0,0
"Slovenia","2024-06-09",0,0,0,0,0,0,0,0
"Slovenia","2024-06-10",0,0,0,0,0,0,0,0
"Slovenia","2024-06-11",0,0,0,0,0,0,0,0
"Slovenia","2024-06-12",0,0,0,0,0,0,0,0
"Slovenia","2024-06-13",0,0,0,0,0,0,0,0
"Slovenia","2024-06-14",0,0,0,0,0,0,0,0
"Slovenia","2024-06-15",0,0,0,0,0,0,0,0
"Slovenia","2024-06-16",0,0,0,0,0,0,0,0
"Slovenia","2024-06-17",0,0,0,0,0,0,0,0
"Slovenia","2024-06-18",0,0,0,0,0,0,0,0
"Slovenia","2024-06-19",0,0,0,0,0,0,0,0
"Slovenia","2024-06-20",0,0,0,0,0,0,0,0
"Slovenia","2024-06-21",0,0,0,0,0,0,0,0
"Slovenia","2024-06-22",0,0,0,0,0,0,0,0
"Slovenia","2024-06-23",0,0,0,0,0,0,0,0
"Slovenia","2024-06-24",0,0,0,0,0,0,0,0
"Slovenia","2024-06-25",0,0,0,0,0,0,0,0
"Slovenia","2024-06-26",0,0,0,0,0,0,0,0
"Slovenia","2024-06-27",0,0,0,0,0,0,0,0
"Slovenia","2024-06-28",0,0,0,0,0,0,0,0
"Slovenia","2024-06-29",0,0,0,0,0,0,0,0
"Slovenia","2024-06-30",0,0,0,0,0,0,0,0
"Slovenia","2024-07-01",0,0,0,0,0,0,0,0
"Slovenia","2024-07-02",0,0,0,0,0,0,0,0
"Slovenia","2024-07-03",0,0,0,0,0,0,0,0
"Slovenia","2024-07-04",0,0,0,0,0,0,0,0
"Slovenia","2024-07-05",0,0,0,0,0,0,0,0
"Slovenia","2024-07-06",0,0,0,0,0,0,0,0
"Slovenia","2024-07-07",0,0,0,0,0,0,0,0
"Slovenia","2024-07-08",0,0,0,0,0,0,0,0
"Slovenia","2024-07-09",0,0,0,0,0,0,0,0
"Slovenia","2024-07-10",0,0,0,0,0,0,0,0
"Slovenia","2024-07-11",0,0,0,0,0,0,0,0
"Slovenia","2024-07-12",0,0,0,0,0,0,0,0
"Slovenia","2024-07-13",0,0,0,0,0,0,0,0
"Slovenia","2024-07-14",0,0,0,0,0,0,0,0
"Slovenia","2024-07-15",0,0,0,0,0,0,0,0
"Slovenia","2024-07-16",0,0,0,0,0,0,0,0
"Slovenia","2024-07-17",0,0,0,0,0,0,0,0
"Slovenia","2024-07-18",0,0,0,0,0,0,0,0
"Slovenia","2024-07-19",0,0,0,0,0,0,0,0
"Slovenia","2024-07-20",0,0,0,0,0,0,0,0
"Slovenia","2024-07-21",0,0,0,0,0,0,0,0
"Slovenia","2024-07-22",0,0,0,0,0,0,0,0
"Slovenia","2024-07-23",0,0,0,0,0,0,0,0
"Slovenia","2024-07-24",0,0,0,0,0,0,0,0
"Slovenia","2024-07-25",0,0,0,0,0,0,0,0
"Slovenia","2024-07-26",0,0,0,0,0,0,0,0
"Slovenia","2024-07-27",0,0,0,0,0,0,0,0
"Slovenia","2024-07-28",0,0,0,0,0,0,0,0
"Slovenia","2024-07-29",0,0,0,0,0,0,0,0
"Slovenia","2024-07-30",0,0,0,0,0,0,0,0
"Slovenia","2024-07-31",0,0,0,0,0,0,0,0
"Slovenia","2024-08-01",0,0,0,0,0,0,0,0
"Slovenia","2024-08-02",0,0,0,0,0,0,0,0
"Slovenia","2024-08-03",0,0,0,0,0,0,0,0
"Slovenia","2024-08-04",0,0,0,0,0,0,0,0
"Slovenia","2024-08-05",0,0,0,0,0,0,0,0
"Slovenia","2024-08-06",0,0,0,0,0,0,0,0
"Slovenia","2024-08-07",0,0,0,0,0,0,0,0
"Slovenia","2024-08-08",0,0,0,0,0,0,0,0
"Slovenia","2024-08-09",0,0,0,0,0,0,0,0
"Slovenia","2024-08-10",0,0,0,0,0,0,0,0
"Slovenia","2024-08-11",0,0,0,0,0,0,0,0
"Slovenia","2024-08-12",0,0,0,0,0,0,0,0
"Slovenia","2024-08-13",0,0,0,0,0,0,0,0
"Slovenia","2024-08-14",0,0,0,0,0,0,0,0
"Slovenia","2024-08-15",0,0,0,0,0,0,0,0
"Slovenia","2024-08-16",0,0,0,0,0,0,0,0
"Slovenia","2024-08-17",0,0,0,0,0,0,0,0
"Slovenia","2024-08-18",0,0,0,0,0,0,0,0
"Slovenia","2024-08-19",0,0,0,0,0,0,0,0
"Slovenia","2024-08-20",0,0,0,0,0,0,0,0
"Slovenia","2024-08-21",0,0,0,0,0,0,0,0
"Slovenia","2024-08-22",0,0,0,0,0,0,0,0
"Slovenia","2024-08-23",0,0,0,0,0,0,0,0
"Slovenia","2024-08-24",0,0,0,0,0,0,0,0
"Slovenia","2024-08-25",0,0,0,0,0,0,0,0
"Slovenia","2024-08-26",0,0,0,0,0,0,0,0
"Slovenia","2024-08-27",0,0,0,0,0,0,0,0
"Slovenia","2024-08-28",0,0,0,0,0,0,0,0
"Slovenia","2024-08-29",0,0,0,0,0,0,0,0
"Slovenia","2024-08-30",0,0,0,0,0,0,0,0
"Slovenia","2024-08-31",0,0,0,0,0,0,0,0
"Slovenia","2024-09-01",0,0,0,0,0,0,0,0
"Slovenia","2024-09-02",0,0,0,0,0,0,0,0
"Slovenia","2024-09-03",0,0,0,0,0,0,0,0
"Slovenia","2024-09-04",0,0,0,0,0,0,0,0
"Slovenia","2024-09-05",0,0,0,0,0,0,0,0
"Slovenia","2024-09-06",0,0,0,0,0,0,0,0
"Slovenia","2024-09-07",0,0,0,0,0,0,0,0
"Slovenia","2024-09-08",0,0,0,0,0,0,0,0
"Slovenia","2024-09-09",0,0,0,0,0,0,0,0
"Slovenia","2024-09-10",0,0,0,0,0,0,0,0
"Slovenia","2024-09-11",0,0,0,0,0,0,0,0
"Slovenia","2024-09-12",0,0,0,0,0,0,0,0
"Slovenia","2024-09-13",0,0,0,0,0,0,0,0
"Slovenia","2024-09-14",0,0,0,0,0,0,0,0
"Slovenia","2024-09-15",0,0,0,0,0,0,0,0
"Slovenia","2024-09-16",0,0,0,0,0,0,0,0
"Slovenia","2024-09-17",0,0,0,0,0,0,0,0
"Slovenia","2024-09-18",0,0,0,0,0,0,0,0
"Slovenia","2024-09-19",0,0,0,0,0,0,0,0
"Slovenia","2024-09-20",0,0,0,0,0,0,0,0
"Slovenia","2024-09-21",0,0,0,0,0,0,0,0
"Slovenia","2024-09-22",0,0,0,0,0,0,0,0
"Slovenia","2024-09-23",0,0,0,0,0,0,0,0
"Slovenia","2024-09-24",0,0,0,0,0,0,0,0
"Slovenia","2024-09-25",0,0,0,0,0,0,0,0
"Slovenia","2024-09-26",0,0,0,0,0,0,0,0
"Slovenia","2024-09-27",0,0,0,0,0,0,0,0
"Slovenia","2024-09-28",0,0,0,0,0,0,0,0
"Slovenia","2024-09-29",0,0,0,0,0,0,0,0
"Slovenia","2024-09-30",0,0,0,0,0,0,0,0
"Slovenia","2024-10-01",0,0,0,0,0,0,0,0
"Slovenia","2024-10-02",0,0,0,0,0,0,0,0
"Slovenia","2024-10-03",0,0,0,0,0,0,0,0
"Slovenia","2024-10-04",0,0,0,0,0,0,0,0
"Slovenia","2024-10-05",0,0,0,0,0,0,0,0
"Slovenia","2024-10-06",0,0,0,0,0,0,0,0
"Slovenia","2024-10-07",0,0,0,0,0,0,0,0
"Slovenia","2024-10-08",0,0,0,0,0,0,0,0
"Slovenia","2024-10-09",0,0,0,0,0,0,0,0
"Slovenia","2024-10-10",0,0,0,0,0,0,0,0
"Slovenia","2024-10-11",0,0,0,0,0,0,0,0
"Slovenia","2024-10-12",0,0,0,0,0,0,0,0
"Slovenia","2024-10-13",0,0,0,0,0,0,0,0
"Slovenia","2024-10-14",0,0,0,0,0,0,0,0
"Slovenia","2024-10-15",0,0,0,0,0,0,0,0
"Slovenia","2024-10-16",0,0,0,0,0,0,0,0
"Slovenia","2024-10-17",0,0,0,0,0,0,0,0
"Slovenia","2024-10-18",0,0,0,0,0,0,0,0
"Slovenia","2024-10-19",0,0,0,0,0,0,0,0
"Slovenia","2024-10-20",0,0,0,0,0,0,0,0
"Slovenia","2024-10-21",0,0,0,0,0,0,0,0
"Slovenia","2024-10-22",0,0,0,0,0,0,0,0
"Slovenia","2024-10-23",0,0,0,0,0,0,0,0
"Slovenia","2024-10-24",0,0,0,0,0,0,0,0
"Slovenia","2024-10-25",0,0,0,0,0,0,0,0
"Slovenia","2024-10-26",0,0,0,0,0,0,0,0
"Slovenia","2024-10-27",0,0,0,0,0,0,0,0
"Slovenia","2024-10-28",0,0,0,0,0,0,0,0
"Slovenia","2024-10-29",0,0,0,0,0,0,0,0
"Slovenia","2024-10-30",0,0,0,0,0,0,0,0
"Slovenia","2024-10-31",0,0,0,0,0,0,0,0
"Slovenia","2024-11-01",0,0,0,0,0,0,0,0
"Slovenia","2024-11-02",0,0,0,0,0,0,0,0
"Slovenia","2024-11-03",0,0,0,0,0,0,0,0
"Slovenia","2024-11-04",0,0,0,0,0,0,0,0
"Slovenia","2024-11-05",0,0,0,0,0,0,0,0
"Slovenia","2024-11-06",0,0,0,0,0,0,0,0
"Slovenia","2024-11-07",0,0,0,0,0,0,0,0
"Slovenia","2024-11-08",0,0,0,0,0,0,0,0
"Slovenia","2024-11-09",0,0,0,0,0,0,0,0
"Slovenia","2024-11-10",0,0,0,0,0,0,0,0
"Slovenia","2024-11-11",0,0,0,0,0,0,0,0
"Slovenia","2024-11-12",0,0,0,0,0,0,0,0
"Slovenia","2024-11-13",0,0,0,0,0,0,0,0
"Slovenia","2024-11-14",0,0,0,0,0,0,0,0
"Slovenia","2024-11-15",0,0,0,0,0,0,0,0
"Slovenia","2024-11-16",0,0,0,0,0,0,0,0
"Slovenia","2024-11-17",0,0,0,0,0,0,0,0
"Slovenia","2024-11-18",0,0,0,0,0,0,0,0
"Slovenia","2024-11-19",0,0,0,0,0,0,0,0
"Slovenia","2024-11-20",0,0,0,0,0,0,0,0
"Slovenia","2024-11-21",0,0,0,0,0,0,0,0
"Slovenia","2024-11-22",0,0,0,0,0,0,0,0
"Slovenia","2024-11-23",0,0,0,0,0,0,0,0
"Slovenia","2024-11-24",0,0,0,0,0,0,0,0
"Slovenia","2024-11-25",0,0,0,0,0,0,0,0
"Slovenia","2024-11-26",0,0,0,0,0,0,0,0
"Slovenia","2024-11-27",0,0,0,0,0,0,0,0
"Slovenia","2024-11-28",0,0,0,0,0,0,0,0
"Slovenia","2024-11-29",0,0,0,0,0,0,0,0
"Slovenia","2024-11-30",0,0,0,0,0,0,0,0
"Slovenia","2024-12-01",0,0,0,0,0,0,0,0
"Slovenia","2024-12-02",0,0,0,0,0,0,0,0
"Slovenia","2024-12-03",0,0,0,0,0,0,0,0
"Slovenia","2024-12-04",0,0,0,0,0,0,0,0
"Slovenia","2024-12-05",0,0,0,0,0,0,0,0
"Slovenia","2024-12-06",0,0,0,0,0,0,0,0
"Slovenia","2024-12-07",0,0,0,0,0,0,0,0
"Slovenia","2024-12-08",0,0,0,0,0,0,0,0
"Slovenia","2024-12-09",0,0,0,0,0,0,0,0
"South Africa","2024-01-01",0,0,0,0,0,0,0,0
"South Africa","2024-01-02",0,0,0,0,0,0,0,0
"South Africa","2024-01-03",0,0,0,0,0,0,0,0
"South Africa","2024-01-04",0,0,0,0,0,0,0,0
"South Africa","2024-01-05",0,0,0,0,0,0,0,0
"South Africa","2024-01-06",0,0,0,0,0,0,0,0
"South Africa","2024-01-07",0,0,0,0,0,0,0,0
"South Africa","2024-01-08",0,0,0,0,0,0,0,0
"South Africa","2024-01-09",0,0,0,0,0,0,0,0
"South Africa","2024-01-10",0,0,0,0,0,0,0,0
"South Africa","2024-01-11",0,0,0,0,0,0,0,0
"South Africa","2024-01-12",0,0,0,0,0,0,0,0
"South Africa","2024-01-13",0,0,0,0,0,0,0,0
"South Africa","2024-01-14",0,0,0,0,0,0,0,0
"South Africa","2024-01-15",0,0,0,0,0,0,0,0
"South Africa","2024-01-16",0,0,0,0,0,0,0,0
"South Africa","2024-01-17",0,0,0,0,0,0,0,0
"South Africa","2024-01-18",0,0,0,0,0,0,0,0
"South Africa","2024-01-19",0,0,0,0,0,0,0,0
"South Africa","2024-01-20",0,0,0,0,0,0,0,0
"South Africa","2024-01-21",0,0,0,0,0,0,0,0
"South Africa","2024-01-22",0,0,0,0,0,0,0,0
"South Africa","2024-01-23",0,0,0,0,0,0,0,0
"South Africa","2024-01-24",0,0,0,0,0,0,0,0
"South Africa","2024-01-25",0,0,0,0,0,0,0,0
"South Africa","2024-01-26",0,0,0,0,0,0,0,0
"South Africa","2024-01-27",0,0,0,0,0,0,0,0
"South Africa","2024-01-28",0,0,0,0,0,0,0,0
"South Africa","2024-01-29",0,0,0,0,0,0,0,0
"South Africa","2024-01-30",0,0,0,0,0,0,0,0
"South Africa","2024-01-31",0,0,0,0,0,0,0,0
"South Africa","2024-02-01",0,0,0,0,0,0,0,0
"South Africa","2024-02-02",0,0,0,0,0,0,0,0
"South Africa","2024-02-03",0,0,0,0,0,0,0,0
"South Africa","2024-02-04",0,0,0,0,0,0,0,0
"South Africa","2024-02-05",0,0,0,0,0,0,0,0
"South Africa","2024-02-06",0,0,0,0,0,0,0,0
"South Africa","2024-02-07",0,0,0,0,0,0,0,0
"South Africa","2024-02-08",0,0,0,0,0,0,0,0
"South Africa","2024-02-09",0,0,0,0,0,0,0,0
"South Africa","2024-02-10",0,0,0,0,0,0,0,0
"South Africa","2024-02-11",0,0,0,0,0,0,0,0
"South Africa","2024-02-12",0,0,0,0,0,0,0,0
"South Africa","2024-02-13",0,0,0,0,0,0,0,0
"South Africa","2024-02-14",0,0,0,0,0,0,0,0
"South Africa","2024-02-15",0,0,0,0,0,0,0,0
"South Africa","2024-02-16",0,0,0,0,0,0,0,0
"South Africa","2024-02-17",0,0,0,0,0,0,0,0
"South Africa","2024-02-18",0,0,0,0,0,0,0,0
"South Africa","2024-02-19",0,0,0,0,0,0,0,0
"South Africa","2024-02-20",0,0,0,0,0,0,0,0
"South Africa","2024-02-21",0,0,0,0,0,0,0,0
"South Africa","2024-02-22",0,0,0,0,0,0,0,0
"South Africa","2024-02-23",0,0,0,0,0,0,0,0
"South Africa","2024-02-24",0,0,0,0,0,0,0,0
"South Africa","2024-02-25",0,0,0,0,0,0,0,0
"South Africa","2024-02-26",0,0,0,0,0,0,0,0
"South Africa","2024-02-27",0,0,0,0,0,0,0,0
"South Africa","2024-02-28",0,0,0,0,0,0,0,0
"South Africa","2024-02-29",0,0,0,0,0,0,0,0
"South Africa","2024-03-01",0,0,0,0,0,0,0,0
"South Africa","2024-03-02",0,0,0,0,0,0,0,0
"South Africa","2024-03-03",0,0,0,0,0,0,0,0
"South Africa","2024-03-04",0,0,0,0,0,0,0,0
"South Africa","2024-03-05",0,0,0,0,0,0,0,0
"South Africa","2024-03-06",0,0,0,0,0,0,0,0
"South Africa","2024-03-07",0,0,0,0,0,0,0,0
"South Africa","2024-03-08",0,0,0,0,0,0,0,0
"South Africa","2024-03-09",0,0,0,0,0,0,0,0
"South Africa","2024-03-10",0,0,0,0,0,0,0,0
"South Africa","2024-03-11",0,0,0,0,0,0,0,0
"South Africa","2024-03-12",0,0,0,0,0,0,0,0
"South Africa","2024-03-13",0,0,0,0,0,0,0,0
"South Africa","2024-03-14",0,0,0,0,0,0,0,0
"South Africa","2024-03-15",0,0,0,0,0,0,0,0
"South Africa","2024-03-16",0,0,0,0,0,0,0,0
"South Africa","2024-03-17",0,0,0,0,0,0,0,0
"South Africa","2024-03-18",0,0,0,0,0,0,0,0
"South Africa","2024-03-19",0,0,0,0,0,0,0,0
"South Africa","2024-03-20",0,0,0,0,0,0,0,0
"South Africa","2024-03-21",0,0,0,0,0,0,0,0
"South Africa","2024-03-22",0,0,0,0,0,0,0,0
"South Africa","2024-03-23",0,0,0,0,0,0,0,0
"South Africa","2024-03-24",0,0,0,0,0,0,0,0
"South Africa","2024-03-25",0,0,0,0,0,0,0,0
"South Africa","2024-03-26",0,0,0,0,0,0,0,0
"South Africa","2024-03-27",0,0,0,0,0,0,0,0
"South Africa","2024-03-28",0,0,0,0,0,0,0,0
"South Africa","2024-03-29",0,0,0,0,0,0,0,0
"South Africa","2024-03-30",0,0,0,0,0,0,0,0
"South Africa","2024-03-31",0,0,0,0,0,0,0,0
"South Africa","2024-04-01",0,0,0,0,0,0,0,0
"South Africa","2024-04-02",0,0,0,0,0,0,0,0
"South Africa","2024-04-03",0,0,0,0,0,0,0,0
"South Africa","2024-04-04",0,0,0,0,0,0,0,0
"South Africa","2024-04-05",0,0,0,0,0,0,0,0
"South Africa","2024-04-06",0,0,0,0,0,0,0,0
"South Africa","2024-04-07",0,0,0,0,0,0,0,0
"South Africa","2024-04-08",0,0,0,0,0,0,0,0
"South Africa","2024-04-09",0,0,0,0,0,0,0,0
"South Africa","2024-04-10",0,0,0,0,0,0,0,0
"South Africa","2024-04-11",0,0,0,0,0,0,0,0
"South Africa","2024-04-12",0,0,0,0,0,0,0,0
"South Africa","2024-04-13",0,0,0,0,0,0,0,0
"South Africa","2024-04-14",0,0,0,0,0,0,0,0
"South Africa","2024-04-15",0,0,0,0,0,0,0,0
"South Africa","2024-04-16",0,0,0,0,0,0,0,0
"South Africa","2024-04-17",0,0,0,0,0,0,0,0
"South Africa","2024-04-18",0,0,0,0,0,0,0,0
"South Africa","2024-04-19",0,0,0,0,0,0,0,0
"South Africa","2024-04-20",0,0,0,0,0,0,0,0
"South Africa","2024-04-21",0,0,0,0,0,0,0,0
"South Africa","2024-04-22",0,0,0,0,0,0,0,0
"South Africa","2024-04-23",0,0,0,0,0,0,0,0
"South Africa","2024-04-24",0,0,0,0,0,0,0,0
"South Africa","2024-04-25",0,0,0,0,0,0,0,0
"South Africa","2024-04-26",0,0,0,0,0,0,0,0
"South Africa","2024-04-27",0,0,0,0,0,0,0,0
"South Africa","2024-04-28",0,0,0,0,0,0,0,0
"South Africa","2024-04-29",0,0,0,0,0,0,0,0
"South Africa","2024-04-30",0,0,0,0,0,0,0,0
"South Africa","2024-05-01",0,0,0,0,0,0,0,0
"South Africa","2024-05-02",0,0,0,0,0,0,0,0
"South Africa","2024-05-03",0,0,0,0,0,0,0,0
"South Africa","2024-05-04",0,0,0,0,0,0,0,0
"South Africa","2024-05-05",0,0,0,0,0,0,0,0
"South Africa","2024-05-06",0,0,0,0,0,0,0,0
"South Africa","2024-05-07",0,0,0,0,0,0,0,0
"South Africa","2024-05-08",0,0,0,0,0,0,0,0
"South Africa","2024-05-09",0,0,0,0,0,0,0,0
"South Africa","2024-05-10",0,0,0,0,0,0,0,0
"South Africa","2024-05-11",0,0,0,0,0,0,0,0
"South Africa","2024-05-12",0,1,1,0,1,1,0,0
"South Africa","2024-05-13",0,0,1,0,0,1,0,0
"South Africa","2024-05-14",0,0,1,0,0,1,0,0
"South Africa","2024-05-15",0,0,1,0,0,1,0,0
"South Africa","2024-05-16",0,0,1,0,0,1,0,0
"South Africa","2024-05-17",0,0,1,0,0,1,0,0
"South Africa","2024-05-18",0,0,1,0,0,1,0,0
"South Africa","2024-05-19",0,0,1,0,0,1,0,0
"South Africa","2024-05-20",0,0,1,0,1,2,0,0
"South Africa","2024-05-21",0,0,1,0,0,2,0,0
"South Africa","2024-05-22",0,0,1,0,0,2,0,0
"South Africa","2024-05-23",0,0,1,0,0,2,0,0
"South Africa","2024-05-24",0,0,1,0,0,2,0,0
"South Africa","2024-05-25",0,0,1,0,0,2,0,0
"South Africa","2024-05-26",0,1,2,0,0,2,0,0
"South Africa","2024-05-27",0,0,2,0,0,2,0,0
"South Africa","2024-05-28",0,0,2,0,0,2,0,0
"South Africa","2024-05-29",0,0,2,0,0,2,0,0
"South Africa","2024-05-30",0,0,2,0,1,3,0,0
"South Africa","2024-05-31",0,0,2,0,0,3,0,0
"South Africa","2024-06-01",0,0,2,0,0,3,0,0
"South Africa","2024-06-02",0,1,3,0,0,3,0,0
"South Africa","2024-06-03",0,0,3,0,0,3,0,0
"South Africa","2024-06-04",0,0,3,0,1,4,0,0
"South Africa","2024-06-05",0,0,3,0,0,4,0,0
"South Africa","2024-06-06",0,0,3,0,0,4,0,0
"South Africa","2024-06-07",0,0,3,0,0,4,0,0
"South Africa","2024-06-08",0,0,3,0,1,5,0,0
"South Africa","2024-06-09",0,2,5,0,0,5,0,0
"South Africa","2024-06-10",0,0,5,0,1,6,0,0
"South Africa","2024-06-11",0,0,5,0,1,7,0,0
"South Africa","2024-06-12",0,0,5,0,1,8,0,0
"South Africa","2024-06-13",0,0,5,0,1,9,0,0
"South Africa","2024-06-14",0,0,5,0,1,10,0,0
"South Africa","2024-06-15",0,0,5,0,1,11,0,0
"South Africa","2024-06-16",0,7,12,0,1,12,0,0
"South Africa","2024-06-17",0,0,12,0,1,13,0,0
"South Africa","2024-06-18",0,0,12,0,0,13,0,0
"South Africa","2024-06-19",0,0,12,0,1,14,0,0
"South Africa","2024-06-20",0,0,12,0,0,14,0,0
"South Africa","2024-06-21",0,0,12,0,1,15,0,0
"South Africa","2024-06-22",0,0,12,0,0,15,0,0
"South Africa","2024-06-23",0,4,16,0,1,16,0,0
"South Africa","2024-06-24",0,0,16,0,0,16,0,0
"South Africa","2024-06-25",0,0,16,0,1,17,0,0
"South Africa","2024-06-26",0,0,16,0,0,17,0,0
"South Africa","2024-06-27",0,0,16,0,0,17,0,0
"South Africa","2024-06-28",0,0,16,0,0,17,0,0
"South Africa","2024-06-29",0,0,16,0,1,18,0,0
"South Africa","2024-06-30",0,0,16,0,0,18,0,0
"South Africa","2024-07-01",0,0,16,0,0,18,0,0
"South Africa","2024-07-02",0,0,16,0,1,19,0,0
"South Africa","2024-07-03",0,0,16,0,0,19,0,0
"South Africa","2024-07-04",0,0,16,0,0,19,0,0
"South Africa","2024-07-05",0,0,16,0,0,19,0,0
"South Africa","2024-07-06",0,0,16,0,1,20,0,0
"South Africa","2024-07-07",0,4,20,0,0,20,0,0
"South Africa","2024-07-08",0,0,20,0,0,20,0,0
"South Africa","2024-07-09",0,0,20,0,1,21,0,0
"South Africa","2024-07-10",0,0,20,0,0,21,0,0
"South Africa","2024-07-11",0,0,20,0,0,21,0,0
"South Africa","2024-07-12",0,0,20,0,0,21,0,0
"South Africa","2024-07-13",0,0,20,0,1,22,0,0
"South Africa","2024-07-14",0,2,22,0,0,22,0,0
"South Africa","2024-07-15",0,0,22,0,0,22,0,0
"South Africa","2024-07-16",0,0,22,0,0,22,0,0
"South Africa","2024-07-17",0,0,22,0,0,22,0,0
"South Africa","2024-07-18",0,0,22,0,0,22,0,0
"South Africa","2024-07-19",0,0,22,0,0,22,0,0
"South Africa","2024-07-20",0,0,22,0,1,23,0,0
"South Africa","2024-07-21",0,0,22,0,0,23,0,0
"South Africa","2024-07-22",0,0,22,0,0,23,0,0
"South Africa","2024-07-23",0,0,22,0,0,23,0,0
"South Africa","2024-07-24",0,0,22,0,0,23,0,0
"South Africa","2024-07-25",0,0,22,0,0,23,0,0
"South Africa","2024-07-26",0,0,22,0,0,23,0,0
"South Africa","2024-07-27",0,0,22,0,0,23,0,0
"South Africa","2024-07-28",0,0,22,0,0,23,0,0
"South Africa","2024-07-29",0,0,22,0,0,23,0,0
"South Africa","2024-07-30",0,0,22,0,1,24,0,0
"South Africa","2024-07-31",0,0,22,0,0,24,0,0
"South Africa","2024-08-01",0,0,22,0,0,24,0,0
"South Africa","2024-08-02",0,0,22,0,0,24,0,0
"South Africa","2024-08-03",0,0,22,0,0,24,0,0
"South Africa","2024-08-04",0,2,24,0,0,24,0,0
"South Africa","2024-08-05",0,0,24,0,0,24,0,0
"South Africa","2024-08-06",0,0,24,0,0,24,0,0
"South Africa","2024-08-07",0,0,24,0,0,24,0,0
"South Africa","2024-08-08",0,0,24,0,0,24,0,0
"South Africa","2024-08-09",0,0,24,0,0,24,0,0
"South Africa","2024-08-10",0,0,24,0,0,24,0,0
"South Africa","2024-08-11",0,0,24,0,0,24,0,0
"South Africa","2024-08-12",0,0,24,0,0,24,0,0
"South Africa","2024-08-13",0,0,24,0,0,24,0,0
"South Africa","2024-08-14",0,0,24,0,0,24,0,0
"South Africa","2024-08-15",0,0,24,0,0,24,0,0
"South Africa","2024-08-16",0,0,24,0,0,24,0,0
"South Africa","2024-08-17",0,0,24,0,0,24,0,0
"South Africa","2024-08-18",0,0,24,0,0,24,0,0
"South Africa","2024-08-19",0,0,24,0,0,24,0,0
"South Africa","2024-08-20",0,0,24,0,0,24,0,0
"South Africa","2024-08-21",0,0,24,0,0,24,0,0
"South Africa","2024-08-22",0,0,24,0,1,25,0,0
"South Africa","2024-08-23",0,0,24,0,0,25,0,0
"South Africa","2024-08-24",0,0,24,0,0,25,0,0
"South Africa","2024-08-25",0,0,24,0,0,25,0,0
"South Africa","2024-08-26",0,0,24,0,0,25,0,0
"South Africa","2024-08-27",0,0,24,0,0,25,0,0
"South Africa","2024-08-28",0,0,24,0,0,25,0,0
"South Africa","2024-08-29",0,0,24,0,0,25,0,0
"South Africa","2024-08-30",0,0,24,0,0,25,0,0
"South Africa","2024-08-31",0,0,24,0,0,25,0,0
"South Africa","2024-09-01",0,0,24,0,0,25,0,0
"South Africa","2024-09-02",0,0,24,0,0,25,0,0
"South Africa","2024-09-03",0,0,24,0,0,25,0,0
"South Africa","2024-09-04",0,0,24,0,0,25,0,0
"South Africa","2024-09-05",0,0,24,0,0,25,0,0
"South Africa","2024-09-06",0,0,24,0,0,25,0,0
"South Africa","2024-09-07",0,0,24,0,0,25,0,0
"South Africa","2024-09-08",0,1,25,0,0,25,0,0
"South Africa","2024-09-09",0,0,25,0,0,25,0,0
"South Africa","2024-09-10",0,0,25,0,0,25,0,0
"South Africa","2024-09-11",0,0,25,0,0,25,0,0
"South Africa","2024-09-12",0,0,25,0,0,25,0,0
"South Africa","2024-09-13",0,0,25,0,0,25,0,0
"South Africa","2024-09-14",0,0,25,0,0,25,0,0
"South Africa","2024-09-15",0,0,25,0,0,25,0,0
"South Africa","2024-09-16",0,0,25,0,0,25,0,0
"South Africa","2024-09-17",0,0,25,0,0,25,0,0
"South Africa","2024-09-18",0,0,25,0,0,25,0,0
"South Africa","2024-09-19",0,0,25,0,0,25,0,0
"South Africa","2024-09-20",0,0,25,0,0,25,0,0
"South Africa","2024-09-21",0,0,25,0,0,25,0,0
"South Africa","2024-09-22",0,0,25,0,0,25,0,0
"South Africa","2024-09-23",0,0,25,0,0,25,0,0
"South Africa","2024-09-24",0,0,25,0,0,25,0,0
"South Africa","2024-09-25",0,0,25,0,0,25,0,0
"South Africa","2024-09-26",0,0,25,0,0,25,0,0
"South Africa","2024-09-27",0,0,25,0,0,25,0,0
"South Africa","2024-09-28",0,0,25,0,0,25,0,0
"South Africa","2024-09-29",0,0,25,0,0,25,0,0
"South Africa","2024-09-30",0,0,25,0,0,25,0,0
"South Africa","2024-10-01",0,0,25,0,0,25,0,0
"South Africa","2024-10-02",0,0,25,0,0,25,0,0
"South Africa","2024-10-03",0,0,25,0,0,25,0,0
"South Africa","2024-10-04",0,0,25,0,0,25,0,0
"South Africa","2024-10-05",0,0,25,0,0,25,0,0
"South Africa","2024-10-06",0,0,25,0,0,25,0,0
"South Africa","2024-10-07",0,0,25,0,0,25,0,0
"South Africa","2024-10-08",0,0,25,0,0,25,0,0
"South Africa","2024-10-09",0,0,25,0,0,25,0,0
"South Africa","2024-10-10",0,0,25,0,0,25,0,0
"South Africa","2024-10-11",0,0,25,0,0,25,0,0
"South Africa","2024-10-12",0,0,25,0,0,25,0,0
"South Africa","2024-10-13",0,0,25,0,0,25,0,0
"South Africa","2024-10-14",0,0,25,0,0,25,0,0
"South Africa","2024-10-15",0,0,25,0,0,25,0,0
"South Africa","2024-10-16",0,0,25,0,0,25,0,0
"South Africa","2024-10-17",0,0,25,0,0,25,0,0
"South Africa","2024-10-18",0,0,25,0,0,25,0,0
"South Africa","2024-10-19",0,0,25,0,0,25,0,0
"South Africa","2024-10-20",0,0,25,0,0,25,0,0
"South Africa","2024-10-21",0,0,25,0,0,25,0,0
"South Africa","2024-10-22",0,0,25,0,0,25,0,0
"South Africa","2024-10-23",0,0,25,0,0,25,0,0
"South Africa","2024-10-24",0,0,25,0,0,25,0,0
"South Africa","2024-10-25",0,0,25,0,0,25,0,0
"South Africa","2024-10-26",0,0,25,0,0,25,0,0
"South Africa","2024-10-27",0,0,25,0,0,25,0,0
"South Africa","2024-10-28",0,0,25,0,0,25,0,0
"South Africa","2024-10-29",0,0,25,0,0,25,0,0
"South Africa","2024-10-30",0,0,25,0,0,25,0,0
"South Africa","2024-10-31",0,0,25,0,0,25,0,0
"South Africa","2024-11-01",0,0,25,0,0,25,0,0
"South Africa","2024-11-02",0,0,25,0,0,25,0,0
"South Africa","2024-11-03",0,0,25,0,0,25,0,0
"South Africa","2024-11-04",0,0,25,0,0,25,0,0
"South Africa","2024-11-05",0,0,25,0,0,25,0,0
"South Africa","2024-11-06",0,0,25,0,0,25,0,0
"South Africa","2024-11-07",0,0,25,0,0,25,0,0
"South Africa","2024-11-08",0,0,25,0,0,25,0,0
"South Africa","2024-11-09",0,0,25,0,0,25,0,0
"South Africa","2024-11-10",0,0,25,0,0,25,0,0
"South Africa","2024-11-11",0,0,25,0,0,25,0,0
"South Africa","2024-11-12",0,0,25,0,0,25,0,0
"South Africa","2024-11-13",0,0,25,0,0,25,0,0
"South Africa","2024-11-14",0,0,25,0,0,25,0,0
"South Africa","2024-11-15",0,0,25,0,0,25,0,0
"South Africa","2024-11-16",0,0,25,0,0,25,0,0
"South Africa","2024-11-17",0,0,25,0,0,25,0,0
"South Africa","2024-11-18",0,0,25,0,0,25,0,0
"South Africa","2024-11-19",0,0,25,0,0,25,0,0
"South Africa","2024-11-20",0,0,25,0,0,25,0,0
"South Africa","2024-11-21",0,0,25,0,0,25,0,0
"South Africa","2024-11-22",0,0,25,0,0,25,0,0
"South Africa","2024-11-23",0,0,25,0,0,25,0,0
"South Africa","2024-11-24",0,0,25,0,0,25,0,0
"South Africa","2024-11-25",0,0,25,0,0,25,0,0
"South Africa","2024-11-26",0,0,25,0,0,25,0,0
"South Africa","2024-11-27",0,0,25,0,0,25,0,0
"South Africa","2024-11-28",0,0,25,0,0,25,0,0
"South Africa","2024-11-29",0,0,25,0,0,25,0,0
"South Africa","2024-11-30",0,0,25,0,0,25,0,0
"South Africa","2024-12-01",0,0,25,0,0,25,0,0
"South Africa","2024-12-02",0,0,25,0,0,25,0,0
"South Africa","2024-12-03",0,0,25,0,0,25,0,0
"South Africa","2024-12-04",0,0,25,0,0,25,0,0
"South Africa","2024-12-05",0,0,25,0,0,25,0,0
"South Africa","2024-12-06",0,0,25,0,0,25,0,0
"South Africa","2024-12-07",0,0,25,0,0,25,0,0
"South Africa","2024-12-08",0,0,25,0,0,25,0,0
"South Africa","2024-12-09",0,0,25,0,0,25,0,0
"South America","2024-01-01",0,0,0,0,0,0,0,0
"South America","2024-01-02",0,61,61,0,61,61,0,0
"South America","2024-01-03",0,0,61,0,7,68,0,0
"South America","2024-01-04",0,0,61,0,7,75,0,0
"South America","2024-01-05",0,0,61,0,7,82,0,0
"South America","2024-01-06",0,0,61,0,8,90,0,0
"South America","2024-01-07",0,0,61,0,7,97,0,0
"South America","2024-01-08",0,0,61,0,7,104,0,0
"South America","2024-01-09",0,50,111,0,7,111,0,0
"South America","2024-01-10",0,0,111,0,7,118,0,0
"South America","2024-01-11",0,0,111,0,8,126,0,0
"South America","2024-01-12",0,0,111,0,7,133,0,0
"South America","2024-01-13",0,0,111,0,7,140,0,0
"South America","2024-01-14",0,0,111,0,7,147,0,0
"South America","2024-01-15",0,0,111,0,8,155,0,0
"South America","2024-01-16",0,51,162,0,7,162,0,0
"South America","2024-01-17",0,0,162,0,6,168,0,0
"South America","2024-01-18",0,0,162,0,5,173,0,0
"South America","2024-01-19",0,0,162,0,6,179,0,0
"South America","2024-01-20",0,0,162,0,6,185,0,0
"South America","2024-01-21",0,0,162,0,6,191,0,0
"South America","2024-01-22",0,0,162,0,5,196,0,0
"South America","2024-01-23",0,40,202,0,6,202,0,0
"South America","2024-01-24",0,0,202,0,6,208,0,0
"South America","2024-01-25",0,0,202,0,7,215,0,0
"South America","2024-01-26",0,0,202,0,6,221,0,0
"South America","2024-01-27",0,0,202,0,7,228,0,0
"South America","2024-01-28",0,0,202,0,6,234,0,0
"South America","2024-01-29",0,0,202,0,7,241,0,0
"South America","2024-01-30",0,45,247,0,6,247,0,0
"South America","2024-01-31",0,0,247,0,5,252,0,0
"South America","2024-02-01",0,0,247,0,5,257,0,0
"South America","2024-02-02",0,0,247,0,5,262,0,0
"South America","2024-02-03",0,0,247,0,6,268,0,0
"South America","2024-02-04",0,0,247,0,5,273,0,0
"South America","2024-02-05",0,0,247,0,5,278,0,0
"South America","2024-02-06",0,36,283,0,5,283,0,0
"South America","2024-02-07",0,0,283,0,5,288,0,0
"South America","2024-02-08",0,0,283,0,5,293,0,0
"South America","2024-02-09",0,0,283,0,5,298,0,0
"South America","2024-02-10",0,0,283,0,6,304,0,0
"South America","2024-02-11",0,0,283,0,5,309,0,0
"South America","2024-02-12",0,0,283,0,5,314,0,0
"South America","2024-02-13",0,36,319,0,5,319,0,0
"South America","2024-02-14",0,0,319,0,6,325,0,0
"South America","2024-02-15",0,0,319,0,6,331,0,0
"South America","2024-02-16",0,0,319,0,6,337,0,0
"South America","2024-02-17",0,0,319,0,7,344,0,0
"South America","2024-02-18",0,0,319,0,6,350,0,0
"South America","2024-02-19",0,0,319,0,6,356,0,0
"South America","2024-02-20",0,43,362,0,6,362,0,0
"South America","2024-02-21",0,0,362,0,6,368,0,0
"South America","2024-02-22",0,0,362,0,6,374,0,0
"South America","2024-02-23",0,0,362,0,6,380,0,0
"South America","2024-02-24",0,0,362,0,5,385,0,0
"South America","2024-02-25",0,0,362,0,6,391,0,0
"South America","2024-02-26",0,0,362,0,6,397,0,0
"South America","2024-02-27",0,41,403,0,6,403,0,0
"South America","2024-02-28",0,0,403,0,4,407,0,0
"South America","2024-02-29",0,0,403,0,4,411,0,0
"South America","2024-03-01",0,0,403,0,4,415,0,0
"South America","2024-03-02",0,0,403,0,4,419,0,0
"South America","2024-03-03",0,0,403,0,4,423,0,0
"South America","2024-03-04",0,0,403,0,4,427,0,0
"South America","2024-03-05",0,28,431,0,4,431,0,0
"South America","2024-03-06",0,0,431,0,4,435,0,0
"South America","2024-03-07",0,0,431,0,4,439,0,0
"South America","2024-03-08",0,0,431,0,4,443,0,0
"South America","2024-03-09",0,0,431,0,5,448,0,0
"South America","2024-03-10",0,0,431,0,4,452,0,0
"South America","2024-03-11",0,0,431,0,4,456,0,0
"South America","2024-03-12",0,29,460,0,4,460,0,0
"South America","2024-03-13",0,0,460,0,4,464,0,0
"South America","2024-03-14",0,0,460,0,5,469,0,0
"South America","2024-03-15",0,0,460,0,4,473,0,0
"South America","2024-03-16",0,0,460,0,5,478,0,0
"South America","2024-03-17",0,0,460,0,4,482,0,0
"South America","2024-03-18",0,0,460,0,5,487,0,0
"South America","2024-03-19",0,31,491,0,4,491,0,0
"South America","2024-03-20",0,0,491,0,4,495,0,0
"South America","2024-03-21",0,0,491,0,4,499,0,0
"South America","2024-03-22",0,0,491,0,4,503,0,0
"South America","2024-03-23",0,0,491,0,4,507,0,0
"South America","2024-03-24",0,0,491,0,4,511,0,0
"South America","2024-03-25",0,0,491,0,4,515,0,0
"South America","2024-03-26",0,28,519,0,4,519,0,0
"South America","2024-03-27",0,0,519,0,4,523,0,0
"South America","2024-03-28",0,0,519,0,4,527,0,0
"South America","2024-03-29",0,0,519,0,4,531,0,0
"South America","2024-03-30",0,0,519,0,5,536,0,0
"South America","2024-03-31",0,0,519,0,4,540,0,0
"South America","2024-04-01",0,0,519,0,4,544,0,0
"South America","2024-04-02",0,29,548,0,4,548,0,0
"South America","2024-04-03",0,0,548,0,3,551,0,0
"South America","2024-04-04",0,0,548,0,4,555,0,0
"South America","2024-04-05",0,0,548,0,3,558,0,0
"South America","2024-04-06",0,0,548,0,4,562,0,0
"South America","2024-04-07",0,0,548,0,3,565,0,0
"South America","2024-04-08",0,0,548,0,4,569,0,0
"South America","2024-04-09",0,24,572,0,3,572,0,0
"South America","2024-04-10",0,0,572,0,3,575,0,0
"South America","2024-04-11",0,0,572,0,3,578,0,0
"South America","2024-04-12",0,0,572,0,3,581,0,0
"South America","2024-04-13",0,0,572,0,2,583,0,0
"South America","2024-04-14",0,0,572,0,3,586,0,0
"South America","2024-04-15",0,0,572,0,3,589,0,0
"South America","2024-04-16",0,20,592,0,3,592,0,0
"South America","2024-04-17",0,0,592,0,5,597,0,0
"South America","2024-04-18",0,0,592,0,4,601,0,0
"South America","2024-04-19",0,0,592,0,5,606,0,0
"South America","2024-04-20",0,0,592,0,4,610,0,0
"South America","2024-04-21",0,0,592,0,5,615,0,0
"South America","2024-04-22",0,0,592,0,4,619,0,0
"South America","2024-04-23",0,32,624,0,5,624,0,0
"South America","2024-04-24",0,0,624,0,4,628,0,0
"South America","2024-04-25",0,0,624,0,3,631,0,0
"South America","2024-04-26",0,0,624,0,4,635,0,0
"South America","2024-04-27",0,0,624,0,3,638,0,0
"South America","2024-04-28",0,0,624,0,4,642,0,0
"South America","2024-04-29",0,0,624,0,3,645,0,0
"South America","2024-04-30",0,25,649,0,4,649,0,0
"South America","2024-05-01",0,0,649,0,3,652,0,0
"South America","2024-05-02",0,0,649,0,3,655,0,0
"South America","2024-05-03",0,0,649,0,3,658,0,0
"South America","2024-05-04",0,0,649,0,3,661,0,0
"South America","2024-05-05",0,0,649,0,3,664,0,0
"South America","2024-05-06",0,0,649,0,3,667,0,0
"South America","2024-05-07",0,21,670,0,3,670,0,0
"South America","2024-05-08",0,0,670,0,3,673,0,0
"South America","2024-05-09",0,0,670,0,3,676,0,0
"South America","2024-05-10",0,0,670,0,3,679,0,0
"South America","2024-05-11",0,0,670,0,4,683,0,0
"South America","2024-05-12",0,0,670,0,3,686,0,0
"South America","2024-05-13",0,0,670,0,3,689,0,0
"South America","2024-05-14",0,22,692,0,3,692,0,0
"South America","2024-05-15",0,0,692,0,1,693,0,0
"South America","2024-05-16",0,0,692,0,2,695,0,0
"South America","2024-05-17",0,0,692,0,1,696,0,0
"South America","2024-05-18",0,0,692,0,2,698,0,0
"South America","2024-05-19",0,0,692,0,1,699,0,0
"South America","2024-05-20",0,0,692,0,2,701,0,0
"South America","2024-05-21",0,10,702,0,1,702,0,0
"South America","2024-05-22",0,0,702,0,3,705,0,0
"South America","2024-05-23",0,0,702,0,3,708,0,0
"South America","2024-05-24",0,0,702,0,3,711,0,0
"South America","2024-05-25",0,0,702,0,2,713,0,0
"South America","2024-05-26",0,0,702,0,3,716,0,0
"South America","2024-05-27",0,0,702,0,3,719,0,0
"South America","2024-05-28",0,20,722,0,3,722,0,0
"South America","2024-05-29",0,0,722,0,2,724,0,0
"South America","2024-05-30",0,0,722,0,3,727,0,0
"South America","2024-05-31",0,0,722,0,2,729,0,0
"South America","2024-06-01",0,0,722,0,3,732,0,0
"South America","2024-06-02",0,0,722,0,2,734,0,0
"South America","2024-06-03",0,0,722,0,3,737,0,0
"South America","2024-06-04",0,17,739,0,2,739,0,0
"South America","2024-06-05",0,0,739,0,2,741,0,0
"South America","2024-06-06",0,0,739,0,3,744,0,0
"South America","2024-06-07",0,0,739,0,2,746,0,0
"South America","2024-06-08",0,0,739,0,2,748,0,0
"South America","2024-06-09",0,0,739,0,2,750,0,0
"South America","2024-06-10",0,0,739,0,3,753,0,0
"South America","2024-06-11",0,16,755,0,2,755,0,0
"South America","2024-06-12",0,0,755,0,2,757,0,0
"South America","2024-06-13",0,0,755,0,1,758,0,0
"South America","2024-06-14",0,0,755,0,2,760,0,0
"South America","2024-06-15",0,0,755,0,1,761,0,0
"South America","2024-06-16",0,0,755,0,2,763,0,0
"South America","2024-06-17",0,0,755,0,1,764,0,0
"South America","2024-06-18",0,11,766,0,2,766,0,0
"South America","2024-06-19",0,0,766,0,2,768,0,0
"South America","2024-06-20",0,0,766,0,2,770,0,0
"South America","2024-06-21",0,0,766,0,2,772,0,0
"South America","2024-06-22",0,0,766,0,3,775,0,0
"South America","2024-06-23",0,0,766,0,2,777,0,0
"South America","2024-06-24",0,0,766,0,2,779,0,0
"South America","2024-06-25",0,15,781,0,2,781,0,0
"South America","2024-06-26",0,0,781,0,4,785,0,0
"South America","2024-06-27",0,0,781,0,4,789,0,0
"South America","2024-06-28",0,0,781,0,4,793,0,0
"South America","2024-06-29",0,0,781,0,3,796,0,0
"South America","2024-06-30",0,0,781,0,4,800,0,0
"South America","2024-07-01",0,0,781,0,4,804,0,0
"South America","2024-07-02",0,27,808,0,4,808,0,0
"South America","2024-07-03",0,0,808,0,4,812,0,0
"South America","2024-07-04",0,0,808,0,4,816,0,0
"South America","2024-07-05",0,0,808,0,4,820,0,0
"South America","2024-07-06",0,0,808,0,4,824,0,0
"South America","2024-07-07",0,0,808,0,4,828,0,0
"South America","2024-07-08",0,0,808,0,4,832,0,0
"South America","2024-07-09",0,28,836,0,4,836,0,0
"South America","2024-07-10",0,0,836,0,4,840,0,0
"South America","2024-07-11",0,0,836,0,5,845,0,0
"South America","2024-07-12",0,0,836,0,4,849,0,0
"South America","2024-07-13",0,0,836,0,5,854,0,0
"South America","2024-07-14",0,0,836,0,4,858,0,0
"South America","2024-07-15",0,0,836,0,5,863,0,0
"South America","2024-07-16",0,31,867,0,4,867,0,0
"South America","2024-07-17",0,0,867,0,5,872,0,0
"South America","2024-07-18",0,0,867,0,5,877,0,0
"South America","2024-07-19",0,0,867,0,5,882,0,0
"South America","2024-07-20",0,0,867,0,6,888,0,0
"South America","2024-07-21",0,0,867,0,5,893,0,0
"South America","2024-07-22",0,0,867,0,5,898,0,0
"South America","2024-07-23",0,36,903,0,5,903,0,0
"South America","2024-07-24",0,0,903,0,6,909,0,0
"South America","2024-07-25",0,0,903,0,6,915,0,0
"South America","2024-07-26",0,0,903,0,6,921,0,0
"South America","2024-07-27",0,0,903,0,5,926,0,0
"South America","2024-07-28",0,0,903,0,6,932,0,0
"South America","2024-07-29",0,0,903,0,6,938,0,0
"South America","2024-07-30",0,41,944,0,6,944,0,0
"South America","2024-07-31",0,0,944,0,9,953,0,0
"South America","2024-08-01",0,0,944,0,9,962,0,0
"South America","2024-08-02",0,0,944,0,9,971,0,0
"South America","2024-08-03",0,0,944,0,10,981,0,0
"South America","2024-08-04",0,0,944,0,9,990,0,0
"South America","2024-08-05",0,0,944,0,9,999,0,0
"South America","2024-08-06",0,64,1008,0,9,1008,0,0
"South America","2024-08-07",0,0,1008,0,10,1018,0,0
"South America","2024-08-08",0,0,1008,0,10,1028,0,0
"South America","2024-08-09",0,0,1008,0,10,1038,0,0
"South America","2024-08-10",0,0,1008,0,11,1049,0,0
"South America","2024-08-11",0,0,1008,0,10,1059,0,0
"South America","2024-08-12",0,0,1008,0,10,1069,0,0
"South America","2024-08-13",0,71,1079,0,10,1079,0,0
"South America","2024-08-14",0,0,1079,0,14,1093,0,0
"South America","2024-08-15",0,0,1079,0,15,1108,0,0
"South America","2024-08-16",0,0,1079,0,14,1122,0,0
"South America","2024-08-17",0,0,1079,0,14,1136,0,0
"South America","2024-08-18",0,0,1079,0,14,1150,0,0
"South America","2024-08-19",0,0,1079,0,15,1165,0,0
"South America","2024-08-20",0,100,1179,0,14,1179,0,0
"South America","2024-08-21",0,0,1179,0,14,1193,0,0
"South America","2024-08-22",0,0,1179,0,14,1207,0,0
"South America","2024-08-23",0,0,1179,0,14,1221,0,0
"South America","2024-08-24",0,0,1179,0,14,1235,0,0
"South America","2024-08-25",0,0,1179,0,14,1249,0,0
"South America","2024-08-26",0,0,1179,0,14,1263,0,0
"South America","2024-08-27",0,98,1277,0,14,1277,0,0
"South America","2024-08-28",0,0,1277,0,14,1291,0,0
"South America","2024-08-29",0,0,1277,0,15,1306,0,0
"South America","2024-08-30",0,0,1277,0,14,1320,0,0
"South America","2024-08-31",0,0,1277,0,15,1335,0,0
"South America","2024-09-01",0,0,1277,0,14,1349,0,0
"South America","2024-09-02",0,0,1277,0,15,1364,0,0
"South America","2024-09-03",0,101,1378,0,14,1378,0,0
"South America","2024-09-04",0,0,1378,0,10,1388,0,0
"South America","2024-09-05",0,0,1378,0,11,1399,0,0
"South America","2024-09-06",0,0,1378,0,10,1409,0,0
"South America","2024-09-07",0,0,1378,0,11,1420,0,0
"South America","2024-09-08",0,0,1378,0,10,1430,0,0
"South America","2024-09-09",0,0,1378,0,11,1441,0,0
"South America","2024-09-10",0,73,1451,0,10,1451,0,0
"South America","2024-09-11",0,0,1451,0,12,1463,0,0
"South America","2024-09-12",0,0,1451,0,11,1474,0,0
"South America","2024-09-13",0,0,1451,0,12,1486,0,0
"South America","2024-09-14",0,0,1451,0,11,1497,0,0
"South America","2024-09-15",0,0,1451,0,12,1509,0,0
"South America","2024-09-16",0,0,1451,0,11,1520,0,0
"South America","2024-09-17",0,81,1532,0,12,1532,0,0
"South America","2024-09-18",0,0,1532,0,10,1542,0,0
"South America","2024-09-19",0,0,1532,0,10,1552,0,0
"South America","2024-09-20",0,0,1532,0,10,1562,0,0
"South America","2024-09-21",0,0,1532,0,11,1573,0,0
"South America","2024-09-22",0,0,1532,0,10,1583,0,0
"South America","2024-09-23",0,0,1532,0,10,1593,0,0
"South America","2024-09-24",0,71,1603,0,10,1603,0,0
"South America","2024-09-25",0,0,1603,0,12,1615,0,0
"South America","2024-09-26",0,0,1603,0,11,1626,0,0
"South America","2024-09-27",0,0,1603,0,12,1638,0,0
"South America","2024-09-28",0,0,1603,0,11,1649,0,0
"South America","2024-09-29",0,0,1603,0,12,1661,0,0
"South America","2024-09-30",0,0,1603,0,11,1672,0,0
"South America","2024-10-01",0,81,1684,0,12,1684,0,0
"South America","2024-10-02",0,0,1684,0,9,1693,0,0
"South America","2024-10-03",0,0,1684,0,10,1703,0,0
"South America","2024-10-04",0,0,1684,0,9,1712,0,0
"South America","2024-10-05",0,0,1684,0,9,1721,0,0
"South America","2024-10-06",0,0,1684,0,9,1730,0,0
"South America","2024-10-07",0,0,1684,0,10,1740,0,0
"South America","2024-10-08",0,65,1749,0,9,1749,0,0
"South America","2024-10-09",0,0,1749,0,7,1756,0,0
"South America","2024-10-10",0,0,1749,0,7,1763,0,0
"South America","2024-10-11",0,0,1749,0,7,1770,0,0
"South America","2024-10-12",0,0,1749,0,7,1777,0,0
"South America","2024-10-13",0,0,1749,0,7,1784,0,0
"South America","2024-10-14",0,0,1749,0,7,1791,0,0
"South America","2024-10-15",0,49,1798,0,7,1798,0,0
"South America","2024-10-16",0,0,1798,0,5,1803,0,0
"South America","2024-10-17",0,0,1798,0,4,1807,0,0
"South America","2024-10-18",0,0,1798,0,5,1812,0,0
"South America","2024-10-19",0,0,1798,0,4,1816,0,0
"South America","2024-10-20",0,0,1798,0,5,1821,0,0
"South America","2024-10-21",0,0,1798,0,4,1825,0,0
"South America","2024-10-22",0,32,1830,0,5,1830,0,0
"South America","2024-10-23",0,0,1830,0,1,1831,0,0
"South America","2024-10-24",0,0,1830,0,0,1831,0,0
"South America","2024-10-25",0,0,1830,0,1,1832,0,0
"South America","2024-10-26",0,0,1830,0,0,1832,0,0
"South America","2024-10-27",0,0,1830,0,1,1833,0,0
"South America","2024-10-28",0,0,1830,0,0,1833,0,0
"South America","2024-10-29",0,4,1834,0,1,1834,0,0
"South America","2024-10-30",0,0,1834,0,0,1834,0,0
"South America","2024-10-31",0,0,1834,0,0,1834,0,0
"South America","2024-11-01",0,0,1834,0,0,1834,0,0
"South America","2024-11-02",0,0,1834,0,0,1834,0,0
"South America","2024-11-03",0,0,1834,0,0,1834,0,0
"South America","2024-11-04",0,0,1834,0,0,1834,0,0
"South America","2024-11-05",0,0,1834,0,0,1834,0,0
"South America","2024-11-06",0,0,1834,0,0,1834,0,0
"South America","2024-11-07",0,0,1834,0,0,1834,0,0
"South America","2024-11-08",0,0,1834,0,0,1834,0,0
"South America","2024-11-09",0,0,1834,0,0,1834,0,0
"South America","2024-11-10",0,0,1834,0,0,1834,0,0
"South America","2024-11-11",0,0,1834,0,0,1834,0,0
"South America","2024-11-12",0,0,1834,0,0,1834,0,0
"South America","2024-11-13",0,0,1834,0,0,1834,0,0
"South America","2024-11-14",0,0,1834,0,0,1834,0,0
"South America","2024-11-15",0,0,1834,0,0,1834,0,0
"South America","2024-11-16",0,0,1834,0,0,1834,0,0
"South America","2024-11-17",0,0,1834,0,0,1834,0,0
"South America","2024-11-18",0,0,1834,0,0,1834,0,0
"South America","2024-11-19",0,0,1834,0,0,1834,0,0
"South America","2024-11-20",0,0,1834,0,0,1834,0,0
"South America","2024-11-21",0,0,1834,0,0,1834,0,0
"South America","2024-11-22",0,0,1834,0,0,1834,0,0
"South America","2024-11-23",0,0,1834,0,0,1834,0,0
"South America","2024-11-24",0,0,1834,0,0,1834,0,0
"South America","2024-11-25",0,0,1834,0,0,1834,0,0
"South America","2024-11-26",0,0,1834,0,0,1834,0,0
"South America","2024-11-27",0,0,1834,0,0,1834,0,0
"South America","2024-11-28",0,0,1834,0,0,1834,0,0
"South America","2024-11-29",0,0,1834,0,0,1834,0,0
"South America","2024-11-30",0,0,1834,0,0,1834,0,0
"South America","2024-12-01",0,0,1834,0,0,1834,0,0
"South America","2024-12-02",0,0,1834,0,0,1834,0,0
"South America","2024-12-03",0,0,1834,0,0,1834,0,0
"South America","2024-12-04",0,0,1834,0,0,1834,0,0
"South America","2024-12-05",0,0,1834,0,0,1834,0,0
"South America","2024-12-06",0,0,1834,0,0,1834,0,0
"South America","2024-12-07",0,0,1834,0,0,1834,0,0
"South America","2024-12-08",0,0,1834,0,0,1834,0,0
"South America","2024-12-09",0,0,1834,0,0,1834,0,0
"Republic of Korea","2024-01-01",0,0,0,0,0,0,0,0
"Republic of Korea","2024-01-02",0,0,0,0,0,0,0,0
"Republic of Korea","2024-01-03",0,0,0,0,0,0,0,0
"Republic of Korea","2024-01-04",0,0,0,0,0,0,0,0
"Republic of Korea","2024-01-05",0,0,0,0,0,0,0,0
"Republic of Korea","2024-01-06",0,0,0,0,0,0,0,0
"Republic of Korea","2024-01-07",0,0,0,0,0,0,0,0
"Republic of Korea","2024-01-08",0,0,0,0,0,0,0,0
"Republic of Korea","2024-01-09",0,0,0,0,0,0,0,0
"Republic of Korea","2024-01-10",0,0,0,0,0,0,0,0
"Republic of Korea","2024-01-11",0,0,0,0,0,0,0,0
"Republic of Korea","2024-01-12",0,0,0,0,0,0,0,0
"Republic of Korea","2024-01-13",0,0,0,0,0,0,0,0
"Republic of Korea","2024-01-14",0,0,0,0,0,0,0,0
"Republic of Korea","2024-01-15",0,0,0,0,0,0,0,0
"Republic of Korea","2024-01-16",0,0,0,0,0,0,0,0
"Republic of Korea","2024-01-17",0,0,0,0,0,0,0,0
"Republic of Korea","2024-01-18",0,0,0,0,0,0,0,0
"Republic of Korea","2024-01-19",0,0,0,0,0,0,0,0
"Republic of Korea","2024-01-20",0,0,0,0,0,0,0,0
"Republic of Korea","2024-01-21",0,0,0,0,0,0,0,0
"Republic of Korea","2024-01-22",0,0,0,0,0,0,0,0
"Republic of Korea","2024-01-23",0,0,0,0,0,0,0,0
"Republic of Korea","2024-01-24",0,0,0,0,0,0,0,0
"Republic of Korea","2024-01-25",0,0,0,0,0,0,0,0
"Republic of Korea","2024-01-26",0,0,0,0,0,0,0,0
"Republic of Korea","2024-01-27",0,0,0,0,0,0,0,0
"Republic of Korea","2024-01-28",0,0,0,0,0,0,0,0
"Republic of Korea","2024-01-29",0,0,0,0,0,0,0,0
"Republic of Korea","2024-01-30",0,0,0,0,0,0,0,0
"Republic of Korea","2024-01-31",0,0,0,0,0,0,0,0
"Republic of Korea","2024-02-01",0,0,0,0,0,0,0,0
"Republic of Korea","2024-02-02",0,0,0,0,0,0,0,0
"Republic of Korea","2024-02-03",0,0,0,0,0,0,0,0
"Republic of Korea","2024-02-04",0,0,0,0,0,0,0,0
"Republic of Korea","2024-02-05",0,0,0,0,0,0,0,0
"Republic of Korea","2024-02-06",0,0,0,0,0,0,0,0
"Republic of Korea","2024-02-07",0,0,0,0,0,0,0,0
"Republic of Korea","2024-02-08",0,0,0,0,0,0,0,0
"Republic of Korea","2024-02-09",0,0,0,0,0,0,0,0
"Republic of Korea","2024-02-10",0,0,0,0,0,0,0,0
"Republic of Korea","2024-02-11",0,0,0,0,0,0,0,0
"Republic of Korea","2024-02-12",0,0,0,0,0,0,0,0
"Republic of Korea","2024-02-13",0,0,0,0,0,0,0,0
"Republic of Korea","2024-02-14",0,0,0,0,0,0,0,0
"Republic of Korea","2024-02-15",0,0,0,0,0,0,0,0
"Republic of Korea","2024-02-16",0,0,0,0,0,0,0,0
"Republic of Korea","2024-02-17",0,0,0,0,0,0,0,0
"Republic of Korea","2024-02-18",0,0,0,0,0,0,0,0
"Republic of Korea","2024-02-19",0,0,0,0,0,0,0,0
"Republic of Korea","2024-02-20",0,0,0,0,0,0,0,0
"Republic of Korea","2024-02-21",0,0,0,0,0,0,0,0
"Republic of Korea","2024-02-22",0,0,0,0,0,0,0,0
"Republic of Korea","2024-02-23",0,0,0,0,0,0,0,0
"Republic of Korea","2024-02-24",0,0,0,0,0,0,0,0
"Republic of Korea","2024-02-25",0,0,0,0,0,0,0,0
"Republic of Korea","2024-02-26",0,0,0,0,0,0,0,0
"Republic of Korea","2024-02-27",0,0,0,0,0,0,0,0
"Republic of Korea","2024-02-28",0,0,0,0,0,0,0,0
"Republic of Korea","2024-02-29",0,0,0,0,0,0,0,0
"Republic of Korea","2024-03-01",0,0,0,0,0,0,0,0
"Republic of Korea","2024-03-02",0,0,0,0,0,0,0,0
"Republic of Korea","2024-03-03",0,0,0,0,0,0,0,0
"Republic of Korea","2024-03-04",0,0,0,0,0,0,0,0
"Republic of Korea","2024-03-05",0,0,0,0,0,0,0,0
"Republic of Korea","2024-03-06",0,0,0,0,0,0,0,0
"Republic of Korea","2024-03-07",0,0,0,0,0,0,0,0
"Republic of Korea","2024-03-08",0,0,0,0,0,0,0,0
"Republic of Korea","2024-03-09",0,0,0,0,0,0,0,0
"Republic of Korea","2024-03-10",0,0,0,0,0,0,0,0
"Republic of Korea","2024-03-11",0,0,0,0,0,0,0,0
"Republic of Korea","2024-03-12",0,0,0,0,0,0,0,0
"Republic of Korea","2024-03-13",0,0,0,0,0,0,0,0
"Republic of Korea","2024-03-14",0,0,0,0,0,0,0,0
"Republic of Korea","2024-03-15",0,0,0,0,0,0,0,0
"Republic of Korea","2024-03-16",0,0,0,0,0,0,0,0
"Republic of Korea","2024-03-17",0,0,0,0,0,0,0,0
"Republic of Korea","2024-03-18",0,0,0,0,0,0,0,0
"Republic of Korea","2024-03-19",0,0,0,0,0,0,0,0
"Republic of Korea","2024-03-20",0,0,0,0,0,0,0,0
"Republic of Korea","2024-03-21",0,0,0,0,0,0,0,0
"Republic of Korea","2024-03-22",0,0,0,0,0,0,0,0
"Republic of Korea","2024-03-23",0,0,0,0,0,0,0,0
"Republic of Korea","2024-03-24",0,0,0,0,0,0,0,0
"Republic of Korea","2024-03-25",0,0,0,0,0,0,0,0
"Republic of Korea","2024-03-26",0,0,0,0,0,0,0,0
"Republic of Korea","2024-03-27",0,0,0,0,0,0,0,0
"Republic of Korea","2024-03-28",0,0,0,0,0,0,0,0
"Republic of Korea","2024-03-29",0,0,0,0,0,0,0,0
"Republic of Korea","2024-03-30",0,0,0,0,0,0,0,0
"Republic of Korea","2024-03-31",0,0,0,0,0,0,0,0
"Republic of Korea","2024-04-01",0,0,0,0,0,0,0,0
"Republic of Korea","2024-04-02",0,0,0,0,0,0,0,0
"Republic of Korea","2024-04-03",0,0,0,0,0,0,0,0
"Republic of Korea","2024-04-04",0,0,0,0,0,0,0,0
"Republic of Korea","2024-04-05",0,0,0,0,0,0,0,0
"Republic of Korea","2024-04-06",0,0,0,0,0,0,0,0
"Republic of Korea","2024-04-07",0,0,0,0,0,0,0,0
"Republic of Korea","2024-04-08",0,0,0,0,0,0,0,0
"Republic of Korea","2024-04-09",0,0,0,0,0,0,0,0
"Republic of Korea","2024-04-10",0,0,0,0,0,0,0,0
"Republic of Korea","2024-04-11",0,0,0,0,0,0,0,0
"Republic of Korea","2024-04-12",0,0,0,0,0,0,0,0
"Republic of Korea","2024-04-13",0,0,0,0,0,0,0,0
"Republic of Korea","2024-04-14",0,0,0,0,0,0,0,0
"Republic of Korea","2024-04-15",0,0,0,0,0,0,0,0
"Republic of Korea","2024-04-16",0,0,0,0,0,0,0,0
"Republic of Korea","2024-04-17",0,0,0,0,0,0,0,0
"Republic of Korea","2024-04-18",0,0,0,0,0,0,0,0
"Republic of Korea","2024-04-19",0,0,0,0,0,0,0,0
"Republic of Korea","2024-04-20",0,0,0,0,0,0,0,0
"Republic of Korea","2024-04-21",0,0,0,0,0,0,0,0
"Republic of Korea","2024-04-22",0,0,0,0,0,0,0,0
"Republic of Korea","2024-04-23",0,0,0,0,0,0,0,0
"Republic of Korea","2024-04-24",0,0,0,0,0,0,0,0
"Republic of Korea","2024-04-25",0,0,0,0,0,0,0,0
"Republic of Korea","2024-04-26",0,0,0,0,0,0,0,0
"Republic of Korea","2024-04-27",0,1,1,0,1,1,0,0
"Republic of Korea","2024-04-28",0,0,1,0,0,1,0,0
"Republic of Korea","2024-04-29",0,0,1,0,0,1,0,0
"Republic of Korea","2024-04-30",0,0,1,0,0,1,0,0
"Republic of Korea","2024-05-01",0,0,1,0,0,1,0,0
"Republic of Korea","2024-05-02",0,0,1,0,0,1,0,0
"Republic of Korea","2024-05-03",0,0,1,0,0,1,0,0
"Republic of Korea","2024-05-04",0,0,1,0,0,1,0,0
"Republic of Korea","2024-05-05",0,0,1,0,0,1,0,0
"Republic of Korea","2024-05-06",0,0,1,0,0,1,0,0
"Republic of Korea","2024-05-07",0,0,1,0,0,1,0,0
"Republic of Korea","2024-05-08",0,0,1,0,0,1,0,0
"Republic of Korea","2024-05-09",0,0,1,0,0,1,0,0
"Republic of Korea","2024-05-10",0,0,1,0,0,1,0,0
"Republic of Korea","2024-05-11",0,0,1,0,0,1,0,0
"Republic of Korea","2024-05-12",0,0,1,0,1,2,0,0
"Republic of Korea","2024-05-13",0,0,1,0,0,2,0,0
"Republic of Korea","2024-05-14",0,0,1,0,0,2,0,0
"Republic of Korea","2024-05-15",0,0,1,0,0,2,0,0
"Republic of Korea","2024-05-16",0,0,1,0,0,2,0,0
"Republic of Korea","2024-05-17",0,0,1,0,0,2,0,0
"Republic of Korea","2024-05-18",0,0,1,0,0,2,0,0
"Republic of Korea","2024-05-19",0,0,1,0,0,2,0,0
"Republic of Korea","2024-05-20",0,0,1,0,0,2,0,0
"Republic of Korea","2024-05-21",0,0,1,0,0,2,0,0
"Republic of Korea","2024-05-22",0,0,1,0,0,2,0,0
"Republic of Korea","2024-05-23",0,0,1,0,0,2,0,0
"Republic of Korea","2024-05-24",0,0,1,0,0,2,0,0
"Republic of Korea","2024-05-25",0,0,1,0,0,2,0,0
"Republic of Korea","2024-05-26",0,0,1,0,0,2,0,0
"Republic of Korea","2024-05-27",0,0,1,0,0,2,0,0
"Republic of Korea","2024-05-28",0,0,1,0,0,2,0,0
"Republic of Korea","2024-05-29",0,0,1,0,0,2,0,0
"Republic of Korea","2024-05-30",0,0,1,0,0,2,0,0
"Republic of Korea","2024-05-31",0,0,1,0,0,2,0,0
"Republic of Korea","2024-06-01",0,0,1,0,0,2,0,0
"Republic of Korea","2024-06-02",0,0,1,0,0,2,0,0
"Republic of Korea","2024-06-03",0,0,1,0,0,2,0,0
"Republic of Korea","2024-06-04",0,0,1,0,0,2,0,0
"Republic of Korea","2024-06-05",0,0,1,0,0,2,0,0
"Republic of Korea","2024-06-06",0,0,1,0,0,2,0,0
"Republic of Korea","2024-06-07",0,0,1,0,0,2,0,0
"Republic of Korea","2024-06-08",0,0,1,0,0,2,0,0
"Republic of Korea","2024-06-09",0,0,1,0,0,2,0,0
"Republic of Korea","2024-06-10",0,0,1,0,0,2,0,0
"Republic of Korea","2024-06-11",0,0,1,0,1,3,0,0
"Republic of Korea","2024-06-12",0,0,1,0,0,3,0,0
"Republic of Korea","2024-06-13",0,0,1,0,0,3,0,0
"Republic of Korea","2024-06-14",0,0,1,0,0,3,0,0
"Republic of Korea","2024-06-15",0,0,1,0,0,3,0,0
"Republic of Korea","2024-06-16",0,0,1,0,0,3,0,0
"Republic of Korea","2024-06-17",0,0,1,0,0,3,0,0
"Republic of Korea","2024-06-18",0,0,1,0,0,3,0,0
"Republic of Korea","2024-06-19",0,0,1,0,0,3,0,0
"Republic of Korea","2024-06-20",0,0,1,0,0,3,0,0
"Republic of Korea","2024-06-21",0,0,1,0,0,3,0,0
"Republic of Korea","2024-06-22",0,0,1,0,0,3,0,0
"Republic of Korea","2024-06-23",0,0,1,0,0,3,0,0
"Republic of Korea","2024-06-24",0,0,1,0,0,3,0,0
"Republic of Korea","2024-06-25",0,2,3,0,0,3,0,0
"Republic of Korea","2024-06-26",0,0,3,0,0,3,0,0
"Republic of Korea","2024-06-27",0,0,3,0,1,4,0,0
"Republic of Korea","2024-06-28",0,1,4,0,0,4,0,0
"Republic of Korea","2024-06-29",0,0,4,0,0,4,0,0
"Republic of Korea","2024-06-30",0,0,4,0,0,4,0,0
"Republic of Korea","2024-07-01",0,0,4,0,0,4,0,0
"Republic of Korea","2024-07-02",0,0,4,0,1,5,0,0
"Republic of Korea","2024-07-03",0,0,4,0,0,5,0,0
"Republic of Korea","2024-07-04",0,0,4,0,0,5,0,0
"Republic of Korea","2024-07-05",0,0,4,0,0,5,0,0
"Republic of Korea","2024-07-06",0,0,4,0,0,5,0,0
"Republic of Korea","2024-07-07",0,0,4,0,0,5,0,0
"Republic of Korea","2024-07-08",0,0,4,0,0,5,0,0
"Republic of Korea","2024-07-09",0,0,4,0,1,6,0,0
"Republic of Korea","2024-07-10",0,0,4,0,0,6,0,0
"Republic of Korea","2024-07-11",0,0,4,0,0,6,0,0
"Republic of Korea","2024-07-12",0,2,6,0,0,6,0,0
"Republic of Korea","2024-07-13",0,0,6,0,0,6,0,0
"Republic of Korea","2024-07-14",0,0,6,0,0,6,0,0
"Republic of Korea","2024-07-15",0,0,6,0,1,7,0,0
"Republic of Korea","2024-07-16",0,0,6,0,0,7,0,0
"Republic of Korea","2024-07-17",0,0,6,0,0,7,0,0
"Republic of Korea","2024-07-18",0,0,6,0,0,7,0,0
"Republic of Korea","2024-07-19",0,0,6,0,0,7,0,0
"Republic of Korea","2024-07-20",0,0,6,0,1,8,0,0
"Republic of Korea","2024-07-21",0,0,6,0,0,8,0,0
"Republic of Korea","2024-07-22",0,0,6,0,0,8,0,0
"Republic of Korea","2024-07-23",0,0,6,0,0,8,0,0
"Republic of Korea","2024-07-24",0,0,6,0,0,8,0,0
"Republic of Korea","2024-07-25",0,0,6,0,0,8,0,0
"Republic of Korea","2024-07-26",0,0,6,0,1,9,0,0
"Republic of Korea","2024-07-27",0,0,6,0,0,9,0,0
"Republic of Korea","2024-07-28",0,0,6,0,0,9,0,0
"Republic of Korea","2024-07-29",0,0,6,0,0,9,0,0
"Republic of Korea","2024-07-30",0,0,6,0,0,9,0,0
"Republic of Korea","2024-07-31",0,0,6,0,1,10,0,0
"Republic of Korea","2024-08-01",0,0,6,0,0,10,0,0
"Republic of Korea","2024-08-02",0,4,10,0,0,10,0,0
"Republic of Korea","2024-08-03",0,0,10,0,0,10,0,0
"Republic of Korea","2024-08-04",0,0,10,0,0,10,0,0
"Republic of Korea","2024-08-05",0,0,10,0,0,10,0,0
"Republic of Korea","2024-08-06",0,0,10,0,0,10,0,0
"Republic of Korea","2024-08-07",0,0,10,0,0,10,0,0
"Republic of Korea","2024-08-08",0,0,10,0,0,10,0,0
"Republic of Korea","2024-08-09",0,0,10,0,0,10,0,0
"Republic of Korea","2024-08-10",0,0,10,0,0,10,0,0
"Republic of Korea","2024-08-11",0,0,10,0,0,10,0,0
"Republic of Korea","2024-08-12",0,0,10,0,0,10,0,0
"Republic of Korea","2024-08-13",0,0,10,0,1,11,0,0
"Republic of Korea","2024-08-14",0,0,10,0,0,11,0,0
"Republic of Korea","2024-08-15",0,0,10,0,0,11,0,0
"Republic of Korea","2024-08-16",0,0,10,0,0,11,0,0
"Republic of Korea","2024-08-17",0,0,10,0,0,11,0,0
"Republic of Korea","2024-08-18",0,0,10,0,0,11,0,0
"Republic of Korea","2024-08-19",0,0,10,0,0,11,0,0
"Republic of Korea","2024-08-20",0,0,10,0,0,11,0,0
"Republic of Korea","2024-08-21",0,0,10,0,0,11,0,0
"Republic of Korea","2024-08-22",0,1,11,0,0,11,0,0
"Republic of Korea","2024-08-23",0,0,11,0,0,11,0,0
"Republic of Korea","2024-08-24",0,0,11,0,0,11,0,0
"Republic of Korea","2024-08-25",0,0,11,0,0,11,0,0
"Republic of Korea","2024-08-26",0,0,11,0,0,11,0,0
"Republic of Korea","2024-08-27",0,0,11,0,0,11,0,0
"Republic of Korea","2024-08-28",0,0,11,0,0,11,0,0
"Republic of Korea","2024-08-29",0,0,11,0,1,12,0,0
"Republic of Korea","2024-08-30",0,0,11,0,0,12,0,0
"Republic of Korea","2024-08-31",0,0,11,0,0,12,0,0
"Republic of Korea","2024-09-01",0,0,11,0,0,12,0,0
"Republic of Korea","2024-09-02",0,0,11,0,0,12,0,0
"Republic of Korea","2024-09-03",0,0,11,0,0,12,0,0
"Republic of Korea","2024-09-04",0,0,11,0,0,12,0,0
"Republic of Korea","2024-09-05",0,0,11,0,0,12,0,0
"Republic of Korea","2024-09-06",0,0,11,0,0,12,0,0
"Republic of Korea","2024-09-07",0,0,11,0,0,12,0,0
"Republic of Korea","2024-09-08",0,0,11,0,0,12,0,0
"Republic of Korea","2024-09-09",0,0,11,0,1,13,0,0
"Republic of Korea","2024-09-10",0,0,11,0,0,13,0,0
"Republic of Korea","2024-09-11",0,0,11,0,0,13,0,0
"Republic of Korea","2024-09-12",0,0,11,0,0,13,0,0
"Republic of Korea","2024-09-13",0,0,11,0,0,13,0,0
"Republic of Korea","2024-09-14",0,0,11,0,0,13,0,0
"Republic of Korea","2024-09-15",0,2,13,0,0,13,0,0
"Republic of Korea","2024-09-16",0,0,13,0,0,13,0,0
"Republic of Korea","2024-09-17",0,0,13,0,0,13,0,0
"Republic of Korea","2024-09-18",0,0,13,0,0,13,0,0
"Republic of Korea","2024-09-19",0,0,13,0,0,13,0,0
"Republic of Korea","2024-09-20",0,0,13,0,0,13,0,0
"Republic of Korea","2024-09-21",0,0,13,0,0,13,0,0
"Republic of Korea","2024-09-22",0,0,13,0,0,13,0,0
"Republic of Korea","2024-09-23",0,0,13,0,0,13,0,0
"Republic of Korea","2024-09-24",0,0,13,0,0,13,0,0
"Republic of Korea","2024-09-25",0,0,13,0,0,13,0,0
"Republic of Korea","2024-09-26",0,0,13,0,0,13,0,0
"Republic of Korea","2024-09-27",0,0,13,0,0,13,0,0
"Republic of Korea","2024-09-28",0,0,13,0,0,13,0,0
"Republic of Korea","2024-09-29",0,0,13,0,0,13,0,0
"Republic of Korea","2024-09-30",0,0,13,0,0,13,0,0
"Republic of Korea","2024-10-01",0,0,13,0,0,13,0,0
"Republic of Korea","2024-10-02",0,0,13,0,0,13,0,0
"Republic of Korea","2024-10-03",0,0,13,0,0,13,0,0
"Republic of Korea","2024-10-04",0,0,13,0,0,13,0,0
"Republic of Korea","2024-10-05",0,0,13,0,0,13,0,0
"Republic of Korea","2024-10-06",0,0,13,0,0,13,0,0
"Republic of Korea","2024-10-07",0,0,13,0,0,13,0,0
"Republic of Korea","2024-10-08",0,0,13,0,0,13,0,0
"Republic of Korea","2024-10-09",0,0,13,0,1,14,0,0
"Republic of Korea","2024-10-10",0,0,13,0,0,14,0,0
"Republic of Korea","2024-10-11",0,0,13,0,0,14,0,0
"Republic of Korea","2024-10-12",0,0,13,0,0,14,0,0
"Republic of Korea","2024-10-13",0,0,13,0,0,14,0,0
"Republic of Korea","2024-10-14",0,0,13,0,0,14,0,0
"Republic of Korea","2024-10-15",0,0,13,0,0,14,0,0
"Republic of Korea","2024-10-16",0,0,13,0,0,14,0,0
"Republic of Korea","2024-10-17",0,0,13,0,0,14,0,0
"Republic of Korea","2024-10-18",0,0,13,0,0,14,0,0
"Republic of Korea","2024-10-19",0,0,13,0,0,14,0,0
"Republic of Korea","2024-10-20",0,0,13,0,0,14,0,0
"Republic of Korea","2024-10-21",0,0,13,0,0,14,0,0
"Republic of Korea","2024-10-22",0,0,13,0,0,14,0,0
"Republic of Korea","2024-10-23",0,0,13,0,0,14,0,0
"Republic of Korea","2024-10-24",0,0,13,0,0,14,0,0
"Republic of Korea","2024-10-25",0,0,13,0,0,14,0,0
"Republic of Korea","2024-10-26",0,0,13,0,0,14,0,0
"Republic of Korea","2024-10-27",0,0,13,0,0,14,0,0
"Republic of Korea","2024-10-28",0,0,13,0,0,14,0,0
"Republic of Korea","2024-10-29",0,0,13,0,0,14,0,0
"Republic of Korea","2024-10-30",0,0,13,0,0,14,0,0
"Republic of Korea","2024-10-31",0,1,14,0,0,14,0,0
"Republic of Korea","2024-11-01",0,0,14,0,0,14,0,0
"Republic of Korea","2024-11-02",0,0,14,0,0,14,0,0
"Republic of Korea","2024-11-03",0,0,14,0,0,14,0,0
"Republic of Korea","2024-11-04",0,0,14,0,0,14,0,0
"Republic of Korea","2024-11-05",0,0,14,0,0,14,0,0
"Republic of Korea","2024-11-06",0,0,14,0,0,14,0,0
"Republic of Korea","2024-11-07",0,0,14,0,0,14,0,0
"Republic of Korea","2024-11-08",0,0,14,0,0,14,0,0
"Republic of Korea","2024-11-09",0,0,14,0,0,14,0,0
"Republic of Korea","2024-11-10",0,0,14,0,0,14,0,0
"Republic of Korea","2024-11-11",0,0,14,0,0,14,0,0
"Republic of Korea","2024-11-12",0,0,14,0,0,14,0,0
"Republic of Korea","2024-11-13",0,0,14,0,0,14,0,0
"Republic of Korea","2024-11-14",0,0,14,0,0,14,0,0
"Republic of Korea","2024-11-15",0,0,14,0,0,14,0,0
"Republic of Korea","2024-11-16",0,0,14,0,0,14,0,0
"Republic of Korea","2024-11-17",0,0,14,0,0,14,0,0
"Republic of Korea","2024-11-18",0,0,14,0,0,14,0,0
"Republic of Korea","2024-11-19",0,0,14,0,0,14,0,0
"Republic of Korea","2024-11-20",0,0,14,0,0,14,0,0
"Republic of Korea","2024-11-21",0,0,14,0,0,14,0,0
"Republic of Korea","2024-11-22",0,0,14,0,0,14,0,0
"Republic of Korea","2024-11-23",0,0,14,0,0,14,0,0
"Republic of Korea","2024-11-24",0,0,14,0,0,14,0,0
"Republic of Korea","2024-11-25",0,0,14,0,0,14,0,0
"Republic of Korea","2024-11-26",0,0,14,0,0,14,0,0
"Republic of Korea","2024-11-27",0,0,14,0,0,14,0,0
"Republic of Korea","2024-11-28",0,0,14,0,0,14,0,0
"Republic of Korea","2024-11-29",0,0,14,0,0,14,0,0
"Republic of Korea","2024-11-30",0,0,14,0,0,14,0,0
"Republic of Korea","2024-12-01",0,0,14,0,0,14,0,0
"Republic of Korea","2024-12-02",0,0,14,0,0,14,0,0
"Republic of Korea","2024-12-03",0,0,14,0,0,14,0,0
"Republic of Korea","2024-12-04",0,0,14,0,0,14,0,0
"Republic of Korea","2024-12-05",0,0,14,0,0,14,0,0
"Republic of Korea","2024-12-06",0,0,14,0,0,14,0,0
"Republic of Korea","2024-12-07",0,0,14,0,0,14,0,0
"Republic of Korea","2024-12-08",0,0,14,0,0,14,0,0
"Republic of Korea","2024-12-09",0,0,14,0,0,14,0,0
"Spain","2024-01-01",0,0,0,0,0,0,0,0
"Spain","2024-01-02",0,0,0,0,0,0,0,0
"Spain","2024-01-03",0,0,0,0,0,0,0,0
"Spain","2024-01-04",0,0,0,0,0,0,0,0
"Spain","2024-01-05",0,0,0,0,0,0,0,0
"Spain","2024-01-06",0,0,0,0,0,0,0,0
"Spain","2024-01-07",0,0,0,0,0,0,0,0
"Spain","2024-01-08",0,0,0,0,0,0,0,0
"Spain","2024-01-09",0,0,0,0,0,0,0,0
"Spain","2024-01-10",0,0,0,0,0,0,0,0
"Spain","2024-01-11",0,0,0,0,0,0,0,0
"Spain","2024-01-12",0,0,0,0,0,0,0,0
"Spain","2024-01-13",0,0,0,0,0,0,0,0
"Spain","2024-01-14",0,0,0,0,0,0,0,0
"Spain","2024-01-15",0,0,0,0,0,0,0,0
"Spain","2024-01-16",0,0,0,0,0,0,0,0
"Spain","2024-01-17",0,0,0,0,0,0,0,0
"Spain","2024-01-18",0,0,0,0,0,0,0,0
"Spain","2024-01-19",0,0,0,0,0,0,0,0
"Spain","2024-01-20",0,0,0,0,0,0,0,0
"Spain","2024-01-21",0,0,0,0,0,0,0,0
"Spain","2024-01-22",0,0,0,0,0,0,0,0
"Spain","2024-01-23",0,0,0,0,0,0,0,0
"Spain","2024-01-24",0,0,0,0,0,0,0,0
"Spain","2024-01-25",0,0,0,0,0,0,0,0
"Spain","2024-01-26",0,0,0,0,0,0,0,0
"Spain","2024-01-27",0,0,0,0,0,0,0,0
"Spain","2024-01-28",0,0,0,0,0,0,0,0
"Spain","2024-01-29",0,0,0,0,0,0,0,0
"Spain","2024-01-30",0,0,0,0,0,0,0,0
"Spain","2024-01-31",0,34,34,0,34,34,0,0
"Spain","2024-02-01",0,0,34,0,4,38,0,0
"Spain","2024-02-02",0,0,34,0,4,42,0,0
"Spain","2024-02-03",0,0,34,0,4,46,0,0
"Spain","2024-02-04",0,0,34,0,3,49,0,0
"Spain","2024-02-05",0,0,34,0,4,53,0,0
"Spain","2024-02-06",0,0,34,0,4,57,0,0
"Spain","2024-02-07",0,0,34,0,4,61,0,0
"Spain","2024-02-08",0,0,34,0,4,65,0,0
"Spain","2024-02-09",0,0,34,0,4,69,0,0
"Spain","2024-02-10",0,0,34,0,4,73,0,0
"Spain","2024-02-11",0,0,34,0,3,76,0,0
"Spain","2024-02-12",0,0,34,0,4,80,0,0
"Spain","2024-02-13",0,0,34,0,4,84,0,0
"Spain","2024-02-14",0,0,34,0,4,88,0,0
"Spain","2024-02-15",0,0,34,0,4,92,0,0
"Spain","2024-02-16",0,0,34,0,4,96,0,0
"Spain","2024-02-17",0,0,34,0,4,100,0,0
"Spain","2024-02-18",0,0,34,0,4,104,0,0
"Spain","2024-02-19",0,0,34,0,3,107,0,0
"Spain","2024-02-20",0,0,34,0,4,111,0,0
"Spain","2024-02-21",0,0,34,0,4,115,0,0
"Spain","2024-02-22",0,0,34,0,4,119,0,0
"Spain","2024-02-23",0,0,34,0,4,123,0,0
"Spain","2024-02-24",0,0,34,0,4,127,0,0
"Spain","2024-02-25",0,0,34,0,4,131,0,0
"Spain","2024-02-26",0,0,34,0,3,134,0,0
"Spain","2024-02-27",0,0,34,0,4,138,0,0
"Spain","2024-02-28",0,0,34,0,4,142,0,0
"Spain","2024-02-29",0,112,146,0,4,146,0,0
"Spain","2024-03-01",0,0,146,0,2,148,0,0
"Spain","2024-03-02",0,0,146,0,2,150,0,0
"Spain","2024-03-03",0,0,146,0,2,152,0,0
"Spain","2024-03-04",0,0,146,0,2,154,0,0
"Spain","2024-03-05",0,0,146,0,2,156,0,0
"Spain","2024-03-06",0,0,146,0,2,158,0,0
"Spain","2024-03-07",0,0,146,0,2,160,0,0
"Spain","2024-03-08",0,0,146,0,2,162,0,0
"Spain","2024-03-09",0,0,146,0,2,164,0,0
"Spain","2024-03-10",0,0,146,0,2,166,0,0
"Spain","2024-03-11",0,0,146,0,2,168,0,0
"Spain","2024-03-12",0,0,146,0,2,170,0,0
"Spain","2024-03-13",0,0,146,0,2,172,0,0
"Spain","2024-03-14",0,0,146,0,2,174,0,0
"Spain","2024-03-15",0,0,146,0,2,176,0,0
"Spain","2024-03-16",0,0,146,0,2,178,0,0
"Spain","2024-03-17",0,0,146,0,2,180,0,0
"Spain","2024-03-18",0,0,146,0,2,182,0,0
"Spain","2024-03-19",0,0,146,0,2,184,0,0
"Spain","2024-03-20",0,0,146,0,2,186,0,0
"Spain","2024-03-21",0,0,146,0,2,188,0,0
"Spain","2024-03-22",0,0,146,0,2,190,0,0
"Spain","2024-03-23",0,0,146,0,2,192,0,0
"Spain","2024-03-24",0,0,146,0,2,194,0,0
"Spain","2024-03-25",0,0,146,0,2,196,0,0
"Spain","2024-03-26",0,0,146,0,2,198,0,0
"Spain","2024-03-27",0,0,146,0,2,200,0,0
"Spain","2024-03-28",0,0,146,0,2,202,0,0
"Spain","2024-03-29",0,0,146,0,2,204,0,0
"Spain","2024-03-30",0,0,146,0,2,206,0,0
"Spain","2024-03-31",0,62,208,0,2,208,0,0
"Spain","2024-04-01",0,0,208,0,1,209,0,0
"Spain","2024-04-02",0,0,208,0,1,210,0,0
"Spain","2024-04-03",0,0,208,0,1,211,0,0
"Spain","2024-04-04",0,0,208,0,1,212,0,0
"Spain","2024-04-05",0,0,208,0,1,213,0,0
"Spain","2024-04-06",0,0,208,0,1,214,0,0
"Spain","2024-04-07",0,0,208,0,1,215,0,0
"Spain","2024-04-08",0,0,208,0,2,217,0,0
"Spain","2024-04-09",0,0,208,0,1,218,0,0
"Spain","2024-04-10",0,0,208,0,1,219,0,0
"Spain","2024-04-11",0,0,208,0,1,220,0,0
"Spain","2024-04-12",0,0,208,0,1,221,0,0
"Spain","2024-04-13",0,0,208,0,1,222,0,0
"Spain","2024-04-14",0,0,208,0,1,223,0,0
"Spain","2024-04-15",0,0,208,0,1,224,0,0
"Spain","2024-04-16",0,0,208,0,1,225,0,0
"Spain","2024-04-17",0,0,208,0,1,226,0,0
"Spain","2024-04-18",0,0,208,0,1,227,0,0
"Spain","2024-04-19",0,0,208,0,1,228,0,0
"Spain","2024-04-20",0,0,208,0,1,229,0,0
"Spain","2024-04-21",0,0,208,0,1,230,0,0
"Spain","2024-04-22",0,0,208,0,1,231,0,0
"Spain","2024-04-23",0,0,208,0,2,233,0,0
"Spain","2024-04-24",0,0,208,0,1,234,0,0
"Spain","2024-04-25",0,0,208,0,1,235,0,0
"Spain","2024-04-26",0,0,208,0,1,236,0,0
"Spain","2024-04-27",0,0,208,0,1,237,0,0
"Spain","2024-04-28",0,0,208,0,1,238,0,0
"Spain","2024-04-29",0,0,208,0,1,239,0,0
"Spain","2024-04-30",0,32,240,0,1,240,0,0
"Spain","2024-05-01",0,0,240,0,1,241,0,0
"Spain","2024-05-02",0,0,240,0,1,242,0,0
"Spain","2024-05-03",0,0,240,0,2,244,0,0
"Spain","2024-05-04",0,0,240,0,1,245,0,0
"Spain","2024-05-05",0,0,240,0,1,246,0,0
"Spain","2024-05-06",0,0,240,0,1,247,0,0
"Spain","2024-05-07",0,0,240,0,2,249,0,0
"Spain","2024-05-08",0,0,240,0,1,250,0,0
"Spain","2024-05-09",0,0,240,0,1,251,0,0
"Spain","2024-05-10",0,0,240,0,1,252,0,0
"Spain","2024-05-11",0,0,240,0,1,253,0,0
"Spain","2024-05-12",0,0,240,0,2,255,0,0
"Spain","2024-05-13",0,0,240,0,1,256,0,0
"Spain","2024-05-14",0,0,240,0,1,257,0,0
"Spain","2024-05-15",0,0,240,0,1,258,0,0
"Spain","2024-05-16",0,0,240,0,2,260,0,0
"Spain","2024-05-17",0,0,240,0,1,261,0,0
"Spain","2024-05-18",0,0,240,0,1,262,0,0
"Spain","2024-05-19",0,0,240,0,1,263,0,0
"Spain","2024-05-20",0,0,240,0,2,265,0,0
"Spain","2024-05-21",0,0,240,0,1,266,0,0
"Spain","2024-05-22",0,0,240,0,1,267,0,0
"Spain","2024-05-23",0,0,240,0,1,268,0,0
"Spain","2024-05-24",0,0,240,0,1,269,0,0
"Spain","2024-05-25",0,0,240,0,2,271,0,0
"Spain","2024-05-26",0,0,240,0,1,272,0,0
"Spain","2024-05-27",0,0,240,0,1,273,0,0
"Spain","2024-05-28",0,0,240,0,1,274,0,0
"Spain","2024-05-29",0,0,240,0,2,276,0,0
"Spain","2024-05-30",0,0,240,0,1,277,0,0
"Spain","2024-05-31",0,38,278,0,1,278,0,0
"Spain","2024-06-01",0,0,278,0,2,280,0,0
"Spain","2024-06-02",0,0,278,0,2,282,0,0
"Spain","2024-06-03",0,0,278,0,1,283,0,0
"Spain","2024-06-04",0,0,278,0,2,285,0,0
"Spain","2024-06-05",0,0,278,0,2,287,0,0
"Spain","2024-06-06",0,0,278,0,2,289,0,0
"Spain","2024-06-07",0,0,278,0,2,291,0,0
"Spain","2024-06-08",0,0,278,0,1,292,0,0
"Spain","2024-06-09",0,0,278,0,2,294,0,0
"Spain","2024-06-10",0,0,278,0,2,296,0,0
"Spain","2024-06-11",0,0,278,0,2,298,0,0
"Spain","2024-06-12",0,0,278,0,2,300,0,0
"Spain","2024-06-13",0,0,278,0,1,301,0,0
"Spain","2024-06-14",0,0,278,0,2,303,0,0
"Spain","2024-06-15",0,0,278,0,2,305,0,0
"Spain","2024-06-16",0,0,278,0,2,307,0,0
"Spain","2024-06-17",0,0,278,0,2,309,0,0
"Spain","2024-06-18",0,0,278,0,1,310,0,0
"Spain","2024-06-19",0,0,278,0,2,312,0,0
"Spain","2024-06-20",0,0,278,0,2,314,0,0
"Spain","2024-06-21",0,0,278,0,2,316,0,0
"Spain","2024-06-22",0,0,278,0,2,318,0,0
"Spain","2024-06-23",0,0,278,0,1,319,0,0
"Spain","2024-06-24",0,0,278,0,2,321,0,0
"Spain","2024-06-25",0,0,278,0,2,323,0,0
"Spain","2024-06-26",0,0,278,0,2,325,0,0
"Spain","2024-06-27",0,0,278,0,2,327,0,0
"Spain","2024-06-28",0,0,278,0,1,328,0,0
"Spain","2024-06-29",0,0,278,0,2,330,0,0
"Spain","2024-06-30",0,54,332,0,2,332,0,0
"Spain","2024-07-01",0,0,332,0,1,333,0,0
"Spain","2024-07-02",0,0,332,0,0,333,0,0
"Spain","2024-07-03",0,0,332,0,1,334,0,0
"Spain","2024-07-04",0,0,332,0,1,335,0,0
"Spain","2024-07-05",0,0,332,0,0,335,0,0
"Spain","2024-07-06",0,0,332,0,1,336,0,0
"Spain","2024-07-07",0,0,332,0,1,337,0,0
"Spain","2024-07-08",0,0,332,0,0,337,0,0
"Spain","2024-07-09",0,0,332,0,1,338,0,0
"Spain","2024-07-10",0,0,332,0,0,338,0,0
"Spain","2024-07-11",0,0,332,0,1,339,0,0
"Spain","2024-07-12",0,0,332,0,1,340,0,0
"Spain","2024-07-13",0,0,332,0,0,340,0,0
"Spain","2024-07-14",0,0,332,0,1,341,0,0
"Spain","2024-07-15",0,0,332,0,1,342,0,0
"Spain","2024-07-16",0,0,332,0,0,342,0,0
"Spain","2024-07-17",0,0,332,0,1,343,0,0
"Spain","2024-07-18",0,0,332,0,1,344,0,0
"Spain","2024-07-19",0,0,332,0,0,344,0,0
"Spain","2024-07-20",0,0,332,0,1,345,0,0
"Spain","2024-07-21",0,0,332,0,1,346,0,0
"Spain","2024-07-22",0,0,332,0,0,346,0,0
"Spain","2024-07-23",0,0,332,0,1,347,0,0
"Spain","2024-07-24",0,0,332,0,0,347,0,0
"Spain","2024-07-25",0,0,332,0,1,348,0,0
"Spain","2024-07-26",0,0,332,0,1,349,0,0
"Spain","2024-07-27",0,0,332,0,0,349,0,0
"Spain","2024-07-28",0,0,332,0,1,350,0,0
"Spain","2024-07-29",0,0,332,0,1,351,0,0
"Spain","2024-07-30",0,0,332,0,0,351,0,0
"Spain","2024-07-31",0,20,352,0,1,352,0,0
"Spain","2024-08-01",0,0,352,0,4,356,0,0
"Spain","2024-08-02",0,0,352,0,5,361,0,0
"Spain","2024-08-03",0,0,352,0,4,365,0,0
"Spain","2024-08-04",0,0,352,0,5,370,0,0
"Spain","2024-08-05",0,0,352,0,4,374,0,0
"Spain","2024-08-06",0,0,352,0,4,378,0,0
"Spain","2024-08-07",0,0,352,0,5,383,0,0
"Spain","2024-08-08",0,0,352,0,4,387,0,0
"Spain","2024-08-09",0,0,352,0,4,391,0,0
"Spain","2024-08-10",0,0,352,0,5,396,0,0
"Spain","2024-08-11",0,0,352,0,4,400,0,0
"Spain","2024-08-12",0,0,352,0,5,405,0,0
"Spain","2024-08-13",0,0,352,0,4,409,0,0
"Spain","2024-08-14",0,0,352,0,4,413,0,0
"Spain","2024-08-15",0,0,352,0,5,418,0,0
"Spain","2024-08-16",0,0,352,0,4,422,0,0
"Spain","2024-08-17",0,0,352,0,5,427,0,0
"Spain","2024-08-18",0,0,352,0,4,431,0,0
"Spain","2024-08-19",0,0,352,0,4,435,0,0
"Spain","2024-08-20",0,0,352,0,5,440,0,0
"Spain","2024-08-21",0,0,352,0,4,444,0,0
"Spain","2024-08-22",0,0,352,0,5,449,0,0
"Spain","2024-08-23",0,0,352,0,4,453,0,0
"Spain","2024-08-24",0,0,352,0,4,457,0,0
"Spain","2024-08-25",0,0,352,0,5,462,0,0
"Spain","2024-08-26",0,0,352,0,4,466,0,0
"Spain","2024-08-27",0,0,352,0,4,470,0,0
"Spain","2024-08-28",0,0,352,0,5,475,0,0
"Spain","2024-08-29",0,0,352,0,4,479,0,0
"Spain","2024-08-30",0,0,352,0,5,484,0,0
"Spain","2024-08-31",0,136,488,0,4,488,0,0
"Spain","2024-09-01",0,0,488,0,1,489,0,0
"Spain","2024-09-02",0,0,488,0,2,491,0,0
"Spain","2024-09-03",0,0,488,0,1,492,0,0
"Spain","2024-09-04",0,0,488,0,2,494,0,0
"Spain","2024-09-05",0,0,488,0,1,495,0,0
"Spain","2024-09-06",0,0,488,0,1,496,0,0
"Spain","2024-09-07",0,0,488,0,2,498,0,0
"Spain","2024-09-08",0,0,488,0,1,499,0,0
"Spain","2024-09-09",0,0,488,0,2,501,0,0
"Spain","2024-09-10",0,0,488,0,1,502,0,0
"Spain","2024-09-11",0,0,488,0,1,503,0,0
"Spain","2024-09-12",0,0,488,0,2,505,0,0
"Spain","2024-09-13",0,0,488,0,1,506,0,0
"Spain","2024-09-14",0,0,488,0,2,508,0,0
"Spain","2024-09-15",0,0,488,0,1,509,0,0
"Spain","2024-09-16",0,0,488,0,1,510,0,0
"Spain","2024-09-17",0,0,488,0,2,512,0,0
"Spain","2024-09-18",0,0,488,0,1,513,0,0
"Spain","2024-09-19",0,0,488,0,2,515,0,0
"Spain","2024-09-20",0,0,488,0,1,516,0,0
"Spain","2024-09-21",0,0,488,0,1,517,0,0
"Spain","2024-09-22",0,0,488,0,2,519,0,0
"Spain","2024-09-23",0,0,488,0,1,520,0,0
"Spain","2024-09-24",0,0,488,0,2,522,0,0
"Spain","2024-09-25",0,0,488,0,1,523,0,0
"Spain","2024-09-26",0,0,488,0,1,524,0,0
"Spain","2024-09-27",0,0,488,0,2,526,0,0
"Spain","2024-09-28",0,0,488,0,1,527,0,0
"Spain","2024-09-29",0,0,488,0,2,529,0,0
"Spain","2024-09-30",0,42,530,0,1,530,0,0
"Spain","2024-10-01",0,0,530,0,2,532,0,0
"Spain","2024-10-02",0,0,530,0,2,534,0,0
"Spain","2024-10-03",0,0,530,0,2,536,0,0
"Spain","2024-10-04",0,0,530,0,2,538,0,0
"Spain","2024-10-05",0,0,530,0,2,540,0,0
"Spain","2024-10-06",0,0,530,0,2,542,0,0
"Spain","2024-10-07",0,0,530,0,2,544,0,0
"Spain","2024-10-08",0,0,530,0,3,547,0,0
"Spain","2024-10-09",0,0,530,0,2,549,0,0
"Spain","2024-10-10",0,0,530,0,2,551,0,0
"Spain","2024-10-11",0,0,530,0,2,553,0,0
"Spain","2024-10-12",0,0,530,0,2,555,0,0
"Spain","2024-10-13",0,0,530,0,2,557,0,0
"Spain","2024-10-14",0,0,530,0,2,559,0,0
"Spain","2024-10-15",0,0,530,0,2,561,0,0
"Spain","2024-10-16",0,0,530,0,2,563,0,0
"Spain","2024-10-17",0,0,530,0,2,565,0,0
"Spain","2024-10-18",0,0,530,0,2,567,0,0
"Spain","2024-10-19",0,0,530,0,2,569,0,0
"Spain","2024-10-20",0,0,530,0,2,571,0,0
"Spain","2024-10-21",0,0,530,0,2,573,0,0
"Spain","2024-10-22",0,0,530,0,2,575,0,0
"Spain","2024-10-23",0,0,530,0,2,577,0,0
"Spain","2024-10-24",0,0,530,0,3,580,0,0
"Spain","2024-10-25",0,0,530,0,2,582,0,0
"Spain","2024-10-26",0,0,530,0,2,584,0,0
"Spain","2024-10-27",0,0,530,0,2,586,0,0
"Spain","2024-10-28",0,0,530,0,2,588,0,0
"Spain","2024-10-29",0,0,530,0,2,590,0,0
"Spain","2024-10-30",0,0,530,0,2,592,0,0
"Spain","2024-10-31",0,64,594,0,2,594,0,0
"Spain","2024-11-01",0,0,594,0,0,594,0,0
"Spain","2024-11-02",0,0,594,0,0,594,0,0
"Spain","2024-11-03",0,0,594,0,0,594,0,0
"Spain","2024-11-04",0,0,594,0,0,594,0,0
"Spain","2024-11-05",0,0,594,0,0,594,0,0
"Spain","2024-11-06",0,0,594,0,0,594,0,0
"Spain","2024-11-07",0,0,594,0,0,594,0,0
"Spain","2024-11-08",0,0,594,0,0,594,0,0
"Spain","2024-11-09",0,0,594,0,0,594,0,0
"Spain","2024-11-10",0,0,594,0,0,594,0,0
"Spain","2024-11-11",0,0,594,0,0,594,0,0
"Spain","2024-11-12",0,0,594,0,0,594,0,0
"Spain","2024-11-13",0,0,594,0,0,594,0,0
"Spain","2024-11-14",0,0,594,0,0,594,0,0
"Spain","2024-11-15",0,0,594,0,0,594,0,0
"Spain","2024-11-16",0,0,594,0,0,594,0,0
"Spain","2024-11-17",0,0,594,0,0,594,0,0
"Spain","2024-11-18",0,0,594,0,0,594,0,0
"Spain","2024-11-19",0,0,594,0,0,594,0,0
"Spain","2024-11-20",0,0,594,0,0,594,0,0
"Spain","2024-11-21",0,0,594,0,0,594,0,0
"Spain","2024-11-22",0,0,594,0,0,594,0,0
"Spain","2024-11-23",0,0,594,0,0,594,0,0
"Spain","2024-11-24",0,0,594,0,0,594,0,0
"Spain","2024-11-25",0,0,594,0,0,594,0,0
"Spain","2024-11-26",0,0,594,0,0,594,0,0
"Spain","2024-11-27",0,0,594,0,0,594,0,0
"Spain","2024-11-28",0,0,594,0,0,594,0,0
"Spain","2024-11-29",0,0,594,0,0,594,0,0
"Spain","2024-11-30",0,0,594,0,0,594,0,0
"Spain","2024-12-01",0,0,594,0,0,594,0,0
"Spain","2024-12-02",0,0,594,0,0,594,0,0
"Spain","2024-12-03",0,0,594,0,0,594,0,0
"Spain","2024-12-04",0,0,594,0,0,594,0,0
"Spain","2024-12-05",0,0,594,0,0,594,0,0
"Spain","2024-12-06",0,0,594,0,0,594,0,0
"Spain","2024-12-07",0,0,594,0,0,594,0,0
"Spain","2024-12-08",0,0,594,0,0,594,0,0
"Spain","2024-12-09",0,0,594,0,0,594,0,0
"Sri Lanka","2024-01-01",0,0,0,0,0,0,0,0
"Sri Lanka","2024-01-02",0,0,0,0,0,0,0,0
"Sri Lanka","2024-01-03",0,0,0,0,0,0,0,0
"Sri Lanka","2024-01-04",0,0,0,0,0,0,0,0
"Sri Lanka","2024-01-05",0,0,0,0,0,0,0,0
"Sri Lanka","2024-01-06",0,0,0,0,0,0,0,0
"Sri Lanka","2024-01-07",0,0,0,0,0,0,0,0
"Sri Lanka","2024-01-08",0,0,0,0,0,0,0,0
"Sri Lanka","2024-01-09",0,0,0,0,0,0,0,0
"Sri Lanka","2024-01-10",0,0,0,0,0,0,0,0
"Sri Lanka","2024-01-11",0,0,0,0,0,0,0,0
"Sri Lanka","2024-01-12",0,0,0,0,0,0,0,0
"Sri Lanka","2024-01-13",0,0,0,0,0,0,0,0
"Sri Lanka","2024-01-14",0,0,0,0,0,0,0,0
"Sri Lanka","2024-01-15",0,0,0,0,0,0,0,0
"Sri Lanka","2024-01-16",0,0,0,0,0,0,0,0
"Sri Lanka","2024-01-17",0,0,0,0,0,0,0,0
"Sri Lanka","2024-01-18",0,0,0,0,0,0,0,0
"Sri Lanka","2024-01-19",0,0,0,0,0,0,0,0
"Sri Lanka","2024-01-20",0,0,0,0,0,0,0,0
"Sri Lanka","2024-01-21",0,0,0,0,0,0,0,0
"Sri Lanka","2024-01-22",0,0,0,0,0,0,0,0
"Sri Lanka","2024-01-23",0,0,0,0,0,0,0,0
"Sri Lanka","2024-01-24",0,0,0,0,0,0,0,0
"Sri Lanka","2024-01-25",0,0,0,0,0,0,0,0
"Sri Lanka","2024-01-26",0,0,0,0,0,0,0,0
"Sri Lanka","2024-01-27",0,0,0,0,0,0,0,0
"Sri Lanka","2024-01-28",0,0,0,0,0,0,0,0
"Sri Lanka","2024-01-29",0,0,0,0,0,0,0,0
"Sri Lanka","2024-01-30",0,0,0,0,0,0,0,0
"Sri Lanka","2024-01-31",0,0,0,0,0,0,0,0
"Sri Lanka","2024-02-01",0,0,0,0,0,0,0,0
"Sri Lanka","2024-02-02",0,0,0,0,0,0,0,0
"Sri Lanka","2024-02-03",0,0,0,0,0,0,0,0
"Sri Lanka","2024-02-04",0,0,0,0,0,0,0,0
"Sri Lanka","2024-02-05",0,0,0,0,0,0,0,0
"Sri Lanka","2024-02-06",0,0,0,0,0,0,0,0
"Sri Lanka","2024-02-07",0,0,0,0,0,0,0,0
"Sri Lanka","2024-02-08",0,0,0,0,0,0,0,0
"Sri Lanka","2024-02-09",0,0,0,0,0,0,0,0
"Sri Lanka","2024-02-10",0,0,0,0,0,0,0,0
"Sri Lanka","2024-02-11",0,0,0,0,0,0,0,0
"Sri Lanka","2024-02-12",0,0,0,0,0,0,0,0
"Sri Lanka","2024-02-13",0,0,0,0,0,0,0,0
"Sri Lanka","2024-02-14",0,0,0,0,0,0,0,0
"Sri Lanka","2024-02-15",0,0,0,0,0,0,0,0
"Sri Lanka","2024-02-16",0,0,0,0,0,0,0,0
"Sri Lanka","2024-02-17",0,0,0,0,0,0,0,0
"Sri Lanka","2024-02-18",0,0,0,0,0,0,0,0
"Sri Lanka","2024-02-19",0,0,0,0,0,0,0,0
"Sri Lanka","2024-02-20",0,0,0,0,0,0,0,0
"Sri Lanka","2024-02-21",0,0,0,0,0,0,0,0
"Sri Lanka","2024-02-22",0,0,0,0,0,0,0,0
"Sri Lanka","2024-02-23",0,0,0,0,0,0,0,0
"Sri Lanka","2024-02-24",0,0,0,0,0,0,0,0
"Sri Lanka","2024-02-25",0,0,0,0,0,0,0,0
"Sri Lanka","2024-02-26",0,0,0,0,0,0,0,0
"Sri Lanka","2024-02-27",0,0,0,0,0,0,0,0
"Sri Lanka","2024-02-28",0,0,0,0,0,0,0,0
"Sri Lanka","2024-02-29",0,0,0,0,0,0,0,0
"Sri Lanka","2024-03-01",0,0,0,0,0,0,0,0
"Sri Lanka","2024-03-02",0,0,0,0,0,0,0,0
"Sri Lanka","2024-03-03",0,0,0,0,0,0,0,0
"Sri Lanka","2024-03-04",0,0,0,0,0,0,0,0
"Sri Lanka","2024-03-05",0,0,0,0,0,0,0,0
"Sri Lanka","2024-03-06",0,0,0,0,0,0,0,0
"Sri Lanka","2024-03-07",0,0,0,0,0,0,0,0
"Sri Lanka","2024-03-08",0,0,0,0,0,0,0,0
"Sri Lanka","2024-03-09",0,0,0,0,0,0,0,0
"Sri Lanka","2024-03-10",0,0,0,0,0,0,0,0
"Sri Lanka","2024-03-11",0,0,0,0,0,0,0,0
"Sri Lanka","2024-03-12",0,0,0,0,0,0,0,0
"Sri Lanka","2024-03-13",0,0,0,0,0,0,0,0
"Sri Lanka","2024-03-14",0,0,0,0,0,0,0,0
"Sri Lanka","2024-03-15",0,0,0,0,0,0,0,0
"Sri Lanka","2024-03-16",0,0,0,0,0,0,0,0
"Sri Lanka","2024-03-17",0,0,0,0,0,0,0,0
"Sri Lanka","2024-03-18",0,0,0,0,0,0,0,0
"Sri Lanka","2024-03-19",0,0,0,0,0,0,0,0
"Sri Lanka","2024-03-20",0,0,0,0,0,0,0,0
"Sri Lanka","2024-03-21",0,0,0,0,0,0,0,0
"Sri Lanka","2024-03-22",0,0,0,0,0,0,0,0
"Sri Lanka","2024-03-23",0,0,0,0,0,0,0,0
"Sri Lanka","2024-03-24",0,0,0,0,0,0,0,0
"Sri Lanka","2024-03-25",0,0,0,0,0,0,0,0
"Sri Lanka","2024-03-26",0,0,0,0,0,0,0,0
"Sri Lanka","2024-03-27",0,0,0,0,0,0,0,0
"Sri Lanka","2024-03-28",0,0,0,0,0,0,0,0
"Sri Lanka","2024-03-29",0,0,0,0,0,0,0,0
"Sri Lanka","2024-03-30",0,0,0,0,0,0,0,0
"Sri Lanka","2024-03-31",0,0,0,0,0,0,0,0
"Sri Lanka","2024-04-01",0,0,0,0,0,0,0,0
"Sri Lanka","2024-04-02",0,0,0,0,0,0,0,0
"Sri Lanka","2024-04-03",0,0,0,0,0,0,0,0
"Sri Lanka","2024-04-04",0,0,0,0,0,0,0,0
"Sri Lanka","2024-04-05",0,0,0,0,0,0,0,0
"Sri Lanka","2024-04-06",0,0,0,0,0,0,0,0
"Sri Lanka","2024-04-07",0,0,0,0,0,0,0,0
"Sri Lanka","2024-04-08",0,0,0,0,0,0,0,0
"Sri Lanka","2024-04-09",0,0,0,0,0,0,0,0
"Sri Lanka","2024-04-10",0,0,0,0,0,0,0,0
"Sri Lanka","2024-04-11",0,0,0,0,0,0,0,0
"Sri Lanka","2024-04-12",0,0,0,0,0,0,0,0
"Sri Lanka","2024-04-13",0,0,0,0,0,0,0,0
"Sri Lanka","2024-04-14",0,0,0,0,0,0,0,0
"Sri Lanka","2024-04-15",0,0,0,0,0,0,0,0
"Sri Lanka","2024-04-16",0,0,0,0,0,0,0,0
"Sri Lanka","2024-04-17",0,0,0,0,0,0,0,0
"Sri Lanka","2024-04-18",0,0,0,0,0,0,0,0
"Sri Lanka","2024-04-19",0,0,0,0,0,0,0,0
"Sri Lanka","2024-04-20",0,0,0,0,0,0,0,0
"Sri Lanka","2024-04-21",0,0,0,0,0,0,0,0
"Sri Lanka","2024-04-22",0,0,0,0,0,0,0,0
"Sri Lanka","2024-04-23",0,0,0,0,0,0,0,0
"Sri Lanka","2024-04-24",0,0,0,0,0,0,0,0
"Sri Lanka","2024-04-25",0,0,0,0,0,0,0,0
"Sri Lanka","2024-04-26",0,0,0,0,0,0,0,0
"Sri Lanka","2024-04-27",0,0,0,0,0,0,0,0
"Sri Lanka","2024-04-28",0,0,0,0,0,0,0,0
"Sri Lanka","2024-04-29",0,0,0,0,0,0,0,0
"Sri Lanka","2024-04-30",0,0,0,0,0,0,0,0
"Sri Lanka","2024-05-01",0,0,0,0,0,0,0,0
"Sri Lanka","2024-05-02",0,0,0,0,0,0,0,0
"Sri Lanka","2024-05-03",0,0,0,0,0,0,0,0
"Sri Lanka","2024-05-04",0,0,0,0,0,0,0,0
"Sri Lanka","2024-05-05",0,0,0,0,0,0,0,0
"Sri Lanka","2024-05-06",0,0,0,0,0,0,0,0
"Sri Lanka","2024-05-07",0,0,0,0,0,0,0,0
"Sri Lanka","2024-05-08",0,0,0,0,0,0,0,0
"Sri Lanka","2024-05-09",0,0,0,0,0,0,0,0
"Sri Lanka","2024-05-10",0,0,0,0,0,0,0,0
"Sri Lanka","2024-05-11",0,0,0,0,0,0,0,0
"Sri Lanka","2024-05-12",0,0,0,0,0,0,0,0
"Sri Lanka","2024-05-13",0,0,0,0,0,0,0,0
"Sri Lanka","2024-05-14",0,0,0,0,0,0,0,0
"Sri Lanka","2024-05-15",0,0,0,0,0,0,0,0
"Sri Lanka","2024-05-16",0,0,0,0,0,0,0,0
"Sri Lanka","2024-05-17",0,0,0,0,0,0,0,0
"Sri Lanka","2024-05-18",0,0,0,0,0,0,0,0
"Sri Lanka","2024-05-19",0,0,0,0,0,0,0,0
"Sri Lanka","2024-05-20",0,0,0,0,0,0,0,0
"Sri Lanka","2024-05-21",0,0,0,0,0,0,0,0
"Sri Lanka","2024-05-22",0,0,0,0,0,0,0,0
"Sri Lanka","2024-05-23",0,0,0,0,0,0,0,0
"Sri Lanka","2024-05-24",0,0,0,0,0,0,0,0
"Sri Lanka","2024-05-25",0,0,0,0,0,0,0,0
"Sri Lanka","2024-05-26",0,0,0,0,0,0,0,0
"Sri Lanka","2024-05-27",0,0,0,0,0,0,0,0
"Sri Lanka","2024-05-28",0,0,0,0,0,0,0,0
"Sri Lanka","2024-05-29",0,0,0,0,0,0,0,0
"Sri Lanka","2024-05-30",0,0,0,0,0,0,0,0
"Sri Lanka","2024-05-31",0,0,0,0,0,0,0,0
"Sri Lanka","2024-06-01",0,0,0,0,0,0,0,0
"Sri Lanka","2024-06-02",0,0,0,0,0,0,0,0
"Sri Lanka","2024-06-03",0,0,0,0,0,0,0,0
"Sri Lanka","2024-06-04",0,0,0,0,0,0,0,0
"Sri Lanka","2024-06-05",0,0,0,0,0,0,0,0
"Sri Lanka","2024-06-06",0,0,0,0,0,0,0,0
"Sri Lanka","2024-06-07",0,0,0,0,0,0,0,0
"Sri Lanka","2024-06-08",0,0,0,0,0,0,0,0
"Sri Lanka","2024-06-09",0,0,0,0,0,0,0,0
"Sri Lanka","2024-06-10",0,0,0,0,0,0,0,0
"Sri Lanka","2024-06-11",0,0,0,0,0,0,0,0
"Sri Lanka","2024-06-12",0,0,0,0,0,0,0,0
"Sri Lanka","2024-06-13",0,0,0,0,0,0,0,0
"Sri Lanka","2024-06-14",0,0,0,0,0,0,0,0
"Sri Lanka","2024-06-15",0,0,0,0,0,0,0,0
"Sri Lanka","2024-06-16",0,0,0,0,0,0,0,0
"Sri Lanka","2024-06-17",0,0,0,0,0,0,0,0
"Sri Lanka","2024-06-18",0,0,0,0,0,0,0,0
"Sri Lanka","2024-06-19",0,0,0,0,0,0,0,0
"Sri Lanka","2024-06-20",0,0,0,0,0,0,0,0
"Sri Lanka","2024-06-21",0,0,0,0,0,0,0,0
"Sri Lanka","2024-06-22",0,0,0,0,0,0,0,0
"Sri Lanka","2024-06-23",0,0,0,0,0,0,0,0
"Sri Lanka","2024-06-24",0,0,0,0,0,0,0,0
"Sri Lanka","2024-06-25",0,0,0,0,0,0,0,0
"Sri Lanka","2024-06-26",0,0,0,0,0,0,0,0
"Sri Lanka","2024-06-27",0,0,0,0,0,0,0,0
"Sri Lanka","2024-06-28",0,0,0,0,0,0,0,0
"Sri Lanka","2024-06-29",0,0,0,0,0,0,0,0
"Sri Lanka","2024-06-30",0,0,0,0,0,0,0,0
"Sri Lanka","2024-07-01",0,0,0,0,0,0,0,0
"Sri Lanka","2024-07-02",0,0,0,0,0,0,0,0
"Sri Lanka","2024-07-03",0,0,0,0,0,0,0,0
"Sri Lanka","2024-07-04",0,0,0,0,0,0,0,0
"Sri Lanka","2024-07-05",0,0,0,0,0,0,0,0
"Sri Lanka","2024-07-06",0,0,0,0,0,0,0,0
"Sri Lanka","2024-07-07",0,0,0,0,0,0,0,0
"Sri Lanka","2024-07-08",0,0,0,0,0,0,0,0
"Sri Lanka","2024-07-09",0,0,0,0,0,0,0,0
"Sri Lanka","2024-07-10",0,0,0,0,0,0,0,0
"Sri Lanka","2024-07-11",0,0,0,0,0,0,0,0
"Sri Lanka","2024-07-12",0,0,0,0,0,0,0,0
"Sri Lanka","2024-07-13",0,0,0,0,0,0,0,0
"Sri Lanka","2024-07-14",0,0,0,0,0,0,0,0
"Sri Lanka","2024-07-15",0,0,0,0,0,0,0,0
"Sri Lanka","2024-07-16",0,0,0,0,0,0,0,0
"Sri Lanka","2024-07-17",0,0,0,0,0,0,0,0
"Sri Lanka","2024-07-18",0,0,0,0,0,0,0,0
"Sri Lanka","2024-07-19",0,0,0,0,0,0,0,0
"Sri Lanka","2024-07-20",0,0,0,0,0,0,0,0
"Sri Lanka","2024-07-21",0,0,0,0,0,0,0,0
"Sri Lanka","2024-07-22",0,0,0,0,0,0,0,0
"Sri Lanka","2024-07-23",0,0,0,0,0,0,0,0
"Sri Lanka","2024-07-24",0,0,0,0,0,0,0,0
"Sri Lanka","2024-07-25",0,0,0,0,0,0,0,0
"Sri Lanka","2024-07-26",0,0,0,0,0,0,0,0
"Sri Lanka","2024-07-27",0,0,0,0,0,0,0,0
"Sri Lanka","2024-07-28",0,0,0,0,0,0,0,0
"Sri Lanka","2024-07-29",0,0,0,0,0,0,0,0
"Sri Lanka","2024-07-30",0,0,0,0,0,0,0,0
"Sri Lanka","2024-07-31",0,0,0,0,0,0,0,0
"Sri Lanka","2024-08-01",0,0,0,0,0,0,0,0
"Sri Lanka","2024-08-02",0,0,0,0,0,0,0,0
"Sri Lanka","2024-08-03",0,0,0,0,0,0,0,0
"Sri Lanka","2024-08-04",0,0,0,0,0,0,0,0
"Sri Lanka","2024-08-05",0,0,0,0,0,0,0,0
"Sri Lanka","2024-08-06",0,0,0,0,0,0,0,0
"Sri Lanka","2024-08-07",0,0,0,0,0,0,0,0
"Sri Lanka","2024-08-08",0,0,0,0,0,0,0,0
"Sri Lanka","2024-08-09",0,0,0,0,0,0,0,0
"Sri Lanka","2024-08-10",0,0,0,0,0,0,0,0
"Sri Lanka","2024-08-11",0,0,0,0,0,0,0,0
"Sri Lanka","2024-08-12",0,0,0,0,0,0,0,0
"Sri Lanka","2024-08-13",0,0,0,0,0,0,0,0
"Sri Lanka","2024-08-14",0,0,0,0,0,0,0,0
"Sri Lanka","2024-08-15",0,0,0,0,0,0,0,0
"Sri Lanka","2024-08-16",0,0,0,0,0,0,0,0
"Sri Lanka","2024-08-17",0,0,0,0,0,0,0,0
"Sri Lanka","2024-08-18",0,0,0,0,0,0,0,0
"Sri Lanka","2024-08-19",0,0,0,0,0,0,0,0
"Sri Lanka","2024-08-20",0,0,0,0,0,0,0,0
"Sri Lanka","2024-08-21",0,0,0,0,0,0,0,0
"Sri Lanka","2024-08-22",0,0,0,0,0,0,0,0
"Sri Lanka","2024-08-23",0,0,0,0,0,0,0,0
"Sri Lanka","2024-08-24",0,0,0,0,0,0,0,0
"Sri Lanka","2024-08-25",0,0,0,0,0,0,0,0
"Sri Lanka","2024-08-26",0,0,0,0,0,0,0,0
"Sri Lanka","2024-08-27",0,0,0,0,0,0,0,0
"Sri Lanka","2024-08-28",0,0,0,0,0,0,0,0
"Sri Lanka","2024-08-29",0,0,0,0,0,0,0,0
"Sri Lanka","2024-08-30",0,0,0,0,0,0,0,0
"Sri Lanka","2024-08-31",0,0,0,0,0,0,0,0
"Sri Lanka","2024-09-01",0,0,0,0,0,0,0,0
"Sri Lanka","2024-09-02",0,0,0,0,0,0,0,0
"Sri Lanka","2024-09-03",0,0,0,0,0,0,0,0
"Sri Lanka","2024-09-04",0,0,0,0,0,0,0,0
"Sri Lanka","2024-09-05",0,0,0,0,0,0,0,0
"Sri Lanka","2024-09-06",0,0,0,0,0,0,0,0
"Sri Lanka","2024-09-07",0,0,0,0,0,0,0,0
"Sri Lanka","2024-09-08",0,0,0,0,0,0,0,0
"Sri Lanka","2024-09-09",0,0,0,0,0,0,0,0
"Sri Lanka","2024-09-10",0,0,0,0,0,0,0,0
"Sri Lanka","2024-09-11",0,0,0,0,0,0,0,0
"Sri Lanka","2024-09-12",0,0,0,0,0,0,0,0
"Sri Lanka","2024-09-13",0,0,0,0,0,0,0,0
"Sri Lanka","2024-09-14",0,0,0,0,0,0,0,0
"Sri Lanka","2024-09-15",0,0,0,0,0,0,0,0
"Sri Lanka","2024-09-16",0,0,0,0,0,0,0,0
"Sri Lanka","2024-09-17",0,0,0,0,0,0,0,0
"Sri Lanka","2024-09-18",0,0,0,0,0,0,0,0
"Sri Lanka","2024-09-19",0,0,0,0,0,0,0,0
"Sri Lanka","2024-09-20",0,0,0,0,0,0,0,0
"Sri Lanka","2024-09-21",0,0,0,0,0,0,0,0
"Sri Lanka","2024-09-22",0,0,0,0,0,0,0,0
"Sri Lanka","2024-09-23",0,0,0,0,0,0,0,0
"Sri Lanka","2024-09-24",0,0,0,0,0,0,0,0
"Sri Lanka","2024-09-25",0,0,0,0,0,0,0,0
"Sri Lanka","2024-09-26",0,0,0,0,0,0,0,0
"Sri Lanka","2024-09-27",0,0,0,0,0,0,0,0
"Sri Lanka","2024-09-28",0,0,0,0,0,0,0,0
"Sri Lanka","2024-09-29",0,0,0,0,0,0,0,0
"Sri Lanka","2024-09-30",0,0,0,0,0,0,0,0
"Sri Lanka","2024-10-01",0,0,0,0,0,0,0,0
"Sri Lanka","2024-10-02",0,0,0,0,0,0,0,0
"Sri Lanka","2024-10-03",0,0,0,0,0,0,0,0
"Sri Lanka","2024-10-04",0,0,0,0,0,0,0,0
"Sri Lanka","2024-10-05",0,0,0,0,0,0,0,0
"Sri Lanka","2024-10-06",0,0,0,0,0,0,0,0
"Sri Lanka","2024-10-07",0,0,0,0,0,0,0,0
"Sri Lanka","2024-10-08",0,0,0,0,0,0,0,0
"Sri Lanka","2024-10-09",0,0,0,0,0,0,0,0
"Sri Lanka","2024-10-10",0,0,0,0,0,0,0,0
"Sri Lanka","2024-10-11",0,0,0,0,0,0,0,0
"Sri Lanka","2024-10-12",0,0,0,0,0,0,0,0
"Sri Lanka","2024-10-13",0,0,0,0,0,0,0,0
"Sri Lanka","2024-10-14",0,0,0,0,0,0,0,0
"Sri Lanka","2024-10-15",0,0,0,0,0,0,0,0
"Sri Lanka","2024-10-16",0,0,0,0,0,0,0,0
"Sri Lanka","2024-10-17",0,0,0,0,0,0,0,0
"Sri Lanka","2024-10-18",0,0,0,0,0,0,0,0
"Sri Lanka","2024-10-19",0,0,0,0,0,0,0,0
"Sri Lanka","2024-10-20",0,0,0,0,0,0,0,0
"Sri Lanka","2024-10-21",0,0,0,0,0,0,0,0
"Sri Lanka","2024-10-22",0,0,0,0,0,0,0,0
"Sri Lanka","2024-10-23",0,0,0,0,0,0,0,0
"Sri Lanka","2024-10-24",0,0,0,0,0,0,0,0
"Sri Lanka","2024-10-25",0,0,0,0,0,0,0,0
"Sri Lanka","2024-10-26",0,0,0,0,0,0,0,0
"Sri Lanka","2024-10-27",0,0,0,0,0,0,0,0
"Sri Lanka","2024-10-28",0,0,0,0,0,0,0,0
"Sri Lanka","2024-10-29",0,0,0,0,0,0,0,0
"Sri Lanka","2024-10-30",0,0,0,0,0,0,0,0
"Sri Lanka","2024-10-31",0,0,0,0,0,0,0,0
"Sri Lanka","2024-11-01",0,0,0,0,0,0,0,0
"Sri Lanka","2024-11-02",0,0,0,0,0,0,0,0
"Sri Lanka","2024-11-03",0,0,0,0,0,0,0,0
"Sri Lanka","2024-11-04",0,0,0,0,0,0,0,0
"Sri Lanka","2024-11-05",0,0,0,0,0,0,0,0
"Sri Lanka","2024-11-06",0,0,0,0,0,0,0,0
"Sri Lanka","2024-11-07",0,0,0,0,0,0,0,0
"Sri Lanka","2024-11-08",0,0,0,0,0,0,0,0
"Sri Lanka","2024-11-09",0,0,0,0,0,0,0,0
"Sri Lanka","2024-11-10",0,0,0,0,0,0,0,0
"Sri Lanka","2024-11-11",0,0,0,0,0,0,0,0
"Sri Lanka","2024-11-12",0,0,0,0,0,0,0,0
"Sri Lanka","2024-11-13",0,0,0,0,0,0,0,0
"Sri Lanka","2024-11-14",0,0,0,0,0,0,0,0
"Sri Lanka","2024-11-15",0,0,0,0,0,0,0,0
"Sri Lanka","2024-11-16",0,0,0,0,0,0,0,0
"Sri Lanka","2024-11-17",0,0,0,0,0,0,0,0
"Sri Lanka","2024-11-18",0,0,0,0,0,0,0,0
"Sri Lanka","2024-11-19",0,0,0,0,0,0,0,0
"Sri Lanka","2024-11-20",0,0,0,0,0,0,0,0
"Sri Lanka","2024-11-21",0,0,0,0,0,0,0,0
"Sri Lanka","2024-11-22",0,0,0,0,0,0,0,0
"Sri Lanka","2024-11-23",0,0,0,0,0,0,0,0
"Sri Lanka","2024-11-24",0,0,0,0,0,0,0,0
"Sri Lanka","2024-11-25",0,0,0,0,0,0,0,0
"Sri Lanka","2024-11-26",0,0,0,0,0,0,0,0
"Sri Lanka","2024-11-27",0,0,0,0,0,0,0,0
"Sri Lanka","2024-11-28",0,0,0,0,0,0,0,0
"Sri Lanka","2024-11-29",0,0,0,0,0,0,0,0
"Sri Lanka","2024-11-30",0,0,0,0,0,0,0,0
"Sri Lanka","2024-12-01",0,0,0,0,0,0,0,0
"Sri Lanka","2024-12-02",0,0,0,0,0,0,0,0
"Sri Lanka","2024-12-03",0,0,0,0,0,0,0,0
"Sri Lanka","2024-12-04",0,0,0,0,0,0,0,0
"Sri Lanka","2024-12-05",0,0,0,0,0,0,0,0
"Sri Lanka","2024-12-06",0,0,0,0,0,0,0,0
"Sri Lanka","2024-12-07",0,0,0,0,0,0,0,0
"Sri Lanka","2024-12-08",0,0,0,0,0,0,0,0
"Sri Lanka","2024-12-09",0,0,0,0,0,0,0,0
"Sweden","2024-01-01",0,0,0,0,0,0,0,0
"Sweden","2024-01-02",0,0,0,0,0,0,0,0
"Sweden","2024-01-03",0,0,0,0,0,0,0,0
"Sweden","2024-01-04",0,0,0,0,0,0,0,0
"Sweden","2024-01-05",0,0,0,0,0,0,0,0
"Sweden","2024-01-06",0,0,0,0,0,0,0,0
"Sweden","2024-01-07",0,0,0,0,0,0,0,0
"Sweden","2024-01-08",0,0,0,0,0,0,0,0
"Sweden","2024-01-09",0,0,0,0,0,0,0,0
"Sweden","2024-01-10",0,0,0,0,0,0,0,0
"Sweden","2024-01-11",0,0,0,0,0,0,0,0
"Sweden","2024-01-12",0,0,0,0,0,0,0,0
"Sweden","2024-01-13",0,0,0,0,0,0,0,0
"Sweden","2024-01-14",0,0,0,0,0,0,0,0
"Sweden","2024-01-15",0,0,0,0,0,0,0,0
"Sweden","2024-01-16",0,0,0,0,0,0,0,0
"Sweden","2024-01-17",0,0,0,0,0,0,0,0
"Sweden","2024-01-18",0,0,0,0,0,0,0,0
"Sweden","2024-01-19",0,0,0,0,0,0,0,0
"Sweden","2024-01-20",0,0,0,0,0,0,0,0
"Sweden","2024-01-21",0,0,0,0,0,0,0,0
"Sweden","2024-01-22",0,0,0,0,0,0,0,0
"Sweden","2024-01-23",0,0,0,0,0,0,0,0
"Sweden","2024-01-24",0,0,0,0,0,0,0,0
"Sweden","2024-01-25",0,0,0,0,0,0,0,0
"Sweden","2024-01-26",0,0,0,0,0,0,0,0
"Sweden","2024-01-27",0,0,0,0,0,0,0,0
"Sweden","2024-01-28",0,0,0,0,0,0,0,0
"Sweden","2024-01-29",0,0,0,0,0,0,0,0
"Sweden","2024-01-30",0,0,0,0,0,0,0,0
"Sweden","2024-01-31",0,3,3,0,3,3,0,0
"Sweden","2024-02-01",0,0,3,0,0,3,0,0
"Sweden","2024-02-02",0,0,3,0,0,3,0,0
"Sweden","2024-02-03",0,0,3,0,0,3,0,0
"Sweden","2024-02-04",0,0,3,0,0,3,0,0
"Sweden","2024-02-05",0,0,3,0,0,3,0,0
"Sweden","2024-02-06",0,0,3,0,0,3,0,0
"Sweden","2024-02-07",0,0,3,0,0,3,0,0
"Sweden","2024-02-08",0,0,3,0,1,4,0,0
"Sweden","2024-02-09",0,0,3,0,0,4,0,0
"Sweden","2024-02-10",0,0,3,0,0,4,0,0
"Sweden","2024-02-11",0,0,3,0,0,4,0,0
"Sweden","2024-02-12",0,0,3,0,0,4,0,0
"Sweden","2024-02-13",0,0,3,0,0,4,0,0
"Sweden","2024-02-14",0,0,3,0,0,4,0,0
"Sweden","2024-02-15",0,0,3,0,0,4,0,0
"Sweden","2024-02-16",0,0,3,0,0,4,0,0
"Sweden","2024-02-17",0,0,3,0,0,4,0,0
"Sweden","2024-02-18",0,0,3,0,0,4,0,0
"Sweden","2024-02-19",0,0,3,0,0,4,0,0
"Sweden","2024-02-20",0,0,3,0,0,4,0,0
"Sweden","2024-02-21",0,0,3,0,0,4,0,0
"Sweden","2024-02-22",0,0,3,0,1,5,0,0
"Sweden","2024-02-23",0,0,3,0,0,5,0,0
"Sweden","2024-02-24",0,0,3,0,0,5,0,0
"Sweden","2024-02-25",0,0,3,0,0,5,0,0
"Sweden","2024-02-26",0,0,3,0,0,5,0,0
"Sweden","2024-02-27",0,0,3,0,0,5,0,0
"Sweden","2024-02-28",0,0,3,0,0,5,0,0
"Sweden","2024-02-29",0,2,5,0,0,5,0,0
"Sweden","2024-03-01",0,0,5,0,0,5,0,0
"Sweden","2024-03-02",0,0,5,0,0,5,0,0
"Sweden","2024-03-03",0,0,5,0,1,6,0,0
"Sweden","2024-03-04",0,0,5,0,0,6,0,0
"Sweden","2024-03-05",0,0,5,0,0,6,0,0
"Sweden","2024-03-06",0,0,5,0,0,6,0,0
"Sweden","2024-03-07",0,0,5,0,1,7,0,0
"Sweden","2024-03-08",0,0,5,0,0,7,0,0
"Sweden","2024-03-09",0,0,5,0,0,7,0,0
"Sweden","2024-03-10",0,0,5,0,0,7,0,0
"Sweden","2024-03-11",0,0,5,0,1,8,0,0
"Sweden","2024-03-12",0,0,5,0,0,8,0,0
"Sweden","2024-03-13",0,0,5,0,0,8,0,0
"Sweden","2024-03-14",0,0,5,0,0,8,0,0
"Sweden","2024-03-15",0,0,5,0,0,8,0,0
"Sweden","2024-03-16",0,0,5,0,1,9,0,0
"Sweden","2024-03-17",0,0,5,0,0,9,0,0
"Sweden","2024-03-18",0,0,5,0,0,9,0,0
"Sweden","2024-03-19",0,0,5,0,0,9,0,0
"Sweden","2024-03-20",0,0,5,0,1,10,0,0
"Sweden","2024-03-21",0,0,5,0,0,10,0,0
"Sweden","2024-03-22",0,0,5,0,0,10,0,0
"Sweden","2024-03-23",0,0,5,0,0,10,0,0
"Sweden","2024-03-24",0,0,5,0,1,11,0,0
"Sweden","2024-03-25",0,0,5,0,0,11,0,0
"Sweden","2024-03-26",0,0,5,0,0,11,0,0
"Sweden","2024-03-27",0,0,5,0,0,11,0,0
"Sweden","2024-03-28",0,0,5,0,0,11,0,0
"Sweden","2024-03-29",0,0,5,0,1,12,0,0
"Sweden","2024-03-30",0,0,5,0,0,12,0,0
"Sweden","2024-03-31",0,0,5,0,0,12,0,0
"Sweden","2024-04-01",0,0,5,0,0,12,0,0
"Sweden","2024-04-02",0,0,5,0,1,13,0,0
"Sweden","2024-04-03",0,0,5,0,0,13,0,0
"Sweden","2024-04-04",0,0,5,0,0,13,0,0
"Sweden","2024-04-05",0,0,5,0,0,13,0,0
"Sweden","2024-04-06",0,0,5,0,0,13,0,0
"Sweden","2024-04-07",0,0,5,0,1,14,0,0
"Sweden","2024-04-08",0,0,5,0,0,14,0,0
"Sweden","2024-04-09",0,0,5,0,0,14,0,0
"Sweden","2024-04-10",0,0,5,0,0,14,0,0
"Sweden","2024-04-11",0,0,5,0,1,15,0,0
"Sweden","2024-04-12",0,0,5,0,0,15,0,0
"Sweden","2024-04-13",0,0,5,0,0,15,0,0
"Sweden","2024-04-14",0,0,5,0,0,15,0,0
"Sweden","2024-04-15",0,0,5,0,1,16,0,0
"Sweden","2024-04-16",0,0,5,0,0,16,0,0
"Sweden","2024-04-17",0,0,5,0,0,16,0,0
"Sweden","2024-04-18",0,0,5,0,0,16,0,0
"Sweden","2024-04-19",0,0,5,0,0,16,0,0
"Sweden","2024-04-20",0,0,5,0,1,17,0,0
"Sweden","2024-04-21",0,0,5,0,0,17,0,0
"Sweden","2024-04-22",0,0,5,0,0,17,0,0
"Sweden","2024-04-23",0,0,5,0,0,17,0,0
"Sweden","2024-04-24",0,0,5,0,1,18,0,0
"Sweden","2024-04-25",0,0,5,0,0,18,0,0
"Sweden","2024-04-26",0,0,5,0,0,18,0,0
"Sweden","2024-04-27",0,0,5,0,0,18,0,0
"Sweden","2024-04-28",0,0,5,0,1,19,0,0
"Sweden","2024-04-29",0,0,5,0,0,19,0,0
"Sweden","2024-04-30",0,14,19,0,0,19,0,0
"Sweden","2024-05-01",0,0,19,0,0,19,0,0
"Sweden","2024-05-02",0,0,19,0,1,20,0,0
"Sweden","2024-05-03",0,0,19,0,0,20,0,0
"Sweden","2024-05-04",0,0,19,0,0,20,0,0
"Sweden","2024-05-05",0,0,19,0,1,21,0,0
"Sweden","2024-05-06",0,0,19,0,0,21,0,0
"Sweden","2024-05-07",0,0,19,0,0,21,0,0
"Sweden","2024-05-08",0,0,19,0,1,22,0,0
"Sweden","2024-05-09",0,0,19,0,0,22,0,0
"Sweden","2024-05-10",0,0,19,0,1,23,0,0
"Sweden","2024-05-11",0,0,19,0,0,23,0,0
"Sweden","2024-05-12",0,0,19,0,0,23,0,0
"Sweden","2024-05-13",0,0,19,0,1,24,0,0
"Sweden","2024-05-14",0,0,19,0,0,24,0,0
"Sweden","2024-05-15",0,0,19,0,0,24,0,0
"Sweden","2024-05-16",0,0,19,0,1,25,0,0
"Sweden","2024-05-17",0,0,19,0,0,25,0,0
"Sweden","2024-05-18",0,0,19,0,0,25,0,0
"Sweden","2024-05-19",0,0,19,0,1,26,0,0
"Sweden","2024-05-20",0,0,19,0,0,26,0,0
"Sweden","2024-05-21",0,0,19,0,0,26,0,0
"Sweden","2024-05-22",0,0,19,0,1,27,0,0
"Sweden","2024-05-23",0,0,19,0,0,27,0,0
"Sweden","2024-05-24",0,0,19,0,1,28,0,0
"Sweden","2024-05-25",0,0,19,0,0,28,0,0
"Sweden","2024-05-26",0,0,19,0,0,28,0,0
"Sweden","2024-05-27",0,0,19,0,1,29,0,0
"Sweden","2024-05-28",0,0,19,0,0,29,0,0
"Sweden","2024-05-29",0,0,19,0,0,29,0,0
"Sweden","2024-05-30",0,0,19,0,1,30,0,0
"Sweden","2024-05-31",0,11,30,0,0,30,0,0
"Sweden","2024-06-01",0,0,30,0,0,30,0,0
"Sweden","2024-06-02",0,0,30,0,0,30,0,0
"Sweden","2024-06-03",0,0,30,0,0,30,0,0
"Sweden","2024-06-04",0,0,30,0,0,30,0,0
"Sweden","2024-06-05",0,0,30,0,0,30,0,0
"Sweden","2024-06-06",0,0,30,0,0,30,0,0
"Sweden","2024-06-07",0,0,30,0,0,30,0,0
"Sweden","2024-06-08",0,0,30,0,1,31,0,0
"Sweden","2024-06-09",0,0,30,0,0,31,0,0
"Sweden","2024-06-10",0,0,30,0,0,31,0,0
"Sweden","2024-06-11",0,0,30,0,0,31,0,0
"Sweden","2024-06-12",0,0,30,0,0,31,0,0
"Sweden","2024-06-13",0,0,30,0,0,31,0,0
"Sweden","2024-06-14",0,0,30,0,0,31,0,0
"Sweden","2024-06-15",0,0,30,0,0,31,0,0
"Sweden","2024-06-16",0,0,30,0,0,31,0,0
"Sweden","2024-06-17",0,0,30,0,0,31,0,0
"Sweden","2024-06-18",0,0,30,0,0,31,0,0
"Sweden","2024-06-19",0,0,30,0,0,31,0,0
"Sweden","2024-06-20",0,0,30,0,0,31,0,0
"Sweden","2024-06-21",0,0,30,0,0,31,0,0
"Sweden","2024-06-22",0,0,30,0,0,31,0,0
"Sweden","2024-06-23",0,0,30,0,1,32,0,0
"Sweden","2024-06-24",0,0,30,0,0,32,0,0
"Sweden","2024-06-25",0,0,30,0,0,32,0,0
"Sweden","2024-06-26",0,0,30,0,0,32,0,0
"Sweden","2024-06-27",0,0,30,0,0,32,0,0
"Sweden","2024-06-28",0,0,30,0,0,32,0,0
"Sweden","2024-06-29",0,0,30,0,0,32,0,0
"Sweden","2024-06-30",0,2,32,0,0,32,0,0
"Sweden","2024-07-01",0,0,32,0,0,32,0,0
"Sweden","2024-07-02",0,0,32,0,0,32,0,0
"Sweden","2024-07-03",0,0,32,0,0,32,0,0
"Sweden","2024-07-04",0,0,32,0,0,32,0,0
"Sweden","2024-07-05",0,0,32,0,0,32,0,0
"Sweden","2024-07-06",0,0,32,0,0,32,0,0
"Sweden","2024-07-07",0,0,32,0,0,32,0,0
"Sweden","2024-07-08",0,0,32,0,0,32,0,0
"Sweden","2024-07-09",0,0,32,0,0,32,0,0
"Sweden","2024-07-10",0,0,32,0,0,32,0,0
"Sweden","2024-07-11",0,0,32,0,0,32,0,0
"Sweden","2024-07-12",0,0,32,0,0,32,0,0
"Sweden","2024-07-13",0,0,32,0,0,32,0,0
"Sweden","2024-07-14",0,0,32,0,0,32,0,0
"Sweden","2024-07-15",0,0,32,0,0,32,0,0
"Sweden","2024-07-16",0,0,32,0,1,33,0,0
"Sweden","2024-07-17",0,0,32,0,0,33,0,0
"Sweden","2024-07-18",0,0,32,0,0,33,0,0
"Sweden","2024-07-19",0,0,32,0,0,33,0,0
"Sweden","2024-07-20",0,0,32,0,0,33,0,0
"Sweden","2024-07-21",0,0,32,0,0,33,0,0
"Sweden","2024-07-22",0,0,32,0,0,33,0,0
"Sweden","2024-07-23",0,0,32,0,0,33,0,0
"Sweden","2024-07-24",0,0,32,0,0,33,0,0
"Sweden","2024-07-25",0,0,32,0,0,33,0,0
"Sweden","2024-07-26",0,0,32,0,0,33,0,0
"Sweden","2024-07-27",0,0,32,0,0,33,0,0
"Sweden","2024-07-28",0,0,32,0,0,33,0,0
"Sweden","2024-07-29",0,0,32,0,0,33,0,0
"Sweden","2024-07-30",0,0,32,0,0,33,0,0
"Sweden","2024-07-31",0,1,33,0,0,33,0,0
"Sweden","2024-08-01",0,0,33,0,0,33,0,0
"Sweden","2024-08-02",0,0,33,0,0,33,0,0
"Sweden","2024-08-03",0,0,33,0,0,33,0,0
"Sweden","2024-08-04",0,0,33,0,0,33,0,0
"Sweden","2024-08-05",0,0,33,0,0,33,0,0
"Sweden","2024-08-06",0,0,33,0,0,33,0,0
"Sweden","2024-08-07",0,0,33,0,0,33,0,0
"Sweden","2024-08-08",0,0,33,0,1,34,0,0
"Sweden","2024-08-09",0,0,33,0,0,34,0,0
"Sweden","2024-08-10",0,0,33,0,0,34,0,0
"Sweden","2024-08-11",0,0,33,0,0,34,0,0
"Sweden","2024-08-12",0,0,33,0,0,34,0,0
"Sweden","2024-08-13",0,0,33,0,0,34,0,0
"Sweden","2024-08-14",0,0,33,0,0,34,0,0
"Sweden","2024-08-15",0,0,33,0,0,34,0,0
"Sweden","2024-08-16",0,0,33,0,0,34,0,0
"Sweden","2024-08-17",0,0,33,0,0,34,0,0
"Sweden","2024-08-18",0,0,33,0,0,34,0,0
"Sweden","2024-08-19",0,0,33,0,0,34,0,0
"Sweden","2024-08-20",0,0,33,0,0,34,0,0
"Sweden","2024-08-21",0,0,33,0,0,34,0,0
"Sweden","2024-08-22",0,0,33,0,0,34,0,0
"Sweden","2024-08-23",0,0,33,0,0,34,0,0
"Sweden","2024-08-24",0,0,33,0,1,35,0,0
"Sweden","2024-08-25",0,0,33,0,0,35,0,0
"Sweden","2024-08-26",0,0,33,0,0,35,0,0
"Sweden","2024-08-27",0,0,33,0,0,35,0,0
"Sweden","2024-08-28",0,0,33,0,0,35,0,0
"Sweden","2024-08-29",0,0,33,0,0,35,0,0
"Sweden","2024-08-30",0,0,33,0,0,35,0,0
"Sweden","2024-08-31",0,2,35,0,0,35,0,0
"Sweden","2024-09-01",0,0,35,0,0,35,0,0
"Sweden","2024-09-02",0,0,35,0,0,35,0,0
"Sweden","2024-09-03",0,0,35,0,0,35,0,0
"Sweden","2024-09-04",0,0,35,0,0,35,0,0
"Sweden","2024-09-05",0,0,35,0,0,35,0,0
"Sweden","2024-09-06",0,0,35,0,0,35,0,0
"Sweden","2024-09-07",0,0,35,0,0,35,0,0
"Sweden","2024-09-08",0,0,35,0,0,35,0,0
"Sweden","2024-09-09",0,0,35,0,0,35,0,0
"Sweden","2024-09-10",0,0,35,0,0,35,0,0
"Sweden","2024-09-11",0,0,35,0,1,36,0,0
"Sweden","2024-09-12",0,0,35,0,0,36,0,0
"Sweden","2024-09-13",0,0,35,0,0,36,0,0
"Sweden","2024-09-14",0,0,35,0,0,36,0,0
"Sweden","2024-09-15",0,0,35,0,0,36,0,0
"Sweden","2024-09-16",0,0,35,0,0,36,0,0
"Sweden","2024-09-17",0,0,35,0,0,36,0,0
"Sweden","2024-09-18",0,0,35,0,0,36,0,0
"Sweden","2024-09-19",0,0,35,0,0,36,0,0
"Sweden","2024-09-20",0,0,35,0,0,36,0,0
"Sweden","2024-09-21",0,0,35,0,0,36,0,0
"Sweden","2024-09-22",0,0,35,0,0,36,0,0
"Sweden","2024-09-23",0,0,35,0,0,36,0,0
"Sweden","2024-09-24",0,0,35,0,0,36,0,0
"Sweden","2024-09-25",0,0,35,0,0,36,0,0
"Sweden","2024-09-26",0,0,35,0,0,36,0,0
"Sweden","2024-09-27",0,0,35,0,0,36,0,0
"Sweden","2024-09-28",0,0,35,0,0,36,0,0
"Sweden","2024-09-29",0,0,35,0,0,36,0,0
"Sweden","2024-09-30",0,0,35,0,0,36,0,0
"Sweden","2024-10-01",0,0,35,0,1,37,0,0
"Sweden","2024-10-02",0,0,35,0,0,37,0,0
"Sweden","2024-10-03",0,0,35,0,0,37,0,0
"Sweden","2024-10-04",0,0,35,0,0,37,0,0
"Sweden","2024-10-05",0,0,35,0,0,37,0,0
"Sweden","2024-10-06",0,0,35,0,0,37,0,0
"Sweden","2024-10-07",0,0,35,0,0,37,0,0
"Sweden","2024-10-08",0,0,35,0,0,37,0,0
"Sweden","2024-10-09",0,0,35,0,0,37,0,0
"Sweden","2024-10-10",0,0,35,0,0,37,0,0
"Sweden","2024-10-11",0,0,35,0,0,37,0,0
"Sweden","2024-10-12",0,0,35,0,0,37,0,0
"Sweden","2024-10-13",0,0,35,0,0,37,0,0
"Sweden","2024-10-14",0,0,35,0,0,37,0,0
"Sweden","2024-10-15",0,0,35,0,0,37,0,0
"Sweden","2024-10-16",0,0,35,0,0,37,0,0
"Sweden","2024-10-17",0,0,35,0,0,37,0,0
"Sweden","2024-10-18",0,0,35,0,0,37,0,0
"Sweden","2024-10-19",0,0,35,0,0,37,0,0
"Sweden","2024-10-20",0,0,35,0,0,37,0,0
"Sweden","2024-10-21",0,0,35,0,1,38,0,0
"Sweden","2024-10-22",0,0,35,0,0,38,0,0
"Sweden","2024-10-23",0,0,35,0,0,38,0,0
"Sweden","2024-10-24",0,0,35,0,0,38,0,0
"Sweden","2024-10-25",0,0,35,0,0,38,0,0
"Sweden","2024-10-26",0,0,35,0,0,38,0,0
"Sweden","2024-10-27",0,0,35,0,0,38,0,0
"Sweden","2024-10-28",0,0,35,0,0,38,0,0
"Sweden","2024-10-29",0,0,35,0,0,38,0,0
"Sweden","2024-10-30",0,0,35,0,0,38,0,0
"Sweden","2024-10-31",0,3,38,0,0,38,0,0
"Sweden","2024-11-01",0,0,38,0,0,38,0,0
"Sweden","2024-11-02",0,0,38,0,0,38,0,0
"Sweden","2024-11-03",0,0,38,0,0,38,0,0
"Sweden","2024-11-04",0,0,38,0,0,38,0,0
"Sweden","2024-11-05",0,0,38,0,0,38,0,0
"Sweden","2024-11-06",0,0,38,0,0,38,0,0
"Sweden","2024-11-07",0,0,38,0,0,38,0,0
"Sweden","2024-11-08",0,0,38,0,0,38,0,0
"Sweden","2024-11-09",0,0,38,0,0,38,0,0
"Sweden","2024-11-10",0,0,38,0,0,38,0,0
"Sweden","2024-11-11",0,0,38,0,0,38,0,0
"Sweden","2024-11-12",0,0,38,0,0,38,0,0
"Sweden","2024-11-13",0,0,38,0,0,38,0,0
"Sweden","2024-11-14",0,0,38,0,0,38,0,0
"Sweden","2024-11-15",0,0,38,0,0,38,0,0
"Sweden","2024-11-16",0,0,38,0,0,38,0,0
"Sweden","2024-11-17",0,0,38,0,0,38,0,0
"Sweden","2024-11-18",0,0,38,0,0,38,0,0
"Sweden","2024-11-19",0,0,38,0,0,38,0,0
"Sweden","2024-11-20",0,0,38,0,0,38,0,0
"Sweden","2024-11-21",0,0,38,0,0,38,0,0
"Sweden","2024-11-22",0,0,38,0,0,38,0,0
"Sweden","2024-11-23",0,0,38,0,0,38,0,0
"Sweden","2024-11-24",0,0,38,0,0,38,0,0
"Sweden","2024-11-25",0,0,38,0,0,38,0,0
"Sweden","2024-11-26",0,0,38,0,0,38,0,0
"Sweden","2024-11-27",0,0,38,0,0,38,0,0
"Sweden","2024-11-28",0,0,38,0,0,38,0,0
"Sweden","2024-11-29",0,0,38,0,0,38,0,0
"Sweden","2024-11-30",0,0,38,0,0,38,0,0
"Sweden","2024-12-01",0,0,38,0,0,38,0,0
"Sweden","2024-12-02",0,0,38,0,0,38,0,0
"Sweden","2024-12-03",0,0,38,0,0,38,0,0
"Sweden","2024-12-04",0,0,38,0,0,38,0,0
"Sweden","2024-12-05",0,0,38,0,0,38,0,0
"Sweden","2024-12-06",0,0,38,0,0,38,0,0
"Sweden","2024-12-07",0,0,38,0,0,38,0,0
"Sweden","2024-12-08",0,0,38,0,0,38,0,0
"Sweden","2024-12-09",0,0,38,0,0,38,0,0
"Switzerland","2024-01-01",0,0,0,0,0,0,0,0
"Switzerland","2024-01-02",0,0,0,0,0,0,0,0
"Switzerland","2024-01-03",0,0,0,0,0,0,0,0
"Switzerland","2024-01-04",0,0,0,0,0,0,0,0
"Switzerland","2024-01-05",0,0,0,0,0,0,0,0
"Switzerland","2024-01-06",0,0,0,0,0,0,0,0
"Switzerland","2024-01-07",0,0,0,0,0,0,0,0
"Switzerland","2024-01-08",0,0,0,0,0,0,0,0
"Switzerland","2024-01-09",0,0,0,0,0,0,0,0
"Switzerland","2024-01-10",0,0,0,0,0,0,0,0
"Switzerland","2024-01-11",0,0,0,0,0,0,0,0
"Switzerland","2024-01-12",0,0,0,0,0,0,0,0
"Switzerland","2024-01-13",0,0,0,0,0,0,0,0
"Switzerland","2024-01-14",0,0,0,0,0,0,0,0
"Switzerland","2024-01-15",0,0,0,0,0,0,0,0
"Switzerland","2024-01-16",0,0,0,0,0,0,0,0
"Switzerland","2024-01-17",0,0,0,0,0,0,0,0
"Switzerland","2024-01-18",0,0,0,0,0,0,0,0
"Switzerland","2024-01-19",0,0,0,0,0,0,0,0
"Switzerland","2024-01-20",0,0,0,0,0,0,0,0
"Switzerland","2024-01-21",0,0,0,0,0,0,0,0
"Switzerland","2024-01-22",0,0,0,0,0,0,0,0
"Switzerland","2024-01-23",0,0,0,0,0,0,0,0
"Switzerland","2024-01-24",0,0,0,0,0,0,0,0
"Switzerland","2024-01-25",0,0,0,0,0,0,0,0
"Switzerland","2024-01-26",0,0,0,0,0,0,0,0
"Switzerland","2024-01-27",0,0,0,0,0,0,0,0
"Switzerland","2024-01-28",0,0,0,0,0,0,0,0
"Switzerland","2024-01-29",0,0,0,0,0,0,0,0
"Switzerland","2024-01-30",0,0,0,0,0,0,0,0
"Switzerland","2024-01-31",0,9,9,0,9,9,0,0
"Switzerland","2024-02-01",0,0,9,0,0,9,0,0
"Switzerland","2024-02-02",0,0,9,0,0,9,0,0
"Switzerland","2024-02-03",0,0,9,0,1,10,0,0
"Switzerland","2024-02-04",0,0,9,0,0,10,0,0
"Switzerland","2024-02-05",0,0,9,0,0,10,0,0
"Switzerland","2024-02-06",0,0,9,0,0,10,0,0
"Switzerland","2024-02-07",0,0,9,0,1,11,0,0
"Switzerland","2024-02-08",0,0,9,0,0,11,0,0
"Switzerland","2024-02-09",0,0,9,0,0,11,0,0
"Switzerland","2024-02-10",0,0,9,0,0,11,0,0
"Switzerland","2024-02-11",0,0,9,0,1,12,0,0
"Switzerland","2024-02-12",0,0,9,0,0,12,0,0
"Switzerland","2024-02-13",0,0,9,0,0,12,0,0
"Switzerland","2024-02-14",0,0,9,0,0,12,0,0
"Switzerland","2024-02-15",0,0,9,0,1,13,0,0
"Switzerland","2024-02-16",0,0,9,0,0,13,0,0
"Switzerland","2024-02-17",0,0,9,0,0,13,0,0
"Switzerland","2024-02-18",0,0,9,0,0,13,0,0
"Switzerland","2024-02-19",0,0,9,0,1,14,0,0
"Switzerland","2024-02-20",0,0,9,0,0,14,0,0
"Switzerland","2024-02-21",0,0,9,0,0,14,0,0
"Switzerland","2024-02-22",0,0,9,0,0,14,0,0
"Switzerland","2024-02-23",0,0,9,0,1,15,0,0
"Switzerland","2024-02-24",0,0,9,0,0,15,0,0
"Switzerland","2024-02-25",0,0,9,0,0,15,0,0
"Switzerland","2024-02-26",0,0,9,0,0,15,0,0
"Switzerland","2024-02-27",0,0,9,0,1,16,0,0
"Switzerland","2024-02-28",0,0,9,0,0,16,0,0
"Switzerland","2024-02-29",0,7,16,0,0,16,0,0
"Switzerland","2024-03-01",0,0,16,0,0,16,0,0
"Switzerland","2024-03-02",0,0,16,0,0,16,0,0
"Switzerland","2024-03-03",0,0,16,0,0,16,0,0
"Switzerland","2024-03-04",0,0,16,0,0,16,0,0
"Switzerland","2024-03-05",0,0,16,0,0,16,0,0
"Switzerland","2024-03-06",0,0,16,0,0,16,0,0
"Switzerland","2024-03-07",0,0,16,0,0,16,0,0
"Switzerland","2024-03-08",0,0,16,0,0,16,0,0
"Switzerland","2024-03-09",0,0,16,0,0,16,0,0
"Switzerland","2024-03-10",0,0,16,0,0,16,0,0
"Switzerland","2024-03-11",0,0,16,0,1,17,0,0
"Switzerland","2024-03-12",0,0,16,0,0,17,0,0
"Switzerland","2024-03-13",0,0,16,0,0,17,0,0
"Switzerland","2024-03-14",0,0,16,0,0,17,0,0
"Switzerland","2024-03-15",0,0,16,0,0,17,0,0
"Switzerland","2024-03-16",0,0,16,0,0,17,0,0
"Switzerland","2024-03-17",0,0,16,0,0,17,0,0
"Switzerland","2024-03-18",0,0,16,0,0,17,0,0
"Switzerland","2024-03-19",0,0,16,0,0,17,0,0
"Switzerland","2024-03-20",0,0,16,0,0,17,0,0
"Switzerland","2024-03-21",0,0,16,0,0,17,0,0
"Switzerland","2024-03-22",0,0,16,0,0,17,0,0
"Switzerland","2024-03-23",0,0,16,0,0,17,0,0
"Switzerland","2024-03-24",0,0,16,0,0,17,0,0
"Switzerland","2024-03-25",0,0,16,0,0,17,0,0
"Switzerland","2024-03-26",0,0,16,0,0,17,0,0
"Switzerland","2024-03-27",0,0,16,0,0,17,0,0
"Switzerland","2024-03-28",0,0,16,0,0,17,0,0
"Switzerland","2024-03-29",0,0,16,0,0,17,0,0
"Switzerland","2024-03-30",0,0,16,0,0,17,0,0
"Switzerland","2024-03-31",0,0,16,0,1,18,0,0
"Switzerland","2024-04-01",0,0,16,0,0,18,0,0
"Switzerland","2024-04-02",0,0,16,0,0,18,0,0
"Switzerland","2024-04-03",0,0,16,0,0,18,0,0
"Switzerland","2024-04-04",0,0,16,0,0,18,0,0
"Switzerland","2024-04-05",0,0,16,0,0,18,0,0
"Switzerland","2024-04-06",0,0,16,0,0,18,0,0
"Switzerland","2024-04-07",0,0,16,0,0,18,0,0
"Switzerland","2024-04-08",0,0,16,0,0,18,0,0
"Switzerland","2024-04-09",0,0,16,0,0,18,0,0
"Switzerland","2024-04-10",0,0,16,0,0,18,0,0
"Switzerland","2024-04-11",0,0,16,0,0,18,0,0
"Switzerland","2024-04-12",0,0,16,0,0,18,0,0
"Switzerland","2024-04-13",0,0,16,0,0,18,0,0
"Switzerland","2024-04-14",0,0,16,0,0,18,0,0
"Switzerland","2024-04-15",0,0,16,0,0,18,0,0
"Switzerland","2024-04-16",0,0,16,0,0,18,0,0
"Switzerland","2024-04-17",0,0,16,0,0,18,0,0
"Switzerland","2024-04-18",0,0,16,0,0,18,0,0
"Switzerland","2024-04-19",0,0,16,0,0,18,0,0
"Switzerland","2024-04-20",0,0,16,0,0,18,0,0
"Switzerland","2024-04-21",0,0,16,0,1,19,0,0
"Switzerland","2024-04-22",0,0,16,0,0,19,0,0
"Switzerland","2024-04-23",0,0,16,0,0,19,0,0
"Switzerland","2024-04-24",0,0,16,0,0,19,0,0
"Switzerland","2024-04-25",0,0,16,0,0,19,0,0
"Switzerland","2024-04-26",0,0,16,0,0,19,0,0
"Switzerland","2024-04-27",0,0,16,0,0,19,0,0
"Switzerland","2024-04-28",0,0,16,0,0,19,0,0
"Switzerland","2024-04-29",0,0,16,0,0,19,0,0
"Switzerland","2024-04-30",0,0,16,0,0,19,0,0
"Switzerland","2024-05-01",0,0,16,0,0,19,0,0
"Switzerland","2024-05-02",0,0,16,0,0,19,0,0
"Switzerland","2024-05-03",0,0,16,0,0,19,0,0
"Switzerland","2024-05-04",0,0,16,0,0,19,0,0
"Switzerland","2024-05-05",0,0,16,0,0,19,0,0
"Switzerland","2024-05-06",0,0,16,0,0,19,0,0
"Switzerland","2024-05-07",0,0,16,0,0,19,0,0
"Switzerland","2024-05-08",0,0,16,0,0,19,0,0
"Switzerland","2024-05-09",0,0,16,0,0,19,0,0
"Switzerland","2024-05-10",0,0,16,0,0,19,0,0
"Switzerland","2024-05-11",0,0,16,0,1,20,0,0
"Switzerland","2024-05-12",0,0,16,0,0,20,0,0
"Switzerland","2024-05-13",0,0,16,0,0,20,0,0
"Switzerland","2024-05-14",0,0,16,0,0,20,0,0
"Switzerland","2024-05-15",0,0,16,0,0,20,0,0
"Switzerland","2024-05-16",0,0,16,0,0,20,0,0
"Switzerland","2024-05-17",0,0,16,0,0,20,0,0
"Switzerland","2024-05-18",0,0,16,0,0,20,0,0
"Switzerland","2024-05-19",0,0,16,0,0,20,0,0
"Switzerland","2024-05-20",0,0,16,0,0,20,0,0
"Switzerland","2024-05-21",0,0,16,0,0,20,0,0
"Switzerland","2024-05-22",0,0,16,0,0,20,0,0
"Switzerland","2024-05-23",0,0,16,0,0,20,0,0
"Switzerland","2024-05-24",0,0,16,0,0,20,0,0
"Switzerland","2024-05-25",0,0,16,0,0,20,0,0
"Switzerland","2024-05-26",0,0,16,0,0,20,0,0
"Switzerland","2024-05-27",0,0,16,0,0,20,0,0
"Switzerland","2024-05-28",0,0,16,0,0,20,0,0
"Switzerland","2024-05-29",0,0,16,0,0,20,0,0
"Switzerland","2024-05-30",0,0,16,0,0,20,0,0
"Switzerland","2024-05-31",0,0,16,0,0,20,0,0
"Switzerland","2024-06-01",0,0,16,0,1,21,0,0
"Switzerland","2024-06-02",0,0,16,0,0,21,0,0
"Switzerland","2024-06-03",0,0,16,0,0,21,0,0
"Switzerland","2024-06-04",0,0,16,0,0,21,0,0
"Switzerland","2024-06-05",0,0,16,0,0,21,0,0
"Switzerland","2024-06-06",0,0,16,0,0,21,0,0
"Switzerland","2024-06-07",0,0,16,0,0,21,0,0
"Switzerland","2024-06-08",0,0,16,0,0,21,0,0
"Switzerland","2024-06-09",0,0,16,0,0,21,0,0
"Switzerland","2024-06-10",0,0,16,0,0,21,0,0
"Switzerland","2024-06-11",0,0,16,0,0,21,0,0
"Switzerland","2024-06-12",0,0,16,0,0,21,0,0
"Switzerland","2024-06-13",0,0,16,0,0,21,0,0
"Switzerland","2024-06-14",0,0,16,0,0,21,0,0
"Switzerland","2024-06-15",0,0,16,0,0,21,0,0
"Switzerland","2024-06-16",0,0,16,0,0,21,0,0
"Switzerland","2024-06-17",0,0,16,0,0,21,0,0
"Switzerland","2024-06-18",0,0,16,0,0,21,0,0
"Switzerland","2024-06-19",0,0,16,0,0,21,0,0
"Switzerland","2024-06-20",0,0,16,0,0,21,0,0
"Switzerland","2024-06-21",0,0,16,0,1,22,0,0
"Switzerland","2024-06-22",0,0,16,0,0,22,0,0
"Switzerland","2024-06-23",0,0,16,0,0,22,0,0
"Switzerland","2024-06-24",0,0,16,0,0,22,0,0
"Switzerland","2024-06-25",0,0,16,0,0,22,0,0
"Switzerland","2024-06-26",0,0,16,0,0,22,0,0
"Switzerland","2024-06-27",0,0,16,0,0,22,0,0
"Switzerland","2024-06-28",0,0,16,0,0,22,0,0
"Switzerland","2024-06-29",0,0,16,0,0,22,0,0
"Switzerland","2024-06-30",0,0,16,0,0,22,0,0
"Switzerland","2024-07-01",0,0,16,0,0,22,0,0
"Switzerland","2024-07-02",0,0,16,0,0,22,0,0
"Switzerland","2024-07-03",0,0,16,0,0,22,0,0
"Switzerland","2024-07-04",0,0,16,0,0,22,0,0
"Switzerland","2024-07-05",0,0,16,0,0,22,0,0
"Switzerland","2024-07-06",0,0,16,0,0,22,0,0
"Switzerland","2024-07-07",0,0,16,0,0,22,0,0
"Switzerland","2024-07-08",0,0,16,0,0,22,0,0
"Switzerland","2024-07-09",0,0,16,0,0,22,0,0
"Switzerland","2024-07-10",0,0,16,0,0,22,0,0
"Switzerland","2024-07-11",0,0,16,0,1,23,0,0
"Switzerland","2024-07-12",0,0,16,0,0,23,0,0
"Switzerland","2024-07-13",0,0,16,0,0,23,0,0
"Switzerland","2024-07-14",0,0,16,0,0,23,0,0
"Switzerland","2024-07-15",0,0,16,0,0,23,0,0
"Switzerland","2024-07-16",0,0,16,0,0,23,0,0
"Switzerland","2024-07-17",0,0,16,0,0,23,0,0
"Switzerland","2024-07-18",0,0,16,0,0,23,0,0
"Switzerland","2024-07-19",0,0,16,0,0,23,0,0
"Switzerland","2024-07-20",0,0,16,0,0,23,0,0
"Switzerland","2024-07-21",0,0,16,0,0,23,0,0
"Switzerland","2024-07-22",0,0,16,0,0,23,0,0
"Switzerland","2024-07-23",0,0,16,0,0,23,0,0
"Switzerland","2024-07-24",0,0,16,0,0,23,0,0
"Switzerland","2024-07-25",0,0,16,0,0,23,0,0
"Switzerland","2024-07-26",0,0,16,0,0,23,0,0
"Switzerland","2024-07-27",0,0,16,0,0,23,0,0
"Switzerland","2024-07-28",0,0,16,0,0,23,0,0
"Switzerland","2024-07-29",0,0,16,0,0,23,0,0
"Switzerland","2024-07-30",0,0,16,0,0,23,0,0
"Switzerland","2024-07-31",0,0,16,0,0,23,0,0
"Switzerland","2024-08-01",0,0,16,0,1,24,0,0
"Switzerland","2024-08-02",0,0,16,0,0,24,0,0
"Switzerland","2024-08-03",0,0,16,0,0,24,0,0
"Switzerland","2024-08-04",0,0,16,0,0,24,0,0
"Switzerland","2024-08-05",0,0,16,0,0,24,0,0
"Switzerland","2024-08-06",0,0,16,0,0,24,0,0
"Switzerland","2024-08-07",0,0,16,0,0,24,0,0
"Switzerland","2024-08-08",0,0,16,0,0,24,0,0
"Switzerland","2024-08-09",0,0,16,0,0,24,0,0
"Switzerland","2024-08-10",0,0,16,0,0,24,0,0
"Switzerland","2024-08-11",0,0,16,0,0,24,0,0
"Switzerland","2024-08-12",0,0,16,0,0,24,0,0
"Switzerland","2024-08-13",0,0,16,0,0,24,0,0
"Switzerland","2024-08-14",0,0,16,0,0,24,0,0
"Switzerland","2024-08-15",0,0,16,0,0,24,0,0
"Switzerland","2024-08-16",0,0,16,0,0,24,0,0
"Switzerland","2024-08-17",0,0,16,0,0,24,0,0
"Switzerland","2024-08-18",0,0,16,0,0,24,0,0
"Switzerland","2024-08-19",0,0,16,0,0,24,0,0
"Switzerland","2024-08-20",0,0,16,0,0,24,0,0
"Switzerland","2024-08-21",0,0,16,0,1,25,0,0
"Switzerland","2024-08-22",0,0,16,0,0,25,0,0
"Switzerland","2024-08-23",0,0,16,0,0,25,0,0
"Switzerland","2024-08-24",0,0,16,0,0,25,0,0
"Switzerland","2024-08-25",0,0,16,0,0,25,0,0
"Switzerland","2024-08-26",0,0,16,0,0,25,0,0
"Switzerland","2024-08-27",0,0,16,0,0,25,0,0
"Switzerland","2024-08-28",0,0,16,0,0,25,0,0
"Switzerland","2024-08-29",0,0,16,0,0,25,0,0
"Switzerland","2024-08-30",0,0,16,0,0,25,0,0
"Switzerland","2024-08-31",0,9,25,0,0,25,0,0
"Switzerland","2024-09-01",0,0,25,0,0,25,0,0
"Switzerland","2024-09-02",0,0,25,0,0,25,0,0
"Switzerland","2024-09-03",0,0,25,0,0,25,0,0
"Switzerland","2024-09-04",0,0,25,0,0,25,0,0
"Switzerland","2024-09-05",0,0,25,0,0,25,0,0
"Switzerland","2024-09-06",0,0,25,0,0,25,0,0
"Switzerland","2024-09-07",0,0,25,0,0,25,0,0
"Switzerland","2024-09-08",0,0,25,0,0,25,0,0
"Switzerland","2024-09-09",0,0,25,0,0,25,0,0
"Switzerland","2024-09-10",0,0,25,0,0,25,0,0
"Switzerland","2024-09-11",0,0,25,0,0,25,0,0
"Switzerland","2024-09-12",0,0,25,0,0,25,0,0
"Switzerland","2024-09-13",0,0,25,0,0,25,0,0
"Switzerland","2024-09-14",0,0,25,0,0,25,0,0
"Switzerland","2024-09-15",0,0,25,0,0,25,0,0
"Switzerland","2024-09-16",0,0,25,0,0,25,0,0
"Switzerland","2024-09-17",0,0,25,0,0,25,0,0
"Switzerland","2024-09-18",0,0,25,0,0,25,0,0
"Switzerland","2024-09-19",0,0,25,0,0,25,0,0
"Switzerland","2024-09-20",0,0,25,0,0,25,0,0
"Switzerland","2024-09-21",0,0,25,0,0,25,0,0
"Switzerland","2024-09-22",0,0,25,0,0,25,0,0
"Switzerland","2024-09-23",0,0,25,0,0,25,0,0
"Switzerland","2024-09-24",0,0,25,0,0,25,0,0
"Switzerland","2024-09-25",0,0,25,0,0,25,0,0
"Switzerland","2024-09-26",0,0,25,0,0,25,0,0
"Switzerland","2024-09-27",0,0,25,0,0,25,0,0
"Switzerland","2024-09-28",0,0,25,0,0,25,0,0
"Switzerland","2024-09-29",0,0,25,0,0,25,0,0
"Switzerland","2024-09-30",0,0,25,0,0,25,0,0
"Switzerland","2024-10-01",0,0,25,0,0,25,0,0
"Switzerland","2024-10-02",0,0,25,0,0,25,0,0
"Switzerland","2024-10-03",0,0,25,0,0,25,0,0
"Switzerland","2024-10-04",0,0,25,0,0,25,0,0
"Switzerland","2024-10-05",0,0,25,0,0,25,0,0
"Switzerland","2024-10-06",0,0,25,0,0,25,0,0
"Switzerland","2024-10-07",0,0,25,0,0,25,0,0
"Switzerland","2024-10-08",0,0,25,0,0,25,0,0
"Switzerland","2024-10-09",0,0,25,0,0,25,0,0
"Switzerland","2024-10-10",0,0,25,0,0,25,0,0
"Switzerland","2024-10-11",0,0,25,0,0,25,0,0
"Switzerland","2024-10-12",0,0,25,0,0,25,0,0
"Switzerland","2024-10-13",0,0,25,0,0,25,0,0
"Switzerland","2024-10-14",0,0,25,0,0,25,0,0
"Switzerland","2024-10-15",0,0,25,0,0,25,0,0
"Switzerland","2024-10-16",0,0,25,0,0,25,0,0
"Switzerland","2024-10-17",0,0,25,0,0,25,0,0
"Switzerland","2024-10-18",0,0,25,0,0,25,0,0
"Switzerland","2024-10-19",0,0,25,0,0,25,0,0
"Switzerland","2024-10-20",0,0,25,0,0,25,0,0
"Switzerland","2024-10-21",0,0,25,0,0,25,0,0
"Switzerland","2024-10-22",0,0,25,0,0,25,0,0
"Switzerland","2024-10-23",0,0,25,0,0,25,0,0
"Switzerland","2024-10-24",0,0,25,0,0,25,0,0
"Switzerland","2024-10-25",0,0,25,0,0,25,0,0
"Switzerland","2024-10-26",0,0,25,0,0,25,0,0
"Switzerland","2024-10-27",0,0,25,0,0,25,0,0
"Switzerland","2024-10-28",0,0,25,0,0,25,0,0
"Switzerland","2024-10-29",0,0,25,0,0,25,0,0
"Switzerland","2024-10-30",0,0,25,0,0,25,0,0
"Switzerland","2024-10-31",0,0,25,0,0,25,0,0
"Switzerland","2024-11-01",0,0,25,0,0,25,0,0
"Switzerland","2024-11-02",0,0,25,0,0,25,0,0
"Switzerland","2024-11-03",0,0,25,0,0,25,0,0
"Switzerland","2024-11-04",0,0,25,0,0,25,0,0
"Switzerland","2024-11-05",0,0,25,0,0,25,0,0
"Switzerland","2024-11-06",0,0,25,0,0,25,0,0
"Switzerland","2024-11-07",0,0,25,0,0,25,0,0
"Switzerland","2024-11-08",0,0,25,0,0,25,0,0
"Switzerland","2024-11-09",0,0,25,0,0,25,0,0
"Switzerland","2024-11-10",0,0,25,0,0,25,0,0
"Switzerland","2024-11-11",0,0,25,0,0,25,0,0
"Switzerland","2024-11-12",0,0,25,0,0,25,0,0
"Switzerland","2024-11-13",0,0,25,0,0,25,0,0
"Switzerland","2024-11-14",0,0,25,0,0,25,0,0
"Switzerland","2024-11-15",0,0,25,0,0,25,0,0
"Switzerland","2024-11-16",0,0,25,0,0,25,0,0
"Switzerland","2024-11-17",0,0,25,0,0,25,0,0
"Switzerland","2024-11-18",0,0,25,0,0,25,0,0
"Switzerland","2024-11-19",0,0,25,0,0,25,0,0
"Switzerland","2024-11-20",0,0,25,0,0,25,0,0
"Switzerland","2024-11-21",0,0,25,0,0,25,0,0
"Switzerland","2024-11-22",0,0,25,0,0,25,0,0
"Switzerland","2024-11-23",0,0,25,0,0,25,0,0
"Switzerland","2024-11-24",0,0,25,0,0,25,0,0
"Switzerland","2024-11-25",0,0,25,0,0,25,0,0
"Switzerland","2024-11-26",0,0,25,0,0,25,0,0
"Switzerland","2024-11-27",0,0,25,0,0,25,0,0
"Switzerland","2024-11-28",0,0,25,0,0,25,0,0
"Switzerland","2024-11-29",0,0,25,0,0,25,0,0
"Switzerland","2024-11-30",0,0,25,0,0,25,0,0
"Switzerland","2024-12-01",0,0,25,0,0,25,0,0
"Switzerland","2024-12-02",0,0,25,0,0,25,0,0
"Switzerland","2024-12-03",0,0,25,0,0,25,0,0
"Switzerland","2024-12-04",0,0,25,0,0,25,0,0
"Switzerland","2024-12-05",0,0,25,0,0,25,0,0
"Switzerland","2024-12-06",0,0,25,0,0,25,0,0
"Switzerland","2024-12-07",0,0,25,0,0,25,0,0
"Switzerland","2024-12-08",0,0,25,0,0,25,0,0
"Switzerland","2024-12-09",0,0,25,0,0,25,0,0
"Thailand","2024-01-01",0,0,0,0,0,0,0,0
"Thailand","2024-01-02",0,0,0,0,0,0,0,0
"Thailand","2024-01-03",0,0,0,0,0,0,0,0
"Thailand","2024-01-04",0,0,0,0,0,0,0,0
"Thailand","2024-01-05",0,0,0,0,0,0,0,0
"Thailand","2024-01-06",0,0,0,0,0,0,0,0
"Thailand","2024-01-07",0,0,0,0,0,0,0,0
"Thailand","2024-01-08",0,0,0,0,0,0,0,0
"Thailand","2024-01-09",0,0,0,0,0,0,0,0
"Thailand","2024-01-10",0,0,0,0,0,0,0,0
"Thailand","2024-01-11",0,0,0,0,0,0,0,0
"Thailand","2024-01-12",0,0,0,0,0,0,0,0
"Thailand","2024-01-13",0,0,0,0,0,0,0,0
"Thailand","2024-01-14",0,0,0,0,0,0,0,0
"Thailand","2024-01-15",0,0,0,0,0,0,0,0
"Thailand","2024-01-16",0,0,0,0,0,0,0,0
"Thailand","2024-01-17",0,0,0,0,0,0,0,0
"Thailand","2024-01-18",0,0,0,0,0,0,0,0
"Thailand","2024-01-19",0,0,0,0,0,0,0,0
"Thailand","2024-01-20",0,0,0,0,0,0,0,0
"Thailand","2024-01-21",0,0,0,0,0,0,0,0
"Thailand","2024-01-22",0,0,0,0,0,0,0,0
"Thailand","2024-01-23",0,0,0,0,0,0,0,0
"Thailand","2024-01-24",0,0,0,0,0,0,0,0
"Thailand","2024-01-25",0,0,0,0,0,0,0,0
"Thailand","2024-01-26",0,0,0,0,0,0,0,0
"Thailand","2024-01-27",0,0,0,0,0,0,0,0
"Thailand","2024-01-28",0,0,0,0,0,0,0,0
"Thailand","2024-01-29",0,0,0,0,0,0,0,0
"Thailand","2024-01-30",0,0,0,0,0,0,0,0
"Thailand","2024-01-31",0,36,36,0,36,36,0,0
"Thailand","2024-02-01",0,0,36,0,1,37,0,0
"Thailand","2024-02-02",0,0,36,0,1,38,0,0
"Thailand","2024-02-03",0,0,36,0,0,38,0,0
"Thailand","2024-02-04",0,0,36,0,1,39,0,0
"Thailand","2024-02-05",0,0,36,0,1,40,0,0
"Thailand","2024-02-06",0,0,36,0,1,41,0,0
"Thailand","2024-02-07",0,0,36,0,0,41,0,0
"Thailand","2024-02-08",0,0,36,0,1,42,0,0
"Thailand","2024-02-09",0,0,36,0,1,43,0,0
"Thailand","2024-02-10",0,0,36,0,1,44,0,0
"Thailand","2024-02-11",0,0,36,0,0,44,0,0
"Thailand","2024-02-12",0,0,36,0,1,45,0,0
"Thailand","2024-02-13",0,0,36,0,1,46,0,0
"Thailand","2024-02-14",0,0,36,0,1,47,0,0
"Thailand","2024-02-15",0,0,36,0,0,47,0,0
"Thailand","2024-02-16",0,0,36,0,1,48,0,0
"Thailand","2024-02-17",0,0,36,0,1,49,0,0
"Thailand","2024-02-18",0,0,36,0,1,50,0,0
"Thailand","2024-02-19",0,0,36,0,0,50,0,0
"Thailand","2024-02-20",0,0,36,0,1,51,0,0
"Thailand","2024-02-21",0,0,36,0,1,52,0,0
"Thailand","2024-02-22",0,0,36,0,1,53,0,0
"Thailand","2024-02-23",0,0,36,0,0,53,0,0
"Thailand","2024-02-24",0,0,36,0,1,54,0,0
"Thailand","2024-02-25",0,0,36,0,1,55,0,0
"Thailand","2024-02-26",0,0,36,0,1,56,0,0
"Thailand","2024-02-27",0,0,36,0,0,56,0,0
"Thailand","2024-02-28",0,0,36,0,1,57,0,0
"Thailand","2024-02-29",0,22,58,0,1,58,0,0
"Thailand","2024-03-01",0,0,58,0,0,58,0,0
"Thailand","2024-03-02",0,0,58,0,1,59,0,0
"Thailand","2024-03-03",0,0,58,0,0,59,0,0
"Thailand","2024-03-04",0,0,58,0,1,60,0,0
"Thailand","2024-03-05",0,0,58,0,0,60,0,0
"Thailand","2024-03-06",0,0,58,0,0,60,0,0
"Thailand","2024-03-07",0,0,58,0,1,61,0,0
"Thailand","2024-03-08",0,0,58,0,0,61,0,0
"Thailand","2024-03-09",0,0,58,0,0,61,0,0
"Thailand","2024-03-10",0,0,58,0,1,62,0,0
"Thailand","2024-03-11",0,0,58,0,0,62,0,0
"Thailand","2024-03-12",0,0,58,0,1,63,0,0
"Thailand","2024-03-13",0,0,58,0,0,63,0,0
"Thailand","2024-03-14",0,0,58,0,0,63,0,0
"Thailand","2024-03-15",0,0,58,0,1,64,0,0
"Thailand","2024-03-16",0,0,58,0,0,64,0,0
"Thailand","2024-03-17",0,0,58,0,1,65,0,0
"Thailand","2024-03-18",0,0,58,0,0,65,0,0
"Thailand","2024-03-19",0,0,58,0,0,65,0,0
"Thailand","2024-03-20",0,0,58,0,1,66,0,0
"Thailand","2024-03-21",0,0,58,0,0,66,0,0
"Thailand","2024-03-22",0,0,58,0,1,67,0,0
"Thailand","2024-03-23",0,0,58,0,0,67,0,0
"Thailand","2024-03-24",0,0,58,0,0,67,0,0
"Thailand","2024-03-25",0,0,58,0,1,68,0,0
"Thailand","2024-03-26",0,0,58,0,0,68,0,0
"Thailand","2024-03-27",0,0,58,0,0,68,0,0
"Thailand","2024-03-28",0,0,58,0,1,69,0,0
"Thailand","2024-03-29",0,0,58,0,0,69,0,0
"Thailand","2024-03-30",0,0,58,0,1,70,0,0
"Thailand","2024-03-31",0,12,70,0,0,70,0,0
"Thailand","2024-04-01",0,6,76,0,6,76,0,0
"Thailand","2024-04-02",0,0,76,0,0,76,0,0
"Thailand","2024-04-03",0,0,76,0,1,77,0,0
"Thailand","2024-04-04",0,0,76,0,0,77,0,0
"Thailand","2024-04-05",0,0,76,0,1,78,0,0
"Thailand","2024-04-06",0,0,76,0,0,78,0,0
"Thailand","2024-04-07",0,0,76,0,1,79,0,0
"Thailand","2024-04-08",0,0,76,0,0,79,0,0
"Thailand","2024-04-09",0,0,76,0,1,80,0,0
"Thailand","2024-04-10",0,0,76,0,0,80,0,0
"Thailand","2024-04-11",0,0,76,0,0,80,0,0
"Thailand","2024-04-12",0,0,76,0,1,81,0,0
"Thailand","2024-04-13",0,0,76,0,0,81,0,0
"Thailand","2024-04-14",0,0,76,0,1,82,0,0
"Thailand","2024-04-15",0,0,76,0,0,82,0,0
"Thailand","2024-04-16",0,0,76,0,1,83,0,0
"Thailand","2024-04-17",0,0,76,0,0,83,0,0
"Thailand","2024-04-18",0,0,76,0,1,84,0,0
"Thailand","2024-04-19",0,0,76,0,0,84,0,0
"Thailand","2024-04-20",0,0,76,0,1,85,0,0
"Thailand","2024-04-21",0,0,76,0,0,85,0,0
"Thailand","2024-04-22",0,0,76,0,0,85,0,0
"Thailand","2024-04-23",0,0,76,0,1,86,0,0
"Thailand","2024-04-24",0,0,76,0,0,86,0,0
"Thailand","2024-04-25",0,0,76,0,1,87,0,0
"Thailand","2024-04-26",0,0,76,0,0,87,0,0
"Thailand","2024-04-27",0,0,76,0,1,88,0,0
"Thailand","2024-04-28",0,0,76,0,0,88,0,0
"Thailand","2024-04-29",0,0,76,0,1,89,0,0
"Thailand","2024-04-30",0,13,89,0,0,89,0,0
"Thailand","2024-05-01",0,0,89,0,1,90,0,0
"Thailand","2024-05-02",0,0,89,0,0,90,0,0
"Thailand","2024-05-03",0,0,89,0,1,91,0,0
"Thailand","2024-05-04",0,0,89,0,1,92,0,0
"Thailand","2024-05-05",0,0,89,0,0,92,0,0
"Thailand","2024-05-06",0,0,89,0,1,93,0,0
"Thailand","2024-05-07",0,0,89,0,1,94,0,0
"Thailand","2024-05-08",0,0,89,0,0,94,0,0
"Thailand","2024-05-09",0,0,89,0,1,95,0,0
"Thailand","2024-05-10",0,0,89,0,1,96,0,0
"Thailand","2024-05-11",0,0,89,0,0,96,0,0
"Thailand","2024-05-12",0,0,89,0,1,97,0,0
"Thailand","2024-05-13",0,0,89,0,1,98,0,0
"Thailand","2024-05-14",0,0,89,0,0,98,0,0
"Thailand","2024-05-15",0,0,89,0,1,99,0,0
"Thailand","2024-05-16",0,0,89,0,1,100,0,0
"Thailand","2024-05-17",0,0,89,0,1,101,0,0
"Thailand","2024-05-18",0,0,89,0,0,101,0,0
"Thailand","2024-05-19",0,0,89,0,1,102,0,0
"Thailand","2024-05-20",0,0,89,0,1,103,0,0
"Thailand","2024-05-21",0,0,89,0,0,103,0,0
"Thailand","2024-05-22",0,0,89,0,1,104,0,0
"Thailand","2024-05-23",0,0,89,0,1,105,0,0
"Thailand","2024-05-24",0,0,89,0,0,105,0,0
"Thailand","2024-05-25",0,0,89,0,1,106,0,0
"Thailand","2024-05-26",0,0,89,0,1,107,0,0
"Thailand","2024-05-27",0,0,89,0,0,107,0,0
"Thailand","2024-05-28",0,0,89,0,1,108,0,0
"Thailand","2024-05-29",0,0,89,0,1,109,0,0
"Thailand","2024-05-30",0,0,89,0,0,109,0,0
"Thailand","2024-05-31",0,21,110,0,1,110,0,0
"Thailand","2024-06-01",0,0,110,0,0,110,0,0
"Thailand","2024-06-02",0,0,110,0,1,111,0,0
"Thailand","2024-06-03",0,0,110,0,0,111,0,0
"Thailand","2024-06-04",0,0,110,0,0,111,0,0
"Thailand","2024-06-05",0,0,110,0,1,112,0,0
"Thailand","2024-06-06",0,0,110,0,0,112,0,0
"Thailand","2024-06-07",0,0,110,0,0,112,0,0
"Thailand","2024-06-08",0,0,110,0,1,113,0,0
"Thailand","2024-06-09",0,0,110,0,0,113,0,0
"Thailand","2024-06-10",0,0,110,0,0,113,0,0
"Thailand","2024-06-11",0,0,110,0,1,114,0,0
"Thailand","2024-06-12",0,0,110,0,0,114,0,0
"Thailand","2024-06-13",0,0,110,0,0,114,0,0
"Thailand","2024-06-14",0,0,110,0,1,115,0,0
"Thailand","2024-06-15",0,0,110,0,0,115,0,0
"Thailand","2024-06-16",0,0,110,0,0,115,0,0
"Thailand","2024-06-17",0,0,110,0,1,116,0,0
"Thailand","2024-06-18",0,0,110,0,0,116,0,0
"Thailand","2024-06-19",0,0,110,0,0,116,0,0
"Thailand","2024-06-20",0,0,110,0,1,117,0,0
"Thailand","2024-06-21",0,0,110,0,0,117,0,0
"Thailand","2024-06-22",0,0,110,0,0,117,0,0
"Thailand","2024-06-23",0,0,110,0,1,118,0,0
"Thailand","2024-06-24",0,0,110,0,0,118,0,0
"Thailand","2024-06-25",0,0,110,0,0,118,0,0
"Thailand","2024-06-26",0,0,110,0,1,119,0,0
"Thailand","2024-06-27",0,0,110,0,0,119,0,0
"Thailand","2024-06-28",0,0,110,0,0,119,0,0
"Thailand","2024-06-29",0,0,110,0,1,120,0,0
"Thailand","2024-06-30",0,10,120,0,0,120,0,0
"Thailand","2024-07-01",0,0,120,0,0,120,0,0
"Thailand","2024-07-02",0,0,120,0,1,121,0,0
"Thailand","2024-07-03",0,0,120,0,0,121,0,0
"Thailand","2024-07-04",0,0,120,0,1,122,0,0
"Thailand","2024-07-05",0,0,120,0,0,122,0,0
"Thailand","2024-07-06",0,0,120,0,1,123,0,0
"Thailand","2024-07-07",0,0,120,0,0,123,0,0
"Thailand","2024-07-08",0,0,120,0,1,124,0,0
"Thailand","2024-07-09",0,0,120,0,0,124,0,0
"Thailand","2024-07-10",0,0,120,0,1,125,0,0
"Thailand","2024-07-11",0,0,120,0,0,125,0,0
"Thailand","2024-07-12",0,0,120,0,1,126,0,0
"Thailand","2024-07-13",0,0,120,0,0,126,0,0
"Thailand","2024-07-14",0,0,120,0,1,127,0,0
"Thailand","2024-07-15",0,0,120,0,0,127,0,0
"Thailand","2024-07-16",0,0,120,0,1,128,0,0
"Thailand","2024-07-17",0,0,120,0,0,128,0,0
"Thailand","2024-07-18",0,0,120,0,1,129,0,0
"Thailand","2024-07-19",0,0,120,0,0,129,0,0
"Thailand","2024-07-20",0,0,120,0,1,130,0,0
"Thailand","2024-07-21",0,0,120,0,0,130,0,0
"Thailand","2024-07-22",0,0,120,0,1,131,0,0
"Thailand","2024-07-23",0,0,120,0,0,131,0,0
"Thailand","2024-07-24",0,0,120,0,1,132,0,0
"Thailand","2024-07-25",0,0,120,0,0,132,0,0
"Thailand","2024-07-26",0,0,120,0,1,133,0,0
"Thailand","2024-07-27",0,0,120,0,0,133,0,0
"Thailand","2024-07-28",0,0,120,0,1,134,0,0
"Thailand","2024-07-29",0,0,120,0,0,134,0,0
"Thailand","2024-07-30",0,0,120,0,1,135,0,0
"Thailand","2024-07-31",0,15,135,0,0,135,0,0
"Thailand","2024-08-01",0,0,135,0,0,135,0,0
"Thailand","2024-08-02",0,0,135,0,1,136,0,0
"Thailand","2024-08-03",0,0,135,0,0,136,0,0
"Thailand","2024-08-04",0,0,135,0,1,137,0,0
"Thailand","2024-08-05",0,0,135,0,0,137,0,0
"Thailand","2024-08-06",0,0,135,0,1,138,0,0
"Thailand","2024-08-07",0,0,135,0,0,138,0,0
"Thailand","2024-08-08",0,0,135,0,0,138,0,0
"Thailand","2024-08-09",0,0,135,0,1,139,0,0
"Thailand","2024-08-10",0,0,135,0,0,139,0,0
"Thailand","2024-08-11",0,0,135,0,1,140,0,0
"Thailand","2024-08-12",0,0,135,0,0,140,0,0
"Thailand","2024-08-13",0,0,135,0,0,140,0,0
"Thailand","2024-08-14",0,0,135,0,1,141,0,0
"Thailand","2024-08-15",0,0,135,0,0,141,0,0
"Thailand","2024-08-16",0,0,135,0,1,142,0,0
"Thailand","2024-08-17",0,0,135,0,0,142,0,0
"Thailand","2024-08-18",0,0,135,0,1,143,0,0
"Thailand","2024-08-19",0,0,135,0,0,143,0,0
"Thailand","2024-08-20",0,0,135,0,0,143,0,0
"Thailand","2024-08-21",0,0,135,0,1,144,0,0
"Thailand","2024-08-22",0,0,135,0,0,144,0,0
"Thailand","2024-08-23",0,0,135,0,1,145,0,0
"Thailand","2024-08-24",0,0,135,0,0,145,0,0
"Thailand","2024-08-25",0,0,135,0,0,145,0,0
"Thailand","2024-08-26",0,0,135,0,1,146,0,0
"Thailand","2024-08-27",0,0,135,0,0,146,0,0
"Thailand","2024-08-28",0,0,135,0,1,147,0,0
"Thailand","2024-08-29",0,0,135,0,0,147,0,0
"Thailand","2024-08-30",0,0,135,0,1,148,0,0
"Thailand","2024-08-31",0,13,148,0,0,148,0,0
"Thailand","2024-09-01",0,0,148,0,0,148,0,0
"Thailand","2024-09-02",0,0,148,0,1,149,0,0
"Thailand","2024-09-03",0,0,148,0,0,149,0,0
"Thailand","2024-09-04",0,0,148,0,1,150,0,0
"Thailand","2024-09-05",0,0,148,0,0,150,0,0
"Thailand","2024-09-06",0,0,148,0,0,150,0,0
"Thailand","2024-09-07",0,0,148,0,1,151,0,0
"Thailand","2024-09-08",0,0,148,0,0,151,0,0
"Thailand","2024-09-09",0,0,148,0,1,152,0,0
"Thailand","2024-09-10",0,0,148,0,0,152,0,0
"Thailand","2024-09-11",0,0,148,0,0,152,0,0
"Thailand","2024-09-12",0,0,148,0,1,153,0,0
"Thailand","2024-09-13",0,0,148,0,0,153,0,0
"Thailand","2024-09-14",0,0,148,0,1,154,0,0
"Thailand","2024-09-15",0,0,148,0,0,154,0,0
"Thailand","2024-09-16",0,0,148,0,0,154,0,0
"Thailand","2024-09-17",0,0,148,0,1,155,0,0
"Thailand","2024-09-18",0,0,148,0,0,155,0,0
"Thailand","2024-09-19",0,0,148,0,1,156,0,0
"Thailand","2024-09-20",0,0,148,0,0,156,0,0
"Thailand","2024-09-21",0,0,148,0,0,156,0,0
"Thailand","2024-09-22",0,0,148,0,1,157,0,0
"Thailand","2024-09-23",0,0,148,0,0,157,0,0
"Thailand","2024-09-24",0,0,148,0,1,158,0,0
"Thailand","2024-09-25",0,0,148,0,0,158,0,0
"Thailand","2024-09-26",0,0,148,0,0,158,0,0
"Thailand","2024-09-27",0,0,148,0,1,159,0,0
"Thailand","2024-09-28",0,0,148,0,0,159,0,0
"Thailand","2024-09-29",0,0,148,0,1,160,0,0
"Thailand","2024-09-30",0,12,160,0,0,160,0,0
"Thailand","2024-10-01",0,0,160,0,0,160,0,0
"Thailand","2024-10-02",0,0,160,0,1,161,0,0
"Thailand","2024-10-03",0,0,160,0,0,161,0,0
"Thailand","2024-10-04",0,0,160,0,1,162,0,0
"Thailand","2024-10-05",0,0,160,0,0,162,0,0
"Thailand","2024-10-06",0,0,160,0,1,163,0,0
"Thailand","2024-10-07",0,0,160,0,0,163,0,0
"Thailand","2024-10-08",0,0,160,0,0,163,0,0
"Thailand","2024-10-09",0,0,160,0,1,164,0,0
"Thailand","2024-10-10",0,0,160,0,0,164,0,0
"Thailand","2024-10-11",0,0,160,0,1,165,0,0
"Thailand","2024-10-12",0,0,160,0,0,165,0,0
"Thailand","2024-10-13",0,0,160,0,0,165,0,0
"Thailand","2024-10-14",0,0,160,0,1,166,0,0
"Thailand","2024-10-15",0,0,160,0,0,166,0,0
"Thailand","2024-10-16",0,0,160,0,1,167,0,0
"Thailand","2024-10-17",0,0,160,0,0,167,0,0
"Thailand","2024-10-18",0,0,160,0,1,168,0,0
"Thailand","2024-10-19",0,0,160,0,0,168,0,0
"Thailand","2024-10-20",0,0,160,0,0,168,0,0
"Thailand","2024-10-21",0,0,160,0,1,169,0,0
"Thailand","2024-10-22",0,0,160,0,0,169,0,0
"Thailand","2024-10-23",0,0,160,0,1,170,0,0
"Thailand","2024-10-24",0,0,160,0,0,170,0,0
"Thailand","2024-10-25",0,0,160,0,0,170,0,0
"Thailand","2024-10-26",0,0,160,0,1,171,0,0
"Thailand","2024-10-27",0,0,160,0,0,171,0,0
"Thailand","2024-10-28",0,0,160,0,1,172,0,0
"Thailand","2024-10-29",0,0,160,0,0,172,0,0
"Thailand","2024-10-30",0,0,160,0,1,173,0,0
"Thailand","2024-10-31",0,13,173,0,0,173,0,0
"Thailand","2024-11-01",0,0,173,0,0,173,0,0
"Thailand","2024-11-02",0,0,173,0,0,173,0,0
"Thailand","2024-11-03",0,0,173,0,0,173,0,0
"Thailand","2024-11-04",0,0,173,0,0,173,0,0
"Thailand","2024-11-05",0,0,173,0,0,173,0,0
"Thailand","2024-11-06",0,0,173,0,0,173,0,0
"Thailand","2024-11-07",0,0,173,0,0,173,0,0
"Thailand","2024-11-08",0,0,173,0,0,173,0,0
"Thailand","2024-11-09",0,0,173,0,0,173,0,0
"Thailand","2024-11-10",0,0,173,0,0,173,0,0
"Thailand","2024-11-11",0,0,173,0,0,173,0,0
"Thailand","2024-11-12",0,0,173,0,0,173,0,0
"Thailand","2024-11-13",0,0,173,0,0,173,0,0
"Thailand","2024-11-14",0,0,173,0,0,173,0,0
"Thailand","2024-11-15",0,0,173,0,0,173,0,0
"Thailand","2024-11-16",0,0,173,0,0,173,0,0
"Thailand","2024-11-17",0,0,173,0,0,173,0,0
"Thailand","2024-11-18",0,0,173,0,0,173,0,0
"Thailand","2024-11-19",0,0,173,0,0,173,0,0
"Thailand","2024-11-20",0,0,173,0,0,173,0,0
"Thailand","2024-11-21",0,0,173,0,0,173,0,0
"Thailand","2024-11-22",0,0,173,0,0,173,0,0
"Thailand","2024-11-23",0,0,173,0,0,173,0,0
"Thailand","2024-11-24",0,0,173,0,0,173,0,0
"Thailand","2024-11-25",0,0,173,0,0,173,0,0
"Thailand","2024-11-26",0,0,173,0,0,173,0,0
"Thailand","2024-11-27",0,0,173,0,0,173,0,0
"Thailand","2024-11-28",0,0,173,0,0,173,0,0
"Thailand","2024-11-29",0,0,173,0,0,173,0,0
"Thailand","2024-11-30",0,0,173,0,0,173,0,0
"Thailand","2024-12-01",0,0,173,0,0,173,0,0
"Thailand","2024-12-02",0,0,173,0,0,173,0,0
"Thailand","2024-12-03",0,0,173,0,0,173,0,0
"Thailand","2024-12-04",0,0,173,0,0,173,0,0
"Thailand","2024-12-05",0,0,173,0,0,173,0,0
"Thailand","2024-12-06",0,0,173,0,0,173,0,0
"Thailand","2024-12-07",0,0,173,0,0,173,0,0
"Thailand","2024-12-08",0,0,173,0,0,173,0,0
"Thailand","2024-12-09",0,0,173,0,0,173,0,0
"Trinidad and Tobago","2024-01-01",0,0,0,0,0,0,0,0
"Trinidad and Tobago","2024-01-02",0,0,0,0,0,0,0,0
"Trinidad and Tobago","2024-01-03",0,0,0,0,0,0,0,0
"Trinidad and Tobago","2024-01-04",0,0,0,0,0,0,0,0
"Trinidad and Tobago","2024-01-05",0,0,0,0,0,0,0,0
"Trinidad and Tobago","2024-01-06",0,0,0,0,0,0,0,0
"Trinidad and Tobago","2024-01-07",0,0,0,0,0,0,0,0
"Trinidad and Tobago","2024-01-08",0,0,0,0,0,0,0,0
"Trinidad and Tobago","2024-01-09",0,0,0,0,0,0,0,0
"Trinidad and Tobago","2024-01-10",0,0,0,0,0,0,0,0
"Trinidad and Tobago","2024-01-11",0,0,0,0,0,0,0,0
"Trinidad and Tobago","2024-01-12",0,0,0,0,0,0,0,0
"Trinidad and Tobago","2024-01-13",0,0,0,0,0,0,0,0
"Trinidad and Tobago","2024-01-14",0,0,0,0,0,0,0,0
"Trinidad and Tobago","2024-01-15",0,0,0,0,0,0,0,0
"Trinidad and Tobago","2024-01-16",0,0,0,0,0,0,0,0
"Trinidad and Tobago","2024-01-17",0,0,0,0,0,0,0,0
"Trinidad and Tobago","2024-01-18",0,0,0,0,0,0,0,0
"Trinidad and Tobago","2024-01-19",0,0,0,0,0,0,0,0
"Trinidad and Tobago","2024-01-20",0,0,0,0,0,0,0,0
"Trinidad and Tobago","2024-01-21",0,0,0,0,0,0,0,0
"Trinidad and Tobago","2024-01-22",0,0,0,0,0,0,0,0
"Trinidad and Tobago","2024-01-23",0,0,0,0,0,0,0,0
"Trinidad and Tobago","2024-01-24",0,0,0,0,0,0,0,0
"Trinidad and Tobago","2024-01-25",0,0,0,0,0,0,0,0
"Trinidad and Tobago","2024-01-26",0,0,0,0,0,0,0,0
"Trinidad and Tobago","2024-01-27",0,0,0,0,0,0,0,0
"Trinidad and Tobago","2024-01-28",0,0,0,0,0,0,0,0
"Trinidad and Tobago","2024-01-29",0,0,0,0,0,0,0,0
"Trinidad and Tobago","2024-01-30",0,0,0,0,0,0,0,0
"Trinidad and Tobago","2024-01-31",0,0,0,0,0,0,0,0
"Trinidad and Tobago","2024-02-01",0,0,0,0,0,0,0,0
"Trinidad and Tobago","2024-02-02",0,0,0,0,0,0,0,0
"Trinidad and Tobago","2024-02-03",0,0,0,0,0,0,0,0
"Trinidad and Tobago","2024-02-04",0,0,0,0,0,0,0,0
"Trinidad and Tobago","2024-02-05",0,0,0,0,0,0,0,0
"Trinidad and Tobago","2024-02-06",0,0,0,0,0,0,0,0
"Trinidad and Tobago","2024-02-07",0,0,0,0,0,0,0,0
"Trinidad and Tobago","2024-02-08",0,0,0,0,0,0,0,0
"Trinidad and Tobago","2024-02-09",0,0,0,0,0,0,0,0
"Trinidad and Tobago","2024-02-10",0,0,0,0,0,0,0,0
"Trinidad and Tobago","2024-02-11",0,0,0,0,0,0,0,0
"Trinidad and Tobago","2024-02-12",0,0,0,0,0,0,0,0
"Trinidad and Tobago","2024-02-13",0,0,0,0,0,0,0,0
"Trinidad and Tobago","2024-02-14",0,0,0,0,0,0,0,0
"Trinidad and Tobago","2024-02-15",0,0,0,0,0,0,0,0
"Trinidad and Tobago","2024-02-16",0,0,0,0,0,0,0,0
"Trinidad and Tobago","2024-02-17",0,0,0,0,0,0,0,0
"Trinidad and Tobago","2024-02-18",0,0,0,0,0,0,0,0
"Trinidad and Tobago","2024-02-19",0,0,0,0,0,0,0,0
"Trinidad and Tobago","2024-02-20",0,0,0,0,0,0,0,0
"Trinidad and Tobago","2024-02-21",0,0,0,0,0,0,0,0
"Trinidad and Tobago","2024-02-22",0,0,0,0,0,0,0,0
"Trinidad and Tobago","2024-02-23",0,0,0,0,0,0,0,0
"Trinidad and Tobago","2024-02-24",0,0,0,0,0,0,0,0
"Trinidad and Tobago","2024-02-25",0,0,0,0,0,0,0,0
"Trinidad and Tobago","2024-02-26",0,0,0,0,0,0,0,0
"Trinidad and Tobago","2024-02-27",0,0,0,0,0,0,0,0
"Trinidad and Tobago","2024-02-28",0,0,0,0,0,0,0,0
"Trinidad and Tobago","2024-02-29",0,0,0,0,0,0,0,0
"Trinidad and Tobago","2024-03-01",0,0,0,0,0,0,0,0
"Trinidad and Tobago","2024-03-02",0,0,0,0,0,0,0,0
"Trinidad and Tobago","2024-03-03",0,0,0,0,0,0,0,0
"Trinidad and Tobago","2024-03-04",0,0,0,0,0,0,0,0
"Trinidad and Tobago","2024-03-05",0,0,0,0,0,0,0,0
"Trinidad and Tobago","2024-03-06",0,0,0,0,0,0,0,0
"Trinidad and Tobago","2024-03-07",0,0,0,0,0,0,0,0
"Trinidad and Tobago","2024-03-08",0,0,0,0,0,0,0,0
"Trinidad and Tobago","2024-03-09",0,0,0,0,0,0,0,0
"Trinidad and Tobago","2024-03-10",0,0,0,0,0,0,0,0
"Trinidad and Tobago","2024-03-11",0,0,0,0,0,0,0,0
"Trinidad and Tobago","2024-03-12",0,0,0,0,0,0,0,0
"Trinidad and Tobago","2024-03-13",0,0,0,0,0,0,0,0
"Trinidad and Tobago","2024-03-14",0,0,0,0,0,0,0,0
"Trinidad and Tobago","2024-03-15",0,0,0,0,0,0,0,0
"Trinidad and Tobago","2024-03-16",0,0,0,0,0,0,0,0
"Trinidad and Tobago","2024-03-17",0,0,0,0,0,0,0,0
"Trinidad and Tobago","2024-03-18",0,0,0,0,0,0,0,0
"Trinidad and Tobago","2024-03-19",0,0,0,0,0,0,0,0
"Trinidad and Tobago","2024-03-20",0,0,0,0,0,0,0,0
"Trinidad and Tobago","2024-03-21",0,0,0,0,0,0,0,0
"Trinidad and Tobago","2024-03-22",0,0,0,0,0,0,0,0
"Trinidad and Tobago","2024-03-23",0,0,0,0,0,0,0,0
"Trinidad and Tobago","2024-03-24",0,0,0,0,0,0,0,0
"Trinidad and Tobago","2024-03-25",0,0,0,0,0,0,0,0
"Trinidad and Tobago","2024-03-26",0,0,0,0,0,0,0,0
"Trinidad and Tobago","2024-03-27",0,0,0,0,0,0,0,0
"Trinidad and Tobago","2024-03-28",0,0,0,0,0,0,0,0
"Trinidad and Tobago","2024-03-29",0,0,0,0,0,0,0,0
"Trinidad and Tobago","2024-03-30",0,0,0,0,0,0,0,0
"Trinidad and Tobago","2024-03-31",0,0,0,0,0,0,0,0
"Trinidad and Tobago","2024-04-01",0,0,0,0,0,0,0,0
"Trinidad and Tobago","2024-04-02",0,0,0,0,0,0,0,0
"Trinidad and Tobago","2024-04-03",0,0,0,0,0,0,0,0
"Trinidad and Tobago","2024-04-04",0,0,0,0,0,0,0,0
"Trinidad and Tobago","2024-04-05",0,0,0,0,0,0,0,0
"Trinidad and Tobago","2024-04-06",0,0,0,0,0,0,0,0
"Trinidad and Tobago","2024-04-07",0,0,0,0,0,0,0,0
"Trinidad and Tobago","2024-04-08",0,0,0,0,0,0,0,0
"Trinidad and Tobago","2024-04-09",0,0,0,0,0,0,0,0
"Trinidad and Tobago","2024-04-10",0,0,0,0,0,0,0,0
"Trinidad and Tobago","2024-04-11",0,0,0,0,0,0,0,0
"Trinidad and Tobago","2024-04-12",0,0,0,0,0,0,0,0
"Trinidad and Tobago","2024-04-13",0,0,0,0,0,0,0,0
"Trinidad and Tobago","2024-04-14",0,0,0,0,0,0,0,0
"Trinidad and Tobago","2024-04-15",0,0,0,0,0,0,0,0
"Trinidad and Tobago","2024-04-16",0,0,0,0,0,0,0,0
"Trinidad and Tobago","2024-04-17",0,0,0,0,0,0,0,0
"Trinidad and Tobago","2024-04-18",0,0,0,0,0,0,0,0
"Trinidad and Tobago","2024-04-19",0,0,0,0,0,0,0,0
"Trinidad and Tobago","2024-04-20",0,0,0,0,0,0,0,0
"Trinidad and Tobago","2024-04-21",0,0,0,0,0,0,0,0
"Trinidad and Tobago","2024-04-22",0,0,0,0,0,0,0,0
"Trinidad and Tobago","2024-04-23",0,0,0,0,0,0,0,0
"Trinidad and Tobago","2024-04-24",0,0,0,0,0,0,0,0
"Trinidad and Tobago","2024-04-25",0,0,0,0,0,0,0,0
"Trinidad and Tobago","2024-04-26",0,0,0,0,0,0,0,0
"Trinidad and Tobago","2024-04-27",0,0,0,0,0,0,0,0
"Trinidad and Tobago","2024-04-28",0,0,0,0,0,0,0,0
"Trinidad and Tobago","2024-04-29",0,0,0,0,0,0,0,0
"Trinidad and Tobago","2024-04-30",0,0,0,0,0,0,0,0
"Trinidad and Tobago","2024-05-01",0,0,0,0,0,0,0,0
"Trinidad and Tobago","2024-05-02",0,0,0,0,0,0,0,0
"Trinidad and Tobago","2024-05-03",0,0,0,0,0,0,0,0
"Trinidad and Tobago","2024-05-04",0,0,0,0,0,0,0,0
"Trinidad and Tobago","2024-05-05",0,0,0,0,0,0,0,0
"Trinidad and Tobago","2024-05-06",0,0,0,0,0,0,0,0
"Trinidad and Tobago","2024-05-07",0,0,0,0,0,0,0,0
"Trinidad and Tobago","2024-05-08",0,0,0,0,0,0,0,0
"Trinidad and Tobago","2024-05-09",0,0,0,0,0,0,0,0
"Trinidad and Tobago","2024-05-10",0,0,0,0,0,0,0,0
"Trinidad and Tobago","2024-05-11",0,0,0,0,0,0,0,0
"Trinidad and Tobago","2024-05-12",0,0,0,0,0,0,0,0
"Trinidad and Tobago","2024-05-13",0,0,0,0,0,0,0,0
"Trinidad and Tobago","2024-05-14",0,0,0,0,0,0,0,0
"Trinidad and Tobago","2024-05-15",0,0,0,0,0,0,0,0
"Trinidad and Tobago","2024-05-16",0,0,0,0,0,0,0,0
"Trinidad and Tobago","2024-05-17",0,0,0,0,0,0,0,0
"Trinidad and Tobago","2024-05-18",0,0,0,0,0,0,0,0
"Trinidad and Tobago","2024-05-19",0,0,0,0,0,0,0,0
"Trinidad and Tobago","2024-05-20",0,0,0,0,0,0,0,0
"Trinidad and Tobago","2024-05-21",0,0,0,0,0,0,0,0
"Trinidad and Tobago","2024-05-22",0,0,0,0,0,0,0,0
"Trinidad and Tobago","2024-05-23",0,0,0,0,0,0,0,0
"Trinidad and Tobago","2024-05-24",0,0,0,0,0,0,0,0
"Trinidad and Tobago","2024-05-25",0,0,0,0,0,0,0,0
"Trinidad and Tobago","2024-05-26",0,0,0,0,0,0,0,0
"Trinidad and Tobago","2024-05-27",0,0,0,0,0,0,0,0
"Trinidad and Tobago","2024-05-28",0,0,0,0,0,0,0,0
"Trinidad and Tobago","2024-05-29",0,0,0,0,0,0,0,0
"Trinidad and Tobago","2024-05-30",0,0,0,0,0,0,0,0
"Trinidad and Tobago","2024-05-31",0,0,0,0,0,0,0,0
"Trinidad and Tobago","2024-06-01",0,0,0,0,0,0,0,0
"Trinidad and Tobago","2024-06-02",0,0,0,0,0,0,0,0
"Trinidad and Tobago","2024-06-03",0,0,0,0,0,0,0,0
"Trinidad and Tobago","2024-06-04",0,0,0,0,0,0,0,0
"Trinidad and Tobago","2024-06-05",0,0,0,0,0,0,0,0
"Trinidad and Tobago","2024-06-06",0,0,0,0,0,0,0,0
"Trinidad and Tobago","2024-06-07",0,0,0,0,0,0,0,0
"Trinidad and Tobago","2024-06-08",0,0,0,0,0,0,0,0
"Trinidad and Tobago","2024-06-09",0,0,0,0,0,0,0,0
"Trinidad and Tobago","2024-06-10",0,0,0,0,0,0,0,0
"Trinidad and Tobago","2024-06-11",0,0,0,0,0,0,0,0
"Trinidad and Tobago","2024-06-12",0,0,0,0,0,0,0,0
"Trinidad and Tobago","2024-06-13",0,0,0,0,0,0,0,0
"Trinidad and Tobago","2024-06-14",0,0,0,0,0,0,0,0
"Trinidad and Tobago","2024-06-15",0,0,0,0,0,0,0,0
"Trinidad and Tobago","2024-06-16",0,0,0,0,0,0,0,0
"Trinidad and Tobago","2024-06-17",0,0,0,0,0,0,0,0
"Trinidad and Tobago","2024-06-18",0,0,0,0,0,0,0,0
"Trinidad and Tobago","2024-06-19",0,0,0,0,0,0,0,0
"Trinidad and Tobago","2024-06-20",0,0,0,0,0,0,0,0
"Trinidad and Tobago","2024-06-21",0,0,0,0,0,0,0,0
"Trinidad and Tobago","2024-06-22",0,0,0,0,0,0,0,0
"Trinidad and Tobago","2024-06-23",0,0,0,0,0,0,0,0
"Trinidad and Tobago","2024-06-24",0,0,0,0,0,0,0,0
"Trinidad and Tobago","2024-06-25",0,0,0,0,0,0,0,0
"Trinidad and Tobago","2024-06-26",0,0,0,0,0,0,0,0
"Trinidad and Tobago","2024-06-27",0,0,0,0,0,0,0,0
"Trinidad and Tobago","2024-06-28",0,0,0,0,0,0,0,0
"Trinidad and Tobago","2024-06-29",0,0,0,0,0,0,0,0
"Trinidad and Tobago","2024-06-30",0,0,0,0,0,0,0,0
"Trinidad and Tobago","2024-07-01",0,0,0,0,0,0,0,0
"Trinidad and Tobago","2024-07-02",0,0,0,0,0,0,0,0
"Trinidad and Tobago","2024-07-03",0,0,0,0,0,0,0,0
"Trinidad and Tobago","2024-07-04",0,0,0,0,0,0,0,0
"Trinidad and Tobago","2024-07-05",0,0,0,0,0,0,0,0
"Trinidad and Tobago","2024-07-06",0,0,0,0,0,0,0,0
"Trinidad and Tobago","2024-07-07",0,0,0,0,0,0,0,0
"Trinidad and Tobago","2024-07-08",0,0,0,0,0,0,0,0
"Trinidad and Tobago","2024-07-09",0,0,0,0,0,0,0,0
"Trinidad and Tobago","2024-07-10",0,0,0,0,0,0,0,0
"Trinidad and Tobago","2024-07-11",0,0,0,0,0,0,0,0
"Trinidad and Tobago","2024-07-12",0,0,0,0,0,0,0,0
"Trinidad and Tobago","2024-07-13",0,0,0,0,0,0,0,0
"Trinidad and Tobago","2024-07-14",0,0,0,0,0,0,0,0
"Trinidad and Tobago","2024-07-15",0,0,0,0,0,0,0,0
"Trinidad and Tobago","2024-07-16",0,0,0,0,0,0,0,0
"Trinidad and Tobago","2024-07-17",0,0,0,0,0,0,0,0
"Trinidad and Tobago","2024-07-18",0,0,0,0,0,0,0,0
"Trinidad and Tobago","2024-07-19",0,0,0,0,0,0,0,0
"Trinidad and Tobago","2024-07-20",0,0,0,0,0,0,0,0
"Trinidad and Tobago","2024-07-21",0,0,0,0,0,0,0,0
"Trinidad and Tobago","2024-07-22",0,0,0,0,0,0,0,0
"Trinidad and Tobago","2024-07-23",0,0,0,0,0,0,0,0
"Trinidad and Tobago","2024-07-24",0,0,0,0,0,0,0,0
"Trinidad and Tobago","2024-07-25",0,0,0,0,0,0,0,0
"Trinidad and Tobago","2024-07-26",0,0,0,0,0,0,0,0
"Trinidad and Tobago","2024-07-27",0,0,0,0,0,0,0,0
"Trinidad and Tobago","2024-07-28",0,0,0,0,0,0,0,0
"Trinidad and Tobago","2024-07-29",0,0,0,0,0,0,0,0
"Trinidad and Tobago","2024-07-30",0,0,0,0,0,0,0,0
"Trinidad and Tobago","2024-07-31",0,0,0,0,0,0,0,0
"Trinidad and Tobago","2024-08-01",0,0,0,0,0,0,0,0
"Trinidad and Tobago","2024-08-02",0,0,0,0,0,0,0,0
"Trinidad and Tobago","2024-08-03",0,0,0,0,0,0,0,0
"Trinidad and Tobago","2024-08-04",0,0,0,0,0,0,0,0
"Trinidad and Tobago","2024-08-05",0,0,0,0,0,0,0,0
"Trinidad and Tobago","2024-08-06",0,0,0,0,0,0,0,0
"Trinidad and Tobago","2024-08-07",0,0,0,0,0,0,0,0
"Trinidad and Tobago","2024-08-08",0,0,0,0,0,0,0,0
"Trinidad and Tobago","2024-08-09",0,0,0,0,0,0,0,0
"Trinidad and Tobago","2024-08-10",0,0,0,0,0,0,0,0
"Trinidad and Tobago","2024-08-11",0,0,0,0,0,0,0,0
"Trinidad and Tobago","2024-08-12",0,0,0,0,0,0,0,0
"Trinidad and Tobago","2024-08-13",0,0,0,0,0,0,0,0
"Trinidad and Tobago","2024-08-14",0,0,0,0,0,0,0,0
"Trinidad and Tobago","2024-08-15",0,0,0,0,0,0,0,0
"Trinidad and Tobago","2024-08-16",0,0,0,0,0,0,0,0
"Trinidad and Tobago","2024-08-17",0,0,0,0,0,0,0,0
"Trinidad and Tobago","2024-08-18",0,0,0,0,0,0,0,0
"Trinidad and Tobago","2024-08-19",0,0,0,0,0,0,0,0
"Trinidad and Tobago","2024-08-20",0,0,0,0,0,0,0,0
"Trinidad and Tobago","2024-08-21",0,0,0,0,0,0,0,0
"Trinidad and Tobago","2024-08-22",0,0,0,0,0,0,0,0
"Trinidad and Tobago","2024-08-23",0,0,0,0,0,0,0,0
"Trinidad and Tobago","2024-08-24",0,0,0,0,0,0,0,0
"Trinidad and Tobago","2024-08-25",0,0,0,0,0,0,0,0
"Trinidad and Tobago","2024-08-26",0,0,0,0,0,0,0,0
"Trinidad and Tobago","2024-08-27",0,0,0,0,0,0,0,0
"Trinidad and Tobago","2024-08-28",0,0,0,0,0,0,0,0
"Trinidad and Tobago","2024-08-29",0,0,0,0,0,0,0,0
"Trinidad and Tobago","2024-08-30",0,0,0,0,0,0,0,0
"Trinidad and Tobago","2024-08-31",0,0,0,0,0,0,0,0
"Trinidad and Tobago","2024-09-01",0,0,0,0,0,0,0,0
"Trinidad and Tobago","2024-09-02",0,0,0,0,0,0,0,0
"Trinidad and Tobago","2024-09-03",0,0,0,0,0,0,0,0
"Trinidad and Tobago","2024-09-04",0,0,0,0,0,0,0,0
"Trinidad and Tobago","2024-09-05",0,0,0,0,0,0,0,0
"Trinidad and Tobago","2024-09-06",0,0,0,0,0,0,0,0
"Trinidad and Tobago","2024-09-07",0,0,0,0,0,0,0,0
"Trinidad and Tobago","2024-09-08",0,0,0,0,0,0,0,0
"Trinidad and Tobago","2024-09-09",0,0,0,0,0,0,0,0
"Trinidad and Tobago","2024-09-10",0,0,0,0,0,0,0,0
"Trinidad and Tobago","2024-09-11",0,0,0,0,0,0,0,0
"Trinidad and Tobago","2024-09-12",0,0,0,0,0,0,0,0
"Trinidad and Tobago","2024-09-13",0,0,0,0,0,0,0,0
"Trinidad and Tobago","2024-09-14",0,0,0,0,0,0,0,0
"Trinidad and Tobago","2024-09-15",0,0,0,0,0,0,0,0
"Trinidad and Tobago","2024-09-16",0,0,0,0,0,0,0,0
"Trinidad and Tobago","2024-09-17",0,0,0,0,0,0,0,0
"Trinidad and Tobago","2024-09-18",0,0,0,0,0,0,0,0
"Trinidad and Tobago","2024-09-19",0,0,0,0,0,0,0,0
"Trinidad and Tobago","2024-09-20",0,0,0,0,0,0,0,0
"Trinidad and Tobago","2024-09-21",0,0,0,0,0,0,0,0
"Trinidad and Tobago","2024-09-22",0,0,0,0,0,0,0,0
"Trinidad and Tobago","2024-09-23",0,0,0,0,0,0,0,0
"Trinidad and Tobago","2024-09-24",0,0,0,0,0,0,0,0
"Trinidad and Tobago","2024-09-25",0,0,0,0,0,0,0,0
"Trinidad and Tobago","2024-09-26",0,0,0,0,0,0,0,0
"Trinidad and Tobago","2024-09-27",0,0,0,0,0,0,0,0
"Trinidad and Tobago","2024-09-28",0,0,0,0,0,0,0,0
"Trinidad and Tobago","2024-09-29",0,0,0,0,0,0,0,0
"Trinidad and Tobago","2024-09-30",0,0,0,0,0,0,0,0
"Trinidad and Tobago","2024-10-01",0,0,0,0,0,0,0,0
"Trinidad and Tobago","2024-10-02",0,0,0,0,0,0,0,0
"Trinidad and Tobago","2024-10-03",0,0,0,0,0,0,0,0
"Trinidad and Tobago","2024-10-04",0,0,0,0,0,0,0,0
"Trinidad and Tobago","2024-10-05",0,0,0,0,0,0,0,0
"Trinidad and Tobago","2024-10-06",0,0,0,0,0,0,0,0
"Trinidad and Tobago","2024-10-07",0,0,0,0,0,0,0,0
"Trinidad and Tobago","2024-10-08",0,0,0,0,0,0,0,0
"Trinidad and Tobago","2024-10-09",0,0,0,0,0,0,0,0
"Trinidad and Tobago","2024-10-10",0,0,0,0,0,0,0,0
"Trinidad and Tobago","2024-10-11",0,0,0,0,0,0,0,0
"Trinidad and Tobago","2024-10-12",0,0,0,0,0,0,0,0
"Trinidad and Tobago","2024-10-13",0,0,0,0,0,0,0,0
"Trinidad and Tobago","2024-10-14",0,0,0,0,0,0,0,0
"Trinidad and Tobago","2024-10-15",0,0,0,0,0,0,0,0
"Trinidad and Tobago","2024-10-16",0,0,0,0,0,0,0,0
"Trinidad and Tobago","2024-10-17",0,0,0,0,0,0,0,0
"Trinidad and Tobago","2024-10-18",0,0,0,0,0,0,0,0
"Trinidad and Tobago","2024-10-19",0,0,0,0,0,0,0,0
"Trinidad and Tobago","2024-10-20",0,0,0,0,0,0,0,0
"Trinidad and Tobago","2024-10-21",0,0,0,0,0,0,0,0
"Trinidad and Tobago","2024-10-22",0,0,0,0,0,0,0,0
"Trinidad and Tobago","2024-10-23",0,0,0,0,0,0,0,0
"Trinidad and Tobago","2024-10-24",0,0,0,0,0,0,0,0
"Trinidad and Tobago","2024-10-25",0,0,0,0,0,0,0,0
"Trinidad and Tobago","2024-10-26",0,0,0,0,0,0,0,0
"Trinidad and Tobago","2024-10-27",0,0,0,0,0,0,0,0
"Trinidad and Tobago","2024-10-28",0,0,0,0,0,0,0,0
"Trinidad and Tobago","2024-10-29",0,0,0,0,0,0,0,0
"Trinidad and Tobago","2024-10-30",0,0,0,0,0,0,0,0
"Trinidad and Tobago","2024-10-31",0,0,0,0,0,0,0,0
"Trinidad and Tobago","2024-11-01",0,0,0,0,0,0,0,0
"Trinidad and Tobago","2024-11-02",0,0,0,0,0,0,0,0
"Trinidad and Tobago","2024-11-03",0,0,0,0,0,0,0,0
"Trinidad and Tobago","2024-11-04",0,0,0,0,0,0,0,0
"Trinidad and Tobago","2024-11-05",0,0,0,0,0,0,0,0
"Trinidad and Tobago","2024-11-06",0,0,0,0,0,0,0,0
"Trinidad and Tobago","2024-11-07",0,0,0,0,0,0,0,0
"Trinidad and Tobago","2024-11-08",0,0,0,0,0,0,0,0
"Trinidad and Tobago","2024-11-09",0,0,0,0,0,0,0,0
"Trinidad and Tobago","2024-11-10",0,0,0,0,0,0,0,0
"Trinidad and Tobago","2024-11-11",0,0,0,0,0,0,0,0
"Trinidad and Tobago","2024-11-12",0,0,0,0,0,0,0,0
"Trinidad and Tobago","2024-11-13",0,0,0,0,0,0,0,0
"Trinidad and Tobago","2024-11-14",0,0,0,0,0,0,0,0
"Trinidad and Tobago","2024-11-15",0,0,0,0,0,0,0,0
"Trinidad and Tobago","2024-11-16",0,0,0,0,0,0,0,0
"Trinidad and Tobago","2024-11-17",0,0,0,0,0,0,0,0
"Trinidad and Tobago","2024-11-18",0,0,0,0,0,0,0,0
"Trinidad and Tobago","2024-11-19",0,0,0,0,0,0,0,0
"Trinidad and Tobago","2024-11-20",0,0,0,0,0,0,0,0
"Trinidad and Tobago","2024-11-21",0,0,0,0,0,0,0,0
"Trinidad and Tobago","2024-11-22",0,0,0,0,0,0,0,0
"Trinidad and Tobago","2024-11-23",0,0,0,0,0,0,0,0
"Trinidad and Tobago","2024-11-24",0,0,0,0,0,0,0,0
"Trinidad and Tobago","2024-11-25",0,0,0,0,0,0,0,0
"Trinidad and Tobago","2024-11-26",0,0,0,0,0,0,0,0
"Trinidad and Tobago","2024-11-27",0,0,0,0,0,0,0,0
"Trinidad and Tobago","2024-11-28",0,0,0,0,0,0,0,0
"Trinidad and Tobago","2024-11-29",0,0,0,0,0,0,0,0
"Trinidad and Tobago","2024-11-30",0,0,0,0,0,0,0,0
"Trinidad and Tobago","2024-12-01",0,0,0,0,0,0,0,0
"Trinidad and Tobago","2024-12-02",0,0,0,0,0,0,0,0
"Trinidad and Tobago","2024-12-03",0,0,0,0,0,0,0,0
"Trinidad and Tobago","2024-12-04",0,0,0,0,0,0,0,0
"Trinidad and Tobago","2024-12-05",0,0,0,0,0,0,0,0
"Trinidad and Tobago","2024-12-06",0,0,0,0,0,0,0,0
"Trinidad and Tobago","2024-12-07",0,0,0,0,0,0,0,0
"Trinidad and Tobago","2024-12-08",0,0,0,0,0,0,0,0
"Trinidad and Tobago","2024-12-09",0,0,0,0,0,0,0,0
"Türkiye","2024-01-01",0,0,0,0,0,0,0,0
"Türkiye","2024-01-02",0,0,0,0,0,0,0,0
"Türkiye","2024-01-03",0,0,0,0,0,0,0,0
"Türkiye","2024-01-04",0,0,0,0,0,0,0,0
"Türkiye","2024-01-05",0,0,0,0,0,0,0,0
"Türkiye","2024-01-06",0,0,0,0,0,0,0,0
"Türkiye","2024-01-07",0,0,0,0,0,0,0,0
"Türkiye","2024-01-08",0,0,0,0,0,0,0,0
"Türkiye","2024-01-09",0,0,0,0,0,0,0,0
"Türkiye","2024-01-10",0,0,0,0,0,0,0,0
"Türkiye","2024-01-11",0,0,0,0,0,0,0,0
"Türkiye","2024-01-12",0,0,0,0,0,0,0,0
"Türkiye","2024-01-13",0,0,0,0,0,0,0,0
"Türkiye","2024-01-14",0,0,0,0,0,0,0,0
"Türkiye","2024-01-15",0,0,0,0,0,0,0,0
"Türkiye","2024-01-16",0,0,0,0,0,0,0,0
"Türkiye","2024-01-17",0,0,0,0,0,0,0,0
"Türkiye","2024-01-18",0,0,0,0,0,0,0,0
"Türkiye","2024-01-19",0,0,0,0,0,0,0,0
"Türkiye","2024-01-20",0,0,0,0,0,0,0,0
"Türkiye","2024-01-21",0,0,0,0,0,0,0,0
"Türkiye","2024-01-22",0,0,0,0,0,0,0,0
"Türkiye","2024-01-23",0,0,0,0,0,0,0,0
"Türkiye","2024-01-24",0,0,0,0,0,0,0,0
"Türkiye","2024-01-25",0,0,0,0,0,0,0,0
"Türkiye","2024-01-26",0,0,0,0,0,0,0,0
"Türkiye","2024-01-27",0,0,0,0,0,0,0,0
"Türkiye","2024-01-28",0,0,0,0,0,0,0,0
"Türkiye","2024-01-29",0,0,0,0,0,0,0,0
"Türkiye","2024-01-30",0,0,0,0,0,0,0,0
"Türkiye","2024-01-31",0,0,0,0,0,0,0,0
"Türkiye","2024-02-01",0,0,0,0,0,0,0,0
"Türkiye","2024-02-02",0,0,0,0,0,0,0,0
"Türkiye","2024-02-03",0,0,0,0,0,0,0,0
"Türkiye","2024-02-04",0,0,0,0,0,0,0,0
"Türkiye","2024-02-05",0,0,0,0,0,0,0,0
"Türkiye","2024-02-06",0,0,0,0,0,0,0,0
"Türkiye","2024-02-07",0,0,0,0,0,0,0,0
"Türkiye","2024-02-08",0,0,0,0,0,0,0,0
"Türkiye","2024-02-09",0,0,0,0,0,0,0,0
"Türkiye","2024-02-10",0,0,0,0,0,0,0,0
"Türkiye","2024-02-11",0,0,0,0,0,0,0,0
"Türkiye","2024-02-12",0,0,0,0,0,0,0,0
"Türkiye","2024-02-13",0,0,0,0,0,0,0,0
"Türkiye","2024-02-14",0,0,0,0,0,0,0,0
"Türkiye","2024-02-15",0,0,0,0,0,0,0,0
"Türkiye","2024-02-16",0,0,0,0,0,0,0,0
"Türkiye","2024-02-17",0,0,0,0,0,0,0,0
"Türkiye","2024-02-18",0,0,0,0,0,0,0,0
"Türkiye","2024-02-19",0,0,0,0,0,0,0,0
"Türkiye","2024-02-20",0,0,0,0,0,0,0,0
"Türkiye","2024-02-21",0,0,0,0,0,0,0,0
"Türkiye","2024-02-22",0,0,0,0,0,0,0,0
"Türkiye","2024-02-23",0,0,0,0,0,0,0,0
"Türkiye","2024-02-24",0,0,0,0,0,0,0,0
"Türkiye","2024-02-25",0,0,0,0,0,0,0,0
"Türkiye","2024-02-26",0,0,0,0,0,0,0,0
"Türkiye","2024-02-27",0,0,0,0,0,0,0,0
"Türkiye","2024-02-28",0,0,0,0,0,0,0,0
"Türkiye","2024-02-29",0,0,0,0,0,0,0,0
"Türkiye","2024-03-01",0,0,0,0,0,0,0,0
"Türkiye","2024-03-02",0,0,0,0,0,0,0,0
"Türkiye","2024-03-03",0,0,0,0,0,0,0,0
"Türkiye","2024-03-04",0,0,0,0,0,0,0,0
"Türkiye","2024-03-05",0,0,0,0,0,0,0,0
"Türkiye","2024-03-06",0,0,0,0,0,0,0,0
"Türkiye","2024-03-07",0,0,0,0,0,0,0,0
"Türkiye","2024-03-08",0,0,0,0,0,0,0,0
"Türkiye","2024-03-09",0,0,0,0,0,0,0,0
"Türkiye","2024-03-10",0,0,0,0,0,0,0,0
"Türkiye","2024-03-11",0,0,0,0,0,0,0,0
"Türkiye","2024-03-12",0,0,0,0,0,0,0,0
"Türkiye","2024-03-13",0,0,0,0,0,0,0,0
"Türkiye","2024-03-14",0,0,0,0,0,0,0,0
"Türkiye","2024-03-15",0,0,0,0,0,0,0,0
"Türkiye","2024-03-16",0,0,0,0,0,0,0,0
"Türkiye","2024-03-17",0,0,0,0,0,0,0,0
"Türkiye","2024-03-18",0,0,0,0,0,0,0,0
"Türkiye","2024-03-19",0,0,0,0,0,0,0,0
"Türkiye","2024-03-20",0,0,0,0,0,0,0,0
"Türkiye","2024-03-21",0,0,0,0,0,0,0,0
"Türkiye","2024-03-22",0,0,0,0,0,0,0,0
"Türkiye","2024-03-23",0,0,0,0,0,0,0,0
"Türkiye","2024-03-24",0,0,0,0,0,0,0,0
"Türkiye","2024-03-25",0,0,0,0,0,0,0,0
"Türkiye","2024-03-26",0,0,0,0,0,0,0,0
"Türkiye","2024-03-27",0,0,0,0,0,0,0,0
"Türkiye","2024-03-28",0,0,0,0,0,0,0,0
"Türkiye","2024-03-29",0,0,0,0,0,0,0,0
"Türkiye","2024-03-30",0,0,0,0,0,0,0,0
"Türkiye","2024-03-31",0,0,0,0,0,0,0,0
"Türkiye","2024-04-01",0,0,0,0,0,0,0,0
"Türkiye","2024-04-02",0,0,0,0,0,0,0,0
"Türkiye","2024-04-03",0,0,0,0,0,0,0,0
"Türkiye","2024-04-04",0,0,0,0,0,0,0,0
"Türkiye","2024-04-05",0,0,0,0,0,0,0,0
"Türkiye","2024-04-06",0,0,0,0,0,0,0,0
"Türkiye","2024-04-07",0,0,0,0,0,0,0,0
"Türkiye","2024-04-08",0,0,0,0,0,0,0,0
"Türkiye","2024-04-09",0,0,0,0,0,0,0,0
"Türkiye","2024-04-10",0,0,0,0,0,0,0,0
"Türkiye","2024-04-11",0,0,0,0,0,0,0,0
"Türkiye","2024-04-12",0,0,0,0,0,0,0,0
"Türkiye","2024-04-13",0,0,0,0,0,0,0,0
"Türkiye","2024-04-14",0,0,0,0,0,0,0,0
"Türkiye","2024-04-15",0,0,0,0,0,0,0,0
"Türkiye","2024-04-16",0,0,0,0,0,0,0,0
"Türkiye","2024-04-17",0,0,0,0,0,0,0,0
"Türkiye","2024-04-18",0,0,0,0,0,0,0,0
"Türkiye","2024-04-19",0,0,0,0,0,0,0,0
"Türkiye","2024-04-20",0,0,0,0,0,0,0,0
"Türkiye","2024-04-21",0,0,0,0,0,0,0,0
"Türkiye","2024-04-22",0,0,0,0,0,0,0,0
"Türkiye","2024-04-23",0,0,0,0,0,0,0,0
"Türkiye","2024-04-24",0,0,0,0,0,0,0,0
"Türkiye","2024-04-25",0,0,0,0,0,0,0,0
"Türkiye","2024-04-26",0,0,0,0,0,0,0,0
"Türkiye","2024-04-27",0,0,0,0,0,0,0,0
"Türkiye","2024-04-28",0,0,0,0,0,0,0,0
"Türkiye","2024-04-29",0,0,0,0,0,0,0,0
"Türkiye","2024-04-30",0,0,0,0,0,0,0,0
"Türkiye","2024-05-01",0,0,0,0,0,0,0,0
"Türkiye","2024-05-02",0,0,0,0,0,0,0,0
"Türkiye","2024-05-03",0,0,0,0,0,0,0,0
"Türkiye","2024-05-04",0,0,0,0,0,0,0,0
"Türkiye","2024-05-05",0,0,0,0,0,0,0,0
"Türkiye","2024-05-06",0,0,0,0,0,0,0,0
"Türkiye","2024-05-07",0,0,0,0,0,0,0,0
"Türkiye","2024-05-08",0,0,0,0,0,0,0,0
"Türkiye","2024-05-09",0,0,0,0,0,0,0,0
"Türkiye","2024-05-10",0,0,0,0,0,0,0,0
"Türkiye","2024-05-11",0,0,0,0,0,0,0,0
"Türkiye","2024-05-12",0,0,0,0,0,0,0,0
"Türkiye","2024-05-13",0,0,0,0,0,0,0,0
"Türkiye","2024-05-14",0,0,0,0,0,0,0,0
"Türkiye","2024-05-15",0,0,0,0,0,0,0,0
"Türkiye","2024-05-16",0,0,0,0,0,0,0,0
"Türkiye","2024-05-17",0,0,0,0,0,0,0,0
"Türkiye","2024-05-18",0,0,0,0,0,0,0,0
"Türkiye","2024-05-19",0,0,0,0,0,0,0,0
"Türkiye","2024-05-20",0,0,0,0,0,0,0,0
"Türkiye","2024-05-21",0,0,0,0,0,0,0,0
"Türkiye","2024-05-22",0,0,0,0,0,0,0,0
"Türkiye","2024-05-23",0,0,0,0,0,0,0,0
"Türkiye","2024-05-24",0,0,0,0,0,0,0,0
"Türkiye","2024-05-25",0,0,0,0,0,0,0,0
"Türkiye","2024-05-26",0,0,0,0,0,0,0,0
"Türkiye","2024-05-27",0,0,0,0,0,0,0,0
"Türkiye","2024-05-28",0,0,0,0,0,0,0,0
"Türkiye","2024-05-29",0,0,0,0,0,0,0,0
"Türkiye","2024-05-30",0,0,0,0,0,0,0,0
"Türkiye","2024-05-31",0,0,0,0,0,0,0,0
"Türkiye","2024-06-01",0,0,0,0,0,0,0,0
"Türkiye","2024-06-02",0,0,0,0,0,0,0,0
"Türkiye","2024-06-03",0,0,0,0,0,0,0,0
"Türkiye","2024-06-04",0,0,0,0,0,0,0,0
"Türkiye","2024-06-05",0,0,0,0,0,0,0,0
"Türkiye","2024-06-06",0,0,0,0,0,0,0,0
"Türkiye","2024-06-07",0,0,0,0,0,0,0,0
"Türkiye","2024-06-08",0,0,0,0,0,0,0,0
"Türkiye","2024-06-09",0,0,0,0,0,0,0,0
"Türkiye","2024-06-10",0,0,0,0,0,0,0,0
"Türkiye","2024-06-11",0,0,0,0,0,0,0,0
"Türkiye","2024-06-12",0,0,0,0,0,0,0,0
"Türkiye","2024-06-13",0,0,0,0,0,0,0,0
"Türkiye","2024-06-14",0,0,0,0,0,0,0,0
"Türkiye","2024-06-15",0,0,0,0,0,0,0,0
"Türkiye","2024-06-16",0,0,0,0,0,0,0,0
"Türkiye","2024-06-17",0,0,0,0,0,0,0,0
"Türkiye","2024-06-18",0,0,0,0,0,0,0,0
"Türkiye","2024-06-19",0,0,0,0,0,0,0,0
"Türkiye","2024-06-20",0,0,0,0,0,0,0,0
"Türkiye","2024-06-21",0,0,0,0,0,0,0,0
"Türkiye","2024-06-22",0,0,0,0,0,0,0,0
"Türkiye","2024-06-23",0,0,0,0,0,0,0,0
"Türkiye","2024-06-24",0,0,0,0,0,0,0,0
"Türkiye","2024-06-25",0,0,0,0,0,0,0,0
"Türkiye","2024-06-26",0,0,0,0,0,0,0,0
"Türkiye","2024-06-27",0,0,0,0,0,0,0,0
"Türkiye","2024-06-28",0,0,0,0,0,0,0,0
"Türkiye","2024-06-29",0,0,0,0,0,0,0,0
"Türkiye","2024-06-30",0,0,0,0,0,0,0,0
"Türkiye","2024-07-01",0,0,0,0,0,0,0,0
"Türkiye","2024-07-02",0,0,0,0,0,0,0,0
"Türkiye","2024-07-03",0,0,0,0,0,0,0,0
"Türkiye","2024-07-04",0,0,0,0,0,0,0,0
"Türkiye","2024-07-05",0,0,0,0,0,0,0,0
"Türkiye","2024-07-06",0,0,0,0,0,0,0,0
"Türkiye","2024-07-07",0,0,0,0,0,0,0,0
"Türkiye","2024-07-08",0,0,0,0,0,0,0,0
"Türkiye","2024-07-09",0,0,0,0,0,0,0,0
"Türkiye","2024-07-10",0,0,0,0,0,0,0,0
"Türkiye","2024-07-11",0,0,0,0,0,0,0,0
"Türkiye","2024-07-12",0,0,0,0,0,0,0,0
"Türkiye","2024-07-13",0,0,0,0,0,0,0,0
"Türkiye","2024-07-14",0,0,0,0,0,0,0,0
"Türkiye","2024-07-15",0,0,0,0,0,0,0,0
"Türkiye","2024-07-16",0,0,0,0,0,0,0,0
"Türkiye","2024-07-17",0,0,0,0,0,0,0,0
"Türkiye","2024-07-18",0,0,0,0,0,0,0,0
"Türkiye","2024-07-19",0,0,0,0,0,0,0,0
"Türkiye","2024-07-20",0,0,0,0,0,0,0,0
"Türkiye","2024-07-21",0,0,0,0,0,0,0,0
"Türkiye","2024-07-22",0,0,0,0,0,0,0,0
"Türkiye","2024-07-23",0,0,0,0,0,0,0,0
"Türkiye","2024-07-24",0,0,0,0,0,0,0,0
"Türkiye","2024-07-25",0,0,0,0,0,0,0,0
"Türkiye","2024-07-26",0,0,0,0,0,0,0,0
"Türkiye","2024-07-27",0,0,0,0,0,0,0,0
"Türkiye","2024-07-28",0,0,0,0,0,0,0,0
"Türkiye","2024-07-29",0,0,0,0,0,0,0,0
"Türkiye","2024-07-30",0,0,0,0,0,0,0,0
"Türkiye","2024-07-31",0,0,0,0,0,0,0,0
"Türkiye","2024-08-01",0,0,0,0,0,0,0,0
"Türkiye","2024-08-02",0,0,0,0,0,0,0,0
"Türkiye","2024-08-03",0,0,0,0,0,0,0,0
"Türkiye","2024-08-04",0,0,0,0,0,0,0,0
"Türkiye","2024-08-05",0,0,0,0,0,0,0,0
"Türkiye","2024-08-06",0,0,0,0,0,0,0,0
"Türkiye","2024-08-07",0,0,0,0,0,0,0,0
"Türkiye","2024-08-08",0,0,0,0,0,0,0,0
"Türkiye","2024-08-09",0,0,0,0,0,0,0,0
"Türkiye","2024-08-10",0,0,0,0,0,0,0,0
"Türkiye","2024-08-11",0,0,0,0,0,0,0,0
"Türkiye","2024-08-12",0,0,0,0,0,0,0,0
"Türkiye","2024-08-13",0,0,0,0,0,0,0,0
"Türkiye","2024-08-14",0,0,0,0,0,0,0,0
"Türkiye","2024-08-15",0,0,0,0,0,0,0,0
"Türkiye","2024-08-16",0,0,0,0,0,0,0,0
"Türkiye","2024-08-17",0,0,0,0,0,0,0,0
"Türkiye","2024-08-18",0,0,0,0,0,0,0,0
"Türkiye","2024-08-19",0,0,0,0,0,0,0,0
"Türkiye","2024-08-20",0,0,0,0,0,0,0,0
"Türkiye","2024-08-21",0,0,0,0,0,0,0,0
"Türkiye","2024-08-22",0,0,0,0,0,0,0,0
"Türkiye","2024-08-23",0,0,0,0,0,0,0,0
"Türkiye","2024-08-24",0,0,0,0,0,0,0,0
"Türkiye","2024-08-25",0,0,0,0,0,0,0,0
"Türkiye","2024-08-26",0,0,0,0,0,0,0,0
"Türkiye","2024-08-27",0,0,0,0,0,0,0,0
"Türkiye","2024-08-28",0,0,0,0,0,0,0,0
"Türkiye","2024-08-29",0,0,0,0,0,0,0,0
"Türkiye","2024-08-30",0,0,0,0,0,0,0,0
"Türkiye","2024-08-31",0,0,0,0,0,0,0,0
"Türkiye","2024-09-01",0,0,0,0,0,0,0,0
"Türkiye","2024-09-02",0,0,0,0,0,0,0,0
"Türkiye","2024-09-03",0,0,0,0,0,0,0,0
"Türkiye","2024-09-04",0,0,0,0,0,0,0,0
"Türkiye","2024-09-05",0,0,0,0,0,0,0,0
"Türkiye","2024-09-06",0,0,0,0,0,0,0,0
"Türkiye","2024-09-07",0,0,0,0,0,0,0,0
"Türkiye","2024-09-08",0,0,0,0,0,0,0,0
"Türkiye","2024-09-09",0,0,0,0,0,0,0,0
"Türkiye","2024-09-10",0,0,0,0,0,0,0,0
"Türkiye","2024-09-11",0,0,0,0,0,0,0,0
"Türkiye","2024-09-12",0,0,0,0,0,0,0,0
"Türkiye","2024-09-13",0,0,0,0,0,0,0,0
"Türkiye","2024-09-14",0,0,0,0,0,0,0,0
"Türkiye","2024-09-15",0,0,0,0,0,0,0,0
"Türkiye","2024-09-16",0,0,0,0,0,0,0,0
"Türkiye","2024-09-17",0,0,0,0,0,0,0,0
"Türkiye","2024-09-18",0,0,0,0,0,0,0,0
"Türkiye","2024-09-19",0,0,0,0,0,0,0,0
"Türkiye","2024-09-20",0,0,0,0,0,0,0,0
"Türkiye","2024-09-21",0,0,0,0,0,0,0,0
"Türkiye","2024-09-22",0,0,0,0,0,0,0,0
"Türkiye","2024-09-23",0,0,0,0,0,0,0,0
"Türkiye","2024-09-24",0,0,0,0,0,0,0,0
"Türkiye","2024-09-25",0,0,0,0,0,0,0,0
"Türkiye","2024-09-26",0,0,0,0,0,0,0,0
"Türkiye","2024-09-27",0,0,0,0,0,0,0,0
"Türkiye","2024-09-28",0,0,0,0,0,0,0,0
"Türkiye","2024-09-29",0,0,0,0,0,0,0,0
"Türkiye","2024-09-30",0,0,0,0,0,0,0,0
"Türkiye","2024-10-01",0,0,0,0,0,0,0,0
"Türkiye","2024-10-02",0,0,0,0,0,0,0,0
"Türkiye","2024-10-03",0,0,0,0,0,0,0,0
"Türkiye","2024-10-04",0,0,0,0,0,0,0,0
"Türkiye","2024-10-05",0,0,0,0,0,0,0,0
"Türkiye","2024-10-06",0,0,0,0,0,0,0,0
"Türkiye","2024-10-07",0,0,0,0,0,0,0,0
"Türkiye","2024-10-08",0,0,0,0,0,0,0,0
"Türkiye","2024-10-09",0,0,0,0,0,0,0,0
"Türkiye","2024-10-10",0,0,0,0,0,0,0,0
"Türkiye","2024-10-11",0,0,0,0,0,0,0,0
"Türkiye","2024-10-12",0,0,0,0,0,0,0,0
"Türkiye","2024-10-13",0,0,0,0,0,0,0,0
"Türkiye","2024-10-14",0,0,0,0,0,0,0,0
"Türkiye","2024-10-15",0,0,0,0,0,0,0,0
"Türkiye","2024-10-16",0,0,0,0,0,0,0,0
"Türkiye","2024-10-17",0,0,0,0,0,0,0,0
"Türkiye","2024-10-18",0,0,0,0,0,0,0,0
"Türkiye","2024-10-19",0,0,0,0,0,0,0,0
"Türkiye","2024-10-20",0,0,0,0,0,0,0,0
"Türkiye","2024-10-21",0,0,0,0,0,0,0,0
"Türkiye","2024-10-22",0,0,0,0,0,0,0,0
"Türkiye","2024-10-23",0,0,0,0,0,0,0,0
"Türkiye","2024-10-24",0,0,0,0,0,0,0,0
"Türkiye","2024-10-25",0,0,0,0,0,0,0,0
"Türkiye","2024-10-26",0,0,0,0,0,0,0,0
"Türkiye","2024-10-27",0,0,0,0,0,0,0,0
"Türkiye","2024-10-28",0,0,0,0,0,0,0,0
"Türkiye","2024-10-29",0,0,0,0,0,0,0,0
"Türkiye","2024-10-30",0,0,0,0,0,0,0,0
"Türkiye","2024-10-31",0,0,0,0,0,0,0,0
"Türkiye","2024-11-01",0,0,0,0,0,0,0,0
"Türkiye","2024-11-02",0,0,0,0,0,0,0,0
"Türkiye","2024-11-03",0,0,0,0,0,0,0,0
"Türkiye","2024-11-04",0,0,0,0,0,0,0,0
"Türkiye","2024-11-05",0,0,0,0,0,0,0,0
"Türkiye","2024-11-06",0,0,0,0,0,0,0,0
"Türkiye","2024-11-07",0,0,0,0,0,0,0,0
"Türkiye","2024-11-08",0,0,0,0,0,0,0,0
"Türkiye","2024-11-09",0,0,0,0,0,0,0,0
"Türkiye","2024-11-10",0,0,0,0,0,0,0,0
"Türkiye","2024-11-11",0,0,0,0,0,0,0,0
"Türkiye","2024-11-12",0,0,0,0,0,0,0,0
"Türkiye","2024-11-13",0,0,0,0,0,0,0,0
"Türkiye","2024-11-14",0,0,0,0,0,0,0,0
"Türkiye","2024-11-15",0,0,0,0,0,0,0,0
"Türkiye","2024-11-16",0,0,0,0,0,0,0,0
"Türkiye","2024-11-17",0,0,0,0,0,0,0,0
"Türkiye","2024-11-18",0,0,0,0,0,0,0,0
"Türkiye","2024-11-19",0,0,0,0,0,0,0,0
"Türkiye","2024-11-20",0,0,0,0,0,0,0,0
"Türkiye","2024-11-21",0,0,0,0,0,0,0,0
"Türkiye","2024-11-22",0,0,0,0,0,0,0,0
"Türkiye","2024-11-23",0,0,0,0,0,0,0,0
"Türkiye","2024-11-24",0,0,0,0,0,0,0,0
"Türkiye","2024-11-25",0,0,0,0,0,0,0,0
"Türkiye","2024-11-26",0,0,0,0,0,0,0,0
"Türkiye","2024-11-27",0,0,0,0,0,0,0,0
"Türkiye","2024-11-28",0,0,0,0,0,0,0,0
"Türkiye","2024-11-29",0,0,0,0,0,0,0,0
"Türkiye","2024-11-30",0,0,0,0,0,0,0,0
"Türkiye","2024-12-01",0,0,0,0,0,0,0,0
"Türkiye","2024-12-02",0,0,0,0,0,0,0,0
"Türkiye","2024-12-03",0,0,0,0,0,0,0,0
"Türkiye","2024-12-04",0,0,0,0,0,0,0,0
"Türkiye","2024-12-05",0,0,0,0,0,0,0,0
"Türkiye","2024-12-06",0,0,0,0,0,0,0,0
"Türkiye","2024-12-07",0,0,0,0,0,0,0,0
"Türkiye","2024-12-08",0,0,0,0,0,0,0,0
"Türkiye","2024-12-09",0,0,0,0,0,0,0,0
"Uganda","2024-01-01",0,0,0,0,0,0,0,0
"Uganda","2024-01-02",0,0,0,0,0,0,0,0
"Uganda","2024-01-03",0,0,0,0,0,0,0,0
"Uganda","2024-01-04",0,0,0,0,0,0,0,0
"Uganda","2024-01-05",0,0,0,0,0,0,0,0
"Uganda","2024-01-06",0,0,0,0,0,0,0,0
"Uganda","2024-01-07",0,0,0,0,0,0,0,0
"Uganda","2024-01-08",0,0,0,0,0,0,0,0
"Uganda","2024-01-09",0,0,0,0,0,0,0,0
"Uganda","2024-01-10",0,0,0,0,0,0,0,0
"Uganda","2024-01-11",0,0,0,0,0,0,0,0
"Uganda","2024-01-12",0,0,0,0,0,0,0,0
"Uganda","2024-01-13",0,0,0,0,0,0,0,0
"Uganda","2024-01-14",0,0,0,0,0,0,0,0
"Uganda","2024-01-15",0,0,0,0,0,0,0,0
"Uganda","2024-01-16",0,0,0,0,0,0,0,0
"Uganda","2024-01-17",0,0,0,0,0,0,0,0
"Uganda","2024-01-18",0,0,0,0,0,0,0,0
"Uganda","2024-01-19",0,0,0,0,0,0,0,0
"Uganda","2024-01-20",0,0,0,0,0,0,0,0
"Uganda","2024-01-21",0,0,0,0,0,0,0,0
"Uganda","2024-01-22",0,0,0,0,0,0,0,0
"Uganda","2024-01-23",0,0,0,0,0,0,0,0
"Uganda","2024-01-24",0,0,0,0,0,0,0,0
"Uganda","2024-01-25",0,0,0,0,0,0,0,0
"Uganda","2024-01-26",0,0,0,0,0,0,0,0
"Uganda","2024-01-27",0,0,0,0,0,0,0,0
"Uganda","2024-01-28",0,0,0,0,0,0,0,0
"Uganda","2024-01-29",0,0,0,0,0,0,0,0
"Uganda","2024-01-30",0,0,0,0,0,0,0,0
"Uganda","2024-01-31",0,0,0,0,0,0,0,0
"Uganda","2024-02-01",0,0,0,0,0,0,0,0
"Uganda","2024-02-02",0,0,0,0,0,0,0,0
"Uganda","2024-02-03",0,0,0,0,0,0,0,0
"Uganda","2024-02-04",0,0,0,0,0,0,0,0
"Uganda","2024-02-05",0,0,0,0,0,0,0,0
"Uganda","2024-02-06",0,0,0,0,0,0,0,0
"Uganda","2024-02-07",0,0,0,0,0,0,0,0
"Uganda","2024-02-08",0,0,0,0,0,0,0,0
"Uganda","2024-02-09",0,0,0,0,0,0,0,0
"Uganda","2024-02-10",0,0,0,0,0,0,0,0
"Uganda","2024-02-11",0,0,0,0,0,0,0,0
"Uganda","2024-02-12",0,0,0,0,0,0,0,0
"Uganda","2024-02-13",0,0,0,0,0,0,0,0
"Uganda","2024-02-14",0,0,0,0,0,0,0,0
"Uganda","2024-02-15",0,0,0,0,0,0,0,0
"Uganda","2024-02-16",0,0,0,0,0,0,0,0
"Uganda","2024-02-17",0,0,0,0,0,0,0,0
"Uganda","2024-02-18",0,0,0,0,0,0,0,0
"Uganda","2024-02-19",0,0,0,0,0,0,0,0
"Uganda","2024-02-20",0,0,0,0,0,0,0,0
"Uganda","2024-02-21",0,0,0,0,0,0,0,0
"Uganda","2024-02-22",0,0,0,0,0,0,0,0
"Uganda","2024-02-23",0,0,0,0,0,0,0,0
"Uganda","2024-02-24",0,0,0,0,0,0,0,0
"Uganda","2024-02-25",0,0,0,0,0,0,0,0
"Uganda","2024-02-26",0,0,0,0,0,0,0,0
"Uganda","2024-02-27",0,0,0,0,0,0,0,0
"Uganda","2024-02-28",0,0,0,0,0,0,0,0
"Uganda","2024-02-29",0,0,0,0,0,0,0,0
"Uganda","2024-03-01",0,0,0,0,0,0,0,0
"Uganda","2024-03-02",0,0,0,0,0,0,0,0
"Uganda","2024-03-03",0,0,0,0,0,0,0,0
"Uganda","2024-03-04",0,0,0,0,0,0,0,0
"Uganda","2024-03-05",0,0,0,0,0,0,0,0
"Uganda","2024-03-06",0,0,0,0,0,0,0,0
"Uganda","2024-03-07",0,0,0,0,0,0,0,0
"Uganda","2024-03-08",0,0,0,0,0,0,0,0
"Uganda","2024-03-09",0,0,0,0,0,0,0,0
"Uganda","2024-03-10",0,0,0,0,0,0,0,0
"Uganda","2024-03-11",0,0,0,0,0,0,0,0
"Uganda","2024-03-12",0,0,0,0,0,0,0,0
"Uganda","2024-03-13",0,0,0,0,0,0,0,0
"Uganda","2024-03-14",0,0,0,0,0,0,0,0
"Uganda","2024-03-15",0,0,0,0,0,0,0,0
"Uganda","2024-03-16",0,0,0,0,0,0,0,0
"Uganda","2024-03-17",0,0,0,0,0,0,0,0
"Uganda","2024-03-18",0,0,0,0,0,0,0,0
"Uganda","2024-03-19",0,0,0,0,0,0,0,0
"Uganda","2024-03-20",0,0,0,0,0,0,0,0
"Uganda","2024-03-21",0,0,0,0,0,0,0,0
"Uganda","2024-03-22",0,0,0,0,0,0,0,0
"Uganda","2024-03-23",0,0,0,0,0,0,0,0
"Uganda","2024-03-24",0,0,0,0,0,0,0,0
"Uganda","2024-03-25",0,0,0,0,0,0,0,0
"Uganda","2024-03-26",0,0,0,0,0,0,0,0
"Uganda","2024-03-27",0,0,0,0,0,0,0,0
"Uganda","2024-03-28",0,0,0,0,0,0,0,0
"Uganda","2024-03-29",0,0,0,0,0,0,0,0
"Uganda","2024-03-30",0,0,0,0,0,0,0,0
"Uganda","2024-03-31",0,0,0,0,0,0,0,0
"Uganda","2024-04-01",0,0,0,0,0,0,0,0
"Uganda","2024-04-02",0,0,0,0,0,0,0,0
"Uganda","2024-04-03",0,0,0,0,0,0,0,0
"Uganda","2024-04-04",0,0,0,0,0,0,0,0
"Uganda","2024-04-05",0,0,0,0,0,0,0,0
"Uganda","2024-04-06",0,0,0,0,0,0,0,0
"Uganda","2024-04-07",0,0,0,0,0,0,0,0
"Uganda","2024-04-08",0,0,0,0,0,0,0,0
"Uganda","2024-04-09",0,0,0,0,0,0,0,0
"Uganda","2024-04-10",0,0,0,0,0,0,0,0
"Uganda","2024-04-11",0,0,0,0,0,0,0,0
"Uganda","2024-04-12",0,0,0,0,0,0,0,0
"Uganda","2024-04-13",0,0,0,0,0,0,0,0
"Uganda","2024-04-14",0,0,0,0,0,0,0,0
"Uganda","2024-04-15",0,0,0,0,0,0,0,0
"Uganda","2024-04-16",0,0,0,0,0,0,0,0
"Uganda","2024-04-17",0,0,0,0,0,0,0,0
"Uganda","2024-04-18",0,0,0,0,0,0,0,0
"Uganda","2024-04-19",0,0,0,0,0,0,0,0
"Uganda","2024-04-20",0,0,0,0,0,0,0,0
"Uganda","2024-04-21",0,0,0,0,0,0,0,0
"Uganda","2024-04-22",0,0,0,0,0,0,0,0
"Uganda","2024-04-23",0,0,0,0,0,0,0,0
"Uganda","2024-04-24",0,0,0,0,0,0,0,0
"Uganda","2024-04-25",0,0,0,0,0,0,0,0
"Uganda","2024-04-26",0,0,0,0,0,0,0,0
"Uganda","2024-04-27",0,0,0,0,0,0,0,0
"Uganda","2024-04-28",0,0,0,0,0,0,0,0
"Uganda","2024-04-29",0,0,0,0,0,0,0,0
"Uganda","2024-04-30",0,0,0,0,0,0,0,0
"Uganda","2024-05-01",0,0,0,0,0,0,0,0
"Uganda","2024-05-02",0,0,0,0,0,0,0,0
"Uganda","2024-05-03",0,0,0,0,0,0,0,0
"Uganda","2024-05-04",0,0,0,0,0,0,0,0
"Uganda","2024-05-05",0,0,0,0,0,0,0,0
"Uganda","2024-05-06",0,0,0,0,0,0,0,0
"Uganda","2024-05-07",0,0,0,0,0,0,0,0
"Uganda","2024-05-08",0,0,0,0,0,0,0,0
"Uganda","2024-05-09",0,0,0,0,0,0,0,0
"Uganda","2024-05-10",0,0,0,0,0,0,0,0
"Uganda","2024-05-11",0,0,0,0,0,0,0,0
"Uganda","2024-05-12",0,0,0,0,0,0,0,0
"Uganda","2024-05-13",0,0,0,0,0,0,0,0
"Uganda","2024-05-14",0,0,0,0,0,0,0,0
"Uganda","2024-05-15",0,0,0,0,0,0,0,0
"Uganda","2024-05-16",0,0,0,0,0,0,0,0
"Uganda","2024-05-17",0,0,0,0,0,0,0,0
"Uganda","2024-05-18",0,0,0,0,0,0,0,0
"Uganda","2024-05-19",0,0,0,0,0,0,0,0
"Uganda","2024-05-20",0,0,0,0,0,0,0,0
"Uganda","2024-05-21",0,0,0,0,0,0,0,0
"Uganda","2024-05-22",0,0,0,0,0,0,0,0
"Uganda","2024-05-23",0,0,0,0,0,0,0,0
"Uganda","2024-05-24",0,0,0,0,0,0,0,0
"Uganda","2024-05-25",0,0,0,0,0,0,0,0
"Uganda","2024-05-26",0,0,0,0,0,0,0,0
"Uganda","2024-05-27",0,0,0,0,0,0,0,0
"Uganda","2024-05-28",0,0,0,0,0,0,0,0
"Uganda","2024-05-29",0,0,0,0,0,0,0,0
"Uganda","2024-05-30",0,0,0,0,0,0,0,0
"Uganda","2024-05-31",0,0,0,0,0,0,0,0
"Uganda","2024-06-01",0,0,0,0,0,0,0,0
"Uganda","2024-06-02",0,0,0,0,0,0,0,0
"Uganda","2024-06-03",0,0,0,0,0,0,0,0
"Uganda","2024-06-04",0,0,0,0,0,0,0,0
"Uganda","2024-06-05",0,0,0,0,0,0,0,0
"Uganda","2024-06-06",0,0,0,0,0,0,0,0
"Uganda","2024-06-07",0,0,0,0,0,0,0,0
"Uganda","2024-06-08",0,0,0,0,0,0,0,0
"Uganda","2024-06-09",0,0,0,0,0,0,0,0
"Uganda","2024-06-10",0,0,0,0,0,0,0,0
"Uganda","2024-06-11",0,0,0,0,0,0,0,0
"Uganda","2024-06-12",0,0,0,0,0,0,0,0
"Uganda","2024-06-13",0,0,0,0,0,0,0,0
"Uganda","2024-06-14",0,0,0,0,0,0,0,0
"Uganda","2024-06-15",0,0,0,0,0,0,0,0
"Uganda","2024-06-16",0,0,0,0,0,0,0,0
"Uganda","2024-06-17",0,0,0,0,0,0,0,0
"Uganda","2024-06-18",0,0,0,0,0,0,0,0
"Uganda","2024-06-19",0,0,0,0,0,0,0,0
"Uganda","2024-06-20",0,0,0,0,0,0,0,0
"Uganda","2024-06-21",0,0,0,0,0,0,0,0
"Uganda","2024-06-22",0,0,0,0,0,0,0,0
"Uganda","2024-06-23",0,0,0,0,0,0,0,0
"Uganda","2024-06-24",0,0,0,0,0,0,0,0
"Uganda","2024-06-25",0,0,0,0,0,0,0,0
"Uganda","2024-06-26",0,0,0,0,0,0,0,0
"Uganda","2024-06-27",0,0,0,0,0,0,0,0
"Uganda","2024-06-28",0,0,0,0,0,0,0,0
"Uganda","2024-06-29",0,0,0,0,0,0,0,0
"Uganda","2024-06-30",0,0,0,0,0,0,0,0
"Uganda","2024-07-01",0,0,0,0,0,0,0,0
"Uganda","2024-07-02",0,0,0,0,0,0,0,0
"Uganda","2024-07-03",0,0,0,0,0,0,0,0
"Uganda","2024-07-04",0,0,0,0,0,0,0,0
"Uganda","2024-07-05",0,0,0,0,0,0,0,0
"Uganda","2024-07-06",0,0,0,0,0,0,0,0
"Uganda","2024-07-07",0,1,1,0,1,1,0,0
"Uganda","2024-07-08",0,0,1,0,0,1,0,0
"Uganda","2024-07-09",0,0,1,0,0,1,0,0
"Uganda","2024-07-10",0,0,1,0,0,1,0,0
"Uganda","2024-07-11",0,0,1,0,1,2,0,0
"Uganda","2024-07-12",0,0,1,0,0,2,0,0
"Uganda","2024-07-13",0,0,1,0,0,2,0,0
"Uganda","2024-07-14",0,1,2,0,0,2,0,0
"Uganda","2024-07-15",0,0,2,0,0,2,0,0
"Uganda","2024-07-16",0,0,2,0,0,2,0,0
"Uganda","2024-07-17",0,0,2,0,0,2,0,0
"Uganda","2024-07-18",0,0,2,0,0,2,0,0
"Uganda","2024-07-19",0,0,2,0,0,2,0,0
"Uganda","2024-07-20",0,0,2,0,0,2,0,0
"Uganda","2024-07-21",0,0,2,0,0,2,0,0
"Uganda","2024-07-22",0,0,2,0,0,2,0,0
"Uganda","2024-07-23",0,0,2,0,0,2,0,0
"Uganda","2024-07-24",0,0,2,0,0,2,0,0
"Uganda","2024-07-25",0,0,2,0,0,2,0,0
"Uganda","2024-07-26",0,0,2,0,0,2,0,0
"Uganda","2024-07-27",0,0,2,0,0,2,0,0
"Uganda","2024-07-28",0,0,2,0,0,2,0,0
"Uganda","2024-07-29",0,0,2,0,1,3,0,0
"Uganda","2024-07-30",0,0,2,0,0,3,0,0
"Uganda","2024-07-31",0,0,2,0,0,3,0,0
"Uganda","2024-08-01",0,0,2,0,0,3,0,0
"Uganda","2024-08-02",0,0,2,0,0,3,0,0
"Uganda","2024-08-03",0,0,2,0,0,3,0,0
"Uganda","2024-08-04",0,0,2,0,0,3,0,0
"Uganda","2024-08-05",0,0,2,0,0,3,0,0
"Uganda","2024-08-06",0,0,2,0,0,3,0,0
"Uganda","2024-08-07",0,0,2,0,0,3,0,0
"Uganda","2024-08-08",0,0,2,0,0,3,0,0
"Uganda","2024-08-09",0,0,2,0,0,3,0,0
"Uganda","2024-08-10",0,0,2,0,0,3,0,0
"Uganda","2024-08-11",0,1,3,0,0,3,0,0
"Uganda","2024-08-12",0,0,3,0,0,3,0,0
"Uganda","2024-08-13",0,0,3,0,1,4,0,0
"Uganda","2024-08-14",0,0,3,0,0,4,0,0
"Uganda","2024-08-15",0,0,3,0,0,4,0,0
"Uganda","2024-08-16",0,0,3,0,0,4,0,0
"Uganda","2024-08-17",0,0,3,0,1,5,0,0
"Uganda","2024-08-18",0,2,5,0,0,5,0,0
"Uganda","2024-08-19",0,0,5,0,1,6,0,0
"Uganda","2024-08-20",0,0,5,0,1,7,0,0
"Uganda","2024-08-21",0,0,5,0,1,8,0,0
"Uganda","2024-08-22",0,0,5,0,0,8,0,0
"Uganda","2024-08-23",0,0,5,0,1,9,0,0
"Uganda","2024-08-24",0,0,5,0,1,10,0,0
"Uganda","2024-08-25",0,6,11,0,1,11,0,0
"Uganda","2024-08-26",0,0,11,0,1,12,0,0
"Uganda","2024-08-27",0,0,11,0,0,12,0,0
"Uganda","2024-08-28",0,0,11,0,1,13,0,0
"Uganda","2024-08-29",0,0,11,0,0,13,0,0
"Uganda","2024-08-30",0,0,11,0,1,14,0,0
"Uganda","2024-08-31",0,0,11,0,0,14,0,0
"Uganda","2024-09-01",0,4,15,0,1,15,0,0
"Uganda","2024-09-02",0,0,15,0,1,16,0,0
"Uganda","2024-09-03",0,0,15,0,1,17,0,0
"Uganda","2024-09-04",0,0,15,0,1,18,0,0
"Uganda","2024-09-05",0,0,15,0,2,20,0,0
"Uganda","2024-09-06",0,0,15,0,1,21,0,0
"Uganda","2024-09-07",0,0,15,0,1,22,0,0
"Uganda","2024-09-08",0,8,23,0,1,23,0,0
"Uganda","2024-09-09",0,0,23,0,1,24,0,0
"Uganda","2024-09-10",0,0,23,0,1,25,0,0
"Uganda","2024-09-11",0,0,23,0,1,26,0,0
"Uganda","2024-09-12",0,0,23,0,0,26,0,0
"Uganda","2024-09-13",0,0,23,0,1,27,0,0
"Uganda","2024-09-14",0,0,23,0,1,28,0,0
"Uganda","2024-09-15",0,6,29,0,1,29,0,0
"Uganda","2024-09-16",0,0,29,0,1,30,0,0
"Uganda","2024-09-17",0,0,29,0,1,31,0,0
"Uganda","2024-09-18",0,0,29,0,1,32,0,0
"Uganda","2024-09-19",0,0,29,0,0,32,0,0
"Uganda","2024-09-20",0,0,29,0,1,33,0,0
"Uganda","2024-09-21",0,0,29,0,1,34,0,0
"Uganda","2024-09-22",0,6,35,0,1,35,0,0
"Uganda","2024-09-23",0,0,35,0,2,37,0,0
"Uganda","2024-09-24",0,0,35,0,2,39,0,0
"Uganda","2024-09-25",0,0,35,0,2,41,0,0
"Uganda","2024-09-26",0,0,35,0,2,43,0,0
"Uganda","2024-09-27",0,0,35,0,2,45,0,0
"Uganda","2024-09-28",0,0,35,0,2,47,0,0
"Uganda","2024-09-29",0,14,49,0,2,49,0,0
"Uganda","2024-09-30",0,0,49,0,3,52,0,0
"Uganda","2024-10-01",0,0,49,0,3,55,0,0
"Uganda","2024-10-02",0,0,49,0,3,58,0,0
"Uganda","2024-10-03",0,0,49,0,2,60,0,0
"Uganda","2024-10-04",0,0,49,0,3,63,0,0
"Uganda","2024-10-05",0,0,49,0,3,66,0,0
"Uganda","2024-10-06",0,20,69,0,3,69,0,0
"Uganda","2024-10-07",0,0,69,0,5,74,0,0
"Uganda","2024-10-08",0,0,69,0,6,80,0,0
"Uganda","2024-10-09",0,0,69,0,5,85,0,0
"Uganda","2024-10-10",0,0,69,0,5,90,0,0
"Uganda","2024-10-11",0,0,69,0,5,95,0,0
"Uganda","2024-10-12",0,0,69,0,6,101,0,0
"Uganda","2024-10-13",0,37,106,0,5,106,0,0
"Uganda","2024-10-14",0,0,106,0,7,113,0,0
"Uganda","2024-10-15",0,0,106,0,6,119,0,0
"Uganda","2024-10-16",0,0,106,0,7,126,0,0
"Uganda","2024-10-17",0,0,106,0,7,133,0,0
"Uganda","2024-10-18",0,0,106,0,7,140,0,0
"Uganda","2024-10-19",0,0,106,0,6,146,0,0
"Uganda","2024-10-20",0,47,153,0,7,153,0,0
"Uganda","2024-10-21",0,0,153,0,20,173,0,0
"Uganda","2024-10-22",0,0,153,0,19,192,0,0
"Uganda","2024-10-23",0,0,153,0,20,212,0,0
"Uganda","2024-10-24",0,0,153,0,19,231,0,0
"Uganda","2024-10-25",0,0,153,0,20,251,0,0
"Uganda","2024-10-26",0,0,153,0,19,270,0,0
"Uganda","2024-10-27",0,137,290,0,20,290,0,0
"Uganda","2024-10-28",0,0,290,0,14,304,0,0
"Uganda","2024-10-29",0,0,290,0,14,318,0,0
"Uganda","2024-10-30",0,0,290,0,14,332,0,0
"Uganda","2024-10-31",0,0,290,0,13,345,0,0
"Uganda","2024-11-01",0,0,290,0,14,359,0,0
"Uganda","2024-11-02",0,0,290,0,14,373,0,0
"Uganda","2024-11-03",0,97,387,0,14,387,0,0
"Uganda","2024-11-04",0,0,387,0,9,396,0,0
"Uganda","2024-11-05",0,0,387,0,10,406,0,0
"Uganda","2024-11-06",0,0,387,0,9,415,0,0
"Uganda","2024-11-07",0,0,387,0,9,424,0,0
"Uganda","2024-11-08",0,0,387,0,10,434,0,0
"Uganda","2024-11-09",0,56,443,0,9,443,0,0
"Uganda","2024-11-10",0,0,443,0,0,443,0,0
"Uganda","2024-11-11",0,0,443,0,0,443,0,0
"Uganda","2024-11-12",0,0,443,0,0,443,0,0
"Uganda","2024-11-13",0,0,443,0,0,443,0,0
"Uganda","2024-11-14",0,0,443,0,0,443,0,0
"Uganda","2024-11-15",0,0,443,0,0,443,0,0
"Uganda","2024-11-16",0,0,443,0,0,443,0,0
"Uganda","2024-11-17",0,0,443,0,0,443,0,0
"Uganda","2024-11-18",0,0,443,0,0,443,0,0
"Uganda","2024-11-19",0,0,443,0,0,443,0,0
"Uganda","2024-11-20",0,0,443,0,0,443,0,0
"Uganda","2024-11-21",0,0,443,0,0,443,0,0
"Uganda","2024-11-22",0,0,443,0,0,443,0,0
"Uganda","2024-11-23",0,0,443,0,0,443,0,0
"Uganda","2024-11-24",0,0,443,0,0,443,0,0
"Uganda","2024-11-25",0,0,443,0,0,443,0,0
"Uganda","2024-11-26",0,0,443,0,0,443,0,0
"Uganda","2024-11-27",0,0,443,0,0,443,0,0
"Uganda","2024-11-28",0,0,443,0,0,443,0,0
"Uganda","2024-11-29",0,0,443,0,0,443,0,0
"Uganda","2024-11-30",0,0,443,0,0,443,0,0
"Uganda","2024-12-01",0,0,443,0,0,443,0,0
"Uganda","2024-12-02",0,0,443,0,0,443,0,0
"Uganda","2024-12-03",0,0,443,0,0,443,0,0
"Uganda","2024-12-04",0,0,443,0,0,443,0,0
"Uganda","2024-12-05",0,0,443,0,0,443,0,0
"Uganda","2024-12-06",0,0,443,0,0,443,0,0
"Uganda","2024-12-07",0,0,443,0,0,443,0,0
"Uganda","2024-12-08",0,0,443,0,0,443,0,0
"Uganda","2024-12-09",0,0,443,0,0,443,0,0
"Ukraine","2024-01-01",0,0,0,0,0,0,0,0
"Ukraine","2024-01-02",0,0,0,0,0,0,0,0
"Ukraine","2024-01-03",0,0,0,0,0,0,0,0
"Ukraine","2024-01-04",0,0,0,0,0,0,0,0
"Ukraine","2024-01-05",0,0,0,0,0,0,0,0
"Ukraine","2024-01-06",0,0,0,0,0,0,0,0
"Ukraine","2024-01-07",0,0,0,0,0,0,0,0
"Ukraine","2024-01-08",0,0,0,0,0,0,0,0
"Ukraine","2024-01-09",0,0,0,0,0,0,0,0
"Ukraine","2024-01-10",0,0,0,0,0,0,0,0
"Ukraine","2024-01-11",0,0,0,0,0,0,0,0
"Ukraine","2024-01-12",0,0,0,0,0,0,0,0
"Ukraine","2024-01-13",0,0,0,0,0,0,0,0
"Ukraine","2024-01-14",0,0,0,0,0,0,0,0
"Ukraine","2024-01-15",0,0,0,0,0,0,0,0
"Ukraine","2024-01-16",0,0,0,0,0,0,0,0
"Ukraine","2024-01-17",0,0,0,0,0,0,0,0
"Ukraine","2024-01-18",0,0,0,0,0,0,0,0
"Ukraine","2024-01-19",0,0,0,0,0,0,0,0
"Ukraine","2024-01-20",0,0,0,0,0,0,0,0
"Ukraine","2024-01-21",0,0,0,0,0,0,0,0
"Ukraine","2024-01-22",0,0,0,0,0,0,0,0
"Ukraine","2024-01-23",0,0,0,0,0,0,0,0
"Ukraine","2024-01-24",0,0,0,0,0,0,0,0
"Ukraine","2024-01-25",0,0,0,0,0,0,0,0
"Ukraine","2024-01-26",0,0,0,0,0,0,0,0
"Ukraine","2024-01-27",0,0,0,0,0,0,0,0
"Ukraine","2024-01-28",0,0,0,0,0,0,0,0
"Ukraine","2024-01-29",0,0,0,0,0,0,0,0
"Ukraine","2024-01-30",0,0,0,0,0,0,0,0
"Ukraine","2024-01-31",0,0,0,0,0,0,0,0
"Ukraine","2024-02-01",0,0,0,0,0,0,0,0
"Ukraine","2024-02-02",0,0,0,0,0,0,0,0
"Ukraine","2024-02-03",0,0,0,0,0,0,0,0
"Ukraine","2024-02-04",0,0,0,0,0,0,0,0
"Ukraine","2024-02-05",0,0,0,0,0,0,0,0
"Ukraine","2024-02-06",0,0,0,0,0,0,0,0
"Ukraine","2024-02-07",0,0,0,0,0,0,0,0
"Ukraine","2024-02-08",0,0,0,0,0,0,0,0
"Ukraine","2024-02-09",0,0,0,0,0,0,0,0
"Ukraine","2024-02-10",0,0,0,0,0,0,0,0
"Ukraine","2024-02-11",0,0,0,0,0,0,0,0
"Ukraine","2024-02-12",0,0,0,0,0,0,0,0
"Ukraine","2024-02-13",0,0,0,0,0,0,0,0
"Ukraine","2024-02-14",0,0,0,0,0,0,0,0
"Ukraine","2024-02-15",0,0,0,0,0,0,0,0
"Ukraine","2024-02-16",0,0,0,0,0,0,0,0
"Ukraine","2024-02-17",0,0,0,0,0,0,0,0
"Ukraine","2024-02-18",0,0,0,0,0,0,0,0
"Ukraine","2024-02-19",0,0,0,0,0,0,0,0
"Ukraine","2024-02-20",0,0,0,0,0,0,0,0
"Ukraine","2024-02-21",0,0,0,0,0,0,0,0
"Ukraine","2024-02-22",0,0,0,0,0,0,0,0
"Ukraine","2024-02-23",0,0,0,0,0,0,0,0
"Ukraine","2024-02-24",0,0,0,0,0,0,0,0
"Ukraine","2024-02-25",0,0,0,0,0,0,0,0
"Ukraine","2024-02-26",0,0,0,0,0,0,0,0
"Ukraine","2024-02-27",0,0,0,0,0,0,0,0
"Ukraine","2024-02-28",0,0,0,0,0,0,0,0
"Ukraine","2024-02-29",0,0,0,0,0,0,0,0
"Ukraine","2024-03-01",0,0,0,0,0,0,0,0
"Ukraine","2024-03-02",0,0,0,0,0,0,0,0
"Ukraine","2024-03-03",0,0,0,0,0,0,0,0
"Ukraine","2024-03-04",0,0,0,0,0,0,0,0
"Ukraine","2024-03-05",0,0,0,0,0,0,0,0
"Ukraine","2024-03-06",0,0,0,0,0,0,0,0
"Ukraine","2024-03-07",0,0,0,0,0,0,0,0
"Ukraine","2024-03-08",0,0,0,0,0,0,0,0
"Ukraine","2024-03-09",0,0,0,0,0,0,0,0
"Ukraine","2024-03-10",0,0,0,0,0,0,0,0
"Ukraine","2024-03-11",0,0,0,0,0,0,0,0
"Ukraine","2024-03-12",0,0,0,0,0,0,0,0
"Ukraine","2024-03-13",0,0,0,0,0,0,0,0
"Ukraine","2024-03-14",0,0,0,0,0,0,0,0
"Ukraine","2024-03-15",0,0,0,0,0,0,0,0
"Ukraine","2024-03-16",0,0,0,0,0,0,0,0
"Ukraine","2024-03-17",0,0,0,0,0,0,0,0
"Ukraine","2024-03-18",0,0,0,0,0,0,0,0
"Ukraine","2024-03-19",0,0,0,0,0,0,0,0
"Ukraine","2024-03-20",0,0,0,0,0,0,0,0
"Ukraine","2024-03-21",0,0,0,0,0,0,0,0
"Ukraine","2024-03-22",0,0,0,0,0,0,0,0
"Ukraine","2024-03-23",0,0,0,0,0,0,0,0
"Ukraine","2024-03-24",0,0,0,0,0,0,0,0
"Ukraine","2024-03-25",0,0,0,0,0,0,0,0
"Ukraine","2024-03-26",0,0,0,0,0,0,0,0
"Ukraine","2024-03-27",0,0,0,0,0,0,0,0
"Ukraine","2024-03-28",0,0,0,0,0,0,0,0
"Ukraine","2024-03-29",0,0,0,0,0,0,0,0
"Ukraine","2024-03-30",0,0,0,0,0,0,0,0
"Ukraine","2024-03-31",0,0,0,0,0,0,0,0
"Ukraine","2024-04-01",0,0,0,0,0,0,0,0
"Ukraine","2024-04-02",0,0,0,0,0,0,0,0
"Ukraine","2024-04-03",0,0,0,0,0,0,0,0
"Ukraine","2024-04-04",0,0,0,0,0,0,0,0
"Ukraine","2024-04-05",0,0,0,0,0,0,0,0
"Ukraine","2024-04-06",0,0,0,0,0,0,0,0
"Ukraine","2024-04-07",0,0,0,0,0,0,0,0
"Ukraine","2024-04-08",0,0,0,0,0,0,0,0
"Ukraine","2024-04-09",0,0,0,0,0,0,0,0
"Ukraine","2024-04-10",0,0,0,0,0,0,0,0
"Ukraine","2024-04-11",0,0,0,0,0,0,0,0
"Ukraine","2024-04-12",0,0,0,0,0,0,0,0
"Ukraine","2024-04-13",0,0,0,0,0,0,0,0
"Ukraine","2024-04-14",0,0,0,0,0,0,0,0
"Ukraine","2024-04-15",0,0,0,0,0,0,0,0
"Ukraine","2024-04-16",0,0,0,0,0,0,0,0
"Ukraine","2024-04-17",0,0,0,0,0,0,0,0
"Ukraine","2024-04-18",0,0,0,0,0,0,0,0
"Ukraine","2024-04-19",0,0,0,0,0,0,0,0
"Ukraine","2024-04-20",0,0,0,0,0,0,0,0
"Ukraine","2024-04-21",0,0,0,0,0,0,0,0
"Ukraine","2024-04-22",0,0,0,0,0,0,0,0
"Ukraine","2024-04-23",0,0,0,0,0,0,0,0
"Ukraine","2024-04-24",0,0,0,0,0,0,0,0
"Ukraine","2024-04-25",0,0,0,0,0,0,0,0
"Ukraine","2024-04-26",0,0,0,0,0,0,0,0
"Ukraine","2024-04-27",0,0,0,0,0,0,0,0
"Ukraine","2024-04-28",0,0,0,0,0,0,0,0
"Ukraine","2024-04-29",0,0,0,0,0,0,0,0
"Ukraine","2024-04-30",0,0,0,0,0,0,0,0
"Ukraine","2024-05-01",0,0,0,0,0,0,0,0
"Ukraine","2024-05-02",0,0,0,0,0,0,0,0
"Ukraine","2024-05-03",0,0,0,0,0,0,0,0
"Ukraine","2024-05-04",0,0,0,0,0,0,0,0
"Ukraine","2024-05-05",0,0,0,0,0,0,0,0
"Ukraine","2024-05-06",0,0,0,0,0,0,0,0
"Ukraine","2024-05-07",0,0,0,0,0,0,0,0
"Ukraine","2024-05-08",0,0,0,0,0,0,0,0
"Ukraine","2024-05-09",0,0,0,0,0,0,0,0
"Ukraine","2024-05-10",0,0,0,0,0,0,0,0
"Ukraine","2024-05-11",0,0,0,0,0,0,0,0
"Ukraine","2024-05-12",0,0,0,0,0,0,0,0
"Ukraine","2024-05-13",0,0,0,0,0,0,0,0
"Ukraine","2024-05-14",0,0,0,0,0,0,0,0
"Ukraine","2024-05-15",0,0,0,0,0,0,0,0
"Ukraine","2024-05-16",0,0,0,0,0,0,0,0
"Ukraine","2024-05-17",0,0,0,0,0,0,0,0
"Ukraine","2024-05-18",0,0,0,0,0,0,0,0
"Ukraine","2024-05-19",0,0,0,0,0,0,0,0
"Ukraine","2024-05-20",0,0,0,0,0,0,0,0
"Ukraine","2024-05-21",0,0,0,0,0,0,0,0
"Ukraine","2024-05-22",0,0,0,0,0,0,0,0
"Ukraine","2024-05-23",0,0,0,0,0,0,0,0
"Ukraine","2024-05-24",0,0,0,0,0,0,0,0
"Ukraine","2024-05-25",0,0,0,0,0,0,0,0
"Ukraine","2024-05-26",0,0,0,0,0,0,0,0
"Ukraine","2024-05-27",0,0,0,0,0,0,0,0
"Ukraine","2024-05-28",0,0,0,0,0,0,0,0
"Ukraine","2024-05-29",0,0,0,0,0,0,0,0
"Ukraine","2024-05-30",0,0,0,0,0,0,0,0
"Ukraine","2024-05-31",0,0,0,0,0,0,0,0
"Ukraine","2024-06-01",0,0,0,0,0,0,0,0
"Ukraine","2024-06-02",0,0,0,0,0,0,0,0
"Ukraine","2024-06-03",0,0,0,0,0,0,0,0
"Ukraine","2024-06-04",0,0,0,0,0,0,0,0
"Ukraine","2024-06-05",0,0,0,0,0,0,0,0
"Ukraine","2024-06-06",0,0,0,0,0,0,0,0
"Ukraine","2024-06-07",0,0,0,0,0,0,0,0
"Ukraine","2024-06-08",0,0,0,0,0,0,0,0
"Ukraine","2024-06-09",0,0,0,0,0,0,0,0
"Ukraine","2024-06-10",0,0,0,0,0,0,0,0
"Ukraine","2024-06-11",0,0,0,0,0,0,0,0
"Ukraine","2024-06-12",0,0,0,0,0,0,0,0
"Ukraine","2024-06-13",0,0,0,0,0,0,0,0
"Ukraine","2024-06-14",0,0,0,0,0,0,0,0
"Ukraine","2024-06-15",0,0,0,0,0,0,0,0
"Ukraine","2024-06-16",0,0,0,0,0,0,0,0
"Ukraine","2024-06-17",0,0,0,0,0,0,0,0
"Ukraine","2024-06-18",0,0,0,0,0,0,0,0
"Ukraine","2024-06-19",0,0,0,0,0,0,0,0
"Ukraine","2024-06-20",0,0,0,0,0,0,0,0
"Ukraine","2024-06-21",0,0,0,0,0,0,0,0
"Ukraine","2024-06-22",0,0,0,0,0,0,0,0
"Ukraine","2024-06-23",0,0,0,0,0,0,0,0
"Ukraine","2024-06-24",0,0,0,0,0,0,0,0
"Ukraine","2024-06-25",0,0,0,0,0,0,0,0
"Ukraine","2024-06-26",0,0,0,0,0,0,0,0
"Ukraine","2024-06-27",0,0,0,0,0,0,0,0
"Ukraine","2024-06-28",0,0,0,0,0,0,0,0
"Ukraine","2024-06-29",0,0,0,0,0,0,0,0
"Ukraine","2024-06-30",0,0,0,0,0,0,0,0
"Ukraine","2024-07-01",0,0,0,0,0,0,0,0
"Ukraine","2024-07-02",0,0,0,0,0,0,0,0
"Ukraine","2024-07-03",0,0,0,0,0,0,0,0
"Ukraine","2024-07-04",0,0,0,0,0,0,0,0
"Ukraine","2024-07-05",0,0,0,0,0,0,0,0
"Ukraine","2024-07-06",0,0,0,0,0,0,0,0
"Ukraine","2024-07-07",0,0,0,0,0,0,0,0
"Ukraine","2024-07-08",0,0,0,0,0,0,0,0
"Ukraine","2024-07-09",0,0,0,0,0,0,0,0
"Ukraine","2024-07-10",0,0,0,0,0,0,0,0
"Ukraine","2024-07-11",0,0,0,0,0,0,0,0
"Ukraine","2024-07-12",0,0,0,0,0,0,0,0
"Ukraine","2024-07-13",0,0,0,0,0,0,0,0
"Ukraine","2024-07-14",0,0,0,0,0,0,0,0
"Ukraine","2024-07-15",0,0,0,0,0,0,0,0
"Ukraine","2024-07-16",0,0,0,0,0,0,0,0
"Ukraine","2024-07-17",0,0,0,0,0,0,0,0
"Ukraine","2024-07-18",0,0,0,0,0,0,0,0
"Ukraine","2024-07-19",0,0,0,0,0,0,0,0
"Ukraine","2024-07-20",0,0,0,0,0,0,0,0
"Ukraine","2024-07-21",0,0,0,0,0,0,0,0
"Ukraine","2024-07-22",0,0,0,0,0,0,0,0
"Ukraine","2024-07-23",0,0,0,0,0,0,0,0
"Ukraine","2024-07-24",0,0,0,0,0,0,0,0
"Ukraine","2024-07-25",0,0,0,0,0,0,0,0
"Ukraine","2024-07-26",0,0,0,0,0,0,0,0
"Ukraine","2024-07-27",0,0,0,0,0,0,0,0
"Ukraine","2024-07-28",0,0,0,0,0,0,0,0
"Ukraine","2024-07-29",0,0,0,0,0,0,0,0
"Ukraine","2024-07-30",0,0,0,0,0,0,0,0
"Ukraine","2024-07-31",0,0,0,0,0,0,0,0
"Ukraine","2024-08-01",0,0,0,0,0,0,0,0
"Ukraine","2024-08-02",0,0,0,0,0,0,0,0
"Ukraine","2024-08-03",0,0,0,0,0,0,0,0
"Ukraine","2024-08-04",0,0,0,0,0,0,0,0
"Ukraine","2024-08-05",0,0,0,0,0,0,0,0
"Ukraine","2024-08-06",0,0,0,0,0,0,0,0
"Ukraine","2024-08-07",0,0,0,0,0,0,0,0
"Ukraine","2024-08-08",0,0,0,0,0,0,0,0
"Ukraine","2024-08-09",0,0,0,0,0,0,0,0
"Ukraine","2024-08-10",0,0,0,0,0,0,0,0
"Ukraine","2024-08-11",0,0,0,0,0,0,0,0
"Ukraine","2024-08-12",0,0,0,0,0,0,0,0
"Ukraine","2024-08-13",0,0,0,0,0,0,0,0
"Ukraine","2024-08-14",0,0,0,0,0,0,0,0
"Ukraine","2024-08-15",0,0,0,0,0,0,0,0
"Ukraine","2024-08-16",0,0,0,0,0,0,0,0
"Ukraine","2024-08-17",0,0,0,0,0,0,0,0
"Ukraine","2024-08-18",0,0,0,0,0,0,0,0
"Ukraine","2024-08-19",0,0,0,0,0,0,0,0
"Ukraine","2024-08-20",0,0,0,0,0,0,0,0
"Ukraine","2024-08-21",0,0,0,0,0,0,0,0
"Ukraine","2024-08-22",0,0,0,0,0,0,0,0
"Ukraine","2024-08-23",0,0,0,0,0,0,0,0
"Ukraine","2024-08-24",0,0,0,0,0,0,0,0
"Ukraine","2024-08-25",0,0,0,0,0,0,0,0
"Ukraine","2024-08-26",0,0,0,0,0,0,0,0
"Ukraine","2024-08-27",0,0,0,0,0,0,0,0
"Ukraine","2024-08-28",0,0,0,0,0,0,0,0
"Ukraine","2024-08-29",0,0,0,0,0,0,0,0
"Ukraine","2024-08-30",0,0,0,0,0,0,0,0
"Ukraine","2024-08-31",0,0,0,0,0,0,0,0
"Ukraine","2024-09-01",0,0,0,0,0,0,0,0
"Ukraine","2024-09-02",0,0,0,0,0,0,0,0
"Ukraine","2024-09-03",0,0,0,0,0,0,0,0
"Ukraine","2024-09-04",0,0,0,0,0,0,0,0
"Ukraine","2024-09-05",0,0,0,0,0,0,0,0
"Ukraine","2024-09-06",0,0,0,0,0,0,0,0
"Ukraine","2024-09-07",0,0,0,0,0,0,0,0
"Ukraine","2024-09-08",0,0,0,0,0,0,0,0
"Ukraine","2024-09-09",0,0,0,0,0,0,0,0
"Ukraine","2024-09-10",0,0,0,0,0,0,0,0
"Ukraine","2024-09-11",0,0,0,0,0,0,0,0
"Ukraine","2024-09-12",0,0,0,0,0,0,0,0
"Ukraine","2024-09-13",0,0,0,0,0,0,0,0
"Ukraine","2024-09-14",0,0,0,0,0,0,0,0
"Ukraine","2024-09-15",0,0,0,0,0,0,0,0
"Ukraine","2024-09-16",0,0,0,0,0,0,0,0
"Ukraine","2024-09-17",0,0,0,0,0,0,0,0
"Ukraine","2024-09-18",0,0,0,0,0,0,0,0
"Ukraine","2024-09-19",0,0,0,0,0,0,0,0
"Ukraine","2024-09-20",0,0,0,0,0,0,0,0
"Ukraine","2024-09-21",0,0,0,0,0,0,0,0
"Ukraine","2024-09-22",0,0,0,0,0,0,0,0
"Ukraine","2024-09-23",0,0,0,0,0,0,0,0
"Ukraine","2024-09-24",0,0,0,0,0,0,0,0
"Ukraine","2024-09-25",0,0,0,0,0,0,0,0
"Ukraine","2024-09-26",0,0,0,0,0,0,0,0
"Ukraine","2024-09-27",0,0,0,0,0,0,0,0
"Ukraine","2024-09-28",0,0,0,0,0,0,0,0
"Ukraine","2024-09-29",0,0,0,0,0,0,0,0
"Ukraine","2024-09-30",0,0,0,0,0,0,0,0
"Ukraine","2024-10-01",0,0,0,0,0,0,0,0
"Ukraine","2024-10-02",0,0,0,0,0,0,0,0
"Ukraine","2024-10-03",0,0,0,0,0,0,0,0
"Ukraine","2024-10-04",0,0,0,0,0,0,0,0
"Ukraine","2024-10-05",0,0,0,0,0,0,0,0
"Ukraine","2024-10-06",0,0,0,0,0,0,0,0
"Ukraine","2024-10-07",0,0,0,0,0,0,0,0
"Ukraine","2024-10-08",0,0,0,0,0,0,0,0
"Ukraine","2024-10-09",0,0,0,0,0,0,0,0
"Ukraine","2024-10-10",0,0,0,0,0,0,0,0
"Ukraine","2024-10-11",0,0,0,0,0,0,0,0
"Ukraine","2024-10-12",0,0,0,0,0,0,0,0
"Ukraine","2024-10-13",0,0,0,0,0,0,0,0
"Ukraine","2024-10-14",0,0,0,0,0,0,0,0
"Ukraine","2024-10-15",0,0,0,0,0,0,0,0
"Ukraine","2024-10-16",0,0,0,0,0,0,0,0
"Ukraine","2024-10-17",0,0,0,0,0,0,0,0
"Ukraine","2024-10-18",0,0,0,0,0,0,0,0
"Ukraine","2024-10-19",0,0,0,0,0,0,0,0
"Ukraine","2024-10-20",0,0,0,0,0,0,0,0
"Ukraine","2024-10-21",0,0,0,0,0,0,0,0
"Ukraine","2024-10-22",0,0,0,0,0,0,0,0
"Ukraine","2024-10-23",0,0,0,0,0,0,0,0
"Ukraine","2024-10-24",0,0,0,0,0,0,0,0
"Ukraine","2024-10-25",0,0,0,0,0,0,0,0
"Ukraine","2024-10-26",0,0,0,0,0,0,0,0
"Ukraine","2024-10-27",0,0,0,0,0,0,0,0
"Ukraine","2024-10-28",0,0,0,0,0,0,0,0
"Ukraine","2024-10-29",0,0,0,0,0,0,0,0
"Ukraine","2024-10-30",0,0,0,0,0,0,0,0
"Ukraine","2024-10-31",0,0,0,0,0,0,0,0
"Ukraine","2024-11-01",0,0,0,0,0,0,0,0
"Ukraine","2024-11-02",0,0,0,0,0,0,0,0
"Ukraine","2024-11-03",0,0,0,0,0,0,0,0
"Ukraine","2024-11-04",0,0,0,0,0,0,0,0
"Ukraine","2024-11-05",0,0,0,0,0,0,0,0
"Ukraine","2024-11-06",0,0,0,0,0,0,0,0
"Ukraine","2024-11-07",0,0,0,0,0,0,0,0
"Ukraine","2024-11-08",0,0,0,0,0,0,0,0
"Ukraine","2024-11-09",0,0,0,0,0,0,0,0
"Ukraine","2024-11-10",0,0,0,0,0,0,0,0
"Ukraine","2024-11-11",0,0,0,0,0,0,0,0
"Ukraine","2024-11-12",0,0,0,0,0,0,0,0
"Ukraine","2024-11-13",0,0,0,0,0,0,0,0
"Ukraine","2024-11-14",0,0,0,0,0,0,0,0
"Ukraine","2024-11-15",0,0,0,0,0,0,0,0
"Ukraine","2024-11-16",0,0,0,0,0,0,0,0
"Ukraine","2024-11-17",0,0,0,0,0,0,0,0
"Ukraine","2024-11-18",0,0,0,0,0,0,0,0
"Ukraine","2024-11-19",0,0,0,0,0,0,0,0
"Ukraine","2024-11-20",0,0,0,0,0,0,0,0
"Ukraine","2024-11-21",0,0,0,0,0,0,0,0
"Ukraine","2024-11-22",0,0,0,0,0,0,0,0
"Ukraine","2024-11-23",0,0,0,0,0,0,0,0
"Ukraine","2024-11-24",0,0,0,0,0,0,0,0
"Ukraine","2024-11-25",0,0,0,0,0,0,0,0
"Ukraine","2024-11-26",0,0,0,0,0,0,0,0
"Ukraine","2024-11-27",0,0,0,0,0,0,0,0
"Ukraine","2024-11-28",0,0,0,0,0,0,0,0
"Ukraine","2024-11-29",0,0,0,0,0,0,0,0
"Ukraine","2024-11-30",0,0,0,0,0,0,0,0
"Ukraine","2024-12-01",0,0,0,0,0,0,0,0
"Ukraine","2024-12-02",0,0,0,0,0,0,0,0
"Ukraine","2024-12-03",0,0,0,0,0,0,0,0
"Ukraine","2024-12-04",0,0,0,0,0,0,0,0
"Ukraine","2024-12-05",0,0,0,0,0,0,0,0
"Ukraine","2024-12-06",0,0,0,0,0,0,0,0
"Ukraine","2024-12-07",0,0,0,0,0,0,0,0
"Ukraine","2024-12-08",0,0,0,0,0,0,0,0
"Ukraine","2024-12-09",0,0,0,0,0,0,0,0
"United Arab Emirates","2024-01-01",0,0,0,0,0,0,0,0
"United Arab Emirates","2024-01-02",0,0,0,0,0,0,0,0
"United Arab Emirates","2024-01-03",0,0,0,0,0,0,0,0
"United Arab Emirates","2024-01-04",0,0,0,0,0,0,0,0
"United Arab Emirates","2024-01-05",0,0,0,0,0,0,0,0
"United Arab Emirates","2024-01-06",0,0,0,0,0,0,0,0
"United Arab Emirates","2024-01-07",0,0,0,0,0,0,0,0
"United Arab Emirates","2024-01-08",0,0,0,0,0,0,0,0
"United Arab Emirates","2024-01-09",0,0,0,0,0,0,0,0
"United Arab Emirates","2024-01-10",0,0,0,0,0,0,0,0
"United Arab Emirates","2024-01-11",0,1,1,0,1,1,0,0
"United Arab Emirates","2024-01-12",0,0,1,0,0,1,0,0
"United Arab Emirates","2024-01-13",0,0,1,0,0,1,0,0
"United Arab Emirates","2024-01-14",0,0,1,0,0,1,0,0
"United Arab Emirates","2024-01-15",0,0,1,0,0,1,0,0
"United Arab Emirates","2024-01-16",0,0,1,0,0,1,0,0
"United Arab Emirates","2024-01-17",0,0,1,0,0,1,0,0
"United Arab Emirates","2024-01-18",0,0,1,0,0,1,0,0
"United Arab Emirates","2024-01-19",0,0,1,0,0,1,0,0
"United Arab Emirates","2024-01-20",0,0,1,0,0,1,0,0
"United Arab Emirates","2024-01-21",0,0,1,0,0,1,0,0
"United Arab Emirates","2024-01-22",0,0,1,0,0,1,0,0
"United Arab Emirates","2024-01-23",0,0,1,0,0,1,0,0
"United Arab Emirates","2024-01-24",0,0,1,0,0,1,0,0
"United Arab Emirates","2024-01-25",0,0,1,0,0,1,0,0
"United Arab Emirates","2024-01-26",0,0,1,0,0,1,0,0
"United Arab Emirates","2024-01-27",0,0,1,0,0,1,0,0
"United Arab Emirates","2024-01-28",0,0,1,0,0,1,0,0
"United Arab Emirates","2024-01-29",0,0,1,0,0,1,0,0
"United Arab Emirates","2024-01-30",0,0,1,0,0,1,0,0
"United Arab Emirates","2024-01-31",0,0,1,0,0,1,0,0
"United Arab Emirates","2024-02-01",0,0,1,0,0,1,0,0
"United Arab Emirates","2024-02-02",0,0,1,0,0,1,0,0
"United Arab Emirates","2024-02-03",0,0,1,0,0,1,0,0
"United Arab Emirates","2024-02-04",0,0,1,0,0,1,0,0
"United Arab Emirates","2024-02-05",0,0,1,0,0,1,0,0
"United Arab Emirates","2024-02-06",0,0,1,0,1,2,0,0
"United Arab Emirates","2024-02-07",0,0,1,0,0,2,0,0
"United Arab Emirates","2024-02-08",0,0,1,0,0,2,0,0
"United Arab Emirates","2024-02-09",0,0,1,0,0,2,0,0
"United Arab Emirates","2024-02-10",0,0,1,0,0,2,0,0
"United Arab Emirates","2024-02-11",0,0,1,0,0,2,0,0
"United Arab Emirates","2024-02-12",0,0,1,0,0,2,0,0
"United Arab Emirates","2024-02-13",0,0,1,0,0,2,0,0
"United Arab Emirates","2024-02-14",0,0,1,0,0,2,0,0
"United Arab Emirates","2024-02-15",0,0,1,0,0,2,0,0
"United Arab Emirates","2024-02-16",0,0,1,0,0,2,0,0
"United Arab Emirates","2024-02-17",0,0,1,0,0,2,0,0
"United Arab Emirates","2024-02-18",0,0,1,0,0,2,0,0
"United Arab Emirates","2024-02-19",0,0,1,0,0,2,0,0
"United Arab Emirates","2024-02-20",0,0,1,0,0,2,0,0
"United Arab Emirates","2024-02-21",0,0,1,0,0,2,0,0
"United Arab Emirates","2024-02-22",0,0,1,0,0,2,0,0
"United Arab Emirates","2024-02-23",0,0,1,0,0,2,0,0
"United Arab Emirates","2024-02-24",0,0,1,0,0,2,0,0
"United Arab Emirates","2024-02-25",0,0,1,0,0,2,0,0
"United Arab Emirates","2024-02-26",0,0,1,0,0,2,0,0
"United Arab Emirates","2024-02-27",0,0,1,0,0,2,0,0
"United Arab Emirates","2024-02-28",0,0,1,0,0,2,0,0
"United Arab Emirates","2024-02-29",0,0,1,0,0,2,0,0
"United Arab Emirates","2024-03-01",0,0,1,0,0,2,0,0
"United Arab Emirates","2024-03-02",0,1,2,0,0,2,0,0
"United Arab Emirates","2024-03-03",0,0,2,0,0,2,0,0
"United Arab Emirates","2024-03-04",0,0,2,0,0,2,0,0
"United Arab Emirates","2024-03-05",0,0,2,0,0,2,0,0
"United Arab Emirates","2024-03-06",0,0,2,0,0,2,0,0
"United Arab Emirates","2024-03-07",0,0,2,0,0,2,0,0
"United Arab Emirates","2024-03-08",0,0,2,0,0,2,0,0
"United Arab Emirates","2024-03-09",0,0,2,0,0,2,0,0
"United Arab Emirates","2024-03-10",0,0,2,0,0,2,0,0
"United Arab Emirates","2024-03-11",0,0,2,0,0,2,0,0
"United Arab Emirates","2024-03-12",0,0,2,0,0,2,0,0
"United Arab Emirates","2024-03-13",0,0,2,0,0,2,0,0
"United Arab Emirates","2024-03-14",0,0,2,0,0,2,0,0
"United Arab Emirates","2024-03-15",0,0,2,0,0,2,0,0
"United Arab Emirates","2024-03-16",0,0,2,0,0,2,0,0
"United Arab Emirates","2024-03-17",0,0,2,0,0,2,0,0
"United Arab Emirates","2024-03-18",0,0,2,0,0,2,0,0
"United Arab Emirates","2024-03-19",0,0,2,0,0,2,0,0
"United Arab Emirates","2024-03-20",0,0,2,0,0,2,0,0
"United Arab Emirates","2024-03-21",0,0,2,0,0,2,0,0
"United Arab Emirates","2024-03-22",0,0,2,0,0,2,0,0
"United Arab Emirates","2024-03-23",0,0,2,0,0,2,0,0
"United Arab Emirates","2024-03-24",0,0,2,0,0,2,0,0
"United Arab Emirates","2024-03-25",0,0,2,0,0,2,0,0
"United Arab Emirates","2024-03-26",0,0,2,0,0,2,0,0
"United Arab Emirates","2024-03-27",0,0,2,0,1,3,0,0
"United Arab Emirates","2024-03-28",0,0,2,0,0,3,0,0
"United Arab Emirates","2024-03-29",0,0,2,0,0,3,0,0
"United Arab Emirates","2024-03-30",0,0,2,0,0,3,0,0
"United Arab Emirates","2024-03-31",0,0,2,0,0,3,0,0
"United Arab Emirates","2024-04-01",0,0,2,0,0,3,0,0
"United Arab Emirates","2024-04-02",0,0,2,0,0,3,0,0
"United Arab Emirates","2024-04-03",0,0,2,0,0,3,0,0
"United Arab Emirates","2024-04-04",0,0,2,0,0,3,0,0
"United Arab Emirates","2024-04-05",0,0,2,0,0,3,0,0
"United Arab Emirates","2024-04-06",0,0,2,0,0,3,0,0
"United Arab Emirates","2024-04-07",0,0,2,0,0,3,0,0
"United Arab Emirates","2024-04-08",0,0,2,0,0,3,0,0
"United Arab Emirates","2024-04-09",0,0,2,0,0,3,0,0
"United Arab Emirates","2024-04-10",0,0,2,0,0,3,0,0
"United Arab Emirates","2024-04-11",0,0,2,0,0,3,0,0
"United Arab Emirates","2024-04-12",0,0,2,0,0,3,0,0
"United Arab Emirates","2024-04-13",0,0,2,0,0,3,0,0
"United Arab Emirates","2024-04-14",0,0,2,0,0,3,0,0
"United Arab Emirates","2024-04-15",0,0,2,0,0,3,0,0
"United Arab Emirates","2024-04-16",0,0,2,0,0,3,0,0
"United Arab Emirates","2024-04-17",0,0,2,0,0,3,0,0
"United Arab Emirates","2024-04-18",0,0,2,0,0,3,0,0
"United Arab Emirates","2024-04-19",0,0,2,0,0,3,0,0
"United Arab Emirates","2024-04-20",0,1,3,0,0,3,0,0
"United Arab Emirates","2024-04-21",0,0,3,0,0,3,0,0
"United Arab Emirates","2024-04-22",0,0,3,0,0,3,0,0
"United Arab Emirates","2024-04-23",0,0,3,0,0,3,0,0
"United Arab Emirates","2024-04-24",0,0,3,0,0,3,0,0
"United Arab Emirates","2024-04-25",0,0,3,0,0,3,0,0
"United Arab Emirates","2024-04-26",0,0,3,0,0,3,0,0
"United Arab Emirates","2024-04-27",0,0,3,0,0,3,0,0
"United Arab Emirates","2024-04-28",0,0,3,0,0,3,0,0
"United Arab Emirates","2024-04-29",0,0,3,0,0,3,0,0
"United Arab Emirates","2024-04-30",0,0,3,0,0,3,0,0
"United Arab Emirates","2024-05-01",0,0,3,0,0,3,0,0
"United Arab Emirates","2024-05-02",0,0,3,0,0,3,0,0
"United Arab Emirates","2024-05-03",0,0,3,0,0,3,0,0
"United Arab Emirates","2024-05-04",0,0,3,0,0,3,0,0
"United Arab Emirates","2024-05-05",0,0,3,0,0,3,0,0
"United Arab Emirates","2024-05-06",0,0,3,0,0,3,0,0
"United Arab Emirates","2024-05-07",0,0,3,0,0,3,0,0
"United Arab Emirates","2024-05-08",0,0,3,0,0,3,0,0
"United Arab Emirates","2024-05-09",0,0,3,0,0,3,0,0
"United Arab Emirates","2024-05-10",0,0,3,0,0,3,0,0
"United Arab Emirates","2024-05-11",0,0,3,0,0,3,0,0
"United Arab Emirates","2024-05-12",0,0,3,0,0,3,0,0
"United Arab Emirates","2024-05-13",0,0,3,0,0,3,0,0
"United Arab Emirates","2024-05-14",0,0,3,0,0,3,0,0
"United Arab Emirates","2024-05-15",0,0,3,0,0,3,0,0
"United Arab Emirates","2024-05-16",0,0,3,0,0,3,0,0
"United Arab Emirates","2024-05-17",0,0,3,0,0,3,0,0
"United Arab Emirates","2024-05-18",0,0,3,0,0,3,0,0
"United Arab Emirates","2024-05-19",0,0,3,0,0,3,0,0
"United Arab Emirates","2024-05-20",0,0,3,0,0,3,0,0
"United Arab Emirates","2024-05-21",0,0,3,0,0,3,0,0
"United Arab Emirates","2024-05-22",0,0,3,0,0,3,0,0
"United Arab Emirates","2024-05-23",0,0,3,0,0,3,0,0
"United Arab Emirates","2024-05-24",0,0,3,0,0,3,0,0
"United Arab Emirates","2024-05-25",0,0,3,0,0,3,0,0
"United Arab Emirates","2024-05-26",0,0,3,0,0,3,0,0
"United Arab Emirates","2024-05-27",0,0,3,0,0,3,0,0
"United Arab Emirates","2024-05-28",0,0,3,0,0,3,0,0
"United Arab Emirates","2024-05-29",0,0,3,0,0,3,0,0
"United Arab Emirates","2024-05-30",0,0,3,0,0,3,0,0
"United Arab Emirates","2024-05-31",0,0,3,0,0,3,0,0
"United Arab Emirates","2024-06-01",0,0,3,0,0,3,0,0
"United Arab Emirates","2024-06-02",0,0,3,0,0,3,0,0
"United Arab Emirates","2024-06-03",0,0,3,0,0,3,0,0
"United Arab Emirates","2024-06-04",0,0,3,0,0,3,0,0
"United Arab Emirates","2024-06-05",0,0,3,0,0,3,0,0
"United Arab Emirates","2024-06-06",0,0,3,0,0,3,0,0
"United Arab Emirates","2024-06-07",0,0,3,0,0,3,0,0
"United Arab Emirates","2024-06-08",0,0,3,0,0,3,0,0
"United Arab Emirates","2024-06-09",0,0,3,0,0,3,0,0
"United Arab Emirates","2024-06-10",0,0,3,0,0,3,0,0
"United Arab Emirates","2024-06-11",0,0,3,0,0,3,0,0
"United Arab Emirates","2024-06-12",0,0,3,0,0,3,0,0
"United Arab Emirates","2024-06-13",0,0,3,0,0,3,0,0
"United Arab Emirates","2024-06-14",0,0,3,0,0,3,0,0
"United Arab Emirates","2024-06-15",0,0,3,0,0,3,0,0
"United Arab Emirates","2024-06-16",0,0,3,0,0,3,0,0
"United Arab Emirates","2024-06-17",0,0,3,0,0,3,0,0
"United Arab Emirates","2024-06-18",0,0,3,0,0,3,0,0
"United Arab Emirates","2024-06-19",0,0,3,0,0,3,0,0
"United Arab Emirates","2024-06-20",0,0,3,0,0,3,0,0
"United Arab Emirates","2024-06-21",0,0,3,0,0,3,0,0
"United Arab Emirates","2024-06-22",0,0,3,0,0,3,0,0
"United Arab Emirates","2024-06-23",0,0,3,0,0,3,0,0
"United Arab Emirates","2024-06-24",0,0,3,0,0,3,0,0
"United Arab Emirates","2024-06-25",0,0,3,0,0,3,0,0
"United Arab Emirates","2024-06-26",0,0,3,0,0,3,0,0
"United Arab Emirates","2024-06-27",0,0,3,0,0,3,0,0
"United Arab Emirates","2024-06-28",0,0,3,0,0,3,0,0
"United Arab Emirates","2024-06-29",0,0,3,0,0,3,0,0
"United Arab Emirates","2024-06-30",0,0,3,0,0,3,0,0
"United Arab Emirates","2024-07-01",0,0,3,0,0,3,0,0
"United Arab Emirates","2024-07-02",0,0,3,0,0,3,0,0
"United Arab Emirates","2024-07-03",0,0,3,0,0,3,0,0
"United Arab Emirates","2024-07-04",0,0,3,0,0,3,0,0
"United Arab Emirates","2024-07-05",0,0,3,0,0,3,0,0
"United Arab Emirates","2024-07-06",0,0,3,0,0,3,0,0
"United Arab Emirates","2024-07-07",0,0,3,0,0,3,0,0
"United Arab Emirates","2024-07-08",0,0,3,0,0,3,0,0
"United Arab Emirates","2024-07-09",0,0,3,0,0,3,0,0
"United Arab Emirates","2024-07-10",0,0,3,0,0,3,0,0
"United Arab Emirates","2024-07-11",0,0,3,0,1,4,0,0
"United Arab Emirates","2024-07-12",0,0,3,0,0,4,0,0
"United Arab Emirates","2024-07-13",0,0,3,0,0,4,0,0
"United Arab Emirates","2024-07-14",0,0,3,0,0,4,0,0
"United Arab Emirates","2024-07-15",0,0,3,0,0,4,0,0
"United Arab Emirates","2024-07-16",0,0,3,0,0,4,0,0
"United Arab Emirates","2024-07-17",0,0,3,0,0,4,0,0
"United Arab Emirates","2024-07-18",0,0,3,0,0,4,0,0
"United Arab Emirates","2024-07-19",0,0,3,0,0,4,0,0
"United Arab Emirates","2024-07-20",0,0,3,0,0,4,0,0
"United Arab Emirates","2024-07-21",0,0,3,0,0,4,0,0
"United Arab Emirates","2024-07-22",0,0,3,0,0,4,0,0
"United Arab Emirates","2024-07-23",0,0,3,0,0,4,0,0
"United Arab Emirates","2024-07-24",0,0,3,0,0,4,0,0
"United Arab Emirates","2024-07-25",0,0,3,0,0,4,0,0
"United Arab Emirates","2024-07-26",0,0,3,0,0,4,0,0
"United Arab Emirates","2024-07-27",0,0,3,0,0,4,0,0
"United Arab Emirates","2024-07-28",0,0,3,0,0,4,0,0
"United Arab Emirates","2024-07-29",0,0,3,0,0,4,0,0
"United Arab Emirates","2024-07-30",0,0,3,0,0,4,0,0
"United Arab Emirates","2024-07-31",0,0,3,0,0,4,0,0
"United Arab Emirates","2024-08-01",0,0,3,0,0,4,0,0
"United Arab Emirates","2024-08-02",0,0,3,0,0,4,0,0
"United Arab Emirates","2024-08-03",0,0,3,0,0,4,0,0
"United Arab Emirates","2024-08-04",0,0,3,0,0,4,0,0
"United Arab Emirates","2024-08-05",0,0,3,0,0,4,0,0
"United Arab Emirates","2024-08-06",0,0,3,0,0,4,0,0
"United Arab Emirates","2024-08-07",0,0,3,0,0,4,0,0
"United Arab Emirates","2024-08-08",0,0,3,0,0,4,0,0
"United Arab Emirates","2024-08-09",0,0,3,0,0,4,0,0
"United Arab Emirates","2024-08-10",0,0,3,0,0,4,0,0
"United Arab Emirates","2024-08-11",0,0,3,0,0,4,0,0
"United Arab Emirates","2024-08-12",0,0,3,0,0,4,0,0
"United Arab Emirates","2024-08-13",0,0,3,0,0,4,0,0
"United Arab Emirates","2024-08-14",0,0,3,0,0,4,0,0
"United Arab Emirates","2024-08-15",0,0,3,0,0,4,0,0
"United Arab Emirates","2024-08-16",0,0,3,0,0,4,0,0
"United Arab Emirates","2024-08-17",0,0,3,0,0,4,0,0
"United Arab Emirates","2024-08-18",0,0,3,0,0,4,0,0
"United Arab Emirates","2024-08-19",0,0,3,0,0,4,0,0
"United Arab Emirates","2024-08-20",0,0,3,0,0,4,0,0
"United Arab Emirates","2024-08-21",0,0,3,0,0,4,0,0
"United Arab Emirates","2024-08-22",0,0,3,0,0,4,0,0
"United Arab Emirates","2024-08-23",0,0,3,0,0,4,0,0
"United Arab Emirates","2024-08-24",0,0,3,0,0,4,0,0
"United Arab Emirates","2024-08-25",0,0,3,0,0,4,0,0
"United Arab Emirates","2024-08-26",0,0,3,0,0,4,0,0
"United Arab Emirates","2024-08-27",0,0,3,0,0,4,0,0
"United Arab Emirates","2024-08-28",0,0,3,0,0,4,0,0
"United Arab Emirates","2024-08-29",0,0,3,0,0,4,0,0
"United Arab Emirates","2024-08-30",0,0,3,0,0,4,0,0
"United Arab Emirates","2024-08-31",0,0,3,0,0,4,0,0
"United Arab Emirates","2024-09-01",0,0,3,0,0,4,0,0
"United Arab Emirates","2024-09-02",0,0,3,0,0,4,0,0
"United Arab Emirates","2024-09-03",0,0,3,0,0,4,0,0
"United Arab Emirates","2024-09-04",0,0,3,0,0,4,0,0
"United Arab Emirates","2024-09-05",0,0,3,0,0,4,0,0
"United Arab Emirates","2024-09-06",0,0,3,0,0,4,0,0
"United Arab Emirates","2024-09-07",0,0,3,0,0,4,0,0
"United Arab Emirates","2024-09-08",0,0,3,0,0,4,0,0
"United Arab Emirates","2024-09-09",0,0,3,0,0,4,0,0
"United Arab Emirates","2024-09-10",0,0,3,0,0,4,0,0
"United Arab Emirates","2024-09-11",0,0,3,0,0,4,0,0
"United Arab Emirates","2024-09-12",0,0,3,0,0,4,0,0
"United Arab Emirates","2024-09-13",0,0,3,0,0,4,0,0
"United Arab Emirates","2024-09-14",0,0,3,0,0,4,0,0
"United Arab Emirates","2024-09-15",0,0,3,0,0,4,0,0
"United Arab Emirates","2024-09-16",0,0,3,0,0,4,0,0
"United Arab Emirates","2024-09-17",0,0,3,0,0,4,0,0
"United Arab Emirates","2024-09-18",0,0,3,0,0,4,0,0
"United Arab Emirates","2024-09-19",0,0,3,0,0,4,0,0
"United Arab Emirates","2024-09-20",0,0,3,0,0,4,0,0
"United Arab Emirates","2024-09-21",0,0,3,0,0,4,0,0
"United Arab Emirates","2024-09-22",0,0,3,0,0,4,0,0
"United Arab Emirates","2024-09-23",0,0,3,0,0,4,0,0
"United Arab Emirates","2024-09-24",0,0,3,0,0,4,0,0
"United Arab Emirates","2024-09-25",0,0,3,0,0,4,0,0
"United Arab Emirates","2024-09-26",0,0,3,0,0,4,0,0
"United Arab Emirates","2024-09-27",0,0,3,0,0,4,0,0
"United Arab Emirates","2024-09-28",0,0,3,0,0,4,0,0
"United Arab Emirates","2024-09-29",0,0,3,0,0,4,0,0
"United Arab Emirates","2024-09-30",0,1,4,0,0,4,0,0
"United Arab Emirates","2024-10-01",0,0,4,0,0,4,0,0
"United Arab Emirates","2024-10-02",0,0,4,0,0,4,0,0
"United Arab Emirates","2024-10-03",0,0,4,0,0,4,0,0
"United Arab Emirates","2024-10-04",0,0,4,0,0,4,0,0
"United Arab Emirates","2024-10-05",0,0,4,0,0,4,0,0
"United Arab Emirates","2024-10-06",0,0,4,0,0,4,0,0
"United Arab Emirates","2024-10-07",0,0,4,0,0,4,0,0
"United Arab Emirates","2024-10-08",0,0,4,0,0,4,0,0
"United Arab Emirates","2024-10-09",0,0,4,0,0,4,0,0
"United Arab Emirates","2024-10-10",0,0,4,0,0,4,0,0
"United Arab Emirates","2024-10-11",0,0,4,0,0,4,0,0
"United Arab Emirates","2024-10-12",0,0,4,0,0,4,0,0
"United Arab Emirates","2024-10-13",0,0,4,0,0,4,0,0
"United Arab Emirates","2024-10-14",0,0,4,0,0,4,0,0
"United Arab Emirates","2024-10-15",0,0,4,0,0,4,0,0
"United Arab Emirates","2024-10-16",0,0,4,0,1,5,0,0
"United Arab Emirates","2024-10-17",0,0,4,0,0,5,0,0
"United Arab Emirates","2024-10-18",0,0,4,0,0,5,0,0
"United Arab Emirates","2024-10-19",0,0,4,0,0,5,0,0
"United Arab Emirates","2024-10-20",0,0,4,0,0,5,0,0
"United Arab Emirates","2024-10-21",0,0,4,0,0,5,0,0
"United Arab Emirates","2024-10-22",0,0,4,0,0,5,0,0
"United Arab Emirates","2024-10-23",0,0,4,0,0,5,0,0
"United Arab Emirates","2024-10-24",0,0,4,0,0,5,0,0
"United Arab Emirates","2024-10-25",0,0,4,0,0,5,0,0
"United Arab Emirates","2024-10-26",0,0,4,0,0,5,0,0
"United Arab Emirates","2024-10-27",0,0,4,0,0,5,0,0
"United Arab Emirates","2024-10-28",0,0,4,0,0,5,0,0
"United Arab Emirates","2024-10-29",0,0,4,0,0,5,0,0
"United Arab Emirates","2024-10-30",0,1,5,0,0,5,0,0
"United Arab Emirates","2024-10-31",0,0,5,0,0,5,0,0
"United Arab Emirates","2024-11-01",0,0,5,0,0,5,0,0
"United Arab Emirates","2024-11-02",0,0,5,0,0,5,0,0
"United Arab Emirates","2024-11-03",0,0,5,0,0,5,0,0
"United Arab Emirates","2024-11-04",0,0,5,0,0,5,0,0
"United Arab Emirates","2024-11-05",0,0,5,0,0,5,0,0
"United Arab Emirates","2024-11-06",0,0,5,0,0,5,0,0
"United Arab Emirates","2024-11-07",0,0,5,0,0,5,0,0
"United Arab Emirates","2024-11-08",0,0,5,0,0,5,0,0
"United Arab Emirates","2024-11-09",0,0,5,0,0,5,0,0
"United Arab Emirates","2024-11-10",0,0,5,0,0,5,0,0
"United Arab Emirates","2024-11-11",0,0,5,0,0,5,0,0
"United Arab Emirates","2024-11-12",0,0,5,0,0,5,0,0
"United Arab Emirates","2024-11-13",0,0,5,0,0,5,0,0
"United Arab Emirates","2024-11-14",0,0,5,0,0,5,0,0
"United Arab Emirates","2024-11-15",0,0,5,0,0,5,0,0
"United Arab Emirates","2024-11-16",0,0,5,0,0,5,0,0
"United Arab Emirates","2024-11-17",0,0,5,0,0,5,0,0
"United Arab Emirates","2024-11-18",0,0,5,0,0,5,0,0
"United Arab Emirates","2024-11-19",0,0,5,0,0,5,0,0
"United Arab Emirates","2024-11-20",0,0,5,0,0,5,0,0
"United Arab Emirates","2024-11-21",0,0,5,0,0,5,0,0
"United Arab Emirates","2024-11-22",0,0,5,0,0,5,0,0
"United Arab Emirates","2024-11-23",0,0,5,0,0,5,0,0
"United Arab Emirates","2024-11-24",0,0,5,0,0,5,0,0
"United Arab Emirates","2024-11-25",0,0,5,0,0,5,0,0
"United Arab Emirates","2024-11-26",0,0,5,0,0,5,0,0
"United Arab Emirates","2024-11-27",0,0,5,0,0,5,0,0
"United Arab Emirates","2024-11-28",0,0,5,0,0,5,0,0
"United Arab Emirates","2024-11-29",0,0,5,0,0,5,0,0
"United Arab Emirates","2024-11-30",0,0,5,0,0,5,0,0
"United Arab Emirates","2024-12-01",0,0,5,0,0,5,0,0
"United Arab Emirates","2024-12-02",0,0,5,0,0,5,0,0
"United Arab Emirates","2024-12-03",0,0,5,0,0,5,0,0
"United Arab Emirates","2024-12-04",0,0,5,0,0,5,0,0
"United Arab Emirates","2024-12-05",0,0,5,0,0,5,0,0
"United Arab Emirates","2024-12-06",0,0,5,0,0,5,0,0
"United Arab Emirates","2024-12-07",0,0,5,0,0,5,0,0
"United Arab Emirates","2024-12-08",0,0,5,0,0,5,0,0
"United Arab Emirates","2024-12-09",0,0,5,0,0,5,0,0
"United Kingdom of Great Britain and Northern Ireland","2024-01-01",0,0,0,0,0,0,0,0
"United Kingdom of Great Britain and Northern Ireland","2024-01-02",0,0,0,0,0,0,0,0
"United Kingdom of Great Britain and Northern Ireland","2024-01-03",0,0,0,0,0,0,0,0
"United Kingdom of Great Britain and Northern Ireland","2024-01-04",0,0,0,0,0,0,0,0
"United Kingdom of Great Britain and Northern Ireland","2024-01-05",0,0,0,0,0,0,0,0
"United Kingdom of Great Britain and Northern Ireland","2024-01-06",0,0,0,0,0,0,0,0
"United Kingdom of Great Britain and Northern Ireland","2024-01-07",0,0,0,0,0,0,0,0
"United Kingdom of Great Britain and Northern Ireland","2024-01-08",0,0,0,0,0,0,0,0
"United Kingdom of Great Britain and Northern Ireland","2024-01-09",0,0,0,0,0,0,0,0
"United Kingdom of Great Britain and Northern Ireland","2024-01-10",0,0,0,0,0,0,0,0
"United Kingdom of Great Britain and Northern Ireland","2024-01-11",0,0,0,0,0,0,0,0
"United Kingdom of Great Britain and Northern Ireland","2024-01-12",0,0,0,0,0,0,0,0
"United Kingdom of Great Britain and Northern Ireland","2024-01-13",0,0,0,0,0,0,0,0
"United Kingdom of Great Britain and Northern Ireland","2024-01-14",0,0,0,0,0,0,0,0
"United Kingdom of Great Britain and Northern Ireland","2024-01-15",0,0,0,0,0,0,0,0
"United Kingdom of Great Britain and Northern Ireland","2024-01-16",0,0,0,0,0,0,0,0
"United Kingdom of Great Britain and Northern Ireland","2024-01-17",0,0,0,0,0,0,0,0
"United Kingdom of Great Britain and Northern Ireland","2024-01-18",0,0,0,0,0,0,0,0
"United Kingdom of Great Britain and Northern Ireland","2024-01-19",0,0,0,0,0,0,0,0
"United Kingdom of Great Britain and Northern Ireland","2024-01-20",0,0,0,0,0,0,0,0
"United Kingdom of Great Britain and Northern Ireland","2024-01-21",0,0,0,0,0,0,0,0
"United Kingdom of Great Britain and Northern Ireland","2024-01-22",0,0,0,0,0,0,0,0
"United Kingdom of Great Britain and Northern Ireland","2024-01-23",0,0,0,0,0,0,0,0
"United Kingdom of Great Britain and Northern Ireland","2024-01-24",0,0,0,0,0,0,0,0
"United Kingdom of Great Britain and Northern Ireland","2024-01-25",0,0,0,0,0,0,0,0
"United Kingdom of Great Britain and Northern Ireland","2024-01-26",0,0,0,0,0,0,0,0
"United Kingdom of Great Britain and Northern Ireland","2024-01-27",0,0,0,0,0,0,0,0
"United Kingdom of Great Britain and Northern Ireland","2024-01-28",0,0,0,0,0,0,0,0
"United Kingdom of Great Britain and Northern Ireland","2024-01-29",0,0,0,0,0,0,0,0
"United Kingdom of Great Britain and Northern Ireland","2024-01-30",0,0,0,0,0,0,0,0
"United Kingdom of Great Britain and Northern Ireland","2024-01-31",0,7,7,0,7,7,0,0
"United Kingdom of Great Britain and Northern Ireland","2024-02-01",0,0,7,0,0,7,0,0
"United Kingdom of Great Britain and Northern Ireland","2024-02-02",0,0,7,0,1,8,0,0
"United Kingdom of Great Britain and Northern Ireland","2024-02-03",0,0,7,0,0,8,0,0
"United Kingdom of Great Britain and Northern Ireland","2024-02-04",0,0,7,0,0,8,0,0
"United Kingdom of Great Britain and Northern Ireland","2024-02-05",0,0,7,0,1,9,0,0
"United Kingdom of Great Britain and Northern Ireland","2024-02-06",0,0,7,0,0,9,0,0
"United Kingdom of Great Britain and Northern Ireland","2024-02-07",0,0,7,0,0,9,0,0
"United Kingdom of Great Britain and Northern Ireland","2024-02-08",0,0,7,0,1,10,0,0
"United Kingdom of Great Britain and Northern Ireland","2024-02-09",0,0,7,0,0,10,0,0
"United Kingdom of Great Britain and Northern Ireland","2024-02-10",0,0,7,0,0,10,0,0
"United Kingdom of Great Britain and Northern Ireland","2024-02-11",0,0,7,0,1,11,0,0
"United Kingdom of Great Britain and Northern Ireland","2024-02-12",0,0,7,0,0,11,0,0
"United Kingdom of Great Britain and Northern Ireland","2024-02-13",0,0,7,0,0,11,0,0
"United Kingdom of Great Britain and Northern Ireland","2024-02-14",0,0,7,0,1,12,0,0
"United Kingdom of Great Britain and Northern Ireland","2024-02-15",0,0,7,0,0,12,0,0
"United Kingdom of Great Britain and Northern Ireland","2024-02-16",0,0,7,0,1,13,0,0
"United Kingdom of Great Britain and Northern Ireland","2024-02-17",0,0,7,0,0,13,0,0
"United Kingdom of Great Britain and Northern Ireland","2024-02-18",0,0,7,0,0,13,0,0
"United Kingdom of Great Britain and Northern Ireland","2024-02-19",0,0,7,0,1,14,0,0
"United Kingdom of Great Britain and Northern Ireland","2024-02-20",0,0,7,0,0,14,0,0
"United Kingdom of Great Britain and Northern Ireland","2024-02-21",0,0,7,0,0,14,0,0
"United Kingdom of Great Britain and Northern Ireland","2024-02-22",0,0,7,0,1,15,0,0
"United Kingdom of Great Britain and Northern Ireland","2024-02-23",0,0,7,0,0,15,0,0
"United Kingdom of Great Britain and Northern Ireland","2024-02-24",0,0,7,0,0,15,0,0
"United Kingdom of Great Britain and Northern Ireland","2024-02-25",0,0,7,0,1,16,0,0
"United Kingdom of Great Britain and Northern Ireland","2024-02-26",0,0,7,0,0,16,0,0
"United Kingdom of Great Britain and Northern Ireland","2024-02-27",0,0,7,0,0,16,0,0
"United Kingdom of Great Britain and Northern Ireland","2024-02-28",0,0,7,0,1,17,0,0
"United Kingdom of Great Britain and Northern Ireland","2024-02-29",0,10,17,0,0,17,0,0
"United Kingdom of Great Britain and Northern Ireland","2024-03-01",0,0,17,0,1,18,0,0
"United Kingdom of Great Britain and Northern Ireland","2024-03-02",0,0,17,0,0,18,0,0
"United Kingdom of Great Britain and Northern Ireland","2024-03-03",0,0,17,0,1,19,0,0
"United Kingdom of Great Britain and Northern Ireland","2024-03-04",0,0,17,0,0,19,0,0
"United Kingdom of Great Britain and Northern Ireland","2024-03-05",0,0,17,0,1,20,0,0
"United Kingdom of Great Britain and Northern Ireland","2024-03-06",0,0,17,0,0,20,0,0
"United Kingdom of Great Britain and Northern Ireland","2024-03-07",0,0,17,0,1,21,0,0
"United Kingdom of Great Britain and Northern Ireland","2024-03-08",0,0,17,0,0,21,0,0
"United Kingdom of Great Britain and Northern Ireland","2024-03-09",0,0,17,0,1,22,0,0
"United Kingdom of Great Britain and Northern Ireland","2024-03-10",0,0,17,0,0,22,0,0
"United Kingdom of Great Britain and Northern Ireland","2024-03-11",0,0,17,0,1,23,0,0
"United Kingdom of Great Britain and Northern Ireland","2024-03-12",0,0,17,0,0,23,0,0
"United Kingdom of Great Britain and Northern Ireland","2024-03-13",0,0,17,0,1,24,0,0
"United Kingdom of Great Britain and Northern Ireland","2024-03-14",0,0,17,0,0,24,0,0
"United Kingdom of Great Britain and Northern Ireland","2024-03-15",0,0,17,0,1,25,0,0
"United Kingdom of Great Britain and Northern Ireland","2024-03-16",0,0,17,0,0,25,0,0
"United Kingdom of Great Britain and Northern Ireland","2024-03-17",0,0,17,0,1,26,0,0
"United Kingdom of Great Britain and Northern Ireland","2024-03-18",0,0,17,0,0,26,0,0
"United Kingdom of Great Britain and Northern Ireland","2024-03-19",0,0,17,0,1,27,0,0
"United Kingdom of Great Britain and Northern Ireland","2024-03-20",0,0,17,0,0,27,0,0
"United Kingdom of Great Britain and Northern Ireland","2024-03-21",0,0,17,0,1,28,0,0
"United Kingdom of Great Britain and Northern Ireland","2024-03-22",0,0,17,0,0,28,0,0
"United Kingdom of Great Britain and Northern Ireland","2024-03-23",0,0,17,0,1,29,0,0
"United Kingdom of Great Britain and Northern Ireland","2024-03-24",0,0,17,0,0,29,0,0
"United Kingdom of Great Britain and Northern Ireland","2024-03-25",0,0,17,0,1,30,0,0
"United Kingdom of Great Britain and Northern Ireland","2024-03-26",0,0,17,0,0,30,0,0
"United Kingdom of Great Britain and Northern Ireland","2024-03-27",0,0,17,0,1,31,0,0
"United Kingdom of Great Britain and Northern Ireland","2024-03-28",0,0,17,0,0,31,0,0
"United Kingdom of Great Britain and Northern Ireland","2024-03-29",0,0,17,0,1,32,0,0
"United Kingdom of Great Britain and Northern Ireland","2024-03-30",0,0,17,0,0,32,0,0
"United Kingdom of Great Britain and Northern Ireland","2024-03-31",0,16,33,0,1,33,0,0
"United Kingdom of Great Britain and Northern Ireland","2024-04-01",0,0,33,0,1,34,0,0
"United Kingdom of Great Britain and Northern Ireland","2024-04-02",0,0,33,0,0,34,0,0
"United Kingdom of Great Britain and Northern Ireland","2024-04-03",0,0,33,0,1,35,0,0
"United Kingdom of Great Britain and Northern Ireland","2024-04-04",0,0,33,0,1,36,0,0
"United Kingdom of Great Britain and Northern Ireland","2024-04-05",0,0,33,0,0,36,0,0
"United Kingdom of Great Britain and Northern Ireland","2024-04-06",0,0,33,0,1,37,0,0
"United Kingdom of Great Britain and Northern Ireland","2024-04-07",0,0,33,0,1,38,0,0
"United Kingdom of Great Britain and Northern Ireland","2024-04-08",0,0,33,0,0,38,0,0
"United Kingdom of Great Britain and Northern Ireland","2024-04-09",0,0,33,0,1,39,0,0
"United Kingdom of Great Britain and Northern Ireland","2024-04-10",0,0,33,0,1,40,0,0
"United Kingdom of Great Britain and Northern Ireland","2024-04-11",0,0,33,0,0,40,0,0
"United Kingdom of Great Britain and Northern Ireland","2024-04-12",0,0,33,0,1,41,0,0
"United Kingdom of Great Britain and Northern Ireland","2024-04-13",0,0,33,0,1,42,0,0
"United Kingdom of Great Britain and Northern Ireland","2024-04-14",0,0,33,0,0,42,0,0
"United Kingdom of Great Britain and Northern Ireland","2024-04-15",0,0,33,0,1,43,0,0
"United Kingdom of Great Britain and Northern Ireland","2024-04-16",0,0,33,0,1,44,0,0
"United Kingdom of Great Britain and Northern Ireland","2024-04-17",0,0,33,0,0,44,0,0
"United Kingdom of Great Britain and Northern Ireland","2024-04-18",0,0,33,0,1,45,0,0
"United Kingdom of Great Britain and Northern Ireland","2024-04-19",0,0,33,0,1,46,0,0
"United Kingdom of Great Britain and Northern Ireland","2024-04-20",0,0,33,0,0,46,0,0
"United Kingdom of Great Britain and Northern Ireland","2024-04-21",0,0,33,0,1,47,0,0
"United Kingdom of Great Britain and Northern Ireland","2024-04-22",0,0,33,0,1,48,0,0
"United Kingdom of Great Britain and Northern Ireland","2024-04-23",0,0,33,0,0,48,0,0
"United Kingdom of Great Britain and Northern Ireland","2024-04-24",0,0,33,0,1,49,0,0
"United Kingdom of Great Britain and Northern Ireland","2024-04-25",0,0,33,0,1,50,0,0
"United Kingdom of Great Britain and Northern Ireland","2024-04-26",0,0,33,0,0,50,0,0
"United Kingdom of Great Britain and Northern Ireland","2024-04-27",0,0,33,0,1,51,0,0
"United Kingdom of Great Britain and Northern Ireland","2024-04-28",0,0,33,0,1,52,0,0
"United Kingdom of Great Britain and Northern Ireland","2024-04-29",0,0,33,0,0,52,0,0
"United Kingdom of Great Britain and Northern Ireland","2024-04-30",0,20,53,0,1,53,0,0
"United Kingdom of Great Britain and Northern Ireland","2024-05-01",0,0,53,0,1,54,0,0
"United Kingdom of Great Britain and Northern Ireland","2024-05-02",0,0,53,0,1,55,0,0
"United Kingdom of Great Britain and Northern Ireland","2024-05-03",0,0,53,0,0,55,0,0
"United Kingdom of Great Britain and Northern Ireland","2024-05-04",0,0,53,0,1,56,0,0
"United Kingdom of Great Britain and Northern Ireland","2024-05-05",0,0,53,0,1,57,0,0
"United Kingdom of Great Britain and Northern Ireland","2024-05-06",0,0,53,0,1,58,0,0
"United Kingdom of Great Britain and Northern Ireland","2024-05-07",0,0,53,0,0,58,0,0
"United Kingdom of Great Britain and Northern Ireland","2024-05-08",0,0,53,0,1,59,0,0
"United Kingdom of Great Britain and Northern Ireland","2024-05-09",0,0,53,0,1,60,0,0
"United Kingdom of Great Britain and Northern Ireland","2024-05-10",0,0,53,0,1,61,0,0
"United Kingdom of Great Britain and Northern Ireland","2024-05-11",0,0,53,0,1,62,0,0
"United Kingdom of Great Britain and Northern Ireland","2024-05-12",0,0,53,0,0,62,0,0
"United Kingdom of Great Britain and Northern Ireland","2024-05-13",0,0,53,0,1,63,0,0
"United Kingdom of Great Britain and Northern Ireland","2024-05-14",0,0,53,0,1,64,0,0
"United Kingdom of Great Britain and Northern Ireland","2024-05-15",0,0,53,0,1,65,0,0
"United Kingdom of Great Britain and Northern Ireland","2024-05-16",0,0,53,0,0,65,0,0
"United Kingdom of Great Britain and Northern Ireland","2024-05-17",0,0,53,0,1,66,0,0
"United Kingdom of Great Britain and Northern Ireland","2024-05-18",0,0,53,0,1,67,0,0
"United Kingdom of Great Britain and Northern Ireland","2024-05-19",0,0,53,0,1,68,0,0
"United Kingdom of Great Britain and Northern Ireland","2024-05-20",0,0,53,0,0,68,0,0
"United Kingdom of Great Britain and Northern Ireland","2024-05-21",0,0,53,0,1,69,0,0
"United Kingdom of Great Britain and Northern Ireland","2024-05-22",0,0,53,0,1,70,0,0
"United Kingdom of Great Britain and Northern Ireland","2024-05-23",0,0,53,0,1,71,0,0
"United Kingdom of Great Britain and Northern Ireland","2024-05-24",0,0,53,0,1,72,0,0
"United Kingdom of Great Britain and Northern Ireland","2024-05-25",0,0,53,0,0,72,0,0
"United Kingdom of Great Britain and Northern Ireland","2024-05-26",0,0,53,0,1,73,0,0
"United Kingdom of Great Britain and Northern Ireland","2024-05-27",0,0,53,0,1,74,0,0
"United Kingdom of Great Britain and Northern Ireland","2024-05-28",0,0,53,0,1,75,0,0
"United Kingdom of Great Britain and Northern Ireland","2024-05-29",0,0,53,0,0,75,0,0
"United Kingdom of Great Britain and Northern Ireland","2024-05-30",0,0,53,0,1,76,0,0
"United Kingdom of Great Britain and Northern Ireland","2024-05-31",0,24,77,0,1,77,0,0
"United Kingdom of Great Britain and Northern Ireland","2024-06-01",0,0,77,0,1,78,0,0
"United Kingdom of Great Britain and Northern Ireland","2024-06-02",0,0,77,0,1,79,0,0
"United Kingdom of Great Britain and Northern Ireland","2024-06-03",0,0,77,0,1,80,0,0
"United Kingdom of Great Britain and Northern Ireland","2024-06-04",0,0,77,0,1,81,0,0
"United Kingdom of Great Britain and Northern Ireland","2024-06-05",0,0,77,0,1,82,0,0
"United Kingdom of Great Britain and Northern Ireland","2024-06-06",0,0,77,0,1,83,0,0
"United Kingdom of Great Britain and Northern Ireland","2024-06-07",0,0,77,0,2,85,0,0
"United Kingdom of Great Britain and Northern Ireland","2024-06-08",0,0,77,0,1,86,0,0
"United Kingdom of Great Britain and Northern Ireland","2024-06-09",0,0,77,0,1,87,0,0
"United Kingdom of Great Britain and Northern Ireland","2024-06-10",0,0,77,0,1,88,0,0
"United Kingdom of Great Britain and Northern Ireland","2024-06-11",0,0,77,0,1,89,0,0
"United Kingdom of Great Britain and Northern Ireland","2024-06-12",0,0,77,0,1,90,0,0
"United Kingdom of Great Britain and Northern Ireland","2024-06-13",0,0,77,0,1,91,0,0
"United Kingdom of Great Britain and Northern Ireland","2024-06-14",0,0,77,0,1,92,0,0
"United Kingdom of Great Britain and Northern Ireland","2024-06-15",0,0,77,0,1,93,0,0
"United Kingdom of Great Britain and Northern Ireland","2024-06-16",0,0,77,0,1,94,0,0
"United Kingdom of Great Britain and Northern Ireland","2024-06-17",0,0,77,0,1,95,0,0
"United Kingdom of Great Britain and Northern Ireland","2024-06-18",0,0,77,0,1,96,0,0
"United Kingdom of Great Britain and Northern Ireland","2024-06-19",0,0,77,0,2,98,0,0
"United Kingdom of Great Britain and Northern Ireland","2024-06-20",0,0,77,0,1,99,0,0
"United Kingdom of Great Britain and Northern Ireland","2024-06-21",0,0,77,0,1,100,0,0
"United Kingdom of Great Britain and Northern Ireland","2024-06-22",0,0,77,0,1,101,0,0
"United Kingdom of Great Britain and Northern Ireland","2024-06-23",0,0,77,0,1,102,0,0
"United Kingdom of Great Britain and Northern Ireland","2024-06-24",0,0,77,0,1,103,0,0
"United Kingdom of Great Britain and Northern Ireland","2024-06-25",0,0,77,0,1,104,0,0
"United Kingdom of Great Britain and Northern Ireland","2024-06-26",0,0,77,0,1,105,0,0
"United Kingdom of Great Britain and Northern Ireland","2024-06-27",0,0,77,0,1,106,0,0
"United Kingdom of Great Britain and Northern Ireland","2024-06-28",0,0,77,0,1,107,0,0
"United Kingdom of Great Britain and Northern Ireland","2024-06-29",0,0,77,0,1,108,0,0
"United Kingdom of Great Britain and Northern Ireland","2024-06-30",0,0,77,0,1,109,0,0
"United Kingdom of Great Britain and Northern Ireland","2024-07-01",0,0,77,0,2,111,0,0
"United Kingdom of Great Britain and Northern Ireland","2024-07-02",0,0,77,0,1,112,0,0
"United Kingdom of Great Britain and Northern Ireland","2024-07-03",0,0,77,0,1,113,0,0
"United Kingdom of Great Britain and Northern Ireland","2024-07-04",0,0,77,0,1,114,0,0
"United Kingdom of Great Britain and Northern Ireland","2024-07-05",0,0,77,0,1,115,0,0
"United Kingdom of Great Britain and Northern Ireland","2024-07-06",0,0,77,0,1,116,0,0
"United Kingdom of Great Britain and Northern Ireland","2024-07-07",0,0,77,0,1,117,0,0
"United Kingdom of Great Britain and Northern Ireland","2024-07-08",0,0,77,0,1,118,0,0
"United Kingdom of Great Britain and Northern Ireland","2024-07-09",0,0,77,0,1,119,0,0
"United Kingdom of Great Britain and Northern Ireland","2024-07-10",0,0,77,0,1,120,0,0
"United Kingdom of Great Britain and Northern Ireland","2024-07-11",0,0,77,0,1,121,0,0
"United Kingdom of Great Britain and Northern Ireland","2024-07-12",0,0,77,0,1,122,0,0
"United Kingdom of Great Britain and Northern Ireland","2024-07-13",0,0,77,0,2,124,0,0
"United Kingdom of Great Britain and Northern Ireland","2024-07-14",0,0,77,0,1,125,0,0
"United Kingdom of Great Britain and Northern Ireland","2024-07-15",0,0,77,0,1,126,0,0
"United Kingdom of Great Britain and Northern Ireland","2024-07-16",0,0,77,0,1,127,0,0
"United Kingdom of Great Britain and Northern Ireland","2024-07-17",0,0,77,0,1,128,0,0
"United Kingdom of Great Britain and Northern Ireland","2024-07-18",0,0,77,0,1,129,0,0
"United Kingdom of Great Britain and Northern Ireland","2024-07-19",0,0,77,0,1,130,0,0
"United Kingdom of Great Britain and Northern Ireland","2024-07-20",0,0,77,0,1,131,0,0
"United Kingdom of Great Britain and Northern Ireland","2024-07-21",0,0,77,0,1,132,0,0
"United Kingdom of Great Britain and Northern Ireland","2024-07-22",0,0,77,0,1,133,0,0
"United Kingdom of Great Britain and Northern Ireland","2024-07-23",0,0,77,0,1,134,0,0
"United Kingdom of Great Britain and Northern Ireland","2024-07-24",0,0,77,0,1,135,0,0
"United Kingdom of Great Britain and Northern Ireland","2024-07-25",0,0,77,0,2,137,0,0
"United Kingdom of Great Britain and Northern Ireland","2024-07-26",0,0,77,0,1,138,0,0
"United Kingdom of Great Britain and Northern Ireland","2024-07-27",0,0,77,0,1,139,0,0
"United Kingdom of Great Britain and Northern Ireland","2024-07-28",0,0,77,0,1,140,0,0
"United Kingdom of Great Britain and Northern Ireland","2024-07-29",0,0,77,0,1,141,0,0
"United Kingdom of Great Britain and Northern Ireland","2024-07-30",0,0,77,0,1,142,0,0
"United Kingdom of Great Britain and Northern Ireland","2024-07-31",0,66,143,0,1,143,0,0
"United Kingdom of Great Britain and Northern Ireland","2024-08-01",0,0,143,0,1,144,0,0
"United Kingdom of Great Britain and Northern Ireland","2024-08-02",0,0,143,0,2,146,0,0
"United Kingdom of Great Britain and Northern Ireland","2024-08-03",0,0,143,0,1,147,0,0
"United Kingdom of Great Britain and Northern Ireland","2024-08-04",0,0,143,0,1,148,0,0
"United Kingdom of Great Britain and Northern Ireland","2024-08-05",0,0,143,0,1,149,0,0
"United Kingdom of Great Britain and Northern Ireland","2024-08-06",0,0,143,0,2,151,0,0
"United Kingdom of Great Britain and Northern Ireland","2024-08-07",0,0,143,0,1,152,0,0
"United Kingdom of Great Britain and Northern Ireland","2024-08-08",0,0,143,0,1,153,0,0
"United Kingdom of Great Britain and Northern Ireland","2024-08-09",0,0,143,0,2,155,0,0
"United Kingdom of Great Britain and Northern Ireland","2024-08-10",0,0,143,0,1,156,0,0
"United Kingdom of Great Britain and Northern Ireland","2024-08-11",0,0,143,0,1,157,0,0
"United Kingdom of Great Britain and Northern Ireland","2024-08-12",0,0,143,0,1,158,0,0
"United Kingdom of Great Britain and Northern Ireland","2024-08-13",0,0,143,0,2,160,0,0
"United Kingdom of Great Britain and Northern Ireland","2024-08-14",0,0,143,0,1,161,0,0
"United Kingdom of Great Britain and Northern Ireland","2024-08-15",0,0,143,0,1,162,0,0
"United Kingdom of Great Britain and Northern Ireland","2024-08-16",0,0,143,0,2,164,0,0
"United Kingdom of Great Britain and Northern Ireland","2024-08-17",0,0,143,0,1,165,0,0
"United Kingdom of Great Britain and Northern Ireland","2024-08-18",0,0,143,0,1,166,0,0
"United Kingdom of Great Britain and Northern Ireland","2024-08-19",0,0,143,0,2,168,0,0
"United Kingdom of Great Britain and Northern Ireland","2024-08-20",0,0,143,0,1,169,0,0
"United Kingdom of Great Britain and Northern Ireland","2024-08-21",0,0,143,0,1,170,0,0
"United Kingdom of Great Britain and Northern Ireland","2024-08-22",0,0,143,0,1,171,0,0
"United Kingdom of Great Britain and Northern Ireland","2024-08-23",0,0,143,0,2,173,0,0
"United Kingdom of Great Britain and Northern Ireland","2024-08-24",0,0,143,0,1,174,0,0
"United Kingdom of Great Britain and Northern Ireland","2024-08-25",0,0,143,0,1,175,0,0
"United Kingdom of Great Britain and Northern Ireland","2024-08-26",0,0,143,0,2,177,0,0
"United Kingdom of Great Britain and Northern Ireland","2024-08-27",0,0,143,0,1,178,0,0
"United Kingdom of Great Britain and Northern Ireland","2024-08-28",0,0,143,0,1,179,0,0
"United Kingdom of Great Britain and Northern Ireland","2024-08-29",0,0,143,0,1,180,0,0
"United Kingdom of Great Britain and Northern Ireland","2024-08-30",0,0,143,0,2,182,0,0
"United Kingdom of Great Britain and Northern Ireland","2024-08-31",0,40,183,0,1,183,0,0
"United Kingdom of Great Britain and Northern Ireland","2024-09-01",0,0,183,0,1,184,0,0
"United Kingdom of Great Britain and Northern Ireland","2024-09-02",0,0,183,0,2,186,0,0
"United Kingdom of Great Britain and Northern Ireland","2024-09-03",0,0,183,0,1,187,0,0
"United Kingdom of Great Britain and Northern Ireland","2024-09-04",0,0,183,0,2,189,0,0
"United Kingdom of Great Britain and Northern Ireland","2024-09-05",0,0,183,0,1,190,0,0
"United Kingdom of Great Britain and Northern Ireland","2024-09-06",0,0,183,0,1,191,0,0
"United Kingdom of Great Britain and Northern Ireland","2024-09-07",0,0,183,0,2,193,0,0
"United Kingdom of Great Britain and Northern Ireland","2024-09-08",0,0,183,0,1,194,0,0
"United Kingdom of Great Britain and Northern Ireland","2024-09-09",0,0,183,0,2,196,0,0
"United Kingdom of Great Britain and Northern Ireland","2024-09-10",0,0,183,0,1,197,0,0
"United Kingdom of Great Britain and Northern Ireland","2024-09-11",0,0,183,0,1,198,0,0
"United Kingdom of Great Britain and Northern Ireland","2024-09-12",0,0,183,0,2,200,0,0
"United Kingdom of Great Britain and Northern Ireland","2024-09-13",0,0,183,0,1,201,0,0
"United Kingdom of Great Britain and Northern Ireland","2024-09-14",0,0,183,0,2,203,0,0
"United Kingdom of Great Britain and Northern Ireland","2024-09-15",0,0,183,0,1,204,0,0
"United Kingdom of Great Britain and Northern Ireland","2024-09-16",0,0,183,0,1,205,0,0
"United Kingdom of Great Britain and Northern Ireland","2024-09-17",0,0,183,0,2,207,0,0
"United Kingdom of Great Britain and Northern Ireland","2024-09-18",0,0,183,0,1,208,0,0
"United Kingdom of Great Britain and Northern Ireland","2024-09-19",0,0,183,0,2,210,0,0
"United Kingdom of Great Britain and Northern Ireland","2024-09-20",0,0,183,0,1,211,0,0
"United Kingdom of Great Britain and Northern Ireland","2024-09-21",0,0,183,0,1,212,0,0
"United Kingdom of Great Britain and Northern Ireland","2024-09-22",0,0,183,0,2,214,0,0
"United Kingdom of Great Britain and Northern Ireland","2024-09-23",0,0,183,0,1,215,0,0
"United Kingdom of Great Britain and Northern Ireland","2024-09-24",0,0,183,0,2,217,0,0
"United Kingdom of Great Britain and Northern Ireland","2024-09-25",0,0,183,0,1,218,0,0
"United Kingdom of Great Britain and Northern Ireland","2024-09-26",0,0,183,0,1,219,0,0
"United Kingdom of Great Britain and Northern Ireland","2024-09-27",0,0,183,0,2,221,0,0
"United Kingdom of Great Britain and Northern Ireland","2024-09-28",0,0,183,0,1,222,0,0
"United Kingdom of Great Britain and Northern Ireland","2024-09-29",0,0,183,0,2,224,0,0
"United Kingdom of Great Britain and Northern Ireland","2024-09-30",0,42,225,0,1,225,0,0
"United Kingdom of Great Britain and Northern Ireland","2024-10-01",0,0,225,0,0,225,0,0
"United Kingdom of Great Britain and Northern Ireland","2024-10-02",0,0,225,0,1,226,0,0
"United Kingdom of Great Britain and Northern Ireland","2024-10-03",0,0,225,0,0,226,0,0
"United Kingdom of Great Britain and Northern Ireland","2024-10-04",0,0,225,0,0,226,0,0
"United Kingdom of Great Britain and Northern Ireland","2024-10-05",0,0,225,0,1,227,0,0
"United Kingdom of Great Britain and Northern Ireland","2024-10-06",0,0,225,0,0,227,0,0
"United Kingdom of Great Britain and Northern Ireland","2024-10-07",0,0,225,0,0,227,0,0
"United Kingdom of Great Britain and Northern Ireland","2024-10-08",0,0,225,0,1,228,0,0
"United Kingdom of Great Britain and Northern Ireland","2024-10-09",0,0,225,0,0,228,0,0
"United Kingdom of Great Britain and Northern Ireland","2024-10-10",0,0,225,0,0,228,0,0
"United Kingdom of Great Britain and Northern Ireland","2024-10-11",0,0,225,0,1,229,0,0
"United Kingdom of Great Britain and Northern Ireland","2024-10-12",0,0,225,0,0,229,0,0
"United Kingdom of Great Britain and Northern Ireland","2024-10-13",0,0,225,0,0,229,0,0
"United Kingdom of Great Britain and Northern Ireland","2024-10-14",0,0,225,0,1,230,0,0
"United Kingdom of Great Britain and Northern Ireland","2024-10-15",0,0,225,0,0,230,0,0
"United Kingdom of Great Britain and Northern Ireland","2024-10-16",0,0,225,0,0,230,0,0
"United Kingdom of Great Britain and Northern Ireland","2024-10-17",0,0,225,0,0,230,0,0
"United Kingdom of Great Britain and Northern Ireland","2024-10-18",0,0,225,0,1,231,0,0
"United Kingdom of Great Britain and Northern Ireland","2024-10-19",0,0,225,0,0,231,0,0
"United Kingdom of Great Britain and Northern Ireland","2024-10-20",0,0,225,0,0,231,0,0
"United Kingdom of Great Britain and Northern Ireland","2024-10-21",0,0,225,0,1,232,0,0
"United Kingdom of Great Britain and Northern Ireland","2024-10-22",0,0,225,0,0,232,0,0
"United Kingdom of Great Britain and Northern Ireland","2024-10-23",0,0,225,0,0,232,0,0
"United Kingdom of Great Britain and Northern Ireland","2024-10-24",0,0,225,0,1,233,0,0
"United Kingdom of Great Britain and Northern Ireland","2024-10-25",0,0,225,0,0,233,0,0
"United Kingdom of Great Britain and Northern Ireland","2024-10-26",0,0,225,0,0,233,0,0
"United Kingdom of Great Britain and Northern Ireland","2024-10-27",0,0,225,0,1,234,0,0
"United Kingdom of Great Britain and Northern Ireland","2024-10-28",0,0,225,0,0,234,0,0
"United Kingdom of Great Britain and Northern Ireland","2024-10-29",0,0,225,0,0,234,0,0
"United Kingdom of Great Britain and Northern Ireland","2024-10-30",0,0,225,0,1,235,0,0
"United Kingdom of Great Britain and Northern Ireland","2024-10-31",0,10,235,0,0,235,0,0
"United Kingdom of Great Britain and Northern Ireland","2024-11-01",0,0,235,0,0,235,0,0
"United Kingdom of Great Britain and Northern Ireland","2024-11-02",0,0,235,0,0,235,0,0
"United Kingdom of Great Britain and Northern Ireland","2024-11-03",0,0,235,0,0,235,0,0
"United Kingdom of Great Britain and Northern Ireland","2024-11-04",0,0,235,0,0,235,0,0
"United Kingdom of Great Britain and Northern Ireland","2024-11-05",0,0,235,0,0,235,0,0
"United Kingdom of Great Britain and Northern Ireland","2024-11-06",0,0,235,0,0,235,0,0
"United Kingdom of Great Britain and Northern Ireland","2024-11-07",0,0,235,0,0,235,0,0
"United Kingdom of Great Britain and Northern Ireland","2024-11-08",0,0,235,0,0,235,0,0
"United Kingdom of Great Britain and Northern Ireland","2024-11-09",0,0,235,0,0,235,0,0
"United Kingdom of Great Britain and Northern Ireland","2024-11-10",0,0,235,0,0,235,0,0
"United Kingdom of Great Britain and Northern Ireland","2024-11-11",0,0,235,0,0,235,0,0
"United Kingdom of Great Britain and Northern Ireland","2024-11-12",0,0,235,0,0,235,0,0
"United Kingdom of Great Britain and Northern Ireland","2024-11-13",0,0,235,0,0,235,0,0
"United Kingdom of Great Britain and Northern Ireland","2024-11-14",0,0,235,0,0,235,0,0
"United Kingdom of Great Britain and Northern Ireland","2024-11-15",0,0,235,0,0,235,0,0
"United Kingdom of Great Britain and Northern Ireland","2024-11-16",0,0,235,0,0,235,0,0
"United Kingdom of Great Britain and Northern Ireland","2024-11-17",0,0,235,0,0,235,0,0
"United Kingdom of Great Britain and Northern Ireland","2024-11-18",0,0,235,0,0,235,0,0
"United Kingdom of Great Britain and Northern Ireland","2024-11-19",0,0,235,0,0,235,0,0
"United Kingdom of Great Britain and Northern Ireland","2024-11-20",0,0,235,0,0,235,0,0
"United Kingdom of Great Britain and Northern Ireland","2024-11-21",0,0,235,0,0,235,0,0
"United Kingdom of Great Britain and Northern Ireland","2024-11-22",0,0,235,0,0,235,0,0
"United Kingdom of Great Britain and Northern Ireland","2024-11-23",0,0,235,0,0,235,0,0
"United Kingdom of Great Britain and Northern Ireland","2024-11-24",0,0,235,0,0,235,0,0
"United Kingdom of Great Britain and Northern Ireland","2024-11-25",0,0,235,0,0,235,0,0
"United Kingdom of Great Britain and Northern Ireland","2024-11-26",0,0,235,0,0,235,0,0
"United Kingdom of Great Britain and Northern Ireland","2024-11-27",0,0,235,0,0,235,0,0
"United Kingdom of Great Britain and Northern Ireland","2024-11-28",0,0,235,0,0,235,0,0
"United Kingdom of Great Britain and Northern Ireland","2024-11-29",0,0,235,0,0,235,0,0
"United Kingdom of Great Britain and Northern Ireland","2024-11-30",0,0,235,0,0,235,0,0
"United Kingdom of Great Britain and Northern Ireland","2024-12-01",0,0,235,0,0,235,0,0
"United Kingdom of Great Britain and Northern Ireland","2024-12-02",0,0,235,0,0,235,0,0
"United Kingdom of Great Britain and Northern Ireland","2024-12-03",0,0,235,0,0,235,0,0
"United Kingdom of Great Britain and Northern Ireland","2024-12-04",0,0,235,0,0,235,0,0
"United Kingdom of Great Britain and Northern Ireland","2024-12-05",0,0,235,0,0,235,0,0
"United Kingdom of Great Britain and Northern Ireland","2024-12-06",0,0,235,0,0,235,0,0
"United Kingdom of Great Britain and Northern Ireland","2024-12-07",0,0,235,0,0,235,0,0
"United Kingdom of Great Britain and Northern Ireland","2024-12-08",0,0,235,0,0,235,0,0
"United Kingdom of Great Britain and Northern Ireland","2024-12-09",0,0,235,0,0,235,0,0
"United States of America","2024-01-01",0,0,0,0,0,0,0,0
"United States of America","2024-01-02",0,50,50,0,50,50,0,0
"United States of America","2024-01-03",0,0,50,0,8,58,0,0
"United States of America","2024-01-04",0,0,50,0,8,66,0,0
"United States of America","2024-01-05",0,0,50,0,8,74,0,0
"United States of America","2024-01-06",0,0,50,0,8,82,0,0
"United States of America","2024-01-07",0,0,50,0,8,90,0,0
"United States of America","2024-01-08",0,0,50,0,8,98,0,0
"United States of America","2024-01-09",0,56,106,0,8,106,0,0
"United States of America","2024-01-10",0,0,106,0,10,116,0,0
"United States of America","2024-01-11",0,0,106,0,10,126,0,0
"United States of America","2024-01-12",0,0,106,0,10,136,0,0
"United States of America","2024-01-13",0,0,106,0,11,147,0,0
"United States of America","2024-01-14",0,0,106,0,10,157,0,0
"United States of America","2024-01-15",0,0,106,0,10,167,0,0
"United States of America","2024-01-16",0,71,177,0,10,177,0,0
"United States of America","2024-01-17",0,0,177,0,7,184,0,0
"United States of America","2024-01-18",0,0,177,0,7,191,0,0
"United States of America","2024-01-19",0,0,177,0,7,198,0,0
"United States of America","2024-01-20",0,0,177,0,7,205,0,0
"United States of America","2024-01-21",0,0,177,0,7,212,0,0
"United States of America","2024-01-22",0,0,177,0,7,219,0,0
"United States of America","2024-01-23",0,49,226,0,7,226,0,0
"United States of America","2024-01-24",0,0,226,0,12,238,0,0
"United States of America","2024-01-25",0,0,226,0,12,250,0,0
"United States of America","2024-01-26",0,0,226,0,12,262,0,0
"United States of America","2024-01-27",0,0,226,0,11,273,0,0
"United States of America","2024-01-28",0,0,226,0,12,285,0,0
"United States of America","2024-01-29",0,0,226,0,12,297,0,0
"United States of America","2024-01-30",0,83,309,0,12,309,0,0
"United States of America","2024-01-31",0,0,309,0,9,318,0,0
"United States of America","2024-02-01",0,0,309,0,8,326,0,0
"United States of America","2024-02-02",0,0,309,0,9,335,0,0
"United States of America","2024-02-03",0,0,309,0,8,343,0,0
"United States of America","2024-02-04",0,0,309,0,9,352,0,0
"United States of America","2024-02-05",0,0,309,0,8,360,0,0
"United States of America","2024-02-06",0,60,369,0,9,369,0,0
"United States of America","2024-02-07",0,0,369,0,8,377,0,0
"United States of America","2024-02-08",0,0,369,0,9,386,0,0
"United States of America","2024-02-09",0,0,369,0,8,394,0,0
"United States of America","2024-02-10",0,0,369,0,8,402,0,0
"United States of America","2024-02-11",0,0,369,0,8,410,0,0
"United States of America","2024-02-12",0,0,369,0,9,419,0,0
"United States of America","2024-02-13",0,58,427,0,8,427,0,0
"United States of America","2024-02-14",0,0,427,0,8,435,0,0
"United States of America","2024-02-15",0,0,427,0,8,443,0,0
"United States of America","2024-02-16",0,0,427,0,8,451,0,0
"United States of America","2024-02-17",0,0,427,0,9,460,0,0
"United States of America","2024-02-18",0,0,427,0,8,468,0,0
"United States of America","2024-02-19",0,0,427,0,8,476,0,0
"United States of America","2024-02-20",0,57,484,0,8,484,0,0
"United States of America","2024-02-21",0,0,484,0,11,495,0,0
"United States of America","2024-02-22",0,0,484,0,10,505,0,0
"United States of America","2024-02-23",0,0,484,0,11,516,0,0
"United States of America","2024-02-24",0,0,484,0,10,526,0,0
"United States of America","2024-02-25",0,0,484,0,11,537,0,0
"United States of America","2024-02-26",0,0,484,0,10,547,0,0
"United States of America","2024-02-27",0,74,558,0,11,558,0,0
"United States of America","2024-02-28",0,0,558,0,10,568,0,0
"United States of America","2024-02-29",0,0,558,0,10,578,0,0
"United States of America","2024-03-01",0,0,558,0,10,588,0,0
"United States of America","2024-03-02",0,0,558,0,9,597,0,0
"United States of America","2024-03-03",0,0,558,0,10,607,0,0
"United States of America","2024-03-04",0,0,558,0,10,617,0,0
"United States of America","2024-03-05",0,69,627,0,10,627,0,0
"United States of America","2024-03-06",0,0,627,0,11,638,0,0
"United States of America","2024-03-07",0,0,627,0,12,650,0,0
"United States of America","2024-03-08",0,0,627,0,11,661,0,0
"United States of America","2024-03-09",0,0,627,0,11,672,0,0
"United States of America","2024-03-10",0,0,627,0,11,683,0,0
"United States of America","2024-03-11",0,0,627,0,12,695,0,0
"United States of America","2024-03-12",0,79,706,0,11,706,0,0
"United States of America","2024-03-13",0,0,706,0,8,714,0,0
"United States of America","2024-03-14",0,0,706,0,8,722,0,0
"United States of America","2024-03-15",0,0,706,0,8,730,0,0
"United States of America","2024-03-16",0,0,706,0,7,737,0,0
"United States of America","2024-03-17",0,0,706,0,8,745,0,0
"United States of America","2024-03-18",0,0,706,0,8,753,0,0
"United States of America","2024-03-19",0,55,761,0,8,761,0,0
"United States of America","2024-03-20",0,0,761,0,9,770,0,0
"United States of America","2024-03-21",0,0,761,0,9,779,0,0
"United States of America","2024-03-22",0,0,761,0,9,788,0,0
"United States of America","2024-03-23",0,0,761,0,9,797,0,0
"United States of America","2024-03-24",0,0,761,0,9,806,0,0
"United States of America","2024-03-25",0,0,761,0,9,815,0,0
"United States of America","2024-03-26",0,63,824,0,9,824,0,0
"United States of America","2024-03-27",0,0,824,0,7,831,0,0
"United States of America","2024-03-28",0,0,824,0,6,837,0,0
"United States of America","2024-03-29",0,0,824,0,7,844,0,0
"United States of America","2024-03-30",0,0,824,0,7,851,0,0
"United States of America","2024-03-31",0,0,824,0,7,858,0,0
"United States of America","2024-04-01",0,0,824,0,6,864,0,0
"United States of America","2024-04-02",0,47,871,0,7,871,0,0
"United States of America","2024-04-03",0,0,871,0,10,881,0,0
"United States of America","2024-04-04",0,0,871,0,9,890,0,0
"United States of America","2024-04-05",0,0,871,0,10,900,0,0
"United States of America","2024-04-06",0,0,871,0,10,910,0,0
"United States of America","2024-04-07",0,0,871,0,10,920,0,0
"United States of America","2024-04-08",0,0,871,0,9,929,0,0
"United States of America","2024-04-09",0,68,939,0,10,939,0,0
"United States of America","2024-04-10",0,0,939,0,11,950,0,0
"United States of America","2024-04-11",0,0,939,0,11,961,0,0
"United States of America","2024-04-12",0,0,939,0,11,972,0,0
"United States of America","2024-04-13",0,0,939,0,11,983,0,0
"United States of America","2024-04-14",0,0,939,0,11,994,0,0
"United States of America","2024-04-15",0,0,939,0,11,1005,0,0
"United States of America","2024-04-16",0,77,1016,0,11,1016,0,0
"United States of America","2024-04-17",0,0,1016,0,11,1027,0,0
"United States of America","2024-04-18",0,0,1016,0,12,1039,0,0
"United States of America","2024-04-19",0,0,1016,0,11,1050,0,0
"United States of America","2024-04-20",0,0,1016,0,11,1061,0,0
"United States of America","2024-04-21",0,0,1016,0,11,1072,0,0
"United States of America","2024-04-22",0,0,1016,0,12,1084,0,0
"United States of America","2024-04-23",0,79,1095,0,11,1095,0,0
"United States of America","2024-04-24",0,0,1095,0,7,1102,0,0
"United States of America","2024-04-25",0,0,1095,0,8,1110,0,0
"United States of America","2024-04-26",0,0,1095,0,7,1117,0,0
"United States of America","2024-04-27",0,0,1095,0,8,1125,0,0
"United States of America","2024-04-28",0,0,1095,0,7,1132,0,0
"United States of America","2024-04-29",0,0,1095,0,8,1140,0,0
"United States of America","2024-04-30",0,52,1147,0,7,1147,0,0
"United States of America","2024-05-01",0,0,1147,0,8,1155,0,0
"United States of America","2024-05-02",0,0,1147,0,7,1162,0,0
"United States of America","2024-05-03",0,0,1147,0,8,1170,0,0
"United States of America","2024-05-04",0,0,1147,0,8,1178,0,0
"United States of America","2024-05-05",0,0,1147,0,8,1186,0,0
"United States of America","2024-05-06",0,0,1147,0,7,1193,0,0
"United States of America","2024-05-07",0,54,1201,0,8,1201,0,0
"United States of America","2024-05-08",0,0,1201,0,7,1208,0,0
"United States of America","2024-05-09",0,0,1201,0,7,1215,0,0
"United States of America","2024-05-10",0,0,1201,0,7,1222,0,0
"United States of America","2024-05-11",0,0,1201,0,7,1229,0,0
"United States of America","2024-05-12",0,0,1201,0,7,1236,0,0
"United States of America","2024-05-13",0,0,1201,0,7,1243,0,0
"United States of America","2024-05-14",0,49,1250,0,7,1250,0,0
"United States of America","2024-05-15",0,0,1250,0,8,1258,0,0
"United States of America","2024-05-16",0,0,1250,0,9,1267,0,0
"United States of America","2024-05-17",0,0,1250,0,8,1275,0,0
"United States of America","2024-05-18",0,0,1250,0,8,1283,0,0
"United States of America","2024-05-19",0,0,1250,0,8,1291,0,0
"United States of America","2024-05-20",0,0,1250,0,9,1300,0,0
"United States of America","2024-05-21",0,58,1308,0,8,1308,0,0
"United States of America","2024-05-22",0,0,1308,0,8,1316,0,0
"United States of America","2024-05-23",0,0,1308,0,9,1325,0,0
"United States of America","2024-05-24",0,0,1308,0,8,1333,0,0
"United States of America","2024-05-25",0,0,1308,0,8,1341,0,0
"United States of America","2024-05-26",0,0,1308,0,8,1349,0,0
"United States of America","2024-05-27",0,0,1308,0,9,1358,0,0
"United States of America","2024-05-28",0,58,1366,0,8,1366,0,0
"United States of America","2024-05-29",0,0,1366,0,8,1374,0,0
"United States of America","2024-05-30",0,0,1366,0,8,1382,0,0
"United States of America","2024-05-31",0,0,1366,0,8,1390,0,0
"United States of America","2024-06-01",0,0,1366,0,8,1398,0,0
"United States of America","2024-06-02",0,0,1366,0,8,1406,0,0
"United States of America","2024-06-03",0,0,1366,0,8,1414,0,0
"United States of America","2024-06-04",0,56,1422,0,8,1422,0,0
"United States of America","2024-06-05",0,0,1422,0,10,1432,0,0
"United States of America","2024-06-06",0,0,1422,0,11,1443,0,0
"United States of America","2024-06-07",0,0,1422,0,10,1453,0,0
"United States of America","2024-06-08",0,0,1422,0,10,1463,0,0
"United States of America","2024-06-09",0,0,1422,0,10,1473,0,0
"United States of America","2024-06-10",0,0,1422,0,11,1484,0,0
"United States of America","2024-06-11",0,72,1494,0,10,1494,0,0
"United States of America","2024-06-12",0,0,1494,0,7,1501,0,0
"United States of America","2024-06-13",0,0,1494,0,7,1508,0,0
"United States of America","2024-06-14",0,0,1494,0,7,1515,0,0
"United States of America","2024-06-15",0,0,1494,0,7,1522,0,0
"United States of America","2024-06-16",0,0,1494,0,7,1529,0,0
"United States of America","2024-06-17",0,0,1494,0,7,1536,0,0
"United States of America","2024-06-18",0,49,1543,0,7,1543,0,0
"United States of America","2024-06-19",0,0,1543,0,6,1549,0,0
"United States of America","2024-06-20",0,0,1543,0,7,1556,0,0
"United States of America","2024-06-21",0,0,1543,0,6,1562,0,0
"United States of America","2024-06-22",0,0,1543,0,6,1568,0,0
"United States of America","2024-06-23",0,0,1543,0,6,1574,0,0
"United States of America","2024-06-24",0,0,1543,0,7,1581,0,0
"United States of America","2024-06-25",0,44,1587,0,6,1587,0,0
"United States of America","2024-06-26",0,0,1587,0,7,1594,0,0
"United States of America","2024-06-27",0,0,1587,0,8,1602,0,0
"United States of America","2024-06-28",0,0,1587,0,7,1609,0,0
"United States of America","2024-06-29",0,0,1587,0,7,1616,0,0
"United States of America","2024-06-30",0,0,1587,0,7,1623,0,0
"United States of America","2024-07-01",0,0,1587,0,8,1631,0,0
"United States of America","2024-07-02",0,51,1638,0,7,1638,0,0
"United States of America","2024-07-03",0,0,1638,0,7,1645,0,0
"United States of America","2024-07-04",0,0,1638,0,8,1653,0,0
"United States of America","2024-07-05",0,0,1638,0,7,1660,0,0
"United States of America","2024-07-06",0,0,1638,0,8,1668,0,0
"United States of America","2024-07-07",0,0,1638,0,7,1675,0,0
"United States of America","2024-07-08",0,0,1638,0,8,1683,0,0
"United States of America","2024-07-09",0,52,1690,0,7,1690,0,0
"United States of America","2024-07-10",0,0,1690,0,9,1699,0,0
"United States of America","2024-07-11",0,0,1690,0,9,1708,0,0
"United States of America","2024-07-12",0,0,1690,0,9,1717,0,0
"United States of America","2024-07-13",0,0,1690,0,10,1727,0,0
"United States of America","2024-07-14",0,0,1690,0,9,1736,0,0
"United States of America","2024-07-15",0,0,1690,0,9,1745,0,0
"United States of America","2024-07-16",0,64,1754,0,9,1754,0,0
"United States of America","2024-07-17",0,0,1754,0,6,1760,0,0
"United States of America","2024-07-18",0,0,1754,0,5,1765,0,0
"United States of America","2024-07-19",0,0,1754,0,6,1771,0,0
"United States of America","2024-07-20",0,0,1754,0,5,1776,0,0
"United States of America","2024-07-21",0,0,1754,0,6,1782,0,0
"United States of America","2024-07-22",0,0,1754,0,5,1787,0,0
"United States of America","2024-07-23",0,39,1793,0,6,1793,0,0
"United States of America","2024-07-24",0,0,1793,0,7,1800,0,0
"United States of America","2024-07-25",0,0,1793,0,7,1807,0,0
"United States of America","2024-07-26",0,0,1793,0,7,1814,0,0
"United States of America","2024-07-27",0,0,1793,0,8,1822,0,0
"United States of America","2024-07-28",0,0,1793,0,7,1829,0,0
"United States of America","2024-07-29",0,0,1793,0,7,1836,0,0
"United States of America","2024-07-30",0,50,1843,0,7,1843,0,0
"United States of America","2024-07-31",0,0,1843,0,7,1850,0,0
"United States of America","2024-08-01",0,0,1843,0,7,1857,0,0
"United States of America","2024-08-02",0,0,1843,0,7,1864,0,0
"United States of America","2024-08-03",0,0,1843,0,8,1872,0,0
"United States of America","2024-08-04",0,0,1843,0,7,1879,0,0
"United States of America","2024-08-05",0,0,1843,0,7,1886,0,0
"United States of America","2024-08-06",0,50,1893,0,7,1893,0,0
"United States of America","2024-08-07",0,0,1893,0,9,1902,0,0
"United States of America","2024-08-08",0,0,1893,0,10,1912,0,0
"United States of America","2024-08-09",0,0,1893,0,9,1921,0,0
"United States of America","2024-08-10",0,0,1893,0,9,1930,0,0
"United States of America","2024-08-11",0,0,1893,0,9,1939,0,0
"United States of America","2024-08-12",0,0,1893,0,10,1949,0,0
"United States of America","2024-08-13",0,65,1958,0,9,1958,0,0
"United States of America","2024-08-14",0,0,1958,0,9,1967,0,0
"United States of America","2024-08-15",0,0,1958,0,9,1976,0,0
"United States of America","2024-08-16",0,0,1958,0,9,1985,0,0
"United States of America","2024-08-17",0,0,1958,0,8,1993,0,0
"United States of America","2024-08-18",0,0,1958,0,9,2002,0,0
"United States of America","2024-08-19",0,0,1958,0,9,2011,0,0
"United States of America","2024-08-20",0,62,2020,0,9,2020,0,0
"United States of America","2024-08-21",0,0,2020,0,8,2028,0,0
"United States of America","2024-08-22",0,0,2020,0,8,2036,0,0
"United States of America","2024-08-23",0,0,2020,0,8,2044,0,0
"United States of America","2024-08-24",0,0,2020,0,7,2051,0,0
"United States of America","2024-08-25",0,0,2020,0,8,2059,0,0
"United States of America","2024-08-26",0,0,2020,0,8,2067,0,0
"United States of America","2024-08-27",0,55,2075,0,8,2075,0,0
"United States of America","2024-08-28",0,0,2075,0,9,2084,0,0
"United States of America","2024-08-29",0,0,2075,0,9,2093,0,0
"United States of America","2024-08-30",0,0,2075,0,9,2102,0,0
"United States of America","2024-08-31",0,0,2075,0,8,2110,0,0
"United States of America","2024-09-01",0,0,2075,0,9,2119,0,0
"United States of America","2024-09-02",0,0,2075,0,9,2128,0,0
"United States of America","2024-09-03",0,62,2137,0,9,2137,0,0
"United States of America","2024-09-04",0,0,2137,0,9,2146,0,0
"United States of America","2024-09-05",0,0,2137,0,9,2155,0,0
"United States of America","2024-09-06",0,0,2137,0,9,2164,0,0
"United States of America","2024-09-07",0,0,2137,0,10,2174,0,0
"United States of America","2024-09-08",0,0,2137,0,9,2183,0,0
"United States of America","2024-09-09",0,0,2137,0,9,2192,0,0
"United States of America","2024-09-10",0,64,2201,0,9,2201,0,0
"United States of America","2024-09-11",0,0,2201,0,6,2207,0,0
"United States of America","2024-09-12",0,0,2201,0,6,2213,0,0
"United States of America","2024-09-13",0,0,2201,0,6,2219,0,0
"United States of America","2024-09-14",0,0,2201,0,5,2224,0,0
"United States of America","2024-09-15",0,0,2201,0,6,2230,0,0
"United States of America","2024-09-16",0,0,2201,0,6,2236,0,0
"United States of America","2024-09-17",0,41,2242,0,6,2242,0,0
"United States of America","2024-09-18",0,0,2242,0,7,2249,0,0
"United States of America","2024-09-19",0,0,2242,0,6,2255,0,0
"United States of America","2024-09-20",0,0,2242,0,7,2262,0,0
"United States of America","2024-09-21",0,0,2242,0,7,2269,0,0
"United States of America","2024-09-22",0,0,2242,0,7,2276,0,0
"United States of America","2024-09-23",0,0,2242,0,6,2282,0,0
"United States of America","2024-09-24",0,47,2289,0,7,2289,0,0
"United States of America","2024-09-25",0,0,2289,0,5,2294,0,0
"United States of America","2024-09-26",0,0,2289,0,6,2300,0,0
"United States of America","2024-09-27",0,0,2289,0,5,2305,0,0
"United States of America","2024-09-28",0,0,2289,0,5,2310,0,0
"United States of America","2024-09-29",0,0,2289,0,5,2315,0,0
"United States of America","2024-09-30",0,0,2289,0,6,2321,0,0
"United States of America","2024-10-01",0,37,2326,0,5,2326,0,0
"United States of America","2024-10-02",0,0,2326,0,3,2329,0,0
"United States of America","2024-10-03",0,0,2326,0,4,2333,0,0
"United States of America","2024-10-04",0,0,2326,0,3,2336,0,0
"United States of America","2024-10-05",0,0,2326,0,4,2340,0,0
"United States of America","2024-10-06",0,0,2326,0,3,2343,0,0
"United States of America","2024-10-07",0,0,2326,0,4,2347,0,0
"United States of America","2024-10-08",0,24,2350,0,3,2350,0,0
"United States of America","2024-10-09",0,0,2350,0,1,2351,0,0
"United States of America","2024-10-10",0,0,2350,0,1,2352,0,0
"United States of America","2024-10-11",0,0,2350,0,1,2353,0,0
"United States of America","2024-10-12",0,0,2350,0,2,2355,0,0
"United States of America","2024-10-13",0,0,2350,0,1,2356,0,0
"United States of America","2024-10-14",0,0,2350,0,1,2357,0,0
"United States of America","2024-10-15",0,8,2358,0,1,2358,0,0
"United States of America","2024-10-16",0,0,2358,0,1,2359,0,0
"United States of America","2024-10-17",0,0,2358,0,2,2361,0,0
"United States of America","2024-10-18",0,0,2358,0,1,2362,0,0
"United States of America","2024-10-19",0,0,2358,0,2,2364,0,0
"United States of America","2024-10-20",0,0,2358,0,1,2365,0,0
"United States of America","2024-10-21",0,0,2358,0,2,2367,0,0
"United States of America","2024-10-22",0,10,2368,0,1,2368,0,0
"United States of America","2024-10-23",0,0,2368,0,0,2368,0,0
"United States of America","2024-10-24",0,0,2368,0,1,2369,0,0
"United States of America","2024-10-25",0,0,2368,0,0,2369,0,0
"United States of America","2024-10-26",0,0,2368,0,1,2370,0,0
"United States of America","2024-10-27",0,0,2368,0,0,2370,0,0
"United States of America","2024-10-28",0,0,2368,0,1,2371,0,0
"United States of America","2024-10-29",0,3,2371,0,0,2371,0,0
"United States of America","2024-10-30",0,0,2371,0,0,2371,0,0
"United States of America","2024-10-31",0,0,2371,0,0,2371,0,0
"United States of America","2024-11-01",0,0,2371,0,0,2371,0,0
"United States of America","2024-11-02",0,0,2371,0,0,2371,0,0
"United States of America","2024-11-03",0,0,2371,0,0,2371,0,0
"United States of America","2024-11-04",0,0,2371,0,0,2371,0,0
"United States of America","2024-11-05",0,0,2371,0,0,2371,0,0
"United States of America","2024-11-06",0,0,2371,0,0,2371,0,0
"United States of America","2024-11-07",0,0,2371,0,0,2371,0,0
"United States of America","2024-11-08",0,0,2371,0,0,2371,0,0
"United States of America","2024-11-09",0,0,2371,0,0,2371,0,0
"United States of America","2024-11-10",0,0,2371,0,0,2371,0,0
"United States of America","2024-11-11",0,0,2371,0,0,2371,0,0
"United States of America","2024-11-12",0,0,2371,0,0,2371,0,0
"United States of America","2024-11-13",0,0,2371,0,0,2371,0,0
"United States of America","2024-11-14",0,0,2371,0,0,2371,0,0
"United States of America","2024-11-15",0,0,2371,0,0,2371,0,0
"United States of America","2024-11-16",0,0,2371,0,0,2371,0,0
"United States of America","2024-11-17",0,0,2371,0,0,2371,0,0
"United States of America","2024-11-18",0,0,2371,0,0,2371,0,0
"United States of America","2024-11-19",0,0,2371,0,0,2371,0,0
"United States of America","2024-11-20",0,0,2371,0,0,2371,0,0
"United States of America","2024-11-21",0,0,2371,0,0,2371,0,0
"United States of America","2024-11-22",0,0,2371,0,0,2371,0,0
"United States of America","2024-11-23",0,0,2371,0,0,2371,0,0
"United States of America","2024-11-24",0,0,2371,0,0,2371,0,0
"United States of America","2024-11-25",0,0,2371,0,0,2371,0,0
"United States of America","2024-11-26",0,0,2371,0,0,2371,0,0
"United States of America","2024-11-27",0,0,2371,0,0,2371,0,0
"United States of America","2024-11-28",0,0,2371,0,0,2371,0,0
"United States of America","2024-11-29",0,0,2371,0,0,2371,0,0
"United States of America","2024-11-30",0,0,2371,0,0,2371,0,0
"United States of America","2024-12-01",0,0,2371,0,0,2371,0,0
"United States of America","2024-12-02",0,0,2371,0,0,2371,0,0
"United States of America","2024-12-03",0,0,2371,0,0,2371,0,0
"United States of America","2024-12-04",0,0,2371,0,0,2371,0,0
"United States of America","2024-12-05",0,0,2371,0,0,2371,0,0
"United States of America","2024-12-06",0,0,2371,0,0,2371,0,0
"United States of America","2024-12-07",0,0,2371,0,0,2371,0,0
"United States of America","2024-12-08",0,0,2371,0,0,2371,0,0
"United States of America","2024-12-09",0,0,2371,0,0,2371,0,0
"Uruguay","2024-01-01",0,0,0,0,0,0,0,0
"Uruguay","2024-01-02",0,0,0,0,0,0,0,0
"Uruguay","2024-01-03",0,0,0,0,0,0,0,0
"Uruguay","2024-01-04",0,0,0,0,0,0,0,0
"Uruguay","2024-01-05",0,0,0,0,0,0,0,0
"Uruguay","2024-01-06",0,0,0,0,0,0,0,0
"Uruguay","2024-01-07",0,0,0,0,0,0,0,0
"Uruguay","2024-01-08",0,0,0,0,0,0,0,0
"Uruguay","2024-01-09",0,0,0,0,0,0,0,0
"Uruguay","2024-01-10",0,0,0,0,0,0,0,0
"Uruguay","2024-01-11",0,0,0,0,0,0,0,0
"Uruguay","2024-01-12",0,0,0,0,0,0,0,0
"Uruguay","2024-01-13",0,0,0,0,0,0,0,0
"Uruguay","2024-01-14",0,0,0,0,0,0,0,0
"Uruguay","2024-01-15",0,0,0,0,0,0,0,0
"Uruguay","2024-01-16",0,0,0,0,0,0,0,0
"Uruguay","2024-01-17",0,0,0,0,0,0,0,0
"Uruguay","2024-01-18",0,0,0,0,0,0,0,0
"Uruguay","2024-01-19",0,0,0,0,0,0,0,0
"Uruguay","2024-01-20",0,0,0,0,0,0,0,0
"Uruguay","2024-01-21",0,0,0,0,0,0,0,0
"Uruguay","2024-01-22",0,0,0,0,0,0,0,0
"Uruguay","2024-01-23",0,0,0,0,0,0,0,0
"Uruguay","2024-01-24",0,0,0,0,0,0,0,0
"Uruguay","2024-01-25",0,0,0,0,0,0,0,0
"Uruguay","2024-01-26",0,0,0,0,0,0,0,0
"Uruguay","2024-01-27",0,0,0,0,0,0,0,0
"Uruguay","2024-01-28",0,0,0,0,0,0,0,0
"Uruguay","2024-01-29",0,0,0,0,0,0,0,0
"Uruguay","2024-01-30",0,0,0,0,0,0,0,0
"Uruguay","2024-01-31",0,0,0,0,0,0,0,0
"Uruguay","2024-02-01",0,0,0,0,0,0,0,0
"Uruguay","2024-02-02",0,0,0,0,0,0,0,0
"Uruguay","2024-02-03",0,0,0,0,0,0,0,0
"Uruguay","2024-02-04",0,0,0,0,0,0,0,0
"Uruguay","2024-02-05",0,0,0,0,0,0,0,0
"Uruguay","2024-02-06",0,0,0,0,0,0,0,0
"Uruguay","2024-02-07",0,0,0,0,0,0,0,0
"Uruguay","2024-02-08",0,0,0,0,0,0,0,0
"Uruguay","2024-02-09",0,0,0,0,0,0,0,0
"Uruguay","2024-02-10",0,0,0,0,0,0,0,0
"Uruguay","2024-02-11",0,0,0,0,0,0,0,0
"Uruguay","2024-02-12",0,0,0,0,0,0,0,0
"Uruguay","2024-02-13",0,0,0,0,0,0,0,0
"Uruguay","2024-02-14",0,0,0,0,0,0,0,0
"Uruguay","2024-02-15",0,0,0,0,0,0,0,0
"Uruguay","2024-02-16",0,0,0,0,0,0,0,0
"Uruguay","2024-02-17",0,0,0,0,0,0,0,0
"Uruguay","2024-02-18",0,0,0,0,0,0,0,0
"Uruguay","2024-02-19",0,0,0,0,0,0,0,0
"Uruguay","2024-02-20",0,0,0,0,0,0,0,0
"Uruguay","2024-02-21",0,0,0,0,0,0,0,0
"Uruguay","2024-02-22",0,0,0,0,0,0,0,0
"Uruguay","2024-02-23",0,0,0,0,0,0,0,0
"Uruguay","2024-02-24",0,0,0,0,0,0,0,0
"Uruguay","2024-02-25",0,0,0,0,0,0,0,0
"Uruguay","2024-02-26",0,0,0,0,0,0,0,0
"Uruguay","2024-02-27",0,0,0,0,0,0,0,0
"Uruguay","2024-02-28",0,0,0,0,0,0,0,0
"Uruguay","2024-02-29",0,0,0,0,0,0,0,0
"Uruguay","2024-03-01",0,0,0,0,0,0,0,0
"Uruguay","2024-03-02",0,0,0,0,0,0,0,0
"Uruguay","2024-03-03",0,0,0,0,0,0,0,0
"Uruguay","2024-03-04",0,0,0,0,0,0,0,0
"Uruguay","2024-03-05",0,0,0,0,0,0,0,0
"Uruguay","2024-03-06",0,0,0,0,0,0,0,0
"Uruguay","2024-03-07",0,0,0,0,0,0,0,0
"Uruguay","2024-03-08",0,0,0,0,0,0,0,0
"Uruguay","2024-03-09",0,0,0,0,0,0,0,0
"Uruguay","2024-03-10",0,0,0,0,0,0,0,0
"Uruguay","2024-03-11",0,0,0,0,0,0,0,0
"Uruguay","2024-03-12",0,0,0,0,0,0,0,0
"Uruguay","2024-03-13",0,0,0,0,0,0,0,0
"Uruguay","2024-03-14",0,0,0,0,0,0,0,0
"Uruguay","2024-03-15",0,0,0,0,0,0,0,0
"Uruguay","2024-03-16",0,0,0,0,0,0,0,0
"Uruguay","2024-03-17",0,0,0,0,0,0,0,0
"Uruguay","2024-03-18",0,0,0,0,0,0,0,0
"Uruguay","2024-03-19",0,0,0,0,0,0,0,0
"Uruguay","2024-03-20",0,0,0,0,0,0,0,0
"Uruguay","2024-03-21",0,0,0,0,0,0,0,0
"Uruguay","2024-03-22",0,0,0,0,0,0,0,0
"Uruguay","2024-03-23",0,0,0,0,0,0,0,0
"Uruguay","2024-03-24",0,0,0,0,0,0,0,0
"Uruguay","2024-03-25",0,0,0,0,0,0,0,0
"Uruguay","2024-03-26",0,0,0,0,0,0,0,0
"Uruguay","2024-03-27",0,0,0,0,0,0,0,0
"Uruguay","2024-03-28",0,0,0,0,0,0,0,0
"Uruguay","2024-03-29",0,0,0,0,0,0,0,0
"Uruguay","2024-03-30",0,0,0,0,0,0,0,0
"Uruguay","2024-03-31",0,0,0,0,0,0,0,0
"Uruguay","2024-04-01",0,0,0,0,0,0,0,0
"Uruguay","2024-04-02",0,0,0,0,0,0,0,0
"Uruguay","2024-04-03",0,0,0,0,0,0,0,0
"Uruguay","2024-04-04",0,0,0,0,0,0,0,0
"Uruguay","2024-04-05",0,0,0,0,0,0,0,0
"Uruguay","2024-04-06",0,0,0,0,0,0,0,0
"Uruguay","2024-04-07",0,0,0,0,0,0,0,0
"Uruguay","2024-04-08",0,0,0,0,0,0,0,0
"Uruguay","2024-04-09",0,0,0,0,0,0,0,0
"Uruguay","2024-04-10",0,0,0,0,0,0,0,0
"Uruguay","2024-04-11",0,0,0,0,0,0,0,0
"Uruguay","2024-04-12",0,0,0,0,0,0,0,0
"Uruguay","2024-04-13",0,0,0,0,0,0,0,0
"Uruguay","2024-04-14",0,0,0,0,0,0,0,0
"Uruguay","2024-04-15",0,0,0,0,0,0,0,0
"Uruguay","2024-04-16",0,0,0,0,0,0,0,0
"Uruguay","2024-04-17",0,0,0,0,0,0,0,0
"Uruguay","2024-04-18",0,0,0,0,0,0,0,0
"Uruguay","2024-04-19",0,0,0,0,0,0,0,0
"Uruguay","2024-04-20",0,0,0,0,0,0,0,0
"Uruguay","2024-04-21",0,0,0,0,0,0,0,0
"Uruguay","2024-04-22",0,0,0,0,0,0,0,0
"Uruguay","2024-04-23",0,0,0,0,0,0,0,0
"Uruguay","2024-04-24",0,0,0,0,0,0,0,0
"Uruguay","2024-04-25",0,0,0,0,0,0,0,0
"Uruguay","2024-04-26",0,0,0,0,0,0,0,0
"Uruguay","2024-04-27",0,0,0,0,0,0,0,0
"Uruguay","2024-04-28",0,0,0,0,0,0,0,0
"Uruguay","2024-04-29",0,0,0,0,0,0,0,0
"Uruguay","2024-04-30",0,0,0,0,0,0,0,0
"Uruguay","2024-05-01",0,0,0,0,0,0,0,0
"Uruguay","2024-05-02",0,0,0,0,0,0,0,0
"Uruguay","2024-05-03",0,0,0,0,0,0,0,0
"Uruguay","2024-05-04",0,0,0,0,0,0,0,0
"Uruguay","2024-05-05",0,0,0,0,0,0,0,0
"Uruguay","2024-05-06",0,0,0,0,0,0,0,0
"Uruguay","2024-05-07",0,0,0,0,0,0,0,0
"Uruguay","2024-05-08",0,0,0,0,0,0,0,0
"Uruguay","2024-05-09",0,0,0,0,0,0,0,0
"Uruguay","2024-05-10",0,0,0,0,0,0,0,0
"Uruguay","2024-05-11",0,0,0,0,0,0,0,0
"Uruguay","2024-05-12",0,0,0,0,0,0,0,0
"Uruguay","2024-05-13",0,0,0,0,0,0,0,0
"Uruguay","2024-05-14",0,0,0,0,0,0,0,0
"Uruguay","2024-05-15",0,0,0,0,0,0,0,0
"Uruguay","2024-05-16",0,0,0,0,0,0,0,0
"Uruguay","2024-05-17",0,0,0,0,0,0,0,0
"Uruguay","2024-05-18",0,0,0,0,0,0,0,0
"Uruguay","2024-05-19",0,0,0,0,0,0,0,0
"Uruguay","2024-05-20",0,0,0,0,0,0,0,0
"Uruguay","2024-05-21",0,0,0,0,0,0,0,0
"Uruguay","2024-05-22",0,0,0,0,0,0,0,0
"Uruguay","2024-05-23",0,0,0,0,0,0,0,0
"Uruguay","2024-05-24",0,0,0,0,0,0,0,0
"Uruguay","2024-05-25",0,0,0,0,0,0,0,0
"Uruguay","2024-05-26",0,0,0,0,0,0,0,0
"Uruguay","2024-05-27",0,0,0,0,0,0,0,0
"Uruguay","2024-05-28",0,0,0,0,0,0,0,0
"Uruguay","2024-05-29",0,0,0,0,0,0,0,0
"Uruguay","2024-05-30",0,0,0,0,0,0,0,0
"Uruguay","2024-05-31",0,0,0,0,0,0,0,0
"Uruguay","2024-06-01",0,0,0,0,0,0,0,0
"Uruguay","2024-06-02",0,0,0,0,0,0,0,0
"Uruguay","2024-06-03",0,0,0,0,0,0,0,0
"Uruguay","2024-06-04",0,0,0,0,0,0,0,0
"Uruguay","2024-06-05",0,0,0,0,0,0,0,0
"Uruguay","2024-06-06",0,0,0,0,0,0,0,0
"Uruguay","2024-06-07",0,0,0,0,0,0,0,0
"Uruguay","2024-06-08",0,0,0,0,0,0,0,0
"Uruguay","2024-06-09",0,0,0,0,0,0,0,0
"Uruguay","2024-06-10",0,0,0,0,0,0,0,0
"Uruguay","2024-06-11",0,0,0,0,0,0,0,0
"Uruguay","2024-06-12",0,0,0,0,0,0,0,0
"Uruguay","2024-06-13",0,0,0,0,0,0,0,0
"Uruguay","2024-06-14",0,0,0,0,0,0,0,0
"Uruguay","2024-06-15",0,0,0,0,0,0,0,0
"Uruguay","2024-06-16",0,0,0,0,0,0,0,0
"Uruguay","2024-06-17",0,0,0,0,0,0,0,0
"Uruguay","2024-06-18",0,0,0,0,0,0,0,0
"Uruguay","2024-06-19",0,0,0,0,0,0,0,0
"Uruguay","2024-06-20",0,0,0,0,0,0,0,0
"Uruguay","2024-06-21",0,0,0,0,0,0,0,0
"Uruguay","2024-06-22",0,0,0,0,0,0,0,0
"Uruguay","2024-06-23",0,0,0,0,0,0,0,0
"Uruguay","2024-06-24",0,0,0,0,0,0,0,0
"Uruguay","2024-06-25",0,0,0,0,0,0,0,0
"Uruguay","2024-06-26",0,0,0,0,0,0,0,0
"Uruguay","2024-06-27",0,0,0,0,0,0,0,0
"Uruguay","2024-06-28",0,0,0,0,0,0,0,0
"Uruguay","2024-06-29",0,0,0,0,0,0,0,0
"Uruguay","2024-06-30",0,0,0,0,0,0,0,0
"Uruguay","2024-07-01",0,0,0,0,0,0,0,0
"Uruguay","2024-07-02",0,0,0,0,0,0,0,0
"Uruguay","2024-07-03",0,0,0,0,0,0,0,0
"Uruguay","2024-07-04",0,0,0,0,0,0,0,0
"Uruguay","2024-07-05",0,0,0,0,0,0,0,0
"Uruguay","2024-07-06",0,0,0,0,0,0,0,0
"Uruguay","2024-07-07",0,0,0,0,0,0,0,0
"Uruguay","2024-07-08",0,0,0,0,0,0,0,0
"Uruguay","2024-07-09",0,0,0,0,0,0,0,0
"Uruguay","2024-07-10",0,0,0,0,0,0,0,0
"Uruguay","2024-07-11",0,0,0,0,0,0,0,0
"Uruguay","2024-07-12",0,0,0,0,0,0,0,0
"Uruguay","2024-07-13",0,0,0,0,0,0,0,0
"Uruguay","2024-07-14",0,0,0,0,0,0,0,0
"Uruguay","2024-07-15",0,0,0,0,0,0,0,0
"Uruguay","2024-07-16",0,0,0,0,0,0,0,0
"Uruguay","2024-07-17",0,0,0,0,0,0,0,0
"Uruguay","2024-07-18",0,0,0,0,0,0,0,0
"Uruguay","2024-07-19",0,0,0,0,0,0,0,0
"Uruguay","2024-07-20",0,0,0,0,0,0,0,0
"Uruguay","2024-07-21",0,0,0,0,0,0,0,0
"Uruguay","2024-07-22",0,0,0,0,0,0,0,0
"Uruguay","2024-07-23",0,0,0,0,0,0,0,0
"Uruguay","2024-07-24",0,0,0,0,0,0,0,0
"Uruguay","2024-07-25",0,0,0,0,0,0,0,0
"Uruguay","2024-07-26",0,0,0,0,0,0,0,0
"Uruguay","2024-07-27",0,0,0,0,0,0,0,0
"Uruguay","2024-07-28",0,0,0,0,0,0,0,0
"Uruguay","2024-07-29",0,0,0,0,0,0,0,0
"Uruguay","2024-07-30",0,0,0,0,0,0,0,0
"Uruguay","2024-07-31",0,0,0,0,0,0,0,0
"Uruguay","2024-08-01",0,0,0,0,0,0,0,0
"Uruguay","2024-08-02",0,0,0,0,0,0,0,0
"Uruguay","2024-08-03",0,0,0,0,0,0,0,0
"Uruguay","2024-08-04",0,0,0,0,0,0,0,0
"Uruguay","2024-08-05",0,0,0,0,0,0,0,0
"Uruguay","2024-08-06",0,0,0,0,0,0,0,0
"Uruguay","2024-08-07",0,0,0,0,0,0,0,0
"Uruguay","2024-08-08",0,0,0,0,0,0,0,0
"Uruguay","2024-08-09",0,0,0,0,0,0,0,0
"Uruguay","2024-08-10",0,0,0,0,0,0,0,0
"Uruguay","2024-08-11",0,0,0,0,0,0,0,0
"Uruguay","2024-08-12",0,0,0,0,0,0,0,0
"Uruguay","2024-08-13",0,0,0,0,0,0,0,0
"Uruguay","2024-08-14",0,0,0,0,0,0,0,0
"Uruguay","2024-08-15",0,0,0,0,0,0,0,0
"Uruguay","2024-08-16",0,0,0,0,0,0,0,0
"Uruguay","2024-08-17",0,0,0,0,0,0,0,0
"Uruguay","2024-08-18",0,0,0,0,0,0,0,0
"Uruguay","2024-08-19",0,0,0,0,0,0,0,0
"Uruguay","2024-08-20",0,0,0,0,0,0,0,0
"Uruguay","2024-08-21",0,0,0,0,0,0,0,0
"Uruguay","2024-08-22",0,0,0,0,0,0,0,0
"Uruguay","2024-08-23",0,0,0,0,0,0,0,0
"Uruguay","2024-08-24",0,0,0,0,0,0,0,0
"Uruguay","2024-08-25",0,0,0,0,0,0,0,0
"Uruguay","2024-08-26",0,0,0,0,0,0,0,0
"Uruguay","2024-08-27",0,0,0,0,0,0,0,0
"Uruguay","2024-08-28",0,0,0,0,0,0,0,0
"Uruguay","2024-08-29",0,0,0,0,0,0,0,0
"Uruguay","2024-08-30",0,0,0,0,0,0,0,0
"Uruguay","2024-08-31",0,0,0,0,0,0,0,0
"Uruguay","2024-09-01",0,0,0,0,0,0,0,0
"Uruguay","2024-09-02",0,0,0,0,0,0,0,0
"Uruguay","2024-09-03",0,0,0,0,0,0,0,0
"Uruguay","2024-09-04",0,0,0,0,0,0,0,0
"Uruguay","2024-09-05",0,0,0,0,0,0,0,0
"Uruguay","2024-09-06",0,0,0,0,0,0,0,0
"Uruguay","2024-09-07",0,0,0,0,0,0,0,0
"Uruguay","2024-09-08",0,0,0,0,0,0,0,0
"Uruguay","2024-09-09",0,0,0,0,0,0,0,0
"Uruguay","2024-09-10",0,0,0,0,0,0,0,0
"Uruguay","2024-09-11",0,0,0,0,0,0,0,0
"Uruguay","2024-09-12",0,0,0,0,0,0,0,0
"Uruguay","2024-09-13",0,0,0,0,0,0,0,0
"Uruguay","2024-09-14",0,0,0,0,0,0,0,0
"Uruguay","2024-09-15",0,0,0,0,0,0,0,0
"Uruguay","2024-09-16",0,0,0,0,0,0,0,0
"Uruguay","2024-09-17",0,0,0,0,0,0,0,0
"Uruguay","2024-09-18",0,0,0,0,0,0,0,0
"Uruguay","2024-09-19",0,0,0,0,0,0,0,0
"Uruguay","2024-09-20",0,0,0,0,0,0,0,0
"Uruguay","2024-09-21",0,0,0,0,0,0,0,0
"Uruguay","2024-09-22",0,0,0,0,0,0,0,0
"Uruguay","2024-09-23",0,0,0,0,0,0,0,0
"Uruguay","2024-09-24",0,1,1,0,1,1,0,0
"Uruguay","2024-09-25",0,0,1,0,0,1,0,0
"Uruguay","2024-09-26",0,0,1,0,0,1,0,0
"Uruguay","2024-09-27",0,0,1,0,0,1,0,0
"Uruguay","2024-09-28",0,0,1,0,0,1,0,0
"Uruguay","2024-09-29",0,0,1,0,0,1,0,0
"Uruguay","2024-09-30",0,0,1,0,0,1,0,0
"Uruguay","2024-10-01",0,0,1,0,0,1,0,0
"Uruguay","2024-10-02",0,0,1,0,0,1,0,0
"Uruguay","2024-10-03",0,0,1,0,0,1,0,0
"Uruguay","2024-10-04",0,0,1,0,0,1,0,0
"Uruguay","2024-10-05",0,0,1,0,0,1,0,0
"Uruguay","2024-10-06",0,0,1,0,0,1,0,0
"Uruguay","2024-10-07",0,0,1,0,0,1,0,0
"Uruguay","2024-10-08",0,0,1,0,0,1,0,0
"Uruguay","2024-10-09",0,0,1,0,0,1,0,0
"Uruguay","2024-10-10",0,0,1,0,0,1,0,0
"Uruguay","2024-10-11",0,0,1,0,0,1,0,0
"Uruguay","2024-10-12",0,0,1,0,0,1,0,0
"Uruguay","2024-10-13",0,0,1,0,0,1,0,0
"Uruguay","2024-10-14",0,0,1,0,0,1,0,0
"Uruguay","2024-10-15",0,0,1,0,0,1,0,0
"Uruguay","2024-10-16",0,0,1,0,0,1,0,0
"Uruguay","2024-10-17",0,0,1,0,0,1,0,0
"Uruguay","2024-10-18",0,0,1,0,0,1,0,0
"Uruguay","2024-10-19",0,0,1,0,0,1,0,0
"Uruguay","2024-10-20",0,0,1,0,0,1,0,0
"Uruguay","2024-10-21",0,0,1,0,0,1,0,0
"Uruguay","2024-10-22",0,0,1,0,0,1,0,0
"Uruguay","2024-10-23",0,0,1,0,0,1,0,0
"Uruguay","2024-10-24",0,0,1,0,0,1,0,0
"Uruguay","2024-10-25",0,0,1,0,0,1,0,0
"Uruguay","2024-10-26",0,0,1,0,0,1,0,0
"Uruguay","2024-10-27",0,0,1,0,0,1,0,0
"Uruguay","2024-10-28",0,0,1,0,0,1,0,0
"Uruguay","2024-10-29",0,0,1,0,0,1,0,0
"Uruguay","2024-10-30",0,0,1,0,0,1,0,0
"Uruguay","2024-10-31",0,0,1,0,0,1,0,0
"Uruguay","2024-11-01",0,0,1,0,0,1,0,0
"Uruguay","2024-11-02",0,0,1,0,0,1,0,0
"Uruguay","2024-11-03",0,0,1,0,0,1,0,0
"Uruguay","2024-11-04",0,0,1,0,0,1,0,0
"Uruguay","2024-11-05",0,0,1,0,0,1,0,0
"Uruguay","2024-11-06",0,0,1,0,0,1,0,0
"Uruguay","2024-11-07",0,0,1,0,0,1,0,0
"Uruguay","2024-11-08",0,0,1,0,0,1,0,0
"Uruguay","2024-11-09",0,0,1,0,0,1,0,0
"Uruguay","2024-11-10",0,0,1,0,0,1,0,0
"Uruguay","2024-11-11",0,0,1,0,0,1,0,0
"Uruguay","2024-11-12",0,0,1,0,0,1,0,0
"Uruguay","2024-11-13",0,0,1,0,0,1,0,0
"Uruguay","2024-11-14",0,0,1,0,0,1,0,0
"Uruguay","2024-11-15",0,0,1,0,0,1,0,0
"Uruguay","2024-11-16",0,0,1,0,0,1,0,0
"Uruguay","2024-11-17",0,0,1,0,0,1,0,0
"Uruguay","2024-11-18",0,0,1,0,0,1,0,0
"Uruguay","2024-11-19",0,0,1,0,0,1,0,0
"Uruguay","2024-11-20",0,0,1,0,0,1,0,0
"Uruguay","2024-11-21",0,0,1,0,0,1,0,0
"Uruguay","2024-11-22",0,0,1,0,0,1,0,0
"Uruguay","2024-11-23",0,0,1,0,0,1,0,0
"Uruguay","2024-11-24",0,0,1,0,0,1,0,0
"Uruguay","2024-11-25",0,0,1,0,0,1,0,0
"Uruguay","2024-11-26",0,0,1,0,0,1,0,0
"Uruguay","2024-11-27",0,0,1,0,0,1,0,0
"Uruguay","2024-11-28",0,0,1,0,0,1,0,0
"Uruguay","2024-11-29",0,0,1,0,0,1,0,0
"Uruguay","2024-11-30",0,0,1,0,0,1,0,0
"Uruguay","2024-12-01",0,0,1,0,0,1,0,0
"Uruguay","2024-12-02",0,0,1,0,0,1,0,0
"Uruguay","2024-12-03",0,0,1,0,0,1,0,0
"Uruguay","2024-12-04",0,0,1,0,0,1,0,0
"Uruguay","2024-12-05",0,0,1,0,0,1,0,0
"Uruguay","2024-12-06",0,0,1,0,0,1,0,0
"Uruguay","2024-12-07",0,0,1,0,0,1,0,0
"Uruguay","2024-12-08",0,0,1,0,0,1,0,0
"Uruguay","2024-12-09",0,0,1,0,0,1,0,0
"Venezuela (Bolivarian Republic of)","2024-01-01",0,0,0,0,0,0,0,0
"Venezuela (Bolivarian Republic of)","2024-01-02",0,0,0,0,0,0,0,0
"Venezuela (Bolivarian Republic of)","2024-01-03",0,0,0,0,0,0,0,0
"Venezuela (Bolivarian Republic of)","2024-01-04",0,0,0,0,0,0,0,0
"Venezuela (Bolivarian Republic of)","2024-01-05",0,0,0,0,0,0,0,0
"Venezuela (Bolivarian Republic of)","2024-01-06",0,0,0,0,0,0,0,0
"Venezuela (Bolivarian Republic of)","2024-01-07",0,0,0,0,0,0,0,0
"Venezuela (Bolivarian Republic of)","2024-01-08",0,0,0,0,0,0,0,0
"Venezuela (Bolivarian Republic of)","2024-01-09",0,0,0,0,0,0,0,0
"Venezuela (Bolivarian Republic of)","2024-01-10",0,0,0,0,0,0,0,0
"Venezuela (Bolivarian Republic of)","2024-01-11",0,0,0,0,0,0,0,0
"Venezuela (Bolivarian Republic of)","2024-01-12",0,0,0,0,0,0,0,0
"Venezuela (Bolivarian Republic of)","2024-01-13",0,0,0,0,0,0,0,0
"Venezuela (Bolivarian Republic of)","2024-01-14",0,0,0,0,0,0,0,0
"Venezuela (Bolivarian Republic of)","2024-01-15",0,0,0,0,0,0,0,0
"Venezuela (Bolivarian Republic of)","2024-01-16",0,0,0,0,0,0,0,0
"Venezuela (Bolivarian Republic of)","2024-01-17",0,0,0,0,0,0,0,0
"Venezuela (Bolivarian Republic of)","2024-01-18",0,0,0,0,0,0,0,0
"Venezuela (Bolivarian Republic of)","2024-01-19",0,0,0,0,0,0,0,0
"Venezuela (Bolivarian Republic of)","2024-01-20",0,0,0,0,0,0,0,0
"Venezuela (Bolivarian Republic of)","2024-01-21",0,0,0,0,0,0,0,0
"Venezuela (Bolivarian Republic of)","2024-01-22",0,0,0,0,0,0,0,0
"Venezuela (Bolivarian Republic of)","2024-01-23",0,0,0,0,0,0,0,0
"Venezuela (Bolivarian Republic of)","2024-01-24",0,0,0,0,0,0,0,0
"Venezuela (Bolivarian Republic of)","2024-01-25",0,0,0,0,0,0,0,0
"Venezuela (Bolivarian Republic of)","2024-01-26",0,0,0,0,0,0,0,0
"Venezuela (Bolivarian Republic of)","2024-01-27",0,0,0,0,0,0,0,0
"Venezuela (Bolivarian Republic of)","2024-01-28",0,0,0,0,0,0,0,0
"Venezuela (Bolivarian Republic of)","2024-01-29",0,0,0,0,0,0,0,0
"Venezuela (Bolivarian Republic of)","2024-01-30",0,0,0,0,0,0,0,0
"Venezuela (Bolivarian Republic of)","2024-01-31",0,0,0,0,0,0,0,0
"Venezuela (Bolivarian Republic of)","2024-02-01",0,0,0,0,0,0,0,0
"Venezuela (Bolivarian Republic of)","2024-02-02",0,0,0,0,0,0,0,0
"Venezuela (Bolivarian Republic of)","2024-02-03",0,0,0,0,0,0,0,0
"Venezuela (Bolivarian Republic of)","2024-02-04",0,0,0,0,0,0,0,0
"Venezuela (Bolivarian Republic of)","2024-02-05",0,0,0,0,0,0,0,0
"Venezuela (Bolivarian Republic of)","2024-02-06",0,0,0,0,0,0,0,0
"Venezuela (Bolivarian Republic of)","2024-02-07",0,0,0,0,0,0,0,0
"Venezuela (Bolivarian Republic of)","2024-02-08",0,0,0,0,0,0,0,0
"Venezuela (Bolivarian Republic of)","2024-02-09",0,0,0,0,0,0,0,0
"Venezuela (Bolivarian Republic of)","2024-02-10",0,0,0,0,0,0,0,0
"Venezuela (Bolivarian Republic of)","2024-02-11",0,0,0,0,0,0,0,0
"Venezuela (Bolivarian Republic of)","2024-02-12",0,0,0,0,0,0,0,0
"Venezuela (Bolivarian Republic of)","2024-02-13",0,0,0,0,0,0,0,0
"Venezuela (Bolivarian Republic of)","2024-02-14",0,0,0,0,0,0,0,0
"Venezuela (Bolivarian Republic of)","2024-02-15",0,0,0,0,0,0,0,0
"Venezuela (Bolivarian Republic of)","2024-02-16",0,0,0,0,0,0,0,0
"Venezuela (Bolivarian Republic of)","2024-02-17",0,0,0,0,0,0,0,0
"Venezuela (Bolivarian Republic of)","2024-02-18",0,0,0,0,0,0,0,0
"Venezuela (Bolivarian Republic of)","2024-02-19",0,0,0,0,0,0,0,0
"Venezuela (Bolivarian Republic of)","2024-02-20",0,0,0,0,0,0,0,0
"Venezuela (Bolivarian Republic of)","2024-02-21",0,0,0,0,0,0,0,0
"Venezuela (Bolivarian Republic of)","2024-02-22",0,0,0,0,0,0,0,0
"Venezuela (Bolivarian Republic of)","2024-02-23",0,0,0,0,0,0,0,0
"Venezuela (Bolivarian Republic of)","2024-02-24",0,0,0,0,0,0,0,0
"Venezuela (Bolivarian Republic of)","2024-02-25",0,0,0,0,0,0,0,0
"Venezuela (Bolivarian Republic of)","2024-02-26",0,0,0,0,0,0,0,0
"Venezuela (Bolivarian Republic of)","2024-02-27",0,0,0,0,0,0,0,0
"Venezuela (Bolivarian Republic of)","2024-02-28",0,0,0,0,0,0,0,0
"Venezuela (Bolivarian Republic of)","2024-02-29",0,0,0,0,0,0,0,0
"Venezuela (Bolivarian Republic of)","2024-03-01",0,0,0,0,0,0,0,0
"Venezuela (Bolivarian Republic of)","2024-03-02",0,0,0,0,0,0,0,0
"Venezuela (Bolivarian Republic of)","2024-03-03",0,0,0,0,0,0,0,0
"Venezuela (Bolivarian Republic of)","2024-03-04",0,0,0,0,0,0,0,0
"Venezuela (Bolivarian Republic of)","2024-03-05",0,0,0,0,0,0,0,0
"Venezuela (Bolivarian Republic of)","2024-03-06",0,0,0,0,0,0,0,0
"Venezuela (Bolivarian Republic of)","2024-03-07",0,0,0,0,0,0,0,0
"Venezuela (Bolivarian Republic of)","2024-03-08",0,0,0,0,0,0,0,0
"Venezuela (Bolivarian Republic of)","2024-03-09",0,0,0,0,0,0,0,0
"Venezuela (Bolivarian Republic of)","2024-03-10",0,0,0,0,0,0,0,0
"Venezuela (Bolivarian Republic of)","2024-03-11",0,0,0,0,0,0,0,0
"Venezuela (Bolivarian Republic of)","2024-03-12",0,0,0,0,0,0,0,0
"Venezuela (Bolivarian Republic of)","2024-03-13",0,0,0,0,0,0,0,0
"Venezuela (Bolivarian Republic of)","2024-03-14",0,0,0,0,0,0,0,0
"Venezuela (Bolivarian Republic of)","2024-03-15",0,0,0,0,0,0,0,0
"Venezuela (Bolivarian Republic of)","2024-03-16",0,0,0,0,0,0,0,0
"Venezuela (Bolivarian Republic of)","2024-03-17",0,0,0,0,0,0,0,0
"Venezuela (Bolivarian Republic of)","2024-03-18",0,0,0,0,0,0,0,0
"Venezuela (Bolivarian Republic of)","2024-03-19",0,0,0,0,0,0,0,0
"Venezuela (Bolivarian Republic of)","2024-03-20",0,0,0,0,0,0,0,0
"Venezuela (Bolivarian Republic of)","2024-03-21",0,0,0,0,0,0,0,0
"Venezuela (Bolivarian Republic of)","2024-03-22",0,0,0,0,0,0,0,0
"Venezuela (Bolivarian Republic of)","2024-03-23",0,0,0,0,0,0,0,0
"Venezuela (Bolivarian Republic of)","2024-03-24",0,0,0,0,0,0,0,0
"Venezuela (Bolivarian Republic of)","2024-03-25",0,0,0,0,0,0,0,0
"Venezuela (Bolivarian Republic of)","2024-03-26",0,0,0,0,0,0,0,0
"Venezuela (Bolivarian Republic of)","2024-03-27",0,0,0,0,0,0,0,0
"Venezuela (Bolivarian Republic of)","2024-03-28",0,0,0,0,0,0,0,0
"Venezuela (Bolivarian Republic of)","2024-03-29",0,0,0,0,0,0,0,0
"Venezuela (Bolivarian Republic of)","2024-03-30",0,0,0,0,0,0,0,0
"Venezuela (Bolivarian Republic of)","2024-03-31",0,0,0,0,0,0,0,0
"Venezuela (Bolivarian Republic of)","2024-04-01",0,0,0,0,0,0,0,0
"Venezuela (Bolivarian Republic of)","2024-04-02",0,0,0,0,0,0,0,0
"Venezuela (Bolivarian Republic of)","2024-04-03",0,0,0,0,0,0,0,0
"Venezuela (Bolivarian Republic of)","2024-04-04",0,0,0,0,0,0,0,0
"Venezuela (Bolivarian Republic of)","2024-04-05",0,0,0,0,0,0,0,0
"Venezuela (Bolivarian Republic of)","2024-04-06",0,0,0,0,0,0,0,0
"Venezuela (Bolivarian Republic of)","2024-04-07",0,0,0,0,0,0,0,0
"Venezuela (Bolivarian Republic of)","2024-04-08",0,0,0,0,0,0,0,0
"Venezuela (Bolivarian Republic of)","2024-04-09",0,0,0,0,0,0,0,0
"Venezuela (Bolivarian Republic of)","2024-04-10",0,0,0,0,0,0,0,0
"Venezuela (Bolivarian Republic of)","2024-04-11",0,0,0,0,0,0,0,0
"Venezuela (Bolivarian Republic of)","2024-04-12",0,0,0,0,0,0,0,0
"Venezuela (Bolivarian Republic of)","2024-04-13",0,0,0,0,0,0,0,0
"Venezuela (Bolivarian Republic of)","2024-04-14",0,0,0,0,0,0,0,0
"Venezuela (Bolivarian Republic of)","2024-04-15",0,0,0,0,0,0,0,0
"Venezuela (Bolivarian Republic of)","2024-04-16",0,0,0,0,0,0,0,0
"Venezuela (Bolivarian Republic of)","2024-04-17",0,0,0,0,0,0,0,0
"Venezuela (Bolivarian Republic of)","2024-04-18",0,0,0,0,0,0,0,0
"Venezuela (Bolivarian Republic of)","2024-04-19",0,0,0,0,0,0,0,0
"Venezuela (Bolivarian Republic of)","2024-04-20",0,0,0,0,0,0,0,0
"Venezuela (Bolivarian Republic of)","2024-04-21",0,0,0,0,0,0,0,0
"Venezuela (Bolivarian Republic of)","2024-04-22",0,0,0,0,0,0,0,0
"Venezuela (Bolivarian Republic of)","2024-04-23",0,0,0,0,0,0,0,0
"Venezuela (Bolivarian Republic of)","2024-04-24",0,0,0,0,0,0,0,0
"Venezuela (Bolivarian Republic of)","2024-04-25",0,0,0,0,0,0,0,0
"Venezuela (Bolivarian Republic of)","2024-04-26",0,0,0,0,0,0,0,0
"Venezuela (Bolivarian Republic of)","2024-04-27",0,0,0,0,0,0,0,0
"Venezuela (Bolivarian Republic of)","2024-04-28",0,0,0,0,0,0,0,0
"Venezuela (Bolivarian Republic of)","2024-04-29",0,0,0,0,0,0,0,0
"Venezuela (Bolivarian Republic of)","2024-04-30",0,0,0,0,0,0,0,0
"Venezuela (Bolivarian Republic of)","2024-05-01",0,0,0,0,0,0,0,0
"Venezuela (Bolivarian Republic of)","2024-05-02",0,0,0,0,0,0,0,0
"Venezuela (Bolivarian Republic of)","2024-05-03",0,0,0,0,0,0,0,0
"Venezuela (Bolivarian Republic of)","2024-05-04",0,0,0,0,0,0,0,0
"Venezuela (Bolivarian Republic of)","2024-05-05",0,0,0,0,0,0,0,0
"Venezuela (Bolivarian Republic of)","2024-05-06",0,0,0,0,0,0,0,0
"Venezuela (Bolivarian Republic of)","2024-05-07",0,0,0,0,0,0,0,0
"Venezuela (Bolivarian Republic of)","2024-05-08",0,0,0,0,0,0,0,0
"Venezuela (Bolivarian Republic of)","2024-05-09",0,0,0,0,0,0,0,0
"Venezuela (Bolivarian Republic of)","2024-05-10",0,0,0,0,0,0,0,0
"Venezuela (Bolivarian Republic of)","2024-05-11",0,0,0,0,0,0,0,0
"Venezuela (Bolivarian Republic of)","2024-05-12",0,0,0,0,0,0,0,0
"Venezuela (Bolivarian Republic of)","2024-05-13",0,0,0,0,0,0,0,0
"Venezuela (Bolivarian Republic of)","2024-05-14",0,0,0,0,0,0,0,0
"Venezuela (Bolivarian Republic of)","2024-05-15",0,0,0,0,0,0,0,0
"Venezuela (Bolivarian Republic of)","2024-05-16",0,0,0,0,0,0,0,0
"Venezuela (Bolivarian Republic of)","2024-05-17",0,0,0,0,0,0,0,0
"Venezuela (Bolivarian Republic of)","2024-05-18",0,0,0,0,0,0,0,0
"Venezuela (Bolivarian Republic of)","2024-05-19",0,0,0,0,0,0,0,0
"Venezuela (Bolivarian Republic of)","2024-05-20",0,0,0,0,0,0,0,0
"Venezuela (Bolivarian Republic of)","2024-05-21",0,0,0,0,0,0,0,0
"Venezuela (Bolivarian Republic of)","2024-05-22",0,0,0,0,0,0,0,0
"Venezuela (Bolivarian Republic of)","2024-05-23",0,0,0,0,0,0,0,0
"Venezuela (Bolivarian Republic of)","2024-05-24",0,0,0,0,0,0,0,0
"Venezuela (Bolivarian Republic of)","2024-05-25",0,0,0,0,0,0,0,0
"Venezuela (Bolivarian Republic of)","2024-05-26",0,0,0,0,0,0,0,0
"Venezuela (Bolivarian Republic of)","2024-05-27",0,0,0,0,0,0,0,0
"Venezuela (Bolivarian Republic of)","2024-05-28",0,0,0,0,0,0,0,0
"Venezuela (Bolivarian Republic of)","2024-05-29",0,0,0,0,0,0,0,0
"Venezuela (Bolivarian Republic of)","2024-05-30",0,0,0,0,0,0,0,0
"Venezuela (Bolivarian Republic of)","2024-05-31",0,0,0,0,0,0,0,0
"Venezuela (Bolivarian Republic of)","2024-06-01",0,0,0,0,0,0,0,0
"Venezuela (Bolivarian Republic of)","2024-06-02",0,0,0,0,0,0,0,0
"Venezuela (Bolivarian Republic of)","2024-06-03",0,0,0,0,0,0,0,0
"Venezuela (Bolivarian Republic of)","2024-06-04",0,0,0,0,0,0,0,0
"Venezuela (Bolivarian Republic of)","2024-06-05",0,0,0,0,0,0,0,0
"Venezuela (Bolivarian Republic of)","2024-06-06",0,0,0,0,0,0,0,0
"Venezuela (Bolivarian Republic of)","2024-06-07",0,0,0,0,0,0,0,0
"Venezuela (Bolivarian Republic of)","2024-06-08",0,0,0,0,0,0,0,0
"Venezuela (Bolivarian Republic of)","2024-06-09",0,0,0,0,0,0,0,0
"Venezuela (Bolivarian Republic of)","2024-06-10",0,0,0,0,0,0,0,0
"Venezuela (Bolivarian Republic of)","2024-06-11",0,0,0,0,0,0,0,0
"Venezuela (Bolivarian Republic of)","2024-06-12",0,0,0,0,0,0,0,0
"Venezuela (Bolivarian Republic of)","2024-06-13",0,0,0,0,0,0,0,0
"Venezuela (Bolivarian Republic of)","2024-06-14",0,0,0,0,0,0,0,0
"Venezuela (Bolivarian Republic of)","2024-06-15",0,0,0,0,0,0,0,0
"Venezuela (Bolivarian Republic of)","2024-06-16",0,0,0,0,0,0,0,0
"Venezuela (Bolivarian Republic of)","2024-06-17",0,0,0,0,0,0,0,0
"Venezuela (Bolivarian Republic of)","2024-06-18",0,0,0,0,0,0,0,0
"Venezuela (Bolivarian Republic of)","2024-06-19",0,0,0,0,0,0,0,0
"Venezuela (Bolivarian Republic of)","2024-06-20",0,0,0,0,0,0,0,0
"Venezuela (Bolivarian Republic of)","2024-06-21",0,0,0,0,0,0,0,0
"Venezuela (Bolivarian Republic of)","2024-06-22",0,0,0,0,0,0,0,0
"Venezuela (Bolivarian Republic of)","2024-06-23",0,0,0,0,0,0,0,0
"Venezuela (Bolivarian Republic of)","2024-06-24",0,0,0,0,0,0,0,0
"Venezuela (Bolivarian Republic of)","2024-06-25",0,0,0,0,0,0,0,0
"Venezuela (Bolivarian Republic of)","2024-06-26",0,0,0,0,0,0,0,0
"Venezuela (Bolivarian Republic of)","2024-06-27",0,0,0,0,0,0,0,0
"Venezuela (Bolivarian Republic of)","2024-06-28",0,0,0,0,0,0,0,0
"Venezuela (Bolivarian Republic of)","2024-06-29",0,0,0,0,0,0,0,0
"Venezuela (Bolivarian Republic of)","2024-06-30",0,0,0,0,0,0,0,0
"Venezuela (Bolivarian Republic of)","2024-07-01",0,0,0,0,0,0,0,0
"Venezuela (Bolivarian Republic of)","2024-07-02",0,0,0,0,0,0,0,0
"Venezuela (Bolivarian Republic of)","2024-07-03",0,0,0,0,0,0,0,0
"Venezuela (Bolivarian Republic of)","2024-07-04",0,0,0,0,0,0,0,0
"Venezuela (Bolivarian Republic of)","2024-07-05",0,0,0,0,0,0,0,0
"Venezuela (Bolivarian Republic of)","2024-07-06",0,0,0,0,0,0,0,0
"Venezuela (Bolivarian Republic of)","2024-07-07",0,0,0,0,0,0,0,0
"Venezuela (Bolivarian Republic of)","2024-07-08",0,0,0,0,0,0,0,0
"Venezuela (Bolivarian Republic of)","2024-07-09",0,0,0,0,0,0,0,0
"Venezuela (Bolivarian Republic of)","2024-07-10",0,0,0,0,0,0,0,0
"Venezuela (Bolivarian Republic of)","2024-07-11",0,0,0,0,0,0,0,0
"Venezuela (Bolivarian Republic of)","2024-07-12",0,0,0,0,0,0,0,0
"Venezuela (Bolivarian Republic of)","2024-07-13",0,0,0,0,0,0,0,0
"Venezuela (Bolivarian Republic of)","2024-07-14",0,0,0,0,0,0,0,0
"Venezuela (Bolivarian Republic of)","2024-07-15",0,0,0,0,0,0,0,0
"Venezuela (Bolivarian Republic of)","2024-07-16",0,0,0,0,0,0,0,0
"Venezuela (Bolivarian Republic of)","2024-07-17",0,0,0,0,0,0,0,0
"Venezuela (Bolivarian Republic of)","2024-07-18",0,0,0,0,0,0,0,0
"Venezuela (Bolivarian Republic of)","2024-07-19",0,0,0,0,0,0,0,0
"Venezuela (Bolivarian Republic of)","2024-07-20",0,0,0,0,0,0,0,0
"Venezuela (Bolivarian Republic of)","2024-07-21",0,0,0,0,0,0,0,0
"Venezuela (Bolivarian Republic of)","2024-07-22",0,0,0,0,0,0,0,0
"Venezuela (Bolivarian Republic of)","2024-07-23",0,0,0,0,0,0,0,0
"Venezuela (Bolivarian Republic of)","2024-07-24",0,0,0,0,0,0,0,0
"Venezuela (Bolivarian Republic of)","2024-07-25",0,0,0,0,0,0,0,0
"Venezuela (Bolivarian Republic of)","2024-07-26",0,0,0,0,0,0,0,0
"Venezuela (Bolivarian Republic of)","2024-07-27",0,0,0,0,0,0,0,0
"Venezuela (Bolivarian Republic of)","2024-07-28",0,0,0,0,0,0,0,0
"Venezuela (Bolivarian Republic of)","2024-07-29",0,0,0,0,0,0,0,0
"Venezuela (Bolivarian Republic of)","2024-07-30",0,0,0,0,0,0,0,0
"Venezuela (Bolivarian Republic of)","2024-07-31",0,0,0,0,0,0,0,0
"Venezuela (Bolivarian Republic of)","2024-08-01",0,0,0,0,0,0,0,0
"Venezuela (Bolivarian Republic of)","2024-08-02",0,0,0,0,0,0,0,0
"Venezuela (Bolivarian Republic of)","2024-08-03",0,0,0,0,0,0,0,0
"Venezuela (Bolivarian Republic of)","2024-08-04",0,0,0,0,0,0,0,0
"Venezuela (Bolivarian Republic of)","2024-08-05",0,0,0,0,0,0,0,0
"Venezuela (Bolivarian Republic of)","2024-08-06",0,0,0,0,0,0,0,0
"Venezuela (Bolivarian Republic of)","2024-08-07",0,0,0,0,0,0,0,0
"Venezuela (Bolivarian Republic of)","2024-08-08",0,0,0,0,0,0,0,0
"Venezuela (Bolivarian Republic of)","2024-08-09",0,0,0,0,0,0,0,0
"Venezuela (Bolivarian Republic of)","2024-08-10",0,0,0,0,0,0,0,0
"Venezuela (Bolivarian Republic of)","2024-08-11",0,0,0,0,0,0,0,0
"Venezuela (Bolivarian Republic of)","2024-08-12",0,0,0,0,0,0,0,0
"Venezuela (Bolivarian Republic of)","2024-08-13",0,0,0,0,0,0,0,0
"Venezuela (Bolivarian Republic of)","2024-08-14",0,0,0,0,0,0,0,0
"Venezuela (Bolivarian Republic of)","2024-08-15",0,0,0,0,0,0,0,0
"Venezuela (Bolivarian Republic of)","2024-08-16",0,0,0,0,0,0,0,0
"Venezuela (Bolivarian Republic of)","2024-08-17",0,0,0,0,0,0,0,0
"Venezuela (Bolivarian Republic of)","2024-08-18",0,0,0,0,0,0,0,0
"Venezuela (Bolivarian Republic of)","2024-08-19",0,0,0,0,0,0,0,0
"Venezuela (Bolivarian Republic of)","2024-08-20",0,0,0,0,0,0,0,0
"Venezuela (Bolivarian Republic of)","2024-08-21",0,0,0,0,0,0,0,0
"Venezuela (Bolivarian Republic of)","2024-08-22",0,0,0,0,0,0,0,0
"Venezuela (Bolivarian Republic of)","2024-08-23",0,0,0,0,0,0,0,0
"Venezuela (Bolivarian Republic of)","2024-08-24",0,0,0,0,0,0,0,0
"Venezuela (Bolivarian Republic of)","2024-08-25",0,0,0,0,0,0,0,0
"Venezuela (Bolivarian Republic of)","2024-08-26",0,0,0,0,0,0,0,0
"Venezuela (Bolivarian Republic of)","2024-08-27",0,0,0,0,0,0,0,0
"Venezuela (Bolivarian Republic of)","2024-08-28",0,0,0,0,0,0,0,0
"Venezuela (Bolivarian Republic of)","2024-08-29",0,0,0,0,0,0,0,0
"Venezuela (Bolivarian Republic of)","2024-08-30",0,0,0,0,0,0,0,0
"Venezuela (Bolivarian Republic of)","2024-08-31",0,0,0,0,0,0,0,0
"Venezuela (Bolivarian Republic of)","2024-09-01",0,0,0,0,0,0,0,0
"Venezuela (Bolivarian Republic of)","2024-09-02",0,0,0,0,0,0,0,0
"Venezuela (Bolivarian Republic of)","2024-09-03",0,0,0,0,0,0,0,0
"Venezuela (Bolivarian Republic of)","2024-09-04",0,0,0,0,0,0,0,0
"Venezuela (Bolivarian Republic of)","2024-09-05",0,0,0,0,0,0,0,0
"Venezuela (Bolivarian Republic of)","2024-09-06",0,0,0,0,0,0,0,0
"Venezuela (Bolivarian Republic of)","2024-09-07",0,0,0,0,0,0,0,0
"Venezuela (Bolivarian Republic of)","2024-09-08",0,0,0,0,0,0,0,0
"Venezuela (Bolivarian Republic of)","2024-09-09",0,0,0,0,0,0,0,0
"Venezuela (Bolivarian Republic of)","2024-09-10",0,0,0,0,0,0,0,0
"Venezuela (Bolivarian Republic of)","2024-09-11",0,0,0,0,0,0,0,0
"Venezuela (Bolivarian Republic of)","2024-09-12",0,0,0,0,0,0,0,0
"Venezuela (Bolivarian Republic of)","2024-09-13",0,0,0,0,0,0,0,0
"Venezuela (Bolivarian Republic of)","2024-09-14",0,0,0,0,0,0,0,0
"Venezuela (Bolivarian Republic of)","2024-09-15",0,0,0,0,0,0,0,0
"Venezuela (Bolivarian Republic of)","2024-09-16",0,0,0,0,0,0,0,0
"Venezuela (Bolivarian Republic of)","2024-09-17",0,0,0,0,0,0,0,0
"Venezuela (Bolivarian Republic of)","2024-09-18",0,0,0,0,0,0,0,0
"Venezuela (Bolivarian Republic of)","2024-09-19",0,0,0,0,0,0,0,0
"Venezuela (Bolivarian Republic of)","2024-09-20",0,0,0,0,0,0,0,0
"Venezuela (Bolivarian Republic of)","2024-09-21",0,0,0,0,0,0,0,0
"Venezuela (Bolivarian Republic of)","2024-09-22",0,0,0,0,0,0,0,0
"Venezuela (Bolivarian Republic of)","2024-09-23",0,0,0,0,0,0,0,0
"Venezuela (Bolivarian Republic of)","2024-09-24",0,0,0,0,0,0,0,0
"Venezuela (Bolivarian Republic of)","2024-09-25",0,0,0,0,0,0,0,0
"Venezuela (Bolivarian Republic of)","2024-09-26",0,0,0,0,0,0,0,0
"Venezuela (Bolivarian Republic of)","2024-09-27",0,0,0,0,0,0,0,0
"Venezuela (Bolivarian Republic of)","2024-09-28",0,0,0,0,0,0,0,0
"Venezuela (Bolivarian Republic of)","2024-09-29",0,0,0,0,0,0,0,0
"Venezuela (Bolivarian Republic of)","2024-09-30",0,0,0,0,0,0,0,0
"Venezuela (Bolivarian Republic of)","2024-10-01",0,0,0,0,0,0,0,0
"Venezuela (Bolivarian Republic of)","2024-10-02",0,0,0,0,0,0,0,0
"Venezuela (Bolivarian Republic of)","2024-10-03",0,0,0,0,0,0,0,0
"Venezuela (Bolivarian Republic of)","2024-10-04",0,0,0,0,0,0,0,0
"Venezuela (Bolivarian Republic of)","2024-10-05",0,0,0,0,0,0,0,0
"Venezuela (Bolivarian Republic of)","2024-10-06",0,0,0,0,0,0,0,0
"Venezuela (Bolivarian Republic of)","2024-10-07",0,0,0,0,0,0,0,0
"Venezuela (Bolivarian Republic of)","2024-10-08",0,0,0,0,0,0,0,0
"Venezuela (Bolivarian Republic of)","2024-10-09",0,0,0,0,0,0,0,0
"Venezuela (Bolivarian Republic of)","2024-10-10",0,0,0,0,0,0,0,0
"Venezuela (Bolivarian Republic of)","2024-10-11",0,0,0,0,0,0,0,0
"Venezuela (Bolivarian Republic of)","2024-10-12",0,0,0,0,0,0,0,0
"Venezuela (Bolivarian Republic of)","2024-10-13",0,0,0,0,0,0,0,0
"Venezuela (Bolivarian Republic of)","2024-10-14",0,0,0,0,0,0,0,0
"Venezuela (Bolivarian Republic of)","2024-10-15",0,0,0,0,0,0,0,0
"Venezuela (Bolivarian Republic of)","2024-10-16",0,0,0,0,0,0,0,0
"Venezuela (Bolivarian Republic of)","2024-10-17",0,0,0,0,0,0,0,0
"Venezuela (Bolivarian Republic of)","2024-10-18",0,0,0,0,0,0,0,0
"Venezuela (Bolivarian Republic of)","2024-10-19",0,0,0,0,0,0,0,0
"Venezuela (Bolivarian Republic of)","2024-10-20",0,0,0,0,0,0,0,0
"Venezuela (Bolivarian Republic of)","2024-10-21",0,0,0,0,0,0,0,0
"Venezuela (Bolivarian Republic of)","2024-10-22",0,0,0,0,0,0,0,0
"Venezuela (Bolivarian Republic of)","2024-10-23",0,0,0,0,0,0,0,0
"Venezuela (Bolivarian Republic of)","2024-10-24",0,0,0,0,0,0,0,0
"Venezuela (Bolivarian Republic of)","2024-10-25",0,0,0,0,0,0,0,0
"Venezuela (Bolivarian Republic of)","2024-10-26",0,0,0,0,0,0,0,0
"Venezuela (Bolivarian Republic of)","2024-10-27",0,0,0,0,0,0,0,0
"Venezuela (Bolivarian Republic of)","2024-10-28",0,0,0,0,0,0,0,0
"Venezuela (Bolivarian Republic of)","2024-10-29",0,0,0,0,0,0,0,0
"Venezuela (Bolivarian Republic of)","2024-10-30",0,0,0,0,0,0,0,0
"Venezuela (Bolivarian Republic of)","2024-10-31",0,0,0,0,0,0,0,0
"Venezuela (Bolivarian Republic of)","2024-11-01",0,0,0,0,0,0,0,0
"Venezuela (Bolivarian Republic of)","2024-11-02",0,0,0,0,0,0,0,0
"Venezuela (Bolivarian Republic of)","2024-11-03",0,0,0,0,0,0,0,0
"Venezuela (Bolivarian Republic of)","2024-11-04",0,0,0,0,0,0,0,0
"Venezuela (Bolivarian Republic of)","2024-11-05",0,0,0,0,0,0,0,0
"Venezuela (Bolivarian Republic of)","2024-11-06",0,0,0,0,0,0,0,0
"Venezuela (Bolivarian Republic of)","2024-11-07",0,0,0,0,0,0,0,0
"Venezuela (Bolivarian Republic of)","2024-11-08",0,0,0,0,0,0,0,0
"Venezuela (Bolivarian Republic of)","2024-11-09",0,0,0,0,0,0,0,0
"Venezuela (Bolivarian Republic of)","2024-11-10",0,0,0,0,0,0,0,0
"Venezuela (Bolivarian Republic of)","2024-11-11",0,0,0,0,0,0,0,0
"Venezuela (Bolivarian Republic of)","2024-11-12",0,0,0,0,0,0,0,0
"Venezuela (Bolivarian Republic of)","2024-11-13",0,0,0,0,0,0,0,0
"Venezuela (Bolivarian Republic of)","2024-11-14",0,0,0,0,0,0,0,0
"Venezuela (Bolivarian Republic of)","2024-11-15",0,0,0,0,0,0,0,0
"Venezuela (Bolivarian Republic of)","2024-11-16",0,0,0,0,0,0,0,0
"Venezuela (Bolivarian Republic of)","2024-11-17",0,0,0,0,0,0,0,0
"Venezuela (Bolivarian Republic of)","2024-11-18",0,0,0,0,0,0,0,0
"Venezuela (Bolivarian Republic of)","2024-11-19",0,0,0,0,0,0,0,0
"Venezuela (Bolivarian Republic of)","2024-11-20",0,0,0,0,0,0,0,0
"Venezuela (Bolivarian Republic of)","2024-11-21",0,0,0,0,0,0,0,0
"Venezuela (Bolivarian Republic of)","2024-11-22",0,0,0,0,0,0,0,0
"Venezuela (Bolivarian Republic of)","2024-11-23",0,0,0,0,0,0,0,0
"Venezuela (Bolivarian Republic of)","2024-11-24",0,0,0,0,0,0,0,0
"Venezuela (Bolivarian Republic of)","2024-11-25",0,0,0,0,0,0,0,0
"Venezuela (Bolivarian Republic of)","2024-11-26",0,0,0,0,0,0,0,0
"Venezuela (Bolivarian Republic of)","2024-11-27",0,0,0,0,0,0,0,0
"Venezuela (Bolivarian Republic of)","2024-11-28",0,0,0,0,0,0,0,0
"Venezuela (Bolivarian Republic of)","2024-11-29",0,0,0,0,0,0,0,0
"Venezuela (Bolivarian Republic of)","2024-11-30",0,0,0,0,0,0,0,0
"Venezuela (Bolivarian Republic of)","2024-12-01",0,0,0,0,0,0,0,0
"Venezuela (Bolivarian Republic of)","2024-12-02",0,0,0,0,0,0,0,0
"Venezuela (Bolivarian Republic of)","2024-12-03",0,0,0,0,0,0,0,0
"Venezuela (Bolivarian Republic of)","2024-12-04",0,0,0,0,0,0,0,0
"Venezuela (Bolivarian Republic of)","2024-12-05",0,0,0,0,0,0,0,0
"Venezuela (Bolivarian Republic of)","2024-12-06",0,0,0,0,0,0,0,0
"Venezuela (Bolivarian Republic of)","2024-12-07",0,0,0,0,0,0,0,0
"Venezuela (Bolivarian Republic of)","2024-12-08",0,0,0,0,0,0,0,0
"Venezuela (Bolivarian Republic of)","2024-12-09",0,0,0,0,0,0,0,0
"Viet Nam","2024-01-01",0,0,0,0,0,0,0,0
"Viet Nam","2024-01-02",0,0,0,0,0,0,0,0
"Viet Nam","2024-01-03",0,0,0,0,0,0,0,0
"Viet Nam","2024-01-04",0,0,0,0,0,0,0,0
"Viet Nam","2024-01-05",0,0,0,0,0,0,0,0
"Viet Nam","2024-01-06",0,0,0,0,0,0,0,0
"Viet Nam","2024-01-07",0,0,0,0,0,0,0,0
"Viet Nam","2024-01-08",0,0,0,0,0,0,0,0
"Viet Nam","2024-01-09",0,0,0,0,0,0,0,0
"Viet Nam","2024-01-10",0,14,14,0,14,14,0,0
"Viet Nam","2024-01-11",0,0,14,0,0,14,0,0
"Viet Nam","2024-01-12",0,0,14,0,0,14,0,0
"Viet Nam","2024-01-13",0,0,14,0,1,15,0,0
"Viet Nam","2024-01-14",0,0,14,0,0,15,0,0
"Viet Nam","2024-01-15",0,0,14,0,0,15,0,0
"Viet Nam","2024-01-16",0,0,14,0,0,15,0,0
"Viet Nam","2024-01-17",0,0,14,0,0,15,0,0
"Viet Nam","2024-01-18",0,0,14,0,1,16,0,0
"Viet Nam","2024-01-19",0,0,14,0,0,16,0,0
"Viet Nam","2024-01-20",0,2,16,0,0,16,0,0
"Viet Nam","2024-01-21",0,0,16,0,1,17,0,0
"Viet Nam","2024-01-22",0,0,16,0,1,18,0,0
"Viet Nam","2024-01-23",0,0,16,0,2,20,0,0
"Viet Nam","2024-01-24",0,5,21,0,1,21,0,0
"Viet Nam","2024-01-25",0,0,21,0,0,21,0,0
"Viet Nam","2024-01-26",0,0,21,0,1,22,0,0
"Viet Nam","2024-01-27",0,0,21,0,0,22,0,0
"Viet Nam","2024-01-28",0,0,21,0,0,22,0,0
"Viet Nam","2024-01-29",0,0,21,0,1,23,0,0
"Viet Nam","2024-01-30",0,0,21,0,0,23,0,0
"Viet Nam","2024-01-31",0,0,21,0,0,23,0,0
"Viet Nam","2024-02-01",0,0,21,0,0,23,0,0
"Viet Nam","2024-02-02",0,0,21,0,1,24,0,0
"Viet Nam","2024-02-03",0,0,21,0,0,24,0,0
"Viet Nam","2024-02-04",0,0,21,0,0,24,0,0
"Viet Nam","2024-02-05",0,0,21,0,1,25,0,0
"Viet Nam","2024-02-06",0,0,21,0,0,25,0,0
"Viet Nam","2024-02-07",0,0,21,0,0,25,0,0
"Viet Nam","2024-02-08",0,0,21,0,1,26,0,0
"Viet Nam","2024-02-09",0,5,26,0,0,26,0,0
"Viet Nam","2024-02-10",0,0,26,0,0,26,0,0
"Viet Nam","2024-02-11",0,0,26,0,1,27,0,0
"Viet Nam","2024-02-12",0,0,26,0,0,27,0,0
"Viet Nam","2024-02-13",0,0,26,0,1,28,0,0
"Viet Nam","2024-02-14",0,0,26,0,0,28,0,0
"Viet Nam","2024-02-15",0,0,26,0,0,28,0,0
"Viet Nam","2024-02-16",0,0,26,0,1,29,0,0
"Viet Nam","2024-02-17",0,0,26,0,0,29,0,0
"Viet Nam","2024-02-18",0,0,26,0,0,29,0,0
"Viet Nam","2024-02-19",0,0,26,0,1,30,0,0
"Viet Nam","2024-02-20",0,0,26,0,0,30,0,0
"Viet Nam","2024-02-21",0,0,26,0,1,31,0,0
"Viet Nam","2024-02-22",0,0,26,0,0,31,0,0
"Viet Nam","2024-02-23",0,0,26,0,0,31,0,0
"Viet Nam","2024-02-24",0,0,26,0,1,32,0,0
"Viet Nam","2024-02-25",0,0,26,0,0,32,0,0
"Viet Nam","2024-02-26",0,0,26,0,1,33,0,0
"Viet Nam","2024-02-27",0,0,26,0,0,33,0,0
"Viet Nam","2024-02-28",0,0,26,0,0,33,0,0
"Viet Nam","2024-02-29",0,0,26,0,1,34,0,0
"Viet Nam","2024-03-01",0,0,26,0,0,34,0,0
"Viet Nam","2024-03-02",0,0,26,0,0,34,0,0
"Viet Nam","2024-03-03",0,0,26,0,1,35,0,0
"Viet Nam","2024-03-04",0,0,26,0,0,35,0,0
"Viet Nam","2024-03-05",0,0,26,0,1,36,0,0
"Viet Nam","2024-03-06",0,10,36,0,0,36,0,0
"Viet Nam","2024-03-07",0,0,36,0,1,37,0,0
"Viet Nam","2024-03-08",0,0,36,0,0,37,0,0
"Viet Nam","2024-03-09",0,0,36,0,1,38,0,0
"Viet Nam","2024-03-10",0,0,36,0,0,38,0,0
"Viet Nam","2024-03-11",0,0,36,0,1,39,0,0
"Viet Nam","2024-03-12",0,0,36,0,1,40,0,0
"Viet Nam","2024-03-13",0,0,36,0,0,40,0,0
"Viet Nam","2024-03-14",0,0,36,0,1,41,0,0
"Viet Nam","2024-03-15",0,0,36,0,0,41,0,0
"Viet Nam","2024-03-16",0,0,36,0,1,42,0,0
"Viet Nam","2024-03-17",0,0,36,0,1,43,0,0
"Viet Nam","2024-03-18",0,0,36,0,0,43,0,0
"Viet Nam","2024-03-19",0,0,36,0,1,44,0,0
"Viet Nam","2024-03-20",0,0,36,0,0,44,0,0
"Viet Nam","2024-03-21",0,0,36,0,1,45,0,0
"Viet Nam","2024-03-22",0,0,36,0,1,46,0,0
"Viet Nam","2024-03-23",0,0,36,0,0,46,0,0
"Viet Nam","2024-03-24",0,0,36,0,1,47,0,0
"Viet Nam","2024-03-25",0,0,36,0,0,47,0,0
"Viet Nam","2024-03-26",0,12,48,0,1,48,0,0
"Viet Nam","2024-03-27",0,0,48,0,1,49,0,0
"Viet Nam","2024-03-28",0,0,48,0,0,49,0,0
"Viet Nam","2024-03-29",0,0,48,0,1,50,0,0
"Viet Nam","2024-03-30",0,0,48,0,0,50,0,0
"Viet Nam","2024-03-31",0,0,48,0,1,51,0,0
"Viet Nam","2024-04-01",0,0,48,0,0,51,0,0
"Viet Nam","2024-04-02",0,0,48,0,1,52,0,0
"Viet Nam","2024-04-03",0,0,48,0,0,52,0,0
"Viet Nam","2024-04-04",0,0,48,0,1,53,0,0
"Viet Nam","2024-04-05",0,0,48,0,0,53,0,0
"Viet Nam","2024-04-06",0,0,48,0,1,54,0,0
"Viet Nam","2024-04-07",0,0,48,0,0,54,0,0
"Viet Nam","2024-04-08",0,0,48,0,1,55,0,0
"Viet Nam","2024-04-09",0,0,48,0,0,55,0,0
"Viet Nam","2024-04-10",0,0,48,0,1,56,0,0
"Viet Nam","2024-04-11",0,0,48,0,1,57,0,0
"Viet Nam","2024-04-12",0,0,48,0,0,57,0,0
"Viet Nam","2024-04-13",0,0,48,0,1,58,0,0
"Viet Nam","2024-04-14",0,0,48,0,0,58,0,0
"Viet Nam","2024-04-15",0,0,48,0,1,59,0,0
"Viet Nam","2024-04-16",0,0,48,0,0,59,0,0
"Viet Nam","2024-04-17",0,0,48,0,1,60,0,0
"Viet Nam","2024-04-18",0,0,48,0,0,60,0,0
"Viet Nam","2024-04-19",0,0,48,0,1,61,0,0
"Viet Nam","2024-04-20",0,0,48,0,0,61,0,0
"Viet Nam","2024-04-21",0,0,48,0,1,62,0,0
"Viet Nam","2024-04-22",0,0,48,0,0,62,0,0
"Viet Nam","2024-04-23",0,0,48,0,1,63,0,0
"Viet Nam","2024-04-24",0,0,48,0,0,63,0,0
"Viet Nam","2024-04-25",0,0,48,0,1,64,0,0
"Viet Nam","2024-04-26",0,0,48,0,1,65,0,0
"Viet Nam","2024-04-27",0,0,48,0,0,65,0,0
"Viet Nam","2024-04-28",0,0,48,0,1,66,0,0
"Viet Nam","2024-04-29",0,0,48,0,0,66,0,0
"Viet Nam","2024-04-30",0,0,48,0,1,67,0,0
"Viet Nam","2024-05-01",0,0,48,0,0,67,0,0
"Viet Nam","2024-05-02",0,0,48,0,1,68,0,0
"Viet Nam","2024-05-03",0,0,48,0,0,68,0,0
"Viet Nam","2024-05-04",0,0,48,0,1,69,0,0
"Viet Nam","2024-05-05",0,0,48,0,0,69,0,0
"Viet Nam","2024-05-06",0,0,48,0,1,70,0,0
"Viet Nam","2024-05-07",0,0,48,0,0,70,0,0
"Viet Nam","2024-05-08",0,0,48,0,1,71,0,0
"Viet Nam","2024-05-09",0,0,48,0,0,71,0,0
"Viet Nam","2024-05-10",0,24,72,0,1,72,0,0
"Viet Nam","2024-05-11",0,0,72,0,0,72,0,0
"Viet Nam","2024-05-12",0,0,72,0,0,72,0,0
"Viet Nam","2024-05-13",0,0,72,0,0,72,0,0
"Viet Nam","2024-05-14",0,0,72,0,1,73,0,0
"Viet Nam","2024-05-15",0,0,72,0,0,73,0,0
"Viet Nam","2024-05-16",0,0,72,0,0,73,0,0
"Viet Nam","2024-05-17",0,0,72,0,0,73,0,0
"Viet Nam","2024-05-18",0,0,72,0,0,73,0,0
"Viet Nam","2024-05-19",0,0,72,0,0,73,0,0
"Viet Nam","2024-05-20",0,0,72,0,0,73,0,0
"Viet Nam","2024-05-21",0,0,72,0,1,74,0,0
"Viet Nam","2024-05-22",0,0,72,0,0,74,0,0
"Viet Nam","2024-05-23",0,0,72,0,0,74,0,0
"Viet Nam","2024-05-24",0,0,72,0,0,74,0,0
"Viet Nam","2024-05-25",0,0,72,0,0,74,0,0
"Viet Nam","2024-05-26",0,0,72,0,0,74,0,0
"Viet Nam","2024-05-27",0,0,72,0,0,74,0,0
"Viet Nam","2024-05-28",0,0,72,0,1,75,0,0
"Viet Nam","2024-05-29",0,0,72,0,0,75,0,0
"Viet Nam","2024-05-30",0,0,72,0,0,75,0,0
"Viet Nam","2024-05-31",0,3,75,0,0,75,0,0
"Viet Nam","2024-06-01",0,0,75,0,0,75,0,0
"Viet Nam","2024-06-02",0,0,75,0,0,75,0,0
"Viet Nam","2024-06-03",0,0,75,0,1,76,0,0
"Viet Nam","2024-06-04",0,0,75,0,0,76,0,0
"Viet Nam","2024-06-05",0,0,75,0,0,76,0,0
"Viet Nam","2024-06-06",0,0,75,0,0,76,0,0
"Viet Nam","2024-06-07",0,0,75,0,1,77,0,0
"Viet Nam","2024-06-08",0,0,75,0,0,77,0,0
"Viet Nam","2024-06-09",0,0,75,0,0,77,0,0
"Viet Nam","2024-06-10",0,0,75,0,0,77,0,0
"Viet Nam","2024-06-11",0,0,75,0,0,77,0,0
"Viet Nam","2024-06-12",0,0,75,0,1,78,0,0
"Viet Nam","2024-06-13",0,0,75,0,0,78,0,0
"Viet Nam","2024-06-14",0,0,75,0,0,78,0,0
"Viet Nam","2024-06-15",0,0,75,0,0,78,0,0
"Viet Nam","2024-06-16",0,0,75,0,0,78,0,0
"Viet Nam","2024-06-17",0,0,75,0,1,79,0,0
"Viet Nam","2024-06-18",0,0,75,0,0,79,0,0
"Viet Nam","2024-06-19",0,0,75,0,0,79,0,0
"Viet Nam","2024-06-20",0,0,75,0,0,79,0,0
"Viet Nam","2024-06-21",0,0,75,0,0,79,0,0
"Viet Nam","2024-06-22",0,0,75,0,1,80,0,0
"Viet Nam","2024-06-23",0,0,75,0,0,80,0,0
"Viet Nam","2024-06-24",0,0,75,0,0,80,0,0
"Viet Nam","2024-06-25",0,0,75,0,0,80,0,0
"Viet Nam","2024-06-26",0,0,75,0,1,81,0,0
"Viet Nam","2024-06-27",0,0,75,0,0,81,0,0
"Viet Nam","2024-06-28",0,6,81,0,0,81,0,0
"Viet Nam","2024-06-29",0,0,81,0,0,81,0,0
"Viet Nam","2024-06-30",0,0,81,0,0,81,0,0
"Viet Nam","2024-07-01",0,0,81,0,0,81,0,0
"Viet Nam","2024-07-02",0,0,81,0,0,81,0,0
"Viet Nam","2024-07-03",0,0,81,0,0,81,0,0
"Viet Nam","2024-07-04",0,0,81,0,0,81,0,0
"Viet Nam","2024-07-05",0,0,81,0,0,81,0,0
"Viet Nam","2024-07-06",0,0,81,0,0,81,0,0
"Viet Nam","2024-07-07",0,0,81,0,0,81,0,0
"Viet Nam","2024-07-08",0,0,81,0,1,82,0,0
"Viet Nam","2024-07-09",0,0,81,0,0,82,0,0
"Viet Nam","2024-07-10",0,0,81,0,0,82,0,0
"Viet Nam","2024-07-11",0,0,81,0,0,82,0,0
"Viet Nam","2024-07-12",0,0,81,0,0,82,0,0
"Viet Nam","2024-07-13",0,0,81,0,0,82,0,0
"Viet Nam","2024-07-14",0,0,81,0,0,82,0,0
"Viet Nam","2024-07-15",0,0,81,0,0,82,0,0
"Viet Nam","2024-07-16",0,1,82,0,0,82,0,0
"Viet Nam","2024-07-17",0,0,82,0,0,82,0,0
"Viet Nam","2024-07-18",0,0,82,0,0,82,0,0
"Viet Nam","2024-07-19",0,0,82,0,0,82,0,0
"Viet Nam","2024-07-20",0,0,82,0,0,82,0,0
"Viet Nam","2024-07-21",0,0,82,0,0,82,0,0
"Viet Nam","2024-07-22",0,0,82,0,0,82,0,0
"Viet Nam","2024-07-23",0,0,82,0,0,82,0,0
"Viet Nam","2024-07-24",0,0,82,0,0,82,0,0
"Viet Nam","2024-07-25",0,0,82,0,0,82,0,0
"Viet Nam","2024-07-26",0,0,82,0,0,82,0,0
"Viet Nam","2024-07-27",0,0,82,0,0,82,0,0
"Viet Nam","2024-07-28",0,0,82,0,0,82,0,0
"Viet Nam","2024-07-29",0,0,82,0,0,82,0,0
"Viet Nam","2024-07-30",0,0,82,0,0,82,0,0
"Viet Nam","2024-07-31",0,0,82,0,0,82,0,0
"Viet Nam","2024-08-01",0,0,82,0,0,82,0,0
"Viet Nam","2024-08-02",0,0,82,0,0,82,0,0
"Viet Nam","2024-08-03",0,0,82,0,0,82,0,0
"Viet Nam","2024-08-04",0,0,82,0,0,82,0,0
"Viet Nam","2024-08-05",0,0,82,0,0,82,0,0
"Viet Nam","2024-08-06",0,0,82,0,0,82,0,0
"Viet Nam","2024-08-07",0,0,82,0,0,82,0,0
"Viet Nam","2024-08-08",0,0,82,0,0,82,0,0
"Viet Nam","2024-08-09",0,0,82,0,0,82,0,0
"Viet Nam","2024-08-10",0,0,82,0,0,82,0,0
"Viet Nam","2024-08-11",0,0,82,0,0,82,0,0
"Viet Nam","2024-08-12",0,0,82,0,0,82,0,0
"Viet Nam","2024-08-13",0,0,82,0,1,83,0,0
"Viet Nam","2024-08-14",0,0,82,0,0,83,0,0
"Viet Nam","2024-08-15",0,0,82,0,0,83,0,0
"Viet Nam","2024-08-16",0,0,82,0,0,83,0,0
"Viet Nam","2024-08-17",0,0,82,0,0,83,0,0
"Viet Nam","2024-08-18",0,0,82,0,0,83,0,0
"Viet Nam","2024-08-19",0,0,82,0,0,83,0,0
"Viet Nam","2024-08-20",0,0,82,0,0,83,0,0
"Viet Nam","2024-08-21",0,0,82,0,0,83,0,0
"Viet Nam","2024-08-22",0,0,82,0,0,83,0,0
"Viet Nam","2024-08-23",0,0,82,0,0,83,0,0
"Viet Nam","2024-08-24",0,0,82,0,0,83,0,0
"Viet Nam","2024-08-25",0,0,82,0,0,83,0,0
"Viet Nam","2024-08-26",0,0,82,0,0,83,0,0
"Viet Nam","2024-08-27",0,0,82,0,0,83,0,0
"Viet Nam","2024-08-28",0,0,82,0,0,83,0,0
"Viet Nam","2024-08-29",0,0,82,0,0,83,0,0
"Viet Nam","2024-08-30",0,0,82,0,0,83,0,0
"Viet Nam","2024-08-31",0,0,82,0,0,83,0,0
"Viet Nam","2024-09-01",0,0,82,0,0,83,0,0
"Viet Nam","2024-09-02",0,0,82,0,0,83,0,0
"Viet Nam","2024-09-03",0,0,82,0,0,83,0,0
"Viet Nam","2024-09-04",0,0,82,0,0,83,0,0
"Viet Nam","2024-09-05",0,0,82,0,0,83,0,0
"Viet Nam","2024-09-06",0,0,82,0,0,83,0,0
"Viet Nam","2024-09-07",0,0,82,0,0,83,0,0
"Viet Nam","2024-09-08",0,0,82,0,0,83,0,0
"Viet Nam","2024-09-09",0,0,82,0,0,83,0,0
"Viet Nam","2024-09-10",0,0,82,0,0,83,0,0
"Viet Nam","2024-09-11",0,0,82,0,0,83,0,0
"Viet Nam","2024-09-12",0,0,82,0,0,83,0,0
"Viet Nam","2024-09-13",0,0,82,0,0,83,0,0
"Viet Nam","2024-09-14",0,0,82,0,0,83,0,0
"Viet Nam","2024-09-15",0,0,82,0,0,83,0,0
"Viet Nam","2024-09-16",0,0,82,0,0,83,0,0
"Viet Nam","2024-09-17",0,0,82,0,0,83,0,0
"Viet Nam","2024-09-18",0,0,82,0,0,83,0,0
"Viet Nam","2024-09-19",0,0,82,0,0,83,0,0
"Viet Nam","2024-09-20",0,0,82,0,0,83,0,0
"Viet Nam","2024-09-21",0,0,82,0,0,83,0,0
"Viet Nam","2024-09-22",0,0,82,0,0,83,0,0
"Viet Nam","2024-09-23",0,0,82,0,0,83,0,0
"Viet Nam","2024-09-24",0,0,82,0,0,83,0,0
"Viet Nam","2024-09-25",0,0,82,0,0,83,0,0
"Viet Nam","2024-09-26",0,0,82,0,0,83,0,0
"Viet Nam","2024-09-27",0,0,82,0,0,83,0,0
"Viet Nam","2024-09-28",0,0,82,0,0,83,0,0
"Viet Nam","2024-09-29",0,0,82,0,0,83,0,0
"Viet Nam","2024-09-30",0,0,82,0,0,83,0,0
"Viet Nam","2024-10-01",0,0,82,0,0,83,0,0
"Viet Nam","2024-10-02",0,0,82,0,0,83,0,0
"Viet Nam","2024-10-03",0,0,82,0,0,83,0,0
"Viet Nam","2024-10-04",0,0,82,0,0,83,0,0
"Viet Nam","2024-10-05",0,0,82,0,1,84,0,0
"Viet Nam","2024-10-06",0,0,82,0,0,84,0,0
"Viet Nam","2024-10-07",0,0,82,0,0,84,0,0
"Viet Nam","2024-10-08",0,0,82,0,0,84,0,0
"Viet Nam","2024-10-09",0,0,82,0,0,84,0,0
"Viet Nam","2024-10-10",0,0,82,0,0,84,0,0
"Viet Nam","2024-10-11",0,0,82,0,0,84,0,0
"Viet Nam","2024-10-12",0,0,82,0,0,84,0,0
"Viet Nam","2024-10-13",0,0,82,0,0,84,0,0
"Viet Nam","2024-10-14",0,0,82,0,0,84,0,0
"Viet Nam","2024-10-15",0,0,82,0,0,84,0,0
"Viet Nam","2024-10-16",0,0,82,0,0,84,0,0
"Viet Nam","2024-10-17",0,0,82,0,0,84,0,0
"Viet Nam","2024-10-18",0,0,82,0,0,84,0,0
"Viet Nam","2024-10-19",0,0,82,0,0,84,0,0
"Viet Nam","2024-10-20",0,0,82,0,0,84,0,0
"Viet Nam","2024-10-21",0,0,82,0,0,84,0,0
"Viet Nam","2024-10-22",0,0,82,0,0,84,0,0
"Viet Nam","2024-10-23",0,0,82,0,0,84,0,0
"Viet Nam","2024-10-24",0,0,82,0,0,84,0,0
"Viet Nam","2024-10-25",0,0,82,0,0,84,0,0
"Viet Nam","2024-10-26",0,0,82,0,0,84,0,0
"Viet Nam","2024-10-27",0,0,82,0,0,84,0,0
"Viet Nam","2024-10-28",0,0,82,0,0,84,0,0
"Viet Nam","2024-10-29",0,0,82,0,0,84,0,0
"Viet Nam","2024-10-30",0,0,82,0,0,84,0,0
"Viet Nam","2024-10-31",0,0,82,0,0,84,0,0
"Viet Nam","2024-11-01",0,2,84,0,0,84,0,0
"Viet Nam","2024-11-02",0,0,84,0,0,84,0,0
"Viet Nam","2024-11-03",0,0,84,0,0,84,0,0
"Viet Nam","2024-11-04",0,0,84,0,0,84,0,0
"Viet Nam","2024-11-05",0,0,84,0,0,84,0,0
"Viet Nam","2024-11-06",0,0,84,0,0,84,0,0
"Viet Nam","2024-11-07",0,0,84,0,0,84,0,0
"Viet Nam","2024-11-08",0,0,84,0,0,84,0,0
"Viet Nam","2024-11-09",0,0,84,0,0,84,0,0
"Viet Nam","2024-11-10",0,0,84,0,0,84,0,0
"Viet Nam","2024-11-11",0,0,84,0,0,84,0,0
"Viet Nam","2024-11-12",0,0,84,0,0,84,0,0
"Viet Nam","2024-11-13",0,0,84,0,0,84,0,0
"Viet Nam","2024-11-14",0,0,84,0,0,84,0,0
"Viet Nam","2024-11-15",0,0,84,0,0,84,0,0
"Viet Nam","2024-11-16",0,0,84,0,0,84,0,0
"Viet Nam","2024-11-17",0,0,84,0,0,84,0,0
"Viet Nam","2024-11-18",0,0,84,0,0,84,0,0
"Viet Nam","2024-11-19",0,0,84,0,0,84,0,0
"Viet Nam","2024-11-20",0,0,84,0,0,84,0,0
"Viet Nam","2024-11-21",0,0,84,0,0,84,0,0
"Viet Nam","2024-11-22",0,0,84,0,0,84,0,0
"Viet Nam","2024-11-23",0,0,84,0,0,84,0,0
"Viet Nam","2024-11-24",0,0,84,0,0,84,0,0
"Viet Nam","2024-11-25",0,0,84,0,0,84,0,0
"Viet Nam","2024-11-26",0,0,84,0,0,84,0,0
"Viet Nam","2024-11-27",0,0,84,0,0,84,0,0
"Viet Nam","2024-11-28",0,0,84,0,0,84,0,0
"Viet Nam","2024-11-29",0,0,84,0,0,84,0,0
"Viet Nam","2024-11-30",0,0,84,0,0,84,0,0
"Viet Nam","2024-12-01",0,0,84,0,0,84,0,0
"Viet Nam","2024-12-02",0,0,84,0,0,84,0,0
"Viet Nam","2024-12-03",0,0,84,0,0,84,0,0
"Viet Nam","2024-12-04",0,0,84,0,0,84,0,0
"Viet Nam","2024-12-05",0,0,84,0,0,84,0,0
"Viet Nam","2024-12-06",0,0,84,0,0,84,0,0
"Viet Nam","2024-12-07",0,0,84,0,0,84,0,0
"Viet Nam","2024-12-08",0,0,84,0,0,84,0,0
"Viet Nam","2024-12-09",0,0,84,0,0,84,0,0
"World","2024-01-01",0,0,0,0,0,0,0,0
"World","2024-01-02",0,111,111,0,111,111,0,0
"World","2024-01-03",0,0,111,0,1,112,0,0
"World","2024-01-04",0,2,113,0,1,113,0,0
"World","2024-01-05",0,1,114,0,1,114,0,0
"World","2024-01-06",0,0,114,0,29,143,0,0
"World","2024-01-07",0,58,172,0,29,172,0,0
"World","2024-01-08",0,0,172,0,54,226,0,0
"World","2024-01-09",0,109,281,0,55,281,0,0
"World","2024-01-10",0,14,295,0,14,295,0,0
"World","2024-01-11",0,1,296,0,1,296,0,0
"World","2024-01-12",0,1,297,0,1,297,0,0
"World","2024-01-13",0,0,297,0,38,335,0,0
"World","2024-01-14",0,76,373,0,38,373,0,0
"World","2024-01-15",0,0,373,0,66,439,0,0
"World","2024-01-16",0,133,506,0,67,506,0,0
"World","2024-01-17",0,1,507,0,1,507,0,0
"World","2024-01-18",0,0,507,0,1,508,0,0
"World","2024-01-19",0,2,509,0,1,509,0,0
"World","2024-01-20",0,2,511,0,2,511,0,0
"World","2024-01-21",0,91,602,0,91,602,0,0
"World","2024-01-22",0,0,602,0,46,648,0,0
"World","2024-01-23",0,92,694,0,46,694,0,0
"World","2024-01-24",0,6,700,0,6,700,0,0
"World","2024-01-25",0,0,700,0,28,728,0,0
"World","2024-01-26",0,0,700,0,28,756,0,0
"World","2024-01-27",0,0,700,0,27,783,0,0
"World","2024-01-28",0,111,811,0,28,811,0,0
"World","2024-01-29",0,0,811,0,67,878,0,0
"World","2024-01-30",0,134,945,0,67,945,0,0
"World","2024-01-31",0,303,1248,0,303,1248,0,0
"World","2024-02-01",0,0,1248,0,2,1250,0,0
"World","2024-02-02",0,5,1253,0,3,1253,0,0
"World","2024-02-03",0,0,1253,0,35,1288,0,0
"World","2024-02-04",0,70,1323,0,35,1323,0,0
"World","2024-02-05",0,3,1326,0,3,1326,0,0
"World","2024-02-06",0,104,1430,0,104,1430,0,0
"World","2024-02-07",0,0,1430,0,2,1432,0,0
"World","2024-02-08",0,0,1430,0,1,1433,0,0
"World","2024-02-09",0,5,1435,0,2,1435,0,0
"World","2024-02-10",0,0,1435,0,48,1483,0,0
"World","2024-02-11",0,95,1530,0,47,1530,0,0
"World","2024-02-12",0,0,1530,0,52,1582,0,0
"World","2024-02-13",0,103,1633,0,51,1633,0,0
"World","2024-02-14",0,0,1633,0,0,1633,0,0
"World","2024-02-15",0,1,1634,0,1,1634,0,0
"World","2024-02-16",0,1,1635,0,1,1635,0,0
"World","2024-02-17",0,0,1635,0,38,1673,0,0
"World","2024-02-18",0,75,1710,0,37,1710,0,0
"World","2024-02-19",0,0,1710,0,55,1765,0,0
"World","2024-02-20",0,110,1820,0,55,1820,0,0
"World","2024-02-21",0,0,1820,0,3,1823,0,0
"World","2024-02-22",0,0,1820,0,4,1827,0,0
"World","2024-02-23",0,10,1830,0,3,1830,0,0
"World","2024-02-24",0,0,1830,0,36,1866,0,0
"World","2024-02-25",0,71,1901,0,35,1901,0,0
"World","2024-02-26",0,0,1901,0,59,1960,0,0
"World","2024-02-27",0,118,2019,0,59,2019,0,0
"World","2024-02-28",0,15,2034,0,15,2034,0,0
"World","2024-02-29",0,309,2343,0,309,2343,0,0
"World","2024-03-01",0,4,2347,0,4,2347,0,0
"World","2024-03-02",0,1,2348,0,1,2348,0,0
"World","2024-03-03",0,82,2430,0,82,2430,0,0
"World","2024-03-04",0,0,2430,0,52,2482,0,0
"World","2024-03-05",0,104,2534,0,52,2534,0,0
"World","2024-03-06",0,10,2544,0,10,2544,0,0
"World","2024-03-07",0,0,2544,0,2,2546,0,0
"World","2024-03-08",0,3,2547,0,1,2547,0,0
"World","2024-03-09",0,0,2547,0,39,2586,0,0
"World","2024-03-10",0,78,2625,0,39,2625,0,0
"World","2024-03-11",0,0,2625,0,56,2681,0,0
"World","2024-03-12",0,111,2736,0,55,2736,0,0
"World","2024-03-13",0,0,2736,0,1,2737,0,0
"World","2024-03-14",0,0,2736,0,1,2738,0,0
"World","2024-03-15",0,3,2739,0,1,2739,0,0
"World","2024-03-16",0,0,2739,0,37,2776,0,0
"World","2024-03-17",0,74,2813,0,37,2813,0,0
"World","2024-03-18",0,0,2813,0,44,2857,0,0
"World","2024-03-19",0,89,2902,0,45,2902,0,0
"World","2024-03-20",0,0,2902,0,0,2902,0,0
"World","2024-03-21",0,0,2902,0,1,2903,0,0
"World","2024-03-22",0,1,2903,0,0,2903,0,0
"World","2024-03-23",0,0,2903,0,42,2945,0,0
"World","2024-03-24",0,84,2987,0,42,2987,0,0
"World","2024-03-25",0,0,2987,0,54,3041,0,0
"World","2024-03-26",0,109,3096,0,55,3096,0,0
"World","2024-03-27",0,0,3096,0,57,3153,0,0
"World","2024-03-28",0,0,3096,0,57,3210,0,0
"World","2024-03-29",0,0,3096,0,58,3268,0,0
"World","2024-03-30",0,0,3096,0,57,3325,0,0
"World","2024-03-31",0,286,3382,0,57,3382,0,0
"World","2024-04-01",0,6,3388,0,6,3388,0,0
"World","2024-04-02",0,82,3470,0,82,3470,0,0
"World","2024-04-03",0,0,3470,0,1,3471,0,0
"World","2024-04-04",0,0,3470,0,1,3472,0,0
"World","2024-04-05",0,3,3473,0,1,3473,0,0
"World","2024-04-06",0,0,3473,0,44,3517,0,0
"World","2024-04-07",0,89,3562,0,45,3562,0,0
"World","2024-04-08",0,0,3562,0,48,3610,0,0
"World","2024-04-09",0,97,3659,0,49,3659,0,0
"World","2024-04-10",0,0,3659,0,1,3660,0,0
"World","2024-04-11",0,0,3659,0,0,3660,0,0
"World","2024-04-12",0,2,3661,0,1,3661,0,0
"World","2024-04-13",0,0,3661,0,68,3729,0,0
"World","2024-04-14",0,137,3798,0,69,3798,0,0
"World","2024-04-15",0,0,3798,0,52,3850,0,0
"World","2024-04-16",0,103,3901,0,51,3901,0,0
"World","2024-04-17",0,0,3901,0,0,3901,0,0
"World","2024-04-18",0,0,3901,0,1,3902,0,0
"World","2024-04-19",0,1,3902,0,0,3902,0,0
"World","2024-04-20",0,1,3903,0,1,3903,0,0
"World","2024-04-21",0,148,4051,0,148,4051,0,0
"World","2024-04-22",0,0,4051,0,59,4110,0,0
"World","2024-04-23",0,118,4169,0,59,4169,0,0
"World","2024-04-24",0,0,4169,0,1,4170,0,0
"World","2024-04-25",0,0,4169,0,0,4170,0,0
"World","2024-04-26",0,2,4171,0,1,4171,0,0
"World","2024-04-27",0,1,4172,0,1,4172,0,0
"World","2024-04-28",0,170,4342,0,170,4342,0,0
"World","2024-04-29",0,0,4342,0,130,4472,0,0
"World","2024-04-30",0,259,4601,0,129,4601,0,0
"World","2024-05-01",0,0,4601,0,41,4642,0,0
"World","2024-05-02",0,0,4601,0,41,4683,0,0
"World","2024-05-03",0,0,4601,0,41,4724,0,0
"World","2024-05-04",0,0,4601,0,41,4765,0,0
"World","2024-05-05",0,205,4806,0,41,4806,0,0
"World","2024-05-06",0,0,4806,0,40,4846,0,0
"World","2024-05-07",0,80,4886,0,40,4886,0,0
"World","2024-05-08",0,0,4886,0,0,4886,0,0
"World","2024-05-09",0,1,4887,0,1,4887,0,0
"World","2024-05-10",0,25,4912,0,25,4912,0,0
"World","2024-05-11",0,0,4912,0,88,5000,0,0
"World","2024-05-12",0,177,5089,0,89,5089,0,0
"World","2024-05-13",0,0,5089,0,43,5132,0,0
"World","2024-05-14",0,86,5175,0,43,5175,0,0
"World","2024-05-15",0,0,5175,0,40,5215,0,0
"World","2024-05-16",0,0,5175,0,41,5256,0,0
"World","2024-05-17",0,0,5175,0,40,5296,0,0
"World","2024-05-18",0,0,5175,0,41,5337,0,0
"World","2024-05-19",0,202,5377,0,40,5377,0,0
"World","2024-05-20",0,0,5377,0,37,5414,0,0
"World","2024-05-21",0,74,5451,0,37,5451,0,0
"World","2024-05-22",0,1,5452,0,1,5452,0,0
"World","2024-05-23",0,0,5452,0,2,5454,0,0
"World","2024-05-24",0,4,5456,0,2,5456,0,0
"World","2024-05-25",0,0,5456,0,95,5551,0,0
"World","2024-05-26",0,190,5646,0,95,5646,0,0
"World","2024-05-27",0,1,5647,0,1,5647,0,0
"World","2024-05-28",0,93,5740,0,93,5740,0,0
"World","2024-05-29",0,0,5740,0,24,5764,0,0
"World","2024-05-30",0,49,5789,0,25,5789,0,0
"World","2024-05-31",0,215,6004,0,215,6004,0,0
"World","2024-06-01",0,0,6004,0,98,6102,0,0
"World","2024-06-02",0,195,6199,0,97,6199,0,0
"World","2024-06-03",0,0,6199,0,42,6241,0,0
"World","2024-06-04",0,84,6283,0,42,6283,0,0
"World","2024-06-05",0,0,6283,0,46,6329,0,0
"World","2024-06-06",0,0,6283,0,46,6375,0,0
"World","2024-06-07",0,0,6283,0,45,6420,0,0
"World","2024-06-08",0,0,6283,0,46,6466,0,0
"World","2024-06-09",0,229,6512,0,46,6512,0,0
"World","2024-06-10",0,0,6512,0,49,6561,0,0
"World","2024-06-11",0,98,6610,0,49,6610,0,0
"World","2024-06-12",0,0,6610,0,52,6662,0,0
"World","2024-06-13",0,0,6610,0,52,6714,0,0
"World","2024-06-14",0,0,6610,0,52,6766,0,0
"World","2024-06-15",0,0,6610,0,52,6818,0,0
"World","2024-06-16",0,260,6870,0,52,6870,0,0
"World","2024-06-17",0,0,6870,0,33,6903,0,0
"World","2024-06-18",0,66,6936,0,33,6936,0,0
"World","2024-06-19",0,0,6936,0,57,6993,0,0
"World","2024-06-20",0,0,6936,0,56,7049,0,0
"World","2024-06-21",0,0,6936,0,57,7106,0,0
"World","2024-06-22",0,0,6936,0,56,7162,0,0
"World","2024-06-23",0,283,7219,0,57,7219,0,0
"World","2024-06-24",0,4,7223,0,4,7223,0,0
"World","2024-06-25",0,79,7302,0,79,7302,0,0
"World","2024-06-26",0,0,7302,0,2,7304,0,0
"World","2024-06-27",0,0,7302,0,3,7307,0,0
"World","2024-06-28",0,7,7309,0,2,7309,0,0
"World","2024-06-29",0,0,7309,0,240,7549,0,0
"World","2024-06-30",0,479,7788,0,239,7788,0,0
"World","2024-07-01",0,2,7790,0,2,7790,0,0
"World","2024-07-02",0,91,7881,0,91,7881,0,0
"World","2024-07-03",0,0,7881,0,53,7934,0,0
"World","2024-07-04",0,0,7881,0,53,7987,0,0
"World","2024-07-05",0,0,7881,0,52,8039,0,0
"World","2024-07-06",0,0,7881,0,53,8092,0,0
"World","2024-07-07",0,264,8145,0,53,8145,0,0
"World","2024-07-08",0,2,8147,0,2,8147,0,0
"World","2024-07-09",0,93,8240,0,93,8240,0,0
"World","2024-07-10",0,0,8240,0,1,8241,0,0
"World","2024-07-11",0,0,8240,0,0,8241,0,0
"World","2024-07-12",0,2,8242,0,1,8242,0,0
"World","2024-07-13",0,1,8243,0,1,8243,0,0
"World","2024-07-14",0,337,8580,0,337,8580,0,0
"World","2024-07-15",0,14,8594,0,14,8594,0,0
"World","2024-07-16",0,114,8708,0,114,8708,0,0
"World","2024-07-17",0,0,8708,0,87,8795,0,0
"World","2024-07-18",0,0,8708,0,88,8883,0,0
"World","2024-07-19",0,0,8708,0,87,8970,0,0
"World","2024-07-20",0,0,8708,0,88,9058,0,0
"World","2024-07-21",0,437,9145,0,87,9145,0,0
"World","2024-07-22",0,21,9166,0,21,9166,0,0
"World","2024-07-23",0,93,9259,0,93,9259,0,0
"World","2024-07-24",0,0,9259,0,5,9264,0,0
"World","2024-07-25",0,0,9259,0,5,9269,0,0
"World","2024-07-26",0,0,9259,0,6,9275,0,0
"World","2024-07-27",0,21,9280,0,5,9280,0,0
"World","2024-07-28",0,414,9694,0,414,9694,0,0
"World","2024-07-29",0,0,9694,0,90,9784,0,0
"World","2024-07-30",0,181,9875,0,91,9875,0,0
"World","2024-07-31",0,188,10063,0,188,10063,0,0
"World","2024-08-01",0,0,10063,0,3,10066,0,0
"World","2024-08-02",0,6,10069,0,3,10069,0,0
"World","2024-08-03",0,0,10069,0,184,10253,0,0
"World","2024-08-04",0,367,10436,0,183,10436,0,0
"World","2024-08-05",0,1,10437,0,1,10437,0,0
"World","2024-08-06",0,140,10577,0,140,10577,0,0
"World","2024-08-07",0,0,10577,0,76,10653,0,0
"World","2024-08-08",0,0,10577,0,76,10729,0,0
"World","2024-08-09",0,0,10577,0,77,10806,0,0
"World","2024-08-10",0,0,10577,0,76,10882,0,0
"World","2024-08-11",0,381,10958,0,76,10958,0,0
"World","2024-08-12",0,0,10958,0,86,11044,0,0
"World","2024-08-13",0,171,11129,0,85,11129,0,0
"World","2024-08-14",0,1,11130,0,1,11130,0,0
"World","2024-08-15",0,2,11132,0,2,11132,0,0
"World","2024-08-16",0,0,11132,0,137,11269,0,0
"World","2024-08-17",0,0,11132,0,138,11407,0,0
"World","2024-08-18",0,412,11544,0,137,11544,0,0
"World","2024-08-19",0,1,11545,0,1,11545,0,0
"World","2024-08-20",0,180,11725,0,180,11725,0,0
"World","2024-08-21",0,75,11800,0,75,11800,0,0
"World","2024-08-22",0,1,11801,0,1,11801,0,0
"World","2024-08-23",0,1,11802,0,1,11802,0,0
"World","2024-08-24",0,0,11802,0,218,12020,0,0
"World","2024-08-25",0,435,12237,0,217,12237,0,0
"World","2024-08-26",0,0,12237,0,90,12327,0,0
"World","2024-08-27",0,180,12417,0,90,12417,0,0
"World","2024-08-28",0,4,12421,0,4,12421,0,0
"World","2024-08-29",0,70,12491,0,70,12491,0,0
"World","2024-08-30",0,0,12491,0,226,12717,0,0
"World","2024-08-31",0,451,12942,0,225,12942,0,0
"World","2024-09-01",0,441,13383,0,441,13383,0,0
"World","2024-09-02",0,1,13384,0,1,13384,0,0
"World","2024-09-03",0,176,13560,0,176,13560,0,0
"World","2024-09-04",0,0,13560,0,88,13648,0,0
"World","2024-09-05",0,0,13560,0,88,13736,0,0
"World","2024-09-06",0,0,13560,0,88,13824,0,0
"World","2024-09-07",0,0,13560,0,88,13912,0,0
"World","2024-09-08",0,440,14000,0,88,14000,0,0
"World","2024-09-09",0,0,14000,0,74,14074,0,0
"World","2024-09-10",0,148,14148,0,74,14148,0,0
"World","2024-09-11",0,0,14148,0,0,14148,0,0
"World","2024-09-12",0,1,14149,0,1,14149,0,0
"World","2024-09-13",0,0,14149,0,200,14349,0,0
"World","2024-09-14",0,0,14149,0,201,14550,0,0
"World","2024-09-15",0,601,14750,0,200,14750,0,0
"World","2024-09-16",0,0,14750,0,64,14814,0,0
"World","2024-09-17",0,129,14879,0,65,14879,0,0
"World","2024-09-18",0,1,14880,0,1,14880,0,0
"World","2024-09-19",0,0,14880,0,143,15023,0,0
"World","2024-09-20",0,0,14880,0,143,15166,0,0
"World","2024-09-21",0,0,14880,0,143,15309,0,0
"World","2024-09-22",0,572,15452,0,143,15452,0,0
"World","2024-09-23",0,3,15455,0,3,15455,0,0
"World","2024-09-24",0,122,15577,0,122,15577,0,0
"World","2024-09-25",0,0,15577,0,8,15585,0,0
"World","2024-09-26",0,15,15592,0,7,15592,0,0
"World","2024-09-27",0,0,15592,0,2,15594,0,0
"World","2024-09-28",0,3,15595,0,1,15595,0,0
"World","2024-09-29",0,769,16364,0,769,16364,0,0
"World","2024-09-30",0,227,16591,0,227,16591,0,0
"World","2024-10-01",0,126,16717,0,126,16717,0,0
"World","2024-10-02",0,1,16718,0,1,16718,0,0
"World","2024-10-03",0,2,16720,0,2,16720,0,0
"World","2024-10-04",0,1,16721,0,1,16721,0,0
"World","2024-10-05",0,0,16721,0,299,17020,0,0
"World","2024-10-06",0,598,17319,0,299,17319,0,0
"World","2024-10-07",0,23,17342,0,23,17342,0,0
"World","2024-10-08",0,90,17432,0,90,17432,0,0
"World","2024-10-09",0,0,17432,0,1,17433,0,0
"World","2024-10-10",0,2,17434,0,1,17434,0,0
"World","2024-10-11",0,2,17436,0,2,17436,0,0
"World","2024-10-12",0,2,17438,0,2,17438,0,0
"World","2024-10-13",0,652,18090,0,652,18090,0,0
"World","2024-10-14",0,0,18090,0,34,18124,0,0
"World","2024-10-15",0,69,18159,0,35,18159,0,0
"World","2024-10-16",0,0,18159,0,1,18160,0,0
"World","2024-10-17",0,0,18159,0,0,18160,0,0
"World","2024-10-18",0,2,18161,0,1,18161,0,0
"World","2024-10-19",0,0,18161,0,295,18456,0,0
"World","2024-10-20",0,590,18751,0,295,18751,0,0
"World","2024-10-21",0,46,18797,0,46,18797,0,0
"World","2024-10-22",0,42,18839,0,42,18839,0,0
"World","2024-10-23",0,2,18841,0,2,18841,0,0
"World","2024-10-24",0,0,18841,0,1,18842,0,0
"World","2024-10-25",0,0,18841,0,0,18842,0,0
"World","2024-10-26",0,2,18843,0,1,18843,0,0
"World","2024-10-27",0,724,19567,0,724,19567,0,0
"World","2024-10-28",0,0,19567,0,6,19573,0,0
"World","2024-10-29",0,11,19578,0,5,19578,0,0
"World","2024-10-30",0,3,19581,0,3,19581,0,0
"World","2024-10-31",0,243,19824,0,243,19824,0,0
"World","2024-11-01",0,2,19826,0,2,19826,0,0
"World","2024-11-02",0,0,19826,0,278,20104,0,0
"World","2024-11-03",0,557,20383,0,279,20383,0,0
"World","2024-11-04",0,1,20384,0,1,20384,0,0
"World","2024-11-05",0,0,20384,0,4,20388,0,0
"World","2024-11-06",0,9,20393,0,5,20393,0,0
"World","2024-11-07",0,0,20393,0,19,20412,0,0
"World","2024-11-08",0,0,20393,0,18,20430,0,0
"World","2024-11-09",0,56,20449,0,19,20449,0,0
"World","2024-11-10",0,278,20727,0,278,20727,0,0
"World","2024-11-11",0,11,20738,0,11,20738,0,0
"World","2024-11-12",0,0,20738,0,0,20738,0,0
"World","2024-11-13",0,0,20738,0,0,20738,0,0
"World","2024-11-14",0,0,20738,0,0,20738,0,0
"World","2024-11-15",0,0,20738,0,0,20738,0,0
"World","2024-11-16",0,0,20738,0,0,20738,0,0
"World","2024-11-17",0,0,20738,0,0,20738,0,0
"World","2024-11-18",0,0,20738,0,0,20738,0,0
"World","2024-11-19",0,0,20738,0,0,20738,0,0
"World","2024-11-20",0,0,20738,0,0,20738,0,0
"World","2024-11-21",0,0,20738,0,0,20738,0,0
"World","2024-11-22",0,0,20738,0,0,20738,0,0
"World","2024-11-23",0,0,20738,0,0,20738,0,0
"World","2024-11-24",0,0,20738,0,0,20738,0,0
"World","2024-11-25",0,0,20738,0,0,20738,0,0
"World","2024-11-26",0,0,20738,0,0,20738,0,0
"World","2024-11-27",0,0,20738,0,0,20738,0,0
"World","2024-11-28",0,0,20738,0,0,20738,0,0
"World","2024-11-29",0,0,20738,0,0,20738,0,0
"World","2024-11-30",0,0,20738,0,0,20738,0,0
"World","2024-12-01",0,0,20738,0,0,20738,0,0
"World","2024-12-02",0,0,20738,0,0,20738,0,0
"World","2024-12-03",0,0,20738,0,0,20738,0,0
"World","2024-12-04",0,0,20738,0,0,20738,0,0
"World","2024-12-05",0,0,20738,0,0,20738,0,0
"World","2024-12-06",0,0,20738,0,0,20738,0,0
"World","2024-12-07",0,0,20738,0,0,20738,0,0
"World","2024-12-08",0,0,20738,0,0,20738,0,0
"World","2024-12-09",0,0,20738,0,0,20738,0,0
"Zambia","2024-01-01",0,0,0,0,0,0,0,0
"Zambia","2024-01-02",0,0,0,0,0,0,0,0
"Zambia","2024-01-03",0,0,0,0,0,0,0,0
"Zambia","2024-01-04",0,0,0,0,0,0,0,0
"Zambia","2024-01-05",0,0,0,0,0,0,0,0
"Zambia","2024-01-06",0,0,0,0,0,0,0,0
"Zambia","2024-01-07",0,0,0,0,0,0,0,0
"Zambia","2024-01-08",0,0,0,0,0,0,0,0
"Zambia","2024-01-09",0,0,0,0,0,0,0,0
"Zambia","2024-01-10",0,0,0,0,0,0,0,0
"Zambia","2024-01-11",0,0,0,0,0,0,0,0
"Zambia","2024-01-12",0,0,0,0,0,0,0,0
"Zambia","2024-01-13",0,0,0,0,0,0,0,0
"Zambia","2024-01-14",0,0,0,0,0,0,0,0
"Zambia","2024-01-15",0,0,0,0,0,0,0,0
"Zambia","2024-01-16",0,0,0,0,0,0,0,0
"Zambia","2024-01-17",0,0,0,0,0,0,0,0
"Zambia","2024-01-18",0,0,0,0,0,0,0,0
"Zambia","2024-01-19",0,0,0,0,0,0,0,0
"Zambia","2024-01-20",0,0,0,0,0,0,0,0
"Zambia","2024-01-21",0,0,0,0,0,0,0,0
"Zambia","2024-01-22",0,0,0,0,0,0,0,0
"Zambia","2024-01-23",0,0,0,0,0,0,0,0
"Zambia","2024-01-24",0,0,0,0,0,0,0,0
"Zambia","2024-01-25",0,0,0,0,0,0,0,0
"Zambia","2024-01-26",0,0,0,0,0,0,0,0
"Zambia","2024-01-27",0,0,0,0,0,0,0,0
"Zambia","2024-01-28",0,0,0,0,0,0,0,0
"Zambia","2024-01-29",0,0,0,0,0,0,0,0
"Zambia","2024-01-30",0,0,0,0,0,0,0,0
"Zambia","2024-01-31",0,0,0,0,0,0,0,0
"Zambia","2024-02-01",0,0,0,0,0,0,0,0
"Zambia","2024-02-02",0,0,0,0,0,0,0,0
"Zambia","2024-02-03",0,0,0,0,0,0,0,0
"Zambia","2024-02-04",0,0,0,0,0,0,0,0
"Zambia","2024-02-05",0,0,0,0,0,0,0,0
"Zambia","2024-02-06",0,0,0,0,0,0,0,0
"Zambia","2024-02-07",0,0,0,0,0,0,0,0
"Zambia","2024-02-08",0,0,0,0,0,0,0,0
"Zambia","2024-02-09",0,0,0,0,0,0,0,0
"Zambia","2024-02-10",0,0,0,0,0,0,0,0
"Zambia","2024-02-11",0,0,0,0,0,0,0,0
"Zambia","2024-02-12",0,0,0,0,0,0,0,0
"Zambia","2024-02-13",0,0,0,0,0,0,0,0
"Zambia","2024-02-14",0,0,0,0,0,0,0,0
"Zambia","2024-02-15",0,0,0,0,0,0,0,0
"Zambia","2024-02-16",0,0,0,0,0,0,0,0
"Zambia","2024-02-17",0,0,0,0,0,0,0,0
"Zambia","2024-02-18",0,0,0,0,0,0,0,0
"Zambia","2024-02-19",0,0,0,0,0,0,0,0
"Zambia","2024-02-20",0,0,0,0,0,0,0,0
"Zambia","2024-02-21",0,0,0,0,0,0,0,0
"Zambia","2024-02-22",0,0,0,0,0,0,0,0
"Zambia","2024-02-23",0,0,0,0,0,0,0,0
"Zambia","2024-02-24",0,0,0,0,0,0,0,0
"Zambia","2024-02-25",0,0,0,0,0,0,0,0
"Zambia","2024-02-26",0,0,0,0,0,0,0,0
"Zambia","2024-02-27",0,0,0,0,0,0,0,0
"Zambia","2024-02-28",0,0,0,0,0,0,0,0
"Zambia","2024-02-29",0,0,0,0,0,0,0,0
"Zambia","2024-03-01",0,0,0,0,0,0,0,0
"Zambia","2024-03-02",0,0,0,0,0,0,0,0
"Zambia","2024-03-03",0,0,0,0,0,0,0,0
"Zambia","2024-03-04",0,0,0,0,0,0,0,0
"Zambia","2024-03-05",0,0,0,0,0,0,0,0
"Zambia","2024-03-06",0,0,0,0,0,0,0,0
"Zambia","2024-03-07",0,0,0,0,0,0,0,0
"Zambia","2024-03-08",0,0,0,0,0,0,0,0
"Zambia","2024-03-09",0,0,0,0,0,0,0,0
"Zambia","2024-03-10",0,0,0,0,0,0,0,0
"Zambia","2024-03-11",0,0,0,0,0,0,0,0
"Zambia","2024-03-12",0,0,0,0,0,0,0,0
"Zambia","2024-03-13",0,0,0,0,0,0,0,0
"Zambia","2024-03-14",0,0,0,0,0,0,0,0
"Zambia","2024-03-15",0,0,0,0,0,0,0,0
"Zambia","2024-03-16",0,0,0,0,0,0,0,0
"Zambia","2024-03-17",0,0,0,0,0,0,0,0
"Zambia","2024-03-18",0,0,0,0,0,0,0,0
"Zambia","2024-03-19",0,0,0,0,0,0,0,0
"Zambia","2024-03-20",0,0,0,0,0,0,0,0
"Zambia","2024-03-21",0,0,0,0,0,0,0,0
"Zambia","2024-03-22",0,0,0,0,0,0,0,0
"Zambia","2024-03-23",0,0,0,0,0,0,0,0
"Zambia","2024-03-24",0,0,0,0,0,0,0,0
"Zambia","2024-03-25",0,0,0,0,0,0,0,0
"Zambia","2024-03-26",0,0,0,0,0,0,0,0
"Zambia","2024-03-27",0,0,0,0,0,0,0,0
"Zambia","2024-03-28",0,0,0,0,0,0,0,0
"Zambia","2024-03-29",0,0,0,0,0,0,0,0
"Zambia","2024-03-30",0,0,0,0,0,0,0,0
"Zambia","2024-03-31",0,0,0,0,0,0,0,0
"Zambia","2024-04-01",0,0,0,0,0,0,0,0
"Zambia","2024-04-02",0,0,0,0,0,0,0,0
"Zambia","2024-04-03",0,0,0,0,0,0,0,0
"Zambia","2024-04-04",0,0,0,0,0,0,0,0
"Zambia","2024-04-05",0,0,0,0,0,0,0,0
"Zambia","2024-04-06",0,0,0,0,0,0,0,0
"Zambia","2024-04-07",0,0,0,0,0,0,0,0
"Zambia","2024-04-08",0,0,0,0,0,0,0,0
"Zambia","2024-04-09",0,0,0,0,0,0,0,0
"Zambia","2024-04-10",0,0,0,0,0,0,0,0
"Zambia","2024-04-11",0,0,0,0,0,0,0,0
"Zambia","2024-04-12",0,0,0,0,0,0,0,0
"Zambia","2024-04-13",0,0,0,0,0,0,0,0
"Zambia","2024-04-14",0,0,0,0,0,0,0,0
"Zambia","2024-04-15",0,0,0,0,0,0,0,0
"Zambia","2024-04-16",0,0,0,0,0,0,0,0
"Zambia","2024-04-17",0,0,0,0,0,0,0,0
"Zambia","2024-04-18",0,0,0,0,0,0,0,0
"Zambia","2024-04-19",0,0,0,0,0,0,0,0
"Zambia","2024-04-20",0,0,0,0,0,0,0,0
"Zambia","2024-04-21",0,0,0,0,0,0,0,0
"Zambia","2024-04-22",0,0,0,0,0,0,0,0
"Zambia","2024-04-23",0,0,0,0,0,0,0,0
"Zambia","2024-04-24",0,0,0,0,0,0,0,0
"Zambia","2024-04-25",0,0,0,0,0,0,0,0
"Zambia","2024-04-26",0,0,0,0,0,0,0,0
"Zambia","2024-04-27",0,0,0,0,0,0,0,0
"Zambia","2024-04-28",0,0,0,0,0,0,0,0
"Zambia","2024-04-29",0,0,0,0,0,0,0,0
"Zambia","2024-04-30",0,0,0,0,0,0,0,0
"Zambia","2024-05-01",0,0,0,0,0,0,0,0
"Zambia","2024-05-02",0,0,0,0,0,0,0,0
"Zambia","2024-05-03",0,0,0,0,0,0,0,0
"Zambia","2024-05-04",0,0,0,0,0,0,0,0
"Zambia","2024-05-05",0,0,0,0,0,0,0,0
"Zambia","2024-05-06",0,0,0,0,0,0,0,0
"Zambia","2024-05-07",0,0,0,0,0,0,0,0
"Zambia","2024-05-08",0,0,0,0,0,0,0,0
"Zambia","2024-05-09",0,0,0,0,0,0,0,0
"Zambia","2024-05-10",0,0,0,0,0,0,0,0
"Zambia","2024-05-11",0,0,0,0,0,0,0,0
"Zambia","2024-05-12",0,0,0,0,0,0,0,0
"Zambia","2024-05-13",0,0,0,0,0,0,0,0
"Zambia","2024-05-14",0,0,0,0,0,0,0,0
"Zambia","2024-05-15",0,0,0,0,0,0,0,0
"Zambia","2024-05-16",0,0,0,0,0,0,0,0
"Zambia","2024-05-17",0,0,0,0,0,0,0,0
"Zambia","2024-05-18",0,0,0,0,0,0,0,0
"Zambia","2024-05-19",0,0,0,0,0,0,0,0
"Zambia","2024-05-20",0,0,0,0,0,0,0,0
"Zambia","2024-05-21",0,0,0,0,0,0,0,0
"Zambia","2024-05-22",0,0,0,0,0,0,0,0
"Zambia","2024-05-23",0,0,0,0,0,0,0,0
"Zambia","2024-05-24",0,0,0,0,0,0,0,0
"Zambia","2024-05-25",0,0,0,0,0,0,0,0
"Zambia","2024-05-26",0,0,0,0,0,0,0,0
"Zambia","2024-05-27",0,0,0,0,0,0,0,0
"Zambia","2024-05-28",0,0,0,0,0,0,0,0
"Zambia","2024-05-29",0,0,0,0,0,0,0,0
"Zambia","2024-05-30",0,0,0,0,0,0,0,0
"Zambia","2024-05-31",0,0,0,0,0,0,0,0
"Zambia","2024-06-01",0,0,0,0,0,0,0,0
"Zambia","2024-06-02",0,0,0,0,0,0,0,0
"Zambia","2024-06-03",0,0,0,0,0,0,0,0
"Zambia","2024-06-04",0,0,0,0,0,0,0,0
"Zambia","2024-06-05",0,0,0,0,0,0,0,0
"Zambia","2024-06-06",0,0,0,0,0,0,0,0
"Zambia","2024-06-07",0,0,0,0,0,0,0,0
"Zambia","2024-06-08",0,0,0,0,0,0,0,0
"Zambia","2024-06-09",0,0,0,0,0,0,0,0
"Zambia","2024-06-10",0,0,0,0,0,0,0,0
"Zambia","2024-06-11",0,0,0,0,0,0,0,0
"Zambia","2024-06-12",0,0,0,0,0,0,0,0
"Zambia","2024-06-13",0,0,0,0,0,0,0,0
"Zambia","2024-06-14",0,0,0,0,0,0,0,0
"Zambia","2024-06-15",0,0,0,0,0,0,0,0
"Zambia","2024-06-16",0,0,0,0,0,0,0,0
"Zambia","2024-06-17",0,0,0,0,0,0,0,0
"Zambia","2024-06-18",0,0,0,0,0,0,0,0
"Zambia","2024-06-19",0,0,0,0,0,0,0,0
"Zambia","2024-06-20",0,0,0,0,0,0,0,0
"Zambia","2024-06-21",0,0,0,0,0,0,0,0
"Zambia","2024-06-22",0,0,0,0,0,0,0,0
"Zambia","2024-06-23",0,0,0,0,0,0,0,0
"Zambia","2024-06-24",0,0,0,0,0,0,0,0
"Zambia","2024-06-25",0,0,0,0,0,0,0,0
"Zambia","2024-06-26",0,0,0,0,0,0,0,0
"Zambia","2024-06-27",0,0,0,0,0,0,0,0
"Zambia","2024-06-28",0,0,0,0,0,0,0,0
"Zambia","2024-06-29",0,0,0,0,0,0,0,0
"Zambia","2024-06-30",0,0,0,0,0,0,0,0
"Zambia","2024-07-01",0,0,0,0,0,0,0,0
"Zambia","2024-07-02",0,0,0,0,0,0,0,0
"Zambia","2024-07-03",0,0,0,0,0,0,0,0
"Zambia","2024-07-04",0,0,0,0,0,0,0,0
"Zambia","2024-07-05",0,0,0,0,0,0,0,0
"Zambia","2024-07-06",0,0,0,0,0,0,0,0
"Zambia","2024-07-07",0,0,0,0,0,0,0,0
"Zambia","2024-07-08",0,0,0,0,0,0,0,0
"Zambia","2024-07-09",0,0,0,0,0,0,0,0
"Zambia","2024-07-10",0,0,0,0,0,0,0,0
"Zambia","2024-07-11",0,0,0,0,0,0,0,0
"Zambia","2024-07-12",0,0,0,0,0,0,0,0
"Zambia","2024-07-13",0,0,0,0,0,0,0,0
"Zambia","2024-07-14",0,0,0,0,0,0,0,0
"Zambia","2024-07-15",0,0,0,0,0,0,0,0
"Zambia","2024-07-16",0,0,0,0,0,0,0,0
"Zambia","2024-07-17",0,0,0,0,0,0,0,0
"Zambia","2024-07-18",0,0,0,0,0,0,0,0
"Zambia","2024-07-19",0,0,0,0,0,0,0,0
"Zambia","2024-07-20",0,0,0,0,0,0,0,0
"Zambia","2024-07-21",0,0,0,0,0,0,0,0
"Zambia","2024-07-22",0,0,0,0,0,0,0,0
"Zambia","2024-07-23",0,0,0,0,0,0,0,0
"Zambia","2024-07-24",0,0,0,0,0,0,0,0
"Zambia","2024-07-25",0,0,0,0,0,0,0,0
"Zambia","2024-07-26",0,0,0,0,0,0,0,0
"Zambia","2024-07-27",0,0,0,0,0,0,0,0
"Zambia","2024-07-28",0,0,0,0,0,0,0,0
"Zambia","2024-07-29",0,0,0,0,0,0,0,0
"Zambia","2024-07-30",0,0,0,0,0,0,0,0
"Zambia","2024-07-31",0,0,0,0,0,0,0,0
"Zambia","2024-08-01",0,0,0,0,0,0,0,0
"Zambia","2024-08-02",0,0,0,0,0,0,0,0
"Zambia","2024-08-03",0,0,0,0,0,0,0,0
"Zambia","2024-08-04",0,0,0,0,0,0,0,0
"Zambia","2024-08-05",0,0,0,0,0,0,0,0
"Zambia","2024-08-06",0,0,0,0,0,0,0,0
"Zambia","2024-08-07",0,0,0,0,0,0,0,0
"Zambia","2024-08-08",0,0,0,0,0,0,0,0
"Zambia","2024-08-09",0,0,0,0,0,0,0,0
"Zambia","2024-08-10",0,0,0,0,0,0,0,0
"Zambia","2024-08-11",0,0,0,0,0,0,0,0
"Zambia","2024-08-12",0,0,0,0,0,0,0,0
"Zambia","2024-08-13",0,0,0,0,0,0,0,0
"Zambia","2024-08-14",0,0,0,0,0,0,0,0
"Zambia","2024-08-15",0,0,0,0,0,0,0,0
"Zambia","2024-08-16",0,0,0,0,0,0,0,0
"Zambia","2024-08-17",0,0,0,0,0,0,0,0
"Zambia","2024-08-18",0,0,0,0,0,0,0,0
"Zambia","2024-08-19",0,0,0,0,0,0,0,0
"Zambia","2024-08-20",0,0,0,0,0,0,0,0
"Zambia","2024-08-21",0,0,0,0,0,0,0,0
"Zambia","2024-08-22",0,0,0,0,0,0,0,0
"Zambia","2024-08-23",0,0,0,0,0,0,0,0
"Zambia","2024-08-24",0,0,0,0,0,0,0,0
"Zambia","2024-08-25",0,0,0,0,0,0,0,0
"Zambia","2024-08-26",0,0,0,0,0,0,0,0
"Zambia","2024-08-27",0,0,0,0,0,0,0,0
"Zambia","2024-08-28",0,0,0,0,0,0,0,0
"Zambia","2024-08-29",0,0,0,0,0,0,0,0
"Zambia","2024-08-30",0,0,0,0,0,0,0,0
"Zambia","2024-08-31",0,0,0,0,0,0,0,0
"Zambia","2024-09-01",0,0,0,0,0,0,0,0
"Zambia","2024-09-02",0,0,0,0,0,0,0,0
"Zambia","2024-09-03",0,0,0,0,0,0,0,0
"Zambia","2024-09-04",0,0,0,0,0,0,0,0
"Zambia","2024-09-05",0,0,0,0,0,0,0,0
"Zambia","2024-09-06",0,0,0,0,0,0,0,0
"Zambia","2024-09-07",0,0,0,0,0,0,0,0
"Zambia","2024-09-08",0,0,0,0,0,0,0,0
"Zambia","2024-09-09",0,0,0,0,0,0,0,0
"Zambia","2024-09-10",0,0,0,0,0,0,0,0
"Zambia","2024-09-11",0,0,0,0,0,0,0,0
"Zambia","2024-09-12",0,0,0,0,0,0,0,0
"Zambia","2024-09-13",0,0,0,0,0,0,0,0
"Zambia","2024-09-14",0,0,0,0,0,0,0,0
"Zambia","2024-09-15",0,0,0,0,0,0,0,0
"Zambia","2024-09-16",0,0,0,0,0,0,0,0
"Zambia","2024-09-17",0,0,0,0,0,0,0,0
"Zambia","2024-09-18",0,0,0,0,0,0,0,0
"Zambia","2024-09-19",0,0,0,0,0,0,0,0
"Zambia","2024-09-20",0,0,0,0,0,0,0,0
"Zambia","2024-09-21",0,0,0,0,0,0,0,0
"Zambia","2024-09-22",0,0,0,0,0,0,0,0
"Zambia","2024-09-23",0,0,0,0,0,0,0,0
"Zambia","2024-09-24",0,0,0,0,0,0,0,0
"Zambia","2024-09-25",0,0,0,0,0,0,0,0
"Zambia","2024-09-26",0,0,0,0,0,0,0,0
"Zambia","2024-09-27",0,0,0,0,0,0,0,0
"Zambia","2024-09-28",0,0,0,0,0,0,0,0
"Zambia","2024-09-29",0,0,0,0,0,0,0,0
"Zambia","2024-09-30",0,0,0,0,0,0,0,0
"Zambia","2024-10-01",0,0,0,0,0,0,0,0
"Zambia","2024-10-02",0,0,0,0,0,0,0,0
"Zambia","2024-10-03",0,0,0,0,0,0,0,0
"Zambia","2024-10-04",0,0,0,0,0,0,0,0
"Zambia","2024-10-05",0,0,0,0,0,0,0,0
"Zambia","2024-10-06",0,0,0,0,0,0,0,0
"Zambia","2024-10-07",0,0,0,0,0,0,0,0
"Zambia","2024-10-08",0,0,0,0,0,0,0,0
"Zambia","2024-10-09",0,0,0,0,0,0,0,0
"Zambia","2024-10-10",0,0,0,0,0,0,0,0
"Zambia","2024-10-11",0,0,0,0,0,0,0,0
"Zambia","2024-10-12",0,1,1,0,1,1,0,0
"Zambia","2024-10-13",0,0,1,0,0,1,0,0
"Zambia","2024-10-14",0,0,1,0,0,1,0,0
"Zambia","2024-10-15",0,0,1,0,0,1,0,0
"Zambia","2024-10-16",0,0,1,0,0,1,0,0
"Zambia","2024-10-17",0,0,1,0,0,1,0,0
"Zambia","2024-10-18",0,0,1,0,0,1,0,0
"Zambia","2024-10-19",0,0,1,0,0,1,0,0
"Zambia","2024-10-20",0,0,1,0,0,1,0,0
"Zambia","2024-10-21",0,0,1,0,0,1,0,0
"Zambia","2024-10-22",0,0,1,0,0,1,0,0
"Zambia","2024-10-23",0,0,1,0,0,1,0,0
"Zambia","2024-10-24",0,0,1,0,0,1,0,0
"Zambia","2024-10-25",0,0,1,0,0,1,0,0
"Zambia","2024-10-26",0,0,1,0,0,1,0,0
"Zambia","2024-10-27",0,0,1,0,0,1,0,0
"Zambia","2024-10-28",0,0,1,0,0,1,0,0
"Zambia","2024-10-29",0,0,1,0,0,1,0,0
"Zambia","2024-10-30",0,0,1,0,0,1,0,0
"Zambia","2024-10-31",0,0,1,0,0,1,0,0
"Zambia","2024-11-01",0,0,1,0,0,1,0,0
"Zambia","2024-11-02",0,0,1,0,0,1,0,0
"Zambia","2024-11-03",0,0,1,0,0,1,0,0
"Zambia","2024-11-04",0,0,1,0,0,1,0,0
"Zambia","2024-11-05",0,0,1,0,0,1,0,0
"Zambia","2024-11-06",0,0,1,0,0,1,0,0
"Zambia","2024-11-07",0,0,1,0,0,1,0,0
"Zambia","2024-11-08",0,0,1,0,0,1,0,0
"Zambia","2024-11-09",0,0,1,0,0,1,0,0
"Zambia","2024-11-10",0,0,1,0,0,1,0,0
"Zambia","2024-11-11",0,0,1,0,0,1,0,0
"Zambia","2024-11-12",0,0,1,0,0,1,0,0
"Zambia","2024-11-13",0,0,1,0,0,1,0,0
"Zambia","2024-11-14",0,0,1,0,0,1,0,0
"Zambia","2024-11-15",0,0,1,0,0,1,0,0
"Zambia","2024-11-16",0,0,1,0,0,1,0,0
"Zambia","2024-11-17",0,0,1,0,0,1,0,0
"Zambia","2024-11-18",0,0,1,0,0,1,0,0
"Zambia","2024-11-19",0,0,1,0,0,1,0,0
"Zambia","2024-11-20",0,0,1,0,0,1,0,0
"Zambia","2024-11-21",0,0,1,0,0,1,0,0
"Zambia","2024-11-22",0,0,1,0,0,1,0,0
"Zambia","2024-11-23",0,0,1,0,0,1,0,0
"Zambia","2024-11-24",0,0,1,0,0,1,0,0
"Zambia","2024-11-25",0,0,1,0,0,1,0,0
"Zambia","2024-11-26",0,0,1,0,0,1,0,0
"Zambia","2024-11-27",0,0,1,0,0,1,0,0
"Zambia","2024-11-28",0,0,1,0,0,1,0,0
"Zambia","2024-11-29",0,0,1,0,0,1,0,0
"Zambia","2024-11-30",0,0,1,0,0,1,0,0
"Zambia","2024-12-01",0,0,1,0,0,1,0,0
"Zambia","2024-12-02",0,0,1,0,0,1,0,0
"Zambia","2024-12-03",0,0,1,0,0,1,0,0
"Zambia","2024-12-04",0,0,1,0,0,1,0,0
"Zambia","2024-12-05",0,0,1,0,0,1,0,0
"Zambia","2024-12-06",0,0,1,0,0,1,0,0
"Zambia","2024-12-07",0,0,1,0,0,1,0,0
"Zambia","2024-12-08",0,0,1,0,0,1,0,0
"Zambia","2024-12-09",0,0,1,0,0,1,0,0
"Zimbabwe","2024-01-01",0,0,0,0,0,0,0,0
"Zimbabwe","2024-01-02",0,0,0,0,0,0,0,0
"Zimbabwe","2024-01-03",0,0,0,0,0,0,0,0
"Zimbabwe","2024-01-04",0,0,0,0,0,0,0,0
"Zimbabwe","2024-01-05",0,0,0,0,0,0,0,0
"Zimbabwe","2024-01-06",0,0,0,0,0,0,0,0
"Zimbabwe","2024-01-07",0,0,0,0,0,0,0,0
"Zimbabwe","2024-01-08",0,0,0,0,0,0,0,0
"Zimbabwe","2024-01-09",0,0,0,0,0,0,0,0
"Zimbabwe","2024-01-10",0,0,0,0,0,0,0,0
"Zimbabwe","2024-01-11",0,0,0,0,0,0,0,0
"Zimbabwe","2024-01-12",0,0,0,0,0,0,0,0
"Zimbabwe","2024-01-13",0,0,0,0,0,0,0,0
"Zimbabwe","2024-01-14",0,0,0,0,0,0,0,0
"Zimbabwe","2024-01-15",0,0,0,0,0,0,0,0
"Zimbabwe","2024-01-16",0,0,0,0,0,0,0,0
"Zimbabwe","2024-01-17",0,0,0,0,0,0,0,0
"Zimbabwe","2024-01-18",0,0,0,0,0,0,0,0
"Zimbabwe","2024-01-19",0,0,0,0,0,0,0,0
"Zimbabwe","2024-01-20",0,0,0,0,0,0,0,0
"Zimbabwe","2024-01-21",0,0,0,0,0,0,0,0
"Zimbabwe","2024-01-22",0,0,0,0,0,0,0,0
"Zimbabwe","2024-01-23",0,0,0,0,0,0,0,0
"Zimbabwe","2024-01-24",0,0,0,0,0,0,0,0
"Zimbabwe","2024-01-25",0,0,0,0,0,0,0,0
"Zimbabwe","2024-01-26",0,0,0,0,0,0,0,0
"Zimbabwe","2024-01-27",0,0,0,0,0,0,0,0
"Zimbabwe","2024-01-28",0,0,0,0,0,0,0,0
"Zimbabwe","2024-01-29",0,0,0,0,0,0,0,0
"Zimbabwe","2024-01-30",0,0,0,0,0,0,0,0
"Zimbabwe","2024-01-31",0,0,0,0,0,0,0,0
"Zimbabwe","2024-02-01",0,0,0,0,0,0,0,0
"Zimbabwe","2024-02-02",0,0,0,0,0,0,0,0
"Zimbabwe","2024-02-03",0,0,0,0,0,0,0,0
"Zimbabwe","2024-02-04",0,0,0,0,0,0,0,0
"Zimbabwe","2024-02-05",0,0,0,0,0,0,0,0
"Zimbabwe","2024-02-06",0,0,0,0,0,0,0,0
"Zimbabwe","2024-02-07",0,0,0,0,0,0,0,0
"Zimbabwe","2024-02-08",0,0,0,0,0,0,0,0
"Zimbabwe","2024-02-09",0,0,0,0,0,0,0,0
"Zimbabwe","2024-02-10",0,0,0,0,0,0,0,0
"Zimbabwe","2024-02-11",0,0,0,0,0,0,0,0
"Zimbabwe","2024-02-12",0,0,0,0,0,0,0,0
"Zimbabwe","2024-02-13",0,0,0,0,0,0,0,0
"Zimbabwe","2024-02-14",0,0,0,0,0,0,0,0
"Zimbabwe","2024-02-15",0,0,0,0,0,0,0,0
"Zimbabwe","2024-02-16",0,0,0,0,0,0,0,0
"Zimbabwe","2024-02-17",0,0,0,0,0,0,0,0
"Zimbabwe","2024-02-18",0,0,0,0,0,0,0,0
"Zimbabwe","2024-02-19",0,0,0,0,0,0,0,0
"Zimbabwe","2024-02-20",0,0,0,0,0,0,0,0
"Zimbabwe","2024-02-21",0,0,0,0,0,0,0,0
"Zimbabwe","2024-02-22",0,0,0,0,0,0,0,0
"Zimbabwe","2024-02-23",0,0,0,0,0,0,0,0
"Zimbabwe","2024-02-24",0,0,0,0,0,0,0,0
"Zimbabwe","2024-02-25",0,0,0,0,0,0,0,0
"Zimbabwe","2024-02-26",0,0,0,0,0,0,0,0
"Zimbabwe","2024-02-27",0,0,0,0,0,0,0,0
"Zimbabwe","2024-02-28",0,0,0,0,0,0,0,0
"Zimbabwe","2024-02-29",0,0,0,0,0,0,0,0
"Zimbabwe","2024-03-01",0,0,0,0,0,0,0,0
"Zimbabwe","2024-03-02",0,0,0,0,0,0,0,0
"Zimbabwe","2024-03-03",0,0,0,0,0,0,0,0
"Zimbabwe","2024-03-04",0,0,0,0,0,0,0,0
"Zimbabwe","2024-03-05",0,0,0,0,0,0,0,0
"Zimbabwe","2024-03-06",0,0,0,0,0,0,0,0
"Zimbabwe","2024-03-07",0,0,0,0,0,0,0,0
"Zimbabwe","2024-03-08",0,0,0,0,0,0,0,0
"Zimbabwe","2024-03-09",0,0,0,0,0,0,0,0
"Zimbabwe","2024-03-10",0,0,0,0,0,0,0,0
"Zimbabwe","2024-03-11",0,0,0,0,0,0,0,0
"Zimbabwe","2024-03-12",0,0,0,0,0,0,0,0
"Zimbabwe","2024-03-13",0,0,0,0,0,0,0,0
"Zimbabwe","2024-03-14",0,0,0,0,0,0,0,0
"Zimbabwe","2024-03-15",0,0,0,0,0,0,0,0
"Zimbabwe","2024-03-16",0,0,0,0,0,0,0,0
"Zimbabwe","2024-03-17",0,0,0,0,0,0,0,0
"Zimbabwe","2024-03-18",0,0,0,0,0,0,0,0
"Zimbabwe","2024-03-19",0,0,0,0,0,0,0,0
"Zimbabwe","2024-03-20",0,0,0,0,0,0,0,0
"Zimbabwe","2024-03-21",0,0,0,0,0,0,0,0
"Zimbabwe","2024-03-22",0,0,0,0,0,0,0,0
"Zimbabwe","2024-03-23",0,0,0,0,0,0,0,0
"Zimbabwe","2024-03-24",0,0,0,0,0,0,0,0
"Zimbabwe","2024-03-25",0,0,0,0,0,0,0,0
"Zimbabwe","2024-03-26",0,0,0,0,0,0,0,0
"Zimbabwe","2024-03-27",0,0,0,0,0,0,0,0
"Zimbabwe","2024-03-28",0,0,0,0,0,0,0,0
"Zimbabwe","2024-03-29",0,0,0,0,0,0,0,0
"Zimbabwe","2024-03-30",0,0,0,0,0,0,0,0
"Zimbabwe","2024-03-31",0,0,0,0,0,0,0,0
"Zimbabwe","2024-04-01",0,0,0,0,0,0,0,0
"Zimbabwe","2024-04-02",0,0,0,0,0,0,0,0
"Zimbabwe","2024-04-03",0,0,0,0,0,0,0,0
"Zimbabwe","2024-04-04",0,0,0,0,0,0,0,0
"Zimbabwe","2024-04-05",0,0,0,0,0,0,0,0
"Zimbabwe","2024-04-06",0,0,0,0,0,0,0,0
"Zimbabwe","2024-04-07",0,0,0,0,0,0,0,0
"Zimbabwe","2024-04-08",0,0,0,0,0,0,0,0
"Zimbabwe","2024-04-09",0,0,0,0,0,0,0,0
"Zimbabwe","2024-04-10",0,0,0,0,0,0,0,0
"Zimbabwe","2024-04-11",0,0,0,0,0,0,0,0
"Zimbabwe","2024-04-12",0,0,0,0,0,0,0,0
"Zimbabwe","2024-04-13",0,0,0,0,0,0,0,0
"Zimbabwe","2024-04-14",0,0,0,0,0,0,0,0
"Zimbabwe","2024-04-15",0,0,0,0,0,0,0,0
"Zimbabwe","2024-04-16",0,0,0,0,0,0,0,0
"Zimbabwe","2024-04-17",0,0,0,0,0,0,0,0
"Zimbabwe","2024-04-18",0,0,0,0,0,0,0,0
"Zimbabwe","2024-04-19",0,0,0,0,0,0,0,0
"Zimbabwe","2024-04-20",0,0,0,0,0,0,0,0
"Zimbabwe","2024-04-21",0,0,0,0,0,0,0,0
"Zimbabwe","2024-04-22",0,0,0,0,0,0,0,0
"Zimbabwe","2024-04-23",0,0,0,0,0,0,0,0
"Zimbabwe","2024-04-24",0,0,0,0,0,0,0,0
"Zimbabwe","2024-04-25",0,0,0,0,0,0,0,0
"Zimbabwe","2024-04-26",0,0,0,0,0,0,0,0
"Zimbabwe","2024-04-27",0,0,0,0,0,0,0,0
"Zimbabwe","2024-04-28",0,0,0,0,0,0,0,0
"Zimbabwe","2024-04-29",0,0,0,0,0,0,0,0
"Zimbabwe","2024-04-30",0,0,0,0,0,0,0,0
"Zimbabwe","2024-05-01",0,0,0,0,0,0,0,0
"Zimbabwe","2024-05-02",0,0,0,0,0,0,0,0
"Zimbabwe","2024-05-03",0,0,0,0,0,0,0,0
"Zimbabwe","2024-05-04",0,0,0,0,0,0,0,0
"Zimbabwe","2024-05-05",0,0,0,0,0,0,0,0
"Zimbabwe","2024-05-06",0,0,0,0,0,0,0,0
"Zimbabwe","2024-05-07",0,0,0,0,0,0,0,0
"Zimbabwe","2024-05-08",0,0,0,0,0,0,0,0
"Zimbabwe","2024-05-09",0,0,0,0,0,0,0,0
"Zimbabwe","2024-05-10",0,0,0,0,0,0,0,0
"Zimbabwe","2024-05-11",0,0,0,0,0,0,0,0
"Zimbabwe","2024-05-12",0,0,0,0,0,0,0,0
"Zimbabwe","2024-05-13",0,0,0,0,0,0,0,0
"Zimbabwe","2024-05-14",0,0,0,0,0,0,0,0
"Zimbabwe","2024-05-15",0,0,0,0,0,0,0,0
"Zimbabwe","2024-05-16",0,0,0,0,0,0,0,0
"Zimbabwe","2024-05-17",0,0,0,0,0,0,0,0
"Zimbabwe","2024-05-18",0,0,0,0,0,0,0,0
"Zimbabwe","2024-05-19",0,0,0,0,0,0,0,0
"Zimbabwe","2024-05-20",0,0,0,0,0,0,0,0
"Zimbabwe","2024-05-21",0,0,0,0,0,0,0,0
"Zimbabwe","2024-05-22",0,0,0,0,0,0,0,0
"Zimbabwe","2024-05-23",0,0,0,0,0,0,0,0
"Zimbabwe","2024-05-24",0,0,0,0,0,0,0,0
"Zimbabwe","2024-05-25",0,0,0,0,0,0,0,0
"Zimbabwe","2024-05-26",0,0,0,0,0,0,0,0
"Zimbabwe","2024-05-27",0,0,0,0,0,0,0,0
"Zimbabwe","2024-05-28",0,0,0,0,0,0,0,0
"Zimbabwe","2024-05-29",0,0,0,0,0,0,0,0
"Zimbabwe","2024-05-30",0,0,0,0,0,0,0,0
"Zimbabwe","2024-05-31",0,0,0,0,0,0,0,0
"Zimbabwe","2024-06-01",0,0,0,0,0,0,0,0
"Zimbabwe","2024-06-02",0,0,0,0,0,0,0,0
"Zimbabwe","2024-06-03",0,0,0,0,0,0,0,0
"Zimbabwe","2024-06-04",0,0,0,0,0,0,0,0
"Zimbabwe","2024-06-05",0,0,0,0,0,0,0,0
"Zimbabwe","2024-06-06",0,0,0,0,0,0,0,0
"Zimbabwe","2024-06-07",0,0,0,0,0,0,0,0
"Zimbabwe","2024-06-08",0,0,0,0,0,0,0,0
"Zimbabwe","2024-06-09",0,0,0,0,0,0,0,0
"Zimbabwe","2024-06-10",0,0,0,0,0,0,0,0
"Zimbabwe","2024-06-11",0,0,0,0,0,0,0,0
"Zimbabwe","2024-06-12",0,0,0,0,0,0,0,0
"Zimbabwe","2024-06-13",0,0,0,0,0,0,0,0
"Zimbabwe","2024-06-14",0,0,0,0,0,0,0,0
"Zimbabwe","2024-06-15",0,0,0,0,0,0,0,0
"Zimbabwe","2024-06-16",0,0,0,0,0,0,0,0
"Zimbabwe","2024-06-17",0,0,0,0,0,0,0,0
"Zimbabwe","2024-06-18",0,0,0,0,0,0,0,0
"Zimbabwe","2024-06-19",0,0,0,0,0,0,0,0
"Zimbabwe","2024-06-20",0,0,0,0,0,0,0,0
"Zimbabwe","2024-06-21",0,0,0,0,0,0,0,0
"Zimbabwe","2024-06-22",0,0,0,0,0,0,0,0
"Zimbabwe","2024-06-23",0,0,0,0,0,0,0,0
"Zimbabwe","2024-06-24",0,0,0,0,0,0,0,0
"Zimbabwe","2024-06-25",0,0,0,0,0,0,0,0
"Zimbabwe","2024-06-26",0,0,0,0,0,0,0,0
"Zimbabwe","2024-06-27",0,0,0,0,0,0,0,0
"Zimbabwe","2024-06-28",0,0,0,0,0,0,0,0
"Zimbabwe","2024-06-29",0,0,0,0,0,0,0,0
"Zimbabwe","2024-06-30",0,0,0,0,0,0,0,0
"Zimbabwe","2024-07-01",0,0,0,0,0,0,0,0
"Zimbabwe","2024-07-02",0,0,0,0,0,0,0,0
"Zimbabwe","2024-07-03",0,0,0,0,0,0,0,0
"Zimbabwe","2024-07-04",0,0,0,0,0,0,0,0
"Zimbabwe","2024-07-05",0,0,0,0,0,0,0,0
"Zimbabwe","2024-07-06",0,0,0,0,0,0,0,0
"Zimbabwe","2024-07-07",0,0,0,0,0,0,0,0
"Zimbabwe","2024-07-08",0,0,0,0,0,0,0,0
"Zimbabwe","2024-07-09",0,0,0,0,0,0,0,0
"Zimbabwe","2024-07-10",0,0,0,0,0,0,0,0
"Zimbabwe","2024-07-11",0,0,0,0,0,0,0,0
"Zimbabwe","2024-07-12",0,0,0,0,0,0,0,0
"Zimbabwe","2024-07-13",0,0,0,0,0,0,0,0
"Zimbabwe","2024-07-14",0,0,0,0,0,0,0,0
"Zimbabwe","2024-07-15",0,0,0,0,0,0,0,0
"Zimbabwe","2024-07-16",0,0,0,0,0,0,0,0
"Zimbabwe","2024-07-17",0,0,0,0,0,0,0,0
"Zimbabwe","2024-07-18",0,0,0,0,0,0,0,0
"Zimbabwe","2024-07-19",0,0,0,0,0,0,0,0
"Zimbabwe","2024-07-20",0,0,0,0,0,0,0,0
"Zimbabwe","2024-07-21",0,0,0,0,0,0,0,0
"Zimbabwe","2024-07-22",0,0,0,0,0,0,0,0
"Zimbabwe","2024-07-23",0,0,0,0,0,0,0,0
"Zimbabwe","2024-07-24",0,0,0,0,0,0,0,0
"Zimbabwe","2024-07-25",0,0,0,0,0,0,0,0
"Zimbabwe","2024-07-26",0,0,0,0,0,0,0,0
"Zimbabwe","2024-07-27",0,0,0,0,0,0,0,0
"Zimbabwe","2024-07-28",0,0,0,0,0,0,0,0
"Zimbabwe","2024-07-29",0,0,0,0,0,0,0,0
"Zimbabwe","2024-07-30",0,0,0,0,0,0,0,0
"Zimbabwe","2024-07-31",0,0,0,0,0,0,0,0
"Zimbabwe","2024-08-01",0,0,0,0,0,0,0,0
"Zimbabwe","2024-08-02",0,0,0,0,0,0,0,0
"Zimbabwe","2024-08-03",0,0,0,0,0,0,0,0
"Zimbabwe","2024-08-04",0,0,0,0,0,0,0,0
"Zimbabwe","2024-08-05",0,0,0,0,0,0,0,0
"Zimbabwe","2024-08-06",0,0,0,0,0,0,0,0
"Zimbabwe","2024-08-07",0,0,0,0,0,0,0,0
"Zimbabwe","2024-08-08",0,0,0,0,0,0,0,0
"Zimbabwe","2024-08-09",0,0,0,0,0,0,0,0
"Zimbabwe","2024-08-10",0,0,0,0,0,0,0,0
"Zimbabwe","2024-08-11",0,0,0,0,0,0,0,0
"Zimbabwe","2024-08-12",0,0,0,0,0,0,0,0
"Zimbabwe","2024-08-13",0,0,0,0,0,0,0,0
"Zimbabwe","2024-08-14",0,0,0,0,0,0,0,0
"Zimbabwe","2024-08-15",0,0,0,0,0,0,0,0
"Zimbabwe","2024-08-16",0,0,0,0,0,0,0,0
"Zimbabwe","2024-08-17",0,0,0,0,0,0,0,0
"Zimbabwe","2024-08-18",0,0,0,0,0,0,0,0
"Zimbabwe","2024-08-19",0,0,0,0,0,0,0,0
"Zimbabwe","2024-08-20",0,0,0,0,0,0,0,0
"Zimbabwe","2024-08-21",0,0,0,0,0,0,0,0
"Zimbabwe","2024-08-22",0,0,0,0,0,0,0,0
"Zimbabwe","2024-08-23",0,0,0,0,0,0,0,0
"Zimbabwe","2024-08-24",0,0,0,0,0,0,0,0
"Zimbabwe","2024-08-25",0,0,0,0,0,0,0,0
"Zimbabwe","2024-08-26",0,0,0,0,0,0,0,0
"Zimbabwe","2024-08-27",0,0,0,0,0,0,0,0
"Zimbabwe","2024-08-28",0,0,0,0,0,0,0,0
"Zimbabwe","2024-08-29",0,0,0,0,0,0,0,0
"Zimbabwe","2024-08-30",0,0,0,0,0,0,0,0
"Zimbabwe","2024-08-31",0,0,0,0,0,0,0,0
"Zimbabwe","2024-09-01",0,0,0,0,0,0,0,0
"Zimbabwe","2024-09-02",0,0,0,0,0,0,0,0
"Zimbabwe","2024-09-03",0,0,0,0,0,0,0,0
"Zimbabwe","2024-09-04",0,0,0,0,0,0,0,0
"Zimbabwe","2024-09-05",0,0,0,0,0,0,0,0
"Zimbabwe","2024-09-06",0,0,0,0,0,0,0,0
"Zimbabwe","2024-09-07",0,0,0,0,0,0,0,0
"Zimbabwe","2024-09-08",0,0,0,0,0,0,0,0
"Zimbabwe","2024-09-09",0,0,0,0,0,0,0,0
"Zimbabwe","2024-09-10",0,0,0,0,0,0,0,0
"Zimbabwe","2024-09-11",0,0,0,0,0,0,0,0
"Zimbabwe","2024-09-12",0,0,0,0,0,0,0,0
"Zimbabwe","2024-09-13",0,0,0,0,0,0,0,0
"Zimbabwe","2024-09-14",0,0,0,0,0,0,0,0
"Zimbabwe","2024-09-15",0,0,0,0,0,0,0,0
"Zimbabwe","2024-09-16",0,0,0,0,0,0,0,0
"Zimbabwe","2024-09-17",0,0,0,0,0,0,0,0
"Zimbabwe","2024-09-18",0,0,0,0,0,0,0,0
"Zimbabwe","2024-09-19",0,0,0,0,0,0,0,0
"Zimbabwe","2024-09-20",0,0,0,0,0,0,0,0
"Zimbabwe","2024-09-21",0,0,0,0,0,0,0,0
"Zimbabwe","2024-09-22",0,0,0,0,0,0,0,0
"Zimbabwe","2024-09-23",0,0,0,0,0,0,0,0
"Zimbabwe","2024-09-24",0,0,0,0,0,0,0,0
"Zimbabwe","2024-09-25",0,0,0,0,0,0,0,0
"Zimbabwe","2024-09-26",0,0,0,0,0,0,0,0
"Zimbabwe","2024-09-27",0,0,0,0,0,0,0,0
"Zimbabwe","2024-09-28",0,0,0,0,0,0,0,0
"Zimbabwe","2024-09-29",0,0,0,0,0,0,0,0
"Zimbabwe","2024-09-30",0,0,0,0,0,0,0,0
"Zimbabwe","2024-10-01",0,0,0,0,0,0,0,0
"Zimbabwe","2024-10-02",0,0,0,0,0,0,0,0
"Zimbabwe","2024-10-03",0,0,0,0,0,0,0,0
"Zimbabwe","2024-10-04",0,0,0,0,0,0,0,0
"Zimbabwe","2024-10-05",0,0,0,0,0,0,0,0
"Zimbabwe","2024-10-06",0,0,0,0,0,0,0,0
"Zimbabwe","2024-10-07",0,0,0,0,0,0,0,0
"Zimbabwe","2024-10-08",0,0,0,0,0,0,0,0
"Zimbabwe","2024-10-09",0,0,0,0,0,0,0,0
"Zimbabwe","2024-10-10",0,0,0,0,0,0,0,0
"Zimbabwe","2024-10-11",0,0,0,0,0,0,0,0
"Zimbabwe","2024-10-12",0,0,0,0,0,0,0,0
"Zimbabwe","2024-10-13",0,2,2,0,2,2,0,0
"Zimbabwe","2024-10-14",0,0,2,0,0,2,0,0
"Zimbabwe","2024-10-15",0,0,2,0,0,2,0,0
"Zimbabwe","2024-10-16",0,0,2,0,0,2,0,0
"Zimbabwe","2024-10-17",0,0,2,0,0,2,0,0
"Zimbabwe","2024-10-18",0,0,2,0,0,2,0,0
"Zimbabwe","2024-10-19",0,0,2,0,0,2,0,0
"Zimbabwe","2024-10-20",0,0,2,0,0,2,0,0
"Zimbabwe","2024-10-21",0,0,2,0,0,2,0,0
"Zimbabwe","2024-10-22",0,0,2,0,0,2,0,0
"Zimbabwe","2024-10-23",0,0,2,0,0,2,0,0
"Zimbabwe","2024-10-24",0,0,2,0,0,2,0,0
"Zimbabwe","2024-10-25",0,0,2,0,0,2,0,0
"Zimbabwe","2024-10-26",0,0,2,0,0,2,0,0
"Zimbabwe","2024-10-27",0,0,2,0,0,2,0,0
"Zimbabwe","2024-10-28",0,0,2,0,0,2,0,0
"Zimbabwe","2024-10-29",0,0,2,0,0,2,0,0
"Zimbabwe","2024-10-30",0,0,2,0,0,2,0,0
"Zimbabwe","2024-10-31",0,0,2,0,0,2,0,0
"Zimbabwe","2024-11-01",0,0,2,0,0,2,0,0
"Zimbabwe","2024-11-02",0,0,2,0,0,2,0,0
"Zimbabwe","2024-11-03",0,0,2,0,0,2,0,0
"Zimbabwe","2024-11-04",0,0,2,0,0,2,0,0
"Zimbabwe","2024-11-05",0,0,2,0,0,2,0,0
"Zimbabwe","2024-11-06",0,0,2,0,0,2,0,0
"Zimbabwe","2024-11-07",0,0,2,0,0,2,0,0
"Zimbabwe","2024-11-08",0,0,2,0,0,2,0,0
"Zimbabwe","2024-11-09",0,0,2,0,0,2,0,0
"Zimbabwe","2024-11-10",0,0,2,0,0,2,0,0
"Zimbabwe","2024-11-11",0,0,2,0,0,2,0,0
"Zimbabwe","2024-11-12",0,0,2,0,0,2,0,0
"Zimbabwe","2024-11-13",0,0,2,0,0,2,0,0
"Zimbabwe","2024-11-14",0,0,2,0,0,2,0,0
"Zimbabwe","2024-11-15",0,0,2,0,0,2,0,0
"Zimbabwe","2024-11-16",0,0,2,0,0,2,0,0
"Zimbabwe","2024-11-17",0,0,2,0,0,2,0,0
"Zimbabwe","2024-11-18",0,0,2,0,0,2,0,0
"Zimbabwe","2024-11-19",0,0,2,0,0,2,0,0
"Zimbabwe","2024-11-20",0,0,2,0,0,2,0,0
"Zimbabwe","2024-11-21",0,0,2,0,0,2,0,0
"Zimbabwe","2024-11-22",0,0,2,0,0,2,0,0
"Zimbabwe","2024-11-23",0,0,2,0,0,2,0,0
"Zimbabwe","2024-11-24",0,0,2,0,0,2,0,0
"Zimbabwe","2024-11-25",0,0,2,0,0,2,0,0
"Zimbabwe","2024-11-26",0,0,2,0,0,2,0,0
"Zimbabwe","2024-11-27",0,0,2,0,0,2,0,0
"Zimbabwe","2024-11-28",0,0,2,0,0,2,0,0
"Zimbabwe","2024-11-29",0,0,2,0,0,2,0,0
"Zimbabwe","2024-11-30",0,0,2,0,0,2,0,0
"Zimbabwe","2024-12-01",0,0,2,0,0,2,0,0
"Zimbabwe","2024-12-02",0,0,2,0,0,2,0,0
"Zimbabwe","2024-12-03",0,0,2,0,0,2,0,0
"Zimbabwe","2024-12-04",0,0,2,0,0,2,0,0
"Zimbabwe","2024-12-05",0,0,2,0,0,2,0,0
"Zimbabwe","2024-12-06",0,0,2,0,0,2,0,0
"Zimbabwe","2024-12-07",0,0,2,0,0,2,0,0
"Zimbabwe","2024-12-08",0,0,2,0,0,2,0,0
"Zimbabwe","2024-12-09",0,0,2,0,0,2,0,0
