"location","date","new_suspected_cases_calc_owd","new_confirmed_cases_calc_owd","cum_confirmed_cases_calc_owd","cum_suspected_cases_calc_owd","all_new_confirmed_cases_owd","all_cum_confirmed_cases_owd","all_new_suspected_cases_owd","all_cum_suspected_cases_owd"
"Africa","2024-01-01",0,0,0,0,0,0,0,0
"Africa","2024-01-02",0,0,0,0,0,0,0,0
"Africa","2024-01-03",0,0,0,0,0,0,0,0
"Africa","2024-01-04",0,0,0,0,0,0,0,0
"Africa","2024-01-05",0,0,0,0,0,0,0,0
"Africa","2024-01-06",0,0,0,0,0,0,0,0
"Africa","2024-01-07",0,57,57,0,57,57,0,0
"Africa","2024-01-08",0,0,57,0,0,57,0,0
"Africa","2024-01-09",0,1,58,0,1,58,0,0
"Africa","2024-01-10",0,0,58,0,16,74,0,0
"Africa","2024-01-11",0,0,58,0,15,89,0,0
"Africa","2024-01-12",0,0,58,0,16,105,0,0
"Africa","2024-01-13",0,0,58,0,15,120,0,0
"Africa","2024-01-14",0,78,136,0,16,136,0,0
"Africa","2024-01-15",0,0,136,0,13,149,0,0
"Africa","2024-01-16",0,0,136,0,13,162,0,0
"Africa","2024-01-17",0,0,136,0,13,175,0,0
"Africa","2024-01-18",0,0,136,0,12,187,0,0
"Africa","2024-01-19",0,0,136,0,13,200,0,0
"Africa","2024-01-20",0,0,136,0,13,213,0,0
"Africa","2024-01-21",0,90,226,0,13,226,0,0
"Africa","2024-01-22",0,0,226,0,11,237,0,0
"Africa","2024-01-23",0,0,226,0,12,249,0,0
"Africa","2024-01-24",0,0,226,0,11,260,0,0
"Africa","2024-01-25",0,0,226,0,11,271,0,0
"Africa","2024-01-26",0,0,226,0,11,282,0,0
"Africa","2024-01-27",0,0,226,0,12,294,0,0
"Africa","2024-01-28",0,79,305,0,11,305,0,0
"Africa","2024-01-29",0,0,305,0,9,314,0,0
"Africa","2024-01-30",0,0,305,0,9,323,0,0
"Africa","2024-01-31",0,0,305,0,9,332,0,0
"Africa","2024-02-01",0,0,305,0,9,341,0,0
"Africa","2024-02-02",0,0,305,0,9,350,0,0
"Africa","2024-02-03",0,0,305,0,9,359,0,0
"Africa","2024-02-04",0,63,368,0,9,368,0,0
"Africa","2024-02-05",0,0,368,0,9,377,0,0
"Africa","2024-02-06",0,0,368,0,10,387,0,0
"Africa","2024-02-07",0,0,368,0,9,396,0,0
"Africa","2024-02-08",0,0,368,0,9,405,0,0
"Africa","2024-02-09",0,0,368,0,9,414,0,0
"Africa","2024-02-10",0,0,368,0,10,424,0,0
"Africa","2024-02-11",0,65,433,0,9,433,0,0
"Africa","2024-02-12",0,0,433,0,9,442,0,0
"Africa","2024-02-13",0,0,433,0,9,451,0,0
"Africa","2024-02-14",0,0,433,0,9,460,0,0
"Africa","2024-02-15",0,0,433,0,10,470,0,0
"Africa","2024-02-16",0,0,433,0,9,479,0,0
"Africa","2024-02-17",0,0,433,0,9,488,0,0
"Africa","2024-02-18",0,64,497,0,9,497,0,0
"Africa","2024-02-19",0,0,497,0,7,504,0,0
"Africa","2024-02-20",0,0,497,0,6,510,0,0
"Africa","2024-02-21",0,0,497,0,7,517,0,0
"Africa","2024-02-22",0,0,497,0,6,523,0,0
"Africa","2024-02-23",0,0,497,0,7,530,0,0
"Africa","2024-02-24",0,0,497,0,6,536,0,0
"Africa","2024-02-25",0,46,543,0,7,543,0,0
"Africa","2024-02-26",0,0,543,0,12,555,0,0
"Africa","2024-02-27",0,0,543,0,11,566,0,0
"Africa","2024-02-28",0,0,543,0,12,578,0,0
"Africa","2024-02-29",0,0,543,0,11,589,0,0
"Africa","2024-03-01",0,0,543,0,12,601,0,0
"Africa","2024-03-02",0,0,543,0,11,612,0,0
"Africa","2024-03-03",0,81,624,0,12,624,0,0
"Africa","2024-03-04",0,0,624,0,10,634,0,0
"Africa","2024-03-05",0,0,624,0,10,644,0,0
"Africa","2024-03-06",0,0,624,0,10,654,0,0
"Africa","2024-03-07",0,0,624,0,9,663,0,0
"Africa","2024-03-08",0,0,624,0,10,673,0,0
"Africa","2024-03-09",0,0,624,0,10,683,0,0
"Africa","2024-03-10",0,69,693,0,10,693,0,0
"Africa","2024-03-11",0,0,693,0,0,693,0,0
"Africa","2024-03-12",0,0,693,0,0,693,0,0
"Africa","2024-03-13",0,0,693,0,1,694,0,0
"Africa","2024-03-14",0,0,693,0,0,694,0,0
"Africa","2024-03-15",0,1,694,0,0,694,0,0
"Africa","2024-03-16",0,0,694,0,37,731,0,0
"Africa","2024-03-17",0,74,768,0,37,768,0,0
"Africa","2024-03-18",0,0,768,0,10,778,0,0
"Africa","2024-03-19",0,0,768,0,10,788,0,0
"Africa","2024-03-20",0,0,768,0,10,798,0,0
"Africa","2024-03-21",0,0,768,0,9,807,0,0
"Africa","2024-03-22",0,0,768,0,10,817,0,0
"Africa","2024-03-23",0,0,768,0,10,827,0,0
"Africa","2024-03-24",0,69,837,0,10,837,0,0
"Africa","2024-03-25",0,0,837,0,10,847,0,0
"Africa","2024-03-26",0,0,837,0,10,857,0,0
"Africa","2024-03-27",0,0,837,0,10,867,0,0
"Africa","2024-03-28",0,0,837,0,9,876,0,0
"Africa","2024-03-29",0,0,837,0,10,886,0,0
"Africa","2024-03-30",0,0,837,0,10,896,0,0
"Africa","2024-03-31",0,69,906,0,10,906,0,0
"Africa","2024-04-01",0,0,906,0,11,917,0,0
"Africa","2024-04-02",0,0,906,0,12,929,0,0
"Africa","2024-04-03",0,0,906,0,11,940,0,0
"Africa","2024-04-04",0,0,906,0,12,952,0,0
"Africa","2024-04-05",0,0,906,0,11,963,0,0
"Africa","2024-04-06",0,0,906,0,12,975,0,0
"Africa","2024-04-07",0,80,986,0,11,986,0,0
"Africa","2024-04-08",0,0,986,0,17,1003,0,0
"Africa","2024-04-09",0,0,986,0,16,1019,0,0
"Africa","2024-04-10",0,0,986,0,17,1036,0,0
"Africa","2024-04-11",0,0,986,0,16,1052,0,0
"Africa","2024-04-12",0,0,986,0,17,1069,0,0
"Africa","2024-04-13",0,0,986,0,16,1085,0,0
"Africa","2024-04-14",0,116,1102,0,17,1102,0,0
"Africa","2024-04-15",0,0,1102,0,23,1125,0,0
"Africa","2024-04-16",0,0,1102,0,22,1147,0,0
"Africa","2024-04-17",0,0,1102,0,23,1170,0,0
"Africa","2024-04-18",0,0,1102,0,23,1193,0,0
"Africa","2024-04-19",0,0,1102,0,23,1216,0,0
"Africa","2024-04-20",0,0,1102,0,22,1238,0,0
"Africa","2024-04-21",0,159,1261,0,23,1261,0,0
"Africa","2024-04-22",0,0,1261,0,25,1286,0,0
"Africa","2024-04-23",0,0,1261,0,26,1312,0,0
"Africa","2024-04-24",0,0,1261,0,25,1337,0,0
"Africa","2024-04-25",0,0,1261,0,26,1363,0,0
"Africa","2024-04-26",0,0,1261,0,25,1388,0,0
"Africa","2024-04-27",0,0,1261,0,26,1414,0,0
"Africa","2024-04-28",0,178,1439,0,25,1439,0,0
"Africa","2024-04-29",0,0,1439,0,36,1475,0,0
"Africa","2024-04-30",0,0,1439,0,35,1510,0,0
"Africa","2024-05-01",0,0,1439,0,36,1546,0,0
"Africa","2024-05-02",0,0,1439,0,35,1581,0,0
"Africa","2024-05-03",0,0,1439,0,36,1617,0,0
"Africa","2024-05-04",0,0,1439,0,35,1652,0,0
"Africa","2024-05-05",0,249,1688,0,36,1688,0,0
"Africa","2024-05-06",0,0,1688,0,30,1718,0,0
"Africa","2024-05-07",0,0,1688,0,30,1748,0,0
"Africa","2024-05-08",0,0,1688,0,30,1778,0,0
"Africa","2024-05-09",0,0,1688,0,30,1808,0,0
"Africa","2024-05-10",0,0,1688,0,30,1838,0,0
"Africa","2024-05-11",0,0,1688,0,30,1868,0,0
"Africa","2024-05-12",0,210,1898,0,30,1898,0,0
"Africa","2024-05-13",0,0,1898,0,34,1932,0,0
"Africa","2024-05-14",0,0,1898,0,33,1965,0,0
"Africa","2024-05-15",0,0,1898,0,34,1999,0,0
"Africa","2024-05-16",0,0,1898,0,34,2033,0,0
"Africa","2024-05-17",0,0,1898,0,34,2067,0,0
"Africa","2024-05-18",0,0,1898,0,33,2100,0,0
"Africa","2024-05-19",0,236,2134,0,34,2134,0,0
"Africa","2024-05-20",0,0,2134,0,31,2165,0,0
"Africa","2024-05-21",0,0,2134,0,30,2195,0,0
"Africa","2024-05-22",0,0,2134,0,31,2226,0,0
"Africa","2024-05-23",0,0,2134,0,30,2256,0,0
"Africa","2024-05-24",0,0,2134,0,31,2287,0,0
"Africa","2024-05-25",0,0,2134,0,30,2317,0,0
"Africa","2024-05-26",0,214,2348,0,31,2348,0,0
"Africa","2024-05-27",0,0,2348,0,37,2385,0,0
"Africa","2024-05-28",0,0,2348,0,36,2421,0,0
"Africa","2024-05-29",0,0,2348,0,37,2458,0,0
"Africa","2024-05-30",0,0,2348,0,37,2495,0,0
"Africa","2024-05-31",0,0,2348,0,37,2532,0,0
"Africa","2024-06-01",0,0,2348,0,36,2568,0,0
"Africa","2024-06-02",0,257,2605,0,37,2605,0,0
"Africa","2024-06-03",0,0,2605,0,51,2656,0,0
"Africa","2024-06-04",0,0,2605,0,50,2706,0,0
"Africa","2024-06-05",0,0,2605,0,51,2757,0,0
"Africa","2024-06-06",0,0,2605,0,50,2807,0,0
"Africa","2024-06-07",0,0,2605,0,51,2858,0,0
"Africa","2024-06-08",0,0,2605,0,50,2908,0,0
"Africa","2024-06-09",0,354,2959,0,51,2959,0,0
"Africa","2024-06-10",0,0,2959,0,55,3014,0,0
"Africa","2024-06-11",0,0,2959,0,55,3069,0,0
"Africa","2024-06-12",0,0,2959,0,55,3124,0,0
"Africa","2024-06-13",0,0,2959,0,54,3178,0,0
"Africa","2024-06-14",0,0,2959,0,55,3233,0,0
"Africa","2024-06-15",0,0,2959,0,55,3288,0,0
"Africa","2024-06-16",0,384,3343,0,55,3343,0,0
"Africa","2024-06-17",0,0,3343,0,49,3392,0,0
"Africa","2024-06-18",0,0,3343,0,49,3441,0,0
"Africa","2024-06-19",0,0,3343,0,49,3490,0,0
"Africa","2024-06-20",0,0,3343,0,49,3539,0,0
"Africa","2024-06-21",0,0,3343,0,49,3588,0,0
"Africa","2024-06-22",0,0,3343,0,49,3637,0,0
"Africa","2024-06-23",0,343,3686,0,49,3686,0,0
"Africa","2024-06-24",0,0,3686,0,66,3752,0,0
"Africa","2024-06-25",0,0,3686,0,66,3818,0,0
"Africa","2024-06-26",0,0,3686,0,66,3884,0,0
"Africa","2024-06-27",0,0,3686,0,65,3949,0,0
"Africa","2024-06-28",0,0,3686,0,66,4015,0,0
"Africa","2024-06-29",0,0,3686,0,66,4081,0,0
"Africa","2024-06-30",0,461,4147,0,66,4147,0,0
"Africa","2024-07-01",0,0,4147,0,60,4207,0,0
"Africa","2024-07-02",0,0,4147,0,61,4268,0,0
"Africa","2024-07-03",0,0,4147,0,60,4328,0,0
"Africa","2024-07-04",0,0,4147,0,61,4389,0,0
"Africa","2024-07-05",0,0,4147,0,60,4449,0,0
"Africa","2024-07-06",0,0,4147,0,61,4510,0,0
"Africa","2024-07-07",0,423,4570,0,60,4570,0,0
"Africa","2024-07-08",0,0,4570,0,84,4654,0,0
"Africa","2024-07-09",0,0,4570,0,85,4739,0,0
"Africa","2024-07-10",0,0,4570,0,84,4823,0,0
"Africa","2024-07-11",0,0,4570,0,84,4907,0,0
"Africa","2024-07-12",0,0,4570,0,84,4991,0,0
"Africa","2024-07-13",0,0,4570,0,85,5076,0,0
"Africa","2024-07-14",0,590,5160,0,84,5160,0,0
"Africa","2024-07-15",0,0,5160,0,75,5235,0,0
"Africa","2024-07-16",0,0,5160,0,75,5310,0,0
"Africa","2024-07-17",0,0,5160,0,75,5385,0,0
"Africa","2024-07-18",0,0,5160,0,75,5460,0,0
"Africa","2024-07-19",0,0,5160,0,75,5535,0,0
"Africa","2024-07-20",0,0,5160,0,75,5610,0,0
"Africa","2024-07-21",0,525,5685,0,75,5685,0,0
"Africa","2024-07-22",0,0,5685,0,66,5751,0,0
"Africa","2024-07-23",0,0,5685,0,67,5818,0,0
"Africa","2024-07-24",0,0,5685,0,66,5884,0,0
"Africa","2024-07-25",0,0,5685,0,67,5951,0,0
"Africa","2024-07-26",0,0,5685,0,66,6017,0,0
"Africa","2024-07-27",0,0,5685,0,67,6084,0,0
"Africa","2024-07-28",0,465,6150,0,66,6150,0,0
"Africa","2024-07-29",0,0,6150,0,38,6188,0,0
"Africa","2024-07-30",0,0,6150,0,39,6227,0,0
"Africa","2024-07-31",0,0,6150,0,38,6265,0,0
"Africa","2024-08-01",0,0,6150,0,39,6304,0,0
"Africa","2024-08-02",0,0,6150,0,38,6342,0,0
"Africa","2024-08-03",0,0,6150,0,39,6381,0,0
"Africa","2024-08-04",0,269,6419,0,38,6419,0,0
"Africa","2024-08-05",0,0,6419,0,42,6461,0,0
"Africa","2024-08-06",0,0,6419,0,43,6504,0,0
"Africa","2024-08-07",0,0,6419,0,42,6546,0,0
"Africa","2024-08-08",0,0,6419,0,42,6588,0,0
"Africa","2024-08-09",0,0,6419,0,42,6630,0,0
"Africa","2024-08-10",0,0,6419,0,43,6673,0,0
"Africa","2024-08-11",0,296,6715,0,42,6715,0,0
"Africa","2024-08-12",0,0,6715,0,43,6758,0,0
"Africa","2024-08-13",0,0,6715,0,42,6800,0,0
"Africa","2024-08-14",0,0,6715,0,43,6843,0,0
"Africa","2024-08-15",0,0,6715,0,42,6885,0,0
"Africa","2024-08-16",0,0,6715,0,43,6928,0,0
"Africa","2024-08-17",0,0,6715,0,42,6970,0,0
"Africa","2024-08-18",0,298,7013,0,43,7013,0,0
"Africa","2024-08-19",0,0,7013,0,44,7057,0,0
"Africa","2024-08-20",0,0,7013,0,44,7101,0,0
"Africa","2024-08-21",0,0,7013,0,44,7145,0,0
"Africa","2024-08-22",0,0,7013,0,43,7188,0,0
"Africa","2024-08-23",0,0,7013,0,44,7232,0,0
"Africa","2024-08-24",0,0,7013,0,44,7276,0,0
"Africa","2024-08-25",0,307,7320,0,44,7320,0,0
"Africa","2024-08-26",0,0,7320,0,54,7374,0,0
"Africa","2024-08-27",0,0,7320,0,54,7428,0,0
"Africa","2024-08-28",0,0,7320,0,54,7482,0,0
"Africa","2024-08-29",0,0,7320,0,55,7537,0,0
"Africa","2024-08-30",0,0,7320,0,54,7591,0,0
"Africa","2024-08-31",0,0,7320,0,54,7645,0,0
"Africa","2024-09-01",0,379,7699,0,54,7699,0,0
"Africa","2024-09-02",0,0,7699,0,51,7750,0,0
"Africa","2024-09-03",0,0,7699,0,50,7800,0,0
"Africa","2024-09-04",0,0,7699,0,51,7851,0,0
"Africa","2024-09-05",0,0,7699,0,51,7902,0,0
"Africa","2024-09-06",0,0,7699,0,51,7953,0,0
"Africa","2024-09-07",0,0,7699,0,50,8003,0,0
"Africa","2024-09-08",0,355,8054,0,51,8054,0,0
"Africa","2024-09-09",0,0,8054,0,0,8054,0,0
"Africa","2024-09-10",0,0,8054,0,0,8054,0,0
"Africa","2024-09-11",0,0,8054,0,1,8055,0,0
"Africa","2024-09-12",0,1,8055,0,0,8055,0,0
"Africa","2024-09-13",0,0,8055,0,156,8211,0,0
"Africa","2024-09-14",0,0,8055,0,156,8367,0,0
"Africa","2024-09-15",0,468,8523,0,156,8523,0,0
"Africa","2024-09-16",0,0,8523,0,67,8590,0,0
"Africa","2024-09-17",0,0,8523,0,67,8657,0,0
"Africa","2024-09-18",0,0,8523,0,67,8724,0,0
"Africa","2024-09-19",0,0,8523,0,67,8791,0,0
"Africa","2024-09-20",0,0,8523,0,67,8858,0,0
"Africa","2024-09-21",0,0,8523,0,67,8925,0,0
"Africa","2024-09-22",0,469,8992,0,67,8992,0,0
"Africa","2024-09-23",0,0,8992,0,0,8992,0,0
"Africa","2024-09-24",0,0,8992,0,1,8993,0,0
"Africa","2024-09-25",0,0,8992,0,1,8994,0,0
"Africa","2024-09-26",0,0,8992,0,0,8994,0,0
"Africa","2024-09-27",0,0,8992,0,0,8994,0,0
"Africa","2024-09-28",0,3,8995,0,1,8995,0,0
"Africa","2024-09-29",0,379,9374,0,379,9374,0,0
"Africa","2024-09-30",0,0,9374,0,0,9374,0,0
"Africa","2024-10-01",0,0,9374,0,0,9374,0,0
"Africa","2024-10-02",0,0,9374,0,1,9375,0,0
"Africa","2024-10-03",0,1,9375,0,0,9375,0,0
"Africa","2024-10-04",0,0,9375,0,121,9496,0,0
"Africa","2024-10-05",0,0,9375,0,120,9616,0,0
"Africa","2024-10-06",0,362,9737,0,121,9737,0,0
"Africa","2024-10-07",0,0,9737,0,0,9737,0,0
"Africa","2024-10-08",0,0,9737,0,0,9737,0,0
"Africa","2024-10-09",0,0,9737,0,0,9737,0,0
"Africa","2024-10-10",0,0,9737,0,1,9738,0,0
"Africa","2024-10-11",0,0,9737,0,0,9738,0,0
"Africa","2024-10-12",0,1,9738,0,0,9738,0,0
"Africa","2024-10-13",0,502,10240,0,502,10240,0,0
"Africa","2024-10-14",0,0,10240,0,70,10310,0,0
"Africa","2024-10-15",0,0,10240,0,70,10380,0,0
"Africa","2024-10-16",0,0,10240,0,70,10450,0,0
"Africa","2024-10-17",0,0,10240,0,71,10521,0,0
"Africa","2024-10-18",0,0,10240,0,70,10591,0,0
"Africa","2024-10-19",0,0,10240,0,70,10661,0,0
"Africa","2024-10-20",0,491,10731,0,70,10731,0,0
"Africa","2024-10-21",0,0,10731,0,0,10731,0,0
"Africa","2024-10-22",0,0,10731,0,1,10732,0,0
"Africa","2024-10-23",0,0,10731,0,1,10733,0,0
"Africa","2024-10-24",0,0,10731,0,0,10733,0,0
"Africa","2024-10-25",0,0,10731,0,0,10733,0,0
"Africa","2024-10-26",0,3,10734,0,1,10734,0,0
"Africa","2024-10-27",0,584,11318,0,584,11318,0,0
"Africa","2024-10-28",0,0,11318,0,1,11319,0,0
"Africa","2024-10-29",0,0,11318,0,2,11321,0,0
"Africa","2024-10-30",0,4,11322,0,1,11322,0,0
"Africa","2024-10-31",0,0,11322,0,137,11459,0,0
"Africa","2024-11-01",0,0,11322,0,137,11596,0,0
"Africa","2024-11-02",0,0,11322,0,136,11732,0,0
"Africa","2024-11-03",0,547,11869,0,137,11869,0,0
"Africa","2024-11-04",0,0,11869,0,83,11952,0,0
"Africa","2024-11-05",0,0,11869,0,84,12036,0,0
"Africa","2024-11-06",0,0,11869,0,83,12119,0,0
"Africa","2024-11-07",0,0,11869,0,83,12202,0,0
"Africa","2024-11-08",0,0,11869,0,83,12285,0,0
"Africa","2024-11-09",0,0,11869,0,84,12369,0,0
"Africa","2024-11-10",0,583,12452,0,83,12452,0,0
"Africa","2024-11-11",0,0,12452,0,88,12540,0,0
"Africa","2024-11-12",0,0,12452,0,89,12629,0,0
"Africa","2024-11-13",0,0,12452,0,88,12717,0,0
"Africa","2024-11-14",0,0,12452,0,88,12805,0,0
"Africa","2024-11-15",0,0,12452,0,88,12893,0,0
"Africa","2024-11-16",0,0,12452,0,89,12982,0,0
"Africa","2024-11-17",0,618,13070,0,88,13070,0,0
"Africa","2024-11-18",0,0,13070,0,0,13070,0,0
"Africa","2024-11-19",0,0,13070,0,1,13071,0,0
"Africa","2024-11-20",0,1,13071,0,0,13071,0,0
"Africa","2024-11-21",0,0,13071,0,157,13228,0,0
"Africa","2024-11-22",0,0,13071,0,157,13385,0,0
"Africa","2024-11-23",0,0,13071,0,158,13543,0,0
"Africa","2024-11-24",0,629,13700,0,157,13700,0,0
"Africa","2024-11-25",0,0,13700,0,1,13701,0,0
"Africa","2024-11-26",0,0,13700,0,1,13702,0,0
"Africa","2024-11-27",0,0,13700,0,2,13704,0,0
"Africa","2024-11-28",0,0,13700,0,1,13705,0,0
"Africa","2024-11-29",0,0,13700,0,1,13706,0,0
"Africa","2024-11-30",0,7,13707,0,1,13707,0,0
"Africa","2024-12-01",0,542,14249,0,542,14249,0,0
"Africa","2024-12-02",0,0,14249,0,88,14337,0,0
"Africa","2024-12-03",0,0,14249,0,88,14425,0,0
"Africa","2024-12-04",0,0,14249,0,88,14513,0,0
"Africa","2024-12-05",0,0,14249,0,88,14601,0,0
"Africa","2024-12-06",0,0,14249,0,88,14689,0,0
"Africa","2024-12-07",0,0,14249,0,88,14777,0,0
"Africa","2024-12-08",0,616,14865,0,88,14865,0,0
"Africa","2024-12-09",0,0,14865,0,80,14945,0,0
"Africa","2024-12-10",0,0,14865,0,81,15026,0,0
"Africa","2024-12-11",0,0,14865,0,80,15106,0,0
"Africa","2024-12-12",0,0,14865,0,81,15187,0,0
"Africa","2024-12-13",0,0,14865,0,80,15267,0,0
"Africa","2024-12-14",0,0,14865,0,81,15348,0,0
"Africa","2024-12-15",0,563,15428,0,80,15428,0,0
"Africa","2024-12-16",0,0,15428,0,74,15502,0,0
"Africa","2024-12-17",0,0,15428,0,73,15575,0,0
"Africa","2024-12-18",0,0,15428,0,74,15649,0,0
"Africa","2024-12-19",0,0,15428,0,73,15722,0,0
"Africa","2024-12-20",0,0,15428,0,74,15796,0,0
"Africa","2024-12-21",0,0,15428,0,73,15869,0,0
"Africa","2024-12-22",0,515,15943,0,74,15943,0,0
"Africa","2024-12-23",0,0,15943,0,63,16006,0,0
"Africa","2024-12-24",0,0,15943,0,63,16069,0,0
"Africa","2024-12-25",0,0,15943,0,63,16132,0,0
"Africa","2024-12-26",0,0,15943,0,64,16196,0,0
"Africa","2024-12-27",0,0,15943,0,63,16259,0,0
"Africa","2024-12-28",0,0,15943,0,63,16322,0,0
"Africa","2024-12-29",0,442,16385,0,63,16385,0,0
"Africa","2024-12-30",0,0,16385,0,43,16428,0,0
"Africa","2024-12-31",0,0,16385,0,43,16471,0,0
"Africa","2025-01-01",0,0,16385,0,43,16514,0,0
"Africa","2025-01-02",0,0,16385,0,44,16558,0,0
"Africa","2025-01-03",0,0,16385,0,43,16601,0,0
"Africa","2025-01-04",0,0,16385,0,43,16644,0,0
"Africa","2025-01-05",0,302,16687,0,43,16687,0,0
"Africa","2025-01-06",0,0,16687,0,1,16688,0,0
"Africa","2025-01-07",0,0,16687,0,0,16688,0,0
"Africa","2025-01-08",0,2,16689,0,1,16689,0,0
"Africa","2025-01-09",0,0,16689,0,91,16780,0,0
"Africa","2025-01-10",0,0,16689,0,91,16871,0,0
"Africa","2025-01-11",0,0,16689,0,92,16963,0,0
"Africa","2025-01-12",0,365,17054,0,91,17054,0,0
"Africa","2025-01-13",0,0,17054,0,13,17067,0,0
"Africa","2025-01-14",0,0,17054,0,13,17080,0,0
"Africa","2025-01-15",0,0,17054,0,14,17094,0,0
"Africa","2025-01-16",0,53,17107,0,13,17107,0,0
"Africa","2025-01-17",0,0,17107,0,2,17109,0,0
"Africa","2025-01-18",0,0,17107,0,3,17112,0,0
"Africa","2025-01-19",0,7,17114,0,2,17114,0,0
"Africa","2025-01-20",0,0,17114,0,0,17114,0,0
"Africa","2025-01-21",0,0,17114,0,0,17114,0,0
"Africa","2025-01-22",0,0,17114,0,0,17114,0,0
"Africa","2025-01-23",0,0,17114,0,0,17114,0,0
"Africa","2025-01-24",0,0,17114,0,0,17114,0,0
"Africa","2025-01-25",0,0,17114,0,0,17114,0,0
"Africa","2025-01-26",0,0,17114,0,0,17114,0,0
"Africa","2025-01-27",0,0,17114,0,0,17114,0,0
"Africa","2025-01-28",0,0,17114,0,0,17114,0,0
"Africa","2025-01-29",0,0,17114,0,0,17114,0,0
"Africa","2025-01-30",0,0,17114,0,0,17114,0,0
"Africa","2025-01-31",0,0,17114,0,0,17114,0,0
"Africa","2025-02-01",0,0,17114,0,0,17114,0,0
"Africa","2025-02-02",0,0,17114,0,0,17114,0,0
"Africa","2025-02-03",0,0,17114,0,0,17114,0,0
"Andorra","2024-01-01",0,0,0,0,0,0,0,0
"Andorra","2024-01-02",0,0,0,0,0,0,0,0
"Andorra","2024-01-03",0,0,0,0,0,0,0,0
"Andorra","2024-01-04",0,0,0,0,0,0,0,0
"Andorra","2024-01-05",0,0,0,0,0,0,0,0
"Andorra","2024-01-06",0,0,0,0,0,0,0,0
"Andorra","2024-01-07",0,0,0,0,0,0,0,0
"Andorra","2024-01-08",0,0,0,0,0,0,0,0
"Andorra","2024-01-09",0,0,0,0,0,0,0,0
"Andorra","2024-01-10",0,0,0,0,0,0,0,0
"Andorra","2024-01-11",0,0,0,0,0,0,0,0
"Andorra","2024-01-12",0,0,0,0,0,0,0,0
"Andorra","2024-01-13",0,0,0,0,0,0,0,0
"Andorra","2024-01-14",0,0,0,0,0,0,0,0
"Andorra","2024-01-15",0,0,0,0,0,0,0,0
"Andorra","2024-01-16",0,0,0,0,0,0,0,0
"Andorra","2024-01-17",0,0,0,0,0,0,0,0
"Andorra","2024-01-18",0,0,0,0,0,0,0,0
"Andorra","2024-01-19",0,0,0,0,0,0,0,0
"Andorra","2024-01-20",0,0,0,0,0,0,0,0
"Andorra","2024-01-21",0,0,0,0,0,0,0,0
"Andorra","2024-01-22",0,0,0,0,0,0,0,0
"Andorra","2024-01-23",0,0,0,0,0,0,0,0
"Andorra","2024-01-24",0,0,0,0,0,0,0,0
"Andorra","2024-01-25",0,0,0,0,0,0,0,0
"Andorra","2024-01-26",0,0,0,0,0,0,0,0
"Andorra","2024-01-27",0,0,0,0,0,0,0,0
"Andorra","2024-01-28",0,0,0,0,0,0,0,0
"Andorra","2024-01-29",0,0,0,0,0,0,0,0
"Andorra","2024-01-30",0,0,0,0,0,0,0,0
"Andorra","2024-01-31",0,0,0,0,0,0,0,0
"Andorra","2024-02-01",0,0,0,0,0,0,0,0
"Andorra","2024-02-02",0,0,0,0,0,0,0,0
"Andorra","2024-02-03",0,0,0,0,0,0,0,0
"Andorra","2024-02-04",0,0,0,0,0,0,0,0
"Andorra","2024-02-05",0,0,0,0,0,0,0,0
"Andorra","2024-02-06",0,0,0,0,0,0,0,0
"Andorra","2024-02-07",0,0,0,0,0,0,0,0
"Andorra","2024-02-08",0,0,0,0,0,0,0,0
"Andorra","2024-02-09",0,0,0,0,0,0,0,0
"Andorra","2024-02-10",0,0,0,0,0,0,0,0
"Andorra","2024-02-11",0,0,0,0,0,0,0,0
"Andorra","2024-02-12",0,0,0,0,0,0,0,0
"Andorra","2024-02-13",0,0,0,0,0,0,0,0
"Andorra","2024-02-14",0,0,0,0,0,0,0,0
"Andorra","2024-02-15",0,0,0,0,0,0,0,0
"Andorra","2024-02-16",0,0,0,0,0,0,0,0
"Andorra","2024-02-17",0,0,0,0,0,0,0,0
"Andorra","2024-02-18",0,0,0,0,0,0,0,0
"Andorra","2024-02-19",0,0,0,0,0,0,0,0
"Andorra","2024-02-20",0,0,0,0,0,0,0,0
"Andorra","2024-02-21",0,0,0,0,0,0,0,0
"Andorra","2024-02-22",0,0,0,0,0,0,0,0
"Andorra","2024-02-23",0,0,0,0,0,0,0,0
"Andorra","2024-02-24",0,0,0,0,0,0,0,0
"Andorra","2024-02-25",0,0,0,0,0,0,0,0
"Andorra","2024-02-26",0,0,0,0,0,0,0,0
"Andorra","2024-02-27",0,0,0,0,0,0,0,0
"Andorra","2024-02-28",0,0,0,0,0,0,0,0
"Andorra","2024-02-29",0,0,0,0,0,0,0,0
"Andorra","2024-03-01",0,0,0,0,0,0,0,0
"Andorra","2024-03-02",0,0,0,0,0,0,0,0
"Andorra","2024-03-03",0,0,0,0,0,0,0,0
"Andorra","2024-03-04",0,0,0,0,0,0,0,0
"Andorra","2024-03-05",0,0,0,0,0,0,0,0
"Andorra","2024-03-06",0,0,0,0,0,0,0,0
"Andorra","2024-03-07",0,0,0,0,0,0,0,0
"Andorra","2024-03-08",0,0,0,0,0,0,0,0
"Andorra","2024-03-09",0,0,0,0,0,0,0,0
"Andorra","2024-03-10",0,0,0,0,0,0,0,0
"Andorra","2024-03-11",0,0,0,0,0,0,0,0
"Andorra","2024-03-12",0,0,0,0,0,0,0,0
"Andorra","2024-03-13",0,0,0,0,0,0,0,0
"Andorra","2024-03-14",0,0,0,0,0,0,0,0
"Andorra","2024-03-15",0,0,0,0,0,0,0,0
"Andorra","2024-03-16",0,0,0,0,0,0,0,0
"Andorra","2024-03-17",0,0,0,0,0,0,0,0
"Andorra","2024-03-18",0,0,0,0,0,0,0,0
"Andorra","2024-03-19",0,0,0,0,0,0,0,0
"Andorra","2024-03-20",0,0,0,0,0,0,0,0
"Andorra","2024-03-21",0,0,0,0,0,0,0,0
"Andorra","2024-03-22",0,0,0,0,0,0,0,0
"Andorra","2024-03-23",0,0,0,0,0,0,0,0
"Andorra","2024-03-24",0,0,0,0,0,0,0,0
"Andorra","2024-03-25",0,0,0,0,0,0,0,0
"Andorra","2024-03-26",0,0,0,0,0,0,0,0
"Andorra","2024-03-27",0,0,0,0,0,0,0,0
"Andorra","2024-03-28",0,0,0,0,0,0,0,0
"Andorra","2024-03-29",0,0,0,0,0,0,0,0
"Andorra","2024-03-30",0,0,0,0,0,0,0,0
"Andorra","2024-03-31",0,0,0,0,0,0,0,0
"Andorra","2024-04-01",0,0,0,0,0,0,0,0
"Andorra","2024-04-02",0,0,0,0,0,0,0,0
"Andorra","2024-04-03",0,0,0,0,0,0,0,0
"Andorra","2024-04-04",0,0,0,0,0,0,0,0
"Andorra","2024-04-05",0,0,0,0,0,0,0,0
"Andorra","2024-04-06",0,0,0,0,0,0,0,0
"Andorra","2024-04-07",0,0,0,0,0,0,0,0
"Andorra","2024-04-08",0,0,0,0,0,0,0,0
"Andorra","2024-04-09",0,0,0,0,0,0,0,0
"Andorra","2024-04-10",0,0,0,0,0,0,0,0
"Andorra","2024-04-11",0,0,0,0,0,0,0,0
"Andorra","2024-04-12",0,0,0,0,0,0,0,0
"Andorra","2024-04-13",0,0,0,0,0,0,0,0
"Andorra","2024-04-14",0,0,0,0,0,0,0,0
"Andorra","2024-04-15",0,0,0,0,0,0,0,0
"Andorra","2024-04-16",0,0,0,0,0,0,0,0
"Andorra","2024-04-17",0,0,0,0,0,0,0,0
"Andorra","2024-04-18",0,0,0,0,0,0,0,0
"Andorra","2024-04-19",0,0,0,0,0,0,0,0
"Andorra","2024-04-20",0,0,0,0,0,0,0,0
"Andorra","2024-04-21",0,0,0,0,0,0,0,0
"Andorra","2024-04-22",0,0,0,0,0,0,0,0
"Andorra","2024-04-23",0,0,0,0,0,0,0,0
"Andorra","2024-04-24",0,0,0,0,0,0,0,0
"Andorra","2024-04-25",0,0,0,0,0,0,0,0
"Andorra","2024-04-26",0,0,0,0,0,0,0,0
"Andorra","2024-04-27",0,0,0,0,0,0,0,0
"Andorra","2024-04-28",0,0,0,0,0,0,0,0
"Andorra","2024-04-29",0,0,0,0,0,0,0,0
"Andorra","2024-04-30",0,0,0,0,0,0,0,0
"Andorra","2024-05-01",0,0,0,0,0,0,0,0
"Andorra","2024-05-02",0,0,0,0,0,0,0,0
"Andorra","2024-05-03",0,0,0,0,0,0,0,0
"Andorra","2024-05-04",0,0,0,0,0,0,0,0
"Andorra","2024-05-05",0,0,0,0,0,0,0,0
"Andorra","2024-05-06",0,0,0,0,0,0,0,0
"Andorra","2024-05-07",0,0,0,0,0,0,0,0
"Andorra","2024-05-08",0,0,0,0,0,0,0,0
"Andorra","2024-05-09",0,0,0,0,0,0,0,0
"Andorra","2024-05-10",0,0,0,0,0,0,0,0
"Andorra","2024-05-11",0,0,0,0,0,0,0,0
"Andorra","2024-05-12",0,0,0,0,0,0,0,0
"Andorra","2024-05-13",0,0,0,0,0,0,0,0
"Andorra","2024-05-14",0,0,0,0,0,0,0,0
"Andorra","2024-05-15",0,0,0,0,0,0,0,0
"Andorra","2024-05-16",0,0,0,0,0,0,0,0
"Andorra","2024-05-17",0,0,0,0,0,0,0,0
"Andorra","2024-05-18",0,0,0,0,0,0,0,0
"Andorra","2024-05-19",0,0,0,0,0,0,0,0
"Andorra","2024-05-20",0,0,0,0,0,0,0,0
"Andorra","2024-05-21",0,0,0,0,0,0,0,0
"Andorra","2024-05-22",0,0,0,0,0,0,0,0
"Andorra","2024-05-23",0,0,0,0,0,0,0,0
"Andorra","2024-05-24",0,0,0,0,0,0,0,0
"Andorra","2024-05-25",0,0,0,0,0,0,0,0
"Andorra","2024-05-26",0,0,0,0,0,0,0,0
"Andorra","2024-05-27",0,0,0,0,0,0,0,0
"Andorra","2024-05-28",0,0,0,0,0,0,0,0
"Andorra","2024-05-29",0,0,0,0,0,0,0,0
"Andorra","2024-05-30",0,0,0,0,0,0,0,0
"Andorra","2024-05-31",0,0,0,0,0,0,0,0
"Andorra","2024-06-01",0,0,0,0,0,0,0,0
"Andorra","2024-06-02",0,0,0,0,0,0,0,0
"Andorra","2024-06-03",0,0,0,0,0,0,0,0
"Andorra","2024-06-04",0,0,0,0,0,0,0,0
"Andorra","2024-06-05",0,0,0,0,0,0,0,0
"Andorra","2024-06-06",0,0,0,0,0,0,0,0
"Andorra","2024-06-07",0,0,0,0,0,0,0,0
"Andorra","2024-06-08",0,0,0,0,0,0,0,0
"Andorra","2024-06-09",0,0,0,0,0,0,0,0
"Andorra","2024-06-10",0,0,0,0,0,0,0,0
"Andorra","2024-06-11",0,0,0,0,0,0,0,0
"Andorra","2024-06-12",0,0,0,0,0,0,0,0
"Andorra","2024-06-13",0,0,0,0,0,0,0,0
"Andorra","2024-06-14",0,0,0,0,0,0,0,0
"Andorra","2024-06-15",0,0,0,0,0,0,0,0
"Andorra","2024-06-16",0,0,0,0,0,0,0,0
"Andorra","2024-06-17",0,0,0,0,0,0,0,0
"Andorra","2024-06-18",0,0,0,0,0,0,0,0
"Andorra","2024-06-19",0,0,0,0,0,0,0,0
"Andorra","2024-06-20",0,0,0,0,0,0,0,0
"Andorra","2024-06-21",0,0,0,0,0,0,0,0
"Andorra","2024-06-22",0,0,0,0,0,0,0,0
"Andorra","2024-06-23",0,0,0,0,0,0,0,0
"Andorra","2024-06-24",0,0,0,0,0,0,0,0
"Andorra","2024-06-25",0,0,0,0,0,0,0,0
"Andorra","2024-06-26",0,0,0,0,0,0,0,0
"Andorra","2024-06-27",0,0,0,0,0,0,0,0
"Andorra","2024-06-28",0,0,0,0,0,0,0,0
"Andorra","2024-06-29",0,0,0,0,0,0,0,0
"Andorra","2024-06-30",0,0,0,0,0,0,0,0
"Andorra","2024-07-01",0,0,0,0,0,0,0,0
"Andorra","2024-07-02",0,0,0,0,0,0,0,0
"Andorra","2024-07-03",0,0,0,0,0,0,0,0
"Andorra","2024-07-04",0,0,0,0,0,0,0,0
"Andorra","2024-07-05",0,0,0,0,0,0,0,0
"Andorra","2024-07-06",0,0,0,0,0,0,0,0
"Andorra","2024-07-07",0,0,0,0,0,0,0,0
"Andorra","2024-07-08",0,0,0,0,0,0,0,0
"Andorra","2024-07-09",0,0,0,0,0,0,0,0
"Andorra","2024-07-10",0,0,0,0,0,0,0,0
"Andorra","2024-07-11",0,0,0,0,0,0,0,0
"Andorra","2024-07-12",0,0,0,0,0,0,0,0
"Andorra","2024-07-13",0,0,0,0,0,0,0,0
"Andorra","2024-07-14",0,0,0,0,0,0,0,0
"Andorra","2024-07-15",0,0,0,0,0,0,0,0
"Andorra","2024-07-16",0,0,0,0,0,0,0,0
"Andorra","2024-07-17",0,0,0,0,0,0,0,0
"Andorra","2024-07-18",0,0,0,0,0,0,0,0
"Andorra","2024-07-19",0,0,0,0,0,0,0,0
"Andorra","2024-07-20",0,0,0,0,0,0,0,0
"Andorra","2024-07-21",0,0,0,0,0,0,0,0
"Andorra","2024-07-22",0,0,0,0,0,0,0,0
"Andorra","2024-07-23",0,0,0,0,0,0,0,0
"Andorra","2024-07-24",0,0,0,0,0,0,0,0
"Andorra","2024-07-25",0,0,0,0,0,0,0,0
"Andorra","2024-07-26",0,0,0,0,0,0,0,0
"Andorra","2024-07-27",0,0,0,0,0,0,0,0
"Andorra","2024-07-28",0,0,0,0,0,0,0,0
"Andorra","2024-07-29",0,0,0,0,0,0,0,0
"Andorra","2024-07-30",0,0,0,0,0,0,0,0
"Andorra","2024-07-31",0,0,0,0,0,0,0,0
"Andorra","2024-08-01",0,0,0,0,0,0,0,0
"Andorra","2024-08-02",0,0,0,0,0,0,0,0
"Andorra","2024-08-03",0,0,0,0,0,0,0,0
"Andorra","2024-08-04",0,0,0,0,0,0,0,0
"Andorra","2024-08-05",0,0,0,0,0,0,0,0
"Andorra","2024-08-06",0,0,0,0,0,0,0,0
"Andorra","2024-08-07",0,0,0,0,0,0,0,0
"Andorra","2024-08-08",0,0,0,0,0,0,0,0
"Andorra","2024-08-09",0,0,0,0,0,0,0,0
"Andorra","2024-08-10",0,0,0,0,0,0,0,0
"Andorra","2024-08-11",0,0,0,0,0,0,0,0
"Andorra","2024-08-12",0,0,0,0,0,0,0,0
"Andorra","2024-08-13",0,0,0,0,0,0,0,0
"Andorra","2024-08-14",0,0,0,0,0,0,0,0
"Andorra","2024-08-15",0,0,0,0,0,0,0,0
"Andorra","2024-08-16",0,0,0,0,0,0,0,0
"Andorra","2024-08-17",0,0,0,0,0,0,0,0
"Andorra","2024-08-18",0,0,0,0,0,0,0,0
"Andorra","2024-08-19",0,0,0,0,0,0,0,0
"Andorra","2024-08-20",0,0,0,0,0,0,0,0
"Andorra","2024-08-21",0,0,0,0,0,0,0,0
"Andorra","2024-08-22",0,0,0,0,0,0,0,0
"Andorra","2024-08-23",0,0,0,0,0,0,0,0
"Andorra","2024-08-24",0,0,0,0,0,0,0,0
"Andorra","2024-08-25",0,0,0,0,0,0,0,0
"Andorra","2024-08-26",0,0,0,0,0,0,0,0
"Andorra","2024-08-27",0,0,0,0,0,0,0,0
"Andorra","2024-08-28",0,0,0,0,0,0,0,0
"Andorra","2024-08-29",0,0,0,0,0,0,0,0
"Andorra","2024-08-30",0,0,0,0,0,0,0,0
"Andorra","2024-08-31",0,0,0,0,0,0,0,0
"Andorra","2024-09-01",0,0,0,0,0,0,0,0
"Andorra","2024-09-02",0,0,0,0,0,0,0,0
"Andorra","2024-09-03",0,0,0,0,0,0,0,0
"Andorra","2024-09-04",0,0,0,0,0,0,0,0
"Andorra","2024-09-05",0,0,0,0,0,0,0,0
"Andorra","2024-09-06",0,0,0,0,0,0,0,0
"Andorra","2024-09-07",0,0,0,0,0,0,0,0
"Andorra","2024-09-08",0,0,0,0,0,0,0,0
"Andorra","2024-09-09",0,0,0,0,0,0,0,0
"Andorra","2024-09-10",0,0,0,0,0,0,0,0
"Andorra","2024-09-11",0,0,0,0,0,0,0,0
"Andorra","2024-09-12",0,0,0,0,0,0,0,0
"Andorra","2024-09-13",0,0,0,0,0,0,0,0
"Andorra","2024-09-14",0,0,0,0,0,0,0,0
"Andorra","2024-09-15",0,0,0,0,0,0,0,0
"Andorra","2024-09-16",0,0,0,0,0,0,0,0
"Andorra","2024-09-17",0,0,0,0,0,0,0,0
"Andorra","2024-09-18",0,0,0,0,0,0,0,0
"Andorra","2024-09-19",0,0,0,0,0,0,0,0
"Andorra","2024-09-20",0,0,0,0,0,0,0,0
"Andorra","2024-09-21",0,0,0,0,0,0,0,0
"Andorra","2024-09-22",0,0,0,0,0,0,0,0
"Andorra","2024-09-23",0,0,0,0,0,0,0,0
"Andorra","2024-09-24",0,0,0,0,0,0,0,0
"Andorra","2024-09-25",0,0,0,0,0,0,0,0
"Andorra","2024-09-26",0,0,0,0,0,0,0,0
"Andorra","2024-09-27",0,0,0,0,0,0,0,0
"Andorra","2024-09-28",0,0,0,0,0,0,0,0
"Andorra","2024-09-29",0,0,0,0,0,0,0,0
"Andorra","2024-09-30",0,0,0,0,0,0,0,0
"Andorra","2024-10-01",0,0,0,0,0,0,0,0
"Andorra","2024-10-02",0,0,0,0,0,0,0,0
"Andorra","2024-10-03",0,0,0,0,0,0,0,0
"Andorra","2024-10-04",0,0,0,0,0,0,0,0
"Andorra","2024-10-05",0,0,0,0,0,0,0,0
"Andorra","2024-10-06",0,0,0,0,0,0,0,0
"Andorra","2024-10-07",0,0,0,0,0,0,0,0
"Andorra","2024-10-08",0,0,0,0,0,0,0,0
"Andorra","2024-10-09",0,0,0,0,0,0,0,0
"Andorra","2024-10-10",0,0,0,0,0,0,0,0
"Andorra","2024-10-11",0,0,0,0,0,0,0,0
"Andorra","2024-10-12",0,0,0,0,0,0,0,0
"Andorra","2024-10-13",0,0,0,0,0,0,0,0
"Andorra","2024-10-14",0,0,0,0,0,0,0,0
"Andorra","2024-10-15",0,0,0,0,0,0,0,0
"Andorra","2024-10-16",0,0,0,0,0,0,0,0
"Andorra","2024-10-17",0,0,0,0,0,0,0,0
"Andorra","2024-10-18",0,0,0,0,0,0,0,0
"Andorra","2024-10-19",0,0,0,0,0,0,0,0
"Andorra","2024-10-20",0,0,0,0,0,0,0,0
"Andorra","2024-10-21",0,0,0,0,0,0,0,0
"Andorra","2024-10-22",0,0,0,0,0,0,0,0
"Andorra","2024-10-23",0,0,0,0,0,0,0,0
"Andorra","2024-10-24",0,0,0,0,0,0,0,0
"Andorra","2024-10-25",0,0,0,0,0,0,0,0
"Andorra","2024-10-26",0,0,0,0,0,0,0,0
"Andorra","2024-10-27",0,0,0,0,0,0,0,0
"Andorra","2024-10-28",0,0,0,0,0,0,0,0
"Andorra","2024-10-29",0,0,0,0,0,0,0,0
"Andorra","2024-10-30",0,0,0,0,0,0,0,0
"Andorra","2024-10-31",0,0,0,0,0,0,0,0
"Andorra","2024-11-01",0,0,0,0,0,0,0,0
"Andorra","2024-11-02",0,0,0,0,0,0,0,0
"Andorra","2024-11-03",0,0,0,0,0,0,0,0
"Andorra","2024-11-04",0,0,0,0,0,0,0,0
"Andorra","2024-11-05",0,0,0,0,0,0,0,0
"Andorra","2024-11-06",0,0,0,0,0,0,0,0
"Andorra","2024-11-07",0,0,0,0,0,0,0,0
"Andorra","2024-11-08",0,0,0,0,0,0,0,0
"Andorra","2024-11-09",0,0,0,0,0,0,0,0
"Andorra","2024-11-10",0,0,0,0,0,0,0,0
"Andorra","2024-11-11",0,0,0,0,0,0,0,0
"Andorra","2024-11-12",0,0,0,0,0,0,0,0
"Andorra","2024-11-13",0,0,0,0,0,0,0,0
"Andorra","2024-11-14",0,0,0,0,0,0,0,0
"Andorra","2024-11-15",0,0,0,0,0,0,0,0
"Andorra","2024-11-16",0,0,0,0,0,0,0,0
"Andorra","2024-11-17",0,0,0,0,0,0,0,0
"Andorra","2024-11-18",0,0,0,0,0,0,0,0
"Andorra","2024-11-19",0,0,0,0,0,0,0,0
"Andorra","2024-11-20",0,0,0,0,0,0,0,0
"Andorra","2024-11-21",0,0,0,0,0,0,0,0
"Andorra","2024-11-22",0,0,0,0,0,0,0,0
"Andorra","2024-11-23",0,0,0,0,0,0,0,0
"Andorra","2024-11-24",0,0,0,0,0,0,0,0
"Andorra","2024-11-25",0,0,0,0,0,0,0,0
"Andorra","2024-11-26",0,0,0,0,0,0,0,0
"Andorra","2024-11-27",0,0,0,0,0,0,0,0
"Andorra","2024-11-28",0,0,0,0,0,0,0,0
"Andorra","2024-11-29",0,0,0,0,0,0,0,0
"Andorra","2024-11-30",0,0,0,0,0,0,0,0
"Andorra","2024-12-01",0,0,0,0,0,0,0,0
"Andorra","2024-12-02",0,0,0,0,0,0,0,0
"Andorra","2024-12-03",0,0,0,0,0,0,0,0
"Andorra","2024-12-04",0,0,0,0,0,0,0,0
"Andorra","2024-12-05",0,0,0,0,0,0,0,0
"Andorra","2024-12-06",0,0,0,0,0,0,0,0
"Andorra","2024-12-07",0,0,0,0,0,0,0,0
"Andorra","2024-12-08",0,0,0,0,0,0,0,0
"Andorra","2024-12-09",0,0,0,0,0,0,0,0
"Andorra","2024-12-10",0,0,0,0,0,0,0,0
"Andorra","2024-12-11",0,0,0,0,0,0,0,0
"Andorra","2024-12-12",0,0,0,0,0,0,0,0
"Andorra","2024-12-13",0,0,0,0,0,0,0,0
"Andorra","2024-12-14",0,0,0,0,0,0,0,0
"Andorra","2024-12-15",0,0,0,0,0,0,0,0
"Andorra","2024-12-16",0,0,0,0,0,0,0,0
"Andorra","2024-12-17",0,0,0,0,0,0,0,0
"Andorra","2024-12-18",0,0,0,0,0,0,0,0
"Andorra","2024-12-19",0,0,0,0,0,0,0,0
"Andorra","2024-12-20",0,0,0,0,0,0,0,0
"Andorra","2024-12-21",0,0,0,0,0,0,0,0
"Andorra","2024-12-22",0,0,0,0,0,0,0,0
"Andorra","2024-12-23",0,0,0,0,0,0,0,0
"Andorra","2024-12-24",0,0,0,0,0,0,0,0
"Andorra","2024-12-25",0,0,0,0,0,0,0,0
"Andorra","2024-12-26",0,0,0,0,0,0,0,0
"Andorra","2024-12-27",0,0,0,0,0,0,0,0
"Andorra","2024-12-28",0,0,0,0,0,0,0,0
"Andorra","2024-12-29",0,0,0,0,0,0,0,0
"Andorra","2024-12-30",0,0,0,0,0,0,0,0
"Andorra","2024-12-31",0,0,0,0,0,0,0,0
"Andorra","2025-01-01",0,0,0,0,0,0,0,0
"Andorra","2025-01-02",0,0,0,0,0,0,0,0
"Andorra","2025-01-03",0,0,0,0,0,0,0,0
"Andorra","2025-01-04",0,0,0,0,0,0,0,0
"Andorra","2025-01-05",0,0,0,0,0,0,0,0
"Andorra","2025-01-06",0,0,0,0,0,0,0,0
"Andorra","2025-01-07",0,0,0,0,0,0,0,0
"Andorra","2025-01-08",0,0,0,0,0,0,0,0
"Andorra","2025-01-09",0,0,0,0,0,0,0,0
"Andorra","2025-01-10",0,0,0,0,0,0,0,0
"Andorra","2025-01-11",0,0,0,0,0,0,0,0
"Andorra","2025-01-12",0,0,0,0,0,0,0,0
"Andorra","2025-01-13",0,0,0,0,0,0,0,0
"Andorra","2025-01-14",0,0,0,0,0,0,0,0
"Andorra","2025-01-15",0,0,0,0,0,0,0,0
"Andorra","2025-01-16",0,0,0,0,0,0,0,0
"Andorra","2025-01-17",0,0,0,0,0,0,0,0
"Andorra","2025-01-18",0,0,0,0,0,0,0,0
"Andorra","2025-01-19",0,0,0,0,0,0,0,0
"Andorra","2025-01-20",0,0,0,0,0,0,0,0
"Andorra","2025-01-21",0,0,0,0,0,0,0,0
"Andorra","2025-01-22",0,0,0,0,0,0,0,0
"Andorra","2025-01-23",0,0,0,0,0,0,0,0
"Andorra","2025-01-24",0,0,0,0,0,0,0,0
"Andorra","2025-01-25",0,0,0,0,0,0,0,0
"Andorra","2025-01-26",0,0,0,0,0,0,0,0
"Andorra","2025-01-27",0,0,0,0,0,0,0,0
"Andorra","2025-01-28",0,0,0,0,0,0,0,0
"Andorra","2025-01-29",0,0,0,0,0,0,0,0
"Andorra","2025-01-30",0,0,0,0,0,0,0,0
"Andorra","2025-01-31",0,0,0,0,0,0,0,0
"Andorra","2025-02-01",0,0,0,0,0,0,0,0
"Andorra","2025-02-02",0,0,0,0,0,0,0,0
"Andorra","2025-02-03",0,0,0,0,0,0,0,0
"Angola","2024-01-01",0,0,0,0,0,0,0,0
"Angola","2024-01-02",0,0,0,0,0,0,0,0
"Angola","2024-01-03",0,0,0,0,0,0,0,0
"Angola","2024-01-04",0,0,0,0,0,0,0,0
"Angola","2024-01-05",0,0,0,0,0,0,0,0
"Angola","2024-01-06",0,0,0,0,0,0,0,0
"Angola","2024-01-07",0,0,0,0,0,0,0,0
"Angola","2024-01-08",0,0,0,0,0,0,0,0
"Angola","2024-01-09",0,0,0,0,0,0,0,0
"Angola","2024-01-10",0,0,0,0,0,0,0,0
"Angola","2024-01-11",0,0,0,0,0,0,0,0
"Angola","2024-01-12",0,0,0,0,0,0,0,0
"Angola","2024-01-13",0,0,0,0,0,0,0,0
"Angola","2024-01-14",0,0,0,0,0,0,0,0
"Angola","2024-01-15",0,0,0,0,0,0,0,0
"Angola","2024-01-16",0,0,0,0,0,0,0,0
"Angola","2024-01-17",0,0,0,0,0,0,0,0
"Angola","2024-01-18",0,0,0,0,0,0,0,0
"Angola","2024-01-19",0,0,0,0,0,0,0,0
"Angola","2024-01-20",0,0,0,0,0,0,0,0
"Angola","2024-01-21",0,0,0,0,0,0,0,0
"Angola","2024-01-22",0,0,0,0,0,0,0,0
"Angola","2024-01-23",0,0,0,0,0,0,0,0
"Angola","2024-01-24",0,0,0,0,0,0,0,0
"Angola","2024-01-25",0,0,0,0,0,0,0,0
"Angola","2024-01-26",0,0,0,0,0,0,0,0
"Angola","2024-01-27",0,0,0,0,0,0,0,0
"Angola","2024-01-28",0,0,0,0,0,0,0,0
"Angola","2024-01-29",0,0,0,0,0,0,0,0
"Angola","2024-01-30",0,0,0,0,0,0,0,0
"Angola","2024-01-31",0,0,0,0,0,0,0,0
"Angola","2024-02-01",0,0,0,0,0,0,0,0
"Angola","2024-02-02",0,0,0,0,0,0,0,0
"Angola","2024-02-03",0,0,0,0,0,0,0,0
"Angola","2024-02-04",0,0,0,0,0,0,0,0
"Angola","2024-02-05",0,0,0,0,0,0,0,0
"Angola","2024-02-06",0,0,0,0,0,0,0,0
"Angola","2024-02-07",0,0,0,0,0,0,0,0
"Angola","2024-02-08",0,0,0,0,0,0,0,0
"Angola","2024-02-09",0,0,0,0,0,0,0,0
"Angola","2024-02-10",0,0,0,0,0,0,0,0
"Angola","2024-02-11",0,0,0,0,0,0,0,0
"Angola","2024-02-12",0,0,0,0,0,0,0,0
"Angola","2024-02-13",0,0,0,0,0,0,0,0
"Angola","2024-02-14",0,0,0,0,0,0,0,0
"Angola","2024-02-15",0,0,0,0,0,0,0,0
"Angola","2024-02-16",0,0,0,0,0,0,0,0
"Angola","2024-02-17",0,0,0,0,0,0,0,0
"Angola","2024-02-18",0,0,0,0,0,0,0,0
"Angola","2024-02-19",0,0,0,0,0,0,0,0
"Angola","2024-02-20",0,0,0,0,0,0,0,0
"Angola","2024-02-21",0,0,0,0,0,0,0,0
"Angola","2024-02-22",0,0,0,0,0,0,0,0
"Angola","2024-02-23",0,0,0,0,0,0,0,0
"Angola","2024-02-24",0,0,0,0,0,0,0,0
"Angola","2024-02-25",0,0,0,0,0,0,0,0
"Angola","2024-02-26",0,0,0,0,0,0,0,0
"Angola","2024-02-27",0,0,0,0,0,0,0,0
"Angola","2024-02-28",0,0,0,0,0,0,0,0
"Angola","2024-02-29",0,0,0,0,0,0,0,0
"Angola","2024-03-01",0,0,0,0,0,0,0,0
"Angola","2024-03-02",0,0,0,0,0,0,0,0
"Angola","2024-03-03",0,0,0,0,0,0,0,0
"Angola","2024-03-04",0,0,0,0,0,0,0,0
"Angola","2024-03-05",0,0,0,0,0,0,0,0
"Angola","2024-03-06",0,0,0,0,0,0,0,0
"Angola","2024-03-07",0,0,0,0,0,0,0,0
"Angola","2024-03-08",0,0,0,0,0,0,0,0
"Angola","2024-03-09",0,0,0,0,0,0,0,0
"Angola","2024-03-10",0,0,0,0,0,0,0,0
"Angola","2024-03-11",0,0,0,0,0,0,0,0
"Angola","2024-03-12",0,0,0,0,0,0,0,0
"Angola","2024-03-13",0,0,0,0,0,0,0,0
"Angola","2024-03-14",0,0,0,0,0,0,0,0
"Angola","2024-03-15",0,0,0,0,0,0,0,0
"Angola","2024-03-16",0,0,0,0,0,0,0,0
"Angola","2024-03-17",0,0,0,0,0,0,0,0
"Angola","2024-03-18",0,0,0,0,0,0,0,0
"Angola","2024-03-19",0,0,0,0,0,0,0,0
"Angola","2024-03-20",0,0,0,0,0,0,0,0
"Angola","2024-03-21",0,0,0,0,0,0,0,0
"Angola","2024-03-22",0,0,0,0,0,0,0,0
"Angola","2024-03-23",0,0,0,0,0,0,0,0
"Angola","2024-03-24",0,0,0,0,0,0,0,0
"Angola","2024-03-25",0,0,0,0,0,0,0,0
"Angola","2024-03-26",0,0,0,0,0,0,0,0
"Angola","2024-03-27",0,0,0,0,0,0,0,0
"Angola","2024-03-28",0,0,0,0,0,0,0,0
"Angola","2024-03-29",0,0,0,0,0,0,0,0
"Angola","2024-03-30",0,0,0,0,0,0,0,0
"Angola","2024-03-31",0,0,0,0,0,0,0,0
"Angola","2024-04-01",0,0,0,0,0,0,0,0
"Angola","2024-04-02",0,0,0,0,0,0,0,0
"Angola","2024-04-03",0,0,0,0,0,0,0,0
"Angola","2024-04-04",0,0,0,0,0,0,0,0
"Angola","2024-04-05",0,0,0,0,0,0,0,0
"Angola","2024-04-06",0,0,0,0,0,0,0,0
"Angola","2024-04-07",0,0,0,0,0,0,0,0
"Angola","2024-04-08",0,0,0,0,0,0,0,0
"Angola","2024-04-09",0,0,0,0,0,0,0,0
"Angola","2024-04-10",0,0,0,0,0,0,0,0
"Angola","2024-04-11",0,0,0,0,0,0,0,0
"Angola","2024-04-12",0,0,0,0,0,0,0,0
"Angola","2024-04-13",0,0,0,0,0,0,0,0
"Angola","2024-04-14",0,0,0,0,0,0,0,0
"Angola","2024-04-15",0,0,0,0,0,0,0,0
"Angola","2024-04-16",0,0,0,0,0,0,0,0
"Angola","2024-04-17",0,0,0,0,0,0,0,0
"Angola","2024-04-18",0,0,0,0,0,0,0,0
"Angola","2024-04-19",0,0,0,0,0,0,0,0
"Angola","2024-04-20",0,0,0,0,0,0,0,0
"Angola","2024-04-21",0,0,0,0,0,0,0,0
"Angola","2024-04-22",0,0,0,0,0,0,0,0
"Angola","2024-04-23",0,0,0,0,0,0,0,0
"Angola","2024-04-24",0,0,0,0,0,0,0,0
"Angola","2024-04-25",0,0,0,0,0,0,0,0
"Angola","2024-04-26",0,0,0,0,0,0,0,0
"Angola","2024-04-27",0,0,0,0,0,0,0,0
"Angola","2024-04-28",0,0,0,0,0,0,0,0
"Angola","2024-04-29",0,0,0,0,0,0,0,0
"Angola","2024-04-30",0,0,0,0,0,0,0,0
"Angola","2024-05-01",0,0,0,0,0,0,0,0
"Angola","2024-05-02",0,0,0,0,0,0,0,0
"Angola","2024-05-03",0,0,0,0,0,0,0,0
"Angola","2024-05-04",0,0,0,0,0,0,0,0
"Angola","2024-05-05",0,0,0,0,0,0,0,0
"Angola","2024-05-06",0,0,0,0,0,0,0,0
"Angola","2024-05-07",0,0,0,0,0,0,0,0
"Angola","2024-05-08",0,0,0,0,0,0,0,0
"Angola","2024-05-09",0,0,0,0,0,0,0,0
"Angola","2024-05-10",0,0,0,0,0,0,0,0
"Angola","2024-05-11",0,0,0,0,0,0,0,0
"Angola","2024-05-12",0,0,0,0,0,0,0,0
"Angola","2024-05-13",0,0,0,0,0,0,0,0
"Angola","2024-05-14",0,0,0,0,0,0,0,0
"Angola","2024-05-15",0,0,0,0,0,0,0,0
"Angola","2024-05-16",0,0,0,0,0,0,0,0
"Angola","2024-05-17",0,0,0,0,0,0,0,0
"Angola","2024-05-18",0,0,0,0,0,0,0,0
"Angola","2024-05-19",0,0,0,0,0,0,0,0
"Angola","2024-05-20",0,0,0,0,0,0,0,0
"Angola","2024-05-21",0,0,0,0,0,0,0,0
"Angola","2024-05-22",0,0,0,0,0,0,0,0
"Angola","2024-05-23",0,0,0,0,0,0,0,0
"Angola","2024-05-24",0,0,0,0,0,0,0,0
"Angola","2024-05-25",0,0,0,0,0,0,0,0
"Angola","2024-05-26",0,0,0,0,0,0,0,0
"Angola","2024-05-27",0,0,0,0,0,0,0,0
"Angola","2024-05-28",0,0,0,0,0,0,0,0
"Angola","2024-05-29",0,0,0,0,0,0,0,0
"Angola","2024-05-30",0,0,0,0,0,0,0,0
"Angola","2024-05-31",0,0,0,0,0,0,0,0
"Angola","2024-06-01",0,0,0,0,0,0,0,0
"Angola","2024-06-02",0,0,0,0,0,0,0,0
"Angola","2024-06-03",0,0,0,0,0,0,0,0
"Angola","2024-06-04",0,0,0,0,0,0,0,0
"Angola","2024-06-05",0,0,0,0,0,0,0,0
"Angola","2024-06-06",0,0,0,0,0,0,0,0
"Angola","2024-06-07",0,0,0,0,0,0,0,0
"Angola","2024-06-08",0,0,0,0,0,0,0,0
"Angola","2024-06-09",0,0,0,0,0,0,0,0
"Angola","2024-06-10",0,0,0,0,0,0,0,0
"Angola","2024-06-11",0,0,0,0,0,0,0,0
"Angola","2024-06-12",0,0,0,0,0,0,0,0
"Angola","2024-06-13",0,0,0,0,0,0,0,0
"Angola","2024-06-14",0,0,0,0,0,0,0,0
"Angola","2024-06-15",0,0,0,0,0,0,0,0
"Angola","2024-06-16",0,0,0,0,0,0,0,0
"Angola","2024-06-17",0,0,0,0,0,0,0,0
"Angola","2024-06-18",0,0,0,0,0,0,0,0
"Angola","2024-06-19",0,0,0,0,0,0,0,0
"Angola","2024-06-20",0,0,0,0,0,0,0,0
"Angola","2024-06-21",0,0,0,0,0,0,0,0
"Angola","2024-06-22",0,0,0,0,0,0,0,0
"Angola","2024-06-23",0,0,0,0,0,0,0,0
"Angola","2024-06-24",0,0,0,0,0,0,0,0
"Angola","2024-06-25",0,0,0,0,0,0,0,0
"Angola","2024-06-26",0,0,0,0,0,0,0,0
"Angola","2024-06-27",0,0,0,0,0,0,0,0
"Angola","2024-06-28",0,0,0,0,0,0,0,0
"Angola","2024-06-29",0,0,0,0,0,0,0,0
"Angola","2024-06-30",0,0,0,0,0,0,0,0
"Angola","2024-07-01",0,0,0,0,0,0,0,0
"Angola","2024-07-02",0,0,0,0,0,0,0,0
"Angola","2024-07-03",0,0,0,0,0,0,0,0
"Angola","2024-07-04",0,0,0,0,0,0,0,0
"Angola","2024-07-05",0,0,0,0,0,0,0,0
"Angola","2024-07-06",0,0,0,0,0,0,0,0
"Angola","2024-07-07",0,0,0,0,0,0,0,0
"Angola","2024-07-08",0,0,0,0,0,0,0,0
"Angola","2024-07-09",0,0,0,0,0,0,0,0
"Angola","2024-07-10",0,0,0,0,0,0,0,0
"Angola","2024-07-11",0,0,0,0,0,0,0,0
"Angola","2024-07-12",0,0,0,0,0,0,0,0
"Angola","2024-07-13",0,0,0,0,0,0,0,0
"Angola","2024-07-14",0,0,0,0,0,0,0,0
"Angola","2024-07-15",0,0,0,0,0,0,0,0
"Angola","2024-07-16",0,0,0,0,0,0,0,0
"Angola","2024-07-17",0,0,0,0,0,0,0,0
"Angola","2024-07-18",0,0,0,0,0,0,0,0
"Angola","2024-07-19",0,0,0,0,0,0,0,0
"Angola","2024-07-20",0,0,0,0,0,0,0,0
"Angola","2024-07-21",0,0,0,0,0,0,0,0
"Angola","2024-07-22",0,0,0,0,0,0,0,0
"Angola","2024-07-23",0,0,0,0,0,0,0,0
"Angola","2024-07-24",0,0,0,0,0,0,0,0
"Angola","2024-07-25",0,0,0,0,0,0,0,0
"Angola","2024-07-26",0,0,0,0,0,0,0,0
"Angola","2024-07-27",0,0,0,0,0,0,0,0
"Angola","2024-07-28",0,0,0,0,0,0,0,0
"Angola","2024-07-29",0,0,0,0,0,0,0,0
"Angola","2024-07-30",0,0,0,0,0,0,0,0
"Angola","2024-07-31",0,0,0,0,0,0,0,0
"Angola","2024-08-01",0,0,0,0,0,0,0,0
"Angola","2024-08-02",0,0,0,0,0,0,0,0
"Angola","2024-08-03",0,0,0,0,0,0,0,0
"Angola","2024-08-04",0,0,0,0,0,0,0,0
"Angola","2024-08-05",0,0,0,0,0,0,0,0
"Angola","2024-08-06",0,0,0,0,0,0,0,0
"Angola","2024-08-07",0,0,0,0,0,0,0,0
"Angola","2024-08-08",0,0,0,0,0,0,0,0
"Angola","2024-08-09",0,0,0,0,0,0,0,0
"Angola","2024-08-10",0,0,0,0,0,0,0,0
"Angola","2024-08-11",0,0,0,0,0,0,0,0
"Angola","2024-08-12",0,0,0,0,0,0,0,0
"Angola","2024-08-13",0,0,0,0,0,0,0,0
"Angola","2024-08-14",0,0,0,0,0,0,0,0
"Angola","2024-08-15",0,0,0,0,0,0,0,0
"Angola","2024-08-16",0,0,0,0,0,0,0,0
"Angola","2024-08-17",0,0,0,0,0,0,0,0
"Angola","2024-08-18",0,0,0,0,0,0,0,0
"Angola","2024-08-19",0,0,0,0,0,0,0,0
"Angola","2024-08-20",0,0,0,0,0,0,0,0
"Angola","2024-08-21",0,0,0,0,0,0,0,0
"Angola","2024-08-22",0,0,0,0,0,0,0,0
"Angola","2024-08-23",0,0,0,0,0,0,0,0
"Angola","2024-08-24",0,0,0,0,0,0,0,0
"Angola","2024-08-25",0,0,0,0,0,0,0,0
"Angola","2024-08-26",0,0,0,0,0,0,0,0
"Angola","2024-08-27",0,0,0,0,0,0,0,0
"Angola","2024-08-28",0,0,0,0,0,0,0,0
"Angola","2024-08-29",0,0,0,0,0,0,0,0
"Angola","2024-08-30",0,0,0,0,0,0,0,0
"Angola","2024-08-31",0,0,0,0,0,0,0,0
"Angola","2024-09-01",0,0,0,0,0,0,0,0
"Angola","2024-09-02",0,0,0,0,0,0,0,0
"Angola","2024-09-03",0,0,0,0,0,0,0,0
"Angola","2024-09-04",0,0,0,0,0,0,0,0
"Angola","2024-09-05",0,0,0,0,0,0,0,0
"Angola","2024-09-06",0,0,0,0,0,0,0,0
"Angola","2024-09-07",0,0,0,0,0,0,0,0
"Angola","2024-09-08",0,0,0,0,0,0,0,0
"Angola","2024-09-09",0,0,0,0,0,0,0,0
"Angola","2024-09-10",0,0,0,0,0,0,0,0
"Angola","2024-09-11",0,0,0,0,0,0,0,0
"Angola","2024-09-12",0,0,0,0,0,0,0,0
"Angola","2024-09-13",0,0,0,0,0,0,0,0
"Angola","2024-09-14",0,0,0,0,0,0,0,0
"Angola","2024-09-15",0,0,0,0,0,0,0,0
"Angola","2024-09-16",0,0,0,0,0,0,0,0
"Angola","2024-09-17",0,0,0,0,0,0,0,0
"Angola","2024-09-18",0,0,0,0,0,0,0,0
"Angola","2024-09-19",0,0,0,0,0,0,0,0
"Angola","2024-09-20",0,0,0,0,0,0,0,0
"Angola","2024-09-21",0,0,0,0,0,0,0,0
"Angola","2024-09-22",0,0,0,0,0,0,0,0
"Angola","2024-09-23",0,0,0,0,0,0,0,0
"Angola","2024-09-24",0,0,0,0,0,0,0,0
"Angola","2024-09-25",0,0,0,0,0,0,0,0
"Angola","2024-09-26",0,0,0,0,0,0,0,0
"Angola","2024-09-27",0,0,0,0,0,0,0,0
"Angola","2024-09-28",0,0,0,0,0,0,0,0
"Angola","2024-09-29",0,0,0,0,0,0,0,0
"Angola","2024-09-30",0,0,0,0,0,0,0,0
"Angola","2024-10-01",0,0,0,0,0,0,0,0
"Angola","2024-10-02",0,0,0,0,0,0,0,0
"Angola","2024-10-03",0,0,0,0,0,0,0,0
"Angola","2024-10-04",0,0,0,0,0,0,0,0
"Angola","2024-10-05",0,0,0,0,0,0,0,0
"Angola","2024-10-06",0,0,0,0,0,0,0,0
"Angola","2024-10-07",0,0,0,0,0,0,0,0
"Angola","2024-10-08",0,0,0,0,0,0,0,0
"Angola","2024-10-09",0,0,0,0,0,0,0,0
"Angola","2024-10-10",0,0,0,0,0,0,0,0
"Angola","2024-10-11",0,0,0,0,0,0,0,0
"Angola","2024-10-12",0,0,0,0,0,0,0,0
"Angola","2024-10-13",0,0,0,0,0,0,0,0
"Angola","2024-10-14",0,0,0,0,0,0,0,0
"Angola","2024-10-15",0,0,0,0,0,0,0,0
"Angola","2024-10-16",0,0,0,0,0,0,0,0
"Angola","2024-10-17",0,0,0,0,0,0,0,0
"Angola","2024-10-18",0,0,0,0,0,0,0,0
"Angola","2024-10-19",0,0,0,0,0,0,0,0
"Angola","2024-10-20",0,0,0,0,0,0,0,0
"Angola","2024-10-21",0,0,0,0,0,0,0,0
"Angola","2024-10-22",0,0,0,0,0,0,0,0
"Angola","2024-10-23",0,0,0,0,0,0,0,0
"Angola","2024-10-24",0,0,0,0,0,0,0,0
"Angola","2024-10-25",0,0,0,0,0,0,0,0
"Angola","2024-10-26",0,0,0,0,0,0,0,0
"Angola","2024-10-27",0,0,0,0,0,0,0,0
"Angola","2024-10-28",0,0,0,0,0,0,0,0
"Angola","2024-10-29",0,0,0,0,0,0,0,0
"Angola","2024-10-30",0,0,0,0,0,0,0,0
"Angola","2024-10-31",0,0,0,0,0,0,0,0
"Angola","2024-11-01",0,0,0,0,0,0,0,0
"Angola","2024-11-02",0,0,0,0,0,0,0,0
"Angola","2024-11-03",0,0,0,0,0,0,0,0
"Angola","2024-11-04",0,0,0,0,0,0,0,0
"Angola","2024-11-05",0,0,0,0,0,0,0,0
"Angola","2024-11-06",0,0,0,0,0,0,0,0
"Angola","2024-11-07",0,0,0,0,0,0,0,0
"Angola","2024-11-08",0,0,0,0,0,0,0,0
"Angola","2024-11-09",0,0,0,0,0,0,0,0
"Angola","2024-11-10",0,0,0,0,0,0,0,0
"Angola","2024-11-11",0,0,0,0,0,0,0,0
"Angola","2024-11-12",0,0,0,0,0,0,0,0
"Angola","2024-11-13",0,0,0,0,0,0,0,0
"Angola","2024-11-14",0,0,0,0,0,0,0,0
"Angola","2024-11-15",0,0,0,0,0,0,0,0
"Angola","2024-11-16",0,0,0,0,0,0,0,0
"Angola","2024-11-17",0,1,1,0,1,1,0,0
"Angola","2024-11-18",0,0,1,0,0,1,0,0
"Angola","2024-11-19",0,0,1,0,1,2,0,0
"Angola","2024-11-20",0,1,2,0,0,2,0,0
"Angola","2024-11-21",0,0,2,0,0,2,0,0
"Angola","2024-11-22",0,0,2,0,0,2,0,0
"Angola","2024-11-23",0,0,2,0,0,2,0,0
"Angola","2024-11-24",0,0,2,0,0,2,0,0
"Angola","2024-11-25",0,0,2,0,0,2,0,0
"Angola","2024-11-26",0,0,2,0,1,3,0,0
"Angola","2024-11-27",0,0,2,0,0,3,0,0
"Angola","2024-11-28",0,0,2,0,0,3,0,0
"Angola","2024-11-29",0,0,2,0,0,3,0,0
"Angola","2024-11-30",0,0,2,0,0,3,0,0
"Angola","2024-12-01",0,1,3,0,0,3,0,0
"Angola","2024-12-02",0,0,3,0,0,3,0,0
"Angola","2024-12-03",0,0,3,0,0,3,0,0
"Angola","2024-12-04",0,0,3,0,0,3,0,0
"Angola","2024-12-05",0,0,3,0,1,4,0,0
"Angola","2024-12-06",0,0,3,0,0,4,0,0
"Angola","2024-12-07",0,0,3,0,0,4,0,0
"Angola","2024-12-08",0,1,4,0,0,4,0,0
"Angola","2024-12-09",0,0,4,0,0,4,0,0
"Angola","2024-12-10",0,0,4,0,0,4,0,0
"Angola","2024-12-11",0,0,4,0,0,4,0,0
"Angola","2024-12-12",0,0,4,0,0,4,0,0
"Angola","2024-12-13",0,0,4,0,0,4,0,0
"Angola","2024-12-14",0,0,4,0,0,4,0,0
"Angola","2024-12-15",0,0,4,0,0,4,0,0
"Angola","2024-12-16",0,0,4,0,0,4,0,0
"Angola","2024-12-17",0,0,4,0,0,4,0,0
"Angola","2024-12-18",0,0,4,0,0,4,0,0
"Angola","2024-12-19",0,0,4,0,0,4,0,0
"Angola","2024-12-20",0,0,4,0,0,4,0,0
"Angola","2024-12-21",0,0,4,0,0,4,0,0
"Angola","2024-12-22",0,0,4,0,0,4,0,0
"Angola","2024-12-23",0,0,4,0,0,4,0,0
"Angola","2024-12-24",0,0,4,0,0,4,0,0
"Angola","2024-12-25",0,0,4,0,0,4,0,0
"Angola","2024-12-26",0,0,4,0,0,4,0,0
"Angola","2024-12-27",0,0,4,0,0,4,0,0
"Angola","2024-12-28",0,0,4,0,0,4,0,0
"Angola","2024-12-29",0,0,4,0,0,4,0,0
"Angola","2024-12-30",0,0,4,0,0,4,0,0
"Angola","2024-12-31",0,0,4,0,0,4,0,0
"Angola","2025-01-01",0,0,4,0,0,4,0,0
"Angola","2025-01-02",0,0,4,0,0,4,0,0
"Angola","2025-01-03",0,0,4,0,0,4,0,0
"Angola","2025-01-04",0,0,4,0,0,4,0,0
"Angola","2025-01-05",0,0,4,0,0,4,0,0
"Angola","2025-01-06",0,0,4,0,0,4,0,0
"Angola","2025-01-07",0,0,4,0,0,4,0,0
"Angola","2025-01-08",0,0,4,0,0,4,0,0
"Angola","2025-01-09",0,0,4,0,0,4,0,0
"Angola","2025-01-10",0,0,4,0,0,4,0,0
"Angola","2025-01-11",0,0,4,0,0,4,0,0
"Angola","2025-01-12",0,0,4,0,0,4,0,0
"Angola","2025-01-13",0,0,4,0,0,4,0,0
"Angola","2025-01-14",0,0,4,0,0,4,0,0
"Angola","2025-01-15",0,0,4,0,0,4,0,0
"Angola","2025-01-16",0,0,4,0,0,4,0,0
"Angola","2025-01-17",0,0,4,0,0,4,0,0
"Angola","2025-01-18",0,0,4,0,0,4,0,0
"Angola","2025-01-19",0,0,4,0,0,4,0,0
"Angola","2025-01-20",0,0,4,0,0,4,0,0
"Angola","2025-01-21",0,0,4,0,0,4,0,0
"Angola","2025-01-22",0,0,4,0,0,4,0,0
"Angola","2025-01-23",0,0,4,0,0,4,0,0
"Angola","2025-01-24",0,0,4,0,0,4,0,0
"Angola","2025-01-25",0,0,4,0,0,4,0,0
"Angola","2025-01-26",0,0,4,0,0,4,0,0
"Angola","2025-01-27",0,0,4,0,0,4,0,0
"Angola","2025-01-28",0,0,4,0,0,4,0,0
"Angola","2025-01-29",0,0,4,0,0,4,0,0
"Angola","2025-01-30",0,0,4,0,0,4,0,0
"Angola","2025-01-31",0,0,4,0,0,4,0,0
"Angola","2025-02-01",0,0,4,0,0,4,0,0
"Angola","2025-02-02",0,0,4,0,0,4,0,0
"Angola","2025-02-03",0,0,4,0,0,4,0,0
"Argentina","2024-01-01",0,0,0,0,0,0,0,0
"Argentina","2024-01-02",0,0,0,0,0,0,0,0
"Argentina","2024-01-03",0,0,0,0,0,0,0,0
"Argentina","2024-01-04",0,0,0,0,0,0,0,0
"Argentina","2024-01-05",0,0,0,0,0,0,0,0
"Argentina","2024-01-06",0,0,0,0,0,0,0,0
"Argentina","2024-01-07",0,0,0,0,0,0,0,0
"Argentina","2024-01-08",0,0,0,0,0,0,0,0
"Argentina","2024-01-09",0,0,0,0,0,0,0,0
"Argentina","2024-01-10",0,0,0,0,0,0,0,0
"Argentina","2024-01-11",0,0,0,0,0,0,0,0
"Argentina","2024-01-12",0,0,0,0,0,0,0,0
"Argentina","2024-01-13",0,0,0,0,0,0,0,0
"Argentina","2024-01-14",0,0,0,0,0,0,0,0
"Argentina","2024-01-15",0,0,0,0,0,0,0,0
"Argentina","2024-01-16",0,0,0,0,0,0,0,0
"Argentina","2024-01-17",0,0,0,0,0,0,0,0
"Argentina","2024-01-18",0,0,0,0,0,0,0,0
"Argentina","2024-01-19",0,0,0,0,0,0,0,0
"Argentina","2024-01-20",0,0,0,0,0,0,0,0
"Argentina","2024-01-21",0,0,0,0,0,0,0,0
"Argentina","2024-01-22",0,0,0,0,0,0,0,0
"Argentina","2024-01-23",0,1,1,0,1,1,0,0
"Argentina","2024-01-24",0,0,1,0,0,1,0,0
"Argentina","2024-01-25",0,0,1,0,0,1,0,0
"Argentina","2024-01-26",0,0,1,0,0,1,0,0
"Argentina","2024-01-27",0,0,1,0,0,1,0,0
"Argentina","2024-01-28",0,0,1,0,0,1,0,0
"Argentina","2024-01-29",0,0,1,0,0,1,0,0
"Argentina","2024-01-30",0,0,1,0,0,1,0,0
"Argentina","2024-01-31",0,0,1,0,0,1,0,0
"Argentina","2024-02-01",0,0,1,0,0,1,0,0
"Argentina","2024-02-02",0,0,1,0,0,1,0,0
"Argentina","2024-02-03",0,0,1,0,0,1,0,0
"Argentina","2024-02-04",0,0,1,0,0,1,0,0
"Argentina","2024-02-05",0,0,1,0,0,1,0,0
"Argentina","2024-02-06",0,0,1,0,0,1,0,0
"Argentina","2024-02-07",0,0,1,0,0,1,0,0
"Argentina","2024-02-08",0,0,1,0,0,1,0,0
"Argentina","2024-02-09",0,0,1,0,0,1,0,0
"Argentina","2024-02-10",0,0,1,0,0,1,0,0
"Argentina","2024-02-11",0,0,1,0,0,1,0,0
"Argentina","2024-02-12",0,0,1,0,0,1,0,0
"Argentina","2024-02-13",0,0,1,0,0,1,0,0
"Argentina","2024-02-14",0,0,1,0,0,1,0,0
"Argentina","2024-02-15",0,0,1,0,0,1,0,0
"Argentina","2024-02-16",0,0,1,0,0,1,0,0
"Argentina","2024-02-17",0,0,1,0,0,1,0,0
"Argentina","2024-02-18",0,0,1,0,0,1,0,0
"Argentina","2024-02-19",0,0,1,0,0,1,0,0
"Argentina","2024-02-20",0,0,1,0,0,1,0,0
"Argentina","2024-02-21",0,0,1,0,0,1,0,0
"Argentina","2024-02-22",0,0,1,0,0,1,0,0
"Argentina","2024-02-23",0,0,1,0,0,1,0,0
"Argentina","2024-02-24",0,0,1,0,0,1,0,0
"Argentina","2024-02-25",0,0,1,0,0,1,0,0
"Argentina","2024-02-26",0,0,1,0,0,1,0,0
"Argentina","2024-02-27",0,0,1,0,0,1,0,0
"Argentina","2024-02-28",0,0,1,0,0,1,0,0
"Argentina","2024-02-29",0,0,1,0,0,1,0,0
"Argentina","2024-03-01",0,0,1,0,0,1,0,0
"Argentina","2024-03-02",0,0,1,0,0,1,0,0
"Argentina","2024-03-03",0,0,1,0,0,1,0,0
"Argentina","2024-03-04",0,0,1,0,1,2,0,0
"Argentina","2024-03-05",0,0,1,0,0,2,0,0
"Argentina","2024-03-06",0,0,1,0,0,2,0,0
"Argentina","2024-03-07",0,0,1,0,0,2,0,0
"Argentina","2024-03-08",0,0,1,0,0,2,0,0
"Argentina","2024-03-09",0,0,1,0,0,2,0,0
"Argentina","2024-03-10",0,0,1,0,0,2,0,0
"Argentina","2024-03-11",0,0,1,0,0,2,0,0
"Argentina","2024-03-12",0,0,1,0,0,2,0,0
"Argentina","2024-03-13",0,0,1,0,0,2,0,0
"Argentina","2024-03-14",0,0,1,0,0,2,0,0
"Argentina","2024-03-15",0,0,1,0,0,2,0,0
"Argentina","2024-03-16",0,0,1,0,0,2,0,0
"Argentina","2024-03-17",0,0,1,0,0,2,0,0
"Argentina","2024-03-18",0,0,1,0,0,2,0,0
"Argentina","2024-03-19",0,0,1,0,0,2,0,0
"Argentina","2024-03-20",0,0,1,0,0,2,0,0
"Argentina","2024-03-21",0,0,1,0,0,2,0,0
"Argentina","2024-03-22",0,0,1,0,0,2,0,0
"Argentina","2024-03-23",0,0,1,0,0,2,0,0
"Argentina","2024-03-24",0,0,1,0,0,2,0,0
"Argentina","2024-03-25",0,0,1,0,0,2,0,0
"Argentina","2024-03-26",0,0,1,0,0,2,0,0
"Argentina","2024-03-27",0,0,1,0,0,2,0,0
"Argentina","2024-03-28",0,0,1,0,0,2,0,0
"Argentina","2024-03-29",0,0,1,0,0,2,0,0
"Argentina","2024-03-30",0,0,1,0,0,2,0,0
"Argentina","2024-03-31",0,0,1,0,0,2,0,0
"Argentina","2024-04-01",0,0,1,0,0,2,0,0
"Argentina","2024-04-02",0,0,1,0,0,2,0,0
"Argentina","2024-04-03",0,0,1,0,0,2,0,0
"Argentina","2024-04-04",0,0,1,0,0,2,0,0
"Argentina","2024-04-05",0,0,1,0,0,2,0,0
"Argentina","2024-04-06",0,0,1,0,0,2,0,0
"Argentina","2024-04-07",0,0,1,0,0,2,0,0
"Argentina","2024-04-08",0,0,1,0,0,2,0,0
"Argentina","2024-04-09",0,0,1,0,0,2,0,0
"Argentina","2024-04-10",0,0,1,0,0,2,0,0
"Argentina","2024-04-11",0,0,1,0,0,2,0,0
"Argentina","2024-04-12",0,0,1,0,0,2,0,0
"Argentina","2024-04-13",0,0,1,0,0,2,0,0
"Argentina","2024-04-14",0,0,1,0,0,2,0,0
"Argentina","2024-04-15",0,0,1,0,0,2,0,0
"Argentina","2024-04-16",0,0,1,0,0,2,0,0
"Argentina","2024-04-17",0,0,1,0,0,2,0,0
"Argentina","2024-04-18",0,0,1,0,0,2,0,0
"Argentina","2024-04-19",0,0,1,0,0,2,0,0
"Argentina","2024-04-20",0,0,1,0,0,2,0,0
"Argentina","2024-04-21",0,0,1,0,0,2,0,0
"Argentina","2024-04-22",0,0,1,0,0,2,0,0
"Argentina","2024-04-23",0,0,1,0,0,2,0,0
"Argentina","2024-04-24",0,0,1,0,0,2,0,0
"Argentina","2024-04-25",0,0,1,0,0,2,0,0
"Argentina","2024-04-26",0,0,1,0,0,2,0,0
"Argentina","2024-04-27",0,0,1,0,0,2,0,0
"Argentina","2024-04-28",0,0,1,0,0,2,0,0
"Argentina","2024-04-29",0,0,1,0,0,2,0,0
"Argentina","2024-04-30",0,0,1,0,0,2,0,0
"Argentina","2024-05-01",0,0,1,0,0,2,0,0
"Argentina","2024-05-02",0,0,1,0,0,2,0,0
"Argentina","2024-05-03",0,0,1,0,0,2,0,0
"Argentina","2024-05-04",0,0,1,0,0,2,0,0
"Argentina","2024-05-05",0,0,1,0,0,2,0,0
"Argentina","2024-05-06",0,0,1,0,0,2,0,0
"Argentina","2024-05-07",0,0,1,0,0,2,0,0
"Argentina","2024-05-08",0,0,1,0,0,2,0,0
"Argentina","2024-05-09",0,0,1,0,0,2,0,0
"Argentina","2024-05-10",0,0,1,0,0,2,0,0
"Argentina","2024-05-11",0,0,1,0,0,2,0,0
"Argentina","2024-05-12",0,0,1,0,0,2,0,0
"Argentina","2024-05-13",0,0,1,0,0,2,0,0
"Argentina","2024-05-14",0,0,1,0,0,2,0,0
"Argentina","2024-05-15",0,0,1,0,0,2,0,0
"Argentina","2024-05-16",0,0,1,0,0,2,0,0
"Argentina","2024-05-17",0,0,1,0,0,2,0,0
"Argentina","2024-05-18",0,0,1,0,0,2,0,0
"Argentina","2024-05-19",0,0,1,0,0,2,0,0
"Argentina","2024-05-20",0,0,1,0,0,2,0,0
"Argentina","2024-05-21",0,0,1,0,0,2,0,0
"Argentina","2024-05-22",0,0,1,0,0,2,0,0
"Argentina","2024-05-23",0,0,1,0,1,3,0,0
"Argentina","2024-05-24",0,0,1,0,0,3,0,0
"Argentina","2024-05-25",0,0,1,0,0,3,0,0
"Argentina","2024-05-26",0,0,1,0,0,3,0,0
"Argentina","2024-05-27",0,0,1,0,0,3,0,0
"Argentina","2024-05-28",0,0,1,0,0,3,0,0
"Argentina","2024-05-29",0,0,1,0,0,3,0,0
"Argentina","2024-05-30",0,0,1,0,0,3,0,0
"Argentina","2024-05-31",0,0,1,0,0,3,0,0
"Argentina","2024-06-01",0,0,1,0,0,3,0,0
"Argentina","2024-06-02",0,0,1,0,0,3,0,0
"Argentina","2024-06-03",0,0,1,0,0,3,0,0
"Argentina","2024-06-04",0,0,1,0,0,3,0,0
"Argentina","2024-06-05",0,0,1,0,0,3,0,0
"Argentina","2024-06-06",0,0,1,0,0,3,0,0
"Argentina","2024-06-07",0,0,1,0,0,3,0,0
"Argentina","2024-06-08",0,0,1,0,0,3,0,0
"Argentina","2024-06-09",0,0,1,0,0,3,0,0
"Argentina","2024-06-10",0,0,1,0,0,3,0,0
"Argentina","2024-06-11",0,0,1,0,0,3,0,0
"Argentina","2024-06-12",0,0,1,0,0,3,0,0
"Argentina","2024-06-13",0,0,1,0,0,3,0,0
"Argentina","2024-06-14",0,0,1,0,0,3,0,0
"Argentina","2024-06-15",0,0,1,0,0,3,0,0
"Argentina","2024-06-16",0,0,1,0,0,3,0,0
"Argentina","2024-06-17",0,0,1,0,0,3,0,0
"Argentina","2024-06-18",0,0,1,0,0,3,0,0
"Argentina","2024-06-19",0,0,1,0,0,3,0,0
"Argentina","2024-06-20",0,0,1,0,0,3,0,0
"Argentina","2024-06-21",0,0,1,0,0,3,0,0
"Argentina","2024-06-22",0,0,1,0,0,3,0,0
"Argentina","2024-06-23",0,0,1,0,0,3,0,0
"Argentina","2024-06-24",0,0,1,0,0,3,0,0
"Argentina","2024-06-25",0,0,1,0,0,3,0,0
"Argentina","2024-06-26",0,0,1,0,0,3,0,0
"Argentina","2024-06-27",0,0,1,0,0,3,0,0
"Argentina","2024-06-28",0,0,1,0,0,3,0,0
"Argentina","2024-06-29",0,0,1,0,0,3,0,0
"Argentina","2024-06-30",0,0,1,0,0,3,0,0
"Argentina","2024-07-01",0,0,1,0,0,3,0,0
"Argentina","2024-07-02",0,2,3,0,0,3,0,0
"Argentina","2024-07-03",0,0,3,0,0,3,0,0
"Argentina","2024-07-04",0,0,3,0,0,3,0,0
"Argentina","2024-07-05",0,0,3,0,0,3,0,0
"Argentina","2024-07-06",0,0,3,0,0,3,0,0
"Argentina","2024-07-07",0,0,3,0,0,3,0,0
"Argentina","2024-07-08",0,0,3,0,0,3,0,0
"Argentina","2024-07-09",0,0,3,0,0,3,0,0
"Argentina","2024-07-10",0,0,3,0,0,3,0,0
"Argentina","2024-07-11",0,0,3,0,0,3,0,0
"Argentina","2024-07-12",0,0,3,0,0,3,0,0
"Argentina","2024-07-13",0,0,3,0,1,4,0,0
"Argentina","2024-07-14",0,0,3,0,0,4,0,0
"Argentina","2024-07-15",0,0,3,0,0,4,0,0
"Argentina","2024-07-16",0,0,3,0,0,4,0,0
"Argentina","2024-07-17",0,0,3,0,0,4,0,0
"Argentina","2024-07-18",0,0,3,0,0,4,0,0
"Argentina","2024-07-19",0,0,3,0,0,4,0,0
"Argentina","2024-07-20",0,0,3,0,0,4,0,0
"Argentina","2024-07-21",0,0,3,0,0,4,0,0
"Argentina","2024-07-22",0,0,3,0,0,4,0,0
"Argentina","2024-07-23",0,1,4,0,0,4,0,0
"Argentina","2024-07-24",0,0,4,0,0,4,0,0
"Argentina","2024-07-25",0,0,4,0,1,5,0,0
"Argentina","2024-07-26",0,0,4,0,0,5,0,0
"Argentina","2024-07-27",0,0,4,0,0,5,0,0
"Argentina","2024-07-28",0,0,4,0,0,5,0,0
"Argentina","2024-07-29",0,0,4,0,1,6,0,0
"Argentina","2024-07-30",0,2,6,0,0,6,0,0
"Argentina","2024-07-31",0,0,6,0,0,6,0,0
"Argentina","2024-08-01",0,0,6,0,1,7,0,0
"Argentina","2024-08-02",0,0,6,0,0,7,0,0
"Argentina","2024-08-03",0,0,6,0,1,8,0,0
"Argentina","2024-08-04",0,0,6,0,0,8,0,0
"Argentina","2024-08-05",0,0,6,0,1,9,0,0
"Argentina","2024-08-06",0,3,9,0,0,9,0,0
"Argentina","2024-08-07",0,0,9,0,1,10,0,0
"Argentina","2024-08-08",0,0,9,0,0,10,0,0
"Argentina","2024-08-09",0,0,9,0,1,11,0,0
"Argentina","2024-08-10",0,0,9,0,0,11,0,0
"Argentina","2024-08-11",0,0,9,0,1,12,0,0
"Argentina","2024-08-12",0,0,9,0,0,12,0,0
"Argentina","2024-08-13",0,4,13,0,1,13,0,0
"Argentina","2024-08-14",0,0,13,0,2,15,0,0
"Argentina","2024-08-15",0,0,13,0,1,16,0,0
"Argentina","2024-08-16",0,0,13,0,2,18,0,0
"Argentina","2024-08-17",0,0,13,0,2,20,0,0
"Argentina","2024-08-18",0,0,13,0,2,22,0,0
"Argentina","2024-08-19",0,0,13,0,1,23,0,0
"Argentina","2024-08-20",0,12,25,0,2,25,0,0
"Argentina","2024-08-21",0,0,25,0,1,26,0,0
"Argentina","2024-08-22",0,0,25,0,1,27,0,0
"Argentina","2024-08-23",0,0,25,0,1,28,0,0
"Argentina","2024-08-24",0,0,25,0,1,29,0,0
"Argentina","2024-08-25",0,0,25,0,1,30,0,0
"Argentina","2024-08-26",0,0,25,0,1,31,0,0
"Argentina","2024-08-27",0,7,32,0,1,32,0,0
"Argentina","2024-08-28",0,0,32,0,2,34,0,0
"Argentina","2024-08-29",0,0,32,0,2,36,0,0
"Argentina","2024-08-30",0,0,32,0,2,38,0,0
"Argentina","2024-08-31",0,0,32,0,1,39,0,0
"Argentina","2024-09-01",0,0,32,0,2,41,0,0
"Argentina","2024-09-02",0,0,32,0,2,43,0,0
"Argentina","2024-09-03",0,13,45,0,2,45,0,0
"Argentina","2024-09-04",0,0,45,0,1,46,0,0
"Argentina","2024-09-05",0,0,45,0,2,48,0,0
"Argentina","2024-09-06",0,0,45,0,1,49,0,0
"Argentina","2024-09-07",0,0,45,0,1,50,0,0
"Argentina","2024-09-08",0,0,45,0,1,51,0,0
"Argentina","2024-09-09",0,0,45,0,2,53,0,0
"Argentina","2024-09-10",0,9,54,0,1,54,0,0
"Argentina","2024-09-11",0,0,54,0,2,56,0,0
"Argentina","2024-09-12",0,0,54,0,2,58,0,0
"Argentina","2024-09-13",0,0,54,0,2,60,0,0
"Argentina","2024-09-14",0,0,54,0,1,61,0,0
"Argentina","2024-09-15",0,0,54,0,2,63,0,0
"Argentina","2024-09-16",0,0,54,0,2,65,0,0
"Argentina","2024-09-17",0,13,67,0,2,67,0,0
"Argentina","2024-09-18",0,0,67,0,1,68,0,0
"Argentina","2024-09-19",0,0,67,0,0,68,0,0
"Argentina","2024-09-20",0,0,67,0,1,69,0,0
"Argentina","2024-09-21",0,0,67,0,1,70,0,0
"Argentina","2024-09-22",0,0,67,0,1,71,0,0
"Argentina","2024-09-23",0,0,67,0,0,71,0,0
"Argentina","2024-09-24",0,5,72,0,1,72,0,0
"Argentina","2024-09-25",0,0,72,0,1,73,0,0
"Argentina","2024-09-26",0,0,72,0,1,74,0,0
"Argentina","2024-09-27",0,0,72,0,1,75,0,0
"Argentina","2024-09-28",0,0,72,0,1,76,0,0
"Argentina","2024-09-29",0,0,72,0,1,77,0,0
"Argentina","2024-09-30",0,0,72,0,1,78,0,0
"Argentina","2024-10-01",0,7,79,0,1,79,0,0
"Argentina","2024-10-02",0,0,79,0,0,79,0,0
"Argentina","2024-10-03",0,0,79,0,1,80,0,0
"Argentina","2024-10-04",0,0,79,0,0,80,0,0
"Argentina","2024-10-05",0,0,79,0,1,81,0,0
"Argentina","2024-10-06",0,0,79,0,0,81,0,0
"Argentina","2024-10-07",0,0,79,0,1,82,0,0
"Argentina","2024-10-08",0,3,82,0,0,82,0,0
"Argentina","2024-10-09",0,0,82,0,0,82,0,0
"Argentina","2024-10-10",0,0,82,0,1,83,0,0
"Argentina","2024-10-11",0,0,82,0,0,83,0,0
"Argentina","2024-10-12",0,0,82,0,0,83,0,0
"Argentina","2024-10-13",0,0,82,0,0,83,0,0
"Argentina","2024-10-14",0,0,82,0,1,84,0,0
"Argentina","2024-10-15",0,2,84,0,0,84,0,0
"Argentina","2024-10-16",0,0,84,0,0,84,0,0
"Argentina","2024-10-17",0,0,84,0,0,84,0,0
"Argentina","2024-10-18",0,0,84,0,0,84,0,0
"Argentina","2024-10-19",0,0,84,0,1,85,0,0
"Argentina","2024-10-20",0,0,84,0,0,85,0,0
"Argentina","2024-10-21",0,0,84,0,0,85,0,0
"Argentina","2024-10-22",0,1,85,0,0,85,0,0
"Argentina","2024-10-23",0,0,85,0,0,85,0,0
"Argentina","2024-10-24",0,0,85,0,1,86,0,0
"Argentina","2024-10-25",0,0,85,0,0,86,0,0
"Argentina","2024-10-26",0,0,85,0,0,86,0,0
"Argentina","2024-10-27",0,0,85,0,0,86,0,0
"Argentina","2024-10-28",0,0,85,0,1,87,0,0
"Argentina","2024-10-29",0,2,87,0,0,87,0,0
"Argentina","2024-10-30",0,0,87,0,0,87,0,0
"Argentina","2024-10-31",0,0,87,0,1,88,0,0
"Argentina","2024-11-01",0,0,87,0,0,88,0,0
"Argentina","2024-11-02",0,0,87,0,0,88,0,0
"Argentina","2024-11-03",0,0,87,0,0,88,0,0
"Argentina","2024-11-04",0,0,87,0,1,89,0,0
"Argentina","2024-11-05",0,2,89,0,0,89,0,0
"Argentina","2024-11-06",0,0,89,0,1,90,0,0
"Argentina","2024-11-07",0,0,89,0,1,91,0,0
"Argentina","2024-11-08",0,0,89,0,1,92,0,0
"Argentina","2024-11-09",0,0,89,0,2,94,0,0
"Argentina","2024-11-10",0,0,89,0,1,95,0,0
"Argentina","2024-11-11",0,0,89,0,1,96,0,0
"Argentina","2024-11-12",0,8,97,0,1,97,0,0
"Argentina","2024-11-13",0,0,97,0,0,97,0,0
"Argentina","2024-11-14",0,0,97,0,1,98,0,0
"Argentina","2024-11-15",0,0,97,0,0,98,0,0
"Argentina","2024-11-16",0,0,97,0,1,99,0,0
"Argentina","2024-11-17",0,0,97,0,0,99,0,0
"Argentina","2024-11-18",0,0,97,0,1,100,0,0
"Argentina","2024-11-19",0,3,100,0,0,100,0,0
"Argentina","2024-11-20",0,0,100,0,0,100,0,0
"Argentina","2024-11-21",0,0,100,0,1,101,0,0
"Argentina","2024-11-22",0,0,100,0,0,101,0,0
"Argentina","2024-11-23",0,0,100,0,0,101,0,0
"Argentina","2024-11-24",0,0,100,0,0,101,0,0
"Argentina","2024-11-25",0,0,100,0,1,102,0,0
"Argentina","2024-11-26",0,2,102,0,0,102,0,0
"Argentina","2024-11-27",0,0,102,0,0,102,0,0
"Argentina","2024-11-28",0,0,102,0,0,102,0,0
"Argentina","2024-11-29",0,0,102,0,0,102,0,0
"Argentina","2024-11-30",0,0,102,0,0,102,0,0
"Argentina","2024-12-01",0,0,102,0,0,102,0,0
"Argentina","2024-12-02",0,0,102,0,0,102,0,0
"Argentina","2024-12-03",0,0,102,0,0,102,0,0
"Argentina","2024-12-04",0,0,102,0,1,103,0,0
"Argentina","2024-12-05",0,0,102,0,0,103,0,0
"Argentina","2024-12-06",0,0,102,0,0,103,0,0
"Argentina","2024-12-07",0,0,102,0,0,103,0,0
"Argentina","2024-12-08",0,0,102,0,0,103,0,0
"Argentina","2024-12-09",0,0,102,0,0,103,0,0
"Argentina","2024-12-10",0,1,103,0,0,103,0,0
"Argentina","2024-12-11",0,0,103,0,0,103,0,0
"Argentina","2024-12-12",0,0,103,0,1,104,0,0
"Argentina","2024-12-13",0,0,103,0,0,104,0,0
"Argentina","2024-12-14",0,0,103,0,0,104,0,0
"Argentina","2024-12-15",0,0,103,0,0,104,0,0
"Argentina","2024-12-16",0,0,103,0,1,105,0,0
"Argentina","2024-12-17",0,2,105,0,0,105,0,0
"Argentina","2024-12-18",0,0,105,0,0,105,0,0
"Argentina","2024-12-19",0,0,105,0,0,105,0,0
"Argentina","2024-12-20",0,0,105,0,0,105,0,0
"Argentina","2024-12-21",0,0,105,0,1,106,0,0
"Argentina","2024-12-22",0,0,105,0,0,106,0,0
"Argentina","2024-12-23",0,0,105,0,0,106,0,0
"Argentina","2024-12-24",0,1,106,0,0,106,0,0
"Argentina","2024-12-25",0,0,106,0,0,106,0,0
"Argentina","2024-12-26",0,0,106,0,0,106,0,0
"Argentina","2024-12-27",0,0,106,0,0,106,0,0
"Argentina","2024-12-28",0,0,106,0,0,106,0,0
"Argentina","2024-12-29",0,0,106,0,0,106,0,0
"Argentina","2024-12-30",0,0,106,0,0,106,0,0
"Argentina","2024-12-31",0,0,106,0,0,106,0,0
"Argentina","2025-01-01",0,0,106,0,0,106,0,0
"Argentina","2025-01-02",0,0,106,0,0,106,0,0
"Argentina","2025-01-03",0,0,106,0,0,106,0,0
"Argentina","2025-01-04",0,0,106,0,0,106,0,0
"Argentina","2025-01-05",0,0,106,0,0,106,0,0
"Argentina","2025-01-06",0,0,106,0,0,106,0,0
"Argentina","2025-01-07",0,0,106,0,0,106,0,0
"Argentina","2025-01-08",0,0,106,0,0,106,0,0
"Argentina","2025-01-09",0,0,106,0,0,106,0,0
"Argentina","2025-01-10",0,0,106,0,0,106,0,0
"Argentina","2025-01-11",0,0,106,0,0,106,0,0
"Argentina","2025-01-12",0,0,106,0,0,106,0,0
"Argentina","2025-01-13",0,0,106,0,0,106,0,0
"Argentina","2025-01-14",0,0,106,0,0,106,0,0
"Argentina","2025-01-15",0,0,106,0,0,106,0,0
"Argentina","2025-01-16",0,0,106,0,0,106,0,0
"Argentina","2025-01-17",0,0,106,0,0,106,0,0
"Argentina","2025-01-18",0,0,106,0,0,106,0,0
"Argentina","2025-01-19",0,0,106,0,0,106,0,0
"Argentina","2025-01-20",0,0,106,0,0,106,0,0
"Argentina","2025-01-21",0,0,106,0,0,106,0,0
"Argentina","2025-01-22",0,0,106,0,0,106,0,0
"Argentina","2025-01-23",0,0,106,0,0,106,0,0
"Argentina","2025-01-24",0,0,106,0,0,106,0,0
"Argentina","2025-01-25",0,0,106,0,0,106,0,0
"Argentina","2025-01-26",0,0,106,0,0,106,0,0
"Argentina","2025-01-27",0,0,106,0,0,106,0,0
"Argentina","2025-01-28",0,0,106,0,0,106,0,0
"Argentina","2025-01-29",0,0,106,0,0,106,0,0
"Argentina","2025-01-30",0,0,106,0,0,106,0,0
"Argentina","2025-01-31",0,0,106,0,0,106,0,0
"Argentina","2025-02-01",0,0,106,0,0,106,0,0
"Argentina","2025-02-02",0,0,106,0,0,106,0,0
"Argentina","2025-02-03",0,0,106,0,0,106,0,0
"Aruba","2024-01-01",0,0,0,0,0,0,0,0
"Aruba","2024-01-02",0,0,0,0,0,0,0,0
"Aruba","2024-01-03",0,0,0,0,0,0,0,0
"Aruba","2024-01-04",0,0,0,0,0,0,0,0
"Aruba","2024-01-05",0,0,0,0,0,0,0,0
"Aruba","2024-01-06",0,0,0,0,0,0,0,0
"Aruba","2024-01-07",0,0,0,0,0,0,0,0
"Aruba","2024-01-08",0,0,0,0,0,0,0,0
"Aruba","2024-01-09",0,0,0,0,0,0,0,0
"Aruba","2024-01-10",0,0,0,0,0,0,0,0
"Aruba","2024-01-11",0,0,0,0,0,0,0,0
"Aruba","2024-01-12",0,0,0,0,0,0,0,0
"Aruba","2024-01-13",0,0,0,0,0,0,0,0
"Aruba","2024-01-14",0,0,0,0,0,0,0,0
"Aruba","2024-01-15",0,0,0,0,0,0,0,0
"Aruba","2024-01-16",0,0,0,0,0,0,0,0
"Aruba","2024-01-17",0,0,0,0,0,0,0,0
"Aruba","2024-01-18",0,0,0,0,0,0,0,0
"Aruba","2024-01-19",0,0,0,0,0,0,0,0
"Aruba","2024-01-20",0,0,0,0,0,0,0,0
"Aruba","2024-01-21",0,0,0,0,0,0,0,0
"Aruba","2024-01-22",0,0,0,0,0,0,0,0
"Aruba","2024-01-23",0,0,0,0,0,0,0,0
"Aruba","2024-01-24",0,0,0,0,0,0,0,0
"Aruba","2024-01-25",0,0,0,0,0,0,0,0
"Aruba","2024-01-26",0,0,0,0,0,0,0,0
"Aruba","2024-01-27",0,0,0,0,0,0,0,0
"Aruba","2024-01-28",0,0,0,0,0,0,0,0
"Aruba","2024-01-29",0,0,0,0,0,0,0,0
"Aruba","2024-01-30",0,0,0,0,0,0,0,0
"Aruba","2024-01-31",0,0,0,0,0,0,0,0
"Aruba","2024-02-01",0,0,0,0,0,0,0,0
"Aruba","2024-02-02",0,0,0,0,0,0,0,0
"Aruba","2024-02-03",0,0,0,0,0,0,0,0
"Aruba","2024-02-04",0,0,0,0,0,0,0,0
"Aruba","2024-02-05",0,0,0,0,0,0,0,0
"Aruba","2024-02-06",0,0,0,0,0,0,0,0
"Aruba","2024-02-07",0,0,0,0,0,0,0,0
"Aruba","2024-02-08",0,0,0,0,0,0,0,0
"Aruba","2024-02-09",0,0,0,0,0,0,0,0
"Aruba","2024-02-10",0,0,0,0,0,0,0,0
"Aruba","2024-02-11",0,0,0,0,0,0,0,0
"Aruba","2024-02-12",0,0,0,0,0,0,0,0
"Aruba","2024-02-13",0,0,0,0,0,0,0,0
"Aruba","2024-02-14",0,0,0,0,0,0,0,0
"Aruba","2024-02-15",0,0,0,0,0,0,0,0
"Aruba","2024-02-16",0,0,0,0,0,0,0,0
"Aruba","2024-02-17",0,0,0,0,0,0,0,0
"Aruba","2024-02-18",0,0,0,0,0,0,0,0
"Aruba","2024-02-19",0,0,0,0,0,0,0,0
"Aruba","2024-02-20",0,0,0,0,0,0,0,0
"Aruba","2024-02-21",0,0,0,0,0,0,0,0
"Aruba","2024-02-22",0,0,0,0,0,0,0,0
"Aruba","2024-02-23",0,0,0,0,0,0,0,0
"Aruba","2024-02-24",0,0,0,0,0,0,0,0
"Aruba","2024-02-25",0,0,0,0,0,0,0,0
"Aruba","2024-02-26",0,0,0,0,0,0,0,0
"Aruba","2024-02-27",0,0,0,0,0,0,0,0
"Aruba","2024-02-28",0,0,0,0,0,0,0,0
"Aruba","2024-02-29",0,0,0,0,0,0,0,0
"Aruba","2024-03-01",0,0,0,0,0,0,0,0
"Aruba","2024-03-02",0,0,0,0,0,0,0,0
"Aruba","2024-03-03",0,0,0,0,0,0,0,0
"Aruba","2024-03-04",0,0,0,0,0,0,0,0
"Aruba","2024-03-05",0,0,0,0,0,0,0,0
"Aruba","2024-03-06",0,0,0,0,0,0,0,0
"Aruba","2024-03-07",0,0,0,0,0,0,0,0
"Aruba","2024-03-08",0,0,0,0,0,0,0,0
"Aruba","2024-03-09",0,0,0,0,0,0,0,0
"Aruba","2024-03-10",0,0,0,0,0,0,0,0
"Aruba","2024-03-11",0,0,0,0,0,0,0,0
"Aruba","2024-03-12",0,0,0,0,0,0,0,0
"Aruba","2024-03-13",0,0,0,0,0,0,0,0
"Aruba","2024-03-14",0,0,0,0,0,0,0,0
"Aruba","2024-03-15",0,0,0,0,0,0,0,0
"Aruba","2024-03-16",0,0,0,0,0,0,0,0
"Aruba","2024-03-17",0,0,0,0,0,0,0,0
"Aruba","2024-03-18",0,0,0,0,0,0,0,0
"Aruba","2024-03-19",0,0,0,0,0,0,0,0
"Aruba","2024-03-20",0,0,0,0,0,0,0,0
"Aruba","2024-03-21",0,0,0,0,0,0,0,0
"Aruba","2024-03-22",0,0,0,0,0,0,0,0
"Aruba","2024-03-23",0,0,0,0,0,0,0,0
"Aruba","2024-03-24",0,0,0,0,0,0,0,0
"Aruba","2024-03-25",0,0,0,0,0,0,0,0
"Aruba","2024-03-26",0,0,0,0,0,0,0,0
"Aruba","2024-03-27",0,0,0,0,0,0,0,0
"Aruba","2024-03-28",0,0,0,0,0,0,0,0
"Aruba","2024-03-29",0,0,0,0,0,0,0,0
"Aruba","2024-03-30",0,0,0,0,0,0,0,0
"Aruba","2024-03-31",0,0,0,0,0,0,0,0
"Aruba","2024-04-01",0,0,0,0,0,0,0,0
"Aruba","2024-04-02",0,0,0,0,0,0,0,0
"Aruba","2024-04-03",0,0,0,0,0,0,0,0
"Aruba","2024-04-04",0,0,0,0,0,0,0,0
"Aruba","2024-04-05",0,0,0,0,0,0,0,0
"Aruba","2024-04-06",0,0,0,0,0,0,0,0
"Aruba","2024-04-07",0,0,0,0,0,0,0,0
"Aruba","2024-04-08",0,0,0,0,0,0,0,0
"Aruba","2024-04-09",0,0,0,0,0,0,0,0
"Aruba","2024-04-10",0,0,0,0,0,0,0,0
"Aruba","2024-04-11",0,0,0,0,0,0,0,0
"Aruba","2024-04-12",0,0,0,0,0,0,0,0
"Aruba","2024-04-13",0,0,0,0,0,0,0,0
"Aruba","2024-04-14",0,0,0,0,0,0,0,0
"Aruba","2024-04-15",0,0,0,0,0,0,0,0
"Aruba","2024-04-16",0,0,0,0,0,0,0,0
"Aruba","2024-04-17",0,0,0,0,0,0,0,0
"Aruba","2024-04-18",0,0,0,0,0,0,0,0
"Aruba","2024-04-19",0,0,0,0,0,0,0,0
"Aruba","2024-04-20",0,0,0,0,0,0,0,0
"Aruba","2024-04-21",0,0,0,0,0,0,0,0
"Aruba","2024-04-22",0,0,0,0,0,0,0,0
"Aruba","2024-04-23",0,0,0,0,0,0,0,0
"Aruba","2024-04-24",0,0,0,0,0,0,0,0
"Aruba","2024-04-25",0,0,0,0,0,0,0,0
"Aruba","2024-04-26",0,0,0,0,0,0,0,0
"Aruba","2024-04-27",0,0,0,0,0,0,0,0
"Aruba","2024-04-28",0,0,0,0,0,0,0,0
"Aruba","2024-04-29",0,0,0,0,0,0,0,0
"Aruba","2024-04-30",0,0,0,0,0,0,0,0
"Aruba","2024-05-01",0,0,0,0,0,0,0,0
"Aruba","2024-05-02",0,0,0,0,0,0,0,0
"Aruba","2024-05-03",0,0,0,0,0,0,0,0
"Aruba","2024-05-04",0,0,0,0,0,0,0,0
"Aruba","2024-05-05",0,0,0,0,0,0,0,0
"Aruba","2024-05-06",0,0,0,0,0,0,0,0
"Aruba","2024-05-07",0,0,0,0,0,0,0,0
"Aruba","2024-05-08",0,0,0,0,0,0,0,0
"Aruba","2024-05-09",0,0,0,0,0,0,0,0
"Aruba","2024-05-10",0,0,0,0,0,0,0,0
"Aruba","2024-05-11",0,0,0,0,0,0,0,0
"Aruba","2024-05-12",0,0,0,0,0,0,0,0
"Aruba","2024-05-13",0,0,0,0,0,0,0,0
"Aruba","2024-05-14",0,0,0,0,0,0,0,0
"Aruba","2024-05-15",0,0,0,0,0,0,0,0
"Aruba","2024-05-16",0,0,0,0,0,0,0,0
"Aruba","2024-05-17",0,0,0,0,0,0,0,0
"Aruba","2024-05-18",0,0,0,0,0,0,0,0
"Aruba","2024-05-19",0,0,0,0,0,0,0,0
"Aruba","2024-05-20",0,0,0,0,0,0,0,0
"Aruba","2024-05-21",0,0,0,0,0,0,0,0
"Aruba","2024-05-22",0,0,0,0,0,0,0,0
"Aruba","2024-05-23",0,0,0,0,0,0,0,0
"Aruba","2024-05-24",0,0,0,0,0,0,0,0
"Aruba","2024-05-25",0,0,0,0,0,0,0,0
"Aruba","2024-05-26",0,0,0,0,0,0,0,0
"Aruba","2024-05-27",0,0,0,0,0,0,0,0
"Aruba","2024-05-28",0,0,0,0,0,0,0,0
"Aruba","2024-05-29",0,0,0,0,0,0,0,0
"Aruba","2024-05-30",0,0,0,0,0,0,0,0
"Aruba","2024-05-31",0,0,0,0,0,0,0,0
"Aruba","2024-06-01",0,0,0,0,0,0,0,0
"Aruba","2024-06-02",0,0,0,0,0,0,0,0
"Aruba","2024-06-03",0,0,0,0,0,0,0,0
"Aruba","2024-06-04",0,0,0,0,0,0,0,0
"Aruba","2024-06-05",0,0,0,0,0,0,0,0
"Aruba","2024-06-06",0,0,0,0,0,0,0,0
"Aruba","2024-06-07",0,0,0,0,0,0,0,0
"Aruba","2024-06-08",0,0,0,0,0,0,0,0
"Aruba","2024-06-09",0,0,0,0,0,0,0,0
"Aruba","2024-06-10",0,0,0,0,0,0,0,0
"Aruba","2024-06-11",0,0,0,0,0,0,0,0
"Aruba","2024-06-12",0,0,0,0,0,0,0,0
"Aruba","2024-06-13",0,0,0,0,0,0,0,0
"Aruba","2024-06-14",0,0,0,0,0,0,0,0
"Aruba","2024-06-15",0,0,0,0,0,0,0,0
"Aruba","2024-06-16",0,0,0,0,0,0,0,0
"Aruba","2024-06-17",0,0,0,0,0,0,0,0
"Aruba","2024-06-18",0,0,0,0,0,0,0,0
"Aruba","2024-06-19",0,0,0,0,0,0,0,0
"Aruba","2024-06-20",0,0,0,0,0,0,0,0
"Aruba","2024-06-21",0,0,0,0,0,0,0,0
"Aruba","2024-06-22",0,0,0,0,0,0,0,0
"Aruba","2024-06-23",0,0,0,0,0,0,0,0
"Aruba","2024-06-24",0,0,0,0,0,0,0,0
"Aruba","2024-06-25",0,0,0,0,0,0,0,0
"Aruba","2024-06-26",0,0,0,0,0,0,0,0
"Aruba","2024-06-27",0,0,0,0,0,0,0,0
"Aruba","2024-06-28",0,0,0,0,0,0,0,0
"Aruba","2024-06-29",0,0,0,0,0,0,0,0
"Aruba","2024-06-30",0,0,0,0,0,0,0,0
"Aruba","2024-07-01",0,0,0,0,0,0,0,0
"Aruba","2024-07-02",0,0,0,0,0,0,0,0
"Aruba","2024-07-03",0,0,0,0,0,0,0,0
"Aruba","2024-07-04",0,0,0,0,0,0,0,0
"Aruba","2024-07-05",0,0,0,0,0,0,0,0
"Aruba","2024-07-06",0,0,0,0,0,0,0,0
"Aruba","2024-07-07",0,0,0,0,0,0,0,0
"Aruba","2024-07-08",0,0,0,0,0,0,0,0
"Aruba","2024-07-09",0,0,0,0,0,0,0,0
"Aruba","2024-07-10",0,0,0,0,0,0,0,0
"Aruba","2024-07-11",0,0,0,0,0,0,0,0
"Aruba","2024-07-12",0,0,0,0,0,0,0,0
"Aruba","2024-07-13",0,0,0,0,0,0,0,0
"Aruba","2024-07-14",0,0,0,0,0,0,0,0
"Aruba","2024-07-15",0,0,0,0,0,0,0,0
"Aruba","2024-07-16",0,0,0,0,0,0,0,0
"Aruba","2024-07-17",0,0,0,0,0,0,0,0
"Aruba","2024-07-18",0,0,0,0,0,0,0,0
"Aruba","2024-07-19",0,0,0,0,0,0,0,0
"Aruba","2024-07-20",0,0,0,0,0,0,0,0
"Aruba","2024-07-21",0,0,0,0,0,0,0,0
"Aruba","2024-07-22",0,0,0,0,0,0,0,0
"Aruba","2024-07-23",0,0,0,0,0,0,0,0
"Aruba","2024-07-24",0,0,0,0,0,0,0,0
"Aruba","2024-07-25",0,0,0,0,0,0,0,0
"Aruba","2024-07-26",0,0,0,0,0,0,0,0
"Aruba","2024-07-27",0,0,0,0,0,0,0,0
"Aruba","2024-07-28",0,0,0,0,0,0,0,0
"Aruba","2024-07-29",0,0,0,0,0,0,0,0
"Aruba","2024-07-30",0,0,0,0,0,0,0,0
"Aruba","2024-07-31",0,0,0,0,0,0,0,0
"Aruba","2024-08-01",0,0,0,0,0,0,0,0
"Aruba","2024-08-02",0,0,0,0,0,0,0,0
"Aruba","2024-08-03",0,0,0,0,0,0,0,0
"Aruba","2024-08-04",0,0,0,0,0,0,0,0
"Aruba","2024-08-05",0,0,0,0,0,0,0,0
"Aruba","2024-08-06",0,0,0,0,0,0,0,0
"Aruba","2024-08-07",0,0,0,0,0,0,0,0
"Aruba","2024-08-08",0,0,0,0,0,0,0,0
"Aruba","2024-08-09",0,0,0,0,0,0,0,0
"Aruba","2024-08-10",0,0,0,0,0,0,0,0
"Aruba","2024-08-11",0,0,0,0,0,0,0,0
"Aruba","2024-08-12",0,0,0,0,0,0,0,0
"Aruba","2024-08-13",0,0,0,0,0,0,0,0
"Aruba","2024-08-14",0,0,0,0,0,0,0,0
"Aruba","2024-08-15",0,0,0,0,0,0,0,0
"Aruba","2024-08-16",0,0,0,0,0,0,0,0
"Aruba","2024-08-17",0,0,0,0,0,0,0,0
"Aruba","2024-08-18",0,0,0,0,0,0,0,0
"Aruba","2024-08-19",0,0,0,0,0,0,0,0
"Aruba","2024-08-20",0,0,0,0,0,0,0,0
"Aruba","2024-08-21",0,0,0,0,0,0,0,0
"Aruba","2024-08-22",0,0,0,0,0,0,0,0
"Aruba","2024-08-23",0,0,0,0,0,0,0,0
"Aruba","2024-08-24",0,0,0,0,0,0,0,0
"Aruba","2024-08-25",0,0,0,0,0,0,0,0
"Aruba","2024-08-26",0,0,0,0,0,0,0,0
"Aruba","2024-08-27",0,0,0,0,0,0,0,0
"Aruba","2024-08-28",0,0,0,0,0,0,0,0
"Aruba","2024-08-29",0,0,0,0,0,0,0,0
"Aruba","2024-08-30",0,0,0,0,0,0,0,0
"Aruba","2024-08-31",0,0,0,0,0,0,0,0
"Aruba","2024-09-01",0,0,0,0,0,0,0,0
"Aruba","2024-09-02",0,0,0,0,0,0,0,0
"Aruba","2024-09-03",0,0,0,0,0,0,0,0
"Aruba","2024-09-04",0,0,0,0,0,0,0,0
"Aruba","2024-09-05",0,0,0,0,0,0,0,0
"Aruba","2024-09-06",0,0,0,0,0,0,0,0
"Aruba","2024-09-07",0,0,0,0,0,0,0,0
"Aruba","2024-09-08",0,0,0,0,0,0,0,0
"Aruba","2024-09-09",0,0,0,0,0,0,0,0
"Aruba","2024-09-10",0,0,0,0,0,0,0,0
"Aruba","2024-09-11",0,0,0,0,0,0,0,0
"Aruba","2024-09-12",0,0,0,0,0,0,0,0
"Aruba","2024-09-13",0,0,0,0,0,0,0,0
"Aruba","2024-09-14",0,0,0,0,0,0,0,0
"Aruba","2024-09-15",0,0,0,0,0,0,0,0
"Aruba","2024-09-16",0,0,0,0,0,0,0,0
"Aruba","2024-09-17",0,0,0,0,0,0,0,0
"Aruba","2024-09-18",0,0,0,0,0,0,0,0
"Aruba","2024-09-19",0,0,0,0,0,0,0,0
"Aruba","2024-09-20",0,0,0,0,0,0,0,0
"Aruba","2024-09-21",0,0,0,0,0,0,0,0
"Aruba","2024-09-22",0,0,0,0,0,0,0,0
"Aruba","2024-09-23",0,0,0,0,0,0,0,0
"Aruba","2024-09-24",0,0,0,0,0,0,0,0
"Aruba","2024-09-25",0,0,0,0,0,0,0,0
"Aruba","2024-09-26",0,0,0,0,0,0,0,0
"Aruba","2024-09-27",0,0,0,0,0,0,0,0
"Aruba","2024-09-28",0,0,0,0,0,0,0,0
"Aruba","2024-09-29",0,0,0,0,0,0,0,0
"Aruba","2024-09-30",0,0,0,0,0,0,0,0
"Aruba","2024-10-01",0,0,0,0,0,0,0,0
"Aruba","2024-10-02",0,0,0,0,0,0,0,0
"Aruba","2024-10-03",0,0,0,0,0,0,0,0
"Aruba","2024-10-04",0,0,0,0,0,0,0,0
"Aruba","2024-10-05",0,0,0,0,0,0,0,0
"Aruba","2024-10-06",0,0,0,0,0,0,0,0
"Aruba","2024-10-07",0,0,0,0,0,0,0,0
"Aruba","2024-10-08",0,0,0,0,0,0,0,0
"Aruba","2024-10-09",0,0,0,0,0,0,0,0
"Aruba","2024-10-10",0,0,0,0,0,0,0,0
"Aruba","2024-10-11",0,0,0,0,0,0,0,0
"Aruba","2024-10-12",0,0,0,0,0,0,0,0
"Aruba","2024-10-13",0,0,0,0,0,0,0,0
"Aruba","2024-10-14",0,0,0,0,0,0,0,0
"Aruba","2024-10-15",0,0,0,0,0,0,0,0
"Aruba","2024-10-16",0,0,0,0,0,0,0,0
"Aruba","2024-10-17",0,0,0,0,0,0,0,0
"Aruba","2024-10-18",0,0,0,0,0,0,0,0
"Aruba","2024-10-19",0,0,0,0,0,0,0,0
"Aruba","2024-10-20",0,0,0,0,0,0,0,0
"Aruba","2024-10-21",0,0,0,0,0,0,0,0
"Aruba","2024-10-22",0,0,0,0,0,0,0,0
"Aruba","2024-10-23",0,0,0,0,0,0,0,0
"Aruba","2024-10-24",0,0,0,0,0,0,0,0
"Aruba","2024-10-25",0,0,0,0,0,0,0,0
"Aruba","2024-10-26",0,0,0,0,0,0,0,0
"Aruba","2024-10-27",0,0,0,0,0,0,0,0
"Aruba","2024-10-28",0,0,0,0,0,0,0,0
"Aruba","2024-10-29",0,0,0,0,0,0,0,0
"Aruba","2024-10-30",0,0,0,0,0,0,0,0
"Aruba","2024-10-31",0,0,0,0,0,0,0,0
"Aruba","2024-11-01",0,0,0,0,0,0,0,0
"Aruba","2024-11-02",0,0,0,0,0,0,0,0
"Aruba","2024-11-03",0,0,0,0,0,0,0,0
"Aruba","2024-11-04",0,0,0,0,0,0,0,0
"Aruba","2024-11-05",0,0,0,0,0,0,0,0
"Aruba","2024-11-06",0,0,0,0,0,0,0,0
"Aruba","2024-11-07",0,0,0,0,0,0,0,0
"Aruba","2024-11-08",0,0,0,0,0,0,0,0
"Aruba","2024-11-09",0,0,0,0,0,0,0,0
"Aruba","2024-11-10",0,0,0,0,0,0,0,0
"Aruba","2024-11-11",0,0,0,0,0,0,0,0
"Aruba","2024-11-12",0,0,0,0,0,0,0,0
"Aruba","2024-11-13",0,0,0,0,0,0,0,0
"Aruba","2024-11-14",0,0,0,0,0,0,0,0
"Aruba","2024-11-15",0,0,0,0,0,0,0,0
"Aruba","2024-11-16",0,0,0,0,0,0,0,0
"Aruba","2024-11-17",0,0,0,0,0,0,0,0
"Aruba","2024-11-18",0,0,0,0,0,0,0,0
"Aruba","2024-11-19",0,0,0,0,0,0,0,0
"Aruba","2024-11-20",0,0,0,0,0,0,0,0
"Aruba","2024-11-21",0,0,0,0,0,0,0,0
"Aruba","2024-11-22",0,0,0,0,0,0,0,0
"Aruba","2024-11-23",0,0,0,0,0,0,0,0
"Aruba","2024-11-24",0,0,0,0,0,0,0,0
"Aruba","2024-11-25",0,0,0,0,0,0,0,0
"Aruba","2024-11-26",0,0,0,0,0,0,0,0
"Aruba","2024-11-27",0,0,0,0,0,0,0,0
"Aruba","2024-11-28",0,0,0,0,0,0,0,0
"Aruba","2024-11-29",0,0,0,0,0,0,0,0
"Aruba","2024-11-30",0,0,0,0,0,0,0,0
"Aruba","2024-12-01",0,0,0,0,0,0,0,0
"Aruba","2024-12-02",0,0,0,0,0,0,0,0
"Aruba","2024-12-03",0,0,0,0,0,0,0,0
"Aruba","2024-12-04",0,0,0,0,0,0,0,0
"Aruba","2024-12-05",0,0,0,0,0,0,0,0
"Aruba","2024-12-06",0,0,0,0,0,0,0,0
"Aruba","2024-12-07",0,0,0,0,0,0,0,0
"Aruba","2024-12-08",0,0,0,0,0,0,0,0
"Aruba","2024-12-09",0,0,0,0,0,0,0,0
"Aruba","2024-12-10",0,0,0,0,0,0,0,0
"Aruba","2024-12-11",0,0,0,0,0,0,0,0
"Aruba","2024-12-12",0,0,0,0,0,0,0,0
"Aruba","2024-12-13",0,0,0,0,0,0,0,0
"Aruba","2024-12-14",0,0,0,0,0,0,0,0
"Aruba","2024-12-15",0,0,0,0,0,0,0,0
"Aruba","2024-12-16",0,0,0,0,0,0,0,0
"Aruba","2024-12-17",0,0,0,0,0,0,0,0
"Aruba","2024-12-18",0,0,0,0,0,0,0,0
"Aruba","2024-12-19",0,0,0,0,0,0,0,0
"Aruba","2024-12-20",0,0,0,0,0,0,0,0
"Aruba","2024-12-21",0,0,0,0,0,0,0,0
"Aruba","2024-12-22",0,0,0,0,0,0,0,0
"Aruba","2024-12-23",0,0,0,0,0,0,0,0
"Aruba","2024-12-24",0,0,0,0,0,0,0,0
"Aruba","2024-12-25",0,0,0,0,0,0,0,0
"Aruba","2024-12-26",0,0,0,0,0,0,0,0
"Aruba","2024-12-27",0,0,0,0,0,0,0,0
"Aruba","2024-12-28",0,0,0,0,0,0,0,0
"Aruba","2024-12-29",0,0,0,0,0,0,0,0
"Aruba","2024-12-30",0,0,0,0,0,0,0,0
"Aruba","2024-12-31",0,0,0,0,0,0,0,0
"Aruba","2025-01-01",0,0,0,0,0,0,0,0
"Aruba","2025-01-02",0,0,0,0,0,0,0,0
"Aruba","2025-01-03",0,0,0,0,0,0,0,0
"Aruba","2025-01-04",0,0,0,0,0,0,0,0
"Aruba","2025-01-05",0,0,0,0,0,0,0,0
"Aruba","2025-01-06",0,0,0,0,0,0,0,0
"Aruba","2025-01-07",0,0,0,0,0,0,0,0
"Aruba","2025-01-08",0,0,0,0,0,0,0,0
"Aruba","2025-01-09",0,0,0,0,0,0,0,0
"Aruba","2025-01-10",0,0,0,0,0,0,0,0
"Aruba","2025-01-11",0,0,0,0,0,0,0,0
"Aruba","2025-01-12",0,0,0,0,0,0,0,0
"Aruba","2025-01-13",0,0,0,0,0,0,0,0
"Aruba","2025-01-14",0,0,0,0,0,0,0,0
"Aruba","2025-01-15",0,0,0,0,0,0,0,0
"Aruba","2025-01-16",0,0,0,0,0,0,0,0
"Aruba","2025-01-17",0,0,0,0,0,0,0,0
"Aruba","2025-01-18",0,0,0,0,0,0,0,0
"Aruba","2025-01-19",0,0,0,0,0,0,0,0
"Aruba","2025-01-20",0,0,0,0,0,0,0,0
"Aruba","2025-01-21",0,0,0,0,0,0,0,0
"Aruba","2025-01-22",0,0,0,0,0,0,0,0
"Aruba","2025-01-23",0,0,0,0,0,0,0,0
"Aruba","2025-01-24",0,0,0,0,0,0,0,0
"Aruba","2025-01-25",0,0,0,0,0,0,0,0
"Aruba","2025-01-26",0,0,0,0,0,0,0,0
"Aruba","2025-01-27",0,0,0,0,0,0,0,0
"Aruba","2025-01-28",0,0,0,0,0,0,0,0
"Aruba","2025-01-29",0,0,0,0,0,0,0,0
"Aruba","2025-01-30",0,0,0,0,0,0,0,0
"Aruba","2025-01-31",0,0,0,0,0,0,0,0
"Aruba","2025-02-01",0,0,0,0,0,0,0,0
"Aruba","2025-02-02",0,0,0,0,0,0,0,0
"Aruba","2025-02-03",0,0,0,0,0,0,0,0
"Asia","2024-01-01",0,0,0,0,0,0,0,0
"Asia","2024-01-02",0,0,0,0,0,0,0,0
"Asia","2024-01-03",0,0,0,0,0,0,0,0
"Asia","2024-01-04",0,2,2,0,2,2,0,0
"Asia","2024-01-05",0,1,3,0,1,3,0,0
"Asia","2024-01-06",0,0,3,0,0,3,0,0
"Asia","2024-01-07",0,0,3,0,0,3,0,0
"Asia","2024-01-08",0,0,3,0,1,4,0,0
"Asia","2024-01-09",0,1,4,0,0,4,0,0
"Asia","2024-01-10",0,14,18,0,14,18,0,0
"Asia","2024-01-11",0,1,19,0,1,19,0,0
"Asia","2024-01-12",0,1,20,0,1,20,0,0
"Asia","2024-01-13",0,0,20,0,0,20,0,0
"Asia","2024-01-14",0,0,20,0,0,20,0,0
"Asia","2024-01-15",0,0,20,0,1,21,0,0
"Asia","2024-01-16",0,0,20,0,0,21,0,0
"Asia","2024-01-17",0,1,21,0,0,21,0,0
"Asia","2024-01-18",0,0,21,0,1,22,0,0
"Asia","2024-01-19",0,2,23,0,1,23,0,0
"Asia","2024-01-20",0,2,25,0,2,25,0,0
"Asia","2024-01-21",0,0,25,0,2,27,0,0
"Asia","2024-01-22",0,0,25,0,1,28,0,0
"Asia","2024-01-23",0,0,25,0,1,29,0,0
"Asia","2024-01-24",0,6,31,0,2,31,0,0
"Asia","2024-01-25",0,0,31,0,22,53,0,0
"Asia","2024-01-26",0,0,31,0,23,76,0,0
"Asia","2024-01-27",0,0,31,0,22,98,0,0
"Asia","2024-01-28",0,0,31,0,22,120,0,0
"Asia","2024-01-29",0,0,31,0,22,142,0,0
"Asia","2024-01-30",0,0,31,0,23,165,0,0
"Asia","2024-01-31",0,156,187,0,22,187,0,0
"Asia","2024-02-01",0,0,187,0,2,189,0,0
"Asia","2024-02-02",0,5,192,0,3,192,0,0
"Asia","2024-02-03",0,0,192,0,1,193,0,0
"Asia","2024-02-04",0,0,192,0,1,194,0,0
"Asia","2024-02-05",0,3,195,0,1,195,0,0
"Asia","2024-02-06",0,0,195,0,1,196,0,0
"Asia","2024-02-07",0,0,195,0,1,197,0,0
"Asia","2024-02-08",0,0,195,0,2,199,0,0
"Asia","2024-02-09",0,5,200,0,1,200,0,0
"Asia","2024-02-10",0,0,200,0,0,200,0,0
"Asia","2024-02-11",0,0,200,0,0,200,0,0
"Asia","2024-02-12",0,0,200,0,0,200,0,0
"Asia","2024-02-13",0,0,200,0,1,201,0,0
"Asia","2024-02-14",0,0,200,0,0,201,0,0
"Asia","2024-02-15",0,1,201,0,0,201,0,0
"Asia","2024-02-16",0,1,202,0,1,202,0,0
"Asia","2024-02-17",0,0,202,0,1,203,0,0
"Asia","2024-02-18",0,0,202,0,2,205,0,0
"Asia","2024-02-19",0,0,202,0,1,206,0,0
"Asia","2024-02-20",0,0,202,0,2,208,0,0
"Asia","2024-02-21",0,0,202,0,1,209,0,0
"Asia","2024-02-22",0,0,202,0,2,211,0,0
"Asia","2024-02-23",0,10,212,0,1,212,0,0
"Asia","2024-02-24",0,0,212,0,3,215,0,0
"Asia","2024-02-25",0,0,212,0,3,218,0,0
"Asia","2024-02-26",0,0,212,0,3,221,0,0
"Asia","2024-02-27",0,0,212,0,3,224,0,0
"Asia","2024-02-28",0,15,227,0,3,227,0,0
"Asia","2024-02-29",0,114,341,0,114,341,0,0
"Asia","2024-03-01",0,4,345,0,4,345,0,0
"Asia","2024-03-02",0,1,346,0,1,346,0,0
"Asia","2024-03-03",0,0,346,0,2,348,0,0
"Asia","2024-03-04",0,0,346,0,3,351,0,0
"Asia","2024-03-05",0,0,346,0,3,354,0,0
"Asia","2024-03-06",0,10,356,0,2,356,0,0
"Asia","2024-03-07",0,0,356,0,2,358,0,0
"Asia","2024-03-08",0,3,359,0,1,359,0,0
"Asia","2024-03-09",0,0,359,0,0,359,0,0
"Asia","2024-03-10",0,0,359,0,0,359,0,0
"Asia","2024-03-11",0,0,359,0,0,359,0,0
"Asia","2024-03-12",0,0,359,0,1,360,0,0
"Asia","2024-03-13",0,0,359,0,0,360,0,0
"Asia","2024-03-14",0,1,360,0,0,360,0,0
"Asia","2024-03-15",0,2,362,0,2,362,0,0
"Asia","2024-03-16",0,0,362,0,0,362,0,0
"Asia","2024-03-17",0,0,362,0,0,362,0,0
"Asia","2024-03-18",0,0,362,0,0,362,0,0
"Asia","2024-03-19",0,0,362,0,1,363,0,0
"Asia","2024-03-20",0,0,362,0,0,363,0,0
"Asia","2024-03-21",0,0,362,0,0,363,0,0
"Asia","2024-03-22",0,1,363,0,0,363,0,0
"Asia","2024-03-23",0,0,363,0,3,366,0,0
"Asia","2024-03-24",0,0,363,0,3,369,0,0
"Asia","2024-03-25",0,0,363,0,3,372,0,0
"Asia","2024-03-26",0,12,375,0,3,375,0,0
"Asia","2024-03-27",0,0,375,0,17,392,0,0
"Asia","2024-03-28",0,0,375,0,16,408,0,0
"Asia","2024-03-29",0,0,375,0,17,425,0,0
"Asia","2024-03-30",0,0,375,0,16,441,0,0
"Asia","2024-03-31",0,83,458,0,17,458,0,0
"Asia","2024-04-01",0,6,464,0,6,464,0,0
"Asia","2024-04-02",0,1,465,0,1,465,0,0
"Asia","2024-04-03",0,0,465,0,1,466,0,0
"Asia","2024-04-04",0,0,465,0,1,467,0,0
"Asia","2024-04-05",0,3,468,0,1,468,0,0
"Asia","2024-04-06",0,0,468,0,0,468,0,0
"Asia","2024-04-07",0,0,468,0,0,468,0,0
"Asia","2024-04-08",0,0,468,0,1,469,0,0
"Asia","2024-04-09",0,1,469,0,0,469,0,0
"Asia","2024-04-10",0,0,469,0,1,470,0,0
"Asia","2024-04-11",0,0,469,0,0,470,0,0
"Asia","2024-04-12",0,2,471,0,1,471,0,0
"Asia","2024-04-13",0,0,471,0,0,471,0,0
"Asia","2024-04-14",0,0,471,0,0,471,0,0
"Asia","2024-04-15",0,0,471,0,0,471,0,0
"Asia","2024-04-16",0,0,471,0,1,472,0,0
"Asia","2024-04-17",0,0,471,0,0,472,0,0
"Asia","2024-04-18",0,0,471,0,0,472,0,0
"Asia","2024-04-19",0,1,472,0,0,472,0,0
"Asia","2024-04-20",0,1,473,0,1,473,0,0
"Asia","2024-04-21",0,0,473,0,0,473,0,0
"Asia","2024-04-22",0,0,473,0,1,474,0,0
"Asia","2024-04-23",0,0,473,0,0,474,0,0
"Asia","2024-04-24",0,0,473,0,0,474,0,0
"Asia","2024-04-25",0,0,473,0,1,475,0,0
"Asia","2024-04-26",0,2,475,0,0,475,0,0
"Asia","2024-04-27",0,1,476,0,1,476,0,0
"Asia","2024-04-28",0,0,476,0,22,498,0,0
"Asia","2024-04-29",0,0,476,0,22,520,0,0
"Asia","2024-04-30",0,66,542,0,22,542,0,0
"Asia","2024-05-01",0,0,542,0,0,542,0,0
"Asia","2024-05-02",0,0,542,0,0,542,0,0
"Asia","2024-05-03",0,0,542,0,0,542,0,0
"Asia","2024-05-04",0,0,542,0,1,543,0,0
"Asia","2024-05-05",0,0,542,0,0,543,0,0
"Asia","2024-05-06",0,0,542,0,0,543,0,0
"Asia","2024-05-07",0,1,543,0,0,543,0,0
"Asia","2024-05-08",0,0,543,0,8,551,0,0
"Asia","2024-05-09",0,0,543,0,9,560,0,0
"Asia","2024-05-10",0,25,568,0,8,568,0,0
"Asia","2024-05-11",0,0,568,0,0,568,0,0
"Asia","2024-05-12",0,0,568,0,0,568,0,0
"Asia","2024-05-13",0,0,568,0,1,569,0,0
"Asia","2024-05-14",0,1,569,0,0,569,0,0
"Asia","2024-05-15",0,0,569,0,0,569,0,0
"Asia","2024-05-16",0,0,569,0,0,569,0,0
"Asia","2024-05-17",0,0,569,0,0,569,0,0
"Asia","2024-05-18",0,0,569,0,0,569,0,0
"Asia","2024-05-19",0,0,569,0,1,570,0,0
"Asia","2024-05-20",0,0,569,0,0,570,0,0
"Asia","2024-05-21",0,0,569,0,0,570,0,0
"Asia","2024-05-22",0,1,570,0,0,570,0,0
"Asia","2024-05-23",0,0,570,0,2,572,0,0
"Asia","2024-05-24",0,4,574,0,2,574,0,0
"Asia","2024-05-25",0,0,574,0,0,574,0,0
"Asia","2024-05-26",0,0,574,0,1,575,0,0
"Asia","2024-05-27",0,1,575,0,0,575,0,0
"Asia","2024-05-28",0,0,575,0,16,591,0,0
"Asia","2024-05-29",0,0,575,0,17,608,0,0
"Asia","2024-05-30",0,49,624,0,16,624,0,0
"Asia","2024-05-31",0,59,683,0,59,683,0,0
"Asia","2024-06-01",0,0,683,0,0,683,0,0
"Asia","2024-06-02",0,0,683,0,0,683,0,0
"Asia","2024-06-03",0,0,683,0,0,683,0,0
"Asia","2024-06-04",0,0,683,0,1,684,0,0
"Asia","2024-06-05",0,0,683,0,0,684,0,0
"Asia","2024-06-06",0,0,683,0,0,684,0,0
"Asia","2024-06-07",0,0,683,0,0,684,0,0
"Asia","2024-06-08",0,0,683,0,0,684,0,0
"Asia","2024-06-09",0,0,683,0,1,685,0,0
"Asia","2024-06-10",0,0,683,0,0,685,0,0
"Asia","2024-06-11",0,0,683,0,0,685,0,0
"Asia","2024-06-12",0,0,683,0,0,685,0,0
"Asia","2024-06-13",0,0,683,0,0,685,0,0
"Asia","2024-06-14",0,0,683,0,0,685,0,0
"Asia","2024-06-15",0,0,683,0,0,685,0,0
"Asia","2024-06-16",0,0,683,0,1,686,0,0
"Asia","2024-06-17",0,0,683,0,0,686,0,0
"Asia","2024-06-18",0,0,683,0,0,686,0,0
"Asia","2024-06-19",0,0,683,0,0,686,0,0
"Asia","2024-06-20",0,0,683,0,0,686,0,0
"Asia","2024-06-21",0,0,683,0,1,687,0,0
"Asia","2024-06-22",0,0,683,0,0,687,0,0
"Asia","2024-06-23",0,0,683,0,0,687,0,0
"Asia","2024-06-24",0,4,687,0,0,687,0,0
"Asia","2024-06-25",0,6,693,0,6,693,0,0
"Asia","2024-06-26",0,0,693,0,2,695,0,0
"Asia","2024-06-27",0,0,693,0,3,698,0,0
"Asia","2024-06-28",0,7,700,0,2,700,0,0
"Asia","2024-06-29",0,0,700,0,35,735,0,0
"Asia","2024-06-30",0,70,770,0,35,770,0,0
"Asia","2024-07-01",0,0,770,0,0,770,0,0
"Asia","2024-07-02",0,0,770,0,0,770,0,0
"Asia","2024-07-03",0,0,770,0,1,771,0,0
"Asia","2024-07-04",0,0,770,0,0,771,0,0
"Asia","2024-07-05",0,0,770,0,0,771,0,0
"Asia","2024-07-06",0,0,770,0,1,772,0,0
"Asia","2024-07-07",0,0,770,0,0,772,0,0
"Asia","2024-07-08",0,2,772,0,0,772,0,0
"Asia","2024-07-09",0,0,772,0,0,772,0,0
"Asia","2024-07-10",0,0,772,0,1,773,0,0
"Asia","2024-07-11",0,0,772,0,1,774,0,0
"Asia","2024-07-12",0,2,774,0,0,774,0,0
"Asia","2024-07-13",0,1,775,0,1,775,0,0
"Asia","2024-07-14",0,0,775,0,2,777,0,0
"Asia","2024-07-15",0,0,775,0,3,780,0,0
"Asia","2024-07-16",0,7,782,0,2,782,0,0
"Asia","2024-07-17",0,0,782,0,1,783,0,0
"Asia","2024-07-18",0,0,782,0,1,784,0,0
"Asia","2024-07-19",0,0,782,0,0,784,0,0
"Asia","2024-07-20",0,0,782,0,1,785,0,0
"Asia","2024-07-21",0,0,782,0,1,786,0,0
"Asia","2024-07-22",0,0,782,0,0,786,0,0
"Asia","2024-07-23",0,0,782,0,1,787,0,0
"Asia","2024-07-24",0,0,782,0,1,788,0,0
"Asia","2024-07-25",0,0,782,0,1,789,0,0
"Asia","2024-07-26",0,0,782,0,1,790,0,0
"Asia","2024-07-27",0,0,782,0,0,790,0,0
"Asia","2024-07-28",0,9,791,0,1,791,0,0
"Asia","2024-07-29",0,0,791,0,20,811,0,0
"Asia","2024-07-30",0,39,830,0,19,830,0,0
"Asia","2024-07-31",0,27,857,0,27,857,0,0
"Asia","2024-08-01",0,0,857,0,3,860,0,0
"Asia","2024-08-02",0,6,863,0,3,863,0,0
"Asia","2024-08-03",0,0,863,0,0,863,0,0
"Asia","2024-08-04",0,0,863,0,1,864,0,0
"Asia","2024-08-05",0,1,864,0,0,864,0,0
"Asia","2024-08-06",0,2,866,0,2,866,0,0
"Asia","2024-08-07",0,0,866,0,1,867,0,0
"Asia","2024-08-08",0,0,866,0,0,867,0,0
"Asia","2024-08-09",0,0,866,0,1,868,0,0
"Asia","2024-08-10",0,0,866,0,1,869,0,0
"Asia","2024-08-11",0,0,866,0,1,870,0,0
"Asia","2024-08-12",0,0,866,0,0,870,0,0
"Asia","2024-08-13",0,5,871,0,1,871,0,0
"Asia","2024-08-14",0,1,872,0,1,872,0,0
"Asia","2024-08-15",0,2,874,0,2,874,0,0
"Asia","2024-08-16",0,0,874,0,0,874,0,0
"Asia","2024-08-17",0,0,874,0,0,874,0,0
"Asia","2024-08-18",0,0,874,0,1,875,0,0
"Asia","2024-08-19",0,1,875,0,0,875,0,0
"Asia","2024-08-20",0,4,879,0,4,879,0,0
"Asia","2024-08-21",0,1,880,0,1,880,0,0
"Asia","2024-08-22",0,2,882,0,2,882,0,0
"Asia","2024-08-23",0,1,883,0,1,883,0,0
"Asia","2024-08-24",0,0,883,0,0,883,0,0
"Asia","2024-08-25",0,0,883,0,0,883,0,0
"Asia","2024-08-26",0,0,883,0,1,884,0,0
"Asia","2024-08-27",0,1,884,0,0,884,0,0
"Asia","2024-08-28",0,4,888,0,4,888,0,0
"Asia","2024-08-29",0,0,888,0,23,911,0,0
"Asia","2024-08-30",0,0,888,0,23,934,0,0
"Asia","2024-08-31",0,69,957,0,23,957,0,0
"Asia","2024-09-01",0,3,960,0,3,960,0,0
"Asia","2024-09-02",0,1,961,0,1,961,0,0
"Asia","2024-09-03",0,0,961,0,0,961,0,0
"Asia","2024-09-04",0,0,961,0,0,961,0,0
"Asia","2024-09-05",0,0,961,0,0,961,0,0
"Asia","2024-09-06",0,0,961,0,1,962,0,0
"Asia","2024-09-07",0,0,961,0,0,962,0,0
"Asia","2024-09-08",0,1,962,0,0,962,0,0
"Asia","2024-09-09",0,0,962,0,2,964,0,0
"Asia","2024-09-10",0,0,962,0,1,965,0,0
"Asia","2024-09-11",0,0,962,0,2,967,0,0
"Asia","2024-09-12",0,0,962,0,2,969,0,0
"Asia","2024-09-13",0,0,962,0,2,971,0,0
"Asia","2024-09-14",0,0,962,0,1,972,0,0
"Asia","2024-09-15",0,12,974,0,2,974,0,0
"Asia","2024-09-16",0,0,974,0,0,974,0,0
"Asia","2024-09-17",0,0,974,0,1,975,0,0
"Asia","2024-09-18",0,1,975,0,0,975,0,0
"Asia","2024-09-19",0,0,975,0,1,976,0,0
"Asia","2024-09-20",0,0,975,0,0,976,0,0
"Asia","2024-09-21",0,0,975,0,1,977,0,0
"Asia","2024-09-22",0,0,975,0,0,977,0,0
"Asia","2024-09-23",0,3,978,0,1,978,0,0
"Asia","2024-09-24",0,0,978,0,5,983,0,0
"Asia","2024-09-25",0,0,978,0,5,988,0,0
"Asia","2024-09-26",0,15,993,0,5,993,0,0
"Asia","2024-09-27",0,0,993,0,2,995,0,0
"Asia","2024-09-28",0,0,993,0,2,997,0,0
"Asia","2024-09-29",0,6,999,0,2,999,0,0
"Asia","2024-09-30",0,66,1065,0,66,1065,0,0
"Asia","2024-10-01",0,6,1071,0,6,1071,0,0
"Asia","2024-10-02",0,1,1072,0,1,1072,0,0
"Asia","2024-10-03",0,1,1073,0,1,1073,0,0
"Asia","2024-10-04",0,1,1074,0,1,1074,0,0
"Asia","2024-10-05",0,0,1074,0,0,1074,0,0
"Asia","2024-10-06",0,0,1074,0,1,1075,0,0
"Asia","2024-10-07",0,0,1074,0,0,1075,0,0
"Asia","2024-10-08",0,0,1074,0,0,1075,0,0
"Asia","2024-10-09",0,0,1074,0,1,1076,0,0
"Asia","2024-10-10",0,2,1076,0,0,1076,0,0
"Asia","2024-10-11",0,2,1078,0,2,1078,0,0
"Asia","2024-10-12",0,0,1078,0,0,1078,0,0
"Asia","2024-10-13",0,0,1078,0,1,1079,0,0
"Asia","2024-10-14",0,0,1078,0,0,1079,0,0
"Asia","2024-10-15",0,0,1078,0,0,1079,0,0
"Asia","2024-10-16",0,0,1078,0,0,1079,0,0
"Asia","2024-10-17",0,0,1078,0,1,1080,0,0
"Asia","2024-10-18",0,2,1080,0,0,1080,0,0
"Asia","2024-10-19",0,0,1080,0,0,1080,0,0
"Asia","2024-10-20",0,0,1080,0,1,1081,0,0
"Asia","2024-10-21",0,0,1080,0,0,1081,0,0
"Asia","2024-10-22",0,0,1080,0,1,1082,0,0
"Asia","2024-10-23",0,2,1082,0,0,1082,0,0
"Asia","2024-10-24",0,0,1082,0,1,1083,0,0
"Asia","2024-10-25",0,0,1082,0,0,1083,0,0
"Asia","2024-10-26",0,0,1082,0,1,1084,0,0
"Asia","2024-10-27",0,0,1082,0,1,1085,0,0
"Asia","2024-10-28",0,0,1082,0,0,1085,0,0
"Asia","2024-10-29",0,4,1086,0,1,1086,0,0
"Asia","2024-10-30",0,1,1087,0,1,1087,0,0
"Asia","2024-10-31",0,52,1139,0,52,1139,0,0
"Asia","2024-11-01",0,2,1141,0,2,1141,0,0
"Asia","2024-11-02",0,0,1141,0,1,1142,0,0
"Asia","2024-11-03",0,0,1141,0,0,1142,0,0
"Asia","2024-11-04",0,0,1141,0,1,1143,0,0
"Asia","2024-11-05",0,0,1141,0,0,1143,0,0
"Asia","2024-11-06",0,3,1144,0,1,1144,0,0
"Asia","2024-11-07",0,0,1144,0,1,1145,0,0
"Asia","2024-11-08",0,0,1144,0,1,1146,0,0
"Asia","2024-11-09",0,0,1144,0,0,1146,0,0
"Asia","2024-11-10",0,0,1144,0,1,1147,0,0
"Asia","2024-11-11",0,0,1144,0,1,1148,0,0
"Asia","2024-11-12",0,0,1144,0,1,1149,0,0
"Asia","2024-11-13",0,0,1144,0,0,1149,0,0
"Asia","2024-11-14",0,0,1144,0,1,1150,0,0
"Asia","2024-11-15",0,7,1151,0,1,1151,0,0
"Asia","2024-11-16",0,0,1151,0,0,1151,0,0
"Asia","2024-11-17",0,0,1151,0,0,1151,0,0
"Asia","2024-11-18",0,0,1151,0,1,1152,0,0
"Asia","2024-11-19",0,1,1152,0,0,1152,0,0
"Asia","2024-11-20",0,0,1152,0,1,1153,0,0
"Asia","2024-11-21",0,0,1152,0,0,1153,0,0
"Asia","2024-11-22",0,0,1152,0,1,1154,0,0
"Asia","2024-11-23",0,0,1152,0,0,1154,0,0
"Asia","2024-11-24",0,0,1152,0,1,1155,0,0
"Asia","2024-11-25",0,0,1152,0,0,1155,0,0
"Asia","2024-11-26",0,4,1156,0,1,1156,0,0
"Asia","2024-11-27",0,24,1180,0,24,1180,0,0
"Asia","2024-11-28",0,0,1180,0,0,1180,0,0
"Asia","2024-11-29",0,1,1181,0,1,1181,0,0
"Asia","2024-11-30",0,23,1204,0,23,1204,0,0
"Asia","2024-12-01",0,0,1204,0,1,1205,0,0
"Asia","2024-12-02",0,0,1204,0,0,1205,0,0
"Asia","2024-12-03",0,2,1206,0,1,1206,0,0
"Asia","2024-12-04",0,0,1206,0,0,1206,0,0
"Asia","2024-12-05",0,0,1206,0,0,1206,0,0
"Asia","2024-12-06",0,0,1206,0,0,1206,0,0
"Asia","2024-12-07",0,0,1206,0,1,1207,0,0
"Asia","2024-12-08",0,0,1206,0,0,1207,0,0
"Asia","2024-12-09",0,1,1207,0,0,1207,0,0
"Asia","2024-12-10",0,1,1208,0,1,1208,0,0
"Asia","2024-12-11",0,0,1208,0,0,1208,0,0
"Asia","2024-12-12",0,0,1208,0,1,1209,0,0
"Asia","2024-12-13",0,0,1208,0,0,1209,0,0
"Asia","2024-12-14",0,0,1208,0,0,1209,0,0
"Asia","2024-12-15",0,0,1208,0,0,1209,0,0
"Asia","2024-12-16",0,0,1208,0,1,1210,0,0
"Asia","2024-12-17",0,2,1210,0,0,1210,0,0
"Asia","2024-12-18",0,0,1210,0,0,1210,0,0
"Asia","2024-12-19",0,0,1210,0,0,1210,0,0
"Asia","2024-12-20",0,0,1210,0,0,1210,0,0
"Asia","2024-12-21",0,0,1210,0,1,1211,0,0
"Asia","2024-12-22",0,0,1210,0,0,1211,0,0
"Asia","2024-12-23",0,0,1210,0,0,1211,0,0
"Asia","2024-12-24",0,1,1211,0,0,1211,0,0
"Asia","2024-12-25",0,0,1211,0,4,1215,0,0
"Asia","2024-12-26",0,7,1218,0,3,1218,0,0
"Asia","2024-12-27",0,1,1219,0,1,1219,0,0
"Asia","2024-12-28",0,0,1219,0,4,1223,0,0
"Asia","2024-12-29",0,0,1219,0,4,1227,0,0
"Asia","2024-12-30",0,0,1219,0,5,1232,0,0
"Asia","2024-12-31",0,17,1236,0,4,1236,0,0
"Asia","2025-01-01",0,0,1236,0,4,1240,0,0
"Asia","2025-01-02",0,0,1236,0,4,1244,0,0
"Asia","2025-01-03",0,0,1236,0,4,1248,0,0
"Asia","2025-01-04",0,0,1236,0,4,1252,0,0
"Asia","2025-01-05",0,0,1236,0,5,1257,0,0
"Asia","2025-01-06",0,0,1236,0,4,1261,0,0
"Asia","2025-01-07",0,0,1236,0,4,1265,0,0
"Asia","2025-01-08",0,33,1269,0,4,1269,0,0
"Asia","2025-01-09",0,0,1269,0,1,1270,0,0
"Asia","2025-01-10",0,2,1271,0,1,1271,0,0
"Asia","2025-01-11",0,0,1271,0,0,1271,0,0
"Asia","2025-01-12",0,0,1271,0,0,1271,0,0
"Asia","2025-01-13",0,0,1271,0,1,1272,0,0
"Asia","2025-01-14",0,0,1271,0,0,1272,0,0
"Asia","2025-01-15",0,0,1271,0,0,1272,0,0
"Asia","2025-01-16",0,0,1271,0,0,1272,0,0
"Asia","2025-01-17",0,0,1271,0,0,1272,0,0
"Asia","2025-01-18",0,0,1271,0,0,1272,0,0
"Asia","2025-01-19",0,0,1271,0,1,1273,0,0
"Asia","2025-01-20",0,0,1271,0,0,1273,0,0
"Asia","2025-01-21",0,2,1273,0,0,1273,0,0
"Asia","2025-01-22",0,0,1273,0,0,1273,0,0
"Asia","2025-01-23",0,0,1273,0,0,1273,0,0
"Asia","2025-01-24",0,0,1273,0,0,1273,0,0
"Asia","2025-01-25",0,0,1273,0,0,1273,0,0
"Asia","2025-01-26",0,0,1273,0,0,1273,0,0
"Asia","2025-01-27",0,0,1273,0,0,1273,0,0
"Asia","2025-01-28",0,0,1273,0,0,1273,0,0
"Asia","2025-01-29",0,0,1273,0,0,1273,0,0
"Asia","2025-01-30",0,0,1273,0,0,1273,0,0
"Asia","2025-01-31",0,0,1273,0,0,1273,0,0
"Asia","2025-02-01",0,0,1273,0,0,1273,0,0
"Asia","2025-02-02",0,0,1273,0,0,1273,0,0
"Asia","2025-02-03",0,0,1273,0,0,1273,0,0
"Australia","2024-01-01",0,0,0,0,0,0,0,0
"Australia","2024-01-02",0,0,0,0,0,0,0,0
"Australia","2024-01-03",0,0,0,0,0,0,0,0
"Australia","2024-01-04",0,0,0,0,0,0,0,0
"Australia","2024-01-05",0,0,0,0,0,0,0,0
"Australia","2024-01-06",0,0,0,0,0,0,0,0
"Australia","2024-01-07",0,0,0,0,0,0,0,0
"Australia","2024-01-08",0,0,0,0,0,0,0,0
"Australia","2024-01-09",0,0,0,0,0,0,0,0
"Australia","2024-01-10",0,0,0,0,0,0,0,0
"Australia","2024-01-11",0,0,0,0,0,0,0,0
"Australia","2024-01-12",0,0,0,0,0,0,0,0
"Australia","2024-01-13",0,0,0,0,0,0,0,0
"Australia","2024-01-14",0,0,0,0,0,0,0,0
"Australia","2024-01-15",0,0,0,0,0,0,0,0
"Australia","2024-01-16",0,0,0,0,0,0,0,0
"Australia","2024-01-17",0,0,0,0,0,0,0,0
"Australia","2024-01-18",0,0,0,0,0,0,0,0
"Australia","2024-01-19",0,0,0,0,0,0,0,0
"Australia","2024-01-20",0,0,0,0,0,0,0,0
"Australia","2024-01-21",0,0,0,0,0,0,0,0
"Australia","2024-01-22",0,0,0,0,0,0,0,0
"Australia","2024-01-23",0,0,0,0,0,0,0,0
"Australia","2024-01-24",0,0,0,0,0,0,0,0
"Australia","2024-01-25",0,0,0,0,0,0,0,0
"Australia","2024-01-26",0,0,0,0,0,0,0,0
"Australia","2024-01-27",0,0,0,0,0,0,0,0
"Australia","2024-01-28",0,0,0,0,0,0,0,0
"Australia","2024-01-29",0,0,0,0,0,0,0,0
"Australia","2024-01-30",0,0,0,0,0,0,0,0
"Australia","2024-01-31",0,6,6,0,6,6,0,0
"Australia","2024-02-01",0,0,6,0,0,6,0,0
"Australia","2024-02-02",0,0,6,0,0,6,0,0
"Australia","2024-02-03",0,0,6,0,0,6,0,0
"Australia","2024-02-04",0,0,6,0,0,6,0,0
"Australia","2024-02-05",0,0,6,0,0,6,0,0
"Australia","2024-02-06",0,0,6,0,0,6,0,0
"Australia","2024-02-07",0,0,6,0,0,6,0,0
"Australia","2024-02-08",0,0,6,0,0,6,0,0
"Australia","2024-02-09",0,0,6,0,0,6,0,0
"Australia","2024-02-10",0,0,6,0,1,7,0,0
"Australia","2024-02-11",0,0,6,0,0,7,0,0
"Australia","2024-02-12",0,0,6,0,0,7,0,0
"Australia","2024-02-13",0,0,6,0,0,7,0,0
"Australia","2024-02-14",0,0,6,0,0,7,0,0
"Australia","2024-02-15",0,0,6,0,0,7,0,0
"Australia","2024-02-16",0,0,6,0,0,7,0,0
"Australia","2024-02-17",0,0,6,0,0,7,0,0
"Australia","2024-02-18",0,0,6,0,0,7,0,0
"Australia","2024-02-19",0,0,6,0,0,7,0,0
"Australia","2024-02-20",0,0,6,0,0,7,0,0
"Australia","2024-02-21",0,0,6,0,0,7,0,0
"Australia","2024-02-22",0,0,6,0,0,7,0,0
"Australia","2024-02-23",0,0,6,0,0,7,0,0
"Australia","2024-02-24",0,0,6,0,0,7,0,0
"Australia","2024-02-25",0,0,6,0,0,7,0,0
"Australia","2024-02-26",0,0,6,0,0,7,0,0
"Australia","2024-02-27",0,0,6,0,1,8,0,0
"Australia","2024-02-28",0,0,6,0,0,8,0,0
"Australia","2024-02-29",0,0,6,0,0,8,0,0
"Australia","2024-03-01",0,0,6,0,0,8,0,0
"Australia","2024-03-02",0,0,6,0,0,8,0,0
"Australia","2024-03-03",0,0,6,0,0,8,0,0
"Australia","2024-03-04",0,0,6,0,0,8,0,0
"Australia","2024-03-05",0,0,6,0,0,8,0,0
"Australia","2024-03-06",0,0,6,0,0,8,0,0
"Australia","2024-03-07",0,0,6,0,0,8,0,0
"Australia","2024-03-08",0,0,6,0,0,8,0,0
"Australia","2024-03-09",0,0,6,0,0,8,0,0
"Australia","2024-03-10",0,0,6,0,0,8,0,0
"Australia","2024-03-11",0,0,6,0,0,8,0,0
"Australia","2024-03-12",0,0,6,0,0,8,0,0
"Australia","2024-03-13",0,0,6,0,0,8,0,0
"Australia","2024-03-14",0,0,6,0,0,8,0,0
"Australia","2024-03-15",0,0,6,0,0,8,0,0
"Australia","2024-03-16",0,0,6,0,0,8,0,0
"Australia","2024-03-17",0,0,6,0,1,9,0,0
"Australia","2024-03-18",0,0,6,0,0,9,0,0
"Australia","2024-03-19",0,0,6,0,0,9,0,0
"Australia","2024-03-20",0,0,6,0,0,9,0,0
"Australia","2024-03-21",0,0,6,0,0,9,0,0
"Australia","2024-03-22",0,0,6,0,0,9,0,0
"Australia","2024-03-23",0,0,6,0,0,9,0,0
"Australia","2024-03-24",0,0,6,0,0,9,0,0
"Australia","2024-03-25",0,0,6,0,0,9,0,0
"Australia","2024-03-26",0,0,6,0,0,9,0,0
"Australia","2024-03-27",0,0,6,0,0,9,0,0
"Australia","2024-03-28",0,0,6,0,0,9,0,0
"Australia","2024-03-29",0,0,6,0,0,9,0,0
"Australia","2024-03-30",0,0,6,0,0,9,0,0
"Australia","2024-03-31",0,0,6,0,0,9,0,0
"Australia","2024-04-01",0,0,6,0,0,9,0,0
"Australia","2024-04-02",0,0,6,0,0,9,0,0
"Australia","2024-04-03",0,0,6,0,1,10,0,0
"Australia","2024-04-04",0,0,6,0,0,10,0,0
"Australia","2024-04-05",0,0,6,0,0,10,0,0
"Australia","2024-04-06",0,0,6,0,0,10,0,0
"Australia","2024-04-07",0,0,6,0,0,10,0,0
"Australia","2024-04-08",0,0,6,0,0,10,0,0
"Australia","2024-04-09",0,0,6,0,0,10,0,0
"Australia","2024-04-10",0,0,6,0,0,10,0,0
"Australia","2024-04-11",0,0,6,0,0,10,0,0
"Australia","2024-04-12",0,0,6,0,0,10,0,0
"Australia","2024-04-13",0,0,6,0,0,10,0,0
"Australia","2024-04-14",0,0,6,0,0,10,0,0
"Australia","2024-04-15",0,0,6,0,0,10,0,0
"Australia","2024-04-16",0,0,6,0,0,10,0,0
"Australia","2024-04-17",0,0,6,0,0,10,0,0
"Australia","2024-04-18",0,0,6,0,0,10,0,0
"Australia","2024-04-19",0,0,6,0,0,10,0,0
"Australia","2024-04-20",0,0,6,0,0,10,0,0
"Australia","2024-04-21",0,0,6,0,0,10,0,0
"Australia","2024-04-22",0,0,6,0,1,11,0,0
"Australia","2024-04-23",0,0,6,0,0,11,0,0
"Australia","2024-04-24",0,0,6,0,0,11,0,0
"Australia","2024-04-25",0,0,6,0,0,11,0,0
"Australia","2024-04-26",0,0,6,0,0,11,0,0
"Australia","2024-04-27",0,0,6,0,0,11,0,0
"Australia","2024-04-28",0,0,6,0,0,11,0,0
"Australia","2024-04-29",0,0,6,0,0,11,0,0
"Australia","2024-04-30",0,5,11,0,0,11,0,0
"Australia","2024-05-01",0,0,11,0,1,12,0,0
"Australia","2024-05-02",0,0,11,0,1,13,0,0
"Australia","2024-05-03",0,0,11,0,1,14,0,0
"Australia","2024-05-04",0,0,11,0,1,15,0,0
"Australia","2024-05-05",0,0,11,0,1,16,0,0
"Australia","2024-05-06",0,0,11,0,1,17,0,0
"Australia","2024-05-07",0,0,11,0,1,18,0,0
"Australia","2024-05-08",0,0,11,0,2,20,0,0
"Australia","2024-05-09",0,0,11,0,1,21,0,0
"Australia","2024-05-10",0,0,11,0,1,22,0,0
"Australia","2024-05-11",0,0,11,0,1,23,0,0
"Australia","2024-05-12",0,0,11,0,1,24,0,0
"Australia","2024-05-13",0,0,11,0,1,25,0,0
"Australia","2024-05-14",0,0,11,0,1,26,0,0
"Australia","2024-05-15",0,0,11,0,1,27,0,0
"Australia","2024-05-16",0,0,11,0,1,28,0,0
"Australia","2024-05-17",0,0,11,0,1,29,0,0
"Australia","2024-05-18",0,0,11,0,1,30,0,0
"Australia","2024-05-19",0,0,11,0,1,31,0,0
"Australia","2024-05-20",0,0,11,0,1,32,0,0
"Australia","2024-05-21",0,0,11,0,1,33,0,0
"Australia","2024-05-22",0,0,11,0,1,34,0,0
"Australia","2024-05-23",0,0,11,0,1,35,0,0
"Australia","2024-05-24",0,0,11,0,2,37,0,0
"Australia","2024-05-25",0,0,11,0,1,38,0,0
"Australia","2024-05-26",0,0,11,0,1,39,0,0
"Australia","2024-05-27",0,0,11,0,1,40,0,0
"Australia","2024-05-28",0,0,11,0,1,41,0,0
"Australia","2024-05-29",0,0,11,0,1,42,0,0
"Australia","2024-05-30",0,0,11,0,1,43,0,0
"Australia","2024-05-31",0,33,44,0,1,44,0,0
"Australia","2024-06-01",0,0,44,0,2,46,0,0
"Australia","2024-06-02",0,0,44,0,2,48,0,0
"Australia","2024-06-03",0,0,44,0,2,50,0,0
"Australia","2024-06-04",0,0,44,0,3,53,0,0
"Australia","2024-06-05",0,0,44,0,2,55,0,0
"Australia","2024-06-06",0,0,44,0,2,57,0,0
"Australia","2024-06-07",0,0,44,0,2,59,0,0
"Australia","2024-06-08",0,0,44,0,2,61,0,0
"Australia","2024-06-09",0,0,44,0,2,63,0,0
"Australia","2024-06-10",0,0,44,0,2,65,0,0
"Australia","2024-06-11",0,0,44,0,2,67,0,0
"Australia","2024-06-12",0,0,44,0,3,70,0,0
"Australia","2024-06-13",0,0,44,0,2,72,0,0
"Australia","2024-06-14",0,0,44,0,2,74,0,0
"Australia","2024-06-15",0,0,44,0,2,76,0,0
"Australia","2024-06-16",0,0,44,0,2,78,0,0
"Australia","2024-06-17",0,0,44,0,2,80,0,0
"Australia","2024-06-18",0,0,44,0,2,82,0,0
"Australia","2024-06-19",0,0,44,0,3,85,0,0
"Australia","2024-06-20",0,0,44,0,2,87,0,0
"Australia","2024-06-21",0,0,44,0,2,89,0,0
"Australia","2024-06-22",0,0,44,0,2,91,0,0
"Australia","2024-06-23",0,0,44,0,2,93,0,0
"Australia","2024-06-24",0,0,44,0,2,95,0,0
"Australia","2024-06-25",0,0,44,0,2,97,0,0
"Australia","2024-06-26",0,0,44,0,2,99,0,0
"Australia","2024-06-27",0,0,44,0,3,102,0,0
"Australia","2024-06-28",0,0,44,0,2,104,0,0
"Australia","2024-06-29",0,0,44,0,2,106,0,0
"Australia","2024-06-30",0,64,108,0,2,108,0,0
"Australia","2024-07-01",0,0,108,0,1,109,0,0
"Australia","2024-07-02",0,0,108,0,1,110,0,0
"Australia","2024-07-03",0,0,108,0,1,111,0,0
"Australia","2024-07-04",0,0,108,0,1,112,0,0
"Australia","2024-07-05",0,0,108,0,1,113,0,0
"Australia","2024-07-06",0,0,108,0,1,114,0,0
"Australia","2024-07-07",0,0,108,0,1,115,0,0
"Australia","2024-07-08",0,0,108,0,0,115,0,0
"Australia","2024-07-09",0,0,108,0,1,116,0,0
"Australia","2024-07-10",0,0,108,0,1,117,0,0
"Australia","2024-07-11",0,0,108,0,1,118,0,0
"Australia","2024-07-12",0,0,108,0,1,119,0,0
"Australia","2024-07-13",0,0,108,0,1,120,0,0
"Australia","2024-07-14",0,0,108,0,1,121,0,0
"Australia","2024-07-15",0,14,122,0,1,122,0,0
"Australia","2024-07-16",0,0,122,0,3,125,0,0
"Australia","2024-07-17",0,0,122,0,3,128,0,0
"Australia","2024-07-18",0,0,122,0,3,131,0,0
"Australia","2024-07-19",0,0,122,0,3,134,0,0
"Australia","2024-07-20",0,0,122,0,3,137,0,0
"Australia","2024-07-21",0,0,122,0,3,140,0,0
"Australia","2024-07-22",0,21,143,0,3,143,0,0
"Australia","2024-07-23",0,0,143,0,4,147,0,0
"Australia","2024-07-24",0,0,143,0,4,151,0,0
"Australia","2024-07-25",0,0,143,0,5,156,0,0
"Australia","2024-07-26",0,0,143,0,4,160,0,0
"Australia","2024-07-27",0,21,164,0,4,164,0,0
"Australia","2024-07-28",0,0,164,0,11,175,0,0
"Australia","2024-07-29",0,0,164,0,10,185,0,0
"Australia","2024-07-30",0,32,196,0,11,196,0,0
"Australia","2024-07-31",0,13,209,0,13,209,0,0
"Australia","2024-08-01",0,0,209,0,4,213,0,0
"Australia","2024-08-02",0,0,209,0,3,216,0,0
"Australia","2024-08-03",0,0,209,0,4,220,0,0
"Australia","2024-08-04",0,0,209,0,3,223,0,0
"Australia","2024-08-05",0,0,209,0,4,227,0,0
"Australia","2024-08-06",0,0,209,0,3,230,0,0
"Australia","2024-08-07",0,0,209,0,4,234,0,0
"Australia","2024-08-08",0,0,209,0,3,237,0,0
"Australia","2024-08-09",0,0,209,0,4,241,0,0
"Australia","2024-08-10",0,0,209,0,3,244,0,0
"Australia","2024-08-11",0,0,209,0,4,248,0,0
"Australia","2024-08-12",0,0,209,0,3,251,0,0
"Australia","2024-08-13",0,0,209,0,4,255,0,0
"Australia","2024-08-14",0,0,209,0,3,258,0,0
"Australia","2024-08-15",0,0,209,0,4,262,0,0
"Australia","2024-08-16",0,0,209,0,3,265,0,0
"Australia","2024-08-17",0,0,209,0,4,269,0,0
"Australia","2024-08-18",0,0,209,0,3,272,0,0
"Australia","2024-08-19",0,0,209,0,4,276,0,0
"Australia","2024-08-20",0,0,209,0,3,279,0,0
"Australia","2024-08-21",0,74,283,0,4,283,0,0
"Australia","2024-08-22",0,0,283,0,9,292,0,0
"Australia","2024-08-23",0,0,283,0,9,301,0,0
"Australia","2024-08-24",0,0,283,0,8,309,0,0
"Australia","2024-08-25",0,0,283,0,9,318,0,0
"Australia","2024-08-26",0,0,283,0,9,327,0,0
"Australia","2024-08-27",0,0,283,0,8,335,0,0
"Australia","2024-08-28",0,0,283,0,9,344,0,0
"Australia","2024-08-29",0,70,353,0,9,353,0,0
"Australia","2024-08-30",0,0,353,0,50,403,0,0
"Australia","2024-08-31",0,101,454,0,51,454,0,0
"Australia","2024-09-01",0,0,454,0,4,458,0,0
"Australia","2024-09-02",0,0,454,0,5,463,0,0
"Australia","2024-09-03",0,0,454,0,4,467,0,0
"Australia","2024-09-04",0,0,454,0,5,472,0,0
"Australia","2024-09-05",0,0,454,0,4,476,0,0
"Australia","2024-09-06",0,0,454,0,4,480,0,0
"Australia","2024-09-07",0,0,454,0,5,485,0,0
"Australia","2024-09-08",0,35,489,0,4,489,0,0
"Australia","2024-09-09",0,0,489,0,12,501,0,0
"Australia","2024-09-10",0,0,489,0,12,513,0,0
"Australia","2024-09-11",0,0,489,0,12,525,0,0
"Australia","2024-09-12",0,0,489,0,12,537,0,0
"Australia","2024-09-13",0,0,489,0,12,549,0,0
"Australia","2024-09-14",0,0,489,0,12,561,0,0
"Australia","2024-09-15",0,84,573,0,12,573,0,0
"Australia","2024-09-16",0,0,573,0,13,586,0,0
"Australia","2024-09-17",0,0,573,0,13,599,0,0
"Australia","2024-09-18",0,0,573,0,13,612,0,0
"Australia","2024-09-19",0,0,573,0,14,626,0,0
"Australia","2024-09-20",0,0,573,0,13,639,0,0
"Australia","2024-09-21",0,0,573,0,13,652,0,0
"Australia","2024-09-22",0,92,665,0,13,665,0,0
"Australia","2024-09-23",0,0,665,0,13,678,0,0
"Australia","2024-09-24",0,0,665,0,13,691,0,0
"Australia","2024-09-25",0,0,665,0,13,704,0,0
"Australia","2024-09-26",0,0,665,0,13,717,0,0
"Australia","2024-09-27",0,0,665,0,13,730,0,0
"Australia","2024-09-28",0,0,665,0,13,743,0,0
"Australia","2024-09-29",0,91,756,0,13,756,0,0
"Australia","2024-09-30",0,0,756,0,10,766,0,0
"Australia","2024-10-01",0,0,756,0,11,777,0,0
"Australia","2024-10-02",0,0,756,0,10,787,0,0
"Australia","2024-10-03",0,0,756,0,10,797,0,0
"Australia","2024-10-04",0,0,756,0,10,807,0,0
"Australia","2024-10-05",0,0,756,0,11,818,0,0
"Australia","2024-10-06",0,72,828,0,10,828,0,0
"Australia","2024-10-07",0,23,851,0,23,851,0,0
"Australia","2024-10-08",0,0,851,0,9,860,0,0
"Australia","2024-10-09",0,0,851,0,9,869,0,0
"Australia","2024-10-10",0,0,851,0,9,878,0,0
"Australia","2024-10-11",0,0,851,0,9,887,0,0
"Australia","2024-10-12",0,0,851,0,9,896,0,0
"Australia","2024-10-13",0,54,905,0,9,905,0,0
"Australia","2024-10-14",0,0,905,0,11,916,0,0
"Australia","2024-10-15",0,0,905,0,12,928,0,0
"Australia","2024-10-16",0,0,905,0,11,939,0,0
"Australia","2024-10-17",0,0,905,0,11,950,0,0
"Australia","2024-10-18",0,0,905,0,11,961,0,0
"Australia","2024-10-19",0,0,905,0,12,973,0,0
"Australia","2024-10-20",0,79,984,0,11,984,0,0
"Australia","2024-10-21",0,0,984,0,10,994,0,0
"Australia","2024-10-22",0,0,984,0,9,1003,0,0
"Australia","2024-10-23",0,0,984,0,10,1013,0,0
"Australia","2024-10-24",0,0,984,0,10,1023,0,0
"Australia","2024-10-25",0,0,984,0,10,1033,0,0
"Australia","2024-10-26",0,0,984,0,9,1042,0,0
"Australia","2024-10-27",0,68,1052,0,10,1052,0,0
"Australia","2024-10-28",0,0,1052,0,11,1063,0,0
"Australia","2024-10-29",0,0,1052,0,12,1075,0,0
"Australia","2024-10-30",0,0,1052,0,11,1086,0,0
"Australia","2024-10-31",0,0,1052,0,11,1097,0,0
"Australia","2024-11-01",0,0,1052,0,11,1108,0,0
"Australia","2024-11-02",0,0,1052,0,12,1120,0,0
"Australia","2024-11-03",0,79,1131,0,11,1131,0,0
"Australia","2024-11-04",0,0,1131,0,8,1139,0,0
"Australia","2024-11-05",0,0,1131,0,8,1147,0,0
"Australia","2024-11-06",0,0,1131,0,8,1155,0,0
"Australia","2024-11-07",0,0,1131,0,9,1164,0,0
"Australia","2024-11-08",0,0,1131,0,8,1172,0,0
"Australia","2024-11-09",0,0,1131,0,8,1180,0,0
"Australia","2024-11-10",0,57,1188,0,8,1188,0,0
"Australia","2024-11-11",0,0,1188,0,7,1195,0,0
"Australia","2024-11-12",0,0,1188,0,7,1202,0,0
"Australia","2024-11-13",0,0,1188,0,7,1209,0,0
"Australia","2024-11-14",0,0,1188,0,7,1216,0,0
"Australia","2024-11-15",0,0,1188,0,7,1223,0,0
"Australia","2024-11-16",0,0,1188,0,7,1230,0,0
"Australia","2024-11-17",0,49,1237,0,7,1237,0,0
"Australia","2024-11-18",0,0,1237,0,4,1241,0,0
"Australia","2024-11-19",0,0,1237,0,4,1245,0,0
"Australia","2024-11-20",0,0,1237,0,4,1249,0,0
"Australia","2024-11-21",0,0,1237,0,5,1254,0,0
"Australia","2024-11-22",0,0,1237,0,4,1258,0,0
"Australia","2024-11-23",0,0,1237,0,4,1262,0,0
"Australia","2024-11-24",0,29,1266,0,4,1266,0,0
"Australia","2024-11-25",0,0,1266,0,5,1271,0,0
"Australia","2024-11-26",0,0,1266,0,5,1276,0,0
"Australia","2024-11-27",0,0,1266,0,5,1281,0,0
"Australia","2024-11-28",0,0,1266,0,4,1285,0,0
"Australia","2024-11-29",0,0,1266,0,5,1290,0,0
"Australia","2024-11-30",0,0,1266,0,5,1295,0,0
"Australia","2024-12-01",0,34,1300,0,5,1300,0,0
"Australia","2024-12-02",0,0,1300,0,3,1303,0,0
"Australia","2024-12-03",0,0,1300,0,3,1306,0,0
"Australia","2024-12-04",0,0,1300,0,4,1310,0,0
"Australia","2024-12-05",0,0,1300,0,3,1313,0,0
"Australia","2024-12-06",0,0,1300,0,3,1316,0,0
"Australia","2024-12-07",0,0,1300,0,4,1320,0,0
"Australia","2024-12-08",0,0,1300,0,3,1323,0,0
"Australia","2024-12-09",0,26,1326,0,3,1326,0,0
"Australia","2024-12-10",0,0,1326,0,4,1330,0,0
"Australia","2024-12-11",0,0,1326,0,5,1335,0,0
"Australia","2024-12-12",0,0,1326,0,4,1339,0,0
"Australia","2024-12-13",0,0,1326,0,4,1343,0,0
"Australia","2024-12-14",0,0,1326,0,5,1348,0,0
"Australia","2024-12-15",0,26,1352,0,4,1352,0,0
"Australia","2024-12-16",0,0,1352,0,3,1355,0,0
"Australia","2024-12-17",0,0,1352,0,2,1357,0,0
"Australia","2024-12-18",0,0,1352,0,3,1360,0,0
"Australia","2024-12-19",0,0,1352,0,3,1363,0,0
"Australia","2024-12-20",0,0,1352,0,3,1366,0,0
"Australia","2024-12-21",0,0,1352,0,2,1368,0,0
"Australia","2024-12-22",0,19,1371,0,3,1371,0,0
"Australia","2024-12-23",0,0,1371,0,2,1373,0,0
"Australia","2024-12-24",0,0,1371,0,2,1375,0,0
"Australia","2024-12-25",0,0,1371,0,2,1377,0,0
"Australia","2024-12-26",0,0,1371,0,1,1378,0,0
"Australia","2024-12-27",0,0,1371,0,2,1380,0,0
"Australia","2024-12-28",0,0,1371,0,2,1382,0,0
"Australia","2024-12-29",0,13,1384,0,2,1384,0,0
"Australia","2024-12-30",0,0,1384,0,2,1386,0,0
"Australia","2024-12-31",0,0,1384,0,1,1387,0,0
"Australia","2025-01-01",0,0,1384,0,2,1389,0,0
"Australia","2025-01-02",0,0,1384,0,2,1391,0,0
"Australia","2025-01-03",0,0,1384,0,2,1393,0,0
"Australia","2025-01-04",0,0,1384,0,1,1394,0,0
"Australia","2025-01-05",0,12,1396,0,2,1396,0,0
"Australia","2025-01-06",0,0,1396,0,4,1400,0,0
"Australia","2025-01-07",0,0,1396,0,4,1404,0,0
"Australia","2025-01-08",0,0,1396,0,4,1408,0,0
"Australia","2025-01-09",0,0,1396,0,3,1411,0,0
"Australia","2025-01-10",0,0,1396,0,4,1415,0,0
"Australia","2025-01-11",0,0,1396,0,4,1419,0,0
"Australia","2025-01-12",0,27,1423,0,4,1423,0,0
"Australia","2025-01-13",0,0,1423,0,5,1428,0,0
"Australia","2025-01-14",0,0,1423,0,4,1432,0,0
"Australia","2025-01-15",0,0,1423,0,5,1437,0,0
"Australia","2025-01-16",0,0,1423,0,4,1441,0,0
"Australia","2025-01-17",0,0,1423,0,5,1446,0,0
"Australia","2025-01-18",0,0,1423,0,4,1450,0,0
"Australia","2025-01-19",0,32,1455,0,5,1455,0,0
"Australia","2025-01-20",0,0,1455,0,0,1455,0,0
"Australia","2025-01-21",0,0,1455,0,0,1455,0,0
"Australia","2025-01-22",0,0,1455,0,0,1455,0,0
"Australia","2025-01-23",0,0,1455,0,0,1455,0,0
"Australia","2025-01-24",0,0,1455,0,0,1455,0,0
"Australia","2025-01-25",0,0,1455,0,0,1455,0,0
"Australia","2025-01-26",0,0,1455,0,0,1455,0,0
"Australia","2025-01-27",0,0,1455,0,0,1455,0,0
"Australia","2025-01-28",0,0,1455,0,0,1455,0,0
"Australia","2025-01-29",0,0,1455,0,0,1455,0,0
"Australia","2025-01-30",0,0,1455,0,0,1455,0,0
"Australia","2025-01-31",0,0,1455,0,0,1455,0,0
"Australia","2025-02-01",0,0,1455,0,0,1455,0,0
"Australia","2025-02-02",0,0,1455,0,0,1455,0,0
"Australia","2025-02-03",0,0,1455,0,0,1455,0,0
"Austria","2024-01-01",0,0,0,0,0,0,0,0
"Austria","2024-01-02",0,0,0,0,0,0,0,0
"Austria","2024-01-03",0,0,0,0,0,0,0,0
"Austria","2024-01-04",0,0,0,0,0,0,0,0
"Austria","2024-01-05",0,0,0,0,0,0,0,0
"Austria","2024-01-06",0,0,0,0,0,0,0,0
"Austria","2024-01-07",0,0,0,0,0,0,0,0
"Austria","2024-01-08",0,0,0,0,0,0,0,0
"Austria","2024-01-09",0,0,0,0,0,0,0,0
"Austria","2024-01-10",0,0,0,0,0,0,0,0
"Austria","2024-01-11",0,0,0,0,0,0,0,0
"Austria","2024-01-12",0,0,0,0,0,0,0,0
"Austria","2024-01-13",0,0,0,0,0,0,0,0
"Austria","2024-01-14",0,0,0,0,0,0,0,0
"Austria","2024-01-15",0,0,0,0,0,0,0,0
"Austria","2024-01-16",0,0,0,0,0,0,0,0
"Austria","2024-01-17",0,0,0,0,0,0,0,0
"Austria","2024-01-18",0,0,0,0,0,0,0,0
"Austria","2024-01-19",0,0,0,0,0,0,0,0
"Austria","2024-01-20",0,0,0,0,0,0,0,0
"Austria","2024-01-21",0,0,0,0,0,0,0,0
"Austria","2024-01-22",0,0,0,0,0,0,0,0
"Austria","2024-01-23",0,0,0,0,0,0,0,0
"Austria","2024-01-24",0,0,0,0,0,0,0,0
"Austria","2024-01-25",0,0,0,0,0,0,0,0
"Austria","2024-01-26",0,0,0,0,0,0,0,0
"Austria","2024-01-27",0,0,0,0,0,0,0,0
"Austria","2024-01-28",0,0,0,0,0,0,0,0
"Austria","2024-01-29",0,0,0,0,0,0,0,0
"Austria","2024-01-30",0,0,0,0,0,0,0,0
"Austria","2024-01-31",0,3,3,0,3,3,0,0
"Austria","2024-02-01",0,0,3,0,0,3,0,0
"Austria","2024-02-02",0,0,3,0,0,3,0,0
"Austria","2024-02-03",0,0,3,0,0,3,0,0
"Austria","2024-02-04",0,0,3,0,1,4,0,0
"Austria","2024-02-05",0,0,3,0,0,4,0,0
"Austria","2024-02-06",0,0,3,0,0,4,0,0
"Austria","2024-02-07",0,0,3,0,0,4,0,0
"Austria","2024-02-08",0,0,3,0,0,4,0,0
"Austria","2024-02-09",0,0,3,0,0,4,0,0
"Austria","2024-02-10",0,0,3,0,0,4,0,0
"Austria","2024-02-11",0,0,3,0,1,5,0,0
"Austria","2024-02-12",0,0,3,0,0,5,0,0
"Austria","2024-02-13",0,0,3,0,0,5,0,0
"Austria","2024-02-14",0,0,3,0,0,5,0,0
"Austria","2024-02-15",0,0,3,0,0,5,0,0
"Austria","2024-02-16",0,0,3,0,0,5,0,0
"Austria","2024-02-17",0,0,3,0,0,5,0,0
"Austria","2024-02-18",0,0,3,0,0,5,0,0
"Austria","2024-02-19",0,0,3,0,1,6,0,0
"Austria","2024-02-20",0,0,3,0,0,6,0,0
"Austria","2024-02-21",0,0,3,0,0,6,0,0
"Austria","2024-02-22",0,0,3,0,0,6,0,0
"Austria","2024-02-23",0,0,3,0,0,6,0,0
"Austria","2024-02-24",0,0,3,0,0,6,0,0
"Austria","2024-02-25",0,0,3,0,0,6,0,0
"Austria","2024-02-26",0,0,3,0,1,7,0,0
"Austria","2024-02-27",0,0,3,0,0,7,0,0
"Austria","2024-02-28",0,0,3,0,0,7,0,0
"Austria","2024-02-29",0,4,7,0,0,7,0,0
"Austria","2024-03-01",0,0,7,0,0,7,0,0
"Austria","2024-03-02",0,0,7,0,0,7,0,0
"Austria","2024-03-03",0,0,7,0,0,7,0,0
"Austria","2024-03-04",0,0,7,0,0,7,0,0
"Austria","2024-03-05",0,0,7,0,0,7,0,0
"Austria","2024-03-06",0,0,7,0,0,7,0,0
"Austria","2024-03-07",0,0,7,0,0,7,0,0
"Austria","2024-03-08",0,0,7,0,0,7,0,0
"Austria","2024-03-09",0,0,7,0,0,7,0,0
"Austria","2024-03-10",0,0,7,0,0,7,0,0
"Austria","2024-03-11",0,0,7,0,0,7,0,0
"Austria","2024-03-12",0,0,7,0,0,7,0,0
"Austria","2024-03-13",0,0,7,0,0,7,0,0
"Austria","2024-03-14",0,0,7,0,0,7,0,0
"Austria","2024-03-15",0,0,7,0,0,7,0,0
"Austria","2024-03-16",0,0,7,0,0,7,0,0
"Austria","2024-03-17",0,0,7,0,0,7,0,0
"Austria","2024-03-18",0,0,7,0,0,7,0,0
"Austria","2024-03-19",0,0,7,0,0,7,0,0
"Austria","2024-03-20",0,0,7,0,0,7,0,0
"Austria","2024-03-21",0,0,7,0,0,7,0,0
"Austria","2024-03-22",0,0,7,0,0,7,0,0
"Austria","2024-03-23",0,0,7,0,0,7,0,0
"Austria","2024-03-24",0,0,7,0,0,7,0,0
"Austria","2024-03-25",0,0,7,0,0,7,0,0
"Austria","2024-03-26",0,0,7,0,0,7,0,0
"Austria","2024-03-27",0,0,7,0,0,7,0,0
"Austria","2024-03-28",0,0,7,0,0,7,0,0
"Austria","2024-03-29",0,0,7,0,0,7,0,0
"Austria","2024-03-30",0,0,7,0,0,7,0,0
"Austria","2024-03-31",0,0,7,0,1,8,0,0
"Austria","2024-04-01",0,0,7,0,0,8,0,0
"Austria","2024-04-02",0,0,7,0,0,8,0,0
"Austria","2024-04-03",0,0,7,0,0,8,0,0
"Austria","2024-04-04",0,0,7,0,0,8,0,0
"Austria","2024-04-05",0,0,7,0,0,8,0,0
"Austria","2024-04-06",0,0,7,0,0,8,0,0
"Austria","2024-04-07",0,0,7,0,0,8,0,0
"Austria","2024-04-08",0,0,7,0,0,8,0,0
"Austria","2024-04-09",0,0,7,0,0,8,0,0
"Austria","2024-04-10",0,0,7,0,0,8,0,0
"Austria","2024-04-11",0,0,7,0,0,8,0,0
"Austria","2024-04-12",0,0,7,0,0,8,0,0
"Austria","2024-04-13",0,0,7,0,0,8,0,0
"Austria","2024-04-14",0,0,7,0,0,8,0,0
"Austria","2024-04-15",0,0,7,0,0,8,0,0
"Austria","2024-04-16",0,0,7,0,0,8,0,0
"Austria","2024-04-17",0,0,7,0,0,8,0,0
"Austria","2024-04-18",0,0,7,0,0,8,0,0
"Austria","2024-04-19",0,0,7,0,0,8,0,0
"Austria","2024-04-20",0,0,7,0,0,8,0,0
"Austria","2024-04-21",0,0,7,0,0,8,0,0
"Austria","2024-04-22",0,0,7,0,0,8,0,0
"Austria","2024-04-23",0,0,7,0,0,8,0,0
"Austria","2024-04-24",0,0,7,0,0,8,0,0
"Austria","2024-04-25",0,0,7,0,0,8,0,0
"Austria","2024-04-26",0,0,7,0,0,8,0,0
"Austria","2024-04-27",0,0,7,0,0,8,0,0
"Austria","2024-04-28",0,0,7,0,0,8,0,0
"Austria","2024-04-29",0,0,7,0,0,8,0,0
"Austria","2024-04-30",0,1,8,0,0,8,0,0
"Austria","2024-05-01",0,0,8,0,0,8,0,0
"Austria","2024-05-02",0,0,8,0,0,8,0,0
"Austria","2024-05-03",0,0,8,0,0,8,0,0
"Austria","2024-05-04",0,0,8,0,0,8,0,0
"Austria","2024-05-05",0,0,8,0,0,8,0,0
"Austria","2024-05-06",0,0,8,0,0,8,0,0
"Austria","2024-05-07",0,0,8,0,0,8,0,0
"Austria","2024-05-08",0,0,8,0,1,9,0,0
"Austria","2024-05-09",0,0,8,0,0,9,0,0
"Austria","2024-05-10",0,0,8,0,0,9,0,0
"Austria","2024-05-11",0,0,8,0,0,9,0,0
"Austria","2024-05-12",0,0,8,0,0,9,0,0
"Austria","2024-05-13",0,0,8,0,0,9,0,0
"Austria","2024-05-14",0,0,8,0,0,9,0,0
"Austria","2024-05-15",0,0,8,0,0,9,0,0
"Austria","2024-05-16",0,0,8,0,0,9,0,0
"Austria","2024-05-17",0,0,8,0,0,9,0,0
"Austria","2024-05-18",0,0,8,0,0,9,0,0
"Austria","2024-05-19",0,0,8,0,0,9,0,0
"Austria","2024-05-20",0,0,8,0,0,9,0,0
"Austria","2024-05-21",0,0,8,0,0,9,0,0
"Austria","2024-05-22",0,0,8,0,0,9,0,0
"Austria","2024-05-23",0,0,8,0,0,9,0,0
"Austria","2024-05-24",0,0,8,0,1,10,0,0
"Austria","2024-05-25",0,0,8,0,0,10,0,0
"Austria","2024-05-26",0,0,8,0,0,10,0,0
"Austria","2024-05-27",0,0,8,0,0,10,0,0
"Austria","2024-05-28",0,0,8,0,0,10,0,0
"Austria","2024-05-29",0,0,8,0,0,10,0,0
"Austria","2024-05-30",0,0,8,0,0,10,0,0
"Austria","2024-05-31",0,2,10,0,0,10,0,0
"Austria","2024-06-01",0,0,10,0,0,10,0,0
"Austria","2024-06-02",0,0,10,0,0,10,0,0
"Austria","2024-06-03",0,0,10,0,0,10,0,0
"Austria","2024-06-04",0,0,10,0,0,10,0,0
"Austria","2024-06-05",0,0,10,0,0,10,0,0
"Austria","2024-06-06",0,0,10,0,0,10,0,0
"Austria","2024-06-07",0,0,10,0,0,10,0,0
"Austria","2024-06-08",0,0,10,0,0,10,0,0
"Austria","2024-06-09",0,0,10,0,0,10,0,0
"Austria","2024-06-10",0,0,10,0,0,10,0,0
"Austria","2024-06-11",0,0,10,0,0,10,0,0
"Austria","2024-06-12",0,0,10,0,0,10,0,0
"Austria","2024-06-13",0,0,10,0,0,10,0,0
"Austria","2024-06-14",0,0,10,0,0,10,0,0
"Austria","2024-06-15",0,0,10,0,0,10,0,0
"Austria","2024-06-16",0,0,10,0,0,10,0,0
"Austria","2024-06-17",0,0,10,0,0,10,0,0
"Austria","2024-06-18",0,0,10,0,0,10,0,0
"Austria","2024-06-19",0,0,10,0,0,10,0,0
"Austria","2024-06-20",0,0,10,0,0,10,0,0
"Austria","2024-06-21",0,0,10,0,0,10,0,0
"Austria","2024-06-22",0,0,10,0,0,10,0,0
"Austria","2024-06-23",0,0,10,0,0,10,0,0
"Austria","2024-06-24",0,0,10,0,1,11,0,0
"Austria","2024-06-25",0,0,10,0,0,11,0,0
"Austria","2024-06-26",0,0,10,0,0,11,0,0
"Austria","2024-06-27",0,0,10,0,0,11,0,0
"Austria","2024-06-28",0,0,10,0,0,11,0,0
"Austria","2024-06-29",0,0,10,0,0,11,0,0
"Austria","2024-06-30",0,0,10,0,0,11,0,0
"Austria","2024-07-01",0,0,10,0,0,11,0,0
"Austria","2024-07-02",0,0,10,0,0,11,0,0
"Austria","2024-07-03",0,0,10,0,0,11,0,0
"Austria","2024-07-04",0,0,10,0,0,11,0,0
"Austria","2024-07-05",0,0,10,0,0,11,0,0
"Austria","2024-07-06",0,0,10,0,0,11,0,0
"Austria","2024-07-07",0,0,10,0,0,11,0,0
"Austria","2024-07-08",0,0,10,0,0,11,0,0
"Austria","2024-07-09",0,0,10,0,0,11,0,0
"Austria","2024-07-10",0,0,10,0,0,11,0,0
"Austria","2024-07-11",0,0,10,0,0,11,0,0
"Austria","2024-07-12",0,0,10,0,0,11,0,0
"Austria","2024-07-13",0,0,10,0,0,11,0,0
"Austria","2024-07-14",0,0,10,0,0,11,0,0
"Austria","2024-07-15",0,0,10,0,0,11,0,0
"Austria","2024-07-16",0,0,10,0,0,11,0,0
"Austria","2024-07-17",0,0,10,0,0,11,0,0
"Austria","2024-07-18",0,0,10,0,0,11,0,0
"Austria","2024-07-19",0,0,10,0,0,11,0,0
"Austria","2024-07-20",0,0,10,0,0,11,0,0
"Austria","2024-07-21",0,0,10,0,0,11,0,0
"Austria","2024-07-22",0,0,10,0,0,11,0,0
"Austria","2024-07-23",0,0,10,0,0,11,0,0
"Austria","2024-07-24",0,0,10,0,0,11,0,0
"Austria","2024-07-25",0,0,10,0,0,11,0,0
"Austria","2024-07-26",0,0,10,0,0,11,0,0
"Austria","2024-07-27",0,0,10,0,0,11,0,0
"Austria","2024-07-28",0,0,10,0,0,11,0,0
"Austria","2024-07-29",0,0,10,0,0,11,0,0
"Austria","2024-07-30",0,0,10,0,0,11,0,0
"Austria","2024-07-31",0,0,10,0,0,11,0,0
"Austria","2024-08-01",0,0,10,0,0,11,0,0
"Austria","2024-08-02",0,0,10,0,0,11,0,0
"Austria","2024-08-03",0,0,10,0,0,11,0,0
"Austria","2024-08-04",0,0,10,0,0,11,0,0
"Austria","2024-08-05",0,0,10,0,0,11,0,0
"Austria","2024-08-06",0,0,10,0,0,11,0,0
"Austria","2024-08-07",0,0,10,0,0,11,0,0
"Austria","2024-08-08",0,0,10,0,1,12,0,0
"Austria","2024-08-09",0,0,10,0,0,12,0,0
"Austria","2024-08-10",0,0,10,0,0,12,0,0
"Austria","2024-08-11",0,0,10,0,0,12,0,0
"Austria","2024-08-12",0,0,10,0,0,12,0,0
"Austria","2024-08-13",0,0,10,0,0,12,0,0
"Austria","2024-08-14",0,0,10,0,0,12,0,0
"Austria","2024-08-15",0,0,10,0,0,12,0,0
"Austria","2024-08-16",0,0,10,0,0,12,0,0
"Austria","2024-08-17",0,0,10,0,0,12,0,0
"Austria","2024-08-18",0,0,10,0,0,12,0,0
"Austria","2024-08-19",0,0,10,0,0,12,0,0
"Austria","2024-08-20",0,0,10,0,0,12,0,0
"Austria","2024-08-21",0,0,10,0,0,12,0,0
"Austria","2024-08-22",0,0,10,0,0,12,0,0
"Austria","2024-08-23",0,0,10,0,0,12,0,0
"Austria","2024-08-24",0,0,10,0,0,12,0,0
"Austria","2024-08-25",0,0,10,0,0,12,0,0
"Austria","2024-08-26",0,0,10,0,0,12,0,0
"Austria","2024-08-27",0,0,10,0,0,12,0,0
"Austria","2024-08-28",0,0,10,0,0,12,0,0
"Austria","2024-08-29",0,0,10,0,0,12,0,0
"Austria","2024-08-30",0,0,10,0,0,12,0,0
"Austria","2024-08-31",0,2,12,0,0,12,0,0
"Austria","2024-09-01",0,0,12,0,0,12,0,0
"Austria","2024-09-02",0,0,12,0,0,12,0,0
"Austria","2024-09-03",0,0,12,0,0,12,0,0
"Austria","2024-09-04",0,0,12,0,0,12,0,0
"Austria","2024-09-05",0,0,12,0,0,12,0,0
"Austria","2024-09-06",0,0,12,0,1,13,0,0
"Austria","2024-09-07",0,0,12,0,0,13,0,0
"Austria","2024-09-08",0,0,12,0,0,13,0,0
"Austria","2024-09-09",0,0,12,0,0,13,0,0
"Austria","2024-09-10",0,0,12,0,0,13,0,0
"Austria","2024-09-11",0,0,12,0,0,13,0,0
"Austria","2024-09-12",0,0,12,0,0,13,0,0
"Austria","2024-09-13",0,0,12,0,0,13,0,0
"Austria","2024-09-14",0,0,12,0,0,13,0,0
"Austria","2024-09-15",0,0,12,0,1,14,0,0
"Austria","2024-09-16",0,0,12,0,0,14,0,0
"Austria","2024-09-17",0,0,12,0,0,14,0,0
"Austria","2024-09-18",0,0,12,0,0,14,0,0
"Austria","2024-09-19",0,0,12,0,0,14,0,0
"Austria","2024-09-20",0,0,12,0,0,14,0,0
"Austria","2024-09-21",0,0,12,0,0,14,0,0
"Austria","2024-09-22",0,0,12,0,0,14,0,0
"Austria","2024-09-23",0,0,12,0,0,14,0,0
"Austria","2024-09-24",0,0,12,0,0,14,0,0
"Austria","2024-09-25",0,0,12,0,0,14,0,0
"Austria","2024-09-26",0,0,12,0,1,15,0,0
"Austria","2024-09-27",0,0,12,0,0,15,0,0
"Austria","2024-09-28",0,0,12,0,0,15,0,0
"Austria","2024-09-29",0,0,12,0,0,15,0,0
"Austria","2024-09-30",0,3,15,0,0,15,0,0
"Austria","2024-10-01",0,0,15,0,0,15,0,0
"Austria","2024-10-02",0,0,15,0,0,15,0,0
"Austria","2024-10-03",0,0,15,0,0,15,0,0
"Austria","2024-10-04",0,0,15,0,0,15,0,0
"Austria","2024-10-05",0,0,15,0,0,15,0,0
"Austria","2024-10-06",0,0,15,0,1,16,0,0
"Austria","2024-10-07",0,0,15,0,0,16,0,0
"Austria","2024-10-08",0,0,15,0,0,16,0,0
"Austria","2024-10-09",0,0,15,0,0,16,0,0
"Austria","2024-10-10",0,0,15,0,0,16,0,0
"Austria","2024-10-11",0,0,15,0,0,16,0,0
"Austria","2024-10-12",0,0,15,0,0,16,0,0
"Austria","2024-10-13",0,0,15,0,0,16,0,0
"Austria","2024-10-14",0,0,15,0,0,16,0,0
"Austria","2024-10-15",0,0,15,0,0,16,0,0
"Austria","2024-10-16",0,0,15,0,1,17,0,0
"Austria","2024-10-17",0,0,15,0,0,17,0,0
"Austria","2024-10-18",0,0,15,0,0,17,0,0
"Austria","2024-10-19",0,0,15,0,0,17,0,0
"Austria","2024-10-20",0,0,15,0,0,17,0,0
"Austria","2024-10-21",0,0,15,0,0,17,0,0
"Austria","2024-10-22",0,0,15,0,0,17,0,0
"Austria","2024-10-23",0,0,15,0,0,17,0,0
"Austria","2024-10-24",0,0,15,0,0,17,0,0
"Austria","2024-10-25",0,0,15,0,0,17,0,0
"Austria","2024-10-26",0,0,15,0,1,18,0,0
"Austria","2024-10-27",0,0,15,0,0,18,0,0
"Austria","2024-10-28",0,0,15,0,0,18,0,0
"Austria","2024-10-29",0,0,15,0,0,18,0,0
"Austria","2024-10-30",0,0,15,0,0,18,0,0
"Austria","2024-10-31",0,3,18,0,0,18,0,0
"Austria","2024-11-01",0,0,18,0,0,18,0,0
"Austria","2024-11-02",0,0,18,0,0,18,0,0
"Austria","2024-11-03",0,0,18,0,1,19,0,0
"Austria","2024-11-04",0,0,18,0,0,19,0,0
"Austria","2024-11-05",0,0,18,0,0,19,0,0
"Austria","2024-11-06",0,0,18,0,0,19,0,0
"Austria","2024-11-07",0,0,18,0,1,20,0,0
"Austria","2024-11-08",0,0,18,0,0,20,0,0
"Austria","2024-11-09",0,0,18,0,0,20,0,0
"Austria","2024-11-10",0,0,18,0,0,20,0,0
"Austria","2024-11-11",0,0,18,0,1,21,0,0
"Austria","2024-11-12",0,0,18,0,0,21,0,0
"Austria","2024-11-13",0,0,18,0,0,21,0,0
"Austria","2024-11-14",0,0,18,0,0,21,0,0
"Austria","2024-11-15",0,0,18,0,1,22,0,0
"Austria","2024-11-16",0,0,18,0,0,22,0,0
"Austria","2024-11-17",0,0,18,0,0,22,0,0
"Austria","2024-11-18",0,0,18,0,0,22,0,0
"Austria","2024-11-19",0,0,18,0,0,22,0,0
"Austria","2024-11-20",0,0,18,0,1,23,0,0
"Austria","2024-11-21",0,0,18,0,0,23,0,0
"Austria","2024-11-22",0,0,18,0,0,23,0,0
"Austria","2024-11-23",0,0,18,0,0,23,0,0
"Austria","2024-11-24",0,0,18,0,1,24,0,0
"Austria","2024-11-25",0,0,18,0,0,24,0,0
"Austria","2024-11-26",0,0,18,0,0,24,0,0
"Austria","2024-11-27",0,0,18,0,0,24,0,0
"Austria","2024-11-28",0,0,18,0,1,25,0,0
"Austria","2024-11-29",0,0,18,0,0,25,0,0
"Austria","2024-11-30",0,7,25,0,0,25,0,0
"Austria","2024-12-01",0,0,25,0,0,25,0,0
"Austria","2024-12-02",0,0,25,0,0,25,0,0
"Austria","2024-12-03",0,0,25,0,0,25,0,0
"Austria","2024-12-04",0,0,25,0,1,26,0,0
"Austria","2024-12-05",0,0,25,0,0,26,0,0
"Austria","2024-12-06",0,0,25,0,0,26,0,0
"Austria","2024-12-07",0,0,25,0,0,26,0,0
"Austria","2024-12-08",0,0,25,0,0,26,0,0
"Austria","2024-12-09",0,0,25,0,0,26,0,0
"Austria","2024-12-10",0,0,25,0,0,26,0,0
"Austria","2024-12-11",0,0,25,0,0,26,0,0
"Austria","2024-12-12",0,0,25,0,1,27,0,0
"Austria","2024-12-13",0,0,25,0,0,27,0,0
"Austria","2024-12-14",0,0,25,0,0,27,0,0
"Austria","2024-12-15",0,0,25,0,0,27,0,0
"Austria","2024-12-16",0,0,25,0,0,27,0,0
"Austria","2024-12-17",0,0,25,0,0,27,0,0
"Austria","2024-12-18",0,0,25,0,0,27,0,0
"Austria","2024-12-19",0,0,25,0,0,27,0,0
"Austria","2024-12-20",0,0,25,0,1,28,0,0
"Austria","2024-12-21",0,0,25,0,0,28,0,0
"Austria","2024-12-22",0,0,25,0,0,28,0,0
"Austria","2024-12-23",0,0,25,0,0,28,0,0
"Austria","2024-12-24",0,0,25,0,0,28,0,0
"Austria","2024-12-25",0,0,25,0,0,28,0,0
"Austria","2024-12-26",0,0,25,0,0,28,0,0
"Austria","2024-12-27",0,0,25,0,0,28,0,0
"Austria","2024-12-28",0,0,25,0,1,29,0,0
"Austria","2024-12-29",0,0,25,0,0,29,0,0
"Austria","2024-12-30",0,0,25,0,0,29,0,0
"Austria","2024-12-31",0,4,29,0,0,29,0,0
"Austria","2025-01-01",0,0,29,0,0,29,0,0
"Austria","2025-01-02",0,0,29,0,0,29,0,0
"Austria","2025-01-03",0,0,29,0,0,29,0,0
"Austria","2025-01-04",0,0,29,0,0,29,0,0
"Austria","2025-01-05",0,0,29,0,0,29,0,0
"Austria","2025-01-06",0,0,29,0,0,29,0,0
"Austria","2025-01-07",0,0,29,0,0,29,0,0
"Austria","2025-01-08",0,0,29,0,0,29,0,0
"Austria","2025-01-09",0,0,29,0,0,29,0,0
"Austria","2025-01-10",0,0,29,0,0,29,0,0
"Austria","2025-01-11",0,0,29,0,0,29,0,0
"Austria","2025-01-12",0,0,29,0,0,29,0,0
"Austria","2025-01-13",0,0,29,0,0,29,0,0
"Austria","2025-01-14",0,0,29,0,0,29,0,0
"Austria","2025-01-15",0,0,29,0,0,29,0,0
"Austria","2025-01-16",0,0,29,0,0,29,0,0
"Austria","2025-01-17",0,0,29,0,0,29,0,0
"Austria","2025-01-18",0,0,29,0,0,29,0,0
"Austria","2025-01-19",0,0,29,0,0,29,0,0
"Austria","2025-01-20",0,0,29,0,0,29,0,0
"Austria","2025-01-21",0,0,29,0,0,29,0,0
"Austria","2025-01-22",0,0,29,0,0,29,0,0
"Austria","2025-01-23",0,0,29,0,0,29,0,0
"Austria","2025-01-24",0,0,29,0,0,29,0,0
"Austria","2025-01-25",0,0,29,0,0,29,0,0
"Austria","2025-01-26",0,0,29,0,0,29,0,0
"Austria","2025-01-27",0,0,29,0,0,29,0,0
"Austria","2025-01-28",0,0,29,0,0,29,0,0
"Austria","2025-01-29",0,0,29,0,0,29,0,0
"Austria","2025-01-30",0,0,29,0,0,29,0,0
"Austria","2025-01-31",0,0,29,0,0,29,0,0
"Austria","2025-02-01",0,0,29,0,0,29,0,0
"Austria","2025-02-02",0,0,29,0,0,29,0,0
"Austria","2025-02-03",0,0,29,0,0,29,0,0
"Bahamas","2024-01-01",0,0,0,0,0,0,0,0
"Bahamas","2024-01-02",0,0,0,0,0,0,0,0
"Bahamas","2024-01-03",0,0,0,0,0,0,0,0
"Bahamas","2024-01-04",0,0,0,0,0,0,0,0
"Bahamas","2024-01-05",0,0,0,0,0,0,0,0
"Bahamas","2024-01-06",0,0,0,0,0,0,0,0
"Bahamas","2024-01-07",0,0,0,0,0,0,0,0
"Bahamas","2024-01-08",0,0,0,0,0,0,0,0
"Bahamas","2024-01-09",0,0,0,0,0,0,0,0
"Bahamas","2024-01-10",0,0,0,0,0,0,0,0
"Bahamas","2024-01-11",0,0,0,0,0,0,0,0
"Bahamas","2024-01-12",0,0,0,0,0,0,0,0
"Bahamas","2024-01-13",0,0,0,0,0,0,0,0
"Bahamas","2024-01-14",0,0,0,0,0,0,0,0
"Bahamas","2024-01-15",0,0,0,0,0,0,0,0
"Bahamas","2024-01-16",0,0,0,0,0,0,0,0
"Bahamas","2024-01-17",0,0,0,0,0,0,0,0
"Bahamas","2024-01-18",0,0,0,0,0,0,0,0
"Bahamas","2024-01-19",0,0,0,0,0,0,0,0
"Bahamas","2024-01-20",0,0,0,0,0,0,0,0
"Bahamas","2024-01-21",0,0,0,0,0,0,0,0
"Bahamas","2024-01-22",0,0,0,0,0,0,0,0
"Bahamas","2024-01-23",0,0,0,0,0,0,0,0
"Bahamas","2024-01-24",0,0,0,0,0,0,0,0
"Bahamas","2024-01-25",0,0,0,0,0,0,0,0
"Bahamas","2024-01-26",0,0,0,0,0,0,0,0
"Bahamas","2024-01-27",0,0,0,0,0,0,0,0
"Bahamas","2024-01-28",0,0,0,0,0,0,0,0
"Bahamas","2024-01-29",0,0,0,0,0,0,0,0
"Bahamas","2024-01-30",0,0,0,0,0,0,0,0
"Bahamas","2024-01-31",0,0,0,0,0,0,0,0
"Bahamas","2024-02-01",0,0,0,0,0,0,0,0
"Bahamas","2024-02-02",0,0,0,0,0,0,0,0
"Bahamas","2024-02-03",0,0,0,0,0,0,0,0
"Bahamas","2024-02-04",0,0,0,0,0,0,0,0
"Bahamas","2024-02-05",0,0,0,0,0,0,0,0
"Bahamas","2024-02-06",0,0,0,0,0,0,0,0
"Bahamas","2024-02-07",0,0,0,0,0,0,0,0
"Bahamas","2024-02-08",0,0,0,0,0,0,0,0
"Bahamas","2024-02-09",0,0,0,0,0,0,0,0
"Bahamas","2024-02-10",0,0,0,0,0,0,0,0
"Bahamas","2024-02-11",0,0,0,0,0,0,0,0
"Bahamas","2024-02-12",0,0,0,0,0,0,0,0
"Bahamas","2024-02-13",0,0,0,0,0,0,0,0
"Bahamas","2024-02-14",0,0,0,0,0,0,0,0
"Bahamas","2024-02-15",0,0,0,0,0,0,0,0
"Bahamas","2024-02-16",0,0,0,0,0,0,0,0
"Bahamas","2024-02-17",0,0,0,0,0,0,0,0
"Bahamas","2024-02-18",0,0,0,0,0,0,0,0
"Bahamas","2024-02-19",0,0,0,0,0,0,0,0
"Bahamas","2024-02-20",0,0,0,0,0,0,0,0
"Bahamas","2024-02-21",0,0,0,0,0,0,0,0
"Bahamas","2024-02-22",0,0,0,0,0,0,0,0
"Bahamas","2024-02-23",0,0,0,0,0,0,0,0
"Bahamas","2024-02-24",0,0,0,0,0,0,0,0
"Bahamas","2024-02-25",0,0,0,0,0,0,0,0
"Bahamas","2024-02-26",0,0,0,0,0,0,0,0
"Bahamas","2024-02-27",0,0,0,0,0,0,0,0
"Bahamas","2024-02-28",0,0,0,0,0,0,0,0
"Bahamas","2024-02-29",0,0,0,0,0,0,0,0
"Bahamas","2024-03-01",0,0,0,0,0,0,0,0
"Bahamas","2024-03-02",0,0,0,0,0,0,0,0
"Bahamas","2024-03-03",0,0,0,0,0,0,0,0
"Bahamas","2024-03-04",0,0,0,0,0,0,0,0
"Bahamas","2024-03-05",0,0,0,0,0,0,0,0
"Bahamas","2024-03-06",0,0,0,0,0,0,0,0
"Bahamas","2024-03-07",0,0,0,0,0,0,0,0
"Bahamas","2024-03-08",0,0,0,0,0,0,0,0
"Bahamas","2024-03-09",0,0,0,0,0,0,0,0
"Bahamas","2024-03-10",0,0,0,0,0,0,0,0
"Bahamas","2024-03-11",0,0,0,0,0,0,0,0
"Bahamas","2024-03-12",0,0,0,0,0,0,0,0
"Bahamas","2024-03-13",0,0,0,0,0,0,0,0
"Bahamas","2024-03-14",0,0,0,0,0,0,0,0
"Bahamas","2024-03-15",0,0,0,0,0,0,0,0
"Bahamas","2024-03-16",0,0,0,0,0,0,0,0
"Bahamas","2024-03-17",0,0,0,0,0,0,0,0
"Bahamas","2024-03-18",0,0,0,0,0,0,0,0
"Bahamas","2024-03-19",0,0,0,0,0,0,0,0
"Bahamas","2024-03-20",0,0,0,0,0,0,0,0
"Bahamas","2024-03-21",0,0,0,0,0,0,0,0
"Bahamas","2024-03-22",0,0,0,0,0,0,0,0
"Bahamas","2024-03-23",0,0,0,0,0,0,0,0
"Bahamas","2024-03-24",0,0,0,0,0,0,0,0
"Bahamas","2024-03-25",0,0,0,0,0,0,0,0
"Bahamas","2024-03-26",0,0,0,0,0,0,0,0
"Bahamas","2024-03-27",0,0,0,0,0,0,0,0
"Bahamas","2024-03-28",0,0,0,0,0,0,0,0
"Bahamas","2024-03-29",0,0,0,0,0,0,0,0
"Bahamas","2024-03-30",0,0,0,0,0,0,0,0
"Bahamas","2024-03-31",0,0,0,0,0,0,0,0
"Bahamas","2024-04-01",0,0,0,0,0,0,0,0
"Bahamas","2024-04-02",0,0,0,0,0,0,0,0
"Bahamas","2024-04-03",0,0,0,0,0,0,0,0
"Bahamas","2024-04-04",0,0,0,0,0,0,0,0
"Bahamas","2024-04-05",0,0,0,0,0,0,0,0
"Bahamas","2024-04-06",0,0,0,0,0,0,0,0
"Bahamas","2024-04-07",0,0,0,0,0,0,0,0
"Bahamas","2024-04-08",0,0,0,0,0,0,0,0
"Bahamas","2024-04-09",0,0,0,0,0,0,0,0
"Bahamas","2024-04-10",0,0,0,0,0,0,0,0
"Bahamas","2024-04-11",0,0,0,0,0,0,0,0
"Bahamas","2024-04-12",0,0,0,0,0,0,0,0
"Bahamas","2024-04-13",0,0,0,0,0,0,0,0
"Bahamas","2024-04-14",0,0,0,0,0,0,0,0
"Bahamas","2024-04-15",0,0,0,0,0,0,0,0
"Bahamas","2024-04-16",0,0,0,0,0,0,0,0
"Bahamas","2024-04-17",0,0,0,0,0,0,0,0
"Bahamas","2024-04-18",0,0,0,0,0,0,0,0
"Bahamas","2024-04-19",0,0,0,0,0,0,0,0
"Bahamas","2024-04-20",0,0,0,0,0,0,0,0
"Bahamas","2024-04-21",0,0,0,0,0,0,0,0
"Bahamas","2024-04-22",0,0,0,0,0,0,0,0
"Bahamas","2024-04-23",0,0,0,0,0,0,0,0
"Bahamas","2024-04-24",0,0,0,0,0,0,0,0
"Bahamas","2024-04-25",0,0,0,0,0,0,0,0
"Bahamas","2024-04-26",0,0,0,0,0,0,0,0
"Bahamas","2024-04-27",0,0,0,0,0,0,0,0
"Bahamas","2024-04-28",0,0,0,0,0,0,0,0
"Bahamas","2024-04-29",0,0,0,0,0,0,0,0
"Bahamas","2024-04-30",0,0,0,0,0,0,0,0
"Bahamas","2024-05-01",0,0,0,0,0,0,0,0
"Bahamas","2024-05-02",0,0,0,0,0,0,0,0
"Bahamas","2024-05-03",0,0,0,0,0,0,0,0
"Bahamas","2024-05-04",0,0,0,0,0,0,0,0
"Bahamas","2024-05-05",0,0,0,0,0,0,0,0
"Bahamas","2024-05-06",0,0,0,0,0,0,0,0
"Bahamas","2024-05-07",0,0,0,0,0,0,0,0
"Bahamas","2024-05-08",0,0,0,0,0,0,0,0
"Bahamas","2024-05-09",0,0,0,0,0,0,0,0
"Bahamas","2024-05-10",0,0,0,0,0,0,0,0
"Bahamas","2024-05-11",0,0,0,0,0,0,0,0
"Bahamas","2024-05-12",0,0,0,0,0,0,0,0
"Bahamas","2024-05-13",0,0,0,0,0,0,0,0
"Bahamas","2024-05-14",0,0,0,0,0,0,0,0
"Bahamas","2024-05-15",0,0,0,0,0,0,0,0
"Bahamas","2024-05-16",0,0,0,0,0,0,0,0
"Bahamas","2024-05-17",0,0,0,0,0,0,0,0
"Bahamas","2024-05-18",0,0,0,0,0,0,0,0
"Bahamas","2024-05-19",0,0,0,0,0,0,0,0
"Bahamas","2024-05-20",0,0,0,0,0,0,0,0
"Bahamas","2024-05-21",0,0,0,0,0,0,0,0
"Bahamas","2024-05-22",0,0,0,0,0,0,0,0
"Bahamas","2024-05-23",0,0,0,0,0,0,0,0
"Bahamas","2024-05-24",0,0,0,0,0,0,0,0
"Bahamas","2024-05-25",0,0,0,0,0,0,0,0
"Bahamas","2024-05-26",0,0,0,0,0,0,0,0
"Bahamas","2024-05-27",0,0,0,0,0,0,0,0
"Bahamas","2024-05-28",0,0,0,0,0,0,0,0
"Bahamas","2024-05-29",0,0,0,0,0,0,0,0
"Bahamas","2024-05-30",0,0,0,0,0,0,0,0
"Bahamas","2024-05-31",0,0,0,0,0,0,0,0
"Bahamas","2024-06-01",0,0,0,0,0,0,0,0
"Bahamas","2024-06-02",0,0,0,0,0,0,0,0
"Bahamas","2024-06-03",0,0,0,0,0,0,0,0
"Bahamas","2024-06-04",0,0,0,0,0,0,0,0
"Bahamas","2024-06-05",0,0,0,0,0,0,0,0
"Bahamas","2024-06-06",0,0,0,0,0,0,0,0
"Bahamas","2024-06-07",0,0,0,0,0,0,0,0
"Bahamas","2024-06-08",0,0,0,0,0,0,0,0
"Bahamas","2024-06-09",0,0,0,0,0,0,0,0
"Bahamas","2024-06-10",0,0,0,0,0,0,0,0
"Bahamas","2024-06-11",0,0,0,0,0,0,0,0
"Bahamas","2024-06-12",0,0,0,0,0,0,0,0
"Bahamas","2024-06-13",0,0,0,0,0,0,0,0
"Bahamas","2024-06-14",0,0,0,0,0,0,0,0
"Bahamas","2024-06-15",0,0,0,0,0,0,0,0
"Bahamas","2024-06-16",0,0,0,0,0,0,0,0
"Bahamas","2024-06-17",0,0,0,0,0,0,0,0
"Bahamas","2024-06-18",0,0,0,0,0,0,0,0
"Bahamas","2024-06-19",0,0,0,0,0,0,0,0
"Bahamas","2024-06-20",0,0,0,0,0,0,0,0
"Bahamas","2024-06-21",0,0,0,0,0,0,0,0
"Bahamas","2024-06-22",0,0,0,0,0,0,0,0
"Bahamas","2024-06-23",0,0,0,0,0,0,0,0
"Bahamas","2024-06-24",0,0,0,0,0,0,0,0
"Bahamas","2024-06-25",0,0,0,0,0,0,0,0
"Bahamas","2024-06-26",0,0,0,0,0,0,0,0
"Bahamas","2024-06-27",0,0,0,0,0,0,0,0
"Bahamas","2024-06-28",0,0,0,0,0,0,0,0
"Bahamas","2024-06-29",0,0,0,0,0,0,0,0
"Bahamas","2024-06-30",0,0,0,0,0,0,0,0
"Bahamas","2024-07-01",0,0,0,0,0,0,0,0
"Bahamas","2024-07-02",0,0,0,0,0,0,0,0
"Bahamas","2024-07-03",0,0,0,0,0,0,0,0
"Bahamas","2024-07-04",0,0,0,0,0,0,0,0
"Bahamas","2024-07-05",0,0,0,0,0,0,0,0
"Bahamas","2024-07-06",0,0,0,0,0,0,0,0
"Bahamas","2024-07-07",0,0,0,0,0,0,0,0
"Bahamas","2024-07-08",0,0,0,0,0,0,0,0
"Bahamas","2024-07-09",0,0,0,0,0,0,0,0
"Bahamas","2024-07-10",0,0,0,0,0,0,0,0
"Bahamas","2024-07-11",0,0,0,0,0,0,0,0
"Bahamas","2024-07-12",0,0,0,0,0,0,0,0
"Bahamas","2024-07-13",0,0,0,0,0,0,0,0
"Bahamas","2024-07-14",0,0,0,0,0,0,0,0
"Bahamas","2024-07-15",0,0,0,0,0,0,0,0
"Bahamas","2024-07-16",0,0,0,0,0,0,0,0
"Bahamas","2024-07-17",0,0,0,0,0,0,0,0
"Bahamas","2024-07-18",0,0,0,0,0,0,0,0
"Bahamas","2024-07-19",0,0,0,0,0,0,0,0
"Bahamas","2024-07-20",0,0,0,0,0,0,0,0
"Bahamas","2024-07-21",0,0,0,0,0,0,0,0
"Bahamas","2024-07-22",0,0,0,0,0,0,0,0
"Bahamas","2024-07-23",0,0,0,0,0,0,0,0
"Bahamas","2024-07-24",0,0,0,0,0,0,0,0
"Bahamas","2024-07-25",0,0,0,0,0,0,0,0
"Bahamas","2024-07-26",0,0,0,0,0,0,0,0
"Bahamas","2024-07-27",0,0,0,0,0,0,0,0
"Bahamas","2024-07-28",0,0,0,0,0,0,0,0
"Bahamas","2024-07-29",0,0,0,0,0,0,0,0
"Bahamas","2024-07-30",0,0,0,0,0,0,0,0
"Bahamas","2024-07-31",0,0,0,0,0,0,0,0
"Bahamas","2024-08-01",0,0,0,0,0,0,0,0
"Bahamas","2024-08-02",0,0,0,0,0,0,0,0
"Bahamas","2024-08-03",0,0,0,0,0,0,0,0
"Bahamas","2024-08-04",0,0,0,0,0,0,0,0
"Bahamas","2024-08-05",0,0,0,0,0,0,0,0
"Bahamas","2024-08-06",0,0,0,0,0,0,0,0
"Bahamas","2024-08-07",0,0,0,0,0,0,0,0
"Bahamas","2024-08-08",0,0,0,0,0,0,0,0
"Bahamas","2024-08-09",0,0,0,0,0,0,0,0
"Bahamas","2024-08-10",0,0,0,0,0,0,0,0
"Bahamas","2024-08-11",0,0,0,0,0,0,0,0
"Bahamas","2024-08-12",0,0,0,0,0,0,0,0
"Bahamas","2024-08-13",0,0,0,0,0,0,0,0
"Bahamas","2024-08-14",0,0,0,0,0,0,0,0
"Bahamas","2024-08-15",0,0,0,0,0,0,0,0
"Bahamas","2024-08-16",0,0,0,0,0,0,0,0
"Bahamas","2024-08-17",0,0,0,0,0,0,0,0
"Bahamas","2024-08-18",0,0,0,0,0,0,0,0
"Bahamas","2024-08-19",0,0,0,0,0,0,0,0
"Bahamas","2024-08-20",0,0,0,0,0,0,0,0
"Bahamas","2024-08-21",0,0,0,0,0,0,0,0
"Bahamas","2024-08-22",0,0,0,0,0,0,0,0
"Bahamas","2024-08-23",0,0,0,0,0,0,0,0
"Bahamas","2024-08-24",0,0,0,0,0,0,0,0
"Bahamas","2024-08-25",0,0,0,0,0,0,0,0
"Bahamas","2024-08-26",0,0,0,0,0,0,0,0
"Bahamas","2024-08-27",0,0,0,0,0,0,0,0
"Bahamas","2024-08-28",0,0,0,0,0,0,0,0
"Bahamas","2024-08-29",0,0,0,0,0,0,0,0
"Bahamas","2024-08-30",0,0,0,0,0,0,0,0
"Bahamas","2024-08-31",0,0,0,0,0,0,0,0
"Bahamas","2024-09-01",0,0,0,0,0,0,0,0
"Bahamas","2024-09-02",0,0,0,0,0,0,0,0
"Bahamas","2024-09-03",0,0,0,0,0,0,0,0
"Bahamas","2024-09-04",0,0,0,0,0,0,0,0
"Bahamas","2024-09-05",0,0,0,0,0,0,0,0
"Bahamas","2024-09-06",0,0,0,0,0,0,0,0
"Bahamas","2024-09-07",0,0,0,0,0,0,0,0
"Bahamas","2024-09-08",0,0,0,0,0,0,0,0
"Bahamas","2024-09-09",0,0,0,0,0,0,0,0
"Bahamas","2024-09-10",0,0,0,0,0,0,0,0
"Bahamas","2024-09-11",0,0,0,0,0,0,0,0
"Bahamas","2024-09-12",0,0,0,0,0,0,0,0
"Bahamas","2024-09-13",0,0,0,0,0,0,0,0
"Bahamas","2024-09-14",0,0,0,0,0,0,0,0
"Bahamas","2024-09-15",0,0,0,0,0,0,0,0
"Bahamas","2024-09-16",0,0,0,0,0,0,0,0
"Bahamas","2024-09-17",0,0,0,0,0,0,0,0
"Bahamas","2024-09-18",0,0,0,0,0,0,0,0
"Bahamas","2024-09-19",0,0,0,0,0,0,0,0
"Bahamas","2024-09-20",0,0,0,0,0,0,0,0
"Bahamas","2024-09-21",0,0,0,0,0,0,0,0
"Bahamas","2024-09-22",0,0,0,0,0,0,0,0
"Bahamas","2024-09-23",0,0,0,0,0,0,0,0
"Bahamas","2024-09-24",0,0,0,0,0,0,0,0
"Bahamas","2024-09-25",0,0,0,0,0,0,0,0
"Bahamas","2024-09-26",0,0,0,0,0,0,0,0
"Bahamas","2024-09-27",0,0,0,0,0,0,0,0
"Bahamas","2024-09-28",0,0,0,0,0,0,0,0
"Bahamas","2024-09-29",0,0,0,0,0,0,0,0
"Bahamas","2024-09-30",0,0,0,0,0,0,0,0
"Bahamas","2024-10-01",0,0,0,0,0,0,0,0
"Bahamas","2024-10-02",0,0,0,0,0,0,0,0
"Bahamas","2024-10-03",0,0,0,0,0,0,0,0
"Bahamas","2024-10-04",0,0,0,0,0,0,0,0
"Bahamas","2024-10-05",0,0,0,0,0,0,0,0
"Bahamas","2024-10-06",0,0,0,0,0,0,0,0
"Bahamas","2024-10-07",0,0,0,0,0,0,0,0
"Bahamas","2024-10-08",0,0,0,0,0,0,0,0
"Bahamas","2024-10-09",0,0,0,0,0,0,0,0
"Bahamas","2024-10-10",0,0,0,0,0,0,0,0
"Bahamas","2024-10-11",0,0,0,0,0,0,0,0
"Bahamas","2024-10-12",0,0,0,0,0,0,0,0
"Bahamas","2024-10-13",0,0,0,0,0,0,0,0
"Bahamas","2024-10-14",0,0,0,0,0,0,0,0
"Bahamas","2024-10-15",0,0,0,0,0,0,0,0
"Bahamas","2024-10-16",0,0,0,0,0,0,0,0
"Bahamas","2024-10-17",0,0,0,0,0,0,0,0
"Bahamas","2024-10-18",0,0,0,0,0,0,0,0
"Bahamas","2024-10-19",0,0,0,0,0,0,0,0
"Bahamas","2024-10-20",0,0,0,0,0,0,0,0
"Bahamas","2024-10-21",0,0,0,0,0,0,0,0
"Bahamas","2024-10-22",0,0,0,0,0,0,0,0
"Bahamas","2024-10-23",0,0,0,0,0,0,0,0
"Bahamas","2024-10-24",0,0,0,0,0,0,0,0
"Bahamas","2024-10-25",0,0,0,0,0,0,0,0
"Bahamas","2024-10-26",0,0,0,0,0,0,0,0
"Bahamas","2024-10-27",0,0,0,0,0,0,0,0
"Bahamas","2024-10-28",0,0,0,0,0,0,0,0
"Bahamas","2024-10-29",0,0,0,0,0,0,0,0
"Bahamas","2024-10-30",0,0,0,0,0,0,0,0
"Bahamas","2024-10-31",0,0,0,0,0,0,0,0
"Bahamas","2024-11-01",0,0,0,0,0,0,0,0
"Bahamas","2024-11-02",0,0,0,0,0,0,0,0
"Bahamas","2024-11-03",0,0,0,0,0,0,0,0
"Bahamas","2024-11-04",0,0,0,0,0,0,0,0
"Bahamas","2024-11-05",0,0,0,0,0,0,0,0
"Bahamas","2024-11-06",0,0,0,0,0,0,0,0
"Bahamas","2024-11-07",0,0,0,0,0,0,0,0
"Bahamas","2024-11-08",0,0,0,0,0,0,0,0
"Bahamas","2024-11-09",0,0,0,0,0,0,0,0
"Bahamas","2024-11-10",0,0,0,0,0,0,0,0
"Bahamas","2024-11-11",0,0,0,0,0,0,0,0
"Bahamas","2024-11-12",0,0,0,0,0,0,0,0
"Bahamas","2024-11-13",0,0,0,0,0,0,0,0
"Bahamas","2024-11-14",0,0,0,0,0,0,0,0
"Bahamas","2024-11-15",0,0,0,0,0,0,0,0
"Bahamas","2024-11-16",0,0,0,0,0,0,0,0
"Bahamas","2024-11-17",0,0,0,0,0,0,0,0
"Bahamas","2024-11-18",0,0,0,0,0,0,0,0
"Bahamas","2024-11-19",0,0,0,0,0,0,0,0
"Bahamas","2024-11-20",0,0,0,0,0,0,0,0
"Bahamas","2024-11-21",0,0,0,0,0,0,0,0
"Bahamas","2024-11-22",0,0,0,0,0,0,0,0
"Bahamas","2024-11-23",0,0,0,0,0,0,0,0
"Bahamas","2024-11-24",0,0,0,0,0,0,0,0
"Bahamas","2024-11-25",0,0,0,0,0,0,0,0
"Bahamas","2024-11-26",0,0,0,0,0,0,0,0
"Bahamas","2024-11-27",0,0,0,0,0,0,0,0
"Bahamas","2024-11-28",0,0,0,0,0,0,0,0
"Bahamas","2024-11-29",0,0,0,0,0,0,0,0
"Bahamas","2024-11-30",0,0,0,0,0,0,0,0
"Bahamas","2024-12-01",0,0,0,0,0,0,0,0
"Bahamas","2024-12-02",0,0,0,0,0,0,0,0
"Bahamas","2024-12-03",0,0,0,0,0,0,0,0
"Bahamas","2024-12-04",0,0,0,0,0,0,0,0
"Bahamas","2024-12-05",0,0,0,0,0,0,0,0
"Bahamas","2024-12-06",0,0,0,0,0,0,0,0
"Bahamas","2024-12-07",0,0,0,0,0,0,0,0
"Bahamas","2024-12-08",0,0,0,0,0,0,0,0
"Bahamas","2024-12-09",0,0,0,0,0,0,0,0
"Bahamas","2024-12-10",0,0,0,0,0,0,0,0
"Bahamas","2024-12-11",0,0,0,0,0,0,0,0
"Bahamas","2024-12-12",0,0,0,0,0,0,0,0
"Bahamas","2024-12-13",0,0,0,0,0,0,0,0
"Bahamas","2024-12-14",0,0,0,0,0,0,0,0
"Bahamas","2024-12-15",0,0,0,0,0,0,0,0
"Bahamas","2024-12-16",0,0,0,0,0,0,0,0
"Bahamas","2024-12-17",0,0,0,0,0,0,0,0
"Bahamas","2024-12-18",0,0,0,0,0,0,0,0
"Bahamas","2024-12-19",0,0,0,0,0,0,0,0
"Bahamas","2024-12-20",0,0,0,0,0,0,0,0
"Bahamas","2024-12-21",0,0,0,0,0,0,0,0
"Bahamas","2024-12-22",0,0,0,0,0,0,0,0
"Bahamas","2024-12-23",0,0,0,0,0,0,0,0
"Bahamas","2024-12-24",0,0,0,0,0,0,0,0
"Bahamas","2024-12-25",0,0,0,0,0,0,0,0
"Bahamas","2024-12-26",0,0,0,0,0,0,0,0
"Bahamas","2024-12-27",0,0,0,0,0,0,0,0
"Bahamas","2024-12-28",0,0,0,0,0,0,0,0
"Bahamas","2024-12-29",0,0,0,0,0,0,0,0
"Bahamas","2024-12-30",0,0,0,0,0,0,0,0
"Bahamas","2024-12-31",0,0,0,0,0,0,0,0
"Bahamas","2025-01-01",0,0,0,0,0,0,0,0
"Bahamas","2025-01-02",0,0,0,0,0,0,0,0
"Bahamas","2025-01-03",0,0,0,0,0,0,0,0
"Bahamas","2025-01-04",0,0,0,0,0,0,0,0
"Bahamas","2025-01-05",0,0,0,0,0,0,0,0
"Bahamas","2025-01-06",0,0,0,0,0,0,0,0
"Bahamas","2025-01-07",0,0,0,0,0,0,0,0
"Bahamas","2025-01-08",0,0,0,0,0,0,0,0
"Bahamas","2025-01-09",0,0,0,0,0,0,0,0
"Bahamas","2025-01-10",0,0,0,0,0,0,0,0
"Bahamas","2025-01-11",0,0,0,0,0,0,0,0
"Bahamas","2025-01-12",0,0,0,0,0,0,0,0
"Bahamas","2025-01-13",0,0,0,0,0,0,0,0
"Bahamas","2025-01-14",0,0,0,0,0,0,0,0
"Bahamas","2025-01-15",0,0,0,0,0,0,0,0
"Bahamas","2025-01-16",0,0,0,0,0,0,0,0
"Bahamas","2025-01-17",0,0,0,0,0,0,0,0
"Bahamas","2025-01-18",0,0,0,0,0,0,0,0
"Bahamas","2025-01-19",0,0,0,0,0,0,0,0
"Bahamas","2025-01-20",0,0,0,0,0,0,0,0
"Bahamas","2025-01-21",0,0,0,0,0,0,0,0
"Bahamas","2025-01-22",0,0,0,0,0,0,0,0
"Bahamas","2025-01-23",0,0,0,0,0,0,0,0
"Bahamas","2025-01-24",0,0,0,0,0,0,0,0
"Bahamas","2025-01-25",0,0,0,0,0,0,0,0
"Bahamas","2025-01-26",0,0,0,0,0,0,0,0
"Bahamas","2025-01-27",0,0,0,0,0,0,0,0
"Bahamas","2025-01-28",0,0,0,0,0,0,0,0
"Bahamas","2025-01-29",0,0,0,0,0,0,0,0
"Bahamas","2025-01-30",0,0,0,0,0,0,0,0
"Bahamas","2025-01-31",0,0,0,0,0,0,0,0
"Bahamas","2025-02-01",0,0,0,0,0,0,0,0
"Bahamas","2025-02-02",0,0,0,0,0,0,0,0
"Bahamas","2025-02-03",0,0,0,0,0,0,0,0
"Barbados","2024-01-01",0,0,0,0,0,0,0,0
"Barbados","2024-01-02",0,0,0,0,0,0,0,0
"Barbados","2024-01-03",0,0,0,0,0,0,0,0
"Barbados","2024-01-04",0,0,0,0,0,0,0,0
"Barbados","2024-01-05",0,0,0,0,0,0,0,0
"Barbados","2024-01-06",0,0,0,0,0,0,0,0
"Barbados","2024-01-07",0,0,0,0,0,0,0,0
"Barbados","2024-01-08",0,0,0,0,0,0,0,0
"Barbados","2024-01-09",0,0,0,0,0,0,0,0
"Barbados","2024-01-10",0,0,0,0,0,0,0,0
"Barbados","2024-01-11",0,0,0,0,0,0,0,0
"Barbados","2024-01-12",0,0,0,0,0,0,0,0
"Barbados","2024-01-13",0,0,0,0,0,0,0,0
"Barbados","2024-01-14",0,0,0,0,0,0,0,0
"Barbados","2024-01-15",0,0,0,0,0,0,0,0
"Barbados","2024-01-16",0,0,0,0,0,0,0,0
"Barbados","2024-01-17",0,0,0,0,0,0,0,0
"Barbados","2024-01-18",0,0,0,0,0,0,0,0
"Barbados","2024-01-19",0,0,0,0,0,0,0,0
"Barbados","2024-01-20",0,0,0,0,0,0,0,0
"Barbados","2024-01-21",0,0,0,0,0,0,0,0
"Barbados","2024-01-22",0,0,0,0,0,0,0,0
"Barbados","2024-01-23",0,0,0,0,0,0,0,0
"Barbados","2024-01-24",0,0,0,0,0,0,0,0
"Barbados","2024-01-25",0,0,0,0,0,0,0,0
"Barbados","2024-01-26",0,0,0,0,0,0,0,0
"Barbados","2024-01-27",0,0,0,0,0,0,0,0
"Barbados","2024-01-28",0,0,0,0,0,0,0,0
"Barbados","2024-01-29",0,0,0,0,0,0,0,0
"Barbados","2024-01-30",0,0,0,0,0,0,0,0
"Barbados","2024-01-31",0,0,0,0,0,0,0,0
"Barbados","2024-02-01",0,0,0,0,0,0,0,0
"Barbados","2024-02-02",0,0,0,0,0,0,0,0
"Barbados","2024-02-03",0,0,0,0,0,0,0,0
"Barbados","2024-02-04",0,0,0,0,0,0,0,0
"Barbados","2024-02-05",0,0,0,0,0,0,0,0
"Barbados","2024-02-06",0,0,0,0,0,0,0,0
"Barbados","2024-02-07",0,0,0,0,0,0,0,0
"Barbados","2024-02-08",0,0,0,0,0,0,0,0
"Barbados","2024-02-09",0,0,0,0,0,0,0,0
"Barbados","2024-02-10",0,0,0,0,0,0,0,0
"Barbados","2024-02-11",0,0,0,0,0,0,0,0
"Barbados","2024-02-12",0,0,0,0,0,0,0,0
"Barbados","2024-02-13",0,0,0,0,0,0,0,0
"Barbados","2024-02-14",0,0,0,0,0,0,0,0
"Barbados","2024-02-15",0,0,0,0,0,0,0,0
"Barbados","2024-02-16",0,0,0,0,0,0,0,0
"Barbados","2024-02-17",0,0,0,0,0,0,0,0
"Barbados","2024-02-18",0,0,0,0,0,0,0,0
"Barbados","2024-02-19",0,0,0,0,0,0,0,0
"Barbados","2024-02-20",0,0,0,0,0,0,0,0
"Barbados","2024-02-21",0,0,0,0,0,0,0,0
"Barbados","2024-02-22",0,0,0,0,0,0,0,0
"Barbados","2024-02-23",0,0,0,0,0,0,0,0
"Barbados","2024-02-24",0,0,0,0,0,0,0,0
"Barbados","2024-02-25",0,0,0,0,0,0,0,0
"Barbados","2024-02-26",0,0,0,0,0,0,0,0
"Barbados","2024-02-27",0,0,0,0,0,0,0,0
"Barbados","2024-02-28",0,0,0,0,0,0,0,0
"Barbados","2024-02-29",0,0,0,0,0,0,0,0
"Barbados","2024-03-01",0,0,0,0,0,0,0,0
"Barbados","2024-03-02",0,0,0,0,0,0,0,0
"Barbados","2024-03-03",0,0,0,0,0,0,0,0
"Barbados","2024-03-04",0,0,0,0,0,0,0,0
"Barbados","2024-03-05",0,0,0,0,0,0,0,0
"Barbados","2024-03-06",0,0,0,0,0,0,0,0
"Barbados","2024-03-07",0,0,0,0,0,0,0,0
"Barbados","2024-03-08",0,0,0,0,0,0,0,0
"Barbados","2024-03-09",0,0,0,0,0,0,0,0
"Barbados","2024-03-10",0,0,0,0,0,0,0,0
"Barbados","2024-03-11",0,0,0,0,0,0,0,0
"Barbados","2024-03-12",0,0,0,0,0,0,0,0
"Barbados","2024-03-13",0,0,0,0,0,0,0,0
"Barbados","2024-03-14",0,0,0,0,0,0,0,0
"Barbados","2024-03-15",0,0,0,0,0,0,0,0
"Barbados","2024-03-16",0,0,0,0,0,0,0,0
"Barbados","2024-03-17",0,0,0,0,0,0,0,0
"Barbados","2024-03-18",0,0,0,0,0,0,0,0
"Barbados","2024-03-19",0,0,0,0,0,0,0,0
"Barbados","2024-03-20",0,0,0,0,0,0,0,0
"Barbados","2024-03-21",0,0,0,0,0,0,0,0
"Barbados","2024-03-22",0,0,0,0,0,0,0,0
"Barbados","2024-03-23",0,0,0,0,0,0,0,0
"Barbados","2024-03-24",0,0,0,0,0,0,0,0
"Barbados","2024-03-25",0,0,0,0,0,0,0,0
"Barbados","2024-03-26",0,0,0,0,0,0,0,0
"Barbados","2024-03-27",0,0,0,0,0,0,0,0
"Barbados","2024-03-28",0,0,0,0,0,0,0,0
"Barbados","2024-03-29",0,0,0,0,0,0,0,0
"Barbados","2024-03-30",0,0,0,0,0,0,0,0
"Barbados","2024-03-31",0,0,0,0,0,0,0,0
"Barbados","2024-04-01",0,0,0,0,0,0,0,0
"Barbados","2024-04-02",0,0,0,0,0,0,0,0
"Barbados","2024-04-03",0,0,0,0,0,0,0,0
"Barbados","2024-04-04",0,0,0,0,0,0,0,0
"Barbados","2024-04-05",0,0,0,0,0,0,0,0
"Barbados","2024-04-06",0,0,0,0,0,0,0,0
"Barbados","2024-04-07",0,0,0,0,0,0,0,0
"Barbados","2024-04-08",0,0,0,0,0,0,0,0
"Barbados","2024-04-09",0,0,0,0,0,0,0,0
"Barbados","2024-04-10",0,0,0,0,0,0,0,0
"Barbados","2024-04-11",0,0,0,0,0,0,0,0
"Barbados","2024-04-12",0,0,0,0,0,0,0,0
"Barbados","2024-04-13",0,0,0,0,0,0,0,0
"Barbados","2024-04-14",0,0,0,0,0,0,0,0
"Barbados","2024-04-15",0,0,0,0,0,0,0,0
"Barbados","2024-04-16",0,0,0,0,0,0,0,0
"Barbados","2024-04-17",0,0,0,0,0,0,0,0
"Barbados","2024-04-18",0,0,0,0,0,0,0,0
"Barbados","2024-04-19",0,0,0,0,0,0,0,0
"Barbados","2024-04-20",0,0,0,0,0,0,0,0
"Barbados","2024-04-21",0,0,0,0,0,0,0,0
"Barbados","2024-04-22",0,0,0,0,0,0,0,0
"Barbados","2024-04-23",0,0,0,0,0,0,0,0
"Barbados","2024-04-24",0,0,0,0,0,0,0,0
"Barbados","2024-04-25",0,0,0,0,0,0,0,0
"Barbados","2024-04-26",0,0,0,0,0,0,0,0
"Barbados","2024-04-27",0,0,0,0,0,0,0,0
"Barbados","2024-04-28",0,0,0,0,0,0,0,0
"Barbados","2024-04-29",0,0,0,0,0,0,0,0
"Barbados","2024-04-30",0,0,0,0,0,0,0,0
"Barbados","2024-05-01",0,0,0,0,0,0,0,0
"Barbados","2024-05-02",0,0,0,0,0,0,0,0
"Barbados","2024-05-03",0,0,0,0,0,0,0,0
"Barbados","2024-05-04",0,0,0,0,0,0,0,0
"Barbados","2024-05-05",0,0,0,0,0,0,0,0
"Barbados","2024-05-06",0,0,0,0,0,0,0,0
"Barbados","2024-05-07",0,0,0,0,0,0,0,0
"Barbados","2024-05-08",0,0,0,0,0,0,0,0
"Barbados","2024-05-09",0,0,0,0,0,0,0,0
"Barbados","2024-05-10",0,0,0,0,0,0,0,0
"Barbados","2024-05-11",0,0,0,0,0,0,0,0
"Barbados","2024-05-12",0,0,0,0,0,0,0,0
"Barbados","2024-05-13",0,0,0,0,0,0,0,0
"Barbados","2024-05-14",0,0,0,0,0,0,0,0
"Barbados","2024-05-15",0,0,0,0,0,0,0,0
"Barbados","2024-05-16",0,0,0,0,0,0,0,0
"Barbados","2024-05-17",0,0,0,0,0,0,0,0
"Barbados","2024-05-18",0,0,0,0,0,0,0,0
"Barbados","2024-05-19",0,0,0,0,0,0,0,0
"Barbados","2024-05-20",0,0,0,0,0,0,0,0
"Barbados","2024-05-21",0,0,0,0,0,0,0,0
"Barbados","2024-05-22",0,0,0,0,0,0,0,0
"Barbados","2024-05-23",0,0,0,0,0,0,0,0
"Barbados","2024-05-24",0,0,0,0,0,0,0,0
"Barbados","2024-05-25",0,0,0,0,0,0,0,0
"Barbados","2024-05-26",0,0,0,0,0,0,0,0
"Barbados","2024-05-27",0,0,0,0,0,0,0,0
"Barbados","2024-05-28",0,0,0,0,0,0,0,0
"Barbados","2024-05-29",0,0,0,0,0,0,0,0
"Barbados","2024-05-30",0,0,0,0,0,0,0,0
"Barbados","2024-05-31",0,0,0,0,0,0,0,0
"Barbados","2024-06-01",0,0,0,0,0,0,0,0
"Barbados","2024-06-02",0,0,0,0,0,0,0,0
"Barbados","2024-06-03",0,0,0,0,0,0,0,0
"Barbados","2024-06-04",0,0,0,0,0,0,0,0
"Barbados","2024-06-05",0,0,0,0,0,0,0,0
"Barbados","2024-06-06",0,0,0,0,0,0,0,0
"Barbados","2024-06-07",0,0,0,0,0,0,0,0
"Barbados","2024-06-08",0,0,0,0,0,0,0,0
"Barbados","2024-06-09",0,0,0,0,0,0,0,0
"Barbados","2024-06-10",0,0,0,0,0,0,0,0
"Barbados","2024-06-11",0,0,0,0,0,0,0,0
"Barbados","2024-06-12",0,0,0,0,0,0,0,0
"Barbados","2024-06-13",0,0,0,0,0,0,0,0
"Barbados","2024-06-14",0,0,0,0,0,0,0,0
"Barbados","2024-06-15",0,0,0,0,0,0,0,0
"Barbados","2024-06-16",0,0,0,0,0,0,0,0
"Barbados","2024-06-17",0,0,0,0,0,0,0,0
"Barbados","2024-06-18",0,0,0,0,0,0,0,0
"Barbados","2024-06-19",0,0,0,0,0,0,0,0
"Barbados","2024-06-20",0,0,0,0,0,0,0,0
"Barbados","2024-06-21",0,0,0,0,0,0,0,0
"Barbados","2024-06-22",0,0,0,0,0,0,0,0
"Barbados","2024-06-23",0,0,0,0,0,0,0,0
"Barbados","2024-06-24",0,0,0,0,0,0,0,0
"Barbados","2024-06-25",0,0,0,0,0,0,0,0
"Barbados","2024-06-26",0,0,0,0,0,0,0,0
"Barbados","2024-06-27",0,0,0,0,0,0,0,0
"Barbados","2024-06-28",0,0,0,0,0,0,0,0
"Barbados","2024-06-29",0,0,0,0,0,0,0,0
"Barbados","2024-06-30",0,0,0,0,0,0,0,0
"Barbados","2024-07-01",0,0,0,0,0,0,0,0
"Barbados","2024-07-02",0,0,0,0,0,0,0,0
"Barbados","2024-07-03",0,0,0,0,0,0,0,0
"Barbados","2024-07-04",0,0,0,0,0,0,0,0
"Barbados","2024-07-05",0,0,0,0,0,0,0,0
"Barbados","2024-07-06",0,0,0,0,0,0,0,0
"Barbados","2024-07-07",0,0,0,0,0,0,0,0
"Barbados","2024-07-08",0,0,0,0,0,0,0,0
"Barbados","2024-07-09",0,0,0,0,0,0,0,0
"Barbados","2024-07-10",0,0,0,0,0,0,0,0
"Barbados","2024-07-11",0,0,0,0,0,0,0,0
"Barbados","2024-07-12",0,0,0,0,0,0,0,0
"Barbados","2024-07-13",0,0,0,0,0,0,0,0
"Barbados","2024-07-14",0,0,0,0,0,0,0,0
"Barbados","2024-07-15",0,0,0,0,0,0,0,0
"Barbados","2024-07-16",0,0,0,0,0,0,0,0
"Barbados","2024-07-17",0,0,0,0,0,0,0,0
"Barbados","2024-07-18",0,0,0,0,0,0,0,0
"Barbados","2024-07-19",0,0,0,0,0,0,0,0
"Barbados","2024-07-20",0,0,0,0,0,0,0,0
"Barbados","2024-07-21",0,0,0,0,0,0,0,0
"Barbados","2024-07-22",0,0,0,0,0,0,0,0
"Barbados","2024-07-23",0,0,0,0,0,0,0,0
"Barbados","2024-07-24",0,0,0,0,0,0,0,0
"Barbados","2024-07-25",0,0,0,0,0,0,0,0
"Barbados","2024-07-26",0,0,0,0,0,0,0,0
"Barbados","2024-07-27",0,0,0,0,0,0,0,0
"Barbados","2024-07-28",0,0,0,0,0,0,0,0
"Barbados","2024-07-29",0,0,0,0,0,0,0,0
"Barbados","2024-07-30",0,0,0,0,0,0,0,0
"Barbados","2024-07-31",0,0,0,0,0,0,0,0
"Barbados","2024-08-01",0,0,0,0,0,0,0,0
"Barbados","2024-08-02",0,0,0,0,0,0,0,0
"Barbados","2024-08-03",0,0,0,0,0,0,0,0
"Barbados","2024-08-04",0,0,0,0,0,0,0,0
"Barbados","2024-08-05",0,0,0,0,0,0,0,0
"Barbados","2024-08-06",0,0,0,0,0,0,0,0
"Barbados","2024-08-07",0,0,0,0,0,0,0,0
"Barbados","2024-08-08",0,0,0,0,0,0,0,0
"Barbados","2024-08-09",0,0,0,0,0,0,0,0
"Barbados","2024-08-10",0,0,0,0,0,0,0,0
"Barbados","2024-08-11",0,0,0,0,0,0,0,0
"Barbados","2024-08-12",0,0,0,0,0,0,0,0
"Barbados","2024-08-13",0,0,0,0,0,0,0,0
"Barbados","2024-08-14",0,0,0,0,0,0,0,0
"Barbados","2024-08-15",0,0,0,0,0,0,0,0
"Barbados","2024-08-16",0,0,0,0,0,0,0,0
"Barbados","2024-08-17",0,0,0,0,0,0,0,0
"Barbados","2024-08-18",0,0,0,0,0,0,0,0
"Barbados","2024-08-19",0,0,0,0,0,0,0,0
"Barbados","2024-08-20",0,0,0,0,0,0,0,0
"Barbados","2024-08-21",0,0,0,0,0,0,0,0
"Barbados","2024-08-22",0,0,0,0,0,0,0,0
"Barbados","2024-08-23",0,0,0,0,0,0,0,0
"Barbados","2024-08-24",0,0,0,0,0,0,0,0
"Barbados","2024-08-25",0,0,0,0,0,0,0,0
"Barbados","2024-08-26",0,0,0,0,0,0,0,0
"Barbados","2024-08-27",0,0,0,0,0,0,0,0
"Barbados","2024-08-28",0,0,0,0,0,0,0,0
"Barbados","2024-08-29",0,0,0,0,0,0,0,0
"Barbados","2024-08-30",0,0,0,0,0,0,0,0
"Barbados","2024-08-31",0,0,0,0,0,0,0,0
"Barbados","2024-09-01",0,0,0,0,0,0,0,0
"Barbados","2024-09-02",0,0,0,0,0,0,0,0
"Barbados","2024-09-03",0,0,0,0,0,0,0,0
"Barbados","2024-09-04",0,0,0,0,0,0,0,0
"Barbados","2024-09-05",0,0,0,0,0,0,0,0
"Barbados","2024-09-06",0,0,0,0,0,0,0,0
"Barbados","2024-09-07",0,0,0,0,0,0,0,0
"Barbados","2024-09-08",0,0,0,0,0,0,0,0
"Barbados","2024-09-09",0,0,0,0,0,0,0,0
"Barbados","2024-09-10",0,0,0,0,0,0,0,0
"Barbados","2024-09-11",0,0,0,0,0,0,0,0
"Barbados","2024-09-12",0,0,0,0,0,0,0,0
"Barbados","2024-09-13",0,0,0,0,0,0,0,0
"Barbados","2024-09-14",0,0,0,0,0,0,0,0
"Barbados","2024-09-15",0,0,0,0,0,0,0,0
"Barbados","2024-09-16",0,0,0,0,0,0,0,0
"Barbados","2024-09-17",0,0,0,0,0,0,0,0
"Barbados","2024-09-18",0,0,0,0,0,0,0,0
"Barbados","2024-09-19",0,0,0,0,0,0,0,0
"Barbados","2024-09-20",0,0,0,0,0,0,0,0
"Barbados","2024-09-21",0,0,0,0,0,0,0,0
"Barbados","2024-09-22",0,0,0,0,0,0,0,0
"Barbados","2024-09-23",0,0,0,0,0,0,0,0
"Barbados","2024-09-24",0,0,0,0,0,0,0,0
"Barbados","2024-09-25",0,0,0,0,0,0,0,0
"Barbados","2024-09-26",0,0,0,0,0,0,0,0
"Barbados","2024-09-27",0,0,0,0,0,0,0,0
"Barbados","2024-09-28",0,0,0,0,0,0,0,0
"Barbados","2024-09-29",0,0,0,0,0,0,0,0
"Barbados","2024-09-30",0,0,0,0,0,0,0,0
"Barbados","2024-10-01",0,0,0,0,0,0,0,0
"Barbados","2024-10-02",0,0,0,0,0,0,0,0
"Barbados","2024-10-03",0,0,0,0,0,0,0,0
"Barbados","2024-10-04",0,0,0,0,0,0,0,0
"Barbados","2024-10-05",0,0,0,0,0,0,0,0
"Barbados","2024-10-06",0,0,0,0,0,0,0,0
"Barbados","2024-10-07",0,0,0,0,0,0,0,0
"Barbados","2024-10-08",0,0,0,0,0,0,0,0
"Barbados","2024-10-09",0,0,0,0,0,0,0,0
"Barbados","2024-10-10",0,0,0,0,0,0,0,0
"Barbados","2024-10-11",0,0,0,0,0,0,0,0
"Barbados","2024-10-12",0,0,0,0,0,0,0,0
"Barbados","2024-10-13",0,0,0,0,0,0,0,0
"Barbados","2024-10-14",0,0,0,0,0,0,0,0
"Barbados","2024-10-15",0,0,0,0,0,0,0,0
"Barbados","2024-10-16",0,0,0,0,0,0,0,0
"Barbados","2024-10-17",0,0,0,0,0,0,0,0
"Barbados","2024-10-18",0,0,0,0,0,0,0,0
"Barbados","2024-10-19",0,0,0,0,0,0,0,0
"Barbados","2024-10-20",0,0,0,0,0,0,0,0
"Barbados","2024-10-21",0,0,0,0,0,0,0,0
"Barbados","2024-10-22",0,0,0,0,0,0,0,0
"Barbados","2024-10-23",0,0,0,0,0,0,0,0
"Barbados","2024-10-24",0,0,0,0,0,0,0,0
"Barbados","2024-10-25",0,0,0,0,0,0,0,0
"Barbados","2024-10-26",0,0,0,0,0,0,0,0
"Barbados","2024-10-27",0,0,0,0,0,0,0,0
"Barbados","2024-10-28",0,0,0,0,0,0,0,0
"Barbados","2024-10-29",0,0,0,0,0,0,0,0
"Barbados","2024-10-30",0,0,0,0,0,0,0,0
"Barbados","2024-10-31",0,0,0,0,0,0,0,0
"Barbados","2024-11-01",0,0,0,0,0,0,0,0
"Barbados","2024-11-02",0,0,0,0,0,0,0,0
"Barbados","2024-11-03",0,0,0,0,0,0,0,0
"Barbados","2024-11-04",0,0,0,0,0,0,0,0
"Barbados","2024-11-05",0,0,0,0,0,0,0,0
"Barbados","2024-11-06",0,0,0,0,0,0,0,0
"Barbados","2024-11-07",0,0,0,0,0,0,0,0
"Barbados","2024-11-08",0,0,0,0,0,0,0,0
"Barbados","2024-11-09",0,0,0,0,0,0,0,0
"Barbados","2024-11-10",0,0,0,0,0,0,0,0
"Barbados","2024-11-11",0,0,0,0,0,0,0,0
"Barbados","2024-11-12",0,0,0,0,0,0,0,0
"Barbados","2024-11-13",0,0,0,0,0,0,0,0
"Barbados","2024-11-14",0,0,0,0,0,0,0,0
"Barbados","2024-11-15",0,0,0,0,0,0,0,0
"Barbados","2024-11-16",0,0,0,0,0,0,0,0
"Barbados","2024-11-17",0,0,0,0,0,0,0,0
"Barbados","2024-11-18",0,0,0,0,0,0,0,0
"Barbados","2024-11-19",0,0,0,0,0,0,0,0
"Barbados","2024-11-20",0,0,0,0,0,0,0,0
"Barbados","2024-11-21",0,0,0,0,0,0,0,0
"Barbados","2024-11-22",0,0,0,0,0,0,0,0
"Barbados","2024-11-23",0,0,0,0,0,0,0,0
"Barbados","2024-11-24",0,0,0,0,0,0,0,0
"Barbados","2024-11-25",0,0,0,0,0,0,0,0
"Barbados","2024-11-26",0,0,0,0,0,0,0,0
"Barbados","2024-11-27",0,0,0,0,0,0,0,0
"Barbados","2024-11-28",0,0,0,0,0,0,0,0
"Barbados","2024-11-29",0,0,0,0,0,0,0,0
"Barbados","2024-11-30",0,0,0,0,0,0,0,0
"Barbados","2024-12-01",0,0,0,0,0,0,0,0
"Barbados","2024-12-02",0,0,0,0,0,0,0,0
"Barbados","2024-12-03",0,0,0,0,0,0,0,0
"Barbados","2024-12-04",0,0,0,0,0,0,0,0
"Barbados","2024-12-05",0,0,0,0,0,0,0,0
"Barbados","2024-12-06",0,0,0,0,0,0,0,0
"Barbados","2024-12-07",0,0,0,0,0,0,0,0
"Barbados","2024-12-08",0,0,0,0,0,0,0,0
"Barbados","2024-12-09",0,0,0,0,0,0,0,0
"Barbados","2024-12-10",0,0,0,0,0,0,0,0
"Barbados","2024-12-11",0,0,0,0,0,0,0,0
"Barbados","2024-12-12",0,0,0,0,0,0,0,0
"Barbados","2024-12-13",0,0,0,0,0,0,0,0
"Barbados","2024-12-14",0,0,0,0,0,0,0,0
"Barbados","2024-12-15",0,0,0,0,0,0,0,0
"Barbados","2024-12-16",0,0,0,0,0,0,0,0
"Barbados","2024-12-17",0,0,0,0,0,0,0,0
"Barbados","2024-12-18",0,0,0,0,0,0,0,0
"Barbados","2024-12-19",0,0,0,0,0,0,0,0
"Barbados","2024-12-20",0,0,0,0,0,0,0,0
"Barbados","2024-12-21",0,0,0,0,0,0,0,0
"Barbados","2024-12-22",0,0,0,0,0,0,0,0
"Barbados","2024-12-23",0,0,0,0,0,0,0,0
"Barbados","2024-12-24",0,0,0,0,0,0,0,0
"Barbados","2024-12-25",0,0,0,0,0,0,0,0
"Barbados","2024-12-26",0,0,0,0,0,0,0,0
"Barbados","2024-12-27",0,0,0,0,0,0,0,0
"Barbados","2024-12-28",0,0,0,0,0,0,0,0
"Barbados","2024-12-29",0,0,0,0,0,0,0,0
"Barbados","2024-12-30",0,0,0,0,0,0,0,0
"Barbados","2024-12-31",0,0,0,0,0,0,0,0
"Barbados","2025-01-01",0,0,0,0,0,0,0,0
"Barbados","2025-01-02",0,0,0,0,0,0,0,0
"Barbados","2025-01-03",0,0,0,0,0,0,0,0
"Barbados","2025-01-04",0,0,0,0,0,0,0,0
"Barbados","2025-01-05",0,0,0,0,0,0,0,0
"Barbados","2025-01-06",0,0,0,0,0,0,0,0
"Barbados","2025-01-07",0,0,0,0,0,0,0,0
"Barbados","2025-01-08",0,0,0,0,0,0,0,0
"Barbados","2025-01-09",0,0,0,0,0,0,0,0
"Barbados","2025-01-10",0,0,0,0,0,0,0,0
"Barbados","2025-01-11",0,0,0,0,0,0,0,0
"Barbados","2025-01-12",0,0,0,0,0,0,0,0
"Barbados","2025-01-13",0,0,0,0,0,0,0,0
"Barbados","2025-01-14",0,0,0,0,0,0,0,0
"Barbados","2025-01-15",0,0,0,0,0,0,0,0
"Barbados","2025-01-16",0,0,0,0,0,0,0,0
"Barbados","2025-01-17",0,0,0,0,0,0,0,0
"Barbados","2025-01-18",0,0,0,0,0,0,0,0
"Barbados","2025-01-19",0,0,0,0,0,0,0,0
"Barbados","2025-01-20",0,0,0,0,0,0,0,0
"Barbados","2025-01-21",0,0,0,0,0,0,0,0
"Barbados","2025-01-22",0,0,0,0,0,0,0,0
"Barbados","2025-01-23",0,0,0,0,0,0,0,0
"Barbados","2025-01-24",0,0,0,0,0,0,0,0
"Barbados","2025-01-25",0,0,0,0,0,0,0,0
"Barbados","2025-01-26",0,0,0,0,0,0,0,0
"Barbados","2025-01-27",0,0,0,0,0,0,0,0
"Barbados","2025-01-28",0,0,0,0,0,0,0,0
"Barbados","2025-01-29",0,0,0,0,0,0,0,0
"Barbados","2025-01-30",0,0,0,0,0,0,0,0
"Barbados","2025-01-31",0,0,0,0,0,0,0,0
"Barbados","2025-02-01",0,0,0,0,0,0,0,0
"Barbados","2025-02-02",0,0,0,0,0,0,0,0
"Barbados","2025-02-03",0,0,0,0,0,0,0,0
"Belgium","2024-01-01",0,0,0,0,0,0,0,0
"Belgium","2024-01-02",0,0,0,0,0,0,0,0
"Belgium","2024-01-03",0,0,0,0,0,0,0,0
"Belgium","2024-01-04",0,0,0,0,0,0,0,0
"Belgium","2024-01-05",0,0,0,0,0,0,0,0
"Belgium","2024-01-06",0,0,0,0,0,0,0,0
"Belgium","2024-01-07",0,0,0,0,0,0,0,0
"Belgium","2024-01-08",0,0,0,0,0,0,0,0
"Belgium","2024-01-09",0,0,0,0,0,0,0,0
"Belgium","2024-01-10",0,0,0,0,0,0,0,0
"Belgium","2024-01-11",0,0,0,0,0,0,0,0
"Belgium","2024-01-12",0,0,0,0,0,0,0,0
"Belgium","2024-01-13",0,0,0,0,0,0,0,0
"Belgium","2024-01-14",0,0,0,0,0,0,0,0
"Belgium","2024-01-15",0,0,0,0,0,0,0,0
"Belgium","2024-01-16",0,0,0,0,0,0,0,0
"Belgium","2024-01-17",0,0,0,0,0,0,0,0
"Belgium","2024-01-18",0,0,0,0,0,0,0,0
"Belgium","2024-01-19",0,0,0,0,0,0,0,0
"Belgium","2024-01-20",0,0,0,0,0,0,0,0
"Belgium","2024-01-21",0,0,0,0,0,0,0,0
"Belgium","2024-01-22",0,0,0,0,0,0,0,0
"Belgium","2024-01-23",0,0,0,0,0,0,0,0
"Belgium","2024-01-24",0,0,0,0,0,0,0,0
"Belgium","2024-01-25",0,0,0,0,0,0,0,0
"Belgium","2024-01-26",0,0,0,0,0,0,0,0
"Belgium","2024-01-27",0,0,0,0,0,0,0,0
"Belgium","2024-01-28",0,0,0,0,0,0,0,0
"Belgium","2024-01-29",0,0,0,0,0,0,0,0
"Belgium","2024-01-30",0,0,0,0,0,0,0,0
"Belgium","2024-01-31",0,3,3,0,3,3,0,0
"Belgium","2024-02-01",0,0,3,0,0,3,0,0
"Belgium","2024-02-02",0,0,3,0,0,3,0,0
"Belgium","2024-02-03",0,0,3,0,0,3,0,0
"Belgium","2024-02-04",0,0,3,0,0,3,0,0
"Belgium","2024-02-05",0,0,3,0,0,3,0,0
"Belgium","2024-02-06",0,0,3,0,0,3,0,0
"Belgium","2024-02-07",0,0,3,0,0,3,0,0
"Belgium","2024-02-08",0,0,3,0,1,4,0,0
"Belgium","2024-02-09",0,0,3,0,0,4,0,0
"Belgium","2024-02-10",0,0,3,0,0,4,0,0
"Belgium","2024-02-11",0,0,3,0,0,4,0,0
"Belgium","2024-02-12",0,0,3,0,0,4,0,0
"Belgium","2024-02-13",0,0,3,0,0,4,0,0
"Belgium","2024-02-14",0,0,3,0,0,4,0,0
"Belgium","2024-02-15",0,0,3,0,0,4,0,0
"Belgium","2024-02-16",0,0,3,0,0,4,0,0
"Belgium","2024-02-17",0,0,3,0,0,4,0,0
"Belgium","2024-02-18",0,0,3,0,0,4,0,0
"Belgium","2024-02-19",0,0,3,0,0,4,0,0
"Belgium","2024-02-20",0,0,3,0,0,4,0,0
"Belgium","2024-02-21",0,0,3,0,0,4,0,0
"Belgium","2024-02-22",0,0,3,0,1,5,0,0
"Belgium","2024-02-23",0,0,3,0,0,5,0,0
"Belgium","2024-02-24",0,0,3,0,0,5,0,0
"Belgium","2024-02-25",0,0,3,0,0,5,0,0
"Belgium","2024-02-26",0,0,3,0,0,5,0,0
"Belgium","2024-02-27",0,0,3,0,0,5,0,0
"Belgium","2024-02-28",0,0,3,0,0,5,0,0
"Belgium","2024-02-29",0,2,5,0,0,5,0,0
"Belgium","2024-03-01",0,0,5,0,0,5,0,0
"Belgium","2024-03-02",0,0,5,0,0,5,0,0
"Belgium","2024-03-03",0,0,5,0,0,5,0,0
"Belgium","2024-03-04",0,0,5,0,0,5,0,0
"Belgium","2024-03-05",0,0,5,0,0,5,0,0
"Belgium","2024-03-06",0,0,5,0,0,5,0,0
"Belgium","2024-03-07",0,0,5,0,0,5,0,0
"Belgium","2024-03-08",0,0,5,0,0,5,0,0
"Belgium","2024-03-09",0,0,5,0,0,5,0,0
"Belgium","2024-03-10",0,0,5,0,0,5,0,0
"Belgium","2024-03-11",0,0,5,0,0,5,0,0
"Belgium","2024-03-12",0,0,5,0,0,5,0,0
"Belgium","2024-03-13",0,0,5,0,0,5,0,0
"Belgium","2024-03-14",0,0,5,0,0,5,0,0
"Belgium","2024-03-15",0,0,5,0,0,5,0,0
"Belgium","2024-03-16",0,0,5,0,1,6,0,0
"Belgium","2024-03-17",0,0,5,0,0,6,0,0
"Belgium","2024-03-18",0,0,5,0,0,6,0,0
"Belgium","2024-03-19",0,0,5,0,0,6,0,0
"Belgium","2024-03-20",0,0,5,0,0,6,0,0
"Belgium","2024-03-21",0,0,5,0,0,6,0,0
"Belgium","2024-03-22",0,0,5,0,0,6,0,0
"Belgium","2024-03-23",0,0,5,0,0,6,0,0
"Belgium","2024-03-24",0,0,5,0,0,6,0,0
"Belgium","2024-03-25",0,0,5,0,0,6,0,0
"Belgium","2024-03-26",0,0,5,0,0,6,0,0
"Belgium","2024-03-27",0,0,5,0,0,6,0,0
"Belgium","2024-03-28",0,0,5,0,0,6,0,0
"Belgium","2024-03-29",0,0,5,0,0,6,0,0
"Belgium","2024-03-30",0,0,5,0,0,6,0,0
"Belgium","2024-03-31",0,1,6,0,0,6,0,0
"Belgium","2024-04-01",0,0,6,0,0,6,0,0
"Belgium","2024-04-02",0,0,6,0,0,6,0,0
"Belgium","2024-04-03",0,0,6,0,0,6,0,0
"Belgium","2024-04-04",0,0,6,0,0,6,0,0
"Belgium","2024-04-05",0,0,6,0,0,6,0,0
"Belgium","2024-04-06",0,0,6,0,1,7,0,0
"Belgium","2024-04-07",0,0,6,0,0,7,0,0
"Belgium","2024-04-08",0,0,6,0,0,7,0,0
"Belgium","2024-04-09",0,0,6,0,0,7,0,0
"Belgium","2024-04-10",0,0,6,0,0,7,0,0
"Belgium","2024-04-11",0,0,6,0,0,7,0,0
"Belgium","2024-04-12",0,0,6,0,0,7,0,0
"Belgium","2024-04-13",0,0,6,0,0,7,0,0
"Belgium","2024-04-14",0,0,6,0,0,7,0,0
"Belgium","2024-04-15",0,0,6,0,1,8,0,0
"Belgium","2024-04-16",0,0,6,0,0,8,0,0
"Belgium","2024-04-17",0,0,6,0,0,8,0,0
"Belgium","2024-04-18",0,0,6,0,0,8,0,0
"Belgium","2024-04-19",0,0,6,0,0,8,0,0
"Belgium","2024-04-20",0,0,6,0,0,8,0,0
"Belgium","2024-04-21",0,0,6,0,0,8,0,0
"Belgium","2024-04-22",0,0,6,0,0,8,0,0
"Belgium","2024-04-23",0,0,6,0,0,8,0,0
"Belgium","2024-04-24",0,0,6,0,0,8,0,0
"Belgium","2024-04-25",0,0,6,0,0,8,0,0
"Belgium","2024-04-26",0,0,6,0,1,9,0,0
"Belgium","2024-04-27",0,0,6,0,0,9,0,0
"Belgium","2024-04-28",0,0,6,0,0,9,0,0
"Belgium","2024-04-29",0,0,6,0,0,9,0,0
"Belgium","2024-04-30",0,3,9,0,0,9,0,0
"Belgium","2024-05-01",0,0,9,0,0,9,0,0
"Belgium","2024-05-02",0,0,9,0,0,9,0,0
"Belgium","2024-05-03",0,0,9,0,0,9,0,0
"Belgium","2024-05-04",0,0,9,0,0,9,0,0
"Belgium","2024-05-05",0,0,9,0,0,9,0,0
"Belgium","2024-05-06",0,0,9,0,0,9,0,0
"Belgium","2024-05-07",0,0,9,0,0,9,0,0
"Belgium","2024-05-08",0,0,9,0,0,9,0,0
"Belgium","2024-05-09",0,0,9,0,0,9,0,0
"Belgium","2024-05-10",0,0,9,0,0,9,0,0
"Belgium","2024-05-11",0,0,9,0,0,9,0,0
"Belgium","2024-05-12",0,0,9,0,0,9,0,0
"Belgium","2024-05-13",0,0,9,0,0,9,0,0
"Belgium","2024-05-14",0,0,9,0,0,9,0,0
"Belgium","2024-05-15",0,0,9,0,0,9,0,0
"Belgium","2024-05-16",0,0,9,0,0,9,0,0
"Belgium","2024-05-17",0,0,9,0,0,9,0,0
"Belgium","2024-05-18",0,0,9,0,0,9,0,0
"Belgium","2024-05-19",0,0,9,0,0,9,0,0
"Belgium","2024-05-20",0,0,9,0,0,9,0,0
"Belgium","2024-05-21",0,0,9,0,0,9,0,0
"Belgium","2024-05-22",0,0,9,0,0,9,0,0
"Belgium","2024-05-23",0,0,9,0,0,9,0,0
"Belgium","2024-05-24",0,0,9,0,0,9,0,0
"Belgium","2024-05-25",0,0,9,0,0,9,0,0
"Belgium","2024-05-26",0,0,9,0,0,9,0,0
"Belgium","2024-05-27",0,0,9,0,0,9,0,0
"Belgium","2024-05-28",0,0,9,0,0,9,0,0
"Belgium","2024-05-29",0,0,9,0,0,9,0,0
"Belgium","2024-05-30",0,0,9,0,0,9,0,0
"Belgium","2024-05-31",0,0,9,0,1,10,0,0
"Belgium","2024-06-01",0,0,9,0,0,10,0,0
"Belgium","2024-06-02",0,0,9,0,0,10,0,0
"Belgium","2024-06-03",0,0,9,0,0,10,0,0
"Belgium","2024-06-04",0,0,9,0,0,10,0,0
"Belgium","2024-06-05",0,0,9,0,0,10,0,0
"Belgium","2024-06-06",0,0,9,0,0,10,0,0
"Belgium","2024-06-07",0,0,9,0,0,10,0,0
"Belgium","2024-06-08",0,0,9,0,0,10,0,0
"Belgium","2024-06-09",0,0,9,0,0,10,0,0
"Belgium","2024-06-10",0,0,9,0,0,10,0,0
"Belgium","2024-06-11",0,0,9,0,0,10,0,0
"Belgium","2024-06-12",0,0,9,0,0,10,0,0
"Belgium","2024-06-13",0,0,9,0,0,10,0,0
"Belgium","2024-06-14",0,0,9,0,0,10,0,0
"Belgium","2024-06-15",0,0,9,0,0,10,0,0
"Belgium","2024-06-16",0,0,9,0,0,10,0,0
"Belgium","2024-06-17",0,0,9,0,0,10,0,0
"Belgium","2024-06-18",0,0,9,0,0,10,0,0
"Belgium","2024-06-19",0,0,9,0,0,10,0,0
"Belgium","2024-06-20",0,0,9,0,0,10,0,0
"Belgium","2024-06-21",0,0,9,0,0,10,0,0
"Belgium","2024-06-22",0,0,9,0,0,10,0,0
"Belgium","2024-06-23",0,0,9,0,0,10,0,0
"Belgium","2024-06-24",0,0,9,0,0,10,0,0
"Belgium","2024-06-25",0,0,9,0,0,10,0,0
"Belgium","2024-06-26",0,0,9,0,0,10,0,0
"Belgium","2024-06-27",0,0,9,0,0,10,0,0
"Belgium","2024-06-28",0,0,9,0,0,10,0,0
"Belgium","2024-06-29",0,0,9,0,0,10,0,0
"Belgium","2024-06-30",0,1,10,0,0,10,0,0
"Belgium","2024-07-01",0,0,10,0,0,10,0,0
"Belgium","2024-07-02",0,0,10,0,0,10,0,0
"Belgium","2024-07-03",0,0,10,0,0,10,0,0
"Belgium","2024-07-04",0,0,10,0,0,10,0,0
"Belgium","2024-07-05",0,0,10,0,0,10,0,0
"Belgium","2024-07-06",0,0,10,0,0,10,0,0
"Belgium","2024-07-07",0,0,10,0,0,10,0,0
"Belgium","2024-07-08",0,0,10,0,0,10,0,0
"Belgium","2024-07-09",0,0,10,0,0,10,0,0
"Belgium","2024-07-10",0,0,10,0,0,10,0,0
"Belgium","2024-07-11",0,0,10,0,0,10,0,0
"Belgium","2024-07-12",0,0,10,0,0,10,0,0
"Belgium","2024-07-13",0,0,10,0,0,10,0,0
"Belgium","2024-07-14",0,0,10,0,0,10,0,0
"Belgium","2024-07-15",0,0,10,0,0,10,0,0
"Belgium","2024-07-16",0,0,10,0,1,11,0,0
"Belgium","2024-07-17",0,0,10,0,0,11,0,0
"Belgium","2024-07-18",0,0,10,0,0,11,0,0
"Belgium","2024-07-19",0,0,10,0,0,11,0,0
"Belgium","2024-07-20",0,0,10,0,0,11,0,0
"Belgium","2024-07-21",0,0,10,0,0,11,0,0
"Belgium","2024-07-22",0,0,10,0,0,11,0,0
"Belgium","2024-07-23",0,0,10,0,0,11,0,0
"Belgium","2024-07-24",0,0,10,0,0,11,0,0
"Belgium","2024-07-25",0,0,10,0,0,11,0,0
"Belgium","2024-07-26",0,0,10,0,0,11,0,0
"Belgium","2024-07-27",0,0,10,0,0,11,0,0
"Belgium","2024-07-28",0,0,10,0,0,11,0,0
"Belgium","2024-07-29",0,0,10,0,0,11,0,0
"Belgium","2024-07-30",0,0,10,0,0,11,0,0
"Belgium","2024-07-31",0,1,11,0,0,11,0,0
"Belgium","2024-08-01",0,0,11,0,0,11,0,0
"Belgium","2024-08-02",0,0,11,0,0,11,0,0
"Belgium","2024-08-03",0,0,11,0,0,11,0,0
"Belgium","2024-08-04",0,0,11,0,0,11,0,0
"Belgium","2024-08-05",0,0,11,0,0,11,0,0
"Belgium","2024-08-06",0,0,11,0,1,12,0,0
"Belgium","2024-08-07",0,0,11,0,0,12,0,0
"Belgium","2024-08-08",0,0,11,0,0,12,0,0
"Belgium","2024-08-09",0,0,11,0,0,12,0,0
"Belgium","2024-08-10",0,0,11,0,0,12,0,0
"Belgium","2024-08-11",0,0,11,0,0,12,0,0
"Belgium","2024-08-12",0,0,11,0,0,12,0,0
"Belgium","2024-08-13",0,0,11,0,0,12,0,0
"Belgium","2024-08-14",0,0,11,0,0,12,0,0
"Belgium","2024-08-15",0,0,11,0,0,12,0,0
"Belgium","2024-08-16",0,0,11,0,1,13,0,0
"Belgium","2024-08-17",0,0,11,0,0,13,0,0
"Belgium","2024-08-18",0,0,11,0,0,13,0,0
"Belgium","2024-08-19",0,0,11,0,0,13,0,0
"Belgium","2024-08-20",0,0,11,0,0,13,0,0
"Belgium","2024-08-21",0,0,11,0,0,13,0,0
"Belgium","2024-08-22",0,0,11,0,0,13,0,0
"Belgium","2024-08-23",0,0,11,0,0,13,0,0
"Belgium","2024-08-24",0,0,11,0,0,13,0,0
"Belgium","2024-08-25",0,0,11,0,0,13,0,0
"Belgium","2024-08-26",0,0,11,0,1,14,0,0
"Belgium","2024-08-27",0,0,11,0,0,14,0,0
"Belgium","2024-08-28",0,0,11,0,0,14,0,0
"Belgium","2024-08-29",0,0,11,0,0,14,0,0
"Belgium","2024-08-30",0,0,11,0,0,14,0,0
"Belgium","2024-08-31",0,3,14,0,0,14,0,0
"Belgium","2024-09-01",0,0,14,0,0,14,0,0
"Belgium","2024-09-02",0,0,14,0,1,15,0,0
"Belgium","2024-09-03",0,0,14,0,0,15,0,0
"Belgium","2024-09-04",0,0,14,0,0,15,0,0
"Belgium","2024-09-05",0,0,14,0,0,15,0,0
"Belgium","2024-09-06",0,0,14,0,1,16,0,0
"Belgium","2024-09-07",0,0,14,0,0,16,0,0
"Belgium","2024-09-08",0,0,14,0,0,16,0,0
"Belgium","2024-09-09",0,0,14,0,0,16,0,0
"Belgium","2024-09-10",0,0,14,0,1,17,0,0
"Belgium","2024-09-11",0,0,14,0,0,17,0,0
"Belgium","2024-09-12",0,0,14,0,0,17,0,0
"Belgium","2024-09-13",0,0,14,0,0,17,0,0
"Belgium","2024-09-14",0,0,14,0,1,18,0,0
"Belgium","2024-09-15",0,0,14,0,0,18,0,0
"Belgium","2024-09-16",0,0,14,0,0,18,0,0
"Belgium","2024-09-17",0,0,14,0,1,19,0,0
"Belgium","2024-09-18",0,0,14,0,0,19,0,0
"Belgium","2024-09-19",0,0,14,0,0,19,0,0
"Belgium","2024-09-20",0,0,14,0,0,19,0,0
"Belgium","2024-09-21",0,0,14,0,1,20,0,0
"Belgium","2024-09-22",0,0,14,0,0,20,0,0
"Belgium","2024-09-23",0,0,14,0,0,20,0,0
"Belgium","2024-09-24",0,0,14,0,0,20,0,0
"Belgium","2024-09-25",0,0,14,0,1,21,0,0
"Belgium","2024-09-26",0,0,14,0,0,21,0,0
"Belgium","2024-09-27",0,0,14,0,0,21,0,0
"Belgium","2024-09-28",0,0,14,0,0,21,0,0
"Belgium","2024-09-29",0,0,14,0,1,22,0,0
"Belgium","2024-09-30",0,8,22,0,0,22,0,0
"Belgium","2024-10-01",0,0,22,0,1,23,0,0
"Belgium","2024-10-02",0,0,22,0,0,23,0,0
"Belgium","2024-10-03",0,0,22,0,1,24,0,0
"Belgium","2024-10-04",0,0,22,0,0,24,0,0
"Belgium","2024-10-05",0,0,22,0,1,25,0,0
"Belgium","2024-10-06",0,0,22,0,0,25,0,0
"Belgium","2024-10-07",0,0,22,0,1,26,0,0
"Belgium","2024-10-08",0,0,22,0,0,26,0,0
"Belgium","2024-10-09",0,0,22,0,1,27,0,0
"Belgium","2024-10-10",0,0,22,0,0,27,0,0
"Belgium","2024-10-11",0,0,22,0,1,28,0,0
"Belgium","2024-10-12",0,0,22,0,1,29,0,0
"Belgium","2024-10-13",0,0,22,0,0,29,0,0
"Belgium","2024-10-14",0,0,22,0,1,30,0,0
"Belgium","2024-10-15",0,0,22,0,0,30,0,0
"Belgium","2024-10-16",0,0,22,0,1,31,0,0
"Belgium","2024-10-17",0,0,22,0,0,31,0,0
"Belgium","2024-10-18",0,0,22,0,1,32,0,0
"Belgium","2024-10-19",0,0,22,0,0,32,0,0
"Belgium","2024-10-20",0,0,22,0,1,33,0,0
"Belgium","2024-10-21",0,0,22,0,1,34,0,0
"Belgium","2024-10-22",0,0,22,0,0,34,0,0
"Belgium","2024-10-23",0,0,22,0,1,35,0,0
"Belgium","2024-10-24",0,0,22,0,0,35,0,0
"Belgium","2024-10-25",0,0,22,0,1,36,0,0
"Belgium","2024-10-26",0,0,22,0,0,36,0,0
"Belgium","2024-10-27",0,0,22,0,1,37,0,0
"Belgium","2024-10-28",0,0,22,0,0,37,0,0
"Belgium","2024-10-29",0,0,22,0,1,38,0,0
"Belgium","2024-10-30",0,0,22,0,0,38,0,0
"Belgium","2024-10-31",0,17,39,0,1,39,0,0
"Belgium","2024-11-01",0,0,39,0,0,39,0,0
"Belgium","2024-11-02",0,0,39,0,0,39,0,0
"Belgium","2024-11-03",0,0,39,0,1,40,0,0
"Belgium","2024-11-04",0,0,39,0,0,40,0,0
"Belgium","2024-11-05",0,0,39,0,0,40,0,0
"Belgium","2024-11-06",0,0,39,0,0,40,0,0
"Belgium","2024-11-07",0,0,39,0,0,40,0,0
"Belgium","2024-11-08",0,0,39,0,1,41,0,0
"Belgium","2024-11-09",0,0,39,0,0,41,0,0
"Belgium","2024-11-10",0,0,39,0,0,41,0,0
"Belgium","2024-11-11",0,0,39,0,0,41,0,0
"Belgium","2024-11-12",0,0,39,0,0,41,0,0
"Belgium","2024-11-13",0,0,39,0,1,42,0,0
"Belgium","2024-11-14",0,0,39,0,0,42,0,0
"Belgium","2024-11-15",0,0,39,0,0,42,0,0
"Belgium","2024-11-16",0,0,39,0,0,42,0,0
"Belgium","2024-11-17",0,0,39,0,0,42,0,0
"Belgium","2024-11-18",0,0,39,0,1,43,0,0
"Belgium","2024-11-19",0,0,39,0,0,43,0,0
"Belgium","2024-11-20",0,0,39,0,0,43,0,0
"Belgium","2024-11-21",0,0,39,0,0,43,0,0
"Belgium","2024-11-22",0,0,39,0,0,43,0,0
"Belgium","2024-11-23",0,0,39,0,1,44,0,0
"Belgium","2024-11-24",0,0,39,0,0,44,0,0
"Belgium","2024-11-25",0,0,39,0,0,44,0,0
"Belgium","2024-11-26",0,0,39,0,0,44,0,0
"Belgium","2024-11-27",0,0,39,0,0,44,0,0
"Belgium","2024-11-28",0,0,39,0,1,45,0,0
"Belgium","2024-11-29",0,0,39,0,0,45,0,0
"Belgium","2024-11-30",0,6,45,0,0,45,0,0
"Belgium","2024-12-01",0,0,45,0,0,45,0,0
"Belgium","2024-12-02",0,0,45,0,0,45,0,0
"Belgium","2024-12-03",0,0,45,0,1,46,0,0
"Belgium","2024-12-04",0,0,45,0,0,46,0,0
"Belgium","2024-12-05",0,0,45,0,0,46,0,0
"Belgium","2024-12-06",0,0,45,0,0,46,0,0
"Belgium","2024-12-07",0,0,45,0,1,47,0,0
"Belgium","2024-12-08",0,0,45,0,0,47,0,0
"Belgium","2024-12-09",0,0,45,0,0,47,0,0
"Belgium","2024-12-10",0,0,45,0,0,47,0,0
"Belgium","2024-12-11",0,0,45,0,0,47,0,0
"Belgium","2024-12-12",0,0,45,0,1,48,0,0
"Belgium","2024-12-13",0,0,45,0,0,48,0,0
"Belgium","2024-12-14",0,0,45,0,0,48,0,0
"Belgium","2024-12-15",0,0,45,0,0,48,0,0
"Belgium","2024-12-16",0,0,45,0,1,49,0,0
"Belgium","2024-12-17",0,0,45,0,0,49,0,0
"Belgium","2024-12-18",0,0,45,0,0,49,0,0
"Belgium","2024-12-19",0,0,45,0,0,49,0,0
"Belgium","2024-12-20",0,0,45,0,1,50,0,0
"Belgium","2024-12-21",0,0,45,0,0,50,0,0
"Belgium","2024-12-22",0,0,45,0,0,50,0,0
"Belgium","2024-12-23",0,0,45,0,0,50,0,0
"Belgium","2024-12-24",0,0,45,0,0,50,0,0
"Belgium","2024-12-25",0,0,45,0,1,51,0,0
"Belgium","2024-12-26",0,0,45,0,0,51,0,0
"Belgium","2024-12-27",0,0,45,0,0,51,0,0
"Belgium","2024-12-28",0,0,45,0,0,51,0,0
"Belgium","2024-12-29",0,0,45,0,1,52,0,0
"Belgium","2024-12-30",0,0,45,0,0,52,0,0
"Belgium","2024-12-31",0,7,52,0,0,52,0,0
"Belgium","2025-01-01",0,0,52,0,0,52,0,0
"Belgium","2025-01-02",0,0,52,0,0,52,0,0
"Belgium","2025-01-03",0,0,52,0,0,52,0,0
"Belgium","2025-01-04",0,0,52,0,0,52,0,0
"Belgium","2025-01-05",0,0,52,0,0,52,0,0
"Belgium","2025-01-06",0,0,52,0,0,52,0,0
"Belgium","2025-01-07",0,0,52,0,0,52,0,0
"Belgium","2025-01-08",0,0,52,0,0,52,0,0
"Belgium","2025-01-09",0,0,52,0,0,52,0,0
"Belgium","2025-01-10",0,0,52,0,0,52,0,0
"Belgium","2025-01-11",0,0,52,0,0,52,0,0
"Belgium","2025-01-12",0,0,52,0,0,52,0,0
"Belgium","2025-01-13",0,0,52,0,0,52,0,0
"Belgium","2025-01-14",0,0,52,0,0,52,0,0
"Belgium","2025-01-15",0,0,52,0,0,52,0,0
"Belgium","2025-01-16",0,0,52,0,0,52,0,0
"Belgium","2025-01-17",0,0,52,0,0,52,0,0
"Belgium","2025-01-18",0,0,52,0,0,52,0,0
"Belgium","2025-01-19",0,0,52,0,0,52,0,0
"Belgium","2025-01-20",0,0,52,0,0,52,0,0
"Belgium","2025-01-21",0,0,52,0,0,52,0,0
"Belgium","2025-01-22",0,0,52,0,0,52,0,0
"Belgium","2025-01-23",0,0,52,0,0,52,0,0
"Belgium","2025-01-24",0,0,52,0,0,52,0,0
"Belgium","2025-01-25",0,0,52,0,0,52,0,0
"Belgium","2025-01-26",0,0,52,0,0,52,0,0
"Belgium","2025-01-27",0,0,52,0,0,52,0,0
"Belgium","2025-01-28",0,0,52,0,0,52,0,0
"Belgium","2025-01-29",0,0,52,0,0,52,0,0
"Belgium","2025-01-30",0,0,52,0,0,52,0,0
"Belgium","2025-01-31",0,0,52,0,0,52,0,0
"Belgium","2025-02-01",0,0,52,0,0,52,0,0
"Belgium","2025-02-02",0,0,52,0,0,52,0,0
"Belgium","2025-02-03",0,0,52,0,0,52,0,0
"Benin","2024-01-01",0,0,0,0,0,0,0,0
"Benin","2024-01-02",0,0,0,0,0,0,0,0
"Benin","2024-01-03",0,0,0,0,0,0,0,0
"Benin","2024-01-04",0,0,0,0,0,0,0,0
"Benin","2024-01-05",0,0,0,0,0,0,0,0
"Benin","2024-01-06",0,0,0,0,0,0,0,0
"Benin","2024-01-07",0,0,0,0,0,0,0,0
"Benin","2024-01-08",0,0,0,0,0,0,0,0
"Benin","2024-01-09",0,0,0,0,0,0,0,0
"Benin","2024-01-10",0,0,0,0,0,0,0,0
"Benin","2024-01-11",0,0,0,0,0,0,0,0
"Benin","2024-01-12",0,0,0,0,0,0,0,0
"Benin","2024-01-13",0,0,0,0,0,0,0,0
"Benin","2024-01-14",0,0,0,0,0,0,0,0
"Benin","2024-01-15",0,0,0,0,0,0,0,0
"Benin","2024-01-16",0,0,0,0,0,0,0,0
"Benin","2024-01-17",0,0,0,0,0,0,0,0
"Benin","2024-01-18",0,0,0,0,0,0,0,0
"Benin","2024-01-19",0,0,0,0,0,0,0,0
"Benin","2024-01-20",0,0,0,0,0,0,0,0
"Benin","2024-01-21",0,0,0,0,0,0,0,0
"Benin","2024-01-22",0,0,0,0,0,0,0,0
"Benin","2024-01-23",0,0,0,0,0,0,0,0
"Benin","2024-01-24",0,0,0,0,0,0,0,0
"Benin","2024-01-25",0,0,0,0,0,0,0,0
"Benin","2024-01-26",0,0,0,0,0,0,0,0
"Benin","2024-01-27",0,0,0,0,0,0,0,0
"Benin","2024-01-28",0,0,0,0,0,0,0,0
"Benin","2024-01-29",0,0,0,0,0,0,0,0
"Benin","2024-01-30",0,0,0,0,0,0,0,0
"Benin","2024-01-31",0,0,0,0,0,0,0,0
"Benin","2024-02-01",0,0,0,0,0,0,0,0
"Benin","2024-02-02",0,0,0,0,0,0,0,0
"Benin","2024-02-03",0,0,0,0,0,0,0,0
"Benin","2024-02-04",0,0,0,0,0,0,0,0
"Benin","2024-02-05",0,0,0,0,0,0,0,0
"Benin","2024-02-06",0,0,0,0,0,0,0,0
"Benin","2024-02-07",0,0,0,0,0,0,0,0
"Benin","2024-02-08",0,0,0,0,0,0,0,0
"Benin","2024-02-09",0,0,0,0,0,0,0,0
"Benin","2024-02-10",0,0,0,0,0,0,0,0
"Benin","2024-02-11",0,0,0,0,0,0,0,0
"Benin","2024-02-12",0,0,0,0,0,0,0,0
"Benin","2024-02-13",0,0,0,0,0,0,0,0
"Benin","2024-02-14",0,0,0,0,0,0,0,0
"Benin","2024-02-15",0,0,0,0,0,0,0,0
"Benin","2024-02-16",0,0,0,0,0,0,0,0
"Benin","2024-02-17",0,0,0,0,0,0,0,0
"Benin","2024-02-18",0,0,0,0,0,0,0,0
"Benin","2024-02-19",0,0,0,0,0,0,0,0
"Benin","2024-02-20",0,0,0,0,0,0,0,0
"Benin","2024-02-21",0,0,0,0,0,0,0,0
"Benin","2024-02-22",0,0,0,0,0,0,0,0
"Benin","2024-02-23",0,0,0,0,0,0,0,0
"Benin","2024-02-24",0,0,0,0,0,0,0,0
"Benin","2024-02-25",0,0,0,0,0,0,0,0
"Benin","2024-02-26",0,0,0,0,0,0,0,0
"Benin","2024-02-27",0,0,0,0,0,0,0,0
"Benin","2024-02-28",0,0,0,0,0,0,0,0
"Benin","2024-02-29",0,0,0,0,0,0,0,0
"Benin","2024-03-01",0,0,0,0,0,0,0,0
"Benin","2024-03-02",0,0,0,0,0,0,0,0
"Benin","2024-03-03",0,0,0,0,0,0,0,0
"Benin","2024-03-04",0,0,0,0,0,0,0,0
"Benin","2024-03-05",0,0,0,0,0,0,0,0
"Benin","2024-03-06",0,0,0,0,0,0,0,0
"Benin","2024-03-07",0,0,0,0,0,0,0,0
"Benin","2024-03-08",0,0,0,0,0,0,0,0
"Benin","2024-03-09",0,0,0,0,0,0,0,0
"Benin","2024-03-10",0,0,0,0,0,0,0,0
"Benin","2024-03-11",0,0,0,0,0,0,0,0
"Benin","2024-03-12",0,0,0,0,0,0,0,0
"Benin","2024-03-13",0,0,0,0,0,0,0,0
"Benin","2024-03-14",0,0,0,0,0,0,0,0
"Benin","2024-03-15",0,0,0,0,0,0,0,0
"Benin","2024-03-16",0,0,0,0,0,0,0,0
"Benin","2024-03-17",0,0,0,0,0,0,0,0
"Benin","2024-03-18",0,0,0,0,0,0,0,0
"Benin","2024-03-19",0,0,0,0,0,0,0,0
"Benin","2024-03-20",0,0,0,0,0,0,0,0
"Benin","2024-03-21",0,0,0,0,0,0,0,0
"Benin","2024-03-22",0,0,0,0,0,0,0,0
"Benin","2024-03-23",0,0,0,0,0,0,0,0
"Benin","2024-03-24",0,0,0,0,0,0,0,0
"Benin","2024-03-25",0,0,0,0,0,0,0,0
"Benin","2024-03-26",0,0,0,0,0,0,0,0
"Benin","2024-03-27",0,0,0,0,0,0,0,0
"Benin","2024-03-28",0,0,0,0,0,0,0,0
"Benin","2024-03-29",0,0,0,0,0,0,0,0
"Benin","2024-03-30",0,0,0,0,0,0,0,0
"Benin","2024-03-31",0,0,0,0,0,0,0,0
"Benin","2024-04-01",0,0,0,0,0,0,0,0
"Benin","2024-04-02",0,0,0,0,0,0,0,0
"Benin","2024-04-03",0,0,0,0,0,0,0,0
"Benin","2024-04-04",0,0,0,0,0,0,0,0
"Benin","2024-04-05",0,0,0,0,0,0,0,0
"Benin","2024-04-06",0,0,0,0,0,0,0,0
"Benin","2024-04-07",0,0,0,0,0,0,0,0
"Benin","2024-04-08",0,0,0,0,0,0,0,0
"Benin","2024-04-09",0,0,0,0,0,0,0,0
"Benin","2024-04-10",0,0,0,0,0,0,0,0
"Benin","2024-04-11",0,0,0,0,0,0,0,0
"Benin","2024-04-12",0,0,0,0,0,0,0,0
"Benin","2024-04-13",0,0,0,0,0,0,0,0
"Benin","2024-04-14",0,0,0,0,0,0,0,0
"Benin","2024-04-15",0,0,0,0,0,0,0,0
"Benin","2024-04-16",0,0,0,0,0,0,0,0
"Benin","2024-04-17",0,0,0,0,0,0,0,0
"Benin","2024-04-18",0,0,0,0,0,0,0,0
"Benin","2024-04-19",0,0,0,0,0,0,0,0
"Benin","2024-04-20",0,0,0,0,0,0,0,0
"Benin","2024-04-21",0,0,0,0,0,0,0,0
"Benin","2024-04-22",0,0,0,0,0,0,0,0
"Benin","2024-04-23",0,0,0,0,0,0,0,0
"Benin","2024-04-24",0,0,0,0,0,0,0,0
"Benin","2024-04-25",0,0,0,0,0,0,0,0
"Benin","2024-04-26",0,0,0,0,0,0,0,0
"Benin","2024-04-27",0,0,0,0,0,0,0,0
"Benin","2024-04-28",0,0,0,0,0,0,0,0
"Benin","2024-04-29",0,0,0,0,0,0,0,0
"Benin","2024-04-30",0,0,0,0,0,0,0,0
"Benin","2024-05-01",0,0,0,0,0,0,0,0
"Benin","2024-05-02",0,0,0,0,0,0,0,0
"Benin","2024-05-03",0,0,0,0,0,0,0,0
"Benin","2024-05-04",0,0,0,0,0,0,0,0
"Benin","2024-05-05",0,0,0,0,0,0,0,0
"Benin","2024-05-06",0,0,0,0,0,0,0,0
"Benin","2024-05-07",0,0,0,0,0,0,0,0
"Benin","2024-05-08",0,0,0,0,0,0,0,0
"Benin","2024-05-09",0,0,0,0,0,0,0,0
"Benin","2024-05-10",0,0,0,0,0,0,0,0
"Benin","2024-05-11",0,0,0,0,0,0,0,0
"Benin","2024-05-12",0,0,0,0,0,0,0,0
"Benin","2024-05-13",0,0,0,0,0,0,0,0
"Benin","2024-05-14",0,0,0,0,0,0,0,0
"Benin","2024-05-15",0,0,0,0,0,0,0,0
"Benin","2024-05-16",0,0,0,0,0,0,0,0
"Benin","2024-05-17",0,0,0,0,0,0,0,0
"Benin","2024-05-18",0,0,0,0,0,0,0,0
"Benin","2024-05-19",0,0,0,0,0,0,0,0
"Benin","2024-05-20",0,0,0,0,0,0,0,0
"Benin","2024-05-21",0,0,0,0,0,0,0,0
"Benin","2024-05-22",0,0,0,0,0,0,0,0
"Benin","2024-05-23",0,0,0,0,0,0,0,0
"Benin","2024-05-24",0,0,0,0,0,0,0,0
"Benin","2024-05-25",0,0,0,0,0,0,0,0
"Benin","2024-05-26",0,0,0,0,0,0,0,0
"Benin","2024-05-27",0,0,0,0,0,0,0,0
"Benin","2024-05-28",0,0,0,0,0,0,0,0
"Benin","2024-05-29",0,0,0,0,0,0,0,0
"Benin","2024-05-30",0,0,0,0,0,0,0,0
"Benin","2024-05-31",0,0,0,0,0,0,0,0
"Benin","2024-06-01",0,0,0,0,0,0,0,0
"Benin","2024-06-02",0,0,0,0,0,0,0,0
"Benin","2024-06-03",0,0,0,0,0,0,0,0
"Benin","2024-06-04",0,0,0,0,0,0,0,0
"Benin","2024-06-05",0,0,0,0,0,0,0,0
"Benin","2024-06-06",0,0,0,0,0,0,0,0
"Benin","2024-06-07",0,0,0,0,0,0,0,0
"Benin","2024-06-08",0,0,0,0,0,0,0,0
"Benin","2024-06-09",0,0,0,0,0,0,0,0
"Benin","2024-06-10",0,0,0,0,0,0,0,0
"Benin","2024-06-11",0,0,0,0,0,0,0,0
"Benin","2024-06-12",0,0,0,0,0,0,0,0
"Benin","2024-06-13",0,0,0,0,0,0,0,0
"Benin","2024-06-14",0,0,0,0,0,0,0,0
"Benin","2024-06-15",0,0,0,0,0,0,0,0
"Benin","2024-06-16",0,0,0,0,0,0,0,0
"Benin","2024-06-17",0,0,0,0,0,0,0,0
"Benin","2024-06-18",0,0,0,0,0,0,0,0
"Benin","2024-06-19",0,0,0,0,0,0,0,0
"Benin","2024-06-20",0,0,0,0,0,0,0,0
"Benin","2024-06-21",0,0,0,0,0,0,0,0
"Benin","2024-06-22",0,0,0,0,0,0,0,0
"Benin","2024-06-23",0,0,0,0,0,0,0,0
"Benin","2024-06-24",0,0,0,0,0,0,0,0
"Benin","2024-06-25",0,0,0,0,0,0,0,0
"Benin","2024-06-26",0,0,0,0,0,0,0,0
"Benin","2024-06-27",0,0,0,0,0,0,0,0
"Benin","2024-06-28",0,0,0,0,0,0,0,0
"Benin","2024-06-29",0,0,0,0,0,0,0,0
"Benin","2024-06-30",0,0,0,0,0,0,0,0
"Benin","2024-07-01",0,0,0,0,0,0,0,0
"Benin","2024-07-02",0,0,0,0,0,0,0,0
"Benin","2024-07-03",0,0,0,0,0,0,0,0
"Benin","2024-07-04",0,0,0,0,0,0,0,0
"Benin","2024-07-05",0,0,0,0,0,0,0,0
"Benin","2024-07-06",0,0,0,0,0,0,0,0
"Benin","2024-07-07",0,0,0,0,0,0,0,0
"Benin","2024-07-08",0,0,0,0,0,0,0,0
"Benin","2024-07-09",0,0,0,0,0,0,0,0
"Benin","2024-07-10",0,0,0,0,0,0,0,0
"Benin","2024-07-11",0,0,0,0,0,0,0,0
"Benin","2024-07-12",0,0,0,0,0,0,0,0
"Benin","2024-07-13",0,0,0,0,0,0,0,0
"Benin","2024-07-14",0,0,0,0,0,0,0,0
"Benin","2024-07-15",0,0,0,0,0,0,0,0
"Benin","2024-07-16",0,0,0,0,0,0,0,0
"Benin","2024-07-17",0,0,0,0,0,0,0,0
"Benin","2024-07-18",0,0,0,0,0,0,0,0
"Benin","2024-07-19",0,0,0,0,0,0,0,0
"Benin","2024-07-20",0,0,0,0,0,0,0,0
"Benin","2024-07-21",0,0,0,0,0,0,0,0
"Benin","2024-07-22",0,0,0,0,0,0,0,0
"Benin","2024-07-23",0,0,0,0,0,0,0,0
"Benin","2024-07-24",0,0,0,0,0,0,0,0
"Benin","2024-07-25",0,0,0,0,0,0,0,0
"Benin","2024-07-26",0,0,0,0,0,0,0,0
"Benin","2024-07-27",0,0,0,0,0,0,0,0
"Benin","2024-07-28",0,0,0,0,0,0,0,0
"Benin","2024-07-29",0,0,0,0,0,0,0,0
"Benin","2024-07-30",0,0,0,0,0,0,0,0
"Benin","2024-07-31",0,0,0,0,0,0,0,0
"Benin","2024-08-01",0,0,0,0,0,0,0,0
"Benin","2024-08-02",0,0,0,0,0,0,0,0
"Benin","2024-08-03",0,0,0,0,0,0,0,0
"Benin","2024-08-04",0,0,0,0,0,0,0,0
"Benin","2024-08-05",0,0,0,0,0,0,0,0
"Benin","2024-08-06",0,0,0,0,0,0,0,0
"Benin","2024-08-07",0,0,0,0,0,0,0,0
"Benin","2024-08-08",0,0,0,0,0,0,0,0
"Benin","2024-08-09",0,0,0,0,0,0,0,0
"Benin","2024-08-10",0,0,0,0,0,0,0,0
"Benin","2024-08-11",0,0,0,0,0,0,0,0
"Benin","2024-08-12",0,0,0,0,0,0,0,0
"Benin","2024-08-13",0,0,0,0,0,0,0,0
"Benin","2024-08-14",0,0,0,0,0,0,0,0
"Benin","2024-08-15",0,0,0,0,0,0,0,0
"Benin","2024-08-16",0,0,0,0,0,0,0,0
"Benin","2024-08-17",0,0,0,0,0,0,0,0
"Benin","2024-08-18",0,0,0,0,0,0,0,0
"Benin","2024-08-19",0,0,0,0,0,0,0,0
"Benin","2024-08-20",0,0,0,0,0,0,0,0
"Benin","2024-08-21",0,0,0,0,0,0,0,0
"Benin","2024-08-22",0,0,0,0,0,0,0,0
"Benin","2024-08-23",0,0,0,0,0,0,0,0
"Benin","2024-08-24",0,0,0,0,0,0,0,0
"Benin","2024-08-25",0,0,0,0,0,0,0,0
"Benin","2024-08-26",0,0,0,0,0,0,0,0
"Benin","2024-08-27",0,0,0,0,0,0,0,0
"Benin","2024-08-28",0,0,0,0,0,0,0,0
"Benin","2024-08-29",0,0,0,0,0,0,0,0
"Benin","2024-08-30",0,0,0,0,0,0,0,0
"Benin","2024-08-31",0,0,0,0,0,0,0,0
"Benin","2024-09-01",0,0,0,0,0,0,0,0
"Benin","2024-09-02",0,0,0,0,0,0,0,0
"Benin","2024-09-03",0,0,0,0,0,0,0,0
"Benin","2024-09-04",0,0,0,0,0,0,0,0
"Benin","2024-09-05",0,0,0,0,0,0,0,0
"Benin","2024-09-06",0,0,0,0,0,0,0,0
"Benin","2024-09-07",0,0,0,0,0,0,0,0
"Benin","2024-09-08",0,0,0,0,0,0,0,0
"Benin","2024-09-09",0,0,0,0,0,0,0,0
"Benin","2024-09-10",0,0,0,0,0,0,0,0
"Benin","2024-09-11",0,0,0,0,0,0,0,0
"Benin","2024-09-12",0,0,0,0,0,0,0,0
"Benin","2024-09-13",0,0,0,0,0,0,0,0
"Benin","2024-09-14",0,0,0,0,0,0,0,0
"Benin","2024-09-15",0,0,0,0,0,0,0,0
"Benin","2024-09-16",0,0,0,0,0,0,0,0
"Benin","2024-09-17",0,0,0,0,0,0,0,0
"Benin","2024-09-18",0,0,0,0,0,0,0,0
"Benin","2024-09-19",0,0,0,0,0,0,0,0
"Benin","2024-09-20",0,0,0,0,0,0,0,0
"Benin","2024-09-21",0,0,0,0,0,0,0,0
"Benin","2024-09-22",0,0,0,0,0,0,0,0
"Benin","2024-09-23",0,0,0,0,0,0,0,0
"Benin","2024-09-24",0,0,0,0,0,0,0,0
"Benin","2024-09-25",0,0,0,0,0,0,0,0
"Benin","2024-09-26",0,0,0,0,0,0,0,0
"Benin","2024-09-27",0,0,0,0,0,0,0,0
"Benin","2024-09-28",0,0,0,0,0,0,0,0
"Benin","2024-09-29",0,0,0,0,0,0,0,0
"Benin","2024-09-30",0,0,0,0,0,0,0,0
"Benin","2024-10-01",0,0,0,0,0,0,0,0
"Benin","2024-10-02",0,0,0,0,0,0,0,0
"Benin","2024-10-03",0,0,0,0,0,0,0,0
"Benin","2024-10-04",0,0,0,0,0,0,0,0
"Benin","2024-10-05",0,0,0,0,0,0,0,0
"Benin","2024-10-06",0,0,0,0,0,0,0,0
"Benin","2024-10-07",0,0,0,0,0,0,0,0
"Benin","2024-10-08",0,0,0,0,0,0,0,0
"Benin","2024-10-09",0,0,0,0,0,0,0,0
"Benin","2024-10-10",0,0,0,0,0,0,0,0
"Benin","2024-10-11",0,0,0,0,0,0,0,0
"Benin","2024-10-12",0,0,0,0,0,0,0,0
"Benin","2024-10-13",0,0,0,0,0,0,0,0
"Benin","2024-10-14",0,0,0,0,0,0,0,0
"Benin","2024-10-15",0,0,0,0,0,0,0,0
"Benin","2024-10-16",0,0,0,0,0,0,0,0
"Benin","2024-10-17",0,0,0,0,0,0,0,0
"Benin","2024-10-18",0,0,0,0,0,0,0,0
"Benin","2024-10-19",0,0,0,0,0,0,0,0
"Benin","2024-10-20",0,0,0,0,0,0,0,0
"Benin","2024-10-21",0,0,0,0,0,0,0,0
"Benin","2024-10-22",0,0,0,0,0,0,0,0
"Benin","2024-10-23",0,0,0,0,0,0,0,0
"Benin","2024-10-24",0,0,0,0,0,0,0,0
"Benin","2024-10-25",0,0,0,0,0,0,0,0
"Benin","2024-10-26",0,0,0,0,0,0,0,0
"Benin","2024-10-27",0,0,0,0,0,0,0,0
"Benin","2024-10-28",0,0,0,0,0,0,0,0
"Benin","2024-10-29",0,0,0,0,0,0,0,0
"Benin","2024-10-30",0,0,0,0,0,0,0,0
"Benin","2024-10-31",0,0,0,0,0,0,0,0
"Benin","2024-11-01",0,0,0,0,0,0,0,0
"Benin","2024-11-02",0,0,0,0,0,0,0,0
"Benin","2024-11-03",0,0,0,0,0,0,0,0
"Benin","2024-11-04",0,0,0,0,0,0,0,0
"Benin","2024-11-05",0,0,0,0,0,0,0,0
"Benin","2024-11-06",0,0,0,0,0,0,0,0
"Benin","2024-11-07",0,0,0,0,0,0,0,0
"Benin","2024-11-08",0,0,0,0,0,0,0,0
"Benin","2024-11-09",0,0,0,0,0,0,0,0
"Benin","2024-11-10",0,0,0,0,0,0,0,0
"Benin","2024-11-11",0,0,0,0,0,0,0,0
"Benin","2024-11-12",0,0,0,0,0,0,0,0
"Benin","2024-11-13",0,0,0,0,0,0,0,0
"Benin","2024-11-14",0,0,0,0,0,0,0,0
"Benin","2024-11-15",0,0,0,0,0,0,0,0
"Benin","2024-11-16",0,0,0,0,0,0,0,0
"Benin","2024-11-17",0,0,0,0,0,0,0,0
"Benin","2024-11-18",0,0,0,0,0,0,0,0
"Benin","2024-11-19",0,0,0,0,0,0,0,0
"Benin","2024-11-20",0,0,0,0,0,0,0,0
"Benin","2024-11-21",0,0,0,0,0,0,0,0
"Benin","2024-11-22",0,0,0,0,0,0,0,0
"Benin","2024-11-23",0,0,0,0,0,0,0,0
"Benin","2024-11-24",0,0,0,0,0,0,0,0
"Benin","2024-11-25",0,0,0,0,0,0,0,0
"Benin","2024-11-26",0,0,0,0,0,0,0,0
"Benin","2024-11-27",0,0,0,0,0,0,0,0
"Benin","2024-11-28",0,0,0,0,0,0,0,0
"Benin","2024-11-29",0,0,0,0,0,0,0,0
"Benin","2024-11-30",0,0,0,0,0,0,0,0
"Benin","2024-12-01",0,0,0,0,0,0,0,0
"Benin","2024-12-02",0,0,0,0,0,0,0,0
"Benin","2024-12-03",0,0,0,0,0,0,0,0
"Benin","2024-12-04",0,0,0,0,0,0,0,0
"Benin","2024-12-05",0,0,0,0,0,0,0,0
"Benin","2024-12-06",0,0,0,0,0,0,0,0
"Benin","2024-12-07",0,0,0,0,0,0,0,0
"Benin","2024-12-08",0,0,0,0,0,0,0,0
"Benin","2024-12-09",0,0,0,0,0,0,0,0
"Benin","2024-12-10",0,0,0,0,0,0,0,0
"Benin","2024-12-11",0,0,0,0,0,0,0,0
"Benin","2024-12-12",0,0,0,0,0,0,0,0
"Benin","2024-12-13",0,0,0,0,0,0,0,0
"Benin","2024-12-14",0,0,0,0,0,0,0,0
"Benin","2024-12-15",0,0,0,0,0,0,0,0
"Benin","2024-12-16",0,0,0,0,0,0,0,0
"Benin","2024-12-17",0,0,0,0,0,0,0,0
"Benin","2024-12-18",0,0,0,0,0,0,0,0
"Benin","2024-12-19",0,0,0,0,0,0,0,0
"Benin","2024-12-20",0,0,0,0,0,0,0,0
"Benin","2024-12-21",0,0,0,0,0,0,0,0
"Benin","2024-12-22",0,0,0,0,0,0,0,0
"Benin","2024-12-23",0,0,0,0,0,0,0,0
"Benin","2024-12-24",0,0,0,0,0,0,0,0
"Benin","2024-12-25",0,0,0,0,0,0,0,0
"Benin","2024-12-26",0,0,0,0,0,0,0,0
"Benin","2024-12-27",0,0,0,0,0,0,0,0
"Benin","2024-12-28",0,0,0,0,0,0,0,0
"Benin","2024-12-29",0,0,0,0,0,0,0,0
"Benin","2024-12-30",0,0,0,0,0,0,0,0
"Benin","2024-12-31",0,0,0,0,0,0,0,0
"Benin","2025-01-01",0,0,0,0,0,0,0,0
"Benin","2025-01-02",0,0,0,0,0,0,0,0
"Benin","2025-01-03",0,0,0,0,0,0,0,0
"Benin","2025-01-04",0,0,0,0,0,0,0,0
"Benin","2025-01-05",0,0,0,0,0,0,0,0
"Benin","2025-01-06",0,0,0,0,0,0,0,0
"Benin","2025-01-07",0,0,0,0,0,0,0,0
"Benin","2025-01-08",0,0,0,0,0,0,0,0
"Benin","2025-01-09",0,0,0,0,0,0,0,0
"Benin","2025-01-10",0,0,0,0,0,0,0,0
"Benin","2025-01-11",0,0,0,0,0,0,0,0
"Benin","2025-01-12",0,0,0,0,0,0,0,0
"Benin","2025-01-13",0,0,0,0,0,0,0,0
"Benin","2025-01-14",0,0,0,0,0,0,0,0
"Benin","2025-01-15",0,0,0,0,0,0,0,0
"Benin","2025-01-16",0,0,0,0,0,0,0,0
"Benin","2025-01-17",0,0,0,0,0,0,0,0
"Benin","2025-01-18",0,0,0,0,0,0,0,0
"Benin","2025-01-19",0,0,0,0,0,0,0,0
"Benin","2025-01-20",0,0,0,0,0,0,0,0
"Benin","2025-01-21",0,0,0,0,0,0,0,0
"Benin","2025-01-22",0,0,0,0,0,0,0,0
"Benin","2025-01-23",0,0,0,0,0,0,0,0
"Benin","2025-01-24",0,0,0,0,0,0,0,0
"Benin","2025-01-25",0,0,0,0,0,0,0,0
"Benin","2025-01-26",0,0,0,0,0,0,0,0
"Benin","2025-01-27",0,0,0,0,0,0,0,0
"Benin","2025-01-28",0,0,0,0,0,0,0,0
"Benin","2025-01-29",0,0,0,0,0,0,0,0
"Benin","2025-01-30",0,0,0,0,0,0,0,0
"Benin","2025-01-31",0,0,0,0,0,0,0,0
"Benin","2025-02-01",0,0,0,0,0,0,0,0
"Benin","2025-02-02",0,0,0,0,0,0,0,0
"Benin","2025-02-03",0,0,0,0,0,0,0,0
"Bermuda","2024-01-01",0,0,0,0,0,0,0,0
"Bermuda","2024-01-02",0,0,0,0,0,0,0,0
"Bermuda","2024-01-03",0,0,0,0,0,0,0,0
"Bermuda","2024-01-04",0,0,0,0,0,0,0,0
"Bermuda","2024-01-05",0,0,0,0,0,0,0,0
"Bermuda","2024-01-06",0,0,0,0,0,0,0,0
"Bermuda","2024-01-07",0,0,0,0,0,0,0,0
"Bermuda","2024-01-08",0,0,0,0,0,0,0,0
"Bermuda","2024-01-09",0,0,0,0,0,0,0,0
"Bermuda","2024-01-10",0,0,0,0,0,0,0,0
"Bermuda","2024-01-11",0,0,0,0,0,0,0,0
"Bermuda","2024-01-12",0,0,0,0,0,0,0,0
"Bermuda","2024-01-13",0,0,0,0,0,0,0,0
"Bermuda","2024-01-14",0,0,0,0,0,0,0,0
"Bermuda","2024-01-15",0,0,0,0,0,0,0,0
"Bermuda","2024-01-16",0,0,0,0,0,0,0,0
"Bermuda","2024-01-17",0,0,0,0,0,0,0,0
"Bermuda","2024-01-18",0,0,0,0,0,0,0,0
"Bermuda","2024-01-19",0,0,0,0,0,0,0,0
"Bermuda","2024-01-20",0,0,0,0,0,0,0,0
"Bermuda","2024-01-21",0,0,0,0,0,0,0,0
"Bermuda","2024-01-22",0,0,0,0,0,0,0,0
"Bermuda","2024-01-23",0,0,0,0,0,0,0,0
"Bermuda","2024-01-24",0,0,0,0,0,0,0,0
"Bermuda","2024-01-25",0,0,0,0,0,0,0,0
"Bermuda","2024-01-26",0,0,0,0,0,0,0,0
"Bermuda","2024-01-27",0,0,0,0,0,0,0,0
"Bermuda","2024-01-28",0,0,0,0,0,0,0,0
"Bermuda","2024-01-29",0,0,0,0,0,0,0,0
"Bermuda","2024-01-30",0,0,0,0,0,0,0,0
"Bermuda","2024-01-31",0,0,0,0,0,0,0,0
"Bermuda","2024-02-01",0,0,0,0,0,0,0,0
"Bermuda","2024-02-02",0,0,0,0,0,0,0,0
"Bermuda","2024-02-03",0,0,0,0,0,0,0,0
"Bermuda","2024-02-04",0,0,0,0,0,0,0,0
"Bermuda","2024-02-05",0,0,0,0,0,0,0,0
"Bermuda","2024-02-06",0,0,0,0,0,0,0,0
"Bermuda","2024-02-07",0,0,0,0,0,0,0,0
"Bermuda","2024-02-08",0,0,0,0,0,0,0,0
"Bermuda","2024-02-09",0,0,0,0,0,0,0,0
"Bermuda","2024-02-10",0,0,0,0,0,0,0,0
"Bermuda","2024-02-11",0,0,0,0,0,0,0,0
"Bermuda","2024-02-12",0,0,0,0,0,0,0,0
"Bermuda","2024-02-13",0,0,0,0,0,0,0,0
"Bermuda","2024-02-14",0,0,0,0,0,0,0,0
"Bermuda","2024-02-15",0,0,0,0,0,0,0,0
"Bermuda","2024-02-16",0,0,0,0,0,0,0,0
"Bermuda","2024-02-17",0,0,0,0,0,0,0,0
"Bermuda","2024-02-18",0,0,0,0,0,0,0,0
"Bermuda","2024-02-19",0,0,0,0,0,0,0,0
"Bermuda","2024-02-20",0,0,0,0,0,0,0,0
"Bermuda","2024-02-21",0,0,0,0,0,0,0,0
"Bermuda","2024-02-22",0,0,0,0,0,0,0,0
"Bermuda","2024-02-23",0,0,0,0,0,0,0,0
"Bermuda","2024-02-24",0,0,0,0,0,0,0,0
"Bermuda","2024-02-25",0,0,0,0,0,0,0,0
"Bermuda","2024-02-26",0,0,0,0,0,0,0,0
"Bermuda","2024-02-27",0,0,0,0,0,0,0,0
"Bermuda","2024-02-28",0,0,0,0,0,0,0,0
"Bermuda","2024-02-29",0,0,0,0,0,0,0,0
"Bermuda","2024-03-01",0,0,0,0,0,0,0,0
"Bermuda","2024-03-02",0,0,0,0,0,0,0,0
"Bermuda","2024-03-03",0,0,0,0,0,0,0,0
"Bermuda","2024-03-04",0,0,0,0,0,0,0,0
"Bermuda","2024-03-05",0,0,0,0,0,0,0,0
"Bermuda","2024-03-06",0,0,0,0,0,0,0,0
"Bermuda","2024-03-07",0,0,0,0,0,0,0,0
"Bermuda","2024-03-08",0,0,0,0,0,0,0,0
"Bermuda","2024-03-09",0,0,0,0,0,0,0,0
"Bermuda","2024-03-10",0,0,0,0,0,0,0,0
"Bermuda","2024-03-11",0,0,0,0,0,0,0,0
"Bermuda","2024-03-12",0,0,0,0,0,0,0,0
"Bermuda","2024-03-13",0,0,0,0,0,0,0,0
"Bermuda","2024-03-14",0,0,0,0,0,0,0,0
"Bermuda","2024-03-15",0,0,0,0,0,0,0,0
"Bermuda","2024-03-16",0,0,0,0,0,0,0,0
"Bermuda","2024-03-17",0,0,0,0,0,0,0,0
"Bermuda","2024-03-18",0,0,0,0,0,0,0,0
"Bermuda","2024-03-19",0,0,0,0,0,0,0,0
"Bermuda","2024-03-20",0,0,0,0,0,0,0,0
"Bermuda","2024-03-21",0,0,0,0,0,0,0,0
"Bermuda","2024-03-22",0,0,0,0,0,0,0,0
"Bermuda","2024-03-23",0,0,0,0,0,0,0,0
"Bermuda","2024-03-24",0,0,0,0,0,0,0,0
"Bermuda","2024-03-25",0,0,0,0,0,0,0,0
"Bermuda","2024-03-26",0,0,0,0,0,0,0,0
"Bermuda","2024-03-27",0,0,0,0,0,0,0,0
"Bermuda","2024-03-28",0,0,0,0,0,0,0,0
"Bermuda","2024-03-29",0,0,0,0,0,0,0,0
"Bermuda","2024-03-30",0,0,0,0,0,0,0,0
"Bermuda","2024-03-31",0,0,0,0,0,0,0,0
"Bermuda","2024-04-01",0,0,0,0,0,0,0,0
"Bermuda","2024-04-02",0,0,0,0,0,0,0,0
"Bermuda","2024-04-03",0,0,0,0,0,0,0,0
"Bermuda","2024-04-04",0,0,0,0,0,0,0,0
"Bermuda","2024-04-05",0,0,0,0,0,0,0,0
"Bermuda","2024-04-06",0,0,0,0,0,0,0,0
"Bermuda","2024-04-07",0,0,0,0,0,0,0,0
"Bermuda","2024-04-08",0,0,0,0,0,0,0,0
"Bermuda","2024-04-09",0,0,0,0,0,0,0,0
"Bermuda","2024-04-10",0,0,0,0,0,0,0,0
"Bermuda","2024-04-11",0,0,0,0,0,0,0,0
"Bermuda","2024-04-12",0,0,0,0,0,0,0,0
"Bermuda","2024-04-13",0,0,0,0,0,0,0,0
"Bermuda","2024-04-14",0,0,0,0,0,0,0,0
"Bermuda","2024-04-15",0,0,0,0,0,0,0,0
"Bermuda","2024-04-16",0,0,0,0,0,0,0,0
"Bermuda","2024-04-17",0,0,0,0,0,0,0,0
"Bermuda","2024-04-18",0,0,0,0,0,0,0,0
"Bermuda","2024-04-19",0,0,0,0,0,0,0,0
"Bermuda","2024-04-20",0,0,0,0,0,0,0,0
"Bermuda","2024-04-21",0,0,0,0,0,0,0,0
"Bermuda","2024-04-22",0,0,0,0,0,0,0,0
"Bermuda","2024-04-23",0,0,0,0,0,0,0,0
"Bermuda","2024-04-24",0,0,0,0,0,0,0,0
"Bermuda","2024-04-25",0,0,0,0,0,0,0,0
"Bermuda","2024-04-26",0,0,0,0,0,0,0,0
"Bermuda","2024-04-27",0,0,0,0,0,0,0,0
"Bermuda","2024-04-28",0,0,0,0,0,0,0,0
"Bermuda","2024-04-29",0,0,0,0,0,0,0,0
"Bermuda","2024-04-30",0,0,0,0,0,0,0,0
"Bermuda","2024-05-01",0,0,0,0,0,0,0,0
"Bermuda","2024-05-02",0,0,0,0,0,0,0,0
"Bermuda","2024-05-03",0,0,0,0,0,0,0,0
"Bermuda","2024-05-04",0,0,0,0,0,0,0,0
"Bermuda","2024-05-05",0,0,0,0,0,0,0,0
"Bermuda","2024-05-06",0,0,0,0,0,0,0,0
"Bermuda","2024-05-07",0,0,0,0,0,0,0,0
"Bermuda","2024-05-08",0,0,0,0,0,0,0,0
"Bermuda","2024-05-09",0,0,0,0,0,0,0,0
"Bermuda","2024-05-10",0,0,0,0,0,0,0,0
"Bermuda","2024-05-11",0,0,0,0,0,0,0,0
"Bermuda","2024-05-12",0,0,0,0,0,0,0,0
"Bermuda","2024-05-13",0,0,0,0,0,0,0,0
"Bermuda","2024-05-14",0,0,0,0,0,0,0,0
"Bermuda","2024-05-15",0,0,0,0,0,0,0,0
"Bermuda","2024-05-16",0,0,0,0,0,0,0,0
"Bermuda","2024-05-17",0,0,0,0,0,0,0,0
"Bermuda","2024-05-18",0,0,0,0,0,0,0,0
"Bermuda","2024-05-19",0,0,0,0,0,0,0,0
"Bermuda","2024-05-20",0,0,0,0,0,0,0,0
"Bermuda","2024-05-21",0,0,0,0,0,0,0,0
"Bermuda","2024-05-22",0,0,0,0,0,0,0,0
"Bermuda","2024-05-23",0,0,0,0,0,0,0,0
"Bermuda","2024-05-24",0,0,0,0,0,0,0,0
"Bermuda","2024-05-25",0,0,0,0,0,0,0,0
"Bermuda","2024-05-26",0,0,0,0,0,0,0,0
"Bermuda","2024-05-27",0,0,0,0,0,0,0,0
"Bermuda","2024-05-28",0,0,0,0,0,0,0,0
"Bermuda","2024-05-29",0,0,0,0,0,0,0,0
"Bermuda","2024-05-30",0,0,0,0,0,0,0,0
"Bermuda","2024-05-31",0,0,0,0,0,0,0,0
"Bermuda","2024-06-01",0,0,0,0,0,0,0,0
"Bermuda","2024-06-02",0,0,0,0,0,0,0,0
"Bermuda","2024-06-03",0,0,0,0,0,0,0,0
"Bermuda","2024-06-04",0,0,0,0,0,0,0,0
"Bermuda","2024-06-05",0,0,0,0,0,0,0,0
"Bermuda","2024-06-06",0,0,0,0,0,0,0,0
"Bermuda","2024-06-07",0,0,0,0,0,0,0,0
"Bermuda","2024-06-08",0,0,0,0,0,0,0,0
"Bermuda","2024-06-09",0,0,0,0,0,0,0,0
"Bermuda","2024-06-10",0,0,0,0,0,0,0,0
"Bermuda","2024-06-11",0,0,0,0,0,0,0,0
"Bermuda","2024-06-12",0,0,0,0,0,0,0,0
"Bermuda","2024-06-13",0,0,0,0,0,0,0,0
"Bermuda","2024-06-14",0,0,0,0,0,0,0,0
"Bermuda","2024-06-15",0,0,0,0,0,0,0,0
"Bermuda","2024-06-16",0,0,0,0,0,0,0,0
"Bermuda","2024-06-17",0,0,0,0,0,0,0,0
"Bermuda","2024-06-18",0,0,0,0,0,0,0,0
"Bermuda","2024-06-19",0,0,0,0,0,0,0,0
"Bermuda","2024-06-20",0,0,0,0,0,0,0,0
"Bermuda","2024-06-21",0,0,0,0,0,0,0,0
"Bermuda","2024-06-22",0,0,0,0,0,0,0,0
"Bermuda","2024-06-23",0,0,0,0,0,0,0,0
"Bermuda","2024-06-24",0,0,0,0,0,0,0,0
"Bermuda","2024-06-25",0,0,0,0,0,0,0,0
"Bermuda","2024-06-26",0,0,0,0,0,0,0,0
"Bermuda","2024-06-27",0,0,0,0,0,0,0,0
"Bermuda","2024-06-28",0,0,0,0,0,0,0,0
"Bermuda","2024-06-29",0,0,0,0,0,0,0,0
"Bermuda","2024-06-30",0,0,0,0,0,0,0,0
"Bermuda","2024-07-01",0,0,0,0,0,0,0,0
"Bermuda","2024-07-02",0,0,0,0,0,0,0,0
"Bermuda","2024-07-03",0,0,0,0,0,0,0,0
"Bermuda","2024-07-04",0,0,0,0,0,0,0,0
"Bermuda","2024-07-05",0,0,0,0,0,0,0,0
"Bermuda","2024-07-06",0,0,0,0,0,0,0,0
"Bermuda","2024-07-07",0,0,0,0,0,0,0,0
"Bermuda","2024-07-08",0,0,0,0,0,0,0,0
"Bermuda","2024-07-09",0,0,0,0,0,0,0,0
"Bermuda","2024-07-10",0,0,0,0,0,0,0,0
"Bermuda","2024-07-11",0,0,0,0,0,0,0,0
"Bermuda","2024-07-12",0,0,0,0,0,0,0,0
"Bermuda","2024-07-13",0,0,0,0,0,0,0,0
"Bermuda","2024-07-14",0,0,0,0,0,0,0,0
"Bermuda","2024-07-15",0,0,0,0,0,0,0,0
"Bermuda","2024-07-16",0,0,0,0,0,0,0,0
"Bermuda","2024-07-17",0,0,0,0,0,0,0,0
"Bermuda","2024-07-18",0,0,0,0,0,0,0,0
"Bermuda","2024-07-19",0,0,0,0,0,0,0,0
"Bermuda","2024-07-20",0,0,0,0,0,0,0,0
"Bermuda","2024-07-21",0,0,0,0,0,0,0,0
"Bermuda","2024-07-22",0,0,0,0,0,0,0,0
"Bermuda","2024-07-23",0,0,0,0,0,0,0,0
"Bermuda","2024-07-24",0,0,0,0,0,0,0,0
"Bermuda","2024-07-25",0,0,0,0,0,0,0,0
"Bermuda","2024-07-26",0,0,0,0,0,0,0,0
"Bermuda","2024-07-27",0,0,0,0,0,0,0,0
"Bermuda","2024-07-28",0,0,0,0,0,0,0,0
"Bermuda","2024-07-29",0,0,0,0,0,0,0,0
"Bermuda","2024-07-30",0,0,0,0,0,0,0,0
"Bermuda","2024-07-31",0,0,0,0,0,0,0,0
"Bermuda","2024-08-01",0,0,0,0,0,0,0,0
"Bermuda","2024-08-02",0,0,0,0,0,0,0,0
"Bermuda","2024-08-03",0,0,0,0,0,0,0,0
"Bermuda","2024-08-04",0,0,0,0,0,0,0,0
"Bermuda","2024-08-05",0,0,0,0,0,0,0,0
"Bermuda","2024-08-06",0,0,0,0,0,0,0,0
"Bermuda","2024-08-07",0,0,0,0,0,0,0,0
"Bermuda","2024-08-08",0,0,0,0,0,0,0,0
"Bermuda","2024-08-09",0,0,0,0,0,0,0,0
"Bermuda","2024-08-10",0,0,0,0,0,0,0,0
"Bermuda","2024-08-11",0,0,0,0,0,0,0,0
"Bermuda","2024-08-12",0,0,0,0,0,0,0,0
"Bermuda","2024-08-13",0,0,0,0,0,0,0,0
"Bermuda","2024-08-14",0,0,0,0,0,0,0,0
"Bermuda","2024-08-15",0,0,0,0,0,0,0,0
"Bermuda","2024-08-16",0,0,0,0,0,0,0,0
"Bermuda","2024-08-17",0,0,0,0,0,0,0,0
"Bermuda","2024-08-18",0,0,0,0,0,0,0,0
"Bermuda","2024-08-19",0,0,0,0,0,0,0,0
"Bermuda","2024-08-20",0,0,0,0,0,0,0,0
"Bermuda","2024-08-21",0,0,0,0,0,0,0,0
"Bermuda","2024-08-22",0,0,0,0,0,0,0,0
"Bermuda","2024-08-23",0,0,0,0,0,0,0,0
"Bermuda","2024-08-24",0,0,0,0,0,0,0,0
"Bermuda","2024-08-25",0,0,0,0,0,0,0,0
"Bermuda","2024-08-26",0,0,0,0,0,0,0,0
"Bermuda","2024-08-27",0,0,0,0,0,0,0,0
"Bermuda","2024-08-28",0,0,0,0,0,0,0,0
"Bermuda","2024-08-29",0,0,0,0,0,0,0,0
"Bermuda","2024-08-30",0,0,0,0,0,0,0,0
"Bermuda","2024-08-31",0,0,0,0,0,0,0,0
"Bermuda","2024-09-01",0,0,0,0,0,0,0,0
"Bermuda","2024-09-02",0,0,0,0,0,0,0,0
"Bermuda","2024-09-03",0,0,0,0,0,0,0,0
"Bermuda","2024-09-04",0,0,0,0,0,0,0,0
"Bermuda","2024-09-05",0,0,0,0,0,0,0,0
"Bermuda","2024-09-06",0,0,0,0,0,0,0,0
"Bermuda","2024-09-07",0,0,0,0,0,0,0,0
"Bermuda","2024-09-08",0,0,0,0,0,0,0,0
"Bermuda","2024-09-09",0,0,0,0,0,0,0,0
"Bermuda","2024-09-10",0,0,0,0,0,0,0,0
"Bermuda","2024-09-11",0,0,0,0,0,0,0,0
"Bermuda","2024-09-12",0,0,0,0,0,0,0,0
"Bermuda","2024-09-13",0,0,0,0,0,0,0,0
"Bermuda","2024-09-14",0,0,0,0,0,0,0,0
"Bermuda","2024-09-15",0,0,0,0,0,0,0,0
"Bermuda","2024-09-16",0,0,0,0,0,0,0,0
"Bermuda","2024-09-17",0,0,0,0,0,0,0,0
"Bermuda","2024-09-18",0,0,0,0,0,0,0,0
"Bermuda","2024-09-19",0,0,0,0,0,0,0,0
"Bermuda","2024-09-20",0,0,0,0,0,0,0,0
"Bermuda","2024-09-21",0,0,0,0,0,0,0,0
"Bermuda","2024-09-22",0,0,0,0,0,0,0,0
"Bermuda","2024-09-23",0,0,0,0,0,0,0,0
"Bermuda","2024-09-24",0,0,0,0,0,0,0,0
"Bermuda","2024-09-25",0,0,0,0,0,0,0,0
"Bermuda","2024-09-26",0,0,0,0,0,0,0,0
"Bermuda","2024-09-27",0,0,0,0,0,0,0,0
"Bermuda","2024-09-28",0,0,0,0,0,0,0,0
"Bermuda","2024-09-29",0,0,0,0,0,0,0,0
"Bermuda","2024-09-30",0,0,0,0,0,0,0,0
"Bermuda","2024-10-01",0,0,0,0,0,0,0,0
"Bermuda","2024-10-02",0,0,0,0,0,0,0,0
"Bermuda","2024-10-03",0,0,0,0,0,0,0,0
"Bermuda","2024-10-04",0,0,0,0,0,0,0,0
"Bermuda","2024-10-05",0,0,0,0,0,0,0,0
"Bermuda","2024-10-06",0,0,0,0,0,0,0,0
"Bermuda","2024-10-07",0,0,0,0,0,0,0,0
"Bermuda","2024-10-08",0,0,0,0,0,0,0,0
"Bermuda","2024-10-09",0,0,0,0,0,0,0,0
"Bermuda","2024-10-10",0,0,0,0,0,0,0,0
"Bermuda","2024-10-11",0,0,0,0,0,0,0,0
"Bermuda","2024-10-12",0,0,0,0,0,0,0,0
"Bermuda","2024-10-13",0,0,0,0,0,0,0,0
"Bermuda","2024-10-14",0,0,0,0,0,0,0,0
"Bermuda","2024-10-15",0,0,0,0,0,0,0,0
"Bermuda","2024-10-16",0,0,0,0,0,0,0,0
"Bermuda","2024-10-17",0,0,0,0,0,0,0,0
"Bermuda","2024-10-18",0,0,0,0,0,0,0,0
"Bermuda","2024-10-19",0,0,0,0,0,0,0,0
"Bermuda","2024-10-20",0,0,0,0,0,0,0,0
"Bermuda","2024-10-21",0,0,0,0,0,0,0,0
"Bermuda","2024-10-22",0,0,0,0,0,0,0,0
"Bermuda","2024-10-23",0,0,0,0,0,0,0,0
"Bermuda","2024-10-24",0,0,0,0,0,0,0,0
"Bermuda","2024-10-25",0,0,0,0,0,0,0,0
"Bermuda","2024-10-26",0,0,0,0,0,0,0,0
"Bermuda","2024-10-27",0,0,0,0,0,0,0,0
"Bermuda","2024-10-28",0,0,0,0,0,0,0,0
"Bermuda","2024-10-29",0,0,0,0,0,0,0,0
"Bermuda","2024-10-30",0,0,0,0,0,0,0,0
"Bermuda","2024-10-31",0,0,0,0,0,0,0,0
"Bermuda","2024-11-01",0,0,0,0,0,0,0,0
"Bermuda","2024-11-02",0,0,0,0,0,0,0,0
"Bermuda","2024-11-03",0,0,0,0,0,0,0,0
"Bermuda","2024-11-04",0,0,0,0,0,0,0,0
"Bermuda","2024-11-05",0,0,0,0,0,0,0,0
"Bermuda","2024-11-06",0,0,0,0,0,0,0,0
"Bermuda","2024-11-07",0,0,0,0,0,0,0,0
"Bermuda","2024-11-08",0,0,0,0,0,0,0,0
"Bermuda","2024-11-09",0,0,0,0,0,0,0,0
"Bermuda","2024-11-10",0,0,0,0,0,0,0,0
"Bermuda","2024-11-11",0,0,0,0,0,0,0,0
"Bermuda","2024-11-12",0,0,0,0,0,0,0,0
"Bermuda","2024-11-13",0,0,0,0,0,0,0,0
"Bermuda","2024-11-14",0,0,0,0,0,0,0,0
"Bermuda","2024-11-15",0,0,0,0,0,0,0,0
"Bermuda","2024-11-16",0,0,0,0,0,0,0,0
"Bermuda","2024-11-17",0,0,0,0,0,0,0,0
"Bermuda","2024-11-18",0,0,0,0,0,0,0,0
"Bermuda","2024-11-19",0,0,0,0,0,0,0,0
"Bermuda","2024-11-20",0,0,0,0,0,0,0,0
"Bermuda","2024-11-21",0,0,0,0,0,0,0,0
"Bermuda","2024-11-22",0,0,0,0,0,0,0,0
"Bermuda","2024-11-23",0,0,0,0,0,0,0,0
"Bermuda","2024-11-24",0,0,0,0,0,0,0,0
"Bermuda","2024-11-25",0,0,0,0,0,0,0,0
"Bermuda","2024-11-26",0,0,0,0,0,0,0,0
"Bermuda","2024-11-27",0,0,0,0,0,0,0,0
"Bermuda","2024-11-28",0,0,0,0,0,0,0,0
"Bermuda","2024-11-29",0,0,0,0,0,0,0,0
"Bermuda","2024-11-30",0,0,0,0,0,0,0,0
"Bermuda","2024-12-01",0,0,0,0,0,0,0,0
"Bermuda","2024-12-02",0,0,0,0,0,0,0,0
"Bermuda","2024-12-03",0,0,0,0,0,0,0,0
"Bermuda","2024-12-04",0,0,0,0,0,0,0,0
"Bermuda","2024-12-05",0,0,0,0,0,0,0,0
"Bermuda","2024-12-06",0,0,0,0,0,0,0,0
"Bermuda","2024-12-07",0,0,0,0,0,0,0,0
"Bermuda","2024-12-08",0,0,0,0,0,0,0,0
"Bermuda","2024-12-09",0,0,0,0,0,0,0,0
"Bermuda","2024-12-10",0,0,0,0,0,0,0,0
"Bermuda","2024-12-11",0,0,0,0,0,0,0,0
"Bermuda","2024-12-12",0,0,0,0,0,0,0,0
"Bermuda","2024-12-13",0,0,0,0,0,0,0,0
"Bermuda","2024-12-14",0,0,0,0,0,0,0,0
"Bermuda","2024-12-15",0,0,0,0,0,0,0,0
"Bermuda","2024-12-16",0,0,0,0,0,0,0,0
"Bermuda","2024-12-17",0,0,0,0,0,0,0,0
"Bermuda","2024-12-18",0,0,0,0,0,0,0,0
"Bermuda","2024-12-19",0,0,0,0,0,0,0,0
"Bermuda","2024-12-20",0,0,0,0,0,0,0,0
"Bermuda","2024-12-21",0,0,0,0,0,0,0,0
"Bermuda","2024-12-22",0,0,0,0,0,0,0,0
"Bermuda","2024-12-23",0,0,0,0,0,0,0,0
"Bermuda","2024-12-24",0,0,0,0,0,0,0,0
"Bermuda","2024-12-25",0,0,0,0,0,0,0,0
"Bermuda","2024-12-26",0,0,0,0,0,0,0,0
"Bermuda","2024-12-27",0,0,0,0,0,0,0,0
"Bermuda","2024-12-28",0,0,0,0,0,0,0,0
"Bermuda","2024-12-29",0,0,0,0,0,0,0,0
"Bermuda","2024-12-30",0,0,0,0,0,0,0,0
"Bermuda","2024-12-31",0,0,0,0,0,0,0,0
"Bermuda","2025-01-01",0,0,0,0,0,0,0,0
"Bermuda","2025-01-02",0,0,0,0,0,0,0,0
"Bermuda","2025-01-03",0,0,0,0,0,0,0,0
"Bermuda","2025-01-04",0,0,0,0,0,0,0,0
"Bermuda","2025-01-05",0,0,0,0,0,0,0,0
"Bermuda","2025-01-06",0,0,0,0,0,0,0,0
"Bermuda","2025-01-07",0,0,0,0,0,0,0,0
"Bermuda","2025-01-08",0,0,0,0,0,0,0,0
"Bermuda","2025-01-09",0,0,0,0,0,0,0,0
"Bermuda","2025-01-10",0,0,0,0,0,0,0,0
"Bermuda","2025-01-11",0,0,0,0,0,0,0,0
"Bermuda","2025-01-12",0,0,0,0,0,0,0,0
"Bermuda","2025-01-13",0,0,0,0,0,0,0,0
"Bermuda","2025-01-14",0,0,0,0,0,0,0,0
"Bermuda","2025-01-15",0,0,0,0,0,0,0,0
"Bermuda","2025-01-16",0,0,0,0,0,0,0,0
"Bermuda","2025-01-17",0,0,0,0,0,0,0,0
"Bermuda","2025-01-18",0,0,0,0,0,0,0,0
"Bermuda","2025-01-19",0,0,0,0,0,0,0,0
"Bermuda","2025-01-20",0,0,0,0,0,0,0,0
"Bermuda","2025-01-21",0,0,0,0,0,0,0,0
"Bermuda","2025-01-22",0,0,0,0,0,0,0,0
"Bermuda","2025-01-23",0,0,0,0,0,0,0,0
"Bermuda","2025-01-24",0,0,0,0,0,0,0,0
"Bermuda","2025-01-25",0,0,0,0,0,0,0,0
"Bermuda","2025-01-26",0,0,0,0,0,0,0,0
"Bermuda","2025-01-27",0,0,0,0,0,0,0,0
"Bermuda","2025-01-28",0,0,0,0,0,0,0,0
"Bermuda","2025-01-29",0,0,0,0,0,0,0,0
"Bermuda","2025-01-30",0,0,0,0,0,0,0,0
"Bermuda","2025-01-31",0,0,0,0,0,0,0,0
"Bermuda","2025-02-01",0,0,0,0,0,0,0,0
"Bermuda","2025-02-02",0,0,0,0,0,0,0,0
"Bermuda","2025-02-03",0,0,0,0,0,0,0,0
"Bolivia (Plurinational State of)","2024-01-01",0,0,0,0,0,0,0,0
"Bolivia (Plurinational State of)","2024-01-02",0,0,0,0,0,0,0,0
"Bolivia (Plurinational State of)","2024-01-03",0,0,0,0,0,0,0,0
"Bolivia (Plurinational State of)","2024-01-04",0,0,0,0,0,0,0,0
"Bolivia (Plurinational State of)","2024-01-05",0,0,0,0,0,0,0,0
"Bolivia (Plurinational State of)","2024-01-06",0,0,0,0,0,0,0,0
"Bolivia (Plurinational State of)","2024-01-07",0,0,0,0,0,0,0,0
"Bolivia (Plurinational State of)","2024-01-08",0,0,0,0,0,0,0,0
"Bolivia (Plurinational State of)","2024-01-09",0,0,0,0,0,0,0,0
"Bolivia (Plurinational State of)","2024-01-10",0,0,0,0,0,0,0,0
"Bolivia (Plurinational State of)","2024-01-11",0,0,0,0,0,0,0,0
"Bolivia (Plurinational State of)","2024-01-12",0,0,0,0,0,0,0,0
"Bolivia (Plurinational State of)","2024-01-13",0,0,0,0,0,0,0,0
"Bolivia (Plurinational State of)","2024-01-14",0,0,0,0,0,0,0,0
"Bolivia (Plurinational State of)","2024-01-15",0,0,0,0,0,0,0,0
"Bolivia (Plurinational State of)","2024-01-16",0,0,0,0,0,0,0,0
"Bolivia (Plurinational State of)","2024-01-17",0,0,0,0,0,0,0,0
"Bolivia (Plurinational State of)","2024-01-18",0,0,0,0,0,0,0,0
"Bolivia (Plurinational State of)","2024-01-19",0,0,0,0,0,0,0,0
"Bolivia (Plurinational State of)","2024-01-20",0,0,0,0,0,0,0,0
"Bolivia (Plurinational State of)","2024-01-21",0,0,0,0,0,0,0,0
"Bolivia (Plurinational State of)","2024-01-22",0,0,0,0,0,0,0,0
"Bolivia (Plurinational State of)","2024-01-23",0,0,0,0,0,0,0,0
"Bolivia (Plurinational State of)","2024-01-24",0,0,0,0,0,0,0,0
"Bolivia (Plurinational State of)","2024-01-25",0,0,0,0,0,0,0,0
"Bolivia (Plurinational State of)","2024-01-26",0,0,0,0,0,0,0,0
"Bolivia (Plurinational State of)","2024-01-27",0,0,0,0,0,0,0,0
"Bolivia (Plurinational State of)","2024-01-28",0,0,0,0,0,0,0,0
"Bolivia (Plurinational State of)","2024-01-29",0,0,0,0,0,0,0,0
"Bolivia (Plurinational State of)","2024-01-30",0,0,0,0,0,0,0,0
"Bolivia (Plurinational State of)","2024-01-31",0,0,0,0,0,0,0,0
"Bolivia (Plurinational State of)","2024-02-01",0,0,0,0,0,0,0,0
"Bolivia (Plurinational State of)","2024-02-02",0,0,0,0,0,0,0,0
"Bolivia (Plurinational State of)","2024-02-03",0,0,0,0,0,0,0,0
"Bolivia (Plurinational State of)","2024-02-04",0,0,0,0,0,0,0,0
"Bolivia (Plurinational State of)","2024-02-05",0,0,0,0,0,0,0,0
"Bolivia (Plurinational State of)","2024-02-06",0,1,1,0,1,1,0,0
"Bolivia (Plurinational State of)","2024-02-07",0,0,1,0,0,1,0,0
"Bolivia (Plurinational State of)","2024-02-08",0,0,1,0,0,1,0,0
"Bolivia (Plurinational State of)","2024-02-09",0,0,1,0,0,1,0,0
"Bolivia (Plurinational State of)","2024-02-10",0,0,1,0,0,1,0,0
"Bolivia (Plurinational State of)","2024-02-11",0,0,1,0,0,1,0,0
"Bolivia (Plurinational State of)","2024-02-12",0,0,1,0,0,1,0,0
"Bolivia (Plurinational State of)","2024-02-13",0,0,1,0,0,1,0,0
"Bolivia (Plurinational State of)","2024-02-14",0,0,1,0,0,1,0,0
"Bolivia (Plurinational State of)","2024-02-15",0,0,1,0,0,1,0,0
"Bolivia (Plurinational State of)","2024-02-16",0,0,1,0,0,1,0,0
"Bolivia (Plurinational State of)","2024-02-17",0,0,1,0,0,1,0,0
"Bolivia (Plurinational State of)","2024-02-18",0,0,1,0,0,1,0,0
"Bolivia (Plurinational State of)","2024-02-19",0,0,1,0,0,1,0,0
"Bolivia (Plurinational State of)","2024-02-20",0,0,1,0,0,1,0,0
"Bolivia (Plurinational State of)","2024-02-21",0,0,1,0,0,1,0,0
"Bolivia (Plurinational State of)","2024-02-22",0,0,1,0,0,1,0,0
"Bolivia (Plurinational State of)","2024-02-23",0,0,1,0,0,1,0,0
"Bolivia (Plurinational State of)","2024-02-24",0,0,1,0,0,1,0,0
"Bolivia (Plurinational State of)","2024-02-25",0,0,1,0,0,1,0,0
"Bolivia (Plurinational State of)","2024-02-26",0,0,1,0,0,1,0,0
"Bolivia (Plurinational State of)","2024-02-27",0,0,1,0,0,1,0,0
"Bolivia (Plurinational State of)","2024-02-28",0,0,1,0,0,1,0,0
"Bolivia (Plurinational State of)","2024-02-29",0,0,1,0,0,1,0,0
"Bolivia (Plurinational State of)","2024-03-01",0,0,1,0,0,1,0,0
"Bolivia (Plurinational State of)","2024-03-02",0,0,1,0,0,1,0,0
"Bolivia (Plurinational State of)","2024-03-03",0,0,1,0,0,1,0,0
"Bolivia (Plurinational State of)","2024-03-04",0,0,1,0,0,1,0,0
"Bolivia (Plurinational State of)","2024-03-05",0,0,1,0,0,1,0,0
"Bolivia (Plurinational State of)","2024-03-06",0,0,1,0,0,1,0,0
"Bolivia (Plurinational State of)","2024-03-07",0,0,1,0,0,1,0,0
"Bolivia (Plurinational State of)","2024-03-08",0,0,1,0,0,1,0,0
"Bolivia (Plurinational State of)","2024-03-09",0,0,1,0,0,1,0,0
"Bolivia (Plurinational State of)","2024-03-10",0,0,1,0,0,1,0,0
"Bolivia (Plurinational State of)","2024-03-11",0,0,1,0,0,1,0,0
"Bolivia (Plurinational State of)","2024-03-12",0,0,1,0,0,1,0,0
"Bolivia (Plurinational State of)","2024-03-13",0,0,1,0,0,1,0,0
"Bolivia (Plurinational State of)","2024-03-14",0,0,1,0,0,1,0,0
"Bolivia (Plurinational State of)","2024-03-15",0,0,1,0,0,1,0,0
"Bolivia (Plurinational State of)","2024-03-16",0,0,1,0,0,1,0,0
"Bolivia (Plurinational State of)","2024-03-17",0,0,1,0,0,1,0,0
"Bolivia (Plurinational State of)","2024-03-18",0,0,1,0,0,1,0,0
"Bolivia (Plurinational State of)","2024-03-19",0,0,1,0,0,1,0,0
"Bolivia (Plurinational State of)","2024-03-20",0,0,1,0,0,1,0,0
"Bolivia (Plurinational State of)","2024-03-21",0,0,1,0,0,1,0,0
"Bolivia (Plurinational State of)","2024-03-22",0,0,1,0,0,1,0,0
"Bolivia (Plurinational State of)","2024-03-23",0,0,1,0,0,1,0,0
"Bolivia (Plurinational State of)","2024-03-24",0,0,1,0,0,1,0,0
"Bolivia (Plurinational State of)","2024-03-25",0,0,1,0,0,1,0,0
"Bolivia (Plurinational State of)","2024-03-26",0,0,1,0,0,1,0,0
"Bolivia (Plurinational State of)","2024-03-27",0,0,1,0,0,1,0,0
"Bolivia (Plurinational State of)","2024-03-28",0,0,1,0,0,1,0,0
"Bolivia (Plurinational State of)","2024-03-29",0,0,1,0,0,1,0,0
"Bolivia (Plurinational State of)","2024-03-30",0,0,1,0,0,1,0,0
"Bolivia (Plurinational State of)","2024-03-31",0,0,1,0,0,1,0,0
"Bolivia (Plurinational State of)","2024-04-01",0,0,1,0,0,1,0,0
"Bolivia (Plurinational State of)","2024-04-02",0,0,1,0,0,1,0,0
"Bolivia (Plurinational State of)","2024-04-03",0,0,1,0,0,1,0,0
"Bolivia (Plurinational State of)","2024-04-04",0,0,1,0,0,1,0,0
"Bolivia (Plurinational State of)","2024-04-05",0,0,1,0,0,1,0,0
"Bolivia (Plurinational State of)","2024-04-06",0,0,1,0,0,1,0,0
"Bolivia (Plurinational State of)","2024-04-07",0,0,1,0,0,1,0,0
"Bolivia (Plurinational State of)","2024-04-08",0,0,1,0,0,1,0,0
"Bolivia (Plurinational State of)","2024-04-09",0,0,1,0,0,1,0,0
"Bolivia (Plurinational State of)","2024-04-10",0,0,1,0,0,1,0,0
"Bolivia (Plurinational State of)","2024-04-11",0,0,1,0,0,1,0,0
"Bolivia (Plurinational State of)","2024-04-12",0,0,1,0,0,1,0,0
"Bolivia (Plurinational State of)","2024-04-13",0,0,1,0,0,1,0,0
"Bolivia (Plurinational State of)","2024-04-14",0,0,1,0,0,1,0,0
"Bolivia (Plurinational State of)","2024-04-15",0,0,1,0,0,1,0,0
"Bolivia (Plurinational State of)","2024-04-16",0,0,1,0,0,1,0,0
"Bolivia (Plurinational State of)","2024-04-17",0,0,1,0,0,1,0,0
"Bolivia (Plurinational State of)","2024-04-18",0,0,1,0,0,1,0,0
"Bolivia (Plurinational State of)","2024-04-19",0,0,1,0,0,1,0,0
"Bolivia (Plurinational State of)","2024-04-20",0,0,1,0,0,1,0,0
"Bolivia (Plurinational State of)","2024-04-21",0,0,1,0,0,1,0,0
"Bolivia (Plurinational State of)","2024-04-22",0,0,1,0,0,1,0,0
"Bolivia (Plurinational State of)","2024-04-23",0,0,1,0,0,1,0,0
"Bolivia (Plurinational State of)","2024-04-24",0,0,1,0,0,1,0,0
"Bolivia (Plurinational State of)","2024-04-25",0,0,1,0,0,1,0,0
"Bolivia (Plurinational State of)","2024-04-26",0,0,1,0,0,1,0,0
"Bolivia (Plurinational State of)","2024-04-27",0,0,1,0,0,1,0,0
"Bolivia (Plurinational State of)","2024-04-28",0,0,1,0,0,1,0,0
"Bolivia (Plurinational State of)","2024-04-29",0,0,1,0,0,1,0,0
"Bolivia (Plurinational State of)","2024-04-30",0,0,1,0,0,1,0,0
"Bolivia (Plurinational State of)","2024-05-01",0,0,1,0,0,1,0,0
"Bolivia (Plurinational State of)","2024-05-02",0,0,1,0,0,1,0,0
"Bolivia (Plurinational State of)","2024-05-03",0,0,1,0,0,1,0,0
"Bolivia (Plurinational State of)","2024-05-04",0,0,1,0,0,1,0,0
"Bolivia (Plurinational State of)","2024-05-05",0,0,1,0,0,1,0,0
"Bolivia (Plurinational State of)","2024-05-06",0,0,1,0,0,1,0,0
"Bolivia (Plurinational State of)","2024-05-07",0,0,1,0,0,1,0,0
"Bolivia (Plurinational State of)","2024-05-08",0,0,1,0,0,1,0,0
"Bolivia (Plurinational State of)","2024-05-09",0,0,1,0,0,1,0,0
"Bolivia (Plurinational State of)","2024-05-10",0,0,1,0,0,1,0,0
"Bolivia (Plurinational State of)","2024-05-11",0,0,1,0,0,1,0,0
"Bolivia (Plurinational State of)","2024-05-12",0,0,1,0,0,1,0,0
"Bolivia (Plurinational State of)","2024-05-13",0,0,1,0,0,1,0,0
"Bolivia (Plurinational State of)","2024-05-14",0,0,1,0,0,1,0,0
"Bolivia (Plurinational State of)","2024-05-15",0,0,1,0,0,1,0,0
"Bolivia (Plurinational State of)","2024-05-16",0,0,1,0,0,1,0,0
"Bolivia (Plurinational State of)","2024-05-17",0,0,1,0,0,1,0,0
"Bolivia (Plurinational State of)","2024-05-18",0,0,1,0,0,1,0,0
"Bolivia (Plurinational State of)","2024-05-19",0,0,1,0,0,1,0,0
"Bolivia (Plurinational State of)","2024-05-20",0,0,1,0,0,1,0,0
"Bolivia (Plurinational State of)","2024-05-21",0,0,1,0,0,1,0,0
"Bolivia (Plurinational State of)","2024-05-22",0,0,1,0,0,1,0,0
"Bolivia (Plurinational State of)","2024-05-23",0,0,1,0,0,1,0,0
"Bolivia (Plurinational State of)","2024-05-24",0,0,1,0,0,1,0,0
"Bolivia (Plurinational State of)","2024-05-25",0,0,1,0,0,1,0,0
"Bolivia (Plurinational State of)","2024-05-26",0,0,1,0,0,1,0,0
"Bolivia (Plurinational State of)","2024-05-27",0,0,1,0,0,1,0,0
"Bolivia (Plurinational State of)","2024-05-28",0,0,1,0,0,1,0,0
"Bolivia (Plurinational State of)","2024-05-29",0,0,1,0,0,1,0,0
"Bolivia (Plurinational State of)","2024-05-30",0,0,1,0,0,1,0,0
"Bolivia (Plurinational State of)","2024-05-31",0,0,1,0,0,1,0,0
"Bolivia (Plurinational State of)","2024-06-01",0,0,1,0,0,1,0,0
"Bolivia (Plurinational State of)","2024-06-02",0,0,1,0,0,1,0,0
"Bolivia (Plurinational State of)","2024-06-03",0,0,1,0,0,1,0,0
"Bolivia (Plurinational State of)","2024-06-04",0,0,1,0,0,1,0,0
"Bolivia (Plurinational State of)","2024-06-05",0,0,1,0,0,1,0,0
"Bolivia (Plurinational State of)","2024-06-06",0,0,1,0,0,1,0,0
"Bolivia (Plurinational State of)","2024-06-07",0,0,1,0,0,1,0,0
"Bolivia (Plurinational State of)","2024-06-08",0,0,1,0,0,1,0,0
"Bolivia (Plurinational State of)","2024-06-09",0,0,1,0,0,1,0,0
"Bolivia (Plurinational State of)","2024-06-10",0,0,1,0,0,1,0,0
"Bolivia (Plurinational State of)","2024-06-11",0,0,1,0,0,1,0,0
"Bolivia (Plurinational State of)","2024-06-12",0,0,1,0,0,1,0,0
"Bolivia (Plurinational State of)","2024-06-13",0,0,1,0,0,1,0,0
"Bolivia (Plurinational State of)","2024-06-14",0,0,1,0,0,1,0,0
"Bolivia (Plurinational State of)","2024-06-15",0,0,1,0,0,1,0,0
"Bolivia (Plurinational State of)","2024-06-16",0,0,1,0,0,1,0,0
"Bolivia (Plurinational State of)","2024-06-17",0,0,1,0,0,1,0,0
"Bolivia (Plurinational State of)","2024-06-18",0,0,1,0,0,1,0,0
"Bolivia (Plurinational State of)","2024-06-19",0,0,1,0,0,1,0,0
"Bolivia (Plurinational State of)","2024-06-20",0,0,1,0,0,1,0,0
"Bolivia (Plurinational State of)","2024-06-21",0,0,1,0,0,1,0,0
"Bolivia (Plurinational State of)","2024-06-22",0,0,1,0,0,1,0,0
"Bolivia (Plurinational State of)","2024-06-23",0,0,1,0,0,1,0,0
"Bolivia (Plurinational State of)","2024-06-24",0,0,1,0,0,1,0,0
"Bolivia (Plurinational State of)","2024-06-25",0,0,1,0,0,1,0,0
"Bolivia (Plurinational State of)","2024-06-26",0,0,1,0,0,1,0,0
"Bolivia (Plurinational State of)","2024-06-27",0,0,1,0,0,1,0,0
"Bolivia (Plurinational State of)","2024-06-28",0,0,1,0,0,1,0,0
"Bolivia (Plurinational State of)","2024-06-29",0,0,1,0,0,1,0,0
"Bolivia (Plurinational State of)","2024-06-30",0,0,1,0,0,1,0,0
"Bolivia (Plurinational State of)","2024-07-01",0,0,1,0,0,1,0,0
"Bolivia (Plurinational State of)","2024-07-02",0,0,1,0,0,1,0,0
"Bolivia (Plurinational State of)","2024-07-03",0,0,1,0,0,1,0,0
"Bolivia (Plurinational State of)","2024-07-04",0,0,1,0,0,1,0,0
"Bolivia (Plurinational State of)","2024-07-05",0,0,1,0,0,1,0,0
"Bolivia (Plurinational State of)","2024-07-06",0,0,1,0,0,1,0,0
"Bolivia (Plurinational State of)","2024-07-07",0,0,1,0,0,1,0,0
"Bolivia (Plurinational State of)","2024-07-08",0,0,1,0,0,1,0,0
"Bolivia (Plurinational State of)","2024-07-09",0,0,1,0,0,1,0,0
"Bolivia (Plurinational State of)","2024-07-10",0,0,1,0,0,1,0,0
"Bolivia (Plurinational State of)","2024-07-11",0,0,1,0,0,1,0,0
"Bolivia (Plurinational State of)","2024-07-12",0,0,1,0,0,1,0,0
"Bolivia (Plurinational State of)","2024-07-13",0,0,1,0,0,1,0,0
"Bolivia (Plurinational State of)","2024-07-14",0,0,1,0,0,1,0,0
"Bolivia (Plurinational State of)","2024-07-15",0,0,1,0,0,1,0,0
"Bolivia (Plurinational State of)","2024-07-16",0,0,1,0,0,1,0,0
"Bolivia (Plurinational State of)","2024-07-17",0,0,1,0,0,1,0,0
"Bolivia (Plurinational State of)","2024-07-18",0,0,1,0,0,1,0,0
"Bolivia (Plurinational State of)","2024-07-19",0,0,1,0,0,1,0,0
"Bolivia (Plurinational State of)","2024-07-20",0,0,1,0,0,1,0,0
"Bolivia (Plurinational State of)","2024-07-21",0,0,1,0,0,1,0,0
"Bolivia (Plurinational State of)","2024-07-22",0,0,1,0,0,1,0,0
"Bolivia (Plurinational State of)","2024-07-23",0,0,1,0,0,1,0,0
"Bolivia (Plurinational State of)","2024-07-24",0,0,1,0,0,1,0,0
"Bolivia (Plurinational State of)","2024-07-25",0,0,1,0,0,1,0,0
"Bolivia (Plurinational State of)","2024-07-26",0,0,1,0,0,1,0,0
"Bolivia (Plurinational State of)","2024-07-27",0,0,1,0,0,1,0,0
"Bolivia (Plurinational State of)","2024-07-28",0,0,1,0,0,1,0,0
"Bolivia (Plurinational State of)","2024-07-29",0,0,1,0,0,1,0,0
"Bolivia (Plurinational State of)","2024-07-30",0,0,1,0,0,1,0,0
"Bolivia (Plurinational State of)","2024-07-31",0,0,1,0,0,1,0,0
"Bolivia (Plurinational State of)","2024-08-01",0,0,1,0,0,1,0,0
"Bolivia (Plurinational State of)","2024-08-02",0,0,1,0,0,1,0,0
"Bolivia (Plurinational State of)","2024-08-03",0,0,1,0,0,1,0,0
"Bolivia (Plurinational State of)","2024-08-04",0,0,1,0,0,1,0,0
"Bolivia (Plurinational State of)","2024-08-05",0,0,1,0,0,1,0,0
"Bolivia (Plurinational State of)","2024-08-06",0,0,1,0,0,1,0,0
"Bolivia (Plurinational State of)","2024-08-07",0,0,1,0,0,1,0,0
"Bolivia (Plurinational State of)","2024-08-08",0,0,1,0,0,1,0,0
"Bolivia (Plurinational State of)","2024-08-09",0,0,1,0,0,1,0,0
"Bolivia (Plurinational State of)","2024-08-10",0,0,1,0,0,1,0,0
"Bolivia (Plurinational State of)","2024-08-11",0,0,1,0,0,1,0,0
"Bolivia (Plurinational State of)","2024-08-12",0,0,1,0,0,1,0,0
"Bolivia (Plurinational State of)","2024-08-13",0,0,1,0,0,1,0,0
"Bolivia (Plurinational State of)","2024-08-14",0,0,1,0,0,1,0,0
"Bolivia (Plurinational State of)","2024-08-15",0,0,1,0,0,1,0,0
"Bolivia (Plurinational State of)","2024-08-16",0,0,1,0,0,1,0,0
"Bolivia (Plurinational State of)","2024-08-17",0,0,1,0,0,1,0,0
"Bolivia (Plurinational State of)","2024-08-18",0,0,1,0,0,1,0,0
"Bolivia (Plurinational State of)","2024-08-19",0,0,1,0,0,1,0,0
"Bolivia (Plurinational State of)","2024-08-20",0,0,1,0,0,1,0,0
"Bolivia (Plurinational State of)","2024-08-21",0,0,1,0,0,1,0,0
"Bolivia (Plurinational State of)","2024-08-22",0,0,1,0,0,1,0,0
"Bolivia (Plurinational State of)","2024-08-23",0,0,1,0,0,1,0,0
"Bolivia (Plurinational State of)","2024-08-24",0,0,1,0,0,1,0,0
"Bolivia (Plurinational State of)","2024-08-25",0,0,1,0,0,1,0,0
"Bolivia (Plurinational State of)","2024-08-26",0,0,1,0,0,1,0,0
"Bolivia (Plurinational State of)","2024-08-27",0,0,1,0,0,1,0,0
"Bolivia (Plurinational State of)","2024-08-28",0,0,1,0,0,1,0,0
"Bolivia (Plurinational State of)","2024-08-29",0,0,1,0,0,1,0,0
"Bolivia (Plurinational State of)","2024-08-30",0,0,1,0,0,1,0,0
"Bolivia (Plurinational State of)","2024-08-31",0,0,1,0,0,1,0,0
"Bolivia (Plurinational State of)","2024-09-01",0,0,1,0,0,1,0,0
"Bolivia (Plurinational State of)","2024-09-02",0,0,1,0,0,1,0,0
"Bolivia (Plurinational State of)","2024-09-03",0,0,1,0,0,1,0,0
"Bolivia (Plurinational State of)","2024-09-04",0,0,1,0,0,1,0,0
"Bolivia (Plurinational State of)","2024-09-05",0,0,1,0,0,1,0,0
"Bolivia (Plurinational State of)","2024-09-06",0,0,1,0,0,1,0,0
"Bolivia (Plurinational State of)","2024-09-07",0,0,1,0,0,1,0,0
"Bolivia (Plurinational State of)","2024-09-08",0,0,1,0,0,1,0,0
"Bolivia (Plurinational State of)","2024-09-09",0,0,1,0,0,1,0,0
"Bolivia (Plurinational State of)","2024-09-10",0,0,1,0,0,1,0,0
"Bolivia (Plurinational State of)","2024-09-11",0,0,1,0,0,1,0,0
"Bolivia (Plurinational State of)","2024-09-12",0,0,1,0,0,1,0,0
"Bolivia (Plurinational State of)","2024-09-13",0,0,1,0,0,1,0,0
"Bolivia (Plurinational State of)","2024-09-14",0,0,1,0,0,1,0,0
"Bolivia (Plurinational State of)","2024-09-15",0,0,1,0,0,1,0,0
"Bolivia (Plurinational State of)","2024-09-16",0,0,1,0,0,1,0,0
"Bolivia (Plurinational State of)","2024-09-17",0,0,1,0,0,1,0,0
"Bolivia (Plurinational State of)","2024-09-18",0,0,1,0,0,1,0,0
"Bolivia (Plurinational State of)","2024-09-19",0,0,1,0,0,1,0,0
"Bolivia (Plurinational State of)","2024-09-20",0,0,1,0,0,1,0,0
"Bolivia (Plurinational State of)","2024-09-21",0,0,1,0,0,1,0,0
"Bolivia (Plurinational State of)","2024-09-22",0,0,1,0,0,1,0,0
"Bolivia (Plurinational State of)","2024-09-23",0,0,1,0,0,1,0,0
"Bolivia (Plurinational State of)","2024-09-24",0,0,1,0,0,1,0,0
"Bolivia (Plurinational State of)","2024-09-25",0,0,1,0,0,1,0,0
"Bolivia (Plurinational State of)","2024-09-26",0,0,1,0,0,1,0,0
"Bolivia (Plurinational State of)","2024-09-27",0,0,1,0,0,1,0,0
"Bolivia (Plurinational State of)","2024-09-28",0,0,1,0,0,1,0,0
"Bolivia (Plurinational State of)","2024-09-29",0,0,1,0,0,1,0,0
"Bolivia (Plurinational State of)","2024-09-30",0,0,1,0,0,1,0,0
"Bolivia (Plurinational State of)","2024-10-01",0,0,1,0,0,1,0,0
"Bolivia (Plurinational State of)","2024-10-02",0,0,1,0,0,1,0,0
"Bolivia (Plurinational State of)","2024-10-03",0,0,1,0,0,1,0,0
"Bolivia (Plurinational State of)","2024-10-04",0,0,1,0,0,1,0,0
"Bolivia (Plurinational State of)","2024-10-05",0,0,1,0,0,1,0,0
"Bolivia (Plurinational State of)","2024-10-06",0,0,1,0,0,1,0,0
"Bolivia (Plurinational State of)","2024-10-07",0,0,1,0,0,1,0,0
"Bolivia (Plurinational State of)","2024-10-08",0,0,1,0,0,1,0,0
"Bolivia (Plurinational State of)","2024-10-09",0,0,1,0,0,1,0,0
"Bolivia (Plurinational State of)","2024-10-10",0,0,1,0,0,1,0,0
"Bolivia (Plurinational State of)","2024-10-11",0,0,1,0,0,1,0,0
"Bolivia (Plurinational State of)","2024-10-12",0,0,1,0,0,1,0,0
"Bolivia (Plurinational State of)","2024-10-13",0,0,1,0,0,1,0,0
"Bolivia (Plurinational State of)","2024-10-14",0,0,1,0,0,1,0,0
"Bolivia (Plurinational State of)","2024-10-15",0,0,1,0,0,1,0,0
"Bolivia (Plurinational State of)","2024-10-16",0,0,1,0,0,1,0,0
"Bolivia (Plurinational State of)","2024-10-17",0,0,1,0,0,1,0,0
"Bolivia (Plurinational State of)","2024-10-18",0,0,1,0,0,1,0,0
"Bolivia (Plurinational State of)","2024-10-19",0,0,1,0,0,1,0,0
"Bolivia (Plurinational State of)","2024-10-20",0,0,1,0,0,1,0,0
"Bolivia (Plurinational State of)","2024-10-21",0,0,1,0,0,1,0,0
"Bolivia (Plurinational State of)","2024-10-22",0,0,1,0,0,1,0,0
"Bolivia (Plurinational State of)","2024-10-23",0,0,1,0,0,1,0,0
"Bolivia (Plurinational State of)","2024-10-24",0,0,1,0,0,1,0,0
"Bolivia (Plurinational State of)","2024-10-25",0,0,1,0,0,1,0,0
"Bolivia (Plurinational State of)","2024-10-26",0,0,1,0,0,1,0,0
"Bolivia (Plurinational State of)","2024-10-27",0,0,1,0,0,1,0,0
"Bolivia (Plurinational State of)","2024-10-28",0,0,1,0,0,1,0,0
"Bolivia (Plurinational State of)","2024-10-29",0,0,1,0,0,1,0,0
"Bolivia (Plurinational State of)","2024-10-30",0,0,1,0,0,1,0,0
"Bolivia (Plurinational State of)","2024-10-31",0,0,1,0,0,1,0,0
"Bolivia (Plurinational State of)","2024-11-01",0,0,1,0,0,1,0,0
"Bolivia (Plurinational State of)","2024-11-02",0,0,1,0,0,1,0,0
"Bolivia (Plurinational State of)","2024-11-03",0,0,1,0,0,1,0,0
"Bolivia (Plurinational State of)","2024-11-04",0,0,1,0,0,1,0,0
"Bolivia (Plurinational State of)","2024-11-05",0,0,1,0,0,1,0,0
"Bolivia (Plurinational State of)","2024-11-06",0,0,1,0,0,1,0,0
"Bolivia (Plurinational State of)","2024-11-07",0,0,1,0,0,1,0,0
"Bolivia (Plurinational State of)","2024-11-08",0,0,1,0,0,1,0,0
"Bolivia (Plurinational State of)","2024-11-09",0,0,1,0,0,1,0,0
"Bolivia (Plurinational State of)","2024-11-10",0,0,1,0,0,1,0,0
"Bolivia (Plurinational State of)","2024-11-11",0,0,1,0,0,1,0,0
"Bolivia (Plurinational State of)","2024-11-12",0,0,1,0,0,1,0,0
"Bolivia (Plurinational State of)","2024-11-13",0,0,1,0,0,1,0,0
"Bolivia (Plurinational State of)","2024-11-14",0,0,1,0,0,1,0,0
"Bolivia (Plurinational State of)","2024-11-15",0,0,1,0,0,1,0,0
"Bolivia (Plurinational State of)","2024-11-16",0,0,1,0,0,1,0,0
"Bolivia (Plurinational State of)","2024-11-17",0,0,1,0,0,1,0,0
"Bolivia (Plurinational State of)","2024-11-18",0,0,1,0,0,1,0,0
"Bolivia (Plurinational State of)","2024-11-19",0,0,1,0,0,1,0,0
"Bolivia (Plurinational State of)","2024-11-20",0,0,1,0,0,1,0,0
"Bolivia (Plurinational State of)","2024-11-21",0,0,1,0,0,1,0,0
"Bolivia (Plurinational State of)","2024-11-22",0,0,1,0,0,1,0,0
"Bolivia (Plurinational State of)","2024-11-23",0,0,1,0,0,1,0,0
"Bolivia (Plurinational State of)","2024-11-24",0,0,1,0,0,1,0,0
"Bolivia (Plurinational State of)","2024-11-25",0,0,1,0,0,1,0,0
"Bolivia (Plurinational State of)","2024-11-26",0,0,1,0,0,1,0,0
"Bolivia (Plurinational State of)","2024-11-27",0,0,1,0,0,1,0,0
"Bolivia (Plurinational State of)","2024-11-28",0,0,1,0,0,1,0,0
"Bolivia (Plurinational State of)","2024-11-29",0,0,1,0,0,1,0,0
"Bolivia (Plurinational State of)","2024-11-30",0,0,1,0,0,1,0,0
"Bolivia (Plurinational State of)","2024-12-01",0,0,1,0,0,1,0,0
"Bolivia (Plurinational State of)","2024-12-02",0,0,1,0,0,1,0,0
"Bolivia (Plurinational State of)","2024-12-03",0,0,1,0,0,1,0,0
"Bolivia (Plurinational State of)","2024-12-04",0,0,1,0,0,1,0,0
"Bolivia (Plurinational State of)","2024-12-05",0,0,1,0,0,1,0,0
"Bolivia (Plurinational State of)","2024-12-06",0,0,1,0,0,1,0,0
"Bolivia (Plurinational State of)","2024-12-07",0,0,1,0,0,1,0,0
"Bolivia (Plurinational State of)","2024-12-08",0,0,1,0,0,1,0,0
"Bolivia (Plurinational State of)","2024-12-09",0,0,1,0,0,1,0,0
"Bolivia (Plurinational State of)","2024-12-10",0,0,1,0,0,1,0,0
"Bolivia (Plurinational State of)","2024-12-11",0,0,1,0,0,1,0,0
"Bolivia (Plurinational State of)","2024-12-12",0,0,1,0,0,1,0,0
"Bolivia (Plurinational State of)","2024-12-13",0,0,1,0,0,1,0,0
"Bolivia (Plurinational State of)","2024-12-14",0,0,1,0,0,1,0,0
"Bolivia (Plurinational State of)","2024-12-15",0,0,1,0,0,1,0,0
"Bolivia (Plurinational State of)","2024-12-16",0,0,1,0,0,1,0,0
"Bolivia (Plurinational State of)","2024-12-17",0,0,1,0,0,1,0,0
"Bolivia (Plurinational State of)","2024-12-18",0,0,1,0,0,1,0,0
"Bolivia (Plurinational State of)","2024-12-19",0,0,1,0,0,1,0,0
"Bolivia (Plurinational State of)","2024-12-20",0,0,1,0,0,1,0,0
"Bolivia (Plurinational State of)","2024-12-21",0,0,1,0,0,1,0,0
"Bolivia (Plurinational State of)","2024-12-22",0,0,1,0,0,1,0,0
"Bolivia (Plurinational State of)","2024-12-23",0,0,1,0,0,1,0,0
"Bolivia (Plurinational State of)","2024-12-24",0,0,1,0,0,1,0,0
"Bolivia (Plurinational State of)","2024-12-25",0,0,1,0,0,1,0,0
"Bolivia (Plurinational State of)","2024-12-26",0,0,1,0,0,1,0,0
"Bolivia (Plurinational State of)","2024-12-27",0,0,1,0,0,1,0,0
"Bolivia (Plurinational State of)","2024-12-28",0,0,1,0,0,1,0,0
"Bolivia (Plurinational State of)","2024-12-29",0,0,1,0,0,1,0,0
"Bolivia (Plurinational State of)","2024-12-30",0,0,1,0,0,1,0,0
"Bolivia (Plurinational State of)","2024-12-31",0,0,1,0,0,1,0,0
"Bolivia (Plurinational State of)","2025-01-01",0,0,1,0,0,1,0,0
"Bolivia (Plurinational State of)","2025-01-02",0,0,1,0,0,1,0,0
"Bolivia (Plurinational State of)","2025-01-03",0,0,1,0,0,1,0,0
"Bolivia (Plurinational State of)","2025-01-04",0,0,1,0,0,1,0,0
"Bolivia (Plurinational State of)","2025-01-05",0,0,1,0,0,1,0,0
"Bolivia (Plurinational State of)","2025-01-06",0,0,1,0,0,1,0,0
"Bolivia (Plurinational State of)","2025-01-07",0,0,1,0,0,1,0,0
"Bolivia (Plurinational State of)","2025-01-08",0,0,1,0,0,1,0,0
"Bolivia (Plurinational State of)","2025-01-09",0,0,1,0,0,1,0,0
"Bolivia (Plurinational State of)","2025-01-10",0,0,1,0,0,1,0,0
"Bolivia (Plurinational State of)","2025-01-11",0,0,1,0,0,1,0,0
"Bolivia (Plurinational State of)","2025-01-12",0,0,1,0,0,1,0,0
"Bolivia (Plurinational State of)","2025-01-13",0,0,1,0,0,1,0,0
"Bolivia (Plurinational State of)","2025-01-14",0,0,1,0,0,1,0,0
"Bolivia (Plurinational State of)","2025-01-15",0,0,1,0,0,1,0,0
"Bolivia (Plurinational State of)","2025-01-16",0,0,1,0,0,1,0,0
"Bolivia (Plurinational State of)","2025-01-17",0,0,1,0,0,1,0,0
"Bolivia (Plurinational State of)","2025-01-18",0,0,1,0,0,1,0,0
"Bolivia (Plurinational State of)","2025-01-19",0,0,1,0,0,1,0,0
"Bolivia (Plurinational State of)","2025-01-20",0,0,1,0,0,1,0,0
"Bolivia (Plurinational State of)","2025-01-21",0,0,1,0,0,1,0,0
"Bolivia (Plurinational State of)","2025-01-22",0,0,1,0,0,1,0,0
"Bolivia (Plurinational State of)","2025-01-23",0,0,1,0,0,1,0,0
"Bolivia (Plurinational State of)","2025-01-24",0,0,1,0,0,1,0,0
"Bolivia (Plurinational State of)","2025-01-25",0,0,1,0,0,1,0,0
"Bolivia (Plurinational State of)","2025-01-26",0,0,1,0,0,1,0,0
"Bolivia (Plurinational State of)","2025-01-27",0,0,1,0,0,1,0,0
"Bolivia (Plurinational State of)","2025-01-28",0,0,1,0,0,1,0,0
"Bolivia (Plurinational State of)","2025-01-29",0,0,1,0,0,1,0,0
"Bolivia (Plurinational State of)","2025-01-30",0,0,1,0,0,1,0,0
"Bolivia (Plurinational State of)","2025-01-31",0,0,1,0,0,1,0,0
"Bolivia (Plurinational State of)","2025-02-01",0,0,1,0,0,1,0,0
"Bolivia (Plurinational State of)","2025-02-02",0,0,1,0,0,1,0,0
"Bolivia (Plurinational State of)","2025-02-03",0,0,1,0,0,1,0,0
"Bosnia and Herzegovina","2024-01-01",0,0,0,0,0,0,0,0
"Bosnia and Herzegovina","2024-01-02",0,0,0,0,0,0,0,0
"Bosnia and Herzegovina","2024-01-03",0,0,0,0,0,0,0,0
"Bosnia and Herzegovina","2024-01-04",0,0,0,0,0,0,0,0
"Bosnia and Herzegovina","2024-01-05",0,0,0,0,0,0,0,0
"Bosnia and Herzegovina","2024-01-06",0,0,0,0,0,0,0,0
"Bosnia and Herzegovina","2024-01-07",0,0,0,0,0,0,0,0
"Bosnia and Herzegovina","2024-01-08",0,0,0,0,0,0,0,0
"Bosnia and Herzegovina","2024-01-09",0,0,0,0,0,0,0,0
"Bosnia and Herzegovina","2024-01-10",0,0,0,0,0,0,0,0
"Bosnia and Herzegovina","2024-01-11",0,0,0,0,0,0,0,0
"Bosnia and Herzegovina","2024-01-12",0,0,0,0,0,0,0,0
"Bosnia and Herzegovina","2024-01-13",0,0,0,0,0,0,0,0
"Bosnia and Herzegovina","2024-01-14",0,0,0,0,0,0,0,0
"Bosnia and Herzegovina","2024-01-15",0,0,0,0,0,0,0,0
"Bosnia and Herzegovina","2024-01-16",0,0,0,0,0,0,0,0
"Bosnia and Herzegovina","2024-01-17",0,0,0,0,0,0,0,0
"Bosnia and Herzegovina","2024-01-18",0,0,0,0,0,0,0,0
"Bosnia and Herzegovina","2024-01-19",0,0,0,0,0,0,0,0
"Bosnia and Herzegovina","2024-01-20",0,0,0,0,0,0,0,0
"Bosnia and Herzegovina","2024-01-21",0,0,0,0,0,0,0,0
"Bosnia and Herzegovina","2024-01-22",0,0,0,0,0,0,0,0
"Bosnia and Herzegovina","2024-01-23",0,0,0,0,0,0,0,0
"Bosnia and Herzegovina","2024-01-24",0,0,0,0,0,0,0,0
"Bosnia and Herzegovina","2024-01-25",0,0,0,0,0,0,0,0
"Bosnia and Herzegovina","2024-01-26",0,0,0,0,0,0,0,0
"Bosnia and Herzegovina","2024-01-27",0,0,0,0,0,0,0,0
"Bosnia and Herzegovina","2024-01-28",0,0,0,0,0,0,0,0
"Bosnia and Herzegovina","2024-01-29",0,0,0,0,0,0,0,0
"Bosnia and Herzegovina","2024-01-30",0,0,0,0,0,0,0,0
"Bosnia and Herzegovina","2024-01-31",0,0,0,0,0,0,0,0
"Bosnia and Herzegovina","2024-02-01",0,0,0,0,0,0,0,0
"Bosnia and Herzegovina","2024-02-02",0,0,0,0,0,0,0,0
"Bosnia and Herzegovina","2024-02-03",0,0,0,0,0,0,0,0
"Bosnia and Herzegovina","2024-02-04",0,0,0,0,0,0,0,0
"Bosnia and Herzegovina","2024-02-05",0,0,0,0,0,0,0,0
"Bosnia and Herzegovina","2024-02-06",0,0,0,0,0,0,0,0
"Bosnia and Herzegovina","2024-02-07",0,0,0,0,0,0,0,0
"Bosnia and Herzegovina","2024-02-08",0,0,0,0,0,0,0,0
"Bosnia and Herzegovina","2024-02-09",0,0,0,0,0,0,0,0
"Bosnia and Herzegovina","2024-02-10",0,0,0,0,0,0,0,0
"Bosnia and Herzegovina","2024-02-11",0,0,0,0,0,0,0,0
"Bosnia and Herzegovina","2024-02-12",0,0,0,0,0,0,0,0
"Bosnia and Herzegovina","2024-02-13",0,0,0,0,0,0,0,0
"Bosnia and Herzegovina","2024-02-14",0,0,0,0,0,0,0,0
"Bosnia and Herzegovina","2024-02-15",0,0,0,0,0,0,0,0
"Bosnia and Herzegovina","2024-02-16",0,0,0,0,0,0,0,0
"Bosnia and Herzegovina","2024-02-17",0,0,0,0,0,0,0,0
"Bosnia and Herzegovina","2024-02-18",0,0,0,0,0,0,0,0
"Bosnia and Herzegovina","2024-02-19",0,0,0,0,0,0,0,0
"Bosnia and Herzegovina","2024-02-20",0,0,0,0,0,0,0,0
"Bosnia and Herzegovina","2024-02-21",0,0,0,0,0,0,0,0
"Bosnia and Herzegovina","2024-02-22",0,0,0,0,0,0,0,0
"Bosnia and Herzegovina","2024-02-23",0,0,0,0,0,0,0,0
"Bosnia and Herzegovina","2024-02-24",0,0,0,0,0,0,0,0
"Bosnia and Herzegovina","2024-02-25",0,0,0,0,0,0,0,0
"Bosnia and Herzegovina","2024-02-26",0,0,0,0,0,0,0,0
"Bosnia and Herzegovina","2024-02-27",0,0,0,0,0,0,0,0
"Bosnia and Herzegovina","2024-02-28",0,0,0,0,0,0,0,0
"Bosnia and Herzegovina","2024-02-29",0,0,0,0,0,0,0,0
"Bosnia and Herzegovina","2024-03-01",0,0,0,0,0,0,0,0
"Bosnia and Herzegovina","2024-03-02",0,0,0,0,0,0,0,0
"Bosnia and Herzegovina","2024-03-03",0,0,0,0,0,0,0,0
"Bosnia and Herzegovina","2024-03-04",0,0,0,0,0,0,0,0
"Bosnia and Herzegovina","2024-03-05",0,0,0,0,0,0,0,0
"Bosnia and Herzegovina","2024-03-06",0,0,0,0,0,0,0,0
"Bosnia and Herzegovina","2024-03-07",0,0,0,0,0,0,0,0
"Bosnia and Herzegovina","2024-03-08",0,0,0,0,0,0,0,0
"Bosnia and Herzegovina","2024-03-09",0,0,0,0,0,0,0,0
"Bosnia and Herzegovina","2024-03-10",0,0,0,0,0,0,0,0
"Bosnia and Herzegovina","2024-03-11",0,0,0,0,0,0,0,0
"Bosnia and Herzegovina","2024-03-12",0,0,0,0,0,0,0,0
"Bosnia and Herzegovina","2024-03-13",0,0,0,0,0,0,0,0
"Bosnia and Herzegovina","2024-03-14",0,0,0,0,0,0,0,0
"Bosnia and Herzegovina","2024-03-15",0,0,0,0,0,0,0,0
"Bosnia and Herzegovina","2024-03-16",0,0,0,0,0,0,0,0
"Bosnia and Herzegovina","2024-03-17",0,0,0,0,0,0,0,0
"Bosnia and Herzegovina","2024-03-18",0,0,0,0,0,0,0,0
"Bosnia and Herzegovina","2024-03-19",0,0,0,0,0,0,0,0
"Bosnia and Herzegovina","2024-03-20",0,0,0,0,0,0,0,0
"Bosnia and Herzegovina","2024-03-21",0,0,0,0,0,0,0,0
"Bosnia and Herzegovina","2024-03-22",0,0,0,0,0,0,0,0
"Bosnia and Herzegovina","2024-03-23",0,0,0,0,0,0,0,0
"Bosnia and Herzegovina","2024-03-24",0,0,0,0,0,0,0,0
"Bosnia and Herzegovina","2024-03-25",0,0,0,0,0,0,0,0
"Bosnia and Herzegovina","2024-03-26",0,0,0,0,0,0,0,0
"Bosnia and Herzegovina","2024-03-27",0,0,0,0,0,0,0,0
"Bosnia and Herzegovina","2024-03-28",0,0,0,0,0,0,0,0
"Bosnia and Herzegovina","2024-03-29",0,0,0,0,0,0,0,0
"Bosnia and Herzegovina","2024-03-30",0,0,0,0,0,0,0,0
"Bosnia and Herzegovina","2024-03-31",0,0,0,0,0,0,0,0
"Bosnia and Herzegovina","2024-04-01",0,0,0,0,0,0,0,0
"Bosnia and Herzegovina","2024-04-02",0,0,0,0,0,0,0,0
"Bosnia and Herzegovina","2024-04-03",0,0,0,0,0,0,0,0
"Bosnia and Herzegovina","2024-04-04",0,0,0,0,0,0,0,0
"Bosnia and Herzegovina","2024-04-05",0,0,0,0,0,0,0,0
"Bosnia and Herzegovina","2024-04-06",0,0,0,0,0,0,0,0
"Bosnia and Herzegovina","2024-04-07",0,0,0,0,0,0,0,0
"Bosnia and Herzegovina","2024-04-08",0,0,0,0,0,0,0,0
"Bosnia and Herzegovina","2024-04-09",0,0,0,0,0,0,0,0
"Bosnia and Herzegovina","2024-04-10",0,0,0,0,0,0,0,0
"Bosnia and Herzegovina","2024-04-11",0,0,0,0,0,0,0,0
"Bosnia and Herzegovina","2024-04-12",0,0,0,0,0,0,0,0
"Bosnia and Herzegovina","2024-04-13",0,0,0,0,0,0,0,0
"Bosnia and Herzegovina","2024-04-14",0,0,0,0,0,0,0,0
"Bosnia and Herzegovina","2024-04-15",0,0,0,0,0,0,0,0
"Bosnia and Herzegovina","2024-04-16",0,0,0,0,0,0,0,0
"Bosnia and Herzegovina","2024-04-17",0,0,0,0,0,0,0,0
"Bosnia and Herzegovina","2024-04-18",0,0,0,0,0,0,0,0
"Bosnia and Herzegovina","2024-04-19",0,0,0,0,0,0,0,0
"Bosnia and Herzegovina","2024-04-20",0,0,0,0,0,0,0,0
"Bosnia and Herzegovina","2024-04-21",0,0,0,0,0,0,0,0
"Bosnia and Herzegovina","2024-04-22",0,0,0,0,0,0,0,0
"Bosnia and Herzegovina","2024-04-23",0,0,0,0,0,0,0,0
"Bosnia and Herzegovina","2024-04-24",0,0,0,0,0,0,0,0
"Bosnia and Herzegovina","2024-04-25",0,0,0,0,0,0,0,0
"Bosnia and Herzegovina","2024-04-26",0,0,0,0,0,0,0,0
"Bosnia and Herzegovina","2024-04-27",0,0,0,0,0,0,0,0
"Bosnia and Herzegovina","2024-04-28",0,0,0,0,0,0,0,0
"Bosnia and Herzegovina","2024-04-29",0,0,0,0,0,0,0,0
"Bosnia and Herzegovina","2024-04-30",0,0,0,0,0,0,0,0
"Bosnia and Herzegovina","2024-05-01",0,0,0,0,0,0,0,0
"Bosnia and Herzegovina","2024-05-02",0,0,0,0,0,0,0,0
"Bosnia and Herzegovina","2024-05-03",0,0,0,0,0,0,0,0
"Bosnia and Herzegovina","2024-05-04",0,0,0,0,0,0,0,0
"Bosnia and Herzegovina","2024-05-05",0,0,0,0,0,0,0,0
"Bosnia and Herzegovina","2024-05-06",0,0,0,0,0,0,0,0
"Bosnia and Herzegovina","2024-05-07",0,0,0,0,0,0,0,0
"Bosnia and Herzegovina","2024-05-08",0,0,0,0,0,0,0,0
"Bosnia and Herzegovina","2024-05-09",0,0,0,0,0,0,0,0
"Bosnia and Herzegovina","2024-05-10",0,0,0,0,0,0,0,0
"Bosnia and Herzegovina","2024-05-11",0,0,0,0,0,0,0,0
"Bosnia and Herzegovina","2024-05-12",0,0,0,0,0,0,0,0
"Bosnia and Herzegovina","2024-05-13",0,0,0,0,0,0,0,0
"Bosnia and Herzegovina","2024-05-14",0,0,0,0,0,0,0,0
"Bosnia and Herzegovina","2024-05-15",0,0,0,0,0,0,0,0
"Bosnia and Herzegovina","2024-05-16",0,0,0,0,0,0,0,0
"Bosnia and Herzegovina","2024-05-17",0,0,0,0,0,0,0,0
"Bosnia and Herzegovina","2024-05-18",0,0,0,0,0,0,0,0
"Bosnia and Herzegovina","2024-05-19",0,0,0,0,0,0,0,0
"Bosnia and Herzegovina","2024-05-20",0,0,0,0,0,0,0,0
"Bosnia and Herzegovina","2024-05-21",0,0,0,0,0,0,0,0
"Bosnia and Herzegovina","2024-05-22",0,0,0,0,0,0,0,0
"Bosnia and Herzegovina","2024-05-23",0,0,0,0,0,0,0,0
"Bosnia and Herzegovina","2024-05-24",0,0,0,0,0,0,0,0
"Bosnia and Herzegovina","2024-05-25",0,0,0,0,0,0,0,0
"Bosnia and Herzegovina","2024-05-26",0,0,0,0,0,0,0,0
"Bosnia and Herzegovina","2024-05-27",0,0,0,0,0,0,0,0
"Bosnia and Herzegovina","2024-05-28",0,0,0,0,0,0,0,0
"Bosnia and Herzegovina","2024-05-29",0,0,0,0,0,0,0,0
"Bosnia and Herzegovina","2024-05-30",0,0,0,0,0,0,0,0
"Bosnia and Herzegovina","2024-05-31",0,0,0,0,0,0,0,0
"Bosnia and Herzegovina","2024-06-01",0,0,0,0,0,0,0,0
"Bosnia and Herzegovina","2024-06-02",0,0,0,0,0,0,0,0
"Bosnia and Herzegovina","2024-06-03",0,0,0,0,0,0,0,0
"Bosnia and Herzegovina","2024-06-04",0,0,0,0,0,0,0,0
"Bosnia and Herzegovina","2024-06-05",0,0,0,0,0,0,0,0
"Bosnia and Herzegovina","2024-06-06",0,0,0,0,0,0,0,0
"Bosnia and Herzegovina","2024-06-07",0,0,0,0,0,0,0,0
"Bosnia and Herzegovina","2024-06-08",0,0,0,0,0,0,0,0
"Bosnia and Herzegovina","2024-06-09",0,0,0,0,0,0,0,0
"Bosnia and Herzegovina","2024-06-10",0,0,0,0,0,0,0,0
"Bosnia and Herzegovina","2024-06-11",0,0,0,0,0,0,0,0
"Bosnia and Herzegovina","2024-06-12",0,0,0,0,0,0,0,0
"Bosnia and Herzegovina","2024-06-13",0,0,0,0,0,0,0,0
"Bosnia and Herzegovina","2024-06-14",0,0,0,0,0,0,0,0
"Bosnia and Herzegovina","2024-06-15",0,0,0,0,0,0,0,0
"Bosnia and Herzegovina","2024-06-16",0,0,0,0,0,0,0,0
"Bosnia and Herzegovina","2024-06-17",0,0,0,0,0,0,0,0
"Bosnia and Herzegovina","2024-06-18",0,0,0,0,0,0,0,0
"Bosnia and Herzegovina","2024-06-19",0,0,0,0,0,0,0,0
"Bosnia and Herzegovina","2024-06-20",0,0,0,0,0,0,0,0
"Bosnia and Herzegovina","2024-06-21",0,0,0,0,0,0,0,0
"Bosnia and Herzegovina","2024-06-22",0,0,0,0,0,0,0,0
"Bosnia and Herzegovina","2024-06-23",0,0,0,0,0,0,0,0
"Bosnia and Herzegovina","2024-06-24",0,0,0,0,0,0,0,0
"Bosnia and Herzegovina","2024-06-25",0,0,0,0,0,0,0,0
"Bosnia and Herzegovina","2024-06-26",0,0,0,0,0,0,0,0
"Bosnia and Herzegovina","2024-06-27",0,0,0,0,0,0,0,0
"Bosnia and Herzegovina","2024-06-28",0,0,0,0,0,0,0,0
"Bosnia and Herzegovina","2024-06-29",0,0,0,0,0,0,0,0
"Bosnia and Herzegovina","2024-06-30",0,0,0,0,0,0,0,0
"Bosnia and Herzegovina","2024-07-01",0,0,0,0,0,0,0,0
"Bosnia and Herzegovina","2024-07-02",0,0,0,0,0,0,0,0
"Bosnia and Herzegovina","2024-07-03",0,0,0,0,0,0,0,0
"Bosnia and Herzegovina","2024-07-04",0,0,0,0,0,0,0,0
"Bosnia and Herzegovina","2024-07-05",0,0,0,0,0,0,0,0
"Bosnia and Herzegovina","2024-07-06",0,0,0,0,0,0,0,0
"Bosnia and Herzegovina","2024-07-07",0,0,0,0,0,0,0,0
"Bosnia and Herzegovina","2024-07-08",0,0,0,0,0,0,0,0
"Bosnia and Herzegovina","2024-07-09",0,0,0,0,0,0,0,0
"Bosnia and Herzegovina","2024-07-10",0,0,0,0,0,0,0,0
"Bosnia and Herzegovina","2024-07-11",0,0,0,0,0,0,0,0
"Bosnia and Herzegovina","2024-07-12",0,0,0,0,0,0,0,0
"Bosnia and Herzegovina","2024-07-13",0,0,0,0,0,0,0,0
"Bosnia and Herzegovina","2024-07-14",0,0,0,0,0,0,0,0
"Bosnia and Herzegovina","2024-07-15",0,0,0,0,0,0,0,0
"Bosnia and Herzegovina","2024-07-16",0,0,0,0,0,0,0,0
"Bosnia and Herzegovina","2024-07-17",0,0,0,0,0,0,0,0
"Bosnia and Herzegovina","2024-07-18",0,0,0,0,0,0,0,0
"Bosnia and Herzegovina","2024-07-19",0,0,0,0,0,0,0,0
"Bosnia and Herzegovina","2024-07-20",0,0,0,0,0,0,0,0
"Bosnia and Herzegovina","2024-07-21",0,0,0,0,0,0,0,0
"Bosnia and Herzegovina","2024-07-22",0,0,0,0,0,0,0,0
"Bosnia and Herzegovina","2024-07-23",0,0,0,0,0,0,0,0
"Bosnia and Herzegovina","2024-07-24",0,0,0,0,0,0,0,0
"Bosnia and Herzegovina","2024-07-25",0,0,0,0,0,0,0,0
"Bosnia and Herzegovina","2024-07-26",0,0,0,0,0,0,0,0
"Bosnia and Herzegovina","2024-07-27",0,0,0,0,0,0,0,0
"Bosnia and Herzegovina","2024-07-28",0,0,0,0,0,0,0,0
"Bosnia and Herzegovina","2024-07-29",0,0,0,0,0,0,0,0
"Bosnia and Herzegovina","2024-07-30",0,0,0,0,0,0,0,0
"Bosnia and Herzegovina","2024-07-31",0,0,0,0,0,0,0,0
"Bosnia and Herzegovina","2024-08-01",0,0,0,0,0,0,0,0
"Bosnia and Herzegovina","2024-08-02",0,0,0,0,0,0,0,0
"Bosnia and Herzegovina","2024-08-03",0,0,0,0,0,0,0,0
"Bosnia and Herzegovina","2024-08-04",0,0,0,0,0,0,0,0
"Bosnia and Herzegovina","2024-08-05",0,0,0,0,0,0,0,0
"Bosnia and Herzegovina","2024-08-06",0,0,0,0,0,0,0,0
"Bosnia and Herzegovina","2024-08-07",0,0,0,0,0,0,0,0
"Bosnia and Herzegovina","2024-08-08",0,0,0,0,0,0,0,0
"Bosnia and Herzegovina","2024-08-09",0,0,0,0,0,0,0,0
"Bosnia and Herzegovina","2024-08-10",0,0,0,0,0,0,0,0
"Bosnia and Herzegovina","2024-08-11",0,0,0,0,0,0,0,0
"Bosnia and Herzegovina","2024-08-12",0,0,0,0,0,0,0,0
"Bosnia and Herzegovina","2024-08-13",0,0,0,0,0,0,0,0
"Bosnia and Herzegovina","2024-08-14",0,0,0,0,0,0,0,0
"Bosnia and Herzegovina","2024-08-15",0,0,0,0,0,0,0,0
"Bosnia and Herzegovina","2024-08-16",0,0,0,0,0,0,0,0
"Bosnia and Herzegovina","2024-08-17",0,0,0,0,0,0,0,0
"Bosnia and Herzegovina","2024-08-18",0,0,0,0,0,0,0,0
"Bosnia and Herzegovina","2024-08-19",0,0,0,0,0,0,0,0
"Bosnia and Herzegovina","2024-08-20",0,0,0,0,0,0,0,0
"Bosnia and Herzegovina","2024-08-21",0,0,0,0,0,0,0,0
"Bosnia and Herzegovina","2024-08-22",0,0,0,0,0,0,0,0
"Bosnia and Herzegovina","2024-08-23",0,0,0,0,0,0,0,0
"Bosnia and Herzegovina","2024-08-24",0,0,0,0,0,0,0,0
"Bosnia and Herzegovina","2024-08-25",0,0,0,0,0,0,0,0
"Bosnia and Herzegovina","2024-08-26",0,0,0,0,0,0,0,0
"Bosnia and Herzegovina","2024-08-27",0,0,0,0,0,0,0,0
"Bosnia and Herzegovina","2024-08-28",0,0,0,0,0,0,0,0
"Bosnia and Herzegovina","2024-08-29",0,0,0,0,0,0,0,0
"Bosnia and Herzegovina","2024-08-30",0,0,0,0,0,0,0,0
"Bosnia and Herzegovina","2024-08-31",0,0,0,0,0,0,0,0
"Bosnia and Herzegovina","2024-09-01",0,0,0,0,0,0,0,0
"Bosnia and Herzegovina","2024-09-02",0,0,0,0,0,0,0,0
"Bosnia and Herzegovina","2024-09-03",0,0,0,0,0,0,0,0
"Bosnia and Herzegovina","2024-09-04",0,0,0,0,0,0,0,0
"Bosnia and Herzegovina","2024-09-05",0,0,0,0,0,0,0,0
"Bosnia and Herzegovina","2024-09-06",0,0,0,0,0,0,0,0
"Bosnia and Herzegovina","2024-09-07",0,0,0,0,0,0,0,0
"Bosnia and Herzegovina","2024-09-08",0,0,0,0,0,0,0,0
"Bosnia and Herzegovina","2024-09-09",0,0,0,0,0,0,0,0
"Bosnia and Herzegovina","2024-09-10",0,0,0,0,0,0,0,0
"Bosnia and Herzegovina","2024-09-11",0,0,0,0,0,0,0,0
"Bosnia and Herzegovina","2024-09-12",0,0,0,0,0,0,0,0
"Bosnia and Herzegovina","2024-09-13",0,0,0,0,0,0,0,0
"Bosnia and Herzegovina","2024-09-14",0,0,0,0,0,0,0,0
"Bosnia and Herzegovina","2024-09-15",0,0,0,0,0,0,0,0
"Bosnia and Herzegovina","2024-09-16",0,0,0,0,0,0,0,0
"Bosnia and Herzegovina","2024-09-17",0,0,0,0,0,0,0,0
"Bosnia and Herzegovina","2024-09-18",0,0,0,0,0,0,0,0
"Bosnia and Herzegovina","2024-09-19",0,0,0,0,0,0,0,0
"Bosnia and Herzegovina","2024-09-20",0,0,0,0,0,0,0,0
"Bosnia and Herzegovina","2024-09-21",0,0,0,0,0,0,0,0
"Bosnia and Herzegovina","2024-09-22",0,0,0,0,0,0,0,0
"Bosnia and Herzegovina","2024-09-23",0,0,0,0,0,0,0,0
"Bosnia and Herzegovina","2024-09-24",0,0,0,0,0,0,0,0
"Bosnia and Herzegovina","2024-09-25",0,0,0,0,0,0,0,0
"Bosnia and Herzegovina","2024-09-26",0,0,0,0,0,0,0,0
"Bosnia and Herzegovina","2024-09-27",0,0,0,0,0,0,0,0
"Bosnia and Herzegovina","2024-09-28",0,0,0,0,0,0,0,0
"Bosnia and Herzegovina","2024-09-29",0,0,0,0,0,0,0,0
"Bosnia and Herzegovina","2024-09-30",0,0,0,0,0,0,0,0
"Bosnia and Herzegovina","2024-10-01",0,0,0,0,0,0,0,0
"Bosnia and Herzegovina","2024-10-02",0,0,0,0,0,0,0,0
"Bosnia and Herzegovina","2024-10-03",0,0,0,0,0,0,0,0
"Bosnia and Herzegovina","2024-10-04",0,0,0,0,0,0,0,0
"Bosnia and Herzegovina","2024-10-05",0,0,0,0,0,0,0,0
"Bosnia and Herzegovina","2024-10-06",0,0,0,0,0,0,0,0
"Bosnia and Herzegovina","2024-10-07",0,0,0,0,0,0,0,0
"Bosnia and Herzegovina","2024-10-08",0,0,0,0,0,0,0,0
"Bosnia and Herzegovina","2024-10-09",0,0,0,0,0,0,0,0
"Bosnia and Herzegovina","2024-10-10",0,0,0,0,0,0,0,0
"Bosnia and Herzegovina","2024-10-11",0,0,0,0,0,0,0,0
"Bosnia and Herzegovina","2024-10-12",0,0,0,0,0,0,0,0
"Bosnia and Herzegovina","2024-10-13",0,0,0,0,0,0,0,0
"Bosnia and Herzegovina","2024-10-14",0,0,0,0,0,0,0,0
"Bosnia and Herzegovina","2024-10-15",0,0,0,0,0,0,0,0
"Bosnia and Herzegovina","2024-10-16",0,0,0,0,0,0,0,0
"Bosnia and Herzegovina","2024-10-17",0,0,0,0,0,0,0,0
"Bosnia and Herzegovina","2024-10-18",0,0,0,0,0,0,0,0
"Bosnia and Herzegovina","2024-10-19",0,0,0,0,0,0,0,0
"Bosnia and Herzegovina","2024-10-20",0,0,0,0,0,0,0,0
"Bosnia and Herzegovina","2024-10-21",0,0,0,0,0,0,0,0
"Bosnia and Herzegovina","2024-10-22",0,0,0,0,0,0,0,0
"Bosnia and Herzegovina","2024-10-23",0,0,0,0,0,0,0,0
"Bosnia and Herzegovina","2024-10-24",0,0,0,0,0,0,0,0
"Bosnia and Herzegovina","2024-10-25",0,0,0,0,0,0,0,0
"Bosnia and Herzegovina","2024-10-26",0,0,0,0,0,0,0,0
"Bosnia and Herzegovina","2024-10-27",0,0,0,0,0,0,0,0
"Bosnia and Herzegovina","2024-10-28",0,0,0,0,0,0,0,0
"Bosnia and Herzegovina","2024-10-29",0,0,0,0,0,0,0,0
"Bosnia and Herzegovina","2024-10-30",0,0,0,0,0,0,0,0
"Bosnia and Herzegovina","2024-10-31",0,0,0,0,0,0,0,0
"Bosnia and Herzegovina","2024-11-01",0,0,0,0,0,0,0,0
"Bosnia and Herzegovina","2024-11-02",0,0,0,0,0,0,0,0
"Bosnia and Herzegovina","2024-11-03",0,0,0,0,0,0,0,0
"Bosnia and Herzegovina","2024-11-04",0,0,0,0,0,0,0,0
"Bosnia and Herzegovina","2024-11-05",0,0,0,0,0,0,0,0
"Bosnia and Herzegovina","2024-11-06",0,0,0,0,0,0,0,0
"Bosnia and Herzegovina","2024-11-07",0,0,0,0,0,0,0,0
"Bosnia and Herzegovina","2024-11-08",0,0,0,0,0,0,0,0
"Bosnia and Herzegovina","2024-11-09",0,0,0,0,0,0,0,0
"Bosnia and Herzegovina","2024-11-10",0,0,0,0,0,0,0,0
"Bosnia and Herzegovina","2024-11-11",0,0,0,0,0,0,0,0
"Bosnia and Herzegovina","2024-11-12",0,0,0,0,0,0,0,0
"Bosnia and Herzegovina","2024-11-13",0,0,0,0,0,0,0,0
"Bosnia and Herzegovina","2024-11-14",0,0,0,0,0,0,0,0
"Bosnia and Herzegovina","2024-11-15",0,0,0,0,0,0,0,0
"Bosnia and Herzegovina","2024-11-16",0,0,0,0,0,0,0,0
"Bosnia and Herzegovina","2024-11-17",0,0,0,0,0,0,0,0
"Bosnia and Herzegovina","2024-11-18",0,0,0,0,0,0,0,0
"Bosnia and Herzegovina","2024-11-19",0,0,0,0,0,0,0,0
"Bosnia and Herzegovina","2024-11-20",0,0,0,0,0,0,0,0
"Bosnia and Herzegovina","2024-11-21",0,0,0,0,0,0,0,0
"Bosnia and Herzegovina","2024-11-22",0,0,0,0,0,0,0,0
"Bosnia and Herzegovina","2024-11-23",0,0,0,0,0,0,0,0
"Bosnia and Herzegovina","2024-11-24",0,0,0,0,0,0,0,0
"Bosnia and Herzegovina","2024-11-25",0,0,0,0,0,0,0,0
"Bosnia and Herzegovina","2024-11-26",0,0,0,0,0,0,0,0
"Bosnia and Herzegovina","2024-11-27",0,0,0,0,0,0,0,0
"Bosnia and Herzegovina","2024-11-28",0,0,0,0,0,0,0,0
"Bosnia and Herzegovina","2024-11-29",0,0,0,0,0,0,0,0
"Bosnia and Herzegovina","2024-11-30",0,0,0,0,0,0,0,0
"Bosnia and Herzegovina","2024-12-01",0,0,0,0,0,0,0,0
"Bosnia and Herzegovina","2024-12-02",0,0,0,0,0,0,0,0
"Bosnia and Herzegovina","2024-12-03",0,0,0,0,0,0,0,0
"Bosnia and Herzegovina","2024-12-04",0,0,0,0,0,0,0,0
"Bosnia and Herzegovina","2024-12-05",0,0,0,0,0,0,0,0
"Bosnia and Herzegovina","2024-12-06",0,0,0,0,0,0,0,0
"Bosnia and Herzegovina","2024-12-07",0,0,0,0,0,0,0,0
"Bosnia and Herzegovina","2024-12-08",0,0,0,0,0,0,0,0
"Bosnia and Herzegovina","2024-12-09",0,0,0,0,0,0,0,0
"Bosnia and Herzegovina","2024-12-10",0,0,0,0,0,0,0,0
"Bosnia and Herzegovina","2024-12-11",0,0,0,0,0,0,0,0
"Bosnia and Herzegovina","2024-12-12",0,0,0,0,0,0,0,0
"Bosnia and Herzegovina","2024-12-13",0,0,0,0,0,0,0,0
"Bosnia and Herzegovina","2024-12-14",0,0,0,0,0,0,0,0
"Bosnia and Herzegovina","2024-12-15",0,0,0,0,0,0,0,0
"Bosnia and Herzegovina","2024-12-16",0,0,0,0,0,0,0,0
"Bosnia and Herzegovina","2024-12-17",0,0,0,0,0,0,0,0
"Bosnia and Herzegovina","2024-12-18",0,0,0,0,0,0,0,0
"Bosnia and Herzegovina","2024-12-19",0,0,0,0,0,0,0,0
"Bosnia and Herzegovina","2024-12-20",0,0,0,0,0,0,0,0
"Bosnia and Herzegovina","2024-12-21",0,0,0,0,0,0,0,0
"Bosnia and Herzegovina","2024-12-22",0,0,0,0,0,0,0,0
"Bosnia and Herzegovina","2024-12-23",0,0,0,0,0,0,0,0
"Bosnia and Herzegovina","2024-12-24",0,0,0,0,0,0,0,0
"Bosnia and Herzegovina","2024-12-25",0,0,0,0,0,0,0,0
"Bosnia and Herzegovina","2024-12-26",0,0,0,0,0,0,0,0
"Bosnia and Herzegovina","2024-12-27",0,0,0,0,0,0,0,0
"Bosnia and Herzegovina","2024-12-28",0,0,0,0,0,0,0,0
"Bosnia and Herzegovina","2024-12-29",0,0,0,0,0,0,0,0
"Bosnia and Herzegovina","2024-12-30",0,0,0,0,0,0,0,0
"Bosnia and Herzegovina","2024-12-31",0,0,0,0,0,0,0,0
"Bosnia and Herzegovina","2025-01-01",0,0,0,0,0,0,0,0
"Bosnia and Herzegovina","2025-01-02",0,0,0,0,0,0,0,0
"Bosnia and Herzegovina","2025-01-03",0,0,0,0,0,0,0,0
"Bosnia and Herzegovina","2025-01-04",0,0,0,0,0,0,0,0
"Bosnia and Herzegovina","2025-01-05",0,0,0,0,0,0,0,0
"Bosnia and Herzegovina","2025-01-06",0,0,0,0,0,0,0,0
"Bosnia and Herzegovina","2025-01-07",0,0,0,0,0,0,0,0
"Bosnia and Herzegovina","2025-01-08",0,0,0,0,0,0,0,0
"Bosnia and Herzegovina","2025-01-09",0,0,0,0,0,0,0,0
"Bosnia and Herzegovina","2025-01-10",0,0,0,0,0,0,0,0
"Bosnia and Herzegovina","2025-01-11",0,0,0,0,0,0,0,0
"Bosnia and Herzegovina","2025-01-12",0,0,0,0,0,0,0,0
"Bosnia and Herzegovina","2025-01-13",0,0,0,0,0,0,0,0
"Bosnia and Herzegovina","2025-01-14",0,0,0,0,0,0,0,0
"Bosnia and Herzegovina","2025-01-15",0,0,0,0,0,0,0,0
"Bosnia and Herzegovina","2025-01-16",0,0,0,0,0,0,0,0
"Bosnia and Herzegovina","2025-01-17",0,0,0,0,0,0,0,0
"Bosnia and Herzegovina","2025-01-18",0,0,0,0,0,0,0,0
"Bosnia and Herzegovina","2025-01-19",0,0,0,0,0,0,0,0
"Bosnia and Herzegovina","2025-01-20",0,0,0,0,0,0,0,0
"Bosnia and Herzegovina","2025-01-21",0,0,0,0,0,0,0,0
"Bosnia and Herzegovina","2025-01-22",0,0,0,0,0,0,0,0
"Bosnia and Herzegovina","2025-01-23",0,0,0,0,0,0,0,0
"Bosnia and Herzegovina","2025-01-24",0,0,0,0,0,0,0,0
"Bosnia and Herzegovina","2025-01-25",0,0,0,0,0,0,0,0
"Bosnia and Herzegovina","2025-01-26",0,0,0,0,0,0,0,0
"Bosnia and Herzegovina","2025-01-27",0,0,0,0,0,0,0,0
"Bosnia and Herzegovina","2025-01-28",0,0,0,0,0,0,0,0
"Bosnia and Herzegovina","2025-01-29",0,0,0,0,0,0,0,0
"Bosnia and Herzegovina","2025-01-30",0,0,0,0,0,0,0,0
"Bosnia and Herzegovina","2025-01-31",0,0,0,0,0,0,0,0
"Bosnia and Herzegovina","2025-02-01",0,0,0,0,0,0,0,0
"Bosnia and Herzegovina","2025-02-02",0,0,0,0,0,0,0,0
"Bosnia and Herzegovina","2025-02-03",0,0,0,0,0,0,0,0
"Brazil","2024-01-01",0,0,0,0,0,0,0,0
"Brazil","2024-01-02",0,48,48,0,48,48,0,0
"Brazil","2024-01-03",0,0,48,0,6,54,0,0
"Brazil","2024-01-04",0,0,48,0,6,60,0,0
"Brazil","2024-01-05",0,0,48,0,6,66,0,0
"Brazil","2024-01-06",0,0,48,0,5,71,0,0
"Brazil","2024-01-07",0,0,48,0,6,77,0,0
"Brazil","2024-01-08",0,0,48,0,6,83,0,0
"Brazil","2024-01-09",0,41,89,0,6,89,0,0
"Brazil","2024-01-10",0,0,89,0,6,95,0,0
"Brazil","2024-01-11",0,0,89,0,6,101,0,0
"Brazil","2024-01-12",0,0,89,0,6,107,0,0
"Brazil","2024-01-13",0,0,89,0,5,112,0,0
"Brazil","2024-01-14",0,0,89,0,6,118,0,0
"Brazil","2024-01-15",0,0,89,0,6,124,0,0
"Brazil","2024-01-16",0,41,130,0,6,130,0,0
"Brazil","2024-01-17",0,0,130,0,5,135,0,0
"Brazil","2024-01-18",0,0,130,0,4,139,0,0
"Brazil","2024-01-19",0,0,130,0,5,144,0,0
"Brazil","2024-01-20",0,0,130,0,5,149,0,0
"Brazil","2024-01-21",0,0,130,0,5,154,0,0
"Brazil","2024-01-22",0,0,130,0,4,158,0,0
"Brazil","2024-01-23",0,33,163,0,5,163,0,0
"Brazil","2024-01-24",0,0,163,0,5,168,0,0
"Brazil","2024-01-25",0,0,163,0,5,173,0,0
"Brazil","2024-01-26",0,0,163,0,5,178,0,0
"Brazil","2024-01-27",0,0,163,0,4,182,0,0
"Brazil","2024-01-28",0,0,163,0,5,187,0,0
"Brazil","2024-01-29",0,0,163,0,5,192,0,0
"Brazil","2024-01-30",0,34,197,0,5,197,0,0
"Brazil","2024-01-31",0,0,197,0,4,201,0,0
"Brazil","2024-02-01",0,0,197,0,5,206,0,0
"Brazil","2024-02-02",0,0,197,0,4,210,0,0
"Brazil","2024-02-03",0,0,197,0,5,215,0,0
"Brazil","2024-02-04",0,0,197,0,4,219,0,0
"Brazil","2024-02-05",0,0,197,0,5,224,0,0
"Brazil","2024-02-06",0,31,228,0,4,228,0,0
"Brazil","2024-02-07",0,0,228,0,5,233,0,0
"Brazil","2024-02-08",0,0,228,0,4,237,0,0
"Brazil","2024-02-09",0,0,228,0,5,242,0,0
"Brazil","2024-02-10",0,0,228,0,5,247,0,0
"Brazil","2024-02-11",0,0,228,0,5,252,0,0
"Brazil","2024-02-12",0,0,228,0,4,256,0,0
"Brazil","2024-02-13",0,33,261,0,5,261,0,0
"Brazil","2024-02-14",0,0,261,0,5,266,0,0
"Brazil","2024-02-15",0,0,261,0,6,272,0,0
"Brazil","2024-02-16",0,0,261,0,5,277,0,0
"Brazil","2024-02-17",0,0,261,0,5,282,0,0
"Brazil","2024-02-18",0,0,261,0,5,287,0,0
"Brazil","2024-02-19",0,0,261,0,6,293,0,0
"Brazil","2024-02-20",0,37,298,0,5,298,0,0
"Brazil","2024-02-21",0,0,298,0,4,302,0,0
"Brazil","2024-02-22",0,0,298,0,4,306,0,0
"Brazil","2024-02-23",0,0,298,0,4,310,0,0
"Brazil","2024-02-24",0,0,298,0,3,313,0,0
"Brazil","2024-02-25",0,0,298,0,4,317,0,0
"Brazil","2024-02-26",0,0,298,0,4,321,0,0
"Brazil","2024-02-27",0,27,325,0,4,325,0,0
"Brazil","2024-02-28",0,0,325,0,3,328,0,0
"Brazil","2024-02-29",0,0,325,0,3,331,0,0
"Brazil","2024-03-01",0,0,325,0,3,334,0,0
"Brazil","2024-03-02",0,0,325,0,3,337,0,0
"Brazil","2024-03-03",0,0,325,0,3,340,0,0
"Brazil","2024-03-04",0,0,325,0,3,343,0,0
"Brazil","2024-03-05",0,21,346,0,3,346,0,0
"Brazil","2024-03-06",0,0,346,0,3,349,0,0
"Brazil","2024-03-07",0,0,346,0,3,352,0,0
"Brazil","2024-03-08",0,0,346,0,3,355,0,0
"Brazil","2024-03-09",0,0,346,0,4,359,0,0
"Brazil","2024-03-10",0,0,346,0,3,362,0,0
"Brazil","2024-03-11",0,0,346,0,3,365,0,0
"Brazil","2024-03-12",0,22,368,0,3,368,0,0
"Brazil","2024-03-13",0,0,368,0,3,371,0,0
"Brazil","2024-03-14",0,0,368,0,3,374,0,0
"Brazil","2024-03-15",0,0,368,0,3,377,0,0
"Brazil","2024-03-16",0,0,368,0,4,381,0,0
"Brazil","2024-03-17",0,0,368,0,3,384,0,0
"Brazil","2024-03-18",0,0,368,0,3,387,0,0
"Brazil","2024-03-19",0,22,390,0,3,390,0,0
"Brazil","2024-03-20",0,0,390,0,3,393,0,0
"Brazil","2024-03-21",0,0,390,0,3,396,0,0
"Brazil","2024-03-22",0,0,390,0,3,399,0,0
"Brazil","2024-03-23",0,0,390,0,4,403,0,0
"Brazil","2024-03-24",0,0,390,0,3,406,0,0
"Brazil","2024-03-25",0,0,390,0,3,409,0,0
"Brazil","2024-03-26",0,22,412,0,3,412,0,0
"Brazil","2024-03-27",0,0,412,0,4,416,0,0
"Brazil","2024-03-28",0,0,412,0,3,419,0,0
"Brazil","2024-03-29",0,0,412,0,4,423,0,0
"Brazil","2024-03-30",0,0,412,0,3,426,0,0
"Brazil","2024-03-31",0,0,412,0,4,430,0,0
"Brazil","2024-04-01",0,0,412,0,3,433,0,0
"Brazil","2024-04-02",0,25,437,0,4,437,0,0
"Brazil","2024-04-03",0,0,437,0,3,440,0,0
"Brazil","2024-04-04",0,0,437,0,2,442,0,0
"Brazil","2024-04-05",0,0,437,0,3,445,0,0
"Brazil","2024-04-06",0,0,437,0,2,447,0,0
"Brazil","2024-04-07",0,0,437,0,3,450,0,0
"Brazil","2024-04-08",0,0,437,0,2,452,0,0
"Brazil","2024-04-09",0,18,455,0,3,455,0,0
"Brazil","2024-04-10",0,0,455,0,2,457,0,0
"Brazil","2024-04-11",0,0,455,0,1,458,0,0
"Brazil","2024-04-12",0,0,455,0,2,460,0,0
"Brazil","2024-04-13",0,0,455,0,1,461,0,0
"Brazil","2024-04-14",0,0,455,0,2,463,0,0
"Brazil","2024-04-15",0,0,455,0,1,464,0,0
"Brazil","2024-04-16",0,11,466,0,2,466,0,0
"Brazil","2024-04-17",0,0,466,0,3,469,0,0
"Brazil","2024-04-18",0,0,466,0,2,471,0,0
"Brazil","2024-04-19",0,0,466,0,3,474,0,0
"Brazil","2024-04-20",0,0,466,0,3,477,0,0
"Brazil","2024-04-21",0,0,466,0,3,480,0,0
"Brazil","2024-04-22",0,0,466,0,2,482,0,0
"Brazil","2024-04-23",0,19,485,0,3,485,0,0
"Brazil","2024-04-24",0,0,485,0,3,488,0,0
"Brazil","2024-04-25",0,0,485,0,3,491,0,0
"Brazil","2024-04-26",0,0,485,0,3,494,0,0
"Brazil","2024-04-27",0,0,485,0,2,496,0,0
"Brazil","2024-04-28",0,0,485,0,3,499,0,0
"Brazil","2024-04-29",0,0,485,0,3,502,0,0
"Brazil","2024-04-30",0,20,505,0,3,505,0,0
"Brazil","2024-05-01",0,0,505,0,2,507,0,0
"Brazil","2024-05-02",0,0,505,0,3,510,0,0
"Brazil","2024-05-03",0,0,505,0,2,512,0,0
"Brazil","2024-05-04",0,0,505,0,3,515,0,0
"Brazil","2024-05-05",0,0,505,0,2,517,0,0
"Brazil","2024-05-06",0,0,505,0,3,520,0,0
"Brazil","2024-05-07",0,17,522,0,2,522,0,0
"Brazil","2024-05-08",0,0,522,0,3,525,0,0
"Brazil","2024-05-09",0,0,522,0,2,527,0,0
"Brazil","2024-05-10",0,0,522,0,3,530,0,0
"Brazil","2024-05-11",0,0,522,0,2,532,0,0
"Brazil","2024-05-12",0,0,522,0,3,535,0,0
"Brazil","2024-05-13",0,0,522,0,2,537,0,0
"Brazil","2024-05-14",0,18,540,0,3,540,0,0
"Brazil","2024-05-15",0,0,540,0,1,541,0,0
"Brazil","2024-05-16",0,0,540,0,1,542,0,0
"Brazil","2024-05-17",0,0,540,0,1,543,0,0
"Brazil","2024-05-18",0,0,540,0,1,544,0,0
"Brazil","2024-05-19",0,0,540,0,1,545,0,0
"Brazil","2024-05-20",0,0,540,0,1,546,0,0
"Brazil","2024-05-21",0,7,547,0,1,547,0,0
"Brazil","2024-05-22",0,0,547,0,2,549,0,0
"Brazil","2024-05-23",0,0,547,0,2,551,0,0
"Brazil","2024-05-24",0,0,547,0,2,553,0,0
"Brazil","2024-05-25",0,0,547,0,3,556,0,0
"Brazil","2024-05-26",0,0,547,0,2,558,0,0
"Brazil","2024-05-27",0,0,547,0,2,560,0,0
"Brazil","2024-05-28",0,15,562,0,2,562,0,0
"Brazil","2024-05-29",0,0,562,0,2,564,0,0
"Brazil","2024-05-30",0,0,562,0,2,566,0,0
"Brazil","2024-05-31",0,0,562,0,2,568,0,0
"Brazil","2024-06-01",0,0,562,0,1,569,0,0
"Brazil","2024-06-02",0,0,562,0,2,571,0,0
"Brazil","2024-06-03",0,0,562,0,2,573,0,0
"Brazil","2024-06-04",0,13,575,0,2,575,0,0
"Brazil","2024-06-05",0,0,575,0,1,576,0,0
"Brazil","2024-06-06",0,0,575,0,1,577,0,0
"Brazil","2024-06-07",0,0,575,0,1,578,0,0
"Brazil","2024-06-08",0,0,575,0,2,580,0,0
"Brazil","2024-06-09",0,0,575,0,1,581,0,0
"Brazil","2024-06-10",0,0,575,0,1,582,0,0
"Brazil","2024-06-11",0,8,583,0,1,583,0,0
"Brazil","2024-06-12",0,0,583,0,1,584,0,0
"Brazil","2024-06-13",0,0,583,0,1,585,0,0
"Brazil","2024-06-14",0,0,583,0,1,586,0,0
"Brazil","2024-06-15",0,0,583,0,1,587,0,0
"Brazil","2024-06-16",0,0,583,0,1,588,0,0
"Brazil","2024-06-17",0,0,583,0,1,589,0,0
"Brazil","2024-06-18",0,7,590,0,1,590,0,0
"Brazil","2024-06-19",0,0,590,0,2,592,0,0
"Brazil","2024-06-20",0,0,590,0,2,594,0,0
"Brazil","2024-06-21",0,0,590,0,2,596,0,0
"Brazil","2024-06-22",0,0,590,0,3,599,0,0
"Brazil","2024-06-23",0,0,590,0,2,601,0,0
"Brazil","2024-06-24",0,0,590,0,2,603,0,0
"Brazil","2024-06-25",0,15,605,0,2,605,0,0
"Brazil","2024-06-26",0,0,605,0,2,607,0,0
"Brazil","2024-06-27",0,0,605,0,2,609,0,0
"Brazil","2024-06-28",0,0,605,0,2,611,0,0
"Brazil","2024-06-29",0,0,605,0,3,614,0,0
"Brazil","2024-06-30",0,0,605,0,2,616,0,0
"Brazil","2024-07-01",0,0,605,0,2,618,0,0
"Brazil","2024-07-02",0,15,620,0,2,620,0,0
"Brazil","2024-07-03",0,0,620,0,3,623,0,0
"Brazil","2024-07-04",0,0,620,0,3,626,0,0
"Brazil","2024-07-05",0,0,620,0,3,629,0,0
"Brazil","2024-07-06",0,0,620,0,4,633,0,0
"Brazil","2024-07-07",0,0,620,0,3,636,0,0
"Brazil","2024-07-08",0,0,620,0,3,639,0,0
"Brazil","2024-07-09",0,22,642,0,3,642,0,0
"Brazil","2024-07-10",0,0,642,0,4,646,0,0
"Brazil","2024-07-11",0,0,642,0,3,649,0,0
"Brazil","2024-07-12",0,0,642,0,4,653,0,0
"Brazil","2024-07-13",0,0,642,0,3,656,0,0
"Brazil","2024-07-14",0,0,642,0,4,660,0,0
"Brazil","2024-07-15",0,0,642,0,3,663,0,0
"Brazil","2024-07-16",0,25,667,0,4,667,0,0
"Brazil","2024-07-17",0,0,667,0,5,672,0,0
"Brazil","2024-07-18",0,0,667,0,4,676,0,0
"Brazil","2024-07-19",0,0,667,0,5,681,0,0
"Brazil","2024-07-20",0,0,667,0,4,685,0,0
"Brazil","2024-07-21",0,0,667,0,5,690,0,0
"Brazil","2024-07-22",0,0,667,0,4,694,0,0
"Brazil","2024-07-23",0,32,699,0,5,699,0,0
"Brazil","2024-07-24",0,0,699,0,5,704,0,0
"Brazil","2024-07-25",0,0,699,0,5,709,0,0
"Brazil","2024-07-26",0,0,699,0,5,714,0,0
"Brazil","2024-07-27",0,0,699,0,5,719,0,0
"Brazil","2024-07-28",0,0,699,0,5,724,0,0
"Brazil","2024-07-29",0,0,699,0,5,729,0,0
"Brazil","2024-07-30",0,35,734,0,5,734,0,0
"Brazil","2024-07-31",0,0,734,0,8,742,0,0
"Brazil","2024-08-01",0,0,734,0,9,751,0,0
"Brazil","2024-08-02",0,0,734,0,8,759,0,0
"Brazil","2024-08-03",0,0,734,0,8,767,0,0
"Brazil","2024-08-04",0,0,734,0,8,775,0,0
"Brazil","2024-08-05",0,0,734,0,9,784,0,0
"Brazil","2024-08-06",0,58,792,0,8,792,0,0
"Brazil","2024-08-07",0,0,792,0,9,801,0,0
"Brazil","2024-08-08",0,0,792,0,10,811,0,0
"Brazil","2024-08-09",0,0,792,0,9,820,0,0
"Brazil","2024-08-10",0,0,792,0,9,829,0,0
"Brazil","2024-08-11",0,0,792,0,9,838,0,0
"Brazil","2024-08-12",0,0,792,0,10,848,0,0
"Brazil","2024-08-13",0,65,857,0,9,857,0,0
"Brazil","2024-08-14",0,0,857,0,12,869,0,0
"Brazil","2024-08-15",0,0,857,0,13,882,0,0
"Brazil","2024-08-16",0,0,857,0,12,894,0,0
"Brazil","2024-08-17",0,0,857,0,12,906,0,0
"Brazil","2024-08-18",0,0,857,0,12,918,0,0
"Brazil","2024-08-19",0,0,857,0,13,931,0,0
"Brazil","2024-08-20",0,86,943,0,12,943,0,0
"Brazil","2024-08-21",0,0,943,0,12,955,0,0
"Brazil","2024-08-22",0,0,943,0,11,966,0,0
"Brazil","2024-08-23",0,0,943,0,12,978,0,0
"Brazil","2024-08-24",0,0,943,0,11,989,0,0
"Brazil","2024-08-25",0,0,943,0,12,1001,0,0
"Brazil","2024-08-26",0,0,943,0,11,1012,0,0
"Brazil","2024-08-27",0,81,1024,0,12,1024,0,0
"Brazil","2024-08-28",0,0,1024,0,13,1037,0,0
"Brazil","2024-08-29",0,0,1024,0,12,1049,0,0
"Brazil","2024-08-30",0,0,1024,0,13,1062,0,0
"Brazil","2024-08-31",0,0,1024,0,13,1075,0,0
"Brazil","2024-09-01",0,0,1024,0,13,1088,0,0
"Brazil","2024-09-02",0,0,1024,0,12,1100,0,0
"Brazil","2024-09-03",0,89,1113,0,13,1113,0,0
"Brazil","2024-09-04",0,0,1113,0,9,1122,0,0
"Brazil","2024-09-05",0,0,1113,0,8,1130,0,0
"Brazil","2024-09-06",0,0,1113,0,9,1139,0,0
"Brazil","2024-09-07",0,0,1113,0,8,1147,0,0
"Brazil","2024-09-08",0,0,1113,0,9,1156,0,0
"Brazil","2024-09-09",0,0,1113,0,8,1164,0,0
"Brazil","2024-09-10",0,60,1173,0,9,1173,0,0
"Brazil","2024-09-11",0,0,1173,0,9,1182,0,0
"Brazil","2024-09-12",0,0,1173,0,8,1190,0,0
"Brazil","2024-09-13",0,0,1173,0,9,1199,0,0
"Brazil","2024-09-14",0,0,1173,0,8,1207,0,0
"Brazil","2024-09-15",0,0,1173,0,9,1216,0,0
"Brazil","2024-09-16",0,0,1173,0,8,1224,0,0
"Brazil","2024-09-17",0,60,1233,0,9,1233,0,0
"Brazil","2024-09-18",0,0,1233,0,9,1242,0,0
"Brazil","2024-09-19",0,0,1233,0,8,1250,0,0
"Brazil","2024-09-20",0,0,1233,0,9,1259,0,0
"Brazil","2024-09-21",0,0,1233,0,9,1268,0,0
"Brazil","2024-09-22",0,0,1233,0,9,1277,0,0
"Brazil","2024-09-23",0,0,1233,0,8,1285,0,0
"Brazil","2024-09-24",0,61,1294,0,9,1294,0,0
"Brazil","2024-09-25",0,0,1294,0,11,1305,0,0
"Brazil","2024-09-26",0,0,1294,0,12,1317,0,0
"Brazil","2024-09-27",0,0,1294,0,11,1328,0,0
"Brazil","2024-09-28",0,0,1294,0,11,1339,0,0
"Brazil","2024-09-29",0,0,1294,0,11,1350,0,0
"Brazil","2024-09-30",0,0,1294,0,12,1362,0,0
"Brazil","2024-10-01",0,79,1373,0,11,1373,0,0
"Brazil","2024-10-02",0,0,1373,0,10,1383,0,0
"Brazil","2024-10-03",0,0,1373,0,11,1394,0,0
"Brazil","2024-10-04",0,0,1373,0,10,1404,0,0
"Brazil","2024-10-05",0,0,1373,0,10,1414,0,0
"Brazil","2024-10-06",0,0,1373,0,10,1424,0,0
"Brazil","2024-10-07",0,0,1373,0,11,1435,0,0
"Brazil","2024-10-08",0,72,1445,0,10,1445,0,0
"Brazil","2024-10-09",0,0,1445,0,9,1454,0,0
"Brazil","2024-10-10",0,0,1445,0,8,1462,0,0
"Brazil","2024-10-11",0,0,1445,0,9,1471,0,0
"Brazil","2024-10-12",0,0,1445,0,8,1479,0,0
"Brazil","2024-10-13",0,0,1445,0,9,1488,0,0
"Brazil","2024-10-14",0,0,1445,0,8,1496,0,0
"Brazil","2024-10-15",0,60,1505,0,9,1505,0,0
"Brazil","2024-10-16",0,0,1505,0,10,1515,0,0
"Brazil","2024-10-17",0,0,1505,0,11,1526,0,0
"Brazil","2024-10-18",0,0,1505,0,10,1536,0,0
"Brazil","2024-10-19",0,0,1505,0,10,1546,0,0
"Brazil","2024-10-20",0,0,1505,0,10,1556,0,0
"Brazil","2024-10-21",0,0,1505,0,11,1567,0,0
"Brazil","2024-10-22",0,72,1577,0,10,1577,0,0
"Brazil","2024-10-23",0,0,1577,0,8,1585,0,0
"Brazil","2024-10-24",0,0,1577,0,9,1594,0,0
"Brazil","2024-10-25",0,0,1577,0,8,1602,0,0
"Brazil","2024-10-26",0,0,1577,0,8,1610,0,0
"Brazil","2024-10-27",0,0,1577,0,8,1618,0,0
"Brazil","2024-10-28",0,0,1577,0,9,1627,0,0
"Brazil","2024-10-29",0,58,1635,0,8,1635,0,0
"Brazil","2024-10-30",0,0,1635,0,9,1644,0,0
"Brazil","2024-10-31",0,0,1635,0,10,1654,0,0
"Brazil","2024-11-01",0,0,1635,0,9,1663,0,0
"Brazil","2024-11-02",0,0,1635,0,10,1673,0,0
"Brazil","2024-11-03",0,0,1635,0,9,1682,0,0
"Brazil","2024-11-04",0,0,1635,0,10,1692,0,0
"Brazil","2024-11-05",0,66,1701,0,9,1701,0,0
"Brazil","2024-11-06",0,0,1701,0,6,1707,0,0
"Brazil","2024-11-07",0,0,1701,0,6,1713,0,0
"Brazil","2024-11-08",0,0,1701,0,6,1719,0,0
"Brazil","2024-11-09",0,0,1701,0,7,1726,0,0
"Brazil","2024-11-10",0,0,1701,0,6,1732,0,0
"Brazil","2024-11-11",0,0,1701,0,6,1738,0,0
"Brazil","2024-11-12",0,43,1744,0,6,1744,0,0
"Brazil","2024-11-13",0,0,1744,0,8,1752,0,0
"Brazil","2024-11-14",0,0,1744,0,7,1759,0,0
"Brazil","2024-11-15",0,0,1744,0,8,1767,0,0
"Brazil","2024-11-16",0,0,1744,0,7,1774,0,0
"Brazil","2024-11-17",0,0,1744,0,8,1782,0,0
"Brazil","2024-11-18",0,0,1744,0,7,1789,0,0
"Brazil","2024-11-19",0,53,1797,0,8,1797,0,0
"Brazil","2024-11-20",0,0,1797,0,7,1804,0,0
"Brazil","2024-11-21",0,0,1797,0,7,1811,0,0
"Brazil","2024-11-22",0,0,1797,0,7,1818,0,0
"Brazil","2024-11-23",0,0,1797,0,6,1824,0,0
"Brazil","2024-11-24",0,0,1797,0,7,1831,0,0
"Brazil","2024-11-25",0,0,1797,0,7,1838,0,0
"Brazil","2024-11-26",0,48,1845,0,7,1845,0,0
"Brazil","2024-11-27",0,0,1845,0,6,1851,0,0
"Brazil","2024-11-28",0,0,1845,0,5,1856,0,0
"Brazil","2024-11-29",0,0,1845,0,6,1862,0,0
"Brazil","2024-11-30",0,0,1845,0,6,1868,0,0
"Brazil","2024-12-01",0,0,1845,0,6,1874,0,0
"Brazil","2024-12-02",0,0,1845,0,5,1879,0,0
"Brazil","2024-12-03",0,40,1885,0,6,1885,0,0
"Brazil","2024-12-04",0,0,1885,0,3,1888,0,0
"Brazil","2024-12-05",0,0,1885,0,4,1892,0,0
"Brazil","2024-12-06",0,0,1885,0,3,1895,0,0
"Brazil","2024-12-07",0,0,1885,0,4,1899,0,0
"Brazil","2024-12-08",0,0,1885,0,3,1902,0,0
"Brazil","2024-12-09",0,0,1885,0,4,1906,0,0
"Brazil","2024-12-10",0,24,1909,0,3,1909,0,0
"Brazil","2024-12-11",0,0,1909,0,3,1912,0,0
"Brazil","2024-12-12",0,0,1909,0,2,1914,0,0
"Brazil","2024-12-13",0,0,1909,0,3,1917,0,0
"Brazil","2024-12-14",0,0,1909,0,2,1919,0,0
"Brazil","2024-12-15",0,0,1909,0,3,1922,0,0
"Brazil","2024-12-16",0,0,1909,0,2,1924,0,0
"Brazil","2024-12-17",0,18,1927,0,3,1927,0,0
"Brazil","2024-12-18",0,0,1927,0,1,1928,0,0
"Brazil","2024-12-19",0,0,1927,0,0,1928,0,0
"Brazil","2024-12-20",0,0,1927,0,1,1929,0,0
"Brazil","2024-12-21",0,0,1927,0,1,1930,0,0
"Brazil","2024-12-22",0,0,1927,0,1,1931,0,0
"Brazil","2024-12-23",0,0,1927,0,0,1931,0,0
"Brazil","2024-12-24",0,5,1932,0,1,1932,0,0
"Brazil","2024-12-25",0,0,1932,0,0,1932,0,0
"Brazil","2024-12-26",0,0,1932,0,0,1932,0,0
"Brazil","2024-12-27",0,0,1932,0,0,1932,0,0
"Brazil","2024-12-28",0,0,1932,0,1,1933,0,0
"Brazil","2024-12-29",0,0,1932,0,0,1933,0,0
"Brazil","2024-12-30",0,0,1932,0,0,1933,0,0
"Brazil","2024-12-31",0,1,1933,0,0,1933,0,0
"Brazil","2025-01-01",0,0,1933,0,0,1933,0,0
"Brazil","2025-01-02",0,0,1933,0,0,1933,0,0
"Brazil","2025-01-03",0,0,1933,0,0,1933,0,0
"Brazil","2025-01-04",0,0,1933,0,0,1933,0,0
"Brazil","2025-01-05",0,0,1933,0,0,1933,0,0
"Brazil","2025-01-06",0,0,1933,0,0,1933,0,0
"Brazil","2025-01-07",0,0,1933,0,0,1933,0,0
"Brazil","2025-01-08",0,0,1933,0,0,1933,0,0
"Brazil","2025-01-09",0,0,1933,0,0,1933,0,0
"Brazil","2025-01-10",0,0,1933,0,0,1933,0,0
"Brazil","2025-01-11",0,0,1933,0,0,1933,0,0
"Brazil","2025-01-12",0,0,1933,0,0,1933,0,0
"Brazil","2025-01-13",0,0,1933,0,0,1933,0,0
"Brazil","2025-01-14",0,0,1933,0,0,1933,0,0
"Brazil","2025-01-15",0,0,1933,0,0,1933,0,0
"Brazil","2025-01-16",0,0,1933,0,0,1933,0,0
"Brazil","2025-01-17",0,0,1933,0,0,1933,0,0
"Brazil","2025-01-18",0,0,1933,0,0,1933,0,0
"Brazil","2025-01-19",0,0,1933,0,0,1933,0,0
"Brazil","2025-01-20",0,0,1933,0,0,1933,0,0
"Brazil","2025-01-21",0,0,1933,0,0,1933,0,0
"Brazil","2025-01-22",0,0,1933,0,0,1933,0,0
"Brazil","2025-01-23",0,0,1933,0,0,1933,0,0
"Brazil","2025-01-24",0,0,1933,0,0,1933,0,0
"Brazil","2025-01-25",0,0,1933,0,0,1933,0,0
"Brazil","2025-01-26",0,0,1933,0,0,1933,0,0
"Brazil","2025-01-27",0,0,1933,0,0,1933,0,0
"Brazil","2025-01-28",0,0,1933,0,0,1933,0,0
"Brazil","2025-01-29",0,0,1933,0,0,1933,0,0
"Brazil","2025-01-30",0,0,1933,0,0,1933,0,0
"Brazil","2025-01-31",0,0,1933,0,0,1933,0,0
"Brazil","2025-02-01",0,0,1933,0,0,1933,0,0
"Brazil","2025-02-02",0,0,1933,0,0,1933,0,0
"Brazil","2025-02-03",0,0,1933,0,0,1933,0,0
"Bulgaria","2024-01-01",0,0,0,0,0,0,0,0
"Bulgaria","2024-01-02",0,0,0,0,0,0,0,0
"Bulgaria","2024-01-03",0,0,0,0,0,0,0,0
"Bulgaria","2024-01-04",0,0,0,0,0,0,0,0
"Bulgaria","2024-01-05",0,0,0,0,0,0,0,0
"Bulgaria","2024-01-06",0,0,0,0,0,0,0,0
"Bulgaria","2024-01-07",0,0,0,0,0,0,0,0
"Bulgaria","2024-01-08",0,0,0,0,0,0,0,0
"Bulgaria","2024-01-09",0,0,0,0,0,0,0,0
"Bulgaria","2024-01-10",0,0,0,0,0,0,0,0
"Bulgaria","2024-01-11",0,0,0,0,0,0,0,0
"Bulgaria","2024-01-12",0,0,0,0,0,0,0,0
"Bulgaria","2024-01-13",0,0,0,0,0,0,0,0
"Bulgaria","2024-01-14",0,0,0,0,0,0,0,0
"Bulgaria","2024-01-15",0,0,0,0,0,0,0,0
"Bulgaria","2024-01-16",0,0,0,0,0,0,0,0
"Bulgaria","2024-01-17",0,0,0,0,0,0,0,0
"Bulgaria","2024-01-18",0,0,0,0,0,0,0,0
"Bulgaria","2024-01-19",0,0,0,0,0,0,0,0
"Bulgaria","2024-01-20",0,0,0,0,0,0,0,0
"Bulgaria","2024-01-21",0,0,0,0,0,0,0,0
"Bulgaria","2024-01-22",0,0,0,0,0,0,0,0
"Bulgaria","2024-01-23",0,0,0,0,0,0,0,0
"Bulgaria","2024-01-24",0,0,0,0,0,0,0,0
"Bulgaria","2024-01-25",0,0,0,0,0,0,0,0
"Bulgaria","2024-01-26",0,0,0,0,0,0,0,0
"Bulgaria","2024-01-27",0,0,0,0,0,0,0,0
"Bulgaria","2024-01-28",0,0,0,0,0,0,0,0
"Bulgaria","2024-01-29",0,0,0,0,0,0,0,0
"Bulgaria","2024-01-30",0,0,0,0,0,0,0,0
"Bulgaria","2024-01-31",0,0,0,0,0,0,0,0
"Bulgaria","2024-02-01",0,0,0,0,0,0,0,0
"Bulgaria","2024-02-02",0,0,0,0,0,0,0,0
"Bulgaria","2024-02-03",0,0,0,0,0,0,0,0
"Bulgaria","2024-02-04",0,0,0,0,0,0,0,0
"Bulgaria","2024-02-05",0,0,0,0,0,0,0,0
"Bulgaria","2024-02-06",0,0,0,0,0,0,0,0
"Bulgaria","2024-02-07",0,0,0,0,0,0,0,0
"Bulgaria","2024-02-08",0,0,0,0,0,0,0,0
"Bulgaria","2024-02-09",0,0,0,0,0,0,0,0
"Bulgaria","2024-02-10",0,0,0,0,0,0,0,0
"Bulgaria","2024-02-11",0,0,0,0,0,0,0,0
"Bulgaria","2024-02-12",0,0,0,0,0,0,0,0
"Bulgaria","2024-02-13",0,0,0,0,0,0,0,0
"Bulgaria","2024-02-14",0,0,0,0,0,0,0,0
"Bulgaria","2024-02-15",0,0,0,0,0,0,0,0
"Bulgaria","2024-02-16",0,0,0,0,0,0,0,0
"Bulgaria","2024-02-17",0,0,0,0,0,0,0,0
"Bulgaria","2024-02-18",0,0,0,0,0,0,0,0
"Bulgaria","2024-02-19",0,0,0,0,0,0,0,0
"Bulgaria","2024-02-20",0,0,0,0,0,0,0,0
"Bulgaria","2024-02-21",0,0,0,0,0,0,0,0
"Bulgaria","2024-02-22",0,0,0,0,0,0,0,0
"Bulgaria","2024-02-23",0,0,0,0,0,0,0,0
"Bulgaria","2024-02-24",0,0,0,0,0,0,0,0
"Bulgaria","2024-02-25",0,0,0,0,0,0,0,0
"Bulgaria","2024-02-26",0,0,0,0,0,0,0,0
"Bulgaria","2024-02-27",0,0,0,0,0,0,0,0
"Bulgaria","2024-02-28",0,0,0,0,0,0,0,0
"Bulgaria","2024-02-29",0,0,0,0,0,0,0,0
"Bulgaria","2024-03-01",0,0,0,0,0,0,0,0
"Bulgaria","2024-03-02",0,0,0,0,0,0,0,0
"Bulgaria","2024-03-03",0,0,0,0,0,0,0,0
"Bulgaria","2024-03-04",0,0,0,0,0,0,0,0
"Bulgaria","2024-03-05",0,0,0,0,0,0,0,0
"Bulgaria","2024-03-06",0,0,0,0,0,0,0,0
"Bulgaria","2024-03-07",0,0,0,0,0,0,0,0
"Bulgaria","2024-03-08",0,0,0,0,0,0,0,0
"Bulgaria","2024-03-09",0,0,0,0,0,0,0,0
"Bulgaria","2024-03-10",0,0,0,0,0,0,0,0
"Bulgaria","2024-03-11",0,0,0,0,0,0,0,0
"Bulgaria","2024-03-12",0,0,0,0,0,0,0,0
"Bulgaria","2024-03-13",0,0,0,0,0,0,0,0
"Bulgaria","2024-03-14",0,0,0,0,0,0,0,0
"Bulgaria","2024-03-15",0,0,0,0,0,0,0,0
"Bulgaria","2024-03-16",0,0,0,0,0,0,0,0
"Bulgaria","2024-03-17",0,0,0,0,0,0,0,0
"Bulgaria","2024-03-18",0,0,0,0,0,0,0,0
"Bulgaria","2024-03-19",0,0,0,0,0,0,0,0
"Bulgaria","2024-03-20",0,0,0,0,0,0,0,0
"Bulgaria","2024-03-21",0,0,0,0,0,0,0,0
"Bulgaria","2024-03-22",0,0,0,0,0,0,0,0
"Bulgaria","2024-03-23",0,0,0,0,0,0,0,0
"Bulgaria","2024-03-24",0,0,0,0,0,0,0,0
"Bulgaria","2024-03-25",0,0,0,0,0,0,0,0
"Bulgaria","2024-03-26",0,0,0,0,0,0,0,0
"Bulgaria","2024-03-27",0,0,0,0,0,0,0,0
"Bulgaria","2024-03-28",0,0,0,0,0,0,0,0
"Bulgaria","2024-03-29",0,0,0,0,0,0,0,0
"Bulgaria","2024-03-30",0,0,0,0,0,0,0,0
"Bulgaria","2024-03-31",0,0,0,0,0,0,0,0
"Bulgaria","2024-04-01",0,0,0,0,0,0,0,0
"Bulgaria","2024-04-02",0,0,0,0,0,0,0,0
"Bulgaria","2024-04-03",0,0,0,0,0,0,0,0
"Bulgaria","2024-04-04",0,0,0,0,0,0,0,0
"Bulgaria","2024-04-05",0,0,0,0,0,0,0,0
"Bulgaria","2024-04-06",0,0,0,0,0,0,0,0
"Bulgaria","2024-04-07",0,0,0,0,0,0,0,0
"Bulgaria","2024-04-08",0,0,0,0,0,0,0,0
"Bulgaria","2024-04-09",0,0,0,0,0,0,0,0
"Bulgaria","2024-04-10",0,0,0,0,0,0,0,0
"Bulgaria","2024-04-11",0,0,0,0,0,0,0,0
"Bulgaria","2024-04-12",0,0,0,0,0,0,0,0
"Bulgaria","2024-04-13",0,0,0,0,0,0,0,0
"Bulgaria","2024-04-14",0,0,0,0,0,0,0,0
"Bulgaria","2024-04-15",0,0,0,0,0,0,0,0
"Bulgaria","2024-04-16",0,0,0,0,0,0,0,0
"Bulgaria","2024-04-17",0,0,0,0,0,0,0,0
"Bulgaria","2024-04-18",0,0,0,0,0,0,0,0
"Bulgaria","2024-04-19",0,0,0,0,0,0,0,0
"Bulgaria","2024-04-20",0,0,0,0,0,0,0,0
"Bulgaria","2024-04-21",0,0,0,0,0,0,0,0
"Bulgaria","2024-04-22",0,0,0,0,0,0,0,0
"Bulgaria","2024-04-23",0,0,0,0,0,0,0,0
"Bulgaria","2024-04-24",0,0,0,0,0,0,0,0
"Bulgaria","2024-04-25",0,0,0,0,0,0,0,0
"Bulgaria","2024-04-26",0,0,0,0,0,0,0,0
"Bulgaria","2024-04-27",0,0,0,0,0,0,0,0
"Bulgaria","2024-04-28",0,0,0,0,0,0,0,0
"Bulgaria","2024-04-29",0,0,0,0,0,0,0,0
"Bulgaria","2024-04-30",0,0,0,0,0,0,0,0
"Bulgaria","2024-05-01",0,0,0,0,0,0,0,0
"Bulgaria","2024-05-02",0,0,0,0,0,0,0,0
"Bulgaria","2024-05-03",0,0,0,0,0,0,0,0
"Bulgaria","2024-05-04",0,0,0,0,0,0,0,0
"Bulgaria","2024-05-05",0,0,0,0,0,0,0,0
"Bulgaria","2024-05-06",0,0,0,0,0,0,0,0
"Bulgaria","2024-05-07",0,0,0,0,0,0,0,0
"Bulgaria","2024-05-08",0,0,0,0,0,0,0,0
"Bulgaria","2024-05-09",0,0,0,0,0,0,0,0
"Bulgaria","2024-05-10",0,0,0,0,0,0,0,0
"Bulgaria","2024-05-11",0,0,0,0,0,0,0,0
"Bulgaria","2024-05-12",0,0,0,0,0,0,0,0
"Bulgaria","2024-05-13",0,0,0,0,0,0,0,0
"Bulgaria","2024-05-14",0,0,0,0,0,0,0,0
"Bulgaria","2024-05-15",0,0,0,0,0,0,0,0
"Bulgaria","2024-05-16",0,0,0,0,0,0,0,0
"Bulgaria","2024-05-17",0,0,0,0,0,0,0,0
"Bulgaria","2024-05-18",0,0,0,0,0,0,0,0
"Bulgaria","2024-05-19",0,0,0,0,0,0,0,0
"Bulgaria","2024-05-20",0,0,0,0,0,0,0,0
"Bulgaria","2024-05-21",0,0,0,0,0,0,0,0
"Bulgaria","2024-05-22",0,0,0,0,0,0,0,0
"Bulgaria","2024-05-23",0,0,0,0,0,0,0,0
"Bulgaria","2024-05-24",0,0,0,0,0,0,0,0
"Bulgaria","2024-05-25",0,0,0,0,0,0,0,0
"Bulgaria","2024-05-26",0,0,0,0,0,0,0,0
"Bulgaria","2024-05-27",0,0,0,0,0,0,0,0
"Bulgaria","2024-05-28",0,0,0,0,0,0,0,0
"Bulgaria","2024-05-29",0,0,0,0,0,0,0,0
"Bulgaria","2024-05-30",0,0,0,0,0,0,0,0
"Bulgaria","2024-05-31",0,1,1,0,1,1,0,0
"Bulgaria","2024-06-01",0,0,1,0,0,1,0,0
"Bulgaria","2024-06-02",0,0,1,0,0,1,0,0
"Bulgaria","2024-06-03",0,0,1,0,0,1,0,0
"Bulgaria","2024-06-04",0,0,1,0,0,1,0,0
"Bulgaria","2024-06-05",0,0,1,0,0,1,0,0
"Bulgaria","2024-06-06",0,0,1,0,0,1,0,0
"Bulgaria","2024-06-07",0,0,1,0,0,1,0,0
"Bulgaria","2024-06-08",0,0,1,0,0,1,0,0
"Bulgaria","2024-06-09",0,0,1,0,0,1,0,0
"Bulgaria","2024-06-10",0,0,1,0,0,1,0,0
"Bulgaria","2024-06-11",0,0,1,0,0,1,0,0
"Bulgaria","2024-06-12",0,0,1,0,0,1,0,0
"Bulgaria","2024-06-13",0,0,1,0,0,1,0,0
"Bulgaria","2024-06-14",0,0,1,0,0,1,0,0
"Bulgaria","2024-06-15",0,0,1,0,0,1,0,0
"Bulgaria","2024-06-16",0,0,1,0,0,1,0,0
"Bulgaria","2024-06-17",0,0,1,0,0,1,0,0
"Bulgaria","2024-06-18",0,0,1,0,0,1,0,0
"Bulgaria","2024-06-19",0,0,1,0,0,1,0,0
"Bulgaria","2024-06-20",0,0,1,0,0,1,0,0
"Bulgaria","2024-06-21",0,0,1,0,0,1,0,0
"Bulgaria","2024-06-22",0,0,1,0,0,1,0,0
"Bulgaria","2024-06-23",0,0,1,0,0,1,0,0
"Bulgaria","2024-06-24",0,0,1,0,0,1,0,0
"Bulgaria","2024-06-25",0,0,1,0,0,1,0,0
"Bulgaria","2024-06-26",0,0,1,0,0,1,0,0
"Bulgaria","2024-06-27",0,0,1,0,0,1,0,0
"Bulgaria","2024-06-28",0,0,1,0,0,1,0,0
"Bulgaria","2024-06-29",0,0,1,0,0,1,0,0
"Bulgaria","2024-06-30",0,0,1,0,0,1,0,0
"Bulgaria","2024-07-01",0,0,1,0,0,1,0,0
"Bulgaria","2024-07-02",0,0,1,0,0,1,0,0
"Bulgaria","2024-07-03",0,0,1,0,0,1,0,0
"Bulgaria","2024-07-04",0,0,1,0,0,1,0,0
"Bulgaria","2024-07-05",0,0,1,0,0,1,0,0
"Bulgaria","2024-07-06",0,0,1,0,0,1,0,0
"Bulgaria","2024-07-07",0,0,1,0,0,1,0,0
"Bulgaria","2024-07-08",0,0,1,0,0,1,0,0
"Bulgaria","2024-07-09",0,0,1,0,0,1,0,0
"Bulgaria","2024-07-10",0,0,1,0,0,1,0,0
"Bulgaria","2024-07-11",0,0,1,0,0,1,0,0
"Bulgaria","2024-07-12",0,0,1,0,0,1,0,0
"Bulgaria","2024-07-13",0,0,1,0,0,1,0,0
"Bulgaria","2024-07-14",0,0,1,0,0,1,0,0
"Bulgaria","2024-07-15",0,0,1,0,0,1,0,0
"Bulgaria","2024-07-16",0,0,1,0,0,1,0,0
"Bulgaria","2024-07-17",0,0,1,0,0,1,0,0
"Bulgaria","2024-07-18",0,0,1,0,0,1,0,0
"Bulgaria","2024-07-19",0,0,1,0,0,1,0,0
"Bulgaria","2024-07-20",0,0,1,0,0,1,0,0
"Bulgaria","2024-07-21",0,0,1,0,0,1,0,0
"Bulgaria","2024-07-22",0,0,1,0,0,1,0,0
"Bulgaria","2024-07-23",0,0,1,0,0,1,0,0
"Bulgaria","2024-07-24",0,0,1,0,0,1,0,0
"Bulgaria","2024-07-25",0,0,1,0,0,1,0,0
"Bulgaria","2024-07-26",0,0,1,0,0,1,0,0
"Bulgaria","2024-07-27",0,0,1,0,0,1,0,0
"Bulgaria","2024-07-28",0,0,1,0,0,1,0,0
"Bulgaria","2024-07-29",0,0,1,0,0,1,0,0
"Bulgaria","2024-07-30",0,0,1,0,0,1,0,0
"Bulgaria","2024-07-31",0,0,1,0,0,1,0,0
"Bulgaria","2024-08-01",0,0,1,0,0,1,0,0
"Bulgaria","2024-08-02",0,0,1,0,0,1,0,0
"Bulgaria","2024-08-03",0,0,1,0,0,1,0,0
"Bulgaria","2024-08-04",0,0,1,0,0,1,0,0
"Bulgaria","2024-08-05",0,0,1,0,0,1,0,0
"Bulgaria","2024-08-06",0,0,1,0,0,1,0,0
"Bulgaria","2024-08-07",0,0,1,0,0,1,0,0
"Bulgaria","2024-08-08",0,0,1,0,0,1,0,0
"Bulgaria","2024-08-09",0,0,1,0,0,1,0,0
"Bulgaria","2024-08-10",0,0,1,0,0,1,0,0
"Bulgaria","2024-08-11",0,0,1,0,0,1,0,0
"Bulgaria","2024-08-12",0,0,1,0,0,1,0,0
"Bulgaria","2024-08-13",0,0,1,0,0,1,0,0
"Bulgaria","2024-08-14",0,0,1,0,0,1,0,0
"Bulgaria","2024-08-15",0,0,1,0,0,1,0,0
"Bulgaria","2024-08-16",0,0,1,0,0,1,0,0
"Bulgaria","2024-08-17",0,0,1,0,0,1,0,0
"Bulgaria","2024-08-18",0,0,1,0,0,1,0,0
"Bulgaria","2024-08-19",0,0,1,0,0,1,0,0
"Bulgaria","2024-08-20",0,0,1,0,0,1,0,0
"Bulgaria","2024-08-21",0,0,1,0,0,1,0,0
"Bulgaria","2024-08-22",0,0,1,0,0,1,0,0
"Bulgaria","2024-08-23",0,0,1,0,0,1,0,0
"Bulgaria","2024-08-24",0,0,1,0,0,1,0,0
"Bulgaria","2024-08-25",0,0,1,0,0,1,0,0
"Bulgaria","2024-08-26",0,0,1,0,0,1,0,0
"Bulgaria","2024-08-27",0,0,1,0,0,1,0,0
"Bulgaria","2024-08-28",0,0,1,0,0,1,0,0
"Bulgaria","2024-08-29",0,0,1,0,0,1,0,0
"Bulgaria","2024-08-30",0,0,1,0,0,1,0,0
"Bulgaria","2024-08-31",0,0,1,0,1,2,0,0
"Bulgaria","2024-09-01",0,0,1,0,0,2,0,0
"Bulgaria","2024-09-02",0,0,1,0,0,2,0,0
"Bulgaria","2024-09-03",0,0,1,0,0,2,0,0
"Bulgaria","2024-09-04",0,0,1,0,0,2,0,0
"Bulgaria","2024-09-05",0,0,1,0,0,2,0,0
"Bulgaria","2024-09-06",0,0,1,0,0,2,0,0
"Bulgaria","2024-09-07",0,0,1,0,0,2,0,0
"Bulgaria","2024-09-08",0,0,1,0,0,2,0,0
"Bulgaria","2024-09-09",0,0,1,0,0,2,0,0
"Bulgaria","2024-09-10",0,0,1,0,0,2,0,0
"Bulgaria","2024-09-11",0,0,1,0,0,2,0,0
"Bulgaria","2024-09-12",0,0,1,0,0,2,0,0
"Bulgaria","2024-09-13",0,0,1,0,0,2,0,0
"Bulgaria","2024-09-14",0,0,1,0,0,2,0,0
"Bulgaria","2024-09-15",0,0,1,0,0,2,0,0
"Bulgaria","2024-09-16",0,0,1,0,0,2,0,0
"Bulgaria","2024-09-17",0,0,1,0,0,2,0,0
"Bulgaria","2024-09-18",0,0,1,0,0,2,0,0
"Bulgaria","2024-09-19",0,0,1,0,0,2,0,0
"Bulgaria","2024-09-20",0,0,1,0,0,2,0,0
"Bulgaria","2024-09-21",0,0,1,0,0,2,0,0
"Bulgaria","2024-09-22",0,0,1,0,0,2,0,0
"Bulgaria","2024-09-23",0,0,1,0,0,2,0,0
"Bulgaria","2024-09-24",0,0,1,0,0,2,0,0
"Bulgaria","2024-09-25",0,0,1,0,0,2,0,0
"Bulgaria","2024-09-26",0,0,1,0,0,2,0,0
"Bulgaria","2024-09-27",0,0,1,0,0,2,0,0
"Bulgaria","2024-09-28",0,0,1,0,0,2,0,0
"Bulgaria","2024-09-29",0,0,1,0,0,2,0,0
"Bulgaria","2024-09-30",0,0,1,0,0,2,0,0
"Bulgaria","2024-10-01",0,0,1,0,0,2,0,0
"Bulgaria","2024-10-02",0,0,1,0,0,2,0,0
"Bulgaria","2024-10-03",0,0,1,0,0,2,0,0
"Bulgaria","2024-10-04",0,0,1,0,0,2,0,0
"Bulgaria","2024-10-05",0,0,1,0,0,2,0,0
"Bulgaria","2024-10-06",0,0,1,0,0,2,0,0
"Bulgaria","2024-10-07",0,0,1,0,0,2,0,0
"Bulgaria","2024-10-08",0,0,1,0,0,2,0,0
"Bulgaria","2024-10-09",0,0,1,0,0,2,0,0
"Bulgaria","2024-10-10",0,0,1,0,0,2,0,0
"Bulgaria","2024-10-11",0,0,1,0,0,2,0,0
"Bulgaria","2024-10-12",0,0,1,0,0,2,0,0
"Bulgaria","2024-10-13",0,0,1,0,0,2,0,0
"Bulgaria","2024-10-14",0,0,1,0,0,2,0,0
"Bulgaria","2024-10-15",0,0,1,0,0,2,0,0
"Bulgaria","2024-10-16",0,0,1,0,0,2,0,0
"Bulgaria","2024-10-17",0,0,1,0,0,2,0,0
"Bulgaria","2024-10-18",0,0,1,0,0,2,0,0
"Bulgaria","2024-10-19",0,0,1,0,0,2,0,0
"Bulgaria","2024-10-20",0,0,1,0,0,2,0,0
"Bulgaria","2024-10-21",0,0,1,0,0,2,0,0
"Bulgaria","2024-10-22",0,0,1,0,0,2,0,0
"Bulgaria","2024-10-23",0,0,1,0,0,2,0,0
"Bulgaria","2024-10-24",0,0,1,0,0,2,0,0
"Bulgaria","2024-10-25",0,0,1,0,0,2,0,0
"Bulgaria","2024-10-26",0,0,1,0,0,2,0,0
"Bulgaria","2024-10-27",0,0,1,0,0,2,0,0
"Bulgaria","2024-10-28",0,0,1,0,0,2,0,0
"Bulgaria","2024-10-29",0,0,1,0,0,2,0,0
"Bulgaria","2024-10-30",0,0,1,0,0,2,0,0
"Bulgaria","2024-10-31",0,0,1,0,0,2,0,0
"Bulgaria","2024-11-01",0,0,1,0,0,2,0,0
"Bulgaria","2024-11-02",0,0,1,0,0,2,0,0
"Bulgaria","2024-11-03",0,0,1,0,0,2,0,0
"Bulgaria","2024-11-04",0,0,1,0,0,2,0,0
"Bulgaria","2024-11-05",0,0,1,0,0,2,0,0
"Bulgaria","2024-11-06",0,0,1,0,0,2,0,0
"Bulgaria","2024-11-07",0,0,1,0,0,2,0,0
"Bulgaria","2024-11-08",0,0,1,0,0,2,0,0
"Bulgaria","2024-11-09",0,0,1,0,0,2,0,0
"Bulgaria","2024-11-10",0,0,1,0,0,2,0,0
"Bulgaria","2024-11-11",0,0,1,0,0,2,0,0
"Bulgaria","2024-11-12",0,0,1,0,0,2,0,0
"Bulgaria","2024-11-13",0,0,1,0,0,2,0,0
"Bulgaria","2024-11-14",0,0,1,0,0,2,0,0
"Bulgaria","2024-11-15",0,0,1,0,0,2,0,0
"Bulgaria","2024-11-16",0,0,1,0,0,2,0,0
"Bulgaria","2024-11-17",0,0,1,0,0,2,0,0
"Bulgaria","2024-11-18",0,0,1,0,0,2,0,0
"Bulgaria","2024-11-19",0,0,1,0,0,2,0,0
"Bulgaria","2024-11-20",0,0,1,0,0,2,0,0
"Bulgaria","2024-11-21",0,0,1,0,0,2,0,0
"Bulgaria","2024-11-22",0,0,1,0,0,2,0,0
"Bulgaria","2024-11-23",0,0,1,0,0,2,0,0
"Bulgaria","2024-11-24",0,0,1,0,0,2,0,0
"Bulgaria","2024-11-25",0,0,1,0,0,2,0,0
"Bulgaria","2024-11-26",0,0,1,0,0,2,0,0
"Bulgaria","2024-11-27",0,0,1,0,0,2,0,0
"Bulgaria","2024-11-28",0,0,1,0,0,2,0,0
"Bulgaria","2024-11-29",0,0,1,0,0,2,0,0
"Bulgaria","2024-11-30",0,1,2,0,0,2,0,0
"Bulgaria","2024-12-01",0,0,2,0,0,2,0,0
"Bulgaria","2024-12-02",0,0,2,0,0,2,0,0
"Bulgaria","2024-12-03",0,0,2,0,0,2,0,0
"Bulgaria","2024-12-04",0,0,2,0,0,2,0,0
"Bulgaria","2024-12-05",0,0,2,0,0,2,0,0
"Bulgaria","2024-12-06",0,0,2,0,0,2,0,0
"Bulgaria","2024-12-07",0,0,2,0,0,2,0,0
"Bulgaria","2024-12-08",0,0,2,0,1,3,0,0
"Bulgaria","2024-12-09",0,0,2,0,0,3,0,0
"Bulgaria","2024-12-10",0,0,2,0,0,3,0,0
"Bulgaria","2024-12-11",0,0,2,0,0,3,0,0
"Bulgaria","2024-12-12",0,0,2,0,0,3,0,0
"Bulgaria","2024-12-13",0,0,2,0,0,3,0,0
"Bulgaria","2024-12-14",0,0,2,0,0,3,0,0
"Bulgaria","2024-12-15",0,0,2,0,0,3,0,0
"Bulgaria","2024-12-16",0,0,2,0,0,3,0,0
"Bulgaria","2024-12-17",0,0,2,0,0,3,0,0
"Bulgaria","2024-12-18",0,0,2,0,0,3,0,0
"Bulgaria","2024-12-19",0,0,2,0,0,3,0,0
"Bulgaria","2024-12-20",0,0,2,0,0,3,0,0
"Bulgaria","2024-12-21",0,0,2,0,0,3,0,0
"Bulgaria","2024-12-22",0,0,2,0,0,3,0,0
"Bulgaria","2024-12-23",0,0,2,0,0,3,0,0
"Bulgaria","2024-12-24",0,0,2,0,1,4,0,0
"Bulgaria","2024-12-25",0,0,2,0,0,4,0,0
"Bulgaria","2024-12-26",0,0,2,0,0,4,0,0
"Bulgaria","2024-12-27",0,0,2,0,0,4,0,0
"Bulgaria","2024-12-28",0,0,2,0,0,4,0,0
"Bulgaria","2024-12-29",0,0,2,0,0,4,0,0
"Bulgaria","2024-12-30",0,0,2,0,0,4,0,0
"Bulgaria","2024-12-31",0,2,4,0,0,4,0,0
"Bulgaria","2025-01-01",0,0,4,0,0,4,0,0
"Bulgaria","2025-01-02",0,0,4,0,0,4,0,0
"Bulgaria","2025-01-03",0,0,4,0,0,4,0,0
"Bulgaria","2025-01-04",0,0,4,0,0,4,0,0
"Bulgaria","2025-01-05",0,0,4,0,0,4,0,0
"Bulgaria","2025-01-06",0,0,4,0,0,4,0,0
"Bulgaria","2025-01-07",0,0,4,0,0,4,0,0
"Bulgaria","2025-01-08",0,0,4,0,0,4,0,0
"Bulgaria","2025-01-09",0,0,4,0,0,4,0,0
"Bulgaria","2025-01-10",0,0,4,0,0,4,0,0
"Bulgaria","2025-01-11",0,0,4,0,0,4,0,0
"Bulgaria","2025-01-12",0,0,4,0,0,4,0,0
"Bulgaria","2025-01-13",0,0,4,0,0,4,0,0
"Bulgaria","2025-01-14",0,0,4,0,0,4,0,0
"Bulgaria","2025-01-15",0,0,4,0,0,4,0,0
"Bulgaria","2025-01-16",0,0,4,0,0,4,0,0
"Bulgaria","2025-01-17",0,0,4,0,0,4,0,0
"Bulgaria","2025-01-18",0,0,4,0,0,4,0,0
"Bulgaria","2025-01-19",0,0,4,0,0,4,0,0
"Bulgaria","2025-01-20",0,0,4,0,0,4,0,0
"Bulgaria","2025-01-21",0,0,4,0,0,4,0,0
"Bulgaria","2025-01-22",0,0,4,0,0,4,0,0
"Bulgaria","2025-01-23",0,0,4,0,0,4,0,0
"Bulgaria","2025-01-24",0,0,4,0,0,4,0,0
"Bulgaria","2025-01-25",0,0,4,0,0,4,0,0
"Bulgaria","2025-01-26",0,0,4,0,0,4,0,0
"Bulgaria","2025-01-27",0,0,4,0,0,4,0,0
"Bulgaria","2025-01-28",0,0,4,0,0,4,0,0
"Bulgaria","2025-01-29",0,0,4,0,0,4,0,0
"Bulgaria","2025-01-30",0,0,4,0,0,4,0,0
"Bulgaria","2025-01-31",0,0,4,0,0,4,0,0
"Bulgaria","2025-02-01",0,0,4,0,0,4,0,0
"Bulgaria","2025-02-02",0,0,4,0,0,4,0,0
"Bulgaria","2025-02-03",0,0,4,0,0,4,0,0
"Burundi","2024-01-01",0,0,0,0,0,0,0,0
"Burundi","2024-01-02",0,0,0,0,0,0,0,0
"Burundi","2024-01-03",0,0,0,0,0,0,0,0
"Burundi","2024-01-04",0,0,0,0,0,0,0,0
"Burundi","2024-01-05",0,0,0,0,0,0,0,0
"Burundi","2024-01-06",0,0,0,0,0,0,0,0
"Burundi","2024-01-07",0,0,0,0,0,0,0,0
"Burundi","2024-01-08",0,0,0,0,0,0,0,0
"Burundi","2024-01-09",0,0,0,0,0,0,0,0
"Burundi","2024-01-10",0,0,0,0,0,0,0,0
"Burundi","2024-01-11",0,0,0,0,0,0,0,0
"Burundi","2024-01-12",0,0,0,0,0,0,0,0
"Burundi","2024-01-13",0,0,0,0,0,0,0,0
"Burundi","2024-01-14",0,0,0,0,0,0,0,0
"Burundi","2024-01-15",0,0,0,0,0,0,0,0
"Burundi","2024-01-16",0,0,0,0,0,0,0,0
"Burundi","2024-01-17",0,0,0,0,0,0,0,0
"Burundi","2024-01-18",0,0,0,0,0,0,0,0
"Burundi","2024-01-19",0,0,0,0,0,0,0,0
"Burundi","2024-01-20",0,0,0,0,0,0,0,0
"Burundi","2024-01-21",0,0,0,0,0,0,0,0
"Burundi","2024-01-22",0,0,0,0,0,0,0,0
"Burundi","2024-01-23",0,0,0,0,0,0,0,0
"Burundi","2024-01-24",0,0,0,0,0,0,0,0
"Burundi","2024-01-25",0,0,0,0,0,0,0,0
"Burundi","2024-01-26",0,0,0,0,0,0,0,0
"Burundi","2024-01-27",0,0,0,0,0,0,0,0
"Burundi","2024-01-28",0,0,0,0,0,0,0,0
"Burundi","2024-01-29",0,0,0,0,0,0,0,0
"Burundi","2024-01-30",0,0,0,0,0,0,0,0
"Burundi","2024-01-31",0,0,0,0,0,0,0,0
"Burundi","2024-02-01",0,0,0,0,0,0,0,0
"Burundi","2024-02-02",0,0,0,0,0,0,0,0
"Burundi","2024-02-03",0,0,0,0,0,0,0,0
"Burundi","2024-02-04",0,0,0,0,0,0,0,0
"Burundi","2024-02-05",0,0,0,0,0,0,0,0
"Burundi","2024-02-06",0,0,0,0,0,0,0,0
"Burundi","2024-02-07",0,0,0,0,0,0,0,0
"Burundi","2024-02-08",0,0,0,0,0,0,0,0
"Burundi","2024-02-09",0,0,0,0,0,0,0,0
"Burundi","2024-02-10",0,0,0,0,0,0,0,0
"Burundi","2024-02-11",0,0,0,0,0,0,0,0
"Burundi","2024-02-12",0,0,0,0,0,0,0,0
"Burundi","2024-02-13",0,0,0,0,0,0,0,0
"Burundi","2024-02-14",0,0,0,0,0,0,0,0
"Burundi","2024-02-15",0,0,0,0,0,0,0,0
"Burundi","2024-02-16",0,0,0,0,0,0,0,0
"Burundi","2024-02-17",0,0,0,0,0,0,0,0
"Burundi","2024-02-18",0,0,0,0,0,0,0,0
"Burundi","2024-02-19",0,0,0,0,0,0,0,0
"Burundi","2024-02-20",0,0,0,0,0,0,0,0
"Burundi","2024-02-21",0,0,0,0,0,0,0,0
"Burundi","2024-02-22",0,0,0,0,0,0,0,0
"Burundi","2024-02-23",0,0,0,0,0,0,0,0
"Burundi","2024-02-24",0,0,0,0,0,0,0,0
"Burundi","2024-02-25",0,0,0,0,0,0,0,0
"Burundi","2024-02-26",0,0,0,0,0,0,0,0
"Burundi","2024-02-27",0,0,0,0,0,0,0,0
"Burundi","2024-02-28",0,0,0,0,0,0,0,0
"Burundi","2024-02-29",0,0,0,0,0,0,0,0
"Burundi","2024-03-01",0,0,0,0,0,0,0,0
"Burundi","2024-03-02",0,0,0,0,0,0,0,0
"Burundi","2024-03-03",0,0,0,0,0,0,0,0
"Burundi","2024-03-04",0,0,0,0,0,0,0,0
"Burundi","2024-03-05",0,0,0,0,0,0,0,0
"Burundi","2024-03-06",0,0,0,0,0,0,0,0
"Burundi","2024-03-07",0,0,0,0,0,0,0,0
"Burundi","2024-03-08",0,0,0,0,0,0,0,0
"Burundi","2024-03-09",0,0,0,0,0,0,0,0
"Burundi","2024-03-10",0,0,0,0,0,0,0,0
"Burundi","2024-03-11",0,0,0,0,0,0,0,0
"Burundi","2024-03-12",0,0,0,0,0,0,0,0
"Burundi","2024-03-13",0,0,0,0,0,0,0,0
"Burundi","2024-03-14",0,0,0,0,0,0,0,0
"Burundi","2024-03-15",0,0,0,0,0,0,0,0
"Burundi","2024-03-16",0,0,0,0,0,0,0,0
"Burundi","2024-03-17",0,0,0,0,0,0,0,0
"Burundi","2024-03-18",0,0,0,0,0,0,0,0
"Burundi","2024-03-19",0,0,0,0,0,0,0,0
"Burundi","2024-03-20",0,0,0,0,0,0,0,0
"Burundi","2024-03-21",0,0,0,0,0,0,0,0
"Burundi","2024-03-22",0,0,0,0,0,0,0,0
"Burundi","2024-03-23",0,0,0,0,0,0,0,0
"Burundi","2024-03-24",0,0,0,0,0,0,0,0
"Burundi","2024-03-25",0,0,0,0,0,0,0,0
"Burundi","2024-03-26",0,0,0,0,0,0,0,0
"Burundi","2024-03-27",0,0,0,0,0,0,0,0
"Burundi","2024-03-28",0,0,0,0,0,0,0,0
"Burundi","2024-03-29",0,0,0,0,0,0,0,0
"Burundi","2024-03-30",0,0,0,0,0,0,0,0
"Burundi","2024-03-31",0,0,0,0,0,0,0,0
"Burundi","2024-04-01",0,0,0,0,0,0,0,0
"Burundi","2024-04-02",0,0,0,0,0,0,0,0
"Burundi","2024-04-03",0,0,0,0,0,0,0,0
"Burundi","2024-04-04",0,0,0,0,0,0,0,0
"Burundi","2024-04-05",0,0,0,0,0,0,0,0
"Burundi","2024-04-06",0,0,0,0,0,0,0,0
"Burundi","2024-04-07",0,0,0,0,0,0,0,0
"Burundi","2024-04-08",0,0,0,0,0,0,0,0
"Burundi","2024-04-09",0,0,0,0,0,0,0,0
"Burundi","2024-04-10",0,0,0,0,0,0,0,0
"Burundi","2024-04-11",0,0,0,0,0,0,0,0
"Burundi","2024-04-12",0,0,0,0,0,0,0,0
"Burundi","2024-04-13",0,0,0,0,0,0,0,0
"Burundi","2024-04-14",0,0,0,0,0,0,0,0
"Burundi","2024-04-15",0,0,0,0,0,0,0,0
"Burundi","2024-04-16",0,0,0,0,0,0,0,0
"Burundi","2024-04-17",0,0,0,0,0,0,0,0
"Burundi","2024-04-18",0,0,0,0,0,0,0,0
"Burundi","2024-04-19",0,0,0,0,0,0,0,0
"Burundi","2024-04-20",0,0,0,0,0,0,0,0
"Burundi","2024-04-21",0,0,0,0,0,0,0,0
"Burundi","2024-04-22",0,0,0,0,0,0,0,0
"Burundi","2024-04-23",0,0,0,0,0,0,0,0
"Burundi","2024-04-24",0,0,0,0,0,0,0,0
"Burundi","2024-04-25",0,0,0,0,0,0,0,0
"Burundi","2024-04-26",0,0,0,0,0,0,0,0
"Burundi","2024-04-27",0,0,0,0,0,0,0,0
"Burundi","2024-04-28",0,0,0,0,0,0,0,0
"Burundi","2024-04-29",0,0,0,0,0,0,0,0
"Burundi","2024-04-30",0,0,0,0,0,0,0,0
"Burundi","2024-05-01",0,0,0,0,0,0,0,0
"Burundi","2024-05-02",0,0,0,0,0,0,0,0
"Burundi","2024-05-03",0,0,0,0,0,0,0,0
"Burundi","2024-05-04",0,0,0,0,0,0,0,0
"Burundi","2024-05-05",0,0,0,0,0,0,0,0
"Burundi","2024-05-06",0,0,0,0,0,0,0,0
"Burundi","2024-05-07",0,0,0,0,0,0,0,0
"Burundi","2024-05-08",0,0,0,0,0,0,0,0
"Burundi","2024-05-09",0,0,0,0,0,0,0,0
"Burundi","2024-05-10",0,0,0,0,0,0,0,0
"Burundi","2024-05-11",0,0,0,0,0,0,0,0
"Burundi","2024-05-12",0,0,0,0,0,0,0,0
"Burundi","2024-05-13",0,0,0,0,0,0,0,0
"Burundi","2024-05-14",0,0,0,0,0,0,0,0
"Burundi","2024-05-15",0,0,0,0,0,0,0,0
"Burundi","2024-05-16",0,0,0,0,0,0,0,0
"Burundi","2024-05-17",0,0,0,0,0,0,0,0
"Burundi","2024-05-18",0,0,0,0,0,0,0,0
"Burundi","2024-05-19",0,0,0,0,0,0,0,0
"Burundi","2024-05-20",0,0,0,0,0,0,0,0
"Burundi","2024-05-21",0,0,0,0,0,0,0,0
"Burundi","2024-05-22",0,0,0,0,0,0,0,0
"Burundi","2024-05-23",0,0,0,0,0,0,0,0
"Burundi","2024-05-24",0,0,0,0,0,0,0,0
"Burundi","2024-05-25",0,0,0,0,0,0,0,0
"Burundi","2024-05-26",0,0,0,0,0,0,0,0
"Burundi","2024-05-27",0,0,0,0,0,0,0,0
"Burundi","2024-05-28",0,0,0,0,0,0,0,0
"Burundi","2024-05-29",0,0,0,0,0,0,0,0
"Burundi","2024-05-30",0,0,0,0,0,0,0,0
"Burundi","2024-05-31",0,0,0,0,0,0,0,0
"Burundi","2024-06-01",0,0,0,0,0,0,0,0
"Burundi","2024-06-02",0,0,0,0,0,0,0,0
"Burundi","2024-06-03",0,0,0,0,0,0,0,0
"Burundi","2024-06-04",0,0,0,0,0,0,0,0
"Burundi","2024-06-05",0,0,0,0,0,0,0,0
"Burundi","2024-06-06",0,0,0,0,0,0,0,0
"Burundi","2024-06-07",0,0,0,0,0,0,0,0
"Burundi","2024-06-08",0,0,0,0,0,0,0,0
"Burundi","2024-06-09",0,0,0,0,0,0,0,0
"Burundi","2024-06-10",0,0,0,0,0,0,0,0
"Burundi","2024-06-11",0,0,0,0,0,0,0,0
"Burundi","2024-06-12",0,0,0,0,0,0,0,0
"Burundi","2024-06-13",0,0,0,0,0,0,0,0
"Burundi","2024-06-14",0,0,0,0,0,0,0,0
"Burundi","2024-06-15",0,0,0,0,0,0,0,0
"Burundi","2024-06-16",0,0,0,0,0,0,0,0
"Burundi","2024-06-17",0,0,0,0,0,0,0,0
"Burundi","2024-06-18",0,0,0,0,0,0,0,0
"Burundi","2024-06-19",0,0,0,0,0,0,0,0
"Burundi","2024-06-20",0,0,0,0,0,0,0,0
"Burundi","2024-06-21",0,0,0,0,0,0,0,0
"Burundi","2024-06-22",0,0,0,0,0,0,0,0
"Burundi","2024-06-23",0,0,0,0,0,0,0,0
"Burundi","2024-06-24",0,0,0,0,0,0,0,0
"Burundi","2024-06-25",0,0,0,0,0,0,0,0
"Burundi","2024-06-26",0,0,0,0,0,0,0,0
"Burundi","2024-06-27",0,0,0,0,0,0,0,0
"Burundi","2024-06-28",0,0,0,0,0,0,0,0
"Burundi","2024-06-29",0,0,0,0,0,0,0,0
"Burundi","2024-06-30",0,0,0,0,0,0,0,0
"Burundi","2024-07-01",0,0,0,0,0,0,0,0
"Burundi","2024-07-02",0,0,0,0,0,0,0,0
"Burundi","2024-07-03",0,0,0,0,0,0,0,0
"Burundi","2024-07-04",0,0,0,0,0,0,0,0
"Burundi","2024-07-05",0,0,0,0,0,0,0,0
"Burundi","2024-07-06",0,0,0,0,0,0,0,0
"Burundi","2024-07-07",0,0,0,0,0,0,0,0
"Burundi","2024-07-08",0,0,0,0,0,0,0,0
"Burundi","2024-07-09",0,0,0,0,0,0,0,0
"Burundi","2024-07-10",0,0,0,0,0,0,0,0
"Burundi","2024-07-11",0,0,0,0,0,0,0,0
"Burundi","2024-07-12",0,0,0,0,0,0,0,0
"Burundi","2024-07-13",0,0,0,0,0,0,0,0
"Burundi","2024-07-14",0,0,0,0,0,0,0,0
"Burundi","2024-07-15",0,0,0,0,0,0,0,0
"Burundi","2024-07-16",0,0,0,0,0,0,0,0
"Burundi","2024-07-17",0,0,0,0,0,0,0,0
"Burundi","2024-07-18",0,0,0,0,0,0,0,0
"Burundi","2024-07-19",5,0,0,5,0,0,5,5
"Burundi","2024-07-20",0,0,0,5,0,0,3,8
"Burundi","2024-07-21",0,0,0,5,0,0,4,12
"Burundi","2024-07-22",0,0,0,5,0,0,3,15
"Burundi","2024-07-23",0,0,0,5,0,0,3,18
"Burundi","2024-07-24",0,0,0,5,0,0,3,21
"Burundi","2024-07-25",0,0,0,5,0,0,4,25
"Burundi","2024-07-26",0,0,0,5,0,0,3,28
"Burundi","2024-07-27",0,0,0,5,0,0,3,31
"Burundi","2024-07-28",0,9,9,5,9,9,3,34
"Burundi","2024-07-29",0,0,9,5,4,13,4,38
"Burundi","2024-07-30",0,0,9,5,5,18,3,41
"Burundi","2024-07-31",0,0,9,5,4,22,3,44
"Burundi","2024-08-01",0,0,9,5,5,27,3,47
"Burundi","2024-08-02",0,0,9,5,4,31,4,51
"Burundi","2024-08-03",49,0,9,54,5,36,3,54
"Burundi","2024-08-04",0,31,40,54,4,40,10,64
"Burundi","2024-08-05",0,0,40,54,6,46,10,74
"Burundi","2024-08-06",0,0,40,54,6,52,10,84
"Burundi","2024-08-07",0,0,40,54,6,58,10,94
"Burundi","2024-08-08",0,0,40,54,7,65,10,104
"Burundi","2024-08-09",60,0,40,114,6,71,10,114
"Burundi","2024-08-10",0,0,40,114,6,77,19,133
"Burundi","2024-08-11",0,43,83,114,6,83,19,152
"Burundi","2024-08-12",0,0,83,114,10,93,19,171
"Burundi","2024-08-13",0,0,83,114,10,103,20,191
"Burundi","2024-08-14",0,0,83,114,10,113,19,210
"Burundi","2024-08-15",0,0,83,114,10,123,19,229
"Burundi","2024-08-16",134,0,83,248,10,133,19,248
"Burundi","2024-08-17",0,0,83,248,10,143,24,272
"Burundi","2024-08-18",0,70,153,248,10,153,23,295
"Burundi","2024-08-19",0,0,153,248,11,164,24,319
"Burundi","2024-08-20",0,0,153,248,11,175,24,343
"Burundi","2024-08-21",0,0,153,248,11,186,23,366
"Burundi","2024-08-22",0,0,153,248,12,198,24,390
"Burundi","2024-08-23",0,0,153,248,11,209,24,414
"Burundi","2024-08-24",0,0,153,248,11,220,23,437
"Burundi","2024-08-25",213,78,231,461,11,231,24,461
"Burundi","2024-08-26",0,0,231,461,14,245,39,500
"Burundi","2024-08-27",0,0,231,461,14,259,40,540
"Burundi","2024-08-28",0,0,231,461,14,273,39,579
"Burundi","2024-08-29",0,0,231,461,13,286,39,618
"Burundi","2024-08-30",0,0,231,461,14,300,40,658
"Burundi","2024-08-31",236,0,231,697,14,314,39,697
"Burundi","2024-09-01",0,97,328,697,14,328,8,705
"Burundi","2024-09-02",0,0,328,697,8,336,8,713
"Burundi","2024-09-03",0,0,328,697,8,344,8,721
"Burundi","2024-09-04",0,0,328,697,8,352,8,729
"Burundi","2024-09-05",0,0,328,697,9,361,7,736
"Burundi","2024-09-06",0,0,328,697,8,369,8,744
"Burundi","2024-09-07",0,0,328,697,8,377,8,752
"Burundi","2024-09-08",63,57,385,760,8,385,8,760
"Burundi","2024-09-09",0,0,385,760,26,411,40,800
"Burundi","2024-09-10",0,0,385,760,25,436,40,840
"Burundi","2024-09-11",0,0,385,760,26,462,40,880
"Burundi","2024-09-12",0,0,385,760,25,487,40,920
"Burundi","2024-09-13",0,0,385,760,26,513,41,961
"Burundi","2024-09-14",0,0,385,760,25,538,40,1001
"Burundi","2024-09-15",0,179,564,760,26,564,40,1041
"Burundi","2024-09-16",321,0,564,1081,19,583,40,1081
"Burundi","2024-09-17",0,0,564,1081,19,602,37,1118
"Burundi","2024-09-18",0,0,564,1081,19,621,37,1155
"Burundi","2024-09-19",0,0,564,1081,18,639,37,1192
"Burundi","2024-09-20",0,0,564,1081,19,658,37,1229
"Burundi","2024-09-21",0,0,564,1081,19,677,37,1266
"Burundi","2024-09-22",0,132,696,1081,19,696,37,1303
"Burundi","2024-09-23",259,0,696,1340,22,718,37,1340
"Burundi","2024-09-24",0,0,696,1340,23,741,10,1350
"Burundi","2024-09-25",0,0,696,1340,22,763,10,1360
"Burundi","2024-09-26",0,0,696,1340,23,786,9,1369
"Burundi","2024-09-27",0,0,696,1340,22,808,10,1379
"Burundi","2024-09-28",0,0,696,1340,23,831,10,1389
"Burundi","2024-09-29",0,157,853,1340,22,853,10,1399
"Burundi","2024-09-30",0,0,853,1340,19,872,10,1409
"Burundi","2024-10-01",0,0,853,1340,19,891,9,1418
"Burundi","2024-10-02",0,0,853,1340,19,910,10,1428
"Burundi","2024-10-03",0,0,853,1340,20,930,10,1438
"Burundi","2024-10-04",0,0,853,1340,19,949,10,1448
"Burundi","2024-10-05",0,0,853,1340,19,968,9,1457
"Burundi","2024-10-06",0,134,987,1340,19,987,10,1467
"Burundi","2024-10-07",0,0,987,1340,26,1013,10,1477
"Burundi","2024-10-08",0,0,987,1340,26,1039,10,1487
"Burundi","2024-10-09",0,0,987,1340,26,1065,10,1497
"Burundi","2024-10-10",0,0,987,1340,27,1092,9,1506
"Burundi","2024-10-11",0,0,987,1340,26,1118,10,1516
"Burundi","2024-10-12",186,0,987,1526,26,1144,10,1526
"Burundi","2024-10-13",98,183,1170,1624,26,1170,98,1624
"Burundi","2024-10-14",0,0,1170,1624,17,1187,16,1640
"Burundi","2024-10-15",0,0,1170,1624,16,1203,17,1657
"Burundi","2024-10-16",0,0,1170,1624,17,1220,16,1673
"Burundi","2024-10-17",0,0,1170,1624,17,1237,17,1690
"Burundi","2024-10-18",0,0,1170,1624,17,1254,16,1706
"Burundi","2024-10-19",0,0,1170,1624,16,1270,17,1723
"Burundi","2024-10-20",115,117,1287,1739,17,1287,16,1739
"Burundi","2024-10-21",0,0,1287,1739,32,1319,16,1755
"Burundi","2024-10-22",0,0,1287,1739,31,1350,16,1771
"Burundi","2024-10-23",0,0,1287,1739,32,1382,16,1787
"Burundi","2024-10-24",0,0,1287,1739,32,1414,17,1804
"Burundi","2024-10-25",0,0,1287,1739,32,1446,16,1820
"Burundi","2024-10-26",0,0,1287,1739,31,1477,16,1836
"Burundi","2024-10-27",113,222,1509,1852,32,1509,16,1852
"Burundi","2024-10-28",0,0,1509,1852,30,1539,14,1866
"Burundi","2024-10-29",0,0,1509,1852,30,1569,15,1881
"Burundi","2024-10-30",0,0,1509,1852,30,1599,14,1895
"Burundi","2024-10-31",0,0,1509,1852,29,1628,15,1910
"Burundi","2024-11-01",0,0,1509,1852,30,1658,14,1924
"Burundi","2024-11-02",0,0,1509,1852,30,1688,15,1939
"Burundi","2024-11-03",101,209,1718,1953,30,1718,14,1953
"Burundi","2024-11-04",0,0,1718,1953,21,1739,11,1964
"Burundi","2024-11-05",0,0,1718,1953,20,1759,11,1975
"Burundi","2024-11-06",0,0,1718,1953,21,1780,10,1985
"Burundi","2024-11-07",0,0,1718,1953,21,1801,11,1996
"Burundi","2024-11-08",0,0,1718,1953,21,1822,11,2007
"Burundi","2024-11-09",0,0,1718,1953,20,1842,11,2018
"Burundi","2024-11-10",0,145,1863,1953,21,1863,11,2029
"Burundi","2024-11-11",0,0,1863,1953,27,1890,10,2039
"Burundi","2024-11-12",0,0,1863,1953,26,1916,11,2050
"Burundi","2024-11-13",108,0,1863,2061,27,1943,11,2061
"Burundi","2024-11-14",0,0,1863,2061,27,1970,0,2061
"Burundi","2024-11-15",0,0,1863,2061,27,1997,0,2061
"Burundi","2024-11-16",0,0,1863,2061,26,2023,0,2061
"Burundi","2024-11-17",0,187,2050,2061,27,2050,0,2061
"Burundi","2024-11-18",0,0,2050,2061,27,2077,0,2061
"Burundi","2024-11-19",0,0,2050,2061,26,2103,0,2061
"Burundi","2024-11-20",0,0,2050,2061,27,2130,0,2061
"Burundi","2024-11-21",0,0,2050,2061,27,2157,0,2061
"Burundi","2024-11-22",0,0,2050,2061,27,2184,0,2061
"Burundi","2024-11-23",0,0,2050,2061,26,2210,0,2061
"Burundi","2024-11-24",0,187,2237,2061,27,2237,0,2061
"Burundi","2024-11-25",0,0,2237,2061,24,2261,0,2061
"Burundi","2024-11-26",0,0,2237,2061,23,2284,0,2061
"Burundi","2024-11-27",0,0,2237,2061,24,2308,0,2061
"Burundi","2024-11-28",0,0,2237,2061,23,2331,0,2061
"Burundi","2024-11-29",0,0,2237,2061,24,2355,0,2061
"Burundi","2024-11-30",0,0,2237,2061,23,2378,0,2061
"Burundi","2024-12-01",0,165,2402,2061,24,2402,0,2061
"Burundi","2024-12-02",0,0,2402,2061,21,2423,0,2061
"Burundi","2024-12-03",0,0,2402,2061,20,2443,0,2061
"Burundi","2024-12-04",0,0,2402,2061,21,2464,0,2061
"Burundi","2024-12-05",0,0,2402,2061,20,2484,0,2061
"Burundi","2024-12-06",0,0,2402,2061,21,2505,0,2061
"Burundi","2024-12-07",0,0,2402,2061,20,2525,0,2061
"Burundi","2024-12-08",0,144,2546,2061,21,2546,0,2061
"Burundi","2024-12-09",0,0,2546,2061,24,2570,0,2061
"Burundi","2024-12-10",0,0,2546,2061,25,2595,0,2061
"Burundi","2024-12-11",0,0,2546,2061,24,2619,0,2061
"Burundi","2024-12-12",0,0,2546,2061,25,2644,0,2061
"Burundi","2024-12-13",0,0,2546,2061,24,2668,0,2061
"Burundi","2024-12-14",0,0,2546,2061,25,2693,0,2061
"Burundi","2024-12-15",0,171,2717,2061,24,2717,0,2061
"Burundi","2024-12-16",0,0,2717,2061,21,2738,0,2061
"Burundi","2024-12-17",0,0,2717,2061,20,2758,0,2061
"Burundi","2024-12-18",0,0,2717,2061,21,2779,0,2061
"Burundi","2024-12-19",0,0,2717,2061,20,2799,0,2061
"Burundi","2024-12-20",0,0,2717,2061,21,2820,0,2061
"Burundi","2024-12-21",0,0,2717,2061,20,2840,0,2061
"Burundi","2024-12-22",0,144,2861,2061,21,2861,0,2061
"Burundi","2024-12-23",0,0,2861,2061,12,2873,0,2061
"Burundi","2024-12-24",0,0,2861,2061,12,2885,0,2061
"Burundi","2024-12-25",0,0,2861,2061,12,2897,0,2061
"Burundi","2024-12-26",0,0,2861,2061,13,2910,0,2061
"Burundi","2024-12-27",0,0,2861,2061,12,2922,0,2061
"Burundi","2024-12-28",0,0,2861,2061,12,2934,0,2061
"Burundi","2024-12-29",0,85,2946,2061,12,2946,0,2061
"Burundi","2024-12-30",0,0,2946,2061,13,2959,0,2061
"Burundi","2024-12-31",0,0,2946,2061,12,2971,0,2061
"Burundi","2025-01-01",0,0,2946,2061,13,2984,0,2061
"Burundi","2025-01-02",0,0,2946,2061,13,2997,0,2061
"Burundi","2025-01-03",0,0,2946,2061,13,3010,0,2061
"Burundi","2025-01-04",0,0,2946,2061,12,3022,0,2061
"Burundi","2025-01-05",0,89,3035,2061,13,3035,0,2061
"Burundi","2025-01-06",0,0,3035,2061,12,3047,0,2061
"Burundi","2025-01-07",0,0,3035,2061,11,3058,0,2061
"Burundi","2025-01-08",0,0,3035,2061,12,3070,0,2061
"Burundi","2025-01-09",0,0,3035,2061,11,3081,0,2061
"Burundi","2025-01-10",0,0,3035,2061,12,3093,0,2061
"Burundi","2025-01-11",0,0,3035,2061,11,3104,0,2061
"Burundi","2025-01-12",0,81,3116,2061,12,3116,0,2061
"Burundi","2025-01-13",0,0,3116,2061,0,3116,0,2061
"Burundi","2025-01-14",0,0,3116,2061,0,3116,0,2061
"Burundi","2025-01-15",0,0,3116,2061,0,3116,0,2061
"Burundi","2025-01-16",0,0,3116,2061,0,3116,0,2061
"Burundi","2025-01-17",0,0,3116,2061,0,3116,0,2061
"Burundi","2025-01-18",0,0,3116,2061,0,3116,0,2061
"Burundi","2025-01-19",0,0,3116,2061,0,3116,0,2061
"Burundi","2025-01-20",0,0,3116,2061,0,3116,0,2061
"Burundi","2025-01-21",0,0,3116,2061,0,3116,0,2061
"Burundi","2025-01-22",0,0,3116,2061,0,3116,0,2061
"Burundi","2025-01-23",0,0,3116,2061,0,3116,0,2061
"Burundi","2025-01-24",0,0,3116,2061,0,3116,0,2061
"Burundi","2025-01-25",0,0,3116,2061,0,3116,0,2061
"Burundi","2025-01-26",0,0,3116,2061,0,3116,0,2061
"Burundi","2025-01-27",0,0,3116,2061,0,3116,0,2061
"Burundi","2025-01-28",0,0,3116,2061,0,3116,0,2061
"Burundi","2025-01-29",0,0,3116,2061,0,3116,0,2061
"Burundi","2025-01-30",0,0,3116,2061,0,3116,0,2061
"Burundi","2025-01-31",0,0,3116,2061,0,3116,0,2061
"Burundi","2025-02-01",0,0,3116,2061,0,3116,0,2061
"Burundi","2025-02-02",0,0,3116,2061,0,3116,0,2061
"Burundi","2025-02-03",0,0,3116,2061,0,3116,0,2061
"Cambodia","2024-01-01",0,0,0,0,0,0,0,0
"Cambodia","2024-01-02",0,0,0,0,0,0,0,0
"Cambodia","2024-01-03",0,0,0,0,0,0,0,0
"Cambodia","2024-01-04",0,2,2,0,2,2,0,0
"Cambodia","2024-01-05",0,0,2,0,0,2,0,0
"Cambodia","2024-01-06",0,0,2,0,0,2,0,0
"Cambodia","2024-01-07",0,0,2,0,0,2,0,0
"Cambodia","2024-01-08",0,0,2,0,0,2,0,0
"Cambodia","2024-01-09",0,0,2,0,0,2,0,0
"Cambodia","2024-01-10",0,0,2,0,0,2,0,0
"Cambodia","2024-01-11",0,0,2,0,0,2,0,0
"Cambodia","2024-01-12",0,0,2,0,0,2,0,0
"Cambodia","2024-01-13",0,0,2,0,0,2,0,0
"Cambodia","2024-01-14",0,0,2,0,0,2,0,0
"Cambodia","2024-01-15",0,0,2,0,0,2,0,0
"Cambodia","2024-01-16",0,0,2,0,0,2,0,0
"Cambodia","2024-01-17",0,0,2,0,0,2,0,0
"Cambodia","2024-01-18",0,0,2,0,0,2,0,0
"Cambodia","2024-01-19",0,0,2,0,1,3,0,0
"Cambodia","2024-01-20",0,0,2,0,0,3,0,0
"Cambodia","2024-01-21",0,0,2,0,0,3,0,0
"Cambodia","2024-01-22",0,0,2,0,0,3,0,0
"Cambodia","2024-01-23",0,0,2,0,0,3,0,0
"Cambodia","2024-01-24",0,0,2,0,0,3,0,0
"Cambodia","2024-01-25",0,0,2,0,0,3,0,0
"Cambodia","2024-01-26",0,0,2,0,0,3,0,0
"Cambodia","2024-01-27",0,0,2,0,0,3,0,0
"Cambodia","2024-01-28",0,0,2,0,0,3,0,0
"Cambodia","2024-01-29",0,0,2,0,0,3,0,0
"Cambodia","2024-01-30",0,0,2,0,0,3,0,0
"Cambodia","2024-01-31",0,0,2,0,0,3,0,0
"Cambodia","2024-02-01",0,0,2,0,0,3,0,0
"Cambodia","2024-02-02",0,1,3,0,0,3,0,0
"Cambodia","2024-02-03",0,0,3,0,0,3,0,0
"Cambodia","2024-02-04",0,0,3,0,1,4,0,0
"Cambodia","2024-02-05",0,0,3,0,0,4,0,0
"Cambodia","2024-02-06",0,0,3,0,1,5,0,0
"Cambodia","2024-02-07",0,0,3,0,0,5,0,0
"Cambodia","2024-02-08",0,0,3,0,1,6,0,0
"Cambodia","2024-02-09",0,0,3,0,0,6,0,0
"Cambodia","2024-02-10",0,0,3,0,0,6,0,0
"Cambodia","2024-02-11",0,0,3,0,1,7,0,0
"Cambodia","2024-02-12",0,0,3,0,0,7,0,0
"Cambodia","2024-02-13",0,0,3,0,1,8,0,0
"Cambodia","2024-02-14",0,0,3,0,0,8,0,0
"Cambodia","2024-02-15",0,0,3,0,1,9,0,0
"Cambodia","2024-02-16",0,0,3,0,0,9,0,0
"Cambodia","2024-02-17",0,0,3,0,0,9,0,0
"Cambodia","2024-02-18",0,0,3,0,1,10,0,0
"Cambodia","2024-02-19",0,0,3,0,0,10,0,0
"Cambodia","2024-02-20",0,0,3,0,1,11,0,0
"Cambodia","2024-02-21",0,0,3,0,0,11,0,0
"Cambodia","2024-02-22",0,0,3,0,1,12,0,0
"Cambodia","2024-02-23",0,9,12,0,0,12,0,0
"Cambodia","2024-02-24",0,0,12,0,0,12,0,0
"Cambodia","2024-02-25",0,0,12,0,0,12,0,0
"Cambodia","2024-02-26",0,0,12,0,0,12,0,0
"Cambodia","2024-02-27",0,0,12,0,0,12,0,0
"Cambodia","2024-02-28",0,0,12,0,0,12,0,0
"Cambodia","2024-02-29",0,0,12,0,0,12,0,0
"Cambodia","2024-03-01",0,0,12,0,0,12,0,0
"Cambodia","2024-03-02",0,0,12,0,0,12,0,0
"Cambodia","2024-03-03",0,0,12,0,0,12,0,0
"Cambodia","2024-03-04",0,0,12,0,0,12,0,0
"Cambodia","2024-03-05",0,0,12,0,0,12,0,0
"Cambodia","2024-03-06",0,0,12,0,0,12,0,0
"Cambodia","2024-03-07",0,0,12,0,0,12,0,0
"Cambodia","2024-03-08",0,0,12,0,0,12,0,0
"Cambodia","2024-03-09",0,0,12,0,0,12,0,0
"Cambodia","2024-03-10",0,0,12,0,0,12,0,0
"Cambodia","2024-03-11",0,0,12,0,0,12,0,0
"Cambodia","2024-03-12",0,0,12,0,0,12,0,0
"Cambodia","2024-03-13",0,0,12,0,0,12,0,0
"Cambodia","2024-03-14",0,0,12,0,0,12,0,0
"Cambodia","2024-03-15",0,0,12,0,0,12,0,0
"Cambodia","2024-03-16",0,0,12,0,0,12,0,0
"Cambodia","2024-03-17",0,0,12,0,0,12,0,0
"Cambodia","2024-03-18",0,0,12,0,0,12,0,0
"Cambodia","2024-03-19",0,0,12,0,0,12,0,0
"Cambodia","2024-03-20",0,0,12,0,0,12,0,0
"Cambodia","2024-03-21",0,0,12,0,0,12,0,0
"Cambodia","2024-03-22",0,0,12,0,0,12,0,0
"Cambodia","2024-03-23",0,0,12,0,0,12,0,0
"Cambodia","2024-03-24",0,0,12,0,0,12,0,0
"Cambodia","2024-03-25",0,0,12,0,0,12,0,0
"Cambodia","2024-03-26",0,0,12,0,0,12,0,0
"Cambodia","2024-03-27",0,0,12,0,0,12,0,0
"Cambodia","2024-03-28",0,0,12,0,0,12,0,0
"Cambodia","2024-03-29",0,0,12,0,0,12,0,0
"Cambodia","2024-03-30",0,0,12,0,0,12,0,0
"Cambodia","2024-03-31",0,0,12,0,0,12,0,0
"Cambodia","2024-04-01",0,0,12,0,0,12,0,0
"Cambodia","2024-04-02",0,0,12,0,0,12,0,0
"Cambodia","2024-04-03",0,0,12,0,0,12,0,0
"Cambodia","2024-04-04",0,0,12,0,0,12,0,0
"Cambodia","2024-04-05",0,0,12,0,0,12,0,0
"Cambodia","2024-04-06",0,0,12,0,0,12,0,0
"Cambodia","2024-04-07",0,0,12,0,0,12,0,0
"Cambodia","2024-04-08",0,0,12,0,0,12,0,0
"Cambodia","2024-04-09",0,0,12,0,0,12,0,0
"Cambodia","2024-04-10",0,0,12,0,0,12,0,0
"Cambodia","2024-04-11",0,0,12,0,0,12,0,0
"Cambodia","2024-04-12",0,0,12,0,0,12,0,0
"Cambodia","2024-04-13",0,0,12,0,0,12,0,0
"Cambodia","2024-04-14",0,0,12,0,0,12,0,0
"Cambodia","2024-04-15",0,0,12,0,0,12,0,0
"Cambodia","2024-04-16",0,0,12,0,0,12,0,0
"Cambodia","2024-04-17",0,0,12,0,0,12,0,0
"Cambodia","2024-04-18",0,0,12,0,0,12,0,0
"Cambodia","2024-04-19",0,0,12,0,0,12,0,0
"Cambodia","2024-04-20",0,0,12,0,0,12,0,0
"Cambodia","2024-04-21",0,0,12,0,0,12,0,0
"Cambodia","2024-04-22",0,0,12,0,0,12,0,0
"Cambodia","2024-04-23",0,0,12,0,0,12,0,0
"Cambodia","2024-04-24",0,0,12,0,0,12,0,0
"Cambodia","2024-04-25",0,0,12,0,0,12,0,0
"Cambodia","2024-04-26",0,0,12,0,0,12,0,0
"Cambodia","2024-04-27",0,0,12,0,0,12,0,0
"Cambodia","2024-04-28",0,0,12,0,0,12,0,0
"Cambodia","2024-04-29",0,0,12,0,0,12,0,0
"Cambodia","2024-04-30",0,0,12,0,0,12,0,0
"Cambodia","2024-05-01",0,0,12,0,0,12,0,0
"Cambodia","2024-05-02",0,0,12,0,0,12,0,0
"Cambodia","2024-05-03",0,0,12,0,0,12,0,0
"Cambodia","2024-05-04",0,0,12,0,0,12,0,0
"Cambodia","2024-05-05",0,0,12,0,0,12,0,0
"Cambodia","2024-05-06",0,0,12,0,0,12,0,0
"Cambodia","2024-05-07",0,0,12,0,0,12,0,0
"Cambodia","2024-05-08",0,0,12,0,0,12,0,0
"Cambodia","2024-05-09",0,0,12,0,0,12,0,0
"Cambodia","2024-05-10",0,0,12,0,0,12,0,0
"Cambodia","2024-05-11",0,0,12,0,0,12,0,0
"Cambodia","2024-05-12",0,0,12,0,0,12,0,0
"Cambodia","2024-05-13",0,0,12,0,0,12,0,0
"Cambodia","2024-05-14",0,0,12,0,0,12,0,0
"Cambodia","2024-05-15",0,0,12,0,0,12,0,0
"Cambodia","2024-05-16",0,0,12,0,0,12,0,0
"Cambodia","2024-05-17",0,0,12,0,0,12,0,0
"Cambodia","2024-05-18",0,0,12,0,0,12,0,0
"Cambodia","2024-05-19",0,0,12,0,0,12,0,0
"Cambodia","2024-05-20",0,0,12,0,0,12,0,0
"Cambodia","2024-05-21",0,0,12,0,0,12,0,0
"Cambodia","2024-05-22",0,0,12,0,0,12,0,0
"Cambodia","2024-05-23",0,0,12,0,0,12,0,0
"Cambodia","2024-05-24",0,0,12,0,0,12,0,0
"Cambodia","2024-05-25",0,0,12,0,0,12,0,0
"Cambodia","2024-05-26",0,0,12,0,0,12,0,0
"Cambodia","2024-05-27",0,0,12,0,0,12,0,0
"Cambodia","2024-05-28",0,0,12,0,0,12,0,0
"Cambodia","2024-05-29",0,0,12,0,0,12,0,0
"Cambodia","2024-05-30",0,0,12,0,0,12,0,0
"Cambodia","2024-05-31",0,0,12,0,0,12,0,0
"Cambodia","2024-06-01",0,0,12,0,0,12,0,0
"Cambodia","2024-06-02",0,0,12,0,0,12,0,0
"Cambodia","2024-06-03",0,0,12,0,0,12,0,0
"Cambodia","2024-06-04",0,0,12,0,0,12,0,0
"Cambodia","2024-06-05",0,0,12,0,0,12,0,0
"Cambodia","2024-06-06",0,0,12,0,0,12,0,0
"Cambodia","2024-06-07",0,0,12,0,0,12,0,0
"Cambodia","2024-06-08",0,0,12,0,0,12,0,0
"Cambodia","2024-06-09",0,0,12,0,0,12,0,0
"Cambodia","2024-06-10",0,0,12,0,0,12,0,0
"Cambodia","2024-06-11",0,0,12,0,0,12,0,0
"Cambodia","2024-06-12",0,0,12,0,0,12,0,0
"Cambodia","2024-06-13",0,0,12,0,0,12,0,0
"Cambodia","2024-06-14",0,0,12,0,0,12,0,0
"Cambodia","2024-06-15",0,0,12,0,0,12,0,0
"Cambodia","2024-06-16",0,0,12,0,0,12,0,0
"Cambodia","2024-06-17",0,0,12,0,0,12,0,0
"Cambodia","2024-06-18",0,0,12,0,0,12,0,0
"Cambodia","2024-06-19",0,0,12,0,0,12,0,0
"Cambodia","2024-06-20",0,0,12,0,0,12,0,0
"Cambodia","2024-06-21",0,0,12,0,0,12,0,0
"Cambodia","2024-06-22",0,0,12,0,0,12,0,0
"Cambodia","2024-06-23",0,0,12,0,0,12,0,0
"Cambodia","2024-06-24",0,0,12,0,0,12,0,0
"Cambodia","2024-06-25",0,0,12,0,0,12,0,0
"Cambodia","2024-06-26",0,0,12,0,0,12,0,0
"Cambodia","2024-06-27",0,0,12,0,0,12,0,0
"Cambodia","2024-06-28",0,0,12,0,0,12,0,0
"Cambodia","2024-06-29",0,0,12,0,0,12,0,0
"Cambodia","2024-06-30",0,0,12,0,0,12,0,0
"Cambodia","2024-07-01",0,0,12,0,0,12,0,0
"Cambodia","2024-07-02",0,0,12,0,0,12,0,0
"Cambodia","2024-07-03",0,0,12,0,0,12,0,0
"Cambodia","2024-07-04",0,0,12,0,0,12,0,0
"Cambodia","2024-07-05",0,0,12,0,0,12,0,0
"Cambodia","2024-07-06",0,0,12,0,0,12,0,0
"Cambodia","2024-07-07",0,0,12,0,0,12,0,0
"Cambodia","2024-07-08",0,0,12,0,0,12,0,0
"Cambodia","2024-07-09",0,0,12,0,0,12,0,0
"Cambodia","2024-07-10",0,0,12,0,0,12,0,0
"Cambodia","2024-07-11",0,0,12,0,0,12,0,0
"Cambodia","2024-07-12",0,0,12,0,0,12,0,0
"Cambodia","2024-07-13",0,0,12,0,0,12,0,0
"Cambodia","2024-07-14",0,0,12,0,0,12,0,0
"Cambodia","2024-07-15",0,0,12,0,0,12,0,0
"Cambodia","2024-07-16",0,0,12,0,0,12,0,0
"Cambodia","2024-07-17",0,0,12,0,0,12,0,0
"Cambodia","2024-07-18",0,0,12,0,0,12,0,0
"Cambodia","2024-07-19",0,0,12,0,0,12,0,0
"Cambodia","2024-07-20",0,0,12,0,0,12,0,0
"Cambodia","2024-07-21",0,0,12,0,0,12,0,0
"Cambodia","2024-07-22",0,0,12,0,0,12,0,0
"Cambodia","2024-07-23",0,0,12,0,0,12,0,0
"Cambodia","2024-07-24",0,0,12,0,0,12,0,0
"Cambodia","2024-07-25",0,0,12,0,0,12,0,0
"Cambodia","2024-07-26",0,0,12,0,0,12,0,0
"Cambodia","2024-07-27",0,0,12,0,0,12,0,0
"Cambodia","2024-07-28",0,0,12,0,0,12,0,0
"Cambodia","2024-07-29",0,0,12,0,0,12,0,0
"Cambodia","2024-07-30",0,0,12,0,0,12,0,0
"Cambodia","2024-07-31",0,0,12,0,0,12,0,0
"Cambodia","2024-08-01",0,0,12,0,0,12,0,0
"Cambodia","2024-08-02",0,0,12,0,0,12,0,0
"Cambodia","2024-08-03",0,0,12,0,0,12,0,0
"Cambodia","2024-08-04",0,0,12,0,0,12,0,0
"Cambodia","2024-08-05",0,0,12,0,0,12,0,0
"Cambodia","2024-08-06",0,0,12,0,0,12,0,0
"Cambodia","2024-08-07",0,0,12,0,0,12,0,0
"Cambodia","2024-08-08",0,0,12,0,0,12,0,0
"Cambodia","2024-08-09",0,0,12,0,0,12,0,0
"Cambodia","2024-08-10",0,0,12,0,0,12,0,0
"Cambodia","2024-08-11",0,0,12,0,0,12,0,0
"Cambodia","2024-08-12",0,0,12,0,0,12,0,0
"Cambodia","2024-08-13",0,0,12,0,0,12,0,0
"Cambodia","2024-08-14",0,0,12,0,0,12,0,0
"Cambodia","2024-08-15",0,0,12,0,0,12,0,0
"Cambodia","2024-08-16",0,0,12,0,0,12,0,0
"Cambodia","2024-08-17",0,0,12,0,0,12,0,0
"Cambodia","2024-08-18",0,0,12,0,0,12,0,0
"Cambodia","2024-08-19",0,0,12,0,0,12,0,0
"Cambodia","2024-08-20",0,0,12,0,0,12,0,0
"Cambodia","2024-08-21",0,0,12,0,0,12,0,0
"Cambodia","2024-08-22",0,0,12,0,0,12,0,0
"Cambodia","2024-08-23",0,0,12,0,0,12,0,0
"Cambodia","2024-08-24",0,0,12,0,0,12,0,0
"Cambodia","2024-08-25",0,0,12,0,0,12,0,0
"Cambodia","2024-08-26",0,0,12,0,0,12,0,0
"Cambodia","2024-08-27",0,0,12,0,0,12,0,0
"Cambodia","2024-08-28",0,0,12,0,0,12,0,0
"Cambodia","2024-08-29",0,0,12,0,0,12,0,0
"Cambodia","2024-08-30",0,0,12,0,0,12,0,0
"Cambodia","2024-08-31",0,0,12,0,0,12,0,0
"Cambodia","2024-09-01",0,0,12,0,0,12,0,0
"Cambodia","2024-09-02",0,0,12,0,0,12,0,0
"Cambodia","2024-09-03",0,0,12,0,0,12,0,0
"Cambodia","2024-09-04",0,0,12,0,0,12,0,0
"Cambodia","2024-09-05",0,0,12,0,0,12,0,0
"Cambodia","2024-09-06",0,0,12,0,0,12,0,0
"Cambodia","2024-09-07",0,0,12,0,0,12,0,0
"Cambodia","2024-09-08",0,0,12,0,0,12,0,0
"Cambodia","2024-09-09",0,0,12,0,0,12,0,0
"Cambodia","2024-09-10",0,0,12,0,0,12,0,0
"Cambodia","2024-09-11",0,0,12,0,0,12,0,0
"Cambodia","2024-09-12",0,0,12,0,0,12,0,0
"Cambodia","2024-09-13",0,0,12,0,0,12,0,0
"Cambodia","2024-09-14",0,0,12,0,0,12,0,0
"Cambodia","2024-09-15",0,0,12,0,0,12,0,0
"Cambodia","2024-09-16",0,0,12,0,0,12,0,0
"Cambodia","2024-09-17",0,0,12,0,0,12,0,0
"Cambodia","2024-09-18",0,0,12,0,0,12,0,0
"Cambodia","2024-09-19",0,0,12,0,0,12,0,0
"Cambodia","2024-09-20",0,0,12,0,0,12,0,0
"Cambodia","2024-09-21",0,0,12,0,0,12,0,0
"Cambodia","2024-09-22",0,0,12,0,0,12,0,0
"Cambodia","2024-09-23",0,0,12,0,0,12,0,0
"Cambodia","2024-09-24",0,0,12,0,0,12,0,0
"Cambodia","2024-09-25",0,0,12,0,0,12,0,0
"Cambodia","2024-09-26",0,0,12,0,0,12,0,0
"Cambodia","2024-09-27",0,0,12,0,0,12,0,0
"Cambodia","2024-09-28",0,0,12,0,0,12,0,0
"Cambodia","2024-09-29",0,0,12,0,0,12,0,0
"Cambodia","2024-09-30",0,0,12,0,0,12,0,0
"Cambodia","2024-10-01",0,0,12,0,0,12,0,0
"Cambodia","2024-10-02",0,0,12,0,0,12,0,0
"Cambodia","2024-10-03",0,0,12,0,0,12,0,0
"Cambodia","2024-10-04",0,0,12,0,0,12,0,0
"Cambodia","2024-10-05",0,0,12,0,0,12,0,0
"Cambodia","2024-10-06",0,0,12,0,0,12,0,0
"Cambodia","2024-10-07",0,0,12,0,0,12,0,0
"Cambodia","2024-10-08",0,0,12,0,0,12,0,0
"Cambodia","2024-10-09",0,0,12,0,0,12,0,0
"Cambodia","2024-10-10",0,0,12,0,0,12,0,0
"Cambodia","2024-10-11",0,0,12,0,0,12,0,0
"Cambodia","2024-10-12",0,0,12,0,0,12,0,0
"Cambodia","2024-10-13",0,0,12,0,0,12,0,0
"Cambodia","2024-10-14",0,0,12,0,0,12,0,0
"Cambodia","2024-10-15",0,0,12,0,0,12,0,0
"Cambodia","2024-10-16",0,0,12,0,0,12,0,0
"Cambodia","2024-10-17",0,0,12,0,0,12,0,0
"Cambodia","2024-10-18",0,0,12,0,0,12,0,0
"Cambodia","2024-10-19",0,0,12,0,0,12,0,0
"Cambodia","2024-10-20",0,0,12,0,0,12,0,0
"Cambodia","2024-10-21",0,0,12,0,0,12,0,0
"Cambodia","2024-10-22",0,0,12,0,0,12,0,0
"Cambodia","2024-10-23",0,0,12,0,0,12,0,0
"Cambodia","2024-10-24",0,0,12,0,0,12,0,0
"Cambodia","2024-10-25",0,0,12,0,0,12,0,0
"Cambodia","2024-10-26",0,0,12,0,0,12,0,0
"Cambodia","2024-10-27",0,0,12,0,0,12,0,0
"Cambodia","2024-10-28",0,0,12,0,0,12,0,0
"Cambodia","2024-10-29",0,0,12,0,0,12,0,0
"Cambodia","2024-10-30",0,0,12,0,0,12,0,0
"Cambodia","2024-10-31",0,0,12,0,0,12,0,0
"Cambodia","2024-11-01",0,0,12,0,0,12,0,0
"Cambodia","2024-11-02",0,0,12,0,0,12,0,0
"Cambodia","2024-11-03",0,0,12,0,0,12,0,0
"Cambodia","2024-11-04",0,0,12,0,0,12,0,0
"Cambodia","2024-11-05",0,0,12,0,0,12,0,0
"Cambodia","2024-11-06",0,0,12,0,0,12,0,0
"Cambodia","2024-11-07",0,0,12,0,0,12,0,0
"Cambodia","2024-11-08",0,0,12,0,0,12,0,0
"Cambodia","2024-11-09",0,0,12,0,0,12,0,0
"Cambodia","2024-11-10",0,0,12,0,0,12,0,0
"Cambodia","2024-11-11",0,0,12,0,0,12,0,0
"Cambodia","2024-11-12",0,0,12,0,0,12,0,0
"Cambodia","2024-11-13",0,0,12,0,0,12,0,0
"Cambodia","2024-11-14",0,0,12,0,0,12,0,0
"Cambodia","2024-11-15",0,0,12,0,0,12,0,0
"Cambodia","2024-11-16",0,0,12,0,0,12,0,0
"Cambodia","2024-11-17",0,0,12,0,0,12,0,0
"Cambodia","2024-11-18",0,0,12,0,0,12,0,0
"Cambodia","2024-11-19",0,0,12,0,0,12,0,0
"Cambodia","2024-11-20",0,0,12,0,0,12,0,0
"Cambodia","2024-11-21",0,0,12,0,0,12,0,0
"Cambodia","2024-11-22",0,0,12,0,0,12,0,0
"Cambodia","2024-11-23",0,0,12,0,0,12,0,0
"Cambodia","2024-11-24",0,0,12,0,0,12,0,0
"Cambodia","2024-11-25",0,0,12,0,0,12,0,0
"Cambodia","2024-11-26",0,0,12,0,0,12,0,0
"Cambodia","2024-11-27",0,0,12,0,0,12,0,0
"Cambodia","2024-11-28",0,0,12,0,0,12,0,0
"Cambodia","2024-11-29",0,0,12,0,0,12,0,0
"Cambodia","2024-11-30",0,0,12,0,0,12,0,0
"Cambodia","2024-12-01",0,0,12,0,0,12,0,0
"Cambodia","2024-12-02",0,0,12,0,0,12,0,0
"Cambodia","2024-12-03",0,0,12,0,0,12,0,0
"Cambodia","2024-12-04",0,0,12,0,0,12,0,0
"Cambodia","2024-12-05",0,0,12,0,0,12,0,0
"Cambodia","2024-12-06",0,0,12,0,0,12,0,0
"Cambodia","2024-12-07",0,0,12,0,0,12,0,0
"Cambodia","2024-12-08",0,0,12,0,0,12,0,0
"Cambodia","2024-12-09",0,0,12,0,0,12,0,0
"Cambodia","2024-12-10",0,0,12,0,0,12,0,0
"Cambodia","2024-12-11",0,0,12,0,0,12,0,0
"Cambodia","2024-12-12",0,0,12,0,0,12,0,0
"Cambodia","2024-12-13",0,0,12,0,0,12,0,0
"Cambodia","2024-12-14",0,0,12,0,0,12,0,0
"Cambodia","2024-12-15",0,0,12,0,0,12,0,0
"Cambodia","2024-12-16",0,0,12,0,0,12,0,0
"Cambodia","2024-12-17",0,0,12,0,0,12,0,0
"Cambodia","2024-12-18",0,0,12,0,0,12,0,0
"Cambodia","2024-12-19",0,0,12,0,0,12,0,0
"Cambodia","2024-12-20",0,0,12,0,0,12,0,0
"Cambodia","2024-12-21",0,0,12,0,0,12,0,0
"Cambodia","2024-12-22",0,0,12,0,0,12,0,0
"Cambodia","2024-12-23",0,0,12,0,0,12,0,0
"Cambodia","2024-12-24",0,0,12,0,0,12,0,0
"Cambodia","2024-12-25",0,0,12,0,0,12,0,0
"Cambodia","2024-12-26",0,0,12,0,0,12,0,0
"Cambodia","2024-12-27",0,0,12,0,0,12,0,0
"Cambodia","2024-12-28",0,0,12,0,0,12,0,0
"Cambodia","2024-12-29",0,0,12,0,0,12,0,0
"Cambodia","2024-12-30",0,0,12,0,0,12,0,0
"Cambodia","2024-12-31",0,0,12,0,0,12,0,0
"Cambodia","2025-01-01",0,0,12,0,0,12,0,0
"Cambodia","2025-01-02",0,0,12,0,0,12,0,0
"Cambodia","2025-01-03",0,0,12,0,0,12,0,0
"Cambodia","2025-01-04",0,0,12,0,0,12,0,0
"Cambodia","2025-01-05",0,0,12,0,0,12,0,0
"Cambodia","2025-01-06",0,0,12,0,0,12,0,0
"Cambodia","2025-01-07",0,0,12,0,0,12,0,0
"Cambodia","2025-01-08",0,0,12,0,0,12,0,0
"Cambodia","2025-01-09",0,0,12,0,0,12,0,0
"Cambodia","2025-01-10",0,0,12,0,0,12,0,0
"Cambodia","2025-01-11",0,0,12,0,0,12,0,0
"Cambodia","2025-01-12",0,0,12,0,0,12,0,0
"Cambodia","2025-01-13",0,0,12,0,0,12,0,0
"Cambodia","2025-01-14",0,0,12,0,0,12,0,0
"Cambodia","2025-01-15",0,0,12,0,0,12,0,0
"Cambodia","2025-01-16",0,0,12,0,0,12,0,0
"Cambodia","2025-01-17",0,0,12,0,0,12,0,0
"Cambodia","2025-01-18",0,0,12,0,0,12,0,0
"Cambodia","2025-01-19",0,0,12,0,0,12,0,0
"Cambodia","2025-01-20",0,0,12,0,0,12,0,0
"Cambodia","2025-01-21",0,0,12,0,0,12,0,0
"Cambodia","2025-01-22",0,0,12,0,0,12,0,0
"Cambodia","2025-01-23",0,0,12,0,0,12,0,0
"Cambodia","2025-01-24",0,0,12,0,0,12,0,0
"Cambodia","2025-01-25",0,0,12,0,0,12,0,0
"Cambodia","2025-01-26",0,0,12,0,0,12,0,0
"Cambodia","2025-01-27",0,0,12,0,0,12,0,0
"Cambodia","2025-01-28",0,0,12,0,0,12,0,0
"Cambodia","2025-01-29",0,0,12,0,0,12,0,0
"Cambodia","2025-01-30",0,0,12,0,0,12,0,0
"Cambodia","2025-01-31",0,0,12,0,0,12,0,0
"Cambodia","2025-02-01",0,0,12,0,0,12,0,0
"Cambodia","2025-02-02",0,0,12,0,0,12,0,0
"Cambodia","2025-02-03",0,0,12,0,0,12,0,0
"Cameroon","2024-01-01",0,0,0,0,0,0,0,0
"Cameroon","2024-01-02",0,0,0,0,0,0,0,0
"Cameroon","2024-01-03",0,0,0,0,0,0,0,0
"Cameroon","2024-01-04",0,0,0,0,0,0,0,0
"Cameroon","2024-01-05",0,0,0,0,0,0,0,0
"Cameroon","2024-01-06",0,0,0,0,0,0,0,0
"Cameroon","2024-01-07",0,0,0,0,0,0,0,0
"Cameroon","2024-01-08",0,0,0,0,0,0,0,0
"Cameroon","2024-01-09",0,0,0,0,0,0,0,0
"Cameroon","2024-01-10",0,0,0,0,0,0,0,0
"Cameroon","2024-01-11",0,0,0,0,0,0,0,0
"Cameroon","2024-01-12",0,0,0,0,0,0,0,0
"Cameroon","2024-01-13",0,0,0,0,0,0,0,0
"Cameroon","2024-01-14",0,2,2,0,2,2,0,0
"Cameroon","2024-01-15",0,0,2,0,0,2,0,0
"Cameroon","2024-01-16",0,0,2,0,0,2,0,0
"Cameroon","2024-01-17",0,0,2,0,0,2,0,0
"Cameroon","2024-01-18",0,0,2,0,0,2,0,0
"Cameroon","2024-01-19",0,0,2,0,0,2,0,0
"Cameroon","2024-01-20",0,0,2,0,0,2,0,0
"Cameroon","2024-01-21",0,0,2,0,0,2,0,0
"Cameroon","2024-01-22",0,0,2,0,0,2,0,0
"Cameroon","2024-01-23",0,0,2,0,0,2,0,0
"Cameroon","2024-01-24",0,0,2,0,0,2,0,0
"Cameroon","2024-01-25",0,0,2,0,0,2,0,0
"Cameroon","2024-01-26",0,0,2,0,0,2,0,0
"Cameroon","2024-01-27",0,0,2,0,0,2,0,0
"Cameroon","2024-01-28",0,0,2,0,0,2,0,0
"Cameroon","2024-01-29",0,0,2,0,0,2,0,0
"Cameroon","2024-01-30",0,0,2,0,0,2,0,0
"Cameroon","2024-01-31",0,0,2,0,0,2,0,0
"Cameroon","2024-02-01",0,0,2,0,0,2,0,0
"Cameroon","2024-02-02",0,0,2,0,0,2,0,0
"Cameroon","2024-02-03",0,0,2,0,0,2,0,0
"Cameroon","2024-02-04",0,0,2,0,0,2,0,0
"Cameroon","2024-02-05",0,0,2,0,0,2,0,0
"Cameroon","2024-02-06",0,0,2,0,0,2,0,0
"Cameroon","2024-02-07",0,0,2,0,0,2,0,0
"Cameroon","2024-02-08",0,0,2,0,0,2,0,0
"Cameroon","2024-02-09",0,0,2,0,0,2,0,0
"Cameroon","2024-02-10",0,0,2,0,0,2,0,0
"Cameroon","2024-02-11",0,0,2,0,0,2,0,0
"Cameroon","2024-02-12",0,0,2,0,0,2,0,0
"Cameroon","2024-02-13",0,0,2,0,0,2,0,0
"Cameroon","2024-02-14",0,0,2,0,0,2,0,0
"Cameroon","2024-02-15",0,0,2,0,0,2,0,0
"Cameroon","2024-02-16",0,0,2,0,0,2,0,0
"Cameroon","2024-02-17",0,0,2,0,0,2,0,0
"Cameroon","2024-02-18",0,0,2,0,0,2,0,0
"Cameroon","2024-02-19",0,0,2,0,0,2,0,0
"Cameroon","2024-02-20",0,0,2,0,0,2,0,0
"Cameroon","2024-02-21",0,0,2,0,0,2,0,0
"Cameroon","2024-02-22",0,0,2,0,0,2,0,0
"Cameroon","2024-02-23",0,0,2,0,0,2,0,0
"Cameroon","2024-02-24",0,0,2,0,0,2,0,0
"Cameroon","2024-02-25",0,0,2,0,0,2,0,0
"Cameroon","2024-02-26",0,0,2,0,1,3,0,0
"Cameroon","2024-02-27",0,0,2,0,0,3,0,0
"Cameroon","2024-02-28",0,0,2,0,0,3,0,0
"Cameroon","2024-02-29",0,0,2,0,0,3,0,0
"Cameroon","2024-03-01",0,0,2,0,0,3,0,0
"Cameroon","2024-03-02",0,0,2,0,0,3,0,0
"Cameroon","2024-03-03",0,0,2,0,0,3,0,0
"Cameroon","2024-03-04",0,0,2,0,0,3,0,0
"Cameroon","2024-03-05",0,0,2,0,0,3,0,0
"Cameroon","2024-03-06",0,0,2,0,0,3,0,0
"Cameroon","2024-03-07",0,0,2,0,0,3,0,0
"Cameroon","2024-03-08",0,0,2,0,0,3,0,0
"Cameroon","2024-03-09",0,0,2,0,0,3,0,0
"Cameroon","2024-03-10",0,0,2,0,0,3,0,0
"Cameroon","2024-03-11",0,0,2,0,0,3,0,0
"Cameroon","2024-03-12",0,0,2,0,0,3,0,0
"Cameroon","2024-03-13",0,0,2,0,0,3,0,0
"Cameroon","2024-03-14",0,0,2,0,0,3,0,0
"Cameroon","2024-03-15",0,0,2,0,0,3,0,0
"Cameroon","2024-03-16",0,0,2,0,0,3,0,0
"Cameroon","2024-03-17",0,0,2,0,0,3,0,0
"Cameroon","2024-03-18",0,0,2,0,0,3,0,0
"Cameroon","2024-03-19",0,0,2,0,0,3,0,0
"Cameroon","2024-03-20",0,0,2,0,0,3,0,0
"Cameroon","2024-03-21",0,0,2,0,0,3,0,0
"Cameroon","2024-03-22",0,0,2,0,0,3,0,0
"Cameroon","2024-03-23",0,0,2,0,0,3,0,0
"Cameroon","2024-03-24",0,0,2,0,0,3,0,0
"Cameroon","2024-03-25",0,0,2,0,0,3,0,0
"Cameroon","2024-03-26",0,0,2,0,0,3,0,0
"Cameroon","2024-03-27",0,0,2,0,0,3,0,0
"Cameroon","2024-03-28",0,0,2,0,0,3,0,0
"Cameroon","2024-03-29",0,0,2,0,0,3,0,0
"Cameroon","2024-03-30",0,0,2,0,0,3,0,0
"Cameroon","2024-03-31",0,0,2,0,0,3,0,0
"Cameroon","2024-04-01",0,0,2,0,0,3,0,0
"Cameroon","2024-04-02",0,0,2,0,0,3,0,0
"Cameroon","2024-04-03",0,0,2,0,0,3,0,0
"Cameroon","2024-04-04",0,0,2,0,0,3,0,0
"Cameroon","2024-04-05",0,0,2,0,0,3,0,0
"Cameroon","2024-04-06",0,0,2,0,0,3,0,0
"Cameroon","2024-04-07",0,1,3,0,0,3,0,0
"Cameroon","2024-04-08",0,0,3,0,0,3,0,0
"Cameroon","2024-04-09",0,0,3,0,1,4,0,0
"Cameroon","2024-04-10",0,0,3,0,0,4,0,0
"Cameroon","2024-04-11",0,0,3,0,0,4,0,0
"Cameroon","2024-04-12",0,0,3,0,0,4,0,0
"Cameroon","2024-04-13",0,0,3,0,1,5,0,0
"Cameroon","2024-04-14",0,2,5,0,0,5,0,0
"Cameroon","2024-04-15",0,0,5,0,0,5,0,0
"Cameroon","2024-04-16",0,0,5,0,0,5,0,0
"Cameroon","2024-04-17",0,0,5,0,0,5,0,0
"Cameroon","2024-04-18",0,0,5,0,0,5,0,0
"Cameroon","2024-04-19",0,0,5,0,0,5,0,0
"Cameroon","2024-04-20",0,0,5,0,0,5,0,0
"Cameroon","2024-04-21",0,0,5,0,0,5,0,0
"Cameroon","2024-04-22",0,0,5,0,0,5,0,0
"Cameroon","2024-04-23",0,0,5,0,0,5,0,0
"Cameroon","2024-04-24",0,0,5,0,0,5,0,0
"Cameroon","2024-04-25",0,0,5,0,0,5,0,0
"Cameroon","2024-04-26",0,0,5,0,0,5,0,0
"Cameroon","2024-04-27",0,0,5,0,0,5,0,0
"Cameroon","2024-04-28",0,0,5,0,0,5,0,0
"Cameroon","2024-04-29",0,0,5,0,0,5,0,0
"Cameroon","2024-04-30",0,0,5,0,0,5,0,0
"Cameroon","2024-05-01",0,0,5,0,0,5,0,0
"Cameroon","2024-05-02",0,0,5,0,0,5,0,0
"Cameroon","2024-05-03",0,0,5,0,0,5,0,0
"Cameroon","2024-05-04",0,0,5,0,0,5,0,0
"Cameroon","2024-05-05",0,0,5,0,0,5,0,0
"Cameroon","2024-05-06",0,0,5,0,0,5,0,0
"Cameroon","2024-05-07",0,0,5,0,0,5,0,0
"Cameroon","2024-05-08",0,0,5,0,0,5,0,0
"Cameroon","2024-05-09",0,0,5,0,0,5,0,0
"Cameroon","2024-05-10",0,0,5,0,0,5,0,0
"Cameroon","2024-05-11",0,0,5,0,0,5,0,0
"Cameroon","2024-05-12",0,0,5,0,0,5,0,0
"Cameroon","2024-05-13",0,0,5,0,0,5,0,0
"Cameroon","2024-05-14",0,0,5,0,0,5,0,0
"Cameroon","2024-05-15",0,0,5,0,0,5,0,0
"Cameroon","2024-05-16",0,0,5,0,0,5,0,0
"Cameroon","2024-05-17",0,0,5,0,0,5,0,0
"Cameroon","2024-05-18",0,0,5,0,0,5,0,0
"Cameroon","2024-05-19",0,0,5,0,0,5,0,0
"Cameroon","2024-05-20",0,0,5,0,0,5,0,0
"Cameroon","2024-05-21",0,0,5,0,0,5,0,0
"Cameroon","2024-05-22",0,0,5,0,0,5,0,0
"Cameroon","2024-05-23",0,0,5,0,0,5,0,0
"Cameroon","2024-05-24",0,0,5,0,0,5,0,0
"Cameroon","2024-05-25",0,0,5,0,0,5,0,0
"Cameroon","2024-05-26",0,0,5,0,0,5,0,0
"Cameroon","2024-05-27",0,0,5,0,0,5,0,0
"Cameroon","2024-05-28",0,0,5,0,0,5,0,0
"Cameroon","2024-05-29",0,0,5,0,0,5,0,0
"Cameroon","2024-05-30",0,0,5,0,0,5,0,0
"Cameroon","2024-05-31",0,0,5,0,0,5,0,0
"Cameroon","2024-06-01",0,0,5,0,0,5,0,0
"Cameroon","2024-06-02",0,0,5,0,0,5,0,0
"Cameroon","2024-06-03",0,0,5,0,0,5,0,0
"Cameroon","2024-06-04",0,0,5,0,0,5,0,0
"Cameroon","2024-06-05",0,0,5,0,0,5,0,0
"Cameroon","2024-06-06",0,0,5,0,0,5,0,0
"Cameroon","2024-06-07",0,0,5,0,0,5,0,0
"Cameroon","2024-06-08",0,0,5,0,0,5,0,0
"Cameroon","2024-06-09",0,0,5,0,0,5,0,0
"Cameroon","2024-06-10",0,0,5,0,0,5,0,0
"Cameroon","2024-06-11",0,0,5,0,0,5,0,0
"Cameroon","2024-06-12",0,0,5,0,0,5,0,0
"Cameroon","2024-06-13",0,0,5,0,0,5,0,0
"Cameroon","2024-06-14",0,0,5,0,0,5,0,0
"Cameroon","2024-06-15",0,0,5,0,0,5,0,0
"Cameroon","2024-06-16",0,0,5,0,0,5,0,0
"Cameroon","2024-06-17",0,0,5,0,0,5,0,0
"Cameroon","2024-06-18",0,0,5,0,0,5,0,0
"Cameroon","2024-06-19",0,0,5,0,0,5,0,0
"Cameroon","2024-06-20",0,0,5,0,0,5,0,0
"Cameroon","2024-06-21",0,0,5,0,0,5,0,0
"Cameroon","2024-06-22",0,0,5,0,0,5,0,0
"Cameroon","2024-06-23",0,0,5,0,0,5,0,0
"Cameroon","2024-06-24",0,0,5,0,1,6,0,0
"Cameroon","2024-06-25",0,0,5,0,0,6,0,0
"Cameroon","2024-06-26",0,0,5,0,0,6,0,0
"Cameroon","2024-06-27",0,0,5,0,0,6,0,0
"Cameroon","2024-06-28",0,0,5,0,0,6,0,0
"Cameroon","2024-06-29",0,0,5,0,0,6,0,0
"Cameroon","2024-06-30",0,0,5,0,0,6,0,0
"Cameroon","2024-07-01",0,0,5,0,0,6,0,0
"Cameroon","2024-07-02",0,0,5,0,0,6,0,0
"Cameroon","2024-07-03",0,0,5,0,0,6,0,0
"Cameroon","2024-07-04",0,0,5,0,0,6,0,0
"Cameroon","2024-07-05",0,0,5,0,0,6,0,0
"Cameroon","2024-07-06",0,0,5,0,0,6,0,0
"Cameroon","2024-07-07",0,0,5,0,0,6,0,0
"Cameroon","2024-07-08",0,0,5,0,0,6,0,0
"Cameroon","2024-07-09",0,0,5,0,0,6,0,0
"Cameroon","2024-07-10",0,0,5,0,0,6,0,0
"Cameroon","2024-07-11",0,0,5,0,0,6,0,0
"Cameroon","2024-07-12",0,0,5,0,0,6,0,0
"Cameroon","2024-07-13",0,0,5,0,0,6,0,0
"Cameroon","2024-07-14",0,0,5,0,0,6,0,0
"Cameroon","2024-07-15",0,0,5,0,0,6,0,0
"Cameroon","2024-07-16",0,0,5,0,0,6,0,0
"Cameroon","2024-07-17",0,0,5,0,0,6,0,0
"Cameroon","2024-07-18",0,0,5,0,0,6,0,0
"Cameroon","2024-07-19",0,0,5,0,0,6,0,0
"Cameroon","2024-07-20",0,0,5,0,0,6,0,0
"Cameroon","2024-07-21",0,0,5,0,0,6,0,0
"Cameroon","2024-07-22",0,0,5,0,0,6,0,0
"Cameroon","2024-07-23",0,0,5,0,0,6,0,0
"Cameroon","2024-07-24",0,0,5,0,0,6,0,0
"Cameroon","2024-07-25",0,0,5,0,0,6,0,0
"Cameroon","2024-07-26",0,0,5,0,0,6,0,0
"Cameroon","2024-07-27",0,0,5,0,0,6,0,0
"Cameroon","2024-07-28",0,0,5,0,0,6,0,0
"Cameroon","2024-07-29",0,0,5,0,0,6,0,0
"Cameroon","2024-07-30",0,0,5,0,0,6,0,0
"Cameroon","2024-07-31",0,0,5,0,0,6,0,0
"Cameroon","2024-08-01",0,0,5,0,0,6,0,0
"Cameroon","2024-08-02",0,0,5,0,0,6,0,0
"Cameroon","2024-08-03",0,0,5,0,0,6,0,0
"Cameroon","2024-08-04",0,0,5,0,0,6,0,0
"Cameroon","2024-08-05",0,0,5,0,0,6,0,0
"Cameroon","2024-08-06",0,0,5,0,0,6,0,0
"Cameroon","2024-08-07",0,0,5,0,0,6,0,0
"Cameroon","2024-08-08",0,0,5,0,0,6,0,0
"Cameroon","2024-08-09",0,0,5,0,0,6,0,0
"Cameroon","2024-08-10",0,0,5,0,0,6,0,0
"Cameroon","2024-08-11",0,0,5,0,0,6,0,0
"Cameroon","2024-08-12",0,0,5,0,0,6,0,0
"Cameroon","2024-08-13",0,0,5,0,0,6,0,0
"Cameroon","2024-08-14",0,0,5,0,0,6,0,0
"Cameroon","2024-08-15",0,0,5,0,0,6,0,0
"Cameroon","2024-08-16",30,0,5,30,0,6,30,30
"Cameroon","2024-08-17",0,0,5,30,0,6,0,30
"Cameroon","2024-08-18",0,0,5,30,0,6,1,31
"Cameroon","2024-08-19",0,0,5,30,0,6,0,31
"Cameroon","2024-08-20",0,0,5,30,0,6,0,31
"Cameroon","2024-08-21",0,0,5,30,0,6,1,32
"Cameroon","2024-08-22",0,0,5,30,0,6,0,32
"Cameroon","2024-08-23",0,0,5,30,0,6,0,32
"Cameroon","2024-08-24",0,0,5,30,0,6,0,32
"Cameroon","2024-08-25",0,0,5,30,0,6,1,33
"Cameroon","2024-08-26",0,0,5,30,0,6,0,33
"Cameroon","2024-08-27",0,0,5,30,0,6,0,33
"Cameroon","2024-08-28",0,0,5,30,0,6,1,34
"Cameroon","2024-08-29",0,0,5,30,0,6,0,34
"Cameroon","2024-08-30",0,0,5,30,0,6,0,34
"Cameroon","2024-08-31",0,0,5,30,0,6,1,35
"Cameroon","2024-09-01",0,1,6,30,0,6,0,35
"Cameroon","2024-09-02",0,0,6,30,0,6,0,35
"Cameroon","2024-09-03",0,0,6,30,0,6,0,35
"Cameroon","2024-09-04",0,0,6,30,0,6,1,36
"Cameroon","2024-09-05",0,0,6,30,0,6,0,36
"Cameroon","2024-09-06",0,0,6,30,0,6,0,36
"Cameroon","2024-09-07",0,0,6,30,0,6,1,37
"Cameroon","2024-09-08",7,0,6,37,0,6,0,37
"Cameroon","2024-09-09",0,0,6,37,0,6,1,38
"Cameroon","2024-09-10",0,0,6,37,0,6,1,39
"Cameroon","2024-09-11",0,0,6,37,0,6,0,39
"Cameroon","2024-09-12",3,0,6,40,0,6,1,40
"Cameroon","2024-09-13",0,0,6,40,0,6,2,42
"Cameroon","2024-09-14",0,0,6,40,1,7,2,44
"Cameroon","2024-09-15",0,0,6,40,0,7,2,46
"Cameroon","2024-09-16",0,0,6,40,0,7,2,48
"Cameroon","2024-09-17",0,0,6,40,0,7,2,50
"Cameroon","2024-09-18",0,0,6,40,0,7,2,52
"Cameroon","2024-09-19",0,0,6,40,0,7,2,54
"Cameroon","2024-09-20",0,0,6,40,0,7,2,56
"Cameroon","2024-09-21",0,0,6,40,0,7,2,58
"Cameroon","2024-09-22",0,0,6,40,0,7,1,59
"Cameroon","2024-09-23",0,0,6,40,0,7,2,61
"Cameroon","2024-09-24",0,0,6,40,0,7,2,63
"Cameroon","2024-09-25",0,0,6,40,0,7,2,65
"Cameroon","2024-09-26",0,0,6,40,0,7,2,67
"Cameroon","2024-09-27",0,0,6,40,0,7,2,69
"Cameroon","2024-09-28",0,0,6,40,0,7,2,71
"Cameroon","2024-09-29",0,0,6,40,0,7,2,73
"Cameroon","2024-09-30",35,0,6,75,0,7,2,75
"Cameroon","2024-10-01",0,0,6,75,0,7,1,76
"Cameroon","2024-10-02",0,0,6,75,0,7,2,78
"Cameroon","2024-10-03",0,0,6,75,0,7,1,79
"Cameroon","2024-10-04",0,0,6,75,0,7,1,80
"Cameroon","2024-10-05",0,0,6,75,0,7,2,82
"Cameroon","2024-10-06",8,0,6,83,0,7,1,83
"Cameroon","2024-10-07",0,0,6,83,0,7,2,85
"Cameroon","2024-10-08",0,0,6,83,0,7,1,86
"Cameroon","2024-10-09",0,0,6,83,0,7,1,87
"Cameroon","2024-10-10",0,0,6,83,1,8,2,89
"Cameroon","2024-10-11",0,0,6,83,0,8,2,91
"Cameroon","2024-10-12",9,0,6,92,0,8,1,92
"Cameroon","2024-10-13",2,0,6,94,0,8,2,94
"Cameroon","2024-10-14",0,0,6,94,0,8,0,94
"Cameroon","2024-10-15",0,0,6,94,0,8,1,95
"Cameroon","2024-10-16",0,0,6,94,0,8,0,95
"Cameroon","2024-10-17",0,0,6,94,0,8,1,96
"Cameroon","2024-10-18",0,0,6,94,0,8,0,96
"Cameroon","2024-10-19",0,0,6,94,0,8,1,97
"Cameroon","2024-10-20",3,0,6,97,0,8,0,97
"Cameroon","2024-10-21",0,0,6,97,0,8,0,97
"Cameroon","2024-10-22",0,0,6,97,0,8,1,98
"Cameroon","2024-10-23",0,0,6,97,0,8,0,98
"Cameroon","2024-10-24",0,0,6,97,0,8,0,98
"Cameroon","2024-10-25",0,0,6,97,0,8,0,98
"Cameroon","2024-10-26",0,0,6,97,0,8,1,99
"Cameroon","2024-10-27",2,0,6,99,0,8,0,99
"Cameroon","2024-10-28",0,0,6,99,0,8,1,100
"Cameroon","2024-10-29",0,0,6,99,0,8,0,100
"Cameroon","2024-10-30",0,0,6,99,0,8,1,101
"Cameroon","2024-10-31",0,0,6,99,0,8,0,101
"Cameroon","2024-11-01",0,0,6,99,0,8,1,102
"Cameroon","2024-11-02",0,0,6,99,0,8,0,102
"Cameroon","2024-11-03",4,0,6,103,0,8,1,103
"Cameroon","2024-11-04",0,0,6,103,0,8,0,103
"Cameroon","2024-11-05",0,0,6,103,1,9,0,103
"Cameroon","2024-11-06",0,0,6,103,0,9,0,103
"Cameroon","2024-11-07",0,0,6,103,0,9,0,103
"Cameroon","2024-11-08",0,0,6,103,0,9,0,103
"Cameroon","2024-11-09",0,0,6,103,0,9,0,103
"Cameroon","2024-11-10",0,0,6,103,0,9,0,103
"Cameroon","2024-11-11",0,0,6,103,0,9,0,103
"Cameroon","2024-11-12",0,0,6,103,0,9,0,103
"Cameroon","2024-11-13",0,0,6,103,0,9,0,103
"Cameroon","2024-11-14",0,0,6,103,0,9,0,103
"Cameroon","2024-11-15",0,0,6,103,0,9,0,103
"Cameroon","2024-11-16",0,0,6,103,0,9,0,103
"Cameroon","2024-11-17",0,3,9,103,0,9,0,103
"Cameroon","2024-11-18",0,0,9,103,0,9,0,103
"Cameroon","2024-11-19",0,0,9,103,0,9,0,103
"Cameroon","2024-11-20",0,0,9,103,0,9,0,103
"Cameroon","2024-11-21",0,0,9,103,0,9,0,103
"Cameroon","2024-11-22",0,0,9,103,0,9,0,103
"Cameroon","2024-11-23",0,0,9,103,0,9,0,103
"Cameroon","2024-11-24",0,0,9,103,0,9,0,103
"Cameroon","2024-11-25",0,0,9,103,0,9,0,103
"Cameroon","2024-11-26",0,0,9,103,0,9,0,103
"Cameroon","2024-11-27",0,0,9,103,0,9,0,103
"Cameroon","2024-11-28",0,0,9,103,0,9,0,103
"Cameroon","2024-11-29",0,0,9,103,0,9,0,103
"Cameroon","2024-11-30",0,0,9,103,0,9,0,103
"Cameroon","2024-12-01",0,0,9,103,0,9,0,103
"Cameroon","2024-12-02",0,0,9,103,0,9,0,103
"Cameroon","2024-12-03",0,0,9,103,0,9,0,103
"Cameroon","2024-12-04",0,0,9,103,0,9,0,103
"Cameroon","2024-12-05",0,0,9,103,0,9,0,103
"Cameroon","2024-12-06",0,0,9,103,0,9,0,103
"Cameroon","2024-12-07",0,0,9,103,0,9,0,103
"Cameroon","2024-12-08",0,0,9,103,0,9,0,103
"Cameroon","2024-12-09",0,0,9,103,0,9,0,103
"Cameroon","2024-12-10",0,0,9,103,0,9,0,103
"Cameroon","2024-12-11",0,0,9,103,0,9,0,103
"Cameroon","2024-12-12",0,0,9,103,0,9,0,103
"Cameroon","2024-12-13",0,0,9,103,0,9,0,103
"Cameroon","2024-12-14",0,0,9,103,0,9,0,103
"Cameroon","2024-12-15",0,0,9,103,0,9,0,103
"Cameroon","2024-12-16",0,0,9,103,0,9,0,103
"Cameroon","2024-12-17",0,0,9,103,0,9,0,103
"Cameroon","2024-12-18",0,0,9,103,0,9,0,103
"Cameroon","2024-12-19",0,0,9,103,0,9,0,103
"Cameroon","2024-12-20",0,0,9,103,0,9,0,103
"Cameroon","2024-12-21",0,0,9,103,0,9,0,103
"Cameroon","2024-12-22",0,0,9,103,0,9,0,103
"Cameroon","2024-12-23",0,0,9,103,0,9,0,103
"Cameroon","2024-12-24",0,0,9,103,0,9,0,103
"Cameroon","2024-12-25",0,0,9,103,0,9,0,103
"Cameroon","2024-12-26",0,0,9,103,0,9,0,103
"Cameroon","2024-12-27",0,0,9,103,0,9,0,103
"Cameroon","2024-12-28",0,0,9,103,0,9,0,103
"Cameroon","2024-12-29",0,0,9,103,0,9,0,103
"Cameroon","2024-12-30",0,0,9,103,0,9,0,103
"Cameroon","2024-12-31",0,0,9,103,0,9,0,103
"Cameroon","2025-01-01",0,0,9,103,0,9,0,103
"Cameroon","2025-01-02",0,0,9,103,0,9,0,103
"Cameroon","2025-01-03",0,0,9,103,0,9,0,103
"Cameroon","2025-01-04",0,0,9,103,0,9,0,103
"Cameroon","2025-01-05",0,0,9,103,0,9,0,103
"Cameroon","2025-01-06",0,0,9,103,0,9,0,103
"Cameroon","2025-01-07",0,0,9,103,0,9,0,103
"Cameroon","2025-01-08",0,0,9,103,0,9,0,103
"Cameroon","2025-01-09",0,0,9,103,0,9,0,103
"Cameroon","2025-01-10",0,0,9,103,0,9,0,103
"Cameroon","2025-01-11",0,0,9,103,0,9,0,103
"Cameroon","2025-01-12",0,0,9,103,0,9,0,103
"Cameroon","2025-01-13",0,0,9,103,0,9,0,103
"Cameroon","2025-01-14",0,0,9,103,0,9,0,103
"Cameroon","2025-01-15",0,0,9,103,0,9,0,103
"Cameroon","2025-01-16",0,0,9,103,0,9,0,103
"Cameroon","2025-01-17",0,0,9,103,0,9,0,103
"Cameroon","2025-01-18",0,0,9,103,0,9,0,103
"Cameroon","2025-01-19",0,0,9,103,0,9,0,103
"Cameroon","2025-01-20",0,0,9,103,0,9,0,103
"Cameroon","2025-01-21",0,0,9,103,0,9,0,103
"Cameroon","2025-01-22",0,0,9,103,0,9,0,103
"Cameroon","2025-01-23",0,0,9,103,0,9,0,103
"Cameroon","2025-01-24",0,0,9,103,0,9,0,103
"Cameroon","2025-01-25",0,0,9,103,0,9,0,103
"Cameroon","2025-01-26",0,0,9,103,0,9,0,103
"Cameroon","2025-01-27",0,0,9,103,0,9,0,103
"Cameroon","2025-01-28",0,0,9,103,0,9,0,103
"Cameroon","2025-01-29",0,0,9,103,0,9,0,103
"Cameroon","2025-01-30",0,0,9,103,0,9,0,103
"Cameroon","2025-01-31",0,0,9,103,0,9,0,103
"Cameroon","2025-02-01",0,0,9,103,0,9,0,103
"Cameroon","2025-02-02",0,0,9,103,0,9,0,103
"Cameroon","2025-02-03",0,0,9,103,0,9,0,103
"Canada","2024-01-01",0,0,0,0,0,0,0,0
"Canada","2024-01-02",0,1,1,0,1,1,0,0
"Canada","2024-01-03",0,0,1,0,0,1,0,0
"Canada","2024-01-04",0,0,1,0,0,1,0,0
"Canada","2024-01-05",0,0,1,0,1,2,0,0
"Canada","2024-01-06",0,0,1,0,0,2,0,0
"Canada","2024-01-07",0,0,1,0,0,2,0,0
"Canada","2024-01-08",0,0,1,0,0,2,0,0
"Canada","2024-01-09",0,0,1,0,1,3,0,0
"Canada","2024-01-10",0,0,1,0,0,3,0,0
"Canada","2024-01-11",0,0,1,0,0,3,0,0
"Canada","2024-01-12",0,0,1,0,0,3,0,0
"Canada","2024-01-13",0,0,1,0,0,3,0,0
"Canada","2024-01-14",0,0,1,0,1,4,0,0
"Canada","2024-01-15",0,0,1,0,0,4,0,0
"Canada","2024-01-16",0,3,4,0,0,4,0,0
"Canada","2024-01-17",0,0,4,0,1,5,0,0
"Canada","2024-01-18",0,0,4,0,0,5,0,0
"Canada","2024-01-19",0,0,4,0,1,6,0,0
"Canada","2024-01-20",0,0,4,0,0,6,0,0
"Canada","2024-01-21",0,0,4,0,1,7,0,0
"Canada","2024-01-22",0,0,4,0,0,7,0,0
"Canada","2024-01-23",0,4,8,0,1,8,0,0
"Canada","2024-01-24",0,0,8,0,1,9,0,0
"Canada","2024-01-25",0,0,8,0,1,10,0,0
"Canada","2024-01-26",0,0,8,0,1,11,0,0
"Canada","2024-01-27",0,0,8,0,1,12,0,0
"Canada","2024-01-28",0,0,8,0,1,13,0,0
"Canada","2024-01-29",0,0,8,0,1,14,0,0
"Canada","2024-01-30",0,7,15,0,1,15,0,0
"Canada","2024-01-31",0,0,15,0,1,16,0,0
"Canada","2024-02-01",0,0,15,0,1,17,0,0
"Canada","2024-02-02",0,0,15,0,1,18,0,0
"Canada","2024-02-03",0,0,15,0,2,20,0,0
"Canada","2024-02-04",0,0,15,0,1,21,0,0
"Canada","2024-02-05",0,0,15,0,1,22,0,0
"Canada","2024-02-06",0,8,23,0,1,23,0,0
"Canada","2024-02-07",0,0,23,0,1,24,0,0
"Canada","2024-02-08",0,0,23,0,1,25,0,0
"Canada","2024-02-09",0,0,23,0,1,26,0,0
"Canada","2024-02-10",0,0,23,0,2,28,0,0
"Canada","2024-02-11",0,0,23,0,1,29,0,0
"Canada","2024-02-12",0,0,23,0,1,30,0,0
"Canada","2024-02-13",0,8,31,0,1,31,0,0
"Canada","2024-02-14",0,0,31,0,0,31,0,0
"Canada","2024-02-15",0,0,31,0,0,31,0,0
"Canada","2024-02-16",0,0,31,0,0,31,0,0
"Canada","2024-02-17",0,0,31,0,1,32,0,0
"Canada","2024-02-18",0,0,31,0,0,32,0,0
"Canada","2024-02-19",0,0,31,0,0,32,0,0
"Canada","2024-02-20",0,1,32,0,0,32,0,0
"Canada","2024-02-21",0,0,32,0,1,33,0,0
"Canada","2024-02-22",0,0,32,0,1,34,0,0
"Canada","2024-02-23",0,0,32,0,1,35,0,0
"Canada","2024-02-24",0,0,32,0,0,35,0,0
"Canada","2024-02-25",0,0,32,0,1,36,0,0
"Canada","2024-02-26",0,0,32,0,1,37,0,0
"Canada","2024-02-27",0,6,38,0,1,38,0,0
"Canada","2024-02-28",0,0,38,0,0,38,0,0
"Canada","2024-02-29",0,0,38,0,0,38,0,0
"Canada","2024-03-01",0,0,38,0,0,38,0,0
"Canada","2024-03-02",0,0,38,0,1,39,0,0
"Canada","2024-03-03",0,0,38,0,0,39,0,0
"Canada","2024-03-04",0,0,38,0,0,39,0,0
"Canada","2024-03-05",0,0,38,0,0,39,0,0
"Canada","2024-03-06",0,0,38,0,0,39,0,0
"Canada","2024-03-07",0,0,38,0,0,39,0,0
"Canada","2024-03-08",0,0,38,0,0,39,0,0
"Canada","2024-03-09",0,0,38,0,1,40,0,0
"Canada","2024-03-10",0,0,38,0,0,40,0,0
"Canada","2024-03-11",0,0,38,0,0,40,0,0
"Canada","2024-03-12",0,2,40,0,0,40,0,0
"Canada","2024-03-13",0,0,40,0,1,41,0,0
"Canada","2024-03-14",0,0,40,0,0,41,0,0
"Canada","2024-03-15",0,0,40,0,1,42,0,0
"Canada","2024-03-16",0,0,40,0,0,42,0,0
"Canada","2024-03-17",0,0,40,0,1,43,0,0
"Canada","2024-03-18",0,0,40,0,0,43,0,0
"Canada","2024-03-19",0,4,44,0,1,44,0,0
"Canada","2024-03-20",0,0,44,0,1,45,0,0
"Canada","2024-03-21",0,0,44,0,0,45,0,0
"Canada","2024-03-22",0,0,44,0,1,46,0,0
"Canada","2024-03-23",0,0,44,0,0,46,0,0
"Canada","2024-03-24",0,0,44,0,1,47,0,0
"Canada","2024-03-25",0,0,44,0,0,47,0,0
"Canada","2024-03-26",0,4,48,0,1,48,0,0
"Canada","2024-03-27",0,0,48,0,1,49,0,0
"Canada","2024-03-28",0,0,48,0,0,49,0,0
"Canada","2024-03-29",0,0,48,0,1,50,0,0
"Canada","2024-03-30",0,0,48,0,0,50,0,0
"Canada","2024-03-31",0,0,48,0,1,51,0,0
"Canada","2024-04-01",0,0,48,0,0,51,0,0
"Canada","2024-04-02",0,4,52,0,1,52,0,0
"Canada","2024-04-03",0,0,52,0,0,52,0,0
"Canada","2024-04-04",0,0,52,0,1,53,0,0
"Canada","2024-04-05",0,0,52,0,0,53,0,0
"Canada","2024-04-06",0,0,52,0,1,54,0,0
"Canada","2024-04-07",0,0,52,0,0,54,0,0
"Canada","2024-04-08",0,0,52,0,1,55,0,0
"Canada","2024-04-09",0,3,55,0,0,55,0,0
"Canada","2024-04-10",0,0,55,0,0,55,0,0
"Canada","2024-04-11",0,0,55,0,0,55,0,0
"Canada","2024-04-12",0,0,55,0,0,55,0,0
"Canada","2024-04-13",0,0,55,0,1,56,0,0
"Canada","2024-04-14",0,0,55,0,0,56,0,0
"Canada","2024-04-15",0,0,55,0,0,56,0,0
"Canada","2024-04-16",0,1,56,0,0,56,0,0
"Canada","2024-04-17",0,0,56,0,0,56,0,0
"Canada","2024-04-18",0,0,56,0,1,57,0,0
"Canada","2024-04-19",0,0,56,0,0,57,0,0
"Canada","2024-04-20",0,0,56,0,0,57,0,0
"Canada","2024-04-21",0,0,56,0,0,57,0,0
"Canada","2024-04-22",0,0,56,0,1,58,0,0
"Canada","2024-04-23",0,2,58,0,0,58,0,0
"Canada","2024-04-24",0,0,58,0,1,59,0,0
"Canada","2024-04-25",0,0,58,0,0,59,0,0
"Canada","2024-04-26",0,0,58,0,1,60,0,0
"Canada","2024-04-27",0,0,58,0,0,60,0,0
"Canada","2024-04-28",0,0,58,0,1,61,0,0
"Canada","2024-04-29",0,0,58,0,0,61,0,0
"Canada","2024-04-30",0,4,62,0,1,62,0,0
"Canada","2024-05-01",0,0,62,0,1,63,0,0
"Canada","2024-05-02",0,0,62,0,1,64,0,0
"Canada","2024-05-03",0,0,62,0,1,65,0,0
"Canada","2024-05-04",0,0,62,0,2,67,0,0
"Canada","2024-05-05",0,0,62,0,1,68,0,0
"Canada","2024-05-06",0,0,62,0,1,69,0,0
"Canada","2024-05-07",0,8,70,0,1,70,0,0
"Canada","2024-05-08",0,0,70,0,0,70,0,0
"Canada","2024-05-09",0,0,70,0,1,71,0,0
"Canada","2024-05-10",0,0,70,0,0,71,0,0
"Canada","2024-05-11",0,0,70,0,1,72,0,0
"Canada","2024-05-12",0,0,70,0,0,72,0,0
"Canada","2024-05-13",0,0,70,0,1,73,0,0
"Canada","2024-05-14",0,3,73,0,0,73,0,0
"Canada","2024-05-15",0,0,73,0,1,74,0,0
"Canada","2024-05-16",0,0,73,0,1,75,0,0
"Canada","2024-05-17",0,0,73,0,1,76,0,0
"Canada","2024-05-18",0,0,73,0,0,76,0,0
"Canada","2024-05-19",0,0,73,0,1,77,0,0
"Canada","2024-05-20",0,0,73,0,1,78,0,0
"Canada","2024-05-21",0,6,79,0,1,79,0,0
"Canada","2024-05-22",0,0,79,0,1,80,0,0
"Canada","2024-05-23",0,0,79,0,1,81,0,0
"Canada","2024-05-24",0,0,79,0,1,82,0,0
"Canada","2024-05-25",0,0,79,0,2,84,0,0
"Canada","2024-05-26",0,0,79,0,1,85,0,0
"Canada","2024-05-27",0,0,79,0,1,86,0,0
"Canada","2024-05-28",0,8,87,0,1,87,0,0
"Canada","2024-05-29",0,0,87,0,1,88,0,0
"Canada","2024-05-30",0,0,87,0,1,89,0,0
"Canada","2024-05-31",0,0,87,0,1,90,0,0
"Canada","2024-06-01",0,0,87,0,2,92,0,0
"Canada","2024-06-02",0,0,87,0,1,93,0,0
"Canada","2024-06-03",0,0,87,0,1,94,0,0
"Canada","2024-06-04",0,8,95,0,1,95,0,0
"Canada","2024-06-05",0,0,95,0,0,95,0,0
"Canada","2024-06-06",0,0,95,0,1,96,0,0
"Canada","2024-06-07",0,0,95,0,0,96,0,0
"Canada","2024-06-08",0,0,95,0,0,96,0,0
"Canada","2024-06-09",0,0,95,0,0,96,0,0
"Canada","2024-06-10",0,0,95,0,1,97,0,0
"Canada","2024-06-11",0,2,97,0,0,97,0,0
"Canada","2024-06-12",0,0,97,0,2,99,0,0
"Canada","2024-06-13",0,0,97,0,1,100,0,0
"Canada","2024-06-14",0,0,97,0,2,102,0,0
"Canada","2024-06-15",0,0,97,0,1,103,0,0
"Canada","2024-06-16",0,0,97,0,2,105,0,0
"Canada","2024-06-17",0,0,97,0,1,106,0,0
"Canada","2024-06-18",0,11,108,0,2,108,0,0
"Canada","2024-06-19",0,0,108,0,2,110,0,0
"Canada","2024-06-20",0,0,108,0,1,111,0,0
"Canada","2024-06-21",0,0,108,0,2,113,0,0
"Canada","2024-06-22",0,0,108,0,2,115,0,0
"Canada","2024-06-23",0,0,108,0,2,117,0,0
"Canada","2024-06-24",0,0,108,0,1,118,0,0
"Canada","2024-06-25",0,12,120,0,2,120,0,0
"Canada","2024-06-26",0,0,120,0,2,122,0,0
"Canada","2024-06-27",0,0,120,0,1,123,0,0
"Canada","2024-06-28",0,0,120,0,2,125,0,0
"Canada","2024-06-29",0,0,120,0,1,126,0,0
"Canada","2024-06-30",0,0,120,0,2,128,0,0
"Canada","2024-07-01",0,0,120,0,1,129,0,0
"Canada","2024-07-02",0,11,131,0,2,131,0,0
"Canada","2024-07-03",0,0,131,0,2,133,0,0
"Canada","2024-07-04",0,0,131,0,2,135,0,0
"Canada","2024-07-05",0,0,131,0,2,137,0,0
"Canada","2024-07-06",0,0,131,0,2,139,0,0
"Canada","2024-07-07",0,0,131,0,2,141,0,0
"Canada","2024-07-08",0,0,131,0,2,143,0,0
"Canada","2024-07-09",0,14,145,0,2,145,0,0
"Canada","2024-07-10",0,0,145,0,3,148,0,0
"Canada","2024-07-11",0,0,145,0,2,150,0,0
"Canada","2024-07-12",0,0,145,0,3,153,0,0
"Canada","2024-07-13",0,0,145,0,2,155,0,0
"Canada","2024-07-14",0,0,145,0,3,158,0,0
"Canada","2024-07-15",0,0,145,0,2,160,0,0
"Canada","2024-07-16",0,18,163,0,3,163,0,0
"Canada","2024-07-17",0,0,163,0,2,165,0,0
"Canada","2024-07-18",0,0,163,0,2,167,0,0
"Canada","2024-07-19",0,0,163,0,2,169,0,0
"Canada","2024-07-20",0,0,163,0,2,171,0,0
"Canada","2024-07-21",0,0,163,0,2,173,0,0
"Canada","2024-07-22",0,0,163,0,2,175,0,0
"Canada","2024-07-23",0,14,177,0,2,177,0,0
"Canada","2024-07-24",0,0,177,0,3,180,0,0
"Canada","2024-07-25",0,0,177,0,3,183,0,0
"Canada","2024-07-26",0,0,177,0,3,186,0,0
"Canada","2024-07-27",0,0,177,0,3,189,0,0
"Canada","2024-07-28",0,0,177,0,3,192,0,0
"Canada","2024-07-29",0,0,177,0,3,195,0,0
"Canada","2024-07-30",0,21,198,0,3,198,0,0
"Canada","2024-07-31",0,0,198,0,2,200,0,0
"Canada","2024-08-01",0,0,198,0,3,203,0,0
"Canada","2024-08-02",0,0,198,0,2,205,0,0
"Canada","2024-08-03",0,0,198,0,3,208,0,0
"Canada","2024-08-04",0,0,198,0,2,210,0,0
"Canada","2024-08-05",0,0,198,0,3,213,0,0
"Canada","2024-08-06",0,17,215,0,2,215,0,0
"Canada","2024-08-07",0,0,215,0,1,216,0,0
"Canada","2024-08-08",0,0,215,0,1,217,0,0
"Canada","2024-08-09",0,0,215,0,1,218,0,0
"Canada","2024-08-10",0,0,215,0,1,219,0,0
"Canada","2024-08-11",0,0,215,0,1,220,0,0
"Canada","2024-08-12",0,0,215,0,1,221,0,0
"Canada","2024-08-13",0,7,222,0,1,222,0,0
"Canada","2024-08-14",0,0,222,0,3,225,0,0
"Canada","2024-08-15",0,0,222,0,2,227,0,0
"Canada","2024-08-16",0,0,222,0,3,230,0,0
"Canada","2024-08-17",0,0,222,0,2,232,0,0
"Canada","2024-08-18",0,0,222,0,3,235,0,0
"Canada","2024-08-19",0,0,222,0,2,237,0,0
"Canada","2024-08-20",0,18,240,0,3,240,0,0
"Canada","2024-08-21",0,0,240,0,2,242,0,0
"Canada","2024-08-22",0,0,240,0,2,244,0,0
"Canada","2024-08-23",0,0,240,0,2,246,0,0
"Canada","2024-08-24",0,0,240,0,3,249,0,0
"Canada","2024-08-25",0,0,240,0,2,251,0,0
"Canada","2024-08-26",0,0,240,0,2,253,0,0
"Canada","2024-08-27",0,15,255,0,2,255,0,0
"Canada","2024-08-28",0,0,255,0,2,257,0,0
"Canada","2024-08-29",0,0,255,0,3,260,0,0
"Canada","2024-08-30",0,0,255,0,2,262,0,0
"Canada","2024-08-31",0,0,255,0,3,265,0,0
"Canada","2024-09-01",0,0,255,0,2,267,0,0
"Canada","2024-09-02",0,0,255,0,3,270,0,0
"Canada","2024-09-03",0,17,272,0,2,272,0,0
"Canada","2024-09-04",0,0,272,0,2,274,0,0
"Canada","2024-09-05",0,0,272,0,3,277,0,0
"Canada","2024-09-06",0,0,272,0,2,279,0,0
"Canada","2024-09-07",0,0,272,0,2,281,0,0
"Canada","2024-09-08",0,0,272,0,2,283,0,0
"Canada","2024-09-09",0,0,272,0,3,286,0,0
"Canada","2024-09-10",0,16,288,0,2,288,0,0
"Canada","2024-09-11",0,0,288,0,2,290,0,0
"Canada","2024-09-12",0,0,288,0,3,293,0,0
"Canada","2024-09-13",0,0,288,0,2,295,0,0
"Canada","2024-09-14",0,0,288,0,2,297,0,0
"Canada","2024-09-15",0,0,288,0,2,299,0,0
"Canada","2024-09-16",0,0,288,0,3,302,0,0
"Canada","2024-09-17",0,16,304,0,2,304,0,0
"Canada","2024-09-18",0,0,304,0,2,306,0,0
"Canada","2024-09-19",0,0,304,0,3,309,0,0
"Canada","2024-09-20",0,0,304,0,2,311,0,0
"Canada","2024-09-21",0,0,304,0,2,313,0,0
"Canada","2024-09-22",0,0,304,0,2,315,0,0
"Canada","2024-09-23",0,0,304,0,3,318,0,0
"Canada","2024-09-24",0,16,320,0,2,320,0,0
"Canada","2024-09-25",0,0,320,0,2,322,0,0
"Canada","2024-09-26",0,0,320,0,1,323,0,0
"Canada","2024-09-27",0,0,320,0,2,325,0,0
"Canada","2024-09-28",0,0,320,0,1,326,0,0
"Canada","2024-09-29",0,0,320,0,2,328,0,0
"Canada","2024-09-30",0,0,320,0,1,329,0,0
"Canada","2024-10-01",0,11,331,0,2,331,0,0
"Canada","2024-10-02",0,0,331,0,2,333,0,0
"Canada","2024-10-03",0,0,331,0,1,334,0,0
"Canada","2024-10-04",0,0,331,0,2,336,0,0
"Canada","2024-10-05",0,0,331,0,1,337,0,0
"Canada","2024-10-06",0,0,331,0,2,339,0,0
"Canada","2024-10-07",0,0,331,0,1,340,0,0
"Canada","2024-10-08",0,11,342,0,2,342,0,0
"Canada","2024-10-09",0,0,342,0,2,344,0,0
"Canada","2024-10-10",0,0,342,0,2,346,0,0
"Canada","2024-10-11",0,0,342,0,2,348,0,0
"Canada","2024-10-12",0,0,342,0,1,349,0,0
"Canada","2024-10-13",0,0,342,0,2,351,0,0
"Canada","2024-10-14",0,0,342,0,2,353,0,0
"Canada","2024-10-15",0,13,355,0,2,355,0,0
"Canada","2024-10-16",0,0,355,0,2,357,0,0
"Canada","2024-10-17",0,0,355,0,2,359,0,0
"Canada","2024-10-18",0,0,355,0,2,361,0,0
"Canada","2024-10-19",0,0,355,0,2,363,0,0
"Canada","2024-10-20",0,0,355,0,2,365,0,0
"Canada","2024-10-21",0,0,355,0,2,367,0,0
"Canada","2024-10-22",0,14,369,0,2,369,0,0
"Canada","2024-10-23",0,0,369,0,2,371,0,0
"Canada","2024-10-24",0,0,369,0,1,372,0,0
"Canada","2024-10-25",0,0,369,0,2,374,0,0
"Canada","2024-10-26",0,0,369,0,1,375,0,0
"Canada","2024-10-27",0,0,369,0,2,377,0,0
"Canada","2024-10-28",0,0,369,0,1,378,0,0
"Canada","2024-10-29",0,11,380,0,2,380,0,0
"Canada","2024-10-30",0,0,380,0,1,381,0,0
"Canada","2024-10-31",0,0,380,0,2,383,0,0
"Canada","2024-11-01",0,0,380,0,1,384,0,0
"Canada","2024-11-02",0,0,380,0,1,385,0,0
"Canada","2024-11-03",0,0,380,0,1,386,0,0
"Canada","2024-11-04",0,0,380,0,2,388,0,0
"Canada","2024-11-05",0,9,389,0,1,389,0,0
"Canada","2024-11-06",0,0,389,0,1,390,0,0
"Canada","2024-11-07",0,0,389,0,1,391,0,0
"Canada","2024-11-08",0,0,389,0,1,392,0,0
"Canada","2024-11-09",0,0,389,0,1,393,0,0
"Canada","2024-11-10",0,0,389,0,1,394,0,0
"Canada","2024-11-11",0,0,389,0,1,395,0,0
"Canada","2024-11-12",0,7,396,0,1,396,0,0
"Canada","2024-11-13",0,0,396,0,2,398,0,0
"Canada","2024-11-14",0,0,396,0,1,399,0,0
"Canada","2024-11-15",0,0,396,0,2,401,0,0
"Canada","2024-11-16",0,0,396,0,1,402,0,0
"Canada","2024-11-17",0,0,396,0,2,404,0,0
"Canada","2024-11-18",0,0,396,0,1,405,0,0
"Canada","2024-11-19",0,11,407,0,2,407,0,0
"Canada","2024-11-20",0,0,407,0,1,408,0,0
"Canada","2024-11-21",0,0,407,0,1,409,0,0
"Canada","2024-11-22",0,0,407,0,1,410,0,0
"Canada","2024-11-23",0,0,407,0,1,411,0,0
"Canada","2024-11-24",0,0,407,0,1,412,0,0
"Canada","2024-11-25",0,0,407,0,1,413,0,0
"Canada","2024-11-26",0,7,414,0,1,414,0,0
"Canada","2024-11-27",0,0,414,0,0,414,0,0
"Canada","2024-11-28",0,0,414,0,0,414,0,0
"Canada","2024-11-29",0,0,414,0,0,414,0,0
"Canada","2024-11-30",0,0,414,0,0,414,0,0
"Canada","2024-12-01",0,0,414,0,0,414,0,0
"Canada","2024-12-02",0,0,414,0,0,414,0,0
"Canada","2024-12-03",0,0,414,0,0,414,0,0
"Canada","2024-12-04",0,0,414,0,0,414,0,0
"Canada","2024-12-05",0,0,414,0,0,414,0,0
"Canada","2024-12-06",0,0,414,0,0,414,0,0
"Canada","2024-12-07",0,0,414,0,0,414,0,0
"Canada","2024-12-08",0,0,414,0,0,414,0,0
"Canada","2024-12-09",0,0,414,0,0,414,0,0
"Canada","2024-12-10",0,0,414,0,0,414,0,0
"Canada","2024-12-11",0,0,414,0,0,414,0,0
"Canada","2024-12-12",0,0,414,0,0,414,0,0
"Canada","2024-12-13",0,0,414,0,0,414,0,0
"Canada","2024-12-14",0,0,414,0,0,414,0,0
"Canada","2024-12-15",0,0,414,0,0,414,0,0
"Canada","2024-12-16",0,0,414,0,0,414,0,0
"Canada","2024-12-17",0,0,414,0,0,414,0,0
"Canada","2024-12-18",0,0,414,0,0,414,0,0
"Canada","2024-12-19",0,0,414,0,0,414,0,0
"Canada","2024-12-20",0,0,414,0,0,414,0,0
"Canada","2024-12-21",0,0,414,0,0,414,0,0
"Canada","2024-12-22",0,0,414,0,0,414,0,0
"Canada","2024-12-23",0,0,414,0,0,414,0,0
"Canada","2024-12-24",0,0,414,0,0,414,0,0
"Canada","2024-12-25",0,0,414,0,0,414,0,0
"Canada","2024-12-26",0,0,414,0,0,414,0,0
"Canada","2024-12-27",0,0,414,0,0,414,0,0
"Canada","2024-12-28",0,0,414,0,0,414,0,0
"Canada","2024-12-29",0,0,414,0,0,414,0,0
"Canada","2024-12-30",0,0,414,0,0,414,0,0
"Canada","2024-12-31",0,0,414,0,0,414,0,0
"Canada","2025-01-01",0,0,414,0,0,414,0,0
"Canada","2025-01-02",0,0,414,0,0,414,0,0
"Canada","2025-01-03",0,0,414,0,0,414,0,0
"Canada","2025-01-04",0,0,414,0,0,414,0,0
"Canada","2025-01-05",0,0,414,0,0,414,0,0
"Canada","2025-01-06",0,0,414,0,0,414,0,0
"Canada","2025-01-07",0,0,414,0,0,414,0,0
"Canada","2025-01-08",0,0,414,0,0,414,0,0
"Canada","2025-01-09",0,0,414,0,0,414,0,0
"Canada","2025-01-10",0,0,414,0,0,414,0,0
"Canada","2025-01-11",0,0,414,0,0,414,0,0
"Canada","2025-01-12",0,0,414,0,0,414,0,0
"Canada","2025-01-13",0,0,414,0,0,414,0,0
"Canada","2025-01-14",0,0,414,0,0,414,0,0
"Canada","2025-01-15",0,0,414,0,0,414,0,0
"Canada","2025-01-16",0,0,414,0,0,414,0,0
"Canada","2025-01-17",0,0,414,0,0,414,0,0
"Canada","2025-01-18",0,0,414,0,0,414,0,0
"Canada","2025-01-19",0,0,414,0,0,414,0,0
"Canada","2025-01-20",0,0,414,0,0,414,0,0
"Canada","2025-01-21",0,0,414,0,0,414,0,0
"Canada","2025-01-22",0,0,414,0,0,414,0,0
"Canada","2025-01-23",0,0,414,0,0,414,0,0
"Canada","2025-01-24",0,0,414,0,0,414,0,0
"Canada","2025-01-25",0,0,414,0,0,414,0,0
"Canada","2025-01-26",0,0,414,0,0,414,0,0
"Canada","2025-01-27",0,0,414,0,0,414,0,0
"Canada","2025-01-28",0,0,414,0,0,414,0,0
"Canada","2025-01-29",0,0,414,0,0,414,0,0
"Canada","2025-01-30",0,0,414,0,0,414,0,0
"Canada","2025-01-31",0,0,414,0,0,414,0,0
"Canada","2025-02-01",0,0,414,0,0,414,0,0
"Canada","2025-02-02",0,0,414,0,0,414,0,0
"Canada","2025-02-03",0,0,414,0,0,414,0,0
"Central African Republic","2024-01-01",0,0,0,0,0,0,0,0
"Central African Republic","2024-01-02",0,0,0,0,0,0,0,0
"Central African Republic","2024-01-03",0,0,0,0,0,0,0,0
"Central African Republic","2024-01-04",0,0,0,0,0,0,0,0
"Central African Republic","2024-01-05",0,0,0,0,0,0,0,0
"Central African Republic","2024-01-06",0,0,0,0,0,0,0,0
"Central African Republic","2024-01-07",0,0,0,0,0,0,0,0
"Central African Republic","2024-01-08",0,0,0,0,0,0,0,0
"Central African Republic","2024-01-09",0,0,0,0,0,0,0,0
"Central African Republic","2024-01-10",0,0,0,0,0,0,0,0
"Central African Republic","2024-01-11",0,0,0,0,0,0,0,0
"Central African Republic","2024-01-12",0,0,0,0,0,0,0,0
"Central African Republic","2024-01-13",0,0,0,0,0,0,0,0
"Central African Republic","2024-01-14",0,4,4,0,4,4,0,0
"Central African Republic","2024-01-15",0,0,4,0,0,4,0,0
"Central African Republic","2024-01-16",0,0,4,0,0,4,0,0
"Central African Republic","2024-01-17",0,0,4,0,0,4,0,0
"Central African Republic","2024-01-18",0,0,4,0,0,4,0,0
"Central African Republic","2024-01-19",0,0,4,0,0,4,0,0
"Central African Republic","2024-01-20",0,0,4,0,0,4,0,0
"Central African Republic","2024-01-21",0,0,4,0,0,4,0,0
"Central African Republic","2024-01-22",0,0,4,0,1,5,0,0
"Central African Republic","2024-01-23",0,0,4,0,0,5,0,0
"Central African Republic","2024-01-24",0,0,4,0,0,5,0,0
"Central African Republic","2024-01-25",0,0,4,0,0,5,0,0
"Central African Republic","2024-01-26",0,0,4,0,0,5,0,0
"Central African Republic","2024-01-27",0,0,4,0,0,5,0,0
"Central African Republic","2024-01-28",0,1,5,0,0,5,0,0
"Central African Republic","2024-01-29",0,0,5,0,0,5,0,0
"Central African Republic","2024-01-30",0,0,5,0,0,5,0,0
"Central African Republic","2024-01-31",0,0,5,0,1,6,0,0
"Central African Republic","2024-02-01",0,0,5,0,0,6,0,0
"Central African Republic","2024-02-02",0,0,5,0,0,6,0,0
"Central African Republic","2024-02-03",0,0,5,0,0,6,0,0
"Central African Republic","2024-02-04",0,0,5,0,1,7,0,0
"Central African Republic","2024-02-05",0,0,5,0,0,7,0,0
"Central African Republic","2024-02-06",0,0,5,0,0,7,0,0
"Central African Republic","2024-02-07",0,0,5,0,0,7,0,0
"Central African Republic","2024-02-08",0,0,5,0,0,7,0,0
"Central African Republic","2024-02-09",0,0,5,0,1,8,0,0
"Central African Republic","2024-02-10",0,0,5,0,0,8,0,0
"Central African Republic","2024-02-11",0,3,8,0,0,8,0,0
"Central African Republic","2024-02-12",0,0,8,0,1,9,0,0
"Central African Republic","2024-02-13",0,0,8,0,0,9,0,0
"Central African Republic","2024-02-14",0,0,8,0,1,10,0,0
"Central African Republic","2024-02-15",0,0,8,0,0,10,0,0
"Central African Republic","2024-02-16",0,0,8,0,1,11,0,0
"Central African Republic","2024-02-17",0,0,8,0,0,11,0,0
"Central African Republic","2024-02-18",0,4,12,0,1,12,0,0
"Central African Republic","2024-02-19",0,0,12,0,0,12,0,0
"Central African Republic","2024-02-20",0,0,12,0,0,12,0,0
"Central African Republic","2024-02-21",0,0,12,0,0,12,0,0
"Central African Republic","2024-02-22",0,0,12,0,1,13,0,0
"Central African Republic","2024-02-23",0,0,12,0,0,13,0,0
"Central African Republic","2024-02-24",0,0,12,0,0,13,0,0
"Central African Republic","2024-02-25",0,0,12,0,0,13,0,0
"Central African Republic","2024-02-26",0,0,12,0,0,13,0,0
"Central African Republic","2024-02-27",0,0,12,0,0,13,0,0
"Central African Republic","2024-02-28",0,0,12,0,0,13,0,0
"Central African Republic","2024-02-29",0,0,12,0,1,14,0,0
"Central African Republic","2024-03-01",0,0,12,0,0,14,0,0
"Central African Republic","2024-03-02",0,0,12,0,0,14,0,0
"Central African Republic","2024-03-03",0,0,12,0,0,14,0,0
"Central African Republic","2024-03-04",0,0,12,0,0,14,0,0
"Central African Republic","2024-03-05",0,0,12,0,0,14,0,0
"Central African Republic","2024-03-06",0,0,12,0,0,14,0,0
"Central African Republic","2024-03-07",0,0,12,0,1,15,0,0
"Central African Republic","2024-03-08",0,0,12,0,0,15,0,0
"Central African Republic","2024-03-09",0,0,12,0,0,15,0,0
"Central African Republic","2024-03-10",0,0,12,0,0,15,0,0
"Central African Republic","2024-03-11",0,0,12,0,0,15,0,0
"Central African Republic","2024-03-12",0,0,12,0,0,15,0,0
"Central African Republic","2024-03-13",0,0,12,0,0,15,0,0
"Central African Republic","2024-03-14",0,0,12,0,1,16,0,0
"Central African Republic","2024-03-15",0,0,12,0,0,16,0,0
"Central African Republic","2024-03-16",0,0,12,0,0,16,0,0
"Central African Republic","2024-03-17",45,4,16,45,0,16,45,45
"Central African Republic","2024-03-18",0,0,16,45,0,16,0,45
"Central African Republic","2024-03-19",0,0,16,45,1,17,1,46
"Central African Republic","2024-03-20",0,0,16,45,0,17,0,46
"Central African Republic","2024-03-21",0,0,16,45,0,17,0,46
"Central African Republic","2024-03-22",0,0,16,45,0,17,0,46
"Central African Republic","2024-03-23",0,0,16,45,1,18,1,47
"Central African Republic","2024-03-24",2,2,18,47,0,18,0,47
"Central African Republic","2024-03-25",0,0,18,47,0,18,1,48
"Central African Republic","2024-03-26",0,0,18,47,0,18,1,49
"Central African Republic","2024-03-27",0,0,18,47,0,18,2,51
"Central African Republic","2024-03-28",0,0,18,47,1,19,1,52
"Central African Republic","2024-03-29",0,0,18,47,0,19,1,53
"Central African Republic","2024-03-30",0,0,18,47,0,19,1,54
"Central African Republic","2024-03-31",0,1,19,47,0,19,2,56
"Central African Republic","2024-04-01",0,0,19,47,0,19,1,57
"Central African Republic","2024-04-02",0,0,19,47,0,19,1,58
"Central African Republic","2024-04-03",0,0,19,47,0,19,1,59
"Central African Republic","2024-04-04",0,0,19,47,0,19,2,61
"Central African Republic","2024-04-05",0,0,19,47,0,19,1,62
"Central African Republic","2024-04-06",0,0,19,47,0,19,1,63
"Central African Republic","2024-04-07",0,0,19,47,0,19,1,64
"Central African Republic","2024-04-08",0,0,19,47,0,19,2,66
"Central African Republic","2024-04-09",0,0,19,47,0,19,1,67
"Central African Republic","2024-04-10",0,0,19,47,0,19,1,68
"Central African Republic","2024-04-11",0,0,19,47,0,19,1,69
"Central African Republic","2024-04-12",0,0,19,47,0,19,2,71
"Central African Republic","2024-04-13",0,0,19,47,0,19,1,72
"Central African Republic","2024-04-14",26,0,19,73,0,19,1,73
"Central African Republic","2024-04-15",0,0,19,73,0,19,0,73
"Central African Republic","2024-04-16",0,0,19,73,0,19,1,74
"Central African Republic","2024-04-17",0,0,19,73,0,19,0,74
"Central African Republic","2024-04-18",0,0,19,73,0,19,1,75
"Central African Republic","2024-04-19",0,0,19,73,0,19,0,75
"Central African Republic","2024-04-20",0,0,19,73,0,19,1,76
"Central African Republic","2024-04-21",0,0,19,73,0,19,0,76
"Central African Republic","2024-04-22",0,0,19,73,0,19,1,77
"Central African Republic","2024-04-23",0,0,19,73,0,19,0,77
"Central African Republic","2024-04-24",0,0,19,73,0,19,0,77
"Central African Republic","2024-04-25",0,0,19,73,0,19,1,78
"Central African Republic","2024-04-26",0,0,19,73,0,19,0,78
"Central African Republic","2024-04-27",0,0,19,73,0,19,1,79
"Central African Republic","2024-04-28",0,0,19,73,0,19,0,79
"Central African Republic","2024-04-29",0,0,19,73,0,19,1,80
"Central African Republic","2024-04-30",0,0,19,73,0,19,0,80
"Central African Republic","2024-05-01",0,0,19,73,0,19,1,81
"Central African Republic","2024-05-02",0,0,19,73,0,19,0,81
"Central African Republic","2024-05-03",0,0,19,73,0,19,0,81
"Central African Republic","2024-05-04",0,0,19,73,0,19,1,82
"Central African Republic","2024-05-05",0,0,19,73,0,19,0,82
"Central African Republic","2024-05-06",0,0,19,73,1,20,1,83
"Central African Republic","2024-05-07",0,0,19,73,0,20,0,83
"Central African Republic","2024-05-08",0,0,19,73,0,20,1,84
"Central African Republic","2024-05-09",0,0,19,73,0,20,0,84
"Central African Republic","2024-05-10",0,0,19,73,0,20,0,84
"Central African Republic","2024-05-11",0,0,19,73,0,20,1,85
"Central African Republic","2024-05-12",0,0,19,73,0,20,0,85
"Central African Republic","2024-05-13",0,0,19,73,0,20,1,86
"Central African Republic","2024-05-14",0,0,19,73,0,20,0,86
"Central African Republic","2024-05-15",0,0,19,73,0,20,1,87
"Central African Republic","2024-05-16",0,0,19,73,0,20,0,87
"Central African Republic","2024-05-17",0,0,19,73,0,20,1,88
"Central African Republic","2024-05-18",15,0,19,88,0,20,0,88
"Central African Republic","2024-05-19",0,0,19,88,0,20,0,88
"Central African Republic","2024-05-20",0,0,19,88,0,20,0,88
"Central African Republic","2024-05-21",0,0,19,88,0,20,0,88
"Central African Republic","2024-05-22",0,0,19,88,0,20,1,89
"Central African Republic","2024-05-23",0,0,19,88,0,20,0,89
"Central African Republic","2024-05-24",0,0,19,88,0,20,0,89
"Central African Republic","2024-05-25",1,0,19,89,0,20,0,89
"Central African Republic","2024-05-26",0,0,19,89,0,20,4,93
"Central African Republic","2024-05-27",0,0,19,89,0,20,3,96
"Central African Republic","2024-05-28",0,0,19,89,0,20,3,99
"Central African Republic","2024-05-29",0,0,19,89,0,20,4,103
"Central African Republic","2024-05-30",0,0,19,89,0,20,4,107
"Central African Republic","2024-05-31",0,0,19,89,0,20,3,110
"Central African Republic","2024-06-01",0,0,19,89,0,20,3,113
"Central African Republic","2024-06-02",0,0,19,89,0,20,4,117
"Central African Republic","2024-06-03",0,0,19,89,0,20,4,121
"Central African Republic","2024-06-04",0,0,19,89,0,20,3,124
"Central African Republic","2024-06-05",0,0,19,89,0,20,3,127
"Central African Republic","2024-06-06",0,0,19,89,0,20,4,131
"Central African Republic","2024-06-07",0,0,19,89,0,20,4,135
"Central African Republic","2024-06-08",0,0,19,89,0,20,3,138
"Central African Republic","2024-06-09",0,1,20,89,0,20,3,141
"Central African Republic","2024-06-10",0,0,20,89,0,20,4,145
"Central African Republic","2024-06-11",0,0,20,89,0,20,4,149
"Central African Republic","2024-06-12",0,0,20,89,0,20,3,152
"Central African Republic","2024-06-13",0,0,20,89,1,21,3,155
"Central African Republic","2024-06-14",0,0,20,89,0,21,4,159
"Central African Republic","2024-06-15",0,0,20,89,0,21,4,163
"Central African Republic","2024-06-16",77,1,21,166,0,21,3,166
"Central African Republic","2024-06-17",0,0,21,166,0,21,0,166
"Central African Republic","2024-06-18",0,0,21,166,1,22,1,167
"Central African Republic","2024-06-19",0,0,21,166,0,22,0,167
"Central African Republic","2024-06-20",0,0,21,166,0,22,1,168
"Central African Republic","2024-06-21",0,0,21,166,0,22,0,168
"Central African Republic","2024-06-22",0,0,21,166,1,23,1,169
"Central African Republic","2024-06-23",0,2,23,166,0,23,0,169
"Central African Republic","2024-06-24",0,0,23,166,0,23,1,170
"Central African Republic","2024-06-25",0,0,23,166,0,23,0,170
"Central African Republic","2024-06-26",0,0,23,166,0,23,1,171
"Central African Republic","2024-06-27",0,0,23,166,1,24,0,171
"Central African Republic","2024-06-28",0,0,23,166,0,24,0,171
"Central African Republic","2024-06-29",0,0,23,166,0,24,1,172
"Central African Republic","2024-06-30",0,1,24,166,0,24,0,172
"Central African Republic","2024-07-01",0,0,24,166,0,24,1,173
"Central African Republic","2024-07-02",0,0,24,166,0,24,0,173
"Central African Republic","2024-07-03",0,0,24,166,0,24,1,174
"Central African Republic","2024-07-04",0,0,24,166,1,25,0,174
"Central African Republic","2024-07-05",0,0,24,166,0,25,1,175
"Central African Republic","2024-07-06",0,0,24,166,0,25,0,175
"Central African Republic","2024-07-07",0,1,25,166,0,25,1,176
"Central African Republic","2024-07-08",0,0,25,166,0,25,0,176
"Central African Republic","2024-07-09",0,0,25,166,0,25,0,176
"Central African Republic","2024-07-10",0,0,25,166,0,25,1,177
"Central African Republic","2024-07-11",0,0,25,166,1,26,0,177
"Central African Republic","2024-07-12",0,0,25,166,0,26,1,178
"Central African Republic","2024-07-13",0,0,25,166,0,26,0,178
"Central African Republic","2024-07-14",0,1,26,166,0,26,1,179
"Central African Republic","2024-07-15",0,0,26,166,1,27,0,179
"Central African Republic","2024-07-16",0,0,26,166,0,27,1,180
"Central African Republic","2024-07-17",0,0,26,166,1,28,0,180
"Central African Republic","2024-07-18",0,0,26,166,0,28,0,180
"Central African Republic","2024-07-19",0,0,26,166,1,29,1,181
"Central African Republic","2024-07-20",0,0,26,166,0,29,0,181
"Central African Republic","2024-07-21",0,4,30,166,1,30,1,182
"Central African Republic","2024-07-22",0,0,30,166,1,31,0,182
"Central African Republic","2024-07-23",0,0,30,166,2,33,1,183
"Central African Republic","2024-07-24",0,0,30,166,1,34,0,183
"Central African Republic","2024-07-25",0,0,30,166,1,35,1,184
"Central African Republic","2024-07-26",0,0,30,166,1,36,0,184
"Central African Republic","2024-07-27",0,0,30,166,2,38,1,185
"Central African Republic","2024-07-28",19,9,39,185,1,39,0,185
"Central African Republic","2024-07-29",0,0,39,185,0,39,2,187
"Central African Republic","2024-07-30",0,0,39,185,1,40,1,188
"Central African Republic","2024-07-31",0,0,39,185,0,40,2,190
"Central African Republic","2024-08-01",0,0,39,185,1,41,2,192
"Central African Republic","2024-08-02",0,0,39,185,0,41,1,193
"Central African Republic","2024-08-03",10,0,39,195,1,42,2,195
"Central African Republic","2024-08-04",0,3,42,195,0,42,5,200
"Central African Republic","2024-08-05",0,0,42,195,0,42,4,204
"Central African Republic","2024-08-06",0,0,42,195,1,43,5,209
"Central African Republic","2024-08-07",0,0,42,195,0,43,5,214
"Central African Republic","2024-08-08",0,0,42,195,0,43,4,218
"Central African Republic","2024-08-09",28,0,42,223,0,43,5,223
"Central African Republic","2024-08-10",0,0,42,223,1,44,1,224
"Central African Republic","2024-08-11",0,2,44,223,0,44,0,224
"Central African Republic","2024-08-12",0,0,44,223,0,44,1,225
"Central African Republic","2024-08-13",0,0,44,223,1,45,1,226
"Central African Republic","2024-08-14",0,0,44,223,0,45,0,226
"Central African Republic","2024-08-15",0,0,44,223,0,45,1,227
"Central African Republic","2024-08-16",0,0,44,223,0,45,1,228
"Central African Republic","2024-08-17",0,0,44,223,1,46,0,228
"Central African Republic","2024-08-18",0,2,46,223,0,46,1,229
"Central African Republic","2024-08-19",0,0,46,223,0,46,1,230
"Central African Republic","2024-08-20",0,0,46,223,1,47,0,230
"Central African Republic","2024-08-21",0,0,46,223,0,47,1,231
"Central African Republic","2024-08-22",0,0,46,223,1,48,1,232
"Central African Republic","2024-08-23",0,0,46,223,0,48,0,232
"Central African Republic","2024-08-24",0,0,46,223,1,49,1,233
"Central African Republic","2024-08-25",0,3,49,223,0,49,1,234
"Central African Republic","2024-08-26",0,0,49,223,0,49,0,234
"Central African Republic","2024-08-27",0,0,49,223,0,49,1,235
"Central African Republic","2024-08-28",0,0,49,223,0,49,1,236
"Central African Republic","2024-08-29",0,0,49,223,1,50,0,236
"Central African Republic","2024-08-30",0,0,49,223,0,50,1,237
"Central African Republic","2024-08-31",0,0,49,223,0,50,1,238
"Central African Republic","2024-09-01",0,1,50,223,0,50,0,238
"Central African Republic","2024-09-02",0,0,50,223,0,50,1,239
"Central African Republic","2024-09-03",0,0,50,223,1,51,1,240
"Central African Republic","2024-09-04",0,0,50,223,0,51,0,240
"Central African Republic","2024-09-05",0,0,50,223,0,51,1,241
"Central African Republic","2024-09-06",0,0,50,223,0,51,1,242
"Central African Republic","2024-09-07",0,0,50,223,1,52,0,242
"Central African Republic","2024-09-08",20,2,52,243,0,52,1,243
"Central African Republic","2024-09-09",0,0,52,243,0,52,1,244
"Central African Republic","2024-09-10",0,0,52,243,1,53,1,245
"Central African Republic","2024-09-11",0,0,52,243,0,53,0,245
"Central African Republic","2024-09-12",0,0,52,243,0,53,1,246
"Central African Republic","2024-09-13",0,0,52,243,0,53,1,247
"Central African Republic","2024-09-14",0,0,52,243,1,54,1,248
"Central African Republic","2024-09-15",0,2,54,243,0,54,1,249
"Central African Republic","2024-09-16",0,0,54,243,0,54,0,249
"Central African Republic","2024-09-17",0,0,54,243,1,55,1,250
"Central African Republic","2024-09-18",0,0,54,243,0,55,1,251
"Central African Republic","2024-09-19",0,0,54,243,0,55,1,252
"Central African Republic","2024-09-20",0,0,54,243,0,55,1,253
"Central African Republic","2024-09-21",0,0,54,243,1,56,0,253
"Central African Republic","2024-09-22",0,2,56,243,0,56,1,254
"Central African Republic","2024-09-23",12,0,56,255,0,56,1,255
"Central African Republic","2024-09-24",0,0,56,255,0,56,2,257
"Central African Republic","2024-09-25",0,0,56,255,0,56,2,259
"Central African Republic","2024-09-26",0,0,56,255,1,57,2,261
"Central African Republic","2024-09-27",0,0,56,255,0,57,2,263
"Central African Republic","2024-09-28",0,0,56,255,0,57,2,265
"Central African Republic","2024-09-29",0,0,56,255,0,57,2,267
"Central African Republic","2024-09-30",14,0,56,269,0,57,2,269
"Central African Republic","2024-10-01",0,0,56,269,0,57,2,271
"Central African Republic","2024-10-02",0,0,56,269,0,57,1,272
"Central African Republic","2024-10-03",0,0,56,269,1,58,2,274
"Central African Republic","2024-10-04",0,0,56,269,0,58,2,276
"Central African Republic","2024-10-05",0,0,56,269,0,58,1,277
"Central African Republic","2024-10-06",10,2,58,279,0,58,2,279
"Central African Republic","2024-10-07",0,0,58,279,1,59,3,282
"Central African Republic","2024-10-08",0,0,58,279,0,59,3,285
"Central African Republic","2024-10-09",0,0,58,279,1,60,2,287
"Central African Republic","2024-10-10",0,0,58,279,0,60,3,290
"Central African Republic","2024-10-11",0,0,58,279,1,61,3,293
"Central African Republic","2024-10-12",0,0,58,279,0,61,3,296
"Central African Republic","2024-10-13",0,4,62,279,1,62,3,299
"Central African Republic","2024-10-14",0,0,62,279,0,62,2,301
"Central African Republic","2024-10-15",0,0,62,279,1,63,3,304
"Central African Republic","2024-10-16",0,0,62,279,0,63,3,307
"Central African Republic","2024-10-17",0,0,62,279,0,63,3,310
"Central African Republic","2024-10-18",0,0,62,279,0,63,2,312
"Central African Republic","2024-10-19",0,0,62,279,1,64,3,315
"Central African Republic","2024-10-20",39,2,64,318,0,64,3,318
"Central African Republic","2024-10-21",0,0,64,318,0,64,1,319
"Central African Republic","2024-10-22",0,0,64,318,1,65,0,319
"Central African Republic","2024-10-23",0,0,64,318,1,66,1,320
"Central African Republic","2024-10-24",0,0,64,318,0,66,1,321
"Central African Republic","2024-10-25",0,0,64,318,0,66,1,322
"Central African Republic","2024-10-26",0,3,67,318,1,67,0,322
"Central African Republic","2024-10-27",5,0,67,323,1,68,1,323
"Central African Republic","2024-10-28",0,0,67,323,0,68,0,323
"Central African Republic","2024-10-29",0,0,67,323,1,69,1,324
"Central African Republic","2024-10-30",0,0,67,323,0,69,0,324
"Central African Republic","2024-10-31",0,0,67,323,1,70,0,324
"Central African Republic","2024-11-01",0,0,67,323,1,71,1,325
"Central African Republic","2024-11-02",0,0,67,323,0,71,0,325
"Central African Republic","2024-11-03",0,5,72,323,1,72,0,325
"Central African Republic","2024-11-04",0,0,72,323,0,72,1,326
"Central African Republic","2024-11-05",0,0,72,323,1,73,0,326
"Central African Republic","2024-11-06",0,0,72,323,0,73,1,327
"Central African Republic","2024-11-07",0,0,72,323,1,74,0,327
"Central African Republic","2024-11-08",0,0,72,323,0,74,0,327
"Central African Republic","2024-11-09",0,0,72,323,1,75,1,328
"Central African Republic","2024-11-10",0,3,75,323,0,75,0,328
"Central African Republic","2024-11-11",0,0,75,323,1,76,0,328
"Central African Republic","2024-11-12",0,0,75,323,1,77,1,329
"Central African Republic","2024-11-13",6,0,75,329,1,78,0,329
"Central African Republic","2024-11-14",0,0,75,329,1,79,0,329
"Central African Republic","2024-11-15",0,0,75,329,1,80,0,329
"Central African Republic","2024-11-16",0,0,75,329,1,81,0,329
"Central African Republic","2024-11-17",0,7,82,329,1,82,0,329
"Central African Republic","2024-11-18",0,0,82,329,1,83,0,329
"Central African Republic","2024-11-19",0,0,82,329,0,83,0,329
"Central African Republic","2024-11-20",0,0,82,329,1,84,0,329
"Central African Republic","2024-11-21",0,0,82,329,0,84,0,329
"Central African Republic","2024-11-22",0,0,82,329,1,85,0,329
"Central African Republic","2024-11-23",0,0,82,329,0,85,0,329
"Central African Republic","2024-11-24",0,4,86,329,1,86,0,329
"Central African Republic","2024-11-25",0,0,86,329,0,86,0,329
"Central African Republic","2024-11-26",0,0,86,329,0,86,0,329
"Central African Republic","2024-11-27",0,0,86,329,0,86,0,329
"Central African Republic","2024-11-28",0,0,86,329,1,87,0,329
"Central African Republic","2024-11-29",0,0,86,329,0,87,0,329
"Central African Republic","2024-11-30",0,0,86,329,0,87,0,329
"Central African Republic","2024-12-01",0,1,87,329,0,87,0,329
"Central African Republic","2024-12-02",0,0,87,329,0,87,0,329
"Central African Republic","2024-12-03",0,0,87,329,0,87,0,329
"Central African Republic","2024-12-04",0,0,87,329,0,87,0,329
"Central African Republic","2024-12-05",0,0,87,329,1,88,0,329
"Central African Republic","2024-12-06",0,0,87,329,0,88,0,329
"Central African Republic","2024-12-07",0,0,87,329,0,88,0,329
"Central African Republic","2024-12-08",0,1,88,329,0,88,0,329
"Central African Republic","2024-12-09",0,0,88,329,0,88,0,329
"Central African Republic","2024-12-10",0,0,88,329,0,88,0,329
"Central African Republic","2024-12-11",0,0,88,329,0,88,0,329
"Central African Republic","2024-12-12",0,0,88,329,1,89,0,329
"Central African Republic","2024-12-13",0,0,88,329,0,89,0,329
"Central African Republic","2024-12-14",0,0,88,329,0,89,0,329
"Central African Republic","2024-12-15",0,1,89,329,0,89,0,329
"Central African Republic","2024-12-16",0,0,89,329,0,89,0,329
"Central African Republic","2024-12-17",0,0,89,329,0,89,0,329
"Central African Republic","2024-12-18",0,0,89,329,0,89,0,329
"Central African Republic","2024-12-19",0,0,89,329,0,89,0,329
"Central African Republic","2024-12-20",0,0,89,329,0,89,0,329
"Central African Republic","2024-12-21",0,0,89,329,0,89,0,329
"Central African Republic","2024-12-22",0,0,89,329,0,89,0,329
"Central African Republic","2024-12-23",0,0,89,329,1,90,0,329
"Central African Republic","2024-12-24",0,0,89,329,0,90,0,329
"Central African Republic","2024-12-25",0,0,89,329,0,90,0,329
"Central African Republic","2024-12-26",0,0,89,329,0,90,0,329
"Central African Republic","2024-12-27",0,0,89,329,0,90,0,329
"Central African Republic","2024-12-28",0,0,89,329,0,90,0,329
"Central African Republic","2024-12-29",0,1,90,329,0,90,0,329
"Central African Republic","2024-12-30",0,0,90,329,0,90,0,329
"Central African Republic","2024-12-31",0,0,90,329,1,91,0,329
"Central African Republic","2025-01-01",0,0,90,329,0,91,0,329
"Central African Republic","2025-01-02",0,0,90,329,1,92,0,329
"Central African Republic","2025-01-03",0,0,90,329,0,92,0,329
"Central African Republic","2025-01-04",0,0,90,329,1,93,0,329
"Central African Republic","2025-01-05",0,3,93,329,0,93,0,329
"Central African Republic","2025-01-06",0,0,93,329,1,94,0,329
"Central African Republic","2025-01-07",0,0,93,329,0,94,0,329
"Central African Republic","2025-01-08",0,2,95,329,1,95,0,329
"Central African Republic","2025-01-09",0,0,95,329,0,95,0,329
"Central African Republic","2025-01-10",0,0,95,329,0,95,0,329
"Central African Republic","2025-01-11",0,0,95,329,0,95,0,329
"Central African Republic","2025-01-12",0,0,95,329,0,95,0,329
"Central African Republic","2025-01-13",0,0,95,329,0,95,0,329
"Central African Republic","2025-01-14",0,0,95,329,0,95,0,329
"Central African Republic","2025-01-15",0,0,95,329,0,95,0,329
"Central African Republic","2025-01-16",0,0,95,329,0,95,0,329
"Central African Republic","2025-01-17",0,0,95,329,0,95,0,329
"Central African Republic","2025-01-18",0,0,95,329,0,95,0,329
"Central African Republic","2025-01-19",0,0,95,329,0,95,0,329
"Central African Republic","2025-01-20",0,0,95,329,0,95,0,329
"Central African Republic","2025-01-21",0,0,95,329,0,95,0,329
"Central African Republic","2025-01-22",0,0,95,329,0,95,0,329
"Central African Republic","2025-01-23",0,0,95,329,0,95,0,329
"Central African Republic","2025-01-24",0,0,95,329,0,95,0,329
"Central African Republic","2025-01-25",0,0,95,329,0,95,0,329
"Central African Republic","2025-01-26",0,0,95,329,0,95,0,329
"Central African Republic","2025-01-27",0,0,95,329,0,95,0,329
"Central African Republic","2025-01-28",0,0,95,329,0,95,0,329
"Central African Republic","2025-01-29",0,0,95,329,0,95,0,329
"Central African Republic","2025-01-30",0,0,95,329,0,95,0,329
"Central African Republic","2025-01-31",0,0,95,329,0,95,0,329
"Central African Republic","2025-02-01",0,0,95,329,0,95,0,329
"Central African Republic","2025-02-02",0,0,95,329,0,95,0,329
"Central African Republic","2025-02-03",0,0,95,329,0,95,0,329
"Chile","2024-01-01",0,0,0,0,0,0,0,0
"Chile","2024-01-02",0,1,1,0,1,1,0,0
"Chile","2024-01-03",0,0,1,0,0,1,0,0
"Chile","2024-01-04",0,0,1,0,0,1,0,0
"Chile","2024-01-05",0,0,1,0,0,1,0,0
"Chile","2024-01-06",0,0,1,0,0,1,0,0
"Chile","2024-01-07",0,0,1,0,0,1,0,0
"Chile","2024-01-08",0,0,1,0,0,1,0,0
"Chile","2024-01-09",0,0,1,0,0,1,0,0
"Chile","2024-01-10",0,0,1,0,0,1,0,0
"Chile","2024-01-11",0,0,1,0,0,1,0,0
"Chile","2024-01-12",0,0,1,0,0,1,0,0
"Chile","2024-01-13",0,0,1,0,0,1,0,0
"Chile","2024-01-14",0,0,1,0,0,1,0,0
"Chile","2024-01-15",0,0,1,0,0,1,0,0
"Chile","2024-01-16",0,0,1,0,0,1,0,0
"Chile","2024-01-17",0,0,1,0,0,1,0,0
"Chile","2024-01-18",0,0,1,0,0,1,0,0
"Chile","2024-01-19",0,0,1,0,0,1,0,0
"Chile","2024-01-20",0,0,1,0,1,2,0,0
"Chile","2024-01-21",0,0,1,0,0,2,0,0
"Chile","2024-01-22",0,0,1,0,0,2,0,0
"Chile","2024-01-23",0,0,1,0,0,2,0,0
"Chile","2024-01-24",0,0,1,0,0,2,0,0
"Chile","2024-01-25",0,0,1,0,0,2,0,0
"Chile","2024-01-26",0,0,1,0,0,2,0,0
"Chile","2024-01-27",0,0,1,0,0,2,0,0
"Chile","2024-01-28",0,0,1,0,0,2,0,0
"Chile","2024-01-29",0,0,1,0,0,2,0,0
"Chile","2024-01-30",0,0,1,0,0,2,0,0
"Chile","2024-01-31",0,0,1,0,0,2,0,0
"Chile","2024-02-01",0,0,1,0,0,2,0,0
"Chile","2024-02-02",0,0,1,0,0,2,0,0
"Chile","2024-02-03",0,0,1,0,0,2,0,0
"Chile","2024-02-04",0,0,1,0,0,2,0,0
"Chile","2024-02-05",0,0,1,0,0,2,0,0
"Chile","2024-02-06",0,1,2,0,0,2,0,0
"Chile","2024-02-07",0,0,2,0,0,2,0,0
"Chile","2024-02-08",0,0,2,0,0,2,0,0
"Chile","2024-02-09",0,0,2,0,0,2,0,0
"Chile","2024-02-10",0,0,2,0,0,2,0,0
"Chile","2024-02-11",0,0,2,0,0,2,0,0
"Chile","2024-02-12",0,0,2,0,0,2,0,0
"Chile","2024-02-13",0,0,2,0,0,2,0,0
"Chile","2024-02-14",0,0,2,0,1,3,0,0
"Chile","2024-02-15",0,0,2,0,0,3,0,0
"Chile","2024-02-16",0,0,2,0,0,3,0,0
"Chile","2024-02-17",0,0,2,0,0,3,0,0
"Chile","2024-02-18",0,0,2,0,0,3,0,0
"Chile","2024-02-19",0,0,2,0,0,3,0,0
"Chile","2024-02-20",0,1,3,0,0,3,0,0
"Chile","2024-02-21",0,0,3,0,0,3,0,0
"Chile","2024-02-22",0,0,3,0,0,3,0,0
"Chile","2024-02-23",0,0,3,0,0,3,0,0
"Chile","2024-02-24",0,0,3,0,1,4,0,0
"Chile","2024-02-25",0,0,3,0,0,4,0,0
"Chile","2024-02-26",0,0,3,0,0,4,0,0
"Chile","2024-02-27",0,1,4,0,0,4,0,0
"Chile","2024-02-28",0,0,4,0,0,4,0,0
"Chile","2024-02-29",0,0,4,0,1,5,0,0
"Chile","2024-03-01",0,0,4,0,0,5,0,0
"Chile","2024-03-02",0,0,4,0,0,5,0,0
"Chile","2024-03-03",0,0,4,0,0,5,0,0
"Chile","2024-03-04",0,0,4,0,1,6,0,0
"Chile","2024-03-05",0,2,6,0,0,6,0,0
"Chile","2024-03-06",0,0,6,0,0,6,0,0
"Chile","2024-03-07",0,0,6,0,0,6,0,0
"Chile","2024-03-08",0,0,6,0,0,6,0,0
"Chile","2024-03-09",0,0,6,0,0,6,0,0
"Chile","2024-03-10",0,0,6,0,0,6,0,0
"Chile","2024-03-11",0,0,6,0,0,6,0,0
"Chile","2024-03-12",0,0,6,0,0,6,0,0
"Chile","2024-03-13",0,0,6,0,0,6,0,0
"Chile","2024-03-14",0,0,6,0,0,6,0,0
"Chile","2024-03-15",0,0,6,0,0,6,0,0
"Chile","2024-03-16",0,0,6,0,0,6,0,0
"Chile","2024-03-17",0,0,6,0,0,6,0,0
"Chile","2024-03-18",0,0,6,0,0,6,0,0
"Chile","2024-03-19",0,0,6,0,0,6,0,0
"Chile","2024-03-20",0,0,6,0,0,6,0,0
"Chile","2024-03-21",0,0,6,0,0,6,0,0
"Chile","2024-03-22",0,0,6,0,0,6,0,0
"Chile","2024-03-23",0,0,6,0,0,6,0,0
"Chile","2024-03-24",0,0,6,0,0,6,0,0
"Chile","2024-03-25",0,0,6,0,0,6,0,0
"Chile","2024-03-26",0,0,6,0,0,6,0,0
"Chile","2024-03-27",0,0,6,0,0,6,0,0
"Chile","2024-03-28",0,0,6,0,0,6,0,0
"Chile","2024-03-29",0,0,6,0,0,6,0,0
"Chile","2024-03-30",0,0,6,0,0,6,0,0
"Chile","2024-03-31",0,0,6,0,0,6,0,0
"Chile","2024-04-01",0,0,6,0,0,6,0,0
"Chile","2024-04-02",0,0,6,0,0,6,0,0
"Chile","2024-04-03",0,0,6,0,0,6,0,0
"Chile","2024-04-04",0,0,6,0,0,6,0,0
"Chile","2024-04-05",0,0,6,0,0,6,0,0
"Chile","2024-04-06",0,0,6,0,0,6,0,0
"Chile","2024-04-07",0,0,6,0,0,6,0,0
"Chile","2024-04-08",0,0,6,0,0,6,0,0
"Chile","2024-04-09",0,0,6,0,0,6,0,0
"Chile","2024-04-10",0,0,6,0,0,6,0,0
"Chile","2024-04-11",0,0,6,0,0,6,0,0
"Chile","2024-04-12",0,0,6,0,0,6,0,0
"Chile","2024-04-13",0,0,6,0,0,6,0,0
"Chile","2024-04-14",0,0,6,0,0,6,0,0
"Chile","2024-04-15",0,0,6,0,0,6,0,0
"Chile","2024-04-16",0,0,6,0,0,6,0,0
"Chile","2024-04-17",0,0,6,0,0,6,0,0
"Chile","2024-04-18",0,0,6,0,0,6,0,0
"Chile","2024-04-19",0,0,6,0,0,6,0,0
"Chile","2024-04-20",0,0,6,0,0,6,0,0
"Chile","2024-04-21",0,0,6,0,0,6,0,0
"Chile","2024-04-22",0,0,6,0,0,6,0,0
"Chile","2024-04-23",0,0,6,0,0,6,0,0
"Chile","2024-04-24",0,0,6,0,0,6,0,0
"Chile","2024-04-25",0,0,6,0,0,6,0,0
"Chile","2024-04-26",0,0,6,0,0,6,0,0
"Chile","2024-04-27",0,0,6,0,0,6,0,0
"Chile","2024-04-28",0,0,6,0,0,6,0,0
"Chile","2024-04-29",0,0,6,0,0,6,0,0
"Chile","2024-04-30",0,0,6,0,0,6,0,0
"Chile","2024-05-01",0,0,6,0,0,6,0,0
"Chile","2024-05-02",0,0,6,0,0,6,0,0
"Chile","2024-05-03",0,0,6,0,0,6,0,0
"Chile","2024-05-04",0,0,6,0,0,6,0,0
"Chile","2024-05-05",0,0,6,0,0,6,0,0
"Chile","2024-05-06",0,0,6,0,0,6,0,0
"Chile","2024-05-07",0,0,6,0,0,6,0,0
"Chile","2024-05-08",0,0,6,0,0,6,0,0
"Chile","2024-05-09",0,0,6,0,0,6,0,0
"Chile","2024-05-10",0,0,6,0,0,6,0,0
"Chile","2024-05-11",0,0,6,0,0,6,0,0
"Chile","2024-05-12",0,0,6,0,0,6,0,0
"Chile","2024-05-13",0,0,6,0,0,6,0,0
"Chile","2024-05-14",0,0,6,0,0,6,0,0
"Chile","2024-05-15",0,0,6,0,1,7,0,0
"Chile","2024-05-16",0,0,6,0,0,7,0,0
"Chile","2024-05-17",0,0,6,0,0,7,0,0
"Chile","2024-05-18",0,0,6,0,0,7,0,0
"Chile","2024-05-19",0,0,6,0,0,7,0,0
"Chile","2024-05-20",0,0,6,0,0,7,0,0
"Chile","2024-05-21",0,0,6,0,0,7,0,0
"Chile","2024-05-22",0,0,6,0,0,7,0,0
"Chile","2024-05-23",0,0,6,0,0,7,0,0
"Chile","2024-05-24",0,0,6,0,0,7,0,0
"Chile","2024-05-25",0,0,6,0,0,7,0,0
"Chile","2024-05-26",0,0,6,0,0,7,0,0
"Chile","2024-05-27",0,0,6,0,0,7,0,0
"Chile","2024-05-28",0,0,6,0,0,7,0,0
"Chile","2024-05-29",0,0,6,0,0,7,0,0
"Chile","2024-05-30",0,0,6,0,0,7,0,0
"Chile","2024-05-31",0,0,6,0,0,7,0,0
"Chile","2024-06-01",0,0,6,0,0,7,0,0
"Chile","2024-06-02",0,0,6,0,0,7,0,0
"Chile","2024-06-03",0,0,6,0,0,7,0,0
"Chile","2024-06-04",0,0,6,0,0,7,0,0
"Chile","2024-06-05",0,0,6,0,0,7,0,0
"Chile","2024-06-06",0,0,6,0,0,7,0,0
"Chile","2024-06-07",0,0,6,0,0,7,0,0
"Chile","2024-06-08",0,0,6,0,0,7,0,0
"Chile","2024-06-09",0,0,6,0,0,7,0,0
"Chile","2024-06-10",0,0,6,0,0,7,0,0
"Chile","2024-06-11",0,0,6,0,0,7,0,0
"Chile","2024-06-12",0,0,6,0,0,7,0,0
"Chile","2024-06-13",0,0,6,0,0,7,0,0
"Chile","2024-06-14",0,0,6,0,0,7,0,0
"Chile","2024-06-15",0,0,6,0,0,7,0,0
"Chile","2024-06-16",0,0,6,0,0,7,0,0
"Chile","2024-06-17",0,0,6,0,0,7,0,0
"Chile","2024-06-18",0,0,6,0,0,7,0,0
"Chile","2024-06-19",0,0,6,0,0,7,0,0
"Chile","2024-06-20",0,0,6,0,0,7,0,0
"Chile","2024-06-21",0,0,6,0,0,7,0,0
"Chile","2024-06-22",0,0,6,0,0,7,0,0
"Chile","2024-06-23",0,0,6,0,0,7,0,0
"Chile","2024-06-24",0,0,6,0,0,7,0,0
"Chile","2024-06-25",0,0,6,0,0,7,0,0
"Chile","2024-06-26",0,0,6,0,0,7,0,0
"Chile","2024-06-27",0,0,6,0,0,7,0,0
"Chile","2024-06-28",0,0,6,0,0,7,0,0
"Chile","2024-06-29",0,0,6,0,0,7,0,0
"Chile","2024-06-30",0,0,6,0,0,7,0,0
"Chile","2024-07-01",0,0,6,0,0,7,0,0
"Chile","2024-07-02",0,0,6,0,0,7,0,0
"Chile","2024-07-03",0,0,6,0,0,7,0,0
"Chile","2024-07-04",0,0,6,0,0,7,0,0
"Chile","2024-07-05",0,0,6,0,0,7,0,0
"Chile","2024-07-06",0,0,6,0,0,7,0,0
"Chile","2024-07-07",0,0,6,0,0,7,0,0
"Chile","2024-07-08",0,0,6,0,0,7,0,0
"Chile","2024-07-09",0,0,6,0,0,7,0,0
"Chile","2024-07-10",0,0,6,0,0,7,0,0
"Chile","2024-07-11",0,0,6,0,0,7,0,0
"Chile","2024-07-12",0,0,6,0,0,7,0,0
"Chile","2024-07-13",0,0,6,0,0,7,0,0
"Chile","2024-07-14",0,0,6,0,0,7,0,0
"Chile","2024-07-15",0,0,6,0,0,7,0,0
"Chile","2024-07-16",0,0,6,0,0,7,0,0
"Chile","2024-07-17",0,0,6,0,0,7,0,0
"Chile","2024-07-18",0,0,6,0,0,7,0,0
"Chile","2024-07-19",0,0,6,0,0,7,0,0
"Chile","2024-07-20",0,0,6,0,0,7,0,0
"Chile","2024-07-21",0,0,6,0,0,7,0,0
"Chile","2024-07-22",0,0,6,0,0,7,0,0
"Chile","2024-07-23",0,1,7,0,0,7,0,0
"Chile","2024-07-24",0,0,7,0,0,7,0,0
"Chile","2024-07-25",0,0,7,0,0,7,0,0
"Chile","2024-07-26",0,0,7,0,0,7,0,0
"Chile","2024-07-27",0,0,7,0,0,7,0,0
"Chile","2024-07-28",0,0,7,0,0,7,0,0
"Chile","2024-07-29",0,0,7,0,0,7,0,0
"Chile","2024-07-30",0,0,7,0,0,7,0,0
"Chile","2024-07-31",0,0,7,0,0,7,0,0
"Chile","2024-08-01",0,0,7,0,0,7,0,0
"Chile","2024-08-02",0,0,7,0,0,7,0,0
"Chile","2024-08-03",0,0,7,0,0,7,0,0
"Chile","2024-08-04",0,0,7,0,0,7,0,0
"Chile","2024-08-05",0,0,7,0,0,7,0,0
"Chile","2024-08-06",0,0,7,0,0,7,0,0
"Chile","2024-08-07",0,0,7,0,0,7,0,0
"Chile","2024-08-08",0,0,7,0,0,7,0,0
"Chile","2024-08-09",0,0,7,0,0,7,0,0
"Chile","2024-08-10",0,0,7,0,1,8,0,0
"Chile","2024-08-11",0,0,7,0,0,8,0,0
"Chile","2024-08-12",0,0,7,0,0,8,0,0
"Chile","2024-08-13",0,0,7,0,0,8,0,0
"Chile","2024-08-14",0,0,7,0,0,8,0,0
"Chile","2024-08-15",0,0,7,0,0,8,0,0
"Chile","2024-08-16",0,0,7,0,0,8,0,0
"Chile","2024-08-17",0,0,7,0,0,8,0,0
"Chile","2024-08-18",0,0,7,0,0,8,0,0
"Chile","2024-08-19",0,0,7,0,0,8,0,0
"Chile","2024-08-20",0,0,7,0,0,8,0,0
"Chile","2024-08-21",0,0,7,0,0,8,0,0
"Chile","2024-08-22",0,0,7,0,0,8,0,0
"Chile","2024-08-23",0,0,7,0,0,8,0,0
"Chile","2024-08-24",0,0,7,0,0,8,0,0
"Chile","2024-08-25",0,0,7,0,0,8,0,0
"Chile","2024-08-26",0,0,7,0,0,8,0,0
"Chile","2024-08-27",0,1,8,0,0,8,0,0
"Chile","2024-08-28",0,0,8,0,0,8,0,0
"Chile","2024-08-29",0,0,8,0,0,8,0,0
"Chile","2024-08-30",0,0,8,0,0,8,0,0
"Chile","2024-08-31",0,0,8,0,1,9,0,0
"Chile","2024-09-01",0,0,8,0,0,9,0,0
"Chile","2024-09-02",0,0,8,0,0,9,0,0
"Chile","2024-09-03",0,1,9,0,0,9,0,0
"Chile","2024-09-04",0,0,9,0,0,9,0,0
"Chile","2024-09-05",0,0,9,0,0,9,0,0
"Chile","2024-09-06",0,0,9,0,0,9,0,0
"Chile","2024-09-07",0,0,9,0,0,9,0,0
"Chile","2024-09-08",0,0,9,0,0,9,0,0
"Chile","2024-09-09",0,0,9,0,0,9,0,0
"Chile","2024-09-10",0,0,9,0,0,9,0,0
"Chile","2024-09-11",0,0,9,0,0,9,0,0
"Chile","2024-09-12",0,0,9,0,0,9,0,0
"Chile","2024-09-13",0,0,9,0,0,9,0,0
"Chile","2024-09-14",0,0,9,0,1,10,0,0
"Chile","2024-09-15",0,0,9,0,0,10,0,0
"Chile","2024-09-16",0,0,9,0,0,10,0,0
"Chile","2024-09-17",0,0,9,0,0,10,0,0
"Chile","2024-09-18",0,0,9,0,0,10,0,0
"Chile","2024-09-19",0,0,9,0,0,10,0,0
"Chile","2024-09-20",0,0,9,0,0,10,0,0
"Chile","2024-09-21",0,0,9,0,0,10,0,0
"Chile","2024-09-22",0,0,9,0,0,10,0,0
"Chile","2024-09-23",0,0,9,0,0,10,0,0
"Chile","2024-09-24",0,1,10,0,0,10,0,0
"Chile","2024-09-25",0,0,10,0,0,10,0,0
"Chile","2024-09-26",0,0,10,0,0,10,0,0
"Chile","2024-09-27",0,0,10,0,0,10,0,0
"Chile","2024-09-28",0,0,10,0,1,11,0,0
"Chile","2024-09-29",0,0,10,0,0,11,0,0
"Chile","2024-09-30",0,0,10,0,0,11,0,0
"Chile","2024-10-01",0,1,11,0,0,11,0,0
"Chile","2024-10-02",0,0,11,0,0,11,0,0
"Chile","2024-10-03",0,0,11,0,1,12,0,0
"Chile","2024-10-04",0,0,11,0,0,12,0,0
"Chile","2024-10-05",0,0,11,0,0,12,0,0
"Chile","2024-10-06",0,0,11,0,0,12,0,0
"Chile","2024-10-07",0,0,11,0,1,13,0,0
"Chile","2024-10-08",0,2,13,0,0,13,0,0
"Chile","2024-10-09",0,0,13,0,0,13,0,0
"Chile","2024-10-10",0,0,13,0,0,13,0,0
"Chile","2024-10-11",0,0,13,0,0,13,0,0
"Chile","2024-10-12",0,0,13,0,1,14,0,0
"Chile","2024-10-13",0,0,13,0,0,14,0,0
"Chile","2024-10-14",0,0,13,0,0,14,0,0
"Chile","2024-10-15",0,0,13,0,0,14,0,0
"Chile","2024-10-16",0,0,13,0,0,14,0,0
"Chile","2024-10-17",0,0,13,0,0,14,0,0
"Chile","2024-10-18",0,0,13,0,0,14,0,0
"Chile","2024-10-19",0,0,13,0,1,15,0,0
"Chile","2024-10-20",0,0,13,0,0,15,0,0
"Chile","2024-10-21",0,0,13,0,0,15,0,0
"Chile","2024-10-22",0,2,15,0,0,15,0,0
"Chile","2024-10-23",0,0,15,0,1,16,0,0
"Chile","2024-10-24",0,0,15,0,0,16,0,0
"Chile","2024-10-25",0,0,15,0,1,17,0,0
"Chile","2024-10-26",0,0,15,0,0,17,0,0
"Chile","2024-10-27",0,0,15,0,1,18,0,0
"Chile","2024-10-28",0,0,15,0,0,18,0,0
"Chile","2024-10-29",0,4,19,0,1,19,0,0
"Chile","2024-10-30",0,0,19,0,1,20,0,0
"Chile","2024-10-31",0,0,19,0,0,20,0,0
"Chile","2024-11-01",0,0,19,0,1,21,0,0
"Chile","2024-11-02",0,0,19,0,0,21,0,0
"Chile","2024-11-03",0,0,19,0,1,22,0,0
"Chile","2024-11-04",0,0,19,0,0,22,0,0
"Chile","2024-11-05",0,4,23,0,1,23,0,0
"Chile","2024-11-06",0,0,23,0,0,23,0,0
"Chile","2024-11-07",0,0,23,0,1,24,0,0
"Chile","2024-11-08",0,0,23,0,0,24,0,0
"Chile","2024-11-09",0,0,23,0,0,24,0,0
"Chile","2024-11-10",0,0,23,0,0,24,0,0
"Chile","2024-11-11",0,0,23,0,1,25,0,0
"Chile","2024-11-12",0,2,25,0,0,25,0,0
"Chile","2024-11-13",0,0,25,0,0,25,0,0
"Chile","2024-11-14",0,0,25,0,0,25,0,0
"Chile","2024-11-15",0,0,25,0,0,25,0,0
"Chile","2024-11-16",0,0,25,0,1,26,0,0
"Chile","2024-11-17",0,0,25,0,0,26,0,0
"Chile","2024-11-18",0,0,25,0,0,26,0,0
"Chile","2024-11-19",0,1,26,0,0,26,0,0
"Chile","2024-11-20",0,0,26,0,0,26,0,0
"Chile","2024-11-21",0,0,26,0,0,26,0,0
"Chile","2024-11-22",0,0,26,0,0,26,0,0
"Chile","2024-11-23",0,0,26,0,0,26,0,0
"Chile","2024-11-24",0,0,26,0,0,26,0,0
"Chile","2024-11-25",0,0,26,0,0,26,0,0
"Chile","2024-11-26",0,0,26,0,0,26,0,0
"Chile","2024-11-27",0,0,26,0,0,26,0,0
"Chile","2024-11-28",0,0,26,0,0,26,0,0
"Chile","2024-11-29",0,0,26,0,0,26,0,0
"Chile","2024-11-30",0,0,26,0,0,26,0,0
"Chile","2024-12-01",0,0,26,0,0,26,0,0
"Chile","2024-12-02",0,0,26,0,0,26,0,0
"Chile","2024-12-03",0,0,26,0,0,26,0,0
"Chile","2024-12-04",0,0,26,0,0,26,0,0
"Chile","2024-12-05",0,0,26,0,0,26,0,0
"Chile","2024-12-06",0,0,26,0,0,26,0,0
"Chile","2024-12-07",0,0,26,0,0,26,0,0
"Chile","2024-12-08",0,0,26,0,0,26,0,0
"Chile","2024-12-09",0,0,26,0,0,26,0,0
"Chile","2024-12-10",0,0,26,0,0,26,0,0
"Chile","2024-12-11",0,0,26,0,0,26,0,0
"Chile","2024-12-12",0,0,26,0,0,26,0,0
"Chile","2024-12-13",0,0,26,0,0,26,0,0
"Chile","2024-12-14",0,0,26,0,0,26,0,0
"Chile","2024-12-15",0,0,26,0,0,26,0,0
"Chile","2024-12-16",0,0,26,0,0,26,0,0
"Chile","2024-12-17",0,0,26,0,0,26,0,0
"Chile","2024-12-18",0,0,26,0,0,26,0,0
"Chile","2024-12-19",0,0,26,0,0,26,0,0
"Chile","2024-12-20",0,0,26,0,0,26,0,0
"Chile","2024-12-21",0,0,26,0,0,26,0,0
"Chile","2024-12-22",0,0,26,0,0,26,0,0
"Chile","2024-12-23",0,0,26,0,0,26,0,0
"Chile","2024-12-24",0,0,26,0,0,26,0,0
"Chile","2024-12-25",0,0,26,0,0,26,0,0
"Chile","2024-12-26",0,0,26,0,0,26,0,0
"Chile","2024-12-27",0,0,26,0,0,26,0,0
"Chile","2024-12-28",0,0,26,0,0,26,0,0
"Chile","2024-12-29",0,0,26,0,0,26,0,0
"Chile","2024-12-30",0,0,26,0,0,26,0,0
"Chile","2024-12-31",0,0,26,0,0,26,0,0
"Chile","2025-01-01",0,0,26,0,0,26,0,0
"Chile","2025-01-02",0,0,26,0,0,26,0,0
"Chile","2025-01-03",0,0,26,0,0,26,0,0
"Chile","2025-01-04",0,0,26,0,0,26,0,0
"Chile","2025-01-05",0,0,26,0,0,26,0,0
"Chile","2025-01-06",0,0,26,0,0,26,0,0
"Chile","2025-01-07",0,0,26,0,0,26,0,0
"Chile","2025-01-08",0,0,26,0,0,26,0,0
"Chile","2025-01-09",0,0,26,0,0,26,0,0
"Chile","2025-01-10",0,0,26,0,0,26,0,0
"Chile","2025-01-11",0,0,26,0,0,26,0,0
"Chile","2025-01-12",0,0,26,0,0,26,0,0
"Chile","2025-01-13",0,0,26,0,0,26,0,0
"Chile","2025-01-14",0,0,26,0,0,26,0,0
"Chile","2025-01-15",0,0,26,0,0,26,0,0
"Chile","2025-01-16",0,0,26,0,0,26,0,0
"Chile","2025-01-17",0,0,26,0,0,26,0,0
"Chile","2025-01-18",0,0,26,0,0,26,0,0
"Chile","2025-01-19",0,0,26,0,0,26,0,0
"Chile","2025-01-20",0,0,26,0,0,26,0,0
"Chile","2025-01-21",0,0,26,0,0,26,0,0
"Chile","2025-01-22",0,0,26,0,0,26,0,0
"Chile","2025-01-23",0,0,26,0,0,26,0,0
"Chile","2025-01-24",0,0,26,0,0,26,0,0
"Chile","2025-01-25",0,0,26,0,0,26,0,0
"Chile","2025-01-26",0,0,26,0,0,26,0,0
"Chile","2025-01-27",0,0,26,0,0,26,0,0
"Chile","2025-01-28",0,0,26,0,0,26,0,0
"Chile","2025-01-29",0,0,26,0,0,26,0,0
"Chile","2025-01-30",0,0,26,0,0,26,0,0
"Chile","2025-01-31",0,0,26,0,0,26,0,0
"Chile","2025-02-01",0,0,26,0,0,26,0,0
"Chile","2025-02-02",0,0,26,0,0,26,0,0
"Chile","2025-02-03",0,0,26,0,0,26,0,0
"China","2024-01-01",0,0,0,0,0,0,0,0
"China","2024-01-02",0,0,0,0,0,0,0,0
"China","2024-01-03",0,0,0,0,0,0,0,0
"China","2024-01-04",0,0,0,0,0,0,0,0
"China","2024-01-05",0,0,0,0,0,0,0,0
"China","2024-01-06",0,0,0,0,0,0,0,0
"China","2024-01-07",0,0,0,0,0,0,0,0
"China","2024-01-08",0,0,0,0,0,0,0,0
"China","2024-01-09",0,0,0,0,0,0,0,0
"China","2024-01-10",0,0,0,0,0,0,0,0
"China","2024-01-11",0,0,0,0,0,0,0,0
"China","2024-01-12",0,1,1,0,1,1,0,0
"China","2024-01-13",0,0,1,0,0,1,0,0
"China","2024-01-14",0,0,1,0,0,1,0,0
"China","2024-01-15",0,0,1,0,1,2,0,0
"China","2024-01-16",0,0,1,0,0,2,0,0
"China","2024-01-17",0,1,2,0,0,2,0,0
"China","2024-01-18",0,0,2,0,0,2,0,0
"China","2024-01-19",0,0,2,0,0,2,0,0
"China","2024-01-20",0,0,2,0,0,2,0,0
"China","2024-01-21",0,0,2,0,1,3,0,0
"China","2024-01-22",0,0,2,0,0,3,0,0
"China","2024-01-23",0,0,2,0,0,3,0,0
"China","2024-01-24",0,1,3,0,0,3,0,0
"China","2024-01-25",0,0,3,0,14,17,0,0
"China","2024-01-26",0,0,3,0,14,31,0,0
"China","2024-01-27",0,0,3,0,14,45,0,0
"China","2024-01-28",0,0,3,0,13,58,0,0
"China","2024-01-29",0,0,3,0,14,72,0,0
"China","2024-01-30",0,0,3,0,14,86,0,0
"China","2024-01-31",0,97,100,0,14,100,0,0
"China","2024-02-01",0,0,100,0,0,100,0,0
"China","2024-02-02",0,1,101,0,1,101,0,0
"China","2024-02-03",0,0,101,0,0,101,0,0
"China","2024-02-04",0,0,101,0,0,101,0,0
"China","2024-02-05",0,0,101,0,0,101,0,0
"China","2024-02-06",0,0,101,0,0,101,0,0
"China","2024-02-07",0,0,101,0,0,101,0,0
"China","2024-02-08",0,0,101,0,0,101,0,0
"China","2024-02-09",0,0,101,0,1,102,0,0
"China","2024-02-10",0,0,101,0,0,102,0,0
"China","2024-02-11",0,0,101,0,0,102,0,0
"China","2024-02-12",0,0,101,0,0,102,0,0
"China","2024-02-13",0,0,101,0,0,102,0,0
"China","2024-02-14",0,0,101,0,0,102,0,0
"China","2024-02-15",0,1,102,0,0,102,0,0
"China","2024-02-16",0,0,102,0,0,102,0,0
"China","2024-02-17",0,0,102,0,0,102,0,0
"China","2024-02-18",0,0,102,0,0,102,0,0
"China","2024-02-19",0,0,102,0,0,102,0,0
"China","2024-02-20",0,0,102,0,1,103,0,0
"China","2024-02-21",0,0,102,0,0,103,0,0
"China","2024-02-22",0,0,102,0,0,103,0,0
"China","2024-02-23",0,1,103,0,0,103,0,0
"China","2024-02-24",0,0,103,0,12,115,0,0
"China","2024-02-25",0,0,103,0,11,126,0,0
"China","2024-02-26",0,0,103,0,12,138,0,0
"China","2024-02-27",0,0,103,0,12,150,0,0
"China","2024-02-28",0,0,103,0,11,161,0,0
"China","2024-02-29",0,70,173,0,12,173,0,0
"China","2024-03-01",0,3,176,0,3,176,0,0
"China","2024-03-02",0,0,176,0,2,178,0,0
"China","2024-03-03",0,0,176,0,1,179,0,0
"China","2024-03-04",0,0,176,0,2,181,0,0
"China","2024-03-05",0,0,176,0,2,183,0,0
"China","2024-03-06",0,0,176,0,1,184,0,0
"China","2024-03-07",0,0,176,0,2,186,0,0
"China","2024-03-08",0,0,176,0,2,188,0,0
"China","2024-03-09",0,0,176,0,2,190,0,0
"China","2024-03-10",0,0,176,0,1,191,0,0
"China","2024-03-11",0,0,176,0,2,193,0,0
"China","2024-03-12",0,0,176,0,2,195,0,0
"China","2024-03-13",0,0,176,0,1,196,0,0
"China","2024-03-14",0,0,176,0,2,198,0,0
"China","2024-03-15",0,0,176,0,2,200,0,0
"China","2024-03-16",0,0,176,0,2,202,0,0
"China","2024-03-17",0,0,176,0,1,203,0,0
"China","2024-03-18",0,0,176,0,2,205,0,0
"China","2024-03-19",0,0,176,0,2,207,0,0
"China","2024-03-20",0,0,176,0,1,208,0,0
"China","2024-03-21",0,0,176,0,2,210,0,0
"China","2024-03-22",0,0,176,0,2,212,0,0
"China","2024-03-23",0,0,176,0,1,213,0,0
"China","2024-03-24",0,0,176,0,2,215,0,0
"China","2024-03-25",0,0,176,0,2,217,0,0
"China","2024-03-26",0,0,176,0,1,218,0,0
"China","2024-03-27",0,0,176,0,2,220,0,0
"China","2024-03-28",0,0,176,0,2,222,0,0
"China","2024-03-29",0,0,176,0,2,224,0,0
"China","2024-03-30",0,0,176,0,1,225,0,0
"China","2024-03-31",0,51,227,0,2,227,0,0
"China","2024-04-01",0,0,227,0,0,227,0,0
"China","2024-04-02",0,0,227,0,0,227,0,0
"China","2024-04-03",0,0,227,0,1,228,0,0
"China","2024-04-04",0,0,227,0,0,228,0,0
"China","2024-04-05",0,1,228,0,0,228,0,0
"China","2024-04-06",0,0,228,0,0,228,0,0
"China","2024-04-07",0,0,228,0,0,228,0,0
"China","2024-04-08",0,0,228,0,0,228,0,0
"China","2024-04-09",0,0,228,0,1,229,0,0
"China","2024-04-10",0,0,228,0,0,229,0,0
"China","2024-04-11",0,0,228,0,0,229,0,0
"China","2024-04-12",0,1,229,0,0,229,0,0
"China","2024-04-13",0,0,229,0,0,229,0,0
"China","2024-04-14",0,0,229,0,0,229,0,0
"China","2024-04-15",0,0,229,0,0,229,0,0
"China","2024-04-16",0,0,229,0,0,229,0,0
"China","2024-04-17",0,0,229,0,0,229,0,0
"China","2024-04-18",0,0,229,0,0,229,0,0
"China","2024-04-19",0,0,229,0,0,229,0,0
"China","2024-04-20",0,0,229,0,1,230,0,0
"China","2024-04-21",0,0,229,0,0,230,0,0
"China","2024-04-22",0,0,229,0,0,230,0,0
"China","2024-04-23",0,0,229,0,0,230,0,0
"China","2024-04-24",0,0,229,0,0,230,0,0
"China","2024-04-25",0,0,229,0,0,230,0,0
"China","2024-04-26",0,1,230,0,0,230,0,0
"China","2024-04-27",0,0,230,0,10,240,0,0
"China","2024-04-28",0,0,230,0,10,250,0,0
"China","2024-04-29",0,0,230,0,9,259,0,0
"China","2024-04-30",0,39,269,0,10,269,0,0
"China","2024-05-01",0,0,269,0,0,269,0,0
"China","2024-05-02",0,0,269,0,0,269,0,0
"China","2024-05-03",0,0,269,0,0,269,0,0
"China","2024-05-04",0,0,269,0,1,270,0,0
"China","2024-05-05",0,0,269,0,0,270,0,0
"China","2024-05-06",0,0,269,0,0,270,0,0
"China","2024-05-07",0,1,270,0,0,270,0,0
"China","2024-05-08",0,0,270,0,0,270,0,0
"China","2024-05-09",0,0,270,0,0,270,0,0
"China","2024-05-10",0,0,270,0,0,270,0,0
"China","2024-05-11",0,0,270,0,1,271,0,0
"China","2024-05-12",0,0,270,0,0,271,0,0
"China","2024-05-13",0,0,270,0,0,271,0,0
"China","2024-05-14",0,1,271,0,0,271,0,0
"China","2024-05-15",0,0,271,0,0,271,0,0
"China","2024-05-16",0,0,271,0,0,271,0,0
"China","2024-05-17",0,0,271,0,0,271,0,0
"China","2024-05-18",0,0,271,0,0,271,0,0
"China","2024-05-19",0,0,271,0,1,272,0,0
"China","2024-05-20",0,0,271,0,0,272,0,0
"China","2024-05-21",0,0,271,0,0,272,0,0
"China","2024-05-22",0,1,272,0,0,272,0,0
"China","2024-05-23",0,0,272,0,2,274,0,0
"China","2024-05-24",0,3,275,0,1,275,0,0
"China","2024-05-25",0,0,275,0,0,275,0,0
"China","2024-05-26",0,0,275,0,1,276,0,0
"China","2024-05-27",0,1,276,0,0,276,0,0
"China","2024-05-28",0,0,276,0,16,292,0,0
"China","2024-05-29",0,0,276,0,17,309,0,0
"China","2024-05-30",0,49,325,0,16,325,0,0
"China","2024-05-31",0,1,326,0,1,326,0,0
"China","2024-06-01",0,0,326,0,0,326,0,0
"China","2024-06-02",0,0,326,0,0,326,0,0
"China","2024-06-03",0,0,326,0,0,326,0,0
"China","2024-06-04",0,0,326,0,1,327,0,0
"China","2024-06-05",0,0,326,0,0,327,0,0
"China","2024-06-06",0,0,326,0,0,327,0,0
"China","2024-06-07",0,0,326,0,0,327,0,0
"China","2024-06-08",0,0,326,0,0,327,0,0
"China","2024-06-09",0,0,326,0,1,328,0,0
"China","2024-06-10",0,0,326,0,0,328,0,0
"China","2024-06-11",0,0,326,0,0,328,0,0
"China","2024-06-12",0,0,326,0,0,328,0,0
"China","2024-06-13",0,0,326,0,0,328,0,0
"China","2024-06-14",0,0,326,0,0,328,0,0
"China","2024-06-15",0,0,326,0,0,328,0,0
"China","2024-06-16",0,0,326,0,1,329,0,0
"China","2024-06-17",0,0,326,0,0,329,0,0
"China","2024-06-18",0,0,326,0,0,329,0,0
"China","2024-06-19",0,0,326,0,0,329,0,0
"China","2024-06-20",0,0,326,0,0,329,0,0
"China","2024-06-21",0,0,326,0,1,330,0,0
"China","2024-06-22",0,0,326,0,0,330,0,0
"China","2024-06-23",0,0,326,0,0,330,0,0
"China","2024-06-24",0,4,330,0,0,330,0,0
"China","2024-06-25",0,3,333,0,3,333,0,0
"China","2024-06-26",0,0,333,0,10,343,0,0
"China","2024-06-27",0,0,333,0,10,353,0,0
"China","2024-06-28",0,0,333,0,11,364,0,0
"China","2024-06-29",0,0,333,0,10,374,0,0
"China","2024-06-30",0,51,384,0,10,384,0,0
"China","2024-07-01",0,0,384,0,0,384,0,0
"China","2024-07-02",0,0,384,0,0,384,0,0
"China","2024-07-03",0,0,384,0,1,385,0,0
"China","2024-07-04",0,0,384,0,0,385,0,0
"China","2024-07-05",0,0,384,0,0,385,0,0
"China","2024-07-06",0,0,384,0,1,386,0,0
"China","2024-07-07",0,0,384,0,0,386,0,0
"China","2024-07-08",0,2,386,0,0,386,0,0
"China","2024-07-09",0,0,386,0,1,387,0,0
"China","2024-07-10",0,0,386,0,1,388,0,0
"China","2024-07-11",0,0,386,0,0,388,0,0
"China","2024-07-12",0,0,386,0,1,389,0,0
"China","2024-07-13",0,0,386,0,1,390,0,0
"China","2024-07-14",0,0,386,0,0,390,0,0
"China","2024-07-15",0,0,386,0,1,391,0,0
"China","2024-07-16",0,6,392,0,1,392,0,0
"China","2024-07-17",0,0,392,0,1,393,0,0
"China","2024-07-18",0,0,392,0,1,394,0,0
"China","2024-07-19",0,0,392,0,0,394,0,0
"China","2024-07-20",0,0,392,0,1,395,0,0
"China","2024-07-21",0,0,392,0,1,396,0,0
"China","2024-07-22",0,0,392,0,0,396,0,0
"China","2024-07-23",0,0,392,0,1,397,0,0
"China","2024-07-24",0,0,392,0,1,398,0,0
"China","2024-07-25",0,0,392,0,1,399,0,0
"China","2024-07-26",0,0,392,0,1,400,0,0
"China","2024-07-27",0,0,392,0,0,400,0,0
"China","2024-07-28",0,9,401,0,1,401,0,0
"China","2024-07-29",0,0,401,0,20,421,0,0
"China","2024-07-30",0,39,440,0,19,440,0,0
"China","2024-07-31",0,0,440,0,1,441,0,0
"China","2024-08-01",0,0,440,0,0,441,0,0
"China","2024-08-02",0,2,442,0,1,442,0,0
"China","2024-08-03",0,0,442,0,0,442,0,0
"China","2024-08-04",0,0,442,0,1,443,0,0
"China","2024-08-05",0,0,442,0,1,444,0,0
"China","2024-08-06",0,2,444,0,0,444,0,0
"China","2024-08-07",0,0,444,0,1,445,0,0
"China","2024-08-08",0,0,444,0,0,445,0,0
"China","2024-08-09",0,0,444,0,1,446,0,0
"China","2024-08-10",0,0,444,0,1,447,0,0
"China","2024-08-11",0,0,444,0,1,448,0,0
"China","2024-08-12",0,0,444,0,0,448,0,0
"China","2024-08-13",0,5,449,0,1,449,0,0
"China","2024-08-14",0,0,449,0,1,450,0,0
"China","2024-08-15",0,0,449,0,0,450,0,0
"China","2024-08-16",0,0,449,0,1,451,0,0
"China","2024-08-17",0,0,449,0,0,451,0,0
"China","2024-08-18",0,0,449,0,1,452,0,0
"China","2024-08-19",0,0,449,0,0,452,0,0
"China","2024-08-20",0,4,453,0,1,453,0,0
"China","2024-08-21",0,0,453,0,0,453,0,0
"China","2024-08-22",0,0,453,0,0,453,0,0
"China","2024-08-23",0,0,453,0,0,453,0,0
"China","2024-08-24",0,0,453,0,1,454,0,0
"China","2024-08-25",0,0,453,0,0,454,0,0
"China","2024-08-26",0,0,453,0,0,454,0,0
"China","2024-08-27",0,1,454,0,0,454,0,0
"China","2024-08-28",0,0,454,0,12,466,0,0
"China","2024-08-29",0,0,454,0,12,478,0,0
"China","2024-08-30",0,0,454,0,13,491,0,0
"China","2024-08-31",0,49,503,0,12,503,0,0
"China","2024-09-01",0,0,503,0,1,504,0,0
"China","2024-09-02",0,0,503,0,0,504,0,0
"China","2024-09-03",0,0,503,0,1,505,0,0
"China","2024-09-04",0,0,503,0,1,506,0,0
"China","2024-09-05",0,0,503,0,0,506,0,0
"China","2024-09-06",0,0,503,0,1,507,0,0
"China","2024-09-07",0,0,503,0,1,508,0,0
"China","2024-09-08",0,0,503,0,0,508,0,0
"China","2024-09-09",0,0,503,0,1,509,0,0
"China","2024-09-10",0,0,503,0,1,510,0,0
"China","2024-09-11",0,0,503,0,0,510,0,0
"China","2024-09-12",0,0,503,0,1,511,0,0
"China","2024-09-13",0,0,503,0,1,512,0,0
"China","2024-09-14",0,0,503,0,0,512,0,0
"China","2024-09-15",0,10,513,0,1,513,0,0
"China","2024-09-16",0,0,513,0,0,513,0,0
"China","2024-09-17",0,0,513,0,1,514,0,0
"China","2024-09-18",0,0,513,0,0,514,0,0
"China","2024-09-19",0,0,513,0,1,515,0,0
"China","2024-09-20",0,0,513,0,0,515,0,0
"China","2024-09-21",0,0,513,0,0,515,0,0
"China","2024-09-22",0,0,513,0,1,516,0,0
"China","2024-09-23",0,3,516,0,0,516,0,0
"China","2024-09-24",0,0,516,0,1,517,0,0
"China","2024-09-25",0,0,516,0,1,518,0,0
"China","2024-09-26",0,0,516,0,1,519,0,0
"China","2024-09-27",0,0,516,0,1,520,0,0
"China","2024-09-28",0,0,516,0,1,521,0,0
"China","2024-09-29",0,6,522,0,1,522,0,0
"China","2024-09-30",0,46,568,0,46,568,0,0
"China","2024-10-01",0,6,574,0,6,574,0,0
"China","2024-10-02",0,0,574,0,0,574,0,0
"China","2024-10-03",0,1,575,0,1,575,0,0
"China","2024-10-04",0,0,575,0,0,575,0,0
"China","2024-10-05",0,0,575,0,1,576,0,0
"China","2024-10-06",0,0,575,0,0,576,0,0
"China","2024-10-07",0,0,575,0,0,576,0,0
"China","2024-10-08",0,0,575,0,0,576,0,0
"China","2024-10-09",0,0,575,0,1,577,0,0
"China","2024-10-10",0,2,577,0,0,577,0,0
"China","2024-10-11",0,0,577,0,0,577,0,0
"China","2024-10-12",0,0,577,0,0,577,0,0
"China","2024-10-13",0,0,577,0,0,577,0,0
"China","2024-10-14",0,0,577,0,1,578,0,0
"China","2024-10-15",0,0,577,0,0,578,0,0
"China","2024-10-16",0,0,577,0,0,578,0,0
"China","2024-10-17",0,0,577,0,0,578,0,0
"China","2024-10-18",0,0,577,0,0,578,0,0
"China","2024-10-19",0,0,577,0,0,578,0,0
"China","2024-10-20",0,0,577,0,1,579,0,0
"China","2024-10-21",0,0,577,0,0,579,0,0
"China","2024-10-22",0,0,577,0,0,579,0,0
"China","2024-10-23",0,2,579,0,0,579,0,0
"China","2024-10-24",0,0,579,0,1,580,0,0
"China","2024-10-25",0,0,579,0,0,580,0,0
"China","2024-10-26",0,0,579,0,1,581,0,0
"China","2024-10-27",0,0,579,0,1,582,0,0
"China","2024-10-28",0,0,579,0,0,582,0,0
"China","2024-10-29",0,4,583,0,1,583,0,0
"China","2024-10-30",0,0,583,0,19,602,0,0
"China","2024-10-31",0,38,621,0,19,621,0,0
"China","2024-11-01",0,0,621,0,0,621,0,0
"China","2024-11-02",0,0,621,0,1,622,0,0
"China","2024-11-03",0,0,621,0,1,623,0,0
"China","2024-11-04",0,0,621,0,0,623,0,0
"China","2024-11-05",0,0,621,0,0,623,0,0
"China","2024-11-06",0,3,624,0,1,624,0,0
"China","2024-11-07",0,0,624,0,0,624,0,0
"China","2024-11-08",0,0,624,0,1,625,0,0
"China","2024-11-09",0,0,624,0,0,625,0,0
"China","2024-11-10",0,0,624,0,0,625,0,0
"China","2024-11-11",0,0,624,0,1,626,0,0
"China","2024-11-12",0,0,624,0,0,626,0,0
"China","2024-11-13",0,0,624,0,0,626,0,0
"China","2024-11-14",0,0,624,0,1,627,0,0
"China","2024-11-15",0,3,627,0,0,627,0,0
"China","2024-11-16",0,0,627,0,0,627,0,0
"China","2024-11-17",0,0,627,0,0,627,0,0
"China","2024-11-18",0,0,627,0,1,628,0,0
"China","2024-11-19",0,1,628,0,0,628,0,0
"China","2024-11-20",0,0,628,0,1,629,0,0
"China","2024-11-21",0,0,628,0,2,631,0,0
"China","2024-11-22",0,0,628,0,1,632,0,0
"China","2024-11-23",0,0,628,0,2,634,0,0
"China","2024-11-24",0,0,628,0,1,635,0,0
"China","2024-11-25",0,0,628,0,2,637,0,0
"China","2024-11-26",0,0,628,0,1,638,0,0
"China","2024-11-27",0,0,628,0,2,640,0,0
"China","2024-11-28",0,0,628,0,1,641,0,0
"China","2024-11-29",0,0,628,0,2,643,0,0
"China","2024-11-30",0,16,644,0,1,644,0,0
"China","2024-12-01",0,0,644,0,1,645,0,0
"China","2024-12-02",0,0,644,0,0,645,0,0
"China","2024-12-03",0,2,646,0,1,646,0,0
"China","2024-12-04",0,0,646,0,0,646,0,0
"China","2024-12-05",0,0,646,0,0,646,0,0
"China","2024-12-06",0,0,646,0,0,646,0,0
"China","2024-12-07",0,0,646,0,1,647,0,0
"China","2024-12-08",0,0,646,0,0,647,0,0
"China","2024-12-09",0,0,646,0,0,647,0,0
"China","2024-12-10",0,1,647,0,0,647,0,0
"China","2024-12-11",0,0,647,0,0,647,0,0
"China","2024-12-12",0,0,647,0,1,648,0,0
"China","2024-12-13",0,0,647,0,0,648,0,0
"China","2024-12-14",0,0,647,0,0,648,0,0
"China","2024-12-15",0,0,647,0,0,648,0,0
"China","2024-12-16",0,0,647,0,1,649,0,0
"China","2024-12-17",0,2,649,0,0,649,0,0
"China","2024-12-18",0,0,649,0,0,649,0,0
"China","2024-12-19",0,0,649,0,0,649,0,0
"China","2024-12-20",0,0,649,0,0,649,0,0
"China","2024-12-21",0,0,649,0,1,650,0,0
"China","2024-12-22",0,0,649,0,0,650,0,0
"China","2024-12-23",0,0,649,0,0,650,0,0
"China","2024-12-24",0,1,650,0,0,650,0,0
"China","2024-12-25",0,0,650,0,0,650,0,0
"China","2024-12-26",0,0,650,0,0,650,0,0
"China","2024-12-27",0,0,650,0,0,650,0,0
"China","2024-12-28",0,0,650,0,1,651,0,0
"China","2024-12-29",0,0,650,0,0,651,0,0
"China","2024-12-30",0,0,650,0,0,651,0,0
"China","2024-12-31",0,1,651,0,0,651,0,0
"China","2025-01-01",0,0,651,0,4,655,0,0
"China","2025-01-02",0,0,651,0,4,659,0,0
"China","2025-01-03",0,0,651,0,4,663,0,0
"China","2025-01-04",0,0,651,0,4,667,0,0
"China","2025-01-05",0,0,651,0,5,672,0,0
"China","2025-01-06",0,0,651,0,4,676,0,0
"China","2025-01-07",0,0,651,0,4,680,0,0
"China","2025-01-08",0,33,684,0,4,684,0,0
"China","2025-01-09",0,0,684,0,0,684,0,0
"China","2025-01-10",0,0,684,0,0,684,0,0
"China","2025-01-11",0,0,684,0,0,684,0,0
"China","2025-01-12",0,0,684,0,1,685,0,0
"China","2025-01-13",0,0,684,0,0,685,0,0
"China","2025-01-14",0,0,684,0,0,685,0,0
"China","2025-01-15",0,0,684,0,0,685,0,0
"China","2025-01-16",0,0,684,0,0,685,0,0
"China","2025-01-17",0,0,684,0,0,685,0,0
"China","2025-01-18",0,0,684,0,1,686,0,0
"China","2025-01-19",0,0,684,0,0,686,0,0
"China","2025-01-20",0,0,684,0,0,686,0,0
"China","2025-01-21",0,2,686,0,0,686,0,0
"China","2025-01-22",0,0,686,0,0,686,0,0
"China","2025-01-23",0,0,686,0,0,686,0,0
"China","2025-01-24",0,0,686,0,0,686,0,0
"China","2025-01-25",0,0,686,0,0,686,0,0
"China","2025-01-26",0,0,686,0,0,686,0,0
"China","2025-01-27",0,0,686,0,0,686,0,0
"China","2025-01-28",0,0,686,0,0,686,0,0
"China","2025-01-29",0,0,686,0,0,686,0,0
"China","2025-01-30",0,0,686,0,0,686,0,0
"China","2025-01-31",0,0,686,0,0,686,0,0
"China","2025-02-01",0,0,686,0,0,686,0,0
"China","2025-02-02",0,0,686,0,0,686,0,0
"China","2025-02-03",0,0,686,0,0,686,0,0
"Colombia","2024-01-01",0,0,0,0,0,0,0,0
"Colombia","2024-01-02",0,10,10,0,10,10,0,0
"Colombia","2024-01-03",0,0,10,0,1,11,0,0
"Colombia","2024-01-04",0,0,10,0,1,12,0,0
"Colombia","2024-01-05",0,0,10,0,1,13,0,0
"Colombia","2024-01-06",0,0,10,0,2,15,0,0
"Colombia","2024-01-07",0,0,10,0,1,16,0,0
"Colombia","2024-01-08",0,0,10,0,1,17,0,0
"Colombia","2024-01-09",0,8,18,0,1,18,0,0
"Colombia","2024-01-10",0,0,18,0,1,19,0,0
"Colombia","2024-01-11",0,0,18,0,1,20,0,0
"Colombia","2024-01-12",0,0,18,0,1,21,0,0
"Colombia","2024-01-13",0,0,18,0,2,23,0,0
"Colombia","2024-01-14",0,0,18,0,1,24,0,0
"Colombia","2024-01-15",0,0,18,0,1,25,0,0
"Colombia","2024-01-16",0,8,26,0,1,26,0,0
"Colombia","2024-01-17",0,0,26,0,1,27,0,0
"Colombia","2024-01-18",0,0,26,0,1,28,0,0
"Colombia","2024-01-19",0,0,26,0,1,29,0,0
"Colombia","2024-01-20",0,0,26,0,0,29,0,0
"Colombia","2024-01-21",0,0,26,0,1,30,0,0
"Colombia","2024-01-22",0,0,26,0,1,31,0,0
"Colombia","2024-01-23",0,6,32,0,1,32,0,0
"Colombia","2024-01-24",0,0,32,0,1,33,0,0
"Colombia","2024-01-25",0,0,32,0,1,34,0,0
"Colombia","2024-01-26",0,0,32,0,1,35,0,0
"Colombia","2024-01-27",0,0,32,0,2,37,0,0
"Colombia","2024-01-28",0,0,32,0,1,38,0,0
"Colombia","2024-01-29",0,0,32,0,1,39,0,0
"Colombia","2024-01-30",0,8,40,0,1,40,0,0
"Colombia","2024-01-31",0,0,40,0,0,40,0,0
"Colombia","2024-02-01",0,0,40,0,0,40,0,0
"Colombia","2024-02-02",0,0,40,0,0,40,0,0
"Colombia","2024-02-03",0,0,40,0,1,41,0,0
"Colombia","2024-02-04",0,0,40,0,0,41,0,0
"Colombia","2024-02-05",0,0,40,0,0,41,0,0
"Colombia","2024-02-06",0,1,41,0,0,41,0,0
"Colombia","2024-02-07",0,0,41,0,0,41,0,0
"Colombia","2024-02-08",0,0,41,0,0,41,0,0
"Colombia","2024-02-09",0,0,41,0,0,41,0,0
"Colombia","2024-02-10",0,0,41,0,1,42,0,0
"Colombia","2024-02-11",0,0,41,0,0,42,0,0
"Colombia","2024-02-12",0,0,41,0,0,42,0,0
"Colombia","2024-02-13",0,1,42,0,0,42,0,0
"Colombia","2024-02-14",0,0,42,0,1,43,0,0
"Colombia","2024-02-15",0,0,42,0,0,43,0,0
"Colombia","2024-02-16",0,0,42,0,1,44,0,0
"Colombia","2024-02-17",0,0,42,0,0,44,0,0
"Colombia","2024-02-18",0,0,42,0,1,45,0,0
"Colombia","2024-02-19",0,0,42,0,0,45,0,0
"Colombia","2024-02-20",0,4,46,0,1,46,0,0
"Colombia","2024-02-21",0,0,46,0,1,47,0,0
"Colombia","2024-02-22",0,0,46,0,2,49,0,0
"Colombia","2024-02-23",0,0,46,0,1,50,0,0
"Colombia","2024-02-24",0,0,46,0,1,51,0,0
"Colombia","2024-02-25",0,0,46,0,1,52,0,0
"Colombia","2024-02-26",0,0,46,0,2,54,0,0
"Colombia","2024-02-27",0,9,55,0,1,55,0,0
"Colombia","2024-02-28",0,0,55,0,0,55,0,0
"Colombia","2024-02-29",0,0,55,0,1,56,0,0
"Colombia","2024-03-01",0,0,55,0,0,56,0,0
"Colombia","2024-03-02",0,0,55,0,1,57,0,0
"Colombia","2024-03-03",0,0,55,0,0,57,0,0
"Colombia","2024-03-04",0,0,55,0,1,58,0,0
"Colombia","2024-03-05",0,3,58,0,0,58,0,0
"Colombia","2024-03-06",0,0,58,0,1,59,0,0
"Colombia","2024-03-07",0,0,58,0,0,59,0,0
"Colombia","2024-03-08",0,0,58,0,1,60,0,0
"Colombia","2024-03-09",0,0,58,0,0,60,0,0
"Colombia","2024-03-10",0,0,58,0,1,61,0,0
"Colombia","2024-03-11",0,0,58,0,0,61,0,0
"Colombia","2024-03-12",0,4,62,0,1,62,0,0
"Colombia","2024-03-13",0,0,62,0,1,63,0,0
"Colombia","2024-03-14",0,0,62,0,0,63,0,0
"Colombia","2024-03-15",0,0,62,0,1,64,0,0
"Colombia","2024-03-16",0,0,62,0,0,64,0,0
"Colombia","2024-03-17",0,0,62,0,1,65,0,0
"Colombia","2024-03-18",0,0,62,0,0,65,0,0
"Colombia","2024-03-19",0,4,66,0,1,66,0,0
"Colombia","2024-03-20",0,0,66,0,0,66,0,0
"Colombia","2024-03-21",0,0,66,0,1,67,0,0
"Colombia","2024-03-22",0,0,66,0,0,67,0,0
"Colombia","2024-03-23",0,0,66,0,0,67,0,0
"Colombia","2024-03-24",0,0,66,0,0,67,0,0
"Colombia","2024-03-25",0,0,66,0,1,68,0,0
"Colombia","2024-03-26",0,2,68,0,0,68,0,0
"Colombia","2024-03-27",0,0,68,0,1,69,0,0
"Colombia","2024-03-28",0,0,68,0,0,69,0,0
"Colombia","2024-03-29",0,0,68,0,1,70,0,0
"Colombia","2024-03-30",0,0,68,0,1,71,0,0
"Colombia","2024-03-31",0,0,68,0,1,72,0,0
"Colombia","2024-04-01",0,0,68,0,0,72,0,0
"Colombia","2024-04-02",0,5,73,0,1,73,0,0
"Colombia","2024-04-03",0,0,73,0,1,74,0,0
"Colombia","2024-04-04",0,0,73,0,0,74,0,0
"Colombia","2024-04-05",0,0,73,0,1,75,0,0
"Colombia","2024-04-06",0,0,73,0,1,76,0,0
"Colombia","2024-04-07",0,0,73,0,1,77,0,0
"Colombia","2024-04-08",0,0,73,0,0,77,0,0
"Colombia","2024-04-09",0,5,78,0,1,78,0,0
"Colombia","2024-04-10",0,0,78,0,0,78,0,0
"Colombia","2024-04-11",0,0,78,0,1,79,0,0
"Colombia","2024-04-12",0,0,78,0,0,79,0,0
"Colombia","2024-04-13",0,0,78,0,1,80,0,0
"Colombia","2024-04-14",0,0,78,0,0,80,0,0
"Colombia","2024-04-15",0,0,78,0,1,81,0,0
"Colombia","2024-04-16",0,3,81,0,0,81,0,0
"Colombia","2024-04-17",0,0,81,0,1,82,0,0
"Colombia","2024-04-18",0,0,81,0,2,84,0,0
"Colombia","2024-04-19",0,0,81,0,1,85,0,0
"Colombia","2024-04-20",0,0,81,0,1,86,0,0
"Colombia","2024-04-21",0,0,81,0,1,87,0,0
"Colombia","2024-04-22",0,0,81,0,2,89,0,0
"Colombia","2024-04-23",0,9,90,0,1,90,0,0
"Colombia","2024-04-24",0,0,90,0,0,90,0,0
"Colombia","2024-04-25",0,0,90,0,1,91,0,0
"Colombia","2024-04-26",0,0,90,0,0,91,0,0
"Colombia","2024-04-27",0,0,90,0,0,91,0,0
"Colombia","2024-04-28",0,0,90,0,0,91,0,0
"Colombia","2024-04-29",0,0,90,0,1,92,0,0
"Colombia","2024-04-30",0,2,92,0,0,92,0,0
"Colombia","2024-05-01",0,0,92,0,0,92,0,0
"Colombia","2024-05-02",0,0,92,0,0,92,0,0
"Colombia","2024-05-03",0,0,92,0,0,92,0,0
"Colombia","2024-05-04",0,0,92,0,1,93,0,0
"Colombia","2024-05-05",0,0,92,0,0,93,0,0
"Colombia","2024-05-06",0,0,92,0,0,93,0,0
"Colombia","2024-05-07",0,0,92,0,0,93,0,0
"Colombia","2024-05-08",0,0,92,0,0,93,0,0
"Colombia","2024-05-09",0,0,92,0,0,93,0,0
"Colombia","2024-05-10",0,0,92,0,0,93,0,0
"Colombia","2024-05-11",0,0,92,0,1,94,0,0
"Colombia","2024-05-12",0,0,92,0,0,94,0,0
"Colombia","2024-05-13",0,0,92,0,0,94,0,0
"Colombia","2024-05-14",0,2,94,0,0,94,0,0
"Colombia","2024-05-15",0,0,94,0,0,94,0,0
"Colombia","2024-05-16",0,0,94,0,1,95,0,0
"Colombia","2024-05-17",0,0,94,0,0,95,0,0
"Colombia","2024-05-18",0,0,94,0,0,95,0,0
"Colombia","2024-05-19",0,0,94,0,0,95,0,0
"Colombia","2024-05-20",0,0,94,0,1,96,0,0
"Colombia","2024-05-21",0,2,96,0,0,96,0,0
"Colombia","2024-05-22",0,0,96,0,0,96,0,0
"Colombia","2024-05-23",0,0,96,0,0,96,0,0
"Colombia","2024-05-24",0,0,96,0,0,96,0,0
"Colombia","2024-05-25",0,0,96,0,1,97,0,0
"Colombia","2024-05-26",0,0,96,0,0,97,0,0
"Colombia","2024-05-27",0,0,96,0,0,97,0,0
"Colombia","2024-05-28",0,0,96,0,0,97,0,0
"Colombia","2024-05-29",0,0,96,0,0,97,0,0
"Colombia","2024-05-30",0,0,96,0,0,97,0,0
"Colombia","2024-05-31",0,0,96,0,0,97,0,0
"Colombia","2024-06-01",0,0,96,0,1,98,0,0
"Colombia","2024-06-02",0,0,96,0,0,98,0,0
"Colombia","2024-06-03",0,0,96,0,0,98,0,0
"Colombia","2024-06-04",0,2,98,0,0,98,0,0
"Colombia","2024-06-05",0,0,98,0,1,99,0,0
"Colombia","2024-06-06",0,0,98,0,0,99,0,0
"Colombia","2024-06-07",0,0,98,0,1,100,0,0
"Colombia","2024-06-08",0,0,98,0,0,100,0,0
"Colombia","2024-06-09",0,0,98,0,1,101,0,0
"Colombia","2024-06-10",0,0,98,0,0,101,0,0
"Colombia","2024-06-11",0,4,102,0,1,102,0,0
"Colombia","2024-06-12",0,0,102,0,0,102,0,0
"Colombia","2024-06-13",0,0,102,0,1,103,0,0
"Colombia","2024-06-14",0,0,102,0,0,103,0,0
"Colombia","2024-06-15",0,0,102,0,0,103,0,0
"Colombia","2024-06-16",0,0,102,0,0,103,0,0
"Colombia","2024-06-17",0,0,102,0,1,104,0,0
"Colombia","2024-06-18",0,2,104,0,0,104,0,0
"Colombia","2024-06-19",0,0,104,0,0,104,0,0
"Colombia","2024-06-20",0,0,104,0,1,105,0,0
"Colombia","2024-06-21",0,0,104,0,0,105,0,0
"Colombia","2024-06-22",0,0,104,0,0,105,0,0
"Colombia","2024-06-23",0,0,104,0,0,105,0,0
"Colombia","2024-06-24",0,0,104,0,1,106,0,0
"Colombia","2024-06-25",0,0,104,0,0,106,0,0
"Colombia","2024-06-26",0,0,104,0,0,106,0,0
"Colombia","2024-06-27",0,0,104,0,1,107,0,0
"Colombia","2024-06-28",0,0,104,0,0,107,0,0
"Colombia","2024-06-29",0,0,104,0,0,107,0,0
"Colombia","2024-06-30",0,0,104,0,0,107,0,0
"Colombia","2024-07-01",0,0,104,0,1,108,0,0
"Colombia","2024-07-02",0,4,108,0,0,108,0,0
"Colombia","2024-07-03",0,0,108,0,0,108,0,0
"Colombia","2024-07-04",0,0,108,0,1,109,0,0
"Colombia","2024-07-05",0,0,108,0,0,109,0,0
"Colombia","2024-07-06",0,0,108,0,0,109,0,0
"Colombia","2024-07-07",0,0,108,0,0,109,0,0
"Colombia","2024-07-08",0,0,108,0,1,110,0,0
"Colombia","2024-07-09",0,2,110,0,0,110,0,0
"Colombia","2024-07-10",0,0,110,0,0,110,0,0
"Colombia","2024-07-11",0,0,110,0,1,111,0,0
"Colombia","2024-07-12",0,0,110,0,0,111,0,0
"Colombia","2024-07-13",0,0,110,0,1,112,0,0
"Colombia","2024-07-14",0,0,110,0,0,112,0,0
"Colombia","2024-07-15",0,0,110,0,1,113,0,0
"Colombia","2024-07-16",0,3,113,0,0,113,0,0
"Colombia","2024-07-17",0,0,113,0,0,113,0,0
"Colombia","2024-07-18",0,0,113,0,0,113,0,0
"Colombia","2024-07-19",0,0,113,0,0,113,0,0
"Colombia","2024-07-20",0,0,113,0,0,113,0,0
"Colombia","2024-07-21",0,0,113,0,0,113,0,0
"Colombia","2024-07-22",0,0,113,0,0,113,0,0
"Colombia","2024-07-23",0,0,113,0,0,113,0,0
"Colombia","2024-07-24",0,0,113,0,1,114,0,0
"Colombia","2024-07-25",0,0,113,0,0,114,0,0
"Colombia","2024-07-26",0,0,113,0,0,114,0,0
"Colombia","2024-07-27",0,0,113,0,0,114,0,0
"Colombia","2024-07-28",0,0,113,0,0,114,0,0
"Colombia","2024-07-29",0,0,113,0,0,114,0,0
"Colombia","2024-07-30",0,1,114,0,0,114,0,0
"Colombia","2024-07-31",0,0,114,0,0,114,0,0
"Colombia","2024-08-01",0,0,114,0,1,115,0,0
"Colombia","2024-08-02",0,0,114,0,0,115,0,0
"Colombia","2024-08-03",0,0,114,0,0,115,0,0
"Colombia","2024-08-04",0,0,114,0,0,115,0,0
"Colombia","2024-08-05",0,0,114,0,1,116,0,0
"Colombia","2024-08-06",0,2,116,0,0,116,0,0
"Colombia","2024-08-07",0,0,116,0,0,116,0,0
"Colombia","2024-08-08",0,0,116,0,0,116,0,0
"Colombia","2024-08-09",0,0,116,0,0,116,0,0
"Colombia","2024-08-10",0,0,116,0,1,117,0,0
"Colombia","2024-08-11",0,0,116,0,0,117,0,0
"Colombia","2024-08-12",0,0,116,0,0,117,0,0
"Colombia","2024-08-13",0,0,116,0,0,117,0,0
"Colombia","2024-08-14",0,0,116,0,0,117,0,0
"Colombia","2024-08-15",0,0,116,0,0,117,0,0
"Colombia","2024-08-16",0,0,116,0,0,117,0,0
"Colombia","2024-08-17",0,0,116,0,1,118,0,0
"Colombia","2024-08-18",0,0,116,0,0,118,0,0
"Colombia","2024-08-19",0,0,116,0,0,118,0,0
"Colombia","2024-08-20",0,2,118,0,0,118,0,0
"Colombia","2024-08-21",0,0,118,0,0,118,0,0
"Colombia","2024-08-22",0,0,118,0,1,119,0,0
"Colombia","2024-08-23",0,0,118,0,0,119,0,0
"Colombia","2024-08-24",0,0,118,0,1,120,0,0
"Colombia","2024-08-25",0,0,118,0,0,120,0,0
"Colombia","2024-08-26",0,0,118,0,1,121,0,0
"Colombia","2024-08-27",0,3,121,0,0,121,0,0
"Colombia","2024-08-28",0,0,121,0,0,121,0,0
"Colombia","2024-08-29",0,0,121,0,0,121,0,0
"Colombia","2024-08-30",0,0,121,0,0,121,0,0
"Colombia","2024-08-31",0,0,121,0,0,121,0,0
"Colombia","2024-09-01",0,0,121,0,0,121,0,0
"Colombia","2024-09-02",0,0,121,0,1,122,0,0
"Colombia","2024-09-03",0,0,121,0,0,122,0,0
"Colombia","2024-09-04",0,0,121,0,0,122,0,0
"Colombia","2024-09-05",0,0,121,0,0,122,0,0
"Colombia","2024-09-06",0,0,121,0,0,122,0,0
"Colombia","2024-09-07",0,0,121,0,0,122,0,0
"Colombia","2024-09-08",0,0,121,0,0,122,0,0
"Colombia","2024-09-09",0,0,121,0,0,122,0,0
"Colombia","2024-09-10",0,0,121,0,0,122,0,0
"Colombia","2024-09-11",0,0,121,0,0,122,0,0
"Colombia","2024-09-12",0,0,121,0,1,123,0,0
"Colombia","2024-09-13",0,0,121,0,0,123,0,0
"Colombia","2024-09-14",0,0,121,0,0,123,0,0
"Colombia","2024-09-15",0,0,121,0,0,123,0,0
"Colombia","2024-09-16",0,0,121,0,0,123,0,0
"Colombia","2024-09-17",0,2,123,0,0,123,0,0
"Colombia","2024-09-18",0,0,123,0,0,123,0,0
"Colombia","2024-09-19",0,0,123,0,0,123,0,0
"Colombia","2024-09-20",0,0,123,0,0,123,0,0
"Colombia","2024-09-21",0,0,123,0,1,124,0,0
"Colombia","2024-09-22",0,0,123,0,0,124,0,0
"Colombia","2024-09-23",0,0,123,0,0,124,0,0
"Colombia","2024-09-24",0,1,124,0,0,124,0,0
"Colombia","2024-09-25",0,0,124,0,0,124,0,0
"Colombia","2024-09-26",0,0,124,0,0,124,0,0
"Colombia","2024-09-27",0,0,124,0,1,125,0,0
"Colombia","2024-09-28",0,0,124,0,0,125,0,0
"Colombia","2024-09-29",0,0,124,0,0,125,0,0
"Colombia","2024-09-30",0,0,124,0,0,125,0,0
"Colombia","2024-10-01",0,0,124,0,1,126,0,0
"Colombia","2024-10-02",0,0,124,0,0,126,0,0
"Colombia","2024-10-03",0,0,124,0,0,126,0,0
"Colombia","2024-10-04",0,0,124,0,0,126,0,0
"Colombia","2024-10-05",0,0,124,0,0,126,0,0
"Colombia","2024-10-06",0,0,124,0,1,127,0,0
"Colombia","2024-10-07",0,0,124,0,0,127,0,0
"Colombia","2024-10-08",0,3,127,0,0,127,0,0
"Colombia","2024-10-09",0,0,127,0,1,128,0,0
"Colombia","2024-10-10",0,0,127,0,0,128,0,0
"Colombia","2024-10-11",0,0,127,0,1,129,0,0
"Colombia","2024-10-12",0,0,127,0,0,129,0,0
"Colombia","2024-10-13",0,0,127,0,1,130,0,0
"Colombia","2024-10-14",0,0,127,0,0,130,0,0
"Colombia","2024-10-15",0,4,131,0,1,131,0,0
"Colombia","2024-10-16",0,0,131,0,0,131,0,0
"Colombia","2024-10-17",0,0,131,0,0,131,0,0
"Colombia","2024-10-18",0,0,131,0,0,131,0,0
"Colombia","2024-10-19",0,0,131,0,1,132,0,0
"Colombia","2024-10-20",0,0,131,0,0,132,0,0
"Colombia","2024-10-21",0,0,131,0,0,132,0,0
"Colombia","2024-10-22",0,1,132,0,0,132,0,0
"Colombia","2024-10-23",0,0,132,0,0,132,0,0
"Colombia","2024-10-24",0,0,132,0,0,132,0,0
"Colombia","2024-10-25",0,0,132,0,1,133,0,0
"Colombia","2024-10-26",0,0,132,0,0,133,0,0
"Colombia","2024-10-27",0,0,132,0,0,133,0,0
"Colombia","2024-10-28",0,0,132,0,0,133,0,0
"Colombia","2024-10-29",0,0,132,0,1,134,0,0
"Colombia","2024-10-30",0,0,132,0,0,134,0,0
"Colombia","2024-10-31",0,0,132,0,0,134,0,0
"Colombia","2024-11-01",0,0,132,0,0,134,0,0
"Colombia","2024-11-02",0,0,132,0,0,134,0,0
"Colombia","2024-11-03",0,0,132,0,1,135,0,0
"Colombia","2024-11-04",0,0,132,0,0,135,0,0
"Colombia","2024-11-05",0,3,135,0,0,135,0,0
"Colombia","2024-11-06",0,0,135,0,0,135,0,0
"Colombia","2024-11-07",0,0,135,0,0,135,0,0
"Colombia","2024-11-08",0,0,135,0,0,135,0,0
"Colombia","2024-11-09",0,0,135,0,0,135,0,0
"Colombia","2024-11-10",0,0,135,0,0,135,0,0
"Colombia","2024-11-11",0,0,135,0,0,135,0,0
"Colombia","2024-11-12",0,0,135,0,0,135,0,0
"Colombia","2024-11-13",0,0,135,0,1,136,0,0
"Colombia","2024-11-14",0,0,135,0,0,136,0,0
"Colombia","2024-11-15",0,0,135,0,0,136,0,0
"Colombia","2024-11-16",0,0,135,0,0,136,0,0
"Colombia","2024-11-17",0,0,135,0,0,136,0,0
"Colombia","2024-11-18",0,0,135,0,0,136,0,0
"Colombia","2024-11-19",0,1,136,0,0,136,0,0
"Colombia","2024-11-20",0,0,136,0,0,136,0,0
"Colombia","2024-11-21",0,0,136,0,0,136,0,0
"Colombia","2024-11-22",0,0,136,0,0,136,0,0
"Colombia","2024-11-23",0,0,136,0,1,137,0,0
"Colombia","2024-11-24",0,0,136,0,0,137,0,0
"Colombia","2024-11-25",0,0,136,0,0,137,0,0
"Colombia","2024-11-26",0,1,137,0,0,137,0,0
"Colombia","2024-11-27",0,0,137,0,0,137,0,0
"Colombia","2024-11-28",0,0,137,0,0,137,0,0
"Colombia","2024-11-29",0,0,137,0,0,137,0,0
"Colombia","2024-11-30",0,0,137,0,0,137,0,0
"Colombia","2024-12-01",0,0,137,0,0,137,0,0
"Colombia","2024-12-02",0,0,137,0,0,137,0,0
"Colombia","2024-12-03",0,0,137,0,0,137,0,0
"Colombia","2024-12-04",0,0,137,0,0,137,0,0
"Colombia","2024-12-05",0,0,137,0,0,137,0,0
"Colombia","2024-12-06",0,0,137,0,0,137,0,0
"Colombia","2024-12-07",0,0,137,0,0,137,0,0
"Colombia","2024-12-08",0,0,137,0,0,137,0,0
"Colombia","2024-12-09",0,0,137,0,0,137,0,0
"Colombia","2024-12-10",0,0,137,0,0,137,0,0
"Colombia","2024-12-11",0,0,137,0,0,137,0,0
"Colombia","2024-12-12",0,0,137,0,0,137,0,0
"Colombia","2024-12-13",0,0,137,0,0,137,0,0
"Colombia","2024-12-14",0,0,137,0,0,137,0,0
"Colombia","2024-12-15",0,0,137,0,0,137,0,0
"Colombia","2024-12-16",0,0,137,0,0,137,0,0
"Colombia","2024-12-17",0,0,137,0,0,137,0,0
"Colombia","2024-12-18",0,0,137,0,0,137,0,0
"Colombia","2024-12-19",0,0,137,0,0,137,0,0
"Colombia","2024-12-20",0,0,137,0,0,137,0,0
"Colombia","2024-12-21",0,0,137,0,0,137,0,0
"Colombia","2024-12-22",0,0,137,0,0,137,0,0
"Colombia","2024-12-23",0,0,137,0,0,137,0,0
"Colombia","2024-12-24",0,0,137,0,0,137,0,0
"Colombia","2024-12-25",0,0,137,0,0,137,0,0
"Colombia","2024-12-26",0,0,137,0,0,137,0,0
"Colombia","2024-12-27",0,0,137,0,0,137,0,0
"Colombia","2024-12-28",0,0,137,0,0,137,0,0
"Colombia","2024-12-29",0,0,137,0,0,137,0,0
"Colombia","2024-12-30",0,0,137,0,0,137,0,0
"Colombia","2024-12-31",0,0,137,0,0,137,0,0
"Colombia","2025-01-01",0,0,137,0,0,137,0,0
"Colombia","2025-01-02",0,0,137,0,0,137,0,0
"Colombia","2025-01-03",0,0,137,0,0,137,0,0
"Colombia","2025-01-04",0,0,137,0,0,137,0,0
"Colombia","2025-01-05",0,0,137,0,0,137,0,0
"Colombia","2025-01-06",0,0,137,0,0,137,0,0
"Colombia","2025-01-07",0,0,137,0,0,137,0,0
"Colombia","2025-01-08",0,0,137,0,0,137,0,0
"Colombia","2025-01-09",0,0,137,0,0,137,0,0
"Colombia","2025-01-10",0,0,137,0,0,137,0,0
"Colombia","2025-01-11",0,0,137,0,0,137,0,0
"Colombia","2025-01-12",0,0,137,0,0,137,0,0
"Colombia","2025-01-13",0,0,137,0,0,137,0,0
"Colombia","2025-01-14",0,0,137,0,0,137,0,0
"Colombia","2025-01-15",0,0,137,0,0,137,0,0
"Colombia","2025-01-16",0,0,137,0,0,137,0,0
"Colombia","2025-01-17",0,0,137,0,0,137,0,0
"Colombia","2025-01-18",0,0,137,0,0,137,0,0
"Colombia","2025-01-19",0,0,137,0,0,137,0,0
"Colombia","2025-01-20",0,0,137,0,0,137,0,0
"Colombia","2025-01-21",0,0,137,0,0,137,0,0
"Colombia","2025-01-22",0,0,137,0,0,137,0,0
"Colombia","2025-01-23",0,0,137,0,0,137,0,0
"Colombia","2025-01-24",0,0,137,0,0,137,0,0
"Colombia","2025-01-25",0,0,137,0,0,137,0,0
"Colombia","2025-01-26",0,0,137,0,0,137,0,0
"Colombia","2025-01-27",0,0,137,0,0,137,0,0
"Colombia","2025-01-28",0,0,137,0,0,137,0,0
"Colombia","2025-01-29",0,0,137,0,0,137,0,0
"Colombia","2025-01-30",0,0,137,0,0,137,0,0
"Colombia","2025-01-31",0,0,137,0,0,137,0,0
"Colombia","2025-02-01",0,0,137,0,0,137,0,0
"Colombia","2025-02-02",0,0,137,0,0,137,0,0
"Colombia","2025-02-03",0,0,137,0,0,137,0,0
"Congo","2024-01-01",0,0,0,0,0,0,0,0
"Congo","2024-01-02",0,0,0,0,0,0,0,0
"Congo","2024-01-03",0,0,0,0,0,0,0,0
"Congo","2024-01-04",0,0,0,0,0,0,0,0
"Congo","2024-01-05",0,0,0,0,0,0,0,0
"Congo","2024-01-06",0,0,0,0,0,0,0,0
"Congo","2024-01-07",0,0,0,0,0,0,0,0
"Congo","2024-01-08",0,0,0,0,0,0,0,0
"Congo","2024-01-09",0,0,0,0,0,0,0,0
"Congo","2024-01-10",0,0,0,0,0,0,0,0
"Congo","2024-01-11",0,0,0,0,0,0,0,0
"Congo","2024-01-12",0,0,0,0,0,0,0,0
"Congo","2024-01-13",0,0,0,0,0,0,0,0
"Congo","2024-01-14",0,1,1,0,1,1,0,0
"Congo","2024-01-15",0,0,1,0,0,1,0,0
"Congo","2024-01-16",0,0,1,0,0,1,0,0
"Congo","2024-01-17",0,0,1,0,0,1,0,0
"Congo","2024-01-18",0,0,1,0,1,2,0,0
"Congo","2024-01-19",0,0,1,0,0,2,0,0
"Congo","2024-01-20",0,0,1,0,0,2,0,0
"Congo","2024-01-21",0,1,2,0,0,2,0,0
"Congo","2024-01-22",0,0,2,0,0,2,0,0
"Congo","2024-01-23",0,0,2,0,1,3,0,0
"Congo","2024-01-24",0,0,2,0,0,3,0,0
"Congo","2024-01-25",0,0,2,0,0,3,0,0
"Congo","2024-01-26",0,0,2,0,0,3,0,0
"Congo","2024-01-27",0,0,2,0,1,4,0,0
"Congo","2024-01-28",0,2,4,0,0,4,0,0
"Congo","2024-01-29",0,0,4,0,0,4,0,0
"Congo","2024-01-30",0,0,4,0,0,4,0,0
"Congo","2024-01-31",0,0,4,0,1,5,0,0
"Congo","2024-02-01",0,0,4,0,0,5,0,0
"Congo","2024-02-02",0,0,4,0,0,5,0,0
"Congo","2024-02-03",0,0,4,0,0,5,0,0
"Congo","2024-02-04",0,0,4,0,1,6,0,0
"Congo","2024-02-05",0,0,4,0,0,6,0,0
"Congo","2024-02-06",0,0,4,0,0,6,0,0
"Congo","2024-02-07",0,0,4,0,0,6,0,0
"Congo","2024-02-08",0,0,4,0,1,7,0,0
"Congo","2024-02-09",0,0,4,0,0,7,0,0
"Congo","2024-02-10",0,0,4,0,0,7,0,0
"Congo","2024-02-11",0,0,4,0,0,7,0,0
"Congo","2024-02-12",0,0,4,0,1,8,0,0
"Congo","2024-02-13",0,0,4,0,0,8,0,0
"Congo","2024-02-14",0,0,4,0,0,8,0,0
"Congo","2024-02-15",0,0,4,0,0,8,0,0
"Congo","2024-02-16",0,0,4,0,1,9,0,0
"Congo","2024-02-17",0,0,4,0,0,9,0,0
"Congo","2024-02-18",0,5,9,0,0,9,0,0
"Congo","2024-02-19",0,0,9,0,0,9,0,0
"Congo","2024-02-20",0,0,9,0,1,10,0,0
"Congo","2024-02-21",0,0,9,0,0,10,0,0
"Congo","2024-02-22",0,0,9,0,0,10,0,0
"Congo","2024-02-23",0,0,9,0,0,10,0,0
"Congo","2024-02-24",0,0,9,0,1,11,0,0
"Congo","2024-02-25",0,2,11,0,0,11,0,0
"Congo","2024-02-26",0,0,11,0,1,12,0,0
"Congo","2024-02-27",0,0,11,0,0,12,0,0
"Congo","2024-02-28",0,0,11,0,1,13,0,0
"Congo","2024-02-29",0,0,11,0,0,13,0,0
"Congo","2024-03-01",0,0,11,0,1,14,0,0
"Congo","2024-03-02",0,0,11,0,0,14,0,0
"Congo","2024-03-03",0,0,11,0,1,15,0,0
"Congo","2024-03-04",0,0,11,0,1,16,0,0
"Congo","2024-03-05",0,0,11,0,0,16,0,0
"Congo","2024-03-06",0,0,11,0,1,17,0,0
"Congo","2024-03-07",0,0,11,0,0,17,0,0
"Congo","2024-03-08",0,0,11,0,1,18,0,0
"Congo","2024-03-09",0,0,11,0,0,18,0,0
"Congo","2024-03-10",0,8,19,0,1,19,0,0
"Congo","2024-03-11",0,0,19,0,0,19,0,0
"Congo","2024-03-12",0,0,19,0,0,19,0,0
"Congo","2024-03-13",0,0,19,0,0,19,0,0
"Congo","2024-03-14",0,0,19,0,0,19,0,0
"Congo","2024-03-15",0,0,19,0,0,19,0,0
"Congo","2024-03-16",0,0,19,0,0,19,0,0
"Congo","2024-03-17",24,0,19,24,0,19,24,24
"Congo","2024-03-18",0,0,19,24,0,19,1,25
"Congo","2024-03-19",0,0,19,24,0,19,1,26
"Congo","2024-03-20",0,0,19,24,0,19,1,27
"Congo","2024-03-21",0,0,19,24,0,19,0,27
"Congo","2024-03-22",0,0,19,24,0,19,1,28
"Congo","2024-03-23",0,0,19,24,0,19,1,29
"Congo","2024-03-24",0,0,19,24,0,19,1,30
"Congo","2024-03-25",0,0,19,24,0,19,1,31
"Congo","2024-03-26",0,0,19,24,0,19,1,32
"Congo","2024-03-27",0,0,19,24,0,19,0,32
"Congo","2024-03-28",0,0,19,24,0,19,1,33
"Congo","2024-03-29",0,0,19,24,0,19,1,34
"Congo","2024-03-30",0,0,19,24,0,19,1,35
"Congo","2024-03-31",0,0,19,24,0,19,1,36
"Congo","2024-04-01",0,0,19,24,0,19,1,37
"Congo","2024-04-02",0,0,19,24,0,19,1,38
"Congo","2024-04-03",0,0,19,24,0,19,0,38
"Congo","2024-04-04",0,0,19,24,0,19,1,39
"Congo","2024-04-05",0,0,19,24,0,19,1,40
"Congo","2024-04-06",17,0,19,41,0,19,1,41
"Congo","2024-04-07",0,0,19,41,0,19,0,41
"Congo","2024-04-08",0,0,19,41,0,19,1,42
"Congo","2024-04-09",0,0,19,41,0,19,1,43
"Congo","2024-04-10",0,0,19,41,0,19,0,43
"Congo","2024-04-11",0,0,19,41,0,19,0,43
"Congo","2024-04-12",0,0,19,41,0,19,1,44
"Congo","2024-04-13",0,0,19,41,0,19,1,45
"Congo","2024-04-14",0,0,19,41,0,19,0,45
"Congo","2024-04-15",0,0,19,41,0,19,0,45
"Congo","2024-04-16",0,0,19,41,0,19,1,46
"Congo","2024-04-17",0,0,19,41,0,19,1,47
"Congo","2024-04-18",0,0,19,41,1,20,0,47
"Congo","2024-04-19",0,0,19,41,0,20,0,47
"Congo","2024-04-20",0,0,19,41,0,20,1,48
"Congo","2024-04-21",0,0,19,41,0,20,1,49
"Congo","2024-04-22",0,0,19,41,0,20,0,49
"Congo","2024-04-23",0,0,19,41,0,20,0,49
"Congo","2024-04-24",0,0,19,41,0,20,1,50
"Congo","2024-04-25",0,0,19,41,0,20,1,51
"Congo","2024-04-26",0,0,19,41,0,20,0,51
"Congo","2024-04-27",0,0,19,41,0,20,0,51
"Congo","2024-04-28",0,0,19,41,0,20,1,52
"Congo","2024-04-29",0,0,19,41,0,20,1,53
"Congo","2024-04-30",0,0,19,41,0,20,0,53
"Congo","2024-05-01",0,0,19,41,0,20,0,53
"Congo","2024-05-02",0,0,19,41,0,20,1,54
"Congo","2024-05-03",0,0,19,41,0,20,1,55
"Congo","2024-05-04",0,0,19,41,0,20,0,55
"Congo","2024-05-05",0,0,19,41,0,20,0,55
"Congo","2024-05-06",0,0,19,41,0,20,1,56
"Congo","2024-05-07",0,0,19,41,0,20,1,57
"Congo","2024-05-08",0,0,19,41,0,20,0,57
"Congo","2024-05-09",0,0,19,41,0,20,0,57
"Congo","2024-05-10",0,0,19,41,0,20,1,58
"Congo","2024-05-11",0,0,19,41,0,20,1,59
"Congo","2024-05-12",18,0,19,59,0,20,0,59
"Congo","2024-05-13",0,0,19,59,0,20,2,61
"Congo","2024-05-14",0,0,19,59,0,20,1,62
"Congo","2024-05-15",0,0,19,59,0,20,1,63
"Congo","2024-05-16",0,0,19,59,0,20,2,65
"Congo","2024-05-17",0,0,19,59,0,20,2,67
"Congo","2024-05-18",9,0,19,68,0,20,1,68
"Congo","2024-05-19",0,0,19,68,0,20,2,70
"Congo","2024-05-20",0,0,19,68,0,20,1,71
"Congo","2024-05-21",0,0,19,68,0,20,2,73
"Congo","2024-05-22",0,0,19,68,0,20,1,74
"Congo","2024-05-23",0,0,19,68,0,20,2,76
"Congo","2024-05-24",0,0,19,68,0,20,1,77
"Congo","2024-05-25",0,0,19,68,0,20,2,79
"Congo","2024-05-26",0,0,19,68,0,20,2,81
"Congo","2024-05-27",0,0,19,68,0,20,1,82
"Congo","2024-05-28",0,0,19,68,0,20,2,84
"Congo","2024-05-29",0,0,19,68,0,20,1,85
"Congo","2024-05-30",0,0,19,68,0,20,2,87
"Congo","2024-05-31",0,0,19,68,0,20,1,88
"Congo","2024-06-01",22,0,19,90,0,20,2,90
"Congo","2024-06-02",0,0,19,90,0,20,1,91
"Congo","2024-06-03",0,0,19,90,0,20,1,92
"Congo","2024-06-04",0,0,19,90,0,20,1,93
"Congo","2024-06-05",0,0,19,90,0,20,2,95
"Congo","2024-06-06",0,0,19,90,0,20,1,96
"Congo","2024-06-07",0,0,19,90,0,20,1,97
"Congo","2024-06-08",0,0,19,90,0,20,1,98
"Congo","2024-06-09",0,0,19,90,0,20,1,99
"Congo","2024-06-10",0,0,19,90,0,20,1,100
"Congo","2024-06-11",0,0,19,90,0,20,1,101
"Congo","2024-06-12",0,0,19,90,0,20,2,103
"Congo","2024-06-13",0,0,19,90,0,20,1,104
"Congo","2024-06-14",0,0,19,90,0,20,1,105
"Congo","2024-06-15",0,0,19,90,0,20,1,106
"Congo","2024-06-16",0,0,19,90,0,20,1,107
"Congo","2024-06-17",0,0,19,90,0,20,1,108
"Congo","2024-06-18",0,0,19,90,0,20,1,109
"Congo","2024-06-19",0,0,19,90,0,20,2,111
"Congo","2024-06-20",0,0,19,90,0,20,1,112
"Congo","2024-06-21",0,0,19,90,0,20,1,113
"Congo","2024-06-22",24,0,19,114,0,20,1,114
"Congo","2024-06-23",0,0,19,114,0,20,2,116
"Congo","2024-06-24",0,0,19,114,0,20,1,117
"Congo","2024-06-25",0,0,19,114,0,20,2,119
"Congo","2024-06-26",0,0,19,114,0,20,1,120
"Congo","2024-06-27",0,0,19,114,0,20,2,122
"Congo","2024-06-28",0,0,19,114,0,20,2,124
"Congo","2024-06-29",0,0,19,114,0,20,1,125
"Congo","2024-06-30",13,0,19,127,0,20,2,127
"Congo","2024-07-01",0,0,19,127,0,20,0,127
"Congo","2024-07-02",0,0,19,127,0,20,1,128
"Congo","2024-07-03",0,0,19,127,0,20,0,128
"Congo","2024-07-04",0,0,19,127,1,21,0,128
"Congo","2024-07-05",0,0,19,127,0,21,1,129
"Congo","2024-07-06",0,0,19,127,0,21,0,129
"Congo","2024-07-07",0,0,19,127,0,21,0,129
"Congo","2024-07-08",0,0,19,127,0,21,1,130
"Congo","2024-07-09",0,0,19,127,0,21,0,130
"Congo","2024-07-10",0,0,19,127,0,21,1,131
"Congo","2024-07-11",0,0,19,127,0,21,0,131
"Congo","2024-07-12",0,0,19,127,0,21,0,131
"Congo","2024-07-13",0,0,19,127,0,21,1,132
"Congo","2024-07-14",0,0,19,127,0,21,0,132
"Congo","2024-07-15",0,0,19,127,0,21,0,132
"Congo","2024-07-16",0,0,19,127,0,21,1,133
"Congo","2024-07-17",0,0,19,127,0,21,0,133
"Congo","2024-07-18",0,0,19,127,0,21,0,133
"Congo","2024-07-19",0,0,19,127,0,21,1,134
"Congo","2024-07-20",0,0,19,127,0,21,0,134
"Congo","2024-07-21",0,0,19,127,0,21,0,134
"Congo","2024-07-22",0,0,19,127,0,21,1,135
"Congo","2024-07-23",0,0,19,127,0,21,0,135
"Congo","2024-07-24",0,0,19,127,0,21,0,135
"Congo","2024-07-25",0,0,19,127,0,21,1,136
"Congo","2024-07-26",0,0,19,127,0,21,0,136
"Congo","2024-07-27",0,0,19,127,0,21,0,136
"Congo","2024-07-28",0,0,19,127,0,21,1,137
"Congo","2024-07-29",0,0,19,127,0,21,0,137
"Congo","2024-07-30",0,0,19,127,0,21,0,137
"Congo","2024-07-31",0,0,19,127,0,21,1,138
"Congo","2024-08-01",0,0,19,127,0,21,0,138
"Congo","2024-08-02",0,0,19,127,0,21,1,139
"Congo","2024-08-03",0,0,19,127,0,21,0,139
"Congo","2024-08-04",0,0,19,127,0,21,0,139
"Congo","2024-08-05",0,0,19,127,0,21,1,140
"Congo","2024-08-06",0,0,19,127,0,21,0,140
"Congo","2024-08-07",0,0,19,127,0,21,0,140
"Congo","2024-08-08",0,0,19,127,0,21,1,141
"Congo","2024-08-09",14,0,19,141,0,21,0,141
"Congo","2024-08-10",0,0,19,141,0,21,1,142
"Congo","2024-08-11",0,2,21,141,0,21,0,142
"Congo","2024-08-12",0,0,21,141,0,21,1,143
"Congo","2024-08-13",0,0,21,141,0,21,0,143
"Congo","2024-08-14",0,0,21,141,0,21,1,144
"Congo","2024-08-15",0,0,21,141,0,21,0,144
"Congo","2024-08-16",0,0,21,141,0,21,1,145
"Congo","2024-08-17",0,0,21,141,0,21,1,146
"Congo","2024-08-18",0,0,21,141,0,21,0,146
"Congo","2024-08-19",0,0,21,141,0,21,1,147
"Congo","2024-08-20",0,0,21,141,0,21,0,147
"Congo","2024-08-21",0,0,21,141,0,21,1,148
"Congo","2024-08-22",0,0,21,141,0,21,1,149
"Congo","2024-08-23",0,0,21,141,0,21,0,149
"Congo","2024-08-24",0,0,21,141,0,21,1,150
"Congo","2024-08-25",0,0,21,141,0,21,0,150
"Congo","2024-08-26",0,0,21,141,0,21,1,151
"Congo","2024-08-27",0,0,21,141,0,21,0,151
"Congo","2024-08-28",0,0,21,141,0,21,1,152
"Congo","2024-08-29",0,0,21,141,0,21,1,153
"Congo","2024-08-30",0,0,21,141,0,21,0,153
"Congo","2024-08-31",0,0,21,141,0,21,1,154
"Congo","2024-09-01",0,0,21,141,0,21,0,154
"Congo","2024-09-02",0,0,21,141,0,21,1,155
"Congo","2024-09-03",0,0,21,141,0,21,0,155
"Congo","2024-09-04",0,0,21,141,0,21,1,156
"Congo","2024-09-05",0,0,21,141,1,22,1,157
"Congo","2024-09-06",0,0,21,141,0,22,0,157
"Congo","2024-09-07",0,0,21,141,0,22,1,158
"Congo","2024-09-08",0,0,21,141,0,22,0,158
"Congo","2024-09-09",0,0,21,141,0,22,1,159
"Congo","2024-09-10",0,0,21,141,0,22,1,160
"Congo","2024-09-11",0,0,21,141,0,22,0,160
"Congo","2024-09-12",0,0,21,141,0,22,1,161
"Congo","2024-09-13",0,0,21,141,0,22,0,161
"Congo","2024-09-14",0,0,21,141,0,22,1,162
"Congo","2024-09-15",0,0,21,141,0,22,0,162
"Congo","2024-09-16",22,0,21,163,0,22,1,163
"Congo","2024-09-17",0,0,21,163,0,22,1,164
"Congo","2024-09-18",0,0,21,163,0,22,1,165
"Congo","2024-09-19",0,0,21,163,0,22,1,166
"Congo","2024-09-20",0,0,21,163,0,22,1,167
"Congo","2024-09-21",0,0,21,163,0,22,1,168
"Congo","2024-09-22",0,0,21,163,0,22,1,169
"Congo","2024-09-23",0,0,21,163,0,22,1,170
"Congo","2024-09-24",0,0,21,163,0,22,1,171
"Congo","2024-09-25",0,0,21,163,0,22,1,172
"Congo","2024-09-26",0,0,21,163,0,22,1,173
"Congo","2024-09-27",0,0,21,163,0,22,1,174
"Congo","2024-09-28",0,0,21,163,0,22,1,175
"Congo","2024-09-29",0,1,22,163,0,22,1,176
"Congo","2024-09-30",14,0,22,177,0,22,1,177
"Congo","2024-10-01",0,0,22,177,0,22,2,179
"Congo","2024-10-02",0,0,22,177,0,22,1,180
"Congo","2024-10-03",0,0,22,177,0,22,1,181
"Congo","2024-10-04",0,0,22,177,0,22,2,183
"Congo","2024-10-05",0,0,22,177,0,22,2,185
"Congo","2024-10-06",0,0,22,177,0,22,1,186
"Congo","2024-10-07",0,0,22,177,0,22,1,187
"Congo","2024-10-08",0,0,22,177,0,22,2,189
"Congo","2024-10-09",0,0,22,177,0,22,2,191
"Congo","2024-10-10",0,0,22,177,0,22,1,192
"Congo","2024-10-11",0,0,22,177,0,22,1,193
"Congo","2024-10-12",0,0,22,177,0,22,2,195
"Congo","2024-10-13",0,0,22,177,0,22,2,197
"Congo","2024-10-14",0,0,22,177,0,22,1,198
"Congo","2024-10-15",0,0,22,177,0,22,1,199
"Congo","2024-10-16",0,0,22,177,0,22,2,201
"Congo","2024-10-17",0,0,22,177,0,22,2,203
"Congo","2024-10-18",0,0,22,177,0,22,1,204
"Congo","2024-10-19",0,0,22,177,0,22,1,205
"Congo","2024-10-20",30,0,22,207,0,22,2,207
"Congo","2024-10-21",0,0,22,207,0,22,1,208
"Congo","2024-10-22",0,0,22,207,0,22,1,209
"Congo","2024-10-23",0,0,22,207,0,22,1,210
"Congo","2024-10-24",0,0,22,207,0,22,1,211
"Congo","2024-10-25",0,0,22,207,0,22,1,212
"Congo","2024-10-26",0,0,22,207,0,22,1,213
"Congo","2024-10-27",7,0,22,214,0,22,1,214
"Congo","2024-10-28",0,0,22,214,0,22,1,215
"Congo","2024-10-29",0,0,22,214,0,22,0,215
"Congo","2024-10-30",0,0,22,214,0,22,1,216
"Congo","2024-10-31",0,0,22,214,1,23,1,217
"Congo","2024-11-01",0,0,22,214,0,23,1,218
"Congo","2024-11-02",0,0,22,214,0,23,0,218
"Congo","2024-11-03",5,0,22,219,0,23,1,219
"Congo","2024-11-04",0,0,22,219,0,23,0,219
"Congo","2024-11-05",0,0,22,219,0,23,0,219
"Congo","2024-11-06",0,0,22,219,0,23,0,219
"Congo","2024-11-07",0,0,22,219,0,23,0,219
"Congo","2024-11-08",0,0,22,219,0,23,0,219
"Congo","2024-11-09",0,0,22,219,0,23,0,219
"Congo","2024-11-10",0,0,22,219,0,23,0,219
"Congo","2024-11-11",0,0,22,219,0,23,0,219
"Congo","2024-11-12",0,0,22,219,0,23,0,219
"Congo","2024-11-13",0,0,22,219,0,23,0,219
"Congo","2024-11-14",0,0,22,219,0,23,0,219
"Congo","2024-11-15",0,0,22,219,0,23,0,219
"Congo","2024-11-16",0,0,22,219,0,23,0,219
"Congo","2024-11-17",0,0,22,219,0,23,0,219
"Congo","2024-11-18",0,0,22,219,0,23,0,219
"Congo","2024-11-19",0,0,22,219,0,23,0,219
"Congo","2024-11-20",0,0,22,219,0,23,0,219
"Congo","2024-11-21",0,0,22,219,0,23,0,219
"Congo","2024-11-22",0,0,22,219,0,23,0,219
"Congo","2024-11-23",0,0,22,219,0,23,0,219
"Congo","2024-11-24",0,0,22,219,0,23,0,219
"Congo","2024-11-25",0,0,22,219,0,23,0,219
"Congo","2024-11-26",0,0,22,219,0,23,0,219
"Congo","2024-11-27",0,0,22,219,0,23,0,219
"Congo","2024-11-28",0,0,22,219,0,23,0,219
"Congo","2024-11-29",0,0,22,219,0,23,0,219
"Congo","2024-11-30",0,0,22,219,0,23,0,219
"Congo","2024-12-01",0,1,23,219,0,23,0,219
"Congo","2024-12-02",0,0,23,219,0,23,0,219
"Congo","2024-12-03",0,0,23,219,0,23,0,219
"Congo","2024-12-04",0,0,23,219,0,23,0,219
"Congo","2024-12-05",0,0,23,219,0,23,0,219
"Congo","2024-12-06",0,0,23,219,0,23,0,219
"Congo","2024-12-07",0,0,23,219,0,23,0,219
"Congo","2024-12-08",0,0,23,219,0,23,0,219
"Congo","2024-12-09",0,0,23,219,0,23,0,219
"Congo","2024-12-10",0,0,23,219,0,23,0,219
"Congo","2024-12-11",0,0,23,219,0,23,0,219
"Congo","2024-12-12",0,0,23,219,0,23,0,219
"Congo","2024-12-13",0,0,23,219,0,23,0,219
"Congo","2024-12-14",0,0,23,219,0,23,0,219
"Congo","2024-12-15",0,0,23,219,0,23,0,219
"Congo","2024-12-16",0,0,23,219,1,24,0,219
"Congo","2024-12-17",0,0,23,219,0,24,0,219
"Congo","2024-12-18",0,0,23,219,0,24,0,219
"Congo","2024-12-19",0,0,23,219,0,24,0,219
"Congo","2024-12-20",0,0,23,219,0,24,0,219
"Congo","2024-12-21",0,0,23,219,0,24,0,219
"Congo","2024-12-22",0,0,23,219,0,24,0,219
"Congo","2024-12-23",0,0,23,219,0,24,0,219
"Congo","2024-12-24",0,0,23,219,0,24,0,219
"Congo","2024-12-25",0,0,23,219,0,24,0,219
"Congo","2024-12-26",0,0,23,219,0,24,0,219
"Congo","2024-12-27",0,0,23,219,0,24,0,219
"Congo","2024-12-28",0,0,23,219,0,24,0,219
"Congo","2024-12-29",0,1,24,219,0,24,0,219
"Congo","2024-12-30",0,0,24,219,0,24,0,219
"Congo","2024-12-31",0,0,24,219,0,24,0,219
"Congo","2025-01-01",0,0,24,219,0,24,0,219
"Congo","2025-01-02",0,0,24,219,0,24,0,219
"Congo","2025-01-03",0,0,24,219,0,24,0,219
"Congo","2025-01-04",0,0,24,219,0,24,0,219
"Congo","2025-01-05",0,0,24,219,0,24,0,219
"Congo","2025-01-06",0,0,24,219,0,24,0,219
"Congo","2025-01-07",0,0,24,219,0,24,0,219
"Congo","2025-01-08",0,0,24,219,0,24,0,219
"Congo","2025-01-09",0,0,24,219,0,24,0,219
"Congo","2025-01-10",0,0,24,219,0,24,0,219
"Congo","2025-01-11",0,0,24,219,0,24,0,219
"Congo","2025-01-12",0,0,24,219,0,24,0,219
"Congo","2025-01-13",0,0,24,219,0,24,0,219
"Congo","2025-01-14",0,0,24,219,0,24,0,219
"Congo","2025-01-15",0,0,24,219,0,24,0,219
"Congo","2025-01-16",0,0,24,219,0,24,0,219
"Congo","2025-01-17",0,0,24,219,0,24,0,219
"Congo","2025-01-18",0,0,24,219,0,24,0,219
"Congo","2025-01-19",0,0,24,219,0,24,0,219
"Congo","2025-01-20",0,0,24,219,0,24,0,219
"Congo","2025-01-21",0,0,24,219,0,24,0,219
"Congo","2025-01-22",0,0,24,219,0,24,0,219
"Congo","2025-01-23",0,0,24,219,0,24,0,219
"Congo","2025-01-24",0,0,24,219,0,24,0,219
"Congo","2025-01-25",0,0,24,219,0,24,0,219
"Congo","2025-01-26",0,0,24,219,0,24,0,219
"Congo","2025-01-27",0,0,24,219,0,24,0,219
"Congo","2025-01-28",0,0,24,219,0,24,0,219
"Congo","2025-01-29",0,0,24,219,0,24,0,219
"Congo","2025-01-30",0,0,24,219,0,24,0,219
"Congo","2025-01-31",0,0,24,219,0,24,0,219
"Congo","2025-02-01",0,0,24,219,0,24,0,219
"Congo","2025-02-02",0,0,24,219,0,24,0,219
"Congo","2025-02-03",0,0,24,219,0,24,0,219
"Costa Rica","2024-01-01",0,0,0,0,0,0,0,0
"Costa Rica","2024-01-02",0,0,0,0,0,0,0,0
"Costa Rica","2024-01-03",0,0,0,0,0,0,0,0
"Costa Rica","2024-01-04",0,0,0,0,0,0,0,0
"Costa Rica","2024-01-05",0,0,0,0,0,0,0,0
"Costa Rica","2024-01-06",0,0,0,0,0,0,0,0
"Costa Rica","2024-01-07",0,0,0,0,0,0,0,0
"Costa Rica","2024-01-08",0,0,0,0,0,0,0,0
"Costa Rica","2024-01-09",0,0,0,0,0,0,0,0
"Costa Rica","2024-01-10",0,0,0,0,0,0,0,0
"Costa Rica","2024-01-11",0,0,0,0,0,0,0,0
"Costa Rica","2024-01-12",0,0,0,0,0,0,0,0
"Costa Rica","2024-01-13",0,0,0,0,0,0,0,0
"Costa Rica","2024-01-14",0,0,0,0,0,0,0,0
"Costa Rica","2024-01-15",0,0,0,0,0,0,0,0
"Costa Rica","2024-01-16",0,0,0,0,0,0,0,0
"Costa Rica","2024-01-17",0,0,0,0,0,0,0,0
"Costa Rica","2024-01-18",0,0,0,0,0,0,0,0
"Costa Rica","2024-01-19",0,0,0,0,0,0,0,0
"Costa Rica","2024-01-20",0,0,0,0,0,0,0,0
"Costa Rica","2024-01-21",0,0,0,0,0,0,0,0
"Costa Rica","2024-01-22",0,0,0,0,0,0,0,0
"Costa Rica","2024-01-23",0,0,0,0,0,0,0,0
"Costa Rica","2024-01-24",0,0,0,0,0,0,0,0
"Costa Rica","2024-01-25",0,0,0,0,0,0,0,0
"Costa Rica","2024-01-26",0,0,0,0,0,0,0,0
"Costa Rica","2024-01-27",0,0,0,0,0,0,0,0
"Costa Rica","2024-01-28",0,0,0,0,0,0,0,0
"Costa Rica","2024-01-29",0,0,0,0,0,0,0,0
"Costa Rica","2024-01-30",0,0,0,0,0,0,0,0
"Costa Rica","2024-01-31",0,0,0,0,0,0,0,0
"Costa Rica","2024-02-01",0,0,0,0,0,0,0,0
"Costa Rica","2024-02-02",0,0,0,0,0,0,0,0
"Costa Rica","2024-02-03",0,0,0,0,0,0,0,0
"Costa Rica","2024-02-04",0,0,0,0,0,0,0,0
"Costa Rica","2024-02-05",0,0,0,0,0,0,0,0
"Costa Rica","2024-02-06",0,0,0,0,0,0,0,0
"Costa Rica","2024-02-07",0,0,0,0,0,0,0,0
"Costa Rica","2024-02-08",0,0,0,0,0,0,0,0
"Costa Rica","2024-02-09",0,0,0,0,0,0,0,0
"Costa Rica","2024-02-10",0,0,0,0,0,0,0,0
"Costa Rica","2024-02-11",0,0,0,0,0,0,0,0
"Costa Rica","2024-02-12",0,0,0,0,0,0,0,0
"Costa Rica","2024-02-13",0,0,0,0,0,0,0,0
"Costa Rica","2024-02-14",0,0,0,0,0,0,0,0
"Costa Rica","2024-02-15",0,0,0,0,0,0,0,0
"Costa Rica","2024-02-16",0,0,0,0,0,0,0,0
"Costa Rica","2024-02-17",0,0,0,0,0,0,0,0
"Costa Rica","2024-02-18",0,0,0,0,0,0,0,0
"Costa Rica","2024-02-19",0,0,0,0,0,0,0,0
"Costa Rica","2024-02-20",0,0,0,0,0,0,0,0
"Costa Rica","2024-02-21",0,0,0,0,0,0,0,0
"Costa Rica","2024-02-22",0,0,0,0,0,0,0,0
"Costa Rica","2024-02-23",0,0,0,0,0,0,0,0
"Costa Rica","2024-02-24",0,0,0,0,0,0,0,0
"Costa Rica","2024-02-25",0,0,0,0,0,0,0,0
"Costa Rica","2024-02-26",0,0,0,0,0,0,0,0
"Costa Rica","2024-02-27",0,0,0,0,0,0,0,0
"Costa Rica","2024-02-28",0,0,0,0,0,0,0,0
"Costa Rica","2024-02-29",0,0,0,0,0,0,0,0
"Costa Rica","2024-03-01",0,0,0,0,0,0,0,0
"Costa Rica","2024-03-02",0,0,0,0,0,0,0,0
"Costa Rica","2024-03-03",0,0,0,0,0,0,0,0
"Costa Rica","2024-03-04",0,0,0,0,0,0,0,0
"Costa Rica","2024-03-05",0,1,1,0,1,1,0,0
"Costa Rica","2024-03-06",0,0,1,0,0,1,0,0
"Costa Rica","2024-03-07",0,0,1,0,0,1,0,0
"Costa Rica","2024-03-08",0,0,1,0,0,1,0,0
"Costa Rica","2024-03-09",0,0,1,0,0,1,0,0
"Costa Rica","2024-03-10",0,0,1,0,0,1,0,0
"Costa Rica","2024-03-11",0,0,1,0,0,1,0,0
"Costa Rica","2024-03-12",0,0,1,0,0,1,0,0
"Costa Rica","2024-03-13",0,0,1,0,0,1,0,0
"Costa Rica","2024-03-14",0,0,1,0,0,1,0,0
"Costa Rica","2024-03-15",0,0,1,0,0,1,0,0
"Costa Rica","2024-03-16",0,0,1,0,0,1,0,0
"Costa Rica","2024-03-17",0,0,1,0,0,1,0,0
"Costa Rica","2024-03-18",0,0,1,0,0,1,0,0
"Costa Rica","2024-03-19",0,0,1,0,0,1,0,0
"Costa Rica","2024-03-20",0,0,1,0,0,1,0,0
"Costa Rica","2024-03-21",0,0,1,0,0,1,0,0
"Costa Rica","2024-03-22",0,0,1,0,0,1,0,0
"Costa Rica","2024-03-23",0,0,1,0,0,1,0,0
"Costa Rica","2024-03-24",0,0,1,0,0,1,0,0
"Costa Rica","2024-03-25",0,0,1,0,0,1,0,0
"Costa Rica","2024-03-26",0,0,1,0,0,1,0,0
"Costa Rica","2024-03-27",0,0,1,0,0,1,0,0
"Costa Rica","2024-03-28",0,0,1,0,0,1,0,0
"Costa Rica","2024-03-29",0,0,1,0,0,1,0,0
"Costa Rica","2024-03-30",0,0,1,0,0,1,0,0
"Costa Rica","2024-03-31",0,0,1,0,0,1,0,0
"Costa Rica","2024-04-01",0,0,1,0,0,1,0,0
"Costa Rica","2024-04-02",0,0,1,0,0,1,0,0
"Costa Rica","2024-04-03",0,0,1,0,0,1,0,0
"Costa Rica","2024-04-04",0,0,1,0,0,1,0,0
"Costa Rica","2024-04-05",0,0,1,0,0,1,0,0
"Costa Rica","2024-04-06",0,0,1,0,0,1,0,0
"Costa Rica","2024-04-07",0,0,1,0,0,1,0,0
"Costa Rica","2024-04-08",0,0,1,0,0,1,0,0
"Costa Rica","2024-04-09",0,0,1,0,0,1,0,0
"Costa Rica","2024-04-10",0,0,1,0,0,1,0,0
"Costa Rica","2024-04-11",0,0,1,0,0,1,0,0
"Costa Rica","2024-04-12",0,0,1,0,0,1,0,0
"Costa Rica","2024-04-13",0,0,1,0,0,1,0,0
"Costa Rica","2024-04-14",0,0,1,0,0,1,0,0
"Costa Rica","2024-04-15",0,0,1,0,0,1,0,0
"Costa Rica","2024-04-16",0,0,1,0,0,1,0,0
"Costa Rica","2024-04-17",0,0,1,0,0,1,0,0
"Costa Rica","2024-04-18",0,0,1,0,0,1,0,0
"Costa Rica","2024-04-19",0,0,1,0,0,1,0,0
"Costa Rica","2024-04-20",0,0,1,0,0,1,0,0
"Costa Rica","2024-04-21",0,0,1,0,0,1,0,0
"Costa Rica","2024-04-22",0,0,1,0,0,1,0,0
"Costa Rica","2024-04-23",0,0,1,0,0,1,0,0
"Costa Rica","2024-04-24",0,0,1,0,0,1,0,0
"Costa Rica","2024-04-25",0,0,1,0,0,1,0,0
"Costa Rica","2024-04-26",0,0,1,0,0,1,0,0
"Costa Rica","2024-04-27",0,0,1,0,0,1,0,0
"Costa Rica","2024-04-28",0,0,1,0,0,1,0,0
"Costa Rica","2024-04-29",0,0,1,0,0,1,0,0
"Costa Rica","2024-04-30",0,0,1,0,0,1,0,0
"Costa Rica","2024-05-01",0,0,1,0,0,1,0,0
"Costa Rica","2024-05-02",0,0,1,0,0,1,0,0
"Costa Rica","2024-05-03",0,0,1,0,0,1,0,0
"Costa Rica","2024-05-04",0,0,1,0,0,1,0,0
"Costa Rica","2024-05-05",0,0,1,0,0,1,0,0
"Costa Rica","2024-05-06",0,0,1,0,0,1,0,0
"Costa Rica","2024-05-07",0,0,1,0,0,1,0,0
"Costa Rica","2024-05-08",0,0,1,0,0,1,0,0
"Costa Rica","2024-05-09",0,0,1,0,0,1,0,0
"Costa Rica","2024-05-10",0,0,1,0,0,1,0,0
"Costa Rica","2024-05-11",0,0,1,0,0,1,0,0
"Costa Rica","2024-05-12",0,0,1,0,0,1,0,0
"Costa Rica","2024-05-13",0,0,1,0,0,1,0,0
"Costa Rica","2024-05-14",0,0,1,0,0,1,0,0
"Costa Rica","2024-05-15",0,0,1,0,0,1,0,0
"Costa Rica","2024-05-16",0,0,1,0,0,1,0,0
"Costa Rica","2024-05-17",0,0,1,0,0,1,0,0
"Costa Rica","2024-05-18",0,0,1,0,0,1,0,0
"Costa Rica","2024-05-19",0,0,1,0,0,1,0,0
"Costa Rica","2024-05-20",0,0,1,0,0,1,0,0
"Costa Rica","2024-05-21",0,0,1,0,0,1,0,0
"Costa Rica","2024-05-22",0,0,1,0,0,1,0,0
"Costa Rica","2024-05-23",0,0,1,0,0,1,0,0
"Costa Rica","2024-05-24",0,0,1,0,0,1,0,0
"Costa Rica","2024-05-25",0,0,1,0,0,1,0,0
"Costa Rica","2024-05-26",0,0,1,0,0,1,0,0
"Costa Rica","2024-05-27",0,0,1,0,0,1,0,0
"Costa Rica","2024-05-28",0,0,1,0,0,1,0,0
"Costa Rica","2024-05-29",0,0,1,0,0,1,0,0
"Costa Rica","2024-05-30",0,0,1,0,0,1,0,0
"Costa Rica","2024-05-31",0,0,1,0,0,1,0,0
"Costa Rica","2024-06-01",0,0,1,0,0,1,0,0
"Costa Rica","2024-06-02",0,0,1,0,0,1,0,0
"Costa Rica","2024-06-03",0,0,1,0,0,1,0,0
"Costa Rica","2024-06-04",0,0,1,0,0,1,0,0
"Costa Rica","2024-06-05",0,0,1,0,0,1,0,0
"Costa Rica","2024-06-06",0,0,1,0,0,1,0,0
"Costa Rica","2024-06-07",0,0,1,0,0,1,0,0
"Costa Rica","2024-06-08",0,0,1,0,0,1,0,0
"Costa Rica","2024-06-09",0,0,1,0,0,1,0,0
"Costa Rica","2024-06-10",0,0,1,0,0,1,0,0
"Costa Rica","2024-06-11",0,0,1,0,0,1,0,0
"Costa Rica","2024-06-12",0,0,1,0,0,1,0,0
"Costa Rica","2024-06-13",0,0,1,0,0,1,0,0
"Costa Rica","2024-06-14",0,0,1,0,0,1,0,0
"Costa Rica","2024-06-15",0,0,1,0,0,1,0,0
"Costa Rica","2024-06-16",0,0,1,0,0,1,0,0
"Costa Rica","2024-06-17",0,0,1,0,0,1,0,0
"Costa Rica","2024-06-18",0,0,1,0,0,1,0,0
"Costa Rica","2024-06-19",0,0,1,0,0,1,0,0
"Costa Rica","2024-06-20",0,0,1,0,0,1,0,0
"Costa Rica","2024-06-21",0,0,1,0,0,1,0,0
"Costa Rica","2024-06-22",0,0,1,0,0,1,0,0
"Costa Rica","2024-06-23",0,0,1,0,0,1,0,0
"Costa Rica","2024-06-24",0,0,1,0,0,1,0,0
"Costa Rica","2024-06-25",0,0,1,0,0,1,0,0
"Costa Rica","2024-06-26",0,0,1,0,0,1,0,0
"Costa Rica","2024-06-27",0,0,1,0,0,1,0,0
"Costa Rica","2024-06-28",0,0,1,0,0,1,0,0
"Costa Rica","2024-06-29",0,0,1,0,0,1,0,0
"Costa Rica","2024-06-30",0,0,1,0,0,1,0,0
"Costa Rica","2024-07-01",0,0,1,0,0,1,0,0
"Costa Rica","2024-07-02",0,0,1,0,0,1,0,0
"Costa Rica","2024-07-03",0,0,1,0,0,1,0,0
"Costa Rica","2024-07-04",0,0,1,0,0,1,0,0
"Costa Rica","2024-07-05",0,0,1,0,0,1,0,0
"Costa Rica","2024-07-06",0,0,1,0,0,1,0,0
"Costa Rica","2024-07-07",0,0,1,0,0,1,0,0
"Costa Rica","2024-07-08",0,0,1,0,0,1,0,0
"Costa Rica","2024-07-09",0,0,1,0,0,1,0,0
"Costa Rica","2024-07-10",0,0,1,0,0,1,0,0
"Costa Rica","2024-07-11",0,0,1,0,0,1,0,0
"Costa Rica","2024-07-12",0,0,1,0,0,1,0,0
"Costa Rica","2024-07-13",0,0,1,0,0,1,0,0
"Costa Rica","2024-07-14",0,0,1,0,0,1,0,0
"Costa Rica","2024-07-15",0,0,1,0,0,1,0,0
"Costa Rica","2024-07-16",0,0,1,0,0,1,0,0
"Costa Rica","2024-07-17",0,0,1,0,0,1,0,0
"Costa Rica","2024-07-18",0,0,1,0,0,1,0,0
"Costa Rica","2024-07-19",0,0,1,0,0,1,0,0
"Costa Rica","2024-07-20",0,0,1,0,0,1,0,0
"Costa Rica","2024-07-21",0,0,1,0,0,1,0,0
"Costa Rica","2024-07-22",0,0,1,0,0,1,0,0
"Costa Rica","2024-07-23",0,0,1,0,0,1,0,0
"Costa Rica","2024-07-24",0,0,1,0,0,1,0,0
"Costa Rica","2024-07-25",0,0,1,0,0,1,0,0
"Costa Rica","2024-07-26",0,0,1,0,0,1,0,0
"Costa Rica","2024-07-27",0,0,1,0,0,1,0,0
"Costa Rica","2024-07-28",0,0,1,0,0,1,0,0
"Costa Rica","2024-07-29",0,0,1,0,0,1,0,0
"Costa Rica","2024-07-30",0,0,1,0,0,1,0,0
"Costa Rica","2024-07-31",0,0,1,0,0,1,0,0
"Costa Rica","2024-08-01",0,0,1,0,0,1,0,0
"Costa Rica","2024-08-02",0,0,1,0,0,1,0,0
"Costa Rica","2024-08-03",0,0,1,0,0,1,0,0
"Costa Rica","2024-08-04",0,0,1,0,0,1,0,0
"Costa Rica","2024-08-05",0,0,1,0,0,1,0,0
"Costa Rica","2024-08-06",0,0,1,0,0,1,0,0
"Costa Rica","2024-08-07",0,0,1,0,0,1,0,0
"Costa Rica","2024-08-08",0,0,1,0,0,1,0,0
"Costa Rica","2024-08-09",0,0,1,0,0,1,0,0
"Costa Rica","2024-08-10",0,0,1,0,0,1,0,0
"Costa Rica","2024-08-11",0,0,1,0,0,1,0,0
"Costa Rica","2024-08-12",0,0,1,0,0,1,0,0
"Costa Rica","2024-08-13",0,0,1,0,0,1,0,0
"Costa Rica","2024-08-14",0,0,1,0,0,1,0,0
"Costa Rica","2024-08-15",0,0,1,0,0,1,0,0
"Costa Rica","2024-08-16",0,0,1,0,0,1,0,0
"Costa Rica","2024-08-17",0,0,1,0,0,1,0,0
"Costa Rica","2024-08-18",0,0,1,0,0,1,0,0
"Costa Rica","2024-08-19",0,0,1,0,0,1,0,0
"Costa Rica","2024-08-20",0,0,1,0,0,1,0,0
"Costa Rica","2024-08-21",0,0,1,0,0,1,0,0
"Costa Rica","2024-08-22",0,0,1,0,0,1,0,0
"Costa Rica","2024-08-23",0,0,1,0,0,1,0,0
"Costa Rica","2024-08-24",0,0,1,0,0,1,0,0
"Costa Rica","2024-08-25",0,0,1,0,0,1,0,0
"Costa Rica","2024-08-26",0,0,1,0,0,1,0,0
"Costa Rica","2024-08-27",0,0,1,0,0,1,0,0
"Costa Rica","2024-08-28",0,0,1,0,0,1,0,0
"Costa Rica","2024-08-29",0,0,1,0,0,1,0,0
"Costa Rica","2024-08-30",0,0,1,0,0,1,0,0
"Costa Rica","2024-08-31",0,0,1,0,0,1,0,0
"Costa Rica","2024-09-01",0,0,1,0,0,1,0,0
"Costa Rica","2024-09-02",0,0,1,0,0,1,0,0
"Costa Rica","2024-09-03",0,0,1,0,0,1,0,0
"Costa Rica","2024-09-04",0,0,1,0,0,1,0,0
"Costa Rica","2024-09-05",0,0,1,0,0,1,0,0
"Costa Rica","2024-09-06",0,0,1,0,0,1,0,0
"Costa Rica","2024-09-07",0,0,1,0,0,1,0,0
"Costa Rica","2024-09-08",0,0,1,0,0,1,0,0
"Costa Rica","2024-09-09",0,0,1,0,0,1,0,0
"Costa Rica","2024-09-10",0,0,1,0,0,1,0,0
"Costa Rica","2024-09-11",0,0,1,0,0,1,0,0
"Costa Rica","2024-09-12",0,0,1,0,0,1,0,0
"Costa Rica","2024-09-13",0,0,1,0,0,1,0,0
"Costa Rica","2024-09-14",0,0,1,0,0,1,0,0
"Costa Rica","2024-09-15",0,0,1,0,0,1,0,0
"Costa Rica","2024-09-16",0,0,1,0,0,1,0,0
"Costa Rica","2024-09-17",0,0,1,0,0,1,0,0
"Costa Rica","2024-09-18",0,0,1,0,0,1,0,0
"Costa Rica","2024-09-19",0,0,1,0,0,1,0,0
"Costa Rica","2024-09-20",0,0,1,0,0,1,0,0
"Costa Rica","2024-09-21",0,0,1,0,0,1,0,0
"Costa Rica","2024-09-22",0,0,1,0,0,1,0,0
"Costa Rica","2024-09-23",0,0,1,0,0,1,0,0
"Costa Rica","2024-09-24",0,0,1,0,0,1,0,0
"Costa Rica","2024-09-25",0,0,1,0,0,1,0,0
"Costa Rica","2024-09-26",0,0,1,0,0,1,0,0
"Costa Rica","2024-09-27",0,0,1,0,0,1,0,0
"Costa Rica","2024-09-28",0,0,1,0,0,1,0,0
"Costa Rica","2024-09-29",0,0,1,0,0,1,0,0
"Costa Rica","2024-09-30",0,0,1,0,0,1,0,0
"Costa Rica","2024-10-01",0,0,1,0,0,1,0,0
"Costa Rica","2024-10-02",0,0,1,0,0,1,0,0
"Costa Rica","2024-10-03",0,0,1,0,0,1,0,0
"Costa Rica","2024-10-04",0,0,1,0,0,1,0,0
"Costa Rica","2024-10-05",0,0,1,0,0,1,0,0
"Costa Rica","2024-10-06",0,0,1,0,0,1,0,0
"Costa Rica","2024-10-07",0,0,1,0,0,1,0,0
"Costa Rica","2024-10-08",0,0,1,0,0,1,0,0
"Costa Rica","2024-10-09",0,0,1,0,0,1,0,0
"Costa Rica","2024-10-10",0,0,1,0,0,1,0,0
"Costa Rica","2024-10-11",0,0,1,0,0,1,0,0
"Costa Rica","2024-10-12",0,0,1,0,0,1,0,0
"Costa Rica","2024-10-13",0,0,1,0,0,1,0,0
"Costa Rica","2024-10-14",0,0,1,0,0,1,0,0
"Costa Rica","2024-10-15",0,0,1,0,0,1,0,0
"Costa Rica","2024-10-16",0,0,1,0,0,1,0,0
"Costa Rica","2024-10-17",0,0,1,0,0,1,0,0
"Costa Rica","2024-10-18",0,0,1,0,0,1,0,0
"Costa Rica","2024-10-19",0,0,1,0,0,1,0,0
"Costa Rica","2024-10-20",0,0,1,0,0,1,0,0
"Costa Rica","2024-10-21",0,0,1,0,0,1,0,0
"Costa Rica","2024-10-22",0,0,1,0,0,1,0,0
"Costa Rica","2024-10-23",0,0,1,0,0,1,0,0
"Costa Rica","2024-10-24",0,0,1,0,0,1,0,0
"Costa Rica","2024-10-25",0,0,1,0,0,1,0,0
"Costa Rica","2024-10-26",0,0,1,0,0,1,0,0
"Costa Rica","2024-10-27",0,0,1,0,0,1,0,0
"Costa Rica","2024-10-28",0,0,1,0,0,1,0,0
"Costa Rica","2024-10-29",0,0,1,0,0,1,0,0
"Costa Rica","2024-10-30",0,0,1,0,0,1,0,0
"Costa Rica","2024-10-31",0,0,1,0,0,1,0,0
"Costa Rica","2024-11-01",0,0,1,0,0,1,0,0
"Costa Rica","2024-11-02",0,0,1,0,0,1,0,0
"Costa Rica","2024-11-03",0,0,1,0,0,1,0,0
"Costa Rica","2024-11-04",0,0,1,0,0,1,0,0
"Costa Rica","2024-11-05",0,0,1,0,0,1,0,0
"Costa Rica","2024-11-06",0,0,1,0,0,1,0,0
"Costa Rica","2024-11-07",0,0,1,0,0,1,0,0
"Costa Rica","2024-11-08",0,0,1,0,0,1,0,0
"Costa Rica","2024-11-09",0,0,1,0,0,1,0,0
"Costa Rica","2024-11-10",0,0,1,0,0,1,0,0
"Costa Rica","2024-11-11",0,0,1,0,0,1,0,0
"Costa Rica","2024-11-12",0,0,1,0,0,1,0,0
"Costa Rica","2024-11-13",0,0,1,0,0,1,0,0
"Costa Rica","2024-11-14",0,0,1,0,0,1,0,0
"Costa Rica","2024-11-15",0,0,1,0,0,1,0,0
"Costa Rica","2024-11-16",0,0,1,0,0,1,0,0
"Costa Rica","2024-11-17",0,0,1,0,0,1,0,0
"Costa Rica","2024-11-18",0,0,1,0,0,1,0,0
"Costa Rica","2024-11-19",0,0,1,0,0,1,0,0
"Costa Rica","2024-11-20",0,0,1,0,0,1,0,0
"Costa Rica","2024-11-21",0,0,1,0,0,1,0,0
"Costa Rica","2024-11-22",0,0,1,0,0,1,0,0
"Costa Rica","2024-11-23",0,0,1,0,0,1,0,0
"Costa Rica","2024-11-24",0,0,1,0,0,1,0,0
"Costa Rica","2024-11-25",0,0,1,0,0,1,0,0
"Costa Rica","2024-11-26",0,0,1,0,0,1,0,0
"Costa Rica","2024-11-27",0,0,1,0,0,1,0,0
"Costa Rica","2024-11-28",0,0,1,0,0,1,0,0
"Costa Rica","2024-11-29",0,0,1,0,0,1,0,0
"Costa Rica","2024-11-30",0,0,1,0,0,1,0,0
"Costa Rica","2024-12-01",0,0,1,0,0,1,0,0
"Costa Rica","2024-12-02",0,0,1,0,0,1,0,0
"Costa Rica","2024-12-03",0,0,1,0,0,1,0,0
"Costa Rica","2024-12-04",0,0,1,0,0,1,0,0
"Costa Rica","2024-12-05",0,0,1,0,0,1,0,0
"Costa Rica","2024-12-06",0,0,1,0,0,1,0,0
"Costa Rica","2024-12-07",0,0,1,0,0,1,0,0
"Costa Rica","2024-12-08",0,0,1,0,0,1,0,0
"Costa Rica","2024-12-09",0,0,1,0,0,1,0,0
"Costa Rica","2024-12-10",0,0,1,0,0,1,0,0
"Costa Rica","2024-12-11",0,0,1,0,0,1,0,0
"Costa Rica","2024-12-12",0,0,1,0,0,1,0,0
"Costa Rica","2024-12-13",0,0,1,0,0,1,0,0
"Costa Rica","2024-12-14",0,0,1,0,0,1,0,0
"Costa Rica","2024-12-15",0,0,1,0,0,1,0,0
"Costa Rica","2024-12-16",0,0,1,0,0,1,0,0
"Costa Rica","2024-12-17",0,0,1,0,0,1,0,0
"Costa Rica","2024-12-18",0,0,1,0,0,1,0,0
"Costa Rica","2024-12-19",0,0,1,0,0,1,0,0
"Costa Rica","2024-12-20",0,0,1,0,0,1,0,0
"Costa Rica","2024-12-21",0,0,1,0,0,1,0,0
"Costa Rica","2024-12-22",0,0,1,0,0,1,0,0
"Costa Rica","2024-12-23",0,0,1,0,0,1,0,0
"Costa Rica","2024-12-24",0,0,1,0,0,1,0,0
"Costa Rica","2024-12-25",0,0,1,0,0,1,0,0
"Costa Rica","2024-12-26",0,0,1,0,0,1,0,0
"Costa Rica","2024-12-27",0,0,1,0,0,1,0,0
"Costa Rica","2024-12-28",0,0,1,0,0,1,0,0
"Costa Rica","2024-12-29",0,0,1,0,0,1,0,0
"Costa Rica","2024-12-30",0,0,1,0,0,1,0,0
"Costa Rica","2024-12-31",0,0,1,0,0,1,0,0
"Costa Rica","2025-01-01",0,0,1,0,0,1,0,0
"Costa Rica","2025-01-02",0,0,1,0,0,1,0,0
"Costa Rica","2025-01-03",0,0,1,0,0,1,0,0
"Costa Rica","2025-01-04",0,0,1,0,0,1,0,0
"Costa Rica","2025-01-05",0,0,1,0,0,1,0,0
"Costa Rica","2025-01-06",0,0,1,0,0,1,0,0
"Costa Rica","2025-01-07",0,0,1,0,0,1,0,0
"Costa Rica","2025-01-08",0,0,1,0,0,1,0,0
"Costa Rica","2025-01-09",0,0,1,0,0,1,0,0
"Costa Rica","2025-01-10",0,0,1,0,0,1,0,0
"Costa Rica","2025-01-11",0,0,1,0,0,1,0,0
"Costa Rica","2025-01-12",0,0,1,0,0,1,0,0
"Costa Rica","2025-01-13",0,0,1,0,0,1,0,0
"Costa Rica","2025-01-14",0,0,1,0,0,1,0,0
"Costa Rica","2025-01-15",0,0,1,0,0,1,0,0
"Costa Rica","2025-01-16",0,0,1,0,0,1,0,0
"Costa Rica","2025-01-17",0,0,1,0,0,1,0,0
"Costa Rica","2025-01-18",0,0,1,0,0,1,0,0
"Costa Rica","2025-01-19",0,0,1,0,0,1,0,0
"Costa Rica","2025-01-20",0,0,1,0,0,1,0,0
"Costa Rica","2025-01-21",0,0,1,0,0,1,0,0
"Costa Rica","2025-01-22",0,0,1,0,0,1,0,0
"Costa Rica","2025-01-23",0,0,1,0,0,1,0,0
"Costa Rica","2025-01-24",0,0,1,0,0,1,0,0
"Costa Rica","2025-01-25",0,0,1,0,0,1,0,0
"Costa Rica","2025-01-26",0,0,1,0,0,1,0,0
"Costa Rica","2025-01-27",0,0,1,0,0,1,0,0
"Costa Rica","2025-01-28",0,0,1,0,0,1,0,0
"Costa Rica","2025-01-29",0,0,1,0,0,1,0,0
"Costa Rica","2025-01-30",0,0,1,0,0,1,0,0
"Costa Rica","2025-01-31",0,0,1,0,0,1,0,0
"Costa Rica","2025-02-01",0,0,1,0,0,1,0,0
"Costa Rica","2025-02-02",0,0,1,0,0,1,0,0
"Costa Rica","2025-02-03",0,0,1,0,0,1,0,0
"Côte d’Ivoire","2024-01-01",0,0,0,0,0,0,0,0
"Côte d’Ivoire","2024-01-02",0,0,0,0,0,0,0,0
"Côte d’Ivoire","2024-01-03",0,0,0,0,0,0,0,0
"Côte d’Ivoire","2024-01-04",0,0,0,0,0,0,0,0
"Côte d’Ivoire","2024-01-05",0,0,0,0,0,0,0,0
"Côte d’Ivoire","2024-01-06",0,0,0,0,0,0,0,0
"Côte d’Ivoire","2024-01-07",0,0,0,0,0,0,0,0
"Côte d’Ivoire","2024-01-08",0,0,0,0,0,0,0,0
"Côte d’Ivoire","2024-01-09",0,0,0,0,0,0,0,0
"Côte d’Ivoire","2024-01-10",0,0,0,0,0,0,0,0
"Côte d’Ivoire","2024-01-11",0,0,0,0,0,0,0,0
"Côte d’Ivoire","2024-01-12",0,0,0,0,0,0,0,0
"Côte d’Ivoire","2024-01-13",0,0,0,0,0,0,0,0
"Côte d’Ivoire","2024-01-14",0,0,0,0,0,0,0,0
"Côte d’Ivoire","2024-01-15",0,0,0,0,0,0,0,0
"Côte d’Ivoire","2024-01-16",0,0,0,0,0,0,0,0
"Côte d’Ivoire","2024-01-17",0,0,0,0,0,0,0,0
"Côte d’Ivoire","2024-01-18",0,0,0,0,0,0,0,0
"Côte d’Ivoire","2024-01-19",0,0,0,0,0,0,0,0
"Côte d’Ivoire","2024-01-20",0,0,0,0,0,0,0,0
"Côte d’Ivoire","2024-01-21",0,0,0,0,0,0,0,0
"Côte d’Ivoire","2024-01-22",0,0,0,0,0,0,0,0
"Côte d’Ivoire","2024-01-23",0,0,0,0,0,0,0,0
"Côte d’Ivoire","2024-01-24",0,0,0,0,0,0,0,0
"Côte d’Ivoire","2024-01-25",0,0,0,0,0,0,0,0
"Côte d’Ivoire","2024-01-26",0,0,0,0,0,0,0,0
"Côte d’Ivoire","2024-01-27",0,0,0,0,0,0,0,0
"Côte d’Ivoire","2024-01-28",0,0,0,0,0,0,0,0
"Côte d’Ivoire","2024-01-29",0,0,0,0,0,0,0,0
"Côte d’Ivoire","2024-01-30",0,0,0,0,0,0,0,0
"Côte d’Ivoire","2024-01-31",0,0,0,0,0,0,0,0
"Côte d’Ivoire","2024-02-01",0,0,0,0,0,0,0,0
"Côte d’Ivoire","2024-02-02",0,0,0,0,0,0,0,0
"Côte d’Ivoire","2024-02-03",0,0,0,0,0,0,0,0
"Côte d’Ivoire","2024-02-04",0,0,0,0,0,0,0,0
"Côte d’Ivoire","2024-02-05",0,0,0,0,0,0,0,0
"Côte d’Ivoire","2024-02-06",0,0,0,0,0,0,0,0
"Côte d’Ivoire","2024-02-07",0,0,0,0,0,0,0,0
"Côte d’Ivoire","2024-02-08",0,0,0,0,0,0,0,0
"Côte d’Ivoire","2024-02-09",0,0,0,0,0,0,0,0
"Côte d’Ivoire","2024-02-10",0,0,0,0,0,0,0,0
"Côte d’Ivoire","2024-02-11",0,0,0,0,0,0,0,0
"Côte d’Ivoire","2024-02-12",0,0,0,0,0,0,0,0
"Côte d’Ivoire","2024-02-13",0,0,0,0,0,0,0,0
"Côte d’Ivoire","2024-02-14",0,0,0,0,0,0,0,0
"Côte d’Ivoire","2024-02-15",0,0,0,0,0,0,0,0
"Côte d’Ivoire","2024-02-16",0,0,0,0,0,0,0,0
"Côte d’Ivoire","2024-02-17",0,0,0,0,0,0,0,0
"Côte d’Ivoire","2024-02-18",0,0,0,0,0,0,0,0
"Côte d’Ivoire","2024-02-19",0,0,0,0,0,0,0,0
"Côte d’Ivoire","2024-02-20",0,0,0,0,0,0,0,0
"Côte d’Ivoire","2024-02-21",0,0,0,0,0,0,0,0
"Côte d’Ivoire","2024-02-22",0,0,0,0,0,0,0,0
"Côte d’Ivoire","2024-02-23",0,0,0,0,0,0,0,0
"Côte d’Ivoire","2024-02-24",0,0,0,0,0,0,0,0
"Côte d’Ivoire","2024-02-25",0,0,0,0,0,0,0,0
"Côte d’Ivoire","2024-02-26",0,0,0,0,0,0,0,0
"Côte d’Ivoire","2024-02-27",0,0,0,0,0,0,0,0
"Côte d’Ivoire","2024-02-28",0,0,0,0,0,0,0,0
"Côte d’Ivoire","2024-02-29",0,0,0,0,0,0,0,0
"Côte d’Ivoire","2024-03-01",0,0,0,0,0,0,0,0
"Côte d’Ivoire","2024-03-02",0,0,0,0,0,0,0,0
"Côte d’Ivoire","2024-03-03",0,0,0,0,0,0,0,0
"Côte d’Ivoire","2024-03-04",0,0,0,0,0,0,0,0
"Côte d’Ivoire","2024-03-05",0,0,0,0,0,0,0,0
"Côte d’Ivoire","2024-03-06",0,0,0,0,0,0,0,0
"Côte d’Ivoire","2024-03-07",0,0,0,0,0,0,0,0
"Côte d’Ivoire","2024-03-08",0,0,0,0,0,0,0,0
"Côte d’Ivoire","2024-03-09",0,0,0,0,0,0,0,0
"Côte d’Ivoire","2024-03-10",0,0,0,0,0,0,0,0
"Côte d’Ivoire","2024-03-11",0,0,0,0,0,0,0,0
"Côte d’Ivoire","2024-03-12",0,0,0,0,0,0,0,0
"Côte d’Ivoire","2024-03-13",0,0,0,0,0,0,0,0
"Côte d’Ivoire","2024-03-14",0,0,0,0,0,0,0,0
"Côte d’Ivoire","2024-03-15",0,0,0,0,0,0,0,0
"Côte d’Ivoire","2024-03-16",0,0,0,0,0,0,0,0
"Côte d’Ivoire","2024-03-17",0,0,0,0,0,0,0,0
"Côte d’Ivoire","2024-03-18",0,0,0,0,0,0,0,0
"Côte d’Ivoire","2024-03-19",0,0,0,0,0,0,0,0
"Côte d’Ivoire","2024-03-20",0,0,0,0,0,0,0,0
"Côte d’Ivoire","2024-03-21",0,0,0,0,0,0,0,0
"Côte d’Ivoire","2024-03-22",0,0,0,0,0,0,0,0
"Côte d’Ivoire","2024-03-23",0,0,0,0,0,0,0,0
"Côte d’Ivoire","2024-03-24",0,0,0,0,0,0,0,0
"Côte d’Ivoire","2024-03-25",0,0,0,0,0,0,0,0
"Côte d’Ivoire","2024-03-26",0,0,0,0,0,0,0,0
"Côte d’Ivoire","2024-03-27",0,0,0,0,0,0,0,0
"Côte d’Ivoire","2024-03-28",0,0,0,0,0,0,0,0
"Côte d’Ivoire","2024-03-29",0,0,0,0,0,0,0,0
"Côte d’Ivoire","2024-03-30",0,0,0,0,0,0,0,0
"Côte d’Ivoire","2024-03-31",0,0,0,0,0,0,0,0
"Côte d’Ivoire","2024-04-01",0,0,0,0,0,0,0,0
"Côte d’Ivoire","2024-04-02",0,0,0,0,0,0,0,0
"Côte d’Ivoire","2024-04-03",0,0,0,0,0,0,0,0
"Côte d’Ivoire","2024-04-04",0,0,0,0,0,0,0,0
"Côte d’Ivoire","2024-04-05",0,0,0,0,0,0,0,0
"Côte d’Ivoire","2024-04-06",0,0,0,0,0,0,0,0
"Côte d’Ivoire","2024-04-07",0,0,0,0,0,0,0,0
"Côte d’Ivoire","2024-04-08",0,0,0,0,0,0,0,0
"Côte d’Ivoire","2024-04-09",0,0,0,0,0,0,0,0
"Côte d’Ivoire","2024-04-10",0,0,0,0,0,0,0,0
"Côte d’Ivoire","2024-04-11",0,0,0,0,0,0,0,0
"Côte d’Ivoire","2024-04-12",0,0,0,0,0,0,0,0
"Côte d’Ivoire","2024-04-13",0,0,0,0,0,0,0,0
"Côte d’Ivoire","2024-04-14",0,0,0,0,0,0,0,0
"Côte d’Ivoire","2024-04-15",0,0,0,0,0,0,0,0
"Côte d’Ivoire","2024-04-16",0,0,0,0,0,0,0,0
"Côte d’Ivoire","2024-04-17",0,0,0,0,0,0,0,0
"Côte d’Ivoire","2024-04-18",0,0,0,0,0,0,0,0
"Côte d’Ivoire","2024-04-19",0,0,0,0,0,0,0,0
"Côte d’Ivoire","2024-04-20",0,0,0,0,0,0,0,0
"Côte d’Ivoire","2024-04-21",0,0,0,0,0,0,0,0
"Côte d’Ivoire","2024-04-22",0,0,0,0,0,0,0,0
"Côte d’Ivoire","2024-04-23",0,0,0,0,0,0,0,0
"Côte d’Ivoire","2024-04-24",0,0,0,0,0,0,0,0
"Côte d’Ivoire","2024-04-25",0,0,0,0,0,0,0,0
"Côte d’Ivoire","2024-04-26",0,0,0,0,0,0,0,0
"Côte d’Ivoire","2024-04-27",0,0,0,0,0,0,0,0
"Côte d’Ivoire","2024-04-28",0,0,0,0,0,0,0,0
"Côte d’Ivoire","2024-04-29",0,0,0,0,0,0,0,0
"Côte d’Ivoire","2024-04-30",0,0,0,0,0,0,0,0
"Côte d’Ivoire","2024-05-01",0,0,0,0,0,0,0,0
"Côte d’Ivoire","2024-05-02",0,0,0,0,0,0,0,0
"Côte d’Ivoire","2024-05-03",0,0,0,0,0,0,0,0
"Côte d’Ivoire","2024-05-04",0,0,0,0,0,0,0,0
"Côte d’Ivoire","2024-05-05",0,0,0,0,0,0,0,0
"Côte d’Ivoire","2024-05-06",0,0,0,0,0,0,0,0
"Côte d’Ivoire","2024-05-07",0,0,0,0,0,0,0,0
"Côte d’Ivoire","2024-05-08",0,0,0,0,0,0,0,0
"Côte d’Ivoire","2024-05-09",0,0,0,0,0,0,0,0
"Côte d’Ivoire","2024-05-10",0,0,0,0,0,0,0,0
"Côte d’Ivoire","2024-05-11",0,0,0,0,0,0,0,0
"Côte d’Ivoire","2024-05-12",0,0,0,0,0,0,0,0
"Côte d’Ivoire","2024-05-13",0,0,0,0,0,0,0,0
"Côte d’Ivoire","2024-05-14",0,0,0,0,0,0,0,0
"Côte d’Ivoire","2024-05-15",0,0,0,0,0,0,0,0
"Côte d’Ivoire","2024-05-16",0,0,0,0,0,0,0,0
"Côte d’Ivoire","2024-05-17",0,0,0,0,0,0,0,0
"Côte d’Ivoire","2024-05-18",0,0,0,0,0,0,0,0
"Côte d’Ivoire","2024-05-19",0,0,0,0,0,0,0,0
"Côte d’Ivoire","2024-05-20",0,0,0,0,0,0,0,0
"Côte d’Ivoire","2024-05-21",0,0,0,0,0,0,0,0
"Côte d’Ivoire","2024-05-22",0,0,0,0,0,0,0,0
"Côte d’Ivoire","2024-05-23",0,0,0,0,0,0,0,0
"Côte d’Ivoire","2024-05-24",0,0,0,0,0,0,0,0
"Côte d’Ivoire","2024-05-25",0,0,0,0,0,0,0,0
"Côte d’Ivoire","2024-05-26",0,0,0,0,0,0,0,0
"Côte d’Ivoire","2024-05-27",0,0,0,0,0,0,0,0
"Côte d’Ivoire","2024-05-28",0,0,0,0,0,0,0,0
"Côte d’Ivoire","2024-05-29",0,0,0,0,0,0,0,0
"Côte d’Ivoire","2024-05-30",0,0,0,0,0,0,0,0
"Côte d’Ivoire","2024-05-31",0,0,0,0,0,0,0,0
"Côte d’Ivoire","2024-06-01",0,0,0,0,0,0,0,0
"Côte d’Ivoire","2024-06-02",0,0,0,0,0,0,0,0
"Côte d’Ivoire","2024-06-03",0,0,0,0,0,0,0,0
"Côte d’Ivoire","2024-06-04",0,0,0,0,0,0,0,0
"Côte d’Ivoire","2024-06-05",0,0,0,0,0,0,0,0
"Côte d’Ivoire","2024-06-06",0,0,0,0,0,0,0,0
"Côte d’Ivoire","2024-06-07",0,0,0,0,0,0,0,0
"Côte d’Ivoire","2024-06-08",0,0,0,0,0,0,0,0
"Côte d’Ivoire","2024-06-09",0,0,0,0,0,0,0,0
"Côte d’Ivoire","2024-06-10",0,0,0,0,0,0,0,0
"Côte d’Ivoire","2024-06-11",0,0,0,0,0,0,0,0
"Côte d’Ivoire","2024-06-12",0,0,0,0,0,0,0,0
"Côte d’Ivoire","2024-06-13",0,0,0,0,0,0,0,0
"Côte d’Ivoire","2024-06-14",0,0,0,0,0,0,0,0
"Côte d’Ivoire","2024-06-15",0,0,0,0,0,0,0,0
"Côte d’Ivoire","2024-06-16",0,0,0,0,0,0,0,0
"Côte d’Ivoire","2024-06-17",0,0,0,0,0,0,0,0
"Côte d’Ivoire","2024-06-18",0,0,0,0,0,0,0,0
"Côte d’Ivoire","2024-06-19",0,0,0,0,0,0,0,0
"Côte d’Ivoire","2024-06-20",0,0,0,0,0,0,0,0
"Côte d’Ivoire","2024-06-21",0,0,0,0,0,0,0,0
"Côte d’Ivoire","2024-06-22",0,0,0,0,0,0,0,0
"Côte d’Ivoire","2024-06-23",0,0,0,0,0,0,0,0
"Côte d’Ivoire","2024-06-24",0,0,0,0,0,0,0,0
"Côte d’Ivoire","2024-06-25",0,0,0,0,0,0,0,0
"Côte d’Ivoire","2024-06-26",0,0,0,0,0,0,0,0
"Côte d’Ivoire","2024-06-27",0,0,0,0,0,0,0,0
"Côte d’Ivoire","2024-06-28",0,0,0,0,0,0,0,0
"Côte d’Ivoire","2024-06-29",0,0,0,0,0,0,0,0
"Côte d’Ivoire","2024-06-30",0,0,0,0,0,0,0,0
"Côte d’Ivoire","2024-07-01",0,0,0,0,0,0,0,0
"Côte d’Ivoire","2024-07-02",0,0,0,0,0,0,0,0
"Côte d’Ivoire","2024-07-03",0,0,0,0,0,0,0,0
"Côte d’Ivoire","2024-07-04",0,0,0,0,0,0,0,0
"Côte d’Ivoire","2024-07-05",0,0,0,0,0,0,0,0
"Côte d’Ivoire","2024-07-06",0,0,0,0,0,0,0,0
"Côte d’Ivoire","2024-07-07",0,1,1,0,1,1,0,0
"Côte d’Ivoire","2024-07-08",0,0,1,0,0,1,0,0
"Côte d’Ivoire","2024-07-09",0,0,1,0,0,1,0,0
"Côte d’Ivoire","2024-07-10",0,0,1,0,0,1,0,0
"Côte d’Ivoire","2024-07-11",0,0,1,0,1,2,0,0
"Côte d’Ivoire","2024-07-12",0,0,1,0,0,2,0,0
"Côte d’Ivoire","2024-07-13",0,0,1,0,0,2,0,0
"Côte d’Ivoire","2024-07-14",0,1,2,0,0,2,0,0
"Côte d’Ivoire","2024-07-15",0,0,2,0,0,2,0,0
"Côte d’Ivoire","2024-07-16",0,0,2,0,1,3,0,0
"Côte d’Ivoire","2024-07-17",0,0,2,0,0,3,0,0
"Côte d’Ivoire","2024-07-18",0,0,2,0,1,4,0,0
"Côte d’Ivoire","2024-07-19",0,0,2,0,0,4,0,0
"Côte d’Ivoire","2024-07-20",0,0,2,0,1,5,0,0
"Côte d’Ivoire","2024-07-21",0,3,5,0,0,5,0,0
"Côte d’Ivoire","2024-07-22",0,0,5,0,1,6,0,0
"Côte d’Ivoire","2024-07-23",0,0,5,0,0,6,0,0
"Côte d’Ivoire","2024-07-24",0,0,5,0,1,7,0,0
"Côte d’Ivoire","2024-07-25",0,0,5,0,0,7,0,0
"Côte d’Ivoire","2024-07-26",0,0,5,0,1,8,0,0
"Côte d’Ivoire","2024-07-27",0,0,5,0,0,8,0,0
"Côte d’Ivoire","2024-07-28",0,4,9,0,1,9,0,0
"Côte d’Ivoire","2024-07-29",0,0,9,0,1,10,0,0
"Côte d’Ivoire","2024-07-30",0,0,9,0,0,10,0,0
"Côte d’Ivoire","2024-07-31",0,0,9,0,1,11,0,0
"Côte d’Ivoire","2024-08-01",0,0,9,0,0,11,0,0
"Côte d’Ivoire","2024-08-02",0,0,9,0,1,12,0,0
"Côte d’Ivoire","2024-08-03",0,0,9,0,0,12,0,0
"Côte d’Ivoire","2024-08-04",0,4,13,0,1,13,0,0
"Côte d’Ivoire","2024-08-05",0,0,13,0,1,14,0,0
"Côte d’Ivoire","2024-08-06",0,0,13,0,1,15,0,0
"Côte d’Ivoire","2024-08-07",0,0,13,0,1,16,0,0
"Côte d’Ivoire","2024-08-08",0,0,13,0,0,16,0,0
"Côte d’Ivoire","2024-08-09",0,0,13,0,1,17,0,0
"Côte d’Ivoire","2024-08-10",0,0,13,0,1,18,0,0
"Côte d’Ivoire","2024-08-11",0,6,19,0,1,19,0,0
"Côte d’Ivoire","2024-08-12",0,0,19,0,2,21,0,0
"Côte d’Ivoire","2024-08-13",0,0,19,0,1,22,0,0
"Côte d’Ivoire","2024-08-14",0,0,19,0,2,24,0,0
"Côte d’Ivoire","2024-08-15",0,0,19,0,2,26,0,0
"Côte d’Ivoire","2024-08-16",0,0,19,0,2,28,0,0
"Côte d’Ivoire","2024-08-17",0,0,19,0,1,29,0,0
"Côte d’Ivoire","2024-08-18",0,12,31,0,2,31,0,0
"Côte d’Ivoire","2024-08-19",0,0,31,0,1,32,0,0
"Côte d’Ivoire","2024-08-20",0,0,31,0,1,33,0,0
"Côte d’Ivoire","2024-08-21",0,0,31,0,1,34,0,0
"Côte d’Ivoire","2024-08-22",0,0,31,0,1,35,0,0
"Côte d’Ivoire","2024-08-23",0,0,31,0,1,36,0,0
"Côte d’Ivoire","2024-08-24",0,0,31,0,1,37,0,0
"Côte d’Ivoire","2024-08-25",0,7,38,0,1,38,0,0
"Côte d’Ivoire","2024-08-26",0,0,38,0,1,39,0,0
"Côte d’Ivoire","2024-08-27",0,0,38,0,0,39,0,0
"Côte d’Ivoire","2024-08-28",0,0,38,0,1,40,0,0
"Côte d’Ivoire","2024-08-29",0,0,38,0,1,41,0,0
"Côte d’Ivoire","2024-08-30",0,0,38,0,1,42,0,0
"Côte d’Ivoire","2024-08-31",0,0,38,0,0,42,0,0
"Côte d’Ivoire","2024-09-01",0,5,43,0,1,43,0,0
"Côte d’Ivoire","2024-09-02",0,0,43,0,1,44,0,0
"Côte d’Ivoire","2024-09-03",0,0,43,0,0,44,0,0
"Côte d’Ivoire","2024-09-04",0,0,43,0,1,45,0,0
"Côte d’Ivoire","2024-09-05",0,0,43,0,0,45,0,0
"Côte d’Ivoire","2024-09-06",0,0,43,0,1,46,0,0
"Côte d’Ivoire","2024-09-07",0,0,43,0,0,46,0,0
"Côte d’Ivoire","2024-09-08",138,4,47,138,1,47,138,138
"Côte d’Ivoire","2024-09-09",0,0,47,138,1,48,6,144
"Côte d’Ivoire","2024-09-10",0,0,47,138,2,50,7,151
"Côte d’Ivoire","2024-09-11",0,0,47,138,1,51,6,157
"Côte d’Ivoire","2024-09-12",0,0,47,138,2,53,7,164
"Côte d’Ivoire","2024-09-13",0,0,47,138,1,54,6,170
"Côte d’Ivoire","2024-09-14",0,0,47,138,2,56,6,176
"Côte d’Ivoire","2024-09-15",0,10,57,138,1,57,7,183
"Côte d’Ivoire","2024-09-16",51,0,57,189,1,58,6,189
"Côte d’Ivoire","2024-09-17",0,0,57,189,1,59,2,191
"Côte d’Ivoire","2024-09-18",0,0,57,189,1,60,3,194
"Côte d’Ivoire","2024-09-19",0,0,57,189,1,61,2,196
"Côte d’Ivoire","2024-09-20",0,0,57,189,1,62,3,199
"Côte d’Ivoire","2024-09-21",0,0,57,189,1,63,2,201
"Côte d’Ivoire","2024-09-22",0,7,64,189,1,64,2,203
"Côte d’Ivoire","2024-09-23",0,0,64,189,1,65,3,206
"Côte d’Ivoire","2024-09-24",0,0,64,189,0,65,2,208
"Côte d’Ivoire","2024-09-25",0,0,64,189,1,66,3,211
"Côte d’Ivoire","2024-09-26",0,0,64,189,0,66,2,213
"Côte d’Ivoire","2024-09-27",0,0,64,189,1,67,2,215
"Côte d’Ivoire","2024-09-28",0,0,64,189,0,67,3,218
"Côte d’Ivoire","2024-09-29",0,4,68,189,1,68,2,220
"Côte d’Ivoire","2024-09-30",0,0,68,189,1,69,3,223
"Côte d’Ivoire","2024-10-01",0,0,68,189,1,70,2,225
"Côte d’Ivoire","2024-10-02",0,0,68,189,1,71,2,227
"Côte d’Ivoire","2024-10-03",0,0,68,189,0,71,3,230
"Côte d’Ivoire","2024-10-04",0,0,68,189,1,72,2,232
"Côte d’Ivoire","2024-10-05",0,0,68,189,1,73,3,235
"Côte d’Ivoire","2024-10-06",48,6,74,237,1,74,2,237
"Côte d’Ivoire","2024-10-07",0,0,74,237,1,75,5,242
"Côte d’Ivoire","2024-10-08",0,0,74,237,0,75,6,248
"Côte d’Ivoire","2024-10-09",0,0,74,237,1,76,5,253
"Côte d’Ivoire","2024-10-10",0,0,74,237,0,76,5,258
"Côte d’Ivoire","2024-10-11",0,0,74,237,1,77,6,264
"Côte d’Ivoire","2024-10-12",32,0,74,269,0,77,5,269
"Côte d’Ivoire","2024-10-13",0,4,78,269,1,78,3,272
"Côte d’Ivoire","2024-10-14",0,0,78,269,1,79,3,275
"Côte d’Ivoire","2024-10-15",0,0,78,269,0,79,2,277
"Côte d’Ivoire","2024-10-16",0,0,78,269,1,80,3,280
"Côte d’Ivoire","2024-10-17",0,0,78,269,1,81,3,283
"Côte d’Ivoire","2024-10-18",0,0,78,269,1,82,3,286
"Côte d’Ivoire","2024-10-19",0,0,78,269,0,82,3,289
"Côte d’Ivoire","2024-10-20",0,5,83,269,1,83,2,291
"Côte d’Ivoire","2024-10-21",0,0,83,269,1,84,3,294
"Côte d’Ivoire","2024-10-22",0,0,83,269,0,84,3,297
"Côte d’Ivoire","2024-10-23",0,0,83,269,1,85,3,300
"Côte d’Ivoire","2024-10-24",0,0,83,269,0,85,3,303
"Côte d’Ivoire","2024-10-25",0,0,83,269,1,86,2,305
"Côte d’Ivoire","2024-10-26",0,0,83,269,0,86,3,308
"Côte d’Ivoire","2024-10-27",42,4,87,311,1,87,3,311
"Côte d’Ivoire","2024-10-28",0,0,87,311,1,88,0,311
"Côte d’Ivoire","2024-10-29",0,0,87,311,2,90,0,311
"Côte d’Ivoire","2024-10-30",0,4,91,311,1,91,0,311
"Côte d’Ivoire","2024-10-31",0,0,91,311,0,91,0,311
"Côte d’Ivoire","2024-11-01",0,0,91,311,0,91,0,311
"Côte d’Ivoire","2024-11-02",0,0,91,311,1,92,0,311
"Côte d’Ivoire","2024-11-03",0,1,92,311,0,92,0,311
"Côte d’Ivoire","2024-11-04",0,0,92,311,1,93,0,311
"Côte d’Ivoire","2024-11-05",0,0,92,311,0,93,0,311
"Côte d’Ivoire","2024-11-06",0,0,92,311,1,94,0,311
"Côte d’Ivoire","2024-11-07",0,0,92,311,0,94,0,311
"Côte d’Ivoire","2024-11-08",0,0,92,311,1,95,0,311
"Côte d’Ivoire","2024-11-09",0,0,92,311,0,95,0,311
"Côte d’Ivoire","2024-11-10",0,4,96,311,1,96,0,311
"Côte d’Ivoire","2024-11-11",0,0,96,311,1,97,0,311
"Côte d’Ivoire","2024-11-12",0,0,96,311,0,97,0,311
"Côte d’Ivoire","2024-11-13",0,0,96,311,1,98,0,311
"Côte d’Ivoire","2024-11-14",0,0,96,311,1,99,0,311
"Côte d’Ivoire","2024-11-15",0,0,96,311,1,100,0,311
"Côte d’Ivoire","2024-11-16",0,0,96,311,0,100,0,311
"Côte d’Ivoire","2024-11-17",0,5,101,311,1,101,0,311
"Côte d’Ivoire","2024-11-18",0,0,101,311,0,101,0,311
"Côte d’Ivoire","2024-11-19",0,0,101,311,1,102,0,311
"Côte d’Ivoire","2024-11-20",0,0,101,311,0,102,0,311
"Côte d’Ivoire","2024-11-21",0,0,101,311,0,102,0,311
"Côte d’Ivoire","2024-11-22",0,0,101,311,0,102,0,311
"Côte d’Ivoire","2024-11-23",0,0,101,311,1,103,0,311
"Côte d’Ivoire","2024-11-24",0,2,103,311,0,103,0,311
"Côte d’Ivoire","2024-11-25",0,0,103,311,1,104,0,311
"Côte d’Ivoire","2024-11-26",0,0,103,311,0,104,0,311
"Côte d’Ivoire","2024-11-27",0,0,103,311,1,105,0,311
"Côte d’Ivoire","2024-11-28",0,0,103,311,0,105,0,311
"Côte d’Ivoire","2024-11-29",0,0,103,311,1,106,0,311
"Côte d’Ivoire","2024-11-30",0,0,103,311,0,106,0,311
"Côte d’Ivoire","2024-12-01",0,4,107,311,1,107,0,311
"Côte d’Ivoire","2024-12-02",0,0,107,311,0,107,0,311
"Côte d’Ivoire","2024-12-03",0,0,107,311,0,107,0,311
"Côte d’Ivoire","2024-12-04",0,0,107,311,0,107,0,311
"Côte d’Ivoire","2024-12-05",0,0,107,311,0,107,0,311
"Côte d’Ivoire","2024-12-06",0,0,107,311,0,107,0,311
"Côte d’Ivoire","2024-12-07",0,0,107,311,0,107,0,311
"Côte d’Ivoire","2024-12-08",0,0,107,311,0,107,0,311
"Côte d’Ivoire","2024-12-09",0,0,107,311,0,107,0,311
"Côte d’Ivoire","2024-12-10",0,0,107,311,0,107,0,311
"Côte d’Ivoire","2024-12-11",0,0,107,311,0,107,0,311
"Côte d’Ivoire","2024-12-12",0,0,107,311,0,107,0,311
"Côte d’Ivoire","2024-12-13",0,0,107,311,0,107,0,311
"Côte d’Ivoire","2024-12-14",0,0,107,311,0,107,0,311
"Côte d’Ivoire","2024-12-15",0,0,107,311,0,107,0,311
"Côte d’Ivoire","2024-12-16",0,0,107,311,0,107,0,311
"Côte d’Ivoire","2024-12-17",0,0,107,311,0,107,0,311
"Côte d’Ivoire","2024-12-18",0,0,107,311,0,107,0,311
"Côte d’Ivoire","2024-12-19",0,0,107,311,0,107,0,311
"Côte d’Ivoire","2024-12-20",0,0,107,311,0,107,0,311
"Côte d’Ivoire","2024-12-21",0,0,107,311,0,107,0,311
"Côte d’Ivoire","2024-12-22",0,0,107,311,0,107,0,311
"Côte d’Ivoire","2024-12-23",0,0,107,311,0,107,0,311
"Côte d’Ivoire","2024-12-24",0,0,107,311,0,107,0,311
"Côte d’Ivoire","2024-12-25",0,0,107,311,0,107,0,311
"Côte d’Ivoire","2024-12-26",0,0,107,311,0,107,0,311
"Côte d’Ivoire","2024-12-27",0,0,107,311,0,107,0,311
"Côte d’Ivoire","2024-12-28",0,0,107,311,0,107,0,311
"Côte d’Ivoire","2024-12-29",0,0,107,311,0,107,0,311
"Côte d’Ivoire","2024-12-30",0,0,107,311,0,107,0,311
"Côte d’Ivoire","2024-12-31",0,0,107,311,0,107,0,311
"Côte d’Ivoire","2025-01-01",0,0,107,311,0,107,0,311
"Côte d’Ivoire","2025-01-02",0,0,107,311,0,107,0,311
"Côte d’Ivoire","2025-01-03",0,0,107,311,0,107,0,311
"Côte d’Ivoire","2025-01-04",0,0,107,311,0,107,0,311
"Côte d’Ivoire","2025-01-05",0,0,107,311,0,107,0,311
"Côte d’Ivoire","2025-01-06",0,0,107,311,0,107,0,311
"Côte d’Ivoire","2025-01-07",0,0,107,311,0,107,0,311
"Côte d’Ivoire","2025-01-08",0,0,107,311,0,107,0,311
"Côte d’Ivoire","2025-01-09",0,0,107,311,0,107,0,311
"Côte d’Ivoire","2025-01-10",0,0,107,311,0,107,0,311
"Côte d’Ivoire","2025-01-11",0,0,107,311,0,107,0,311
"Côte d’Ivoire","2025-01-12",0,0,107,311,0,107,0,311
"Côte d’Ivoire","2025-01-13",0,0,107,311,0,107,0,311
"Côte d’Ivoire","2025-01-14",0,0,107,311,0,107,0,311
"Côte d’Ivoire","2025-01-15",0,0,107,311,0,107,0,311
"Côte d’Ivoire","2025-01-16",0,0,107,311,0,107,0,311
"Côte d’Ivoire","2025-01-17",0,0,107,311,0,107,0,311
"Côte d’Ivoire","2025-01-18",0,0,107,311,0,107,0,311
"Côte d’Ivoire","2025-01-19",0,0,107,311,0,107,0,311
"Côte d’Ivoire","2025-01-20",0,0,107,311,0,107,0,311
"Côte d’Ivoire","2025-01-21",0,0,107,311,0,107,0,311
"Côte d’Ivoire","2025-01-22",0,0,107,311,0,107,0,311
"Côte d’Ivoire","2025-01-23",0,0,107,311,0,107,0,311
"Côte d’Ivoire","2025-01-24",0,0,107,311,0,107,0,311
"Côte d’Ivoire","2025-01-25",0,0,107,311,0,107,0,311
"Côte d’Ivoire","2025-01-26",0,0,107,311,0,107,0,311
"Côte d’Ivoire","2025-01-27",0,0,107,311,0,107,0,311
"Côte d’Ivoire","2025-01-28",0,0,107,311,0,107,0,311
"Côte d’Ivoire","2025-01-29",0,0,107,311,0,107,0,311
"Côte d’Ivoire","2025-01-30",0,0,107,311,0,107,0,311
"Côte d’Ivoire","2025-01-31",0,0,107,311,0,107,0,311
"Côte d’Ivoire","2025-02-01",0,0,107,311,0,107,0,311
"Côte d’Ivoire","2025-02-02",0,0,107,311,0,107,0,311
"Côte d’Ivoire","2025-02-03",0,0,107,311,0,107,0,311
"Croatia","2024-01-01",0,0,0,0,0,0,0,0
"Croatia","2024-01-02",0,0,0,0,0,0,0,0
"Croatia","2024-01-03",0,0,0,0,0,0,0,0
"Croatia","2024-01-04",0,0,0,0,0,0,0,0
"Croatia","2024-01-05",0,0,0,0,0,0,0,0
"Croatia","2024-01-06",0,0,0,0,0,0,0,0
"Croatia","2024-01-07",0,0,0,0,0,0,0,0
"Croatia","2024-01-08",0,0,0,0,0,0,0,0
"Croatia","2024-01-09",0,0,0,0,0,0,0,0
"Croatia","2024-01-10",0,0,0,0,0,0,0,0
"Croatia","2024-01-11",0,0,0,0,0,0,0,0
"Croatia","2024-01-12",0,0,0,0,0,0,0,0
"Croatia","2024-01-13",0,0,0,0,0,0,0,0
"Croatia","2024-01-14",0,0,0,0,0,0,0,0
"Croatia","2024-01-15",0,0,0,0,0,0,0,0
"Croatia","2024-01-16",0,0,0,0,0,0,0,0
"Croatia","2024-01-17",0,0,0,0,0,0,0,0
"Croatia","2024-01-18",0,0,0,0,0,0,0,0
"Croatia","2024-01-19",0,0,0,0,0,0,0,0
"Croatia","2024-01-20",0,0,0,0,0,0,0,0
"Croatia","2024-01-21",0,0,0,0,0,0,0,0
"Croatia","2024-01-22",0,0,0,0,0,0,0,0
"Croatia","2024-01-23",0,0,0,0,0,0,0,0
"Croatia","2024-01-24",0,0,0,0,0,0,0,0
"Croatia","2024-01-25",0,0,0,0,0,0,0,0
"Croatia","2024-01-26",0,0,0,0,0,0,0,0
"Croatia","2024-01-27",0,0,0,0,0,0,0,0
"Croatia","2024-01-28",0,0,0,0,0,0,0,0
"Croatia","2024-01-29",0,0,0,0,0,0,0,0
"Croatia","2024-01-30",0,0,0,0,0,0,0,0
"Croatia","2024-01-31",0,0,0,0,0,0,0,0
"Croatia","2024-02-01",0,0,0,0,0,0,0,0
"Croatia","2024-02-02",0,0,0,0,0,0,0,0
"Croatia","2024-02-03",0,0,0,0,0,0,0,0
"Croatia","2024-02-04",0,0,0,0,0,0,0,0
"Croatia","2024-02-05",0,0,0,0,0,0,0,0
"Croatia","2024-02-06",0,0,0,0,0,0,0,0
"Croatia","2024-02-07",0,0,0,0,0,0,0,0
"Croatia","2024-02-08",0,0,0,0,0,0,0,0
"Croatia","2024-02-09",0,0,0,0,0,0,0,0
"Croatia","2024-02-10",0,0,0,0,0,0,0,0
"Croatia","2024-02-11",0,0,0,0,0,0,0,0
"Croatia","2024-02-12",0,0,0,0,0,0,0,0
"Croatia","2024-02-13",0,0,0,0,0,0,0,0
"Croatia","2024-02-14",0,0,0,0,0,0,0,0
"Croatia","2024-02-15",0,0,0,0,0,0,0,0
"Croatia","2024-02-16",0,0,0,0,0,0,0,0
"Croatia","2024-02-17",0,0,0,0,0,0,0,0
"Croatia","2024-02-18",0,0,0,0,0,0,0,0
"Croatia","2024-02-19",0,0,0,0,0,0,0,0
"Croatia","2024-02-20",0,0,0,0,0,0,0,0
"Croatia","2024-02-21",0,0,0,0,0,0,0,0
"Croatia","2024-02-22",0,0,0,0,0,0,0,0
"Croatia","2024-02-23",0,0,0,0,0,0,0,0
"Croatia","2024-02-24",0,0,0,0,0,0,0,0
"Croatia","2024-02-25",0,0,0,0,0,0,0,0
"Croatia","2024-02-26",0,0,0,0,0,0,0,0
"Croatia","2024-02-27",0,0,0,0,0,0,0,0
"Croatia","2024-02-28",0,0,0,0,0,0,0,0
"Croatia","2024-02-29",0,0,0,0,0,0,0,0
"Croatia","2024-03-01",0,0,0,0,0,0,0,0
"Croatia","2024-03-02",0,0,0,0,0,0,0,0
"Croatia","2024-03-03",0,0,0,0,0,0,0,0
"Croatia","2024-03-04",0,0,0,0,0,0,0,0
"Croatia","2024-03-05",0,0,0,0,0,0,0,0
"Croatia","2024-03-06",0,0,0,0,0,0,0,0
"Croatia","2024-03-07",0,0,0,0,0,0,0,0
"Croatia","2024-03-08",0,0,0,0,0,0,0,0
"Croatia","2024-03-09",0,0,0,0,0,0,0,0
"Croatia","2024-03-10",0,0,0,0,0,0,0,0
"Croatia","2024-03-11",0,0,0,0,0,0,0,0
"Croatia","2024-03-12",0,0,0,0,0,0,0,0
"Croatia","2024-03-13",0,0,0,0,0,0,0,0
"Croatia","2024-03-14",0,0,0,0,0,0,0,0
"Croatia","2024-03-15",0,0,0,0,0,0,0,0
"Croatia","2024-03-16",0,0,0,0,0,0,0,0
"Croatia","2024-03-17",0,0,0,0,0,0,0,0
"Croatia","2024-03-18",0,0,0,0,0,0,0,0
"Croatia","2024-03-19",0,0,0,0,0,0,0,0
"Croatia","2024-03-20",0,0,0,0,0,0,0,0
"Croatia","2024-03-21",0,0,0,0,0,0,0,0
"Croatia","2024-03-22",0,0,0,0,0,0,0,0
"Croatia","2024-03-23",0,0,0,0,0,0,0,0
"Croatia","2024-03-24",0,0,0,0,0,0,0,0
"Croatia","2024-03-25",0,0,0,0,0,0,0,0
"Croatia","2024-03-26",0,0,0,0,0,0,0,0
"Croatia","2024-03-27",0,0,0,0,0,0,0,0
"Croatia","2024-03-28",0,0,0,0,0,0,0,0
"Croatia","2024-03-29",0,0,0,0,0,0,0,0
"Croatia","2024-03-30",0,0,0,0,0,0,0,0
"Croatia","2024-03-31",0,0,0,0,0,0,0,0
"Croatia","2024-04-01",0,0,0,0,0,0,0,0
"Croatia","2024-04-02",0,0,0,0,0,0,0,0
"Croatia","2024-04-03",0,0,0,0,0,0,0,0
"Croatia","2024-04-04",0,0,0,0,0,0,0,0
"Croatia","2024-04-05",0,0,0,0,0,0,0,0
"Croatia","2024-04-06",0,0,0,0,0,0,0,0
"Croatia","2024-04-07",0,0,0,0,0,0,0,0
"Croatia","2024-04-08",0,0,0,0,0,0,0,0
"Croatia","2024-04-09",0,0,0,0,0,0,0,0
"Croatia","2024-04-10",0,0,0,0,0,0,0,0
"Croatia","2024-04-11",0,0,0,0,0,0,0,0
"Croatia","2024-04-12",0,0,0,0,0,0,0,0
"Croatia","2024-04-13",0,0,0,0,0,0,0,0
"Croatia","2024-04-14",0,0,0,0,0,0,0,0
"Croatia","2024-04-15",0,0,0,0,0,0,0,0
"Croatia","2024-04-16",0,0,0,0,0,0,0,0
"Croatia","2024-04-17",0,0,0,0,0,0,0,0
"Croatia","2024-04-18",0,0,0,0,0,0,0,0
"Croatia","2024-04-19",0,0,0,0,0,0,0,0
"Croatia","2024-04-20",0,0,0,0,0,0,0,0
"Croatia","2024-04-21",0,0,0,0,0,0,0,0
"Croatia","2024-04-22",0,0,0,0,0,0,0,0
"Croatia","2024-04-23",0,0,0,0,0,0,0,0
"Croatia","2024-04-24",0,0,0,0,0,0,0,0
"Croatia","2024-04-25",0,0,0,0,0,0,0,0
"Croatia","2024-04-26",0,0,0,0,0,0,0,0
"Croatia","2024-04-27",0,0,0,0,0,0,0,0
"Croatia","2024-04-28",0,0,0,0,0,0,0,0
"Croatia","2024-04-29",0,0,0,0,0,0,0,0
"Croatia","2024-04-30",0,1,1,0,1,1,0,0
"Croatia","2024-05-01",0,0,1,0,0,1,0,0
"Croatia","2024-05-02",0,0,1,0,0,1,0,0
"Croatia","2024-05-03",0,0,1,0,0,1,0,0
"Croatia","2024-05-04",0,0,1,0,0,1,0,0
"Croatia","2024-05-05",0,0,1,0,0,1,0,0
"Croatia","2024-05-06",0,0,1,0,0,1,0,0
"Croatia","2024-05-07",0,0,1,0,0,1,0,0
"Croatia","2024-05-08",0,0,1,0,0,1,0,0
"Croatia","2024-05-09",0,0,1,0,0,1,0,0
"Croatia","2024-05-10",0,0,1,0,0,1,0,0
"Croatia","2024-05-11",0,0,1,0,0,1,0,0
"Croatia","2024-05-12",0,0,1,0,0,1,0,0
"Croatia","2024-05-13",0,0,1,0,0,1,0,0
"Croatia","2024-05-14",0,0,1,0,0,1,0,0
"Croatia","2024-05-15",0,0,1,0,0,1,0,0
"Croatia","2024-05-16",0,0,1,0,0,1,0,0
"Croatia","2024-05-17",0,0,1,0,0,1,0,0
"Croatia","2024-05-18",0,0,1,0,0,1,0,0
"Croatia","2024-05-19",0,0,1,0,0,1,0,0
"Croatia","2024-05-20",0,0,1,0,0,1,0,0
"Croatia","2024-05-21",0,0,1,0,0,1,0,0
"Croatia","2024-05-22",0,0,1,0,0,1,0,0
"Croatia","2024-05-23",0,0,1,0,0,1,0,0
"Croatia","2024-05-24",0,0,1,0,0,1,0,0
"Croatia","2024-05-25",0,0,1,0,0,1,0,0
"Croatia","2024-05-26",0,0,1,0,0,1,0,0
"Croatia","2024-05-27",0,0,1,0,0,1,0,0
"Croatia","2024-05-28",0,0,1,0,0,1,0,0
"Croatia","2024-05-29",0,0,1,0,0,1,0,0
"Croatia","2024-05-30",0,0,1,0,0,1,0,0
"Croatia","2024-05-31",0,0,1,0,0,1,0,0
"Croatia","2024-06-01",0,0,1,0,0,1,0,0
"Croatia","2024-06-02",0,0,1,0,0,1,0,0
"Croatia","2024-06-03",0,0,1,0,0,1,0,0
"Croatia","2024-06-04",0,0,1,0,0,1,0,0
"Croatia","2024-06-05",0,0,1,0,0,1,0,0
"Croatia","2024-06-06",0,0,1,0,0,1,0,0
"Croatia","2024-06-07",0,0,1,0,0,1,0,0
"Croatia","2024-06-08",0,0,1,0,0,1,0,0
"Croatia","2024-06-09",0,0,1,0,0,1,0,0
"Croatia","2024-06-10",0,0,1,0,0,1,0,0
"Croatia","2024-06-11",0,0,1,0,0,1,0,0
"Croatia","2024-06-12",0,0,1,0,0,1,0,0
"Croatia","2024-06-13",0,0,1,0,0,1,0,0
"Croatia","2024-06-14",0,0,1,0,0,1,0,0
"Croatia","2024-06-15",0,0,1,0,0,1,0,0
"Croatia","2024-06-16",0,0,1,0,0,1,0,0
"Croatia","2024-06-17",0,0,1,0,0,1,0,0
"Croatia","2024-06-18",0,0,1,0,0,1,0,0
"Croatia","2024-06-19",0,0,1,0,0,1,0,0
"Croatia","2024-06-20",0,0,1,0,0,1,0,0
"Croatia","2024-06-21",0,0,1,0,0,1,0,0
"Croatia","2024-06-22",0,0,1,0,0,1,0,0
"Croatia","2024-06-23",0,0,1,0,0,1,0,0
"Croatia","2024-06-24",0,0,1,0,0,1,0,0
"Croatia","2024-06-25",0,0,1,0,0,1,0,0
"Croatia","2024-06-26",0,0,1,0,0,1,0,0
"Croatia","2024-06-27",0,0,1,0,0,1,0,0
"Croatia","2024-06-28",0,0,1,0,0,1,0,0
"Croatia","2024-06-29",0,0,1,0,0,1,0,0
"Croatia","2024-06-30",0,0,1,0,0,1,0,0
"Croatia","2024-07-01",0,0,1,0,0,1,0,0
"Croatia","2024-07-02",0,0,1,0,0,1,0,0
"Croatia","2024-07-03",0,0,1,0,0,1,0,0
"Croatia","2024-07-04",0,0,1,0,0,1,0,0
"Croatia","2024-07-05",0,0,1,0,0,1,0,0
"Croatia","2024-07-06",0,0,1,0,0,1,0,0
"Croatia","2024-07-07",0,0,1,0,0,1,0,0
"Croatia","2024-07-08",0,0,1,0,0,1,0,0
"Croatia","2024-07-09",0,0,1,0,0,1,0,0
"Croatia","2024-07-10",0,0,1,0,0,1,0,0
"Croatia","2024-07-11",0,0,1,0,0,1,0,0
"Croatia","2024-07-12",0,0,1,0,0,1,0,0
"Croatia","2024-07-13",0,0,1,0,0,1,0,0
"Croatia","2024-07-14",0,0,1,0,0,1,0,0
"Croatia","2024-07-15",0,0,1,0,0,1,0,0
"Croatia","2024-07-16",0,0,1,0,0,1,0,0
"Croatia","2024-07-17",0,0,1,0,0,1,0,0
"Croatia","2024-07-18",0,0,1,0,0,1,0,0
"Croatia","2024-07-19",0,0,1,0,0,1,0,0
"Croatia","2024-07-20",0,0,1,0,0,1,0,0
"Croatia","2024-07-21",0,0,1,0,0,1,0,0
"Croatia","2024-07-22",0,0,1,0,0,1,0,0
"Croatia","2024-07-23",0,0,1,0,0,1,0,0
"Croatia","2024-07-24",0,0,1,0,0,1,0,0
"Croatia","2024-07-25",0,0,1,0,0,1,0,0
"Croatia","2024-07-26",0,0,1,0,0,1,0,0
"Croatia","2024-07-27",0,0,1,0,0,1,0,0
"Croatia","2024-07-28",0,0,1,0,0,1,0,0
"Croatia","2024-07-29",0,0,1,0,0,1,0,0
"Croatia","2024-07-30",0,0,1,0,0,1,0,0
"Croatia","2024-07-31",0,0,1,0,0,1,0,0
"Croatia","2024-08-01",0,0,1,0,0,1,0,0
"Croatia","2024-08-02",0,0,1,0,0,1,0,0
"Croatia","2024-08-03",0,0,1,0,0,1,0,0
"Croatia","2024-08-04",0,0,1,0,0,1,0,0
"Croatia","2024-08-05",0,0,1,0,0,1,0,0
"Croatia","2024-08-06",0,0,1,0,0,1,0,0
"Croatia","2024-08-07",0,0,1,0,0,1,0,0
"Croatia","2024-08-08",0,0,1,0,0,1,0,0
"Croatia","2024-08-09",0,0,1,0,0,1,0,0
"Croatia","2024-08-10",0,0,1,0,0,1,0,0
"Croatia","2024-08-11",0,0,1,0,0,1,0,0
"Croatia","2024-08-12",0,0,1,0,0,1,0,0
"Croatia","2024-08-13",0,0,1,0,0,1,0,0
"Croatia","2024-08-14",0,0,1,0,0,1,0,0
"Croatia","2024-08-15",0,0,1,0,0,1,0,0
"Croatia","2024-08-16",0,0,1,0,1,2,0,0
"Croatia","2024-08-17",0,0,1,0,0,2,0,0
"Croatia","2024-08-18",0,0,1,0,0,2,0,0
"Croatia","2024-08-19",0,0,1,0,0,2,0,0
"Croatia","2024-08-20",0,0,1,0,0,2,0,0
"Croatia","2024-08-21",0,0,1,0,0,2,0,0
"Croatia","2024-08-22",0,0,1,0,0,2,0,0
"Croatia","2024-08-23",0,0,1,0,0,2,0,0
"Croatia","2024-08-24",0,0,1,0,0,2,0,0
"Croatia","2024-08-25",0,0,1,0,0,2,0,0
"Croatia","2024-08-26",0,0,1,0,0,2,0,0
"Croatia","2024-08-27",0,0,1,0,0,2,0,0
"Croatia","2024-08-28",0,0,1,0,0,2,0,0
"Croatia","2024-08-29",0,0,1,0,0,2,0,0
"Croatia","2024-08-30",0,0,1,0,0,2,0,0
"Croatia","2024-08-31",0,0,1,0,0,2,0,0
"Croatia","2024-09-01",0,0,1,0,0,2,0,0
"Croatia","2024-09-02",0,0,1,0,0,2,0,0
"Croatia","2024-09-03",0,0,1,0,0,2,0,0
"Croatia","2024-09-04",0,0,1,0,0,2,0,0
"Croatia","2024-09-05",0,0,1,0,0,2,0,0
"Croatia","2024-09-06",0,0,1,0,0,2,0,0
"Croatia","2024-09-07",0,0,1,0,0,2,0,0
"Croatia","2024-09-08",0,0,1,0,0,2,0,0
"Croatia","2024-09-09",0,0,1,0,0,2,0,0
"Croatia","2024-09-10",0,0,1,0,0,2,0,0
"Croatia","2024-09-11",0,0,1,0,0,2,0,0
"Croatia","2024-09-12",0,0,1,0,0,2,0,0
"Croatia","2024-09-13",0,0,1,0,0,2,0,0
"Croatia","2024-09-14",0,0,1,0,0,2,0,0
"Croatia","2024-09-15",0,0,1,0,0,2,0,0
"Croatia","2024-09-16",0,0,1,0,0,2,0,0
"Croatia","2024-09-17",0,0,1,0,0,2,0,0
"Croatia","2024-09-18",0,0,1,0,0,2,0,0
"Croatia","2024-09-19",0,0,1,0,0,2,0,0
"Croatia","2024-09-20",0,0,1,0,0,2,0,0
"Croatia","2024-09-21",0,0,1,0,0,2,0,0
"Croatia","2024-09-22",0,0,1,0,0,2,0,0
"Croatia","2024-09-23",0,0,1,0,0,2,0,0
"Croatia","2024-09-24",0,0,1,0,0,2,0,0
"Croatia","2024-09-25",0,0,1,0,0,2,0,0
"Croatia","2024-09-26",0,0,1,0,0,2,0,0
"Croatia","2024-09-27",0,0,1,0,0,2,0,0
"Croatia","2024-09-28",0,0,1,0,0,2,0,0
"Croatia","2024-09-29",0,0,1,0,0,2,0,0
"Croatia","2024-09-30",0,0,1,0,0,2,0,0
"Croatia","2024-10-01",0,0,1,0,0,2,0,0
"Croatia","2024-10-02",0,0,1,0,0,2,0,0
"Croatia","2024-10-03",0,0,1,0,0,2,0,0
"Croatia","2024-10-04",0,0,1,0,0,2,0,0
"Croatia","2024-10-05",0,0,1,0,0,2,0,0
"Croatia","2024-10-06",0,0,1,0,0,2,0,0
"Croatia","2024-10-07",0,0,1,0,0,2,0,0
"Croatia","2024-10-08",0,0,1,0,0,2,0,0
"Croatia","2024-10-09",0,0,1,0,0,2,0,0
"Croatia","2024-10-10",0,0,1,0,0,2,0,0
"Croatia","2024-10-11",0,0,1,0,0,2,0,0
"Croatia","2024-10-12",0,0,1,0,0,2,0,0
"Croatia","2024-10-13",0,0,1,0,0,2,0,0
"Croatia","2024-10-14",0,0,1,0,0,2,0,0
"Croatia","2024-10-15",0,0,1,0,0,2,0,0
"Croatia","2024-10-16",0,0,1,0,0,2,0,0
"Croatia","2024-10-17",0,0,1,0,0,2,0,0
"Croatia","2024-10-18",0,0,1,0,0,2,0,0
"Croatia","2024-10-19",0,0,1,0,0,2,0,0
"Croatia","2024-10-20",0,0,1,0,0,2,0,0
"Croatia","2024-10-21",0,0,1,0,0,2,0,0
"Croatia","2024-10-22",0,0,1,0,0,2,0,0
"Croatia","2024-10-23",0,0,1,0,0,2,0,0
"Croatia","2024-10-24",0,0,1,0,0,2,0,0
"Croatia","2024-10-25",0,0,1,0,0,2,0,0
"Croatia","2024-10-26",0,0,1,0,0,2,0,0
"Croatia","2024-10-27",0,0,1,0,0,2,0,0
"Croatia","2024-10-28",0,0,1,0,0,2,0,0
"Croatia","2024-10-29",0,0,1,0,0,2,0,0
"Croatia","2024-10-30",0,0,1,0,0,2,0,0
"Croatia","2024-10-31",0,0,1,0,0,2,0,0
"Croatia","2024-11-01",0,0,1,0,0,2,0,0
"Croatia","2024-11-02",0,0,1,0,0,2,0,0
"Croatia","2024-11-03",0,0,1,0,0,2,0,0
"Croatia","2024-11-04",0,0,1,0,0,2,0,0
"Croatia","2024-11-05",0,0,1,0,0,2,0,0
"Croatia","2024-11-06",0,0,1,0,0,2,0,0
"Croatia","2024-11-07",0,0,1,0,0,2,0,0
"Croatia","2024-11-08",0,0,1,0,0,2,0,0
"Croatia","2024-11-09",0,0,1,0,0,2,0,0
"Croatia","2024-11-10",0,0,1,0,0,2,0,0
"Croatia","2024-11-11",0,0,1,0,0,2,0,0
"Croatia","2024-11-12",0,0,1,0,0,2,0,0
"Croatia","2024-11-13",0,0,1,0,0,2,0,0
"Croatia","2024-11-14",0,0,1,0,0,2,0,0
"Croatia","2024-11-15",0,0,1,0,0,2,0,0
"Croatia","2024-11-16",0,0,1,0,0,2,0,0
"Croatia","2024-11-17",0,0,1,0,0,2,0,0
"Croatia","2024-11-18",0,0,1,0,0,2,0,0
"Croatia","2024-11-19",0,0,1,0,0,2,0,0
"Croatia","2024-11-20",0,0,1,0,0,2,0,0
"Croatia","2024-11-21",0,0,1,0,0,2,0,0
"Croatia","2024-11-22",0,0,1,0,0,2,0,0
"Croatia","2024-11-23",0,0,1,0,0,2,0,0
"Croatia","2024-11-24",0,0,1,0,0,2,0,0
"Croatia","2024-11-25",0,0,1,0,0,2,0,0
"Croatia","2024-11-26",0,0,1,0,0,2,0,0
"Croatia","2024-11-27",0,0,1,0,0,2,0,0
"Croatia","2024-11-28",0,0,1,0,0,2,0,0
"Croatia","2024-11-29",0,0,1,0,0,2,0,0
"Croatia","2024-11-30",0,1,2,0,0,2,0,0
"Croatia","2024-12-01",0,0,2,0,0,2,0,0
"Croatia","2024-12-02",0,0,2,0,0,2,0,0
"Croatia","2024-12-03",0,0,2,0,0,2,0,0
"Croatia","2024-12-04",0,0,2,0,0,2,0,0
"Croatia","2024-12-05",0,0,2,0,0,2,0,0
"Croatia","2024-12-06",0,0,2,0,0,2,0,0
"Croatia","2024-12-07",0,0,2,0,0,2,0,0
"Croatia","2024-12-08",0,0,2,0,0,2,0,0
"Croatia","2024-12-09",0,0,2,0,0,2,0,0
"Croatia","2024-12-10",0,0,2,0,0,2,0,0
"Croatia","2024-12-11",0,0,2,0,0,2,0,0
"Croatia","2024-12-12",0,0,2,0,0,2,0,0
"Croatia","2024-12-13",0,0,2,0,0,2,0,0
"Croatia","2024-12-14",0,0,2,0,0,2,0,0
"Croatia","2024-12-15",0,0,2,0,0,2,0,0
"Croatia","2024-12-16",0,0,2,0,0,2,0,0
"Croatia","2024-12-17",0,0,2,0,0,2,0,0
"Croatia","2024-12-18",0,0,2,0,0,2,0,0
"Croatia","2024-12-19",0,0,2,0,0,2,0,0
"Croatia","2024-12-20",0,0,2,0,0,2,0,0
"Croatia","2024-12-21",0,0,2,0,0,2,0,0
"Croatia","2024-12-22",0,0,2,0,0,2,0,0
"Croatia","2024-12-23",0,0,2,0,0,2,0,0
"Croatia","2024-12-24",0,0,2,0,0,2,0,0
"Croatia","2024-12-25",0,0,2,0,0,2,0,0
"Croatia","2024-12-26",0,0,2,0,0,2,0,0
"Croatia","2024-12-27",0,0,2,0,0,2,0,0
"Croatia","2024-12-28",0,0,2,0,0,2,0,0
"Croatia","2024-12-29",0,0,2,0,0,2,0,0
"Croatia","2024-12-30",0,0,2,0,0,2,0,0
"Croatia","2024-12-31",0,0,2,0,0,2,0,0
"Croatia","2025-01-01",0,0,2,0,0,2,0,0
"Croatia","2025-01-02",0,0,2,0,0,2,0,0
"Croatia","2025-01-03",0,0,2,0,0,2,0,0
"Croatia","2025-01-04",0,0,2,0,0,2,0,0
"Croatia","2025-01-05",0,0,2,0,0,2,0,0
"Croatia","2025-01-06",0,0,2,0,0,2,0,0
"Croatia","2025-01-07",0,0,2,0,0,2,0,0
"Croatia","2025-01-08",0,0,2,0,0,2,0,0
"Croatia","2025-01-09",0,0,2,0,0,2,0,0
"Croatia","2025-01-10",0,0,2,0,0,2,0,0
"Croatia","2025-01-11",0,0,2,0,0,2,0,0
"Croatia","2025-01-12",0,0,2,0,0,2,0,0
"Croatia","2025-01-13",0,0,2,0,0,2,0,0
"Croatia","2025-01-14",0,0,2,0,0,2,0,0
"Croatia","2025-01-15",0,0,2,0,0,2,0,0
"Croatia","2025-01-16",0,0,2,0,0,2,0,0
"Croatia","2025-01-17",0,0,2,0,0,2,0,0
"Croatia","2025-01-18",0,0,2,0,0,2,0,0
"Croatia","2025-01-19",0,0,2,0,0,2,0,0
"Croatia","2025-01-20",0,0,2,0,0,2,0,0
"Croatia","2025-01-21",0,0,2,0,0,2,0,0
"Croatia","2025-01-22",0,0,2,0,0,2,0,0
"Croatia","2025-01-23",0,0,2,0,0,2,0,0
"Croatia","2025-01-24",0,0,2,0,0,2,0,0
"Croatia","2025-01-25",0,0,2,0,0,2,0,0
"Croatia","2025-01-26",0,0,2,0,0,2,0,0
"Croatia","2025-01-27",0,0,2,0,0,2,0,0
"Croatia","2025-01-28",0,0,2,0,0,2,0,0
"Croatia","2025-01-29",0,0,2,0,0,2,0,0
"Croatia","2025-01-30",0,0,2,0,0,2,0,0
"Croatia","2025-01-31",0,0,2,0,0,2,0,0
"Croatia","2025-02-01",0,0,2,0,0,2,0,0
"Croatia","2025-02-02",0,0,2,0,0,2,0,0
"Croatia","2025-02-03",0,0,2,0,0,2,0,0
"Cuba","2024-01-01",0,0,0,0,0,0,0,0
"Cuba","2024-01-02",0,0,0,0,0,0,0,0
"Cuba","2024-01-03",0,0,0,0,0,0,0,0
"Cuba","2024-01-04",0,0,0,0,0,0,0,0
"Cuba","2024-01-05",0,0,0,0,0,0,0,0
"Cuba","2024-01-06",0,0,0,0,0,0,0,0
"Cuba","2024-01-07",0,0,0,0,0,0,0,0
"Cuba","2024-01-08",0,0,0,0,0,0,0,0
"Cuba","2024-01-09",0,0,0,0,0,0,0,0
"Cuba","2024-01-10",0,0,0,0,0,0,0,0
"Cuba","2024-01-11",0,0,0,0,0,0,0,0
"Cuba","2024-01-12",0,0,0,0,0,0,0,0
"Cuba","2024-01-13",0,0,0,0,0,0,0,0
"Cuba","2024-01-14",0,0,0,0,0,0,0,0
"Cuba","2024-01-15",0,0,0,0,0,0,0,0
"Cuba","2024-01-16",0,0,0,0,0,0,0,0
"Cuba","2024-01-17",0,0,0,0,0,0,0,0
"Cuba","2024-01-18",0,0,0,0,0,0,0,0
"Cuba","2024-01-19",0,0,0,0,0,0,0,0
"Cuba","2024-01-20",0,0,0,0,0,0,0,0
"Cuba","2024-01-21",0,0,0,0,0,0,0,0
"Cuba","2024-01-22",0,0,0,0,0,0,0,0
"Cuba","2024-01-23",0,0,0,0,0,0,0,0
"Cuba","2024-01-24",0,0,0,0,0,0,0,0
"Cuba","2024-01-25",0,0,0,0,0,0,0,0
"Cuba","2024-01-26",0,0,0,0,0,0,0,0
"Cuba","2024-01-27",0,0,0,0,0,0,0,0
"Cuba","2024-01-28",0,0,0,0,0,0,0,0
"Cuba","2024-01-29",0,0,0,0,0,0,0,0
"Cuba","2024-01-30",0,0,0,0,0,0,0,0
"Cuba","2024-01-31",0,0,0,0,0,0,0,0
"Cuba","2024-02-01",0,0,0,0,0,0,0,0
"Cuba","2024-02-02",0,0,0,0,0,0,0,0
"Cuba","2024-02-03",0,0,0,0,0,0,0,0
"Cuba","2024-02-04",0,0,0,0,0,0,0,0
"Cuba","2024-02-05",0,0,0,0,0,0,0,0
"Cuba","2024-02-06",0,0,0,0,0,0,0,0
"Cuba","2024-02-07",0,0,0,0,0,0,0,0
"Cuba","2024-02-08",0,0,0,0,0,0,0,0
"Cuba","2024-02-09",0,0,0,0,0,0,0,0
"Cuba","2024-02-10",0,0,0,0,0,0,0,0
"Cuba","2024-02-11",0,0,0,0,0,0,0,0
"Cuba","2024-02-12",0,0,0,0,0,0,0,0
"Cuba","2024-02-13",0,0,0,0,0,0,0,0
"Cuba","2024-02-14",0,0,0,0,0,0,0,0
"Cuba","2024-02-15",0,0,0,0,0,0,0,0
"Cuba","2024-02-16",0,0,0,0,0,0,0,0
"Cuba","2024-02-17",0,0,0,0,0,0,0,0
"Cuba","2024-02-18",0,0,0,0,0,0,0,0
"Cuba","2024-02-19",0,0,0,0,0,0,0,0
"Cuba","2024-02-20",0,0,0,0,0,0,0,0
"Cuba","2024-02-21",0,0,0,0,0,0,0,0
"Cuba","2024-02-22",0,0,0,0,0,0,0,0
"Cuba","2024-02-23",0,0,0,0,0,0,0,0
"Cuba","2024-02-24",0,0,0,0,0,0,0,0
"Cuba","2024-02-25",0,0,0,0,0,0,0,0
"Cuba","2024-02-26",0,0,0,0,0,0,0,0
"Cuba","2024-02-27",0,0,0,0,0,0,0,0
"Cuba","2024-02-28",0,0,0,0,0,0,0,0
"Cuba","2024-02-29",0,0,0,0,0,0,0,0
"Cuba","2024-03-01",0,0,0,0,0,0,0,0
"Cuba","2024-03-02",0,0,0,0,0,0,0,0
"Cuba","2024-03-03",0,0,0,0,0,0,0,0
"Cuba","2024-03-04",0,0,0,0,0,0,0,0
"Cuba","2024-03-05",0,0,0,0,0,0,0,0
"Cuba","2024-03-06",0,0,0,0,0,0,0,0
"Cuba","2024-03-07",0,0,0,0,0,0,0,0
"Cuba","2024-03-08",0,0,0,0,0,0,0,0
"Cuba","2024-03-09",0,0,0,0,0,0,0,0
"Cuba","2024-03-10",0,0,0,0,0,0,0,0
"Cuba","2024-03-11",0,0,0,0,0,0,0,0
"Cuba","2024-03-12",0,0,0,0,0,0,0,0
"Cuba","2024-03-13",0,0,0,0,0,0,0,0
"Cuba","2024-03-14",0,0,0,0,0,0,0,0
"Cuba","2024-03-15",0,0,0,0,0,0,0,0
"Cuba","2024-03-16",0,0,0,0,0,0,0,0
"Cuba","2024-03-17",0,0,0,0,0,0,0,0
"Cuba","2024-03-18",0,0,0,0,0,0,0,0
"Cuba","2024-03-19",0,0,0,0,0,0,0,0
"Cuba","2024-03-20",0,0,0,0,0,0,0,0
"Cuba","2024-03-21",0,0,0,0,0,0,0,0
"Cuba","2024-03-22",0,0,0,0,0,0,0,0
"Cuba","2024-03-23",0,0,0,0,0,0,0,0
"Cuba","2024-03-24",0,0,0,0,0,0,0,0
"Cuba","2024-03-25",0,0,0,0,0,0,0,0
"Cuba","2024-03-26",0,0,0,0,0,0,0,0
"Cuba","2024-03-27",0,0,0,0,0,0,0,0
"Cuba","2024-03-28",0,0,0,0,0,0,0,0
"Cuba","2024-03-29",0,0,0,0,0,0,0,0
"Cuba","2024-03-30",0,0,0,0,0,0,0,0
"Cuba","2024-03-31",0,0,0,0,0,0,0,0
"Cuba","2024-04-01",0,0,0,0,0,0,0,0
"Cuba","2024-04-02",0,0,0,0,0,0,0,0
"Cuba","2024-04-03",0,0,0,0,0,0,0,0
"Cuba","2024-04-04",0,0,0,0,0,0,0,0
"Cuba","2024-04-05",0,0,0,0,0,0,0,0
"Cuba","2024-04-06",0,0,0,0,0,0,0,0
"Cuba","2024-04-07",0,0,0,0,0,0,0,0
"Cuba","2024-04-08",0,0,0,0,0,0,0,0
"Cuba","2024-04-09",0,0,0,0,0,0,0,0
"Cuba","2024-04-10",0,0,0,0,0,0,0,0
"Cuba","2024-04-11",0,0,0,0,0,0,0,0
"Cuba","2024-04-12",0,0,0,0,0,0,0,0
"Cuba","2024-04-13",0,0,0,0,0,0,0,0
"Cuba","2024-04-14",0,0,0,0,0,0,0,0
"Cuba","2024-04-15",0,0,0,0,0,0,0,0
"Cuba","2024-04-16",0,0,0,0,0,0,0,0
"Cuba","2024-04-17",0,0,0,0,0,0,0,0
"Cuba","2024-04-18",0,0,0,0,0,0,0,0
"Cuba","2024-04-19",0,0,0,0,0,0,0,0
"Cuba","2024-04-20",0,0,0,0,0,0,0,0
"Cuba","2024-04-21",0,0,0,0,0,0,0,0
"Cuba","2024-04-22",0,0,0,0,0,0,0,0
"Cuba","2024-04-23",0,0,0,0,0,0,0,0
"Cuba","2024-04-24",0,0,0,0,0,0,0,0
"Cuba","2024-04-25",0,0,0,0,0,0,0,0
"Cuba","2024-04-26",0,0,0,0,0,0,0,0
"Cuba","2024-04-27",0,0,0,0,0,0,0,0
"Cuba","2024-04-28",0,0,0,0,0,0,0,0
"Cuba","2024-04-29",0,0,0,0,0,0,0,0
"Cuba","2024-04-30",0,0,0,0,0,0,0,0
"Cuba","2024-05-01",0,0,0,0,0,0,0,0
"Cuba","2024-05-02",0,0,0,0,0,0,0,0
"Cuba","2024-05-03",0,0,0,0,0,0,0,0
"Cuba","2024-05-04",0,0,0,0,0,0,0,0
"Cuba","2024-05-05",0,0,0,0,0,0,0,0
"Cuba","2024-05-06",0,0,0,0,0,0,0,0
"Cuba","2024-05-07",0,0,0,0,0,0,0,0
"Cuba","2024-05-08",0,0,0,0,0,0,0,0
"Cuba","2024-05-09",0,0,0,0,0,0,0,0
"Cuba","2024-05-10",0,0,0,0,0,0,0,0
"Cuba","2024-05-11",0,0,0,0,0,0,0,0
"Cuba","2024-05-12",0,0,0,0,0,0,0,0
"Cuba","2024-05-13",0,0,0,0,0,0,0,0
"Cuba","2024-05-14",0,0,0,0,0,0,0,0
"Cuba","2024-05-15",0,0,0,0,0,0,0,0
"Cuba","2024-05-16",0,0,0,0,0,0,0,0
"Cuba","2024-05-17",0,0,0,0,0,0,0,0
"Cuba","2024-05-18",0,0,0,0,0,0,0,0
"Cuba","2024-05-19",0,0,0,0,0,0,0,0
"Cuba","2024-05-20",0,0,0,0,0,0,0,0
"Cuba","2024-05-21",0,0,0,0,0,0,0,0
"Cuba","2024-05-22",0,0,0,0,0,0,0,0
"Cuba","2024-05-23",0,0,0,0,0,0,0,0
"Cuba","2024-05-24",0,0,0,0,0,0,0,0
"Cuba","2024-05-25",0,0,0,0,0,0,0,0
"Cuba","2024-05-26",0,0,0,0,0,0,0,0
"Cuba","2024-05-27",0,0,0,0,0,0,0,0
"Cuba","2024-05-28",0,0,0,0,0,0,0,0
"Cuba","2024-05-29",0,0,0,0,0,0,0,0
"Cuba","2024-05-30",0,0,0,0,0,0,0,0
"Cuba","2024-05-31",0,0,0,0,0,0,0,0
"Cuba","2024-06-01",0,0,0,0,0,0,0,0
"Cuba","2024-06-02",0,0,0,0,0,0,0,0
"Cuba","2024-06-03",0,0,0,0,0,0,0,0
"Cuba","2024-06-04",0,0,0,0,0,0,0,0
"Cuba","2024-06-05",0,0,0,0,0,0,0,0
"Cuba","2024-06-06",0,0,0,0,0,0,0,0
"Cuba","2024-06-07",0,0,0,0,0,0,0,0
"Cuba","2024-06-08",0,0,0,0,0,0,0,0
"Cuba","2024-06-09",0,0,0,0,0,0,0,0
"Cuba","2024-06-10",0,0,0,0,0,0,0,0
"Cuba","2024-06-11",0,0,0,0,0,0,0,0
"Cuba","2024-06-12",0,0,0,0,0,0,0,0
"Cuba","2024-06-13",0,0,0,0,0,0,0,0
"Cuba","2024-06-14",0,0,0,0,0,0,0,0
"Cuba","2024-06-15",0,0,0,0,0,0,0,0
"Cuba","2024-06-16",0,0,0,0,0,0,0,0
"Cuba","2024-06-17",0,0,0,0,0,0,0,0
"Cuba","2024-06-18",0,0,0,0,0,0,0,0
"Cuba","2024-06-19",0,0,0,0,0,0,0,0
"Cuba","2024-06-20",0,0,0,0,0,0,0,0
"Cuba","2024-06-21",0,0,0,0,0,0,0,0
"Cuba","2024-06-22",0,0,0,0,0,0,0,0
"Cuba","2024-06-23",0,0,0,0,0,0,0,0
"Cuba","2024-06-24",0,0,0,0,0,0,0,0
"Cuba","2024-06-25",0,0,0,0,0,0,0,0
"Cuba","2024-06-26",0,0,0,0,0,0,0,0
"Cuba","2024-06-27",0,0,0,0,0,0,0,0
"Cuba","2024-06-28",0,0,0,0,0,0,0,0
"Cuba","2024-06-29",0,0,0,0,0,0,0,0
"Cuba","2024-06-30",0,0,0,0,0,0,0,0
"Cuba","2024-07-01",0,0,0,0,0,0,0,0
"Cuba","2024-07-02",0,0,0,0,0,0,0,0
"Cuba","2024-07-03",0,0,0,0,0,0,0,0
"Cuba","2024-07-04",0,0,0,0,0,0,0,0
"Cuba","2024-07-05",0,0,0,0,0,0,0,0
"Cuba","2024-07-06",0,0,0,0,0,0,0,0
"Cuba","2024-07-07",0,0,0,0,0,0,0,0
"Cuba","2024-07-08",0,0,0,0,0,0,0,0
"Cuba","2024-07-09",0,0,0,0,0,0,0,0
"Cuba","2024-07-10",0,0,0,0,0,0,0,0
"Cuba","2024-07-11",0,0,0,0,0,0,0,0
"Cuba","2024-07-12",0,0,0,0,0,0,0,0
"Cuba","2024-07-13",0,0,0,0,0,0,0,0
"Cuba","2024-07-14",0,0,0,0,0,0,0,0
"Cuba","2024-07-15",0,0,0,0,0,0,0,0
"Cuba","2024-07-16",0,0,0,0,0,0,0,0
"Cuba","2024-07-17",0,0,0,0,0,0,0,0
"Cuba","2024-07-18",0,0,0,0,0,0,0,0
"Cuba","2024-07-19",0,0,0,0,0,0,0,0
"Cuba","2024-07-20",0,0,0,0,0,0,0,0
"Cuba","2024-07-21",0,0,0,0,0,0,0,0
"Cuba","2024-07-22",0,0,0,0,0,0,0,0
"Cuba","2024-07-23",0,0,0,0,0,0,0,0
"Cuba","2024-07-24",0,0,0,0,0,0,0,0
"Cuba","2024-07-25",0,0,0,0,0,0,0,0
"Cuba","2024-07-26",0,0,0,0,0,0,0,0
"Cuba","2024-07-27",0,0,0,0,0,0,0,0
"Cuba","2024-07-28",0,0,0,0,0,0,0,0
"Cuba","2024-07-29",0,0,0,0,0,0,0,0
"Cuba","2024-07-30",0,0,0,0,0,0,0,0
"Cuba","2024-07-31",0,0,0,0,0,0,0,0
"Cuba","2024-08-01",0,0,0,0,0,0,0,0
"Cuba","2024-08-02",0,0,0,0,0,0,0,0
"Cuba","2024-08-03",0,0,0,0,0,0,0,0
"Cuba","2024-08-04",0,0,0,0,0,0,0,0
"Cuba","2024-08-05",0,0,0,0,0,0,0,0
"Cuba","2024-08-06",0,0,0,0,0,0,0,0
"Cuba","2024-08-07",0,0,0,0,0,0,0,0
"Cuba","2024-08-08",0,0,0,0,0,0,0,0
"Cuba","2024-08-09",0,0,0,0,0,0,0,0
"Cuba","2024-08-10",0,0,0,0,0,0,0,0
"Cuba","2024-08-11",0,0,0,0,0,0,0,0
"Cuba","2024-08-12",0,0,0,0,0,0,0,0
"Cuba","2024-08-13",0,0,0,0,0,0,0,0
"Cuba","2024-08-14",0,0,0,0,0,0,0,0
"Cuba","2024-08-15",0,0,0,0,0,0,0,0
"Cuba","2024-08-16",0,0,0,0,0,0,0,0
"Cuba","2024-08-17",0,0,0,0,0,0,0,0
"Cuba","2024-08-18",0,0,0,0,0,0,0,0
"Cuba","2024-08-19",0,0,0,0,0,0,0,0
"Cuba","2024-08-20",0,0,0,0,0,0,0,0
"Cuba","2024-08-21",0,0,0,0,0,0,0,0
"Cuba","2024-08-22",0,0,0,0,0,0,0,0
"Cuba","2024-08-23",0,0,0,0,0,0,0,0
"Cuba","2024-08-24",0,0,0,0,0,0,0,0
"Cuba","2024-08-25",0,0,0,0,0,0,0,0
"Cuba","2024-08-26",0,0,0,0,0,0,0,0
"Cuba","2024-08-27",0,0,0,0,0,0,0,0
"Cuba","2024-08-28",0,0,0,0,0,0,0,0
"Cuba","2024-08-29",0,0,0,0,0,0,0,0
"Cuba","2024-08-30",0,0,0,0,0,0,0,0
"Cuba","2024-08-31",0,0,0,0,0,0,0,0
"Cuba","2024-09-01",0,0,0,0,0,0,0,0
"Cuba","2024-09-02",0,0,0,0,0,0,0,0
"Cuba","2024-09-03",0,0,0,0,0,0,0,0
"Cuba","2024-09-04",0,0,0,0,0,0,0,0
"Cuba","2024-09-05",0,0,0,0,0,0,0,0
"Cuba","2024-09-06",0,0,0,0,0,0,0,0
"Cuba","2024-09-07",0,0,0,0,0,0,0,0
"Cuba","2024-09-08",0,0,0,0,0,0,0,0
"Cuba","2024-09-09",0,0,0,0,0,0,0,0
"Cuba","2024-09-10",0,0,0,0,0,0,0,0
"Cuba","2024-09-11",0,0,0,0,0,0,0,0
"Cuba","2024-09-12",0,0,0,0,0,0,0,0
"Cuba","2024-09-13",0,0,0,0,0,0,0,0
"Cuba","2024-09-14",0,0,0,0,0,0,0,0
"Cuba","2024-09-15",0,0,0,0,0,0,0,0
"Cuba","2024-09-16",0,0,0,0,0,0,0,0
"Cuba","2024-09-17",0,0,0,0,0,0,0,0
"Cuba","2024-09-18",0,0,0,0,0,0,0,0
"Cuba","2024-09-19",0,0,0,0,0,0,0,0
"Cuba","2024-09-20",0,0,0,0,0,0,0,0
"Cuba","2024-09-21",0,0,0,0,0,0,0,0
"Cuba","2024-09-22",0,0,0,0,0,0,0,0
"Cuba","2024-09-23",0,0,0,0,0,0,0,0
"Cuba","2024-09-24",0,0,0,0,0,0,0,0
"Cuba","2024-09-25",0,0,0,0,0,0,0,0
"Cuba","2024-09-26",0,0,0,0,0,0,0,0
"Cuba","2024-09-27",0,0,0,0,0,0,0,0
"Cuba","2024-09-28",0,0,0,0,0,0,0,0
"Cuba","2024-09-29",0,0,0,0,0,0,0,0
"Cuba","2024-09-30",0,0,0,0,0,0,0,0
"Cuba","2024-10-01",0,0,0,0,0,0,0,0
"Cuba","2024-10-02",0,0,0,0,0,0,0,0
"Cuba","2024-10-03",0,0,0,0,0,0,0,0
"Cuba","2024-10-04",0,0,0,0,0,0,0,0
"Cuba","2024-10-05",0,0,0,0,0,0,0,0
"Cuba","2024-10-06",0,0,0,0,0,0,0,0
"Cuba","2024-10-07",0,0,0,0,0,0,0,0
"Cuba","2024-10-08",0,0,0,0,0,0,0,0
"Cuba","2024-10-09",0,0,0,0,0,0,0,0
"Cuba","2024-10-10",0,0,0,0,0,0,0,0
"Cuba","2024-10-11",0,0,0,0,0,0,0,0
"Cuba","2024-10-12",0,0,0,0,0,0,0,0
"Cuba","2024-10-13",0,0,0,0,0,0,0,0
"Cuba","2024-10-14",0,0,0,0,0,0,0,0
"Cuba","2024-10-15",0,0,0,0,0,0,0,0
"Cuba","2024-10-16",0,0,0,0,0,0,0,0
"Cuba","2024-10-17",0,0,0,0,0,0,0,0
"Cuba","2024-10-18",0,0,0,0,0,0,0,0
"Cuba","2024-10-19",0,0,0,0,0,0,0,0
"Cuba","2024-10-20",0,0,0,0,0,0,0,0
"Cuba","2024-10-21",0,0,0,0,0,0,0,0
"Cuba","2024-10-22",0,0,0,0,0,0,0,0
"Cuba","2024-10-23",0,0,0,0,0,0,0,0
"Cuba","2024-10-24",0,0,0,0,0,0,0,0
"Cuba","2024-10-25",0,0,0,0,0,0,0,0
"Cuba","2024-10-26",0,0,0,0,0,0,0,0
"Cuba","2024-10-27",0,0,0,0,0,0,0,0
"Cuba","2024-10-28",0,0,0,0,0,0,0,0
"Cuba","2024-10-29",0,0,0,0,0,0,0,0
"Cuba","2024-10-30",0,0,0,0,0,0,0,0
"Cuba","2024-10-31",0,0,0,0,0,0,0,0
"Cuba","2024-11-01",0,0,0,0,0,0,0,0
"Cuba","2024-11-02",0,0,0,0,0,0,0,0
"Cuba","2024-11-03",0,0,0,0,0,0,0,0
"Cuba","2024-11-04",0,0,0,0,0,0,0,0
"Cuba","2024-11-05",0,0,0,0,0,0,0,0
"Cuba","2024-11-06",0,0,0,0,0,0,0,0
"Cuba","2024-11-07",0,0,0,0,0,0,0,0
"Cuba","2024-11-08",0,0,0,0,0,0,0,0
"Cuba","2024-11-09",0,0,0,0,0,0,0,0
"Cuba","2024-11-10",0,0,0,0,0,0,0,0
"Cuba","2024-11-11",0,0,0,0,0,0,0,0
"Cuba","2024-11-12",0,0,0,0,0,0,0,0
"Cuba","2024-11-13",0,0,0,0,0,0,0,0
"Cuba","2024-11-14",0,0,0,0,0,0,0,0
"Cuba","2024-11-15",0,0,0,0,0,0,0,0
"Cuba","2024-11-16",0,0,0,0,0,0,0,0
"Cuba","2024-11-17",0,0,0,0,0,0,0,0
"Cuba","2024-11-18",0,0,0,0,0,0,0,0
"Cuba","2024-11-19",0,0,0,0,0,0,0,0
"Cuba","2024-11-20",0,0,0,0,0,0,0,0
"Cuba","2024-11-21",0,0,0,0,0,0,0,0
"Cuba","2024-11-22",0,0,0,0,0,0,0,0
"Cuba","2024-11-23",0,0,0,0,0,0,0,0
"Cuba","2024-11-24",0,0,0,0,0,0,0,0
"Cuba","2024-11-25",0,0,0,0,0,0,0,0
"Cuba","2024-11-26",0,0,0,0,0,0,0,0
"Cuba","2024-11-27",0,0,0,0,0,0,0,0
"Cuba","2024-11-28",0,0,0,0,0,0,0,0
"Cuba","2024-11-29",0,0,0,0,0,0,0,0
"Cuba","2024-11-30",0,0,0,0,0,0,0,0
"Cuba","2024-12-01",0,0,0,0,0,0,0,0
"Cuba","2024-12-02",0,0,0,0,0,0,0,0
"Cuba","2024-12-03",0,0,0,0,0,0,0,0
"Cuba","2024-12-04",0,0,0,0,0,0,0,0
"Cuba","2024-12-05",0,0,0,0,0,0,0,0
"Cuba","2024-12-06",0,0,0,0,0,0,0,0
"Cuba","2024-12-07",0,0,0,0,0,0,0,0
"Cuba","2024-12-08",0,0,0,0,0,0,0,0
"Cuba","2024-12-09",0,0,0,0,0,0,0,0
"Cuba","2024-12-10",0,0,0,0,0,0,0,0
"Cuba","2024-12-11",0,0,0,0,0,0,0,0
"Cuba","2024-12-12",0,0,0,0,0,0,0,0
"Cuba","2024-12-13",0,0,0,0,0,0,0,0
"Cuba","2024-12-14",0,0,0,0,0,0,0,0
"Cuba","2024-12-15",0,0,0,0,0,0,0,0
"Cuba","2024-12-16",0,0,0,0,0,0,0,0
"Cuba","2024-12-17",0,0,0,0,0,0,0,0
"Cuba","2024-12-18",0,0,0,0,0,0,0,0
"Cuba","2024-12-19",0,0,0,0,0,0,0,0
"Cuba","2024-12-20",0,0,0,0,0,0,0,0
"Cuba","2024-12-21",0,0,0,0,0,0,0,0
"Cuba","2024-12-22",0,0,0,0,0,0,0,0
"Cuba","2024-12-23",0,0,0,0,0,0,0,0
"Cuba","2024-12-24",0,0,0,0,0,0,0,0
"Cuba","2024-12-25",0,0,0,0,0,0,0,0
"Cuba","2024-12-26",0,0,0,0,0,0,0,0
"Cuba","2024-12-27",0,0,0,0,0,0,0,0
"Cuba","2024-12-28",0,0,0,0,0,0,0,0
"Cuba","2024-12-29",0,0,0,0,0,0,0,0
"Cuba","2024-12-30",0,0,0,0,0,0,0,0
"Cuba","2024-12-31",0,0,0,0,0,0,0,0
"Cuba","2025-01-01",0,0,0,0,0,0,0,0
"Cuba","2025-01-02",0,0,0,0,0,0,0,0
"Cuba","2025-01-03",0,0,0,0,0,0,0,0
"Cuba","2025-01-04",0,0,0,0,0,0,0,0
"Cuba","2025-01-05",0,0,0,0,0,0,0,0
"Cuba","2025-01-06",0,0,0,0,0,0,0,0
"Cuba","2025-01-07",0,0,0,0,0,0,0,0
"Cuba","2025-01-08",0,0,0,0,0,0,0,0
"Cuba","2025-01-09",0,0,0,0,0,0,0,0
"Cuba","2025-01-10",0,0,0,0,0,0,0,0
"Cuba","2025-01-11",0,0,0,0,0,0,0,0
"Cuba","2025-01-12",0,0,0,0,0,0,0,0
"Cuba","2025-01-13",0,0,0,0,0,0,0,0
"Cuba","2025-01-14",0,0,0,0,0,0,0,0
"Cuba","2025-01-15",0,0,0,0,0,0,0,0
"Cuba","2025-01-16",0,0,0,0,0,0,0,0
"Cuba","2025-01-17",0,0,0,0,0,0,0,0
"Cuba","2025-01-18",0,0,0,0,0,0,0,0
"Cuba","2025-01-19",0,0,0,0,0,0,0,0
"Cuba","2025-01-20",0,0,0,0,0,0,0,0
"Cuba","2025-01-21",0,0,0,0,0,0,0,0
"Cuba","2025-01-22",0,0,0,0,0,0,0,0
"Cuba","2025-01-23",0,0,0,0,0,0,0,0
"Cuba","2025-01-24",0,0,0,0,0,0,0,0
"Cuba","2025-01-25",0,0,0,0,0,0,0,0
"Cuba","2025-01-26",0,0,0,0,0,0,0,0
"Cuba","2025-01-27",0,0,0,0,0,0,0,0
"Cuba","2025-01-28",0,0,0,0,0,0,0,0
"Cuba","2025-01-29",0,0,0,0,0,0,0,0
"Cuba","2025-01-30",0,0,0,0,0,0,0,0
"Cuba","2025-01-31",0,0,0,0,0,0,0,0
"Cuba","2025-02-01",0,0,0,0,0,0,0,0
"Cuba","2025-02-02",0,0,0,0,0,0,0,0
"Cuba","2025-02-03",0,0,0,0,0,0,0,0
"Curaçao","2024-01-01",0,0,0,0,0,0,0,0
"Curaçao","2024-01-02",0,0,0,0,0,0,0,0
"Curaçao","2024-01-03",0,0,0,0,0,0,0,0
"Curaçao","2024-01-04",0,0,0,0,0,0,0,0
"Curaçao","2024-01-05",0,0,0,0,0,0,0,0
"Curaçao","2024-01-06",0,0,0,0,0,0,0,0
"Curaçao","2024-01-07",0,0,0,0,0,0,0,0
"Curaçao","2024-01-08",0,0,0,0,0,0,0,0
"Curaçao","2024-01-09",0,0,0,0,0,0,0,0
"Curaçao","2024-01-10",0,0,0,0,0,0,0,0
"Curaçao","2024-01-11",0,0,0,0,0,0,0,0
"Curaçao","2024-01-12",0,0,0,0,0,0,0,0
"Curaçao","2024-01-13",0,0,0,0,0,0,0,0
"Curaçao","2024-01-14",0,0,0,0,0,0,0,0
"Curaçao","2024-01-15",0,0,0,0,0,0,0,0
"Curaçao","2024-01-16",0,0,0,0,0,0,0,0
"Curaçao","2024-01-17",0,0,0,0,0,0,0,0
"Curaçao","2024-01-18",0,0,0,0,0,0,0,0
"Curaçao","2024-01-19",0,0,0,0,0,0,0,0
"Curaçao","2024-01-20",0,0,0,0,0,0,0,0
"Curaçao","2024-01-21",0,0,0,0,0,0,0,0
"Curaçao","2024-01-22",0,0,0,0,0,0,0,0
"Curaçao","2024-01-23",0,0,0,0,0,0,0,0
"Curaçao","2024-01-24",0,0,0,0,0,0,0,0
"Curaçao","2024-01-25",0,0,0,0,0,0,0,0
"Curaçao","2024-01-26",0,0,0,0,0,0,0,0
"Curaçao","2024-01-27",0,0,0,0,0,0,0,0
"Curaçao","2024-01-28",0,0,0,0,0,0,0,0
"Curaçao","2024-01-29",0,0,0,0,0,0,0,0
"Curaçao","2024-01-30",0,0,0,0,0,0,0,0
"Curaçao","2024-01-31",0,0,0,0,0,0,0,0
"Curaçao","2024-02-01",0,0,0,0,0,0,0,0
"Curaçao","2024-02-02",0,0,0,0,0,0,0,0
"Curaçao","2024-02-03",0,0,0,0,0,0,0,0
"Curaçao","2024-02-04",0,0,0,0,0,0,0,0
"Curaçao","2024-02-05",0,0,0,0,0,0,0,0
"Curaçao","2024-02-06",0,0,0,0,0,0,0,0
"Curaçao","2024-02-07",0,0,0,0,0,0,0,0
"Curaçao","2024-02-08",0,0,0,0,0,0,0,0
"Curaçao","2024-02-09",0,0,0,0,0,0,0,0
"Curaçao","2024-02-10",0,0,0,0,0,0,0,0
"Curaçao","2024-02-11",0,0,0,0,0,0,0,0
"Curaçao","2024-02-12",0,0,0,0,0,0,0,0
"Curaçao","2024-02-13",0,0,0,0,0,0,0,0
"Curaçao","2024-02-14",0,0,0,0,0,0,0,0
"Curaçao","2024-02-15",0,0,0,0,0,0,0,0
"Curaçao","2024-02-16",0,0,0,0,0,0,0,0
"Curaçao","2024-02-17",0,0,0,0,0,0,0,0
"Curaçao","2024-02-18",0,0,0,0,0,0,0,0
"Curaçao","2024-02-19",0,0,0,0,0,0,0,0
"Curaçao","2024-02-20",0,0,0,0,0,0,0,0
"Curaçao","2024-02-21",0,0,0,0,0,0,0,0
"Curaçao","2024-02-22",0,0,0,0,0,0,0,0
"Curaçao","2024-02-23",0,0,0,0,0,0,0,0
"Curaçao","2024-02-24",0,0,0,0,0,0,0,0
"Curaçao","2024-02-25",0,0,0,0,0,0,0,0
"Curaçao","2024-02-26",0,0,0,0,0,0,0,0
"Curaçao","2024-02-27",0,0,0,0,0,0,0,0
"Curaçao","2024-02-28",0,0,0,0,0,0,0,0
"Curaçao","2024-02-29",0,0,0,0,0,0,0,0
"Curaçao","2024-03-01",0,0,0,0,0,0,0,0
"Curaçao","2024-03-02",0,0,0,0,0,0,0,0
"Curaçao","2024-03-03",0,0,0,0,0,0,0,0
"Curaçao","2024-03-04",0,0,0,0,0,0,0,0
"Curaçao","2024-03-05",0,0,0,0,0,0,0,0
"Curaçao","2024-03-06",0,0,0,0,0,0,0,0
"Curaçao","2024-03-07",0,0,0,0,0,0,0,0
"Curaçao","2024-03-08",0,0,0,0,0,0,0,0
"Curaçao","2024-03-09",0,0,0,0,0,0,0,0
"Curaçao","2024-03-10",0,0,0,0,0,0,0,0
"Curaçao","2024-03-11",0,0,0,0,0,0,0,0
"Curaçao","2024-03-12",0,0,0,0,0,0,0,0
"Curaçao","2024-03-13",0,0,0,0,0,0,0,0
"Curaçao","2024-03-14",0,0,0,0,0,0,0,0
"Curaçao","2024-03-15",0,0,0,0,0,0,0,0
"Curaçao","2024-03-16",0,0,0,0,0,0,0,0
"Curaçao","2024-03-17",0,0,0,0,0,0,0,0
"Curaçao","2024-03-18",0,0,0,0,0,0,0,0
"Curaçao","2024-03-19",0,0,0,0,0,0,0,0
"Curaçao","2024-03-20",0,0,0,0,0,0,0,0
"Curaçao","2024-03-21",0,0,0,0,0,0,0,0
"Curaçao","2024-03-22",0,0,0,0,0,0,0,0
"Curaçao","2024-03-23",0,0,0,0,0,0,0,0
"Curaçao","2024-03-24",0,0,0,0,0,0,0,0
"Curaçao","2024-03-25",0,0,0,0,0,0,0,0
"Curaçao","2024-03-26",0,0,0,0,0,0,0,0
"Curaçao","2024-03-27",0,0,0,0,0,0,0,0
"Curaçao","2024-03-28",0,0,0,0,0,0,0,0
"Curaçao","2024-03-29",0,0,0,0,0,0,0,0
"Curaçao","2024-03-30",0,0,0,0,0,0,0,0
"Curaçao","2024-03-31",0,0,0,0,0,0,0,0
"Curaçao","2024-04-01",0,0,0,0,0,0,0,0
"Curaçao","2024-04-02",0,0,0,0,0,0,0,0
"Curaçao","2024-04-03",0,0,0,0,0,0,0,0
"Curaçao","2024-04-04",0,0,0,0,0,0,0,0
"Curaçao","2024-04-05",0,0,0,0,0,0,0,0
"Curaçao","2024-04-06",0,0,0,0,0,0,0,0
"Curaçao","2024-04-07",0,0,0,0,0,0,0,0
"Curaçao","2024-04-08",0,0,0,0,0,0,0,0
"Curaçao","2024-04-09",0,0,0,0,0,0,0,0
"Curaçao","2024-04-10",0,0,0,0,0,0,0,0
"Curaçao","2024-04-11",0,0,0,0,0,0,0,0
"Curaçao","2024-04-12",0,0,0,0,0,0,0,0
"Curaçao","2024-04-13",0,0,0,0,0,0,0,0
"Curaçao","2024-04-14",0,0,0,0,0,0,0,0
"Curaçao","2024-04-15",0,0,0,0,0,0,0,0
"Curaçao","2024-04-16",0,0,0,0,0,0,0,0
"Curaçao","2024-04-17",0,0,0,0,0,0,0,0
"Curaçao","2024-04-18",0,0,0,0,0,0,0,0
"Curaçao","2024-04-19",0,0,0,0,0,0,0,0
"Curaçao","2024-04-20",0,0,0,0,0,0,0,0
"Curaçao","2024-04-21",0,0,0,0,0,0,0,0
"Curaçao","2024-04-22",0,0,0,0,0,0,0,0
"Curaçao","2024-04-23",0,0,0,0,0,0,0,0
"Curaçao","2024-04-24",0,0,0,0,0,0,0,0
"Curaçao","2024-04-25",0,0,0,0,0,0,0,0
"Curaçao","2024-04-26",0,0,0,0,0,0,0,0
"Curaçao","2024-04-27",0,0,0,0,0,0,0,0
"Curaçao","2024-04-28",0,0,0,0,0,0,0,0
"Curaçao","2024-04-29",0,0,0,0,0,0,0,0
"Curaçao","2024-04-30",0,0,0,0,0,0,0,0
"Curaçao","2024-05-01",0,0,0,0,0,0,0,0
"Curaçao","2024-05-02",0,0,0,0,0,0,0,0
"Curaçao","2024-05-03",0,0,0,0,0,0,0,0
"Curaçao","2024-05-04",0,0,0,0,0,0,0,0
"Curaçao","2024-05-05",0,0,0,0,0,0,0,0
"Curaçao","2024-05-06",0,0,0,0,0,0,0,0
"Curaçao","2024-05-07",0,0,0,0,0,0,0,0
"Curaçao","2024-05-08",0,0,0,0,0,0,0,0
"Curaçao","2024-05-09",0,0,0,0,0,0,0,0
"Curaçao","2024-05-10",0,0,0,0,0,0,0,0
"Curaçao","2024-05-11",0,0,0,0,0,0,0,0
"Curaçao","2024-05-12",0,0,0,0,0,0,0,0
"Curaçao","2024-05-13",0,0,0,0,0,0,0,0
"Curaçao","2024-05-14",0,0,0,0,0,0,0,0
"Curaçao","2024-05-15",0,0,0,0,0,0,0,0
"Curaçao","2024-05-16",0,0,0,0,0,0,0,0
"Curaçao","2024-05-17",0,0,0,0,0,0,0,0
"Curaçao","2024-05-18",0,0,0,0,0,0,0,0
"Curaçao","2024-05-19",0,0,0,0,0,0,0,0
"Curaçao","2024-05-20",0,0,0,0,0,0,0,0
"Curaçao","2024-05-21",0,0,0,0,0,0,0,0
"Curaçao","2024-05-22",0,0,0,0,0,0,0,0
"Curaçao","2024-05-23",0,0,0,0,0,0,0,0
"Curaçao","2024-05-24",0,0,0,0,0,0,0,0
"Curaçao","2024-05-25",0,0,0,0,0,0,0,0
"Curaçao","2024-05-26",0,0,0,0,0,0,0,0
"Curaçao","2024-05-27",0,0,0,0,0,0,0,0
"Curaçao","2024-05-28",0,0,0,0,0,0,0,0
"Curaçao","2024-05-29",0,0,0,0,0,0,0,0
"Curaçao","2024-05-30",0,0,0,0,0,0,0,0
"Curaçao","2024-05-31",0,0,0,0,0,0,0,0
"Curaçao","2024-06-01",0,0,0,0,0,0,0,0
"Curaçao","2024-06-02",0,0,0,0,0,0,0,0
"Curaçao","2024-06-03",0,0,0,0,0,0,0,0
"Curaçao","2024-06-04",0,0,0,0,0,0,0,0
"Curaçao","2024-06-05",0,0,0,0,0,0,0,0
"Curaçao","2024-06-06",0,0,0,0,0,0,0,0
"Curaçao","2024-06-07",0,0,0,0,0,0,0,0
"Curaçao","2024-06-08",0,0,0,0,0,0,0,0
"Curaçao","2024-06-09",0,0,0,0,0,0,0,0
"Curaçao","2024-06-10",0,0,0,0,0,0,0,0
"Curaçao","2024-06-11",0,0,0,0,0,0,0,0
"Curaçao","2024-06-12",0,0,0,0,0,0,0,0
"Curaçao","2024-06-13",0,0,0,0,0,0,0,0
"Curaçao","2024-06-14",0,0,0,0,0,0,0,0
"Curaçao","2024-06-15",0,0,0,0,0,0,0,0
"Curaçao","2024-06-16",0,0,0,0,0,0,0,0
"Curaçao","2024-06-17",0,0,0,0,0,0,0,0
"Curaçao","2024-06-18",0,0,0,0,0,0,0,0
"Curaçao","2024-06-19",0,0,0,0,0,0,0,0
"Curaçao","2024-06-20",0,0,0,0,0,0,0,0
"Curaçao","2024-06-21",0,0,0,0,0,0,0,0
"Curaçao","2024-06-22",0,0,0,0,0,0,0,0
"Curaçao","2024-06-23",0,0,0,0,0,0,0,0
"Curaçao","2024-06-24",0,0,0,0,0,0,0,0
"Curaçao","2024-06-25",0,0,0,0,0,0,0,0
"Curaçao","2024-06-26",0,0,0,0,0,0,0,0
"Curaçao","2024-06-27",0,0,0,0,0,0,0,0
"Curaçao","2024-06-28",0,0,0,0,0,0,0,0
"Curaçao","2024-06-29",0,0,0,0,0,0,0,0
"Curaçao","2024-06-30",0,0,0,0,0,0,0,0
"Curaçao","2024-07-01",0,0,0,0,0,0,0,0
"Curaçao","2024-07-02",0,0,0,0,0,0,0,0
"Curaçao","2024-07-03",0,0,0,0,0,0,0,0
"Curaçao","2024-07-04",0,0,0,0,0,0,0,0
"Curaçao","2024-07-05",0,0,0,0,0,0,0,0
"Curaçao","2024-07-06",0,0,0,0,0,0,0,0
"Curaçao","2024-07-07",0,0,0,0,0,0,0,0
"Curaçao","2024-07-08",0,0,0,0,0,0,0,0
"Curaçao","2024-07-09",0,0,0,0,0,0,0,0
"Curaçao","2024-07-10",0,0,0,0,0,0,0,0
"Curaçao","2024-07-11",0,0,0,0,0,0,0,0
"Curaçao","2024-07-12",0,0,0,0,0,0,0,0
"Curaçao","2024-07-13",0,0,0,0,0,0,0,0
"Curaçao","2024-07-14",0,0,0,0,0,0,0,0
"Curaçao","2024-07-15",0,0,0,0,0,0,0,0
"Curaçao","2024-07-16",0,0,0,0,0,0,0,0
"Curaçao","2024-07-17",0,0,0,0,0,0,0,0
"Curaçao","2024-07-18",0,0,0,0,0,0,0,0
"Curaçao","2024-07-19",0,0,0,0,0,0,0,0
"Curaçao","2024-07-20",0,0,0,0,0,0,0,0
"Curaçao","2024-07-21",0,0,0,0,0,0,0,0
"Curaçao","2024-07-22",0,0,0,0,0,0,0,0
"Curaçao","2024-07-23",0,0,0,0,0,0,0,0
"Curaçao","2024-07-24",0,0,0,0,0,0,0,0
"Curaçao","2024-07-25",0,0,0,0,0,0,0,0
"Curaçao","2024-07-26",0,0,0,0,0,0,0,0
"Curaçao","2024-07-27",0,0,0,0,0,0,0,0
"Curaçao","2024-07-28",0,0,0,0,0,0,0,0
"Curaçao","2024-07-29",0,0,0,0,0,0,0,0
"Curaçao","2024-07-30",0,0,0,0,0,0,0,0
"Curaçao","2024-07-31",0,0,0,0,0,0,0,0
"Curaçao","2024-08-01",0,0,0,0,0,0,0,0
"Curaçao","2024-08-02",0,0,0,0,0,0,0,0
"Curaçao","2024-08-03",0,0,0,0,0,0,0,0
"Curaçao","2024-08-04",0,0,0,0,0,0,0,0
"Curaçao","2024-08-05",0,0,0,0,0,0,0,0
"Curaçao","2024-08-06",0,0,0,0,0,0,0,0
"Curaçao","2024-08-07",0,0,0,0,0,0,0,0
"Curaçao","2024-08-08",0,0,0,0,0,0,0,0
"Curaçao","2024-08-09",0,0,0,0,0,0,0,0
"Curaçao","2024-08-10",0,0,0,0,0,0,0,0
"Curaçao","2024-08-11",0,0,0,0,0,0,0,0
"Curaçao","2024-08-12",0,0,0,0,0,0,0,0
"Curaçao","2024-08-13",0,0,0,0,0,0,0,0
"Curaçao","2024-08-14",0,0,0,0,0,0,0,0
"Curaçao","2024-08-15",0,0,0,0,0,0,0,0
"Curaçao","2024-08-16",0,0,0,0,0,0,0,0
"Curaçao","2024-08-17",0,0,0,0,0,0,0,0
"Curaçao","2024-08-18",0,0,0,0,0,0,0,0
"Curaçao","2024-08-19",0,0,0,0,0,0,0,0
"Curaçao","2024-08-20",0,0,0,0,0,0,0,0
"Curaçao","2024-08-21",0,0,0,0,0,0,0,0
"Curaçao","2024-08-22",0,0,0,0,0,0,0,0
"Curaçao","2024-08-23",0,0,0,0,0,0,0,0
"Curaçao","2024-08-24",0,0,0,0,0,0,0,0
"Curaçao","2024-08-25",0,0,0,0,0,0,0,0
"Curaçao","2024-08-26",0,0,0,0,0,0,0,0
"Curaçao","2024-08-27",0,0,0,0,0,0,0,0
"Curaçao","2024-08-28",0,0,0,0,0,0,0,0
"Curaçao","2024-08-29",0,0,0,0,0,0,0,0
"Curaçao","2024-08-30",0,0,0,0,0,0,0,0
"Curaçao","2024-08-31",0,0,0,0,0,0,0,0
"Curaçao","2024-09-01",0,0,0,0,0,0,0,0
"Curaçao","2024-09-02",0,0,0,0,0,0,0,0
"Curaçao","2024-09-03",0,0,0,0,0,0,0,0
"Curaçao","2024-09-04",0,0,0,0,0,0,0,0
"Curaçao","2024-09-05",0,0,0,0,0,0,0,0
"Curaçao","2024-09-06",0,0,0,0,0,0,0,0
"Curaçao","2024-09-07",0,0,0,0,0,0,0,0
"Curaçao","2024-09-08",0,0,0,0,0,0,0,0
"Curaçao","2024-09-09",0,0,0,0,0,0,0,0
"Curaçao","2024-09-10",0,0,0,0,0,0,0,0
"Curaçao","2024-09-11",0,0,0,0,0,0,0,0
"Curaçao","2024-09-12",0,0,0,0,0,0,0,0
"Curaçao","2024-09-13",0,0,0,0,0,0,0,0
"Curaçao","2024-09-14",0,0,0,0,0,0,0,0
"Curaçao","2024-09-15",0,0,0,0,0,0,0,0
"Curaçao","2024-09-16",0,0,0,0,0,0,0,0
"Curaçao","2024-09-17",0,0,0,0,0,0,0,0
"Curaçao","2024-09-18",0,0,0,0,0,0,0,0
"Curaçao","2024-09-19",0,0,0,0,0,0,0,0
"Curaçao","2024-09-20",0,0,0,0,0,0,0,0
"Curaçao","2024-09-21",0,0,0,0,0,0,0,0
"Curaçao","2024-09-22",0,0,0,0,0,0,0,0
"Curaçao","2024-09-23",0,0,0,0,0,0,0,0
"Curaçao","2024-09-24",0,0,0,0,0,0,0,0
"Curaçao","2024-09-25",0,0,0,0,0,0,0,0
"Curaçao","2024-09-26",0,0,0,0,0,0,0,0
"Curaçao","2024-09-27",0,0,0,0,0,0,0,0
"Curaçao","2024-09-28",0,0,0,0,0,0,0,0
"Curaçao","2024-09-29",0,0,0,0,0,0,0,0
"Curaçao","2024-09-30",0,0,0,0,0,0,0,0
"Curaçao","2024-10-01",0,0,0,0,0,0,0,0
"Curaçao","2024-10-02",0,0,0,0,0,0,0,0
"Curaçao","2024-10-03",0,0,0,0,0,0,0,0
"Curaçao","2024-10-04",0,0,0,0,0,0,0,0
"Curaçao","2024-10-05",0,0,0,0,0,0,0,0
"Curaçao","2024-10-06",0,0,0,0,0,0,0,0
"Curaçao","2024-10-07",0,0,0,0,0,0,0,0
"Curaçao","2024-10-08",0,0,0,0,0,0,0,0
"Curaçao","2024-10-09",0,0,0,0,0,0,0,0
"Curaçao","2024-10-10",0,0,0,0,0,0,0,0
"Curaçao","2024-10-11",0,0,0,0,0,0,0,0
"Curaçao","2024-10-12",0,0,0,0,0,0,0,0
"Curaçao","2024-10-13",0,0,0,0,0,0,0,0
"Curaçao","2024-10-14",0,0,0,0,0,0,0,0
"Curaçao","2024-10-15",0,0,0,0,0,0,0,0
"Curaçao","2024-10-16",0,0,0,0,0,0,0,0
"Curaçao","2024-10-17",0,0,0,0,0,0,0,0
"Curaçao","2024-10-18",0,0,0,0,0,0,0,0
"Curaçao","2024-10-19",0,0,0,0,0,0,0,0
"Curaçao","2024-10-20",0,0,0,0,0,0,0,0
"Curaçao","2024-10-21",0,0,0,0,0,0,0,0
"Curaçao","2024-10-22",0,0,0,0,0,0,0,0
"Curaçao","2024-10-23",0,0,0,0,0,0,0,0
"Curaçao","2024-10-24",0,0,0,0,0,0,0,0
"Curaçao","2024-10-25",0,0,0,0,0,0,0,0
"Curaçao","2024-10-26",0,0,0,0,0,0,0,0
"Curaçao","2024-10-27",0,0,0,0,0,0,0,0
"Curaçao","2024-10-28",0,0,0,0,0,0,0,0
"Curaçao","2024-10-29",0,0,0,0,0,0,0,0
"Curaçao","2024-10-30",0,0,0,0,0,0,0,0
"Curaçao","2024-10-31",0,0,0,0,0,0,0,0
"Curaçao","2024-11-01",0,0,0,0,0,0,0,0
"Curaçao","2024-11-02",0,0,0,0,0,0,0,0
"Curaçao","2024-11-03",0,0,0,0,0,0,0,0
"Curaçao","2024-11-04",0,0,0,0,0,0,0,0
"Curaçao","2024-11-05",0,0,0,0,0,0,0,0
"Curaçao","2024-11-06",0,0,0,0,0,0,0,0
"Curaçao","2024-11-07",0,0,0,0,0,0,0,0
"Curaçao","2024-11-08",0,0,0,0,0,0,0,0
"Curaçao","2024-11-09",0,0,0,0,0,0,0,0
"Curaçao","2024-11-10",0,0,0,0,0,0,0,0
"Curaçao","2024-11-11",0,0,0,0,0,0,0,0
"Curaçao","2024-11-12",0,0,0,0,0,0,0,0
"Curaçao","2024-11-13",0,0,0,0,0,0,0,0
"Curaçao","2024-11-14",0,0,0,0,0,0,0,0
"Curaçao","2024-11-15",0,0,0,0,0,0,0,0
"Curaçao","2024-11-16",0,0,0,0,0,0,0,0
"Curaçao","2024-11-17",0,0,0,0,0,0,0,0
"Curaçao","2024-11-18",0,0,0,0,0,0,0,0
"Curaçao","2024-11-19",0,0,0,0,0,0,0,0
"Curaçao","2024-11-20",0,0,0,0,0,0,0,0
"Curaçao","2024-11-21",0,0,0,0,0,0,0,0
"Curaçao","2024-11-22",0,0,0,0,0,0,0,0
"Curaçao","2024-11-23",0,0,0,0,0,0,0,0
"Curaçao","2024-11-24",0,0,0,0,0,0,0,0
"Curaçao","2024-11-25",0,0,0,0,0,0,0,0
"Curaçao","2024-11-26",0,0,0,0,0,0,0,0
"Curaçao","2024-11-27",0,0,0,0,0,0,0,0
"Curaçao","2024-11-28",0,0,0,0,0,0,0,0
"Curaçao","2024-11-29",0,0,0,0,0,0,0,0
"Curaçao","2024-11-30",0,0,0,0,0,0,0,0
"Curaçao","2024-12-01",0,0,0,0,0,0,0,0
"Curaçao","2024-12-02",0,0,0,0,0,0,0,0
"Curaçao","2024-12-03",0,0,0,0,0,0,0,0
"Curaçao","2024-12-04",0,0,0,0,0,0,0,0
"Curaçao","2024-12-05",0,0,0,0,0,0,0,0
"Curaçao","2024-12-06",0,0,0,0,0,0,0,0
"Curaçao","2024-12-07",0,0,0,0,0,0,0,0
"Curaçao","2024-12-08",0,0,0,0,0,0,0,0
"Curaçao","2024-12-09",0,0,0,0,0,0,0,0
"Curaçao","2024-12-10",0,0,0,0,0,0,0,0
"Curaçao","2024-12-11",0,0,0,0,0,0,0,0
"Curaçao","2024-12-12",0,0,0,0,0,0,0,0
"Curaçao","2024-12-13",0,0,0,0,0,0,0,0
"Curaçao","2024-12-14",0,0,0,0,0,0,0,0
"Curaçao","2024-12-15",0,0,0,0,0,0,0,0
"Curaçao","2024-12-16",0,0,0,0,0,0,0,0
"Curaçao","2024-12-17",0,0,0,0,0,0,0,0
"Curaçao","2024-12-18",0,0,0,0,0,0,0,0
"Curaçao","2024-12-19",0,0,0,0,0,0,0,0
"Curaçao","2024-12-20",0,0,0,0,0,0,0,0
"Curaçao","2024-12-21",0,0,0,0,0,0,0,0
"Curaçao","2024-12-22",0,0,0,0,0,0,0,0
"Curaçao","2024-12-23",0,0,0,0,0,0,0,0
"Curaçao","2024-12-24",0,0,0,0,0,0,0,0
"Curaçao","2024-12-25",0,0,0,0,0,0,0,0
"Curaçao","2024-12-26",0,0,0,0,0,0,0,0
"Curaçao","2024-12-27",0,0,0,0,0,0,0,0
"Curaçao","2024-12-28",0,0,0,0,0,0,0,0
"Curaçao","2024-12-29",0,0,0,0,0,0,0,0
"Curaçao","2024-12-30",0,0,0,0,0,0,0,0
"Curaçao","2024-12-31",0,0,0,0,0,0,0,0
"Curaçao","2025-01-01",0,0,0,0,0,0,0,0
"Curaçao","2025-01-02",0,0,0,0,0,0,0,0
"Curaçao","2025-01-03",0,0,0,0,0,0,0,0
"Curaçao","2025-01-04",0,0,0,0,0,0,0,0
"Curaçao","2025-01-05",0,0,0,0,0,0,0,0
"Curaçao","2025-01-06",0,0,0,0,0,0,0,0
"Curaçao","2025-01-07",0,0,0,0,0,0,0,0
"Curaçao","2025-01-08",0,0,0,0,0,0,0,0
"Curaçao","2025-01-09",0,0,0,0,0,0,0,0
"Curaçao","2025-01-10",0,0,0,0,0,0,0,0
"Curaçao","2025-01-11",0,0,0,0,0,0,0,0
"Curaçao","2025-01-12",0,0,0,0,0,0,0,0
"Curaçao","2025-01-13",0,0,0,0,0,0,0,0
"Curaçao","2025-01-14",0,0,0,0,0,0,0,0
"Curaçao","2025-01-15",0,0,0,0,0,0,0,0
"Curaçao","2025-01-16",0,0,0,0,0,0,0,0
"Curaçao","2025-01-17",0,0,0,0,0,0,0,0
"Curaçao","2025-01-18",0,0,0,0,0,0,0,0
"Curaçao","2025-01-19",0,0,0,0,0,0,0,0
"Curaçao","2025-01-20",0,0,0,0,0,0,0,0
"Curaçao","2025-01-21",0,0,0,0,0,0,0,0
"Curaçao","2025-01-22",0,0,0,0,0,0,0,0
"Curaçao","2025-01-23",0,0,0,0,0,0,0,0
"Curaçao","2025-01-24",0,0,0,0,0,0,0,0
"Curaçao","2025-01-25",0,0,0,0,0,0,0,0
"Curaçao","2025-01-26",0,0,0,0,0,0,0,0
"Curaçao","2025-01-27",0,0,0,0,0,0,0,0
"Curaçao","2025-01-28",0,0,0,0,0,0,0,0
"Curaçao","2025-01-29",0,0,0,0,0,0,0,0
"Curaçao","2025-01-30",0,0,0,0,0,0,0,0
"Curaçao","2025-01-31",0,0,0,0,0,0,0,0
"Curaçao","2025-02-01",0,0,0,0,0,0,0,0
"Curaçao","2025-02-02",0,0,0,0,0,0,0,0
"Curaçao","2025-02-03",0,0,0,0,0,0,0,0
"Cyprus","2024-01-01",0,0,0,0,0,0,0,0
"Cyprus","2024-01-02",0,0,0,0,0,0,0,0
"Cyprus","2024-01-03",0,0,0,0,0,0,0,0
"Cyprus","2024-01-04",0,0,0,0,0,0,0,0
"Cyprus","2024-01-05",0,0,0,0,0,0,0,0
"Cyprus","2024-01-06",0,0,0,0,0,0,0,0
"Cyprus","2024-01-07",0,0,0,0,0,0,0,0
"Cyprus","2024-01-08",0,0,0,0,0,0,0,0
"Cyprus","2024-01-09",0,0,0,0,0,0,0,0
"Cyprus","2024-01-10",0,0,0,0,0,0,0,0
"Cyprus","2024-01-11",0,0,0,0,0,0,0,0
"Cyprus","2024-01-12",0,0,0,0,0,0,0,0
"Cyprus","2024-01-13",0,0,0,0,0,0,0,0
"Cyprus","2024-01-14",0,0,0,0,0,0,0,0
"Cyprus","2024-01-15",0,0,0,0,0,0,0,0
"Cyprus","2024-01-16",0,0,0,0,0,0,0,0
"Cyprus","2024-01-17",0,0,0,0,0,0,0,0
"Cyprus","2024-01-18",0,0,0,0,0,0,0,0
"Cyprus","2024-01-19",0,0,0,0,0,0,0,0
"Cyprus","2024-01-20",0,0,0,0,0,0,0,0
"Cyprus","2024-01-21",0,0,0,0,0,0,0,0
"Cyprus","2024-01-22",0,0,0,0,0,0,0,0
"Cyprus","2024-01-23",0,0,0,0,0,0,0,0
"Cyprus","2024-01-24",0,0,0,0,0,0,0,0
"Cyprus","2024-01-25",0,0,0,0,0,0,0,0
"Cyprus","2024-01-26",0,0,0,0,0,0,0,0
"Cyprus","2024-01-27",0,0,0,0,0,0,0,0
"Cyprus","2024-01-28",0,0,0,0,0,0,0,0
"Cyprus","2024-01-29",0,0,0,0,0,0,0,0
"Cyprus","2024-01-30",0,0,0,0,0,0,0,0
"Cyprus","2024-01-31",0,0,0,0,0,0,0,0
"Cyprus","2024-02-01",0,0,0,0,0,0,0,0
"Cyprus","2024-02-02",0,0,0,0,0,0,0,0
"Cyprus","2024-02-03",0,0,0,0,0,0,0,0
"Cyprus","2024-02-04",0,0,0,0,0,0,0,0
"Cyprus","2024-02-05",0,0,0,0,0,0,0,0
"Cyprus","2024-02-06",0,0,0,0,0,0,0,0
"Cyprus","2024-02-07",0,0,0,0,0,0,0,0
"Cyprus","2024-02-08",0,0,0,0,0,0,0,0
"Cyprus","2024-02-09",0,0,0,0,0,0,0,0
"Cyprus","2024-02-10",0,0,0,0,0,0,0,0
"Cyprus","2024-02-11",0,0,0,0,0,0,0,0
"Cyprus","2024-02-12",0,0,0,0,0,0,0,0
"Cyprus","2024-02-13",0,0,0,0,0,0,0,0
"Cyprus","2024-02-14",0,0,0,0,0,0,0,0
"Cyprus","2024-02-15",0,0,0,0,0,0,0,0
"Cyprus","2024-02-16",0,0,0,0,0,0,0,0
"Cyprus","2024-02-17",0,0,0,0,0,0,0,0
"Cyprus","2024-02-18",0,0,0,0,0,0,0,0
"Cyprus","2024-02-19",0,0,0,0,0,0,0,0
"Cyprus","2024-02-20",0,0,0,0,0,0,0,0
"Cyprus","2024-02-21",0,0,0,0,0,0,0,0
"Cyprus","2024-02-22",0,0,0,0,0,0,0,0
"Cyprus","2024-02-23",0,0,0,0,0,0,0,0
"Cyprus","2024-02-24",0,0,0,0,0,0,0,0
"Cyprus","2024-02-25",0,0,0,0,0,0,0,0
"Cyprus","2024-02-26",0,0,0,0,0,0,0,0
"Cyprus","2024-02-27",0,0,0,0,0,0,0,0
"Cyprus","2024-02-28",0,0,0,0,0,0,0,0
"Cyprus","2024-02-29",0,0,0,0,0,0,0,0
"Cyprus","2024-03-01",0,0,0,0,0,0,0,0
"Cyprus","2024-03-02",0,0,0,0,0,0,0,0
"Cyprus","2024-03-03",0,0,0,0,0,0,0,0
"Cyprus","2024-03-04",0,0,0,0,0,0,0,0
"Cyprus","2024-03-05",0,0,0,0,0,0,0,0
"Cyprus","2024-03-06",0,0,0,0,0,0,0,0
"Cyprus","2024-03-07",0,0,0,0,0,0,0,0
"Cyprus","2024-03-08",0,0,0,0,0,0,0,0
"Cyprus","2024-03-09",0,0,0,0,0,0,0,0
"Cyprus","2024-03-10",0,0,0,0,0,0,0,0
"Cyprus","2024-03-11",0,0,0,0,0,0,0,0
"Cyprus","2024-03-12",0,0,0,0,0,0,0,0
"Cyprus","2024-03-13",0,0,0,0,0,0,0,0
"Cyprus","2024-03-14",0,0,0,0,0,0,0,0
"Cyprus","2024-03-15",0,0,0,0,0,0,0,0
"Cyprus","2024-03-16",0,0,0,0,0,0,0,0
"Cyprus","2024-03-17",0,0,0,0,0,0,0,0
"Cyprus","2024-03-18",0,0,0,0,0,0,0,0
"Cyprus","2024-03-19",0,0,0,0,0,0,0,0
"Cyprus","2024-03-20",0,0,0,0,0,0,0,0
"Cyprus","2024-03-21",0,0,0,0,0,0,0,0
"Cyprus","2024-03-22",0,0,0,0,0,0,0,0
"Cyprus","2024-03-23",0,0,0,0,0,0,0,0
"Cyprus","2024-03-24",0,0,0,0,0,0,0,0
"Cyprus","2024-03-25",0,0,0,0,0,0,0,0
"Cyprus","2024-03-26",0,0,0,0,0,0,0,0
"Cyprus","2024-03-27",0,0,0,0,0,0,0,0
"Cyprus","2024-03-28",0,0,0,0,0,0,0,0
"Cyprus","2024-03-29",0,0,0,0,0,0,0,0
"Cyprus","2024-03-30",0,0,0,0,0,0,0,0
"Cyprus","2024-03-31",0,0,0,0,0,0,0,0
"Cyprus","2024-04-01",0,0,0,0,0,0,0,0
"Cyprus","2024-04-02",0,0,0,0,0,0,0,0
"Cyprus","2024-04-03",0,0,0,0,0,0,0,0
"Cyprus","2024-04-04",0,0,0,0,0,0,0,0
"Cyprus","2024-04-05",0,0,0,0,0,0,0,0
"Cyprus","2024-04-06",0,0,0,0,0,0,0,0
"Cyprus","2024-04-07",0,0,0,0,0,0,0,0
"Cyprus","2024-04-08",0,0,0,0,0,0,0,0
"Cyprus","2024-04-09",0,0,0,0,0,0,0,0
"Cyprus","2024-04-10",0,0,0,0,0,0,0,0
"Cyprus","2024-04-11",0,0,0,0,0,0,0,0
"Cyprus","2024-04-12",0,0,0,0,0,0,0,0
"Cyprus","2024-04-13",0,0,0,0,0,0,0,0
"Cyprus","2024-04-14",0,0,0,0,0,0,0,0
"Cyprus","2024-04-15",0,0,0,0,0,0,0,0
"Cyprus","2024-04-16",0,0,0,0,0,0,0,0
"Cyprus","2024-04-17",0,0,0,0,0,0,0,0
"Cyprus","2024-04-18",0,0,0,0,0,0,0,0
"Cyprus","2024-04-19",0,0,0,0,0,0,0,0
"Cyprus","2024-04-20",0,0,0,0,0,0,0,0
"Cyprus","2024-04-21",0,0,0,0,0,0,0,0
"Cyprus","2024-04-22",0,0,0,0,0,0,0,0
"Cyprus","2024-04-23",0,0,0,0,0,0,0,0
"Cyprus","2024-04-24",0,0,0,0,0,0,0,0
"Cyprus","2024-04-25",0,0,0,0,0,0,0,0
"Cyprus","2024-04-26",0,0,0,0,0,0,0,0
"Cyprus","2024-04-27",0,0,0,0,0,0,0,0
"Cyprus","2024-04-28",0,0,0,0,0,0,0,0
"Cyprus","2024-04-29",0,0,0,0,0,0,0,0
"Cyprus","2024-04-30",0,0,0,0,0,0,0,0
"Cyprus","2024-05-01",0,0,0,0,0,0,0,0
"Cyprus","2024-05-02",0,0,0,0,0,0,0,0
"Cyprus","2024-05-03",0,0,0,0,0,0,0,0
"Cyprus","2024-05-04",0,0,0,0,0,0,0,0
"Cyprus","2024-05-05",0,0,0,0,0,0,0,0
"Cyprus","2024-05-06",0,0,0,0,0,0,0,0
"Cyprus","2024-05-07",0,0,0,0,0,0,0,0
"Cyprus","2024-05-08",0,0,0,0,0,0,0,0
"Cyprus","2024-05-09",0,0,0,0,0,0,0,0
"Cyprus","2024-05-10",0,0,0,0,0,0,0,0
"Cyprus","2024-05-11",0,0,0,0,0,0,0,0
"Cyprus","2024-05-12",0,0,0,0,0,0,0,0
"Cyprus","2024-05-13",0,0,0,0,0,0,0,0
"Cyprus","2024-05-14",0,0,0,0,0,0,0,0
"Cyprus","2024-05-15",0,0,0,0,0,0,0,0
"Cyprus","2024-05-16",0,0,0,0,0,0,0,0
"Cyprus","2024-05-17",0,0,0,0,0,0,0,0
"Cyprus","2024-05-18",0,0,0,0,0,0,0,0
"Cyprus","2024-05-19",0,0,0,0,0,0,0,0
"Cyprus","2024-05-20",0,0,0,0,0,0,0,0
"Cyprus","2024-05-21",0,0,0,0,0,0,0,0
"Cyprus","2024-05-22",0,0,0,0,0,0,0,0
"Cyprus","2024-05-23",0,0,0,0,0,0,0,0
"Cyprus","2024-05-24",0,0,0,0,0,0,0,0
"Cyprus","2024-05-25",0,0,0,0,0,0,0,0
"Cyprus","2024-05-26",0,0,0,0,0,0,0,0
"Cyprus","2024-05-27",0,0,0,0,0,0,0,0
"Cyprus","2024-05-28",0,0,0,0,0,0,0,0
"Cyprus","2024-05-29",0,0,0,0,0,0,0,0
"Cyprus","2024-05-30",0,0,0,0,0,0,0,0
"Cyprus","2024-05-31",0,0,0,0,0,0,0,0
"Cyprus","2024-06-01",0,0,0,0,0,0,0,0
"Cyprus","2024-06-02",0,0,0,0,0,0,0,0
"Cyprus","2024-06-03",0,0,0,0,0,0,0,0
"Cyprus","2024-06-04",0,0,0,0,0,0,0,0
"Cyprus","2024-06-05",0,0,0,0,0,0,0,0
"Cyprus","2024-06-06",0,0,0,0,0,0,0,0
"Cyprus","2024-06-07",0,0,0,0,0,0,0,0
"Cyprus","2024-06-08",0,0,0,0,0,0,0,0
"Cyprus","2024-06-09",0,0,0,0,0,0,0,0
"Cyprus","2024-06-10",0,0,0,0,0,0,0,0
"Cyprus","2024-06-11",0,0,0,0,0,0,0,0
"Cyprus","2024-06-12",0,0,0,0,0,0,0,0
"Cyprus","2024-06-13",0,0,0,0,0,0,0,0
"Cyprus","2024-06-14",0,0,0,0,0,0,0,0
"Cyprus","2024-06-15",0,0,0,0,0,0,0,0
"Cyprus","2024-06-16",0,0,0,0,0,0,0,0
"Cyprus","2024-06-17",0,0,0,0,0,0,0,0
"Cyprus","2024-06-18",0,0,0,0,0,0,0,0
"Cyprus","2024-06-19",0,0,0,0,0,0,0,0
"Cyprus","2024-06-20",0,0,0,0,0,0,0,0
"Cyprus","2024-06-21",0,0,0,0,0,0,0,0
"Cyprus","2024-06-22",0,0,0,0,0,0,0,0
"Cyprus","2024-06-23",0,0,0,0,0,0,0,0
"Cyprus","2024-06-24",0,0,0,0,0,0,0,0
"Cyprus","2024-06-25",0,0,0,0,0,0,0,0
"Cyprus","2024-06-26",0,0,0,0,0,0,0,0
"Cyprus","2024-06-27",0,0,0,0,0,0,0,0
"Cyprus","2024-06-28",0,0,0,0,0,0,0,0
"Cyprus","2024-06-29",0,0,0,0,0,0,0,0
"Cyprus","2024-06-30",0,0,0,0,0,0,0,0
"Cyprus","2024-07-01",0,0,0,0,0,0,0,0
"Cyprus","2024-07-02",0,0,0,0,0,0,0,0
"Cyprus","2024-07-03",0,0,0,0,0,0,0,0
"Cyprus","2024-07-04",0,0,0,0,0,0,0,0
"Cyprus","2024-07-05",0,0,0,0,0,0,0,0
"Cyprus","2024-07-06",0,0,0,0,0,0,0,0
"Cyprus","2024-07-07",0,0,0,0,0,0,0,0
"Cyprus","2024-07-08",0,0,0,0,0,0,0,0
"Cyprus","2024-07-09",0,0,0,0,0,0,0,0
"Cyprus","2024-07-10",0,0,0,0,0,0,0,0
"Cyprus","2024-07-11",0,0,0,0,0,0,0,0
"Cyprus","2024-07-12",0,0,0,0,0,0,0,0
"Cyprus","2024-07-13",0,0,0,0,0,0,0,0
"Cyprus","2024-07-14",0,0,0,0,0,0,0,0
"Cyprus","2024-07-15",0,0,0,0,0,0,0,0
"Cyprus","2024-07-16",0,0,0,0,0,0,0,0
"Cyprus","2024-07-17",0,0,0,0,0,0,0,0
"Cyprus","2024-07-18",0,0,0,0,0,0,0,0
"Cyprus","2024-07-19",0,0,0,0,0,0,0,0
"Cyprus","2024-07-20",0,0,0,0,0,0,0,0
"Cyprus","2024-07-21",0,0,0,0,0,0,0,0
"Cyprus","2024-07-22",0,0,0,0,0,0,0,0
"Cyprus","2024-07-23",0,0,0,0,0,0,0,0
"Cyprus","2024-07-24",0,0,0,0,0,0,0,0
"Cyprus","2024-07-25",0,0,0,0,0,0,0,0
"Cyprus","2024-07-26",0,0,0,0,0,0,0,0
"Cyprus","2024-07-27",0,0,0,0,0,0,0,0
"Cyprus","2024-07-28",0,0,0,0,0,0,0,0
"Cyprus","2024-07-29",0,0,0,0,0,0,0,0
"Cyprus","2024-07-30",0,0,0,0,0,0,0,0
"Cyprus","2024-07-31",0,0,0,0,0,0,0,0
"Cyprus","2024-08-01",0,0,0,0,0,0,0,0
"Cyprus","2024-08-02",0,0,0,0,0,0,0,0
"Cyprus","2024-08-03",0,0,0,0,0,0,0,0
"Cyprus","2024-08-04",0,0,0,0,0,0,0,0
"Cyprus","2024-08-05",0,0,0,0,0,0,0,0
"Cyprus","2024-08-06",0,0,0,0,0,0,0,0
"Cyprus","2024-08-07",0,0,0,0,0,0,0,0
"Cyprus","2024-08-08",0,0,0,0,0,0,0,0
"Cyprus","2024-08-09",0,0,0,0,0,0,0,0
"Cyprus","2024-08-10",0,0,0,0,0,0,0,0
"Cyprus","2024-08-11",0,0,0,0,0,0,0,0
"Cyprus","2024-08-12",0,0,0,0,0,0,0,0
"Cyprus","2024-08-13",0,0,0,0,0,0,0,0
"Cyprus","2024-08-14",0,0,0,0,0,0,0,0
"Cyprus","2024-08-15",0,0,0,0,0,0,0,0
"Cyprus","2024-08-16",0,0,0,0,0,0,0,0
"Cyprus","2024-08-17",0,0,0,0,0,0,0,0
"Cyprus","2024-08-18",0,0,0,0,0,0,0,0
"Cyprus","2024-08-19",0,0,0,0,0,0,0,0
"Cyprus","2024-08-20",0,0,0,0,0,0,0,0
"Cyprus","2024-08-21",0,0,0,0,0,0,0,0
"Cyprus","2024-08-22",0,0,0,0,0,0,0,0
"Cyprus","2024-08-23",0,0,0,0,0,0,0,0
"Cyprus","2024-08-24",0,0,0,0,0,0,0,0
"Cyprus","2024-08-25",0,0,0,0,0,0,0,0
"Cyprus","2024-08-26",0,0,0,0,0,0,0,0
"Cyprus","2024-08-27",0,0,0,0,0,0,0,0
"Cyprus","2024-08-28",0,0,0,0,0,0,0,0
"Cyprus","2024-08-29",0,0,0,0,0,0,0,0
"Cyprus","2024-08-30",0,0,0,0,0,0,0,0
"Cyprus","2024-08-31",0,0,0,0,0,0,0,0
"Cyprus","2024-09-01",0,0,0,0,0,0,0,0
"Cyprus","2024-09-02",0,0,0,0,0,0,0,0
"Cyprus","2024-09-03",0,0,0,0,0,0,0,0
"Cyprus","2024-09-04",0,0,0,0,0,0,0,0
"Cyprus","2024-09-05",0,0,0,0,0,0,0,0
"Cyprus","2024-09-06",0,0,0,0,0,0,0,0
"Cyprus","2024-09-07",0,0,0,0,0,0,0,0
"Cyprus","2024-09-08",0,0,0,0,0,0,0,0
"Cyprus","2024-09-09",0,0,0,0,0,0,0,0
"Cyprus","2024-09-10",0,0,0,0,0,0,0,0
"Cyprus","2024-09-11",0,0,0,0,0,0,0,0
"Cyprus","2024-09-12",0,0,0,0,0,0,0,0
"Cyprus","2024-09-13",0,0,0,0,0,0,0,0
"Cyprus","2024-09-14",0,0,0,0,0,0,0,0
"Cyprus","2024-09-15",0,0,0,0,0,0,0,0
"Cyprus","2024-09-16",0,0,0,0,0,0,0,0
"Cyprus","2024-09-17",0,0,0,0,0,0,0,0
"Cyprus","2024-09-18",0,0,0,0,0,0,0,0
"Cyprus","2024-09-19",0,0,0,0,0,0,0,0
"Cyprus","2024-09-20",0,0,0,0,0,0,0,0
"Cyprus","2024-09-21",0,0,0,0,0,0,0,0
"Cyprus","2024-09-22",0,0,0,0,0,0,0,0
"Cyprus","2024-09-23",0,0,0,0,0,0,0,0
"Cyprus","2024-09-24",0,0,0,0,0,0,0,0
"Cyprus","2024-09-25",0,0,0,0,0,0,0,0
"Cyprus","2024-09-26",0,0,0,0,0,0,0,0
"Cyprus","2024-09-27",0,0,0,0,0,0,0,0
"Cyprus","2024-09-28",0,0,0,0,0,0,0,0
"Cyprus","2024-09-29",0,0,0,0,0,0,0,0
"Cyprus","2024-09-30",0,0,0,0,0,0,0,0
"Cyprus","2024-10-01",0,0,0,0,0,0,0,0
"Cyprus","2024-10-02",0,0,0,0,0,0,0,0
"Cyprus","2024-10-03",0,0,0,0,0,0,0,0
"Cyprus","2024-10-04",0,0,0,0,0,0,0,0
"Cyprus","2024-10-05",0,0,0,0,0,0,0,0
"Cyprus","2024-10-06",0,0,0,0,0,0,0,0
"Cyprus","2024-10-07",0,0,0,0,0,0,0,0
"Cyprus","2024-10-08",0,0,0,0,0,0,0,0
"Cyprus","2024-10-09",0,0,0,0,0,0,0,0
"Cyprus","2024-10-10",0,0,0,0,0,0,0,0
"Cyprus","2024-10-11",0,0,0,0,0,0,0,0
"Cyprus","2024-10-12",0,0,0,0,0,0,0,0
"Cyprus","2024-10-13",0,0,0,0,0,0,0,0
"Cyprus","2024-10-14",0,0,0,0,0,0,0,0
"Cyprus","2024-10-15",0,0,0,0,0,0,0,0
"Cyprus","2024-10-16",0,0,0,0,0,0,0,0
"Cyprus","2024-10-17",0,0,0,0,0,0,0,0
"Cyprus","2024-10-18",0,0,0,0,0,0,0,0
"Cyprus","2024-10-19",0,0,0,0,0,0,0,0
"Cyprus","2024-10-20",0,0,0,0,0,0,0,0
"Cyprus","2024-10-21",0,0,0,0,0,0,0,0
"Cyprus","2024-10-22",0,0,0,0,0,0,0,0
"Cyprus","2024-10-23",0,0,0,0,0,0,0,0
"Cyprus","2024-10-24",0,0,0,0,0,0,0,0
"Cyprus","2024-10-25",0,0,0,0,0,0,0,0
"Cyprus","2024-10-26",0,0,0,0,0,0,0,0
"Cyprus","2024-10-27",0,0,0,0,0,0,0,0
"Cyprus","2024-10-28",0,0,0,0,0,0,0,0
"Cyprus","2024-10-29",0,0,0,0,0,0,0,0
"Cyprus","2024-10-30",0,0,0,0,0,0,0,0
"Cyprus","2024-10-31",0,0,0,0,0,0,0,0
"Cyprus","2024-11-01",0,0,0,0,0,0,0,0
"Cyprus","2024-11-02",0,0,0,0,0,0,0,0
"Cyprus","2024-11-03",0,0,0,0,0,0,0,0
"Cyprus","2024-11-04",0,0,0,0,0,0,0,0
"Cyprus","2024-11-05",0,0,0,0,0,0,0,0
"Cyprus","2024-11-06",0,0,0,0,0,0,0,0
"Cyprus","2024-11-07",0,0,0,0,0,0,0,0
"Cyprus","2024-11-08",0,0,0,0,0,0,0,0
"Cyprus","2024-11-09",0,0,0,0,0,0,0,0
"Cyprus","2024-11-10",0,0,0,0,0,0,0,0
"Cyprus","2024-11-11",0,0,0,0,0,0,0,0
"Cyprus","2024-11-12",0,0,0,0,0,0,0,0
"Cyprus","2024-11-13",0,0,0,0,0,0,0,0
"Cyprus","2024-11-14",0,0,0,0,0,0,0,0
"Cyprus","2024-11-15",0,0,0,0,0,0,0,0
"Cyprus","2024-11-16",0,0,0,0,0,0,0,0
"Cyprus","2024-11-17",0,0,0,0,0,0,0,0
"Cyprus","2024-11-18",0,0,0,0,0,0,0,0
"Cyprus","2024-11-19",0,0,0,0,0,0,0,0
"Cyprus","2024-11-20",0,0,0,0,0,0,0,0
"Cyprus","2024-11-21",0,0,0,0,0,0,0,0
"Cyprus","2024-11-22",0,0,0,0,0,0,0,0
"Cyprus","2024-11-23",0,0,0,0,0,0,0,0
"Cyprus","2024-11-24",0,0,0,0,0,0,0,0
"Cyprus","2024-11-25",0,0,0,0,0,0,0,0
"Cyprus","2024-11-26",0,0,0,0,0,0,0,0
"Cyprus","2024-11-27",0,0,0,0,0,0,0,0
"Cyprus","2024-11-28",0,0,0,0,0,0,0,0
"Cyprus","2024-11-29",0,0,0,0,0,0,0,0
"Cyprus","2024-11-30",0,0,0,0,0,0,0,0
"Cyprus","2024-12-01",0,0,0,0,0,0,0,0
"Cyprus","2024-12-02",0,0,0,0,0,0,0,0
"Cyprus","2024-12-03",0,0,0,0,0,0,0,0
"Cyprus","2024-12-04",0,0,0,0,0,0,0,0
"Cyprus","2024-12-05",0,0,0,0,0,0,0,0
"Cyprus","2024-12-06",0,0,0,0,0,0,0,0
"Cyprus","2024-12-07",0,0,0,0,0,0,0,0
"Cyprus","2024-12-08",0,0,0,0,0,0,0,0
"Cyprus","2024-12-09",0,0,0,0,0,0,0,0
"Cyprus","2024-12-10",0,0,0,0,0,0,0,0
"Cyprus","2024-12-11",0,0,0,0,0,0,0,0
"Cyprus","2024-12-12",0,0,0,0,0,0,0,0
"Cyprus","2024-12-13",0,0,0,0,0,0,0,0
"Cyprus","2024-12-14",0,0,0,0,0,0,0,0
"Cyprus","2024-12-15",0,0,0,0,0,0,0,0
"Cyprus","2024-12-16",0,0,0,0,0,0,0,0
"Cyprus","2024-12-17",0,0,0,0,0,0,0,0
"Cyprus","2024-12-18",0,0,0,0,0,0,0,0
"Cyprus","2024-12-19",0,0,0,0,0,0,0,0
"Cyprus","2024-12-20",0,0,0,0,0,0,0,0
"Cyprus","2024-12-21",0,0,0,0,0,0,0,0
"Cyprus","2024-12-22",0,0,0,0,0,0,0,0
"Cyprus","2024-12-23",0,0,0,0,0,0,0,0
"Cyprus","2024-12-24",0,0,0,0,0,0,0,0
"Cyprus","2024-12-25",0,0,0,0,0,0,0,0
"Cyprus","2024-12-26",0,0,0,0,0,0,0,0
"Cyprus","2024-12-27",0,0,0,0,0,0,0,0
"Cyprus","2024-12-28",0,0,0,0,0,0,0,0
"Cyprus","2024-12-29",0,0,0,0,0,0,0,0
"Cyprus","2024-12-30",0,0,0,0,0,0,0,0
"Cyprus","2024-12-31",0,1,1,0,1,1,0,0
"Cyprus","2025-01-01",0,0,1,0,0,1,0,0
"Cyprus","2025-01-02",0,0,1,0,0,1,0,0
"Cyprus","2025-01-03",0,0,1,0,0,1,0,0
"Cyprus","2025-01-04",0,0,1,0,0,1,0,0
"Cyprus","2025-01-05",0,0,1,0,0,1,0,0
"Cyprus","2025-01-06",0,0,1,0,0,1,0,0
"Cyprus","2025-01-07",0,0,1,0,0,1,0,0
"Cyprus","2025-01-08",0,0,1,0,0,1,0,0
"Cyprus","2025-01-09",0,0,1,0,0,1,0,0
"Cyprus","2025-01-10",0,0,1,0,0,1,0,0
"Cyprus","2025-01-11",0,0,1,0,0,1,0,0
"Cyprus","2025-01-12",0,0,1,0,0,1,0,0
"Cyprus","2025-01-13",0,0,1,0,0,1,0,0
"Cyprus","2025-01-14",0,0,1,0,0,1,0,0
"Cyprus","2025-01-15",0,0,1,0,0,1,0,0
"Cyprus","2025-01-16",0,0,1,0,0,1,0,0
"Cyprus","2025-01-17",0,0,1,0,0,1,0,0
"Cyprus","2025-01-18",0,0,1,0,0,1,0,0
"Cyprus","2025-01-19",0,0,1,0,0,1,0,0
"Cyprus","2025-01-20",0,0,1,0,0,1,0,0
"Cyprus","2025-01-21",0,0,1,0,0,1,0,0
"Cyprus","2025-01-22",0,0,1,0,0,1,0,0
"Cyprus","2025-01-23",0,0,1,0,0,1,0,0
"Cyprus","2025-01-24",0,0,1,0,0,1,0,0
"Cyprus","2025-01-25",0,0,1,0,0,1,0,0
"Cyprus","2025-01-26",0,0,1,0,0,1,0,0
"Cyprus","2025-01-27",0,0,1,0,0,1,0,0
"Cyprus","2025-01-28",0,0,1,0,0,1,0,0
"Cyprus","2025-01-29",0,0,1,0,0,1,0,0
"Cyprus","2025-01-30",0,0,1,0,0,1,0,0
"Cyprus","2025-01-31",0,0,1,0,0,1,0,0
"Cyprus","2025-02-01",0,0,1,0,0,1,0,0
"Cyprus","2025-02-02",0,0,1,0,0,1,0,0
"Cyprus","2025-02-03",0,0,1,0,0,1,0,0
"Czechia","2024-01-01",0,0,0,0,0,0,0,0
"Czechia","2024-01-02",0,0,0,0,0,0,0,0
"Czechia","2024-01-03",0,0,0,0,0,0,0,0
"Czechia","2024-01-04",0,0,0,0,0,0,0,0
"Czechia","2024-01-05",0,0,0,0,0,0,0,0
"Czechia","2024-01-06",0,0,0,0,0,0,0,0
"Czechia","2024-01-07",0,0,0,0,0,0,0,0
"Czechia","2024-01-08",0,0,0,0,0,0,0,0
"Czechia","2024-01-09",0,0,0,0,0,0,0,0
"Czechia","2024-01-10",0,0,0,0,0,0,0,0
"Czechia","2024-01-11",0,0,0,0,0,0,0,0
"Czechia","2024-01-12",0,0,0,0,0,0,0,0
"Czechia","2024-01-13",0,0,0,0,0,0,0,0
"Czechia","2024-01-14",0,0,0,0,0,0,0,0
"Czechia","2024-01-15",0,0,0,0,0,0,0,0
"Czechia","2024-01-16",0,0,0,0,0,0,0,0
"Czechia","2024-01-17",0,0,0,0,0,0,0,0
"Czechia","2024-01-18",0,0,0,0,0,0,0,0
"Czechia","2024-01-19",0,0,0,0,0,0,0,0
"Czechia","2024-01-20",0,0,0,0,0,0,0,0
"Czechia","2024-01-21",0,0,0,0,0,0,0,0
"Czechia","2024-01-22",0,0,0,0,0,0,0,0
"Czechia","2024-01-23",0,0,0,0,0,0,0,0
"Czechia","2024-01-24",0,0,0,0,0,0,0,0
"Czechia","2024-01-25",0,0,0,0,0,0,0,0
"Czechia","2024-01-26",0,0,0,0,0,0,0,0
"Czechia","2024-01-27",0,0,0,0,0,0,0,0
"Czechia","2024-01-28",0,0,0,0,0,0,0,0
"Czechia","2024-01-29",0,0,0,0,0,0,0,0
"Czechia","2024-01-30",0,0,0,0,0,0,0,0
"Czechia","2024-01-31",0,1,1,0,1,1,0,0
"Czechia","2024-02-01",0,0,1,0,0,1,0,0
"Czechia","2024-02-02",0,0,1,0,0,1,0,0
"Czechia","2024-02-03",0,0,1,0,1,2,0,0
"Czechia","2024-02-04",0,0,1,0,0,2,0,0
"Czechia","2024-02-05",0,0,1,0,0,2,0,0
"Czechia","2024-02-06",0,0,1,0,0,2,0,0
"Czechia","2024-02-07",0,0,1,0,0,2,0,0
"Czechia","2024-02-08",0,0,1,0,1,3,0,0
"Czechia","2024-02-09",0,0,1,0,0,3,0,0
"Czechia","2024-02-10",0,0,1,0,0,3,0,0
"Czechia","2024-02-11",0,0,1,0,0,3,0,0
"Czechia","2024-02-12",0,0,1,0,0,3,0,0
"Czechia","2024-02-13",0,0,1,0,1,4,0,0
"Czechia","2024-02-14",0,0,1,0,0,4,0,0
"Czechia","2024-02-15",0,0,1,0,0,4,0,0
"Czechia","2024-02-16",0,0,1,0,0,4,0,0
"Czechia","2024-02-17",0,0,1,0,1,5,0,0
"Czechia","2024-02-18",0,0,1,0,0,5,0,0
"Czechia","2024-02-19",0,0,1,0,0,5,0,0
"Czechia","2024-02-20",0,0,1,0,0,5,0,0
"Czechia","2024-02-21",0,0,1,0,0,5,0,0
"Czechia","2024-02-22",0,0,1,0,1,6,0,0
"Czechia","2024-02-23",0,0,1,0,0,6,0,0
"Czechia","2024-02-24",0,0,1,0,0,6,0,0
"Czechia","2024-02-25",0,0,1,0,0,6,0,0
"Czechia","2024-02-26",0,0,1,0,0,6,0,0
"Czechia","2024-02-27",0,0,1,0,1,7,0,0
"Czechia","2024-02-28",0,0,1,0,0,7,0,0
"Czechia","2024-02-29",0,6,7,0,0,7,0,0
"Czechia","2024-03-01",0,0,7,0,0,7,0,0
"Czechia","2024-03-02",0,0,7,0,0,7,0,0
"Czechia","2024-03-03",0,0,7,0,0,7,0,0
"Czechia","2024-03-04",0,0,7,0,0,7,0,0
"Czechia","2024-03-05",0,0,7,0,0,7,0,0
"Czechia","2024-03-06",0,0,7,0,0,7,0,0
"Czechia","2024-03-07",0,0,7,0,0,7,0,0
"Czechia","2024-03-08",0,0,7,0,0,7,0,0
"Czechia","2024-03-09",0,0,7,0,0,7,0,0
"Czechia","2024-03-10",0,0,7,0,0,7,0,0
"Czechia","2024-03-11",0,0,7,0,1,8,0,0
"Czechia","2024-03-12",0,0,7,0,0,8,0,0
"Czechia","2024-03-13",0,0,7,0,0,8,0,0
"Czechia","2024-03-14",0,0,7,0,0,8,0,0
"Czechia","2024-03-15",0,0,7,0,0,8,0,0
"Czechia","2024-03-16",0,0,7,0,0,8,0,0
"Czechia","2024-03-17",0,0,7,0,0,8,0,0
"Czechia","2024-03-18",0,0,7,0,0,8,0,0
"Czechia","2024-03-19",0,0,7,0,0,8,0,0
"Czechia","2024-03-20",0,0,7,0,0,8,0,0
"Czechia","2024-03-21",0,0,7,0,0,8,0,0
"Czechia","2024-03-22",0,0,7,0,0,8,0,0
"Czechia","2024-03-23",0,0,7,0,0,8,0,0
"Czechia","2024-03-24",0,0,7,0,0,8,0,0
"Czechia","2024-03-25",0,0,7,0,0,8,0,0
"Czechia","2024-03-26",0,0,7,0,0,8,0,0
"Czechia","2024-03-27",0,0,7,0,0,8,0,0
"Czechia","2024-03-28",0,0,7,0,0,8,0,0
"Czechia","2024-03-29",0,0,7,0,0,8,0,0
"Czechia","2024-03-30",0,0,7,0,0,8,0,0
"Czechia","2024-03-31",0,0,7,0,1,9,0,0
"Czechia","2024-04-01",0,0,7,0,0,9,0,0
"Czechia","2024-04-02",0,0,7,0,0,9,0,0
"Czechia","2024-04-03",0,0,7,0,0,9,0,0
"Czechia","2024-04-04",0,0,7,0,0,9,0,0
"Czechia","2024-04-05",0,0,7,0,0,9,0,0
"Czechia","2024-04-06",0,0,7,0,0,9,0,0
"Czechia","2024-04-07",0,0,7,0,0,9,0,0
"Czechia","2024-04-08",0,0,7,0,0,9,0,0
"Czechia","2024-04-09",0,0,7,0,0,9,0,0
"Czechia","2024-04-10",0,0,7,0,0,9,0,0
"Czechia","2024-04-11",0,0,7,0,0,9,0,0
"Czechia","2024-04-12",0,0,7,0,0,9,0,0
"Czechia","2024-04-13",0,0,7,0,0,9,0,0
"Czechia","2024-04-14",0,0,7,0,0,9,0,0
"Czechia","2024-04-15",0,0,7,0,0,9,0,0
"Czechia","2024-04-16",0,0,7,0,0,9,0,0
"Czechia","2024-04-17",0,0,7,0,0,9,0,0
"Czechia","2024-04-18",0,0,7,0,0,9,0,0
"Czechia","2024-04-19",0,0,7,0,0,9,0,0
"Czechia","2024-04-20",0,0,7,0,1,10,0,0
"Czechia","2024-04-21",0,0,7,0,0,10,0,0
"Czechia","2024-04-22",0,0,7,0,0,10,0,0
"Czechia","2024-04-23",0,0,7,0,0,10,0,0
"Czechia","2024-04-24",0,0,7,0,0,10,0,0
"Czechia","2024-04-25",0,0,7,0,0,10,0,0
"Czechia","2024-04-26",0,0,7,0,0,10,0,0
"Czechia","2024-04-27",0,0,7,0,0,10,0,0
"Czechia","2024-04-28",0,0,7,0,0,10,0,0
"Czechia","2024-04-29",0,0,7,0,0,10,0,0
"Czechia","2024-04-30",0,3,10,0,0,10,0,0
"Czechia","2024-05-01",0,0,10,0,0,10,0,0
"Czechia","2024-05-02",0,0,10,0,0,10,0,0
"Czechia","2024-05-03",0,0,10,0,0,10,0,0
"Czechia","2024-05-04",0,0,10,0,0,10,0,0
"Czechia","2024-05-05",0,0,10,0,0,10,0,0
"Czechia","2024-05-06",0,0,10,0,0,10,0,0
"Czechia","2024-05-07",0,0,10,0,0,10,0,0
"Czechia","2024-05-08",0,0,10,0,0,10,0,0
"Czechia","2024-05-09",0,0,10,0,0,10,0,0
"Czechia","2024-05-10",0,0,10,0,0,10,0,0
"Czechia","2024-05-11",0,0,10,0,0,10,0,0
"Czechia","2024-05-12",0,0,10,0,0,10,0,0
"Czechia","2024-05-13",0,0,10,0,0,10,0,0
"Czechia","2024-05-14",0,0,10,0,0,10,0,0
"Czechia","2024-05-15",0,0,10,0,0,10,0,0
"Czechia","2024-05-16",0,0,10,0,1,11,0,0
"Czechia","2024-05-17",0,0,10,0,0,11,0,0
"Czechia","2024-05-18",0,0,10,0,0,11,0,0
"Czechia","2024-05-19",0,0,10,0,0,11,0,0
"Czechia","2024-05-20",0,0,10,0,0,11,0,0
"Czechia","2024-05-21",0,0,10,0,0,11,0,0
"Czechia","2024-05-22",0,0,10,0,0,11,0,0
"Czechia","2024-05-23",0,0,10,0,0,11,0,0
"Czechia","2024-05-24",0,0,10,0,0,11,0,0
"Czechia","2024-05-25",0,0,10,0,0,11,0,0
"Czechia","2024-05-26",0,0,10,0,0,11,0,0
"Czechia","2024-05-27",0,0,10,0,0,11,0,0
"Czechia","2024-05-28",0,0,10,0,0,11,0,0
"Czechia","2024-05-29",0,0,10,0,0,11,0,0
"Czechia","2024-05-30",0,0,10,0,0,11,0,0
"Czechia","2024-05-31",0,1,11,0,0,11,0,0
"Czechia","2024-06-01",0,0,11,0,0,11,0,0
"Czechia","2024-06-02",0,0,11,0,0,11,0,0
"Czechia","2024-06-03",0,0,11,0,0,11,0,0
"Czechia","2024-06-04",0,0,11,0,0,11,0,0
"Czechia","2024-06-05",0,0,11,0,0,11,0,0
"Czechia","2024-06-06",0,0,11,0,0,11,0,0
"Czechia","2024-06-07",0,0,11,0,0,11,0,0
"Czechia","2024-06-08",0,0,11,0,0,11,0,0
"Czechia","2024-06-09",0,0,11,0,0,11,0,0
"Czechia","2024-06-10",0,0,11,0,0,11,0,0
"Czechia","2024-06-11",0,0,11,0,0,11,0,0
"Czechia","2024-06-12",0,0,11,0,0,11,0,0
"Czechia","2024-06-13",0,0,11,0,0,11,0,0
"Czechia","2024-06-14",0,0,11,0,0,11,0,0
"Czechia","2024-06-15",0,0,11,0,0,11,0,0
"Czechia","2024-06-16",0,0,11,0,1,12,0,0
"Czechia","2024-06-17",0,0,11,0,0,12,0,0
"Czechia","2024-06-18",0,0,11,0,0,12,0,0
"Czechia","2024-06-19",0,0,11,0,0,12,0,0
"Czechia","2024-06-20",0,0,11,0,0,12,0,0
"Czechia","2024-06-21",0,0,11,0,0,12,0,0
"Czechia","2024-06-22",0,0,11,0,0,12,0,0
"Czechia","2024-06-23",0,0,11,0,0,12,0,0
"Czechia","2024-06-24",0,0,11,0,0,12,0,0
"Czechia","2024-06-25",0,0,11,0,0,12,0,0
"Czechia","2024-06-26",0,0,11,0,0,12,0,0
"Czechia","2024-06-27",0,0,11,0,0,12,0,0
"Czechia","2024-06-28",0,0,11,0,0,12,0,0
"Czechia","2024-06-29",0,0,11,0,0,12,0,0
"Czechia","2024-06-30",0,0,11,0,0,12,0,0
"Czechia","2024-07-01",0,0,11,0,0,12,0,0
"Czechia","2024-07-02",0,0,11,0,0,12,0,0
"Czechia","2024-07-03",0,0,11,0,0,12,0,0
"Czechia","2024-07-04",0,0,11,0,0,12,0,0
"Czechia","2024-07-05",0,0,11,0,0,12,0,0
"Czechia","2024-07-06",0,0,11,0,0,12,0,0
"Czechia","2024-07-07",0,0,11,0,0,12,0,0
"Czechia","2024-07-08",0,0,11,0,0,12,0,0
"Czechia","2024-07-09",0,0,11,0,0,12,0,0
"Czechia","2024-07-10",0,0,11,0,0,12,0,0
"Czechia","2024-07-11",0,0,11,0,0,12,0,0
"Czechia","2024-07-12",0,0,11,0,0,12,0,0
"Czechia","2024-07-13",0,0,11,0,0,12,0,0
"Czechia","2024-07-14",0,0,11,0,0,12,0,0
"Czechia","2024-07-15",0,0,11,0,0,12,0,0
"Czechia","2024-07-16",0,0,11,0,1,13,0,0
"Czechia","2024-07-17",0,0,11,0,0,13,0,0
"Czechia","2024-07-18",0,0,11,0,0,13,0,0
"Czechia","2024-07-19",0,0,11,0,0,13,0,0
"Czechia","2024-07-20",0,0,11,0,0,13,0,0
"Czechia","2024-07-21",0,0,11,0,0,13,0,0
"Czechia","2024-07-22",0,0,11,0,0,13,0,0
"Czechia","2024-07-23",0,0,11,0,0,13,0,0
"Czechia","2024-07-24",0,0,11,0,0,13,0,0
"Czechia","2024-07-25",0,0,11,0,0,13,0,0
"Czechia","2024-07-26",0,0,11,0,0,13,0,0
"Czechia","2024-07-27",0,0,11,0,0,13,0,0
"Czechia","2024-07-28",0,0,11,0,0,13,0,0
"Czechia","2024-07-29",0,0,11,0,0,13,0,0
"Czechia","2024-07-30",0,0,11,0,0,13,0,0
"Czechia","2024-07-31",0,0,11,0,0,13,0,0
"Czechia","2024-08-01",0,0,11,0,0,13,0,0
"Czechia","2024-08-02",0,0,11,0,0,13,0,0
"Czechia","2024-08-03",0,0,11,0,0,13,0,0
"Czechia","2024-08-04",0,0,11,0,0,13,0,0
"Czechia","2024-08-05",0,0,11,0,0,13,0,0
"Czechia","2024-08-06",0,0,11,0,0,13,0,0
"Czechia","2024-08-07",0,0,11,0,0,13,0,0
"Czechia","2024-08-08",0,0,11,0,0,13,0,0
"Czechia","2024-08-09",0,0,11,0,0,13,0,0
"Czechia","2024-08-10",0,0,11,0,0,13,0,0
"Czechia","2024-08-11",0,0,11,0,0,13,0,0
"Czechia","2024-08-12",0,0,11,0,0,13,0,0
"Czechia","2024-08-13",0,0,11,0,0,13,0,0
"Czechia","2024-08-14",0,0,11,0,0,13,0,0
"Czechia","2024-08-15",0,0,11,0,0,13,0,0
"Czechia","2024-08-16",0,0,11,0,1,14,0,0
"Czechia","2024-08-17",0,0,11,0,0,14,0,0
"Czechia","2024-08-18",0,0,11,0,0,14,0,0
"Czechia","2024-08-19",0,0,11,0,0,14,0,0
"Czechia","2024-08-20",0,0,11,0,0,14,0,0
"Czechia","2024-08-21",0,0,11,0,0,14,0,0
"Czechia","2024-08-22",0,0,11,0,0,14,0,0
"Czechia","2024-08-23",0,0,11,0,0,14,0,0
"Czechia","2024-08-24",0,0,11,0,0,14,0,0
"Czechia","2024-08-25",0,0,11,0,0,14,0,0
"Czechia","2024-08-26",0,0,11,0,0,14,0,0
"Czechia","2024-08-27",0,0,11,0,0,14,0,0
"Czechia","2024-08-28",0,0,11,0,0,14,0,0
"Czechia","2024-08-29",0,0,11,0,0,14,0,0
"Czechia","2024-08-30",0,0,11,0,0,14,0,0
"Czechia","2024-08-31",0,3,14,0,0,14,0,0
"Czechia","2024-09-01",0,0,14,0,0,14,0,0
"Czechia","2024-09-02",0,0,14,0,0,14,0,0
"Czechia","2024-09-03",0,0,14,0,0,14,0,0
"Czechia","2024-09-04",0,0,14,0,0,14,0,0
"Czechia","2024-09-05",0,0,14,0,0,14,0,0
"Czechia","2024-09-06",0,0,14,0,0,14,0,0
"Czechia","2024-09-07",0,0,14,0,0,14,0,0
"Czechia","2024-09-08",0,0,14,0,1,15,0,0
"Czechia","2024-09-09",0,0,14,0,0,15,0,0
"Czechia","2024-09-10",0,0,14,0,0,15,0,0
"Czechia","2024-09-11",0,0,14,0,0,15,0,0
"Czechia","2024-09-12",0,0,14,0,0,15,0,0
"Czechia","2024-09-13",0,0,14,0,0,15,0,0
"Czechia","2024-09-14",0,0,14,0,0,15,0,0
"Czechia","2024-09-15",0,0,14,0,0,15,0,0
"Czechia","2024-09-16",0,0,14,0,0,15,0,0
"Czechia","2024-09-17",0,0,14,0,0,15,0,0
"Czechia","2024-09-18",0,0,14,0,0,15,0,0
"Czechia","2024-09-19",0,0,14,0,0,15,0,0
"Czechia","2024-09-20",0,0,14,0,0,15,0,0
"Czechia","2024-09-21",0,0,14,0,0,15,0,0
"Czechia","2024-09-22",0,0,14,0,0,15,0,0
"Czechia","2024-09-23",0,0,14,0,1,16,0,0
"Czechia","2024-09-24",0,0,14,0,0,16,0,0
"Czechia","2024-09-25",0,0,14,0,0,16,0,0
"Czechia","2024-09-26",0,0,14,0,0,16,0,0
"Czechia","2024-09-27",0,0,14,0,0,16,0,0
"Czechia","2024-09-28",0,0,14,0,0,16,0,0
"Czechia","2024-09-29",0,0,14,0,0,16,0,0
"Czechia","2024-09-30",0,2,16,0,0,16,0,0
"Czechia","2024-10-01",0,0,16,0,0,16,0,0
"Czechia","2024-10-02",0,0,16,0,0,16,0,0
"Czechia","2024-10-03",0,0,16,0,0,16,0,0
"Czechia","2024-10-04",0,0,16,0,0,16,0,0
"Czechia","2024-10-05",0,0,16,0,0,16,0,0
"Czechia","2024-10-06",0,0,16,0,1,17,0,0
"Czechia","2024-10-07",0,0,16,0,0,17,0,0
"Czechia","2024-10-08",0,0,16,0,0,17,0,0
"Czechia","2024-10-09",0,0,16,0,0,17,0,0
"Czechia","2024-10-10",0,0,16,0,0,17,0,0
"Czechia","2024-10-11",0,0,16,0,0,17,0,0
"Czechia","2024-10-12",0,0,16,0,0,17,0,0
"Czechia","2024-10-13",0,0,16,0,0,17,0,0
"Czechia","2024-10-14",0,0,16,0,0,17,0,0
"Czechia","2024-10-15",0,0,16,0,0,17,0,0
"Czechia","2024-10-16",0,0,16,0,1,18,0,0
"Czechia","2024-10-17",0,0,16,0,0,18,0,0
"Czechia","2024-10-18",0,0,16,0,0,18,0,0
"Czechia","2024-10-19",0,0,16,0,0,18,0,0
"Czechia","2024-10-20",0,0,16,0,0,18,0,0
"Czechia","2024-10-21",0,0,16,0,0,18,0,0
"Czechia","2024-10-22",0,0,16,0,0,18,0,0
"Czechia","2024-10-23",0,0,16,0,0,18,0,0
"Czechia","2024-10-24",0,0,16,0,0,18,0,0
"Czechia","2024-10-25",0,0,16,0,0,18,0,0
"Czechia","2024-10-26",0,0,16,0,1,19,0,0
"Czechia","2024-10-27",0,0,16,0,0,19,0,0
"Czechia","2024-10-28",0,0,16,0,0,19,0,0
"Czechia","2024-10-29",0,0,16,0,0,19,0,0
"Czechia","2024-10-30",0,0,16,0,0,19,0,0
"Czechia","2024-10-31",0,3,19,0,0,19,0,0
"Czechia","2024-11-01",0,0,19,0,0,19,0,0
"Czechia","2024-11-02",0,0,19,0,0,19,0,0
"Czechia","2024-11-03",0,0,19,0,0,19,0,0
"Czechia","2024-11-04",0,0,19,0,0,19,0,0
"Czechia","2024-11-05",0,0,19,0,0,19,0,0
"Czechia","2024-11-06",0,0,19,0,0,19,0,0
"Czechia","2024-11-07",0,0,19,0,0,19,0,0
"Czechia","2024-11-08",0,0,19,0,1,20,0,0
"Czechia","2024-11-09",0,0,19,0,0,20,0,0
"Czechia","2024-11-10",0,0,19,0,0,20,0,0
"Czechia","2024-11-11",0,0,19,0,0,20,0,0
"Czechia","2024-11-12",0,0,19,0,0,20,0,0
"Czechia","2024-11-13",0,0,19,0,0,20,0,0
"Czechia","2024-11-14",0,0,19,0,0,20,0,0
"Czechia","2024-11-15",0,0,19,0,0,20,0,0
"Czechia","2024-11-16",0,0,19,0,0,20,0,0
"Czechia","2024-11-17",0,0,19,0,0,20,0,0
"Czechia","2024-11-18",0,0,19,0,0,20,0,0
"Czechia","2024-11-19",0,0,19,0,0,20,0,0
"Czechia","2024-11-20",0,0,19,0,0,20,0,0
"Czechia","2024-11-21",0,0,19,0,0,20,0,0
"Czechia","2024-11-22",0,0,19,0,0,20,0,0
"Czechia","2024-11-23",0,0,19,0,1,21,0,0
"Czechia","2024-11-24",0,0,19,0,0,21,0,0
"Czechia","2024-11-25",0,0,19,0,0,21,0,0
"Czechia","2024-11-26",0,0,19,0,0,21,0,0
"Czechia","2024-11-27",0,0,19,0,0,21,0,0
"Czechia","2024-11-28",0,0,19,0,0,21,0,0
"Czechia","2024-11-29",0,0,19,0,0,21,0,0
"Czechia","2024-11-30",0,2,21,0,0,21,0,0
"Czechia","2024-12-01",0,0,21,0,0,21,0,0
"Czechia","2024-12-02",0,0,21,0,0,21,0,0
"Czechia","2024-12-03",0,0,21,0,0,21,0,0
"Czechia","2024-12-04",0,0,21,0,0,21,0,0
"Czechia","2024-12-05",0,0,21,0,0,21,0,0
"Czechia","2024-12-06",0,0,21,0,0,21,0,0
"Czechia","2024-12-07",0,0,21,0,0,21,0,0
"Czechia","2024-12-08",0,0,21,0,1,22,0,0
"Czechia","2024-12-09",0,0,21,0,0,22,0,0
"Czechia","2024-12-10",0,0,21,0,0,22,0,0
"Czechia","2024-12-11",0,0,21,0,0,22,0,0
"Czechia","2024-12-12",0,0,21,0,0,22,0,0
"Czechia","2024-12-13",0,0,21,0,0,22,0,0
"Czechia","2024-12-14",0,0,21,0,0,22,0,0
"Czechia","2024-12-15",0,0,21,0,0,22,0,0
"Czechia","2024-12-16",0,0,21,0,0,22,0,0
"Czechia","2024-12-17",0,0,21,0,0,22,0,0
"Czechia","2024-12-18",0,0,21,0,0,22,0,0
"Czechia","2024-12-19",0,0,21,0,0,22,0,0
"Czechia","2024-12-20",0,0,21,0,0,22,0,0
"Czechia","2024-12-21",0,0,21,0,0,22,0,0
"Czechia","2024-12-22",0,0,21,0,0,22,0,0
"Czechia","2024-12-23",0,0,21,0,0,22,0,0
"Czechia","2024-12-24",0,0,21,0,1,23,0,0
"Czechia","2024-12-25",0,0,21,0,0,23,0,0
"Czechia","2024-12-26",0,0,21,0,0,23,0,0
"Czechia","2024-12-27",0,0,21,0,0,23,0,0
"Czechia","2024-12-28",0,0,21,0,0,23,0,0
"Czechia","2024-12-29",0,0,21,0,0,23,0,0
"Czechia","2024-12-30",0,0,21,0,0,23,0,0
"Czechia","2024-12-31",0,2,23,0,0,23,0,0
"Czechia","2025-01-01",0,0,23,0,0,23,0,0
"Czechia","2025-01-02",0,0,23,0,0,23,0,0
"Czechia","2025-01-03",0,0,23,0,0,23,0,0
"Czechia","2025-01-04",0,0,23,0,0,23,0,0
"Czechia","2025-01-05",0,0,23,0,0,23,0,0
"Czechia","2025-01-06",0,0,23,0,0,23,0,0
"Czechia","2025-01-07",0,0,23,0,0,23,0,0
"Czechia","2025-01-08",0,0,23,0,0,23,0,0
"Czechia","2025-01-09",0,0,23,0,0,23,0,0
"Czechia","2025-01-10",0,0,23,0,0,23,0,0
"Czechia","2025-01-11",0,0,23,0,0,23,0,0
"Czechia","2025-01-12",0,0,23,0,0,23,0,0
"Czechia","2025-01-13",0,0,23,0,0,23,0,0
"Czechia","2025-01-14",0,0,23,0,0,23,0,0
"Czechia","2025-01-15",0,0,23,0,0,23,0,0
"Czechia","2025-01-16",0,0,23,0,0,23,0,0
"Czechia","2025-01-17",0,0,23,0,0,23,0,0
"Czechia","2025-01-18",0,0,23,0,0,23,0,0
"Czechia","2025-01-19",0,0,23,0,0,23,0,0
"Czechia","2025-01-20",0,0,23,0,0,23,0,0
"Czechia","2025-01-21",0,0,23,0,0,23,0,0
"Czechia","2025-01-22",0,0,23,0,0,23,0,0
"Czechia","2025-01-23",0,0,23,0,0,23,0,0
"Czechia","2025-01-24",0,0,23,0,0,23,0,0
"Czechia","2025-01-25",0,0,23,0,0,23,0,0
"Czechia","2025-01-26",0,0,23,0,0,23,0,0
"Czechia","2025-01-27",0,0,23,0,0,23,0,0
"Czechia","2025-01-28",0,0,23,0,0,23,0,0
"Czechia","2025-01-29",0,0,23,0,0,23,0,0
"Czechia","2025-01-30",0,0,23,0,0,23,0,0
"Czechia","2025-01-31",0,0,23,0,0,23,0,0
"Czechia","2025-02-01",0,0,23,0,0,23,0,0
"Czechia","2025-02-02",0,0,23,0,0,23,0,0
"Czechia","2025-02-03",0,0,23,0,0,23,0,0
"Democratic Republic of the Congo","2024-01-01",0,0,0,0,0,0,0,0
"Democratic Republic of the Congo","2024-01-02",0,0,0,0,0,0,0,0
"Democratic Republic of the Congo","2024-01-03",0,0,0,0,0,0,0,0
"Democratic Republic of the Congo","2024-01-04",0,0,0,0,0,0,0,0
"Democratic Republic of the Congo","2024-01-05",0,0,0,0,0,0,0,0
"Democratic Republic of the Congo","2024-01-06",0,0,0,0,0,0,0,0
"Democratic Republic of the Congo","2024-01-07",0,57,57,0,57,57,0,0
"Democratic Republic of the Congo","2024-01-08",0,0,57,0,10,67,0,0
"Democratic Republic of the Congo","2024-01-09",0,0,57,0,10,77,0,0
"Democratic Republic of the Congo","2024-01-10",0,0,57,0,10,87,0,0
"Democratic Republic of the Congo","2024-01-11",0,0,57,0,10,97,0,0
"Democratic Republic of the Congo","2024-01-12",0,0,57,0,10,107,0,0
"Democratic Republic of the Congo","2024-01-13",0,0,57,0,10,117,0,0
"Democratic Republic of the Congo","2024-01-14",0,70,127,0,10,127,0,0
"Democratic Republic of the Congo","2024-01-15",0,0,127,0,13,140,0,0
"Democratic Republic of the Congo","2024-01-16",0,0,127,0,12,152,0,0
"Democratic Republic of the Congo","2024-01-17",0,0,127,0,13,165,0,0
"Democratic Republic of the Congo","2024-01-18",0,0,127,0,13,178,0,0
"Democratic Republic of the Congo","2024-01-19",0,0,127,0,13,191,0,0
"Democratic Republic of the Congo","2024-01-20",0,0,127,0,12,203,0,0
"Democratic Republic of the Congo","2024-01-21",0,89,216,0,13,216,0,0
"Democratic Republic of the Congo","2024-01-22",0,0,216,0,11,227,0,0
"Democratic Republic of the Congo","2024-01-23",0,0,216,0,10,237,0,0
"Democratic Republic of the Congo","2024-01-24",0,0,216,0,11,248,0,0
"Democratic Republic of the Congo","2024-01-25",0,0,216,0,10,258,0,0
"Democratic Republic of the Congo","2024-01-26",0,0,216,0,11,269,0,0
"Democratic Republic of the Congo","2024-01-27",0,0,216,0,10,279,0,0
"Democratic Republic of the Congo","2024-01-28",0,74,290,0,11,290,0,0
"Democratic Republic of the Congo","2024-01-29",0,0,290,0,9,299,0,0
"Democratic Republic of the Congo","2024-01-30",0,0,290,0,9,308,0,0
"Democratic Republic of the Congo","2024-01-31",0,0,290,0,9,317,0,0
"Democratic Republic of the Congo","2024-02-01",0,0,290,0,8,325,0,0
"Democratic Republic of the Congo","2024-02-02",0,0,290,0,9,334,0,0
"Democratic Republic of the Congo","2024-02-03",0,0,290,0,9,343,0,0
"Democratic Republic of the Congo","2024-02-04",0,62,352,0,9,352,0,0
"Democratic Republic of the Congo","2024-02-05",0,0,352,0,9,361,0,0
"Democratic Republic of the Congo","2024-02-06",0,0,352,0,8,369,0,0
"Democratic Republic of the Congo","2024-02-07",0,0,352,0,9,378,0,0
"Democratic Republic of the Congo","2024-02-08",0,0,352,0,8,386,0,0
"Democratic Republic of the Congo","2024-02-09",0,0,352,0,9,395,0,0
"Democratic Republic of the Congo","2024-02-10",1351,0,352,1351,8,403,1351,1351
"Democratic Republic of the Congo","2024-02-11",0,60,412,1351,9,412,44,1395
"Democratic Republic of the Congo","2024-02-12",0,0,412,1351,7,419,44,1439
"Democratic Republic of the Congo","2024-02-13",0,0,412,1351,8,427,45,1484
"Democratic Republic of the Congo","2024-02-14",0,0,412,1351,7,434,44,1528
"Democratic Republic of the Congo","2024-02-15",0,0,412,1351,8,442,44,1572
"Democratic Republic of the Congo","2024-02-16",0,0,412,1351,7,449,44,1616
"Democratic Republic of the Congo","2024-02-17",0,0,412,1351,8,457,45,1661
"Democratic Republic of the Congo","2024-02-18",0,52,464,1351,7,464,44,1705
"Democratic Republic of the Congo","2024-02-19",0,0,464,1351,6,470,44,1749
"Democratic Republic of the Congo","2024-02-20",0,0,464,1351,7,477,44,1793
"Democratic Republic of the Congo","2024-02-21",0,0,464,1351,6,483,44,1837
"Democratic Republic of the Congo","2024-02-22",0,0,464,1351,6,489,45,1882
"Democratic Republic of the Congo","2024-02-23",0,0,464,1351,6,495,44,1926
"Democratic Republic of the Congo","2024-02-24",0,0,464,1351,7,502,44,1970
"Democratic Republic of the Congo","2024-02-25",0,44,508,1351,6,508,44,2014
"Democratic Republic of the Congo","2024-02-26",0,0,508,1351,12,520,45,2059
"Democratic Republic of the Congo","2024-02-27",0,0,508,1351,11,531,44,2103
"Democratic Republic of the Congo","2024-02-28",0,0,508,1351,12,543,44,2147
"Democratic Republic of the Congo","2024-02-29",0,0,508,1351,11,554,44,2191
"Democratic Republic of the Congo","2024-03-01",0,0,508,1351,12,566,44,2235
"Democratic Republic of the Congo","2024-03-02",0,0,508,1351,11,577,45,2280
"Democratic Republic of the Congo","2024-03-03",0,81,589,1351,12,589,44,2324
"Democratic Republic of the Congo","2024-03-04",0,0,589,1351,8,597,44,2368
"Democratic Republic of the Congo","2024-03-05",0,0,589,1351,8,605,44,2412
"Democratic Republic of the Congo","2024-03-06",0,0,589,1351,8,613,45,2457
"Democratic Republic of the Congo","2024-03-07",0,0,589,1351,8,621,44,2501
"Democratic Republic of the Congo","2024-03-08",0,0,589,1351,8,629,44,2545
"Democratic Republic of the Congo","2024-03-09",0,0,589,1351,8,637,44,2589
"Democratic Republic of the Congo","2024-03-10",0,56,645,1351,8,645,44,2633
"Democratic Republic of the Congo","2024-03-11",0,0,645,1351,10,655,45,2678
"Democratic Republic of the Congo","2024-03-12",0,0,645,1351,9,664,44,2722
"Democratic Republic of the Congo","2024-03-13",0,0,645,1351,10,674,44,2766
"Democratic Republic of the Congo","2024-03-14",0,0,645,1351,10,684,44,2810
"Democratic Republic of the Congo","2024-03-15",0,0,645,1351,10,694,45,2855
"Democratic Republic of the Congo","2024-03-16",0,0,645,1351,9,703,44,2899
"Democratic Republic of the Congo","2024-03-17",1592,68,713,2943,10,713,44,2943
"Democratic Republic of the Congo","2024-03-18",0,0,713,2943,10,723,90,3033
"Democratic Republic of the Congo","2024-03-19",0,0,713,2943,9,732,91,3124
"Democratic Republic of the Congo","2024-03-20",0,0,713,2943,10,742,90,3214
"Democratic Republic of the Congo","2024-03-21",0,0,713,2943,9,751,91,3305
"Democratic Republic of the Congo","2024-03-22",0,0,713,2943,10,761,90,3395
"Democratic Republic of the Congo","2024-03-23",0,0,713,2943,9,770,91,3486
"Democratic Republic of the Congo","2024-03-24",633,67,780,3576,10,780,90,3576
"Democratic Republic of the Congo","2024-03-25",0,0,780,3576,9,789,119,3695
"Democratic Republic of the Congo","2024-03-26",0,0,780,3576,8,797,118,3813
"Democratic Republic of the Congo","2024-03-27",0,0,780,3576,9,806,119,3932
"Democratic Republic of the Congo","2024-03-28",0,0,780,3576,9,815,118,4050
"Democratic Republic of the Congo","2024-03-29",593,0,780,4169,9,824,119,4169
"Democratic Republic of the Congo","2024-03-30",0,0,780,4169,8,832,6,4175
"Democratic Republic of the Congo","2024-03-31",0,61,841,4169,9,841,6,4181
"Democratic Republic of the Congo","2024-04-01",0,0,841,4169,11,852,7,4188
"Democratic Republic of the Congo","2024-04-02",0,0,841,4169,11,863,6,4194
"Democratic Republic of the Congo","2024-04-03",0,0,841,4169,11,874,6,4200
"Democratic Republic of the Congo","2024-04-04",0,0,841,4169,12,886,7,4207
"Democratic Republic of the Congo","2024-04-05",0,0,841,4169,11,897,6,4213
"Democratic Republic of the Congo","2024-04-06",50,0,841,4219,11,908,6,4219
"Democratic Republic of the Congo","2024-04-07",0,78,919,4219,11,919,48,4267
"Democratic Republic of the Congo","2024-04-08",0,0,919,4219,16,935,47,4314
"Democratic Republic of the Congo","2024-04-09",0,0,919,4219,16,951,48,4362
"Democratic Republic of the Congo","2024-04-10",0,0,919,4219,16,967,47,4409
"Democratic Republic of the Congo","2024-04-11",0,0,919,4219,17,984,48,4457
"Democratic Republic of the Congo","2024-04-12",0,0,919,4219,16,1000,48,4505
"Democratic Republic of the Congo","2024-04-13",0,0,919,4219,16,1016,47,4552
"Democratic Republic of the Congo","2024-04-14",381,113,1032,4600,16,1032,48,4600
"Democratic Republic of the Congo","2024-04-15",0,0,1032,4600,23,1055,28,4628
"Democratic Republic of the Congo","2024-04-16",0,0,1032,4600,22,1077,28,4656
"Democratic Republic of the Congo","2024-04-17",0,0,1032,4600,23,1100,28,4684
"Democratic Republic of the Congo","2024-04-18",0,0,1032,4600,23,1123,27,4711
"Democratic Republic of the Congo","2024-04-19",0,0,1032,4600,23,1146,28,4739
"Democratic Republic of the Congo","2024-04-20",167,0,1032,4767,22,1168,28,4767
"Democratic Republic of the Congo","2024-04-21",0,159,1191,4767,23,1191,25,4792
"Democratic Republic of the Congo","2024-04-22",0,0,1191,4767,25,1216,25,4817
"Democratic Republic of the Congo","2024-04-23",0,0,1191,4767,25,1241,24,4841
"Democratic Republic of the Congo","2024-04-24",0,0,1191,4767,25,1266,25,4866
"Democratic Republic of the Congo","2024-04-25",0,0,1191,4767,26,1292,25,4891
"Democratic Republic of the Congo","2024-04-26",0,0,1191,4767,25,1317,24,4915
"Democratic Republic of the Congo","2024-04-27",0,0,1191,4767,25,1342,25,4940
"Democratic Republic of the Congo","2024-04-28",198,176,1367,4965,25,1367,25,4965
"Democratic Republic of the Congo","2024-04-29",0,0,1367,4965,35,1402,69,5034
"Democratic Republic of the Congo","2024-04-30",0,0,1367,4965,36,1438,68,5102
"Democratic Republic of the Congo","2024-05-01",0,0,1367,4965,35,1473,69,5171
"Democratic Republic of the Congo","2024-05-02",0,0,1367,4965,35,1508,68,5239
"Democratic Republic of the Congo","2024-05-03",0,0,1367,4965,35,1543,69,5308
"Democratic Republic of the Congo","2024-05-04",0,0,1367,4965,36,1579,68,5376
"Democratic Republic of the Congo","2024-05-05",480,247,1614,5445,35,1614,69,5445
"Democratic Republic of the Congo","2024-05-06",0,0,1614,5445,30,1644,19,5464
"Democratic Republic of the Congo","2024-05-07",0,0,1614,5445,30,1674,20,5484
"Democratic Republic of the Congo","2024-05-08",0,0,1614,5445,30,1704,19,5503
"Democratic Republic of the Congo","2024-05-09",0,0,1614,5445,29,1733,20,5523
"Democratic Republic of the Congo","2024-05-10",0,0,1614,5445,30,1763,19,5542
"Democratic Republic of the Congo","2024-05-11",0,0,1614,5445,30,1793,20,5562
"Democratic Republic of the Congo","2024-05-12",136,209,1823,5581,30,1823,19,5581
"Democratic Republic of the Congo","2024-05-13",0,0,1823,5581,34,1857,78,5659
"Democratic Republic of the Congo","2024-05-14",0,0,1823,5581,33,1890,78,5737
"Democratic Republic of the Congo","2024-05-15",0,0,1823,5581,34,1924,78,5815
"Democratic Republic of the Congo","2024-05-16",0,0,1823,5581,34,1958,78,5893
"Democratic Republic of the Congo","2024-05-17",0,0,1823,5581,34,1992,78,5971
"Democratic Republic of the Congo","2024-05-18",468,0,1823,6049,33,2025,78,6049
"Democratic Republic of the Congo","2024-05-19",0,236,2059,6049,34,2059,50,6099
"Democratic Republic of the Congo","2024-05-20",0,0,2059,6049,30,2089,49,6148
"Democratic Republic of the Congo","2024-05-21",0,0,2059,6049,30,2119,50,6198
"Democratic Republic of the Congo","2024-05-22",0,0,2059,6049,30,2149,50,6248
"Democratic Republic of the Congo","2024-05-23",0,0,2059,6049,31,2180,50,6298
"Democratic Republic of the Congo","2024-05-24",0,0,2059,6049,30,2210,49,6347
"Democratic Republic of the Congo","2024-05-25",348,0,2059,6397,30,2240,50,6397
"Democratic Republic of the Congo","2024-05-26",0,211,2270,6397,30,2270,22,6419
"Democratic Republic of the Congo","2024-05-27",0,0,2270,6397,36,2306,22,6441
"Democratic Republic of the Congo","2024-05-28",0,0,2270,6397,37,2343,22,6463
"Democratic Republic of the Congo","2024-05-29",0,0,2270,6397,36,2379,23,6486
"Democratic Republic of the Congo","2024-05-30",0,0,2270,6397,37,2416,22,6508
"Democratic Republic of the Congo","2024-05-31",0,0,2270,6397,36,2452,22,6530
"Democratic Republic of the Congo","2024-06-01",0,0,2270,6397,37,2489,22,6552
"Democratic Republic of the Congo","2024-06-02",0,255,2525,6397,36,2525,22,6574
"Democratic Republic of the Congo","2024-06-03",0,0,2525,6397,50,2575,22,6596
"Democratic Republic of the Congo","2024-06-04",0,0,2525,6397,50,2625,22,6618
"Democratic Republic of the Congo","2024-06-05",0,0,2525,6397,50,2675,22,6640
"Democratic Republic of the Congo","2024-06-06",0,0,2525,6397,50,2725,23,6663
"Democratic Republic of the Congo","2024-06-07",0,0,2525,6397,50,2775,22,6685
"Democratic Republic of the Congo","2024-06-08",0,0,2525,6397,50,2825,22,6707
"Democratic Republic of the Congo","2024-06-09",332,350,2875,6729,50,2875,22,6729
"Democratic Republic of the Congo","2024-06-10",0,0,2875,6729,53,2928,39,6768
"Democratic Republic of the Congo","2024-06-11",0,0,2875,6729,54,2982,39,6807
"Democratic Republic of the Congo","2024-06-12",0,0,2875,6729,53,3035,39,6846
"Democratic Republic of the Congo","2024-06-13",0,0,2875,6729,54,3089,39,6885
"Democratic Republic of the Congo","2024-06-14",0,0,2875,6729,53,3142,39,6924
"Democratic Republic of the Congo","2024-06-15",0,0,2875,6729,54,3196,39,6963
"Democratic Republic of the Congo","2024-06-16",273,374,3249,7002,53,3249,39,7002
"Democratic Republic of the Congo","2024-06-17",0,0,3249,7002,48,3297,100,7102
"Democratic Republic of the Congo","2024-06-18",0,0,3249,7002,48,3345,99,7201
"Democratic Republic of the Congo","2024-06-19",0,0,3249,7002,48,3393,99,7300
"Democratic Republic of the Congo","2024-06-20",0,0,3249,7002,48,3441,100,7400
"Democratic Republic of the Congo","2024-06-21",0,0,3249,7002,48,3489,100,7500
"Democratic Republic of the Congo","2024-06-22",597,0,3249,7599,48,3537,99,7599
"Democratic Republic of the Congo","2024-06-23",0,336,3585,7599,48,3585,57,7656
"Democratic Republic of the Congo","2024-06-24",0,0,3585,7599,65,3650,57,7713
"Democratic Republic of the Congo","2024-06-25",0,0,3585,7599,66,3716,58,7771
"Democratic Republic of the Congo","2024-06-26",0,0,3585,7599,65,3781,57,7828
"Democratic Republic of the Congo","2024-06-27",0,0,3585,7599,65,3846,57,7885
"Democratic Republic of the Congo","2024-06-28",0,0,3585,7599,65,3911,58,7943
"Democratic Republic of the Congo","2024-06-29",0,0,3585,7599,66,3977,57,8000
"Democratic Republic of the Congo","2024-06-30",458,457,4042,8057,65,4042,57,8057
"Democratic Republic of the Congo","2024-07-01",0,0,4042,8057,59,4101,87,8144
"Democratic Republic of the Congo","2024-07-02",0,0,4042,8057,59,4160,88,8232
"Democratic Republic of the Congo","2024-07-03",0,0,4042,8057,59,4219,87,8319
"Democratic Republic of the Congo","2024-07-04",0,0,4042,8057,60,4279,87,8406
"Democratic Republic of the Congo","2024-07-05",0,0,4042,8057,59,4338,88,8494
"Democratic Republic of the Congo","2024-07-06",524,0,4042,8581,59,4397,87,8581
"Democratic Republic of the Congo","2024-07-07",0,414,4456,8581,59,4456,75,8656
"Democratic Republic of the Congo","2024-07-08",0,0,4456,8581,84,4540,76,8732
"Democratic Republic of the Congo","2024-07-09",0,0,4456,8581,83,4623,75,8807
"Democratic Republic of the Congo","2024-07-10",0,0,4456,8581,84,4707,75,8882
"Democratic Republic of the Congo","2024-07-11",0,0,4456,8581,84,4791,76,8958
"Democratic Republic of the Congo","2024-07-12",452,0,4456,9033,84,4875,75,9033
"Democratic Republic of the Congo","2024-07-13",0,0,4456,9033,83,4958,133,9166
"Democratic Republic of the Congo","2024-07-14",0,586,5042,9033,84,5042,133,9299
"Democratic Republic of the Congo","2024-07-15",0,0,5042,9033,74,5116,133,9432
"Democratic Republic of the Congo","2024-07-16",0,0,5042,9033,74,5190,133,9565
"Democratic Republic of the Congo","2024-07-17",0,0,5042,9033,74,5264,134,9699
"Democratic Republic of the Congo","2024-07-18",0,0,5042,9033,73,5337,133,9832
"Democratic Republic of the Congo","2024-07-19",0,0,5042,9033,74,5411,133,9965
"Democratic Republic of the Congo","2024-07-20",0,0,5042,9033,74,5485,133,10098
"Democratic Republic of the Congo","2024-07-21",0,517,5559,9033,74,5559,133,10231
"Democratic Republic of the Congo","2024-07-22",0,0,5559,9033,62,5621,133,10364
"Democratic Republic of the Congo","2024-07-23",0,0,5559,9033,63,5684,133,10497
"Democratic Republic of the Congo","2024-07-24",0,0,5559,9033,62,5746,134,10631
"Democratic Republic of the Congo","2024-07-25",0,0,5559,9033,62,5808,133,10764
"Democratic Republic of the Congo","2024-07-26",0,0,5559,9033,62,5870,133,10897
"Democratic Republic of the Congo","2024-07-27",0,0,5559,9033,63,5933,133,11030
"Democratic Republic of the Congo","2024-07-28",2130,436,5995,11163,62,5995,133,11163
"Democratic Republic of the Congo","2024-07-29",0,0,5995,11163,33,6028,100,11263
"Democratic Republic of the Congo","2024-07-30",0,0,5995,11163,32,6060,100,11363
"Democratic Republic of the Congo","2024-07-31",0,0,5995,11163,33,6093,100,11463
"Democratic Republic of the Congo","2024-08-01",0,0,5995,11163,32,6125,101,11564
"Democratic Republic of the Congo","2024-08-02",0,0,5995,11163,33,6158,100,11664
"Democratic Republic of the Congo","2024-08-03",601,0,5995,11764,32,6190,100,11764
"Democratic Republic of the Congo","2024-08-04",0,228,6223,11764,33,6223,398,12162
"Democratic Republic of the Congo","2024-08-05",0,0,6223,11764,34,6257,398,12560
"Democratic Republic of the Congo","2024-08-06",0,0,6223,11764,34,6291,398,12958
"Democratic Republic of the Congo","2024-08-07",0,0,6223,11764,34,6325,397,13355
"Democratic Republic of the Congo","2024-08-08",0,0,6223,11764,35,6360,398,13753
"Democratic Republic of the Congo","2024-08-09",2387,0,6223,14151,34,6394,398,14151
"Democratic Republic of the Congo","2024-08-10",0,0,6223,14151,34,6428,112,14263
"Democratic Republic of the Congo","2024-08-11",0,239,6462,14151,34,6462,112,14375
"Democratic Republic of the Congo","2024-08-12",0,0,6462,14151,29,6491,112,14487
"Democratic Republic of the Congo","2024-08-13",0,0,6462,14151,30,6521,111,14598
"Democratic Republic of the Congo","2024-08-14",0,0,6462,14151,29,6550,112,14710
"Democratic Republic of the Congo","2024-08-15",0,0,6462,14151,30,6580,112,14822
"Democratic Republic of the Congo","2024-08-16",783,0,6462,14934,29,6609,112,14934
"Democratic Republic of the Congo","2024-08-17",0,0,6462,14934,30,6639,197,15131
"Democratic Republic of the Congo","2024-08-18",0,206,6668,14934,29,6668,197,15328
"Democratic Republic of the Congo","2024-08-19",0,0,6668,14934,29,6697,197,15525
"Democratic Republic of the Congo","2024-08-20",0,0,6668,14934,29,6726,197,15722
"Democratic Republic of the Congo","2024-08-21",0,0,6668,14934,29,6755,196,15918
"Democratic Republic of the Congo","2024-08-22",0,0,6668,14934,30,6785,197,16115
"Democratic Republic of the Congo","2024-08-23",0,0,6668,14934,29,6814,197,16312
"Democratic Republic of the Congo","2024-08-24",0,0,6668,14934,29,6843,197,16509
"Democratic Republic of the Congo","2024-08-25",1772,204,6872,16706,29,6872,197,16706
"Democratic Republic of the Congo","2024-08-26",0,0,6872,16706,37,6909,182,16888
"Democratic Republic of the Congo","2024-08-27",0,0,6872,16706,37,6946,183,17071
"Democratic Republic of the Congo","2024-08-28",0,0,6872,16706,37,6983,183,17254
"Democratic Republic of the Congo","2024-08-29",0,0,6872,16706,37,7020,182,17436
"Democratic Republic of the Congo","2024-08-30",0,0,6872,16706,37,7057,182,17618
"Democratic Republic of the Congo","2024-08-31",1095,0,6872,17801,37,7094,183,17801
"Democratic Republic of the Congo","2024-09-01",0,259,7131,17801,37,7131,333,18134
"Democratic Republic of the Congo","2024-09-02",0,0,7131,17801,39,7170,333,18467
"Democratic Republic of the Congo","2024-09-03",0,0,7131,17801,38,7208,332,18799
"Democratic Republic of the Congo","2024-09-04",0,0,7131,17801,39,7247,333,19132
"Democratic Republic of the Congo","2024-09-05",0,0,7131,17801,38,7285,333,19465
"Democratic Republic of the Congo","2024-09-06",0,0,7131,17801,39,7324,332,19797
"Democratic Republic of the Congo","2024-09-07",0,0,7131,17801,38,7362,333,20130
"Democratic Republic of the Congo","2024-09-08",2662,270,7401,20463,39,7401,333,20463
"Democratic Republic of the Congo","2024-09-09",0,0,7401,20463,37,7438,14,20477
"Democratic Republic of the Congo","2024-09-10",0,0,7401,20463,37,7475,13,20490
"Democratic Republic of the Congo","2024-09-11",0,0,7401,20463,37,7512,14,20504
"Democratic Republic of the Congo","2024-09-12",0,0,7401,20463,36,7548,14,20518
"Democratic Republic of the Congo","2024-09-13",0,0,7401,20463,37,7585,13,20531
"Democratic Republic of the Congo","2024-09-14",0,0,7401,20463,37,7622,14,20545
"Democratic Republic of the Congo","2024-09-15",0,258,7659,20463,37,7659,14,20559
"Democratic Republic of the Congo","2024-09-16",0,0,7659,20463,43,7702,13,20572
"Democratic Republic of the Congo","2024-09-17",0,0,7659,20463,44,7746,14,20586
"Democratic Republic of the Congo","2024-09-18",0,0,7659,20463,43,7789,14,20600
"Democratic Republic of the Congo","2024-09-19",0,0,7659,20463,43,7832,13,20613
"Democratic Republic of the Congo","2024-09-20",0,0,7659,20463,43,7875,14,20627
"Democratic Republic of the Congo","2024-09-21",0,0,7659,20463,44,7919,14,20641
"Democratic Republic of the Congo","2024-09-22",0,303,7962,20463,43,7962,13,20654
"Democratic Republic of the Congo","2024-09-23",205,0,7962,20668,26,7988,14,20668
"Democratic Republic of the Congo","2024-09-24",0,0,7962,20668,27,8015,144,20812
"Democratic Republic of the Congo","2024-09-25",0,0,7962,20668,26,8041,144,20956
"Democratic Republic of the Congo","2024-09-26",0,0,7962,20668,26,8067,144,21100
"Democratic Republic of the Congo","2024-09-27",0,0,7962,20668,26,8093,143,21243
"Democratic Republic of the Congo","2024-09-28",0,0,7962,20668,27,8120,144,21387
"Democratic Republic of the Congo","2024-09-29",0,184,8146,20668,26,8146,144,21531
"Democratic Republic of the Congo","2024-09-30",1007,0,8146,21675,24,8170,144,21675
"Democratic Republic of the Congo","2024-10-01",0,0,8146,21675,24,8194,415,22090
"Democratic Republic of the Congo","2024-10-02",0,0,8146,21675,24,8218,415,22505
"Democratic Republic of the Congo","2024-10-03",0,0,8146,21675,24,8242,415,22920
"Democratic Republic of the Congo","2024-10-04",0,0,8146,21675,24,8266,414,23334
"Democratic Republic of the Congo","2024-10-05",0,0,8146,21675,24,8290,415,23749
"Democratic Republic of the Congo","2024-10-06",0,168,8314,21675,24,8314,415,24164
"Democratic Republic of the Congo","2024-10-07",0,0,8314,21675,36,8350,415,24579
"Democratic Republic of the Congo","2024-10-08",0,0,8314,21675,36,8386,415,24994
"Democratic Republic of the Congo","2024-10-09",0,0,8314,21675,36,8422,415,25409
"Democratic Republic of the Congo","2024-10-10",0,0,8314,21675,35,8457,414,25823
"Democratic Republic of the Congo","2024-10-11",0,0,8314,21675,36,8493,415,26238
"Democratic Republic of the Congo","2024-10-12",0,0,8314,21675,36,8529,415,26653
"Democratic Republic of the Congo","2024-10-13",5393,251,8565,27068,36,8565,415,27068
"Democratic Republic of the Congo","2024-10-14",0,0,8565,27068,44,8609,189,27257
"Democratic Republic of the Congo","2024-10-15",0,0,8565,27068,44,8653,189,27446
"Democratic Republic of the Congo","2024-10-16",0,0,8565,27068,44,8697,189,27635
"Democratic Republic of the Congo","2024-10-17",0,0,8565,27068,44,8741,189,27824
"Democratic Republic of the Congo","2024-10-18",0,0,8565,27068,44,8785,189,28013
"Democratic Republic of the Congo","2024-10-19",0,0,8565,27068,44,8829,189,28202
"Democratic Republic of the Congo","2024-10-20",1323,308,8873,28391,44,8873,189,28391
"Democratic Republic of the Congo","2024-10-21",0,0,8873,28391,30,8903,95,28486
"Democratic Republic of the Congo","2024-10-22",0,0,8873,28391,31,8934,96,28582
"Democratic Republic of the Congo","2024-10-23",0,0,8873,28391,30,8964,95,28677
"Democratic Republic of the Congo","2024-10-24",0,0,8873,28391,31,8995,95,28772
"Democratic Republic of the Congo","2024-10-25",0,0,8873,28391,30,9025,95,28867
"Democratic Republic of the Congo","2024-10-26",0,0,8873,28391,31,9056,96,28963
"Democratic Republic of the Congo","2024-10-27",667,213,9086,29058,30,9086,95,29058
"Democratic Republic of the Congo","2024-10-28",0,0,9086,29058,35,9121,68,29126
"Democratic Republic of the Congo","2024-10-29",0,0,9086,29058,34,9155,68,29194
"Democratic Republic of the Congo","2024-10-30",0,0,9086,29058,35,9190,68,29262
"Democratic Republic of the Congo","2024-10-31",0,0,9086,29058,35,9225,67,29329
"Democratic Republic of the Congo","2024-11-01",0,0,9086,29058,35,9260,68,29397
"Democratic Republic of the Congo","2024-11-02",0,0,9086,29058,34,9294,68,29465
"Democratic Republic of the Congo","2024-11-03",475,243,9329,29533,35,9329,68,29533
"Democratic Republic of the Congo","2024-11-04",0,0,9329,29533,41,9370,268,29801
"Democratic Republic of the Congo","2024-11-05",0,0,9329,29533,40,9410,267,30068
"Democratic Republic of the Congo","2024-11-06",0,0,9329,29533,41,9451,268,30336
"Democratic Republic of the Congo","2024-11-07",0,0,9329,29533,41,9492,267,30603
"Democratic Republic of the Congo","2024-11-08",0,0,9329,29533,41,9533,268,30871
"Democratic Republic of the Congo","2024-11-09",0,0,9329,29533,40,9573,267,31138
"Democratic Republic of the Congo","2024-11-10",0,285,9614,29533,41,9614,268,31406
"Democratic Republic of the Congo","2024-11-11",0,0,9614,29533,38,9652,267,31673
"Democratic Republic of the Congo","2024-11-12",0,0,9614,29533,39,9691,268,31941
"Democratic Republic of the Congo","2024-11-13",0,0,9614,29533,38,9729,268,32209
"Democratic Republic of the Congo","2024-11-14",0,0,9614,29533,38,9767,267,32476
"Democratic Republic of the Congo","2024-11-15",0,0,9614,29533,38,9805,268,32744
"Democratic Republic of the Congo","2024-11-16",0,0,9614,29533,39,9844,267,33011
"Democratic Republic of the Congo","2024-11-17",0,268,9882,29533,38,9882,268,33279
"Democratic Republic of the Congo","2024-11-18",0,0,9882,29533,37,9919,267,33546
"Democratic Republic of the Congo","2024-11-19",0,0,9882,29533,38,9957,268,33814
"Democratic Republic of the Congo","2024-11-20",0,0,9882,29533,37,9994,267,34081
"Democratic Republic of the Congo","2024-11-21",4816,0,9882,34349,38,10032,268,34349
"Democratic Republic of the Congo","2024-11-22",0,0,9882,34349,37,10069,0,34349
"Democratic Republic of the Congo","2024-11-23",0,0,9882,34349,38,10107,0,34349
"Democratic Republic of the Congo","2024-11-24",0,262,10144,34349,37,10144,0,34349
"Democratic Republic of the Congo","2024-11-25",0,0,10144,34349,38,10182,0,34349
"Democratic Republic of the Congo","2024-11-26",0,0,10144,34349,39,10221,0,34349
"Democratic Republic of the Congo","2024-11-27",0,0,10144,34349,38,10259,0,34349
"Democratic Republic of the Congo","2024-11-28",0,0,10144,34349,38,10297,0,34349
"Democratic Republic of the Congo","2024-11-29",0,0,10144,34349,38,10335,0,34349
"Democratic Republic of the Congo","2024-11-30",0,0,10144,34349,39,10374,0,34349
"Democratic Republic of the Congo","2024-12-01",0,268,10412,34349,38,10412,0,34349
"Democratic Republic of the Congo","2024-12-02",0,0,10412,34349,37,10449,0,34349
"Democratic Republic of the Congo","2024-12-03",0,0,10412,34349,36,10485,0,34349
"Democratic Republic of the Congo","2024-12-04",0,0,10412,34349,37,10522,0,34349
"Democratic Republic of the Congo","2024-12-05",0,0,10412,34349,37,10559,0,34349
"Democratic Republic of the Congo","2024-12-06",0,0,10412,34349,37,10596,0,34349
"Democratic Republic of the Congo","2024-12-07",0,0,10412,34349,36,10632,0,34349
"Democratic Republic of the Congo","2024-12-08",0,257,10669,34349,37,10669,0,34349
"Democratic Republic of the Congo","2024-12-09",0,0,10669,34349,33,10702,0,34349
"Democratic Republic of the Congo","2024-12-10",0,0,10669,34349,34,10736,0,34349
"Democratic Republic of the Congo","2024-12-11",0,0,10669,34349,33,10769,0,34349
"Democratic Republic of the Congo","2024-12-12",0,0,10669,34349,34,10803,0,34349
"Democratic Republic of the Congo","2024-12-13",0,0,10669,34349,33,10836,0,34349
"Democratic Republic of the Congo","2024-12-14",0,0,10669,34349,34,10870,0,34349
"Democratic Republic of the Congo","2024-12-15",0,234,10903,34349,33,10903,0,34349
"Democratic Republic of the Congo","2024-12-16",0,0,10903,34349,30,10933,0,34349
"Democratic Republic of the Congo","2024-12-17",0,0,10903,34349,29,10962,0,34349
"Democratic Republic of the Congo","2024-12-18",0,0,10903,34349,30,10992,0,34349
"Democratic Republic of the Congo","2024-12-19",0,0,10903,34349,30,11022,0,34349
"Democratic Republic of the Congo","2024-12-20",0,0,10903,34349,30,11052,0,34349
"Democratic Republic of the Congo","2024-12-21",0,0,10903,34349,29,11081,0,34349
"Democratic Republic of the Congo","2024-12-22",0,208,11111,34349,30,11111,0,34349
"Democratic Republic of the Congo","2024-12-23",0,0,11111,34349,27,11138,0,34349
"Democratic Republic of the Congo","2024-12-24",0,0,11111,34349,27,11165,0,34349
"Democratic Republic of the Congo","2024-12-25",0,0,11111,34349,27,11192,0,34349
"Democratic Republic of the Congo","2024-12-26",0,0,11111,34349,26,11218,0,34349
"Democratic Republic of the Congo","2024-12-27",0,0,11111,34349,27,11245,0,34349
"Democratic Republic of the Congo","2024-12-28",0,0,11111,34349,27,11272,0,34349
"Democratic Republic of the Congo","2024-12-29",0,188,11299,34349,27,11299,0,34349
"Democratic Republic of the Congo","2024-12-30",0,0,11299,34349,0,11299,0,34349
"Democratic Republic of the Congo","2024-12-31",0,0,11299,34349,0,11299,0,34349
"Democratic Republic of the Congo","2025-01-01",0,0,11299,34349,0,11299,0,34349
"Democratic Republic of the Congo","2025-01-02",0,0,11299,34349,0,11299,0,34349
"Democratic Republic of the Congo","2025-01-03",0,0,11299,34349,0,11299,0,34349
"Democratic Republic of the Congo","2025-01-04",0,0,11299,34349,0,11299,0,34349
"Democratic Republic of the Congo","2025-01-05",0,0,11299,34349,0,11299,0,34349
"Democratic Republic of the Congo","2025-01-06",0,0,11299,34349,0,11299,0,34349
"Democratic Republic of the Congo","2025-01-07",0,0,11299,34349,0,11299,0,34349
"Democratic Republic of the Congo","2025-01-08",0,0,11299,34349,0,11299,0,34349
"Democratic Republic of the Congo","2025-01-09",0,0,11299,34349,0,11299,0,34349
"Democratic Republic of the Congo","2025-01-10",0,0,11299,34349,0,11299,0,34349
"Democratic Republic of the Congo","2025-01-11",0,0,11299,34349,0,11299,0,34349
"Democratic Republic of the Congo","2025-01-12",0,0,11299,34349,0,11299,0,34349
"Democratic Republic of the Congo","2025-01-13",0,0,11299,34349,0,11299,0,34349
"Democratic Republic of the Congo","2025-01-14",0,0,11299,34349,0,11299,0,34349
"Democratic Republic of the Congo","2025-01-15",0,0,11299,34349,0,11299,0,34349
"Democratic Republic of the Congo","2025-01-16",0,0,11299,34349,0,11299,0,34349
"Democratic Republic of the Congo","2025-01-17",0,0,11299,34349,0,11299,0,34349
"Democratic Republic of the Congo","2025-01-18",0,0,11299,34349,0,11299,0,34349
"Democratic Republic of the Congo","2025-01-19",0,0,11299,34349,0,11299,0,34349
"Democratic Republic of the Congo","2025-01-20",0,0,11299,34349,0,11299,0,34349
"Democratic Republic of the Congo","2025-01-21",0,0,11299,34349,0,11299,0,34349
"Democratic Republic of the Congo","2025-01-22",0,0,11299,34349,0,11299,0,34349
"Democratic Republic of the Congo","2025-01-23",0,0,11299,34349,0,11299,0,34349
"Democratic Republic of the Congo","2025-01-24",0,0,11299,34349,0,11299,0,34349
"Democratic Republic of the Congo","2025-01-25",0,0,11299,34349,0,11299,0,34349
"Democratic Republic of the Congo","2025-01-26",0,0,11299,34349,0,11299,0,34349
"Democratic Republic of the Congo","2025-01-27",0,0,11299,34349,0,11299,0,34349
"Democratic Republic of the Congo","2025-01-28",0,0,11299,34349,0,11299,0,34349
"Democratic Republic of the Congo","2025-01-29",0,0,11299,34349,0,11299,0,34349
"Democratic Republic of the Congo","2025-01-30",0,0,11299,34349,0,11299,0,34349
"Democratic Republic of the Congo","2025-01-31",0,0,11299,34349,0,11299,0,34349
"Democratic Republic of the Congo","2025-02-01",0,0,11299,34349,0,11299,0,34349
"Democratic Republic of the Congo","2025-02-02",0,0,11299,34349,0,11299,0,34349
"Democratic Republic of the Congo","2025-02-03",0,0,11299,34349,0,11299,0,34349
"Denmark","2024-01-01",0,0,0,0,0,0,0,0
"Denmark","2024-01-02",0,0,0,0,0,0,0,0
"Denmark","2024-01-03",0,0,0,0,0,0,0,0
"Denmark","2024-01-04",0,0,0,0,0,0,0,0
"Denmark","2024-01-05",0,0,0,0,0,0,0,0
"Denmark","2024-01-06",0,0,0,0,0,0,0,0
"Denmark","2024-01-07",0,0,0,0,0,0,0,0
"Denmark","2024-01-08",0,0,0,0,0,0,0,0
"Denmark","2024-01-09",0,0,0,0,0,0,0,0
"Denmark","2024-01-10",0,0,0,0,0,0,0,0
"Denmark","2024-01-11",0,0,0,0,0,0,0,0
"Denmark","2024-01-12",0,0,0,0,0,0,0,0
"Denmark","2024-01-13",0,0,0,0,0,0,0,0
"Denmark","2024-01-14",0,0,0,0,0,0,0,0
"Denmark","2024-01-15",0,0,0,0,0,0,0,0
"Denmark","2024-01-16",0,0,0,0,0,0,0,0
"Denmark","2024-01-17",0,0,0,0,0,0,0,0
"Denmark","2024-01-18",0,0,0,0,0,0,0,0
"Denmark","2024-01-19",0,0,0,0,0,0,0,0
"Denmark","2024-01-20",0,0,0,0,0,0,0,0
"Denmark","2024-01-21",0,0,0,0,0,0,0,0
"Denmark","2024-01-22",0,0,0,0,0,0,0,0
"Denmark","2024-01-23",0,0,0,0,0,0,0,0
"Denmark","2024-01-24",0,0,0,0,0,0,0,0
"Denmark","2024-01-25",0,0,0,0,0,0,0,0
"Denmark","2024-01-26",0,0,0,0,0,0,0,0
"Denmark","2024-01-27",0,0,0,0,0,0,0,0
"Denmark","2024-01-28",0,0,0,0,0,0,0,0
"Denmark","2024-01-29",0,0,0,0,0,0,0,0
"Denmark","2024-01-30",0,0,0,0,0,0,0,0
"Denmark","2024-01-31",0,0,0,0,0,0,0,0
"Denmark","2024-02-01",0,0,0,0,0,0,0,0
"Denmark","2024-02-02",0,0,0,0,0,0,0,0
"Denmark","2024-02-03",0,0,0,0,0,0,0,0
"Denmark","2024-02-04",0,0,0,0,0,0,0,0
"Denmark","2024-02-05",0,0,0,0,0,0,0,0
"Denmark","2024-02-06",0,0,0,0,0,0,0,0
"Denmark","2024-02-07",0,0,0,0,0,0,0,0
"Denmark","2024-02-08",0,0,0,0,0,0,0,0
"Denmark","2024-02-09",0,0,0,0,0,0,0,0
"Denmark","2024-02-10",0,0,0,0,0,0,0,0
"Denmark","2024-02-11",0,0,0,0,0,0,0,0
"Denmark","2024-02-12",0,0,0,0,0,0,0,0
"Denmark","2024-02-13",0,0,0,0,0,0,0,0
"Denmark","2024-02-14",0,0,0,0,0,0,0,0
"Denmark","2024-02-15",0,0,0,0,0,0,0,0
"Denmark","2024-02-16",0,0,0,0,0,0,0,0
"Denmark","2024-02-17",0,0,0,0,0,0,0,0
"Denmark","2024-02-18",0,0,0,0,0,0,0,0
"Denmark","2024-02-19",0,0,0,0,0,0,0,0
"Denmark","2024-02-20",0,0,0,0,0,0,0,0
"Denmark","2024-02-21",0,0,0,0,0,0,0,0
"Denmark","2024-02-22",0,0,0,0,0,0,0,0
"Denmark","2024-02-23",0,0,0,0,0,0,0,0
"Denmark","2024-02-24",0,0,0,0,0,0,0,0
"Denmark","2024-02-25",0,0,0,0,0,0,0,0
"Denmark","2024-02-26",0,0,0,0,0,0,0,0
"Denmark","2024-02-27",0,0,0,0,0,0,0,0
"Denmark","2024-02-28",0,0,0,0,0,0,0,0
"Denmark","2024-02-29",0,0,0,0,0,0,0,0
"Denmark","2024-03-01",0,0,0,0,0,0,0,0
"Denmark","2024-03-02",0,0,0,0,0,0,0,0
"Denmark","2024-03-03",0,0,0,0,0,0,0,0
"Denmark","2024-03-04",0,0,0,0,0,0,0,0
"Denmark","2024-03-05",0,0,0,0,0,0,0,0
"Denmark","2024-03-06",0,0,0,0,0,0,0,0
"Denmark","2024-03-07",0,0,0,0,0,0,0,0
"Denmark","2024-03-08",0,0,0,0,0,0,0,0
"Denmark","2024-03-09",0,0,0,0,0,0,0,0
"Denmark","2024-03-10",0,0,0,0,0,0,0,0
"Denmark","2024-03-11",0,0,0,0,0,0,0,0
"Denmark","2024-03-12",0,0,0,0,0,0,0,0
"Denmark","2024-03-13",0,0,0,0,0,0,0,0
"Denmark","2024-03-14",0,0,0,0,0,0,0,0
"Denmark","2024-03-15",0,0,0,0,0,0,0,0
"Denmark","2024-03-16",0,0,0,0,0,0,0,0
"Denmark","2024-03-17",0,0,0,0,0,0,0,0
"Denmark","2024-03-18",0,0,0,0,0,0,0,0
"Denmark","2024-03-19",0,0,0,0,0,0,0,0
"Denmark","2024-03-20",0,0,0,0,0,0,0,0
"Denmark","2024-03-21",0,0,0,0,0,0,0,0
"Denmark","2024-03-22",0,0,0,0,0,0,0,0
"Denmark","2024-03-23",0,0,0,0,0,0,0,0
"Denmark","2024-03-24",0,0,0,0,0,0,0,0
"Denmark","2024-03-25",0,0,0,0,0,0,0,0
"Denmark","2024-03-26",0,0,0,0,0,0,0,0
"Denmark","2024-03-27",0,0,0,0,0,0,0,0
"Denmark","2024-03-28",0,0,0,0,0,0,0,0
"Denmark","2024-03-29",0,0,0,0,0,0,0,0
"Denmark","2024-03-30",0,0,0,0,0,0,0,0
"Denmark","2024-03-31",0,0,0,0,0,0,0,0
"Denmark","2024-04-01",0,0,0,0,0,0,0,0
"Denmark","2024-04-02",0,0,0,0,0,0,0,0
"Denmark","2024-04-03",0,0,0,0,0,0,0,0
"Denmark","2024-04-04",0,0,0,0,0,0,0,0
"Denmark","2024-04-05",0,0,0,0,0,0,0,0
"Denmark","2024-04-06",0,0,0,0,0,0,0,0
"Denmark","2024-04-07",0,0,0,0,0,0,0,0
"Denmark","2024-04-08",0,0,0,0,0,0,0,0
"Denmark","2024-04-09",0,0,0,0,0,0,0,0
"Denmark","2024-04-10",0,0,0,0,0,0,0,0
"Denmark","2024-04-11",0,0,0,0,0,0,0,0
"Denmark","2024-04-12",0,0,0,0,0,0,0,0
"Denmark","2024-04-13",0,0,0,0,0,0,0,0
"Denmark","2024-04-14",0,0,0,0,0,0,0,0
"Denmark","2024-04-15",0,0,0,0,0,0,0,0
"Denmark","2024-04-16",0,0,0,0,0,0,0,0
"Denmark","2024-04-17",0,0,0,0,0,0,0,0
"Denmark","2024-04-18",0,0,0,0,0,0,0,0
"Denmark","2024-04-19",0,0,0,0,0,0,0,0
"Denmark","2024-04-20",0,0,0,0,0,0,0,0
"Denmark","2024-04-21",0,0,0,0,0,0,0,0
"Denmark","2024-04-22",0,0,0,0,0,0,0,0
"Denmark","2024-04-23",0,0,0,0,0,0,0,0
"Denmark","2024-04-24",0,0,0,0,0,0,0,0
"Denmark","2024-04-25",0,0,0,0,0,0,0,0
"Denmark","2024-04-26",0,0,0,0,0,0,0,0
"Denmark","2024-04-27",0,0,0,0,0,0,0,0
"Denmark","2024-04-28",0,0,0,0,0,0,0,0
"Denmark","2024-04-29",0,0,0,0,0,0,0,0
"Denmark","2024-04-30",0,0,0,0,0,0,0,0
"Denmark","2024-05-01",0,0,0,0,0,0,0,0
"Denmark","2024-05-02",0,0,0,0,0,0,0,0
"Denmark","2024-05-03",0,0,0,0,0,0,0,0
"Denmark","2024-05-04",0,0,0,0,0,0,0,0
"Denmark","2024-05-05",0,0,0,0,0,0,0,0
"Denmark","2024-05-06",0,0,0,0,0,0,0,0
"Denmark","2024-05-07",0,0,0,0,0,0,0,0
"Denmark","2024-05-08",0,0,0,0,0,0,0,0
"Denmark","2024-05-09",0,0,0,0,0,0,0,0
"Denmark","2024-05-10",0,0,0,0,0,0,0,0
"Denmark","2024-05-11",0,0,0,0,0,0,0,0
"Denmark","2024-05-12",0,0,0,0,0,0,0,0
"Denmark","2024-05-13",0,0,0,0,0,0,0,0
"Denmark","2024-05-14",0,0,0,0,0,0,0,0
"Denmark","2024-05-15",0,0,0,0,0,0,0,0
"Denmark","2024-05-16",0,0,0,0,0,0,0,0
"Denmark","2024-05-17",0,0,0,0,0,0,0,0
"Denmark","2024-05-18",0,0,0,0,0,0,0,0
"Denmark","2024-05-19",0,0,0,0,0,0,0,0
"Denmark","2024-05-20",0,0,0,0,0,0,0,0
"Denmark","2024-05-21",0,0,0,0,0,0,0,0
"Denmark","2024-05-22",0,0,0,0,0,0,0,0
"Denmark","2024-05-23",0,0,0,0,0,0,0,0
"Denmark","2024-05-24",0,0,0,0,0,0,0,0
"Denmark","2024-05-25",0,0,0,0,0,0,0,0
"Denmark","2024-05-26",0,0,0,0,0,0,0,0
"Denmark","2024-05-27",0,0,0,0,0,0,0,0
"Denmark","2024-05-28",0,0,0,0,0,0,0,0
"Denmark","2024-05-29",0,0,0,0,0,0,0,0
"Denmark","2024-05-30",0,0,0,0,0,0,0,0
"Denmark","2024-05-31",0,0,0,0,0,0,0,0
"Denmark","2024-06-01",0,0,0,0,0,0,0,0
"Denmark","2024-06-02",0,0,0,0,0,0,0,0
"Denmark","2024-06-03",0,0,0,0,0,0,0,0
"Denmark","2024-06-04",0,0,0,0,0,0,0,0
"Denmark","2024-06-05",0,0,0,0,0,0,0,0
"Denmark","2024-06-06",0,0,0,0,0,0,0,0
"Denmark","2024-06-07",0,0,0,0,0,0,0,0
"Denmark","2024-06-08",0,0,0,0,0,0,0,0
"Denmark","2024-06-09",0,0,0,0,0,0,0,0
"Denmark","2024-06-10",0,0,0,0,0,0,0,0
"Denmark","2024-06-11",0,0,0,0,0,0,0,0
"Denmark","2024-06-12",0,0,0,0,0,0,0,0
"Denmark","2024-06-13",0,0,0,0,0,0,0,0
"Denmark","2024-06-14",0,0,0,0,0,0,0,0
"Denmark","2024-06-15",0,0,0,0,0,0,0,0
"Denmark","2024-06-16",0,0,0,0,0,0,0,0
"Denmark","2024-06-17",0,0,0,0,0,0,0,0
"Denmark","2024-06-18",0,0,0,0,0,0,0,0
"Denmark","2024-06-19",0,0,0,0,0,0,0,0
"Denmark","2024-06-20",0,0,0,0,0,0,0,0
"Denmark","2024-06-21",0,0,0,0,0,0,0,0
"Denmark","2024-06-22",0,0,0,0,0,0,0,0
"Denmark","2024-06-23",0,0,0,0,0,0,0,0
"Denmark","2024-06-24",0,0,0,0,0,0,0,0
"Denmark","2024-06-25",0,0,0,0,0,0,0,0
"Denmark","2024-06-26",0,0,0,0,0,0,0,0
"Denmark","2024-06-27",0,0,0,0,0,0,0,0
"Denmark","2024-06-28",0,0,0,0,0,0,0,0
"Denmark","2024-06-29",0,0,0,0,0,0,0,0
"Denmark","2024-06-30",0,0,0,0,0,0,0,0
"Denmark","2024-07-01",0,0,0,0,0,0,0,0
"Denmark","2024-07-02",0,0,0,0,0,0,0,0
"Denmark","2024-07-03",0,0,0,0,0,0,0,0
"Denmark","2024-07-04",0,0,0,0,0,0,0,0
"Denmark","2024-07-05",0,0,0,0,0,0,0,0
"Denmark","2024-07-06",0,0,0,0,0,0,0,0
"Denmark","2024-07-07",0,0,0,0,0,0,0,0
"Denmark","2024-07-08",0,0,0,0,0,0,0,0
"Denmark","2024-07-09",0,0,0,0,0,0,0,0
"Denmark","2024-07-10",0,0,0,0,0,0,0,0
"Denmark","2024-07-11",0,0,0,0,0,0,0,0
"Denmark","2024-07-12",0,0,0,0,0,0,0,0
"Denmark","2024-07-13",0,0,0,0,0,0,0,0
"Denmark","2024-07-14",0,0,0,0,0,0,0,0
"Denmark","2024-07-15",0,0,0,0,0,0,0,0
"Denmark","2024-07-16",0,0,0,0,0,0,0,0
"Denmark","2024-07-17",0,0,0,0,0,0,0,0
"Denmark","2024-07-18",0,0,0,0,0,0,0,0
"Denmark","2024-07-19",0,0,0,0,0,0,0,0
"Denmark","2024-07-20",0,0,0,0,0,0,0,0
"Denmark","2024-07-21",0,0,0,0,0,0,0,0
"Denmark","2024-07-22",0,0,0,0,0,0,0,0
"Denmark","2024-07-23",0,0,0,0,0,0,0,0
"Denmark","2024-07-24",0,0,0,0,0,0,0,0
"Denmark","2024-07-25",0,0,0,0,0,0,0,0
"Denmark","2024-07-26",0,0,0,0,0,0,0,0
"Denmark","2024-07-27",0,0,0,0,0,0,0,0
"Denmark","2024-07-28",0,0,0,0,0,0,0,0
"Denmark","2024-07-29",0,0,0,0,0,0,0,0
"Denmark","2024-07-30",0,0,0,0,0,0,0,0
"Denmark","2024-07-31",0,5,5,0,5,5,0,0
"Denmark","2024-08-01",0,0,5,0,0,5,0,0
"Denmark","2024-08-02",0,0,5,0,0,5,0,0
"Denmark","2024-08-03",0,0,5,0,0,5,0,0
"Denmark","2024-08-04",0,0,5,0,0,5,0,0
"Denmark","2024-08-05",0,0,5,0,0,5,0,0
"Denmark","2024-08-06",0,0,5,0,0,5,0,0
"Denmark","2024-08-07",0,0,5,0,0,5,0,0
"Denmark","2024-08-08",0,0,5,0,0,5,0,0
"Denmark","2024-08-09",0,0,5,0,0,5,0,0
"Denmark","2024-08-10",0,0,5,0,0,5,0,0
"Denmark","2024-08-11",0,0,5,0,0,5,0,0
"Denmark","2024-08-12",0,0,5,0,0,5,0,0
"Denmark","2024-08-13",0,0,5,0,0,5,0,0
"Denmark","2024-08-14",0,0,5,0,0,5,0,0
"Denmark","2024-08-15",0,0,5,0,0,5,0,0
"Denmark","2024-08-16",0,0,5,0,1,6,0,0
"Denmark","2024-08-17",0,0,5,0,0,6,0,0
"Denmark","2024-08-18",0,0,5,0,0,6,0,0
"Denmark","2024-08-19",0,0,5,0,0,6,0,0
"Denmark","2024-08-20",0,0,5,0,0,6,0,0
"Denmark","2024-08-21",0,0,5,0,0,6,0,0
"Denmark","2024-08-22",0,0,5,0,0,6,0,0
"Denmark","2024-08-23",0,0,5,0,0,6,0,0
"Denmark","2024-08-24",0,0,5,0,0,6,0,0
"Denmark","2024-08-25",0,0,5,0,0,6,0,0
"Denmark","2024-08-26",0,0,5,0,0,6,0,0
"Denmark","2024-08-27",0,0,5,0,0,6,0,0
"Denmark","2024-08-28",0,0,5,0,0,6,0,0
"Denmark","2024-08-29",0,0,5,0,0,6,0,0
"Denmark","2024-08-30",0,0,5,0,0,6,0,0
"Denmark","2024-08-31",0,1,6,0,0,6,0,0
"Denmark","2024-09-01",0,0,6,0,0,6,0,0
"Denmark","2024-09-02",0,0,6,0,0,6,0,0
"Denmark","2024-09-03",0,0,6,0,0,6,0,0
"Denmark","2024-09-04",0,0,6,0,1,7,0,0
"Denmark","2024-09-05",0,0,6,0,0,7,0,0
"Denmark","2024-09-06",0,0,6,0,0,7,0,0
"Denmark","2024-09-07",0,0,6,0,0,7,0,0
"Denmark","2024-09-08",0,0,6,0,0,7,0,0
"Denmark","2024-09-09",0,0,6,0,1,8,0,0
"Denmark","2024-09-10",0,0,6,0,0,8,0,0
"Denmark","2024-09-11",0,0,6,0,0,8,0,0
"Denmark","2024-09-12",0,0,6,0,0,8,0,0
"Denmark","2024-09-13",0,0,6,0,0,8,0,0
"Denmark","2024-09-14",0,0,6,0,0,8,0,0
"Denmark","2024-09-15",0,0,6,0,0,8,0,0
"Denmark","2024-09-16",0,0,6,0,1,9,0,0
"Denmark","2024-09-17",0,0,6,0,0,9,0,0
"Denmark","2024-09-18",0,0,6,0,0,9,0,0
"Denmark","2024-09-19",0,0,6,0,0,9,0,0
"Denmark","2024-09-20",0,0,6,0,0,9,0,0
"Denmark","2024-09-21",0,0,6,0,1,10,0,0
"Denmark","2024-09-22",0,0,6,0,0,10,0,0
"Denmark","2024-09-23",0,0,6,0,0,10,0,0
"Denmark","2024-09-24",0,0,6,0,0,10,0,0
"Denmark","2024-09-25",0,0,6,0,0,10,0,0
"Denmark","2024-09-26",0,0,6,0,0,10,0,0
"Denmark","2024-09-27",0,0,6,0,0,10,0,0
"Denmark","2024-09-28",0,0,6,0,1,11,0,0
"Denmark","2024-09-29",0,0,6,0,0,11,0,0
"Denmark","2024-09-30",0,5,11,0,0,11,0,0
"Denmark","2024-10-01",0,0,11,0,0,11,0,0
"Denmark","2024-10-02",0,0,11,0,0,11,0,0
"Denmark","2024-10-03",0,0,11,0,0,11,0,0
"Denmark","2024-10-04",0,0,11,0,0,11,0,0
"Denmark","2024-10-05",0,0,11,0,0,11,0,0
"Denmark","2024-10-06",0,0,11,0,0,11,0,0
"Denmark","2024-10-07",0,0,11,0,0,11,0,0
"Denmark","2024-10-08",0,0,11,0,0,11,0,0
"Denmark","2024-10-09",0,0,11,0,0,11,0,0
"Denmark","2024-10-10",0,0,11,0,0,11,0,0
"Denmark","2024-10-11",0,0,11,0,0,11,0,0
"Denmark","2024-10-12",0,0,11,0,0,11,0,0
"Denmark","2024-10-13",0,0,11,0,0,11,0,0
"Denmark","2024-10-14",0,0,11,0,0,11,0,0
"Denmark","2024-10-15",0,0,11,0,0,11,0,0
"Denmark","2024-10-16",0,0,11,0,0,11,0,0
"Denmark","2024-10-17",0,0,11,0,0,11,0,0
"Denmark","2024-10-18",0,0,11,0,0,11,0,0
"Denmark","2024-10-19",0,0,11,0,0,11,0,0
"Denmark","2024-10-20",0,0,11,0,0,11,0,0
"Denmark","2024-10-21",0,0,11,0,0,11,0,0
"Denmark","2024-10-22",0,0,11,0,0,11,0,0
"Denmark","2024-10-23",0,0,11,0,0,11,0,0
"Denmark","2024-10-24",0,0,11,0,1,12,0,0
"Denmark","2024-10-25",0,0,11,0,0,12,0,0
"Denmark","2024-10-26",0,0,11,0,0,12,0,0
"Denmark","2024-10-27",0,0,11,0,0,12,0,0
"Denmark","2024-10-28",0,0,11,0,0,12,0,0
"Denmark","2024-10-29",0,0,11,0,0,12,0,0
"Denmark","2024-10-30",0,0,11,0,0,12,0,0
"Denmark","2024-10-31",0,0,11,0,0,12,0,0
"Denmark","2024-11-01",0,0,11,0,0,12,0,0
"Denmark","2024-11-02",0,0,11,0,0,12,0,0
"Denmark","2024-11-03",0,0,11,0,0,12,0,0
"Denmark","2024-11-04",0,0,11,0,0,12,0,0
"Denmark","2024-11-05",0,0,11,0,0,12,0,0
"Denmark","2024-11-06",0,0,11,0,0,12,0,0
"Denmark","2024-11-07",0,0,11,0,0,12,0,0
"Denmark","2024-11-08",0,0,11,0,0,12,0,0
"Denmark","2024-11-09",0,0,11,0,0,12,0,0
"Denmark","2024-11-10",0,0,11,0,0,12,0,0
"Denmark","2024-11-11",0,0,11,0,0,12,0,0
"Denmark","2024-11-12",0,0,11,0,0,12,0,0
"Denmark","2024-11-13",0,0,11,0,0,12,0,0
"Denmark","2024-11-14",0,0,11,0,0,12,0,0
"Denmark","2024-11-15",0,0,11,0,0,12,0,0
"Denmark","2024-11-16",0,0,11,0,0,12,0,0
"Denmark","2024-11-17",0,0,11,0,0,12,0,0
"Denmark","2024-11-18",0,0,11,0,0,12,0,0
"Denmark","2024-11-19",0,0,11,0,0,12,0,0
"Denmark","2024-11-20",0,0,11,0,0,12,0,0
"Denmark","2024-11-21",0,0,11,0,0,12,0,0
"Denmark","2024-11-22",0,0,11,0,0,12,0,0
"Denmark","2024-11-23",0,0,11,0,0,12,0,0
"Denmark","2024-11-24",0,0,11,0,0,12,0,0
"Denmark","2024-11-25",0,0,11,0,0,12,0,0
"Denmark","2024-11-26",0,0,11,0,0,12,0,0
"Denmark","2024-11-27",0,0,11,0,0,12,0,0
"Denmark","2024-11-28",0,0,11,0,0,12,0,0
"Denmark","2024-11-29",0,0,11,0,0,12,0,0
"Denmark","2024-11-30",0,0,11,0,0,12,0,0
"Denmark","2024-12-01",0,0,11,0,0,12,0,0
"Denmark","2024-12-02",0,0,11,0,0,12,0,0
"Denmark","2024-12-03",0,0,11,0,0,12,0,0
"Denmark","2024-12-04",0,0,11,0,0,12,0,0
"Denmark","2024-12-05",0,0,11,0,0,12,0,0
"Denmark","2024-12-06",0,0,11,0,0,12,0,0
"Denmark","2024-12-07",0,0,11,0,0,12,0,0
"Denmark","2024-12-08",0,0,11,0,1,13,0,0
"Denmark","2024-12-09",0,0,11,0,0,13,0,0
"Denmark","2024-12-10",0,0,11,0,0,13,0,0
"Denmark","2024-12-11",0,0,11,0,0,13,0,0
"Denmark","2024-12-12",0,0,11,0,0,13,0,0
"Denmark","2024-12-13",0,0,11,0,0,13,0,0
"Denmark","2024-12-14",0,0,11,0,0,13,0,0
"Denmark","2024-12-15",0,0,11,0,0,13,0,0
"Denmark","2024-12-16",0,0,11,0,0,13,0,0
"Denmark","2024-12-17",0,0,11,0,0,13,0,0
"Denmark","2024-12-18",0,0,11,0,0,13,0,0
"Denmark","2024-12-19",0,0,11,0,0,13,0,0
"Denmark","2024-12-20",0,0,11,0,0,13,0,0
"Denmark","2024-12-21",0,0,11,0,0,13,0,0
"Denmark","2024-12-22",0,0,11,0,0,13,0,0
"Denmark","2024-12-23",0,0,11,0,0,13,0,0
"Denmark","2024-12-24",0,0,11,0,0,13,0,0
"Denmark","2024-12-25",0,0,11,0,0,13,0,0
"Denmark","2024-12-26",0,0,11,0,0,13,0,0
"Denmark","2024-12-27",0,0,11,0,0,13,0,0
"Denmark","2024-12-28",0,0,11,0,0,13,0,0
"Denmark","2024-12-29",0,0,11,0,0,13,0,0
"Denmark","2024-12-30",0,0,11,0,0,13,0,0
"Denmark","2024-12-31",0,2,13,0,0,13,0,0
"Denmark","2025-01-01",0,0,13,0,0,13,0,0
"Denmark","2025-01-02",0,0,13,0,0,13,0,0
"Denmark","2025-01-03",0,0,13,0,0,13,0,0
"Denmark","2025-01-04",0,0,13,0,0,13,0,0
"Denmark","2025-01-05",0,0,13,0,0,13,0,0
"Denmark","2025-01-06",0,0,13,0,0,13,0,0
"Denmark","2025-01-07",0,0,13,0,0,13,0,0
"Denmark","2025-01-08",0,0,13,0,0,13,0,0
"Denmark","2025-01-09",0,0,13,0,0,13,0,0
"Denmark","2025-01-10",0,0,13,0,0,13,0,0
"Denmark","2025-01-11",0,0,13,0,0,13,0,0
"Denmark","2025-01-12",0,0,13,0,0,13,0,0
"Denmark","2025-01-13",0,0,13,0,0,13,0,0
"Denmark","2025-01-14",0,0,13,0,0,13,0,0
"Denmark","2025-01-15",0,0,13,0,0,13,0,0
"Denmark","2025-01-16",0,0,13,0,0,13,0,0
"Denmark","2025-01-17",0,0,13,0,0,13,0,0
"Denmark","2025-01-18",0,0,13,0,0,13,0,0
"Denmark","2025-01-19",0,0,13,0,0,13,0,0
"Denmark","2025-01-20",0,0,13,0,0,13,0,0
"Denmark","2025-01-21",0,0,13,0,0,13,0,0
"Denmark","2025-01-22",0,0,13,0,0,13,0,0
"Denmark","2025-01-23",0,0,13,0,0,13,0,0
"Denmark","2025-01-24",0,0,13,0,0,13,0,0
"Denmark","2025-01-25",0,0,13,0,0,13,0,0
"Denmark","2025-01-26",0,0,13,0,0,13,0,0
"Denmark","2025-01-27",0,0,13,0,0,13,0,0
"Denmark","2025-01-28",0,0,13,0,0,13,0,0
"Denmark","2025-01-29",0,0,13,0,0,13,0,0
"Denmark","2025-01-30",0,0,13,0,0,13,0,0
"Denmark","2025-01-31",0,0,13,0,0,13,0,0
"Denmark","2025-02-01",0,0,13,0,0,13,0,0
"Denmark","2025-02-02",0,0,13,0,0,13,0,0
"Denmark","2025-02-03",0,0,13,0,0,13,0,0
"Dominican Republic","2024-01-01",0,0,0,0,0,0,0,0
"Dominican Republic","2024-01-02",0,0,0,0,0,0,0,0
"Dominican Republic","2024-01-03",0,0,0,0,0,0,0,0
"Dominican Republic","2024-01-04",0,0,0,0,0,0,0,0
"Dominican Republic","2024-01-05",0,0,0,0,0,0,0,0
"Dominican Republic","2024-01-06",0,0,0,0,0,0,0,0
"Dominican Republic","2024-01-07",0,0,0,0,0,0,0,0
"Dominican Republic","2024-01-08",0,0,0,0,0,0,0,0
"Dominican Republic","2024-01-09",0,0,0,0,0,0,0,0
"Dominican Republic","2024-01-10",0,0,0,0,0,0,0,0
"Dominican Republic","2024-01-11",0,0,0,0,0,0,0,0
"Dominican Republic","2024-01-12",0,0,0,0,0,0,0,0
"Dominican Republic","2024-01-13",0,0,0,0,0,0,0,0
"Dominican Republic","2024-01-14",0,0,0,0,0,0,0,0
"Dominican Republic","2024-01-15",0,0,0,0,0,0,0,0
"Dominican Republic","2024-01-16",0,0,0,0,0,0,0,0
"Dominican Republic","2024-01-17",0,0,0,0,0,0,0,0
"Dominican Republic","2024-01-18",0,0,0,0,0,0,0,0
"Dominican Republic","2024-01-19",0,0,0,0,0,0,0,0
"Dominican Republic","2024-01-20",0,0,0,0,0,0,0,0
"Dominican Republic","2024-01-21",0,0,0,0,0,0,0,0
"Dominican Republic","2024-01-22",0,0,0,0,0,0,0,0
"Dominican Republic","2024-01-23",0,0,0,0,0,0,0,0
"Dominican Republic","2024-01-24",0,0,0,0,0,0,0,0
"Dominican Republic","2024-01-25",0,0,0,0,0,0,0,0
"Dominican Republic","2024-01-26",0,0,0,0,0,0,0,0
"Dominican Republic","2024-01-27",0,0,0,0,0,0,0,0
"Dominican Republic","2024-01-28",0,0,0,0,0,0,0,0
"Dominican Republic","2024-01-29",0,0,0,0,0,0,0,0
"Dominican Republic","2024-01-30",0,0,0,0,0,0,0,0
"Dominican Republic","2024-01-31",0,0,0,0,0,0,0,0
"Dominican Republic","2024-02-01",0,0,0,0,0,0,0,0
"Dominican Republic","2024-02-02",0,0,0,0,0,0,0,0
"Dominican Republic","2024-02-03",0,0,0,0,0,0,0,0
"Dominican Republic","2024-02-04",0,0,0,0,0,0,0,0
"Dominican Republic","2024-02-05",0,0,0,0,0,0,0,0
"Dominican Republic","2024-02-06",0,0,0,0,0,0,0,0
"Dominican Republic","2024-02-07",0,0,0,0,0,0,0,0
"Dominican Republic","2024-02-08",0,0,0,0,0,0,0,0
"Dominican Republic","2024-02-09",0,0,0,0,0,0,0,0
"Dominican Republic","2024-02-10",0,0,0,0,0,0,0,0
"Dominican Republic","2024-02-11",0,0,0,0,0,0,0,0
"Dominican Republic","2024-02-12",0,0,0,0,0,0,0,0
"Dominican Republic","2024-02-13",0,0,0,0,0,0,0,0
"Dominican Republic","2024-02-14",0,0,0,0,0,0,0,0
"Dominican Republic","2024-02-15",0,0,0,0,0,0,0,0
"Dominican Republic","2024-02-16",0,0,0,0,0,0,0,0
"Dominican Republic","2024-02-17",0,0,0,0,0,0,0,0
"Dominican Republic","2024-02-18",0,0,0,0,0,0,0,0
"Dominican Republic","2024-02-19",0,0,0,0,0,0,0,0
"Dominican Republic","2024-02-20",0,2,2,0,2,2,0,0
"Dominican Republic","2024-02-21",0,0,2,0,0,2,0,0
"Dominican Republic","2024-02-22",0,0,2,0,1,3,0,0
"Dominican Republic","2024-02-23",0,0,2,0,0,3,0,0
"Dominican Republic","2024-02-24",0,0,2,0,0,3,0,0
"Dominican Republic","2024-02-25",0,0,2,0,0,3,0,0
"Dominican Republic","2024-02-26",0,0,2,0,1,4,0,0
"Dominican Republic","2024-02-27",0,2,4,0,0,4,0,0
"Dominican Republic","2024-02-28",0,0,4,0,0,4,0,0
"Dominican Republic","2024-02-29",0,0,4,0,0,4,0,0
"Dominican Republic","2024-03-01",0,0,4,0,0,4,0,0
"Dominican Republic","2024-03-02",0,0,4,0,0,4,0,0
"Dominican Republic","2024-03-03",0,0,4,0,0,4,0,0
"Dominican Republic","2024-03-04",0,0,4,0,0,4,0,0
"Dominican Republic","2024-03-05",0,0,4,0,0,4,0,0
"Dominican Republic","2024-03-06",0,0,4,0,1,5,0,0
"Dominican Republic","2024-03-07",0,0,4,0,0,5,0,0
"Dominican Republic","2024-03-08",0,0,4,0,0,5,0,0
"Dominican Republic","2024-03-09",0,0,4,0,0,5,0,0
"Dominican Republic","2024-03-10",0,0,4,0,0,5,0,0
"Dominican Republic","2024-03-11",0,0,4,0,0,5,0,0
"Dominican Republic","2024-03-12",0,1,5,0,0,5,0,0
"Dominican Republic","2024-03-13",0,0,5,0,0,5,0,0
"Dominican Republic","2024-03-14",0,0,5,0,0,5,0,0
"Dominican Republic","2024-03-15",0,0,5,0,0,5,0,0
"Dominican Republic","2024-03-16",0,0,5,0,1,6,0,0
"Dominican Republic","2024-03-17",0,0,5,0,0,6,0,0
"Dominican Republic","2024-03-18",0,0,5,0,0,6,0,0
"Dominican Republic","2024-03-19",0,1,6,0,0,6,0,0
"Dominican Republic","2024-03-20",0,0,6,0,0,6,0,0
"Dominican Republic","2024-03-21",0,0,6,0,0,6,0,0
"Dominican Republic","2024-03-22",0,0,6,0,0,6,0,0
"Dominican Republic","2024-03-23",0,0,6,0,0,6,0,0
"Dominican Republic","2024-03-24",0,0,6,0,0,6,0,0
"Dominican Republic","2024-03-25",0,0,6,0,0,6,0,0
"Dominican Republic","2024-03-26",0,0,6,0,0,6,0,0
"Dominican Republic","2024-03-27",0,0,6,0,0,6,0,0
"Dominican Republic","2024-03-28",0,0,6,0,0,6,0,0
"Dominican Republic","2024-03-29",0,0,6,0,0,6,0,0
"Dominican Republic","2024-03-30",0,0,6,0,0,6,0,0
"Dominican Republic","2024-03-31",0,0,6,0,0,6,0,0
"Dominican Republic","2024-04-01",0,0,6,0,0,6,0,0
"Dominican Republic","2024-04-02",0,0,6,0,0,6,0,0
"Dominican Republic","2024-04-03",0,0,6,0,1,7,0,0
"Dominican Republic","2024-04-04",0,0,6,0,0,7,0,0
"Dominican Republic","2024-04-05",0,0,6,0,0,7,0,0
"Dominican Republic","2024-04-06",0,0,6,0,0,7,0,0
"Dominican Republic","2024-04-07",0,0,6,0,0,7,0,0
"Dominican Republic","2024-04-08",0,0,6,0,0,7,0,0
"Dominican Republic","2024-04-09",0,0,6,0,0,7,0,0
"Dominican Republic","2024-04-10",0,0,6,0,0,7,0,0
"Dominican Republic","2024-04-11",0,0,6,0,0,7,0,0
"Dominican Republic","2024-04-12",0,0,6,0,0,7,0,0
"Dominican Republic","2024-04-13",0,0,6,0,0,7,0,0
"Dominican Republic","2024-04-14",0,0,6,0,0,7,0,0
"Dominican Republic","2024-04-15",0,0,6,0,0,7,0,0
"Dominican Republic","2024-04-16",0,1,7,0,0,7,0,0
"Dominican Republic","2024-04-17",0,0,7,0,0,7,0,0
"Dominican Republic","2024-04-18",0,0,7,0,0,7,0,0
"Dominican Republic","2024-04-19",0,0,7,0,0,7,0,0
"Dominican Republic","2024-04-20",0,0,7,0,1,8,0,0
"Dominican Republic","2024-04-21",0,0,7,0,0,8,0,0
"Dominican Republic","2024-04-22",0,0,7,0,0,8,0,0
"Dominican Republic","2024-04-23",0,1,8,0,0,8,0,0
"Dominican Republic","2024-04-24",0,0,8,0,0,8,0,0
"Dominican Republic","2024-04-25",0,0,8,0,0,8,0,0
"Dominican Republic","2024-04-26",0,0,8,0,0,8,0,0
"Dominican Republic","2024-04-27",0,0,8,0,0,8,0,0
"Dominican Republic","2024-04-28",0,0,8,0,0,8,0,0
"Dominican Republic","2024-04-29",0,0,8,0,0,8,0,0
"Dominican Republic","2024-04-30",0,0,8,0,0,8,0,0
"Dominican Republic","2024-05-01",0,0,8,0,0,8,0,0
"Dominican Republic","2024-05-02",0,0,8,0,0,8,0,0
"Dominican Republic","2024-05-03",0,0,8,0,0,8,0,0
"Dominican Republic","2024-05-04",0,0,8,0,0,8,0,0
"Dominican Republic","2024-05-05",0,0,8,0,0,8,0,0
"Dominican Republic","2024-05-06",0,0,8,0,0,8,0,0
"Dominican Republic","2024-05-07",0,0,8,0,0,8,0,0
"Dominican Republic","2024-05-08",0,0,8,0,0,8,0,0
"Dominican Republic","2024-05-09",0,0,8,0,0,8,0,0
"Dominican Republic","2024-05-10",0,0,8,0,0,8,0,0
"Dominican Republic","2024-05-11",0,0,8,0,0,8,0,0
"Dominican Republic","2024-05-12",0,0,8,0,0,8,0,0
"Dominican Republic","2024-05-13",0,0,8,0,0,8,0,0
"Dominican Republic","2024-05-14",0,0,8,0,0,8,0,0
"Dominican Republic","2024-05-15",0,0,8,0,0,8,0,0
"Dominican Republic","2024-05-16",0,0,8,0,0,8,0,0
"Dominican Republic","2024-05-17",0,0,8,0,0,8,0,0
"Dominican Republic","2024-05-18",0,0,8,0,0,8,0,0
"Dominican Republic","2024-05-19",0,0,8,0,0,8,0,0
"Dominican Republic","2024-05-20",0,0,8,0,0,8,0,0
"Dominican Republic","2024-05-21",0,0,8,0,0,8,0,0
"Dominican Republic","2024-05-22",0,0,8,0,0,8,0,0
"Dominican Republic","2024-05-23",0,0,8,0,0,8,0,0
"Dominican Republic","2024-05-24",0,0,8,0,0,8,0,0
"Dominican Republic","2024-05-25",0,0,8,0,0,8,0,0
"Dominican Republic","2024-05-26",0,0,8,0,0,8,0,0
"Dominican Republic","2024-05-27",0,0,8,0,0,8,0,0
"Dominican Republic","2024-05-28",0,0,8,0,0,8,0,0
"Dominican Republic","2024-05-29",0,0,8,0,0,8,0,0
"Dominican Republic","2024-05-30",0,0,8,0,0,8,0,0
"Dominican Republic","2024-05-31",0,0,8,0,0,8,0,0
"Dominican Republic","2024-06-01",0,0,8,0,0,8,0,0
"Dominican Republic","2024-06-02",0,0,8,0,0,8,0,0
"Dominican Republic","2024-06-03",0,0,8,0,0,8,0,0
"Dominican Republic","2024-06-04",0,0,8,0,0,8,0,0
"Dominican Republic","2024-06-05",0,0,8,0,0,8,0,0
"Dominican Republic","2024-06-06",0,0,8,0,0,8,0,0
"Dominican Republic","2024-06-07",0,0,8,0,0,8,0,0
"Dominican Republic","2024-06-08",0,0,8,0,0,8,0,0
"Dominican Republic","2024-06-09",0,0,8,0,0,8,0,0
"Dominican Republic","2024-06-10",0,0,8,0,0,8,0,0
"Dominican Republic","2024-06-11",0,0,8,0,0,8,0,0
"Dominican Republic","2024-06-12",0,0,8,0,0,8,0,0
"Dominican Republic","2024-06-13",0,0,8,0,0,8,0,0
"Dominican Republic","2024-06-14",0,0,8,0,0,8,0,0
"Dominican Republic","2024-06-15",0,0,8,0,0,8,0,0
"Dominican Republic","2024-06-16",0,0,8,0,0,8,0,0
"Dominican Republic","2024-06-17",0,0,8,0,0,8,0,0
"Dominican Republic","2024-06-18",0,0,8,0,0,8,0,0
"Dominican Republic","2024-06-19",0,0,8,0,0,8,0,0
"Dominican Republic","2024-06-20",0,0,8,0,0,8,0,0
"Dominican Republic","2024-06-21",0,0,8,0,0,8,0,0
"Dominican Republic","2024-06-22",0,0,8,0,0,8,0,0
"Dominican Republic","2024-06-23",0,0,8,0,0,8,0,0
"Dominican Republic","2024-06-24",0,0,8,0,0,8,0,0
"Dominican Republic","2024-06-25",0,0,8,0,0,8,0,0
"Dominican Republic","2024-06-26",0,0,8,0,0,8,0,0
"Dominican Republic","2024-06-27",0,0,8,0,0,8,0,0
"Dominican Republic","2024-06-28",0,0,8,0,0,8,0,0
"Dominican Republic","2024-06-29",0,0,8,0,0,8,0,0
"Dominican Republic","2024-06-30",0,0,8,0,0,8,0,0
"Dominican Republic","2024-07-01",0,0,8,0,0,8,0,0
"Dominican Republic","2024-07-02",0,0,8,0,0,8,0,0
"Dominican Republic","2024-07-03",0,0,8,0,0,8,0,0
"Dominican Republic","2024-07-04",0,0,8,0,0,8,0,0
"Dominican Republic","2024-07-05",0,0,8,0,0,8,0,0
"Dominican Republic","2024-07-06",0,0,8,0,0,8,0,0
"Dominican Republic","2024-07-07",0,0,8,0,0,8,0,0
"Dominican Republic","2024-07-08",0,0,8,0,0,8,0,0
"Dominican Republic","2024-07-09",0,0,8,0,0,8,0,0
"Dominican Republic","2024-07-10",0,0,8,0,0,8,0,0
"Dominican Republic","2024-07-11",0,0,8,0,0,8,0,0
"Dominican Republic","2024-07-12",0,0,8,0,0,8,0,0
"Dominican Republic","2024-07-13",0,0,8,0,0,8,0,0
"Dominican Republic","2024-07-14",0,0,8,0,0,8,0,0
"Dominican Republic","2024-07-15",0,0,8,0,0,8,0,0
"Dominican Republic","2024-07-16",0,0,8,0,0,8,0,0
"Dominican Republic","2024-07-17",0,0,8,0,0,8,0,0
"Dominican Republic","2024-07-18",0,0,8,0,0,8,0,0
"Dominican Republic","2024-07-19",0,0,8,0,0,8,0,0
"Dominican Republic","2024-07-20",0,0,8,0,0,8,0,0
"Dominican Republic","2024-07-21",0,0,8,0,0,8,0,0
"Dominican Republic","2024-07-22",0,0,8,0,0,8,0,0
"Dominican Republic","2024-07-23",0,0,8,0,0,8,0,0
"Dominican Republic","2024-07-24",0,0,8,0,0,8,0,0
"Dominican Republic","2024-07-25",0,0,8,0,0,8,0,0
"Dominican Republic","2024-07-26",0,0,8,0,0,8,0,0
"Dominican Republic","2024-07-27",0,0,8,0,0,8,0,0
"Dominican Republic","2024-07-28",0,0,8,0,0,8,0,0
"Dominican Republic","2024-07-29",0,0,8,0,0,8,0,0
"Dominican Republic","2024-07-30",0,0,8,0,0,8,0,0
"Dominican Republic","2024-07-31",0,0,8,0,0,8,0,0
"Dominican Republic","2024-08-01",0,0,8,0,0,8,0,0
"Dominican Republic","2024-08-02",0,0,8,0,0,8,0,0
"Dominican Republic","2024-08-03",0,0,8,0,0,8,0,0
"Dominican Republic","2024-08-04",0,0,8,0,0,8,0,0
"Dominican Republic","2024-08-05",0,0,8,0,0,8,0,0
"Dominican Republic","2024-08-06",0,0,8,0,0,8,0,0
"Dominican Republic","2024-08-07",0,0,8,0,0,8,0,0
"Dominican Republic","2024-08-08",0,0,8,0,0,8,0,0
"Dominican Republic","2024-08-09",0,0,8,0,0,8,0,0
"Dominican Republic","2024-08-10",0,0,8,0,0,8,0,0
"Dominican Republic","2024-08-11",0,0,8,0,0,8,0,0
"Dominican Republic","2024-08-12",0,0,8,0,0,8,0,0
"Dominican Republic","2024-08-13",0,0,8,0,0,8,0,0
"Dominican Republic","2024-08-14",0,0,8,0,0,8,0,0
"Dominican Republic","2024-08-15",0,0,8,0,0,8,0,0
"Dominican Republic","2024-08-16",0,0,8,0,0,8,0,0
"Dominican Republic","2024-08-17",0,0,8,0,0,8,0,0
"Dominican Republic","2024-08-18",0,0,8,0,0,8,0,0
"Dominican Republic","2024-08-19",0,0,8,0,0,8,0,0
"Dominican Republic","2024-08-20",0,0,8,0,0,8,0,0
"Dominican Republic","2024-08-21",0,0,8,0,0,8,0,0
"Dominican Republic","2024-08-22",0,0,8,0,0,8,0,0
"Dominican Republic","2024-08-23",0,0,8,0,0,8,0,0
"Dominican Republic","2024-08-24",0,0,8,0,0,8,0,0
"Dominican Republic","2024-08-25",0,0,8,0,0,8,0,0
"Dominican Republic","2024-08-26",0,0,8,0,0,8,0,0
"Dominican Republic","2024-08-27",0,0,8,0,0,8,0,0
"Dominican Republic","2024-08-28",0,0,8,0,0,8,0,0
"Dominican Republic","2024-08-29",0,0,8,0,0,8,0,0
"Dominican Republic","2024-08-30",0,0,8,0,0,8,0,0
"Dominican Republic","2024-08-31",0,0,8,0,0,8,0,0
"Dominican Republic","2024-09-01",0,0,8,0,0,8,0,0
"Dominican Republic","2024-09-02",0,0,8,0,0,8,0,0
"Dominican Republic","2024-09-03",0,0,8,0,0,8,0,0
"Dominican Republic","2024-09-04",0,0,8,0,0,8,0,0
"Dominican Republic","2024-09-05",0,0,8,0,0,8,0,0
"Dominican Republic","2024-09-06",0,0,8,0,0,8,0,0
"Dominican Republic","2024-09-07",0,0,8,0,0,8,0,0
"Dominican Republic","2024-09-08",0,0,8,0,0,8,0,0
"Dominican Republic","2024-09-09",0,0,8,0,0,8,0,0
"Dominican Republic","2024-09-10",0,0,8,0,0,8,0,0
"Dominican Republic","2024-09-11",0,0,8,0,0,8,0,0
"Dominican Republic","2024-09-12",0,0,8,0,0,8,0,0
"Dominican Republic","2024-09-13",0,0,8,0,0,8,0,0
"Dominican Republic","2024-09-14",0,0,8,0,0,8,0,0
"Dominican Republic","2024-09-15",0,0,8,0,0,8,0,0
"Dominican Republic","2024-09-16",0,0,8,0,0,8,0,0
"Dominican Republic","2024-09-17",0,0,8,0,0,8,0,0
"Dominican Republic","2024-09-18",0,0,8,0,0,8,0,0
"Dominican Republic","2024-09-19",0,0,8,0,0,8,0,0
"Dominican Republic","2024-09-20",0,0,8,0,0,8,0,0
"Dominican Republic","2024-09-21",0,0,8,0,0,8,0,0
"Dominican Republic","2024-09-22",0,0,8,0,0,8,0,0
"Dominican Republic","2024-09-23",0,0,8,0,0,8,0,0
"Dominican Republic","2024-09-24",0,0,8,0,0,8,0,0
"Dominican Republic","2024-09-25",0,0,8,0,0,8,0,0
"Dominican Republic","2024-09-26",0,0,8,0,0,8,0,0
"Dominican Republic","2024-09-27",0,0,8,0,0,8,0,0
"Dominican Republic","2024-09-28",0,0,8,0,0,8,0,0
"Dominican Republic","2024-09-29",0,0,8,0,0,8,0,0
"Dominican Republic","2024-09-30",0,0,8,0,0,8,0,0
"Dominican Republic","2024-10-01",0,0,8,0,0,8,0,0
"Dominican Republic","2024-10-02",0,0,8,0,0,8,0,0
"Dominican Republic","2024-10-03",0,0,8,0,0,8,0,0
"Dominican Republic","2024-10-04",0,0,8,0,0,8,0,0
"Dominican Republic","2024-10-05",0,0,8,0,0,8,0,0
"Dominican Republic","2024-10-06",0,0,8,0,0,8,0,0
"Dominican Republic","2024-10-07",0,0,8,0,0,8,0,0
"Dominican Republic","2024-10-08",0,0,8,0,0,8,0,0
"Dominican Republic","2024-10-09",0,0,8,0,0,8,0,0
"Dominican Republic","2024-10-10",0,0,8,0,0,8,0,0
"Dominican Republic","2024-10-11",0,0,8,0,0,8,0,0
"Dominican Republic","2024-10-12",0,0,8,0,0,8,0,0
"Dominican Republic","2024-10-13",0,0,8,0,0,8,0,0
"Dominican Republic","2024-10-14",0,0,8,0,0,8,0,0
"Dominican Republic","2024-10-15",0,0,8,0,0,8,0,0
"Dominican Republic","2024-10-16",0,0,8,0,0,8,0,0
"Dominican Republic","2024-10-17",0,0,8,0,0,8,0,0
"Dominican Republic","2024-10-18",0,0,8,0,0,8,0,0
"Dominican Republic","2024-10-19",0,0,8,0,0,8,0,0
"Dominican Republic","2024-10-20",0,0,8,0,0,8,0,0
"Dominican Republic","2024-10-21",0,0,8,0,0,8,0,0
"Dominican Republic","2024-10-22",0,0,8,0,0,8,0,0
"Dominican Republic","2024-10-23",0,0,8,0,0,8,0,0
"Dominican Republic","2024-10-24",0,0,8,0,0,8,0,0
"Dominican Republic","2024-10-25",0,0,8,0,0,8,0,0
"Dominican Republic","2024-10-26",0,0,8,0,0,8,0,0
"Dominican Republic","2024-10-27",0,0,8,0,0,8,0,0
"Dominican Republic","2024-10-28",0,0,8,0,0,8,0,0
"Dominican Republic","2024-10-29",0,0,8,0,0,8,0,0
"Dominican Republic","2024-10-30",0,0,8,0,0,8,0,0
"Dominican Republic","2024-10-31",0,0,8,0,0,8,0,0
"Dominican Republic","2024-11-01",0,0,8,0,0,8,0,0
"Dominican Republic","2024-11-02",0,0,8,0,0,8,0,0
"Dominican Republic","2024-11-03",0,0,8,0,0,8,0,0
"Dominican Republic","2024-11-04",0,0,8,0,0,8,0,0
"Dominican Republic","2024-11-05",0,0,8,0,0,8,0,0
"Dominican Republic","2024-11-06",0,0,8,0,0,8,0,0
"Dominican Republic","2024-11-07",0,0,8,0,0,8,0,0
"Dominican Republic","2024-11-08",0,0,8,0,0,8,0,0
"Dominican Republic","2024-11-09",0,0,8,0,0,8,0,0
"Dominican Republic","2024-11-10",0,0,8,0,0,8,0,0
"Dominican Republic","2024-11-11",0,0,8,0,0,8,0,0
"Dominican Republic","2024-11-12",0,0,8,0,0,8,0,0
"Dominican Republic","2024-11-13",0,0,8,0,0,8,0,0
"Dominican Republic","2024-11-14",0,0,8,0,0,8,0,0
"Dominican Republic","2024-11-15",0,0,8,0,0,8,0,0
"Dominican Republic","2024-11-16",0,0,8,0,0,8,0,0
"Dominican Republic","2024-11-17",0,0,8,0,0,8,0,0
"Dominican Republic","2024-11-18",0,0,8,0,0,8,0,0
"Dominican Republic","2024-11-19",0,0,8,0,0,8,0,0
"Dominican Republic","2024-11-20",0,0,8,0,0,8,0,0
"Dominican Republic","2024-11-21",0,0,8,0,0,8,0,0
"Dominican Republic","2024-11-22",0,0,8,0,0,8,0,0
"Dominican Republic","2024-11-23",0,0,8,0,0,8,0,0
"Dominican Republic","2024-11-24",0,0,8,0,0,8,0,0
"Dominican Republic","2024-11-25",0,0,8,0,0,8,0,0
"Dominican Republic","2024-11-26",0,0,8,0,0,8,0,0
"Dominican Republic","2024-11-27",0,0,8,0,0,8,0,0
"Dominican Republic","2024-11-28",0,0,8,0,0,8,0,0
"Dominican Republic","2024-11-29",0,0,8,0,0,8,0,0
"Dominican Republic","2024-11-30",0,0,8,0,0,8,0,0
"Dominican Republic","2024-12-01",0,0,8,0,0,8,0,0
"Dominican Republic","2024-12-02",0,0,8,0,0,8,0,0
"Dominican Republic","2024-12-03",0,0,8,0,0,8,0,0
"Dominican Republic","2024-12-04",0,0,8,0,0,8,0,0
"Dominican Republic","2024-12-05",0,0,8,0,0,8,0,0
"Dominican Republic","2024-12-06",0,0,8,0,0,8,0,0
"Dominican Republic","2024-12-07",0,0,8,0,0,8,0,0
"Dominican Republic","2024-12-08",0,0,8,0,0,8,0,0
"Dominican Republic","2024-12-09",0,0,8,0,0,8,0,0
"Dominican Republic","2024-12-10",0,0,8,0,0,8,0,0
"Dominican Republic","2024-12-11",0,0,8,0,0,8,0,0
"Dominican Republic","2024-12-12",0,0,8,0,0,8,0,0
"Dominican Republic","2024-12-13",0,0,8,0,0,8,0,0
"Dominican Republic","2024-12-14",0,0,8,0,0,8,0,0
"Dominican Republic","2024-12-15",0,0,8,0,0,8,0,0
"Dominican Republic","2024-12-16",0,0,8,0,0,8,0,0
"Dominican Republic","2024-12-17",0,0,8,0,0,8,0,0
"Dominican Republic","2024-12-18",0,0,8,0,0,8,0,0
"Dominican Republic","2024-12-19",0,0,8,0,0,8,0,0
"Dominican Republic","2024-12-20",0,0,8,0,0,8,0,0
"Dominican Republic","2024-12-21",0,0,8,0,0,8,0,0
"Dominican Republic","2024-12-22",0,0,8,0,0,8,0,0
"Dominican Republic","2024-12-23",0,0,8,0,0,8,0,0
"Dominican Republic","2024-12-24",0,0,8,0,0,8,0,0
"Dominican Republic","2024-12-25",0,0,8,0,0,8,0,0
"Dominican Republic","2024-12-26",0,0,8,0,0,8,0,0
"Dominican Republic","2024-12-27",0,0,8,0,0,8,0,0
"Dominican Republic","2024-12-28",0,0,8,0,0,8,0,0
"Dominican Republic","2024-12-29",0,0,8,0,0,8,0,0
"Dominican Republic","2024-12-30",0,0,8,0,0,8,0,0
"Dominican Republic","2024-12-31",0,0,8,0,0,8,0,0
"Dominican Republic","2025-01-01",0,0,8,0,0,8,0,0
"Dominican Republic","2025-01-02",0,0,8,0,0,8,0,0
"Dominican Republic","2025-01-03",0,0,8,0,0,8,0,0
"Dominican Republic","2025-01-04",0,0,8,0,0,8,0,0
"Dominican Republic","2025-01-05",0,0,8,0,0,8,0,0
"Dominican Republic","2025-01-06",0,0,8,0,0,8,0,0
"Dominican Republic","2025-01-07",0,0,8,0,0,8,0,0
"Dominican Republic","2025-01-08",0,0,8,0,0,8,0,0
"Dominican Republic","2025-01-09",0,0,8,0,0,8,0,0
"Dominican Republic","2025-01-10",0,0,8,0,0,8,0,0
"Dominican Republic","2025-01-11",0,0,8,0,0,8,0,0
"Dominican Republic","2025-01-12",0,0,8,0,0,8,0,0
"Dominican Republic","2025-01-13",0,0,8,0,0,8,0,0
"Dominican Republic","2025-01-14",0,0,8,0,0,8,0,0
"Dominican Republic","2025-01-15",0,0,8,0,0,8,0,0
"Dominican Republic","2025-01-16",0,0,8,0,0,8,0,0
"Dominican Republic","2025-01-17",0,0,8,0,0,8,0,0
"Dominican Republic","2025-01-18",0,0,8,0,0,8,0,0
"Dominican Republic","2025-01-19",0,0,8,0,0,8,0,0
"Dominican Republic","2025-01-20",0,0,8,0,0,8,0,0
"Dominican Republic","2025-01-21",0,0,8,0,0,8,0,0
"Dominican Republic","2025-01-22",0,0,8,0,0,8,0,0
"Dominican Republic","2025-01-23",0,0,8,0,0,8,0,0
"Dominican Republic","2025-01-24",0,0,8,0,0,8,0,0
"Dominican Republic","2025-01-25",0,0,8,0,0,8,0,0
"Dominican Republic","2025-01-26",0,0,8,0,0,8,0,0
"Dominican Republic","2025-01-27",0,0,8,0,0,8,0,0
"Dominican Republic","2025-01-28",0,0,8,0,0,8,0,0
"Dominican Republic","2025-01-29",0,0,8,0,0,8,0,0
"Dominican Republic","2025-01-30",0,0,8,0,0,8,0,0
"Dominican Republic","2025-01-31",0,0,8,0,0,8,0,0
"Dominican Republic","2025-02-01",0,0,8,0,0,8,0,0
"Dominican Republic","2025-02-02",0,0,8,0,0,8,0,0
"Dominican Republic","2025-02-03",0,0,8,0,0,8,0,0
"Ecuador","2024-01-01",0,0,0,0,0,0,0,0
"Ecuador","2024-01-02",0,0,0,0,0,0,0,0
"Ecuador","2024-01-03",0,0,0,0,0,0,0,0
"Ecuador","2024-01-04",0,0,0,0,0,0,0,0
"Ecuador","2024-01-05",0,0,0,0,0,0,0,0
"Ecuador","2024-01-06",0,0,0,0,0,0,0,0
"Ecuador","2024-01-07",0,0,0,0,0,0,0,0
"Ecuador","2024-01-08",0,0,0,0,0,0,0,0
"Ecuador","2024-01-09",0,0,0,0,0,0,0,0
"Ecuador","2024-01-10",0,0,0,0,0,0,0,0
"Ecuador","2024-01-11",0,0,0,0,0,0,0,0
"Ecuador","2024-01-12",0,0,0,0,0,0,0,0
"Ecuador","2024-01-13",0,0,0,0,0,0,0,0
"Ecuador","2024-01-14",0,0,0,0,0,0,0,0
"Ecuador","2024-01-15",0,0,0,0,0,0,0,0
"Ecuador","2024-01-16",0,0,0,0,0,0,0,0
"Ecuador","2024-01-17",0,0,0,0,0,0,0,0
"Ecuador","2024-01-18",0,0,0,0,0,0,0,0
"Ecuador","2024-01-19",0,0,0,0,0,0,0,0
"Ecuador","2024-01-20",0,0,0,0,0,0,0,0
"Ecuador","2024-01-21",0,0,0,0,0,0,0,0
"Ecuador","2024-01-22",0,0,0,0,0,0,0,0
"Ecuador","2024-01-23",0,0,0,0,0,0,0,0
"Ecuador","2024-01-24",0,0,0,0,0,0,0,0
"Ecuador","2024-01-25",0,0,0,0,0,0,0,0
"Ecuador","2024-01-26",0,0,0,0,0,0,0,0
"Ecuador","2024-01-27",0,0,0,0,0,0,0,0
"Ecuador","2024-01-28",0,0,0,0,0,0,0,0
"Ecuador","2024-01-29",0,0,0,0,0,0,0,0
"Ecuador","2024-01-30",0,0,0,0,0,0,0,0
"Ecuador","2024-01-31",0,0,0,0,0,0,0,0
"Ecuador","2024-02-01",0,0,0,0,0,0,0,0
"Ecuador","2024-02-02",0,0,0,0,0,0,0,0
"Ecuador","2024-02-03",0,0,0,0,0,0,0,0
"Ecuador","2024-02-04",0,0,0,0,0,0,0,0
"Ecuador","2024-02-05",0,0,0,0,0,0,0,0
"Ecuador","2024-02-06",0,1,1,0,1,1,0,0
"Ecuador","2024-02-07",0,0,1,0,0,1,0,0
"Ecuador","2024-02-08",0,0,1,0,0,1,0,0
"Ecuador","2024-02-09",0,0,1,0,0,1,0,0
"Ecuador","2024-02-10",0,0,1,0,0,1,0,0
"Ecuador","2024-02-11",0,0,1,0,0,1,0,0
"Ecuador","2024-02-12",0,0,1,0,0,1,0,0
"Ecuador","2024-02-13",0,0,1,0,0,1,0,0
"Ecuador","2024-02-14",0,0,1,0,0,1,0,0
"Ecuador","2024-02-15",0,0,1,0,0,1,0,0
"Ecuador","2024-02-16",0,0,1,0,0,1,0,0
"Ecuador","2024-02-17",0,0,1,0,0,1,0,0
"Ecuador","2024-02-18",0,0,1,0,0,1,0,0
"Ecuador","2024-02-19",0,0,1,0,0,1,0,0
"Ecuador","2024-02-20",0,0,1,0,0,1,0,0
"Ecuador","2024-02-21",0,0,1,0,0,1,0,0
"Ecuador","2024-02-22",0,0,1,0,0,1,0,0
"Ecuador","2024-02-23",0,0,1,0,0,1,0,0
"Ecuador","2024-02-24",0,0,1,0,1,2,0,0
"Ecuador","2024-02-25",0,0,1,0,0,2,0,0
"Ecuador","2024-02-26",0,0,1,0,0,2,0,0
"Ecuador","2024-02-27",0,0,1,0,0,2,0,0
"Ecuador","2024-02-28",0,0,1,0,0,2,0,0
"Ecuador","2024-02-29",0,0,1,0,0,2,0,0
"Ecuador","2024-03-01",0,0,1,0,0,2,0,0
"Ecuador","2024-03-02",0,0,1,0,0,2,0,0
"Ecuador","2024-03-03",0,0,1,0,0,2,0,0
"Ecuador","2024-03-04",0,0,1,0,0,2,0,0
"Ecuador","2024-03-05",0,0,1,0,0,2,0,0
"Ecuador","2024-03-06",0,0,1,0,0,2,0,0
"Ecuador","2024-03-07",0,0,1,0,0,2,0,0
"Ecuador","2024-03-08",0,0,1,0,0,2,0,0
"Ecuador","2024-03-09",0,0,1,0,0,2,0,0
"Ecuador","2024-03-10",0,0,1,0,0,2,0,0
"Ecuador","2024-03-11",0,0,1,0,0,2,0,0
"Ecuador","2024-03-12",0,1,2,0,0,2,0,0
"Ecuador","2024-03-13",0,0,2,0,0,2,0,0
"Ecuador","2024-03-14",0,0,2,0,0,2,0,0
"Ecuador","2024-03-15",0,0,2,0,0,2,0,0
"Ecuador","2024-03-16",0,0,2,0,0,2,0,0
"Ecuador","2024-03-17",0,0,2,0,0,2,0,0
"Ecuador","2024-03-18",0,0,2,0,0,2,0,0
"Ecuador","2024-03-19",0,0,2,0,0,2,0,0
"Ecuador","2024-03-20",0,0,2,0,0,2,0,0
"Ecuador","2024-03-21",0,0,2,0,0,2,0,0
"Ecuador","2024-03-22",0,0,2,0,0,2,0,0
"Ecuador","2024-03-23",0,0,2,0,0,2,0,0
"Ecuador","2024-03-24",0,0,2,0,0,2,0,0
"Ecuador","2024-03-25",0,0,2,0,0,2,0,0
"Ecuador","2024-03-26",0,0,2,0,0,2,0,0
"Ecuador","2024-03-27",0,0,2,0,0,2,0,0
"Ecuador","2024-03-28",0,0,2,0,0,2,0,0
"Ecuador","2024-03-29",0,0,2,0,0,2,0,0
"Ecuador","2024-03-30",0,0,2,0,0,2,0,0
"Ecuador","2024-03-31",0,0,2,0,0,2,0,0
"Ecuador","2024-04-01",0,0,2,0,0,2,0,0
"Ecuador","2024-04-02",0,0,2,0,0,2,0,0
"Ecuador","2024-04-03",0,0,2,0,1,3,0,0
"Ecuador","2024-04-04",0,0,2,0,0,3,0,0
"Ecuador","2024-04-05",0,0,2,0,0,3,0,0
"Ecuador","2024-04-06",0,0,2,0,0,3,0,0
"Ecuador","2024-04-07",0,0,2,0,0,3,0,0
"Ecuador","2024-04-08",0,0,2,0,0,3,0,0
"Ecuador","2024-04-09",0,0,2,0,0,3,0,0
"Ecuador","2024-04-10",0,0,2,0,0,3,0,0
"Ecuador","2024-04-11",0,0,2,0,0,3,0,0
"Ecuador","2024-04-12",0,0,2,0,0,3,0,0
"Ecuador","2024-04-13",0,0,2,0,0,3,0,0
"Ecuador","2024-04-14",0,0,2,0,0,3,0,0
"Ecuador","2024-04-15",0,0,2,0,0,3,0,0
"Ecuador","2024-04-16",0,0,2,0,0,3,0,0
"Ecuador","2024-04-17",0,0,2,0,0,3,0,0
"Ecuador","2024-04-18",0,0,2,0,0,3,0,0
"Ecuador","2024-04-19",0,0,2,0,0,3,0,0
"Ecuador","2024-04-20",0,0,2,0,0,3,0,0
"Ecuador","2024-04-21",0,0,2,0,0,3,0,0
"Ecuador","2024-04-22",0,0,2,0,0,3,0,0
"Ecuador","2024-04-23",0,1,3,0,0,3,0,0
"Ecuador","2024-04-24",0,0,3,0,0,3,0,0
"Ecuador","2024-04-25",0,0,3,0,0,3,0,0
"Ecuador","2024-04-26",0,0,3,0,0,3,0,0
"Ecuador","2024-04-27",0,0,3,0,0,3,0,0
"Ecuador","2024-04-28",0,0,3,0,0,3,0,0
"Ecuador","2024-04-29",0,0,3,0,0,3,0,0
"Ecuador","2024-04-30",0,0,3,0,0,3,0,0
"Ecuador","2024-05-01",0,0,3,0,1,4,0,0
"Ecuador","2024-05-02",0,0,3,0,0,4,0,0
"Ecuador","2024-05-03",0,0,3,0,0,4,0,0
"Ecuador","2024-05-04",0,0,3,0,0,4,0,0
"Ecuador","2024-05-05",0,0,3,0,0,4,0,0
"Ecuador","2024-05-06",0,0,3,0,0,4,0,0
"Ecuador","2024-05-07",0,1,4,0,0,4,0,0
"Ecuador","2024-05-08",0,0,4,0,0,4,0,0
"Ecuador","2024-05-09",0,0,4,0,0,4,0,0
"Ecuador","2024-05-10",0,0,4,0,0,4,0,0
"Ecuador","2024-05-11",0,0,4,0,0,4,0,0
"Ecuador","2024-05-12",0,0,4,0,0,4,0,0
"Ecuador","2024-05-13",0,0,4,0,0,4,0,0
"Ecuador","2024-05-14",0,0,4,0,0,4,0,0
"Ecuador","2024-05-15",0,0,4,0,0,4,0,0
"Ecuador","2024-05-16",0,0,4,0,0,4,0,0
"Ecuador","2024-05-17",0,0,4,0,0,4,0,0
"Ecuador","2024-05-18",0,0,4,0,0,4,0,0
"Ecuador","2024-05-19",0,0,4,0,0,4,0,0
"Ecuador","2024-05-20",0,0,4,0,0,4,0,0
"Ecuador","2024-05-21",0,0,4,0,0,4,0,0
"Ecuador","2024-05-22",0,0,4,0,0,4,0,0
"Ecuador","2024-05-23",0,0,4,0,0,4,0,0
"Ecuador","2024-05-24",0,0,4,0,0,4,0,0
"Ecuador","2024-05-25",0,0,4,0,0,4,0,0
"Ecuador","2024-05-26",0,0,4,0,0,4,0,0
"Ecuador","2024-05-27",0,0,4,0,0,4,0,0
"Ecuador","2024-05-28",0,0,4,0,0,4,0,0
"Ecuador","2024-05-29",0,0,4,0,0,4,0,0
"Ecuador","2024-05-30",0,0,4,0,0,4,0,0
"Ecuador","2024-05-31",0,0,4,0,0,4,0,0
"Ecuador","2024-06-01",0,0,4,0,0,4,0,0
"Ecuador","2024-06-02",0,0,4,0,0,4,0,0
"Ecuador","2024-06-03",0,0,4,0,0,4,0,0
"Ecuador","2024-06-04",0,0,4,0,0,4,0,0
"Ecuador","2024-06-05",0,0,4,0,0,4,0,0
"Ecuador","2024-06-06",0,0,4,0,0,4,0,0
"Ecuador","2024-06-07",0,0,4,0,0,4,0,0
"Ecuador","2024-06-08",0,0,4,0,0,4,0,0
"Ecuador","2024-06-09",0,0,4,0,0,4,0,0
"Ecuador","2024-06-10",0,0,4,0,0,4,0,0
"Ecuador","2024-06-11",0,0,4,0,0,4,0,0
"Ecuador","2024-06-12",0,0,4,0,0,4,0,0
"Ecuador","2024-06-13",0,0,4,0,0,4,0,0
"Ecuador","2024-06-14",0,0,4,0,0,4,0,0
"Ecuador","2024-06-15",0,0,4,0,0,4,0,0
"Ecuador","2024-06-16",0,0,4,0,0,4,0,0
"Ecuador","2024-06-17",0,0,4,0,0,4,0,0
"Ecuador","2024-06-18",0,0,4,0,0,4,0,0
"Ecuador","2024-06-19",0,0,4,0,1,5,0,0
"Ecuador","2024-06-20",0,0,4,0,0,5,0,0
"Ecuador","2024-06-21",0,0,4,0,0,5,0,0
"Ecuador","2024-06-22",0,0,4,0,0,5,0,0
"Ecuador","2024-06-23",0,0,4,0,0,5,0,0
"Ecuador","2024-06-24",0,0,4,0,0,5,0,0
"Ecuador","2024-06-25",0,0,4,0,0,5,0,0
"Ecuador","2024-06-26",0,0,4,0,0,5,0,0
"Ecuador","2024-06-27",0,0,4,0,0,5,0,0
"Ecuador","2024-06-28",0,0,4,0,0,5,0,0
"Ecuador","2024-06-29",0,0,4,0,0,5,0,0
"Ecuador","2024-06-30",0,0,4,0,0,5,0,0
"Ecuador","2024-07-01",0,0,4,0,0,5,0,0
"Ecuador","2024-07-02",0,0,4,0,0,5,0,0
"Ecuador","2024-07-03",0,0,4,0,0,5,0,0
"Ecuador","2024-07-04",0,0,4,0,0,5,0,0
"Ecuador","2024-07-05",0,0,4,0,0,5,0,0
"Ecuador","2024-07-06",0,0,4,0,0,5,0,0
"Ecuador","2024-07-07",0,0,4,0,0,5,0,0
"Ecuador","2024-07-08",0,0,4,0,0,5,0,0
"Ecuador","2024-07-09",0,0,4,0,0,5,0,0
"Ecuador","2024-07-10",0,0,4,0,0,5,0,0
"Ecuador","2024-07-11",0,0,4,0,0,5,0,0
"Ecuador","2024-07-12",0,0,4,0,0,5,0,0
"Ecuador","2024-07-13",0,0,4,0,0,5,0,0
"Ecuador","2024-07-14",0,0,4,0,0,5,0,0
"Ecuador","2024-07-15",0,0,4,0,0,5,0,0
"Ecuador","2024-07-16",0,0,4,0,0,5,0,0
"Ecuador","2024-07-17",0,0,4,0,0,5,0,0
"Ecuador","2024-07-18",0,0,4,0,0,5,0,0
"Ecuador","2024-07-19",0,0,4,0,0,5,0,0
"Ecuador","2024-07-20",0,0,4,0,0,5,0,0
"Ecuador","2024-07-21",0,0,4,0,0,5,0,0
"Ecuador","2024-07-22",0,0,4,0,0,5,0,0
"Ecuador","2024-07-23",0,0,4,0,0,5,0,0
"Ecuador","2024-07-24",0,0,4,0,0,5,0,0
"Ecuador","2024-07-25",0,0,4,0,0,5,0,0
"Ecuador","2024-07-26",0,0,4,0,0,5,0,0
"Ecuador","2024-07-27",0,0,4,0,0,5,0,0
"Ecuador","2024-07-28",0,0,4,0,0,5,0,0
"Ecuador","2024-07-29",0,0,4,0,0,5,0,0
"Ecuador","2024-07-30",0,1,5,0,0,5,0,0
"Ecuador","2024-07-31",0,0,5,0,0,5,0,0
"Ecuador","2024-08-01",0,0,5,0,0,5,0,0
"Ecuador","2024-08-02",0,0,5,0,0,5,0,0
"Ecuador","2024-08-03",0,0,5,0,1,6,0,0
"Ecuador","2024-08-04",0,0,5,0,0,6,0,0
"Ecuador","2024-08-05",0,0,5,0,0,6,0,0
"Ecuador","2024-08-06",0,1,6,0,0,6,0,0
"Ecuador","2024-08-07",0,0,6,0,0,6,0,0
"Ecuador","2024-08-08",0,0,6,0,0,6,0,0
"Ecuador","2024-08-09",0,0,6,0,0,6,0,0
"Ecuador","2024-08-10",0,0,6,0,1,7,0,0
"Ecuador","2024-08-11",0,0,6,0,0,7,0,0
"Ecuador","2024-08-12",0,0,6,0,0,7,0,0
"Ecuador","2024-08-13",0,1,7,0,0,7,0,0
"Ecuador","2024-08-14",0,0,7,0,0,7,0,0
"Ecuador","2024-08-15",0,0,7,0,0,7,0,0
"Ecuador","2024-08-16",0,0,7,0,0,7,0,0
"Ecuador","2024-08-17",0,0,7,0,1,8,0,0
"Ecuador","2024-08-18",0,0,7,0,0,8,0,0
"Ecuador","2024-08-19",0,0,7,0,0,8,0,0
"Ecuador","2024-08-20",0,1,8,0,0,8,0,0
"Ecuador","2024-08-21",0,0,8,0,1,9,0,0
"Ecuador","2024-08-22",0,0,8,0,0,9,0,0
"Ecuador","2024-08-23",0,0,8,0,1,10,0,0
"Ecuador","2024-08-24",0,0,8,0,1,11,0,0
"Ecuador","2024-08-25",0,0,8,0,1,12,0,0
"Ecuador","2024-08-26",0,0,8,0,0,12,0,0
"Ecuador","2024-08-27",0,5,13,0,1,13,0,0
"Ecuador","2024-08-28",0,0,13,0,0,13,0,0
"Ecuador","2024-08-29",0,0,13,0,0,13,0,0
"Ecuador","2024-08-30",0,0,13,0,1,14,0,0
"Ecuador","2024-08-31",0,0,13,0,0,14,0,0
"Ecuador","2024-09-01",0,0,13,0,0,14,0,0
"Ecuador","2024-09-02",0,0,13,0,0,14,0,0
"Ecuador","2024-09-03",0,0,13,0,1,15,0,0
"Ecuador","2024-09-04",0,0,13,0,0,15,0,0
"Ecuador","2024-09-05",0,0,13,0,0,15,0,0
"Ecuador","2024-09-06",0,0,13,0,0,15,0,0
"Ecuador","2024-09-07",0,0,13,0,0,15,0,0
"Ecuador","2024-09-08",0,0,13,0,1,16,0,0
"Ecuador","2024-09-09",0,0,13,0,0,16,0,0
"Ecuador","2024-09-10",0,3,16,0,0,16,0,0
"Ecuador","2024-09-11",0,0,16,0,1,17,0,0
"Ecuador","2024-09-12",0,0,16,0,0,17,0,0
"Ecuador","2024-09-13",0,0,16,0,1,18,0,0
"Ecuador","2024-09-14",0,0,16,0,0,18,0,0
"Ecuador","2024-09-15",0,0,16,0,1,19,0,0
"Ecuador","2024-09-16",0,0,16,0,0,19,0,0
"Ecuador","2024-09-17",0,4,20,0,1,20,0,0
"Ecuador","2024-09-18",0,0,20,0,0,20,0,0
"Ecuador","2024-09-19",0,0,20,0,1,21,0,0
"Ecuador","2024-09-20",0,0,20,0,0,21,0,0
"Ecuador","2024-09-21",0,0,20,0,1,22,0,0
"Ecuador","2024-09-22",0,0,20,0,0,22,0,0
"Ecuador","2024-09-23",0,0,20,0,1,23,0,0
"Ecuador","2024-09-24",0,3,23,0,0,23,0,0
"Ecuador","2024-09-25",0,0,23,0,0,23,0,0
"Ecuador","2024-09-26",0,0,23,0,0,23,0,0
"Ecuador","2024-09-27",0,0,23,0,0,23,0,0
"Ecuador","2024-09-28",0,0,23,0,1,24,0,0
"Ecuador","2024-09-29",0,0,23,0,0,24,0,0
"Ecuador","2024-09-30",0,0,23,0,0,24,0,0
"Ecuador","2024-10-01",0,1,24,0,0,24,0,0
"Ecuador","2024-10-02",0,0,24,0,0,24,0,0
"Ecuador","2024-10-03",0,0,24,0,0,24,0,0
"Ecuador","2024-10-04",0,0,24,0,0,24,0,0
"Ecuador","2024-10-05",0,0,24,0,0,24,0,0
"Ecuador","2024-10-06",0,0,24,0,0,24,0,0
"Ecuador","2024-10-07",0,0,24,0,0,24,0,0
"Ecuador","2024-10-08",0,0,24,0,0,24,0,0
"Ecuador","2024-10-09",0,0,24,0,0,24,0,0
"Ecuador","2024-10-10",0,0,24,0,0,24,0,0
"Ecuador","2024-10-11",0,0,24,0,0,24,0,0
"Ecuador","2024-10-12",0,0,24,0,1,25,0,0
"Ecuador","2024-10-13",0,0,24,0,0,25,0,0
"Ecuador","2024-10-14",0,0,24,0,0,25,0,0
"Ecuador","2024-10-15",0,0,24,0,0,25,0,0
"Ecuador","2024-10-16",0,0,24,0,0,25,0,0
"Ecuador","2024-10-17",0,0,24,0,0,25,0,0
"Ecuador","2024-10-18",0,0,24,0,0,25,0,0
"Ecuador","2024-10-19",0,0,24,0,0,25,0,0
"Ecuador","2024-10-20",0,0,24,0,0,25,0,0
"Ecuador","2024-10-21",0,0,24,0,0,25,0,0
"Ecuador","2024-10-22",0,1,25,0,0,25,0,0
"Ecuador","2024-10-23",0,0,25,0,1,26,0,0
"Ecuador","2024-10-24",0,0,25,0,0,26,0,0
"Ecuador","2024-10-25",0,0,25,0,1,27,0,0
"Ecuador","2024-10-26",0,0,25,0,0,27,0,0
"Ecuador","2024-10-27",0,0,25,0,1,28,0,0
"Ecuador","2024-10-28",0,0,25,0,0,28,0,0
"Ecuador","2024-10-29",0,4,29,0,1,29,0,0
"Ecuador","2024-10-30",0,0,29,0,0,29,0,0
"Ecuador","2024-10-31",0,0,29,0,1,30,0,0
"Ecuador","2024-11-01",0,0,29,0,0,30,0,0
"Ecuador","2024-11-02",0,0,29,0,0,30,0,0
"Ecuador","2024-11-03",0,0,29,0,0,30,0,0
"Ecuador","2024-11-04",0,0,29,0,1,31,0,0
"Ecuador","2024-11-05",0,2,31,0,0,31,0,0
"Ecuador","2024-11-06",0,0,31,0,0,31,0,0
"Ecuador","2024-11-07",0,0,31,0,0,31,0,0
"Ecuador","2024-11-08",0,0,31,0,0,31,0,0
"Ecuador","2024-11-09",0,0,31,0,0,31,0,0
"Ecuador","2024-11-10",0,0,31,0,0,31,0,0
"Ecuador","2024-11-11",0,0,31,0,0,31,0,0
"Ecuador","2024-11-12",0,0,31,0,0,31,0,0
"Ecuador","2024-11-13",0,0,31,0,0,31,0,0
"Ecuador","2024-11-14",0,0,31,0,0,31,0,0
"Ecuador","2024-11-15",0,0,31,0,0,31,0,0
"Ecuador","2024-11-16",0,0,31,0,0,31,0,0
"Ecuador","2024-11-17",0,0,31,0,0,31,0,0
"Ecuador","2024-11-18",0,0,31,0,0,31,0,0
"Ecuador","2024-11-19",0,0,31,0,0,31,0,0
"Ecuador","2024-11-20",0,0,31,0,0,31,0,0
"Ecuador","2024-11-21",0,0,31,0,0,31,0,0
"Ecuador","2024-11-22",0,0,31,0,0,31,0,0
"Ecuador","2024-11-23",0,0,31,0,0,31,0,0
"Ecuador","2024-11-24",0,0,31,0,0,31,0,0
"Ecuador","2024-11-25",0,0,31,0,0,31,0,0
"Ecuador","2024-11-26",0,0,31,0,0,31,0,0
"Ecuador","2024-11-27",0,0,31,0,0,31,0,0
"Ecuador","2024-11-28",0,0,31,0,0,31,0,0
"Ecuador","2024-11-29",0,0,31,0,0,31,0,0
"Ecuador","2024-11-30",0,0,31,0,0,31,0,0
"Ecuador","2024-12-01",0,0,31,0,0,31,0,0
"Ecuador","2024-12-02",0,0,31,0,0,31,0,0
"Ecuador","2024-12-03",0,0,31,0,0,31,0,0
"Ecuador","2024-12-04",0,0,31,0,0,31,0,0
"Ecuador","2024-12-05",0,0,31,0,0,31,0,0
"Ecuador","2024-12-06",0,0,31,0,0,31,0,0
"Ecuador","2024-12-07",0,0,31,0,0,31,0,0
"Ecuador","2024-12-08",0,0,31,0,0,31,0,0
"Ecuador","2024-12-09",0,0,31,0,0,31,0,0
"Ecuador","2024-12-10",0,0,31,0,0,31,0,0
"Ecuador","2024-12-11",0,0,31,0,0,31,0,0
"Ecuador","2024-12-12",0,0,31,0,0,31,0,0
"Ecuador","2024-12-13",0,0,31,0,0,31,0,0
"Ecuador","2024-12-14",0,0,31,0,0,31,0,0
"Ecuador","2024-12-15",0,0,31,0,0,31,0,0
"Ecuador","2024-12-16",0,0,31,0,0,31,0,0
"Ecuador","2024-12-17",0,0,31,0,0,31,0,0
"Ecuador","2024-12-18",0,0,31,0,0,31,0,0
"Ecuador","2024-12-19",0,0,31,0,0,31,0,0
"Ecuador","2024-12-20",0,0,31,0,0,31,0,0
"Ecuador","2024-12-21",0,0,31,0,0,31,0,0
"Ecuador","2024-12-22",0,0,31,0,0,31,0,0
"Ecuador","2024-12-23",0,0,31,0,0,31,0,0
"Ecuador","2024-12-24",0,0,31,0,0,31,0,0
"Ecuador","2024-12-25",0,0,31,0,0,31,0,0
"Ecuador","2024-12-26",0,0,31,0,0,31,0,0
"Ecuador","2024-12-27",0,0,31,0,0,31,0,0
"Ecuador","2024-12-28",0,0,31,0,0,31,0,0
"Ecuador","2024-12-29",0,0,31,0,0,31,0,0
"Ecuador","2024-12-30",0,0,31,0,0,31,0,0
"Ecuador","2024-12-31",0,0,31,0,0,31,0,0
"Ecuador","2025-01-01",0,0,31,0,0,31,0,0
"Ecuador","2025-01-02",0,0,31,0,0,31,0,0
"Ecuador","2025-01-03",0,0,31,0,0,31,0,0
"Ecuador","2025-01-04",0,0,31,0,0,31,0,0
"Ecuador","2025-01-05",0,0,31,0,0,31,0,0
"Ecuador","2025-01-06",0,0,31,0,0,31,0,0
"Ecuador","2025-01-07",0,0,31,0,0,31,0,0
"Ecuador","2025-01-08",0,0,31,0,0,31,0,0
"Ecuador","2025-01-09",0,0,31,0,0,31,0,0
"Ecuador","2025-01-10",0,0,31,0,0,31,0,0
"Ecuador","2025-01-11",0,0,31,0,0,31,0,0
"Ecuador","2025-01-12",0,0,31,0,0,31,0,0
"Ecuador","2025-01-13",0,0,31,0,0,31,0,0
"Ecuador","2025-01-14",0,0,31,0,0,31,0,0
"Ecuador","2025-01-15",0,0,31,0,0,31,0,0
"Ecuador","2025-01-16",0,0,31,0,0,31,0,0
"Ecuador","2025-01-17",0,0,31,0,0,31,0,0
"Ecuador","2025-01-18",0,0,31,0,0,31,0,0
"Ecuador","2025-01-19",0,0,31,0,0,31,0,0
"Ecuador","2025-01-20",0,0,31,0,0,31,0,0
"Ecuador","2025-01-21",0,0,31,0,0,31,0,0
"Ecuador","2025-01-22",0,0,31,0,0,31,0,0
"Ecuador","2025-01-23",0,0,31,0,0,31,0,0
"Ecuador","2025-01-24",0,0,31,0,0,31,0,0
"Ecuador","2025-01-25",0,0,31,0,0,31,0,0
"Ecuador","2025-01-26",0,0,31,0,0,31,0,0
"Ecuador","2025-01-27",0,0,31,0,0,31,0,0
"Ecuador","2025-01-28",0,0,31,0,0,31,0,0
"Ecuador","2025-01-29",0,0,31,0,0,31,0,0
"Ecuador","2025-01-30",0,0,31,0,0,31,0,0
"Ecuador","2025-01-31",0,0,31,0,0,31,0,0
"Ecuador","2025-02-01",0,0,31,0,0,31,0,0
"Ecuador","2025-02-02",0,0,31,0,0,31,0,0
"Ecuador","2025-02-03",0,0,31,0,0,31,0,0
"El Salvador","2024-01-01",0,0,0,0,0,0,0,0
"El Salvador","2024-01-02",0,0,0,0,0,0,0,0
"El Salvador","2024-01-03",0,0,0,0,0,0,0,0
"El Salvador","2024-01-04",0,0,0,0,0,0,0,0
"El Salvador","2024-01-05",0,0,0,0,0,0,0,0
"El Salvador","2024-01-06",0,0,0,0,0,0,0,0
"El Salvador","2024-01-07",0,0,0,0,0,0,0,0
"El Salvador","2024-01-08",0,0,0,0,0,0,0,0
"El Salvador","2024-01-09",0,0,0,0,0,0,0,0
"El Salvador","2024-01-10",0,0,0,0,0,0,0,0
"El Salvador","2024-01-11",0,0,0,0,0,0,0,0
"El Salvador","2024-01-12",0,0,0,0,0,0,0,0
"El Salvador","2024-01-13",0,0,0,0,0,0,0,0
"El Salvador","2024-01-14",0,0,0,0,0,0,0,0
"El Salvador","2024-01-15",0,0,0,0,0,0,0,0
"El Salvador","2024-01-16",0,0,0,0,0,0,0,0
"El Salvador","2024-01-17",0,0,0,0,0,0,0,0
"El Salvador","2024-01-18",0,0,0,0,0,0,0,0
"El Salvador","2024-01-19",0,0,0,0,0,0,0,0
"El Salvador","2024-01-20",0,0,0,0,0,0,0,0
"El Salvador","2024-01-21",0,0,0,0,0,0,0,0
"El Salvador","2024-01-22",0,0,0,0,0,0,0,0
"El Salvador","2024-01-23",0,0,0,0,0,0,0,0
"El Salvador","2024-01-24",0,0,0,0,0,0,0,0
"El Salvador","2024-01-25",0,0,0,0,0,0,0,0
"El Salvador","2024-01-26",0,0,0,0,0,0,0,0
"El Salvador","2024-01-27",0,0,0,0,0,0,0,0
"El Salvador","2024-01-28",0,0,0,0,0,0,0,0
"El Salvador","2024-01-29",0,0,0,0,0,0,0,0
"El Salvador","2024-01-30",0,0,0,0,0,0,0,0
"El Salvador","2024-01-31",0,0,0,0,0,0,0,0
"El Salvador","2024-02-01",0,0,0,0,0,0,0,0
"El Salvador","2024-02-02",0,0,0,0,0,0,0,0
"El Salvador","2024-02-03",0,0,0,0,0,0,0,0
"El Salvador","2024-02-04",0,0,0,0,0,0,0,0
"El Salvador","2024-02-05",0,0,0,0,0,0,0,0
"El Salvador","2024-02-06",0,0,0,0,0,0,0,0
"El Salvador","2024-02-07",0,0,0,0,0,0,0,0
"El Salvador","2024-02-08",0,0,0,0,0,0,0,0
"El Salvador","2024-02-09",0,0,0,0,0,0,0,0
"El Salvador","2024-02-10",0,0,0,0,0,0,0,0
"El Salvador","2024-02-11",0,0,0,0,0,0,0,0
"El Salvador","2024-02-12",0,0,0,0,0,0,0,0
"El Salvador","2024-02-13",0,0,0,0,0,0,0,0
"El Salvador","2024-02-14",0,0,0,0,0,0,0,0
"El Salvador","2024-02-15",0,0,0,0,0,0,0,0
"El Salvador","2024-02-16",0,0,0,0,0,0,0,0
"El Salvador","2024-02-17",0,0,0,0,0,0,0,0
"El Salvador","2024-02-18",0,0,0,0,0,0,0,0
"El Salvador","2024-02-19",0,0,0,0,0,0,0,0
"El Salvador","2024-02-20",0,0,0,0,0,0,0,0
"El Salvador","2024-02-21",0,0,0,0,0,0,0,0
"El Salvador","2024-02-22",0,0,0,0,0,0,0,0
"El Salvador","2024-02-23",0,0,0,0,0,0,0,0
"El Salvador","2024-02-24",0,0,0,0,0,0,0,0
"El Salvador","2024-02-25",0,0,0,0,0,0,0,0
"El Salvador","2024-02-26",0,0,0,0,0,0,0,0
"El Salvador","2024-02-27",0,0,0,0,0,0,0,0
"El Salvador","2024-02-28",0,0,0,0,0,0,0,0
"El Salvador","2024-02-29",0,0,0,0,0,0,0,0
"El Salvador","2024-03-01",0,0,0,0,0,0,0,0
"El Salvador","2024-03-02",0,0,0,0,0,0,0,0
"El Salvador","2024-03-03",0,0,0,0,0,0,0,0
"El Salvador","2024-03-04",0,0,0,0,0,0,0,0
"El Salvador","2024-03-05",0,0,0,0,0,0,0,0
"El Salvador","2024-03-06",0,0,0,0,0,0,0,0
"El Salvador","2024-03-07",0,0,0,0,0,0,0,0
"El Salvador","2024-03-08",0,0,0,0,0,0,0,0
"El Salvador","2024-03-09",0,0,0,0,0,0,0,0
"El Salvador","2024-03-10",0,0,0,0,0,0,0,0
"El Salvador","2024-03-11",0,0,0,0,0,0,0,0
"El Salvador","2024-03-12",0,0,0,0,0,0,0,0
"El Salvador","2024-03-13",0,0,0,0,0,0,0,0
"El Salvador","2024-03-14",0,0,0,0,0,0,0,0
"El Salvador","2024-03-15",0,0,0,0,0,0,0,0
"El Salvador","2024-03-16",0,0,0,0,0,0,0,0
"El Salvador","2024-03-17",0,0,0,0,0,0,0,0
"El Salvador","2024-03-18",0,0,0,0,0,0,0,0
"El Salvador","2024-03-19",0,0,0,0,0,0,0,0
"El Salvador","2024-03-20",0,0,0,0,0,0,0,0
"El Salvador","2024-03-21",0,0,0,0,0,0,0,0
"El Salvador","2024-03-22",0,0,0,0,0,0,0,0
"El Salvador","2024-03-23",0,0,0,0,0,0,0,0
"El Salvador","2024-03-24",0,0,0,0,0,0,0,0
"El Salvador","2024-03-25",0,0,0,0,0,0,0,0
"El Salvador","2024-03-26",0,0,0,0,0,0,0,0
"El Salvador","2024-03-27",0,0,0,0,0,0,0,0
"El Salvador","2024-03-28",0,0,0,0,0,0,0,0
"El Salvador","2024-03-29",0,0,0,0,0,0,0,0
"El Salvador","2024-03-30",0,0,0,0,0,0,0,0
"El Salvador","2024-03-31",0,0,0,0,0,0,0,0
"El Salvador","2024-04-01",0,0,0,0,0,0,0,0
"El Salvador","2024-04-02",0,0,0,0,0,0,0,0
"El Salvador","2024-04-03",0,0,0,0,0,0,0,0
"El Salvador","2024-04-04",0,0,0,0,0,0,0,0
"El Salvador","2024-04-05",0,0,0,0,0,0,0,0
"El Salvador","2024-04-06",0,0,0,0,0,0,0,0
"El Salvador","2024-04-07",0,0,0,0,0,0,0,0
"El Salvador","2024-04-08",0,0,0,0,0,0,0,0
"El Salvador","2024-04-09",0,0,0,0,0,0,0,0
"El Salvador","2024-04-10",0,0,0,0,0,0,0,0
"El Salvador","2024-04-11",0,0,0,0,0,0,0,0
"El Salvador","2024-04-12",0,0,0,0,0,0,0,0
"El Salvador","2024-04-13",0,0,0,0,0,0,0,0
"El Salvador","2024-04-14",0,0,0,0,0,0,0,0
"El Salvador","2024-04-15",0,0,0,0,0,0,0,0
"El Salvador","2024-04-16",0,0,0,0,0,0,0,0
"El Salvador","2024-04-17",0,0,0,0,0,0,0,0
"El Salvador","2024-04-18",0,0,0,0,0,0,0,0
"El Salvador","2024-04-19",0,0,0,0,0,0,0,0
"El Salvador","2024-04-20",0,0,0,0,0,0,0,0
"El Salvador","2024-04-21",0,0,0,0,0,0,0,0
"El Salvador","2024-04-22",0,0,0,0,0,0,0,0
"El Salvador","2024-04-23",0,0,0,0,0,0,0,0
"El Salvador","2024-04-24",0,0,0,0,0,0,0,0
"El Salvador","2024-04-25",0,0,0,0,0,0,0,0
"El Salvador","2024-04-26",0,0,0,0,0,0,0,0
"El Salvador","2024-04-27",0,0,0,0,0,0,0,0
"El Salvador","2024-04-28",0,0,0,0,0,0,0,0
"El Salvador","2024-04-29",0,0,0,0,0,0,0,0
"El Salvador","2024-04-30",0,0,0,0,0,0,0,0
"El Salvador","2024-05-01",0,0,0,0,0,0,0,0
"El Salvador","2024-05-02",0,0,0,0,0,0,0,0
"El Salvador","2024-05-03",0,0,0,0,0,0,0,0
"El Salvador","2024-05-04",0,0,0,0,0,0,0,0
"El Salvador","2024-05-05",0,0,0,0,0,0,0,0
"El Salvador","2024-05-06",0,0,0,0,0,0,0,0
"El Salvador","2024-05-07",0,0,0,0,0,0,0,0
"El Salvador","2024-05-08",0,0,0,0,0,0,0,0
"El Salvador","2024-05-09",0,0,0,0,0,0,0,0
"El Salvador","2024-05-10",0,0,0,0,0,0,0,0
"El Salvador","2024-05-11",0,0,0,0,0,0,0,0
"El Salvador","2024-05-12",0,0,0,0,0,0,0,0
"El Salvador","2024-05-13",0,0,0,0,0,0,0,0
"El Salvador","2024-05-14",0,0,0,0,0,0,0,0
"El Salvador","2024-05-15",0,0,0,0,0,0,0,0
"El Salvador","2024-05-16",0,0,0,0,0,0,0,0
"El Salvador","2024-05-17",0,0,0,0,0,0,0,0
"El Salvador","2024-05-18",0,0,0,0,0,0,0,0
"El Salvador","2024-05-19",0,0,0,0,0,0,0,0
"El Salvador","2024-05-20",0,0,0,0,0,0,0,0
"El Salvador","2024-05-21",0,0,0,0,0,0,0,0
"El Salvador","2024-05-22",0,0,0,0,0,0,0,0
"El Salvador","2024-05-23",0,0,0,0,0,0,0,0
"El Salvador","2024-05-24",0,0,0,0,0,0,0,0
"El Salvador","2024-05-25",0,0,0,0,0,0,0,0
"El Salvador","2024-05-26",0,0,0,0,0,0,0,0
"El Salvador","2024-05-27",0,0,0,0,0,0,0,0
"El Salvador","2024-05-28",0,0,0,0,0,0,0,0
"El Salvador","2024-05-29",0,0,0,0,0,0,0,0
"El Salvador","2024-05-30",0,0,0,0,0,0,0,0
"El Salvador","2024-05-31",0,0,0,0,0,0,0,0
"El Salvador","2024-06-01",0,0,0,0,0,0,0,0
"El Salvador","2024-06-02",0,0,0,0,0,0,0,0
"El Salvador","2024-06-03",0,0,0,0,0,0,0,0
"El Salvador","2024-06-04",0,0,0,0,0,0,0,0
"El Salvador","2024-06-05",0,0,0,0,0,0,0,0
"El Salvador","2024-06-06",0,0,0,0,0,0,0,0
"El Salvador","2024-06-07",0,0,0,0,0,0,0,0
"El Salvador","2024-06-08",0,0,0,0,0,0,0,0
"El Salvador","2024-06-09",0,0,0,0,0,0,0,0
"El Salvador","2024-06-10",0,0,0,0,0,0,0,0
"El Salvador","2024-06-11",0,0,0,0,0,0,0,0
"El Salvador","2024-06-12",0,0,0,0,0,0,0,0
"El Salvador","2024-06-13",0,0,0,0,0,0,0,0
"El Salvador","2024-06-14",0,0,0,0,0,0,0,0
"El Salvador","2024-06-15",0,0,0,0,0,0,0,0
"El Salvador","2024-06-16",0,0,0,0,0,0,0,0
"El Salvador","2024-06-17",0,0,0,0,0,0,0,0
"El Salvador","2024-06-18",0,0,0,0,0,0,0,0
"El Salvador","2024-06-19",0,0,0,0,0,0,0,0
"El Salvador","2024-06-20",0,0,0,0,0,0,0,0
"El Salvador","2024-06-21",0,0,0,0,0,0,0,0
"El Salvador","2024-06-22",0,0,0,0,0,0,0,0
"El Salvador","2024-06-23",0,0,0,0,0,0,0,0
"El Salvador","2024-06-24",0,0,0,0,0,0,0,0
"El Salvador","2024-06-25",0,0,0,0,0,0,0,0
"El Salvador","2024-06-26",0,0,0,0,0,0,0,0
"El Salvador","2024-06-27",0,0,0,0,0,0,0,0
"El Salvador","2024-06-28",0,0,0,0,0,0,0,0
"El Salvador","2024-06-29",0,0,0,0,0,0,0,0
"El Salvador","2024-06-30",0,0,0,0,0,0,0,0
"El Salvador","2024-07-01",0,0,0,0,0,0,0,0
"El Salvador","2024-07-02",0,0,0,0,0,0,0,0
"El Salvador","2024-07-03",0,0,0,0,0,0,0,0
"El Salvador","2024-07-04",0,0,0,0,0,0,0,0
"El Salvador","2024-07-05",0,0,0,0,0,0,0,0
"El Salvador","2024-07-06",0,0,0,0,0,0,0,0
"El Salvador","2024-07-07",0,0,0,0,0,0,0,0
"El Salvador","2024-07-08",0,0,0,0,0,0,0,0
"El Salvador","2024-07-09",0,0,0,0,0,0,0,0
"El Salvador","2024-07-10",0,0,0,0,0,0,0,0
"El Salvador","2024-07-11",0,0,0,0,0,0,0,0
"El Salvador","2024-07-12",0,0,0,0,0,0,0,0
"El Salvador","2024-07-13",0,0,0,0,0,0,0,0
"El Salvador","2024-07-14",0,0,0,0,0,0,0,0
"El Salvador","2024-07-15",0,0,0,0,0,0,0,0
"El Salvador","2024-07-16",0,0,0,0,0,0,0,0
"El Salvador","2024-07-17",0,0,0,0,0,0,0,0
"El Salvador","2024-07-18",0,0,0,0,0,0,0,0
"El Salvador","2024-07-19",0,0,0,0,0,0,0,0
"El Salvador","2024-07-20",0,0,0,0,0,0,0,0
"El Salvador","2024-07-21",0,0,0,0,0,0,0,0
"El Salvador","2024-07-22",0,0,0,0,0,0,0,0
"El Salvador","2024-07-23",0,0,0,0,0,0,0,0
"El Salvador","2024-07-24",0,0,0,0,0,0,0,0
"El Salvador","2024-07-25",0,0,0,0,0,0,0,0
"El Salvador","2024-07-26",0,0,0,0,0,0,0,0
"El Salvador","2024-07-27",0,0,0,0,0,0,0,0
"El Salvador","2024-07-28",0,0,0,0,0,0,0,0
"El Salvador","2024-07-29",0,0,0,0,0,0,0,0
"El Salvador","2024-07-30",0,0,0,0,0,0,0,0
"El Salvador","2024-07-31",0,0,0,0,0,0,0,0
"El Salvador","2024-08-01",0,0,0,0,0,0,0,0
"El Salvador","2024-08-02",0,0,0,0,0,0,0,0
"El Salvador","2024-08-03",0,0,0,0,0,0,0,0
"El Salvador","2024-08-04",0,0,0,0,0,0,0,0
"El Salvador","2024-08-05",0,0,0,0,0,0,0,0
"El Salvador","2024-08-06",0,0,0,0,0,0,0,0
"El Salvador","2024-08-07",0,0,0,0,0,0,0,0
"El Salvador","2024-08-08",0,0,0,0,0,0,0,0
"El Salvador","2024-08-09",0,0,0,0,0,0,0,0
"El Salvador","2024-08-10",0,0,0,0,0,0,0,0
"El Salvador","2024-08-11",0,0,0,0,0,0,0,0
"El Salvador","2024-08-12",0,0,0,0,0,0,0,0
"El Salvador","2024-08-13",0,0,0,0,0,0,0,0
"El Salvador","2024-08-14",0,0,0,0,0,0,0,0
"El Salvador","2024-08-15",0,0,0,0,0,0,0,0
"El Salvador","2024-08-16",0,0,0,0,0,0,0,0
"El Salvador","2024-08-17",0,0,0,0,0,0,0,0
"El Salvador","2024-08-18",0,0,0,0,0,0,0,0
"El Salvador","2024-08-19",0,0,0,0,0,0,0,0
"El Salvador","2024-08-20",0,0,0,0,0,0,0,0
"El Salvador","2024-08-21",0,0,0,0,0,0,0,0
"El Salvador","2024-08-22",0,0,0,0,0,0,0,0
"El Salvador","2024-08-23",0,0,0,0,0,0,0,0
"El Salvador","2024-08-24",0,0,0,0,0,0,0,0
"El Salvador","2024-08-25",0,0,0,0,0,0,0,0
"El Salvador","2024-08-26",0,0,0,0,0,0,0,0
"El Salvador","2024-08-27",0,0,0,0,0,0,0,0
"El Salvador","2024-08-28",0,0,0,0,0,0,0,0
"El Salvador","2024-08-29",0,0,0,0,0,0,0,0
"El Salvador","2024-08-30",0,0,0,0,0,0,0,0
"El Salvador","2024-08-31",0,0,0,0,0,0,0,0
"El Salvador","2024-09-01",0,0,0,0,0,0,0,0
"El Salvador","2024-09-02",0,0,0,0,0,0,0,0
"El Salvador","2024-09-03",0,0,0,0,0,0,0,0
"El Salvador","2024-09-04",0,0,0,0,0,0,0,0
"El Salvador","2024-09-05",0,0,0,0,0,0,0,0
"El Salvador","2024-09-06",0,0,0,0,0,0,0,0
"El Salvador","2024-09-07",0,0,0,0,0,0,0,0
"El Salvador","2024-09-08",0,0,0,0,0,0,0,0
"El Salvador","2024-09-09",0,0,0,0,0,0,0,0
"El Salvador","2024-09-10",0,0,0,0,0,0,0,0
"El Salvador","2024-09-11",0,0,0,0,0,0,0,0
"El Salvador","2024-09-12",0,0,0,0,0,0,0,0
"El Salvador","2024-09-13",0,0,0,0,0,0,0,0
"El Salvador","2024-09-14",0,0,0,0,0,0,0,0
"El Salvador","2024-09-15",0,0,0,0,0,0,0,0
"El Salvador","2024-09-16",0,0,0,0,0,0,0,0
"El Salvador","2024-09-17",0,0,0,0,0,0,0,0
"El Salvador","2024-09-18",0,0,0,0,0,0,0,0
"El Salvador","2024-09-19",0,0,0,0,0,0,0,0
"El Salvador","2024-09-20",0,0,0,0,0,0,0,0
"El Salvador","2024-09-21",0,0,0,0,0,0,0,0
"El Salvador","2024-09-22",0,0,0,0,0,0,0,0
"El Salvador","2024-09-23",0,0,0,0,0,0,0,0
"El Salvador","2024-09-24",0,0,0,0,0,0,0,0
"El Salvador","2024-09-25",0,0,0,0,0,0,0,0
"El Salvador","2024-09-26",0,0,0,0,0,0,0,0
"El Salvador","2024-09-27",0,0,0,0,0,0,0,0
"El Salvador","2024-09-28",0,0,0,0,0,0,0,0
"El Salvador","2024-09-29",0,0,0,0,0,0,0,0
"El Salvador","2024-09-30",0,0,0,0,0,0,0,0
"El Salvador","2024-10-01",0,0,0,0,0,0,0,0
"El Salvador","2024-10-02",0,0,0,0,0,0,0,0
"El Salvador","2024-10-03",0,0,0,0,0,0,0,0
"El Salvador","2024-10-04",0,0,0,0,0,0,0,0
"El Salvador","2024-10-05",0,0,0,0,0,0,0,0
"El Salvador","2024-10-06",0,0,0,0,0,0,0,0
"El Salvador","2024-10-07",0,0,0,0,0,0,0,0
"El Salvador","2024-10-08",0,0,0,0,0,0,0,0
"El Salvador","2024-10-09",0,0,0,0,0,0,0,0
"El Salvador","2024-10-10",0,0,0,0,0,0,0,0
"El Salvador","2024-10-11",0,0,0,0,0,0,0,0
"El Salvador","2024-10-12",0,0,0,0,0,0,0,0
"El Salvador","2024-10-13",0,0,0,0,0,0,0,0
"El Salvador","2024-10-14",0,0,0,0,0,0,0,0
"El Salvador","2024-10-15",0,0,0,0,0,0,0,0
"El Salvador","2024-10-16",0,0,0,0,0,0,0,0
"El Salvador","2024-10-17",0,0,0,0,0,0,0,0
"El Salvador","2024-10-18",0,0,0,0,0,0,0,0
"El Salvador","2024-10-19",0,0,0,0,0,0,0,0
"El Salvador","2024-10-20",0,0,0,0,0,0,0,0
"El Salvador","2024-10-21",0,0,0,0,0,0,0,0
"El Salvador","2024-10-22",0,0,0,0,0,0,0,0
"El Salvador","2024-10-23",0,0,0,0,0,0,0,0
"El Salvador","2024-10-24",0,0,0,0,0,0,0,0
"El Salvador","2024-10-25",0,0,0,0,0,0,0,0
"El Salvador","2024-10-26",0,0,0,0,0,0,0,0
"El Salvador","2024-10-27",0,0,0,0,0,0,0,0
"El Salvador","2024-10-28",0,0,0,0,0,0,0,0
"El Salvador","2024-10-29",0,0,0,0,0,0,0,0
"El Salvador","2024-10-30",0,0,0,0,0,0,0,0
"El Salvador","2024-10-31",0,0,0,0,0,0,0,0
"El Salvador","2024-11-01",0,0,0,0,0,0,0,0
"El Salvador","2024-11-02",0,0,0,0,0,0,0,0
"El Salvador","2024-11-03",0,0,0,0,0,0,0,0
"El Salvador","2024-11-04",0,0,0,0,0,0,0,0
"El Salvador","2024-11-05",0,0,0,0,0,0,0,0
"El Salvador","2024-11-06",0,0,0,0,0,0,0,0
"El Salvador","2024-11-07",0,0,0,0,0,0,0,0
"El Salvador","2024-11-08",0,0,0,0,0,0,0,0
"El Salvador","2024-11-09",0,0,0,0,0,0,0,0
"El Salvador","2024-11-10",0,0,0,0,0,0,0,0
"El Salvador","2024-11-11",0,0,0,0,0,0,0,0
"El Salvador","2024-11-12",0,0,0,0,0,0,0,0
"El Salvador","2024-11-13",0,0,0,0,0,0,0,0
"El Salvador","2024-11-14",0,0,0,0,0,0,0,0
"El Salvador","2024-11-15",0,0,0,0,0,0,0,0
"El Salvador","2024-11-16",0,0,0,0,0,0,0,0
"El Salvador","2024-11-17",0,0,0,0,0,0,0,0
"El Salvador","2024-11-18",0,0,0,0,0,0,0,0
"El Salvador","2024-11-19",0,0,0,0,0,0,0,0
"El Salvador","2024-11-20",0,0,0,0,0,0,0,0
"El Salvador","2024-11-21",0,0,0,0,0,0,0,0
"El Salvador","2024-11-22",0,0,0,0,0,0,0,0
"El Salvador","2024-11-23",0,0,0,0,0,0,0,0
"El Salvador","2024-11-24",0,0,0,0,0,0,0,0
"El Salvador","2024-11-25",0,0,0,0,0,0,0,0
"El Salvador","2024-11-26",0,0,0,0,0,0,0,0
"El Salvador","2024-11-27",0,0,0,0,0,0,0,0
"El Salvador","2024-11-28",0,0,0,0,0,0,0,0
"El Salvador","2024-11-29",0,0,0,0,0,0,0,0
"El Salvador","2024-11-30",0,0,0,0,0,0,0,0
"El Salvador","2024-12-01",0,0,0,0,0,0,0,0
"El Salvador","2024-12-02",0,0,0,0,0,0,0,0
"El Salvador","2024-12-03",0,0,0,0,0,0,0,0
"El Salvador","2024-12-04",0,0,0,0,0,0,0,0
"El Salvador","2024-12-05",0,0,0,0,0,0,0,0
"El Salvador","2024-12-06",0,0,0,0,0,0,0,0
"El Salvador","2024-12-07",0,0,0,0,0,0,0,0
"El Salvador","2024-12-08",0,0,0,0,0,0,0,0
"El Salvador","2024-12-09",0,0,0,0,0,0,0,0
"El Salvador","2024-12-10",0,0,0,0,0,0,0,0
"El Salvador","2024-12-11",0,0,0,0,0,0,0,0
"El Salvador","2024-12-12",0,0,0,0,0,0,0,0
"El Salvador","2024-12-13",0,0,0,0,0,0,0,0
"El Salvador","2024-12-14",0,0,0,0,0,0,0,0
"El Salvador","2024-12-15",0,0,0,0,0,0,0,0
"El Salvador","2024-12-16",0,0,0,0,0,0,0,0
"El Salvador","2024-12-17",0,0,0,0,0,0,0,0
"El Salvador","2024-12-18",0,0,0,0,0,0,0,0
"El Salvador","2024-12-19",0,0,0,0,0,0,0,0
"El Salvador","2024-12-20",0,0,0,0,0,0,0,0
"El Salvador","2024-12-21",0,0,0,0,0,0,0,0
"El Salvador","2024-12-22",0,0,0,0,0,0,0,0
"El Salvador","2024-12-23",0,0,0,0,0,0,0,0
"El Salvador","2024-12-24",0,0,0,0,0,0,0,0
"El Salvador","2024-12-25",0,0,0,0,0,0,0,0
"El Salvador","2024-12-26",0,0,0,0,0,0,0,0
"El Salvador","2024-12-27",0,0,0,0,0,0,0,0
"El Salvador","2024-12-28",0,0,0,0,0,0,0,0
"El Salvador","2024-12-29",0,0,0,0,0,0,0,0
"El Salvador","2024-12-30",0,0,0,0,0,0,0,0
"El Salvador","2024-12-31",0,0,0,0,0,0,0,0
"El Salvador","2025-01-01",0,0,0,0,0,0,0,0
"El Salvador","2025-01-02",0,0,0,0,0,0,0,0
"El Salvador","2025-01-03",0,0,0,0,0,0,0,0
"El Salvador","2025-01-04",0,0,0,0,0,0,0,0
"El Salvador","2025-01-05",0,0,0,0,0,0,0,0
"El Salvador","2025-01-06",0,0,0,0,0,0,0,0
"El Salvador","2025-01-07",0,0,0,0,0,0,0,0
"El Salvador","2025-01-08",0,0,0,0,0,0,0,0
"El Salvador","2025-01-09",0,0,0,0,0,0,0,0
"El Salvador","2025-01-10",0,0,0,0,0,0,0,0
"El Salvador","2025-01-11",0,0,0,0,0,0,0,0
"El Salvador","2025-01-12",0,0,0,0,0,0,0,0
"El Salvador","2025-01-13",0,0,0,0,0,0,0,0
"El Salvador","2025-01-14",0,0,0,0,0,0,0,0
"El Salvador","2025-01-15",0,0,0,0,0,0,0,0
"El Salvador","2025-01-16",0,0,0,0,0,0,0,0
"El Salvador","2025-01-17",0,0,0,0,0,0,0,0
"El Salvador","2025-01-18",0,0,0,0,0,0,0,0
"El Salvador","2025-01-19",0,0,0,0,0,0,0,0
"El Salvador","2025-01-20",0,0,0,0,0,0,0,0
"El Salvador","2025-01-21",0,0,0,0,0,0,0,0
"El Salvador","2025-01-22",0,0,0,0,0,0,0,0
"El Salvador","2025-01-23",0,0,0,0,0,0,0,0
"El Salvador","2025-01-24",0,0,0,0,0,0,0,0
"El Salvador","2025-01-25",0,0,0,0,0,0,0,0
"El Salvador","2025-01-26",0,0,0,0,0,0,0,0
"El Salvador","2025-01-27",0,0,0,0,0,0,0,0
"El Salvador","2025-01-28",0,0,0,0,0,0,0,0
"El Salvador","2025-01-29",0,0,0,0,0,0,0,0
"El Salvador","2025-01-30",0,0,0,0,0,0,0,0
"El Salvador","2025-01-31",0,0,0,0,0,0,0,0
"El Salvador","2025-02-01",0,0,0,0,0,0,0,0
"El Salvador","2025-02-02",0,0,0,0,0,0,0,0
"El Salvador","2025-02-03",0,0,0,0,0,0,0,0
"Estonia","2024-01-01",0,0,0,0,0,0,0,0
"Estonia","2024-01-02",0,0,0,0,0,0,0,0
"Estonia","2024-01-03",0,0,0,0,0,0,0,0
"Estonia","2024-01-04",0,0,0,0,0,0,0,0
"Estonia","2024-01-05",0,0,0,0,0,0,0,0
"Estonia","2024-01-06",0,0,0,0,0,0,0,0
"Estonia","2024-01-07",0,0,0,0,0,0,0,0
"Estonia","2024-01-08",0,0,0,0,0,0,0,0
"Estonia","2024-01-09",0,0,0,0,0,0,0,0
"Estonia","2024-01-10",0,0,0,0,0,0,0,0
"Estonia","2024-01-11",0,0,0,0,0,0,0,0
"Estonia","2024-01-12",0,0,0,0,0,0,0,0
"Estonia","2024-01-13",0,0,0,0,0,0,0,0
"Estonia","2024-01-14",0,0,0,0,0,0,0,0
"Estonia","2024-01-15",0,0,0,0,0,0,0,0
"Estonia","2024-01-16",0,0,0,0,0,0,0,0
"Estonia","2024-01-17",0,0,0,0,0,0,0,0
"Estonia","2024-01-18",0,0,0,0,0,0,0,0
"Estonia","2024-01-19",0,0,0,0,0,0,0,0
"Estonia","2024-01-20",0,0,0,0,0,0,0,0
"Estonia","2024-01-21",0,0,0,0,0,0,0,0
"Estonia","2024-01-22",0,0,0,0,0,0,0,0
"Estonia","2024-01-23",0,0,0,0,0,0,0,0
"Estonia","2024-01-24",0,0,0,0,0,0,0,0
"Estonia","2024-01-25",0,0,0,0,0,0,0,0
"Estonia","2024-01-26",0,0,0,0,0,0,0,0
"Estonia","2024-01-27",0,0,0,0,0,0,0,0
"Estonia","2024-01-28",0,0,0,0,0,0,0,0
"Estonia","2024-01-29",0,0,0,0,0,0,0,0
"Estonia","2024-01-30",0,0,0,0,0,0,0,0
"Estonia","2024-01-31",0,0,0,0,0,0,0,0
"Estonia","2024-02-01",0,0,0,0,0,0,0,0
"Estonia","2024-02-02",0,0,0,0,0,0,0,0
"Estonia","2024-02-03",0,0,0,0,0,0,0,0
"Estonia","2024-02-04",0,0,0,0,0,0,0,0
"Estonia","2024-02-05",0,0,0,0,0,0,0,0
"Estonia","2024-02-06",0,0,0,0,0,0,0,0
"Estonia","2024-02-07",0,0,0,0,0,0,0,0
"Estonia","2024-02-08",0,0,0,0,0,0,0,0
"Estonia","2024-02-09",0,0,0,0,0,0,0,0
"Estonia","2024-02-10",0,0,0,0,0,0,0,0
"Estonia","2024-02-11",0,0,0,0,0,0,0,0
"Estonia","2024-02-12",0,0,0,0,0,0,0,0
"Estonia","2024-02-13",0,0,0,0,0,0,0,0
"Estonia","2024-02-14",0,0,0,0,0,0,0,0
"Estonia","2024-02-15",0,0,0,0,0,0,0,0
"Estonia","2024-02-16",0,0,0,0,0,0,0,0
"Estonia","2024-02-17",0,0,0,0,0,0,0,0
"Estonia","2024-02-18",0,0,0,0,0,0,0,0
"Estonia","2024-02-19",0,0,0,0,0,0,0,0
"Estonia","2024-02-20",0,0,0,0,0,0,0,0
"Estonia","2024-02-21",0,0,0,0,0,0,0,0
"Estonia","2024-02-22",0,0,0,0,0,0,0,0
"Estonia","2024-02-23",0,0,0,0,0,0,0,0
"Estonia","2024-02-24",0,0,0,0,0,0,0,0
"Estonia","2024-02-25",0,0,0,0,0,0,0,0
"Estonia","2024-02-26",0,0,0,0,0,0,0,0
"Estonia","2024-02-27",0,0,0,0,0,0,0,0
"Estonia","2024-02-28",0,0,0,0,0,0,0,0
"Estonia","2024-02-29",0,0,0,0,0,0,0,0
"Estonia","2024-03-01",0,0,0,0,0,0,0,0
"Estonia","2024-03-02",0,0,0,0,0,0,0,0
"Estonia","2024-03-03",0,0,0,0,0,0,0,0
"Estonia","2024-03-04",0,0,0,0,0,0,0,0
"Estonia","2024-03-05",0,0,0,0,0,0,0,0
"Estonia","2024-03-06",0,0,0,0,0,0,0,0
"Estonia","2024-03-07",0,0,0,0,0,0,0,0
"Estonia","2024-03-08",0,0,0,0,0,0,0,0
"Estonia","2024-03-09",0,0,0,0,0,0,0,0
"Estonia","2024-03-10",0,0,0,0,0,0,0,0
"Estonia","2024-03-11",0,0,0,0,0,0,0,0
"Estonia","2024-03-12",0,0,0,0,0,0,0,0
"Estonia","2024-03-13",0,0,0,0,0,0,0,0
"Estonia","2024-03-14",0,0,0,0,0,0,0,0
"Estonia","2024-03-15",0,0,0,0,0,0,0,0
"Estonia","2024-03-16",0,0,0,0,0,0,0,0
"Estonia","2024-03-17",0,0,0,0,0,0,0,0
"Estonia","2024-03-18",0,0,0,0,0,0,0,0
"Estonia","2024-03-19",0,0,0,0,0,0,0,0
"Estonia","2024-03-20",0,0,0,0,0,0,0,0
"Estonia","2024-03-21",0,0,0,0,0,0,0,0
"Estonia","2024-03-22",0,0,0,0,0,0,0,0
"Estonia","2024-03-23",0,0,0,0,0,0,0,0
"Estonia","2024-03-24",0,0,0,0,0,0,0,0
"Estonia","2024-03-25",0,0,0,0,0,0,0,0
"Estonia","2024-03-26",0,0,0,0,0,0,0,0
"Estonia","2024-03-27",0,0,0,0,0,0,0,0
"Estonia","2024-03-28",0,0,0,0,0,0,0,0
"Estonia","2024-03-29",0,0,0,0,0,0,0,0
"Estonia","2024-03-30",0,0,0,0,0,0,0,0
"Estonia","2024-03-31",0,0,0,0,0,0,0,0
"Estonia","2024-04-01",0,0,0,0,0,0,0,0
"Estonia","2024-04-02",0,0,0,0,0,0,0,0
"Estonia","2024-04-03",0,0,0,0,0,0,0,0
"Estonia","2024-04-04",0,0,0,0,0,0,0,0
"Estonia","2024-04-05",0,0,0,0,0,0,0,0
"Estonia","2024-04-06",0,0,0,0,0,0,0,0
"Estonia","2024-04-07",0,0,0,0,0,0,0,0
"Estonia","2024-04-08",0,0,0,0,0,0,0,0
"Estonia","2024-04-09",0,0,0,0,0,0,0,0
"Estonia","2024-04-10",0,0,0,0,0,0,0,0
"Estonia","2024-04-11",0,0,0,0,0,0,0,0
"Estonia","2024-04-12",0,0,0,0,0,0,0,0
"Estonia","2024-04-13",0,0,0,0,0,0,0,0
"Estonia","2024-04-14",0,0,0,0,0,0,0,0
"Estonia","2024-04-15",0,0,0,0,0,0,0,0
"Estonia","2024-04-16",0,0,0,0,0,0,0,0
"Estonia","2024-04-17",0,0,0,0,0,0,0,0
"Estonia","2024-04-18",0,0,0,0,0,0,0,0
"Estonia","2024-04-19",0,0,0,0,0,0,0,0
"Estonia","2024-04-20",0,0,0,0,0,0,0,0
"Estonia","2024-04-21",0,0,0,0,0,0,0,0
"Estonia","2024-04-22",0,0,0,0,0,0,0,0
"Estonia","2024-04-23",0,0,0,0,0,0,0,0
"Estonia","2024-04-24",0,0,0,0,0,0,0,0
"Estonia","2024-04-25",0,0,0,0,0,0,0,0
"Estonia","2024-04-26",0,0,0,0,0,0,0,0
"Estonia","2024-04-27",0,0,0,0,0,0,0,0
"Estonia","2024-04-28",0,0,0,0,0,0,0,0
"Estonia","2024-04-29",0,0,0,0,0,0,0,0
"Estonia","2024-04-30",0,0,0,0,0,0,0,0
"Estonia","2024-05-01",0,0,0,0,0,0,0,0
"Estonia","2024-05-02",0,0,0,0,0,0,0,0
"Estonia","2024-05-03",0,0,0,0,0,0,0,0
"Estonia","2024-05-04",0,0,0,0,0,0,0,0
"Estonia","2024-05-05",0,0,0,0,0,0,0,0
"Estonia","2024-05-06",0,0,0,0,0,0,0,0
"Estonia","2024-05-07",0,0,0,0,0,0,0,0
"Estonia","2024-05-08",0,0,0,0,0,0,0,0
"Estonia","2024-05-09",0,0,0,0,0,0,0,0
"Estonia","2024-05-10",0,0,0,0,0,0,0,0
"Estonia","2024-05-11",0,0,0,0,0,0,0,0
"Estonia","2024-05-12",0,0,0,0,0,0,0,0
"Estonia","2024-05-13",0,0,0,0,0,0,0,0
"Estonia","2024-05-14",0,0,0,0,0,0,0,0
"Estonia","2024-05-15",0,0,0,0,0,0,0,0
"Estonia","2024-05-16",0,0,0,0,0,0,0,0
"Estonia","2024-05-17",0,0,0,0,0,0,0,0
"Estonia","2024-05-18",0,0,0,0,0,0,0,0
"Estonia","2024-05-19",0,0,0,0,0,0,0,0
"Estonia","2024-05-20",0,0,0,0,0,0,0,0
"Estonia","2024-05-21",0,0,0,0,0,0,0,0
"Estonia","2024-05-22",0,0,0,0,0,0,0,0
"Estonia","2024-05-23",0,0,0,0,0,0,0,0
"Estonia","2024-05-24",0,0,0,0,0,0,0,0
"Estonia","2024-05-25",0,0,0,0,0,0,0,0
"Estonia","2024-05-26",0,0,0,0,0,0,0,0
"Estonia","2024-05-27",0,0,0,0,0,0,0,0
"Estonia","2024-05-28",0,0,0,0,0,0,0,0
"Estonia","2024-05-29",0,0,0,0,0,0,0,0
"Estonia","2024-05-30",0,0,0,0,0,0,0,0
"Estonia","2024-05-31",0,0,0,0,0,0,0,0
"Estonia","2024-06-01",0,0,0,0,0,0,0,0
"Estonia","2024-06-02",0,0,0,0,0,0,0,0
"Estonia","2024-06-03",0,0,0,0,0,0,0,0
"Estonia","2024-06-04",0,0,0,0,0,0,0,0
"Estonia","2024-06-05",0,0,0,0,0,0,0,0
"Estonia","2024-06-06",0,0,0,0,0,0,0,0
"Estonia","2024-06-07",0,0,0,0,0,0,0,0
"Estonia","2024-06-08",0,0,0,0,0,0,0,0
"Estonia","2024-06-09",0,0,0,0,0,0,0,0
"Estonia","2024-06-10",0,0,0,0,0,0,0,0
"Estonia","2024-06-11",0,0,0,0,0,0,0,0
"Estonia","2024-06-12",0,0,0,0,0,0,0,0
"Estonia","2024-06-13",0,0,0,0,0,0,0,0
"Estonia","2024-06-14",0,0,0,0,0,0,0,0
"Estonia","2024-06-15",0,0,0,0,0,0,0,0
"Estonia","2024-06-16",0,0,0,0,0,0,0,0
"Estonia","2024-06-17",0,0,0,0,0,0,0,0
"Estonia","2024-06-18",0,0,0,0,0,0,0,0
"Estonia","2024-06-19",0,0,0,0,0,0,0,0
"Estonia","2024-06-20",0,0,0,0,0,0,0,0
"Estonia","2024-06-21",0,0,0,0,0,0,0,0
"Estonia","2024-06-22",0,0,0,0,0,0,0,0
"Estonia","2024-06-23",0,0,0,0,0,0,0,0
"Estonia","2024-06-24",0,0,0,0,0,0,0,0
"Estonia","2024-06-25",0,0,0,0,0,0,0,0
"Estonia","2024-06-26",0,0,0,0,0,0,0,0
"Estonia","2024-06-27",0,0,0,0,0,0,0,0
"Estonia","2024-06-28",0,0,0,0,0,0,0,0
"Estonia","2024-06-29",0,0,0,0,0,0,0,0
"Estonia","2024-06-30",0,0,0,0,0,0,0,0
"Estonia","2024-07-01",0,0,0,0,0,0,0,0
"Estonia","2024-07-02",0,0,0,0,0,0,0,0
"Estonia","2024-07-03",0,0,0,0,0,0,0,0
"Estonia","2024-07-04",0,0,0,0,0,0,0,0
"Estonia","2024-07-05",0,0,0,0,0,0,0,0
"Estonia","2024-07-06",0,0,0,0,0,0,0,0
"Estonia","2024-07-07",0,0,0,0,0,0,0,0
"Estonia","2024-07-08",0,0,0,0,0,0,0,0
"Estonia","2024-07-09",0,0,0,0,0,0,0,0
"Estonia","2024-07-10",0,0,0,0,0,0,0,0
"Estonia","2024-07-11",0,0,0,0,0,0,0,0
"Estonia","2024-07-12",0,0,0,0,0,0,0,0
"Estonia","2024-07-13",0,0,0,0,0,0,0,0
"Estonia","2024-07-14",0,0,0,0,0,0,0,0
"Estonia","2024-07-15",0,0,0,0,0,0,0,0
"Estonia","2024-07-16",0,0,0,0,0,0,0,0
"Estonia","2024-07-17",0,0,0,0,0,0,0,0
"Estonia","2024-07-18",0,0,0,0,0,0,0,0
"Estonia","2024-07-19",0,0,0,0,0,0,0,0
"Estonia","2024-07-20",0,0,0,0,0,0,0,0
"Estonia","2024-07-21",0,0,0,0,0,0,0,0
"Estonia","2024-07-22",0,0,0,0,0,0,0,0
"Estonia","2024-07-23",0,0,0,0,0,0,0,0
"Estonia","2024-07-24",0,0,0,0,0,0,0,0
"Estonia","2024-07-25",0,0,0,0,0,0,0,0
"Estonia","2024-07-26",0,0,0,0,0,0,0,0
"Estonia","2024-07-27",0,0,0,0,0,0,0,0
"Estonia","2024-07-28",0,0,0,0,0,0,0,0
"Estonia","2024-07-29",0,0,0,0,0,0,0,0
"Estonia","2024-07-30",0,0,0,0,0,0,0,0
"Estonia","2024-07-31",0,0,0,0,0,0,0,0
"Estonia","2024-08-01",0,0,0,0,0,0,0,0
"Estonia","2024-08-02",0,0,0,0,0,0,0,0
"Estonia","2024-08-03",0,0,0,0,0,0,0,0
"Estonia","2024-08-04",0,0,0,0,0,0,0,0
"Estonia","2024-08-05",0,0,0,0,0,0,0,0
"Estonia","2024-08-06",0,0,0,0,0,0,0,0
"Estonia","2024-08-07",0,0,0,0,0,0,0,0
"Estonia","2024-08-08",0,0,0,0,0,0,0,0
"Estonia","2024-08-09",0,0,0,0,0,0,0,0
"Estonia","2024-08-10",0,0,0,0,0,0,0,0
"Estonia","2024-08-11",0,0,0,0,0,0,0,0
"Estonia","2024-08-12",0,0,0,0,0,0,0,0
"Estonia","2024-08-13",0,0,0,0,0,0,0,0
"Estonia","2024-08-14",0,0,0,0,0,0,0,0
"Estonia","2024-08-15",0,0,0,0,0,0,0,0
"Estonia","2024-08-16",0,0,0,0,0,0,0,0
"Estonia","2024-08-17",0,0,0,0,0,0,0,0
"Estonia","2024-08-18",0,0,0,0,0,0,0,0
"Estonia","2024-08-19",0,0,0,0,0,0,0,0
"Estonia","2024-08-20",0,0,0,0,0,0,0,0
"Estonia","2024-08-21",0,0,0,0,0,0,0,0
"Estonia","2024-08-22",0,0,0,0,0,0,0,0
"Estonia","2024-08-23",0,0,0,0,0,0,0,0
"Estonia","2024-08-24",0,0,0,0,0,0,0,0
"Estonia","2024-08-25",0,0,0,0,0,0,0,0
"Estonia","2024-08-26",0,0,0,0,0,0,0,0
"Estonia","2024-08-27",0,0,0,0,0,0,0,0
"Estonia","2024-08-28",0,0,0,0,0,0,0,0
"Estonia","2024-08-29",0,0,0,0,0,0,0,0
"Estonia","2024-08-30",0,0,0,0,0,0,0,0
"Estonia","2024-08-31",0,0,0,0,0,0,0,0
"Estonia","2024-09-01",0,0,0,0,0,0,0,0
"Estonia","2024-09-02",0,0,0,0,0,0,0,0
"Estonia","2024-09-03",0,0,0,0,0,0,0,0
"Estonia","2024-09-04",0,0,0,0,0,0,0,0
"Estonia","2024-09-05",0,0,0,0,0,0,0,0
"Estonia","2024-09-06",0,0,0,0,0,0,0,0
"Estonia","2024-09-07",0,0,0,0,0,0,0,0
"Estonia","2024-09-08",0,0,0,0,0,0,0,0
"Estonia","2024-09-09",0,0,0,0,0,0,0,0
"Estonia","2024-09-10",0,0,0,0,0,0,0,0
"Estonia","2024-09-11",0,0,0,0,0,0,0,0
"Estonia","2024-09-12",0,0,0,0,0,0,0,0
"Estonia","2024-09-13",0,0,0,0,0,0,0,0
"Estonia","2024-09-14",0,0,0,0,0,0,0,0
"Estonia","2024-09-15",0,0,0,0,0,0,0,0
"Estonia","2024-09-16",0,0,0,0,0,0,0,0
"Estonia","2024-09-17",0,0,0,0,0,0,0,0
"Estonia","2024-09-18",0,0,0,0,0,0,0,0
"Estonia","2024-09-19",0,0,0,0,0,0,0,0
"Estonia","2024-09-20",0,0,0,0,0,0,0,0
"Estonia","2024-09-21",0,0,0,0,0,0,0,0
"Estonia","2024-09-22",0,0,0,0,0,0,0,0
"Estonia","2024-09-23",0,0,0,0,0,0,0,0
"Estonia","2024-09-24",0,0,0,0,0,0,0,0
"Estonia","2024-09-25",0,0,0,0,0,0,0,0
"Estonia","2024-09-26",0,0,0,0,0,0,0,0
"Estonia","2024-09-27",0,0,0,0,0,0,0,0
"Estonia","2024-09-28",0,0,0,0,0,0,0,0
"Estonia","2024-09-29",0,0,0,0,0,0,0,0
"Estonia","2024-09-30",0,0,0,0,0,0,0,0
"Estonia","2024-10-01",0,0,0,0,0,0,0,0
"Estonia","2024-10-02",0,0,0,0,0,0,0,0
"Estonia","2024-10-03",0,0,0,0,0,0,0,0
"Estonia","2024-10-04",0,0,0,0,0,0,0,0
"Estonia","2024-10-05",0,0,0,0,0,0,0,0
"Estonia","2024-10-06",0,0,0,0,0,0,0,0
"Estonia","2024-10-07",0,0,0,0,0,0,0,0
"Estonia","2024-10-08",0,0,0,0,0,0,0,0
"Estonia","2024-10-09",0,0,0,0,0,0,0,0
"Estonia","2024-10-10",0,0,0,0,0,0,0,0
"Estonia","2024-10-11",0,0,0,0,0,0,0,0
"Estonia","2024-10-12",0,0,0,0,0,0,0,0
"Estonia","2024-10-13",0,0,0,0,0,0,0,0
"Estonia","2024-10-14",0,0,0,0,0,0,0,0
"Estonia","2024-10-15",0,0,0,0,0,0,0,0
"Estonia","2024-10-16",0,0,0,0,0,0,0,0
"Estonia","2024-10-17",0,0,0,0,0,0,0,0
"Estonia","2024-10-18",0,0,0,0,0,0,0,0
"Estonia","2024-10-19",0,0,0,0,0,0,0,0
"Estonia","2024-10-20",0,0,0,0,0,0,0,0
"Estonia","2024-10-21",0,0,0,0,0,0,0,0
"Estonia","2024-10-22",0,0,0,0,0,0,0,0
"Estonia","2024-10-23",0,0,0,0,0,0,0,0
"Estonia","2024-10-24",0,0,0,0,0,0,0,0
"Estonia","2024-10-25",0,0,0,0,0,0,0,0
"Estonia","2024-10-26",0,0,0,0,0,0,0,0
"Estonia","2024-10-27",0,0,0,0,0,0,0,0
"Estonia","2024-10-28",0,0,0,0,0,0,0,0
"Estonia","2024-10-29",0,0,0,0,0,0,0,0
"Estonia","2024-10-30",0,0,0,0,0,0,0,0
"Estonia","2024-10-31",0,0,0,0,0,0,0,0
"Estonia","2024-11-01",0,0,0,0,0,0,0,0
"Estonia","2024-11-02",0,0,0,0,0,0,0,0
"Estonia","2024-11-03",0,0,0,0,0,0,0,0
"Estonia","2024-11-04",0,0,0,0,0,0,0,0
"Estonia","2024-11-05",0,0,0,0,0,0,0,0
"Estonia","2024-11-06",0,0,0,0,0,0,0,0
"Estonia","2024-11-07",0,0,0,0,0,0,0,0
"Estonia","2024-11-08",0,0,0,0,0,0,0,0
"Estonia","2024-11-09",0,0,0,0,0,0,0,0
"Estonia","2024-11-10",0,0,0,0,0,0,0,0
"Estonia","2024-11-11",0,0,0,0,0,0,0,0
"Estonia","2024-11-12",0,0,0,0,0,0,0,0
"Estonia","2024-11-13",0,0,0,0,0,0,0,0
"Estonia","2024-11-14",0,0,0,0,0,0,0,0
"Estonia","2024-11-15",0,0,0,0,0,0,0,0
"Estonia","2024-11-16",0,0,0,0,0,0,0,0
"Estonia","2024-11-17",0,0,0,0,0,0,0,0
"Estonia","2024-11-18",0,0,0,0,0,0,0,0
"Estonia","2024-11-19",0,0,0,0,0,0,0,0
"Estonia","2024-11-20",0,0,0,0,0,0,0,0
"Estonia","2024-11-21",0,0,0,0,0,0,0,0
"Estonia","2024-11-22",0,0,0,0,0,0,0,0
"Estonia","2024-11-23",0,0,0,0,0,0,0,0
"Estonia","2024-11-24",0,0,0,0,0,0,0,0
"Estonia","2024-11-25",0,0,0,0,0,0,0,0
"Estonia","2024-11-26",0,0,0,0,0,0,0,0
"Estonia","2024-11-27",0,0,0,0,0,0,0,0
"Estonia","2024-11-28",0,0,0,0,0,0,0,0
"Estonia","2024-11-29",0,0,0,0,0,0,0,0
"Estonia","2024-11-30",0,0,0,0,0,0,0,0
"Estonia","2024-12-01",0,0,0,0,0,0,0,0
"Estonia","2024-12-02",0,0,0,0,0,0,0,0
"Estonia","2024-12-03",0,0,0,0,0,0,0,0
"Estonia","2024-12-04",0,0,0,0,0,0,0,0
"Estonia","2024-12-05",0,0,0,0,0,0,0,0
"Estonia","2024-12-06",0,0,0,0,0,0,0,0
"Estonia","2024-12-07",0,0,0,0,0,0,0,0
"Estonia","2024-12-08",0,0,0,0,0,0,0,0
"Estonia","2024-12-09",0,0,0,0,0,0,0,0
"Estonia","2024-12-10",0,0,0,0,0,0,0,0
"Estonia","2024-12-11",0,0,0,0,0,0,0,0
"Estonia","2024-12-12",0,0,0,0,0,0,0,0
"Estonia","2024-12-13",0,0,0,0,0,0,0,0
"Estonia","2024-12-14",0,0,0,0,0,0,0,0
"Estonia","2024-12-15",0,0,0,0,0,0,0,0
"Estonia","2024-12-16",0,0,0,0,0,0,0,0
"Estonia","2024-12-17",0,0,0,0,0,0,0,0
"Estonia","2024-12-18",0,0,0,0,0,0,0,0
"Estonia","2024-12-19",0,0,0,0,0,0,0,0
"Estonia","2024-12-20",0,0,0,0,0,0,0,0
"Estonia","2024-12-21",0,0,0,0,0,0,0,0
"Estonia","2024-12-22",0,0,0,0,0,0,0,0
"Estonia","2024-12-23",0,0,0,0,0,0,0,0
"Estonia","2024-12-24",0,0,0,0,0,0,0,0
"Estonia","2024-12-25",0,0,0,0,0,0,0,0
"Estonia","2024-12-26",0,0,0,0,0,0,0,0
"Estonia","2024-12-27",0,0,0,0,0,0,0,0
"Estonia","2024-12-28",0,0,0,0,0,0,0,0
"Estonia","2024-12-29",0,0,0,0,0,0,0,0
"Estonia","2024-12-30",0,0,0,0,0,0,0,0
"Estonia","2024-12-31",0,0,0,0,0,0,0,0
"Estonia","2025-01-01",0,0,0,0,0,0,0,0
"Estonia","2025-01-02",0,0,0,0,0,0,0,0
"Estonia","2025-01-03",0,0,0,0,0,0,0,0
"Estonia","2025-01-04",0,0,0,0,0,0,0,0
"Estonia","2025-01-05",0,0,0,0,0,0,0,0
"Estonia","2025-01-06",0,0,0,0,0,0,0,0
"Estonia","2025-01-07",0,0,0,0,0,0,0,0
"Estonia","2025-01-08",0,0,0,0,0,0,0,0
"Estonia","2025-01-09",0,0,0,0,0,0,0,0
"Estonia","2025-01-10",0,0,0,0,0,0,0,0
"Estonia","2025-01-11",0,0,0,0,0,0,0,0
"Estonia","2025-01-12",0,0,0,0,0,0,0,0
"Estonia","2025-01-13",0,0,0,0,0,0,0,0
"Estonia","2025-01-14",0,0,0,0,0,0,0,0
"Estonia","2025-01-15",0,0,0,0,0,0,0,0
"Estonia","2025-01-16",0,0,0,0,0,0,0,0
"Estonia","2025-01-17",0,0,0,0,0,0,0,0
"Estonia","2025-01-18",0,0,0,0,0,0,0,0
"Estonia","2025-01-19",0,0,0,0,0,0,0,0
"Estonia","2025-01-20",0,0,0,0,0,0,0,0
"Estonia","2025-01-21",0,0,0,0,0,0,0,0
"Estonia","2025-01-22",0,0,0,0,0,0,0,0
"Estonia","2025-01-23",0,0,0,0,0,0,0,0
"Estonia","2025-01-24",0,0,0,0,0,0,0,0
"Estonia","2025-01-25",0,0,0,0,0,0,0,0
"Estonia","2025-01-26",0,0,0,0,0,0,0,0
"Estonia","2025-01-27",0,0,0,0,0,0,0,0
"Estonia","2025-01-28",0,0,0,0,0,0,0,0
"Estonia","2025-01-29",0,0,0,0,0,0,0,0
"Estonia","2025-01-30",0,0,0,0,0,0,0,0
"Estonia","2025-01-31",0,0,0,0,0,0,0,0
"Estonia","2025-02-01",0,0,0,0,0,0,0,0
"Estonia","2025-02-02",0,0,0,0,0,0,0,0
"Estonia","2025-02-03",0,0,0,0,0,0,0,0
"Europe","2024-01-01",0,0,0,0,0,0,0,0
"Europe","2024-01-02",0,0,0,0,0,0,0,0
"Europe","2024-01-03",0,0,0,0,0,0,0,0
"Europe","2024-01-04",0,0,0,0,0,0,0,0
"Europe","2024-01-05",0,0,0,0,0,0,0,0
"Europe","2024-01-06",0,0,0,0,0,0,0,0
"Europe","2024-01-07",0,0,0,0,0,0,0,0
"Europe","2024-01-08",0,0,0,0,0,0,0,0
"Europe","2024-01-09",0,0,0,0,0,0,0,0
"Europe","2024-01-10",0,0,0,0,0,0,0,0
"Europe","2024-01-11",0,0,0,0,0,0,0,0
"Europe","2024-01-12",0,0,0,0,0,0,0,0
"Europe","2024-01-13",0,0,0,0,0,0,0,0
"Europe","2024-01-14",0,0,0,0,0,0,0,0
"Europe","2024-01-15",0,0,0,0,0,0,0,0
"Europe","2024-01-16",0,0,0,0,0,0,0,0
"Europe","2024-01-17",0,0,0,0,0,0,0,0
"Europe","2024-01-18",0,0,0,0,0,0,0,0
"Europe","2024-01-19",0,0,0,0,0,0,0,0
"Europe","2024-01-20",0,0,0,0,0,0,0,0
"Europe","2024-01-21",0,0,0,0,0,0,0,0
"Europe","2024-01-22",0,0,0,0,0,0,0,0
"Europe","2024-01-23",0,0,0,0,0,0,0,0
"Europe","2024-01-24",0,0,0,0,0,0,0,0
"Europe","2024-01-25",0,0,0,0,0,0,0,0
"Europe","2024-01-26",0,0,0,0,0,0,0,0
"Europe","2024-01-27",0,0,0,0,0,0,0,0
"Europe","2024-01-28",0,0,0,0,0,0,0,0
"Europe","2024-01-29",0,0,0,0,0,0,0,0
"Europe","2024-01-30",0,0,0,0,0,0,0,0
"Europe","2024-01-31",0,141,141,0,141,141,0,0
"Europe","2024-02-01",0,0,141,0,7,148,0,0
"Europe","2024-02-02",0,0,141,0,6,154,0,0
"Europe","2024-02-03",0,0,141,0,7,161,0,0
"Europe","2024-02-04",0,0,141,0,7,168,0,0
"Europe","2024-02-05",0,0,141,0,7,175,0,0
"Europe","2024-02-06",0,0,141,0,6,181,0,0
"Europe","2024-02-07",0,0,141,0,7,188,0,0
"Europe","2024-02-08",0,0,141,0,7,195,0,0
"Europe","2024-02-09",0,0,141,0,7,202,0,0
"Europe","2024-02-10",0,0,141,0,6,208,0,0
"Europe","2024-02-11",0,0,141,0,7,215,0,0
"Europe","2024-02-12",0,0,141,0,7,222,0,0
"Europe","2024-02-13",0,0,141,0,6,228,0,0
"Europe","2024-02-14",0,0,141,0,7,235,0,0
"Europe","2024-02-15",0,0,141,0,7,242,0,0
"Europe","2024-02-16",0,0,141,0,7,249,0,0
"Europe","2024-02-17",0,0,141,0,6,255,0,0
"Europe","2024-02-18",0,0,141,0,7,262,0,0
"Europe","2024-02-19",0,0,141,0,7,269,0,0
"Europe","2024-02-20",0,0,141,0,6,275,0,0
"Europe","2024-02-21",0,0,141,0,7,282,0,0
"Europe","2024-02-22",0,0,141,0,7,289,0,0
"Europe","2024-02-23",0,0,141,0,7,296,0,0
"Europe","2024-02-24",0,0,141,0,6,302,0,0
"Europe","2024-02-25",0,0,141,0,7,309,0,0
"Europe","2024-02-26",0,0,141,0,7,316,0,0
"Europe","2024-02-27",0,0,141,0,7,323,0,0
"Europe","2024-02-28",0,0,141,0,6,329,0,0
"Europe","2024-02-29",0,195,336,0,7,336,0,0
"Europe","2024-03-01",0,0,336,0,4,340,0,0
"Europe","2024-03-02",0,0,336,0,4,344,0,0
"Europe","2024-03-03",0,0,336,0,4,348,0,0
"Europe","2024-03-04",0,0,336,0,4,352,0,0
"Europe","2024-03-05",0,0,336,0,4,356,0,0
"Europe","2024-03-06",0,0,336,0,4,360,0,0
"Europe","2024-03-07",0,0,336,0,4,364,0,0
"Europe","2024-03-08",0,0,336,0,4,368,0,0
"Europe","2024-03-09",0,0,336,0,4,372,0,0
"Europe","2024-03-10",0,0,336,0,4,376,0,0
"Europe","2024-03-11",0,0,336,0,4,380,0,0
"Europe","2024-03-12",0,0,336,0,4,384,0,0
"Europe","2024-03-13",0,0,336,0,4,388,0,0
"Europe","2024-03-14",0,0,336,0,4,392,0,0
"Europe","2024-03-15",0,0,336,0,4,396,0,0
"Europe","2024-03-16",0,0,336,0,3,399,0,0
"Europe","2024-03-17",0,0,336,0,4,403,0,0
"Europe","2024-03-18",0,0,336,0,4,407,0,0
"Europe","2024-03-19",0,0,336,0,4,411,0,0
"Europe","2024-03-20",0,0,336,0,4,415,0,0
"Europe","2024-03-21",0,0,336,0,4,419,0,0
"Europe","2024-03-22",0,0,336,0,4,423,0,0
"Europe","2024-03-23",0,0,336,0,4,427,0,0
"Europe","2024-03-24",0,0,336,0,4,431,0,0
"Europe","2024-03-25",0,0,336,0,4,435,0,0
"Europe","2024-03-26",0,0,336,0,4,439,0,0
"Europe","2024-03-27",0,0,336,0,4,443,0,0
"Europe","2024-03-28",0,0,336,0,4,447,0,0
"Europe","2024-03-29",0,0,336,0,4,451,0,0
"Europe","2024-03-30",0,0,336,0,4,455,0,0
"Europe","2024-03-31",0,123,459,0,4,459,0,0
"Europe","2024-04-01",0,0,459,0,4,463,0,0
"Europe","2024-04-02",0,0,459,0,3,466,0,0
"Europe","2024-04-03",0,0,459,0,4,470,0,0
"Europe","2024-04-04",0,0,459,0,3,473,0,0
"Europe","2024-04-05",0,0,459,0,4,477,0,0
"Europe","2024-04-06",0,0,459,0,4,481,0,0
"Europe","2024-04-07",0,0,459,0,3,484,0,0
"Europe","2024-04-08",0,0,459,0,4,488,0,0
"Europe","2024-04-09",0,0,459,0,3,491,0,0
"Europe","2024-04-10",0,0,459,0,4,495,0,0
"Europe","2024-04-11",0,0,459,0,4,499,0,0
"Europe","2024-04-12",0,0,459,0,3,502,0,0
"Europe","2024-04-13",0,0,459,0,4,506,0,0
"Europe","2024-04-14",0,0,459,0,3,509,0,0
"Europe","2024-04-15",0,0,459,0,4,513,0,0
"Europe","2024-04-16",0,0,459,0,4,517,0,0
"Europe","2024-04-17",0,0,459,0,3,520,0,0
"Europe","2024-04-18",0,0,459,0,4,524,0,0
"Europe","2024-04-19",0,0,459,0,3,527,0,0
"Europe","2024-04-20",0,0,459,0,4,531,0,0
"Europe","2024-04-21",0,0,459,0,4,535,0,0
"Europe","2024-04-22",0,0,459,0,3,538,0,0
"Europe","2024-04-23",0,0,459,0,4,542,0,0
"Europe","2024-04-24",0,0,459,0,3,545,0,0
"Europe","2024-04-25",0,0,459,0,4,549,0,0
"Europe","2024-04-26",0,0,459,0,4,553,0,0
"Europe","2024-04-27",0,0,459,0,3,556,0,0
"Europe","2024-04-28",0,0,459,0,4,560,0,0
"Europe","2024-04-29",0,0,459,0,3,563,0,0
"Europe","2024-04-30",0,108,567,0,4,567,0,0
"Europe","2024-05-01",0,0,567,0,4,571,0,0
"Europe","2024-05-02",0,0,567,0,4,575,0,0
"Europe","2024-05-03",0,0,567,0,4,579,0,0
"Europe","2024-05-04",0,0,567,0,4,583,0,0
"Europe","2024-05-05",0,0,567,0,4,587,0,0
"Europe","2024-05-06",0,0,567,0,4,591,0,0
"Europe","2024-05-07",0,0,567,0,4,595,0,0
"Europe","2024-05-08",0,0,567,0,4,599,0,0
"Europe","2024-05-09",0,0,567,0,4,603,0,0
"Europe","2024-05-10",0,0,567,0,4,607,0,0
"Europe","2024-05-11",0,0,567,0,4,611,0,0
"Europe","2024-05-12",0,0,567,0,4,615,0,0
"Europe","2024-05-13",0,0,567,0,4,619,0,0
"Europe","2024-05-14",0,0,567,0,4,623,0,0
"Europe","2024-05-15",0,0,567,0,4,627,0,0
"Europe","2024-05-16",0,0,567,0,3,630,0,0
"Europe","2024-05-17",0,0,567,0,4,634,0,0
"Europe","2024-05-18",0,0,567,0,4,638,0,0
"Europe","2024-05-19",0,0,567,0,4,642,0,0
"Europe","2024-05-20",0,0,567,0,4,646,0,0
"Europe","2024-05-21",0,0,567,0,4,650,0,0
"Europe","2024-05-22",0,0,567,0,4,654,0,0
"Europe","2024-05-23",0,0,567,0,4,658,0,0
"Europe","2024-05-24",0,0,567,0,4,662,0,0
"Europe","2024-05-25",0,0,567,0,4,666,0,0
"Europe","2024-05-26",0,0,567,0,4,670,0,0
"Europe","2024-05-27",0,0,567,0,4,674,0,0
"Europe","2024-05-28",0,0,567,0,4,678,0,0
"Europe","2024-05-29",0,0,567,0,4,682,0,0
"Europe","2024-05-30",0,0,567,0,4,686,0,0
"Europe","2024-05-31",0,123,690,0,4,690,0,0
"Europe","2024-06-01",0,0,690,0,3,693,0,0
"Europe","2024-06-02",0,0,690,0,4,697,0,0
"Europe","2024-06-03",0,0,690,0,3,700,0,0
"Europe","2024-06-04",0,0,690,0,3,703,0,0
"Europe","2024-06-05",0,0,690,0,3,706,0,0
"Europe","2024-06-06",0,0,690,0,4,710,0,0
"Europe","2024-06-07",0,0,690,0,3,713,0,0
"Europe","2024-06-08",0,0,690,0,3,716,0,0
"Europe","2024-06-09",0,0,690,0,3,719,0,0
"Europe","2024-06-10",0,0,690,0,4,723,0,0
"Europe","2024-06-11",0,0,690,0,3,726,0,0
"Europe","2024-06-12",0,0,690,0,3,729,0,0
"Europe","2024-06-13",0,0,690,0,3,732,0,0
"Europe","2024-06-14",0,0,690,0,4,736,0,0
"Europe","2024-06-15",0,0,690,0,3,739,0,0
"Europe","2024-06-16",0,0,690,0,3,742,0,0
"Europe","2024-06-17",0,0,690,0,4,746,0,0
"Europe","2024-06-18",0,0,690,0,3,749,0,0
"Europe","2024-06-19",0,0,690,0,3,752,0,0
"Europe","2024-06-20",0,0,690,0,3,755,0,0
"Europe","2024-06-21",0,0,690,0,4,759,0,0
"Europe","2024-06-22",0,0,690,0,3,762,0,0
"Europe","2024-06-23",0,0,690,0,3,765,0,0
"Europe","2024-06-24",0,0,690,0,3,768,0,0
"Europe","2024-06-25",0,0,690,0,4,772,0,0
"Europe","2024-06-26",0,0,690,0,3,775,0,0
"Europe","2024-06-27",0,0,690,0,3,778,0,0
"Europe","2024-06-28",0,0,690,0,3,781,0,0
"Europe","2024-06-29",0,0,690,0,4,785,0,0
"Europe","2024-06-30",0,98,788,0,3,788,0,0
"Europe","2024-07-01",0,0,788,0,5,793,0,0
"Europe","2024-07-02",0,0,788,0,5,798,0,0
"Europe","2024-07-03",0,0,788,0,4,802,0,0
"Europe","2024-07-04",0,0,788,0,5,807,0,0
"Europe","2024-07-05",0,0,788,0,5,812,0,0
"Europe","2024-07-06",0,0,788,0,5,817,0,0
"Europe","2024-07-07",0,0,788,0,4,821,0,0
"Europe","2024-07-08",0,0,788,0,5,826,0,0
"Europe","2024-07-09",0,0,788,0,5,831,0,0
"Europe","2024-07-10",0,0,788,0,5,836,0,0
"Europe","2024-07-11",0,0,788,0,5,841,0,0
"Europe","2024-07-12",0,0,788,0,4,845,0,0
"Europe","2024-07-13",0,0,788,0,5,850,0,0
"Europe","2024-07-14",0,0,788,0,5,855,0,0
"Europe","2024-07-15",0,0,788,0,5,860,0,0
"Europe","2024-07-16",0,0,788,0,4,864,0,0
"Europe","2024-07-17",0,0,788,0,5,869,0,0
"Europe","2024-07-18",0,0,788,0,5,874,0,0
"Europe","2024-07-19",0,0,788,0,5,879,0,0
"Europe","2024-07-20",0,0,788,0,4,883,0,0
"Europe","2024-07-21",0,0,788,0,5,888,0,0
"Europe","2024-07-22",0,0,788,0,5,893,0,0
"Europe","2024-07-23",0,0,788,0,5,898,0,0
"Europe","2024-07-24",0,0,788,0,5,903,0,0
"Europe","2024-07-25",0,0,788,0,4,907,0,0
"Europe","2024-07-26",0,0,788,0,5,912,0,0
"Europe","2024-07-27",0,0,788,0,5,917,0,0
"Europe","2024-07-28",0,0,788,0,5,922,0,0
"Europe","2024-07-29",0,0,788,0,4,926,0,0
"Europe","2024-07-30",0,0,788,0,5,931,0,0
"Europe","2024-07-31",0,148,936,0,5,936,0,0
"Europe","2024-08-01",0,0,936,0,9,945,0,0
"Europe","2024-08-02",0,0,936,0,9,954,0,0
"Europe","2024-08-03",0,0,936,0,9,963,0,0
"Europe","2024-08-04",0,0,936,0,9,972,0,0
"Europe","2024-08-05",0,0,936,0,9,981,0,0
"Europe","2024-08-06",0,0,936,0,9,990,0,0
"Europe","2024-08-07",0,0,936,0,9,999,0,0
"Europe","2024-08-08",0,0,936,0,10,1009,0,0
"Europe","2024-08-09",0,0,936,0,9,1018,0,0
"Europe","2024-08-10",0,0,936,0,9,1027,0,0
"Europe","2024-08-11",0,0,936,0,9,1036,0,0
"Europe","2024-08-12",0,0,936,0,9,1045,0,0
"Europe","2024-08-13",0,0,936,0,9,1054,0,0
"Europe","2024-08-14",0,0,936,0,9,1063,0,0
"Europe","2024-08-15",0,0,936,0,9,1072,0,0
"Europe","2024-08-16",0,0,936,0,9,1081,0,0
"Europe","2024-08-17",0,0,936,0,9,1090,0,0
"Europe","2024-08-18",0,0,936,0,9,1099,0,0
"Europe","2024-08-19",0,0,936,0,9,1108,0,0
"Europe","2024-08-20",0,0,936,0,9,1117,0,0
"Europe","2024-08-21",0,0,936,0,9,1126,0,0
"Europe","2024-08-22",0,0,936,0,9,1135,0,0
"Europe","2024-08-23",0,0,936,0,9,1144,0,0
"Europe","2024-08-24",0,0,936,0,10,1154,0,0
"Europe","2024-08-25",0,0,936,0,9,1163,0,0
"Europe","2024-08-26",0,0,936,0,9,1172,0,0
"Europe","2024-08-27",0,0,936,0,9,1181,0,0
"Europe","2024-08-28",0,0,936,0,9,1190,0,0
"Europe","2024-08-29",0,0,936,0,9,1199,0,0
"Europe","2024-08-30",0,0,936,0,9,1208,0,0
"Europe","2024-08-31",0,281,1217,0,9,1217,0,0
"Europe","2024-09-01",0,0,1217,0,6,1223,0,0
"Europe","2024-09-02",0,0,1217,0,7,1230,0,0
"Europe","2024-09-03",0,0,1217,0,6,1236,0,0
"Europe","2024-09-04",0,0,1217,0,6,1242,0,0
"Europe","2024-09-05",0,0,1217,0,7,1249,0,0
"Europe","2024-09-06",0,0,1217,0,6,1255,0,0
"Europe","2024-09-07",0,0,1217,0,7,1262,0,0
"Europe","2024-09-08",0,0,1217,0,6,1268,0,0
"Europe","2024-09-09",0,0,1217,0,6,1274,0,0
"Europe","2024-09-10",0,0,1217,0,7,1281,0,0
"Europe","2024-09-11",0,0,1217,0,6,1287,0,0
"Europe","2024-09-12",0,0,1217,0,6,1293,0,0
"Europe","2024-09-13",0,0,1217,0,7,1300,0,0
"Europe","2024-09-14",0,0,1217,0,6,1306,0,0
"Europe","2024-09-15",0,0,1217,0,7,1313,0,0
"Europe","2024-09-16",0,0,1217,0,6,1319,0,0
"Europe","2024-09-17",0,0,1217,0,6,1325,0,0
"Europe","2024-09-18",0,0,1217,0,7,1332,0,0
"Europe","2024-09-19",0,0,1217,0,6,1338,0,0
"Europe","2024-09-20",0,0,1217,0,6,1344,0,0
"Europe","2024-09-21",0,0,1217,0,7,1351,0,0
"Europe","2024-09-22",0,0,1217,0,6,1357,0,0
"Europe","2024-09-23",0,0,1217,0,6,1363,0,0
"Europe","2024-09-24",0,0,1217,0,7,1370,0,0
"Europe","2024-09-25",0,0,1217,0,6,1376,0,0
"Europe","2024-09-26",0,0,1217,0,7,1383,0,0
"Europe","2024-09-27",0,0,1217,0,6,1389,0,0
"Europe","2024-09-28",0,0,1217,0,6,1395,0,0
"Europe","2024-09-29",0,0,1217,0,7,1402,0,0
"Europe","2024-09-30",0,191,1408,0,6,1408,0,0
"Europe","2024-10-01",0,0,1408,0,8,1416,0,0
"Europe","2024-10-02",0,0,1408,0,7,1423,0,0
"Europe","2024-10-03",0,0,1408,0,8,1431,0,0
"Europe","2024-10-04",0,0,1408,0,7,1438,0,0
"Europe","2024-10-05",0,0,1408,0,8,1446,0,0
"Europe","2024-10-06",0,0,1408,0,7,1453,0,0
"Europe","2024-10-07",0,0,1408,0,8,1461,0,0
"Europe","2024-10-08",0,0,1408,0,7,1468,0,0
"Europe","2024-10-09",0,0,1408,0,8,1476,0,0
"Europe","2024-10-10",0,0,1408,0,7,1483,0,0
"Europe","2024-10-11",0,0,1408,0,8,1491,0,0
"Europe","2024-10-12",0,0,1408,0,8,1499,0,0
"Europe","2024-10-13",0,0,1408,0,7,1506,0,0
"Europe","2024-10-14",0,0,1408,0,8,1514,0,0
"Europe","2024-10-15",0,0,1408,0,7,1521,0,0
"Europe","2024-10-16",0,0,1408,0,8,1529,0,0
"Europe","2024-10-17",0,0,1408,0,7,1536,0,0
"Europe","2024-10-18",0,0,1408,0,8,1544,0,0
"Europe","2024-10-19",0,0,1408,0,7,1551,0,0
"Europe","2024-10-20",0,0,1408,0,8,1559,0,0
"Europe","2024-10-21",0,0,1408,0,8,1567,0,0
"Europe","2024-10-22",0,0,1408,0,7,1574,0,0
"Europe","2024-10-23",0,0,1408,0,8,1582,0,0
"Europe","2024-10-24",0,0,1408,0,7,1589,0,0
"Europe","2024-10-25",0,0,1408,0,8,1597,0,0
"Europe","2024-10-26",0,0,1408,0,7,1604,0,0
"Europe","2024-10-27",0,0,1408,0,8,1612,0,0
"Europe","2024-10-28",0,0,1408,0,7,1619,0,0
"Europe","2024-10-29",0,0,1408,0,8,1627,0,0
"Europe","2024-10-30",0,0,1408,0,7,1634,0,0
"Europe","2024-10-31",0,234,1642,0,8,1642,0,0
"Europe","2024-11-01",0,0,1642,0,9,1651,0,0
"Europe","2024-11-02",0,0,1642,0,9,1660,0,0
"Europe","2024-11-03",0,0,1642,0,10,1670,0,0
"Europe","2024-11-04",0,0,1642,0,9,1679,0,0
"Europe","2024-11-05",0,0,1642,0,9,1688,0,0
"Europe","2024-11-06",0,0,1642,0,9,1697,0,0
"Europe","2024-11-07",0,0,1642,0,10,1707,0,0
"Europe","2024-11-08",0,0,1642,0,9,1716,0,0
"Europe","2024-11-09",0,0,1642,0,9,1725,0,0
"Europe","2024-11-10",0,0,1642,0,9,1734,0,0
"Europe","2024-11-11",0,0,1642,0,10,1744,0,0
"Europe","2024-11-12",0,0,1642,0,9,1753,0,0
"Europe","2024-11-13",0,0,1642,0,9,1762,0,0
"Europe","2024-11-14",0,0,1642,0,9,1771,0,0
"Europe","2024-11-15",0,0,1642,0,9,1780,0,0
"Europe","2024-11-16",0,0,1642,0,10,1790,0,0
"Europe","2024-11-17",0,0,1642,0,9,1799,0,0
"Europe","2024-11-18",0,0,1642,0,9,1808,0,0
"Europe","2024-11-19",0,0,1642,0,9,1817,0,0
"Europe","2024-11-20",0,0,1642,0,10,1827,0,0
"Europe","2024-11-21",0,0,1642,0,9,1836,0,0
"Europe","2024-11-22",0,0,1642,0,9,1845,0,0
"Europe","2024-11-23",0,0,1642,0,9,1854,0,0
"Europe","2024-11-24",0,0,1642,0,10,1864,0,0
"Europe","2024-11-25",0,0,1642,0,9,1873,0,0
"Europe","2024-11-26",0,0,1642,0,9,1882,0,0
"Europe","2024-11-27",0,0,1642,0,9,1891,0,0
"Europe","2024-11-28",0,0,1642,0,10,1901,0,0
"Europe","2024-11-29",0,0,1642,0,9,1910,0,0
"Europe","2024-11-30",0,277,1919,0,9,1919,0,0
"Europe","2024-12-01",0,0,1919,0,7,1926,0,0
"Europe","2024-12-02",0,0,1919,0,6,1932,0,0
"Europe","2024-12-03",0,0,1919,0,7,1939,0,0
"Europe","2024-12-04",0,0,1919,0,6,1945,0,0
"Europe","2024-12-05",0,0,1919,0,7,1952,0,0
"Europe","2024-12-06",0,0,1919,0,6,1958,0,0
"Europe","2024-12-07",0,0,1919,0,7,1965,0,0
"Europe","2024-12-08",0,0,1919,0,6,1971,0,0
"Europe","2024-12-09",0,0,1919,0,7,1978,0,0
"Europe","2024-12-10",0,0,1919,0,6,1984,0,0
"Europe","2024-12-11",0,0,1919,0,7,1991,0,0
"Europe","2024-12-12",0,0,1919,0,6,1997,0,0
"Europe","2024-12-13",0,0,1919,0,7,2004,0,0
"Europe","2024-12-14",0,0,1919,0,6,2010,0,0
"Europe","2024-12-15",0,0,1919,0,7,2017,0,0
"Europe","2024-12-16",0,0,1919,0,6,2023,0,0
"Europe","2024-12-17",0,0,1919,0,7,2030,0,0
"Europe","2024-12-18",0,0,1919,0,6,2036,0,0
"Europe","2024-12-19",0,0,1919,0,7,2043,0,0
"Europe","2024-12-20",0,0,1919,0,6,2049,0,0
"Europe","2024-12-21",0,0,1919,0,7,2056,0,0
"Europe","2024-12-22",0,0,1919,0,6,2062,0,0
"Europe","2024-12-23",0,0,1919,0,7,2069,0,0
"Europe","2024-12-24",0,0,1919,0,6,2075,0,0
"Europe","2024-12-25",0,0,1919,0,7,2082,0,0
"Europe","2024-12-26",0,0,1919,0,6,2088,0,0
"Europe","2024-12-27",0,0,1919,0,7,2095,0,0
"Europe","2024-12-28",0,0,1919,0,6,2101,0,0
"Europe","2024-12-29",0,0,1919,0,7,2108,0,0
"Europe","2024-12-30",0,0,1919,0,6,2114,0,0
"Europe","2024-12-31",0,202,2121,0,7,2121,0,0
"Europe","2025-01-01",0,0,2121,0,0,2121,0,0
"Europe","2025-01-02",0,0,2121,0,0,2121,0,0
"Europe","2025-01-03",0,0,2121,0,0,2121,0,0
"Europe","2025-01-04",0,0,2121,0,0,2121,0,0
"Europe","2025-01-05",0,0,2121,0,0,2121,0,0
"Europe","2025-01-06",0,0,2121,0,0,2121,0,0
"Europe","2025-01-07",0,0,2121,0,0,2121,0,0
"Europe","2025-01-08",0,0,2121,0,0,2121,0,0
"Europe","2025-01-09",0,0,2121,0,0,2121,0,0
"Europe","2025-01-10",0,0,2121,0,0,2121,0,0
"Europe","2025-01-11",0,0,2121,0,0,2121,0,0
"Europe","2025-01-12",0,0,2121,0,0,2121,0,0
"Europe","2025-01-13",0,0,2121,0,0,2121,0,0
"Europe","2025-01-14",0,0,2121,0,0,2121,0,0
"Europe","2025-01-15",0,0,2121,0,0,2121,0,0
"Europe","2025-01-16",0,0,2121,0,0,2121,0,0
"Europe","2025-01-17",0,0,2121,0,0,2121,0,0
"Europe","2025-01-18",0,0,2121,0,0,2121,0,0
"Europe","2025-01-19",0,0,2121,0,0,2121,0,0
"Europe","2025-01-20",0,0,2121,0,0,2121,0,0
"Europe","2025-01-21",0,0,2121,0,0,2121,0,0
"Europe","2025-01-22",0,0,2121,0,0,2121,0,0
"Europe","2025-01-23",0,0,2121,0,0,2121,0,0
"Europe","2025-01-24",0,0,2121,0,0,2121,0,0
"Europe","2025-01-25",0,0,2121,0,0,2121,0,0
"Europe","2025-01-26",0,0,2121,0,0,2121,0,0
"Europe","2025-01-27",0,0,2121,0,0,2121,0,0
"Europe","2025-01-28",0,0,2121,0,0,2121,0,0
"Europe","2025-01-29",0,0,2121,0,0,2121,0,0
"Europe","2025-01-30",0,0,2121,0,0,2121,0,0
"Europe","2025-01-31",0,0,2121,0,0,2121,0,0
"Europe","2025-02-01",0,0,2121,0,0,2121,0,0
"Europe","2025-02-02",0,0,2121,0,0,2121,0,0
"Europe","2025-02-03",0,0,2121,0,0,2121,0,0
"Finland","2024-01-01",0,0,0,0,0,0,0,0
"Finland","2024-01-02",0,0,0,0,0,0,0,0
"Finland","2024-01-03",0,0,0,0,0,0,0,0
"Finland","2024-01-04",0,0,0,0,0,0,0,0
"Finland","2024-01-05",0,0,0,0,0,0,0,0
"Finland","2024-01-06",0,0,0,0,0,0,0,0
"Finland","2024-01-07",0,0,0,0,0,0,0,0
"Finland","2024-01-08",0,0,0,0,0,0,0,0
"Finland","2024-01-09",0,0,0,0,0,0,0,0
"Finland","2024-01-10",0,0,0,0,0,0,0,0
"Finland","2024-01-11",0,0,0,0,0,0,0,0
"Finland","2024-01-12",0,0,0,0,0,0,0,0
"Finland","2024-01-13",0,0,0,0,0,0,0,0
"Finland","2024-01-14",0,0,0,0,0,0,0,0
"Finland","2024-01-15",0,0,0,0,0,0,0,0
"Finland","2024-01-16",0,0,0,0,0,0,0,0
"Finland","2024-01-17",0,0,0,0,0,0,0,0
"Finland","2024-01-18",0,0,0,0,0,0,0,0
"Finland","2024-01-19",0,0,0,0,0,0,0,0
"Finland","2024-01-20",0,0,0,0,0,0,0,0
"Finland","2024-01-21",0,0,0,0,0,0,0,0
"Finland","2024-01-22",0,0,0,0,0,0,0,0
"Finland","2024-01-23",0,0,0,0,0,0,0,0
"Finland","2024-01-24",0,0,0,0,0,0,0,0
"Finland","2024-01-25",0,0,0,0,0,0,0,0
"Finland","2024-01-26",0,0,0,0,0,0,0,0
"Finland","2024-01-27",0,0,0,0,0,0,0,0
"Finland","2024-01-28",0,0,0,0,0,0,0,0
"Finland","2024-01-29",0,0,0,0,0,0,0,0
"Finland","2024-01-30",0,0,0,0,0,0,0,0
"Finland","2024-01-31",0,0,0,0,0,0,0,0
"Finland","2024-02-01",0,0,0,0,0,0,0,0
"Finland","2024-02-02",0,0,0,0,0,0,0,0
"Finland","2024-02-03",0,0,0,0,0,0,0,0
"Finland","2024-02-04",0,0,0,0,0,0,0,0
"Finland","2024-02-05",0,0,0,0,0,0,0,0
"Finland","2024-02-06",0,0,0,0,0,0,0,0
"Finland","2024-02-07",0,0,0,0,0,0,0,0
"Finland","2024-02-08",0,0,0,0,0,0,0,0
"Finland","2024-02-09",0,0,0,0,0,0,0,0
"Finland","2024-02-10",0,0,0,0,0,0,0,0
"Finland","2024-02-11",0,0,0,0,0,0,0,0
"Finland","2024-02-12",0,0,0,0,0,0,0,0
"Finland","2024-02-13",0,0,0,0,0,0,0,0
"Finland","2024-02-14",0,0,0,0,0,0,0,0
"Finland","2024-02-15",0,0,0,0,0,0,0,0
"Finland","2024-02-16",0,0,0,0,0,0,0,0
"Finland","2024-02-17",0,0,0,0,0,0,0,0
"Finland","2024-02-18",0,0,0,0,0,0,0,0
"Finland","2024-02-19",0,0,0,0,0,0,0,0
"Finland","2024-02-20",0,0,0,0,0,0,0,0
"Finland","2024-02-21",0,0,0,0,0,0,0,0
"Finland","2024-02-22",0,0,0,0,0,0,0,0
"Finland","2024-02-23",0,0,0,0,0,0,0,0
"Finland","2024-02-24",0,0,0,0,0,0,0,0
"Finland","2024-02-25",0,0,0,0,0,0,0,0
"Finland","2024-02-26",0,0,0,0,0,0,0,0
"Finland","2024-02-27",0,0,0,0,0,0,0,0
"Finland","2024-02-28",0,0,0,0,0,0,0,0
"Finland","2024-02-29",0,1,1,0,1,1,0,0
"Finland","2024-03-01",0,0,1,0,0,1,0,0
"Finland","2024-03-02",0,0,1,0,0,1,0,0
"Finland","2024-03-03",0,0,1,0,0,1,0,0
"Finland","2024-03-04",0,0,1,0,0,1,0,0
"Finland","2024-03-05",0,0,1,0,0,1,0,0
"Finland","2024-03-06",0,0,1,0,0,1,0,0
"Finland","2024-03-07",0,0,1,0,0,1,0,0
"Finland","2024-03-08",0,0,1,0,0,1,0,0
"Finland","2024-03-09",0,0,1,0,0,1,0,0
"Finland","2024-03-10",0,0,1,0,0,1,0,0
"Finland","2024-03-11",0,0,1,0,0,1,0,0
"Finland","2024-03-12",0,0,1,0,0,1,0,0
"Finland","2024-03-13",0,0,1,0,0,1,0,0
"Finland","2024-03-14",0,0,1,0,0,1,0,0
"Finland","2024-03-15",0,0,1,0,0,1,0,0
"Finland","2024-03-16",0,0,1,0,0,1,0,0
"Finland","2024-03-17",0,0,1,0,0,1,0,0
"Finland","2024-03-18",0,0,1,0,0,1,0,0
"Finland","2024-03-19",0,0,1,0,0,1,0,0
"Finland","2024-03-20",0,0,1,0,0,1,0,0
"Finland","2024-03-21",0,0,1,0,0,1,0,0
"Finland","2024-03-22",0,0,1,0,0,1,0,0
"Finland","2024-03-23",0,0,1,0,0,1,0,0
"Finland","2024-03-24",0,0,1,0,0,1,0,0
"Finland","2024-03-25",0,0,1,0,0,1,0,0
"Finland","2024-03-26",0,0,1,0,0,1,0,0
"Finland","2024-03-27",0,0,1,0,0,1,0,0
"Finland","2024-03-28",0,0,1,0,0,1,0,0
"Finland","2024-03-29",0,0,1,0,0,1,0,0
"Finland","2024-03-30",0,0,1,0,0,1,0,0
"Finland","2024-03-31",0,0,1,0,0,1,0,0
"Finland","2024-04-01",0,0,1,0,0,1,0,0
"Finland","2024-04-02",0,0,1,0,0,1,0,0
"Finland","2024-04-03",0,0,1,0,0,1,0,0
"Finland","2024-04-04",0,0,1,0,0,1,0,0
"Finland","2024-04-05",0,0,1,0,0,1,0,0
"Finland","2024-04-06",0,0,1,0,0,1,0,0
"Finland","2024-04-07",0,0,1,0,0,1,0,0
"Finland","2024-04-08",0,0,1,0,0,1,0,0
"Finland","2024-04-09",0,0,1,0,0,1,0,0
"Finland","2024-04-10",0,0,1,0,0,1,0,0
"Finland","2024-04-11",0,0,1,0,0,1,0,0
"Finland","2024-04-12",0,0,1,0,0,1,0,0
"Finland","2024-04-13",0,0,1,0,0,1,0,0
"Finland","2024-04-14",0,0,1,0,0,1,0,0
"Finland","2024-04-15",0,0,1,0,0,1,0,0
"Finland","2024-04-16",0,0,1,0,0,1,0,0
"Finland","2024-04-17",0,0,1,0,0,1,0,0
"Finland","2024-04-18",0,0,1,0,0,1,0,0
"Finland","2024-04-19",0,0,1,0,0,1,0,0
"Finland","2024-04-20",0,0,1,0,0,1,0,0
"Finland","2024-04-21",0,0,1,0,0,1,0,0
"Finland","2024-04-22",0,0,1,0,0,1,0,0
"Finland","2024-04-23",0,0,1,0,0,1,0,0
"Finland","2024-04-24",0,0,1,0,0,1,0,0
"Finland","2024-04-25",0,0,1,0,0,1,0,0
"Finland","2024-04-26",0,0,1,0,0,1,0,0
"Finland","2024-04-27",0,0,1,0,0,1,0,0
"Finland","2024-04-28",0,0,1,0,0,1,0,0
"Finland","2024-04-29",0,0,1,0,0,1,0,0
"Finland","2024-04-30",0,0,1,0,0,1,0,0
"Finland","2024-05-01",0,0,1,0,0,1,0,0
"Finland","2024-05-02",0,0,1,0,0,1,0,0
"Finland","2024-05-03",0,0,1,0,0,1,0,0
"Finland","2024-05-04",0,0,1,0,0,1,0,0
"Finland","2024-05-05",0,0,1,0,0,1,0,0
"Finland","2024-05-06",0,0,1,0,0,1,0,0
"Finland","2024-05-07",0,0,1,0,0,1,0,0
"Finland","2024-05-08",0,0,1,0,0,1,0,0
"Finland","2024-05-09",0,0,1,0,0,1,0,0
"Finland","2024-05-10",0,0,1,0,0,1,0,0
"Finland","2024-05-11",0,0,1,0,0,1,0,0
"Finland","2024-05-12",0,0,1,0,0,1,0,0
"Finland","2024-05-13",0,0,1,0,0,1,0,0
"Finland","2024-05-14",0,0,1,0,0,1,0,0
"Finland","2024-05-15",0,0,1,0,0,1,0,0
"Finland","2024-05-16",0,0,1,0,0,1,0,0
"Finland","2024-05-17",0,0,1,0,0,1,0,0
"Finland","2024-05-18",0,0,1,0,0,1,0,0
"Finland","2024-05-19",0,0,1,0,0,1,0,0
"Finland","2024-05-20",0,0,1,0,0,1,0,0
"Finland","2024-05-21",0,0,1,0,0,1,0,0
"Finland","2024-05-22",0,0,1,0,0,1,0,0
"Finland","2024-05-23",0,0,1,0,0,1,0,0
"Finland","2024-05-24",0,0,1,0,0,1,0,0
"Finland","2024-05-25",0,0,1,0,0,1,0,0
"Finland","2024-05-26",0,0,1,0,0,1,0,0
"Finland","2024-05-27",0,0,1,0,0,1,0,0
"Finland","2024-05-28",0,0,1,0,0,1,0,0
"Finland","2024-05-29",0,0,1,0,0,1,0,0
"Finland","2024-05-30",0,0,1,0,0,1,0,0
"Finland","2024-05-31",0,0,1,0,0,1,0,0
"Finland","2024-06-01",0,0,1,0,0,1,0,0
"Finland","2024-06-02",0,0,1,0,0,1,0,0
"Finland","2024-06-03",0,0,1,0,0,1,0,0
"Finland","2024-06-04",0,0,1,0,0,1,0,0
"Finland","2024-06-05",0,0,1,0,0,1,0,0
"Finland","2024-06-06",0,0,1,0,0,1,0,0
"Finland","2024-06-07",0,0,1,0,0,1,0,0
"Finland","2024-06-08",0,0,1,0,0,1,0,0
"Finland","2024-06-09",0,0,1,0,0,1,0,0
"Finland","2024-06-10",0,0,1,0,0,1,0,0
"Finland","2024-06-11",0,0,1,0,0,1,0,0
"Finland","2024-06-12",0,0,1,0,0,1,0,0
"Finland","2024-06-13",0,0,1,0,0,1,0,0
"Finland","2024-06-14",0,0,1,0,0,1,0,0
"Finland","2024-06-15",0,0,1,0,0,1,0,0
"Finland","2024-06-16",0,0,1,0,0,1,0,0
"Finland","2024-06-17",0,0,1,0,0,1,0,0
"Finland","2024-06-18",0,0,1,0,0,1,0,0
"Finland","2024-06-19",0,0,1,0,0,1,0,0
"Finland","2024-06-20",0,0,1,0,0,1,0,0
"Finland","2024-06-21",0,0,1,0,0,1,0,0
"Finland","2024-06-22",0,0,1,0,0,1,0,0
"Finland","2024-06-23",0,0,1,0,0,1,0,0
"Finland","2024-06-24",0,0,1,0,0,1,0,0
"Finland","2024-06-25",0,0,1,0,0,1,0,0
"Finland","2024-06-26",0,0,1,0,0,1,0,0
"Finland","2024-06-27",0,0,1,0,0,1,0,0
"Finland","2024-06-28",0,0,1,0,0,1,0,0
"Finland","2024-06-29",0,0,1,0,0,1,0,0
"Finland","2024-06-30",0,0,1,0,0,1,0,0
"Finland","2024-07-01",0,0,1,0,0,1,0,0
"Finland","2024-07-02",0,0,1,0,0,1,0,0
"Finland","2024-07-03",0,0,1,0,0,1,0,0
"Finland","2024-07-04",0,0,1,0,0,1,0,0
"Finland","2024-07-05",0,0,1,0,0,1,0,0
"Finland","2024-07-06",0,0,1,0,0,1,0,0
"Finland","2024-07-07",0,0,1,0,0,1,0,0
"Finland","2024-07-08",0,0,1,0,0,1,0,0
"Finland","2024-07-09",0,0,1,0,0,1,0,0
"Finland","2024-07-10",0,0,1,0,0,1,0,0
"Finland","2024-07-11",0,0,1,0,0,1,0,0
"Finland","2024-07-12",0,0,1,0,0,1,0,0
"Finland","2024-07-13",0,0,1,0,0,1,0,0
"Finland","2024-07-14",0,0,1,0,0,1,0,0
"Finland","2024-07-15",0,0,1,0,0,1,0,0
"Finland","2024-07-16",0,0,1,0,0,1,0,0
"Finland","2024-07-17",0,0,1,0,0,1,0,0
"Finland","2024-07-18",0,0,1,0,0,1,0,0
"Finland","2024-07-19",0,0,1,0,0,1,0,0
"Finland","2024-07-20",0,0,1,0,0,1,0,0
"Finland","2024-07-21",0,0,1,0,0,1,0,0
"Finland","2024-07-22",0,0,1,0,0,1,0,0
"Finland","2024-07-23",0,0,1,0,0,1,0,0
"Finland","2024-07-24",0,0,1,0,0,1,0,0
"Finland","2024-07-25",0,0,1,0,0,1,0,0
"Finland","2024-07-26",0,0,1,0,0,1,0,0
"Finland","2024-07-27",0,0,1,0,0,1,0,0
"Finland","2024-07-28",0,0,1,0,0,1,0,0
"Finland","2024-07-29",0,0,1,0,0,1,0,0
"Finland","2024-07-30",0,0,1,0,0,1,0,0
"Finland","2024-07-31",0,0,1,0,0,1,0,0
"Finland","2024-08-01",0,0,1,0,0,1,0,0
"Finland","2024-08-02",0,0,1,0,0,1,0,0
"Finland","2024-08-03",0,0,1,0,0,1,0,0
"Finland","2024-08-04",0,0,1,0,0,1,0,0
"Finland","2024-08-05",0,0,1,0,0,1,0,0
"Finland","2024-08-06",0,0,1,0,0,1,0,0
"Finland","2024-08-07",0,0,1,0,0,1,0,0
"Finland","2024-08-08",0,0,1,0,0,1,0,0
"Finland","2024-08-09",0,0,1,0,0,1,0,0
"Finland","2024-08-10",0,0,1,0,0,1,0,0
"Finland","2024-08-11",0,0,1,0,0,1,0,0
"Finland","2024-08-12",0,0,1,0,0,1,0,0
"Finland","2024-08-13",0,0,1,0,0,1,0,0
"Finland","2024-08-14",0,0,1,0,0,1,0,0
"Finland","2024-08-15",0,0,1,0,0,1,0,0
"Finland","2024-08-16",0,0,1,0,0,1,0,0
"Finland","2024-08-17",0,0,1,0,0,1,0,0
"Finland","2024-08-18",0,0,1,0,0,1,0,0
"Finland","2024-08-19",0,0,1,0,0,1,0,0
"Finland","2024-08-20",0,0,1,0,0,1,0,0
"Finland","2024-08-21",0,0,1,0,0,1,0,0
"Finland","2024-08-22",0,0,1,0,0,1,0,0
"Finland","2024-08-23",0,0,1,0,0,1,0,0
"Finland","2024-08-24",0,0,1,0,0,1,0,0
"Finland","2024-08-25",0,0,1,0,0,1,0,0
"Finland","2024-08-26",0,0,1,0,0,1,0,0
"Finland","2024-08-27",0,0,1,0,0,1,0,0
"Finland","2024-08-28",0,0,1,0,0,1,0,0
"Finland","2024-08-29",0,0,1,0,0,1,0,0
"Finland","2024-08-30",0,0,1,0,0,1,0,0
"Finland","2024-08-31",0,0,1,0,0,1,0,0
"Finland","2024-09-01",0,0,1,0,0,1,0,0
"Finland","2024-09-02",0,0,1,0,0,1,0,0
"Finland","2024-09-03",0,0,1,0,0,1,0,0
"Finland","2024-09-04",0,0,1,0,0,1,0,0
"Finland","2024-09-05",0,0,1,0,0,1,0,0
"Finland","2024-09-06",0,0,1,0,0,1,0,0
"Finland","2024-09-07",0,0,1,0,0,1,0,0
"Finland","2024-09-08",0,0,1,0,0,1,0,0
"Finland","2024-09-09",0,0,1,0,0,1,0,0
"Finland","2024-09-10",0,0,1,0,0,1,0,0
"Finland","2024-09-11",0,0,1,0,0,1,0,0
"Finland","2024-09-12",0,0,1,0,0,1,0,0
"Finland","2024-09-13",0,0,1,0,0,1,0,0
"Finland","2024-09-14",0,0,1,0,0,1,0,0
"Finland","2024-09-15",0,0,1,0,0,1,0,0
"Finland","2024-09-16",0,0,1,0,0,1,0,0
"Finland","2024-09-17",0,0,1,0,0,1,0,0
"Finland","2024-09-18",0,0,1,0,0,1,0,0
"Finland","2024-09-19",0,0,1,0,0,1,0,0
"Finland","2024-09-20",0,0,1,0,0,1,0,0
"Finland","2024-09-21",0,0,1,0,0,1,0,0
"Finland","2024-09-22",0,0,1,0,0,1,0,0
"Finland","2024-09-23",0,0,1,0,0,1,0,0
"Finland","2024-09-24",0,0,1,0,0,1,0,0
"Finland","2024-09-25",0,0,1,0,0,1,0,0
"Finland","2024-09-26",0,0,1,0,0,1,0,0
"Finland","2024-09-27",0,0,1,0,0,1,0,0
"Finland","2024-09-28",0,0,1,0,0,1,0,0
"Finland","2024-09-29",0,0,1,0,0,1,0,0
"Finland","2024-09-30",0,0,1,0,0,1,0,0
"Finland","2024-10-01",0,0,1,0,0,1,0,0
"Finland","2024-10-02",0,0,1,0,0,1,0,0
"Finland","2024-10-03",0,0,1,0,0,1,0,0
"Finland","2024-10-04",0,0,1,0,0,1,0,0
"Finland","2024-10-05",0,0,1,0,0,1,0,0
"Finland","2024-10-06",0,0,1,0,0,1,0,0
"Finland","2024-10-07",0,0,1,0,0,1,0,0
"Finland","2024-10-08",0,0,1,0,0,1,0,0
"Finland","2024-10-09",0,0,1,0,0,1,0,0
"Finland","2024-10-10",0,0,1,0,0,1,0,0
"Finland","2024-10-11",0,0,1,0,0,1,0,0
"Finland","2024-10-12",0,0,1,0,0,1,0,0
"Finland","2024-10-13",0,0,1,0,0,1,0,0
"Finland","2024-10-14",0,0,1,0,0,1,0,0
"Finland","2024-10-15",0,0,1,0,0,1,0,0
"Finland","2024-10-16",0,0,1,0,0,1,0,0
"Finland","2024-10-17",0,0,1,0,0,1,0,0
"Finland","2024-10-18",0,0,1,0,0,1,0,0
"Finland","2024-10-19",0,0,1,0,0,1,0,0
"Finland","2024-10-20",0,0,1,0,0,1,0,0
"Finland","2024-10-21",0,0,1,0,0,1,0,0
"Finland","2024-10-22",0,0,1,0,0,1,0,0
"Finland","2024-10-23",0,0,1,0,0,1,0,0
"Finland","2024-10-24",0,0,1,0,0,1,0,0
"Finland","2024-10-25",0,0,1,0,0,1,0,0
"Finland","2024-10-26",0,0,1,0,0,1,0,0
"Finland","2024-10-27",0,0,1,0,0,1,0,0
"Finland","2024-10-28",0,0,1,0,0,1,0,0
"Finland","2024-10-29",0,0,1,0,0,1,0,0
"Finland","2024-10-30",0,0,1,0,0,1,0,0
"Finland","2024-10-31",0,0,1,0,0,1,0,0
"Finland","2024-11-01",0,0,1,0,0,1,0,0
"Finland","2024-11-02",0,0,1,0,0,1,0,0
"Finland","2024-11-03",0,0,1,0,0,1,0,0
"Finland","2024-11-04",0,0,1,0,0,1,0,0
"Finland","2024-11-05",0,0,1,0,0,1,0,0
"Finland","2024-11-06",0,0,1,0,0,1,0,0
"Finland","2024-11-07",0,0,1,0,0,1,0,0
"Finland","2024-11-08",0,0,1,0,0,1,0,0
"Finland","2024-11-09",0,0,1,0,0,1,0,0
"Finland","2024-11-10",0,0,1,0,0,1,0,0
"Finland","2024-11-11",0,0,1,0,0,1,0,0
"Finland","2024-11-12",0,0,1,0,0,1,0,0
"Finland","2024-11-13",0,0,1,0,0,1,0,0
"Finland","2024-11-14",0,0,1,0,0,1,0,0
"Finland","2024-11-15",0,0,1,0,0,1,0,0
"Finland","2024-11-16",0,0,1,0,0,1,0,0
"Finland","2024-11-17",0,0,1,0,0,1,0,0
"Finland","2024-11-18",0,0,1,0,0,1,0,0
"Finland","2024-11-19",0,0,1,0,0,1,0,0
"Finland","2024-11-20",0,0,1,0,0,1,0,0
"Finland","2024-11-21",0,0,1,0,0,1,0,0
"Finland","2024-11-22",0,0,1,0,0,1,0,0
"Finland","2024-11-23",0,0,1,0,0,1,0,0
"Finland","2024-11-24",0,0,1,0,0,1,0,0
"Finland","2024-11-25",0,0,1,0,0,1,0,0
"Finland","2024-11-26",0,0,1,0,0,1,0,0
"Finland","2024-11-27",0,0,1,0,0,1,0,0
"Finland","2024-11-28",0,0,1,0,0,1,0,0
"Finland","2024-11-29",0,0,1,0,0,1,0,0
"Finland","2024-11-30",0,0,1,0,0,1,0,0
"Finland","2024-12-01",0,0,1,0,0,1,0,0
"Finland","2024-12-02",0,0,1,0,0,1,0,0
"Finland","2024-12-03",0,0,1,0,0,1,0,0
"Finland","2024-12-04",0,0,1,0,0,1,0,0
"Finland","2024-12-05",0,0,1,0,0,1,0,0
"Finland","2024-12-06",0,0,1,0,0,1,0,0
"Finland","2024-12-07",0,0,1,0,0,1,0,0
"Finland","2024-12-08",0,0,1,0,0,1,0,0
"Finland","2024-12-09",0,0,1,0,0,1,0,0
"Finland","2024-12-10",0,0,1,0,0,1,0,0
"Finland","2024-12-11",0,0,1,0,0,1,0,0
"Finland","2024-12-12",0,0,1,0,0,1,0,0
"Finland","2024-12-13",0,0,1,0,0,1,0,0
"Finland","2024-12-14",0,0,1,0,0,1,0,0
"Finland","2024-12-15",0,0,1,0,0,1,0,0
"Finland","2024-12-16",0,0,1,0,0,1,0,0
"Finland","2024-12-17",0,0,1,0,0,1,0,0
"Finland","2024-12-18",0,0,1,0,0,1,0,0
"Finland","2024-12-19",0,0,1,0,0,1,0,0
"Finland","2024-12-20",0,0,1,0,0,1,0,0
"Finland","2024-12-21",0,0,1,0,0,1,0,0
"Finland","2024-12-22",0,0,1,0,0,1,0,0
"Finland","2024-12-23",0,0,1,0,0,1,0,0
"Finland","2024-12-24",0,0,1,0,0,1,0,0
"Finland","2024-12-25",0,0,1,0,0,1,0,0
"Finland","2024-12-26",0,0,1,0,0,1,0,0
"Finland","2024-12-27",0,0,1,0,0,1,0,0
"Finland","2024-12-28",0,0,1,0,0,1,0,0
"Finland","2024-12-29",0,0,1,0,0,1,0,0
"Finland","2024-12-30",0,0,1,0,0,1,0,0
"Finland","2024-12-31",0,0,1,0,0,1,0,0
"Finland","2025-01-01",0,0,1,0,0,1,0,0
"Finland","2025-01-02",0,0,1,0,0,1,0,0
"Finland","2025-01-03",0,0,1,0,0,1,0,0
"Finland","2025-01-04",0,0,1,0,0,1,0,0
"Finland","2025-01-05",0,0,1,0,0,1,0,0
"Finland","2025-01-06",0,0,1,0,0,1,0,0
"Finland","2025-01-07",0,0,1,0,0,1,0,0
"Finland","2025-01-08",0,0,1,0,0,1,0,0
"Finland","2025-01-09",0,0,1,0,0,1,0,0
"Finland","2025-01-10",0,0,1,0,0,1,0,0
"Finland","2025-01-11",0,0,1,0,0,1,0,0
"Finland","2025-01-12",0,0,1,0,0,1,0,0
"Finland","2025-01-13",0,0,1,0,0,1,0,0
"Finland","2025-01-14",0,0,1,0,0,1,0,0
"Finland","2025-01-15",0,0,1,0,0,1,0,0
"Finland","2025-01-16",0,0,1,0,0,1,0,0
"Finland","2025-01-17",0,0,1,0,0,1,0,0
"Finland","2025-01-18",0,0,1,0,0,1,0,0
"Finland","2025-01-19",0,0,1,0,0,1,0,0
"Finland","2025-01-20",0,0,1,0,0,1,0,0
"Finland","2025-01-21",0,0,1,0,0,1,0,0
"Finland","2025-01-22",0,0,1,0,0,1,0,0
"Finland","2025-01-23",0,0,1,0,0,1,0,0
"Finland","2025-01-24",0,0,1,0,0,1,0,0
"Finland","2025-01-25",0,0,1,0,0,1,0,0
"Finland","2025-01-26",0,0,1,0,0,1,0,0
"Finland","2025-01-27",0,0,1,0,0,1,0,0
"Finland","2025-01-28",0,0,1,0,0,1,0,0
"Finland","2025-01-29",0,0,1,0,0,1,0,0
"Finland","2025-01-30",0,0,1,0,0,1,0,0
"Finland","2025-01-31",0,0,1,0,0,1,0,0
"Finland","2025-02-01",0,0,1,0,0,1,0,0
"Finland","2025-02-02",0,0,1,0,0,1,0,0
"Finland","2025-02-03",0,0,1,0,0,1,0,0
"France","2024-01-01",0,0,0,0,0,0,0,0
"France","2024-01-02",0,0,0,0,0,0,0,0
"France","2024-01-03",0,0,0,0,0,0,0,0
"France","2024-01-04",0,0,0,0,0,0,0,0
"France","2024-01-05",0,0,0,0,0,0,0,0
"France","2024-01-06",0,0,0,0,0,0,0,0
"France","2024-01-07",0,0,0,0,0,0,0,0
"France","2024-01-08",0,0,0,0,0,0,0,0
"France","2024-01-09",0,0,0,0,0,0,0,0
"France","2024-01-10",0,0,0,0,0,0,0,0
"France","2024-01-11",0,0,0,0,0,0,0,0
"France","2024-01-12",0,0,0,0,0,0,0,0
"France","2024-01-13",0,0,0,0,0,0,0,0
"France","2024-01-14",0,0,0,0,0,0,0,0
"France","2024-01-15",0,0,0,0,0,0,0,0
"France","2024-01-16",0,0,0,0,0,0,0,0
"France","2024-01-17",0,0,0,0,0,0,0,0
"France","2024-01-18",0,0,0,0,0,0,0,0
"France","2024-01-19",0,0,0,0,0,0,0,0
"France","2024-01-20",0,0,0,0,0,0,0,0
"France","2024-01-21",0,0,0,0,0,0,0,0
"France","2024-01-22",0,0,0,0,0,0,0,0
"France","2024-01-23",0,0,0,0,0,0,0,0
"France","2024-01-24",0,0,0,0,0,0,0,0
"France","2024-01-25",0,0,0,0,0,0,0,0
"France","2024-01-26",0,0,0,0,0,0,0,0
"France","2024-01-27",0,0,0,0,0,0,0,0
"France","2024-01-28",0,0,0,0,0,0,0,0
"France","2024-01-29",0,0,0,0,0,0,0,0
"France","2024-01-30",0,0,0,0,0,0,0,0
"France","2024-01-31",0,8,8,0,8,8,0,0
"France","2024-02-01",0,0,8,0,1,9,0,0
"France","2024-02-02",0,0,8,0,0,9,0,0
"France","2024-02-03",0,0,8,0,1,10,0,0
"France","2024-02-04",0,0,8,0,0,10,0,0
"France","2024-02-05",0,0,8,0,1,11,0,0
"France","2024-02-06",0,0,8,0,0,11,0,0
"France","2024-02-07",0,0,8,0,1,12,0,0
"France","2024-02-08",0,0,8,0,0,12,0,0
"France","2024-02-09",0,0,8,0,1,13,0,0
"France","2024-02-10",0,0,8,0,1,14,0,0
"France","2024-02-11",0,0,8,0,0,14,0,0
"France","2024-02-12",0,0,8,0,1,15,0,0
"France","2024-02-13",0,0,8,0,0,15,0,0
"France","2024-02-14",0,0,8,0,1,16,0,0
"France","2024-02-15",0,0,8,0,0,16,0,0
"France","2024-02-16",0,0,8,0,1,17,0,0
"France","2024-02-17",0,0,8,0,0,17,0,0
"France","2024-02-18",0,0,8,0,1,18,0,0
"France","2024-02-19",0,0,8,0,0,18,0,0
"France","2024-02-20",0,0,8,0,1,19,0,0
"France","2024-02-21",0,0,8,0,1,20,0,0
"France","2024-02-22",0,0,8,0,0,20,0,0
"France","2024-02-23",0,0,8,0,1,21,0,0
"France","2024-02-24",0,0,8,0,0,21,0,0
"France","2024-02-25",0,0,8,0,1,22,0,0
"France","2024-02-26",0,0,8,0,0,22,0,0
"France","2024-02-27",0,0,8,0,1,23,0,0
"France","2024-02-28",0,0,8,0,0,23,0,0
"France","2024-02-29",0,16,24,0,1,24,0,0
"France","2024-03-01",0,0,24,0,0,24,0,0
"France","2024-03-02",0,0,24,0,1,25,0,0
"France","2024-03-03",0,0,24,0,0,25,0,0
"France","2024-03-04",0,0,24,0,0,25,0,0
"France","2024-03-05",0,0,24,0,1,26,0,0
"France","2024-03-06",0,0,24,0,0,26,0,0
"France","2024-03-07",0,0,24,0,0,26,0,0
"France","2024-03-08",0,0,24,0,1,27,0,0
"France","2024-03-09",0,0,24,0,0,27,0,0
"France","2024-03-10",0,0,24,0,1,28,0,0
"France","2024-03-11",0,0,24,0,0,28,0,0
"France","2024-03-12",0,0,24,0,0,28,0,0
"France","2024-03-13",0,0,24,0,1,29,0,0
"France","2024-03-14",0,0,24,0,0,29,0,0
"France","2024-03-15",0,0,24,0,0,29,0,0
"France","2024-03-16",0,0,24,0,1,30,0,0
"France","2024-03-17",0,0,24,0,0,30,0,0
"France","2024-03-18",0,0,24,0,0,30,0,0
"France","2024-03-19",0,0,24,0,1,31,0,0
"France","2024-03-20",0,0,24,0,0,31,0,0
"France","2024-03-21",0,0,24,0,0,31,0,0
"France","2024-03-22",0,0,24,0,1,32,0,0
"France","2024-03-23",0,0,24,0,0,32,0,0
"France","2024-03-24",0,0,24,0,1,33,0,0
"France","2024-03-25",0,0,24,0,0,33,0,0
"France","2024-03-26",0,0,24,0,0,33,0,0
"France","2024-03-27",0,0,24,0,1,34,0,0
"France","2024-03-28",0,0,24,0,0,34,0,0
"France","2024-03-29",0,0,24,0,0,34,0,0
"France","2024-03-30",0,0,24,0,1,35,0,0
"France","2024-03-31",0,11,35,0,0,35,0,0
"France","2024-04-01",0,0,35,0,0,35,0,0
"France","2024-04-02",0,0,35,0,1,36,0,0
"France","2024-04-03",0,0,35,0,0,36,0,0
"France","2024-04-04",0,0,35,0,1,37,0,0
"France","2024-04-05",0,0,35,0,0,37,0,0
"France","2024-04-06",0,0,35,0,0,37,0,0
"France","2024-04-07",0,0,35,0,1,38,0,0
"France","2024-04-08",0,0,35,0,0,38,0,0
"France","2024-04-09",0,0,35,0,1,39,0,0
"France","2024-04-10",0,0,35,0,0,39,0,0
"France","2024-04-11",0,0,35,0,0,39,0,0
"France","2024-04-12",0,0,35,0,1,40,0,0
"France","2024-04-13",0,0,35,0,0,40,0,0
"France","2024-04-14",0,0,35,0,1,41,0,0
"France","2024-04-15",0,0,35,0,0,41,0,0
"France","2024-04-16",0,0,35,0,0,41,0,0
"France","2024-04-17",0,0,35,0,1,42,0,0
"France","2024-04-18",0,0,35,0,0,42,0,0
"France","2024-04-19",0,0,35,0,1,43,0,0
"France","2024-04-20",0,0,35,0,0,43,0,0
"France","2024-04-21",0,0,35,0,0,43,0,0
"France","2024-04-22",0,0,35,0,1,44,0,0
"France","2024-04-23",0,0,35,0,0,44,0,0
"France","2024-04-24",0,0,35,0,1,45,0,0
"France","2024-04-25",0,0,35,0,0,45,0,0
"France","2024-04-26",0,0,35,0,0,45,0,0
"France","2024-04-27",0,0,35,0,1,46,0,0
"France","2024-04-28",0,0,35,0,0,46,0,0
"France","2024-04-29",0,0,35,0,1,47,0,0
"France","2024-04-30",0,12,47,0,0,47,0,0
"France","2024-05-01",0,0,47,0,1,48,0,0
"France","2024-05-02",0,0,47,0,1,49,0,0
"France","2024-05-03",0,0,47,0,1,50,0,0
"France","2024-05-04",0,0,47,0,1,51,0,0
"France","2024-05-05",0,0,47,0,1,52,0,0
"France","2024-05-06",0,0,47,0,1,53,0,0
"France","2024-05-07",0,0,47,0,1,54,0,0
"France","2024-05-08",0,0,47,0,1,55,0,0
"France","2024-05-09",0,0,47,0,1,56,0,0
"France","2024-05-10",0,0,47,0,1,57,0,0
"France","2024-05-11",0,0,47,0,1,58,0,0
"France","2024-05-12",0,0,47,0,1,59,0,0
"France","2024-05-13",0,0,47,0,1,60,0,0
"France","2024-05-14",0,0,47,0,1,61,0,0
"France","2024-05-15",0,0,47,0,1,62,0,0
"France","2024-05-16",0,0,47,0,1,63,0,0
"France","2024-05-17",0,0,47,0,1,64,0,0
"France","2024-05-18",0,0,47,0,1,65,0,0
"France","2024-05-19",0,0,47,0,1,66,0,0
"France","2024-05-20",0,0,47,0,1,67,0,0
"France","2024-05-21",0,0,47,0,1,68,0,0
"France","2024-05-22",0,0,47,0,1,69,0,0
"France","2024-05-23",0,0,47,0,1,70,0,0
"France","2024-05-24",0,0,47,0,1,71,0,0
"France","2024-05-25",0,0,47,0,1,72,0,0
"France","2024-05-26",0,0,47,0,1,73,0,0
"France","2024-05-27",0,0,47,0,1,74,0,0
"France","2024-05-28",0,0,47,0,1,75,0,0
"France","2024-05-29",0,0,47,0,1,76,0,0
"France","2024-05-30",0,0,47,0,1,77,0,0
"France","2024-05-31",0,31,78,0,1,78,0,0
"France","2024-06-01",0,0,78,0,1,79,0,0
"France","2024-06-02",0,0,78,0,1,80,0,0
"France","2024-06-03",0,0,78,0,0,80,0,0
"France","2024-06-04",0,0,78,0,1,81,0,0
"France","2024-06-05",0,0,78,0,1,82,0,0
"France","2024-06-06",0,0,78,0,1,83,0,0
"France","2024-06-07",0,0,78,0,0,83,0,0
"France","2024-06-08",0,0,78,0,1,84,0,0
"France","2024-06-09",0,0,78,0,1,85,0,0
"France","2024-06-10",0,0,78,0,1,86,0,0
"France","2024-06-11",0,0,78,0,0,86,0,0
"France","2024-06-12",0,0,78,0,1,87,0,0
"France","2024-06-13",0,0,78,0,1,88,0,0
"France","2024-06-14",0,0,78,0,1,89,0,0
"France","2024-06-15",0,0,78,0,1,90,0,0
"France","2024-06-16",0,0,78,0,0,90,0,0
"France","2024-06-17",0,0,78,0,1,91,0,0
"France","2024-06-18",0,0,78,0,1,92,0,0
"France","2024-06-19",0,0,78,0,1,93,0,0
"France","2024-06-20",0,0,78,0,0,93,0,0
"France","2024-06-21",0,0,78,0,1,94,0,0
"France","2024-06-22",0,0,78,0,1,95,0,0
"France","2024-06-23",0,0,78,0,1,96,0,0
"France","2024-06-24",0,0,78,0,0,96,0,0
"France","2024-06-25",0,0,78,0,1,97,0,0
"France","2024-06-26",0,0,78,0,1,98,0,0
"France","2024-06-27",0,0,78,0,1,99,0,0
"France","2024-06-28",0,0,78,0,0,99,0,0
"France","2024-06-29",0,0,78,0,1,100,0,0
"France","2024-06-30",0,23,101,0,1,101,0,0
"France","2024-07-01",0,0,101,0,0,101,0,0
"France","2024-07-02",0,0,101,0,1,102,0,0
"France","2024-07-03",0,0,101,0,0,102,0,0
"France","2024-07-04",0,0,101,0,0,102,0,0
"France","2024-07-05",0,0,101,0,1,103,0,0
"France","2024-07-06",0,0,101,0,0,103,0,0
"France","2024-07-07",0,0,101,0,0,103,0,0
"France","2024-07-08",0,0,101,0,1,104,0,0
"France","2024-07-09",0,0,101,0,0,104,0,0
"France","2024-07-10",0,0,101,0,1,105,0,0
"France","2024-07-11",0,0,101,0,0,105,0,0
"France","2024-07-12",0,0,101,0,0,105,0,0
"France","2024-07-13",0,0,101,0,1,106,0,0
"France","2024-07-14",0,0,101,0,0,106,0,0
"France","2024-07-15",0,0,101,0,0,106,0,0
"France","2024-07-16",0,0,101,0,1,107,0,0
"France","2024-07-17",0,0,101,0,0,107,0,0
"France","2024-07-18",0,0,101,0,0,107,0,0
"France","2024-07-19",0,0,101,0,1,108,0,0
"France","2024-07-20",0,0,101,0,0,108,0,0
"France","2024-07-21",0,0,101,0,0,108,0,0
"France","2024-07-22",0,0,101,0,1,109,0,0
"France","2024-07-23",0,0,101,0,0,109,0,0
"France","2024-07-24",0,0,101,0,1,110,0,0
"France","2024-07-25",0,0,101,0,0,110,0,0
"France","2024-07-26",0,0,101,0,0,110,0,0
"France","2024-07-27",0,0,101,0,1,111,0,0
"France","2024-07-28",0,0,101,0,0,111,0,0
"France","2024-07-29",0,0,101,0,0,111,0,0
"France","2024-07-30",0,0,101,0,1,112,0,0
"France","2024-07-31",0,11,112,0,0,112,0,0
"France","2024-08-01",0,0,112,0,1,113,0,0
"France","2024-08-02",0,0,112,0,1,114,0,0
"France","2024-08-03",0,0,112,0,0,114,0,0
"France","2024-08-04",0,0,112,0,1,115,0,0
"France","2024-08-05",0,0,112,0,1,116,0,0
"France","2024-08-06",0,0,112,0,1,117,0,0
"France","2024-08-07",0,0,112,0,0,117,0,0
"France","2024-08-08",0,0,112,0,1,118,0,0
"France","2024-08-09",0,0,112,0,1,119,0,0
"France","2024-08-10",0,0,112,0,1,120,0,0
"France","2024-08-11",0,0,112,0,1,121,0,0
"France","2024-08-12",0,0,112,0,0,121,0,0
"France","2024-08-13",0,0,112,0,1,122,0,0
"France","2024-08-14",0,0,112,0,1,123,0,0
"France","2024-08-15",0,0,112,0,1,124,0,0
"France","2024-08-16",0,0,112,0,0,124,0,0
"France","2024-08-17",0,0,112,0,1,125,0,0
"France","2024-08-18",0,0,112,0,1,126,0,0
"France","2024-08-19",0,0,112,0,1,127,0,0
"France","2024-08-20",0,0,112,0,0,127,0,0
"France","2024-08-21",0,0,112,0,1,128,0,0
"France","2024-08-22",0,0,112,0,1,129,0,0
"France","2024-08-23",0,0,112,0,1,130,0,0
"France","2024-08-24",0,0,112,0,1,131,0,0
"France","2024-08-25",0,0,112,0,0,131,0,0
"France","2024-08-26",0,0,112,0,1,132,0,0
"France","2024-08-27",0,0,112,0,1,133,0,0
"France","2024-08-28",0,0,112,0,1,134,0,0
"France","2024-08-29",0,0,112,0,0,134,0,0
"France","2024-08-30",0,0,112,0,1,135,0,0
"France","2024-08-31",0,24,136,0,1,136,0,0
"France","2024-09-01",0,0,136,0,1,137,0,0
"France","2024-09-02",0,0,136,0,1,138,0,0
"France","2024-09-03",0,0,136,0,1,139,0,0
"France","2024-09-04",0,0,136,0,1,140,0,0
"France","2024-09-05",0,0,136,0,0,140,0,0
"France","2024-09-06",0,0,136,0,1,141,0,0
"France","2024-09-07",0,0,136,0,1,142,0,0
"France","2024-09-08",0,0,136,0,1,143,0,0
"France","2024-09-09",0,0,136,0,1,144,0,0
"France","2024-09-10",0,0,136,0,1,145,0,0
"France","2024-09-11",0,0,136,0,1,146,0,0
"France","2024-09-12",0,0,136,0,1,147,0,0
"France","2024-09-13",0,0,136,0,1,148,0,0
"France","2024-09-14",0,0,136,0,1,149,0,0
"France","2024-09-15",0,0,136,0,1,150,0,0
"France","2024-09-16",0,0,136,0,0,150,0,0
"France","2024-09-17",0,0,136,0,1,151,0,0
"France","2024-09-18",0,0,136,0,1,152,0,0
"France","2024-09-19",0,0,136,0,1,153,0,0
"France","2024-09-20",0,0,136,0,1,154,0,0
"France","2024-09-21",0,0,136,0,1,155,0,0
"France","2024-09-22",0,0,136,0,1,156,0,0
"France","2024-09-23",0,0,136,0,1,157,0,0
"France","2024-09-24",0,0,136,0,1,158,0,0
"France","2024-09-25",0,0,136,0,0,158,0,0
"France","2024-09-26",0,0,136,0,1,159,0,0
"France","2024-09-27",0,0,136,0,1,160,0,0
"France","2024-09-28",0,0,136,0,1,161,0,0
"France","2024-09-29",0,0,136,0,1,162,0,0
"France","2024-09-30",0,27,163,0,1,163,0,0
"France","2024-10-01",0,0,163,0,1,164,0,0
"France","2024-10-02",0,0,163,0,1,165,0,0
"France","2024-10-03",0,0,163,0,1,166,0,0
"France","2024-10-04",0,0,163,0,1,167,0,0
"France","2024-10-05",0,0,163,0,1,168,0,0
"France","2024-10-06",0,0,163,0,1,169,0,0
"France","2024-10-07",0,0,163,0,1,170,0,0
"France","2024-10-08",0,0,163,0,0,170,0,0
"France","2024-10-09",0,0,163,0,1,171,0,0
"France","2024-10-10",0,0,163,0,1,172,0,0
"France","2024-10-11",0,0,163,0,1,173,0,0
"France","2024-10-12",0,0,163,0,1,174,0,0
"France","2024-10-13",0,0,163,0,1,175,0,0
"France","2024-10-14",0,0,163,0,1,176,0,0
"France","2024-10-15",0,0,163,0,1,177,0,0
"France","2024-10-16",0,0,163,0,1,178,0,0
"France","2024-10-17",0,0,163,0,1,179,0,0
"France","2024-10-18",0,0,163,0,1,180,0,0
"France","2024-10-19",0,0,163,0,1,181,0,0
"France","2024-10-20",0,0,163,0,1,182,0,0
"France","2024-10-21",0,0,163,0,1,183,0,0
"France","2024-10-22",0,0,163,0,1,184,0,0
"France","2024-10-23",0,0,163,0,1,185,0,0
"France","2024-10-24",0,0,163,0,0,185,0,0
"France","2024-10-25",0,0,163,0,1,186,0,0
"France","2024-10-26",0,0,163,0,1,187,0,0
"France","2024-10-27",0,0,163,0,1,188,0,0
"France","2024-10-28",0,0,163,0,1,189,0,0
"France","2024-10-29",0,0,163,0,1,190,0,0
"France","2024-10-30",0,0,163,0,1,191,0,0
"France","2024-10-31",0,29,192,0,1,192,0,0
"France","2024-11-01",0,0,192,0,0,192,0,0
"France","2024-11-02",0,0,192,0,1,193,0,0
"France","2024-11-03",0,0,192,0,0,193,0,0
"France","2024-11-04",0,0,192,0,0,193,0,0
"France","2024-11-05",0,0,192,0,0,193,0,0
"France","2024-11-06",0,0,192,0,1,194,0,0
"France","2024-11-07",0,0,192,0,0,194,0,0
"France","2024-11-08",0,0,192,0,0,194,0,0
"France","2024-11-09",0,0,192,0,0,194,0,0
"France","2024-11-10",0,0,192,0,1,195,0,0
"France","2024-11-11",0,0,192,0,0,195,0,0
"France","2024-11-12",0,0,192,0,0,195,0,0
"France","2024-11-13",0,0,192,0,0,195,0,0
"France","2024-11-14",0,0,192,0,1,196,0,0
"France","2024-11-15",0,0,192,0,0,196,0,0
"France","2024-11-16",0,0,192,0,0,196,0,0
"France","2024-11-17",0,0,192,0,1,197,0,0
"France","2024-11-18",0,0,192,0,0,197,0,0
"France","2024-11-19",0,0,192,0,0,197,0,0
"France","2024-11-20",0,0,192,0,0,197,0,0
"France","2024-11-21",0,0,192,0,1,198,0,0
"France","2024-11-22",0,0,192,0,0,198,0,0
"France","2024-11-23",0,0,192,0,0,198,0,0
"France","2024-11-24",0,0,192,0,0,198,0,0
"France","2024-11-25",0,0,192,0,1,199,0,0
"France","2024-11-26",0,0,192,0,0,199,0,0
"France","2024-11-27",0,0,192,0,0,199,0,0
"France","2024-11-28",0,0,192,0,0,199,0,0
"France","2024-11-29",0,0,192,0,1,200,0,0
"France","2024-11-30",0,8,200,0,0,200,0,0
"France","2024-12-01",0,0,200,0,0,200,0,0
"France","2024-12-02",0,0,200,0,1,201,0,0
"France","2024-12-03",0,0,200,0,0,201,0,0
"France","2024-12-04",0,0,200,0,1,202,0,0
"France","2024-12-05",0,0,200,0,0,202,0,0
"France","2024-12-06",0,0,200,0,0,202,0,0
"France","2024-12-07",0,0,200,0,1,203,0,0
"France","2024-12-08",0,0,200,0,0,203,0,0
"France","2024-12-09",0,0,200,0,0,203,0,0
"France","2024-12-10",0,0,200,0,1,204,0,0
"France","2024-12-11",0,0,200,0,0,204,0,0
"France","2024-12-12",0,0,200,0,1,205,0,0
"France","2024-12-13",0,0,200,0,0,205,0,0
"France","2024-12-14",0,0,200,0,0,205,0,0
"France","2024-12-15",0,0,200,0,1,206,0,0
"France","2024-12-16",0,0,200,0,0,206,0,0
"France","2024-12-17",0,0,200,0,1,207,0,0
"France","2024-12-18",0,0,200,0,0,207,0,0
"France","2024-12-19",0,0,200,0,0,207,0,0
"France","2024-12-20",0,0,200,0,1,208,0,0
"France","2024-12-21",0,0,200,0,0,208,0,0
"France","2024-12-22",0,0,200,0,1,209,0,0
"France","2024-12-23",0,0,200,0,0,209,0,0
"France","2024-12-24",0,0,200,0,0,209,0,0
"France","2024-12-25",0,0,200,0,1,210,0,0
"France","2024-12-26",0,0,200,0,0,210,0,0
"France","2024-12-27",0,0,200,0,0,210,0,0
"France","2024-12-28",0,0,200,0,1,211,0,0
"France","2024-12-29",0,0,200,0,0,211,0,0
"France","2024-12-30",0,0,200,0,1,212,0,0
"France","2024-12-31",0,12,212,0,0,212,0,0
"France","2025-01-01",0,0,212,0,0,212,0,0
"France","2025-01-02",0,0,212,0,0,212,0,0
"France","2025-01-03",0,0,212,0,0,212,0,0
"France","2025-01-04",0,0,212,0,0,212,0,0
"France","2025-01-05",0,0,212,0,0,212,0,0
"France","2025-01-06",0,0,212,0,0,212,0,0
"France","2025-01-07",0,0,212,0,0,212,0,0
"France","2025-01-08",0,0,212,0,0,212,0,0
"France","2025-01-09",0,0,212,0,0,212,0,0
"France","2025-01-10",0,0,212,0,0,212,0,0
"France","2025-01-11",0,0,212,0,0,212,0,0
"France","2025-01-12",0,0,212,0,0,212,0,0
"France","2025-01-13",0,0,212,0,0,212,0,0
"France","2025-01-14",0,0,212,0,0,212,0,0
"France","2025-01-15",0,0,212,0,0,212,0,0
"France","2025-01-16",0,0,212,0,0,212,0,0
"France","2025-01-17",0,0,212,0,0,212,0,0
"France","2025-01-18",0,0,212,0,0,212,0,0
"France","2025-01-19",0,0,212,0,0,212,0,0
"France","2025-01-20",0,0,212,0,0,212,0,0
"France","2025-01-21",0,0,212,0,0,212,0,0
"France","2025-01-22",0,0,212,0,0,212,0,0
"France","2025-01-23",0,0,212,0,0,212,0,0
"France","2025-01-24",0,0,212,0,0,212,0,0
"France","2025-01-25",0,0,212,0,0,212,0,0
"France","2025-01-26",0,0,212,0,0,212,0,0
"France","2025-01-27",0,0,212,0,0,212,0,0
"France","2025-01-28",0,0,212,0,0,212,0,0
"France","2025-01-29",0,0,212,0,0,212,0,0
"France","2025-01-30",0,0,212,0,0,212,0,0
"France","2025-01-31",0,0,212,0,0,212,0,0
"France","2025-02-01",0,0,212,0,0,212,0,0
"France","2025-02-02",0,0,212,0,0,212,0,0
"France","2025-02-03",0,0,212,0,0,212,0,0
"Gabon","2024-01-01",0,0,0,0,0,0,0,0
"Gabon","2024-01-02",0,0,0,0,0,0,0,0
"Gabon","2024-01-03",0,0,0,0,0,0,0,0
"Gabon","2024-01-04",0,0,0,0,0,0,0,0
"Gabon","2024-01-05",0,0,0,0,0,0,0,0
"Gabon","2024-01-06",0,0,0,0,0,0,0,0
"Gabon","2024-01-07",0,0,0,0,0,0,0,0
"Gabon","2024-01-08",0,0,0,0,0,0,0,0
"Gabon","2024-01-09",0,0,0,0,0,0,0,0
"Gabon","2024-01-10",0,0,0,0,0,0,0,0
"Gabon","2024-01-11",0,0,0,0,0,0,0,0
"Gabon","2024-01-12",0,0,0,0,0,0,0,0
"Gabon","2024-01-13",0,0,0,0,0,0,0,0
"Gabon","2024-01-14",0,0,0,0,0,0,0,0
"Gabon","2024-01-15",0,0,0,0,0,0,0,0
"Gabon","2024-01-16",0,0,0,0,0,0,0,0
"Gabon","2024-01-17",0,0,0,0,0,0,0,0
"Gabon","2024-01-18",0,0,0,0,0,0,0,0
"Gabon","2024-01-19",0,0,0,0,0,0,0,0
"Gabon","2024-01-20",0,0,0,0,0,0,0,0
"Gabon","2024-01-21",0,0,0,0,0,0,0,0
"Gabon","2024-01-22",0,0,0,0,0,0,0,0
"Gabon","2024-01-23",0,0,0,0,0,0,0,0
"Gabon","2024-01-24",0,0,0,0,0,0,0,0
"Gabon","2024-01-25",0,0,0,0,0,0,0,0
"Gabon","2024-01-26",0,0,0,0,0,0,0,0
"Gabon","2024-01-27",0,0,0,0,0,0,0,0
"Gabon","2024-01-28",0,0,0,0,0,0,0,0
"Gabon","2024-01-29",0,0,0,0,0,0,0,0
"Gabon","2024-01-30",0,0,0,0,0,0,0,0
"Gabon","2024-01-31",0,0,0,0,0,0,0,0
"Gabon","2024-02-01",0,0,0,0,0,0,0,0
"Gabon","2024-02-02",0,0,0,0,0,0,0,0
"Gabon","2024-02-03",0,0,0,0,0,0,0,0
"Gabon","2024-02-04",0,0,0,0,0,0,0,0
"Gabon","2024-02-05",0,0,0,0,0,0,0,0
"Gabon","2024-02-06",0,0,0,0,0,0,0,0
"Gabon","2024-02-07",0,0,0,0,0,0,0,0
"Gabon","2024-02-08",0,0,0,0,0,0,0,0
"Gabon","2024-02-09",0,0,0,0,0,0,0,0
"Gabon","2024-02-10",0,0,0,0,0,0,0,0
"Gabon","2024-02-11",0,0,0,0,0,0,0,0
"Gabon","2024-02-12",0,0,0,0,0,0,0,0
"Gabon","2024-02-13",0,0,0,0,0,0,0,0
"Gabon","2024-02-14",0,0,0,0,0,0,0,0
"Gabon","2024-02-15",0,0,0,0,0,0,0,0
"Gabon","2024-02-16",0,0,0,0,0,0,0,0
"Gabon","2024-02-17",0,0,0,0,0,0,0,0
"Gabon","2024-02-18",0,0,0,0,0,0,0,0
"Gabon","2024-02-19",0,0,0,0,0,0,0,0
"Gabon","2024-02-20",0,0,0,0,0,0,0,0
"Gabon","2024-02-21",0,0,0,0,0,0,0,0
"Gabon","2024-02-22",0,0,0,0,0,0,0,0
"Gabon","2024-02-23",0,0,0,0,0,0,0,0
"Gabon","2024-02-24",0,0,0,0,0,0,0,0
"Gabon","2024-02-25",0,0,0,0,0,0,0,0
"Gabon","2024-02-26",0,0,0,0,0,0,0,0
"Gabon","2024-02-27",0,0,0,0,0,0,0,0
"Gabon","2024-02-28",0,0,0,0,0,0,0,0
"Gabon","2024-02-29",0,0,0,0,0,0,0,0
"Gabon","2024-03-01",0,0,0,0,0,0,0,0
"Gabon","2024-03-02",0,0,0,0,0,0,0,0
"Gabon","2024-03-03",0,0,0,0,0,0,0,0
"Gabon","2024-03-04",0,0,0,0,0,0,0,0
"Gabon","2024-03-05",0,0,0,0,0,0,0,0
"Gabon","2024-03-06",0,0,0,0,0,0,0,0
"Gabon","2024-03-07",0,0,0,0,0,0,0,0
"Gabon","2024-03-08",0,0,0,0,0,0,0,0
"Gabon","2024-03-09",0,0,0,0,0,0,0,0
"Gabon","2024-03-10",0,0,0,0,0,0,0,0
"Gabon","2024-03-11",0,0,0,0,0,0,0,0
"Gabon","2024-03-12",0,0,0,0,0,0,0,0
"Gabon","2024-03-13",0,0,0,0,0,0,0,0
"Gabon","2024-03-14",0,0,0,0,0,0,0,0
"Gabon","2024-03-15",0,0,0,0,0,0,0,0
"Gabon","2024-03-16",0,0,0,0,0,0,0,0
"Gabon","2024-03-17",0,0,0,0,0,0,0,0
"Gabon","2024-03-18",0,0,0,0,0,0,0,0
"Gabon","2024-03-19",0,0,0,0,0,0,0,0
"Gabon","2024-03-20",0,0,0,0,0,0,0,0
"Gabon","2024-03-21",0,0,0,0,0,0,0,0
"Gabon","2024-03-22",0,0,0,0,0,0,0,0
"Gabon","2024-03-23",0,0,0,0,0,0,0,0
"Gabon","2024-03-24",0,0,0,0,0,0,0,0
"Gabon","2024-03-25",0,0,0,0,0,0,0,0
"Gabon","2024-03-26",0,0,0,0,0,0,0,0
"Gabon","2024-03-27",0,0,0,0,0,0,0,0
"Gabon","2024-03-28",0,0,0,0,0,0,0,0
"Gabon","2024-03-29",0,0,0,0,0,0,0,0
"Gabon","2024-03-30",0,0,0,0,0,0,0,0
"Gabon","2024-03-31",0,0,0,0,0,0,0,0
"Gabon","2024-04-01",0,0,0,0,0,0,0,0
"Gabon","2024-04-02",0,0,0,0,0,0,0,0
"Gabon","2024-04-03",0,0,0,0,0,0,0,0
"Gabon","2024-04-04",0,0,0,0,0,0,0,0
"Gabon","2024-04-05",0,0,0,0,0,0,0,0
"Gabon","2024-04-06",0,0,0,0,0,0,0,0
"Gabon","2024-04-07",0,0,0,0,0,0,0,0
"Gabon","2024-04-08",0,0,0,0,0,0,0,0
"Gabon","2024-04-09",0,0,0,0,0,0,0,0
"Gabon","2024-04-10",0,0,0,0,0,0,0,0
"Gabon","2024-04-11",0,0,0,0,0,0,0,0
"Gabon","2024-04-12",0,0,0,0,0,0,0,0
"Gabon","2024-04-13",0,0,0,0,0,0,0,0
"Gabon","2024-04-14",0,0,0,0,0,0,0,0
"Gabon","2024-04-15",0,0,0,0,0,0,0,0
"Gabon","2024-04-16",0,0,0,0,0,0,0,0
"Gabon","2024-04-17",0,0,0,0,0,0,0,0
"Gabon","2024-04-18",0,0,0,0,0,0,0,0
"Gabon","2024-04-19",0,0,0,0,0,0,0,0
"Gabon","2024-04-20",0,0,0,0,0,0,0,0
"Gabon","2024-04-21",0,0,0,0,0,0,0,0
"Gabon","2024-04-22",0,0,0,0,0,0,0,0
"Gabon","2024-04-23",0,0,0,0,0,0,0,0
"Gabon","2024-04-24",0,0,0,0,0,0,0,0
"Gabon","2024-04-25",0,0,0,0,0,0,0,0
"Gabon","2024-04-26",0,0,0,0,0,0,0,0
"Gabon","2024-04-27",0,0,0,0,0,0,0,0
"Gabon","2024-04-28",0,0,0,0,0,0,0,0
"Gabon","2024-04-29",0,0,0,0,0,0,0,0
"Gabon","2024-04-30",0,0,0,0,0,0,0,0
"Gabon","2024-05-01",0,0,0,0,0,0,0,0
"Gabon","2024-05-02",0,0,0,0,0,0,0,0
"Gabon","2024-05-03",0,0,0,0,0,0,0,0
"Gabon","2024-05-04",0,0,0,0,0,0,0,0
"Gabon","2024-05-05",0,0,0,0,0,0,0,0
"Gabon","2024-05-06",0,0,0,0,0,0,0,0
"Gabon","2024-05-07",0,0,0,0,0,0,0,0
"Gabon","2024-05-08",0,0,0,0,0,0,0,0
"Gabon","2024-05-09",0,0,0,0,0,0,0,0
"Gabon","2024-05-10",0,0,0,0,0,0,0,0
"Gabon","2024-05-11",0,0,0,0,0,0,0,0
"Gabon","2024-05-12",0,0,0,0,0,0,0,0
"Gabon","2024-05-13",0,0,0,0,0,0,0,0
"Gabon","2024-05-14",0,0,0,0,0,0,0,0
"Gabon","2024-05-15",0,0,0,0,0,0,0,0
"Gabon","2024-05-16",0,0,0,0,0,0,0,0
"Gabon","2024-05-17",0,0,0,0,0,0,0,0
"Gabon","2024-05-18",0,0,0,0,0,0,0,0
"Gabon","2024-05-19",0,0,0,0,0,0,0,0
"Gabon","2024-05-20",0,0,0,0,0,0,0,0
"Gabon","2024-05-21",0,0,0,0,0,0,0,0
"Gabon","2024-05-22",0,0,0,0,0,0,0,0
"Gabon","2024-05-23",0,0,0,0,0,0,0,0
"Gabon","2024-05-24",0,0,0,0,0,0,0,0
"Gabon","2024-05-25",0,0,0,0,0,0,0,0
"Gabon","2024-05-26",0,0,0,0,0,0,0,0
"Gabon","2024-05-27",0,0,0,0,0,0,0,0
"Gabon","2024-05-28",0,0,0,0,0,0,0,0
"Gabon","2024-05-29",0,0,0,0,0,0,0,0
"Gabon","2024-05-30",0,0,0,0,0,0,0,0
"Gabon","2024-05-31",0,0,0,0,0,0,0,0
"Gabon","2024-06-01",0,0,0,0,0,0,0,0
"Gabon","2024-06-02",0,0,0,0,0,0,0,0
"Gabon","2024-06-03",0,0,0,0,0,0,0,0
"Gabon","2024-06-04",0,0,0,0,0,0,0,0
"Gabon","2024-06-05",0,0,0,0,0,0,0,0
"Gabon","2024-06-06",0,0,0,0,0,0,0,0
"Gabon","2024-06-07",0,0,0,0,0,0,0,0
"Gabon","2024-06-08",0,0,0,0,0,0,0,0
"Gabon","2024-06-09",0,0,0,0,0,0,0,0
"Gabon","2024-06-10",0,0,0,0,0,0,0,0
"Gabon","2024-06-11",0,0,0,0,0,0,0,0
"Gabon","2024-06-12",0,0,0,0,0,0,0,0
"Gabon","2024-06-13",0,0,0,0,0,0,0,0
"Gabon","2024-06-14",0,0,0,0,0,0,0,0
"Gabon","2024-06-15",0,0,0,0,0,0,0,0
"Gabon","2024-06-16",0,0,0,0,0,0,0,0
"Gabon","2024-06-17",0,0,0,0,0,0,0,0
"Gabon","2024-06-18",0,0,0,0,0,0,0,0
"Gabon","2024-06-19",0,0,0,0,0,0,0,0
"Gabon","2024-06-20",0,0,0,0,0,0,0,0
"Gabon","2024-06-21",0,0,0,0,0,0,0,0
"Gabon","2024-06-22",0,0,0,0,0,0,0,0
"Gabon","2024-06-23",0,0,0,0,0,0,0,0
"Gabon","2024-06-24",0,0,0,0,0,0,0,0
"Gabon","2024-06-25",0,0,0,0,0,0,0,0
"Gabon","2024-06-26",0,0,0,0,0,0,0,0
"Gabon","2024-06-27",0,0,0,0,0,0,0,0
"Gabon","2024-06-28",0,0,0,0,0,0,0,0
"Gabon","2024-06-29",0,0,0,0,0,0,0,0
"Gabon","2024-06-30",0,0,0,0,0,0,0,0
"Gabon","2024-07-01",0,0,0,0,0,0,0,0
"Gabon","2024-07-02",0,0,0,0,0,0,0,0
"Gabon","2024-07-03",0,0,0,0,0,0,0,0
"Gabon","2024-07-04",0,0,0,0,0,0,0,0
"Gabon","2024-07-05",0,0,0,0,0,0,0,0
"Gabon","2024-07-06",0,0,0,0,0,0,0,0
"Gabon","2024-07-07",0,0,0,0,0,0,0,0
"Gabon","2024-07-08",0,0,0,0,0,0,0,0
"Gabon","2024-07-09",0,0,0,0,0,0,0,0
"Gabon","2024-07-10",0,0,0,0,0,0,0,0
"Gabon","2024-07-11",0,0,0,0,0,0,0,0
"Gabon","2024-07-12",0,0,0,0,0,0,0,0
"Gabon","2024-07-13",0,0,0,0,0,0,0,0
"Gabon","2024-07-14",0,0,0,0,0,0,0,0
"Gabon","2024-07-15",0,0,0,0,0,0,0,0
"Gabon","2024-07-16",0,0,0,0,0,0,0,0
"Gabon","2024-07-17",0,0,0,0,0,0,0,0
"Gabon","2024-07-18",0,0,0,0,0,0,0,0
"Gabon","2024-07-19",0,0,0,0,0,0,0,0
"Gabon","2024-07-20",0,0,0,0,0,0,0,0
"Gabon","2024-07-21",0,0,0,0,0,0,0,0
"Gabon","2024-07-22",0,0,0,0,0,0,0,0
"Gabon","2024-07-23",0,0,0,0,0,0,0,0
"Gabon","2024-07-24",0,0,0,0,0,0,0,0
"Gabon","2024-07-25",0,0,0,0,0,0,0,0
"Gabon","2024-07-26",0,0,0,0,0,0,0,0
"Gabon","2024-07-27",0,0,0,0,0,0,0,0
"Gabon","2024-07-28",0,0,0,0,0,0,0,0
"Gabon","2024-07-29",0,0,0,0,0,0,0,0
"Gabon","2024-07-30",0,0,0,0,0,0,0,0
"Gabon","2024-07-31",0,0,0,0,0,0,0,0
"Gabon","2024-08-01",0,0,0,0,0,0,0,0
"Gabon","2024-08-02",0,0,0,0,0,0,0,0
"Gabon","2024-08-03",0,0,0,0,0,0,0,0
"Gabon","2024-08-04",0,0,0,0,0,0,0,0
"Gabon","2024-08-05",0,0,0,0,0,0,0,0
"Gabon","2024-08-06",0,0,0,0,0,0,0,0
"Gabon","2024-08-07",0,0,0,0,0,0,0,0
"Gabon","2024-08-08",0,0,0,0,0,0,0,0
"Gabon","2024-08-09",0,0,0,0,0,0,0,0
"Gabon","2024-08-10",0,0,0,0,0,0,0,0
"Gabon","2024-08-11",0,0,0,0,0,0,0,0
"Gabon","2024-08-12",0,0,0,0,0,0,0,0
"Gabon","2024-08-13",0,0,0,0,0,0,0,0
"Gabon","2024-08-14",0,0,0,0,0,0,0,0
"Gabon","2024-08-15",0,0,0,0,0,0,0,0
"Gabon","2024-08-16",0,0,0,0,0,0,0,0
"Gabon","2024-08-17",0,0,0,0,0,0,0,0
"Gabon","2024-08-18",0,0,0,0,0,0,0,0
"Gabon","2024-08-19",0,0,0,0,0,0,0,0
"Gabon","2024-08-20",0,0,0,0,0,0,0,0
"Gabon","2024-08-21",0,0,0,0,0,0,0,0
"Gabon","2024-08-22",0,0,0,0,0,0,0,0
"Gabon","2024-08-23",0,0,0,0,0,0,0,0
"Gabon","2024-08-24",0,0,0,0,0,0,0,0
"Gabon","2024-08-25",0,1,1,0,1,1,0,0
"Gabon","2024-08-26",0,0,1,0,0,1,0,0
"Gabon","2024-08-27",0,0,1,0,0,1,0,0
"Gabon","2024-08-28",0,0,1,0,0,1,0,0
"Gabon","2024-08-29",0,0,1,0,1,2,0,0
"Gabon","2024-08-30",0,0,1,0,0,2,0,0
"Gabon","2024-08-31",0,0,1,0,0,2,0,0
"Gabon","2024-09-01",0,1,2,0,0,2,0,0
"Gabon","2024-09-02",0,0,2,0,0,2,0,0
"Gabon","2024-09-03",0,0,2,0,0,2,0,0
"Gabon","2024-09-04",0,0,2,0,0,2,0,0
"Gabon","2024-09-05",0,0,2,0,0,2,0,0
"Gabon","2024-09-06",0,0,2,0,0,2,0,0
"Gabon","2024-09-07",0,0,2,0,0,2,0,0
"Gabon","2024-09-08",4,0,2,4,0,2,4,4
"Gabon","2024-09-09",0,0,2,4,0,2,0,4
"Gabon","2024-09-10",0,0,2,4,0,2,0,4
"Gabon","2024-09-11",0,0,2,4,0,2,0,4
"Gabon","2024-09-12",0,0,2,4,0,2,1,5
"Gabon","2024-09-13",0,0,2,4,0,2,0,5
"Gabon","2024-09-14",0,0,2,4,0,2,0,5
"Gabon","2024-09-15",0,0,2,4,0,2,0,5
"Gabon","2024-09-16",0,0,2,4,0,2,0,5
"Gabon","2024-09-17",0,0,2,4,0,2,0,5
"Gabon","2024-09-18",0,0,2,4,0,2,0,5
"Gabon","2024-09-19",0,0,2,4,0,2,1,6
"Gabon","2024-09-20",0,0,2,4,0,2,0,6
"Gabon","2024-09-21",0,0,2,4,0,2,0,6
"Gabon","2024-09-22",0,0,2,4,0,2,0,6
"Gabon","2024-09-23",0,0,2,4,0,2,0,6
"Gabon","2024-09-24",0,0,2,4,0,2,0,6
"Gabon","2024-09-25",0,0,2,4,0,2,0,6
"Gabon","2024-09-26",0,0,2,4,0,2,0,6
"Gabon","2024-09-27",0,0,2,4,0,2,1,7
"Gabon","2024-09-28",0,0,2,4,0,2,0,7
"Gabon","2024-09-29",0,0,2,4,0,2,0,7
"Gabon","2024-09-30",3,0,2,7,0,2,0,7
"Gabon","2024-10-01",0,0,2,7,0,2,0,7
"Gabon","2024-10-02",0,0,2,7,0,2,1,8
"Gabon","2024-10-03",0,0,2,7,0,2,0,8
"Gabon","2024-10-04",0,0,2,7,0,2,0,8
"Gabon","2024-10-05",0,0,2,7,0,2,1,9
"Gabon","2024-10-06",2,0,2,9,0,2,0,9
"Gabon","2024-10-07",0,0,2,9,0,2,0,9
"Gabon","2024-10-08",0,0,2,9,0,2,0,9
"Gabon","2024-10-09",0,0,2,9,0,2,0,9
"Gabon","2024-10-10",0,0,2,9,0,2,0,9
"Gabon","2024-10-11",0,0,2,9,0,2,0,9
"Gabon","2024-10-12",0,0,2,9,0,2,0,9
"Gabon","2024-10-13",0,0,2,9,0,2,0,9
"Gabon","2024-10-14",0,0,2,9,0,2,1,10
"Gabon","2024-10-15",0,0,2,9,0,2,0,10
"Gabon","2024-10-16",0,0,2,9,0,2,0,10
"Gabon","2024-10-17",0,0,2,9,0,2,0,10
"Gabon","2024-10-18",0,0,2,9,0,2,0,10
"Gabon","2024-10-19",0,0,2,9,0,2,0,10
"Gabon","2024-10-20",1,0,2,10,0,2,0,10
"Gabon","2024-10-21",3,0,2,13,0,2,3,13
"Gabon","2024-10-22",0,0,2,13,0,2,0,13
"Gabon","2024-10-23",0,0,2,13,0,2,0,13
"Gabon","2024-10-24",0,0,2,13,0,2,0,13
"Gabon","2024-10-25",0,0,2,13,0,2,0,13
"Gabon","2024-10-26",0,0,2,13,0,2,0,13
"Gabon","2024-10-27",0,0,2,13,0,2,0,13
"Gabon","2024-10-28",0,0,2,13,0,2,0,13
"Gabon","2024-10-29",0,0,2,13,0,2,0,13
"Gabon","2024-10-30",0,0,2,13,0,2,0,13
"Gabon","2024-10-31",0,0,2,13,0,2,0,13
"Gabon","2024-11-01",0,0,2,13,0,2,0,13
"Gabon","2024-11-02",0,0,2,13,0,2,0,13
"Gabon","2024-11-03",0,0,2,13,0,2,0,13
"Gabon","2024-11-04",0,0,2,13,0,2,0,13
"Gabon","2024-11-05",0,0,2,13,0,2,0,13
"Gabon","2024-11-06",0,0,2,13,0,2,0,13
"Gabon","2024-11-07",0,0,2,13,0,2,0,13
"Gabon","2024-11-08",0,0,2,13,0,2,0,13
"Gabon","2024-11-09",0,0,2,13,0,2,0,13
"Gabon","2024-11-10",0,0,2,13,0,2,0,13
"Gabon","2024-11-11",0,0,2,13,0,2,0,13
"Gabon","2024-11-12",0,0,2,13,0,2,0,13
"Gabon","2024-11-13",0,0,2,13,0,2,0,13
"Gabon","2024-11-14",0,0,2,13,0,2,0,13
"Gabon","2024-11-15",0,0,2,13,0,2,0,13
"Gabon","2024-11-16",0,0,2,13,0,2,0,13
"Gabon","2024-11-17",0,0,2,13,0,2,0,13
"Gabon","2024-11-18",0,0,2,13,0,2,0,13
"Gabon","2024-11-19",0,0,2,13,0,2,0,13
"Gabon","2024-11-20",0,0,2,13,0,2,0,13
"Gabon","2024-11-21",0,0,2,13,0,2,0,13
"Gabon","2024-11-22",0,0,2,13,0,2,0,13
"Gabon","2024-11-23",0,0,2,13,0,2,0,13
"Gabon","2024-11-24",0,0,2,13,0,2,0,13
"Gabon","2024-11-25",0,0,2,13,0,2,0,13
"Gabon","2024-11-26",0,0,2,13,0,2,0,13
"Gabon","2024-11-27",0,0,2,13,0,2,0,13
"Gabon","2024-11-28",0,0,2,13,0,2,0,13
"Gabon","2024-11-29",0,0,2,13,0,2,0,13
"Gabon","2024-11-30",0,0,2,13,0,2,0,13
"Gabon","2024-12-01",0,0,2,13,0,2,0,13
"Gabon","2024-12-02",0,0,2,13,0,2,0,13
"Gabon","2024-12-03",0,0,2,13,0,2,0,13
"Gabon","2024-12-04",0,0,2,13,0,2,0,13
"Gabon","2024-12-05",0,0,2,13,0,2,0,13
"Gabon","2024-12-06",0,0,2,13,0,2,0,13
"Gabon","2024-12-07",0,0,2,13,0,2,0,13
"Gabon","2024-12-08",0,0,2,13,0,2,0,13
"Gabon","2024-12-09",0,0,2,13,0,2,0,13
"Gabon","2024-12-10",0,0,2,13,0,2,0,13
"Gabon","2024-12-11",0,0,2,13,0,2,0,13
"Gabon","2024-12-12",0,0,2,13,0,2,0,13
"Gabon","2024-12-13",0,0,2,13,0,2,0,13
"Gabon","2024-12-14",0,0,2,13,0,2,0,13
"Gabon","2024-12-15",0,0,2,13,0,2,0,13
"Gabon","2024-12-16",0,0,2,13,0,2,0,13
"Gabon","2024-12-17",0,0,2,13,0,2,0,13
"Gabon","2024-12-18",0,0,2,13,0,2,0,13
"Gabon","2024-12-19",0,0,2,13,0,2,0,13
"Gabon","2024-12-20",0,0,2,13,0,2,0,13
"Gabon","2024-12-21",0,0,2,13,0,2,0,13
"Gabon","2024-12-22",0,0,2,13,0,2,0,13
"Gabon","2024-12-23",0,0,2,13,0,2,0,13
"Gabon","2024-12-24",0,0,2,13,0,2,0,13
"Gabon","2024-12-25",0,0,2,13,0,2,0,13
"Gabon","2024-12-26",0,0,2,13,0,2,0,13
"Gabon","2024-12-27",0,0,2,13,0,2,0,13
"Gabon","2024-12-28",0,0,2,13,0,2,0,13
"Gabon","2024-12-29",0,0,2,13,0,2,0,13
"Gabon","2024-12-30",0,0,2,13,0,2,0,13
"Gabon","2024-12-31",0,0,2,13,0,2,0,13
"Gabon","2025-01-01",0,0,2,13,0,2,0,13
"Gabon","2025-01-02",0,0,2,13,0,2,0,13
"Gabon","2025-01-03",0,0,2,13,0,2,0,13
"Gabon","2025-01-04",0,0,2,13,0,2,0,13
"Gabon","2025-01-05",0,0,2,13,0,2,0,13
"Gabon","2025-01-06",0,0,2,13,0,2,0,13
"Gabon","2025-01-07",0,0,2,13,0,2,0,13
"Gabon","2025-01-08",0,0,2,13,0,2,0,13
"Gabon","2025-01-09",0,0,2,13,0,2,0,13
"Gabon","2025-01-10",0,0,2,13,0,2,0,13
"Gabon","2025-01-11",0,0,2,13,0,2,0,13
"Gabon","2025-01-12",0,0,2,13,0,2,0,13
"Gabon","2025-01-13",0,0,2,13,0,2,0,13
"Gabon","2025-01-14",0,0,2,13,0,2,0,13
"Gabon","2025-01-15",0,0,2,13,0,2,0,13
"Gabon","2025-01-16",0,0,2,13,0,2,0,13
"Gabon","2025-01-17",0,0,2,13,0,2,0,13
"Gabon","2025-01-18",0,0,2,13,0,2,0,13
"Gabon","2025-01-19",0,0,2,13,0,2,0,13
"Gabon","2025-01-20",0,0,2,13,0,2,0,13
"Gabon","2025-01-21",0,0,2,13,0,2,0,13
"Gabon","2025-01-22",0,0,2,13,0,2,0,13
"Gabon","2025-01-23",0,0,2,13,0,2,0,13
"Gabon","2025-01-24",0,0,2,13,0,2,0,13
"Gabon","2025-01-25",0,0,2,13,0,2,0,13
"Gabon","2025-01-26",0,0,2,13,0,2,0,13
"Gabon","2025-01-27",0,0,2,13,0,2,0,13
"Gabon","2025-01-28",0,0,2,13,0,2,0,13
"Gabon","2025-01-29",0,0,2,13,0,2,0,13
"Gabon","2025-01-30",0,0,2,13,0,2,0,13
"Gabon","2025-01-31",0,0,2,13,0,2,0,13
"Gabon","2025-02-01",0,0,2,13,0,2,0,13
"Gabon","2025-02-02",0,0,2,13,0,2,0,13
"Gabon","2025-02-03",0,0,2,13,0,2,0,13
"Georgia","2024-01-01",0,0,0,0,0,0,0,0
"Georgia","2024-01-02",0,0,0,0,0,0,0,0
"Georgia","2024-01-03",0,0,0,0,0,0,0,0
"Georgia","2024-01-04",0,0,0,0,0,0,0,0
"Georgia","2024-01-05",0,0,0,0,0,0,0,0
"Georgia","2024-01-06",0,0,0,0,0,0,0,0
"Georgia","2024-01-07",0,0,0,0,0,0,0,0
"Georgia","2024-01-08",0,0,0,0,0,0,0,0
"Georgia","2024-01-09",0,0,0,0,0,0,0,0
"Georgia","2024-01-10",0,0,0,0,0,0,0,0
"Georgia","2024-01-11",0,0,0,0,0,0,0,0
"Georgia","2024-01-12",0,0,0,0,0,0,0,0
"Georgia","2024-01-13",0,0,0,0,0,0,0,0
"Georgia","2024-01-14",0,0,0,0,0,0,0,0
"Georgia","2024-01-15",0,0,0,0,0,0,0,0
"Georgia","2024-01-16",0,0,0,0,0,0,0,0
"Georgia","2024-01-17",0,0,0,0,0,0,0,0
"Georgia","2024-01-18",0,0,0,0,0,0,0,0
"Georgia","2024-01-19",0,0,0,0,0,0,0,0
"Georgia","2024-01-20",0,0,0,0,0,0,0,0
"Georgia","2024-01-21",0,0,0,0,0,0,0,0
"Georgia","2024-01-22",0,0,0,0,0,0,0,0
"Georgia","2024-01-23",0,0,0,0,0,0,0,0
"Georgia","2024-01-24",0,0,0,0,0,0,0,0
"Georgia","2024-01-25",0,0,0,0,0,0,0,0
"Georgia","2024-01-26",0,0,0,0,0,0,0,0
"Georgia","2024-01-27",0,0,0,0,0,0,0,0
"Georgia","2024-01-28",0,0,0,0,0,0,0,0
"Georgia","2024-01-29",0,0,0,0,0,0,0,0
"Georgia","2024-01-30",0,0,0,0,0,0,0,0
"Georgia","2024-01-31",0,0,0,0,0,0,0,0
"Georgia","2024-02-01",0,0,0,0,0,0,0,0
"Georgia","2024-02-02",0,0,0,0,0,0,0,0
"Georgia","2024-02-03",0,0,0,0,0,0,0,0
"Georgia","2024-02-04",0,0,0,0,0,0,0,0
"Georgia","2024-02-05",0,0,0,0,0,0,0,0
"Georgia","2024-02-06",0,0,0,0,0,0,0,0
"Georgia","2024-02-07",0,0,0,0,0,0,0,0
"Georgia","2024-02-08",0,0,0,0,0,0,0,0
"Georgia","2024-02-09",0,0,0,0,0,0,0,0
"Georgia","2024-02-10",0,0,0,0,0,0,0,0
"Georgia","2024-02-11",0,0,0,0,0,0,0,0
"Georgia","2024-02-12",0,0,0,0,0,0,0,0
"Georgia","2024-02-13",0,0,0,0,0,0,0,0
"Georgia","2024-02-14",0,0,0,0,0,0,0,0
"Georgia","2024-02-15",0,0,0,0,0,0,0,0
"Georgia","2024-02-16",0,0,0,0,0,0,0,0
"Georgia","2024-02-17",0,0,0,0,0,0,0,0
"Georgia","2024-02-18",0,0,0,0,0,0,0,0
"Georgia","2024-02-19",0,0,0,0,0,0,0,0
"Georgia","2024-02-20",0,0,0,0,0,0,0,0
"Georgia","2024-02-21",0,0,0,0,0,0,0,0
"Georgia","2024-02-22",0,0,0,0,0,0,0,0
"Georgia","2024-02-23",0,0,0,0,0,0,0,0
"Georgia","2024-02-24",0,0,0,0,0,0,0,0
"Georgia","2024-02-25",0,0,0,0,0,0,0,0
"Georgia","2024-02-26",0,0,0,0,0,0,0,0
"Georgia","2024-02-27",0,0,0,0,0,0,0,0
"Georgia","2024-02-28",0,0,0,0,0,0,0,0
"Georgia","2024-02-29",0,0,0,0,0,0,0,0
"Georgia","2024-03-01",0,0,0,0,0,0,0,0
"Georgia","2024-03-02",0,0,0,0,0,0,0,0
"Georgia","2024-03-03",0,0,0,0,0,0,0,0
"Georgia","2024-03-04",0,0,0,0,0,0,0,0
"Georgia","2024-03-05",0,0,0,0,0,0,0,0
"Georgia","2024-03-06",0,0,0,0,0,0,0,0
"Georgia","2024-03-07",0,0,0,0,0,0,0,0
"Georgia","2024-03-08",0,0,0,0,0,0,0,0
"Georgia","2024-03-09",0,0,0,0,0,0,0,0
"Georgia","2024-03-10",0,0,0,0,0,0,0,0
"Georgia","2024-03-11",0,0,0,0,0,0,0,0
"Georgia","2024-03-12",0,0,0,0,0,0,0,0
"Georgia","2024-03-13",0,0,0,0,0,0,0,0
"Georgia","2024-03-14",0,0,0,0,0,0,0,0
"Georgia","2024-03-15",0,0,0,0,0,0,0,0
"Georgia","2024-03-16",0,0,0,0,0,0,0,0
"Georgia","2024-03-17",0,0,0,0,0,0,0,0
"Georgia","2024-03-18",0,0,0,0,0,0,0,0
"Georgia","2024-03-19",0,0,0,0,0,0,0,0
"Georgia","2024-03-20",0,0,0,0,0,0,0,0
"Georgia","2024-03-21",0,0,0,0,0,0,0,0
"Georgia","2024-03-22",0,0,0,0,0,0,0,0
"Georgia","2024-03-23",0,0,0,0,0,0,0,0
"Georgia","2024-03-24",0,0,0,0,0,0,0,0
"Georgia","2024-03-25",0,0,0,0,0,0,0,0
"Georgia","2024-03-26",0,0,0,0,0,0,0,0
"Georgia","2024-03-27",0,0,0,0,0,0,0,0
"Georgia","2024-03-28",0,0,0,0,0,0,0,0
"Georgia","2024-03-29",0,0,0,0,0,0,0,0
"Georgia","2024-03-30",0,0,0,0,0,0,0,0
"Georgia","2024-03-31",0,0,0,0,0,0,0,0
"Georgia","2024-04-01",0,0,0,0,0,0,0,0
"Georgia","2024-04-02",0,0,0,0,0,0,0,0
"Georgia","2024-04-03",0,0,0,0,0,0,0,0
"Georgia","2024-04-04",0,0,0,0,0,0,0,0
"Georgia","2024-04-05",0,0,0,0,0,0,0,0
"Georgia","2024-04-06",0,0,0,0,0,0,0,0
"Georgia","2024-04-07",0,0,0,0,0,0,0,0
"Georgia","2024-04-08",0,0,0,0,0,0,0,0
"Georgia","2024-04-09",0,0,0,0,0,0,0,0
"Georgia","2024-04-10",0,0,0,0,0,0,0,0
"Georgia","2024-04-11",0,0,0,0,0,0,0,0
"Georgia","2024-04-12",0,0,0,0,0,0,0,0
"Georgia","2024-04-13",0,0,0,0,0,0,0,0
"Georgia","2024-04-14",0,0,0,0,0,0,0,0
"Georgia","2024-04-15",0,0,0,0,0,0,0,0
"Georgia","2024-04-16",0,0,0,0,0,0,0,0
"Georgia","2024-04-17",0,0,0,0,0,0,0,0
"Georgia","2024-04-18",0,0,0,0,0,0,0,0
"Georgia","2024-04-19",0,0,0,0,0,0,0,0
"Georgia","2024-04-20",0,0,0,0,0,0,0,0
"Georgia","2024-04-21",0,0,0,0,0,0,0,0
"Georgia","2024-04-22",0,0,0,0,0,0,0,0
"Georgia","2024-04-23",0,0,0,0,0,0,0,0
"Georgia","2024-04-24",0,0,0,0,0,0,0,0
"Georgia","2024-04-25",0,0,0,0,0,0,0,0
"Georgia","2024-04-26",0,0,0,0,0,0,0,0
"Georgia","2024-04-27",0,0,0,0,0,0,0,0
"Georgia","2024-04-28",0,0,0,0,0,0,0,0
"Georgia","2024-04-29",0,0,0,0,0,0,0,0
"Georgia","2024-04-30",0,0,0,0,0,0,0,0
"Georgia","2024-05-01",0,0,0,0,0,0,0,0
"Georgia","2024-05-02",0,0,0,0,0,0,0,0
"Georgia","2024-05-03",0,0,0,0,0,0,0,0
"Georgia","2024-05-04",0,0,0,0,0,0,0,0
"Georgia","2024-05-05",0,0,0,0,0,0,0,0
"Georgia","2024-05-06",0,0,0,0,0,0,0,0
"Georgia","2024-05-07",0,0,0,0,0,0,0,0
"Georgia","2024-05-08",0,0,0,0,0,0,0,0
"Georgia","2024-05-09",0,0,0,0,0,0,0,0
"Georgia","2024-05-10",0,0,0,0,0,0,0,0
"Georgia","2024-05-11",0,0,0,0,0,0,0,0
"Georgia","2024-05-12",0,0,0,0,0,0,0,0
"Georgia","2024-05-13",0,0,0,0,0,0,0,0
"Georgia","2024-05-14",0,0,0,0,0,0,0,0
"Georgia","2024-05-15",0,0,0,0,0,0,0,0
"Georgia","2024-05-16",0,0,0,0,0,0,0,0
"Georgia","2024-05-17",0,0,0,0,0,0,0,0
"Georgia","2024-05-18",0,0,0,0,0,0,0,0
"Georgia","2024-05-19",0,0,0,0,0,0,0,0
"Georgia","2024-05-20",0,0,0,0,0,0,0,0
"Georgia","2024-05-21",0,0,0,0,0,0,0,0
"Georgia","2024-05-22",0,0,0,0,0,0,0,0
"Georgia","2024-05-23",0,0,0,0,0,0,0,0
"Georgia","2024-05-24",0,0,0,0,0,0,0,0
"Georgia","2024-05-25",0,0,0,0,0,0,0,0
"Georgia","2024-05-26",0,0,0,0,0,0,0,0
"Georgia","2024-05-27",0,0,0,0,0,0,0,0
"Georgia","2024-05-28",0,0,0,0,0,0,0,0
"Georgia","2024-05-29",0,0,0,0,0,0,0,0
"Georgia","2024-05-30",0,0,0,0,0,0,0,0
"Georgia","2024-05-31",0,0,0,0,0,0,0,0
"Georgia","2024-06-01",0,0,0,0,0,0,0,0
"Georgia","2024-06-02",0,0,0,0,0,0,0,0
"Georgia","2024-06-03",0,0,0,0,0,0,0,0
"Georgia","2024-06-04",0,0,0,0,0,0,0,0
"Georgia","2024-06-05",0,0,0,0,0,0,0,0
"Georgia","2024-06-06",0,0,0,0,0,0,0,0
"Georgia","2024-06-07",0,0,0,0,0,0,0,0
"Georgia","2024-06-08",0,0,0,0,0,0,0,0
"Georgia","2024-06-09",0,0,0,0,0,0,0,0
"Georgia","2024-06-10",0,0,0,0,0,0,0,0
"Georgia","2024-06-11",0,0,0,0,0,0,0,0
"Georgia","2024-06-12",0,0,0,0,0,0,0,0
"Georgia","2024-06-13",0,0,0,0,0,0,0,0
"Georgia","2024-06-14",0,0,0,0,0,0,0,0
"Georgia","2024-06-15",0,0,0,0,0,0,0,0
"Georgia","2024-06-16",0,0,0,0,0,0,0,0
"Georgia","2024-06-17",0,0,0,0,0,0,0,0
"Georgia","2024-06-18",0,0,0,0,0,0,0,0
"Georgia","2024-06-19",0,0,0,0,0,0,0,0
"Georgia","2024-06-20",0,0,0,0,0,0,0,0
"Georgia","2024-06-21",0,0,0,0,0,0,0,0
"Georgia","2024-06-22",0,0,0,0,0,0,0,0
"Georgia","2024-06-23",0,0,0,0,0,0,0,0
"Georgia","2024-06-24",0,0,0,0,0,0,0,0
"Georgia","2024-06-25",0,0,0,0,0,0,0,0
"Georgia","2024-06-26",0,0,0,0,0,0,0,0
"Georgia","2024-06-27",0,0,0,0,0,0,0,0
"Georgia","2024-06-28",0,0,0,0,0,0,0,0
"Georgia","2024-06-29",0,0,0,0,0,0,0,0
"Georgia","2024-06-30",0,0,0,0,0,0,0,0
"Georgia","2024-07-01",0,0,0,0,0,0,0,0
"Georgia","2024-07-02",0,0,0,0,0,0,0,0
"Georgia","2024-07-03",0,0,0,0,0,0,0,0
"Georgia","2024-07-04",0,0,0,0,0,0,0,0
"Georgia","2024-07-05",0,0,0,0,0,0,0,0
"Georgia","2024-07-06",0,0,0,0,0,0,0,0
"Georgia","2024-07-07",0,0,0,0,0,0,0,0
"Georgia","2024-07-08",0,0,0,0,0,0,0,0
"Georgia","2024-07-09",0,0,0,0,0,0,0,0
"Georgia","2024-07-10",0,0,0,0,0,0,0,0
"Georgia","2024-07-11",0,0,0,0,0,0,0,0
"Georgia","2024-07-12",0,0,0,0,0,0,0,0
"Georgia","2024-07-13",0,0,0,0,0,0,0,0
"Georgia","2024-07-14",0,0,0,0,0,0,0,0
"Georgia","2024-07-15",0,0,0,0,0,0,0,0
"Georgia","2024-07-16",0,0,0,0,0,0,0,0
"Georgia","2024-07-17",0,0,0,0,0,0,0,0
"Georgia","2024-07-18",0,0,0,0,0,0,0,0
"Georgia","2024-07-19",0,0,0,0,0,0,0,0
"Georgia","2024-07-20",0,0,0,0,0,0,0,0
"Georgia","2024-07-21",0,0,0,0,0,0,0,0
"Georgia","2024-07-22",0,0,0,0,0,0,0,0
"Georgia","2024-07-23",0,0,0,0,0,0,0,0
"Georgia","2024-07-24",0,0,0,0,0,0,0,0
"Georgia","2024-07-25",0,0,0,0,0,0,0,0
"Georgia","2024-07-26",0,0,0,0,0,0,0,0
"Georgia","2024-07-27",0,0,0,0,0,0,0,0
"Georgia","2024-07-28",0,0,0,0,0,0,0,0
"Georgia","2024-07-29",0,0,0,0,0,0,0,0
"Georgia","2024-07-30",0,0,0,0,0,0,0,0
"Georgia","2024-07-31",0,0,0,0,0,0,0,0
"Georgia","2024-08-01",0,0,0,0,0,0,0,0
"Georgia","2024-08-02",0,0,0,0,0,0,0,0
"Georgia","2024-08-03",0,0,0,0,0,0,0,0
"Georgia","2024-08-04",0,0,0,0,0,0,0,0
"Georgia","2024-08-05",0,0,0,0,0,0,0,0
"Georgia","2024-08-06",0,0,0,0,0,0,0,0
"Georgia","2024-08-07",0,0,0,0,0,0,0,0
"Georgia","2024-08-08",0,0,0,0,0,0,0,0
"Georgia","2024-08-09",0,0,0,0,0,0,0,0
"Georgia","2024-08-10",0,0,0,0,0,0,0,0
"Georgia","2024-08-11",0,0,0,0,0,0,0,0
"Georgia","2024-08-12",0,0,0,0,0,0,0,0
"Georgia","2024-08-13",0,0,0,0,0,0,0,0
"Georgia","2024-08-14",0,0,0,0,0,0,0,0
"Georgia","2024-08-15",0,0,0,0,0,0,0,0
"Georgia","2024-08-16",0,0,0,0,0,0,0,0
"Georgia","2024-08-17",0,0,0,0,0,0,0,0
"Georgia","2024-08-18",0,0,0,0,0,0,0,0
"Georgia","2024-08-19",0,0,0,0,0,0,0,0
"Georgia","2024-08-20",0,0,0,0,0,0,0,0
"Georgia","2024-08-21",0,0,0,0,0,0,0,0
"Georgia","2024-08-22",0,0,0,0,0,0,0,0
"Georgia","2024-08-23",0,0,0,0,0,0,0,0
"Georgia","2024-08-24",0,0,0,0,0,0,0,0
"Georgia","2024-08-25",0,0,0,0,0,0,0,0
"Georgia","2024-08-26",0,0,0,0,0,0,0,0
"Georgia","2024-08-27",0,0,0,0,0,0,0,0
"Georgia","2024-08-28",0,0,0,0,0,0,0,0
"Georgia","2024-08-29",0,0,0,0,0,0,0,0
"Georgia","2024-08-30",0,0,0,0,0,0,0,0
"Georgia","2024-08-31",0,0,0,0,0,0,0,0
"Georgia","2024-09-01",0,0,0,0,0,0,0,0
"Georgia","2024-09-02",0,0,0,0,0,0,0,0
"Georgia","2024-09-03",0,0,0,0,0,0,0,0
"Georgia","2024-09-04",0,0,0,0,0,0,0,0
"Georgia","2024-09-05",0,0,0,0,0,0,0,0
"Georgia","2024-09-06",0,0,0,0,0,0,0,0
"Georgia","2024-09-07",0,0,0,0,0,0,0,0
"Georgia","2024-09-08",0,0,0,0,0,0,0,0
"Georgia","2024-09-09",0,0,0,0,0,0,0,0
"Georgia","2024-09-10",0,0,0,0,0,0,0,0
"Georgia","2024-09-11",0,0,0,0,0,0,0,0
"Georgia","2024-09-12",0,0,0,0,0,0,0,0
"Georgia","2024-09-13",0,0,0,0,0,0,0,0
"Georgia","2024-09-14",0,0,0,0,0,0,0,0
"Georgia","2024-09-15",0,0,0,0,0,0,0,0
"Georgia","2024-09-16",0,0,0,0,0,0,0,0
"Georgia","2024-09-17",0,0,0,0,0,0,0,0
"Georgia","2024-09-18",0,0,0,0,0,0,0,0
"Georgia","2024-09-19",0,0,0,0,0,0,0,0
"Georgia","2024-09-20",0,0,0,0,0,0,0,0
"Georgia","2024-09-21",0,0,0,0,0,0,0,0
"Georgia","2024-09-22",0,0,0,0,0,0,0,0
"Georgia","2024-09-23",0,0,0,0,0,0,0,0
"Georgia","2024-09-24",0,0,0,0,0,0,0,0
"Georgia","2024-09-25",0,0,0,0,0,0,0,0
"Georgia","2024-09-26",0,0,0,0,0,0,0,0
"Georgia","2024-09-27",0,0,0,0,0,0,0,0
"Georgia","2024-09-28",0,0,0,0,0,0,0,0
"Georgia","2024-09-29",0,0,0,0,0,0,0,0
"Georgia","2024-09-30",0,0,0,0,0,0,0,0
"Georgia","2024-10-01",0,0,0,0,0,0,0,0
"Georgia","2024-10-02",0,0,0,0,0,0,0,0
"Georgia","2024-10-03",0,0,0,0,0,0,0,0
"Georgia","2024-10-04",0,0,0,0,0,0,0,0
"Georgia","2024-10-05",0,0,0,0,0,0,0,0
"Georgia","2024-10-06",0,0,0,0,0,0,0,0
"Georgia","2024-10-07",0,0,0,0,0,0,0,0
"Georgia","2024-10-08",0,0,0,0,0,0,0,0
"Georgia","2024-10-09",0,0,0,0,0,0,0,0
"Georgia","2024-10-10",0,0,0,0,0,0,0,0
"Georgia","2024-10-11",0,0,0,0,0,0,0,0
"Georgia","2024-10-12",0,0,0,0,0,0,0,0
"Georgia","2024-10-13",0,0,0,0,0,0,0,0
"Georgia","2024-10-14",0,0,0,0,0,0,0,0
"Georgia","2024-10-15",0,0,0,0,0,0,0,0
"Georgia","2024-10-16",0,0,0,0,0,0,0,0
"Georgia","2024-10-17",0,0,0,0,0,0,0,0
"Georgia","2024-10-18",0,0,0,0,0,0,0,0
"Georgia","2024-10-19",0,0,0,0,0,0,0,0
"Georgia","2024-10-20",0,0,0,0,0,0,0,0
"Georgia","2024-10-21",0,0,0,0,0,0,0,0
"Georgia","2024-10-22",0,0,0,0,0,0,0,0
"Georgia","2024-10-23",0,0,0,0,0,0,0,0
"Georgia","2024-10-24",0,0,0,0,0,0,0,0
"Georgia","2024-10-25",0,0,0,0,0,0,0,0
"Georgia","2024-10-26",0,0,0,0,0,0,0,0
"Georgia","2024-10-27",0,0,0,0,0,0,0,0
"Georgia","2024-10-28",0,0,0,0,0,0,0,0
"Georgia","2024-10-29",0,0,0,0,0,0,0,0
"Georgia","2024-10-30",0,0,0,0,0,0,0,0
"Georgia","2024-10-31",0,0,0,0,0,0,0,0
"Georgia","2024-11-01",0,0,0,0,0,0,0,0
"Georgia","2024-11-02",0,0,0,0,0,0,0,0
"Georgia","2024-11-03",0,0,0,0,0,0,0,0
"Georgia","2024-11-04",0,0,0,0,0,0,0,0
"Georgia","2024-11-05",0,0,0,0,0,0,0,0
"Georgia","2024-11-06",0,0,0,0,0,0,0,0
"Georgia","2024-11-07",0,0,0,0,0,0,0,0
"Georgia","2024-11-08",0,0,0,0,0,0,0,0
"Georgia","2024-11-09",0,0,0,0,0,0,0,0
"Georgia","2024-11-10",0,0,0,0,0,0,0,0
"Georgia","2024-11-11",0,0,0,0,0,0,0,0
"Georgia","2024-11-12",0,0,0,0,0,0,0,0
"Georgia","2024-11-13",0,0,0,0,0,0,0,0
"Georgia","2024-11-14",0,0,0,0,0,0,0,0
"Georgia","2024-11-15",0,0,0,0,0,0,0,0
"Georgia","2024-11-16",0,0,0,0,0,0,0,0
"Georgia","2024-11-17",0,0,0,0,0,0,0,0
"Georgia","2024-11-18",0,0,0,0,0,0,0,0
"Georgia","2024-11-19",0,0,0,0,0,0,0,0
"Georgia","2024-11-20",0,0,0,0,0,0,0,0
"Georgia","2024-11-21",0,0,0,0,0,0,0,0
"Georgia","2024-11-22",0,0,0,0,0,0,0,0
"Georgia","2024-11-23",0,0,0,0,0,0,0,0
"Georgia","2024-11-24",0,0,0,0,0,0,0,0
"Georgia","2024-11-25",0,0,0,0,0,0,0,0
"Georgia","2024-11-26",0,0,0,0,0,0,0,0
"Georgia","2024-11-27",0,0,0,0,0,0,0,0
"Georgia","2024-11-28",0,0,0,0,0,0,0,0
"Georgia","2024-11-29",0,0,0,0,0,0,0,0
"Georgia","2024-11-30",0,0,0,0,0,0,0,0
"Georgia","2024-12-01",0,0,0,0,0,0,0,0
"Georgia","2024-12-02",0,0,0,0,0,0,0,0
"Georgia","2024-12-03",0,0,0,0,0,0,0,0
"Georgia","2024-12-04",0,0,0,0,0,0,0,0
"Georgia","2024-12-05",0,0,0,0,0,0,0,0
"Georgia","2024-12-06",0,0,0,0,0,0,0,0
"Georgia","2024-12-07",0,0,0,0,0,0,0,0
"Georgia","2024-12-08",0,0,0,0,0,0,0,0
"Georgia","2024-12-09",0,0,0,0,0,0,0,0
"Georgia","2024-12-10",0,0,0,0,0,0,0,0
"Georgia","2024-12-11",0,0,0,0,0,0,0,0
"Georgia","2024-12-12",0,0,0,0,0,0,0,0
"Georgia","2024-12-13",0,0,0,0,0,0,0,0
"Georgia","2024-12-14",0,0,0,0,0,0,0,0
"Georgia","2024-12-15",0,0,0,0,0,0,0,0
"Georgia","2024-12-16",0,0,0,0,0,0,0,0
"Georgia","2024-12-17",0,0,0,0,0,0,0,0
"Georgia","2024-12-18",0,0,0,0,0,0,0,0
"Georgia","2024-12-19",0,0,0,0,0,0,0,0
"Georgia","2024-12-20",0,0,0,0,0,0,0,0
"Georgia","2024-12-21",0,0,0,0,0,0,0,0
"Georgia","2024-12-22",0,0,0,0,0,0,0,0
"Georgia","2024-12-23",0,0,0,0,0,0,0,0
"Georgia","2024-12-24",0,0,0,0,0,0,0,0
"Georgia","2024-12-25",0,0,0,0,0,0,0,0
"Georgia","2024-12-26",0,0,0,0,0,0,0,0
"Georgia","2024-12-27",0,0,0,0,0,0,0,0
"Georgia","2024-12-28",0,0,0,0,0,0,0,0
"Georgia","2024-12-29",0,0,0,0,0,0,0,0
"Georgia","2024-12-30",0,0,0,0,0,0,0,0
"Georgia","2024-12-31",0,0,0,0,0,0,0,0
"Georgia","2025-01-01",0,0,0,0,0,0,0,0
"Georgia","2025-01-02",0,0,0,0,0,0,0,0
"Georgia","2025-01-03",0,0,0,0,0,0,0,0
"Georgia","2025-01-04",0,0,0,0,0,0,0,0
"Georgia","2025-01-05",0,0,0,0,0,0,0,0
"Georgia","2025-01-06",0,0,0,0,0,0,0,0
"Georgia","2025-01-07",0,0,0,0,0,0,0,0
"Georgia","2025-01-08",0,0,0,0,0,0,0,0
"Georgia","2025-01-09",0,0,0,0,0,0,0,0
"Georgia","2025-01-10",0,0,0,0,0,0,0,0
"Georgia","2025-01-11",0,0,0,0,0,0,0,0
"Georgia","2025-01-12",0,0,0,0,0,0,0,0
"Georgia","2025-01-13",0,0,0,0,0,0,0,0
"Georgia","2025-01-14",0,0,0,0,0,0,0,0
"Georgia","2025-01-15",0,0,0,0,0,0,0,0
"Georgia","2025-01-16",0,0,0,0,0,0,0,0
"Georgia","2025-01-17",0,0,0,0,0,0,0,0
"Georgia","2025-01-18",0,0,0,0,0,0,0,0
"Georgia","2025-01-19",0,0,0,0,0,0,0,0
"Georgia","2025-01-20",0,0,0,0,0,0,0,0
"Georgia","2025-01-21",0,0,0,0,0,0,0,0
"Georgia","2025-01-22",0,0,0,0,0,0,0,0
"Georgia","2025-01-23",0,0,0,0,0,0,0,0
"Georgia","2025-01-24",0,0,0,0,0,0,0,0
"Georgia","2025-01-25",0,0,0,0,0,0,0,0
"Georgia","2025-01-26",0,0,0,0,0,0,0,0
"Georgia","2025-01-27",0,0,0,0,0,0,0,0
"Georgia","2025-01-28",0,0,0,0,0,0,0,0
"Georgia","2025-01-29",0,0,0,0,0,0,0,0
"Georgia","2025-01-30",0,0,0,0,0,0,0,0
"Georgia","2025-01-31",0,0,0,0,0,0,0,0
"Georgia","2025-02-01",0,0,0,0,0,0,0,0
"Georgia","2025-02-02",0,0,0,0,0,0,0,0
"Georgia","2025-02-03",0,0,0,0,0,0,0,0
"Germany","2024-01-01",0,0,0,0,0,0,0,0
"Germany","2024-01-02",0,0,0,0,0,0,0,0
"Germany","2024-01-03",0,0,0,0,0,0,0,0
"Germany","2024-01-04",0,0,0,0,0,0,0,0
"Germany","2024-01-05",0,0,0,0,0,0,0,0
"Germany","2024-01-06",0,0,0,0,0,0,0,0
"Germany","2024-01-07",0,0,0,0,0,0,0,0
"Germany","2024-01-08",0,0,0,0,0,0,0,0
"Germany","2024-01-09",0,0,0,0,0,0,0,0
"Germany","2024-01-10",0,0,0,0,0,0,0,0
"Germany","2024-01-11",0,0,0,0,0,0,0,0
"Germany","2024-01-12",0,0,0,0,0,0,0,0
"Germany","2024-01-13",0,0,0,0,0,0,0,0
"Germany","2024-01-14",0,0,0,0,0,0,0,0
"Germany","2024-01-15",0,0,0,0,0,0,0,0
"Germany","2024-01-16",0,0,0,0,0,0,0,0
"Germany","2024-01-17",0,0,0,0,0,0,0,0
"Germany","2024-01-18",0,0,0,0,0,0,0,0
"Germany","2024-01-19",0,0,0,0,0,0,0,0
"Germany","2024-01-20",0,0,0,0,0,0,0,0
"Germany","2024-01-21",0,0,0,0,0,0,0,0
"Germany","2024-01-22",0,0,0,0,0,0,0,0
"Germany","2024-01-23",0,0,0,0,0,0,0,0
"Germany","2024-01-24",0,0,0,0,0,0,0,0
"Germany","2024-01-25",0,0,0,0,0,0,0,0
"Germany","2024-01-26",0,0,0,0,0,0,0,0
"Germany","2024-01-27",0,0,0,0,0,0,0,0
"Germany","2024-01-28",0,0,0,0,0,0,0,0
"Germany","2024-01-29",0,0,0,0,0,0,0,0
"Germany","2024-01-30",0,0,0,0,0,0,0,0
"Germany","2024-01-31",0,7,7,0,7,7,0,0
"Germany","2024-02-01",0,0,7,0,0,7,0,0
"Germany","2024-02-02",0,0,7,0,1,8,0,0
"Germany","2024-02-03",0,0,7,0,0,8,0,0
"Germany","2024-02-04",0,0,7,0,0,8,0,0
"Germany","2024-02-05",0,0,7,0,1,9,0,0
"Germany","2024-02-06",0,0,7,0,0,9,0,0
"Germany","2024-02-07",0,0,7,0,0,9,0,0
"Germany","2024-02-08",0,0,7,0,0,9,0,0
"Germany","2024-02-09",0,0,7,0,1,10,0,0
"Germany","2024-02-10",0,0,7,0,0,10,0,0
"Germany","2024-02-11",0,0,7,0,0,10,0,0
"Germany","2024-02-12",0,0,7,0,1,11,0,0
"Germany","2024-02-13",0,0,7,0,0,11,0,0
"Germany","2024-02-14",0,0,7,0,0,11,0,0
"Germany","2024-02-15",0,0,7,0,1,12,0,0
"Germany","2024-02-16",0,0,7,0,0,12,0,0
"Germany","2024-02-17",0,0,7,0,0,12,0,0
"Germany","2024-02-18",0,0,7,0,1,13,0,0
"Germany","2024-02-19",0,0,7,0,0,13,0,0
"Germany","2024-02-20",0,0,7,0,0,13,0,0
"Germany","2024-02-21",0,0,7,0,1,14,0,0
"Germany","2024-02-22",0,0,7,0,0,14,0,0
"Germany","2024-02-23",0,0,7,0,0,14,0,0
"Germany","2024-02-24",0,0,7,0,0,14,0,0
"Germany","2024-02-25",0,0,7,0,1,15,0,0
"Germany","2024-02-26",0,0,7,0,0,15,0,0
"Germany","2024-02-27",0,0,7,0,0,15,0,0
"Germany","2024-02-28",0,0,7,0,1,16,0,0
"Germany","2024-02-29",0,9,16,0,0,16,0,0
"Germany","2024-03-01",0,0,16,0,0,16,0,0
"Germany","2024-03-02",0,0,16,0,1,17,0,0
"Germany","2024-03-03",0,0,16,0,0,17,0,0
"Germany","2024-03-04",0,0,16,0,1,18,0,0
"Germany","2024-03-05",0,0,16,0,0,18,0,0
"Germany","2024-03-06",0,0,16,0,1,19,0,0
"Germany","2024-03-07",0,0,16,0,0,19,0,0
"Germany","2024-03-08",0,0,16,0,1,20,0,0
"Germany","2024-03-09",0,0,16,0,0,20,0,0
"Germany","2024-03-10",0,0,16,0,1,21,0,0
"Germany","2024-03-11",0,0,16,0,0,21,0,0
"Germany","2024-03-12",0,0,16,0,0,21,0,0
"Germany","2024-03-13",0,0,16,0,1,22,0,0
"Germany","2024-03-14",0,0,16,0,0,22,0,0
"Germany","2024-03-15",0,0,16,0,1,23,0,0
"Germany","2024-03-16",0,0,16,0,0,23,0,0
"Germany","2024-03-17",0,0,16,0,1,24,0,0
"Germany","2024-03-18",0,0,16,0,0,24,0,0
"Germany","2024-03-19",0,0,16,0,1,25,0,0
"Germany","2024-03-20",0,0,16,0,0,25,0,0
"Germany","2024-03-21",0,0,16,0,0,25,0,0
"Germany","2024-03-22",0,0,16,0,1,26,0,0
"Germany","2024-03-23",0,0,16,0,0,26,0,0
"Germany","2024-03-24",0,0,16,0,1,27,0,0
"Germany","2024-03-25",0,0,16,0,0,27,0,0
"Germany","2024-03-26",0,0,16,0,1,28,0,0
"Germany","2024-03-27",0,0,16,0,0,28,0,0
"Germany","2024-03-28",0,0,16,0,1,29,0,0
"Germany","2024-03-29",0,0,16,0,0,29,0,0
"Germany","2024-03-30",0,0,16,0,1,30,0,0
"Germany","2024-03-31",0,14,30,0,0,30,0,0
"Germany","2024-04-01",0,0,30,0,0,30,0,0
"Germany","2024-04-02",0,0,30,0,1,31,0,0
"Germany","2024-04-03",0,0,30,0,0,31,0,0
"Germany","2024-04-04",0,0,30,0,0,31,0,0
"Germany","2024-04-05",0,0,30,0,1,32,0,0
"Germany","2024-04-06",0,0,30,0,0,32,0,0
"Germany","2024-04-07",0,0,30,0,1,33,0,0
"Germany","2024-04-08",0,0,30,0,0,33,0,0
"Germany","2024-04-09",0,0,30,0,0,33,0,0
"Germany","2024-04-10",0,0,30,0,1,34,0,0
"Germany","2024-04-11",0,0,30,0,0,34,0,0
"Germany","2024-04-12",0,0,30,0,0,34,0,0
"Germany","2024-04-13",0,0,30,0,1,35,0,0
"Germany","2024-04-14",0,0,30,0,0,35,0,0
"Germany","2024-04-15",0,0,30,0,1,36,0,0
"Germany","2024-04-16",0,0,30,0,0,36,0,0
"Germany","2024-04-17",0,0,30,0,0,36,0,0
"Germany","2024-04-18",0,0,30,0,1,37,0,0
"Germany","2024-04-19",0,0,30,0,0,37,0,0
"Germany","2024-04-20",0,0,30,0,0,37,0,0
"Germany","2024-04-21",0,0,30,0,1,38,0,0
"Germany","2024-04-22",0,0,30,0,0,38,0,0
"Germany","2024-04-23",0,0,30,0,0,38,0,0
"Germany","2024-04-24",0,0,30,0,1,39,0,0
"Germany","2024-04-25",0,0,30,0,0,39,0,0
"Germany","2024-04-26",0,0,30,0,1,40,0,0
"Germany","2024-04-27",0,0,30,0,0,40,0,0
"Germany","2024-04-28",0,0,30,0,0,40,0,0
"Germany","2024-04-29",0,0,30,0,1,41,0,0
"Germany","2024-04-30",0,11,41,0,0,41,0,0
"Germany","2024-05-01",0,0,41,0,0,41,0,0
"Germany","2024-05-02",0,0,41,0,0,41,0,0
"Germany","2024-05-03",0,0,41,0,1,42,0,0
"Germany","2024-05-04",0,0,41,0,0,42,0,0
"Germany","2024-05-05",0,0,41,0,0,42,0,0
"Germany","2024-05-06",0,0,41,0,0,42,0,0
"Germany","2024-05-07",0,0,41,0,0,42,0,0
"Germany","2024-05-08",0,0,41,0,1,43,0,0
"Germany","2024-05-09",0,0,41,0,0,43,0,0
"Germany","2024-05-10",0,0,41,0,0,43,0,0
"Germany","2024-05-11",0,0,41,0,0,43,0,0
"Germany","2024-05-12",0,0,41,0,0,43,0,0
"Germany","2024-05-13",0,0,41,0,1,44,0,0
"Germany","2024-05-14",0,0,41,0,0,44,0,0
"Germany","2024-05-15",0,0,41,0,0,44,0,0
"Germany","2024-05-16",0,0,41,0,0,44,0,0
"Germany","2024-05-17",0,0,41,0,0,44,0,0
"Germany","2024-05-18",0,0,41,0,0,44,0,0
"Germany","2024-05-19",0,0,41,0,1,45,0,0
"Germany","2024-05-20",0,0,41,0,0,45,0,0
"Germany","2024-05-21",0,0,41,0,0,45,0,0
"Germany","2024-05-22",0,0,41,0,0,45,0,0
"Germany","2024-05-23",0,0,41,0,0,45,0,0
"Germany","2024-05-24",0,0,41,0,1,46,0,0
"Germany","2024-05-25",0,0,41,0,0,46,0,0
"Germany","2024-05-26",0,0,41,0,0,46,0,0
"Germany","2024-05-27",0,0,41,0,0,46,0,0
"Germany","2024-05-28",0,0,41,0,0,46,0,0
"Germany","2024-05-29",0,0,41,0,1,47,0,0
"Germany","2024-05-30",0,0,41,0,0,47,0,0
"Germany","2024-05-31",0,6,47,0,0,47,0,0
"Germany","2024-06-01",0,0,47,0,0,47,0,0
"Germany","2024-06-02",0,0,47,0,1,48,0,0
"Germany","2024-06-03",0,0,47,0,0,48,0,0
"Germany","2024-06-04",0,0,47,0,0,48,0,0
"Germany","2024-06-05",0,0,47,0,1,49,0,0
"Germany","2024-06-06",0,0,47,0,0,49,0,0
"Germany","2024-06-07",0,0,47,0,0,49,0,0
"Germany","2024-06-08",0,0,47,0,1,50,0,0
"Germany","2024-06-09",0,0,47,0,0,50,0,0
"Germany","2024-06-10",0,0,47,0,0,50,0,0
"Germany","2024-06-11",0,0,47,0,1,51,0,0
"Germany","2024-06-12",0,0,47,0,0,51,0,0
"Germany","2024-06-13",0,0,47,0,0,51,0,0
"Germany","2024-06-14",0,0,47,0,1,52,0,0
"Germany","2024-06-15",0,0,47,0,0,52,0,0
"Germany","2024-06-16",0,0,47,0,0,52,0,0
"Germany","2024-06-17",0,0,47,0,1,53,0,0
"Germany","2024-06-18",0,0,47,0,0,53,0,0
"Germany","2024-06-19",0,0,47,0,0,53,0,0
"Germany","2024-06-20",0,0,47,0,1,54,0,0
"Germany","2024-06-21",0,0,47,0,0,54,0,0
"Germany","2024-06-22",0,0,47,0,0,54,0,0
"Germany","2024-06-23",0,0,47,0,1,55,0,0
"Germany","2024-06-24",0,0,47,0,0,55,0,0
"Germany","2024-06-25",0,0,47,0,0,55,0,0
"Germany","2024-06-26",0,0,47,0,1,56,0,0
"Germany","2024-06-27",0,0,47,0,0,56,0,0
"Germany","2024-06-28",0,0,47,0,0,56,0,0
"Germany","2024-06-29",0,0,47,0,1,57,0,0
"Germany","2024-06-30",0,10,57,0,0,57,0,0
"Germany","2024-07-01",0,0,57,0,1,58,0,0
"Germany","2024-07-02",0,0,57,0,1,59,0,0
"Germany","2024-07-03",0,0,57,0,1,60,0,0
"Germany","2024-07-04",0,0,57,0,1,61,0,0
"Germany","2024-07-05",0,0,57,0,1,62,0,0
"Germany","2024-07-06",0,0,57,0,1,63,0,0
"Germany","2024-07-07",0,0,57,0,1,64,0,0
"Germany","2024-07-08",0,0,57,0,0,64,0,0
"Germany","2024-07-09",0,0,57,0,1,65,0,0
"Germany","2024-07-10",0,0,57,0,1,66,0,0
"Germany","2024-07-11",0,0,57,0,1,67,0,0
"Germany","2024-07-12",0,0,57,0,1,68,0,0
"Germany","2024-07-13",0,0,57,0,1,69,0,0
"Germany","2024-07-14",0,0,57,0,1,70,0,0
"Germany","2024-07-15",0,0,57,0,1,71,0,0
"Germany","2024-07-16",0,0,57,0,1,72,0,0
"Germany","2024-07-17",0,0,57,0,1,73,0,0
"Germany","2024-07-18",0,0,57,0,1,74,0,0
"Germany","2024-07-19",0,0,57,0,1,75,0,0
"Germany","2024-07-20",0,0,57,0,1,76,0,0
"Germany","2024-07-21",0,0,57,0,1,77,0,0
"Germany","2024-07-22",0,0,57,0,1,78,0,0
"Germany","2024-07-23",0,0,57,0,1,79,0,0
"Germany","2024-07-24",0,0,57,0,0,79,0,0
"Germany","2024-07-25",0,0,57,0,1,80,0,0
"Germany","2024-07-26",0,0,57,0,1,81,0,0
"Germany","2024-07-27",0,0,57,0,1,82,0,0
"Germany","2024-07-28",0,0,57,0,1,83,0,0
"Germany","2024-07-29",0,0,57,0,1,84,0,0
"Germany","2024-07-30",0,0,57,0,1,85,0,0
"Germany","2024-07-31",0,29,86,0,1,86,0,0
"Germany","2024-08-01",0,0,86,0,1,87,0,0
"Germany","2024-08-02",0,0,86,0,0,87,0,0
"Germany","2024-08-03",0,0,86,0,1,88,0,0
"Germany","2024-08-04",0,0,86,0,1,89,0,0
"Germany","2024-08-05",0,0,86,0,1,90,0,0
"Germany","2024-08-06",0,0,86,0,0,90,0,0
"Germany","2024-08-07",0,0,86,0,1,91,0,0
"Germany","2024-08-08",0,0,86,0,1,92,0,0
"Germany","2024-08-09",0,0,86,0,1,93,0,0
"Germany","2024-08-10",0,0,86,0,0,93,0,0
"Germany","2024-08-11",0,0,86,0,1,94,0,0
"Germany","2024-08-12",0,0,86,0,1,95,0,0
"Germany","2024-08-13",0,0,86,0,1,96,0,0
"Germany","2024-08-14",0,0,86,0,0,96,0,0
"Germany","2024-08-15",0,0,86,0,1,97,0,0
"Germany","2024-08-16",0,0,86,0,1,98,0,0
"Germany","2024-08-17",0,0,86,0,1,99,0,0
"Germany","2024-08-18",0,0,86,0,0,99,0,0
"Germany","2024-08-19",0,0,86,0,1,100,0,0
"Germany","2024-08-20",0,0,86,0,1,101,0,0
"Germany","2024-08-21",0,0,86,0,1,102,0,0
"Germany","2024-08-22",0,0,86,0,0,102,0,0
"Germany","2024-08-23",0,0,86,0,1,103,0,0
"Germany","2024-08-24",0,0,86,0,1,104,0,0
"Germany","2024-08-25",0,0,86,0,1,105,0,0
"Germany","2024-08-26",0,0,86,0,0,105,0,0
"Germany","2024-08-27",0,0,86,0,1,106,0,0
"Germany","2024-08-28",0,0,86,0,1,107,0,0
"Germany","2024-08-29",0,0,86,0,1,108,0,0
"Germany","2024-08-30",0,0,86,0,0,108,0,0
"Germany","2024-08-31",0,23,109,0,1,109,0,0
"Germany","2024-09-01",0,0,109,0,1,110,0,0
"Germany","2024-09-02",0,0,109,0,1,111,0,0
"Germany","2024-09-03",0,0,109,0,0,111,0,0
"Germany","2024-09-04",0,0,109,0,1,112,0,0
"Germany","2024-09-05",0,0,109,0,1,113,0,0
"Germany","2024-09-06",0,0,109,0,1,114,0,0
"Germany","2024-09-07",0,0,109,0,0,114,0,0
"Germany","2024-09-08",0,0,109,0,1,115,0,0
"Germany","2024-09-09",0,0,109,0,1,116,0,0
"Germany","2024-09-10",0,0,109,0,1,117,0,0
"Germany","2024-09-11",0,0,109,0,0,117,0,0
"Germany","2024-09-12",0,0,109,0,1,118,0,0
"Germany","2024-09-13",0,0,109,0,1,119,0,0
"Germany","2024-09-14",0,0,109,0,1,120,0,0
"Germany","2024-09-15",0,0,109,0,1,121,0,0
"Germany","2024-09-16",0,0,109,0,0,121,0,0
"Germany","2024-09-17",0,0,109,0,1,122,0,0
"Germany","2024-09-18",0,0,109,0,1,123,0,0
"Germany","2024-09-19",0,0,109,0,1,124,0,0
"Germany","2024-09-20",0,0,109,0,0,124,0,0
"Germany","2024-09-21",0,0,109,0,1,125,0,0
"Germany","2024-09-22",0,0,109,0,1,126,0,0
"Germany","2024-09-23",0,0,109,0,1,127,0,0
"Germany","2024-09-24",0,0,109,0,0,127,0,0
"Germany","2024-09-25",0,0,109,0,1,128,0,0
"Germany","2024-09-26",0,0,109,0,1,129,0,0
"Germany","2024-09-27",0,0,109,0,1,130,0,0
"Germany","2024-09-28",0,0,109,0,0,130,0,0
"Germany","2024-09-29",0,0,109,0,1,131,0,0
"Germany","2024-09-30",0,23,132,0,1,132,0,0
"Germany","2024-10-01",0,0,132,0,2,134,0,0
"Germany","2024-10-02",0,0,132,0,1,135,0,0
"Germany","2024-10-03",0,0,132,0,2,137,0,0
"Germany","2024-10-04",0,0,132,0,1,138,0,0
"Germany","2024-10-05",0,0,132,0,2,140,0,0
"Germany","2024-10-06",0,0,132,0,1,141,0,0
"Germany","2024-10-07",0,0,132,0,2,143,0,0
"Germany","2024-10-08",0,0,132,0,1,144,0,0
"Germany","2024-10-09",0,0,132,0,2,146,0,0
"Germany","2024-10-10",0,0,132,0,1,147,0,0
"Germany","2024-10-11",0,0,132,0,2,149,0,0
"Germany","2024-10-12",0,0,132,0,2,151,0,0
"Germany","2024-10-13",0,0,132,0,1,152,0,0
"Germany","2024-10-14",0,0,132,0,2,154,0,0
"Germany","2024-10-15",0,0,132,0,1,155,0,0
"Germany","2024-10-16",0,0,132,0,2,157,0,0
"Germany","2024-10-17",0,0,132,0,1,158,0,0
"Germany","2024-10-18",0,0,132,0,2,160,0,0
"Germany","2024-10-19",0,0,132,0,1,161,0,0
"Germany","2024-10-20",0,0,132,0,2,163,0,0
"Germany","2024-10-21",0,0,132,0,2,165,0,0
"Germany","2024-10-22",0,0,132,0,1,166,0,0
"Germany","2024-10-23",0,0,132,0,2,168,0,0
"Germany","2024-10-24",0,0,132,0,1,169,0,0
"Germany","2024-10-25",0,0,132,0,2,171,0,0
"Germany","2024-10-26",0,0,132,0,1,172,0,0
"Germany","2024-10-27",0,0,132,0,2,174,0,0
"Germany","2024-10-28",0,0,132,0,1,175,0,0
"Germany","2024-10-29",0,0,132,0,2,177,0,0
"Germany","2024-10-30",0,0,132,0,1,178,0,0
"Germany","2024-10-31",0,48,180,0,2,180,0,0
"Germany","2024-11-01",0,0,180,0,2,182,0,0
"Germany","2024-11-02",0,0,180,0,2,184,0,0
"Germany","2024-11-03",0,0,180,0,2,186,0,0
"Germany","2024-11-04",0,0,180,0,2,188,0,0
"Germany","2024-11-05",0,0,180,0,2,190,0,0
"Germany","2024-11-06",0,0,180,0,2,192,0,0
"Germany","2024-11-07",0,0,180,0,2,194,0,0
"Germany","2024-11-08",0,0,180,0,2,196,0,0
"Germany","2024-11-09",0,0,180,0,2,198,0,0
"Germany","2024-11-10",0,0,180,0,2,200,0,0
"Germany","2024-11-11",0,0,180,0,2,202,0,0
"Germany","2024-11-12",0,0,180,0,2,204,0,0
"Germany","2024-11-13",0,0,180,0,2,206,0,0
"Germany","2024-11-14",0,0,180,0,2,208,0,0
"Germany","2024-11-15",0,0,180,0,2,210,0,0
"Germany","2024-11-16",0,0,180,0,2,212,0,0
"Germany","2024-11-17",0,0,180,0,2,214,0,0
"Germany","2024-11-18",0,0,180,0,2,216,0,0
"Germany","2024-11-19",0,0,180,0,2,218,0,0
"Germany","2024-11-20",0,0,180,0,2,220,0,0
"Germany","2024-11-21",0,0,180,0,2,222,0,0
"Germany","2024-11-22",0,0,180,0,2,224,0,0
"Germany","2024-11-23",0,0,180,0,2,226,0,0
"Germany","2024-11-24",0,0,180,0,2,228,0,0
"Germany","2024-11-25",0,0,180,0,2,230,0,0
"Germany","2024-11-26",0,0,180,0,2,232,0,0
"Germany","2024-11-27",0,0,180,0,2,234,0,0
"Germany","2024-11-28",0,0,180,0,2,236,0,0
"Germany","2024-11-29",0,0,180,0,2,238,0,0
"Germany","2024-11-30",0,60,240,0,2,240,0,0
"Germany","2024-12-01",0,0,240,0,2,242,0,0
"Germany","2024-12-02",0,0,240,0,1,243,0,0
"Germany","2024-12-03",0,0,240,0,2,245,0,0
"Germany","2024-12-04",0,0,240,0,1,246,0,0
"Germany","2024-12-05",0,0,240,0,2,248,0,0
"Germany","2024-12-06",0,0,240,0,2,250,0,0
"Germany","2024-12-07",0,0,240,0,1,251,0,0
"Germany","2024-12-08",0,0,240,0,2,253,0,0
"Germany","2024-12-09",0,0,240,0,2,255,0,0
"Germany","2024-12-10",0,0,240,0,1,256,0,0
"Germany","2024-12-11",0,0,240,0,2,258,0,0
"Germany","2024-12-12",0,0,240,0,1,259,0,0
"Germany","2024-12-13",0,0,240,0,2,261,0,0
"Germany","2024-12-14",0,0,240,0,2,263,0,0
"Germany","2024-12-15",0,0,240,0,1,264,0,0
"Germany","2024-12-16",0,0,240,0,2,266,0,0
"Germany","2024-12-17",0,0,240,0,1,267,0,0
"Germany","2024-12-18",0,0,240,0,2,269,0,0
"Germany","2024-12-19",0,0,240,0,2,271,0,0
"Germany","2024-12-20",0,0,240,0,1,272,0,0
"Germany","2024-12-21",0,0,240,0,2,274,0,0
"Germany","2024-12-22",0,0,240,0,1,275,0,0
"Germany","2024-12-23",0,0,240,0,2,277,0,0
"Germany","2024-12-24",0,0,240,0,2,279,0,0
"Germany","2024-12-25",0,0,240,0,1,280,0,0
"Germany","2024-12-26",0,0,240,0,2,282,0,0
"Germany","2024-12-27",0,0,240,0,2,284,0,0
"Germany","2024-12-28",0,0,240,0,1,285,0,0
"Germany","2024-12-29",0,0,240,0,2,287,0,0
"Germany","2024-12-30",0,0,240,0,1,288,0,0
"Germany","2024-12-31",0,50,290,0,2,290,0,0
"Germany","2025-01-01",0,0,290,0,0,290,0,0
"Germany","2025-01-02",0,0,290,0,0,290,0,0
"Germany","2025-01-03",0,0,290,0,0,290,0,0
"Germany","2025-01-04",0,0,290,0,0,290,0,0
"Germany","2025-01-05",0,0,290,0,0,290,0,0
"Germany","2025-01-06",0,0,290,0,0,290,0,0
"Germany","2025-01-07",0,0,290,0,0,290,0,0
"Germany","2025-01-08",0,0,290,0,0,290,0,0
"Germany","2025-01-09",0,0,290,0,0,290,0,0
"Germany","2025-01-10",0,0,290,0,0,290,0,0
"Germany","2025-01-11",0,0,290,0,0,290,0,0
"Germany","2025-01-12",0,0,290,0,0,290,0,0
"Germany","2025-01-13",0,0,290,0,0,290,0,0
"Germany","2025-01-14",0,0,290,0,0,290,0,0
"Germany","2025-01-15",0,0,290,0,0,290,0,0
"Germany","2025-01-16",0,0,290,0,0,290,0,0
"Germany","2025-01-17",0,0,290,0,0,290,0,0
"Germany","2025-01-18",0,0,290,0,0,290,0,0
"Germany","2025-01-19",0,0,290,0,0,290,0,0
"Germany","2025-01-20",0,0,290,0,0,290,0,0
"Germany","2025-01-21",0,0,290,0,0,290,0,0
"Germany","2025-01-22",0,0,290,0,0,290,0,0
"Germany","2025-01-23",0,0,290,0,0,290,0,0
"Germany","2025-01-24",0,0,290,0,0,290,0,0
"Germany","2025-01-25",0,0,290,0,0,290,0,0
"Germany","2025-01-26",0,0,290,0,0,290,0,0
"Germany","2025-01-27",0,0,290,0,0,290,0,0
"Germany","2025-01-28",0,0,290,0,0,290,0,0
"Germany","2025-01-29",0,0,290,0,0,290,0,0
"Germany","2025-01-30",0,0,290,0,0,290,0,0
"Germany","2025-01-31",0,0,290,0,0,290,0,0
"Germany","2025-02-01",0,0,290,0,0,290,0,0
"Germany","2025-02-02",0,0,290,0,0,290,0,0
"Germany","2025-02-03",0,0,290,0,0,290,0,0
"Ghana","2024-01-01",0,0,0,0,0,0,0,0
"Ghana","2024-01-02",0,0,0,0,0,0,0,0
"Ghana","2024-01-03",0,0,0,0,0,0,0,0
"Ghana","2024-01-04",0,0,0,0,0,0,0,0
"Ghana","2024-01-05",0,0,0,0,0,0,0,0
"Ghana","2024-01-06",0,0,0,0,0,0,0,0
"Ghana","2024-01-07",0,0,0,0,0,0,0,0
"Ghana","2024-01-08",0,0,0,0,0,0,0,0
"Ghana","2024-01-09",0,0,0,0,0,0,0,0
"Ghana","2024-01-10",0,0,0,0,0,0,0,0
"Ghana","2024-01-11",0,0,0,0,0,0,0,0
"Ghana","2024-01-12",0,0,0,0,0,0,0,0
"Ghana","2024-01-13",0,0,0,0,0,0,0,0
"Ghana","2024-01-14",0,0,0,0,0,0,0,0
"Ghana","2024-01-15",0,0,0,0,0,0,0,0
"Ghana","2024-01-16",0,0,0,0,0,0,0,0
"Ghana","2024-01-17",0,0,0,0,0,0,0,0
"Ghana","2024-01-18",0,0,0,0,0,0,0,0
"Ghana","2024-01-19",0,0,0,0,0,0,0,0
"Ghana","2024-01-20",0,0,0,0,0,0,0,0
"Ghana","2024-01-21",0,0,0,0,0,0,0,0
"Ghana","2024-01-22",0,0,0,0,0,0,0,0
"Ghana","2024-01-23",0,0,0,0,0,0,0,0
"Ghana","2024-01-24",0,0,0,0,0,0,0,0
"Ghana","2024-01-25",0,0,0,0,0,0,0,0
"Ghana","2024-01-26",0,0,0,0,0,0,0,0
"Ghana","2024-01-27",0,0,0,0,0,0,0,0
"Ghana","2024-01-28",0,0,0,0,0,0,0,0
"Ghana","2024-01-29",0,0,0,0,0,0,0,0
"Ghana","2024-01-30",0,0,0,0,0,0,0,0
"Ghana","2024-01-31",0,0,0,0,0,0,0,0
"Ghana","2024-02-01",0,0,0,0,0,0,0,0
"Ghana","2024-02-02",0,0,0,0,0,0,0,0
"Ghana","2024-02-03",0,0,0,0,0,0,0,0
"Ghana","2024-02-04",0,0,0,0,0,0,0,0
"Ghana","2024-02-05",0,0,0,0,0,0,0,0
"Ghana","2024-02-06",0,0,0,0,0,0,0,0
"Ghana","2024-02-07",0,0,0,0,0,0,0,0
"Ghana","2024-02-08",0,0,0,0,0,0,0,0
"Ghana","2024-02-09",0,0,0,0,0,0,0,0
"Ghana","2024-02-10",0,0,0,0,0,0,0,0
"Ghana","2024-02-11",0,0,0,0,0,0,0,0
"Ghana","2024-02-12",0,0,0,0,0,0,0,0
"Ghana","2024-02-13",0,0,0,0,0,0,0,0
"Ghana","2024-02-14",0,0,0,0,0,0,0,0
"Ghana","2024-02-15",0,0,0,0,0,0,0,0
"Ghana","2024-02-16",0,0,0,0,0,0,0,0
"Ghana","2024-02-17",0,0,0,0,0,0,0,0
"Ghana","2024-02-18",0,0,0,0,0,0,0,0
"Ghana","2024-02-19",0,0,0,0,0,0,0,0
"Ghana","2024-02-20",0,0,0,0,0,0,0,0
"Ghana","2024-02-21",0,0,0,0,0,0,0,0
"Ghana","2024-02-22",0,0,0,0,0,0,0,0
"Ghana","2024-02-23",0,0,0,0,0,0,0,0
"Ghana","2024-02-24",0,0,0,0,0,0,0,0
"Ghana","2024-02-25",0,0,0,0,0,0,0,0
"Ghana","2024-02-26",0,0,0,0,0,0,0,0
"Ghana","2024-02-27",0,0,0,0,0,0,0,0
"Ghana","2024-02-28",0,0,0,0,0,0,0,0
"Ghana","2024-02-29",0,0,0,0,0,0,0,0
"Ghana","2024-03-01",0,0,0,0,0,0,0,0
"Ghana","2024-03-02",0,0,0,0,0,0,0,0
"Ghana","2024-03-03",0,0,0,0,0,0,0,0
"Ghana","2024-03-04",0,0,0,0,0,0,0,0
"Ghana","2024-03-05",0,0,0,0,0,0,0,0
"Ghana","2024-03-06",0,0,0,0,0,0,0,0
"Ghana","2024-03-07",0,0,0,0,0,0,0,0
"Ghana","2024-03-08",0,0,0,0,0,0,0,0
"Ghana","2024-03-09",0,0,0,0,0,0,0,0
"Ghana","2024-03-10",0,0,0,0,0,0,0,0
"Ghana","2024-03-11",0,0,0,0,0,0,0,0
"Ghana","2024-03-12",0,0,0,0,0,0,0,0
"Ghana","2024-03-13",0,0,0,0,0,0,0,0
"Ghana","2024-03-14",0,0,0,0,0,0,0,0
"Ghana","2024-03-15",0,0,0,0,0,0,0,0
"Ghana","2024-03-16",0,0,0,0,0,0,0,0
"Ghana","2024-03-17",0,0,0,0,0,0,0,0
"Ghana","2024-03-18",0,0,0,0,0,0,0,0
"Ghana","2024-03-19",0,0,0,0,0,0,0,0
"Ghana","2024-03-20",0,0,0,0,0,0,0,0
"Ghana","2024-03-21",0,0,0,0,0,0,0,0
"Ghana","2024-03-22",0,0,0,0,0,0,0,0
"Ghana","2024-03-23",0,0,0,0,0,0,0,0
"Ghana","2024-03-24",0,0,0,0,0,0,0,0
"Ghana","2024-03-25",0,0,0,0,0,0,0,0
"Ghana","2024-03-26",0,0,0,0,0,0,0,0
"Ghana","2024-03-27",0,0,0,0,0,0,0,0
"Ghana","2024-03-28",0,0,0,0,0,0,0,0
"Ghana","2024-03-29",0,0,0,0,0,0,0,0
"Ghana","2024-03-30",0,0,0,0,0,0,0,0
"Ghana","2024-03-31",0,0,0,0,0,0,0,0
"Ghana","2024-04-01",0,0,0,0,0,0,0,0
"Ghana","2024-04-02",0,0,0,0,0,0,0,0
"Ghana","2024-04-03",0,0,0,0,0,0,0,0
"Ghana","2024-04-04",0,0,0,0,0,0,0,0
"Ghana","2024-04-05",0,0,0,0,0,0,0,0
"Ghana","2024-04-06",0,0,0,0,0,0,0,0
"Ghana","2024-04-07",0,0,0,0,0,0,0,0
"Ghana","2024-04-08",0,0,0,0,0,0,0,0
"Ghana","2024-04-09",0,0,0,0,0,0,0,0
"Ghana","2024-04-10",0,0,0,0,0,0,0,0
"Ghana","2024-04-11",0,0,0,0,0,0,0,0
"Ghana","2024-04-12",0,0,0,0,0,0,0,0
"Ghana","2024-04-13",0,0,0,0,0,0,0,0
"Ghana","2024-04-14",0,0,0,0,0,0,0,0
"Ghana","2024-04-15",0,0,0,0,0,0,0,0
"Ghana","2024-04-16",0,0,0,0,0,0,0,0
"Ghana","2024-04-17",0,0,0,0,0,0,0,0
"Ghana","2024-04-18",0,0,0,0,0,0,0,0
"Ghana","2024-04-19",0,0,0,0,0,0,0,0
"Ghana","2024-04-20",0,0,0,0,0,0,0,0
"Ghana","2024-04-21",0,0,0,0,0,0,0,0
"Ghana","2024-04-22",0,0,0,0,0,0,0,0
"Ghana","2024-04-23",0,0,0,0,0,0,0,0
"Ghana","2024-04-24",0,0,0,0,0,0,0,0
"Ghana","2024-04-25",0,0,0,0,0,0,0,0
"Ghana","2024-04-26",0,0,0,0,0,0,0,0
"Ghana","2024-04-27",0,0,0,0,0,0,0,0
"Ghana","2024-04-28",0,0,0,0,0,0,0,0
"Ghana","2024-04-29",0,0,0,0,0,0,0,0
"Ghana","2024-04-30",0,0,0,0,0,0,0,0
"Ghana","2024-05-01",0,0,0,0,0,0,0,0
"Ghana","2024-05-02",0,0,0,0,0,0,0,0
"Ghana","2024-05-03",0,0,0,0,0,0,0,0
"Ghana","2024-05-04",0,0,0,0,0,0,0,0
"Ghana","2024-05-05",0,0,0,0,0,0,0,0
"Ghana","2024-05-06",0,0,0,0,0,0,0,0
"Ghana","2024-05-07",0,0,0,0,0,0,0,0
"Ghana","2024-05-08",0,0,0,0,0,0,0,0
"Ghana","2024-05-09",0,0,0,0,0,0,0,0
"Ghana","2024-05-10",0,0,0,0,0,0,0,0
"Ghana","2024-05-11",0,0,0,0,0,0,0,0
"Ghana","2024-05-12",0,0,0,0,0,0,0,0
"Ghana","2024-05-13",0,0,0,0,0,0,0,0
"Ghana","2024-05-14",0,0,0,0,0,0,0,0
"Ghana","2024-05-15",0,0,0,0,0,0,0,0
"Ghana","2024-05-16",0,0,0,0,0,0,0,0
"Ghana","2024-05-17",0,0,0,0,0,0,0,0
"Ghana","2024-05-18",0,0,0,0,0,0,0,0
"Ghana","2024-05-19",0,0,0,0,0,0,0,0
"Ghana","2024-05-20",0,0,0,0,0,0,0,0
"Ghana","2024-05-21",0,0,0,0,0,0,0,0
"Ghana","2024-05-22",0,0,0,0,0,0,0,0
"Ghana","2024-05-23",0,0,0,0,0,0,0,0
"Ghana","2024-05-24",0,0,0,0,0,0,0,0
"Ghana","2024-05-25",0,0,0,0,0,0,0,0
"Ghana","2024-05-26",0,0,0,0,0,0,0,0
"Ghana","2024-05-27",0,0,0,0,0,0,0,0
"Ghana","2024-05-28",0,0,0,0,0,0,0,0
"Ghana","2024-05-29",0,0,0,0,0,0,0,0
"Ghana","2024-05-30",0,0,0,0,0,0,0,0
"Ghana","2024-05-31",0,0,0,0,0,0,0,0
"Ghana","2024-06-01",0,0,0,0,0,0,0,0
"Ghana","2024-06-02",0,0,0,0,0,0,0,0
"Ghana","2024-06-03",0,0,0,0,0,0,0,0
"Ghana","2024-06-04",0,0,0,0,0,0,0,0
"Ghana","2024-06-05",0,0,0,0,0,0,0,0
"Ghana","2024-06-06",0,0,0,0,0,0,0,0
"Ghana","2024-06-07",0,0,0,0,0,0,0,0
"Ghana","2024-06-08",0,0,0,0,0,0,0,0
"Ghana","2024-06-09",0,0,0,0,0,0,0,0
"Ghana","2024-06-10",0,0,0,0,0,0,0,0
"Ghana","2024-06-11",0,0,0,0,0,0,0,0
"Ghana","2024-06-12",0,0,0,0,0,0,0,0
"Ghana","2024-06-13",0,0,0,0,0,0,0,0
"Ghana","2024-06-14",0,0,0,0,0,0,0,0
"Ghana","2024-06-15",0,0,0,0,0,0,0,0
"Ghana","2024-06-16",0,0,0,0,0,0,0,0
"Ghana","2024-06-17",0,0,0,0,0,0,0,0
"Ghana","2024-06-18",0,0,0,0,0,0,0,0
"Ghana","2024-06-19",0,0,0,0,0,0,0,0
"Ghana","2024-06-20",0,0,0,0,0,0,0,0
"Ghana","2024-06-21",0,0,0,0,0,0,0,0
"Ghana","2024-06-22",0,0,0,0,0,0,0,0
"Ghana","2024-06-23",0,0,0,0,0,0,0,0
"Ghana","2024-06-24",0,0,0,0,0,0,0,0
"Ghana","2024-06-25",0,0,0,0,0,0,0,0
"Ghana","2024-06-26",0,0,0,0,0,0,0,0
"Ghana","2024-06-27",0,0,0,0,0,0,0,0
"Ghana","2024-06-28",0,0,0,0,0,0,0,0
"Ghana","2024-06-29",0,0,0,0,0,0,0,0
"Ghana","2024-06-30",0,0,0,0,0,0,0,0
"Ghana","2024-07-01",0,0,0,0,0,0,0,0
"Ghana","2024-07-02",0,0,0,0,0,0,0,0
"Ghana","2024-07-03",0,0,0,0,0,0,0,0
"Ghana","2024-07-04",0,0,0,0,0,0,0,0
"Ghana","2024-07-05",0,0,0,0,0,0,0,0
"Ghana","2024-07-06",0,0,0,0,0,0,0,0
"Ghana","2024-07-07",0,0,0,0,0,0,0,0
"Ghana","2024-07-08",0,0,0,0,0,0,0,0
"Ghana","2024-07-09",0,0,0,0,0,0,0,0
"Ghana","2024-07-10",0,0,0,0,0,0,0,0
"Ghana","2024-07-11",0,0,0,0,0,0,0,0
"Ghana","2024-07-12",0,0,0,0,0,0,0,0
"Ghana","2024-07-13",0,0,0,0,0,0,0,0
"Ghana","2024-07-14",0,0,0,0,0,0,0,0
"Ghana","2024-07-15",0,0,0,0,0,0,0,0
"Ghana","2024-07-16",0,0,0,0,0,0,0,0
"Ghana","2024-07-17",0,0,0,0,0,0,0,0
"Ghana","2024-07-18",0,0,0,0,0,0,0,0
"Ghana","2024-07-19",0,0,0,0,0,0,0,0
"Ghana","2024-07-20",0,0,0,0,0,0,0,0
"Ghana","2024-07-21",0,0,0,0,0,0,0,0
"Ghana","2024-07-22",0,0,0,0,0,0,0,0
"Ghana","2024-07-23",0,0,0,0,0,0,0,0
"Ghana","2024-07-24",0,0,0,0,0,0,0,0
"Ghana","2024-07-25",0,0,0,0,0,0,0,0
"Ghana","2024-07-26",0,0,0,0,0,0,0,0
"Ghana","2024-07-27",0,0,0,0,0,0,0,0
"Ghana","2024-07-28",0,0,0,0,0,0,0,0
"Ghana","2024-07-29",0,0,0,0,0,0,0,0
"Ghana","2024-07-30",0,0,0,0,0,0,0,0
"Ghana","2024-07-31",0,0,0,0,0,0,0,0
"Ghana","2024-08-01",0,0,0,0,0,0,0,0
"Ghana","2024-08-02",0,0,0,0,0,0,0,0
"Ghana","2024-08-03",0,0,0,0,0,0,0,0
"Ghana","2024-08-04",0,0,0,0,0,0,0,0
"Ghana","2024-08-05",0,0,0,0,0,0,0,0
"Ghana","2024-08-06",0,0,0,0,0,0,0,0
"Ghana","2024-08-07",0,0,0,0,0,0,0,0
"Ghana","2024-08-08",0,0,0,0,0,0,0,0
"Ghana","2024-08-09",0,0,0,0,0,0,0,0
"Ghana","2024-08-10",0,0,0,0,0,0,0,0
"Ghana","2024-08-11",0,0,0,0,0,0,0,0
"Ghana","2024-08-12",0,0,0,0,0,0,0,0
"Ghana","2024-08-13",0,0,0,0,0,0,0,0
"Ghana","2024-08-14",0,0,0,0,0,0,0,0
"Ghana","2024-08-15",0,0,0,0,0,0,0,0
"Ghana","2024-08-16",0,0,0,0,0,0,0,0
"Ghana","2024-08-17",0,0,0,0,0,0,0,0
"Ghana","2024-08-18",0,0,0,0,0,0,0,0
"Ghana","2024-08-19",0,0,0,0,0,0,0,0
"Ghana","2024-08-20",0,0,0,0,0,0,0,0
"Ghana","2024-08-21",0,0,0,0,0,0,0,0
"Ghana","2024-08-22",0,0,0,0,0,0,0,0
"Ghana","2024-08-23",0,0,0,0,0,0,0,0
"Ghana","2024-08-24",0,0,0,0,0,0,0,0
"Ghana","2024-08-25",0,0,0,0,0,0,0,0
"Ghana","2024-08-26",0,0,0,0,0,0,0,0
"Ghana","2024-08-27",0,0,0,0,0,0,0,0
"Ghana","2024-08-28",0,0,0,0,0,0,0,0
"Ghana","2024-08-29",0,0,0,0,0,0,0,0
"Ghana","2024-08-30",0,0,0,0,0,0,0,0
"Ghana","2024-08-31",0,0,0,0,0,0,0,0
"Ghana","2024-09-01",0,0,0,0,0,0,0,0
"Ghana","2024-09-02",0,0,0,0,0,0,0,0
"Ghana","2024-09-03",0,0,0,0,0,0,0,0
"Ghana","2024-09-04",0,0,0,0,0,0,0,0
"Ghana","2024-09-05",0,0,0,0,0,0,0,0
"Ghana","2024-09-06",0,0,0,0,0,0,0,0
"Ghana","2024-09-07",0,0,0,0,0,0,0,0
"Ghana","2024-09-08",0,0,0,0,0,0,0,0
"Ghana","2024-09-09",0,0,0,0,0,0,0,0
"Ghana","2024-09-10",0,0,0,0,0,0,0,0
"Ghana","2024-09-11",0,0,0,0,0,0,0,0
"Ghana","2024-09-12",0,0,0,0,0,0,0,0
"Ghana","2024-09-13",0,0,0,0,0,0,0,0
"Ghana","2024-09-14",0,0,0,0,0,0,0,0
"Ghana","2024-09-15",0,0,0,0,0,0,0,0
"Ghana","2024-09-16",0,0,0,0,0,0,0,0
"Ghana","2024-09-17",0,0,0,0,0,0,0,0
"Ghana","2024-09-18",0,0,0,0,0,0,0,0
"Ghana","2024-09-19",0,0,0,0,0,0,0,0
"Ghana","2024-09-20",0,0,0,0,0,0,0,0
"Ghana","2024-09-21",0,0,0,0,0,0,0,0
"Ghana","2024-09-22",0,1,1,0,1,1,0,0
"Ghana","2024-09-23",0,0,1,0,0,1,0,0
"Ghana","2024-09-24",0,0,1,0,0,1,0,0
"Ghana","2024-09-25",0,0,1,0,0,1,0,0
"Ghana","2024-09-26",0,0,1,0,1,2,0,0
"Ghana","2024-09-27",0,0,1,0,0,2,0,0
"Ghana","2024-09-28",0,0,1,0,0,2,0,0
"Ghana","2024-09-29",0,1,2,0,0,2,0,0
"Ghana","2024-09-30",0,0,2,0,0,2,0,0
"Ghana","2024-10-01",0,0,2,0,0,2,0,0
"Ghana","2024-10-02",0,0,2,0,0,2,0,0
"Ghana","2024-10-03",0,0,2,0,0,2,0,0
"Ghana","2024-10-04",0,0,2,0,0,2,0,0
"Ghana","2024-10-05",0,0,2,0,0,2,0,0
"Ghana","2024-10-06",0,0,2,0,0,2,0,0
"Ghana","2024-10-07",0,0,2,0,0,2,0,0
"Ghana","2024-10-08",0,0,2,0,0,2,0,0
"Ghana","2024-10-09",0,0,2,0,0,2,0,0
"Ghana","2024-10-10",0,0,2,0,0,2,0,0
"Ghana","2024-10-11",0,0,2,0,0,2,0,0
"Ghana","2024-10-12",0,0,2,0,0,2,0,0
"Ghana","2024-10-13",0,0,2,0,0,2,0,0
"Ghana","2024-10-14",0,0,2,0,1,3,0,0
"Ghana","2024-10-15",0,0,2,0,0,3,0,0
"Ghana","2024-10-16",0,0,2,0,0,3,0,0
"Ghana","2024-10-17",0,0,2,0,0,3,0,0
"Ghana","2024-10-18",0,0,2,0,0,3,0,0
"Ghana","2024-10-19",0,0,2,0,0,3,0,0
"Ghana","2024-10-20",0,0,2,0,0,3,0,0
"Ghana","2024-10-21",0,0,2,0,0,3,0,0
"Ghana","2024-10-22",0,0,2,0,0,3,0,0
"Ghana","2024-10-23",0,0,2,0,0,3,0,0
"Ghana","2024-10-24",0,0,2,0,0,3,0,0
"Ghana","2024-10-25",0,0,2,0,0,3,0,0
"Ghana","2024-10-26",0,0,2,0,0,3,0,0
"Ghana","2024-10-27",0,1,3,0,0,3,0,0
"Ghana","2024-10-28",0,0,3,0,0,3,0,0
"Ghana","2024-10-29",0,0,3,0,0,3,0,0
"Ghana","2024-10-30",0,0,3,0,0,3,0,0
"Ghana","2024-10-31",0,0,3,0,0,3,0,0
"Ghana","2024-11-01",0,0,3,0,0,3,0,0
"Ghana","2024-11-02",0,0,3,0,0,3,0,0
"Ghana","2024-11-03",0,0,3,0,0,3,0,0
"Ghana","2024-11-04",0,0,3,0,0,3,0,0
"Ghana","2024-11-05",0,0,3,0,0,3,0,0
"Ghana","2024-11-06",0,0,3,0,0,3,0,0
"Ghana","2024-11-07",0,0,3,0,1,4,0,0
"Ghana","2024-11-08",0,0,3,0,0,4,0,0
"Ghana","2024-11-09",0,0,3,0,0,4,0,0
"Ghana","2024-11-10",0,0,3,0,0,4,0,0
"Ghana","2024-11-11",0,0,3,0,0,4,0,0
"Ghana","2024-11-12",0,0,3,0,0,4,0,0
"Ghana","2024-11-13",0,0,3,0,0,4,0,0
"Ghana","2024-11-14",0,0,3,0,0,4,0,0
"Ghana","2024-11-15",0,0,3,0,0,4,0,0
"Ghana","2024-11-16",0,0,3,0,0,4,0,0
"Ghana","2024-11-17",0,1,4,0,0,4,0,0
"Ghana","2024-11-18",0,0,4,0,0,4,0,0
"Ghana","2024-11-19",0,0,4,0,0,4,0,0
"Ghana","2024-11-20",0,0,4,0,0,4,0,0
"Ghana","2024-11-21",0,0,4,0,1,5,0,0
"Ghana","2024-11-22",0,0,4,0,0,5,0,0
"Ghana","2024-11-23",0,0,4,0,0,5,0,0
"Ghana","2024-11-24",0,1,5,0,0,5,0,0
"Ghana","2024-11-25",0,0,5,0,0,5,0,0
"Ghana","2024-11-26",0,0,5,0,0,5,0,0
"Ghana","2024-11-27",0,0,5,0,0,5,0,0
"Ghana","2024-11-28",0,0,5,0,0,5,0,0
"Ghana","2024-11-29",0,0,5,0,0,5,0,0
"Ghana","2024-11-30",0,0,5,0,0,5,0,0
"Ghana","2024-12-01",0,0,5,0,0,5,0,0
"Ghana","2024-12-02",0,0,5,0,0,5,0,0
"Ghana","2024-12-03",0,0,5,0,0,5,0,0
"Ghana","2024-12-04",0,0,5,0,0,5,0,0
"Ghana","2024-12-05",0,0,5,0,0,5,0,0
"Ghana","2024-12-06",0,0,5,0,0,5,0,0
"Ghana","2024-12-07",0,0,5,0,0,5,0,0
"Ghana","2024-12-08",0,0,5,0,0,5,0,0
"Ghana","2024-12-09",0,0,5,0,0,5,0,0
"Ghana","2024-12-10",0,0,5,0,0,5,0,0
"Ghana","2024-12-11",0,0,5,0,0,5,0,0
"Ghana","2024-12-12",0,0,5,0,0,5,0,0
"Ghana","2024-12-13",0,0,5,0,0,5,0,0
"Ghana","2024-12-14",0,0,5,0,0,5,0,0
"Ghana","2024-12-15",0,0,5,0,0,5,0,0
"Ghana","2024-12-16",0,0,5,0,0,5,0,0
"Ghana","2024-12-17",0,0,5,0,0,5,0,0
"Ghana","2024-12-18",0,0,5,0,0,5,0,0
"Ghana","2024-12-19",0,0,5,0,0,5,0,0
"Ghana","2024-12-20",0,0,5,0,0,5,0,0
"Ghana","2024-12-21",0,0,5,0,0,5,0,0
"Ghana","2024-12-22",0,0,5,0,0,5,0,0
"Ghana","2024-12-23",0,0,5,0,0,5,0,0
"Ghana","2024-12-24",0,0,5,0,0,5,0,0
"Ghana","2024-12-25",0,0,5,0,0,5,0,0
"Ghana","2024-12-26",0,0,5,0,0,5,0,0
"Ghana","2024-12-27",0,0,5,0,0,5,0,0
"Ghana","2024-12-28",0,0,5,0,0,5,0,0
"Ghana","2024-12-29",0,0,5,0,0,5,0,0
"Ghana","2024-12-30",0,0,5,0,0,5,0,0
"Ghana","2024-12-31",0,0,5,0,0,5,0,0
"Ghana","2025-01-01",0,0,5,0,0,5,0,0
"Ghana","2025-01-02",0,0,5,0,0,5,0,0
"Ghana","2025-01-03",0,0,5,0,0,5,0,0
"Ghana","2025-01-04",0,0,5,0,0,5,0,0
"Ghana","2025-01-05",0,0,5,0,0,5,0,0
"Ghana","2025-01-06",0,0,5,0,0,5,0,0
"Ghana","2025-01-07",0,0,5,0,0,5,0,0
"Ghana","2025-01-08",0,0,5,0,0,5,0,0
"Ghana","2025-01-09",0,0,5,0,0,5,0,0
"Ghana","2025-01-10",0,0,5,0,0,5,0,0
"Ghana","2025-01-11",0,0,5,0,0,5,0,0
"Ghana","2025-01-12",0,0,5,0,0,5,0,0
"Ghana","2025-01-13",0,0,5,0,0,5,0,0
"Ghana","2025-01-14",0,0,5,0,0,5,0,0
"Ghana","2025-01-15",0,0,5,0,0,5,0,0
"Ghana","2025-01-16",0,0,5,0,0,5,0,0
"Ghana","2025-01-17",0,0,5,0,0,5,0,0
"Ghana","2025-01-18",0,0,5,0,0,5,0,0
"Ghana","2025-01-19",0,0,5,0,0,5,0,0
"Ghana","2025-01-20",0,0,5,0,0,5,0,0
"Ghana","2025-01-21",0,0,5,0,0,5,0,0
"Ghana","2025-01-22",0,0,5,0,0,5,0,0
"Ghana","2025-01-23",0,0,5,0,0,5,0,0
"Ghana","2025-01-24",0,0,5,0,0,5,0,0
"Ghana","2025-01-25",0,0,5,0,0,5,0,0
"Ghana","2025-01-26",0,0,5,0,0,5,0,0
"Ghana","2025-01-27",0,0,5,0,0,5,0,0
"Ghana","2025-01-28",0,0,5,0,0,5,0,0
"Ghana","2025-01-29",0,0,5,0,0,5,0,0
"Ghana","2025-01-30",0,0,5,0,0,5,0,0
"Ghana","2025-01-31",0,0,5,0,0,5,0,0
"Ghana","2025-02-01",0,0,5,0,0,5,0,0
"Ghana","2025-02-02",0,0,5,0,0,5,0,0
"Ghana","2025-02-03",0,0,5,0,0,5,0,0
"Gibraltar","2024-01-01",0,0,0,0,0,0,0,0
"Gibraltar","2024-01-02",0,0,0,0,0,0,0,0
"Gibraltar","2024-01-03",0,0,0,0,0,0,0,0
"Gibraltar","2024-01-04",0,0,0,0,0,0,0,0
"Gibraltar","2024-01-05",0,0,0,0,0,0,0,0
"Gibraltar","2024-01-06",0,0,0,0,0,0,0,0
"Gibraltar","2024-01-07",0,0,0,0,0,0,0,0
"Gibraltar","2024-01-08",0,0,0,0,0,0,0,0
"Gibraltar","2024-01-09",0,0,0,0,0,0,0,0
"Gibraltar","2024-01-10",0,0,0,0,0,0,0,0
"Gibraltar","2024-01-11",0,0,0,0,0,0,0,0
"Gibraltar","2024-01-12",0,0,0,0,0,0,0,0
"Gibraltar","2024-01-13",0,0,0,0,0,0,0,0
"Gibraltar","2024-01-14",0,0,0,0,0,0,0,0
"Gibraltar","2024-01-15",0,0,0,0,0,0,0,0
"Gibraltar","2024-01-16",0,0,0,0,0,0,0,0
"Gibraltar","2024-01-17",0,0,0,0,0,0,0,0
"Gibraltar","2024-01-18",0,0,0,0,0,0,0,0
"Gibraltar","2024-01-19",0,0,0,0,0,0,0,0
"Gibraltar","2024-01-20",0,0,0,0,0,0,0,0
"Gibraltar","2024-01-21",0,0,0,0,0,0,0,0
"Gibraltar","2024-01-22",0,0,0,0,0,0,0,0
"Gibraltar","2024-01-23",0,0,0,0,0,0,0,0
"Gibraltar","2024-01-24",0,0,0,0,0,0,0,0
"Gibraltar","2024-01-25",0,0,0,0,0,0,0,0
"Gibraltar","2024-01-26",0,0,0,0,0,0,0,0
"Gibraltar","2024-01-27",0,0,0,0,0,0,0,0
"Gibraltar","2024-01-28",0,0,0,0,0,0,0,0
"Gibraltar","2024-01-29",0,0,0,0,0,0,0,0
"Gibraltar","2024-01-30",0,0,0,0,0,0,0,0
"Gibraltar","2024-01-31",0,0,0,0,0,0,0,0
"Gibraltar","2024-02-01",0,0,0,0,0,0,0,0
"Gibraltar","2024-02-02",0,0,0,0,0,0,0,0
"Gibraltar","2024-02-03",0,0,0,0,0,0,0,0
"Gibraltar","2024-02-04",0,0,0,0,0,0,0,0
"Gibraltar","2024-02-05",0,0,0,0,0,0,0,0
"Gibraltar","2024-02-06",0,0,0,0,0,0,0,0
"Gibraltar","2024-02-07",0,0,0,0,0,0,0,0
"Gibraltar","2024-02-08",0,0,0,0,0,0,0,0
"Gibraltar","2024-02-09",0,0,0,0,0,0,0,0
"Gibraltar","2024-02-10",0,0,0,0,0,0,0,0
"Gibraltar","2024-02-11",0,0,0,0,0,0,0,0
"Gibraltar","2024-02-12",0,0,0,0,0,0,0,0
"Gibraltar","2024-02-13",0,0,0,0,0,0,0,0
"Gibraltar","2024-02-14",0,0,0,0,0,0,0,0
"Gibraltar","2024-02-15",0,0,0,0,0,0,0,0
"Gibraltar","2024-02-16",0,0,0,0,0,0,0,0
"Gibraltar","2024-02-17",0,0,0,0,0,0,0,0
"Gibraltar","2024-02-18",0,0,0,0,0,0,0,0
"Gibraltar","2024-02-19",0,0,0,0,0,0,0,0
"Gibraltar","2024-02-20",0,0,0,0,0,0,0,0
"Gibraltar","2024-02-21",0,0,0,0,0,0,0,0
"Gibraltar","2024-02-22",0,0,0,0,0,0,0,0
"Gibraltar","2024-02-23",0,0,0,0,0,0,0,0
"Gibraltar","2024-02-24",0,0,0,0,0,0,0,0
"Gibraltar","2024-02-25",0,0,0,0,0,0,0,0
"Gibraltar","2024-02-26",0,0,0,0,0,0,0,0
"Gibraltar","2024-02-27",0,0,0,0,0,0,0,0
"Gibraltar","2024-02-28",0,0,0,0,0,0,0,0
"Gibraltar","2024-02-29",0,0,0,0,0,0,0,0
"Gibraltar","2024-03-01",0,0,0,0,0,0,0,0
"Gibraltar","2024-03-02",0,0,0,0,0,0,0,0
"Gibraltar","2024-03-03",0,0,0,0,0,0,0,0
"Gibraltar","2024-03-04",0,0,0,0,0,0,0,0
"Gibraltar","2024-03-05",0,0,0,0,0,0,0,0
"Gibraltar","2024-03-06",0,0,0,0,0,0,0,0
"Gibraltar","2024-03-07",0,0,0,0,0,0,0,0
"Gibraltar","2024-03-08",0,0,0,0,0,0,0,0
"Gibraltar","2024-03-09",0,0,0,0,0,0,0,0
"Gibraltar","2024-03-10",0,0,0,0,0,0,0,0
"Gibraltar","2024-03-11",0,0,0,0,0,0,0,0
"Gibraltar","2024-03-12",0,0,0,0,0,0,0,0
"Gibraltar","2024-03-13",0,0,0,0,0,0,0,0
"Gibraltar","2024-03-14",0,0,0,0,0,0,0,0
"Gibraltar","2024-03-15",0,0,0,0,0,0,0,0
"Gibraltar","2024-03-16",0,0,0,0,0,0,0,0
"Gibraltar","2024-03-17",0,0,0,0,0,0,0,0
"Gibraltar","2024-03-18",0,0,0,0,0,0,0,0
"Gibraltar","2024-03-19",0,0,0,0,0,0,0,0
"Gibraltar","2024-03-20",0,0,0,0,0,0,0,0
"Gibraltar","2024-03-21",0,0,0,0,0,0,0,0
"Gibraltar","2024-03-22",0,0,0,0,0,0,0,0
"Gibraltar","2024-03-23",0,0,0,0,0,0,0,0
"Gibraltar","2024-03-24",0,0,0,0,0,0,0,0
"Gibraltar","2024-03-25",0,0,0,0,0,0,0,0
"Gibraltar","2024-03-26",0,0,0,0,0,0,0,0
"Gibraltar","2024-03-27",0,0,0,0,0,0,0,0
"Gibraltar","2024-03-28",0,0,0,0,0,0,0,0
"Gibraltar","2024-03-29",0,0,0,0,0,0,0,0
"Gibraltar","2024-03-30",0,0,0,0,0,0,0,0
"Gibraltar","2024-03-31",0,0,0,0,0,0,0,0
"Gibraltar","2024-04-01",0,0,0,0,0,0,0,0
"Gibraltar","2024-04-02",0,0,0,0,0,0,0,0
"Gibraltar","2024-04-03",0,0,0,0,0,0,0,0
"Gibraltar","2024-04-04",0,0,0,0,0,0,0,0
"Gibraltar","2024-04-05",0,0,0,0,0,0,0,0
"Gibraltar","2024-04-06",0,0,0,0,0,0,0,0
"Gibraltar","2024-04-07",0,0,0,0,0,0,0,0
"Gibraltar","2024-04-08",0,0,0,0,0,0,0,0
"Gibraltar","2024-04-09",0,0,0,0,0,0,0,0
"Gibraltar","2024-04-10",0,0,0,0,0,0,0,0
"Gibraltar","2024-04-11",0,0,0,0,0,0,0,0
"Gibraltar","2024-04-12",0,0,0,0,0,0,0,0
"Gibraltar","2024-04-13",0,0,0,0,0,0,0,0
"Gibraltar","2024-04-14",0,0,0,0,0,0,0,0
"Gibraltar","2024-04-15",0,0,0,0,0,0,0,0
"Gibraltar","2024-04-16",0,0,0,0,0,0,0,0
"Gibraltar","2024-04-17",0,0,0,0,0,0,0,0
"Gibraltar","2024-04-18",0,0,0,0,0,0,0,0
"Gibraltar","2024-04-19",0,0,0,0,0,0,0,0
"Gibraltar","2024-04-20",0,0,0,0,0,0,0,0
"Gibraltar","2024-04-21",0,0,0,0,0,0,0,0
"Gibraltar","2024-04-22",0,0,0,0,0,0,0,0
"Gibraltar","2024-04-23",0,0,0,0,0,0,0,0
"Gibraltar","2024-04-24",0,0,0,0,0,0,0,0
"Gibraltar","2024-04-25",0,0,0,0,0,0,0,0
"Gibraltar","2024-04-26",0,0,0,0,0,0,0,0
"Gibraltar","2024-04-27",0,0,0,0,0,0,0,0
"Gibraltar","2024-04-28",0,0,0,0,0,0,0,0
"Gibraltar","2024-04-29",0,0,0,0,0,0,0,0
"Gibraltar","2024-04-30",0,0,0,0,0,0,0,0
"Gibraltar","2024-05-01",0,0,0,0,0,0,0,0
"Gibraltar","2024-05-02",0,0,0,0,0,0,0,0
"Gibraltar","2024-05-03",0,0,0,0,0,0,0,0
"Gibraltar","2024-05-04",0,0,0,0,0,0,0,0
"Gibraltar","2024-05-05",0,0,0,0,0,0,0,0
"Gibraltar","2024-05-06",0,0,0,0,0,0,0,0
"Gibraltar","2024-05-07",0,0,0,0,0,0,0,0
"Gibraltar","2024-05-08",0,0,0,0,0,0,0,0
"Gibraltar","2024-05-09",0,0,0,0,0,0,0,0
"Gibraltar","2024-05-10",0,0,0,0,0,0,0,0
"Gibraltar","2024-05-11",0,0,0,0,0,0,0,0
"Gibraltar","2024-05-12",0,0,0,0,0,0,0,0
"Gibraltar","2024-05-13",0,0,0,0,0,0,0,0
"Gibraltar","2024-05-14",0,0,0,0,0,0,0,0
"Gibraltar","2024-05-15",0,0,0,0,0,0,0,0
"Gibraltar","2024-05-16",0,0,0,0,0,0,0,0
"Gibraltar","2024-05-17",0,0,0,0,0,0,0,0
"Gibraltar","2024-05-18",0,0,0,0,0,0,0,0
"Gibraltar","2024-05-19",0,0,0,0,0,0,0,0
"Gibraltar","2024-05-20",0,0,0,0,0,0,0,0
"Gibraltar","2024-05-21",0,0,0,0,0,0,0,0
"Gibraltar","2024-05-22",0,0,0,0,0,0,0,0
"Gibraltar","2024-05-23",0,0,0,0,0,0,0,0
"Gibraltar","2024-05-24",0,0,0,0,0,0,0,0
"Gibraltar","2024-05-25",0,0,0,0,0,0,0,0
"Gibraltar","2024-05-26",0,0,0,0,0,0,0,0
"Gibraltar","2024-05-27",0,0,0,0,0,0,0,0
"Gibraltar","2024-05-28",0,0,0,0,0,0,0,0
"Gibraltar","2024-05-29",0,0,0,0,0,0,0,0
"Gibraltar","2024-05-30",0,0,0,0,0,0,0,0
"Gibraltar","2024-05-31",0,0,0,0,0,0,0,0
"Gibraltar","2024-06-01",0,0,0,0,0,0,0,0
"Gibraltar","2024-06-02",0,0,0,0,0,0,0,0
"Gibraltar","2024-06-03",0,0,0,0,0,0,0,0
"Gibraltar","2024-06-04",0,0,0,0,0,0,0,0
"Gibraltar","2024-06-05",0,0,0,0,0,0,0,0
"Gibraltar","2024-06-06",0,0,0,0,0,0,0,0
"Gibraltar","2024-06-07",0,0,0,0,0,0,0,0
"Gibraltar","2024-06-08",0,0,0,0,0,0,0,0
"Gibraltar","2024-06-09",0,0,0,0,0,0,0,0
"Gibraltar","2024-06-10",0,0,0,0,0,0,0,0
"Gibraltar","2024-06-11",0,0,0,0,0,0,0,0
"Gibraltar","2024-06-12",0,0,0,0,0,0,0,0
"Gibraltar","2024-06-13",0,0,0,0,0,0,0,0
"Gibraltar","2024-06-14",0,0,0,0,0,0,0,0
"Gibraltar","2024-06-15",0,0,0,0,0,0,0,0
"Gibraltar","2024-06-16",0,0,0,0,0,0,0,0
"Gibraltar","2024-06-17",0,0,0,0,0,0,0,0
"Gibraltar","2024-06-18",0,0,0,0,0,0,0,0
"Gibraltar","2024-06-19",0,0,0,0,0,0,0,0
"Gibraltar","2024-06-20",0,0,0,0,0,0,0,0
"Gibraltar","2024-06-21",0,0,0,0,0,0,0,0
"Gibraltar","2024-06-22",0,0,0,0,0,0,0,0
"Gibraltar","2024-06-23",0,0,0,0,0,0,0,0
"Gibraltar","2024-06-24",0,0,0,0,0,0,0,0
"Gibraltar","2024-06-25",0,0,0,0,0,0,0,0
"Gibraltar","2024-06-26",0,0,0,0,0,0,0,0
"Gibraltar","2024-06-27",0,0,0,0,0,0,0,0
"Gibraltar","2024-06-28",0,0,0,0,0,0,0,0
"Gibraltar","2024-06-29",0,0,0,0,0,0,0,0
"Gibraltar","2024-06-30",0,0,0,0,0,0,0,0
"Gibraltar","2024-07-01",0,0,0,0,0,0,0,0
"Gibraltar","2024-07-02",0,0,0,0,0,0,0,0
"Gibraltar","2024-07-03",0,0,0,0,0,0,0,0
"Gibraltar","2024-07-04",0,0,0,0,0,0,0,0
"Gibraltar","2024-07-05",0,0,0,0,0,0,0,0
"Gibraltar","2024-07-06",0,0,0,0,0,0,0,0
"Gibraltar","2024-07-07",0,0,0,0,0,0,0,0
"Gibraltar","2024-07-08",0,0,0,0,0,0,0,0
"Gibraltar","2024-07-09",0,0,0,0,0,0,0,0
"Gibraltar","2024-07-10",0,0,0,0,0,0,0,0
"Gibraltar","2024-07-11",0,0,0,0,0,0,0,0
"Gibraltar","2024-07-12",0,0,0,0,0,0,0,0
"Gibraltar","2024-07-13",0,0,0,0,0,0,0,0
"Gibraltar","2024-07-14",0,0,0,0,0,0,0,0
"Gibraltar","2024-07-15",0,0,0,0,0,0,0,0
"Gibraltar","2024-07-16",0,0,0,0,0,0,0,0
"Gibraltar","2024-07-17",0,0,0,0,0,0,0,0
"Gibraltar","2024-07-18",0,0,0,0,0,0,0,0
"Gibraltar","2024-07-19",0,0,0,0,0,0,0,0
"Gibraltar","2024-07-20",0,0,0,0,0,0,0,0
"Gibraltar","2024-07-21",0,0,0,0,0,0,0,0
"Gibraltar","2024-07-22",0,0,0,0,0,0,0,0
"Gibraltar","2024-07-23",0,0,0,0,0,0,0,0
"Gibraltar","2024-07-24",0,0,0,0,0,0,0,0
"Gibraltar","2024-07-25",0,0,0,0,0,0,0,0
"Gibraltar","2024-07-26",0,0,0,0,0,0,0,0
"Gibraltar","2024-07-27",0,0,0,0,0,0,0,0
"Gibraltar","2024-07-28",0,0,0,0,0,0,0,0
"Gibraltar","2024-07-29",0,0,0,0,0,0,0,0
"Gibraltar","2024-07-30",0,0,0,0,0,0,0,0
"Gibraltar","2024-07-31",0,0,0,0,0,0,0,0
"Gibraltar","2024-08-01",0,0,0,0,0,0,0,0
"Gibraltar","2024-08-02",0,0,0,0,0,0,0,0
"Gibraltar","2024-08-03",0,0,0,0,0,0,0,0
"Gibraltar","2024-08-04",0,0,0,0,0,0,0,0
"Gibraltar","2024-08-05",0,0,0,0,0,0,0,0
"Gibraltar","2024-08-06",0,0,0,0,0,0,0,0
"Gibraltar","2024-08-07",0,0,0,0,0,0,0,0
"Gibraltar","2024-08-08",0,0,0,0,0,0,0,0
"Gibraltar","2024-08-09",0,0,0,0,0,0,0,0
"Gibraltar","2024-08-10",0,0,0,0,0,0,0,0
"Gibraltar","2024-08-11",0,0,0,0,0,0,0,0
"Gibraltar","2024-08-12",0,0,0,0,0,0,0,0
"Gibraltar","2024-08-13",0,0,0,0,0,0,0,0
"Gibraltar","2024-08-14",0,0,0,0,0,0,0,0
"Gibraltar","2024-08-15",0,0,0,0,0,0,0,0
"Gibraltar","2024-08-16",0,0,0,0,0,0,0,0
"Gibraltar","2024-08-17",0,0,0,0,0,0,0,0
"Gibraltar","2024-08-18",0,0,0,0,0,0,0,0
"Gibraltar","2024-08-19",0,0,0,0,0,0,0,0
"Gibraltar","2024-08-20",0,0,0,0,0,0,0,0
"Gibraltar","2024-08-21",0,0,0,0,0,0,0,0
"Gibraltar","2024-08-22",0,0,0,0,0,0,0,0
"Gibraltar","2024-08-23",0,0,0,0,0,0,0,0
"Gibraltar","2024-08-24",0,0,0,0,0,0,0,0
"Gibraltar","2024-08-25",0,0,0,0,0,0,0,0
"Gibraltar","2024-08-26",0,0,0,0,0,0,0,0
"Gibraltar","2024-08-27",0,0,0,0,0,0,0,0
"Gibraltar","2024-08-28",0,0,0,0,0,0,0,0
"Gibraltar","2024-08-29",0,0,0,0,0,0,0,0
"Gibraltar","2024-08-30",0,0,0,0,0,0,0,0
"Gibraltar","2024-08-31",0,0,0,0,0,0,0,0
"Gibraltar","2024-09-01",0,0,0,0,0,0,0,0
"Gibraltar","2024-09-02",0,0,0,0,0,0,0,0
"Gibraltar","2024-09-03",0,0,0,0,0,0,0,0
"Gibraltar","2024-09-04",0,0,0,0,0,0,0,0
"Gibraltar","2024-09-05",0,0,0,0,0,0,0,0
"Gibraltar","2024-09-06",0,0,0,0,0,0,0,0
"Gibraltar","2024-09-07",0,0,0,0,0,0,0,0
"Gibraltar","2024-09-08",0,0,0,0,0,0,0,0
"Gibraltar","2024-09-09",0,0,0,0,0,0,0,0
"Gibraltar","2024-09-10",0,0,0,0,0,0,0,0
"Gibraltar","2024-09-11",0,0,0,0,0,0,0,0
"Gibraltar","2024-09-12",0,0,0,0,0,0,0,0
"Gibraltar","2024-09-13",0,0,0,0,0,0,0,0
"Gibraltar","2024-09-14",0,0,0,0,0,0,0,0
"Gibraltar","2024-09-15",0,0,0,0,0,0,0,0
"Gibraltar","2024-09-16",0,0,0,0,0,0,0,0
"Gibraltar","2024-09-17",0,0,0,0,0,0,0,0
"Gibraltar","2024-09-18",0,0,0,0,0,0,0,0
"Gibraltar","2024-09-19",0,0,0,0,0,0,0,0
"Gibraltar","2024-09-20",0,0,0,0,0,0,0,0
"Gibraltar","2024-09-21",0,0,0,0,0,0,0,0
"Gibraltar","2024-09-22",0,0,0,0,0,0,0,0
"Gibraltar","2024-09-23",0,0,0,0,0,0,0,0
"Gibraltar","2024-09-24",0,0,0,0,0,0,0,0
"Gibraltar","2024-09-25",0,0,0,0,0,0,0,0
"Gibraltar","2024-09-26",0,0,0,0,0,0,0,0
"Gibraltar","2024-09-27",0,0,0,0,0,0,0,0
"Gibraltar","2024-09-28",0,0,0,0,0,0,0,0
"Gibraltar","2024-09-29",0,0,0,0,0,0,0,0
"Gibraltar","2024-09-30",0,0,0,0,0,0,0,0
"Gibraltar","2024-10-01",0,0,0,0,0,0,0,0
"Gibraltar","2024-10-02",0,0,0,0,0,0,0,0
"Gibraltar","2024-10-03",0,0,0,0,0,0,0,0
"Gibraltar","2024-10-04",0,0,0,0,0,0,0,0
"Gibraltar","2024-10-05",0,0,0,0,0,0,0,0
"Gibraltar","2024-10-06",0,0,0,0,0,0,0,0
"Gibraltar","2024-10-07",0,0,0,0,0,0,0,0
"Gibraltar","2024-10-08",0,0,0,0,0,0,0,0
"Gibraltar","2024-10-09",0,0,0,0,0,0,0,0
"Gibraltar","2024-10-10",0,0,0,0,0,0,0,0
"Gibraltar","2024-10-11",0,0,0,0,0,0,0,0
"Gibraltar","2024-10-12",0,0,0,0,0,0,0,0
"Gibraltar","2024-10-13",0,0,0,0,0,0,0,0
"Gibraltar","2024-10-14",0,0,0,0,0,0,0,0
"Gibraltar","2024-10-15",0,0,0,0,0,0,0,0
"Gibraltar","2024-10-16",0,0,0,0,0,0,0,0
"Gibraltar","2024-10-17",0,0,0,0,0,0,0,0
"Gibraltar","2024-10-18",0,0,0,0,0,0,0,0
"Gibraltar","2024-10-19",0,0,0,0,0,0,0,0
"Gibraltar","2024-10-20",0,0,0,0,0,0,0,0
"Gibraltar","2024-10-21",0,0,0,0,0,0,0,0
"Gibraltar","2024-10-22",0,0,0,0,0,0,0,0
"Gibraltar","2024-10-23",0,0,0,0,0,0,0,0
"Gibraltar","2024-10-24",0,0,0,0,0,0,0,0
"Gibraltar","2024-10-25",0,0,0,0,0,0,0,0
"Gibraltar","2024-10-26",0,0,0,0,0,0,0,0
"Gibraltar","2024-10-27",0,0,0,0,0,0,0,0
"Gibraltar","2024-10-28",0,0,0,0,0,0,0,0
"Gibraltar","2024-10-29",0,0,0,0,0,0,0,0
"Gibraltar","2024-10-30",0,0,0,0,0,0,0,0
"Gibraltar","2024-10-31",0,0,0,0,0,0,0,0
"Gibraltar","2024-11-01",0,0,0,0,0,0,0,0
"Gibraltar","2024-11-02",0,0,0,0,0,0,0,0
"Gibraltar","2024-11-03",0,0,0,0,0,0,0,0
"Gibraltar","2024-11-04",0,0,0,0,0,0,0,0
"Gibraltar","2024-11-05",0,0,0,0,0,0,0,0
"Gibraltar","2024-11-06",0,0,0,0,0,0,0,0
"Gibraltar","2024-11-07",0,0,0,0,0,0,0,0
"Gibraltar","2024-11-08",0,0,0,0,0,0,0,0
"Gibraltar","2024-11-09",0,0,0,0,0,0,0,0
"Gibraltar","2024-11-10",0,0,0,0,0,0,0,0
"Gibraltar","2024-11-11",0,0,0,0,0,0,0,0
"Gibraltar","2024-11-12",0,0,0,0,0,0,0,0
"Gibraltar","2024-11-13",0,0,0,0,0,0,0,0
"Gibraltar","2024-11-14",0,0,0,0,0,0,0,0
"Gibraltar","2024-11-15",0,0,0,0,0,0,0,0
"Gibraltar","2024-11-16",0,0,0,0,0,0,0,0
"Gibraltar","2024-11-17",0,0,0,0,0,0,0,0
"Gibraltar","2024-11-18",0,0,0,0,0,0,0,0
"Gibraltar","2024-11-19",0,0,0,0,0,0,0,0
"Gibraltar","2024-11-20",0,0,0,0,0,0,0,0
"Gibraltar","2024-11-21",0,0,0,0,0,0,0,0
"Gibraltar","2024-11-22",0,0,0,0,0,0,0,0
"Gibraltar","2024-11-23",0,0,0,0,0,0,0,0
"Gibraltar","2024-11-24",0,0,0,0,0,0,0,0
"Gibraltar","2024-11-25",0,0,0,0,0,0,0,0
"Gibraltar","2024-11-26",0,0,0,0,0,0,0,0
"Gibraltar","2024-11-27",0,0,0,0,0,0,0,0
"Gibraltar","2024-11-28",0,0,0,0,0,0,0,0
"Gibraltar","2024-11-29",0,0,0,0,0,0,0,0
"Gibraltar","2024-11-30",0,0,0,0,0,0,0,0
"Gibraltar","2024-12-01",0,0,0,0,0,0,0,0
"Gibraltar","2024-12-02",0,0,0,0,0,0,0,0
"Gibraltar","2024-12-03",0,0,0,0,0,0,0,0
"Gibraltar","2024-12-04",0,0,0,0,0,0,0,0
"Gibraltar","2024-12-05",0,0,0,0,0,0,0,0
"Gibraltar","2024-12-06",0,0,0,0,0,0,0,0
"Gibraltar","2024-12-07",0,0,0,0,0,0,0,0
"Gibraltar","2024-12-08",0,0,0,0,0,0,0,0
"Gibraltar","2024-12-09",0,0,0,0,0,0,0,0
"Gibraltar","2024-12-10",0,0,0,0,0,0,0,0
"Gibraltar","2024-12-11",0,0,0,0,0,0,0,0
"Gibraltar","2024-12-12",0,0,0,0,0,0,0,0
"Gibraltar","2024-12-13",0,0,0,0,0,0,0,0
"Gibraltar","2024-12-14",0,0,0,0,0,0,0,0
"Gibraltar","2024-12-15",0,0,0,0,0,0,0,0
"Gibraltar","2024-12-16",0,0,0,0,0,0,0,0
"Gibraltar","2024-12-17",0,0,0,0,0,0,0,0
"Gibraltar","2024-12-18",0,0,0,0,0,0,0,0
"Gibraltar","2024-12-19",0,0,0,0,0,0,0,0
"Gibraltar","2024-12-20",0,0,0,0,0,0,0,0
"Gibraltar","2024-12-21",0,0,0,0,0,0,0,0
"Gibraltar","2024-12-22",0,0,0,0,0,0,0,0
"Gibraltar","2024-12-23",0,0,0,0,0,0,0,0
"Gibraltar","2024-12-24",0,0,0,0,0,0,0,0
"Gibraltar","2024-12-25",0,0,0,0,0,0,0,0
"Gibraltar","2024-12-26",0,0,0,0,0,0,0,0
"Gibraltar","2024-12-27",0,0,0,0,0,0,0,0
"Gibraltar","2024-12-28",0,0,0,0,0,0,0,0
"Gibraltar","2024-12-29",0,0,0,0,0,0,0,0
"Gibraltar","2024-12-30",0,0,0,0,0,0,0,0
"Gibraltar","2024-12-31",0,0,0,0,0,0,0,0
"Gibraltar","2025-01-01",0,0,0,0,0,0,0,0
"Gibraltar","2025-01-02",0,0,0,0,0,0,0,0
"Gibraltar","2025-01-03",0,0,0,0,0,0,0,0
"Gibraltar","2025-01-04",0,0,0,0,0,0,0,0
"Gibraltar","2025-01-05",0,0,0,0,0,0,0,0
"Gibraltar","2025-01-06",0,0,0,0,0,0,0,0
"Gibraltar","2025-01-07",0,0,0,0,0,0,0,0
"Gibraltar","2025-01-08",0,0,0,0,0,0,0,0
"Gibraltar","2025-01-09",0,0,0,0,0,0,0,0
"Gibraltar","2025-01-10",0,0,0,0,0,0,0,0
"Gibraltar","2025-01-11",0,0,0,0,0,0,0,0
"Gibraltar","2025-01-12",0,0,0,0,0,0,0,0
"Gibraltar","2025-01-13",0,0,0,0,0,0,0,0
"Gibraltar","2025-01-14",0,0,0,0,0,0,0,0
"Gibraltar","2025-01-15",0,0,0,0,0,0,0,0
"Gibraltar","2025-01-16",0,0,0,0,0,0,0,0
"Gibraltar","2025-01-17",0,0,0,0,0,0,0,0
"Gibraltar","2025-01-18",0,0,0,0,0,0,0,0
"Gibraltar","2025-01-19",0,0,0,0,0,0,0,0
"Gibraltar","2025-01-20",0,0,0,0,0,0,0,0
"Gibraltar","2025-01-21",0,0,0,0,0,0,0,0
"Gibraltar","2025-01-22",0,0,0,0,0,0,0,0
"Gibraltar","2025-01-23",0,0,0,0,0,0,0,0
"Gibraltar","2025-01-24",0,0,0,0,0,0,0,0
"Gibraltar","2025-01-25",0,0,0,0,0,0,0,0
"Gibraltar","2025-01-26",0,0,0,0,0,0,0,0
"Gibraltar","2025-01-27",0,0,0,0,0,0,0,0
"Gibraltar","2025-01-28",0,0,0,0,0,0,0,0
"Gibraltar","2025-01-29",0,0,0,0,0,0,0,0
"Gibraltar","2025-01-30",0,0,0,0,0,0,0,0
"Gibraltar","2025-01-31",0,0,0,0,0,0,0,0
"Gibraltar","2025-02-01",0,0,0,0,0,0,0,0
"Gibraltar","2025-02-02",0,0,0,0,0,0,0,0
"Gibraltar","2025-02-03",0,0,0,0,0,0,0,0
"Greece","2024-01-01",0,0,0,0,0,0,0,0
"Greece","2024-01-02",0,0,0,0,0,0,0,0
"Greece","2024-01-03",0,0,0,0,0,0,0,0
"Greece","2024-01-04",0,0,0,0,0,0,0,0
"Greece","2024-01-05",0,0,0,0,0,0,0,0
"Greece","2024-01-06",0,0,0,0,0,0,0,0
"Greece","2024-01-07",0,0,0,0,0,0,0,0
"Greece","2024-01-08",0,0,0,0,0,0,0,0
"Greece","2024-01-09",0,0,0,0,0,0,0,0
"Greece","2024-01-10",0,0,0,0,0,0,0,0
"Greece","2024-01-11",0,0,0,0,0,0,0,0
"Greece","2024-01-12",0,0,0,0,0,0,0,0
"Greece","2024-01-13",0,0,0,0,0,0,0,0
"Greece","2024-01-14",0,0,0,0,0,0,0,0
"Greece","2024-01-15",0,0,0,0,0,0,0,0
"Greece","2024-01-16",0,0,0,0,0,0,0,0
"Greece","2024-01-17",0,0,0,0,0,0,0,0
"Greece","2024-01-18",0,0,0,0,0,0,0,0
"Greece","2024-01-19",0,0,0,0,0,0,0,0
"Greece","2024-01-20",0,0,0,0,0,0,0,0
"Greece","2024-01-21",0,0,0,0,0,0,0,0
"Greece","2024-01-22",0,0,0,0,0,0,0,0
"Greece","2024-01-23",0,0,0,0,0,0,0,0
"Greece","2024-01-24",0,0,0,0,0,0,0,0
"Greece","2024-01-25",0,0,0,0,0,0,0,0
"Greece","2024-01-26",0,0,0,0,0,0,0,0
"Greece","2024-01-27",0,0,0,0,0,0,0,0
"Greece","2024-01-28",0,0,0,0,0,0,0,0
"Greece","2024-01-29",0,0,0,0,0,0,0,0
"Greece","2024-01-30",0,0,0,0,0,0,0,0
"Greece","2024-01-31",0,2,2,0,2,2,0,0
"Greece","2024-02-01",0,0,2,0,0,2,0,0
"Greece","2024-02-02",0,0,2,0,0,2,0,0
"Greece","2024-02-03",0,0,2,0,0,2,0,0
"Greece","2024-02-04",0,0,2,0,0,2,0,0
"Greece","2024-02-05",0,0,2,0,0,2,0,0
"Greece","2024-02-06",0,0,2,0,0,2,0,0
"Greece","2024-02-07",0,0,2,0,0,2,0,0
"Greece","2024-02-08",0,0,2,0,0,2,0,0
"Greece","2024-02-09",0,0,2,0,0,2,0,0
"Greece","2024-02-10",0,0,2,0,0,2,0,0
"Greece","2024-02-11",0,0,2,0,0,2,0,0
"Greece","2024-02-12",0,0,2,0,0,2,0,0
"Greece","2024-02-13",0,0,2,0,0,2,0,0
"Greece","2024-02-14",0,0,2,0,0,2,0,0
"Greece","2024-02-15",0,0,2,0,0,2,0,0
"Greece","2024-02-16",0,0,2,0,0,2,0,0
"Greece","2024-02-17",0,0,2,0,0,2,0,0
"Greece","2024-02-18",0,0,2,0,0,2,0,0
"Greece","2024-02-19",0,0,2,0,0,2,0,0
"Greece","2024-02-20",0,0,2,0,0,2,0,0
"Greece","2024-02-21",0,0,2,0,0,2,0,0
"Greece","2024-02-22",0,0,2,0,0,2,0,0
"Greece","2024-02-23",0,0,2,0,0,2,0,0
"Greece","2024-02-24",0,0,2,0,0,2,0,0
"Greece","2024-02-25",0,0,2,0,0,2,0,0
"Greece","2024-02-26",0,0,2,0,0,2,0,0
"Greece","2024-02-27",0,0,2,0,0,2,0,0
"Greece","2024-02-28",0,0,2,0,0,2,0,0
"Greece","2024-02-29",0,0,2,0,0,2,0,0
"Greece","2024-03-01",0,0,2,0,0,2,0,0
"Greece","2024-03-02",0,0,2,0,1,3,0,0
"Greece","2024-03-03",0,0,2,0,0,3,0,0
"Greece","2024-03-04",0,0,2,0,0,3,0,0
"Greece","2024-03-05",0,0,2,0,0,3,0,0
"Greece","2024-03-06",0,0,2,0,0,3,0,0
"Greece","2024-03-07",0,0,2,0,0,3,0,0
"Greece","2024-03-08",0,0,2,0,0,3,0,0
"Greece","2024-03-09",0,0,2,0,0,3,0,0
"Greece","2024-03-10",0,0,2,0,0,3,0,0
"Greece","2024-03-11",0,0,2,0,0,3,0,0
"Greece","2024-03-12",0,0,2,0,0,3,0,0
"Greece","2024-03-13",0,0,2,0,0,3,0,0
"Greece","2024-03-14",0,0,2,0,0,3,0,0
"Greece","2024-03-15",0,0,2,0,0,3,0,0
"Greece","2024-03-16",0,0,2,0,0,3,0,0
"Greece","2024-03-17",0,0,2,0,0,3,0,0
"Greece","2024-03-18",0,0,2,0,0,3,0,0
"Greece","2024-03-19",0,0,2,0,0,3,0,0
"Greece","2024-03-20",0,0,2,0,0,3,0,0
"Greece","2024-03-21",0,0,2,0,0,3,0,0
"Greece","2024-03-22",0,0,2,0,0,3,0,0
"Greece","2024-03-23",0,0,2,0,0,3,0,0
"Greece","2024-03-24",0,0,2,0,0,3,0,0
"Greece","2024-03-25",0,0,2,0,0,3,0,0
"Greece","2024-03-26",0,0,2,0,0,3,0,0
"Greece","2024-03-27",0,0,2,0,0,3,0,0
"Greece","2024-03-28",0,0,2,0,0,3,0,0
"Greece","2024-03-29",0,0,2,0,0,3,0,0
"Greece","2024-03-30",0,0,2,0,0,3,0,0
"Greece","2024-03-31",0,1,3,0,0,3,0,0
"Greece","2024-04-01",0,0,3,0,0,3,0,0
"Greece","2024-04-02",0,0,3,0,0,3,0,0
"Greece","2024-04-03",0,0,3,0,1,4,0,0
"Greece","2024-04-04",0,0,3,0,0,4,0,0
"Greece","2024-04-05",0,0,3,0,0,4,0,0
"Greece","2024-04-06",0,0,3,0,0,4,0,0
"Greece","2024-04-07",0,0,3,0,0,4,0,0
"Greece","2024-04-08",0,0,3,0,1,5,0,0
"Greece","2024-04-09",0,0,3,0,0,5,0,0
"Greece","2024-04-10",0,0,3,0,0,5,0,0
"Greece","2024-04-11",0,0,3,0,0,5,0,0
"Greece","2024-04-12",0,0,3,0,0,5,0,0
"Greece","2024-04-13",0,0,3,0,1,6,0,0
"Greece","2024-04-14",0,0,3,0,0,6,0,0
"Greece","2024-04-15",0,0,3,0,0,6,0,0
"Greece","2024-04-16",0,0,3,0,0,6,0,0
"Greece","2024-04-17",0,0,3,0,0,6,0,0
"Greece","2024-04-18",0,0,3,0,1,7,0,0
"Greece","2024-04-19",0,0,3,0,0,7,0,0
"Greece","2024-04-20",0,0,3,0,0,7,0,0
"Greece","2024-04-21",0,0,3,0,0,7,0,0
"Greece","2024-04-22",0,0,3,0,0,7,0,0
"Greece","2024-04-23",0,0,3,0,1,8,0,0
"Greece","2024-04-24",0,0,3,0,0,8,0,0
"Greece","2024-04-25",0,0,3,0,0,8,0,0
"Greece","2024-04-26",0,0,3,0,0,8,0,0
"Greece","2024-04-27",0,0,3,0,0,8,0,0
"Greece","2024-04-28",0,0,3,0,1,9,0,0
"Greece","2024-04-29",0,0,3,0,0,9,0,0
"Greece","2024-04-30",0,6,9,0,0,9,0,0
"Greece","2024-05-01",0,0,9,0,0,9,0,0
"Greece","2024-05-02",0,0,9,0,0,9,0,0
"Greece","2024-05-03",0,0,9,0,0,9,0,0
"Greece","2024-05-04",0,0,9,0,0,9,0,0
"Greece","2024-05-05",0,0,9,0,0,9,0,0
"Greece","2024-05-06",0,0,9,0,0,9,0,0
"Greece","2024-05-07",0,0,9,0,0,9,0,0
"Greece","2024-05-08",0,0,9,0,0,9,0,0
"Greece","2024-05-09",0,0,9,0,0,9,0,0
"Greece","2024-05-10",0,0,9,0,0,9,0,0
"Greece","2024-05-11",0,0,9,0,0,9,0,0
"Greece","2024-05-12",0,0,9,0,0,9,0,0
"Greece","2024-05-13",0,0,9,0,0,9,0,0
"Greece","2024-05-14",0,0,9,0,0,9,0,0
"Greece","2024-05-15",0,0,9,0,0,9,0,0
"Greece","2024-05-16",0,0,9,0,1,10,0,0
"Greece","2024-05-17",0,0,9,0,0,10,0,0
"Greece","2024-05-18",0,0,9,0,0,10,0,0
"Greece","2024-05-19",0,0,9,0,0,10,0,0
"Greece","2024-05-20",0,0,9,0,0,10,0,0
"Greece","2024-05-21",0,0,9,0,0,10,0,0
"Greece","2024-05-22",0,0,9,0,0,10,0,0
"Greece","2024-05-23",0,0,9,0,0,10,0,0
"Greece","2024-05-24",0,0,9,0,0,10,0,0
"Greece","2024-05-25",0,0,9,0,0,10,0,0
"Greece","2024-05-26",0,0,9,0,0,10,0,0
"Greece","2024-05-27",0,0,9,0,0,10,0,0
"Greece","2024-05-28",0,0,9,0,0,10,0,0
"Greece","2024-05-29",0,0,9,0,0,10,0,0
"Greece","2024-05-30",0,0,9,0,0,10,0,0
"Greece","2024-05-31",0,1,10,0,0,10,0,0
"Greece","2024-06-01",0,0,10,0,0,10,0,0
"Greece","2024-06-02",0,0,10,0,0,10,0,0
"Greece","2024-06-03",0,0,10,0,0,10,0,0
"Greece","2024-06-04",0,0,10,0,0,10,0,0
"Greece","2024-06-05",0,0,10,0,0,10,0,0
"Greece","2024-06-06",0,0,10,0,0,10,0,0
"Greece","2024-06-07",0,0,10,0,0,10,0,0
"Greece","2024-06-08",0,0,10,0,0,10,0,0
"Greece","2024-06-09",0,0,10,0,0,10,0,0
"Greece","2024-06-10",0,0,10,0,0,10,0,0
"Greece","2024-06-11",0,0,10,0,0,10,0,0
"Greece","2024-06-12",0,0,10,0,0,10,0,0
"Greece","2024-06-13",0,0,10,0,0,10,0,0
"Greece","2024-06-14",0,0,10,0,0,10,0,0
"Greece","2024-06-15",0,0,10,0,0,10,0,0
"Greece","2024-06-16",0,0,10,0,0,10,0,0
"Greece","2024-06-17",0,0,10,0,0,10,0,0
"Greece","2024-06-18",0,0,10,0,0,10,0,0
"Greece","2024-06-19",0,0,10,0,0,10,0,0
"Greece","2024-06-20",0,0,10,0,0,10,0,0
"Greece","2024-06-21",0,0,10,0,1,11,0,0
"Greece","2024-06-22",0,0,10,0,0,11,0,0
"Greece","2024-06-23",0,0,10,0,0,11,0,0
"Greece","2024-06-24",0,0,10,0,0,11,0,0
"Greece","2024-06-25",0,0,10,0,0,11,0,0
"Greece","2024-06-26",0,0,10,0,0,11,0,0
"Greece","2024-06-27",0,0,10,0,0,11,0,0
"Greece","2024-06-28",0,0,10,0,0,11,0,0
"Greece","2024-06-29",0,0,10,0,0,11,0,0
"Greece","2024-06-30",0,0,10,0,0,11,0,0
"Greece","2024-07-01",0,0,10,0,0,11,0,0
"Greece","2024-07-02",0,0,10,0,0,11,0,0
"Greece","2024-07-03",0,0,10,0,0,11,0,0
"Greece","2024-07-04",0,0,10,0,0,11,0,0
"Greece","2024-07-05",0,0,10,0,0,11,0,0
"Greece","2024-07-06",0,0,10,0,0,11,0,0
"Greece","2024-07-07",0,0,10,0,0,11,0,0
"Greece","2024-07-08",0,0,10,0,0,11,0,0
"Greece","2024-07-09",0,0,10,0,0,11,0,0
"Greece","2024-07-10",0,0,10,0,0,11,0,0
"Greece","2024-07-11",0,0,10,0,0,11,0,0
"Greece","2024-07-12",0,0,10,0,0,11,0,0
"Greece","2024-07-13",0,0,10,0,0,11,0,0
"Greece","2024-07-14",0,0,10,0,0,11,0,0
"Greece","2024-07-15",0,0,10,0,0,11,0,0
"Greece","2024-07-16",0,0,10,0,0,11,0,0
"Greece","2024-07-17",0,0,10,0,0,11,0,0
"Greece","2024-07-18",0,0,10,0,0,11,0,0
"Greece","2024-07-19",0,0,10,0,0,11,0,0
"Greece","2024-07-20",0,0,10,0,0,11,0,0
"Greece","2024-07-21",0,0,10,0,0,11,0,0
"Greece","2024-07-22",0,0,10,0,0,11,0,0
"Greece","2024-07-23",0,0,10,0,0,11,0,0
"Greece","2024-07-24",0,0,10,0,0,11,0,0
"Greece","2024-07-25",0,0,10,0,0,11,0,0
"Greece","2024-07-26",0,0,10,0,0,11,0,0
"Greece","2024-07-27",0,0,10,0,0,11,0,0
"Greece","2024-07-28",0,0,10,0,0,11,0,0
"Greece","2024-07-29",0,0,10,0,0,11,0,0
"Greece","2024-07-30",0,0,10,0,0,11,0,0
"Greece","2024-07-31",0,0,10,0,1,12,0,0
"Greece","2024-08-01",0,0,10,0,0,12,0,0
"Greece","2024-08-02",0,0,10,0,0,12,0,0
"Greece","2024-08-03",0,0,10,0,0,12,0,0
"Greece","2024-08-04",0,0,10,0,0,12,0,0
"Greece","2024-08-05",0,0,10,0,0,12,0,0
"Greece","2024-08-06",0,0,10,0,0,12,0,0
"Greece","2024-08-07",0,0,10,0,0,12,0,0
"Greece","2024-08-08",0,0,10,0,0,12,0,0
"Greece","2024-08-09",0,0,10,0,0,12,0,0
"Greece","2024-08-10",0,0,10,0,0,12,0,0
"Greece","2024-08-11",0,0,10,0,0,12,0,0
"Greece","2024-08-12",0,0,10,0,0,12,0,0
"Greece","2024-08-13",0,0,10,0,0,12,0,0
"Greece","2024-08-14",0,0,10,0,0,12,0,0
"Greece","2024-08-15",0,0,10,0,0,12,0,0
"Greece","2024-08-16",0,0,10,0,0,12,0,0
"Greece","2024-08-17",0,0,10,0,0,12,0,0
"Greece","2024-08-18",0,0,10,0,0,12,0,0
"Greece","2024-08-19",0,0,10,0,0,12,0,0
"Greece","2024-08-20",0,0,10,0,0,12,0,0
"Greece","2024-08-21",0,0,10,0,0,12,0,0
"Greece","2024-08-22",0,0,10,0,0,12,0,0
"Greece","2024-08-23",0,0,10,0,0,12,0,0
"Greece","2024-08-24",0,0,10,0,0,12,0,0
"Greece","2024-08-25",0,0,10,0,0,12,0,0
"Greece","2024-08-26",0,0,10,0,0,12,0,0
"Greece","2024-08-27",0,0,10,0,0,12,0,0
"Greece","2024-08-28",0,0,10,0,0,12,0,0
"Greece","2024-08-29",0,0,10,0,0,12,0,0
"Greece","2024-08-30",0,0,10,0,0,12,0,0
"Greece","2024-08-31",0,0,10,0,0,12,0,0
"Greece","2024-09-01",0,0,10,0,0,12,0,0
"Greece","2024-09-02",0,0,10,0,0,12,0,0
"Greece","2024-09-03",0,0,10,0,0,12,0,0
"Greece","2024-09-04",0,0,10,0,0,12,0,0
"Greece","2024-09-05",0,0,10,0,0,12,0,0
"Greece","2024-09-06",0,0,10,0,0,12,0,0
"Greece","2024-09-07",0,0,10,0,0,12,0,0
"Greece","2024-09-08",0,0,10,0,0,12,0,0
"Greece","2024-09-09",0,0,10,0,0,12,0,0
"Greece","2024-09-10",0,0,10,0,1,13,0,0
"Greece","2024-09-11",0,0,10,0,0,13,0,0
"Greece","2024-09-12",0,0,10,0,0,13,0,0
"Greece","2024-09-13",0,0,10,0,0,13,0,0
"Greece","2024-09-14",0,0,10,0,0,13,0,0
"Greece","2024-09-15",0,0,10,0,0,13,0,0
"Greece","2024-09-16",0,0,10,0,0,13,0,0
"Greece","2024-09-17",0,0,10,0,0,13,0,0
"Greece","2024-09-18",0,0,10,0,0,13,0,0
"Greece","2024-09-19",0,0,10,0,0,13,0,0
"Greece","2024-09-20",0,0,10,0,0,13,0,0
"Greece","2024-09-21",0,0,10,0,0,13,0,0
"Greece","2024-09-22",0,0,10,0,0,13,0,0
"Greece","2024-09-23",0,0,10,0,0,13,0,0
"Greece","2024-09-24",0,0,10,0,0,13,0,0
"Greece","2024-09-25",0,0,10,0,0,13,0,0
"Greece","2024-09-26",0,0,10,0,0,13,0,0
"Greece","2024-09-27",0,0,10,0,0,13,0,0
"Greece","2024-09-28",0,0,10,0,0,13,0,0
"Greece","2024-09-29",0,0,10,0,0,13,0,0
"Greece","2024-09-30",0,3,13,0,0,13,0,0
"Greece","2024-10-01",0,0,13,0,0,13,0,0
"Greece","2024-10-02",0,0,13,0,0,13,0,0
"Greece","2024-10-03",0,0,13,0,0,13,0,0
"Greece","2024-10-04",0,0,13,0,0,13,0,0
"Greece","2024-10-05",0,0,13,0,0,13,0,0
"Greece","2024-10-06",0,0,13,0,0,13,0,0
"Greece","2024-10-07",0,0,13,0,1,14,0,0
"Greece","2024-10-08",0,0,13,0,0,14,0,0
"Greece","2024-10-09",0,0,13,0,0,14,0,0
"Greece","2024-10-10",0,0,13,0,0,14,0,0
"Greece","2024-10-11",0,0,13,0,0,14,0,0
"Greece","2024-10-12",0,0,13,0,0,14,0,0
"Greece","2024-10-13",0,0,13,0,0,14,0,0
"Greece","2024-10-14",0,0,13,0,0,14,0,0
"Greece","2024-10-15",0,0,13,0,0,14,0,0
"Greece","2024-10-16",0,0,13,0,0,14,0,0
"Greece","2024-10-17",0,0,13,0,0,14,0,0
"Greece","2024-10-18",0,0,13,0,0,14,0,0
"Greece","2024-10-19",0,0,13,0,1,15,0,0
"Greece","2024-10-20",0,0,13,0,0,15,0,0
"Greece","2024-10-21",0,0,13,0,0,15,0,0
"Greece","2024-10-22",0,0,13,0,0,15,0,0
"Greece","2024-10-23",0,0,13,0,0,15,0,0
"Greece","2024-10-24",0,0,13,0,0,15,0,0
"Greece","2024-10-25",0,0,13,0,0,15,0,0
"Greece","2024-10-26",0,0,13,0,0,15,0,0
"Greece","2024-10-27",0,0,13,0,0,15,0,0
"Greece","2024-10-28",0,0,13,0,0,15,0,0
"Greece","2024-10-29",0,0,13,0,0,15,0,0
"Greece","2024-10-30",0,0,13,0,0,15,0,0
"Greece","2024-10-31",0,0,13,0,1,16,0,0
"Greece","2024-11-01",0,0,13,0,0,16,0,0
"Greece","2024-11-02",0,0,13,0,0,16,0,0
"Greece","2024-11-03",0,0,13,0,0,16,0,0
"Greece","2024-11-04",0,0,13,0,0,16,0,0
"Greece","2024-11-05",0,0,13,0,0,16,0,0
"Greece","2024-11-06",0,0,13,0,0,16,0,0
"Greece","2024-11-07",0,0,13,0,0,16,0,0
"Greece","2024-11-08",0,0,13,0,0,16,0,0
"Greece","2024-11-09",0,0,13,0,0,16,0,0
"Greece","2024-11-10",0,0,13,0,0,16,0,0
"Greece","2024-11-11",0,0,13,0,0,16,0,0
"Greece","2024-11-12",0,0,13,0,1,17,0,0
"Greece","2024-11-13",0,0,13,0,0,17,0,0
"Greece","2024-11-14",0,0,13,0,0,17,0,0
"Greece","2024-11-15",0,0,13,0,0,17,0,0
"Greece","2024-11-16",0,0,13,0,0,17,0,0
"Greece","2024-11-17",0,0,13,0,0,17,0,0
"Greece","2024-11-18",0,0,13,0,0,17,0,0
"Greece","2024-11-19",0,0,13,0,0,17,0,0
"Greece","2024-11-20",0,0,13,0,0,17,0,0
"Greece","2024-11-21",0,0,13,0,0,17,0,0
"Greece","2024-11-22",0,0,13,0,0,17,0,0
"Greece","2024-11-23",0,0,13,0,0,17,0,0
"Greece","2024-11-24",0,0,13,0,1,18,0,0
"Greece","2024-11-25",0,0,13,0,0,18,0,0
"Greece","2024-11-26",0,0,13,0,0,18,0,0
"Greece","2024-11-27",0,0,13,0,0,18,0,0
"Greece","2024-11-28",0,0,13,0,0,18,0,0
"Greece","2024-11-29",0,0,13,0,0,18,0,0
"Greece","2024-11-30",0,5,18,0,0,18,0,0
"Greece","2024-12-01",0,0,18,0,1,19,0,0
"Greece","2024-12-02",0,0,18,0,0,19,0,0
"Greece","2024-12-03",0,0,18,0,1,20,0,0
"Greece","2024-12-04",0,0,18,0,1,21,0,0
"Greece","2024-12-05",0,0,18,0,1,22,0,0
"Greece","2024-12-06",0,0,18,0,0,22,0,0
"Greece","2024-12-07",0,0,18,0,1,23,0,0
"Greece","2024-12-08",0,0,18,0,1,24,0,0
"Greece","2024-12-09",0,0,18,0,0,24,0,0
"Greece","2024-12-10",0,0,18,0,1,25,0,0
"Greece","2024-12-11",0,0,18,0,1,26,0,0
"Greece","2024-12-12",0,0,18,0,1,27,0,0
"Greece","2024-12-13",0,0,18,0,0,27,0,0
"Greece","2024-12-14",0,0,18,0,1,28,0,0
"Greece","2024-12-15",0,0,18,0,1,29,0,0
"Greece","2024-12-16",0,0,18,0,0,29,0,0
"Greece","2024-12-17",0,0,18,0,1,30,0,0
"Greece","2024-12-18",0,0,18,0,1,31,0,0
"Greece","2024-12-19",0,0,18,0,0,31,0,0
"Greece","2024-12-20",0,0,18,0,1,32,0,0
"Greece","2024-12-21",0,0,18,0,1,33,0,0
"Greece","2024-12-22",0,0,18,0,1,34,0,0
"Greece","2024-12-23",0,0,18,0,0,34,0,0
"Greece","2024-12-24",0,0,18,0,1,35,0,0
"Greece","2024-12-25",0,0,18,0,1,36,0,0
"Greece","2024-12-26",0,0,18,0,0,36,0,0
"Greece","2024-12-27",0,0,18,0,1,37,0,0
"Greece","2024-12-28",0,0,18,0,1,38,0,0
"Greece","2024-12-29",0,0,18,0,1,39,0,0
"Greece","2024-12-30",0,0,18,0,0,39,0,0
"Greece","2024-12-31",0,22,40,0,1,40,0,0
"Greece","2025-01-01",0,0,40,0,0,40,0,0
"Greece","2025-01-02",0,0,40,0,0,40,0,0
"Greece","2025-01-03",0,0,40,0,0,40,0,0
"Greece","2025-01-04",0,0,40,0,0,40,0,0
"Greece","2025-01-05",0,0,40,0,0,40,0,0
"Greece","2025-01-06",0,0,40,0,0,40,0,0
"Greece","2025-01-07",0,0,40,0,0,40,0,0
"Greece","2025-01-08",0,0,40,0,0,40,0,0
"Greece","2025-01-09",0,0,40,0,0,40,0,0
"Greece","2025-01-10",0,0,40,0,0,40,0,0
"Greece","2025-01-11",0,0,40,0,0,40,0,0
"Greece","2025-01-12",0,0,40,0,0,40,0,0
"Greece","2025-01-13",0,0,40,0,0,40,0,0
"Greece","2025-01-14",0,0,40,0,0,40,0,0
"Greece","2025-01-15",0,0,40,0,0,40,0,0
"Greece","2025-01-16",0,0,40,0,0,40,0,0
"Greece","2025-01-17",0,0,40,0,0,40,0,0
"Greece","2025-01-18",0,0,40,0,0,40,0,0
"Greece","2025-01-19",0,0,40,0,0,40,0,0
"Greece","2025-01-20",0,0,40,0,0,40,0,0
"Greece","2025-01-21",0,0,40,0,0,40,0,0
"Greece","2025-01-22",0,0,40,0,0,40,0,0
"Greece","2025-01-23",0,0,40,0,0,40,0,0
"Greece","2025-01-24",0,0,40,0,0,40,0,0
"Greece","2025-01-25",0,0,40,0,0,40,0,0
"Greece","2025-01-26",0,0,40,0,0,40,0,0
"Greece","2025-01-27",0,0,40,0,0,40,0,0
"Greece","2025-01-28",0,0,40,0,0,40,0,0
"Greece","2025-01-29",0,0,40,0,0,40,0,0
"Greece","2025-01-30",0,0,40,0,0,40,0,0
"Greece","2025-01-31",0,0,40,0,0,40,0,0
"Greece","2025-02-01",0,0,40,0,0,40,0,0
"Greece","2025-02-02",0,0,40,0,0,40,0,0
"Greece","2025-02-03",0,0,40,0,0,40,0,0
"Greenland","2024-01-01",0,0,0,0,0,0,0,0
"Greenland","2024-01-02",0,0,0,0,0,0,0,0
"Greenland","2024-01-03",0,0,0,0,0,0,0,0
"Greenland","2024-01-04",0,0,0,0,0,0,0,0
"Greenland","2024-01-05",0,0,0,0,0,0,0,0
"Greenland","2024-01-06",0,0,0,0,0,0,0,0
"Greenland","2024-01-07",0,0,0,0,0,0,0,0
"Greenland","2024-01-08",0,0,0,0,0,0,0,0
"Greenland","2024-01-09",0,0,0,0,0,0,0,0
"Greenland","2024-01-10",0,0,0,0,0,0,0,0
"Greenland","2024-01-11",0,0,0,0,0,0,0,0
"Greenland","2024-01-12",0,0,0,0,0,0,0,0
"Greenland","2024-01-13",0,0,0,0,0,0,0,0
"Greenland","2024-01-14",0,0,0,0,0,0,0,0
"Greenland","2024-01-15",0,0,0,0,0,0,0,0
"Greenland","2024-01-16",0,0,0,0,0,0,0,0
"Greenland","2024-01-17",0,0,0,0,0,0,0,0
"Greenland","2024-01-18",0,0,0,0,0,0,0,0
"Greenland","2024-01-19",0,0,0,0,0,0,0,0
"Greenland","2024-01-20",0,0,0,0,0,0,0,0
"Greenland","2024-01-21",0,0,0,0,0,0,0,0
"Greenland","2024-01-22",0,0,0,0,0,0,0,0
"Greenland","2024-01-23",0,0,0,0,0,0,0,0
"Greenland","2024-01-24",0,0,0,0,0,0,0,0
"Greenland","2024-01-25",0,0,0,0,0,0,0,0
"Greenland","2024-01-26",0,0,0,0,0,0,0,0
"Greenland","2024-01-27",0,0,0,0,0,0,0,0
"Greenland","2024-01-28",0,0,0,0,0,0,0,0
"Greenland","2024-01-29",0,0,0,0,0,0,0,0
"Greenland","2024-01-30",0,0,0,0,0,0,0,0
"Greenland","2024-01-31",0,0,0,0,0,0,0,0
"Greenland","2024-02-01",0,0,0,0,0,0,0,0
"Greenland","2024-02-02",0,0,0,0,0,0,0,0
"Greenland","2024-02-03",0,0,0,0,0,0,0,0
"Greenland","2024-02-04",0,0,0,0,0,0,0,0
"Greenland","2024-02-05",0,0,0,0,0,0,0,0
"Greenland","2024-02-06",0,0,0,0,0,0,0,0
"Greenland","2024-02-07",0,0,0,0,0,0,0,0
"Greenland","2024-02-08",0,0,0,0,0,0,0,0
"Greenland","2024-02-09",0,0,0,0,0,0,0,0
"Greenland","2024-02-10",0,0,0,0,0,0,0,0
"Greenland","2024-02-11",0,0,0,0,0,0,0,0
"Greenland","2024-02-12",0,0,0,0,0,0,0,0
"Greenland","2024-02-13",0,0,0,0,0,0,0,0
"Greenland","2024-02-14",0,0,0,0,0,0,0,0
"Greenland","2024-02-15",0,0,0,0,0,0,0,0
"Greenland","2024-02-16",0,0,0,0,0,0,0,0
"Greenland","2024-02-17",0,0,0,0,0,0,0,0
"Greenland","2024-02-18",0,0,0,0,0,0,0,0
"Greenland","2024-02-19",0,0,0,0,0,0,0,0
"Greenland","2024-02-20",0,0,0,0,0,0,0,0
"Greenland","2024-02-21",0,0,0,0,0,0,0,0
"Greenland","2024-02-22",0,0,0,0,0,0,0,0
"Greenland","2024-02-23",0,0,0,0,0,0,0,0
"Greenland","2024-02-24",0,0,0,0,0,0,0,0
"Greenland","2024-02-25",0,0,0,0,0,0,0,0
"Greenland","2024-02-26",0,0,0,0,0,0,0,0
"Greenland","2024-02-27",0,0,0,0,0,0,0,0
"Greenland","2024-02-28",0,0,0,0,0,0,0,0
"Greenland","2024-02-29",0,0,0,0,0,0,0,0
"Greenland","2024-03-01",0,0,0,0,0,0,0,0
"Greenland","2024-03-02",0,0,0,0,0,0,0,0
"Greenland","2024-03-03",0,0,0,0,0,0,0,0
"Greenland","2024-03-04",0,0,0,0,0,0,0,0
"Greenland","2024-03-05",0,0,0,0,0,0,0,0
"Greenland","2024-03-06",0,0,0,0,0,0,0,0
"Greenland","2024-03-07",0,0,0,0,0,0,0,0
"Greenland","2024-03-08",0,0,0,0,0,0,0,0
"Greenland","2024-03-09",0,0,0,0,0,0,0,0
"Greenland","2024-03-10",0,0,0,0,0,0,0,0
"Greenland","2024-03-11",0,0,0,0,0,0,0,0
"Greenland","2024-03-12",0,0,0,0,0,0,0,0
"Greenland","2024-03-13",0,0,0,0,0,0,0,0
"Greenland","2024-03-14",0,0,0,0,0,0,0,0
"Greenland","2024-03-15",0,0,0,0,0,0,0,0
"Greenland","2024-03-16",0,0,0,0,0,0,0,0
"Greenland","2024-03-17",0,0,0,0,0,0,0,0
"Greenland","2024-03-18",0,0,0,0,0,0,0,0
"Greenland","2024-03-19",0,0,0,0,0,0,0,0
"Greenland","2024-03-20",0,0,0,0,0,0,0,0
"Greenland","2024-03-21",0,0,0,0,0,0,0,0
"Greenland","2024-03-22",0,0,0,0,0,0,0,0
"Greenland","2024-03-23",0,0,0,0,0,0,0,0
"Greenland","2024-03-24",0,0,0,0,0,0,0,0
"Greenland","2024-03-25",0,0,0,0,0,0,0,0
"Greenland","2024-03-26",0,0,0,0,0,0,0,0
"Greenland","2024-03-27",0,0,0,0,0,0,0,0
"Greenland","2024-03-28",0,0,0,0,0,0,0,0
"Greenland","2024-03-29",0,0,0,0,0,0,0,0
"Greenland","2024-03-30",0,0,0,0,0,0,0,0
"Greenland","2024-03-31",0,0,0,0,0,0,0,0
"Greenland","2024-04-01",0,0,0,0,0,0,0,0
"Greenland","2024-04-02",0,0,0,0,0,0,0,0
"Greenland","2024-04-03",0,0,0,0,0,0,0,0
"Greenland","2024-04-04",0,0,0,0,0,0,0,0
"Greenland","2024-04-05",0,0,0,0,0,0,0,0
"Greenland","2024-04-06",0,0,0,0,0,0,0,0
"Greenland","2024-04-07",0,0,0,0,0,0,0,0
"Greenland","2024-04-08",0,0,0,0,0,0,0,0
"Greenland","2024-04-09",0,0,0,0,0,0,0,0
"Greenland","2024-04-10",0,0,0,0,0,0,0,0
"Greenland","2024-04-11",0,0,0,0,0,0,0,0
"Greenland","2024-04-12",0,0,0,0,0,0,0,0
"Greenland","2024-04-13",0,0,0,0,0,0,0,0
"Greenland","2024-04-14",0,0,0,0,0,0,0,0
"Greenland","2024-04-15",0,0,0,0,0,0,0,0
"Greenland","2024-04-16",0,0,0,0,0,0,0,0
"Greenland","2024-04-17",0,0,0,0,0,0,0,0
"Greenland","2024-04-18",0,0,0,0,0,0,0,0
"Greenland","2024-04-19",0,0,0,0,0,0,0,0
"Greenland","2024-04-20",0,0,0,0,0,0,0,0
"Greenland","2024-04-21",0,0,0,0,0,0,0,0
"Greenland","2024-04-22",0,0,0,0,0,0,0,0
"Greenland","2024-04-23",0,0,0,0,0,0,0,0
"Greenland","2024-04-24",0,0,0,0,0,0,0,0
"Greenland","2024-04-25",0,0,0,0,0,0,0,0
"Greenland","2024-04-26",0,0,0,0,0,0,0,0
"Greenland","2024-04-27",0,0,0,0,0,0,0,0
"Greenland","2024-04-28",0,0,0,0,0,0,0,0
"Greenland","2024-04-29",0,0,0,0,0,0,0,0
"Greenland","2024-04-30",0,0,0,0,0,0,0,0
"Greenland","2024-05-01",0,0,0,0,0,0,0,0
"Greenland","2024-05-02",0,0,0,0,0,0,0,0
"Greenland","2024-05-03",0,0,0,0,0,0,0,0
"Greenland","2024-05-04",0,0,0,0,0,0,0,0
"Greenland","2024-05-05",0,0,0,0,0,0,0,0
"Greenland","2024-05-06",0,0,0,0,0,0,0,0
"Greenland","2024-05-07",0,0,0,0,0,0,0,0
"Greenland","2024-05-08",0,0,0,0,0,0,0,0
"Greenland","2024-05-09",0,0,0,0,0,0,0,0
"Greenland","2024-05-10",0,0,0,0,0,0,0,0
"Greenland","2024-05-11",0,0,0,0,0,0,0,0
"Greenland","2024-05-12",0,0,0,0,0,0,0,0
"Greenland","2024-05-13",0,0,0,0,0,0,0,0
"Greenland","2024-05-14",0,0,0,0,0,0,0,0
"Greenland","2024-05-15",0,0,0,0,0,0,0,0
"Greenland","2024-05-16",0,0,0,0,0,0,0,0
"Greenland","2024-05-17",0,0,0,0,0,0,0,0
"Greenland","2024-05-18",0,0,0,0,0,0,0,0
"Greenland","2024-05-19",0,0,0,0,0,0,0,0
"Greenland","2024-05-20",0,0,0,0,0,0,0,0
"Greenland","2024-05-21",0,0,0,0,0,0,0,0
"Greenland","2024-05-22",0,0,0,0,0,0,0,0
"Greenland","2024-05-23",0,0,0,0,0,0,0,0
"Greenland","2024-05-24",0,0,0,0,0,0,0,0
"Greenland","2024-05-25",0,0,0,0,0,0,0,0
"Greenland","2024-05-26",0,0,0,0,0,0,0,0
"Greenland","2024-05-27",0,0,0,0,0,0,0,0
"Greenland","2024-05-28",0,0,0,0,0,0,0,0
"Greenland","2024-05-29",0,0,0,0,0,0,0,0
"Greenland","2024-05-30",0,0,0,0,0,0,0,0
"Greenland","2024-05-31",0,0,0,0,0,0,0,0
"Greenland","2024-06-01",0,0,0,0,0,0,0,0
"Greenland","2024-06-02",0,0,0,0,0,0,0,0
"Greenland","2024-06-03",0,0,0,0,0,0,0,0
"Greenland","2024-06-04",0,0,0,0,0,0,0,0
"Greenland","2024-06-05",0,0,0,0,0,0,0,0
"Greenland","2024-06-06",0,0,0,0,0,0,0,0
"Greenland","2024-06-07",0,0,0,0,0,0,0,0
"Greenland","2024-06-08",0,0,0,0,0,0,0,0
"Greenland","2024-06-09",0,0,0,0,0,0,0,0
"Greenland","2024-06-10",0,0,0,0,0,0,0,0
"Greenland","2024-06-11",0,0,0,0,0,0,0,0
"Greenland","2024-06-12",0,0,0,0,0,0,0,0
"Greenland","2024-06-13",0,0,0,0,0,0,0,0
"Greenland","2024-06-14",0,0,0,0,0,0,0,0
"Greenland","2024-06-15",0,0,0,0,0,0,0,0
"Greenland","2024-06-16",0,0,0,0,0,0,0,0
"Greenland","2024-06-17",0,0,0,0,0,0,0,0
"Greenland","2024-06-18",0,0,0,0,0,0,0,0
"Greenland","2024-06-19",0,0,0,0,0,0,0,0
"Greenland","2024-06-20",0,0,0,0,0,0,0,0
"Greenland","2024-06-21",0,0,0,0,0,0,0,0
"Greenland","2024-06-22",0,0,0,0,0,0,0,0
"Greenland","2024-06-23",0,0,0,0,0,0,0,0
"Greenland","2024-06-24",0,0,0,0,0,0,0,0
"Greenland","2024-06-25",0,0,0,0,0,0,0,0
"Greenland","2024-06-26",0,0,0,0,0,0,0,0
"Greenland","2024-06-27",0,0,0,0,0,0,0,0
"Greenland","2024-06-28",0,0,0,0,0,0,0,0
"Greenland","2024-06-29",0,0,0,0,0,0,0,0
"Greenland","2024-06-30",0,0,0,0,0,0,0,0
"Greenland","2024-07-01",0,0,0,0,0,0,0,0
"Greenland","2024-07-02",0,0,0,0,0,0,0,0
"Greenland","2024-07-03",0,0,0,0,0,0,0,0
"Greenland","2024-07-04",0,0,0,0,0,0,0,0
"Greenland","2024-07-05",0,0,0,0,0,0,0,0
"Greenland","2024-07-06",0,0,0,0,0,0,0,0
"Greenland","2024-07-07",0,0,0,0,0,0,0,0
"Greenland","2024-07-08",0,0,0,0,0,0,0,0
"Greenland","2024-07-09",0,0,0,0,0,0,0,0
"Greenland","2024-07-10",0,0,0,0,0,0,0,0
"Greenland","2024-07-11",0,0,0,0,0,0,0,0
"Greenland","2024-07-12",0,0,0,0,0,0,0,0
"Greenland","2024-07-13",0,0,0,0,0,0,0,0
"Greenland","2024-07-14",0,0,0,0,0,0,0,0
"Greenland","2024-07-15",0,0,0,0,0,0,0,0
"Greenland","2024-07-16",0,0,0,0,0,0,0,0
"Greenland","2024-07-17",0,0,0,0,0,0,0,0
"Greenland","2024-07-18",0,0,0,0,0,0,0,0
"Greenland","2024-07-19",0,0,0,0,0,0,0,0
"Greenland","2024-07-20",0,0,0,0,0,0,0,0
"Greenland","2024-07-21",0,0,0,0,0,0,0,0
"Greenland","2024-07-22",0,0,0,0,0,0,0,0
"Greenland","2024-07-23",0,0,0,0,0,0,0,0
"Greenland","2024-07-24",0,0,0,0,0,0,0,0
"Greenland","2024-07-25",0,0,0,0,0,0,0,0
"Greenland","2024-07-26",0,0,0,0,0,0,0,0
"Greenland","2024-07-27",0,0,0,0,0,0,0,0
"Greenland","2024-07-28",0,0,0,0,0,0,0,0
"Greenland","2024-07-29",0,0,0,0,0,0,0,0
"Greenland","2024-07-30",0,0,0,0,0,0,0,0
"Greenland","2024-07-31",0,0,0,0,0,0,0,0
"Greenland","2024-08-01",0,0,0,0,0,0,0,0
"Greenland","2024-08-02",0,0,0,0,0,0,0,0
"Greenland","2024-08-03",0,0,0,0,0,0,0,0
"Greenland","2024-08-04",0,0,0,0,0,0,0,0
"Greenland","2024-08-05",0,0,0,0,0,0,0,0
"Greenland","2024-08-06",0,0,0,0,0,0,0,0
"Greenland","2024-08-07",0,0,0,0,0,0,0,0
"Greenland","2024-08-08",0,0,0,0,0,0,0,0
"Greenland","2024-08-09",0,0,0,0,0,0,0,0
"Greenland","2024-08-10",0,0,0,0,0,0,0,0
"Greenland","2024-08-11",0,0,0,0,0,0,0,0
"Greenland","2024-08-12",0,0,0,0,0,0,0,0
"Greenland","2024-08-13",0,0,0,0,0,0,0,0
"Greenland","2024-08-14",0,0,0,0,0,0,0,0
"Greenland","2024-08-15",0,0,0,0,0,0,0,0
"Greenland","2024-08-16",0,0,0,0,0,0,0,0
"Greenland","2024-08-17",0,0,0,0,0,0,0,0
"Greenland","2024-08-18",0,0,0,0,0,0,0,0
"Greenland","2024-08-19",0,0,0,0,0,0,0,0
"Greenland","2024-08-20",0,0,0,0,0,0,0,0
"Greenland","2024-08-21",0,0,0,0,0,0,0,0
"Greenland","2024-08-22",0,0,0,0,0,0,0,0
"Greenland","2024-08-23",0,0,0,0,0,0,0,0
"Greenland","2024-08-24",0,0,0,0,0,0,0,0
"Greenland","2024-08-25",0,0,0,0,0,0,0,0
"Greenland","2024-08-26",0,0,0,0,0,0,0,0
"Greenland","2024-08-27",0,0,0,0,0,0,0,0
"Greenland","2024-08-28",0,0,0,0,0,0,0,0
"Greenland","2024-08-29",0,0,0,0,0,0,0,0
"Greenland","2024-08-30",0,0,0,0,0,0,0,0
"Greenland","2024-08-31",0,0,0,0,0,0,0,0
"Greenland","2024-09-01",0,0,0,0,0,0,0,0
"Greenland","2024-09-02",0,0,0,0,0,0,0,0
"Greenland","2024-09-03",0,0,0,0,0,0,0,0
"Greenland","2024-09-04",0,0,0,0,0,0,0,0
"Greenland","2024-09-05",0,0,0,0,0,0,0,0
"Greenland","2024-09-06",0,0,0,0,0,0,0,0
"Greenland","2024-09-07",0,0,0,0,0,0,0,0
"Greenland","2024-09-08",0,0,0,0,0,0,0,0
"Greenland","2024-09-09",0,0,0,0,0,0,0,0
"Greenland","2024-09-10",0,0,0,0,0,0,0,0
"Greenland","2024-09-11",0,0,0,0,0,0,0,0
"Greenland","2024-09-12",0,0,0,0,0,0,0,0
"Greenland","2024-09-13",0,0,0,0,0,0,0,0
"Greenland","2024-09-14",0,0,0,0,0,0,0,0
"Greenland","2024-09-15",0,0,0,0,0,0,0,0
"Greenland","2024-09-16",0,0,0,0,0,0,0,0
"Greenland","2024-09-17",0,0,0,0,0,0,0,0
"Greenland","2024-09-18",0,0,0,0,0,0,0,0
"Greenland","2024-09-19",0,0,0,0,0,0,0,0
"Greenland","2024-09-20",0,0,0,0,0,0,0,0
"Greenland","2024-09-21",0,0,0,0,0,0,0,0
"Greenland","2024-09-22",0,0,0,0,0,0,0,0
"Greenland","2024-09-23",0,0,0,0,0,0,0,0
"Greenland","2024-09-24",0,0,0,0,0,0,0,0
"Greenland","2024-09-25",0,0,0,0,0,0,0,0
"Greenland","2024-09-26",0,0,0,0,0,0,0,0
"Greenland","2024-09-27",0,0,0,0,0,0,0,0
"Greenland","2024-09-28",0,0,0,0,0,0,0,0
"Greenland","2024-09-29",0,0,0,0,0,0,0,0
"Greenland","2024-09-30",0,0,0,0,0,0,0,0
"Greenland","2024-10-01",0,0,0,0,0,0,0,0
"Greenland","2024-10-02",0,0,0,0,0,0,0,0
"Greenland","2024-10-03",0,0,0,0,0,0,0,0
"Greenland","2024-10-04",0,0,0,0,0,0,0,0
"Greenland","2024-10-05",0,0,0,0,0,0,0,0
"Greenland","2024-10-06",0,0,0,0,0,0,0,0
"Greenland","2024-10-07",0,0,0,0,0,0,0,0
"Greenland","2024-10-08",0,0,0,0,0,0,0,0
"Greenland","2024-10-09",0,0,0,0,0,0,0,0
"Greenland","2024-10-10",0,0,0,0,0,0,0,0
"Greenland","2024-10-11",0,0,0,0,0,0,0,0
"Greenland","2024-10-12",0,0,0,0,0,0,0,0
"Greenland","2024-10-13",0,0,0,0,0,0,0,0
"Greenland","2024-10-14",0,0,0,0,0,0,0,0
"Greenland","2024-10-15",0,0,0,0,0,0,0,0
"Greenland","2024-10-16",0,0,0,0,0,0,0,0
"Greenland","2024-10-17",0,0,0,0,0,0,0,0
"Greenland","2024-10-18",0,0,0,0,0,0,0,0
"Greenland","2024-10-19",0,0,0,0,0,0,0,0
"Greenland","2024-10-20",0,0,0,0,0,0,0,0
"Greenland","2024-10-21",0,0,0,0,0,0,0,0
"Greenland","2024-10-22",0,0,0,0,0,0,0,0
"Greenland","2024-10-23",0,0,0,0,0,0,0,0
"Greenland","2024-10-24",0,0,0,0,0,0,0,0
"Greenland","2024-10-25",0,0,0,0,0,0,0,0
"Greenland","2024-10-26",0,0,0,0,0,0,0,0
"Greenland","2024-10-27",0,0,0,0,0,0,0,0
"Greenland","2024-10-28",0,0,0,0,0,0,0,0
"Greenland","2024-10-29",0,0,0,0,0,0,0,0
"Greenland","2024-10-30",0,0,0,0,0,0,0,0
"Greenland","2024-10-31",0,0,0,0,0,0,0,0
"Greenland","2024-11-01",0,0,0,0,0,0,0,0
"Greenland","2024-11-02",0,0,0,0,0,0,0,0
"Greenland","2024-11-03",0,0,0,0,0,0,0,0
"Greenland","2024-11-04",0,0,0,0,0,0,0,0
"Greenland","2024-11-05",0,0,0,0,0,0,0,0
"Greenland","2024-11-06",0,0,0,0,0,0,0,0
"Greenland","2024-11-07",0,0,0,0,0,0,0,0
"Greenland","2024-11-08",0,0,0,0,0,0,0,0
"Greenland","2024-11-09",0,0,0,0,0,0,0,0
"Greenland","2024-11-10",0,0,0,0,0,0,0,0
"Greenland","2024-11-11",0,0,0,0,0,0,0,0
"Greenland","2024-11-12",0,0,0,0,0,0,0,0
"Greenland","2024-11-13",0,0,0,0,0,0,0,0
"Greenland","2024-11-14",0,0,0,0,0,0,0,0
"Greenland","2024-11-15",0,0,0,0,0,0,0,0
"Greenland","2024-11-16",0,0,0,0,0,0,0,0
"Greenland","2024-11-17",0,0,0,0,0,0,0,0
"Greenland","2024-11-18",0,0,0,0,0,0,0,0
"Greenland","2024-11-19",0,0,0,0,0,0,0,0
"Greenland","2024-11-20",0,0,0,0,0,0,0,0
"Greenland","2024-11-21",0,0,0,0,0,0,0,0
"Greenland","2024-11-22",0,0,0,0,0,0,0,0
"Greenland","2024-11-23",0,0,0,0,0,0,0,0
"Greenland","2024-11-24",0,0,0,0,0,0,0,0
"Greenland","2024-11-25",0,0,0,0,0,0,0,0
"Greenland","2024-11-26",0,0,0,0,0,0,0,0
"Greenland","2024-11-27",0,0,0,0,0,0,0,0
"Greenland","2024-11-28",0,0,0,0,0,0,0,0
"Greenland","2024-11-29",0,0,0,0,0,0,0,0
"Greenland","2024-11-30",0,0,0,0,0,0,0,0
"Greenland","2024-12-01",0,0,0,0,0,0,0,0
"Greenland","2024-12-02",0,0,0,0,0,0,0,0
"Greenland","2024-12-03",0,0,0,0,0,0,0,0
"Greenland","2024-12-04",0,0,0,0,0,0,0,0
"Greenland","2024-12-05",0,0,0,0,0,0,0,0
"Greenland","2024-12-06",0,0,0,0,0,0,0,0
"Greenland","2024-12-07",0,0,0,0,0,0,0,0
"Greenland","2024-12-08",0,0,0,0,0,0,0,0
"Greenland","2024-12-09",0,0,0,0,0,0,0,0
"Greenland","2024-12-10",0,0,0,0,0,0,0,0
"Greenland","2024-12-11",0,0,0,0,0,0,0,0
"Greenland","2024-12-12",0,0,0,0,0,0,0,0
"Greenland","2024-12-13",0,0,0,0,0,0,0,0
"Greenland","2024-12-14",0,0,0,0,0,0,0,0
"Greenland","2024-12-15",0,0,0,0,0,0,0,0
"Greenland","2024-12-16",0,0,0,0,0,0,0,0
"Greenland","2024-12-17",0,0,0,0,0,0,0,0
"Greenland","2024-12-18",0,0,0,0,0,0,0,0
"Greenland","2024-12-19",0,0,0,0,0,0,0,0
"Greenland","2024-12-20",0,0,0,0,0,0,0,0
"Greenland","2024-12-21",0,0,0,0,0,0,0,0
"Greenland","2024-12-22",0,0,0,0,0,0,0,0
"Greenland","2024-12-23",0,0,0,0,0,0,0,0
"Greenland","2024-12-24",0,0,0,0,0,0,0,0
"Greenland","2024-12-25",0,0,0,0,0,0,0,0
"Greenland","2024-12-26",0,0,0,0,0,0,0,0
"Greenland","2024-12-27",0,0,0,0,0,0,0,0
"Greenland","2024-12-28",0,0,0,0,0,0,0,0
"Greenland","2024-12-29",0,0,0,0,0,0,0,0
"Greenland","2024-12-30",0,0,0,0,0,0,0,0
"Greenland","2024-12-31",0,0,0,0,0,0,0,0
"Greenland","2025-01-01",0,0,0,0,0,0,0,0
"Greenland","2025-01-02",0,0,0,0,0,0,0,0
"Greenland","2025-01-03",0,0,0,0,0,0,0,0
"Greenland","2025-01-04",0,0,0,0,0,0,0,0
"Greenland","2025-01-05",0,0,0,0,0,0,0,0
"Greenland","2025-01-06",0,0,0,0,0,0,0,0
"Greenland","2025-01-07",0,0,0,0,0,0,0,0
"Greenland","2025-01-08",0,0,0,0,0,0,0,0
"Greenland","2025-01-09",0,0,0,0,0,0,0,0
"Greenland","2025-01-10",0,0,0,0,0,0,0,0
"Greenland","2025-01-11",0,0,0,0,0,0,0,0
"Greenland","2025-01-12",0,0,0,0,0,0,0,0
"Greenland","2025-01-13",0,0,0,0,0,0,0,0
"Greenland","2025-01-14",0,0,0,0,0,0,0,0
"Greenland","2025-01-15",0,0,0,0,0,0,0,0
"Greenland","2025-01-16",0,0,0,0,0,0,0,0
"Greenland","2025-01-17",0,0,0,0,0,0,0,0
"Greenland","2025-01-18",0,0,0,0,0,0,0,0
"Greenland","2025-01-19",0,0,0,0,0,0,0,0
"Greenland","2025-01-20",0,0,0,0,0,0,0,0
"Greenland","2025-01-21",0,0,0,0,0,0,0,0
"Greenland","2025-01-22",0,0,0,0,0,0,0,0
"Greenland","2025-01-23",0,0,0,0,0,0,0,0
"Greenland","2025-01-24",0,0,0,0,0,0,0,0
"Greenland","2025-01-25",0,0,0,0,0,0,0,0
"Greenland","2025-01-26",0,0,0,0,0,0,0,0
"Greenland","2025-01-27",0,0,0,0,0,0,0,0
"Greenland","2025-01-28",0,0,0,0,0,0,0,0
"Greenland","2025-01-29",0,0,0,0,0,0,0,0
"Greenland","2025-01-30",0,0,0,0,0,0,0,0
"Greenland","2025-01-31",0,0,0,0,0,0,0,0
"Greenland","2025-02-01",0,0,0,0,0,0,0,0
"Greenland","2025-02-02",0,0,0,0,0,0,0,0
"Greenland","2025-02-03",0,0,0,0,0,0,0,0
"Guadeloupe","2024-01-01",0,0,0,0,0,0,0,0
"Guadeloupe","2024-01-02",0,0,0,0,0,0,0,0
"Guadeloupe","2024-01-03",0,0,0,0,0,0,0,0
"Guadeloupe","2024-01-04",0,0,0,0,0,0,0,0
"Guadeloupe","2024-01-05",0,0,0,0,0,0,0,0
"Guadeloupe","2024-01-06",0,0,0,0,0,0,0,0
"Guadeloupe","2024-01-07",0,0,0,0,0,0,0,0
"Guadeloupe","2024-01-08",0,0,0,0,0,0,0,0
"Guadeloupe","2024-01-09",0,0,0,0,0,0,0,0
"Guadeloupe","2024-01-10",0,0,0,0,0,0,0,0
"Guadeloupe","2024-01-11",0,0,0,0,0,0,0,0
"Guadeloupe","2024-01-12",0,0,0,0,0,0,0,0
"Guadeloupe","2024-01-13",0,0,0,0,0,0,0,0
"Guadeloupe","2024-01-14",0,0,0,0,0,0,0,0
"Guadeloupe","2024-01-15",0,0,0,0,0,0,0,0
"Guadeloupe","2024-01-16",0,0,0,0,0,0,0,0
"Guadeloupe","2024-01-17",0,0,0,0,0,0,0,0
"Guadeloupe","2024-01-18",0,0,0,0,0,0,0,0
"Guadeloupe","2024-01-19",0,0,0,0,0,0,0,0
"Guadeloupe","2024-01-20",0,0,0,0,0,0,0,0
"Guadeloupe","2024-01-21",0,0,0,0,0,0,0,0
"Guadeloupe","2024-01-22",0,0,0,0,0,0,0,0
"Guadeloupe","2024-01-23",0,0,0,0,0,0,0,0
"Guadeloupe","2024-01-24",0,0,0,0,0,0,0,0
"Guadeloupe","2024-01-25",0,0,0,0,0,0,0,0
"Guadeloupe","2024-01-26",0,0,0,0,0,0,0,0
"Guadeloupe","2024-01-27",0,0,0,0,0,0,0,0
"Guadeloupe","2024-01-28",0,0,0,0,0,0,0,0
"Guadeloupe","2024-01-29",0,0,0,0,0,0,0,0
"Guadeloupe","2024-01-30",0,0,0,0,0,0,0,0
"Guadeloupe","2024-01-31",0,0,0,0,0,0,0,0
"Guadeloupe","2024-02-01",0,0,0,0,0,0,0,0
"Guadeloupe","2024-02-02",0,0,0,0,0,0,0,0
"Guadeloupe","2024-02-03",0,0,0,0,0,0,0,0
"Guadeloupe","2024-02-04",0,0,0,0,0,0,0,0
"Guadeloupe","2024-02-05",0,0,0,0,0,0,0,0
"Guadeloupe","2024-02-06",0,0,0,0,0,0,0,0
"Guadeloupe","2024-02-07",0,0,0,0,0,0,0,0
"Guadeloupe","2024-02-08",0,0,0,0,0,0,0,0
"Guadeloupe","2024-02-09",0,0,0,0,0,0,0,0
"Guadeloupe","2024-02-10",0,0,0,0,0,0,0,0
"Guadeloupe","2024-02-11",0,0,0,0,0,0,0,0
"Guadeloupe","2024-02-12",0,0,0,0,0,0,0,0
"Guadeloupe","2024-02-13",0,0,0,0,0,0,0,0
"Guadeloupe","2024-02-14",0,0,0,0,0,0,0,0
"Guadeloupe","2024-02-15",0,0,0,0,0,0,0,0
"Guadeloupe","2024-02-16",0,0,0,0,0,0,0,0
"Guadeloupe","2024-02-17",0,0,0,0,0,0,0,0
"Guadeloupe","2024-02-18",0,0,0,0,0,0,0,0
"Guadeloupe","2024-02-19",0,0,0,0,0,0,0,0
"Guadeloupe","2024-02-20",0,0,0,0,0,0,0,0
"Guadeloupe","2024-02-21",0,0,0,0,0,0,0,0
"Guadeloupe","2024-02-22",0,0,0,0,0,0,0,0
"Guadeloupe","2024-02-23",0,0,0,0,0,0,0,0
"Guadeloupe","2024-02-24",0,0,0,0,0,0,0,0
"Guadeloupe","2024-02-25",0,0,0,0,0,0,0,0
"Guadeloupe","2024-02-26",0,0,0,0,0,0,0,0
"Guadeloupe","2024-02-27",0,0,0,0,0,0,0,0
"Guadeloupe","2024-02-28",0,0,0,0,0,0,0,0
"Guadeloupe","2024-02-29",0,0,0,0,0,0,0,0
"Guadeloupe","2024-03-01",0,0,0,0,0,0,0,0
"Guadeloupe","2024-03-02",0,0,0,0,0,0,0,0
"Guadeloupe","2024-03-03",0,0,0,0,0,0,0,0
"Guadeloupe","2024-03-04",0,0,0,0,0,0,0,0
"Guadeloupe","2024-03-05",0,0,0,0,0,0,0,0
"Guadeloupe","2024-03-06",0,0,0,0,0,0,0,0
"Guadeloupe","2024-03-07",0,0,0,0,0,0,0,0
"Guadeloupe","2024-03-08",0,0,0,0,0,0,0,0
"Guadeloupe","2024-03-09",0,0,0,0,0,0,0,0
"Guadeloupe","2024-03-10",0,0,0,0,0,0,0,0
"Guadeloupe","2024-03-11",0,0,0,0,0,0,0,0
"Guadeloupe","2024-03-12",0,0,0,0,0,0,0,0
"Guadeloupe","2024-03-13",0,0,0,0,0,0,0,0
"Guadeloupe","2024-03-14",0,0,0,0,0,0,0,0
"Guadeloupe","2024-03-15",0,0,0,0,0,0,0,0
"Guadeloupe","2024-03-16",0,0,0,0,0,0,0,0
"Guadeloupe","2024-03-17",0,0,0,0,0,0,0,0
"Guadeloupe","2024-03-18",0,0,0,0,0,0,0,0
"Guadeloupe","2024-03-19",0,0,0,0,0,0,0,0
"Guadeloupe","2024-03-20",0,0,0,0,0,0,0,0
"Guadeloupe","2024-03-21",0,0,0,0,0,0,0,0
"Guadeloupe","2024-03-22",0,0,0,0,0,0,0,0
"Guadeloupe","2024-03-23",0,0,0,0,0,0,0,0
"Guadeloupe","2024-03-24",0,0,0,0,0,0,0,0
"Guadeloupe","2024-03-25",0,0,0,0,0,0,0,0
"Guadeloupe","2024-03-26",0,0,0,0,0,0,0,0
"Guadeloupe","2024-03-27",0,0,0,0,0,0,0,0
"Guadeloupe","2024-03-28",0,0,0,0,0,0,0,0
"Guadeloupe","2024-03-29",0,0,0,0,0,0,0,0
"Guadeloupe","2024-03-30",0,0,0,0,0,0,0,0
"Guadeloupe","2024-03-31",0,0,0,0,0,0,0,0
"Guadeloupe","2024-04-01",0,0,0,0,0,0,0,0
"Guadeloupe","2024-04-02",0,0,0,0,0,0,0,0
"Guadeloupe","2024-04-03",0,0,0,0,0,0,0,0
"Guadeloupe","2024-04-04",0,0,0,0,0,0,0,0
"Guadeloupe","2024-04-05",0,0,0,0,0,0,0,0
"Guadeloupe","2024-04-06",0,0,0,0,0,0,0,0
"Guadeloupe","2024-04-07",0,0,0,0,0,0,0,0
"Guadeloupe","2024-04-08",0,0,0,0,0,0,0,0
"Guadeloupe","2024-04-09",0,0,0,0,0,0,0,0
"Guadeloupe","2024-04-10",0,0,0,0,0,0,0,0
"Guadeloupe","2024-04-11",0,0,0,0,0,0,0,0
"Guadeloupe","2024-04-12",0,0,0,0,0,0,0,0
"Guadeloupe","2024-04-13",0,0,0,0,0,0,0,0
"Guadeloupe","2024-04-14",0,0,0,0,0,0,0,0
"Guadeloupe","2024-04-15",0,0,0,0,0,0,0,0
"Guadeloupe","2024-04-16",0,0,0,0,0,0,0,0
"Guadeloupe","2024-04-17",0,0,0,0,0,0,0,0
"Guadeloupe","2024-04-18",0,0,0,0,0,0,0,0
"Guadeloupe","2024-04-19",0,0,0,0,0,0,0,0
"Guadeloupe","2024-04-20",0,0,0,0,0,0,0,0
"Guadeloupe","2024-04-21",0,0,0,0,0,0,0,0
"Guadeloupe","2024-04-22",0,0,0,0,0,0,0,0
"Guadeloupe","2024-04-23",0,0,0,0,0,0,0,0
"Guadeloupe","2024-04-24",0,0,0,0,0,0,0,0
"Guadeloupe","2024-04-25",0,0,0,0,0,0,0,0
"Guadeloupe","2024-04-26",0,0,0,0,0,0,0,0
"Guadeloupe","2024-04-27",0,0,0,0,0,0,0,0
"Guadeloupe","2024-04-28",0,0,0,0,0,0,0,0
"Guadeloupe","2024-04-29",0,0,0,0,0,0,0,0
"Guadeloupe","2024-04-30",0,0,0,0,0,0,0,0
"Guadeloupe","2024-05-01",0,0,0,0,0,0,0,0
"Guadeloupe","2024-05-02",0,0,0,0,0,0,0,0
"Guadeloupe","2024-05-03",0,0,0,0,0,0,0,0
"Guadeloupe","2024-05-04",0,0,0,0,0,0,0,0
"Guadeloupe","2024-05-05",0,0,0,0,0,0,0,0
"Guadeloupe","2024-05-06",0,0,0,0,0,0,0,0
"Guadeloupe","2024-05-07",0,0,0,0,0,0,0,0
"Guadeloupe","2024-05-08",0,0,0,0,0,0,0,0
"Guadeloupe","2024-05-09",0,0,0,0,0,0,0,0
"Guadeloupe","2024-05-10",0,0,0,0,0,0,0,0
"Guadeloupe","2024-05-11",0,0,0,0,0,0,0,0
"Guadeloupe","2024-05-12",0,0,0,0,0,0,0,0
"Guadeloupe","2024-05-13",0,0,0,0,0,0,0,0
"Guadeloupe","2024-05-14",0,0,0,0,0,0,0,0
"Guadeloupe","2024-05-15",0,0,0,0,0,0,0,0
"Guadeloupe","2024-05-16",0,0,0,0,0,0,0,0
"Guadeloupe","2024-05-17",0,0,0,0,0,0,0,0
"Guadeloupe","2024-05-18",0,0,0,0,0,0,0,0
"Guadeloupe","2024-05-19",0,0,0,0,0,0,0,0
"Guadeloupe","2024-05-20",0,0,0,0,0,0,0,0
"Guadeloupe","2024-05-21",0,0,0,0,0,0,0,0
"Guadeloupe","2024-05-22",0,0,0,0,0,0,0,0
"Guadeloupe","2024-05-23",0,0,0,0,0,0,0,0
"Guadeloupe","2024-05-24",0,0,0,0,0,0,0,0
"Guadeloupe","2024-05-25",0,0,0,0,0,0,0,0
"Guadeloupe","2024-05-26",0,0,0,0,0,0,0,0
"Guadeloupe","2024-05-27",0,0,0,0,0,0,0,0
"Guadeloupe","2024-05-28",0,0,0,0,0,0,0,0
"Guadeloupe","2024-05-29",0,0,0,0,0,0,0,0
"Guadeloupe","2024-05-30",0,0,0,0,0,0,0,0
"Guadeloupe","2024-05-31",0,0,0,0,0,0,0,0
"Guadeloupe","2024-06-01",0,0,0,0,0,0,0,0
"Guadeloupe","2024-06-02",0,0,0,0,0,0,0,0
"Guadeloupe","2024-06-03",0,0,0,0,0,0,0,0
"Guadeloupe","2024-06-04",0,0,0,0,0,0,0,0
"Guadeloupe","2024-06-05",0,0,0,0,0,0,0,0
"Guadeloupe","2024-06-06",0,0,0,0,0,0,0,0
"Guadeloupe","2024-06-07",0,0,0,0,0,0,0,0
"Guadeloupe","2024-06-08",0,0,0,0,0,0,0,0
"Guadeloupe","2024-06-09",0,0,0,0,0,0,0,0
"Guadeloupe","2024-06-10",0,0,0,0,0,0,0,0
"Guadeloupe","2024-06-11",0,0,0,0,0,0,0,0
"Guadeloupe","2024-06-12",0,0,0,0,0,0,0,0
"Guadeloupe","2024-06-13",0,0,0,0,0,0,0,0
"Guadeloupe","2024-06-14",0,0,0,0,0,0,0,0
"Guadeloupe","2024-06-15",0,0,0,0,0,0,0,0
"Guadeloupe","2024-06-16",0,0,0,0,0,0,0,0
"Guadeloupe","2024-06-17",0,0,0,0,0,0,0,0
"Guadeloupe","2024-06-18",0,0,0,0,0,0,0,0
"Guadeloupe","2024-06-19",0,0,0,0,0,0,0,0
"Guadeloupe","2024-06-20",0,0,0,0,0,0,0,0
"Guadeloupe","2024-06-21",0,0,0,0,0,0,0,0
"Guadeloupe","2024-06-22",0,0,0,0,0,0,0,0
"Guadeloupe","2024-06-23",0,0,0,0,0,0,0,0
"Guadeloupe","2024-06-24",0,0,0,0,0,0,0,0
"Guadeloupe","2024-06-25",0,0,0,0,0,0,0,0
"Guadeloupe","2024-06-26",0,0,0,0,0,0,0,0
"Guadeloupe","2024-06-27",0,0,0,0,0,0,0,0
"Guadeloupe","2024-06-28",0,0,0,0,0,0,0,0
"Guadeloupe","2024-06-29",0,0,0,0,0,0,0,0
"Guadeloupe","2024-06-30",0,0,0,0,0,0,0,0
"Guadeloupe","2024-07-01",0,0,0,0,0,0,0,0
"Guadeloupe","2024-07-02",0,0,0,0,0,0,0,0
"Guadeloupe","2024-07-03",0,0,0,0,0,0,0,0
"Guadeloupe","2024-07-04",0,0,0,0,0,0,0,0
"Guadeloupe","2024-07-05",0,0,0,0,0,0,0,0
"Guadeloupe","2024-07-06",0,0,0,0,0,0,0,0
"Guadeloupe","2024-07-07",0,0,0,0,0,0,0,0
"Guadeloupe","2024-07-08",0,0,0,0,0,0,0,0
"Guadeloupe","2024-07-09",0,0,0,0,0,0,0,0
"Guadeloupe","2024-07-10",0,0,0,0,0,0,0,0
"Guadeloupe","2024-07-11",0,0,0,0,0,0,0,0
"Guadeloupe","2024-07-12",0,0,0,0,0,0,0,0
"Guadeloupe","2024-07-13",0,0,0,0,0,0,0,0
"Guadeloupe","2024-07-14",0,0,0,0,0,0,0,0
"Guadeloupe","2024-07-15",0,0,0,0,0,0,0,0
"Guadeloupe","2024-07-16",0,0,0,0,0,0,0,0
"Guadeloupe","2024-07-17",0,0,0,0,0,0,0,0
"Guadeloupe","2024-07-18",0,0,0,0,0,0,0,0
"Guadeloupe","2024-07-19",0,0,0,0,0,0,0,0
"Guadeloupe","2024-07-20",0,0,0,0,0,0,0,0
"Guadeloupe","2024-07-21",0,0,0,0,0,0,0,0
"Guadeloupe","2024-07-22",0,0,0,0,0,0,0,0
"Guadeloupe","2024-07-23",0,0,0,0,0,0,0,0
"Guadeloupe","2024-07-24",0,0,0,0,0,0,0,0
"Guadeloupe","2024-07-25",0,0,0,0,0,0,0,0
"Guadeloupe","2024-07-26",0,0,0,0,0,0,0,0
"Guadeloupe","2024-07-27",0,0,0,0,0,0,0,0
"Guadeloupe","2024-07-28",0,0,0,0,0,0,0,0
"Guadeloupe","2024-07-29",0,0,0,0,0,0,0,0
"Guadeloupe","2024-07-30",0,0,0,0,0,0,0,0
"Guadeloupe","2024-07-31",0,0,0,0,0,0,0,0
"Guadeloupe","2024-08-01",0,0,0,0,0,0,0,0
"Guadeloupe","2024-08-02",0,0,0,0,0,0,0,0
"Guadeloupe","2024-08-03",0,0,0,0,0,0,0,0
"Guadeloupe","2024-08-04",0,0,0,0,0,0,0,0
"Guadeloupe","2024-08-05",0,0,0,0,0,0,0,0
"Guadeloupe","2024-08-06",0,0,0,0,0,0,0,0
"Guadeloupe","2024-08-07",0,0,0,0,0,0,0,0
"Guadeloupe","2024-08-08",0,0,0,0,0,0,0,0
"Guadeloupe","2024-08-09",0,0,0,0,0,0,0,0
"Guadeloupe","2024-08-10",0,0,0,0,0,0,0,0
"Guadeloupe","2024-08-11",0,0,0,0,0,0,0,0
"Guadeloupe","2024-08-12",0,0,0,0,0,0,0,0
"Guadeloupe","2024-08-13",0,0,0,0,0,0,0,0
"Guadeloupe","2024-08-14",0,0,0,0,0,0,0,0
"Guadeloupe","2024-08-15",0,0,0,0,0,0,0,0
"Guadeloupe","2024-08-16",0,0,0,0,0,0,0,0
"Guadeloupe","2024-08-17",0,0,0,0,0,0,0,0
"Guadeloupe","2024-08-18",0,0,0,0,0,0,0,0
"Guadeloupe","2024-08-19",0,0,0,0,0,0,0,0
"Guadeloupe","2024-08-20",0,0,0,0,0,0,0,0
"Guadeloupe","2024-08-21",0,0,0,0,0,0,0,0
"Guadeloupe","2024-08-22",0,0,0,0,0,0,0,0
"Guadeloupe","2024-08-23",0,0,0,0,0,0,0,0
"Guadeloupe","2024-08-24",0,0,0,0,0,0,0,0
"Guadeloupe","2024-08-25",0,0,0,0,0,0,0,0
"Guadeloupe","2024-08-26",0,0,0,0,0,0,0,0
"Guadeloupe","2024-08-27",0,0,0,0,0,0,0,0
"Guadeloupe","2024-08-28",0,0,0,0,0,0,0,0
"Guadeloupe","2024-08-29",0,0,0,0,0,0,0,0
"Guadeloupe","2024-08-30",0,0,0,0,0,0,0,0
"Guadeloupe","2024-08-31",0,0,0,0,0,0,0,0
"Guadeloupe","2024-09-01",0,0,0,0,0,0,0,0
"Guadeloupe","2024-09-02",0,0,0,0,0,0,0,0
"Guadeloupe","2024-09-03",0,0,0,0,0,0,0,0
"Guadeloupe","2024-09-04",0,0,0,0,0,0,0,0
"Guadeloupe","2024-09-05",0,0,0,0,0,0,0,0
"Guadeloupe","2024-09-06",0,0,0,0,0,0,0,0
"Guadeloupe","2024-09-07",0,0,0,0,0,0,0,0
"Guadeloupe","2024-09-08",0,0,0,0,0,0,0,0
"Guadeloupe","2024-09-09",0,0,0,0,0,0,0,0
"Guadeloupe","2024-09-10",0,0,0,0,0,0,0,0
"Guadeloupe","2024-09-11",0,0,0,0,0,0,0,0
"Guadeloupe","2024-09-12",0,0,0,0,0,0,0,0
"Guadeloupe","2024-09-13",0,0,0,0,0,0,0,0
"Guadeloupe","2024-09-14",0,0,0,0,0,0,0,0
"Guadeloupe","2024-09-15",0,0,0,0,0,0,0,0
"Guadeloupe","2024-09-16",0,0,0,0,0,0,0,0
"Guadeloupe","2024-09-17",0,0,0,0,0,0,0,0
"Guadeloupe","2024-09-18",0,0,0,0,0,0,0,0
"Guadeloupe","2024-09-19",0,0,0,0,0,0,0,0
"Guadeloupe","2024-09-20",0,0,0,0,0,0,0,0
"Guadeloupe","2024-09-21",0,0,0,0,0,0,0,0
"Guadeloupe","2024-09-22",0,0,0,0,0,0,0,0
"Guadeloupe","2024-09-23",0,0,0,0,0,0,0,0
"Guadeloupe","2024-09-24",0,0,0,0,0,0,0,0
"Guadeloupe","2024-09-25",0,0,0,0,0,0,0,0
"Guadeloupe","2024-09-26",0,0,0,0,0,0,0,0
"Guadeloupe","2024-09-27",0,0,0,0,0,0,0,0
"Guadeloupe","2024-09-28",0,0,0,0,0,0,0,0
"Guadeloupe","2024-09-29",0,0,0,0,0,0,0,0
"Guadeloupe","2024-09-30",0,0,0,0,0,0,0,0
"Guadeloupe","2024-10-01",0,0,0,0,0,0,0,0
"Guadeloupe","2024-10-02",0,0,0,0,0,0,0,0
"Guadeloupe","2024-10-03",0,0,0,0,0,0,0,0
"Guadeloupe","2024-10-04",0,0,0,0,0,0,0,0
"Guadeloupe","2024-10-05",0,0,0,0,0,0,0,0
"Guadeloupe","2024-10-06",0,0,0,0,0,0,0,0
"Guadeloupe","2024-10-07",0,0,0,0,0,0,0,0
"Guadeloupe","2024-10-08",0,0,0,0,0,0,0,0
"Guadeloupe","2024-10-09",0,0,0,0,0,0,0,0
"Guadeloupe","2024-10-10",0,0,0,0,0,0,0,0
"Guadeloupe","2024-10-11",0,0,0,0,0,0,0,0
"Guadeloupe","2024-10-12",0,0,0,0,0,0,0,0
"Guadeloupe","2024-10-13",0,0,0,0,0,0,0,0
"Guadeloupe","2024-10-14",0,0,0,0,0,0,0,0
"Guadeloupe","2024-10-15",0,0,0,0,0,0,0,0
"Guadeloupe","2024-10-16",0,0,0,0,0,0,0,0
"Guadeloupe","2024-10-17",0,0,0,0,0,0,0,0
"Guadeloupe","2024-10-18",0,0,0,0,0,0,0,0
"Guadeloupe","2024-10-19",0,0,0,0,0,0,0,0
"Guadeloupe","2024-10-20",0,0,0,0,0,0,0,0
"Guadeloupe","2024-10-21",0,0,0,0,0,0,0,0
"Guadeloupe","2024-10-22",0,0,0,0,0,0,0,0
"Guadeloupe","2024-10-23",0,0,0,0,0,0,0,0
"Guadeloupe","2024-10-24",0,0,0,0,0,0,0,0
"Guadeloupe","2024-10-25",0,0,0,0,0,0,0,0
"Guadeloupe","2024-10-26",0,0,0,0,0,0,0,0
"Guadeloupe","2024-10-27",0,0,0,0,0,0,0,0
"Guadeloupe","2024-10-28",0,0,0,0,0,0,0,0
"Guadeloupe","2024-10-29",0,0,0,0,0,0,0,0
"Guadeloupe","2024-10-30",0,0,0,0,0,0,0,0
"Guadeloupe","2024-10-31",0,0,0,0,0,0,0,0
"Guadeloupe","2024-11-01",0,0,0,0,0,0,0,0
"Guadeloupe","2024-11-02",0,0,0,0,0,0,0,0
"Guadeloupe","2024-11-03",0,0,0,0,0,0,0,0
"Guadeloupe","2024-11-04",0,0,0,0,0,0,0,0
"Guadeloupe","2024-11-05",0,0,0,0,0,0,0,0
"Guadeloupe","2024-11-06",0,0,0,0,0,0,0,0
"Guadeloupe","2024-11-07",0,0,0,0,0,0,0,0
"Guadeloupe","2024-11-08",0,0,0,0,0,0,0,0
"Guadeloupe","2024-11-09",0,0,0,0,0,0,0,0
"Guadeloupe","2024-11-10",0,0,0,0,0,0,0,0
"Guadeloupe","2024-11-11",0,0,0,0,0,0,0,0
"Guadeloupe","2024-11-12",0,0,0,0,0,0,0,0
"Guadeloupe","2024-11-13",0,0,0,0,0,0,0,0
"Guadeloupe","2024-11-14",0,0,0,0,0,0,0,0
"Guadeloupe","2024-11-15",0,0,0,0,0,0,0,0
"Guadeloupe","2024-11-16",0,0,0,0,0,0,0,0
"Guadeloupe","2024-11-17",0,0,0,0,0,0,0,0
"Guadeloupe","2024-11-18",0,0,0,0,0,0,0,0
"Guadeloupe","2024-11-19",0,0,0,0,0,0,0,0
"Guadeloupe","2024-11-20",0,0,0,0,0,0,0,0
"Guadeloupe","2024-11-21",0,0,0,0,0,0,0,0
"Guadeloupe","2024-11-22",0,0,0,0,0,0,0,0
"Guadeloupe","2024-11-23",0,0,0,0,0,0,0,0
"Guadeloupe","2024-11-24",0,0,0,0,0,0,0,0
"Guadeloupe","2024-11-25",0,0,0,0,0,0,0,0
"Guadeloupe","2024-11-26",0,0,0,0,0,0,0,0
"Guadeloupe","2024-11-27",0,0,0,0,0,0,0,0
"Guadeloupe","2024-11-28",0,0,0,0,0,0,0,0
"Guadeloupe","2024-11-29",0,0,0,0,0,0,0,0
"Guadeloupe","2024-11-30",0,0,0,0,0,0,0,0
"Guadeloupe","2024-12-01",0,0,0,0,0,0,0,0
"Guadeloupe","2024-12-02",0,0,0,0,0,0,0,0
"Guadeloupe","2024-12-03",0,0,0,0,0,0,0,0
"Guadeloupe","2024-12-04",0,0,0,0,0,0,0,0
"Guadeloupe","2024-12-05",0,0,0,0,0,0,0,0
"Guadeloupe","2024-12-06",0,0,0,0,0,0,0,0
"Guadeloupe","2024-12-07",0,0,0,0,0,0,0,0
"Guadeloupe","2024-12-08",0,0,0,0,0,0,0,0
"Guadeloupe","2024-12-09",0,0,0,0,0,0,0,0
"Guadeloupe","2024-12-10",0,0,0,0,0,0,0,0
"Guadeloupe","2024-12-11",0,0,0,0,0,0,0,0
"Guadeloupe","2024-12-12",0,0,0,0,0,0,0,0
"Guadeloupe","2024-12-13",0,0,0,0,0,0,0,0
"Guadeloupe","2024-12-14",0,0,0,0,0,0,0,0
"Guadeloupe","2024-12-15",0,0,0,0,0,0,0,0
"Guadeloupe","2024-12-16",0,0,0,0,0,0,0,0
"Guadeloupe","2024-12-17",0,0,0,0,0,0,0,0
"Guadeloupe","2024-12-18",0,0,0,0,0,0,0,0
"Guadeloupe","2024-12-19",0,0,0,0,0,0,0,0
"Guadeloupe","2024-12-20",0,0,0,0,0,0,0,0
"Guadeloupe","2024-12-21",0,0,0,0,0,0,0,0
"Guadeloupe","2024-12-22",0,0,0,0,0,0,0,0
"Guadeloupe","2024-12-23",0,0,0,0,0,0,0,0
"Guadeloupe","2024-12-24",0,0,0,0,0,0,0,0
"Guadeloupe","2024-12-25",0,0,0,0,0,0,0,0
"Guadeloupe","2024-12-26",0,0,0,0,0,0,0,0
"Guadeloupe","2024-12-27",0,0,0,0,0,0,0,0
"Guadeloupe","2024-12-28",0,0,0,0,0,0,0,0
"Guadeloupe","2024-12-29",0,0,0,0,0,0,0,0
"Guadeloupe","2024-12-30",0,0,0,0,0,0,0,0
"Guadeloupe","2024-12-31",0,0,0,0,0,0,0,0
"Guadeloupe","2025-01-01",0,0,0,0,0,0,0,0
"Guadeloupe","2025-01-02",0,0,0,0,0,0,0,0
"Guadeloupe","2025-01-03",0,0,0,0,0,0,0,0
"Guadeloupe","2025-01-04",0,0,0,0,0,0,0,0
"Guadeloupe","2025-01-05",0,0,0,0,0,0,0,0
"Guadeloupe","2025-01-06",0,0,0,0,0,0,0,0
"Guadeloupe","2025-01-07",0,0,0,0,0,0,0,0
"Guadeloupe","2025-01-08",0,0,0,0,0,0,0,0
"Guadeloupe","2025-01-09",0,0,0,0,0,0,0,0
"Guadeloupe","2025-01-10",0,0,0,0,0,0,0,0
"Guadeloupe","2025-01-11",0,0,0,0,0,0,0,0
"Guadeloupe","2025-01-12",0,0,0,0,0,0,0,0
"Guadeloupe","2025-01-13",0,0,0,0,0,0,0,0
"Guadeloupe","2025-01-14",0,0,0,0,0,0,0,0
"Guadeloupe","2025-01-15",0,0,0,0,0,0,0,0
"Guadeloupe","2025-01-16",0,0,0,0,0,0,0,0
"Guadeloupe","2025-01-17",0,0,0,0,0,0,0,0
"Guadeloupe","2025-01-18",0,0,0,0,0,0,0,0
"Guadeloupe","2025-01-19",0,0,0,0,0,0,0,0
"Guadeloupe","2025-01-20",0,0,0,0,0,0,0,0
"Guadeloupe","2025-01-21",0,0,0,0,0,0,0,0
"Guadeloupe","2025-01-22",0,0,0,0,0,0,0,0
"Guadeloupe","2025-01-23",0,0,0,0,0,0,0,0
"Guadeloupe","2025-01-24",0,0,0,0,0,0,0,0
"Guadeloupe","2025-01-25",0,0,0,0,0,0,0,0
"Guadeloupe","2025-01-26",0,0,0,0,0,0,0,0
"Guadeloupe","2025-01-27",0,0,0,0,0,0,0,0
"Guadeloupe","2025-01-28",0,0,0,0,0,0,0,0
"Guadeloupe","2025-01-29",0,0,0,0,0,0,0,0
"Guadeloupe","2025-01-30",0,0,0,0,0,0,0,0
"Guadeloupe","2025-01-31",0,0,0,0,0,0,0,0
"Guadeloupe","2025-02-01",0,0,0,0,0,0,0,0
"Guadeloupe","2025-02-02",0,0,0,0,0,0,0,0
"Guadeloupe","2025-02-03",0,0,0,0,0,0,0,0
"Guatemala","2024-01-01",0,0,0,0,0,0,0,0
"Guatemala","2024-01-02",0,0,0,0,0,0,0,0
"Guatemala","2024-01-03",0,0,0,0,0,0,0,0
"Guatemala","2024-01-04",0,0,0,0,0,0,0,0
"Guatemala","2024-01-05",0,0,0,0,0,0,0,0
"Guatemala","2024-01-06",0,0,0,0,0,0,0,0
"Guatemala","2024-01-07",0,0,0,0,0,0,0,0
"Guatemala","2024-01-08",0,0,0,0,0,0,0,0
"Guatemala","2024-01-09",0,0,0,0,0,0,0,0
"Guatemala","2024-01-10",0,0,0,0,0,0,0,0
"Guatemala","2024-01-11",0,0,0,0,0,0,0,0
"Guatemala","2024-01-12",0,0,0,0,0,0,0,0
"Guatemala","2024-01-13",0,0,0,0,0,0,0,0
"Guatemala","2024-01-14",0,0,0,0,0,0,0,0
"Guatemala","2024-01-15",0,0,0,0,0,0,0,0
"Guatemala","2024-01-16",0,0,0,0,0,0,0,0
"Guatemala","2024-01-17",0,0,0,0,0,0,0,0
"Guatemala","2024-01-18",0,0,0,0,0,0,0,0
"Guatemala","2024-01-19",0,0,0,0,0,0,0,0
"Guatemala","2024-01-20",0,0,0,0,0,0,0,0
"Guatemala","2024-01-21",0,0,0,0,0,0,0,0
"Guatemala","2024-01-22",0,0,0,0,0,0,0,0
"Guatemala","2024-01-23",0,1,1,0,1,1,0,0
"Guatemala","2024-01-24",0,0,1,0,0,1,0,0
"Guatemala","2024-01-25",0,0,1,0,0,1,0,0
"Guatemala","2024-01-26",0,0,1,0,0,1,0,0
"Guatemala","2024-01-27",0,0,1,0,0,1,0,0
"Guatemala","2024-01-28",0,0,1,0,0,1,0,0
"Guatemala","2024-01-29",0,0,1,0,0,1,0,0
"Guatemala","2024-01-30",0,0,1,0,0,1,0,0
"Guatemala","2024-01-31",0,0,1,0,0,1,0,0
"Guatemala","2024-02-01",0,0,1,0,0,1,0,0
"Guatemala","2024-02-02",0,0,1,0,0,1,0,0
"Guatemala","2024-02-03",0,0,1,0,0,1,0,0
"Guatemala","2024-02-04",0,0,1,0,0,1,0,0
"Guatemala","2024-02-05",0,0,1,0,0,1,0,0
"Guatemala","2024-02-06",0,0,1,0,0,1,0,0
"Guatemala","2024-02-07",0,0,1,0,0,1,0,0
"Guatemala","2024-02-08",0,0,1,0,0,1,0,0
"Guatemala","2024-02-09",0,0,1,0,0,1,0,0
"Guatemala","2024-02-10",0,0,1,0,0,1,0,0
"Guatemala","2024-02-11",0,0,1,0,0,1,0,0
"Guatemala","2024-02-12",0,0,1,0,0,1,0,0
"Guatemala","2024-02-13",0,0,1,0,0,1,0,0
"Guatemala","2024-02-14",0,0,1,0,0,1,0,0
"Guatemala","2024-02-15",0,0,1,0,0,1,0,0
"Guatemala","2024-02-16",0,0,1,0,0,1,0,0
"Guatemala","2024-02-17",0,0,1,0,0,1,0,0
"Guatemala","2024-02-18",0,0,1,0,0,1,0,0
"Guatemala","2024-02-19",0,0,1,0,0,1,0,0
"Guatemala","2024-02-20",0,0,1,0,0,1,0,0
"Guatemala","2024-02-21",0,0,1,0,0,1,0,0
"Guatemala","2024-02-22",0,0,1,0,0,1,0,0
"Guatemala","2024-02-23",0,0,1,0,0,1,0,0
"Guatemala","2024-02-24",0,0,1,0,0,1,0,0
"Guatemala","2024-02-25",0,0,1,0,0,1,0,0
"Guatemala","2024-02-26",0,0,1,0,0,1,0,0
"Guatemala","2024-02-27",0,0,1,0,0,1,0,0
"Guatemala","2024-02-28",0,0,1,0,0,1,0,0
"Guatemala","2024-02-29",0,0,1,0,0,1,0,0
"Guatemala","2024-03-01",0,0,1,0,0,1,0,0
"Guatemala","2024-03-02",0,0,1,0,0,1,0,0
"Guatemala","2024-03-03",0,0,1,0,0,1,0,0
"Guatemala","2024-03-04",0,0,1,0,0,1,0,0
"Guatemala","2024-03-05",0,0,1,0,0,1,0,0
"Guatemala","2024-03-06",0,0,1,0,0,1,0,0
"Guatemala","2024-03-07",0,0,1,0,0,1,0,0
"Guatemala","2024-03-08",0,0,1,0,0,1,0,0
"Guatemala","2024-03-09",0,0,1,0,0,1,0,0
"Guatemala","2024-03-10",0,0,1,0,0,1,0,0
"Guatemala","2024-03-11",0,0,1,0,0,1,0,0
"Guatemala","2024-03-12",0,0,1,0,0,1,0,0
"Guatemala","2024-03-13",0,0,1,0,0,1,0,0
"Guatemala","2024-03-14",0,0,1,0,0,1,0,0
"Guatemala","2024-03-15",0,0,1,0,0,1,0,0
"Guatemala","2024-03-16",0,0,1,0,0,1,0,0
"Guatemala","2024-03-17",0,0,1,0,0,1,0,0
"Guatemala","2024-03-18",0,0,1,0,0,1,0,0
"Guatemala","2024-03-19",0,0,1,0,0,1,0,0
"Guatemala","2024-03-20",0,0,1,0,0,1,0,0
"Guatemala","2024-03-21",0,0,1,0,0,1,0,0
"Guatemala","2024-03-22",0,0,1,0,0,1,0,0
"Guatemala","2024-03-23",0,0,1,0,0,1,0,0
"Guatemala","2024-03-24",0,0,1,0,0,1,0,0
"Guatemala","2024-03-25",0,0,1,0,0,1,0,0
"Guatemala","2024-03-26",0,0,1,0,0,1,0,0
"Guatemala","2024-03-27",0,0,1,0,0,1,0,0
"Guatemala","2024-03-28",0,0,1,0,0,1,0,0
"Guatemala","2024-03-29",0,0,1,0,0,1,0,0
"Guatemala","2024-03-30",0,0,1,0,0,1,0,0
"Guatemala","2024-03-31",0,0,1,0,0,1,0,0
"Guatemala","2024-04-01",0,0,1,0,0,1,0,0
"Guatemala","2024-04-02",0,0,1,0,0,1,0,0
"Guatemala","2024-04-03",0,0,1,0,0,1,0,0
"Guatemala","2024-04-04",0,0,1,0,0,1,0,0
"Guatemala","2024-04-05",0,0,1,0,0,1,0,0
"Guatemala","2024-04-06",0,0,1,0,0,1,0,0
"Guatemala","2024-04-07",0,0,1,0,0,1,0,0
"Guatemala","2024-04-08",0,0,1,0,0,1,0,0
"Guatemala","2024-04-09",0,0,1,0,0,1,0,0
"Guatemala","2024-04-10",0,0,1,0,0,1,0,0
"Guatemala","2024-04-11",0,0,1,0,0,1,0,0
"Guatemala","2024-04-12",0,0,1,0,0,1,0,0
"Guatemala","2024-04-13",0,0,1,0,0,1,0,0
"Guatemala","2024-04-14",0,0,1,0,0,1,0,0
"Guatemala","2024-04-15",0,0,1,0,0,1,0,0
"Guatemala","2024-04-16",0,0,1,0,0,1,0,0
"Guatemala","2024-04-17",0,0,1,0,0,1,0,0
"Guatemala","2024-04-18",0,0,1,0,0,1,0,0
"Guatemala","2024-04-19",0,0,1,0,0,1,0,0
"Guatemala","2024-04-20",0,0,1,0,0,1,0,0
"Guatemala","2024-04-21",0,0,1,0,0,1,0,0
"Guatemala","2024-04-22",0,0,1,0,0,1,0,0
"Guatemala","2024-04-23",0,0,1,0,0,1,0,0
"Guatemala","2024-04-24",0,0,1,0,0,1,0,0
"Guatemala","2024-04-25",0,0,1,0,0,1,0,0
"Guatemala","2024-04-26",0,0,1,0,0,1,0,0
"Guatemala","2024-04-27",0,0,1,0,0,1,0,0
"Guatemala","2024-04-28",0,0,1,0,0,1,0,0
"Guatemala","2024-04-29",0,0,1,0,0,1,0,0
"Guatemala","2024-04-30",0,0,1,0,0,1,0,0
"Guatemala","2024-05-01",0,0,1,0,0,1,0,0
"Guatemala","2024-05-02",0,0,1,0,0,1,0,0
"Guatemala","2024-05-03",0,0,1,0,0,1,0,0
"Guatemala","2024-05-04",0,0,1,0,0,1,0,0
"Guatemala","2024-05-05",0,0,1,0,0,1,0,0
"Guatemala","2024-05-06",0,0,1,0,0,1,0,0
"Guatemala","2024-05-07",0,0,1,0,0,1,0,0
"Guatemala","2024-05-08",0,0,1,0,0,1,0,0
"Guatemala","2024-05-09",0,0,1,0,0,1,0,0
"Guatemala","2024-05-10",0,0,1,0,0,1,0,0
"Guatemala","2024-05-11",0,0,1,0,0,1,0,0
"Guatemala","2024-05-12",0,0,1,0,0,1,0,0
"Guatemala","2024-05-13",0,0,1,0,0,1,0,0
"Guatemala","2024-05-14",0,0,1,0,0,1,0,0
"Guatemala","2024-05-15",0,0,1,0,0,1,0,0
"Guatemala","2024-05-16",0,0,1,0,0,1,0,0
"Guatemala","2024-05-17",0,0,1,0,0,1,0,0
"Guatemala","2024-05-18",0,0,1,0,0,1,0,0
"Guatemala","2024-05-19",0,0,1,0,0,1,0,0
"Guatemala","2024-05-20",0,0,1,0,0,1,0,0
"Guatemala","2024-05-21",0,0,1,0,0,1,0,0
"Guatemala","2024-05-22",0,0,1,0,0,1,0,0
"Guatemala","2024-05-23",0,0,1,0,0,1,0,0
"Guatemala","2024-05-24",0,0,1,0,0,1,0,0
"Guatemala","2024-05-25",0,0,1,0,0,1,0,0
"Guatemala","2024-05-26",0,0,1,0,0,1,0,0
"Guatemala","2024-05-27",0,0,1,0,0,1,0,0
"Guatemala","2024-05-28",0,0,1,0,0,1,0,0
"Guatemala","2024-05-29",0,0,1,0,0,1,0,0
"Guatemala","2024-05-30",0,0,1,0,0,1,0,0
"Guatemala","2024-05-31",0,0,1,0,0,1,0,0
"Guatemala","2024-06-01",0,0,1,0,0,1,0,0
"Guatemala","2024-06-02",0,0,1,0,0,1,0,0
"Guatemala","2024-06-03",0,0,1,0,0,1,0,0
"Guatemala","2024-06-04",0,0,1,0,0,1,0,0
"Guatemala","2024-06-05",0,0,1,0,0,1,0,0
"Guatemala","2024-06-06",0,0,1,0,0,1,0,0
"Guatemala","2024-06-07",0,0,1,0,0,1,0,0
"Guatemala","2024-06-08",0,0,1,0,0,1,0,0
"Guatemala","2024-06-09",0,0,1,0,0,1,0,0
"Guatemala","2024-06-10",0,0,1,0,0,1,0,0
"Guatemala","2024-06-11",0,0,1,0,0,1,0,0
"Guatemala","2024-06-12",0,0,1,0,0,1,0,0
"Guatemala","2024-06-13",0,0,1,0,0,1,0,0
"Guatemala","2024-06-14",0,0,1,0,0,1,0,0
"Guatemala","2024-06-15",0,0,1,0,1,2,0,0
"Guatemala","2024-06-16",0,0,1,0,0,2,0,0
"Guatemala","2024-06-17",0,0,1,0,0,2,0,0
"Guatemala","2024-06-18",0,0,1,0,0,2,0,0
"Guatemala","2024-06-19",0,0,1,0,0,2,0,0
"Guatemala","2024-06-20",0,0,1,0,0,2,0,0
"Guatemala","2024-06-21",0,0,1,0,0,2,0,0
"Guatemala","2024-06-22",0,0,1,0,0,2,0,0
"Guatemala","2024-06-23",0,0,1,0,0,2,0,0
"Guatemala","2024-06-24",0,0,1,0,0,2,0,0
"Guatemala","2024-06-25",0,0,1,0,0,2,0,0
"Guatemala","2024-06-26",0,0,1,0,0,2,0,0
"Guatemala","2024-06-27",0,0,1,0,0,2,0,0
"Guatemala","2024-06-28",0,0,1,0,0,2,0,0
"Guatemala","2024-06-29",0,0,1,0,0,2,0,0
"Guatemala","2024-06-30",0,0,1,0,0,2,0,0
"Guatemala","2024-07-01",0,0,1,0,0,2,0,0
"Guatemala","2024-07-02",0,0,1,0,0,2,0,0
"Guatemala","2024-07-03",0,0,1,0,0,2,0,0
"Guatemala","2024-07-04",0,0,1,0,0,2,0,0
"Guatemala","2024-07-05",0,0,1,0,0,2,0,0
"Guatemala","2024-07-06",0,0,1,0,0,2,0,0
"Guatemala","2024-07-07",0,0,1,0,0,2,0,0
"Guatemala","2024-07-08",0,0,1,0,0,2,0,0
"Guatemala","2024-07-09",0,0,1,0,0,2,0,0
"Guatemala","2024-07-10",0,0,1,0,0,2,0,0
"Guatemala","2024-07-11",0,0,1,0,0,2,0,0
"Guatemala","2024-07-12",0,0,1,0,0,2,0,0
"Guatemala","2024-07-13",0,0,1,0,0,2,0,0
"Guatemala","2024-07-14",0,0,1,0,0,2,0,0
"Guatemala","2024-07-15",0,0,1,0,0,2,0,0
"Guatemala","2024-07-16",0,0,1,0,0,2,0,0
"Guatemala","2024-07-17",0,0,1,0,0,2,0,0
"Guatemala","2024-07-18",0,0,1,0,0,2,0,0
"Guatemala","2024-07-19",0,0,1,0,0,2,0,0
"Guatemala","2024-07-20",0,0,1,0,0,2,0,0
"Guatemala","2024-07-21",0,0,1,0,0,2,0,0
"Guatemala","2024-07-22",0,0,1,0,0,2,0,0
"Guatemala","2024-07-23",0,0,1,0,0,2,0,0
"Guatemala","2024-07-24",0,0,1,0,0,2,0,0
"Guatemala","2024-07-25",0,0,1,0,0,2,0,0
"Guatemala","2024-07-26",0,0,1,0,0,2,0,0
"Guatemala","2024-07-27",0,0,1,0,0,2,0,0
"Guatemala","2024-07-28",0,0,1,0,0,2,0,0
"Guatemala","2024-07-29",0,0,1,0,0,2,0,0
"Guatemala","2024-07-30",0,0,1,0,0,2,0,0
"Guatemala","2024-07-31",0,0,1,0,0,2,0,0
"Guatemala","2024-08-01",0,0,1,0,0,2,0,0
"Guatemala","2024-08-02",0,0,1,0,0,2,0,0
"Guatemala","2024-08-03",0,0,1,0,0,2,0,0
"Guatemala","2024-08-04",0,0,1,0,0,2,0,0
"Guatemala","2024-08-05",0,0,1,0,0,2,0,0
"Guatemala","2024-08-06",0,0,1,0,0,2,0,0
"Guatemala","2024-08-07",0,0,1,0,0,2,0,0
"Guatemala","2024-08-08",0,0,1,0,0,2,0,0
"Guatemala","2024-08-09",0,0,1,0,0,2,0,0
"Guatemala","2024-08-10",0,0,1,0,0,2,0,0
"Guatemala","2024-08-11",0,0,1,0,0,2,0,0
"Guatemala","2024-08-12",0,0,1,0,0,2,0,0
"Guatemala","2024-08-13",0,0,1,0,0,2,0,0
"Guatemala","2024-08-14",0,0,1,0,0,2,0,0
"Guatemala","2024-08-15",0,0,1,0,0,2,0,0
"Guatemala","2024-08-16",0,0,1,0,0,2,0,0
"Guatemala","2024-08-17",0,0,1,0,0,2,0,0
"Guatemala","2024-08-18",0,0,1,0,0,2,0,0
"Guatemala","2024-08-19",0,0,1,0,0,2,0,0
"Guatemala","2024-08-20",0,0,1,0,0,2,0,0
"Guatemala","2024-08-21",0,0,1,0,0,2,0,0
"Guatemala","2024-08-22",0,0,1,0,0,2,0,0
"Guatemala","2024-08-23",0,0,1,0,0,2,0,0
"Guatemala","2024-08-24",0,0,1,0,0,2,0,0
"Guatemala","2024-08-25",0,0,1,0,0,2,0,0
"Guatemala","2024-08-26",0,0,1,0,0,2,0,0
"Guatemala","2024-08-27",0,0,1,0,0,2,0,0
"Guatemala","2024-08-28",0,0,1,0,0,2,0,0
"Guatemala","2024-08-29",0,0,1,0,0,2,0,0
"Guatemala","2024-08-30",0,0,1,0,0,2,0,0
"Guatemala","2024-08-31",0,0,1,0,0,2,0,0
"Guatemala","2024-09-01",0,0,1,0,0,2,0,0
"Guatemala","2024-09-02",0,0,1,0,0,2,0,0
"Guatemala","2024-09-03",0,0,1,0,0,2,0,0
"Guatemala","2024-09-04",0,0,1,0,0,2,0,0
"Guatemala","2024-09-05",0,0,1,0,0,2,0,0
"Guatemala","2024-09-06",0,0,1,0,0,2,0,0
"Guatemala","2024-09-07",0,0,1,0,0,2,0,0
"Guatemala","2024-09-08",0,0,1,0,0,2,0,0
"Guatemala","2024-09-09",0,0,1,0,0,2,0,0
"Guatemala","2024-09-10",0,0,1,0,0,2,0,0
"Guatemala","2024-09-11",0,0,1,0,0,2,0,0
"Guatemala","2024-09-12",0,0,1,0,0,2,0,0
"Guatemala","2024-09-13",0,0,1,0,0,2,0,0
"Guatemala","2024-09-14",0,0,1,0,0,2,0,0
"Guatemala","2024-09-15",0,0,1,0,0,2,0,0
"Guatemala","2024-09-16",0,0,1,0,0,2,0,0
"Guatemala","2024-09-17",0,0,1,0,0,2,0,0
"Guatemala","2024-09-18",0,0,1,0,0,2,0,0
"Guatemala","2024-09-19",0,0,1,0,0,2,0,0
"Guatemala","2024-09-20",0,0,1,0,0,2,0,0
"Guatemala","2024-09-21",0,0,1,0,0,2,0,0
"Guatemala","2024-09-22",0,0,1,0,0,2,0,0
"Guatemala","2024-09-23",0,0,1,0,0,2,0,0
"Guatemala","2024-09-24",0,0,1,0,0,2,0,0
"Guatemala","2024-09-25",0,0,1,0,0,2,0,0
"Guatemala","2024-09-26",0,0,1,0,0,2,0,0
"Guatemala","2024-09-27",0,0,1,0,0,2,0,0
"Guatemala","2024-09-28",0,0,1,0,0,2,0,0
"Guatemala","2024-09-29",0,0,1,0,0,2,0,0
"Guatemala","2024-09-30",0,0,1,0,0,2,0,0
"Guatemala","2024-10-01",0,0,1,0,0,2,0,0
"Guatemala","2024-10-02",0,0,1,0,0,2,0,0
"Guatemala","2024-10-03",0,0,1,0,0,2,0,0
"Guatemala","2024-10-04",0,0,1,0,0,2,0,0
"Guatemala","2024-10-05",0,0,1,0,0,2,0,0
"Guatemala","2024-10-06",0,0,1,0,0,2,0,0
"Guatemala","2024-10-07",0,0,1,0,0,2,0,0
"Guatemala","2024-10-08",0,0,1,0,0,2,0,0
"Guatemala","2024-10-09",0,0,1,0,0,2,0,0
"Guatemala","2024-10-10",0,0,1,0,0,2,0,0
"Guatemala","2024-10-11",0,0,1,0,0,2,0,0
"Guatemala","2024-10-12",0,0,1,0,0,2,0,0
"Guatemala","2024-10-13",0,0,1,0,0,2,0,0
"Guatemala","2024-10-14",0,0,1,0,0,2,0,0
"Guatemala","2024-10-15",0,0,1,0,0,2,0,0
"Guatemala","2024-10-16",0,0,1,0,0,2,0,0
"Guatemala","2024-10-17",0,0,1,0,0,2,0,0
"Guatemala","2024-10-18",0,0,1,0,0,2,0,0
"Guatemala","2024-10-19",0,0,1,0,0,2,0,0
"Guatemala","2024-10-20",0,0,1,0,0,2,0,0
"Guatemala","2024-10-21",0,0,1,0,0,2,0,0
"Guatemala","2024-10-22",0,0,1,0,0,2,0,0
"Guatemala","2024-10-23",0,0,1,0,0,2,0,0
"Guatemala","2024-10-24",0,0,1,0,0,2,0,0
"Guatemala","2024-10-25",0,0,1,0,0,2,0,0
"Guatemala","2024-10-26",0,0,1,0,0,2,0,0
"Guatemala","2024-10-27",0,0,1,0,0,2,0,0
"Guatemala","2024-10-28",0,0,1,0,0,2,0,0
"Guatemala","2024-10-29",0,0,1,0,0,2,0,0
"Guatemala","2024-10-30",0,0,1,0,0,2,0,0
"Guatemala","2024-10-31",0,0,1,0,0,2,0,0
"Guatemala","2024-11-01",0,0,1,0,0,2,0,0
"Guatemala","2024-11-02",0,0,1,0,0,2,0,0
"Guatemala","2024-11-03",0,0,1,0,0,2,0,0
"Guatemala","2024-11-04",0,0,1,0,0,2,0,0
"Guatemala","2024-11-05",0,1,2,0,0,2,0,0
"Guatemala","2024-11-06",0,0,2,0,0,2,0,0
"Guatemala","2024-11-07",0,0,2,0,0,2,0,0
"Guatemala","2024-11-08",0,0,2,0,0,2,0,0
"Guatemala","2024-11-09",0,0,2,0,0,2,0,0
"Guatemala","2024-11-10",0,0,2,0,0,2,0,0
"Guatemala","2024-11-11",0,0,2,0,0,2,0,0
"Guatemala","2024-11-12",0,0,2,0,0,2,0,0
"Guatemala","2024-11-13",0,0,2,0,0,2,0,0
"Guatemala","2024-11-14",0,0,2,0,0,2,0,0
"Guatemala","2024-11-15",0,0,2,0,0,2,0,0
"Guatemala","2024-11-16",0,0,2,0,0,2,0,0
"Guatemala","2024-11-17",0,0,2,0,0,2,0,0
"Guatemala","2024-11-18",0,0,2,0,0,2,0,0
"Guatemala","2024-11-19",0,0,2,0,0,2,0,0
"Guatemala","2024-11-20",0,0,2,0,0,2,0,0
"Guatemala","2024-11-21",0,0,2,0,0,2,0,0
"Guatemala","2024-11-22",0,0,2,0,0,2,0,0
"Guatemala","2024-11-23",0,0,2,0,0,2,0,0
"Guatemala","2024-11-24",0,0,2,0,0,2,0,0
"Guatemala","2024-11-25",0,0,2,0,0,2,0,0
"Guatemala","2024-11-26",0,0,2,0,0,2,0,0
"Guatemala","2024-11-27",0,0,2,0,0,2,0,0
"Guatemala","2024-11-28",0,0,2,0,0,2,0,0
"Guatemala","2024-11-29",0,0,2,0,0,2,0,0
"Guatemala","2024-11-30",0,0,2,0,0,2,0,0
"Guatemala","2024-12-01",0,0,2,0,0,2,0,0
"Guatemala","2024-12-02",0,0,2,0,0,2,0,0
"Guatemala","2024-12-03",0,0,2,0,0,2,0,0
"Guatemala","2024-12-04",0,0,2,0,0,2,0,0
"Guatemala","2024-12-05",0,0,2,0,0,2,0,0
"Guatemala","2024-12-06",0,0,2,0,0,2,0,0
"Guatemala","2024-12-07",0,0,2,0,0,2,0,0
"Guatemala","2024-12-08",0,0,2,0,0,2,0,0
"Guatemala","2024-12-09",0,0,2,0,0,2,0,0
"Guatemala","2024-12-10",0,0,2,0,0,2,0,0
"Guatemala","2024-12-11",0,0,2,0,0,2,0,0
"Guatemala","2024-12-12",0,0,2,0,0,2,0,0
"Guatemala","2024-12-13",0,0,2,0,0,2,0,0
"Guatemala","2024-12-14",0,0,2,0,0,2,0,0
"Guatemala","2024-12-15",0,0,2,0,0,2,0,0
"Guatemala","2024-12-16",0,0,2,0,0,2,0,0
"Guatemala","2024-12-17",0,0,2,0,0,2,0,0
"Guatemala","2024-12-18",0,0,2,0,0,2,0,0
"Guatemala","2024-12-19",0,0,2,0,0,2,0,0
"Guatemala","2024-12-20",0,0,2,0,0,2,0,0
"Guatemala","2024-12-21",0,0,2,0,0,2,0,0
"Guatemala","2024-12-22",0,0,2,0,0,2,0,0
"Guatemala","2024-12-23",0,0,2,0,0,2,0,0
"Guatemala","2024-12-24",0,0,2,0,0,2,0,0
"Guatemala","2024-12-25",0,0,2,0,0,2,0,0
"Guatemala","2024-12-26",0,0,2,0,0,2,0,0
"Guatemala","2024-12-27",0,0,2,0,0,2,0,0
"Guatemala","2024-12-28",0,0,2,0,0,2,0,0
"Guatemala","2024-12-29",0,0,2,0,0,2,0,0
"Guatemala","2024-12-30",0,0,2,0,0,2,0,0
"Guatemala","2024-12-31",0,0,2,0,0,2,0,0
"Guatemala","2025-01-01",0,0,2,0,0,2,0,0
"Guatemala","2025-01-02",0,0,2,0,0,2,0,0
"Guatemala","2025-01-03",0,0,2,0,0,2,0,0
"Guatemala","2025-01-04",0,0,2,0,0,2,0,0
"Guatemala","2025-01-05",0,0,2,0,0,2,0,0
"Guatemala","2025-01-06",0,0,2,0,0,2,0,0
"Guatemala","2025-01-07",0,0,2,0,0,2,0,0
"Guatemala","2025-01-08",0,0,2,0,0,2,0,0
"Guatemala","2025-01-09",0,0,2,0,0,2,0,0
"Guatemala","2025-01-10",0,0,2,0,0,2,0,0
"Guatemala","2025-01-11",0,0,2,0,0,2,0,0
"Guatemala","2025-01-12",0,0,2,0,0,2,0,0
"Guatemala","2025-01-13",0,0,2,0,0,2,0,0
"Guatemala","2025-01-14",0,0,2,0,0,2,0,0
"Guatemala","2025-01-15",0,0,2,0,0,2,0,0
"Guatemala","2025-01-16",0,0,2,0,0,2,0,0
"Guatemala","2025-01-17",0,0,2,0,0,2,0,0
"Guatemala","2025-01-18",0,0,2,0,0,2,0,0
"Guatemala","2025-01-19",0,0,2,0,0,2,0,0
"Guatemala","2025-01-20",0,0,2,0,0,2,0,0
"Guatemala","2025-01-21",0,0,2,0,0,2,0,0
"Guatemala","2025-01-22",0,0,2,0,0,2,0,0
"Guatemala","2025-01-23",0,0,2,0,0,2,0,0
"Guatemala","2025-01-24",0,0,2,0,0,2,0,0
"Guatemala","2025-01-25",0,0,2,0,0,2,0,0
"Guatemala","2025-01-26",0,0,2,0,0,2,0,0
"Guatemala","2025-01-27",0,0,2,0,0,2,0,0
"Guatemala","2025-01-28",0,0,2,0,0,2,0,0
"Guatemala","2025-01-29",0,0,2,0,0,2,0,0
"Guatemala","2025-01-30",0,0,2,0,0,2,0,0
"Guatemala","2025-01-31",0,0,2,0,0,2,0,0
"Guatemala","2025-02-01",0,0,2,0,0,2,0,0
"Guatemala","2025-02-02",0,0,2,0,0,2,0,0
"Guatemala","2025-02-03",0,0,2,0,0,2,0,0
"Guinea","2024-01-01",0,0,0,0,0,0,0,0
"Guinea","2024-01-02",0,0,0,0,0,0,0,0
"Guinea","2024-01-03",0,0,0,0,0,0,0,0
"Guinea","2024-01-04",0,0,0,0,0,0,0,0
"Guinea","2024-01-05",0,0,0,0,0,0,0,0
"Guinea","2024-01-06",0,0,0,0,0,0,0,0
"Guinea","2024-01-07",0,0,0,0,0,0,0,0
"Guinea","2024-01-08",0,0,0,0,0,0,0,0
"Guinea","2024-01-09",0,1,1,0,1,1,0,0
"Guinea","2024-01-10",0,0,1,0,0,1,0,0
"Guinea","2024-01-11",0,0,1,0,0,1,0,0
"Guinea","2024-01-12",0,0,1,0,0,1,0,0
"Guinea","2024-01-13",0,0,1,0,0,1,0,0
"Guinea","2024-01-14",0,0,1,0,0,1,0,0
"Guinea","2024-01-15",0,0,1,0,0,1,0,0
"Guinea","2024-01-16",0,0,1,0,0,1,0,0
"Guinea","2024-01-17",0,0,1,0,0,1,0,0
"Guinea","2024-01-18",0,0,1,0,0,1,0,0
"Guinea","2024-01-19",0,0,1,0,0,1,0,0
"Guinea","2024-01-20",0,0,1,0,0,1,0,0
"Guinea","2024-01-21",0,0,1,0,0,1,0,0
"Guinea","2024-01-22",0,0,1,0,0,1,0,0
"Guinea","2024-01-23",0,0,1,0,0,1,0,0
"Guinea","2024-01-24",0,0,1,0,0,1,0,0
"Guinea","2024-01-25",0,0,1,0,0,1,0,0
"Guinea","2024-01-26",0,0,1,0,0,1,0,0
"Guinea","2024-01-27",0,0,1,0,0,1,0,0
"Guinea","2024-01-28",0,0,1,0,0,1,0,0
"Guinea","2024-01-29",0,0,1,0,0,1,0,0
"Guinea","2024-01-30",0,0,1,0,0,1,0,0
"Guinea","2024-01-31",0,0,1,0,0,1,0,0
"Guinea","2024-02-01",0,0,1,0,0,1,0,0
"Guinea","2024-02-02",0,0,1,0,0,1,0,0
"Guinea","2024-02-03",0,0,1,0,0,1,0,0
"Guinea","2024-02-04",0,0,1,0,0,1,0,0
"Guinea","2024-02-05",0,0,1,0,0,1,0,0
"Guinea","2024-02-06",0,0,1,0,0,1,0,0
"Guinea","2024-02-07",0,0,1,0,0,1,0,0
"Guinea","2024-02-08",0,0,1,0,0,1,0,0
"Guinea","2024-02-09",0,0,1,0,0,1,0,0
"Guinea","2024-02-10",0,0,1,0,0,1,0,0
"Guinea","2024-02-11",0,0,1,0,0,1,0,0
"Guinea","2024-02-12",0,0,1,0,0,1,0,0
"Guinea","2024-02-13",0,0,1,0,0,1,0,0
"Guinea","2024-02-14",0,0,1,0,0,1,0,0
"Guinea","2024-02-15",0,0,1,0,0,1,0,0
"Guinea","2024-02-16",0,0,1,0,0,1,0,0
"Guinea","2024-02-17",0,0,1,0,0,1,0,0
"Guinea","2024-02-18",0,0,1,0,0,1,0,0
"Guinea","2024-02-19",0,0,1,0,0,1,0,0
"Guinea","2024-02-20",0,0,1,0,0,1,0,0
"Guinea","2024-02-21",0,0,1,0,0,1,0,0
"Guinea","2024-02-22",0,0,1,0,0,1,0,0
"Guinea","2024-02-23",0,0,1,0,0,1,0,0
"Guinea","2024-02-24",0,0,1,0,0,1,0,0
"Guinea","2024-02-25",0,0,1,0,0,1,0,0
"Guinea","2024-02-26",0,0,1,0,0,1,0,0
"Guinea","2024-02-27",0,0,1,0,0,1,0,0
"Guinea","2024-02-28",0,0,1,0,0,1,0,0
"Guinea","2024-02-29",0,0,1,0,0,1,0,0
"Guinea","2024-03-01",0,0,1,0,0,1,0,0
"Guinea","2024-03-02",0,0,1,0,0,1,0,0
"Guinea","2024-03-03",0,0,1,0,0,1,0,0
"Guinea","2024-03-04",0,0,1,0,0,1,0,0
"Guinea","2024-03-05",0,0,1,0,0,1,0,0
"Guinea","2024-03-06",0,0,1,0,0,1,0,0
"Guinea","2024-03-07",0,0,1,0,0,1,0,0
"Guinea","2024-03-08",0,0,1,0,0,1,0,0
"Guinea","2024-03-09",0,0,1,0,0,1,0,0
"Guinea","2024-03-10",0,0,1,0,0,1,0,0
"Guinea","2024-03-11",0,0,1,0,0,1,0,0
"Guinea","2024-03-12",0,0,1,0,0,1,0,0
"Guinea","2024-03-13",0,0,1,0,0,1,0,0
"Guinea","2024-03-14",0,0,1,0,0,1,0,0
"Guinea","2024-03-15",0,0,1,0,0,1,0,0
"Guinea","2024-03-16",0,0,1,0,0,1,0,0
"Guinea","2024-03-17",0,0,1,0,0,1,0,0
"Guinea","2024-03-18",0,0,1,0,0,1,0,0
"Guinea","2024-03-19",0,0,1,0,0,1,0,0
"Guinea","2024-03-20",0,0,1,0,0,1,0,0
"Guinea","2024-03-21",0,0,1,0,0,1,0,0
"Guinea","2024-03-22",0,0,1,0,0,1,0,0
"Guinea","2024-03-23",0,0,1,0,0,1,0,0
"Guinea","2024-03-24",0,0,1,0,0,1,0,0
"Guinea","2024-03-25",0,0,1,0,0,1,0,0
"Guinea","2024-03-26",0,0,1,0,0,1,0,0
"Guinea","2024-03-27",0,0,1,0,0,1,0,0
"Guinea","2024-03-28",0,0,1,0,0,1,0,0
"Guinea","2024-03-29",0,0,1,0,0,1,0,0
"Guinea","2024-03-30",0,0,1,0,0,1,0,0
"Guinea","2024-03-31",0,0,1,0,0,1,0,0
"Guinea","2024-04-01",0,0,1,0,0,1,0,0
"Guinea","2024-04-02",0,0,1,0,0,1,0,0
"Guinea","2024-04-03",0,0,1,0,0,1,0,0
"Guinea","2024-04-04",0,0,1,0,0,1,0,0
"Guinea","2024-04-05",0,0,1,0,0,1,0,0
"Guinea","2024-04-06",0,0,1,0,0,1,0,0
"Guinea","2024-04-07",0,0,1,0,0,1,0,0
"Guinea","2024-04-08",0,0,1,0,0,1,0,0
"Guinea","2024-04-09",0,0,1,0,0,1,0,0
"Guinea","2024-04-10",0,0,1,0,0,1,0,0
"Guinea","2024-04-11",0,0,1,0,0,1,0,0
"Guinea","2024-04-12",0,0,1,0,0,1,0,0
"Guinea","2024-04-13",0,0,1,0,0,1,0,0
"Guinea","2024-04-14",0,0,1,0,0,1,0,0
"Guinea","2024-04-15",0,0,1,0,0,1,0,0
"Guinea","2024-04-16",0,0,1,0,0,1,0,0
"Guinea","2024-04-17",0,0,1,0,0,1,0,0
"Guinea","2024-04-18",0,0,1,0,0,1,0,0
"Guinea","2024-04-19",0,0,1,0,0,1,0,0
"Guinea","2024-04-20",0,0,1,0,0,1,0,0
"Guinea","2024-04-21",0,0,1,0,0,1,0,0
"Guinea","2024-04-22",0,0,1,0,0,1,0,0
"Guinea","2024-04-23",0,0,1,0,0,1,0,0
"Guinea","2024-04-24",0,0,1,0,0,1,0,0
"Guinea","2024-04-25",0,0,1,0,0,1,0,0
"Guinea","2024-04-26",0,0,1,0,0,1,0,0
"Guinea","2024-04-27",0,0,1,0,0,1,0,0
"Guinea","2024-04-28",0,0,1,0,0,1,0,0
"Guinea","2024-04-29",0,0,1,0,0,1,0,0
"Guinea","2024-04-30",0,0,1,0,0,1,0,0
"Guinea","2024-05-01",0,0,1,0,0,1,0,0
"Guinea","2024-05-02",0,0,1,0,0,1,0,0
"Guinea","2024-05-03",0,0,1,0,0,1,0,0
"Guinea","2024-05-04",0,0,1,0,0,1,0,0
"Guinea","2024-05-05",0,0,1,0,0,1,0,0
"Guinea","2024-05-06",0,0,1,0,0,1,0,0
"Guinea","2024-05-07",0,0,1,0,0,1,0,0
"Guinea","2024-05-08",0,0,1,0,0,1,0,0
"Guinea","2024-05-09",0,0,1,0,0,1,0,0
"Guinea","2024-05-10",0,0,1,0,0,1,0,0
"Guinea","2024-05-11",0,0,1,0,0,1,0,0
"Guinea","2024-05-12",0,0,1,0,0,1,0,0
"Guinea","2024-05-13",0,0,1,0,0,1,0,0
"Guinea","2024-05-14",0,0,1,0,0,1,0,0
"Guinea","2024-05-15",0,0,1,0,0,1,0,0
"Guinea","2024-05-16",0,0,1,0,0,1,0,0
"Guinea","2024-05-17",0,0,1,0,0,1,0,0
"Guinea","2024-05-18",0,0,1,0,0,1,0,0
"Guinea","2024-05-19",0,0,1,0,0,1,0,0
"Guinea","2024-05-20",0,0,1,0,0,1,0,0
"Guinea","2024-05-21",0,0,1,0,0,1,0,0
"Guinea","2024-05-22",0,0,1,0,0,1,0,0
"Guinea","2024-05-23",0,0,1,0,0,1,0,0
"Guinea","2024-05-24",0,0,1,0,0,1,0,0
"Guinea","2024-05-25",0,0,1,0,0,1,0,0
"Guinea","2024-05-26",0,0,1,0,0,1,0,0
"Guinea","2024-05-27",0,0,1,0,0,1,0,0
"Guinea","2024-05-28",0,0,1,0,0,1,0,0
"Guinea","2024-05-29",0,0,1,0,0,1,0,0
"Guinea","2024-05-30",0,0,1,0,0,1,0,0
"Guinea","2024-05-31",0,0,1,0,0,1,0,0
"Guinea","2024-06-01",0,0,1,0,0,1,0,0
"Guinea","2024-06-02",0,0,1,0,0,1,0,0
"Guinea","2024-06-03",0,0,1,0,0,1,0,0
"Guinea","2024-06-04",0,0,1,0,0,1,0,0
"Guinea","2024-06-05",0,0,1,0,0,1,0,0
"Guinea","2024-06-06",0,0,1,0,0,1,0,0
"Guinea","2024-06-07",0,0,1,0,0,1,0,0
"Guinea","2024-06-08",0,0,1,0,0,1,0,0
"Guinea","2024-06-09",0,0,1,0,0,1,0,0
"Guinea","2024-06-10",0,0,1,0,0,1,0,0
"Guinea","2024-06-11",0,0,1,0,0,1,0,0
"Guinea","2024-06-12",0,0,1,0,0,1,0,0
"Guinea","2024-06-13",0,0,1,0,0,1,0,0
"Guinea","2024-06-14",0,0,1,0,0,1,0,0
"Guinea","2024-06-15",0,0,1,0,0,1,0,0
"Guinea","2024-06-16",0,0,1,0,0,1,0,0
"Guinea","2024-06-17",0,0,1,0,0,1,0,0
"Guinea","2024-06-18",0,0,1,0,0,1,0,0
"Guinea","2024-06-19",0,0,1,0,0,1,0,0
"Guinea","2024-06-20",0,0,1,0,0,1,0,0
"Guinea","2024-06-21",0,0,1,0,0,1,0,0
"Guinea","2024-06-22",0,0,1,0,0,1,0,0
"Guinea","2024-06-23",0,0,1,0,0,1,0,0
"Guinea","2024-06-24",0,0,1,0,0,1,0,0
"Guinea","2024-06-25",0,0,1,0,1,2,0,0
"Guinea","2024-06-26",0,0,1,0,0,2,0,0
"Guinea","2024-06-27",0,0,1,0,0,2,0,0
"Guinea","2024-06-28",0,0,1,0,0,2,0,0
"Guinea","2024-06-29",0,0,1,0,0,2,0,0
"Guinea","2024-06-30",0,0,1,0,0,2,0,0
"Guinea","2024-07-01",0,0,1,0,0,2,0,0
"Guinea","2024-07-02",0,0,1,0,0,2,0,0
"Guinea","2024-07-03",0,0,1,0,0,2,0,0
"Guinea","2024-07-04",0,0,1,0,0,2,0,0
"Guinea","2024-07-05",0,0,1,0,0,2,0,0
"Guinea","2024-07-06",0,0,1,0,0,2,0,0
"Guinea","2024-07-07",0,0,1,0,0,2,0,0
"Guinea","2024-07-08",0,0,1,0,0,2,0,0
"Guinea","2024-07-09",0,0,1,0,0,2,0,0
"Guinea","2024-07-10",0,0,1,0,0,2,0,0
"Guinea","2024-07-11",0,0,1,0,0,2,0,0
"Guinea","2024-07-12",0,0,1,0,0,2,0,0
"Guinea","2024-07-13",0,0,1,0,0,2,0,0
"Guinea","2024-07-14",0,0,1,0,0,2,0,0
"Guinea","2024-07-15",0,0,1,0,0,2,0,0
"Guinea","2024-07-16",0,0,1,0,0,2,0,0
"Guinea","2024-07-17",0,0,1,0,0,2,0,0
"Guinea","2024-07-18",0,0,1,0,0,2,0,0
"Guinea","2024-07-19",0,0,1,0,0,2,0,0
"Guinea","2024-07-20",0,0,1,0,0,2,0,0
"Guinea","2024-07-21",0,0,1,0,0,2,0,0
"Guinea","2024-07-22",0,0,1,0,0,2,0,0
"Guinea","2024-07-23",0,0,1,0,0,2,0,0
"Guinea","2024-07-24",0,0,1,0,0,2,0,0
"Guinea","2024-07-25",0,0,1,0,0,2,0,0
"Guinea","2024-07-26",0,0,1,0,0,2,0,0
"Guinea","2024-07-27",0,0,1,0,0,2,0,0
"Guinea","2024-07-28",0,0,1,0,0,2,0,0
"Guinea","2024-07-29",0,0,1,0,0,2,0,0
"Guinea","2024-07-30",0,0,1,0,0,2,0,0
"Guinea","2024-07-31",0,0,1,0,0,2,0,0
"Guinea","2024-08-01",0,0,1,0,0,2,0,0
"Guinea","2024-08-02",0,0,1,0,0,2,0,0
"Guinea","2024-08-03",0,0,1,0,0,2,0,0
"Guinea","2024-08-04",0,0,1,0,0,2,0,0
"Guinea","2024-08-05",0,0,1,0,0,2,0,0
"Guinea","2024-08-06",0,0,1,0,0,2,0,0
"Guinea","2024-08-07",0,0,1,0,0,2,0,0
"Guinea","2024-08-08",0,0,1,0,0,2,0,0
"Guinea","2024-08-09",0,0,1,0,0,2,0,0
"Guinea","2024-08-10",0,0,1,0,0,2,0,0
"Guinea","2024-08-11",0,0,1,0,0,2,0,0
"Guinea","2024-08-12",0,0,1,0,0,2,0,0
"Guinea","2024-08-13",0,0,1,0,0,2,0,0
"Guinea","2024-08-14",0,0,1,0,0,2,0,0
"Guinea","2024-08-15",0,0,1,0,0,2,0,0
"Guinea","2024-08-16",0,0,1,0,0,2,0,0
"Guinea","2024-08-17",0,0,1,0,0,2,0,0
"Guinea","2024-08-18",0,0,1,0,0,2,0,0
"Guinea","2024-08-19",0,0,1,0,0,2,0,0
"Guinea","2024-08-20",0,0,1,0,0,2,0,0
"Guinea","2024-08-21",0,0,1,0,0,2,0,0
"Guinea","2024-08-22",0,0,1,0,0,2,0,0
"Guinea","2024-08-23",0,0,1,0,0,2,0,0
"Guinea","2024-08-24",0,0,1,0,0,2,0,0
"Guinea","2024-08-25",0,0,1,0,0,2,0,0
"Guinea","2024-08-26",0,0,1,0,0,2,0,0
"Guinea","2024-08-27",0,0,1,0,0,2,0,0
"Guinea","2024-08-28",0,0,1,0,0,2,0,0
"Guinea","2024-08-29",0,0,1,0,0,2,0,0
"Guinea","2024-08-30",0,0,1,0,0,2,0,0
"Guinea","2024-08-31",0,0,1,0,0,2,0,0
"Guinea","2024-09-01",0,0,1,0,0,2,0,0
"Guinea","2024-09-02",0,0,1,0,0,2,0,0
"Guinea","2024-09-03",0,0,1,0,0,2,0,0
"Guinea","2024-09-04",0,0,1,0,0,2,0,0
"Guinea","2024-09-05",0,0,1,0,0,2,0,0
"Guinea","2024-09-06",0,0,1,0,0,2,0,0
"Guinea","2024-09-07",0,0,1,0,0,2,0,0
"Guinea","2024-09-08",0,0,1,0,0,2,0,0
"Guinea","2024-09-09",0,0,1,0,0,2,0,0
"Guinea","2024-09-10",0,0,1,0,0,2,0,0
"Guinea","2024-09-11",0,0,1,0,0,2,0,0
"Guinea","2024-09-12",0,0,1,0,0,2,0,0
"Guinea","2024-09-13",0,0,1,0,0,2,0,0
"Guinea","2024-09-14",0,0,1,0,0,2,0,0
"Guinea","2024-09-15",0,0,1,0,0,2,0,0
"Guinea","2024-09-16",0,0,1,0,0,2,0,0
"Guinea","2024-09-17",0,0,1,0,0,2,0,0
"Guinea","2024-09-18",0,0,1,0,0,2,0,0
"Guinea","2024-09-19",0,0,1,0,0,2,0,0
"Guinea","2024-09-20",0,0,1,0,0,2,0,0
"Guinea","2024-09-21",0,0,1,0,0,2,0,0
"Guinea","2024-09-22",0,0,1,0,0,2,0,0
"Guinea","2024-09-23",0,0,1,0,0,2,0,0
"Guinea","2024-09-24",0,0,1,0,0,2,0,0
"Guinea","2024-09-25",0,0,1,0,0,2,0,0
"Guinea","2024-09-26",0,0,1,0,0,2,0,0
"Guinea","2024-09-27",0,0,1,0,0,2,0,0
"Guinea","2024-09-28",0,0,1,0,0,2,0,0
"Guinea","2024-09-29",0,0,1,0,0,2,0,0
"Guinea","2024-09-30",0,0,1,0,0,2,0,0
"Guinea","2024-10-01",0,0,1,0,0,2,0,0
"Guinea","2024-10-02",0,0,1,0,0,2,0,0
"Guinea","2024-10-03",0,0,1,0,0,2,0,0
"Guinea","2024-10-04",0,0,1,0,0,2,0,0
"Guinea","2024-10-05",0,0,1,0,0,2,0,0
"Guinea","2024-10-06",0,0,1,0,0,2,0,0
"Guinea","2024-10-07",0,0,1,0,0,2,0,0
"Guinea","2024-10-08",0,0,1,0,0,2,0,0
"Guinea","2024-10-09",0,0,1,0,0,2,0,0
"Guinea","2024-10-10",0,0,1,0,0,2,0,0
"Guinea","2024-10-11",0,0,1,0,0,2,0,0
"Guinea","2024-10-12",0,0,1,0,0,2,0,0
"Guinea","2024-10-13",0,0,1,0,0,2,0,0
"Guinea","2024-10-14",0,0,1,0,0,2,0,0
"Guinea","2024-10-15",0,0,1,0,0,2,0,0
"Guinea","2024-10-16",0,0,1,0,0,2,0,0
"Guinea","2024-10-17",0,0,1,0,0,2,0,0
"Guinea","2024-10-18",0,0,1,0,0,2,0,0
"Guinea","2024-10-19",0,0,1,0,0,2,0,0
"Guinea","2024-10-20",0,0,1,0,0,2,0,0
"Guinea","2024-10-21",0,0,1,0,0,2,0,0
"Guinea","2024-10-22",0,0,1,0,0,2,0,0
"Guinea","2024-10-23",0,0,1,0,0,2,0,0
"Guinea","2024-10-24",0,0,1,0,0,2,0,0
"Guinea","2024-10-25",0,0,1,0,0,2,0,0
"Guinea","2024-10-26",0,0,1,0,0,2,0,0
"Guinea","2024-10-27",0,0,1,0,0,2,0,0
"Guinea","2024-10-28",0,0,1,0,0,2,0,0
"Guinea","2024-10-29",0,0,1,0,0,2,0,0
"Guinea","2024-10-30",0,0,1,0,0,2,0,0
"Guinea","2024-10-31",0,0,1,0,0,2,0,0
"Guinea","2024-11-01",0,0,1,0,0,2,0,0
"Guinea","2024-11-02",0,0,1,0,0,2,0,0
"Guinea","2024-11-03",0,0,1,0,0,2,0,0
"Guinea","2024-11-04",0,0,1,0,0,2,0,0
"Guinea","2024-11-05",0,0,1,0,0,2,0,0
"Guinea","2024-11-06",0,0,1,0,0,2,0,0
"Guinea","2024-11-07",0,0,1,0,0,2,0,0
"Guinea","2024-11-08",0,0,1,0,0,2,0,0
"Guinea","2024-11-09",0,0,1,0,0,2,0,0
"Guinea","2024-11-10",0,0,1,0,0,2,0,0
"Guinea","2024-11-11",0,0,1,0,0,2,0,0
"Guinea","2024-11-12",0,0,1,0,0,2,0,0
"Guinea","2024-11-13",0,0,1,0,0,2,0,0
"Guinea","2024-11-14",0,0,1,0,0,2,0,0
"Guinea","2024-11-15",0,0,1,0,0,2,0,0
"Guinea","2024-11-16",0,0,1,0,0,2,0,0
"Guinea","2024-11-17",0,0,1,0,0,2,0,0
"Guinea","2024-11-18",0,0,1,0,0,2,0,0
"Guinea","2024-11-19",0,0,1,0,0,2,0,0
"Guinea","2024-11-20",0,0,1,0,0,2,0,0
"Guinea","2024-11-21",0,0,1,0,0,2,0,0
"Guinea","2024-11-22",0,0,1,0,0,2,0,0
"Guinea","2024-11-23",0,0,1,0,0,2,0,0
"Guinea","2024-11-24",0,0,1,0,0,2,0,0
"Guinea","2024-11-25",0,0,1,0,0,2,0,0
"Guinea","2024-11-26",0,0,1,0,0,2,0,0
"Guinea","2024-11-27",0,0,1,0,0,2,0,0
"Guinea","2024-11-28",0,0,1,0,0,2,0,0
"Guinea","2024-11-29",0,0,1,0,0,2,0,0
"Guinea","2024-11-30",0,0,1,0,0,2,0,0
"Guinea","2024-12-01",0,0,1,0,0,2,0,0
"Guinea","2024-12-02",0,0,1,0,0,2,0,0
"Guinea","2024-12-03",0,0,1,0,0,2,0,0
"Guinea","2024-12-04",0,0,1,0,0,2,0,0
"Guinea","2024-12-05",0,0,1,0,0,2,0,0
"Guinea","2024-12-06",0,0,1,0,0,2,0,0
"Guinea","2024-12-07",0,0,1,0,0,2,0,0
"Guinea","2024-12-08",0,1,2,0,0,2,0,0
"Guinea","2024-12-09",0,0,2,0,0,2,0,0
"Guinea","2024-12-10",0,0,2,0,0,2,0,0
"Guinea","2024-12-11",0,0,2,0,0,2,0,0
"Guinea","2024-12-12",0,0,2,0,0,2,0,0
"Guinea","2024-12-13",0,0,2,0,0,2,0,0
"Guinea","2024-12-14",0,0,2,0,0,2,0,0
"Guinea","2024-12-15",0,0,2,0,0,2,0,0
"Guinea","2024-12-16",0,0,2,0,0,2,0,0
"Guinea","2024-12-17",0,0,2,0,0,2,0,0
"Guinea","2024-12-18",0,0,2,0,0,2,0,0
"Guinea","2024-12-19",0,0,2,0,0,2,0,0
"Guinea","2024-12-20",0,0,2,0,0,2,0,0
"Guinea","2024-12-21",0,0,2,0,0,2,0,0
"Guinea","2024-12-22",0,0,2,0,0,2,0,0
"Guinea","2024-12-23",0,0,2,0,0,2,0,0
"Guinea","2024-12-24",0,0,2,0,0,2,0,0
"Guinea","2024-12-25",0,0,2,0,0,2,0,0
"Guinea","2024-12-26",0,0,2,0,0,2,0,0
"Guinea","2024-12-27",0,0,2,0,0,2,0,0
"Guinea","2024-12-28",0,0,2,0,0,2,0,0
"Guinea","2024-12-29",0,0,2,0,0,2,0,0
"Guinea","2024-12-30",0,0,2,0,0,2,0,0
"Guinea","2024-12-31",0,0,2,0,0,2,0,0
"Guinea","2025-01-01",0,0,2,0,0,2,0,0
"Guinea","2025-01-02",0,0,2,0,0,2,0,0
"Guinea","2025-01-03",0,0,2,0,0,2,0,0
"Guinea","2025-01-04",0,0,2,0,0,2,0,0
"Guinea","2025-01-05",0,0,2,0,0,2,0,0
"Guinea","2025-01-06",0,0,2,0,0,2,0,0
"Guinea","2025-01-07",0,0,2,0,0,2,0,0
"Guinea","2025-01-08",0,0,2,0,0,2,0,0
"Guinea","2025-01-09",0,0,2,0,0,2,0,0
"Guinea","2025-01-10",0,0,2,0,0,2,0,0
"Guinea","2025-01-11",0,0,2,0,0,2,0,0
"Guinea","2025-01-12",0,0,2,0,0,2,0,0
"Guinea","2025-01-13",0,0,2,0,0,2,0,0
"Guinea","2025-01-14",0,0,2,0,0,2,0,0
"Guinea","2025-01-15",0,0,2,0,0,2,0,0
"Guinea","2025-01-16",0,0,2,0,0,2,0,0
"Guinea","2025-01-17",0,0,2,0,0,2,0,0
"Guinea","2025-01-18",0,0,2,0,0,2,0,0
"Guinea","2025-01-19",0,0,2,0,0,2,0,0
"Guinea","2025-01-20",0,0,2,0,0,2,0,0
"Guinea","2025-01-21",0,0,2,0,0,2,0,0
"Guinea","2025-01-22",0,0,2,0,0,2,0,0
"Guinea","2025-01-23",0,0,2,0,0,2,0,0
"Guinea","2025-01-24",0,0,2,0,0,2,0,0
"Guinea","2025-01-25",0,0,2,0,0,2,0,0
"Guinea","2025-01-26",0,0,2,0,0,2,0,0
"Guinea","2025-01-27",0,0,2,0,0,2,0,0
"Guinea","2025-01-28",0,0,2,0,0,2,0,0
"Guinea","2025-01-29",0,0,2,0,0,2,0,0
"Guinea","2025-01-30",0,0,2,0,0,2,0,0
"Guinea","2025-01-31",0,0,2,0,0,2,0,0
"Guinea","2025-02-01",0,0,2,0,0,2,0,0
"Guinea","2025-02-02",0,0,2,0,0,2,0,0
"Guinea","2025-02-03",0,0,2,0,0,2,0,0
"Guyana","2024-01-01",0,0,0,0,0,0,0,0
"Guyana","2024-01-02",0,0,0,0,0,0,0,0
"Guyana","2024-01-03",0,0,0,0,0,0,0,0
"Guyana","2024-01-04",0,0,0,0,0,0,0,0
"Guyana","2024-01-05",0,0,0,0,0,0,0,0
"Guyana","2024-01-06",0,0,0,0,0,0,0,0
"Guyana","2024-01-07",0,0,0,0,0,0,0,0
"Guyana","2024-01-08",0,0,0,0,0,0,0,0
"Guyana","2024-01-09",0,0,0,0,0,0,0,0
"Guyana","2024-01-10",0,0,0,0,0,0,0,0
"Guyana","2024-01-11",0,0,0,0,0,0,0,0
"Guyana","2024-01-12",0,0,0,0,0,0,0,0
"Guyana","2024-01-13",0,0,0,0,0,0,0,0
"Guyana","2024-01-14",0,0,0,0,0,0,0,0
"Guyana","2024-01-15",0,0,0,0,0,0,0,0
"Guyana","2024-01-16",0,0,0,0,0,0,0,0
"Guyana","2024-01-17",0,0,0,0,0,0,0,0
"Guyana","2024-01-18",0,0,0,0,0,0,0,0
"Guyana","2024-01-19",0,0,0,0,0,0,0,0
"Guyana","2024-01-20",0,0,0,0,0,0,0,0
"Guyana","2024-01-21",0,0,0,0,0,0,0,0
"Guyana","2024-01-22",0,0,0,0,0,0,0,0
"Guyana","2024-01-23",0,0,0,0,0,0,0,0
"Guyana","2024-01-24",0,0,0,0,0,0,0,0
"Guyana","2024-01-25",0,0,0,0,0,0,0,0
"Guyana","2024-01-26",0,0,0,0,0,0,0,0
"Guyana","2024-01-27",0,0,0,0,0,0,0,0
"Guyana","2024-01-28",0,0,0,0,0,0,0,0
"Guyana","2024-01-29",0,0,0,0,0,0,0,0
"Guyana","2024-01-30",0,0,0,0,0,0,0,0
"Guyana","2024-01-31",0,0,0,0,0,0,0,0
"Guyana","2024-02-01",0,0,0,0,0,0,0,0
"Guyana","2024-02-02",0,0,0,0,0,0,0,0
"Guyana","2024-02-03",0,0,0,0,0,0,0,0
"Guyana","2024-02-04",0,0,0,0,0,0,0,0
"Guyana","2024-02-05",0,0,0,0,0,0,0,0
"Guyana","2024-02-06",0,0,0,0,0,0,0,0
"Guyana","2024-02-07",0,0,0,0,0,0,0,0
"Guyana","2024-02-08",0,0,0,0,0,0,0,0
"Guyana","2024-02-09",0,0,0,0,0,0,0,0
"Guyana","2024-02-10",0,0,0,0,0,0,0,0
"Guyana","2024-02-11",0,0,0,0,0,0,0,0
"Guyana","2024-02-12",0,0,0,0,0,0,0,0
"Guyana","2024-02-13",0,0,0,0,0,0,0,0
"Guyana","2024-02-14",0,0,0,0,0,0,0,0
"Guyana","2024-02-15",0,0,0,0,0,0,0,0
"Guyana","2024-02-16",0,0,0,0,0,0,0,0
"Guyana","2024-02-17",0,0,0,0,0,0,0,0
"Guyana","2024-02-18",0,0,0,0,0,0,0,0
"Guyana","2024-02-19",0,0,0,0,0,0,0,0
"Guyana","2024-02-20",0,0,0,0,0,0,0,0
"Guyana","2024-02-21",0,0,0,0,0,0,0,0
"Guyana","2024-02-22",0,0,0,0,0,0,0,0
"Guyana","2024-02-23",0,0,0,0,0,0,0,0
"Guyana","2024-02-24",0,0,0,0,0,0,0,0
"Guyana","2024-02-25",0,0,0,0,0,0,0,0
"Guyana","2024-02-26",0,0,0,0,0,0,0,0
"Guyana","2024-02-27",0,0,0,0,0,0,0,0
"Guyana","2024-02-28",0,0,0,0,0,0,0,0
"Guyana","2024-02-29",0,0,0,0,0,0,0,0
"Guyana","2024-03-01",0,0,0,0,0,0,0,0
"Guyana","2024-03-02",0,0,0,0,0,0,0,0
"Guyana","2024-03-03",0,0,0,0,0,0,0,0
"Guyana","2024-03-04",0,0,0,0,0,0,0,0
"Guyana","2024-03-05",0,0,0,0,0,0,0,0
"Guyana","2024-03-06",0,0,0,0,0,0,0,0
"Guyana","2024-03-07",0,0,0,0,0,0,0,0
"Guyana","2024-03-08",0,0,0,0,0,0,0,0
"Guyana","2024-03-09",0,0,0,0,0,0,0,0
"Guyana","2024-03-10",0,0,0,0,0,0,0,0
"Guyana","2024-03-11",0,0,0,0,0,0,0,0
"Guyana","2024-03-12",0,0,0,0,0,0,0,0
"Guyana","2024-03-13",0,0,0,0,0,0,0,0
"Guyana","2024-03-14",0,0,0,0,0,0,0,0
"Guyana","2024-03-15",0,0,0,0,0,0,0,0
"Guyana","2024-03-16",0,0,0,0,0,0,0,0
"Guyana","2024-03-17",0,0,0,0,0,0,0,0
"Guyana","2024-03-18",0,0,0,0,0,0,0,0
"Guyana","2024-03-19",0,0,0,0,0,0,0,0
"Guyana","2024-03-20",0,0,0,0,0,0,0,0
"Guyana","2024-03-21",0,0,0,0,0,0,0,0
"Guyana","2024-03-22",0,0,0,0,0,0,0,0
"Guyana","2024-03-23",0,0,0,0,0,0,0,0
"Guyana","2024-03-24",0,0,0,0,0,0,0,0
"Guyana","2024-03-25",0,0,0,0,0,0,0,0
"Guyana","2024-03-26",0,0,0,0,0,0,0,0
"Guyana","2024-03-27",0,0,0,0,0,0,0,0
"Guyana","2024-03-28",0,0,0,0,0,0,0,0
"Guyana","2024-03-29",0,0,0,0,0,0,0,0
"Guyana","2024-03-30",0,0,0,0,0,0,0,0
"Guyana","2024-03-31",0,0,0,0,0,0,0,0
"Guyana","2024-04-01",0,0,0,0,0,0,0,0
"Guyana","2024-04-02",0,0,0,0,0,0,0,0
"Guyana","2024-04-03",0,0,0,0,0,0,0,0
"Guyana","2024-04-04",0,0,0,0,0,0,0,0
"Guyana","2024-04-05",0,0,0,0,0,0,0,0
"Guyana","2024-04-06",0,0,0,0,0,0,0,0
"Guyana","2024-04-07",0,0,0,0,0,0,0,0
"Guyana","2024-04-08",0,0,0,0,0,0,0,0
"Guyana","2024-04-09",0,0,0,0,0,0,0,0
"Guyana","2024-04-10",0,0,0,0,0,0,0,0
"Guyana","2024-04-11",0,0,0,0,0,0,0,0
"Guyana","2024-04-12",0,0,0,0,0,0,0,0
"Guyana","2024-04-13",0,0,0,0,0,0,0,0
"Guyana","2024-04-14",0,0,0,0,0,0,0,0
"Guyana","2024-04-15",0,0,0,0,0,0,0,0
"Guyana","2024-04-16",0,0,0,0,0,0,0,0
"Guyana","2024-04-17",0,0,0,0,0,0,0,0
"Guyana","2024-04-18",0,0,0,0,0,0,0,0
"Guyana","2024-04-19",0,0,0,0,0,0,0,0
"Guyana","2024-04-20",0,0,0,0,0,0,0,0
"Guyana","2024-04-21",0,0,0,0,0,0,0,0
"Guyana","2024-04-22",0,0,0,0,0,0,0,0
"Guyana","2024-04-23",0,0,0,0,0,0,0,0
"Guyana","2024-04-24",0,0,0,0,0,0,0,0
"Guyana","2024-04-25",0,0,0,0,0,0,0,0
"Guyana","2024-04-26",0,0,0,0,0,0,0,0
"Guyana","2024-04-27",0,0,0,0,0,0,0,0
"Guyana","2024-04-28",0,0,0,0,0,0,0,0
"Guyana","2024-04-29",0,0,0,0,0,0,0,0
"Guyana","2024-04-30",0,0,0,0,0,0,0,0
"Guyana","2024-05-01",0,0,0,0,0,0,0,0
"Guyana","2024-05-02",0,0,0,0,0,0,0,0
"Guyana","2024-05-03",0,0,0,0,0,0,0,0
"Guyana","2024-05-04",0,0,0,0,0,0,0,0
"Guyana","2024-05-05",0,0,0,0,0,0,0,0
"Guyana","2024-05-06",0,0,0,0,0,0,0,0
"Guyana","2024-05-07",0,0,0,0,0,0,0,0
"Guyana","2024-05-08",0,0,0,0,0,0,0,0
"Guyana","2024-05-09",0,0,0,0,0,0,0,0
"Guyana","2024-05-10",0,0,0,0,0,0,0,0
"Guyana","2024-05-11",0,0,0,0,0,0,0,0
"Guyana","2024-05-12",0,0,0,0,0,0,0,0
"Guyana","2024-05-13",0,0,0,0,0,0,0,0
"Guyana","2024-05-14",0,0,0,0,0,0,0,0
"Guyana","2024-05-15",0,0,0,0,0,0,0,0
"Guyana","2024-05-16",0,0,0,0,0,0,0,0
"Guyana","2024-05-17",0,0,0,0,0,0,0,0
"Guyana","2024-05-18",0,0,0,0,0,0,0,0
"Guyana","2024-05-19",0,0,0,0,0,0,0,0
"Guyana","2024-05-20",0,0,0,0,0,0,0,0
"Guyana","2024-05-21",0,0,0,0,0,0,0,0
"Guyana","2024-05-22",0,0,0,0,0,0,0,0
"Guyana","2024-05-23",0,0,0,0,0,0,0,0
"Guyana","2024-05-24",0,0,0,0,0,0,0,0
"Guyana","2024-05-25",0,0,0,0,0,0,0,0
"Guyana","2024-05-26",0,0,0,0,0,0,0,0
"Guyana","2024-05-27",0,0,0,0,0,0,0,0
"Guyana","2024-05-28",0,0,0,0,0,0,0,0
"Guyana","2024-05-29",0,0,0,0,0,0,0,0
"Guyana","2024-05-30",0,0,0,0,0,0,0,0
"Guyana","2024-05-31",0,0,0,0,0,0,0,0
"Guyana","2024-06-01",0,0,0,0,0,0,0,0
"Guyana","2024-06-02",0,0,0,0,0,0,0,0
"Guyana","2024-06-03",0,0,0,0,0,0,0,0
"Guyana","2024-06-04",0,0,0,0,0,0,0,0
"Guyana","2024-06-05",0,0,0,0,0,0,0,0
"Guyana","2024-06-06",0,0,0,0,0,0,0,0
"Guyana","2024-06-07",0,0,0,0,0,0,0,0
"Guyana","2024-06-08",0,0,0,0,0,0,0,0
"Guyana","2024-06-09",0,0,0,0,0,0,0,0
"Guyana","2024-06-10",0,0,0,0,0,0,0,0
"Guyana","2024-06-11",0,0,0,0,0,0,0,0
"Guyana","2024-06-12",0,0,0,0,0,0,0,0
"Guyana","2024-06-13",0,0,0,0,0,0,0,0
"Guyana","2024-06-14",0,0,0,0,0,0,0,0
"Guyana","2024-06-15",0,0,0,0,0,0,0,0
"Guyana","2024-06-16",0,0,0,0,0,0,0,0
"Guyana","2024-06-17",0,0,0,0,0,0,0,0
"Guyana","2024-06-18",0,0,0,0,0,0,0,0
"Guyana","2024-06-19",0,0,0,0,0,0,0,0
"Guyana","2024-06-20",0,0,0,0,0,0,0,0
"Guyana","2024-06-21",0,0,0,0,0,0,0,0
"Guyana","2024-06-22",0,0,0,0,0,0,0,0
"Guyana","2024-06-23",0,0,0,0,0,0,0,0
"Guyana","2024-06-24",0,0,0,0,0,0,0,0
"Guyana","2024-06-25",0,0,0,0,0,0,0,0
"Guyana","2024-06-26",0,0,0,0,0,0,0,0
"Guyana","2024-06-27",0,0,0,0,0,0,0,0
"Guyana","2024-06-28",0,0,0,0,0,0,0,0
"Guyana","2024-06-29",0,0,0,0,0,0,0,0
"Guyana","2024-06-30",0,0,0,0,0,0,0,0
"Guyana","2024-07-01",0,0,0,0,0,0,0,0
"Guyana","2024-07-02",0,0,0,0,0,0,0,0
"Guyana","2024-07-03",0,0,0,0,0,0,0,0
"Guyana","2024-07-04",0,0,0,0,0,0,0,0
"Guyana","2024-07-05",0,0,0,0,0,0,0,0
"Guyana","2024-07-06",0,0,0,0,0,0,0,0
"Guyana","2024-07-07",0,0,0,0,0,0,0,0
"Guyana","2024-07-08",0,0,0,0,0,0,0,0
"Guyana","2024-07-09",0,0,0,0,0,0,0,0
"Guyana","2024-07-10",0,0,0,0,0,0,0,0
"Guyana","2024-07-11",0,0,0,0,0,0,0,0
"Guyana","2024-07-12",0,0,0,0,0,0,0,0
"Guyana","2024-07-13",0,0,0,0,0,0,0,0
"Guyana","2024-07-14",0,0,0,0,0,0,0,0
"Guyana","2024-07-15",0,0,0,0,0,0,0,0
"Guyana","2024-07-16",0,0,0,0,0,0,0,0
"Guyana","2024-07-17",0,0,0,0,0,0,0,0
"Guyana","2024-07-18",0,0,0,0,0,0,0,0
"Guyana","2024-07-19",0,0,0,0,0,0,0,0
"Guyana","2024-07-20",0,0,0,0,0,0,0,0
"Guyana","2024-07-21",0,0,0,0,0,0,0,0
"Guyana","2024-07-22",0,0,0,0,0,0,0,0
"Guyana","2024-07-23",0,0,0,0,0,0,0,0
"Guyana","2024-07-24",0,0,0,0,0,0,0,0
"Guyana","2024-07-25",0,0,0,0,0,0,0,0
"Guyana","2024-07-26",0,0,0,0,0,0,0,0
"Guyana","2024-07-27",0,0,0,0,0,0,0,0
"Guyana","2024-07-28",0,0,0,0,0,0,0,0
"Guyana","2024-07-29",0,0,0,0,0,0,0,0
"Guyana","2024-07-30",0,0,0,0,0,0,0,0
"Guyana","2024-07-31",0,0,0,0,0,0,0,0
"Guyana","2024-08-01",0,0,0,0,0,0,0,0
"Guyana","2024-08-02",0,0,0,0,0,0,0,0
"Guyana","2024-08-03",0,0,0,0,0,0,0,0
"Guyana","2024-08-04",0,0,0,0,0,0,0,0
"Guyana","2024-08-05",0,0,0,0,0,0,0,0
"Guyana","2024-08-06",0,0,0,0,0,0,0,0
"Guyana","2024-08-07",0,0,0,0,0,0,0,0
"Guyana","2024-08-08",0,0,0,0,0,0,0,0
"Guyana","2024-08-09",0,0,0,0,0,0,0,0
"Guyana","2024-08-10",0,0,0,0,0,0,0,0
"Guyana","2024-08-11",0,0,0,0,0,0,0,0
"Guyana","2024-08-12",0,0,0,0,0,0,0,0
"Guyana","2024-08-13",0,0,0,0,0,0,0,0
"Guyana","2024-08-14",0,0,0,0,0,0,0,0
"Guyana","2024-08-15",0,0,0,0,0,0,0,0
"Guyana","2024-08-16",0,0,0,0,0,0,0,0
"Guyana","2024-08-17",0,0,0,0,0,0,0,0
"Guyana","2024-08-18",0,0,0,0,0,0,0,0
"Guyana","2024-08-19",0,0,0,0,0,0,0,0
"Guyana","2024-08-20",0,0,0,0,0,0,0,0
"Guyana","2024-08-21",0,0,0,0,0,0,0,0
"Guyana","2024-08-22",0,0,0,0,0,0,0,0
"Guyana","2024-08-23",0,0,0,0,0,0,0,0
"Guyana","2024-08-24",0,0,0,0,0,0,0,0
"Guyana","2024-08-25",0,0,0,0,0,0,0,0
"Guyana","2024-08-26",0,0,0,0,0,0,0,0
"Guyana","2024-08-27",0,0,0,0,0,0,0,0
"Guyana","2024-08-28",0,0,0,0,0,0,0,0
"Guyana","2024-08-29",0,0,0,0,0,0,0,0
"Guyana","2024-08-30",0,0,0,0,0,0,0,0
"Guyana","2024-08-31",0,0,0,0,0,0,0,0
"Guyana","2024-09-01",0,0,0,0,0,0,0,0
"Guyana","2024-09-02",0,0,0,0,0,0,0,0
"Guyana","2024-09-03",0,0,0,0,0,0,0,0
"Guyana","2024-09-04",0,0,0,0,0,0,0,0
"Guyana","2024-09-05",0,0,0,0,0,0,0,0
"Guyana","2024-09-06",0,0,0,0,0,0,0,0
"Guyana","2024-09-07",0,0,0,0,0,0,0,0
"Guyana","2024-09-08",0,0,0,0,0,0,0,0
"Guyana","2024-09-09",0,0,0,0,0,0,0,0
"Guyana","2024-09-10",0,0,0,0,0,0,0,0
"Guyana","2024-09-11",0,0,0,0,0,0,0,0
"Guyana","2024-09-12",0,0,0,0,0,0,0,0
"Guyana","2024-09-13",0,0,0,0,0,0,0,0
"Guyana","2024-09-14",0,0,0,0,0,0,0,0
"Guyana","2024-09-15",0,0,0,0,0,0,0,0
"Guyana","2024-09-16",0,0,0,0,0,0,0,0
"Guyana","2024-09-17",0,0,0,0,0,0,0,0
"Guyana","2024-09-18",0,0,0,0,0,0,0,0
"Guyana","2024-09-19",0,0,0,0,0,0,0,0
"Guyana","2024-09-20",0,0,0,0,0,0,0,0
"Guyana","2024-09-21",0,0,0,0,0,0,0,0
"Guyana","2024-09-22",0,0,0,0,0,0,0,0
"Guyana","2024-09-23",0,0,0,0,0,0,0,0
"Guyana","2024-09-24",0,0,0,0,0,0,0,0
"Guyana","2024-09-25",0,0,0,0,0,0,0,0
"Guyana","2024-09-26",0,0,0,0,0,0,0,0
"Guyana","2024-09-27",0,0,0,0,0,0,0,0
"Guyana","2024-09-28",0,0,0,0,0,0,0,0
"Guyana","2024-09-29",0,0,0,0,0,0,0,0
"Guyana","2024-09-30",0,0,0,0,0,0,0,0
"Guyana","2024-10-01",0,0,0,0,0,0,0,0
"Guyana","2024-10-02",0,0,0,0,0,0,0,0
"Guyana","2024-10-03",0,0,0,0,0,0,0,0
"Guyana","2024-10-04",0,0,0,0,0,0,0,0
"Guyana","2024-10-05",0,0,0,0,0,0,0,0
"Guyana","2024-10-06",0,0,0,0,0,0,0,0
"Guyana","2024-10-07",0,0,0,0,0,0,0,0
"Guyana","2024-10-08",0,0,0,0,0,0,0,0
"Guyana","2024-10-09",0,0,0,0,0,0,0,0
"Guyana","2024-10-10",0,0,0,0,0,0,0,0
"Guyana","2024-10-11",0,0,0,0,0,0,0,0
"Guyana","2024-10-12",0,0,0,0,0,0,0,0
"Guyana","2024-10-13",0,0,0,0,0,0,0,0
"Guyana","2024-10-14",0,0,0,0,0,0,0,0
"Guyana","2024-10-15",0,0,0,0,0,0,0,0
"Guyana","2024-10-16",0,0,0,0,0,0,0,0
"Guyana","2024-10-17",0,0,0,0,0,0,0,0
"Guyana","2024-10-18",0,0,0,0,0,0,0,0
"Guyana","2024-10-19",0,0,0,0,0,0,0,0
"Guyana","2024-10-20",0,0,0,0,0,0,0,0
"Guyana","2024-10-21",0,0,0,0,0,0,0,0
"Guyana","2024-10-22",0,0,0,0,0,0,0,0
"Guyana","2024-10-23",0,0,0,0,0,0,0,0
"Guyana","2024-10-24",0,0,0,0,0,0,0,0
"Guyana","2024-10-25",0,0,0,0,0,0,0,0
"Guyana","2024-10-26",0,0,0,0,0,0,0,0
"Guyana","2024-10-27",0,0,0,0,0,0,0,0
"Guyana","2024-10-28",0,0,0,0,0,0,0,0
"Guyana","2024-10-29",0,0,0,0,0,0,0,0
"Guyana","2024-10-30",0,0,0,0,0,0,0,0
"Guyana","2024-10-31",0,0,0,0,0,0,0,0
"Guyana","2024-11-01",0,0,0,0,0,0,0,0
"Guyana","2024-11-02",0,0,0,0,0,0,0,0
"Guyana","2024-11-03",0,0,0,0,0,0,0,0
"Guyana","2024-11-04",0,0,0,0,0,0,0,0
"Guyana","2024-11-05",0,0,0,0,0,0,0,0
"Guyana","2024-11-06",0,0,0,0,0,0,0,0
"Guyana","2024-11-07",0,0,0,0,0,0,0,0
"Guyana","2024-11-08",0,0,0,0,0,0,0,0
"Guyana","2024-11-09",0,0,0,0,0,0,0,0
"Guyana","2024-11-10",0,0,0,0,0,0,0,0
"Guyana","2024-11-11",0,0,0,0,0,0,0,0
"Guyana","2024-11-12",0,0,0,0,0,0,0,0
"Guyana","2024-11-13",0,0,0,0,0,0,0,0
"Guyana","2024-11-14",0,0,0,0,0,0,0,0
"Guyana","2024-11-15",0,0,0,0,0,0,0,0
"Guyana","2024-11-16",0,0,0,0,0,0,0,0
"Guyana","2024-11-17",0,0,0,0,0,0,0,0
"Guyana","2024-11-18",0,0,0,0,0,0,0,0
"Guyana","2024-11-19",0,0,0,0,0,0,0,0
"Guyana","2024-11-20",0,0,0,0,0,0,0,0
"Guyana","2024-11-21",0,0,0,0,0,0,0,0
"Guyana","2024-11-22",0,0,0,0,0,0,0,0
"Guyana","2024-11-23",0,0,0,0,0,0,0,0
"Guyana","2024-11-24",0,0,0,0,0,0,0,0
"Guyana","2024-11-25",0,0,0,0,0,0,0,0
"Guyana","2024-11-26",0,0,0,0,0,0,0,0
"Guyana","2024-11-27",0,0,0,0,0,0,0,0
"Guyana","2024-11-28",0,0,0,0,0,0,0,0
"Guyana","2024-11-29",0,0,0,0,0,0,0,0
"Guyana","2024-11-30",0,0,0,0,0,0,0,0
"Guyana","2024-12-01",0,0,0,0,0,0,0,0
"Guyana","2024-12-02",0,0,0,0,0,0,0,0
"Guyana","2024-12-03",0,0,0,0,0,0,0,0
"Guyana","2024-12-04",0,0,0,0,0,0,0,0
"Guyana","2024-12-05",0,0,0,0,0,0,0,0
"Guyana","2024-12-06",0,0,0,0,0,0,0,0
"Guyana","2024-12-07",0,0,0,0,0,0,0,0
"Guyana","2024-12-08",0,0,0,0,0,0,0,0
"Guyana","2024-12-09",0,0,0,0,0,0,0,0
"Guyana","2024-12-10",0,0,0,0,0,0,0,0
"Guyana","2024-12-11",0,0,0,0,0,0,0,0
"Guyana","2024-12-12",0,0,0,0,0,0,0,0
"Guyana","2024-12-13",0,0,0,0,0,0,0,0
"Guyana","2024-12-14",0,0,0,0,0,0,0,0
"Guyana","2024-12-15",0,0,0,0,0,0,0,0
"Guyana","2024-12-16",0,0,0,0,0,0,0,0
"Guyana","2024-12-17",0,0,0,0,0,0,0,0
"Guyana","2024-12-18",0,0,0,0,0,0,0,0
"Guyana","2024-12-19",0,0,0,0,0,0,0,0
"Guyana","2024-12-20",0,0,0,0,0,0,0,0
"Guyana","2024-12-21",0,0,0,0,0,0,0,0
"Guyana","2024-12-22",0,0,0,0,0,0,0,0
"Guyana","2024-12-23",0,0,0,0,0,0,0,0
"Guyana","2024-12-24",0,0,0,0,0,0,0,0
"Guyana","2024-12-25",0,0,0,0,0,0,0,0
"Guyana","2024-12-26",0,0,0,0,0,0,0,0
"Guyana","2024-12-27",0,0,0,0,0,0,0,0
"Guyana","2024-12-28",0,0,0,0,0,0,0,0
"Guyana","2024-12-29",0,0,0,0,0,0,0,0
"Guyana","2024-12-30",0,0,0,0,0,0,0,0
"Guyana","2024-12-31",0,0,0,0,0,0,0,0
"Guyana","2025-01-01",0,0,0,0,0,0,0,0
"Guyana","2025-01-02",0,0,0,0,0,0,0,0
"Guyana","2025-01-03",0,0,0,0,0,0,0,0
"Guyana","2025-01-04",0,0,0,0,0,0,0,0
"Guyana","2025-01-05",0,0,0,0,0,0,0,0
"Guyana","2025-01-06",0,0,0,0,0,0,0,0
"Guyana","2025-01-07",0,0,0,0,0,0,0,0
"Guyana","2025-01-08",0,0,0,0,0,0,0,0
"Guyana","2025-01-09",0,0,0,0,0,0,0,0
"Guyana","2025-01-10",0,0,0,0,0,0,0,0
"Guyana","2025-01-11",0,0,0,0,0,0,0,0
"Guyana","2025-01-12",0,0,0,0,0,0,0,0
"Guyana","2025-01-13",0,0,0,0,0,0,0,0
"Guyana","2025-01-14",0,0,0,0,0,0,0,0
"Guyana","2025-01-15",0,0,0,0,0,0,0,0
"Guyana","2025-01-16",0,0,0,0,0,0,0,0
"Guyana","2025-01-17",0,0,0,0,0,0,0,0
"Guyana","2025-01-18",0,0,0,0,0,0,0,0
"Guyana","2025-01-19",0,0,0,0,0,0,0,0
"Guyana","2025-01-20",0,0,0,0,0,0,0,0
"Guyana","2025-01-21",0,0,0,0,0,0,0,0
"Guyana","2025-01-22",0,0,0,0,0,0,0,0
"Guyana","2025-01-23",0,0,0,0,0,0,0,0
"Guyana","2025-01-24",0,0,0,0,0,0,0,0
"Guyana","2025-01-25",0,0,0,0,0,0,0,0
"Guyana","2025-01-26",0,0,0,0,0,0,0,0
"Guyana","2025-01-27",0,0,0,0,0,0,0,0
"Guyana","2025-01-28",0,0,0,0,0,0,0,0
"Guyana","2025-01-29",0,0,0,0,0,0,0,0
"Guyana","2025-01-30",0,0,0,0,0,0,0,0
"Guyana","2025-01-31",0,0,0,0,0,0,0,0
"Guyana","2025-02-01",0,0,0,0,0,0,0,0
"Guyana","2025-02-02",0,0,0,0,0,0,0,0
"Guyana","2025-02-03",0,0,0,0,0,0,0,0
"Honduras","2024-01-01",0,0,0,0,0,0,0,0
"Honduras","2024-01-02",0,0,0,0,0,0,0,0
"Honduras","2024-01-03",0,0,0,0,0,0,0,0
"Honduras","2024-01-04",0,0,0,0,0,0,0,0
"Honduras","2024-01-05",0,0,0,0,0,0,0,0
"Honduras","2024-01-06",0,0,0,0,0,0,0,0
"Honduras","2024-01-07",0,0,0,0,0,0,0,0
"Honduras","2024-01-08",0,0,0,0,0,0,0,0
"Honduras","2024-01-09",0,0,0,0,0,0,0,0
"Honduras","2024-01-10",0,0,0,0,0,0,0,0
"Honduras","2024-01-11",0,0,0,0,0,0,0,0
"Honduras","2024-01-12",0,0,0,0,0,0,0,0
"Honduras","2024-01-13",0,0,0,0,0,0,0,0
"Honduras","2024-01-14",0,0,0,0,0,0,0,0
"Honduras","2024-01-15",0,0,0,0,0,0,0,0
"Honduras","2024-01-16",0,0,0,0,0,0,0,0
"Honduras","2024-01-17",0,0,0,0,0,0,0,0
"Honduras","2024-01-18",0,0,0,0,0,0,0,0
"Honduras","2024-01-19",0,0,0,0,0,0,0,0
"Honduras","2024-01-20",0,0,0,0,0,0,0,0
"Honduras","2024-01-21",0,0,0,0,0,0,0,0
"Honduras","2024-01-22",0,0,0,0,0,0,0,0
"Honduras","2024-01-23",0,0,0,0,0,0,0,0
"Honduras","2024-01-24",0,0,0,0,0,0,0,0
"Honduras","2024-01-25",0,0,0,0,0,0,0,0
"Honduras","2024-01-26",0,0,0,0,0,0,0,0
"Honduras","2024-01-27",0,0,0,0,0,0,0,0
"Honduras","2024-01-28",0,0,0,0,0,0,0,0
"Honduras","2024-01-29",0,0,0,0,0,0,0,0
"Honduras","2024-01-30",0,0,0,0,0,0,0,0
"Honduras","2024-01-31",0,0,0,0,0,0,0,0
"Honduras","2024-02-01",0,0,0,0,0,0,0,0
"Honduras","2024-02-02",0,0,0,0,0,0,0,0
"Honduras","2024-02-03",0,0,0,0,0,0,0,0
"Honduras","2024-02-04",0,0,0,0,0,0,0,0
"Honduras","2024-02-05",0,0,0,0,0,0,0,0
"Honduras","2024-02-06",0,0,0,0,0,0,0,0
"Honduras","2024-02-07",0,0,0,0,0,0,0,0
"Honduras","2024-02-08",0,0,0,0,0,0,0,0
"Honduras","2024-02-09",0,0,0,0,0,0,0,0
"Honduras","2024-02-10",0,0,0,0,0,0,0,0
"Honduras","2024-02-11",0,0,0,0,0,0,0,0
"Honduras","2024-02-12",0,0,0,0,0,0,0,0
"Honduras","2024-02-13",0,0,0,0,0,0,0,0
"Honduras","2024-02-14",0,0,0,0,0,0,0,0
"Honduras","2024-02-15",0,0,0,0,0,0,0,0
"Honduras","2024-02-16",0,0,0,0,0,0,0,0
"Honduras","2024-02-17",0,0,0,0,0,0,0,0
"Honduras","2024-02-18",0,0,0,0,0,0,0,0
"Honduras","2024-02-19",0,0,0,0,0,0,0,0
"Honduras","2024-02-20",0,0,0,0,0,0,0,0
"Honduras","2024-02-21",0,0,0,0,0,0,0,0
"Honduras","2024-02-22",0,0,0,0,0,0,0,0
"Honduras","2024-02-23",0,0,0,0,0,0,0,0
"Honduras","2024-02-24",0,0,0,0,0,0,0,0
"Honduras","2024-02-25",0,0,0,0,0,0,0,0
"Honduras","2024-02-26",0,0,0,0,0,0,0,0
"Honduras","2024-02-27",0,0,0,0,0,0,0,0
"Honduras","2024-02-28",0,0,0,0,0,0,0,0
"Honduras","2024-02-29",0,0,0,0,0,0,0,0
"Honduras","2024-03-01",0,0,0,0,0,0,0,0
"Honduras","2024-03-02",0,0,0,0,0,0,0,0
"Honduras","2024-03-03",0,0,0,0,0,0,0,0
"Honduras","2024-03-04",0,0,0,0,0,0,0,0
"Honduras","2024-03-05",0,0,0,0,0,0,0,0
"Honduras","2024-03-06",0,0,0,0,0,0,0,0
"Honduras","2024-03-07",0,0,0,0,0,0,0,0
"Honduras","2024-03-08",0,0,0,0,0,0,0,0
"Honduras","2024-03-09",0,0,0,0,0,0,0,0
"Honduras","2024-03-10",0,0,0,0,0,0,0,0
"Honduras","2024-03-11",0,0,0,0,0,0,0,0
"Honduras","2024-03-12",0,0,0,0,0,0,0,0
"Honduras","2024-03-13",0,0,0,0,0,0,0,0
"Honduras","2024-03-14",0,0,0,0,0,0,0,0
"Honduras","2024-03-15",0,0,0,0,0,0,0,0
"Honduras","2024-03-16",0,0,0,0,0,0,0,0
"Honduras","2024-03-17",0,0,0,0,0,0,0,0
"Honduras","2024-03-18",0,0,0,0,0,0,0,0
"Honduras","2024-03-19",0,0,0,0,0,0,0,0
"Honduras","2024-03-20",0,0,0,0,0,0,0,0
"Honduras","2024-03-21",0,0,0,0,0,0,0,0
"Honduras","2024-03-22",0,0,0,0,0,0,0,0
"Honduras","2024-03-23",0,0,0,0,0,0,0,0
"Honduras","2024-03-24",0,0,0,0,0,0,0,0
"Honduras","2024-03-25",0,0,0,0,0,0,0,0
"Honduras","2024-03-26",0,0,0,0,0,0,0,0
"Honduras","2024-03-27",0,0,0,0,0,0,0,0
"Honduras","2024-03-28",0,0,0,0,0,0,0,0
"Honduras","2024-03-29",0,0,0,0,0,0,0,0
"Honduras","2024-03-30",0,0,0,0,0,0,0,0
"Honduras","2024-03-31",0,0,0,0,0,0,0,0
"Honduras","2024-04-01",0,0,0,0,0,0,0,0
"Honduras","2024-04-02",0,0,0,0,0,0,0,0
"Honduras","2024-04-03",0,0,0,0,0,0,0,0
"Honduras","2024-04-04",0,0,0,0,0,0,0,0
"Honduras","2024-04-05",0,0,0,0,0,0,0,0
"Honduras","2024-04-06",0,0,0,0,0,0,0,0
"Honduras","2024-04-07",0,0,0,0,0,0,0,0
"Honduras","2024-04-08",0,0,0,0,0,0,0,0
"Honduras","2024-04-09",0,0,0,0,0,0,0,0
"Honduras","2024-04-10",0,0,0,0,0,0,0,0
"Honduras","2024-04-11",0,0,0,0,0,0,0,0
"Honduras","2024-04-12",0,0,0,0,0,0,0,0
"Honduras","2024-04-13",0,0,0,0,0,0,0,0
"Honduras","2024-04-14",0,0,0,0,0,0,0,0
"Honduras","2024-04-15",0,0,0,0,0,0,0,0
"Honduras","2024-04-16",0,0,0,0,0,0,0,0
"Honduras","2024-04-17",0,0,0,0,0,0,0,0
"Honduras","2024-04-18",0,0,0,0,0,0,0,0
"Honduras","2024-04-19",0,0,0,0,0,0,0,0
"Honduras","2024-04-20",0,0,0,0,0,0,0,0
"Honduras","2024-04-21",0,0,0,0,0,0,0,0
"Honduras","2024-04-22",0,0,0,0,0,0,0,0
"Honduras","2024-04-23",0,0,0,0,0,0,0,0
"Honduras","2024-04-24",0,0,0,0,0,0,0,0
"Honduras","2024-04-25",0,0,0,0,0,0,0,0
"Honduras","2024-04-26",0,0,0,0,0,0,0,0
"Honduras","2024-04-27",0,0,0,0,0,0,0,0
"Honduras","2024-04-28",0,0,0,0,0,0,0,0
"Honduras","2024-04-29",0,0,0,0,0,0,0,0
"Honduras","2024-04-30",0,0,0,0,0,0,0,0
"Honduras","2024-05-01",0,0,0,0,0,0,0,0
"Honduras","2024-05-02",0,0,0,0,0,0,0,0
"Honduras","2024-05-03",0,0,0,0,0,0,0,0
"Honduras","2024-05-04",0,0,0,0,0,0,0,0
"Honduras","2024-05-05",0,0,0,0,0,0,0,0
"Honduras","2024-05-06",0,0,0,0,0,0,0,0
"Honduras","2024-05-07",0,0,0,0,0,0,0,0
"Honduras","2024-05-08",0,0,0,0,0,0,0,0
"Honduras","2024-05-09",0,0,0,0,0,0,0,0
"Honduras","2024-05-10",0,0,0,0,0,0,0,0
"Honduras","2024-05-11",0,0,0,0,0,0,0,0
"Honduras","2024-05-12",0,0,0,0,0,0,0,0
"Honduras","2024-05-13",0,0,0,0,0,0,0,0
"Honduras","2024-05-14",0,0,0,0,0,0,0,0
"Honduras","2024-05-15",0,0,0,0,0,0,0,0
"Honduras","2024-05-16",0,0,0,0,0,0,0,0
"Honduras","2024-05-17",0,0,0,0,0,0,0,0
"Honduras","2024-05-18",0,0,0,0,0,0,0,0
"Honduras","2024-05-19",0,0,0,0,0,0,0,0
"Honduras","2024-05-20",0,0,0,0,0,0,0,0
"Honduras","2024-05-21",0,0,0,0,0,0,0,0
"Honduras","2024-05-22",0,0,0,0,0,0,0,0
"Honduras","2024-05-23",0,0,0,0,0,0,0,0
"Honduras","2024-05-24",0,0,0,0,0,0,0,0
"Honduras","2024-05-25",0,0,0,0,0,0,0,0
"Honduras","2024-05-26",0,0,0,0,0,0,0,0
"Honduras","2024-05-27",0,0,0,0,0,0,0,0
"Honduras","2024-05-28",0,0,0,0,0,0,0,0
"Honduras","2024-05-29",0,0,0,0,0,0,0,0
"Honduras","2024-05-30",0,0,0,0,0,0,0,0
"Honduras","2024-05-31",0,0,0,0,0,0,0,0
"Honduras","2024-06-01",0,0,0,0,0,0,0,0
"Honduras","2024-06-02",0,0,0,0,0,0,0,0
"Honduras","2024-06-03",0,0,0,0,0,0,0,0
"Honduras","2024-06-04",0,0,0,0,0,0,0,0
"Honduras","2024-06-05",0,0,0,0,0,0,0,0
"Honduras","2024-06-06",0,0,0,0,0,0,0,0
"Honduras","2024-06-07",0,0,0,0,0,0,0,0
"Honduras","2024-06-08",0,0,0,0,0,0,0,0
"Honduras","2024-06-09",0,0,0,0,0,0,0,0
"Honduras","2024-06-10",0,0,0,0,0,0,0,0
"Honduras","2024-06-11",0,0,0,0,0,0,0,0
"Honduras","2024-06-12",0,0,0,0,0,0,0,0
"Honduras","2024-06-13",0,0,0,0,0,0,0,0
"Honduras","2024-06-14",0,0,0,0,0,0,0,0
"Honduras","2024-06-15",0,0,0,0,0,0,0,0
"Honduras","2024-06-16",0,0,0,0,0,0,0,0
"Honduras","2024-06-17",0,0,0,0,0,0,0,0
"Honduras","2024-06-18",0,0,0,0,0,0,0,0
"Honduras","2024-06-19",0,0,0,0,0,0,0,0
"Honduras","2024-06-20",0,0,0,0,0,0,0,0
"Honduras","2024-06-21",0,0,0,0,0,0,0,0
"Honduras","2024-06-22",0,0,0,0,0,0,0,0
"Honduras","2024-06-23",0,0,0,0,0,0,0,0
"Honduras","2024-06-24",0,0,0,0,0,0,0,0
"Honduras","2024-06-25",0,0,0,0,0,0,0,0
"Honduras","2024-06-26",0,0,0,0,0,0,0,0
"Honduras","2024-06-27",0,0,0,0,0,0,0,0
"Honduras","2024-06-28",0,0,0,0,0,0,0,0
"Honduras","2024-06-29",0,0,0,0,0,0,0,0
"Honduras","2024-06-30",0,0,0,0,0,0,0,0
"Honduras","2024-07-01",0,0,0,0,0,0,0,0
"Honduras","2024-07-02",0,0,0,0,0,0,0,0
"Honduras","2024-07-03",0,0,0,0,0,0,0,0
"Honduras","2024-07-04",0,0,0,0,0,0,0,0
"Honduras","2024-07-05",0,0,0,0,0,0,0,0
"Honduras","2024-07-06",0,0,0,0,0,0,0,0
"Honduras","2024-07-07",0,0,0,0,0,0,0,0
"Honduras","2024-07-08",0,0,0,0,0,0,0,0
"Honduras","2024-07-09",0,0,0,0,0,0,0,0
"Honduras","2024-07-10",0,0,0,0,0,0,0,0
"Honduras","2024-07-11",0,0,0,0,0,0,0,0
"Honduras","2024-07-12",0,0,0,0,0,0,0,0
"Honduras","2024-07-13",0,0,0,0,0,0,0,0
"Honduras","2024-07-14",0,0,0,0,0,0,0,0
"Honduras","2024-07-15",0,0,0,0,0,0,0,0
"Honduras","2024-07-16",0,0,0,0,0,0,0,0
"Honduras","2024-07-17",0,0,0,0,0,0,0,0
"Honduras","2024-07-18",0,0,0,0,0,0,0,0
"Honduras","2024-07-19",0,0,0,0,0,0,0,0
"Honduras","2024-07-20",0,0,0,0,0,0,0,0
"Honduras","2024-07-21",0,0,0,0,0,0,0,0
"Honduras","2024-07-22",0,0,0,0,0,0,0,0
"Honduras","2024-07-23",0,0,0,0,0,0,0,0
"Honduras","2024-07-24",0,0,0,0,0,0,0,0
"Honduras","2024-07-25",0,0,0,0,0,0,0,0
"Honduras","2024-07-26",0,0,0,0,0,0,0,0
"Honduras","2024-07-27",0,0,0,0,0,0,0,0
"Honduras","2024-07-28",0,0,0,0,0,0,0,0
"Honduras","2024-07-29",0,0,0,0,0,0,0,0
"Honduras","2024-07-30",0,0,0,0,0,0,0,0
"Honduras","2024-07-31",0,0,0,0,0,0,0,0
"Honduras","2024-08-01",0,0,0,0,0,0,0,0
"Honduras","2024-08-02",0,0,0,0,0,0,0,0
"Honduras","2024-08-03",0,0,0,0,0,0,0,0
"Honduras","2024-08-04",0,0,0,0,0,0,0,0
"Honduras","2024-08-05",0,0,0,0,0,0,0,0
"Honduras","2024-08-06",0,0,0,0,0,0,0,0
"Honduras","2024-08-07",0,0,0,0,0,0,0,0
"Honduras","2024-08-08",0,0,0,0,0,0,0,0
"Honduras","2024-08-09",0,0,0,0,0,0,0,0
"Honduras","2024-08-10",0,0,0,0,0,0,0,0
"Honduras","2024-08-11",0,0,0,0,0,0,0,0
"Honduras","2024-08-12",0,0,0,0,0,0,0,0
"Honduras","2024-08-13",0,0,0,0,0,0,0,0
"Honduras","2024-08-14",0,0,0,0,0,0,0,0
"Honduras","2024-08-15",0,0,0,0,0,0,0,0
"Honduras","2024-08-16",0,0,0,0,0,0,0,0
"Honduras","2024-08-17",0,0,0,0,0,0,0,0
"Honduras","2024-08-18",0,0,0,0,0,0,0,0
"Honduras","2024-08-19",0,0,0,0,0,0,0,0
"Honduras","2024-08-20",0,0,0,0,0,0,0,0
"Honduras","2024-08-21",0,0,0,0,0,0,0,0
"Honduras","2024-08-22",0,0,0,0,0,0,0,0
"Honduras","2024-08-23",0,0,0,0,0,0,0,0
"Honduras","2024-08-24",0,0,0,0,0,0,0,0
"Honduras","2024-08-25",0,0,0,0,0,0,0,0
"Honduras","2024-08-26",0,0,0,0,0,0,0,0
"Honduras","2024-08-27",0,0,0,0,0,0,0,0
"Honduras","2024-08-28",0,0,0,0,0,0,0,0
"Honduras","2024-08-29",0,0,0,0,0,0,0,0
"Honduras","2024-08-30",0,0,0,0,0,0,0,0
"Honduras","2024-08-31",0,0,0,0,0,0,0,0
"Honduras","2024-09-01",0,0,0,0,0,0,0,0
"Honduras","2024-09-02",0,0,0,0,0,0,0,0
"Honduras","2024-09-03",0,0,0,0,0,0,0,0
"Honduras","2024-09-04",0,0,0,0,0,0,0,0
"Honduras","2024-09-05",0,0,0,0,0,0,0,0
"Honduras","2024-09-06",0,0,0,0,0,0,0,0
"Honduras","2024-09-07",0,0,0,0,0,0,0,0
"Honduras","2024-09-08",0,0,0,0,0,0,0,0
"Honduras","2024-09-09",0,0,0,0,0,0,0,0
"Honduras","2024-09-10",0,0,0,0,0,0,0,0
"Honduras","2024-09-11",0,0,0,0,0,0,0,0
"Honduras","2024-09-12",0,0,0,0,0,0,0,0
"Honduras","2024-09-13",0,0,0,0,0,0,0,0
"Honduras","2024-09-14",0,0,0,0,0,0,0,0
"Honduras","2024-09-15",0,0,0,0,0,0,0,0
"Honduras","2024-09-16",0,0,0,0,0,0,0,0
"Honduras","2024-09-17",0,0,0,0,0,0,0,0
"Honduras","2024-09-18",0,0,0,0,0,0,0,0
"Honduras","2024-09-19",0,0,0,0,0,0,0,0
"Honduras","2024-09-20",0,0,0,0,0,0,0,0
"Honduras","2024-09-21",0,0,0,0,0,0,0,0
"Honduras","2024-09-22",0,0,0,0,0,0,0,0
"Honduras","2024-09-23",0,0,0,0,0,0,0,0
"Honduras","2024-09-24",0,0,0,0,0,0,0,0
"Honduras","2024-09-25",0,0,0,0,0,0,0,0
"Honduras","2024-09-26",0,0,0,0,0,0,0,0
"Honduras","2024-09-27",0,0,0,0,0,0,0,0
"Honduras","2024-09-28",0,0,0,0,0,0,0,0
"Honduras","2024-09-29",0,0,0,0,0,0,0,0
"Honduras","2024-09-30",0,0,0,0,0,0,0,0
"Honduras","2024-10-01",0,0,0,0,0,0,0,0
"Honduras","2024-10-02",0,0,0,0,0,0,0,0
"Honduras","2024-10-03",0,0,0,0,0,0,0,0
"Honduras","2024-10-04",0,0,0,0,0,0,0,0
"Honduras","2024-10-05",0,0,0,0,0,0,0,0
"Honduras","2024-10-06",0,0,0,0,0,0,0,0
"Honduras","2024-10-07",0,0,0,0,0,0,0,0
"Honduras","2024-10-08",0,0,0,0,0,0,0,0
"Honduras","2024-10-09",0,0,0,0,0,0,0,0
"Honduras","2024-10-10",0,0,0,0,0,0,0,0
"Honduras","2024-10-11",0,0,0,0,0,0,0,0
"Honduras","2024-10-12",0,0,0,0,0,0,0,0
"Honduras","2024-10-13",0,0,0,0,0,0,0,0
"Honduras","2024-10-14",0,0,0,0,0,0,0,0
"Honduras","2024-10-15",0,0,0,0,0,0,0,0
"Honduras","2024-10-16",0,0,0,0,0,0,0,0
"Honduras","2024-10-17",0,0,0,0,0,0,0,0
"Honduras","2024-10-18",0,0,0,0,0,0,0,0
"Honduras","2024-10-19",0,0,0,0,0,0,0,0
"Honduras","2024-10-20",0,0,0,0,0,0,0,0
"Honduras","2024-10-21",0,0,0,0,0,0,0,0
"Honduras","2024-10-22",0,0,0,0,0,0,0,0
"Honduras","2024-10-23",0,0,0,0,0,0,0,0
"Honduras","2024-10-24",0,0,0,0,0,0,0,0
"Honduras","2024-10-25",0,0,0,0,0,0,0,0
"Honduras","2024-10-26",0,0,0,0,0,0,0,0
"Honduras","2024-10-27",0,0,0,0,0,0,0,0
"Honduras","2024-10-28",0,0,0,0,0,0,0,0
"Honduras","2024-10-29",0,0,0,0,0,0,0,0
"Honduras","2024-10-30",0,0,0,0,0,0,0,0
"Honduras","2024-10-31",0,0,0,0,0,0,0,0
"Honduras","2024-11-01",0,0,0,0,0,0,0,0
"Honduras","2024-11-02",0,0,0,0,0,0,0,0
"Honduras","2024-11-03",0,0,0,0,0,0,0,0
"Honduras","2024-11-04",0,0,0,0,0,0,0,0
"Honduras","2024-11-05",0,0,0,0,0,0,0,0
"Honduras","2024-11-06",0,0,0,0,0,0,0,0
"Honduras","2024-11-07",0,0,0,0,0,0,0,0
"Honduras","2024-11-08",0,0,0,0,0,0,0,0
"Honduras","2024-11-09",0,0,0,0,0,0,0,0
"Honduras","2024-11-10",0,0,0,0,0,0,0,0
"Honduras","2024-11-11",0,0,0,0,0,0,0,0
"Honduras","2024-11-12",0,0,0,0,0,0,0,0
"Honduras","2024-11-13",0,0,0,0,0,0,0,0
"Honduras","2024-11-14",0,0,0,0,0,0,0,0
"Honduras","2024-11-15",0,0,0,0,0,0,0,0
"Honduras","2024-11-16",0,0,0,0,0,0,0,0
"Honduras","2024-11-17",0,0,0,0,0,0,0,0
"Honduras","2024-11-18",0,0,0,0,0,0,0,0
"Honduras","2024-11-19",0,0,0,0,0,0,0,0
"Honduras","2024-11-20",0,0,0,0,0,0,0,0
"Honduras","2024-11-21",0,0,0,0,0,0,0,0
"Honduras","2024-11-22",0,0,0,0,0,0,0,0
"Honduras","2024-11-23",0,0,0,0,0,0,0,0
"Honduras","2024-11-24",0,0,0,0,0,0,0,0
"Honduras","2024-11-25",0,0,0,0,0,0,0,0
"Honduras","2024-11-26",0,0,0,0,0,0,0,0
"Honduras","2024-11-27",0,0,0,0,0,0,0,0
"Honduras","2024-11-28",0,0,0,0,0,0,0,0
"Honduras","2024-11-29",0,0,0,0,0,0,0,0
"Honduras","2024-11-30",0,0,0,0,0,0,0,0
"Honduras","2024-12-01",0,0,0,0,0,0,0,0
"Honduras","2024-12-02",0,0,0,0,0,0,0,0
"Honduras","2024-12-03",0,0,0,0,0,0,0,0
"Honduras","2024-12-04",0,0,0,0,0,0,0,0
"Honduras","2024-12-05",0,0,0,0,0,0,0,0
"Honduras","2024-12-06",0,0,0,0,0,0,0,0
"Honduras","2024-12-07",0,0,0,0,0,0,0,0
"Honduras","2024-12-08",0,0,0,0,0,0,0,0
"Honduras","2024-12-09",0,0,0,0,0,0,0,0
"Honduras","2024-12-10",0,0,0,0,0,0,0,0
"Honduras","2024-12-11",0,0,0,0,0,0,0,0
"Honduras","2024-12-12",0,0,0,0,0,0,0,0
"Honduras","2024-12-13",0,0,0,0,0,0,0,0
"Honduras","2024-12-14",0,0,0,0,0,0,0,0
"Honduras","2024-12-15",0,0,0,0,0,0,0,0
"Honduras","2024-12-16",0,0,0,0,0,0,0,0
"Honduras","2024-12-17",0,0,0,0,0,0,0,0
"Honduras","2024-12-18",0,0,0,0,0,0,0,0
"Honduras","2024-12-19",0,0,0,0,0,0,0,0
"Honduras","2024-12-20",0,0,0,0,0,0,0,0
"Honduras","2024-12-21",0,0,0,0,0,0,0,0
"Honduras","2024-12-22",0,0,0,0,0,0,0,0
"Honduras","2024-12-23",0,0,0,0,0,0,0,0
"Honduras","2024-12-24",0,0,0,0,0,0,0,0
"Honduras","2024-12-25",0,0,0,0,0,0,0,0
"Honduras","2024-12-26",0,0,0,0,0,0,0,0
"Honduras","2024-12-27",0,0,0,0,0,0,0,0
"Honduras","2024-12-28",0,0,0,0,0,0,0,0
"Honduras","2024-12-29",0,0,0,0,0,0,0,0
"Honduras","2024-12-30",0,0,0,0,0,0,0,0
"Honduras","2024-12-31",0,0,0,0,0,0,0,0
"Honduras","2025-01-01",0,0,0,0,0,0,0,0
"Honduras","2025-01-02",0,0,0,0,0,0,0,0
"Honduras","2025-01-03",0,0,0,0,0,0,0,0
"Honduras","2025-01-04",0,0,0,0,0,0,0,0
"Honduras","2025-01-05",0,0,0,0,0,0,0,0
"Honduras","2025-01-06",0,0,0,0,0,0,0,0
"Honduras","2025-01-07",0,0,0,0,0,0,0,0
"Honduras","2025-01-08",0,0,0,0,0,0,0,0
"Honduras","2025-01-09",0,0,0,0,0,0,0,0
"Honduras","2025-01-10",0,0,0,0,0,0,0,0
"Honduras","2025-01-11",0,0,0,0,0,0,0,0
"Honduras","2025-01-12",0,0,0,0,0,0,0,0
"Honduras","2025-01-13",0,0,0,0,0,0,0,0
"Honduras","2025-01-14",0,0,0,0,0,0,0,0
"Honduras","2025-01-15",0,0,0,0,0,0,0,0
"Honduras","2025-01-16",0,0,0,0,0,0,0,0
"Honduras","2025-01-17",0,0,0,0,0,0,0,0
"Honduras","2025-01-18",0,0,0,0,0,0,0,0
"Honduras","2025-01-19",0,0,0,0,0,0,0,0
"Honduras","2025-01-20",0,0,0,0,0,0,0,0
"Honduras","2025-01-21",0,0,0,0,0,0,0,0
"Honduras","2025-01-22",0,0,0,0,0,0,0,0
"Honduras","2025-01-23",0,0,0,0,0,0,0,0
"Honduras","2025-01-24",0,0,0,0,0,0,0,0
"Honduras","2025-01-25",0,0,0,0,0,0,0,0
"Honduras","2025-01-26",0,0,0,0,0,0,0,0
"Honduras","2025-01-27",0,0,0,0,0,0,0,0
"Honduras","2025-01-28",0,0,0,0,0,0,0,0
"Honduras","2025-01-29",0,0,0,0,0,0,0,0
"Honduras","2025-01-30",0,0,0,0,0,0,0,0
"Honduras","2025-01-31",0,0,0,0,0,0,0,0
"Honduras","2025-02-01",0,0,0,0,0,0,0,0
"Honduras","2025-02-02",0,0,0,0,0,0,0,0
"Honduras","2025-02-03",0,0,0,0,0,0,0,0
"Hungary","2024-01-01",0,0,0,0,0,0,0,0
"Hungary","2024-01-02",0,0,0,0,0,0,0,0
"Hungary","2024-01-03",0,0,0,0,0,0,0,0
"Hungary","2024-01-04",0,0,0,0,0,0,0,0
"Hungary","2024-01-05",0,0,0,0,0,0,0,0
"Hungary","2024-01-06",0,0,0,0,0,0,0,0
"Hungary","2024-01-07",0,0,0,0,0,0,0,0
"Hungary","2024-01-08",0,0,0,0,0,0,0,0
"Hungary","2024-01-09",0,0,0,0,0,0,0,0
"Hungary","2024-01-10",0,0,0,0,0,0,0,0
"Hungary","2024-01-11",0,0,0,0,0,0,0,0
"Hungary","2024-01-12",0,0,0,0,0,0,0,0
"Hungary","2024-01-13",0,0,0,0,0,0,0,0
"Hungary","2024-01-14",0,0,0,0,0,0,0,0
"Hungary","2024-01-15",0,0,0,0,0,0,0,0
"Hungary","2024-01-16",0,0,0,0,0,0,0,0
"Hungary","2024-01-17",0,0,0,0,0,0,0,0
"Hungary","2024-01-18",0,0,0,0,0,0,0,0
"Hungary","2024-01-19",0,0,0,0,0,0,0,0
"Hungary","2024-01-20",0,0,0,0,0,0,0,0
"Hungary","2024-01-21",0,0,0,0,0,0,0,0
"Hungary","2024-01-22",0,0,0,0,0,0,0,0
"Hungary","2024-01-23",0,0,0,0,0,0,0,0
"Hungary","2024-01-24",0,0,0,0,0,0,0,0
"Hungary","2024-01-25",0,0,0,0,0,0,0,0
"Hungary","2024-01-26",0,0,0,0,0,0,0,0
"Hungary","2024-01-27",0,0,0,0,0,0,0,0
"Hungary","2024-01-28",0,0,0,0,0,0,0,0
"Hungary","2024-01-29",0,0,0,0,0,0,0,0
"Hungary","2024-01-30",0,0,0,0,0,0,0,0
"Hungary","2024-01-31",0,1,1,0,1,1,0,0
"Hungary","2024-02-01",0,0,1,0,0,1,0,0
"Hungary","2024-02-02",0,0,1,0,0,1,0,0
"Hungary","2024-02-03",0,0,1,0,0,1,0,0
"Hungary","2024-02-04",0,0,1,0,0,1,0,0
"Hungary","2024-02-05",0,0,1,0,0,1,0,0
"Hungary","2024-02-06",0,0,1,0,0,1,0,0
"Hungary","2024-02-07",0,0,1,0,0,1,0,0
"Hungary","2024-02-08",0,0,1,0,0,1,0,0
"Hungary","2024-02-09",0,0,1,0,0,1,0,0
"Hungary","2024-02-10",0,0,1,0,0,1,0,0
"Hungary","2024-02-11",0,0,1,0,0,1,0,0
"Hungary","2024-02-12",0,0,1,0,0,1,0,0
"Hungary","2024-02-13",0,0,1,0,0,1,0,0
"Hungary","2024-02-14",0,0,1,0,0,1,0,0
"Hungary","2024-02-15",0,0,1,0,0,1,0,0
"Hungary","2024-02-16",0,0,1,0,0,1,0,0
"Hungary","2024-02-17",0,0,1,0,0,1,0,0
"Hungary","2024-02-18",0,0,1,0,0,1,0,0
"Hungary","2024-02-19",0,0,1,0,0,1,0,0
"Hungary","2024-02-20",0,0,1,0,0,1,0,0
"Hungary","2024-02-21",0,0,1,0,0,1,0,0
"Hungary","2024-02-22",0,0,1,0,0,1,0,0
"Hungary","2024-02-23",0,0,1,0,0,1,0,0
"Hungary","2024-02-24",0,0,1,0,0,1,0,0
"Hungary","2024-02-25",0,0,1,0,0,1,0,0
"Hungary","2024-02-26",0,0,1,0,0,1,0,0
"Hungary","2024-02-27",0,0,1,0,0,1,0,0
"Hungary","2024-02-28",0,0,1,0,0,1,0,0
"Hungary","2024-02-29",0,0,1,0,0,1,0,0
"Hungary","2024-03-01",0,0,1,0,0,1,0,0
"Hungary","2024-03-02",0,0,1,0,0,1,0,0
"Hungary","2024-03-03",0,0,1,0,0,1,0,0
"Hungary","2024-03-04",0,0,1,0,0,1,0,0
"Hungary","2024-03-05",0,0,1,0,0,1,0,0
"Hungary","2024-03-06",0,0,1,0,0,1,0,0
"Hungary","2024-03-07",0,0,1,0,0,1,0,0
"Hungary","2024-03-08",0,0,1,0,0,1,0,0
"Hungary","2024-03-09",0,0,1,0,1,2,0,0
"Hungary","2024-03-10",0,0,1,0,0,2,0,0
"Hungary","2024-03-11",0,0,1,0,0,2,0,0
"Hungary","2024-03-12",0,0,1,0,0,2,0,0
"Hungary","2024-03-13",0,0,1,0,0,2,0,0
"Hungary","2024-03-14",0,0,1,0,0,2,0,0
"Hungary","2024-03-15",0,0,1,0,0,2,0,0
"Hungary","2024-03-16",0,0,1,0,0,2,0,0
"Hungary","2024-03-17",0,0,1,0,0,2,0,0
"Hungary","2024-03-18",0,0,1,0,0,2,0,0
"Hungary","2024-03-19",0,0,1,0,0,2,0,0
"Hungary","2024-03-20",0,0,1,0,0,2,0,0
"Hungary","2024-03-21",0,0,1,0,0,2,0,0
"Hungary","2024-03-22",0,0,1,0,0,2,0,0
"Hungary","2024-03-23",0,0,1,0,0,2,0,0
"Hungary","2024-03-24",0,0,1,0,0,2,0,0
"Hungary","2024-03-25",0,0,1,0,0,2,0,0
"Hungary","2024-03-26",0,0,1,0,0,2,0,0
"Hungary","2024-03-27",0,0,1,0,0,2,0,0
"Hungary","2024-03-28",0,0,1,0,0,2,0,0
"Hungary","2024-03-29",0,0,1,0,0,2,0,0
"Hungary","2024-03-30",0,0,1,0,0,2,0,0
"Hungary","2024-03-31",0,0,1,0,0,2,0,0
"Hungary","2024-04-01",0,0,1,0,0,2,0,0
"Hungary","2024-04-02",0,0,1,0,0,2,0,0
"Hungary","2024-04-03",0,0,1,0,0,2,0,0
"Hungary","2024-04-04",0,0,1,0,0,2,0,0
"Hungary","2024-04-05",0,0,1,0,0,2,0,0
"Hungary","2024-04-06",0,0,1,0,0,2,0,0
"Hungary","2024-04-07",0,0,1,0,0,2,0,0
"Hungary","2024-04-08",0,0,1,0,0,2,0,0
"Hungary","2024-04-09",0,0,1,0,0,2,0,0
"Hungary","2024-04-10",0,0,1,0,0,2,0,0
"Hungary","2024-04-11",0,0,1,0,0,2,0,0
"Hungary","2024-04-12",0,0,1,0,0,2,0,0
"Hungary","2024-04-13",0,0,1,0,0,2,0,0
"Hungary","2024-04-14",0,0,1,0,0,2,0,0
"Hungary","2024-04-15",0,0,1,0,0,2,0,0
"Hungary","2024-04-16",0,0,1,0,0,2,0,0
"Hungary","2024-04-17",0,0,1,0,0,2,0,0
"Hungary","2024-04-18",0,0,1,0,0,2,0,0
"Hungary","2024-04-19",0,0,1,0,0,2,0,0
"Hungary","2024-04-20",0,0,1,0,0,2,0,0
"Hungary","2024-04-21",0,0,1,0,0,2,0,0
"Hungary","2024-04-22",0,0,1,0,0,2,0,0
"Hungary","2024-04-23",0,0,1,0,0,2,0,0
"Hungary","2024-04-24",0,0,1,0,0,2,0,0
"Hungary","2024-04-25",0,0,1,0,0,2,0,0
"Hungary","2024-04-26",0,0,1,0,0,2,0,0
"Hungary","2024-04-27",0,0,1,0,0,2,0,0
"Hungary","2024-04-28",0,0,1,0,0,2,0,0
"Hungary","2024-04-29",0,0,1,0,0,2,0,0
"Hungary","2024-04-30",0,0,1,0,0,2,0,0
"Hungary","2024-05-01",0,0,1,0,0,2,0,0
"Hungary","2024-05-02",0,0,1,0,0,2,0,0
"Hungary","2024-05-03",0,0,1,0,0,2,0,0
"Hungary","2024-05-04",0,0,1,0,0,2,0,0
"Hungary","2024-05-05",0,0,1,0,0,2,0,0
"Hungary","2024-05-06",0,0,1,0,0,2,0,0
"Hungary","2024-05-07",0,0,1,0,0,2,0,0
"Hungary","2024-05-08",0,0,1,0,0,2,0,0
"Hungary","2024-05-09",0,0,1,0,0,2,0,0
"Hungary","2024-05-10",0,0,1,0,0,2,0,0
"Hungary","2024-05-11",0,0,1,0,0,2,0,0
"Hungary","2024-05-12",0,0,1,0,0,2,0,0
"Hungary","2024-05-13",0,0,1,0,0,2,0,0
"Hungary","2024-05-14",0,0,1,0,0,2,0,0
"Hungary","2024-05-15",0,0,1,0,0,2,0,0
"Hungary","2024-05-16",0,0,1,0,0,2,0,0
"Hungary","2024-05-17",0,0,1,0,0,2,0,0
"Hungary","2024-05-18",0,0,1,0,0,2,0,0
"Hungary","2024-05-19",0,0,1,0,0,2,0,0
"Hungary","2024-05-20",0,0,1,0,0,2,0,0
"Hungary","2024-05-21",0,0,1,0,0,2,0,0
"Hungary","2024-05-22",0,0,1,0,0,2,0,0
"Hungary","2024-05-23",0,0,1,0,0,2,0,0
"Hungary","2024-05-24",0,0,1,0,1,3,0,0
"Hungary","2024-05-25",0,0,1,0,0,3,0,0
"Hungary","2024-05-26",0,0,1,0,0,3,0,0
"Hungary","2024-05-27",0,0,1,0,0,3,0,0
"Hungary","2024-05-28",0,0,1,0,0,3,0,0
"Hungary","2024-05-29",0,0,1,0,0,3,0,0
"Hungary","2024-05-30",0,0,1,0,0,3,0,0
"Hungary","2024-05-31",0,0,1,0,0,3,0,0
"Hungary","2024-06-01",0,0,1,0,0,3,0,0
"Hungary","2024-06-02",0,0,1,0,0,3,0,0
"Hungary","2024-06-03",0,0,1,0,0,3,0,0
"Hungary","2024-06-04",0,0,1,0,0,3,0,0
"Hungary","2024-06-05",0,0,1,0,0,3,0,0
"Hungary","2024-06-06",0,0,1,0,0,3,0,0
"Hungary","2024-06-07",0,0,1,0,0,3,0,0
"Hungary","2024-06-08",0,0,1,0,0,3,0,0
"Hungary","2024-06-09",0,0,1,0,0,3,0,0
"Hungary","2024-06-10",0,0,1,0,0,3,0,0
"Hungary","2024-06-11",0,0,1,0,0,3,0,0
"Hungary","2024-06-12",0,0,1,0,0,3,0,0
"Hungary","2024-06-13",0,0,1,0,0,3,0,0
"Hungary","2024-06-14",0,0,1,0,0,3,0,0
"Hungary","2024-06-15",0,0,1,0,0,3,0,0
"Hungary","2024-06-16",0,0,1,0,0,3,0,0
"Hungary","2024-06-17",0,0,1,0,0,3,0,0
"Hungary","2024-06-18",0,0,1,0,0,3,0,0
"Hungary","2024-06-19",0,0,1,0,0,3,0,0
"Hungary","2024-06-20",0,0,1,0,0,3,0,0
"Hungary","2024-06-21",0,0,1,0,0,3,0,0
"Hungary","2024-06-22",0,0,1,0,0,3,0,0
"Hungary","2024-06-23",0,0,1,0,0,3,0,0
"Hungary","2024-06-24",0,0,1,0,0,3,0,0
"Hungary","2024-06-25",0,0,1,0,0,3,0,0
"Hungary","2024-06-26",0,0,1,0,0,3,0,0
"Hungary","2024-06-27",0,0,1,0,0,3,0,0
"Hungary","2024-06-28",0,0,1,0,0,3,0,0
"Hungary","2024-06-29",0,0,1,0,0,3,0,0
"Hungary","2024-06-30",0,2,3,0,0,3,0,0
"Hungary","2024-07-01",0,0,3,0,0,3,0,0
"Hungary","2024-07-02",0,0,3,0,0,3,0,0
"Hungary","2024-07-03",0,0,3,0,0,3,0,0
"Hungary","2024-07-04",0,0,3,0,0,3,0,0
"Hungary","2024-07-05",0,0,3,0,0,3,0,0
"Hungary","2024-07-06",0,0,3,0,0,3,0,0
"Hungary","2024-07-07",0,0,3,0,0,3,0,0
"Hungary","2024-07-08",0,0,3,0,0,3,0,0
"Hungary","2024-07-09",0,0,3,0,0,3,0,0
"Hungary","2024-07-10",0,0,3,0,0,3,0,0
"Hungary","2024-07-11",0,0,3,0,0,3,0,0
"Hungary","2024-07-12",0,0,3,0,0,3,0,0
"Hungary","2024-07-13",0,0,3,0,0,3,0,0
"Hungary","2024-07-14",0,0,3,0,0,3,0,0
"Hungary","2024-07-15",0,0,3,0,0,3,0,0
"Hungary","2024-07-16",0,0,3,0,0,3,0,0
"Hungary","2024-07-17",0,0,3,0,0,3,0,0
"Hungary","2024-07-18",0,0,3,0,0,3,0,0
"Hungary","2024-07-19",0,0,3,0,0,3,0,0
"Hungary","2024-07-20",0,0,3,0,0,3,0,0
"Hungary","2024-07-21",0,0,3,0,0,3,0,0
"Hungary","2024-07-22",0,0,3,0,0,3,0,0
"Hungary","2024-07-23",0,0,3,0,0,3,0,0
"Hungary","2024-07-24",0,0,3,0,0,3,0,0
"Hungary","2024-07-25",0,0,3,0,0,3,0,0
"Hungary","2024-07-26",0,0,3,0,0,3,0,0
"Hungary","2024-07-27",0,0,3,0,0,3,0,0
"Hungary","2024-07-28",0,0,3,0,0,3,0,0
"Hungary","2024-07-29",0,0,3,0,0,3,0,0
"Hungary","2024-07-30",0,0,3,0,0,3,0,0
"Hungary","2024-07-31",0,0,3,0,0,3,0,0
"Hungary","2024-08-01",0,0,3,0,0,3,0,0
"Hungary","2024-08-02",0,0,3,0,0,3,0,0
"Hungary","2024-08-03",0,0,3,0,0,3,0,0
"Hungary","2024-08-04",0,0,3,0,0,3,0,0
"Hungary","2024-08-05",0,0,3,0,0,3,0,0
"Hungary","2024-08-06",0,0,3,0,0,3,0,0
"Hungary","2024-08-07",0,0,3,0,0,3,0,0
"Hungary","2024-08-08",0,0,3,0,0,3,0,0
"Hungary","2024-08-09",0,0,3,0,0,3,0,0
"Hungary","2024-08-10",0,0,3,0,0,3,0,0
"Hungary","2024-08-11",0,0,3,0,0,3,0,0
"Hungary","2024-08-12",0,0,3,0,0,3,0,0
"Hungary","2024-08-13",0,0,3,0,0,3,0,0
"Hungary","2024-08-14",0,0,3,0,0,3,0,0
"Hungary","2024-08-15",0,0,3,0,0,3,0,0
"Hungary","2024-08-16",0,0,3,0,0,3,0,0
"Hungary","2024-08-17",0,0,3,0,0,3,0,0
"Hungary","2024-08-18",0,0,3,0,0,3,0,0
"Hungary","2024-08-19",0,0,3,0,0,3,0,0
"Hungary","2024-08-20",0,0,3,0,0,3,0,0
"Hungary","2024-08-21",0,0,3,0,0,3,0,0
"Hungary","2024-08-22",0,0,3,0,0,3,0,0
"Hungary","2024-08-23",0,0,3,0,0,3,0,0
"Hungary","2024-08-24",0,0,3,0,0,3,0,0
"Hungary","2024-08-25",0,0,3,0,0,3,0,0
"Hungary","2024-08-26",0,0,3,0,0,3,0,0
"Hungary","2024-08-27",0,0,3,0,0,3,0,0
"Hungary","2024-08-28",0,0,3,0,0,3,0,0
"Hungary","2024-08-29",0,0,3,0,0,3,0,0
"Hungary","2024-08-30",0,0,3,0,0,3,0,0
"Hungary","2024-08-31",0,0,3,0,0,3,0,0
"Hungary","2024-09-01",0,0,3,0,0,3,0,0
"Hungary","2024-09-02",0,0,3,0,0,3,0,0
"Hungary","2024-09-03",0,0,3,0,0,3,0,0
"Hungary","2024-09-04",0,0,3,0,0,3,0,0
"Hungary","2024-09-05",0,0,3,0,0,3,0,0
"Hungary","2024-09-06",0,0,3,0,0,3,0,0
"Hungary","2024-09-07",0,0,3,0,0,3,0,0
"Hungary","2024-09-08",0,0,3,0,0,3,0,0
"Hungary","2024-09-09",0,0,3,0,0,3,0,0
"Hungary","2024-09-10",0,0,3,0,0,3,0,0
"Hungary","2024-09-11",0,0,3,0,0,3,0,0
"Hungary","2024-09-12",0,0,3,0,0,3,0,0
"Hungary","2024-09-13",0,0,3,0,0,3,0,0
"Hungary","2024-09-14",0,0,3,0,0,3,0,0
"Hungary","2024-09-15",0,0,3,0,0,3,0,0
"Hungary","2024-09-16",0,0,3,0,0,3,0,0
"Hungary","2024-09-17",0,0,3,0,0,3,0,0
"Hungary","2024-09-18",0,0,3,0,0,3,0,0
"Hungary","2024-09-19",0,0,3,0,0,3,0,0
"Hungary","2024-09-20",0,0,3,0,0,3,0,0
"Hungary","2024-09-21",0,0,3,0,0,3,0,0
"Hungary","2024-09-22",0,0,3,0,0,3,0,0
"Hungary","2024-09-23",0,0,3,0,0,3,0,0
"Hungary","2024-09-24",0,0,3,0,0,3,0,0
"Hungary","2024-09-25",0,0,3,0,0,3,0,0
"Hungary","2024-09-26",0,0,3,0,0,3,0,0
"Hungary","2024-09-27",0,0,3,0,0,3,0,0
"Hungary","2024-09-28",0,0,3,0,0,3,0,0
"Hungary","2024-09-29",0,0,3,0,0,3,0,0
"Hungary","2024-09-30",0,0,3,0,0,3,0,0
"Hungary","2024-10-01",0,0,3,0,0,3,0,0
"Hungary","2024-10-02",0,0,3,0,0,3,0,0
"Hungary","2024-10-03",0,0,3,0,0,3,0,0
"Hungary","2024-10-04",0,0,3,0,0,3,0,0
"Hungary","2024-10-05",0,0,3,0,0,3,0,0
"Hungary","2024-10-06",0,0,3,0,0,3,0,0
"Hungary","2024-10-07",0,0,3,0,0,3,0,0
"Hungary","2024-10-08",0,0,3,0,0,3,0,0
"Hungary","2024-10-09",0,0,3,0,0,3,0,0
"Hungary","2024-10-10",0,0,3,0,0,3,0,0
"Hungary","2024-10-11",0,0,3,0,0,3,0,0
"Hungary","2024-10-12",0,0,3,0,0,3,0,0
"Hungary","2024-10-13",0,0,3,0,0,3,0,0
"Hungary","2024-10-14",0,0,3,0,0,3,0,0
"Hungary","2024-10-15",0,0,3,0,0,3,0,0
"Hungary","2024-10-16",0,0,3,0,0,3,0,0
"Hungary","2024-10-17",0,0,3,0,0,3,0,0
"Hungary","2024-10-18",0,0,3,0,0,3,0,0
"Hungary","2024-10-19",0,0,3,0,0,3,0,0
"Hungary","2024-10-20",0,0,3,0,0,3,0,0
"Hungary","2024-10-21",0,0,3,0,0,3,0,0
"Hungary","2024-10-22",0,0,3,0,0,3,0,0
"Hungary","2024-10-23",0,0,3,0,0,3,0,0
"Hungary","2024-10-24",0,0,3,0,0,3,0,0
"Hungary","2024-10-25",0,0,3,0,0,3,0,0
"Hungary","2024-10-26",0,0,3,0,0,3,0,0
"Hungary","2024-10-27",0,0,3,0,0,3,0,0
"Hungary","2024-10-28",0,0,3,0,0,3,0,0
"Hungary","2024-10-29",0,0,3,0,0,3,0,0
"Hungary","2024-10-30",0,0,3,0,0,3,0,0
"Hungary","2024-10-31",0,0,3,0,0,3,0,0
"Hungary","2024-11-01",0,0,3,0,0,3,0,0
"Hungary","2024-11-02",0,0,3,0,0,3,0,0
"Hungary","2024-11-03",0,0,3,0,0,3,0,0
"Hungary","2024-11-04",0,0,3,0,0,3,0,0
"Hungary","2024-11-05",0,0,3,0,0,3,0,0
"Hungary","2024-11-06",0,0,3,0,0,3,0,0
"Hungary","2024-11-07",0,0,3,0,0,3,0,0
"Hungary","2024-11-08",0,0,3,0,0,3,0,0
"Hungary","2024-11-09",0,0,3,0,0,3,0,0
"Hungary","2024-11-10",0,0,3,0,0,3,0,0
"Hungary","2024-11-11",0,0,3,0,0,3,0,0
"Hungary","2024-11-12",0,0,3,0,0,3,0,0
"Hungary","2024-11-13",0,0,3,0,0,3,0,0
"Hungary","2024-11-14",0,0,3,0,0,3,0,0
"Hungary","2024-11-15",0,0,3,0,0,3,0,0
"Hungary","2024-11-16",0,0,3,0,0,3,0,0
"Hungary","2024-11-17",0,0,3,0,0,3,0,0
"Hungary","2024-11-18",0,0,3,0,0,3,0,0
"Hungary","2024-11-19",0,0,3,0,0,3,0,0
"Hungary","2024-11-20",0,0,3,0,0,3,0,0
"Hungary","2024-11-21",0,0,3,0,0,3,0,0
"Hungary","2024-11-22",0,0,3,0,0,3,0,0
"Hungary","2024-11-23",0,0,3,0,0,3,0,0
"Hungary","2024-11-24",0,0,3,0,0,3,0,0
"Hungary","2024-11-25",0,0,3,0,0,3,0,0
"Hungary","2024-11-26",0,0,3,0,0,3,0,0
"Hungary","2024-11-27",0,0,3,0,0,3,0,0
"Hungary","2024-11-28",0,0,3,0,0,3,0,0
"Hungary","2024-11-29",0,0,3,0,0,3,0,0
"Hungary","2024-11-30",0,0,3,0,0,3,0,0
"Hungary","2024-12-01",0,0,3,0,0,3,0,0
"Hungary","2024-12-02",0,0,3,0,0,3,0,0
"Hungary","2024-12-03",0,0,3,0,0,3,0,0
"Hungary","2024-12-04",0,0,3,0,0,3,0,0
"Hungary","2024-12-05",0,0,3,0,0,3,0,0
"Hungary","2024-12-06",0,0,3,0,0,3,0,0
"Hungary","2024-12-07",0,0,3,0,0,3,0,0
"Hungary","2024-12-08",0,0,3,0,0,3,0,0
"Hungary","2024-12-09",0,0,3,0,0,3,0,0
"Hungary","2024-12-10",0,0,3,0,0,3,0,0
"Hungary","2024-12-11",0,0,3,0,0,3,0,0
"Hungary","2024-12-12",0,0,3,0,0,3,0,0
"Hungary","2024-12-13",0,0,3,0,0,3,0,0
"Hungary","2024-12-14",0,0,3,0,0,3,0,0
"Hungary","2024-12-15",0,0,3,0,0,3,0,0
"Hungary","2024-12-16",0,0,3,0,0,3,0,0
"Hungary","2024-12-17",0,0,3,0,0,3,0,0
"Hungary","2024-12-18",0,0,3,0,0,3,0,0
"Hungary","2024-12-19",0,0,3,0,0,3,0,0
"Hungary","2024-12-20",0,0,3,0,0,3,0,0
"Hungary","2024-12-21",0,0,3,0,0,3,0,0
"Hungary","2024-12-22",0,0,3,0,0,3,0,0
"Hungary","2024-12-23",0,0,3,0,0,3,0,0
"Hungary","2024-12-24",0,0,3,0,0,3,0,0
"Hungary","2024-12-25",0,0,3,0,0,3,0,0
"Hungary","2024-12-26",0,0,3,0,0,3,0,0
"Hungary","2024-12-27",0,0,3,0,0,3,0,0
"Hungary","2024-12-28",0,0,3,0,0,3,0,0
"Hungary","2024-12-29",0,0,3,0,0,3,0,0
"Hungary","2024-12-30",0,0,3,0,0,3,0,0
"Hungary","2024-12-31",0,0,3,0,0,3,0,0
"Hungary","2025-01-01",0,0,3,0,0,3,0,0
"Hungary","2025-01-02",0,0,3,0,0,3,0,0
"Hungary","2025-01-03",0,0,3,0,0,3,0,0
"Hungary","2025-01-04",0,0,3,0,0,3,0,0
"Hungary","2025-01-05",0,0,3,0,0,3,0,0
"Hungary","2025-01-06",0,0,3,0,0,3,0,0
"Hungary","2025-01-07",0,0,3,0,0,3,0,0
"Hungary","2025-01-08",0,0,3,0,0,3,0,0
"Hungary","2025-01-09",0,0,3,0,0,3,0,0
"Hungary","2025-01-10",0,0,3,0,0,3,0,0
"Hungary","2025-01-11",0,0,3,0,0,3,0,0
"Hungary","2025-01-12",0,0,3,0,0,3,0,0
"Hungary","2025-01-13",0,0,3,0,0,3,0,0
"Hungary","2025-01-14",0,0,3,0,0,3,0,0
"Hungary","2025-01-15",0,0,3,0,0,3,0,0
"Hungary","2025-01-16",0,0,3,0,0,3,0,0
"Hungary","2025-01-17",0,0,3,0,0,3,0,0
"Hungary","2025-01-18",0,0,3,0,0,3,0,0
"Hungary","2025-01-19",0,0,3,0,0,3,0,0
"Hungary","2025-01-20",0,0,3,0,0,3,0,0
"Hungary","2025-01-21",0,0,3,0,0,3,0,0
"Hungary","2025-01-22",0,0,3,0,0,3,0,0
"Hungary","2025-01-23",0,0,3,0,0,3,0,0
"Hungary","2025-01-24",0,0,3,0,0,3,0,0
"Hungary","2025-01-25",0,0,3,0,0,3,0,0
"Hungary","2025-01-26",0,0,3,0,0,3,0,0
"Hungary","2025-01-27",0,0,3,0,0,3,0,0
"Hungary","2025-01-28",0,0,3,0,0,3,0,0
"Hungary","2025-01-29",0,0,3,0,0,3,0,0
"Hungary","2025-01-30",0,0,3,0,0,3,0,0
"Hungary","2025-01-31",0,0,3,0,0,3,0,0
"Hungary","2025-02-01",0,0,3,0,0,3,0,0
"Hungary","2025-02-02",0,0,3,0,0,3,0,0
"Hungary","2025-02-03",0,0,3,0,0,3,0,0
"Iceland","2024-01-01",0,0,0,0,0,0,0,0
"Iceland","2024-01-02",0,0,0,0,0,0,0,0
"Iceland","2024-01-03",0,0,0,0,0,0,0,0
"Iceland","2024-01-04",0,0,0,0,0,0,0,0
"Iceland","2024-01-05",0,0,0,0,0,0,0,0
"Iceland","2024-01-06",0,0,0,0,0,0,0,0
"Iceland","2024-01-07",0,0,0,0,0,0,0,0
"Iceland","2024-01-08",0,0,0,0,0,0,0,0
"Iceland","2024-01-09",0,0,0,0,0,0,0,0
"Iceland","2024-01-10",0,0,0,0,0,0,0,0
"Iceland","2024-01-11",0,0,0,0,0,0,0,0
"Iceland","2024-01-12",0,0,0,0,0,0,0,0
"Iceland","2024-01-13",0,0,0,0,0,0,0,0
"Iceland","2024-01-14",0,0,0,0,0,0,0,0
"Iceland","2024-01-15",0,0,0,0,0,0,0,0
"Iceland","2024-01-16",0,0,0,0,0,0,0,0
"Iceland","2024-01-17",0,0,0,0,0,0,0,0
"Iceland","2024-01-18",0,0,0,0,0,0,0,0
"Iceland","2024-01-19",0,0,0,0,0,0,0,0
"Iceland","2024-01-20",0,0,0,0,0,0,0,0
"Iceland","2024-01-21",0,0,0,0,0,0,0,0
"Iceland","2024-01-22",0,0,0,0,0,0,0,0
"Iceland","2024-01-23",0,0,0,0,0,0,0,0
"Iceland","2024-01-24",0,0,0,0,0,0,0,0
"Iceland","2024-01-25",0,0,0,0,0,0,0,0
"Iceland","2024-01-26",0,0,0,0,0,0,0,0
"Iceland","2024-01-27",0,0,0,0,0,0,0,0
"Iceland","2024-01-28",0,0,0,0,0,0,0,0
"Iceland","2024-01-29",0,0,0,0,0,0,0,0
"Iceland","2024-01-30",0,0,0,0,0,0,0,0
"Iceland","2024-01-31",0,0,0,0,0,0,0,0
"Iceland","2024-02-01",0,0,0,0,0,0,0,0
"Iceland","2024-02-02",0,0,0,0,0,0,0,0
"Iceland","2024-02-03",0,0,0,0,0,0,0,0
"Iceland","2024-02-04",0,0,0,0,0,0,0,0
"Iceland","2024-02-05",0,0,0,0,0,0,0,0
"Iceland","2024-02-06",0,0,0,0,0,0,0,0
"Iceland","2024-02-07",0,0,0,0,0,0,0,0
"Iceland","2024-02-08",0,0,0,0,0,0,0,0
"Iceland","2024-02-09",0,0,0,0,0,0,0,0
"Iceland","2024-02-10",0,0,0,0,0,0,0,0
"Iceland","2024-02-11",0,0,0,0,0,0,0,0
"Iceland","2024-02-12",0,0,0,0,0,0,0,0
"Iceland","2024-02-13",0,0,0,0,0,0,0,0
"Iceland","2024-02-14",0,0,0,0,0,0,0,0
"Iceland","2024-02-15",0,0,0,0,0,0,0,0
"Iceland","2024-02-16",0,0,0,0,0,0,0,0
"Iceland","2024-02-17",0,0,0,0,0,0,0,0
"Iceland","2024-02-18",0,0,0,0,0,0,0,0
"Iceland","2024-02-19",0,0,0,0,0,0,0,0
"Iceland","2024-02-20",0,0,0,0,0,0,0,0
"Iceland","2024-02-21",0,0,0,0,0,0,0,0
"Iceland","2024-02-22",0,0,0,0,0,0,0,0
"Iceland","2024-02-23",0,0,0,0,0,0,0,0
"Iceland","2024-02-24",0,0,0,0,0,0,0,0
"Iceland","2024-02-25",0,0,0,0,0,0,0,0
"Iceland","2024-02-26",0,0,0,0,0,0,0,0
"Iceland","2024-02-27",0,0,0,0,0,0,0,0
"Iceland","2024-02-28",0,0,0,0,0,0,0,0
"Iceland","2024-02-29",0,0,0,0,0,0,0,0
"Iceland","2024-03-01",0,0,0,0,0,0,0,0
"Iceland","2024-03-02",0,0,0,0,0,0,0,0
"Iceland","2024-03-03",0,0,0,0,0,0,0,0
"Iceland","2024-03-04",0,0,0,0,0,0,0,0
"Iceland","2024-03-05",0,0,0,0,0,0,0,0
"Iceland","2024-03-06",0,0,0,0,0,0,0,0
"Iceland","2024-03-07",0,0,0,0,0,0,0,0
"Iceland","2024-03-08",0,0,0,0,0,0,0,0
"Iceland","2024-03-09",0,0,0,0,0,0,0,0
"Iceland","2024-03-10",0,0,0,0,0,0,0,0
"Iceland","2024-03-11",0,0,0,0,0,0,0,0
"Iceland","2024-03-12",0,0,0,0,0,0,0,0
"Iceland","2024-03-13",0,0,0,0,0,0,0,0
"Iceland","2024-03-14",0,0,0,0,0,0,0,0
"Iceland","2024-03-15",0,0,0,0,0,0,0,0
"Iceland","2024-03-16",0,0,0,0,0,0,0,0
"Iceland","2024-03-17",0,0,0,0,0,0,0,0
"Iceland","2024-03-18",0,0,0,0,0,0,0,0
"Iceland","2024-03-19",0,0,0,0,0,0,0,0
"Iceland","2024-03-20",0,0,0,0,0,0,0,0
"Iceland","2024-03-21",0,0,0,0,0,0,0,0
"Iceland","2024-03-22",0,0,0,0,0,0,0,0
"Iceland","2024-03-23",0,0,0,0,0,0,0,0
"Iceland","2024-03-24",0,0,0,0,0,0,0,0
"Iceland","2024-03-25",0,0,0,0,0,0,0,0
"Iceland","2024-03-26",0,0,0,0,0,0,0,0
"Iceland","2024-03-27",0,0,0,0,0,0,0,0
"Iceland","2024-03-28",0,0,0,0,0,0,0,0
"Iceland","2024-03-29",0,0,0,0,0,0,0,0
"Iceland","2024-03-30",0,0,0,0,0,0,0,0
"Iceland","2024-03-31",0,0,0,0,0,0,0,0
"Iceland","2024-04-01",0,0,0,0,0,0,0,0
"Iceland","2024-04-02",0,0,0,0,0,0,0,0
"Iceland","2024-04-03",0,0,0,0,0,0,0,0
"Iceland","2024-04-04",0,0,0,0,0,0,0,0
"Iceland","2024-04-05",0,0,0,0,0,0,0,0
"Iceland","2024-04-06",0,0,0,0,0,0,0,0
"Iceland","2024-04-07",0,0,0,0,0,0,0,0
"Iceland","2024-04-08",0,0,0,0,0,0,0,0
"Iceland","2024-04-09",0,0,0,0,0,0,0,0
"Iceland","2024-04-10",0,0,0,0,0,0,0,0
"Iceland","2024-04-11",0,0,0,0,0,0,0,0
"Iceland","2024-04-12",0,0,0,0,0,0,0,0
"Iceland","2024-04-13",0,0,0,0,0,0,0,0
"Iceland","2024-04-14",0,0,0,0,0,0,0,0
"Iceland","2024-04-15",0,0,0,0,0,0,0,0
"Iceland","2024-04-16",0,0,0,0,0,0,0,0
"Iceland","2024-04-17",0,0,0,0,0,0,0,0
"Iceland","2024-04-18",0,0,0,0,0,0,0,0
"Iceland","2024-04-19",0,0,0,0,0,0,0,0
"Iceland","2024-04-20",0,0,0,0,0,0,0,0
"Iceland","2024-04-21",0,0,0,0,0,0,0,0
"Iceland","2024-04-22",0,0,0,0,0,0,0,0
"Iceland","2024-04-23",0,0,0,0,0,0,0,0
"Iceland","2024-04-24",0,0,0,0,0,0,0,0
"Iceland","2024-04-25",0,0,0,0,0,0,0,0
"Iceland","2024-04-26",0,0,0,0,0,0,0,0
"Iceland","2024-04-27",0,0,0,0,0,0,0,0
"Iceland","2024-04-28",0,0,0,0,0,0,0,0
"Iceland","2024-04-29",0,0,0,0,0,0,0,0
"Iceland","2024-04-30",0,0,0,0,0,0,0,0
"Iceland","2024-05-01",0,0,0,0,0,0,0,0
"Iceland","2024-05-02",0,0,0,0,0,0,0,0
"Iceland","2024-05-03",0,0,0,0,0,0,0,0
"Iceland","2024-05-04",0,0,0,0,0,0,0,0
"Iceland","2024-05-05",0,0,0,0,0,0,0,0
"Iceland","2024-05-06",0,0,0,0,0,0,0,0
"Iceland","2024-05-07",0,0,0,0,0,0,0,0
"Iceland","2024-05-08",0,0,0,0,0,0,0,0
"Iceland","2024-05-09",0,0,0,0,0,0,0,0
"Iceland","2024-05-10",0,0,0,0,0,0,0,0
"Iceland","2024-05-11",0,0,0,0,0,0,0,0
"Iceland","2024-05-12",0,0,0,0,0,0,0,0
"Iceland","2024-05-13",0,0,0,0,0,0,0,0
"Iceland","2024-05-14",0,0,0,0,0,0,0,0
"Iceland","2024-05-15",0,0,0,0,0,0,0,0
"Iceland","2024-05-16",0,0,0,0,0,0,0,0
"Iceland","2024-05-17",0,0,0,0,0,0,0,0
"Iceland","2024-05-18",0,0,0,0,0,0,0,0
"Iceland","2024-05-19",0,0,0,0,0,0,0,0
"Iceland","2024-05-20",0,0,0,0,0,0,0,0
"Iceland","2024-05-21",0,0,0,0,0,0,0,0
"Iceland","2024-05-22",0,0,0,0,0,0,0,0
"Iceland","2024-05-23",0,0,0,0,0,0,0,0
"Iceland","2024-05-24",0,0,0,0,0,0,0,0
"Iceland","2024-05-25",0,0,0,0,0,0,0,0
"Iceland","2024-05-26",0,0,0,0,0,0,0,0
"Iceland","2024-05-27",0,0,0,0,0,0,0,0
"Iceland","2024-05-28",0,0,0,0,0,0,0,0
"Iceland","2024-05-29",0,0,0,0,0,0,0,0
"Iceland","2024-05-30",0,0,0,0,0,0,0,0
"Iceland","2024-05-31",0,0,0,0,0,0,0,0
"Iceland","2024-06-01",0,0,0,0,0,0,0,0
"Iceland","2024-06-02",0,0,0,0,0,0,0,0
"Iceland","2024-06-03",0,0,0,0,0,0,0,0
"Iceland","2024-06-04",0,0,0,0,0,0,0,0
"Iceland","2024-06-05",0,0,0,0,0,0,0,0
"Iceland","2024-06-06",0,0,0,0,0,0,0,0
"Iceland","2024-06-07",0,0,0,0,0,0,0,0
"Iceland","2024-06-08",0,0,0,0,0,0,0,0
"Iceland","2024-06-09",0,0,0,0,0,0,0,0
"Iceland","2024-06-10",0,0,0,0,0,0,0,0
"Iceland","2024-06-11",0,0,0,0,0,0,0,0
"Iceland","2024-06-12",0,0,0,0,0,0,0,0
"Iceland","2024-06-13",0,0,0,0,0,0,0,0
"Iceland","2024-06-14",0,0,0,0,0,0,0,0
"Iceland","2024-06-15",0,0,0,0,0,0,0,0
"Iceland","2024-06-16",0,0,0,0,0,0,0,0
"Iceland","2024-06-17",0,0,0,0,0,0,0,0
"Iceland","2024-06-18",0,0,0,0,0,0,0,0
"Iceland","2024-06-19",0,0,0,0,0,0,0,0
"Iceland","2024-06-20",0,0,0,0,0,0,0,0
"Iceland","2024-06-21",0,0,0,0,0,0,0,0
"Iceland","2024-06-22",0,0,0,0,0,0,0,0
"Iceland","2024-06-23",0,0,0,0,0,0,0,0
"Iceland","2024-06-24",0,0,0,0,0,0,0,0
"Iceland","2024-06-25",0,0,0,0,0,0,0,0
"Iceland","2024-06-26",0,0,0,0,0,0,0,0
"Iceland","2024-06-27",0,0,0,0,0,0,0,0
"Iceland","2024-06-28",0,0,0,0,0,0,0,0
"Iceland","2024-06-29",0,0,0,0,0,0,0,0
"Iceland","2024-06-30",0,0,0,0,0,0,0,0
"Iceland","2024-07-01",0,0,0,0,0,0,0,0
"Iceland","2024-07-02",0,0,0,0,0,0,0,0
"Iceland","2024-07-03",0,0,0,0,0,0,0,0
"Iceland","2024-07-04",0,0,0,0,0,0,0,0
"Iceland","2024-07-05",0,0,0,0,0,0,0,0
"Iceland","2024-07-06",0,0,0,0,0,0,0,0
"Iceland","2024-07-07",0,0,0,0,0,0,0,0
"Iceland","2024-07-08",0,0,0,0,0,0,0,0
"Iceland","2024-07-09",0,0,0,0,0,0,0,0
"Iceland","2024-07-10",0,0,0,0,0,0,0,0
"Iceland","2024-07-11",0,0,0,0,0,0,0,0
"Iceland","2024-07-12",0,0,0,0,0,0,0,0
"Iceland","2024-07-13",0,0,0,0,0,0,0,0
"Iceland","2024-07-14",0,0,0,0,0,0,0,0
"Iceland","2024-07-15",0,0,0,0,0,0,0,0
"Iceland","2024-07-16",0,0,0,0,0,0,0,0
"Iceland","2024-07-17",0,0,0,0,0,0,0,0
"Iceland","2024-07-18",0,0,0,0,0,0,0,0
"Iceland","2024-07-19",0,0,0,0,0,0,0,0
"Iceland","2024-07-20",0,0,0,0,0,0,0,0
"Iceland","2024-07-21",0,0,0,0,0,0,0,0
"Iceland","2024-07-22",0,0,0,0,0,0,0,0
"Iceland","2024-07-23",0,0,0,0,0,0,0,0
"Iceland","2024-07-24",0,0,0,0,0,0,0,0
"Iceland","2024-07-25",0,0,0,0,0,0,0,0
"Iceland","2024-07-26",0,0,0,0,0,0,0,0
"Iceland","2024-07-27",0,0,0,0,0,0,0,0
"Iceland","2024-07-28",0,0,0,0,0,0,0,0
"Iceland","2024-07-29",0,0,0,0,0,0,0,0
"Iceland","2024-07-30",0,0,0,0,0,0,0,0
"Iceland","2024-07-31",0,0,0,0,0,0,0,0
"Iceland","2024-08-01",0,0,0,0,0,0,0,0
"Iceland","2024-08-02",0,0,0,0,0,0,0,0
"Iceland","2024-08-03",0,0,0,0,0,0,0,0
"Iceland","2024-08-04",0,0,0,0,0,0,0,0
"Iceland","2024-08-05",0,0,0,0,0,0,0,0
"Iceland","2024-08-06",0,0,0,0,0,0,0,0
"Iceland","2024-08-07",0,0,0,0,0,0,0,0
"Iceland","2024-08-08",0,0,0,0,0,0,0,0
"Iceland","2024-08-09",0,0,0,0,0,0,0,0
"Iceland","2024-08-10",0,0,0,0,0,0,0,0
"Iceland","2024-08-11",0,0,0,0,0,0,0,0
"Iceland","2024-08-12",0,0,0,0,0,0,0,0
"Iceland","2024-08-13",0,0,0,0,0,0,0,0
"Iceland","2024-08-14",0,0,0,0,0,0,0,0
"Iceland","2024-08-15",0,0,0,0,0,0,0,0
"Iceland","2024-08-16",0,0,0,0,0,0,0,0
"Iceland","2024-08-17",0,0,0,0,0,0,0,0
"Iceland","2024-08-18",0,0,0,0,0,0,0,0
"Iceland","2024-08-19",0,0,0,0,0,0,0,0
"Iceland","2024-08-20",0,0,0,0,0,0,0,0
"Iceland","2024-08-21",0,0,0,0,0,0,0,0
"Iceland","2024-08-22",0,0,0,0,0,0,0,0
"Iceland","2024-08-23",0,0,0,0,0,0,0,0
"Iceland","2024-08-24",0,0,0,0,0,0,0,0
"Iceland","2024-08-25",0,0,0,0,0,0,0,0
"Iceland","2024-08-26",0,0,0,0,0,0,0,0
"Iceland","2024-08-27",0,0,0,0,0,0,0,0
"Iceland","2024-08-28",0,0,0,0,0,0,0,0
"Iceland","2024-08-29",0,0,0,0,0,0,0,0
"Iceland","2024-08-30",0,0,0,0,0,0,0,0
"Iceland","2024-08-31",0,0,0,0,0,0,0,0
"Iceland","2024-09-01",0,0,0,0,0,0,0,0
"Iceland","2024-09-02",0,0,0,0,0,0,0,0
"Iceland","2024-09-03",0,0,0,0,0,0,0,0
"Iceland","2024-09-04",0,0,0,0,0,0,0,0
"Iceland","2024-09-05",0,0,0,0,0,0,0,0
"Iceland","2024-09-06",0,0,0,0,0,0,0,0
"Iceland","2024-09-07",0,0,0,0,0,0,0,0
"Iceland","2024-09-08",0,0,0,0,0,0,0,0
"Iceland","2024-09-09",0,0,0,0,0,0,0,0
"Iceland","2024-09-10",0,0,0,0,0,0,0,0
"Iceland","2024-09-11",0,0,0,0,0,0,0,0
"Iceland","2024-09-12",0,0,0,0,0,0,0,0
"Iceland","2024-09-13",0,0,0,0,0,0,0,0
"Iceland","2024-09-14",0,0,0,0,0,0,0,0
"Iceland","2024-09-15",0,0,0,0,0,0,0,0
"Iceland","2024-09-16",0,0,0,0,0,0,0,0
"Iceland","2024-09-17",0,0,0,0,0,0,0,0
"Iceland","2024-09-18",0,0,0,0,0,0,0,0
"Iceland","2024-09-19",0,0,0,0,0,0,0,0
"Iceland","2024-09-20",0,0,0,0,0,0,0,0
"Iceland","2024-09-21",0,0,0,0,0,0,0,0
"Iceland","2024-09-22",0,0,0,0,0,0,0,0
"Iceland","2024-09-23",0,0,0,0,0,0,0,0
"Iceland","2024-09-24",0,0,0,0,0,0,0,0
"Iceland","2024-09-25",0,0,0,0,0,0,0,0
"Iceland","2024-09-26",0,0,0,0,0,0,0,0
"Iceland","2024-09-27",0,0,0,0,0,0,0,0
"Iceland","2024-09-28",0,0,0,0,0,0,0,0
"Iceland","2024-09-29",0,0,0,0,0,0,0,0
"Iceland","2024-09-30",0,0,0,0,0,0,0,0
"Iceland","2024-10-01",0,0,0,0,0,0,0,0
"Iceland","2024-10-02",0,0,0,0,0,0,0,0
"Iceland","2024-10-03",0,0,0,0,0,0,0,0
"Iceland","2024-10-04",0,0,0,0,0,0,0,0
"Iceland","2024-10-05",0,0,0,0,0,0,0,0
"Iceland","2024-10-06",0,0,0,0,0,0,0,0
"Iceland","2024-10-07",0,0,0,0,0,0,0,0
"Iceland","2024-10-08",0,0,0,0,0,0,0,0
"Iceland","2024-10-09",0,0,0,0,0,0,0,0
"Iceland","2024-10-10",0,0,0,0,0,0,0,0
"Iceland","2024-10-11",0,0,0,0,0,0,0,0
"Iceland","2024-10-12",0,0,0,0,0,0,0,0
"Iceland","2024-10-13",0,0,0,0,0,0,0,0
"Iceland","2024-10-14",0,0,0,0,0,0,0,0
"Iceland","2024-10-15",0,0,0,0,0,0,0,0
"Iceland","2024-10-16",0,0,0,0,0,0,0,0
"Iceland","2024-10-17",0,0,0,0,0,0,0,0
"Iceland","2024-10-18",0,0,0,0,0,0,0,0
"Iceland","2024-10-19",0,0,0,0,0,0,0,0
"Iceland","2024-10-20",0,0,0,0,0,0,0,0
"Iceland","2024-10-21",0,0,0,0,0,0,0,0
"Iceland","2024-10-22",0,0,0,0,0,0,0,0
"Iceland","2024-10-23",0,0,0,0,0,0,0,0
"Iceland","2024-10-24",0,0,0,0,0,0,0,0
"Iceland","2024-10-25",0,0,0,0,0,0,0,0
"Iceland","2024-10-26",0,0,0,0,0,0,0,0
"Iceland","2024-10-27",0,0,0,0,0,0,0,0
"Iceland","2024-10-28",0,0,0,0,0,0,0,0
"Iceland","2024-10-29",0,0,0,0,0,0,0,0
"Iceland","2024-10-30",0,0,0,0,0,0,0,0
"Iceland","2024-10-31",0,0,0,0,0,0,0,0
"Iceland","2024-11-01",0,0,0,0,0,0,0,0
"Iceland","2024-11-02",0,0,0,0,0,0,0,0
"Iceland","2024-11-03",0,0,0,0,0,0,0,0
"Iceland","2024-11-04",0,0,0,0,0,0,0,0
"Iceland","2024-11-05",0,0,0,0,0,0,0,0
"Iceland","2024-11-06",0,0,0,0,0,0,0,0
"Iceland","2024-11-07",0,0,0,0,0,0,0,0
"Iceland","2024-11-08",0,0,0,0,0,0,0,0
"Iceland","2024-11-09",0,0,0,0,0,0,0,0
"Iceland","2024-11-10",0,0,0,0,0,0,0,0
"Iceland","2024-11-11",0,0,0,0,0,0,0,0
"Iceland","2024-11-12",0,0,0,0,0,0,0,0
"Iceland","2024-11-13",0,0,0,0,0,0,0,0
"Iceland","2024-11-14",0,0,0,0,0,0,0,0
"Iceland","2024-11-15",0,0,0,0,0,0,0,0
"Iceland","2024-11-16",0,0,0,0,0,0,0,0
"Iceland","2024-11-17",0,0,0,0,0,0,0,0
"Iceland","2024-11-18",0,0,0,0,0,0,0,0
"Iceland","2024-11-19",0,0,0,0,0,0,0,0
"Iceland","2024-11-20",0,0,0,0,0,0,0,0
"Iceland","2024-11-21",0,0,0,0,0,0,0,0
"Iceland","2024-11-22",0,0,0,0,0,0,0,0
"Iceland","2024-11-23",0,0,0,0,0,0,0,0
"Iceland","2024-11-24",0,0,0,0,0,0,0,0
"Iceland","2024-11-25",0,0,0,0,0,0,0,0
"Iceland","2024-11-26",0,0,0,0,0,0,0,0
"Iceland","2024-11-27",0,0,0,0,0,0,0,0
"Iceland","2024-11-28",0,0,0,0,0,0,0,0
"Iceland","2024-11-29",0,0,0,0,0,0,0,0
"Iceland","2024-11-30",0,0,0,0,0,0,0,0
"Iceland","2024-12-01",0,0,0,0,0,0,0,0
"Iceland","2024-12-02",0,0,0,0,0,0,0,0
"Iceland","2024-12-03",0,0,0,0,0,0,0,0
"Iceland","2024-12-04",0,0,0,0,0,0,0,0
"Iceland","2024-12-05",0,0,0,0,0,0,0,0
"Iceland","2024-12-06",0,0,0,0,0,0,0,0
"Iceland","2024-12-07",0,0,0,0,0,0,0,0
"Iceland","2024-12-08",0,0,0,0,0,0,0,0
"Iceland","2024-12-09",0,0,0,0,0,0,0,0
"Iceland","2024-12-10",0,0,0,0,0,0,0,0
"Iceland","2024-12-11",0,0,0,0,0,0,0,0
"Iceland","2024-12-12",0,0,0,0,0,0,0,0
"Iceland","2024-12-13",0,0,0,0,0,0,0,0
"Iceland","2024-12-14",0,0,0,0,0,0,0,0
"Iceland","2024-12-15",0,0,0,0,0,0,0,0
"Iceland","2024-12-16",0,0,0,0,0,0,0,0
"Iceland","2024-12-17",0,0,0,0,0,0,0,0
"Iceland","2024-12-18",0,0,0,0,0,0,0,0
"Iceland","2024-12-19",0,0,0,0,0,0,0,0
"Iceland","2024-12-20",0,0,0,0,0,0,0,0
"Iceland","2024-12-21",0,0,0,0,0,0,0,0
"Iceland","2024-12-22",0,0,0,0,0,0,0,0
"Iceland","2024-12-23",0,0,0,0,0,0,0,0
"Iceland","2024-12-24",0,0,0,0,0,0,0,0
"Iceland","2024-12-25",0,0,0,0,0,0,0,0
"Iceland","2024-12-26",0,0,0,0,0,0,0,0
"Iceland","2024-12-27",0,0,0,0,0,0,0,0
"Iceland","2024-12-28",0,0,0,0,0,0,0,0
"Iceland","2024-12-29",0,0,0,0,0,0,0,0
"Iceland","2024-12-30",0,0,0,0,0,0,0,0
"Iceland","2024-12-31",0,0,0,0,0,0,0,0
"Iceland","2025-01-01",0,0,0,0,0,0,0,0
"Iceland","2025-01-02",0,0,0,0,0,0,0,0
"Iceland","2025-01-03",0,0,0,0,0,0,0,0
"Iceland","2025-01-04",0,0,0,0,0,0,0,0
"Iceland","2025-01-05",0,0,0,0,0,0,0,0
"Iceland","2025-01-06",0,0,0,0,0,0,0,0
"Iceland","2025-01-07",0,0,0,0,0,0,0,0
"Iceland","2025-01-08",0,0,0,0,0,0,0,0
"Iceland","2025-01-09",0,0,0,0,0,0,0,0
"Iceland","2025-01-10",0,0,0,0,0,0,0,0
"Iceland","2025-01-11",0,0,0,0,0,0,0,0
"Iceland","2025-01-12",0,0,0,0,0,0,0,0
"Iceland","2025-01-13",0,0,0,0,0,0,0,0
"Iceland","2025-01-14",0,0,0,0,0,0,0,0
"Iceland","2025-01-15",0,0,0,0,0,0,0,0
"Iceland","2025-01-16",0,0,0,0,0,0,0,0
"Iceland","2025-01-17",0,0,0,0,0,0,0,0
"Iceland","2025-01-18",0,0,0,0,0,0,0,0
"Iceland","2025-01-19",0,0,0,0,0,0,0,0
"Iceland","2025-01-20",0,0,0,0,0,0,0,0
"Iceland","2025-01-21",0,0,0,0,0,0,0,0
"Iceland","2025-01-22",0,0,0,0,0,0,0,0
"Iceland","2025-01-23",0,0,0,0,0,0,0,0
"Iceland","2025-01-24",0,0,0,0,0,0,0,0
"Iceland","2025-01-25",0,0,0,0,0,0,0,0
"Iceland","2025-01-26",0,0,0,0,0,0,0,0
"Iceland","2025-01-27",0,0,0,0,0,0,0,0
"Iceland","2025-01-28",0,0,0,0,0,0,0,0
"Iceland","2025-01-29",0,0,0,0,0,0,0,0
"Iceland","2025-01-30",0,0,0,0,0,0,0,0
"Iceland","2025-01-31",0,0,0,0,0,0,0,0
"Iceland","2025-02-01",0,0,0,0,0,0,0,0
"Iceland","2025-02-02",0,0,0,0,0,0,0,0
"Iceland","2025-02-03",0,0,0,0,0,0,0,0
"India","2024-01-01",0,0,0,0,0,0,0,0
"India","2024-01-02",0,0,0,0,0,0,0,0
"India","2024-01-03",0,0,0,0,0,0,0,0
"India","2024-01-04",0,0,0,0,0,0,0,0
"India","2024-01-05",0,0,0,0,0,0,0,0
"India","2024-01-06",0,0,0,0,0,0,0,0
"India","2024-01-07",0,0,0,0,0,0,0,0
"India","2024-01-08",0,0,0,0,0,0,0,0
"India","2024-01-09",0,0,0,0,0,0,0,0
"India","2024-01-10",0,0,0,0,0,0,0,0
"India","2024-01-11",0,0,0,0,0,0,0,0
"India","2024-01-12",0,0,0,0,0,0,0,0
"India","2024-01-13",0,0,0,0,0,0,0,0
"India","2024-01-14",0,0,0,0,0,0,0,0
"India","2024-01-15",0,0,0,0,0,0,0,0
"India","2024-01-16",0,0,0,0,0,0,0,0
"India","2024-01-17",0,0,0,0,0,0,0,0
"India","2024-01-18",0,0,0,0,0,0,0,0
"India","2024-01-19",0,0,0,0,0,0,0,0
"India","2024-01-20",0,0,0,0,0,0,0,0
"India","2024-01-21",0,0,0,0,0,0,0,0
"India","2024-01-22",0,0,0,0,0,0,0,0
"India","2024-01-23",0,0,0,0,0,0,0,0
"India","2024-01-24",0,0,0,0,0,0,0,0
"India","2024-01-25",0,0,0,0,0,0,0,0
"India","2024-01-26",0,0,0,0,0,0,0,0
"India","2024-01-27",0,0,0,0,0,0,0,0
"India","2024-01-28",0,0,0,0,0,0,0,0
"India","2024-01-29",0,0,0,0,0,0,0,0
"India","2024-01-30",0,0,0,0,0,0,0,0
"India","2024-01-31",0,0,0,0,0,0,0,0
"India","2024-02-01",0,0,0,0,0,0,0,0
"India","2024-02-02",0,0,0,0,0,0,0,0
"India","2024-02-03",0,0,0,0,0,0,0,0
"India","2024-02-04",0,0,0,0,0,0,0,0
"India","2024-02-05",0,0,0,0,0,0,0,0
"India","2024-02-06",0,0,0,0,0,0,0,0
"India","2024-02-07",0,0,0,0,0,0,0,0
"India","2024-02-08",0,0,0,0,0,0,0,0
"India","2024-02-09",0,0,0,0,0,0,0,0
"India","2024-02-10",0,0,0,0,0,0,0,0
"India","2024-02-11",0,0,0,0,0,0,0,0
"India","2024-02-12",0,0,0,0,0,0,0,0
"India","2024-02-13",0,0,0,0,0,0,0,0
"India","2024-02-14",0,0,0,0,0,0,0,0
"India","2024-02-15",0,0,0,0,0,0,0,0
"India","2024-02-16",0,0,0,0,0,0,0,0
"India","2024-02-17",0,0,0,0,0,0,0,0
"India","2024-02-18",0,0,0,0,0,0,0,0
"India","2024-02-19",0,0,0,0,0,0,0,0
"India","2024-02-20",0,0,0,0,0,0,0,0
"India","2024-02-21",0,0,0,0,0,0,0,0
"India","2024-02-22",0,0,0,0,0,0,0,0
"India","2024-02-23",0,0,0,0,0,0,0,0
"India","2024-02-24",0,0,0,0,0,0,0,0
"India","2024-02-25",0,0,0,0,0,0,0,0
"India","2024-02-26",0,0,0,0,0,0,0,0
"India","2024-02-27",0,0,0,0,0,0,0,0
"India","2024-02-28",0,0,0,0,0,0,0,0
"India","2024-02-29",0,0,0,0,0,0,0,0
"India","2024-03-01",0,0,0,0,0,0,0,0
"India","2024-03-02",0,0,0,0,0,0,0,0
"India","2024-03-03",0,0,0,0,0,0,0,0
"India","2024-03-04",0,0,0,0,0,0,0,0
"India","2024-03-05",0,0,0,0,0,0,0,0
"India","2024-03-06",0,0,0,0,0,0,0,0
"India","2024-03-07",0,0,0,0,0,0,0,0
"India","2024-03-08",0,0,0,0,0,0,0,0
"India","2024-03-09",0,0,0,0,0,0,0,0
"India","2024-03-10",0,0,0,0,0,0,0,0
"India","2024-03-11",0,0,0,0,0,0,0,0
"India","2024-03-12",0,0,0,0,0,0,0,0
"India","2024-03-13",0,0,0,0,0,0,0,0
"India","2024-03-14",0,0,0,0,0,0,0,0
"India","2024-03-15",0,0,0,0,0,0,0,0
"India","2024-03-16",0,0,0,0,0,0,0,0
"India","2024-03-17",0,0,0,0,0,0,0,0
"India","2024-03-18",0,0,0,0,0,0,0,0
"India","2024-03-19",0,0,0,0,0,0,0,0
"India","2024-03-20",0,0,0,0,0,0,0,0
"India","2024-03-21",0,0,0,0,0,0,0,0
"India","2024-03-22",0,0,0,0,0,0,0,0
"India","2024-03-23",0,0,0,0,0,0,0,0
"India","2024-03-24",0,0,0,0,0,0,0,0
"India","2024-03-25",0,0,0,0,0,0,0,0
"India","2024-03-26",0,0,0,0,0,0,0,0
"India","2024-03-27",0,0,0,0,0,0,0,0
"India","2024-03-28",0,0,0,0,0,0,0,0
"India","2024-03-29",0,0,0,0,0,0,0,0
"India","2024-03-30",0,0,0,0,0,0,0,0
"India","2024-03-31",0,0,0,0,0,0,0,0
"India","2024-04-01",0,0,0,0,0,0,0,0
"India","2024-04-02",0,0,0,0,0,0,0,0
"India","2024-04-03",0,0,0,0,0,0,0,0
"India","2024-04-04",0,0,0,0,0,0,0,0
"India","2024-04-05",0,0,0,0,0,0,0,0
"India","2024-04-06",0,0,0,0,0,0,0,0
"India","2024-04-07",0,0,0,0,0,0,0,0
"India","2024-04-08",0,0,0,0,0,0,0,0
"India","2024-04-09",0,0,0,0,0,0,0,0
"India","2024-04-10",0,0,0,0,0,0,0,0
"India","2024-04-11",0,0,0,0,0,0,0,0
"India","2024-04-12",0,0,0,0,0,0,0,0
"India","2024-04-13",0,0,0,0,0,0,0,0
"India","2024-04-14",0,0,0,0,0,0,0,0
"India","2024-04-15",0,0,0,0,0,0,0,0
"India","2024-04-16",0,0,0,0,0,0,0,0
"India","2024-04-17",0,0,0,0,0,0,0,0
"India","2024-04-18",0,0,0,0,0,0,0,0
"India","2024-04-19",0,0,0,0,0,0,0,0
"India","2024-04-20",0,0,0,0,0,0,0,0
"India","2024-04-21",0,0,0,0,0,0,0,0
"India","2024-04-22",0,0,0,0,0,0,0,0
"India","2024-04-23",0,0,0,0,0,0,0,0
"India","2024-04-24",0,0,0,0,0,0,0,0
"India","2024-04-25",0,0,0,0,0,0,0,0
"India","2024-04-26",0,0,0,0,0,0,0,0
"India","2024-04-27",0,0,0,0,0,0,0,0
"India","2024-04-28",0,0,0,0,0,0,0,0
"India","2024-04-29",0,0,0,0,0,0,0,0
"India","2024-04-30",0,0,0,0,0,0,0,0
"India","2024-05-01",0,0,0,0,0,0,0,0
"India","2024-05-02",0,0,0,0,0,0,0,0
"India","2024-05-03",0,0,0,0,0,0,0,0
"India","2024-05-04",0,0,0,0,0,0,0,0
"India","2024-05-05",0,0,0,0,0,0,0,0
"India","2024-05-06",0,0,0,0,0,0,0,0
"India","2024-05-07",0,0,0,0,0,0,0,0
"India","2024-05-08",0,0,0,0,0,0,0,0
"India","2024-05-09",0,0,0,0,0,0,0,0
"India","2024-05-10",0,0,0,0,0,0,0,0
"India","2024-05-11",0,0,0,0,0,0,0,0
"India","2024-05-12",0,0,0,0,0,0,0,0
"India","2024-05-13",0,0,0,0,0,0,0,0
"India","2024-05-14",0,0,0,0,0,0,0,0
"India","2024-05-15",0,0,0,0,0,0,0,0
"India","2024-05-16",0,0,0,0,0,0,0,0
"India","2024-05-17",0,0,0,0,0,0,0,0
"India","2024-05-18",0,0,0,0,0,0,0,0
"India","2024-05-19",0,0,0,0,0,0,0,0
"India","2024-05-20",0,0,0,0,0,0,0,0
"India","2024-05-21",0,0,0,0,0,0,0,0
"India","2024-05-22",0,0,0,0,0,0,0,0
"India","2024-05-23",0,0,0,0,0,0,0,0
"India","2024-05-24",0,0,0,0,0,0,0,0
"India","2024-05-25",0,0,0,0,0,0,0,0
"India","2024-05-26",0,0,0,0,0,0,0,0
"India","2024-05-27",0,0,0,0,0,0,0,0
"India","2024-05-28",0,0,0,0,0,0,0,0
"India","2024-05-29",0,0,0,0,0,0,0,0
"India","2024-05-30",0,0,0,0,0,0,0,0
"India","2024-05-31",0,0,0,0,0,0,0,0
"India","2024-06-01",0,0,0,0,0,0,0,0
"India","2024-06-02",0,0,0,0,0,0,0,0
"India","2024-06-03",0,0,0,0,0,0,0,0
"India","2024-06-04",0,0,0,0,0,0,0,0
"India","2024-06-05",0,0,0,0,0,0,0,0
"India","2024-06-06",0,0,0,0,0,0,0,0
"India","2024-06-07",0,0,0,0,0,0,0,0
"India","2024-06-08",0,0,0,0,0,0,0,0
"India","2024-06-09",0,0,0,0,0,0,0,0
"India","2024-06-10",0,0,0,0,0,0,0,0
"India","2024-06-11",0,0,0,0,0,0,0,0
"India","2024-06-12",0,0,0,0,0,0,0,0
"India","2024-06-13",0,0,0,0,0,0,0,0
"India","2024-06-14",0,0,0,0,0,0,0,0
"India","2024-06-15",0,0,0,0,0,0,0,0
"India","2024-06-16",0,0,0,0,0,0,0,0
"India","2024-06-17",0,0,0,0,0,0,0,0
"India","2024-06-18",0,0,0,0,0,0,0,0
"India","2024-06-19",0,0,0,0,0,0,0,0
"India","2024-06-20",0,0,0,0,0,0,0,0
"India","2024-06-21",0,0,0,0,0,0,0,0
"India","2024-06-22",0,0,0,0,0,0,0,0
"India","2024-06-23",0,0,0,0,0,0,0,0
"India","2024-06-24",0,0,0,0,0,0,0,0
"India","2024-06-25",0,0,0,0,0,0,0,0
"India","2024-06-26",0,0,0,0,0,0,0,0
"India","2024-06-27",0,0,0,0,0,0,0,0
"India","2024-06-28",0,0,0,0,0,0,0,0
"India","2024-06-29",0,0,0,0,0,0,0,0
"India","2024-06-30",0,0,0,0,0,0,0,0
"India","2024-07-01",0,0,0,0,0,0,0,0
"India","2024-07-02",0,0,0,0,0,0,0,0
"India","2024-07-03",0,0,0,0,0,0,0,0
"India","2024-07-04",0,0,0,0,0,0,0,0
"India","2024-07-05",0,0,0,0,0,0,0,0
"India","2024-07-06",0,0,0,0,0,0,0,0
"India","2024-07-07",0,0,0,0,0,0,0,0
"India","2024-07-08",0,0,0,0,0,0,0,0
"India","2024-07-09",0,0,0,0,0,0,0,0
"India","2024-07-10",0,0,0,0,0,0,0,0
"India","2024-07-11",0,0,0,0,0,0,0,0
"India","2024-07-12",0,0,0,0,0,0,0,0
"India","2024-07-13",0,0,0,0,0,0,0,0
"India","2024-07-14",0,0,0,0,0,0,0,0
"India","2024-07-15",0,0,0,0,0,0,0,0
"India","2024-07-16",0,0,0,0,0,0,0,0
"India","2024-07-17",0,0,0,0,0,0,0,0
"India","2024-07-18",0,0,0,0,0,0,0,0
"India","2024-07-19",0,0,0,0,0,0,0,0
"India","2024-07-20",0,0,0,0,0,0,0,0
"India","2024-07-21",0,0,0,0,0,0,0,0
"India","2024-07-22",0,0,0,0,0,0,0,0
"India","2024-07-23",0,0,0,0,0,0,0,0
"India","2024-07-24",0,0,0,0,0,0,0,0
"India","2024-07-25",0,0,0,0,0,0,0,0
"India","2024-07-26",0,0,0,0,0,0,0,0
"India","2024-07-27",0,0,0,0,0,0,0,0
"India","2024-07-28",0,0,0,0,0,0,0,0
"India","2024-07-29",0,0,0,0,0,0,0,0
"India","2024-07-30",0,0,0,0,0,0,0,0
"India","2024-07-31",0,0,0,0,0,0,0,0
"India","2024-08-01",0,0,0,0,0,0,0,0
"India","2024-08-02",0,0,0,0,0,0,0,0
"India","2024-08-03",0,0,0,0,0,0,0,0
"India","2024-08-04",0,0,0,0,0,0,0,0
"India","2024-08-05",0,0,0,0,0,0,0,0
"India","2024-08-06",0,0,0,0,0,0,0,0
"India","2024-08-07",0,0,0,0,0,0,0,0
"India","2024-08-08",0,0,0,0,0,0,0,0
"India","2024-08-09",0,0,0,0,0,0,0,0
"India","2024-08-10",0,0,0,0,0,0,0,0
"India","2024-08-11",0,0,0,0,0,0,0,0
"India","2024-08-12",0,0,0,0,0,0,0,0
"India","2024-08-13",0,0,0,0,0,0,0,0
"India","2024-08-14",0,0,0,0,0,0,0,0
"India","2024-08-15",0,0,0,0,0,0,0,0
"India","2024-08-16",0,0,0,0,0,0,0,0
"India","2024-08-17",0,0,0,0,0,0,0,0
"India","2024-08-18",0,0,0,0,0,0,0,0
"India","2024-08-19",0,0,0,0,0,0,0,0
"India","2024-08-20",0,0,0,0,0,0,0,0
"India","2024-08-21",0,0,0,0,0,0,0,0
"India","2024-08-22",0,0,0,0,0,0,0,0
"India","2024-08-23",0,0,0,0,0,0,0,0
"India","2024-08-24",0,0,0,0,0,0,0,0
"India","2024-08-25",0,0,0,0,0,0,0,0
"India","2024-08-26",0,0,0,0,0,0,0,0
"India","2024-08-27",0,0,0,0,0,0,0,0
"India","2024-08-28",0,0,0,0,0,0,0,0
"India","2024-08-29",0,0,0,0,0,0,0,0
"India","2024-08-30",0,0,0,0,0,0,0,0
"India","2024-08-31",0,3,3,0,3,3,0,0
"India","2024-09-01",0,0,3,0,0,3,0,0
"India","2024-09-02",0,0,3,0,0,3,0,0
"India","2024-09-03",0,0,3,0,0,3,0,0
"India","2024-09-04",0,0,3,0,0,3,0,0
"India","2024-09-05",0,0,3,0,0,3,0,0
"India","2024-09-06",0,0,3,0,1,4,0,0
"India","2024-09-07",0,0,3,0,0,4,0,0
"India","2024-09-08",0,0,3,0,0,4,0,0
"India","2024-09-09",0,0,3,0,0,4,0,0
"India","2024-09-10",0,0,3,0,0,4,0,0
"India","2024-09-11",0,0,3,0,0,4,0,0
"India","2024-09-12",0,0,3,0,0,4,0,0
"India","2024-09-13",0,0,3,0,0,4,0,0
"India","2024-09-14",0,0,3,0,0,4,0,0
"India","2024-09-15",0,0,3,0,1,5,0,0
"India","2024-09-16",0,0,3,0,0,5,0,0
"India","2024-09-17",0,0,3,0,0,5,0,0
"India","2024-09-18",0,0,3,0,0,5,0,0
"India","2024-09-19",0,0,3,0,0,5,0,0
"India","2024-09-20",0,0,3,0,0,5,0,0
"India","2024-09-21",0,0,3,0,0,5,0,0
"India","2024-09-22",0,0,3,0,0,5,0,0
"India","2024-09-23",0,0,3,0,0,5,0,0
"India","2024-09-24",0,0,3,0,0,5,0,0
"India","2024-09-25",0,0,3,0,0,5,0,0
"India","2024-09-26",0,0,3,0,1,6,0,0
"India","2024-09-27",0,0,3,0,0,6,0,0
"India","2024-09-28",0,0,3,0,0,6,0,0
"India","2024-09-29",0,0,3,0,0,6,0,0
"India","2024-09-30",0,3,6,0,0,6,0,0
"India","2024-10-01",0,0,6,0,0,6,0,0
"India","2024-10-02",0,0,6,0,0,6,0,0
"India","2024-10-03",0,0,6,0,0,6,0,0
"India","2024-10-04",0,0,6,0,0,6,0,0
"India","2024-10-05",0,0,6,0,0,6,0,0
"India","2024-10-06",0,0,6,0,0,6,0,0
"India","2024-10-07",0,0,6,0,0,6,0,0
"India","2024-10-08",0,0,6,0,0,6,0,0
"India","2024-10-09",0,0,6,0,0,6,0,0
"India","2024-10-10",0,0,6,0,0,6,0,0
"India","2024-10-11",0,0,6,0,0,6,0,0
"India","2024-10-12",0,0,6,0,0,6,0,0
"India","2024-10-13",0,0,6,0,0,6,0,0
"India","2024-10-14",0,0,6,0,0,6,0,0
"India","2024-10-15",0,0,6,0,0,6,0,0
"India","2024-10-16",0,0,6,0,1,7,0,0
"India","2024-10-17",0,0,6,0,0,7,0,0
"India","2024-10-18",0,0,6,0,0,7,0,0
"India","2024-10-19",0,0,6,0,0,7,0,0
"India","2024-10-20",0,0,6,0,0,7,0,0
"India","2024-10-21",0,0,6,0,0,7,0,0
"India","2024-10-22",0,0,6,0,0,7,0,0
"India","2024-10-23",0,0,6,0,0,7,0,0
"India","2024-10-24",0,0,6,0,0,7,0,0
"India","2024-10-25",0,0,6,0,0,7,0,0
"India","2024-10-26",0,0,6,0,0,7,0,0
"India","2024-10-27",0,0,6,0,0,7,0,0
"India","2024-10-28",0,0,6,0,0,7,0,0
"India","2024-10-29",0,0,6,0,0,7,0,0
"India","2024-10-30",0,0,6,0,0,7,0,0
"India","2024-10-31",0,0,6,0,0,7,0,0
"India","2024-11-01",0,0,6,0,0,7,0,0
"India","2024-11-02",0,0,6,0,0,7,0,0
"India","2024-11-03",0,0,6,0,0,7,0,0
"India","2024-11-04",0,0,6,0,0,7,0,0
"India","2024-11-05",0,0,6,0,0,7,0,0
"India","2024-11-06",0,0,6,0,0,7,0,0
"India","2024-11-07",0,0,6,0,0,7,0,0
"India","2024-11-08",0,0,6,0,0,7,0,0
"India","2024-11-09",0,0,6,0,0,7,0,0
"India","2024-11-10",0,0,6,0,0,7,0,0
"India","2024-11-11",0,0,6,0,0,7,0,0
"India","2024-11-12",0,0,6,0,0,7,0,0
"India","2024-11-13",0,0,6,0,0,7,0,0
"India","2024-11-14",0,0,6,0,0,7,0,0
"India","2024-11-15",0,0,6,0,1,8,0,0
"India","2024-11-16",0,0,6,0,0,8,0,0
"India","2024-11-17",0,0,6,0,0,8,0,0
"India","2024-11-18",0,0,6,0,0,8,0,0
"India","2024-11-19",0,0,6,0,0,8,0,0
"India","2024-11-20",0,0,6,0,0,8,0,0
"India","2024-11-21",0,0,6,0,0,8,0,0
"India","2024-11-22",0,0,6,0,0,8,0,0
"India","2024-11-23",0,0,6,0,0,8,0,0
"India","2024-11-24",0,0,6,0,0,8,0,0
"India","2024-11-25",0,0,6,0,0,8,0,0
"India","2024-11-26",0,0,6,0,0,8,0,0
"India","2024-11-27",0,0,6,0,0,8,0,0
"India","2024-11-28",0,0,6,0,0,8,0,0
"India","2024-11-29",0,0,6,0,0,8,0,0
"India","2024-11-30",0,0,6,0,0,8,0,0
"India","2024-12-01",0,0,6,0,0,8,0,0
"India","2024-12-02",0,0,6,0,0,8,0,0
"India","2024-12-03",0,0,6,0,0,8,0,0
"India","2024-12-04",0,0,6,0,0,8,0,0
"India","2024-12-05",0,0,6,0,0,8,0,0
"India","2024-12-06",0,0,6,0,0,8,0,0
"India","2024-12-07",0,0,6,0,0,8,0,0
"India","2024-12-08",0,0,6,0,0,8,0,0
"India","2024-12-09",0,0,6,0,0,8,0,0
"India","2024-12-10",0,0,6,0,0,8,0,0
"India","2024-12-11",0,0,6,0,0,8,0,0
"India","2024-12-12",0,0,6,0,0,8,0,0
"India","2024-12-13",0,0,6,0,0,8,0,0
"India","2024-12-14",0,0,6,0,0,8,0,0
"India","2024-12-15",0,0,6,0,0,8,0,0
"India","2024-12-16",0,0,6,0,1,9,0,0
"India","2024-12-17",0,0,6,0,0,9,0,0
"India","2024-12-18",0,0,6,0,0,9,0,0
"India","2024-12-19",0,0,6,0,0,9,0,0
"India","2024-12-20",0,0,6,0,0,9,0,0
"India","2024-12-21",0,0,6,0,0,9,0,0
"India","2024-12-22",0,0,6,0,0,9,0,0
"India","2024-12-23",0,0,6,0,0,9,0,0
"India","2024-12-24",0,0,6,0,0,9,0,0
"India","2024-12-25",0,0,6,0,0,9,0,0
"India","2024-12-26",0,0,6,0,0,9,0,0
"India","2024-12-27",0,0,6,0,0,9,0,0
"India","2024-12-28",0,0,6,0,0,9,0,0
"India","2024-12-29",0,0,6,0,0,9,0,0
"India","2024-12-30",0,0,6,0,0,9,0,0
"India","2024-12-31",0,3,9,0,0,9,0,0
"India","2025-01-01",0,0,9,0,0,9,0,0
"India","2025-01-02",0,0,9,0,0,9,0,0
"India","2025-01-03",0,0,9,0,0,9,0,0
"India","2025-01-04",0,0,9,0,0,9,0,0
"India","2025-01-05",0,0,9,0,0,9,0,0
"India","2025-01-06",0,0,9,0,0,9,0,0
"India","2025-01-07",0,0,9,0,0,9,0,0
"India","2025-01-08",0,0,9,0,0,9,0,0
"India","2025-01-09",0,0,9,0,0,9,0,0
"India","2025-01-10",0,0,9,0,0,9,0,0
"India","2025-01-11",0,0,9,0,0,9,0,0
"India","2025-01-12",0,0,9,0,0,9,0,0
"India","2025-01-13",0,0,9,0,0,9,0,0
"India","2025-01-14",0,0,9,0,0,9,0,0
"India","2025-01-15",0,0,9,0,0,9,0,0
"India","2025-01-16",0,0,9,0,0,9,0,0
"India","2025-01-17",0,0,9,0,0,9,0,0
"India","2025-01-18",0,0,9,0,0,9,0,0
"India","2025-01-19",0,0,9,0,0,9,0,0
"India","2025-01-20",0,0,9,0,0,9,0,0
"India","2025-01-21",0,0,9,0,0,9,0,0
"India","2025-01-22",0,0,9,0,0,9,0,0
"India","2025-01-23",0,0,9,0,0,9,0,0
"India","2025-01-24",0,0,9,0,0,9,0,0
"India","2025-01-25",0,0,9,0,0,9,0,0
"India","2025-01-26",0,0,9,0,0,9,0,0
"India","2025-01-27",0,0,9,0,0,9,0,0
"India","2025-01-28",0,0,9,0,0,9,0,0
"India","2025-01-29",0,0,9,0,0,9,0,0
"India","2025-01-30",0,0,9,0,0,9,0,0
"India","2025-01-31",0,0,9,0,0,9,0,0
"India","2025-02-01",0,0,9,0,0,9,0,0
"India","2025-02-02",0,0,9,0,0,9,0,0
"India","2025-02-03",0,0,9,0,0,9,0,0
"Indonesia","2024-01-01",0,0,0,0,0,0,0,0
"Indonesia","2024-01-02",0,0,0,0,0,0,0,0
"Indonesia","2024-01-03",0,0,0,0,0,0,0,0
"Indonesia","2024-01-04",0,0,0,0,0,0,0,0
"Indonesia","2024-01-05",0,0,0,0,0,0,0,0
"Indonesia","2024-01-06",0,0,0,0,0,0,0,0
"Indonesia","2024-01-07",0,0,0,0,0,0,0,0
"Indonesia","2024-01-08",0,0,0,0,0,0,0,0
"Indonesia","2024-01-09",0,0,0,0,0,0,0,0
"Indonesia","2024-01-10",0,0,0,0,0,0,0,0
"Indonesia","2024-01-11",0,0,0,0,0,0,0,0
"Indonesia","2024-01-12",0,0,0,0,0,0,0,0
"Indonesia","2024-01-13",0,0,0,0,0,0,0,0
"Indonesia","2024-01-14",0,0,0,0,0,0,0,0
"Indonesia","2024-01-15",0,0,0,0,0,0,0,0
"Indonesia","2024-01-16",0,0,0,0,0,0,0,0
"Indonesia","2024-01-17",0,0,0,0,0,0,0,0
"Indonesia","2024-01-18",0,0,0,0,0,0,0,0
"Indonesia","2024-01-19",0,0,0,0,0,0,0,0
"Indonesia","2024-01-20",0,0,0,0,0,0,0,0
"Indonesia","2024-01-21",0,0,0,0,0,0,0,0
"Indonesia","2024-01-22",0,0,0,0,0,0,0,0
"Indonesia","2024-01-23",0,0,0,0,0,0,0,0
"Indonesia","2024-01-24",0,0,0,0,0,0,0,0
"Indonesia","2024-01-25",0,0,0,0,0,0,0,0
"Indonesia","2024-01-26",0,0,0,0,0,0,0,0
"Indonesia","2024-01-27",0,0,0,0,0,0,0,0
"Indonesia","2024-01-28",0,0,0,0,0,0,0,0
"Indonesia","2024-01-29",0,0,0,0,0,0,0,0
"Indonesia","2024-01-30",0,0,0,0,0,0,0,0
"Indonesia","2024-01-31",0,7,7,0,7,7,0,0
"Indonesia","2024-02-01",0,0,7,0,0,7,0,0
"Indonesia","2024-02-02",0,0,7,0,0,7,0,0
"Indonesia","2024-02-03",0,0,7,0,0,7,0,0
"Indonesia","2024-02-04",0,0,7,0,1,8,0,0
"Indonesia","2024-02-05",0,0,7,0,0,8,0,0
"Indonesia","2024-02-06",0,0,7,0,0,8,0,0
"Indonesia","2024-02-07",0,0,7,0,0,8,0,0
"Indonesia","2024-02-08",0,0,7,0,0,8,0,0
"Indonesia","2024-02-09",0,0,7,0,0,8,0,0
"Indonesia","2024-02-10",0,0,7,0,0,8,0,0
"Indonesia","2024-02-11",0,0,7,0,1,9,0,0
"Indonesia","2024-02-12",0,0,7,0,0,9,0,0
"Indonesia","2024-02-13",0,0,7,0,0,9,0,0
"Indonesia","2024-02-14",0,0,7,0,0,9,0,0
"Indonesia","2024-02-15",0,0,7,0,0,9,0,0
"Indonesia","2024-02-16",0,0,7,0,0,9,0,0
"Indonesia","2024-02-17",0,0,7,0,0,9,0,0
"Indonesia","2024-02-18",0,0,7,0,0,9,0,0
"Indonesia","2024-02-19",0,0,7,0,1,10,0,0
"Indonesia","2024-02-20",0,0,7,0,0,10,0,0
"Indonesia","2024-02-21",0,0,7,0,0,10,0,0
"Indonesia","2024-02-22",0,0,7,0,0,10,0,0
"Indonesia","2024-02-23",0,0,7,0,0,10,0,0
"Indonesia","2024-02-24",0,0,7,0,0,10,0,0
"Indonesia","2024-02-25",0,0,7,0,0,10,0,0
"Indonesia","2024-02-26",0,0,7,0,1,11,0,0
"Indonesia","2024-02-27",0,0,7,0,0,11,0,0
"Indonesia","2024-02-28",0,0,7,0,0,11,0,0
"Indonesia","2024-02-29",0,4,11,0,0,11,0,0
"Indonesia","2024-03-01",0,0,11,0,0,11,0,0
"Indonesia","2024-03-02",0,0,11,0,0,11,0,0
"Indonesia","2024-03-03",0,0,11,0,0,11,0,0
"Indonesia","2024-03-04",0,0,11,0,0,11,0,0
"Indonesia","2024-03-05",0,0,11,0,0,11,0,0
"Indonesia","2024-03-06",0,0,11,0,0,11,0,0
"Indonesia","2024-03-07",0,0,11,0,0,11,0,0
"Indonesia","2024-03-08",0,0,11,0,0,11,0,0
"Indonesia","2024-03-09",0,0,11,0,0,11,0,0
"Indonesia","2024-03-10",0,0,11,0,0,11,0,0
"Indonesia","2024-03-11",0,0,11,0,0,11,0,0
"Indonesia","2024-03-12",0,0,11,0,0,11,0,0
"Indonesia","2024-03-13",0,0,11,0,0,11,0,0
"Indonesia","2024-03-14",0,0,11,0,0,11,0,0
"Indonesia","2024-03-15",0,0,11,0,0,11,0,0
"Indonesia","2024-03-16",0,0,11,0,0,11,0,0
"Indonesia","2024-03-17",0,0,11,0,1,12,0,0
"Indonesia","2024-03-18",0,0,11,0,0,12,0,0
"Indonesia","2024-03-19",0,0,11,0,0,12,0,0
"Indonesia","2024-03-20",0,0,11,0,0,12,0,0
"Indonesia","2024-03-21",0,0,11,0,0,12,0,0
"Indonesia","2024-03-22",0,0,11,0,0,12,0,0
"Indonesia","2024-03-23",0,0,11,0,0,12,0,0
"Indonesia","2024-03-24",0,0,11,0,0,12,0,0
"Indonesia","2024-03-25",0,0,11,0,0,12,0,0
"Indonesia","2024-03-26",0,0,11,0,0,12,0,0
"Indonesia","2024-03-27",0,0,11,0,0,12,0,0
"Indonesia","2024-03-28",0,0,11,0,0,12,0,0
"Indonesia","2024-03-29",0,0,11,0,0,12,0,0
"Indonesia","2024-03-30",0,0,11,0,0,12,0,0
"Indonesia","2024-03-31",0,0,11,0,0,12,0,0
"Indonesia","2024-04-01",0,0,11,0,0,12,0,0
"Indonesia","2024-04-02",0,1,12,0,0,12,0,0
"Indonesia","2024-04-03",0,0,12,0,0,12,0,0
"Indonesia","2024-04-04",0,0,12,0,0,12,0,0
"Indonesia","2024-04-05",0,0,12,0,0,12,0,0
"Indonesia","2024-04-06",0,0,12,0,0,12,0,0
"Indonesia","2024-04-07",0,0,12,0,0,12,0,0
"Indonesia","2024-04-08",0,0,12,0,0,12,0,0
"Indonesia","2024-04-09",0,0,12,0,0,12,0,0
"Indonesia","2024-04-10",0,0,12,0,0,12,0,0
"Indonesia","2024-04-11",0,0,12,0,0,12,0,0
"Indonesia","2024-04-12",0,0,12,0,0,12,0,0
"Indonesia","2024-04-13",0,0,12,0,0,12,0,0
"Indonesia","2024-04-14",0,0,12,0,0,12,0,0
"Indonesia","2024-04-15",0,0,12,0,0,12,0,0
"Indonesia","2024-04-16",0,0,12,0,0,12,0,0
"Indonesia","2024-04-17",0,0,12,0,1,13,0,0
"Indonesia","2024-04-18",0,0,12,0,0,13,0,0
"Indonesia","2024-04-19",0,0,12,0,0,13,0,0
"Indonesia","2024-04-20",0,0,12,0,0,13,0,0
"Indonesia","2024-04-21",0,0,12,0,0,13,0,0
"Indonesia","2024-04-22",0,0,12,0,0,13,0,0
"Indonesia","2024-04-23",0,0,12,0,0,13,0,0
"Indonesia","2024-04-24",0,0,12,0,0,13,0,0
"Indonesia","2024-04-25",0,0,12,0,0,13,0,0
"Indonesia","2024-04-26",0,0,12,0,0,13,0,0
"Indonesia","2024-04-27",0,0,12,0,0,13,0,0
"Indonesia","2024-04-28",0,0,12,0,0,13,0,0
"Indonesia","2024-04-29",0,0,12,0,0,13,0,0
"Indonesia","2024-04-30",0,1,13,0,0,13,0,0
"Indonesia","2024-05-01",0,0,13,0,0,13,0,0
"Indonesia","2024-05-02",0,0,13,0,0,13,0,0
"Indonesia","2024-05-03",0,0,13,0,0,13,0,0
"Indonesia","2024-05-04",0,0,13,0,0,13,0,0
"Indonesia","2024-05-05",0,0,13,0,0,13,0,0
"Indonesia","2024-05-06",0,0,13,0,0,13,0,0
"Indonesia","2024-05-07",0,0,13,0,0,13,0,0
"Indonesia","2024-05-08",0,0,13,0,0,13,0,0
"Indonesia","2024-05-09",0,0,13,0,0,13,0,0
"Indonesia","2024-05-10",0,0,13,0,0,13,0,0
"Indonesia","2024-05-11",0,0,13,0,0,13,0,0
"Indonesia","2024-05-12",0,0,13,0,0,13,0,0
"Indonesia","2024-05-13",0,0,13,0,0,13,0,0
"Indonesia","2024-05-14",0,0,13,0,0,13,0,0
"Indonesia","2024-05-15",0,0,13,0,0,13,0,0
"Indonesia","2024-05-16",0,0,13,0,1,14,0,0
"Indonesia","2024-05-17",0,0,13,0,0,14,0,0
"Indonesia","2024-05-18",0,0,13,0,0,14,0,0
"Indonesia","2024-05-19",0,0,13,0,0,14,0,0
"Indonesia","2024-05-20",0,0,13,0,0,14,0,0
"Indonesia","2024-05-21",0,0,13,0,0,14,0,0
"Indonesia","2024-05-22",0,0,13,0,0,14,0,0
"Indonesia","2024-05-23",0,0,13,0,0,14,0,0
"Indonesia","2024-05-24",0,0,13,0,0,14,0,0
"Indonesia","2024-05-25",0,0,13,0,0,14,0,0
"Indonesia","2024-05-26",0,0,13,0,0,14,0,0
"Indonesia","2024-05-27",0,0,13,0,0,14,0,0
"Indonesia","2024-05-28",0,0,13,0,0,14,0,0
"Indonesia","2024-05-29",0,0,13,0,0,14,0,0
"Indonesia","2024-05-30",0,0,13,0,0,14,0,0
"Indonesia","2024-05-31",0,1,14,0,0,14,0,0
"Indonesia","2024-06-01",0,0,14,0,0,14,0,0
"Indonesia","2024-06-02",0,0,14,0,0,14,0,0
"Indonesia","2024-06-03",0,0,14,0,0,14,0,0
"Indonesia","2024-06-04",0,0,14,0,0,14,0,0
"Indonesia","2024-06-05",0,0,14,0,0,14,0,0
"Indonesia","2024-06-06",0,0,14,0,0,14,0,0
"Indonesia","2024-06-07",0,0,14,0,0,14,0,0
"Indonesia","2024-06-08",0,0,14,0,0,14,0,0
"Indonesia","2024-06-09",0,0,14,0,0,14,0,0
"Indonesia","2024-06-10",0,0,14,0,0,14,0,0
"Indonesia","2024-06-11",0,0,14,0,0,14,0,0
"Indonesia","2024-06-12",0,0,14,0,0,14,0,0
"Indonesia","2024-06-13",0,0,14,0,0,14,0,0
"Indonesia","2024-06-14",0,0,14,0,0,14,0,0
"Indonesia","2024-06-15",0,0,14,0,0,14,0,0
"Indonesia","2024-06-16",0,0,14,0,1,15,0,0
"Indonesia","2024-06-17",0,0,14,0,0,15,0,0
"Indonesia","2024-06-18",0,0,14,0,0,15,0,0
"Indonesia","2024-06-19",0,0,14,0,0,15,0,0
"Indonesia","2024-06-20",0,0,14,0,0,15,0,0
"Indonesia","2024-06-21",0,0,14,0,0,15,0,0
"Indonesia","2024-06-22",0,0,14,0,0,15,0,0
"Indonesia","2024-06-23",0,0,14,0,0,15,0,0
"Indonesia","2024-06-24",0,0,14,0,0,15,0,0
"Indonesia","2024-06-25",0,0,14,0,0,15,0,0
"Indonesia","2024-06-26",0,0,14,0,0,15,0,0
"Indonesia","2024-06-27",0,0,14,0,0,15,0,0
"Indonesia","2024-06-28",0,0,14,0,0,15,0,0
"Indonesia","2024-06-29",0,0,14,0,0,15,0,0
"Indonesia","2024-06-30",0,1,15,0,0,15,0,0
"Indonesia","2024-07-01",0,0,15,0,0,15,0,0
"Indonesia","2024-07-02",0,0,15,0,0,15,0,0
"Indonesia","2024-07-03",0,0,15,0,0,15,0,0
"Indonesia","2024-07-04",0,0,15,0,0,15,0,0
"Indonesia","2024-07-05",0,0,15,0,0,15,0,0
"Indonesia","2024-07-06",0,0,15,0,0,15,0,0
"Indonesia","2024-07-07",0,0,15,0,0,15,0,0
"Indonesia","2024-07-08",0,0,15,0,0,15,0,0
"Indonesia","2024-07-09",0,0,15,0,0,15,0,0
"Indonesia","2024-07-10",0,0,15,0,0,15,0,0
"Indonesia","2024-07-11",0,0,15,0,0,15,0,0
"Indonesia","2024-07-12",0,0,15,0,0,15,0,0
"Indonesia","2024-07-13",0,0,15,0,0,15,0,0
"Indonesia","2024-07-14",0,0,15,0,0,15,0,0
"Indonesia","2024-07-15",0,0,15,0,0,15,0,0
"Indonesia","2024-07-16",0,0,15,0,0,15,0,0
"Indonesia","2024-07-17",0,0,15,0,0,15,0,0
"Indonesia","2024-07-18",0,0,15,0,0,15,0,0
"Indonesia","2024-07-19",0,0,15,0,0,15,0,0
"Indonesia","2024-07-20",0,0,15,0,0,15,0,0
"Indonesia","2024-07-21",0,0,15,0,0,15,0,0
"Indonesia","2024-07-22",0,0,15,0,0,15,0,0
"Indonesia","2024-07-23",0,0,15,0,0,15,0,0
"Indonesia","2024-07-24",0,0,15,0,0,15,0,0
"Indonesia","2024-07-25",0,0,15,0,0,15,0,0
"Indonesia","2024-07-26",0,0,15,0,0,15,0,0
"Indonesia","2024-07-27",0,0,15,0,0,15,0,0
"Indonesia","2024-07-28",0,0,15,0,0,15,0,0
"Indonesia","2024-07-29",0,0,15,0,0,15,0,0
"Indonesia","2024-07-30",0,0,15,0,0,15,0,0
"Indonesia","2024-07-31",0,0,15,0,0,15,0,0
"Indonesia","2024-08-01",0,0,15,0,0,15,0,0
"Indonesia","2024-08-02",0,0,15,0,0,15,0,0
"Indonesia","2024-08-03",0,0,15,0,0,15,0,0
"Indonesia","2024-08-04",0,0,15,0,0,15,0,0
"Indonesia","2024-08-05",0,0,15,0,0,15,0,0
"Indonesia","2024-08-06",0,0,15,0,0,15,0,0
"Indonesia","2024-08-07",0,0,15,0,0,15,0,0
"Indonesia","2024-08-08",0,0,15,0,0,15,0,0
"Indonesia","2024-08-09",0,0,15,0,0,15,0,0
"Indonesia","2024-08-10",0,0,15,0,0,15,0,0
"Indonesia","2024-08-11",0,0,15,0,0,15,0,0
"Indonesia","2024-08-12",0,0,15,0,0,15,0,0
"Indonesia","2024-08-13",0,0,15,0,0,15,0,0
"Indonesia","2024-08-14",0,0,15,0,0,15,0,0
"Indonesia","2024-08-15",0,0,15,0,0,15,0,0
"Indonesia","2024-08-16",0,0,15,0,0,15,0,0
"Indonesia","2024-08-17",0,0,15,0,0,15,0,0
"Indonesia","2024-08-18",0,0,15,0,0,15,0,0
"Indonesia","2024-08-19",0,0,15,0,0,15,0,0
"Indonesia","2024-08-20",0,0,15,0,0,15,0,0
"Indonesia","2024-08-21",0,0,15,0,0,15,0,0
"Indonesia","2024-08-22",0,0,15,0,0,15,0,0
"Indonesia","2024-08-23",0,0,15,0,0,15,0,0
"Indonesia","2024-08-24",0,0,15,0,0,15,0,0
"Indonesia","2024-08-25",0,0,15,0,0,15,0,0
"Indonesia","2024-08-26",0,0,15,0,0,15,0,0
"Indonesia","2024-08-27",0,0,15,0,0,15,0,0
"Indonesia","2024-08-28",0,0,15,0,0,15,0,0
"Indonesia","2024-08-29",0,0,15,0,0,15,0,0
"Indonesia","2024-08-30",0,0,15,0,0,15,0,0
"Indonesia","2024-08-31",0,0,15,0,0,15,0,0
"Indonesia","2024-09-01",0,0,15,0,0,15,0,0
"Indonesia","2024-09-02",0,0,15,0,0,15,0,0
"Indonesia","2024-09-03",0,0,15,0,0,15,0,0
"Indonesia","2024-09-04",0,0,15,0,0,15,0,0
"Indonesia","2024-09-05",0,0,15,0,0,15,0,0
"Indonesia","2024-09-06",0,0,15,0,0,15,0,0
"Indonesia","2024-09-07",0,0,15,0,0,15,0,0
"Indonesia","2024-09-08",0,0,15,0,0,15,0,0
"Indonesia","2024-09-09",0,0,15,0,0,15,0,0
"Indonesia","2024-09-10",0,0,15,0,0,15,0,0
"Indonesia","2024-09-11",0,0,15,0,0,15,0,0
"Indonesia","2024-09-12",0,0,15,0,0,15,0,0
"Indonesia","2024-09-13",0,0,15,0,0,15,0,0
"Indonesia","2024-09-14",0,0,15,0,0,15,0,0
"Indonesia","2024-09-15",0,0,15,0,0,15,0,0
"Indonesia","2024-09-16",0,0,15,0,0,15,0,0
"Indonesia","2024-09-17",0,0,15,0,0,15,0,0
"Indonesia","2024-09-18",0,0,15,0,0,15,0,0
"Indonesia","2024-09-19",0,0,15,0,0,15,0,0
"Indonesia","2024-09-20",0,0,15,0,0,15,0,0
"Indonesia","2024-09-21",0,0,15,0,0,15,0,0
"Indonesia","2024-09-22",0,0,15,0,0,15,0,0
"Indonesia","2024-09-23",0,0,15,0,0,15,0,0
"Indonesia","2024-09-24",0,0,15,0,0,15,0,0
"Indonesia","2024-09-25",0,0,15,0,0,15,0,0
"Indonesia","2024-09-26",0,0,15,0,0,15,0,0
"Indonesia","2024-09-27",0,0,15,0,0,15,0,0
"Indonesia","2024-09-28",0,0,15,0,0,15,0,0
"Indonesia","2024-09-29",0,0,15,0,0,15,0,0
"Indonesia","2024-09-30",0,0,15,0,0,15,0,0
"Indonesia","2024-10-01",0,0,15,0,0,15,0,0
"Indonesia","2024-10-02",0,0,15,0,0,15,0,0
"Indonesia","2024-10-03",0,0,15,0,0,15,0,0
"Indonesia","2024-10-04",0,0,15,0,0,15,0,0
"Indonesia","2024-10-05",0,0,15,0,0,15,0,0
"Indonesia","2024-10-06",0,0,15,0,0,15,0,0
"Indonesia","2024-10-07",0,0,15,0,0,15,0,0
"Indonesia","2024-10-08",0,0,15,0,0,15,0,0
"Indonesia","2024-10-09",0,0,15,0,0,15,0,0
"Indonesia","2024-10-10",0,0,15,0,0,15,0,0
"Indonesia","2024-10-11",0,0,15,0,0,15,0,0
"Indonesia","2024-10-12",0,0,15,0,0,15,0,0
"Indonesia","2024-10-13",0,0,15,0,0,15,0,0
"Indonesia","2024-10-14",0,0,15,0,0,15,0,0
"Indonesia","2024-10-15",0,0,15,0,0,15,0,0
"Indonesia","2024-10-16",0,0,15,0,0,15,0,0
"Indonesia","2024-10-17",0,0,15,0,0,15,0,0
"Indonesia","2024-10-18",0,0,15,0,0,15,0,0
"Indonesia","2024-10-19",0,0,15,0,0,15,0,0
"Indonesia","2024-10-20",0,0,15,0,0,15,0,0
"Indonesia","2024-10-21",0,0,15,0,0,15,0,0
"Indonesia","2024-10-22",0,0,15,0,0,15,0,0
"Indonesia","2024-10-23",0,0,15,0,0,15,0,0
"Indonesia","2024-10-24",0,0,15,0,0,15,0,0
"Indonesia","2024-10-25",0,0,15,0,0,15,0,0
"Indonesia","2024-10-26",0,0,15,0,0,15,0,0
"Indonesia","2024-10-27",0,0,15,0,0,15,0,0
"Indonesia","2024-10-28",0,0,15,0,0,15,0,0
"Indonesia","2024-10-29",0,0,15,0,0,15,0,0
"Indonesia","2024-10-30",0,0,15,0,0,15,0,0
"Indonesia","2024-10-31",0,0,15,0,0,15,0,0
"Indonesia","2024-11-01",0,0,15,0,0,15,0,0
"Indonesia","2024-11-02",0,0,15,0,0,15,0,0
"Indonesia","2024-11-03",0,0,15,0,0,15,0,0
"Indonesia","2024-11-04",0,0,15,0,0,15,0,0
"Indonesia","2024-11-05",0,0,15,0,0,15,0,0
"Indonesia","2024-11-06",0,0,15,0,0,15,0,0
"Indonesia","2024-11-07",0,0,15,0,0,15,0,0
"Indonesia","2024-11-08",0,0,15,0,0,15,0,0
"Indonesia","2024-11-09",0,0,15,0,0,15,0,0
"Indonesia","2024-11-10",0,0,15,0,0,15,0,0
"Indonesia","2024-11-11",0,0,15,0,0,15,0,0
"Indonesia","2024-11-12",0,0,15,0,0,15,0,0
"Indonesia","2024-11-13",0,0,15,0,0,15,0,0
"Indonesia","2024-11-14",0,0,15,0,0,15,0,0
"Indonesia","2024-11-15",0,0,15,0,0,15,0,0
"Indonesia","2024-11-16",0,0,15,0,0,15,0,0
"Indonesia","2024-11-17",0,0,15,0,0,15,0,0
"Indonesia","2024-11-18",0,0,15,0,0,15,0,0
"Indonesia","2024-11-19",0,0,15,0,0,15,0,0
"Indonesia","2024-11-20",0,0,15,0,0,15,0,0
"Indonesia","2024-11-21",0,0,15,0,0,15,0,0
"Indonesia","2024-11-22",0,0,15,0,0,15,0,0
"Indonesia","2024-11-23",0,0,15,0,0,15,0,0
"Indonesia","2024-11-24",0,0,15,0,0,15,0,0
"Indonesia","2024-11-25",0,0,15,0,0,15,0,0
"Indonesia","2024-11-26",0,0,15,0,0,15,0,0
"Indonesia","2024-11-27",0,0,15,0,0,15,0,0
"Indonesia","2024-11-28",0,0,15,0,0,15,0,0
"Indonesia","2024-11-29",0,0,15,0,0,15,0,0
"Indonesia","2024-11-30",0,0,15,0,0,15,0,0
"Indonesia","2024-12-01",0,0,15,0,0,15,0,0
"Indonesia","2024-12-02",0,0,15,0,0,15,0,0
"Indonesia","2024-12-03",0,0,15,0,0,15,0,0
"Indonesia","2024-12-04",0,0,15,0,0,15,0,0
"Indonesia","2024-12-05",0,0,15,0,0,15,0,0
"Indonesia","2024-12-06",0,0,15,0,0,15,0,0
"Indonesia","2024-12-07",0,0,15,0,0,15,0,0
"Indonesia","2024-12-08",0,0,15,0,0,15,0,0
"Indonesia","2024-12-09",0,0,15,0,0,15,0,0
"Indonesia","2024-12-10",0,0,15,0,0,15,0,0
"Indonesia","2024-12-11",0,0,15,0,0,15,0,0
"Indonesia","2024-12-12",0,0,15,0,0,15,0,0
"Indonesia","2024-12-13",0,0,15,0,0,15,0,0
"Indonesia","2024-12-14",0,0,15,0,0,15,0,0
"Indonesia","2024-12-15",0,0,15,0,0,15,0,0
"Indonesia","2024-12-16",0,0,15,0,0,15,0,0
"Indonesia","2024-12-17",0,0,15,0,0,15,0,0
"Indonesia","2024-12-18",0,0,15,0,0,15,0,0
"Indonesia","2024-12-19",0,0,15,0,0,15,0,0
"Indonesia","2024-12-20",0,0,15,0,0,15,0,0
"Indonesia","2024-12-21",0,0,15,0,0,15,0,0
"Indonesia","2024-12-22",0,0,15,0,0,15,0,0
"Indonesia","2024-12-23",0,0,15,0,0,15,0,0
"Indonesia","2024-12-24",0,0,15,0,0,15,0,0
"Indonesia","2024-12-25",0,0,15,0,0,15,0,0
"Indonesia","2024-12-26",0,0,15,0,0,15,0,0
"Indonesia","2024-12-27",0,0,15,0,0,15,0,0
"Indonesia","2024-12-28",0,0,15,0,0,15,0,0
"Indonesia","2024-12-29",0,0,15,0,0,15,0,0
"Indonesia","2024-12-30",0,0,15,0,0,15,0,0
"Indonesia","2024-12-31",0,0,15,0,0,15,0,0
"Indonesia","2025-01-01",0,0,15,0,0,15,0,0
"Indonesia","2025-01-02",0,0,15,0,0,15,0,0
"Indonesia","2025-01-03",0,0,15,0,0,15,0,0
"Indonesia","2025-01-04",0,0,15,0,0,15,0,0
"Indonesia","2025-01-05",0,0,15,0,0,15,0,0
"Indonesia","2025-01-06",0,0,15,0,0,15,0,0
"Indonesia","2025-01-07",0,0,15,0,0,15,0,0
"Indonesia","2025-01-08",0,0,15,0,0,15,0,0
"Indonesia","2025-01-09",0,0,15,0,0,15,0,0
"Indonesia","2025-01-10",0,0,15,0,0,15,0,0
"Indonesia","2025-01-11",0,0,15,0,0,15,0,0
"Indonesia","2025-01-12",0,0,15,0,0,15,0,0
"Indonesia","2025-01-13",0,0,15,0,0,15,0,0
"Indonesia","2025-01-14",0,0,15,0,0,15,0,0
"Indonesia","2025-01-15",0,0,15,0,0,15,0,0
"Indonesia","2025-01-16",0,0,15,0,0,15,0,0
"Indonesia","2025-01-17",0,0,15,0,0,15,0,0
"Indonesia","2025-01-18",0,0,15,0,0,15,0,0
"Indonesia","2025-01-19",0,0,15,0,0,15,0,0
"Indonesia","2025-01-20",0,0,15,0,0,15,0,0
"Indonesia","2025-01-21",0,0,15,0,0,15,0,0
"Indonesia","2025-01-22",0,0,15,0,0,15,0,0
"Indonesia","2025-01-23",0,0,15,0,0,15,0,0
"Indonesia","2025-01-24",0,0,15,0,0,15,0,0
"Indonesia","2025-01-25",0,0,15,0,0,15,0,0
"Indonesia","2025-01-26",0,0,15,0,0,15,0,0
"Indonesia","2025-01-27",0,0,15,0,0,15,0,0
"Indonesia","2025-01-28",0,0,15,0,0,15,0,0
"Indonesia","2025-01-29",0,0,15,0,0,15,0,0
"Indonesia","2025-01-30",0,0,15,0,0,15,0,0
"Indonesia","2025-01-31",0,0,15,0,0,15,0,0
"Indonesia","2025-02-01",0,0,15,0,0,15,0,0
"Indonesia","2025-02-02",0,0,15,0,0,15,0,0
"Indonesia","2025-02-03",0,0,15,0,0,15,0,0
"Ireland","2024-01-01",0,0,0,0,0,0,0,0
"Ireland","2024-01-02",0,0,0,0,0,0,0,0
"Ireland","2024-01-03",0,0,0,0,0,0,0,0
"Ireland","2024-01-04",0,0,0,0,0,0,0,0
"Ireland","2024-01-05",0,0,0,0,0,0,0,0
"Ireland","2024-01-06",0,0,0,0,0,0,0,0
"Ireland","2024-01-07",0,0,0,0,0,0,0,0
"Ireland","2024-01-08",0,0,0,0,0,0,0,0
"Ireland","2024-01-09",0,0,0,0,0,0,0,0
"Ireland","2024-01-10",0,0,0,0,0,0,0,0
"Ireland","2024-01-11",0,0,0,0,0,0,0,0
"Ireland","2024-01-12",0,0,0,0,0,0,0,0
"Ireland","2024-01-13",0,0,0,0,0,0,0,0
"Ireland","2024-01-14",0,0,0,0,0,0,0,0
"Ireland","2024-01-15",0,0,0,0,0,0,0,0
"Ireland","2024-01-16",0,0,0,0,0,0,0,0
"Ireland","2024-01-17",0,0,0,0,0,0,0,0
"Ireland","2024-01-18",0,0,0,0,0,0,0,0
"Ireland","2024-01-19",0,0,0,0,0,0,0,0
"Ireland","2024-01-20",0,0,0,0,0,0,0,0
"Ireland","2024-01-21",0,0,0,0,0,0,0,0
"Ireland","2024-01-22",0,0,0,0,0,0,0,0
"Ireland","2024-01-23",0,0,0,0,0,0,0,0
"Ireland","2024-01-24",0,0,0,0,0,0,0,0
"Ireland","2024-01-25",0,0,0,0,0,0,0,0
"Ireland","2024-01-26",0,0,0,0,0,0,0,0
"Ireland","2024-01-27",0,0,0,0,0,0,0,0
"Ireland","2024-01-28",0,0,0,0,0,0,0,0
"Ireland","2024-01-29",0,0,0,0,0,0,0,0
"Ireland","2024-01-30",0,0,0,0,0,0,0,0
"Ireland","2024-01-31",0,0,0,0,0,0,0,0
"Ireland","2024-02-01",0,0,0,0,0,0,0,0
"Ireland","2024-02-02",0,0,0,0,0,0,0,0
"Ireland","2024-02-03",0,0,0,0,0,0,0,0
"Ireland","2024-02-04",0,0,0,0,0,0,0,0
"Ireland","2024-02-05",0,0,0,0,0,0,0,0
"Ireland","2024-02-06",0,0,0,0,0,0,0,0
"Ireland","2024-02-07",0,0,0,0,0,0,0,0
"Ireland","2024-02-08",0,0,0,0,0,0,0,0
"Ireland","2024-02-09",0,0,0,0,0,0,0,0
"Ireland","2024-02-10",0,0,0,0,0,0,0,0
"Ireland","2024-02-11",0,0,0,0,0,0,0,0
"Ireland","2024-02-12",0,0,0,0,0,0,0,0
"Ireland","2024-02-13",0,0,0,0,0,0,0,0
"Ireland","2024-02-14",0,0,0,0,0,0,0,0
"Ireland","2024-02-15",0,0,0,0,0,0,0,0
"Ireland","2024-02-16",0,0,0,0,0,0,0,0
"Ireland","2024-02-17",0,0,0,0,0,0,0,0
"Ireland","2024-02-18",0,0,0,0,0,0,0,0
"Ireland","2024-02-19",0,0,0,0,0,0,0,0
"Ireland","2024-02-20",0,0,0,0,0,0,0,0
"Ireland","2024-02-21",0,0,0,0,0,0,0,0
"Ireland","2024-02-22",0,0,0,0,0,0,0,0
"Ireland","2024-02-23",0,0,0,0,0,0,0,0
"Ireland","2024-02-24",0,0,0,0,0,0,0,0
"Ireland","2024-02-25",0,0,0,0,0,0,0,0
"Ireland","2024-02-26",0,0,0,0,0,0,0,0
"Ireland","2024-02-27",0,0,0,0,0,0,0,0
"Ireland","2024-02-28",0,0,0,0,0,0,0,0
"Ireland","2024-02-29",0,1,1,0,1,1,0,0
"Ireland","2024-03-01",0,0,1,0,0,1,0,0
"Ireland","2024-03-02",0,0,1,0,0,1,0,0
"Ireland","2024-03-03",0,0,1,0,0,1,0,0
"Ireland","2024-03-04",0,0,1,0,0,1,0,0
"Ireland","2024-03-05",0,0,1,0,0,1,0,0
"Ireland","2024-03-06",0,0,1,0,0,1,0,0
"Ireland","2024-03-07",0,0,1,0,0,1,0,0
"Ireland","2024-03-08",0,0,1,0,0,1,0,0
"Ireland","2024-03-09",0,0,1,0,0,1,0,0
"Ireland","2024-03-10",0,0,1,0,0,1,0,0
"Ireland","2024-03-11",0,0,1,0,0,1,0,0
"Ireland","2024-03-12",0,0,1,0,0,1,0,0
"Ireland","2024-03-13",0,0,1,0,0,1,0,0
"Ireland","2024-03-14",0,0,1,0,0,1,0,0
"Ireland","2024-03-15",0,0,1,0,0,1,0,0
"Ireland","2024-03-16",0,0,1,0,0,1,0,0
"Ireland","2024-03-17",0,0,1,0,0,1,0,0
"Ireland","2024-03-18",0,0,1,0,0,1,0,0
"Ireland","2024-03-19",0,0,1,0,0,1,0,0
"Ireland","2024-03-20",0,0,1,0,0,1,0,0
"Ireland","2024-03-21",0,0,1,0,0,1,0,0
"Ireland","2024-03-22",0,0,1,0,0,1,0,0
"Ireland","2024-03-23",0,0,1,0,0,1,0,0
"Ireland","2024-03-24",0,0,1,0,0,1,0,0
"Ireland","2024-03-25",0,0,1,0,0,1,0,0
"Ireland","2024-03-26",0,0,1,0,0,1,0,0
"Ireland","2024-03-27",0,0,1,0,0,1,0,0
"Ireland","2024-03-28",0,0,1,0,0,1,0,0
"Ireland","2024-03-29",0,0,1,0,0,1,0,0
"Ireland","2024-03-30",0,0,1,0,0,1,0,0
"Ireland","2024-03-31",0,0,1,0,1,2,0,0
"Ireland","2024-04-01",0,0,1,0,0,2,0,0
"Ireland","2024-04-02",0,0,1,0,0,2,0,0
"Ireland","2024-04-03",0,0,1,0,0,2,0,0
"Ireland","2024-04-04",0,0,1,0,0,2,0,0
"Ireland","2024-04-05",0,0,1,0,0,2,0,0
"Ireland","2024-04-06",0,0,1,0,0,2,0,0
"Ireland","2024-04-07",0,0,1,0,0,2,0,0
"Ireland","2024-04-08",0,0,1,0,0,2,0,0
"Ireland","2024-04-09",0,0,1,0,0,2,0,0
"Ireland","2024-04-10",0,0,1,0,0,2,0,0
"Ireland","2024-04-11",0,0,1,0,0,2,0,0
"Ireland","2024-04-12",0,0,1,0,0,2,0,0
"Ireland","2024-04-13",0,0,1,0,0,2,0,0
"Ireland","2024-04-14",0,0,1,0,0,2,0,0
"Ireland","2024-04-15",0,0,1,0,0,2,0,0
"Ireland","2024-04-16",0,0,1,0,0,2,0,0
"Ireland","2024-04-17",0,0,1,0,0,2,0,0
"Ireland","2024-04-18",0,0,1,0,0,2,0,0
"Ireland","2024-04-19",0,0,1,0,0,2,0,0
"Ireland","2024-04-20",0,0,1,0,0,2,0,0
"Ireland","2024-04-21",0,0,1,0,0,2,0,0
"Ireland","2024-04-22",0,0,1,0,0,2,0,0
"Ireland","2024-04-23",0,0,1,0,0,2,0,0
"Ireland","2024-04-24",0,0,1,0,0,2,0,0
"Ireland","2024-04-25",0,0,1,0,0,2,0,0
"Ireland","2024-04-26",0,0,1,0,0,2,0,0
"Ireland","2024-04-27",0,0,1,0,0,2,0,0
"Ireland","2024-04-28",0,0,1,0,0,2,0,0
"Ireland","2024-04-29",0,0,1,0,0,2,0,0
"Ireland","2024-04-30",0,1,2,0,0,2,0,0
"Ireland","2024-05-01",0,0,2,0,0,2,0,0
"Ireland","2024-05-02",0,0,2,0,0,2,0,0
"Ireland","2024-05-03",0,0,2,0,0,2,0,0
"Ireland","2024-05-04",0,0,2,0,0,2,0,0
"Ireland","2024-05-05",0,0,2,0,0,2,0,0
"Ireland","2024-05-06",0,0,2,0,0,2,0,0
"Ireland","2024-05-07",0,0,2,0,0,2,0,0
"Ireland","2024-05-08",0,0,2,0,0,2,0,0
"Ireland","2024-05-09",0,0,2,0,0,2,0,0
"Ireland","2024-05-10",0,0,2,0,0,2,0,0
"Ireland","2024-05-11",0,0,2,0,0,2,0,0
"Ireland","2024-05-12",0,0,2,0,0,2,0,0
"Ireland","2024-05-13",0,0,2,0,0,2,0,0
"Ireland","2024-05-14",0,0,2,0,0,2,0,0
"Ireland","2024-05-15",0,0,2,0,0,2,0,0
"Ireland","2024-05-16",0,0,2,0,1,3,0,0
"Ireland","2024-05-17",0,0,2,0,0,3,0,0
"Ireland","2024-05-18",0,0,2,0,0,3,0,0
"Ireland","2024-05-19",0,0,2,0,0,3,0,0
"Ireland","2024-05-20",0,0,2,0,0,3,0,0
"Ireland","2024-05-21",0,0,2,0,0,3,0,0
"Ireland","2024-05-22",0,0,2,0,0,3,0,0
"Ireland","2024-05-23",0,0,2,0,0,3,0,0
"Ireland","2024-05-24",0,0,2,0,0,3,0,0
"Ireland","2024-05-25",0,0,2,0,0,3,0,0
"Ireland","2024-05-26",0,0,2,0,0,3,0,0
"Ireland","2024-05-27",0,0,2,0,0,3,0,0
"Ireland","2024-05-28",0,0,2,0,0,3,0,0
"Ireland","2024-05-29",0,0,2,0,0,3,0,0
"Ireland","2024-05-30",0,0,2,0,0,3,0,0
"Ireland","2024-05-31",0,1,3,0,0,3,0,0
"Ireland","2024-06-01",0,0,3,0,0,3,0,0
"Ireland","2024-06-02",0,0,3,0,0,3,0,0
"Ireland","2024-06-03",0,0,3,0,0,3,0,0
"Ireland","2024-06-04",0,0,3,0,0,3,0,0
"Ireland","2024-06-05",0,0,3,0,0,3,0,0
"Ireland","2024-06-06",0,0,3,0,0,3,0,0
"Ireland","2024-06-07",0,0,3,0,0,3,0,0
"Ireland","2024-06-08",0,0,3,0,1,4,0,0
"Ireland","2024-06-09",0,0,3,0,0,4,0,0
"Ireland","2024-06-10",0,0,3,0,0,4,0,0
"Ireland","2024-06-11",0,0,3,0,0,4,0,0
"Ireland","2024-06-12",0,0,3,0,0,4,0,0
"Ireland","2024-06-13",0,0,3,0,0,4,0,0
"Ireland","2024-06-14",0,0,3,0,0,4,0,0
"Ireland","2024-06-15",0,0,3,0,0,4,0,0
"Ireland","2024-06-16",0,0,3,0,0,4,0,0
"Ireland","2024-06-17",0,0,3,0,0,4,0,0
"Ireland","2024-06-18",0,0,3,0,0,4,0,0
"Ireland","2024-06-19",0,0,3,0,0,4,0,0
"Ireland","2024-06-20",0,0,3,0,0,4,0,0
"Ireland","2024-06-21",0,0,3,0,0,4,0,0
"Ireland","2024-06-22",0,0,3,0,0,4,0,0
"Ireland","2024-06-23",0,0,3,0,1,5,0,0
"Ireland","2024-06-24",0,0,3,0,0,5,0,0
"Ireland","2024-06-25",0,0,3,0,0,5,0,0
"Ireland","2024-06-26",0,0,3,0,0,5,0,0
"Ireland","2024-06-27",0,0,3,0,0,5,0,0
"Ireland","2024-06-28",0,0,3,0,0,5,0,0
"Ireland","2024-06-29",0,0,3,0,0,5,0,0
"Ireland","2024-06-30",0,2,5,0,0,5,0,0
"Ireland","2024-07-01",0,0,5,0,0,5,0,0
"Ireland","2024-07-02",0,0,5,0,0,5,0,0
"Ireland","2024-07-03",0,0,5,0,0,5,0,0
"Ireland","2024-07-04",0,0,5,0,0,5,0,0
"Ireland","2024-07-05",0,0,5,0,0,5,0,0
"Ireland","2024-07-06",0,0,5,0,0,5,0,0
"Ireland","2024-07-07",0,0,5,0,0,5,0,0
"Ireland","2024-07-08",0,0,5,0,0,5,0,0
"Ireland","2024-07-09",0,0,5,0,0,5,0,0
"Ireland","2024-07-10",0,0,5,0,0,5,0,0
"Ireland","2024-07-11",0,0,5,0,0,5,0,0
"Ireland","2024-07-12",0,0,5,0,0,5,0,0
"Ireland","2024-07-13",0,0,5,0,0,5,0,0
"Ireland","2024-07-14",0,0,5,0,0,5,0,0
"Ireland","2024-07-15",0,0,5,0,0,5,0,0
"Ireland","2024-07-16",0,0,5,0,0,5,0,0
"Ireland","2024-07-17",0,0,5,0,0,5,0,0
"Ireland","2024-07-18",0,0,5,0,0,5,0,0
"Ireland","2024-07-19",0,0,5,0,0,5,0,0
"Ireland","2024-07-20",0,0,5,0,0,5,0,0
"Ireland","2024-07-21",0,0,5,0,0,5,0,0
"Ireland","2024-07-22",0,0,5,0,0,5,0,0
"Ireland","2024-07-23",0,0,5,0,0,5,0,0
"Ireland","2024-07-24",0,0,5,0,0,5,0,0
"Ireland","2024-07-25",0,0,5,0,0,5,0,0
"Ireland","2024-07-26",0,0,5,0,0,5,0,0
"Ireland","2024-07-27",0,0,5,0,0,5,0,0
"Ireland","2024-07-28",0,0,5,0,0,5,0,0
"Ireland","2024-07-29",0,0,5,0,0,5,0,0
"Ireland","2024-07-30",0,0,5,0,0,5,0,0
"Ireland","2024-07-31",0,0,5,0,0,5,0,0
"Ireland","2024-08-01",0,0,5,0,1,6,0,0
"Ireland","2024-08-02",0,0,5,0,0,6,0,0
"Ireland","2024-08-03",0,0,5,0,0,6,0,0
"Ireland","2024-08-04",0,0,5,0,0,6,0,0
"Ireland","2024-08-05",0,0,5,0,0,6,0,0
"Ireland","2024-08-06",0,0,5,0,0,6,0,0
"Ireland","2024-08-07",0,0,5,0,0,6,0,0
"Ireland","2024-08-08",0,0,5,0,0,6,0,0
"Ireland","2024-08-09",0,0,5,0,0,6,0,0
"Ireland","2024-08-10",0,0,5,0,0,6,0,0
"Ireland","2024-08-11",0,0,5,0,0,6,0,0
"Ireland","2024-08-12",0,0,5,0,0,6,0,0
"Ireland","2024-08-13",0,0,5,0,0,6,0,0
"Ireland","2024-08-14",0,0,5,0,0,6,0,0
"Ireland","2024-08-15",0,0,5,0,0,6,0,0
"Ireland","2024-08-16",0,0,5,0,0,6,0,0
"Ireland","2024-08-17",0,0,5,0,0,6,0,0
"Ireland","2024-08-18",0,0,5,0,0,6,0,0
"Ireland","2024-08-19",0,0,5,0,0,6,0,0
"Ireland","2024-08-20",0,0,5,0,0,6,0,0
"Ireland","2024-08-21",0,0,5,0,0,6,0,0
"Ireland","2024-08-22",0,0,5,0,0,6,0,0
"Ireland","2024-08-23",0,0,5,0,0,6,0,0
"Ireland","2024-08-24",0,0,5,0,0,6,0,0
"Ireland","2024-08-25",0,0,5,0,0,6,0,0
"Ireland","2024-08-26",0,0,5,0,0,6,0,0
"Ireland","2024-08-27",0,0,5,0,0,6,0,0
"Ireland","2024-08-28",0,0,5,0,0,6,0,0
"Ireland","2024-08-29",0,0,5,0,0,6,0,0
"Ireland","2024-08-30",0,0,5,0,0,6,0,0
"Ireland","2024-08-31",0,1,6,0,0,6,0,0
"Ireland","2024-09-01",0,0,6,0,0,6,0,0
"Ireland","2024-09-02",0,0,6,0,0,6,0,0
"Ireland","2024-09-03",0,0,6,0,0,6,0,0
"Ireland","2024-09-04",0,0,6,0,0,6,0,0
"Ireland","2024-09-05",0,0,6,0,0,6,0,0
"Ireland","2024-09-06",0,0,6,0,1,7,0,0
"Ireland","2024-09-07",0,0,6,0,0,7,0,0
"Ireland","2024-09-08",0,0,6,0,0,7,0,0
"Ireland","2024-09-09",0,0,6,0,0,7,0,0
"Ireland","2024-09-10",0,0,6,0,0,7,0,0
"Ireland","2024-09-11",0,0,6,0,0,7,0,0
"Ireland","2024-09-12",0,0,6,0,0,7,0,0
"Ireland","2024-09-13",0,0,6,0,0,7,0,0
"Ireland","2024-09-14",0,0,6,0,0,7,0,0
"Ireland","2024-09-15",0,0,6,0,1,8,0,0
"Ireland","2024-09-16",0,0,6,0,0,8,0,0
"Ireland","2024-09-17",0,0,6,0,0,8,0,0
"Ireland","2024-09-18",0,0,6,0,0,8,0,0
"Ireland","2024-09-19",0,0,6,0,0,8,0,0
"Ireland","2024-09-20",0,0,6,0,0,8,0,0
"Ireland","2024-09-21",0,0,6,0,0,8,0,0
"Ireland","2024-09-22",0,0,6,0,0,8,0,0
"Ireland","2024-09-23",0,0,6,0,0,8,0,0
"Ireland","2024-09-24",0,0,6,0,0,8,0,0
"Ireland","2024-09-25",0,0,6,0,0,8,0,0
"Ireland","2024-09-26",0,0,6,0,1,9,0,0
"Ireland","2024-09-27",0,0,6,0,0,9,0,0
"Ireland","2024-09-28",0,0,6,0,0,9,0,0
"Ireland","2024-09-29",0,0,6,0,0,9,0,0
"Ireland","2024-09-30",0,3,9,0,0,9,0,0
"Ireland","2024-10-01",0,0,9,0,0,9,0,0
"Ireland","2024-10-02",0,0,9,0,1,10,0,0
"Ireland","2024-10-03",0,0,9,0,0,10,0,0
"Ireland","2024-10-04",0,0,9,0,0,10,0,0
"Ireland","2024-10-05",0,0,9,0,0,10,0,0
"Ireland","2024-10-06",0,0,9,0,1,11,0,0
"Ireland","2024-10-07",0,0,9,0,0,11,0,0
"Ireland","2024-10-08",0,0,9,0,0,11,0,0
"Ireland","2024-10-09",0,0,9,0,0,11,0,0
"Ireland","2024-10-10",0,0,9,0,1,12,0,0
"Ireland","2024-10-11",0,0,9,0,0,12,0,0
"Ireland","2024-10-12",0,0,9,0,0,12,0,0
"Ireland","2024-10-13",0,0,9,0,0,12,0,0
"Ireland","2024-10-14",0,0,9,0,1,13,0,0
"Ireland","2024-10-15",0,0,9,0,0,13,0,0
"Ireland","2024-10-16",0,0,9,0,0,13,0,0
"Ireland","2024-10-17",0,0,9,0,0,13,0,0
"Ireland","2024-10-18",0,0,9,0,1,14,0,0
"Ireland","2024-10-19",0,0,9,0,0,14,0,0
"Ireland","2024-10-20",0,0,9,0,0,14,0,0
"Ireland","2024-10-21",0,0,9,0,0,14,0,0
"Ireland","2024-10-22",0,0,9,0,1,15,0,0
"Ireland","2024-10-23",0,0,9,0,0,15,0,0
"Ireland","2024-10-24",0,0,9,0,0,15,0,0
"Ireland","2024-10-25",0,0,9,0,0,15,0,0
"Ireland","2024-10-26",0,0,9,0,1,16,0,0
"Ireland","2024-10-27",0,0,9,0,0,16,0,0
"Ireland","2024-10-28",0,0,9,0,0,16,0,0
"Ireland","2024-10-29",0,0,9,0,0,16,0,0
"Ireland","2024-10-30",0,0,9,0,1,17,0,0
"Ireland","2024-10-31",0,8,17,0,0,17,0,0
"Ireland","2024-11-01",0,0,17,0,0,17,0,0
"Ireland","2024-11-02",0,0,17,0,0,17,0,0
"Ireland","2024-11-03",0,0,17,0,0,17,0,0
"Ireland","2024-11-04",0,0,17,0,1,18,0,0
"Ireland","2024-11-05",0,0,17,0,0,18,0,0
"Ireland","2024-11-06",0,0,17,0,0,18,0,0
"Ireland","2024-11-07",0,0,17,0,0,18,0,0
"Ireland","2024-11-08",0,0,17,0,0,18,0,0
"Ireland","2024-11-09",0,0,17,0,0,18,0,0
"Ireland","2024-11-10",0,0,17,0,0,18,0,0
"Ireland","2024-11-11",0,0,17,0,0,18,0,0
"Ireland","2024-11-12",0,0,17,0,1,19,0,0
"Ireland","2024-11-13",0,0,17,0,0,19,0,0
"Ireland","2024-11-14",0,0,17,0,0,19,0,0
"Ireland","2024-11-15",0,0,17,0,0,19,0,0
"Ireland","2024-11-16",0,0,17,0,0,19,0,0
"Ireland","2024-11-17",0,0,17,0,0,19,0,0
"Ireland","2024-11-18",0,0,17,0,0,19,0,0
"Ireland","2024-11-19",0,0,17,0,1,20,0,0
"Ireland","2024-11-20",0,0,17,0,0,20,0,0
"Ireland","2024-11-21",0,0,17,0,0,20,0,0
"Ireland","2024-11-22",0,0,17,0,0,20,0,0
"Ireland","2024-11-23",0,0,17,0,0,20,0,0
"Ireland","2024-11-24",0,0,17,0,0,20,0,0
"Ireland","2024-11-25",0,0,17,0,0,20,0,0
"Ireland","2024-11-26",0,0,17,0,0,20,0,0
"Ireland","2024-11-27",0,0,17,0,1,21,0,0
"Ireland","2024-11-28",0,0,17,0,0,21,0,0
"Ireland","2024-11-29",0,0,17,0,0,21,0,0
"Ireland","2024-11-30",0,4,21,0,0,21,0,0
"Ireland","2024-12-01",0,0,21,0,0,21,0,0
"Ireland","2024-12-02",0,0,21,0,0,21,0,0
"Ireland","2024-12-03",0,0,21,0,0,21,0,0
"Ireland","2024-12-04",0,0,21,0,1,22,0,0
"Ireland","2024-12-05",0,0,21,0,0,22,0,0
"Ireland","2024-12-06",0,0,21,0,0,22,0,0
"Ireland","2024-12-07",0,0,21,0,0,22,0,0
"Ireland","2024-12-08",0,0,21,0,0,22,0,0
"Ireland","2024-12-09",0,0,21,0,0,22,0,0
"Ireland","2024-12-10",0,0,21,0,1,23,0,0
"Ireland","2024-12-11",0,0,21,0,0,23,0,0
"Ireland","2024-12-12",0,0,21,0,0,23,0,0
"Ireland","2024-12-13",0,0,21,0,0,23,0,0
"Ireland","2024-12-14",0,0,21,0,0,23,0,0
"Ireland","2024-12-15",0,0,21,0,0,23,0,0
"Ireland","2024-12-16",0,0,21,0,1,24,0,0
"Ireland","2024-12-17",0,0,21,0,0,24,0,0
"Ireland","2024-12-18",0,0,21,0,0,24,0,0
"Ireland","2024-12-19",0,0,21,0,0,24,0,0
"Ireland","2024-12-20",0,0,21,0,0,24,0,0
"Ireland","2024-12-21",0,0,21,0,0,24,0,0
"Ireland","2024-12-22",0,0,21,0,1,25,0,0
"Ireland","2024-12-23",0,0,21,0,0,25,0,0
"Ireland","2024-12-24",0,0,21,0,0,25,0,0
"Ireland","2024-12-25",0,0,21,0,0,25,0,0
"Ireland","2024-12-26",0,0,21,0,0,25,0,0
"Ireland","2024-12-27",0,0,21,0,0,25,0,0
"Ireland","2024-12-28",0,0,21,0,1,26,0,0
"Ireland","2024-12-29",0,0,21,0,0,26,0,0
"Ireland","2024-12-30",0,0,21,0,0,26,0,0
"Ireland","2024-12-31",0,5,26,0,0,26,0,0
"Ireland","2025-01-01",0,0,26,0,0,26,0,0
"Ireland","2025-01-02",0,0,26,0,0,26,0,0
"Ireland","2025-01-03",0,0,26,0,0,26,0,0
"Ireland","2025-01-04",0,0,26,0,0,26,0,0
"Ireland","2025-01-05",0,0,26,0,0,26,0,0
"Ireland","2025-01-06",0,0,26,0,0,26,0,0
"Ireland","2025-01-07",0,0,26,0,0,26,0,0
"Ireland","2025-01-08",0,0,26,0,0,26,0,0
"Ireland","2025-01-09",0,0,26,0,0,26,0,0
"Ireland","2025-01-10",0,0,26,0,0,26,0,0
"Ireland","2025-01-11",0,0,26,0,0,26,0,0
"Ireland","2025-01-12",0,0,26,0,0,26,0,0
"Ireland","2025-01-13",0,0,26,0,0,26,0,0
"Ireland","2025-01-14",0,0,26,0,0,26,0,0
"Ireland","2025-01-15",0,0,26,0,0,26,0,0
"Ireland","2025-01-16",0,0,26,0,0,26,0,0
"Ireland","2025-01-17",0,0,26,0,0,26,0,0
"Ireland","2025-01-18",0,0,26,0,0,26,0,0
"Ireland","2025-01-19",0,0,26,0,0,26,0,0
"Ireland","2025-01-20",0,0,26,0,0,26,0,0
"Ireland","2025-01-21",0,0,26,0,0,26,0,0
"Ireland","2025-01-22",0,0,26,0,0,26,0,0
"Ireland","2025-01-23",0,0,26,0,0,26,0,0
"Ireland","2025-01-24",0,0,26,0,0,26,0,0
"Ireland","2025-01-25",0,0,26,0,0,26,0,0
"Ireland","2025-01-26",0,0,26,0,0,26,0,0
"Ireland","2025-01-27",0,0,26,0,0,26,0,0
"Ireland","2025-01-28",0,0,26,0,0,26,0,0
"Ireland","2025-01-29",0,0,26,0,0,26,0,0
"Ireland","2025-01-30",0,0,26,0,0,26,0,0
"Ireland","2025-01-31",0,0,26,0,0,26,0,0
"Ireland","2025-02-01",0,0,26,0,0,26,0,0
"Ireland","2025-02-02",0,0,26,0,0,26,0,0
"Ireland","2025-02-03",0,0,26,0,0,26,0,0
"Israel","2024-01-01",0,0,0,0,0,0,0,0
"Israel","2024-01-02",0,0,0,0,0,0,0,0
"Israel","2024-01-03",0,0,0,0,0,0,0,0
"Israel","2024-01-04",0,0,0,0,0,0,0,0
"Israel","2024-01-05",0,0,0,0,0,0,0,0
"Israel","2024-01-06",0,0,0,0,0,0,0,0
"Israel","2024-01-07",0,0,0,0,0,0,0,0
"Israel","2024-01-08",0,0,0,0,0,0,0,0
"Israel","2024-01-09",0,0,0,0,0,0,0,0
"Israel","2024-01-10",0,0,0,0,0,0,0,0
"Israel","2024-01-11",0,0,0,0,0,0,0,0
"Israel","2024-01-12",0,0,0,0,0,0,0,0
"Israel","2024-01-13",0,0,0,0,0,0,0,0
"Israel","2024-01-14",0,0,0,0,0,0,0,0
"Israel","2024-01-15",0,0,0,0,0,0,0,0
"Israel","2024-01-16",0,0,0,0,0,0,0,0
"Israel","2024-01-17",0,0,0,0,0,0,0,0
"Israel","2024-01-18",0,0,0,0,0,0,0,0
"Israel","2024-01-19",0,0,0,0,0,0,0,0
"Israel","2024-01-20",0,0,0,0,0,0,0,0
"Israel","2024-01-21",0,0,0,0,0,0,0,0
"Israel","2024-01-22",0,0,0,0,0,0,0,0
"Israel","2024-01-23",0,0,0,0,0,0,0,0
"Israel","2024-01-24",0,0,0,0,0,0,0,0
"Israel","2024-01-25",0,0,0,0,0,0,0,0
"Israel","2024-01-26",0,0,0,0,0,0,0,0
"Israel","2024-01-27",0,0,0,0,0,0,0,0
"Israel","2024-01-28",0,0,0,0,0,0,0,0
"Israel","2024-01-29",0,0,0,0,0,0,0,0
"Israel","2024-01-30",0,0,0,0,0,0,0,0
"Israel","2024-01-31",0,0,0,0,0,0,0,0
"Israel","2024-02-01",0,0,0,0,0,0,0,0
"Israel","2024-02-02",0,0,0,0,0,0,0,0
"Israel","2024-02-03",0,0,0,0,0,0,0,0
"Israel","2024-02-04",0,0,0,0,0,0,0,0
"Israel","2024-02-05",0,0,0,0,0,0,0,0
"Israel","2024-02-06",0,0,0,0,0,0,0,0
"Israel","2024-02-07",0,0,0,0,0,0,0,0
"Israel","2024-02-08",0,0,0,0,0,0,0,0
"Israel","2024-02-09",0,0,0,0,0,0,0,0
"Israel","2024-02-10",0,0,0,0,0,0,0,0
"Israel","2024-02-11",0,0,0,0,0,0,0,0
"Israel","2024-02-12",0,0,0,0,0,0,0,0
"Israel","2024-02-13",0,0,0,0,0,0,0,0
"Israel","2024-02-14",0,0,0,0,0,0,0,0
"Israel","2024-02-15",0,0,0,0,0,0,0,0
"Israel","2024-02-16",0,0,0,0,0,0,0,0
"Israel","2024-02-17",0,0,0,0,0,0,0,0
"Israel","2024-02-18",0,0,0,0,0,0,0,0
"Israel","2024-02-19",0,0,0,0,0,0,0,0
"Israel","2024-02-20",0,0,0,0,0,0,0,0
"Israel","2024-02-21",0,0,0,0,0,0,0,0
"Israel","2024-02-22",0,0,0,0,0,0,0,0
"Israel","2024-02-23",0,0,0,0,0,0,0,0
"Israel","2024-02-24",0,0,0,0,0,0,0,0
"Israel","2024-02-25",0,0,0,0,0,0,0,0
"Israel","2024-02-26",0,0,0,0,0,0,0,0
"Israel","2024-02-27",0,0,0,0,0,0,0,0
"Israel","2024-02-28",0,0,0,0,0,0,0,0
"Israel","2024-02-29",0,18,18,0,18,18,0,0
"Israel","2024-03-01",0,0,18,0,0,18,0,0
"Israel","2024-03-02",0,0,18,0,0,18,0,0
"Israel","2024-03-03",0,0,18,0,0,18,0,0
"Israel","2024-03-04",0,0,18,0,0,18,0,0
"Israel","2024-03-05",0,0,18,0,0,18,0,0
"Israel","2024-03-06",0,0,18,0,0,18,0,0
"Israel","2024-03-07",0,0,18,0,0,18,0,0
"Israel","2024-03-08",0,0,18,0,0,18,0,0
"Israel","2024-03-09",0,0,18,0,0,18,0,0
"Israel","2024-03-10",0,0,18,0,0,18,0,0
"Israel","2024-03-11",0,0,18,0,0,18,0,0
"Israel","2024-03-12",0,0,18,0,0,18,0,0
"Israel","2024-03-13",0,0,18,0,0,18,0,0
"Israel","2024-03-14",0,0,18,0,0,18,0,0
"Israel","2024-03-15",0,0,18,0,0,18,0,0
"Israel","2024-03-16",0,0,18,0,0,18,0,0
"Israel","2024-03-17",0,0,18,0,0,18,0,0
"Israel","2024-03-18",0,0,18,0,0,18,0,0
"Israel","2024-03-19",0,0,18,0,0,18,0,0
"Israel","2024-03-20",0,0,18,0,0,18,0,0
"Israel","2024-03-21",0,0,18,0,1,19,0,0
"Israel","2024-03-22",0,0,18,0,0,19,0,0
"Israel","2024-03-23",0,0,18,0,0,19,0,0
"Israel","2024-03-24",0,0,18,0,0,19,0,0
"Israel","2024-03-25",0,0,18,0,0,19,0,0
"Israel","2024-03-26",0,0,18,0,0,19,0,0
"Israel","2024-03-27",0,0,18,0,0,19,0,0
"Israel","2024-03-28",0,0,18,0,0,19,0,0
"Israel","2024-03-29",0,0,18,0,0,19,0,0
"Israel","2024-03-30",0,0,18,0,0,19,0,0
"Israel","2024-03-31",0,0,18,0,0,19,0,0
"Israel","2024-04-01",0,0,18,0,0,19,0,0
"Israel","2024-04-02",0,0,18,0,0,19,0,0
"Israel","2024-04-03",0,0,18,0,0,19,0,0
"Israel","2024-04-04",0,0,18,0,0,19,0,0
"Israel","2024-04-05",0,0,18,0,0,19,0,0
"Israel","2024-04-06",0,0,18,0,0,19,0,0
"Israel","2024-04-07",0,0,18,0,0,19,0,0
"Israel","2024-04-08",0,0,18,0,0,19,0,0
"Israel","2024-04-09",0,1,19,0,0,19,0,0
"Israel","2024-04-10",0,0,19,0,0,19,0,0
"Israel","2024-04-11",0,0,19,0,1,20,0,0
"Israel","2024-04-12",0,0,19,0,0,20,0,0
"Israel","2024-04-13",0,0,19,0,0,20,0,0
"Israel","2024-04-14",0,0,19,0,1,21,0,0
"Israel","2024-04-15",0,0,19,0,0,21,0,0
"Israel","2024-04-16",0,0,19,0,0,21,0,0
"Israel","2024-04-17",0,0,19,0,1,22,0,0
"Israel","2024-04-18",0,0,19,0,0,22,0,0
"Israel","2024-04-19",0,0,19,0,0,22,0,0
"Israel","2024-04-20",0,0,19,0,1,23,0,0
"Israel","2024-04-21",0,0,19,0,0,23,0,0
"Israel","2024-04-22",0,0,19,0,0,23,0,0
"Israel","2024-04-23",0,0,19,0,1,24,0,0
"Israel","2024-04-24",0,0,19,0,0,24,0,0
"Israel","2024-04-25",0,0,19,0,1,25,0,0
"Israel","2024-04-26",0,0,19,0,0,25,0,0
"Israel","2024-04-27",0,0,19,0,0,25,0,0
"Israel","2024-04-28",0,0,19,0,1,26,0,0
"Israel","2024-04-29",0,0,19,0,0,26,0,0
"Israel","2024-04-30",0,0,19,0,0,26,0,0
"Israel","2024-05-01",0,0,19,0,1,27,0,0
"Israel","2024-05-02",0,0,19,0,0,27,0,0
"Israel","2024-05-03",0,0,19,0,0,27,0,0
"Israel","2024-05-04",0,0,19,0,1,28,0,0
"Israel","2024-05-05",0,0,19,0,0,28,0,0
"Israel","2024-05-06",0,0,19,0,0,28,0,0
"Israel","2024-05-07",0,0,19,0,1,29,0,0
"Israel","2024-05-08",0,0,19,0,0,29,0,0
"Israel","2024-05-09",0,0,19,0,0,29,0,0
"Israel","2024-05-10",0,0,19,0,1,30,0,0
"Israel","2024-05-11",0,0,19,0,0,30,0,0
"Israel","2024-05-12",0,0,19,0,0,30,0,0
"Israel","2024-05-13",0,0,19,0,1,31,0,0
"Israel","2024-05-14",0,0,19,0,0,31,0,0
"Israel","2024-05-15",0,0,19,0,0,31,0,0
"Israel","2024-05-16",0,0,19,0,1,32,0,0
"Israel","2024-05-17",0,0,19,0,0,32,0,0
"Israel","2024-05-18",0,0,19,0,1,33,0,0
"Israel","2024-05-19",0,0,19,0,0,33,0,0
"Israel","2024-05-20",0,0,19,0,0,33,0,0
"Israel","2024-05-21",0,0,19,0,1,34,0,0
"Israel","2024-05-22",0,0,19,0,0,34,0,0
"Israel","2024-05-23",0,0,19,0,0,34,0,0
"Israel","2024-05-24",0,0,19,0,1,35,0,0
"Israel","2024-05-25",0,0,19,0,0,35,0,0
"Israel","2024-05-26",0,0,19,0,0,35,0,0
"Israel","2024-05-27",0,0,19,0,1,36,0,0
"Israel","2024-05-28",0,0,19,0,0,36,0,0
"Israel","2024-05-29",0,0,19,0,0,36,0,0
"Israel","2024-05-30",0,0,19,0,1,37,0,0
"Israel","2024-05-31",0,18,37,0,0,37,0,0
"Israel","2024-06-01",0,0,37,0,0,37,0,0
"Israel","2024-06-02",0,0,37,0,0,37,0,0
"Israel","2024-06-03",0,0,37,0,0,37,0,0
"Israel","2024-06-04",0,0,37,0,0,37,0,0
"Israel","2024-06-05",0,0,37,0,0,37,0,0
"Israel","2024-06-06",0,0,37,0,0,37,0,0
"Israel","2024-06-07",0,0,37,0,0,37,0,0
"Israel","2024-06-08",0,0,37,0,1,38,0,0
"Israel","2024-06-09",0,0,37,0,0,38,0,0
"Israel","2024-06-10",0,0,37,0,0,38,0,0
"Israel","2024-06-11",0,0,37,0,0,38,0,0
"Israel","2024-06-12",0,0,37,0,0,38,0,0
"Israel","2024-06-13",0,0,37,0,0,38,0,0
"Israel","2024-06-14",0,0,37,0,0,38,0,0
"Israel","2024-06-15",0,0,37,0,0,38,0,0
"Israel","2024-06-16",0,0,37,0,0,38,0,0
"Israel","2024-06-17",0,0,37,0,0,38,0,0
"Israel","2024-06-18",0,0,37,0,0,38,0,0
"Israel","2024-06-19",0,0,37,0,0,38,0,0
"Israel","2024-06-20",0,0,37,0,0,38,0,0
"Israel","2024-06-21",0,0,37,0,0,38,0,0
"Israel","2024-06-22",0,0,37,0,0,38,0,0
"Israel","2024-06-23",0,0,37,0,1,39,0,0
"Israel","2024-06-24",0,0,37,0,0,39,0,0
"Israel","2024-06-25",0,0,37,0,0,39,0,0
"Israel","2024-06-26",0,0,37,0,0,39,0,0
"Israel","2024-06-27",0,0,37,0,0,39,0,0
"Israel","2024-06-28",0,0,37,0,0,39,0,0
"Israel","2024-06-29",0,0,37,0,0,39,0,0
"Israel","2024-06-30",0,2,39,0,0,39,0,0
"Israel","2024-07-01",0,0,39,0,0,39,0,0
"Israel","2024-07-02",0,0,39,0,0,39,0,0
"Israel","2024-07-03",0,0,39,0,0,39,0,0
"Israel","2024-07-04",0,0,39,0,0,39,0,0
"Israel","2024-07-05",0,0,39,0,0,39,0,0
"Israel","2024-07-06",0,0,39,0,1,40,0,0
"Israel","2024-07-07",0,0,39,0,0,40,0,0
"Israel","2024-07-08",0,0,39,0,0,40,0,0
"Israel","2024-07-09",0,0,39,0,0,40,0,0
"Israel","2024-07-10",0,0,39,0,0,40,0,0
"Israel","2024-07-11",0,0,39,0,0,40,0,0
"Israel","2024-07-12",0,0,39,0,0,40,0,0
"Israel","2024-07-13",0,0,39,0,0,40,0,0
"Israel","2024-07-14",0,0,39,0,0,40,0,0
"Israel","2024-07-15",0,0,39,0,0,40,0,0
"Israel","2024-07-16",0,0,39,0,1,41,0,0
"Israel","2024-07-17",0,0,39,0,0,41,0,0
"Israel","2024-07-18",0,0,39,0,0,41,0,0
"Israel","2024-07-19",0,0,39,0,0,41,0,0
"Israel","2024-07-20",0,0,39,0,0,41,0,0
"Israel","2024-07-21",0,0,39,0,0,41,0,0
"Israel","2024-07-22",0,0,39,0,0,41,0,0
"Israel","2024-07-23",0,0,39,0,0,41,0,0
"Israel","2024-07-24",0,0,39,0,0,41,0,0
"Israel","2024-07-25",0,0,39,0,0,41,0,0
"Israel","2024-07-26",0,0,39,0,1,42,0,0
"Israel","2024-07-27",0,0,39,0,0,42,0,0
"Israel","2024-07-28",0,0,39,0,0,42,0,0
"Israel","2024-07-29",0,0,39,0,0,42,0,0
"Israel","2024-07-30",0,0,39,0,0,42,0,0
"Israel","2024-07-31",0,3,42,0,0,42,0,0
"Israel","2024-08-01",0,0,42,0,0,42,0,0
"Israel","2024-08-02",0,0,42,0,0,42,0,0
"Israel","2024-08-03",0,0,42,0,0,42,0,0
"Israel","2024-08-04",0,0,42,0,1,43,0,0
"Israel","2024-08-05",0,0,42,0,0,43,0,0
"Israel","2024-08-06",0,0,42,0,0,43,0,0
"Israel","2024-08-07",0,0,42,0,0,43,0,0
"Israel","2024-08-08",0,0,42,0,0,43,0,0
"Israel","2024-08-09",0,0,42,0,0,43,0,0
"Israel","2024-08-10",0,0,42,0,0,43,0,0
"Israel","2024-08-11",0,0,42,0,0,43,0,0
"Israel","2024-08-12",0,0,42,0,1,44,0,0
"Israel","2024-08-13",0,0,42,0,0,44,0,0
"Israel","2024-08-14",0,0,42,0,0,44,0,0
"Israel","2024-08-15",0,0,42,0,0,44,0,0
"Israel","2024-08-16",0,0,42,0,0,44,0,0
"Israel","2024-08-17",0,0,42,0,0,44,0,0
"Israel","2024-08-18",0,0,42,0,0,44,0,0
"Israel","2024-08-19",0,0,42,0,0,44,0,0
"Israel","2024-08-20",0,0,42,0,1,45,0,0
"Israel","2024-08-21",0,0,42,0,0,45,0,0
"Israel","2024-08-22",0,0,42,0,0,45,0,0
"Israel","2024-08-23",0,0,42,0,0,45,0,0
"Israel","2024-08-24",0,0,42,0,0,45,0,0
"Israel","2024-08-25",0,0,42,0,0,45,0,0
"Israel","2024-08-26",0,0,42,0,0,45,0,0
"Israel","2024-08-27",0,0,42,0,0,45,0,0
"Israel","2024-08-28",0,0,42,0,1,46,0,0
"Israel","2024-08-29",0,0,42,0,0,46,0,0
"Israel","2024-08-30",0,0,42,0,0,46,0,0
"Israel","2024-08-31",0,4,46,0,0,46,0,0
"Israel","2024-09-01",0,0,46,0,0,46,0,0
"Israel","2024-09-02",0,0,46,0,0,46,0,0
"Israel","2024-09-03",0,0,46,0,0,46,0,0
"Israel","2024-09-04",0,0,46,0,1,47,0,0
"Israel","2024-09-05",0,0,46,0,0,47,0,0
"Israel","2024-09-06",0,0,46,0,0,47,0,0
"Israel","2024-09-07",0,0,46,0,0,47,0,0
"Israel","2024-09-08",0,0,46,0,0,47,0,0
"Israel","2024-09-09",0,0,46,0,0,47,0,0
"Israel","2024-09-10",0,0,46,0,0,47,0,0
"Israel","2024-09-11",0,0,46,0,0,47,0,0
"Israel","2024-09-12",0,0,46,0,1,48,0,0
"Israel","2024-09-13",0,0,46,0,0,48,0,0
"Israel","2024-09-14",0,0,46,0,0,48,0,0
"Israel","2024-09-15",0,0,46,0,0,48,0,0
"Israel","2024-09-16",0,0,46,0,0,48,0,0
"Israel","2024-09-17",0,0,46,0,0,48,0,0
"Israel","2024-09-18",0,0,46,0,0,48,0,0
"Israel","2024-09-19",0,0,46,0,1,49,0,0
"Israel","2024-09-20",0,0,46,0,0,49,0,0
"Israel","2024-09-21",0,0,46,0,0,49,0,0
"Israel","2024-09-22",0,0,46,0,0,49,0,0
"Israel","2024-09-23",0,0,46,0,0,49,0,0
"Israel","2024-09-24",0,0,46,0,0,49,0,0
"Israel","2024-09-25",0,0,46,0,0,49,0,0
"Israel","2024-09-26",0,0,46,0,0,49,0,0
"Israel","2024-09-27",0,0,46,0,1,50,0,0
"Israel","2024-09-28",0,0,46,0,0,50,0,0
"Israel","2024-09-29",0,0,46,0,0,50,0,0
"Israel","2024-09-30",0,4,50,0,0,50,0,0
"Israel","2024-10-01",0,0,50,0,0,50,0,0
"Israel","2024-10-02",0,0,50,0,0,50,0,0
"Israel","2024-10-03",0,0,50,0,0,50,0,0
"Israel","2024-10-04",0,0,50,0,0,50,0,0
"Israel","2024-10-05",0,0,50,0,1,51,0,0
"Israel","2024-10-06",0,0,50,0,0,51,0,0
"Israel","2024-10-07",0,0,50,0,0,51,0,0
"Israel","2024-10-08",0,0,50,0,0,51,0,0
"Israel","2024-10-09",0,0,50,0,0,51,0,0
"Israel","2024-10-10",0,0,50,0,0,51,0,0
"Israel","2024-10-11",0,0,50,0,0,51,0,0
"Israel","2024-10-12",0,0,50,0,0,51,0,0
"Israel","2024-10-13",0,0,50,0,1,52,0,0
"Israel","2024-10-14",0,0,50,0,0,52,0,0
"Israel","2024-10-15",0,0,50,0,0,52,0,0
"Israel","2024-10-16",0,0,50,0,0,52,0,0
"Israel","2024-10-17",0,0,50,0,0,52,0,0
"Israel","2024-10-18",0,0,50,0,0,52,0,0
"Israel","2024-10-19",0,0,50,0,0,52,0,0
"Israel","2024-10-20",0,0,50,0,0,52,0,0
"Israel","2024-10-21",0,0,50,0,1,53,0,0
"Israel","2024-10-22",0,0,50,0,0,53,0,0
"Israel","2024-10-23",0,0,50,0,0,53,0,0
"Israel","2024-10-24",0,0,50,0,0,53,0,0
"Israel","2024-10-25",0,0,50,0,0,53,0,0
"Israel","2024-10-26",0,0,50,0,0,53,0,0
"Israel","2024-10-27",0,0,50,0,0,53,0,0
"Israel","2024-10-28",0,0,50,0,0,53,0,0
"Israel","2024-10-29",0,0,50,0,0,53,0,0
"Israel","2024-10-30",0,0,50,0,1,54,0,0
"Israel","2024-10-31",0,0,50,0,0,54,0,0
"Israel","2024-11-01",0,0,50,0,0,54,0,0
"Israel","2024-11-02",0,0,50,0,0,54,0,0
"Israel","2024-11-03",0,0,50,0,0,54,0,0
"Israel","2024-11-04",0,0,50,0,0,54,0,0
"Israel","2024-11-05",0,0,50,0,0,54,0,0
"Israel","2024-11-06",0,0,50,0,0,54,0,0
"Israel","2024-11-07",0,0,50,0,1,55,0,0
"Israel","2024-11-08",0,0,50,0,0,55,0,0
"Israel","2024-11-09",0,0,50,0,0,55,0,0
"Israel","2024-11-10",0,0,50,0,0,55,0,0
"Israel","2024-11-11",0,0,50,0,0,55,0,0
"Israel","2024-11-12",0,0,50,0,0,55,0,0
"Israel","2024-11-13",0,0,50,0,0,55,0,0
"Israel","2024-11-14",0,0,50,0,0,55,0,0
"Israel","2024-11-15",0,0,50,0,1,56,0,0
"Israel","2024-11-16",0,0,50,0,0,56,0,0
"Israel","2024-11-17",0,0,50,0,0,56,0,0
"Israel","2024-11-18",0,0,50,0,0,56,0,0
"Israel","2024-11-19",0,0,50,0,0,56,0,0
"Israel","2024-11-20",0,0,50,0,0,56,0,0
"Israel","2024-11-21",0,0,50,0,0,56,0,0
"Israel","2024-11-22",0,0,50,0,0,56,0,0
"Israel","2024-11-23",0,0,50,0,0,56,0,0
"Israel","2024-11-24",0,0,50,0,1,57,0,0
"Israel","2024-11-25",0,0,50,0,0,57,0,0
"Israel","2024-11-26",0,0,50,0,0,57,0,0
"Israel","2024-11-27",0,0,50,0,0,57,0,0
"Israel","2024-11-28",0,0,50,0,0,57,0,0
"Israel","2024-11-29",0,0,50,0,0,57,0,0
"Israel","2024-11-30",0,0,50,0,0,57,0,0
"Israel","2024-12-01",0,0,50,0,0,57,0,0
"Israel","2024-12-02",0,0,50,0,1,58,0,0
"Israel","2024-12-03",0,0,50,0,0,58,0,0
"Israel","2024-12-04",0,0,50,0,0,58,0,0
"Israel","2024-12-05",0,0,50,0,0,58,0,0
"Israel","2024-12-06",0,0,50,0,0,58,0,0
"Israel","2024-12-07",0,0,50,0,0,58,0,0
"Israel","2024-12-08",0,0,50,0,0,58,0,0
"Israel","2024-12-09",0,0,50,0,0,58,0,0
"Israel","2024-12-10",0,0,50,0,0,58,0,0
"Israel","2024-12-11",0,0,50,0,1,59,0,0
"Israel","2024-12-12",0,0,50,0,0,59,0,0
"Israel","2024-12-13",0,0,50,0,0,59,0,0
"Israel","2024-12-14",0,0,50,0,0,59,0,0
"Israel","2024-12-15",0,0,50,0,0,59,0,0
"Israel","2024-12-16",0,0,50,0,0,59,0,0
"Israel","2024-12-17",0,0,50,0,0,59,0,0
"Israel","2024-12-18",0,0,50,0,0,59,0,0
"Israel","2024-12-19",0,0,50,0,1,60,0,0
"Israel","2024-12-20",0,0,50,0,0,60,0,0
"Israel","2024-12-21",0,0,50,0,0,60,0,0
"Israel","2024-12-22",0,0,50,0,0,60,0,0
"Israel","2024-12-23",0,0,50,0,0,60,0,0
"Israel","2024-12-24",0,0,50,0,0,60,0,0
"Israel","2024-12-25",0,0,50,0,0,60,0,0
"Israel","2024-12-26",0,0,50,0,0,60,0,0
"Israel","2024-12-27",0,0,50,0,1,61,0,0
"Israel","2024-12-28",0,0,50,0,0,61,0,0
"Israel","2024-12-29",0,0,50,0,0,61,0,0
"Israel","2024-12-30",0,0,50,0,0,61,0,0
"Israel","2024-12-31",0,11,61,0,0,61,0,0
"Israel","2025-01-01",0,0,61,0,0,61,0,0
"Israel","2025-01-02",0,0,61,0,0,61,0,0
"Israel","2025-01-03",0,0,61,0,0,61,0,0
"Israel","2025-01-04",0,0,61,0,0,61,0,0
"Israel","2025-01-05",0,0,61,0,0,61,0,0
"Israel","2025-01-06",0,0,61,0,0,61,0,0
"Israel","2025-01-07",0,0,61,0,0,61,0,0
"Israel","2025-01-08",0,0,61,0,0,61,0,0
"Israel","2025-01-09",0,0,61,0,0,61,0,0
"Israel","2025-01-10",0,0,61,0,0,61,0,0
"Israel","2025-01-11",0,0,61,0,0,61,0,0
"Israel","2025-01-12",0,0,61,0,0,61,0,0
"Israel","2025-01-13",0,0,61,0,0,61,0,0
"Israel","2025-01-14",0,0,61,0,0,61,0,0
"Israel","2025-01-15",0,0,61,0,0,61,0,0
"Israel","2025-01-16",0,0,61,0,0,61,0,0
"Israel","2025-01-17",0,0,61,0,0,61,0,0
"Israel","2025-01-18",0,0,61,0,0,61,0,0
"Israel","2025-01-19",0,0,61,0,0,61,0,0
"Israel","2025-01-20",0,0,61,0,0,61,0,0
"Israel","2025-01-21",0,0,61,0,0,61,0,0
"Israel","2025-01-22",0,0,61,0,0,61,0,0
"Israel","2025-01-23",0,0,61,0,0,61,0,0
"Israel","2025-01-24",0,0,61,0,0,61,0,0
"Israel","2025-01-25",0,0,61,0,0,61,0,0
"Israel","2025-01-26",0,0,61,0,0,61,0,0
"Israel","2025-01-27",0,0,61,0,0,61,0,0
"Israel","2025-01-28",0,0,61,0,0,61,0,0
"Israel","2025-01-29",0,0,61,0,0,61,0,0
"Israel","2025-01-30",0,0,61,0,0,61,0,0
"Israel","2025-01-31",0,0,61,0,0,61,0,0
"Israel","2025-02-01",0,0,61,0,0,61,0,0
"Israel","2025-02-02",0,0,61,0,0,61,0,0
"Israel","2025-02-03",0,0,61,0,0,61,0,0
"Italy","2024-01-01",0,0,0,0,0,0,0,0
"Italy","2024-01-02",0,0,0,0,0,0,0,0
"Italy","2024-01-03",0,0,0,0,0,0,0,0
"Italy","2024-01-04",0,0,0,0,0,0,0,0
"Italy","2024-01-05",0,0,0,0,0,0,0,0
"Italy","2024-01-06",0,0,0,0,0,0,0,0
"Italy","2024-01-07",0,0,0,0,0,0,0,0
"Italy","2024-01-08",0,0,0,0,0,0,0,0
"Italy","2024-01-09",0,0,0,0,0,0,0,0
"Italy","2024-01-10",0,0,0,0,0,0,0,0
"Italy","2024-01-11",0,0,0,0,0,0,0,0
"Italy","2024-01-12",0,0,0,0,0,0,0,0
"Italy","2024-01-13",0,0,0,0,0,0,0,0
"Italy","2024-01-14",0,0,0,0,0,0,0,0
"Italy","2024-01-15",0,0,0,0,0,0,0,0
"Italy","2024-01-16",0,0,0,0,0,0,0,0
"Italy","2024-01-17",0,0,0,0,0,0,0,0
"Italy","2024-01-18",0,0,0,0,0,0,0,0
"Italy","2024-01-19",0,0,0,0,0,0,0,0
"Italy","2024-01-20",0,0,0,0,0,0,0,0
"Italy","2024-01-21",0,0,0,0,0,0,0,0
"Italy","2024-01-22",0,0,0,0,0,0,0,0
"Italy","2024-01-23",0,0,0,0,0,0,0,0
"Italy","2024-01-24",0,0,0,0,0,0,0,0
"Italy","2024-01-25",0,0,0,0,0,0,0,0
"Italy","2024-01-26",0,0,0,0,0,0,0,0
"Italy","2024-01-27",0,0,0,0,0,0,0,0
"Italy","2024-01-28",0,0,0,0,0,0,0,0
"Italy","2024-01-29",0,0,0,0,0,0,0,0
"Italy","2024-01-30",0,0,0,0,0,0,0,0
"Italy","2024-01-31",0,26,26,0,26,26,0,0
"Italy","2024-02-01",0,0,26,0,0,26,0,0
"Italy","2024-02-02",0,0,26,0,1,27,0,0
"Italy","2024-02-03",0,0,26,0,0,27,0,0
"Italy","2024-02-04",0,0,26,0,1,28,0,0
"Italy","2024-02-05",0,0,26,0,0,28,0,0
"Italy","2024-02-06",0,0,26,0,1,29,0,0
"Italy","2024-02-07",0,0,26,0,0,29,0,0
"Italy","2024-02-08",0,0,26,0,1,30,0,0
"Italy","2024-02-09",0,0,26,0,0,30,0,0
"Italy","2024-02-10",0,0,26,0,0,30,0,0
"Italy","2024-02-11",0,0,26,0,1,31,0,0
"Italy","2024-02-12",0,0,26,0,0,31,0,0
"Italy","2024-02-13",0,0,26,0,1,32,0,0
"Italy","2024-02-14",0,0,26,0,0,32,0,0
"Italy","2024-02-15",0,0,26,0,1,33,0,0
"Italy","2024-02-16",0,0,26,0,0,33,0,0
"Italy","2024-02-17",0,0,26,0,1,34,0,0
"Italy","2024-02-18",0,0,26,0,0,34,0,0
"Italy","2024-02-19",0,0,26,0,1,35,0,0
"Italy","2024-02-20",0,0,26,0,0,35,0,0
"Italy","2024-02-21",0,0,26,0,0,35,0,0
"Italy","2024-02-22",0,0,26,0,1,36,0,0
"Italy","2024-02-23",0,0,26,0,0,36,0,0
"Italy","2024-02-24",0,0,26,0,1,37,0,0
"Italy","2024-02-25",0,0,26,0,0,37,0,0
"Italy","2024-02-26",0,0,26,0,1,38,0,0
"Italy","2024-02-27",0,0,26,0,0,38,0,0
"Italy","2024-02-28",0,0,26,0,1,39,0,0
"Italy","2024-02-29",0,13,39,0,0,39,0,0
"Italy","2024-03-01",0,0,39,0,0,39,0,0
"Italy","2024-03-02",0,0,39,0,1,40,0,0
"Italy","2024-03-03",0,0,39,0,0,40,0,0
"Italy","2024-03-04",0,0,39,0,1,41,0,0
"Italy","2024-03-05",0,0,39,0,0,41,0,0
"Italy","2024-03-06",0,0,39,0,1,42,0,0
"Italy","2024-03-07",0,0,39,0,0,42,0,0
"Italy","2024-03-08",0,0,39,0,1,43,0,0
"Italy","2024-03-09",0,0,39,0,0,43,0,0
"Italy","2024-03-10",0,0,39,0,1,44,0,0
"Italy","2024-03-11",0,0,39,0,0,44,0,0
"Italy","2024-03-12",0,0,39,0,0,44,0,0
"Italy","2024-03-13",0,0,39,0,1,45,0,0
"Italy","2024-03-14",0,0,39,0,0,45,0,0
"Italy","2024-03-15",0,0,39,0,1,46,0,0
"Italy","2024-03-16",0,0,39,0,0,46,0,0
"Italy","2024-03-17",0,0,39,0,1,47,0,0
"Italy","2024-03-18",0,0,39,0,0,47,0,0
"Italy","2024-03-19",0,0,39,0,1,48,0,0
"Italy","2024-03-20",0,0,39,0,0,48,0,0
"Italy","2024-03-21",0,0,39,0,0,48,0,0
"Italy","2024-03-22",0,0,39,0,1,49,0,0
"Italy","2024-03-23",0,0,39,0,0,49,0,0
"Italy","2024-03-24",0,0,39,0,1,50,0,0
"Italy","2024-03-25",0,0,39,0,0,50,0,0
"Italy","2024-03-26",0,0,39,0,1,51,0,0
"Italy","2024-03-27",0,0,39,0,0,51,0,0
"Italy","2024-03-28",0,0,39,0,1,52,0,0
"Italy","2024-03-29",0,0,39,0,0,52,0,0
"Italy","2024-03-30",0,0,39,0,1,53,0,0
"Italy","2024-03-31",0,14,53,0,0,53,0,0
"Italy","2024-04-01",0,0,53,0,0,53,0,0
"Italy","2024-04-02",0,0,53,0,0,53,0,0
"Italy","2024-04-03",0,0,53,0,0,53,0,0
"Italy","2024-04-04",0,0,53,0,0,53,0,0
"Italy","2024-04-05",0,0,53,0,0,53,0,0
"Italy","2024-04-06",0,0,53,0,0,53,0,0
"Italy","2024-04-07",0,0,53,0,0,53,0,0
"Italy","2024-04-08",0,0,53,0,0,53,0,0
"Italy","2024-04-09",0,0,53,0,0,53,0,0
"Italy","2024-04-10",0,0,53,0,0,53,0,0
"Italy","2024-04-11",0,0,53,0,0,53,0,0
"Italy","2024-04-12",0,0,53,0,0,53,0,0
"Italy","2024-04-13",0,0,53,0,0,53,0,0
"Italy","2024-04-14",0,0,53,0,0,53,0,0
"Italy","2024-04-15",0,0,53,0,0,53,0,0
"Italy","2024-04-16",0,0,53,0,1,54,0,0
"Italy","2024-04-17",0,0,53,0,0,54,0,0
"Italy","2024-04-18",0,0,53,0,0,54,0,0
"Italy","2024-04-19",0,0,53,0,0,54,0,0
"Italy","2024-04-20",0,0,53,0,0,54,0,0
"Italy","2024-04-21",0,0,53,0,0,54,0,0
"Italy","2024-04-22",0,0,53,0,0,54,0,0
"Italy","2024-04-23",0,0,53,0,0,54,0,0
"Italy","2024-04-24",0,0,53,0,0,54,0,0
"Italy","2024-04-25",0,0,53,0,0,54,0,0
"Italy","2024-04-26",0,0,53,0,0,54,0,0
"Italy","2024-04-27",0,0,53,0,0,54,0,0
"Italy","2024-04-28",0,0,53,0,0,54,0,0
"Italy","2024-04-29",0,0,53,0,0,54,0,0
"Italy","2024-04-30",0,1,54,0,0,54,0,0
"Italy","2024-05-01",0,0,54,0,0,54,0,0
"Italy","2024-05-02",0,0,54,0,0,54,0,0
"Italy","2024-05-03",0,0,54,0,0,54,0,0
"Italy","2024-05-04",0,0,54,0,1,55,0,0
"Italy","2024-05-05",0,0,54,0,0,55,0,0
"Italy","2024-05-06",0,0,54,0,0,55,0,0
"Italy","2024-05-07",0,0,54,0,0,55,0,0
"Italy","2024-05-08",0,0,54,0,0,55,0,0
"Italy","2024-05-09",0,0,54,0,0,55,0,0
"Italy","2024-05-10",0,0,54,0,0,55,0,0
"Italy","2024-05-11",0,0,54,0,0,55,0,0
"Italy","2024-05-12",0,0,54,0,1,56,0,0
"Italy","2024-05-13",0,0,54,0,0,56,0,0
"Italy","2024-05-14",0,0,54,0,0,56,0,0
"Italy","2024-05-15",0,0,54,0,0,56,0,0
"Italy","2024-05-16",0,0,54,0,0,56,0,0
"Italy","2024-05-17",0,0,54,0,0,56,0,0
"Italy","2024-05-18",0,0,54,0,0,56,0,0
"Italy","2024-05-19",0,0,54,0,0,56,0,0
"Italy","2024-05-20",0,0,54,0,1,57,0,0
"Italy","2024-05-21",0,0,54,0,0,57,0,0
"Italy","2024-05-22",0,0,54,0,0,57,0,0
"Italy","2024-05-23",0,0,54,0,0,57,0,0
"Italy","2024-05-24",0,0,54,0,0,57,0,0
"Italy","2024-05-25",0,0,54,0,0,57,0,0
"Italy","2024-05-26",0,0,54,0,0,57,0,0
"Italy","2024-05-27",0,0,54,0,0,57,0,0
"Italy","2024-05-28",0,0,54,0,1,58,0,0
"Italy","2024-05-29",0,0,54,0,0,58,0,0
"Italy","2024-05-30",0,0,54,0,0,58,0,0
"Italy","2024-05-31",0,4,58,0,0,58,0,0
"Italy","2024-06-01",0,0,58,0,0,58,0,0
"Italy","2024-06-02",0,0,58,0,0,58,0,0
"Italy","2024-06-03",0,0,58,0,0,58,0,0
"Italy","2024-06-04",0,0,58,0,0,58,0,0
"Italy","2024-06-05",0,0,58,0,0,58,0,0
"Italy","2024-06-06",0,0,58,0,0,58,0,0
"Italy","2024-06-07",0,0,58,0,0,58,0,0
"Italy","2024-06-08",0,0,58,0,1,59,0,0
"Italy","2024-06-09",0,0,58,0,0,59,0,0
"Italy","2024-06-10",0,0,58,0,0,59,0,0
"Italy","2024-06-11",0,0,58,0,0,59,0,0
"Italy","2024-06-12",0,0,58,0,0,59,0,0
"Italy","2024-06-13",0,0,58,0,0,59,0,0
"Italy","2024-06-14",0,0,58,0,0,59,0,0
"Italy","2024-06-15",0,0,58,0,0,59,0,0
"Italy","2024-06-16",0,0,58,0,0,59,0,0
"Italy","2024-06-17",0,0,58,0,0,59,0,0
"Italy","2024-06-18",0,0,58,0,0,59,0,0
"Italy","2024-06-19",0,0,58,0,0,59,0,0
"Italy","2024-06-20",0,0,58,0,0,59,0,0
"Italy","2024-06-21",0,0,58,0,0,59,0,0
"Italy","2024-06-22",0,0,58,0,0,59,0,0
"Italy","2024-06-23",0,0,58,0,1,60,0,0
"Italy","2024-06-24",0,0,58,0,0,60,0,0
"Italy","2024-06-25",0,0,58,0,0,60,0,0
"Italy","2024-06-26",0,0,58,0,0,60,0,0
"Italy","2024-06-27",0,0,58,0,0,60,0,0
"Italy","2024-06-28",0,0,58,0,0,60,0,0
"Italy","2024-06-29",0,0,58,0,0,60,0,0
"Italy","2024-06-30",0,2,60,0,0,60,0,0
"Italy","2024-07-01",0,0,60,0,0,60,0,0
"Italy","2024-07-02",0,0,60,0,0,60,0,0
"Italy","2024-07-03",0,0,60,0,1,61,0,0
"Italy","2024-07-04",0,0,60,0,0,61,0,0
"Italy","2024-07-05",0,0,60,0,0,61,0,0
"Italy","2024-07-06",0,0,60,0,0,61,0,0
"Italy","2024-07-07",0,0,60,0,1,62,0,0
"Italy","2024-07-08",0,0,60,0,0,62,0,0
"Italy","2024-07-09",0,0,60,0,0,62,0,0
"Italy","2024-07-10",0,0,60,0,0,62,0,0
"Italy","2024-07-11",0,0,60,0,0,62,0,0
"Italy","2024-07-12",0,0,60,0,1,63,0,0
"Italy","2024-07-13",0,0,60,0,0,63,0,0
"Italy","2024-07-14",0,0,60,0,0,63,0,0
"Italy","2024-07-15",0,0,60,0,0,63,0,0
"Italy","2024-07-16",0,0,60,0,1,64,0,0
"Italy","2024-07-17",0,0,60,0,0,64,0,0
"Italy","2024-07-18",0,0,60,0,0,64,0,0
"Italy","2024-07-19",0,0,60,0,0,64,0,0
"Italy","2024-07-20",0,0,60,0,1,65,0,0
"Italy","2024-07-21",0,0,60,0,0,65,0,0
"Italy","2024-07-22",0,0,60,0,0,65,0,0
"Italy","2024-07-23",0,0,60,0,0,65,0,0
"Italy","2024-07-24",0,0,60,0,0,65,0,0
"Italy","2024-07-25",0,0,60,0,1,66,0,0
"Italy","2024-07-26",0,0,60,0,0,66,0,0
"Italy","2024-07-27",0,0,60,0,0,66,0,0
"Italy","2024-07-28",0,0,60,0,0,66,0,0
"Italy","2024-07-29",0,0,60,0,1,67,0,0
"Italy","2024-07-30",0,0,60,0,0,67,0,0
"Italy","2024-07-31",0,7,67,0,0,67,0,0
"Italy","2024-08-01",0,0,67,0,0,67,0,0
"Italy","2024-08-02",0,0,67,0,0,67,0,0
"Italy","2024-08-03",0,0,67,0,0,67,0,0
"Italy","2024-08-04",0,0,67,0,0,67,0,0
"Italy","2024-08-05",0,0,67,0,0,67,0,0
"Italy","2024-08-06",0,0,67,0,0,67,0,0
"Italy","2024-08-07",0,0,67,0,0,67,0,0
"Italy","2024-08-08",0,0,67,0,0,67,0,0
"Italy","2024-08-09",0,0,67,0,0,67,0,0
"Italy","2024-08-10",0,0,67,0,0,67,0,0
"Italy","2024-08-11",0,0,67,0,0,67,0,0
"Italy","2024-08-12",0,0,67,0,0,67,0,0
"Italy","2024-08-13",0,0,67,0,0,67,0,0
"Italy","2024-08-14",0,0,67,0,0,67,0,0
"Italy","2024-08-15",0,0,67,0,0,67,0,0
"Italy","2024-08-16",0,0,67,0,1,68,0,0
"Italy","2024-08-17",0,0,67,0,0,68,0,0
"Italy","2024-08-18",0,0,67,0,0,68,0,0
"Italy","2024-08-19",0,0,67,0,0,68,0,0
"Italy","2024-08-20",0,0,67,0,0,68,0,0
"Italy","2024-08-21",0,0,67,0,0,68,0,0
"Italy","2024-08-22",0,0,67,0,0,68,0,0
"Italy","2024-08-23",0,0,67,0,0,68,0,0
"Italy","2024-08-24",0,0,67,0,0,68,0,0
"Italy","2024-08-25",0,0,67,0,0,68,0,0
"Italy","2024-08-26",0,0,67,0,0,68,0,0
"Italy","2024-08-27",0,0,67,0,0,68,0,0
"Italy","2024-08-28",0,0,67,0,0,68,0,0
"Italy","2024-08-29",0,0,67,0,0,68,0,0
"Italy","2024-08-30",0,0,67,0,0,68,0,0
"Italy","2024-08-31",0,1,68,0,0,68,0,0
"Italy","2024-09-01",0,0,68,0,0,68,0,0
"Italy","2024-09-02",0,0,68,0,0,68,0,0
"Italy","2024-09-03",0,0,68,0,0,68,0,0
"Italy","2024-09-04",0,0,68,0,1,69,0,0
"Italy","2024-09-05",0,0,68,0,0,69,0,0
"Italy","2024-09-06",0,0,68,0,0,69,0,0
"Italy","2024-09-07",0,0,68,0,0,69,0,0
"Italy","2024-09-08",0,0,68,0,0,69,0,0
"Italy","2024-09-09",0,0,68,0,1,70,0,0
"Italy","2024-09-10",0,0,68,0,0,70,0,0
"Italy","2024-09-11",0,0,68,0,0,70,0,0
"Italy","2024-09-12",0,0,68,0,0,70,0,0
"Italy","2024-09-13",0,0,68,0,0,70,0,0
"Italy","2024-09-14",0,0,68,0,0,70,0,0
"Italy","2024-09-15",0,0,68,0,0,70,0,0
"Italy","2024-09-16",0,0,68,0,1,71,0,0
"Italy","2024-09-17",0,0,68,0,0,71,0,0
"Italy","2024-09-18",0,0,68,0,0,71,0,0
"Italy","2024-09-19",0,0,68,0,0,71,0,0
"Italy","2024-09-20",0,0,68,0,0,71,0,0
"Italy","2024-09-21",0,0,68,0,1,72,0,0
"Italy","2024-09-22",0,0,68,0,0,72,0,0
"Italy","2024-09-23",0,0,68,0,0,72,0,0
"Italy","2024-09-24",0,0,68,0,0,72,0,0
"Italy","2024-09-25",0,0,68,0,0,72,0,0
"Italy","2024-09-26",0,0,68,0,0,72,0,0
"Italy","2024-09-27",0,0,68,0,0,72,0,0
"Italy","2024-09-28",0,0,68,0,1,73,0,0
"Italy","2024-09-29",0,0,68,0,0,73,0,0
"Italy","2024-09-30",0,5,73,0,0,73,0,0
"Italy","2024-10-01",0,0,73,0,0,73,0,0
"Italy","2024-10-02",0,0,73,0,1,74,0,0
"Italy","2024-10-03",0,0,73,0,0,74,0,0
"Italy","2024-10-04",0,0,73,0,0,74,0,0
"Italy","2024-10-05",0,0,73,0,1,75,0,0
"Italy","2024-10-06",0,0,73,0,0,75,0,0
"Italy","2024-10-07",0,0,73,0,0,75,0,0
"Italy","2024-10-08",0,0,73,0,1,76,0,0
"Italy","2024-10-09",0,0,73,0,0,76,0,0
"Italy","2024-10-10",0,0,73,0,0,76,0,0
"Italy","2024-10-11",0,0,73,0,1,77,0,0
"Italy","2024-10-12",0,0,73,0,0,77,0,0
"Italy","2024-10-13",0,0,73,0,0,77,0,0
"Italy","2024-10-14",0,0,73,0,1,78,0,0
"Italy","2024-10-15",0,0,73,0,0,78,0,0
"Italy","2024-10-16",0,0,73,0,0,78,0,0
"Italy","2024-10-17",0,0,73,0,0,78,0,0
"Italy","2024-10-18",0,0,73,0,1,79,0,0
"Italy","2024-10-19",0,0,73,0,0,79,0,0
"Italy","2024-10-20",0,0,73,0,0,79,0,0
"Italy","2024-10-21",0,0,73,0,1,80,0,0
"Italy","2024-10-22",0,0,73,0,0,80,0,0
"Italy","2024-10-23",0,0,73,0,0,80,0,0
"Italy","2024-10-24",0,0,73,0,1,81,0,0
"Italy","2024-10-25",0,0,73,0,0,81,0,0
"Italy","2024-10-26",0,0,73,0,0,81,0,0
"Italy","2024-10-27",0,0,73,0,1,82,0,0
"Italy","2024-10-28",0,0,73,0,0,82,0,0
"Italy","2024-10-29",0,0,73,0,0,82,0,0
"Italy","2024-10-30",0,0,73,0,1,83,0,0
"Italy","2024-10-31",0,10,83,0,0,83,0,0
"Italy","2024-11-01",0,0,83,0,0,83,0,0
"Italy","2024-11-02",0,0,83,0,0,83,0,0
"Italy","2024-11-03",0,0,83,0,1,84,0,0
"Italy","2024-11-04",0,0,83,0,0,84,0,0
"Italy","2024-11-05",0,0,83,0,0,84,0,0
"Italy","2024-11-06",0,0,83,0,0,84,0,0
"Italy","2024-11-07",0,0,83,0,1,85,0,0
"Italy","2024-11-08",0,0,83,0,0,85,0,0
"Italy","2024-11-09",0,0,83,0,0,85,0,0
"Italy","2024-11-10",0,0,83,0,0,85,0,0
"Italy","2024-11-11",0,0,83,0,1,86,0,0
"Italy","2024-11-12",0,0,83,0,0,86,0,0
"Italy","2024-11-13",0,0,83,0,0,86,0,0
"Italy","2024-11-14",0,0,83,0,0,86,0,0
"Italy","2024-11-15",0,0,83,0,1,87,0,0
"Italy","2024-11-16",0,0,83,0,0,87,0,0
"Italy","2024-11-17",0,0,83,0,0,87,0,0
"Italy","2024-11-18",0,0,83,0,0,87,0,0
"Italy","2024-11-19",0,0,83,0,0,87,0,0
"Italy","2024-11-20",0,0,83,0,1,88,0,0
"Italy","2024-11-21",0,0,83,0,0,88,0,0
"Italy","2024-11-22",0,0,83,0,0,88,0,0
"Italy","2024-11-23",0,0,83,0,0,88,0,0
"Italy","2024-11-24",0,0,83,0,1,89,0,0
"Italy","2024-11-25",0,0,83,0,0,89,0,0
"Italy","2024-11-26",0,0,83,0,0,89,0,0
"Italy","2024-11-27",0,0,83,0,0,89,0,0
"Italy","2024-11-28",0,0,83,0,1,90,0,0
"Italy","2024-11-29",0,0,83,0,0,90,0,0
"Italy","2024-11-30",0,7,90,0,0,90,0,0
"Italy","2024-12-01",0,0,90,0,0,90,0,0
"Italy","2024-12-02",0,0,90,0,1,91,0,0
"Italy","2024-12-03",0,0,90,0,0,91,0,0
"Italy","2024-12-04",0,0,90,0,0,91,0,0
"Italy","2024-12-05",0,0,90,0,0,91,0,0
"Italy","2024-12-06",0,0,90,0,1,92,0,0
"Italy","2024-12-07",0,0,90,0,0,92,0,0
"Italy","2024-12-08",0,0,90,0,0,92,0,0
"Italy","2024-12-09",0,0,90,0,0,92,0,0
"Italy","2024-12-10",0,0,90,0,1,93,0,0
"Italy","2024-12-11",0,0,90,0,0,93,0,0
"Italy","2024-12-12",0,0,90,0,0,93,0,0
"Italy","2024-12-13",0,0,90,0,0,93,0,0
"Italy","2024-12-14",0,0,90,0,1,94,0,0
"Italy","2024-12-15",0,0,90,0,0,94,0,0
"Italy","2024-12-16",0,0,90,0,0,94,0,0
"Italy","2024-12-17",0,0,90,0,0,94,0,0
"Italy","2024-12-18",0,0,90,0,1,95,0,0
"Italy","2024-12-19",0,0,90,0,0,95,0,0
"Italy","2024-12-20",0,0,90,0,0,95,0,0
"Italy","2024-12-21",0,0,90,0,0,95,0,0
"Italy","2024-12-22",0,0,90,0,1,96,0,0
"Italy","2024-12-23",0,0,90,0,0,96,0,0
"Italy","2024-12-24",0,0,90,0,0,96,0,0
"Italy","2024-12-25",0,0,90,0,0,96,0,0
"Italy","2024-12-26",0,0,90,0,1,97,0,0
"Italy","2024-12-27",0,0,90,0,0,97,0,0
"Italy","2024-12-28",0,0,90,0,0,97,0,0
"Italy","2024-12-29",0,0,90,0,0,97,0,0
"Italy","2024-12-30",0,0,90,0,1,98,0,0
"Italy","2024-12-31",0,8,98,0,0,98,0,0
"Italy","2025-01-01",0,0,98,0,0,98,0,0
"Italy","2025-01-02",0,0,98,0,0,98,0,0
"Italy","2025-01-03",0,0,98,0,0,98,0,0
"Italy","2025-01-04",0,0,98,0,0,98,0,0
"Italy","2025-01-05",0,0,98,0,0,98,0,0
"Italy","2025-01-06",0,0,98,0,0,98,0,0
"Italy","2025-01-07",0,0,98,0,0,98,0,0
"Italy","2025-01-08",0,0,98,0,0,98,0,0
"Italy","2025-01-09",0,0,98,0,0,98,0,0
"Italy","2025-01-10",0,0,98,0,0,98,0,0
"Italy","2025-01-11",0,0,98,0,0,98,0,0
"Italy","2025-01-12",0,0,98,0,0,98,0,0
"Italy","2025-01-13",0,0,98,0,0,98,0,0
"Italy","2025-01-14",0,0,98,0,0,98,0,0
"Italy","2025-01-15",0,0,98,0,0,98,0,0
"Italy","2025-01-16",0,0,98,0,0,98,0,0
"Italy","2025-01-17",0,0,98,0,0,98,0,0
"Italy","2025-01-18",0,0,98,0,0,98,0,0
"Italy","2025-01-19",0,0,98,0,0,98,0,0
"Italy","2025-01-20",0,0,98,0,0,98,0,0
"Italy","2025-01-21",0,0,98,0,0,98,0,0
"Italy","2025-01-22",0,0,98,0,0,98,0,0
"Italy","2025-01-23",0,0,98,0,0,98,0,0
"Italy","2025-01-24",0,0,98,0,0,98,0,0
"Italy","2025-01-25",0,0,98,0,0,98,0,0
"Italy","2025-01-26",0,0,98,0,0,98,0,0
"Italy","2025-01-27",0,0,98,0,0,98,0,0
"Italy","2025-01-28",0,0,98,0,0,98,0,0
"Italy","2025-01-29",0,0,98,0,0,98,0,0
"Italy","2025-01-30",0,0,98,0,0,98,0,0
"Italy","2025-01-31",0,0,98,0,0,98,0,0
"Italy","2025-02-01",0,0,98,0,0,98,0,0
"Italy","2025-02-02",0,0,98,0,0,98,0,0
"Italy","2025-02-03",0,0,98,0,0,98,0,0
"Jamaica","2024-01-01",0,0,0,0,0,0,0,0
"Jamaica","2024-01-02",0,0,0,0,0,0,0,0
"Jamaica","2024-01-03",0,0,0,0,0,0,0,0
"Jamaica","2024-01-04",0,0,0,0,0,0,0,0
"Jamaica","2024-01-05",0,0,0,0,0,0,0,0
"Jamaica","2024-01-06",0,0,0,0,0,0,0,0
"Jamaica","2024-01-07",0,0,0,0,0,0,0,0
"Jamaica","2024-01-08",0,0,0,0,0,0,0,0
"Jamaica","2024-01-09",0,0,0,0,0,0,0,0
"Jamaica","2024-01-10",0,0,0,0,0,0,0,0
"Jamaica","2024-01-11",0,0,0,0,0,0,0,0
"Jamaica","2024-01-12",0,0,0,0,0,0,0,0
"Jamaica","2024-01-13",0,0,0,0,0,0,0,0
"Jamaica","2024-01-14",0,0,0,0,0,0,0,0
"Jamaica","2024-01-15",0,0,0,0,0,0,0,0
"Jamaica","2024-01-16",0,0,0,0,0,0,0,0
"Jamaica","2024-01-17",0,0,0,0,0,0,0,0
"Jamaica","2024-01-18",0,0,0,0,0,0,0,0
"Jamaica","2024-01-19",0,0,0,0,0,0,0,0
"Jamaica","2024-01-20",0,0,0,0,0,0,0,0
"Jamaica","2024-01-21",0,0,0,0,0,0,0,0
"Jamaica","2024-01-22",0,0,0,0,0,0,0,0
"Jamaica","2024-01-23",0,0,0,0,0,0,0,0
"Jamaica","2024-01-24",0,0,0,0,0,0,0,0
"Jamaica","2024-01-25",0,0,0,0,0,0,0,0
"Jamaica","2024-01-26",0,0,0,0,0,0,0,0
"Jamaica","2024-01-27",0,0,0,0,0,0,0,0
"Jamaica","2024-01-28",0,0,0,0,0,0,0,0
"Jamaica","2024-01-29",0,0,0,0,0,0,0,0
"Jamaica","2024-01-30",0,0,0,0,0,0,0,0
"Jamaica","2024-01-31",0,0,0,0,0,0,0,0
"Jamaica","2024-02-01",0,0,0,0,0,0,0,0
"Jamaica","2024-02-02",0,0,0,0,0,0,0,0
"Jamaica","2024-02-03",0,0,0,0,0,0,0,0
"Jamaica","2024-02-04",0,0,0,0,0,0,0,0
"Jamaica","2024-02-05",0,0,0,0,0,0,0,0
"Jamaica","2024-02-06",0,0,0,0,0,0,0,0
"Jamaica","2024-02-07",0,0,0,0,0,0,0,0
"Jamaica","2024-02-08",0,0,0,0,0,0,0,0
"Jamaica","2024-02-09",0,0,0,0,0,0,0,0
"Jamaica","2024-02-10",0,0,0,0,0,0,0,0
"Jamaica","2024-02-11",0,0,0,0,0,0,0,0
"Jamaica","2024-02-12",0,0,0,0,0,0,0,0
"Jamaica","2024-02-13",0,0,0,0,0,0,0,0
"Jamaica","2024-02-14",0,0,0,0,0,0,0,0
"Jamaica","2024-02-15",0,0,0,0,0,0,0,0
"Jamaica","2024-02-16",0,0,0,0,0,0,0,0
"Jamaica","2024-02-17",0,0,0,0,0,0,0,0
"Jamaica","2024-02-18",0,0,0,0,0,0,0,0
"Jamaica","2024-02-19",0,0,0,0,0,0,0,0
"Jamaica","2024-02-20",0,0,0,0,0,0,0,0
"Jamaica","2024-02-21",0,0,0,0,0,0,0,0
"Jamaica","2024-02-22",0,0,0,0,0,0,0,0
"Jamaica","2024-02-23",0,0,0,0,0,0,0,0
"Jamaica","2024-02-24",0,0,0,0,0,0,0,0
"Jamaica","2024-02-25",0,0,0,0,0,0,0,0
"Jamaica","2024-02-26",0,0,0,0,0,0,0,0
"Jamaica","2024-02-27",0,0,0,0,0,0,0,0
"Jamaica","2024-02-28",0,0,0,0,0,0,0,0
"Jamaica","2024-02-29",0,0,0,0,0,0,0,0
"Jamaica","2024-03-01",0,0,0,0,0,0,0,0
"Jamaica","2024-03-02",0,0,0,0,0,0,0,0
"Jamaica","2024-03-03",0,0,0,0,0,0,0,0
"Jamaica","2024-03-04",0,0,0,0,0,0,0,0
"Jamaica","2024-03-05",0,0,0,0,0,0,0,0
"Jamaica","2024-03-06",0,0,0,0,0,0,0,0
"Jamaica","2024-03-07",0,0,0,0,0,0,0,0
"Jamaica","2024-03-08",0,0,0,0,0,0,0,0
"Jamaica","2024-03-09",0,0,0,0,0,0,0,0
"Jamaica","2024-03-10",0,0,0,0,0,0,0,0
"Jamaica","2024-03-11",0,0,0,0,0,0,0,0
"Jamaica","2024-03-12",0,0,0,0,0,0,0,0
"Jamaica","2024-03-13",0,0,0,0,0,0,0,0
"Jamaica","2024-03-14",0,0,0,0,0,0,0,0
"Jamaica","2024-03-15",0,0,0,0,0,0,0,0
"Jamaica","2024-03-16",0,0,0,0,0,0,0,0
"Jamaica","2024-03-17",0,0,0,0,0,0,0,0
"Jamaica","2024-03-18",0,0,0,0,0,0,0,0
"Jamaica","2024-03-19",0,0,0,0,0,0,0,0
"Jamaica","2024-03-20",0,0,0,0,0,0,0,0
"Jamaica","2024-03-21",0,0,0,0,0,0,0,0
"Jamaica","2024-03-22",0,0,0,0,0,0,0,0
"Jamaica","2024-03-23",0,0,0,0,0,0,0,0
"Jamaica","2024-03-24",0,0,0,0,0,0,0,0
"Jamaica","2024-03-25",0,0,0,0,0,0,0,0
"Jamaica","2024-03-26",0,0,0,0,0,0,0,0
"Jamaica","2024-03-27",0,0,0,0,0,0,0,0
"Jamaica","2024-03-28",0,0,0,0,0,0,0,0
"Jamaica","2024-03-29",0,0,0,0,0,0,0,0
"Jamaica","2024-03-30",0,0,0,0,0,0,0,0
"Jamaica","2024-03-31",0,0,0,0,0,0,0,0
"Jamaica","2024-04-01",0,0,0,0,0,0,0,0
"Jamaica","2024-04-02",0,0,0,0,0,0,0,0
"Jamaica","2024-04-03",0,0,0,0,0,0,0,0
"Jamaica","2024-04-04",0,0,0,0,0,0,0,0
"Jamaica","2024-04-05",0,0,0,0,0,0,0,0
"Jamaica","2024-04-06",0,0,0,0,0,0,0,0
"Jamaica","2024-04-07",0,0,0,0,0,0,0,0
"Jamaica","2024-04-08",0,0,0,0,0,0,0,0
"Jamaica","2024-04-09",0,0,0,0,0,0,0,0
"Jamaica","2024-04-10",0,0,0,0,0,0,0,0
"Jamaica","2024-04-11",0,0,0,0,0,0,0,0
"Jamaica","2024-04-12",0,0,0,0,0,0,0,0
"Jamaica","2024-04-13",0,0,0,0,0,0,0,0
"Jamaica","2024-04-14",0,0,0,0,0,0,0,0
"Jamaica","2024-04-15",0,0,0,0,0,0,0,0
"Jamaica","2024-04-16",0,0,0,0,0,0,0,0
"Jamaica","2024-04-17",0,0,0,0,0,0,0,0
"Jamaica","2024-04-18",0,0,0,0,0,0,0,0
"Jamaica","2024-04-19",0,0,0,0,0,0,0,0
"Jamaica","2024-04-20",0,0,0,0,0,0,0,0
"Jamaica","2024-04-21",0,0,0,0,0,0,0,0
"Jamaica","2024-04-22",0,0,0,0,0,0,0,0
"Jamaica","2024-04-23",0,0,0,0,0,0,0,0
"Jamaica","2024-04-24",0,0,0,0,0,0,0,0
"Jamaica","2024-04-25",0,0,0,0,0,0,0,0
"Jamaica","2024-04-26",0,0,0,0,0,0,0,0
"Jamaica","2024-04-27",0,0,0,0,0,0,0,0
"Jamaica","2024-04-28",0,0,0,0,0,0,0,0
"Jamaica","2024-04-29",0,0,0,0,0,0,0,0
"Jamaica","2024-04-30",0,0,0,0,0,0,0,0
"Jamaica","2024-05-01",0,0,0,0,0,0,0,0
"Jamaica","2024-05-02",0,0,0,0,0,0,0,0
"Jamaica","2024-05-03",0,0,0,0,0,0,0,0
"Jamaica","2024-05-04",0,0,0,0,0,0,0,0
"Jamaica","2024-05-05",0,0,0,0,0,0,0,0
"Jamaica","2024-05-06",0,0,0,0,0,0,0,0
"Jamaica","2024-05-07",0,0,0,0,0,0,0,0
"Jamaica","2024-05-08",0,0,0,0,0,0,0,0
"Jamaica","2024-05-09",0,0,0,0,0,0,0,0
"Jamaica","2024-05-10",0,0,0,0,0,0,0,0
"Jamaica","2024-05-11",0,0,0,0,0,0,0,0
"Jamaica","2024-05-12",0,0,0,0,0,0,0,0
"Jamaica","2024-05-13",0,0,0,0,0,0,0,0
"Jamaica","2024-05-14",0,0,0,0,0,0,0,0
"Jamaica","2024-05-15",0,0,0,0,0,0,0,0
"Jamaica","2024-05-16",0,0,0,0,0,0,0,0
"Jamaica","2024-05-17",0,0,0,0,0,0,0,0
"Jamaica","2024-05-18",0,0,0,0,0,0,0,0
"Jamaica","2024-05-19",0,0,0,0,0,0,0,0
"Jamaica","2024-05-20",0,0,0,0,0,0,0,0
"Jamaica","2024-05-21",0,0,0,0,0,0,0,0
"Jamaica","2024-05-22",0,0,0,0,0,0,0,0
"Jamaica","2024-05-23",0,0,0,0,0,0,0,0
"Jamaica","2024-05-24",0,0,0,0,0,0,0,0
"Jamaica","2024-05-25",0,0,0,0,0,0,0,0
"Jamaica","2024-05-26",0,0,0,0,0,0,0,0
"Jamaica","2024-05-27",0,0,0,0,0,0,0,0
"Jamaica","2024-05-28",0,0,0,0,0,0,0,0
"Jamaica","2024-05-29",0,0,0,0,0,0,0,0
"Jamaica","2024-05-30",0,0,0,0,0,0,0,0
"Jamaica","2024-05-31",0,0,0,0,0,0,0,0
"Jamaica","2024-06-01",0,0,0,0,0,0,0,0
"Jamaica","2024-06-02",0,0,0,0,0,0,0,0
"Jamaica","2024-06-03",0,0,0,0,0,0,0,0
"Jamaica","2024-06-04",0,0,0,0,0,0,0,0
"Jamaica","2024-06-05",0,0,0,0,0,0,0,0
"Jamaica","2024-06-06",0,0,0,0,0,0,0,0
"Jamaica","2024-06-07",0,0,0,0,0,0,0,0
"Jamaica","2024-06-08",0,0,0,0,0,0,0,0
"Jamaica","2024-06-09",0,0,0,0,0,0,0,0
"Jamaica","2024-06-10",0,0,0,0,0,0,0,0
"Jamaica","2024-06-11",0,0,0,0,0,0,0,0
"Jamaica","2024-06-12",0,0,0,0,0,0,0,0
"Jamaica","2024-06-13",0,0,0,0,0,0,0,0
"Jamaica","2024-06-14",0,0,0,0,0,0,0,0
"Jamaica","2024-06-15",0,0,0,0,0,0,0,0
"Jamaica","2024-06-16",0,0,0,0,0,0,0,0
"Jamaica","2024-06-17",0,0,0,0,0,0,0,0
"Jamaica","2024-06-18",0,0,0,0,0,0,0,0
"Jamaica","2024-06-19",0,0,0,0,0,0,0,0
"Jamaica","2024-06-20",0,0,0,0,0,0,0,0
"Jamaica","2024-06-21",0,0,0,0,0,0,0,0
"Jamaica","2024-06-22",0,0,0,0,0,0,0,0
"Jamaica","2024-06-23",0,0,0,0,0,0,0,0
"Jamaica","2024-06-24",0,0,0,0,0,0,0,0
"Jamaica","2024-06-25",0,0,0,0,0,0,0,0
"Jamaica","2024-06-26",0,0,0,0,0,0,0,0
"Jamaica","2024-06-27",0,0,0,0,0,0,0,0
"Jamaica","2024-06-28",0,0,0,0,0,0,0,0
"Jamaica","2024-06-29",0,0,0,0,0,0,0,0
"Jamaica","2024-06-30",0,0,0,0,0,0,0,0
"Jamaica","2024-07-01",0,0,0,0,0,0,0,0
"Jamaica","2024-07-02",0,0,0,0,0,0,0,0
"Jamaica","2024-07-03",0,0,0,0,0,0,0,0
"Jamaica","2024-07-04",0,0,0,0,0,0,0,0
"Jamaica","2024-07-05",0,0,0,0,0,0,0,0
"Jamaica","2024-07-06",0,0,0,0,0,0,0,0
"Jamaica","2024-07-07",0,0,0,0,0,0,0,0
"Jamaica","2024-07-08",0,0,0,0,0,0,0,0
"Jamaica","2024-07-09",0,0,0,0,0,0,0,0
"Jamaica","2024-07-10",0,0,0,0,0,0,0,0
"Jamaica","2024-07-11",0,0,0,0,0,0,0,0
"Jamaica","2024-07-12",0,0,0,0,0,0,0,0
"Jamaica","2024-07-13",0,0,0,0,0,0,0,0
"Jamaica","2024-07-14",0,0,0,0,0,0,0,0
"Jamaica","2024-07-15",0,0,0,0,0,0,0,0
"Jamaica","2024-07-16",0,0,0,0,0,0,0,0
"Jamaica","2024-07-17",0,0,0,0,0,0,0,0
"Jamaica","2024-07-18",0,0,0,0,0,0,0,0
"Jamaica","2024-07-19",0,0,0,0,0,0,0,0
"Jamaica","2024-07-20",0,0,0,0,0,0,0,0
"Jamaica","2024-07-21",0,0,0,0,0,0,0,0
"Jamaica","2024-07-22",0,0,0,0,0,0,0,0
"Jamaica","2024-07-23",0,0,0,0,0,0,0,0
"Jamaica","2024-07-24",0,0,0,0,0,0,0,0
"Jamaica","2024-07-25",0,0,0,0,0,0,0,0
"Jamaica","2024-07-26",0,0,0,0,0,0,0,0
"Jamaica","2024-07-27",0,0,0,0,0,0,0,0
"Jamaica","2024-07-28",0,0,0,0,0,0,0,0
"Jamaica","2024-07-29",0,0,0,0,0,0,0,0
"Jamaica","2024-07-30",0,0,0,0,0,0,0,0
"Jamaica","2024-07-31",0,0,0,0,0,0,0,0
"Jamaica","2024-08-01",0,0,0,0,0,0,0,0
"Jamaica","2024-08-02",0,0,0,0,0,0,0,0
"Jamaica","2024-08-03",0,0,0,0,0,0,0,0
"Jamaica","2024-08-04",0,0,0,0,0,0,0,0
"Jamaica","2024-08-05",0,0,0,0,0,0,0,0
"Jamaica","2024-08-06",0,0,0,0,0,0,0,0
"Jamaica","2024-08-07",0,0,0,0,0,0,0,0
"Jamaica","2024-08-08",0,0,0,0,0,0,0,0
"Jamaica","2024-08-09",0,0,0,0,0,0,0,0
"Jamaica","2024-08-10",0,0,0,0,0,0,0,0
"Jamaica","2024-08-11",0,0,0,0,0,0,0,0
"Jamaica","2024-08-12",0,0,0,0,0,0,0,0
"Jamaica","2024-08-13",0,0,0,0,0,0,0,0
"Jamaica","2024-08-14",0,0,0,0,0,0,0,0
"Jamaica","2024-08-15",0,0,0,0,0,0,0,0
"Jamaica","2024-08-16",0,0,0,0,0,0,0,0
"Jamaica","2024-08-17",0,0,0,0,0,0,0,0
"Jamaica","2024-08-18",0,0,0,0,0,0,0,0
"Jamaica","2024-08-19",0,0,0,0,0,0,0,0
"Jamaica","2024-08-20",0,0,0,0,0,0,0,0
"Jamaica","2024-08-21",0,0,0,0,0,0,0,0
"Jamaica","2024-08-22",0,0,0,0,0,0,0,0
"Jamaica","2024-08-23",0,0,0,0,0,0,0,0
"Jamaica","2024-08-24",0,0,0,0,0,0,0,0
"Jamaica","2024-08-25",0,0,0,0,0,0,0,0
"Jamaica","2024-08-26",0,0,0,0,0,0,0,0
"Jamaica","2024-08-27",0,0,0,0,0,0,0,0
"Jamaica","2024-08-28",0,0,0,0,0,0,0,0
"Jamaica","2024-08-29",0,0,0,0,0,0,0,0
"Jamaica","2024-08-30",0,0,0,0,0,0,0,0
"Jamaica","2024-08-31",0,0,0,0,0,0,0,0
"Jamaica","2024-09-01",0,0,0,0,0,0,0,0
"Jamaica","2024-09-02",0,0,0,0,0,0,0,0
"Jamaica","2024-09-03",0,0,0,0,0,0,0,0
"Jamaica","2024-09-04",0,0,0,0,0,0,0,0
"Jamaica","2024-09-05",0,0,0,0,0,0,0,0
"Jamaica","2024-09-06",0,0,0,0,0,0,0,0
"Jamaica","2024-09-07",0,0,0,0,0,0,0,0
"Jamaica","2024-09-08",0,0,0,0,0,0,0,0
"Jamaica","2024-09-09",0,0,0,0,0,0,0,0
"Jamaica","2024-09-10",0,0,0,0,0,0,0,0
"Jamaica","2024-09-11",0,0,0,0,0,0,0,0
"Jamaica","2024-09-12",0,0,0,0,0,0,0,0
"Jamaica","2024-09-13",0,0,0,0,0,0,0,0
"Jamaica","2024-09-14",0,0,0,0,0,0,0,0
"Jamaica","2024-09-15",0,0,0,0,0,0,0,0
"Jamaica","2024-09-16",0,0,0,0,0,0,0,0
"Jamaica","2024-09-17",0,0,0,0,0,0,0,0
"Jamaica","2024-09-18",0,0,0,0,0,0,0,0
"Jamaica","2024-09-19",0,0,0,0,0,0,0,0
"Jamaica","2024-09-20",0,0,0,0,0,0,0,0
"Jamaica","2024-09-21",0,0,0,0,0,0,0,0
"Jamaica","2024-09-22",0,0,0,0,0,0,0,0
"Jamaica","2024-09-23",0,0,0,0,0,0,0,0
"Jamaica","2024-09-24",0,0,0,0,0,0,0,0
"Jamaica","2024-09-25",0,0,0,0,0,0,0,0
"Jamaica","2024-09-26",0,0,0,0,0,0,0,0
"Jamaica","2024-09-27",0,0,0,0,0,0,0,0
"Jamaica","2024-09-28",0,0,0,0,0,0,0,0
"Jamaica","2024-09-29",0,0,0,0,0,0,0,0
"Jamaica","2024-09-30",0,0,0,0,0,0,0,0
"Jamaica","2024-10-01",0,0,0,0,0,0,0,0
"Jamaica","2024-10-02",0,0,0,0,0,0,0,0
"Jamaica","2024-10-03",0,0,0,0,0,0,0,0
"Jamaica","2024-10-04",0,0,0,0,0,0,0,0
"Jamaica","2024-10-05",0,0,0,0,0,0,0,0
"Jamaica","2024-10-06",0,0,0,0,0,0,0,0
"Jamaica","2024-10-07",0,0,0,0,0,0,0,0
"Jamaica","2024-10-08",0,0,0,0,0,0,0,0
"Jamaica","2024-10-09",0,0,0,0,0,0,0,0
"Jamaica","2024-10-10",0,0,0,0,0,0,0,0
"Jamaica","2024-10-11",0,0,0,0,0,0,0,0
"Jamaica","2024-10-12",0,0,0,0,0,0,0,0
"Jamaica","2024-10-13",0,0,0,0,0,0,0,0
"Jamaica","2024-10-14",0,0,0,0,0,0,0,0
"Jamaica","2024-10-15",0,0,0,0,0,0,0,0
"Jamaica","2024-10-16",0,0,0,0,0,0,0,0
"Jamaica","2024-10-17",0,0,0,0,0,0,0,0
"Jamaica","2024-10-18",0,0,0,0,0,0,0,0
"Jamaica","2024-10-19",0,0,0,0,0,0,0,0
"Jamaica","2024-10-20",0,0,0,0,0,0,0,0
"Jamaica","2024-10-21",0,0,0,0,0,0,0,0
"Jamaica","2024-10-22",0,0,0,0,0,0,0,0
"Jamaica","2024-10-23",0,0,0,0,0,0,0,0
"Jamaica","2024-10-24",0,0,0,0,0,0,0,0
"Jamaica","2024-10-25",0,0,0,0,0,0,0,0
"Jamaica","2024-10-26",0,0,0,0,0,0,0,0
"Jamaica","2024-10-27",0,0,0,0,0,0,0,0
"Jamaica","2024-10-28",0,0,0,0,0,0,0,0
"Jamaica","2024-10-29",0,0,0,0,0,0,0,0
"Jamaica","2024-10-30",0,0,0,0,0,0,0,0
"Jamaica","2024-10-31",0,0,0,0,0,0,0,0
"Jamaica","2024-11-01",0,0,0,0,0,0,0,0
"Jamaica","2024-11-02",0,0,0,0,0,0,0,0
"Jamaica","2024-11-03",0,0,0,0,0,0,0,0
"Jamaica","2024-11-04",0,0,0,0,0,0,0,0
"Jamaica","2024-11-05",0,0,0,0,0,0,0,0
"Jamaica","2024-11-06",0,0,0,0,0,0,0,0
"Jamaica","2024-11-07",0,0,0,0,0,0,0,0
"Jamaica","2024-11-08",0,0,0,0,0,0,0,0
"Jamaica","2024-11-09",0,0,0,0,0,0,0,0
"Jamaica","2024-11-10",0,0,0,0,0,0,0,0
"Jamaica","2024-11-11",0,0,0,0,0,0,0,0
"Jamaica","2024-11-12",0,0,0,0,0,0,0,0
"Jamaica","2024-11-13",0,0,0,0,0,0,0,0
"Jamaica","2024-11-14",0,0,0,0,0,0,0,0
"Jamaica","2024-11-15",0,0,0,0,0,0,0,0
"Jamaica","2024-11-16",0,0,0,0,0,0,0,0
"Jamaica","2024-11-17",0,0,0,0,0,0,0,0
"Jamaica","2024-11-18",0,0,0,0,0,0,0,0
"Jamaica","2024-11-19",0,0,0,0,0,0,0,0
"Jamaica","2024-11-20",0,0,0,0,0,0,0,0
"Jamaica","2024-11-21",0,0,0,0,0,0,0,0
"Jamaica","2024-11-22",0,0,0,0,0,0,0,0
"Jamaica","2024-11-23",0,0,0,0,0,0,0,0
"Jamaica","2024-11-24",0,0,0,0,0,0,0,0
"Jamaica","2024-11-25",0,0,0,0,0,0,0,0
"Jamaica","2024-11-26",0,0,0,0,0,0,0,0
"Jamaica","2024-11-27",0,0,0,0,0,0,0,0
"Jamaica","2024-11-28",0,0,0,0,0,0,0,0
"Jamaica","2024-11-29",0,0,0,0,0,0,0,0
"Jamaica","2024-11-30",0,0,0,0,0,0,0,0
"Jamaica","2024-12-01",0,0,0,0,0,0,0,0
"Jamaica","2024-12-02",0,0,0,0,0,0,0,0
"Jamaica","2024-12-03",0,0,0,0,0,0,0,0
"Jamaica","2024-12-04",0,0,0,0,0,0,0,0
"Jamaica","2024-12-05",0,0,0,0,0,0,0,0
"Jamaica","2024-12-06",0,0,0,0,0,0,0,0
"Jamaica","2024-12-07",0,0,0,0,0,0,0,0
"Jamaica","2024-12-08",0,0,0,0,0,0,0,0
"Jamaica","2024-12-09",0,0,0,0,0,0,0,0
"Jamaica","2024-12-10",0,0,0,0,0,0,0,0
"Jamaica","2024-12-11",0,0,0,0,0,0,0,0
"Jamaica","2024-12-12",0,0,0,0,0,0,0,0
"Jamaica","2024-12-13",0,0,0,0,0,0,0,0
"Jamaica","2024-12-14",0,0,0,0,0,0,0,0
"Jamaica","2024-12-15",0,0,0,0,0,0,0,0
"Jamaica","2024-12-16",0,0,0,0,0,0,0,0
"Jamaica","2024-12-17",0,0,0,0,0,0,0,0
"Jamaica","2024-12-18",0,0,0,0,0,0,0,0
"Jamaica","2024-12-19",0,0,0,0,0,0,0,0
"Jamaica","2024-12-20",0,0,0,0,0,0,0,0
"Jamaica","2024-12-21",0,0,0,0,0,0,0,0
"Jamaica","2024-12-22",0,0,0,0,0,0,0,0
"Jamaica","2024-12-23",0,0,0,0,0,0,0,0
"Jamaica","2024-12-24",0,0,0,0,0,0,0,0
"Jamaica","2024-12-25",0,0,0,0,0,0,0,0
"Jamaica","2024-12-26",0,0,0,0,0,0,0,0
"Jamaica","2024-12-27",0,0,0,0,0,0,0,0
"Jamaica","2024-12-28",0,0,0,0,0,0,0,0
"Jamaica","2024-12-29",0,0,0,0,0,0,0,0
"Jamaica","2024-12-30",0,0,0,0,0,0,0,0
"Jamaica","2024-12-31",0,0,0,0,0,0,0,0
"Jamaica","2025-01-01",0,0,0,0,0,0,0,0
"Jamaica","2025-01-02",0,0,0,0,0,0,0,0
"Jamaica","2025-01-03",0,0,0,0,0,0,0,0
"Jamaica","2025-01-04",0,0,0,0,0,0,0,0
"Jamaica","2025-01-05",0,0,0,0,0,0,0,0
"Jamaica","2025-01-06",0,0,0,0,0,0,0,0
"Jamaica","2025-01-07",0,0,0,0,0,0,0,0
"Jamaica","2025-01-08",0,0,0,0,0,0,0,0
"Jamaica","2025-01-09",0,0,0,0,0,0,0,0
"Jamaica","2025-01-10",0,0,0,0,0,0,0,0
"Jamaica","2025-01-11",0,0,0,0,0,0,0,0
"Jamaica","2025-01-12",0,0,0,0,0,0,0,0
"Jamaica","2025-01-13",0,0,0,0,0,0,0,0
"Jamaica","2025-01-14",0,0,0,0,0,0,0,0
"Jamaica","2025-01-15",0,0,0,0,0,0,0,0
"Jamaica","2025-01-16",0,0,0,0,0,0,0,0
"Jamaica","2025-01-17",0,0,0,0,0,0,0,0
"Jamaica","2025-01-18",0,0,0,0,0,0,0,0
"Jamaica","2025-01-19",0,0,0,0,0,0,0,0
"Jamaica","2025-01-20",0,0,0,0,0,0,0,0
"Jamaica","2025-01-21",0,0,0,0,0,0,0,0
"Jamaica","2025-01-22",0,0,0,0,0,0,0,0
"Jamaica","2025-01-23",0,0,0,0,0,0,0,0
"Jamaica","2025-01-24",0,0,0,0,0,0,0,0
"Jamaica","2025-01-25",0,0,0,0,0,0,0,0
"Jamaica","2025-01-26",0,0,0,0,0,0,0,0
"Jamaica","2025-01-27",0,0,0,0,0,0,0,0
"Jamaica","2025-01-28",0,0,0,0,0,0,0,0
"Jamaica","2025-01-29",0,0,0,0,0,0,0,0
"Jamaica","2025-01-30",0,0,0,0,0,0,0,0
"Jamaica","2025-01-31",0,0,0,0,0,0,0,0
"Jamaica","2025-02-01",0,0,0,0,0,0,0,0
"Jamaica","2025-02-02",0,0,0,0,0,0,0,0
"Jamaica","2025-02-03",0,0,0,0,0,0,0,0
"Japan","2024-01-01",0,0,0,0,0,0,0,0
"Japan","2024-01-02",0,0,0,0,0,0,0,0
"Japan","2024-01-03",0,0,0,0,0,0,0,0
"Japan","2024-01-04",0,0,0,0,0,0,0,0
"Japan","2024-01-05",0,0,0,0,0,0,0,0
"Japan","2024-01-06",0,0,0,0,0,0,0,0
"Japan","2024-01-07",0,0,0,0,0,0,0,0
"Japan","2024-01-08",0,0,0,0,0,0,0,0
"Japan","2024-01-09",0,1,1,0,1,1,0,0
"Japan","2024-01-10",0,0,1,0,0,1,0,0
"Japan","2024-01-11",0,0,1,0,0,1,0,0
"Japan","2024-01-12",0,0,1,0,0,1,0,0
"Japan","2024-01-13",0,0,1,0,0,1,0,0
"Japan","2024-01-14",0,0,1,0,0,1,0,0
"Japan","2024-01-15",0,0,1,0,1,2,0,0
"Japan","2024-01-16",0,0,1,0,0,2,0,0
"Japan","2024-01-17",0,0,1,0,0,2,0,0
"Japan","2024-01-18",0,0,1,0,0,2,0,0
"Japan","2024-01-19",0,1,2,0,0,2,0,0
"Japan","2024-01-20",0,0,2,0,0,2,0,0
"Japan","2024-01-21",0,0,2,0,0,2,0,0
"Japan","2024-01-22",0,0,2,0,1,3,0,0
"Japan","2024-01-23",0,0,2,0,0,3,0,0
"Japan","2024-01-24",0,0,2,0,0,3,0,0
"Japan","2024-01-25",0,0,2,0,0,3,0,0
"Japan","2024-01-26",0,0,2,0,1,4,0,0
"Japan","2024-01-27",0,0,2,0,0,4,0,0
"Japan","2024-01-28",0,0,2,0,0,4,0,0
"Japan","2024-01-29",0,0,2,0,0,4,0,0
"Japan","2024-01-30",0,0,2,0,0,4,0,0
"Japan","2024-01-31",0,0,2,0,1,5,0,0
"Japan","2024-02-01",0,0,2,0,0,5,0,0
"Japan","2024-02-02",0,3,5,0,0,5,0,0
"Japan","2024-02-03",0,0,5,0,1,6,0,0
"Japan","2024-02-04",0,0,5,0,1,7,0,0
"Japan","2024-02-05",0,3,8,0,1,8,0,0
"Japan","2024-02-06",0,0,8,0,0,8,0,0
"Japan","2024-02-07",0,0,8,0,0,8,0,0
"Japan","2024-02-08",0,0,8,0,0,8,0,0
"Japan","2024-02-09",0,0,8,0,0,8,0,0
"Japan","2024-02-10",0,0,8,0,0,8,0,0
"Japan","2024-02-11",0,0,8,0,0,8,0,0
"Japan","2024-02-12",0,0,8,0,0,8,0,0
"Japan","2024-02-13",0,0,8,0,0,8,0,0
"Japan","2024-02-14",0,0,8,0,0,8,0,0
"Japan","2024-02-15",0,0,8,0,0,8,0,0
"Japan","2024-02-16",0,0,8,0,0,8,0,0
"Japan","2024-02-17",0,0,8,0,0,8,0,0
"Japan","2024-02-18",0,0,8,0,1,9,0,0
"Japan","2024-02-19",0,0,8,0,0,9,0,0
"Japan","2024-02-20",0,0,8,0,0,9,0,0
"Japan","2024-02-21",0,0,8,0,0,9,0,0
"Japan","2024-02-22",0,0,8,0,0,9,0,0
"Japan","2024-02-23",0,0,8,0,0,9,0,0
"Japan","2024-02-24",0,0,8,0,0,9,0,0
"Japan","2024-02-25",0,0,8,0,0,9,0,0
"Japan","2024-02-26",0,0,8,0,0,9,0,0
"Japan","2024-02-27",0,0,8,0,0,9,0,0
"Japan","2024-02-28",0,0,8,0,0,9,0,0
"Japan","2024-02-29",0,0,8,0,0,9,0,0
"Japan","2024-03-01",0,1,9,0,0,9,0,0
"Japan","2024-03-02",0,0,9,0,0,9,0,0
"Japan","2024-03-03",0,0,9,0,0,9,0,0
"Japan","2024-03-04",0,0,9,0,0,9,0,0
"Japan","2024-03-05",0,0,9,0,1,10,0,0
"Japan","2024-03-06",0,0,9,0,0,10,0,0
"Japan","2024-03-07",0,0,9,0,0,10,0,0
"Japan","2024-03-08",0,1,10,0,0,10,0,0
"Japan","2024-03-09",0,0,10,0,0,10,0,0
"Japan","2024-03-10",0,0,10,0,0,10,0,0
"Japan","2024-03-11",0,0,10,0,0,10,0,0
"Japan","2024-03-12",0,0,10,0,0,10,0,0
"Japan","2024-03-13",0,0,10,0,0,10,0,0
"Japan","2024-03-14",0,0,10,0,0,10,0,0
"Japan","2024-03-15",0,0,10,0,0,10,0,0
"Japan","2024-03-16",0,0,10,0,0,10,0,0
"Japan","2024-03-17",0,0,10,0,0,10,0,0
"Japan","2024-03-18",0,0,10,0,0,10,0,0
"Japan","2024-03-19",0,0,10,0,0,10,0,0
"Japan","2024-03-20",0,0,10,0,0,10,0,0
"Japan","2024-03-21",0,0,10,0,0,10,0,0
"Japan","2024-03-22",0,0,10,0,0,10,0,0
"Japan","2024-03-23",0,0,10,0,1,11,0,0
"Japan","2024-03-24",0,0,10,0,0,11,0,0
"Japan","2024-03-25",0,0,10,0,0,11,0,0
"Japan","2024-03-26",0,0,10,0,0,11,0,0
"Japan","2024-03-27",0,0,10,0,0,11,0,0
"Japan","2024-03-28",0,0,10,0,0,11,0,0
"Japan","2024-03-29",0,0,10,0,0,11,0,0
"Japan","2024-03-30",0,0,10,0,0,11,0,0
"Japan","2024-03-31",0,0,10,0,0,11,0,0
"Japan","2024-04-01",0,0,10,0,0,11,0,0
"Japan","2024-04-02",0,0,10,0,0,11,0,0
"Japan","2024-04-03",0,0,10,0,0,11,0,0
"Japan","2024-04-04",0,0,10,0,0,11,0,0
"Japan","2024-04-05",0,1,11,0,0,11,0,0
"Japan","2024-04-06",0,0,11,0,0,11,0,0
"Japan","2024-04-07",0,0,11,0,0,11,0,0
"Japan","2024-04-08",0,0,11,0,0,11,0,0
"Japan","2024-04-09",0,0,11,0,1,12,0,0
"Japan","2024-04-10",0,0,11,0,0,12,0,0
"Japan","2024-04-11",0,0,11,0,0,12,0,0
"Japan","2024-04-12",0,1,12,0,0,12,0,0
"Japan","2024-04-13",0,0,12,0,0,12,0,0
"Japan","2024-04-14",0,0,12,0,0,12,0,0
"Japan","2024-04-15",0,0,12,0,0,12,0,0
"Japan","2024-04-16",0,0,12,0,1,13,0,0
"Japan","2024-04-17",0,0,12,0,0,13,0,0
"Japan","2024-04-18",0,0,12,0,0,13,0,0
"Japan","2024-04-19",0,1,13,0,0,13,0,0
"Japan","2024-04-20",0,0,13,0,0,13,0,0
"Japan","2024-04-21",0,0,13,0,0,13,0,0
"Japan","2024-04-22",0,0,13,0,0,13,0,0
"Japan","2024-04-23",0,0,13,0,0,13,0,0
"Japan","2024-04-24",0,0,13,0,0,13,0,0
"Japan","2024-04-25",0,0,13,0,0,13,0,0
"Japan","2024-04-26",0,0,13,0,0,13,0,0
"Japan","2024-04-27",0,0,13,0,0,13,0,0
"Japan","2024-04-28",0,0,13,0,0,13,0,0
"Japan","2024-04-29",0,0,13,0,0,13,0,0
"Japan","2024-04-30",0,0,13,0,1,14,0,0
"Japan","2024-05-01",0,0,13,0,0,14,0,0
"Japan","2024-05-02",0,0,13,0,0,14,0,0
"Japan","2024-05-03",0,0,13,0,0,14,0,0
"Japan","2024-05-04",0,0,13,0,0,14,0,0
"Japan","2024-05-05",0,0,13,0,0,14,0,0
"Japan","2024-05-06",0,0,13,0,0,14,0,0
"Japan","2024-05-07",0,0,13,0,0,14,0,0
"Japan","2024-05-08",0,0,13,0,0,14,0,0
"Japan","2024-05-09",0,0,13,0,0,14,0,0
"Japan","2024-05-10",0,1,14,0,0,14,0,0
"Japan","2024-05-11",0,0,14,0,0,14,0,0
"Japan","2024-05-12",0,0,14,0,0,14,0,0
"Japan","2024-05-13",0,0,14,0,0,14,0,0
"Japan","2024-05-14",0,0,14,0,0,14,0,0
"Japan","2024-05-15",0,0,14,0,0,14,0,0
"Japan","2024-05-16",0,0,14,0,0,14,0,0
"Japan","2024-05-17",0,0,14,0,0,14,0,0
"Japan","2024-05-18",0,0,14,0,1,15,0,0
"Japan","2024-05-19",0,0,14,0,0,15,0,0
"Japan","2024-05-20",0,0,14,0,0,15,0,0
"Japan","2024-05-21",0,0,14,0,0,15,0,0
"Japan","2024-05-22",0,0,14,0,0,15,0,0
"Japan","2024-05-23",0,0,14,0,0,15,0,0
"Japan","2024-05-24",0,1,15,0,0,15,0,0
"Japan","2024-05-25",0,0,15,0,0,15,0,0
"Japan","2024-05-26",0,0,15,0,0,15,0,0
"Japan","2024-05-27",0,0,15,0,0,15,0,0
"Japan","2024-05-28",0,0,15,0,0,15,0,0
"Japan","2024-05-29",0,0,15,0,0,15,0,0
"Japan","2024-05-30",0,0,15,0,0,15,0,0
"Japan","2024-05-31",0,0,15,0,0,15,0,0
"Japan","2024-06-01",0,0,15,0,0,15,0,0
"Japan","2024-06-02",0,0,15,0,0,15,0,0
"Japan","2024-06-03",0,0,15,0,0,15,0,0
"Japan","2024-06-04",0,0,15,0,0,15,0,0
"Japan","2024-06-05",0,0,15,0,0,15,0,0
"Japan","2024-06-06",0,0,15,0,0,15,0,0
"Japan","2024-06-07",0,0,15,0,0,15,0,0
"Japan","2024-06-08",0,0,15,0,0,15,0,0
"Japan","2024-06-09",0,0,15,0,0,15,0,0
"Japan","2024-06-10",0,0,15,0,0,15,0,0
"Japan","2024-06-11",0,0,15,0,0,15,0,0
"Japan","2024-06-12",0,0,15,0,0,15,0,0
"Japan","2024-06-13",0,0,15,0,0,15,0,0
"Japan","2024-06-14",0,0,15,0,0,15,0,0
"Japan","2024-06-15",0,0,15,0,0,15,0,0
"Japan","2024-06-16",0,0,15,0,0,15,0,0
"Japan","2024-06-17",0,0,15,0,0,15,0,0
"Japan","2024-06-18",0,0,15,0,0,15,0,0
"Japan","2024-06-19",0,0,15,0,0,15,0,0
"Japan","2024-06-20",0,0,15,0,0,15,0,0
"Japan","2024-06-21",0,0,15,0,0,15,0,0
"Japan","2024-06-22",0,0,15,0,0,15,0,0
"Japan","2024-06-23",0,0,15,0,0,15,0,0
"Japan","2024-06-24",0,0,15,0,0,15,0,0
"Japan","2024-06-25",0,0,15,0,0,15,0,0
"Japan","2024-06-26",0,0,15,0,0,15,0,0
"Japan","2024-06-27",0,0,15,0,0,15,0,0
"Japan","2024-06-28",0,0,15,0,0,15,0,0
"Japan","2024-06-29",0,0,15,0,0,15,0,0
"Japan","2024-06-30",0,0,15,0,1,16,0,0
"Japan","2024-07-01",0,0,15,0,0,16,0,0
"Japan","2024-07-02",0,0,15,0,0,16,0,0
"Japan","2024-07-03",0,0,15,0,0,16,0,0
"Japan","2024-07-04",0,0,15,0,0,16,0,0
"Japan","2024-07-05",0,0,15,0,0,16,0,0
"Japan","2024-07-06",0,0,15,0,0,16,0,0
"Japan","2024-07-07",0,0,15,0,0,16,0,0
"Japan","2024-07-08",0,0,15,0,0,16,0,0
"Japan","2024-07-09",0,0,15,0,0,16,0,0
"Japan","2024-07-10",0,0,15,0,0,16,0,0
"Japan","2024-07-11",0,0,15,0,0,16,0,0
"Japan","2024-07-12",0,0,15,0,0,16,0,0
"Japan","2024-07-13",0,0,15,0,0,16,0,0
"Japan","2024-07-14",0,0,15,0,0,16,0,0
"Japan","2024-07-15",0,0,15,0,0,16,0,0
"Japan","2024-07-16",0,0,15,0,0,16,0,0
"Japan","2024-07-17",0,0,15,0,0,16,0,0
"Japan","2024-07-18",0,0,15,0,0,16,0,0
"Japan","2024-07-19",0,0,15,0,0,16,0,0
"Japan","2024-07-20",0,0,15,0,0,16,0,0
"Japan","2024-07-21",0,0,15,0,0,16,0,0
"Japan","2024-07-22",0,0,15,0,0,16,0,0
"Japan","2024-07-23",0,0,15,0,0,16,0,0
"Japan","2024-07-24",0,0,15,0,0,16,0,0
"Japan","2024-07-25",0,0,15,0,0,16,0,0
"Japan","2024-07-26",0,0,15,0,0,16,0,0
"Japan","2024-07-27",0,0,15,0,0,16,0,0
"Japan","2024-07-28",0,0,15,0,0,16,0,0
"Japan","2024-07-29",0,0,15,0,0,16,0,0
"Japan","2024-07-30",0,0,15,0,0,16,0,0
"Japan","2024-07-31",0,0,15,0,0,16,0,0
"Japan","2024-08-01",0,0,15,0,0,16,0,0
"Japan","2024-08-02",0,0,15,0,0,16,0,0
"Japan","2024-08-03",0,0,15,0,0,16,0,0
"Japan","2024-08-04",0,0,15,0,0,16,0,0
"Japan","2024-08-05",0,1,16,0,0,16,0,0
"Japan","2024-08-06",0,0,16,0,0,16,0,0
"Japan","2024-08-07",0,0,16,0,0,16,0,0
"Japan","2024-08-08",0,0,16,0,0,16,0,0
"Japan","2024-08-09",0,0,16,0,0,16,0,0
"Japan","2024-08-10",0,0,16,0,0,16,0,0
"Japan","2024-08-11",0,0,16,0,0,16,0,0
"Japan","2024-08-12",0,0,16,0,0,16,0,0
"Japan","2024-08-13",0,0,16,0,0,16,0,0
"Japan","2024-08-14",0,0,16,0,0,16,0,0
"Japan","2024-08-15",0,0,16,0,0,16,0,0
"Japan","2024-08-16",0,0,16,0,0,16,0,0
"Japan","2024-08-17",0,0,16,0,0,16,0,0
"Japan","2024-08-18",0,0,16,0,0,16,0,0
"Japan","2024-08-19",0,0,16,0,0,16,0,0
"Japan","2024-08-20",0,0,16,0,0,16,0,0
"Japan","2024-08-21",0,0,16,0,0,16,0,0
"Japan","2024-08-22",0,0,16,0,0,16,0,0
"Japan","2024-08-23",0,0,16,0,0,16,0,0
"Japan","2024-08-24",0,0,16,0,0,16,0,0
"Japan","2024-08-25",0,0,16,0,0,16,0,0
"Japan","2024-08-26",0,0,16,0,0,16,0,0
"Japan","2024-08-27",0,0,16,0,0,16,0,0
"Japan","2024-08-28",0,0,16,0,0,16,0,0
"Japan","2024-08-29",0,0,16,0,0,16,0,0
"Japan","2024-08-30",0,0,16,0,0,16,0,0
"Japan","2024-08-31",0,0,16,0,0,16,0,0
"Japan","2024-09-01",0,0,16,0,0,16,0,0
"Japan","2024-09-02",0,0,16,0,0,16,0,0
"Japan","2024-09-03",0,0,16,0,0,16,0,0
"Japan","2024-09-04",0,0,16,0,0,16,0,0
"Japan","2024-09-05",0,0,16,0,1,17,0,0
"Japan","2024-09-06",0,0,16,0,0,17,0,0
"Japan","2024-09-07",0,0,16,0,0,17,0,0
"Japan","2024-09-08",0,0,16,0,0,17,0,0
"Japan","2024-09-09",0,0,16,0,0,17,0,0
"Japan","2024-09-10",0,0,16,0,0,17,0,0
"Japan","2024-09-11",0,0,16,0,0,17,0,0
"Japan","2024-09-12",0,0,16,0,0,17,0,0
"Japan","2024-09-13",0,0,16,0,0,17,0,0
"Japan","2024-09-14",0,0,16,0,0,17,0,0
"Japan","2024-09-15",0,0,16,0,0,17,0,0
"Japan","2024-09-16",0,0,16,0,0,17,0,0
"Japan","2024-09-17",0,0,16,0,0,17,0,0
"Japan","2024-09-18",0,0,16,0,0,17,0,0
"Japan","2024-09-19",0,0,16,0,0,17,0,0
"Japan","2024-09-20",0,0,16,0,0,17,0,0
"Japan","2024-09-21",0,0,16,0,0,17,0,0
"Japan","2024-09-22",0,0,16,0,0,17,0,0
"Japan","2024-09-23",0,0,16,0,0,17,0,0
"Japan","2024-09-24",0,0,16,0,0,17,0,0
"Japan","2024-09-25",0,0,16,0,0,17,0,0
"Japan","2024-09-26",0,0,16,0,0,17,0,0
"Japan","2024-09-27",0,0,16,0,0,17,0,0
"Japan","2024-09-28",0,0,16,0,0,17,0,0
"Japan","2024-09-29",0,0,16,0,0,17,0,0
"Japan","2024-09-30",0,0,16,0,0,17,0,0
"Japan","2024-10-01",0,0,16,0,0,17,0,0
"Japan","2024-10-02",0,0,16,0,0,17,0,0
"Japan","2024-10-03",0,0,16,0,0,17,0,0
"Japan","2024-10-04",0,1,17,0,0,17,0,0
"Japan","2024-10-05",0,0,17,0,0,17,0,0
"Japan","2024-10-06",0,0,17,0,0,17,0,0
"Japan","2024-10-07",0,0,17,0,0,17,0,0
"Japan","2024-10-08",0,0,17,0,1,18,0,0
"Japan","2024-10-09",0,0,17,0,0,18,0,0
"Japan","2024-10-10",0,0,17,0,0,18,0,0
"Japan","2024-10-11",0,0,17,0,0,18,0,0
"Japan","2024-10-12",0,0,17,0,0,18,0,0
"Japan","2024-10-13",0,0,17,0,0,18,0,0
"Japan","2024-10-14",0,0,17,0,0,18,0,0
"Japan","2024-10-15",0,0,17,0,1,19,0,0
"Japan","2024-10-16",0,0,17,0,0,19,0,0
"Japan","2024-10-17",0,0,17,0,0,19,0,0
"Japan","2024-10-18",0,2,19,0,0,19,0,0
"Japan","2024-10-19",0,0,19,0,0,19,0,0
"Japan","2024-10-20",0,0,19,0,0,19,0,0
"Japan","2024-10-21",0,0,19,0,0,19,0,0
"Japan","2024-10-22",0,0,19,0,0,19,0,0
"Japan","2024-10-23",0,0,19,0,0,19,0,0
"Japan","2024-10-24",0,0,19,0,0,19,0,0
"Japan","2024-10-25",0,0,19,0,0,19,0,0
"Japan","2024-10-26",0,0,19,0,0,19,0,0
"Japan","2024-10-27",0,0,19,0,0,19,0,0
"Japan","2024-10-28",0,0,19,0,0,19,0,0
"Japan","2024-10-29",0,0,19,0,0,19,0,0
"Japan","2024-10-30",0,0,19,0,0,19,0,0
"Japan","2024-10-31",0,0,19,0,0,19,0,0
"Japan","2024-11-01",0,0,19,0,0,19,0,0
"Japan","2024-11-02",0,0,19,0,1,20,0,0
"Japan","2024-11-03",0,0,19,0,0,20,0,0
"Japan","2024-11-04",0,0,19,0,0,20,0,0
"Japan","2024-11-05",0,0,19,0,0,20,0,0
"Japan","2024-11-06",0,0,19,0,0,20,0,0
"Japan","2024-11-07",0,0,19,0,0,20,0,0
"Japan","2024-11-08",0,0,19,0,0,20,0,0
"Japan","2024-11-09",0,0,19,0,0,20,0,0
"Japan","2024-11-10",0,0,19,0,0,20,0,0
"Japan","2024-11-11",0,0,19,0,0,20,0,0
"Japan","2024-11-12",0,0,19,0,0,20,0,0
"Japan","2024-11-13",0,0,19,0,0,20,0,0
"Japan","2024-11-14",0,0,19,0,0,20,0,0
"Japan","2024-11-15",0,1,20,0,0,20,0,0
"Japan","2024-11-16",0,0,20,0,0,20,0,0
"Japan","2024-11-17",0,0,20,0,0,20,0,0
"Japan","2024-11-18",0,0,20,0,0,20,0,0
"Japan","2024-11-19",0,0,20,0,0,20,0,0
"Japan","2024-11-20",0,0,20,0,0,20,0,0
"Japan","2024-11-21",0,0,20,0,0,20,0,0
"Japan","2024-11-22",0,0,20,0,0,20,0,0
"Japan","2024-11-23",0,0,20,0,0,20,0,0
"Japan","2024-11-24",0,0,20,0,0,20,0,0
"Japan","2024-11-25",0,0,20,0,0,20,0,0
"Japan","2024-11-26",0,0,20,0,0,20,0,0
"Japan","2024-11-27",0,0,20,0,0,20,0,0
"Japan","2024-11-28",0,0,20,0,0,20,0,0
"Japan","2024-11-29",0,0,20,0,0,20,0,0
"Japan","2024-11-30",0,0,20,0,0,20,0,0
"Japan","2024-12-01",0,0,20,0,0,20,0,0
"Japan","2024-12-02",0,0,20,0,0,20,0,0
"Japan","2024-12-03",0,0,20,0,0,20,0,0
"Japan","2024-12-04",0,0,20,0,0,20,0,0
"Japan","2024-12-05",0,0,20,0,0,20,0,0
"Japan","2024-12-06",0,0,20,0,0,20,0,0
"Japan","2024-12-07",0,0,20,0,0,20,0,0
"Japan","2024-12-08",0,0,20,0,0,20,0,0
"Japan","2024-12-09",0,0,20,0,0,20,0,0
"Japan","2024-12-10",0,0,20,0,0,20,0,0
"Japan","2024-12-11",0,0,20,0,0,20,0,0
"Japan","2024-12-12",0,0,20,0,0,20,0,0
"Japan","2024-12-13",0,0,20,0,0,20,0,0
"Japan","2024-12-14",0,0,20,0,0,20,0,0
"Japan","2024-12-15",0,0,20,0,0,20,0,0
"Japan","2024-12-16",0,0,20,0,0,20,0,0
"Japan","2024-12-17",0,0,20,0,0,20,0,0
"Japan","2024-12-18",0,0,20,0,0,20,0,0
"Japan","2024-12-19",0,0,20,0,0,20,0,0
"Japan","2024-12-20",0,0,20,0,0,20,0,0
"Japan","2024-12-21",0,0,20,0,0,20,0,0
"Japan","2024-12-22",0,0,20,0,0,20,0,0
"Japan","2024-12-23",0,0,20,0,0,20,0,0
"Japan","2024-12-24",0,0,20,0,0,20,0,0
"Japan","2024-12-25",0,0,20,0,0,20,0,0
"Japan","2024-12-26",0,0,20,0,0,20,0,0
"Japan","2024-12-27",0,0,20,0,0,20,0,0
"Japan","2024-12-28",0,0,20,0,0,20,0,0
"Japan","2024-12-29",0,0,20,0,0,20,0,0
"Japan","2024-12-30",0,0,20,0,0,20,0,0
"Japan","2024-12-31",0,0,20,0,0,20,0,0
"Japan","2025-01-01",0,0,20,0,0,20,0,0
"Japan","2025-01-02",0,0,20,0,0,20,0,0
"Japan","2025-01-03",0,0,20,0,0,20,0,0
"Japan","2025-01-04",0,0,20,0,0,20,0,0
"Japan","2025-01-05",0,0,20,0,0,20,0,0
"Japan","2025-01-06",0,0,20,0,0,20,0,0
"Japan","2025-01-07",0,0,20,0,0,20,0,0
"Japan","2025-01-08",0,0,20,0,0,20,0,0
"Japan","2025-01-09",0,0,20,0,0,20,0,0
"Japan","2025-01-10",0,0,20,0,0,20,0,0
"Japan","2025-01-11",0,0,20,0,0,20,0,0
"Japan","2025-01-12",0,0,20,0,0,20,0,0
"Japan","2025-01-13",0,0,20,0,0,20,0,0
"Japan","2025-01-14",0,0,20,0,0,20,0,0
"Japan","2025-01-15",0,0,20,0,0,20,0,0
"Japan","2025-01-16",0,0,20,0,0,20,0,0
"Japan","2025-01-17",0,0,20,0,0,20,0,0
"Japan","2025-01-18",0,0,20,0,0,20,0,0
"Japan","2025-01-19",0,0,20,0,0,20,0,0
"Japan","2025-01-20",0,0,20,0,0,20,0,0
"Japan","2025-01-21",0,0,20,0,0,20,0,0
"Japan","2025-01-22",0,0,20,0,0,20,0,0
"Japan","2025-01-23",0,0,20,0,0,20,0,0
"Japan","2025-01-24",0,0,20,0,0,20,0,0
"Japan","2025-01-25",0,0,20,0,0,20,0,0
"Japan","2025-01-26",0,0,20,0,0,20,0,0
"Japan","2025-01-27",0,0,20,0,0,20,0,0
"Japan","2025-01-28",0,0,20,0,0,20,0,0
"Japan","2025-01-29",0,0,20,0,0,20,0,0
"Japan","2025-01-30",0,0,20,0,0,20,0,0
"Japan","2025-01-31",0,0,20,0,0,20,0,0
"Japan","2025-02-01",0,0,20,0,0,20,0,0
"Japan","2025-02-02",0,0,20,0,0,20,0,0
"Japan","2025-02-03",0,0,20,0,0,20,0,0
"Jordan","2024-01-01",0,0,0,0,0,0,0,0
"Jordan","2024-01-02",0,0,0,0,0,0,0,0
"Jordan","2024-01-03",0,0,0,0,0,0,0,0
"Jordan","2024-01-04",0,0,0,0,0,0,0,0
"Jordan","2024-01-05",0,0,0,0,0,0,0,0
"Jordan","2024-01-06",0,0,0,0,0,0,0,0
"Jordan","2024-01-07",0,0,0,0,0,0,0,0
"Jordan","2024-01-08",0,0,0,0,0,0,0,0
"Jordan","2024-01-09",0,0,0,0,0,0,0,0
"Jordan","2024-01-10",0,0,0,0,0,0,0,0
"Jordan","2024-01-11",0,0,0,0,0,0,0,0
"Jordan","2024-01-12",0,0,0,0,0,0,0,0
"Jordan","2024-01-13",0,0,0,0,0,0,0,0
"Jordan","2024-01-14",0,0,0,0,0,0,0,0
"Jordan","2024-01-15",0,0,0,0,0,0,0,0
"Jordan","2024-01-16",0,0,0,0,0,0,0,0
"Jordan","2024-01-17",0,0,0,0,0,0,0,0
"Jordan","2024-01-18",0,0,0,0,0,0,0,0
"Jordan","2024-01-19",0,0,0,0,0,0,0,0
"Jordan","2024-01-20",0,0,0,0,0,0,0,0
"Jordan","2024-01-21",0,0,0,0,0,0,0,0
"Jordan","2024-01-22",0,0,0,0,0,0,0,0
"Jordan","2024-01-23",0,0,0,0,0,0,0,0
"Jordan","2024-01-24",0,0,0,0,0,0,0,0
"Jordan","2024-01-25",0,0,0,0,0,0,0,0
"Jordan","2024-01-26",0,0,0,0,0,0,0,0
"Jordan","2024-01-27",0,0,0,0,0,0,0,0
"Jordan","2024-01-28",0,0,0,0,0,0,0,0
"Jordan","2024-01-29",0,0,0,0,0,0,0,0
"Jordan","2024-01-30",0,0,0,0,0,0,0,0
"Jordan","2024-01-31",0,0,0,0,0,0,0,0
"Jordan","2024-02-01",0,0,0,0,0,0,0,0
"Jordan","2024-02-02",0,0,0,0,0,0,0,0
"Jordan","2024-02-03",0,0,0,0,0,0,0,0
"Jordan","2024-02-04",0,0,0,0,0,0,0,0
"Jordan","2024-02-05",0,0,0,0,0,0,0,0
"Jordan","2024-02-06",0,0,0,0,0,0,0,0
"Jordan","2024-02-07",0,0,0,0,0,0,0,0
"Jordan","2024-02-08",0,0,0,0,0,0,0,0
"Jordan","2024-02-09",0,0,0,0,0,0,0,0
"Jordan","2024-02-10",0,0,0,0,0,0,0,0
"Jordan","2024-02-11",0,0,0,0,0,0,0,0
"Jordan","2024-02-12",0,0,0,0,0,0,0,0
"Jordan","2024-02-13",0,0,0,0,0,0,0,0
"Jordan","2024-02-14",0,0,0,0,0,0,0,0
"Jordan","2024-02-15",0,0,0,0,0,0,0,0
"Jordan","2024-02-16",0,0,0,0,0,0,0,0
"Jordan","2024-02-17",0,0,0,0,0,0,0,0
"Jordan","2024-02-18",0,0,0,0,0,0,0,0
"Jordan","2024-02-19",0,0,0,0,0,0,0,0
"Jordan","2024-02-20",0,0,0,0,0,0,0,0
"Jordan","2024-02-21",0,0,0,0,0,0,0,0
"Jordan","2024-02-22",0,0,0,0,0,0,0,0
"Jordan","2024-02-23",0,0,0,0,0,0,0,0
"Jordan","2024-02-24",0,0,0,0,0,0,0,0
"Jordan","2024-02-25",0,0,0,0,0,0,0,0
"Jordan","2024-02-26",0,0,0,0,0,0,0,0
"Jordan","2024-02-27",0,0,0,0,0,0,0,0
"Jordan","2024-02-28",0,0,0,0,0,0,0,0
"Jordan","2024-02-29",0,0,0,0,0,0,0,0
"Jordan","2024-03-01",0,0,0,0,0,0,0,0
"Jordan","2024-03-02",0,0,0,0,0,0,0,0
"Jordan","2024-03-03",0,0,0,0,0,0,0,0
"Jordan","2024-03-04",0,0,0,0,0,0,0,0
"Jordan","2024-03-05",0,0,0,0,0,0,0,0
"Jordan","2024-03-06",0,0,0,0,0,0,0,0
"Jordan","2024-03-07",0,0,0,0,0,0,0,0
"Jordan","2024-03-08",0,0,0,0,0,0,0,0
"Jordan","2024-03-09",0,0,0,0,0,0,0,0
"Jordan","2024-03-10",0,0,0,0,0,0,0,0
"Jordan","2024-03-11",0,0,0,0,0,0,0,0
"Jordan","2024-03-12",0,0,0,0,0,0,0,0
"Jordan","2024-03-13",0,0,0,0,0,0,0,0
"Jordan","2024-03-14",0,0,0,0,0,0,0,0
"Jordan","2024-03-15",0,0,0,0,0,0,0,0
"Jordan","2024-03-16",0,0,0,0,0,0,0,0
"Jordan","2024-03-17",0,0,0,0,0,0,0,0
"Jordan","2024-03-18",0,0,0,0,0,0,0,0
"Jordan","2024-03-19",0,0,0,0,0,0,0,0
"Jordan","2024-03-20",0,0,0,0,0,0,0,0
"Jordan","2024-03-21",0,0,0,0,0,0,0,0
"Jordan","2024-03-22",0,0,0,0,0,0,0,0
"Jordan","2024-03-23",0,0,0,0,0,0,0,0
"Jordan","2024-03-24",0,0,0,0,0,0,0,0
"Jordan","2024-03-25",0,0,0,0,0,0,0,0
"Jordan","2024-03-26",0,0,0,0,0,0,0,0
"Jordan","2024-03-27",0,0,0,0,0,0,0,0
"Jordan","2024-03-28",0,0,0,0,0,0,0,0
"Jordan","2024-03-29",0,0,0,0,0,0,0,0
"Jordan","2024-03-30",0,0,0,0,0,0,0,0
"Jordan","2024-03-31",0,0,0,0,0,0,0,0
"Jordan","2024-04-01",0,0,0,0,0,0,0,0
"Jordan","2024-04-02",0,0,0,0,0,0,0,0
"Jordan","2024-04-03",0,0,0,0,0,0,0,0
"Jordan","2024-04-04",0,0,0,0,0,0,0,0
"Jordan","2024-04-05",0,0,0,0,0,0,0,0
"Jordan","2024-04-06",0,0,0,0,0,0,0,0
"Jordan","2024-04-07",0,0,0,0,0,0,0,0
"Jordan","2024-04-08",0,0,0,0,0,0,0,0
"Jordan","2024-04-09",0,0,0,0,0,0,0,0
"Jordan","2024-04-10",0,0,0,0,0,0,0,0
"Jordan","2024-04-11",0,0,0,0,0,0,0,0
"Jordan","2024-04-12",0,0,0,0,0,0,0,0
"Jordan","2024-04-13",0,0,0,0,0,0,0,0
"Jordan","2024-04-14",0,0,0,0,0,0,0,0
"Jordan","2024-04-15",0,0,0,0,0,0,0,0
"Jordan","2024-04-16",0,0,0,0,0,0,0,0
"Jordan","2024-04-17",0,0,0,0,0,0,0,0
"Jordan","2024-04-18",0,0,0,0,0,0,0,0
"Jordan","2024-04-19",0,0,0,0,0,0,0,0
"Jordan","2024-04-20",0,0,0,0,0,0,0,0
"Jordan","2024-04-21",0,0,0,0,0,0,0,0
"Jordan","2024-04-22",0,0,0,0,0,0,0,0
"Jordan","2024-04-23",0,0,0,0,0,0,0,0
"Jordan","2024-04-24",0,0,0,0,0,0,0,0
"Jordan","2024-04-25",0,0,0,0,0,0,0,0
"Jordan","2024-04-26",0,0,0,0,0,0,0,0
"Jordan","2024-04-27",0,0,0,0,0,0,0,0
"Jordan","2024-04-28",0,0,0,0,0,0,0,0
"Jordan","2024-04-29",0,0,0,0,0,0,0,0
"Jordan","2024-04-30",0,0,0,0,0,0,0,0
"Jordan","2024-05-01",0,0,0,0,0,0,0,0
"Jordan","2024-05-02",0,0,0,0,0,0,0,0
"Jordan","2024-05-03",0,0,0,0,0,0,0,0
"Jordan","2024-05-04",0,0,0,0,0,0,0,0
"Jordan","2024-05-05",0,0,0,0,0,0,0,0
"Jordan","2024-05-06",0,0,0,0,0,0,0,0
"Jordan","2024-05-07",0,0,0,0,0,0,0,0
"Jordan","2024-05-08",0,0,0,0,0,0,0,0
"Jordan","2024-05-09",0,0,0,0,0,0,0,0
"Jordan","2024-05-10",0,0,0,0,0,0,0,0
"Jordan","2024-05-11",0,0,0,0,0,0,0,0
"Jordan","2024-05-12",0,0,0,0,0,0,0,0
"Jordan","2024-05-13",0,0,0,0,0,0,0,0
"Jordan","2024-05-14",0,0,0,0,0,0,0,0
"Jordan","2024-05-15",0,0,0,0,0,0,0,0
"Jordan","2024-05-16",0,0,0,0,0,0,0,0
"Jordan","2024-05-17",0,0,0,0,0,0,0,0
"Jordan","2024-05-18",0,0,0,0,0,0,0,0
"Jordan","2024-05-19",0,0,0,0,0,0,0,0
"Jordan","2024-05-20",0,0,0,0,0,0,0,0
"Jordan","2024-05-21",0,0,0,0,0,0,0,0
"Jordan","2024-05-22",0,0,0,0,0,0,0,0
"Jordan","2024-05-23",0,0,0,0,0,0,0,0
"Jordan","2024-05-24",0,0,0,0,0,0,0,0
"Jordan","2024-05-25",0,0,0,0,0,0,0,0
"Jordan","2024-05-26",0,0,0,0,0,0,0,0
"Jordan","2024-05-27",0,0,0,0,0,0,0,0
"Jordan","2024-05-28",0,0,0,0,0,0,0,0
"Jordan","2024-05-29",0,0,0,0,0,0,0,0
"Jordan","2024-05-30",0,0,0,0,0,0,0,0
"Jordan","2024-05-31",0,0,0,0,0,0,0,0
"Jordan","2024-06-01",0,0,0,0,0,0,0,0
"Jordan","2024-06-02",0,0,0,0,0,0,0,0
"Jordan","2024-06-03",0,0,0,0,0,0,0,0
"Jordan","2024-06-04",0,0,0,0,0,0,0,0
"Jordan","2024-06-05",0,0,0,0,0,0,0,0
"Jordan","2024-06-06",0,0,0,0,0,0,0,0
"Jordan","2024-06-07",0,0,0,0,0,0,0,0
"Jordan","2024-06-08",0,0,0,0,0,0,0,0
"Jordan","2024-06-09",0,0,0,0,0,0,0,0
"Jordan","2024-06-10",0,0,0,0,0,0,0,0
"Jordan","2024-06-11",0,0,0,0,0,0,0,0
"Jordan","2024-06-12",0,0,0,0,0,0,0,0
"Jordan","2024-06-13",0,0,0,0,0,0,0,0
"Jordan","2024-06-14",0,0,0,0,0,0,0,0
"Jordan","2024-06-15",0,0,0,0,0,0,0,0
"Jordan","2024-06-16",0,0,0,0,0,0,0,0
"Jordan","2024-06-17",0,0,0,0,0,0,0,0
"Jordan","2024-06-18",0,0,0,0,0,0,0,0
"Jordan","2024-06-19",0,0,0,0,0,0,0,0
"Jordan","2024-06-20",0,0,0,0,0,0,0,0
"Jordan","2024-06-21",0,0,0,0,0,0,0,0
"Jordan","2024-06-22",0,0,0,0,0,0,0,0
"Jordan","2024-06-23",0,0,0,0,0,0,0,0
"Jordan","2024-06-24",0,0,0,0,0,0,0,0
"Jordan","2024-06-25",0,0,0,0,0,0,0,0
"Jordan","2024-06-26",0,0,0,0,0,0,0,0
"Jordan","2024-06-27",0,0,0,0,0,0,0,0
"Jordan","2024-06-28",0,0,0,0,0,0,0,0
"Jordan","2024-06-29",0,0,0,0,0,0,0,0
"Jordan","2024-06-30",0,0,0,0,0,0,0,0
"Jordan","2024-07-01",0,0,0,0,0,0,0,0
"Jordan","2024-07-02",0,0,0,0,0,0,0,0
"Jordan","2024-07-03",0,0,0,0,0,0,0,0
"Jordan","2024-07-04",0,0,0,0,0,0,0,0
"Jordan","2024-07-05",0,0,0,0,0,0,0,0
"Jordan","2024-07-06",0,0,0,0,0,0,0,0
"Jordan","2024-07-07",0,0,0,0,0,0,0,0
"Jordan","2024-07-08",0,0,0,0,0,0,0,0
"Jordan","2024-07-09",0,0,0,0,0,0,0,0
"Jordan","2024-07-10",0,0,0,0,0,0,0,0
"Jordan","2024-07-11",0,0,0,0,0,0,0,0
"Jordan","2024-07-12",0,0,0,0,0,0,0,0
"Jordan","2024-07-13",0,0,0,0,0,0,0,0
"Jordan","2024-07-14",0,0,0,0,0,0,0,0
"Jordan","2024-07-15",0,0,0,0,0,0,0,0
"Jordan","2024-07-16",0,0,0,0,0,0,0,0
"Jordan","2024-07-17",0,0,0,0,0,0,0,0
"Jordan","2024-07-18",0,0,0,0,0,0,0,0
"Jordan","2024-07-19",0,0,0,0,0,0,0,0
"Jordan","2024-07-20",0,0,0,0,0,0,0,0
"Jordan","2024-07-21",0,0,0,0,0,0,0,0
"Jordan","2024-07-22",0,0,0,0,0,0,0,0
"Jordan","2024-07-23",0,0,0,0,0,0,0,0
"Jordan","2024-07-24",0,0,0,0,0,0,0,0
"Jordan","2024-07-25",0,0,0,0,0,0,0,0
"Jordan","2024-07-26",0,0,0,0,0,0,0,0
"Jordan","2024-07-27",0,0,0,0,0,0,0,0
"Jordan","2024-07-28",0,0,0,0,0,0,0,0
"Jordan","2024-07-29",0,0,0,0,0,0,0,0
"Jordan","2024-07-30",0,0,0,0,0,0,0,0
"Jordan","2024-07-31",0,0,0,0,0,0,0,0
"Jordan","2024-08-01",0,0,0,0,0,0,0,0
"Jordan","2024-08-02",0,0,0,0,0,0,0,0
"Jordan","2024-08-03",0,0,0,0,0,0,0,0
"Jordan","2024-08-04",0,0,0,0,0,0,0,0
"Jordan","2024-08-05",0,0,0,0,0,0,0,0
"Jordan","2024-08-06",0,0,0,0,0,0,0,0
"Jordan","2024-08-07",0,0,0,0,0,0,0,0
"Jordan","2024-08-08",0,0,0,0,0,0,0,0
"Jordan","2024-08-09",0,0,0,0,0,0,0,0
"Jordan","2024-08-10",0,0,0,0,0,0,0,0
"Jordan","2024-08-11",0,0,0,0,0,0,0,0
"Jordan","2024-08-12",0,0,0,0,0,0,0,0
"Jordan","2024-08-13",0,0,0,0,0,0,0,0
"Jordan","2024-08-14",0,0,0,0,0,0,0,0
"Jordan","2024-08-15",0,0,0,0,0,0,0,0
"Jordan","2024-08-16",0,0,0,0,0,0,0,0
"Jordan","2024-08-17",0,0,0,0,0,0,0,0
"Jordan","2024-08-18",0,0,0,0,0,0,0,0
"Jordan","2024-08-19",0,0,0,0,0,0,0,0
"Jordan","2024-08-20",0,0,0,0,0,0,0,0
"Jordan","2024-08-21",0,0,0,0,0,0,0,0
"Jordan","2024-08-22",0,0,0,0,0,0,0,0
"Jordan","2024-08-23",0,0,0,0,0,0,0,0
"Jordan","2024-08-24",0,0,0,0,0,0,0,0
"Jordan","2024-08-25",0,0,0,0,0,0,0,0
"Jordan","2024-08-26",0,0,0,0,0,0,0,0
"Jordan","2024-08-27",0,0,0,0,0,0,0,0
"Jordan","2024-08-28",0,0,0,0,0,0,0,0
"Jordan","2024-08-29",0,0,0,0,0,0,0,0
"Jordan","2024-08-30",0,0,0,0,0,0,0,0
"Jordan","2024-08-31",0,0,0,0,0,0,0,0
"Jordan","2024-09-01",0,0,0,0,0,0,0,0
"Jordan","2024-09-02",0,1,1,0,1,1,0,0
"Jordan","2024-09-03",0,0,1,0,0,1,0,0
"Jordan","2024-09-04",0,0,1,0,0,1,0,0
"Jordan","2024-09-05",0,0,1,0,0,1,0,0
"Jordan","2024-09-06",0,0,1,0,0,1,0,0
"Jordan","2024-09-07",0,0,1,0,0,1,0,0
"Jordan","2024-09-08",0,0,1,0,0,1,0,0
"Jordan","2024-09-09",0,0,1,0,0,1,0,0
"Jordan","2024-09-10",0,0,1,0,0,1,0,0
"Jordan","2024-09-11",0,0,1,0,0,1,0,0
"Jordan","2024-09-12",0,0,1,0,0,1,0,0
"Jordan","2024-09-13",0,0,1,0,0,1,0,0
"Jordan","2024-09-14",0,0,1,0,0,1,0,0
"Jordan","2024-09-15",0,0,1,0,0,1,0,0
"Jordan","2024-09-16",0,0,1,0,0,1,0,0
"Jordan","2024-09-17",0,0,1,0,0,1,0,0
"Jordan","2024-09-18",0,0,1,0,0,1,0,0
"Jordan","2024-09-19",0,0,1,0,0,1,0,0
"Jordan","2024-09-20",0,0,1,0,0,1,0,0
"Jordan","2024-09-21",0,0,1,0,0,1,0,0
"Jordan","2024-09-22",0,0,1,0,0,1,0,0
"Jordan","2024-09-23",0,0,1,0,0,1,0,0
"Jordan","2024-09-24",0,0,1,0,0,1,0,0
"Jordan","2024-09-25",0,0,1,0,0,1,0,0
"Jordan","2024-09-26",0,0,1,0,0,1,0,0
"Jordan","2024-09-27",0,0,1,0,0,1,0,0
"Jordan","2024-09-28",0,0,1,0,0,1,0,0
"Jordan","2024-09-29",0,0,1,0,0,1,0,0
"Jordan","2024-09-30",0,0,1,0,0,1,0,0
"Jordan","2024-10-01",0,0,1,0,0,1,0,0
"Jordan","2024-10-02",0,0,1,0,0,1,0,0
"Jordan","2024-10-03",0,0,1,0,0,1,0,0
"Jordan","2024-10-04",0,0,1,0,0,1,0,0
"Jordan","2024-10-05",0,0,1,0,0,1,0,0
"Jordan","2024-10-06",0,0,1,0,0,1,0,0
"Jordan","2024-10-07",0,0,1,0,0,1,0,0
"Jordan","2024-10-08",0,0,1,0,0,1,0,0
"Jordan","2024-10-09",0,0,1,0,0,1,0,0
"Jordan","2024-10-10",0,0,1,0,0,1,0,0
"Jordan","2024-10-11",0,0,1,0,0,1,0,0
"Jordan","2024-10-12",0,0,1,0,0,1,0,0
"Jordan","2024-10-13",0,0,1,0,0,1,0,0
"Jordan","2024-10-14",0,0,1,0,0,1,0,0
"Jordan","2024-10-15",0,0,1,0,0,1,0,0
"Jordan","2024-10-16",0,0,1,0,0,1,0,0
"Jordan","2024-10-17",0,0,1,0,0,1,0,0
"Jordan","2024-10-18",0,0,1,0,0,1,0,0
"Jordan","2024-10-19",0,0,1,0,0,1,0,0
"Jordan","2024-10-20",0,0,1,0,0,1,0,0
"Jordan","2024-10-21",0,0,1,0,0,1,0,0
"Jordan","2024-10-22",0,0,1,0,0,1,0,0
"Jordan","2024-10-23",0,0,1,0,0,1,0,0
"Jordan","2024-10-24",0,0,1,0,0,1,0,0
"Jordan","2024-10-25",0,0,1,0,0,1,0,0
"Jordan","2024-10-26",0,0,1,0,0,1,0,0
"Jordan","2024-10-27",0,0,1,0,0,1,0,0
"Jordan","2024-10-28",0,0,1,0,0,1,0,0
"Jordan","2024-10-29",0,0,1,0,0,1,0,0
"Jordan","2024-10-30",0,0,1,0,0,1,0,0
"Jordan","2024-10-31",0,0,1,0,0,1,0,0
"Jordan","2024-11-01",0,0,1,0,0,1,0,0
"Jordan","2024-11-02",0,0,1,0,0,1,0,0
"Jordan","2024-11-03",0,0,1,0,0,1,0,0
"Jordan","2024-11-04",0,0,1,0,0,1,0,0
"Jordan","2024-11-05",0,0,1,0,0,1,0,0
"Jordan","2024-11-06",0,0,1,0,0,1,0,0
"Jordan","2024-11-07",0,0,1,0,0,1,0,0
"Jordan","2024-11-08",0,0,1,0,0,1,0,0
"Jordan","2024-11-09",0,0,1,0,0,1,0,0
"Jordan","2024-11-10",0,0,1,0,0,1,0,0
"Jordan","2024-11-11",0,0,1,0,0,1,0,0
"Jordan","2024-11-12",0,0,1,0,0,1,0,0
"Jordan","2024-11-13",0,0,1,0,0,1,0,0
"Jordan","2024-11-14",0,0,1,0,0,1,0,0
"Jordan","2024-11-15",0,0,1,0,0,1,0,0
"Jordan","2024-11-16",0,0,1,0,0,1,0,0
"Jordan","2024-11-17",0,0,1,0,0,1,0,0
"Jordan","2024-11-18",0,0,1,0,0,1,0,0
"Jordan","2024-11-19",0,0,1,0,0,1,0,0
"Jordan","2024-11-20",0,0,1,0,0,1,0,0
"Jordan","2024-11-21",0,0,1,0,0,1,0,0
"Jordan","2024-11-22",0,0,1,0,0,1,0,0
"Jordan","2024-11-23",0,0,1,0,0,1,0,0
"Jordan","2024-11-24",0,0,1,0,0,1,0,0
"Jordan","2024-11-25",0,0,1,0,0,1,0,0
"Jordan","2024-11-26",0,0,1,0,0,1,0,0
"Jordan","2024-11-27",0,0,1,0,0,1,0,0
"Jordan","2024-11-28",0,0,1,0,0,1,0,0
"Jordan","2024-11-29",0,0,1,0,0,1,0,0
"Jordan","2024-11-30",0,0,1,0,0,1,0,0
"Jordan","2024-12-01",0,0,1,0,0,1,0,0
"Jordan","2024-12-02",0,0,1,0,0,1,0,0
"Jordan","2024-12-03",0,0,1,0,0,1,0,0
"Jordan","2024-12-04",0,0,1,0,0,1,0,0
"Jordan","2024-12-05",0,0,1,0,0,1,0,0
"Jordan","2024-12-06",0,0,1,0,0,1,0,0
"Jordan","2024-12-07",0,0,1,0,0,1,0,0
"Jordan","2024-12-08",0,0,1,0,0,1,0,0
"Jordan","2024-12-09",0,0,1,0,0,1,0,0
"Jordan","2024-12-10",0,0,1,0,0,1,0,0
"Jordan","2024-12-11",0,0,1,0,0,1,0,0
"Jordan","2024-12-12",0,0,1,0,0,1,0,0
"Jordan","2024-12-13",0,0,1,0,0,1,0,0
"Jordan","2024-12-14",0,0,1,0,0,1,0,0
"Jordan","2024-12-15",0,0,1,0,0,1,0,0
"Jordan","2024-12-16",0,0,1,0,0,1,0,0
"Jordan","2024-12-17",0,0,1,0,0,1,0,0
"Jordan","2024-12-18",0,0,1,0,0,1,0,0
"Jordan","2024-12-19",0,0,1,0,0,1,0,0
"Jordan","2024-12-20",0,0,1,0,0,1,0,0
"Jordan","2024-12-21",0,0,1,0,0,1,0,0
"Jordan","2024-12-22",0,0,1,0,0,1,0,0
"Jordan","2024-12-23",0,0,1,0,0,1,0,0
"Jordan","2024-12-24",0,0,1,0,0,1,0,0
"Jordan","2024-12-25",0,0,1,0,0,1,0,0
"Jordan","2024-12-26",0,0,1,0,0,1,0,0
"Jordan","2024-12-27",0,0,1,0,0,1,0,0
"Jordan","2024-12-28",0,0,1,0,0,1,0,0
"Jordan","2024-12-29",0,0,1,0,0,1,0,0
"Jordan","2024-12-30",0,0,1,0,0,1,0,0
"Jordan","2024-12-31",0,0,1,0,0,1,0,0
"Jordan","2025-01-01",0,0,1,0,0,1,0,0
"Jordan","2025-01-02",0,0,1,0,0,1,0,0
"Jordan","2025-01-03",0,0,1,0,0,1,0,0
"Jordan","2025-01-04",0,0,1,0,0,1,0,0
"Jordan","2025-01-05",0,0,1,0,0,1,0,0
"Jordan","2025-01-06",0,0,1,0,0,1,0,0
"Jordan","2025-01-07",0,0,1,0,0,1,0,0
"Jordan","2025-01-08",0,0,1,0,0,1,0,0
"Jordan","2025-01-09",0,0,1,0,0,1,0,0
"Jordan","2025-01-10",0,0,1,0,0,1,0,0
"Jordan","2025-01-11",0,0,1,0,0,1,0,0
"Jordan","2025-01-12",0,0,1,0,0,1,0,0
"Jordan","2025-01-13",0,0,1,0,0,1,0,0
"Jordan","2025-01-14",0,0,1,0,0,1,0,0
"Jordan","2025-01-15",0,0,1,0,0,1,0,0
"Jordan","2025-01-16",0,0,1,0,0,1,0,0
"Jordan","2025-01-17",0,0,1,0,0,1,0,0
"Jordan","2025-01-18",0,0,1,0,0,1,0,0
"Jordan","2025-01-19",0,0,1,0,0,1,0,0
"Jordan","2025-01-20",0,0,1,0,0,1,0,0
"Jordan","2025-01-21",0,0,1,0,0,1,0,0
"Jordan","2025-01-22",0,0,1,0,0,1,0,0
"Jordan","2025-01-23",0,0,1,0,0,1,0,0
"Jordan","2025-01-24",0,0,1,0,0,1,0,0
"Jordan","2025-01-25",0,0,1,0,0,1,0,0
"Jordan","2025-01-26",0,0,1,0,0,1,0,0
"Jordan","2025-01-27",0,0,1,0,0,1,0,0
"Jordan","2025-01-28",0,0,1,0,0,1,0,0
"Jordan","2025-01-29",0,0,1,0,0,1,0,0
"Jordan","2025-01-30",0,0,1,0,0,1,0,0
"Jordan","2025-01-31",0,0,1,0,0,1,0,0
"Jordan","2025-02-01",0,0,1,0,0,1,0,0
"Jordan","2025-02-02",0,0,1,0,0,1,0,0
"Jordan","2025-02-03",0,0,1,0,0,1,0,0
"Kenya","2024-01-01",0,0,0,0,0,0,0,0
"Kenya","2024-01-02",0,0,0,0,0,0,0,0
"Kenya","2024-01-03",0,0,0,0,0,0,0,0
"Kenya","2024-01-04",0,0,0,0,0,0,0,0
"Kenya","2024-01-05",0,0,0,0,0,0,0,0
"Kenya","2024-01-06",0,0,0,0,0,0,0,0
"Kenya","2024-01-07",0,0,0,0,0,0,0,0
"Kenya","2024-01-08",0,0,0,0,0,0,0,0
"Kenya","2024-01-09",0,0,0,0,0,0,0,0
"Kenya","2024-01-10",0,0,0,0,0,0,0,0
"Kenya","2024-01-11",0,0,0,0,0,0,0,0
"Kenya","2024-01-12",0,0,0,0,0,0,0,0
"Kenya","2024-01-13",0,0,0,0,0,0,0,0
"Kenya","2024-01-14",0,0,0,0,0,0,0,0
"Kenya","2024-01-15",0,0,0,0,0,0,0,0
"Kenya","2024-01-16",0,0,0,0,0,0,0,0
"Kenya","2024-01-17",0,0,0,0,0,0,0,0
"Kenya","2024-01-18",0,0,0,0,0,0,0,0
"Kenya","2024-01-19",0,0,0,0,0,0,0,0
"Kenya","2024-01-20",0,0,0,0,0,0,0,0
"Kenya","2024-01-21",0,0,0,0,0,0,0,0
"Kenya","2024-01-22",0,0,0,0,0,0,0,0
"Kenya","2024-01-23",0,0,0,0,0,0,0,0
"Kenya","2024-01-24",0,0,0,0,0,0,0,0
"Kenya","2024-01-25",0,0,0,0,0,0,0,0
"Kenya","2024-01-26",0,0,0,0,0,0,0,0
"Kenya","2024-01-27",0,0,0,0,0,0,0,0
"Kenya","2024-01-28",0,0,0,0,0,0,0,0
"Kenya","2024-01-29",0,0,0,0,0,0,0,0
"Kenya","2024-01-30",0,0,0,0,0,0,0,0
"Kenya","2024-01-31",0,0,0,0,0,0,0,0
"Kenya","2024-02-01",0,0,0,0,0,0,0,0
"Kenya","2024-02-02",0,0,0,0,0,0,0,0
"Kenya","2024-02-03",0,0,0,0,0,0,0,0
"Kenya","2024-02-04",0,0,0,0,0,0,0,0
"Kenya","2024-02-05",0,0,0,0,0,0,0,0
"Kenya","2024-02-06",0,0,0,0,0,0,0,0
"Kenya","2024-02-07",0,0,0,0,0,0,0,0
"Kenya","2024-02-08",0,0,0,0,0,0,0,0
"Kenya","2024-02-09",0,0,0,0,0,0,0,0
"Kenya","2024-02-10",0,0,0,0,0,0,0,0
"Kenya","2024-02-11",0,0,0,0,0,0,0,0
"Kenya","2024-02-12",0,0,0,0,0,0,0,0
"Kenya","2024-02-13",0,0,0,0,0,0,0,0
"Kenya","2024-02-14",0,0,0,0,0,0,0,0
"Kenya","2024-02-15",0,0,0,0,0,0,0,0
"Kenya","2024-02-16",0,0,0,0,0,0,0,0
"Kenya","2024-02-17",0,0,0,0,0,0,0,0
"Kenya","2024-02-18",0,0,0,0,0,0,0,0
"Kenya","2024-02-19",0,0,0,0,0,0,0,0
"Kenya","2024-02-20",0,0,0,0,0,0,0,0
"Kenya","2024-02-21",0,0,0,0,0,0,0,0
"Kenya","2024-02-22",0,0,0,0,0,0,0,0
"Kenya","2024-02-23",0,0,0,0,0,0,0,0
"Kenya","2024-02-24",0,0,0,0,0,0,0,0
"Kenya","2024-02-25",0,0,0,0,0,0,0,0
"Kenya","2024-02-26",0,0,0,0,0,0,0,0
"Kenya","2024-02-27",0,0,0,0,0,0,0,0
"Kenya","2024-02-28",0,0,0,0,0,0,0,0
"Kenya","2024-02-29",0,0,0,0,0,0,0,0
"Kenya","2024-03-01",0,0,0,0,0,0,0,0
"Kenya","2024-03-02",0,0,0,0,0,0,0,0
"Kenya","2024-03-03",0,0,0,0,0,0,0,0
"Kenya","2024-03-04",0,0,0,0,0,0,0,0
"Kenya","2024-03-05",0,0,0,0,0,0,0,0
"Kenya","2024-03-06",0,0,0,0,0,0,0,0
"Kenya","2024-03-07",0,0,0,0,0,0,0,0
"Kenya","2024-03-08",0,0,0,0,0,0,0,0
"Kenya","2024-03-09",0,0,0,0,0,0,0,0
"Kenya","2024-03-10",0,0,0,0,0,0,0,0
"Kenya","2024-03-11",0,0,0,0,0,0,0,0
"Kenya","2024-03-12",0,0,0,0,0,0,0,0
"Kenya","2024-03-13",0,0,0,0,0,0,0,0
"Kenya","2024-03-14",0,0,0,0,0,0,0,0
"Kenya","2024-03-15",0,0,0,0,0,0,0,0
"Kenya","2024-03-16",0,0,0,0,0,0,0,0
"Kenya","2024-03-17",0,0,0,0,0,0,0,0
"Kenya","2024-03-18",0,0,0,0,0,0,0,0
"Kenya","2024-03-19",0,0,0,0,0,0,0,0
"Kenya","2024-03-20",0,0,0,0,0,0,0,0
"Kenya","2024-03-21",0,0,0,0,0,0,0,0
"Kenya","2024-03-22",0,0,0,0,0,0,0,0
"Kenya","2024-03-23",0,0,0,0,0,0,0,0
"Kenya","2024-03-24",0,0,0,0,0,0,0,0
"Kenya","2024-03-25",0,0,0,0,0,0,0,0
"Kenya","2024-03-26",0,0,0,0,0,0,0,0
"Kenya","2024-03-27",0,0,0,0,0,0,0,0
"Kenya","2024-03-28",0,0,0,0,0,0,0,0
"Kenya","2024-03-29",0,0,0,0,0,0,0,0
"Kenya","2024-03-30",0,0,0,0,0,0,0,0
"Kenya","2024-03-31",0,0,0,0,0,0,0,0
"Kenya","2024-04-01",0,0,0,0,0,0,0,0
"Kenya","2024-04-02",0,0,0,0,0,0,0,0
"Kenya","2024-04-03",0,0,0,0,0,0,0,0
"Kenya","2024-04-04",0,0,0,0,0,0,0,0
"Kenya","2024-04-05",0,0,0,0,0,0,0,0
"Kenya","2024-04-06",0,0,0,0,0,0,0,0
"Kenya","2024-04-07",0,0,0,0,0,0,0,0
"Kenya","2024-04-08",0,0,0,0,0,0,0,0
"Kenya","2024-04-09",0,0,0,0,0,0,0,0
"Kenya","2024-04-10",0,0,0,0,0,0,0,0
"Kenya","2024-04-11",0,0,0,0,0,0,0,0
"Kenya","2024-04-12",0,0,0,0,0,0,0,0
"Kenya","2024-04-13",0,0,0,0,0,0,0,0
"Kenya","2024-04-14",0,0,0,0,0,0,0,0
"Kenya","2024-04-15",0,0,0,0,0,0,0,0
"Kenya","2024-04-16",0,0,0,0,0,0,0,0
"Kenya","2024-04-17",0,0,0,0,0,0,0,0
"Kenya","2024-04-18",0,0,0,0,0,0,0,0
"Kenya","2024-04-19",0,0,0,0,0,0,0,0
"Kenya","2024-04-20",0,0,0,0,0,0,0,0
"Kenya","2024-04-21",0,0,0,0,0,0,0,0
"Kenya","2024-04-22",0,0,0,0,0,0,0,0
"Kenya","2024-04-23",0,0,0,0,0,0,0,0
"Kenya","2024-04-24",0,0,0,0,0,0,0,0
"Kenya","2024-04-25",0,0,0,0,0,0,0,0
"Kenya","2024-04-26",0,0,0,0,0,0,0,0
"Kenya","2024-04-27",0,0,0,0,0,0,0,0
"Kenya","2024-04-28",0,0,0,0,0,0,0,0
"Kenya","2024-04-29",0,0,0,0,0,0,0,0
"Kenya","2024-04-30",0,0,0,0,0,0,0,0
"Kenya","2024-05-01",0,0,0,0,0,0,0,0
"Kenya","2024-05-02",0,0,0,0,0,0,0,0
"Kenya","2024-05-03",0,0,0,0,0,0,0,0
"Kenya","2024-05-04",0,0,0,0,0,0,0,0
"Kenya","2024-05-05",0,0,0,0,0,0,0,0
"Kenya","2024-05-06",0,0,0,0,0,0,0,0
"Kenya","2024-05-07",0,0,0,0,0,0,0,0
"Kenya","2024-05-08",0,0,0,0,0,0,0,0
"Kenya","2024-05-09",0,0,0,0,0,0,0,0
"Kenya","2024-05-10",0,0,0,0,0,0,0,0
"Kenya","2024-05-11",0,0,0,0,0,0,0,0
"Kenya","2024-05-12",0,0,0,0,0,0,0,0
"Kenya","2024-05-13",0,0,0,0,0,0,0,0
"Kenya","2024-05-14",0,0,0,0,0,0,0,0
"Kenya","2024-05-15",0,0,0,0,0,0,0,0
"Kenya","2024-05-16",0,0,0,0,0,0,0,0
"Kenya","2024-05-17",0,0,0,0,0,0,0,0
"Kenya","2024-05-18",0,0,0,0,0,0,0,0
"Kenya","2024-05-19",0,0,0,0,0,0,0,0
"Kenya","2024-05-20",0,0,0,0,0,0,0,0
"Kenya","2024-05-21",0,0,0,0,0,0,0,0
"Kenya","2024-05-22",0,0,0,0,0,0,0,0
"Kenya","2024-05-23",0,0,0,0,0,0,0,0
"Kenya","2024-05-24",0,0,0,0,0,0,0,0
"Kenya","2024-05-25",0,0,0,0,0,0,0,0
"Kenya","2024-05-26",0,0,0,0,0,0,0,0
"Kenya","2024-05-27",0,0,0,0,0,0,0,0
"Kenya","2024-05-28",0,0,0,0,0,0,0,0
"Kenya","2024-05-29",0,0,0,0,0,0,0,0
"Kenya","2024-05-30",0,0,0,0,0,0,0,0
"Kenya","2024-05-31",0,0,0,0,0,0,0,0
"Kenya","2024-06-01",0,0,0,0,0,0,0,0
"Kenya","2024-06-02",0,0,0,0,0,0,0,0
"Kenya","2024-06-03",0,0,0,0,0,0,0,0
"Kenya","2024-06-04",0,0,0,0,0,0,0,0
"Kenya","2024-06-05",0,0,0,0,0,0,0,0
"Kenya","2024-06-06",0,0,0,0,0,0,0,0
"Kenya","2024-06-07",0,0,0,0,0,0,0,0
"Kenya","2024-06-08",0,0,0,0,0,0,0,0
"Kenya","2024-06-09",0,0,0,0,0,0,0,0
"Kenya","2024-06-10",0,0,0,0,0,0,0,0
"Kenya","2024-06-11",0,0,0,0,0,0,0,0
"Kenya","2024-06-12",0,0,0,0,0,0,0,0
"Kenya","2024-06-13",0,0,0,0,0,0,0,0
"Kenya","2024-06-14",0,0,0,0,0,0,0,0
"Kenya","2024-06-15",0,0,0,0,0,0,0,0
"Kenya","2024-06-16",0,0,0,0,0,0,0,0
"Kenya","2024-06-17",0,0,0,0,0,0,0,0
"Kenya","2024-06-18",0,0,0,0,0,0,0,0
"Kenya","2024-06-19",0,0,0,0,0,0,0,0
"Kenya","2024-06-20",0,0,0,0,0,0,0,0
"Kenya","2024-06-21",0,0,0,0,0,0,0,0
"Kenya","2024-06-22",0,0,0,0,0,0,0,0
"Kenya","2024-06-23",0,0,0,0,0,0,0,0
"Kenya","2024-06-24",0,0,0,0,0,0,0,0
"Kenya","2024-06-25",0,0,0,0,0,0,0,0
"Kenya","2024-06-26",0,0,0,0,0,0,0,0
"Kenya","2024-06-27",0,0,0,0,0,0,0,0
"Kenya","2024-06-28",0,0,0,0,0,0,0,0
"Kenya","2024-06-29",0,0,0,0,0,0,0,0
"Kenya","2024-06-30",0,0,0,0,0,0,0,0
"Kenya","2024-07-01",0,0,0,0,0,0,0,0
"Kenya","2024-07-02",0,0,0,0,0,0,0,0
"Kenya","2024-07-03",0,0,0,0,0,0,0,0
"Kenya","2024-07-04",0,0,0,0,0,0,0,0
"Kenya","2024-07-05",0,0,0,0,0,0,0,0
"Kenya","2024-07-06",0,0,0,0,0,0,0,0
"Kenya","2024-07-07",0,0,0,0,0,0,0,0
"Kenya","2024-07-08",0,0,0,0,0,0,0,0
"Kenya","2024-07-09",0,0,0,0,0,0,0,0
"Kenya","2024-07-10",0,0,0,0,0,0,0,0
"Kenya","2024-07-11",0,0,0,0,0,0,0,0
"Kenya","2024-07-12",0,0,0,0,0,0,0,0
"Kenya","2024-07-13",0,0,0,0,0,0,0,0
"Kenya","2024-07-14",0,0,0,0,0,0,0,0
"Kenya","2024-07-15",0,0,0,0,0,0,0,0
"Kenya","2024-07-16",0,0,0,0,0,0,0,0
"Kenya","2024-07-17",0,0,0,0,0,0,0,0
"Kenya","2024-07-18",0,0,0,0,0,0,0,0
"Kenya","2024-07-19",0,0,0,0,0,0,0,0
"Kenya","2024-07-20",0,0,0,0,0,0,0,0
"Kenya","2024-07-21",0,0,0,0,0,0,0,0
"Kenya","2024-07-22",0,0,0,0,0,0,0,0
"Kenya","2024-07-23",0,0,0,0,0,0,0,0
"Kenya","2024-07-24",0,0,0,0,0,0,0,0
"Kenya","2024-07-25",0,0,0,0,0,0,0,0
"Kenya","2024-07-26",0,0,0,0,0,0,0,0
"Kenya","2024-07-27",0,0,0,0,0,0,0,0
"Kenya","2024-07-28",0,1,1,0,1,1,0,0
"Kenya","2024-07-29",0,0,1,0,0,1,0,0
"Kenya","2024-07-30",0,0,1,0,0,1,0,0
"Kenya","2024-07-31",0,0,1,0,0,1,0,0
"Kenya","2024-08-01",0,0,1,0,0,1,0,0
"Kenya","2024-08-02",0,0,1,0,0,1,0,0
"Kenya","2024-08-03",0,0,1,0,0,1,0,0
"Kenya","2024-08-04",0,0,1,0,0,1,0,0
"Kenya","2024-08-05",0,0,1,0,0,1,0,0
"Kenya","2024-08-06",0,0,1,0,0,1,0,0
"Kenya","2024-08-07",0,0,1,0,0,1,0,0
"Kenya","2024-08-08",0,0,1,0,0,1,0,0
"Kenya","2024-08-09",0,0,1,0,0,1,0,0
"Kenya","2024-08-10",0,0,1,0,0,1,0,0
"Kenya","2024-08-11",0,0,1,0,0,1,0,0
"Kenya","2024-08-12",0,0,1,0,1,2,0,0
"Kenya","2024-08-13",0,0,1,0,0,2,0,0
"Kenya","2024-08-14",0,0,1,0,0,2,0,0
"Kenya","2024-08-15",0,0,1,0,0,2,0,0
"Kenya","2024-08-16",0,0,1,0,0,2,0,0
"Kenya","2024-08-17",0,0,1,0,0,2,0,0
"Kenya","2024-08-18",0,0,1,0,0,2,0,0
"Kenya","2024-08-19",0,0,1,0,0,2,0,0
"Kenya","2024-08-20",0,0,1,0,0,2,0,0
"Kenya","2024-08-21",0,0,1,0,0,2,0,0
"Kenya","2024-08-22",0,0,1,0,0,2,0,0
"Kenya","2024-08-23",0,0,1,0,0,2,0,0
"Kenya","2024-08-24",0,0,1,0,0,2,0,0
"Kenya","2024-08-25",0,1,2,0,0,2,0,0
"Kenya","2024-08-26",0,0,2,0,0,2,0,0
"Kenya","2024-08-27",0,0,2,0,1,3,0,0
"Kenya","2024-08-28",0,0,2,0,0,3,0,0
"Kenya","2024-08-29",0,0,2,0,0,3,0,0
"Kenya","2024-08-30",0,0,2,0,0,3,0,0
"Kenya","2024-08-31",0,0,2,0,1,4,0,0
"Kenya","2024-09-01",0,2,4,0,0,4,0,0
"Kenya","2024-09-02",0,0,4,0,0,4,0,0
"Kenya","2024-09-03",0,0,4,0,0,4,0,0
"Kenya","2024-09-04",0,0,4,0,0,4,0,0
"Kenya","2024-09-05",0,0,4,0,1,5,0,0
"Kenya","2024-09-06",0,0,4,0,0,5,0,0
"Kenya","2024-09-07",0,0,4,0,0,5,0,0
"Kenya","2024-09-08",110,1,5,110,0,5,110,110
"Kenya","2024-09-09",0,0,5,110,0,5,4,114
"Kenya","2024-09-10",0,0,5,110,0,5,4,118
"Kenya","2024-09-11",0,0,5,110,0,5,4,122
"Kenya","2024-09-12",0,0,5,110,1,6,4,126
"Kenya","2024-09-13",0,0,5,110,0,6,5,131
"Kenya","2024-09-14",0,0,5,110,0,6,4,135
"Kenya","2024-09-15",0,0,5,110,0,6,4,139
"Kenya","2024-09-16",0,0,5,110,0,6,4,143
"Kenya","2024-09-17",0,0,5,110,0,6,4,147
"Kenya","2024-09-18",0,0,5,110,1,7,4,151
"Kenya","2024-09-19",0,0,5,110,0,7,4,155
"Kenya","2024-09-20",0,0,5,110,0,7,4,159
"Kenya","2024-09-21",0,0,5,110,0,7,5,164
"Kenya","2024-09-22",0,0,5,110,0,7,4,168
"Kenya","2024-09-23",0,0,5,110,0,7,4,172
"Kenya","2024-09-24",0,0,5,110,0,7,4,176
"Kenya","2024-09-25",0,0,5,110,1,8,4,180
"Kenya","2024-09-26",0,0,5,110,0,8,4,184
"Kenya","2024-09-27",0,0,5,110,0,8,4,188
"Kenya","2024-09-28",0,3,8,110,0,8,4,192
"Kenya","2024-09-29",0,0,8,110,0,8,4,196
"Kenya","2024-09-30",0,0,8,110,1,9,5,201
"Kenya","2024-10-01",0,0,8,110,1,10,4,205
"Kenya","2024-10-02",0,0,8,110,0,10,4,209
"Kenya","2024-10-03",0,0,8,110,0,10,4,213
"Kenya","2024-10-04",107,0,8,217,1,11,4,217
"Kenya","2024-10-05",0,0,8,217,1,12,1,218
"Kenya","2024-10-06",0,4,12,217,0,12,1,219
"Kenya","2024-10-07",0,0,12,217,0,12,0,219
"Kenya","2024-10-08",0,0,12,217,0,12,1,220
"Kenya","2024-10-09",0,0,12,217,0,12,1,221
"Kenya","2024-10-10",0,0,12,217,1,13,1,222
"Kenya","2024-10-11",0,0,12,217,0,13,1,223
"Kenya","2024-10-12",0,0,12,217,0,13,0,223
"Kenya","2024-10-13",0,1,13,217,0,13,1,224
"Kenya","2024-10-14",8,0,13,225,0,13,1,225
"Kenya","2024-10-15",0,0,13,225,0,13,1,226
"Kenya","2024-10-16",0,0,13,225,0,13,1,227
"Kenya","2024-10-17",0,0,13,225,1,14,0,227
"Kenya","2024-10-18",0,0,13,225,0,14,1,228
"Kenya","2024-10-19",0,0,13,225,0,14,1,229
"Kenya","2024-10-20",5,1,14,230,0,14,1,230
"Kenya","2024-10-21",0,0,14,230,0,14,0,230
"Kenya","2024-10-22",0,0,14,230,0,14,0,230
"Kenya","2024-10-23",0,0,14,230,0,14,0,230
"Kenya","2024-10-24",0,0,14,230,1,15,0,230
"Kenya","2024-10-25",0,0,14,230,0,15,0,230
"Kenya","2024-10-26",0,0,14,230,0,15,0,230
"Kenya","2024-10-27",0,0,14,230,0,15,0,230
"Kenya","2024-10-28",0,0,14,230,0,15,0,230
"Kenya","2024-10-29",0,0,14,230,0,15,0,230
"Kenya","2024-10-30",0,0,14,230,0,15,0,230
"Kenya","2024-10-31",0,0,14,230,1,16,0,230
"Kenya","2024-11-01",0,0,14,230,0,16,0,230
"Kenya","2024-11-02",0,0,14,230,0,16,0,230
"Kenya","2024-11-03",0,0,14,230,0,16,0,230
"Kenya","2024-11-04",0,0,14,230,0,16,0,230
"Kenya","2024-11-05",0,0,14,230,0,16,0,230
"Kenya","2024-11-06",0,0,14,230,0,16,0,230
"Kenya","2024-11-07",0,0,14,230,1,17,0,230
"Kenya","2024-11-08",0,0,14,230,0,17,0,230
"Kenya","2024-11-09",0,0,14,230,0,17,0,230
"Kenya","2024-11-10",0,3,17,230,0,17,0,230
"Kenya","2024-11-11",0,0,17,230,0,17,0,230
"Kenya","2024-11-12",0,0,17,230,0,17,0,230
"Kenya","2024-11-13",0,0,17,230,0,17,0,230
"Kenya","2024-11-14",0,0,17,230,1,18,0,230
"Kenya","2024-11-15",0,0,17,230,0,18,0,230
"Kenya","2024-11-16",0,0,17,230,0,18,0,230
"Kenya","2024-11-17",0,0,17,230,0,18,0,230
"Kenya","2024-11-18",0,0,17,230,0,18,0,230
"Kenya","2024-11-19",0,0,17,230,0,18,0,230
"Kenya","2024-11-20",0,0,17,230,0,18,0,230
"Kenya","2024-11-21",0,0,17,230,1,19,0,230
"Kenya","2024-11-22",0,0,17,230,0,19,0,230
"Kenya","2024-11-23",0,0,17,230,0,19,0,230
"Kenya","2024-11-24",0,2,19,230,0,19,0,230
"Kenya","2024-11-25",0,0,19,230,1,20,0,230
"Kenya","2024-11-26",0,0,19,230,0,20,0,230
"Kenya","2024-11-27",0,0,19,230,1,21,0,230
"Kenya","2024-11-28",0,0,19,230,0,21,0,230
"Kenya","2024-11-29",0,0,19,230,1,22,0,230
"Kenya","2024-11-30",0,0,19,230,0,22,0,230
"Kenya","2024-12-01",0,4,23,230,1,23,0,230
"Kenya","2024-12-02",0,0,23,230,1,24,0,230
"Kenya","2024-12-03",0,0,23,230,0,24,0,230
"Kenya","2024-12-04",0,0,23,230,1,25,0,230
"Kenya","2024-12-05",0,0,23,230,1,26,0,230
"Kenya","2024-12-06",0,0,23,230,1,27,0,230
"Kenya","2024-12-07",0,0,23,230,0,27,0,230
"Kenya","2024-12-08",0,5,28,230,1,28,0,230
"Kenya","2024-12-09",0,0,28,230,0,28,0,230
"Kenya","2024-12-10",0,0,28,230,0,28,0,230
"Kenya","2024-12-11",0,0,28,230,0,28,0,230
"Kenya","2024-12-12",0,0,28,230,1,29,0,230
"Kenya","2024-12-13",0,0,28,230,0,29,0,230
"Kenya","2024-12-14",0,0,28,230,0,29,0,230
"Kenya","2024-12-15",0,1,29,230,0,29,0,230
"Kenya","2024-12-16",0,0,29,230,0,29,0,230
"Kenya","2024-12-17",0,0,29,230,1,30,0,230
"Kenya","2024-12-18",0,0,29,230,0,30,0,230
"Kenya","2024-12-19",0,0,29,230,0,30,0,230
"Kenya","2024-12-20",0,0,29,230,0,30,0,230
"Kenya","2024-12-21",0,0,29,230,1,31,0,230
"Kenya","2024-12-22",0,0,29,230,0,31,0,230
"Kenya","2024-12-23",0,0,29,230,0,31,0,230
"Kenya","2024-12-24",0,0,29,230,1,32,0,230
"Kenya","2024-12-25",0,0,29,230,0,32,0,230
"Kenya","2024-12-26",0,0,29,230,0,32,0,230
"Kenya","2024-12-27",0,0,29,230,0,32,0,230
"Kenya","2024-12-28",0,0,29,230,1,33,0,230
"Kenya","2024-12-29",0,4,33,230,0,33,0,230
"Kenya","2024-12-30",0,0,33,230,0,33,0,230
"Kenya","2024-12-31",0,0,33,230,0,33,0,230
"Kenya","2025-01-01",0,0,33,230,0,33,0,230
"Kenya","2025-01-02",0,0,33,230,1,34,0,230
"Kenya","2025-01-03",0,0,33,230,0,34,0,230
"Kenya","2025-01-04",0,0,33,230,0,34,0,230
"Kenya","2025-01-05",0,1,34,230,0,34,0,230
"Kenya","2025-01-06",0,0,34,230,0,34,0,230
"Kenya","2025-01-07",0,0,34,230,0,34,0,230
"Kenya","2025-01-08",0,0,34,230,1,35,0,230
"Kenya","2025-01-09",0,0,34,230,0,35,0,230
"Kenya","2025-01-10",0,0,34,230,0,35,0,230
"Kenya","2025-01-11",0,0,34,230,0,35,0,230
"Kenya","2025-01-12",0,0,34,230,0,35,0,230
"Kenya","2025-01-13",0,0,34,230,0,35,0,230
"Kenya","2025-01-14",0,0,34,230,1,36,0,230
"Kenya","2025-01-15",0,0,34,230,0,36,0,230
"Kenya","2025-01-16",0,2,36,230,0,36,0,230
"Kenya","2025-01-17",0,0,36,230,0,36,0,230
"Kenya","2025-01-18",0,0,36,230,0,36,0,230
"Kenya","2025-01-19",0,0,36,230,0,36,0,230
"Kenya","2025-01-20",0,0,36,230,0,36,0,230
"Kenya","2025-01-21",0,0,36,230,0,36,0,230
"Kenya","2025-01-22",0,0,36,230,0,36,0,230
"Kenya","2025-01-23",0,0,36,230,0,36,0,230
"Kenya","2025-01-24",0,0,36,230,0,36,0,230
"Kenya","2025-01-25",0,0,36,230,0,36,0,230
"Kenya","2025-01-26",0,0,36,230,0,36,0,230
"Kenya","2025-01-27",0,0,36,230,0,36,0,230
"Kenya","2025-01-28",0,0,36,230,0,36,0,230
"Kenya","2025-01-29",0,0,36,230,0,36,0,230
"Kenya","2025-01-30",0,0,36,230,0,36,0,230
"Kenya","2025-01-31",0,0,36,230,0,36,0,230
"Kenya","2025-02-01",0,0,36,230,0,36,0,230
"Kenya","2025-02-02",0,0,36,230,0,36,0,230
"Kenya","2025-02-03",0,0,36,230,0,36,0,230
"Kosovo","2024-01-01",0,0,0,0,0,0,0,0
"Kosovo","2024-01-02",0,0,0,0,0,0,0,0
"Kosovo","2024-01-03",0,0,0,0,0,0,0,0
"Kosovo","2024-01-04",0,0,0,0,0,0,0,0
"Kosovo","2024-01-05",0,0,0,0,0,0,0,0
"Kosovo","2024-01-06",0,0,0,0,0,0,0,0
"Kosovo","2024-01-07",0,0,0,0,0,0,0,0
"Kosovo","2024-01-08",0,0,0,0,0,0,0,0
"Kosovo","2024-01-09",0,0,0,0,0,0,0,0
"Kosovo","2024-01-10",0,0,0,0,0,0,0,0
"Kosovo","2024-01-11",0,0,0,0,0,0,0,0
"Kosovo","2024-01-12",0,0,0,0,0,0,0,0
"Kosovo","2024-01-13",0,0,0,0,0,0,0,0
"Kosovo","2024-01-14",0,0,0,0,0,0,0,0
"Kosovo","2024-01-15",0,0,0,0,0,0,0,0
"Kosovo","2024-01-16",0,0,0,0,0,0,0,0
"Kosovo","2024-01-17",0,0,0,0,0,0,0,0
"Kosovo","2024-01-18",0,0,0,0,0,0,0,0
"Kosovo","2024-01-19",0,0,0,0,0,0,0,0
"Kosovo","2024-01-20",0,0,0,0,0,0,0,0
"Kosovo","2024-01-21",0,0,0,0,0,0,0,0
"Kosovo","2024-01-22",0,0,0,0,0,0,0,0
"Kosovo","2024-01-23",0,0,0,0,0,0,0,0
"Kosovo","2024-01-24",0,0,0,0,0,0,0,0
"Kosovo","2024-01-25",0,0,0,0,0,0,0,0
"Kosovo","2024-01-26",0,0,0,0,0,0,0,0
"Kosovo","2024-01-27",0,0,0,0,0,0,0,0
"Kosovo","2024-01-28",0,0,0,0,0,0,0,0
"Kosovo","2024-01-29",0,0,0,0,0,0,0,0
"Kosovo","2024-01-30",0,0,0,0,0,0,0,0
"Kosovo","2024-01-31",0,0,0,0,0,0,0,0
"Kosovo","2024-02-01",0,0,0,0,0,0,0,0
"Kosovo","2024-02-02",0,0,0,0,0,0,0,0
"Kosovo","2024-02-03",0,0,0,0,0,0,0,0
"Kosovo","2024-02-04",0,0,0,0,0,0,0,0
"Kosovo","2024-02-05",0,0,0,0,0,0,0,0
"Kosovo","2024-02-06",0,0,0,0,0,0,0,0
"Kosovo","2024-02-07",0,0,0,0,0,0,0,0
"Kosovo","2024-02-08",0,0,0,0,0,0,0,0
"Kosovo","2024-02-09",0,0,0,0,0,0,0,0
"Kosovo","2024-02-10",0,0,0,0,0,0,0,0
"Kosovo","2024-02-11",0,0,0,0,0,0,0,0
"Kosovo","2024-02-12",0,0,0,0,0,0,0,0
"Kosovo","2024-02-13",0,0,0,0,0,0,0,0
"Kosovo","2024-02-14",0,0,0,0,0,0,0,0
"Kosovo","2024-02-15",0,0,0,0,0,0,0,0
"Kosovo","2024-02-16",0,0,0,0,0,0,0,0
"Kosovo","2024-02-17",0,0,0,0,0,0,0,0
"Kosovo","2024-02-18",0,0,0,0,0,0,0,0
"Kosovo","2024-02-19",0,0,0,0,0,0,0,0
"Kosovo","2024-02-20",0,0,0,0,0,0,0,0
"Kosovo","2024-02-21",0,0,0,0,0,0,0,0
"Kosovo","2024-02-22",0,0,0,0,0,0,0,0
"Kosovo","2024-02-23",0,0,0,0,0,0,0,0
"Kosovo","2024-02-24",0,0,0,0,0,0,0,0
"Kosovo","2024-02-25",0,0,0,0,0,0,0,0
"Kosovo","2024-02-26",0,0,0,0,0,0,0,0
"Kosovo","2024-02-27",0,0,0,0,0,0,0,0
"Kosovo","2024-02-28",0,0,0,0,0,0,0,0
"Kosovo","2024-02-29",0,0,0,0,0,0,0,0
"Kosovo","2024-03-01",0,0,0,0,0,0,0,0
"Kosovo","2024-03-02",0,0,0,0,0,0,0,0
"Kosovo","2024-03-03",0,0,0,0,0,0,0,0
"Kosovo","2024-03-04",0,0,0,0,0,0,0,0
"Kosovo","2024-03-05",0,0,0,0,0,0,0,0
"Kosovo","2024-03-06",0,0,0,0,0,0,0,0
"Kosovo","2024-03-07",0,0,0,0,0,0,0,0
"Kosovo","2024-03-08",0,0,0,0,0,0,0,0
"Kosovo","2024-03-09",0,0,0,0,0,0,0,0
"Kosovo","2024-03-10",0,0,0,0,0,0,0,0
"Kosovo","2024-03-11",0,0,0,0,0,0,0,0
"Kosovo","2024-03-12",0,0,0,0,0,0,0,0
"Kosovo","2024-03-13",0,0,0,0,0,0,0,0
"Kosovo","2024-03-14",0,0,0,0,0,0,0,0
"Kosovo","2024-03-15",0,0,0,0,0,0,0,0
"Kosovo","2024-03-16",0,0,0,0,0,0,0,0
"Kosovo","2024-03-17",0,0,0,0,0,0,0,0
"Kosovo","2024-03-18",0,0,0,0,0,0,0,0
"Kosovo","2024-03-19",0,0,0,0,0,0,0,0
"Kosovo","2024-03-20",0,0,0,0,0,0,0,0
"Kosovo","2024-03-21",0,0,0,0,0,0,0,0
"Kosovo","2024-03-22",0,0,0,0,0,0,0,0
"Kosovo","2024-03-23",0,0,0,0,0,0,0,0
"Kosovo","2024-03-24",0,0,0,0,0,0,0,0
"Kosovo","2024-03-25",0,0,0,0,0,0,0,0
"Kosovo","2024-03-26",0,0,0,0,0,0,0,0
"Kosovo","2024-03-27",0,0,0,0,0,0,0,0
"Kosovo","2024-03-28",0,0,0,0,0,0,0,0
"Kosovo","2024-03-29",0,0,0,0,0,0,0,0
"Kosovo","2024-03-30",0,0,0,0,0,0,0,0
"Kosovo","2024-03-31",0,0,0,0,0,0,0,0
"Kosovo","2024-04-01",0,0,0,0,0,0,0,0
"Kosovo","2024-04-02",0,0,0,0,0,0,0,0
"Kosovo","2024-04-03",0,0,0,0,0,0,0,0
"Kosovo","2024-04-04",0,0,0,0,0,0,0,0
"Kosovo","2024-04-05",0,0,0,0,0,0,0,0
"Kosovo","2024-04-06",0,0,0,0,0,0,0,0
"Kosovo","2024-04-07",0,0,0,0,0,0,0,0
"Kosovo","2024-04-08",0,0,0,0,0,0,0,0
"Kosovo","2024-04-09",0,0,0,0,0,0,0,0
"Kosovo","2024-04-10",0,0,0,0,0,0,0,0
"Kosovo","2024-04-11",0,0,0,0,0,0,0,0
"Kosovo","2024-04-12",0,0,0,0,0,0,0,0
"Kosovo","2024-04-13",0,0,0,0,0,0,0,0
"Kosovo","2024-04-14",0,0,0,0,0,0,0,0
"Kosovo","2024-04-15",0,0,0,0,0,0,0,0
"Kosovo","2024-04-16",0,0,0,0,0,0,0,0
"Kosovo","2024-04-17",0,0,0,0,0,0,0,0
"Kosovo","2024-04-18",0,0,0,0,0,0,0,0
"Kosovo","2024-04-19",0,0,0,0,0,0,0,0
"Kosovo","2024-04-20",0,0,0,0,0,0,0,0
"Kosovo","2024-04-21",0,0,0,0,0,0,0,0
"Kosovo","2024-04-22",0,0,0,0,0,0,0,0
"Kosovo","2024-04-23",0,0,0,0,0,0,0,0
"Kosovo","2024-04-24",0,0,0,0,0,0,0,0
"Kosovo","2024-04-25",0,0,0,0,0,0,0,0
"Kosovo","2024-04-26",0,0,0,0,0,0,0,0
"Kosovo","2024-04-27",0,0,0,0,0,0,0,0
"Kosovo","2024-04-28",0,0,0,0,0,0,0,0
"Kosovo","2024-04-29",0,0,0,0,0,0,0,0
"Kosovo","2024-04-30",0,0,0,0,0,0,0,0
"Kosovo","2024-05-01",0,0,0,0,0,0,0,0
"Kosovo","2024-05-02",0,0,0,0,0,0,0,0
"Kosovo","2024-05-03",0,0,0,0,0,0,0,0
"Kosovo","2024-05-04",0,0,0,0,0,0,0,0
"Kosovo","2024-05-05",0,0,0,0,0,0,0,0
"Kosovo","2024-05-06",0,0,0,0,0,0,0,0
"Kosovo","2024-05-07",0,0,0,0,0,0,0,0
"Kosovo","2024-05-08",0,0,0,0,0,0,0,0
"Kosovo","2024-05-09",0,0,0,0,0,0,0,0
"Kosovo","2024-05-10",0,0,0,0,0,0,0,0
"Kosovo","2024-05-11",0,0,0,0,0,0,0,0
"Kosovo","2024-05-12",0,0,0,0,0,0,0,0
"Kosovo","2024-05-13",0,0,0,0,0,0,0,0
"Kosovo","2024-05-14",0,0,0,0,0,0,0,0
"Kosovo","2024-05-15",0,0,0,0,0,0,0,0
"Kosovo","2024-05-16",0,0,0,0,0,0,0,0
"Kosovo","2024-05-17",0,0,0,0,0,0,0,0
"Kosovo","2024-05-18",0,0,0,0,0,0,0,0
"Kosovo","2024-05-19",0,0,0,0,0,0,0,0
"Kosovo","2024-05-20",0,0,0,0,0,0,0,0
"Kosovo","2024-05-21",0,0,0,0,0,0,0,0
"Kosovo","2024-05-22",0,0,0,0,0,0,0,0
"Kosovo","2024-05-23",0,0,0,0,0,0,0,0
"Kosovo","2024-05-24",0,0,0,0,0,0,0,0
"Kosovo","2024-05-25",0,0,0,0,0,0,0,0
"Kosovo","2024-05-26",0,0,0,0,0,0,0,0
"Kosovo","2024-05-27",0,0,0,0,0,0,0,0
"Kosovo","2024-05-28",0,0,0,0,0,0,0,0
"Kosovo","2024-05-29",0,0,0,0,0,0,0,0
"Kosovo","2024-05-30",0,0,0,0,0,0,0,0
"Kosovo","2024-05-31",0,0,0,0,0,0,0,0
"Kosovo","2024-06-01",0,0,0,0,0,0,0,0
"Kosovo","2024-06-02",0,0,0,0,0,0,0,0
"Kosovo","2024-06-03",0,0,0,0,0,0,0,0
"Kosovo","2024-06-04",0,0,0,0,0,0,0,0
"Kosovo","2024-06-05",0,0,0,0,0,0,0,0
"Kosovo","2024-06-06",0,0,0,0,0,0,0,0
"Kosovo","2024-06-07",0,0,0,0,0,0,0,0
"Kosovo","2024-06-08",0,0,0,0,0,0,0,0
"Kosovo","2024-06-09",0,0,0,0,0,0,0,0
"Kosovo","2024-06-10",0,0,0,0,0,0,0,0
"Kosovo","2024-06-11",0,0,0,0,0,0,0,0
"Kosovo","2024-06-12",0,0,0,0,0,0,0,0
"Kosovo","2024-06-13",0,0,0,0,0,0,0,0
"Kosovo","2024-06-14",0,0,0,0,0,0,0,0
"Kosovo","2024-06-15",0,0,0,0,0,0,0,0
"Kosovo","2024-06-16",0,0,0,0,0,0,0,0
"Kosovo","2024-06-17",0,0,0,0,0,0,0,0
"Kosovo","2024-06-18",0,0,0,0,0,0,0,0
"Kosovo","2024-06-19",0,0,0,0,0,0,0,0
"Kosovo","2024-06-20",0,0,0,0,0,0,0,0
"Kosovo","2024-06-21",0,0,0,0,0,0,0,0
"Kosovo","2024-06-22",0,0,0,0,0,0,0,0
"Kosovo","2024-06-23",0,0,0,0,0,0,0,0
"Kosovo","2024-06-24",0,0,0,0,0,0,0,0
"Kosovo","2024-06-25",0,0,0,0,0,0,0,0
"Kosovo","2024-06-26",0,0,0,0,0,0,0,0
"Kosovo","2024-06-27",0,0,0,0,0,0,0,0
"Kosovo","2024-06-28",0,0,0,0,0,0,0,0
"Kosovo","2024-06-29",0,0,0,0,0,0,0,0
"Kosovo","2024-06-30",0,0,0,0,0,0,0,0
"Kosovo","2024-07-01",0,0,0,0,0,0,0,0
"Kosovo","2024-07-02",0,0,0,0,0,0,0,0
"Kosovo","2024-07-03",0,0,0,0,0,0,0,0
"Kosovo","2024-07-04",0,0,0,0,0,0,0,0
"Kosovo","2024-07-05",0,0,0,0,0,0,0,0
"Kosovo","2024-07-06",0,0,0,0,0,0,0,0
"Kosovo","2024-07-07",0,0,0,0,0,0,0,0
"Kosovo","2024-07-08",0,0,0,0,0,0,0,0
"Kosovo","2024-07-09",0,0,0,0,0,0,0,0
"Kosovo","2024-07-10",0,0,0,0,0,0,0,0
"Kosovo","2024-07-11",0,0,0,0,0,0,0,0
"Kosovo","2024-07-12",0,0,0,0,0,0,0,0
"Kosovo","2024-07-13",0,0,0,0,0,0,0,0
"Kosovo","2024-07-14",0,0,0,0,0,0,0,0
"Kosovo","2024-07-15",0,0,0,0,0,0,0,0
"Kosovo","2024-07-16",0,0,0,0,0,0,0,0
"Kosovo","2024-07-17",0,0,0,0,0,0,0,0
"Kosovo","2024-07-18",0,0,0,0,0,0,0,0
"Kosovo","2024-07-19",0,0,0,0,0,0,0,0
"Kosovo","2024-07-20",0,0,0,0,0,0,0,0
"Kosovo","2024-07-21",0,0,0,0,0,0,0,0
"Kosovo","2024-07-22",0,0,0,0,0,0,0,0
"Kosovo","2024-07-23",0,0,0,0,0,0,0,0
"Kosovo","2024-07-24",0,0,0,0,0,0,0,0
"Kosovo","2024-07-25",0,0,0,0,0,0,0,0
"Kosovo","2024-07-26",0,0,0,0,0,0,0,0
"Kosovo","2024-07-27",0,0,0,0,0,0,0,0
"Kosovo","2024-07-28",0,0,0,0,0,0,0,0
"Kosovo","2024-07-29",0,0,0,0,0,0,0,0
"Kosovo","2024-07-30",0,0,0,0,0,0,0,0
"Kosovo","2024-07-31",0,0,0,0,0,0,0,0
"Kosovo","2024-08-01",0,0,0,0,0,0,0,0
"Kosovo","2024-08-02",0,0,0,0,0,0,0,0
"Kosovo","2024-08-03",0,0,0,0,0,0,0,0
"Kosovo","2024-08-04",0,0,0,0,0,0,0,0
"Kosovo","2024-08-05",0,0,0,0,0,0,0,0
"Kosovo","2024-08-06",0,0,0,0,0,0,0,0
"Kosovo","2024-08-07",0,0,0,0,0,0,0,0
"Kosovo","2024-08-08",0,0,0,0,0,0,0,0
"Kosovo","2024-08-09",0,0,0,0,0,0,0,0
"Kosovo","2024-08-10",0,0,0,0,0,0,0,0
"Kosovo","2024-08-11",0,0,0,0,0,0,0,0
"Kosovo","2024-08-12",0,0,0,0,0,0,0,0
"Kosovo","2024-08-13",0,0,0,0,0,0,0,0
"Kosovo","2024-08-14",0,0,0,0,0,0,0,0
"Kosovo","2024-08-15",0,0,0,0,0,0,0,0
"Kosovo","2024-08-16",0,0,0,0,0,0,0,0
"Kosovo","2024-08-17",0,0,0,0,0,0,0,0
"Kosovo","2024-08-18",0,0,0,0,0,0,0,0
"Kosovo","2024-08-19",0,0,0,0,0,0,0,0
"Kosovo","2024-08-20",0,0,0,0,0,0,0,0
"Kosovo","2024-08-21",0,0,0,0,0,0,0,0
"Kosovo","2024-08-22",0,0,0,0,0,0,0,0
"Kosovo","2024-08-23",0,0,0,0,0,0,0,0
"Kosovo","2024-08-24",0,0,0,0,0,0,0,0
"Kosovo","2024-08-25",0,0,0,0,0,0,0,0
"Kosovo","2024-08-26",0,0,0,0,0,0,0,0
"Kosovo","2024-08-27",0,0,0,0,0,0,0,0
"Kosovo","2024-08-28",0,0,0,0,0,0,0,0
"Kosovo","2024-08-29",0,0,0,0,0,0,0,0
"Kosovo","2024-08-30",0,0,0,0,0,0,0,0
"Kosovo","2024-08-31",0,0,0,0,0,0,0,0
"Kosovo","2024-09-01",0,0,0,0,0,0,0,0
"Kosovo","2024-09-02",0,0,0,0,0,0,0,0
"Kosovo","2024-09-03",0,0,0,0,0,0,0,0
"Kosovo","2024-09-04",0,0,0,0,0,0,0,0
"Kosovo","2024-09-05",0,0,0,0,0,0,0,0
"Kosovo","2024-09-06",0,0,0,0,0,0,0,0
"Kosovo","2024-09-07",0,0,0,0,0,0,0,0
"Kosovo","2024-09-08",0,0,0,0,0,0,0,0
"Kosovo","2024-09-09",0,0,0,0,0,0,0,0
"Kosovo","2024-09-10",0,0,0,0,0,0,0,0
"Kosovo","2024-09-11",0,0,0,0,0,0,0,0
"Kosovo","2024-09-12",0,0,0,0,0,0,0,0
"Kosovo","2024-09-13",0,0,0,0,0,0,0,0
"Kosovo","2024-09-14",0,0,0,0,0,0,0,0
"Kosovo","2024-09-15",0,0,0,0,0,0,0,0
"Kosovo","2024-09-16",0,0,0,0,0,0,0,0
"Kosovo","2024-09-17",0,0,0,0,0,0,0,0
"Kosovo","2024-09-18",0,0,0,0,0,0,0,0
"Kosovo","2024-09-19",0,0,0,0,0,0,0,0
"Kosovo","2024-09-20",0,0,0,0,0,0,0,0
"Kosovo","2024-09-21",0,0,0,0,0,0,0,0
"Kosovo","2024-09-22",0,0,0,0,0,0,0,0
"Kosovo","2024-09-23",0,0,0,0,0,0,0,0
"Kosovo","2024-09-24",0,0,0,0,0,0,0,0
"Kosovo","2024-09-25",0,0,0,0,0,0,0,0
"Kosovo","2024-09-26",0,0,0,0,0,0,0,0
"Kosovo","2024-09-27",0,0,0,0,0,0,0,0
"Kosovo","2024-09-28",0,0,0,0,0,0,0,0
"Kosovo","2024-09-29",0,0,0,0,0,0,0,0
"Kosovo","2024-09-30",0,0,0,0,0,0,0,0
"Kosovo","2024-10-01",0,0,0,0,0,0,0,0
"Kosovo","2024-10-02",0,0,0,0,0,0,0,0
"Kosovo","2024-10-03",0,0,0,0,0,0,0,0
"Kosovo","2024-10-04",0,0,0,0,0,0,0,0
"Kosovo","2024-10-05",0,0,0,0,0,0,0,0
"Kosovo","2024-10-06",0,0,0,0,0,0,0,0
"Kosovo","2024-10-07",0,0,0,0,0,0,0,0
"Kosovo","2024-10-08",0,0,0,0,0,0,0,0
"Kosovo","2024-10-09",0,0,0,0,0,0,0,0
"Kosovo","2024-10-10",0,0,0,0,0,0,0,0
"Kosovo","2024-10-11",0,0,0,0,0,0,0,0
"Kosovo","2024-10-12",0,0,0,0,0,0,0,0
"Kosovo","2024-10-13",0,0,0,0,0,0,0,0
"Kosovo","2024-10-14",0,0,0,0,0,0,0,0
"Kosovo","2024-10-15",0,0,0,0,0,0,0,0
"Kosovo","2024-10-16",0,0,0,0,0,0,0,0
"Kosovo","2024-10-17",0,0,0,0,0,0,0,0
"Kosovo","2024-10-18",0,0,0,0,0,0,0,0
"Kosovo","2024-10-19",0,0,0,0,0,0,0,0
"Kosovo","2024-10-20",0,0,0,0,0,0,0,0
"Kosovo","2024-10-21",0,0,0,0,0,0,0,0
"Kosovo","2024-10-22",0,0,0,0,0,0,0,0
"Kosovo","2024-10-23",0,0,0,0,0,0,0,0
"Kosovo","2024-10-24",0,0,0,0,0,0,0,0
"Kosovo","2024-10-25",0,0,0,0,0,0,0,0
"Kosovo","2024-10-26",0,0,0,0,0,0,0,0
"Kosovo","2024-10-27",0,0,0,0,0,0,0,0
"Kosovo","2024-10-28",0,0,0,0,0,0,0,0
"Kosovo","2024-10-29",0,0,0,0,0,0,0,0
"Kosovo","2024-10-30",0,0,0,0,0,0,0,0
"Kosovo","2024-10-31",0,0,0,0,0,0,0,0
"Kosovo","2024-11-01",0,0,0,0,0,0,0,0
"Kosovo","2024-11-02",0,0,0,0,0,0,0,0
"Kosovo","2024-11-03",0,0,0,0,0,0,0,0
"Kosovo","2024-11-04",0,0,0,0,0,0,0,0
"Kosovo","2024-11-05",0,0,0,0,0,0,0,0
"Kosovo","2024-11-06",0,0,0,0,0,0,0,0
"Kosovo","2024-11-07",0,0,0,0,0,0,0,0
"Kosovo","2024-11-08",0,0,0,0,0,0,0,0
"Kosovo","2024-11-09",0,0,0,0,0,0,0,0
"Kosovo","2024-11-10",0,0,0,0,0,0,0,0
"Kosovo","2024-11-11",0,0,0,0,0,0,0,0
"Kosovo","2024-11-12",0,0,0,0,0,0,0,0
"Kosovo","2024-11-13",0,0,0,0,0,0,0,0
"Kosovo","2024-11-14",0,0,0,0,0,0,0,0
"Kosovo","2024-11-15",0,0,0,0,0,0,0,0
"Kosovo","2024-11-16",0,0,0,0,0,0,0,0
"Kosovo","2024-11-17",0,0,0,0,0,0,0,0
"Kosovo","2024-11-18",0,0,0,0,0,0,0,0
"Kosovo","2024-11-19",0,0,0,0,0,0,0,0
"Kosovo","2024-11-20",0,0,0,0,0,0,0,0
"Kosovo","2024-11-21",0,0,0,0,0,0,0,0
"Kosovo","2024-11-22",0,0,0,0,0,0,0,0
"Kosovo","2024-11-23",0,0,0,0,0,0,0,0
"Kosovo","2024-11-24",0,0,0,0,0,0,0,0
"Kosovo","2024-11-25",0,0,0,0,0,0,0,0
"Kosovo","2024-11-26",0,0,0,0,0,0,0,0
"Kosovo","2024-11-27",0,0,0,0,0,0,0,0
"Kosovo","2024-11-28",0,0,0,0,0,0,0,0
"Kosovo","2024-11-29",0,0,0,0,0,0,0,0
"Kosovo","2024-11-30",0,0,0,0,0,0,0,0
"Kosovo","2024-12-01",0,0,0,0,0,0,0,0
"Kosovo","2024-12-02",0,0,0,0,0,0,0,0
"Kosovo","2024-12-03",0,0,0,0,0,0,0,0
"Kosovo","2024-12-04",0,0,0,0,0,0,0,0
"Kosovo","2024-12-05",0,0,0,0,0,0,0,0
"Kosovo","2024-12-06",0,0,0,0,0,0,0,0
"Kosovo","2024-12-07",0,0,0,0,0,0,0,0
"Kosovo","2024-12-08",0,0,0,0,0,0,0,0
"Kosovo","2024-12-09",0,0,0,0,0,0,0,0
"Kosovo","2024-12-10",0,0,0,0,0,0,0,0
"Kosovo","2024-12-11",0,0,0,0,0,0,0,0
"Kosovo","2024-12-12",0,0,0,0,0,0,0,0
"Kosovo","2024-12-13",0,0,0,0,0,0,0,0
"Kosovo","2024-12-14",0,0,0,0,0,0,0,0
"Kosovo","2024-12-15",0,0,0,0,0,0,0,0
"Kosovo","2024-12-16",0,0,0,0,0,0,0,0
"Kosovo","2024-12-17",0,0,0,0,0,0,0,0
"Kosovo","2024-12-18",0,0,0,0,0,0,0,0
"Kosovo","2024-12-19",0,0,0,0,0,0,0,0
"Kosovo","2024-12-20",0,0,0,0,0,0,0,0
"Kosovo","2024-12-21",0,0,0,0,0,0,0,0
"Kosovo","2024-12-22",0,0,0,0,0,0,0,0
"Kosovo","2024-12-23",0,0,0,0,0,0,0,0
"Kosovo","2024-12-24",0,0,0,0,0,0,0,0
"Kosovo","2024-12-25",0,0,0,0,0,0,0,0
"Kosovo","2024-12-26",0,0,0,0,0,0,0,0
"Kosovo","2024-12-27",0,0,0,0,0,0,0,0
"Kosovo","2024-12-28",0,0,0,0,0,0,0,0
"Kosovo","2024-12-29",0,0,0,0,0,0,0,0
"Kosovo","2024-12-30",0,0,0,0,0,0,0,0
"Kosovo","2024-12-31",0,1,1,0,1,1,0,0
"Kosovo","2025-01-01",0,0,1,0,0,1,0,0
"Kosovo","2025-01-02",0,0,1,0,0,1,0,0
"Kosovo","2025-01-03",0,0,1,0,0,1,0,0
"Kosovo","2025-01-04",0,0,1,0,0,1,0,0
"Kosovo","2025-01-05",0,0,1,0,0,1,0,0
"Kosovo","2025-01-06",0,0,1,0,0,1,0,0
"Kosovo","2025-01-07",0,0,1,0,0,1,0,0
"Kosovo","2025-01-08",0,0,1,0,0,1,0,0
"Kosovo","2025-01-09",0,0,1,0,0,1,0,0
"Kosovo","2025-01-10",0,0,1,0,0,1,0,0
"Kosovo","2025-01-11",0,0,1,0,0,1,0,0
"Kosovo","2025-01-12",0,0,1,0,0,1,0,0
"Kosovo","2025-01-13",0,0,1,0,0,1,0,0
"Kosovo","2025-01-14",0,0,1,0,0,1,0,0
"Kosovo","2025-01-15",0,0,1,0,0,1,0,0
"Kosovo","2025-01-16",0,0,1,0,0,1,0,0
"Kosovo","2025-01-17",0,0,1,0,0,1,0,0
"Kosovo","2025-01-18",0,0,1,0,0,1,0,0
"Kosovo","2025-01-19",0,0,1,0,0,1,0,0
"Kosovo","2025-01-20",0,0,1,0,0,1,0,0
"Kosovo","2025-01-21",0,0,1,0,0,1,0,0
"Kosovo","2025-01-22",0,0,1,0,0,1,0,0
"Kosovo","2025-01-23",0,0,1,0,0,1,0,0
"Kosovo","2025-01-24",0,0,1,0,0,1,0,0
"Kosovo","2025-01-25",0,0,1,0,0,1,0,0
"Kosovo","2025-01-26",0,0,1,0,0,1,0,0
"Kosovo","2025-01-27",0,0,1,0,0,1,0,0
"Kosovo","2025-01-28",0,0,1,0,0,1,0,0
"Kosovo","2025-01-29",0,0,1,0,0,1,0,0
"Kosovo","2025-01-30",0,0,1,0,0,1,0,0
"Kosovo","2025-01-31",0,0,1,0,0,1,0,0
"Kosovo","2025-02-01",0,0,1,0,0,1,0,0
"Kosovo","2025-02-02",0,0,1,0,0,1,0,0
"Kosovo","2025-02-03",0,0,1,0,0,1,0,0
"Latvia","2024-01-01",0,0,0,0,0,0,0,0
"Latvia","2024-01-02",0,0,0,0,0,0,0,0
"Latvia","2024-01-03",0,0,0,0,0,0,0,0
"Latvia","2024-01-04",0,0,0,0,0,0,0,0
"Latvia","2024-01-05",0,0,0,0,0,0,0,0
"Latvia","2024-01-06",0,0,0,0,0,0,0,0
"Latvia","2024-01-07",0,0,0,0,0,0,0,0
"Latvia","2024-01-08",0,0,0,0,0,0,0,0
"Latvia","2024-01-09",0,0,0,0,0,0,0,0
"Latvia","2024-01-10",0,0,0,0,0,0,0,0
"Latvia","2024-01-11",0,0,0,0,0,0,0,0
"Latvia","2024-01-12",0,0,0,0,0,0,0,0
"Latvia","2024-01-13",0,0,0,0,0,0,0,0
"Latvia","2024-01-14",0,0,0,0,0,0,0,0
"Latvia","2024-01-15",0,0,0,0,0,0,0,0
"Latvia","2024-01-16",0,0,0,0,0,0,0,0
"Latvia","2024-01-17",0,0,0,0,0,0,0,0
"Latvia","2024-01-18",0,0,0,0,0,0,0,0
"Latvia","2024-01-19",0,0,0,0,0,0,0,0
"Latvia","2024-01-20",0,0,0,0,0,0,0,0
"Latvia","2024-01-21",0,0,0,0,0,0,0,0
"Latvia","2024-01-22",0,0,0,0,0,0,0,0
"Latvia","2024-01-23",0,0,0,0,0,0,0,0
"Latvia","2024-01-24",0,0,0,0,0,0,0,0
"Latvia","2024-01-25",0,0,0,0,0,0,0,0
"Latvia","2024-01-26",0,0,0,0,0,0,0,0
"Latvia","2024-01-27",0,0,0,0,0,0,0,0
"Latvia","2024-01-28",0,0,0,0,0,0,0,0
"Latvia","2024-01-29",0,0,0,0,0,0,0,0
"Latvia","2024-01-30",0,0,0,0,0,0,0,0
"Latvia","2024-01-31",0,0,0,0,0,0,0,0
"Latvia","2024-02-01",0,0,0,0,0,0,0,0
"Latvia","2024-02-02",0,0,0,0,0,0,0,0
"Latvia","2024-02-03",0,0,0,0,0,0,0,0
"Latvia","2024-02-04",0,0,0,0,0,0,0,0
"Latvia","2024-02-05",0,0,0,0,0,0,0,0
"Latvia","2024-02-06",0,0,0,0,0,0,0,0
"Latvia","2024-02-07",0,0,0,0,0,0,0,0
"Latvia","2024-02-08",0,0,0,0,0,0,0,0
"Latvia","2024-02-09",0,0,0,0,0,0,0,0
"Latvia","2024-02-10",0,0,0,0,0,0,0,0
"Latvia","2024-02-11",0,0,0,0,0,0,0,0
"Latvia","2024-02-12",0,0,0,0,0,0,0,0
"Latvia","2024-02-13",0,0,0,0,0,0,0,0
"Latvia","2024-02-14",0,0,0,0,0,0,0,0
"Latvia","2024-02-15",0,0,0,0,0,0,0,0
"Latvia","2024-02-16",0,0,0,0,0,0,0,0
"Latvia","2024-02-17",0,0,0,0,0,0,0,0
"Latvia","2024-02-18",0,0,0,0,0,0,0,0
"Latvia","2024-02-19",0,0,0,0,0,0,0,0
"Latvia","2024-02-20",0,0,0,0,0,0,0,0
"Latvia","2024-02-21",0,0,0,0,0,0,0,0
"Latvia","2024-02-22",0,0,0,0,0,0,0,0
"Latvia","2024-02-23",0,0,0,0,0,0,0,0
"Latvia","2024-02-24",0,0,0,0,0,0,0,0
"Latvia","2024-02-25",0,0,0,0,0,0,0,0
"Latvia","2024-02-26",0,0,0,0,0,0,0,0
"Latvia","2024-02-27",0,0,0,0,0,0,0,0
"Latvia","2024-02-28",0,0,0,0,0,0,0,0
"Latvia","2024-02-29",0,0,0,0,0,0,0,0
"Latvia","2024-03-01",0,0,0,0,0,0,0,0
"Latvia","2024-03-02",0,0,0,0,0,0,0,0
"Latvia","2024-03-03",0,0,0,0,0,0,0,0
"Latvia","2024-03-04",0,0,0,0,0,0,0,0
"Latvia","2024-03-05",0,0,0,0,0,0,0,0
"Latvia","2024-03-06",0,0,0,0,0,0,0,0
"Latvia","2024-03-07",0,0,0,0,0,0,0,0
"Latvia","2024-03-08",0,0,0,0,0,0,0,0
"Latvia","2024-03-09",0,0,0,0,0,0,0,0
"Latvia","2024-03-10",0,0,0,0,0,0,0,0
"Latvia","2024-03-11",0,0,0,0,0,0,0,0
"Latvia","2024-03-12",0,0,0,0,0,0,0,0
"Latvia","2024-03-13",0,0,0,0,0,0,0,0
"Latvia","2024-03-14",0,0,0,0,0,0,0,0
"Latvia","2024-03-15",0,0,0,0,0,0,0,0
"Latvia","2024-03-16",0,0,0,0,0,0,0,0
"Latvia","2024-03-17",0,0,0,0,0,0,0,0
"Latvia","2024-03-18",0,0,0,0,0,0,0,0
"Latvia","2024-03-19",0,0,0,0,0,0,0,0
"Latvia","2024-03-20",0,0,0,0,0,0,0,0
"Latvia","2024-03-21",0,0,0,0,0,0,0,0
"Latvia","2024-03-22",0,0,0,0,0,0,0,0
"Latvia","2024-03-23",0,0,0,0,0,0,0,0
"Latvia","2024-03-24",0,0,0,0,0,0,0,0
"Latvia","2024-03-25",0,0,0,0,0,0,0,0
"Latvia","2024-03-26",0,0,0,0,0,0,0,0
"Latvia","2024-03-27",0,0,0,0,0,0,0,0
"Latvia","2024-03-28",0,0,0,0,0,0,0,0
"Latvia","2024-03-29",0,0,0,0,0,0,0,0
"Latvia","2024-03-30",0,0,0,0,0,0,0,0
"Latvia","2024-03-31",0,0,0,0,0,0,0,0
"Latvia","2024-04-01",0,0,0,0,0,0,0,0
"Latvia","2024-04-02",0,0,0,0,0,0,0,0
"Latvia","2024-04-03",0,0,0,0,0,0,0,0
"Latvia","2024-04-04",0,0,0,0,0,0,0,0
"Latvia","2024-04-05",0,0,0,0,0,0,0,0
"Latvia","2024-04-06",0,0,0,0,0,0,0,0
"Latvia","2024-04-07",0,0,0,0,0,0,0,0
"Latvia","2024-04-08",0,0,0,0,0,0,0,0
"Latvia","2024-04-09",0,0,0,0,0,0,0,0
"Latvia","2024-04-10",0,0,0,0,0,0,0,0
"Latvia","2024-04-11",0,0,0,0,0,0,0,0
"Latvia","2024-04-12",0,0,0,0,0,0,0,0
"Latvia","2024-04-13",0,0,0,0,0,0,0,0
"Latvia","2024-04-14",0,0,0,0,0,0,0,0
"Latvia","2024-04-15",0,0,0,0,0,0,0,0
"Latvia","2024-04-16",0,0,0,0,0,0,0,0
"Latvia","2024-04-17",0,0,0,0,0,0,0,0
"Latvia","2024-04-18",0,0,0,0,0,0,0,0
"Latvia","2024-04-19",0,0,0,0,0,0,0,0
"Latvia","2024-04-20",0,0,0,0,0,0,0,0
"Latvia","2024-04-21",0,0,0,0,0,0,0,0
"Latvia","2024-04-22",0,0,0,0,0,0,0,0
"Latvia","2024-04-23",0,0,0,0,0,0,0,0
"Latvia","2024-04-24",0,0,0,0,0,0,0,0
"Latvia","2024-04-25",0,0,0,0,0,0,0,0
"Latvia","2024-04-26",0,0,0,0,0,0,0,0
"Latvia","2024-04-27",0,0,0,0,0,0,0,0
"Latvia","2024-04-28",0,0,0,0,0,0,0,0
"Latvia","2024-04-29",0,0,0,0,0,0,0,0
"Latvia","2024-04-30",0,0,0,0,0,0,0,0
"Latvia","2024-05-01",0,0,0,0,0,0,0,0
"Latvia","2024-05-02",0,0,0,0,0,0,0,0
"Latvia","2024-05-03",0,0,0,0,0,0,0,0
"Latvia","2024-05-04",0,0,0,0,0,0,0,0
"Latvia","2024-05-05",0,0,0,0,0,0,0,0
"Latvia","2024-05-06",0,0,0,0,0,0,0,0
"Latvia","2024-05-07",0,0,0,0,0,0,0,0
"Latvia","2024-05-08",0,0,0,0,0,0,0,0
"Latvia","2024-05-09",0,0,0,0,0,0,0,0
"Latvia","2024-05-10",0,0,0,0,0,0,0,0
"Latvia","2024-05-11",0,0,0,0,0,0,0,0
"Latvia","2024-05-12",0,0,0,0,0,0,0,0
"Latvia","2024-05-13",0,0,0,0,0,0,0,0
"Latvia","2024-05-14",0,0,0,0,0,0,0,0
"Latvia","2024-05-15",0,0,0,0,0,0,0,0
"Latvia","2024-05-16",0,0,0,0,0,0,0,0
"Latvia","2024-05-17",0,0,0,0,0,0,0,0
"Latvia","2024-05-18",0,0,0,0,0,0,0,0
"Latvia","2024-05-19",0,0,0,0,0,0,0,0
"Latvia","2024-05-20",0,0,0,0,0,0,0,0
"Latvia","2024-05-21",0,0,0,0,0,0,0,0
"Latvia","2024-05-22",0,0,0,0,0,0,0,0
"Latvia","2024-05-23",0,0,0,0,0,0,0,0
"Latvia","2024-05-24",0,0,0,0,0,0,0,0
"Latvia","2024-05-25",0,0,0,0,0,0,0,0
"Latvia","2024-05-26",0,0,0,0,0,0,0,0
"Latvia","2024-05-27",0,0,0,0,0,0,0,0
"Latvia","2024-05-28",0,0,0,0,0,0,0,0
"Latvia","2024-05-29",0,0,0,0,0,0,0,0
"Latvia","2024-05-30",0,0,0,0,0,0,0,0
"Latvia","2024-05-31",0,0,0,0,0,0,0,0
"Latvia","2024-06-01",0,0,0,0,0,0,0,0
"Latvia","2024-06-02",0,0,0,0,0,0,0,0
"Latvia","2024-06-03",0,0,0,0,0,0,0,0
"Latvia","2024-06-04",0,0,0,0,0,0,0,0
"Latvia","2024-06-05",0,0,0,0,0,0,0,0
"Latvia","2024-06-06",0,0,0,0,0,0,0,0
"Latvia","2024-06-07",0,0,0,0,0,0,0,0
"Latvia","2024-06-08",0,0,0,0,0,0,0,0
"Latvia","2024-06-09",0,0,0,0,0,0,0,0
"Latvia","2024-06-10",0,0,0,0,0,0,0,0
"Latvia","2024-06-11",0,0,0,0,0,0,0,0
"Latvia","2024-06-12",0,0,0,0,0,0,0,0
"Latvia","2024-06-13",0,0,0,0,0,0,0,0
"Latvia","2024-06-14",0,0,0,0,0,0,0,0
"Latvia","2024-06-15",0,0,0,0,0,0,0,0
"Latvia","2024-06-16",0,0,0,0,0,0,0,0
"Latvia","2024-06-17",0,0,0,0,0,0,0,0
"Latvia","2024-06-18",0,0,0,0,0,0,0,0
"Latvia","2024-06-19",0,0,0,0,0,0,0,0
"Latvia","2024-06-20",0,0,0,0,0,0,0,0
"Latvia","2024-06-21",0,0,0,0,0,0,0,0
"Latvia","2024-06-22",0,0,0,0,0,0,0,0
"Latvia","2024-06-23",0,0,0,0,0,0,0,0
"Latvia","2024-06-24",0,0,0,0,0,0,0,0
"Latvia","2024-06-25",0,0,0,0,0,0,0,0
"Latvia","2024-06-26",0,0,0,0,0,0,0,0
"Latvia","2024-06-27",0,0,0,0,0,0,0,0
"Latvia","2024-06-28",0,0,0,0,0,0,0,0
"Latvia","2024-06-29",0,0,0,0,0,0,0,0
"Latvia","2024-06-30",0,0,0,0,0,0,0,0
"Latvia","2024-07-01",0,0,0,0,0,0,0,0
"Latvia","2024-07-02",0,0,0,0,0,0,0,0
"Latvia","2024-07-03",0,0,0,0,0,0,0,0
"Latvia","2024-07-04",0,0,0,0,0,0,0,0
"Latvia","2024-07-05",0,0,0,0,0,0,0,0
"Latvia","2024-07-06",0,0,0,0,0,0,0,0
"Latvia","2024-07-07",0,0,0,0,0,0,0,0
"Latvia","2024-07-08",0,0,0,0,0,0,0,0
"Latvia","2024-07-09",0,0,0,0,0,0,0,0
"Latvia","2024-07-10",0,0,0,0,0,0,0,0
"Latvia","2024-07-11",0,0,0,0,0,0,0,0
"Latvia","2024-07-12",0,0,0,0,0,0,0,0
"Latvia","2024-07-13",0,0,0,0,0,0,0,0
"Latvia","2024-07-14",0,0,0,0,0,0,0,0
"Latvia","2024-07-15",0,0,0,0,0,0,0,0
"Latvia","2024-07-16",0,0,0,0,0,0,0,0
"Latvia","2024-07-17",0,0,0,0,0,0,0,0
"Latvia","2024-07-18",0,0,0,0,0,0,0,0
"Latvia","2024-07-19",0,0,0,0,0,0,0,0
"Latvia","2024-07-20",0,0,0,0,0,0,0,0
"Latvia","2024-07-21",0,0,0,0,0,0,0,0
"Latvia","2024-07-22",0,0,0,0,0,0,0,0
"Latvia","2024-07-23",0,0,0,0,0,0,0,0
"Latvia","2024-07-24",0,0,0,0,0,0,0,0
"Latvia","2024-07-25",0,0,0,0,0,0,0,0
"Latvia","2024-07-26",0,0,0,0,0,0,0,0
"Latvia","2024-07-27",0,0,0,0,0,0,0,0
"Latvia","2024-07-28",0,0,0,0,0,0,0,0
"Latvia","2024-07-29",0,0,0,0,0,0,0,0
"Latvia","2024-07-30",0,0,0,0,0,0,0,0
"Latvia","2024-07-31",0,0,0,0,0,0,0,0
"Latvia","2024-08-01",0,0,0,0,0,0,0,0
"Latvia","2024-08-02",0,0,0,0,0,0,0,0
"Latvia","2024-08-03",0,0,0,0,0,0,0,0
"Latvia","2024-08-04",0,0,0,0,0,0,0,0
"Latvia","2024-08-05",0,0,0,0,0,0,0,0
"Latvia","2024-08-06",0,0,0,0,0,0,0,0
"Latvia","2024-08-07",0,0,0,0,0,0,0,0
"Latvia","2024-08-08",0,0,0,0,0,0,0,0
"Latvia","2024-08-09",0,0,0,0,0,0,0,0
"Latvia","2024-08-10",0,0,0,0,0,0,0,0
"Latvia","2024-08-11",0,0,0,0,0,0,0,0
"Latvia","2024-08-12",0,0,0,0,0,0,0,0
"Latvia","2024-08-13",0,0,0,0,0,0,0,0
"Latvia","2024-08-14",0,0,0,0,0,0,0,0
"Latvia","2024-08-15",0,0,0,0,0,0,0,0
"Latvia","2024-08-16",0,0,0,0,0,0,0,0
"Latvia","2024-08-17",0,0,0,0,0,0,0,0
"Latvia","2024-08-18",0,0,0,0,0,0,0,0
"Latvia","2024-08-19",0,0,0,0,0,0,0,0
"Latvia","2024-08-20",0,0,0,0,0,0,0,0
"Latvia","2024-08-21",0,0,0,0,0,0,0,0
"Latvia","2024-08-22",0,0,0,0,0,0,0,0
"Latvia","2024-08-23",0,0,0,0,0,0,0,0
"Latvia","2024-08-24",0,0,0,0,0,0,0,0
"Latvia","2024-08-25",0,0,0,0,0,0,0,0
"Latvia","2024-08-26",0,0,0,0,0,0,0,0
"Latvia","2024-08-27",0,0,0,0,0,0,0,0
"Latvia","2024-08-28",0,0,0,0,0,0,0,0
"Latvia","2024-08-29",0,0,0,0,0,0,0,0
"Latvia","2024-08-30",0,0,0,0,0,0,0,0
"Latvia","2024-08-31",0,0,0,0,0,0,0,0
"Latvia","2024-09-01",0,0,0,0,0,0,0,0
"Latvia","2024-09-02",0,0,0,0,0,0,0,0
"Latvia","2024-09-03",0,0,0,0,0,0,0,0
"Latvia","2024-09-04",0,0,0,0,0,0,0,0
"Latvia","2024-09-05",0,0,0,0,0,0,0,0
"Latvia","2024-09-06",0,0,0,0,0,0,0,0
"Latvia","2024-09-07",0,0,0,0,0,0,0,0
"Latvia","2024-09-08",0,0,0,0,0,0,0,0
"Latvia","2024-09-09",0,0,0,0,0,0,0,0
"Latvia","2024-09-10",0,0,0,0,0,0,0,0
"Latvia","2024-09-11",0,0,0,0,0,0,0,0
"Latvia","2024-09-12",0,0,0,0,0,0,0,0
"Latvia","2024-09-13",0,0,0,0,0,0,0,0
"Latvia","2024-09-14",0,0,0,0,0,0,0,0
"Latvia","2024-09-15",0,0,0,0,0,0,0,0
"Latvia","2024-09-16",0,0,0,0,0,0,0,0
"Latvia","2024-09-17",0,0,0,0,0,0,0,0
"Latvia","2024-09-18",0,0,0,0,0,0,0,0
"Latvia","2024-09-19",0,0,0,0,0,0,0,0
"Latvia","2024-09-20",0,0,0,0,0,0,0,0
"Latvia","2024-09-21",0,0,0,0,0,0,0,0
"Latvia","2024-09-22",0,0,0,0,0,0,0,0
"Latvia","2024-09-23",0,0,0,0,0,0,0,0
"Latvia","2024-09-24",0,0,0,0,0,0,0,0
"Latvia","2024-09-25",0,0,0,0,0,0,0,0
"Latvia","2024-09-26",0,0,0,0,0,0,0,0
"Latvia","2024-09-27",0,0,0,0,0,0,0,0
"Latvia","2024-09-28",0,0,0,0,0,0,0,0
"Latvia","2024-09-29",0,0,0,0,0,0,0,0
"Latvia","2024-09-30",0,0,0,0,0,0,0,0
"Latvia","2024-10-01",0,0,0,0,0,0,0,0
"Latvia","2024-10-02",0,0,0,0,0,0,0,0
"Latvia","2024-10-03",0,0,0,0,0,0,0,0
"Latvia","2024-10-04",0,0,0,0,0,0,0,0
"Latvia","2024-10-05",0,0,0,0,0,0,0,0
"Latvia","2024-10-06",0,0,0,0,0,0,0,0
"Latvia","2024-10-07",0,0,0,0,0,0,0,0
"Latvia","2024-10-08",0,0,0,0,0,0,0,0
"Latvia","2024-10-09",0,0,0,0,0,0,0,0
"Latvia","2024-10-10",0,0,0,0,0,0,0,0
"Latvia","2024-10-11",0,0,0,0,0,0,0,0
"Latvia","2024-10-12",0,0,0,0,0,0,0,0
"Latvia","2024-10-13",0,0,0,0,0,0,0,0
"Latvia","2024-10-14",0,0,0,0,0,0,0,0
"Latvia","2024-10-15",0,0,0,0,0,0,0,0
"Latvia","2024-10-16",0,0,0,0,0,0,0,0
"Latvia","2024-10-17",0,0,0,0,0,0,0,0
"Latvia","2024-10-18",0,0,0,0,0,0,0,0
"Latvia","2024-10-19",0,0,0,0,0,0,0,0
"Latvia","2024-10-20",0,0,0,0,0,0,0,0
"Latvia","2024-10-21",0,0,0,0,0,0,0,0
"Latvia","2024-10-22",0,0,0,0,0,0,0,0
"Latvia","2024-10-23",0,0,0,0,0,0,0,0
"Latvia","2024-10-24",0,0,0,0,0,0,0,0
"Latvia","2024-10-25",0,0,0,0,0,0,0,0
"Latvia","2024-10-26",0,0,0,0,0,0,0,0
"Latvia","2024-10-27",0,0,0,0,0,0,0,0
"Latvia","2024-10-28",0,0,0,0,0,0,0,0
"Latvia","2024-10-29",0,0,0,0,0,0,0,0
"Latvia","2024-10-30",0,0,0,0,0,0,0,0
"Latvia","2024-10-31",0,0,0,0,0,0,0,0
"Latvia","2024-11-01",0,0,0,0,0,0,0,0
"Latvia","2024-11-02",0,0,0,0,0,0,0,0
"Latvia","2024-11-03",0,0,0,0,0,0,0,0
"Latvia","2024-11-04",0,0,0,0,0,0,0,0
"Latvia","2024-11-05",0,0,0,0,0,0,0,0
"Latvia","2024-11-06",0,0,0,0,0,0,0,0
"Latvia","2024-11-07",0,0,0,0,0,0,0,0
"Latvia","2024-11-08",0,0,0,0,0,0,0,0
"Latvia","2024-11-09",0,0,0,0,0,0,0,0
"Latvia","2024-11-10",0,0,0,0,0,0,0,0
"Latvia","2024-11-11",0,0,0,0,0,0,0,0
"Latvia","2024-11-12",0,0,0,0,0,0,0,0
"Latvia","2024-11-13",0,0,0,0,0,0,0,0
"Latvia","2024-11-14",0,0,0,0,0,0,0,0
"Latvia","2024-11-15",0,0,0,0,0,0,0,0
"Latvia","2024-11-16",0,0,0,0,0,0,0,0
"Latvia","2024-11-17",0,0,0,0,0,0,0,0
"Latvia","2024-11-18",0,0,0,0,0,0,0,0
"Latvia","2024-11-19",0,0,0,0,0,0,0,0
"Latvia","2024-11-20",0,0,0,0,0,0,0,0
"Latvia","2024-11-21",0,0,0,0,0,0,0,0
"Latvia","2024-11-22",0,0,0,0,0,0,0,0
"Latvia","2024-11-23",0,0,0,0,0,0,0,0
"Latvia","2024-11-24",0,0,0,0,0,0,0,0
"Latvia","2024-11-25",0,0,0,0,0,0,0,0
"Latvia","2024-11-26",0,0,0,0,0,0,0,0
"Latvia","2024-11-27",0,0,0,0,0,0,0,0
"Latvia","2024-11-28",0,0,0,0,0,0,0,0
"Latvia","2024-11-29",0,0,0,0,0,0,0,0
"Latvia","2024-11-30",0,0,0,0,0,0,0,0
"Latvia","2024-12-01",0,0,0,0,0,0,0,0
"Latvia","2024-12-02",0,0,0,0,0,0,0,0
"Latvia","2024-12-03",0,0,0,0,0,0,0,0
"Latvia","2024-12-04",0,0,0,0,0,0,0,0
"Latvia","2024-12-05",0,0,0,0,0,0,0,0
"Latvia","2024-12-06",0,0,0,0,0,0,0,0
"Latvia","2024-12-07",0,0,0,0,0,0,0,0
"Latvia","2024-12-08",0,0,0,0,0,0,0,0
"Latvia","2024-12-09",0,0,0,0,0,0,0,0
"Latvia","2024-12-10",0,0,0,0,0,0,0,0
"Latvia","2024-12-11",0,0,0,0,0,0,0,0
"Latvia","2024-12-12",0,0,0,0,0,0,0,0
"Latvia","2024-12-13",0,0,0,0,0,0,0,0
"Latvia","2024-12-14",0,0,0,0,0,0,0,0
"Latvia","2024-12-15",0,0,0,0,0,0,0,0
"Latvia","2024-12-16",0,0,0,0,0,0,0,0
"Latvia","2024-12-17",0,0,0,0,0,0,0,0
"Latvia","2024-12-18",0,0,0,0,0,0,0,0
"Latvia","2024-12-19",0,0,0,0,0,0,0,0
"Latvia","2024-12-20",0,0,0,0,0,0,0,0
"Latvia","2024-12-21",0,0,0,0,0,0,0,0
"Latvia","2024-12-22",0,0,0,0,0,0,0,0
"Latvia","2024-12-23",0,0,0,0,0,0,0,0
"Latvia","2024-12-24",0,0,0,0,0,0,0,0
"Latvia","2024-12-25",0,0,0,0,0,0,0,0
"Latvia","2024-12-26",0,0,0,0,0,0,0,0
"Latvia","2024-12-27",0,0,0,0,0,0,0,0
"Latvia","2024-12-28",0,0,0,0,0,0,0,0
"Latvia","2024-12-29",0,0,0,0,0,0,0,0
"Latvia","2024-12-30",0,0,0,0,0,0,0,0
"Latvia","2024-12-31",0,0,0,0,0,0,0,0
"Latvia","2025-01-01",0,0,0,0,0,0,0,0
"Latvia","2025-01-02",0,0,0,0,0,0,0,0
"Latvia","2025-01-03",0,0,0,0,0,0,0,0
"Latvia","2025-01-04",0,0,0,0,0,0,0,0
"Latvia","2025-01-05",0,0,0,0,0,0,0,0
"Latvia","2025-01-06",0,0,0,0,0,0,0,0
"Latvia","2025-01-07",0,0,0,0,0,0,0,0
"Latvia","2025-01-08",0,0,0,0,0,0,0,0
"Latvia","2025-01-09",0,0,0,0,0,0,0,0
"Latvia","2025-01-10",0,0,0,0,0,0,0,0
"Latvia","2025-01-11",0,0,0,0,0,0,0,0
"Latvia","2025-01-12",0,0,0,0,0,0,0,0
"Latvia","2025-01-13",0,0,0,0,0,0,0,0
"Latvia","2025-01-14",0,0,0,0,0,0,0,0
"Latvia","2025-01-15",0,0,0,0,0,0,0,0
"Latvia","2025-01-16",0,0,0,0,0,0,0,0
"Latvia","2025-01-17",0,0,0,0,0,0,0,0
"Latvia","2025-01-18",0,0,0,0,0,0,0,0
"Latvia","2025-01-19",0,0,0,0,0,0,0,0
"Latvia","2025-01-20",0,0,0,0,0,0,0,0
"Latvia","2025-01-21",0,0,0,0,0,0,0,0
"Latvia","2025-01-22",0,0,0,0,0,0,0,0
"Latvia","2025-01-23",0,0,0,0,0,0,0,0
"Latvia","2025-01-24",0,0,0,0,0,0,0,0
"Latvia","2025-01-25",0,0,0,0,0,0,0,0
"Latvia","2025-01-26",0,0,0,0,0,0,0,0
"Latvia","2025-01-27",0,0,0,0,0,0,0,0
"Latvia","2025-01-28",0,0,0,0,0,0,0,0
"Latvia","2025-01-29",0,0,0,0,0,0,0,0
"Latvia","2025-01-30",0,0,0,0,0,0,0,0
"Latvia","2025-01-31",0,0,0,0,0,0,0,0
"Latvia","2025-02-01",0,0,0,0,0,0,0,0
"Latvia","2025-02-02",0,0,0,0,0,0,0,0
"Latvia","2025-02-03",0,0,0,0,0,0,0,0
"Lebanon","2024-01-01",0,0,0,0,0,0,0,0
"Lebanon","2024-01-02",0,0,0,0,0,0,0,0
"Lebanon","2024-01-03",0,0,0,0,0,0,0,0
"Lebanon","2024-01-04",0,0,0,0,0,0,0,0
"Lebanon","2024-01-05",0,0,0,0,0,0,0,0
"Lebanon","2024-01-06",0,0,0,0,0,0,0,0
"Lebanon","2024-01-07",0,0,0,0,0,0,0,0
"Lebanon","2024-01-08",0,0,0,0,0,0,0,0
"Lebanon","2024-01-09",0,0,0,0,0,0,0,0
"Lebanon","2024-01-10",0,0,0,0,0,0,0,0
"Lebanon","2024-01-11",0,0,0,0,0,0,0,0
"Lebanon","2024-01-12",0,0,0,0,0,0,0,0
"Lebanon","2024-01-13",0,0,0,0,0,0,0,0
"Lebanon","2024-01-14",0,0,0,0,0,0,0,0
"Lebanon","2024-01-15",0,0,0,0,0,0,0,0
"Lebanon","2024-01-16",0,0,0,0,0,0,0,0
"Lebanon","2024-01-17",0,0,0,0,0,0,0,0
"Lebanon","2024-01-18",0,0,0,0,0,0,0,0
"Lebanon","2024-01-19",0,0,0,0,0,0,0,0
"Lebanon","2024-01-20",0,0,0,0,0,0,0,0
"Lebanon","2024-01-21",0,0,0,0,0,0,0,0
"Lebanon","2024-01-22",0,0,0,0,0,0,0,0
"Lebanon","2024-01-23",0,0,0,0,0,0,0,0
"Lebanon","2024-01-24",0,0,0,0,0,0,0,0
"Lebanon","2024-01-25",0,0,0,0,0,0,0,0
"Lebanon","2024-01-26",0,0,0,0,0,0,0,0
"Lebanon","2024-01-27",0,0,0,0,0,0,0,0
"Lebanon","2024-01-28",0,0,0,0,0,0,0,0
"Lebanon","2024-01-29",0,0,0,0,0,0,0,0
"Lebanon","2024-01-30",0,0,0,0,0,0,0,0
"Lebanon","2024-01-31",0,0,0,0,0,0,0,0
"Lebanon","2024-02-01",0,0,0,0,0,0,0,0
"Lebanon","2024-02-02",0,0,0,0,0,0,0,0
"Lebanon","2024-02-03",0,0,0,0,0,0,0,0
"Lebanon","2024-02-04",0,0,0,0,0,0,0,0
"Lebanon","2024-02-05",0,0,0,0,0,0,0,0
"Lebanon","2024-02-06",0,0,0,0,0,0,0,0
"Lebanon","2024-02-07",0,0,0,0,0,0,0,0
"Lebanon","2024-02-08",0,0,0,0,0,0,0,0
"Lebanon","2024-02-09",0,0,0,0,0,0,0,0
"Lebanon","2024-02-10",0,0,0,0,0,0,0,0
"Lebanon","2024-02-11",0,0,0,0,0,0,0,0
"Lebanon","2024-02-12",0,0,0,0,0,0,0,0
"Lebanon","2024-02-13",0,0,0,0,0,0,0,0
"Lebanon","2024-02-14",0,0,0,0,0,0,0,0
"Lebanon","2024-02-15",0,0,0,0,0,0,0,0
"Lebanon","2024-02-16",0,0,0,0,0,0,0,0
"Lebanon","2024-02-17",0,0,0,0,0,0,0,0
"Lebanon","2024-02-18",0,0,0,0,0,0,0,0
"Lebanon","2024-02-19",0,0,0,0,0,0,0,0
"Lebanon","2024-02-20",0,0,0,0,0,0,0,0
"Lebanon","2024-02-21",0,0,0,0,0,0,0,0
"Lebanon","2024-02-22",0,0,0,0,0,0,0,0
"Lebanon","2024-02-23",0,0,0,0,0,0,0,0
"Lebanon","2024-02-24",0,0,0,0,0,0,0,0
"Lebanon","2024-02-25",0,0,0,0,0,0,0,0
"Lebanon","2024-02-26",0,0,0,0,0,0,0,0
"Lebanon","2024-02-27",0,0,0,0,0,0,0,0
"Lebanon","2024-02-28",0,0,0,0,0,0,0,0
"Lebanon","2024-02-29",0,0,0,0,0,0,0,0
"Lebanon","2024-03-01",0,0,0,0,0,0,0,0
"Lebanon","2024-03-02",0,0,0,0,0,0,0,0
"Lebanon","2024-03-03",0,0,0,0,0,0,0,0
"Lebanon","2024-03-04",0,0,0,0,0,0,0,0
"Lebanon","2024-03-05",0,0,0,0,0,0,0,0
"Lebanon","2024-03-06",0,0,0,0,0,0,0,0
"Lebanon","2024-03-07",0,0,0,0,0,0,0,0
"Lebanon","2024-03-08",0,0,0,0,0,0,0,0
"Lebanon","2024-03-09",0,0,0,0,0,0,0,0
"Lebanon","2024-03-10",0,0,0,0,0,0,0,0
"Lebanon","2024-03-11",0,0,0,0,0,0,0,0
"Lebanon","2024-03-12",0,0,0,0,0,0,0,0
"Lebanon","2024-03-13",0,0,0,0,0,0,0,0
"Lebanon","2024-03-14",0,1,1,0,1,1,0,0
"Lebanon","2024-03-15",0,0,1,0,0,1,0,0
"Lebanon","2024-03-16",0,0,1,0,0,1,0,0
"Lebanon","2024-03-17",0,0,1,0,0,1,0,0
"Lebanon","2024-03-18",0,0,1,0,0,1,0,0
"Lebanon","2024-03-19",0,0,1,0,0,1,0,0
"Lebanon","2024-03-20",0,0,1,0,0,1,0,0
"Lebanon","2024-03-21",0,0,1,0,0,1,0,0
"Lebanon","2024-03-22",0,0,1,0,0,1,0,0
"Lebanon","2024-03-23",0,0,1,0,0,1,0,0
"Lebanon","2024-03-24",0,0,1,0,0,1,0,0
"Lebanon","2024-03-25",0,0,1,0,0,1,0,0
"Lebanon","2024-03-26",0,0,1,0,0,1,0,0
"Lebanon","2024-03-27",0,0,1,0,0,1,0,0
"Lebanon","2024-03-28",0,0,1,0,0,1,0,0
"Lebanon","2024-03-29",0,0,1,0,0,1,0,0
"Lebanon","2024-03-30",0,0,1,0,0,1,0,0
"Lebanon","2024-03-31",0,0,1,0,0,1,0,0
"Lebanon","2024-04-01",0,0,1,0,0,1,0,0
"Lebanon","2024-04-02",0,0,1,0,0,1,0,0
"Lebanon","2024-04-03",0,0,1,0,0,1,0,0
"Lebanon","2024-04-04",0,0,1,0,0,1,0,0
"Lebanon","2024-04-05",0,0,1,0,0,1,0,0
"Lebanon","2024-04-06",0,0,1,0,0,1,0,0
"Lebanon","2024-04-07",0,0,1,0,0,1,0,0
"Lebanon","2024-04-08",0,0,1,0,0,1,0,0
"Lebanon","2024-04-09",0,0,1,0,0,1,0,0
"Lebanon","2024-04-10",0,0,1,0,0,1,0,0
"Lebanon","2024-04-11",0,0,1,0,0,1,0,0
"Lebanon","2024-04-12",0,0,1,0,0,1,0,0
"Lebanon","2024-04-13",0,0,1,0,0,1,0,0
"Lebanon","2024-04-14",0,0,1,0,0,1,0,0
"Lebanon","2024-04-15",0,0,1,0,0,1,0,0
"Lebanon","2024-04-16",0,0,1,0,0,1,0,0
"Lebanon","2024-04-17",0,0,1,0,0,1,0,0
"Lebanon","2024-04-18",0,0,1,0,0,1,0,0
"Lebanon","2024-04-19",0,0,1,0,0,1,0,0
"Lebanon","2024-04-20",0,0,1,0,0,1,0,0
"Lebanon","2024-04-21",0,0,1,0,0,1,0,0
"Lebanon","2024-04-22",0,0,1,0,0,1,0,0
"Lebanon","2024-04-23",0,0,1,0,0,1,0,0
"Lebanon","2024-04-24",0,0,1,0,0,1,0,0
"Lebanon","2024-04-25",0,0,1,0,0,1,0,0
"Lebanon","2024-04-26",0,0,1,0,0,1,0,0
"Lebanon","2024-04-27",0,0,1,0,0,1,0,0
"Lebanon","2024-04-28",0,0,1,0,0,1,0,0
"Lebanon","2024-04-29",0,0,1,0,0,1,0,0
"Lebanon","2024-04-30",0,0,1,0,0,1,0,0
"Lebanon","2024-05-01",0,0,1,0,0,1,0,0
"Lebanon","2024-05-02",0,0,1,0,0,1,0,0
"Lebanon","2024-05-03",0,0,1,0,0,1,0,0
"Lebanon","2024-05-04",0,0,1,0,0,1,0,0
"Lebanon","2024-05-05",0,0,1,0,0,1,0,0
"Lebanon","2024-05-06",0,0,1,0,0,1,0,0
"Lebanon","2024-05-07",0,0,1,0,0,1,0,0
"Lebanon","2024-05-08",0,0,1,0,0,1,0,0
"Lebanon","2024-05-09",0,0,1,0,0,1,0,0
"Lebanon","2024-05-10",0,0,1,0,0,1,0,0
"Lebanon","2024-05-11",0,0,1,0,0,1,0,0
"Lebanon","2024-05-12",0,0,1,0,0,1,0,0
"Lebanon","2024-05-13",0,0,1,0,0,1,0,0
"Lebanon","2024-05-14",0,0,1,0,0,1,0,0
"Lebanon","2024-05-15",0,0,1,0,0,1,0,0
"Lebanon","2024-05-16",0,0,1,0,0,1,0,0
"Lebanon","2024-05-17",0,0,1,0,0,1,0,0
"Lebanon","2024-05-18",0,0,1,0,0,1,0,0
"Lebanon","2024-05-19",0,0,1,0,0,1,0,0
"Lebanon","2024-05-20",0,0,1,0,0,1,0,0
"Lebanon","2024-05-21",0,0,1,0,0,1,0,0
"Lebanon","2024-05-22",0,0,1,0,0,1,0,0
"Lebanon","2024-05-23",0,0,1,0,0,1,0,0
"Lebanon","2024-05-24",0,0,1,0,0,1,0,0
"Lebanon","2024-05-25",0,0,1,0,0,1,0,0
"Lebanon","2024-05-26",0,0,1,0,0,1,0,0
"Lebanon","2024-05-27",0,0,1,0,0,1,0,0
"Lebanon","2024-05-28",0,0,1,0,0,1,0,0
"Lebanon","2024-05-29",0,0,1,0,0,1,0,0
"Lebanon","2024-05-30",0,0,1,0,0,1,0,0
"Lebanon","2024-05-31",0,0,1,0,0,1,0,0
"Lebanon","2024-06-01",0,0,1,0,0,1,0,0
"Lebanon","2024-06-02",0,0,1,0,0,1,0,0
"Lebanon","2024-06-03",0,0,1,0,0,1,0,0
"Lebanon","2024-06-04",0,0,1,0,0,1,0,0
"Lebanon","2024-06-05",0,0,1,0,0,1,0,0
"Lebanon","2024-06-06",0,0,1,0,0,1,0,0
"Lebanon","2024-06-07",0,0,1,0,0,1,0,0
"Lebanon","2024-06-08",0,0,1,0,0,1,0,0
"Lebanon","2024-06-09",0,0,1,0,0,1,0,0
"Lebanon","2024-06-10",0,0,1,0,0,1,0,0
"Lebanon","2024-06-11",0,0,1,0,0,1,0,0
"Lebanon","2024-06-12",0,0,1,0,0,1,0,0
"Lebanon","2024-06-13",0,0,1,0,0,1,0,0
"Lebanon","2024-06-14",0,0,1,0,0,1,0,0
"Lebanon","2024-06-15",0,0,1,0,0,1,0,0
"Lebanon","2024-06-16",0,0,1,0,0,1,0,0
"Lebanon","2024-06-17",0,0,1,0,0,1,0,0
"Lebanon","2024-06-18",0,0,1,0,0,1,0,0
"Lebanon","2024-06-19",0,0,1,0,0,1,0,0
"Lebanon","2024-06-20",0,0,1,0,0,1,0,0
"Lebanon","2024-06-21",0,0,1,0,0,1,0,0
"Lebanon","2024-06-22",0,0,1,0,0,1,0,0
"Lebanon","2024-06-23",0,0,1,0,0,1,0,0
"Lebanon","2024-06-24",0,0,1,0,0,1,0,0
"Lebanon","2024-06-25",0,0,1,0,0,1,0,0
"Lebanon","2024-06-26",0,0,1,0,0,1,0,0
"Lebanon","2024-06-27",0,0,1,0,0,1,0,0
"Lebanon","2024-06-28",0,0,1,0,0,1,0,0
"Lebanon","2024-06-29",0,0,1,0,0,1,0,0
"Lebanon","2024-06-30",0,0,1,0,0,1,0,0
"Lebanon","2024-07-01",0,0,1,0,0,1,0,0
"Lebanon","2024-07-02",0,0,1,0,0,1,0,0
"Lebanon","2024-07-03",0,0,1,0,0,1,0,0
"Lebanon","2024-07-04",0,0,1,0,0,1,0,0
"Lebanon","2024-07-05",0,0,1,0,0,1,0,0
"Lebanon","2024-07-06",0,0,1,0,0,1,0,0
"Lebanon","2024-07-07",0,0,1,0,0,1,0,0
"Lebanon","2024-07-08",0,0,1,0,0,1,0,0
"Lebanon","2024-07-09",0,0,1,0,0,1,0,0
"Lebanon","2024-07-10",0,0,1,0,0,1,0,0
"Lebanon","2024-07-11",0,0,1,0,0,1,0,0
"Lebanon","2024-07-12",0,0,1,0,0,1,0,0
"Lebanon","2024-07-13",0,0,1,0,0,1,0,0
"Lebanon","2024-07-14",0,0,1,0,0,1,0,0
"Lebanon","2024-07-15",0,0,1,0,0,1,0,0
"Lebanon","2024-07-16",0,0,1,0,0,1,0,0
"Lebanon","2024-07-17",0,0,1,0,0,1,0,0
"Lebanon","2024-07-18",0,0,1,0,0,1,0,0
"Lebanon","2024-07-19",0,0,1,0,0,1,0,0
"Lebanon","2024-07-20",0,0,1,0,0,1,0,0
"Lebanon","2024-07-21",0,0,1,0,0,1,0,0
"Lebanon","2024-07-22",0,0,1,0,0,1,0,0
"Lebanon","2024-07-23",0,0,1,0,0,1,0,0
"Lebanon","2024-07-24",0,0,1,0,0,1,0,0
"Lebanon","2024-07-25",0,0,1,0,0,1,0,0
"Lebanon","2024-07-26",0,0,1,0,0,1,0,0
"Lebanon","2024-07-27",0,0,1,0,0,1,0,0
"Lebanon","2024-07-28",0,0,1,0,0,1,0,0
"Lebanon","2024-07-29",0,0,1,0,0,1,0,0
"Lebanon","2024-07-30",0,0,1,0,0,1,0,0
"Lebanon","2024-07-31",0,0,1,0,0,1,0,0
"Lebanon","2024-08-01",0,0,1,0,0,1,0,0
"Lebanon","2024-08-02",0,0,1,0,0,1,0,0
"Lebanon","2024-08-03",0,0,1,0,0,1,0,0
"Lebanon","2024-08-04",0,0,1,0,0,1,0,0
"Lebanon","2024-08-05",0,0,1,0,0,1,0,0
"Lebanon","2024-08-06",0,0,1,0,0,1,0,0
"Lebanon","2024-08-07",0,0,1,0,0,1,0,0
"Lebanon","2024-08-08",0,0,1,0,0,1,0,0
"Lebanon","2024-08-09",0,0,1,0,0,1,0,0
"Lebanon","2024-08-10",0,0,1,0,0,1,0,0
"Lebanon","2024-08-11",0,0,1,0,0,1,0,0
"Lebanon","2024-08-12",0,0,1,0,0,1,0,0
"Lebanon","2024-08-13",0,0,1,0,0,1,0,0
"Lebanon","2024-08-14",0,0,1,0,0,1,0,0
"Lebanon","2024-08-15",0,0,1,0,0,1,0,0
"Lebanon","2024-08-16",0,0,1,0,0,1,0,0
"Lebanon","2024-08-17",0,0,1,0,0,1,0,0
"Lebanon","2024-08-18",0,0,1,0,0,1,0,0
"Lebanon","2024-08-19",0,0,1,0,0,1,0,0
"Lebanon","2024-08-20",0,0,1,0,0,1,0,0
"Lebanon","2024-08-21",0,0,1,0,0,1,0,0
"Lebanon","2024-08-22",0,0,1,0,0,1,0,0
"Lebanon","2024-08-23",0,0,1,0,0,1,0,0
"Lebanon","2024-08-24",0,0,1,0,0,1,0,0
"Lebanon","2024-08-25",0,0,1,0,0,1,0,0
"Lebanon","2024-08-26",0,0,1,0,0,1,0,0
"Lebanon","2024-08-27",0,0,1,0,0,1,0,0
"Lebanon","2024-08-28",0,0,1,0,0,1,0,0
"Lebanon","2024-08-29",0,0,1,0,0,1,0,0
"Lebanon","2024-08-30",0,0,1,0,0,1,0,0
"Lebanon","2024-08-31",0,0,1,0,0,1,0,0
"Lebanon","2024-09-01",0,0,1,0,0,1,0,0
"Lebanon","2024-09-02",0,0,1,0,0,1,0,0
"Lebanon","2024-09-03",0,0,1,0,0,1,0,0
"Lebanon","2024-09-04",0,0,1,0,0,1,0,0
"Lebanon","2024-09-05",0,0,1,0,0,1,0,0
"Lebanon","2024-09-06",0,0,1,0,0,1,0,0
"Lebanon","2024-09-07",0,0,1,0,0,1,0,0
"Lebanon","2024-09-08",0,0,1,0,0,1,0,0
"Lebanon","2024-09-09",0,0,1,0,0,1,0,0
"Lebanon","2024-09-10",0,0,1,0,0,1,0,0
"Lebanon","2024-09-11",0,0,1,0,0,1,0,0
"Lebanon","2024-09-12",0,0,1,0,0,1,0,0
"Lebanon","2024-09-13",0,0,1,0,0,1,0,0
"Lebanon","2024-09-14",0,0,1,0,0,1,0,0
"Lebanon","2024-09-15",0,0,1,0,0,1,0,0
"Lebanon","2024-09-16",0,0,1,0,0,1,0,0
"Lebanon","2024-09-17",0,0,1,0,0,1,0,0
"Lebanon","2024-09-18",0,0,1,0,0,1,0,0
"Lebanon","2024-09-19",0,0,1,0,0,1,0,0
"Lebanon","2024-09-20",0,0,1,0,0,1,0,0
"Lebanon","2024-09-21",0,0,1,0,0,1,0,0
"Lebanon","2024-09-22",0,0,1,0,0,1,0,0
"Lebanon","2024-09-23",0,0,1,0,0,1,0,0
"Lebanon","2024-09-24",0,0,1,0,0,1,0,0
"Lebanon","2024-09-25",0,0,1,0,0,1,0,0
"Lebanon","2024-09-26",0,0,1,0,0,1,0,0
"Lebanon","2024-09-27",0,0,1,0,0,1,0,0
"Lebanon","2024-09-28",0,0,1,0,0,1,0,0
"Lebanon","2024-09-29",0,0,1,0,0,1,0,0
"Lebanon","2024-09-30",0,0,1,0,0,1,0,0
"Lebanon","2024-10-01",0,0,1,0,0,1,0,0
"Lebanon","2024-10-02",0,0,1,0,0,1,0,0
"Lebanon","2024-10-03",0,0,1,0,0,1,0,0
"Lebanon","2024-10-04",0,0,1,0,0,1,0,0
"Lebanon","2024-10-05",0,0,1,0,0,1,0,0
"Lebanon","2024-10-06",0,0,1,0,0,1,0,0
"Lebanon","2024-10-07",0,0,1,0,0,1,0,0
"Lebanon","2024-10-08",0,0,1,0,0,1,0,0
"Lebanon","2024-10-09",0,0,1,0,0,1,0,0
"Lebanon","2024-10-10",0,0,1,0,0,1,0,0
"Lebanon","2024-10-11",0,0,1,0,0,1,0,0
"Lebanon","2024-10-12",0,0,1,0,0,1,0,0
"Lebanon","2024-10-13",0,0,1,0,0,1,0,0
"Lebanon","2024-10-14",0,0,1,0,0,1,0,0
"Lebanon","2024-10-15",0,0,1,0,0,1,0,0
"Lebanon","2024-10-16",0,0,1,0,0,1,0,0
"Lebanon","2024-10-17",0,0,1,0,0,1,0,0
"Lebanon","2024-10-18",0,0,1,0,0,1,0,0
"Lebanon","2024-10-19",0,0,1,0,0,1,0,0
"Lebanon","2024-10-20",0,0,1,0,0,1,0,0
"Lebanon","2024-10-21",0,0,1,0,0,1,0,0
"Lebanon","2024-10-22",0,0,1,0,0,1,0,0
"Lebanon","2024-10-23",0,0,1,0,0,1,0,0
"Lebanon","2024-10-24",0,0,1,0,0,1,0,0
"Lebanon","2024-10-25",0,0,1,0,0,1,0,0
"Lebanon","2024-10-26",0,0,1,0,0,1,0,0
"Lebanon","2024-10-27",0,0,1,0,0,1,0,0
"Lebanon","2024-10-28",0,0,1,0,0,1,0,0
"Lebanon","2024-10-29",0,0,1,0,0,1,0,0
"Lebanon","2024-10-30",0,0,1,0,0,1,0,0
"Lebanon","2024-10-31",0,0,1,0,0,1,0,0
"Lebanon","2024-11-01",0,0,1,0,0,1,0,0
"Lebanon","2024-11-02",0,0,1,0,0,1,0,0
"Lebanon","2024-11-03",0,0,1,0,0,1,0,0
"Lebanon","2024-11-04",0,0,1,0,0,1,0,0
"Lebanon","2024-11-05",0,0,1,0,0,1,0,0
"Lebanon","2024-11-06",0,0,1,0,0,1,0,0
"Lebanon","2024-11-07",0,0,1,0,0,1,0,0
"Lebanon","2024-11-08",0,0,1,0,0,1,0,0
"Lebanon","2024-11-09",0,0,1,0,0,1,0,0
"Lebanon","2024-11-10",0,0,1,0,0,1,0,0
"Lebanon","2024-11-11",0,0,1,0,0,1,0,0
"Lebanon","2024-11-12",0,0,1,0,0,1,0,0
"Lebanon","2024-11-13",0,0,1,0,0,1,0,0
"Lebanon","2024-11-14",0,0,1,0,0,1,0,0
"Lebanon","2024-11-15",0,0,1,0,0,1,0,0
"Lebanon","2024-11-16",0,0,1,0,0,1,0,0
"Lebanon","2024-11-17",0,0,1,0,0,1,0,0
"Lebanon","2024-11-18",0,0,1,0,0,1,0,0
"Lebanon","2024-11-19",0,0,1,0,0,1,0,0
"Lebanon","2024-11-20",0,0,1,0,0,1,0,0
"Lebanon","2024-11-21",0,0,1,0,0,1,0,0
"Lebanon","2024-11-22",0,0,1,0,0,1,0,0
"Lebanon","2024-11-23",0,0,1,0,0,1,0,0
"Lebanon","2024-11-24",0,0,1,0,0,1,0,0
"Lebanon","2024-11-25",0,0,1,0,0,1,0,0
"Lebanon","2024-11-26",0,0,1,0,0,1,0,0
"Lebanon","2024-11-27",0,0,1,0,0,1,0,0
"Lebanon","2024-11-28",0,0,1,0,0,1,0,0
"Lebanon","2024-11-29",0,0,1,0,0,1,0,0
"Lebanon","2024-11-30",0,0,1,0,0,1,0,0
"Lebanon","2024-12-01",0,0,1,0,0,1,0,0
"Lebanon","2024-12-02",0,0,1,0,0,1,0,0
"Lebanon","2024-12-03",0,0,1,0,0,1,0,0
"Lebanon","2024-12-04",0,0,1,0,0,1,0,0
"Lebanon","2024-12-05",0,0,1,0,0,1,0,0
"Lebanon","2024-12-06",0,0,1,0,0,1,0,0
"Lebanon","2024-12-07",0,0,1,0,0,1,0,0
"Lebanon","2024-12-08",0,0,1,0,0,1,0,0
"Lebanon","2024-12-09",0,0,1,0,0,1,0,0
"Lebanon","2024-12-10",0,0,1,0,0,1,0,0
"Lebanon","2024-12-11",0,0,1,0,0,1,0,0
"Lebanon","2024-12-12",0,0,1,0,0,1,0,0
"Lebanon","2024-12-13",0,0,1,0,0,1,0,0
"Lebanon","2024-12-14",0,0,1,0,0,1,0,0
"Lebanon","2024-12-15",0,0,1,0,0,1,0,0
"Lebanon","2024-12-16",0,0,1,0,0,1,0,0
"Lebanon","2024-12-17",0,0,1,0,0,1,0,0
"Lebanon","2024-12-18",0,0,1,0,0,1,0,0
"Lebanon","2024-12-19",0,0,1,0,0,1,0,0
"Lebanon","2024-12-20",0,0,1,0,0,1,0,0
"Lebanon","2024-12-21",0,0,1,0,0,1,0,0
"Lebanon","2024-12-22",0,0,1,0,0,1,0,0
"Lebanon","2024-12-23",0,0,1,0,0,1,0,0
"Lebanon","2024-12-24",0,0,1,0,0,1,0,0
"Lebanon","2024-12-25",0,0,1,0,0,1,0,0
"Lebanon","2024-12-26",0,0,1,0,0,1,0,0
"Lebanon","2024-12-27",0,0,1,0,0,1,0,0
"Lebanon","2024-12-28",0,0,1,0,0,1,0,0
"Lebanon","2024-12-29",0,0,1,0,0,1,0,0
"Lebanon","2024-12-30",0,0,1,0,0,1,0,0
"Lebanon","2024-12-31",0,0,1,0,0,1,0,0
"Lebanon","2025-01-01",0,0,1,0,0,1,0,0
"Lebanon","2025-01-02",0,0,1,0,0,1,0,0
"Lebanon","2025-01-03",0,0,1,0,0,1,0,0
"Lebanon","2025-01-04",0,0,1,0,0,1,0,0
"Lebanon","2025-01-05",0,0,1,0,0,1,0,0
"Lebanon","2025-01-06",0,0,1,0,0,1,0,0
"Lebanon","2025-01-07",0,0,1,0,0,1,0,0
"Lebanon","2025-01-08",0,0,1,0,0,1,0,0
"Lebanon","2025-01-09",0,0,1,0,0,1,0,0
"Lebanon","2025-01-10",0,0,1,0,0,1,0,0
"Lebanon","2025-01-11",0,0,1,0,0,1,0,0
"Lebanon","2025-01-12",0,0,1,0,0,1,0,0
"Lebanon","2025-01-13",0,0,1,0,0,1,0,0
"Lebanon","2025-01-14",0,0,1,0,0,1,0,0
"Lebanon","2025-01-15",0,0,1,0,0,1,0,0
"Lebanon","2025-01-16",0,0,1,0,0,1,0,0
"Lebanon","2025-01-17",0,0,1,0,0,1,0,0
"Lebanon","2025-01-18",0,0,1,0,0,1,0,0
"Lebanon","2025-01-19",0,0,1,0,0,1,0,0
"Lebanon","2025-01-20",0,0,1,0,0,1,0,0
"Lebanon","2025-01-21",0,0,1,0,0,1,0,0
"Lebanon","2025-01-22",0,0,1,0,0,1,0,0
"Lebanon","2025-01-23",0,0,1,0,0,1,0,0
"Lebanon","2025-01-24",0,0,1,0,0,1,0,0
"Lebanon","2025-01-25",0,0,1,0,0,1,0,0
"Lebanon","2025-01-26",0,0,1,0,0,1,0,0
"Lebanon","2025-01-27",0,0,1,0,0,1,0,0
"Lebanon","2025-01-28",0,0,1,0,0,1,0,0
"Lebanon","2025-01-29",0,0,1,0,0,1,0,0
"Lebanon","2025-01-30",0,0,1,0,0,1,0,0
"Lebanon","2025-01-31",0,0,1,0,0,1,0,0
"Lebanon","2025-02-01",0,0,1,0,0,1,0,0
"Lebanon","2025-02-02",0,0,1,0,0,1,0,0
"Lebanon","2025-02-03",0,0,1,0,0,1,0,0
"Liberia","2024-01-01",0,0,0,0,0,0,0,0
"Liberia","2024-01-02",0,0,0,0,0,0,0,0
"Liberia","2024-01-03",0,0,0,0,0,0,0,0
"Liberia","2024-01-04",0,0,0,0,0,0,0,0
"Liberia","2024-01-05",0,0,0,0,0,0,0,0
"Liberia","2024-01-06",0,0,0,0,0,0,0,0
"Liberia","2024-01-07",0,0,0,0,0,0,0,0
"Liberia","2024-01-08",0,0,0,0,0,0,0,0
"Liberia","2024-01-09",0,0,0,0,0,0,0,0
"Liberia","2024-01-10",0,0,0,0,0,0,0,0
"Liberia","2024-01-11",0,0,0,0,0,0,0,0
"Liberia","2024-01-12",0,0,0,0,0,0,0,0
"Liberia","2024-01-13",0,0,0,0,0,0,0,0
"Liberia","2024-01-14",0,1,1,0,1,1,0,0
"Liberia","2024-01-15",0,0,1,0,0,1,0,0
"Liberia","2024-01-16",0,0,1,0,0,1,0,0
"Liberia","2024-01-17",0,0,1,0,0,1,0,0
"Liberia","2024-01-18",0,0,1,0,0,1,0,0
"Liberia","2024-01-19",0,0,1,0,0,1,0,0
"Liberia","2024-01-20",0,0,1,0,0,1,0,0
"Liberia","2024-01-21",0,0,1,0,0,1,0,0
"Liberia","2024-01-22",0,0,1,0,0,1,0,0
"Liberia","2024-01-23",0,0,1,0,0,1,0,0
"Liberia","2024-01-24",0,0,1,0,0,1,0,0
"Liberia","2024-01-25",0,0,1,0,1,2,0,0
"Liberia","2024-01-26",0,0,1,0,0,2,0,0
"Liberia","2024-01-27",0,0,1,0,0,2,0,0
"Liberia","2024-01-28",0,0,1,0,0,2,0,0
"Liberia","2024-01-29",0,0,1,0,0,2,0,0
"Liberia","2024-01-30",0,0,1,0,0,2,0,0
"Liberia","2024-01-31",0,0,1,0,0,2,0,0
"Liberia","2024-02-01",0,0,1,0,0,2,0,0
"Liberia","2024-02-02",0,0,1,0,0,2,0,0
"Liberia","2024-02-03",0,0,1,0,0,2,0,0
"Liberia","2024-02-04",0,1,2,0,0,2,0,0
"Liberia","2024-02-05",0,0,2,0,0,2,0,0
"Liberia","2024-02-06",0,0,2,0,0,2,0,0
"Liberia","2024-02-07",0,0,2,0,0,2,0,0
"Liberia","2024-02-08",0,0,2,0,0,2,0,0
"Liberia","2024-02-09",0,0,2,0,0,2,0,0
"Liberia","2024-02-10",0,0,2,0,0,2,0,0
"Liberia","2024-02-11",0,0,2,0,0,2,0,0
"Liberia","2024-02-12",0,0,2,0,1,3,0,0
"Liberia","2024-02-13",0,0,2,0,0,3,0,0
"Liberia","2024-02-14",0,0,2,0,0,3,0,0
"Liberia","2024-02-15",0,0,2,0,0,3,0,0
"Liberia","2024-02-16",0,0,2,0,0,3,0,0
"Liberia","2024-02-17",0,0,2,0,0,3,0,0
"Liberia","2024-02-18",0,1,3,0,0,3,0,0
"Liberia","2024-02-19",0,0,3,0,0,3,0,0
"Liberia","2024-02-20",0,0,3,0,0,3,0,0
"Liberia","2024-02-21",0,0,3,0,0,3,0,0
"Liberia","2024-02-22",0,0,3,0,0,3,0,0
"Liberia","2024-02-23",0,0,3,0,0,3,0,0
"Liberia","2024-02-24",0,0,3,0,0,3,0,0
"Liberia","2024-02-25",0,0,3,0,0,3,0,0
"Liberia","2024-02-26",0,0,3,0,0,3,0,0
"Liberia","2024-02-27",0,0,3,0,0,3,0,0
"Liberia","2024-02-28",0,0,3,0,0,3,0,0
"Liberia","2024-02-29",0,0,3,0,1,4,0,0
"Liberia","2024-03-01",0,0,3,0,0,4,0,0
"Liberia","2024-03-02",0,0,3,0,0,4,0,0
"Liberia","2024-03-03",0,0,3,0,0,4,0,0
"Liberia","2024-03-04",0,0,3,0,0,4,0,0
"Liberia","2024-03-05",0,0,3,0,0,4,0,0
"Liberia","2024-03-06",0,0,3,0,0,4,0,0
"Liberia","2024-03-07",0,0,3,0,0,4,0,0
"Liberia","2024-03-08",0,0,3,0,0,4,0,0
"Liberia","2024-03-09",0,0,3,0,0,4,0,0
"Liberia","2024-03-10",0,1,4,0,0,4,0,0
"Liberia","2024-03-11",0,0,4,0,0,4,0,0
"Liberia","2024-03-12",0,0,4,0,0,4,0,0
"Liberia","2024-03-13",0,0,4,0,0,4,0,0
"Liberia","2024-03-14",0,0,4,0,0,4,0,0
"Liberia","2024-03-15",0,0,4,0,0,4,0,0
"Liberia","2024-03-16",0,0,4,0,0,4,0,0
"Liberia","2024-03-17",0,0,4,0,0,4,0,0
"Liberia","2024-03-18",0,0,4,0,0,4,0,0
"Liberia","2024-03-19",0,0,4,0,0,4,0,0
"Liberia","2024-03-20",0,0,4,0,0,4,0,0
"Liberia","2024-03-21",0,0,4,0,1,5,0,0
"Liberia","2024-03-22",0,0,4,0,0,5,0,0
"Liberia","2024-03-23",0,0,4,0,0,5,0,0
"Liberia","2024-03-24",0,0,4,0,0,5,0,0
"Liberia","2024-03-25",0,0,4,0,0,5,0,0
"Liberia","2024-03-26",0,0,4,0,0,5,0,0
"Liberia","2024-03-27",0,0,4,0,0,5,0,0
"Liberia","2024-03-28",0,0,4,0,0,5,0,0
"Liberia","2024-03-29",0,0,4,0,0,5,0,0
"Liberia","2024-03-30",0,0,4,0,0,5,0,0
"Liberia","2024-03-31",0,1,5,0,0,5,0,0
"Liberia","2024-04-01",0,0,5,0,0,5,0,0
"Liberia","2024-04-02",0,0,5,0,0,5,0,0
"Liberia","2024-04-03",0,0,5,0,0,5,0,0
"Liberia","2024-04-04",0,0,5,0,0,5,0,0
"Liberia","2024-04-05",0,0,5,0,0,5,0,0
"Liberia","2024-04-06",0,0,5,0,0,5,0,0
"Liberia","2024-04-07",0,0,5,0,0,5,0,0
"Liberia","2024-04-08",0,0,5,0,0,5,0,0
"Liberia","2024-04-09",0,0,5,0,0,5,0,0
"Liberia","2024-04-10",0,0,5,0,0,5,0,0
"Liberia","2024-04-11",0,0,5,0,0,5,0,0
"Liberia","2024-04-12",0,0,5,0,0,5,0,0
"Liberia","2024-04-13",0,0,5,0,0,5,0,0
"Liberia","2024-04-14",0,0,5,0,0,5,0,0
"Liberia","2024-04-15",0,0,5,0,0,5,0,0
"Liberia","2024-04-16",0,0,5,0,0,5,0,0
"Liberia","2024-04-17",0,0,5,0,0,5,0,0
"Liberia","2024-04-18",0,0,5,0,0,5,0,0
"Liberia","2024-04-19",0,0,5,0,0,5,0,0
"Liberia","2024-04-20",0,0,5,0,0,5,0,0
"Liberia","2024-04-21",0,0,5,0,0,5,0,0
"Liberia","2024-04-22",0,0,5,0,0,5,0,0
"Liberia","2024-04-23",0,0,5,0,0,5,0,0
"Liberia","2024-04-24",0,0,5,0,0,5,0,0
"Liberia","2024-04-25",0,0,5,0,0,5,0,0
"Liberia","2024-04-26",0,0,5,0,0,5,0,0
"Liberia","2024-04-27",0,0,5,0,0,5,0,0
"Liberia","2024-04-28",0,0,5,0,0,5,0,0
"Liberia","2024-04-29",0,0,5,0,0,5,0,0
"Liberia","2024-04-30",0,0,5,0,0,5,0,0
"Liberia","2024-05-01",0,0,5,0,0,5,0,0
"Liberia","2024-05-02",0,0,5,0,0,5,0,0
"Liberia","2024-05-03",0,0,5,0,0,5,0,0
"Liberia","2024-05-04",0,0,5,0,0,5,0,0
"Liberia","2024-05-05",0,0,5,0,0,5,0,0
"Liberia","2024-05-06",0,0,5,0,0,5,0,0
"Liberia","2024-05-07",0,0,5,0,0,5,0,0
"Liberia","2024-05-08",0,0,5,0,0,5,0,0
"Liberia","2024-05-09",0,0,5,0,0,5,0,0
"Liberia","2024-05-10",0,0,5,0,0,5,0,0
"Liberia","2024-05-11",0,0,5,0,0,5,0,0
"Liberia","2024-05-12",0,0,5,0,0,5,0,0
"Liberia","2024-05-13",0,0,5,0,0,5,0,0
"Liberia","2024-05-14",0,0,5,0,0,5,0,0
"Liberia","2024-05-15",0,0,5,0,0,5,0,0
"Liberia","2024-05-16",0,0,5,0,0,5,0,0
"Liberia","2024-05-17",0,0,5,0,0,5,0,0
"Liberia","2024-05-18",0,0,5,0,0,5,0,0
"Liberia","2024-05-19",0,0,5,0,0,5,0,0
"Liberia","2024-05-20",0,0,5,0,0,5,0,0
"Liberia","2024-05-21",0,0,5,0,0,5,0,0
"Liberia","2024-05-22",0,0,5,0,0,5,0,0
"Liberia","2024-05-23",0,0,5,0,0,5,0,0
"Liberia","2024-05-24",0,0,5,0,0,5,0,0
"Liberia","2024-05-25",0,0,5,0,0,5,0,0
"Liberia","2024-05-26",0,0,5,0,0,5,0,0
"Liberia","2024-05-27",0,0,5,0,0,5,0,0
"Liberia","2024-05-28",0,0,5,0,0,5,0,0
"Liberia","2024-05-29",0,0,5,0,0,5,0,0
"Liberia","2024-05-30",0,0,5,0,0,5,0,0
"Liberia","2024-05-31",0,0,5,0,0,5,0,0
"Liberia","2024-06-01",0,0,5,0,0,5,0,0
"Liberia","2024-06-02",0,0,5,0,0,5,0,0
"Liberia","2024-06-03",0,0,5,0,0,5,0,0
"Liberia","2024-06-04",0,0,5,0,0,5,0,0
"Liberia","2024-06-05",0,0,5,0,0,5,0,0
"Liberia","2024-06-06",0,0,5,0,1,6,0,0
"Liberia","2024-06-07",0,0,5,0,0,6,0,0
"Liberia","2024-06-08",0,0,5,0,0,6,0,0
"Liberia","2024-06-09",0,0,5,0,0,6,0,0
"Liberia","2024-06-10",0,0,5,0,0,6,0,0
"Liberia","2024-06-11",0,0,5,0,0,6,0,0
"Liberia","2024-06-12",0,0,5,0,0,6,0,0
"Liberia","2024-06-13",0,0,5,0,0,6,0,0
"Liberia","2024-06-14",0,0,5,0,0,6,0,0
"Liberia","2024-06-15",0,0,5,0,0,6,0,0
"Liberia","2024-06-16",0,0,5,0,0,6,0,0
"Liberia","2024-06-17",0,0,5,0,0,6,0,0
"Liberia","2024-06-18",0,0,5,0,0,6,0,0
"Liberia","2024-06-19",0,0,5,0,0,6,0,0
"Liberia","2024-06-20",0,0,5,0,0,6,0,0
"Liberia","2024-06-21",0,0,5,0,0,6,0,0
"Liberia","2024-06-22",0,0,5,0,0,6,0,0
"Liberia","2024-06-23",0,0,5,0,0,6,0,0
"Liberia","2024-06-24",0,0,5,0,0,6,0,0
"Liberia","2024-06-25",0,0,5,0,0,6,0,0
"Liberia","2024-06-26",0,0,5,0,0,6,0,0
"Liberia","2024-06-27",0,0,5,0,0,6,0,0
"Liberia","2024-06-28",0,0,5,0,0,6,0,0
"Liberia","2024-06-29",0,0,5,0,0,6,0,0
"Liberia","2024-06-30",0,0,5,0,0,6,0,0
"Liberia","2024-07-01",0,0,5,0,0,6,0,0
"Liberia","2024-07-02",0,0,5,0,0,6,0,0
"Liberia","2024-07-03",0,0,5,0,0,6,0,0
"Liberia","2024-07-04",0,0,5,0,0,6,0,0
"Liberia","2024-07-05",0,0,5,0,0,6,0,0
"Liberia","2024-07-06",0,0,5,0,0,6,0,0
"Liberia","2024-07-07",0,0,5,0,0,6,0,0
"Liberia","2024-07-08",0,0,5,0,0,6,0,0
"Liberia","2024-07-09",0,0,5,0,0,6,0,0
"Liberia","2024-07-10",0,0,5,0,0,6,0,0
"Liberia","2024-07-11",0,0,5,0,0,6,0,0
"Liberia","2024-07-12",0,0,5,0,0,6,0,0
"Liberia","2024-07-13",0,0,5,0,0,6,0,0
"Liberia","2024-07-14",0,0,5,0,0,6,0,0
"Liberia","2024-07-15",0,0,5,0,0,6,0,0
"Liberia","2024-07-16",0,0,5,0,0,6,0,0
"Liberia","2024-07-17",0,0,5,0,0,6,0,0
"Liberia","2024-07-18",0,0,5,0,0,6,0,0
"Liberia","2024-07-19",0,0,5,0,0,6,0,0
"Liberia","2024-07-20",0,0,5,0,0,6,0,0
"Liberia","2024-07-21",0,0,5,0,0,6,0,0
"Liberia","2024-07-22",0,0,5,0,0,6,0,0
"Liberia","2024-07-23",0,0,5,0,0,6,0,0
"Liberia","2024-07-24",0,0,5,0,0,6,0,0
"Liberia","2024-07-25",0,0,5,0,0,6,0,0
"Liberia","2024-07-26",0,0,5,0,0,6,0,0
"Liberia","2024-07-27",0,0,5,0,0,6,0,0
"Liberia","2024-07-28",0,0,5,0,0,6,0,0
"Liberia","2024-07-29",0,0,5,0,0,6,0,0
"Liberia","2024-07-30",0,0,5,0,0,6,0,0
"Liberia","2024-07-31",0,0,5,0,0,6,0,0
"Liberia","2024-08-01",0,0,5,0,0,6,0,0
"Liberia","2024-08-02",0,0,5,0,0,6,0,0
"Liberia","2024-08-03",0,0,5,0,0,6,0,0
"Liberia","2024-08-04",0,0,5,0,0,6,0,0
"Liberia","2024-08-05",0,0,5,0,0,6,0,0
"Liberia","2024-08-06",0,0,5,0,0,6,0,0
"Liberia","2024-08-07",0,0,5,0,0,6,0,0
"Liberia","2024-08-08",0,0,5,0,0,6,0,0
"Liberia","2024-08-09",0,0,5,0,0,6,0,0
"Liberia","2024-08-10",0,0,5,0,0,6,0,0
"Liberia","2024-08-11",0,1,6,0,0,6,0,0
"Liberia","2024-08-12",0,0,6,0,0,6,0,0
"Liberia","2024-08-13",0,0,6,0,0,6,0,0
"Liberia","2024-08-14",0,0,6,0,0,6,0,0
"Liberia","2024-08-15",0,0,6,0,0,6,0,0
"Liberia","2024-08-16",0,0,6,0,0,6,0,0
"Liberia","2024-08-17",0,0,6,0,0,6,0,0
"Liberia","2024-08-18",0,0,6,0,0,6,0,0
"Liberia","2024-08-19",0,0,6,0,0,6,0,0
"Liberia","2024-08-20",0,0,6,0,0,6,0,0
"Liberia","2024-08-21",0,0,6,0,0,6,0,0
"Liberia","2024-08-22",0,0,6,0,1,7,0,0
"Liberia","2024-08-23",0,0,6,0,0,7,0,0
"Liberia","2024-08-24",0,0,6,0,0,7,0,0
"Liberia","2024-08-25",0,0,6,0,0,7,0,0
"Liberia","2024-08-26",0,0,6,0,0,7,0,0
"Liberia","2024-08-27",0,0,6,0,0,7,0,0
"Liberia","2024-08-28",0,0,6,0,0,7,0,0
"Liberia","2024-08-29",0,0,6,0,0,7,0,0
"Liberia","2024-08-30",0,0,6,0,0,7,0,0
"Liberia","2024-08-31",0,0,6,0,0,7,0,0
"Liberia","2024-09-01",0,1,7,0,0,7,0,0
"Liberia","2024-09-02",0,0,7,0,0,7,0,0
"Liberia","2024-09-03",0,0,7,0,1,8,0,0
"Liberia","2024-09-04",0,0,7,0,0,8,0,0
"Liberia","2024-09-05",0,0,7,0,0,8,0,0
"Liberia","2024-09-06",0,0,7,0,0,8,0,0
"Liberia","2024-09-07",0,0,7,0,1,9,0,0
"Liberia","2024-09-08",85,2,9,85,0,9,85,85
"Liberia","2024-09-09",0,0,9,85,0,9,6,91
"Liberia","2024-09-10",0,0,9,85,1,10,5,96
"Liberia","2024-09-11",0,0,9,85,0,10,6,102
"Liberia","2024-09-12",0,0,9,85,1,11,6,108
"Liberia","2024-09-13",0,0,9,85,0,11,5,113
"Liberia","2024-09-14",0,0,9,85,1,12,6,119
"Liberia","2024-09-15",0,3,12,85,0,12,6,125
"Liberia","2024-09-16",0,0,12,85,0,12,5,130
"Liberia","2024-09-17",0,0,12,85,0,12,6,136
"Liberia","2024-09-18",0,0,12,85,0,12,5,141
"Liberia","2024-09-19",0,0,12,85,1,13,6,147
"Liberia","2024-09-20",0,0,12,85,0,13,6,153
"Liberia","2024-09-21",0,0,12,85,0,13,5,158
"Liberia","2024-09-22",79,0,12,164,0,13,6,164
"Liberia","2024-09-23",0,0,12,164,0,13,1,165
"Liberia","2024-09-24",0,0,12,164,0,13,1,166
"Liberia","2024-09-25",0,0,12,164,0,13,0,166
"Liberia","2024-09-26",0,0,12,164,1,14,1,167
"Liberia","2024-09-27",0,0,12,164,0,14,1,168
"Liberia","2024-09-28",0,0,12,164,0,14,1,169
"Liberia","2024-09-29",0,2,14,164,0,14,1,170
"Liberia","2024-09-30",0,0,14,164,0,14,1,171
"Liberia","2024-10-01",0,0,14,164,1,15,0,171
"Liberia","2024-10-02",0,0,14,164,0,15,1,172
"Liberia","2024-10-03",0,0,14,164,0,15,1,173
"Liberia","2024-10-04",0,0,14,164,0,15,1,174
"Liberia","2024-10-05",0,0,14,164,1,16,1,175
"Liberia","2024-10-06",0,0,14,164,0,16,1,176
"Liberia","2024-10-07",0,0,14,164,0,16,0,176
"Liberia","2024-10-08",0,0,14,164,1,17,1,177
"Liberia","2024-10-09",0,0,14,164,0,17,1,178
"Liberia","2024-10-10",0,0,14,164,0,17,1,179
"Liberia","2024-10-11",0,0,14,164,0,17,1,180
"Liberia","2024-10-12",0,0,14,164,1,18,0,180
"Liberia","2024-10-13",0,4,18,164,0,18,1,181
"Liberia","2024-10-14",0,0,18,164,0,18,1,182
"Liberia","2024-10-15",0,0,18,164,0,18,1,183
"Liberia","2024-10-16",0,0,18,164,0,18,1,184
"Liberia","2024-10-17",0,0,18,164,1,19,1,185
"Liberia","2024-10-18",0,0,18,164,0,19,0,185
"Liberia","2024-10-19",0,0,18,164,0,19,1,186
"Liberia","2024-10-20",23,1,19,187,0,19,1,187
"Liberia","2024-10-21",47,0,19,234,0,19,47,234
"Liberia","2024-10-22",0,0,19,234,0,19,1,235
"Liberia","2024-10-23",0,0,19,234,0,19,2,237
"Liberia","2024-10-24",0,0,19,234,1,20,1,238
"Liberia","2024-10-25",0,0,19,234,0,20,1,239
"Liberia","2024-10-26",0,0,19,234,0,20,2,241
"Liberia","2024-10-27",0,1,20,234,0,20,1,242
"Liberia","2024-10-28",0,0,20,234,0,20,1,243
"Liberia","2024-10-29",0,0,20,234,1,21,1,244
"Liberia","2024-10-30",0,0,20,234,0,21,2,246
"Liberia","2024-10-31",0,0,20,234,1,22,1,247
"Liberia","2024-11-01",0,0,20,234,0,22,1,248
"Liberia","2024-11-02",0,0,20,234,1,23,2,250
"Liberia","2024-11-03",17,3,23,251,0,23,1,251
"Liberia","2024-11-04",0,0,23,251,3,26,2,253
"Liberia","2024-11-05",0,0,23,251,2,28,3,256
"Liberia","2024-11-06",0,0,23,251,3,31,2,258
"Liberia","2024-11-07",0,0,23,251,2,33,2,260
"Liberia","2024-11-08",0,0,23,251,3,36,3,263
"Liberia","2024-11-09",0,0,23,251,2,38,2,265
"Liberia","2024-11-10",0,18,41,251,3,41,2,267
"Liberia","2024-11-11",0,0,41,251,0,41,2,269
"Liberia","2024-11-12",0,0,41,251,0,41,3,272
"Liberia","2024-11-13",23,0,41,274,0,41,2,274
"Liberia","2024-11-14",0,0,41,274,1,42,0,274
"Liberia","2024-11-15",0,0,41,274,0,42,0,274
"Liberia","2024-11-16",0,0,41,274,0,42,0,274
"Liberia","2024-11-17",0,1,42,274,0,42,0,274
"Liberia","2024-11-18",0,0,42,274,1,43,0,274
"Liberia","2024-11-19",0,0,42,274,2,45,0,274
"Liberia","2024-11-20",0,0,42,274,1,46,0,274
"Liberia","2024-11-21",0,0,42,274,1,47,0,274
"Liberia","2024-11-22",0,0,42,274,1,48,0,274
"Liberia","2024-11-23",0,0,42,274,2,50,0,274
"Liberia","2024-11-24",0,9,51,274,1,51,0,274
"Liberia","2024-11-25",0,0,51,274,2,53,0,274
"Liberia","2024-11-26",0,0,51,274,1,54,0,274
"Liberia","2024-11-27",0,0,51,274,2,56,0,274
"Liberia","2024-11-28",0,0,51,274,1,57,0,274
"Liberia","2024-11-29",0,0,51,274,2,59,0,274
"Liberia","2024-11-30",0,0,51,274,1,60,0,274
"Liberia","2024-12-01",0,11,62,274,2,62,0,274
"Liberia","2024-12-02",0,0,62,274,0,62,0,274
"Liberia","2024-12-03",0,0,62,274,0,62,0,274
"Liberia","2024-12-04",0,0,62,274,0,62,0,274
"Liberia","2024-12-05",0,0,62,274,1,63,0,274
"Liberia","2024-12-06",0,0,62,274,0,63,0,274
"Liberia","2024-12-07",0,0,62,274,0,63,0,274
"Liberia","2024-12-08",0,1,63,274,0,63,0,274
"Liberia","2024-12-09",0,0,63,274,0,63,0,274
"Liberia","2024-12-10",0,0,63,274,0,63,0,274
"Liberia","2024-12-11",0,0,63,274,0,63,0,274
"Liberia","2024-12-12",0,0,63,274,0,63,0,274
"Liberia","2024-12-13",0,0,63,274,0,63,0,274
"Liberia","2024-12-14",0,0,63,274,0,63,0,274
"Liberia","2024-12-15",0,0,63,274,0,63,0,274
"Liberia","2024-12-16",0,0,63,274,0,63,0,274
"Liberia","2024-12-17",0,0,63,274,0,63,0,274
"Liberia","2024-12-18",0,0,63,274,0,63,0,274
"Liberia","2024-12-19",0,0,63,274,0,63,0,274
"Liberia","2024-12-20",0,0,63,274,0,63,0,274
"Liberia","2024-12-21",0,0,63,274,0,63,0,274
"Liberia","2024-12-22",0,0,63,274,0,63,0,274
"Liberia","2024-12-23",0,0,63,274,0,63,0,274
"Liberia","2024-12-24",0,0,63,274,0,63,0,274
"Liberia","2024-12-25",0,0,63,274,0,63,0,274
"Liberia","2024-12-26",0,0,63,274,0,63,0,274
"Liberia","2024-12-27",0,0,63,274,0,63,0,274
"Liberia","2024-12-28",0,0,63,274,0,63,0,274
"Liberia","2024-12-29",0,0,63,274,0,63,0,274
"Liberia","2024-12-30",0,0,63,274,1,64,0,274
"Liberia","2024-12-31",0,0,63,274,0,64,0,274
"Liberia","2025-01-01",0,0,63,274,0,64,0,274
"Liberia","2025-01-02",0,0,63,274,0,64,0,274
"Liberia","2025-01-03",0,0,63,274,0,64,0,274
"Liberia","2025-01-04",0,0,63,274,0,64,0,274
"Liberia","2025-01-05",0,0,63,274,0,64,0,274
"Liberia","2025-01-06",0,0,63,274,0,64,0,274
"Liberia","2025-01-07",0,0,63,274,0,64,0,274
"Liberia","2025-01-08",0,0,63,274,0,64,0,274
"Liberia","2025-01-09",0,0,63,274,0,64,0,274
"Liberia","2025-01-10",0,0,63,274,0,64,0,274
"Liberia","2025-01-11",0,0,63,274,0,64,0,274
"Liberia","2025-01-12",0,0,63,274,0,64,0,274
"Liberia","2025-01-13",0,0,63,274,0,64,0,274
"Liberia","2025-01-14",0,0,63,274,0,64,0,274
"Liberia","2025-01-15",0,0,63,274,0,64,0,274
"Liberia","2025-01-16",0,0,63,274,0,64,0,274
"Liberia","2025-01-17",0,0,63,274,0,64,0,274
"Liberia","2025-01-18",0,0,63,274,0,64,0,274
"Liberia","2025-01-19",0,1,64,274,0,64,0,274
"Liberia","2025-01-20",0,0,64,274,0,64,0,274
"Liberia","2025-01-21",0,0,64,274,0,64,0,274
"Liberia","2025-01-22",0,0,64,274,0,64,0,274
"Liberia","2025-01-23",0,0,64,274,0,64,0,274
"Liberia","2025-01-24",0,0,64,274,0,64,0,274
"Liberia","2025-01-25",0,0,64,274,0,64,0,274
"Liberia","2025-01-26",0,0,64,274,0,64,0,274
"Liberia","2025-01-27",0,0,64,274,0,64,0,274
"Liberia","2025-01-28",0,0,64,274,0,64,0,274
"Liberia","2025-01-29",0,0,64,274,0,64,0,274
"Liberia","2025-01-30",0,0,64,274,0,64,0,274
"Liberia","2025-01-31",0,0,64,274,0,64,0,274
"Liberia","2025-02-01",0,0,64,274,0,64,0,274
"Liberia","2025-02-02",0,0,64,274,0,64,0,274
"Liberia","2025-02-03",0,0,64,274,0,64,0,274
"Lithuania","2024-01-01",0,0,0,0,0,0,0,0
"Lithuania","2024-01-02",0,0,0,0,0,0,0,0
"Lithuania","2024-01-03",0,0,0,0,0,0,0,0
"Lithuania","2024-01-04",0,0,0,0,0,0,0,0
"Lithuania","2024-01-05",0,0,0,0,0,0,0,0
"Lithuania","2024-01-06",0,0,0,0,0,0,0,0
"Lithuania","2024-01-07",0,0,0,0,0,0,0,0
"Lithuania","2024-01-08",0,0,0,0,0,0,0,0
"Lithuania","2024-01-09",0,0,0,0,0,0,0,0
"Lithuania","2024-01-10",0,0,0,0,0,0,0,0
"Lithuania","2024-01-11",0,0,0,0,0,0,0,0
"Lithuania","2024-01-12",0,0,0,0,0,0,0,0
"Lithuania","2024-01-13",0,0,0,0,0,0,0,0
"Lithuania","2024-01-14",0,0,0,0,0,0,0,0
"Lithuania","2024-01-15",0,0,0,0,0,0,0,0
"Lithuania","2024-01-16",0,0,0,0,0,0,0,0
"Lithuania","2024-01-17",0,0,0,0,0,0,0,0
"Lithuania","2024-01-18",0,0,0,0,0,0,0,0
"Lithuania","2024-01-19",0,0,0,0,0,0,0,0
"Lithuania","2024-01-20",0,0,0,0,0,0,0,0
"Lithuania","2024-01-21",0,0,0,0,0,0,0,0
"Lithuania","2024-01-22",0,0,0,0,0,0,0,0
"Lithuania","2024-01-23",0,0,0,0,0,0,0,0
"Lithuania","2024-01-24",0,0,0,0,0,0,0,0
"Lithuania","2024-01-25",0,0,0,0,0,0,0,0
"Lithuania","2024-01-26",0,0,0,0,0,0,0,0
"Lithuania","2024-01-27",0,0,0,0,0,0,0,0
"Lithuania","2024-01-28",0,0,0,0,0,0,0,0
"Lithuania","2024-01-29",0,0,0,0,0,0,0,0
"Lithuania","2024-01-30",0,0,0,0,0,0,0,0
"Lithuania","2024-01-31",0,0,0,0,0,0,0,0
"Lithuania","2024-02-01",0,0,0,0,0,0,0,0
"Lithuania","2024-02-02",0,0,0,0,0,0,0,0
"Lithuania","2024-02-03",0,0,0,0,0,0,0,0
"Lithuania","2024-02-04",0,0,0,0,0,0,0,0
"Lithuania","2024-02-05",0,0,0,0,0,0,0,0
"Lithuania","2024-02-06",0,0,0,0,0,0,0,0
"Lithuania","2024-02-07",0,0,0,0,0,0,0,0
"Lithuania","2024-02-08",0,0,0,0,0,0,0,0
"Lithuania","2024-02-09",0,0,0,0,0,0,0,0
"Lithuania","2024-02-10",0,0,0,0,0,0,0,0
"Lithuania","2024-02-11",0,0,0,0,0,0,0,0
"Lithuania","2024-02-12",0,0,0,0,0,0,0,0
"Lithuania","2024-02-13",0,0,0,0,0,0,0,0
"Lithuania","2024-02-14",0,0,0,0,0,0,0,0
"Lithuania","2024-02-15",0,0,0,0,0,0,0,0
"Lithuania","2024-02-16",0,0,0,0,0,0,0,0
"Lithuania","2024-02-17",0,0,0,0,0,0,0,0
"Lithuania","2024-02-18",0,0,0,0,0,0,0,0
"Lithuania","2024-02-19",0,0,0,0,0,0,0,0
"Lithuania","2024-02-20",0,0,0,0,0,0,0,0
"Lithuania","2024-02-21",0,0,0,0,0,0,0,0
"Lithuania","2024-02-22",0,0,0,0,0,0,0,0
"Lithuania","2024-02-23",0,0,0,0,0,0,0,0
"Lithuania","2024-02-24",0,0,0,0,0,0,0,0
"Lithuania","2024-02-25",0,0,0,0,0,0,0,0
"Lithuania","2024-02-26",0,0,0,0,0,0,0,0
"Lithuania","2024-02-27",0,0,0,0,0,0,0,0
"Lithuania","2024-02-28",0,0,0,0,0,0,0,0
"Lithuania","2024-02-29",0,0,0,0,0,0,0,0
"Lithuania","2024-03-01",0,0,0,0,0,0,0,0
"Lithuania","2024-03-02",0,0,0,0,0,0,0,0
"Lithuania","2024-03-03",0,0,0,0,0,0,0,0
"Lithuania","2024-03-04",0,0,0,0,0,0,0,0
"Lithuania","2024-03-05",0,0,0,0,0,0,0,0
"Lithuania","2024-03-06",0,0,0,0,0,0,0,0
"Lithuania","2024-03-07",0,0,0,0,0,0,0,0
"Lithuania","2024-03-08",0,0,0,0,0,0,0,0
"Lithuania","2024-03-09",0,0,0,0,0,0,0,0
"Lithuania","2024-03-10",0,0,0,0,0,0,0,0
"Lithuania","2024-03-11",0,0,0,0,0,0,0,0
"Lithuania","2024-03-12",0,0,0,0,0,0,0,0
"Lithuania","2024-03-13",0,0,0,0,0,0,0,0
"Lithuania","2024-03-14",0,0,0,0,0,0,0,0
"Lithuania","2024-03-15",0,0,0,0,0,0,0,0
"Lithuania","2024-03-16",0,0,0,0,0,0,0,0
"Lithuania","2024-03-17",0,0,0,0,0,0,0,0
"Lithuania","2024-03-18",0,0,0,0,0,0,0,0
"Lithuania","2024-03-19",0,0,0,0,0,0,0,0
"Lithuania","2024-03-20",0,0,0,0,0,0,0,0
"Lithuania","2024-03-21",0,0,0,0,0,0,0,0
"Lithuania","2024-03-22",0,0,0,0,0,0,0,0
"Lithuania","2024-03-23",0,0,0,0,0,0,0,0
"Lithuania","2024-03-24",0,0,0,0,0,0,0,0
"Lithuania","2024-03-25",0,0,0,0,0,0,0,0
"Lithuania","2024-03-26",0,0,0,0,0,0,0,0
"Lithuania","2024-03-27",0,0,0,0,0,0,0,0
"Lithuania","2024-03-28",0,0,0,0,0,0,0,0
"Lithuania","2024-03-29",0,0,0,0,0,0,0,0
"Lithuania","2024-03-30",0,0,0,0,0,0,0,0
"Lithuania","2024-03-31",0,0,0,0,0,0,0,0
"Lithuania","2024-04-01",0,0,0,0,0,0,0,0
"Lithuania","2024-04-02",0,0,0,0,0,0,0,0
"Lithuania","2024-04-03",0,0,0,0,0,0,0,0
"Lithuania","2024-04-04",0,0,0,0,0,0,0,0
"Lithuania","2024-04-05",0,0,0,0,0,0,0,0
"Lithuania","2024-04-06",0,0,0,0,0,0,0,0
"Lithuania","2024-04-07",0,0,0,0,0,0,0,0
"Lithuania","2024-04-08",0,0,0,0,0,0,0,0
"Lithuania","2024-04-09",0,0,0,0,0,0,0,0
"Lithuania","2024-04-10",0,0,0,0,0,0,0,0
"Lithuania","2024-04-11",0,0,0,0,0,0,0,0
"Lithuania","2024-04-12",0,0,0,0,0,0,0,0
"Lithuania","2024-04-13",0,0,0,0,0,0,0,0
"Lithuania","2024-04-14",0,0,0,0,0,0,0,0
"Lithuania","2024-04-15",0,0,0,0,0,0,0,0
"Lithuania","2024-04-16",0,0,0,0,0,0,0,0
"Lithuania","2024-04-17",0,0,0,0,0,0,0,0
"Lithuania","2024-04-18",0,0,0,0,0,0,0,0
"Lithuania","2024-04-19",0,0,0,0,0,0,0,0
"Lithuania","2024-04-20",0,0,0,0,0,0,0,0
"Lithuania","2024-04-21",0,0,0,0,0,0,0,0
"Lithuania","2024-04-22",0,0,0,0,0,0,0,0
"Lithuania","2024-04-23",0,0,0,0,0,0,0,0
"Lithuania","2024-04-24",0,0,0,0,0,0,0,0
"Lithuania","2024-04-25",0,0,0,0,0,0,0,0
"Lithuania","2024-04-26",0,0,0,0,0,0,0,0
"Lithuania","2024-04-27",0,0,0,0,0,0,0,0
"Lithuania","2024-04-28",0,0,0,0,0,0,0,0
"Lithuania","2024-04-29",0,0,0,0,0,0,0,0
"Lithuania","2024-04-30",0,0,0,0,0,0,0,0
"Lithuania","2024-05-01",0,0,0,0,0,0,0,0
"Lithuania","2024-05-02",0,0,0,0,0,0,0,0
"Lithuania","2024-05-03",0,0,0,0,0,0,0,0
"Lithuania","2024-05-04",0,0,0,0,0,0,0,0
"Lithuania","2024-05-05",0,0,0,0,0,0,0,0
"Lithuania","2024-05-06",0,0,0,0,0,0,0,0
"Lithuania","2024-05-07",0,0,0,0,0,0,0,0
"Lithuania","2024-05-08",0,0,0,0,0,0,0,0
"Lithuania","2024-05-09",0,0,0,0,0,0,0,0
"Lithuania","2024-05-10",0,0,0,0,0,0,0,0
"Lithuania","2024-05-11",0,0,0,0,0,0,0,0
"Lithuania","2024-05-12",0,0,0,0,0,0,0,0
"Lithuania","2024-05-13",0,0,0,0,0,0,0,0
"Lithuania","2024-05-14",0,0,0,0,0,0,0,0
"Lithuania","2024-05-15",0,0,0,0,0,0,0,0
"Lithuania","2024-05-16",0,0,0,0,0,0,0,0
"Lithuania","2024-05-17",0,0,0,0,0,0,0,0
"Lithuania","2024-05-18",0,0,0,0,0,0,0,0
"Lithuania","2024-05-19",0,0,0,0,0,0,0,0
"Lithuania","2024-05-20",0,0,0,0,0,0,0,0
"Lithuania","2024-05-21",0,0,0,0,0,0,0,0
"Lithuania","2024-05-22",0,0,0,0,0,0,0,0
"Lithuania","2024-05-23",0,0,0,0,0,0,0,0
"Lithuania","2024-05-24",0,0,0,0,0,0,0,0
"Lithuania","2024-05-25",0,0,0,0,0,0,0,0
"Lithuania","2024-05-26",0,0,0,0,0,0,0,0
"Lithuania","2024-05-27",0,0,0,0,0,0,0,0
"Lithuania","2024-05-28",0,0,0,0,0,0,0,0
"Lithuania","2024-05-29",0,0,0,0,0,0,0,0
"Lithuania","2024-05-30",0,0,0,0,0,0,0,0
"Lithuania","2024-05-31",0,0,0,0,0,0,0,0
"Lithuania","2024-06-01",0,0,0,0,0,0,0,0
"Lithuania","2024-06-02",0,0,0,0,0,0,0,0
"Lithuania","2024-06-03",0,0,0,0,0,0,0,0
"Lithuania","2024-06-04",0,0,0,0,0,0,0,0
"Lithuania","2024-06-05",0,0,0,0,0,0,0,0
"Lithuania","2024-06-06",0,0,0,0,0,0,0,0
"Lithuania","2024-06-07",0,0,0,0,0,0,0,0
"Lithuania","2024-06-08",0,0,0,0,0,0,0,0
"Lithuania","2024-06-09",0,0,0,0,0,0,0,0
"Lithuania","2024-06-10",0,0,0,0,0,0,0,0
"Lithuania","2024-06-11",0,0,0,0,0,0,0,0
"Lithuania","2024-06-12",0,0,0,0,0,0,0,0
"Lithuania","2024-06-13",0,0,0,0,0,0,0,0
"Lithuania","2024-06-14",0,0,0,0,0,0,0,0
"Lithuania","2024-06-15",0,0,0,0,0,0,0,0
"Lithuania","2024-06-16",0,0,0,0,0,0,0,0
"Lithuania","2024-06-17",0,0,0,0,0,0,0,0
"Lithuania","2024-06-18",0,0,0,0,0,0,0,0
"Lithuania","2024-06-19",0,0,0,0,0,0,0,0
"Lithuania","2024-06-20",0,0,0,0,0,0,0,0
"Lithuania","2024-06-21",0,0,0,0,0,0,0,0
"Lithuania","2024-06-22",0,0,0,0,0,0,0,0
"Lithuania","2024-06-23",0,0,0,0,0,0,0,0
"Lithuania","2024-06-24",0,0,0,0,0,0,0,0
"Lithuania","2024-06-25",0,0,0,0,0,0,0,0
"Lithuania","2024-06-26",0,0,0,0,0,0,0,0
"Lithuania","2024-06-27",0,0,0,0,0,0,0,0
"Lithuania","2024-06-28",0,0,0,0,0,0,0,0
"Lithuania","2024-06-29",0,0,0,0,0,0,0,0
"Lithuania","2024-06-30",0,0,0,0,0,0,0,0
"Lithuania","2024-07-01",0,0,0,0,0,0,0,0
"Lithuania","2024-07-02",0,0,0,0,0,0,0,0
"Lithuania","2024-07-03",0,0,0,0,0,0,0,0
"Lithuania","2024-07-04",0,0,0,0,0,0,0,0
"Lithuania","2024-07-05",0,0,0,0,0,0,0,0
"Lithuania","2024-07-06",0,0,0,0,0,0,0,0
"Lithuania","2024-07-07",0,0,0,0,0,0,0,0
"Lithuania","2024-07-08",0,0,0,0,0,0,0,0
"Lithuania","2024-07-09",0,0,0,0,0,0,0,0
"Lithuania","2024-07-10",0,0,0,0,0,0,0,0
"Lithuania","2024-07-11",0,0,0,0,0,0,0,0
"Lithuania","2024-07-12",0,0,0,0,0,0,0,0
"Lithuania","2024-07-13",0,0,0,0,0,0,0,0
"Lithuania","2024-07-14",0,0,0,0,0,0,0,0
"Lithuania","2024-07-15",0,0,0,0,0,0,0,0
"Lithuania","2024-07-16",0,0,0,0,0,0,0,0
"Lithuania","2024-07-17",0,0,0,0,0,0,0,0
"Lithuania","2024-07-18",0,0,0,0,0,0,0,0
"Lithuania","2024-07-19",0,0,0,0,0,0,0,0
"Lithuania","2024-07-20",0,0,0,0,0,0,0,0
"Lithuania","2024-07-21",0,0,0,0,0,0,0,0
"Lithuania","2024-07-22",0,0,0,0,0,0,0,0
"Lithuania","2024-07-23",0,0,0,0,0,0,0,0
"Lithuania","2024-07-24",0,0,0,0,0,0,0,0
"Lithuania","2024-07-25",0,0,0,0,0,0,0,0
"Lithuania","2024-07-26",0,0,0,0,0,0,0,0
"Lithuania","2024-07-27",0,0,0,0,0,0,0,0
"Lithuania","2024-07-28",0,0,0,0,0,0,0,0
"Lithuania","2024-07-29",0,0,0,0,0,0,0,0
"Lithuania","2024-07-30",0,0,0,0,0,0,0,0
"Lithuania","2024-07-31",0,0,0,0,0,0,0,0
"Lithuania","2024-08-01",0,0,0,0,0,0,0,0
"Lithuania","2024-08-02",0,0,0,0,0,0,0,0
"Lithuania","2024-08-03",0,0,0,0,0,0,0,0
"Lithuania","2024-08-04",0,0,0,0,0,0,0,0
"Lithuania","2024-08-05",0,0,0,0,0,0,0,0
"Lithuania","2024-08-06",0,0,0,0,0,0,0,0
"Lithuania","2024-08-07",0,0,0,0,0,0,0,0
"Lithuania","2024-08-08",0,0,0,0,0,0,0,0
"Lithuania","2024-08-09",0,0,0,0,0,0,0,0
"Lithuania","2024-08-10",0,0,0,0,0,0,0,0
"Lithuania","2024-08-11",0,0,0,0,0,0,0,0
"Lithuania","2024-08-12",0,0,0,0,0,0,0,0
"Lithuania","2024-08-13",0,0,0,0,0,0,0,0
"Lithuania","2024-08-14",0,0,0,0,0,0,0,0
"Lithuania","2024-08-15",0,0,0,0,0,0,0,0
"Lithuania","2024-08-16",0,0,0,0,0,0,0,0
"Lithuania","2024-08-17",0,0,0,0,0,0,0,0
"Lithuania","2024-08-18",0,0,0,0,0,0,0,0
"Lithuania","2024-08-19",0,0,0,0,0,0,0,0
"Lithuania","2024-08-20",0,0,0,0,0,0,0,0
"Lithuania","2024-08-21",0,0,0,0,0,0,0,0
"Lithuania","2024-08-22",0,0,0,0,0,0,0,0
"Lithuania","2024-08-23",0,0,0,0,0,0,0,0
"Lithuania","2024-08-24",0,0,0,0,0,0,0,0
"Lithuania","2024-08-25",0,0,0,0,0,0,0,0
"Lithuania","2024-08-26",0,0,0,0,0,0,0,0
"Lithuania","2024-08-27",0,0,0,0,0,0,0,0
"Lithuania","2024-08-28",0,0,0,0,0,0,0,0
"Lithuania","2024-08-29",0,0,0,0,0,0,0,0
"Lithuania","2024-08-30",0,0,0,0,0,0,0,0
"Lithuania","2024-08-31",0,0,0,0,0,0,0,0
"Lithuania","2024-09-01",0,0,0,0,0,0,0,0
"Lithuania","2024-09-02",0,0,0,0,0,0,0,0
"Lithuania","2024-09-03",0,0,0,0,0,0,0,0
"Lithuania","2024-09-04",0,0,0,0,0,0,0,0
"Lithuania","2024-09-05",0,0,0,0,0,0,0,0
"Lithuania","2024-09-06",0,0,0,0,0,0,0,0
"Lithuania","2024-09-07",0,0,0,0,0,0,0,0
"Lithuania","2024-09-08",0,0,0,0,0,0,0,0
"Lithuania","2024-09-09",0,0,0,0,0,0,0,0
"Lithuania","2024-09-10",0,0,0,0,0,0,0,0
"Lithuania","2024-09-11",0,0,0,0,0,0,0,0
"Lithuania","2024-09-12",0,0,0,0,0,0,0,0
"Lithuania","2024-09-13",0,0,0,0,0,0,0,0
"Lithuania","2024-09-14",0,0,0,0,0,0,0,0
"Lithuania","2024-09-15",0,0,0,0,0,0,0,0
"Lithuania","2024-09-16",0,0,0,0,0,0,0,0
"Lithuania","2024-09-17",0,0,0,0,0,0,0,0
"Lithuania","2024-09-18",0,0,0,0,0,0,0,0
"Lithuania","2024-09-19",0,0,0,0,0,0,0,0
"Lithuania","2024-09-20",0,0,0,0,0,0,0,0
"Lithuania","2024-09-21",0,0,0,0,0,0,0,0
"Lithuania","2024-09-22",0,0,0,0,0,0,0,0
"Lithuania","2024-09-23",0,0,0,0,0,0,0,0
"Lithuania","2024-09-24",0,0,0,0,0,0,0,0
"Lithuania","2024-09-25",0,0,0,0,0,0,0,0
"Lithuania","2024-09-26",0,0,0,0,0,0,0,0
"Lithuania","2024-09-27",0,0,0,0,0,0,0,0
"Lithuania","2024-09-28",0,0,0,0,0,0,0,0
"Lithuania","2024-09-29",0,0,0,0,0,0,0,0
"Lithuania","2024-09-30",0,1,1,0,1,1,0,0
"Lithuania","2024-10-01",0,0,1,0,0,1,0,0
"Lithuania","2024-10-02",0,0,1,0,0,1,0,0
"Lithuania","2024-10-03",0,0,1,0,0,1,0,0
"Lithuania","2024-10-04",0,0,1,0,0,1,0,0
"Lithuania","2024-10-05",0,0,1,0,0,1,0,0
"Lithuania","2024-10-06",0,0,1,0,0,1,0,0
"Lithuania","2024-10-07",0,0,1,0,0,1,0,0
"Lithuania","2024-10-08",0,0,1,0,0,1,0,0
"Lithuania","2024-10-09",0,0,1,0,0,1,0,0
"Lithuania","2024-10-10",0,0,1,0,0,1,0,0
"Lithuania","2024-10-11",0,0,1,0,0,1,0,0
"Lithuania","2024-10-12",0,0,1,0,0,1,0,0
"Lithuania","2024-10-13",0,0,1,0,0,1,0,0
"Lithuania","2024-10-14",0,0,1,0,0,1,0,0
"Lithuania","2024-10-15",0,0,1,0,0,1,0,0
"Lithuania","2024-10-16",0,0,1,0,0,1,0,0
"Lithuania","2024-10-17",0,0,1,0,0,1,0,0
"Lithuania","2024-10-18",0,0,1,0,0,1,0,0
"Lithuania","2024-10-19",0,0,1,0,0,1,0,0
"Lithuania","2024-10-20",0,0,1,0,0,1,0,0
"Lithuania","2024-10-21",0,0,1,0,0,1,0,0
"Lithuania","2024-10-22",0,0,1,0,0,1,0,0
"Lithuania","2024-10-23",0,0,1,0,0,1,0,0
"Lithuania","2024-10-24",0,0,1,0,0,1,0,0
"Lithuania","2024-10-25",0,0,1,0,0,1,0,0
"Lithuania","2024-10-26",0,0,1,0,0,1,0,0
"Lithuania","2024-10-27",0,0,1,0,0,1,0,0
"Lithuania","2024-10-28",0,0,1,0,0,1,0,0
"Lithuania","2024-10-29",0,0,1,0,0,1,0,0
"Lithuania","2024-10-30",0,0,1,0,0,1,0,0
"Lithuania","2024-10-31",0,0,1,0,0,1,0,0
"Lithuania","2024-11-01",0,0,1,0,0,1,0,0
"Lithuania","2024-11-02",0,0,1,0,0,1,0,0
"Lithuania","2024-11-03",0,0,1,0,0,1,0,0
"Lithuania","2024-11-04",0,0,1,0,0,1,0,0
"Lithuania","2024-11-05",0,0,1,0,0,1,0,0
"Lithuania","2024-11-06",0,0,1,0,0,1,0,0
"Lithuania","2024-11-07",0,0,1,0,0,1,0,0
"Lithuania","2024-11-08",0,0,1,0,0,1,0,0
"Lithuania","2024-11-09",0,0,1,0,0,1,0,0
"Lithuania","2024-11-10",0,0,1,0,0,1,0,0
"Lithuania","2024-11-11",0,0,1,0,0,1,0,0
"Lithuania","2024-11-12",0,0,1,0,0,1,0,0
"Lithuania","2024-11-13",0,0,1,0,0,1,0,0
"Lithuania","2024-11-14",0,0,1,0,0,1,0,0
"Lithuania","2024-11-15",0,0,1,0,0,1,0,0
"Lithuania","2024-11-16",0,0,1,0,0,1,0,0
"Lithuania","2024-11-17",0,0,1,0,0,1,0,0
"Lithuania","2024-11-18",0,0,1,0,0,1,0,0
"Lithuania","2024-11-19",0,0,1,0,0,1,0,0
"Lithuania","2024-11-20",0,0,1,0,0,1,0,0
"Lithuania","2024-11-21",0,0,1,0,0,1,0,0
"Lithuania","2024-11-22",0,0,1,0,0,1,0,0
"Lithuania","2024-11-23",0,0,1,0,0,1,0,0
"Lithuania","2024-11-24",0,0,1,0,0,1,0,0
"Lithuania","2024-11-25",0,0,1,0,0,1,0,0
"Lithuania","2024-11-26",0,0,1,0,0,1,0,0
"Lithuania","2024-11-27",0,0,1,0,0,1,0,0
"Lithuania","2024-11-28",0,0,1,0,0,1,0,0
"Lithuania","2024-11-29",0,0,1,0,0,1,0,0
"Lithuania","2024-11-30",0,0,1,0,0,1,0,0
"Lithuania","2024-12-01",0,0,1,0,0,1,0,0
"Lithuania","2024-12-02",0,0,1,0,0,1,0,0
"Lithuania","2024-12-03",0,0,1,0,0,1,0,0
"Lithuania","2024-12-04",0,0,1,0,0,1,0,0
"Lithuania","2024-12-05",0,0,1,0,0,1,0,0
"Lithuania","2024-12-06",0,0,1,0,0,1,0,0
"Lithuania","2024-12-07",0,0,1,0,0,1,0,0
"Lithuania","2024-12-08",0,0,1,0,0,1,0,0
"Lithuania","2024-12-09",0,0,1,0,0,1,0,0
"Lithuania","2024-12-10",0,0,1,0,0,1,0,0
"Lithuania","2024-12-11",0,0,1,0,0,1,0,0
"Lithuania","2024-12-12",0,0,1,0,0,1,0,0
"Lithuania","2024-12-13",0,0,1,0,0,1,0,0
"Lithuania","2024-12-14",0,0,1,0,0,1,0,0
"Lithuania","2024-12-15",0,0,1,0,0,1,0,0
"Lithuania","2024-12-16",0,0,1,0,0,1,0,0
"Lithuania","2024-12-17",0,0,1,0,0,1,0,0
"Lithuania","2024-12-18",0,0,1,0,0,1,0,0
"Lithuania","2024-12-19",0,0,1,0,0,1,0,0
"Lithuania","2024-12-20",0,0,1,0,0,1,0,0
"Lithuania","2024-12-21",0,0,1,0,0,1,0,0
"Lithuania","2024-12-22",0,0,1,0,0,1,0,0
"Lithuania","2024-12-23",0,0,1,0,0,1,0,0
"Lithuania","2024-12-24",0,0,1,0,0,1,0,0
"Lithuania","2024-12-25",0,0,1,0,0,1,0,0
"Lithuania","2024-12-26",0,0,1,0,0,1,0,0
"Lithuania","2024-12-27",0,0,1,0,0,1,0,0
"Lithuania","2024-12-28",0,0,1,0,0,1,0,0
"Lithuania","2024-12-29",0,0,1,0,0,1,0,0
"Lithuania","2024-12-30",0,0,1,0,0,1,0,0
"Lithuania","2024-12-31",0,0,1,0,0,1,0,0
"Lithuania","2025-01-01",0,0,1,0,0,1,0,0
"Lithuania","2025-01-02",0,0,1,0,0,1,0,0
"Lithuania","2025-01-03",0,0,1,0,0,1,0,0
"Lithuania","2025-01-04",0,0,1,0,0,1,0,0
"Lithuania","2025-01-05",0,0,1,0,0,1,0,0
"Lithuania","2025-01-06",0,0,1,0,0,1,0,0
"Lithuania","2025-01-07",0,0,1,0,0,1,0,0
"Lithuania","2025-01-08",0,0,1,0,0,1,0,0
"Lithuania","2025-01-09",0,0,1,0,0,1,0,0
"Lithuania","2025-01-10",0,0,1,0,0,1,0,0
"Lithuania","2025-01-11",0,0,1,0,0,1,0,0
"Lithuania","2025-01-12",0,0,1,0,0,1,0,0
"Lithuania","2025-01-13",0,0,1,0,0,1,0,0
"Lithuania","2025-01-14",0,0,1,0,0,1,0,0
"Lithuania","2025-01-15",0,0,1,0,0,1,0,0
"Lithuania","2025-01-16",0,0,1,0,0,1,0,0
"Lithuania","2025-01-17",0,0,1,0,0,1,0,0
"Lithuania","2025-01-18",0,0,1,0,0,1,0,0
"Lithuania","2025-01-19",0,0,1,0,0,1,0,0
"Lithuania","2025-01-20",0,0,1,0,0,1,0,0
"Lithuania","2025-01-21",0,0,1,0,0,1,0,0
"Lithuania","2025-01-22",0,0,1,0,0,1,0,0
"Lithuania","2025-01-23",0,0,1,0,0,1,0,0
"Lithuania","2025-01-24",0,0,1,0,0,1,0,0
"Lithuania","2025-01-25",0,0,1,0,0,1,0,0
"Lithuania","2025-01-26",0,0,1,0,0,1,0,0
"Lithuania","2025-01-27",0,0,1,0,0,1,0,0
"Lithuania","2025-01-28",0,0,1,0,0,1,0,0
"Lithuania","2025-01-29",0,0,1,0,0,1,0,0
"Lithuania","2025-01-30",0,0,1,0,0,1,0,0
"Lithuania","2025-01-31",0,0,1,0,0,1,0,0
"Lithuania","2025-02-01",0,0,1,0,0,1,0,0
"Lithuania","2025-02-02",0,0,1,0,0,1,0,0
"Lithuania","2025-02-03",0,0,1,0,0,1,0,0
"Luxembourg","2024-01-01",0,0,0,0,0,0,0,0
"Luxembourg","2024-01-02",0,0,0,0,0,0,0,0
"Luxembourg","2024-01-03",0,0,0,0,0,0,0,0
"Luxembourg","2024-01-04",0,0,0,0,0,0,0,0
"Luxembourg","2024-01-05",0,0,0,0,0,0,0,0
"Luxembourg","2024-01-06",0,0,0,0,0,0,0,0
"Luxembourg","2024-01-07",0,0,0,0,0,0,0,0
"Luxembourg","2024-01-08",0,0,0,0,0,0,0,0
"Luxembourg","2024-01-09",0,0,0,0,0,0,0,0
"Luxembourg","2024-01-10",0,0,0,0,0,0,0,0
"Luxembourg","2024-01-11",0,0,0,0,0,0,0,0
"Luxembourg","2024-01-12",0,0,0,0,0,0,0,0
"Luxembourg","2024-01-13",0,0,0,0,0,0,0,0
"Luxembourg","2024-01-14",0,0,0,0,0,0,0,0
"Luxembourg","2024-01-15",0,0,0,0,0,0,0,0
"Luxembourg","2024-01-16",0,0,0,0,0,0,0,0
"Luxembourg","2024-01-17",0,0,0,0,0,0,0,0
"Luxembourg","2024-01-18",0,0,0,0,0,0,0,0
"Luxembourg","2024-01-19",0,0,0,0,0,0,0,0
"Luxembourg","2024-01-20",0,0,0,0,0,0,0,0
"Luxembourg","2024-01-21",0,0,0,0,0,0,0,0
"Luxembourg","2024-01-22",0,0,0,0,0,0,0,0
"Luxembourg","2024-01-23",0,0,0,0,0,0,0,0
"Luxembourg","2024-01-24",0,0,0,0,0,0,0,0
"Luxembourg","2024-01-25",0,0,0,0,0,0,0,0
"Luxembourg","2024-01-26",0,0,0,0,0,0,0,0
"Luxembourg","2024-01-27",0,0,0,0,0,0,0,0
"Luxembourg","2024-01-28",0,0,0,0,0,0,0,0
"Luxembourg","2024-01-29",0,0,0,0,0,0,0,0
"Luxembourg","2024-01-30",0,0,0,0,0,0,0,0
"Luxembourg","2024-01-31",0,0,0,0,0,0,0,0
"Luxembourg","2024-02-01",0,0,0,0,0,0,0,0
"Luxembourg","2024-02-02",0,0,0,0,0,0,0,0
"Luxembourg","2024-02-03",0,0,0,0,0,0,0,0
"Luxembourg","2024-02-04",0,0,0,0,0,0,0,0
"Luxembourg","2024-02-05",0,0,0,0,0,0,0,0
"Luxembourg","2024-02-06",0,0,0,0,0,0,0,0
"Luxembourg","2024-02-07",0,0,0,0,0,0,0,0
"Luxembourg","2024-02-08",0,0,0,0,0,0,0,0
"Luxembourg","2024-02-09",0,0,0,0,0,0,0,0
"Luxembourg","2024-02-10",0,0,0,0,0,0,0,0
"Luxembourg","2024-02-11",0,0,0,0,0,0,0,0
"Luxembourg","2024-02-12",0,0,0,0,0,0,0,0
"Luxembourg","2024-02-13",0,0,0,0,0,0,0,0
"Luxembourg","2024-02-14",0,0,0,0,0,0,0,0
"Luxembourg","2024-02-15",0,0,0,0,0,0,0,0
"Luxembourg","2024-02-16",0,0,0,0,0,0,0,0
"Luxembourg","2024-02-17",0,0,0,0,0,0,0,0
"Luxembourg","2024-02-18",0,0,0,0,0,0,0,0
"Luxembourg","2024-02-19",0,0,0,0,0,0,0,0
"Luxembourg","2024-02-20",0,0,0,0,0,0,0,0
"Luxembourg","2024-02-21",0,0,0,0,0,0,0,0
"Luxembourg","2024-02-22",0,0,0,0,0,0,0,0
"Luxembourg","2024-02-23",0,0,0,0,0,0,0,0
"Luxembourg","2024-02-24",0,0,0,0,0,0,0,0
"Luxembourg","2024-02-25",0,0,0,0,0,0,0,0
"Luxembourg","2024-02-26",0,0,0,0,0,0,0,0
"Luxembourg","2024-02-27",0,0,0,0,0,0,0,0
"Luxembourg","2024-02-28",0,0,0,0,0,0,0,0
"Luxembourg","2024-02-29",0,1,1,0,1,1,0,0
"Luxembourg","2024-03-01",0,0,1,0,0,1,0,0
"Luxembourg","2024-03-02",0,0,1,0,0,1,0,0
"Luxembourg","2024-03-03",0,0,1,0,0,1,0,0
"Luxembourg","2024-03-04",0,0,1,0,0,1,0,0
"Luxembourg","2024-03-05",0,0,1,0,0,1,0,0
"Luxembourg","2024-03-06",0,0,1,0,0,1,0,0
"Luxembourg","2024-03-07",0,0,1,0,0,1,0,0
"Luxembourg","2024-03-08",0,0,1,0,0,1,0,0
"Luxembourg","2024-03-09",0,0,1,0,0,1,0,0
"Luxembourg","2024-03-10",0,0,1,0,0,1,0,0
"Luxembourg","2024-03-11",0,0,1,0,0,1,0,0
"Luxembourg","2024-03-12",0,0,1,0,0,1,0,0
"Luxembourg","2024-03-13",0,0,1,0,0,1,0,0
"Luxembourg","2024-03-14",0,0,1,0,0,1,0,0
"Luxembourg","2024-03-15",0,0,1,0,0,1,0,0
"Luxembourg","2024-03-16",0,0,1,0,0,1,0,0
"Luxembourg","2024-03-17",0,0,1,0,0,1,0,0
"Luxembourg","2024-03-18",0,0,1,0,0,1,0,0
"Luxembourg","2024-03-19",0,0,1,0,0,1,0,0
"Luxembourg","2024-03-20",0,0,1,0,0,1,0,0
"Luxembourg","2024-03-21",0,0,1,0,0,1,0,0
"Luxembourg","2024-03-22",0,0,1,0,0,1,0,0
"Luxembourg","2024-03-23",0,0,1,0,0,1,0,0
"Luxembourg","2024-03-24",0,0,1,0,0,1,0,0
"Luxembourg","2024-03-25",0,0,1,0,0,1,0,0
"Luxembourg","2024-03-26",0,0,1,0,0,1,0,0
"Luxembourg","2024-03-27",0,0,1,0,0,1,0,0
"Luxembourg","2024-03-28",0,0,1,0,0,1,0,0
"Luxembourg","2024-03-29",0,0,1,0,0,1,0,0
"Luxembourg","2024-03-30",0,0,1,0,0,1,0,0
"Luxembourg","2024-03-31",0,0,1,0,0,1,0,0
"Luxembourg","2024-04-01",0,0,1,0,0,1,0,0
"Luxembourg","2024-04-02",0,0,1,0,0,1,0,0
"Luxembourg","2024-04-03",0,0,1,0,0,1,0,0
"Luxembourg","2024-04-04",0,0,1,0,0,1,0,0
"Luxembourg","2024-04-05",0,0,1,0,0,1,0,0
"Luxembourg","2024-04-06",0,0,1,0,0,1,0,0
"Luxembourg","2024-04-07",0,0,1,0,0,1,0,0
"Luxembourg","2024-04-08",0,0,1,0,0,1,0,0
"Luxembourg","2024-04-09",0,0,1,0,0,1,0,0
"Luxembourg","2024-04-10",0,0,1,0,0,1,0,0
"Luxembourg","2024-04-11",0,0,1,0,0,1,0,0
"Luxembourg","2024-04-12",0,0,1,0,0,1,0,0
"Luxembourg","2024-04-13",0,0,1,0,0,1,0,0
"Luxembourg","2024-04-14",0,0,1,0,0,1,0,0
"Luxembourg","2024-04-15",0,0,1,0,0,1,0,0
"Luxembourg","2024-04-16",0,0,1,0,0,1,0,0
"Luxembourg","2024-04-17",0,0,1,0,0,1,0,0
"Luxembourg","2024-04-18",0,0,1,0,0,1,0,0
"Luxembourg","2024-04-19",0,0,1,0,0,1,0,0
"Luxembourg","2024-04-20",0,0,1,0,0,1,0,0
"Luxembourg","2024-04-21",0,0,1,0,0,1,0,0
"Luxembourg","2024-04-22",0,0,1,0,0,1,0,0
"Luxembourg","2024-04-23",0,0,1,0,0,1,0,0
"Luxembourg","2024-04-24",0,0,1,0,0,1,0,0
"Luxembourg","2024-04-25",0,0,1,0,0,1,0,0
"Luxembourg","2024-04-26",0,0,1,0,0,1,0,0
"Luxembourg","2024-04-27",0,0,1,0,0,1,0,0
"Luxembourg","2024-04-28",0,0,1,0,0,1,0,0
"Luxembourg","2024-04-29",0,0,1,0,0,1,0,0
"Luxembourg","2024-04-30",0,0,1,0,0,1,0,0
"Luxembourg","2024-05-01",0,0,1,0,0,1,0,0
"Luxembourg","2024-05-02",0,0,1,0,0,1,0,0
"Luxembourg","2024-05-03",0,0,1,0,0,1,0,0
"Luxembourg","2024-05-04",0,0,1,0,0,1,0,0
"Luxembourg","2024-05-05",0,0,1,0,0,1,0,0
"Luxembourg","2024-05-06",0,0,1,0,0,1,0,0
"Luxembourg","2024-05-07",0,0,1,0,0,1,0,0
"Luxembourg","2024-05-08",0,0,1,0,0,1,0,0
"Luxembourg","2024-05-09",0,0,1,0,0,1,0,0
"Luxembourg","2024-05-10",0,0,1,0,0,1,0,0
"Luxembourg","2024-05-11",0,0,1,0,0,1,0,0
"Luxembourg","2024-05-12",0,0,1,0,0,1,0,0
"Luxembourg","2024-05-13",0,0,1,0,0,1,0,0
"Luxembourg","2024-05-14",0,0,1,0,0,1,0,0
"Luxembourg","2024-05-15",0,0,1,0,0,1,0,0
"Luxembourg","2024-05-16",0,0,1,0,0,1,0,0
"Luxembourg","2024-05-17",0,0,1,0,0,1,0,0
"Luxembourg","2024-05-18",0,0,1,0,0,1,0,0
"Luxembourg","2024-05-19",0,0,1,0,0,1,0,0
"Luxembourg","2024-05-20",0,0,1,0,0,1,0,0
"Luxembourg","2024-05-21",0,0,1,0,0,1,0,0
"Luxembourg","2024-05-22",0,0,1,0,0,1,0,0
"Luxembourg","2024-05-23",0,0,1,0,0,1,0,0
"Luxembourg","2024-05-24",0,0,1,0,0,1,0,0
"Luxembourg","2024-05-25",0,0,1,0,0,1,0,0
"Luxembourg","2024-05-26",0,0,1,0,0,1,0,0
"Luxembourg","2024-05-27",0,0,1,0,0,1,0,0
"Luxembourg","2024-05-28",0,0,1,0,0,1,0,0
"Luxembourg","2024-05-29",0,0,1,0,0,1,0,0
"Luxembourg","2024-05-30",0,0,1,0,0,1,0,0
"Luxembourg","2024-05-31",0,0,1,0,0,1,0,0
"Luxembourg","2024-06-01",0,0,1,0,0,1,0,0
"Luxembourg","2024-06-02",0,0,1,0,0,1,0,0
"Luxembourg","2024-06-03",0,0,1,0,0,1,0,0
"Luxembourg","2024-06-04",0,0,1,0,0,1,0,0
"Luxembourg","2024-06-05",0,0,1,0,0,1,0,0
"Luxembourg","2024-06-06",0,0,1,0,0,1,0,0
"Luxembourg","2024-06-07",0,0,1,0,0,1,0,0
"Luxembourg","2024-06-08",0,0,1,0,0,1,0,0
"Luxembourg","2024-06-09",0,0,1,0,0,1,0,0
"Luxembourg","2024-06-10",0,0,1,0,0,1,0,0
"Luxembourg","2024-06-11",0,0,1,0,0,1,0,0
"Luxembourg","2024-06-12",0,0,1,0,0,1,0,0
"Luxembourg","2024-06-13",0,0,1,0,0,1,0,0
"Luxembourg","2024-06-14",0,0,1,0,0,1,0,0
"Luxembourg","2024-06-15",0,0,1,0,0,1,0,0
"Luxembourg","2024-06-16",0,0,1,0,0,1,0,0
"Luxembourg","2024-06-17",0,0,1,0,0,1,0,0
"Luxembourg","2024-06-18",0,0,1,0,0,1,0,0
"Luxembourg","2024-06-19",0,0,1,0,0,1,0,0
"Luxembourg","2024-06-20",0,0,1,0,0,1,0,0
"Luxembourg","2024-06-21",0,0,1,0,0,1,0,0
"Luxembourg","2024-06-22",0,0,1,0,0,1,0,0
"Luxembourg","2024-06-23",0,0,1,0,0,1,0,0
"Luxembourg","2024-06-24",0,0,1,0,0,1,0,0
"Luxembourg","2024-06-25",0,0,1,0,0,1,0,0
"Luxembourg","2024-06-26",0,0,1,0,0,1,0,0
"Luxembourg","2024-06-27",0,0,1,0,0,1,0,0
"Luxembourg","2024-06-28",0,0,1,0,0,1,0,0
"Luxembourg","2024-06-29",0,0,1,0,0,1,0,0
"Luxembourg","2024-06-30",0,0,1,0,0,1,0,0
"Luxembourg","2024-07-01",0,0,1,0,1,2,0,0
"Luxembourg","2024-07-02",0,0,1,0,0,2,0,0
"Luxembourg","2024-07-03",0,0,1,0,0,2,0,0
"Luxembourg","2024-07-04",0,0,1,0,0,2,0,0
"Luxembourg","2024-07-05",0,0,1,0,0,2,0,0
"Luxembourg","2024-07-06",0,0,1,0,0,2,0,0
"Luxembourg","2024-07-07",0,0,1,0,0,2,0,0
"Luxembourg","2024-07-08",0,0,1,0,0,2,0,0
"Luxembourg","2024-07-09",0,0,1,0,0,2,0,0
"Luxembourg","2024-07-10",0,0,1,0,0,2,0,0
"Luxembourg","2024-07-11",0,0,1,0,0,2,0,0
"Luxembourg","2024-07-12",0,0,1,0,0,2,0,0
"Luxembourg","2024-07-13",0,0,1,0,0,2,0,0
"Luxembourg","2024-07-14",0,0,1,0,0,2,0,0
"Luxembourg","2024-07-15",0,0,1,0,0,2,0,0
"Luxembourg","2024-07-16",0,0,1,0,0,2,0,0
"Luxembourg","2024-07-17",0,0,1,0,0,2,0,0
"Luxembourg","2024-07-18",0,0,1,0,0,2,0,0
"Luxembourg","2024-07-19",0,0,1,0,0,2,0,0
"Luxembourg","2024-07-20",0,0,1,0,0,2,0,0
"Luxembourg","2024-07-21",0,0,1,0,0,2,0,0
"Luxembourg","2024-07-22",0,0,1,0,0,2,0,0
"Luxembourg","2024-07-23",0,0,1,0,0,2,0,0
"Luxembourg","2024-07-24",0,0,1,0,0,2,0,0
"Luxembourg","2024-07-25",0,0,1,0,0,2,0,0
"Luxembourg","2024-07-26",0,0,1,0,0,2,0,0
"Luxembourg","2024-07-27",0,0,1,0,0,2,0,0
"Luxembourg","2024-07-28",0,0,1,0,0,2,0,0
"Luxembourg","2024-07-29",0,0,1,0,0,2,0,0
"Luxembourg","2024-07-30",0,0,1,0,0,2,0,0
"Luxembourg","2024-07-31",0,0,1,0,0,2,0,0
"Luxembourg","2024-08-01",0,0,1,0,0,2,0,0
"Luxembourg","2024-08-02",0,0,1,0,0,2,0,0
"Luxembourg","2024-08-03",0,0,1,0,0,2,0,0
"Luxembourg","2024-08-04",0,0,1,0,0,2,0,0
"Luxembourg","2024-08-05",0,0,1,0,0,2,0,0
"Luxembourg","2024-08-06",0,0,1,0,0,2,0,0
"Luxembourg","2024-08-07",0,0,1,0,0,2,0,0
"Luxembourg","2024-08-08",0,0,1,0,0,2,0,0
"Luxembourg","2024-08-09",0,0,1,0,0,2,0,0
"Luxembourg","2024-08-10",0,0,1,0,0,2,0,0
"Luxembourg","2024-08-11",0,0,1,0,0,2,0,0
"Luxembourg","2024-08-12",0,0,1,0,0,2,0,0
"Luxembourg","2024-08-13",0,0,1,0,0,2,0,0
"Luxembourg","2024-08-14",0,0,1,0,0,2,0,0
"Luxembourg","2024-08-15",0,0,1,0,0,2,0,0
"Luxembourg","2024-08-16",0,0,1,0,0,2,0,0
"Luxembourg","2024-08-17",0,0,1,0,0,2,0,0
"Luxembourg","2024-08-18",0,0,1,0,0,2,0,0
"Luxembourg","2024-08-19",0,0,1,0,0,2,0,0
"Luxembourg","2024-08-20",0,0,1,0,0,2,0,0
"Luxembourg","2024-08-21",0,0,1,0,0,2,0,0
"Luxembourg","2024-08-22",0,0,1,0,0,2,0,0
"Luxembourg","2024-08-23",0,0,1,0,0,2,0,0
"Luxembourg","2024-08-24",0,0,1,0,0,2,0,0
"Luxembourg","2024-08-25",0,0,1,0,0,2,0,0
"Luxembourg","2024-08-26",0,0,1,0,0,2,0,0
"Luxembourg","2024-08-27",0,0,1,0,0,2,0,0
"Luxembourg","2024-08-28",0,0,1,0,0,2,0,0
"Luxembourg","2024-08-29",0,0,1,0,0,2,0,0
"Luxembourg","2024-08-30",0,0,1,0,0,2,0,0
"Luxembourg","2024-08-31",0,0,1,0,0,2,0,0
"Luxembourg","2024-09-01",0,0,1,0,0,2,0,0
"Luxembourg","2024-09-02",0,0,1,0,0,2,0,0
"Luxembourg","2024-09-03",0,0,1,0,0,2,0,0
"Luxembourg","2024-09-04",0,0,1,0,0,2,0,0
"Luxembourg","2024-09-05",0,0,1,0,0,2,0,0
"Luxembourg","2024-09-06",0,0,1,0,0,2,0,0
"Luxembourg","2024-09-07",0,0,1,0,0,2,0,0
"Luxembourg","2024-09-08",0,0,1,0,0,2,0,0
"Luxembourg","2024-09-09",0,0,1,0,0,2,0,0
"Luxembourg","2024-09-10",0,0,1,0,0,2,0,0
"Luxembourg","2024-09-11",0,0,1,0,0,2,0,0
"Luxembourg","2024-09-12",0,0,1,0,0,2,0,0
"Luxembourg","2024-09-13",0,0,1,0,0,2,0,0
"Luxembourg","2024-09-14",0,0,1,0,0,2,0,0
"Luxembourg","2024-09-15",0,0,1,0,0,2,0,0
"Luxembourg","2024-09-16",0,0,1,0,0,2,0,0
"Luxembourg","2024-09-17",0,0,1,0,0,2,0,0
"Luxembourg","2024-09-18",0,0,1,0,0,2,0,0
"Luxembourg","2024-09-19",0,0,1,0,0,2,0,0
"Luxembourg","2024-09-20",0,0,1,0,0,2,0,0
"Luxembourg","2024-09-21",0,0,1,0,0,2,0,0
"Luxembourg","2024-09-22",0,0,1,0,0,2,0,0
"Luxembourg","2024-09-23",0,0,1,0,0,2,0,0
"Luxembourg","2024-09-24",0,0,1,0,0,2,0,0
"Luxembourg","2024-09-25",0,0,1,0,0,2,0,0
"Luxembourg","2024-09-26",0,0,1,0,0,2,0,0
"Luxembourg","2024-09-27",0,0,1,0,0,2,0,0
"Luxembourg","2024-09-28",0,0,1,0,0,2,0,0
"Luxembourg","2024-09-29",0,0,1,0,0,2,0,0
"Luxembourg","2024-09-30",0,0,1,0,0,2,0,0
"Luxembourg","2024-10-01",0,0,1,0,0,2,0,0
"Luxembourg","2024-10-02",0,0,1,0,0,2,0,0
"Luxembourg","2024-10-03",0,0,1,0,0,2,0,0
"Luxembourg","2024-10-04",0,0,1,0,0,2,0,0
"Luxembourg","2024-10-05",0,0,1,0,0,2,0,0
"Luxembourg","2024-10-06",0,0,1,0,0,2,0,0
"Luxembourg","2024-10-07",0,0,1,0,0,2,0,0
"Luxembourg","2024-10-08",0,0,1,0,0,2,0,0
"Luxembourg","2024-10-09",0,0,1,0,0,2,0,0
"Luxembourg","2024-10-10",0,0,1,0,0,2,0,0
"Luxembourg","2024-10-11",0,0,1,0,0,2,0,0
"Luxembourg","2024-10-12",0,0,1,0,0,2,0,0
"Luxembourg","2024-10-13",0,0,1,0,0,2,0,0
"Luxembourg","2024-10-14",0,0,1,0,0,2,0,0
"Luxembourg","2024-10-15",0,0,1,0,0,2,0,0
"Luxembourg","2024-10-16",0,0,1,0,0,2,0,0
"Luxembourg","2024-10-17",0,0,1,0,0,2,0,0
"Luxembourg","2024-10-18",0,0,1,0,0,2,0,0
"Luxembourg","2024-10-19",0,0,1,0,0,2,0,0
"Luxembourg","2024-10-20",0,0,1,0,0,2,0,0
"Luxembourg","2024-10-21",0,0,1,0,0,2,0,0
"Luxembourg","2024-10-22",0,0,1,0,0,2,0,0
"Luxembourg","2024-10-23",0,0,1,0,0,2,0,0
"Luxembourg","2024-10-24",0,0,1,0,0,2,0,0
"Luxembourg","2024-10-25",0,0,1,0,0,2,0,0
"Luxembourg","2024-10-26",0,0,1,0,0,2,0,0
"Luxembourg","2024-10-27",0,0,1,0,0,2,0,0
"Luxembourg","2024-10-28",0,0,1,0,0,2,0,0
"Luxembourg","2024-10-29",0,0,1,0,0,2,0,0
"Luxembourg","2024-10-30",0,0,1,0,0,2,0,0
"Luxembourg","2024-10-31",0,1,2,0,0,2,0,0
"Luxembourg","2024-11-01",0,0,2,0,0,2,0,0
"Luxembourg","2024-11-02",0,0,2,0,0,2,0,0
"Luxembourg","2024-11-03",0,0,2,0,0,2,0,0
"Luxembourg","2024-11-04",0,0,2,0,0,2,0,0
"Luxembourg","2024-11-05",0,0,2,0,0,2,0,0
"Luxembourg","2024-11-06",0,0,2,0,0,2,0,0
"Luxembourg","2024-11-07",0,0,2,0,0,2,0,0
"Luxembourg","2024-11-08",0,0,2,0,0,2,0,0
"Luxembourg","2024-11-09",0,0,2,0,0,2,0,0
"Luxembourg","2024-11-10",0,0,2,0,0,2,0,0
"Luxembourg","2024-11-11",0,0,2,0,0,2,0,0
"Luxembourg","2024-11-12",0,0,2,0,0,2,0,0
"Luxembourg","2024-11-13",0,0,2,0,0,2,0,0
"Luxembourg","2024-11-14",0,0,2,0,0,2,0,0
"Luxembourg","2024-11-15",0,0,2,0,0,2,0,0
"Luxembourg","2024-11-16",0,0,2,0,0,2,0,0
"Luxembourg","2024-11-17",0,0,2,0,0,2,0,0
"Luxembourg","2024-11-18",0,0,2,0,0,2,0,0
"Luxembourg","2024-11-19",0,0,2,0,0,2,0,0
"Luxembourg","2024-11-20",0,0,2,0,0,2,0,0
"Luxembourg","2024-11-21",0,0,2,0,0,2,0,0
"Luxembourg","2024-11-22",0,0,2,0,0,2,0,0
"Luxembourg","2024-11-23",0,0,2,0,0,2,0,0
"Luxembourg","2024-11-24",0,0,2,0,0,2,0,0
"Luxembourg","2024-11-25",0,0,2,0,0,2,0,0
"Luxembourg","2024-11-26",0,0,2,0,0,2,0,0
"Luxembourg","2024-11-27",0,0,2,0,0,2,0,0
"Luxembourg","2024-11-28",0,0,2,0,0,2,0,0
"Luxembourg","2024-11-29",0,0,2,0,0,2,0,0
"Luxembourg","2024-11-30",0,0,2,0,0,2,0,0
"Luxembourg","2024-12-01",0,0,2,0,0,2,0,0
"Luxembourg","2024-12-02",0,0,2,0,0,2,0,0
"Luxembourg","2024-12-03",0,0,2,0,0,2,0,0
"Luxembourg","2024-12-04",0,0,2,0,0,2,0,0
"Luxembourg","2024-12-05",0,0,2,0,0,2,0,0
"Luxembourg","2024-12-06",0,0,2,0,0,2,0,0
"Luxembourg","2024-12-07",0,0,2,0,0,2,0,0
"Luxembourg","2024-12-08",0,0,2,0,0,2,0,0
"Luxembourg","2024-12-09",0,0,2,0,0,2,0,0
"Luxembourg","2024-12-10",0,0,2,0,0,2,0,0
"Luxembourg","2024-12-11",0,0,2,0,0,2,0,0
"Luxembourg","2024-12-12",0,0,2,0,0,2,0,0
"Luxembourg","2024-12-13",0,0,2,0,0,2,0,0
"Luxembourg","2024-12-14",0,0,2,0,0,2,0,0
"Luxembourg","2024-12-15",0,0,2,0,0,2,0,0
"Luxembourg","2024-12-16",0,0,2,0,0,2,0,0
"Luxembourg","2024-12-17",0,0,2,0,0,2,0,0
"Luxembourg","2024-12-18",0,0,2,0,0,2,0,0
"Luxembourg","2024-12-19",0,0,2,0,0,2,0,0
"Luxembourg","2024-12-20",0,0,2,0,0,2,0,0
"Luxembourg","2024-12-21",0,0,2,0,0,2,0,0
"Luxembourg","2024-12-22",0,0,2,0,0,2,0,0
"Luxembourg","2024-12-23",0,0,2,0,0,2,0,0
"Luxembourg","2024-12-24",0,0,2,0,0,2,0,0
"Luxembourg","2024-12-25",0,0,2,0,0,2,0,0
"Luxembourg","2024-12-26",0,0,2,0,0,2,0,0
"Luxembourg","2024-12-27",0,0,2,0,0,2,0,0
"Luxembourg","2024-12-28",0,0,2,0,0,2,0,0
"Luxembourg","2024-12-29",0,0,2,0,0,2,0,0
"Luxembourg","2024-12-30",0,0,2,0,0,2,0,0
"Luxembourg","2024-12-31",0,0,2,0,0,2,0,0
"Luxembourg","2025-01-01",0,0,2,0,0,2,0,0
"Luxembourg","2025-01-02",0,0,2,0,0,2,0,0
"Luxembourg","2025-01-03",0,0,2,0,0,2,0,0
"Luxembourg","2025-01-04",0,0,2,0,0,2,0,0
"Luxembourg","2025-01-05",0,0,2,0,0,2,0,0
"Luxembourg","2025-01-06",0,0,2,0,0,2,0,0
"Luxembourg","2025-01-07",0,0,2,0,0,2,0,0
"Luxembourg","2025-01-08",0,0,2,0,0,2,0,0
"Luxembourg","2025-01-09",0,0,2,0,0,2,0,0
"Luxembourg","2025-01-10",0,0,2,0,0,2,0,0
"Luxembourg","2025-01-11",0,0,2,0,0,2,0,0
"Luxembourg","2025-01-12",0,0,2,0,0,2,0,0
"Luxembourg","2025-01-13",0,0,2,0,0,2,0,0
"Luxembourg","2025-01-14",0,0,2,0,0,2,0,0
"Luxembourg","2025-01-15",0,0,2,0,0,2,0,0
"Luxembourg","2025-01-16",0,0,2,0,0,2,0,0
"Luxembourg","2025-01-17",0,0,2,0,0,2,0,0
"Luxembourg","2025-01-18",0,0,2,0,0,2,0,0
"Luxembourg","2025-01-19",0,0,2,0,0,2,0,0
"Luxembourg","2025-01-20",0,0,2,0,0,2,0,0
"Luxembourg","2025-01-21",0,0,2,0,0,2,0,0
"Luxembourg","2025-01-22",0,0,2,0,0,2,0,0
"Luxembourg","2025-01-23",0,0,2,0,0,2,0,0
"Luxembourg","2025-01-24",0,0,2,0,0,2,0,0
"Luxembourg","2025-01-25",0,0,2,0,0,2,0,0
"Luxembourg","2025-01-26",0,0,2,0,0,2,0,0
"Luxembourg","2025-01-27",0,0,2,0,0,2,0,0
"Luxembourg","2025-01-28",0,0,2,0,0,2,0,0
"Luxembourg","2025-01-29",0,0,2,0,0,2,0,0
"Luxembourg","2025-01-30",0,0,2,0,0,2,0,0
"Luxembourg","2025-01-31",0,0,2,0,0,2,0,0
"Luxembourg","2025-02-01",0,0,2,0,0,2,0,0
"Luxembourg","2025-02-02",0,0,2,0,0,2,0,0
"Luxembourg","2025-02-03",0,0,2,0,0,2,0,0
"Malaysia","2024-01-01",0,0,0,0,0,0,0,0
"Malaysia","2024-01-02",0,0,0,0,0,0,0,0
"Malaysia","2024-01-03",0,0,0,0,0,0,0,0
"Malaysia","2024-01-04",0,0,0,0,0,0,0,0
"Malaysia","2024-01-05",0,0,0,0,0,0,0,0
"Malaysia","2024-01-06",0,0,0,0,0,0,0,0
"Malaysia","2024-01-07",0,0,0,0,0,0,0,0
"Malaysia","2024-01-08",0,0,0,0,0,0,0,0
"Malaysia","2024-01-09",0,0,0,0,0,0,0,0
"Malaysia","2024-01-10",0,0,0,0,0,0,0,0
"Malaysia","2024-01-11",0,0,0,0,0,0,0,0
"Malaysia","2024-01-12",0,0,0,0,0,0,0,0
"Malaysia","2024-01-13",0,0,0,0,0,0,0,0
"Malaysia","2024-01-14",0,0,0,0,0,0,0,0
"Malaysia","2024-01-15",0,0,0,0,0,0,0,0
"Malaysia","2024-01-16",0,0,0,0,0,0,0,0
"Malaysia","2024-01-17",0,0,0,0,0,0,0,0
"Malaysia","2024-01-18",0,0,0,0,0,0,0,0
"Malaysia","2024-01-19",0,0,0,0,0,0,0,0
"Malaysia","2024-01-20",0,0,0,0,0,0,0,0
"Malaysia","2024-01-21",0,0,0,0,0,0,0,0
"Malaysia","2024-01-22",0,0,0,0,0,0,0,0
"Malaysia","2024-01-23",0,0,0,0,0,0,0,0
"Malaysia","2024-01-24",0,0,0,0,0,0,0,0
"Malaysia","2024-01-25",0,0,0,0,0,0,0,0
"Malaysia","2024-01-26",0,0,0,0,0,0,0,0
"Malaysia","2024-01-27",0,0,0,0,0,0,0,0
"Malaysia","2024-01-28",0,0,0,0,0,0,0,0
"Malaysia","2024-01-29",0,0,0,0,0,0,0,0
"Malaysia","2024-01-30",0,0,0,0,0,0,0,0
"Malaysia","2024-01-31",0,0,0,0,0,0,0,0
"Malaysia","2024-02-01",0,0,0,0,0,0,0,0
"Malaysia","2024-02-02",0,0,0,0,0,0,0,0
"Malaysia","2024-02-03",0,0,0,0,0,0,0,0
"Malaysia","2024-02-04",0,0,0,0,0,0,0,0
"Malaysia","2024-02-05",0,0,0,0,0,0,0,0
"Malaysia","2024-02-06",0,0,0,0,0,0,0,0
"Malaysia","2024-02-07",0,0,0,0,0,0,0,0
"Malaysia","2024-02-08",0,0,0,0,0,0,0,0
"Malaysia","2024-02-09",0,0,0,0,0,0,0,0
"Malaysia","2024-02-10",0,0,0,0,0,0,0,0
"Malaysia","2024-02-11",0,0,0,0,0,0,0,0
"Malaysia","2024-02-12",0,0,0,0,0,0,0,0
"Malaysia","2024-02-13",0,0,0,0,0,0,0,0
"Malaysia","2024-02-14",0,0,0,0,0,0,0,0
"Malaysia","2024-02-15",0,0,0,0,0,0,0,0
"Malaysia","2024-02-16",0,0,0,0,0,0,0,0
"Malaysia","2024-02-17",0,0,0,0,0,0,0,0
"Malaysia","2024-02-18",0,0,0,0,0,0,0,0
"Malaysia","2024-02-19",0,0,0,0,0,0,0,0
"Malaysia","2024-02-20",0,0,0,0,0,0,0,0
"Malaysia","2024-02-21",0,0,0,0,0,0,0,0
"Malaysia","2024-02-22",0,0,0,0,0,0,0,0
"Malaysia","2024-02-23",0,0,0,0,0,0,0,0
"Malaysia","2024-02-24",0,0,0,0,0,0,0,0
"Malaysia","2024-02-25",0,0,0,0,0,0,0,0
"Malaysia","2024-02-26",0,0,0,0,0,0,0,0
"Malaysia","2024-02-27",0,0,0,0,0,0,0,0
"Malaysia","2024-02-28",0,0,0,0,0,0,0,0
"Malaysia","2024-02-29",0,0,0,0,0,0,0,0
"Malaysia","2024-03-01",0,0,0,0,0,0,0,0
"Malaysia","2024-03-02",0,0,0,0,0,0,0,0
"Malaysia","2024-03-03",0,0,0,0,0,0,0,0
"Malaysia","2024-03-04",0,0,0,0,0,0,0,0
"Malaysia","2024-03-05",0,0,0,0,0,0,0,0
"Malaysia","2024-03-06",0,0,0,0,0,0,0,0
"Malaysia","2024-03-07",0,0,0,0,0,0,0,0
"Malaysia","2024-03-08",0,0,0,0,0,0,0,0
"Malaysia","2024-03-09",0,0,0,0,0,0,0,0
"Malaysia","2024-03-10",0,0,0,0,0,0,0,0
"Malaysia","2024-03-11",0,0,0,0,0,0,0,0
"Malaysia","2024-03-12",0,0,0,0,0,0,0,0
"Malaysia","2024-03-13",0,0,0,0,0,0,0,0
"Malaysia","2024-03-14",0,0,0,0,0,0,0,0
"Malaysia","2024-03-15",0,0,0,0,0,0,0,0
"Malaysia","2024-03-16",0,0,0,0,0,0,0,0
"Malaysia","2024-03-17",0,0,0,0,0,0,0,0
"Malaysia","2024-03-18",0,0,0,0,0,0,0,0
"Malaysia","2024-03-19",0,0,0,0,0,0,0,0
"Malaysia","2024-03-20",0,0,0,0,0,0,0,0
"Malaysia","2024-03-21",0,0,0,0,0,0,0,0
"Malaysia","2024-03-22",0,0,0,0,0,0,0,0
"Malaysia","2024-03-23",0,0,0,0,0,0,0,0
"Malaysia","2024-03-24",0,0,0,0,0,0,0,0
"Malaysia","2024-03-25",0,0,0,0,0,0,0,0
"Malaysia","2024-03-26",0,0,0,0,0,0,0,0
"Malaysia","2024-03-27",0,0,0,0,0,0,0,0
"Malaysia","2024-03-28",0,0,0,0,0,0,0,0
"Malaysia","2024-03-29",0,0,0,0,0,0,0,0
"Malaysia","2024-03-30",0,0,0,0,0,0,0,0
"Malaysia","2024-03-31",0,0,0,0,0,0,0,0
"Malaysia","2024-04-01",0,0,0,0,0,0,0,0
"Malaysia","2024-04-02",0,0,0,0,0,0,0,0
"Malaysia","2024-04-03",0,0,0,0,0,0,0,0
"Malaysia","2024-04-04",0,0,0,0,0,0,0,0
"Malaysia","2024-04-05",0,0,0,0,0,0,0,0
"Malaysia","2024-04-06",0,0,0,0,0,0,0,0
"Malaysia","2024-04-07",0,0,0,0,0,0,0,0
"Malaysia","2024-04-08",0,0,0,0,0,0,0,0
"Malaysia","2024-04-09",0,0,0,0,0,0,0,0
"Malaysia","2024-04-10",0,0,0,0,0,0,0,0
"Malaysia","2024-04-11",0,0,0,0,0,0,0,0
"Malaysia","2024-04-12",0,0,0,0,0,0,0,0
"Malaysia","2024-04-13",0,0,0,0,0,0,0,0
"Malaysia","2024-04-14",0,0,0,0,0,0,0,0
"Malaysia","2024-04-15",0,0,0,0,0,0,0,0
"Malaysia","2024-04-16",0,0,0,0,0,0,0,0
"Malaysia","2024-04-17",0,0,0,0,0,0,0,0
"Malaysia","2024-04-18",0,0,0,0,0,0,0,0
"Malaysia","2024-04-19",0,0,0,0,0,0,0,0
"Malaysia","2024-04-20",0,0,0,0,0,0,0,0
"Malaysia","2024-04-21",0,0,0,0,0,0,0,0
"Malaysia","2024-04-22",0,0,0,0,0,0,0,0
"Malaysia","2024-04-23",0,0,0,0,0,0,0,0
"Malaysia","2024-04-24",0,0,0,0,0,0,0,0
"Malaysia","2024-04-25",0,0,0,0,0,0,0,0
"Malaysia","2024-04-26",0,0,0,0,0,0,0,0
"Malaysia","2024-04-27",0,0,0,0,0,0,0,0
"Malaysia","2024-04-28",0,0,0,0,0,0,0,0
"Malaysia","2024-04-29",0,0,0,0,0,0,0,0
"Malaysia","2024-04-30",0,0,0,0,0,0,0,0
"Malaysia","2024-05-01",0,0,0,0,0,0,0,0
"Malaysia","2024-05-02",0,0,0,0,0,0,0,0
"Malaysia","2024-05-03",0,0,0,0,0,0,0,0
"Malaysia","2024-05-04",0,0,0,0,0,0,0,0
"Malaysia","2024-05-05",0,0,0,0,0,0,0,0
"Malaysia","2024-05-06",0,0,0,0,0,0,0,0
"Malaysia","2024-05-07",0,0,0,0,0,0,0,0
"Malaysia","2024-05-08",0,0,0,0,0,0,0,0
"Malaysia","2024-05-09",0,0,0,0,0,0,0,0
"Malaysia","2024-05-10",0,0,0,0,0,0,0,0
"Malaysia","2024-05-11",0,0,0,0,0,0,0,0
"Malaysia","2024-05-12",0,0,0,0,0,0,0,0
"Malaysia","2024-05-13",0,0,0,0,0,0,0,0
"Malaysia","2024-05-14",0,0,0,0,0,0,0,0
"Malaysia","2024-05-15",0,0,0,0,0,0,0,0
"Malaysia","2024-05-16",0,0,0,0,0,0,0,0
"Malaysia","2024-05-17",0,0,0,0,0,0,0,0
"Malaysia","2024-05-18",0,0,0,0,0,0,0,0
"Malaysia","2024-05-19",0,0,0,0,0,0,0,0
"Malaysia","2024-05-20",0,0,0,0,0,0,0,0
"Malaysia","2024-05-21",0,0,0,0,0,0,0,0
"Malaysia","2024-05-22",0,0,0,0,0,0,0,0
"Malaysia","2024-05-23",0,0,0,0,0,0,0,0
"Malaysia","2024-05-24",0,0,0,0,0,0,0,0
"Malaysia","2024-05-25",0,0,0,0,0,0,0,0
"Malaysia","2024-05-26",0,0,0,0,0,0,0,0
"Malaysia","2024-05-27",0,0,0,0,0,0,0,0
"Malaysia","2024-05-28",0,0,0,0,0,0,0,0
"Malaysia","2024-05-29",0,0,0,0,0,0,0,0
"Malaysia","2024-05-30",0,0,0,0,0,0,0,0
"Malaysia","2024-05-31",0,0,0,0,0,0,0,0
"Malaysia","2024-06-01",0,0,0,0,0,0,0,0
"Malaysia","2024-06-02",0,0,0,0,0,0,0,0
"Malaysia","2024-06-03",0,0,0,0,0,0,0,0
"Malaysia","2024-06-04",0,0,0,0,0,0,0,0
"Malaysia","2024-06-05",0,0,0,0,0,0,0,0
"Malaysia","2024-06-06",0,0,0,0,0,0,0,0
"Malaysia","2024-06-07",0,0,0,0,0,0,0,0
"Malaysia","2024-06-08",0,0,0,0,0,0,0,0
"Malaysia","2024-06-09",0,0,0,0,0,0,0,0
"Malaysia","2024-06-10",0,0,0,0,0,0,0,0
"Malaysia","2024-06-11",0,0,0,0,0,0,0,0
"Malaysia","2024-06-12",0,0,0,0,0,0,0,0
"Malaysia","2024-06-13",0,0,0,0,0,0,0,0
"Malaysia","2024-06-14",0,0,0,0,0,0,0,0
"Malaysia","2024-06-15",0,0,0,0,0,0,0,0
"Malaysia","2024-06-16",0,0,0,0,0,0,0,0
"Malaysia","2024-06-17",0,0,0,0,0,0,0,0
"Malaysia","2024-06-18",0,0,0,0,0,0,0,0
"Malaysia","2024-06-19",0,0,0,0,0,0,0,0
"Malaysia","2024-06-20",0,0,0,0,0,0,0,0
"Malaysia","2024-06-21",0,0,0,0,0,0,0,0
"Malaysia","2024-06-22",0,0,0,0,0,0,0,0
"Malaysia","2024-06-23",0,0,0,0,0,0,0,0
"Malaysia","2024-06-24",0,0,0,0,0,0,0,0
"Malaysia","2024-06-25",0,0,0,0,0,0,0,0
"Malaysia","2024-06-26",0,0,0,0,0,0,0,0
"Malaysia","2024-06-27",0,0,0,0,0,0,0,0
"Malaysia","2024-06-28",0,0,0,0,0,0,0,0
"Malaysia","2024-06-29",0,0,0,0,0,0,0,0
"Malaysia","2024-06-30",0,0,0,0,0,0,0,0
"Malaysia","2024-07-01",0,0,0,0,0,0,0,0
"Malaysia","2024-07-02",0,0,0,0,0,0,0,0
"Malaysia","2024-07-03",0,0,0,0,0,0,0,0
"Malaysia","2024-07-04",0,0,0,0,0,0,0,0
"Malaysia","2024-07-05",0,0,0,0,0,0,0,0
"Malaysia","2024-07-06",0,0,0,0,0,0,0,0
"Malaysia","2024-07-07",0,0,0,0,0,0,0,0
"Malaysia","2024-07-08",0,0,0,0,0,0,0,0
"Malaysia","2024-07-09",0,0,0,0,0,0,0,0
"Malaysia","2024-07-10",0,0,0,0,0,0,0,0
"Malaysia","2024-07-11",0,0,0,0,0,0,0,0
"Malaysia","2024-07-12",0,0,0,0,0,0,0,0
"Malaysia","2024-07-13",0,0,0,0,0,0,0,0
"Malaysia","2024-07-14",0,0,0,0,0,0,0,0
"Malaysia","2024-07-15",0,0,0,0,0,0,0,0
"Malaysia","2024-07-16",0,0,0,0,0,0,0,0
"Malaysia","2024-07-17",0,0,0,0,0,0,0,0
"Malaysia","2024-07-18",0,0,0,0,0,0,0,0
"Malaysia","2024-07-19",0,0,0,0,0,0,0,0
"Malaysia","2024-07-20",0,0,0,0,0,0,0,0
"Malaysia","2024-07-21",0,0,0,0,0,0,0,0
"Malaysia","2024-07-22",0,0,0,0,0,0,0,0
"Malaysia","2024-07-23",0,0,0,0,0,0,0,0
"Malaysia","2024-07-24",0,0,0,0,0,0,0,0
"Malaysia","2024-07-25",0,0,0,0,0,0,0,0
"Malaysia","2024-07-26",0,0,0,0,0,0,0,0
"Malaysia","2024-07-27",0,0,0,0,0,0,0,0
"Malaysia","2024-07-28",0,0,0,0,0,0,0,0
"Malaysia","2024-07-29",0,0,0,0,0,0,0,0
"Malaysia","2024-07-30",0,0,0,0,0,0,0,0
"Malaysia","2024-07-31",0,0,0,0,0,0,0,0
"Malaysia","2024-08-01",0,0,0,0,0,0,0,0
"Malaysia","2024-08-02",0,0,0,0,0,0,0,0
"Malaysia","2024-08-03",0,0,0,0,0,0,0,0
"Malaysia","2024-08-04",0,0,0,0,0,0,0,0
"Malaysia","2024-08-05",0,0,0,0,0,0,0,0
"Malaysia","2024-08-06",0,0,0,0,0,0,0,0
"Malaysia","2024-08-07",0,0,0,0,0,0,0,0
"Malaysia","2024-08-08",0,0,0,0,0,0,0,0
"Malaysia","2024-08-09",0,0,0,0,0,0,0,0
"Malaysia","2024-08-10",0,0,0,0,0,0,0,0
"Malaysia","2024-08-11",0,0,0,0,0,0,0,0
"Malaysia","2024-08-12",0,0,0,0,0,0,0,0
"Malaysia","2024-08-13",0,0,0,0,0,0,0,0
"Malaysia","2024-08-14",0,0,0,0,0,0,0,0
"Malaysia","2024-08-15",0,0,0,0,0,0,0,0
"Malaysia","2024-08-16",0,0,0,0,0,0,0,0
"Malaysia","2024-08-17",0,0,0,0,0,0,0,0
"Malaysia","2024-08-18",0,0,0,0,0,0,0,0
"Malaysia","2024-08-19",0,0,0,0,0,0,0,0
"Malaysia","2024-08-20",0,0,0,0,0,0,0,0
"Malaysia","2024-08-21",0,0,0,0,0,0,0,0
"Malaysia","2024-08-22",0,0,0,0,0,0,0,0
"Malaysia","2024-08-23",0,0,0,0,0,0,0,0
"Malaysia","2024-08-24",0,0,0,0,0,0,0,0
"Malaysia","2024-08-25",0,0,0,0,0,0,0,0
"Malaysia","2024-08-26",0,0,0,0,0,0,0,0
"Malaysia","2024-08-27",0,0,0,0,0,0,0,0
"Malaysia","2024-08-28",0,0,0,0,0,0,0,0
"Malaysia","2024-08-29",0,0,0,0,0,0,0,0
"Malaysia","2024-08-30",0,0,0,0,0,0,0,0
"Malaysia","2024-08-31",0,0,0,0,0,0,0,0
"Malaysia","2024-09-01",0,0,0,0,0,0,0,0
"Malaysia","2024-09-02",0,0,0,0,0,0,0,0
"Malaysia","2024-09-03",0,0,0,0,0,0,0,0
"Malaysia","2024-09-04",0,0,0,0,0,0,0,0
"Malaysia","2024-09-05",0,0,0,0,0,0,0,0
"Malaysia","2024-09-06",0,0,0,0,0,0,0,0
"Malaysia","2024-09-07",0,0,0,0,0,0,0,0
"Malaysia","2024-09-08",0,0,0,0,0,0,0,0
"Malaysia","2024-09-09",0,0,0,0,0,0,0,0
"Malaysia","2024-09-10",0,0,0,0,0,0,0,0
"Malaysia","2024-09-11",0,0,0,0,0,0,0,0
"Malaysia","2024-09-12",0,0,0,0,0,0,0,0
"Malaysia","2024-09-13",0,0,0,0,0,0,0,0
"Malaysia","2024-09-14",0,0,0,0,0,0,0,0
"Malaysia","2024-09-15",0,0,0,0,0,0,0,0
"Malaysia","2024-09-16",0,0,0,0,0,0,0,0
"Malaysia","2024-09-17",0,0,0,0,0,0,0,0
"Malaysia","2024-09-18",0,1,1,0,1,1,0,0
"Malaysia","2024-09-19",0,0,1,0,0,1,0,0
"Malaysia","2024-09-20",0,0,1,0,0,1,0,0
"Malaysia","2024-09-21",0,0,1,0,0,1,0,0
"Malaysia","2024-09-22",0,0,1,0,0,1,0,0
"Malaysia","2024-09-23",0,0,1,0,0,1,0,0
"Malaysia","2024-09-24",0,0,1,0,0,1,0,0
"Malaysia","2024-09-25",0,0,1,0,0,1,0,0
"Malaysia","2024-09-26",0,0,1,0,0,1,0,0
"Malaysia","2024-09-27",0,0,1,0,0,1,0,0
"Malaysia","2024-09-28",0,0,1,0,0,1,0,0
"Malaysia","2024-09-29",0,0,1,0,0,1,0,0
"Malaysia","2024-09-30",0,0,1,0,0,1,0,0
"Malaysia","2024-10-01",0,0,1,0,0,1,0,0
"Malaysia","2024-10-02",0,0,1,0,0,1,0,0
"Malaysia","2024-10-03",0,0,1,0,0,1,0,0
"Malaysia","2024-10-04",0,0,1,0,0,1,0,0
"Malaysia","2024-10-05",0,0,1,0,0,1,0,0
"Malaysia","2024-10-06",0,0,1,0,0,1,0,0
"Malaysia","2024-10-07",0,0,1,0,0,1,0,0
"Malaysia","2024-10-08",0,0,1,0,0,1,0,0
"Malaysia","2024-10-09",0,0,1,0,0,1,0,0
"Malaysia","2024-10-10",0,0,1,0,0,1,0,0
"Malaysia","2024-10-11",0,0,1,0,0,1,0,0
"Malaysia","2024-10-12",0,0,1,0,0,1,0,0
"Malaysia","2024-10-13",0,0,1,0,0,1,0,0
"Malaysia","2024-10-14",0,0,1,0,0,1,0,0
"Malaysia","2024-10-15",0,0,1,0,0,1,0,0
"Malaysia","2024-10-16",0,0,1,0,0,1,0,0
"Malaysia","2024-10-17",0,0,1,0,1,2,0,0
"Malaysia","2024-10-18",0,0,1,0,0,2,0,0
"Malaysia","2024-10-19",0,0,1,0,0,2,0,0
"Malaysia","2024-10-20",0,0,1,0,0,2,0,0
"Malaysia","2024-10-21",0,0,1,0,0,2,0,0
"Malaysia","2024-10-22",0,0,1,0,0,2,0,0
"Malaysia","2024-10-23",0,0,1,0,0,2,0,0
"Malaysia","2024-10-24",0,0,1,0,0,2,0,0
"Malaysia","2024-10-25",0,0,1,0,0,2,0,0
"Malaysia","2024-10-26",0,0,1,0,0,2,0,0
"Malaysia","2024-10-27",0,0,1,0,0,2,0,0
"Malaysia","2024-10-28",0,0,1,0,0,2,0,0
"Malaysia","2024-10-29",0,0,1,0,0,2,0,0
"Malaysia","2024-10-30",0,0,1,0,0,2,0,0
"Malaysia","2024-10-31",0,0,1,0,0,2,0,0
"Malaysia","2024-11-01",0,0,1,0,0,2,0,0
"Malaysia","2024-11-02",0,0,1,0,0,2,0,0
"Malaysia","2024-11-03",0,0,1,0,0,2,0,0
"Malaysia","2024-11-04",0,0,1,0,0,2,0,0
"Malaysia","2024-11-05",0,0,1,0,0,2,0,0
"Malaysia","2024-11-06",0,0,1,0,0,2,0,0
"Malaysia","2024-11-07",0,0,1,0,0,2,0,0
"Malaysia","2024-11-08",0,0,1,0,0,2,0,0
"Malaysia","2024-11-09",0,0,1,0,0,2,0,0
"Malaysia","2024-11-10",0,0,1,0,0,2,0,0
"Malaysia","2024-11-11",0,0,1,0,0,2,0,0
"Malaysia","2024-11-12",0,0,1,0,0,2,0,0
"Malaysia","2024-11-13",0,0,1,0,0,2,0,0
"Malaysia","2024-11-14",0,0,1,0,0,2,0,0
"Malaysia","2024-11-15",0,0,1,0,0,2,0,0
"Malaysia","2024-11-16",0,0,1,0,0,2,0,0
"Malaysia","2024-11-17",0,0,1,0,0,2,0,0
"Malaysia","2024-11-18",0,0,1,0,0,2,0,0
"Malaysia","2024-11-19",0,0,1,0,0,2,0,0
"Malaysia","2024-11-20",0,0,1,0,0,2,0,0
"Malaysia","2024-11-21",0,0,1,0,0,2,0,0
"Malaysia","2024-11-22",0,0,1,0,0,2,0,0
"Malaysia","2024-11-23",0,0,1,0,0,2,0,0
"Malaysia","2024-11-24",0,0,1,0,0,2,0,0
"Malaysia","2024-11-25",0,0,1,0,0,2,0,0
"Malaysia","2024-11-26",0,0,1,0,0,2,0,0
"Malaysia","2024-11-27",0,0,1,0,0,2,0,0
"Malaysia","2024-11-28",0,0,1,0,0,2,0,0
"Malaysia","2024-11-29",0,0,1,0,0,2,0,0
"Malaysia","2024-11-30",0,0,1,0,0,2,0,0
"Malaysia","2024-12-01",0,0,1,0,0,2,0,0
"Malaysia","2024-12-02",0,0,1,0,0,2,0,0
"Malaysia","2024-12-03",0,0,1,0,0,2,0,0
"Malaysia","2024-12-04",0,0,1,0,0,2,0,0
"Malaysia","2024-12-05",0,0,1,0,0,2,0,0
"Malaysia","2024-12-06",0,0,1,0,0,2,0,0
"Malaysia","2024-12-07",0,0,1,0,0,2,0,0
"Malaysia","2024-12-08",0,0,1,0,0,2,0,0
"Malaysia","2024-12-09",0,0,1,0,0,2,0,0
"Malaysia","2024-12-10",0,0,1,0,0,2,0,0
"Malaysia","2024-12-11",0,0,1,0,0,2,0,0
"Malaysia","2024-12-12",0,0,1,0,0,2,0,0
"Malaysia","2024-12-13",0,0,1,0,1,3,0,0
"Malaysia","2024-12-14",0,0,1,0,0,3,0,0
"Malaysia","2024-12-15",0,0,1,0,0,3,0,0
"Malaysia","2024-12-16",0,0,1,0,0,3,0,0
"Malaysia","2024-12-17",0,0,1,0,0,3,0,0
"Malaysia","2024-12-18",0,0,1,0,0,3,0,0
"Malaysia","2024-12-19",0,0,1,0,0,3,0,0
"Malaysia","2024-12-20",0,0,1,0,0,3,0,0
"Malaysia","2024-12-21",0,0,1,0,0,3,0,0
"Malaysia","2024-12-22",0,0,1,0,0,3,0,0
"Malaysia","2024-12-23",0,0,1,0,0,3,0,0
"Malaysia","2024-12-24",0,0,1,0,0,3,0,0
"Malaysia","2024-12-25",0,0,1,0,0,3,0,0
"Malaysia","2024-12-26",0,0,1,0,0,3,0,0
"Malaysia","2024-12-27",0,0,1,0,0,3,0,0
"Malaysia","2024-12-28",0,0,1,0,0,3,0,0
"Malaysia","2024-12-29",0,0,1,0,0,3,0,0
"Malaysia","2024-12-30",0,0,1,0,0,3,0,0
"Malaysia","2024-12-31",0,0,1,0,0,3,0,0
"Malaysia","2025-01-01",0,0,1,0,0,3,0,0
"Malaysia","2025-01-02",0,0,1,0,0,3,0,0
"Malaysia","2025-01-03",0,0,1,0,0,3,0,0
"Malaysia","2025-01-04",0,0,1,0,0,3,0,0
"Malaysia","2025-01-05",0,0,1,0,0,3,0,0
"Malaysia","2025-01-06",0,0,1,0,0,3,0,0
"Malaysia","2025-01-07",0,0,1,0,0,3,0,0
"Malaysia","2025-01-08",0,0,1,0,0,3,0,0
"Malaysia","2025-01-09",0,0,1,0,0,3,0,0
"Malaysia","2025-01-10",0,2,3,0,0,3,0,0
"Malaysia","2025-01-11",0,0,3,0,0,3,0,0
"Malaysia","2025-01-12",0,0,3,0,0,3,0,0
"Malaysia","2025-01-13",0,0,3,0,0,3,0,0
"Malaysia","2025-01-14",0,0,3,0,0,3,0,0
"Malaysia","2025-01-15",0,0,3,0,0,3,0,0
"Malaysia","2025-01-16",0,0,3,0,0,3,0,0
"Malaysia","2025-01-17",0,0,3,0,0,3,0,0
"Malaysia","2025-01-18",0,0,3,0,0,3,0,0
"Malaysia","2025-01-19",0,0,3,0,0,3,0,0
"Malaysia","2025-01-20",0,0,3,0,0,3,0,0
"Malaysia","2025-01-21",0,0,3,0,0,3,0,0
"Malaysia","2025-01-22",0,0,3,0,0,3,0,0
"Malaysia","2025-01-23",0,0,3,0,0,3,0,0
"Malaysia","2025-01-24",0,0,3,0,0,3,0,0
"Malaysia","2025-01-25",0,0,3,0,0,3,0,0
"Malaysia","2025-01-26",0,0,3,0,0,3,0,0
"Malaysia","2025-01-27",0,0,3,0,0,3,0,0
"Malaysia","2025-01-28",0,0,3,0,0,3,0,0
"Malaysia","2025-01-29",0,0,3,0,0,3,0,0
"Malaysia","2025-01-30",0,0,3,0,0,3,0,0
"Malaysia","2025-01-31",0,0,3,0,0,3,0,0
"Malaysia","2025-02-01",0,0,3,0,0,3,0,0
"Malaysia","2025-02-02",0,0,3,0,0,3,0,0
"Malaysia","2025-02-03",0,0,3,0,0,3,0,0
"Malta","2024-01-01",0,0,0,0,0,0,0,0
"Malta","2024-01-02",0,0,0,0,0,0,0,0
"Malta","2024-01-03",0,0,0,0,0,0,0,0
"Malta","2024-01-04",0,0,0,0,0,0,0,0
"Malta","2024-01-05",0,0,0,0,0,0,0,0
"Malta","2024-01-06",0,0,0,0,0,0,0,0
"Malta","2024-01-07",0,0,0,0,0,0,0,0
"Malta","2024-01-08",0,0,0,0,0,0,0,0
"Malta","2024-01-09",0,0,0,0,0,0,0,0
"Malta","2024-01-10",0,0,0,0,0,0,0,0
"Malta","2024-01-11",0,0,0,0,0,0,0,0
"Malta","2024-01-12",0,0,0,0,0,0,0,0
"Malta","2024-01-13",0,0,0,0,0,0,0,0
"Malta","2024-01-14",0,0,0,0,0,0,0,0
"Malta","2024-01-15",0,0,0,0,0,0,0,0
"Malta","2024-01-16",0,0,0,0,0,0,0,0
"Malta","2024-01-17",0,0,0,0,0,0,0,0
"Malta","2024-01-18",0,0,0,0,0,0,0,0
"Malta","2024-01-19",0,0,0,0,0,0,0,0
"Malta","2024-01-20",0,0,0,0,0,0,0,0
"Malta","2024-01-21",0,0,0,0,0,0,0,0
"Malta","2024-01-22",0,0,0,0,0,0,0,0
"Malta","2024-01-23",0,0,0,0,0,0,0,0
"Malta","2024-01-24",0,0,0,0,0,0,0,0
"Malta","2024-01-25",0,0,0,0,0,0,0,0
"Malta","2024-01-26",0,0,0,0,0,0,0,0
"Malta","2024-01-27",0,0,0,0,0,0,0,0
"Malta","2024-01-28",0,0,0,0,0,0,0,0
"Malta","2024-01-29",0,0,0,0,0,0,0,0
"Malta","2024-01-30",0,0,0,0,0,0,0,0
"Malta","2024-01-31",0,0,0,0,0,0,0,0
"Malta","2024-02-01",0,0,0,0,0,0,0,0
"Malta","2024-02-02",0,0,0,0,0,0,0,0
"Malta","2024-02-03",0,0,0,0,0,0,0,0
"Malta","2024-02-04",0,0,0,0,0,0,0,0
"Malta","2024-02-05",0,0,0,0,0,0,0,0
"Malta","2024-02-06",0,0,0,0,0,0,0,0
"Malta","2024-02-07",0,0,0,0,0,0,0,0
"Malta","2024-02-08",0,0,0,0,0,0,0,0
"Malta","2024-02-09",0,0,0,0,0,0,0,0
"Malta","2024-02-10",0,0,0,0,0,0,0,0
"Malta","2024-02-11",0,0,0,0,0,0,0,0
"Malta","2024-02-12",0,0,0,0,0,0,0,0
"Malta","2024-02-13",0,0,0,0,0,0,0,0
"Malta","2024-02-14",0,0,0,0,0,0,0,0
"Malta","2024-02-15",0,0,0,0,0,0,0,0
"Malta","2024-02-16",0,0,0,0,0,0,0,0
"Malta","2024-02-17",0,0,0,0,0,0,0,0
"Malta","2024-02-18",0,0,0,0,0,0,0,0
"Malta","2024-02-19",0,0,0,0,0,0,0,0
"Malta","2024-02-20",0,0,0,0,0,0,0,0
"Malta","2024-02-21",0,0,0,0,0,0,0,0
"Malta","2024-02-22",0,0,0,0,0,0,0,0
"Malta","2024-02-23",0,0,0,0,0,0,0,0
"Malta","2024-02-24",0,0,0,0,0,0,0,0
"Malta","2024-02-25",0,0,0,0,0,0,0,0
"Malta","2024-02-26",0,0,0,0,0,0,0,0
"Malta","2024-02-27",0,0,0,0,0,0,0,0
"Malta","2024-02-28",0,0,0,0,0,0,0,0
"Malta","2024-02-29",0,0,0,0,0,0,0,0
"Malta","2024-03-01",0,0,0,0,0,0,0,0
"Malta","2024-03-02",0,0,0,0,0,0,0,0
"Malta","2024-03-03",0,0,0,0,0,0,0,0
"Malta","2024-03-04",0,0,0,0,0,0,0,0
"Malta","2024-03-05",0,0,0,0,0,0,0,0
"Malta","2024-03-06",0,0,0,0,0,0,0,0
"Malta","2024-03-07",0,0,0,0,0,0,0,0
"Malta","2024-03-08",0,0,0,0,0,0,0,0
"Malta","2024-03-09",0,0,0,0,0,0,0,0
"Malta","2024-03-10",0,0,0,0,0,0,0,0
"Malta","2024-03-11",0,0,0,0,0,0,0,0
"Malta","2024-03-12",0,0,0,0,0,0,0,0
"Malta","2024-03-13",0,0,0,0,0,0,0,0
"Malta","2024-03-14",0,0,0,0,0,0,0,0
"Malta","2024-03-15",0,0,0,0,0,0,0,0
"Malta","2024-03-16",0,0,0,0,0,0,0,0
"Malta","2024-03-17",0,0,0,0,0,0,0,0
"Malta","2024-03-18",0,0,0,0,0,0,0,0
"Malta","2024-03-19",0,0,0,0,0,0,0,0
"Malta","2024-03-20",0,0,0,0,0,0,0,0
"Malta","2024-03-21",0,0,0,0,0,0,0,0
"Malta","2024-03-22",0,0,0,0,0,0,0,0
"Malta","2024-03-23",0,0,0,0,0,0,0,0
"Malta","2024-03-24",0,0,0,0,0,0,0,0
"Malta","2024-03-25",0,0,0,0,0,0,0,0
"Malta","2024-03-26",0,0,0,0,0,0,0,0
"Malta","2024-03-27",0,0,0,0,0,0,0,0
"Malta","2024-03-28",0,0,0,0,0,0,0,0
"Malta","2024-03-29",0,0,0,0,0,0,0,0
"Malta","2024-03-30",0,0,0,0,0,0,0,0
"Malta","2024-03-31",0,0,0,0,0,0,0,0
"Malta","2024-04-01",0,0,0,0,0,0,0,0
"Malta","2024-04-02",0,0,0,0,0,0,0,0
"Malta","2024-04-03",0,0,0,0,0,0,0,0
"Malta","2024-04-04",0,0,0,0,0,0,0,0
"Malta","2024-04-05",0,0,0,0,0,0,0,0
"Malta","2024-04-06",0,0,0,0,0,0,0,0
"Malta","2024-04-07",0,0,0,0,0,0,0,0
"Malta","2024-04-08",0,0,0,0,0,0,0,0
"Malta","2024-04-09",0,0,0,0,0,0,0,0
"Malta","2024-04-10",0,0,0,0,0,0,0,0
"Malta","2024-04-11",0,0,0,0,0,0,0,0
"Malta","2024-04-12",0,0,0,0,0,0,0,0
"Malta","2024-04-13",0,0,0,0,0,0,0,0
"Malta","2024-04-14",0,0,0,0,0,0,0,0
"Malta","2024-04-15",0,0,0,0,0,0,0,0
"Malta","2024-04-16",0,0,0,0,0,0,0,0
"Malta","2024-04-17",0,0,0,0,0,0,0,0
"Malta","2024-04-18",0,0,0,0,0,0,0,0
"Malta","2024-04-19",0,0,0,0,0,0,0,0
"Malta","2024-04-20",0,0,0,0,0,0,0,0
"Malta","2024-04-21",0,0,0,0,0,0,0,0
"Malta","2024-04-22",0,0,0,0,0,0,0,0
"Malta","2024-04-23",0,0,0,0,0,0,0,0
"Malta","2024-04-24",0,0,0,0,0,0,0,0
"Malta","2024-04-25",0,0,0,0,0,0,0,0
"Malta","2024-04-26",0,0,0,0,0,0,0,0
"Malta","2024-04-27",0,0,0,0,0,0,0,0
"Malta","2024-04-28",0,0,0,0,0,0,0,0
"Malta","2024-04-29",0,0,0,0,0,0,0,0
"Malta","2024-04-30",0,0,0,0,0,0,0,0
"Malta","2024-05-01",0,0,0,0,0,0,0,0
"Malta","2024-05-02",0,0,0,0,0,0,0,0
"Malta","2024-05-03",0,0,0,0,0,0,0,0
"Malta","2024-05-04",0,0,0,0,0,0,0,0
"Malta","2024-05-05",0,0,0,0,0,0,0,0
"Malta","2024-05-06",0,0,0,0,0,0,0,0
"Malta","2024-05-07",0,0,0,0,0,0,0,0
"Malta","2024-05-08",0,0,0,0,0,0,0,0
"Malta","2024-05-09",0,0,0,0,0,0,0,0
"Malta","2024-05-10",0,0,0,0,0,0,0,0
"Malta","2024-05-11",0,0,0,0,0,0,0,0
"Malta","2024-05-12",0,0,0,0,0,0,0,0
"Malta","2024-05-13",0,0,0,0,0,0,0,0
"Malta","2024-05-14",0,0,0,0,0,0,0,0
"Malta","2024-05-15",0,0,0,0,0,0,0,0
"Malta","2024-05-16",0,0,0,0,0,0,0,0
"Malta","2024-05-17",0,0,0,0,0,0,0,0
"Malta","2024-05-18",0,0,0,0,0,0,0,0
"Malta","2024-05-19",0,0,0,0,0,0,0,0
"Malta","2024-05-20",0,0,0,0,0,0,0,0
"Malta","2024-05-21",0,0,0,0,0,0,0,0
"Malta","2024-05-22",0,0,0,0,0,0,0,0
"Malta","2024-05-23",0,0,0,0,0,0,0,0
"Malta","2024-05-24",0,0,0,0,0,0,0,0
"Malta","2024-05-25",0,0,0,0,0,0,0,0
"Malta","2024-05-26",0,0,0,0,0,0,0,0
"Malta","2024-05-27",0,0,0,0,0,0,0,0
"Malta","2024-05-28",0,0,0,0,0,0,0,0
"Malta","2024-05-29",0,0,0,0,0,0,0,0
"Malta","2024-05-30",0,0,0,0,0,0,0,0
"Malta","2024-05-31",0,0,0,0,0,0,0,0
"Malta","2024-06-01",0,0,0,0,0,0,0,0
"Malta","2024-06-02",0,0,0,0,0,0,0,0
"Malta","2024-06-03",0,0,0,0,0,0,0,0
"Malta","2024-06-04",0,0,0,0,0,0,0,0
"Malta","2024-06-05",0,0,0,0,0,0,0,0
"Malta","2024-06-06",0,0,0,0,0,0,0,0
"Malta","2024-06-07",0,0,0,0,0,0,0,0
"Malta","2024-06-08",0,0,0,0,0,0,0,0
"Malta","2024-06-09",0,0,0,0,0,0,0,0
"Malta","2024-06-10",0,0,0,0,0,0,0,0
"Malta","2024-06-11",0,0,0,0,0,0,0,0
"Malta","2024-06-12",0,0,0,0,0,0,0,0
"Malta","2024-06-13",0,0,0,0,0,0,0,0
"Malta","2024-06-14",0,0,0,0,0,0,0,0
"Malta","2024-06-15",0,0,0,0,0,0,0,0
"Malta","2024-06-16",0,0,0,0,0,0,0,0
"Malta","2024-06-17",0,0,0,0,0,0,0,0
"Malta","2024-06-18",0,0,0,0,0,0,0,0
"Malta","2024-06-19",0,0,0,0,0,0,0,0
"Malta","2024-06-20",0,0,0,0,0,0,0,0
"Malta","2024-06-21",0,0,0,0,0,0,0,0
"Malta","2024-06-22",0,0,0,0,0,0,0,0
"Malta","2024-06-23",0,0,0,0,0,0,0,0
"Malta","2024-06-24",0,0,0,0,0,0,0,0
"Malta","2024-06-25",0,0,0,0,0,0,0,0
"Malta","2024-06-26",0,0,0,0,0,0,0,0
"Malta","2024-06-27",0,0,0,0,0,0,0,0
"Malta","2024-06-28",0,0,0,0,0,0,0,0
"Malta","2024-06-29",0,0,0,0,0,0,0,0
"Malta","2024-06-30",0,0,0,0,0,0,0,0
"Malta","2024-07-01",0,0,0,0,0,0,0,0
"Malta","2024-07-02",0,0,0,0,0,0,0,0
"Malta","2024-07-03",0,0,0,0,0,0,0,0
"Malta","2024-07-04",0,0,0,0,0,0,0,0
"Malta","2024-07-05",0,0,0,0,0,0,0,0
"Malta","2024-07-06",0,0,0,0,0,0,0,0
"Malta","2024-07-07",0,0,0,0,0,0,0,0
"Malta","2024-07-08",0,0,0,0,0,0,0,0
"Malta","2024-07-09",0,0,0,0,0,0,0,0
"Malta","2024-07-10",0,0,0,0,0,0,0,0
"Malta","2024-07-11",0,0,0,0,0,0,0,0
"Malta","2024-07-12",0,0,0,0,0,0,0,0
"Malta","2024-07-13",0,0,0,0,0,0,0,0
"Malta","2024-07-14",0,0,0,0,0,0,0,0
"Malta","2024-07-15",0,0,0,0,0,0,0,0
"Malta","2024-07-16",0,0,0,0,0,0,0,0
"Malta","2024-07-17",0,0,0,0,0,0,0,0
"Malta","2024-07-18",0,0,0,0,0,0,0,0
"Malta","2024-07-19",0,0,0,0,0,0,0,0
"Malta","2024-07-20",0,0,0,0,0,0,0,0
"Malta","2024-07-21",0,0,0,0,0,0,0,0
"Malta","2024-07-22",0,0,0,0,0,0,0,0
"Malta","2024-07-23",0,0,0,0,0,0,0,0
"Malta","2024-07-24",0,0,0,0,0,0,0,0
"Malta","2024-07-25",0,0,0,0,0,0,0,0
"Malta","2024-07-26",0,0,0,0,0,0,0,0
"Malta","2024-07-27",0,0,0,0,0,0,0,0
"Malta","2024-07-28",0,0,0,0,0,0,0,0
"Malta","2024-07-29",0,0,0,0,0,0,0,0
"Malta","2024-07-30",0,0,0,0,0,0,0,0
"Malta","2024-07-31",0,0,0,0,0,0,0,0
"Malta","2024-08-01",0,0,0,0,0,0,0,0
"Malta","2024-08-02",0,0,0,0,0,0,0,0
"Malta","2024-08-03",0,0,0,0,0,0,0,0
"Malta","2024-08-04",0,0,0,0,0,0,0,0
"Malta","2024-08-05",0,0,0,0,0,0,0,0
"Malta","2024-08-06",0,0,0,0,0,0,0,0
"Malta","2024-08-07",0,0,0,0,0,0,0,0
"Malta","2024-08-08",0,0,0,0,0,0,0,0
"Malta","2024-08-09",0,0,0,0,0,0,0,0
"Malta","2024-08-10",0,0,0,0,0,0,0,0
"Malta","2024-08-11",0,0,0,0,0,0,0,0
"Malta","2024-08-12",0,0,0,0,0,0,0,0
"Malta","2024-08-13",0,0,0,0,0,0,0,0
"Malta","2024-08-14",0,0,0,0,0,0,0,0
"Malta","2024-08-15",0,0,0,0,0,0,0,0
"Malta","2024-08-16",0,0,0,0,0,0,0,0
"Malta","2024-08-17",0,0,0,0,0,0,0,0
"Malta","2024-08-18",0,0,0,0,0,0,0,0
"Malta","2024-08-19",0,0,0,0,0,0,0,0
"Malta","2024-08-20",0,0,0,0,0,0,0,0
"Malta","2024-08-21",0,0,0,0,0,0,0,0
"Malta","2024-08-22",0,0,0,0,0,0,0,0
"Malta","2024-08-23",0,0,0,0,0,0,0,0
"Malta","2024-08-24",0,0,0,0,0,0,0,0
"Malta","2024-08-25",0,0,0,0,0,0,0,0
"Malta","2024-08-26",0,0,0,0,0,0,0,0
"Malta","2024-08-27",0,0,0,0,0,0,0,0
"Malta","2024-08-28",0,0,0,0,0,0,0,0
"Malta","2024-08-29",0,0,0,0,0,0,0,0
"Malta","2024-08-30",0,0,0,0,0,0,0,0
"Malta","2024-08-31",0,2,2,0,2,2,0,0
"Malta","2024-09-01",0,0,2,0,0,2,0,0
"Malta","2024-09-02",0,0,2,0,0,2,0,0
"Malta","2024-09-03",0,0,2,0,0,2,0,0
"Malta","2024-09-04",0,0,2,0,0,2,0,0
"Malta","2024-09-05",0,0,2,0,0,2,0,0
"Malta","2024-09-06",0,0,2,0,0,2,0,0
"Malta","2024-09-07",0,0,2,0,0,2,0,0
"Malta","2024-09-08",0,0,2,0,0,2,0,0
"Malta","2024-09-09",0,0,2,0,0,2,0,0
"Malta","2024-09-10",0,0,2,0,0,2,0,0
"Malta","2024-09-11",0,0,2,0,0,2,0,0
"Malta","2024-09-12",0,0,2,0,0,2,0,0
"Malta","2024-09-13",0,0,2,0,0,2,0,0
"Malta","2024-09-14",0,0,2,0,0,2,0,0
"Malta","2024-09-15",0,0,2,0,0,2,0,0
"Malta","2024-09-16",0,0,2,0,0,2,0,0
"Malta","2024-09-17",0,0,2,0,0,2,0,0
"Malta","2024-09-18",0,0,2,0,0,2,0,0
"Malta","2024-09-19",0,0,2,0,0,2,0,0
"Malta","2024-09-20",0,0,2,0,0,2,0,0
"Malta","2024-09-21",0,0,2,0,0,2,0,0
"Malta","2024-09-22",0,0,2,0,0,2,0,0
"Malta","2024-09-23",0,0,2,0,0,2,0,0
"Malta","2024-09-24",0,0,2,0,0,2,0,0
"Malta","2024-09-25",0,0,2,0,0,2,0,0
"Malta","2024-09-26",0,0,2,0,0,2,0,0
"Malta","2024-09-27",0,0,2,0,0,2,0,0
"Malta","2024-09-28",0,0,2,0,0,2,0,0
"Malta","2024-09-29",0,0,2,0,0,2,0,0
"Malta","2024-09-30",0,0,2,0,0,2,0,0
"Malta","2024-10-01",0,0,2,0,1,3,0,0
"Malta","2024-10-02",0,0,2,0,0,3,0,0
"Malta","2024-10-03",0,0,2,0,0,3,0,0
"Malta","2024-10-04",0,0,2,0,0,3,0,0
"Malta","2024-10-05",0,0,2,0,0,3,0,0
"Malta","2024-10-06",0,0,2,0,0,3,0,0
"Malta","2024-10-07",0,0,2,0,0,3,0,0
"Malta","2024-10-08",0,0,2,0,0,3,0,0
"Malta","2024-10-09",0,0,2,0,0,3,0,0
"Malta","2024-10-10",0,0,2,0,0,3,0,0
"Malta","2024-10-11",0,0,2,0,0,3,0,0
"Malta","2024-10-12",0,0,2,0,0,3,0,0
"Malta","2024-10-13",0,0,2,0,0,3,0,0
"Malta","2024-10-14",0,0,2,0,0,3,0,0
"Malta","2024-10-15",0,0,2,0,0,3,0,0
"Malta","2024-10-16",0,0,2,0,0,3,0,0
"Malta","2024-10-17",0,0,2,0,0,3,0,0
"Malta","2024-10-18",0,0,2,0,0,3,0,0
"Malta","2024-10-19",0,0,2,0,0,3,0,0
"Malta","2024-10-20",0,0,2,0,0,3,0,0
"Malta","2024-10-21",0,0,2,0,0,3,0,0
"Malta","2024-10-22",0,0,2,0,0,3,0,0
"Malta","2024-10-23",0,0,2,0,0,3,0,0
"Malta","2024-10-24",0,0,2,0,0,3,0,0
"Malta","2024-10-25",0,0,2,0,0,3,0,0
"Malta","2024-10-26",0,0,2,0,0,3,0,0
"Malta","2024-10-27",0,0,2,0,0,3,0,0
"Malta","2024-10-28",0,0,2,0,0,3,0,0
"Malta","2024-10-29",0,0,2,0,0,3,0,0
"Malta","2024-10-30",0,0,2,0,0,3,0,0
"Malta","2024-10-31",0,1,3,0,0,3,0,0
"Malta","2024-11-01",0,0,3,0,0,3,0,0
"Malta","2024-11-02",0,0,3,0,0,3,0,0
"Malta","2024-11-03",0,0,3,0,0,3,0,0
"Malta","2024-11-04",0,0,3,0,0,3,0,0
"Malta","2024-11-05",0,0,3,0,0,3,0,0
"Malta","2024-11-06",0,0,3,0,0,3,0,0
"Malta","2024-11-07",0,0,3,0,0,3,0,0
"Malta","2024-11-08",0,0,3,0,0,3,0,0
"Malta","2024-11-09",0,0,3,0,0,3,0,0
"Malta","2024-11-10",0,0,3,0,0,3,0,0
"Malta","2024-11-11",0,0,3,0,1,4,0,0
"Malta","2024-11-12",0,0,3,0,0,4,0,0
"Malta","2024-11-13",0,0,3,0,0,4,0,0
"Malta","2024-11-14",0,0,3,0,0,4,0,0
"Malta","2024-11-15",0,0,3,0,0,4,0,0
"Malta","2024-11-16",0,0,3,0,0,4,0,0
"Malta","2024-11-17",0,0,3,0,0,4,0,0
"Malta","2024-11-18",0,0,3,0,0,4,0,0
"Malta","2024-11-19",0,0,3,0,0,4,0,0
"Malta","2024-11-20",0,0,3,0,0,4,0,0
"Malta","2024-11-21",0,0,3,0,0,4,0,0
"Malta","2024-11-22",0,0,3,0,0,4,0,0
"Malta","2024-11-23",0,0,3,0,0,4,0,0
"Malta","2024-11-24",0,0,3,0,0,4,0,0
"Malta","2024-11-25",0,0,3,0,0,4,0,0
"Malta","2024-11-26",0,0,3,0,0,4,0,0
"Malta","2024-11-27",0,0,3,0,0,4,0,0
"Malta","2024-11-28",0,0,3,0,0,4,0,0
"Malta","2024-11-29",0,0,3,0,0,4,0,0
"Malta","2024-11-30",0,0,3,0,0,4,0,0
"Malta","2024-12-01",0,0,3,0,1,5,0,0
"Malta","2024-12-02",0,0,3,0,0,5,0,0
"Malta","2024-12-03",0,0,3,0,0,5,0,0
"Malta","2024-12-04",0,0,3,0,0,5,0,0
"Malta","2024-12-05",0,0,3,0,0,5,0,0
"Malta","2024-12-06",0,0,3,0,0,5,0,0
"Malta","2024-12-07",0,0,3,0,0,5,0,0
"Malta","2024-12-08",0,0,3,0,0,5,0,0
"Malta","2024-12-09",0,0,3,0,0,5,0,0
"Malta","2024-12-10",0,0,3,0,0,5,0,0
"Malta","2024-12-11",0,0,3,0,0,5,0,0
"Malta","2024-12-12",0,0,3,0,0,5,0,0
"Malta","2024-12-13",0,0,3,0,0,5,0,0
"Malta","2024-12-14",0,0,3,0,0,5,0,0
"Malta","2024-12-15",0,0,3,0,0,5,0,0
"Malta","2024-12-16",0,0,3,0,0,5,0,0
"Malta","2024-12-17",0,0,3,0,0,5,0,0
"Malta","2024-12-18",0,0,3,0,0,5,0,0
"Malta","2024-12-19",0,0,3,0,0,5,0,0
"Malta","2024-12-20",0,0,3,0,0,5,0,0
"Malta","2024-12-21",0,0,3,0,1,6,0,0
"Malta","2024-12-22",0,0,3,0,0,6,0,0
"Malta","2024-12-23",0,0,3,0,0,6,0,0
"Malta","2024-12-24",0,0,3,0,0,6,0,0
"Malta","2024-12-25",0,0,3,0,0,6,0,0
"Malta","2024-12-26",0,0,3,0,0,6,0,0
"Malta","2024-12-27",0,0,3,0,0,6,0,0
"Malta","2024-12-28",0,0,3,0,0,6,0,0
"Malta","2024-12-29",0,0,3,0,0,6,0,0
"Malta","2024-12-30",0,0,3,0,0,6,0,0
"Malta","2024-12-31",0,3,6,0,0,6,0,0
"Malta","2025-01-01",0,0,6,0,0,6,0,0
"Malta","2025-01-02",0,0,6,0,0,6,0,0
"Malta","2025-01-03",0,0,6,0,0,6,0,0
"Malta","2025-01-04",0,0,6,0,0,6,0,0
"Malta","2025-01-05",0,0,6,0,0,6,0,0
"Malta","2025-01-06",0,0,6,0,0,6,0,0
"Malta","2025-01-07",0,0,6,0,0,6,0,0
"Malta","2025-01-08",0,0,6,0,0,6,0,0
"Malta","2025-01-09",0,0,6,0,0,6,0,0
"Malta","2025-01-10",0,0,6,0,0,6,0,0
"Malta","2025-01-11",0,0,6,0,0,6,0,0
"Malta","2025-01-12",0,0,6,0,0,6,0,0
"Malta","2025-01-13",0,0,6,0,0,6,0,0
"Malta","2025-01-14",0,0,6,0,0,6,0,0
"Malta","2025-01-15",0,0,6,0,0,6,0,0
"Malta","2025-01-16",0,0,6,0,0,6,0,0
"Malta","2025-01-17",0,0,6,0,0,6,0,0
"Malta","2025-01-18",0,0,6,0,0,6,0,0
"Malta","2025-01-19",0,0,6,0,0,6,0,0
"Malta","2025-01-20",0,0,6,0,0,6,0,0
"Malta","2025-01-21",0,0,6,0,0,6,0,0
"Malta","2025-01-22",0,0,6,0,0,6,0,0
"Malta","2025-01-23",0,0,6,0,0,6,0,0
"Malta","2025-01-24",0,0,6,0,0,6,0,0
"Malta","2025-01-25",0,0,6,0,0,6,0,0
"Malta","2025-01-26",0,0,6,0,0,6,0,0
"Malta","2025-01-27",0,0,6,0,0,6,0,0
"Malta","2025-01-28",0,0,6,0,0,6,0,0
"Malta","2025-01-29",0,0,6,0,0,6,0,0
"Malta","2025-01-30",0,0,6,0,0,6,0,0
"Malta","2025-01-31",0,0,6,0,0,6,0,0
"Malta","2025-02-01",0,0,6,0,0,6,0,0
"Malta","2025-02-02",0,0,6,0,0,6,0,0
"Malta","2025-02-03",0,0,6,0,0,6,0,0
"Martinique","2024-01-01",0,0,0,0,0,0,0,0
"Martinique","2024-01-02",0,0,0,0,0,0,0,0
"Martinique","2024-01-03",0,0,0,0,0,0,0,0
"Martinique","2024-01-04",0,0,0,0,0,0,0,0
"Martinique","2024-01-05",0,0,0,0,0,0,0,0
"Martinique","2024-01-06",0,0,0,0,0,0,0,0
"Martinique","2024-01-07",0,0,0,0,0,0,0,0
"Martinique","2024-01-08",0,0,0,0,0,0,0,0
"Martinique","2024-01-09",0,0,0,0,0,0,0,0
"Martinique","2024-01-10",0,0,0,0,0,0,0,0
"Martinique","2024-01-11",0,0,0,0,0,0,0,0
"Martinique","2024-01-12",0,0,0,0,0,0,0,0
"Martinique","2024-01-13",0,0,0,0,0,0,0,0
"Martinique","2024-01-14",0,0,0,0,0,0,0,0
"Martinique","2024-01-15",0,0,0,0,0,0,0,0
"Martinique","2024-01-16",0,0,0,0,0,0,0,0
"Martinique","2024-01-17",0,0,0,0,0,0,0,0
"Martinique","2024-01-18",0,0,0,0,0,0,0,0
"Martinique","2024-01-19",0,0,0,0,0,0,0,0
"Martinique","2024-01-20",0,0,0,0,0,0,0,0
"Martinique","2024-01-21",0,0,0,0,0,0,0,0
"Martinique","2024-01-22",0,0,0,0,0,0,0,0
"Martinique","2024-01-23",0,0,0,0,0,0,0,0
"Martinique","2024-01-24",0,0,0,0,0,0,0,0
"Martinique","2024-01-25",0,0,0,0,0,0,0,0
"Martinique","2024-01-26",0,0,0,0,0,0,0,0
"Martinique","2024-01-27",0,0,0,0,0,0,0,0
"Martinique","2024-01-28",0,0,0,0,0,0,0,0
"Martinique","2024-01-29",0,0,0,0,0,0,0,0
"Martinique","2024-01-30",0,0,0,0,0,0,0,0
"Martinique","2024-01-31",0,0,0,0,0,0,0,0
"Martinique","2024-02-01",0,0,0,0,0,0,0,0
"Martinique","2024-02-02",0,0,0,0,0,0,0,0
"Martinique","2024-02-03",0,0,0,0,0,0,0,0
"Martinique","2024-02-04",0,0,0,0,0,0,0,0
"Martinique","2024-02-05",0,0,0,0,0,0,0,0
"Martinique","2024-02-06",0,0,0,0,0,0,0,0
"Martinique","2024-02-07",0,0,0,0,0,0,0,0
"Martinique","2024-02-08",0,0,0,0,0,0,0,0
"Martinique","2024-02-09",0,0,0,0,0,0,0,0
"Martinique","2024-02-10",0,0,0,0,0,0,0,0
"Martinique","2024-02-11",0,0,0,0,0,0,0,0
"Martinique","2024-02-12",0,0,0,0,0,0,0,0
"Martinique","2024-02-13",0,0,0,0,0,0,0,0
"Martinique","2024-02-14",0,0,0,0,0,0,0,0
"Martinique","2024-02-15",0,0,0,0,0,0,0,0
"Martinique","2024-02-16",0,0,0,0,0,0,0,0
"Martinique","2024-02-17",0,0,0,0,0,0,0,0
"Martinique","2024-02-18",0,0,0,0,0,0,0,0
"Martinique","2024-02-19",0,0,0,0,0,0,0,0
"Martinique","2024-02-20",0,0,0,0,0,0,0,0
"Martinique","2024-02-21",0,0,0,0,0,0,0,0
"Martinique","2024-02-22",0,0,0,0,0,0,0,0
"Martinique","2024-02-23",0,0,0,0,0,0,0,0
"Martinique","2024-02-24",0,0,0,0,0,0,0,0
"Martinique","2024-02-25",0,0,0,0,0,0,0,0
"Martinique","2024-02-26",0,0,0,0,0,0,0,0
"Martinique","2024-02-27",0,0,0,0,0,0,0,0
"Martinique","2024-02-28",0,0,0,0,0,0,0,0
"Martinique","2024-02-29",0,0,0,0,0,0,0,0
"Martinique","2024-03-01",0,0,0,0,0,0,0,0
"Martinique","2024-03-02",0,0,0,0,0,0,0,0
"Martinique","2024-03-03",0,0,0,0,0,0,0,0
"Martinique","2024-03-04",0,0,0,0,0,0,0,0
"Martinique","2024-03-05",0,0,0,0,0,0,0,0
"Martinique","2024-03-06",0,0,0,0,0,0,0,0
"Martinique","2024-03-07",0,0,0,0,0,0,0,0
"Martinique","2024-03-08",0,0,0,0,0,0,0,0
"Martinique","2024-03-09",0,0,0,0,0,0,0,0
"Martinique","2024-03-10",0,0,0,0,0,0,0,0
"Martinique","2024-03-11",0,0,0,0,0,0,0,0
"Martinique","2024-03-12",0,0,0,0,0,0,0,0
"Martinique","2024-03-13",0,0,0,0,0,0,0,0
"Martinique","2024-03-14",0,0,0,0,0,0,0,0
"Martinique","2024-03-15",0,0,0,0,0,0,0,0
"Martinique","2024-03-16",0,0,0,0,0,0,0,0
"Martinique","2024-03-17",0,0,0,0,0,0,0,0
"Martinique","2024-03-18",0,0,0,0,0,0,0,0
"Martinique","2024-03-19",0,0,0,0,0,0,0,0
"Martinique","2024-03-20",0,0,0,0,0,0,0,0
"Martinique","2024-03-21",0,0,0,0,0,0,0,0
"Martinique","2024-03-22",0,0,0,0,0,0,0,0
"Martinique","2024-03-23",0,0,0,0,0,0,0,0
"Martinique","2024-03-24",0,0,0,0,0,0,0,0
"Martinique","2024-03-25",0,0,0,0,0,0,0,0
"Martinique","2024-03-26",0,0,0,0,0,0,0,0
"Martinique","2024-03-27",0,0,0,0,0,0,0,0
"Martinique","2024-03-28",0,0,0,0,0,0,0,0
"Martinique","2024-03-29",0,0,0,0,0,0,0,0
"Martinique","2024-03-30",0,0,0,0,0,0,0,0
"Martinique","2024-03-31",0,0,0,0,0,0,0,0
"Martinique","2024-04-01",0,0,0,0,0,0,0,0
"Martinique","2024-04-02",0,0,0,0,0,0,0,0
"Martinique","2024-04-03",0,0,0,0,0,0,0,0
"Martinique","2024-04-04",0,0,0,0,0,0,0,0
"Martinique","2024-04-05",0,0,0,0,0,0,0,0
"Martinique","2024-04-06",0,0,0,0,0,0,0,0
"Martinique","2024-04-07",0,0,0,0,0,0,0,0
"Martinique","2024-04-08",0,0,0,0,0,0,0,0
"Martinique","2024-04-09",0,0,0,0,0,0,0,0
"Martinique","2024-04-10",0,0,0,0,0,0,0,0
"Martinique","2024-04-11",0,0,0,0,0,0,0,0
"Martinique","2024-04-12",0,0,0,0,0,0,0,0
"Martinique","2024-04-13",0,0,0,0,0,0,0,0
"Martinique","2024-04-14",0,0,0,0,0,0,0,0
"Martinique","2024-04-15",0,0,0,0,0,0,0,0
"Martinique","2024-04-16",0,0,0,0,0,0,0,0
"Martinique","2024-04-17",0,0,0,0,0,0,0,0
"Martinique","2024-04-18",0,0,0,0,0,0,0,0
"Martinique","2024-04-19",0,0,0,0,0,0,0,0
"Martinique","2024-04-20",0,0,0,0,0,0,0,0
"Martinique","2024-04-21",0,0,0,0,0,0,0,0
"Martinique","2024-04-22",0,0,0,0,0,0,0,0
"Martinique","2024-04-23",0,0,0,0,0,0,0,0
"Martinique","2024-04-24",0,0,0,0,0,0,0,0
"Martinique","2024-04-25",0,0,0,0,0,0,0,0
"Martinique","2024-04-26",0,0,0,0,0,0,0,0
"Martinique","2024-04-27",0,0,0,0,0,0,0,0
"Martinique","2024-04-28",0,0,0,0,0,0,0,0
"Martinique","2024-04-29",0,0,0,0,0,0,0,0
"Martinique","2024-04-30",0,0,0,0,0,0,0,0
"Martinique","2024-05-01",0,0,0,0,0,0,0,0
"Martinique","2024-05-02",0,0,0,0,0,0,0,0
"Martinique","2024-05-03",0,0,0,0,0,0,0,0
"Martinique","2024-05-04",0,0,0,0,0,0,0,0
"Martinique","2024-05-05",0,0,0,0,0,0,0,0
"Martinique","2024-05-06",0,0,0,0,0,0,0,0
"Martinique","2024-05-07",0,0,0,0,0,0,0,0
"Martinique","2024-05-08",0,0,0,0,0,0,0,0
"Martinique","2024-05-09",0,0,0,0,0,0,0,0
"Martinique","2024-05-10",0,0,0,0,0,0,0,0
"Martinique","2024-05-11",0,0,0,0,0,0,0,0
"Martinique","2024-05-12",0,0,0,0,0,0,0,0
"Martinique","2024-05-13",0,0,0,0,0,0,0,0
"Martinique","2024-05-14",0,0,0,0,0,0,0,0
"Martinique","2024-05-15",0,0,0,0,0,0,0,0
"Martinique","2024-05-16",0,0,0,0,0,0,0,0
"Martinique","2024-05-17",0,0,0,0,0,0,0,0
"Martinique","2024-05-18",0,0,0,0,0,0,0,0
"Martinique","2024-05-19",0,0,0,0,0,0,0,0
"Martinique","2024-05-20",0,0,0,0,0,0,0,0
"Martinique","2024-05-21",0,0,0,0,0,0,0,0
"Martinique","2024-05-22",0,0,0,0,0,0,0,0
"Martinique","2024-05-23",0,0,0,0,0,0,0,0
"Martinique","2024-05-24",0,0,0,0,0,0,0,0
"Martinique","2024-05-25",0,0,0,0,0,0,0,0
"Martinique","2024-05-26",0,0,0,0,0,0,0,0
"Martinique","2024-05-27",0,0,0,0,0,0,0,0
"Martinique","2024-05-28",0,0,0,0,0,0,0,0
"Martinique","2024-05-29",0,0,0,0,0,0,0,0
"Martinique","2024-05-30",0,0,0,0,0,0,0,0
"Martinique","2024-05-31",0,0,0,0,0,0,0,0
"Martinique","2024-06-01",0,0,0,0,0,0,0,0
"Martinique","2024-06-02",0,0,0,0,0,0,0,0
"Martinique","2024-06-03",0,0,0,0,0,0,0,0
"Martinique","2024-06-04",0,0,0,0,0,0,0,0
"Martinique","2024-06-05",0,0,0,0,0,0,0,0
"Martinique","2024-06-06",0,0,0,0,0,0,0,0
"Martinique","2024-06-07",0,0,0,0,0,0,0,0
"Martinique","2024-06-08",0,0,0,0,0,0,0,0
"Martinique","2024-06-09",0,0,0,0,0,0,0,0
"Martinique","2024-06-10",0,0,0,0,0,0,0,0
"Martinique","2024-06-11",0,0,0,0,0,0,0,0
"Martinique","2024-06-12",0,0,0,0,0,0,0,0
"Martinique","2024-06-13",0,0,0,0,0,0,0,0
"Martinique","2024-06-14",0,0,0,0,0,0,0,0
"Martinique","2024-06-15",0,0,0,0,0,0,0,0
"Martinique","2024-06-16",0,0,0,0,0,0,0,0
"Martinique","2024-06-17",0,0,0,0,0,0,0,0
"Martinique","2024-06-18",0,0,0,0,0,0,0,0
"Martinique","2024-06-19",0,0,0,0,0,0,0,0
"Martinique","2024-06-20",0,0,0,0,0,0,0,0
"Martinique","2024-06-21",0,0,0,0,0,0,0,0
"Martinique","2024-06-22",0,0,0,0,0,0,0,0
"Martinique","2024-06-23",0,0,0,0,0,0,0,0
"Martinique","2024-06-24",0,0,0,0,0,0,0,0
"Martinique","2024-06-25",0,0,0,0,0,0,0,0
"Martinique","2024-06-26",0,0,0,0,0,0,0,0
"Martinique","2024-06-27",0,0,0,0,0,0,0,0
"Martinique","2024-06-28",0,0,0,0,0,0,0,0
"Martinique","2024-06-29",0,0,0,0,0,0,0,0
"Martinique","2024-06-30",0,0,0,0,0,0,0,0
"Martinique","2024-07-01",0,0,0,0,0,0,0,0
"Martinique","2024-07-02",0,0,0,0,0,0,0,0
"Martinique","2024-07-03",0,0,0,0,0,0,0,0
"Martinique","2024-07-04",0,0,0,0,0,0,0,0
"Martinique","2024-07-05",0,0,0,0,0,0,0,0
"Martinique","2024-07-06",0,0,0,0,0,0,0,0
"Martinique","2024-07-07",0,0,0,0,0,0,0,0
"Martinique","2024-07-08",0,0,0,0,0,0,0,0
"Martinique","2024-07-09",0,0,0,0,0,0,0,0
"Martinique","2024-07-10",0,0,0,0,0,0,0,0
"Martinique","2024-07-11",0,0,0,0,0,0,0,0
"Martinique","2024-07-12",0,0,0,0,0,0,0,0
"Martinique","2024-07-13",0,0,0,0,0,0,0,0
"Martinique","2024-07-14",0,0,0,0,0,0,0,0
"Martinique","2024-07-15",0,0,0,0,0,0,0,0
"Martinique","2024-07-16",0,0,0,0,0,0,0,0
"Martinique","2024-07-17",0,0,0,0,0,0,0,0
"Martinique","2024-07-18",0,0,0,0,0,0,0,0
"Martinique","2024-07-19",0,0,0,0,0,0,0,0
"Martinique","2024-07-20",0,0,0,0,0,0,0,0
"Martinique","2024-07-21",0,0,0,0,0,0,0,0
"Martinique","2024-07-22",0,0,0,0,0,0,0,0
"Martinique","2024-07-23",0,0,0,0,0,0,0,0
"Martinique","2024-07-24",0,0,0,0,0,0,0,0
"Martinique","2024-07-25",0,0,0,0,0,0,0,0
"Martinique","2024-07-26",0,0,0,0,0,0,0,0
"Martinique","2024-07-27",0,0,0,0,0,0,0,0
"Martinique","2024-07-28",0,0,0,0,0,0,0,0
"Martinique","2024-07-29",0,0,0,0,0,0,0,0
"Martinique","2024-07-30",0,0,0,0,0,0,0,0
"Martinique","2024-07-31",0,0,0,0,0,0,0,0
"Martinique","2024-08-01",0,0,0,0,0,0,0,0
"Martinique","2024-08-02",0,0,0,0,0,0,0,0
"Martinique","2024-08-03",0,0,0,0,0,0,0,0
"Martinique","2024-08-04",0,0,0,0,0,0,0,0
"Martinique","2024-08-05",0,0,0,0,0,0,0,0
"Martinique","2024-08-06",0,0,0,0,0,0,0,0
"Martinique","2024-08-07",0,0,0,0,0,0,0,0
"Martinique","2024-08-08",0,0,0,0,0,0,0,0
"Martinique","2024-08-09",0,0,0,0,0,0,0,0
"Martinique","2024-08-10",0,0,0,0,0,0,0,0
"Martinique","2024-08-11",0,0,0,0,0,0,0,0
"Martinique","2024-08-12",0,0,0,0,0,0,0,0
"Martinique","2024-08-13",0,0,0,0,0,0,0,0
"Martinique","2024-08-14",0,0,0,0,0,0,0,0
"Martinique","2024-08-15",0,0,0,0,0,0,0,0
"Martinique","2024-08-16",0,0,0,0,0,0,0,0
"Martinique","2024-08-17",0,0,0,0,0,0,0,0
"Martinique","2024-08-18",0,0,0,0,0,0,0,0
"Martinique","2024-08-19",0,0,0,0,0,0,0,0
"Martinique","2024-08-20",0,0,0,0,0,0,0,0
"Martinique","2024-08-21",0,0,0,0,0,0,0,0
"Martinique","2024-08-22",0,0,0,0,0,0,0,0
"Martinique","2024-08-23",0,0,0,0,0,0,0,0
"Martinique","2024-08-24",0,0,0,0,0,0,0,0
"Martinique","2024-08-25",0,0,0,0,0,0,0,0
"Martinique","2024-08-26",0,0,0,0,0,0,0,0
"Martinique","2024-08-27",0,0,0,0,0,0,0,0
"Martinique","2024-08-28",0,0,0,0,0,0,0,0
"Martinique","2024-08-29",0,0,0,0,0,0,0,0
"Martinique","2024-08-30",0,0,0,0,0,0,0,0
"Martinique","2024-08-31",0,0,0,0,0,0,0,0
"Martinique","2024-09-01",0,0,0,0,0,0,0,0
"Martinique","2024-09-02",0,0,0,0,0,0,0,0
"Martinique","2024-09-03",0,0,0,0,0,0,0,0
"Martinique","2024-09-04",0,0,0,0,0,0,0,0
"Martinique","2024-09-05",0,0,0,0,0,0,0,0
"Martinique","2024-09-06",0,0,0,0,0,0,0,0
"Martinique","2024-09-07",0,0,0,0,0,0,0,0
"Martinique","2024-09-08",0,0,0,0,0,0,0,0
"Martinique","2024-09-09",0,0,0,0,0,0,0,0
"Martinique","2024-09-10",0,0,0,0,0,0,0,0
"Martinique","2024-09-11",0,0,0,0,0,0,0,0
"Martinique","2024-09-12",0,0,0,0,0,0,0,0
"Martinique","2024-09-13",0,0,0,0,0,0,0,0
"Martinique","2024-09-14",0,0,0,0,0,0,0,0
"Martinique","2024-09-15",0,0,0,0,0,0,0,0
"Martinique","2024-09-16",0,0,0,0,0,0,0,0
"Martinique","2024-09-17",0,0,0,0,0,0,0,0
"Martinique","2024-09-18",0,0,0,0,0,0,0,0
"Martinique","2024-09-19",0,0,0,0,0,0,0,0
"Martinique","2024-09-20",0,0,0,0,0,0,0,0
"Martinique","2024-09-21",0,0,0,0,0,0,0,0
"Martinique","2024-09-22",0,0,0,0,0,0,0,0
"Martinique","2024-09-23",0,0,0,0,0,0,0,0
"Martinique","2024-09-24",0,0,0,0,0,0,0,0
"Martinique","2024-09-25",0,0,0,0,0,0,0,0
"Martinique","2024-09-26",0,0,0,0,0,0,0,0
"Martinique","2024-09-27",0,0,0,0,0,0,0,0
"Martinique","2024-09-28",0,0,0,0,0,0,0,0
"Martinique","2024-09-29",0,0,0,0,0,0,0,0
"Martinique","2024-09-30",0,0,0,0,0,0,0,0
"Martinique","2024-10-01",0,0,0,0,0,0,0,0
"Martinique","2024-10-02",0,0,0,0,0,0,0,0
"Martinique","2024-10-03",0,0,0,0,0,0,0,0
"Martinique","2024-10-04",0,0,0,0,0,0,0,0
"Martinique","2024-10-05",0,0,0,0,0,0,0,0
"Martinique","2024-10-06",0,0,0,0,0,0,0,0
"Martinique","2024-10-07",0,0,0,0,0,0,0,0
"Martinique","2024-10-08",0,0,0,0,0,0,0,0
"Martinique","2024-10-09",0,0,0,0,0,0,0,0
"Martinique","2024-10-10",0,0,0,0,0,0,0,0
"Martinique","2024-10-11",0,0,0,0,0,0,0,0
"Martinique","2024-10-12",0,0,0,0,0,0,0,0
"Martinique","2024-10-13",0,0,0,0,0,0,0,0
"Martinique","2024-10-14",0,0,0,0,0,0,0,0
"Martinique","2024-10-15",0,0,0,0,0,0,0,0
"Martinique","2024-10-16",0,0,0,0,0,0,0,0
"Martinique","2024-10-17",0,0,0,0,0,0,0,0
"Martinique","2024-10-18",0,0,0,0,0,0,0,0
"Martinique","2024-10-19",0,0,0,0,0,0,0,0
"Martinique","2024-10-20",0,0,0,0,0,0,0,0
"Martinique","2024-10-21",0,0,0,0,0,0,0,0
"Martinique","2024-10-22",0,0,0,0,0,0,0,0
"Martinique","2024-10-23",0,0,0,0,0,0,0,0
"Martinique","2024-10-24",0,0,0,0,0,0,0,0
"Martinique","2024-10-25",0,0,0,0,0,0,0,0
"Martinique","2024-10-26",0,0,0,0,0,0,0,0
"Martinique","2024-10-27",0,0,0,0,0,0,0,0
"Martinique","2024-10-28",0,0,0,0,0,0,0,0
"Martinique","2024-10-29",0,0,0,0,0,0,0,0
"Martinique","2024-10-30",0,0,0,0,0,0,0,0
"Martinique","2024-10-31",0,0,0,0,0,0,0,0
"Martinique","2024-11-01",0,0,0,0,0,0,0,0
"Martinique","2024-11-02",0,0,0,0,0,0,0,0
"Martinique","2024-11-03",0,0,0,0,0,0,0,0
"Martinique","2024-11-04",0,0,0,0,0,0,0,0
"Martinique","2024-11-05",0,0,0,0,0,0,0,0
"Martinique","2024-11-06",0,0,0,0,0,0,0,0
"Martinique","2024-11-07",0,0,0,0,0,0,0,0
"Martinique","2024-11-08",0,0,0,0,0,0,0,0
"Martinique","2024-11-09",0,0,0,0,0,0,0,0
"Martinique","2024-11-10",0,0,0,0,0,0,0,0
"Martinique","2024-11-11",0,0,0,0,0,0,0,0
"Martinique","2024-11-12",0,0,0,0,0,0,0,0
"Martinique","2024-11-13",0,0,0,0,0,0,0,0
"Martinique","2024-11-14",0,0,0,0,0,0,0,0
"Martinique","2024-11-15",0,0,0,0,0,0,0,0
"Martinique","2024-11-16",0,0,0,0,0,0,0,0
"Martinique","2024-11-17",0,0,0,0,0,0,0,0
"Martinique","2024-11-18",0,0,0,0,0,0,0,0
"Martinique","2024-11-19",0,0,0,0,0,0,0,0
"Martinique","2024-11-20",0,0,0,0,0,0,0,0
"Martinique","2024-11-21",0,0,0,0,0,0,0,0
"Martinique","2024-11-22",0,0,0,0,0,0,0,0
"Martinique","2024-11-23",0,0,0,0,0,0,0,0
"Martinique","2024-11-24",0,0,0,0,0,0,0,0
"Martinique","2024-11-25",0,0,0,0,0,0,0,0
"Martinique","2024-11-26",0,0,0,0,0,0,0,0
"Martinique","2024-11-27",0,0,0,0,0,0,0,0
"Martinique","2024-11-28",0,0,0,0,0,0,0,0
"Martinique","2024-11-29",0,0,0,0,0,0,0,0
"Martinique","2024-11-30",0,0,0,0,0,0,0,0
"Martinique","2024-12-01",0,0,0,0,0,0,0,0
"Martinique","2024-12-02",0,0,0,0,0,0,0,0
"Martinique","2024-12-03",0,0,0,0,0,0,0,0
"Martinique","2024-12-04",0,0,0,0,0,0,0,0
"Martinique","2024-12-05",0,0,0,0,0,0,0,0
"Martinique","2024-12-06",0,0,0,0,0,0,0,0
"Martinique","2024-12-07",0,0,0,0,0,0,0,0
"Martinique","2024-12-08",0,0,0,0,0,0,0,0
"Martinique","2024-12-09",0,0,0,0,0,0,0,0
"Martinique","2024-12-10",0,0,0,0,0,0,0,0
"Martinique","2024-12-11",0,0,0,0,0,0,0,0
"Martinique","2024-12-12",0,0,0,0,0,0,0,0
"Martinique","2024-12-13",0,0,0,0,0,0,0,0
"Martinique","2024-12-14",0,0,0,0,0,0,0,0
"Martinique","2024-12-15",0,0,0,0,0,0,0,0
"Martinique","2024-12-16",0,0,0,0,0,0,0,0
"Martinique","2024-12-17",0,0,0,0,0,0,0,0
"Martinique","2024-12-18",0,0,0,0,0,0,0,0
"Martinique","2024-12-19",0,0,0,0,0,0,0,0
"Martinique","2024-12-20",0,0,0,0,0,0,0,0
"Martinique","2024-12-21",0,0,0,0,0,0,0,0
"Martinique","2024-12-22",0,0,0,0,0,0,0,0
"Martinique","2024-12-23",0,0,0,0,0,0,0,0
"Martinique","2024-12-24",0,0,0,0,0,0,0,0
"Martinique","2024-12-25",0,0,0,0,0,0,0,0
"Martinique","2024-12-26",0,0,0,0,0,0,0,0
"Martinique","2024-12-27",0,0,0,0,0,0,0,0
"Martinique","2024-12-28",0,0,0,0,0,0,0,0
"Martinique","2024-12-29",0,0,0,0,0,0,0,0
"Martinique","2024-12-30",0,0,0,0,0,0,0,0
"Martinique","2024-12-31",0,0,0,0,0,0,0,0
"Martinique","2025-01-01",0,0,0,0,0,0,0,0
"Martinique","2025-01-02",0,0,0,0,0,0,0,0
"Martinique","2025-01-03",0,0,0,0,0,0,0,0
"Martinique","2025-01-04",0,0,0,0,0,0,0,0
"Martinique","2025-01-05",0,0,0,0,0,0,0,0
"Martinique","2025-01-06",0,0,0,0,0,0,0,0
"Martinique","2025-01-07",0,0,0,0,0,0,0,0
"Martinique","2025-01-08",0,0,0,0,0,0,0,0
"Martinique","2025-01-09",0,0,0,0,0,0,0,0
"Martinique","2025-01-10",0,0,0,0,0,0,0,0
"Martinique","2025-01-11",0,0,0,0,0,0,0,0
"Martinique","2025-01-12",0,0,0,0,0,0,0,0
"Martinique","2025-01-13",0,0,0,0,0,0,0,0
"Martinique","2025-01-14",0,0,0,0,0,0,0,0
"Martinique","2025-01-15",0,0,0,0,0,0,0,0
"Martinique","2025-01-16",0,0,0,0,0,0,0,0
"Martinique","2025-01-17",0,0,0,0,0,0,0,0
"Martinique","2025-01-18",0,0,0,0,0,0,0,0
"Martinique","2025-01-19",0,0,0,0,0,0,0,0
"Martinique","2025-01-20",0,0,0,0,0,0,0,0
"Martinique","2025-01-21",0,0,0,0,0,0,0,0
"Martinique","2025-01-22",0,0,0,0,0,0,0,0
"Martinique","2025-01-23",0,0,0,0,0,0,0,0
"Martinique","2025-01-24",0,0,0,0,0,0,0,0
"Martinique","2025-01-25",0,0,0,0,0,0,0,0
"Martinique","2025-01-26",0,0,0,0,0,0,0,0
"Martinique","2025-01-27",0,0,0,0,0,0,0,0
"Martinique","2025-01-28",0,0,0,0,0,0,0,0
"Martinique","2025-01-29",0,0,0,0,0,0,0,0
"Martinique","2025-01-30",0,0,0,0,0,0,0,0
"Martinique","2025-01-31",0,0,0,0,0,0,0,0
"Martinique","2025-02-01",0,0,0,0,0,0,0,0
"Martinique","2025-02-02",0,0,0,0,0,0,0,0
"Martinique","2025-02-03",0,0,0,0,0,0,0,0
"Mauritius","2024-01-01",0,0,0,0,0,0,0,0
"Mauritius","2024-01-02",0,0,0,0,0,0,0,0
"Mauritius","2024-01-03",0,0,0,0,0,0,0,0
"Mauritius","2024-01-04",0,0,0,0,0,0,0,0
"Mauritius","2024-01-05",0,0,0,0,0,0,0,0
"Mauritius","2024-01-06",0,0,0,0,0,0,0,0
"Mauritius","2024-01-07",0,0,0,0,0,0,0,0
"Mauritius","2024-01-08",0,0,0,0,0,0,0,0
"Mauritius","2024-01-09",0,0,0,0,0,0,0,0
"Mauritius","2024-01-10",0,0,0,0,0,0,0,0
"Mauritius","2024-01-11",0,0,0,0,0,0,0,0
"Mauritius","2024-01-12",0,0,0,0,0,0,0,0
"Mauritius","2024-01-13",0,0,0,0,0,0,0,0
"Mauritius","2024-01-14",0,0,0,0,0,0,0,0
"Mauritius","2024-01-15",0,0,0,0,0,0,0,0
"Mauritius","2024-01-16",0,0,0,0,0,0,0,0
"Mauritius","2024-01-17",0,0,0,0,0,0,0,0
"Mauritius","2024-01-18",0,0,0,0,0,0,0,0
"Mauritius","2024-01-19",0,0,0,0,0,0,0,0
"Mauritius","2024-01-20",0,0,0,0,0,0,0,0
"Mauritius","2024-01-21",0,0,0,0,0,0,0,0
"Mauritius","2024-01-22",0,0,0,0,0,0,0,0
"Mauritius","2024-01-23",0,0,0,0,0,0,0,0
"Mauritius","2024-01-24",0,0,0,0,0,0,0,0
"Mauritius","2024-01-25",0,0,0,0,0,0,0,0
"Mauritius","2024-01-26",0,0,0,0,0,0,0,0
"Mauritius","2024-01-27",0,0,0,0,0,0,0,0
"Mauritius","2024-01-28",0,0,0,0,0,0,0,0
"Mauritius","2024-01-29",0,0,0,0,0,0,0,0
"Mauritius","2024-01-30",0,0,0,0,0,0,0,0
"Mauritius","2024-01-31",0,0,0,0,0,0,0,0
"Mauritius","2024-02-01",0,0,0,0,0,0,0,0
"Mauritius","2024-02-02",0,0,0,0,0,0,0,0
"Mauritius","2024-02-03",0,0,0,0,0,0,0,0
"Mauritius","2024-02-04",0,0,0,0,0,0,0,0
"Mauritius","2024-02-05",0,0,0,0,0,0,0,0
"Mauritius","2024-02-06",0,0,0,0,0,0,0,0
"Mauritius","2024-02-07",0,0,0,0,0,0,0,0
"Mauritius","2024-02-08",0,0,0,0,0,0,0,0
"Mauritius","2024-02-09",0,0,0,0,0,0,0,0
"Mauritius","2024-02-10",0,0,0,0,0,0,0,0
"Mauritius","2024-02-11",0,0,0,0,0,0,0,0
"Mauritius","2024-02-12",0,0,0,0,0,0,0,0
"Mauritius","2024-02-13",0,0,0,0,0,0,0,0
"Mauritius","2024-02-14",0,0,0,0,0,0,0,0
"Mauritius","2024-02-15",0,0,0,0,0,0,0,0
"Mauritius","2024-02-16",0,0,0,0,0,0,0,0
"Mauritius","2024-02-17",0,0,0,0,0,0,0,0
"Mauritius","2024-02-18",0,0,0,0,0,0,0,0
"Mauritius","2024-02-19",0,0,0,0,0,0,0,0
"Mauritius","2024-02-20",0,0,0,0,0,0,0,0
"Mauritius","2024-02-21",0,0,0,0,0,0,0,0
"Mauritius","2024-02-22",0,0,0,0,0,0,0,0
"Mauritius","2024-02-23",0,0,0,0,0,0,0,0
"Mauritius","2024-02-24",0,0,0,0,0,0,0,0
"Mauritius","2024-02-25",0,0,0,0,0,0,0,0
"Mauritius","2024-02-26",0,0,0,0,0,0,0,0
"Mauritius","2024-02-27",0,0,0,0,0,0,0,0
"Mauritius","2024-02-28",0,0,0,0,0,0,0,0
"Mauritius","2024-02-29",0,0,0,0,0,0,0,0
"Mauritius","2024-03-01",0,0,0,0,0,0,0,0
"Mauritius","2024-03-02",0,0,0,0,0,0,0,0
"Mauritius","2024-03-03",0,0,0,0,0,0,0,0
"Mauritius","2024-03-04",0,0,0,0,0,0,0,0
"Mauritius","2024-03-05",0,0,0,0,0,0,0,0
"Mauritius","2024-03-06",0,0,0,0,0,0,0,0
"Mauritius","2024-03-07",0,0,0,0,0,0,0,0
"Mauritius","2024-03-08",0,0,0,0,0,0,0,0
"Mauritius","2024-03-09",0,0,0,0,0,0,0,0
"Mauritius","2024-03-10",0,0,0,0,0,0,0,0
"Mauritius","2024-03-11",0,0,0,0,0,0,0,0
"Mauritius","2024-03-12",0,0,0,0,0,0,0,0
"Mauritius","2024-03-13",0,0,0,0,0,0,0,0
"Mauritius","2024-03-14",0,0,0,0,0,0,0,0
"Mauritius","2024-03-15",0,0,0,0,0,0,0,0
"Mauritius","2024-03-16",0,0,0,0,0,0,0,0
"Mauritius","2024-03-17",0,0,0,0,0,0,0,0
"Mauritius","2024-03-18",0,0,0,0,0,0,0,0
"Mauritius","2024-03-19",0,0,0,0,0,0,0,0
"Mauritius","2024-03-20",0,0,0,0,0,0,0,0
"Mauritius","2024-03-21",0,0,0,0,0,0,0,0
"Mauritius","2024-03-22",0,0,0,0,0,0,0,0
"Mauritius","2024-03-23",0,0,0,0,0,0,0,0
"Mauritius","2024-03-24",0,0,0,0,0,0,0,0
"Mauritius","2024-03-25",0,0,0,0,0,0,0,0
"Mauritius","2024-03-26",0,0,0,0,0,0,0,0
"Mauritius","2024-03-27",0,0,0,0,0,0,0,0
"Mauritius","2024-03-28",0,0,0,0,0,0,0,0
"Mauritius","2024-03-29",0,0,0,0,0,0,0,0
"Mauritius","2024-03-30",0,0,0,0,0,0,0,0
"Mauritius","2024-03-31",0,0,0,0,0,0,0,0
"Mauritius","2024-04-01",0,0,0,0,0,0,0,0
"Mauritius","2024-04-02",0,0,0,0,0,0,0,0
"Mauritius","2024-04-03",0,0,0,0,0,0,0,0
"Mauritius","2024-04-04",0,0,0,0,0,0,0,0
"Mauritius","2024-04-05",0,0,0,0,0,0,0,0
"Mauritius","2024-04-06",0,0,0,0,0,0,0,0
"Mauritius","2024-04-07",0,0,0,0,0,0,0,0
"Mauritius","2024-04-08",0,0,0,0,0,0,0,0
"Mauritius","2024-04-09",0,0,0,0,0,0,0,0
"Mauritius","2024-04-10",0,0,0,0,0,0,0,0
"Mauritius","2024-04-11",0,0,0,0,0,0,0,0
"Mauritius","2024-04-12",0,0,0,0,0,0,0,0
"Mauritius","2024-04-13",0,0,0,0,0,0,0,0
"Mauritius","2024-04-14",0,0,0,0,0,0,0,0
"Mauritius","2024-04-15",0,0,0,0,0,0,0,0
"Mauritius","2024-04-16",0,0,0,0,0,0,0,0
"Mauritius","2024-04-17",0,0,0,0,0,0,0,0
"Mauritius","2024-04-18",0,0,0,0,0,0,0,0
"Mauritius","2024-04-19",0,0,0,0,0,0,0,0
"Mauritius","2024-04-20",0,0,0,0,0,0,0,0
"Mauritius","2024-04-21",0,0,0,0,0,0,0,0
"Mauritius","2024-04-22",0,0,0,0,0,0,0,0
"Mauritius","2024-04-23",0,0,0,0,0,0,0,0
"Mauritius","2024-04-24",0,0,0,0,0,0,0,0
"Mauritius","2024-04-25",0,0,0,0,0,0,0,0
"Mauritius","2024-04-26",0,0,0,0,0,0,0,0
"Mauritius","2024-04-27",0,0,0,0,0,0,0,0
"Mauritius","2024-04-28",0,0,0,0,0,0,0,0
"Mauritius","2024-04-29",0,0,0,0,0,0,0,0
"Mauritius","2024-04-30",0,0,0,0,0,0,0,0
"Mauritius","2024-05-01",0,0,0,0,0,0,0,0
"Mauritius","2024-05-02",0,0,0,0,0,0,0,0
"Mauritius","2024-05-03",0,0,0,0,0,0,0,0
"Mauritius","2024-05-04",0,0,0,0,0,0,0,0
"Mauritius","2024-05-05",0,0,0,0,0,0,0,0
"Mauritius","2024-05-06",0,0,0,0,0,0,0,0
"Mauritius","2024-05-07",0,0,0,0,0,0,0,0
"Mauritius","2024-05-08",0,0,0,0,0,0,0,0
"Mauritius","2024-05-09",0,0,0,0,0,0,0,0
"Mauritius","2024-05-10",0,0,0,0,0,0,0,0
"Mauritius","2024-05-11",0,0,0,0,0,0,0,0
"Mauritius","2024-05-12",0,0,0,0,0,0,0,0
"Mauritius","2024-05-13",0,0,0,0,0,0,0,0
"Mauritius","2024-05-14",0,0,0,0,0,0,0,0
"Mauritius","2024-05-15",0,0,0,0,0,0,0,0
"Mauritius","2024-05-16",0,0,0,0,0,0,0,0
"Mauritius","2024-05-17",0,0,0,0,0,0,0,0
"Mauritius","2024-05-18",0,0,0,0,0,0,0,0
"Mauritius","2024-05-19",0,0,0,0,0,0,0,0
"Mauritius","2024-05-20",0,0,0,0,0,0,0,0
"Mauritius","2024-05-21",0,0,0,0,0,0,0,0
"Mauritius","2024-05-22",0,0,0,0,0,0,0,0
"Mauritius","2024-05-23",0,0,0,0,0,0,0,0
"Mauritius","2024-05-24",0,0,0,0,0,0,0,0
"Mauritius","2024-05-25",0,0,0,0,0,0,0,0
"Mauritius","2024-05-26",0,0,0,0,0,0,0,0
"Mauritius","2024-05-27",0,0,0,0,0,0,0,0
"Mauritius","2024-05-28",0,0,0,0,0,0,0,0
"Mauritius","2024-05-29",0,0,0,0,0,0,0,0
"Mauritius","2024-05-30",0,0,0,0,0,0,0,0
"Mauritius","2024-05-31",0,0,0,0,0,0,0,0
"Mauritius","2024-06-01",0,0,0,0,0,0,0,0
"Mauritius","2024-06-02",0,0,0,0,0,0,0,0
"Mauritius","2024-06-03",0,0,0,0,0,0,0,0
"Mauritius","2024-06-04",0,0,0,0,0,0,0,0
"Mauritius","2024-06-05",0,0,0,0,0,0,0,0
"Mauritius","2024-06-06",0,0,0,0,0,0,0,0
"Mauritius","2024-06-07",0,0,0,0,0,0,0,0
"Mauritius","2024-06-08",0,0,0,0,0,0,0,0
"Mauritius","2024-06-09",0,0,0,0,0,0,0,0
"Mauritius","2024-06-10",0,0,0,0,0,0,0,0
"Mauritius","2024-06-11",0,0,0,0,0,0,0,0
"Mauritius","2024-06-12",0,0,0,0,0,0,0,0
"Mauritius","2024-06-13",0,0,0,0,0,0,0,0
"Mauritius","2024-06-14",0,0,0,0,0,0,0,0
"Mauritius","2024-06-15",0,0,0,0,0,0,0,0
"Mauritius","2024-06-16",0,0,0,0,0,0,0,0
"Mauritius","2024-06-17",0,0,0,0,0,0,0,0
"Mauritius","2024-06-18",0,0,0,0,0,0,0,0
"Mauritius","2024-06-19",0,0,0,0,0,0,0,0
"Mauritius","2024-06-20",0,0,0,0,0,0,0,0
"Mauritius","2024-06-21",0,0,0,0,0,0,0,0
"Mauritius","2024-06-22",0,0,0,0,0,0,0,0
"Mauritius","2024-06-23",0,0,0,0,0,0,0,0
"Mauritius","2024-06-24",0,0,0,0,0,0,0,0
"Mauritius","2024-06-25",0,0,0,0,0,0,0,0
"Mauritius","2024-06-26",0,0,0,0,0,0,0,0
"Mauritius","2024-06-27",0,0,0,0,0,0,0,0
"Mauritius","2024-06-28",0,0,0,0,0,0,0,0
"Mauritius","2024-06-29",0,0,0,0,0,0,0,0
"Mauritius","2024-06-30",0,0,0,0,0,0,0,0
"Mauritius","2024-07-01",0,0,0,0,0,0,0,0
"Mauritius","2024-07-02",0,0,0,0,0,0,0,0
"Mauritius","2024-07-03",0,0,0,0,0,0,0,0
"Mauritius","2024-07-04",0,0,0,0,0,0,0,0
"Mauritius","2024-07-05",0,0,0,0,0,0,0,0
"Mauritius","2024-07-06",0,0,0,0,0,0,0,0
"Mauritius","2024-07-07",0,0,0,0,0,0,0,0
"Mauritius","2024-07-08",0,0,0,0,0,0,0,0
"Mauritius","2024-07-09",0,0,0,0,0,0,0,0
"Mauritius","2024-07-10",0,0,0,0,0,0,0,0
"Mauritius","2024-07-11",0,0,0,0,0,0,0,0
"Mauritius","2024-07-12",0,0,0,0,0,0,0,0
"Mauritius","2024-07-13",0,0,0,0,0,0,0,0
"Mauritius","2024-07-14",0,0,0,0,0,0,0,0
"Mauritius","2024-07-15",0,0,0,0,0,0,0,0
"Mauritius","2024-07-16",0,0,0,0,0,0,0,0
"Mauritius","2024-07-17",0,0,0,0,0,0,0,0
"Mauritius","2024-07-18",0,0,0,0,0,0,0,0
"Mauritius","2024-07-19",0,0,0,0,0,0,0,0
"Mauritius","2024-07-20",0,0,0,0,0,0,0,0
"Mauritius","2024-07-21",0,0,0,0,0,0,0,0
"Mauritius","2024-07-22",0,0,0,0,0,0,0,0
"Mauritius","2024-07-23",0,0,0,0,0,0,0,0
"Mauritius","2024-07-24",0,0,0,0,0,0,0,0
"Mauritius","2024-07-25",0,0,0,0,0,0,0,0
"Mauritius","2024-07-26",0,0,0,0,0,0,0,0
"Mauritius","2024-07-27",0,0,0,0,0,0,0,0
"Mauritius","2024-07-28",0,0,0,0,0,0,0,0
"Mauritius","2024-07-29",0,0,0,0,0,0,0,0
"Mauritius","2024-07-30",0,0,0,0,0,0,0,0
"Mauritius","2024-07-31",0,0,0,0,0,0,0,0
"Mauritius","2024-08-01",0,0,0,0,0,0,0,0
"Mauritius","2024-08-02",0,0,0,0,0,0,0,0
"Mauritius","2024-08-03",0,0,0,0,0,0,0,0
"Mauritius","2024-08-04",0,0,0,0,0,0,0,0
"Mauritius","2024-08-05",0,0,0,0,0,0,0,0
"Mauritius","2024-08-06",0,0,0,0,0,0,0,0
"Mauritius","2024-08-07",0,0,0,0,0,0,0,0
"Mauritius","2024-08-08",0,0,0,0,0,0,0,0
"Mauritius","2024-08-09",0,0,0,0,0,0,0,0
"Mauritius","2024-08-10",0,0,0,0,0,0,0,0
"Mauritius","2024-08-11",0,0,0,0,0,0,0,0
"Mauritius","2024-08-12",0,0,0,0,0,0,0,0
"Mauritius","2024-08-13",0,0,0,0,0,0,0,0
"Mauritius","2024-08-14",0,0,0,0,0,0,0,0
"Mauritius","2024-08-15",0,0,0,0,0,0,0,0
"Mauritius","2024-08-16",0,0,0,0,0,0,0,0
"Mauritius","2024-08-17",0,0,0,0,0,0,0,0
"Mauritius","2024-08-18",0,0,0,0,0,0,0,0
"Mauritius","2024-08-19",0,0,0,0,0,0,0,0
"Mauritius","2024-08-20",0,0,0,0,0,0,0,0
"Mauritius","2024-08-21",0,0,0,0,0,0,0,0
"Mauritius","2024-08-22",0,0,0,0,0,0,0,0
"Mauritius","2024-08-23",0,0,0,0,0,0,0,0
"Mauritius","2024-08-24",0,0,0,0,0,0,0,0
"Mauritius","2024-08-25",0,0,0,0,0,0,0,0
"Mauritius","2024-08-26",0,0,0,0,0,0,0,0
"Mauritius","2024-08-27",0,0,0,0,0,0,0,0
"Mauritius","2024-08-28",0,0,0,0,0,0,0,0
"Mauritius","2024-08-29",0,0,0,0,0,0,0,0
"Mauritius","2024-08-30",0,0,0,0,0,0,0,0
"Mauritius","2024-08-31",0,0,0,0,0,0,0,0
"Mauritius","2024-09-01",0,0,0,0,0,0,0,0
"Mauritius","2024-09-02",0,0,0,0,0,0,0,0
"Mauritius","2024-09-03",0,0,0,0,0,0,0,0
"Mauritius","2024-09-04",0,0,0,0,0,0,0,0
"Mauritius","2024-09-05",0,0,0,0,0,0,0,0
"Mauritius","2024-09-06",0,0,0,0,0,0,0,0
"Mauritius","2024-09-07",0,0,0,0,0,0,0,0
"Mauritius","2024-09-08",0,0,0,0,0,0,0,0
"Mauritius","2024-09-09",0,0,0,0,0,0,0,0
"Mauritius","2024-09-10",0,0,0,0,0,0,0,0
"Mauritius","2024-09-11",0,0,0,0,0,0,0,0
"Mauritius","2024-09-12",0,0,0,0,0,0,0,0
"Mauritius","2024-09-13",0,0,0,0,0,0,0,0
"Mauritius","2024-09-14",0,0,0,0,0,0,0,0
"Mauritius","2024-09-15",0,0,0,0,0,0,0,0
"Mauritius","2024-09-16",0,0,0,0,0,0,0,0
"Mauritius","2024-09-17",0,0,0,0,0,0,0,0
"Mauritius","2024-09-18",0,0,0,0,0,0,0,0
"Mauritius","2024-09-19",0,0,0,0,0,0,0,0
"Mauritius","2024-09-20",0,0,0,0,0,0,0,0
"Mauritius","2024-09-21",0,0,0,0,0,0,0,0
"Mauritius","2024-09-22",0,0,0,0,0,0,0,0
"Mauritius","2024-09-23",0,0,0,0,0,0,0,0
"Mauritius","2024-09-24",0,0,0,0,0,0,0,0
"Mauritius","2024-09-25",0,0,0,0,0,0,0,0
"Mauritius","2024-09-26",0,0,0,0,0,0,0,0
"Mauritius","2024-09-27",0,0,0,0,0,0,0,0
"Mauritius","2024-09-28",0,0,0,0,0,0,0,0
"Mauritius","2024-09-29",0,0,0,0,0,0,0,0
"Mauritius","2024-09-30",0,0,0,0,0,0,0,0
"Mauritius","2024-10-01",0,0,0,0,0,0,0,0
"Mauritius","2024-10-02",0,0,0,0,0,0,0,0
"Mauritius","2024-10-03",0,0,0,0,0,0,0,0
"Mauritius","2024-10-04",0,0,0,0,0,0,0,0
"Mauritius","2024-10-05",0,0,0,0,0,0,0,0
"Mauritius","2024-10-06",0,0,0,0,0,0,0,0
"Mauritius","2024-10-07",0,0,0,0,0,0,0,0
"Mauritius","2024-10-08",0,0,0,0,0,0,0,0
"Mauritius","2024-10-09",0,0,0,0,0,0,0,0
"Mauritius","2024-10-10",0,0,0,0,0,0,0,0
"Mauritius","2024-10-11",0,0,0,0,0,0,0,0
"Mauritius","2024-10-12",0,0,0,0,0,0,0,0
"Mauritius","2024-10-13",0,0,0,0,0,0,0,0
"Mauritius","2024-10-14",0,0,0,0,0,0,0,0
"Mauritius","2024-10-15",0,0,0,0,0,0,0,0
"Mauritius","2024-10-16",0,0,0,0,0,0,0,0
"Mauritius","2024-10-17",0,0,0,0,0,0,0,0
"Mauritius","2024-10-18",0,0,0,0,0,0,0,0
"Mauritius","2024-10-19",0,0,0,0,0,0,0,0
"Mauritius","2024-10-20",0,0,0,0,0,0,0,0
"Mauritius","2024-10-21",0,0,0,0,0,0,0,0
"Mauritius","2024-10-22",0,0,0,0,0,0,0,0
"Mauritius","2024-10-23",0,0,0,0,0,0,0,0
"Mauritius","2024-10-24",0,0,0,0,0,0,0,0
"Mauritius","2024-10-25",0,0,0,0,0,0,0,0
"Mauritius","2024-10-26",0,0,0,0,0,0,0,0
"Mauritius","2024-10-27",0,1,1,0,1,1,0,0
"Mauritius","2024-10-28",0,0,1,0,0,1,0,0
"Mauritius","2024-10-29",0,0,1,0,0,1,0,0
"Mauritius","2024-10-30",0,0,1,0,0,1,0,0
"Mauritius","2024-10-31",0,0,1,0,0,1,0,0
"Mauritius","2024-11-01",0,0,1,0,0,1,0,0
"Mauritius","2024-11-02",0,0,1,0,0,1,0,0
"Mauritius","2024-11-03",0,0,1,0,0,1,0,0
"Mauritius","2024-11-04",0,0,1,0,0,1,0,0
"Mauritius","2024-11-05",0,0,1,0,0,1,0,0
"Mauritius","2024-11-06",0,0,1,0,0,1,0,0
"Mauritius","2024-11-07",0,0,1,0,0,1,0,0
"Mauritius","2024-11-08",0,0,1,0,0,1,0,0
"Mauritius","2024-11-09",0,0,1,0,0,1,0,0
"Mauritius","2024-11-10",0,0,1,0,0,1,0,0
"Mauritius","2024-11-11",0,0,1,0,0,1,0,0
"Mauritius","2024-11-12",0,0,1,0,0,1,0,0
"Mauritius","2024-11-13",0,0,1,0,0,1,0,0
"Mauritius","2024-11-14",0,0,1,0,0,1,0,0
"Mauritius","2024-11-15",0,0,1,0,0,1,0,0
"Mauritius","2024-11-16",0,0,1,0,0,1,0,0
"Mauritius","2024-11-17",0,0,1,0,0,1,0,0
"Mauritius","2024-11-18",0,0,1,0,0,1,0,0
"Mauritius","2024-11-19",0,0,1,0,0,1,0,0
"Mauritius","2024-11-20",0,0,1,0,0,1,0,0
"Mauritius","2024-11-21",0,0,1,0,0,1,0,0
"Mauritius","2024-11-22",0,0,1,0,0,1,0,0
"Mauritius","2024-11-23",0,0,1,0,0,1,0,0
"Mauritius","2024-11-24",0,0,1,0,0,1,0,0
"Mauritius","2024-11-25",0,0,1,0,0,1,0,0
"Mauritius","2024-11-26",0,0,1,0,0,1,0,0
"Mauritius","2024-11-27",0,0,1,0,0,1,0,0
"Mauritius","2024-11-28",0,0,1,0,0,1,0,0
"Mauritius","2024-11-29",0,0,1,0,0,1,0,0
"Mauritius","2024-11-30",0,0,1,0,0,1,0,0
"Mauritius","2024-12-01",0,0,1,0,0,1,0,0
"Mauritius","2024-12-02",0,0,1,0,0,1,0,0
"Mauritius","2024-12-03",0,0,1,0,0,1,0,0
"Mauritius","2024-12-04",0,0,1,0,0,1,0,0
"Mauritius","2024-12-05",0,0,1,0,0,1,0,0
"Mauritius","2024-12-06",0,0,1,0,0,1,0,0
"Mauritius","2024-12-07",0,0,1,0,0,1,0,0
"Mauritius","2024-12-08",0,0,1,0,0,1,0,0
"Mauritius","2024-12-09",0,0,1,0,0,1,0,0
"Mauritius","2024-12-10",0,0,1,0,0,1,0,0
"Mauritius","2024-12-11",0,0,1,0,0,1,0,0
"Mauritius","2024-12-12",0,0,1,0,0,1,0,0
"Mauritius","2024-12-13",0,0,1,0,0,1,0,0
"Mauritius","2024-12-14",0,0,1,0,0,1,0,0
"Mauritius","2024-12-15",0,0,1,0,0,1,0,0
"Mauritius","2024-12-16",0,0,1,0,0,1,0,0
"Mauritius","2024-12-17",0,0,1,0,0,1,0,0
"Mauritius","2024-12-18",0,0,1,0,0,1,0,0
"Mauritius","2024-12-19",0,0,1,0,0,1,0,0
"Mauritius","2024-12-20",0,0,1,0,0,1,0,0
"Mauritius","2024-12-21",0,0,1,0,0,1,0,0
"Mauritius","2024-12-22",0,0,1,0,0,1,0,0
"Mauritius","2024-12-23",0,0,1,0,0,1,0,0
"Mauritius","2024-12-24",0,0,1,0,0,1,0,0
"Mauritius","2024-12-25",0,0,1,0,0,1,0,0
"Mauritius","2024-12-26",0,0,1,0,0,1,0,0
"Mauritius","2024-12-27",0,0,1,0,0,1,0,0
"Mauritius","2024-12-28",0,0,1,0,0,1,0,0
"Mauritius","2024-12-29",0,0,1,0,0,1,0,0
"Mauritius","2024-12-30",0,0,1,0,0,1,0,0
"Mauritius","2024-12-31",0,0,1,0,0,1,0,0
"Mauritius","2025-01-01",0,0,1,0,0,1,0,0
"Mauritius","2025-01-02",0,0,1,0,0,1,0,0
"Mauritius","2025-01-03",0,0,1,0,0,1,0,0
"Mauritius","2025-01-04",0,0,1,0,0,1,0,0
"Mauritius","2025-01-05",0,0,1,0,0,1,0,0
"Mauritius","2025-01-06",0,0,1,0,0,1,0,0
"Mauritius","2025-01-07",0,0,1,0,0,1,0,0
"Mauritius","2025-01-08",0,0,1,0,0,1,0,0
"Mauritius","2025-01-09",0,0,1,0,0,1,0,0
"Mauritius","2025-01-10",0,0,1,0,0,1,0,0
"Mauritius","2025-01-11",0,0,1,0,0,1,0,0
"Mauritius","2025-01-12",0,0,1,0,0,1,0,0
"Mauritius","2025-01-13",0,0,1,0,0,1,0,0
"Mauritius","2025-01-14",0,0,1,0,0,1,0,0
"Mauritius","2025-01-15",0,0,1,0,0,1,0,0
"Mauritius","2025-01-16",0,0,1,0,0,1,0,0
"Mauritius","2025-01-17",0,0,1,0,0,1,0,0
"Mauritius","2025-01-18",0,0,1,0,0,1,0,0
"Mauritius","2025-01-19",0,0,1,0,0,1,0,0
"Mauritius","2025-01-20",0,0,1,0,0,1,0,0
"Mauritius","2025-01-21",0,0,1,0,0,1,0,0
"Mauritius","2025-01-22",0,0,1,0,0,1,0,0
"Mauritius","2025-01-23",0,0,1,0,0,1,0,0
"Mauritius","2025-01-24",0,0,1,0,0,1,0,0
"Mauritius","2025-01-25",0,0,1,0,0,1,0,0
"Mauritius","2025-01-26",0,0,1,0,0,1,0,0
"Mauritius","2025-01-27",0,0,1,0,0,1,0,0
"Mauritius","2025-01-28",0,0,1,0,0,1,0,0
"Mauritius","2025-01-29",0,0,1,0,0,1,0,0
"Mauritius","2025-01-30",0,0,1,0,0,1,0,0
"Mauritius","2025-01-31",0,0,1,0,0,1,0,0
"Mauritius","2025-02-01",0,0,1,0,0,1,0,0
"Mauritius","2025-02-02",0,0,1,0,0,1,0,0
"Mauritius","2025-02-03",0,0,1,0,0,1,0,0
"Mexico","2024-01-01",0,0,0,0,0,0,0,0
"Mexico","2024-01-02",0,0,0,0,0,0,0,0
"Mexico","2024-01-03",0,0,0,0,0,0,0,0
"Mexico","2024-01-04",0,0,0,0,0,0,0,0
"Mexico","2024-01-05",0,0,0,0,0,0,0,0
"Mexico","2024-01-06",0,0,0,0,0,0,0,0
"Mexico","2024-01-07",0,0,0,0,0,0,0,0
"Mexico","2024-01-08",0,0,0,0,0,0,0,0
"Mexico","2024-01-09",0,0,0,0,0,0,0,0
"Mexico","2024-01-10",0,0,0,0,0,0,0,0
"Mexico","2024-01-11",0,0,0,0,0,0,0,0
"Mexico","2024-01-12",0,0,0,0,0,0,0,0
"Mexico","2024-01-13",0,0,0,0,0,0,0,0
"Mexico","2024-01-14",0,0,0,0,0,0,0,0
"Mexico","2024-01-15",0,0,0,0,0,0,0,0
"Mexico","2024-01-16",0,0,0,0,0,0,0,0
"Mexico","2024-01-17",0,0,0,0,0,0,0,0
"Mexico","2024-01-18",0,0,0,0,0,0,0,0
"Mexico","2024-01-19",0,0,0,0,0,0,0,0
"Mexico","2024-01-20",0,0,0,0,0,0,0,0
"Mexico","2024-01-21",0,0,0,0,0,0,0,0
"Mexico","2024-01-22",0,0,0,0,0,0,0,0
"Mexico","2024-01-23",0,1,1,0,1,1,0,0
"Mexico","2024-01-24",0,0,1,0,0,1,0,0
"Mexico","2024-01-25",0,0,1,0,0,1,0,0
"Mexico","2024-01-26",0,0,1,0,0,1,0,0
"Mexico","2024-01-27",0,0,1,0,1,2,0,0
"Mexico","2024-01-28",0,0,1,0,0,2,0,0
"Mexico","2024-01-29",0,0,1,0,0,2,0,0
"Mexico","2024-01-30",0,1,2,0,0,2,0,0
"Mexico","2024-01-31",0,0,2,0,0,2,0,0
"Mexico","2024-02-01",0,0,2,0,0,2,0,0
"Mexico","2024-02-02",0,0,2,0,0,2,0,0
"Mexico","2024-02-03",0,0,2,0,1,3,0,0
"Mexico","2024-02-04",0,0,2,0,0,3,0,0
"Mexico","2024-02-05",0,0,2,0,0,3,0,0
"Mexico","2024-02-06",0,0,2,0,0,3,0,0
"Mexico","2024-02-07",0,0,2,0,0,3,0,0
"Mexico","2024-02-08",0,0,2,0,0,3,0,0
"Mexico","2024-02-09",0,0,2,0,0,3,0,0
"Mexico","2024-02-10",0,0,2,0,1,4,0,0
"Mexico","2024-02-11",0,0,2,0,0,4,0,0
"Mexico","2024-02-12",0,0,2,0,0,4,0,0
"Mexico","2024-02-13",0,2,4,0,0,4,0,0
"Mexico","2024-02-14",0,0,4,0,0,4,0,0
"Mexico","2024-02-15",0,0,4,0,0,4,0,0
"Mexico","2024-02-16",0,0,4,0,0,4,0,0
"Mexico","2024-02-17",0,0,4,0,1,5,0,0
"Mexico","2024-02-18",0,0,4,0,0,5,0,0
"Mexico","2024-02-19",0,0,4,0,0,5,0,0
"Mexico","2024-02-20",0,1,5,0,0,5,0,0
"Mexico","2024-02-21",0,0,5,0,0,5,0,0
"Mexico","2024-02-22",0,0,5,0,0,5,0,0
"Mexico","2024-02-23",0,0,5,0,0,5,0,0
"Mexico","2024-02-24",0,0,5,0,0,5,0,0
"Mexico","2024-02-25",0,0,5,0,0,5,0,0
"Mexico","2024-02-26",0,0,5,0,0,5,0,0
"Mexico","2024-02-27",0,0,5,0,0,5,0,0
"Mexico","2024-02-28",0,0,5,0,0,5,0,0
"Mexico","2024-02-29",0,0,5,0,0,5,0,0
"Mexico","2024-03-01",0,0,5,0,0,5,0,0
"Mexico","2024-03-02",0,0,5,0,1,6,0,0
"Mexico","2024-03-03",0,0,5,0,0,6,0,0
"Mexico","2024-03-04",0,0,5,0,0,6,0,0
"Mexico","2024-03-05",0,0,5,0,0,6,0,0
"Mexico","2024-03-06",0,0,5,0,0,6,0,0
"Mexico","2024-03-07",0,0,5,0,0,6,0,0
"Mexico","2024-03-08",0,0,5,0,0,6,0,0
"Mexico","2024-03-09",0,0,5,0,0,6,0,0
"Mexico","2024-03-10",0,0,5,0,0,6,0,0
"Mexico","2024-03-11",0,0,5,0,0,6,0,0
"Mexico","2024-03-12",0,0,5,0,0,6,0,0
"Mexico","2024-03-13",0,0,5,0,0,6,0,0
"Mexico","2024-03-14",0,0,5,0,0,6,0,0
"Mexico","2024-03-15",0,0,5,0,0,6,0,0
"Mexico","2024-03-16",0,0,5,0,0,6,0,0
"Mexico","2024-03-17",0,0,5,0,0,6,0,0
"Mexico","2024-03-18",0,0,5,0,0,6,0,0
"Mexico","2024-03-19",0,0,5,0,0,6,0,0
"Mexico","2024-03-20",0,0,5,0,0,6,0,0
"Mexico","2024-03-21",0,0,5,0,0,6,0,0
"Mexico","2024-03-22",0,0,5,0,0,6,0,0
"Mexico","2024-03-23",0,0,5,0,1,7,0,0
"Mexico","2024-03-24",0,0,5,0,0,7,0,0
"Mexico","2024-03-25",0,0,5,0,0,7,0,0
"Mexico","2024-03-26",0,0,5,0,0,7,0,0
"Mexico","2024-03-27",0,0,5,0,0,7,0,0
"Mexico","2024-03-28",0,0,5,0,0,7,0,0
"Mexico","2024-03-29",0,0,5,0,0,7,0,0
"Mexico","2024-03-30",0,0,5,0,0,7,0,0
"Mexico","2024-03-31",0,0,5,0,0,7,0,0
"Mexico","2024-04-01",0,0,5,0,0,7,0,0
"Mexico","2024-04-02",0,2,7,0,0,7,0,0
"Mexico","2024-04-03",0,0,7,0,0,7,0,0
"Mexico","2024-04-04",0,0,7,0,1,8,0,0
"Mexico","2024-04-05",0,0,7,0,0,8,0,0
"Mexico","2024-04-06",0,0,7,0,0,8,0,0
"Mexico","2024-04-07",0,0,7,0,0,8,0,0
"Mexico","2024-04-08",0,0,7,0,1,9,0,0
"Mexico","2024-04-09",0,2,9,0,0,9,0,0
"Mexico","2024-04-10",0,0,9,0,0,9,0,0
"Mexico","2024-04-11",0,0,9,0,0,9,0,0
"Mexico","2024-04-12",0,0,9,0,0,9,0,0
"Mexico","2024-04-13",0,0,9,0,1,10,0,0
"Mexico","2024-04-14",0,0,9,0,0,10,0,0
"Mexico","2024-04-15",0,0,9,0,0,10,0,0
"Mexico","2024-04-16",0,1,10,0,0,10,0,0
"Mexico","2024-04-17",0,0,10,0,0,10,0,0
"Mexico","2024-04-18",0,0,10,0,1,11,0,0
"Mexico","2024-04-19",0,0,10,0,0,11,0,0
"Mexico","2024-04-20",0,0,10,0,0,11,0,0
"Mexico","2024-04-21",0,0,10,0,0,11,0,0
"Mexico","2024-04-22",0,0,10,0,1,12,0,0
"Mexico","2024-04-23",0,0,10,0,0,12,0,0
"Mexico","2024-04-24",0,0,10,0,0,12,0,0
"Mexico","2024-04-25",0,0,10,0,1,13,0,0
"Mexico","2024-04-26",0,0,10,0,0,13,0,0
"Mexico","2024-04-27",0,0,10,0,0,13,0,0
"Mexico","2024-04-28",0,0,10,0,0,13,0,0
"Mexico","2024-04-29",0,0,10,0,1,14,0,0
"Mexico","2024-04-30",0,4,14,0,0,14,0,0
"Mexico","2024-05-01",0,0,14,0,0,14,0,0
"Mexico","2024-05-02",0,0,14,0,0,14,0,0
"Mexico","2024-05-03",0,0,14,0,0,14,0,0
"Mexico","2024-05-04",0,0,14,0,1,15,0,0
"Mexico","2024-05-05",0,0,14,0,0,15,0,0
"Mexico","2024-05-06",0,0,14,0,0,15,0,0
"Mexico","2024-05-07",0,1,15,0,0,15,0,0
"Mexico","2024-05-08",0,0,15,0,0,15,0,0
"Mexico","2024-05-09",0,0,15,0,1,16,0,0
"Mexico","2024-05-10",0,0,15,0,0,16,0,0
"Mexico","2024-05-11",0,0,15,0,1,17,0,0
"Mexico","2024-05-12",0,0,15,0,0,17,0,0
"Mexico","2024-05-13",0,0,15,0,1,18,0,0
"Mexico","2024-05-14",0,3,18,0,0,18,0,0
"Mexico","2024-05-15",0,0,18,0,1,19,0,0
"Mexico","2024-05-16",0,0,18,0,0,19,0,0
"Mexico","2024-05-17",0,0,18,0,1,20,0,0
"Mexico","2024-05-18",0,0,18,0,0,20,0,0
"Mexico","2024-05-19",0,0,18,0,1,21,0,0
"Mexico","2024-05-20",0,0,18,0,0,21,0,0
"Mexico","2024-05-21",0,4,22,0,1,22,0,0
"Mexico","2024-05-22",0,0,22,0,0,22,0,0
"Mexico","2024-05-23",0,0,22,0,0,22,0,0
"Mexico","2024-05-24",0,0,22,0,0,22,0,0
"Mexico","2024-05-25",0,0,22,0,1,23,0,0
"Mexico","2024-05-26",0,0,22,0,0,23,0,0
"Mexico","2024-05-27",0,0,22,0,0,23,0,0
"Mexico","2024-05-28",0,1,23,0,0,23,0,0
"Mexico","2024-05-29",0,0,23,0,1,24,0,0
"Mexico","2024-05-30",0,0,23,0,1,25,0,0
"Mexico","2024-05-31",0,0,23,0,1,26,0,0
"Mexico","2024-06-01",0,0,23,0,1,27,0,0
"Mexico","2024-06-02",0,0,23,0,1,28,0,0
"Mexico","2024-06-03",0,0,23,0,1,29,0,0
"Mexico","2024-06-04",0,7,30,0,1,30,0,0
"Mexico","2024-06-05",0,0,30,0,0,30,0,0
"Mexico","2024-06-06",0,0,30,0,1,31,0,0
"Mexico","2024-06-07",0,0,30,0,0,31,0,0
"Mexico","2024-06-08",0,0,30,0,1,32,0,0
"Mexico","2024-06-09",0,0,30,0,0,32,0,0
"Mexico","2024-06-10",0,0,30,0,1,33,0,0
"Mexico","2024-06-11",0,3,33,0,0,33,0,0
"Mexico","2024-06-12",0,0,33,0,1,34,0,0
"Mexico","2024-06-13",0,0,33,0,0,34,0,0
"Mexico","2024-06-14",0,0,33,0,1,35,0,0
"Mexico","2024-06-15",0,0,33,0,0,35,0,0
"Mexico","2024-06-16",0,0,33,0,1,36,0,0
"Mexico","2024-06-17",0,0,33,0,0,36,0,0
"Mexico","2024-06-18",0,4,37,0,1,37,0,0
"Mexico","2024-06-19",0,0,37,0,0,37,0,0
"Mexico","2024-06-20",0,0,37,0,0,37,0,0
"Mexico","2024-06-21",0,0,37,0,0,37,0,0
"Mexico","2024-06-22",0,0,37,0,1,38,0,0
"Mexico","2024-06-23",0,0,37,0,0,38,0,0
"Mexico","2024-06-24",0,0,37,0,0,38,0,0
"Mexico","2024-06-25",0,1,38,0,0,38,0,0
"Mexico","2024-06-26",0,0,38,0,1,39,0,0
"Mexico","2024-06-27",0,0,38,0,0,39,0,0
"Mexico","2024-06-28",0,0,38,0,1,40,0,0
"Mexico","2024-06-29",0,0,38,0,0,40,0,0
"Mexico","2024-06-30",0,0,38,0,1,41,0,0
"Mexico","2024-07-01",0,0,38,0,0,41,0,0
"Mexico","2024-07-02",0,4,42,0,1,42,0,0
"Mexico","2024-07-03",0,0,42,0,0,42,0,0
"Mexico","2024-07-04",0,0,42,0,1,43,0,0
"Mexico","2024-07-05",0,0,42,0,0,43,0,0
"Mexico","2024-07-06",0,0,42,0,1,44,0,0
"Mexico","2024-07-07",0,0,42,0,0,44,0,0
"Mexico","2024-07-08",0,0,42,0,1,45,0,0
"Mexico","2024-07-09",0,3,45,0,0,45,0,0
"Mexico","2024-07-10",0,0,45,0,0,45,0,0
"Mexico","2024-07-11",0,0,45,0,0,45,0,0
"Mexico","2024-07-12",0,0,45,0,0,45,0,0
"Mexico","2024-07-13",0,0,45,0,1,46,0,0
"Mexico","2024-07-14",0,0,45,0,0,46,0,0
"Mexico","2024-07-15",0,0,45,0,0,46,0,0
"Mexico","2024-07-16",0,1,46,0,0,46,0,0
"Mexico","2024-07-17",0,0,46,0,0,46,0,0
"Mexico","2024-07-18",0,0,46,0,0,46,0,0
"Mexico","2024-07-19",0,0,46,0,1,47,0,0
"Mexico","2024-07-20",0,0,46,0,0,47,0,0
"Mexico","2024-07-21",0,0,46,0,0,47,0,0
"Mexico","2024-07-22",0,0,46,0,0,47,0,0
"Mexico","2024-07-23",0,0,46,0,1,48,0,0
"Mexico","2024-07-24",0,0,46,0,0,48,0,0
"Mexico","2024-07-25",0,0,46,0,0,48,0,0
"Mexico","2024-07-26",0,0,46,0,0,48,0,0
"Mexico","2024-07-27",0,0,46,0,0,48,0,0
"Mexico","2024-07-28",0,0,46,0,1,49,0,0
"Mexico","2024-07-29",0,0,46,0,0,49,0,0
"Mexico","2024-07-30",0,3,49,0,0,49,0,0
"Mexico","2024-07-31",0,0,49,0,1,50,0,0
"Mexico","2024-08-01",0,0,49,0,0,50,0,0
"Mexico","2024-08-02",0,0,49,0,1,51,0,0
"Mexico","2024-08-03",0,0,49,0,0,51,0,0
"Mexico","2024-08-04",0,0,49,0,1,52,0,0
"Mexico","2024-08-05",0,0,49,0,0,52,0,0
"Mexico","2024-08-06",0,4,53,0,1,53,0,0
"Mexico","2024-08-07",0,0,53,0,0,53,0,0
"Mexico","2024-08-08",0,0,53,0,1,54,0,0
"Mexico","2024-08-09",0,0,53,0,0,54,0,0
"Mexico","2024-08-10",0,0,53,0,0,54,0,0
"Mexico","2024-08-11",0,0,53,0,0,54,0,0
"Mexico","2024-08-12",0,0,53,0,1,55,0,0
"Mexico","2024-08-13",0,2,55,0,0,55,0,0
"Mexico","2024-08-14",0,0,55,0,1,56,0,0
"Mexico","2024-08-15",0,0,55,0,1,57,0,0
"Mexico","2024-08-16",0,0,55,0,1,58,0,0
"Mexico","2024-08-17",0,0,55,0,0,58,0,0
"Mexico","2024-08-18",0,0,55,0,1,59,0,0
"Mexico","2024-08-19",0,0,55,0,1,60,0,0
"Mexico","2024-08-20",0,6,61,0,1,61,0,0
"Mexico","2024-08-21",0,0,61,0,2,63,0,0
"Mexico","2024-08-22",0,0,61,0,1,64,0,0
"Mexico","2024-08-23",0,0,61,0,2,66,0,0
"Mexico","2024-08-24",0,0,61,0,1,67,0,0
"Mexico","2024-08-25",0,0,61,0,2,69,0,0
"Mexico","2024-08-26",0,0,61,0,1,70,0,0
"Mexico","2024-08-27",0,11,72,0,2,72,0,0
"Mexico","2024-08-28",0,0,72,0,1,73,0,0
"Mexico","2024-08-29",0,0,72,0,0,73,0,0
"Mexico","2024-08-30",0,0,72,0,1,74,0,0
"Mexico","2024-08-31",0,0,72,0,0,74,0,0
"Mexico","2024-09-01",0,0,72,0,1,75,0,0
"Mexico","2024-09-02",0,0,72,0,0,75,0,0
"Mexico","2024-09-03",0,4,76,0,1,76,0,0
"Mexico","2024-09-04",0,0,76,0,1,77,0,0
"Mexico","2024-09-05",0,0,76,0,1,78,0,0
"Mexico","2024-09-06",0,0,76,0,1,79,0,0
"Mexico","2024-09-07",0,0,76,0,1,80,0,0
"Mexico","2024-09-08",0,0,76,0,1,81,0,0
"Mexico","2024-09-09",0,0,76,0,1,82,0,0
"Mexico","2024-09-10",0,7,83,0,1,83,0,0
"Mexico","2024-09-11",0,0,83,0,0,83,0,0
"Mexico","2024-09-12",0,0,83,0,1,84,0,0
"Mexico","2024-09-13",0,0,83,0,0,84,0,0
"Mexico","2024-09-14",0,0,83,0,0,84,0,0
"Mexico","2024-09-15",0,0,83,0,0,84,0,0
"Mexico","2024-09-16",0,0,83,0,1,85,0,0
"Mexico","2024-09-17",0,2,85,0,0,85,0,0
"Mexico","2024-09-18",0,0,85,0,0,85,0,0
"Mexico","2024-09-19",0,0,85,0,1,86,0,0
"Mexico","2024-09-20",0,0,85,0,0,86,0,0
"Mexico","2024-09-21",0,0,85,0,0,86,0,0
"Mexico","2024-09-22",0,0,85,0,0,86,0,0
"Mexico","2024-09-23",0,0,85,0,1,87,0,0
"Mexico","2024-09-24",0,2,87,0,0,87,0,0
"Mexico","2024-09-25",0,0,87,0,2,89,0,0
"Mexico","2024-09-26",0,0,87,0,1,90,0,0
"Mexico","2024-09-27",0,0,87,0,2,92,0,0
"Mexico","2024-09-28",0,0,87,0,1,93,0,0
"Mexico","2024-09-29",0,0,87,0,2,95,0,0
"Mexico","2024-09-30",0,0,87,0,1,96,0,0
"Mexico","2024-10-01",0,11,98,0,2,98,0,0
"Mexico","2024-10-02",0,0,98,0,0,98,0,0
"Mexico","2024-10-03",0,0,98,0,1,99,0,0
"Mexico","2024-10-04",0,0,98,0,0,99,0,0
"Mexico","2024-10-05",0,0,98,0,1,100,0,0
"Mexico","2024-10-06",0,0,98,0,0,100,0,0
"Mexico","2024-10-07",0,0,98,0,1,101,0,0
"Mexico","2024-10-08",0,3,101,0,0,101,0,0
"Mexico","2024-10-09",0,0,101,0,0,101,0,0
"Mexico","2024-10-10",0,0,101,0,1,102,0,0
"Mexico","2024-10-11",0,0,101,0,0,102,0,0
"Mexico","2024-10-12",0,0,101,0,1,103,0,0
"Mexico","2024-10-13",0,0,101,0,0,103,0,0
"Mexico","2024-10-14",0,0,101,0,1,104,0,0
"Mexico","2024-10-15",0,3,104,0,0,104,0,0
"Mexico","2024-10-16",0,0,104,0,0,104,0,0
"Mexico","2024-10-17",0,0,104,0,1,105,0,0
"Mexico","2024-10-18",0,0,104,0,0,105,0,0
"Mexico","2024-10-19",0,0,104,0,1,106,0,0
"Mexico","2024-10-20",0,0,104,0,0,106,0,0
"Mexico","2024-10-21",0,0,104,0,1,107,0,0
"Mexico","2024-10-22",0,3,107,0,0,107,0,0
"Mexico","2024-10-23",0,0,107,0,0,107,0,0
"Mexico","2024-10-24",0,0,107,0,1,108,0,0
"Mexico","2024-10-25",0,0,107,0,0,108,0,0
"Mexico","2024-10-26",0,0,107,0,1,109,0,0
"Mexico","2024-10-27",0,0,107,0,0,109,0,0
"Mexico","2024-10-28",0,0,107,0,1,110,0,0
"Mexico","2024-10-29",0,3,110,0,0,110,0,0
"Mexico","2024-10-30",0,0,110,0,0,110,0,0
"Mexico","2024-10-31",0,0,110,0,0,110,0,0
"Mexico","2024-11-01",0,0,110,0,0,110,0,0
"Mexico","2024-11-02",0,0,110,0,1,111,0,0
"Mexico","2024-11-03",0,0,110,0,0,111,0,0
"Mexico","2024-11-04",0,0,110,0,0,111,0,0
"Mexico","2024-11-05",0,1,111,0,0,111,0,0
"Mexico","2024-11-06",0,0,111,0,0,111,0,0
"Mexico","2024-11-07",0,0,111,0,0,111,0,0
"Mexico","2024-11-08",0,0,111,0,0,111,0,0
"Mexico","2024-11-09",0,0,111,0,1,112,0,0
"Mexico","2024-11-10",0,0,111,0,0,112,0,0
"Mexico","2024-11-11",0,0,111,0,0,112,0,0
"Mexico","2024-11-12",0,1,112,0,0,112,0,0
"Mexico","2024-11-13",0,0,112,0,0,112,0,0
"Mexico","2024-11-14",0,0,112,0,0,112,0,0
"Mexico","2024-11-15",0,0,112,0,0,112,0,0
"Mexico","2024-11-16",0,0,112,0,0,112,0,0
"Mexico","2024-11-17",0,0,112,0,0,112,0,0
"Mexico","2024-11-18",0,0,112,0,0,112,0,0
"Mexico","2024-11-19",0,0,112,0,0,112,0,0
"Mexico","2024-11-20",0,0,112,0,0,112,0,0
"Mexico","2024-11-21",0,0,112,0,0,112,0,0
"Mexico","2024-11-22",0,0,112,0,0,112,0,0
"Mexico","2024-11-23",0,0,112,0,1,113,0,0
"Mexico","2024-11-24",0,0,112,0,0,113,0,0
"Mexico","2024-11-25",0,0,112,0,0,113,0,0
"Mexico","2024-11-26",0,0,112,0,0,113,0,0
"Mexico","2024-11-27",0,0,112,0,0,113,0,0
"Mexico","2024-11-28",0,0,112,0,0,113,0,0
"Mexico","2024-11-29",0,0,112,0,0,113,0,0
"Mexico","2024-11-30",0,0,112,0,0,113,0,0
"Mexico","2024-12-01",0,0,112,0,0,113,0,0
"Mexico","2024-12-02",0,0,112,0,0,113,0,0
"Mexico","2024-12-03",0,1,113,0,0,113,0,0
"Mexico","2024-12-04",0,0,113,0,0,113,0,0
"Mexico","2024-12-05",0,0,113,0,1,114,0,0
"Mexico","2024-12-06",0,0,113,0,0,114,0,0
"Mexico","2024-12-07",0,0,113,0,0,114,0,0
"Mexico","2024-12-08",0,0,113,0,0,114,0,0
"Mexico","2024-12-09",0,0,113,0,1,115,0,0
"Mexico","2024-12-10",0,2,115,0,0,115,0,0
"Mexico","2024-12-11",0,0,115,0,1,116,0,0
"Mexico","2024-12-12",0,0,115,0,0,116,0,0
"Mexico","2024-12-13",0,0,115,0,1,117,0,0
"Mexico","2024-12-14",0,0,115,0,0,117,0,0
"Mexico","2024-12-15",0,0,115,0,1,118,0,0
"Mexico","2024-12-16",0,0,115,0,0,118,0,0
"Mexico","2024-12-17",0,4,119,0,1,119,0,0
"Mexico","2024-12-18",0,0,119,0,0,119,0,0
"Mexico","2024-12-19",0,0,119,0,1,120,0,0
"Mexico","2024-12-20",0,0,119,0,0,120,0,0
"Mexico","2024-12-21",0,0,119,0,1,121,0,0
"Mexico","2024-12-22",0,0,119,0,0,121,0,0
"Mexico","2024-12-23",0,0,119,0,1,122,0,0
"Mexico","2024-12-24",0,3,122,0,0,122,0,0
"Mexico","2024-12-25",0,0,122,0,0,122,0,0
"Mexico","2024-12-26",0,0,122,0,0,122,0,0
"Mexico","2024-12-27",0,0,122,0,0,122,0,0
"Mexico","2024-12-28",0,0,122,0,0,122,0,0
"Mexico","2024-12-29",0,0,122,0,0,122,0,0
"Mexico","2024-12-30",0,0,122,0,0,122,0,0
"Mexico","2024-12-31",0,0,122,0,0,122,0,0
"Mexico","2025-01-01",0,0,122,0,0,122,0,0
"Mexico","2025-01-02",0,0,122,0,0,122,0,0
"Mexico","2025-01-03",0,0,122,0,0,122,0,0
"Mexico","2025-01-04",0,0,122,0,0,122,0,0
"Mexico","2025-01-05",0,0,122,0,0,122,0,0
"Mexico","2025-01-06",0,0,122,0,0,122,0,0
"Mexico","2025-01-07",0,0,122,0,0,122,0,0
"Mexico","2025-01-08",0,0,122,0,0,122,0,0
"Mexico","2025-01-09",0,0,122,0,0,122,0,0
"Mexico","2025-01-10",0,0,122,0,0,122,0,0
"Mexico","2025-01-11",0,0,122,0,0,122,0,0
"Mexico","2025-01-12",0,0,122,0,0,122,0,0
"Mexico","2025-01-13",0,0,122,0,0,122,0,0
"Mexico","2025-01-14",0,0,122,0,0,122,0,0
"Mexico","2025-01-15",0,0,122,0,0,122,0,0
"Mexico","2025-01-16",0,0,122,0,0,122,0,0
"Mexico","2025-01-17",0,0,122,0,0,122,0,0
"Mexico","2025-01-18",0,0,122,0,0,122,0,0
"Mexico","2025-01-19",0,0,122,0,0,122,0,0
"Mexico","2025-01-20",0,0,122,0,0,122,0,0
"Mexico","2025-01-21",0,0,122,0,0,122,0,0
"Mexico","2025-01-22",0,0,122,0,0,122,0,0
"Mexico","2025-01-23",0,0,122,0,0,122,0,0
"Mexico","2025-01-24",0,0,122,0,0,122,0,0
"Mexico","2025-01-25",0,0,122,0,0,122,0,0
"Mexico","2025-01-26",0,0,122,0,0,122,0,0
"Mexico","2025-01-27",0,0,122,0,0,122,0,0
"Mexico","2025-01-28",0,0,122,0,0,122,0,0
"Mexico","2025-01-29",0,0,122,0,0,122,0,0
"Mexico","2025-01-30",0,0,122,0,0,122,0,0
"Mexico","2025-01-31",0,0,122,0,0,122,0,0
"Mexico","2025-02-01",0,0,122,0,0,122,0,0
"Mexico","2025-02-02",0,0,122,0,0,122,0,0
"Mexico","2025-02-03",0,0,122,0,0,122,0,0
"Republic of Moldova","2024-01-01",0,0,0,0,0,0,0,0
"Republic of Moldova","2024-01-02",0,0,0,0,0,0,0,0
"Republic of Moldova","2024-01-03",0,0,0,0,0,0,0,0
"Republic of Moldova","2024-01-04",0,0,0,0,0,0,0,0
"Republic of Moldova","2024-01-05",0,0,0,0,0,0,0,0
"Republic of Moldova","2024-01-06",0,0,0,0,0,0,0,0
"Republic of Moldova","2024-01-07",0,0,0,0,0,0,0,0
"Republic of Moldova","2024-01-08",0,0,0,0,0,0,0,0
"Republic of Moldova","2024-01-09",0,0,0,0,0,0,0,0
"Republic of Moldova","2024-01-10",0,0,0,0,0,0,0,0
"Republic of Moldova","2024-01-11",0,0,0,0,0,0,0,0
"Republic of Moldova","2024-01-12",0,0,0,0,0,0,0,0
"Republic of Moldova","2024-01-13",0,0,0,0,0,0,0,0
"Republic of Moldova","2024-01-14",0,0,0,0,0,0,0,0
"Republic of Moldova","2024-01-15",0,0,0,0,0,0,0,0
"Republic of Moldova","2024-01-16",0,0,0,0,0,0,0,0
"Republic of Moldova","2024-01-17",0,0,0,0,0,0,0,0
"Republic of Moldova","2024-01-18",0,0,0,0,0,0,0,0
"Republic of Moldova","2024-01-19",0,0,0,0,0,0,0,0
"Republic of Moldova","2024-01-20",0,0,0,0,0,0,0,0
"Republic of Moldova","2024-01-21",0,0,0,0,0,0,0,0
"Republic of Moldova","2024-01-22",0,0,0,0,0,0,0,0
"Republic of Moldova","2024-01-23",0,0,0,0,0,0,0,0
"Republic of Moldova","2024-01-24",0,0,0,0,0,0,0,0
"Republic of Moldova","2024-01-25",0,0,0,0,0,0,0,0
"Republic of Moldova","2024-01-26",0,0,0,0,0,0,0,0
"Republic of Moldova","2024-01-27",0,0,0,0,0,0,0,0
"Republic of Moldova","2024-01-28",0,0,0,0,0,0,0,0
"Republic of Moldova","2024-01-29",0,0,0,0,0,0,0,0
"Republic of Moldova","2024-01-30",0,0,0,0,0,0,0,0
"Republic of Moldova","2024-01-31",0,0,0,0,0,0,0,0
"Republic of Moldova","2024-02-01",0,0,0,0,0,0,0,0
"Republic of Moldova","2024-02-02",0,0,0,0,0,0,0,0
"Republic of Moldova","2024-02-03",0,0,0,0,0,0,0,0
"Republic of Moldova","2024-02-04",0,0,0,0,0,0,0,0
"Republic of Moldova","2024-02-05",0,0,0,0,0,0,0,0
"Republic of Moldova","2024-02-06",0,0,0,0,0,0,0,0
"Republic of Moldova","2024-02-07",0,0,0,0,0,0,0,0
"Republic of Moldova","2024-02-08",0,0,0,0,0,0,0,0
"Republic of Moldova","2024-02-09",0,0,0,0,0,0,0,0
"Republic of Moldova","2024-02-10",0,0,0,0,0,0,0,0
"Republic of Moldova","2024-02-11",0,0,0,0,0,0,0,0
"Republic of Moldova","2024-02-12",0,0,0,0,0,0,0,0
"Republic of Moldova","2024-02-13",0,0,0,0,0,0,0,0
"Republic of Moldova","2024-02-14",0,0,0,0,0,0,0,0
"Republic of Moldova","2024-02-15",0,0,0,0,0,0,0,0
"Republic of Moldova","2024-02-16",0,0,0,0,0,0,0,0
"Republic of Moldova","2024-02-17",0,0,0,0,0,0,0,0
"Republic of Moldova","2024-02-18",0,0,0,0,0,0,0,0
"Republic of Moldova","2024-02-19",0,0,0,0,0,0,0,0
"Republic of Moldova","2024-02-20",0,0,0,0,0,0,0,0
"Republic of Moldova","2024-02-21",0,0,0,0,0,0,0,0
"Republic of Moldova","2024-02-22",0,0,0,0,0,0,0,0
"Republic of Moldova","2024-02-23",0,0,0,0,0,0,0,0
"Republic of Moldova","2024-02-24",0,0,0,0,0,0,0,0
"Republic of Moldova","2024-02-25",0,0,0,0,0,0,0,0
"Republic of Moldova","2024-02-26",0,0,0,0,0,0,0,0
"Republic of Moldova","2024-02-27",0,0,0,0,0,0,0,0
"Republic of Moldova","2024-02-28",0,0,0,0,0,0,0,0
"Republic of Moldova","2024-02-29",0,0,0,0,0,0,0,0
"Republic of Moldova","2024-03-01",0,0,0,0,0,0,0,0
"Republic of Moldova","2024-03-02",0,0,0,0,0,0,0,0
"Republic of Moldova","2024-03-03",0,0,0,0,0,0,0,0
"Republic of Moldova","2024-03-04",0,0,0,0,0,0,0,0
"Republic of Moldova","2024-03-05",0,0,0,0,0,0,0,0
"Republic of Moldova","2024-03-06",0,0,0,0,0,0,0,0
"Republic of Moldova","2024-03-07",0,0,0,0,0,0,0,0
"Republic of Moldova","2024-03-08",0,0,0,0,0,0,0,0
"Republic of Moldova","2024-03-09",0,0,0,0,0,0,0,0
"Republic of Moldova","2024-03-10",0,0,0,0,0,0,0,0
"Republic of Moldova","2024-03-11",0,0,0,0,0,0,0,0
"Republic of Moldova","2024-03-12",0,0,0,0,0,0,0,0
"Republic of Moldova","2024-03-13",0,0,0,0,0,0,0,0
"Republic of Moldova","2024-03-14",0,0,0,0,0,0,0,0
"Republic of Moldova","2024-03-15",0,0,0,0,0,0,0,0
"Republic of Moldova","2024-03-16",0,0,0,0,0,0,0,0
"Republic of Moldova","2024-03-17",0,0,0,0,0,0,0,0
"Republic of Moldova","2024-03-18",0,0,0,0,0,0,0,0
"Republic of Moldova","2024-03-19",0,0,0,0,0,0,0,0
"Republic of Moldova","2024-03-20",0,0,0,0,0,0,0,0
"Republic of Moldova","2024-03-21",0,0,0,0,0,0,0,0
"Republic of Moldova","2024-03-22",0,0,0,0,0,0,0,0
"Republic of Moldova","2024-03-23",0,0,0,0,0,0,0,0
"Republic of Moldova","2024-03-24",0,0,0,0,0,0,0,0
"Republic of Moldova","2024-03-25",0,0,0,0,0,0,0,0
"Republic of Moldova","2024-03-26",0,0,0,0,0,0,0,0
"Republic of Moldova","2024-03-27",0,0,0,0,0,0,0,0
"Republic of Moldova","2024-03-28",0,0,0,0,0,0,0,0
"Republic of Moldova","2024-03-29",0,0,0,0,0,0,0,0
"Republic of Moldova","2024-03-30",0,0,0,0,0,0,0,0
"Republic of Moldova","2024-03-31",0,0,0,0,0,0,0,0
"Republic of Moldova","2024-04-01",0,0,0,0,0,0,0,0
"Republic of Moldova","2024-04-02",0,0,0,0,0,0,0,0
"Republic of Moldova","2024-04-03",0,0,0,0,0,0,0,0
"Republic of Moldova","2024-04-04",0,0,0,0,0,0,0,0
"Republic of Moldova","2024-04-05",0,0,0,0,0,0,0,0
"Republic of Moldova","2024-04-06",0,0,0,0,0,0,0,0
"Republic of Moldova","2024-04-07",0,0,0,0,0,0,0,0
"Republic of Moldova","2024-04-08",0,0,0,0,0,0,0,0
"Republic of Moldova","2024-04-09",0,0,0,0,0,0,0,0
"Republic of Moldova","2024-04-10",0,0,0,0,0,0,0,0
"Republic of Moldova","2024-04-11",0,0,0,0,0,0,0,0
"Republic of Moldova","2024-04-12",0,0,0,0,0,0,0,0
"Republic of Moldova","2024-04-13",0,0,0,0,0,0,0,0
"Republic of Moldova","2024-04-14",0,0,0,0,0,0,0,0
"Republic of Moldova","2024-04-15",0,0,0,0,0,0,0,0
"Republic of Moldova","2024-04-16",0,0,0,0,0,0,0,0
"Republic of Moldova","2024-04-17",0,0,0,0,0,0,0,0
"Republic of Moldova","2024-04-18",0,0,0,0,0,0,0,0
"Republic of Moldova","2024-04-19",0,0,0,0,0,0,0,0
"Republic of Moldova","2024-04-20",0,0,0,0,0,0,0,0
"Republic of Moldova","2024-04-21",0,0,0,0,0,0,0,0
"Republic of Moldova","2024-04-22",0,0,0,0,0,0,0,0
"Republic of Moldova","2024-04-23",0,0,0,0,0,0,0,0
"Republic of Moldova","2024-04-24",0,0,0,0,0,0,0,0
"Republic of Moldova","2024-04-25",0,0,0,0,0,0,0,0
"Republic of Moldova","2024-04-26",0,0,0,0,0,0,0,0
"Republic of Moldova","2024-04-27",0,0,0,0,0,0,0,0
"Republic of Moldova","2024-04-28",0,0,0,0,0,0,0,0
"Republic of Moldova","2024-04-29",0,0,0,0,0,0,0,0
"Republic of Moldova","2024-04-30",0,0,0,0,0,0,0,0
"Republic of Moldova","2024-05-01",0,0,0,0,0,0,0,0
"Republic of Moldova","2024-05-02",0,0,0,0,0,0,0,0
"Republic of Moldova","2024-05-03",0,0,0,0,0,0,0,0
"Republic of Moldova","2024-05-04",0,0,0,0,0,0,0,0
"Republic of Moldova","2024-05-05",0,0,0,0,0,0,0,0
"Republic of Moldova","2024-05-06",0,0,0,0,0,0,0,0
"Republic of Moldova","2024-05-07",0,0,0,0,0,0,0,0
"Republic of Moldova","2024-05-08",0,0,0,0,0,0,0,0
"Republic of Moldova","2024-05-09",0,0,0,0,0,0,0,0
"Republic of Moldova","2024-05-10",0,0,0,0,0,0,0,0
"Republic of Moldova","2024-05-11",0,0,0,0,0,0,0,0
"Republic of Moldova","2024-05-12",0,0,0,0,0,0,0,0
"Republic of Moldova","2024-05-13",0,0,0,0,0,0,0,0
"Republic of Moldova","2024-05-14",0,0,0,0,0,0,0,0
"Republic of Moldova","2024-05-15",0,0,0,0,0,0,0,0
"Republic of Moldova","2024-05-16",0,0,0,0,0,0,0,0
"Republic of Moldova","2024-05-17",0,0,0,0,0,0,0,0
"Republic of Moldova","2024-05-18",0,0,0,0,0,0,0,0
"Republic of Moldova","2024-05-19",0,0,0,0,0,0,0,0
"Republic of Moldova","2024-05-20",0,0,0,0,0,0,0,0
"Republic of Moldova","2024-05-21",0,0,0,0,0,0,0,0
"Republic of Moldova","2024-05-22",0,0,0,0,0,0,0,0
"Republic of Moldova","2024-05-23",0,0,0,0,0,0,0,0
"Republic of Moldova","2024-05-24",0,0,0,0,0,0,0,0
"Republic of Moldova","2024-05-25",0,0,0,0,0,0,0,0
"Republic of Moldova","2024-05-26",0,0,0,0,0,0,0,0
"Republic of Moldova","2024-05-27",0,0,0,0,0,0,0,0
"Republic of Moldova","2024-05-28",0,0,0,0,0,0,0,0
"Republic of Moldova","2024-05-29",0,0,0,0,0,0,0,0
"Republic of Moldova","2024-05-30",0,0,0,0,0,0,0,0
"Republic of Moldova","2024-05-31",0,0,0,0,0,0,0,0
"Republic of Moldova","2024-06-01",0,0,0,0,0,0,0,0
"Republic of Moldova","2024-06-02",0,0,0,0,0,0,0,0
"Republic of Moldova","2024-06-03",0,0,0,0,0,0,0,0
"Republic of Moldova","2024-06-04",0,0,0,0,0,0,0,0
"Republic of Moldova","2024-06-05",0,0,0,0,0,0,0,0
"Republic of Moldova","2024-06-06",0,0,0,0,0,0,0,0
"Republic of Moldova","2024-06-07",0,0,0,0,0,0,0,0
"Republic of Moldova","2024-06-08",0,0,0,0,0,0,0,0
"Republic of Moldova","2024-06-09",0,0,0,0,0,0,0,0
"Republic of Moldova","2024-06-10",0,0,0,0,0,0,0,0
"Republic of Moldova","2024-06-11",0,0,0,0,0,0,0,0
"Republic of Moldova","2024-06-12",0,0,0,0,0,0,0,0
"Republic of Moldova","2024-06-13",0,0,0,0,0,0,0,0
"Republic of Moldova","2024-06-14",0,0,0,0,0,0,0,0
"Republic of Moldova","2024-06-15",0,0,0,0,0,0,0,0
"Republic of Moldova","2024-06-16",0,0,0,0,0,0,0,0
"Republic of Moldova","2024-06-17",0,0,0,0,0,0,0,0
"Republic of Moldova","2024-06-18",0,0,0,0,0,0,0,0
"Republic of Moldova","2024-06-19",0,0,0,0,0,0,0,0
"Republic of Moldova","2024-06-20",0,0,0,0,0,0,0,0
"Republic of Moldova","2024-06-21",0,0,0,0,0,0,0,0
"Republic of Moldova","2024-06-22",0,0,0,0,0,0,0,0
"Republic of Moldova","2024-06-23",0,0,0,0,0,0,0,0
"Republic of Moldova","2024-06-24",0,0,0,0,0,0,0,0
"Republic of Moldova","2024-06-25",0,0,0,0,0,0,0,0
"Republic of Moldova","2024-06-26",0,0,0,0,0,0,0,0
"Republic of Moldova","2024-06-27",0,0,0,0,0,0,0,0
"Republic of Moldova","2024-06-28",0,0,0,0,0,0,0,0
"Republic of Moldova","2024-06-29",0,0,0,0,0,0,0,0
"Republic of Moldova","2024-06-30",0,0,0,0,0,0,0,0
"Republic of Moldova","2024-07-01",0,0,0,0,0,0,0,0
"Republic of Moldova","2024-07-02",0,0,0,0,0,0,0,0
"Republic of Moldova","2024-07-03",0,0,0,0,0,0,0,0
"Republic of Moldova","2024-07-04",0,0,0,0,0,0,0,0
"Republic of Moldova","2024-07-05",0,0,0,0,0,0,0,0
"Republic of Moldova","2024-07-06",0,0,0,0,0,0,0,0
"Republic of Moldova","2024-07-07",0,0,0,0,0,0,0,0
"Republic of Moldova","2024-07-08",0,0,0,0,0,0,0,0
"Republic of Moldova","2024-07-09",0,0,0,0,0,0,0,0
"Republic of Moldova","2024-07-10",0,0,0,0,0,0,0,0
"Republic of Moldova","2024-07-11",0,0,0,0,0,0,0,0
"Republic of Moldova","2024-07-12",0,0,0,0,0,0,0,0
"Republic of Moldova","2024-07-13",0,0,0,0,0,0,0,0
"Republic of Moldova","2024-07-14",0,0,0,0,0,0,0,0
"Republic of Moldova","2024-07-15",0,0,0,0,0,0,0,0
"Republic of Moldova","2024-07-16",0,0,0,0,0,0,0,0
"Republic of Moldova","2024-07-17",0,0,0,0,0,0,0,0
"Republic of Moldova","2024-07-18",0,0,0,0,0,0,0,0
"Republic of Moldova","2024-07-19",0,0,0,0,0,0,0,0
"Republic of Moldova","2024-07-20",0,0,0,0,0,0,0,0
"Republic of Moldova","2024-07-21",0,0,0,0,0,0,0,0
"Republic of Moldova","2024-07-22",0,0,0,0,0,0,0,0
"Republic of Moldova","2024-07-23",0,0,0,0,0,0,0,0
"Republic of Moldova","2024-07-24",0,0,0,0,0,0,0,0
"Republic of Moldova","2024-07-25",0,0,0,0,0,0,0,0
"Republic of Moldova","2024-07-26",0,0,0,0,0,0,0,0
"Republic of Moldova","2024-07-27",0,0,0,0,0,0,0,0
"Republic of Moldova","2024-07-28",0,0,0,0,0,0,0,0
"Republic of Moldova","2024-07-29",0,0,0,0,0,0,0,0
"Republic of Moldova","2024-07-30",0,0,0,0,0,0,0,0
"Republic of Moldova","2024-07-31",0,0,0,0,0,0,0,0
"Republic of Moldova","2024-08-01",0,0,0,0,0,0,0,0
"Republic of Moldova","2024-08-02",0,0,0,0,0,0,0,0
"Republic of Moldova","2024-08-03",0,0,0,0,0,0,0,0
"Republic of Moldova","2024-08-04",0,0,0,0,0,0,0,0
"Republic of Moldova","2024-08-05",0,0,0,0,0,0,0,0
"Republic of Moldova","2024-08-06",0,0,0,0,0,0,0,0
"Republic of Moldova","2024-08-07",0,0,0,0,0,0,0,0
"Republic of Moldova","2024-08-08",0,0,0,0,0,0,0,0
"Republic of Moldova","2024-08-09",0,0,0,0,0,0,0,0
"Republic of Moldova","2024-08-10",0,0,0,0,0,0,0,0
"Republic of Moldova","2024-08-11",0,0,0,0,0,0,0,0
"Republic of Moldova","2024-08-12",0,0,0,0,0,0,0,0
"Republic of Moldova","2024-08-13",0,0,0,0,0,0,0,0
"Republic of Moldova","2024-08-14",0,0,0,0,0,0,0,0
"Republic of Moldova","2024-08-15",0,0,0,0,0,0,0,0
"Republic of Moldova","2024-08-16",0,0,0,0,0,0,0,0
"Republic of Moldova","2024-08-17",0,0,0,0,0,0,0,0
"Republic of Moldova","2024-08-18",0,0,0,0,0,0,0,0
"Republic of Moldova","2024-08-19",0,0,0,0,0,0,0,0
"Republic of Moldova","2024-08-20",0,0,0,0,0,0,0,0
"Republic of Moldova","2024-08-21",0,0,0,0,0,0,0,0
"Republic of Moldova","2024-08-22",0,0,0,0,0,0,0,0
"Republic of Moldova","2024-08-23",0,0,0,0,0,0,0,0
"Republic of Moldova","2024-08-24",0,0,0,0,0,0,0,0
"Republic of Moldova","2024-08-25",0,0,0,0,0,0,0,0
"Republic of Moldova","2024-08-26",0,0,0,0,0,0,0,0
"Republic of Moldova","2024-08-27",0,0,0,0,0,0,0,0
"Republic of Moldova","2024-08-28",0,0,0,0,0,0,0,0
"Republic of Moldova","2024-08-29",0,0,0,0,0,0,0,0
"Republic of Moldova","2024-08-30",0,0,0,0,0,0,0,0
"Republic of Moldova","2024-08-31",0,0,0,0,0,0,0,0
"Republic of Moldova","2024-09-01",0,0,0,0,0,0,0,0
"Republic of Moldova","2024-09-02",0,0,0,0,0,0,0,0
"Republic of Moldova","2024-09-03",0,0,0,0,0,0,0,0
"Republic of Moldova","2024-09-04",0,0,0,0,0,0,0,0
"Republic of Moldova","2024-09-05",0,0,0,0,0,0,0,0
"Republic of Moldova","2024-09-06",0,0,0,0,0,0,0,0
"Republic of Moldova","2024-09-07",0,0,0,0,0,0,0,0
"Republic of Moldova","2024-09-08",0,0,0,0,0,0,0,0
"Republic of Moldova","2024-09-09",0,0,0,0,0,0,0,0
"Republic of Moldova","2024-09-10",0,0,0,0,0,0,0,0
"Republic of Moldova","2024-09-11",0,0,0,0,0,0,0,0
"Republic of Moldova","2024-09-12",0,0,0,0,0,0,0,0
"Republic of Moldova","2024-09-13",0,0,0,0,0,0,0,0
"Republic of Moldova","2024-09-14",0,0,0,0,0,0,0,0
"Republic of Moldova","2024-09-15",0,0,0,0,0,0,0,0
"Republic of Moldova","2024-09-16",0,0,0,0,0,0,0,0
"Republic of Moldova","2024-09-17",0,0,0,0,0,0,0,0
"Republic of Moldova","2024-09-18",0,0,0,0,0,0,0,0
"Republic of Moldova","2024-09-19",0,0,0,0,0,0,0,0
"Republic of Moldova","2024-09-20",0,0,0,0,0,0,0,0
"Republic of Moldova","2024-09-21",0,0,0,0,0,0,0,0
"Republic of Moldova","2024-09-22",0,0,0,0,0,0,0,0
"Republic of Moldova","2024-09-23",0,0,0,0,0,0,0,0
"Republic of Moldova","2024-09-24",0,0,0,0,0,0,0,0
"Republic of Moldova","2024-09-25",0,0,0,0,0,0,0,0
"Republic of Moldova","2024-09-26",0,0,0,0,0,0,0,0
"Republic of Moldova","2024-09-27",0,0,0,0,0,0,0,0
"Republic of Moldova","2024-09-28",0,0,0,0,0,0,0,0
"Republic of Moldova","2024-09-29",0,0,0,0,0,0,0,0
"Republic of Moldova","2024-09-30",0,0,0,0,0,0,0,0
"Republic of Moldova","2024-10-01",0,0,0,0,0,0,0,0
"Republic of Moldova","2024-10-02",0,0,0,0,0,0,0,0
"Republic of Moldova","2024-10-03",0,0,0,0,0,0,0,0
"Republic of Moldova","2024-10-04",0,0,0,0,0,0,0,0
"Republic of Moldova","2024-10-05",0,0,0,0,0,0,0,0
"Republic of Moldova","2024-10-06",0,0,0,0,0,0,0,0
"Republic of Moldova","2024-10-07",0,0,0,0,0,0,0,0
"Republic of Moldova","2024-10-08",0,0,0,0,0,0,0,0
"Republic of Moldova","2024-10-09",0,0,0,0,0,0,0,0
"Republic of Moldova","2024-10-10",0,0,0,0,0,0,0,0
"Republic of Moldova","2024-10-11",0,0,0,0,0,0,0,0
"Republic of Moldova","2024-10-12",0,0,0,0,0,0,0,0
"Republic of Moldova","2024-10-13",0,0,0,0,0,0,0,0
"Republic of Moldova","2024-10-14",0,0,0,0,0,0,0,0
"Republic of Moldova","2024-10-15",0,0,0,0,0,0,0,0
"Republic of Moldova","2024-10-16",0,0,0,0,0,0,0,0
"Republic of Moldova","2024-10-17",0,0,0,0,0,0,0,0
"Republic of Moldova","2024-10-18",0,0,0,0,0,0,0,0
"Republic of Moldova","2024-10-19",0,0,0,0,0,0,0,0
"Republic of Moldova","2024-10-20",0,0,0,0,0,0,0,0
"Republic of Moldova","2024-10-21",0,0,0,0,0,0,0,0
"Republic of Moldova","2024-10-22",0,0,0,0,0,0,0,0
"Republic of Moldova","2024-10-23",0,0,0,0,0,0,0,0
"Republic of Moldova","2024-10-24",0,0,0,0,0,0,0,0
"Republic of Moldova","2024-10-25",0,0,0,0,0,0,0,0
"Republic of Moldova","2024-10-26",0,0,0,0,0,0,0,0
"Republic of Moldova","2024-10-27",0,0,0,0,0,0,0,0
"Republic of Moldova","2024-10-28",0,0,0,0,0,0,0,0
"Republic of Moldova","2024-10-29",0,0,0,0,0,0,0,0
"Republic of Moldova","2024-10-30",0,0,0,0,0,0,0,0
"Republic of Moldova","2024-10-31",0,0,0,0,0,0,0,0
"Republic of Moldova","2024-11-01",0,0,0,0,0,0,0,0
"Republic of Moldova","2024-11-02",0,0,0,0,0,0,0,0
"Republic of Moldova","2024-11-03",0,0,0,0,0,0,0,0
"Republic of Moldova","2024-11-04",0,0,0,0,0,0,0,0
"Republic of Moldova","2024-11-05",0,0,0,0,0,0,0,0
"Republic of Moldova","2024-11-06",0,0,0,0,0,0,0,0
"Republic of Moldova","2024-11-07",0,0,0,0,0,0,0,0
"Republic of Moldova","2024-11-08",0,0,0,0,0,0,0,0
"Republic of Moldova","2024-11-09",0,0,0,0,0,0,0,0
"Republic of Moldova","2024-11-10",0,0,0,0,0,0,0,0
"Republic of Moldova","2024-11-11",0,0,0,0,0,0,0,0
"Republic of Moldova","2024-11-12",0,0,0,0,0,0,0,0
"Republic of Moldova","2024-11-13",0,0,0,0,0,0,0,0
"Republic of Moldova","2024-11-14",0,0,0,0,0,0,0,0
"Republic of Moldova","2024-11-15",0,0,0,0,0,0,0,0
"Republic of Moldova","2024-11-16",0,0,0,0,0,0,0,0
"Republic of Moldova","2024-11-17",0,0,0,0,0,0,0,0
"Republic of Moldova","2024-11-18",0,0,0,0,0,0,0,0
"Republic of Moldova","2024-11-19",0,0,0,0,0,0,0,0
"Republic of Moldova","2024-11-20",0,0,0,0,0,0,0,0
"Republic of Moldova","2024-11-21",0,0,0,0,0,0,0,0
"Republic of Moldova","2024-11-22",0,0,0,0,0,0,0,0
"Republic of Moldova","2024-11-23",0,0,0,0,0,0,0,0
"Republic of Moldova","2024-11-24",0,0,0,0,0,0,0,0
"Republic of Moldova","2024-11-25",0,0,0,0,0,0,0,0
"Republic of Moldova","2024-11-26",0,0,0,0,0,0,0,0
"Republic of Moldova","2024-11-27",0,0,0,0,0,0,0,0
"Republic of Moldova","2024-11-28",0,0,0,0,0,0,0,0
"Republic of Moldova","2024-11-29",0,0,0,0,0,0,0,0
"Republic of Moldova","2024-11-30",0,0,0,0,0,0,0,0
"Republic of Moldova","2024-12-01",0,0,0,0,0,0,0,0
"Republic of Moldova","2024-12-02",0,0,0,0,0,0,0,0
"Republic of Moldova","2024-12-03",0,0,0,0,0,0,0,0
"Republic of Moldova","2024-12-04",0,0,0,0,0,0,0,0
"Republic of Moldova","2024-12-05",0,0,0,0,0,0,0,0
"Republic of Moldova","2024-12-06",0,0,0,0,0,0,0,0
"Republic of Moldova","2024-12-07",0,0,0,0,0,0,0,0
"Republic of Moldova","2024-12-08",0,0,0,0,0,0,0,0
"Republic of Moldova","2024-12-09",0,0,0,0,0,0,0,0
"Republic of Moldova","2024-12-10",0,0,0,0,0,0,0,0
"Republic of Moldova","2024-12-11",0,0,0,0,0,0,0,0
"Republic of Moldova","2024-12-12",0,0,0,0,0,0,0,0
"Republic of Moldova","2024-12-13",0,0,0,0,0,0,0,0
"Republic of Moldova","2024-12-14",0,0,0,0,0,0,0,0
"Republic of Moldova","2024-12-15",0,0,0,0,0,0,0,0
"Republic of Moldova","2024-12-16",0,0,0,0,0,0,0,0
"Republic of Moldova","2024-12-17",0,0,0,0,0,0,0,0
"Republic of Moldova","2024-12-18",0,0,0,0,0,0,0,0
"Republic of Moldova","2024-12-19",0,0,0,0,0,0,0,0
"Republic of Moldova","2024-12-20",0,0,0,0,0,0,0,0
"Republic of Moldova","2024-12-21",0,0,0,0,0,0,0,0
"Republic of Moldova","2024-12-22",0,0,0,0,0,0,0,0
"Republic of Moldova","2024-12-23",0,0,0,0,0,0,0,0
"Republic of Moldova","2024-12-24",0,0,0,0,0,0,0,0
"Republic of Moldova","2024-12-25",0,0,0,0,0,0,0,0
"Republic of Moldova","2024-12-26",0,0,0,0,0,0,0,0
"Republic of Moldova","2024-12-27",0,0,0,0,0,0,0,0
"Republic of Moldova","2024-12-28",0,0,0,0,0,0,0,0
"Republic of Moldova","2024-12-29",0,0,0,0,0,0,0,0
"Republic of Moldova","2024-12-30",0,0,0,0,0,0,0,0
"Republic of Moldova","2024-12-31",0,0,0,0,0,0,0,0
"Republic of Moldova","2025-01-01",0,0,0,0,0,0,0,0
"Republic of Moldova","2025-01-02",0,0,0,0,0,0,0,0
"Republic of Moldova","2025-01-03",0,0,0,0,0,0,0,0
"Republic of Moldova","2025-01-04",0,0,0,0,0,0,0,0
"Republic of Moldova","2025-01-05",0,0,0,0,0,0,0,0
"Republic of Moldova","2025-01-06",0,0,0,0,0,0,0,0
"Republic of Moldova","2025-01-07",0,0,0,0,0,0,0,0
"Republic of Moldova","2025-01-08",0,0,0,0,0,0,0,0
"Republic of Moldova","2025-01-09",0,0,0,0,0,0,0,0
"Republic of Moldova","2025-01-10",0,0,0,0,0,0,0,0
"Republic of Moldova","2025-01-11",0,0,0,0,0,0,0,0
"Republic of Moldova","2025-01-12",0,0,0,0,0,0,0,0
"Republic of Moldova","2025-01-13",0,0,0,0,0,0,0,0
"Republic of Moldova","2025-01-14",0,0,0,0,0,0,0,0
"Republic of Moldova","2025-01-15",0,0,0,0,0,0,0,0
"Republic of Moldova","2025-01-16",0,0,0,0,0,0,0,0
"Republic of Moldova","2025-01-17",0,0,0,0,0,0,0,0
"Republic of Moldova","2025-01-18",0,0,0,0,0,0,0,0
"Republic of Moldova","2025-01-19",0,0,0,0,0,0,0,0
"Republic of Moldova","2025-01-20",0,0,0,0,0,0,0,0
"Republic of Moldova","2025-01-21",0,0,0,0,0,0,0,0
"Republic of Moldova","2025-01-22",0,0,0,0,0,0,0,0
"Republic of Moldova","2025-01-23",0,0,0,0,0,0,0,0
"Republic of Moldova","2025-01-24",0,0,0,0,0,0,0,0
"Republic of Moldova","2025-01-25",0,0,0,0,0,0,0,0
"Republic of Moldova","2025-01-26",0,0,0,0,0,0,0,0
"Republic of Moldova","2025-01-27",0,0,0,0,0,0,0,0
"Republic of Moldova","2025-01-28",0,0,0,0,0,0,0,0
"Republic of Moldova","2025-01-29",0,0,0,0,0,0,0,0
"Republic of Moldova","2025-01-30",0,0,0,0,0,0,0,0
"Republic of Moldova","2025-01-31",0,0,0,0,0,0,0,0
"Republic of Moldova","2025-02-01",0,0,0,0,0,0,0,0
"Republic of Moldova","2025-02-02",0,0,0,0,0,0,0,0
"Republic of Moldova","2025-02-03",0,0,0,0,0,0,0,0
"Monaco","2024-01-01",0,0,0,0,0,0,0,0
"Monaco","2024-01-02",0,0,0,0,0,0,0,0
"Monaco","2024-01-03",0,0,0,0,0,0,0,0
"Monaco","2024-01-04",0,0,0,0,0,0,0,0
"Monaco","2024-01-05",0,0,0,0,0,0,0,0
"Monaco","2024-01-06",0,0,0,0,0,0,0,0
"Monaco","2024-01-07",0,0,0,0,0,0,0,0
"Monaco","2024-01-08",0,0,0,0,0,0,0,0
"Monaco","2024-01-09",0,0,0,0,0,0,0,0
"Monaco","2024-01-10",0,0,0,0,0,0,0,0
"Monaco","2024-01-11",0,0,0,0,0,0,0,0
"Monaco","2024-01-12",0,0,0,0,0,0,0,0
"Monaco","2024-01-13",0,0,0,0,0,0,0,0
"Monaco","2024-01-14",0,0,0,0,0,0,0,0
"Monaco","2024-01-15",0,0,0,0,0,0,0,0
"Monaco","2024-01-16",0,0,0,0,0,0,0,0
"Monaco","2024-01-17",0,0,0,0,0,0,0,0
"Monaco","2024-01-18",0,0,0,0,0,0,0,0
"Monaco","2024-01-19",0,0,0,0,0,0,0,0
"Monaco","2024-01-20",0,0,0,0,0,0,0,0
"Monaco","2024-01-21",0,0,0,0,0,0,0,0
"Monaco","2024-01-22",0,0,0,0,0,0,0,0
"Monaco","2024-01-23",0,0,0,0,0,0,0,0
"Monaco","2024-01-24",0,0,0,0,0,0,0,0
"Monaco","2024-01-25",0,0,0,0,0,0,0,0
"Monaco","2024-01-26",0,0,0,0,0,0,0,0
"Monaco","2024-01-27",0,0,0,0,0,0,0,0
"Monaco","2024-01-28",0,0,0,0,0,0,0,0
"Monaco","2024-01-29",0,0,0,0,0,0,0,0
"Monaco","2024-01-30",0,0,0,0,0,0,0,0
"Monaco","2024-01-31",0,0,0,0,0,0,0,0
"Monaco","2024-02-01",0,0,0,0,0,0,0,0
"Monaco","2024-02-02",0,0,0,0,0,0,0,0
"Monaco","2024-02-03",0,0,0,0,0,0,0,0
"Monaco","2024-02-04",0,0,0,0,0,0,0,0
"Monaco","2024-02-05",0,0,0,0,0,0,0,0
"Monaco","2024-02-06",0,0,0,0,0,0,0,0
"Monaco","2024-02-07",0,0,0,0,0,0,0,0
"Monaco","2024-02-08",0,0,0,0,0,0,0,0
"Monaco","2024-02-09",0,0,0,0,0,0,0,0
"Monaco","2024-02-10",0,0,0,0,0,0,0,0
"Monaco","2024-02-11",0,0,0,0,0,0,0,0
"Monaco","2024-02-12",0,0,0,0,0,0,0,0
"Monaco","2024-02-13",0,0,0,0,0,0,0,0
"Monaco","2024-02-14",0,0,0,0,0,0,0,0
"Monaco","2024-02-15",0,0,0,0,0,0,0,0
"Monaco","2024-02-16",0,0,0,0,0,0,0,0
"Monaco","2024-02-17",0,0,0,0,0,0,0,0
"Monaco","2024-02-18",0,0,0,0,0,0,0,0
"Monaco","2024-02-19",0,0,0,0,0,0,0,0
"Monaco","2024-02-20",0,0,0,0,0,0,0,0
"Monaco","2024-02-21",0,0,0,0,0,0,0,0
"Monaco","2024-02-22",0,0,0,0,0,0,0,0
"Monaco","2024-02-23",0,0,0,0,0,0,0,0
"Monaco","2024-02-24",0,0,0,0,0,0,0,0
"Monaco","2024-02-25",0,0,0,0,0,0,0,0
"Monaco","2024-02-26",0,0,0,0,0,0,0,0
"Monaco","2024-02-27",0,0,0,0,0,0,0,0
"Monaco","2024-02-28",0,0,0,0,0,0,0,0
"Monaco","2024-02-29",0,0,0,0,0,0,0,0
"Monaco","2024-03-01",0,0,0,0,0,0,0,0
"Monaco","2024-03-02",0,0,0,0,0,0,0,0
"Monaco","2024-03-03",0,0,0,0,0,0,0,0
"Monaco","2024-03-04",0,0,0,0,0,0,0,0
"Monaco","2024-03-05",0,0,0,0,0,0,0,0
"Monaco","2024-03-06",0,0,0,0,0,0,0,0
"Monaco","2024-03-07",0,0,0,0,0,0,0,0
"Monaco","2024-03-08",0,0,0,0,0,0,0,0
"Monaco","2024-03-09",0,0,0,0,0,0,0,0
"Monaco","2024-03-10",0,0,0,0,0,0,0,0
"Monaco","2024-03-11",0,0,0,0,0,0,0,0
"Monaco","2024-03-12",0,0,0,0,0,0,0,0
"Monaco","2024-03-13",0,0,0,0,0,0,0,0
"Monaco","2024-03-14",0,0,0,0,0,0,0,0
"Monaco","2024-03-15",0,0,0,0,0,0,0,0
"Monaco","2024-03-16",0,0,0,0,0,0,0,0
"Monaco","2024-03-17",0,0,0,0,0,0,0,0
"Monaco","2024-03-18",0,0,0,0,0,0,0,0
"Monaco","2024-03-19",0,0,0,0,0,0,0,0
"Monaco","2024-03-20",0,0,0,0,0,0,0,0
"Monaco","2024-03-21",0,0,0,0,0,0,0,0
"Monaco","2024-03-22",0,0,0,0,0,0,0,0
"Monaco","2024-03-23",0,0,0,0,0,0,0,0
"Monaco","2024-03-24",0,0,0,0,0,0,0,0
"Monaco","2024-03-25",0,0,0,0,0,0,0,0
"Monaco","2024-03-26",0,0,0,0,0,0,0,0
"Monaco","2024-03-27",0,0,0,0,0,0,0,0
"Monaco","2024-03-28",0,0,0,0,0,0,0,0
"Monaco","2024-03-29",0,0,0,0,0,0,0,0
"Monaco","2024-03-30",0,0,0,0,0,0,0,0
"Monaco","2024-03-31",0,0,0,0,0,0,0,0
"Monaco","2024-04-01",0,0,0,0,0,0,0,0
"Monaco","2024-04-02",0,0,0,0,0,0,0,0
"Monaco","2024-04-03",0,0,0,0,0,0,0,0
"Monaco","2024-04-04",0,0,0,0,0,0,0,0
"Monaco","2024-04-05",0,0,0,0,0,0,0,0
"Monaco","2024-04-06",0,0,0,0,0,0,0,0
"Monaco","2024-04-07",0,0,0,0,0,0,0,0
"Monaco","2024-04-08",0,0,0,0,0,0,0,0
"Monaco","2024-04-09",0,0,0,0,0,0,0,0
"Monaco","2024-04-10",0,0,0,0,0,0,0,0
"Monaco","2024-04-11",0,0,0,0,0,0,0,0
"Monaco","2024-04-12",0,0,0,0,0,0,0,0
"Monaco","2024-04-13",0,0,0,0,0,0,0,0
"Monaco","2024-04-14",0,0,0,0,0,0,0,0
"Monaco","2024-04-15",0,0,0,0,0,0,0,0
"Monaco","2024-04-16",0,0,0,0,0,0,0,0
"Monaco","2024-04-17",0,0,0,0,0,0,0,0
"Monaco","2024-04-18",0,0,0,0,0,0,0,0
"Monaco","2024-04-19",0,0,0,0,0,0,0,0
"Monaco","2024-04-20",0,0,0,0,0,0,0,0
"Monaco","2024-04-21",0,0,0,0,0,0,0,0
"Monaco","2024-04-22",0,0,0,0,0,0,0,0
"Monaco","2024-04-23",0,0,0,0,0,0,0,0
"Monaco","2024-04-24",0,0,0,0,0,0,0,0
"Monaco","2024-04-25",0,0,0,0,0,0,0,0
"Monaco","2024-04-26",0,0,0,0,0,0,0,0
"Monaco","2024-04-27",0,0,0,0,0,0,0,0
"Monaco","2024-04-28",0,0,0,0,0,0,0,0
"Monaco","2024-04-29",0,0,0,0,0,0,0,0
"Monaco","2024-04-30",0,0,0,0,0,0,0,0
"Monaco","2024-05-01",0,0,0,0,0,0,0,0
"Monaco","2024-05-02",0,0,0,0,0,0,0,0
"Monaco","2024-05-03",0,0,0,0,0,0,0,0
"Monaco","2024-05-04",0,0,0,0,0,0,0,0
"Monaco","2024-05-05",0,0,0,0,0,0,0,0
"Monaco","2024-05-06",0,0,0,0,0,0,0,0
"Monaco","2024-05-07",0,0,0,0,0,0,0,0
"Monaco","2024-05-08",0,0,0,0,0,0,0,0
"Monaco","2024-05-09",0,0,0,0,0,0,0,0
"Monaco","2024-05-10",0,0,0,0,0,0,0,0
"Monaco","2024-05-11",0,0,0,0,0,0,0,0
"Monaco","2024-05-12",0,0,0,0,0,0,0,0
"Monaco","2024-05-13",0,0,0,0,0,0,0,0
"Monaco","2024-05-14",0,0,0,0,0,0,0,0
"Monaco","2024-05-15",0,0,0,0,0,0,0,0
"Monaco","2024-05-16",0,0,0,0,0,0,0,0
"Monaco","2024-05-17",0,0,0,0,0,0,0,0
"Monaco","2024-05-18",0,0,0,0,0,0,0,0
"Monaco","2024-05-19",0,0,0,0,0,0,0,0
"Monaco","2024-05-20",0,0,0,0,0,0,0,0
"Monaco","2024-05-21",0,0,0,0,0,0,0,0
"Monaco","2024-05-22",0,0,0,0,0,0,0,0
"Monaco","2024-05-23",0,0,0,0,0,0,0,0
"Monaco","2024-05-24",0,0,0,0,0,0,0,0
"Monaco","2024-05-25",0,0,0,0,0,0,0,0
"Monaco","2024-05-26",0,0,0,0,0,0,0,0
"Monaco","2024-05-27",0,0,0,0,0,0,0,0
"Monaco","2024-05-28",0,0,0,0,0,0,0,0
"Monaco","2024-05-29",0,0,0,0,0,0,0,0
"Monaco","2024-05-30",0,0,0,0,0,0,0,0
"Monaco","2024-05-31",0,0,0,0,0,0,0,0
"Monaco","2024-06-01",0,0,0,0,0,0,0,0
"Monaco","2024-06-02",0,0,0,0,0,0,0,0
"Monaco","2024-06-03",0,0,0,0,0,0,0,0
"Monaco","2024-06-04",0,0,0,0,0,0,0,0
"Monaco","2024-06-05",0,0,0,0,0,0,0,0
"Monaco","2024-06-06",0,0,0,0,0,0,0,0
"Monaco","2024-06-07",0,0,0,0,0,0,0,0
"Monaco","2024-06-08",0,0,0,0,0,0,0,0
"Monaco","2024-06-09",0,0,0,0,0,0,0,0
"Monaco","2024-06-10",0,0,0,0,0,0,0,0
"Monaco","2024-06-11",0,0,0,0,0,0,0,0
"Monaco","2024-06-12",0,0,0,0,0,0,0,0
"Monaco","2024-06-13",0,0,0,0,0,0,0,0
"Monaco","2024-06-14",0,0,0,0,0,0,0,0
"Monaco","2024-06-15",0,0,0,0,0,0,0,0
"Monaco","2024-06-16",0,0,0,0,0,0,0,0
"Monaco","2024-06-17",0,0,0,0,0,0,0,0
"Monaco","2024-06-18",0,0,0,0,0,0,0,0
"Monaco","2024-06-19",0,0,0,0,0,0,0,0
"Monaco","2024-06-20",0,0,0,0,0,0,0,0
"Monaco","2024-06-21",0,0,0,0,0,0,0,0
"Monaco","2024-06-22",0,0,0,0,0,0,0,0
"Monaco","2024-06-23",0,0,0,0,0,0,0,0
"Monaco","2024-06-24",0,0,0,0,0,0,0,0
"Monaco","2024-06-25",0,0,0,0,0,0,0,0
"Monaco","2024-06-26",0,0,0,0,0,0,0,0
"Monaco","2024-06-27",0,0,0,0,0,0,0,0
"Monaco","2024-06-28",0,0,0,0,0,0,0,0
"Monaco","2024-06-29",0,0,0,0,0,0,0,0
"Monaco","2024-06-30",0,0,0,0,0,0,0,0
"Monaco","2024-07-01",0,0,0,0,0,0,0,0
"Monaco","2024-07-02",0,0,0,0,0,0,0,0
"Monaco","2024-07-03",0,0,0,0,0,0,0,0
"Monaco","2024-07-04",0,0,0,0,0,0,0,0
"Monaco","2024-07-05",0,0,0,0,0,0,0,0
"Monaco","2024-07-06",0,0,0,0,0,0,0,0
"Monaco","2024-07-07",0,0,0,0,0,0,0,0
"Monaco","2024-07-08",0,0,0,0,0,0,0,0
"Monaco","2024-07-09",0,0,0,0,0,0,0,0
"Monaco","2024-07-10",0,0,0,0,0,0,0,0
"Monaco","2024-07-11",0,0,0,0,0,0,0,0
"Monaco","2024-07-12",0,0,0,0,0,0,0,0
"Monaco","2024-07-13",0,0,0,0,0,0,0,0
"Monaco","2024-07-14",0,0,0,0,0,0,0,0
"Monaco","2024-07-15",0,0,0,0,0,0,0,0
"Monaco","2024-07-16",0,0,0,0,0,0,0,0
"Monaco","2024-07-17",0,0,0,0,0,0,0,0
"Monaco","2024-07-18",0,0,0,0,0,0,0,0
"Monaco","2024-07-19",0,0,0,0,0,0,0,0
"Monaco","2024-07-20",0,0,0,0,0,0,0,0
"Monaco","2024-07-21",0,0,0,0,0,0,0,0
"Monaco","2024-07-22",0,0,0,0,0,0,0,0
"Monaco","2024-07-23",0,0,0,0,0,0,0,0
"Monaco","2024-07-24",0,0,0,0,0,0,0,0
"Monaco","2024-07-25",0,0,0,0,0,0,0,0
"Monaco","2024-07-26",0,0,0,0,0,0,0,0
"Monaco","2024-07-27",0,0,0,0,0,0,0,0
"Monaco","2024-07-28",0,0,0,0,0,0,0,0
"Monaco","2024-07-29",0,0,0,0,0,0,0,0
"Monaco","2024-07-30",0,0,0,0,0,0,0,0
"Monaco","2024-07-31",0,0,0,0,0,0,0,0
"Monaco","2024-08-01",0,0,0,0,0,0,0,0
"Monaco","2024-08-02",0,0,0,0,0,0,0,0
"Monaco","2024-08-03",0,0,0,0,0,0,0,0
"Monaco","2024-08-04",0,0,0,0,0,0,0,0
"Monaco","2024-08-05",0,0,0,0,0,0,0,0
"Monaco","2024-08-06",0,0,0,0,0,0,0,0
"Monaco","2024-08-07",0,0,0,0,0,0,0,0
"Monaco","2024-08-08",0,0,0,0,0,0,0,0
"Monaco","2024-08-09",0,0,0,0,0,0,0,0
"Monaco","2024-08-10",0,0,0,0,0,0,0,0
"Monaco","2024-08-11",0,0,0,0,0,0,0,0
"Monaco","2024-08-12",0,0,0,0,0,0,0,0
"Monaco","2024-08-13",0,0,0,0,0,0,0,0
"Monaco","2024-08-14",0,0,0,0,0,0,0,0
"Monaco","2024-08-15",0,0,0,0,0,0,0,0
"Monaco","2024-08-16",0,0,0,0,0,0,0,0
"Monaco","2024-08-17",0,0,0,0,0,0,0,0
"Monaco","2024-08-18",0,0,0,0,0,0,0,0
"Monaco","2024-08-19",0,0,0,0,0,0,0,0
"Monaco","2024-08-20",0,0,0,0,0,0,0,0
"Monaco","2024-08-21",0,0,0,0,0,0,0,0
"Monaco","2024-08-22",0,0,0,0,0,0,0,0
"Monaco","2024-08-23",0,0,0,0,0,0,0,0
"Monaco","2024-08-24",0,0,0,0,0,0,0,0
"Monaco","2024-08-25",0,0,0,0,0,0,0,0
"Monaco","2024-08-26",0,0,0,0,0,0,0,0
"Monaco","2024-08-27",0,0,0,0,0,0,0,0
"Monaco","2024-08-28",0,0,0,0,0,0,0,0
"Monaco","2024-08-29",0,0,0,0,0,0,0,0
"Monaco","2024-08-30",0,0,0,0,0,0,0,0
"Monaco","2024-08-31",0,0,0,0,0,0,0,0
"Monaco","2024-09-01",0,0,0,0,0,0,0,0
"Monaco","2024-09-02",0,0,0,0,0,0,0,0
"Monaco","2024-09-03",0,0,0,0,0,0,0,0
"Monaco","2024-09-04",0,0,0,0,0,0,0,0
"Monaco","2024-09-05",0,0,0,0,0,0,0,0
"Monaco","2024-09-06",0,0,0,0,0,0,0,0
"Monaco","2024-09-07",0,0,0,0,0,0,0,0
"Monaco","2024-09-08",0,0,0,0,0,0,0,0
"Monaco","2024-09-09",0,0,0,0,0,0,0,0
"Monaco","2024-09-10",0,0,0,0,0,0,0,0
"Monaco","2024-09-11",0,0,0,0,0,0,0,0
"Monaco","2024-09-12",0,0,0,0,0,0,0,0
"Monaco","2024-09-13",0,0,0,0,0,0,0,0
"Monaco","2024-09-14",0,0,0,0,0,0,0,0
"Monaco","2024-09-15",0,0,0,0,0,0,0,0
"Monaco","2024-09-16",0,0,0,0,0,0,0,0
"Monaco","2024-09-17",0,0,0,0,0,0,0,0
"Monaco","2024-09-18",0,0,0,0,0,0,0,0
"Monaco","2024-09-19",0,0,0,0,0,0,0,0
"Monaco","2024-09-20",0,0,0,0,0,0,0,0
"Monaco","2024-09-21",0,0,0,0,0,0,0,0
"Monaco","2024-09-22",0,0,0,0,0,0,0,0
"Monaco","2024-09-23",0,0,0,0,0,0,0,0
"Monaco","2024-09-24",0,0,0,0,0,0,0,0
"Monaco","2024-09-25",0,0,0,0,0,0,0,0
"Monaco","2024-09-26",0,0,0,0,0,0,0,0
"Monaco","2024-09-27",0,0,0,0,0,0,0,0
"Monaco","2024-09-28",0,0,0,0,0,0,0,0
"Monaco","2024-09-29",0,0,0,0,0,0,0,0
"Monaco","2024-09-30",0,0,0,0,0,0,0,0
"Monaco","2024-10-01",0,0,0,0,0,0,0,0
"Monaco","2024-10-02",0,0,0,0,0,0,0,0
"Monaco","2024-10-03",0,0,0,0,0,0,0,0
"Monaco","2024-10-04",0,0,0,0,0,0,0,0
"Monaco","2024-10-05",0,0,0,0,0,0,0,0
"Monaco","2024-10-06",0,0,0,0,0,0,0,0
"Monaco","2024-10-07",0,0,0,0,0,0,0,0
"Monaco","2024-10-08",0,0,0,0,0,0,0,0
"Monaco","2024-10-09",0,0,0,0,0,0,0,0
"Monaco","2024-10-10",0,0,0,0,0,0,0,0
"Monaco","2024-10-11",0,0,0,0,0,0,0,0
"Monaco","2024-10-12",0,0,0,0,0,0,0,0
"Monaco","2024-10-13",0,0,0,0,0,0,0,0
"Monaco","2024-10-14",0,0,0,0,0,0,0,0
"Monaco","2024-10-15",0,0,0,0,0,0,0,0
"Monaco","2024-10-16",0,0,0,0,0,0,0,0
"Monaco","2024-10-17",0,0,0,0,0,0,0,0
"Monaco","2024-10-18",0,0,0,0,0,0,0,0
"Monaco","2024-10-19",0,0,0,0,0,0,0,0
"Monaco","2024-10-20",0,0,0,0,0,0,0,0
"Monaco","2024-10-21",0,0,0,0,0,0,0,0
"Monaco","2024-10-22",0,0,0,0,0,0,0,0
"Monaco","2024-10-23",0,0,0,0,0,0,0,0
"Monaco","2024-10-24",0,0,0,0,0,0,0,0
"Monaco","2024-10-25",0,0,0,0,0,0,0,0
"Monaco","2024-10-26",0,0,0,0,0,0,0,0
"Monaco","2024-10-27",0,0,0,0,0,0,0,0
"Monaco","2024-10-28",0,0,0,0,0,0,0,0
"Monaco","2024-10-29",0,0,0,0,0,0,0,0
"Monaco","2024-10-30",0,0,0,0,0,0,0,0
"Monaco","2024-10-31",0,0,0,0,0,0,0,0
"Monaco","2024-11-01",0,0,0,0,0,0,0,0
"Monaco","2024-11-02",0,0,0,0,0,0,0,0
"Monaco","2024-11-03",0,0,0,0,0,0,0,0
"Monaco","2024-11-04",0,0,0,0,0,0,0,0
"Monaco","2024-11-05",0,0,0,0,0,0,0,0
"Monaco","2024-11-06",0,0,0,0,0,0,0,0
"Monaco","2024-11-07",0,0,0,0,0,0,0,0
"Monaco","2024-11-08",0,0,0,0,0,0,0,0
"Monaco","2024-11-09",0,0,0,0,0,0,0,0
"Monaco","2024-11-10",0,0,0,0,0,0,0,0
"Monaco","2024-11-11",0,0,0,0,0,0,0,0
"Monaco","2024-11-12",0,0,0,0,0,0,0,0
"Monaco","2024-11-13",0,0,0,0,0,0,0,0
"Monaco","2024-11-14",0,0,0,0,0,0,0,0
"Monaco","2024-11-15",0,0,0,0,0,0,0,0
"Monaco","2024-11-16",0,0,0,0,0,0,0,0
"Monaco","2024-11-17",0,0,0,0,0,0,0,0
"Monaco","2024-11-18",0,0,0,0,0,0,0,0
"Monaco","2024-11-19",0,0,0,0,0,0,0,0
"Monaco","2024-11-20",0,0,0,0,0,0,0,0
"Monaco","2024-11-21",0,0,0,0,0,0,0,0
"Monaco","2024-11-22",0,0,0,0,0,0,0,0
"Monaco","2024-11-23",0,0,0,0,0,0,0,0
"Monaco","2024-11-24",0,0,0,0,0,0,0,0
"Monaco","2024-11-25",0,0,0,0,0,0,0,0
"Monaco","2024-11-26",0,0,0,0,0,0,0,0
"Monaco","2024-11-27",0,0,0,0,0,0,0,0
"Monaco","2024-11-28",0,0,0,0,0,0,0,0
"Monaco","2024-11-29",0,0,0,0,0,0,0,0
"Monaco","2024-11-30",0,0,0,0,0,0,0,0
"Monaco","2024-12-01",0,0,0,0,0,0,0,0
"Monaco","2024-12-02",0,0,0,0,0,0,0,0
"Monaco","2024-12-03",0,0,0,0,0,0,0,0
"Monaco","2024-12-04",0,0,0,0,0,0,0,0
"Monaco","2024-12-05",0,0,0,0,0,0,0,0
"Monaco","2024-12-06",0,0,0,0,0,0,0,0
"Monaco","2024-12-07",0,0,0,0,0,0,0,0
"Monaco","2024-12-08",0,0,0,0,0,0,0,0
"Monaco","2024-12-09",0,0,0,0,0,0,0,0
"Monaco","2024-12-10",0,0,0,0,0,0,0,0
"Monaco","2024-12-11",0,0,0,0,0,0,0,0
"Monaco","2024-12-12",0,0,0,0,0,0,0,0
"Monaco","2024-12-13",0,0,0,0,0,0,0,0
"Monaco","2024-12-14",0,0,0,0,0,0,0,0
"Monaco","2024-12-15",0,0,0,0,0,0,0,0
"Monaco","2024-12-16",0,0,0,0,0,0,0,0
"Monaco","2024-12-17",0,0,0,0,0,0,0,0
"Monaco","2024-12-18",0,0,0,0,0,0,0,0
"Monaco","2024-12-19",0,0,0,0,0,0,0,0
"Monaco","2024-12-20",0,0,0,0,0,0,0,0
"Monaco","2024-12-21",0,0,0,0,0,0,0,0
"Monaco","2024-12-22",0,0,0,0,0,0,0,0
"Monaco","2024-12-23",0,0,0,0,0,0,0,0
"Monaco","2024-12-24",0,0,0,0,0,0,0,0
"Monaco","2024-12-25",0,0,0,0,0,0,0,0
"Monaco","2024-12-26",0,0,0,0,0,0,0,0
"Monaco","2024-12-27",0,0,0,0,0,0,0,0
"Monaco","2024-12-28",0,0,0,0,0,0,0,0
"Monaco","2024-12-29",0,0,0,0,0,0,0,0
"Monaco","2024-12-30",0,0,0,0,0,0,0,0
"Monaco","2024-12-31",0,0,0,0,0,0,0,0
"Monaco","2025-01-01",0,0,0,0,0,0,0,0
"Monaco","2025-01-02",0,0,0,0,0,0,0,0
"Monaco","2025-01-03",0,0,0,0,0,0,0,0
"Monaco","2025-01-04",0,0,0,0,0,0,0,0
"Monaco","2025-01-05",0,0,0,0,0,0,0,0
"Monaco","2025-01-06",0,0,0,0,0,0,0,0
"Monaco","2025-01-07",0,0,0,0,0,0,0,0
"Monaco","2025-01-08",0,0,0,0,0,0,0,0
"Monaco","2025-01-09",0,0,0,0,0,0,0,0
"Monaco","2025-01-10",0,0,0,0,0,0,0,0
"Monaco","2025-01-11",0,0,0,0,0,0,0,0
"Monaco","2025-01-12",0,0,0,0,0,0,0,0
"Monaco","2025-01-13",0,0,0,0,0,0,0,0
"Monaco","2025-01-14",0,0,0,0,0,0,0,0
"Monaco","2025-01-15",0,0,0,0,0,0,0,0
"Monaco","2025-01-16",0,0,0,0,0,0,0,0
"Monaco","2025-01-17",0,0,0,0,0,0,0,0
"Monaco","2025-01-18",0,0,0,0,0,0,0,0
"Monaco","2025-01-19",0,0,0,0,0,0,0,0
"Monaco","2025-01-20",0,0,0,0,0,0,0,0
"Monaco","2025-01-21",0,0,0,0,0,0,0,0
"Monaco","2025-01-22",0,0,0,0,0,0,0,0
"Monaco","2025-01-23",0,0,0,0,0,0,0,0
"Monaco","2025-01-24",0,0,0,0,0,0,0,0
"Monaco","2025-01-25",0,0,0,0,0,0,0,0
"Monaco","2025-01-26",0,0,0,0,0,0,0,0
"Monaco","2025-01-27",0,0,0,0,0,0,0,0
"Monaco","2025-01-28",0,0,0,0,0,0,0,0
"Monaco","2025-01-29",0,0,0,0,0,0,0,0
"Monaco","2025-01-30",0,0,0,0,0,0,0,0
"Monaco","2025-01-31",0,0,0,0,0,0,0,0
"Monaco","2025-02-01",0,0,0,0,0,0,0,0
"Monaco","2025-02-02",0,0,0,0,0,0,0,0
"Monaco","2025-02-03",0,0,0,0,0,0,0,0
"Montenegro","2024-01-01",0,0,0,0,0,0,0,0
"Montenegro","2024-01-02",0,0,0,0,0,0,0,0
"Montenegro","2024-01-03",0,0,0,0,0,0,0,0
"Montenegro","2024-01-04",0,0,0,0,0,0,0,0
"Montenegro","2024-01-05",0,0,0,0,0,0,0,0
"Montenegro","2024-01-06",0,0,0,0,0,0,0,0
"Montenegro","2024-01-07",0,0,0,0,0,0,0,0
"Montenegro","2024-01-08",0,0,0,0,0,0,0,0
"Montenegro","2024-01-09",0,0,0,0,0,0,0,0
"Montenegro","2024-01-10",0,0,0,0,0,0,0,0
"Montenegro","2024-01-11",0,0,0,0,0,0,0,0
"Montenegro","2024-01-12",0,0,0,0,0,0,0,0
"Montenegro","2024-01-13",0,0,0,0,0,0,0,0
"Montenegro","2024-01-14",0,0,0,0,0,0,0,0
"Montenegro","2024-01-15",0,0,0,0,0,0,0,0
"Montenegro","2024-01-16",0,0,0,0,0,0,0,0
"Montenegro","2024-01-17",0,0,0,0,0,0,0,0
"Montenegro","2024-01-18",0,0,0,0,0,0,0,0
"Montenegro","2024-01-19",0,0,0,0,0,0,0,0
"Montenegro","2024-01-20",0,0,0,0,0,0,0,0
"Montenegro","2024-01-21",0,0,0,0,0,0,0,0
"Montenegro","2024-01-22",0,0,0,0,0,0,0,0
"Montenegro","2024-01-23",0,0,0,0,0,0,0,0
"Montenegro","2024-01-24",0,0,0,0,0,0,0,0
"Montenegro","2024-01-25",0,0,0,0,0,0,0,0
"Montenegro","2024-01-26",0,0,0,0,0,0,0,0
"Montenegro","2024-01-27",0,0,0,0,0,0,0,0
"Montenegro","2024-01-28",0,0,0,0,0,0,0,0
"Montenegro","2024-01-29",0,0,0,0,0,0,0,0
"Montenegro","2024-01-30",0,0,0,0,0,0,0,0
"Montenegro","2024-01-31",0,0,0,0,0,0,0,0
"Montenegro","2024-02-01",0,0,0,0,0,0,0,0
"Montenegro","2024-02-02",0,0,0,0,0,0,0,0
"Montenegro","2024-02-03",0,0,0,0,0,0,0,0
"Montenegro","2024-02-04",0,0,0,0,0,0,0,0
"Montenegro","2024-02-05",0,0,0,0,0,0,0,0
"Montenegro","2024-02-06",0,0,0,0,0,0,0,0
"Montenegro","2024-02-07",0,0,0,0,0,0,0,0
"Montenegro","2024-02-08",0,0,0,0,0,0,0,0
"Montenegro","2024-02-09",0,0,0,0,0,0,0,0
"Montenegro","2024-02-10",0,0,0,0,0,0,0,0
"Montenegro","2024-02-11",0,0,0,0,0,0,0,0
"Montenegro","2024-02-12",0,0,0,0,0,0,0,0
"Montenegro","2024-02-13",0,0,0,0,0,0,0,0
"Montenegro","2024-02-14",0,0,0,0,0,0,0,0
"Montenegro","2024-02-15",0,0,0,0,0,0,0,0
"Montenegro","2024-02-16",0,0,0,0,0,0,0,0
"Montenegro","2024-02-17",0,0,0,0,0,0,0,0
"Montenegro","2024-02-18",0,0,0,0,0,0,0,0
"Montenegro","2024-02-19",0,0,0,0,0,0,0,0
"Montenegro","2024-02-20",0,0,0,0,0,0,0,0
"Montenegro","2024-02-21",0,0,0,0,0,0,0,0
"Montenegro","2024-02-22",0,0,0,0,0,0,0,0
"Montenegro","2024-02-23",0,0,0,0,0,0,0,0
"Montenegro","2024-02-24",0,0,0,0,0,0,0,0
"Montenegro","2024-02-25",0,0,0,0,0,0,0,0
"Montenegro","2024-02-26",0,0,0,0,0,0,0,0
"Montenegro","2024-02-27",0,0,0,0,0,0,0,0
"Montenegro","2024-02-28",0,0,0,0,0,0,0,0
"Montenegro","2024-02-29",0,0,0,0,0,0,0,0
"Montenegro","2024-03-01",0,0,0,0,0,0,0,0
"Montenegro","2024-03-02",0,0,0,0,0,0,0,0
"Montenegro","2024-03-03",0,0,0,0,0,0,0,0
"Montenegro","2024-03-04",0,0,0,0,0,0,0,0
"Montenegro","2024-03-05",0,0,0,0,0,0,0,0
"Montenegro","2024-03-06",0,0,0,0,0,0,0,0
"Montenegro","2024-03-07",0,0,0,0,0,0,0,0
"Montenegro","2024-03-08",0,0,0,0,0,0,0,0
"Montenegro","2024-03-09",0,0,0,0,0,0,0,0
"Montenegro","2024-03-10",0,0,0,0,0,0,0,0
"Montenegro","2024-03-11",0,0,0,0,0,0,0,0
"Montenegro","2024-03-12",0,0,0,0,0,0,0,0
"Montenegro","2024-03-13",0,0,0,0,0,0,0,0
"Montenegro","2024-03-14",0,0,0,0,0,0,0,0
"Montenegro","2024-03-15",0,0,0,0,0,0,0,0
"Montenegro","2024-03-16",0,0,0,0,0,0,0,0
"Montenegro","2024-03-17",0,0,0,0,0,0,0,0
"Montenegro","2024-03-18",0,0,0,0,0,0,0,0
"Montenegro","2024-03-19",0,0,0,0,0,0,0,0
"Montenegro","2024-03-20",0,0,0,0,0,0,0,0
"Montenegro","2024-03-21",0,0,0,0,0,0,0,0
"Montenegro","2024-03-22",0,0,0,0,0,0,0,0
"Montenegro","2024-03-23",0,0,0,0,0,0,0,0
"Montenegro","2024-03-24",0,0,0,0,0,0,0,0
"Montenegro","2024-03-25",0,0,0,0,0,0,0,0
"Montenegro","2024-03-26",0,0,0,0,0,0,0,0
"Montenegro","2024-03-27",0,0,0,0,0,0,0,0
"Montenegro","2024-03-28",0,0,0,0,0,0,0,0
"Montenegro","2024-03-29",0,0,0,0,0,0,0,0
"Montenegro","2024-03-30",0,0,0,0,0,0,0,0
"Montenegro","2024-03-31",0,0,0,0,0,0,0,0
"Montenegro","2024-04-01",0,0,0,0,0,0,0,0
"Montenegro","2024-04-02",0,0,0,0,0,0,0,0
"Montenegro","2024-04-03",0,0,0,0,0,0,0,0
"Montenegro","2024-04-04",0,0,0,0,0,0,0,0
"Montenegro","2024-04-05",0,0,0,0,0,0,0,0
"Montenegro","2024-04-06",0,0,0,0,0,0,0,0
"Montenegro","2024-04-07",0,0,0,0,0,0,0,0
"Montenegro","2024-04-08",0,0,0,0,0,0,0,0
"Montenegro","2024-04-09",0,0,0,0,0,0,0,0
"Montenegro","2024-04-10",0,0,0,0,0,0,0,0
"Montenegro","2024-04-11",0,0,0,0,0,0,0,0
"Montenegro","2024-04-12",0,0,0,0,0,0,0,0
"Montenegro","2024-04-13",0,0,0,0,0,0,0,0
"Montenegro","2024-04-14",0,0,0,0,0,0,0,0
"Montenegro","2024-04-15",0,0,0,0,0,0,0,0
"Montenegro","2024-04-16",0,0,0,0,0,0,0,0
"Montenegro","2024-04-17",0,0,0,0,0,0,0,0
"Montenegro","2024-04-18",0,0,0,0,0,0,0,0
"Montenegro","2024-04-19",0,0,0,0,0,0,0,0
"Montenegro","2024-04-20",0,0,0,0,0,0,0,0
"Montenegro","2024-04-21",0,0,0,0,0,0,0,0
"Montenegro","2024-04-22",0,0,0,0,0,0,0,0
"Montenegro","2024-04-23",0,0,0,0,0,0,0,0
"Montenegro","2024-04-24",0,0,0,0,0,0,0,0
"Montenegro","2024-04-25",0,0,0,0,0,0,0,0
"Montenegro","2024-04-26",0,0,0,0,0,0,0,0
"Montenegro","2024-04-27",0,0,0,0,0,0,0,0
"Montenegro","2024-04-28",0,0,0,0,0,0,0,0
"Montenegro","2024-04-29",0,0,0,0,0,0,0,0
"Montenegro","2024-04-30",0,0,0,0,0,0,0,0
"Montenegro","2024-05-01",0,0,0,0,0,0,0,0
"Montenegro","2024-05-02",0,0,0,0,0,0,0,0
"Montenegro","2024-05-03",0,0,0,0,0,0,0,0
"Montenegro","2024-05-04",0,0,0,0,0,0,0,0
"Montenegro","2024-05-05",0,0,0,0,0,0,0,0
"Montenegro","2024-05-06",0,0,0,0,0,0,0,0
"Montenegro","2024-05-07",0,0,0,0,0,0,0,0
"Montenegro","2024-05-08",0,0,0,0,0,0,0,0
"Montenegro","2024-05-09",0,0,0,0,0,0,0,0
"Montenegro","2024-05-10",0,0,0,0,0,0,0,0
"Montenegro","2024-05-11",0,0,0,0,0,0,0,0
"Montenegro","2024-05-12",0,0,0,0,0,0,0,0
"Montenegro","2024-05-13",0,0,0,0,0,0,0,0
"Montenegro","2024-05-14",0,0,0,0,0,0,0,0
"Montenegro","2024-05-15",0,0,0,0,0,0,0,0
"Montenegro","2024-05-16",0,0,0,0,0,0,0,0
"Montenegro","2024-05-17",0,0,0,0,0,0,0,0
"Montenegro","2024-05-18",0,0,0,0,0,0,0,0
"Montenegro","2024-05-19",0,0,0,0,0,0,0,0
"Montenegro","2024-05-20",0,0,0,0,0,0,0,0
"Montenegro","2024-05-21",0,0,0,0,0,0,0,0
"Montenegro","2024-05-22",0,0,0,0,0,0,0,0
"Montenegro","2024-05-23",0,0,0,0,0,0,0,0
"Montenegro","2024-05-24",0,0,0,0,0,0,0,0
"Montenegro","2024-05-25",0,0,0,0,0,0,0,0
"Montenegro","2024-05-26",0,0,0,0,0,0,0,0
"Montenegro","2024-05-27",0,0,0,0,0,0,0,0
"Montenegro","2024-05-28",0,0,0,0,0,0,0,0
"Montenegro","2024-05-29",0,0,0,0,0,0,0,0
"Montenegro","2024-05-30",0,0,0,0,0,0,0,0
"Montenegro","2024-05-31",0,0,0,0,0,0,0,0
"Montenegro","2024-06-01",0,0,0,0,0,0,0,0
"Montenegro","2024-06-02",0,0,0,0,0,0,0,0
"Montenegro","2024-06-03",0,0,0,0,0,0,0,0
"Montenegro","2024-06-04",0,0,0,0,0,0,0,0
"Montenegro","2024-06-05",0,0,0,0,0,0,0,0
"Montenegro","2024-06-06",0,0,0,0,0,0,0,0
"Montenegro","2024-06-07",0,0,0,0,0,0,0,0
"Montenegro","2024-06-08",0,0,0,0,0,0,0,0
"Montenegro","2024-06-09",0,0,0,0,0,0,0,0
"Montenegro","2024-06-10",0,0,0,0,0,0,0,0
"Montenegro","2024-06-11",0,0,0,0,0,0,0,0
"Montenegro","2024-06-12",0,0,0,0,0,0,0,0
"Montenegro","2024-06-13",0,0,0,0,0,0,0,0
"Montenegro","2024-06-14",0,0,0,0,0,0,0,0
"Montenegro","2024-06-15",0,0,0,0,0,0,0,0
"Montenegro","2024-06-16",0,0,0,0,0,0,0,0
"Montenegro","2024-06-17",0,0,0,0,0,0,0,0
"Montenegro","2024-06-18",0,0,0,0,0,0,0,0
"Montenegro","2024-06-19",0,0,0,0,0,0,0,0
"Montenegro","2024-06-20",0,0,0,0,0,0,0,0
"Montenegro","2024-06-21",0,0,0,0,0,0,0,0
"Montenegro","2024-06-22",0,0,0,0,0,0,0,0
"Montenegro","2024-06-23",0,0,0,0,0,0,0,0
"Montenegro","2024-06-24",0,0,0,0,0,0,0,0
"Montenegro","2024-06-25",0,0,0,0,0,0,0,0
"Montenegro","2024-06-26",0,0,0,0,0,0,0,0
"Montenegro","2024-06-27",0,0,0,0,0,0,0,0
"Montenegro","2024-06-28",0,0,0,0,0,0,0,0
"Montenegro","2024-06-29",0,0,0,0,0,0,0,0
"Montenegro","2024-06-30",0,0,0,0,0,0,0,0
"Montenegro","2024-07-01",0,0,0,0,0,0,0,0
"Montenegro","2024-07-02",0,0,0,0,0,0,0,0
"Montenegro","2024-07-03",0,0,0,0,0,0,0,0
"Montenegro","2024-07-04",0,0,0,0,0,0,0,0
"Montenegro","2024-07-05",0,0,0,0,0,0,0,0
"Montenegro","2024-07-06",0,0,0,0,0,0,0,0
"Montenegro","2024-07-07",0,0,0,0,0,0,0,0
"Montenegro","2024-07-08",0,0,0,0,0,0,0,0
"Montenegro","2024-07-09",0,0,0,0,0,0,0,0
"Montenegro","2024-07-10",0,0,0,0,0,0,0,0
"Montenegro","2024-07-11",0,0,0,0,0,0,0,0
"Montenegro","2024-07-12",0,0,0,0,0,0,0,0
"Montenegro","2024-07-13",0,0,0,0,0,0,0,0
"Montenegro","2024-07-14",0,0,0,0,0,0,0,0
"Montenegro","2024-07-15",0,0,0,0,0,0,0,0
"Montenegro","2024-07-16",0,0,0,0,0,0,0,0
"Montenegro","2024-07-17",0,0,0,0,0,0,0,0
"Montenegro","2024-07-18",0,0,0,0,0,0,0,0
"Montenegro","2024-07-19",0,0,0,0,0,0,0,0
"Montenegro","2024-07-20",0,0,0,0,0,0,0,0
"Montenegro","2024-07-21",0,0,0,0,0,0,0,0
"Montenegro","2024-07-22",0,0,0,0,0,0,0,0
"Montenegro","2024-07-23",0,0,0,0,0,0,0,0
"Montenegro","2024-07-24",0,0,0,0,0,0,0,0
"Montenegro","2024-07-25",0,0,0,0,0,0,0,0
"Montenegro","2024-07-26",0,0,0,0,0,0,0,0
"Montenegro","2024-07-27",0,0,0,0,0,0,0,0
"Montenegro","2024-07-28",0,0,0,0,0,0,0,0
"Montenegro","2024-07-29",0,0,0,0,0,0,0,0
"Montenegro","2024-07-30",0,0,0,0,0,0,0,0
"Montenegro","2024-07-31",0,0,0,0,0,0,0,0
"Montenegro","2024-08-01",0,0,0,0,0,0,0,0
"Montenegro","2024-08-02",0,0,0,0,0,0,0,0
"Montenegro","2024-08-03",0,0,0,0,0,0,0,0
"Montenegro","2024-08-04",0,0,0,0,0,0,0,0
"Montenegro","2024-08-05",0,0,0,0,0,0,0,0
"Montenegro","2024-08-06",0,0,0,0,0,0,0,0
"Montenegro","2024-08-07",0,0,0,0,0,0,0,0
"Montenegro","2024-08-08",0,0,0,0,0,0,0,0
"Montenegro","2024-08-09",0,0,0,0,0,0,0,0
"Montenegro","2024-08-10",0,0,0,0,0,0,0,0
"Montenegro","2024-08-11",0,0,0,0,0,0,0,0
"Montenegro","2024-08-12",0,0,0,0,0,0,0,0
"Montenegro","2024-08-13",0,0,0,0,0,0,0,0
"Montenegro","2024-08-14",0,0,0,0,0,0,0,0
"Montenegro","2024-08-15",0,0,0,0,0,0,0,0
"Montenegro","2024-08-16",0,0,0,0,0,0,0,0
"Montenegro","2024-08-17",0,0,0,0,0,0,0,0
"Montenegro","2024-08-18",0,0,0,0,0,0,0,0
"Montenegro","2024-08-19",0,0,0,0,0,0,0,0
"Montenegro","2024-08-20",0,0,0,0,0,0,0,0
"Montenegro","2024-08-21",0,0,0,0,0,0,0,0
"Montenegro","2024-08-22",0,0,0,0,0,0,0,0
"Montenegro","2024-08-23",0,0,0,0,0,0,0,0
"Montenegro","2024-08-24",0,0,0,0,0,0,0,0
"Montenegro","2024-08-25",0,0,0,0,0,0,0,0
"Montenegro","2024-08-26",0,0,0,0,0,0,0,0
"Montenegro","2024-08-27",0,0,0,0,0,0,0,0
"Montenegro","2024-08-28",0,0,0,0,0,0,0,0
"Montenegro","2024-08-29",0,0,0,0,0,0,0,0
"Montenegro","2024-08-30",0,0,0,0,0,0,0,0
"Montenegro","2024-08-31",0,0,0,0,0,0,0,0
"Montenegro","2024-09-01",0,0,0,0,0,0,0,0
"Montenegro","2024-09-02",0,0,0,0,0,0,0,0
"Montenegro","2024-09-03",0,0,0,0,0,0,0,0
"Montenegro","2024-09-04",0,0,0,0,0,0,0,0
"Montenegro","2024-09-05",0,0,0,0,0,0,0,0
"Montenegro","2024-09-06",0,0,0,0,0,0,0,0
"Montenegro","2024-09-07",0,0,0,0,0,0,0,0
"Montenegro","2024-09-08",0,0,0,0,0,0,0,0
"Montenegro","2024-09-09",0,0,0,0,0,0,0,0
"Montenegro","2024-09-10",0,0,0,0,0,0,0,0
"Montenegro","2024-09-11",0,0,0,0,0,0,0,0
"Montenegro","2024-09-12",0,0,0,0,0,0,0,0
"Montenegro","2024-09-13",0,0,0,0,0,0,0,0
"Montenegro","2024-09-14",0,0,0,0,0,0,0,0
"Montenegro","2024-09-15",0,0,0,0,0,0,0,0
"Montenegro","2024-09-16",0,0,0,0,0,0,0,0
"Montenegro","2024-09-17",0,0,0,0,0,0,0,0
"Montenegro","2024-09-18",0,0,0,0,0,0,0,0
"Montenegro","2024-09-19",0,0,0,0,0,0,0,0
"Montenegro","2024-09-20",0,0,0,0,0,0,0,0
"Montenegro","2024-09-21",0,0,0,0,0,0,0,0
"Montenegro","2024-09-22",0,0,0,0,0,0,0,0
"Montenegro","2024-09-23",0,0,0,0,0,0,0,0
"Montenegro","2024-09-24",0,0,0,0,0,0,0,0
"Montenegro","2024-09-25",0,0,0,0,0,0,0,0
"Montenegro","2024-09-26",0,0,0,0,0,0,0,0
"Montenegro","2024-09-27",0,0,0,0,0,0,0,0
"Montenegro","2024-09-28",0,0,0,0,0,0,0,0
"Montenegro","2024-09-29",0,0,0,0,0,0,0,0
"Montenegro","2024-09-30",0,0,0,0,0,0,0,0
"Montenegro","2024-10-01",0,0,0,0,0,0,0,0
"Montenegro","2024-10-02",0,0,0,0,0,0,0,0
"Montenegro","2024-10-03",0,0,0,0,0,0,0,0
"Montenegro","2024-10-04",0,0,0,0,0,0,0,0
"Montenegro","2024-10-05",0,0,0,0,0,0,0,0
"Montenegro","2024-10-06",0,0,0,0,0,0,0,0
"Montenegro","2024-10-07",0,0,0,0,0,0,0,0
"Montenegro","2024-10-08",0,0,0,0,0,0,0,0
"Montenegro","2024-10-09",0,0,0,0,0,0,0,0
"Montenegro","2024-10-10",0,0,0,0,0,0,0,0
"Montenegro","2024-10-11",0,0,0,0,0,0,0,0
"Montenegro","2024-10-12",0,0,0,0,0,0,0,0
"Montenegro","2024-10-13",0,0,0,0,0,0,0,0
"Montenegro","2024-10-14",0,0,0,0,0,0,0,0
"Montenegro","2024-10-15",0,0,0,0,0,0,0,0
"Montenegro","2024-10-16",0,0,0,0,0,0,0,0
"Montenegro","2024-10-17",0,0,0,0,0,0,0,0
"Montenegro","2024-10-18",0,0,0,0,0,0,0,0
"Montenegro","2024-10-19",0,0,0,0,0,0,0,0
"Montenegro","2024-10-20",0,0,0,0,0,0,0,0
"Montenegro","2024-10-21",0,0,0,0,0,0,0,0
"Montenegro","2024-10-22",0,0,0,0,0,0,0,0
"Montenegro","2024-10-23",0,0,0,0,0,0,0,0
"Montenegro","2024-10-24",0,0,0,0,0,0,0,0
"Montenegro","2024-10-25",0,0,0,0,0,0,0,0
"Montenegro","2024-10-26",0,0,0,0,0,0,0,0
"Montenegro","2024-10-27",0,0,0,0,0,0,0,0
"Montenegro","2024-10-28",0,0,0,0,0,0,0,0
"Montenegro","2024-10-29",0,0,0,0,0,0,0,0
"Montenegro","2024-10-30",0,0,0,0,0,0,0,0
"Montenegro","2024-10-31",0,0,0,0,0,0,0,0
"Montenegro","2024-11-01",0,0,0,0,0,0,0,0
"Montenegro","2024-11-02",0,0,0,0,0,0,0,0
"Montenegro","2024-11-03",0,0,0,0,0,0,0,0
"Montenegro","2024-11-04",0,0,0,0,0,0,0,0
"Montenegro","2024-11-05",0,0,0,0,0,0,0,0
"Montenegro","2024-11-06",0,0,0,0,0,0,0,0
"Montenegro","2024-11-07",0,0,0,0,0,0,0,0
"Montenegro","2024-11-08",0,0,0,0,0,0,0,0
"Montenegro","2024-11-09",0,0,0,0,0,0,0,0
"Montenegro","2024-11-10",0,0,0,0,0,0,0,0
"Montenegro","2024-11-11",0,0,0,0,0,0,0,0
"Montenegro","2024-11-12",0,0,0,0,0,0,0,0
"Montenegro","2024-11-13",0,0,0,0,0,0,0,0
"Montenegro","2024-11-14",0,0,0,0,0,0,0,0
"Montenegro","2024-11-15",0,0,0,0,0,0,0,0
"Montenegro","2024-11-16",0,0,0,0,0,0,0,0
"Montenegro","2024-11-17",0,0,0,0,0,0,0,0
"Montenegro","2024-11-18",0,0,0,0,0,0,0,0
"Montenegro","2024-11-19",0,0,0,0,0,0,0,0
"Montenegro","2024-11-20",0,0,0,0,0,0,0,0
"Montenegro","2024-11-21",0,0,0,0,0,0,0,0
"Montenegro","2024-11-22",0,0,0,0,0,0,0,0
"Montenegro","2024-11-23",0,0,0,0,0,0,0,0
"Montenegro","2024-11-24",0,0,0,0,0,0,0,0
"Montenegro","2024-11-25",0,0,0,0,0,0,0,0
"Montenegro","2024-11-26",0,0,0,0,0,0,0,0
"Montenegro","2024-11-27",0,0,0,0,0,0,0,0
"Montenegro","2024-11-28",0,0,0,0,0,0,0,0
"Montenegro","2024-11-29",0,0,0,0,0,0,0,0
"Montenegro","2024-11-30",0,0,0,0,0,0,0,0
"Montenegro","2024-12-01",0,0,0,0,0,0,0,0
"Montenegro","2024-12-02",0,0,0,0,0,0,0,0
"Montenegro","2024-12-03",0,0,0,0,0,0,0,0
"Montenegro","2024-12-04",0,0,0,0,0,0,0,0
"Montenegro","2024-12-05",0,0,0,0,0,0,0,0
"Montenegro","2024-12-06",0,0,0,0,0,0,0,0
"Montenegro","2024-12-07",0,0,0,0,0,0,0,0
"Montenegro","2024-12-08",0,0,0,0,0,0,0,0
"Montenegro","2024-12-09",0,0,0,0,0,0,0,0
"Montenegro","2024-12-10",0,0,0,0,0,0,0,0
"Montenegro","2024-12-11",0,0,0,0,0,0,0,0
"Montenegro","2024-12-12",0,0,0,0,0,0,0,0
"Montenegro","2024-12-13",0,0,0,0,0,0,0,0
"Montenegro","2024-12-14",0,0,0,0,0,0,0,0
"Montenegro","2024-12-15",0,0,0,0,0,0,0,0
"Montenegro","2024-12-16",0,0,0,0,0,0,0,0
"Montenegro","2024-12-17",0,0,0,0,0,0,0,0
"Montenegro","2024-12-18",0,0,0,0,0,0,0,0
"Montenegro","2024-12-19",0,0,0,0,0,0,0,0
"Montenegro","2024-12-20",0,0,0,0,0,0,0,0
"Montenegro","2024-12-21",0,0,0,0,0,0,0,0
"Montenegro","2024-12-22",0,0,0,0,0,0,0,0
"Montenegro","2024-12-23",0,0,0,0,0,0,0,0
"Montenegro","2024-12-24",0,0,0,0,0,0,0,0
"Montenegro","2024-12-25",0,0,0,0,0,0,0,0
"Montenegro","2024-12-26",0,0,0,0,0,0,0,0
"Montenegro","2024-12-27",0,0,0,0,0,0,0,0
"Montenegro","2024-12-28",0,0,0,0,0,0,0,0
"Montenegro","2024-12-29",0,0,0,0,0,0,0,0
"Montenegro","2024-12-30",0,0,0,0,0,0,0,0
"Montenegro","2024-12-31",0,0,0,0,0,0,0,0
"Montenegro","2025-01-01",0,0,0,0,0,0,0,0
"Montenegro","2025-01-02",0,0,0,0,0,0,0,0
"Montenegro","2025-01-03",0,0,0,0,0,0,0,0
"Montenegro","2025-01-04",0,0,0,0,0,0,0,0
"Montenegro","2025-01-05",0,0,0,0,0,0,0,0
"Montenegro","2025-01-06",0,0,0,0,0,0,0,0
"Montenegro","2025-01-07",0,0,0,0,0,0,0,0
"Montenegro","2025-01-08",0,0,0,0,0,0,0,0
"Montenegro","2025-01-09",0,0,0,0,0,0,0,0
"Montenegro","2025-01-10",0,0,0,0,0,0,0,0
"Montenegro","2025-01-11",0,0,0,0,0,0,0,0
"Montenegro","2025-01-12",0,0,0,0,0,0,0,0
"Montenegro","2025-01-13",0,0,0,0,0,0,0,0
"Montenegro","2025-01-14",0,0,0,0,0,0,0,0
"Montenegro","2025-01-15",0,0,0,0,0,0,0,0
"Montenegro","2025-01-16",0,0,0,0,0,0,0,0
"Montenegro","2025-01-17",0,0,0,0,0,0,0,0
"Montenegro","2025-01-18",0,0,0,0,0,0,0,0
"Montenegro","2025-01-19",0,0,0,0,0,0,0,0
"Montenegro","2025-01-20",0,0,0,0,0,0,0,0
"Montenegro","2025-01-21",0,0,0,0,0,0,0,0
"Montenegro","2025-01-22",0,0,0,0,0,0,0,0
"Montenegro","2025-01-23",0,0,0,0,0,0,0,0
"Montenegro","2025-01-24",0,0,0,0,0,0,0,0
"Montenegro","2025-01-25",0,0,0,0,0,0,0,0
"Montenegro","2025-01-26",0,0,0,0,0,0,0,0
"Montenegro","2025-01-27",0,0,0,0,0,0,0,0
"Montenegro","2025-01-28",0,0,0,0,0,0,0,0
"Montenegro","2025-01-29",0,0,0,0,0,0,0,0
"Montenegro","2025-01-30",0,0,0,0,0,0,0,0
"Montenegro","2025-01-31",0,0,0,0,0,0,0,0
"Montenegro","2025-02-01",0,0,0,0,0,0,0,0
"Montenegro","2025-02-02",0,0,0,0,0,0,0,0
"Montenegro","2025-02-03",0,0,0,0,0,0,0,0
"Morocco","2024-01-01",0,0,0,0,0,0,0,0
"Morocco","2024-01-02",0,0,0,0,0,0,0,0
"Morocco","2024-01-03",0,0,0,0,0,0,0,0
"Morocco","2024-01-04",0,0,0,0,0,0,0,0
"Morocco","2024-01-05",0,0,0,0,0,0,0,0
"Morocco","2024-01-06",0,0,0,0,0,0,0,0
"Morocco","2024-01-07",0,0,0,0,0,0,0,0
"Morocco","2024-01-08",0,0,0,0,0,0,0,0
"Morocco","2024-01-09",0,0,0,0,0,0,0,0
"Morocco","2024-01-10",0,0,0,0,0,0,0,0
"Morocco","2024-01-11",0,0,0,0,0,0,0,0
"Morocco","2024-01-12",0,0,0,0,0,0,0,0
"Morocco","2024-01-13",0,0,0,0,0,0,0,0
"Morocco","2024-01-14",0,0,0,0,0,0,0,0
"Morocco","2024-01-15",0,0,0,0,0,0,0,0
"Morocco","2024-01-16",0,0,0,0,0,0,0,0
"Morocco","2024-01-17",0,0,0,0,0,0,0,0
"Morocco","2024-01-18",0,0,0,0,0,0,0,0
"Morocco","2024-01-19",0,0,0,0,0,0,0,0
"Morocco","2024-01-20",0,0,0,0,0,0,0,0
"Morocco","2024-01-21",0,0,0,0,0,0,0,0
"Morocco","2024-01-22",0,0,0,0,0,0,0,0
"Morocco","2024-01-23",0,0,0,0,0,0,0,0
"Morocco","2024-01-24",0,0,0,0,0,0,0,0
"Morocco","2024-01-25",0,0,0,0,0,0,0,0
"Morocco","2024-01-26",0,0,0,0,0,0,0,0
"Morocco","2024-01-27",0,0,0,0,0,0,0,0
"Morocco","2024-01-28",0,0,0,0,0,0,0,0
"Morocco","2024-01-29",0,0,0,0,0,0,0,0
"Morocco","2024-01-30",0,0,0,0,0,0,0,0
"Morocco","2024-01-31",0,0,0,0,0,0,0,0
"Morocco","2024-02-01",0,0,0,0,0,0,0,0
"Morocco","2024-02-02",0,0,0,0,0,0,0,0
"Morocco","2024-02-03",0,0,0,0,0,0,0,0
"Morocco","2024-02-04",0,0,0,0,0,0,0,0
"Morocco","2024-02-05",0,0,0,0,0,0,0,0
"Morocco","2024-02-06",0,0,0,0,0,0,0,0
"Morocco","2024-02-07",0,0,0,0,0,0,0,0
"Morocco","2024-02-08",0,0,0,0,0,0,0,0
"Morocco","2024-02-09",0,0,0,0,0,0,0,0
"Morocco","2024-02-10",0,0,0,0,0,0,0,0
"Morocco","2024-02-11",0,0,0,0,0,0,0,0
"Morocco","2024-02-12",0,0,0,0,0,0,0,0
"Morocco","2024-02-13",0,0,0,0,0,0,0,0
"Morocco","2024-02-14",0,0,0,0,0,0,0,0
"Morocco","2024-02-15",0,0,0,0,0,0,0,0
"Morocco","2024-02-16",0,0,0,0,0,0,0,0
"Morocco","2024-02-17",0,0,0,0,0,0,0,0
"Morocco","2024-02-18",0,0,0,0,0,0,0,0
"Morocco","2024-02-19",0,0,0,0,0,0,0,0
"Morocco","2024-02-20",0,0,0,0,0,0,0,0
"Morocco","2024-02-21",0,0,0,0,0,0,0,0
"Morocco","2024-02-22",0,0,0,0,0,0,0,0
"Morocco","2024-02-23",0,0,0,0,0,0,0,0
"Morocco","2024-02-24",0,0,0,0,0,0,0,0
"Morocco","2024-02-25",0,0,0,0,0,0,0,0
"Morocco","2024-02-26",0,0,0,0,0,0,0,0
"Morocco","2024-02-27",0,0,0,0,0,0,0,0
"Morocco","2024-02-28",0,0,0,0,0,0,0,0
"Morocco","2024-02-29",0,0,0,0,0,0,0,0
"Morocco","2024-03-01",0,0,0,0,0,0,0,0
"Morocco","2024-03-02",0,0,0,0,0,0,0,0
"Morocco","2024-03-03",0,0,0,0,0,0,0,0
"Morocco","2024-03-04",0,0,0,0,0,0,0,0
"Morocco","2024-03-05",0,0,0,0,0,0,0,0
"Morocco","2024-03-06",0,0,0,0,0,0,0,0
"Morocco","2024-03-07",0,0,0,0,0,0,0,0
"Morocco","2024-03-08",0,0,0,0,0,0,0,0
"Morocco","2024-03-09",0,0,0,0,0,0,0,0
"Morocco","2024-03-10",0,0,0,0,0,0,0,0
"Morocco","2024-03-11",0,0,0,0,0,0,0,0
"Morocco","2024-03-12",0,0,0,0,0,0,0,0
"Morocco","2024-03-13",0,0,0,0,0,0,0,0
"Morocco","2024-03-14",0,0,0,0,0,0,0,0
"Morocco","2024-03-15",0,1,1,0,1,1,0,0
"Morocco","2024-03-16",0,0,1,0,0,1,0,0
"Morocco","2024-03-17",0,0,1,0,0,1,0,0
"Morocco","2024-03-18",0,0,1,0,0,1,0,0
"Morocco","2024-03-19",0,0,1,0,0,1,0,0
"Morocco","2024-03-20",0,0,1,0,0,1,0,0
"Morocco","2024-03-21",0,0,1,0,0,1,0,0
"Morocco","2024-03-22",0,0,1,0,0,1,0,0
"Morocco","2024-03-23",0,0,1,0,0,1,0,0
"Morocco","2024-03-24",0,0,1,0,0,1,0,0
"Morocco","2024-03-25",0,0,1,0,0,1,0,0
"Morocco","2024-03-26",0,0,1,0,0,1,0,0
"Morocco","2024-03-27",0,0,1,0,0,1,0,0
"Morocco","2024-03-28",0,0,1,0,0,1,0,0
"Morocco","2024-03-29",0,0,1,0,0,1,0,0
"Morocco","2024-03-30",0,0,1,0,0,1,0,0
"Morocco","2024-03-31",0,0,1,0,0,1,0,0
"Morocco","2024-04-01",0,0,1,0,0,1,0,0
"Morocco","2024-04-02",0,0,1,0,0,1,0,0
"Morocco","2024-04-03",0,0,1,0,0,1,0,0
"Morocco","2024-04-04",0,0,1,0,0,1,0,0
"Morocco","2024-04-05",0,0,1,0,0,1,0,0
"Morocco","2024-04-06",0,0,1,0,0,1,0,0
"Morocco","2024-04-07",0,0,1,0,0,1,0,0
"Morocco","2024-04-08",0,0,1,0,0,1,0,0
"Morocco","2024-04-09",0,0,1,0,0,1,0,0
"Morocco","2024-04-10",0,0,1,0,0,1,0,0
"Morocco","2024-04-11",0,0,1,0,0,1,0,0
"Morocco","2024-04-12",0,0,1,0,0,1,0,0
"Morocco","2024-04-13",0,0,1,0,0,1,0,0
"Morocco","2024-04-14",0,0,1,0,0,1,0,0
"Morocco","2024-04-15",0,0,1,0,0,1,0,0
"Morocco","2024-04-16",0,0,1,0,0,1,0,0
"Morocco","2024-04-17",0,0,1,0,0,1,0,0
"Morocco","2024-04-18",0,0,1,0,0,1,0,0
"Morocco","2024-04-19",0,0,1,0,0,1,0,0
"Morocco","2024-04-20",0,0,1,0,0,1,0,0
"Morocco","2024-04-21",0,0,1,0,0,1,0,0
"Morocco","2024-04-22",0,0,1,0,0,1,0,0
"Morocco","2024-04-23",0,0,1,0,0,1,0,0
"Morocco","2024-04-24",0,0,1,0,0,1,0,0
"Morocco","2024-04-25",0,0,1,0,0,1,0,0
"Morocco","2024-04-26",0,0,1,0,0,1,0,0
"Morocco","2024-04-27",0,0,1,0,0,1,0,0
"Morocco","2024-04-28",0,0,1,0,0,1,0,0
"Morocco","2024-04-29",0,0,1,0,0,1,0,0
"Morocco","2024-04-30",0,0,1,0,0,1,0,0
"Morocco","2024-05-01",0,0,1,0,0,1,0,0
"Morocco","2024-05-02",0,0,1,0,0,1,0,0
"Morocco","2024-05-03",0,0,1,0,0,1,0,0
"Morocco","2024-05-04",0,0,1,0,0,1,0,0
"Morocco","2024-05-05",0,0,1,0,0,1,0,0
"Morocco","2024-05-06",0,0,1,0,0,1,0,0
"Morocco","2024-05-07",0,0,1,0,0,1,0,0
"Morocco","2024-05-08",0,0,1,0,0,1,0,0
"Morocco","2024-05-09",0,0,1,0,0,1,0,0
"Morocco","2024-05-10",0,0,1,0,0,1,0,0
"Morocco","2024-05-11",0,0,1,0,0,1,0,0
"Morocco","2024-05-12",0,0,1,0,0,1,0,0
"Morocco","2024-05-13",0,0,1,0,0,1,0,0
"Morocco","2024-05-14",0,0,1,0,0,1,0,0
"Morocco","2024-05-15",0,0,1,0,0,1,0,0
"Morocco","2024-05-16",0,0,1,0,0,1,0,0
"Morocco","2024-05-17",0,0,1,0,0,1,0,0
"Morocco","2024-05-18",0,0,1,0,0,1,0,0
"Morocco","2024-05-19",0,0,1,0,0,1,0,0
"Morocco","2024-05-20",0,0,1,0,0,1,0,0
"Morocco","2024-05-21",0,0,1,0,0,1,0,0
"Morocco","2024-05-22",0,0,1,0,0,1,0,0
"Morocco","2024-05-23",0,0,1,0,0,1,0,0
"Morocco","2024-05-24",0,0,1,0,0,1,0,0
"Morocco","2024-05-25",0,0,1,0,0,1,0,0
"Morocco","2024-05-26",0,0,1,0,0,1,0,0
"Morocco","2024-05-27",0,0,1,0,0,1,0,0
"Morocco","2024-05-28",0,0,1,0,0,1,0,0
"Morocco","2024-05-29",0,0,1,0,0,1,0,0
"Morocco","2024-05-30",0,0,1,0,0,1,0,0
"Morocco","2024-05-31",0,0,1,0,0,1,0,0
"Morocco","2024-06-01",0,0,1,0,0,1,0,0
"Morocco","2024-06-02",0,0,1,0,0,1,0,0
"Morocco","2024-06-03",0,0,1,0,0,1,0,0
"Morocco","2024-06-04",0,0,1,0,0,1,0,0
"Morocco","2024-06-05",0,0,1,0,0,1,0,0
"Morocco","2024-06-06",0,0,1,0,0,1,0,0
"Morocco","2024-06-07",0,0,1,0,0,1,0,0
"Morocco","2024-06-08",0,0,1,0,0,1,0,0
"Morocco","2024-06-09",0,0,1,0,0,1,0,0
"Morocco","2024-06-10",0,0,1,0,0,1,0,0
"Morocco","2024-06-11",0,0,1,0,0,1,0,0
"Morocco","2024-06-12",0,0,1,0,0,1,0,0
"Morocco","2024-06-13",0,0,1,0,0,1,0,0
"Morocco","2024-06-14",0,0,1,0,1,2,0,0
"Morocco","2024-06-15",0,0,1,0,0,2,0,0
"Morocco","2024-06-16",0,0,1,0,0,2,0,0
"Morocco","2024-06-17",0,0,1,0,0,2,0,0
"Morocco","2024-06-18",0,0,1,0,0,2,0,0
"Morocco","2024-06-19",0,0,1,0,0,2,0,0
"Morocco","2024-06-20",0,0,1,0,0,2,0,0
"Morocco","2024-06-21",0,0,1,0,0,2,0,0
"Morocco","2024-06-22",0,0,1,0,0,2,0,0
"Morocco","2024-06-23",0,0,1,0,0,2,0,0
"Morocco","2024-06-24",0,0,1,0,0,2,0,0
"Morocco","2024-06-25",0,0,1,0,0,2,0,0
"Morocco","2024-06-26",0,0,1,0,0,2,0,0
"Morocco","2024-06-27",0,0,1,0,0,2,0,0
"Morocco","2024-06-28",0,0,1,0,0,2,0,0
"Morocco","2024-06-29",0,0,1,0,0,2,0,0
"Morocco","2024-06-30",0,0,1,0,0,2,0,0
"Morocco","2024-07-01",0,0,1,0,0,2,0,0
"Morocco","2024-07-02",0,0,1,0,0,2,0,0
"Morocco","2024-07-03",0,0,1,0,0,2,0,0
"Morocco","2024-07-04",0,0,1,0,0,2,0,0
"Morocco","2024-07-05",0,0,1,0,0,2,0,0
"Morocco","2024-07-06",0,0,1,0,0,2,0,0
"Morocco","2024-07-07",0,0,1,0,0,2,0,0
"Morocco","2024-07-08",0,0,1,0,0,2,0,0
"Morocco","2024-07-09",0,0,1,0,0,2,0,0
"Morocco","2024-07-10",0,0,1,0,0,2,0,0
"Morocco","2024-07-11",0,0,1,0,0,2,0,0
"Morocco","2024-07-12",0,0,1,0,0,2,0,0
"Morocco","2024-07-13",0,0,1,0,0,2,0,0
"Morocco","2024-07-14",0,0,1,0,0,2,0,0
"Morocco","2024-07-15",0,0,1,0,0,2,0,0
"Morocco","2024-07-16",0,0,1,0,0,2,0,0
"Morocco","2024-07-17",0,0,1,0,0,2,0,0
"Morocco","2024-07-18",0,0,1,0,0,2,0,0
"Morocco","2024-07-19",0,0,1,0,0,2,0,0
"Morocco","2024-07-20",0,0,1,0,0,2,0,0
"Morocco","2024-07-21",0,0,1,0,0,2,0,0
"Morocco","2024-07-22",0,0,1,0,0,2,0,0
"Morocco","2024-07-23",0,0,1,0,0,2,0,0
"Morocco","2024-07-24",0,0,1,0,0,2,0,0
"Morocco","2024-07-25",0,0,1,0,0,2,0,0
"Morocco","2024-07-26",0,0,1,0,0,2,0,0
"Morocco","2024-07-27",0,0,1,0,0,2,0,0
"Morocco","2024-07-28",0,0,1,0,0,2,0,0
"Morocco","2024-07-29",0,0,1,0,0,2,0,0
"Morocco","2024-07-30",0,0,1,0,0,2,0,0
"Morocco","2024-07-31",0,0,1,0,0,2,0,0
"Morocco","2024-08-01",0,0,1,0,0,2,0,0
"Morocco","2024-08-02",0,0,1,0,0,2,0,0
"Morocco","2024-08-03",0,0,1,0,0,2,0,0
"Morocco","2024-08-04",0,0,1,0,0,2,0,0
"Morocco","2024-08-05",0,0,1,0,0,2,0,0
"Morocco","2024-08-06",0,0,1,0,0,2,0,0
"Morocco","2024-08-07",0,0,1,0,0,2,0,0
"Morocco","2024-08-08",0,0,1,0,0,2,0,0
"Morocco","2024-08-09",0,0,1,0,0,2,0,0
"Morocco","2024-08-10",0,0,1,0,0,2,0,0
"Morocco","2024-08-11",0,0,1,0,0,2,0,0
"Morocco","2024-08-12",0,0,1,0,0,2,0,0
"Morocco","2024-08-13",0,0,1,0,0,2,0,0
"Morocco","2024-08-14",0,0,1,0,0,2,0,0
"Morocco","2024-08-15",0,0,1,0,0,2,0,0
"Morocco","2024-08-16",0,0,1,0,0,2,0,0
"Morocco","2024-08-17",0,0,1,0,0,2,0,0
"Morocco","2024-08-18",0,0,1,0,0,2,0,0
"Morocco","2024-08-19",0,0,1,0,0,2,0,0
"Morocco","2024-08-20",0,0,1,0,0,2,0,0
"Morocco","2024-08-21",0,0,1,0,0,2,0,0
"Morocco","2024-08-22",0,0,1,0,0,2,0,0
"Morocco","2024-08-23",0,0,1,0,0,2,0,0
"Morocco","2024-08-24",0,0,1,0,0,2,0,0
"Morocco","2024-08-25",0,0,1,0,0,2,0,0
"Morocco","2024-08-26",0,0,1,0,0,2,0,0
"Morocco","2024-08-27",0,0,1,0,0,2,0,0
"Morocco","2024-08-28",0,0,1,0,0,2,0,0
"Morocco","2024-08-29",0,0,1,0,0,2,0,0
"Morocco","2024-08-30",0,0,1,0,0,2,0,0
"Morocco","2024-08-31",0,0,1,0,0,2,0,0
"Morocco","2024-09-01",0,0,1,0,0,2,0,0
"Morocco","2024-09-02",0,0,1,0,0,2,0,0
"Morocco","2024-09-03",0,0,1,0,0,2,0,0
"Morocco","2024-09-04",0,0,1,0,0,2,0,0
"Morocco","2024-09-05",0,0,1,0,0,2,0,0
"Morocco","2024-09-06",0,0,1,0,0,2,0,0
"Morocco","2024-09-07",0,0,1,0,0,2,0,0
"Morocco","2024-09-08",0,0,1,0,0,2,0,0
"Morocco","2024-09-09",0,0,1,0,0,2,0,0
"Morocco","2024-09-10",0,0,1,0,0,2,0,0
"Morocco","2024-09-11",0,0,1,0,0,2,0,0
"Morocco","2024-09-12",0,1,2,0,0,2,0,0
"Morocco","2024-09-13",0,0,2,0,0,2,0,0
"Morocco","2024-09-14",0,0,2,0,0,2,0,0
"Morocco","2024-09-15",0,0,2,0,0,2,0,0
"Morocco","2024-09-16",0,0,2,0,0,2,0,0
"Morocco","2024-09-17",0,0,2,0,0,2,0,0
"Morocco","2024-09-18",0,0,2,0,0,2,0,0
"Morocco","2024-09-19",0,0,2,0,0,2,0,0
"Morocco","2024-09-20",0,0,2,0,0,2,0,0
"Morocco","2024-09-21",0,0,2,0,0,2,0,0
"Morocco","2024-09-22",0,0,2,0,0,2,0,0
"Morocco","2024-09-23",0,0,2,0,1,3,0,0
"Morocco","2024-09-24",0,0,2,0,0,3,0,0
"Morocco","2024-09-25",0,0,2,0,0,3,0,0
"Morocco","2024-09-26",0,0,2,0,0,3,0,0
"Morocco","2024-09-27",0,0,2,0,0,3,0,0
"Morocco","2024-09-28",0,0,2,0,0,3,0,0
"Morocco","2024-09-29",0,0,2,0,0,3,0,0
"Morocco","2024-09-30",0,0,2,0,0,3,0,0
"Morocco","2024-10-01",0,0,2,0,0,3,0,0
"Morocco","2024-10-02",0,0,2,0,0,3,0,0
"Morocco","2024-10-03",0,1,3,0,0,3,0,0
"Morocco","2024-10-04",0,0,3,0,0,3,0,0
"Morocco","2024-10-05",0,0,3,0,0,3,0,0
"Morocco","2024-10-06",0,0,3,0,0,3,0,0
"Morocco","2024-10-07",0,0,3,0,0,3,0,0
"Morocco","2024-10-08",0,0,3,0,0,3,0,0
"Morocco","2024-10-09",0,0,3,0,0,3,0,0
"Morocco","2024-10-10",0,0,3,0,0,3,0,0
"Morocco","2024-10-11",0,0,3,0,0,3,0,0
"Morocco","2024-10-12",0,0,3,0,0,3,0,0
"Morocco","2024-10-13",0,0,3,0,0,3,0,0
"Morocco","2024-10-14",0,0,3,0,0,3,0,0
"Morocco","2024-10-15",0,0,3,0,0,3,0,0
"Morocco","2024-10-16",0,0,3,0,0,3,0,0
"Morocco","2024-10-17",0,0,3,0,0,3,0,0
"Morocco","2024-10-18",0,0,3,0,0,3,0,0
"Morocco","2024-10-19",0,0,3,0,0,3,0,0
"Morocco","2024-10-20",0,0,3,0,0,3,0,0
"Morocco","2024-10-21",0,0,3,0,0,3,0,0
"Morocco","2024-10-22",0,0,3,0,0,3,0,0
"Morocco","2024-10-23",0,0,3,0,0,3,0,0
"Morocco","2024-10-24",0,0,3,0,0,3,0,0
"Morocco","2024-10-25",0,0,3,0,0,3,0,0
"Morocco","2024-10-26",0,0,3,0,0,3,0,0
"Morocco","2024-10-27",0,0,3,0,0,3,0,0
"Morocco","2024-10-28",0,0,3,0,0,3,0,0
"Morocco","2024-10-29",0,0,3,0,0,3,0,0
"Morocco","2024-10-30",0,0,3,0,0,3,0,0
"Morocco","2024-10-31",0,0,3,0,0,3,0,0
"Morocco","2024-11-01",0,0,3,0,0,3,0,0
"Morocco","2024-11-02",0,0,3,0,0,3,0,0
"Morocco","2024-11-03",0,0,3,0,0,3,0,0
"Morocco","2024-11-04",0,0,3,0,0,3,0,0
"Morocco","2024-11-05",0,0,3,0,0,3,0,0
"Morocco","2024-11-06",0,0,3,0,0,3,0,0
"Morocco","2024-11-07",0,0,3,0,0,3,0,0
"Morocco","2024-11-08",0,0,3,0,0,3,0,0
"Morocco","2024-11-09",0,0,3,0,0,3,0,0
"Morocco","2024-11-10",0,0,3,0,0,3,0,0
"Morocco","2024-11-11",0,0,3,0,0,3,0,0
"Morocco","2024-11-12",0,0,3,0,0,3,0,0
"Morocco","2024-11-13",0,0,3,0,0,3,0,0
"Morocco","2024-11-14",0,0,3,0,0,3,0,0
"Morocco","2024-11-15",0,0,3,0,0,3,0,0
"Morocco","2024-11-16",0,0,3,0,0,3,0,0
"Morocco","2024-11-17",0,0,3,0,0,3,0,0
"Morocco","2024-11-18",0,0,3,0,0,3,0,0
"Morocco","2024-11-19",0,0,3,0,0,3,0,0
"Morocco","2024-11-20",0,0,3,0,0,3,0,0
"Morocco","2024-11-21",0,0,3,0,0,3,0,0
"Morocco","2024-11-22",0,0,3,0,0,3,0,0
"Morocco","2024-11-23",0,0,3,0,0,3,0,0
"Morocco","2024-11-24",0,0,3,0,0,3,0,0
"Morocco","2024-11-25",0,0,3,0,0,3,0,0
"Morocco","2024-11-26",0,0,3,0,0,3,0,0
"Morocco","2024-11-27",0,0,3,0,0,3,0,0
"Morocco","2024-11-28",0,0,3,0,0,3,0,0
"Morocco","2024-11-29",0,0,3,0,0,3,0,0
"Morocco","2024-11-30",0,0,3,0,0,3,0,0
"Morocco","2024-12-01",0,0,3,0,0,3,0,0
"Morocco","2024-12-02",0,0,3,0,0,3,0,0
"Morocco","2024-12-03",0,0,3,0,0,3,0,0
"Morocco","2024-12-04",0,0,3,0,0,3,0,0
"Morocco","2024-12-05",0,0,3,0,0,3,0,0
"Morocco","2024-12-06",0,0,3,0,0,3,0,0
"Morocco","2024-12-07",0,0,3,0,0,3,0,0
"Morocco","2024-12-08",0,0,3,0,0,3,0,0
"Morocco","2024-12-09",0,0,3,0,0,3,0,0
"Morocco","2024-12-10",0,0,3,0,0,3,0,0
"Morocco","2024-12-11",0,0,3,0,0,3,0,0
"Morocco","2024-12-12",0,0,3,0,0,3,0,0
"Morocco","2024-12-13",0,0,3,0,0,3,0,0
"Morocco","2024-12-14",0,0,3,0,0,3,0,0
"Morocco","2024-12-15",0,0,3,0,0,3,0,0
"Morocco","2024-12-16",0,0,3,0,0,3,0,0
"Morocco","2024-12-17",0,0,3,0,0,3,0,0
"Morocco","2024-12-18",0,0,3,0,0,3,0,0
"Morocco","2024-12-19",0,0,3,0,0,3,0,0
"Morocco","2024-12-20",0,0,3,0,0,3,0,0
"Morocco","2024-12-21",0,0,3,0,0,3,0,0
"Morocco","2024-12-22",0,0,3,0,0,3,0,0
"Morocco","2024-12-23",0,0,3,0,0,3,0,0
"Morocco","2024-12-24",0,0,3,0,0,3,0,0
"Morocco","2024-12-25",0,0,3,0,0,3,0,0
"Morocco","2024-12-26",0,0,3,0,0,3,0,0
"Morocco","2024-12-27",0,0,3,0,0,3,0,0
"Morocco","2024-12-28",0,0,3,0,0,3,0,0
"Morocco","2024-12-29",0,0,3,0,0,3,0,0
"Morocco","2024-12-30",0,0,3,0,0,3,0,0
"Morocco","2024-12-31",0,0,3,0,0,3,0,0
"Morocco","2025-01-01",0,0,3,0,0,3,0,0
"Morocco","2025-01-02",0,0,3,0,0,3,0,0
"Morocco","2025-01-03",0,0,3,0,0,3,0,0
"Morocco","2025-01-04",0,0,3,0,0,3,0,0
"Morocco","2025-01-05",0,0,3,0,0,3,0,0
"Morocco","2025-01-06",0,0,3,0,0,3,0,0
"Morocco","2025-01-07",0,0,3,0,0,3,0,0
"Morocco","2025-01-08",0,0,3,0,0,3,0,0
"Morocco","2025-01-09",0,0,3,0,0,3,0,0
"Morocco","2025-01-10",0,0,3,0,0,3,0,0
"Morocco","2025-01-11",0,0,3,0,0,3,0,0
"Morocco","2025-01-12",0,0,3,0,0,3,0,0
"Morocco","2025-01-13",0,0,3,0,0,3,0,0
"Morocco","2025-01-14",0,0,3,0,0,3,0,0
"Morocco","2025-01-15",0,0,3,0,0,3,0,0
"Morocco","2025-01-16",0,0,3,0,0,3,0,0
"Morocco","2025-01-17",0,0,3,0,0,3,0,0
"Morocco","2025-01-18",0,0,3,0,0,3,0,0
"Morocco","2025-01-19",0,0,3,0,0,3,0,0
"Morocco","2025-01-20",0,0,3,0,0,3,0,0
"Morocco","2025-01-21",0,0,3,0,0,3,0,0
"Morocco","2025-01-22",0,0,3,0,0,3,0,0
"Morocco","2025-01-23",0,0,3,0,0,3,0,0
"Morocco","2025-01-24",0,0,3,0,0,3,0,0
"Morocco","2025-01-25",0,0,3,0,0,3,0,0
"Morocco","2025-01-26",0,0,3,0,0,3,0,0
"Morocco","2025-01-27",0,0,3,0,0,3,0,0
"Morocco","2025-01-28",0,0,3,0,0,3,0,0
"Morocco","2025-01-29",0,0,3,0,0,3,0,0
"Morocco","2025-01-30",0,0,3,0,0,3,0,0
"Morocco","2025-01-31",0,0,3,0,0,3,0,0
"Morocco","2025-02-01",0,0,3,0,0,3,0,0
"Morocco","2025-02-02",0,0,3,0,0,3,0,0
"Morocco","2025-02-03",0,0,3,0,0,3,0,0
"Mozambique","2024-01-01",0,0,0,0,0,0,0,0
"Mozambique","2024-01-02",0,0,0,0,0,0,0,0
"Mozambique","2024-01-03",0,0,0,0,0,0,0,0
"Mozambique","2024-01-04",0,0,0,0,0,0,0,0
"Mozambique","2024-01-05",0,0,0,0,0,0,0,0
"Mozambique","2024-01-06",0,0,0,0,0,0,0,0
"Mozambique","2024-01-07",0,0,0,0,0,0,0,0
"Mozambique","2024-01-08",0,0,0,0,0,0,0,0
"Mozambique","2024-01-09",0,0,0,0,0,0,0,0
"Mozambique","2024-01-10",0,0,0,0,0,0,0,0
"Mozambique","2024-01-11",0,0,0,0,0,0,0,0
"Mozambique","2024-01-12",0,0,0,0,0,0,0,0
"Mozambique","2024-01-13",0,0,0,0,0,0,0,0
"Mozambique","2024-01-14",0,0,0,0,0,0,0,0
"Mozambique","2024-01-15",0,0,0,0,0,0,0,0
"Mozambique","2024-01-16",0,0,0,0,0,0,0,0
"Mozambique","2024-01-17",0,0,0,0,0,0,0,0
"Mozambique","2024-01-18",0,0,0,0,0,0,0,0
"Mozambique","2024-01-19",0,0,0,0,0,0,0,0
"Mozambique","2024-01-20",0,0,0,0,0,0,0,0
"Mozambique","2024-01-21",0,0,0,0,0,0,0,0
"Mozambique","2024-01-22",0,0,0,0,0,0,0,0
"Mozambique","2024-01-23",0,0,0,0,0,0,0,0
"Mozambique","2024-01-24",0,0,0,0,0,0,0,0
"Mozambique","2024-01-25",0,0,0,0,0,0,0,0
"Mozambique","2024-01-26",0,0,0,0,0,0,0,0
"Mozambique","2024-01-27",0,0,0,0,0,0,0,0
"Mozambique","2024-01-28",0,0,0,0,0,0,0,0
"Mozambique","2024-01-29",0,0,0,0,0,0,0,0
"Mozambique","2024-01-30",0,0,0,0,0,0,0,0
"Mozambique","2024-01-31",0,0,0,0,0,0,0,0
"Mozambique","2024-02-01",0,0,0,0,0,0,0,0
"Mozambique","2024-02-02",0,0,0,0,0,0,0,0
"Mozambique","2024-02-03",0,0,0,0,0,0,0,0
"Mozambique","2024-02-04",0,0,0,0,0,0,0,0
"Mozambique","2024-02-05",0,0,0,0,0,0,0,0
"Mozambique","2024-02-06",0,0,0,0,0,0,0,0
"Mozambique","2024-02-07",0,0,0,0,0,0,0,0
"Mozambique","2024-02-08",0,0,0,0,0,0,0,0
"Mozambique","2024-02-09",0,0,0,0,0,0,0,0
"Mozambique","2024-02-10",0,0,0,0,0,0,0,0
"Mozambique","2024-02-11",0,0,0,0,0,0,0,0
"Mozambique","2024-02-12",0,0,0,0,0,0,0,0
"Mozambique","2024-02-13",0,0,0,0,0,0,0,0
"Mozambique","2024-02-14",0,0,0,0,0,0,0,0
"Mozambique","2024-02-15",0,0,0,0,0,0,0,0
"Mozambique","2024-02-16",0,0,0,0,0,0,0,0
"Mozambique","2024-02-17",0,0,0,0,0,0,0,0
"Mozambique","2024-02-18",0,0,0,0,0,0,0,0
"Mozambique","2024-02-19",0,0,0,0,0,0,0,0
"Mozambique","2024-02-20",0,0,0,0,0,0,0,0
"Mozambique","2024-02-21",0,0,0,0,0,0,0,0
"Mozambique","2024-02-22",0,0,0,0,0,0,0,0
"Mozambique","2024-02-23",0,0,0,0,0,0,0,0
"Mozambique","2024-02-24",0,0,0,0,0,0,0,0
"Mozambique","2024-02-25",0,0,0,0,0,0,0,0
"Mozambique","2024-02-26",0,0,0,0,0,0,0,0
"Mozambique","2024-02-27",0,0,0,0,0,0,0,0
"Mozambique","2024-02-28",0,0,0,0,0,0,0,0
"Mozambique","2024-02-29",0,0,0,0,0,0,0,0
"Mozambique","2024-03-01",0,0,0,0,0,0,0,0
"Mozambique","2024-03-02",0,0,0,0,0,0,0,0
"Mozambique","2024-03-03",0,0,0,0,0,0,0,0
"Mozambique","2024-03-04",0,0,0,0,0,0,0,0
"Mozambique","2024-03-05",0,0,0,0,0,0,0,0
"Mozambique","2024-03-06",0,0,0,0,0,0,0,0
"Mozambique","2024-03-07",0,0,0,0,0,0,0,0
"Mozambique","2024-03-08",0,0,0,0,0,0,0,0
"Mozambique","2024-03-09",0,0,0,0,0,0,0,0
"Mozambique","2024-03-10",0,0,0,0,0,0,0,0
"Mozambique","2024-03-11",0,0,0,0,0,0,0,0
"Mozambique","2024-03-12",0,0,0,0,0,0,0,0
"Mozambique","2024-03-13",0,0,0,0,0,0,0,0
"Mozambique","2024-03-14",0,0,0,0,0,0,0,0
"Mozambique","2024-03-15",0,0,0,0,0,0,0,0
"Mozambique","2024-03-16",0,0,0,0,0,0,0,0
"Mozambique","2024-03-17",0,0,0,0,0,0,0,0
"Mozambique","2024-03-18",0,0,0,0,0,0,0,0
"Mozambique","2024-03-19",0,0,0,0,0,0,0,0
"Mozambique","2024-03-20",0,0,0,0,0,0,0,0
"Mozambique","2024-03-21",0,0,0,0,0,0,0,0
"Mozambique","2024-03-22",0,0,0,0,0,0,0,0
"Mozambique","2024-03-23",0,0,0,0,0,0,0,0
"Mozambique","2024-03-24",0,0,0,0,0,0,0,0
"Mozambique","2024-03-25",0,0,0,0,0,0,0,0
"Mozambique","2024-03-26",0,0,0,0,0,0,0,0
"Mozambique","2024-03-27",0,0,0,0,0,0,0,0
"Mozambique","2024-03-28",0,0,0,0,0,0,0,0
"Mozambique","2024-03-29",0,0,0,0,0,0,0,0
"Mozambique","2024-03-30",0,0,0,0,0,0,0,0
"Mozambique","2024-03-31",0,0,0,0,0,0,0,0
"Mozambique","2024-04-01",0,0,0,0,0,0,0,0
"Mozambique","2024-04-02",0,0,0,0,0,0,0,0
"Mozambique","2024-04-03",0,0,0,0,0,0,0,0
"Mozambique","2024-04-04",0,0,0,0,0,0,0,0
"Mozambique","2024-04-05",0,0,0,0,0,0,0,0
"Mozambique","2024-04-06",0,0,0,0,0,0,0,0
"Mozambique","2024-04-07",0,0,0,0,0,0,0,0
"Mozambique","2024-04-08",0,0,0,0,0,0,0,0
"Mozambique","2024-04-09",0,0,0,0,0,0,0,0
"Mozambique","2024-04-10",0,0,0,0,0,0,0,0
"Mozambique","2024-04-11",0,0,0,0,0,0,0,0
"Mozambique","2024-04-12",0,0,0,0,0,0,0,0
"Mozambique","2024-04-13",0,0,0,0,0,0,0,0
"Mozambique","2024-04-14",0,0,0,0,0,0,0,0
"Mozambique","2024-04-15",0,0,0,0,0,0,0,0
"Mozambique","2024-04-16",0,0,0,0,0,0,0,0
"Mozambique","2024-04-17",0,0,0,0,0,0,0,0
"Mozambique","2024-04-18",0,0,0,0,0,0,0,0
"Mozambique","2024-04-19",0,0,0,0,0,0,0,0
"Mozambique","2024-04-20",0,0,0,0,0,0,0,0
"Mozambique","2024-04-21",0,0,0,0,0,0,0,0
"Mozambique","2024-04-22",0,0,0,0,0,0,0,0
"Mozambique","2024-04-23",0,0,0,0,0,0,0,0
"Mozambique","2024-04-24",0,0,0,0,0,0,0,0
"Mozambique","2024-04-25",0,0,0,0,0,0,0,0
"Mozambique","2024-04-26",0,0,0,0,0,0,0,0
"Mozambique","2024-04-27",0,0,0,0,0,0,0,0
"Mozambique","2024-04-28",0,0,0,0,0,0,0,0
"Mozambique","2024-04-29",0,0,0,0,0,0,0,0
"Mozambique","2024-04-30",0,0,0,0,0,0,0,0
"Mozambique","2024-05-01",0,0,0,0,0,0,0,0
"Mozambique","2024-05-02",0,0,0,0,0,0,0,0
"Mozambique","2024-05-03",0,0,0,0,0,0,0,0
"Mozambique","2024-05-04",0,0,0,0,0,0,0,0
"Mozambique","2024-05-05",0,0,0,0,0,0,0,0
"Mozambique","2024-05-06",0,0,0,0,0,0,0,0
"Mozambique","2024-05-07",0,0,0,0,0,0,0,0
"Mozambique","2024-05-08",0,0,0,0,0,0,0,0
"Mozambique","2024-05-09",0,0,0,0,0,0,0,0
"Mozambique","2024-05-10",0,0,0,0,0,0,0,0
"Mozambique","2024-05-11",0,0,0,0,0,0,0,0
"Mozambique","2024-05-12",0,0,0,0,0,0,0,0
"Mozambique","2024-05-13",0,0,0,0,0,0,0,0
"Mozambique","2024-05-14",0,0,0,0,0,0,0,0
"Mozambique","2024-05-15",0,0,0,0,0,0,0,0
"Mozambique","2024-05-16",0,0,0,0,0,0,0,0
"Mozambique","2024-05-17",0,0,0,0,0,0,0,0
"Mozambique","2024-05-18",0,0,0,0,0,0,0,0
"Mozambique","2024-05-19",0,0,0,0,0,0,0,0
"Mozambique","2024-05-20",0,0,0,0,0,0,0,0
"Mozambique","2024-05-21",0,0,0,0,0,0,0,0
"Mozambique","2024-05-22",0,0,0,0,0,0,0,0
"Mozambique","2024-05-23",0,0,0,0,0,0,0,0
"Mozambique","2024-05-24",0,0,0,0,0,0,0,0
"Mozambique","2024-05-25",0,0,0,0,0,0,0,0
"Mozambique","2024-05-26",0,0,0,0,0,0,0,0
"Mozambique","2024-05-27",0,0,0,0,0,0,0,0
"Mozambique","2024-05-28",0,0,0,0,0,0,0,0
"Mozambique","2024-05-29",0,0,0,0,0,0,0,0
"Mozambique","2024-05-30",0,0,0,0,0,0,0,0
"Mozambique","2024-05-31",0,0,0,0,0,0,0,0
"Mozambique","2024-06-01",0,0,0,0,0,0,0,0
"Mozambique","2024-06-02",0,0,0,0,0,0,0,0
"Mozambique","2024-06-03",0,0,0,0,0,0,0,0
"Mozambique","2024-06-04",0,0,0,0,0,0,0,0
"Mozambique","2024-06-05",0,0,0,0,0,0,0,0
"Mozambique","2024-06-06",0,0,0,0,0,0,0,0
"Mozambique","2024-06-07",0,0,0,0,0,0,0,0
"Mozambique","2024-06-08",0,0,0,0,0,0,0,0
"Mozambique","2024-06-09",0,0,0,0,0,0,0,0
"Mozambique","2024-06-10",0,0,0,0,0,0,0,0
"Mozambique","2024-06-11",0,0,0,0,0,0,0,0
"Mozambique","2024-06-12",0,0,0,0,0,0,0,0
"Mozambique","2024-06-13",0,0,0,0,0,0,0,0
"Mozambique","2024-06-14",0,0,0,0,0,0,0,0
"Mozambique","2024-06-15",0,0,0,0,0,0,0,0
"Mozambique","2024-06-16",0,0,0,0,0,0,0,0
"Mozambique","2024-06-17",0,0,0,0,0,0,0,0
"Mozambique","2024-06-18",0,0,0,0,0,0,0,0
"Mozambique","2024-06-19",0,0,0,0,0,0,0,0
"Mozambique","2024-06-20",0,0,0,0,0,0,0,0
"Mozambique","2024-06-21",0,0,0,0,0,0,0,0
"Mozambique","2024-06-22",0,0,0,0,0,0,0,0
"Mozambique","2024-06-23",0,0,0,0,0,0,0,0
"Mozambique","2024-06-24",0,0,0,0,0,0,0,0
"Mozambique","2024-06-25",0,0,0,0,0,0,0,0
"Mozambique","2024-06-26",0,0,0,0,0,0,0,0
"Mozambique","2024-06-27",0,0,0,0,0,0,0,0
"Mozambique","2024-06-28",0,0,0,0,0,0,0,0
"Mozambique","2024-06-29",0,0,0,0,0,0,0,0
"Mozambique","2024-06-30",0,0,0,0,0,0,0,0
"Mozambique","2024-07-01",0,0,0,0,0,0,0,0
"Mozambique","2024-07-02",0,0,0,0,0,0,0,0
"Mozambique","2024-07-03",0,0,0,0,0,0,0,0
"Mozambique","2024-07-04",0,0,0,0,0,0,0,0
"Mozambique","2024-07-05",0,0,0,0,0,0,0,0
"Mozambique","2024-07-06",0,0,0,0,0,0,0,0
"Mozambique","2024-07-07",0,0,0,0,0,0,0,0
"Mozambique","2024-07-08",0,0,0,0,0,0,0,0
"Mozambique","2024-07-09",0,0,0,0,0,0,0,0
"Mozambique","2024-07-10",0,0,0,0,0,0,0,0
"Mozambique","2024-07-11",0,0,0,0,0,0,0,0
"Mozambique","2024-07-12",0,0,0,0,0,0,0,0
"Mozambique","2024-07-13",0,0,0,0,0,0,0,0
"Mozambique","2024-07-14",0,0,0,0,0,0,0,0
"Mozambique","2024-07-15",0,0,0,0,0,0,0,0
"Mozambique","2024-07-16",0,0,0,0,0,0,0,0
"Mozambique","2024-07-17",0,0,0,0,0,0,0,0
"Mozambique","2024-07-18",0,0,0,0,0,0,0,0
"Mozambique","2024-07-19",0,0,0,0,0,0,0,0
"Mozambique","2024-07-20",0,0,0,0,0,0,0,0
"Mozambique","2024-07-21",0,0,0,0,0,0,0,0
"Mozambique","2024-07-22",0,0,0,0,0,0,0,0
"Mozambique","2024-07-23",0,0,0,0,0,0,0,0
"Mozambique","2024-07-24",0,0,0,0,0,0,0,0
"Mozambique","2024-07-25",0,0,0,0,0,0,0,0
"Mozambique","2024-07-26",0,0,0,0,0,0,0,0
"Mozambique","2024-07-27",0,0,0,0,0,0,0,0
"Mozambique","2024-07-28",0,0,0,0,0,0,0,0
"Mozambique","2024-07-29",0,0,0,0,0,0,0,0
"Mozambique","2024-07-30",0,0,0,0,0,0,0,0
"Mozambique","2024-07-31",0,0,0,0,0,0,0,0
"Mozambique","2024-08-01",0,0,0,0,0,0,0,0
"Mozambique","2024-08-02",0,0,0,0,0,0,0,0
"Mozambique","2024-08-03",0,0,0,0,0,0,0,0
"Mozambique","2024-08-04",0,0,0,0,0,0,0,0
"Mozambique","2024-08-05",0,0,0,0,0,0,0,0
"Mozambique","2024-08-06",0,0,0,0,0,0,0,0
"Mozambique","2024-08-07",0,0,0,0,0,0,0,0
"Mozambique","2024-08-08",0,0,0,0,0,0,0,0
"Mozambique","2024-08-09",0,0,0,0,0,0,0,0
"Mozambique","2024-08-10",0,0,0,0,0,0,0,0
"Mozambique","2024-08-11",0,0,0,0,0,0,0,0
"Mozambique","2024-08-12",0,0,0,0,0,0,0,0
"Mozambique","2024-08-13",0,0,0,0,0,0,0,0
"Mozambique","2024-08-14",0,0,0,0,0,0,0,0
"Mozambique","2024-08-15",0,0,0,0,0,0,0,0
"Mozambique","2024-08-16",0,0,0,0,0,0,0,0
"Mozambique","2024-08-17",0,0,0,0,0,0,0,0
"Mozambique","2024-08-18",0,0,0,0,0,0,0,0
"Mozambique","2024-08-19",0,0,0,0,0,0,0,0
"Mozambique","2024-08-20",0,0,0,0,0,0,0,0
"Mozambique","2024-08-21",0,0,0,0,0,0,0,0
"Mozambique","2024-08-22",0,0,0,0,0,0,0,0
"Mozambique","2024-08-23",0,0,0,0,0,0,0,0
"Mozambique","2024-08-24",0,0,0,0,0,0,0,0
"Mozambique","2024-08-25",0,0,0,0,0,0,0,0
"Mozambique","2024-08-26",0,0,0,0,0,0,0,0
"Mozambique","2024-08-27",0,0,0,0,0,0,0,0
"Mozambique","2024-08-28",0,0,0,0,0,0,0,0
"Mozambique","2024-08-29",0,0,0,0,0,0,0,0
"Mozambique","2024-08-30",0,0,0,0,0,0,0,0
"Mozambique","2024-08-31",0,0,0,0,0,0,0,0
"Mozambique","2024-09-01",0,0,0,0,0,0,0,0
"Mozambique","2024-09-02",0,0,0,0,0,0,0,0
"Mozambique","2024-09-03",0,0,0,0,0,0,0,0
"Mozambique","2024-09-04",0,0,0,0,0,0,0,0
"Mozambique","2024-09-05",0,0,0,0,0,0,0,0
"Mozambique","2024-09-06",0,0,0,0,0,0,0,0
"Mozambique","2024-09-07",0,0,0,0,0,0,0,0
"Mozambique","2024-09-08",0,0,0,0,0,0,0,0
"Mozambique","2024-09-09",0,0,0,0,0,0,0,0
"Mozambique","2024-09-10",0,0,0,0,0,0,0,0
"Mozambique","2024-09-11",0,0,0,0,0,0,0,0
"Mozambique","2024-09-12",0,0,0,0,0,0,0,0
"Mozambique","2024-09-13",0,0,0,0,0,0,0,0
"Mozambique","2024-09-14",0,0,0,0,0,0,0,0
"Mozambique","2024-09-15",0,0,0,0,0,0,0,0
"Mozambique","2024-09-16",0,0,0,0,0,0,0,0
"Mozambique","2024-09-17",0,0,0,0,0,0,0,0
"Mozambique","2024-09-18",0,0,0,0,0,0,0,0
"Mozambique","2024-09-19",0,0,0,0,0,0,0,0
"Mozambique","2024-09-20",0,0,0,0,0,0,0,0
"Mozambique","2024-09-21",0,0,0,0,0,0,0,0
"Mozambique","2024-09-22",0,0,0,0,0,0,0,0
"Mozambique","2024-09-23",0,0,0,0,0,0,0,0
"Mozambique","2024-09-24",0,0,0,0,0,0,0,0
"Mozambique","2024-09-25",0,0,0,0,0,0,0,0
"Mozambique","2024-09-26",0,0,0,0,0,0,0,0
"Mozambique","2024-09-27",0,0,0,0,0,0,0,0
"Mozambique","2024-09-28",0,0,0,0,0,0,0,0
"Mozambique","2024-09-29",0,0,0,0,0,0,0,0
"Mozambique","2024-09-30",0,0,0,0,0,0,0,0
"Mozambique","2024-10-01",0,0,0,0,0,0,0,0
"Mozambique","2024-10-02",0,0,0,0,0,0,0,0
"Mozambique","2024-10-03",0,0,0,0,0,0,0,0
"Mozambique","2024-10-04",0,0,0,0,0,0,0,0
"Mozambique","2024-10-05",0,0,0,0,0,0,0,0
"Mozambique","2024-10-06",0,0,0,0,0,0,0,0
"Mozambique","2024-10-07",0,0,0,0,0,0,0,0
"Mozambique","2024-10-08",0,0,0,0,0,0,0,0
"Mozambique","2024-10-09",0,0,0,0,0,0,0,0
"Mozambique","2024-10-10",0,0,0,0,0,0,0,0
"Mozambique","2024-10-11",0,0,0,0,0,0,0,0
"Mozambique","2024-10-12",0,0,0,0,0,0,0,0
"Mozambique","2024-10-13",0,0,0,0,0,0,0,0
"Mozambique","2024-10-14",0,0,0,0,0,0,0,0
"Mozambique","2024-10-15",0,0,0,0,0,0,0,0
"Mozambique","2024-10-16",0,0,0,0,0,0,0,0
"Mozambique","2024-10-17",0,0,0,0,0,0,0,0
"Mozambique","2024-10-18",0,0,0,0,0,0,0,0
"Mozambique","2024-10-19",0,0,0,0,0,0,0,0
"Mozambique","2024-10-20",0,0,0,0,0,0,0,0
"Mozambique","2024-10-21",0,0,0,0,0,0,0,0
"Mozambique","2024-10-22",0,0,0,0,0,0,0,0
"Mozambique","2024-10-23",0,0,0,0,0,0,0,0
"Mozambique","2024-10-24",0,0,0,0,0,0,0,0
"Mozambique","2024-10-25",0,0,0,0,0,0,0,0
"Mozambique","2024-10-26",0,0,0,0,0,0,0,0
"Mozambique","2024-10-27",0,0,0,0,0,0,0,0
"Mozambique","2024-10-28",0,0,0,0,0,0,0,0
"Mozambique","2024-10-29",0,0,0,0,0,0,0,0
"Mozambique","2024-10-30",0,0,0,0,0,0,0,0
"Mozambique","2024-10-31",0,0,0,0,0,0,0,0
"Mozambique","2024-11-01",0,0,0,0,0,0,0,0
"Mozambique","2024-11-02",0,0,0,0,0,0,0,0
"Mozambique","2024-11-03",0,0,0,0,0,0,0,0
"Mozambique","2024-11-04",0,0,0,0,0,0,0,0
"Mozambique","2024-11-05",0,0,0,0,0,0,0,0
"Mozambique","2024-11-06",0,0,0,0,0,0,0,0
"Mozambique","2024-11-07",0,0,0,0,0,0,0,0
"Mozambique","2024-11-08",0,0,0,0,0,0,0,0
"Mozambique","2024-11-09",0,0,0,0,0,0,0,0
"Mozambique","2024-11-10",0,0,0,0,0,0,0,0
"Mozambique","2024-11-11",0,0,0,0,0,0,0,0
"Mozambique","2024-11-12",0,0,0,0,0,0,0,0
"Mozambique","2024-11-13",0,0,0,0,0,0,0,0
"Mozambique","2024-11-14",0,0,0,0,0,0,0,0
"Mozambique","2024-11-15",0,0,0,0,0,0,0,0
"Mozambique","2024-11-16",0,0,0,0,0,0,0,0
"Mozambique","2024-11-17",0,0,0,0,0,0,0,0
"Mozambique","2024-11-18",0,0,0,0,0,0,0,0
"Mozambique","2024-11-19",0,0,0,0,0,0,0,0
"Mozambique","2024-11-20",0,0,0,0,0,0,0,0
"Mozambique","2024-11-21",0,0,0,0,0,0,0,0
"Mozambique","2024-11-22",0,0,0,0,0,0,0,0
"Mozambique","2024-11-23",0,0,0,0,0,0,0,0
"Mozambique","2024-11-24",0,0,0,0,0,0,0,0
"Mozambique","2024-11-25",0,0,0,0,0,0,0,0
"Mozambique","2024-11-26",0,0,0,0,0,0,0,0
"Mozambique","2024-11-27",0,0,0,0,0,0,0,0
"Mozambique","2024-11-28",0,0,0,0,0,0,0,0
"Mozambique","2024-11-29",0,0,0,0,0,0,0,0
"Mozambique","2024-11-30",0,0,0,0,0,0,0,0
"Mozambique","2024-12-01",0,0,0,0,0,0,0,0
"Mozambique","2024-12-02",0,0,0,0,0,0,0,0
"Mozambique","2024-12-03",0,0,0,0,0,0,0,0
"Mozambique","2024-12-04",0,0,0,0,0,0,0,0
"Mozambique","2024-12-05",0,0,0,0,0,0,0,0
"Mozambique","2024-12-06",0,0,0,0,0,0,0,0
"Mozambique","2024-12-07",0,0,0,0,0,0,0,0
"Mozambique","2024-12-08",0,0,0,0,0,0,0,0
"Mozambique","2024-12-09",0,0,0,0,0,0,0,0
"Mozambique","2024-12-10",0,0,0,0,0,0,0,0
"Mozambique","2024-12-11",0,0,0,0,0,0,0,0
"Mozambique","2024-12-12",0,0,0,0,0,0,0,0
"Mozambique","2024-12-13",0,0,0,0,0,0,0,0
"Mozambique","2024-12-14",0,0,0,0,0,0,0,0
"Mozambique","2024-12-15",0,0,0,0,0,0,0,0
"Mozambique","2024-12-16",0,0,0,0,0,0,0,0
"Mozambique","2024-12-17",0,0,0,0,0,0,0,0
"Mozambique","2024-12-18",0,0,0,0,0,0,0,0
"Mozambique","2024-12-19",0,0,0,0,0,0,0,0
"Mozambique","2024-12-20",0,0,0,0,0,0,0,0
"Mozambique","2024-12-21",0,0,0,0,0,0,0,0
"Mozambique","2024-12-22",0,0,0,0,0,0,0,0
"Mozambique","2024-12-23",0,0,0,0,0,0,0,0
"Mozambique","2024-12-24",0,0,0,0,0,0,0,0
"Mozambique","2024-12-25",0,0,0,0,0,0,0,0
"Mozambique","2024-12-26",0,0,0,0,0,0,0,0
"Mozambique","2024-12-27",0,0,0,0,0,0,0,0
"Mozambique","2024-12-28",0,0,0,0,0,0,0,0
"Mozambique","2024-12-29",0,0,0,0,0,0,0,0
"Mozambique","2024-12-30",0,0,0,0,0,0,0,0
"Mozambique","2024-12-31",0,0,0,0,0,0,0,0
"Mozambique","2025-01-01",0,0,0,0,0,0,0,0
"Mozambique","2025-01-02",0,0,0,0,0,0,0,0
"Mozambique","2025-01-03",0,0,0,0,0,0,0,0
"Mozambique","2025-01-04",0,0,0,0,0,0,0,0
"Mozambique","2025-01-05",0,0,0,0,0,0,0,0
"Mozambique","2025-01-06",0,0,0,0,0,0,0,0
"Mozambique","2025-01-07",0,0,0,0,0,0,0,0
"Mozambique","2025-01-08",0,0,0,0,0,0,0,0
"Mozambique","2025-01-09",0,0,0,0,0,0,0,0
"Mozambique","2025-01-10",0,0,0,0,0,0,0,0
"Mozambique","2025-01-11",0,0,0,0,0,0,0,0
"Mozambique","2025-01-12",0,0,0,0,0,0,0,0
"Mozambique","2025-01-13",0,0,0,0,0,0,0,0
"Mozambique","2025-01-14",0,0,0,0,0,0,0,0
"Mozambique","2025-01-15",0,0,0,0,0,0,0,0
"Mozambique","2025-01-16",0,0,0,0,0,0,0,0
"Mozambique","2025-01-17",0,0,0,0,0,0,0,0
"Mozambique","2025-01-18",0,0,0,0,0,0,0,0
"Mozambique","2025-01-19",0,0,0,0,0,0,0,0
"Mozambique","2025-01-20",0,0,0,0,0,0,0,0
"Mozambique","2025-01-21",0,0,0,0,0,0,0,0
"Mozambique","2025-01-22",0,0,0,0,0,0,0,0
"Mozambique","2025-01-23",0,0,0,0,0,0,0,0
"Mozambique","2025-01-24",0,0,0,0,0,0,0,0
"Mozambique","2025-01-25",0,0,0,0,0,0,0,0
"Mozambique","2025-01-26",0,0,0,0,0,0,0,0
"Mozambique","2025-01-27",0,0,0,0,0,0,0,0
"Mozambique","2025-01-28",0,0,0,0,0,0,0,0
"Mozambique","2025-01-29",0,0,0,0,0,0,0,0
"Mozambique","2025-01-30",0,0,0,0,0,0,0,0
"Mozambique","2025-01-31",0,0,0,0,0,0,0,0
"Mozambique","2025-02-01",0,0,0,0,0,0,0,0
"Mozambique","2025-02-02",0,0,0,0,0,0,0,0
"Mozambique","2025-02-03",0,0,0,0,0,0,0,0
"Nepal","2024-01-01",0,0,0,0,0,0,0,0
"Nepal","2024-01-02",0,0,0,0,0,0,0,0
"Nepal","2024-01-03",0,0,0,0,0,0,0,0
"Nepal","2024-01-04",0,0,0,0,0,0,0,0
"Nepal","2024-01-05",0,0,0,0,0,0,0,0
"Nepal","2024-01-06",0,0,0,0,0,0,0,0
"Nepal","2024-01-07",0,0,0,0,0,0,0,0
"Nepal","2024-01-08",0,0,0,0,0,0,0,0
"Nepal","2024-01-09",0,0,0,0,0,0,0,0
"Nepal","2024-01-10",0,0,0,0,0,0,0,0
"Nepal","2024-01-11",0,0,0,0,0,0,0,0
"Nepal","2024-01-12",0,0,0,0,0,0,0,0
"Nepal","2024-01-13",0,0,0,0,0,0,0,0
"Nepal","2024-01-14",0,0,0,0,0,0,0,0
"Nepal","2024-01-15",0,0,0,0,0,0,0,0
"Nepal","2024-01-16",0,0,0,0,0,0,0,0
"Nepal","2024-01-17",0,0,0,0,0,0,0,0
"Nepal","2024-01-18",0,0,0,0,0,0,0,0
"Nepal","2024-01-19",0,0,0,0,0,0,0,0
"Nepal","2024-01-20",0,0,0,0,0,0,0,0
"Nepal","2024-01-21",0,0,0,0,0,0,0,0
"Nepal","2024-01-22",0,0,0,0,0,0,0,0
"Nepal","2024-01-23",0,0,0,0,0,0,0,0
"Nepal","2024-01-24",0,0,0,0,0,0,0,0
"Nepal","2024-01-25",0,0,0,0,0,0,0,0
"Nepal","2024-01-26",0,0,0,0,0,0,0,0
"Nepal","2024-01-27",0,0,0,0,0,0,0,0
"Nepal","2024-01-28",0,0,0,0,0,0,0,0
"Nepal","2024-01-29",0,0,0,0,0,0,0,0
"Nepal","2024-01-30",0,0,0,0,0,0,0,0
"Nepal","2024-01-31",0,0,0,0,0,0,0,0
"Nepal","2024-02-01",0,0,0,0,0,0,0,0
"Nepal","2024-02-02",0,0,0,0,0,0,0,0
"Nepal","2024-02-03",0,0,0,0,0,0,0,0
"Nepal","2024-02-04",0,0,0,0,0,0,0,0
"Nepal","2024-02-05",0,0,0,0,0,0,0,0
"Nepal","2024-02-06",0,0,0,0,0,0,0,0
"Nepal","2024-02-07",0,0,0,0,0,0,0,0
"Nepal","2024-02-08",0,0,0,0,0,0,0,0
"Nepal","2024-02-09",0,0,0,0,0,0,0,0
"Nepal","2024-02-10",0,0,0,0,0,0,0,0
"Nepal","2024-02-11",0,0,0,0,0,0,0,0
"Nepal","2024-02-12",0,0,0,0,0,0,0,0
"Nepal","2024-02-13",0,0,0,0,0,0,0,0
"Nepal","2024-02-14",0,0,0,0,0,0,0,0
"Nepal","2024-02-15",0,0,0,0,0,0,0,0
"Nepal","2024-02-16",0,0,0,0,0,0,0,0
"Nepal","2024-02-17",0,0,0,0,0,0,0,0
"Nepal","2024-02-18",0,0,0,0,0,0,0,0
"Nepal","2024-02-19",0,0,0,0,0,0,0,0
"Nepal","2024-02-20",0,0,0,0,0,0,0,0
"Nepal","2024-02-21",0,0,0,0,0,0,0,0
"Nepal","2024-02-22",0,0,0,0,0,0,0,0
"Nepal","2024-02-23",0,0,0,0,0,0,0,0
"Nepal","2024-02-24",0,0,0,0,0,0,0,0
"Nepal","2024-02-25",0,0,0,0,0,0,0,0
"Nepal","2024-02-26",0,0,0,0,0,0,0,0
"Nepal","2024-02-27",0,0,0,0,0,0,0,0
"Nepal","2024-02-28",0,0,0,0,0,0,0,0
"Nepal","2024-02-29",0,0,0,0,0,0,0,0
"Nepal","2024-03-01",0,0,0,0,0,0,0,0
"Nepal","2024-03-02",0,0,0,0,0,0,0,0
"Nepal","2024-03-03",0,0,0,0,0,0,0,0
"Nepal","2024-03-04",0,0,0,0,0,0,0,0
"Nepal","2024-03-05",0,0,0,0,0,0,0,0
"Nepal","2024-03-06",0,0,0,0,0,0,0,0
"Nepal","2024-03-07",0,0,0,0,0,0,0,0
"Nepal","2024-03-08",0,0,0,0,0,0,0,0
"Nepal","2024-03-09",0,0,0,0,0,0,0,0
"Nepal","2024-03-10",0,0,0,0,0,0,0,0
"Nepal","2024-03-11",0,0,0,0,0,0,0,0
"Nepal","2024-03-12",0,0,0,0,0,0,0,0
"Nepal","2024-03-13",0,0,0,0,0,0,0,0
"Nepal","2024-03-14",0,0,0,0,0,0,0,0
"Nepal","2024-03-15",0,0,0,0,0,0,0,0
"Nepal","2024-03-16",0,0,0,0,0,0,0,0
"Nepal","2024-03-17",0,0,0,0,0,0,0,0
"Nepal","2024-03-18",0,0,0,0,0,0,0,0
"Nepal","2024-03-19",0,0,0,0,0,0,0,0
"Nepal","2024-03-20",0,0,0,0,0,0,0,0
"Nepal","2024-03-21",0,0,0,0,0,0,0,0
"Nepal","2024-03-22",0,0,0,0,0,0,0,0
"Nepal","2024-03-23",0,0,0,0,0,0,0,0
"Nepal","2024-03-24",0,0,0,0,0,0,0,0
"Nepal","2024-03-25",0,0,0,0,0,0,0,0
"Nepal","2024-03-26",0,0,0,0,0,0,0,0
"Nepal","2024-03-27",0,0,0,0,0,0,0,0
"Nepal","2024-03-28",0,0,0,0,0,0,0,0
"Nepal","2024-03-29",0,0,0,0,0,0,0,0
"Nepal","2024-03-30",0,0,0,0,0,0,0,0
"Nepal","2024-03-31",0,0,0,0,0,0,0,0
"Nepal","2024-04-01",0,0,0,0,0,0,0,0
"Nepal","2024-04-02",0,0,0,0,0,0,0,0
"Nepal","2024-04-03",0,0,0,0,0,0,0,0
"Nepal","2024-04-04",0,0,0,0,0,0,0,0
"Nepal","2024-04-05",0,0,0,0,0,0,0,0
"Nepal","2024-04-06",0,0,0,0,0,0,0,0
"Nepal","2024-04-07",0,0,0,0,0,0,0,0
"Nepal","2024-04-08",0,0,0,0,0,0,0,0
"Nepal","2024-04-09",0,0,0,0,0,0,0,0
"Nepal","2024-04-10",0,0,0,0,0,0,0,0
"Nepal","2024-04-11",0,0,0,0,0,0,0,0
"Nepal","2024-04-12",0,0,0,0,0,0,0,0
"Nepal","2024-04-13",0,0,0,0,0,0,0,0
"Nepal","2024-04-14",0,0,0,0,0,0,0,0
"Nepal","2024-04-15",0,0,0,0,0,0,0,0
"Nepal","2024-04-16",0,0,0,0,0,0,0,0
"Nepal","2024-04-17",0,0,0,0,0,0,0,0
"Nepal","2024-04-18",0,0,0,0,0,0,0,0
"Nepal","2024-04-19",0,0,0,0,0,0,0,0
"Nepal","2024-04-20",0,0,0,0,0,0,0,0
"Nepal","2024-04-21",0,0,0,0,0,0,0,0
"Nepal","2024-04-22",0,0,0,0,0,0,0,0
"Nepal","2024-04-23",0,0,0,0,0,0,0,0
"Nepal","2024-04-24",0,0,0,0,0,0,0,0
"Nepal","2024-04-25",0,0,0,0,0,0,0,0
"Nepal","2024-04-26",0,0,0,0,0,0,0,0
"Nepal","2024-04-27",0,0,0,0,0,0,0,0
"Nepal","2024-04-28",0,0,0,0,0,0,0,0
"Nepal","2024-04-29",0,0,0,0,0,0,0,0
"Nepal","2024-04-30",0,0,0,0,0,0,0,0
"Nepal","2024-05-01",0,0,0,0,0,0,0,0
"Nepal","2024-05-02",0,0,0,0,0,0,0,0
"Nepal","2024-05-03",0,0,0,0,0,0,0,0
"Nepal","2024-05-04",0,0,0,0,0,0,0,0
"Nepal","2024-05-05",0,0,0,0,0,0,0,0
"Nepal","2024-05-06",0,0,0,0,0,0,0,0
"Nepal","2024-05-07",0,0,0,0,0,0,0,0
"Nepal","2024-05-08",0,0,0,0,0,0,0,0
"Nepal","2024-05-09",0,0,0,0,0,0,0,0
"Nepal","2024-05-10",0,0,0,0,0,0,0,0
"Nepal","2024-05-11",0,0,0,0,0,0,0,0
"Nepal","2024-05-12",0,0,0,0,0,0,0,0
"Nepal","2024-05-13",0,0,0,0,0,0,0,0
"Nepal","2024-05-14",0,0,0,0,0,0,0,0
"Nepal","2024-05-15",0,0,0,0,0,0,0,0
"Nepal","2024-05-16",0,0,0,0,0,0,0,0
"Nepal","2024-05-17",0,0,0,0,0,0,0,0
"Nepal","2024-05-18",0,0,0,0,0,0,0,0
"Nepal","2024-05-19",0,0,0,0,0,0,0,0
"Nepal","2024-05-20",0,0,0,0,0,0,0,0
"Nepal","2024-05-21",0,0,0,0,0,0,0,0
"Nepal","2024-05-22",0,0,0,0,0,0,0,0
"Nepal","2024-05-23",0,0,0,0,0,0,0,0
"Nepal","2024-05-24",0,0,0,0,0,0,0,0
"Nepal","2024-05-25",0,0,0,0,0,0,0,0
"Nepal","2024-05-26",0,0,0,0,0,0,0,0
"Nepal","2024-05-27",0,0,0,0,0,0,0,0
"Nepal","2024-05-28",0,0,0,0,0,0,0,0
"Nepal","2024-05-29",0,0,0,0,0,0,0,0
"Nepal","2024-05-30",0,0,0,0,0,0,0,0
"Nepal","2024-05-31",0,0,0,0,0,0,0,0
"Nepal","2024-06-01",0,0,0,0,0,0,0,0
"Nepal","2024-06-02",0,0,0,0,0,0,0,0
"Nepal","2024-06-03",0,0,0,0,0,0,0,0
"Nepal","2024-06-04",0,0,0,0,0,0,0,0
"Nepal","2024-06-05",0,0,0,0,0,0,0,0
"Nepal","2024-06-06",0,0,0,0,0,0,0,0
"Nepal","2024-06-07",0,0,0,0,0,0,0,0
"Nepal","2024-06-08",0,0,0,0,0,0,0,0
"Nepal","2024-06-09",0,0,0,0,0,0,0,0
"Nepal","2024-06-10",0,0,0,0,0,0,0,0
"Nepal","2024-06-11",0,0,0,0,0,0,0,0
"Nepal","2024-06-12",0,0,0,0,0,0,0,0
"Nepal","2024-06-13",0,0,0,0,0,0,0,0
"Nepal","2024-06-14",0,0,0,0,0,0,0,0
"Nepal","2024-06-15",0,0,0,0,0,0,0,0
"Nepal","2024-06-16",0,0,0,0,0,0,0,0
"Nepal","2024-06-17",0,0,0,0,0,0,0,0
"Nepal","2024-06-18",0,0,0,0,0,0,0,0
"Nepal","2024-06-19",0,0,0,0,0,0,0,0
"Nepal","2024-06-20",0,0,0,0,0,0,0,0
"Nepal","2024-06-21",0,0,0,0,0,0,0,0
"Nepal","2024-06-22",0,0,0,0,0,0,0,0
"Nepal","2024-06-23",0,0,0,0,0,0,0,0
"Nepal","2024-06-24",0,0,0,0,0,0,0,0
"Nepal","2024-06-25",0,0,0,0,0,0,0,0
"Nepal","2024-06-26",0,0,0,0,0,0,0,0
"Nepal","2024-06-27",0,0,0,0,0,0,0,0
"Nepal","2024-06-28",0,0,0,0,0,0,0,0
"Nepal","2024-06-29",0,0,0,0,0,0,0,0
"Nepal","2024-06-30",0,0,0,0,0,0,0,0
"Nepal","2024-07-01",0,0,0,0,0,0,0,0
"Nepal","2024-07-02",0,0,0,0,0,0,0,0
"Nepal","2024-07-03",0,0,0,0,0,0,0,0
"Nepal","2024-07-04",0,0,0,0,0,0,0,0
"Nepal","2024-07-05",0,0,0,0,0,0,0,0
"Nepal","2024-07-06",0,0,0,0,0,0,0,0
"Nepal","2024-07-07",0,0,0,0,0,0,0,0
"Nepal","2024-07-08",0,0,0,0,0,0,0,0
"Nepal","2024-07-09",0,0,0,0,0,0,0,0
"Nepal","2024-07-10",0,0,0,0,0,0,0,0
"Nepal","2024-07-11",0,0,0,0,0,0,0,0
"Nepal","2024-07-12",0,0,0,0,0,0,0,0
"Nepal","2024-07-13",0,0,0,0,0,0,0,0
"Nepal","2024-07-14",0,0,0,0,0,0,0,0
"Nepal","2024-07-15",0,0,0,0,0,0,0,0
"Nepal","2024-07-16",0,0,0,0,0,0,0,0
"Nepal","2024-07-17",0,0,0,0,0,0,0,0
"Nepal","2024-07-18",0,0,0,0,0,0,0,0
"Nepal","2024-07-19",0,0,0,0,0,0,0,0
"Nepal","2024-07-20",0,0,0,0,0,0,0,0
"Nepal","2024-07-21",0,0,0,0,0,0,0,0
"Nepal","2024-07-22",0,0,0,0,0,0,0,0
"Nepal","2024-07-23",0,0,0,0,0,0,0,0
"Nepal","2024-07-24",0,0,0,0,0,0,0,0
"Nepal","2024-07-25",0,0,0,0,0,0,0,0
"Nepal","2024-07-26",0,0,0,0,0,0,0,0
"Nepal","2024-07-27",0,0,0,0,0,0,0,0
"Nepal","2024-07-28",0,0,0,0,0,0,0,0
"Nepal","2024-07-29",0,0,0,0,0,0,0,0
"Nepal","2024-07-30",0,0,0,0,0,0,0,0
"Nepal","2024-07-31",0,0,0,0,0,0,0,0
"Nepal","2024-08-01",0,0,0,0,0,0,0,0
"Nepal","2024-08-02",0,0,0,0,0,0,0,0
"Nepal","2024-08-03",0,0,0,0,0,0,0,0
"Nepal","2024-08-04",0,0,0,0,0,0,0,0
"Nepal","2024-08-05",0,0,0,0,0,0,0,0
"Nepal","2024-08-06",0,0,0,0,0,0,0,0
"Nepal","2024-08-07",0,0,0,0,0,0,0,0
"Nepal","2024-08-08",0,0,0,0,0,0,0,0
"Nepal","2024-08-09",0,0,0,0,0,0,0,0
"Nepal","2024-08-10",0,0,0,0,0,0,0,0
"Nepal","2024-08-11",0,0,0,0,0,0,0,0
"Nepal","2024-08-12",0,0,0,0,0,0,0,0
"Nepal","2024-08-13",0,0,0,0,0,0,0,0
"Nepal","2024-08-14",0,0,0,0,0,0,0,0
"Nepal","2024-08-15",0,0,0,0,0,0,0,0
"Nepal","2024-08-16",0,0,0,0,0,0,0,0
"Nepal","2024-08-17",0,0,0,0,0,0,0,0
"Nepal","2024-08-18",0,0,0,0,0,0,0,0
"Nepal","2024-08-19",0,0,0,0,0,0,0,0
"Nepal","2024-08-20",0,0,0,0,0,0,0,0
"Nepal","2024-08-21",0,0,0,0,0,0,0,0
"Nepal","2024-08-22",0,0,0,0,0,0,0,0
"Nepal","2024-08-23",0,0,0,0,0,0,0,0
"Nepal","2024-08-24",0,0,0,0,0,0,0,0
"Nepal","2024-08-25",0,0,0,0,0,0,0,0
"Nepal","2024-08-26",0,0,0,0,0,0,0,0
"Nepal","2024-08-27",0,0,0,0,0,0,0,0
"Nepal","2024-08-28",0,0,0,0,0,0,0,0
"Nepal","2024-08-29",0,0,0,0,0,0,0,0
"Nepal","2024-08-30",0,0,0,0,0,0,0,0
"Nepal","2024-08-31",0,0,0,0,0,0,0,0
"Nepal","2024-09-01",0,0,0,0,0,0,0,0
"Nepal","2024-09-02",0,0,0,0,0,0,0,0
"Nepal","2024-09-03",0,0,0,0,0,0,0,0
"Nepal","2024-09-04",0,0,0,0,0,0,0,0
"Nepal","2024-09-05",0,0,0,0,0,0,0,0
"Nepal","2024-09-06",0,0,0,0,0,0,0,0
"Nepal","2024-09-07",0,0,0,0,0,0,0,0
"Nepal","2024-09-08",0,0,0,0,0,0,0,0
"Nepal","2024-09-09",0,0,0,0,0,0,0,0
"Nepal","2024-09-10",0,0,0,0,0,0,0,0
"Nepal","2024-09-11",0,0,0,0,0,0,0,0
"Nepal","2024-09-12",0,0,0,0,0,0,0,0
"Nepal","2024-09-13",0,0,0,0,0,0,0,0
"Nepal","2024-09-14",0,0,0,0,0,0,0,0
"Nepal","2024-09-15",0,0,0,0,0,0,0,0
"Nepal","2024-09-16",0,0,0,0,0,0,0,0
"Nepal","2024-09-17",0,0,0,0,0,0,0,0
"Nepal","2024-09-18",0,0,0,0,0,0,0,0
"Nepal","2024-09-19",0,0,0,0,0,0,0,0
"Nepal","2024-09-20",0,0,0,0,0,0,0,0
"Nepal","2024-09-21",0,0,0,0,0,0,0,0
"Nepal","2024-09-22",0,0,0,0,0,0,0,0
"Nepal","2024-09-23",0,0,0,0,0,0,0,0
"Nepal","2024-09-24",0,0,0,0,0,0,0,0
"Nepal","2024-09-25",0,0,0,0,0,0,0,0
"Nepal","2024-09-26",0,0,0,0,0,0,0,0
"Nepal","2024-09-27",0,0,0,0,0,0,0,0
"Nepal","2024-09-28",0,0,0,0,0,0,0,0
"Nepal","2024-09-29",0,0,0,0,0,0,0,0
"Nepal","2024-09-30",0,0,0,0,0,0,0,0
"Nepal","2024-10-01",0,0,0,0,0,0,0,0
"Nepal","2024-10-02",0,0,0,0,0,0,0,0
"Nepal","2024-10-03",0,0,0,0,0,0,0,0
"Nepal","2024-10-04",0,0,0,0,0,0,0,0
"Nepal","2024-10-05",0,0,0,0,0,0,0,0
"Nepal","2024-10-06",0,0,0,0,0,0,0,0
"Nepal","2024-10-07",0,0,0,0,0,0,0,0
"Nepal","2024-10-08",0,0,0,0,0,0,0,0
"Nepal","2024-10-09",0,0,0,0,0,0,0,0
"Nepal","2024-10-10",0,0,0,0,0,0,0,0
"Nepal","2024-10-11",0,0,0,0,0,0,0,0
"Nepal","2024-10-12",0,0,0,0,0,0,0,0
"Nepal","2024-10-13",0,0,0,0,0,0,0,0
"Nepal","2024-10-14",0,0,0,0,0,0,0,0
"Nepal","2024-10-15",0,0,0,0,0,0,0,0
"Nepal","2024-10-16",0,0,0,0,0,0,0,0
"Nepal","2024-10-17",0,0,0,0,0,0,0,0
"Nepal","2024-10-18",0,0,0,0,0,0,0,0
"Nepal","2024-10-19",0,0,0,0,0,0,0,0
"Nepal","2024-10-20",0,0,0,0,0,0,0,0
"Nepal","2024-10-21",0,0,0,0,0,0,0,0
"Nepal","2024-10-22",0,0,0,0,0,0,0,0
"Nepal","2024-10-23",0,0,0,0,0,0,0,0
"Nepal","2024-10-24",0,0,0,0,0,0,0,0
"Nepal","2024-10-25",0,0,0,0,0,0,0,0
"Nepal","2024-10-26",0,0,0,0,0,0,0,0
"Nepal","2024-10-27",0,0,0,0,0,0,0,0
"Nepal","2024-10-28",0,0,0,0,0,0,0,0
"Nepal","2024-10-29",0,0,0,0,0,0,0,0
"Nepal","2024-10-30",0,0,0,0,0,0,0,0
"Nepal","2024-10-31",0,0,0,0,0,0,0,0
"Nepal","2024-11-01",0,0,0,0,0,0,0,0
"Nepal","2024-11-02",0,0,0,0,0,0,0,0
"Nepal","2024-11-03",0,0,0,0,0,0,0,0
"Nepal","2024-11-04",0,0,0,0,0,0,0,0
"Nepal","2024-11-05",0,0,0,0,0,0,0,0
"Nepal","2024-11-06",0,0,0,0,0,0,0,0
"Nepal","2024-11-07",0,0,0,0,0,0,0,0
"Nepal","2024-11-08",0,0,0,0,0,0,0,0
"Nepal","2024-11-09",0,0,0,0,0,0,0,0
"Nepal","2024-11-10",0,0,0,0,0,0,0,0
"Nepal","2024-11-11",0,0,0,0,0,0,0,0
"Nepal","2024-11-12",0,0,0,0,0,0,0,0
"Nepal","2024-11-13",0,0,0,0,0,0,0,0
"Nepal","2024-11-14",0,0,0,0,0,0,0,0
"Nepal","2024-11-15",0,0,0,0,0,0,0,0
"Nepal","2024-11-16",0,0,0,0,0,0,0,0
"Nepal","2024-11-17",0,0,0,0,0,0,0,0
"Nepal","2024-11-18",0,0,0,0,0,0,0,0
"Nepal","2024-11-19",0,0,0,0,0,0,0,0
"Nepal","2024-11-20",0,0,0,0,0,0,0,0
"Nepal","2024-11-21",0,0,0,0,0,0,0,0
"Nepal","2024-11-22",0,0,0,0,0,0,0,0
"Nepal","2024-11-23",0,0,0,0,0,0,0,0
"Nepal","2024-11-24",0,0,0,0,0,0,0,0
"Nepal","2024-11-25",0,0,0,0,0,0,0,0
"Nepal","2024-11-26",0,0,0,0,0,0,0,0
"Nepal","2024-11-27",0,0,0,0,0,0,0,0
"Nepal","2024-11-28",0,0,0,0,0,0,0,0
"Nepal","2024-11-29",0,0,0,0,0,0,0,0
"Nepal","2024-11-30",0,0,0,0,0,0,0,0
"Nepal","2024-12-01",0,0,0,0,0,0,0,0
"Nepal","2024-12-02",0,0,0,0,0,0,0,0
"Nepal","2024-12-03",0,0,0,0,0,0,0,0
"Nepal","2024-12-04",0,0,0,0,0,0,0,0
"Nepal","2024-12-05",0,0,0,0,0,0,0,0
"Nepal","2024-12-06",0,0,0,0,0,0,0,0
"Nepal","2024-12-07",0,0,0,0,0,0,0,0
"Nepal","2024-12-08",0,0,0,0,0,0,0,0
"Nepal","2024-12-09",0,0,0,0,0,0,0,0
"Nepal","2024-12-10",0,0,0,0,0,0,0,0
"Nepal","2024-12-11",0,0,0,0,0,0,0,0
"Nepal","2024-12-12",0,0,0,0,0,0,0,0
"Nepal","2024-12-13",0,0,0,0,0,0,0,0
"Nepal","2024-12-14",0,0,0,0,0,0,0,0
"Nepal","2024-12-15",0,0,0,0,0,0,0,0
"Nepal","2024-12-16",0,0,0,0,0,0,0,0
"Nepal","2024-12-17",0,0,0,0,0,0,0,0
"Nepal","2024-12-18",0,0,0,0,0,0,0,0
"Nepal","2024-12-19",0,0,0,0,0,0,0,0
"Nepal","2024-12-20",0,0,0,0,0,0,0,0
"Nepal","2024-12-21",0,0,0,0,0,0,0,0
"Nepal","2024-12-22",0,0,0,0,0,0,0,0
"Nepal","2024-12-23",0,0,0,0,0,0,0,0
"Nepal","2024-12-24",0,0,0,0,0,0,0,0
"Nepal","2024-12-25",0,0,0,0,0,0,0,0
"Nepal","2024-12-26",0,0,0,0,0,0,0,0
"Nepal","2024-12-27",0,0,0,0,0,0,0,0
"Nepal","2024-12-28",0,0,0,0,0,0,0,0
"Nepal","2024-12-29",0,0,0,0,0,0,0,0
"Nepal","2024-12-30",0,0,0,0,0,0,0,0
"Nepal","2024-12-31",0,2,2,0,2,2,0,0
"Nepal","2025-01-01",0,0,2,0,0,2,0,0
"Nepal","2025-01-02",0,0,2,0,0,2,0,0
"Nepal","2025-01-03",0,0,2,0,0,2,0,0
"Nepal","2025-01-04",0,0,2,0,0,2,0,0
"Nepal","2025-01-05",0,0,2,0,0,2,0,0
"Nepal","2025-01-06",0,0,2,0,0,2,0,0
"Nepal","2025-01-07",0,0,2,0,0,2,0,0
"Nepal","2025-01-08",0,0,2,0,0,2,0,0
"Nepal","2025-01-09",0,0,2,0,0,2,0,0
"Nepal","2025-01-10",0,0,2,0,0,2,0,0
"Nepal","2025-01-11",0,0,2,0,0,2,0,0
"Nepal","2025-01-12",0,0,2,0,0,2,0,0
"Nepal","2025-01-13",0,0,2,0,0,2,0,0
"Nepal","2025-01-14",0,0,2,0,0,2,0,0
"Nepal","2025-01-15",0,0,2,0,0,2,0,0
"Nepal","2025-01-16",0,0,2,0,0,2,0,0
"Nepal","2025-01-17",0,0,2,0,0,2,0,0
"Nepal","2025-01-18",0,0,2,0,0,2,0,0
"Nepal","2025-01-19",0,0,2,0,0,2,0,0
"Nepal","2025-01-20",0,0,2,0,0,2,0,0
"Nepal","2025-01-21",0,0,2,0,0,2,0,0
"Nepal","2025-01-22",0,0,2,0,0,2,0,0
"Nepal","2025-01-23",0,0,2,0,0,2,0,0
"Nepal","2025-01-24",0,0,2,0,0,2,0,0
"Nepal","2025-01-25",0,0,2,0,0,2,0,0
"Nepal","2025-01-26",0,0,2,0,0,2,0,0
"Nepal","2025-01-27",0,0,2,0,0,2,0,0
"Nepal","2025-01-28",0,0,2,0,0,2,0,0
"Nepal","2025-01-29",0,0,2,0,0,2,0,0
"Nepal","2025-01-30",0,0,2,0,0,2,0,0
"Nepal","2025-01-31",0,0,2,0,0,2,0,0
"Nepal","2025-02-01",0,0,2,0,0,2,0,0
"Nepal","2025-02-02",0,0,2,0,0,2,0,0
"Nepal","2025-02-03",0,0,2,0,0,2,0,0
"Netherlands (Kingdom of the)","2024-01-01",0,0,0,0,0,0,0,0
"Netherlands (Kingdom of the)","2024-01-02",0,0,0,0,0,0,0,0
"Netherlands (Kingdom of the)","2024-01-03",0,0,0,0,0,0,0,0
"Netherlands (Kingdom of the)","2024-01-04",0,0,0,0,0,0,0,0
"Netherlands (Kingdom of the)","2024-01-05",0,0,0,0,0,0,0,0
"Netherlands (Kingdom of the)","2024-01-06",0,0,0,0,0,0,0,0
"Netherlands (Kingdom of the)","2024-01-07",0,0,0,0,0,0,0,0
"Netherlands (Kingdom of the)","2024-01-08",0,0,0,0,0,0,0,0
"Netherlands (Kingdom of the)","2024-01-09",0,0,0,0,0,0,0,0
"Netherlands (Kingdom of the)","2024-01-10",0,0,0,0,0,0,0,0
"Netherlands (Kingdom of the)","2024-01-11",0,0,0,0,0,0,0,0
"Netherlands (Kingdom of the)","2024-01-12",0,0,0,0,0,0,0,0
"Netherlands (Kingdom of the)","2024-01-13",0,0,0,0,0,0,0,0
"Netherlands (Kingdom of the)","2024-01-14",0,0,0,0,0,0,0,0
"Netherlands (Kingdom of the)","2024-01-15",0,0,0,0,0,0,0,0
"Netherlands (Kingdom of the)","2024-01-16",0,0,0,0,0,0,0,0
"Netherlands (Kingdom of the)","2024-01-17",0,0,0,0,0,0,0,0
"Netherlands (Kingdom of the)","2024-01-18",0,0,0,0,0,0,0,0
"Netherlands (Kingdom of the)","2024-01-19",0,0,0,0,0,0,0,0
"Netherlands (Kingdom of the)","2024-01-20",0,0,0,0,0,0,0,0
"Netherlands (Kingdom of the)","2024-01-21",0,0,0,0,0,0,0,0
"Netherlands (Kingdom of the)","2024-01-22",0,0,0,0,0,0,0,0
"Netherlands (Kingdom of the)","2024-01-23",0,0,0,0,0,0,0,0
"Netherlands (Kingdom of the)","2024-01-24",0,0,0,0,0,0,0,0
"Netherlands (Kingdom of the)","2024-01-25",0,0,0,0,0,0,0,0
"Netherlands (Kingdom of the)","2024-01-26",0,0,0,0,0,0,0,0
"Netherlands (Kingdom of the)","2024-01-27",0,0,0,0,0,0,0,0
"Netherlands (Kingdom of the)","2024-01-28",0,0,0,0,0,0,0,0
"Netherlands (Kingdom of the)","2024-01-29",0,0,0,0,0,0,0,0
"Netherlands (Kingdom of the)","2024-01-30",0,0,0,0,0,0,0,0
"Netherlands (Kingdom of the)","2024-01-31",0,5,5,0,5,5,0,0
"Netherlands (Kingdom of the)","2024-02-01",0,0,5,0,0,5,0,0
"Netherlands (Kingdom of the)","2024-02-02",0,0,5,0,0,5,0,0
"Netherlands (Kingdom of the)","2024-02-03",0,0,5,0,1,6,0,0
"Netherlands (Kingdom of the)","2024-02-04",0,0,5,0,0,6,0,0
"Netherlands (Kingdom of the)","2024-02-05",0,0,5,0,0,6,0,0
"Netherlands (Kingdom of the)","2024-02-06",0,0,5,0,0,6,0,0
"Netherlands (Kingdom of the)","2024-02-07",0,0,5,0,1,7,0,0
"Netherlands (Kingdom of the)","2024-02-08",0,0,5,0,0,7,0,0
"Netherlands (Kingdom of the)","2024-02-09",0,0,5,0,0,7,0,0
"Netherlands (Kingdom of the)","2024-02-10",0,0,5,0,0,7,0,0
"Netherlands (Kingdom of the)","2024-02-11",0,0,5,0,1,8,0,0
"Netherlands (Kingdom of the)","2024-02-12",0,0,5,0,0,8,0,0
"Netherlands (Kingdom of the)","2024-02-13",0,0,5,0,0,8,0,0
"Netherlands (Kingdom of the)","2024-02-14",0,0,5,0,0,8,0,0
"Netherlands (Kingdom of the)","2024-02-15",0,0,5,0,1,9,0,0
"Netherlands (Kingdom of the)","2024-02-16",0,0,5,0,0,9,0,0
"Netherlands (Kingdom of the)","2024-02-17",0,0,5,0,0,9,0,0
"Netherlands (Kingdom of the)","2024-02-18",0,0,5,0,0,9,0,0
"Netherlands (Kingdom of the)","2024-02-19",0,0,5,0,1,10,0,0
"Netherlands (Kingdom of the)","2024-02-20",0,0,5,0,0,10,0,0
"Netherlands (Kingdom of the)","2024-02-21",0,0,5,0,0,10,0,0
"Netherlands (Kingdom of the)","2024-02-22",0,0,5,0,0,10,0,0
"Netherlands (Kingdom of the)","2024-02-23",0,0,5,0,1,11,0,0
"Netherlands (Kingdom of the)","2024-02-24",0,0,5,0,0,11,0,0
"Netherlands (Kingdom of the)","2024-02-25",0,0,5,0,0,11,0,0
"Netherlands (Kingdom of the)","2024-02-26",0,0,5,0,0,11,0,0
"Netherlands (Kingdom of the)","2024-02-27",0,0,5,0,1,12,0,0
"Netherlands (Kingdom of the)","2024-02-28",0,0,5,0,0,12,0,0
"Netherlands (Kingdom of the)","2024-02-29",0,7,12,0,0,12,0,0
"Netherlands (Kingdom of the)","2024-03-01",0,0,12,0,0,12,0,0
"Netherlands (Kingdom of the)","2024-03-02",0,0,12,0,0,12,0,0
"Netherlands (Kingdom of the)","2024-03-03",0,0,12,0,0,12,0,0
"Netherlands (Kingdom of the)","2024-03-04",0,0,12,0,0,12,0,0
"Netherlands (Kingdom of the)","2024-03-05",0,0,12,0,0,12,0,0
"Netherlands (Kingdom of the)","2024-03-06",0,0,12,0,0,12,0,0
"Netherlands (Kingdom of the)","2024-03-07",0,0,12,0,0,12,0,0
"Netherlands (Kingdom of the)","2024-03-08",0,0,12,0,0,12,0,0
"Netherlands (Kingdom of the)","2024-03-09",0,0,12,0,0,12,0,0
"Netherlands (Kingdom of the)","2024-03-10",0,0,12,0,0,12,0,0
"Netherlands (Kingdom of the)","2024-03-11",0,0,12,0,0,12,0,0
"Netherlands (Kingdom of the)","2024-03-12",0,0,12,0,0,12,0,0
"Netherlands (Kingdom of the)","2024-03-13",0,0,12,0,0,12,0,0
"Netherlands (Kingdom of the)","2024-03-14",0,0,12,0,0,12,0,0
"Netherlands (Kingdom of the)","2024-03-15",0,0,12,0,0,12,0,0
"Netherlands (Kingdom of the)","2024-03-16",0,0,12,0,1,13,0,0
"Netherlands (Kingdom of the)","2024-03-17",0,0,12,0,0,13,0,0
"Netherlands (Kingdom of the)","2024-03-18",0,0,12,0,0,13,0,0
"Netherlands (Kingdom of the)","2024-03-19",0,0,12,0,0,13,0,0
"Netherlands (Kingdom of the)","2024-03-20",0,0,12,0,0,13,0,0
"Netherlands (Kingdom of the)","2024-03-21",0,0,12,0,0,13,0,0
"Netherlands (Kingdom of the)","2024-03-22",0,0,12,0,0,13,0,0
"Netherlands (Kingdom of the)","2024-03-23",0,0,12,0,0,13,0,0
"Netherlands (Kingdom of the)","2024-03-24",0,0,12,0,0,13,0,0
"Netherlands (Kingdom of the)","2024-03-25",0,0,12,0,0,13,0,0
"Netherlands (Kingdom of the)","2024-03-26",0,0,12,0,0,13,0,0
"Netherlands (Kingdom of the)","2024-03-27",0,0,12,0,0,13,0,0
"Netherlands (Kingdom of the)","2024-03-28",0,0,12,0,0,13,0,0
"Netherlands (Kingdom of the)","2024-03-29",0,0,12,0,0,13,0,0
"Netherlands (Kingdom of the)","2024-03-30",0,0,12,0,0,13,0,0
"Netherlands (Kingdom of the)","2024-03-31",0,0,12,0,0,13,0,0
"Netherlands (Kingdom of the)","2024-04-01",0,0,12,0,0,13,0,0
"Netherlands (Kingdom of the)","2024-04-02",0,0,12,0,0,13,0,0
"Netherlands (Kingdom of the)","2024-04-03",0,0,12,0,0,13,0,0
"Netherlands (Kingdom of the)","2024-04-04",0,0,12,0,0,13,0,0
"Netherlands (Kingdom of the)","2024-04-05",0,0,12,0,0,13,0,0
"Netherlands (Kingdom of the)","2024-04-06",0,0,12,0,0,13,0,0
"Netherlands (Kingdom of the)","2024-04-07",0,0,12,0,0,13,0,0
"Netherlands (Kingdom of the)","2024-04-08",0,0,12,0,0,13,0,0
"Netherlands (Kingdom of the)","2024-04-09",0,0,12,0,0,13,0,0
"Netherlands (Kingdom of the)","2024-04-10",0,0,12,0,0,13,0,0
"Netherlands (Kingdom of the)","2024-04-11",0,0,12,0,0,13,0,0
"Netherlands (Kingdom of the)","2024-04-12",0,0,12,0,0,13,0,0
"Netherlands (Kingdom of the)","2024-04-13",0,0,12,0,0,13,0,0
"Netherlands (Kingdom of the)","2024-04-14",0,0,12,0,0,13,0,0
"Netherlands (Kingdom of the)","2024-04-15",0,0,12,0,1,14,0,0
"Netherlands (Kingdom of the)","2024-04-16",0,0,12,0,0,14,0,0
"Netherlands (Kingdom of the)","2024-04-17",0,0,12,0,0,14,0,0
"Netherlands (Kingdom of the)","2024-04-18",0,0,12,0,0,14,0,0
"Netherlands (Kingdom of the)","2024-04-19",0,0,12,0,0,14,0,0
"Netherlands (Kingdom of the)","2024-04-20",0,0,12,0,0,14,0,0
"Netherlands (Kingdom of the)","2024-04-21",0,0,12,0,0,14,0,0
"Netherlands (Kingdom of the)","2024-04-22",0,0,12,0,0,14,0,0
"Netherlands (Kingdom of the)","2024-04-23",0,0,12,0,0,14,0,0
"Netherlands (Kingdom of the)","2024-04-24",0,0,12,0,0,14,0,0
"Netherlands (Kingdom of the)","2024-04-25",0,0,12,0,0,14,0,0
"Netherlands (Kingdom of the)","2024-04-26",0,0,12,0,0,14,0,0
"Netherlands (Kingdom of the)","2024-04-27",0,0,12,0,0,14,0,0
"Netherlands (Kingdom of the)","2024-04-28",0,0,12,0,0,14,0,0
"Netherlands (Kingdom of the)","2024-04-29",0,0,12,0,0,14,0,0
"Netherlands (Kingdom of the)","2024-04-30",0,2,14,0,0,14,0,0
"Netherlands (Kingdom of the)","2024-05-01",0,0,14,0,0,14,0,0
"Netherlands (Kingdom of the)","2024-05-02",0,0,14,0,0,14,0,0
"Netherlands (Kingdom of the)","2024-05-03",0,0,14,0,0,14,0,0
"Netherlands (Kingdom of the)","2024-05-04",0,0,14,0,0,14,0,0
"Netherlands (Kingdom of the)","2024-05-05",0,0,14,0,0,14,0,0
"Netherlands (Kingdom of the)","2024-05-06",0,0,14,0,0,14,0,0
"Netherlands (Kingdom of the)","2024-05-07",0,0,14,0,0,14,0,0
"Netherlands (Kingdom of the)","2024-05-08",0,0,14,0,0,14,0,0
"Netherlands (Kingdom of the)","2024-05-09",0,0,14,0,0,14,0,0
"Netherlands (Kingdom of the)","2024-05-10",0,0,14,0,0,14,0,0
"Netherlands (Kingdom of the)","2024-05-11",0,0,14,0,0,14,0,0
"Netherlands (Kingdom of the)","2024-05-12",0,0,14,0,0,14,0,0
"Netherlands (Kingdom of the)","2024-05-13",0,0,14,0,0,14,0,0
"Netherlands (Kingdom of the)","2024-05-14",0,0,14,0,0,14,0,0
"Netherlands (Kingdom of the)","2024-05-15",0,0,14,0,0,14,0,0
"Netherlands (Kingdom of the)","2024-05-16",0,0,14,0,1,15,0,0
"Netherlands (Kingdom of the)","2024-05-17",0,0,14,0,0,15,0,0
"Netherlands (Kingdom of the)","2024-05-18",0,0,14,0,0,15,0,0
"Netherlands (Kingdom of the)","2024-05-19",0,0,14,0,0,15,0,0
"Netherlands (Kingdom of the)","2024-05-20",0,0,14,0,0,15,0,0
"Netherlands (Kingdom of the)","2024-05-21",0,0,14,0,0,15,0,0
"Netherlands (Kingdom of the)","2024-05-22",0,0,14,0,0,15,0,0
"Netherlands (Kingdom of the)","2024-05-23",0,0,14,0,0,15,0,0
"Netherlands (Kingdom of the)","2024-05-24",0,0,14,0,0,15,0,0
"Netherlands (Kingdom of the)","2024-05-25",0,0,14,0,0,15,0,0
"Netherlands (Kingdom of the)","2024-05-26",0,0,14,0,0,15,0,0
"Netherlands (Kingdom of the)","2024-05-27",0,0,14,0,0,15,0,0
"Netherlands (Kingdom of the)","2024-05-28",0,0,14,0,0,15,0,0
"Netherlands (Kingdom of the)","2024-05-29",0,0,14,0,0,15,0,0
"Netherlands (Kingdom of the)","2024-05-30",0,0,14,0,0,15,0,0
"Netherlands (Kingdom of the)","2024-05-31",0,1,15,0,0,15,0,0
"Netherlands (Kingdom of the)","2024-06-01",0,0,15,0,0,15,0,0
"Netherlands (Kingdom of the)","2024-06-02",0,0,15,0,0,15,0,0
"Netherlands (Kingdom of the)","2024-06-03",0,0,15,0,0,15,0,0
"Netherlands (Kingdom of the)","2024-06-04",0,0,15,0,0,15,0,0
"Netherlands (Kingdom of the)","2024-06-05",0,0,15,0,0,15,0,0
"Netherlands (Kingdom of the)","2024-06-06",0,0,15,0,0,15,0,0
"Netherlands (Kingdom of the)","2024-06-07",0,0,15,0,0,15,0,0
"Netherlands (Kingdom of the)","2024-06-08",0,0,15,0,1,16,0,0
"Netherlands (Kingdom of the)","2024-06-09",0,0,15,0,0,16,0,0
"Netherlands (Kingdom of the)","2024-06-10",0,0,15,0,0,16,0,0
"Netherlands (Kingdom of the)","2024-06-11",0,0,15,0,0,16,0,0
"Netherlands (Kingdom of the)","2024-06-12",0,0,15,0,0,16,0,0
"Netherlands (Kingdom of the)","2024-06-13",0,0,15,0,0,16,0,0
"Netherlands (Kingdom of the)","2024-06-14",0,0,15,0,0,16,0,0
"Netherlands (Kingdom of the)","2024-06-15",0,0,15,0,0,16,0,0
"Netherlands (Kingdom of the)","2024-06-16",0,0,15,0,0,16,0,0
"Netherlands (Kingdom of the)","2024-06-17",0,0,15,0,0,16,0,0
"Netherlands (Kingdom of the)","2024-06-18",0,0,15,0,0,16,0,0
"Netherlands (Kingdom of the)","2024-06-19",0,0,15,0,0,16,0,0
"Netherlands (Kingdom of the)","2024-06-20",0,0,15,0,0,16,0,0
"Netherlands (Kingdom of the)","2024-06-21",0,0,15,0,0,16,0,0
"Netherlands (Kingdom of the)","2024-06-22",0,0,15,0,0,16,0,0
"Netherlands (Kingdom of the)","2024-06-23",0,0,15,0,1,17,0,0
"Netherlands (Kingdom of the)","2024-06-24",0,0,15,0,0,17,0,0
"Netherlands (Kingdom of the)","2024-06-25",0,0,15,0,0,17,0,0
"Netherlands (Kingdom of the)","2024-06-26",0,0,15,0,0,17,0,0
"Netherlands (Kingdom of the)","2024-06-27",0,0,15,0,0,17,0,0
"Netherlands (Kingdom of the)","2024-06-28",0,0,15,0,0,17,0,0
"Netherlands (Kingdom of the)","2024-06-29",0,0,15,0,0,17,0,0
"Netherlands (Kingdom of the)","2024-06-30",0,2,17,0,0,17,0,0
"Netherlands (Kingdom of the)","2024-07-01",0,0,17,0,0,17,0,0
"Netherlands (Kingdom of the)","2024-07-02",0,0,17,0,0,17,0,0
"Netherlands (Kingdom of the)","2024-07-03",0,0,17,0,0,17,0,0
"Netherlands (Kingdom of the)","2024-07-04",0,0,17,0,1,18,0,0
"Netherlands (Kingdom of the)","2024-07-05",0,0,17,0,0,18,0,0
"Netherlands (Kingdom of the)","2024-07-06",0,0,17,0,0,18,0,0
"Netherlands (Kingdom of the)","2024-07-07",0,0,17,0,0,18,0,0
"Netherlands (Kingdom of the)","2024-07-08",0,0,17,0,0,18,0,0
"Netherlands (Kingdom of the)","2024-07-09",0,0,17,0,0,18,0,0
"Netherlands (Kingdom of the)","2024-07-10",0,0,17,0,0,18,0,0
"Netherlands (Kingdom of the)","2024-07-11",0,0,17,0,0,18,0,0
"Netherlands (Kingdom of the)","2024-07-12",0,0,17,0,1,19,0,0
"Netherlands (Kingdom of the)","2024-07-13",0,0,17,0,0,19,0,0
"Netherlands (Kingdom of the)","2024-07-14",0,0,17,0,0,19,0,0
"Netherlands (Kingdom of the)","2024-07-15",0,0,17,0,0,19,0,0
"Netherlands (Kingdom of the)","2024-07-16",0,0,17,0,0,19,0,0
"Netherlands (Kingdom of the)","2024-07-17",0,0,17,0,0,19,0,0
"Netherlands (Kingdom of the)","2024-07-18",0,0,17,0,0,19,0,0
"Netherlands (Kingdom of the)","2024-07-19",0,0,17,0,0,19,0,0
"Netherlands (Kingdom of the)","2024-07-20",0,0,17,0,1,20,0,0
"Netherlands (Kingdom of the)","2024-07-21",0,0,17,0,0,20,0,0
"Netherlands (Kingdom of the)","2024-07-22",0,0,17,0,0,20,0,0
"Netherlands (Kingdom of the)","2024-07-23",0,0,17,0,0,20,0,0
"Netherlands (Kingdom of the)","2024-07-24",0,0,17,0,0,20,0,0
"Netherlands (Kingdom of the)","2024-07-25",0,0,17,0,0,20,0,0
"Netherlands (Kingdom of the)","2024-07-26",0,0,17,0,0,20,0,0
"Netherlands (Kingdom of the)","2024-07-27",0,0,17,0,0,20,0,0
"Netherlands (Kingdom of the)","2024-07-28",0,0,17,0,1,21,0,0
"Netherlands (Kingdom of the)","2024-07-29",0,0,17,0,0,21,0,0
"Netherlands (Kingdom of the)","2024-07-30",0,0,17,0,0,21,0,0
"Netherlands (Kingdom of the)","2024-07-31",0,4,21,0,0,21,0,0
"Netherlands (Kingdom of the)","2024-08-01",0,0,21,0,1,22,0,0
"Netherlands (Kingdom of the)","2024-08-02",0,0,21,0,0,22,0,0
"Netherlands (Kingdom of the)","2024-08-03",0,0,21,0,1,23,0,0
"Netherlands (Kingdom of the)","2024-08-04",0,0,21,0,0,23,0,0
"Netherlands (Kingdom of the)","2024-08-05",0,0,21,0,1,24,0,0
"Netherlands (Kingdom of the)","2024-08-06",0,0,21,0,1,25,0,0
"Netherlands (Kingdom of the)","2024-08-07",0,0,21,0,0,25,0,0
"Netherlands (Kingdom of the)","2024-08-08",0,0,21,0,1,26,0,0
"Netherlands (Kingdom of the)","2024-08-09",0,0,21,0,1,27,0,0
"Netherlands (Kingdom of the)","2024-08-10",0,0,21,0,0,27,0,0
"Netherlands (Kingdom of the)","2024-08-11",0,0,21,0,1,28,0,0
"Netherlands (Kingdom of the)","2024-08-12",0,0,21,0,0,28,0,0
"Netherlands (Kingdom of the)","2024-08-13",0,0,21,0,1,29,0,0
"Netherlands (Kingdom of the)","2024-08-14",0,0,21,0,1,30,0,0
"Netherlands (Kingdom of the)","2024-08-15",0,0,21,0,0,30,0,0
"Netherlands (Kingdom of the)","2024-08-16",0,0,21,0,1,31,0,0
"Netherlands (Kingdom of the)","2024-08-17",0,0,21,0,0,31,0,0
"Netherlands (Kingdom of the)","2024-08-18",0,0,21,0,1,32,0,0
"Netherlands (Kingdom of the)","2024-08-19",0,0,21,0,1,33,0,0
"Netherlands (Kingdom of the)","2024-08-20",0,0,21,0,0,33,0,0
"Netherlands (Kingdom of the)","2024-08-21",0,0,21,0,1,34,0,0
"Netherlands (Kingdom of the)","2024-08-22",0,0,21,0,0,34,0,0
"Netherlands (Kingdom of the)","2024-08-23",0,0,21,0,1,35,0,0
"Netherlands (Kingdom of the)","2024-08-24",0,0,21,0,1,36,0,0
"Netherlands (Kingdom of the)","2024-08-25",0,0,21,0,0,36,0,0
"Netherlands (Kingdom of the)","2024-08-26",0,0,21,0,1,37,0,0
"Netherlands (Kingdom of the)","2024-08-27",0,0,21,0,1,38,0,0
"Netherlands (Kingdom of the)","2024-08-28",0,0,21,0,0,38,0,0
"Netherlands (Kingdom of the)","2024-08-29",0,0,21,0,1,39,0,0
"Netherlands (Kingdom of the)","2024-08-30",0,0,21,0,0,39,0,0
"Netherlands (Kingdom of the)","2024-08-31",0,19,40,0,1,40,0,0
"Netherlands (Kingdom of the)","2024-09-01",0,0,40,0,1,41,0,0
"Netherlands (Kingdom of the)","2024-09-02",0,0,40,0,0,41,0,0
"Netherlands (Kingdom of the)","2024-09-03",0,0,40,0,1,42,0,0
"Netherlands (Kingdom of the)","2024-09-04",0,0,40,0,1,43,0,0
"Netherlands (Kingdom of the)","2024-09-05",0,0,40,0,1,44,0,0
"Netherlands (Kingdom of the)","2024-09-06",0,0,40,0,0,44,0,0
"Netherlands (Kingdom of the)","2024-09-07",0,0,40,0,1,45,0,0
"Netherlands (Kingdom of the)","2024-09-08",0,0,40,0,1,46,0,0
"Netherlands (Kingdom of the)","2024-09-09",0,0,40,0,1,47,0,0
"Netherlands (Kingdom of the)","2024-09-10",0,0,40,0,0,47,0,0
"Netherlands (Kingdom of the)","2024-09-11",0,0,40,0,1,48,0,0
"Netherlands (Kingdom of the)","2024-09-12",0,0,40,0,1,49,0,0
"Netherlands (Kingdom of the)","2024-09-13",0,0,40,0,1,50,0,0
"Netherlands (Kingdom of the)","2024-09-14",0,0,40,0,0,50,0,0
"Netherlands (Kingdom of the)","2024-09-15",0,0,40,0,1,51,0,0
"Netherlands (Kingdom of the)","2024-09-16",0,0,40,0,1,52,0,0
"Netherlands (Kingdom of the)","2024-09-17",0,0,40,0,0,52,0,0
"Netherlands (Kingdom of the)","2024-09-18",0,0,40,0,1,53,0,0
"Netherlands (Kingdom of the)","2024-09-19",0,0,40,0,1,54,0,0
"Netherlands (Kingdom of the)","2024-09-20",0,0,40,0,1,55,0,0
"Netherlands (Kingdom of the)","2024-09-21",0,0,40,0,0,55,0,0
"Netherlands (Kingdom of the)","2024-09-22",0,0,40,0,1,56,0,0
"Netherlands (Kingdom of the)","2024-09-23",0,0,40,0,1,57,0,0
"Netherlands (Kingdom of the)","2024-09-24",0,0,40,0,1,58,0,0
"Netherlands (Kingdom of the)","2024-09-25",0,0,40,0,0,58,0,0
"Netherlands (Kingdom of the)","2024-09-26",0,0,40,0,1,59,0,0
"Netherlands (Kingdom of the)","2024-09-27",0,0,40,0,1,60,0,0
"Netherlands (Kingdom of the)","2024-09-28",0,0,40,0,1,61,0,0
"Netherlands (Kingdom of the)","2024-09-29",0,0,40,0,0,61,0,0
"Netherlands (Kingdom of the)","2024-09-30",0,22,62,0,1,62,0,0
"Netherlands (Kingdom of the)","2024-10-01",0,0,62,0,1,63,0,0
"Netherlands (Kingdom of the)","2024-10-02",0,0,62,0,1,64,0,0
"Netherlands (Kingdom of the)","2024-10-03",0,0,62,0,0,64,0,0
"Netherlands (Kingdom of the)","2024-10-04",0,0,62,0,1,65,0,0
"Netherlands (Kingdom of the)","2024-10-05",0,0,62,0,1,66,0,0
"Netherlands (Kingdom of the)","2024-10-06",0,0,62,0,1,67,0,0
"Netherlands (Kingdom of the)","2024-10-07",0,0,62,0,1,68,0,0
"Netherlands (Kingdom of the)","2024-10-08",0,0,62,0,0,68,0,0
"Netherlands (Kingdom of the)","2024-10-09",0,0,62,0,1,69,0,0
"Netherlands (Kingdom of the)","2024-10-10",0,0,62,0,1,70,0,0
"Netherlands (Kingdom of the)","2024-10-11",0,0,62,0,1,71,0,0
"Netherlands (Kingdom of the)","2024-10-12",0,0,62,0,1,72,0,0
"Netherlands (Kingdom of the)","2024-10-13",0,0,62,0,0,72,0,0
"Netherlands (Kingdom of the)","2024-10-14",0,0,62,0,1,73,0,0
"Netherlands (Kingdom of the)","2024-10-15",0,0,62,0,1,74,0,0
"Netherlands (Kingdom of the)","2024-10-16",0,0,62,0,1,75,0,0
"Netherlands (Kingdom of the)","2024-10-17",0,0,62,0,1,76,0,0
"Netherlands (Kingdom of the)","2024-10-18",0,0,62,0,1,77,0,0
"Netherlands (Kingdom of the)","2024-10-19",0,0,62,0,0,77,0,0
"Netherlands (Kingdom of the)","2024-10-20",0,0,62,0,1,78,0,0
"Netherlands (Kingdom of the)","2024-10-21",0,0,62,0,1,79,0,0
"Netherlands (Kingdom of the)","2024-10-22",0,0,62,0,1,80,0,0
"Netherlands (Kingdom of the)","2024-10-23",0,0,62,0,1,81,0,0
"Netherlands (Kingdom of the)","2024-10-24",0,0,62,0,0,81,0,0
"Netherlands (Kingdom of the)","2024-10-25",0,0,62,0,1,82,0,0
"Netherlands (Kingdom of the)","2024-10-26",0,0,62,0,1,83,0,0
"Netherlands (Kingdom of the)","2024-10-27",0,0,62,0,1,84,0,0
"Netherlands (Kingdom of the)","2024-10-28",0,0,62,0,1,85,0,0
"Netherlands (Kingdom of the)","2024-10-29",0,0,62,0,0,85,0,0
"Netherlands (Kingdom of the)","2024-10-30",0,0,62,0,1,86,0,0
"Netherlands (Kingdom of the)","2024-10-31",0,25,87,0,1,87,0,0
"Netherlands (Kingdom of the)","2024-11-01",0,0,87,0,1,88,0,0
"Netherlands (Kingdom of the)","2024-11-02",0,0,87,0,2,90,0,0
"Netherlands (Kingdom of the)","2024-11-03",0,0,87,0,1,91,0,0
"Netherlands (Kingdom of the)","2024-11-04",0,0,87,0,1,92,0,0
"Netherlands (Kingdom of the)","2024-11-05",0,0,87,0,1,93,0,0
"Netherlands (Kingdom of the)","2024-11-06",0,0,87,0,2,95,0,0
"Netherlands (Kingdom of the)","2024-11-07",0,0,87,0,1,96,0,0
"Netherlands (Kingdom of the)","2024-11-08",0,0,87,0,1,97,0,0
"Netherlands (Kingdom of the)","2024-11-09",0,0,87,0,1,98,0,0
"Netherlands (Kingdom of the)","2024-11-10",0,0,87,0,2,100,0,0
"Netherlands (Kingdom of the)","2024-11-11",0,0,87,0,1,101,0,0
"Netherlands (Kingdom of the)","2024-11-12",0,0,87,0,1,102,0,0
"Netherlands (Kingdom of the)","2024-11-13",0,0,87,0,1,103,0,0
"Netherlands (Kingdom of the)","2024-11-14",0,0,87,0,2,105,0,0
"Netherlands (Kingdom of the)","2024-11-15",0,0,87,0,1,106,0,0
"Netherlands (Kingdom of the)","2024-11-16",0,0,87,0,1,107,0,0
"Netherlands (Kingdom of the)","2024-11-17",0,0,87,0,2,109,0,0
"Netherlands (Kingdom of the)","2024-11-18",0,0,87,0,1,110,0,0
"Netherlands (Kingdom of the)","2024-11-19",0,0,87,0,1,111,0,0
"Netherlands (Kingdom of the)","2024-11-20",0,0,87,0,1,112,0,0
"Netherlands (Kingdom of the)","2024-11-21",0,0,87,0,2,114,0,0
"Netherlands (Kingdom of the)","2024-11-22",0,0,87,0,1,115,0,0
"Netherlands (Kingdom of the)","2024-11-23",0,0,87,0,1,116,0,0
"Netherlands (Kingdom of the)","2024-11-24",0,0,87,0,1,117,0,0
"Netherlands (Kingdom of the)","2024-11-25",0,0,87,0,2,119,0,0
"Netherlands (Kingdom of the)","2024-11-26",0,0,87,0,1,120,0,0
"Netherlands (Kingdom of the)","2024-11-27",0,0,87,0,1,121,0,0
"Netherlands (Kingdom of the)","2024-11-28",0,0,87,0,1,122,0,0
"Netherlands (Kingdom of the)","2024-11-29",0,0,87,0,2,124,0,0
"Netherlands (Kingdom of the)","2024-11-30",0,38,125,0,1,125,0,0
"Netherlands (Kingdom of the)","2024-12-01",0,0,125,0,1,126,0,0
"Netherlands (Kingdom of the)","2024-12-02",0,0,125,0,0,126,0,0
"Netherlands (Kingdom of the)","2024-12-03",0,0,125,0,1,127,0,0
"Netherlands (Kingdom of the)","2024-12-04",0,0,125,0,0,127,0,0
"Netherlands (Kingdom of the)","2024-12-05",0,0,125,0,1,128,0,0
"Netherlands (Kingdom of the)","2024-12-06",0,0,125,0,0,128,0,0
"Netherlands (Kingdom of the)","2024-12-07",0,0,125,0,1,129,0,0
"Netherlands (Kingdom of the)","2024-12-08",0,0,125,0,0,129,0,0
"Netherlands (Kingdom of the)","2024-12-09",0,0,125,0,1,130,0,0
"Netherlands (Kingdom of the)","2024-12-10",0,0,125,0,0,130,0,0
"Netherlands (Kingdom of the)","2024-12-11",0,0,125,0,1,131,0,0
"Netherlands (Kingdom of the)","2024-12-12",0,0,125,0,0,131,0,0
"Netherlands (Kingdom of the)","2024-12-13",0,0,125,0,1,132,0,0
"Netherlands (Kingdom of the)","2024-12-14",0,0,125,0,0,132,0,0
"Netherlands (Kingdom of the)","2024-12-15",0,0,125,0,1,133,0,0
"Netherlands (Kingdom of the)","2024-12-16",0,0,125,0,0,133,0,0
"Netherlands (Kingdom of the)","2024-12-17",0,0,125,0,1,134,0,0
"Netherlands (Kingdom of the)","2024-12-18",0,0,125,0,0,134,0,0
"Netherlands (Kingdom of the)","2024-12-19",0,0,125,0,1,135,0,0
"Netherlands (Kingdom of the)","2024-12-20",0,0,125,0,0,135,0,0
"Netherlands (Kingdom of the)","2024-12-21",0,0,125,0,1,136,0,0
"Netherlands (Kingdom of the)","2024-12-22",0,0,125,0,0,136,0,0
"Netherlands (Kingdom of the)","2024-12-23",0,0,125,0,1,137,0,0
"Netherlands (Kingdom of the)","2024-12-24",0,0,125,0,0,137,0,0
"Netherlands (Kingdom of the)","2024-12-25",0,0,125,0,1,138,0,0
"Netherlands (Kingdom of the)","2024-12-26",0,0,125,0,0,138,0,0
"Netherlands (Kingdom of the)","2024-12-27",0,0,125,0,1,139,0,0
"Netherlands (Kingdom of the)","2024-12-28",0,0,125,0,0,139,0,0
"Netherlands (Kingdom of the)","2024-12-29",0,0,125,0,1,140,0,0
"Netherlands (Kingdom of the)","2024-12-30",0,0,125,0,0,140,0,0
"Netherlands (Kingdom of the)","2024-12-31",0,16,141,0,1,141,0,0
"Netherlands (Kingdom of the)","2025-01-01",0,0,141,0,0,141,0,0
"Netherlands (Kingdom of the)","2025-01-02",0,0,141,0,0,141,0,0
"Netherlands (Kingdom of the)","2025-01-03",0,0,141,0,0,141,0,0
"Netherlands (Kingdom of the)","2025-01-04",0,0,141,0,0,141,0,0
"Netherlands (Kingdom of the)","2025-01-05",0,0,141,0,0,141,0,0
"Netherlands (Kingdom of the)","2025-01-06",0,0,141,0,0,141,0,0
"Netherlands (Kingdom of the)","2025-01-07",0,0,141,0,0,141,0,0
"Netherlands (Kingdom of the)","2025-01-08",0,0,141,0,0,141,0,0
"Netherlands (Kingdom of the)","2025-01-09",0,0,141,0,0,141,0,0
"Netherlands (Kingdom of the)","2025-01-10",0,0,141,0,0,141,0,0
"Netherlands (Kingdom of the)","2025-01-11",0,0,141,0,0,141,0,0
"Netherlands (Kingdom of the)","2025-01-12",0,0,141,0,0,141,0,0
"Netherlands (Kingdom of the)","2025-01-13",0,0,141,0,0,141,0,0
"Netherlands (Kingdom of the)","2025-01-14",0,0,141,0,0,141,0,0
"Netherlands (Kingdom of the)","2025-01-15",0,0,141,0,0,141,0,0
"Netherlands (Kingdom of the)","2025-01-16",0,0,141,0,0,141,0,0
"Netherlands (Kingdom of the)","2025-01-17",0,0,141,0,0,141,0,0
"Netherlands (Kingdom of the)","2025-01-18",0,0,141,0,0,141,0,0
"Netherlands (Kingdom of the)","2025-01-19",0,0,141,0,0,141,0,0
"Netherlands (Kingdom of the)","2025-01-20",0,0,141,0,0,141,0,0
"Netherlands (Kingdom of the)","2025-01-21",0,0,141,0,0,141,0,0
"Netherlands (Kingdom of the)","2025-01-22",0,0,141,0,0,141,0,0
"Netherlands (Kingdom of the)","2025-01-23",0,0,141,0,0,141,0,0
"Netherlands (Kingdom of the)","2025-01-24",0,0,141,0,0,141,0,0
"Netherlands (Kingdom of the)","2025-01-25",0,0,141,0,0,141,0,0
"Netherlands (Kingdom of the)","2025-01-26",0,0,141,0,0,141,0,0
"Netherlands (Kingdom of the)","2025-01-27",0,0,141,0,0,141,0,0
"Netherlands (Kingdom of the)","2025-01-28",0,0,141,0,0,141,0,0
"Netherlands (Kingdom of the)","2025-01-29",0,0,141,0,0,141,0,0
"Netherlands (Kingdom of the)","2025-01-30",0,0,141,0,0,141,0,0
"Netherlands (Kingdom of the)","2025-01-31",0,0,141,0,0,141,0,0
"Netherlands (Kingdom of the)","2025-02-01",0,0,141,0,0,141,0,0
"Netherlands (Kingdom of the)","2025-02-02",0,0,141,0,0,141,0,0
"Netherlands (Kingdom of the)","2025-02-03",0,0,141,0,0,141,0,0
"New Zealand","2024-01-01",0,0,0,0,0,0,0,0
"New Zealand","2024-01-02",0,0,0,0,0,0,0,0
"New Zealand","2024-01-03",0,0,0,0,0,0,0,0
"New Zealand","2024-01-04",0,0,0,0,0,0,0,0
"New Zealand","2024-01-05",0,0,0,0,0,0,0,0
"New Zealand","2024-01-06",0,0,0,0,0,0,0,0
"New Zealand","2024-01-07",0,0,0,0,0,0,0,0
"New Zealand","2024-01-08",0,0,0,0,0,0,0,0
"New Zealand","2024-01-09",0,0,0,0,0,0,0,0
"New Zealand","2024-01-10",0,0,0,0,0,0,0,0
"New Zealand","2024-01-11",0,0,0,0,0,0,0,0
"New Zealand","2024-01-12",0,0,0,0,0,0,0,0
"New Zealand","2024-01-13",0,0,0,0,0,0,0,0
"New Zealand","2024-01-14",0,0,0,0,0,0,0,0
"New Zealand","2024-01-15",0,0,0,0,0,0,0,0
"New Zealand","2024-01-16",0,8,8,0,8,8,0,0
"New Zealand","2024-01-17",0,0,8,0,0,8,0,0
"New Zealand","2024-01-18",0,0,8,0,0,8,0,0
"New Zealand","2024-01-19",0,0,8,0,0,8,0,0
"New Zealand","2024-01-20",0,0,8,0,0,8,0,0
"New Zealand","2024-01-21",0,0,8,0,0,8,0,0
"New Zealand","2024-01-22",0,0,8,0,0,8,0,0
"New Zealand","2024-01-23",0,0,8,0,0,8,0,0
"New Zealand","2024-01-24",0,0,8,0,0,8,0,0
"New Zealand","2024-01-25",0,0,8,0,0,8,0,0
"New Zealand","2024-01-26",0,0,8,0,0,8,0,0
"New Zealand","2024-01-27",0,0,8,0,0,8,0,0
"New Zealand","2024-01-28",0,0,8,0,0,8,0,0
"New Zealand","2024-01-29",0,0,8,0,0,8,0,0
"New Zealand","2024-01-30",0,0,8,0,0,8,0,0
"New Zealand","2024-01-31",0,0,8,0,0,8,0,0
"New Zealand","2024-02-01",0,0,8,0,0,8,0,0
"New Zealand","2024-02-02",0,0,8,0,0,8,0,0
"New Zealand","2024-02-03",0,0,8,0,0,8,0,0
"New Zealand","2024-02-04",0,0,8,0,0,8,0,0
"New Zealand","2024-02-05",0,0,8,0,0,8,0,0
"New Zealand","2024-02-06",0,0,8,0,0,8,0,0
"New Zealand","2024-02-07",0,0,8,0,0,8,0,0
"New Zealand","2024-02-08",0,0,8,0,0,8,0,0
"New Zealand","2024-02-09",0,0,8,0,0,8,0,0
"New Zealand","2024-02-10",0,0,8,0,0,8,0,0
"New Zealand","2024-02-11",0,0,8,0,0,8,0,0
"New Zealand","2024-02-12",0,0,8,0,0,8,0,0
"New Zealand","2024-02-13",0,0,8,0,0,8,0,0
"New Zealand","2024-02-14",0,0,8,0,0,8,0,0
"New Zealand","2024-02-15",0,0,8,0,0,8,0,0
"New Zealand","2024-02-16",0,0,8,0,0,8,0,0
"New Zealand","2024-02-17",0,0,8,0,0,8,0,0
"New Zealand","2024-02-18",0,0,8,0,0,8,0,0
"New Zealand","2024-02-19",0,0,8,0,0,8,0,0
"New Zealand","2024-02-20",0,0,8,0,0,8,0,0
"New Zealand","2024-02-21",0,0,8,0,0,8,0,0
"New Zealand","2024-02-22",0,0,8,0,0,8,0,0
"New Zealand","2024-02-23",0,0,8,0,0,8,0,0
"New Zealand","2024-02-24",0,0,8,0,0,8,0,0
"New Zealand","2024-02-25",0,0,8,0,0,8,0,0
"New Zealand","2024-02-26",0,0,8,0,0,8,0,0
"New Zealand","2024-02-27",0,0,8,0,0,8,0,0
"New Zealand","2024-02-28",0,0,8,0,0,8,0,0
"New Zealand","2024-02-29",0,0,8,0,0,8,0,0
"New Zealand","2024-03-01",0,0,8,0,0,8,0,0
"New Zealand","2024-03-02",0,0,8,0,0,8,0,0
"New Zealand","2024-03-03",0,0,8,0,0,8,0,0
"New Zealand","2024-03-04",0,0,8,0,0,8,0,0
"New Zealand","2024-03-05",0,0,8,0,0,8,0,0
"New Zealand","2024-03-06",0,0,8,0,0,8,0,0
"New Zealand","2024-03-07",0,0,8,0,0,8,0,0
"New Zealand","2024-03-08",0,0,8,0,0,8,0,0
"New Zealand","2024-03-09",0,0,8,0,0,8,0,0
"New Zealand","2024-03-10",0,0,8,0,0,8,0,0
"New Zealand","2024-03-11",0,0,8,0,0,8,0,0
"New Zealand","2024-03-12",0,0,8,0,0,8,0,0
"New Zealand","2024-03-13",0,0,8,0,0,8,0,0
"New Zealand","2024-03-14",0,0,8,0,1,9,0,0
"New Zealand","2024-03-15",0,0,8,0,0,9,0,0
"New Zealand","2024-03-16",0,0,8,0,0,9,0,0
"New Zealand","2024-03-17",0,0,8,0,0,9,0,0
"New Zealand","2024-03-18",0,0,8,0,0,9,0,0
"New Zealand","2024-03-19",0,0,8,0,0,9,0,0
"New Zealand","2024-03-20",0,0,8,0,0,9,0,0
"New Zealand","2024-03-21",0,0,8,0,0,9,0,0
"New Zealand","2024-03-22",0,0,8,0,0,9,0,0
"New Zealand","2024-03-23",0,0,8,0,0,9,0,0
"New Zealand","2024-03-24",0,0,8,0,0,9,0,0
"New Zealand","2024-03-25",0,0,8,0,0,9,0,0
"New Zealand","2024-03-26",0,0,8,0,0,9,0,0
"New Zealand","2024-03-27",0,0,8,0,0,9,0,0
"New Zealand","2024-03-28",0,0,8,0,0,9,0,0
"New Zealand","2024-03-29",0,0,8,0,0,9,0,0
"New Zealand","2024-03-30",0,0,8,0,0,9,0,0
"New Zealand","2024-03-31",0,0,8,0,0,9,0,0
"New Zealand","2024-04-01",0,0,8,0,0,9,0,0
"New Zealand","2024-04-02",0,0,8,0,0,9,0,0
"New Zealand","2024-04-03",0,0,8,0,0,9,0,0
"New Zealand","2024-04-04",0,0,8,0,0,9,0,0
"New Zealand","2024-04-05",0,0,8,0,0,9,0,0
"New Zealand","2024-04-06",0,0,8,0,0,9,0,0
"New Zealand","2024-04-07",0,0,8,0,0,9,0,0
"New Zealand","2024-04-08",0,0,8,0,0,9,0,0
"New Zealand","2024-04-09",0,0,8,0,0,9,0,0
"New Zealand","2024-04-10",0,0,8,0,0,9,0,0
"New Zealand","2024-04-11",0,0,8,0,0,9,0,0
"New Zealand","2024-04-12",0,0,8,0,0,9,0,0
"New Zealand","2024-04-13",0,0,8,0,0,9,0,0
"New Zealand","2024-04-14",0,0,8,0,0,9,0,0
"New Zealand","2024-04-15",0,0,8,0,0,9,0,0
"New Zealand","2024-04-16",0,0,8,0,0,9,0,0
"New Zealand","2024-04-17",0,0,8,0,0,9,0,0
"New Zealand","2024-04-18",0,0,8,0,0,9,0,0
"New Zealand","2024-04-19",0,0,8,0,0,9,0,0
"New Zealand","2024-04-20",0,0,8,0,0,9,0,0
"New Zealand","2024-04-21",0,0,8,0,0,9,0,0
"New Zealand","2024-04-22",0,0,8,0,0,9,0,0
"New Zealand","2024-04-23",0,0,8,0,0,9,0,0
"New Zealand","2024-04-24",0,0,8,0,0,9,0,0
"New Zealand","2024-04-25",0,0,8,0,0,9,0,0
"New Zealand","2024-04-26",0,0,8,0,0,9,0,0
"New Zealand","2024-04-27",0,0,8,0,0,9,0,0
"New Zealand","2024-04-28",0,0,8,0,0,9,0,0
"New Zealand","2024-04-29",0,0,8,0,0,9,0,0
"New Zealand","2024-04-30",0,0,8,0,0,9,0,0
"New Zealand","2024-05-01",0,0,8,0,0,9,0,0
"New Zealand","2024-05-02",0,0,8,0,0,9,0,0
"New Zealand","2024-05-03",0,0,8,0,0,9,0,0
"New Zealand","2024-05-04",0,0,8,0,0,9,0,0
"New Zealand","2024-05-05",0,0,8,0,0,9,0,0
"New Zealand","2024-05-06",0,0,8,0,0,9,0,0
"New Zealand","2024-05-07",0,0,8,0,0,9,0,0
"New Zealand","2024-05-08",0,0,8,0,0,9,0,0
"New Zealand","2024-05-09",0,1,9,0,0,9,0,0
"New Zealand","2024-05-10",0,0,9,0,0,9,0,0
"New Zealand","2024-05-11",0,0,9,0,0,9,0,0
"New Zealand","2024-05-12",0,0,9,0,0,9,0,0
"New Zealand","2024-05-13",0,0,9,0,0,9,0,0
"New Zealand","2024-05-14",0,0,9,0,0,9,0,0
"New Zealand","2024-05-15",0,0,9,0,0,9,0,0
"New Zealand","2024-05-16",0,0,9,0,0,9,0,0
"New Zealand","2024-05-17",0,0,9,0,0,9,0,0
"New Zealand","2024-05-18",0,0,9,0,0,9,0,0
"New Zealand","2024-05-19",0,0,9,0,0,9,0,0
"New Zealand","2024-05-20",0,0,9,0,0,9,0,0
"New Zealand","2024-05-21",0,0,9,0,0,9,0,0
"New Zealand","2024-05-22",0,0,9,0,0,9,0,0
"New Zealand","2024-05-23",0,0,9,0,1,10,0,0
"New Zealand","2024-05-24",0,0,9,0,0,10,0,0
"New Zealand","2024-05-25",0,0,9,0,0,10,0,0
"New Zealand","2024-05-26",0,0,9,0,0,10,0,0
"New Zealand","2024-05-27",0,0,9,0,0,10,0,0
"New Zealand","2024-05-28",0,0,9,0,0,10,0,0
"New Zealand","2024-05-29",0,0,9,0,0,10,0,0
"New Zealand","2024-05-30",0,0,9,0,0,10,0,0
"New Zealand","2024-05-31",0,0,9,0,0,10,0,0
"New Zealand","2024-06-01",0,0,9,0,0,10,0,0
"New Zealand","2024-06-02",0,0,9,0,0,10,0,0
"New Zealand","2024-06-03",0,0,9,0,0,10,0,0
"New Zealand","2024-06-04",0,0,9,0,0,10,0,0
"New Zealand","2024-06-05",0,0,9,0,0,10,0,0
"New Zealand","2024-06-06",0,0,9,0,0,10,0,0
"New Zealand","2024-06-07",0,0,9,0,0,10,0,0
"New Zealand","2024-06-08",0,0,9,0,0,10,0,0
"New Zealand","2024-06-09",0,0,9,0,0,10,0,0
"New Zealand","2024-06-10",0,0,9,0,0,10,0,0
"New Zealand","2024-06-11",0,0,9,0,0,10,0,0
"New Zealand","2024-06-12",0,0,9,0,0,10,0,0
"New Zealand","2024-06-13",0,0,9,0,0,10,0,0
"New Zealand","2024-06-14",0,0,9,0,0,10,0,0
"New Zealand","2024-06-15",0,0,9,0,0,10,0,0
"New Zealand","2024-06-16",0,0,9,0,0,10,0,0
"New Zealand","2024-06-17",0,0,9,0,0,10,0,0
"New Zealand","2024-06-18",0,0,9,0,1,11,0,0
"New Zealand","2024-06-19",0,0,9,0,0,11,0,0
"New Zealand","2024-06-20",0,0,9,0,0,11,0,0
"New Zealand","2024-06-21",0,0,9,0,0,11,0,0
"New Zealand","2024-06-22",0,0,9,0,0,11,0,0
"New Zealand","2024-06-23",0,0,9,0,0,11,0,0
"New Zealand","2024-06-24",0,0,9,0,0,11,0,0
"New Zealand","2024-06-25",0,0,9,0,0,11,0,0
"New Zealand","2024-06-26",0,0,9,0,0,11,0,0
"New Zealand","2024-06-27",0,0,9,0,0,11,0,0
"New Zealand","2024-06-28",0,0,9,0,0,11,0,0
"New Zealand","2024-06-29",0,0,9,0,0,11,0,0
"New Zealand","2024-06-30",0,0,9,0,0,11,0,0
"New Zealand","2024-07-01",0,2,11,0,0,11,0,0
"New Zealand","2024-07-02",0,0,11,0,0,11,0,0
"New Zealand","2024-07-03",0,0,11,0,0,11,0,0
"New Zealand","2024-07-04",0,0,11,0,0,11,0,0
"New Zealand","2024-07-05",0,0,11,0,0,11,0,0
"New Zealand","2024-07-06",0,0,11,0,1,12,0,0
"New Zealand","2024-07-07",0,0,11,0,0,12,0,0
"New Zealand","2024-07-08",0,0,11,0,0,12,0,0
"New Zealand","2024-07-09",0,0,11,0,0,12,0,0
"New Zealand","2024-07-10",0,0,11,0,0,12,0,0
"New Zealand","2024-07-11",0,0,11,0,0,12,0,0
"New Zealand","2024-07-12",0,0,11,0,0,12,0,0
"New Zealand","2024-07-13",0,0,11,0,0,12,0,0
"New Zealand","2024-07-14",0,0,11,0,0,12,0,0
"New Zealand","2024-07-15",0,0,11,0,1,13,0,0
"New Zealand","2024-07-16",0,0,11,0,0,13,0,0
"New Zealand","2024-07-17",0,0,11,0,0,13,0,0
"New Zealand","2024-07-18",0,0,11,0,0,13,0,0
"New Zealand","2024-07-19",0,0,11,0,0,13,0,0
"New Zealand","2024-07-20",0,0,11,0,0,13,0,0
"New Zealand","2024-07-21",0,0,11,0,0,13,0,0
"New Zealand","2024-07-22",0,0,11,0,0,13,0,0
"New Zealand","2024-07-23",0,0,11,0,0,13,0,0
"New Zealand","2024-07-24",0,0,11,0,1,14,0,0
"New Zealand","2024-07-25",0,0,11,0,0,14,0,0
"New Zealand","2024-07-26",0,0,11,0,0,14,0,0
"New Zealand","2024-07-27",0,0,11,0,0,14,0,0
"New Zealand","2024-07-28",0,0,11,0,0,14,0,0
"New Zealand","2024-07-29",0,0,11,0,0,14,0,0
"New Zealand","2024-07-30",0,0,11,0,0,14,0,0
"New Zealand","2024-07-31",0,0,11,0,0,14,0,0
"New Zealand","2024-08-01",0,0,11,0,1,15,0,0
"New Zealand","2024-08-02",0,0,11,0,0,15,0,0
"New Zealand","2024-08-03",0,0,11,0,0,15,0,0
"New Zealand","2024-08-04",0,0,11,0,0,15,0,0
"New Zealand","2024-08-05",0,0,11,0,0,15,0,0
"New Zealand","2024-08-06",0,0,11,0,0,15,0,0
"New Zealand","2024-08-07",0,0,11,0,0,15,0,0
"New Zealand","2024-08-08",0,0,11,0,0,15,0,0
"New Zealand","2024-08-09",0,0,11,0,0,15,0,0
"New Zealand","2024-08-10",0,0,11,0,1,16,0,0
"New Zealand","2024-08-11",0,0,11,0,0,16,0,0
"New Zealand","2024-08-12",0,0,11,0,0,16,0,0
"New Zealand","2024-08-13",0,0,11,0,0,16,0,0
"New Zealand","2024-08-14",0,0,11,0,0,16,0,0
"New Zealand","2024-08-15",0,0,11,0,0,16,0,0
"New Zealand","2024-08-16",0,0,11,0,0,16,0,0
"New Zealand","2024-08-17",0,0,11,0,0,16,0,0
"New Zealand","2024-08-18",0,0,11,0,0,16,0,0
"New Zealand","2024-08-19",0,0,11,0,1,17,0,0
"New Zealand","2024-08-20",0,0,11,0,0,17,0,0
"New Zealand","2024-08-21",0,0,11,0,0,17,0,0
"New Zealand","2024-08-22",0,0,11,0,0,17,0,0
"New Zealand","2024-08-23",0,0,11,0,0,17,0,0
"New Zealand","2024-08-24",0,0,11,0,0,17,0,0
"New Zealand","2024-08-25",0,0,11,0,0,17,0,0
"New Zealand","2024-08-26",0,0,11,0,0,17,0,0
"New Zealand","2024-08-27",0,0,11,0,0,17,0,0
"New Zealand","2024-08-28",0,0,11,0,1,18,0,0
"New Zealand","2024-08-29",0,0,11,0,0,18,0,0
"New Zealand","2024-08-30",0,0,11,0,0,18,0,0
"New Zealand","2024-08-31",0,0,11,0,0,18,0,0
"New Zealand","2024-09-01",0,0,11,0,0,18,0,0
"New Zealand","2024-09-02",0,0,11,0,0,18,0,0
"New Zealand","2024-09-03",0,0,11,0,0,18,0,0
"New Zealand","2024-09-04",0,0,11,0,0,18,0,0
"New Zealand","2024-09-05",0,0,11,0,0,18,0,0
"New Zealand","2024-09-06",0,0,11,0,1,19,0,0
"New Zealand","2024-09-07",0,0,11,0,0,19,0,0
"New Zealand","2024-09-08",0,0,11,0,0,19,0,0
"New Zealand","2024-09-09",0,0,11,0,0,19,0,0
"New Zealand","2024-09-10",0,0,11,0,0,19,0,0
"New Zealand","2024-09-11",0,0,11,0,0,19,0,0
"New Zealand","2024-09-12",0,0,11,0,0,19,0,0
"New Zealand","2024-09-13",0,0,11,0,0,19,0,0
"New Zealand","2024-09-14",0,0,11,0,0,19,0,0
"New Zealand","2024-09-15",0,0,11,0,1,20,0,0
"New Zealand","2024-09-16",0,0,11,0,0,20,0,0
"New Zealand","2024-09-17",0,0,11,0,0,20,0,0
"New Zealand","2024-09-18",0,0,11,0,0,20,0,0
"New Zealand","2024-09-19",0,0,11,0,0,20,0,0
"New Zealand","2024-09-20",0,0,11,0,0,20,0,0
"New Zealand","2024-09-21",0,0,11,0,0,20,0,0
"New Zealand","2024-09-22",0,0,11,0,0,20,0,0
"New Zealand","2024-09-23",0,0,11,0,1,21,0,0
"New Zealand","2024-09-24",0,0,11,0,0,21,0,0
"New Zealand","2024-09-25",0,0,11,0,0,21,0,0
"New Zealand","2024-09-26",0,0,11,0,0,21,0,0
"New Zealand","2024-09-27",0,0,11,0,0,21,0,0
"New Zealand","2024-09-28",0,0,11,0,0,21,0,0
"New Zealand","2024-09-29",0,0,11,0,0,21,0,0
"New Zealand","2024-09-30",0,0,11,0,0,21,0,0
"New Zealand","2024-10-01",0,0,11,0,0,21,0,0
"New Zealand","2024-10-02",0,0,11,0,1,22,0,0
"New Zealand","2024-10-03",0,0,11,0,0,22,0,0
"New Zealand","2024-10-04",0,0,11,0,0,22,0,0
"New Zealand","2024-10-05",0,0,11,0,0,22,0,0
"New Zealand","2024-10-06",0,0,11,0,0,22,0,0
"New Zealand","2024-10-07",0,0,11,0,0,22,0,0
"New Zealand","2024-10-08",0,0,11,0,0,22,0,0
"New Zealand","2024-10-09",0,0,11,0,0,22,0,0
"New Zealand","2024-10-10",0,0,11,0,0,22,0,0
"New Zealand","2024-10-11",0,0,11,0,1,23,0,0
"New Zealand","2024-10-12",0,0,11,0,0,23,0,0
"New Zealand","2024-10-13",0,0,11,0,0,23,0,0
"New Zealand","2024-10-14",0,0,11,0,0,23,0,0
"New Zealand","2024-10-15",0,12,23,0,0,23,0,0
"New Zealand","2024-10-16",0,0,23,0,0,23,0,0
"New Zealand","2024-10-17",0,0,23,0,0,23,0,0
"New Zealand","2024-10-18",0,0,23,0,0,23,0,0
"New Zealand","2024-10-19",0,0,23,0,0,23,0,0
"New Zealand","2024-10-20",0,0,23,0,0,23,0,0
"New Zealand","2024-10-21",0,0,23,0,0,23,0,0
"New Zealand","2024-10-22",0,0,23,0,0,23,0,0
"New Zealand","2024-10-23",0,0,23,0,0,23,0,0
"New Zealand","2024-10-24",0,0,23,0,0,23,0,0
"New Zealand","2024-10-25",0,0,23,0,0,23,0,0
"New Zealand","2024-10-26",0,0,23,0,1,24,0,0
"New Zealand","2024-10-27",0,0,23,0,0,24,0,0
"New Zealand","2024-10-28",0,0,23,0,0,24,0,0
"New Zealand","2024-10-29",0,0,23,0,0,24,0,0
"New Zealand","2024-10-30",0,0,23,0,0,24,0,0
"New Zealand","2024-10-31",0,0,23,0,0,24,0,0
"New Zealand","2024-11-01",0,0,23,0,0,24,0,0
"New Zealand","2024-11-02",0,0,23,0,0,24,0,0
"New Zealand","2024-11-03",0,0,23,0,0,24,0,0
"New Zealand","2024-11-04",0,1,24,0,0,24,0,0
"New Zealand","2024-11-05",0,0,24,0,0,24,0,0
"New Zealand","2024-11-06",0,0,24,0,0,24,0,0
"New Zealand","2024-11-07",0,0,24,0,0,24,0,0
"New Zealand","2024-11-08",0,0,24,0,0,24,0,0
"New Zealand","2024-11-09",0,0,24,0,0,24,0,0
"New Zealand","2024-11-10",0,0,24,0,1,25,0,0
"New Zealand","2024-11-11",0,0,24,0,0,25,0,0
"New Zealand","2024-11-12",0,0,24,0,0,25,0,0
"New Zealand","2024-11-13",0,0,24,0,0,25,0,0
"New Zealand","2024-11-14",0,0,24,0,0,25,0,0
"New Zealand","2024-11-15",0,0,24,0,0,25,0,0
"New Zealand","2024-11-16",0,0,24,0,0,25,0,0
"New Zealand","2024-11-17",0,0,24,0,0,25,0,0
"New Zealand","2024-11-18",0,0,24,0,0,25,0,0
"New Zealand","2024-11-19",0,0,24,0,0,25,0,0
"New Zealand","2024-11-20",0,0,24,0,1,26,0,0
"New Zealand","2024-11-21",0,0,24,0,0,26,0,0
"New Zealand","2024-11-22",0,0,24,0,0,26,0,0
"New Zealand","2024-11-23",0,0,24,0,0,26,0,0
"New Zealand","2024-11-24",0,0,24,0,0,26,0,0
"New Zealand","2024-11-25",0,0,24,0,0,26,0,0
"New Zealand","2024-11-26",0,0,24,0,0,26,0,0
"New Zealand","2024-11-27",0,0,24,0,0,26,0,0
"New Zealand","2024-11-28",0,0,24,0,0,26,0,0
"New Zealand","2024-11-29",0,0,24,0,0,26,0,0
"New Zealand","2024-11-30",0,0,24,0,1,27,0,0
"New Zealand","2024-12-01",0,0,24,0,0,27,0,0
"New Zealand","2024-12-02",0,0,24,0,0,27,0,0
"New Zealand","2024-12-03",0,0,24,0,0,27,0,0
"New Zealand","2024-12-04",0,0,24,0,0,27,0,0
"New Zealand","2024-12-05",0,3,27,0,0,27,0,0
"New Zealand","2024-12-06",0,0,27,0,0,27,0,0
"New Zealand","2024-12-07",0,0,27,0,0,27,0,0
"New Zealand","2024-12-08",0,0,27,0,0,27,0,0
"New Zealand","2024-12-09",0,0,27,0,0,27,0,0
"New Zealand","2024-12-10",0,0,27,0,0,27,0,0
"New Zealand","2024-12-11",0,0,27,0,0,27,0,0
"New Zealand","2024-12-12",0,0,27,0,0,27,0,0
"New Zealand","2024-12-13",0,0,27,0,0,27,0,0
"New Zealand","2024-12-14",0,0,27,0,0,27,0,0
"New Zealand","2024-12-15",0,0,27,0,0,27,0,0
"New Zealand","2024-12-16",0,0,27,0,0,27,0,0
"New Zealand","2024-12-17",0,0,27,0,0,27,0,0
"New Zealand","2024-12-18",0,0,27,0,0,27,0,0
"New Zealand","2024-12-19",0,0,27,0,0,27,0,0
"New Zealand","2024-12-20",0,0,27,0,0,27,0,0
"New Zealand","2024-12-21",0,0,27,0,0,27,0,0
"New Zealand","2024-12-22",0,0,27,0,0,27,0,0
"New Zealand","2024-12-23",0,0,27,0,0,27,0,0
"New Zealand","2024-12-24",0,0,27,0,0,27,0,0
"New Zealand","2024-12-25",0,0,27,0,0,27,0,0
"New Zealand","2024-12-26",0,0,27,0,0,27,0,0
"New Zealand","2024-12-27",0,0,27,0,0,27,0,0
"New Zealand","2024-12-28",0,0,27,0,0,27,0,0
"New Zealand","2024-12-29",0,0,27,0,0,27,0,0
"New Zealand","2024-12-30",0,0,27,0,0,27,0,0
"New Zealand","2024-12-31",0,0,27,0,0,27,0,0
"New Zealand","2025-01-01",0,0,27,0,0,27,0,0
"New Zealand","2025-01-02",0,0,27,0,0,27,0,0
"New Zealand","2025-01-03",0,0,27,0,0,27,0,0
"New Zealand","2025-01-04",0,0,27,0,0,27,0,0
"New Zealand","2025-01-05",0,0,27,0,0,27,0,0
"New Zealand","2025-01-06",0,0,27,0,0,27,0,0
"New Zealand","2025-01-07",0,0,27,0,0,27,0,0
"New Zealand","2025-01-08",0,0,27,0,0,27,0,0
"New Zealand","2025-01-09",0,0,27,0,0,27,0,0
"New Zealand","2025-01-10",0,0,27,0,0,27,0,0
"New Zealand","2025-01-11",0,0,27,0,0,27,0,0
"New Zealand","2025-01-12",0,0,27,0,0,27,0,0
"New Zealand","2025-01-13",0,0,27,0,0,27,0,0
"New Zealand","2025-01-14",0,0,27,0,0,27,0,0
"New Zealand","2025-01-15",0,0,27,0,0,27,0,0
"New Zealand","2025-01-16",0,0,27,0,0,27,0,0
"New Zealand","2025-01-17",0,0,27,0,0,27,0,0
"New Zealand","2025-01-18",0,0,27,0,0,27,0,0
"New Zealand","2025-01-19",0,0,27,0,0,27,0,0
"New Zealand","2025-01-20",0,0,27,0,0,27,0,0
"New Zealand","2025-01-21",0,0,27,0,0,27,0,0
"New Zealand","2025-01-22",0,0,27,0,0,27,0,0
"New Zealand","2025-01-23",0,0,27,0,0,27,0,0
"New Zealand","2025-01-24",0,0,27,0,0,27,0,0
"New Zealand","2025-01-25",0,0,27,0,0,27,0,0
"New Zealand","2025-01-26",0,0,27,0,0,27,0,0
"New Zealand","2025-01-27",0,0,27,0,0,27,0,0
"New Zealand","2025-01-28",0,0,27,0,0,27,0,0
"New Zealand","2025-01-29",0,0,27,0,0,27,0,0
"New Zealand","2025-01-30",0,0,27,0,0,27,0,0
"New Zealand","2025-01-31",0,0,27,0,0,27,0,0
"New Zealand","2025-02-01",0,0,27,0,0,27,0,0
"New Zealand","2025-02-02",0,0,27,0,0,27,0,0
"New Zealand","2025-02-03",0,0,27,0,0,27,0,0
"Nigeria","2024-01-01",0,0,0,0,0,0,0,0
"Nigeria","2024-01-02",0,0,0,0,0,0,0,0
"Nigeria","2024-01-03",0,0,0,0,0,0,0,0
"Nigeria","2024-01-04",0,0,0,0,0,0,0,0
"Nigeria","2024-01-05",0,0,0,0,0,0,0,0
"Nigeria","2024-01-06",0,0,0,0,0,0,0,0
"Nigeria","2024-01-07",0,0,0,0,0,0,0,0
"Nigeria","2024-01-08",0,0,0,0,0,0,0,0
"Nigeria","2024-01-09",0,0,0,0,0,0,0,0
"Nigeria","2024-01-10",0,0,0,0,0,0,0,0
"Nigeria","2024-01-11",0,0,0,0,0,0,0,0
"Nigeria","2024-01-12",0,0,0,0,0,0,0,0
"Nigeria","2024-01-13",0,0,0,0,0,0,0,0
"Nigeria","2024-01-14",0,0,0,0,0,0,0,0
"Nigeria","2024-01-15",0,0,0,0,0,0,0,0
"Nigeria","2024-01-16",0,0,0,0,0,0,0,0
"Nigeria","2024-01-17",0,0,0,0,0,0,0,0
"Nigeria","2024-01-18",0,0,0,0,0,0,0,0
"Nigeria","2024-01-19",0,0,0,0,0,0,0,0
"Nigeria","2024-01-20",0,0,0,0,0,0,0,0
"Nigeria","2024-01-21",0,0,0,0,0,0,0,0
"Nigeria","2024-01-22",0,0,0,0,0,0,0,0
"Nigeria","2024-01-23",0,0,0,0,0,0,0,0
"Nigeria","2024-01-24",0,0,0,0,0,0,0,0
"Nigeria","2024-01-25",0,0,0,0,0,0,0,0
"Nigeria","2024-01-26",0,0,0,0,0,0,0,0
"Nigeria","2024-01-27",0,0,0,0,0,0,0,0
"Nigeria","2024-01-28",0,2,2,0,2,2,0,0
"Nigeria","2024-01-29",0,0,2,0,0,2,0,0
"Nigeria","2024-01-30",0,0,2,0,0,2,0,0
"Nigeria","2024-01-31",0,0,2,0,0,2,0,0
"Nigeria","2024-02-01",0,0,2,0,1,3,0,0
"Nigeria","2024-02-02",0,0,2,0,0,3,0,0
"Nigeria","2024-02-03",0,0,2,0,0,3,0,0
"Nigeria","2024-02-04",0,0,2,0,0,3,0,0
"Nigeria","2024-02-05",0,0,2,0,0,3,0,0
"Nigeria","2024-02-06",0,0,2,0,0,3,0,0
"Nigeria","2024-02-07",0,0,2,0,0,3,0,0
"Nigeria","2024-02-08",0,0,2,0,1,4,0,0
"Nigeria","2024-02-09",0,0,2,0,0,4,0,0
"Nigeria","2024-02-10",0,0,2,0,0,4,0,0
"Nigeria","2024-02-11",0,2,4,0,0,4,0,0
"Nigeria","2024-02-12",0,0,4,0,0,4,0,0
"Nigeria","2024-02-13",0,0,4,0,1,5,0,0
"Nigeria","2024-02-14",0,0,4,0,0,5,0,0
"Nigeria","2024-02-15",0,0,4,0,0,5,0,0
"Nigeria","2024-02-16",0,0,4,0,0,5,0,0
"Nigeria","2024-02-17",0,0,4,0,1,6,0,0
"Nigeria","2024-02-18",0,2,6,0,0,6,0,0
"Nigeria","2024-02-19",0,0,6,0,0,6,0,0
"Nigeria","2024-02-20",0,0,6,0,0,6,0,0
"Nigeria","2024-02-21",0,0,6,0,1,7,0,0
"Nigeria","2024-02-22",0,0,6,0,0,7,0,0
"Nigeria","2024-02-23",0,0,6,0,0,7,0,0
"Nigeria","2024-02-24",0,0,6,0,0,7,0,0
"Nigeria","2024-02-25",0,0,6,0,0,7,0,0
"Nigeria","2024-02-26",0,0,6,0,1,8,0,0
"Nigeria","2024-02-27",0,0,6,0,0,8,0,0
"Nigeria","2024-02-28",0,0,6,0,0,8,0,0
"Nigeria","2024-02-29",0,0,6,0,0,8,0,0
"Nigeria","2024-03-01",0,0,6,0,0,8,0,0
"Nigeria","2024-03-02",0,0,6,0,0,8,0,0
"Nigeria","2024-03-03",0,0,6,0,1,9,0,0
"Nigeria","2024-03-04",0,0,6,0,0,9,0,0
"Nigeria","2024-03-05",0,0,6,0,0,9,0,0
"Nigeria","2024-03-06",0,0,6,0,0,9,0,0
"Nigeria","2024-03-07",0,0,6,0,0,9,0,0
"Nigeria","2024-03-08",0,0,6,0,1,10,0,0
"Nigeria","2024-03-09",0,0,6,0,0,10,0,0
"Nigeria","2024-03-10",0,4,10,0,0,10,0,0
"Nigeria","2024-03-11",0,0,10,0,0,10,0,0
"Nigeria","2024-03-12",0,0,10,0,1,11,0,0
"Nigeria","2024-03-13",0,0,10,0,0,11,0,0
"Nigeria","2024-03-14",0,0,10,0,0,11,0,0
"Nigeria","2024-03-15",0,0,10,0,0,11,0,0
"Nigeria","2024-03-16",0,0,10,0,1,12,0,0
"Nigeria","2024-03-17",0,2,12,0,0,12,0,0
"Nigeria","2024-03-18",0,0,12,0,0,12,0,0
"Nigeria","2024-03-19",0,0,12,0,1,13,0,0
"Nigeria","2024-03-20",0,0,12,0,0,13,0,0
"Nigeria","2024-03-21",0,0,12,0,1,14,0,0
"Nigeria","2024-03-22",0,0,12,0,0,14,0,0
"Nigeria","2024-03-23",0,0,12,0,1,15,0,0
"Nigeria","2024-03-24",0,0,12,0,0,15,0,0
"Nigeria","2024-03-25",0,0,12,0,0,15,0,0
"Nigeria","2024-03-26",0,0,12,0,1,16,0,0
"Nigeria","2024-03-27",0,0,12,0,0,16,0,0
"Nigeria","2024-03-28",0,0,12,0,1,17,0,0
"Nigeria","2024-03-29",0,0,12,0,0,17,0,0
"Nigeria","2024-03-30",0,0,12,0,1,18,0,0
"Nigeria","2024-03-31",0,6,18,0,0,18,0,0
"Nigeria","2024-04-01",0,0,18,0,0,18,0,0
"Nigeria","2024-04-02",0,0,18,0,0,18,0,0
"Nigeria","2024-04-03",0,0,18,0,0,18,0,0
"Nigeria","2024-04-04",0,0,18,0,1,19,0,0
"Nigeria","2024-04-05",0,0,18,0,0,19,0,0
"Nigeria","2024-04-06",0,0,18,0,0,19,0,0
"Nigeria","2024-04-07",0,1,19,0,0,19,0,0
"Nigeria","2024-04-08",0,0,19,0,0,19,0,0
"Nigeria","2024-04-09",0,0,19,0,0,19,0,0
"Nigeria","2024-04-10",0,0,19,0,0,19,0,0
"Nigeria","2024-04-11",0,0,19,0,1,20,0,0
"Nigeria","2024-04-12",0,0,19,0,0,20,0,0
"Nigeria","2024-04-13",0,0,19,0,0,20,0,0
"Nigeria","2024-04-14",0,1,20,0,0,20,0,0
"Nigeria","2024-04-15",0,0,20,0,0,20,0,0
"Nigeria","2024-04-16",0,0,20,0,0,20,0,0
"Nigeria","2024-04-17",0,0,20,0,0,20,0,0
"Nigeria","2024-04-18",0,0,20,0,1,21,0,0
"Nigeria","2024-04-19",0,0,20,0,0,21,0,0
"Nigeria","2024-04-20",0,0,20,0,0,21,0,0
"Nigeria","2024-04-21",0,0,20,0,0,21,0,0
"Nigeria","2024-04-22",0,0,20,0,0,21,0,0
"Nigeria","2024-04-23",0,0,20,0,0,21,0,0
"Nigeria","2024-04-24",0,0,20,0,0,21,0,0
"Nigeria","2024-04-25",0,0,20,0,1,22,0,0
"Nigeria","2024-04-26",0,0,20,0,0,22,0,0
"Nigeria","2024-04-27",0,0,20,0,0,22,0,0
"Nigeria","2024-04-28",0,2,22,0,0,22,0,0
"Nigeria","2024-04-29",0,0,22,0,0,22,0,0
"Nigeria","2024-04-30",0,0,22,0,1,23,0,0
"Nigeria","2024-05-01",0,0,22,0,0,23,0,0
"Nigeria","2024-05-02",0,0,22,0,0,23,0,0
"Nigeria","2024-05-03",0,0,22,0,0,23,0,0
"Nigeria","2024-05-04",0,0,22,0,1,24,0,0
"Nigeria","2024-05-05",0,2,24,0,0,24,0,0
"Nigeria","2024-05-06",0,0,24,0,0,24,0,0
"Nigeria","2024-05-07",0,0,24,0,0,24,0,0
"Nigeria","2024-05-08",0,0,24,0,0,24,0,0
"Nigeria","2024-05-09",0,0,24,0,0,24,0,0
"Nigeria","2024-05-10",0,0,24,0,0,24,0,0
"Nigeria","2024-05-11",0,0,24,0,1,25,0,0
"Nigeria","2024-05-12",0,0,24,0,0,25,0,0
"Nigeria","2024-05-13",0,0,24,0,0,25,0,0
"Nigeria","2024-05-14",0,0,24,0,0,25,0,0
"Nigeria","2024-05-15",0,0,24,0,0,25,0,0
"Nigeria","2024-05-16",0,0,24,0,0,25,0,0
"Nigeria","2024-05-17",0,0,24,0,0,25,0,0
"Nigeria","2024-05-18",0,0,24,0,0,25,0,0
"Nigeria","2024-05-19",0,0,24,0,0,25,0,0
"Nigeria","2024-05-20",0,0,24,0,0,25,0,0
"Nigeria","2024-05-21",0,0,24,0,1,26,0,0
"Nigeria","2024-05-22",0,0,24,0,0,26,0,0
"Nigeria","2024-05-23",0,0,24,0,0,26,0,0
"Nigeria","2024-05-24",0,0,24,0,0,26,0,0
"Nigeria","2024-05-25",0,0,24,0,0,26,0,0
"Nigeria","2024-05-26",0,2,26,0,0,26,0,0
"Nigeria","2024-05-27",0,0,26,0,0,26,0,0
"Nigeria","2024-05-28",0,0,26,0,0,26,0,0
"Nigeria","2024-05-29",0,0,26,0,0,26,0,0
"Nigeria","2024-05-30",0,0,26,0,1,27,0,0
"Nigeria","2024-05-31",0,0,26,0,0,27,0,0
"Nigeria","2024-06-01",0,0,26,0,0,27,0,0
"Nigeria","2024-06-02",0,1,27,0,0,27,0,0
"Nigeria","2024-06-03",0,0,27,0,0,27,0,0
"Nigeria","2024-06-04",0,0,27,0,0,27,0,0
"Nigeria","2024-06-05",0,0,27,0,0,27,0,0
"Nigeria","2024-06-06",0,0,27,0,1,28,0,0
"Nigeria","2024-06-07",0,0,27,0,0,28,0,0
"Nigeria","2024-06-08",0,0,27,0,0,28,0,0
"Nigeria","2024-06-09",0,1,28,0,0,28,0,0
"Nigeria","2024-06-10",0,0,28,0,0,28,0,0
"Nigeria","2024-06-11",0,0,28,0,1,29,0,0
"Nigeria","2024-06-12",0,0,28,0,0,29,0,0
"Nigeria","2024-06-13",0,0,28,0,0,29,0,0
"Nigeria","2024-06-14",0,0,28,0,0,29,0,0
"Nigeria","2024-06-15",0,0,28,0,1,30,0,0
"Nigeria","2024-06-16",0,2,30,0,0,30,0,0
"Nigeria","2024-06-17",0,0,30,0,0,30,0,0
"Nigeria","2024-06-18",0,0,30,0,0,30,0,0
"Nigeria","2024-06-19",0,0,30,0,0,30,0,0
"Nigeria","2024-06-20",0,0,30,0,1,31,0,0
"Nigeria","2024-06-21",0,0,30,0,0,31,0,0
"Nigeria","2024-06-22",0,0,30,0,0,31,0,0
"Nigeria","2024-06-23",0,1,31,0,0,31,0,0
"Nigeria","2024-06-24",0,0,31,0,0,31,0,0
"Nigeria","2024-06-25",0,0,31,0,1,32,0,0
"Nigeria","2024-06-26",0,0,31,0,0,32,0,0
"Nigeria","2024-06-27",0,0,31,0,1,33,0,0
"Nigeria","2024-06-28",0,0,31,0,0,33,0,0
"Nigeria","2024-06-29",0,0,31,0,1,34,0,0
"Nigeria","2024-06-30",0,3,34,0,0,34,0,0
"Nigeria","2024-07-01",0,0,34,0,0,34,0,0
"Nigeria","2024-07-02",0,0,34,0,1,35,0,0
"Nigeria","2024-07-03",0,0,34,0,0,35,0,0
"Nigeria","2024-07-04",0,0,34,0,1,36,0,0
"Nigeria","2024-07-05",0,0,34,0,0,36,0,0
"Nigeria","2024-07-06",0,0,34,0,1,37,0,0
"Nigeria","2024-07-07",0,3,37,0,0,37,0,0
"Nigeria","2024-07-08",0,0,37,0,0,37,0,0
"Nigeria","2024-07-09",0,0,37,0,0,37,0,0
"Nigeria","2024-07-10",0,0,37,0,0,37,0,0
"Nigeria","2024-07-11",0,0,37,0,0,37,0,0
"Nigeria","2024-07-12",0,0,37,0,0,37,0,0
"Nigeria","2024-07-13",0,0,37,0,0,37,0,0
"Nigeria","2024-07-14",0,0,37,0,0,37,0,0
"Nigeria","2024-07-15",0,0,37,0,1,38,0,0
"Nigeria","2024-07-16",0,0,37,0,0,38,0,0
"Nigeria","2024-07-17",0,0,37,0,0,38,0,0
"Nigeria","2024-07-18",0,0,37,0,0,38,0,0
"Nigeria","2024-07-19",0,0,37,0,0,38,0,0
"Nigeria","2024-07-20",0,0,37,0,0,38,0,0
"Nigeria","2024-07-21",0,1,38,0,0,38,0,0
"Nigeria","2024-07-22",0,0,38,0,0,38,0,0
"Nigeria","2024-07-23",0,0,38,0,0,38,0,0
"Nigeria","2024-07-24",0,0,38,0,0,38,0,0
"Nigeria","2024-07-25",0,0,38,0,0,38,0,0
"Nigeria","2024-07-26",0,0,38,0,0,38,0,0
"Nigeria","2024-07-27",0,0,38,0,1,39,0,0
"Nigeria","2024-07-28",0,0,38,0,0,39,0,0
"Nigeria","2024-07-29",0,0,38,0,0,39,0,0
"Nigeria","2024-07-30",0,0,38,0,0,39,0,0
"Nigeria","2024-07-31",0,0,38,0,0,39,0,0
"Nigeria","2024-08-01",0,0,38,0,0,39,0,0
"Nigeria","2024-08-02",0,0,38,0,0,39,0,0
"Nigeria","2024-08-03",0,0,38,0,0,39,0,0
"Nigeria","2024-08-04",0,0,38,0,0,39,0,0
"Nigeria","2024-08-05",0,0,38,0,0,39,0,0
"Nigeria","2024-08-06",0,0,38,0,1,40,0,0
"Nigeria","2024-08-07",0,0,38,0,0,40,0,0
"Nigeria","2024-08-08",0,0,38,0,0,40,0,0
"Nigeria","2024-08-09",0,0,38,0,0,40,0,0
"Nigeria","2024-08-10",0,0,38,0,0,40,0,0
"Nigeria","2024-08-11",0,2,40,0,0,40,0,0
"Nigeria","2024-08-12",0,0,40,0,0,40,0,0
"Nigeria","2024-08-13",0,0,40,0,1,41,0,0
"Nigeria","2024-08-14",0,0,40,0,0,41,0,0
"Nigeria","2024-08-15",0,0,40,0,1,42,0,0
"Nigeria","2024-08-16",0,0,40,0,0,42,0,0
"Nigeria","2024-08-17",0,0,40,0,1,43,0,0
"Nigeria","2024-08-18",802,3,43,802,0,43,802,802
"Nigeria","2024-08-19",0,0,43,802,1,44,9,811
"Nigeria","2024-08-20",0,0,43,802,2,46,10,821
"Nigeria","2024-08-21",0,0,43,802,1,47,9,830
"Nigeria","2024-08-22",0,0,43,802,2,49,9,839
"Nigeria","2024-08-23",0,0,43,802,1,50,9,848
"Nigeria","2024-08-24",0,0,43,802,2,52,10,858
"Nigeria","2024-08-25",65,10,53,867,1,53,9,867
"Nigeria","2024-08-26",0,0,53,867,1,54,8,875
"Nigeria","2024-08-27",0,0,53,867,1,55,7,882
"Nigeria","2024-08-28",0,0,53,867,1,56,8,890
"Nigeria","2024-08-29",0,0,53,867,2,58,7,897
"Nigeria","2024-08-30",0,0,53,867,1,59,8,905
"Nigeria","2024-08-31",0,0,53,867,1,60,7,912
"Nigeria","2024-09-01",53,8,61,920,1,61,8,920
"Nigeria","2024-09-02",0,0,61,920,1,62,10,930
"Nigeria","2024-09-03",0,0,61,920,2,64,11,941
"Nigeria","2024-09-04",0,0,61,920,1,65,10,951
"Nigeria","2024-09-05",0,0,61,920,1,66,10,961
"Nigeria","2024-09-06",0,0,61,920,1,67,10,971
"Nigeria","2024-09-07",0,0,61,920,2,69,11,982
"Nigeria","2024-09-08",72,9,70,992,1,70,10,992
"Nigeria","2024-09-09",0,0,70,992,1,71,9,1001
"Nigeria","2024-09-10",0,0,70,992,1,72,9,1010
"Nigeria","2024-09-11",0,0,70,992,1,73,9,1019
"Nigeria","2024-09-12",0,0,70,992,0,73,9,1028
"Nigeria","2024-09-13",0,0,70,992,1,74,9,1037
"Nigeria","2024-09-14",0,0,70,992,1,75,9,1046
"Nigeria","2024-09-15",63,6,76,1055,1,76,9,1055
"Nigeria","2024-09-16",0,0,76,1055,1,77,10,1065
"Nigeria","2024-09-17",0,0,76,1055,0,77,11,1076
"Nigeria","2024-09-18",0,0,76,1055,1,78,10,1086
"Nigeria","2024-09-19",0,0,76,1055,1,79,10,1096
"Nigeria","2024-09-20",0,0,76,1055,1,80,10,1106
"Nigeria","2024-09-21",0,0,76,1055,0,80,11,1117
"Nigeria","2024-09-22",72,5,81,1127,1,81,10,1127
"Nigeria","2024-09-23",0,0,81,1127,1,82,8,1135
"Nigeria","2024-09-24",0,0,81,1127,2,84,7,1142
"Nigeria","2024-09-25",0,0,81,1127,1,85,8,1150
"Nigeria","2024-09-26",0,0,81,1127,2,87,8,1158
"Nigeria","2024-09-27",0,0,81,1127,1,88,8,1166
"Nigeria","2024-09-28",0,0,81,1127,2,90,7,1173
"Nigeria","2024-09-29",54,10,91,1181,1,91,8,1181
"Nigeria","2024-09-30",0,0,91,1181,1,92,8,1189
"Nigeria","2024-10-01",0,0,91,1181,1,93,8,1197
"Nigeria","2024-10-02",0,0,91,1181,1,94,8,1205
"Nigeria","2024-10-03",0,0,91,1181,1,95,8,1213
"Nigeria","2024-10-04",0,0,91,1181,1,96,8,1221
"Nigeria","2024-10-05",0,0,91,1181,1,97,8,1229
"Nigeria","2024-10-06",56,7,98,1237,1,98,8,1237
"Nigeria","2024-10-07",0,0,98,1237,1,99,2,1239
"Nigeria","2024-10-08",0,0,98,1237,2,101,3,1242
"Nigeria","2024-10-09",0,0,98,1237,1,102,2,1244
"Nigeria","2024-10-10",0,0,98,1237,1,103,3,1247
"Nigeria","2024-10-11",0,0,98,1237,1,104,2,1249
"Nigeria","2024-10-12",0,0,98,1237,2,106,2,1251
"Nigeria","2024-10-13",0,9,107,1237,1,107,3,1254
"Nigeria","2024-10-14",0,0,107,1237,1,108,2,1256
"Nigeria","2024-10-15",0,0,107,1237,1,109,2,1258
"Nigeria","2024-10-16",0,0,107,1237,1,110,3,1261
"Nigeria","2024-10-17",0,0,107,1237,2,112,2,1263
"Nigeria","2024-10-18",0,0,107,1237,1,113,3,1266
"Nigeria","2024-10-19",0,0,107,1237,1,114,2,1268
"Nigeria","2024-10-20",0,8,115,1237,1,115,2,1270
"Nigeria","2024-10-21",0,0,115,1237,1,116,3,1273
"Nigeria","2024-10-22",0,0,115,1237,2,118,2,1275
"Nigeria","2024-10-23",0,0,115,1237,1,119,2,1277
"Nigeria","2024-10-24",0,0,115,1237,2,121,3,1280
"Nigeria","2024-10-25",0,0,115,1237,1,122,2,1282
"Nigeria","2024-10-26",0,0,115,1237,2,124,3,1285
"Nigeria","2024-10-27",50,10,125,1287,1,125,2,1287
"Nigeria","2024-10-28",0,0,125,1287,1,126,5,1292
"Nigeria","2024-10-29",0,0,125,1287,1,127,6,1298
"Nigeria","2024-10-30",0,0,125,1287,1,128,5,1303
"Nigeria","2024-10-31",0,0,125,1287,0,128,5,1308
"Nigeria","2024-11-01",0,0,125,1287,1,129,5,1313
"Nigeria","2024-11-02",0,0,125,1287,1,130,6,1319
"Nigeria","2024-11-03",37,6,131,1324,1,131,5,1324
"Nigeria","2024-11-04",0,0,131,1324,2,133,0,1324
"Nigeria","2024-11-05",0,0,131,1324,2,135,0,1324
"Nigeria","2024-11-06",0,0,131,1324,2,137,0,1324
"Nigeria","2024-11-07",0,0,131,1324,1,138,0,1324
"Nigeria","2024-11-08",0,0,131,1324,2,140,0,1324
"Nigeria","2024-11-09",0,0,131,1324,2,142,0,1324
"Nigeria","2024-11-10",0,13,144,1324,2,144,0,1324
"Nigeria","2024-11-11",0,0,144,1324,1,145,0,1324
"Nigeria","2024-11-12",0,0,144,1324,1,146,0,1324
"Nigeria","2024-11-13",0,0,144,1324,1,147,0,1324
"Nigeria","2024-11-14",0,0,144,1324,0,147,0,1324
"Nigeria","2024-11-15",0,0,144,1324,1,148,0,1324
"Nigeria","2024-11-16",0,0,144,1324,1,149,0,1324
"Nigeria","2024-11-17",0,6,150,1324,1,150,0,1324
"Nigeria","2024-11-18",0,0,150,1324,0,150,0,1324
"Nigeria","2024-11-19",0,0,150,1324,1,151,0,1324
"Nigeria","2024-11-20",0,0,150,1324,0,151,0,1324
"Nigeria","2024-11-21",0,0,150,1324,1,152,0,1324
"Nigeria","2024-11-22",0,0,150,1324,0,152,0,1324
"Nigeria","2024-11-23",0,0,150,1324,1,153,0,1324
"Nigeria","2024-11-24",0,3,153,1324,0,153,0,1324
"Nigeria","2024-11-25",0,0,153,1324,1,154,0,1324
"Nigeria","2024-11-26",0,0,153,1324,1,155,0,1324
"Nigeria","2024-11-27",0,0,153,1324,1,156,0,1324
"Nigeria","2024-11-28",0,0,153,1324,1,157,0,1324
"Nigeria","2024-11-29",0,0,153,1324,1,158,0,1324
"Nigeria","2024-11-30",0,0,153,1324,1,159,0,1324
"Nigeria","2024-12-01",0,7,160,1324,1,160,0,1324
"Nigeria","2024-12-02",0,0,160,1324,2,162,0,1324
"Nigeria","2024-12-03",0,0,160,1324,2,164,0,1324
"Nigeria","2024-12-04",0,0,160,1324,2,166,0,1324
"Nigeria","2024-12-05",0,0,160,1324,3,169,0,1324
"Nigeria","2024-12-06",0,0,160,1324,2,171,0,1324
"Nigeria","2024-12-07",0,0,160,1324,2,173,0,1324
"Nigeria","2024-12-08",0,15,175,1324,2,175,0,1324
"Nigeria","2024-12-09",0,0,175,1324,1,176,0,1324
"Nigeria","2024-12-10",0,0,175,1324,1,177,0,1324
"Nigeria","2024-12-11",0,0,175,1324,1,178,0,1324
"Nigeria","2024-12-12",0,0,175,1324,0,178,0,1324
"Nigeria","2024-12-13",0,0,175,1324,1,179,0,1324
"Nigeria","2024-12-14",0,0,175,1324,1,180,0,1324
"Nigeria","2024-12-15",0,6,181,1324,1,181,0,1324
"Nigeria","2024-12-16",0,0,181,1324,1,182,0,1324
"Nigeria","2024-12-17",0,0,181,1324,0,182,0,1324
"Nigeria","2024-12-18",0,0,181,1324,1,183,0,1324
"Nigeria","2024-12-19",0,0,181,1324,0,183,0,1324
"Nigeria","2024-12-20",0,0,181,1324,1,184,0,1324
"Nigeria","2024-12-21",0,0,181,1324,0,184,0,1324
"Nigeria","2024-12-22",0,4,185,1324,1,185,0,1324
"Nigeria","2024-12-23",0,0,185,1324,1,186,0,1324
"Nigeria","2024-12-24",0,0,185,1324,0,186,0,1324
"Nigeria","2024-12-25",0,0,185,1324,1,187,0,1324
"Nigeria","2024-12-26",0,0,185,1324,0,187,0,1324
"Nigeria","2024-12-27",0,0,185,1324,1,188,0,1324
"Nigeria","2024-12-28",0,0,185,1324,0,188,0,1324
"Nigeria","2024-12-29",0,4,189,1324,1,189,0,1324
"Nigeria","2024-12-30",0,0,189,1324,0,189,0,1324
"Nigeria","2024-12-31",0,0,189,1324,1,190,0,1324
"Nigeria","2025-01-01",0,0,189,1324,0,190,0,1324
"Nigeria","2025-01-02",0,0,189,1324,0,190,0,1324
"Nigeria","2025-01-03",0,0,189,1324,0,190,0,1324
"Nigeria","2025-01-04",0,0,189,1324,1,191,0,1324
"Nigeria","2025-01-05",0,2,191,1324,0,191,0,1324
"Nigeria","2025-01-06",0,0,191,1324,1,192,0,1324
"Nigeria","2025-01-07",0,0,191,1324,0,192,0,1324
"Nigeria","2025-01-08",0,0,191,1324,1,193,0,1324
"Nigeria","2025-01-09",0,0,191,1324,0,193,0,1324
"Nigeria","2025-01-10",0,0,191,1324,1,194,0,1324
"Nigeria","2025-01-11",0,0,191,1324,0,194,0,1324
"Nigeria","2025-01-12",0,4,195,1324,1,195,0,1324
"Nigeria","2025-01-13",0,0,195,1324,0,195,0,1324
"Nigeria","2025-01-14",0,0,195,1324,0,195,0,1324
"Nigeria","2025-01-15",0,0,195,1324,0,195,0,1324
"Nigeria","2025-01-16",0,0,195,1324,0,195,0,1324
"Nigeria","2025-01-17",0,0,195,1324,0,195,0,1324
"Nigeria","2025-01-18",0,0,195,1324,0,195,0,1324
"Nigeria","2025-01-19",0,0,195,1324,0,195,0,1324
"Nigeria","2025-01-20",0,0,195,1324,0,195,0,1324
"Nigeria","2025-01-21",0,0,195,1324,0,195,0,1324
"Nigeria","2025-01-22",0,0,195,1324,0,195,0,1324
"Nigeria","2025-01-23",0,0,195,1324,0,195,0,1324
"Nigeria","2025-01-24",0,0,195,1324,0,195,0,1324
"Nigeria","2025-01-25",0,0,195,1324,0,195,0,1324
"Nigeria","2025-01-26",0,0,195,1324,0,195,0,1324
"Nigeria","2025-01-27",0,0,195,1324,0,195,0,1324
"Nigeria","2025-01-28",0,0,195,1324,0,195,0,1324
"Nigeria","2025-01-29",0,0,195,1324,0,195,0,1324
"Nigeria","2025-01-30",0,0,195,1324,0,195,0,1324
"Nigeria","2025-01-31",0,0,195,1324,0,195,0,1324
"Nigeria","2025-02-01",0,0,195,1324,0,195,0,1324
"Nigeria","2025-02-02",0,0,195,1324,0,195,0,1324
"Nigeria","2025-02-03",0,0,195,1324,0,195,0,1324
"North America","2024-01-01",0,0,0,0,0,0,0,0
"North America","2024-01-02",0,51,51,0,51,51,0,0
"North America","2024-01-03",0,0,51,0,8,59,0,0
"North America","2024-01-04",0,0,51,0,8,67,0,0
"North America","2024-01-05",0,0,51,0,8,75,0,0
"North America","2024-01-06",0,0,51,0,8,83,0,0
"North America","2024-01-07",0,0,51,0,8,91,0,0
"North America","2024-01-08",0,0,51,0,8,99,0,0
"North America","2024-01-09",0,56,107,0,8,107,0,0
"North America","2024-01-10",0,0,107,0,11,118,0,0
"North America","2024-01-11",0,0,107,0,10,128,0,0
"North America","2024-01-12",0,0,107,0,11,139,0,0
"North America","2024-01-13",0,0,107,0,11,150,0,0
"North America","2024-01-14",0,0,107,0,11,161,0,0
"North America","2024-01-15",0,0,107,0,10,171,0,0
"North America","2024-01-16",0,75,182,0,11,182,0,0
"North America","2024-01-17",0,0,182,0,8,190,0,0
"North America","2024-01-18",0,0,182,0,8,198,0,0
"North America","2024-01-19",0,0,182,0,8,206,0,0
"North America","2024-01-20",0,0,182,0,7,213,0,0
"North America","2024-01-21",0,0,182,0,8,221,0,0
"North America","2024-01-22",0,0,182,0,8,229,0,0
"North America","2024-01-23",0,55,237,0,8,237,0,0
"North America","2024-01-24",0,0,237,0,13,250,0,0
"North America","2024-01-25",0,0,237,0,13,263,0,0
"North America","2024-01-26",0,0,237,0,13,276,0,0
"North America","2024-01-27",0,0,237,0,13,289,0,0
"North America","2024-01-28",0,0,237,0,13,302,0,0
"North America","2024-01-29",0,0,237,0,13,315,0,0
"North America","2024-01-30",0,91,328,0,13,328,0,0
"North America","2024-01-31",0,0,328,0,10,338,0,0
"North America","2024-02-01",0,0,328,0,9,347,0,0
"North America","2024-02-02",0,0,328,0,10,357,0,0
"North America","2024-02-03",0,0,328,0,10,367,0,0
"North America","2024-02-04",0,0,328,0,10,377,0,0
"North America","2024-02-05",0,0,328,0,9,386,0,0
"North America","2024-02-06",0,68,396,0,10,396,0,0
"North America","2024-02-07",0,0,396,0,10,406,0,0
"North America","2024-02-08",0,0,396,0,9,415,0,0
"North America","2024-02-09",0,0,396,0,10,425,0,0
"North America","2024-02-10",0,0,396,0,10,435,0,0
"North America","2024-02-11",0,0,396,0,10,445,0,0
"North America","2024-02-12",0,0,396,0,9,454,0,0
"North America","2024-02-13",0,68,464,0,10,464,0,0
"North America","2024-02-14",0,0,464,0,9,473,0,0
"North America","2024-02-15",0,0,464,0,9,482,0,0
"North America","2024-02-16",0,0,464,0,9,491,0,0
"North America","2024-02-17",0,0,464,0,8,499,0,0
"North America","2024-02-18",0,0,464,0,9,508,0,0
"North America","2024-02-19",0,0,464,0,9,517,0,0
"North America","2024-02-20",0,62,526,0,9,526,0,0
"North America","2024-02-21",0,0,526,0,12,538,0,0
"North America","2024-02-22",0,0,526,0,11,549,0,0
"North America","2024-02-23",0,0,526,0,12,561,0,0
"North America","2024-02-24",0,0,526,0,12,573,0,0
"North America","2024-02-25",0,0,526,0,12,585,0,0
"North America","2024-02-26",0,0,526,0,11,596,0,0
"North America","2024-02-27",0,82,608,0,12,608,0,0
"North America","2024-02-28",0,0,608,0,10,618,0,0
"North America","2024-02-29",0,0,608,0,10,628,0,0
"North America","2024-03-01",0,0,608,0,10,638,0,0
"North America","2024-03-02",0,0,608,0,10,648,0,0
"North America","2024-03-03",0,0,608,0,10,658,0,0
"North America","2024-03-04",0,0,608,0,10,668,0,0
"North America","2024-03-05",0,70,678,0,10,678,0,0
"North America","2024-03-06",0,0,678,0,12,690,0,0
"North America","2024-03-07",0,0,678,0,12,702,0,0
"North America","2024-03-08",0,0,678,0,12,714,0,0
"North America","2024-03-09",0,0,678,0,11,725,0,0
"North America","2024-03-10",0,0,678,0,12,737,0,0
"North America","2024-03-11",0,0,678,0,12,749,0,0
"North America","2024-03-12",0,83,761,0,12,761,0,0
"North America","2024-03-13",0,0,761,0,9,770,0,0
"North America","2024-03-14",0,0,761,0,8,778,0,0
"North America","2024-03-15",0,0,761,0,9,787,0,0
"North America","2024-03-16",0,0,761,0,8,795,0,0
"North America","2024-03-17",0,0,761,0,9,804,0,0
"North America","2024-03-18",0,0,761,0,8,812,0,0
"North America","2024-03-19",0,60,821,0,9,821,0,0
"North America","2024-03-20",0,0,821,0,9,830,0,0
"North America","2024-03-21",0,0,821,0,10,840,0,0
"North America","2024-03-22",0,0,821,0,9,849,0,0
"North America","2024-03-23",0,0,821,0,10,859,0,0
"North America","2024-03-24",0,0,821,0,9,868,0,0
"North America","2024-03-25",0,0,821,0,10,878,0,0
"North America","2024-03-26",0,66,887,0,9,887,0,0
"North America","2024-03-27",0,0,887,0,8,895,0,0
"North America","2024-03-28",0,0,887,0,7,902,0,0
"North America","2024-03-29",0,0,887,0,8,910,0,0
"North America","2024-03-30",0,0,887,0,7,917,0,0
"North America","2024-03-31",0,0,887,0,8,925,0,0
"North America","2024-04-01",0,0,887,0,7,932,0,0
"North America","2024-04-02",0,53,940,0,8,940,0,0
"North America","2024-04-03",0,0,940,0,10,950,0,0
"North America","2024-04-04",0,0,940,0,11,961,0,0
"North America","2024-04-05",0,0,940,0,10,971,0,0
"North America","2024-04-06",0,0,940,0,11,982,0,0
"North America","2024-04-07",0,0,940,0,10,992,0,0
"North America","2024-04-08",0,0,940,0,11,1003,0,0
"North America","2024-04-09",0,73,1013,0,10,1013,0,0
"North America","2024-04-10",0,0,1013,0,11,1024,0,0
"North America","2024-04-11",0,0,1013,0,12,1036,0,0
"North America","2024-04-12",0,0,1013,0,11,1047,0,0
"North America","2024-04-13",0,0,1013,0,12,1059,0,0
"North America","2024-04-14",0,0,1013,0,11,1070,0,0
"North America","2024-04-15",0,0,1013,0,12,1082,0,0
"North America","2024-04-16",0,80,1093,0,11,1093,0,0
"North America","2024-04-17",0,0,1093,0,12,1105,0,0
"North America","2024-04-18",0,0,1093,0,11,1116,0,0
"North America","2024-04-19",0,0,1093,0,12,1128,0,0
"North America","2024-04-20",0,0,1093,0,12,1140,0,0
"North America","2024-04-21",0,0,1093,0,12,1152,0,0
"North America","2024-04-22",0,0,1093,0,11,1163,0,0
"North America","2024-04-23",0,82,1175,0,12,1175,0,0
"North America","2024-04-24",0,0,1175,0,9,1184,0,0
"North America","2024-04-25",0,0,1175,0,8,1192,0,0
"North America","2024-04-26",0,0,1175,0,9,1201,0,0
"North America","2024-04-27",0,0,1175,0,8,1209,0,0
"North America","2024-04-28",0,0,1175,0,9,1218,0,0
"North America","2024-04-29",0,0,1175,0,8,1226,0,0
"North America","2024-04-30",0,60,1235,0,9,1235,0,0
"North America","2024-05-01",0,0,1235,0,9,1244,0,0
"North America","2024-05-02",0,0,1235,0,9,1253,0,0
"North America","2024-05-03",0,0,1235,0,9,1262,0,0
"North America","2024-05-04",0,0,1235,0,10,1272,0,0
"North America","2024-05-05",0,0,1235,0,9,1281,0,0
"North America","2024-05-06",0,0,1235,0,9,1290,0,0
"North America","2024-05-07",0,64,1299,0,9,1299,0,0
"North America","2024-05-08",0,0,1299,0,8,1307,0,0
"North America","2024-05-09",0,0,1299,0,8,1315,0,0
"North America","2024-05-10",0,0,1299,0,8,1323,0,0
"North America","2024-05-11",0,0,1299,0,7,1330,0,0
"North America","2024-05-12",0,0,1299,0,8,1338,0,0
"North America","2024-05-13",0,0,1299,0,8,1346,0,0
"North America","2024-05-14",0,55,1354,0,8,1354,0,0
"North America","2024-05-15",0,0,1354,0,10,1364,0,0
"North America","2024-05-16",0,0,1354,0,9,1373,0,0
"North America","2024-05-17",0,0,1354,0,10,1383,0,0
"North America","2024-05-18",0,0,1354,0,10,1393,0,0
"North America","2024-05-19",0,0,1354,0,10,1403,0,0
"North America","2024-05-20",0,0,1354,0,9,1412,0,0
"North America","2024-05-21",0,68,1422,0,10,1422,0,0
"North America","2024-05-22",0,0,1422,0,10,1432,0,0
"North America","2024-05-23",0,0,1422,0,9,1441,0,0
"North America","2024-05-24",0,0,1422,0,10,1451,0,0
"North America","2024-05-25",0,0,1422,0,9,1460,0,0
"North America","2024-05-26",0,0,1422,0,10,1470,0,0
"North America","2024-05-27",0,0,1422,0,9,1479,0,0
"North America","2024-05-28",0,67,1489,0,10,1489,0,0
"North America","2024-05-29",0,0,1489,0,11,1500,0,0
"North America","2024-05-30",0,0,1489,0,10,1510,0,0
"North America","2024-05-31",0,0,1489,0,11,1521,0,0
"North America","2024-06-01",0,0,1489,0,11,1532,0,0
"North America","2024-06-02",0,0,1489,0,11,1543,0,0
"North America","2024-06-03",0,0,1489,0,10,1553,0,0
"North America","2024-06-04",0,75,1564,0,11,1564,0,0
"North America","2024-06-05",0,0,1564,0,11,1575,0,0
"North America","2024-06-06",0,0,1564,0,11,1586,0,0
"North America","2024-06-07",0,0,1564,0,11,1597,0,0
"North America","2024-06-08",0,0,1564,0,11,1608,0,0
"North America","2024-06-09",0,0,1564,0,11,1619,0,0
"North America","2024-06-10",0,0,1564,0,11,1630,0,0
"North America","2024-06-11",0,77,1641,0,11,1641,0,0
"North America","2024-06-12",0,0,1641,0,9,1650,0,0
"North America","2024-06-13",0,0,1641,0,9,1659,0,0
"North America","2024-06-14",0,0,1641,0,9,1668,0,0
"North America","2024-06-15",0,0,1641,0,9,1677,0,0
"North America","2024-06-16",0,0,1641,0,9,1686,0,0
"North America","2024-06-17",0,0,1641,0,9,1695,0,0
"North America","2024-06-18",0,63,1704,0,9,1704,0,0
"North America","2024-06-19",0,0,1704,0,9,1713,0,0
"North America","2024-06-20",0,0,1704,0,9,1722,0,0
"North America","2024-06-21",0,0,1704,0,9,1731,0,0
"North America","2024-06-22",0,0,1704,0,8,1739,0,0
"North America","2024-06-23",0,0,1704,0,9,1748,0,0
"North America","2024-06-24",0,0,1704,0,9,1757,0,0
"North America","2024-06-25",0,62,1766,0,9,1766,0,0
"North America","2024-06-26",0,0,1766,0,9,1775,0,0
"North America","2024-06-27",0,0,1766,0,10,1785,0,0
"North America","2024-06-28",0,0,1766,0,9,1794,0,0
"North America","2024-06-29",0,0,1766,0,9,1803,0,0
"North America","2024-06-30",0,0,1766,0,9,1812,0,0
"North America","2024-07-01",0,0,1766,0,10,1822,0,0
"North America","2024-07-02",0,65,1831,0,9,1831,0,0
"North America","2024-07-03",0,0,1831,0,11,1842,0,0
"North America","2024-07-04",0,0,1831,0,10,1852,0,0
"North America","2024-07-05",0,0,1831,0,11,1863,0,0
"North America","2024-07-06",0,0,1831,0,10,1873,0,0
"North America","2024-07-07",0,0,1831,0,11,1884,0,0
"North America","2024-07-08",0,0,1831,0,10,1894,0,0
"North America","2024-07-09",0,74,1905,0,11,1905,0,0
"North America","2024-07-10",0,0,1905,0,12,1917,0,0
"North America","2024-07-11",0,0,1905,0,12,1929,0,0
"North America","2024-07-12",0,0,1905,0,12,1941,0,0
"North America","2024-07-13",0,0,1905,0,12,1953,0,0
"North America","2024-07-14",0,0,1905,0,12,1965,0,0
"North America","2024-07-15",0,0,1905,0,12,1977,0,0
"North America","2024-07-16",0,84,1989,0,12,1989,0,0
"North America","2024-07-17",0,0,1989,0,8,1997,0,0
"North America","2024-07-18",0,0,1989,0,8,2005,0,0
"North America","2024-07-19",0,0,1989,0,8,2013,0,0
"North America","2024-07-20",0,0,1989,0,9,2022,0,0
"North America","2024-07-21",0,0,1989,0,8,2030,0,0
"North America","2024-07-22",0,0,1989,0,8,2038,0,0
"North America","2024-07-23",0,57,2046,0,8,2046,0,0
"North America","2024-07-24",0,0,2046,0,11,2057,0,0
"North America","2024-07-25",0,0,2046,0,12,2069,0,0
"North America","2024-07-26",0,0,2046,0,11,2080,0,0
"North America","2024-07-27",0,0,2046,0,12,2092,0,0
"North America","2024-07-28",0,0,2046,0,11,2103,0,0
"North America","2024-07-29",0,0,2046,0,12,2115,0,0
"North America","2024-07-30",0,80,2126,0,11,2126,0,0
"North America","2024-07-31",0,0,2126,0,11,2137,0,0
"North America","2024-08-01",0,0,2126,0,11,2148,0,0
"North America","2024-08-02",0,0,2126,0,11,2159,0,0
"North America","2024-08-03",0,0,2126,0,11,2170,0,0
"North America","2024-08-04",0,0,2126,0,11,2181,0,0
"North America","2024-08-05",0,0,2126,0,11,2192,0,0
"North America","2024-08-06",0,77,2203,0,11,2203,0,0
"North America","2024-08-07",0,0,2203,0,11,2214,0,0
"North America","2024-08-08",0,0,2203,0,11,2225,0,0
"North America","2024-08-09",0,0,2203,0,11,2236,0,0
"North America","2024-08-10",0,0,2203,0,11,2247,0,0
"North America","2024-08-11",0,0,2203,0,11,2258,0,0
"North America","2024-08-12",0,0,2203,0,11,2269,0,0
"North America","2024-08-13",0,77,2280,0,11,2280,0,0
"North America","2024-08-14",0,0,2280,0,12,2292,0,0
"North America","2024-08-15",0,0,2280,0,13,2305,0,0
"North America","2024-08-16",0,0,2280,0,12,2317,0,0
"North America","2024-08-17",0,0,2280,0,13,2330,0,0
"North America","2024-08-18",0,0,2280,0,12,2342,0,0
"North America","2024-08-19",0,0,2280,0,13,2355,0,0
"North America","2024-08-20",0,87,2367,0,12,2367,0,0
"North America","2024-08-21",0,0,2367,0,12,2379,0,0
"North America","2024-08-22",0,0,2367,0,12,2391,0,0
"North America","2024-08-23",0,0,2367,0,12,2403,0,0
"North America","2024-08-24",0,0,2367,0,13,2416,0,0
"North America","2024-08-25",0,0,2367,0,12,2428,0,0
"North America","2024-08-26",0,0,2367,0,12,2440,0,0
"North America","2024-08-27",0,85,2452,0,12,2452,0,0
"North America","2024-08-28",0,0,2452,0,13,2465,0,0
"North America","2024-08-29",0,0,2452,0,12,2477,0,0
"North America","2024-08-30",0,0,2452,0,13,2490,0,0
"North America","2024-08-31",0,0,2452,0,12,2502,0,0
"North America","2024-09-01",0,0,2452,0,13,2515,0,0
"North America","2024-09-02",0,0,2452,0,12,2527,0,0
"North America","2024-09-03",0,88,2540,0,13,2540,0,0
"North America","2024-09-04",0,0,2540,0,13,2553,0,0
"North America","2024-09-05",0,0,2540,0,13,2566,0,0
"North America","2024-09-06",0,0,2540,0,13,2579,0,0
"North America","2024-09-07",0,0,2540,0,12,2591,0,0
"North America","2024-09-08",0,0,2540,0,13,2604,0,0
"North America","2024-09-09",0,0,2540,0,13,2617,0,0
"North America","2024-09-10",0,90,2630,0,13,2630,0,0
"North America","2024-09-11",0,0,2630,0,9,2639,0,0
"North America","2024-09-12",0,0,2630,0,10,2649,0,0
"North America","2024-09-13",0,0,2630,0,9,2658,0,0
"North America","2024-09-14",0,0,2630,0,9,2667,0,0
"North America","2024-09-15",0,0,2630,0,9,2676,0,0
"North America","2024-09-16",0,0,2630,0,10,2686,0,0
"North America","2024-09-17",0,65,2695,0,9,2695,0,0
"North America","2024-09-18",0,0,2695,0,11,2706,0,0
"North America","2024-09-19",0,0,2695,0,11,2717,0,0
"North America","2024-09-20",0,0,2695,0,11,2728,0,0
"North America","2024-09-21",0,0,2695,0,12,2740,0,0
"North America","2024-09-22",0,0,2695,0,11,2751,0,0
"North America","2024-09-23",0,0,2695,0,11,2762,0,0
"North America","2024-09-24",0,78,2773,0,11,2773,0,0
"North America","2024-09-25",0,0,2773,0,10,2783,0,0
"North America","2024-09-26",0,0,2773,0,9,2792,0,0
"North America","2024-09-27",0,0,2773,0,10,2802,0,0
"North America","2024-09-28",0,0,2773,0,9,2811,0,0
"North America","2024-09-29",0,0,2773,0,10,2821,0,0
"North America","2024-09-30",0,0,2773,0,9,2830,0,0
"North America","2024-10-01",0,67,2840,0,10,2840,0,0
"North America","2024-10-02",0,0,2840,0,7,2847,0,0
"North America","2024-10-03",0,0,2840,0,8,2855,0,0
"North America","2024-10-04",0,0,2840,0,7,2862,0,0
"North America","2024-10-05",0,0,2840,0,7,2869,0,0
"North America","2024-10-06",0,0,2840,0,7,2876,0,0
"North America","2024-10-07",0,0,2840,0,8,2884,0,0
"North America","2024-10-08",0,51,2891,0,7,2891,0,0
"North America","2024-10-09",0,0,2891,0,6,2897,0,0
"North America","2024-10-10",0,0,2891,0,5,2902,0,0
"North America","2024-10-11",0,0,2891,0,6,2908,0,0
"North America","2024-10-12",0,0,2891,0,5,2913,0,0
"North America","2024-10-13",0,0,2891,0,6,2919,0,0
"North America","2024-10-14",0,0,2891,0,5,2924,0,0
"North America","2024-10-15",0,39,2930,0,6,2930,0,0
"North America","2024-10-16",0,0,2930,0,8,2938,0,0
"North America","2024-10-17",0,0,2930,0,7,2945,0,0
"North America","2024-10-18",0,0,2930,0,8,2953,0,0
"North America","2024-10-19",0,0,2930,0,8,2961,0,0
"North America","2024-10-20",0,0,2930,0,8,2969,0,0
"North America","2024-10-21",0,0,2930,0,7,2976,0,0
"North America","2024-10-22",0,54,2984,0,8,2984,0,0
"North America","2024-10-23",0,0,2984,0,6,2990,0,0
"North America","2024-10-24",0,0,2984,0,6,2996,0,0
"North America","2024-10-25",0,0,2984,0,6,3002,0,0
"North America","2024-10-26",0,0,2984,0,7,3009,0,0
"North America","2024-10-27",0,0,2984,0,6,3015,0,0
"North America","2024-10-28",0,0,2984,0,6,3021,0,0
"North America","2024-10-29",0,43,3027,0,6,3027,0,0
"North America","2024-10-30",0,0,3027,0,6,3033,0,0
"North America","2024-10-31",0,0,3027,0,5,3038,0,0
"North America","2024-11-01",0,0,3027,0,6,3044,0,0
"North America","2024-11-02",0,0,3027,0,6,3050,0,0
"North America","2024-11-03",0,0,3027,0,6,3056,0,0
"North America","2024-11-04",0,0,3027,0,5,3061,0,0
"North America","2024-11-05",0,40,3067,0,6,3067,0,0
"North America","2024-11-06",0,0,3067,0,6,3073,0,0
"North America","2024-11-07",0,0,3067,0,6,3079,0,0
"North America","2024-11-08",0,0,3067,0,6,3085,0,0
"North America","2024-11-09",0,0,3067,0,5,3090,0,0
"North America","2024-11-10",0,0,3067,0,6,3096,0,0
"North America","2024-11-11",0,0,3067,0,6,3102,0,0
"North America","2024-11-12",0,41,3108,0,6,3108,0,0
"North America","2024-11-13",0,0,3108,0,5,3113,0,0
"North America","2024-11-14",0,0,3108,0,6,3119,0,0
"North America","2024-11-15",0,0,3108,0,5,3124,0,0
"North America","2024-11-16",0,0,3108,0,5,3129,0,0
"North America","2024-11-17",0,0,3108,0,5,3134,0,0
"North America","2024-11-18",0,0,3108,0,6,3140,0,0
"North America","2024-11-19",0,37,3145,0,5,3145,0,0
"North America","2024-11-20",0,0,3145,0,4,3149,0,0
"North America","2024-11-21",0,0,3145,0,3,3152,0,0
"North America","2024-11-22",0,0,3145,0,4,3156,0,0
"North America","2024-11-23",0,0,3145,0,3,3159,0,0
"North America","2024-11-24",0,0,3145,0,4,3163,0,0
"North America","2024-11-25",0,0,3145,0,3,3166,0,0
"North America","2024-11-26",0,25,3170,0,4,3170,0,0
"North America","2024-11-27",0,0,3170,0,2,3172,0,0
"North America","2024-11-28",0,0,3170,0,2,3174,0,0
"North America","2024-11-29",0,0,3170,0,2,3176,0,0
"North America","2024-11-30",0,0,3170,0,2,3178,0,0
"North America","2024-12-01",0,0,3170,0,2,3180,0,0
"North America","2024-12-02",0,0,3170,0,2,3182,0,0
"North America","2024-12-03",0,14,3184,0,2,3184,0,0
"North America","2024-12-04",0,0,3184,0,2,3186,0,0
"North America","2024-12-05",0,0,3184,0,3,3189,0,0
"North America","2024-12-06",0,0,3184,0,2,3191,0,0
"North America","2024-12-07",0,0,3184,0,3,3194,0,0
"North America","2024-12-08",0,0,3184,0,2,3196,0,0
"North America","2024-12-09",0,0,3184,0,3,3199,0,0
"North America","2024-12-10",0,17,3201,0,2,3201,0,0
"North America","2024-12-11",0,0,3201,0,1,3202,0,0
"North America","2024-12-12",0,0,3201,0,2,3204,0,0
"North America","2024-12-13",0,0,3201,0,1,3205,0,0
"North America","2024-12-14",0,0,3201,0,2,3207,0,0
"North America","2024-12-15",0,0,3201,0,1,3208,0,0
"North America","2024-12-16",0,0,3201,0,2,3210,0,0
"North America","2024-12-17",0,10,3211,0,1,3211,0,0
"North America","2024-12-18",0,0,3211,0,1,3212,0,0
"North America","2024-12-19",0,0,3211,0,2,3214,0,0
"North America","2024-12-20",0,0,3211,0,1,3215,0,0
"North America","2024-12-21",0,0,3211,0,1,3216,0,0
"North America","2024-12-22",0,0,3211,0,1,3217,0,0
"North America","2024-12-23",0,0,3211,0,2,3219,0,0
"North America","2024-12-24",0,9,3220,0,1,3220,0,0
"North America","2024-12-25",0,0,3220,0,0,3220,0,0
"North America","2024-12-26",0,0,3220,0,1,3221,0,0
"North America","2024-12-27",0,0,3220,0,0,3221,0,0
"North America","2024-12-28",0,0,3220,0,0,3221,0,0
"North America","2024-12-29",0,0,3220,0,0,3221,0,0
"North America","2024-12-30",0,0,3220,0,1,3222,0,0
"North America","2024-12-31",0,2,3222,0,0,3222,0,0
"North America","2025-01-01",0,0,3222,0,0,3222,0,0
"North America","2025-01-02",0,0,3222,0,0,3222,0,0
"North America","2025-01-03",0,0,3222,0,0,3222,0,0
"North America","2025-01-04",0,0,3222,0,0,3222,0,0
"North America","2025-01-05",0,0,3222,0,0,3222,0,0
"North America","2025-01-06",0,0,3222,0,0,3222,0,0
"North America","2025-01-07",0,0,3222,0,0,3222,0,0
"North America","2025-01-08",0,0,3222,0,0,3222,0,0
"North America","2025-01-09",0,0,3222,0,0,3222,0,0
"North America","2025-01-10",0,0,3222,0,0,3222,0,0
"North America","2025-01-11",0,0,3222,0,0,3222,0,0
"North America","2025-01-12",0,0,3222,0,0,3222,0,0
"North America","2025-01-13",0,0,3222,0,0,3222,0,0
"North America","2025-01-14",0,0,3222,0,0,3222,0,0
"North America","2025-01-15",0,0,3222,0,0,3222,0,0
"North America","2025-01-16",0,0,3222,0,0,3222,0,0
"North America","2025-01-17",0,0,3222,0,0,3222,0,0
"North America","2025-01-18",0,0,3222,0,0,3222,0,0
"North America","2025-01-19",0,0,3222,0,0,3222,0,0
"North America","2025-01-20",0,0,3222,0,0,3222,0,0
"North America","2025-01-21",0,0,3222,0,0,3222,0,0
"North America","2025-01-22",0,0,3222,0,0,3222,0,0
"North America","2025-01-23",0,0,3222,0,0,3222,0,0
"North America","2025-01-24",0,0,3222,0,0,3222,0,0
"North America","2025-01-25",0,0,3222,0,0,3222,0,0
"North America","2025-01-26",0,0,3222,0,0,3222,0,0
"North America","2025-01-27",0,0,3222,0,0,3222,0,0
"North America","2025-01-28",0,0,3222,0,0,3222,0,0
"North America","2025-01-29",0,0,3222,0,0,3222,0,0
"North America","2025-01-30",0,0,3222,0,0,3222,0,0
"North America","2025-01-31",0,0,3222,0,0,3222,0,0
"North America","2025-02-01",0,0,3222,0,0,3222,0,0
"North America","2025-02-02",0,0,3222,0,0,3222,0,0
"North America","2025-02-03",0,0,3222,0,0,3222,0,0
"Norway","2024-01-01",0,0,0,0,0,0,0,0
"Norway","2024-01-02",0,0,0,0,0,0,0,0
"Norway","2024-01-03",0,0,0,0,0,0,0,0
"Norway","2024-01-04",0,0,0,0,0,0,0,0
"Norway","2024-01-05",0,0,0,0,0,0,0,0
"Norway","2024-01-06",0,0,0,0,0,0,0,0
"Norway","2024-01-07",0,0,0,0,0,0,0,0
"Norway","2024-01-08",0,0,0,0,0,0,0,0
"Norway","2024-01-09",0,0,0,0,0,0,0,0
"Norway","2024-01-10",0,0,0,0,0,0,0,0
"Norway","2024-01-11",0,0,0,0,0,0,0,0
"Norway","2024-01-12",0,0,0,0,0,0,0,0
"Norway","2024-01-13",0,0,0,0,0,0,0,0
"Norway","2024-01-14",0,0,0,0,0,0,0,0
"Norway","2024-01-15",0,0,0,0,0,0,0,0
"Norway","2024-01-16",0,0,0,0,0,0,0,0
"Norway","2024-01-17",0,0,0,0,0,0,0,0
"Norway","2024-01-18",0,0,0,0,0,0,0,0
"Norway","2024-01-19",0,0,0,0,0,0,0,0
"Norway","2024-01-20",0,0,0,0,0,0,0,0
"Norway","2024-01-21",0,0,0,0,0,0,0,0
"Norway","2024-01-22",0,0,0,0,0,0,0,0
"Norway","2024-01-23",0,0,0,0,0,0,0,0
"Norway","2024-01-24",0,0,0,0,0,0,0,0
"Norway","2024-01-25",0,0,0,0,0,0,0,0
"Norway","2024-01-26",0,0,0,0,0,0,0,0
"Norway","2024-01-27",0,0,0,0,0,0,0,0
"Norway","2024-01-28",0,0,0,0,0,0,0,0
"Norway","2024-01-29",0,0,0,0,0,0,0,0
"Norway","2024-01-30",0,0,0,0,0,0,0,0
"Norway","2024-01-31",0,1,1,0,1,1,0,0
"Norway","2024-02-01",0,0,1,0,0,1,0,0
"Norway","2024-02-02",0,0,1,0,0,1,0,0
"Norway","2024-02-03",0,0,1,0,0,1,0,0
"Norway","2024-02-04",0,0,1,0,0,1,0,0
"Norway","2024-02-05",0,0,1,0,0,1,0,0
"Norway","2024-02-06",0,0,1,0,0,1,0,0
"Norway","2024-02-07",0,0,1,0,0,1,0,0
"Norway","2024-02-08",0,0,1,0,0,1,0,0
"Norway","2024-02-09",0,0,1,0,0,1,0,0
"Norway","2024-02-10",0,0,1,0,0,1,0,0
"Norway","2024-02-11",0,0,1,0,0,1,0,0
"Norway","2024-02-12",0,0,1,0,0,1,0,0
"Norway","2024-02-13",0,0,1,0,0,1,0,0
"Norway","2024-02-14",0,0,1,0,0,1,0,0
"Norway","2024-02-15",0,0,1,0,0,1,0,0
"Norway","2024-02-16",0,0,1,0,0,1,0,0
"Norway","2024-02-17",0,0,1,0,0,1,0,0
"Norway","2024-02-18",0,0,1,0,0,1,0,0
"Norway","2024-02-19",0,0,1,0,0,1,0,0
"Norway","2024-02-20",0,0,1,0,0,1,0,0
"Norway","2024-02-21",0,0,1,0,0,1,0,0
"Norway","2024-02-22",0,0,1,0,0,1,0,0
"Norway","2024-02-23",0,0,1,0,0,1,0,0
"Norway","2024-02-24",0,0,1,0,0,1,0,0
"Norway","2024-02-25",0,0,1,0,0,1,0,0
"Norway","2024-02-26",0,0,1,0,0,1,0,0
"Norway","2024-02-27",0,0,1,0,0,1,0,0
"Norway","2024-02-28",0,0,1,0,0,1,0,0
"Norway","2024-02-29",0,0,1,0,0,1,0,0
"Norway","2024-03-01",0,0,1,0,0,1,0,0
"Norway","2024-03-02",0,0,1,0,0,1,0,0
"Norway","2024-03-03",0,0,1,0,0,1,0,0
"Norway","2024-03-04",0,0,1,0,0,1,0,0
"Norway","2024-03-05",0,0,1,0,0,1,0,0
"Norway","2024-03-06",0,0,1,0,0,1,0,0
"Norway","2024-03-07",0,0,1,0,0,1,0,0
"Norway","2024-03-08",0,0,1,0,0,1,0,0
"Norway","2024-03-09",0,0,1,0,0,1,0,0
"Norway","2024-03-10",0,0,1,0,0,1,0,0
"Norway","2024-03-11",0,0,1,0,0,1,0,0
"Norway","2024-03-12",0,0,1,0,0,1,0,0
"Norway","2024-03-13",0,0,1,0,0,1,0,0
"Norway","2024-03-14",0,0,1,0,0,1,0,0
"Norway","2024-03-15",0,0,1,0,0,1,0,0
"Norway","2024-03-16",0,0,1,0,0,1,0,0
"Norway","2024-03-17",0,0,1,0,1,2,0,0
"Norway","2024-03-18",0,0,1,0,0,2,0,0
"Norway","2024-03-19",0,0,1,0,0,2,0,0
"Norway","2024-03-20",0,0,1,0,0,2,0,0
"Norway","2024-03-21",0,0,1,0,0,2,0,0
"Norway","2024-03-22",0,0,1,0,0,2,0,0
"Norway","2024-03-23",0,0,1,0,0,2,0,0
"Norway","2024-03-24",0,0,1,0,0,2,0,0
"Norway","2024-03-25",0,0,1,0,0,2,0,0
"Norway","2024-03-26",0,0,1,0,0,2,0,0
"Norway","2024-03-27",0,0,1,0,0,2,0,0
"Norway","2024-03-28",0,0,1,0,0,2,0,0
"Norway","2024-03-29",0,0,1,0,0,2,0,0
"Norway","2024-03-30",0,0,1,0,0,2,0,0
"Norway","2024-03-31",0,0,1,0,0,2,0,0
"Norway","2024-04-01",0,0,1,0,0,2,0,0
"Norway","2024-04-02",0,0,1,0,0,2,0,0
"Norway","2024-04-03",0,0,1,0,0,2,0,0
"Norway","2024-04-04",0,0,1,0,0,2,0,0
"Norway","2024-04-05",0,0,1,0,0,2,0,0
"Norway","2024-04-06",0,0,1,0,0,2,0,0
"Norway","2024-04-07",0,0,1,0,0,2,0,0
"Norway","2024-04-08",0,0,1,0,0,2,0,0
"Norway","2024-04-09",0,0,1,0,0,2,0,0
"Norway","2024-04-10",0,0,1,0,0,2,0,0
"Norway","2024-04-11",0,0,1,0,0,2,0,0
"Norway","2024-04-12",0,0,1,0,0,2,0,0
"Norway","2024-04-13",0,0,1,0,0,2,0,0
"Norway","2024-04-14",0,0,1,0,0,2,0,0
"Norway","2024-04-15",0,0,1,0,0,2,0,0
"Norway","2024-04-16",0,0,1,0,0,2,0,0
"Norway","2024-04-17",0,0,1,0,0,2,0,0
"Norway","2024-04-18",0,0,1,0,0,2,0,0
"Norway","2024-04-19",0,0,1,0,0,2,0,0
"Norway","2024-04-20",0,0,1,0,0,2,0,0
"Norway","2024-04-21",0,0,1,0,0,2,0,0
"Norway","2024-04-22",0,0,1,0,0,2,0,0
"Norway","2024-04-23",0,0,1,0,0,2,0,0
"Norway","2024-04-24",0,0,1,0,0,2,0,0
"Norway","2024-04-25",0,0,1,0,0,2,0,0
"Norway","2024-04-26",0,0,1,0,0,2,0,0
"Norway","2024-04-27",0,0,1,0,0,2,0,0
"Norway","2024-04-28",0,0,1,0,0,2,0,0
"Norway","2024-04-29",0,0,1,0,0,2,0,0
"Norway","2024-04-30",0,1,2,0,0,2,0,0
"Norway","2024-05-01",0,0,2,0,0,2,0,0
"Norway","2024-05-02",0,0,2,0,0,2,0,0
"Norway","2024-05-03",0,0,2,0,0,2,0,0
"Norway","2024-05-04",0,0,2,0,0,2,0,0
"Norway","2024-05-05",0,0,2,0,0,2,0,0
"Norway","2024-05-06",0,0,2,0,0,2,0,0
"Norway","2024-05-07",0,0,2,0,0,2,0,0
"Norway","2024-05-08",0,0,2,0,0,2,0,0
"Norway","2024-05-09",0,0,2,0,0,2,0,0
"Norway","2024-05-10",0,0,2,0,0,2,0,0
"Norway","2024-05-11",0,0,2,0,0,2,0,0
"Norway","2024-05-12",0,0,2,0,0,2,0,0
"Norway","2024-05-13",0,0,2,0,0,2,0,0
"Norway","2024-05-14",0,0,2,0,0,2,0,0
"Norway","2024-05-15",0,0,2,0,0,2,0,0
"Norway","2024-05-16",0,0,2,0,0,2,0,0
"Norway","2024-05-17",0,0,2,0,0,2,0,0
"Norway","2024-05-18",0,0,2,0,0,2,0,0
"Norway","2024-05-19",0,0,2,0,0,2,0,0
"Norway","2024-05-20",0,0,2,0,0,2,0,0
"Norway","2024-05-21",0,0,2,0,0,2,0,0
"Norway","2024-05-22",0,0,2,0,0,2,0,0
"Norway","2024-05-23",0,0,2,0,0,2,0,0
"Norway","2024-05-24",0,0,2,0,0,2,0,0
"Norway","2024-05-25",0,0,2,0,0,2,0,0
"Norway","2024-05-26",0,0,2,0,0,2,0,0
"Norway","2024-05-27",0,0,2,0,0,2,0,0
"Norway","2024-05-28",0,0,2,0,0,2,0,0
"Norway","2024-05-29",0,0,2,0,0,2,0,0
"Norway","2024-05-30",0,0,2,0,0,2,0,0
"Norway","2024-05-31",0,0,2,0,0,2,0,0
"Norway","2024-06-01",0,0,2,0,0,2,0,0
"Norway","2024-06-02",0,0,2,0,0,2,0,0
"Norway","2024-06-03",0,0,2,0,0,2,0,0
"Norway","2024-06-04",0,0,2,0,0,2,0,0
"Norway","2024-06-05",0,0,2,0,0,2,0,0
"Norway","2024-06-06",0,0,2,0,0,2,0,0
"Norway","2024-06-07",0,0,2,0,0,2,0,0
"Norway","2024-06-08",0,0,2,0,0,2,0,0
"Norway","2024-06-09",0,0,2,0,0,2,0,0
"Norway","2024-06-10",0,0,2,0,0,2,0,0
"Norway","2024-06-11",0,0,2,0,0,2,0,0
"Norway","2024-06-12",0,0,2,0,0,2,0,0
"Norway","2024-06-13",0,0,2,0,0,2,0,0
"Norway","2024-06-14",0,0,2,0,0,2,0,0
"Norway","2024-06-15",0,0,2,0,0,2,0,0
"Norway","2024-06-16",0,0,2,0,1,3,0,0
"Norway","2024-06-17",0,0,2,0,0,3,0,0
"Norway","2024-06-18",0,0,2,0,0,3,0,0
"Norway","2024-06-19",0,0,2,0,0,3,0,0
"Norway","2024-06-20",0,0,2,0,0,3,0,0
"Norway","2024-06-21",0,0,2,0,0,3,0,0
"Norway","2024-06-22",0,0,2,0,0,3,0,0
"Norway","2024-06-23",0,0,2,0,0,3,0,0
"Norway","2024-06-24",0,0,2,0,0,3,0,0
"Norway","2024-06-25",0,0,2,0,0,3,0,0
"Norway","2024-06-26",0,0,2,0,0,3,0,0
"Norway","2024-06-27",0,0,2,0,0,3,0,0
"Norway","2024-06-28",0,0,2,0,0,3,0,0
"Norway","2024-06-29",0,0,2,0,0,3,0,0
"Norway","2024-06-30",0,0,2,0,0,3,0,0
"Norway","2024-07-01",0,0,2,0,0,3,0,0
"Norway","2024-07-02",0,0,2,0,0,3,0,0
"Norway","2024-07-03",0,0,2,0,0,3,0,0
"Norway","2024-07-04",0,0,2,0,0,3,0,0
"Norway","2024-07-05",0,0,2,0,0,3,0,0
"Norway","2024-07-06",0,0,2,0,0,3,0,0
"Norway","2024-07-07",0,0,2,0,0,3,0,0
"Norway","2024-07-08",0,0,2,0,0,3,0,0
"Norway","2024-07-09",0,0,2,0,0,3,0,0
"Norway","2024-07-10",0,0,2,0,0,3,0,0
"Norway","2024-07-11",0,0,2,0,0,3,0,0
"Norway","2024-07-12",0,0,2,0,0,3,0,0
"Norway","2024-07-13",0,0,2,0,0,3,0,0
"Norway","2024-07-14",0,0,2,0,0,3,0,0
"Norway","2024-07-15",0,0,2,0,0,3,0,0
"Norway","2024-07-16",0,0,2,0,0,3,0,0
"Norway","2024-07-17",0,0,2,0,0,3,0,0
"Norway","2024-07-18",0,0,2,0,0,3,0,0
"Norway","2024-07-19",0,0,2,0,0,3,0,0
"Norway","2024-07-20",0,0,2,0,0,3,0,0
"Norway","2024-07-21",0,0,2,0,0,3,0,0
"Norway","2024-07-22",0,0,2,0,0,3,0,0
"Norway","2024-07-23",0,0,2,0,0,3,0,0
"Norway","2024-07-24",0,0,2,0,0,3,0,0
"Norway","2024-07-25",0,0,2,0,0,3,0,0
"Norway","2024-07-26",0,0,2,0,0,3,0,0
"Norway","2024-07-27",0,0,2,0,0,3,0,0
"Norway","2024-07-28",0,0,2,0,0,3,0,0
"Norway","2024-07-29",0,0,2,0,0,3,0,0
"Norway","2024-07-30",0,0,2,0,0,3,0,0
"Norway","2024-07-31",0,1,3,0,0,3,0,0
"Norway","2024-08-01",0,0,3,0,0,3,0,0
"Norway","2024-08-02",0,0,3,0,0,3,0,0
"Norway","2024-08-03",0,0,3,0,0,3,0,0
"Norway","2024-08-04",0,0,3,0,0,3,0,0
"Norway","2024-08-05",0,0,3,0,0,3,0,0
"Norway","2024-08-06",0,0,3,0,0,3,0,0
"Norway","2024-08-07",0,0,3,0,0,3,0,0
"Norway","2024-08-08",0,0,3,0,1,4,0,0
"Norway","2024-08-09",0,0,3,0,0,4,0,0
"Norway","2024-08-10",0,0,3,0,0,4,0,0
"Norway","2024-08-11",0,0,3,0,0,4,0,0
"Norway","2024-08-12",0,0,3,0,0,4,0,0
"Norway","2024-08-13",0,0,3,0,0,4,0,0
"Norway","2024-08-14",0,0,3,0,0,4,0,0
"Norway","2024-08-15",0,0,3,0,0,4,0,0
"Norway","2024-08-16",0,0,3,0,0,4,0,0
"Norway","2024-08-17",0,0,3,0,0,4,0,0
"Norway","2024-08-18",0,0,3,0,0,4,0,0
"Norway","2024-08-19",0,0,3,0,0,4,0,0
"Norway","2024-08-20",0,0,3,0,0,4,0,0
"Norway","2024-08-21",0,0,3,0,0,4,0,0
"Norway","2024-08-22",0,0,3,0,0,4,0,0
"Norway","2024-08-23",0,0,3,0,0,4,0,0
"Norway","2024-08-24",0,0,3,0,1,5,0,0
"Norway","2024-08-25",0,0,3,0,0,5,0,0
"Norway","2024-08-26",0,0,3,0,0,5,0,0
"Norway","2024-08-27",0,0,3,0,0,5,0,0
"Norway","2024-08-28",0,0,3,0,0,5,0,0
"Norway","2024-08-29",0,0,3,0,0,5,0,0
"Norway","2024-08-30",0,0,3,0,0,5,0,0
"Norway","2024-08-31",0,2,5,0,0,5,0,0
"Norway","2024-09-01",0,0,5,0,0,5,0,0
"Norway","2024-09-02",0,0,5,0,0,5,0,0
"Norway","2024-09-03",0,0,5,0,0,5,0,0
"Norway","2024-09-04",0,0,5,0,0,5,0,0
"Norway","2024-09-05",0,0,5,0,1,6,0,0
"Norway","2024-09-06",0,0,5,0,0,6,0,0
"Norway","2024-09-07",0,0,5,0,0,6,0,0
"Norway","2024-09-08",0,0,5,0,0,6,0,0
"Norway","2024-09-09",0,0,5,0,0,6,0,0
"Norway","2024-09-10",0,0,5,0,0,6,0,0
"Norway","2024-09-11",0,0,5,0,0,6,0,0
"Norway","2024-09-12",0,0,5,0,0,6,0,0
"Norway","2024-09-13",0,0,5,0,0,6,0,0
"Norway","2024-09-14",0,0,5,0,1,7,0,0
"Norway","2024-09-15",0,0,5,0,0,7,0,0
"Norway","2024-09-16",0,0,5,0,0,7,0,0
"Norway","2024-09-17",0,0,5,0,0,7,0,0
"Norway","2024-09-18",0,0,5,0,0,7,0,0
"Norway","2024-09-19",0,0,5,0,0,7,0,0
"Norway","2024-09-20",0,0,5,0,0,7,0,0
"Norway","2024-09-21",0,0,5,0,0,7,0,0
"Norway","2024-09-22",0,0,5,0,1,8,0,0
"Norway","2024-09-23",0,0,5,0,0,8,0,0
"Norway","2024-09-24",0,0,5,0,0,8,0,0
"Norway","2024-09-25",0,0,5,0,0,8,0,0
"Norway","2024-09-26",0,0,5,0,0,8,0,0
"Norway","2024-09-27",0,0,5,0,0,8,0,0
"Norway","2024-09-28",0,0,5,0,0,8,0,0
"Norway","2024-09-29",0,0,5,0,0,8,0,0
"Norway","2024-09-30",0,0,5,0,0,8,0,0
"Norway","2024-10-01",0,0,5,0,1,9,0,0
"Norway","2024-10-02",0,0,5,0,0,9,0,0
"Norway","2024-10-03",0,0,5,0,0,9,0,0
"Norway","2024-10-04",0,0,5,0,0,9,0,0
"Norway","2024-10-05",0,0,5,0,0,9,0,0
"Norway","2024-10-06",0,0,5,0,0,9,0,0
"Norway","2024-10-07",0,0,5,0,0,9,0,0
"Norway","2024-10-08",0,0,5,0,0,9,0,0
"Norway","2024-10-09",0,0,5,0,0,9,0,0
"Norway","2024-10-10",0,0,5,0,1,10,0,0
"Norway","2024-10-11",0,0,5,0,0,10,0,0
"Norway","2024-10-12",0,0,5,0,0,10,0,0
"Norway","2024-10-13",0,0,5,0,0,10,0,0
"Norway","2024-10-14",0,0,5,0,0,10,0,0
"Norway","2024-10-15",0,0,5,0,0,10,0,0
"Norway","2024-10-16",0,0,5,0,0,10,0,0
"Norway","2024-10-17",0,0,5,0,0,10,0,0
"Norway","2024-10-18",0,0,5,0,1,11,0,0
"Norway","2024-10-19",0,0,5,0,0,11,0,0
"Norway","2024-10-20",0,0,5,0,0,11,0,0
"Norway","2024-10-21",0,0,5,0,0,11,0,0
"Norway","2024-10-22",0,0,5,0,0,11,0,0
"Norway","2024-10-23",0,0,5,0,0,11,0,0
"Norway","2024-10-24",0,0,5,0,0,11,0,0
"Norway","2024-10-25",0,0,5,0,0,11,0,0
"Norway","2024-10-26",0,0,5,0,0,11,0,0
"Norway","2024-10-27",0,0,5,0,1,12,0,0
"Norway","2024-10-28",0,0,5,0,0,12,0,0
"Norway","2024-10-29",0,0,5,0,0,12,0,0
"Norway","2024-10-30",0,0,5,0,0,12,0,0
"Norway","2024-10-31",0,7,12,0,0,12,0,0
"Norway","2024-11-01",0,0,12,0,0,12,0,0
"Norway","2024-11-02",0,0,12,0,0,12,0,0
"Norway","2024-11-03",0,0,12,0,0,12,0,0
"Norway","2024-11-04",0,0,12,0,0,12,0,0
"Norway","2024-11-05",0,0,12,0,0,12,0,0
"Norway","2024-11-06",0,0,12,0,1,13,0,0
"Norway","2024-11-07",0,0,12,0,0,13,0,0
"Norway","2024-11-08",0,0,12,0,0,13,0,0
"Norway","2024-11-09",0,0,12,0,0,13,0,0
"Norway","2024-11-10",0,0,12,0,0,13,0,0
"Norway","2024-11-11",0,0,12,0,0,13,0,0
"Norway","2024-11-12",0,0,12,0,0,13,0,0
"Norway","2024-11-13",0,0,12,0,0,13,0,0
"Norway","2024-11-14",0,0,12,0,0,13,0,0
"Norway","2024-11-15",0,0,12,0,1,14,0,0
"Norway","2024-11-16",0,0,12,0,0,14,0,0
"Norway","2024-11-17",0,0,12,0,0,14,0,0
"Norway","2024-11-18",0,0,12,0,0,14,0,0
"Norway","2024-11-19",0,0,12,0,0,14,0,0
"Norway","2024-11-20",0,0,12,0,0,14,0,0
"Norway","2024-11-21",0,0,12,0,0,14,0,0
"Norway","2024-11-22",0,0,12,0,0,14,0,0
"Norway","2024-11-23",0,0,12,0,0,14,0,0
"Norway","2024-11-24",0,0,12,0,0,14,0,0
"Norway","2024-11-25",0,0,12,0,0,14,0,0
"Norway","2024-11-26",0,0,12,0,1,15,0,0
"Norway","2024-11-27",0,0,12,0,0,15,0,0
"Norway","2024-11-28",0,0,12,0,0,15,0,0
"Norway","2024-11-29",0,0,12,0,0,15,0,0
"Norway","2024-11-30",0,3,15,0,0,15,0,0
"Norway","2024-12-01",0,0,15,0,0,15,0,0
"Norway","2024-12-02",0,0,15,0,0,15,0,0
"Norway","2024-12-03",0,0,15,0,0,15,0,0
"Norway","2024-12-04",0,0,15,0,0,15,0,0
"Norway","2024-12-05",0,0,15,0,0,15,0,0
"Norway","2024-12-06",0,0,15,0,0,15,0,0
"Norway","2024-12-07",0,0,15,0,0,15,0,0
"Norway","2024-12-08",0,0,15,0,0,15,0,0
"Norway","2024-12-09",0,0,15,0,0,15,0,0
"Norway","2024-12-10",0,0,15,0,0,15,0,0
"Norway","2024-12-11",0,0,15,0,0,15,0,0
"Norway","2024-12-12",0,0,15,0,0,15,0,0
"Norway","2024-12-13",0,0,15,0,0,15,0,0
"Norway","2024-12-14",0,0,15,0,0,15,0,0
"Norway","2024-12-15",0,0,15,0,0,15,0,0
"Norway","2024-12-16",0,0,15,0,0,15,0,0
"Norway","2024-12-17",0,0,15,0,0,15,0,0
"Norway","2024-12-18",0,0,15,0,0,15,0,0
"Norway","2024-12-19",0,0,15,0,0,15,0,0
"Norway","2024-12-20",0,0,15,0,0,15,0,0
"Norway","2024-12-21",0,0,15,0,0,15,0,0
"Norway","2024-12-22",0,0,15,0,0,15,0,0
"Norway","2024-12-23",0,0,15,0,0,15,0,0
"Norway","2024-12-24",0,0,15,0,0,15,0,0
"Norway","2024-12-25",0,0,15,0,0,15,0,0
"Norway","2024-12-26",0,0,15,0,0,15,0,0
"Norway","2024-12-27",0,0,15,0,0,15,0,0
"Norway","2024-12-28",0,0,15,0,0,15,0,0
"Norway","2024-12-29",0,0,15,0,0,15,0,0
"Norway","2024-12-30",0,0,15,0,0,15,0,0
"Norway","2024-12-31",0,0,15,0,0,15,0,0
"Norway","2025-01-01",0,0,15,0,0,15,0,0
"Norway","2025-01-02",0,0,15,0,0,15,0,0
"Norway","2025-01-03",0,0,15,0,0,15,0,0
"Norway","2025-01-04",0,0,15,0,0,15,0,0
"Norway","2025-01-05",0,0,15,0,0,15,0,0
"Norway","2025-01-06",0,0,15,0,0,15,0,0
"Norway","2025-01-07",0,0,15,0,0,15,0,0
"Norway","2025-01-08",0,0,15,0,0,15,0,0
"Norway","2025-01-09",0,0,15,0,0,15,0,0
"Norway","2025-01-10",0,0,15,0,0,15,0,0
"Norway","2025-01-11",0,0,15,0,0,15,0,0
"Norway","2025-01-12",0,0,15,0,0,15,0,0
"Norway","2025-01-13",0,0,15,0,0,15,0,0
"Norway","2025-01-14",0,0,15,0,0,15,0,0
"Norway","2025-01-15",0,0,15,0,0,15,0,0
"Norway","2025-01-16",0,0,15,0,0,15,0,0
"Norway","2025-01-17",0,0,15,0,0,15,0,0
"Norway","2025-01-18",0,0,15,0,0,15,0,0
"Norway","2025-01-19",0,0,15,0,0,15,0,0
"Norway","2025-01-20",0,0,15,0,0,15,0,0
"Norway","2025-01-21",0,0,15,0,0,15,0,0
"Norway","2025-01-22",0,0,15,0,0,15,0,0
"Norway","2025-01-23",0,0,15,0,0,15,0,0
"Norway","2025-01-24",0,0,15,0,0,15,0,0
"Norway","2025-01-25",0,0,15,0,0,15,0,0
"Norway","2025-01-26",0,0,15,0,0,15,0,0
"Norway","2025-01-27",0,0,15,0,0,15,0,0
"Norway","2025-01-28",0,0,15,0,0,15,0,0
"Norway","2025-01-29",0,0,15,0,0,15,0,0
"Norway","2025-01-30",0,0,15,0,0,15,0,0
"Norway","2025-01-31",0,0,15,0,0,15,0,0
"Norway","2025-02-01",0,0,15,0,0,15,0,0
"Norway","2025-02-02",0,0,15,0,0,15,0,0
"Norway","2025-02-03",0,0,15,0,0,15,0,0
"Oceania","2024-01-01",0,0,0,0,0,0,0,0
"Oceania","2024-01-02",0,0,0,0,0,0,0,0
"Oceania","2024-01-03",0,0,0,0,0,0,0,0
"Oceania","2024-01-04",0,0,0,0,0,0,0,0
"Oceania","2024-01-05",0,0,0,0,0,0,0,0
"Oceania","2024-01-06",0,0,0,0,0,0,0,0
"Oceania","2024-01-07",0,0,0,0,0,0,0,0
"Oceania","2024-01-08",0,0,0,0,0,0,0,0
"Oceania","2024-01-09",0,0,0,0,0,0,0,0
"Oceania","2024-01-10",0,0,0,0,0,0,0,0
"Oceania","2024-01-11",0,0,0,0,0,0,0,0
"Oceania","2024-01-12",0,0,0,0,0,0,0,0
"Oceania","2024-01-13",0,0,0,0,0,0,0,0
"Oceania","2024-01-14",0,0,0,0,0,0,0,0
"Oceania","2024-01-15",0,0,0,0,0,0,0,0
"Oceania","2024-01-16",0,8,8,0,8,8,0,0
"Oceania","2024-01-17",0,0,8,0,0,8,0,0
"Oceania","2024-01-18",0,0,8,0,1,9,0,0
"Oceania","2024-01-19",0,0,8,0,0,9,0,0
"Oceania","2024-01-20",0,0,8,0,1,10,0,0
"Oceania","2024-01-21",0,0,8,0,0,10,0,0
"Oceania","2024-01-22",0,0,8,0,0,10,0,0
"Oceania","2024-01-23",0,0,8,0,1,11,0,0
"Oceania","2024-01-24",0,0,8,0,0,11,0,0
"Oceania","2024-01-25",0,0,8,0,1,12,0,0
"Oceania","2024-01-26",0,0,8,0,0,12,0,0
"Oceania","2024-01-27",0,0,8,0,0,12,0,0
"Oceania","2024-01-28",0,0,8,0,1,13,0,0
"Oceania","2024-01-29",0,0,8,0,0,13,0,0
"Oceania","2024-01-30",0,0,8,0,1,14,0,0
"Oceania","2024-01-31",0,6,14,0,0,14,0,0
"Oceania","2024-02-01",0,0,14,0,0,14,0,0
"Oceania","2024-02-02",0,0,14,0,0,14,0,0
"Oceania","2024-02-03",0,0,14,0,0,14,0,0
"Oceania","2024-02-04",0,0,14,0,0,14,0,0
"Oceania","2024-02-05",0,0,14,0,0,14,0,0
"Oceania","2024-02-06",0,0,14,0,0,14,0,0
"Oceania","2024-02-07",0,0,14,0,0,14,0,0
"Oceania","2024-02-08",0,0,14,0,0,14,0,0
"Oceania","2024-02-09",0,0,14,0,0,14,0,0
"Oceania","2024-02-10",0,0,14,0,1,15,0,0
"Oceania","2024-02-11",0,0,14,0,0,15,0,0
"Oceania","2024-02-12",0,0,14,0,0,15,0,0
"Oceania","2024-02-13",0,0,14,0,0,15,0,0
"Oceania","2024-02-14",0,0,14,0,0,15,0,0
"Oceania","2024-02-15",0,0,14,0,0,15,0,0
"Oceania","2024-02-16",0,0,14,0,0,15,0,0
"Oceania","2024-02-17",0,0,14,0,0,15,0,0
"Oceania","2024-02-18",0,0,14,0,0,15,0,0
"Oceania","2024-02-19",0,0,14,0,0,15,0,0
"Oceania","2024-02-20",0,0,14,0,0,15,0,0
"Oceania","2024-02-21",0,0,14,0,0,15,0,0
"Oceania","2024-02-22",0,0,14,0,0,15,0,0
"Oceania","2024-02-23",0,0,14,0,0,15,0,0
"Oceania","2024-02-24",0,0,14,0,0,15,0,0
"Oceania","2024-02-25",0,0,14,0,0,15,0,0
"Oceania","2024-02-26",0,0,14,0,0,15,0,0
"Oceania","2024-02-27",0,0,14,0,1,16,0,0
"Oceania","2024-02-28",0,0,14,0,0,16,0,0
"Oceania","2024-02-29",0,0,14,0,0,16,0,0
"Oceania","2024-03-01",0,0,14,0,0,16,0,0
"Oceania","2024-03-02",0,0,14,0,0,16,0,0
"Oceania","2024-03-03",0,0,14,0,0,16,0,0
"Oceania","2024-03-04",0,0,14,0,0,16,0,0
"Oceania","2024-03-05",0,0,14,0,0,16,0,0
"Oceania","2024-03-06",0,0,14,0,0,16,0,0
"Oceania","2024-03-07",0,0,14,0,0,16,0,0
"Oceania","2024-03-08",0,0,14,0,0,16,0,0
"Oceania","2024-03-09",0,0,14,0,0,16,0,0
"Oceania","2024-03-10",0,0,14,0,0,16,0,0
"Oceania","2024-03-11",0,0,14,0,0,16,0,0
"Oceania","2024-03-12",0,0,14,0,0,16,0,0
"Oceania","2024-03-13",0,0,14,0,0,16,0,0
"Oceania","2024-03-14",0,0,14,0,0,16,0,0
"Oceania","2024-03-15",0,0,14,0,0,16,0,0
"Oceania","2024-03-16",0,0,14,0,0,16,0,0
"Oceania","2024-03-17",0,0,14,0,1,17,0,0
"Oceania","2024-03-18",0,0,14,0,0,17,0,0
"Oceania","2024-03-19",0,0,14,0,0,17,0,0
"Oceania","2024-03-20",0,0,14,0,0,17,0,0
"Oceania","2024-03-21",0,0,14,0,0,17,0,0
"Oceania","2024-03-22",0,0,14,0,0,17,0,0
"Oceania","2024-03-23",0,0,14,0,0,17,0,0
"Oceania","2024-03-24",0,0,14,0,0,17,0,0
"Oceania","2024-03-25",0,0,14,0,0,17,0,0
"Oceania","2024-03-26",0,0,14,0,0,17,0,0
"Oceania","2024-03-27",0,0,14,0,0,17,0,0
"Oceania","2024-03-28",0,0,14,0,0,17,0,0
"Oceania","2024-03-29",0,0,14,0,0,17,0,0
"Oceania","2024-03-30",0,0,14,0,0,17,0,0
"Oceania","2024-03-31",0,0,14,0,0,17,0,0
"Oceania","2024-04-01",0,0,14,0,0,17,0,0
"Oceania","2024-04-02",0,0,14,0,0,17,0,0
"Oceania","2024-04-03",0,0,14,0,1,18,0,0
"Oceania","2024-04-04",0,0,14,0,0,18,0,0
"Oceania","2024-04-05",0,0,14,0,0,18,0,0
"Oceania","2024-04-06",0,0,14,0,0,18,0,0
"Oceania","2024-04-07",0,0,14,0,0,18,0,0
"Oceania","2024-04-08",0,0,14,0,0,18,0,0
"Oceania","2024-04-09",0,0,14,0,0,18,0,0
"Oceania","2024-04-10",0,0,14,0,0,18,0,0
"Oceania","2024-04-11",0,0,14,0,0,18,0,0
"Oceania","2024-04-12",0,0,14,0,0,18,0,0
"Oceania","2024-04-13",0,0,14,0,0,18,0,0
"Oceania","2024-04-14",0,0,14,0,0,18,0,0
"Oceania","2024-04-15",0,0,14,0,0,18,0,0
"Oceania","2024-04-16",0,0,14,0,0,18,0,0
"Oceania","2024-04-17",0,0,14,0,0,18,0,0
"Oceania","2024-04-18",0,0,14,0,0,18,0,0
"Oceania","2024-04-19",0,0,14,0,0,18,0,0
"Oceania","2024-04-20",0,0,14,0,0,18,0,0
"Oceania","2024-04-21",0,0,14,0,0,18,0,0
"Oceania","2024-04-22",0,0,14,0,1,19,0,0
"Oceania","2024-04-23",0,0,14,0,0,19,0,0
"Oceania","2024-04-24",0,0,14,0,0,19,0,0
"Oceania","2024-04-25",0,0,14,0,0,19,0,0
"Oceania","2024-04-26",0,0,14,0,0,19,0,0
"Oceania","2024-04-27",0,0,14,0,0,19,0,0
"Oceania","2024-04-28",0,0,14,0,0,19,0,0
"Oceania","2024-04-29",0,0,14,0,0,19,0,0
"Oceania","2024-04-30",0,5,19,0,0,19,0,0
"Oceania","2024-05-01",0,0,19,0,0,19,0,0
"Oceania","2024-05-02",0,0,19,0,0,19,0,0
"Oceania","2024-05-03",0,0,19,0,0,19,0,0
"Oceania","2024-05-04",0,0,19,0,0,19,0,0
"Oceania","2024-05-05",0,0,19,0,1,20,0,0
"Oceania","2024-05-06",0,0,19,0,0,20,0,0
"Oceania","2024-05-07",0,0,19,0,0,20,0,0
"Oceania","2024-05-08",0,0,19,0,0,20,0,0
"Oceania","2024-05-09",0,1,20,0,0,20,0,0
"Oceania","2024-05-10",0,0,20,0,2,22,0,0
"Oceania","2024-05-11",0,0,20,0,1,23,0,0
"Oceania","2024-05-12",0,0,20,0,1,24,0,0
"Oceania","2024-05-13",0,0,20,0,2,26,0,0
"Oceania","2024-05-14",0,0,20,0,2,28,0,0
"Oceania","2024-05-15",0,0,20,0,1,29,0,0
"Oceania","2024-05-16",0,0,20,0,1,30,0,0
"Oceania","2024-05-17",0,0,20,0,2,32,0,0
"Oceania","2024-05-18",0,0,20,0,2,34,0,0
"Oceania","2024-05-19",0,0,20,0,1,35,0,0
"Oceania","2024-05-20",0,0,20,0,1,36,0,0
"Oceania","2024-05-21",0,0,20,0,2,38,0,0
"Oceania","2024-05-22",0,0,20,0,2,40,0,0
"Oceania","2024-05-23",0,0,20,0,1,41,0,0
"Oceania","2024-05-24",0,0,20,0,1,42,0,0
"Oceania","2024-05-25",0,0,20,0,2,44,0,0
"Oceania","2024-05-26",0,0,20,0,2,46,0,0
"Oceania","2024-05-27",0,0,20,0,1,47,0,0
"Oceania","2024-05-28",0,0,20,0,1,48,0,0
"Oceania","2024-05-29",0,0,20,0,2,50,0,0
"Oceania","2024-05-30",0,0,20,0,2,52,0,0
"Oceania","2024-05-31",0,33,53,0,1,53,0,0
"Oceania","2024-06-01",0,0,53,0,2,55,0,0
"Oceania","2024-06-02",0,0,53,0,2,57,0,0
"Oceania","2024-06-03",0,0,53,0,2,59,0,0
"Oceania","2024-06-04",0,0,53,0,3,62,0,0
"Oceania","2024-06-05",0,0,53,0,2,64,0,0
"Oceania","2024-06-06",0,0,53,0,2,66,0,0
"Oceania","2024-06-07",0,0,53,0,2,68,0,0
"Oceania","2024-06-08",0,0,53,0,2,70,0,0
"Oceania","2024-06-09",0,0,53,0,2,72,0,0
"Oceania","2024-06-10",0,0,53,0,2,74,0,0
"Oceania","2024-06-11",0,0,53,0,2,76,0,0
"Oceania","2024-06-12",0,0,53,0,3,79,0,0
"Oceania","2024-06-13",0,0,53,0,2,81,0,0
"Oceania","2024-06-14",0,0,53,0,2,83,0,0
"Oceania","2024-06-15",0,0,53,0,2,85,0,0
"Oceania","2024-06-16",0,0,53,0,2,87,0,0
"Oceania","2024-06-17",0,0,53,0,2,89,0,0
"Oceania","2024-06-18",0,0,53,0,2,91,0,0
"Oceania","2024-06-19",0,0,53,0,3,94,0,0
"Oceania","2024-06-20",0,0,53,0,2,96,0,0
"Oceania","2024-06-21",0,0,53,0,2,98,0,0
"Oceania","2024-06-22",0,0,53,0,2,100,0,0
"Oceania","2024-06-23",0,0,53,0,2,102,0,0
"Oceania","2024-06-24",0,0,53,0,2,104,0,0
"Oceania","2024-06-25",0,0,53,0,2,106,0,0
"Oceania","2024-06-26",0,0,53,0,2,108,0,0
"Oceania","2024-06-27",0,0,53,0,3,111,0,0
"Oceania","2024-06-28",0,0,53,0,2,113,0,0
"Oceania","2024-06-29",0,0,53,0,2,115,0,0
"Oceania","2024-06-30",0,64,117,0,2,117,0,0
"Oceania","2024-07-01",0,2,119,0,2,119,0,0
"Oceania","2024-07-02",0,0,119,0,1,120,0,0
"Oceania","2024-07-03",0,0,119,0,1,121,0,0
"Oceania","2024-07-04",0,0,119,0,1,122,0,0
"Oceania","2024-07-05",0,0,119,0,1,123,0,0
"Oceania","2024-07-06",0,0,119,0,1,124,0,0
"Oceania","2024-07-07",0,0,119,0,1,125,0,0
"Oceania","2024-07-08",0,0,119,0,1,126,0,0
"Oceania","2024-07-09",0,0,119,0,1,127,0,0
"Oceania","2024-07-10",0,0,119,0,1,128,0,0
"Oceania","2024-07-11",0,0,119,0,1,129,0,0
"Oceania","2024-07-12",0,0,119,0,1,130,0,0
"Oceania","2024-07-13",0,0,119,0,1,131,0,0
"Oceania","2024-07-14",0,0,119,0,1,132,0,0
"Oceania","2024-07-15",0,14,133,0,1,133,0,0
"Oceania","2024-07-16",0,0,133,0,3,136,0,0
"Oceania","2024-07-17",0,0,133,0,3,139,0,0
"Oceania","2024-07-18",0,0,133,0,3,142,0,0
"Oceania","2024-07-19",0,0,133,0,3,145,0,0
"Oceania","2024-07-20",0,0,133,0,3,148,0,0
"Oceania","2024-07-21",0,0,133,0,3,151,0,0
"Oceania","2024-07-22",0,21,154,0,3,154,0,0
"Oceania","2024-07-23",0,0,154,0,4,158,0,0
"Oceania","2024-07-24",0,0,154,0,4,162,0,0
"Oceania","2024-07-25",0,0,154,0,5,167,0,0
"Oceania","2024-07-26",0,0,154,0,4,171,0,0
"Oceania","2024-07-27",0,21,175,0,4,175,0,0
"Oceania","2024-07-28",0,0,175,0,11,186,0,0
"Oceania","2024-07-29",0,0,175,0,10,196,0,0
"Oceania","2024-07-30",0,32,207,0,11,207,0,0
"Oceania","2024-07-31",0,13,220,0,13,220,0,0
"Oceania","2024-08-01",0,0,220,0,4,224,0,0
"Oceania","2024-08-02",0,0,220,0,3,227,0,0
"Oceania","2024-08-03",0,0,220,0,4,231,0,0
"Oceania","2024-08-04",0,0,220,0,3,234,0,0
"Oceania","2024-08-05",0,0,220,0,4,238,0,0
"Oceania","2024-08-06",0,0,220,0,3,241,0,0
"Oceania","2024-08-07",0,0,220,0,4,245,0,0
"Oceania","2024-08-08",0,0,220,0,3,248,0,0
"Oceania","2024-08-09",0,0,220,0,4,252,0,0
"Oceania","2024-08-10",0,0,220,0,3,255,0,0
"Oceania","2024-08-11",0,0,220,0,4,259,0,0
"Oceania","2024-08-12",0,0,220,0,3,262,0,0
"Oceania","2024-08-13",0,0,220,0,4,266,0,0
"Oceania","2024-08-14",0,0,220,0,3,269,0,0
"Oceania","2024-08-15",0,0,220,0,4,273,0,0
"Oceania","2024-08-16",0,0,220,0,3,276,0,0
"Oceania","2024-08-17",0,0,220,0,4,280,0,0
"Oceania","2024-08-18",0,0,220,0,3,283,0,0
"Oceania","2024-08-19",0,0,220,0,4,287,0,0
"Oceania","2024-08-20",0,0,220,0,3,290,0,0
"Oceania","2024-08-21",0,74,294,0,4,294,0,0
"Oceania","2024-08-22",0,0,294,0,9,303,0,0
"Oceania","2024-08-23",0,0,294,0,9,312,0,0
"Oceania","2024-08-24",0,0,294,0,8,320,0,0
"Oceania","2024-08-25",0,0,294,0,9,329,0,0
"Oceania","2024-08-26",0,0,294,0,9,338,0,0
"Oceania","2024-08-27",0,0,294,0,8,346,0,0
"Oceania","2024-08-28",0,0,294,0,9,355,0,0
"Oceania","2024-08-29",0,70,364,0,9,364,0,0
"Oceania","2024-08-30",0,0,364,0,50,414,0,0
"Oceania","2024-08-31",0,101,465,0,51,465,0,0
"Oceania","2024-09-01",0,0,465,0,4,469,0,0
"Oceania","2024-09-02",0,0,465,0,5,474,0,0
"Oceania","2024-09-03",0,0,465,0,4,478,0,0
"Oceania","2024-09-04",0,0,465,0,5,483,0,0
"Oceania","2024-09-05",0,0,465,0,4,487,0,0
"Oceania","2024-09-06",0,0,465,0,4,491,0,0
"Oceania","2024-09-07",0,0,465,0,5,496,0,0
"Oceania","2024-09-08",0,35,500,0,4,500,0,0
"Oceania","2024-09-09",0,0,500,0,12,512,0,0
"Oceania","2024-09-10",0,0,500,0,12,524,0,0
"Oceania","2024-09-11",0,0,500,0,12,536,0,0
"Oceania","2024-09-12",0,0,500,0,12,548,0,0
"Oceania","2024-09-13",0,0,500,0,12,560,0,0
"Oceania","2024-09-14",0,0,500,0,12,572,0,0
"Oceania","2024-09-15",0,84,584,0,12,584,0,0
"Oceania","2024-09-16",0,0,584,0,13,597,0,0
"Oceania","2024-09-17",0,0,584,0,13,610,0,0
"Oceania","2024-09-18",0,0,584,0,13,623,0,0
"Oceania","2024-09-19",0,0,584,0,14,637,0,0
"Oceania","2024-09-20",0,0,584,0,13,650,0,0
"Oceania","2024-09-21",0,0,584,0,13,663,0,0
"Oceania","2024-09-22",0,92,676,0,13,676,0,0
"Oceania","2024-09-23",0,0,676,0,13,689,0,0
"Oceania","2024-09-24",0,0,676,0,13,702,0,0
"Oceania","2024-09-25",0,0,676,0,13,715,0,0
"Oceania","2024-09-26",0,0,676,0,13,728,0,0
"Oceania","2024-09-27",0,0,676,0,13,741,0,0
"Oceania","2024-09-28",0,0,676,0,13,754,0,0
"Oceania","2024-09-29",0,91,767,0,13,767,0,0
"Oceania","2024-09-30",0,0,767,0,10,777,0,0
"Oceania","2024-10-01",0,0,767,0,11,788,0,0
"Oceania","2024-10-02",0,0,767,0,10,798,0,0
"Oceania","2024-10-03",0,0,767,0,10,808,0,0
"Oceania","2024-10-04",0,0,767,0,10,818,0,0
"Oceania","2024-10-05",0,0,767,0,11,829,0,0
"Oceania","2024-10-06",0,72,839,0,10,839,0,0
"Oceania","2024-10-07",0,23,862,0,23,862,0,0
"Oceania","2024-10-08",0,0,862,0,9,871,0,0
"Oceania","2024-10-09",0,0,862,0,9,880,0,0
"Oceania","2024-10-10",0,0,862,0,9,889,0,0
"Oceania","2024-10-11",0,0,862,0,9,898,0,0
"Oceania","2024-10-12",0,0,862,0,9,907,0,0
"Oceania","2024-10-13",0,54,916,0,9,916,0,0
"Oceania","2024-10-14",0,0,916,0,6,922,0,0
"Oceania","2024-10-15",0,12,928,0,6,928,0,0
"Oceania","2024-10-16",0,0,928,0,16,944,0,0
"Oceania","2024-10-17",0,0,928,0,16,960,0,0
"Oceania","2024-10-18",0,0,928,0,15,975,0,0
"Oceania","2024-10-19",0,0,928,0,16,991,0,0
"Oceania","2024-10-20",0,79,1007,0,16,1007,0,0
"Oceania","2024-10-21",0,0,1007,0,10,1017,0,0
"Oceania","2024-10-22",0,0,1007,0,9,1026,0,0
"Oceania","2024-10-23",0,0,1007,0,10,1036,0,0
"Oceania","2024-10-24",0,0,1007,0,10,1046,0,0
"Oceania","2024-10-25",0,0,1007,0,10,1056,0,0
"Oceania","2024-10-26",0,0,1007,0,9,1065,0,0
"Oceania","2024-10-27",0,68,1075,0,10,1075,0,0
"Oceania","2024-10-28",0,0,1075,0,11,1086,0,0
"Oceania","2024-10-29",0,0,1075,0,12,1098,0,0
"Oceania","2024-10-30",0,0,1075,0,11,1109,0,0
"Oceania","2024-10-31",0,0,1075,0,11,1120,0,0
"Oceania","2024-11-01",0,0,1075,0,11,1131,0,0
"Oceania","2024-11-02",0,0,1075,0,12,1143,0,0
"Oceania","2024-11-03",0,79,1154,0,11,1154,0,0
"Oceania","2024-11-04",0,1,1155,0,1,1155,0,0
"Oceania","2024-11-05",0,0,1155,0,10,1165,0,0
"Oceania","2024-11-06",0,0,1155,0,9,1174,0,0
"Oceania","2024-11-07",0,0,1155,0,9,1183,0,0
"Oceania","2024-11-08",0,0,1155,0,10,1193,0,0
"Oceania","2024-11-09",0,0,1155,0,10,1203,0,0
"Oceania","2024-11-10",0,57,1212,0,9,1212,0,0
"Oceania","2024-11-11",0,0,1212,0,7,1219,0,0
"Oceania","2024-11-12",0,0,1212,0,7,1226,0,0
"Oceania","2024-11-13",0,0,1212,0,7,1233,0,0
"Oceania","2024-11-14",0,0,1212,0,7,1240,0,0
"Oceania","2024-11-15",0,0,1212,0,7,1247,0,0
"Oceania","2024-11-16",0,0,1212,0,7,1254,0,0
"Oceania","2024-11-17",0,49,1261,0,7,1261,0,0
"Oceania","2024-11-18",0,0,1261,0,4,1265,0,0
"Oceania","2024-11-19",0,0,1261,0,4,1269,0,0
"Oceania","2024-11-20",0,0,1261,0,4,1273,0,0
"Oceania","2024-11-21",0,0,1261,0,5,1278,0,0
"Oceania","2024-11-22",0,0,1261,0,4,1282,0,0
"Oceania","2024-11-23",0,0,1261,0,4,1286,0,0
"Oceania","2024-11-24",0,29,1290,0,4,1290,0,0
"Oceania","2024-11-25",0,0,1290,0,5,1295,0,0
"Oceania","2024-11-26",0,0,1290,0,5,1300,0,0
"Oceania","2024-11-27",0,0,1290,0,5,1305,0,0
"Oceania","2024-11-28",0,0,1290,0,4,1309,0,0
"Oceania","2024-11-29",0,0,1290,0,5,1314,0,0
"Oceania","2024-11-30",0,0,1290,0,5,1319,0,0
"Oceania","2024-12-01",0,34,1324,0,5,1324,0,0
"Oceania","2024-12-02",0,0,1324,0,1,1325,0,0
"Oceania","2024-12-03",0,0,1324,0,1,1326,0,0
"Oceania","2024-12-04",0,0,1324,0,0,1326,0,0
"Oceania","2024-12-05",0,3,1327,0,1,1327,0,0
"Oceania","2024-12-06",0,0,1327,0,6,1333,0,0
"Oceania","2024-12-07",0,0,1327,0,7,1340,0,0
"Oceania","2024-12-08",0,0,1327,0,7,1347,0,0
"Oceania","2024-12-09",0,26,1353,0,6,1353,0,0
"Oceania","2024-12-10",0,0,1353,0,4,1357,0,0
"Oceania","2024-12-11",0,0,1353,0,5,1362,0,0
"Oceania","2024-12-12",0,0,1353,0,4,1366,0,0
"Oceania","2024-12-13",0,0,1353,0,4,1370,0,0
"Oceania","2024-12-14",0,0,1353,0,5,1375,0,0
"Oceania","2024-12-15",0,26,1379,0,4,1379,0,0
"Oceania","2024-12-16",0,0,1379,0,3,1382,0,0
"Oceania","2024-12-17",0,0,1379,0,2,1384,0,0
"Oceania","2024-12-18",0,0,1379,0,3,1387,0,0
"Oceania","2024-12-19",0,0,1379,0,3,1390,0,0
"Oceania","2024-12-20",0,0,1379,0,3,1393,0,0
"Oceania","2024-12-21",0,0,1379,0,2,1395,0,0
"Oceania","2024-12-22",0,19,1398,0,3,1398,0,0
"Oceania","2024-12-23",0,0,1398,0,2,1400,0,0
"Oceania","2024-12-24",0,0,1398,0,2,1402,0,0
"Oceania","2024-12-25",0,0,1398,0,2,1404,0,0
"Oceania","2024-12-26",0,0,1398,0,1,1405,0,0
"Oceania","2024-12-27",0,0,1398,0,2,1407,0,0
"Oceania","2024-12-28",0,0,1398,0,2,1409,0,0
"Oceania","2024-12-29",0,13,1411,0,2,1411,0,0
"Oceania","2024-12-30",0,0,1411,0,2,1413,0,0
"Oceania","2024-12-31",0,0,1411,0,1,1414,0,0
"Oceania","2025-01-01",0,0,1411,0,2,1416,0,0
"Oceania","2025-01-02",0,0,1411,0,2,1418,0,0
"Oceania","2025-01-03",0,0,1411,0,2,1420,0,0
"Oceania","2025-01-04",0,0,1411,0,1,1421,0,0
"Oceania","2025-01-05",0,12,1423,0,2,1423,0,0
"Oceania","2025-01-06",0,0,1423,0,4,1427,0,0
"Oceania","2025-01-07",0,0,1423,0,4,1431,0,0
"Oceania","2025-01-08",0,0,1423,0,4,1435,0,0
"Oceania","2025-01-09",0,0,1423,0,3,1438,0,0
"Oceania","2025-01-10",0,0,1423,0,4,1442,0,0
"Oceania","2025-01-11",0,0,1423,0,4,1446,0,0
"Oceania","2025-01-12",0,27,1450,0,4,1450,0,0
"Oceania","2025-01-13",0,0,1450,0,5,1455,0,0
"Oceania","2025-01-14",0,0,1450,0,4,1459,0,0
"Oceania","2025-01-15",0,0,1450,0,5,1464,0,0
"Oceania","2025-01-16",0,0,1450,0,4,1468,0,0
"Oceania","2025-01-17",0,0,1450,0,5,1473,0,0
"Oceania","2025-01-18",0,0,1450,0,4,1477,0,0
"Oceania","2025-01-19",0,32,1482,0,5,1482,0,0
"Oceania","2025-01-20",0,0,1482,0,0,1482,0,0
"Oceania","2025-01-21",0,0,1482,0,0,1482,0,0
"Oceania","2025-01-22",0,0,1482,0,0,1482,0,0
"Oceania","2025-01-23",0,0,1482,0,0,1482,0,0
"Oceania","2025-01-24",0,0,1482,0,0,1482,0,0
"Oceania","2025-01-25",0,0,1482,0,0,1482,0,0
"Oceania","2025-01-26",0,0,1482,0,0,1482,0,0
"Oceania","2025-01-27",0,0,1482,0,0,1482,0,0
"Oceania","2025-01-28",0,0,1482,0,0,1482,0,0
"Oceania","2025-01-29",0,0,1482,0,0,1482,0,0
"Oceania","2025-01-30",0,0,1482,0,0,1482,0,0
"Oceania","2025-01-31",0,0,1482,0,0,1482,0,0
"Oceania","2025-02-01",0,0,1482,0,0,1482,0,0
"Oceania","2025-02-02",0,0,1482,0,0,1482,0,0
"Oceania","2025-02-03",0,0,1482,0,0,1482,0,0
"Oman","2024-01-01",0,0,0,0,0,0,0,0
"Oman","2024-01-02",0,0,0,0,0,0,0,0
"Oman","2024-01-03",0,0,0,0,0,0,0,0
"Oman","2024-01-04",0,0,0,0,0,0,0,0
"Oman","2024-01-05",0,0,0,0,0,0,0,0
"Oman","2024-01-06",0,0,0,0,0,0,0,0
"Oman","2024-01-07",0,0,0,0,0,0,0,0
"Oman","2024-01-08",0,0,0,0,0,0,0,0
"Oman","2024-01-09",0,0,0,0,0,0,0,0
"Oman","2024-01-10",0,0,0,0,0,0,0,0
"Oman","2024-01-11",0,0,0,0,0,0,0,0
"Oman","2024-01-12",0,0,0,0,0,0,0,0
"Oman","2024-01-13",0,0,0,0,0,0,0,0
"Oman","2024-01-14",0,0,0,0,0,0,0,0
"Oman","2024-01-15",0,0,0,0,0,0,0,0
"Oman","2024-01-16",0,0,0,0,0,0,0,0
"Oman","2024-01-17",0,0,0,0,0,0,0,0
"Oman","2024-01-18",0,0,0,0,0,0,0,0
"Oman","2024-01-19",0,0,0,0,0,0,0,0
"Oman","2024-01-20",0,0,0,0,0,0,0,0
"Oman","2024-01-21",0,0,0,0,0,0,0,0
"Oman","2024-01-22",0,0,0,0,0,0,0,0
"Oman","2024-01-23",0,0,0,0,0,0,0,0
"Oman","2024-01-24",0,0,0,0,0,0,0,0
"Oman","2024-01-25",0,0,0,0,0,0,0,0
"Oman","2024-01-26",0,0,0,0,0,0,0,0
"Oman","2024-01-27",0,0,0,0,0,0,0,0
"Oman","2024-01-28",0,0,0,0,0,0,0,0
"Oman","2024-01-29",0,0,0,0,0,0,0,0
"Oman","2024-01-30",0,0,0,0,0,0,0,0
"Oman","2024-01-31",0,0,0,0,0,0,0,0
"Oman","2024-02-01",0,0,0,0,0,0,0,0
"Oman","2024-02-02",0,0,0,0,0,0,0,0
"Oman","2024-02-03",0,0,0,0,0,0,0,0
"Oman","2024-02-04",0,0,0,0,0,0,0,0
"Oman","2024-02-05",0,0,0,0,0,0,0,0
"Oman","2024-02-06",0,0,0,0,0,0,0,0
"Oman","2024-02-07",0,0,0,0,0,0,0,0
"Oman","2024-02-08",0,0,0,0,0,0,0,0
"Oman","2024-02-09",0,0,0,0,0,0,0,0
"Oman","2024-02-10",0,0,0,0,0,0,0,0
"Oman","2024-02-11",0,0,0,0,0,0,0,0
"Oman","2024-02-12",0,0,0,0,0,0,0,0
"Oman","2024-02-13",0,0,0,0,0,0,0,0
"Oman","2024-02-14",0,0,0,0,0,0,0,0
"Oman","2024-02-15",0,0,0,0,0,0,0,0
"Oman","2024-02-16",0,0,0,0,0,0,0,0
"Oman","2024-02-17",0,0,0,0,0,0,0,0
"Oman","2024-02-18",0,0,0,0,0,0,0,0
"Oman","2024-02-19",0,0,0,0,0,0,0,0
"Oman","2024-02-20",0,0,0,0,0,0,0,0
"Oman","2024-02-21",0,0,0,0,0,0,0,0
"Oman","2024-02-22",0,0,0,0,0,0,0,0
"Oman","2024-02-23",0,0,0,0,0,0,0,0
"Oman","2024-02-24",0,0,0,0,0,0,0,0
"Oman","2024-02-25",0,0,0,0,0,0,0,0
"Oman","2024-02-26",0,0,0,0,0,0,0,0
"Oman","2024-02-27",0,0,0,0,0,0,0,0
"Oman","2024-02-28",0,0,0,0,0,0,0,0
"Oman","2024-02-29",0,0,0,0,0,0,0,0
"Oman","2024-03-01",0,0,0,0,0,0,0,0
"Oman","2024-03-02",0,0,0,0,0,0,0,0
"Oman","2024-03-03",0,0,0,0,0,0,0,0
"Oman","2024-03-04",0,0,0,0,0,0,0,0
"Oman","2024-03-05",0,0,0,0,0,0,0,0
"Oman","2024-03-06",0,0,0,0,0,0,0,0
"Oman","2024-03-07",0,0,0,0,0,0,0,0
"Oman","2024-03-08",0,0,0,0,0,0,0,0
"Oman","2024-03-09",0,0,0,0,0,0,0,0
"Oman","2024-03-10",0,0,0,0,0,0,0,0
"Oman","2024-03-11",0,0,0,0,0,0,0,0
"Oman","2024-03-12",0,0,0,0,0,0,0,0
"Oman","2024-03-13",0,0,0,0,0,0,0,0
"Oman","2024-03-14",0,0,0,0,0,0,0,0
"Oman","2024-03-15",0,0,0,0,0,0,0,0
"Oman","2024-03-16",0,0,0,0,0,0,0,0
"Oman","2024-03-17",0,0,0,0,0,0,0,0
"Oman","2024-03-18",0,0,0,0,0,0,0,0
"Oman","2024-03-19",0,0,0,0,0,0,0,0
"Oman","2024-03-20",0,0,0,0,0,0,0,0
"Oman","2024-03-21",0,0,0,0,0,0,0,0
"Oman","2024-03-22",0,0,0,0,0,0,0,0
"Oman","2024-03-23",0,0,0,0,0,0,0,0
"Oman","2024-03-24",0,0,0,0,0,0,0,0
"Oman","2024-03-25",0,0,0,0,0,0,0,0
"Oman","2024-03-26",0,0,0,0,0,0,0,0
"Oman","2024-03-27",0,0,0,0,0,0,0,0
"Oman","2024-03-28",0,0,0,0,0,0,0,0
"Oman","2024-03-29",0,0,0,0,0,0,0,0
"Oman","2024-03-30",0,0,0,0,0,0,0,0
"Oman","2024-03-31",0,0,0,0,0,0,0,0
"Oman","2024-04-01",0,0,0,0,0,0,0,0
"Oman","2024-04-02",0,0,0,0,0,0,0,0
"Oman","2024-04-03",0,0,0,0,0,0,0,0
"Oman","2024-04-04",0,0,0,0,0,0,0,0
"Oman","2024-04-05",0,0,0,0,0,0,0,0
"Oman","2024-04-06",0,0,0,0,0,0,0,0
"Oman","2024-04-07",0,0,0,0,0,0,0,0
"Oman","2024-04-08",0,0,0,0,0,0,0,0
"Oman","2024-04-09",0,0,0,0,0,0,0,0
"Oman","2024-04-10",0,0,0,0,0,0,0,0
"Oman","2024-04-11",0,0,0,0,0,0,0,0
"Oman","2024-04-12",0,0,0,0,0,0,0,0
"Oman","2024-04-13",0,0,0,0,0,0,0,0
"Oman","2024-04-14",0,0,0,0,0,0,0,0
"Oman","2024-04-15",0,0,0,0,0,0,0,0
"Oman","2024-04-16",0,0,0,0,0,0,0,0
"Oman","2024-04-17",0,0,0,0,0,0,0,0
"Oman","2024-04-18",0,0,0,0,0,0,0,0
"Oman","2024-04-19",0,0,0,0,0,0,0,0
"Oman","2024-04-20",0,0,0,0,0,0,0,0
"Oman","2024-04-21",0,0,0,0,0,0,0,0
"Oman","2024-04-22",0,0,0,0,0,0,0,0
"Oman","2024-04-23",0,0,0,0,0,0,0,0
"Oman","2024-04-24",0,0,0,0,0,0,0,0
"Oman","2024-04-25",0,0,0,0,0,0,0,0
"Oman","2024-04-26",0,0,0,0,0,0,0,0
"Oman","2024-04-27",0,0,0,0,0,0,0,0
"Oman","2024-04-28",0,0,0,0,0,0,0,0
"Oman","2024-04-29",0,0,0,0,0,0,0,0
"Oman","2024-04-30",0,0,0,0,0,0,0,0
"Oman","2024-05-01",0,0,0,0,0,0,0,0
"Oman","2024-05-02",0,0,0,0,0,0,0,0
"Oman","2024-05-03",0,0,0,0,0,0,0,0
"Oman","2024-05-04",0,0,0,0,0,0,0,0
"Oman","2024-05-05",0,0,0,0,0,0,0,0
"Oman","2024-05-06",0,0,0,0,0,0,0,0
"Oman","2024-05-07",0,0,0,0,0,0,0,0
"Oman","2024-05-08",0,0,0,0,0,0,0,0
"Oman","2024-05-09",0,0,0,0,0,0,0,0
"Oman","2024-05-10",0,0,0,0,0,0,0,0
"Oman","2024-05-11",0,0,0,0,0,0,0,0
"Oman","2024-05-12",0,0,0,0,0,0,0,0
"Oman","2024-05-13",0,0,0,0,0,0,0,0
"Oman","2024-05-14",0,0,0,0,0,0,0,0
"Oman","2024-05-15",0,0,0,0,0,0,0,0
"Oman","2024-05-16",0,0,0,0,0,0,0,0
"Oman","2024-05-17",0,0,0,0,0,0,0,0
"Oman","2024-05-18",0,0,0,0,0,0,0,0
"Oman","2024-05-19",0,0,0,0,0,0,0,0
"Oman","2024-05-20",0,0,0,0,0,0,0,0
"Oman","2024-05-21",0,0,0,0,0,0,0,0
"Oman","2024-05-22",0,0,0,0,0,0,0,0
"Oman","2024-05-23",0,0,0,0,0,0,0,0
"Oman","2024-05-24",0,0,0,0,0,0,0,0
"Oman","2024-05-25",0,0,0,0,0,0,0,0
"Oman","2024-05-26",0,0,0,0,0,0,0,0
"Oman","2024-05-27",0,0,0,0,0,0,0,0
"Oman","2024-05-28",0,0,0,0,0,0,0,0
"Oman","2024-05-29",0,0,0,0,0,0,0,0
"Oman","2024-05-30",0,0,0,0,0,0,0,0
"Oman","2024-05-31",0,0,0,0,0,0,0,0
"Oman","2024-06-01",0,0,0,0,0,0,0,0
"Oman","2024-06-02",0,0,0,0,0,0,0,0
"Oman","2024-06-03",0,0,0,0,0,0,0,0
"Oman","2024-06-04",0,0,0,0,0,0,0,0
"Oman","2024-06-05",0,0,0,0,0,0,0,0
"Oman","2024-06-06",0,0,0,0,0,0,0,0
"Oman","2024-06-07",0,0,0,0,0,0,0,0
"Oman","2024-06-08",0,0,0,0,0,0,0,0
"Oman","2024-06-09",0,0,0,0,0,0,0,0
"Oman","2024-06-10",0,0,0,0,0,0,0,0
"Oman","2024-06-11",0,0,0,0,0,0,0,0
"Oman","2024-06-12",0,0,0,0,0,0,0,0
"Oman","2024-06-13",0,0,0,0,0,0,0,0
"Oman","2024-06-14",0,0,0,0,0,0,0,0
"Oman","2024-06-15",0,0,0,0,0,0,0,0
"Oman","2024-06-16",0,0,0,0,0,0,0,0
"Oman","2024-06-17",0,0,0,0,0,0,0,0
"Oman","2024-06-18",0,0,0,0,0,0,0,0
"Oman","2024-06-19",0,0,0,0,0,0,0,0
"Oman","2024-06-20",0,0,0,0,0,0,0,0
"Oman","2024-06-21",0,0,0,0,0,0,0,0
"Oman","2024-06-22",0,0,0,0,0,0,0,0
"Oman","2024-06-23",0,0,0,0,0,0,0,0
"Oman","2024-06-24",0,0,0,0,0,0,0,0
"Oman","2024-06-25",0,0,0,0,0,0,0,0
"Oman","2024-06-26",0,0,0,0,0,0,0,0
"Oman","2024-06-27",0,0,0,0,0,0,0,0
"Oman","2024-06-28",0,0,0,0,0,0,0,0
"Oman","2024-06-29",0,0,0,0,0,0,0,0
"Oman","2024-06-30",0,0,0,0,0,0,0,0
"Oman","2024-07-01",0,0,0,0,0,0,0,0
"Oman","2024-07-02",0,0,0,0,0,0,0,0
"Oman","2024-07-03",0,0,0,0,0,0,0,0
"Oman","2024-07-04",0,0,0,0,0,0,0,0
"Oman","2024-07-05",0,0,0,0,0,0,0,0
"Oman","2024-07-06",0,0,0,0,0,0,0,0
"Oman","2024-07-07",0,0,0,0,0,0,0,0
"Oman","2024-07-08",0,0,0,0,0,0,0,0
"Oman","2024-07-09",0,0,0,0,0,0,0,0
"Oman","2024-07-10",0,0,0,0,0,0,0,0
"Oman","2024-07-11",0,0,0,0,0,0,0,0
"Oman","2024-07-12",0,0,0,0,0,0,0,0
"Oman","2024-07-13",0,0,0,0,0,0,0,0
"Oman","2024-07-14",0,0,0,0,0,0,0,0
"Oman","2024-07-15",0,0,0,0,0,0,0,0
"Oman","2024-07-16",0,0,0,0,0,0,0,0
"Oman","2024-07-17",0,0,0,0,0,0,0,0
"Oman","2024-07-18",0,0,0,0,0,0,0,0
"Oman","2024-07-19",0,0,0,0,0,0,0,0
"Oman","2024-07-20",0,0,0,0,0,0,0,0
"Oman","2024-07-21",0,0,0,0,0,0,0,0
"Oman","2024-07-22",0,0,0,0,0,0,0,0
"Oman","2024-07-23",0,0,0,0,0,0,0,0
"Oman","2024-07-24",0,0,0,0,0,0,0,0
"Oman","2024-07-25",0,0,0,0,0,0,0,0
"Oman","2024-07-26",0,0,0,0,0,0,0,0
"Oman","2024-07-27",0,0,0,0,0,0,0,0
"Oman","2024-07-28",0,0,0,0,0,0,0,0
"Oman","2024-07-29",0,0,0,0,0,0,0,0
"Oman","2024-07-30",0,0,0,0,0,0,0,0
"Oman","2024-07-31",0,0,0,0,0,0,0,0
"Oman","2024-08-01",0,0,0,0,0,0,0,0
"Oman","2024-08-02",0,0,0,0,0,0,0,0
"Oman","2024-08-03",0,0,0,0,0,0,0,0
"Oman","2024-08-04",0,0,0,0,0,0,0,0
"Oman","2024-08-05",0,0,0,0,0,0,0,0
"Oman","2024-08-06",0,0,0,0,0,0,0,0
"Oman","2024-08-07",0,0,0,0,0,0,0,0
"Oman","2024-08-08",0,0,0,0,0,0,0,0
"Oman","2024-08-09",0,0,0,0,0,0,0,0
"Oman","2024-08-10",0,0,0,0,0,0,0,0
"Oman","2024-08-11",0,0,0,0,0,0,0,0
"Oman","2024-08-12",0,0,0,0,0,0,0,0
"Oman","2024-08-13",0,0,0,0,0,0,0,0
"Oman","2024-08-14",0,0,0,0,0,0,0,0
"Oman","2024-08-15",0,0,0,0,0,0,0,0
"Oman","2024-08-16",0,0,0,0,0,0,0,0
"Oman","2024-08-17",0,0,0,0,0,0,0,0
"Oman","2024-08-18",0,0,0,0,0,0,0,0
"Oman","2024-08-19",0,0,0,0,0,0,0,0
"Oman","2024-08-20",0,0,0,0,0,0,0,0
"Oman","2024-08-21",0,0,0,0,0,0,0,0
"Oman","2024-08-22",0,0,0,0,0,0,0,0
"Oman","2024-08-23",0,0,0,0,0,0,0,0
"Oman","2024-08-24",0,0,0,0,0,0,0,0
"Oman","2024-08-25",0,0,0,0,0,0,0,0
"Oman","2024-08-26",0,0,0,0,0,0,0,0
"Oman","2024-08-27",0,0,0,0,0,0,0,0
"Oman","2024-08-28",0,0,0,0,0,0,0,0
"Oman","2024-08-29",0,0,0,0,0,0,0,0
"Oman","2024-08-30",0,0,0,0,0,0,0,0
"Oman","2024-08-31",0,0,0,0,0,0,0,0
"Oman","2024-09-01",0,0,0,0,0,0,0,0
"Oman","2024-09-02",0,0,0,0,0,0,0,0
"Oman","2024-09-03",0,0,0,0,0,0,0,0
"Oman","2024-09-04",0,0,0,0,0,0,0,0
"Oman","2024-09-05",0,0,0,0,0,0,0,0
"Oman","2024-09-06",0,0,0,0,0,0,0,0
"Oman","2024-09-07",0,0,0,0,0,0,0,0
"Oman","2024-09-08",0,0,0,0,0,0,0,0
"Oman","2024-09-09",0,0,0,0,0,0,0,0
"Oman","2024-09-10",0,0,0,0,0,0,0,0
"Oman","2024-09-11",0,0,0,0,0,0,0,0
"Oman","2024-09-12",0,0,0,0,0,0,0,0
"Oman","2024-09-13",0,0,0,0,0,0,0,0
"Oman","2024-09-14",0,0,0,0,0,0,0,0
"Oman","2024-09-15",0,0,0,0,0,0,0,0
"Oman","2024-09-16",0,0,0,0,0,0,0,0
"Oman","2024-09-17",0,0,0,0,0,0,0,0
"Oman","2024-09-18",0,0,0,0,0,0,0,0
"Oman","2024-09-19",0,0,0,0,0,0,0,0
"Oman","2024-09-20",0,0,0,0,0,0,0,0
"Oman","2024-09-21",0,0,0,0,0,0,0,0
"Oman","2024-09-22",0,0,0,0,0,0,0,0
"Oman","2024-09-23",0,0,0,0,0,0,0,0
"Oman","2024-09-24",0,0,0,0,0,0,0,0
"Oman","2024-09-25",0,0,0,0,0,0,0,0
"Oman","2024-09-26",0,0,0,0,0,0,0,0
"Oman","2024-09-27",0,0,0,0,0,0,0,0
"Oman","2024-09-28",0,0,0,0,0,0,0,0
"Oman","2024-09-29",0,0,0,0,0,0,0,0
"Oman","2024-09-30",0,0,0,0,0,0,0,0
"Oman","2024-10-01",0,0,0,0,0,0,0,0
"Oman","2024-10-02",0,1,1,0,1,1,0,0
"Oman","2024-10-03",0,0,1,0,0,1,0,0
"Oman","2024-10-04",0,0,1,0,0,1,0,0
"Oman","2024-10-05",0,0,1,0,0,1,0,0
"Oman","2024-10-06",0,0,1,0,0,1,0,0
"Oman","2024-10-07",0,0,1,0,0,1,0,0
"Oman","2024-10-08",0,0,1,0,0,1,0,0
"Oman","2024-10-09",0,0,1,0,0,1,0,0
"Oman","2024-10-10",0,0,1,0,0,1,0,0
"Oman","2024-10-11",0,0,1,0,0,1,0,0
"Oman","2024-10-12",0,0,1,0,0,1,0,0
"Oman","2024-10-13",0,0,1,0,0,1,0,0
"Oman","2024-10-14",0,0,1,0,0,1,0,0
"Oman","2024-10-15",0,0,1,0,0,1,0,0
"Oman","2024-10-16",0,0,1,0,0,1,0,0
"Oman","2024-10-17",0,0,1,0,0,1,0,0
"Oman","2024-10-18",0,0,1,0,0,1,0,0
"Oman","2024-10-19",0,0,1,0,0,1,0,0
"Oman","2024-10-20",0,0,1,0,0,1,0,0
"Oman","2024-10-21",0,0,1,0,0,1,0,0
"Oman","2024-10-22",0,0,1,0,0,1,0,0
"Oman","2024-10-23",0,0,1,0,0,1,0,0
"Oman","2024-10-24",0,0,1,0,0,1,0,0
"Oman","2024-10-25",0,0,1,0,0,1,0,0
"Oman","2024-10-26",0,0,1,0,0,1,0,0
"Oman","2024-10-27",0,0,1,0,0,1,0,0
"Oman","2024-10-28",0,0,1,0,0,1,0,0
"Oman","2024-10-29",0,0,1,0,0,1,0,0
"Oman","2024-10-30",0,0,1,0,0,1,0,0
"Oman","2024-10-31",0,0,1,0,0,1,0,0
"Oman","2024-11-01",0,0,1,0,0,1,0,0
"Oman","2024-11-02",0,0,1,0,0,1,0,0
"Oman","2024-11-03",0,0,1,0,0,1,0,0
"Oman","2024-11-04",0,0,1,0,0,1,0,0
"Oman","2024-11-05",0,0,1,0,0,1,0,0
"Oman","2024-11-06",0,0,1,0,1,2,0,0
"Oman","2024-11-07",0,0,1,0,0,2,0,0
"Oman","2024-11-08",0,0,1,0,0,2,0,0
"Oman","2024-11-09",0,0,1,0,0,2,0,0
"Oman","2024-11-10",0,0,1,0,0,2,0,0
"Oman","2024-11-11",0,0,1,0,0,2,0,0
"Oman","2024-11-12",0,0,1,0,0,2,0,0
"Oman","2024-11-13",0,0,1,0,0,2,0,0
"Oman","2024-11-14",0,0,1,0,0,2,0,0
"Oman","2024-11-15",0,0,1,0,0,2,0,0
"Oman","2024-11-16",0,0,1,0,0,2,0,0
"Oman","2024-11-17",0,0,1,0,0,2,0,0
"Oman","2024-11-18",0,0,1,0,0,2,0,0
"Oman","2024-11-19",0,0,1,0,0,2,0,0
"Oman","2024-11-20",0,0,1,0,0,2,0,0
"Oman","2024-11-21",0,0,1,0,0,2,0,0
"Oman","2024-11-22",0,0,1,0,0,2,0,0
"Oman","2024-11-23",0,0,1,0,0,2,0,0
"Oman","2024-11-24",0,0,1,0,0,2,0,0
"Oman","2024-11-25",0,0,1,0,0,2,0,0
"Oman","2024-11-26",0,0,1,0,0,2,0,0
"Oman","2024-11-27",0,0,1,0,0,2,0,0
"Oman","2024-11-28",0,0,1,0,0,2,0,0
"Oman","2024-11-29",0,0,1,0,0,2,0,0
"Oman","2024-11-30",0,0,1,0,0,2,0,0
"Oman","2024-12-01",0,0,1,0,0,2,0,0
"Oman","2024-12-02",0,0,1,0,0,2,0,0
"Oman","2024-12-03",0,0,1,0,0,2,0,0
"Oman","2024-12-04",0,0,1,0,0,2,0,0
"Oman","2024-12-05",0,0,1,0,0,2,0,0
"Oman","2024-12-06",0,0,1,0,0,2,0,0
"Oman","2024-12-07",0,0,1,0,0,2,0,0
"Oman","2024-12-08",0,0,1,0,0,2,0,0
"Oman","2024-12-09",0,1,2,0,0,2,0,0
"Oman","2024-12-10",0,0,2,0,0,2,0,0
"Oman","2024-12-11",0,0,2,0,0,2,0,0
"Oman","2024-12-12",0,0,2,0,0,2,0,0
"Oman","2024-12-13",0,0,2,0,0,2,0,0
"Oman","2024-12-14",0,0,2,0,0,2,0,0
"Oman","2024-12-15",0,0,2,0,0,2,0,0
"Oman","2024-12-16",0,0,2,0,0,2,0,0
"Oman","2024-12-17",0,0,2,0,0,2,0,0
"Oman","2024-12-18",0,0,2,0,0,2,0,0
"Oman","2024-12-19",0,0,2,0,0,2,0,0
"Oman","2024-12-20",0,0,2,0,0,2,0,0
"Oman","2024-12-21",0,0,2,0,0,2,0,0
"Oman","2024-12-22",0,0,2,0,0,2,0,0
"Oman","2024-12-23",0,0,2,0,0,2,0,0
"Oman","2024-12-24",0,0,2,0,0,2,0,0
"Oman","2024-12-25",0,0,2,0,0,2,0,0
"Oman","2024-12-26",0,0,2,0,0,2,0,0
"Oman","2024-12-27",0,0,2,0,0,2,0,0
"Oman","2024-12-28",0,0,2,0,0,2,0,0
"Oman","2024-12-29",0,0,2,0,0,2,0,0
"Oman","2024-12-30",0,0,2,0,0,2,0,0
"Oman","2024-12-31",0,0,2,0,0,2,0,0
"Oman","2025-01-01",0,0,2,0,0,2,0,0
"Oman","2025-01-02",0,0,2,0,0,2,0,0
"Oman","2025-01-03",0,0,2,0,0,2,0,0
"Oman","2025-01-04",0,0,2,0,0,2,0,0
"Oman","2025-01-05",0,0,2,0,0,2,0,0
"Oman","2025-01-06",0,0,2,0,0,2,0,0
"Oman","2025-01-07",0,0,2,0,0,2,0,0
"Oman","2025-01-08",0,0,2,0,0,2,0,0
"Oman","2025-01-09",0,0,2,0,0,2,0,0
"Oman","2025-01-10",0,0,2,0,0,2,0,0
"Oman","2025-01-11",0,0,2,0,0,2,0,0
"Oman","2025-01-12",0,0,2,0,0,2,0,0
"Oman","2025-01-13",0,0,2,0,0,2,0,0
"Oman","2025-01-14",0,0,2,0,0,2,0,0
"Oman","2025-01-15",0,0,2,0,0,2,0,0
"Oman","2025-01-16",0,0,2,0,0,2,0,0
"Oman","2025-01-17",0,0,2,0,0,2,0,0
"Oman","2025-01-18",0,0,2,0,0,2,0,0
"Oman","2025-01-19",0,0,2,0,0,2,0,0
"Oman","2025-01-20",0,0,2,0,0,2,0,0
"Oman","2025-01-21",0,0,2,0,0,2,0,0
"Oman","2025-01-22",0,0,2,0,0,2,0,0
"Oman","2025-01-23",0,0,2,0,0,2,0,0
"Oman","2025-01-24",0,0,2,0,0,2,0,0
"Oman","2025-01-25",0,0,2,0,0,2,0,0
"Oman","2025-01-26",0,0,2,0,0,2,0,0
"Oman","2025-01-27",0,0,2,0,0,2,0,0
"Oman","2025-01-28",0,0,2,0,0,2,0,0
"Oman","2025-01-29",0,0,2,0,0,2,0,0
"Oman","2025-01-30",0,0,2,0,0,2,0,0
"Oman","2025-01-31",0,0,2,0,0,2,0,0
"Oman","2025-02-01",0,0,2,0,0,2,0,0
"Oman","2025-02-02",0,0,2,0,0,2,0,0
"Oman","2025-02-03",0,0,2,0,0,2,0,0
"Pakistan","2024-01-01",0,0,0,0,0,0,0,0
"Pakistan","2024-01-02",0,0,0,0,0,0,0,0
"Pakistan","2024-01-03",0,0,0,0,0,0,0,0
"Pakistan","2024-01-04",0,0,0,0,0,0,0,0
"Pakistan","2024-01-05",0,0,0,0,0,0,0,0
"Pakistan","2024-01-06",0,0,0,0,0,0,0,0
"Pakistan","2024-01-07",0,0,0,0,0,0,0,0
"Pakistan","2024-01-08",0,0,0,0,0,0,0,0
"Pakistan","2024-01-09",0,0,0,0,0,0,0,0
"Pakistan","2024-01-10",0,0,0,0,0,0,0,0
"Pakistan","2024-01-11",0,0,0,0,0,0,0,0
"Pakistan","2024-01-12",0,0,0,0,0,0,0,0
"Pakistan","2024-01-13",0,0,0,0,0,0,0,0
"Pakistan","2024-01-14",0,0,0,0,0,0,0,0
"Pakistan","2024-01-15",0,0,0,0,0,0,0,0
"Pakistan","2024-01-16",0,0,0,0,0,0,0,0
"Pakistan","2024-01-17",0,0,0,0,0,0,0,0
"Pakistan","2024-01-18",0,0,0,0,0,0,0,0
"Pakistan","2024-01-19",0,1,1,0,1,1,0,0
"Pakistan","2024-01-20",0,0,1,0,0,1,0,0
"Pakistan","2024-01-21",0,0,1,0,0,1,0,0
"Pakistan","2024-01-22",0,0,1,0,0,1,0,0
"Pakistan","2024-01-23",0,0,1,0,0,1,0,0
"Pakistan","2024-01-24",0,0,1,0,0,1,0,0
"Pakistan","2024-01-25",0,0,1,0,0,1,0,0
"Pakistan","2024-01-26",0,0,1,0,0,1,0,0
"Pakistan","2024-01-27",0,0,1,0,0,1,0,0
"Pakistan","2024-01-28",0,0,1,0,0,1,0,0
"Pakistan","2024-01-29",0,0,1,0,0,1,0,0
"Pakistan","2024-01-30",0,0,1,0,0,1,0,0
"Pakistan","2024-01-31",0,0,1,0,0,1,0,0
"Pakistan","2024-02-01",0,0,1,0,0,1,0,0
"Pakistan","2024-02-02",0,0,1,0,0,1,0,0
"Pakistan","2024-02-03",0,0,1,0,0,1,0,0
"Pakistan","2024-02-04",0,0,1,0,0,1,0,0
"Pakistan","2024-02-05",0,0,1,0,0,1,0,0
"Pakistan","2024-02-06",0,0,1,0,0,1,0,0
"Pakistan","2024-02-07",0,0,1,0,0,1,0,0
"Pakistan","2024-02-08",0,0,1,0,0,1,0,0
"Pakistan","2024-02-09",0,0,1,0,0,1,0,0
"Pakistan","2024-02-10",0,0,1,0,0,1,0,0
"Pakistan","2024-02-11",0,0,1,0,0,1,0,0
"Pakistan","2024-02-12",0,0,1,0,0,1,0,0
"Pakistan","2024-02-13",0,0,1,0,0,1,0,0
"Pakistan","2024-02-14",0,0,1,0,0,1,0,0
"Pakistan","2024-02-15",0,0,1,0,0,1,0,0
"Pakistan","2024-02-16",0,0,1,0,0,1,0,0
"Pakistan","2024-02-17",0,0,1,0,0,1,0,0
"Pakistan","2024-02-18",0,0,1,0,0,1,0,0
"Pakistan","2024-02-19",0,0,1,0,0,1,0,0
"Pakistan","2024-02-20",0,0,1,0,0,1,0,0
"Pakistan","2024-02-21",0,0,1,0,0,1,0,0
"Pakistan","2024-02-22",0,0,1,0,0,1,0,0
"Pakistan","2024-02-23",0,0,1,0,0,1,0,0
"Pakistan","2024-02-24",0,0,1,0,0,1,0,0
"Pakistan","2024-02-25",0,0,1,0,0,1,0,0
"Pakistan","2024-02-26",0,0,1,0,0,1,0,0
"Pakistan","2024-02-27",0,0,1,0,0,1,0,0
"Pakistan","2024-02-28",0,0,1,0,0,1,0,0
"Pakistan","2024-02-29",0,0,1,0,0,1,0,0
"Pakistan","2024-03-01",0,0,1,0,0,1,0,0
"Pakistan","2024-03-02",0,0,1,0,0,1,0,0
"Pakistan","2024-03-03",0,0,1,0,0,1,0,0
"Pakistan","2024-03-04",0,0,1,0,0,1,0,0
"Pakistan","2024-03-05",0,0,1,0,0,1,0,0
"Pakistan","2024-03-06",0,0,1,0,0,1,0,0
"Pakistan","2024-03-07",0,0,1,0,0,1,0,0
"Pakistan","2024-03-08",0,0,1,0,0,1,0,0
"Pakistan","2024-03-09",0,0,1,0,0,1,0,0
"Pakistan","2024-03-10",0,0,1,0,0,1,0,0
"Pakistan","2024-03-11",0,0,1,0,0,1,0,0
"Pakistan","2024-03-12",0,0,1,0,0,1,0,0
"Pakistan","2024-03-13",0,0,1,0,0,1,0,0
"Pakistan","2024-03-14",0,0,1,0,0,1,0,0
"Pakistan","2024-03-15",0,0,1,0,0,1,0,0
"Pakistan","2024-03-16",0,0,1,0,0,1,0,0
"Pakistan","2024-03-17",0,0,1,0,0,1,0,0
"Pakistan","2024-03-18",0,0,1,0,0,1,0,0
"Pakistan","2024-03-19",0,0,1,0,0,1,0,0
"Pakistan","2024-03-20",0,0,1,0,0,1,0,0
"Pakistan","2024-03-21",0,0,1,0,0,1,0,0
"Pakistan","2024-03-22",0,0,1,0,0,1,0,0
"Pakistan","2024-03-23",0,0,1,0,0,1,0,0
"Pakistan","2024-03-24",0,0,1,0,0,1,0,0
"Pakistan","2024-03-25",0,0,1,0,0,1,0,0
"Pakistan","2024-03-26",0,0,1,0,0,1,0,0
"Pakistan","2024-03-27",0,0,1,0,0,1,0,0
"Pakistan","2024-03-28",0,0,1,0,0,1,0,0
"Pakistan","2024-03-29",0,0,1,0,0,1,0,0
"Pakistan","2024-03-30",0,0,1,0,0,1,0,0
"Pakistan","2024-03-31",0,0,1,0,0,1,0,0
"Pakistan","2024-04-01",0,0,1,0,0,1,0,0
"Pakistan","2024-04-02",0,0,1,0,0,1,0,0
"Pakistan","2024-04-03",0,0,1,0,0,1,0,0
"Pakistan","2024-04-04",0,0,1,0,0,1,0,0
"Pakistan","2024-04-05",0,0,1,0,0,1,0,0
"Pakistan","2024-04-06",0,0,1,0,0,1,0,0
"Pakistan","2024-04-07",0,0,1,0,0,1,0,0
"Pakistan","2024-04-08",0,0,1,0,0,1,0,0
"Pakistan","2024-04-09",0,0,1,0,0,1,0,0
"Pakistan","2024-04-10",0,0,1,0,0,1,0,0
"Pakistan","2024-04-11",0,0,1,0,0,1,0,0
"Pakistan","2024-04-12",0,0,1,0,0,1,0,0
"Pakistan","2024-04-13",0,0,1,0,0,1,0,0
"Pakistan","2024-04-14",0,0,1,0,0,1,0,0
"Pakistan","2024-04-15",0,0,1,0,0,1,0,0
"Pakistan","2024-04-16",0,0,1,0,0,1,0,0
"Pakistan","2024-04-17",0,0,1,0,0,1,0,0
"Pakistan","2024-04-18",0,0,1,0,0,1,0,0
"Pakistan","2024-04-19",0,0,1,0,0,1,0,0
"Pakistan","2024-04-20",0,0,1,0,0,1,0,0
"Pakistan","2024-04-21",0,0,1,0,0,1,0,0
"Pakistan","2024-04-22",0,0,1,0,0,1,0,0
"Pakistan","2024-04-23",0,0,1,0,0,1,0,0
"Pakistan","2024-04-24",0,0,1,0,0,1,0,0
"Pakistan","2024-04-25",0,0,1,0,0,1,0,0
"Pakistan","2024-04-26",0,0,1,0,0,1,0,0
"Pakistan","2024-04-27",0,0,1,0,0,1,0,0
"Pakistan","2024-04-28",0,0,1,0,0,1,0,0
"Pakistan","2024-04-29",0,0,1,0,0,1,0,0
"Pakistan","2024-04-30",0,0,1,0,0,1,0,0
"Pakistan","2024-05-01",0,0,1,0,0,1,0,0
"Pakistan","2024-05-02",0,0,1,0,0,1,0,0
"Pakistan","2024-05-03",0,0,1,0,1,2,0,0
"Pakistan","2024-05-04",0,0,1,0,0,2,0,0
"Pakistan","2024-05-05",0,0,1,0,0,2,0,0
"Pakistan","2024-05-06",0,0,1,0,0,2,0,0
"Pakistan","2024-05-07",0,0,1,0,0,2,0,0
"Pakistan","2024-05-08",0,0,1,0,0,2,0,0
"Pakistan","2024-05-09",0,0,1,0,0,2,0,0
"Pakistan","2024-05-10",0,0,1,0,0,2,0,0
"Pakistan","2024-05-11",0,0,1,0,0,2,0,0
"Pakistan","2024-05-12",0,0,1,0,0,2,0,0
"Pakistan","2024-05-13",0,0,1,0,0,2,0,0
"Pakistan","2024-05-14",0,0,1,0,0,2,0,0
"Pakistan","2024-05-15",0,0,1,0,0,2,0,0
"Pakistan","2024-05-16",0,0,1,0,0,2,0,0
"Pakistan","2024-05-17",0,0,1,0,0,2,0,0
"Pakistan","2024-05-18",0,0,1,0,0,2,0,0
"Pakistan","2024-05-19",0,0,1,0,0,2,0,0
"Pakistan","2024-05-20",0,0,1,0,0,2,0,0
"Pakistan","2024-05-21",0,0,1,0,0,2,0,0
"Pakistan","2024-05-22",0,0,1,0,0,2,0,0
"Pakistan","2024-05-23",0,0,1,0,0,2,0,0
"Pakistan","2024-05-24",0,0,1,0,0,2,0,0
"Pakistan","2024-05-25",0,0,1,0,0,2,0,0
"Pakistan","2024-05-26",0,0,1,0,0,2,0,0
"Pakistan","2024-05-27",0,0,1,0,0,2,0,0
"Pakistan","2024-05-28",0,0,1,0,0,2,0,0
"Pakistan","2024-05-29",0,0,1,0,0,2,0,0
"Pakistan","2024-05-30",0,0,1,0,0,2,0,0
"Pakistan","2024-05-31",0,0,1,0,0,2,0,0
"Pakistan","2024-06-01",0,0,1,0,0,2,0,0
"Pakistan","2024-06-02",0,0,1,0,0,2,0,0
"Pakistan","2024-06-03",0,0,1,0,0,2,0,0
"Pakistan","2024-06-04",0,0,1,0,0,2,0,0
"Pakistan","2024-06-05",0,0,1,0,0,2,0,0
"Pakistan","2024-06-06",0,0,1,0,0,2,0,0
"Pakistan","2024-06-07",0,0,1,0,0,2,0,0
"Pakistan","2024-06-08",0,0,1,0,0,2,0,0
"Pakistan","2024-06-09",0,0,1,0,0,2,0,0
"Pakistan","2024-06-10",0,0,1,0,0,2,0,0
"Pakistan","2024-06-11",0,0,1,0,0,2,0,0
"Pakistan","2024-06-12",0,0,1,0,0,2,0,0
"Pakistan","2024-06-13",0,0,1,0,0,2,0,0
"Pakistan","2024-06-14",0,0,1,0,0,2,0,0
"Pakistan","2024-06-15",0,0,1,0,0,2,0,0
"Pakistan","2024-06-16",0,0,1,0,0,2,0,0
"Pakistan","2024-06-17",0,0,1,0,0,2,0,0
"Pakistan","2024-06-18",0,0,1,0,0,2,0,0
"Pakistan","2024-06-19",0,0,1,0,0,2,0,0
"Pakistan","2024-06-20",0,0,1,0,0,2,0,0
"Pakistan","2024-06-21",0,0,1,0,0,2,0,0
"Pakistan","2024-06-22",0,0,1,0,0,2,0,0
"Pakistan","2024-06-23",0,0,1,0,0,2,0,0
"Pakistan","2024-06-24",0,0,1,0,0,2,0,0
"Pakistan","2024-06-25",0,0,1,0,0,2,0,0
"Pakistan","2024-06-26",0,0,1,0,0,2,0,0
"Pakistan","2024-06-27",0,0,1,0,0,2,0,0
"Pakistan","2024-06-28",0,0,1,0,0,2,0,0
"Pakistan","2024-06-29",0,0,1,0,0,2,0,0
"Pakistan","2024-06-30",0,0,1,0,0,2,0,0
"Pakistan","2024-07-01",0,0,1,0,0,2,0,0
"Pakistan","2024-07-02",0,0,1,0,0,2,0,0
"Pakistan","2024-07-03",0,0,1,0,0,2,0,0
"Pakistan","2024-07-04",0,0,1,0,0,2,0,0
"Pakistan","2024-07-05",0,0,1,0,0,2,0,0
"Pakistan","2024-07-06",0,0,1,0,0,2,0,0
"Pakistan","2024-07-07",0,0,1,0,0,2,0,0
"Pakistan","2024-07-08",0,0,1,0,0,2,0,0
"Pakistan","2024-07-09",0,0,1,0,0,2,0,0
"Pakistan","2024-07-10",0,0,1,0,0,2,0,0
"Pakistan","2024-07-11",0,0,1,0,0,2,0,0
"Pakistan","2024-07-12",0,0,1,0,0,2,0,0
"Pakistan","2024-07-13",0,0,1,0,0,2,0,0
"Pakistan","2024-07-14",0,0,1,0,0,2,0,0
"Pakistan","2024-07-15",0,0,1,0,0,2,0,0
"Pakistan","2024-07-16",0,0,1,0,0,2,0,0
"Pakistan","2024-07-17",0,0,1,0,0,2,0,0
"Pakistan","2024-07-18",0,0,1,0,0,2,0,0
"Pakistan","2024-07-19",0,0,1,0,0,2,0,0
"Pakistan","2024-07-20",0,0,1,0,0,2,0,0
"Pakistan","2024-07-21",0,0,1,0,0,2,0,0
"Pakistan","2024-07-22",0,0,1,0,0,2,0,0
"Pakistan","2024-07-23",0,0,1,0,0,2,0,0
"Pakistan","2024-07-24",0,0,1,0,0,2,0,0
"Pakistan","2024-07-25",0,0,1,0,0,2,0,0
"Pakistan","2024-07-26",0,0,1,0,0,2,0,0
"Pakistan","2024-07-27",0,0,1,0,0,2,0,0
"Pakistan","2024-07-28",0,0,1,0,0,2,0,0
"Pakistan","2024-07-29",0,0,1,0,0,2,0,0
"Pakistan","2024-07-30",0,0,1,0,0,2,0,0
"Pakistan","2024-07-31",0,0,1,0,0,2,0,0
"Pakistan","2024-08-01",0,0,1,0,0,2,0,0
"Pakistan","2024-08-02",0,0,1,0,0,2,0,0
"Pakistan","2024-08-03",0,0,1,0,0,2,0,0
"Pakistan","2024-08-04",0,0,1,0,0,2,0,0
"Pakistan","2024-08-05",0,0,1,0,0,2,0,0
"Pakistan","2024-08-06",0,0,1,0,0,2,0,0
"Pakistan","2024-08-07",0,0,1,0,0,2,0,0
"Pakistan","2024-08-08",0,0,1,0,0,2,0,0
"Pakistan","2024-08-09",0,0,1,0,0,2,0,0
"Pakistan","2024-08-10",0,0,1,0,0,2,0,0
"Pakistan","2024-08-11",0,0,1,0,0,2,0,0
"Pakistan","2024-08-12",0,0,1,0,0,2,0,0
"Pakistan","2024-08-13",0,0,1,0,0,2,0,0
"Pakistan","2024-08-14",0,1,2,0,0,2,0,0
"Pakistan","2024-08-15",0,0,2,0,0,2,0,0
"Pakistan","2024-08-16",0,0,2,0,0,2,0,0
"Pakistan","2024-08-17",0,0,2,0,0,2,0,0
"Pakistan","2024-08-18",0,0,2,0,0,2,0,0
"Pakistan","2024-08-19",0,0,2,0,1,3,0,0
"Pakistan","2024-08-20",0,0,2,0,0,3,0,0
"Pakistan","2024-08-21",0,0,2,0,0,3,0,0
"Pakistan","2024-08-22",0,1,3,0,0,3,0,0
"Pakistan","2024-08-23",0,0,3,0,0,3,0,0
"Pakistan","2024-08-24",0,0,3,0,0,3,0,0
"Pakistan","2024-08-25",0,0,3,0,0,3,0,0
"Pakistan","2024-08-26",0,0,3,0,0,3,0,0
"Pakistan","2024-08-27",0,0,3,0,0,3,0,0
"Pakistan","2024-08-28",0,0,3,0,0,3,0,0
"Pakistan","2024-08-29",0,0,3,0,0,3,0,0
"Pakistan","2024-08-30",0,0,3,0,0,3,0,0
"Pakistan","2024-08-31",0,0,3,0,0,3,0,0
"Pakistan","2024-09-01",0,0,3,0,0,3,0,0
"Pakistan","2024-09-02",0,0,3,0,0,3,0,0
"Pakistan","2024-09-03",0,0,3,0,0,3,0,0
"Pakistan","2024-09-04",0,0,3,0,0,3,0,0
"Pakistan","2024-09-05",0,0,3,0,0,3,0,0
"Pakistan","2024-09-06",0,0,3,0,0,3,0,0
"Pakistan","2024-09-07",0,0,3,0,0,3,0,0
"Pakistan","2024-09-08",0,0,3,0,0,3,0,0
"Pakistan","2024-09-09",0,0,3,0,0,3,0,0
"Pakistan","2024-09-10",0,0,3,0,0,3,0,0
"Pakistan","2024-09-11",0,0,3,0,0,3,0,0
"Pakistan","2024-09-12",0,0,3,0,0,3,0,0
"Pakistan","2024-09-13",0,0,3,0,0,3,0,0
"Pakistan","2024-09-14",0,0,3,0,0,3,0,0
"Pakistan","2024-09-15",0,0,3,0,0,3,0,0
"Pakistan","2024-09-16",0,0,3,0,0,3,0,0
"Pakistan","2024-09-17",0,0,3,0,0,3,0,0
"Pakistan","2024-09-18",0,0,3,0,0,3,0,0
"Pakistan","2024-09-19",0,0,3,0,0,3,0,0
"Pakistan","2024-09-20",0,0,3,0,0,3,0,0
"Pakistan","2024-09-21",0,0,3,0,0,3,0,0
"Pakistan","2024-09-22",0,0,3,0,0,3,0,0
"Pakistan","2024-09-23",0,0,3,0,0,3,0,0
"Pakistan","2024-09-24",0,0,3,0,0,3,0,0
"Pakistan","2024-09-25",0,0,3,0,0,3,0,0
"Pakistan","2024-09-26",0,0,3,0,0,3,0,0
"Pakistan","2024-09-27",0,0,3,0,0,3,0,0
"Pakistan","2024-09-28",0,0,3,0,0,3,0,0
"Pakistan","2024-09-29",0,0,3,0,0,3,0,0
"Pakistan","2024-09-30",0,0,3,0,0,3,0,0
"Pakistan","2024-10-01",0,0,3,0,0,3,0,0
"Pakistan","2024-10-02",0,0,3,0,0,3,0,0
"Pakistan","2024-10-03",0,0,3,0,0,3,0,0
"Pakistan","2024-10-04",0,0,3,0,0,3,0,0
"Pakistan","2024-10-05",0,0,3,0,0,3,0,0
"Pakistan","2024-10-06",0,0,3,0,0,3,0,0
"Pakistan","2024-10-07",0,0,3,0,0,3,0,0
"Pakistan","2024-10-08",0,0,3,0,0,3,0,0
"Pakistan","2024-10-09",0,0,3,0,0,3,0,0
"Pakistan","2024-10-10",0,0,3,0,0,3,0,0
"Pakistan","2024-10-11",0,0,3,0,1,4,0,0
"Pakistan","2024-10-12",0,0,3,0,0,4,0,0
"Pakistan","2024-10-13",0,0,3,0,0,4,0,0
"Pakistan","2024-10-14",0,0,3,0,0,4,0,0
"Pakistan","2024-10-15",0,0,3,0,0,4,0,0
"Pakistan","2024-10-16",0,0,3,0,0,4,0,0
"Pakistan","2024-10-17",0,0,3,0,0,4,0,0
"Pakistan","2024-10-18",0,0,3,0,0,4,0,0
"Pakistan","2024-10-19",0,0,3,0,0,4,0,0
"Pakistan","2024-10-20",0,0,3,0,0,4,0,0
"Pakistan","2024-10-21",0,0,3,0,0,4,0,0
"Pakistan","2024-10-22",0,0,3,0,0,4,0,0
"Pakistan","2024-10-23",0,0,3,0,0,4,0,0
"Pakistan","2024-10-24",0,0,3,0,0,4,0,0
"Pakistan","2024-10-25",0,0,3,0,0,4,0,0
"Pakistan","2024-10-26",0,0,3,0,0,4,0,0
"Pakistan","2024-10-27",0,0,3,0,0,4,0,0
"Pakistan","2024-10-28",0,0,3,0,0,4,0,0
"Pakistan","2024-10-29",0,0,3,0,0,4,0,0
"Pakistan","2024-10-30",0,0,3,0,0,4,0,0
"Pakistan","2024-10-31",0,0,3,0,0,4,0,0
"Pakistan","2024-11-01",0,0,3,0,0,4,0,0
"Pakistan","2024-11-02",0,0,3,0,0,4,0,0
"Pakistan","2024-11-03",0,0,3,0,0,4,0,0
"Pakistan","2024-11-04",0,0,3,0,0,4,0,0
"Pakistan","2024-11-05",0,0,3,0,0,4,0,0
"Pakistan","2024-11-06",0,0,3,0,0,4,0,0
"Pakistan","2024-11-07",0,0,3,0,0,4,0,0
"Pakistan","2024-11-08",0,0,3,0,0,4,0,0
"Pakistan","2024-11-09",0,0,3,0,0,4,0,0
"Pakistan","2024-11-10",0,0,3,0,0,4,0,0
"Pakistan","2024-11-11",0,0,3,0,0,4,0,0
"Pakistan","2024-11-12",0,0,3,0,0,4,0,0
"Pakistan","2024-11-13",0,0,3,0,0,4,0,0
"Pakistan","2024-11-14",0,0,3,0,0,4,0,0
"Pakistan","2024-11-15",0,0,3,0,0,4,0,0
"Pakistan","2024-11-16",0,0,3,0,0,4,0,0
"Pakistan","2024-11-17",0,0,3,0,0,4,0,0
"Pakistan","2024-11-18",0,0,3,0,0,4,0,0
"Pakistan","2024-11-19",0,0,3,0,0,4,0,0
"Pakistan","2024-11-20",0,0,3,0,0,4,0,0
"Pakistan","2024-11-21",0,0,3,0,0,4,0,0
"Pakistan","2024-11-22",0,0,3,0,0,4,0,0
"Pakistan","2024-11-23",0,0,3,0,0,4,0,0
"Pakistan","2024-11-24",0,0,3,0,0,4,0,0
"Pakistan","2024-11-25",0,0,3,0,0,4,0,0
"Pakistan","2024-11-26",0,0,3,0,0,4,0,0
"Pakistan","2024-11-27",0,0,3,0,0,4,0,0
"Pakistan","2024-11-28",0,0,3,0,0,4,0,0
"Pakistan","2024-11-29",0,1,4,0,0,4,0,0
"Pakistan","2024-11-30",0,0,4,0,0,4,0,0
"Pakistan","2024-12-01",0,0,4,0,0,4,0,0
"Pakistan","2024-12-02",0,0,4,0,0,4,0,0
"Pakistan","2024-12-03",0,0,4,0,0,4,0,0
"Pakistan","2024-12-04",0,0,4,0,0,4,0,0
"Pakistan","2024-12-05",0,0,4,0,0,4,0,0
"Pakistan","2024-12-06",0,0,4,0,0,4,0,0
"Pakistan","2024-12-07",0,0,4,0,0,4,0,0
"Pakistan","2024-12-08",0,0,4,0,0,4,0,0
"Pakistan","2024-12-09",0,0,4,0,0,4,0,0
"Pakistan","2024-12-10",0,0,4,0,0,4,0,0
"Pakistan","2024-12-11",0,0,4,0,0,4,0,0
"Pakistan","2024-12-12",0,0,4,0,0,4,0,0
"Pakistan","2024-12-13",0,0,4,0,0,4,0,0
"Pakistan","2024-12-14",0,0,4,0,0,4,0,0
"Pakistan","2024-12-15",0,0,4,0,0,4,0,0
"Pakistan","2024-12-16",0,0,4,0,0,4,0,0
"Pakistan","2024-12-17",0,0,4,0,0,4,0,0
"Pakistan","2024-12-18",0,0,4,0,0,4,0,0
"Pakistan","2024-12-19",0,0,4,0,0,4,0,0
"Pakistan","2024-12-20",0,0,4,0,0,4,0,0
"Pakistan","2024-12-21",0,0,4,0,0,4,0,0
"Pakistan","2024-12-22",0,0,4,0,0,4,0,0
"Pakistan","2024-12-23",0,0,4,0,0,4,0,0
"Pakistan","2024-12-24",0,0,4,0,0,4,0,0
"Pakistan","2024-12-25",0,0,4,0,0,4,0,0
"Pakistan","2024-12-26",0,0,4,0,0,4,0,0
"Pakistan","2024-12-27",0,0,4,0,0,4,0,0
"Pakistan","2024-12-28",0,0,4,0,0,4,0,0
"Pakistan","2024-12-29",0,0,4,0,0,4,0,0
"Pakistan","2024-12-30",0,0,4,0,0,4,0,0
"Pakistan","2024-12-31",0,0,4,0,0,4,0,0
"Pakistan","2025-01-01",0,0,4,0,0,4,0,0
"Pakistan","2025-01-02",0,0,4,0,0,4,0,0
"Pakistan","2025-01-03",0,0,4,0,0,4,0,0
"Pakistan","2025-01-04",0,0,4,0,0,4,0,0
"Pakistan","2025-01-05",0,0,4,0,0,4,0,0
"Pakistan","2025-01-06",0,0,4,0,0,4,0,0
"Pakistan","2025-01-07",0,0,4,0,0,4,0,0
"Pakistan","2025-01-08",0,0,4,0,0,4,0,0
"Pakistan","2025-01-09",0,0,4,0,0,4,0,0
"Pakistan","2025-01-10",0,0,4,0,0,4,0,0
"Pakistan","2025-01-11",0,0,4,0,0,4,0,0
"Pakistan","2025-01-12",0,0,4,0,0,4,0,0
"Pakistan","2025-01-13",0,0,4,0,0,4,0,0
"Pakistan","2025-01-14",0,0,4,0,0,4,0,0
"Pakistan","2025-01-15",0,0,4,0,0,4,0,0
"Pakistan","2025-01-16",0,0,4,0,0,4,0,0
"Pakistan","2025-01-17",0,0,4,0,0,4,0,0
"Pakistan","2025-01-18",0,0,4,0,0,4,0,0
"Pakistan","2025-01-19",0,0,4,0,0,4,0,0
"Pakistan","2025-01-20",0,0,4,0,0,4,0,0
"Pakistan","2025-01-21",0,0,4,0,0,4,0,0
"Pakistan","2025-01-22",0,0,4,0,0,4,0,0
"Pakistan","2025-01-23",0,0,4,0,0,4,0,0
"Pakistan","2025-01-24",0,0,4,0,0,4,0,0
"Pakistan","2025-01-25",0,0,4,0,0,4,0,0
"Pakistan","2025-01-26",0,0,4,0,0,4,0,0
"Pakistan","2025-01-27",0,0,4,0,0,4,0,0
"Pakistan","2025-01-28",0,0,4,0,0,4,0,0
"Pakistan","2025-01-29",0,0,4,0,0,4,0,0
"Pakistan","2025-01-30",0,0,4,0,0,4,0,0
"Pakistan","2025-01-31",0,0,4,0,0,4,0,0
"Pakistan","2025-02-01",0,0,4,0,0,4,0,0
"Pakistan","2025-02-02",0,0,4,0,0,4,0,0
"Pakistan","2025-02-03",0,0,4,0,0,4,0,0
"Panama","2024-01-01",0,0,0,0,0,0,0,0
"Panama","2024-01-02",0,0,0,0,0,0,0,0
"Panama","2024-01-03",0,0,0,0,0,0,0,0
"Panama","2024-01-04",0,0,0,0,0,0,0,0
"Panama","2024-01-05",0,0,0,0,0,0,0,0
"Panama","2024-01-06",0,0,0,0,0,0,0,0
"Panama","2024-01-07",0,0,0,0,0,0,0,0
"Panama","2024-01-08",0,0,0,0,0,0,0,0
"Panama","2024-01-09",0,0,0,0,0,0,0,0
"Panama","2024-01-10",0,0,0,0,0,0,0,0
"Panama","2024-01-11",0,0,0,0,0,0,0,0
"Panama","2024-01-12",0,0,0,0,0,0,0,0
"Panama","2024-01-13",0,0,0,0,0,0,0,0
"Panama","2024-01-14",0,0,0,0,0,0,0,0
"Panama","2024-01-15",0,0,0,0,0,0,0,0
"Panama","2024-01-16",0,1,1,0,1,1,0,0
"Panama","2024-01-17",0,0,1,0,0,1,0,0
"Panama","2024-01-18",0,0,1,0,0,1,0,0
"Panama","2024-01-19",0,0,1,0,0,1,0,0
"Panama","2024-01-20",0,0,1,0,0,1,0,0
"Panama","2024-01-21",0,0,1,0,0,1,0,0
"Panama","2024-01-22",0,0,1,0,0,1,0,0
"Panama","2024-01-23",0,0,1,0,0,1,0,0
"Panama","2024-01-24",0,0,1,0,0,1,0,0
"Panama","2024-01-25",0,0,1,0,0,1,0,0
"Panama","2024-01-26",0,0,1,0,0,1,0,0
"Panama","2024-01-27",0,0,1,0,1,2,0,0
"Panama","2024-01-28",0,0,1,0,0,2,0,0
"Panama","2024-01-29",0,0,1,0,0,2,0,0
"Panama","2024-01-30",0,0,1,0,0,2,0,0
"Panama","2024-01-31",0,0,1,0,0,2,0,0
"Panama","2024-02-01",0,0,1,0,0,2,0,0
"Panama","2024-02-02",0,0,1,0,0,2,0,0
"Panama","2024-02-03",0,0,1,0,0,2,0,0
"Panama","2024-02-04",0,0,1,0,0,2,0,0
"Panama","2024-02-05",0,0,1,0,0,2,0,0
"Panama","2024-02-06",0,1,2,0,0,2,0,0
"Panama","2024-02-07",0,0,2,0,0,2,0,0
"Panama","2024-02-08",0,0,2,0,0,2,0,0
"Panama","2024-02-09",0,0,2,0,0,2,0,0
"Panama","2024-02-10",0,0,2,0,0,2,0,0
"Panama","2024-02-11",0,0,2,0,0,2,0,0
"Panama","2024-02-12",0,0,2,0,0,2,0,0
"Panama","2024-02-13",0,0,2,0,0,2,0,0
"Panama","2024-02-14",0,0,2,0,0,2,0,0
"Panama","2024-02-15",0,0,2,0,0,2,0,0
"Panama","2024-02-16",0,0,2,0,0,2,0,0
"Panama","2024-02-17",0,0,2,0,0,2,0,0
"Panama","2024-02-18",0,0,2,0,0,2,0,0
"Panama","2024-02-19",0,0,2,0,0,2,0,0
"Panama","2024-02-20",0,0,2,0,0,2,0,0
"Panama","2024-02-21",0,0,2,0,0,2,0,0
"Panama","2024-02-22",0,0,2,0,0,2,0,0
"Panama","2024-02-23",0,0,2,0,0,2,0,0
"Panama","2024-02-24",0,0,2,0,0,2,0,0
"Panama","2024-02-25",0,0,2,0,0,2,0,0
"Panama","2024-02-26",0,0,2,0,0,2,0,0
"Panama","2024-02-27",0,0,2,0,0,2,0,0
"Panama","2024-02-28",0,0,2,0,0,2,0,0
"Panama","2024-02-29",0,0,2,0,0,2,0,0
"Panama","2024-03-01",0,0,2,0,0,2,0,0
"Panama","2024-03-02",0,0,2,0,0,2,0,0
"Panama","2024-03-03",0,0,2,0,0,2,0,0
"Panama","2024-03-04",0,0,2,0,0,2,0,0
"Panama","2024-03-05",0,0,2,0,0,2,0,0
"Panama","2024-03-06",0,0,2,0,0,2,0,0
"Panama","2024-03-07",0,0,2,0,0,2,0,0
"Panama","2024-03-08",0,0,2,0,0,2,0,0
"Panama","2024-03-09",0,0,2,0,0,2,0,0
"Panama","2024-03-10",0,0,2,0,0,2,0,0
"Panama","2024-03-11",0,0,2,0,0,2,0,0
"Panama","2024-03-12",0,0,2,0,0,2,0,0
"Panama","2024-03-13",0,0,2,0,0,2,0,0
"Panama","2024-03-14",0,0,2,0,0,2,0,0
"Panama","2024-03-15",0,0,2,0,0,2,0,0
"Panama","2024-03-16",0,0,2,0,0,2,0,0
"Panama","2024-03-17",0,0,2,0,0,2,0,0
"Panama","2024-03-18",0,0,2,0,0,2,0,0
"Panama","2024-03-19",0,0,2,0,0,2,0,0
"Panama","2024-03-20",0,0,2,0,0,2,0,0
"Panama","2024-03-21",0,0,2,0,0,2,0,0
"Panama","2024-03-22",0,0,2,0,0,2,0,0
"Panama","2024-03-23",0,0,2,0,0,2,0,0
"Panama","2024-03-24",0,0,2,0,0,2,0,0
"Panama","2024-03-25",0,0,2,0,0,2,0,0
"Panama","2024-03-26",0,0,2,0,0,2,0,0
"Panama","2024-03-27",0,0,2,0,0,2,0,0
"Panama","2024-03-28",0,0,2,0,0,2,0,0
"Panama","2024-03-29",0,0,2,0,0,2,0,0
"Panama","2024-03-30",0,0,2,0,0,2,0,0
"Panama","2024-03-31",0,0,2,0,0,2,0,0
"Panama","2024-04-01",0,0,2,0,0,2,0,0
"Panama","2024-04-02",0,0,2,0,0,2,0,0
"Panama","2024-04-03",0,0,2,0,0,2,0,0
"Panama","2024-04-04",0,0,2,0,0,2,0,0
"Panama","2024-04-05",0,0,2,0,0,2,0,0
"Panama","2024-04-06",0,0,2,0,0,2,0,0
"Panama","2024-04-07",0,0,2,0,0,2,0,0
"Panama","2024-04-08",0,0,2,0,0,2,0,0
"Panama","2024-04-09",0,0,2,0,0,2,0,0
"Panama","2024-04-10",0,0,2,0,0,2,0,0
"Panama","2024-04-11",0,0,2,0,0,2,0,0
"Panama","2024-04-12",0,0,2,0,0,2,0,0
"Panama","2024-04-13",0,0,2,0,0,2,0,0
"Panama","2024-04-14",0,0,2,0,0,2,0,0
"Panama","2024-04-15",0,0,2,0,0,2,0,0
"Panama","2024-04-16",0,0,2,0,0,2,0,0
"Panama","2024-04-17",0,0,2,0,1,3,0,0
"Panama","2024-04-18",0,0,2,0,0,3,0,0
"Panama","2024-04-19",0,0,2,0,0,3,0,0
"Panama","2024-04-20",0,0,2,0,0,3,0,0
"Panama","2024-04-21",0,0,2,0,0,3,0,0
"Panama","2024-04-22",0,0,2,0,0,3,0,0
"Panama","2024-04-23",0,0,2,0,0,3,0,0
"Panama","2024-04-24",0,0,2,0,0,3,0,0
"Panama","2024-04-25",0,0,2,0,0,3,0,0
"Panama","2024-04-26",0,0,2,0,0,3,0,0
"Panama","2024-04-27",0,0,2,0,0,3,0,0
"Panama","2024-04-28",0,0,2,0,0,3,0,0
"Panama","2024-04-29",0,0,2,0,0,3,0,0
"Panama","2024-04-30",0,0,2,0,0,3,0,0
"Panama","2024-05-01",0,0,2,0,0,3,0,0
"Panama","2024-05-02",0,0,2,0,0,3,0,0
"Panama","2024-05-03",0,0,2,0,0,3,0,0
"Panama","2024-05-04",0,0,2,0,0,3,0,0
"Panama","2024-05-05",0,0,2,0,0,3,0,0
"Panama","2024-05-06",0,0,2,0,0,3,0,0
"Panama","2024-05-07",0,0,2,0,0,3,0,0
"Panama","2024-05-08",0,0,2,0,0,3,0,0
"Panama","2024-05-09",0,0,2,0,0,3,0,0
"Panama","2024-05-10",0,0,2,0,0,3,0,0
"Panama","2024-05-11",0,0,2,0,0,3,0,0
"Panama","2024-05-12",0,0,2,0,0,3,0,0
"Panama","2024-05-13",0,0,2,0,0,3,0,0
"Panama","2024-05-14",0,0,2,0,0,3,0,0
"Panama","2024-05-15",0,0,2,0,0,3,0,0
"Panama","2024-05-16",0,0,2,0,0,3,0,0
"Panama","2024-05-17",0,0,2,0,0,3,0,0
"Panama","2024-05-18",0,0,2,0,0,3,0,0
"Panama","2024-05-19",0,0,2,0,0,3,0,0
"Panama","2024-05-20",0,0,2,0,0,3,0,0
"Panama","2024-05-21",0,0,2,0,0,3,0,0
"Panama","2024-05-22",0,0,2,0,0,3,0,0
"Panama","2024-05-23",0,0,2,0,0,3,0,0
"Panama","2024-05-24",0,0,2,0,0,3,0,0
"Panama","2024-05-25",0,0,2,0,0,3,0,0
"Panama","2024-05-26",0,0,2,0,0,3,0,0
"Panama","2024-05-27",0,0,2,0,0,3,0,0
"Panama","2024-05-28",0,0,2,0,0,3,0,0
"Panama","2024-05-29",0,0,2,0,0,3,0,0
"Panama","2024-05-30",0,0,2,0,0,3,0,0
"Panama","2024-05-31",0,0,2,0,0,3,0,0
"Panama","2024-06-01",0,0,2,0,0,3,0,0
"Panama","2024-06-02",0,0,2,0,0,3,0,0
"Panama","2024-06-03",0,0,2,0,0,3,0,0
"Panama","2024-06-04",0,0,2,0,0,3,0,0
"Panama","2024-06-05",0,0,2,0,0,3,0,0
"Panama","2024-06-06",0,0,2,0,0,3,0,0
"Panama","2024-06-07",0,0,2,0,0,3,0,0
"Panama","2024-06-08",0,0,2,0,0,3,0,0
"Panama","2024-06-09",0,0,2,0,0,3,0,0
"Panama","2024-06-10",0,0,2,0,0,3,0,0
"Panama","2024-06-11",0,0,2,0,0,3,0,0
"Panama","2024-06-12",0,0,2,0,0,3,0,0
"Panama","2024-06-13",0,0,2,0,0,3,0,0
"Panama","2024-06-14",0,0,2,0,0,3,0,0
"Panama","2024-06-15",0,0,2,0,0,3,0,0
"Panama","2024-06-16",0,0,2,0,0,3,0,0
"Panama","2024-06-17",0,0,2,0,0,3,0,0
"Panama","2024-06-18",0,0,2,0,0,3,0,0
"Panama","2024-06-19",0,0,2,0,0,3,0,0
"Panama","2024-06-20",0,0,2,0,0,3,0,0
"Panama","2024-06-21",0,0,2,0,0,3,0,0
"Panama","2024-06-22",0,0,2,0,0,3,0,0
"Panama","2024-06-23",0,0,2,0,0,3,0,0
"Panama","2024-06-24",0,0,2,0,0,3,0,0
"Panama","2024-06-25",0,1,3,0,0,3,0,0
"Panama","2024-06-26",0,0,3,0,0,3,0,0
"Panama","2024-06-27",0,0,3,0,0,3,0,0
"Panama","2024-06-28",0,0,3,0,0,3,0,0
"Panama","2024-06-29",0,0,3,0,0,3,0,0
"Panama","2024-06-30",0,0,3,0,0,3,0,0
"Panama","2024-07-01",0,0,3,0,0,3,0,0
"Panama","2024-07-02",0,0,3,0,0,3,0,0
"Panama","2024-07-03",0,0,3,0,0,3,0,0
"Panama","2024-07-04",0,0,3,0,0,3,0,0
"Panama","2024-07-05",0,0,3,0,0,3,0,0
"Panama","2024-07-06",0,0,3,0,0,3,0,0
"Panama","2024-07-07",0,0,3,0,0,3,0,0
"Panama","2024-07-08",0,0,3,0,0,3,0,0
"Panama","2024-07-09",0,0,3,0,0,3,0,0
"Panama","2024-07-10",0,0,3,0,0,3,0,0
"Panama","2024-07-11",0,0,3,0,0,3,0,0
"Panama","2024-07-12",0,0,3,0,0,3,0,0
"Panama","2024-07-13",0,0,3,0,1,4,0,0
"Panama","2024-07-14",0,0,3,0,0,4,0,0
"Panama","2024-07-15",0,0,3,0,0,4,0,0
"Panama","2024-07-16",0,0,3,0,0,4,0,0
"Panama","2024-07-17",0,0,3,0,0,4,0,0
"Panama","2024-07-18",0,0,3,0,0,4,0,0
"Panama","2024-07-19",0,0,3,0,0,4,0,0
"Panama","2024-07-20",0,0,3,0,0,4,0,0
"Panama","2024-07-21",0,0,3,0,0,4,0,0
"Panama","2024-07-22",0,0,3,0,0,4,0,0
"Panama","2024-07-23",0,0,3,0,0,4,0,0
"Panama","2024-07-24",0,0,3,0,0,4,0,0
"Panama","2024-07-25",0,0,3,0,0,4,0,0
"Panama","2024-07-26",0,0,3,0,0,4,0,0
"Panama","2024-07-27",0,0,3,0,0,4,0,0
"Panama","2024-07-28",0,0,3,0,0,4,0,0
"Panama","2024-07-29",0,0,3,0,0,4,0,0
"Panama","2024-07-30",0,1,4,0,0,4,0,0
"Panama","2024-07-31",0,0,4,0,0,4,0,0
"Panama","2024-08-01",0,0,4,0,0,4,0,0
"Panama","2024-08-02",0,0,4,0,0,4,0,0
"Panama","2024-08-03",0,0,4,0,0,4,0,0
"Panama","2024-08-04",0,0,4,0,0,4,0,0
"Panama","2024-08-05",0,0,4,0,0,4,0,0
"Panama","2024-08-06",0,0,4,0,0,4,0,0
"Panama","2024-08-07",0,0,4,0,0,4,0,0
"Panama","2024-08-08",0,0,4,0,0,4,0,0
"Panama","2024-08-09",0,0,4,0,0,4,0,0
"Panama","2024-08-10",0,0,4,0,0,4,0,0
"Panama","2024-08-11",0,0,4,0,0,4,0,0
"Panama","2024-08-12",0,0,4,0,0,4,0,0
"Panama","2024-08-13",0,0,4,0,0,4,0,0
"Panama","2024-08-14",0,0,4,0,0,4,0,0
"Panama","2024-08-15",0,0,4,0,0,4,0,0
"Panama","2024-08-16",0,0,4,0,0,4,0,0
"Panama","2024-08-17",0,0,4,0,0,4,0,0
"Panama","2024-08-18",0,0,4,0,0,4,0,0
"Panama","2024-08-19",0,0,4,0,0,4,0,0
"Panama","2024-08-20",0,0,4,0,0,4,0,0
"Panama","2024-08-21",0,0,4,0,0,4,0,0
"Panama","2024-08-22",0,0,4,0,0,4,0,0
"Panama","2024-08-23",0,0,4,0,0,4,0,0
"Panama","2024-08-24",0,0,4,0,1,5,0,0
"Panama","2024-08-25",0,0,4,0,0,5,0,0
"Panama","2024-08-26",0,0,4,0,0,5,0,0
"Panama","2024-08-27",0,0,4,0,0,5,0,0
"Panama","2024-08-28",0,0,4,0,0,5,0,0
"Panama","2024-08-29",0,0,4,0,0,5,0,0
"Panama","2024-08-30",0,0,4,0,0,5,0,0
"Panama","2024-08-31",0,0,4,0,0,5,0,0
"Panama","2024-09-01",0,0,4,0,0,5,0,0
"Panama","2024-09-02",0,0,4,0,0,5,0,0
"Panama","2024-09-03",0,0,4,0,0,5,0,0
"Panama","2024-09-04",0,0,4,0,0,5,0,0
"Panama","2024-09-05",0,0,4,0,0,5,0,0
"Panama","2024-09-06",0,0,4,0,0,5,0,0
"Panama","2024-09-07",0,0,4,0,0,5,0,0
"Panama","2024-09-08",0,0,4,0,0,5,0,0
"Panama","2024-09-09",0,0,4,0,0,5,0,0
"Panama","2024-09-10",0,0,4,0,0,5,0,0
"Panama","2024-09-11",0,0,4,0,0,5,0,0
"Panama","2024-09-12",0,0,4,0,0,5,0,0
"Panama","2024-09-13",0,0,4,0,0,5,0,0
"Panama","2024-09-14",0,0,4,0,0,5,0,0
"Panama","2024-09-15",0,0,4,0,0,5,0,0
"Panama","2024-09-16",0,0,4,0,0,5,0,0
"Panama","2024-09-17",0,1,5,0,0,5,0,0
"Panama","2024-09-18",0,0,5,0,0,5,0,0
"Panama","2024-09-19",0,0,5,0,0,5,0,0
"Panama","2024-09-20",0,0,5,0,0,5,0,0
"Panama","2024-09-21",0,0,5,0,0,5,0,0
"Panama","2024-09-22",0,0,5,0,0,5,0,0
"Panama","2024-09-23",0,0,5,0,0,5,0,0
"Panama","2024-09-24",0,0,5,0,0,5,0,0
"Panama","2024-09-25",0,0,5,0,0,5,0,0
"Panama","2024-09-26",0,0,5,0,0,5,0,0
"Panama","2024-09-27",0,0,5,0,0,5,0,0
"Panama","2024-09-28",0,0,5,0,0,5,0,0
"Panama","2024-09-29",0,0,5,0,0,5,0,0
"Panama","2024-09-30",0,0,5,0,0,5,0,0
"Panama","2024-10-01",0,0,5,0,0,5,0,0
"Panama","2024-10-02",0,0,5,0,0,5,0,0
"Panama","2024-10-03",0,0,5,0,0,5,0,0
"Panama","2024-10-04",0,0,5,0,0,5,0,0
"Panama","2024-10-05",0,0,5,0,0,5,0,0
"Panama","2024-10-06",0,0,5,0,0,5,0,0
"Panama","2024-10-07",0,0,5,0,0,5,0,0
"Panama","2024-10-08",0,0,5,0,0,5,0,0
"Panama","2024-10-09",0,0,5,0,0,5,0,0
"Panama","2024-10-10",0,0,5,0,0,5,0,0
"Panama","2024-10-11",0,0,5,0,0,5,0,0
"Panama","2024-10-12",0,0,5,0,0,5,0,0
"Panama","2024-10-13",0,0,5,0,0,5,0,0
"Panama","2024-10-14",0,0,5,0,0,5,0,0
"Panama","2024-10-15",0,0,5,0,0,5,0,0
"Panama","2024-10-16",0,0,5,0,0,5,0,0
"Panama","2024-10-17",0,0,5,0,0,5,0,0
"Panama","2024-10-18",0,0,5,0,0,5,0,0
"Panama","2024-10-19",0,0,5,0,0,5,0,0
"Panama","2024-10-20",0,0,5,0,0,5,0,0
"Panama","2024-10-21",0,0,5,0,0,5,0,0
"Panama","2024-10-22",0,0,5,0,0,5,0,0
"Panama","2024-10-23",0,0,5,0,0,5,0,0
"Panama","2024-10-24",0,0,5,0,0,5,0,0
"Panama","2024-10-25",0,0,5,0,0,5,0,0
"Panama","2024-10-26",0,0,5,0,0,5,0,0
"Panama","2024-10-27",0,0,5,0,0,5,0,0
"Panama","2024-10-28",0,0,5,0,0,5,0,0
"Panama","2024-10-29",0,0,5,0,0,5,0,0
"Panama","2024-10-30",0,0,5,0,0,5,0,0
"Panama","2024-10-31",0,0,5,0,0,5,0,0
"Panama","2024-11-01",0,0,5,0,0,5,0,0
"Panama","2024-11-02",0,0,5,0,0,5,0,0
"Panama","2024-11-03",0,0,5,0,0,5,0,0
"Panama","2024-11-04",0,0,5,0,0,5,0,0
"Panama","2024-11-05",0,0,5,0,0,5,0,0
"Panama","2024-11-06",0,0,5,0,0,5,0,0
"Panama","2024-11-07",0,0,5,0,0,5,0,0
"Panama","2024-11-08",0,0,5,0,0,5,0,0
"Panama","2024-11-09",0,0,5,0,0,5,0,0
"Panama","2024-11-10",0,0,5,0,0,5,0,0
"Panama","2024-11-11",0,0,5,0,0,5,0,0
"Panama","2024-11-12",0,0,5,0,0,5,0,0
"Panama","2024-11-13",0,0,5,0,0,5,0,0
"Panama","2024-11-14",0,0,5,0,0,5,0,0
"Panama","2024-11-15",0,0,5,0,0,5,0,0
"Panama","2024-11-16",0,0,5,0,0,5,0,0
"Panama","2024-11-17",0,0,5,0,0,5,0,0
"Panama","2024-11-18",0,0,5,0,0,5,0,0
"Panama","2024-11-19",0,0,5,0,0,5,0,0
"Panama","2024-11-20",0,0,5,0,0,5,0,0
"Panama","2024-11-21",0,0,5,0,0,5,0,0
"Panama","2024-11-22",0,0,5,0,0,5,0,0
"Panama","2024-11-23",0,0,5,0,0,5,0,0
"Panama","2024-11-24",0,0,5,0,0,5,0,0
"Panama","2024-11-25",0,0,5,0,0,5,0,0
"Panama","2024-11-26",0,0,5,0,0,5,0,0
"Panama","2024-11-27",0,0,5,0,0,5,0,0
"Panama","2024-11-28",0,0,5,0,0,5,0,0
"Panama","2024-11-29",0,0,5,0,0,5,0,0
"Panama","2024-11-30",0,0,5,0,0,5,0,0
"Panama","2024-12-01",0,0,5,0,0,5,0,0
"Panama","2024-12-02",0,0,5,0,0,5,0,0
"Panama","2024-12-03",0,0,5,0,0,5,0,0
"Panama","2024-12-04",0,0,5,0,0,5,0,0
"Panama","2024-12-05",0,0,5,0,0,5,0,0
"Panama","2024-12-06",0,0,5,0,0,5,0,0
"Panama","2024-12-07",0,0,5,0,0,5,0,0
"Panama","2024-12-08",0,0,5,0,0,5,0,0
"Panama","2024-12-09",0,0,5,0,0,5,0,0
"Panama","2024-12-10",0,0,5,0,0,5,0,0
"Panama","2024-12-11",0,0,5,0,0,5,0,0
"Panama","2024-12-12",0,0,5,0,0,5,0,0
"Panama","2024-12-13",0,0,5,0,0,5,0,0
"Panama","2024-12-14",0,0,5,0,0,5,0,0
"Panama","2024-12-15",0,0,5,0,0,5,0,0
"Panama","2024-12-16",0,0,5,0,0,5,0,0
"Panama","2024-12-17",0,0,5,0,0,5,0,0
"Panama","2024-12-18",0,0,5,0,0,5,0,0
"Panama","2024-12-19",0,0,5,0,0,5,0,0
"Panama","2024-12-20",0,0,5,0,0,5,0,0
"Panama","2024-12-21",0,0,5,0,0,5,0,0
"Panama","2024-12-22",0,0,5,0,0,5,0,0
"Panama","2024-12-23",0,0,5,0,0,5,0,0
"Panama","2024-12-24",0,0,5,0,0,5,0,0
"Panama","2024-12-25",0,0,5,0,0,5,0,0
"Panama","2024-12-26",0,0,5,0,0,5,0,0
"Panama","2024-12-27",0,0,5,0,0,5,0,0
"Panama","2024-12-28",0,0,5,0,0,5,0,0
"Panama","2024-12-29",0,0,5,0,0,5,0,0
"Panama","2024-12-30",0,0,5,0,0,5,0,0
"Panama","2024-12-31",0,0,5,0,0,5,0,0
"Panama","2025-01-01",0,0,5,0,0,5,0,0
"Panama","2025-01-02",0,0,5,0,0,5,0,0
"Panama","2025-01-03",0,0,5,0,0,5,0,0
"Panama","2025-01-04",0,0,5,0,0,5,0,0
"Panama","2025-01-05",0,0,5,0,0,5,0,0
"Panama","2025-01-06",0,0,5,0,0,5,0,0
"Panama","2025-01-07",0,0,5,0,0,5,0,0
"Panama","2025-01-08",0,0,5,0,0,5,0,0
"Panama","2025-01-09",0,0,5,0,0,5,0,0
"Panama","2025-01-10",0,0,5,0,0,5,0,0
"Panama","2025-01-11",0,0,5,0,0,5,0,0
"Panama","2025-01-12",0,0,5,0,0,5,0,0
"Panama","2025-01-13",0,0,5,0,0,5,0,0
"Panama","2025-01-14",0,0,5,0,0,5,0,0
"Panama","2025-01-15",0,0,5,0,0,5,0,0
"Panama","2025-01-16",0,0,5,0,0,5,0,0
"Panama","2025-01-17",0,0,5,0,0,5,0,0
"Panama","2025-01-18",0,0,5,0,0,5,0,0
"Panama","2025-01-19",0,0,5,0,0,5,0,0
"Panama","2025-01-20",0,0,5,0,0,5,0,0
"Panama","2025-01-21",0,0,5,0,0,5,0,0
"Panama","2025-01-22",0,0,5,0,0,5,0,0
"Panama","2025-01-23",0,0,5,0,0,5,0,0
"Panama","2025-01-24",0,0,5,0,0,5,0,0
"Panama","2025-01-25",0,0,5,0,0,5,0,0
"Panama","2025-01-26",0,0,5,0,0,5,0,0
"Panama","2025-01-27",0,0,5,0,0,5,0,0
"Panama","2025-01-28",0,0,5,0,0,5,0,0
"Panama","2025-01-29",0,0,5,0,0,5,0,0
"Panama","2025-01-30",0,0,5,0,0,5,0,0
"Panama","2025-01-31",0,0,5,0,0,5,0,0
"Panama","2025-02-01",0,0,5,0,0,5,0,0
"Panama","2025-02-02",0,0,5,0,0,5,0,0
"Panama","2025-02-03",0,0,5,0,0,5,0,0
"Paraguay","2024-01-01",0,0,0,0,0,0,0,0
"Paraguay","2024-01-02",0,0,0,0,0,0,0,0
"Paraguay","2024-01-03",0,0,0,0,0,0,0,0
"Paraguay","2024-01-04",0,0,0,0,0,0,0,0
"Paraguay","2024-01-05",0,0,0,0,0,0,0,0
"Paraguay","2024-01-06",0,0,0,0,0,0,0,0
"Paraguay","2024-01-07",0,0,0,0,0,0,0,0
"Paraguay","2024-01-08",0,0,0,0,0,0,0,0
"Paraguay","2024-01-09",0,0,0,0,0,0,0,0
"Paraguay","2024-01-10",0,0,0,0,0,0,0,0
"Paraguay","2024-01-11",0,0,0,0,0,0,0,0
"Paraguay","2024-01-12",0,0,0,0,0,0,0,0
"Paraguay","2024-01-13",0,0,0,0,0,0,0,0
"Paraguay","2024-01-14",0,0,0,0,0,0,0,0
"Paraguay","2024-01-15",0,0,0,0,0,0,0,0
"Paraguay","2024-01-16",0,0,0,0,0,0,0,0
"Paraguay","2024-01-17",0,0,0,0,0,0,0,0
"Paraguay","2024-01-18",0,0,0,0,0,0,0,0
"Paraguay","2024-01-19",0,0,0,0,0,0,0,0
"Paraguay","2024-01-20",0,0,0,0,0,0,0,0
"Paraguay","2024-01-21",0,0,0,0,0,0,0,0
"Paraguay","2024-01-22",0,0,0,0,0,0,0,0
"Paraguay","2024-01-23",0,0,0,0,0,0,0,0
"Paraguay","2024-01-24",0,0,0,0,0,0,0,0
"Paraguay","2024-01-25",0,0,0,0,0,0,0,0
"Paraguay","2024-01-26",0,0,0,0,0,0,0,0
"Paraguay","2024-01-27",0,0,0,0,0,0,0,0
"Paraguay","2024-01-28",0,0,0,0,0,0,0,0
"Paraguay","2024-01-29",0,0,0,0,0,0,0,0
"Paraguay","2024-01-30",0,0,0,0,0,0,0,0
"Paraguay","2024-01-31",0,0,0,0,0,0,0,0
"Paraguay","2024-02-01",0,0,0,0,0,0,0,0
"Paraguay","2024-02-02",0,0,0,0,0,0,0,0
"Paraguay","2024-02-03",0,0,0,0,0,0,0,0
"Paraguay","2024-02-04",0,0,0,0,0,0,0,0
"Paraguay","2024-02-05",0,0,0,0,0,0,0,0
"Paraguay","2024-02-06",0,0,0,0,0,0,0,0
"Paraguay","2024-02-07",0,0,0,0,0,0,0,0
"Paraguay","2024-02-08",0,0,0,0,0,0,0,0
"Paraguay","2024-02-09",0,0,0,0,0,0,0,0
"Paraguay","2024-02-10",0,0,0,0,0,0,0,0
"Paraguay","2024-02-11",0,0,0,0,0,0,0,0
"Paraguay","2024-02-12",0,0,0,0,0,0,0,0
"Paraguay","2024-02-13",0,0,0,0,0,0,0,0
"Paraguay","2024-02-14",0,0,0,0,0,0,0,0
"Paraguay","2024-02-15",0,0,0,0,0,0,0,0
"Paraguay","2024-02-16",0,0,0,0,0,0,0,0
"Paraguay","2024-02-17",0,0,0,0,0,0,0,0
"Paraguay","2024-02-18",0,0,0,0,0,0,0,0
"Paraguay","2024-02-19",0,0,0,0,0,0,0,0
"Paraguay","2024-02-20",0,0,0,0,0,0,0,0
"Paraguay","2024-02-21",0,0,0,0,0,0,0,0
"Paraguay","2024-02-22",0,0,0,0,0,0,0,0
"Paraguay","2024-02-23",0,0,0,0,0,0,0,0
"Paraguay","2024-02-24",0,0,0,0,0,0,0,0
"Paraguay","2024-02-25",0,0,0,0,0,0,0,0
"Paraguay","2024-02-26",0,0,0,0,0,0,0,0
"Paraguay","2024-02-27",0,0,0,0,0,0,0,0
"Paraguay","2024-02-28",0,0,0,0,0,0,0,0
"Paraguay","2024-02-29",0,0,0,0,0,0,0,0
"Paraguay","2024-03-01",0,0,0,0,0,0,0,0
"Paraguay","2024-03-02",0,0,0,0,0,0,0,0
"Paraguay","2024-03-03",0,0,0,0,0,0,0,0
"Paraguay","2024-03-04",0,0,0,0,0,0,0,0
"Paraguay","2024-03-05",0,0,0,0,0,0,0,0
"Paraguay","2024-03-06",0,0,0,0,0,0,0,0
"Paraguay","2024-03-07",0,0,0,0,0,0,0,0
"Paraguay","2024-03-08",0,0,0,0,0,0,0,0
"Paraguay","2024-03-09",0,0,0,0,0,0,0,0
"Paraguay","2024-03-10",0,0,0,0,0,0,0,0
"Paraguay","2024-03-11",0,0,0,0,0,0,0,0
"Paraguay","2024-03-12",0,0,0,0,0,0,0,0
"Paraguay","2024-03-13",0,0,0,0,0,0,0,0
"Paraguay","2024-03-14",0,0,0,0,0,0,0,0
"Paraguay","2024-03-15",0,0,0,0,0,0,0,0
"Paraguay","2024-03-16",0,0,0,0,0,0,0,0
"Paraguay","2024-03-17",0,0,0,0,0,0,0,0
"Paraguay","2024-03-18",0,0,0,0,0,0,0,0
"Paraguay","2024-03-19",0,0,0,0,0,0,0,0
"Paraguay","2024-03-20",0,0,0,0,0,0,0,0
"Paraguay","2024-03-21",0,0,0,0,0,0,0,0
"Paraguay","2024-03-22",0,0,0,0,0,0,0,0
"Paraguay","2024-03-23",0,0,0,0,0,0,0,0
"Paraguay","2024-03-24",0,0,0,0,0,0,0,0
"Paraguay","2024-03-25",0,0,0,0,0,0,0,0
"Paraguay","2024-03-26",0,0,0,0,0,0,0,0
"Paraguay","2024-03-27",0,0,0,0,0,0,0,0
"Paraguay","2024-03-28",0,0,0,0,0,0,0,0
"Paraguay","2024-03-29",0,0,0,0,0,0,0,0
"Paraguay","2024-03-30",0,0,0,0,0,0,0,0
"Paraguay","2024-03-31",0,0,0,0,0,0,0,0
"Paraguay","2024-04-01",0,0,0,0,0,0,0,0
"Paraguay","2024-04-02",0,0,0,0,0,0,0,0
"Paraguay","2024-04-03",0,0,0,0,0,0,0,0
"Paraguay","2024-04-04",0,0,0,0,0,0,0,0
"Paraguay","2024-04-05",0,0,0,0,0,0,0,0
"Paraguay","2024-04-06",0,0,0,0,0,0,0,0
"Paraguay","2024-04-07",0,0,0,0,0,0,0,0
"Paraguay","2024-04-08",0,0,0,0,0,0,0,0
"Paraguay","2024-04-09",0,0,0,0,0,0,0,0
"Paraguay","2024-04-10",0,0,0,0,0,0,0,0
"Paraguay","2024-04-11",0,0,0,0,0,0,0,0
"Paraguay","2024-04-12",0,0,0,0,0,0,0,0
"Paraguay","2024-04-13",0,0,0,0,0,0,0,0
"Paraguay","2024-04-14",0,0,0,0,0,0,0,0
"Paraguay","2024-04-15",0,0,0,0,0,0,0,0
"Paraguay","2024-04-16",0,0,0,0,0,0,0,0
"Paraguay","2024-04-17",0,0,0,0,0,0,0,0
"Paraguay","2024-04-18",0,0,0,0,0,0,0,0
"Paraguay","2024-04-19",0,0,0,0,0,0,0,0
"Paraguay","2024-04-20",0,0,0,0,0,0,0,0
"Paraguay","2024-04-21",0,0,0,0,0,0,0,0
"Paraguay","2024-04-22",0,0,0,0,0,0,0,0
"Paraguay","2024-04-23",0,0,0,0,0,0,0,0
"Paraguay","2024-04-24",0,0,0,0,0,0,0,0
"Paraguay","2024-04-25",0,0,0,0,0,0,0,0
"Paraguay","2024-04-26",0,0,0,0,0,0,0,0
"Paraguay","2024-04-27",0,0,0,0,0,0,0,0
"Paraguay","2024-04-28",0,0,0,0,0,0,0,0
"Paraguay","2024-04-29",0,0,0,0,0,0,0,0
"Paraguay","2024-04-30",0,0,0,0,0,0,0,0
"Paraguay","2024-05-01",0,0,0,0,0,0,0,0
"Paraguay","2024-05-02",0,0,0,0,0,0,0,0
"Paraguay","2024-05-03",0,0,0,0,0,0,0,0
"Paraguay","2024-05-04",0,0,0,0,0,0,0,0
"Paraguay","2024-05-05",0,0,0,0,0,0,0,0
"Paraguay","2024-05-06",0,0,0,0,0,0,0,0
"Paraguay","2024-05-07",0,0,0,0,0,0,0,0
"Paraguay","2024-05-08",0,0,0,0,0,0,0,0
"Paraguay","2024-05-09",0,0,0,0,0,0,0,0
"Paraguay","2024-05-10",0,0,0,0,0,0,0,0
"Paraguay","2024-05-11",0,0,0,0,0,0,0,0
"Paraguay","2024-05-12",0,0,0,0,0,0,0,0
"Paraguay","2024-05-13",0,0,0,0,0,0,0,0
"Paraguay","2024-05-14",0,0,0,0,0,0,0,0
"Paraguay","2024-05-15",0,0,0,0,0,0,0,0
"Paraguay","2024-05-16",0,0,0,0,0,0,0,0
"Paraguay","2024-05-17",0,0,0,0,0,0,0,0
"Paraguay","2024-05-18",0,0,0,0,0,0,0,0
"Paraguay","2024-05-19",0,0,0,0,0,0,0,0
"Paraguay","2024-05-20",0,0,0,0,0,0,0,0
"Paraguay","2024-05-21",0,0,0,0,0,0,0,0
"Paraguay","2024-05-22",0,0,0,0,0,0,0,0
"Paraguay","2024-05-23",0,0,0,0,0,0,0,0
"Paraguay","2024-05-24",0,0,0,0,0,0,0,0
"Paraguay","2024-05-25",0,0,0,0,0,0,0,0
"Paraguay","2024-05-26",0,0,0,0,0,0,0,0
"Paraguay","2024-05-27",0,0,0,0,0,0,0,0
"Paraguay","2024-05-28",0,0,0,0,0,0,0,0
"Paraguay","2024-05-29",0,0,0,0,0,0,0,0
"Paraguay","2024-05-30",0,0,0,0,0,0,0,0
"Paraguay","2024-05-31",0,0,0,0,0,0,0,0
"Paraguay","2024-06-01",0,0,0,0,0,0,0,0
"Paraguay","2024-06-02",0,0,0,0,0,0,0,0
"Paraguay","2024-06-03",0,0,0,0,0,0,0,0
"Paraguay","2024-06-04",0,0,0,0,0,0,0,0
"Paraguay","2024-06-05",0,0,0,0,0,0,0,0
"Paraguay","2024-06-06",0,0,0,0,0,0,0,0
"Paraguay","2024-06-07",0,0,0,0,0,0,0,0
"Paraguay","2024-06-08",0,0,0,0,0,0,0,0
"Paraguay","2024-06-09",0,0,0,0,0,0,0,0
"Paraguay","2024-06-10",0,0,0,0,0,0,0,0
"Paraguay","2024-06-11",0,0,0,0,0,0,0,0
"Paraguay","2024-06-12",0,0,0,0,0,0,0,0
"Paraguay","2024-06-13",0,0,0,0,0,0,0,0
"Paraguay","2024-06-14",0,0,0,0,0,0,0,0
"Paraguay","2024-06-15",0,0,0,0,0,0,0,0
"Paraguay","2024-06-16",0,0,0,0,0,0,0,0
"Paraguay","2024-06-17",0,0,0,0,0,0,0,0
"Paraguay","2024-06-18",0,0,0,0,0,0,0,0
"Paraguay","2024-06-19",0,0,0,0,0,0,0,0
"Paraguay","2024-06-20",0,0,0,0,0,0,0,0
"Paraguay","2024-06-21",0,0,0,0,0,0,0,0
"Paraguay","2024-06-22",0,0,0,0,0,0,0,0
"Paraguay","2024-06-23",0,0,0,0,0,0,0,0
"Paraguay","2024-06-24",0,0,0,0,0,0,0,0
"Paraguay","2024-06-25",0,0,0,0,0,0,0,0
"Paraguay","2024-06-26",0,0,0,0,0,0,0,0
"Paraguay","2024-06-27",0,0,0,0,0,0,0,0
"Paraguay","2024-06-28",0,0,0,0,0,0,0,0
"Paraguay","2024-06-29",0,0,0,0,0,0,0,0
"Paraguay","2024-06-30",0,0,0,0,0,0,0,0
"Paraguay","2024-07-01",0,0,0,0,0,0,0,0
"Paraguay","2024-07-02",0,0,0,0,0,0,0,0
"Paraguay","2024-07-03",0,0,0,0,0,0,0,0
"Paraguay","2024-07-04",0,0,0,0,0,0,0,0
"Paraguay","2024-07-05",0,0,0,0,0,0,0,0
"Paraguay","2024-07-06",0,0,0,0,0,0,0,0
"Paraguay","2024-07-07",0,0,0,0,0,0,0,0
"Paraguay","2024-07-08",0,0,0,0,0,0,0,0
"Paraguay","2024-07-09",0,0,0,0,0,0,0,0
"Paraguay","2024-07-10",0,0,0,0,0,0,0,0
"Paraguay","2024-07-11",0,0,0,0,0,0,0,0
"Paraguay","2024-07-12",0,0,0,0,0,0,0,0
"Paraguay","2024-07-13",0,0,0,0,0,0,0,0
"Paraguay","2024-07-14",0,0,0,0,0,0,0,0
"Paraguay","2024-07-15",0,0,0,0,0,0,0,0
"Paraguay","2024-07-16",0,0,0,0,0,0,0,0
"Paraguay","2024-07-17",0,0,0,0,0,0,0,0
"Paraguay","2024-07-18",0,0,0,0,0,0,0,0
"Paraguay","2024-07-19",0,0,0,0,0,0,0,0
"Paraguay","2024-07-20",0,0,0,0,0,0,0,0
"Paraguay","2024-07-21",0,0,0,0,0,0,0,0
"Paraguay","2024-07-22",0,0,0,0,0,0,0,0
"Paraguay","2024-07-23",0,0,0,0,0,0,0,0
"Paraguay","2024-07-24",0,0,0,0,0,0,0,0
"Paraguay","2024-07-25",0,0,0,0,0,0,0,0
"Paraguay","2024-07-26",0,0,0,0,0,0,0,0
"Paraguay","2024-07-27",0,0,0,0,0,0,0,0
"Paraguay","2024-07-28",0,0,0,0,0,0,0,0
"Paraguay","2024-07-29",0,0,0,0,0,0,0,0
"Paraguay","2024-07-30",0,0,0,0,0,0,0,0
"Paraguay","2024-07-31",0,0,0,0,0,0,0,0
"Paraguay","2024-08-01",0,0,0,0,0,0,0,0
"Paraguay","2024-08-02",0,0,0,0,0,0,0,0
"Paraguay","2024-08-03",0,0,0,0,0,0,0,0
"Paraguay","2024-08-04",0,0,0,0,0,0,0,0
"Paraguay","2024-08-05",0,0,0,0,0,0,0,0
"Paraguay","2024-08-06",0,0,0,0,0,0,0,0
"Paraguay","2024-08-07",0,0,0,0,0,0,0,0
"Paraguay","2024-08-08",0,0,0,0,0,0,0,0
"Paraguay","2024-08-09",0,0,0,0,0,0,0,0
"Paraguay","2024-08-10",0,0,0,0,0,0,0,0
"Paraguay","2024-08-11",0,0,0,0,0,0,0,0
"Paraguay","2024-08-12",0,0,0,0,0,0,0,0
"Paraguay","2024-08-13",0,0,0,0,0,0,0,0
"Paraguay","2024-08-14",0,0,0,0,0,0,0,0
"Paraguay","2024-08-15",0,0,0,0,0,0,0,0
"Paraguay","2024-08-16",0,0,0,0,0,0,0,0
"Paraguay","2024-08-17",0,0,0,0,0,0,0,0
"Paraguay","2024-08-18",0,0,0,0,0,0,0,0
"Paraguay","2024-08-19",0,0,0,0,0,0,0,0
"Paraguay","2024-08-20",0,0,0,0,0,0,0,0
"Paraguay","2024-08-21",0,0,0,0,0,0,0,0
"Paraguay","2024-08-22",0,0,0,0,0,0,0,0
"Paraguay","2024-08-23",0,0,0,0,0,0,0,0
"Paraguay","2024-08-24",0,0,0,0,0,0,0,0
"Paraguay","2024-08-25",0,0,0,0,0,0,0,0
"Paraguay","2024-08-26",0,0,0,0,0,0,0,0
"Paraguay","2024-08-27",0,0,0,0,0,0,0,0
"Paraguay","2024-08-28",0,0,0,0,0,0,0,0
"Paraguay","2024-08-29",0,0,0,0,0,0,0,0
"Paraguay","2024-08-30",0,0,0,0,0,0,0,0
"Paraguay","2024-08-31",0,0,0,0,0,0,0,0
"Paraguay","2024-09-01",0,0,0,0,0,0,0,0
"Paraguay","2024-09-02",0,0,0,0,0,0,0,0
"Paraguay","2024-09-03",0,0,0,0,0,0,0,0
"Paraguay","2024-09-04",0,0,0,0,0,0,0,0
"Paraguay","2024-09-05",0,0,0,0,0,0,0,0
"Paraguay","2024-09-06",0,0,0,0,0,0,0,0
"Paraguay","2024-09-07",0,0,0,0,0,0,0,0
"Paraguay","2024-09-08",0,0,0,0,0,0,0,0
"Paraguay","2024-09-09",0,0,0,0,0,0,0,0
"Paraguay","2024-09-10",0,0,0,0,0,0,0,0
"Paraguay","2024-09-11",0,0,0,0,0,0,0,0
"Paraguay","2024-09-12",0,0,0,0,0,0,0,0
"Paraguay","2024-09-13",0,0,0,0,0,0,0,0
"Paraguay","2024-09-14",0,0,0,0,0,0,0,0
"Paraguay","2024-09-15",0,0,0,0,0,0,0,0
"Paraguay","2024-09-16",0,0,0,0,0,0,0,0
"Paraguay","2024-09-17",0,0,0,0,0,0,0,0
"Paraguay","2024-09-18",0,0,0,0,0,0,0,0
"Paraguay","2024-09-19",0,0,0,0,0,0,0,0
"Paraguay","2024-09-20",0,0,0,0,0,0,0,0
"Paraguay","2024-09-21",0,0,0,0,0,0,0,0
"Paraguay","2024-09-22",0,0,0,0,0,0,0,0
"Paraguay","2024-09-23",0,0,0,0,0,0,0,0
"Paraguay","2024-09-24",0,0,0,0,0,0,0,0
"Paraguay","2024-09-25",0,0,0,0,0,0,0,0
"Paraguay","2024-09-26",0,0,0,0,0,0,0,0
"Paraguay","2024-09-27",0,0,0,0,0,0,0,0
"Paraguay","2024-09-28",0,0,0,0,0,0,0,0
"Paraguay","2024-09-29",0,0,0,0,0,0,0,0
"Paraguay","2024-09-30",0,0,0,0,0,0,0,0
"Paraguay","2024-10-01",0,0,0,0,0,0,0,0
"Paraguay","2024-10-02",0,0,0,0,0,0,0,0
"Paraguay","2024-10-03",0,0,0,0,0,0,0,0
"Paraguay","2024-10-04",0,0,0,0,0,0,0,0
"Paraguay","2024-10-05",0,0,0,0,0,0,0,0
"Paraguay","2024-10-06",0,0,0,0,0,0,0,0
"Paraguay","2024-10-07",0,0,0,0,0,0,0,0
"Paraguay","2024-10-08",0,0,0,0,0,0,0,0
"Paraguay","2024-10-09",0,0,0,0,0,0,0,0
"Paraguay","2024-10-10",0,0,0,0,0,0,0,0
"Paraguay","2024-10-11",0,0,0,0,0,0,0,0
"Paraguay","2024-10-12",0,0,0,0,0,0,0,0
"Paraguay","2024-10-13",0,0,0,0,0,0,0,0
"Paraguay","2024-10-14",0,0,0,0,0,0,0,0
"Paraguay","2024-10-15",0,0,0,0,0,0,0,0
"Paraguay","2024-10-16",0,0,0,0,0,0,0,0
"Paraguay","2024-10-17",0,0,0,0,0,0,0,0
"Paraguay","2024-10-18",0,0,0,0,0,0,0,0
"Paraguay","2024-10-19",0,0,0,0,0,0,0,0
"Paraguay","2024-10-20",0,0,0,0,0,0,0,0
"Paraguay","2024-10-21",0,0,0,0,0,0,0,0
"Paraguay","2024-10-22",0,0,0,0,0,0,0,0
"Paraguay","2024-10-23",0,0,0,0,0,0,0,0
"Paraguay","2024-10-24",0,0,0,0,0,0,0,0
"Paraguay","2024-10-25",0,0,0,0,0,0,0,0
"Paraguay","2024-10-26",0,0,0,0,0,0,0,0
"Paraguay","2024-10-27",0,0,0,0,0,0,0,0
"Paraguay","2024-10-28",0,0,0,0,0,0,0,0
"Paraguay","2024-10-29",0,0,0,0,0,0,0,0
"Paraguay","2024-10-30",0,0,0,0,0,0,0,0
"Paraguay","2024-10-31",0,0,0,0,0,0,0,0
"Paraguay","2024-11-01",0,0,0,0,0,0,0,0
"Paraguay","2024-11-02",0,0,0,0,0,0,0,0
"Paraguay","2024-11-03",0,0,0,0,0,0,0,0
"Paraguay","2024-11-04",0,0,0,0,0,0,0,0
"Paraguay","2024-11-05",0,0,0,0,0,0,0,0
"Paraguay","2024-11-06",0,0,0,0,0,0,0,0
"Paraguay","2024-11-07",0,0,0,0,0,0,0,0
"Paraguay","2024-11-08",0,0,0,0,0,0,0,0
"Paraguay","2024-11-09",0,0,0,0,0,0,0,0
"Paraguay","2024-11-10",0,0,0,0,0,0,0,0
"Paraguay","2024-11-11",0,0,0,0,0,0,0,0
"Paraguay","2024-11-12",0,0,0,0,0,0,0,0
"Paraguay","2024-11-13",0,0,0,0,0,0,0,0
"Paraguay","2024-11-14",0,0,0,0,0,0,0,0
"Paraguay","2024-11-15",0,0,0,0,0,0,0,0
"Paraguay","2024-11-16",0,0,0,0,0,0,0,0
"Paraguay","2024-11-17",0,0,0,0,0,0,0,0
"Paraguay","2024-11-18",0,0,0,0,0,0,0,0
"Paraguay","2024-11-19",0,0,0,0,0,0,0,0
"Paraguay","2024-11-20",0,0,0,0,0,0,0,0
"Paraguay","2024-11-21",0,0,0,0,0,0,0,0
"Paraguay","2024-11-22",0,0,0,0,0,0,0,0
"Paraguay","2024-11-23",0,0,0,0,0,0,0,0
"Paraguay","2024-11-24",0,0,0,0,0,0,0,0
"Paraguay","2024-11-25",0,0,0,0,0,0,0,0
"Paraguay","2024-11-26",0,0,0,0,0,0,0,0
"Paraguay","2024-11-27",0,0,0,0,0,0,0,0
"Paraguay","2024-11-28",0,0,0,0,0,0,0,0
"Paraguay","2024-11-29",0,0,0,0,0,0,0,0
"Paraguay","2024-11-30",0,0,0,0,0,0,0,0
"Paraguay","2024-12-01",0,0,0,0,0,0,0,0
"Paraguay","2024-12-02",0,0,0,0,0,0,0,0
"Paraguay","2024-12-03",0,0,0,0,0,0,0,0
"Paraguay","2024-12-04",0,0,0,0,0,0,0,0
"Paraguay","2024-12-05",0,0,0,0,0,0,0,0
"Paraguay","2024-12-06",0,0,0,0,0,0,0,0
"Paraguay","2024-12-07",0,0,0,0,0,0,0,0
"Paraguay","2024-12-08",0,0,0,0,0,0,0,0
"Paraguay","2024-12-09",0,0,0,0,0,0,0,0
"Paraguay","2024-12-10",0,0,0,0,0,0,0,0
"Paraguay","2024-12-11",0,0,0,0,0,0,0,0
"Paraguay","2024-12-12",0,0,0,0,0,0,0,0
"Paraguay","2024-12-13",0,0,0,0,0,0,0,0
"Paraguay","2024-12-14",0,0,0,0,0,0,0,0
"Paraguay","2024-12-15",0,0,0,0,0,0,0,0
"Paraguay","2024-12-16",0,0,0,0,0,0,0,0
"Paraguay","2024-12-17",0,0,0,0,0,0,0,0
"Paraguay","2024-12-18",0,0,0,0,0,0,0,0
"Paraguay","2024-12-19",0,0,0,0,0,0,0,0
"Paraguay","2024-12-20",0,0,0,0,0,0,0,0
"Paraguay","2024-12-21",0,0,0,0,0,0,0,0
"Paraguay","2024-12-22",0,0,0,0,0,0,0,0
"Paraguay","2024-12-23",0,0,0,0,0,0,0,0
"Paraguay","2024-12-24",0,0,0,0,0,0,0,0
"Paraguay","2024-12-25",0,0,0,0,0,0,0,0
"Paraguay","2024-12-26",0,0,0,0,0,0,0,0
"Paraguay","2024-12-27",0,0,0,0,0,0,0,0
"Paraguay","2024-12-28",0,0,0,0,0,0,0,0
"Paraguay","2024-12-29",0,0,0,0,0,0,0,0
"Paraguay","2024-12-30",0,0,0,0,0,0,0,0
"Paraguay","2024-12-31",0,0,0,0,0,0,0,0
"Paraguay","2025-01-01",0,0,0,0,0,0,0,0
"Paraguay","2025-01-02",0,0,0,0,0,0,0,0
"Paraguay","2025-01-03",0,0,0,0,0,0,0,0
"Paraguay","2025-01-04",0,0,0,0,0,0,0,0
"Paraguay","2025-01-05",0,0,0,0,0,0,0,0
"Paraguay","2025-01-06",0,0,0,0,0,0,0,0
"Paraguay","2025-01-07",0,0,0,0,0,0,0,0
"Paraguay","2025-01-08",0,0,0,0,0,0,0,0
"Paraguay","2025-01-09",0,0,0,0,0,0,0,0
"Paraguay","2025-01-10",0,0,0,0,0,0,0,0
"Paraguay","2025-01-11",0,0,0,0,0,0,0,0
"Paraguay","2025-01-12",0,0,0,0,0,0,0,0
"Paraguay","2025-01-13",0,0,0,0,0,0,0,0
"Paraguay","2025-01-14",0,0,0,0,0,0,0,0
"Paraguay","2025-01-15",0,0,0,0,0,0,0,0
"Paraguay","2025-01-16",0,0,0,0,0,0,0,0
"Paraguay","2025-01-17",0,0,0,0,0,0,0,0
"Paraguay","2025-01-18",0,0,0,0,0,0,0,0
"Paraguay","2025-01-19",0,0,0,0,0,0,0,0
"Paraguay","2025-01-20",0,0,0,0,0,0,0,0
"Paraguay","2025-01-21",0,0,0,0,0,0,0,0
"Paraguay","2025-01-22",0,0,0,0,0,0,0,0
"Paraguay","2025-01-23",0,0,0,0,0,0,0,0
"Paraguay","2025-01-24",0,0,0,0,0,0,0,0
"Paraguay","2025-01-25",0,0,0,0,0,0,0,0
"Paraguay","2025-01-26",0,0,0,0,0,0,0,0
"Paraguay","2025-01-27",0,0,0,0,0,0,0,0
"Paraguay","2025-01-28",0,0,0,0,0,0,0,0
"Paraguay","2025-01-29",0,0,0,0,0,0,0,0
"Paraguay","2025-01-30",0,0,0,0,0,0,0,0
"Paraguay","2025-01-31",0,0,0,0,0,0,0,0
"Paraguay","2025-02-01",0,0,0,0,0,0,0,0
"Paraguay","2025-02-02",0,0,0,0,0,0,0,0
"Paraguay","2025-02-03",0,0,0,0,0,0,0,0
"Peru","2024-01-01",0,0,0,0,0,0,0,0
"Peru","2024-01-02",0,2,2,0,2,2,0,0
"Peru","2024-01-03",0,0,2,0,0,2,0,0
"Peru","2024-01-04",0,0,2,0,0,2,0,0
"Peru","2024-01-05",0,0,2,0,0,2,0,0
"Peru","2024-01-06",0,0,2,0,1,3,0,0
"Peru","2024-01-07",0,0,2,0,0,3,0,0
"Peru","2024-01-08",0,0,2,0,0,3,0,0
"Peru","2024-01-09",0,1,3,0,0,3,0,0
"Peru","2024-01-10",0,0,3,0,0,3,0,0
"Peru","2024-01-11",0,0,3,0,1,4,0,0
"Peru","2024-01-12",0,0,3,0,0,4,0,0
"Peru","2024-01-13",0,0,3,0,0,4,0,0
"Peru","2024-01-14",0,0,3,0,0,4,0,0
"Peru","2024-01-15",0,0,3,0,1,5,0,0
"Peru","2024-01-16",0,2,5,0,0,5,0,0
"Peru","2024-01-17",0,0,5,0,0,5,0,0
"Peru","2024-01-18",0,0,5,0,0,5,0,0
"Peru","2024-01-19",0,0,5,0,1,6,0,0
"Peru","2024-01-20",0,0,5,0,0,6,0,0
"Peru","2024-01-21",0,0,5,0,0,6,0,0
"Peru","2024-01-22",0,0,5,0,0,6,0,0
"Peru","2024-01-23",0,0,5,0,1,7,0,0
"Peru","2024-01-24",0,0,5,0,0,7,0,0
"Peru","2024-01-25",0,0,5,0,0,7,0,0
"Peru","2024-01-26",0,0,5,0,0,7,0,0
"Peru","2024-01-27",0,0,5,0,0,7,0,0
"Peru","2024-01-28",0,0,5,0,1,8,0,0
"Peru","2024-01-29",0,0,5,0,0,8,0,0
"Peru","2024-01-30",0,3,8,0,0,8,0,0
"Peru","2024-01-31",0,0,8,0,0,8,0,0
"Peru","2024-02-01",0,0,8,0,0,8,0,0
"Peru","2024-02-02",0,0,8,0,0,8,0,0
"Peru","2024-02-03",0,0,8,0,1,9,0,0
"Peru","2024-02-04",0,0,8,0,0,9,0,0
"Peru","2024-02-05",0,0,8,0,0,9,0,0
"Peru","2024-02-06",0,1,9,0,0,9,0,0
"Peru","2024-02-07",0,0,9,0,0,9,0,0
"Peru","2024-02-08",0,0,9,0,1,10,0,0
"Peru","2024-02-09",0,0,9,0,0,10,0,0
"Peru","2024-02-10",0,0,9,0,0,10,0,0
"Peru","2024-02-11",0,0,9,0,0,10,0,0
"Peru","2024-02-12",0,0,9,0,1,11,0,0
"Peru","2024-02-13",0,2,11,0,0,11,0,0
"Peru","2024-02-14",0,0,11,0,0,11,0,0
"Peru","2024-02-15",0,0,11,0,1,12,0,0
"Peru","2024-02-16",0,0,11,0,0,12,0,0
"Peru","2024-02-17",0,0,11,0,0,12,0,0
"Peru","2024-02-18",0,0,11,0,0,12,0,0
"Peru","2024-02-19",0,0,11,0,1,13,0,0
"Peru","2024-02-20",0,2,13,0,0,13,0,0
"Peru","2024-02-21",0,0,13,0,1,14,0,0
"Peru","2024-02-22",0,0,13,0,0,14,0,0
"Peru","2024-02-23",0,0,13,0,1,15,0,0
"Peru","2024-02-24",0,0,13,0,1,16,0,0
"Peru","2024-02-25",0,0,13,0,1,17,0,0
"Peru","2024-02-26",0,0,13,0,0,17,0,0
"Peru","2024-02-27",0,5,18,0,1,18,0,0
"Peru","2024-02-28",0,0,18,0,0,18,0,0
"Peru","2024-02-29",0,0,18,0,1,19,0,0
"Peru","2024-03-01",0,0,18,0,0,19,0,0
"Peru","2024-03-02",0,0,18,0,0,19,0,0
"Peru","2024-03-03",0,0,18,0,0,19,0,0
"Peru","2024-03-04",0,0,18,0,1,20,0,0
"Peru","2024-03-05",0,2,20,0,0,20,0,0
"Peru","2024-03-06",0,0,20,0,0,20,0,0
"Peru","2024-03-07",0,0,20,0,1,21,0,0
"Peru","2024-03-08",0,0,20,0,0,21,0,0
"Peru","2024-03-09",0,0,20,0,0,21,0,0
"Peru","2024-03-10",0,0,20,0,0,21,0,0
"Peru","2024-03-11",0,0,20,0,1,22,0,0
"Peru","2024-03-12",0,2,22,0,0,22,0,0
"Peru","2024-03-13",0,0,22,0,1,23,0,0
"Peru","2024-03-14",0,0,22,0,0,23,0,0
"Peru","2024-03-15",0,0,22,0,1,24,0,0
"Peru","2024-03-16",0,0,22,0,1,25,0,0
"Peru","2024-03-17",0,0,22,0,1,26,0,0
"Peru","2024-03-18",0,0,22,0,0,26,0,0
"Peru","2024-03-19",0,5,27,0,1,27,0,0
"Peru","2024-03-20",0,0,27,0,1,28,0,0
"Peru","2024-03-21",0,0,27,0,0,28,0,0
"Peru","2024-03-22",0,0,27,0,1,29,0,0
"Peru","2024-03-23",0,0,27,0,1,30,0,0
"Peru","2024-03-24",0,0,27,0,1,31,0,0
"Peru","2024-03-25",0,0,27,0,0,31,0,0
"Peru","2024-03-26",0,5,32,0,1,32,0,0
"Peru","2024-03-27",0,0,32,0,0,32,0,0
"Peru","2024-03-28",0,0,32,0,0,32,0,0
"Peru","2024-03-29",0,0,32,0,0,32,0,0
"Peru","2024-03-30",0,0,32,0,0,32,0,0
"Peru","2024-03-31",0,0,32,0,0,32,0,0
"Peru","2024-04-01",0,0,32,0,0,32,0,0
"Peru","2024-04-02",0,0,32,0,0,32,0,0
"Peru","2024-04-03",0,0,32,0,1,33,0,0
"Peru","2024-04-04",0,0,32,0,0,33,0,0
"Peru","2024-04-05",0,0,32,0,0,33,0,0
"Peru","2024-04-06",0,0,32,0,0,33,0,0
"Peru","2024-04-07",0,0,32,0,0,33,0,0
"Peru","2024-04-08",0,0,32,0,0,33,0,0
"Peru","2024-04-09",0,1,33,0,0,33,0,0
"Peru","2024-04-10",0,0,33,0,1,34,0,0
"Peru","2024-04-11",0,0,33,0,1,35,0,0
"Peru","2024-04-12",0,0,33,0,1,36,0,0
"Peru","2024-04-13",0,0,33,0,0,36,0,0
"Peru","2024-04-14",0,0,33,0,1,37,0,0
"Peru","2024-04-15",0,0,33,0,1,38,0,0
"Peru","2024-04-16",0,6,39,0,1,39,0,0
"Peru","2024-04-17",0,0,39,0,0,39,0,0
"Peru","2024-04-18",0,0,39,0,1,40,0,0
"Peru","2024-04-19",0,0,39,0,0,40,0,0
"Peru","2024-04-20",0,0,39,0,1,41,0,0
"Peru","2024-04-21",0,0,39,0,0,41,0,0
"Peru","2024-04-22",0,0,39,0,1,42,0,0
"Peru","2024-04-23",0,3,42,0,0,42,0,0
"Peru","2024-04-24",0,0,42,0,1,43,0,0
"Peru","2024-04-25",0,0,42,0,0,43,0,0
"Peru","2024-04-26",0,0,42,0,1,44,0,0
"Peru","2024-04-27",0,0,42,0,0,44,0,0
"Peru","2024-04-28",0,0,42,0,1,45,0,0
"Peru","2024-04-29",0,0,42,0,0,45,0,0
"Peru","2024-04-30",0,4,46,0,1,46,0,0
"Peru","2024-05-01",0,0,46,0,0,46,0,0
"Peru","2024-05-02",0,0,46,0,1,47,0,0
"Peru","2024-05-03",0,0,46,0,0,47,0,0
"Peru","2024-05-04",0,0,46,0,1,48,0,0
"Peru","2024-05-05",0,0,46,0,0,48,0,0
"Peru","2024-05-06",0,0,46,0,1,49,0,0
"Peru","2024-05-07",0,3,49,0,0,49,0,0
"Peru","2024-05-08",0,0,49,0,0,49,0,0
"Peru","2024-05-09",0,0,49,0,1,50,0,0
"Peru","2024-05-10",0,0,49,0,0,50,0,0
"Peru","2024-05-11",0,0,49,0,0,50,0,0
"Peru","2024-05-12",0,0,49,0,0,50,0,0
"Peru","2024-05-13",0,0,49,0,1,51,0,0
"Peru","2024-05-14",0,2,51,0,0,51,0,0
"Peru","2024-05-15",0,0,51,0,0,51,0,0
"Peru","2024-05-16",0,0,51,0,0,51,0,0
"Peru","2024-05-17",0,0,51,0,0,51,0,0
"Peru","2024-05-18",0,0,51,0,1,52,0,0
"Peru","2024-05-19",0,0,51,0,0,52,0,0
"Peru","2024-05-20",0,0,51,0,0,52,0,0
"Peru","2024-05-21",0,1,52,0,0,52,0,0
"Peru","2024-05-22",0,0,52,0,1,53,0,0
"Peru","2024-05-23",0,0,52,0,0,53,0,0
"Peru","2024-05-24",0,0,52,0,1,54,0,0
"Peru","2024-05-25",0,0,52,0,1,55,0,0
"Peru","2024-05-26",0,0,52,0,1,56,0,0
"Peru","2024-05-27",0,0,52,0,0,56,0,0
"Peru","2024-05-28",0,5,57,0,1,57,0,0
"Peru","2024-05-29",0,0,57,0,0,57,0,0
"Peru","2024-05-30",0,0,57,0,1,58,0,0
"Peru","2024-05-31",0,0,57,0,0,58,0,0
"Peru","2024-06-01",0,0,57,0,0,58,0,0
"Peru","2024-06-02",0,0,57,0,0,58,0,0
"Peru","2024-06-03",0,0,57,0,1,59,0,0
"Peru","2024-06-04",0,2,59,0,0,59,0,0
"Peru","2024-06-05",0,0,59,0,1,60,0,0
"Peru","2024-06-06",0,0,59,0,0,60,0,0
"Peru","2024-06-07",0,0,59,0,1,61,0,0
"Peru","2024-06-08",0,0,59,0,0,61,0,0
"Peru","2024-06-09",0,0,59,0,1,62,0,0
"Peru","2024-06-10",0,0,59,0,0,62,0,0
"Peru","2024-06-11",0,4,63,0,1,63,0,0
"Peru","2024-06-12",0,0,63,0,0,63,0,0
"Peru","2024-06-13",0,0,63,0,1,64,0,0
"Peru","2024-06-14",0,0,63,0,0,64,0,0
"Peru","2024-06-15",0,0,63,0,0,64,0,0
"Peru","2024-06-16",0,0,63,0,0,64,0,0
"Peru","2024-06-17",0,0,63,0,1,65,0,0
"Peru","2024-06-18",0,2,65,0,0,65,0,0
"Peru","2024-06-19",0,0,65,0,0,65,0,0
"Peru","2024-06-20",0,0,65,0,0,65,0,0
"Peru","2024-06-21",0,0,65,0,0,65,0,0
"Peru","2024-06-22",0,0,65,0,1,66,0,0
"Peru","2024-06-23",0,0,65,0,0,66,0,0
"Peru","2024-06-24",0,0,65,0,0,66,0,0
"Peru","2024-06-25",0,1,66,0,0,66,0,0
"Peru","2024-06-26",0,0,66,0,1,67,0,0
"Peru","2024-06-27",0,0,66,0,1,68,0,0
"Peru","2024-06-28",0,0,66,0,1,69,0,0
"Peru","2024-06-29",0,0,66,0,0,69,0,0
"Peru","2024-06-30",0,0,66,0,1,70,0,0
"Peru","2024-07-01",0,0,66,0,1,71,0,0
"Peru","2024-07-02",0,6,72,0,1,72,0,0
"Peru","2024-07-03",0,0,72,0,1,73,0,0
"Peru","2024-07-04",0,0,72,0,0,73,0,0
"Peru","2024-07-05",0,0,72,0,1,74,0,0
"Peru","2024-07-06",0,0,72,0,0,74,0,0
"Peru","2024-07-07",0,0,72,0,1,75,0,0
"Peru","2024-07-08",0,0,72,0,0,75,0,0
"Peru","2024-07-09",0,4,76,0,1,76,0,0
"Peru","2024-07-10",0,0,76,0,0,76,0,0
"Peru","2024-07-11",0,0,76,0,1,77,0,0
"Peru","2024-07-12",0,0,76,0,0,77,0,0
"Peru","2024-07-13",0,0,76,0,1,78,0,0
"Peru","2024-07-14",0,0,76,0,0,78,0,0
"Peru","2024-07-15",0,0,76,0,1,79,0,0
"Peru","2024-07-16",0,3,79,0,0,79,0,0
"Peru","2024-07-17",0,0,79,0,0,79,0,0
"Peru","2024-07-18",0,0,79,0,1,80,0,0
"Peru","2024-07-19",0,0,79,0,0,80,0,0
"Peru","2024-07-20",0,0,79,0,0,80,0,0
"Peru","2024-07-21",0,0,79,0,0,80,0,0
"Peru","2024-07-22",0,0,79,0,1,81,0,0
"Peru","2024-07-23",0,2,81,0,0,81,0,0
"Peru","2024-07-24",0,0,81,0,0,81,0,0
"Peru","2024-07-25",0,0,81,0,1,82,0,0
"Peru","2024-07-26",0,0,81,0,0,82,0,0
"Peru","2024-07-27",0,0,81,0,0,82,0,0
"Peru","2024-07-28",0,0,81,0,0,82,0,0
"Peru","2024-07-29",0,0,81,0,1,83,0,0
"Peru","2024-07-30",0,2,83,0,0,83,0,0
"Peru","2024-07-31",0,0,83,0,0,83,0,0
"Peru","2024-08-01",0,0,83,0,0,83,0,0
"Peru","2024-08-02",0,0,83,0,0,83,0,0
"Peru","2024-08-03",0,0,83,0,0,83,0,0
"Peru","2024-08-04",0,0,83,0,0,83,0,0
"Peru","2024-08-05",0,0,83,0,0,83,0,0
"Peru","2024-08-06",0,0,83,0,0,83,0,0
"Peru","2024-08-07",0,0,83,0,1,84,0,0
"Peru","2024-08-08",0,0,83,0,0,84,0,0
"Peru","2024-08-09",0,0,83,0,0,84,0,0
"Peru","2024-08-10",0,0,83,0,0,84,0,0
"Peru","2024-08-11",0,0,83,0,0,84,0,0
"Peru","2024-08-12",0,0,83,0,0,84,0,0
"Peru","2024-08-13",0,1,84,0,0,84,0,0
"Peru","2024-08-14",0,0,84,0,0,84,0,0
"Peru","2024-08-15",0,0,84,0,0,84,0,0
"Peru","2024-08-16",0,0,84,0,0,84,0,0
"Peru","2024-08-17",0,0,84,0,1,85,0,0
"Peru","2024-08-18",0,0,84,0,0,85,0,0
"Peru","2024-08-19",0,0,84,0,0,85,0,0
"Peru","2024-08-20",0,1,85,0,0,85,0,0
"Peru","2024-08-21",0,0,85,0,0,85,0,0
"Peru","2024-08-22",0,0,85,0,0,85,0,0
"Peru","2024-08-23",0,0,85,0,0,85,0,0
"Peru","2024-08-24",0,0,85,0,1,86,0,0
"Peru","2024-08-25",0,0,85,0,0,86,0,0
"Peru","2024-08-26",0,0,85,0,0,86,0,0
"Peru","2024-08-27",0,1,86,0,0,86,0,0
"Peru","2024-08-28",0,0,86,0,0,86,0,0
"Peru","2024-08-29",0,0,86,0,0,86,0,0
"Peru","2024-08-30",0,0,86,0,0,86,0,0
"Peru","2024-08-31",0,0,86,0,0,86,0,0
"Peru","2024-09-01",0,0,86,0,0,86,0,0
"Peru","2024-09-02",0,0,86,0,0,86,0,0
"Peru","2024-09-03",0,0,86,0,0,86,0,0
"Peru","2024-09-04",0,0,86,0,1,87,0,0
"Peru","2024-09-05",0,0,86,0,0,87,0,0
"Peru","2024-09-06",0,0,86,0,0,87,0,0
"Peru","2024-09-07",0,0,86,0,0,87,0,0
"Peru","2024-09-08",0,0,86,0,0,87,0,0
"Peru","2024-09-09",0,0,86,0,0,87,0,0
"Peru","2024-09-10",0,1,87,0,0,87,0,0
"Peru","2024-09-11",0,0,87,0,0,87,0,0
"Peru","2024-09-12",0,0,87,0,1,88,0,0
"Peru","2024-09-13",0,0,87,0,0,88,0,0
"Peru","2024-09-14",0,0,87,0,0,88,0,0
"Peru","2024-09-15",0,0,87,0,0,88,0,0
"Peru","2024-09-16",0,0,87,0,1,89,0,0
"Peru","2024-09-17",0,2,89,0,0,89,0,0
"Peru","2024-09-18",0,0,89,0,0,89,0,0
"Peru","2024-09-19",0,0,89,0,0,89,0,0
"Peru","2024-09-20",0,0,89,0,0,89,0,0
"Peru","2024-09-21",0,0,89,0,0,89,0,0
"Peru","2024-09-22",0,0,89,0,0,89,0,0
"Peru","2024-09-23",0,0,89,0,0,89,0,0
"Peru","2024-09-24",0,0,89,0,0,89,0,0
"Peru","2024-09-25",0,0,89,0,1,90,0,0
"Peru","2024-09-26",0,0,89,0,0,90,0,0
"Peru","2024-09-27",0,0,89,0,0,90,0,0
"Peru","2024-09-28",0,0,89,0,0,90,0,0
"Peru","2024-09-29",0,0,89,0,0,90,0,0
"Peru","2024-09-30",0,0,89,0,0,90,0,0
"Peru","2024-10-01",0,1,90,0,0,90,0,0
"Peru","2024-10-02",0,0,90,0,0,90,0,0
"Peru","2024-10-03",0,0,90,0,0,90,0,0
"Peru","2024-10-04",0,0,90,0,0,90,0,0
"Peru","2024-10-05",0,0,90,0,0,90,0,0
"Peru","2024-10-06",0,0,90,0,0,90,0,0
"Peru","2024-10-07",0,0,90,0,0,90,0,0
"Peru","2024-10-08",0,0,90,0,0,90,0,0
"Peru","2024-10-09",0,0,90,0,0,90,0,0
"Peru","2024-10-10",0,0,90,0,0,90,0,0
"Peru","2024-10-11",0,0,90,0,0,90,0,0
"Peru","2024-10-12",0,0,90,0,0,90,0,0
"Peru","2024-10-13",0,0,90,0,0,90,0,0
"Peru","2024-10-14",0,0,90,0,0,90,0,0
"Peru","2024-10-15",0,0,90,0,0,90,0,0
"Peru","2024-10-16",0,0,90,0,0,90,0,0
"Peru","2024-10-17",0,0,90,0,0,90,0,0
"Peru","2024-10-18",0,0,90,0,0,90,0,0
"Peru","2024-10-19",0,0,90,0,0,90,0,0
"Peru","2024-10-20",0,0,90,0,0,90,0,0
"Peru","2024-10-21",0,0,90,0,0,90,0,0
"Peru","2024-10-22",0,0,90,0,0,90,0,0
"Peru","2024-10-23",0,0,90,0,0,90,0,0
"Peru","2024-10-24",0,0,90,0,0,90,0,0
"Peru","2024-10-25",0,0,90,0,0,90,0,0
"Peru","2024-10-26",0,0,90,0,0,90,0,0
"Peru","2024-10-27",0,0,90,0,0,90,0,0
"Peru","2024-10-28",0,0,90,0,0,90,0,0
"Peru","2024-10-29",0,0,90,0,0,90,0,0
"Peru","2024-10-30",0,0,90,0,0,90,0,0
"Peru","2024-10-31",0,0,90,0,0,90,0,0
"Peru","2024-11-01",0,0,90,0,0,90,0,0
"Peru","2024-11-02",0,0,90,0,0,90,0,0
"Peru","2024-11-03",0,0,90,0,0,90,0,0
"Peru","2024-11-04",0,0,90,0,0,90,0,0
"Peru","2024-11-05",0,0,90,0,0,90,0,0
"Peru","2024-11-06",0,0,90,0,0,90,0,0
"Peru","2024-11-07",0,0,90,0,0,90,0,0
"Peru","2024-11-08",0,0,90,0,0,90,0,0
"Peru","2024-11-09",0,0,90,0,0,90,0,0
"Peru","2024-11-10",0,0,90,0,0,90,0,0
"Peru","2024-11-11",0,0,90,0,0,90,0,0
"Peru","2024-11-12",0,0,90,0,0,90,0,0
"Peru","2024-11-13",0,0,90,0,0,90,0,0
"Peru","2024-11-14",0,0,90,0,0,90,0,0
"Peru","2024-11-15",0,0,90,0,0,90,0,0
"Peru","2024-11-16",0,0,90,0,0,90,0,0
"Peru","2024-11-17",0,0,90,0,0,90,0,0
"Peru","2024-11-18",0,0,90,0,0,90,0,0
"Peru","2024-11-19",0,0,90,0,0,90,0,0
"Peru","2024-11-20",0,0,90,0,0,90,0,0
"Peru","2024-11-21",0,0,90,0,0,90,0,0
"Peru","2024-11-22",0,0,90,0,0,90,0,0
"Peru","2024-11-23",0,0,90,0,0,90,0,0
"Peru","2024-11-24",0,0,90,0,0,90,0,0
"Peru","2024-11-25",0,0,90,0,0,90,0,0
"Peru","2024-11-26",0,0,90,0,0,90,0,0
"Peru","2024-11-27",0,0,90,0,0,90,0,0
"Peru","2024-11-28",0,0,90,0,0,90,0,0
"Peru","2024-11-29",0,0,90,0,0,90,0,0
"Peru","2024-11-30",0,0,90,0,0,90,0,0
"Peru","2024-12-01",0,0,90,0,0,90,0,0
"Peru","2024-12-02",0,0,90,0,0,90,0,0
"Peru","2024-12-03",0,0,90,0,0,90,0,0
"Peru","2024-12-04",0,0,90,0,0,90,0,0
"Peru","2024-12-05",0,0,90,0,0,90,0,0
"Peru","2024-12-06",0,0,90,0,0,90,0,0
"Peru","2024-12-07",0,0,90,0,0,90,0,0
"Peru","2024-12-08",0,0,90,0,0,90,0,0
"Peru","2024-12-09",0,0,90,0,0,90,0,0
"Peru","2024-12-10",0,0,90,0,0,90,0,0
"Peru","2024-12-11",0,0,90,0,0,90,0,0
"Peru","2024-12-12",0,0,90,0,0,90,0,0
"Peru","2024-12-13",0,0,90,0,0,90,0,0
"Peru","2024-12-14",0,0,90,0,0,90,0,0
"Peru","2024-12-15",0,0,90,0,0,90,0,0
"Peru","2024-12-16",0,0,90,0,0,90,0,0
"Peru","2024-12-17",0,0,90,0,0,90,0,0
"Peru","2024-12-18",0,0,90,0,0,90,0,0
"Peru","2024-12-19",0,0,90,0,0,90,0,0
"Peru","2024-12-20",0,0,90,0,0,90,0,0
"Peru","2024-12-21",0,0,90,0,0,90,0,0
"Peru","2024-12-22",0,0,90,0,0,90,0,0
"Peru","2024-12-23",0,0,90,0,0,90,0,0
"Peru","2024-12-24",0,0,90,0,0,90,0,0
"Peru","2024-12-25",0,0,90,0,0,90,0,0
"Peru","2024-12-26",0,0,90,0,0,90,0,0
"Peru","2024-12-27",0,0,90,0,0,90,0,0
"Peru","2024-12-28",0,0,90,0,0,90,0,0
"Peru","2024-12-29",0,0,90,0,0,90,0,0
"Peru","2024-12-30",0,0,90,0,0,90,0,0
"Peru","2024-12-31",0,0,90,0,0,90,0,0
"Peru","2025-01-01",0,0,90,0,0,90,0,0
"Peru","2025-01-02",0,0,90,0,0,90,0,0
"Peru","2025-01-03",0,0,90,0,0,90,0,0
"Peru","2025-01-04",0,0,90,0,0,90,0,0
"Peru","2025-01-05",0,0,90,0,0,90,0,0
"Peru","2025-01-06",0,0,90,0,0,90,0,0
"Peru","2025-01-07",0,0,90,0,0,90,0,0
"Peru","2025-01-08",0,0,90,0,0,90,0,0
"Peru","2025-01-09",0,0,90,0,0,90,0,0
"Peru","2025-01-10",0,0,90,0,0,90,0,0
"Peru","2025-01-11",0,0,90,0,0,90,0,0
"Peru","2025-01-12",0,0,90,0,0,90,0,0
"Peru","2025-01-13",0,0,90,0,0,90,0,0
"Peru","2025-01-14",0,0,90,0,0,90,0,0
"Peru","2025-01-15",0,0,90,0,0,90,0,0
"Peru","2025-01-16",0,0,90,0,0,90,0,0
"Peru","2025-01-17",0,0,90,0,0,90,0,0
"Peru","2025-01-18",0,0,90,0,0,90,0,0
"Peru","2025-01-19",0,0,90,0,0,90,0,0
"Peru","2025-01-20",0,0,90,0,0,90,0,0
"Peru","2025-01-21",0,0,90,0,0,90,0,0
"Peru","2025-01-22",0,0,90,0,0,90,0,0
"Peru","2025-01-23",0,0,90,0,0,90,0,0
"Peru","2025-01-24",0,0,90,0,0,90,0,0
"Peru","2025-01-25",0,0,90,0,0,90,0,0
"Peru","2025-01-26",0,0,90,0,0,90,0,0
"Peru","2025-01-27",0,0,90,0,0,90,0,0
"Peru","2025-01-28",0,0,90,0,0,90,0,0
"Peru","2025-01-29",0,0,90,0,0,90,0,0
"Peru","2025-01-30",0,0,90,0,0,90,0,0
"Peru","2025-01-31",0,0,90,0,0,90,0,0
"Peru","2025-02-01",0,0,90,0,0,90,0,0
"Peru","2025-02-02",0,0,90,0,0,90,0,0
"Peru","2025-02-03",0,0,90,0,0,90,0,0
"Philippines","2024-01-01",0,0,0,0,0,0,0,0
"Philippines","2024-01-02",0,0,0,0,0,0,0,0
"Philippines","2024-01-03",0,0,0,0,0,0,0,0
"Philippines","2024-01-04",0,0,0,0,0,0,0,0
"Philippines","2024-01-05",0,0,0,0,0,0,0,0
"Philippines","2024-01-06",0,0,0,0,0,0,0,0
"Philippines","2024-01-07",0,0,0,0,0,0,0,0
"Philippines","2024-01-08",0,0,0,0,0,0,0,0
"Philippines","2024-01-09",0,0,0,0,0,0,0,0
"Philippines","2024-01-10",0,0,0,0,0,0,0,0
"Philippines","2024-01-11",0,0,0,0,0,0,0,0
"Philippines","2024-01-12",0,0,0,0,0,0,0,0
"Philippines","2024-01-13",0,0,0,0,0,0,0,0
"Philippines","2024-01-14",0,0,0,0,0,0,0,0
"Philippines","2024-01-15",0,0,0,0,0,0,0,0
"Philippines","2024-01-16",0,0,0,0,0,0,0,0
"Philippines","2024-01-17",0,0,0,0,0,0,0,0
"Philippines","2024-01-18",0,0,0,0,0,0,0,0
"Philippines","2024-01-19",0,0,0,0,0,0,0,0
"Philippines","2024-01-20",0,0,0,0,0,0,0,0
"Philippines","2024-01-21",0,0,0,0,0,0,0,0
"Philippines","2024-01-22",0,0,0,0,0,0,0,0
"Philippines","2024-01-23",0,0,0,0,0,0,0,0
"Philippines","2024-01-24",0,0,0,0,0,0,0,0
"Philippines","2024-01-25",0,0,0,0,0,0,0,0
"Philippines","2024-01-26",0,0,0,0,0,0,0,0
"Philippines","2024-01-27",0,0,0,0,0,0,0,0
"Philippines","2024-01-28",0,0,0,0,0,0,0,0
"Philippines","2024-01-29",0,0,0,0,0,0,0,0
"Philippines","2024-01-30",0,0,0,0,0,0,0,0
"Philippines","2024-01-31",0,0,0,0,0,0,0,0
"Philippines","2024-02-01",0,0,0,0,0,0,0,0
"Philippines","2024-02-02",0,0,0,0,0,0,0,0
"Philippines","2024-02-03",0,0,0,0,0,0,0,0
"Philippines","2024-02-04",0,0,0,0,0,0,0,0
"Philippines","2024-02-05",0,0,0,0,0,0,0,0
"Philippines","2024-02-06",0,0,0,0,0,0,0,0
"Philippines","2024-02-07",0,0,0,0,0,0,0,0
"Philippines","2024-02-08",0,0,0,0,0,0,0,0
"Philippines","2024-02-09",0,0,0,0,0,0,0,0
"Philippines","2024-02-10",0,0,0,0,0,0,0,0
"Philippines","2024-02-11",0,0,0,0,0,0,0,0
"Philippines","2024-02-12",0,0,0,0,0,0,0,0
"Philippines","2024-02-13",0,0,0,0,0,0,0,0
"Philippines","2024-02-14",0,0,0,0,0,0,0,0
"Philippines","2024-02-15",0,0,0,0,0,0,0,0
"Philippines","2024-02-16",0,0,0,0,0,0,0,0
"Philippines","2024-02-17",0,0,0,0,0,0,0,0
"Philippines","2024-02-18",0,0,0,0,0,0,0,0
"Philippines","2024-02-19",0,0,0,0,0,0,0,0
"Philippines","2024-02-20",0,0,0,0,0,0,0,0
"Philippines","2024-02-21",0,0,0,0,0,0,0,0
"Philippines","2024-02-22",0,0,0,0,0,0,0,0
"Philippines","2024-02-23",0,0,0,0,0,0,0,0
"Philippines","2024-02-24",0,0,0,0,0,0,0,0
"Philippines","2024-02-25",0,0,0,0,0,0,0,0
"Philippines","2024-02-26",0,0,0,0,0,0,0,0
"Philippines","2024-02-27",0,0,0,0,0,0,0,0
"Philippines","2024-02-28",0,0,0,0,0,0,0,0
"Philippines","2024-02-29",0,0,0,0,0,0,0,0
"Philippines","2024-03-01",0,0,0,0,0,0,0,0
"Philippines","2024-03-02",0,0,0,0,0,0,0,0
"Philippines","2024-03-03",0,0,0,0,0,0,0,0
"Philippines","2024-03-04",0,0,0,0,0,0,0,0
"Philippines","2024-03-05",0,0,0,0,0,0,0,0
"Philippines","2024-03-06",0,0,0,0,0,0,0,0
"Philippines","2024-03-07",0,0,0,0,0,0,0,0
"Philippines","2024-03-08",0,0,0,0,0,0,0,0
"Philippines","2024-03-09",0,0,0,0,0,0,0,0
"Philippines","2024-03-10",0,0,0,0,0,0,0,0
"Philippines","2024-03-11",0,0,0,0,0,0,0,0
"Philippines","2024-03-12",0,0,0,0,0,0,0,0
"Philippines","2024-03-13",0,0,0,0,0,0,0,0
"Philippines","2024-03-14",0,0,0,0,0,0,0,0
"Philippines","2024-03-15",0,0,0,0,0,0,0,0
"Philippines","2024-03-16",0,0,0,0,0,0,0,0
"Philippines","2024-03-17",0,0,0,0,0,0,0,0
"Philippines","2024-03-18",0,0,0,0,0,0,0,0
"Philippines","2024-03-19",0,0,0,0,0,0,0,0
"Philippines","2024-03-20",0,0,0,0,0,0,0,0
"Philippines","2024-03-21",0,0,0,0,0,0,0,0
"Philippines","2024-03-22",0,0,0,0,0,0,0,0
"Philippines","2024-03-23",0,0,0,0,0,0,0,0
"Philippines","2024-03-24",0,0,0,0,0,0,0,0
"Philippines","2024-03-25",0,0,0,0,0,0,0,0
"Philippines","2024-03-26",0,0,0,0,0,0,0,0
"Philippines","2024-03-27",0,0,0,0,0,0,0,0
"Philippines","2024-03-28",0,0,0,0,0,0,0,0
"Philippines","2024-03-29",0,0,0,0,0,0,0,0
"Philippines","2024-03-30",0,0,0,0,0,0,0,0
"Philippines","2024-03-31",0,0,0,0,0,0,0,0
"Philippines","2024-04-01",0,0,0,0,0,0,0,0
"Philippines","2024-04-02",0,0,0,0,0,0,0,0
"Philippines","2024-04-03",0,0,0,0,0,0,0,0
"Philippines","2024-04-04",0,0,0,0,0,0,0,0
"Philippines","2024-04-05",0,0,0,0,0,0,0,0
"Philippines","2024-04-06",0,0,0,0,0,0,0,0
"Philippines","2024-04-07",0,0,0,0,0,0,0,0
"Philippines","2024-04-08",0,0,0,0,0,0,0,0
"Philippines","2024-04-09",0,0,0,0,0,0,0,0
"Philippines","2024-04-10",0,0,0,0,0,0,0,0
"Philippines","2024-04-11",0,0,0,0,0,0,0,0
"Philippines","2024-04-12",0,0,0,0,0,0,0,0
"Philippines","2024-04-13",0,0,0,0,0,0,0,0
"Philippines","2024-04-14",0,0,0,0,0,0,0,0
"Philippines","2024-04-15",0,0,0,0,0,0,0,0
"Philippines","2024-04-16",0,0,0,0,0,0,0,0
"Philippines","2024-04-17",0,0,0,0,0,0,0,0
"Philippines","2024-04-18",0,0,0,0,0,0,0,0
"Philippines","2024-04-19",0,0,0,0,0,0,0,0
"Philippines","2024-04-20",0,0,0,0,0,0,0,0
"Philippines","2024-04-21",0,0,0,0,0,0,0,0
"Philippines","2024-04-22",0,0,0,0,0,0,0,0
"Philippines","2024-04-23",0,0,0,0,0,0,0,0
"Philippines","2024-04-24",0,0,0,0,0,0,0,0
"Philippines","2024-04-25",0,0,0,0,0,0,0,0
"Philippines","2024-04-26",0,0,0,0,0,0,0,0
"Philippines","2024-04-27",0,0,0,0,0,0,0,0
"Philippines","2024-04-28",0,0,0,0,0,0,0,0
"Philippines","2024-04-29",0,0,0,0,0,0,0,0
"Philippines","2024-04-30",0,0,0,0,0,0,0,0
"Philippines","2024-05-01",0,0,0,0,0,0,0,0
"Philippines","2024-05-02",0,0,0,0,0,0,0,0
"Philippines","2024-05-03",0,0,0,0,0,0,0,0
"Philippines","2024-05-04",0,0,0,0,0,0,0,0
"Philippines","2024-05-05",0,0,0,0,0,0,0,0
"Philippines","2024-05-06",0,0,0,0,0,0,0,0
"Philippines","2024-05-07",0,0,0,0,0,0,0,0
"Philippines","2024-05-08",0,0,0,0,0,0,0,0
"Philippines","2024-05-09",0,0,0,0,0,0,0,0
"Philippines","2024-05-10",0,0,0,0,0,0,0,0
"Philippines","2024-05-11",0,0,0,0,0,0,0,0
"Philippines","2024-05-12",0,0,0,0,0,0,0,0
"Philippines","2024-05-13",0,0,0,0,0,0,0,0
"Philippines","2024-05-14",0,0,0,0,0,0,0,0
"Philippines","2024-05-15",0,0,0,0,0,0,0,0
"Philippines","2024-05-16",0,0,0,0,0,0,0,0
"Philippines","2024-05-17",0,0,0,0,0,0,0,0
"Philippines","2024-05-18",0,0,0,0,0,0,0,0
"Philippines","2024-05-19",0,0,0,0,0,0,0,0
"Philippines","2024-05-20",0,0,0,0,0,0,0,0
"Philippines","2024-05-21",0,0,0,0,0,0,0,0
"Philippines","2024-05-22",0,0,0,0,0,0,0,0
"Philippines","2024-05-23",0,0,0,0,0,0,0,0
"Philippines","2024-05-24",0,0,0,0,0,0,0,0
"Philippines","2024-05-25",0,0,0,0,0,0,0,0
"Philippines","2024-05-26",0,0,0,0,0,0,0,0
"Philippines","2024-05-27",0,0,0,0,0,0,0,0
"Philippines","2024-05-28",0,0,0,0,0,0,0,0
"Philippines","2024-05-29",0,0,0,0,0,0,0,0
"Philippines","2024-05-30",0,0,0,0,0,0,0,0
"Philippines","2024-05-31",0,0,0,0,0,0,0,0
"Philippines","2024-06-01",0,0,0,0,0,0,0,0
"Philippines","2024-06-02",0,0,0,0,0,0,0,0
"Philippines","2024-06-03",0,0,0,0,0,0,0,0
"Philippines","2024-06-04",0,0,0,0,0,0,0,0
"Philippines","2024-06-05",0,0,0,0,0,0,0,0
"Philippines","2024-06-06",0,0,0,0,0,0,0,0
"Philippines","2024-06-07",0,0,0,0,0,0,0,0
"Philippines","2024-06-08",0,0,0,0,0,0,0,0
"Philippines","2024-06-09",0,0,0,0,0,0,0,0
"Philippines","2024-06-10",0,0,0,0,0,0,0,0
"Philippines","2024-06-11",0,0,0,0,0,0,0,0
"Philippines","2024-06-12",0,0,0,0,0,0,0,0
"Philippines","2024-06-13",0,0,0,0,0,0,0,0
"Philippines","2024-06-14",0,0,0,0,0,0,0,0
"Philippines","2024-06-15",0,0,0,0,0,0,0,0
"Philippines","2024-06-16",0,0,0,0,0,0,0,0
"Philippines","2024-06-17",0,0,0,0,0,0,0,0
"Philippines","2024-06-18",0,0,0,0,0,0,0,0
"Philippines","2024-06-19",0,0,0,0,0,0,0,0
"Philippines","2024-06-20",0,0,0,0,0,0,0,0
"Philippines","2024-06-21",0,0,0,0,0,0,0,0
"Philippines","2024-06-22",0,0,0,0,0,0,0,0
"Philippines","2024-06-23",0,0,0,0,0,0,0,0
"Philippines","2024-06-24",0,0,0,0,0,0,0,0
"Philippines","2024-06-25",0,0,0,0,0,0,0,0
"Philippines","2024-06-26",0,0,0,0,0,0,0,0
"Philippines","2024-06-27",0,0,0,0,0,0,0,0
"Philippines","2024-06-28",0,0,0,0,0,0,0,0
"Philippines","2024-06-29",0,0,0,0,0,0,0,0
"Philippines","2024-06-30",0,0,0,0,0,0,0,0
"Philippines","2024-07-01",0,0,0,0,0,0,0,0
"Philippines","2024-07-02",0,0,0,0,0,0,0,0
"Philippines","2024-07-03",0,0,0,0,0,0,0,0
"Philippines","2024-07-04",0,0,0,0,0,0,0,0
"Philippines","2024-07-05",0,0,0,0,0,0,0,0
"Philippines","2024-07-06",0,0,0,0,0,0,0,0
"Philippines","2024-07-07",0,0,0,0,0,0,0,0
"Philippines","2024-07-08",0,0,0,0,0,0,0,0
"Philippines","2024-07-09",0,0,0,0,0,0,0,0
"Philippines","2024-07-10",0,0,0,0,0,0,0,0
"Philippines","2024-07-11",0,0,0,0,0,0,0,0
"Philippines","2024-07-12",0,0,0,0,0,0,0,0
"Philippines","2024-07-13",0,0,0,0,0,0,0,0
"Philippines","2024-07-14",0,0,0,0,0,0,0,0
"Philippines","2024-07-15",0,0,0,0,0,0,0,0
"Philippines","2024-07-16",0,0,0,0,0,0,0,0
"Philippines","2024-07-17",0,0,0,0,0,0,0,0
"Philippines","2024-07-18",0,0,0,0,0,0,0,0
"Philippines","2024-07-19",0,0,0,0,0,0,0,0
"Philippines","2024-07-20",0,0,0,0,0,0,0,0
"Philippines","2024-07-21",0,0,0,0,0,0,0,0
"Philippines","2024-07-22",0,0,0,0,0,0,0,0
"Philippines","2024-07-23",0,0,0,0,0,0,0,0
"Philippines","2024-07-24",0,0,0,0,0,0,0,0
"Philippines","2024-07-25",0,0,0,0,0,0,0,0
"Philippines","2024-07-26",0,0,0,0,0,0,0,0
"Philippines","2024-07-27",0,0,0,0,0,0,0,0
"Philippines","2024-07-28",0,0,0,0,0,0,0,0
"Philippines","2024-07-29",0,0,0,0,0,0,0,0
"Philippines","2024-07-30",0,0,0,0,0,0,0,0
"Philippines","2024-07-31",0,0,0,0,0,0,0,0
"Philippines","2024-08-01",0,0,0,0,0,0,0,0
"Philippines","2024-08-02",0,0,0,0,0,0,0,0
"Philippines","2024-08-03",0,0,0,0,0,0,0,0
"Philippines","2024-08-04",0,0,0,0,0,0,0,0
"Philippines","2024-08-05",0,0,0,0,0,0,0,0
"Philippines","2024-08-06",0,0,0,0,0,0,0,0
"Philippines","2024-08-07",0,0,0,0,0,0,0,0
"Philippines","2024-08-08",0,0,0,0,0,0,0,0
"Philippines","2024-08-09",0,0,0,0,0,0,0,0
"Philippines","2024-08-10",0,0,0,0,0,0,0,0
"Philippines","2024-08-11",0,0,0,0,0,0,0,0
"Philippines","2024-08-12",0,0,0,0,0,0,0,0
"Philippines","2024-08-13",0,0,0,0,0,0,0,0
"Philippines","2024-08-14",0,0,0,0,0,0,0,0
"Philippines","2024-08-15",0,0,0,0,0,0,0,0
"Philippines","2024-08-16",0,0,0,0,0,0,0,0
"Philippines","2024-08-17",0,0,0,0,0,0,0,0
"Philippines","2024-08-18",0,0,0,0,0,0,0,0
"Philippines","2024-08-19",0,1,1,0,1,1,0,0
"Philippines","2024-08-20",0,0,1,0,0,1,0,0
"Philippines","2024-08-21",0,0,1,0,1,2,0,0
"Philippines","2024-08-22",0,0,1,0,0,2,0,0
"Philippines","2024-08-23",0,0,1,0,1,3,0,0
"Philippines","2024-08-24",0,0,1,0,0,3,0,0
"Philippines","2024-08-25",0,0,1,0,1,4,0,0
"Philippines","2024-08-26",0,0,1,0,0,4,0,0
"Philippines","2024-08-27",0,0,1,0,1,5,0,0
"Philippines","2024-08-28",0,4,5,0,0,5,0,0
"Philippines","2024-08-29",0,0,5,0,1,6,0,0
"Philippines","2024-08-30",0,0,5,0,1,7,0,0
"Philippines","2024-08-31",0,0,5,0,0,7,0,0
"Philippines","2024-09-01",0,3,8,0,1,8,0,0
"Philippines","2024-09-02",0,0,8,0,1,9,0,0
"Philippines","2024-09-03",0,0,8,0,0,9,0,0
"Philippines","2024-09-04",0,0,8,0,1,10,0,0
"Philippines","2024-09-05",0,0,8,0,0,10,0,0
"Philippines","2024-09-06",0,0,8,0,1,11,0,0
"Philippines","2024-09-07",0,0,8,0,1,12,0,0
"Philippines","2024-09-08",0,0,8,0,0,12,0,0
"Philippines","2024-09-09",0,0,8,0,1,13,0,0
"Philippines","2024-09-10",0,0,8,0,0,13,0,0
"Philippines","2024-09-11",0,0,8,0,1,14,0,0
"Philippines","2024-09-12",0,0,8,0,1,15,0,0
"Philippines","2024-09-13",0,0,8,0,0,15,0,0
"Philippines","2024-09-14",0,0,8,0,1,16,0,0
"Philippines","2024-09-15",0,0,8,0,0,16,0,0
"Philippines","2024-09-16",0,0,8,0,1,17,0,0
"Philippines","2024-09-17",0,0,8,0,1,18,0,0
"Philippines","2024-09-18",0,0,8,0,0,18,0,0
"Philippines","2024-09-19",0,0,8,0,1,19,0,0
"Philippines","2024-09-20",0,0,8,0,0,19,0,0
"Philippines","2024-09-21",0,0,8,0,1,20,0,0
"Philippines","2024-09-22",0,0,8,0,1,21,0,0
"Philippines","2024-09-23",0,0,8,0,0,21,0,0
"Philippines","2024-09-24",0,0,8,0,1,22,0,0
"Philippines","2024-09-25",0,0,8,0,0,22,0,0
"Philippines","2024-09-26",0,15,23,0,1,23,0,0
"Philippines","2024-09-27",0,0,23,0,0,23,0,0
"Philippines","2024-09-28",0,0,23,0,1,24,0,0
"Philippines","2024-09-29",0,0,23,0,0,24,0,0
"Philippines","2024-09-30",0,0,23,0,1,25,0,0
"Philippines","2024-10-01",0,0,23,0,0,25,0,0
"Philippines","2024-10-02",0,0,23,0,0,25,0,0
"Philippines","2024-10-03",0,0,23,0,1,26,0,0
"Philippines","2024-10-04",0,0,23,0,0,26,0,0
"Philippines","2024-10-05",0,0,23,0,0,26,0,0
"Philippines","2024-10-06",0,0,23,0,1,27,0,0
"Philippines","2024-10-07",0,0,23,0,0,27,0,0
"Philippines","2024-10-08",0,0,23,0,1,28,0,0
"Philippines","2024-10-09",0,0,23,0,0,28,0,0
"Philippines","2024-10-10",0,0,23,0,0,28,0,0
"Philippines","2024-10-11",0,0,23,0,1,29,0,0
"Philippines","2024-10-12",0,0,23,0,0,29,0,0
"Philippines","2024-10-13",0,0,23,0,1,30,0,0
"Philippines","2024-10-14",0,0,23,0,0,30,0,0
"Philippines","2024-10-15",0,0,23,0,0,30,0,0
"Philippines","2024-10-16",0,0,23,0,1,31,0,0
"Philippines","2024-10-17",0,0,23,0,0,31,0,0
"Philippines","2024-10-18",0,0,23,0,1,32,0,0
"Philippines","2024-10-19",0,0,23,0,0,32,0,0
"Philippines","2024-10-20",0,0,23,0,0,32,0,0
"Philippines","2024-10-21",0,0,23,0,1,33,0,0
"Philippines","2024-10-22",0,0,23,0,0,33,0,0
"Philippines","2024-10-23",0,0,23,0,0,33,0,0
"Philippines","2024-10-24",0,0,23,0,1,34,0,0
"Philippines","2024-10-25",0,0,23,0,0,34,0,0
"Philippines","2024-10-26",0,0,23,0,1,35,0,0
"Philippines","2024-10-27",0,0,23,0,0,35,0,0
"Philippines","2024-10-28",0,0,23,0,0,35,0,0
"Philippines","2024-10-29",0,0,23,0,1,36,0,0
"Philippines","2024-10-30",0,0,23,0,0,36,0,0
"Philippines","2024-10-31",0,0,23,0,1,37,0,0
"Philippines","2024-11-01",0,0,23,0,0,37,0,0
"Philippines","2024-11-02",0,0,23,0,0,37,0,0
"Philippines","2024-11-03",0,0,23,0,1,38,0,0
"Philippines","2024-11-04",0,0,23,0,0,38,0,0
"Philippines","2024-11-05",0,0,23,0,0,38,0,0
"Philippines","2024-11-06",0,0,23,0,1,39,0,0
"Philippines","2024-11-07",0,0,23,0,0,39,0,0
"Philippines","2024-11-08",0,0,23,0,1,40,0,0
"Philippines","2024-11-09",0,0,23,0,0,40,0,0
"Philippines","2024-11-10",0,0,23,0,0,40,0,0
"Philippines","2024-11-11",0,0,23,0,1,41,0,0
"Philippines","2024-11-12",0,0,23,0,0,41,0,0
"Philippines","2024-11-13",0,0,23,0,1,42,0,0
"Philippines","2024-11-14",0,0,23,0,0,42,0,0
"Philippines","2024-11-15",0,0,23,0,0,42,0,0
"Philippines","2024-11-16",0,0,23,0,1,43,0,0
"Philippines","2024-11-17",0,0,23,0,0,43,0,0
"Philippines","2024-11-18",0,0,23,0,1,44,0,0
"Philippines","2024-11-19",0,0,23,0,0,44,0,0
"Philippines","2024-11-20",0,0,23,0,0,44,0,0
"Philippines","2024-11-21",0,0,23,0,1,45,0,0
"Philippines","2024-11-22",0,0,23,0,0,45,0,0
"Philippines","2024-11-23",0,0,23,0,0,45,0,0
"Philippines","2024-11-24",0,0,23,0,1,46,0,0
"Philippines","2024-11-25",0,0,23,0,0,46,0,0
"Philippines","2024-11-26",0,0,23,0,1,47,0,0
"Philippines","2024-11-27",0,24,47,0,0,47,0,0
"Philippines","2024-11-28",0,0,47,0,0,47,0,0
"Philippines","2024-11-29",0,0,47,0,0,47,0,0
"Philippines","2024-11-30",0,0,47,0,1,48,0,0
"Philippines","2024-12-01",0,0,47,0,0,48,0,0
"Philippines","2024-12-02",0,0,47,0,0,48,0,0
"Philippines","2024-12-03",0,0,47,0,0,48,0,0
"Philippines","2024-12-04",0,0,47,0,1,49,0,0
"Philippines","2024-12-05",0,0,47,0,0,49,0,0
"Philippines","2024-12-06",0,0,47,0,0,49,0,0
"Philippines","2024-12-07",0,0,47,0,0,49,0,0
"Philippines","2024-12-08",0,0,47,0,1,50,0,0
"Philippines","2024-12-09",0,0,47,0,0,50,0,0
"Philippines","2024-12-10",0,0,47,0,0,50,0,0
"Philippines","2024-12-11",0,0,47,0,0,50,0,0
"Philippines","2024-12-12",0,0,47,0,1,51,0,0
"Philippines","2024-12-13",0,0,47,0,0,51,0,0
"Philippines","2024-12-14",0,0,47,0,0,51,0,0
"Philippines","2024-12-15",0,0,47,0,0,51,0,0
"Philippines","2024-12-16",0,0,47,0,1,52,0,0
"Philippines","2024-12-17",0,0,47,0,0,52,0,0
"Philippines","2024-12-18",0,0,47,0,0,52,0,0
"Philippines","2024-12-19",0,0,47,0,0,52,0,0
"Philippines","2024-12-20",0,0,47,0,1,53,0,0
"Philippines","2024-12-21",0,0,47,0,0,53,0,0
"Philippines","2024-12-22",0,0,47,0,0,53,0,0
"Philippines","2024-12-23",0,0,47,0,0,53,0,0
"Philippines","2024-12-24",0,0,47,0,1,54,0,0
"Philippines","2024-12-25",0,0,47,0,0,54,0,0
"Philippines","2024-12-26",0,7,54,0,0,54,0,0
"Philippines","2024-12-27",0,0,54,0,0,54,0,0
"Philippines","2024-12-28",0,0,54,0,0,54,0,0
"Philippines","2024-12-29",0,0,54,0,0,54,0,0
"Philippines","2024-12-30",0,0,54,0,0,54,0,0
"Philippines","2024-12-31",0,0,54,0,0,54,0,0
"Philippines","2025-01-01",0,0,54,0,0,54,0,0
"Philippines","2025-01-02",0,0,54,0,0,54,0,0
"Philippines","2025-01-03",0,0,54,0,0,54,0,0
"Philippines","2025-01-04",0,0,54,0,0,54,0,0
"Philippines","2025-01-05",0,0,54,0,0,54,0,0
"Philippines","2025-01-06",0,0,54,0,0,54,0,0
"Philippines","2025-01-07",0,0,54,0,0,54,0,0
"Philippines","2025-01-08",0,0,54,0,0,54,0,0
"Philippines","2025-01-09",0,0,54,0,0,54,0,0
"Philippines","2025-01-10",0,0,54,0,0,54,0,0
"Philippines","2025-01-11",0,0,54,0,0,54,0,0
"Philippines","2025-01-12",0,0,54,0,0,54,0,0
"Philippines","2025-01-13",0,0,54,0,0,54,0,0
"Philippines","2025-01-14",0,0,54,0,0,54,0,0
"Philippines","2025-01-15",0,0,54,0,0,54,0,0
"Philippines","2025-01-16",0,0,54,0,0,54,0,0
"Philippines","2025-01-17",0,0,54,0,0,54,0,0
"Philippines","2025-01-18",0,0,54,0,0,54,0,0
"Philippines","2025-01-19",0,0,54,0,0,54,0,0
"Philippines","2025-01-20",0,0,54,0,0,54,0,0
"Philippines","2025-01-21",0,0,54,0,0,54,0,0
"Philippines","2025-01-22",0,0,54,0,0,54,0,0
"Philippines","2025-01-23",0,0,54,0,0,54,0,0
"Philippines","2025-01-24",0,0,54,0,0,54,0,0
"Philippines","2025-01-25",0,0,54,0,0,54,0,0
"Philippines","2025-01-26",0,0,54,0,0,54,0,0
"Philippines","2025-01-27",0,0,54,0,0,54,0,0
"Philippines","2025-01-28",0,0,54,0,0,54,0,0
"Philippines","2025-01-29",0,0,54,0,0,54,0,0
"Philippines","2025-01-30",0,0,54,0,0,54,0,0
"Philippines","2025-01-31",0,0,54,0,0,54,0,0
"Philippines","2025-02-01",0,0,54,0,0,54,0,0
"Philippines","2025-02-02",0,0,54,0,0,54,0,0
"Philippines","2025-02-03",0,0,54,0,0,54,0,0
"Poland","2024-01-01",0,0,0,0,0,0,0,0
"Poland","2024-01-02",0,0,0,0,0,0,0,0
"Poland","2024-01-03",0,0,0,0,0,0,0,0
"Poland","2024-01-04",0,0,0,0,0,0,0,0
"Poland","2024-01-05",0,0,0,0,0,0,0,0
"Poland","2024-01-06",0,0,0,0,0,0,0,0
"Poland","2024-01-07",0,0,0,0,0,0,0,0
"Poland","2024-01-08",0,0,0,0,0,0,0,0
"Poland","2024-01-09",0,0,0,0,0,0,0,0
"Poland","2024-01-10",0,0,0,0,0,0,0,0
"Poland","2024-01-11",0,0,0,0,0,0,0,0
"Poland","2024-01-12",0,0,0,0,0,0,0,0
"Poland","2024-01-13",0,0,0,0,0,0,0,0
"Poland","2024-01-14",0,0,0,0,0,0,0,0
"Poland","2024-01-15",0,0,0,0,0,0,0,0
"Poland","2024-01-16",0,0,0,0,0,0,0,0
"Poland","2024-01-17",0,0,0,0,0,0,0,0
"Poland","2024-01-18",0,0,0,0,0,0,0,0
"Poland","2024-01-19",0,0,0,0,0,0,0,0
"Poland","2024-01-20",0,0,0,0,0,0,0,0
"Poland","2024-01-21",0,0,0,0,0,0,0,0
"Poland","2024-01-22",0,0,0,0,0,0,0,0
"Poland","2024-01-23",0,0,0,0,0,0,0,0
"Poland","2024-01-24",0,0,0,0,0,0,0,0
"Poland","2024-01-25",0,0,0,0,0,0,0,0
"Poland","2024-01-26",0,0,0,0,0,0,0,0
"Poland","2024-01-27",0,0,0,0,0,0,0,0
"Poland","2024-01-28",0,0,0,0,0,0,0,0
"Poland","2024-01-29",0,0,0,0,0,0,0,0
"Poland","2024-01-30",0,0,0,0,0,0,0,0
"Poland","2024-01-31",0,3,3,0,3,3,0,0
"Poland","2024-02-01",0,0,3,0,0,3,0,0
"Poland","2024-02-02",0,0,3,0,0,3,0,0
"Poland","2024-02-03",0,0,3,0,0,3,0,0
"Poland","2024-02-04",0,0,3,0,0,3,0,0
"Poland","2024-02-05",0,0,3,0,0,3,0,0
"Poland","2024-02-06",0,0,3,0,0,3,0,0
"Poland","2024-02-07",0,0,3,0,0,3,0,0
"Poland","2024-02-08",0,0,3,0,0,3,0,0
"Poland","2024-02-09",0,0,3,0,0,3,0,0
"Poland","2024-02-10",0,0,3,0,0,3,0,0
"Poland","2024-02-11",0,0,3,0,0,3,0,0
"Poland","2024-02-12",0,0,3,0,0,3,0,0
"Poland","2024-02-13",0,0,3,0,0,3,0,0
"Poland","2024-02-14",0,0,3,0,0,3,0,0
"Poland","2024-02-15",0,0,3,0,0,3,0,0
"Poland","2024-02-16",0,0,3,0,0,3,0,0
"Poland","2024-02-17",0,0,3,0,0,3,0,0
"Poland","2024-02-18",0,0,3,0,0,3,0,0
"Poland","2024-02-19",0,0,3,0,0,3,0,0
"Poland","2024-02-20",0,0,3,0,0,3,0,0
"Poland","2024-02-21",0,0,3,0,0,3,0,0
"Poland","2024-02-22",0,0,3,0,0,3,0,0
"Poland","2024-02-23",0,0,3,0,0,3,0,0
"Poland","2024-02-24",0,0,3,0,0,3,0,0
"Poland","2024-02-25",0,0,3,0,0,3,0,0
"Poland","2024-02-26",0,0,3,0,0,3,0,0
"Poland","2024-02-27",0,0,3,0,0,3,0,0
"Poland","2024-02-28",0,0,3,0,0,3,0,0
"Poland","2024-02-29",0,0,3,0,0,3,0,0
"Poland","2024-03-01",0,0,3,0,0,3,0,0
"Poland","2024-03-02",0,0,3,0,1,4,0,0
"Poland","2024-03-03",0,0,3,0,0,4,0,0
"Poland","2024-03-04",0,0,3,0,0,4,0,0
"Poland","2024-03-05",0,0,3,0,0,4,0,0
"Poland","2024-03-06",0,0,3,0,0,4,0,0
"Poland","2024-03-07",0,0,3,0,0,4,0,0
"Poland","2024-03-08",0,0,3,0,0,4,0,0
"Poland","2024-03-09",0,0,3,0,0,4,0,0
"Poland","2024-03-10",0,0,3,0,0,4,0,0
"Poland","2024-03-11",0,0,3,0,0,4,0,0
"Poland","2024-03-12",0,0,3,0,0,4,0,0
"Poland","2024-03-13",0,0,3,0,0,4,0,0
"Poland","2024-03-14",0,0,3,0,0,4,0,0
"Poland","2024-03-15",0,0,3,0,0,4,0,0
"Poland","2024-03-16",0,0,3,0,0,4,0,0
"Poland","2024-03-17",0,0,3,0,0,4,0,0
"Poland","2024-03-18",0,0,3,0,0,4,0,0
"Poland","2024-03-19",0,0,3,0,0,4,0,0
"Poland","2024-03-20",0,0,3,0,0,4,0,0
"Poland","2024-03-21",0,0,3,0,0,4,0,0
"Poland","2024-03-22",0,0,3,0,0,4,0,0
"Poland","2024-03-23",0,0,3,0,0,4,0,0
"Poland","2024-03-24",0,0,3,0,0,4,0,0
"Poland","2024-03-25",0,0,3,0,0,4,0,0
"Poland","2024-03-26",0,0,3,0,0,4,0,0
"Poland","2024-03-27",0,0,3,0,0,4,0,0
"Poland","2024-03-28",0,0,3,0,0,4,0,0
"Poland","2024-03-29",0,0,3,0,0,4,0,0
"Poland","2024-03-30",0,0,3,0,0,4,0,0
"Poland","2024-03-31",0,1,4,0,0,4,0,0
"Poland","2024-04-01",0,0,4,0,0,4,0,0
"Poland","2024-04-02",0,0,4,0,0,4,0,0
"Poland","2024-04-03",0,0,4,0,0,4,0,0
"Poland","2024-04-04",0,0,4,0,0,4,0,0
"Poland","2024-04-05",0,0,4,0,0,4,0,0
"Poland","2024-04-06",0,0,4,0,0,4,0,0
"Poland","2024-04-07",0,0,4,0,0,4,0,0
"Poland","2024-04-08",0,0,4,0,0,4,0,0
"Poland","2024-04-09",0,0,4,0,0,4,0,0
"Poland","2024-04-10",0,0,4,0,0,4,0,0
"Poland","2024-04-11",0,0,4,0,0,4,0,0
"Poland","2024-04-12",0,0,4,0,0,4,0,0
"Poland","2024-04-13",0,0,4,0,0,4,0,0
"Poland","2024-04-14",0,0,4,0,0,4,0,0
"Poland","2024-04-15",0,0,4,0,0,4,0,0
"Poland","2024-04-16",0,0,4,0,1,5,0,0
"Poland","2024-04-17",0,0,4,0,0,5,0,0
"Poland","2024-04-18",0,0,4,0,0,5,0,0
"Poland","2024-04-19",0,0,4,0,0,5,0,0
"Poland","2024-04-20",0,0,4,0,0,5,0,0
"Poland","2024-04-21",0,0,4,0,0,5,0,0
"Poland","2024-04-22",0,0,4,0,0,5,0,0
"Poland","2024-04-23",0,0,4,0,0,5,0,0
"Poland","2024-04-24",0,0,4,0,0,5,0,0
"Poland","2024-04-25",0,0,4,0,0,5,0,0
"Poland","2024-04-26",0,0,4,0,0,5,0,0
"Poland","2024-04-27",0,0,4,0,0,5,0,0
"Poland","2024-04-28",0,0,4,0,0,5,0,0
"Poland","2024-04-29",0,0,4,0,0,5,0,0
"Poland","2024-04-30",0,0,4,0,0,5,0,0
"Poland","2024-05-01",0,0,4,0,0,5,0,0
"Poland","2024-05-02",0,0,4,0,0,5,0,0
"Poland","2024-05-03",0,0,4,0,0,5,0,0
"Poland","2024-05-04",0,0,4,0,0,5,0,0
"Poland","2024-05-05",0,0,4,0,0,5,0,0
"Poland","2024-05-06",0,0,4,0,0,5,0,0
"Poland","2024-05-07",0,0,4,0,0,5,0,0
"Poland","2024-05-08",0,0,4,0,0,5,0,0
"Poland","2024-05-09",0,0,4,0,0,5,0,0
"Poland","2024-05-10",0,0,4,0,0,5,0,0
"Poland","2024-05-11",0,0,4,0,0,5,0,0
"Poland","2024-05-12",0,0,4,0,0,5,0,0
"Poland","2024-05-13",0,0,4,0,0,5,0,0
"Poland","2024-05-14",0,0,4,0,0,5,0,0
"Poland","2024-05-15",0,0,4,0,0,5,0,0
"Poland","2024-05-16",0,0,4,0,1,6,0,0
"Poland","2024-05-17",0,0,4,0,0,6,0,0
"Poland","2024-05-18",0,0,4,0,0,6,0,0
"Poland","2024-05-19",0,0,4,0,0,6,0,0
"Poland","2024-05-20",0,0,4,0,0,6,0,0
"Poland","2024-05-21",0,0,4,0,0,6,0,0
"Poland","2024-05-22",0,0,4,0,0,6,0,0
"Poland","2024-05-23",0,0,4,0,0,6,0,0
"Poland","2024-05-24",0,0,4,0,0,6,0,0
"Poland","2024-05-25",0,0,4,0,0,6,0,0
"Poland","2024-05-26",0,0,4,0,0,6,0,0
"Poland","2024-05-27",0,0,4,0,0,6,0,0
"Poland","2024-05-28",0,0,4,0,0,6,0,0
"Poland","2024-05-29",0,0,4,0,0,6,0,0
"Poland","2024-05-30",0,0,4,0,0,6,0,0
"Poland","2024-05-31",0,2,6,0,0,6,0,0
"Poland","2024-06-01",0,0,6,0,0,6,0,0
"Poland","2024-06-02",0,0,6,0,0,6,0,0
"Poland","2024-06-03",0,0,6,0,0,6,0,0
"Poland","2024-06-04",0,0,6,0,0,6,0,0
"Poland","2024-06-05",0,0,6,0,0,6,0,0
"Poland","2024-06-06",0,0,6,0,0,6,0,0
"Poland","2024-06-07",0,0,6,0,0,6,0,0
"Poland","2024-06-08",0,0,6,0,0,6,0,0
"Poland","2024-06-09",0,0,6,0,0,6,0,0
"Poland","2024-06-10",0,0,6,0,0,6,0,0
"Poland","2024-06-11",0,0,6,0,0,6,0,0
"Poland","2024-06-12",0,0,6,0,0,6,0,0
"Poland","2024-06-13",0,0,6,0,0,6,0,0
"Poland","2024-06-14",0,0,6,0,0,6,0,0
"Poland","2024-06-15",0,0,6,0,0,6,0,0
"Poland","2024-06-16",0,0,6,0,0,6,0,0
"Poland","2024-06-17",0,0,6,0,0,6,0,0
"Poland","2024-06-18",0,0,6,0,0,6,0,0
"Poland","2024-06-19",0,0,6,0,0,6,0,0
"Poland","2024-06-20",0,0,6,0,0,6,0,0
"Poland","2024-06-21",0,0,6,0,0,6,0,0
"Poland","2024-06-22",0,0,6,0,0,6,0,0
"Poland","2024-06-23",0,0,6,0,0,6,0,0
"Poland","2024-06-24",0,0,6,0,1,7,0,0
"Poland","2024-06-25",0,0,6,0,0,7,0,0
"Poland","2024-06-26",0,0,6,0,0,7,0,0
"Poland","2024-06-27",0,0,6,0,0,7,0,0
"Poland","2024-06-28",0,0,6,0,0,7,0,0
"Poland","2024-06-29",0,0,6,0,0,7,0,0
"Poland","2024-06-30",0,0,6,0,0,7,0,0
"Poland","2024-07-01",0,0,6,0,0,7,0,0
"Poland","2024-07-02",0,0,6,0,0,7,0,0
"Poland","2024-07-03",0,0,6,0,0,7,0,0
"Poland","2024-07-04",0,0,6,0,0,7,0,0
"Poland","2024-07-05",0,0,6,0,0,7,0,0
"Poland","2024-07-06",0,0,6,0,0,7,0,0
"Poland","2024-07-07",0,0,6,0,0,7,0,0
"Poland","2024-07-08",0,0,6,0,0,7,0,0
"Poland","2024-07-09",0,0,6,0,0,7,0,0
"Poland","2024-07-10",0,0,6,0,0,7,0,0
"Poland","2024-07-11",0,0,6,0,0,7,0,0
"Poland","2024-07-12",0,0,6,0,0,7,0,0
"Poland","2024-07-13",0,0,6,0,0,7,0,0
"Poland","2024-07-14",0,0,6,0,0,7,0,0
"Poland","2024-07-15",0,0,6,0,0,7,0,0
"Poland","2024-07-16",0,0,6,0,0,7,0,0
"Poland","2024-07-17",0,0,6,0,0,7,0,0
"Poland","2024-07-18",0,0,6,0,0,7,0,0
"Poland","2024-07-19",0,0,6,0,0,7,0,0
"Poland","2024-07-20",0,0,6,0,0,7,0,0
"Poland","2024-07-21",0,0,6,0,0,7,0,0
"Poland","2024-07-22",0,0,6,0,0,7,0,0
"Poland","2024-07-23",0,0,6,0,0,7,0,0
"Poland","2024-07-24",0,0,6,0,0,7,0,0
"Poland","2024-07-25",0,0,6,0,0,7,0,0
"Poland","2024-07-26",0,0,6,0,0,7,0,0
"Poland","2024-07-27",0,0,6,0,0,7,0,0
"Poland","2024-07-28",0,0,6,0,0,7,0,0
"Poland","2024-07-29",0,0,6,0,0,7,0,0
"Poland","2024-07-30",0,0,6,0,0,7,0,0
"Poland","2024-07-31",0,0,6,0,0,7,0,0
"Poland","2024-08-01",0,0,6,0,0,7,0,0
"Poland","2024-08-02",0,0,6,0,0,7,0,0
"Poland","2024-08-03",0,0,6,0,0,7,0,0
"Poland","2024-08-04",0,0,6,0,0,7,0,0
"Poland","2024-08-05",0,0,6,0,0,7,0,0
"Poland","2024-08-06",0,0,6,0,0,7,0,0
"Poland","2024-08-07",0,0,6,0,0,7,0,0
"Poland","2024-08-08",0,0,6,0,1,8,0,0
"Poland","2024-08-09",0,0,6,0,0,8,0,0
"Poland","2024-08-10",0,0,6,0,0,8,0,0
"Poland","2024-08-11",0,0,6,0,0,8,0,0
"Poland","2024-08-12",0,0,6,0,0,8,0,0
"Poland","2024-08-13",0,0,6,0,0,8,0,0
"Poland","2024-08-14",0,0,6,0,0,8,0,0
"Poland","2024-08-15",0,0,6,0,0,8,0,0
"Poland","2024-08-16",0,0,6,0,0,8,0,0
"Poland","2024-08-17",0,0,6,0,0,8,0,0
"Poland","2024-08-18",0,0,6,0,0,8,0,0
"Poland","2024-08-19",0,0,6,0,0,8,0,0
"Poland","2024-08-20",0,0,6,0,0,8,0,0
"Poland","2024-08-21",0,0,6,0,0,8,0,0
"Poland","2024-08-22",0,0,6,0,0,8,0,0
"Poland","2024-08-23",0,0,6,0,0,8,0,0
"Poland","2024-08-24",0,0,6,0,0,8,0,0
"Poland","2024-08-25",0,0,6,0,0,8,0,0
"Poland","2024-08-26",0,0,6,0,0,8,0,0
"Poland","2024-08-27",0,0,6,0,0,8,0,0
"Poland","2024-08-28",0,0,6,0,0,8,0,0
"Poland","2024-08-29",0,0,6,0,0,8,0,0
"Poland","2024-08-30",0,0,6,0,0,8,0,0
"Poland","2024-08-31",0,2,8,0,0,8,0,0
"Poland","2024-09-01",0,0,8,0,0,8,0,0
"Poland","2024-09-02",0,0,8,0,0,8,0,0
"Poland","2024-09-03",0,0,8,0,0,8,0,0
"Poland","2024-09-04",0,0,8,0,0,8,0,0
"Poland","2024-09-05",0,0,8,0,0,8,0,0
"Poland","2024-09-06",0,0,8,0,0,8,0,0
"Poland","2024-09-07",0,0,8,0,0,8,0,0
"Poland","2024-09-08",0,0,8,0,0,8,0,0
"Poland","2024-09-09",0,0,8,0,0,8,0,0
"Poland","2024-09-10",0,0,8,0,0,8,0,0
"Poland","2024-09-11",0,0,8,0,0,8,0,0
"Poland","2024-09-12",0,0,8,0,0,8,0,0
"Poland","2024-09-13",0,0,8,0,0,8,0,0
"Poland","2024-09-14",0,0,8,0,0,8,0,0
"Poland","2024-09-15",0,0,8,0,0,8,0,0
"Poland","2024-09-16",0,0,8,0,0,8,0,0
"Poland","2024-09-17",0,0,8,0,0,8,0,0
"Poland","2024-09-18",0,0,8,0,0,8,0,0
"Poland","2024-09-19",0,0,8,0,0,8,0,0
"Poland","2024-09-20",0,0,8,0,0,8,0,0
"Poland","2024-09-21",0,0,8,0,0,8,0,0
"Poland","2024-09-22",0,0,8,0,0,8,0,0
"Poland","2024-09-23",0,0,8,0,0,8,0,0
"Poland","2024-09-24",0,0,8,0,0,8,0,0
"Poland","2024-09-25",0,0,8,0,0,8,0,0
"Poland","2024-09-26",0,0,8,0,0,8,0,0
"Poland","2024-09-27",0,0,8,0,0,8,0,0
"Poland","2024-09-28",0,0,8,0,0,8,0,0
"Poland","2024-09-29",0,0,8,0,0,8,0,0
"Poland","2024-09-30",0,0,8,0,0,8,0,0
"Poland","2024-10-01",0,0,8,0,1,9,0,0
"Poland","2024-10-02",0,0,8,0,0,9,0,0
"Poland","2024-10-03",0,0,8,0,0,9,0,0
"Poland","2024-10-04",0,0,8,0,0,9,0,0
"Poland","2024-10-05",0,0,8,0,0,9,0,0
"Poland","2024-10-06",0,0,8,0,0,9,0,0
"Poland","2024-10-07",0,0,8,0,0,9,0,0
"Poland","2024-10-08",0,0,8,0,0,9,0,0
"Poland","2024-10-09",0,0,8,0,0,9,0,0
"Poland","2024-10-10",0,0,8,0,0,9,0,0
"Poland","2024-10-11",0,0,8,0,0,9,0,0
"Poland","2024-10-12",0,0,8,0,0,9,0,0
"Poland","2024-10-13",0,0,8,0,0,9,0,0
"Poland","2024-10-14",0,0,8,0,0,9,0,0
"Poland","2024-10-15",0,0,8,0,0,9,0,0
"Poland","2024-10-16",0,0,8,0,0,9,0,0
"Poland","2024-10-17",0,0,8,0,0,9,0,0
"Poland","2024-10-18",0,0,8,0,0,9,0,0
"Poland","2024-10-19",0,0,8,0,0,9,0,0
"Poland","2024-10-20",0,0,8,0,0,9,0,0
"Poland","2024-10-21",0,0,8,0,0,9,0,0
"Poland","2024-10-22",0,0,8,0,0,9,0,0
"Poland","2024-10-23",0,0,8,0,0,9,0,0
"Poland","2024-10-24",0,0,8,0,0,9,0,0
"Poland","2024-10-25",0,0,8,0,0,9,0,0
"Poland","2024-10-26",0,0,8,0,0,9,0,0
"Poland","2024-10-27",0,0,8,0,0,9,0,0
"Poland","2024-10-28",0,0,8,0,0,9,0,0
"Poland","2024-10-29",0,0,8,0,0,9,0,0
"Poland","2024-10-30",0,0,8,0,0,9,0,0
"Poland","2024-10-31",0,0,8,0,0,9,0,0
"Poland","2024-11-01",0,0,8,0,0,9,0,0
"Poland","2024-11-02",0,0,8,0,0,9,0,0
"Poland","2024-11-03",0,0,8,0,0,9,0,0
"Poland","2024-11-04",0,0,8,0,0,9,0,0
"Poland","2024-11-05",0,0,8,0,0,9,0,0
"Poland","2024-11-06",0,0,8,0,0,9,0,0
"Poland","2024-11-07",0,0,8,0,0,9,0,0
"Poland","2024-11-08",0,0,8,0,0,9,0,0
"Poland","2024-11-09",0,0,8,0,0,9,0,0
"Poland","2024-11-10",0,0,8,0,0,9,0,0
"Poland","2024-11-11",0,0,8,0,0,9,0,0
"Poland","2024-11-12",0,0,8,0,0,9,0,0
"Poland","2024-11-13",0,0,8,0,0,9,0,0
"Poland","2024-11-14",0,0,8,0,0,9,0,0
"Poland","2024-11-15",0,0,8,0,0,9,0,0
"Poland","2024-11-16",0,0,8,0,0,9,0,0
"Poland","2024-11-17",0,0,8,0,0,9,0,0
"Poland","2024-11-18",0,0,8,0,0,9,0,0
"Poland","2024-11-19",0,0,8,0,0,9,0,0
"Poland","2024-11-20",0,0,8,0,0,9,0,0
"Poland","2024-11-21",0,0,8,0,0,9,0,0
"Poland","2024-11-22",0,0,8,0,0,9,0,0
"Poland","2024-11-23",0,0,8,0,0,9,0,0
"Poland","2024-11-24",0,0,8,0,0,9,0,0
"Poland","2024-11-25",0,0,8,0,0,9,0,0
"Poland","2024-11-26",0,0,8,0,0,9,0,0
"Poland","2024-11-27",0,0,8,0,0,9,0,0
"Poland","2024-11-28",0,0,8,0,0,9,0,0
"Poland","2024-11-29",0,0,8,0,0,9,0,0
"Poland","2024-11-30",0,0,8,0,0,9,0,0
"Poland","2024-12-01",0,0,8,0,1,10,0,0
"Poland","2024-12-02",0,0,8,0,0,10,0,0
"Poland","2024-12-03",0,0,8,0,0,10,0,0
"Poland","2024-12-04",0,0,8,0,0,10,0,0
"Poland","2024-12-05",0,0,8,0,0,10,0,0
"Poland","2024-12-06",0,0,8,0,0,10,0,0
"Poland","2024-12-07",0,0,8,0,0,10,0,0
"Poland","2024-12-08",0,0,8,0,0,10,0,0
"Poland","2024-12-09",0,0,8,0,0,10,0,0
"Poland","2024-12-10",0,0,8,0,0,10,0,0
"Poland","2024-12-11",0,0,8,0,0,10,0,0
"Poland","2024-12-12",0,0,8,0,0,10,0,0
"Poland","2024-12-13",0,0,8,0,0,10,0,0
"Poland","2024-12-14",0,0,8,0,0,10,0,0
"Poland","2024-12-15",0,0,8,0,0,10,0,0
"Poland","2024-12-16",0,0,8,0,0,10,0,0
"Poland","2024-12-17",0,0,8,0,0,10,0,0
"Poland","2024-12-18",0,0,8,0,0,10,0,0
"Poland","2024-12-19",0,0,8,0,0,10,0,0
"Poland","2024-12-20",0,0,8,0,0,10,0,0
"Poland","2024-12-21",0,0,8,0,0,10,0,0
"Poland","2024-12-22",0,0,8,0,0,10,0,0
"Poland","2024-12-23",0,0,8,0,0,10,0,0
"Poland","2024-12-24",0,0,8,0,0,10,0,0
"Poland","2024-12-25",0,0,8,0,0,10,0,0
"Poland","2024-12-26",0,0,8,0,0,10,0,0
"Poland","2024-12-27",0,0,8,0,0,10,0,0
"Poland","2024-12-28",0,0,8,0,0,10,0,0
"Poland","2024-12-29",0,0,8,0,0,10,0,0
"Poland","2024-12-30",0,0,8,0,0,10,0,0
"Poland","2024-12-31",0,2,10,0,0,10,0,0
"Poland","2025-01-01",0,0,10,0,0,10,0,0
"Poland","2025-01-02",0,0,10,0,0,10,0,0
"Poland","2025-01-03",0,0,10,0,0,10,0,0
"Poland","2025-01-04",0,0,10,0,0,10,0,0
"Poland","2025-01-05",0,0,10,0,0,10,0,0
"Poland","2025-01-06",0,0,10,0,0,10,0,0
"Poland","2025-01-07",0,0,10,0,0,10,0,0
"Poland","2025-01-08",0,0,10,0,0,10,0,0
"Poland","2025-01-09",0,0,10,0,0,10,0,0
"Poland","2025-01-10",0,0,10,0,0,10,0,0
"Poland","2025-01-11",0,0,10,0,0,10,0,0
"Poland","2025-01-12",0,0,10,0,0,10,0,0
"Poland","2025-01-13",0,0,10,0,0,10,0,0
"Poland","2025-01-14",0,0,10,0,0,10,0,0
"Poland","2025-01-15",0,0,10,0,0,10,0,0
"Poland","2025-01-16",0,0,10,0,0,10,0,0
"Poland","2025-01-17",0,0,10,0,0,10,0,0
"Poland","2025-01-18",0,0,10,0,0,10,0,0
"Poland","2025-01-19",0,0,10,0,0,10,0,0
"Poland","2025-01-20",0,0,10,0,0,10,0,0
"Poland","2025-01-21",0,0,10,0,0,10,0,0
"Poland","2025-01-22",0,0,10,0,0,10,0,0
"Poland","2025-01-23",0,0,10,0,0,10,0,0
"Poland","2025-01-24",0,0,10,0,0,10,0,0
"Poland","2025-01-25",0,0,10,0,0,10,0,0
"Poland","2025-01-26",0,0,10,0,0,10,0,0
"Poland","2025-01-27",0,0,10,0,0,10,0,0
"Poland","2025-01-28",0,0,10,0,0,10,0,0
"Poland","2025-01-29",0,0,10,0,0,10,0,0
"Poland","2025-01-30",0,0,10,0,0,10,0,0
"Poland","2025-01-31",0,0,10,0,0,10,0,0
"Poland","2025-02-01",0,0,10,0,0,10,0,0
"Poland","2025-02-02",0,0,10,0,0,10,0,0
"Poland","2025-02-03",0,0,10,0,0,10,0,0
"Portugal","2024-01-01",0,0,0,0,0,0,0,0
"Portugal","2024-01-02",0,0,0,0,0,0,0,0
"Portugal","2024-01-03",0,0,0,0,0,0,0,0
"Portugal","2024-01-04",0,0,0,0,0,0,0,0
"Portugal","2024-01-05",0,0,0,0,0,0,0,0
"Portugal","2024-01-06",0,0,0,0,0,0,0,0
"Portugal","2024-01-07",0,0,0,0,0,0,0,0
"Portugal","2024-01-08",0,0,0,0,0,0,0,0
"Portugal","2024-01-09",0,0,0,0,0,0,0,0
"Portugal","2024-01-10",0,0,0,0,0,0,0,0
"Portugal","2024-01-11",0,0,0,0,0,0,0,0
"Portugal","2024-01-12",0,0,0,0,0,0,0,0
"Portugal","2024-01-13",0,0,0,0,0,0,0,0
"Portugal","2024-01-14",0,0,0,0,0,0,0,0
"Portugal","2024-01-15",0,0,0,0,0,0,0,0
"Portugal","2024-01-16",0,0,0,0,0,0,0,0
"Portugal","2024-01-17",0,0,0,0,0,0,0,0
"Portugal","2024-01-18",0,0,0,0,0,0,0,0
"Portugal","2024-01-19",0,0,0,0,0,0,0,0
"Portugal","2024-01-20",0,0,0,0,0,0,0,0
"Portugal","2024-01-21",0,0,0,0,0,0,0,0
"Portugal","2024-01-22",0,0,0,0,0,0,0,0
"Portugal","2024-01-23",0,0,0,0,0,0,0,0
"Portugal","2024-01-24",0,0,0,0,0,0,0,0
"Portugal","2024-01-25",0,0,0,0,0,0,0,0
"Portugal","2024-01-26",0,0,0,0,0,0,0,0
"Portugal","2024-01-27",0,0,0,0,0,0,0,0
"Portugal","2024-01-28",0,0,0,0,0,0,0,0
"Portugal","2024-01-29",0,0,0,0,0,0,0,0
"Portugal","2024-01-30",0,0,0,0,0,0,0,0
"Portugal","2024-01-31",0,24,24,0,24,24,0,0
"Portugal","2024-02-01",0,0,24,0,0,24,0,0
"Portugal","2024-02-02",0,0,24,0,0,24,0,0
"Portugal","2024-02-03",0,0,24,0,0,24,0,0
"Portugal","2024-02-04",0,0,24,0,1,25,0,0
"Portugal","2024-02-05",0,0,24,0,0,25,0,0
"Portugal","2024-02-06",0,0,24,0,0,25,0,0
"Portugal","2024-02-07",0,0,24,0,0,25,0,0
"Portugal","2024-02-08",0,0,24,0,0,25,0,0
"Portugal","2024-02-09",0,0,24,0,0,25,0,0
"Portugal","2024-02-10",0,0,24,0,0,25,0,0
"Portugal","2024-02-11",0,0,24,0,1,26,0,0
"Portugal","2024-02-12",0,0,24,0,0,26,0,0
"Portugal","2024-02-13",0,0,24,0,0,26,0,0
"Portugal","2024-02-14",0,0,24,0,0,26,0,0
"Portugal","2024-02-15",0,0,24,0,0,26,0,0
"Portugal","2024-02-16",0,0,24,0,0,26,0,0
"Portugal","2024-02-17",0,0,24,0,0,26,0,0
"Portugal","2024-02-18",0,0,24,0,0,26,0,0
"Portugal","2024-02-19",0,0,24,0,1,27,0,0
"Portugal","2024-02-20",0,0,24,0,0,27,0,0
"Portugal","2024-02-21",0,0,24,0,0,27,0,0
"Portugal","2024-02-22",0,0,24,0,0,27,0,0
"Portugal","2024-02-23",0,0,24,0,0,27,0,0
"Portugal","2024-02-24",0,0,24,0,0,27,0,0
"Portugal","2024-02-25",0,0,24,0,0,27,0,0
"Portugal","2024-02-26",0,0,24,0,1,28,0,0
"Portugal","2024-02-27",0,0,24,0,0,28,0,0
"Portugal","2024-02-28",0,0,24,0,0,28,0,0
"Portugal","2024-02-29",0,4,28,0,0,28,0,0
"Portugal","2024-03-01",0,0,28,0,0,28,0,0
"Portugal","2024-03-02",0,0,28,0,0,28,0,0
"Portugal","2024-03-03",0,0,28,0,0,28,0,0
"Portugal","2024-03-04",0,0,28,0,0,28,0,0
"Portugal","2024-03-05",0,0,28,0,0,28,0,0
"Portugal","2024-03-06",0,0,28,0,1,29,0,0
"Portugal","2024-03-07",0,0,28,0,0,29,0,0
"Portugal","2024-03-08",0,0,28,0,0,29,0,0
"Portugal","2024-03-09",0,0,28,0,0,29,0,0
"Portugal","2024-03-10",0,0,28,0,0,29,0,0
"Portugal","2024-03-11",0,0,28,0,0,29,0,0
"Portugal","2024-03-12",0,0,28,0,0,29,0,0
"Portugal","2024-03-13",0,0,28,0,0,29,0,0
"Portugal","2024-03-14",0,0,28,0,0,29,0,0
"Portugal","2024-03-15",0,0,28,0,0,29,0,0
"Portugal","2024-03-16",0,0,28,0,1,30,0,0
"Portugal","2024-03-17",0,0,28,0,0,30,0,0
"Portugal","2024-03-18",0,0,28,0,0,30,0,0
"Portugal","2024-03-19",0,0,28,0,0,30,0,0
"Portugal","2024-03-20",0,0,28,0,0,30,0,0
"Portugal","2024-03-21",0,0,28,0,0,30,0,0
"Portugal","2024-03-22",0,0,28,0,0,30,0,0
"Portugal","2024-03-23",0,0,28,0,0,30,0,0
"Portugal","2024-03-24",0,0,28,0,0,30,0,0
"Portugal","2024-03-25",0,0,28,0,0,30,0,0
"Portugal","2024-03-26",0,0,28,0,1,31,0,0
"Portugal","2024-03-27",0,0,28,0,0,31,0,0
"Portugal","2024-03-28",0,0,28,0,0,31,0,0
"Portugal","2024-03-29",0,0,28,0,0,31,0,0
"Portugal","2024-03-30",0,0,28,0,0,31,0,0
"Portugal","2024-03-31",0,3,31,0,0,31,0,0
"Portugal","2024-04-01",0,0,31,0,0,31,0,0
"Portugal","2024-04-02",0,0,31,0,0,31,0,0
"Portugal","2024-04-03",0,0,31,0,0,31,0,0
"Portugal","2024-04-04",0,0,31,0,0,31,0,0
"Portugal","2024-04-05",0,0,31,0,0,31,0,0
"Portugal","2024-04-06",0,0,31,0,0,31,0,0
"Portugal","2024-04-07",0,0,31,0,0,31,0,0
"Portugal","2024-04-08",0,0,31,0,0,31,0,0
"Portugal","2024-04-09",0,0,31,0,0,31,0,0
"Portugal","2024-04-10",0,0,31,0,0,31,0,0
"Portugal","2024-04-11",0,0,31,0,0,31,0,0
"Portugal","2024-04-12",0,0,31,0,0,31,0,0
"Portugal","2024-04-13",0,0,31,0,0,31,0,0
"Portugal","2024-04-14",0,0,31,0,0,31,0,0
"Portugal","2024-04-15",0,0,31,0,0,31,0,0
"Portugal","2024-04-16",0,0,31,0,0,31,0,0
"Portugal","2024-04-17",0,0,31,0,0,31,0,0
"Portugal","2024-04-18",0,0,31,0,0,31,0,0
"Portugal","2024-04-19",0,0,31,0,0,31,0,0
"Portugal","2024-04-20",0,0,31,0,0,31,0,0
"Portugal","2024-04-21",0,0,31,0,1,32,0,0
"Portugal","2024-04-22",0,0,31,0,0,32,0,0
"Portugal","2024-04-23",0,0,31,0,0,32,0,0
"Portugal","2024-04-24",0,0,31,0,0,32,0,0
"Portugal","2024-04-25",0,0,31,0,0,32,0,0
"Portugal","2024-04-26",0,0,31,0,0,32,0,0
"Portugal","2024-04-27",0,0,31,0,0,32,0,0
"Portugal","2024-04-28",0,0,31,0,0,32,0,0
"Portugal","2024-04-29",0,0,31,0,0,32,0,0
"Portugal","2024-04-30",0,0,31,0,0,32,0,0
"Portugal","2024-05-01",0,0,31,0,0,32,0,0
"Portugal","2024-05-02",0,0,31,0,0,32,0,0
"Portugal","2024-05-03",0,0,31,0,0,32,0,0
"Portugal","2024-05-04",0,0,31,0,0,32,0,0
"Portugal","2024-05-05",0,0,31,0,0,32,0,0
"Portugal","2024-05-06",0,0,31,0,0,32,0,0
"Portugal","2024-05-07",0,0,31,0,0,32,0,0
"Portugal","2024-05-08",0,0,31,0,0,32,0,0
"Portugal","2024-05-09",0,0,31,0,0,32,0,0
"Portugal","2024-05-10",0,0,31,0,0,32,0,0
"Portugal","2024-05-11",0,0,31,0,0,32,0,0
"Portugal","2024-05-12",0,0,31,0,0,32,0,0
"Portugal","2024-05-13",0,0,31,0,0,32,0,0
"Portugal","2024-05-14",0,0,31,0,0,32,0,0
"Portugal","2024-05-15",0,0,31,0,0,32,0,0
"Portugal","2024-05-16",0,0,31,0,0,32,0,0
"Portugal","2024-05-17",0,0,31,0,0,32,0,0
"Portugal","2024-05-18",0,0,31,0,0,32,0,0
"Portugal","2024-05-19",0,0,31,0,0,32,0,0
"Portugal","2024-05-20",0,0,31,0,0,32,0,0
"Portugal","2024-05-21",0,0,31,0,0,32,0,0
"Portugal","2024-05-22",0,0,31,0,0,32,0,0
"Portugal","2024-05-23",0,0,31,0,0,32,0,0
"Portugal","2024-05-24",0,0,31,0,0,32,0,0
"Portugal","2024-05-25",0,0,31,0,0,32,0,0
"Portugal","2024-05-26",0,0,31,0,0,32,0,0
"Portugal","2024-05-27",0,0,31,0,0,32,0,0
"Portugal","2024-05-28",0,0,31,0,0,32,0,0
"Portugal","2024-05-29",0,0,31,0,0,32,0,0
"Portugal","2024-05-30",0,0,31,0,0,32,0,0
"Portugal","2024-05-31",0,0,31,0,1,33,0,0
"Portugal","2024-06-01",0,0,31,0,0,33,0,0
"Portugal","2024-06-02",0,0,31,0,0,33,0,0
"Portugal","2024-06-03",0,0,31,0,0,33,0,0
"Portugal","2024-06-04",0,0,31,0,0,33,0,0
"Portugal","2024-06-05",0,0,31,0,0,33,0,0
"Portugal","2024-06-06",0,0,31,0,0,33,0,0
"Portugal","2024-06-07",0,0,31,0,0,33,0,0
"Portugal","2024-06-08",0,0,31,0,0,33,0,0
"Portugal","2024-06-09",0,0,31,0,0,33,0,0
"Portugal","2024-06-10",0,0,31,0,0,33,0,0
"Portugal","2024-06-11",0,0,31,0,0,33,0,0
"Portugal","2024-06-12",0,0,31,0,0,33,0,0
"Portugal","2024-06-13",0,0,31,0,0,33,0,0
"Portugal","2024-06-14",0,0,31,0,0,33,0,0
"Portugal","2024-06-15",0,0,31,0,0,33,0,0
"Portugal","2024-06-16",0,0,31,0,0,33,0,0
"Portugal","2024-06-17",0,0,31,0,0,33,0,0
"Portugal","2024-06-18",0,0,31,0,0,33,0,0
"Portugal","2024-06-19",0,0,31,0,0,33,0,0
"Portugal","2024-06-20",0,0,31,0,0,33,0,0
"Portugal","2024-06-21",0,0,31,0,0,33,0,0
"Portugal","2024-06-22",0,0,31,0,0,33,0,0
"Portugal","2024-06-23",0,0,31,0,0,33,0,0
"Portugal","2024-06-24",0,0,31,0,0,33,0,0
"Portugal","2024-06-25",0,0,31,0,0,33,0,0
"Portugal","2024-06-26",0,0,31,0,0,33,0,0
"Portugal","2024-06-27",0,0,31,0,0,33,0,0
"Portugal","2024-06-28",0,0,31,0,0,33,0,0
"Portugal","2024-06-29",0,0,31,0,0,33,0,0
"Portugal","2024-06-30",0,0,31,0,0,33,0,0
"Portugal","2024-07-01",0,0,31,0,0,33,0,0
"Portugal","2024-07-02",0,0,31,0,0,33,0,0
"Portugal","2024-07-03",0,0,31,0,0,33,0,0
"Portugal","2024-07-04",0,0,31,0,0,33,0,0
"Portugal","2024-07-05",0,0,31,0,0,33,0,0
"Portugal","2024-07-06",0,0,31,0,0,33,0,0
"Portugal","2024-07-07",0,0,31,0,0,33,0,0
"Portugal","2024-07-08",0,0,31,0,0,33,0,0
"Portugal","2024-07-09",0,0,31,0,0,33,0,0
"Portugal","2024-07-10",0,0,31,0,0,33,0,0
"Portugal","2024-07-11",0,0,31,0,1,34,0,0
"Portugal","2024-07-12",0,0,31,0,0,34,0,0
"Portugal","2024-07-13",0,0,31,0,0,34,0,0
"Portugal","2024-07-14",0,0,31,0,0,34,0,0
"Portugal","2024-07-15",0,0,31,0,0,34,0,0
"Portugal","2024-07-16",0,0,31,0,0,34,0,0
"Portugal","2024-07-17",0,0,31,0,0,34,0,0
"Portugal","2024-07-18",0,0,31,0,0,34,0,0
"Portugal","2024-07-19",0,0,31,0,0,34,0,0
"Portugal","2024-07-20",0,0,31,0,0,34,0,0
"Portugal","2024-07-21",0,0,31,0,0,34,0,0
"Portugal","2024-07-22",0,0,31,0,0,34,0,0
"Portugal","2024-07-23",0,0,31,0,0,34,0,0
"Portugal","2024-07-24",0,0,31,0,0,34,0,0
"Portugal","2024-07-25",0,0,31,0,0,34,0,0
"Portugal","2024-07-26",0,0,31,0,0,34,0,0
"Portugal","2024-07-27",0,0,31,0,0,34,0,0
"Portugal","2024-07-28",0,0,31,0,0,34,0,0
"Portugal","2024-07-29",0,0,31,0,0,34,0,0
"Portugal","2024-07-30",0,0,31,0,0,34,0,0
"Portugal","2024-07-31",0,3,34,0,0,34,0,0
"Portugal","2024-08-01",0,0,34,0,0,34,0,0
"Portugal","2024-08-02",0,0,34,0,1,35,0,0
"Portugal","2024-08-03",0,0,34,0,0,35,0,0
"Portugal","2024-08-04",0,0,34,0,0,35,0,0
"Portugal","2024-08-05",0,0,34,0,1,36,0,0
"Portugal","2024-08-06",0,0,34,0,0,36,0,0
"Portugal","2024-08-07",0,0,34,0,0,36,0,0
"Portugal","2024-08-08",0,0,34,0,1,37,0,0
"Portugal","2024-08-09",0,0,34,0,0,37,0,0
"Portugal","2024-08-10",0,0,34,0,0,37,0,0
"Portugal","2024-08-11",0,0,34,0,1,38,0,0
"Portugal","2024-08-12",0,0,34,0,0,38,0,0
"Portugal","2024-08-13",0,0,34,0,0,38,0,0
"Portugal","2024-08-14",0,0,34,0,1,39,0,0
"Portugal","2024-08-15",0,0,34,0,0,39,0,0
"Portugal","2024-08-16",0,0,34,0,0,39,0,0
"Portugal","2024-08-17",0,0,34,0,0,39,0,0
"Portugal","2024-08-18",0,0,34,0,1,40,0,0
"Portugal","2024-08-19",0,0,34,0,0,40,0,0
"Portugal","2024-08-20",0,0,34,0,0,40,0,0
"Portugal","2024-08-21",0,0,34,0,1,41,0,0
"Portugal","2024-08-22",0,0,34,0,0,41,0,0
"Portugal","2024-08-23",0,0,34,0,0,41,0,0
"Portugal","2024-08-24",0,0,34,0,1,42,0,0
"Portugal","2024-08-25",0,0,34,0,0,42,0,0
"Portugal","2024-08-26",0,0,34,0,0,42,0,0
"Portugal","2024-08-27",0,0,34,0,1,43,0,0
"Portugal","2024-08-28",0,0,34,0,0,43,0,0
"Portugal","2024-08-29",0,0,34,0,0,43,0,0
"Portugal","2024-08-30",0,0,34,0,1,44,0,0
"Portugal","2024-08-31",0,10,44,0,0,44,0,0
"Portugal","2024-09-01",0,0,44,0,0,44,0,0
"Portugal","2024-09-02",0,0,44,0,0,44,0,0
"Portugal","2024-09-03",0,0,44,0,0,44,0,0
"Portugal","2024-09-04",0,0,44,0,0,44,0,0
"Portugal","2024-09-05",0,0,44,0,0,44,0,0
"Portugal","2024-09-06",0,0,44,0,0,44,0,0
"Portugal","2024-09-07",0,0,44,0,0,44,0,0
"Portugal","2024-09-08",0,0,44,0,0,44,0,0
"Portugal","2024-09-09",0,0,44,0,0,44,0,0
"Portugal","2024-09-10",0,0,44,0,0,44,0,0
"Portugal","2024-09-11",0,0,44,0,0,44,0,0
"Portugal","2024-09-12",0,0,44,0,0,44,0,0
"Portugal","2024-09-13",0,0,44,0,0,44,0,0
"Portugal","2024-09-14",0,0,44,0,0,44,0,0
"Portugal","2024-09-15",0,0,44,0,0,44,0,0
"Portugal","2024-09-16",0,0,44,0,1,45,0,0
"Portugal","2024-09-17",0,0,44,0,0,45,0,0
"Portugal","2024-09-18",0,0,44,0,0,45,0,0
"Portugal","2024-09-19",0,0,44,0,0,45,0,0
"Portugal","2024-09-20",0,0,44,0,0,45,0,0
"Portugal","2024-09-21",0,0,44,0,0,45,0,0
"Portugal","2024-09-22",0,0,44,0,0,45,0,0
"Portugal","2024-09-23",0,0,44,0,0,45,0,0
"Portugal","2024-09-24",0,0,44,0,0,45,0,0
"Portugal","2024-09-25",0,0,44,0,0,45,0,0
"Portugal","2024-09-26",0,0,44,0,0,45,0,0
"Portugal","2024-09-27",0,0,44,0,0,45,0,0
"Portugal","2024-09-28",0,0,44,0,0,45,0,0
"Portugal","2024-09-29",0,0,44,0,0,45,0,0
"Portugal","2024-09-30",0,1,45,0,0,45,0,0
"Portugal","2024-10-01",0,0,45,0,0,45,0,0
"Portugal","2024-10-02",0,0,45,0,0,45,0,0
"Portugal","2024-10-03",0,0,45,0,0,45,0,0
"Portugal","2024-10-04",0,0,45,0,0,45,0,0
"Portugal","2024-10-05",0,0,45,0,0,45,0,0
"Portugal","2024-10-06",0,0,45,0,0,45,0,0
"Portugal","2024-10-07",0,0,45,0,0,45,0,0
"Portugal","2024-10-08",0,0,45,0,0,45,0,0
"Portugal","2024-10-09",0,0,45,0,0,45,0,0
"Portugal","2024-10-10",0,0,45,0,0,45,0,0
"Portugal","2024-10-11",0,0,45,0,0,45,0,0
"Portugal","2024-10-12",0,0,45,0,0,45,0,0
"Portugal","2024-10-13",0,0,45,0,0,45,0,0
"Portugal","2024-10-14",0,0,45,0,0,45,0,0
"Portugal","2024-10-15",0,0,45,0,0,45,0,0
"Portugal","2024-10-16",0,0,45,0,1,46,0,0
"Portugal","2024-10-17",0,0,45,0,0,46,0,0
"Portugal","2024-10-18",0,0,45,0,0,46,0,0
"Portugal","2024-10-19",0,0,45,0,0,46,0,0
"Portugal","2024-10-20",0,0,45,0,0,46,0,0
"Portugal","2024-10-21",0,0,45,0,0,46,0,0
"Portugal","2024-10-22",0,0,45,0,0,46,0,0
"Portugal","2024-10-23",0,0,45,0,0,46,0,0
"Portugal","2024-10-24",0,0,45,0,0,46,0,0
"Portugal","2024-10-25",0,0,45,0,0,46,0,0
"Portugal","2024-10-26",0,0,45,0,0,46,0,0
"Portugal","2024-10-27",0,0,45,0,0,46,0,0
"Portugal","2024-10-28",0,0,45,0,0,46,0,0
"Portugal","2024-10-29",0,0,45,0,0,46,0,0
"Portugal","2024-10-30",0,0,45,0,0,46,0,0
"Portugal","2024-10-31",0,1,46,0,0,46,0,0
"Portugal","2024-11-01",0,0,46,0,0,46,0,0
"Portugal","2024-11-02",0,0,46,0,0,46,0,0
"Portugal","2024-11-03",0,0,46,0,0,46,0,0
"Portugal","2024-11-04",0,0,46,0,0,46,0,0
"Portugal","2024-11-05",0,0,46,0,0,46,0,0
"Portugal","2024-11-06",0,0,46,0,0,46,0,0
"Portugal","2024-11-07",0,0,46,0,0,46,0,0
"Portugal","2024-11-08",0,0,46,0,0,46,0,0
"Portugal","2024-11-09",0,0,46,0,0,46,0,0
"Portugal","2024-11-10",0,0,46,0,0,46,0,0
"Portugal","2024-11-11",0,0,46,0,0,46,0,0
"Portugal","2024-11-12",0,0,46,0,0,46,0,0
"Portugal","2024-11-13",0,0,46,0,0,46,0,0
"Portugal","2024-11-14",0,0,46,0,0,46,0,0
"Portugal","2024-11-15",0,0,46,0,0,46,0,0
"Portugal","2024-11-16",0,0,46,0,1,47,0,0
"Portugal","2024-11-17",0,0,46,0,0,47,0,0
"Portugal","2024-11-18",0,0,46,0,0,47,0,0
"Portugal","2024-11-19",0,0,46,0,0,47,0,0
"Portugal","2024-11-20",0,0,46,0,0,47,0,0
"Portugal","2024-11-21",0,0,46,0,0,47,0,0
"Portugal","2024-11-22",0,0,46,0,0,47,0,0
"Portugal","2024-11-23",0,0,46,0,0,47,0,0
"Portugal","2024-11-24",0,0,46,0,0,47,0,0
"Portugal","2024-11-25",0,0,46,0,0,47,0,0
"Portugal","2024-11-26",0,0,46,0,0,47,0,0
"Portugal","2024-11-27",0,0,46,0,0,47,0,0
"Portugal","2024-11-28",0,0,46,0,0,47,0,0
"Portugal","2024-11-29",0,0,46,0,0,47,0,0
"Portugal","2024-11-30",0,0,46,0,0,47,0,0
"Portugal","2024-12-01",0,0,46,0,0,47,0,0
"Portugal","2024-12-02",0,0,46,0,0,47,0,0
"Portugal","2024-12-03",0,0,46,0,0,47,0,0
"Portugal","2024-12-04",0,0,46,0,0,47,0,0
"Portugal","2024-12-05",0,0,46,0,0,47,0,0
"Portugal","2024-12-06",0,0,46,0,0,47,0,0
"Portugal","2024-12-07",0,0,46,0,0,47,0,0
"Portugal","2024-12-08",0,0,46,0,0,47,0,0
"Portugal","2024-12-09",0,0,46,0,0,47,0,0
"Portugal","2024-12-10",0,0,46,0,0,47,0,0
"Portugal","2024-12-11",0,0,46,0,0,47,0,0
"Portugal","2024-12-12",0,0,46,0,0,47,0,0
"Portugal","2024-12-13",0,0,46,0,0,47,0,0
"Portugal","2024-12-14",0,0,46,0,0,47,0,0
"Portugal","2024-12-15",0,0,46,0,0,47,0,0
"Portugal","2024-12-16",0,0,46,0,1,48,0,0
"Portugal","2024-12-17",0,0,46,0,0,48,0,0
"Portugal","2024-12-18",0,0,46,0,0,48,0,0
"Portugal","2024-12-19",0,0,46,0,0,48,0,0
"Portugal","2024-12-20",0,0,46,0,0,48,0,0
"Portugal","2024-12-21",0,0,46,0,0,48,0,0
"Portugal","2024-12-22",0,0,46,0,0,48,0,0
"Portugal","2024-12-23",0,0,46,0,0,48,0,0
"Portugal","2024-12-24",0,0,46,0,0,48,0,0
"Portugal","2024-12-25",0,0,46,0,0,48,0,0
"Portugal","2024-12-26",0,0,46,0,0,48,0,0
"Portugal","2024-12-27",0,0,46,0,0,48,0,0
"Portugal","2024-12-28",0,0,46,0,0,48,0,0
"Portugal","2024-12-29",0,0,46,0,0,48,0,0
"Portugal","2024-12-30",0,0,46,0,0,48,0,0
"Portugal","2024-12-31",0,2,48,0,0,48,0,0
"Portugal","2025-01-01",0,0,48,0,0,48,0,0
"Portugal","2025-01-02",0,0,48,0,0,48,0,0
"Portugal","2025-01-03",0,0,48,0,0,48,0,0
"Portugal","2025-01-04",0,0,48,0,0,48,0,0
"Portugal","2025-01-05",0,0,48,0,0,48,0,0
"Portugal","2025-01-06",0,0,48,0,0,48,0,0
"Portugal","2025-01-07",0,0,48,0,0,48,0,0
"Portugal","2025-01-08",0,0,48,0,0,48,0,0
"Portugal","2025-01-09",0,0,48,0,0,48,0,0
"Portugal","2025-01-10",0,0,48,0,0,48,0,0
"Portugal","2025-01-11",0,0,48,0,0,48,0,0
"Portugal","2025-01-12",0,0,48,0,0,48,0,0
"Portugal","2025-01-13",0,0,48,0,0,48,0,0
"Portugal","2025-01-14",0,0,48,0,0,48,0,0
"Portugal","2025-01-15",0,0,48,0,0,48,0,0
"Portugal","2025-01-16",0,0,48,0,0,48,0,0
"Portugal","2025-01-17",0,0,48,0,0,48,0,0
"Portugal","2025-01-18",0,0,48,0,0,48,0,0
"Portugal","2025-01-19",0,0,48,0,0,48,0,0
"Portugal","2025-01-20",0,0,48,0,0,48,0,0
"Portugal","2025-01-21",0,0,48,0,0,48,0,0
"Portugal","2025-01-22",0,0,48,0,0,48,0,0
"Portugal","2025-01-23",0,0,48,0,0,48,0,0
"Portugal","2025-01-24",0,0,48,0,0,48,0,0
"Portugal","2025-01-25",0,0,48,0,0,48,0,0
"Portugal","2025-01-26",0,0,48,0,0,48,0,0
"Portugal","2025-01-27",0,0,48,0,0,48,0,0
"Portugal","2025-01-28",0,0,48,0,0,48,0,0
"Portugal","2025-01-29",0,0,48,0,0,48,0,0
"Portugal","2025-01-30",0,0,48,0,0,48,0,0
"Portugal","2025-01-31",0,0,48,0,0,48,0,0
"Portugal","2025-02-01",0,0,48,0,0,48,0,0
"Portugal","2025-02-02",0,0,48,0,0,48,0,0
"Portugal","2025-02-03",0,0,48,0,0,48,0,0
"Romania","2024-01-01",0,0,0,0,0,0,0,0
"Romania","2024-01-02",0,0,0,0,0,0,0,0
"Romania","2024-01-03",0,0,0,0,0,0,0,0
"Romania","2024-01-04",0,0,0,0,0,0,0,0
"Romania","2024-01-05",0,0,0,0,0,0,0,0
"Romania","2024-01-06",0,0,0,0,0,0,0,0
"Romania","2024-01-07",0,0,0,0,0,0,0,0
"Romania","2024-01-08",0,0,0,0,0,0,0,0
"Romania","2024-01-09",0,0,0,0,0,0,0,0
"Romania","2024-01-10",0,0,0,0,0,0,0,0
"Romania","2024-01-11",0,0,0,0,0,0,0,0
"Romania","2024-01-12",0,0,0,0,0,0,0,0
"Romania","2024-01-13",0,0,0,0,0,0,0,0
"Romania","2024-01-14",0,0,0,0,0,0,0,0
"Romania","2024-01-15",0,0,0,0,0,0,0,0
"Romania","2024-01-16",0,0,0,0,0,0,0,0
"Romania","2024-01-17",0,0,0,0,0,0,0,0
"Romania","2024-01-18",0,0,0,0,0,0,0,0
"Romania","2024-01-19",0,0,0,0,0,0,0,0
"Romania","2024-01-20",0,0,0,0,0,0,0,0
"Romania","2024-01-21",0,0,0,0,0,0,0,0
"Romania","2024-01-22",0,0,0,0,0,0,0,0
"Romania","2024-01-23",0,0,0,0,0,0,0,0
"Romania","2024-01-24",0,0,0,0,0,0,0,0
"Romania","2024-01-25",0,0,0,0,0,0,0,0
"Romania","2024-01-26",0,0,0,0,0,0,0,0
"Romania","2024-01-27",0,0,0,0,0,0,0,0
"Romania","2024-01-28",0,0,0,0,0,0,0,0
"Romania","2024-01-29",0,0,0,0,0,0,0,0
"Romania","2024-01-30",0,0,0,0,0,0,0,0
"Romania","2024-01-31",0,0,0,0,0,0,0,0
"Romania","2024-02-01",0,0,0,0,0,0,0,0
"Romania","2024-02-02",0,0,0,0,0,0,0,0
"Romania","2024-02-03",0,0,0,0,0,0,0,0
"Romania","2024-02-04",0,0,0,0,0,0,0,0
"Romania","2024-02-05",0,0,0,0,0,0,0,0
"Romania","2024-02-06",0,0,0,0,0,0,0,0
"Romania","2024-02-07",0,0,0,0,0,0,0,0
"Romania","2024-02-08",0,0,0,0,0,0,0,0
"Romania","2024-02-09",0,0,0,0,0,0,0,0
"Romania","2024-02-10",0,0,0,0,0,0,0,0
"Romania","2024-02-11",0,0,0,0,0,0,0,0
"Romania","2024-02-12",0,0,0,0,0,0,0,0
"Romania","2024-02-13",0,0,0,0,0,0,0,0
"Romania","2024-02-14",0,0,0,0,0,0,0,0
"Romania","2024-02-15",0,0,0,0,0,0,0,0
"Romania","2024-02-16",0,0,0,0,0,0,0,0
"Romania","2024-02-17",0,0,0,0,0,0,0,0
"Romania","2024-02-18",0,0,0,0,0,0,0,0
"Romania","2024-02-19",0,0,0,0,0,0,0,0
"Romania","2024-02-20",0,0,0,0,0,0,0,0
"Romania","2024-02-21",0,0,0,0,0,0,0,0
"Romania","2024-02-22",0,0,0,0,0,0,0,0
"Romania","2024-02-23",0,0,0,0,0,0,0,0
"Romania","2024-02-24",0,0,0,0,0,0,0,0
"Romania","2024-02-25",0,0,0,0,0,0,0,0
"Romania","2024-02-26",0,0,0,0,0,0,0,0
"Romania","2024-02-27",0,0,0,0,0,0,0,0
"Romania","2024-02-28",0,0,0,0,0,0,0,0
"Romania","2024-02-29",0,0,0,0,0,0,0,0
"Romania","2024-03-01",0,0,0,0,0,0,0,0
"Romania","2024-03-02",0,0,0,0,0,0,0,0
"Romania","2024-03-03",0,0,0,0,0,0,0,0
"Romania","2024-03-04",0,0,0,0,0,0,0,0
"Romania","2024-03-05",0,0,0,0,0,0,0,0
"Romania","2024-03-06",0,0,0,0,0,0,0,0
"Romania","2024-03-07",0,0,0,0,0,0,0,0
"Romania","2024-03-08",0,0,0,0,0,0,0,0
"Romania","2024-03-09",0,0,0,0,0,0,0,0
"Romania","2024-03-10",0,0,0,0,0,0,0,0
"Romania","2024-03-11",0,0,0,0,0,0,0,0
"Romania","2024-03-12",0,0,0,0,0,0,0,0
"Romania","2024-03-13",0,0,0,0,0,0,0,0
"Romania","2024-03-14",0,0,0,0,0,0,0,0
"Romania","2024-03-15",0,0,0,0,0,0,0,0
"Romania","2024-03-16",0,0,0,0,0,0,0,0
"Romania","2024-03-17",0,0,0,0,0,0,0,0
"Romania","2024-03-18",0,0,0,0,0,0,0,0
"Romania","2024-03-19",0,0,0,0,0,0,0,0
"Romania","2024-03-20",0,0,0,0,0,0,0,0
"Romania","2024-03-21",0,0,0,0,0,0,0,0
"Romania","2024-03-22",0,0,0,0,0,0,0,0
"Romania","2024-03-23",0,0,0,0,0,0,0,0
"Romania","2024-03-24",0,0,0,0,0,0,0,0
"Romania","2024-03-25",0,0,0,0,0,0,0,0
"Romania","2024-03-26",0,0,0,0,0,0,0,0
"Romania","2024-03-27",0,0,0,0,0,0,0,0
"Romania","2024-03-28",0,0,0,0,0,0,0,0
"Romania","2024-03-29",0,0,0,0,0,0,0,0
"Romania","2024-03-30",0,0,0,0,0,0,0,0
"Romania","2024-03-31",0,0,0,0,0,0,0,0
"Romania","2024-04-01",0,0,0,0,0,0,0,0
"Romania","2024-04-02",0,0,0,0,0,0,0,0
"Romania","2024-04-03",0,0,0,0,0,0,0,0
"Romania","2024-04-04",0,0,0,0,0,0,0,0
"Romania","2024-04-05",0,0,0,0,0,0,0,0
"Romania","2024-04-06",0,0,0,0,0,0,0,0
"Romania","2024-04-07",0,0,0,0,0,0,0,0
"Romania","2024-04-08",0,0,0,0,0,0,0,0
"Romania","2024-04-09",0,0,0,0,0,0,0,0
"Romania","2024-04-10",0,0,0,0,0,0,0,0
"Romania","2024-04-11",0,0,0,0,0,0,0,0
"Romania","2024-04-12",0,0,0,0,0,0,0,0
"Romania","2024-04-13",0,0,0,0,0,0,0,0
"Romania","2024-04-14",0,0,0,0,0,0,0,0
"Romania","2024-04-15",0,0,0,0,0,0,0,0
"Romania","2024-04-16",0,0,0,0,0,0,0,0
"Romania","2024-04-17",0,0,0,0,0,0,0,0
"Romania","2024-04-18",0,0,0,0,0,0,0,0
"Romania","2024-04-19",0,0,0,0,0,0,0,0
"Romania","2024-04-20",0,0,0,0,0,0,0,0
"Romania","2024-04-21",0,0,0,0,0,0,0,0
"Romania","2024-04-22",0,0,0,0,0,0,0,0
"Romania","2024-04-23",0,0,0,0,0,0,0,0
"Romania","2024-04-24",0,0,0,0,0,0,0,0
"Romania","2024-04-25",0,0,0,0,0,0,0,0
"Romania","2024-04-26",0,0,0,0,0,0,0,0
"Romania","2024-04-27",0,0,0,0,0,0,0,0
"Romania","2024-04-28",0,0,0,0,0,0,0,0
"Romania","2024-04-29",0,0,0,0,0,0,0,0
"Romania","2024-04-30",0,0,0,0,0,0,0,0
"Romania","2024-05-01",0,0,0,0,0,0,0,0
"Romania","2024-05-02",0,0,0,0,0,0,0,0
"Romania","2024-05-03",0,0,0,0,0,0,0,0
"Romania","2024-05-04",0,0,0,0,0,0,0,0
"Romania","2024-05-05",0,0,0,0,0,0,0,0
"Romania","2024-05-06",0,0,0,0,0,0,0,0
"Romania","2024-05-07",0,0,0,0,0,0,0,0
"Romania","2024-05-08",0,0,0,0,0,0,0,0
"Romania","2024-05-09",0,0,0,0,0,0,0,0
"Romania","2024-05-10",0,0,0,0,0,0,0,0
"Romania","2024-05-11",0,0,0,0,0,0,0,0
"Romania","2024-05-12",0,0,0,0,0,0,0,0
"Romania","2024-05-13",0,0,0,0,0,0,0,0
"Romania","2024-05-14",0,0,0,0,0,0,0,0
"Romania","2024-05-15",0,0,0,0,0,0,0,0
"Romania","2024-05-16",0,0,0,0,0,0,0,0
"Romania","2024-05-17",0,0,0,0,0,0,0,0
"Romania","2024-05-18",0,0,0,0,0,0,0,0
"Romania","2024-05-19",0,0,0,0,0,0,0,0
"Romania","2024-05-20",0,0,0,0,0,0,0,0
"Romania","2024-05-21",0,0,0,0,0,0,0,0
"Romania","2024-05-22",0,0,0,0,0,0,0,0
"Romania","2024-05-23",0,0,0,0,0,0,0,0
"Romania","2024-05-24",0,0,0,0,0,0,0,0
"Romania","2024-05-25",0,0,0,0,0,0,0,0
"Romania","2024-05-26",0,0,0,0,0,0,0,0
"Romania","2024-05-27",0,0,0,0,0,0,0,0
"Romania","2024-05-28",0,0,0,0,0,0,0,0
"Romania","2024-05-29",0,0,0,0,0,0,0,0
"Romania","2024-05-30",0,0,0,0,0,0,0,0
"Romania","2024-05-31",0,0,0,0,0,0,0,0
"Romania","2024-06-01",0,0,0,0,0,0,0,0
"Romania","2024-06-02",0,0,0,0,0,0,0,0
"Romania","2024-06-03",0,0,0,0,0,0,0,0
"Romania","2024-06-04",0,0,0,0,0,0,0,0
"Romania","2024-06-05",0,0,0,0,0,0,0,0
"Romania","2024-06-06",0,0,0,0,0,0,0,0
"Romania","2024-06-07",0,0,0,0,0,0,0,0
"Romania","2024-06-08",0,0,0,0,0,0,0,0
"Romania","2024-06-09",0,0,0,0,0,0,0,0
"Romania","2024-06-10",0,0,0,0,0,0,0,0
"Romania","2024-06-11",0,0,0,0,0,0,0,0
"Romania","2024-06-12",0,0,0,0,0,0,0,0
"Romania","2024-06-13",0,0,0,0,0,0,0,0
"Romania","2024-06-14",0,0,0,0,0,0,0,0
"Romania","2024-06-15",0,0,0,0,0,0,0,0
"Romania","2024-06-16",0,0,0,0,0,0,0,0
"Romania","2024-06-17",0,0,0,0,0,0,0,0
"Romania","2024-06-18",0,0,0,0,0,0,0,0
"Romania","2024-06-19",0,0,0,0,0,0,0,0
"Romania","2024-06-20",0,0,0,0,0,0,0,0
"Romania","2024-06-21",0,0,0,0,0,0,0,0
"Romania","2024-06-22",0,0,0,0,0,0,0,0
"Romania","2024-06-23",0,0,0,0,0,0,0,0
"Romania","2024-06-24",0,0,0,0,0,0,0,0
"Romania","2024-06-25",0,0,0,0,0,0,0,0
"Romania","2024-06-26",0,0,0,0,0,0,0,0
"Romania","2024-06-27",0,0,0,0,0,0,0,0
"Romania","2024-06-28",0,0,0,0,0,0,0,0
"Romania","2024-06-29",0,0,0,0,0,0,0,0
"Romania","2024-06-30",0,0,0,0,0,0,0,0
"Romania","2024-07-01",0,0,0,0,0,0,0,0
"Romania","2024-07-02",0,0,0,0,0,0,0,0
"Romania","2024-07-03",0,0,0,0,0,0,0,0
"Romania","2024-07-04",0,0,0,0,0,0,0,0
"Romania","2024-07-05",0,0,0,0,0,0,0,0
"Romania","2024-07-06",0,0,0,0,0,0,0,0
"Romania","2024-07-07",0,0,0,0,0,0,0,0
"Romania","2024-07-08",0,0,0,0,0,0,0,0
"Romania","2024-07-09",0,0,0,0,0,0,0,0
"Romania","2024-07-10",0,0,0,0,0,0,0,0
"Romania","2024-07-11",0,0,0,0,0,0,0,0
"Romania","2024-07-12",0,0,0,0,0,0,0,0
"Romania","2024-07-13",0,0,0,0,0,0,0,0
"Romania","2024-07-14",0,0,0,0,0,0,0,0
"Romania","2024-07-15",0,0,0,0,0,0,0,0
"Romania","2024-07-16",0,0,0,0,0,0,0,0
"Romania","2024-07-17",0,0,0,0,0,0,0,0
"Romania","2024-07-18",0,0,0,0,0,0,0,0
"Romania","2024-07-19",0,0,0,0,0,0,0,0
"Romania","2024-07-20",0,0,0,0,0,0,0,0
"Romania","2024-07-21",0,0,0,0,0,0,0,0
"Romania","2024-07-22",0,0,0,0,0,0,0,0
"Romania","2024-07-23",0,0,0,0,0,0,0,0
"Romania","2024-07-24",0,0,0,0,0,0,0,0
"Romania","2024-07-25",0,0,0,0,0,0,0,0
"Romania","2024-07-26",0,0,0,0,0,0,0,0
"Romania","2024-07-27",0,0,0,0,0,0,0,0
"Romania","2024-07-28",0,0,0,0,0,0,0,0
"Romania","2024-07-29",0,0,0,0,0,0,0,0
"Romania","2024-07-30",0,0,0,0,0,0,0,0
"Romania","2024-07-31",0,0,0,0,0,0,0,0
"Romania","2024-08-01",0,0,0,0,0,0,0,0
"Romania","2024-08-02",0,0,0,0,0,0,0,0
"Romania","2024-08-03",0,0,0,0,0,0,0,0
"Romania","2024-08-04",0,0,0,0,0,0,0,0
"Romania","2024-08-05",0,0,0,0,0,0,0,0
"Romania","2024-08-06",0,0,0,0,0,0,0,0
"Romania","2024-08-07",0,0,0,0,0,0,0,0
"Romania","2024-08-08",0,0,0,0,0,0,0,0
"Romania","2024-08-09",0,0,0,0,0,0,0,0
"Romania","2024-08-10",0,0,0,0,0,0,0,0
"Romania","2024-08-11",0,0,0,0,0,0,0,0
"Romania","2024-08-12",0,0,0,0,0,0,0,0
"Romania","2024-08-13",0,0,0,0,0,0,0,0
"Romania","2024-08-14",0,0,0,0,0,0,0,0
"Romania","2024-08-15",0,0,0,0,0,0,0,0
"Romania","2024-08-16",0,0,0,0,0,0,0,0
"Romania","2024-08-17",0,0,0,0,0,0,0,0
"Romania","2024-08-18",0,0,0,0,0,0,0,0
"Romania","2024-08-19",0,0,0,0,0,0,0,0
"Romania","2024-08-20",0,0,0,0,0,0,0,0
"Romania","2024-08-21",0,0,0,0,0,0,0,0
"Romania","2024-08-22",0,0,0,0,0,0,0,0
"Romania","2024-08-23",0,0,0,0,0,0,0,0
"Romania","2024-08-24",0,0,0,0,0,0,0,0
"Romania","2024-08-25",0,0,0,0,0,0,0,0
"Romania","2024-08-26",0,0,0,0,0,0,0,0
"Romania","2024-08-27",0,0,0,0,0,0,0,0
"Romania","2024-08-28",0,0,0,0,0,0,0,0
"Romania","2024-08-29",0,0,0,0,0,0,0,0
"Romania","2024-08-30",0,0,0,0,0,0,0,0
"Romania","2024-08-31",0,1,1,0,1,1,0,0
"Romania","2024-09-01",0,0,1,0,0,1,0,0
"Romania","2024-09-02",0,0,1,0,0,1,0,0
"Romania","2024-09-03",0,0,1,0,0,1,0,0
"Romania","2024-09-04",0,0,1,0,0,1,0,0
"Romania","2024-09-05",0,0,1,0,0,1,0,0
"Romania","2024-09-06",0,0,1,0,0,1,0,0
"Romania","2024-09-07",0,0,1,0,0,1,0,0
"Romania","2024-09-08",0,0,1,0,0,1,0,0
"Romania","2024-09-09",0,0,1,0,0,1,0,0
"Romania","2024-09-10",0,0,1,0,0,1,0,0
"Romania","2024-09-11",0,0,1,0,0,1,0,0
"Romania","2024-09-12",0,0,1,0,0,1,0,0
"Romania","2024-09-13",0,0,1,0,0,1,0,0
"Romania","2024-09-14",0,0,1,0,0,1,0,0
"Romania","2024-09-15",0,0,1,0,0,1,0,0
"Romania","2024-09-16",0,0,1,0,0,1,0,0
"Romania","2024-09-17",0,0,1,0,0,1,0,0
"Romania","2024-09-18",0,0,1,0,0,1,0,0
"Romania","2024-09-19",0,0,1,0,0,1,0,0
"Romania","2024-09-20",0,0,1,0,0,1,0,0
"Romania","2024-09-21",0,0,1,0,0,1,0,0
"Romania","2024-09-22",0,0,1,0,0,1,0,0
"Romania","2024-09-23",0,0,1,0,0,1,0,0
"Romania","2024-09-24",0,0,1,0,0,1,0,0
"Romania","2024-09-25",0,0,1,0,0,1,0,0
"Romania","2024-09-26",0,0,1,0,0,1,0,0
"Romania","2024-09-27",0,0,1,0,0,1,0,0
"Romania","2024-09-28",0,0,1,0,0,1,0,0
"Romania","2024-09-29",0,0,1,0,0,1,0,0
"Romania","2024-09-30",0,0,1,0,0,1,0,0
"Romania","2024-10-01",0,0,1,0,0,1,0,0
"Romania","2024-10-02",0,0,1,0,0,1,0,0
"Romania","2024-10-03",0,0,1,0,0,1,0,0
"Romania","2024-10-04",0,0,1,0,0,1,0,0
"Romania","2024-10-05",0,0,1,0,0,1,0,0
"Romania","2024-10-06",0,0,1,0,0,1,0,0
"Romania","2024-10-07",0,0,1,0,0,1,0,0
"Romania","2024-10-08",0,0,1,0,0,1,0,0
"Romania","2024-10-09",0,0,1,0,0,1,0,0
"Romania","2024-10-10",0,0,1,0,0,1,0,0
"Romania","2024-10-11",0,0,1,0,0,1,0,0
"Romania","2024-10-12",0,0,1,0,0,1,0,0
"Romania","2024-10-13",0,0,1,0,0,1,0,0
"Romania","2024-10-14",0,0,1,0,0,1,0,0
"Romania","2024-10-15",0,0,1,0,0,1,0,0
"Romania","2024-10-16",0,0,1,0,0,1,0,0
"Romania","2024-10-17",0,0,1,0,0,1,0,0
"Romania","2024-10-18",0,0,1,0,0,1,0,0
"Romania","2024-10-19",0,0,1,0,0,1,0,0
"Romania","2024-10-20",0,0,1,0,0,1,0,0
"Romania","2024-10-21",0,0,1,0,0,1,0,0
"Romania","2024-10-22",0,0,1,0,0,1,0,0
"Romania","2024-10-23",0,0,1,0,0,1,0,0
"Romania","2024-10-24",0,0,1,0,0,1,0,0
"Romania","2024-10-25",0,0,1,0,0,1,0,0
"Romania","2024-10-26",0,0,1,0,0,1,0,0
"Romania","2024-10-27",0,0,1,0,0,1,0,0
"Romania","2024-10-28",0,0,1,0,0,1,0,0
"Romania","2024-10-29",0,0,1,0,0,1,0,0
"Romania","2024-10-30",0,0,1,0,0,1,0,0
"Romania","2024-10-31",0,0,1,0,0,1,0,0
"Romania","2024-11-01",0,0,1,0,0,1,0,0
"Romania","2024-11-02",0,0,1,0,0,1,0,0
"Romania","2024-11-03",0,0,1,0,0,1,0,0
"Romania","2024-11-04",0,0,1,0,0,1,0,0
"Romania","2024-11-05",0,0,1,0,0,1,0,0
"Romania","2024-11-06",0,0,1,0,0,1,0,0
"Romania","2024-11-07",0,0,1,0,0,1,0,0
"Romania","2024-11-08",0,0,1,0,0,1,0,0
"Romania","2024-11-09",0,0,1,0,0,1,0,0
"Romania","2024-11-10",0,0,1,0,0,1,0,0
"Romania","2024-11-11",0,0,1,0,0,1,0,0
"Romania","2024-11-12",0,0,1,0,0,1,0,0
"Romania","2024-11-13",0,0,1,0,0,1,0,0
"Romania","2024-11-14",0,0,1,0,0,1,0,0
"Romania","2024-11-15",0,0,1,0,0,1,0,0
"Romania","2024-11-16",0,0,1,0,0,1,0,0
"Romania","2024-11-17",0,0,1,0,0,1,0,0
"Romania","2024-11-18",0,0,1,0,0,1,0,0
"Romania","2024-11-19",0,0,1,0,0,1,0,0
"Romania","2024-11-20",0,0,1,0,0,1,0,0
"Romania","2024-11-21",0,0,1,0,0,1,0,0
"Romania","2024-11-22",0,0,1,0,0,1,0,0
"Romania","2024-11-23",0,0,1,0,0,1,0,0
"Romania","2024-11-24",0,0,1,0,0,1,0,0
"Romania","2024-11-25",0,0,1,0,0,1,0,0
"Romania","2024-11-26",0,0,1,0,0,1,0,0
"Romania","2024-11-27",0,0,1,0,0,1,0,0
"Romania","2024-11-28",0,0,1,0,0,1,0,0
"Romania","2024-11-29",0,0,1,0,0,1,0,0
"Romania","2024-11-30",0,0,1,0,0,1,0,0
"Romania","2024-12-01",0,0,1,0,0,1,0,0
"Romania","2024-12-02",0,0,1,0,0,1,0,0
"Romania","2024-12-03",0,0,1,0,0,1,0,0
"Romania","2024-12-04",0,0,1,0,0,1,0,0
"Romania","2024-12-05",0,0,1,0,0,1,0,0
"Romania","2024-12-06",0,0,1,0,0,1,0,0
"Romania","2024-12-07",0,0,1,0,0,1,0,0
"Romania","2024-12-08",0,0,1,0,0,1,0,0
"Romania","2024-12-09",0,0,1,0,0,1,0,0
"Romania","2024-12-10",0,0,1,0,0,1,0,0
"Romania","2024-12-11",0,0,1,0,0,1,0,0
"Romania","2024-12-12",0,0,1,0,0,1,0,0
"Romania","2024-12-13",0,0,1,0,0,1,0,0
"Romania","2024-12-14",0,0,1,0,0,1,0,0
"Romania","2024-12-15",0,0,1,0,0,1,0,0
"Romania","2024-12-16",0,0,1,0,0,1,0,0
"Romania","2024-12-17",0,0,1,0,0,1,0,0
"Romania","2024-12-18",0,0,1,0,0,1,0,0
"Romania","2024-12-19",0,0,1,0,0,1,0,0
"Romania","2024-12-20",0,0,1,0,0,1,0,0
"Romania","2024-12-21",0,0,1,0,0,1,0,0
"Romania","2024-12-22",0,0,1,0,0,1,0,0
"Romania","2024-12-23",0,0,1,0,0,1,0,0
"Romania","2024-12-24",0,0,1,0,0,1,0,0
"Romania","2024-12-25",0,0,1,0,0,1,0,0
"Romania","2024-12-26",0,0,1,0,0,1,0,0
"Romania","2024-12-27",0,0,1,0,0,1,0,0
"Romania","2024-12-28",0,0,1,0,0,1,0,0
"Romania","2024-12-29",0,0,1,0,0,1,0,0
"Romania","2024-12-30",0,0,1,0,0,1,0,0
"Romania","2024-12-31",0,0,1,0,0,1,0,0
"Romania","2025-01-01",0,0,1,0,0,1,0,0
"Romania","2025-01-02",0,0,1,0,0,1,0,0
"Romania","2025-01-03",0,0,1,0,0,1,0,0
"Romania","2025-01-04",0,0,1,0,0,1,0,0
"Romania","2025-01-05",0,0,1,0,0,1,0,0
"Romania","2025-01-06",0,0,1,0,0,1,0,0
"Romania","2025-01-07",0,0,1,0,0,1,0,0
"Romania","2025-01-08",0,0,1,0,0,1,0,0
"Romania","2025-01-09",0,0,1,0,0,1,0,0
"Romania","2025-01-10",0,0,1,0,0,1,0,0
"Romania","2025-01-11",0,0,1,0,0,1,0,0
"Romania","2025-01-12",0,0,1,0,0,1,0,0
"Romania","2025-01-13",0,0,1,0,0,1,0,0
"Romania","2025-01-14",0,0,1,0,0,1,0,0
"Romania","2025-01-15",0,0,1,0,0,1,0,0
"Romania","2025-01-16",0,0,1,0,0,1,0,0
"Romania","2025-01-17",0,0,1,0,0,1,0,0
"Romania","2025-01-18",0,0,1,0,0,1,0,0
"Romania","2025-01-19",0,0,1,0,0,1,0,0
"Romania","2025-01-20",0,0,1,0,0,1,0,0
"Romania","2025-01-21",0,0,1,0,0,1,0,0
"Romania","2025-01-22",0,0,1,0,0,1,0,0
"Romania","2025-01-23",0,0,1,0,0,1,0,0
"Romania","2025-01-24",0,0,1,0,0,1,0,0
"Romania","2025-01-25",0,0,1,0,0,1,0,0
"Romania","2025-01-26",0,0,1,0,0,1,0,0
"Romania","2025-01-27",0,0,1,0,0,1,0,0
"Romania","2025-01-28",0,0,1,0,0,1,0,0
"Romania","2025-01-29",0,0,1,0,0,1,0,0
"Romania","2025-01-30",0,0,1,0,0,1,0,0
"Romania","2025-01-31",0,0,1,0,0,1,0,0
"Romania","2025-02-01",0,0,1,0,0,1,0,0
"Romania","2025-02-02",0,0,1,0,0,1,0,0
"Romania","2025-02-03",0,0,1,0,0,1,0,0
"Russian Federation","2024-01-01",0,0,0,0,0,0,0,0
"Russian Federation","2024-01-02",0,0,0,0,0,0,0,0
"Russian Federation","2024-01-03",0,0,0,0,0,0,0,0
"Russian Federation","2024-01-04",0,0,0,0,0,0,0,0
"Russian Federation","2024-01-05",0,0,0,0,0,0,0,0
"Russian Federation","2024-01-06",0,0,0,0,0,0,0,0
"Russian Federation","2024-01-07",0,0,0,0,0,0,0,0
"Russian Federation","2024-01-08",0,0,0,0,0,0,0,0
"Russian Federation","2024-01-09",0,0,0,0,0,0,0,0
"Russian Federation","2024-01-10",0,0,0,0,0,0,0,0
"Russian Federation","2024-01-11",0,0,0,0,0,0,0,0
"Russian Federation","2024-01-12",0,0,0,0,0,0,0,0
"Russian Federation","2024-01-13",0,0,0,0,0,0,0,0
"Russian Federation","2024-01-14",0,0,0,0,0,0,0,0
"Russian Federation","2024-01-15",0,0,0,0,0,0,0,0
"Russian Federation","2024-01-16",0,0,0,0,0,0,0,0
"Russian Federation","2024-01-17",0,0,0,0,0,0,0,0
"Russian Federation","2024-01-18",0,0,0,0,0,0,0,0
"Russian Federation","2024-01-19",0,0,0,0,0,0,0,0
"Russian Federation","2024-01-20",0,0,0,0,0,0,0,0
"Russian Federation","2024-01-21",0,0,0,0,0,0,0,0
"Russian Federation","2024-01-22",0,0,0,0,0,0,0,0
"Russian Federation","2024-01-23",0,0,0,0,0,0,0,0
"Russian Federation","2024-01-24",0,0,0,0,0,0,0,0
"Russian Federation","2024-01-25",0,0,0,0,0,0,0,0
"Russian Federation","2024-01-26",0,0,0,0,0,0,0,0
"Russian Federation","2024-01-27",0,0,0,0,0,0,0,0
"Russian Federation","2024-01-28",0,0,0,0,0,0,0,0
"Russian Federation","2024-01-29",0,0,0,0,0,0,0,0
"Russian Federation","2024-01-30",0,0,0,0,0,0,0,0
"Russian Federation","2024-01-31",0,2,2,0,2,2,0,0
"Russian Federation","2024-02-01",0,0,2,0,0,2,0,0
"Russian Federation","2024-02-02",0,0,2,0,0,2,0,0
"Russian Federation","2024-02-03",0,0,2,0,0,2,0,0
"Russian Federation","2024-02-04",0,0,2,0,0,2,0,0
"Russian Federation","2024-02-05",0,0,2,0,0,2,0,0
"Russian Federation","2024-02-06",0,0,2,0,0,2,0,0
"Russian Federation","2024-02-07",0,0,2,0,0,2,0,0
"Russian Federation","2024-02-08",0,0,2,0,0,2,0,0
"Russian Federation","2024-02-09",0,0,2,0,0,2,0,0
"Russian Federation","2024-02-10",0,0,2,0,0,2,0,0
"Russian Federation","2024-02-11",0,0,2,0,0,2,0,0
"Russian Federation","2024-02-12",0,0,2,0,0,2,0,0
"Russian Federation","2024-02-13",0,0,2,0,0,2,0,0
"Russian Federation","2024-02-14",0,0,2,0,0,2,0,0
"Russian Federation","2024-02-15",0,0,2,0,0,2,0,0
"Russian Federation","2024-02-16",0,0,2,0,0,2,0,0
"Russian Federation","2024-02-17",0,0,2,0,0,2,0,0
"Russian Federation","2024-02-18",0,0,2,0,0,2,0,0
"Russian Federation","2024-02-19",0,0,2,0,0,2,0,0
"Russian Federation","2024-02-20",0,0,2,0,0,2,0,0
"Russian Federation","2024-02-21",0,0,2,0,0,2,0,0
"Russian Federation","2024-02-22",0,0,2,0,0,2,0,0
"Russian Federation","2024-02-23",0,0,2,0,0,2,0,0
"Russian Federation","2024-02-24",0,0,2,0,0,2,0,0
"Russian Federation","2024-02-25",0,0,2,0,0,2,0,0
"Russian Federation","2024-02-26",0,0,2,0,0,2,0,0
"Russian Federation","2024-02-27",0,0,2,0,0,2,0,0
"Russian Federation","2024-02-28",0,0,2,0,0,2,0,0
"Russian Federation","2024-02-29",0,0,2,0,0,2,0,0
"Russian Federation","2024-03-01",0,0,2,0,0,2,0,0
"Russian Federation","2024-03-02",0,0,2,0,0,2,0,0
"Russian Federation","2024-03-03",0,0,2,0,0,2,0,0
"Russian Federation","2024-03-04",0,0,2,0,0,2,0,0
"Russian Federation","2024-03-05",0,0,2,0,0,2,0,0
"Russian Federation","2024-03-06",0,0,2,0,0,2,0,0
"Russian Federation","2024-03-07",0,0,2,0,0,2,0,0
"Russian Federation","2024-03-08",0,0,2,0,0,2,0,0
"Russian Federation","2024-03-09",0,0,2,0,0,2,0,0
"Russian Federation","2024-03-10",0,0,2,0,0,2,0,0
"Russian Federation","2024-03-11",0,0,2,0,0,2,0,0
"Russian Federation","2024-03-12",0,0,2,0,0,2,0,0
"Russian Federation","2024-03-13",0,0,2,0,0,2,0,0
"Russian Federation","2024-03-14",0,0,2,0,0,2,0,0
"Russian Federation","2024-03-15",0,0,2,0,0,2,0,0
"Russian Federation","2024-03-16",0,0,2,0,0,2,0,0
"Russian Federation","2024-03-17",0,0,2,0,0,2,0,0
"Russian Federation","2024-03-18",0,0,2,0,0,2,0,0
"Russian Federation","2024-03-19",0,0,2,0,0,2,0,0
"Russian Federation","2024-03-20",0,0,2,0,0,2,0,0
"Russian Federation","2024-03-21",0,0,2,0,0,2,0,0
"Russian Federation","2024-03-22",0,0,2,0,0,2,0,0
"Russian Federation","2024-03-23",0,0,2,0,0,2,0,0
"Russian Federation","2024-03-24",0,0,2,0,0,2,0,0
"Russian Federation","2024-03-25",0,0,2,0,0,2,0,0
"Russian Federation","2024-03-26",0,0,2,0,0,2,0,0
"Russian Federation","2024-03-27",0,0,2,0,0,2,0,0
"Russian Federation","2024-03-28",0,0,2,0,0,2,0,0
"Russian Federation","2024-03-29",0,0,2,0,0,2,0,0
"Russian Federation","2024-03-30",0,0,2,0,0,2,0,0
"Russian Federation","2024-03-31",0,0,2,0,0,2,0,0
"Russian Federation","2024-04-01",0,0,2,0,0,2,0,0
"Russian Federation","2024-04-02",0,0,2,0,0,2,0,0
"Russian Federation","2024-04-03",0,0,2,0,0,2,0,0
"Russian Federation","2024-04-04",0,0,2,0,0,2,0,0
"Russian Federation","2024-04-05",0,0,2,0,0,2,0,0
"Russian Federation","2024-04-06",0,0,2,0,0,2,0,0
"Russian Federation","2024-04-07",0,0,2,0,0,2,0,0
"Russian Federation","2024-04-08",0,0,2,0,0,2,0,0
"Russian Federation","2024-04-09",0,0,2,0,0,2,0,0
"Russian Federation","2024-04-10",0,0,2,0,0,2,0,0
"Russian Federation","2024-04-11",0,0,2,0,0,2,0,0
"Russian Federation","2024-04-12",0,0,2,0,0,2,0,0
"Russian Federation","2024-04-13",0,0,2,0,0,2,0,0
"Russian Federation","2024-04-14",0,0,2,0,0,2,0,0
"Russian Federation","2024-04-15",0,0,2,0,0,2,0,0
"Russian Federation","2024-04-16",0,0,2,0,0,2,0,0
"Russian Federation","2024-04-17",0,0,2,0,0,2,0,0
"Russian Federation","2024-04-18",0,0,2,0,0,2,0,0
"Russian Federation","2024-04-19",0,0,2,0,0,2,0,0
"Russian Federation","2024-04-20",0,0,2,0,0,2,0,0
"Russian Federation","2024-04-21",0,0,2,0,0,2,0,0
"Russian Federation","2024-04-22",0,0,2,0,0,2,0,0
"Russian Federation","2024-04-23",0,0,2,0,0,2,0,0
"Russian Federation","2024-04-24",0,0,2,0,0,2,0,0
"Russian Federation","2024-04-25",0,0,2,0,0,2,0,0
"Russian Federation","2024-04-26",0,0,2,0,0,2,0,0
"Russian Federation","2024-04-27",0,0,2,0,0,2,0,0
"Russian Federation","2024-04-28",0,0,2,0,0,2,0,0
"Russian Federation","2024-04-29",0,0,2,0,0,2,0,0
"Russian Federation","2024-04-30",0,0,2,0,0,2,0,0
"Russian Federation","2024-05-01",0,0,2,0,0,2,0,0
"Russian Federation","2024-05-02",0,0,2,0,0,2,0,0
"Russian Federation","2024-05-03",0,0,2,0,0,2,0,0
"Russian Federation","2024-05-04",0,0,2,0,0,2,0,0
"Russian Federation","2024-05-05",0,0,2,0,0,2,0,0
"Russian Federation","2024-05-06",0,0,2,0,0,2,0,0
"Russian Federation","2024-05-07",0,0,2,0,0,2,0,0
"Russian Federation","2024-05-08",0,0,2,0,0,2,0,0
"Russian Federation","2024-05-09",0,0,2,0,0,2,0,0
"Russian Federation","2024-05-10",0,0,2,0,0,2,0,0
"Russian Federation","2024-05-11",0,0,2,0,0,2,0,0
"Russian Federation","2024-05-12",0,0,2,0,0,2,0,0
"Russian Federation","2024-05-13",0,0,2,0,0,2,0,0
"Russian Federation","2024-05-14",0,0,2,0,0,2,0,0
"Russian Federation","2024-05-15",0,0,2,0,0,2,0,0
"Russian Federation","2024-05-16",0,0,2,0,0,2,0,0
"Russian Federation","2024-05-17",0,0,2,0,0,2,0,0
"Russian Federation","2024-05-18",0,0,2,0,0,2,0,0
"Russian Federation","2024-05-19",0,0,2,0,0,2,0,0
"Russian Federation","2024-05-20",0,0,2,0,0,2,0,0
"Russian Federation","2024-05-21",0,0,2,0,0,2,0,0
"Russian Federation","2024-05-22",0,0,2,0,0,2,0,0
"Russian Federation","2024-05-23",0,0,2,0,0,2,0,0
"Russian Federation","2024-05-24",0,0,2,0,0,2,0,0
"Russian Federation","2024-05-25",0,0,2,0,0,2,0,0
"Russian Federation","2024-05-26",0,0,2,0,0,2,0,0
"Russian Federation","2024-05-27",0,0,2,0,0,2,0,0
"Russian Federation","2024-05-28",0,0,2,0,0,2,0,0
"Russian Federation","2024-05-29",0,0,2,0,0,2,0,0
"Russian Federation","2024-05-30",0,0,2,0,0,2,0,0
"Russian Federation","2024-05-31",0,0,2,0,0,2,0,0
"Russian Federation","2024-06-01",0,0,2,0,0,2,0,0
"Russian Federation","2024-06-02",0,0,2,0,0,2,0,0
"Russian Federation","2024-06-03",0,0,2,0,0,2,0,0
"Russian Federation","2024-06-04",0,0,2,0,0,2,0,0
"Russian Federation","2024-06-05",0,0,2,0,0,2,0,0
"Russian Federation","2024-06-06",0,0,2,0,0,2,0,0
"Russian Federation","2024-06-07",0,0,2,0,0,2,0,0
"Russian Federation","2024-06-08",0,0,2,0,0,2,0,0
"Russian Federation","2024-06-09",0,0,2,0,0,2,0,0
"Russian Federation","2024-06-10",0,0,2,0,0,2,0,0
"Russian Federation","2024-06-11",0,0,2,0,0,2,0,0
"Russian Federation","2024-06-12",0,0,2,0,0,2,0,0
"Russian Federation","2024-06-13",0,0,2,0,0,2,0,0
"Russian Federation","2024-06-14",0,0,2,0,0,2,0,0
"Russian Federation","2024-06-15",0,0,2,0,0,2,0,0
"Russian Federation","2024-06-16",0,0,2,0,0,2,0,0
"Russian Federation","2024-06-17",0,0,2,0,0,2,0,0
"Russian Federation","2024-06-18",0,0,2,0,0,2,0,0
"Russian Federation","2024-06-19",0,0,2,0,0,2,0,0
"Russian Federation","2024-06-20",0,0,2,0,0,2,0,0
"Russian Federation","2024-06-21",0,0,2,0,0,2,0,0
"Russian Federation","2024-06-22",0,0,2,0,0,2,0,0
"Russian Federation","2024-06-23",0,0,2,0,0,2,0,0
"Russian Federation","2024-06-24",0,0,2,0,0,2,0,0
"Russian Federation","2024-06-25",0,0,2,0,0,2,0,0
"Russian Federation","2024-06-26",0,0,2,0,0,2,0,0
"Russian Federation","2024-06-27",0,0,2,0,0,2,0,0
"Russian Federation","2024-06-28",0,0,2,0,0,2,0,0
"Russian Federation","2024-06-29",0,0,2,0,0,2,0,0
"Russian Federation","2024-06-30",0,0,2,0,0,2,0,0
"Russian Federation","2024-07-01",0,0,2,0,0,2,0,0
"Russian Federation","2024-07-02",0,0,2,0,0,2,0,0
"Russian Federation","2024-07-03",0,0,2,0,0,2,0,0
"Russian Federation","2024-07-04",0,0,2,0,0,2,0,0
"Russian Federation","2024-07-05",0,0,2,0,0,2,0,0
"Russian Federation","2024-07-06",0,0,2,0,0,2,0,0
"Russian Federation","2024-07-07",0,0,2,0,0,2,0,0
"Russian Federation","2024-07-08",0,0,2,0,0,2,0,0
"Russian Federation","2024-07-09",0,0,2,0,0,2,0,0
"Russian Federation","2024-07-10",0,0,2,0,0,2,0,0
"Russian Federation","2024-07-11",0,0,2,0,0,2,0,0
"Russian Federation","2024-07-12",0,0,2,0,0,2,0,0
"Russian Federation","2024-07-13",0,0,2,0,0,2,0,0
"Russian Federation","2024-07-14",0,0,2,0,0,2,0,0
"Russian Federation","2024-07-15",0,0,2,0,0,2,0,0
"Russian Federation","2024-07-16",0,0,2,0,0,2,0,0
"Russian Federation","2024-07-17",0,0,2,0,0,2,0,0
"Russian Federation","2024-07-18",0,0,2,0,0,2,0,0
"Russian Federation","2024-07-19",0,0,2,0,0,2,0,0
"Russian Federation","2024-07-20",0,0,2,0,0,2,0,0
"Russian Federation","2024-07-21",0,0,2,0,0,2,0,0
"Russian Federation","2024-07-22",0,0,2,0,0,2,0,0
"Russian Federation","2024-07-23",0,0,2,0,0,2,0,0
"Russian Federation","2024-07-24",0,0,2,0,0,2,0,0
"Russian Federation","2024-07-25",0,0,2,0,0,2,0,0
"Russian Federation","2024-07-26",0,0,2,0,0,2,0,0
"Russian Federation","2024-07-27",0,0,2,0,0,2,0,0
"Russian Federation","2024-07-28",0,0,2,0,0,2,0,0
"Russian Federation","2024-07-29",0,0,2,0,0,2,0,0
"Russian Federation","2024-07-30",0,0,2,0,0,2,0,0
"Russian Federation","2024-07-31",0,0,2,0,0,2,0,0
"Russian Federation","2024-08-01",0,0,2,0,0,2,0,0
"Russian Federation","2024-08-02",0,0,2,0,0,2,0,0
"Russian Federation","2024-08-03",0,0,2,0,0,2,0,0
"Russian Federation","2024-08-04",0,0,2,0,0,2,0,0
"Russian Federation","2024-08-05",0,0,2,0,0,2,0,0
"Russian Federation","2024-08-06",0,0,2,0,0,2,0,0
"Russian Federation","2024-08-07",0,0,2,0,0,2,0,0
"Russian Federation","2024-08-08",0,0,2,0,0,2,0,0
"Russian Federation","2024-08-09",0,0,2,0,0,2,0,0
"Russian Federation","2024-08-10",0,0,2,0,0,2,0,0
"Russian Federation","2024-08-11",0,0,2,0,0,2,0,0
"Russian Federation","2024-08-12",0,0,2,0,0,2,0,0
"Russian Federation","2024-08-13",0,0,2,0,0,2,0,0
"Russian Federation","2024-08-14",0,0,2,0,0,2,0,0
"Russian Federation","2024-08-15",0,0,2,0,0,2,0,0
"Russian Federation","2024-08-16",0,0,2,0,0,2,0,0
"Russian Federation","2024-08-17",0,0,2,0,0,2,0,0
"Russian Federation","2024-08-18",0,0,2,0,0,2,0,0
"Russian Federation","2024-08-19",0,0,2,0,0,2,0,0
"Russian Federation","2024-08-20",0,0,2,0,0,2,0,0
"Russian Federation","2024-08-21",0,0,2,0,0,2,0,0
"Russian Federation","2024-08-22",0,0,2,0,0,2,0,0
"Russian Federation","2024-08-23",0,0,2,0,0,2,0,0
"Russian Federation","2024-08-24",0,0,2,0,0,2,0,0
"Russian Federation","2024-08-25",0,0,2,0,0,2,0,0
"Russian Federation","2024-08-26",0,0,2,0,0,2,0,0
"Russian Federation","2024-08-27",0,0,2,0,0,2,0,0
"Russian Federation","2024-08-28",0,0,2,0,0,2,0,0
"Russian Federation","2024-08-29",0,0,2,0,0,2,0,0
"Russian Federation","2024-08-30",0,0,2,0,0,2,0,0
"Russian Federation","2024-08-31",0,0,2,0,0,2,0,0
"Russian Federation","2024-09-01",0,0,2,0,0,2,0,0
"Russian Federation","2024-09-02",0,0,2,0,0,2,0,0
"Russian Federation","2024-09-03",0,0,2,0,0,2,0,0
"Russian Federation","2024-09-04",0,0,2,0,0,2,0,0
"Russian Federation","2024-09-05",0,0,2,0,0,2,0,0
"Russian Federation","2024-09-06",0,0,2,0,0,2,0,0
"Russian Federation","2024-09-07",0,0,2,0,0,2,0,0
"Russian Federation","2024-09-08",0,0,2,0,0,2,0,0
"Russian Federation","2024-09-09",0,0,2,0,0,2,0,0
"Russian Federation","2024-09-10",0,0,2,0,0,2,0,0
"Russian Federation","2024-09-11",0,0,2,0,0,2,0,0
"Russian Federation","2024-09-12",0,0,2,0,0,2,0,0
"Russian Federation","2024-09-13",0,0,2,0,0,2,0,0
"Russian Federation","2024-09-14",0,0,2,0,0,2,0,0
"Russian Federation","2024-09-15",0,0,2,0,0,2,0,0
"Russian Federation","2024-09-16",0,0,2,0,0,2,0,0
"Russian Federation","2024-09-17",0,0,2,0,0,2,0,0
"Russian Federation","2024-09-18",0,0,2,0,0,2,0,0
"Russian Federation","2024-09-19",0,0,2,0,0,2,0,0
"Russian Federation","2024-09-20",0,0,2,0,0,2,0,0
"Russian Federation","2024-09-21",0,0,2,0,0,2,0,0
"Russian Federation","2024-09-22",0,0,2,0,0,2,0,0
"Russian Federation","2024-09-23",0,0,2,0,0,2,0,0
"Russian Federation","2024-09-24",0,0,2,0,0,2,0,0
"Russian Federation","2024-09-25",0,0,2,0,0,2,0,0
"Russian Federation","2024-09-26",0,0,2,0,0,2,0,0
"Russian Federation","2024-09-27",0,0,2,0,0,2,0,0
"Russian Federation","2024-09-28",0,0,2,0,0,2,0,0
"Russian Federation","2024-09-29",0,0,2,0,0,2,0,0
"Russian Federation","2024-09-30",0,0,2,0,0,2,0,0
"Russian Federation","2024-10-01",0,0,2,0,0,2,0,0
"Russian Federation","2024-10-02",0,0,2,0,0,2,0,0
"Russian Federation","2024-10-03",0,0,2,0,0,2,0,0
"Russian Federation","2024-10-04",0,0,2,0,0,2,0,0
"Russian Federation","2024-10-05",0,0,2,0,0,2,0,0
"Russian Federation","2024-10-06",0,0,2,0,0,2,0,0
"Russian Federation","2024-10-07",0,0,2,0,0,2,0,0
"Russian Federation","2024-10-08",0,0,2,0,0,2,0,0
"Russian Federation","2024-10-09",0,0,2,0,0,2,0,0
"Russian Federation","2024-10-10",0,0,2,0,0,2,0,0
"Russian Federation","2024-10-11",0,0,2,0,0,2,0,0
"Russian Federation","2024-10-12",0,0,2,0,0,2,0,0
"Russian Federation","2024-10-13",0,0,2,0,0,2,0,0
"Russian Federation","2024-10-14",0,0,2,0,0,2,0,0
"Russian Federation","2024-10-15",0,0,2,0,0,2,0,0
"Russian Federation","2024-10-16",0,0,2,0,0,2,0,0
"Russian Federation","2024-10-17",0,0,2,0,0,2,0,0
"Russian Federation","2024-10-18",0,0,2,0,0,2,0,0
"Russian Federation","2024-10-19",0,0,2,0,0,2,0,0
"Russian Federation","2024-10-20",0,0,2,0,0,2,0,0
"Russian Federation","2024-10-21",0,0,2,0,0,2,0,0
"Russian Federation","2024-10-22",0,0,2,0,0,2,0,0
"Russian Federation","2024-10-23",0,0,2,0,0,2,0,0
"Russian Federation","2024-10-24",0,0,2,0,0,2,0,0
"Russian Federation","2024-10-25",0,0,2,0,0,2,0,0
"Russian Federation","2024-10-26",0,0,2,0,0,2,0,0
"Russian Federation","2024-10-27",0,0,2,0,0,2,0,0
"Russian Federation","2024-10-28",0,0,2,0,0,2,0,0
"Russian Federation","2024-10-29",0,0,2,0,0,2,0,0
"Russian Federation","2024-10-30",0,0,2,0,0,2,0,0
"Russian Federation","2024-10-31",0,0,2,0,0,2,0,0
"Russian Federation","2024-11-01",0,0,2,0,0,2,0,0
"Russian Federation","2024-11-02",0,0,2,0,0,2,0,0
"Russian Federation","2024-11-03",0,0,2,0,0,2,0,0
"Russian Federation","2024-11-04",0,0,2,0,0,2,0,0
"Russian Federation","2024-11-05",0,0,2,0,0,2,0,0
"Russian Federation","2024-11-06",0,0,2,0,0,2,0,0
"Russian Federation","2024-11-07",0,0,2,0,0,2,0,0
"Russian Federation","2024-11-08",0,0,2,0,0,2,0,0
"Russian Federation","2024-11-09",0,0,2,0,0,2,0,0
"Russian Federation","2024-11-10",0,0,2,0,0,2,0,0
"Russian Federation","2024-11-11",0,0,2,0,0,2,0,0
"Russian Federation","2024-11-12",0,0,2,0,0,2,0,0
"Russian Federation","2024-11-13",0,0,2,0,0,2,0,0
"Russian Federation","2024-11-14",0,0,2,0,0,2,0,0
"Russian Federation","2024-11-15",0,0,2,0,0,2,0,0
"Russian Federation","2024-11-16",0,0,2,0,0,2,0,0
"Russian Federation","2024-11-17",0,0,2,0,0,2,0,0
"Russian Federation","2024-11-18",0,0,2,0,0,2,0,0
"Russian Federation","2024-11-19",0,0,2,0,0,2,0,0
"Russian Federation","2024-11-20",0,0,2,0,0,2,0,0
"Russian Federation","2024-11-21",0,0,2,0,0,2,0,0
"Russian Federation","2024-11-22",0,0,2,0,0,2,0,0
"Russian Federation","2024-11-23",0,0,2,0,0,2,0,0
"Russian Federation","2024-11-24",0,0,2,0,0,2,0,0
"Russian Federation","2024-11-25",0,0,2,0,0,2,0,0
"Russian Federation","2024-11-26",0,0,2,0,0,2,0,0
"Russian Federation","2024-11-27",0,0,2,0,0,2,0,0
"Russian Federation","2024-11-28",0,0,2,0,0,2,0,0
"Russian Federation","2024-11-29",0,0,2,0,0,2,0,0
"Russian Federation","2024-11-30",0,0,2,0,0,2,0,0
"Russian Federation","2024-12-01",0,0,2,0,0,2,0,0
"Russian Federation","2024-12-02",0,0,2,0,0,2,0,0
"Russian Federation","2024-12-03",0,0,2,0,0,2,0,0
"Russian Federation","2024-12-04",0,0,2,0,0,2,0,0
"Russian Federation","2024-12-05",0,0,2,0,0,2,0,0
"Russian Federation","2024-12-06",0,0,2,0,0,2,0,0
"Russian Federation","2024-12-07",0,0,2,0,0,2,0,0
"Russian Federation","2024-12-08",0,0,2,0,0,2,0,0
"Russian Federation","2024-12-09",0,0,2,0,0,2,0,0
"Russian Federation","2024-12-10",0,0,2,0,0,2,0,0
"Russian Federation","2024-12-11",0,0,2,0,0,2,0,0
"Russian Federation","2024-12-12",0,0,2,0,0,2,0,0
"Russian Federation","2024-12-13",0,0,2,0,0,2,0,0
"Russian Federation","2024-12-14",0,0,2,0,0,2,0,0
"Russian Federation","2024-12-15",0,0,2,0,0,2,0,0
"Russian Federation","2024-12-16",0,0,2,0,0,2,0,0
"Russian Federation","2024-12-17",0,0,2,0,0,2,0,0
"Russian Federation","2024-12-18",0,0,2,0,0,2,0,0
"Russian Federation","2024-12-19",0,0,2,0,0,2,0,0
"Russian Federation","2024-12-20",0,0,2,0,0,2,0,0
"Russian Federation","2024-12-21",0,0,2,0,0,2,0,0
"Russian Federation","2024-12-22",0,0,2,0,0,2,0,0
"Russian Federation","2024-12-23",0,0,2,0,0,2,0,0
"Russian Federation","2024-12-24",0,0,2,0,0,2,0,0
"Russian Federation","2024-12-25",0,0,2,0,0,2,0,0
"Russian Federation","2024-12-26",0,0,2,0,0,2,0,0
"Russian Federation","2024-12-27",0,0,2,0,0,2,0,0
"Russian Federation","2024-12-28",0,0,2,0,0,2,0,0
"Russian Federation","2024-12-29",0,0,2,0,0,2,0,0
"Russian Federation","2024-12-30",0,0,2,0,0,2,0,0
"Russian Federation","2024-12-31",0,0,2,0,0,2,0,0
"Russian Federation","2025-01-01",0,0,2,0,0,2,0,0
"Russian Federation","2025-01-02",0,0,2,0,0,2,0,0
"Russian Federation","2025-01-03",0,0,2,0,0,2,0,0
"Russian Federation","2025-01-04",0,0,2,0,0,2,0,0
"Russian Federation","2025-01-05",0,0,2,0,0,2,0,0
"Russian Federation","2025-01-06",0,0,2,0,0,2,0,0
"Russian Federation","2025-01-07",0,0,2,0,0,2,0,0
"Russian Federation","2025-01-08",0,0,2,0,0,2,0,0
"Russian Federation","2025-01-09",0,0,2,0,0,2,0,0
"Russian Federation","2025-01-10",0,0,2,0,0,2,0,0
"Russian Federation","2025-01-11",0,0,2,0,0,2,0,0
"Russian Federation","2025-01-12",0,0,2,0,0,2,0,0
"Russian Federation","2025-01-13",0,0,2,0,0,2,0,0
"Russian Federation","2025-01-14",0,0,2,0,0,2,0,0
"Russian Federation","2025-01-15",0,0,2,0,0,2,0,0
"Russian Federation","2025-01-16",0,0,2,0,0,2,0,0
"Russian Federation","2025-01-17",0,0,2,0,0,2,0,0
"Russian Federation","2025-01-18",0,0,2,0,0,2,0,0
"Russian Federation","2025-01-19",0,0,2,0,0,2,0,0
"Russian Federation","2025-01-20",0,0,2,0,0,2,0,0
"Russian Federation","2025-01-21",0,0,2,0,0,2,0,0
"Russian Federation","2025-01-22",0,0,2,0,0,2,0,0
"Russian Federation","2025-01-23",0,0,2,0,0,2,0,0
"Russian Federation","2025-01-24",0,0,2,0,0,2,0,0
"Russian Federation","2025-01-25",0,0,2,0,0,2,0,0
"Russian Federation","2025-01-26",0,0,2,0,0,2,0,0
"Russian Federation","2025-01-27",0,0,2,0,0,2,0,0
"Russian Federation","2025-01-28",0,0,2,0,0,2,0,0
"Russian Federation","2025-01-29",0,0,2,0,0,2,0,0
"Russian Federation","2025-01-30",0,0,2,0,0,2,0,0
"Russian Federation","2025-01-31",0,0,2,0,0,2,0,0
"Russian Federation","2025-02-01",0,0,2,0,0,2,0,0
"Russian Federation","2025-02-02",0,0,2,0,0,2,0,0
"Russian Federation","2025-02-03",0,0,2,0,0,2,0,0
"Rwanda","2024-01-01",0,0,0,0,0,0,0,0
"Rwanda","2024-01-02",0,0,0,0,0,0,0,0
"Rwanda","2024-01-03",0,0,0,0,0,0,0,0
"Rwanda","2024-01-04",0,0,0,0,0,0,0,0
"Rwanda","2024-01-05",0,0,0,0,0,0,0,0
"Rwanda","2024-01-06",0,0,0,0,0,0,0,0
"Rwanda","2024-01-07",0,0,0,0,0,0,0,0
"Rwanda","2024-01-08",0,0,0,0,0,0,0,0
"Rwanda","2024-01-09",0,0,0,0,0,0,0,0
"Rwanda","2024-01-10",0,0,0,0,0,0,0,0
"Rwanda","2024-01-11",0,0,0,0,0,0,0,0
"Rwanda","2024-01-12",0,0,0,0,0,0,0,0
"Rwanda","2024-01-13",0,0,0,0,0,0,0,0
"Rwanda","2024-01-14",0,0,0,0,0,0,0,0
"Rwanda","2024-01-15",0,0,0,0,0,0,0,0
"Rwanda","2024-01-16",0,0,0,0,0,0,0,0
"Rwanda","2024-01-17",0,0,0,0,0,0,0,0
"Rwanda","2024-01-18",0,0,0,0,0,0,0,0
"Rwanda","2024-01-19",0,0,0,0,0,0,0,0
"Rwanda","2024-01-20",0,0,0,0,0,0,0,0
"Rwanda","2024-01-21",0,0,0,0,0,0,0,0
"Rwanda","2024-01-22",0,0,0,0,0,0,0,0
"Rwanda","2024-01-23",0,0,0,0,0,0,0,0
"Rwanda","2024-01-24",0,0,0,0,0,0,0,0
"Rwanda","2024-01-25",0,0,0,0,0,0,0,0
"Rwanda","2024-01-26",0,0,0,0,0,0,0,0
"Rwanda","2024-01-27",0,0,0,0,0,0,0,0
"Rwanda","2024-01-28",0,0,0,0,0,0,0,0
"Rwanda","2024-01-29",0,0,0,0,0,0,0,0
"Rwanda","2024-01-30",0,0,0,0,0,0,0,0
"Rwanda","2024-01-31",0,0,0,0,0,0,0,0
"Rwanda","2024-02-01",0,0,0,0,0,0,0,0
"Rwanda","2024-02-02",0,0,0,0,0,0,0,0
"Rwanda","2024-02-03",0,0,0,0,0,0,0,0
"Rwanda","2024-02-04",0,0,0,0,0,0,0,0
"Rwanda","2024-02-05",0,0,0,0,0,0,0,0
"Rwanda","2024-02-06",0,0,0,0,0,0,0,0
"Rwanda","2024-02-07",0,0,0,0,0,0,0,0
"Rwanda","2024-02-08",0,0,0,0,0,0,0,0
"Rwanda","2024-02-09",0,0,0,0,0,0,0,0
"Rwanda","2024-02-10",0,0,0,0,0,0,0,0
"Rwanda","2024-02-11",0,0,0,0,0,0,0,0
"Rwanda","2024-02-12",0,0,0,0,0,0,0,0
"Rwanda","2024-02-13",0,0,0,0,0,0,0,0
"Rwanda","2024-02-14",0,0,0,0,0,0,0,0
"Rwanda","2024-02-15",0,0,0,0,0,0,0,0
"Rwanda","2024-02-16",0,0,0,0,0,0,0,0
"Rwanda","2024-02-17",0,0,0,0,0,0,0,0
"Rwanda","2024-02-18",0,0,0,0,0,0,0,0
"Rwanda","2024-02-19",0,0,0,0,0,0,0,0
"Rwanda","2024-02-20",0,0,0,0,0,0,0,0
"Rwanda","2024-02-21",0,0,0,0,0,0,0,0
"Rwanda","2024-02-22",0,0,0,0,0,0,0,0
"Rwanda","2024-02-23",0,0,0,0,0,0,0,0
"Rwanda","2024-02-24",0,0,0,0,0,0,0,0
"Rwanda","2024-02-25",0,0,0,0,0,0,0,0
"Rwanda","2024-02-26",0,0,0,0,0,0,0,0
"Rwanda","2024-02-27",0,0,0,0,0,0,0,0
"Rwanda","2024-02-28",0,0,0,0,0,0,0,0
"Rwanda","2024-02-29",0,0,0,0,0,0,0,0
"Rwanda","2024-03-01",0,0,0,0,0,0,0,0
"Rwanda","2024-03-02",0,0,0,0,0,0,0,0
"Rwanda","2024-03-03",0,0,0,0,0,0,0,0
"Rwanda","2024-03-04",0,0,0,0,0,0,0,0
"Rwanda","2024-03-05",0,0,0,0,0,0,0,0
"Rwanda","2024-03-06",0,0,0,0,0,0,0,0
"Rwanda","2024-03-07",0,0,0,0,0,0,0,0
"Rwanda","2024-03-08",0,0,0,0,0,0,0,0
"Rwanda","2024-03-09",0,0,0,0,0,0,0,0
"Rwanda","2024-03-10",0,0,0,0,0,0,0,0
"Rwanda","2024-03-11",0,0,0,0,0,0,0,0
"Rwanda","2024-03-12",0,0,0,0,0,0,0,0
"Rwanda","2024-03-13",0,0,0,0,0,0,0,0
"Rwanda","2024-03-14",0,0,0,0,0,0,0,0
"Rwanda","2024-03-15",0,0,0,0,0,0,0,0
"Rwanda","2024-03-16",0,0,0,0,0,0,0,0
"Rwanda","2024-03-17",0,0,0,0,0,0,0,0
"Rwanda","2024-03-18",0,0,0,0,0,0,0,0
"Rwanda","2024-03-19",0,0,0,0,0,0,0,0
"Rwanda","2024-03-20",0,0,0,0,0,0,0,0
"Rwanda","2024-03-21",0,0,0,0,0,0,0,0
"Rwanda","2024-03-22",0,0,0,0,0,0,0,0
"Rwanda","2024-03-23",0,0,0,0,0,0,0,0
"Rwanda","2024-03-24",0,0,0,0,0,0,0,0
"Rwanda","2024-03-25",0,0,0,0,0,0,0,0
"Rwanda","2024-03-26",0,0,0,0,0,0,0,0
"Rwanda","2024-03-27",0,0,0,0,0,0,0,0
"Rwanda","2024-03-28",0,0,0,0,0,0,0,0
"Rwanda","2024-03-29",0,0,0,0,0,0,0,0
"Rwanda","2024-03-30",0,0,0,0,0,0,0,0
"Rwanda","2024-03-31",0,0,0,0,0,0,0,0
"Rwanda","2024-04-01",0,0,0,0,0,0,0,0
"Rwanda","2024-04-02",0,0,0,0,0,0,0,0
"Rwanda","2024-04-03",0,0,0,0,0,0,0,0
"Rwanda","2024-04-04",0,0,0,0,0,0,0,0
"Rwanda","2024-04-05",0,0,0,0,0,0,0,0
"Rwanda","2024-04-06",0,0,0,0,0,0,0,0
"Rwanda","2024-04-07",0,0,0,0,0,0,0,0
"Rwanda","2024-04-08",0,0,0,0,0,0,0,0
"Rwanda","2024-04-09",0,0,0,0,0,0,0,0
"Rwanda","2024-04-10",0,0,0,0,0,0,0,0
"Rwanda","2024-04-11",0,0,0,0,0,0,0,0
"Rwanda","2024-04-12",0,0,0,0,0,0,0,0
"Rwanda","2024-04-13",0,0,0,0,0,0,0,0
"Rwanda","2024-04-14",0,0,0,0,0,0,0,0
"Rwanda","2024-04-15",0,0,0,0,0,0,0,0
"Rwanda","2024-04-16",0,0,0,0,0,0,0,0
"Rwanda","2024-04-17",0,0,0,0,0,0,0,0
"Rwanda","2024-04-18",0,0,0,0,0,0,0,0
"Rwanda","2024-04-19",0,0,0,0,0,0,0,0
"Rwanda","2024-04-20",0,0,0,0,0,0,0,0
"Rwanda","2024-04-21",0,0,0,0,0,0,0,0
"Rwanda","2024-04-22",0,0,0,0,0,0,0,0
"Rwanda","2024-04-23",0,0,0,0,0,0,0,0
"Rwanda","2024-04-24",0,0,0,0,0,0,0,0
"Rwanda","2024-04-25",0,0,0,0,0,0,0,0
"Rwanda","2024-04-26",0,0,0,0,0,0,0,0
"Rwanda","2024-04-27",0,0,0,0,0,0,0,0
"Rwanda","2024-04-28",0,0,0,0,0,0,0,0
"Rwanda","2024-04-29",0,0,0,0,0,0,0,0
"Rwanda","2024-04-30",0,0,0,0,0,0,0,0
"Rwanda","2024-05-01",0,0,0,0,0,0,0,0
"Rwanda","2024-05-02",0,0,0,0,0,0,0,0
"Rwanda","2024-05-03",0,0,0,0,0,0,0,0
"Rwanda","2024-05-04",0,0,0,0,0,0,0,0
"Rwanda","2024-05-05",0,0,0,0,0,0,0,0
"Rwanda","2024-05-06",0,0,0,0,0,0,0,0
"Rwanda","2024-05-07",0,0,0,0,0,0,0,0
"Rwanda","2024-05-08",0,0,0,0,0,0,0,0
"Rwanda","2024-05-09",0,0,0,0,0,0,0,0
"Rwanda","2024-05-10",0,0,0,0,0,0,0,0
"Rwanda","2024-05-11",0,0,0,0,0,0,0,0
"Rwanda","2024-05-12",0,0,0,0,0,0,0,0
"Rwanda","2024-05-13",0,0,0,0,0,0,0,0
"Rwanda","2024-05-14",0,0,0,0,0,0,0,0
"Rwanda","2024-05-15",0,0,0,0,0,0,0,0
"Rwanda","2024-05-16",0,0,0,0,0,0,0,0
"Rwanda","2024-05-17",0,0,0,0,0,0,0,0
"Rwanda","2024-05-18",0,0,0,0,0,0,0,0
"Rwanda","2024-05-19",0,0,0,0,0,0,0,0
"Rwanda","2024-05-20",0,0,0,0,0,0,0,0
"Rwanda","2024-05-21",0,0,0,0,0,0,0,0
"Rwanda","2024-05-22",0,0,0,0,0,0,0,0
"Rwanda","2024-05-23",0,0,0,0,0,0,0,0
"Rwanda","2024-05-24",0,0,0,0,0,0,0,0
"Rwanda","2024-05-25",0,0,0,0,0,0,0,0
"Rwanda","2024-05-26",0,0,0,0,0,0,0,0
"Rwanda","2024-05-27",0,0,0,0,0,0,0,0
"Rwanda","2024-05-28",0,0,0,0,0,0,0,0
"Rwanda","2024-05-29",0,0,0,0,0,0,0,0
"Rwanda","2024-05-30",0,0,0,0,0,0,0,0
"Rwanda","2024-05-31",0,0,0,0,0,0,0,0
"Rwanda","2024-06-01",0,0,0,0,0,0,0,0
"Rwanda","2024-06-02",0,0,0,0,0,0,0,0
"Rwanda","2024-06-03",0,0,0,0,0,0,0,0
"Rwanda","2024-06-04",0,0,0,0,0,0,0,0
"Rwanda","2024-06-05",0,0,0,0,0,0,0,0
"Rwanda","2024-06-06",0,0,0,0,0,0,0,0
"Rwanda","2024-06-07",0,0,0,0,0,0,0,0
"Rwanda","2024-06-08",0,0,0,0,0,0,0,0
"Rwanda","2024-06-09",0,0,0,0,0,0,0,0
"Rwanda","2024-06-10",0,0,0,0,0,0,0,0
"Rwanda","2024-06-11",0,0,0,0,0,0,0,0
"Rwanda","2024-06-12",0,0,0,0,0,0,0,0
"Rwanda","2024-06-13",0,0,0,0,0,0,0,0
"Rwanda","2024-06-14",0,0,0,0,0,0,0,0
"Rwanda","2024-06-15",0,0,0,0,0,0,0,0
"Rwanda","2024-06-16",0,0,0,0,0,0,0,0
"Rwanda","2024-06-17",0,0,0,0,0,0,0,0
"Rwanda","2024-06-18",0,0,0,0,0,0,0,0
"Rwanda","2024-06-19",0,0,0,0,0,0,0,0
"Rwanda","2024-06-20",0,0,0,0,0,0,0,0
"Rwanda","2024-06-21",0,0,0,0,0,0,0,0
"Rwanda","2024-06-22",0,0,0,0,0,0,0,0
"Rwanda","2024-06-23",0,0,0,0,0,0,0,0
"Rwanda","2024-06-24",0,0,0,0,0,0,0,0
"Rwanda","2024-06-25",0,0,0,0,0,0,0,0
"Rwanda","2024-06-26",0,0,0,0,0,0,0,0
"Rwanda","2024-06-27",0,0,0,0,0,0,0,0
"Rwanda","2024-06-28",0,0,0,0,0,0,0,0
"Rwanda","2024-06-29",0,0,0,0,0,0,0,0
"Rwanda","2024-06-30",0,0,0,0,0,0,0,0
"Rwanda","2024-07-01",0,0,0,0,0,0,0,0
"Rwanda","2024-07-02",0,0,0,0,0,0,0,0
"Rwanda","2024-07-03",0,0,0,0,0,0,0,0
"Rwanda","2024-07-04",0,0,0,0,0,0,0,0
"Rwanda","2024-07-05",0,0,0,0,0,0,0,0
"Rwanda","2024-07-06",0,0,0,0,0,0,0,0
"Rwanda","2024-07-07",0,0,0,0,0,0,0,0
"Rwanda","2024-07-08",0,0,0,0,0,0,0,0
"Rwanda","2024-07-09",0,0,0,0,0,0,0,0
"Rwanda","2024-07-10",0,0,0,0,0,0,0,0
"Rwanda","2024-07-11",0,0,0,0,0,0,0,0
"Rwanda","2024-07-12",0,0,0,0,0,0,0,0
"Rwanda","2024-07-13",0,0,0,0,0,0,0,0
"Rwanda","2024-07-14",8,0,0,8,0,0,8,8
"Rwanda","2024-07-15",0,0,0,8,0,0,1,9
"Rwanda","2024-07-16",0,0,0,8,0,0,1,10
"Rwanda","2024-07-17",0,0,0,8,0,0,1,11
"Rwanda","2024-07-18",0,0,0,8,0,0,1,12
"Rwanda","2024-07-19",0,0,0,8,0,0,1,13
"Rwanda","2024-07-20",0,0,0,8,0,0,1,14
"Rwanda","2024-07-21",0,0,0,8,0,0,2,16
"Rwanda","2024-07-22",0,0,0,8,0,0,1,17
"Rwanda","2024-07-23",0,0,0,8,0,0,1,18
"Rwanda","2024-07-24",0,0,0,8,0,0,1,19
"Rwanda","2024-07-25",0,0,0,8,0,0,1,20
"Rwanda","2024-07-26",0,0,0,8,0,0,1,21
"Rwanda","2024-07-27",0,0,0,8,0,0,1,22
"Rwanda","2024-07-28",15,4,4,23,4,4,1,23
"Rwanda","2024-07-29",0,0,4,23,0,4,30,53
"Rwanda","2024-07-30",0,0,4,23,0,4,29,82
"Rwanda","2024-07-31",0,0,4,23,0,4,30,112
"Rwanda","2024-08-01",0,0,4,23,0,4,30,142
"Rwanda","2024-08-02",0,0,4,23,0,4,30,172
"Rwanda","2024-08-03",0,0,4,23,0,4,29,201
"Rwanda","2024-08-04",208,0,4,231,0,4,30,231
"Rwanda","2024-08-05",0,0,4,231,0,4,24,255
"Rwanda","2024-08-06",0,0,4,231,0,4,25,280
"Rwanda","2024-08-07",0,0,4,231,0,4,24,304
"Rwanda","2024-08-08",0,0,4,231,0,4,24,328
"Rwanda","2024-08-09",0,0,4,231,0,4,24,352
"Rwanda","2024-08-10",0,0,4,231,1,5,25,377
"Rwanda","2024-08-11",170,0,4,401,0,5,24,401
"Rwanda","2024-08-12",0,0,4,401,0,5,20,421
"Rwanda","2024-08-13",0,0,4,401,0,5,19,440
"Rwanda","2024-08-14",0,0,4,401,0,5,20,460
"Rwanda","2024-08-15",0,0,4,401,0,5,20,480
"Rwanda","2024-08-16",0,0,4,401,0,5,20,500
"Rwanda","2024-08-17",0,0,4,401,0,5,19,519
"Rwanda","2024-08-18",138,0,4,539,0,5,20,539
"Rwanda","2024-08-19",0,0,4,539,0,5,30,569
"Rwanda","2024-08-20",0,0,4,539,0,5,30,599
"Rwanda","2024-08-21",0,0,4,539,0,5,30,629
"Rwanda","2024-08-22",0,0,4,539,0,5,29,658
"Rwanda","2024-08-23",0,0,4,539,0,5,30,688
"Rwanda","2024-08-24",0,0,4,539,0,5,30,718
"Rwanda","2024-08-25",209,0,4,748,0,5,30,748
"Rwanda","2024-08-26",0,0,4,748,0,5,53,801
"Rwanda","2024-08-27",0,0,4,748,0,5,52,853
"Rwanda","2024-08-28",0,0,4,748,0,5,53,906
"Rwanda","2024-08-29",0,0,4,748,0,5,52,958
"Rwanda","2024-08-30",0,0,4,748,0,5,53,1011
"Rwanda","2024-08-31",0,0,4,748,0,5,52,1063
"Rwanda","2024-09-01",368,0,4,1116,0,5,53,1116
"Rwanda","2024-09-02",0,0,4,1116,0,5,38,1154
"Rwanda","2024-09-03",0,0,4,1116,1,6,37,1191
"Rwanda","2024-09-04",0,0,4,1116,0,6,38,1229
"Rwanda","2024-09-05",0,0,4,1116,0,6,37,1266
"Rwanda","2024-09-06",0,0,4,1116,0,6,38,1304
"Rwanda","2024-09-07",0,0,4,1116,0,6,37,1341
"Rwanda","2024-09-08",263,0,4,1379,0,6,38,1379
"Rwanda","2024-09-09",0,0,4,1379,0,6,51,1430
"Rwanda","2024-09-10",0,0,4,1379,0,6,52,1482
"Rwanda","2024-09-11",0,0,4,1379,0,6,51,1533
"Rwanda","2024-09-12",0,0,4,1379,0,6,52,1585
"Rwanda","2024-09-13",0,0,4,1379,0,6,51,1636
"Rwanda","2024-09-14",0,0,4,1379,0,6,52,1688
"Rwanda","2024-09-15",360,2,6,1739,0,6,51,1739
"Rwanda","2024-09-16",0,0,6,1739,0,6,72,1811
"Rwanda","2024-09-17",0,0,6,1739,0,6,73,1884
"Rwanda","2024-09-18",0,0,6,1739,1,7,72,1956
"Rwanda","2024-09-19",0,0,6,1739,0,7,72,2028
"Rwanda","2024-09-20",0,0,6,1739,0,7,72,2100
"Rwanda","2024-09-21",0,0,6,1739,0,7,73,2173
"Rwanda","2024-09-22",506,0,6,2245,0,7,72,2245
"Rwanda","2024-09-23",0,0,6,2245,1,8,78,2323
"Rwanda","2024-09-24",0,0,6,2245,0,8,77,2400
"Rwanda","2024-09-25",0,0,6,2245,0,8,78,2478
"Rwanda","2024-09-26",0,0,6,2245,0,8,78,2556
"Rwanda","2024-09-27",0,0,6,2245,0,8,78,2634
"Rwanda","2024-09-28",0,0,6,2245,0,8,77,2711
"Rwanda","2024-09-29",544,0,6,2789,1,9,78,2789
"Rwanda","2024-09-30",0,0,6,2789,0,9,1,2790
"Rwanda","2024-10-01",0,0,6,2789,0,9,2,2792
"Rwanda","2024-10-02",0,0,6,2789,0,9,1,2793
"Rwanda","2024-10-03",0,0,6,2789,0,9,1,2794
"Rwanda","2024-10-04",0,0,6,2789,1,10,1,2795
"Rwanda","2024-10-05",0,0,6,2789,0,10,2,2797
"Rwanda","2024-10-06",9,4,10,2798,0,10,1,2798
"Rwanda","2024-10-07",0,0,10,2798,1,11,76,2874
"Rwanda","2024-10-08",0,0,10,2798,0,11,76,2950
"Rwanda","2024-10-09",0,0,10,2798,1,12,76,3026
"Rwanda","2024-10-10",0,0,10,2798,0,12,75,3101
"Rwanda","2024-10-11",0,0,10,2798,1,13,76,3177
"Rwanda","2024-10-12",0,0,10,2798,0,13,76,3253
"Rwanda","2024-10-13",531,4,14,3329,1,14,76,3329
"Rwanda","2024-10-14",0,0,14,3329,1,15,25,3354
"Rwanda","2024-10-15",0,0,14,3329,1,16,26,3380
"Rwanda","2024-10-16",0,0,14,3329,1,17,25,3405
"Rwanda","2024-10-17",0,0,14,3329,2,19,26,3431
"Rwanda","2024-10-18",0,0,14,3329,1,20,25,3456
"Rwanda","2024-10-19",0,0,14,3329,1,21,26,3482
"Rwanda","2024-10-20",178,8,22,3507,1,22,25,3507
"Rwanda","2024-10-21",0,0,22,3507,1,23,27,3534
"Rwanda","2024-10-22",0,0,22,3507,0,23,27,3561
"Rwanda","2024-10-23",0,0,22,3507,1,24,27,3588
"Rwanda","2024-10-24",0,0,22,3507,0,24,28,3616
"Rwanda","2024-10-25",0,0,22,3507,1,25,27,3643
"Rwanda","2024-10-26",0,0,22,3507,0,25,27,3670
"Rwanda","2024-10-27",190,4,26,3697,1,26,27,3697
"Rwanda","2024-10-28",0,0,26,3697,1,27,33,3730
"Rwanda","2024-10-29",0,0,26,3697,1,28,32,3762
"Rwanda","2024-10-30",0,0,26,3697,0,28,33,3795
"Rwanda","2024-10-31",0,0,26,3697,1,29,32,3827
"Rwanda","2024-11-01",0,0,26,3697,1,30,33,3860
"Rwanda","2024-11-02",0,0,26,3697,1,31,32,3892
"Rwanda","2024-11-03",228,0,26,3925,1,32,33,3925
"Rwanda","2024-11-04",0,0,26,3925,0,32,22,3947
"Rwanda","2024-11-05",0,0,26,3925,1,33,22,3969
"Rwanda","2024-11-06",0,0,26,3925,1,34,22,3991
"Rwanda","2024-11-07",0,0,26,3925,1,35,21,4012
"Rwanda","2024-11-08",0,0,26,3925,0,35,22,4034
"Rwanda","2024-11-09",0,0,26,3925,1,36,22,4056
"Rwanda","2024-11-10",153,11,37,4078,1,37,22,4078
"Rwanda","2024-11-11",0,0,37,4078,1,38,0,4078
"Rwanda","2024-11-12",0,0,37,4078,1,39,0,4078
"Rwanda","2024-11-13",0,0,37,4078,1,40,0,4078
"Rwanda","2024-11-14",0,0,37,4078,1,41,0,4078
"Rwanda","2024-11-15",0,0,37,4078,1,42,0,4078
"Rwanda","2024-11-16",0,0,37,4078,1,43,0,4078
"Rwanda","2024-11-17",0,0,37,4078,2,45,0,4078
"Rwanda","2024-11-18",0,0,37,4078,1,46,0,4078
"Rwanda","2024-11-19",0,0,37,4078,1,47,0,4078
"Rwanda","2024-11-20",0,0,37,4078,1,48,0,4078
"Rwanda","2024-11-21",0,0,37,4078,1,49,0,4078
"Rwanda","2024-11-22",0,0,37,4078,1,50,0,4078
"Rwanda","2024-11-23",0,0,37,4078,1,51,0,4078
"Rwanda","2024-11-24",0,15,52,4078,1,52,0,4078
"Rwanda","2024-11-25",0,0,52,4078,1,53,0,4078
"Rwanda","2024-11-26",0,0,52,4078,1,54,0,4078
"Rwanda","2024-11-27",0,0,52,4078,2,56,0,4078
"Rwanda","2024-11-28",0,0,52,4078,1,57,0,4078
"Rwanda","2024-11-29",0,0,52,4078,1,58,0,4078
"Rwanda","2024-11-30",0,7,59,4078,1,59,0,4078
"Rwanda","2024-12-01",0,0,59,4078,1,60,0,4078
"Rwanda","2024-12-02",0,0,59,4078,1,61,0,4078
"Rwanda","2024-12-03",0,0,59,4078,0,61,0,4078
"Rwanda","2024-12-04",0,0,59,4078,1,62,0,4078
"Rwanda","2024-12-05",0,0,59,4078,1,63,0,4078
"Rwanda","2024-12-06",0,0,59,4078,0,63,0,4078
"Rwanda","2024-12-07",0,0,59,4078,1,64,0,4078
"Rwanda","2024-12-08",0,6,65,4078,1,65,0,4078
"Rwanda","2024-12-09",0,0,65,4078,2,67,0,4078
"Rwanda","2024-12-10",0,0,65,4078,2,69,0,4078
"Rwanda","2024-12-11",0,0,65,4078,2,71,0,4078
"Rwanda","2024-12-12",0,0,65,4078,1,72,0,4078
"Rwanda","2024-12-13",0,0,65,4078,2,74,0,4078
"Rwanda","2024-12-14",0,0,65,4078,2,76,0,4078
"Rwanda","2024-12-15",0,13,78,4078,2,78,0,4078
"Rwanda","2024-12-16",0,0,78,4078,0,78,0,4078
"Rwanda","2024-12-17",0,0,78,4078,1,79,0,4078
"Rwanda","2024-12-18",0,0,78,4078,0,79,0,4078
"Rwanda","2024-12-19",0,0,78,4078,0,79,0,4078
"Rwanda","2024-12-20",0,0,78,4078,0,79,0,4078
"Rwanda","2024-12-21",0,0,78,4078,1,80,0,4078
"Rwanda","2024-12-22",0,0,78,4078,0,80,0,4078
"Rwanda","2024-12-23",0,0,78,4078,0,80,0,4078
"Rwanda","2024-12-24",0,0,78,4078,1,81,0,4078
"Rwanda","2024-12-25",0,0,78,4078,0,81,0,4078
"Rwanda","2024-12-26",0,0,78,4078,0,81,0,4078
"Rwanda","2024-12-27",0,0,78,4078,0,81,0,4078
"Rwanda","2024-12-28",0,0,78,4078,1,82,0,4078
"Rwanda","2024-12-29",0,4,82,4078,0,82,0,4078
"Rwanda","2024-12-30",0,0,82,4078,0,82,0,4078
"Rwanda","2024-12-31",0,0,82,4078,0,82,0,4078
"Rwanda","2025-01-01",0,0,82,4078,0,82,0,4078
"Rwanda","2025-01-02",0,0,82,4078,0,82,0,4078
"Rwanda","2025-01-03",0,0,82,4078,0,82,0,4078
"Rwanda","2025-01-04",0,0,82,4078,0,82,0,4078
"Rwanda","2025-01-05",0,0,82,4078,0,82,0,4078
"Rwanda","2025-01-06",0,0,82,4078,0,82,0,4078
"Rwanda","2025-01-07",0,0,82,4078,0,82,0,4078
"Rwanda","2025-01-08",0,0,82,4078,0,82,0,4078
"Rwanda","2025-01-09",0,0,82,4078,0,82,0,4078
"Rwanda","2025-01-10",0,0,82,4078,0,82,0,4078
"Rwanda","2025-01-11",0,0,82,4078,0,82,0,4078
"Rwanda","2025-01-12",0,0,82,4078,0,82,0,4078
"Rwanda","2025-01-13",0,0,82,4078,0,82,0,4078
"Rwanda","2025-01-14",0,0,82,4078,0,82,0,4078
"Rwanda","2025-01-15",0,0,82,4078,0,82,0,4078
"Rwanda","2025-01-16",0,0,82,4078,0,82,0,4078
"Rwanda","2025-01-17",0,0,82,4078,0,82,0,4078
"Rwanda","2025-01-18",0,0,82,4078,0,82,0,4078
"Rwanda","2025-01-19",0,0,82,4078,0,82,0,4078
"Rwanda","2025-01-20",0,0,82,4078,0,82,0,4078
"Rwanda","2025-01-21",0,0,82,4078,0,82,0,4078
"Rwanda","2025-01-22",0,0,82,4078,0,82,0,4078
"Rwanda","2025-01-23",0,0,82,4078,0,82,0,4078
"Rwanda","2025-01-24",0,0,82,4078,0,82,0,4078
"Rwanda","2025-01-25",0,0,82,4078,0,82,0,4078
"Rwanda","2025-01-26",0,0,82,4078,0,82,0,4078
"Rwanda","2025-01-27",0,0,82,4078,0,82,0,4078
"Rwanda","2025-01-28",0,0,82,4078,0,82,0,4078
"Rwanda","2025-01-29",0,0,82,4078,0,82,0,4078
"Rwanda","2025-01-30",0,0,82,4078,0,82,0,4078
"Rwanda","2025-01-31",0,0,82,4078,0,82,0,4078
"Rwanda","2025-02-01",0,0,82,4078,0,82,0,4078
"Rwanda","2025-02-02",0,0,82,4078,0,82,0,4078
"Rwanda","2025-02-03",0,0,82,4078,0,82,0,4078
"Saint Martin (French Part)","2024-01-01",0,0,0,0,0,0,0,0
"Saint Martin (French Part)","2024-01-02",0,0,0,0,0,0,0,0
"Saint Martin (French Part)","2024-01-03",0,0,0,0,0,0,0,0
"Saint Martin (French Part)","2024-01-04",0,0,0,0,0,0,0,0
"Saint Martin (French Part)","2024-01-05",0,0,0,0,0,0,0,0
"Saint Martin (French Part)","2024-01-06",0,0,0,0,0,0,0,0
"Saint Martin (French Part)","2024-01-07",0,0,0,0,0,0,0,0
"Saint Martin (French Part)","2024-01-08",0,0,0,0,0,0,0,0
"Saint Martin (French Part)","2024-01-09",0,0,0,0,0,0,0,0
"Saint Martin (French Part)","2024-01-10",0,0,0,0,0,0,0,0
"Saint Martin (French Part)","2024-01-11",0,0,0,0,0,0,0,0
"Saint Martin (French Part)","2024-01-12",0,0,0,0,0,0,0,0
"Saint Martin (French Part)","2024-01-13",0,0,0,0,0,0,0,0
"Saint Martin (French Part)","2024-01-14",0,0,0,0,0,0,0,0
"Saint Martin (French Part)","2024-01-15",0,0,0,0,0,0,0,0
"Saint Martin (French Part)","2024-01-16",0,0,0,0,0,0,0,0
"Saint Martin (French Part)","2024-01-17",0,0,0,0,0,0,0,0
"Saint Martin (French Part)","2024-01-18",0,0,0,0,0,0,0,0
"Saint Martin (French Part)","2024-01-19",0,0,0,0,0,0,0,0
"Saint Martin (French Part)","2024-01-20",0,0,0,0,0,0,0,0
"Saint Martin (French Part)","2024-01-21",0,0,0,0,0,0,0,0
"Saint Martin (French Part)","2024-01-22",0,0,0,0,0,0,0,0
"Saint Martin (French Part)","2024-01-23",0,0,0,0,0,0,0,0
"Saint Martin (French Part)","2024-01-24",0,0,0,0,0,0,0,0
"Saint Martin (French Part)","2024-01-25",0,0,0,0,0,0,0,0
"Saint Martin (French Part)","2024-01-26",0,0,0,0,0,0,0,0
"Saint Martin (French Part)","2024-01-27",0,0,0,0,0,0,0,0
"Saint Martin (French Part)","2024-01-28",0,0,0,0,0,0,0,0
"Saint Martin (French Part)","2024-01-29",0,0,0,0,0,0,0,0
"Saint Martin (French Part)","2024-01-30",0,0,0,0,0,0,0,0
"Saint Martin (French Part)","2024-01-31",0,0,0,0,0,0,0,0
"Saint Martin (French Part)","2024-02-01",0,0,0,0,0,0,0,0
"Saint Martin (French Part)","2024-02-02",0,0,0,0,0,0,0,0
"Saint Martin (French Part)","2024-02-03",0,0,0,0,0,0,0,0
"Saint Martin (French Part)","2024-02-04",0,0,0,0,0,0,0,0
"Saint Martin (French Part)","2024-02-05",0,0,0,0,0,0,0,0
"Saint Martin (French Part)","2024-02-06",0,0,0,0,0,0,0,0
"Saint Martin (French Part)","2024-02-07",0,0,0,0,0,0,0,0
"Saint Martin (French Part)","2024-02-08",0,0,0,0,0,0,0,0
"Saint Martin (French Part)","2024-02-09",0,0,0,0,0,0,0,0
"Saint Martin (French Part)","2024-02-10",0,0,0,0,0,0,0,0
"Saint Martin (French Part)","2024-02-11",0,0,0,0,0,0,0,0
"Saint Martin (French Part)","2024-02-12",0,0,0,0,0,0,0,0
"Saint Martin (French Part)","2024-02-13",0,0,0,0,0,0,0,0
"Saint Martin (French Part)","2024-02-14",0,0,0,0,0,0,0,0
"Saint Martin (French Part)","2024-02-15",0,0,0,0,0,0,0,0
"Saint Martin (French Part)","2024-02-16",0,0,0,0,0,0,0,0
"Saint Martin (French Part)","2024-02-17",0,0,0,0,0,0,0,0
"Saint Martin (French Part)","2024-02-18",0,0,0,0,0,0,0,0
"Saint Martin (French Part)","2024-02-19",0,0,0,0,0,0,0,0
"Saint Martin (French Part)","2024-02-20",0,0,0,0,0,0,0,0
"Saint Martin (French Part)","2024-02-21",0,0,0,0,0,0,0,0
"Saint Martin (French Part)","2024-02-22",0,0,0,0,0,0,0,0
"Saint Martin (French Part)","2024-02-23",0,0,0,0,0,0,0,0
"Saint Martin (French Part)","2024-02-24",0,0,0,0,0,0,0,0
"Saint Martin (French Part)","2024-02-25",0,0,0,0,0,0,0,0
"Saint Martin (French Part)","2024-02-26",0,0,0,0,0,0,0,0
"Saint Martin (French Part)","2024-02-27",0,0,0,0,0,0,0,0
"Saint Martin (French Part)","2024-02-28",0,0,0,0,0,0,0,0
"Saint Martin (French Part)","2024-02-29",0,0,0,0,0,0,0,0
"Saint Martin (French Part)","2024-03-01",0,0,0,0,0,0,0,0
"Saint Martin (French Part)","2024-03-02",0,0,0,0,0,0,0,0
"Saint Martin (French Part)","2024-03-03",0,0,0,0,0,0,0,0
"Saint Martin (French Part)","2024-03-04",0,0,0,0,0,0,0,0
"Saint Martin (French Part)","2024-03-05",0,0,0,0,0,0,0,0
"Saint Martin (French Part)","2024-03-06",0,0,0,0,0,0,0,0
"Saint Martin (French Part)","2024-03-07",0,0,0,0,0,0,0,0
"Saint Martin (French Part)","2024-03-08",0,0,0,0,0,0,0,0
"Saint Martin (French Part)","2024-03-09",0,0,0,0,0,0,0,0
"Saint Martin (French Part)","2024-03-10",0,0,0,0,0,0,0,0
"Saint Martin (French Part)","2024-03-11",0,0,0,0,0,0,0,0
"Saint Martin (French Part)","2024-03-12",0,0,0,0,0,0,0,0
"Saint Martin (French Part)","2024-03-13",0,0,0,0,0,0,0,0
"Saint Martin (French Part)","2024-03-14",0,0,0,0,0,0,0,0
"Saint Martin (French Part)","2024-03-15",0,0,0,0,0,0,0,0
"Saint Martin (French Part)","2024-03-16",0,0,0,0,0,0,0,0
"Saint Martin (French Part)","2024-03-17",0,0,0,0,0,0,0,0
"Saint Martin (French Part)","2024-03-18",0,0,0,0,0,0,0,0
"Saint Martin (French Part)","2024-03-19",0,0,0,0,0,0,0,0
"Saint Martin (French Part)","2024-03-20",0,0,0,0,0,0,0,0
"Saint Martin (French Part)","2024-03-21",0,0,0,0,0,0,0,0
"Saint Martin (French Part)","2024-03-22",0,0,0,0,0,0,0,0
"Saint Martin (French Part)","2024-03-23",0,0,0,0,0,0,0,0
"Saint Martin (French Part)","2024-03-24",0,0,0,0,0,0,0,0
"Saint Martin (French Part)","2024-03-25",0,0,0,0,0,0,0,0
"Saint Martin (French Part)","2024-03-26",0,0,0,0,0,0,0,0
"Saint Martin (French Part)","2024-03-27",0,0,0,0,0,0,0,0
"Saint Martin (French Part)","2024-03-28",0,0,0,0,0,0,0,0
"Saint Martin (French Part)","2024-03-29",0,0,0,0,0,0,0,0
"Saint Martin (French Part)","2024-03-30",0,0,0,0,0,0,0,0
"Saint Martin (French Part)","2024-03-31",0,0,0,0,0,0,0,0
"Saint Martin (French Part)","2024-04-01",0,0,0,0,0,0,0,0
"Saint Martin (French Part)","2024-04-02",0,0,0,0,0,0,0,0
"Saint Martin (French Part)","2024-04-03",0,0,0,0,0,0,0,0
"Saint Martin (French Part)","2024-04-04",0,0,0,0,0,0,0,0
"Saint Martin (French Part)","2024-04-05",0,0,0,0,0,0,0,0
"Saint Martin (French Part)","2024-04-06",0,0,0,0,0,0,0,0
"Saint Martin (French Part)","2024-04-07",0,0,0,0,0,0,0,0
"Saint Martin (French Part)","2024-04-08",0,0,0,0,0,0,0,0
"Saint Martin (French Part)","2024-04-09",0,0,0,0,0,0,0,0
"Saint Martin (French Part)","2024-04-10",0,0,0,0,0,0,0,0
"Saint Martin (French Part)","2024-04-11",0,0,0,0,0,0,0,0
"Saint Martin (French Part)","2024-04-12",0,0,0,0,0,0,0,0
"Saint Martin (French Part)","2024-04-13",0,0,0,0,0,0,0,0
"Saint Martin (French Part)","2024-04-14",0,0,0,0,0,0,0,0
"Saint Martin (French Part)","2024-04-15",0,0,0,0,0,0,0,0
"Saint Martin (French Part)","2024-04-16",0,0,0,0,0,0,0,0
"Saint Martin (French Part)","2024-04-17",0,0,0,0,0,0,0,0
"Saint Martin (French Part)","2024-04-18",0,0,0,0,0,0,0,0
"Saint Martin (French Part)","2024-04-19",0,0,0,0,0,0,0,0
"Saint Martin (French Part)","2024-04-20",0,0,0,0,0,0,0,0
"Saint Martin (French Part)","2024-04-21",0,0,0,0,0,0,0,0
"Saint Martin (French Part)","2024-04-22",0,0,0,0,0,0,0,0
"Saint Martin (French Part)","2024-04-23",0,0,0,0,0,0,0,0
"Saint Martin (French Part)","2024-04-24",0,0,0,0,0,0,0,0
"Saint Martin (French Part)","2024-04-25",0,0,0,0,0,0,0,0
"Saint Martin (French Part)","2024-04-26",0,0,0,0,0,0,0,0
"Saint Martin (French Part)","2024-04-27",0,0,0,0,0,0,0,0
"Saint Martin (French Part)","2024-04-28",0,0,0,0,0,0,0,0
"Saint Martin (French Part)","2024-04-29",0,0,0,0,0,0,0,0
"Saint Martin (French Part)","2024-04-30",0,0,0,0,0,0,0,0
"Saint Martin (French Part)","2024-05-01",0,0,0,0,0,0,0,0
"Saint Martin (French Part)","2024-05-02",0,0,0,0,0,0,0,0
"Saint Martin (French Part)","2024-05-03",0,0,0,0,0,0,0,0
"Saint Martin (French Part)","2024-05-04",0,0,0,0,0,0,0,0
"Saint Martin (French Part)","2024-05-05",0,0,0,0,0,0,0,0
"Saint Martin (French Part)","2024-05-06",0,0,0,0,0,0,0,0
"Saint Martin (French Part)","2024-05-07",0,0,0,0,0,0,0,0
"Saint Martin (French Part)","2024-05-08",0,0,0,0,0,0,0,0
"Saint Martin (French Part)","2024-05-09",0,0,0,0,0,0,0,0
"Saint Martin (French Part)","2024-05-10",0,0,0,0,0,0,0,0
"Saint Martin (French Part)","2024-05-11",0,0,0,0,0,0,0,0
"Saint Martin (French Part)","2024-05-12",0,0,0,0,0,0,0,0
"Saint Martin (French Part)","2024-05-13",0,0,0,0,0,0,0,0
"Saint Martin (French Part)","2024-05-14",0,0,0,0,0,0,0,0
"Saint Martin (French Part)","2024-05-15",0,0,0,0,0,0,0,0
"Saint Martin (French Part)","2024-05-16",0,0,0,0,0,0,0,0
"Saint Martin (French Part)","2024-05-17",0,0,0,0,0,0,0,0
"Saint Martin (French Part)","2024-05-18",0,0,0,0,0,0,0,0
"Saint Martin (French Part)","2024-05-19",0,0,0,0,0,0,0,0
"Saint Martin (French Part)","2024-05-20",0,0,0,0,0,0,0,0
"Saint Martin (French Part)","2024-05-21",0,0,0,0,0,0,0,0
"Saint Martin (French Part)","2024-05-22",0,0,0,0,0,0,0,0
"Saint Martin (French Part)","2024-05-23",0,0,0,0,0,0,0,0
"Saint Martin (French Part)","2024-05-24",0,0,0,0,0,0,0,0
"Saint Martin (French Part)","2024-05-25",0,0,0,0,0,0,0,0
"Saint Martin (French Part)","2024-05-26",0,0,0,0,0,0,0,0
"Saint Martin (French Part)","2024-05-27",0,0,0,0,0,0,0,0
"Saint Martin (French Part)","2024-05-28",0,0,0,0,0,0,0,0
"Saint Martin (French Part)","2024-05-29",0,0,0,0,0,0,0,0
"Saint Martin (French Part)","2024-05-30",0,0,0,0,0,0,0,0
"Saint Martin (French Part)","2024-05-31",0,0,0,0,0,0,0,0
"Saint Martin (French Part)","2024-06-01",0,0,0,0,0,0,0,0
"Saint Martin (French Part)","2024-06-02",0,0,0,0,0,0,0,0
"Saint Martin (French Part)","2024-06-03",0,0,0,0,0,0,0,0
"Saint Martin (French Part)","2024-06-04",0,0,0,0,0,0,0,0
"Saint Martin (French Part)","2024-06-05",0,0,0,0,0,0,0,0
"Saint Martin (French Part)","2024-06-06",0,0,0,0,0,0,0,0
"Saint Martin (French Part)","2024-06-07",0,0,0,0,0,0,0,0
"Saint Martin (French Part)","2024-06-08",0,0,0,0,0,0,0,0
"Saint Martin (French Part)","2024-06-09",0,0,0,0,0,0,0,0
"Saint Martin (French Part)","2024-06-10",0,0,0,0,0,0,0,0
"Saint Martin (French Part)","2024-06-11",0,0,0,0,0,0,0,0
"Saint Martin (French Part)","2024-06-12",0,0,0,0,0,0,0,0
"Saint Martin (French Part)","2024-06-13",0,0,0,0,0,0,0,0
"Saint Martin (French Part)","2024-06-14",0,0,0,0,0,0,0,0
"Saint Martin (French Part)","2024-06-15",0,0,0,0,0,0,0,0
"Saint Martin (French Part)","2024-06-16",0,0,0,0,0,0,0,0
"Saint Martin (French Part)","2024-06-17",0,0,0,0,0,0,0,0
"Saint Martin (French Part)","2024-06-18",0,0,0,0,0,0,0,0
"Saint Martin (French Part)","2024-06-19",0,0,0,0,0,0,0,0
"Saint Martin (French Part)","2024-06-20",0,0,0,0,0,0,0,0
"Saint Martin (French Part)","2024-06-21",0,0,0,0,0,0,0,0
"Saint Martin (French Part)","2024-06-22",0,0,0,0,0,0,0,0
"Saint Martin (French Part)","2024-06-23",0,0,0,0,0,0,0,0
"Saint Martin (French Part)","2024-06-24",0,0,0,0,0,0,0,0
"Saint Martin (French Part)","2024-06-25",0,0,0,0,0,0,0,0
"Saint Martin (French Part)","2024-06-26",0,0,0,0,0,0,0,0
"Saint Martin (French Part)","2024-06-27",0,0,0,0,0,0,0,0
"Saint Martin (French Part)","2024-06-28",0,0,0,0,0,0,0,0
"Saint Martin (French Part)","2024-06-29",0,0,0,0,0,0,0,0
"Saint Martin (French Part)","2024-06-30",0,0,0,0,0,0,0,0
"Saint Martin (French Part)","2024-07-01",0,0,0,0,0,0,0,0
"Saint Martin (French Part)","2024-07-02",0,0,0,0,0,0,0,0
"Saint Martin (French Part)","2024-07-03",0,0,0,0,0,0,0,0
"Saint Martin (French Part)","2024-07-04",0,0,0,0,0,0,0,0
"Saint Martin (French Part)","2024-07-05",0,0,0,0,0,0,0,0
"Saint Martin (French Part)","2024-07-06",0,0,0,0,0,0,0,0
"Saint Martin (French Part)","2024-07-07",0,0,0,0,0,0,0,0
"Saint Martin (French Part)","2024-07-08",0,0,0,0,0,0,0,0
"Saint Martin (French Part)","2024-07-09",0,0,0,0,0,0,0,0
"Saint Martin (French Part)","2024-07-10",0,0,0,0,0,0,0,0
"Saint Martin (French Part)","2024-07-11",0,0,0,0,0,0,0,0
"Saint Martin (French Part)","2024-07-12",0,0,0,0,0,0,0,0
"Saint Martin (French Part)","2024-07-13",0,0,0,0,0,0,0,0
"Saint Martin (French Part)","2024-07-14",0,0,0,0,0,0,0,0
"Saint Martin (French Part)","2024-07-15",0,0,0,0,0,0,0,0
"Saint Martin (French Part)","2024-07-16",0,0,0,0,0,0,0,0
"Saint Martin (French Part)","2024-07-17",0,0,0,0,0,0,0,0
"Saint Martin (French Part)","2024-07-18",0,0,0,0,0,0,0,0
"Saint Martin (French Part)","2024-07-19",0,0,0,0,0,0,0,0
"Saint Martin (French Part)","2024-07-20",0,0,0,0,0,0,0,0
"Saint Martin (French Part)","2024-07-21",0,0,0,0,0,0,0,0
"Saint Martin (French Part)","2024-07-22",0,0,0,0,0,0,0,0
"Saint Martin (French Part)","2024-07-23",0,0,0,0,0,0,0,0
"Saint Martin (French Part)","2024-07-24",0,0,0,0,0,0,0,0
"Saint Martin (French Part)","2024-07-25",0,0,0,0,0,0,0,0
"Saint Martin (French Part)","2024-07-26",0,0,0,0,0,0,0,0
"Saint Martin (French Part)","2024-07-27",0,0,0,0,0,0,0,0
"Saint Martin (French Part)","2024-07-28",0,0,0,0,0,0,0,0
"Saint Martin (French Part)","2024-07-29",0,0,0,0,0,0,0,0
"Saint Martin (French Part)","2024-07-30",0,0,0,0,0,0,0,0
"Saint Martin (French Part)","2024-07-31",0,0,0,0,0,0,0,0
"Saint Martin (French Part)","2024-08-01",0,0,0,0,0,0,0,0
"Saint Martin (French Part)","2024-08-02",0,0,0,0,0,0,0,0
"Saint Martin (French Part)","2024-08-03",0,0,0,0,0,0,0,0
"Saint Martin (French Part)","2024-08-04",0,0,0,0,0,0,0,0
"Saint Martin (French Part)","2024-08-05",0,0,0,0,0,0,0,0
"Saint Martin (French Part)","2024-08-06",0,0,0,0,0,0,0,0
"Saint Martin (French Part)","2024-08-07",0,0,0,0,0,0,0,0
"Saint Martin (French Part)","2024-08-08",0,0,0,0,0,0,0,0
"Saint Martin (French Part)","2024-08-09",0,0,0,0,0,0,0,0
"Saint Martin (French Part)","2024-08-10",0,0,0,0,0,0,0,0
"Saint Martin (French Part)","2024-08-11",0,0,0,0,0,0,0,0
"Saint Martin (French Part)","2024-08-12",0,0,0,0,0,0,0,0
"Saint Martin (French Part)","2024-08-13",0,0,0,0,0,0,0,0
"Saint Martin (French Part)","2024-08-14",0,0,0,0,0,0,0,0
"Saint Martin (French Part)","2024-08-15",0,0,0,0,0,0,0,0
"Saint Martin (French Part)","2024-08-16",0,0,0,0,0,0,0,0
"Saint Martin (French Part)","2024-08-17",0,0,0,0,0,0,0,0
"Saint Martin (French Part)","2024-08-18",0,0,0,0,0,0,0,0
"Saint Martin (French Part)","2024-08-19",0,0,0,0,0,0,0,0
"Saint Martin (French Part)","2024-08-20",0,0,0,0,0,0,0,0
"Saint Martin (French Part)","2024-08-21",0,0,0,0,0,0,0,0
"Saint Martin (French Part)","2024-08-22",0,0,0,0,0,0,0,0
"Saint Martin (French Part)","2024-08-23",0,0,0,0,0,0,0,0
"Saint Martin (French Part)","2024-08-24",0,0,0,0,0,0,0,0
"Saint Martin (French Part)","2024-08-25",0,0,0,0,0,0,0,0
"Saint Martin (French Part)","2024-08-26",0,0,0,0,0,0,0,0
"Saint Martin (French Part)","2024-08-27",0,0,0,0,0,0,0,0
"Saint Martin (French Part)","2024-08-28",0,0,0,0,0,0,0,0
"Saint Martin (French Part)","2024-08-29",0,0,0,0,0,0,0,0
"Saint Martin (French Part)","2024-08-30",0,0,0,0,0,0,0,0
"Saint Martin (French Part)","2024-08-31",0,0,0,0,0,0,0,0
"Saint Martin (French Part)","2024-09-01",0,0,0,0,0,0,0,0
"Saint Martin (French Part)","2024-09-02",0,0,0,0,0,0,0,0
"Saint Martin (French Part)","2024-09-03",0,0,0,0,0,0,0,0
"Saint Martin (French Part)","2024-09-04",0,0,0,0,0,0,0,0
"Saint Martin (French Part)","2024-09-05",0,0,0,0,0,0,0,0
"Saint Martin (French Part)","2024-09-06",0,0,0,0,0,0,0,0
"Saint Martin (French Part)","2024-09-07",0,0,0,0,0,0,0,0
"Saint Martin (French Part)","2024-09-08",0,0,0,0,0,0,0,0
"Saint Martin (French Part)","2024-09-09",0,0,0,0,0,0,0,0
"Saint Martin (French Part)","2024-09-10",0,0,0,0,0,0,0,0
"Saint Martin (French Part)","2024-09-11",0,0,0,0,0,0,0,0
"Saint Martin (French Part)","2024-09-12",0,0,0,0,0,0,0,0
"Saint Martin (French Part)","2024-09-13",0,0,0,0,0,0,0,0
"Saint Martin (French Part)","2024-09-14",0,0,0,0,0,0,0,0
"Saint Martin (French Part)","2024-09-15",0,0,0,0,0,0,0,0
"Saint Martin (French Part)","2024-09-16",0,0,0,0,0,0,0,0
"Saint Martin (French Part)","2024-09-17",0,0,0,0,0,0,0,0
"Saint Martin (French Part)","2024-09-18",0,0,0,0,0,0,0,0
"Saint Martin (French Part)","2024-09-19",0,0,0,0,0,0,0,0
"Saint Martin (French Part)","2024-09-20",0,0,0,0,0,0,0,0
"Saint Martin (French Part)","2024-09-21",0,0,0,0,0,0,0,0
"Saint Martin (French Part)","2024-09-22",0,0,0,0,0,0,0,0
"Saint Martin (French Part)","2024-09-23",0,0,0,0,0,0,0,0
"Saint Martin (French Part)","2024-09-24",0,0,0,0,0,0,0,0
"Saint Martin (French Part)","2024-09-25",0,0,0,0,0,0,0,0
"Saint Martin (French Part)","2024-09-26",0,0,0,0,0,0,0,0
"Saint Martin (French Part)","2024-09-27",0,0,0,0,0,0,0,0
"Saint Martin (French Part)","2024-09-28",0,0,0,0,0,0,0,0
"Saint Martin (French Part)","2024-09-29",0,0,0,0,0,0,0,0
"Saint Martin (French Part)","2024-09-30",0,0,0,0,0,0,0,0
"Saint Martin (French Part)","2024-10-01",0,0,0,0,0,0,0,0
"Saint Martin (French Part)","2024-10-02",0,0,0,0,0,0,0,0
"Saint Martin (French Part)","2024-10-03",0,0,0,0,0,0,0,0
"Saint Martin (French Part)","2024-10-04",0,0,0,0,0,0,0,0
"Saint Martin (French Part)","2024-10-05",0,0,0,0,0,0,0,0
"Saint Martin (French Part)","2024-10-06",0,0,0,0,0,0,0,0
"Saint Martin (French Part)","2024-10-07",0,0,0,0,0,0,0,0
"Saint Martin (French Part)","2024-10-08",0,0,0,0,0,0,0,0
"Saint Martin (French Part)","2024-10-09",0,0,0,0,0,0,0,0
"Saint Martin (French Part)","2024-10-10",0,0,0,0,0,0,0,0
"Saint Martin (French Part)","2024-10-11",0,0,0,0,0,0,0,0
"Saint Martin (French Part)","2024-10-12",0,0,0,0,0,0,0,0
"Saint Martin (French Part)","2024-10-13",0,0,0,0,0,0,0,0
"Saint Martin (French Part)","2024-10-14",0,0,0,0,0,0,0,0
"Saint Martin (French Part)","2024-10-15",0,0,0,0,0,0,0,0
"Saint Martin (French Part)","2024-10-16",0,0,0,0,0,0,0,0
"Saint Martin (French Part)","2024-10-17",0,0,0,0,0,0,0,0
"Saint Martin (French Part)","2024-10-18",0,0,0,0,0,0,0,0
"Saint Martin (French Part)","2024-10-19",0,0,0,0,0,0,0,0
"Saint Martin (French Part)","2024-10-20",0,0,0,0,0,0,0,0
"Saint Martin (French Part)","2024-10-21",0,0,0,0,0,0,0,0
"Saint Martin (French Part)","2024-10-22",0,0,0,0,0,0,0,0
"Saint Martin (French Part)","2024-10-23",0,0,0,0,0,0,0,0
"Saint Martin (French Part)","2024-10-24",0,0,0,0,0,0,0,0
"Saint Martin (French Part)","2024-10-25",0,0,0,0,0,0,0,0
"Saint Martin (French Part)","2024-10-26",0,0,0,0,0,0,0,0
"Saint Martin (French Part)","2024-10-27",0,0,0,0,0,0,0,0
"Saint Martin (French Part)","2024-10-28",0,0,0,0,0,0,0,0
"Saint Martin (French Part)","2024-10-29",0,0,0,0,0,0,0,0
"Saint Martin (French Part)","2024-10-30",0,0,0,0,0,0,0,0
"Saint Martin (French Part)","2024-10-31",0,0,0,0,0,0,0,0
"Saint Martin (French Part)","2024-11-01",0,0,0,0,0,0,0,0
"Saint Martin (French Part)","2024-11-02",0,0,0,0,0,0,0,0
"Saint Martin (French Part)","2024-11-03",0,0,0,0,0,0,0,0
"Saint Martin (French Part)","2024-11-04",0,0,0,0,0,0,0,0
"Saint Martin (French Part)","2024-11-05",0,0,0,0,0,0,0,0
"Saint Martin (French Part)","2024-11-06",0,0,0,0,0,0,0,0
"Saint Martin (French Part)","2024-11-07",0,0,0,0,0,0,0,0
"Saint Martin (French Part)","2024-11-08",0,0,0,0,0,0,0,0
"Saint Martin (French Part)","2024-11-09",0,0,0,0,0,0,0,0
"Saint Martin (French Part)","2024-11-10",0,0,0,0,0,0,0,0
"Saint Martin (French Part)","2024-11-11",0,0,0,0,0,0,0,0
"Saint Martin (French Part)","2024-11-12",0,0,0,0,0,0,0,0
"Saint Martin (French Part)","2024-11-13",0,0,0,0,0,0,0,0
"Saint Martin (French Part)","2024-11-14",0,0,0,0,0,0,0,0
"Saint Martin (French Part)","2024-11-15",0,0,0,0,0,0,0,0
"Saint Martin (French Part)","2024-11-16",0,0,0,0,0,0,0,0
"Saint Martin (French Part)","2024-11-17",0,0,0,0,0,0,0,0
"Saint Martin (French Part)","2024-11-18",0,0,0,0,0,0,0,0
"Saint Martin (French Part)","2024-11-19",0,0,0,0,0,0,0,0
"Saint Martin (French Part)","2024-11-20",0,0,0,0,0,0,0,0
"Saint Martin (French Part)","2024-11-21",0,0,0,0,0,0,0,0
"Saint Martin (French Part)","2024-11-22",0,0,0,0,0,0,0,0
"Saint Martin (French Part)","2024-11-23",0,0,0,0,0,0,0,0
"Saint Martin (French Part)","2024-11-24",0,0,0,0,0,0,0,0
"Saint Martin (French Part)","2024-11-25",0,0,0,0,0,0,0,0
"Saint Martin (French Part)","2024-11-26",0,0,0,0,0,0,0,0
"Saint Martin (French Part)","2024-11-27",0,0,0,0,0,0,0,0
"Saint Martin (French Part)","2024-11-28",0,0,0,0,0,0,0,0
"Saint Martin (French Part)","2024-11-29",0,0,0,0,0,0,0,0
"Saint Martin (French Part)","2024-11-30",0,0,0,0,0,0,0,0
"Saint Martin (French Part)","2024-12-01",0,0,0,0,0,0,0,0
"Saint Martin (French Part)","2024-12-02",0,0,0,0,0,0,0,0
"Saint Martin (French Part)","2024-12-03",0,0,0,0,0,0,0,0
"Saint Martin (French Part)","2024-12-04",0,0,0,0,0,0,0,0
"Saint Martin (French Part)","2024-12-05",0,0,0,0,0,0,0,0
"Saint Martin (French Part)","2024-12-06",0,0,0,0,0,0,0,0
"Saint Martin (French Part)","2024-12-07",0,0,0,0,0,0,0,0
"Saint Martin (French Part)","2024-12-08",0,0,0,0,0,0,0,0
"Saint Martin (French Part)","2024-12-09",0,0,0,0,0,0,0,0
"Saint Martin (French Part)","2024-12-10",0,0,0,0,0,0,0,0
"Saint Martin (French Part)","2024-12-11",0,0,0,0,0,0,0,0
"Saint Martin (French Part)","2024-12-12",0,0,0,0,0,0,0,0
"Saint Martin (French Part)","2024-12-13",0,0,0,0,0,0,0,0
"Saint Martin (French Part)","2024-12-14",0,0,0,0,0,0,0,0
"Saint Martin (French Part)","2024-12-15",0,0,0,0,0,0,0,0
"Saint Martin (French Part)","2024-12-16",0,0,0,0,0,0,0,0
"Saint Martin (French Part)","2024-12-17",0,0,0,0,0,0,0,0
"Saint Martin (French Part)","2024-12-18",0,0,0,0,0,0,0,0
"Saint Martin (French Part)","2024-12-19",0,0,0,0,0,0,0,0
"Saint Martin (French Part)","2024-12-20",0,0,0,0,0,0,0,0
"Saint Martin (French Part)","2024-12-21",0,0,0,0,0,0,0,0
"Saint Martin (French Part)","2024-12-22",0,0,0,0,0,0,0,0
"Saint Martin (French Part)","2024-12-23",0,0,0,0,0,0,0,0
"Saint Martin (French Part)","2024-12-24",0,0,0,0,0,0,0,0
"Saint Martin (French Part)","2024-12-25",0,0,0,0,0,0,0,0
"Saint Martin (French Part)","2024-12-26",0,0,0,0,0,0,0,0
"Saint Martin (French Part)","2024-12-27",0,0,0,0,0,0,0,0
"Saint Martin (French Part)","2024-12-28",0,0,0,0,0,0,0,0
"Saint Martin (French Part)","2024-12-29",0,0,0,0,0,0,0,0
"Saint Martin (French Part)","2024-12-30",0,0,0,0,0,0,0,0
"Saint Martin (French Part)","2024-12-31",0,0,0,0,0,0,0,0
"Saint Martin (French Part)","2025-01-01",0,0,0,0,0,0,0,0
"Saint Martin (French Part)","2025-01-02",0,0,0,0,0,0,0,0
"Saint Martin (French Part)","2025-01-03",0,0,0,0,0,0,0,0
"Saint Martin (French Part)","2025-01-04",0,0,0,0,0,0,0,0
"Saint Martin (French Part)","2025-01-05",0,0,0,0,0,0,0,0
"Saint Martin (French Part)","2025-01-06",0,0,0,0,0,0,0,0
"Saint Martin (French Part)","2025-01-07",0,0,0,0,0,0,0,0
"Saint Martin (French Part)","2025-01-08",0,0,0,0,0,0,0,0
"Saint Martin (French Part)","2025-01-09",0,0,0,0,0,0,0,0
"Saint Martin (French Part)","2025-01-10",0,0,0,0,0,0,0,0
"Saint Martin (French Part)","2025-01-11",0,0,0,0,0,0,0,0
"Saint Martin (French Part)","2025-01-12",0,0,0,0,0,0,0,0
"Saint Martin (French Part)","2025-01-13",0,0,0,0,0,0,0,0
"Saint Martin (French Part)","2025-01-14",0,0,0,0,0,0,0,0
"Saint Martin (French Part)","2025-01-15",0,0,0,0,0,0,0,0
"Saint Martin (French Part)","2025-01-16",0,0,0,0,0,0,0,0
"Saint Martin (French Part)","2025-01-17",0,0,0,0,0,0,0,0
"Saint Martin (French Part)","2025-01-18",0,0,0,0,0,0,0,0
"Saint Martin (French Part)","2025-01-19",0,0,0,0,0,0,0,0
"Saint Martin (French Part)","2025-01-20",0,0,0,0,0,0,0,0
"Saint Martin (French Part)","2025-01-21",0,0,0,0,0,0,0,0
"Saint Martin (French Part)","2025-01-22",0,0,0,0,0,0,0,0
"Saint Martin (French Part)","2025-01-23",0,0,0,0,0,0,0,0
"Saint Martin (French Part)","2025-01-24",0,0,0,0,0,0,0,0
"Saint Martin (French Part)","2025-01-25",0,0,0,0,0,0,0,0
"Saint Martin (French Part)","2025-01-26",0,0,0,0,0,0,0,0
"Saint Martin (French Part)","2025-01-27",0,0,0,0,0,0,0,0
"Saint Martin (French Part)","2025-01-28",0,0,0,0,0,0,0,0
"Saint Martin (French Part)","2025-01-29",0,0,0,0,0,0,0,0
"Saint Martin (French Part)","2025-01-30",0,0,0,0,0,0,0,0
"Saint Martin (French Part)","2025-01-31",0,0,0,0,0,0,0,0
"Saint Martin (French Part)","2025-02-01",0,0,0,0,0,0,0,0
"Saint Martin (French Part)","2025-02-02",0,0,0,0,0,0,0,0
"Saint Martin (French Part)","2025-02-03",0,0,0,0,0,0,0,0
"San Marino","2024-01-01",0,0,0,0,0,0,0,0
"San Marino","2024-01-02",0,0,0,0,0,0,0,0
"San Marino","2024-01-03",0,0,0,0,0,0,0,0
"San Marino","2024-01-04",0,0,0,0,0,0,0,0
"San Marino","2024-01-05",0,0,0,0,0,0,0,0
"San Marino","2024-01-06",0,0,0,0,0,0,0,0
"San Marino","2024-01-07",0,0,0,0,0,0,0,0
"San Marino","2024-01-08",0,0,0,0,0,0,0,0
"San Marino","2024-01-09",0,0,0,0,0,0,0,0
"San Marino","2024-01-10",0,0,0,0,0,0,0,0
"San Marino","2024-01-11",0,0,0,0,0,0,0,0
"San Marino","2024-01-12",0,0,0,0,0,0,0,0
"San Marino","2024-01-13",0,0,0,0,0,0,0,0
"San Marino","2024-01-14",0,0,0,0,0,0,0,0
"San Marino","2024-01-15",0,0,0,0,0,0,0,0
"San Marino","2024-01-16",0,0,0,0,0,0,0,0
"San Marino","2024-01-17",0,0,0,0,0,0,0,0
"San Marino","2024-01-18",0,0,0,0,0,0,0,0
"San Marino","2024-01-19",0,0,0,0,0,0,0,0
"San Marino","2024-01-20",0,0,0,0,0,0,0,0
"San Marino","2024-01-21",0,0,0,0,0,0,0,0
"San Marino","2024-01-22",0,0,0,0,0,0,0,0
"San Marino","2024-01-23",0,0,0,0,0,0,0,0
"San Marino","2024-01-24",0,0,0,0,0,0,0,0
"San Marino","2024-01-25",0,0,0,0,0,0,0,0
"San Marino","2024-01-26",0,0,0,0,0,0,0,0
"San Marino","2024-01-27",0,0,0,0,0,0,0,0
"San Marino","2024-01-28",0,0,0,0,0,0,0,0
"San Marino","2024-01-29",0,0,0,0,0,0,0,0
"San Marino","2024-01-30",0,0,0,0,0,0,0,0
"San Marino","2024-01-31",0,0,0,0,0,0,0,0
"San Marino","2024-02-01",0,0,0,0,0,0,0,0
"San Marino","2024-02-02",0,0,0,0,0,0,0,0
"San Marino","2024-02-03",0,0,0,0,0,0,0,0
"San Marino","2024-02-04",0,0,0,0,0,0,0,0
"San Marino","2024-02-05",0,0,0,0,0,0,0,0
"San Marino","2024-02-06",0,0,0,0,0,0,0,0
"San Marino","2024-02-07",0,0,0,0,0,0,0,0
"San Marino","2024-02-08",0,0,0,0,0,0,0,0
"San Marino","2024-02-09",0,0,0,0,0,0,0,0
"San Marino","2024-02-10",0,0,0,0,0,0,0,0
"San Marino","2024-02-11",0,0,0,0,0,0,0,0
"San Marino","2024-02-12",0,0,0,0,0,0,0,0
"San Marino","2024-02-13",0,0,0,0,0,0,0,0
"San Marino","2024-02-14",0,0,0,0,0,0,0,0
"San Marino","2024-02-15",0,0,0,0,0,0,0,0
"San Marino","2024-02-16",0,0,0,0,0,0,0,0
"San Marino","2024-02-17",0,0,0,0,0,0,0,0
"San Marino","2024-02-18",0,0,0,0,0,0,0,0
"San Marino","2024-02-19",0,0,0,0,0,0,0,0
"San Marino","2024-02-20",0,0,0,0,0,0,0,0
"San Marino","2024-02-21",0,0,0,0,0,0,0,0
"San Marino","2024-02-22",0,0,0,0,0,0,0,0
"San Marino","2024-02-23",0,0,0,0,0,0,0,0
"San Marino","2024-02-24",0,0,0,0,0,0,0,0
"San Marino","2024-02-25",0,0,0,0,0,0,0,0
"San Marino","2024-02-26",0,0,0,0,0,0,0,0
"San Marino","2024-02-27",0,0,0,0,0,0,0,0
"San Marino","2024-02-28",0,0,0,0,0,0,0,0
"San Marino","2024-02-29",0,0,0,0,0,0,0,0
"San Marino","2024-03-01",0,0,0,0,0,0,0,0
"San Marino","2024-03-02",0,0,0,0,0,0,0,0
"San Marino","2024-03-03",0,0,0,0,0,0,0,0
"San Marino","2024-03-04",0,0,0,0,0,0,0,0
"San Marino","2024-03-05",0,0,0,0,0,0,0,0
"San Marino","2024-03-06",0,0,0,0,0,0,0,0
"San Marino","2024-03-07",0,0,0,0,0,0,0,0
"San Marino","2024-03-08",0,0,0,0,0,0,0,0
"San Marino","2024-03-09",0,0,0,0,0,0,0,0
"San Marino","2024-03-10",0,0,0,0,0,0,0,0
"San Marino","2024-03-11",0,0,0,0,0,0,0,0
"San Marino","2024-03-12",0,0,0,0,0,0,0,0
"San Marino","2024-03-13",0,0,0,0,0,0,0,0
"San Marino","2024-03-14",0,0,0,0,0,0,0,0
"San Marino","2024-03-15",0,0,0,0,0,0,0,0
"San Marino","2024-03-16",0,0,0,0,0,0,0,0
"San Marino","2024-03-17",0,0,0,0,0,0,0,0
"San Marino","2024-03-18",0,0,0,0,0,0,0,0
"San Marino","2024-03-19",0,0,0,0,0,0,0,0
"San Marino","2024-03-20",0,0,0,0,0,0,0,0
"San Marino","2024-03-21",0,0,0,0,0,0,0,0
"San Marino","2024-03-22",0,0,0,0,0,0,0,0
"San Marino","2024-03-23",0,0,0,0,0,0,0,0
"San Marino","2024-03-24",0,0,0,0,0,0,0,0
"San Marino","2024-03-25",0,0,0,0,0,0,0,0
"San Marino","2024-03-26",0,0,0,0,0,0,0,0
"San Marino","2024-03-27",0,0,0,0,0,0,0,0
"San Marino","2024-03-28",0,0,0,0,0,0,0,0
"San Marino","2024-03-29",0,0,0,0,0,0,0,0
"San Marino","2024-03-30",0,0,0,0,0,0,0,0
"San Marino","2024-03-31",0,0,0,0,0,0,0,0
"San Marino","2024-04-01",0,0,0,0,0,0,0,0
"San Marino","2024-04-02",0,0,0,0,0,0,0,0
"San Marino","2024-04-03",0,0,0,0,0,0,0,0
"San Marino","2024-04-04",0,0,0,0,0,0,0,0
"San Marino","2024-04-05",0,0,0,0,0,0,0,0
"San Marino","2024-04-06",0,0,0,0,0,0,0,0
"San Marino","2024-04-07",0,0,0,0,0,0,0,0
"San Marino","2024-04-08",0,0,0,0,0,0,0,0
"San Marino","2024-04-09",0,0,0,0,0,0,0,0
"San Marino","2024-04-10",0,0,0,0,0,0,0,0
"San Marino","2024-04-11",0,0,0,0,0,0,0,0
"San Marino","2024-04-12",0,0,0,0,0,0,0,0
"San Marino","2024-04-13",0,0,0,0,0,0,0,0
"San Marino","2024-04-14",0,0,0,0,0,0,0,0
"San Marino","2024-04-15",0,0,0,0,0,0,0,0
"San Marino","2024-04-16",0,0,0,0,0,0,0,0
"San Marino","2024-04-17",0,0,0,0,0,0,0,0
"San Marino","2024-04-18",0,0,0,0,0,0,0,0
"San Marino","2024-04-19",0,0,0,0,0,0,0,0
"San Marino","2024-04-20",0,0,0,0,0,0,0,0
"San Marino","2024-04-21",0,0,0,0,0,0,0,0
"San Marino","2024-04-22",0,0,0,0,0,0,0,0
"San Marino","2024-04-23",0,0,0,0,0,0,0,0
"San Marino","2024-04-24",0,0,0,0,0,0,0,0
"San Marino","2024-04-25",0,0,0,0,0,0,0,0
"San Marino","2024-04-26",0,0,0,0,0,0,0,0
"San Marino","2024-04-27",0,0,0,0,0,0,0,0
"San Marino","2024-04-28",0,0,0,0,0,0,0,0
"San Marino","2024-04-29",0,0,0,0,0,0,0,0
"San Marino","2024-04-30",0,0,0,0,0,0,0,0
"San Marino","2024-05-01",0,0,0,0,0,0,0,0
"San Marino","2024-05-02",0,0,0,0,0,0,0,0
"San Marino","2024-05-03",0,0,0,0,0,0,0,0
"San Marino","2024-05-04",0,0,0,0,0,0,0,0
"San Marino","2024-05-05",0,0,0,0,0,0,0,0
"San Marino","2024-05-06",0,0,0,0,0,0,0,0
"San Marino","2024-05-07",0,0,0,0,0,0,0,0
"San Marino","2024-05-08",0,0,0,0,0,0,0,0
"San Marino","2024-05-09",0,0,0,0,0,0,0,0
"San Marino","2024-05-10",0,0,0,0,0,0,0,0
"San Marino","2024-05-11",0,0,0,0,0,0,0,0
"San Marino","2024-05-12",0,0,0,0,0,0,0,0
"San Marino","2024-05-13",0,0,0,0,0,0,0,0
"San Marino","2024-05-14",0,0,0,0,0,0,0,0
"San Marino","2024-05-15",0,0,0,0,0,0,0,0
"San Marino","2024-05-16",0,0,0,0,0,0,0,0
"San Marino","2024-05-17",0,0,0,0,0,0,0,0
"San Marino","2024-05-18",0,0,0,0,0,0,0,0
"San Marino","2024-05-19",0,0,0,0,0,0,0,0
"San Marino","2024-05-20",0,0,0,0,0,0,0,0
"San Marino","2024-05-21",0,0,0,0,0,0,0,0
"San Marino","2024-05-22",0,0,0,0,0,0,0,0
"San Marino","2024-05-23",0,0,0,0,0,0,0,0
"San Marino","2024-05-24",0,0,0,0,0,0,0,0
"San Marino","2024-05-25",0,0,0,0,0,0,0,0
"San Marino","2024-05-26",0,0,0,0,0,0,0,0
"San Marino","2024-05-27",0,0,0,0,0,0,0,0
"San Marino","2024-05-28",0,0,0,0,0,0,0,0
"San Marino","2024-05-29",0,0,0,0,0,0,0,0
"San Marino","2024-05-30",0,0,0,0,0,0,0,0
"San Marino","2024-05-31",0,0,0,0,0,0,0,0
"San Marino","2024-06-01",0,0,0,0,0,0,0,0
"San Marino","2024-06-02",0,0,0,0,0,0,0,0
"San Marino","2024-06-03",0,0,0,0,0,0,0,0
"San Marino","2024-06-04",0,0,0,0,0,0,0,0
"San Marino","2024-06-05",0,0,0,0,0,0,0,0
"San Marino","2024-06-06",0,0,0,0,0,0,0,0
"San Marino","2024-06-07",0,0,0,0,0,0,0,0
"San Marino","2024-06-08",0,0,0,0,0,0,0,0
"San Marino","2024-06-09",0,0,0,0,0,0,0,0
"San Marino","2024-06-10",0,0,0,0,0,0,0,0
"San Marino","2024-06-11",0,0,0,0,0,0,0,0
"San Marino","2024-06-12",0,0,0,0,0,0,0,0
"San Marino","2024-06-13",0,0,0,0,0,0,0,0
"San Marino","2024-06-14",0,0,0,0,0,0,0,0
"San Marino","2024-06-15",0,0,0,0,0,0,0,0
"San Marino","2024-06-16",0,0,0,0,0,0,0,0
"San Marino","2024-06-17",0,0,0,0,0,0,0,0
"San Marino","2024-06-18",0,0,0,0,0,0,0,0
"San Marino","2024-06-19",0,0,0,0,0,0,0,0
"San Marino","2024-06-20",0,0,0,0,0,0,0,0
"San Marino","2024-06-21",0,0,0,0,0,0,0,0
"San Marino","2024-06-22",0,0,0,0,0,0,0,0
"San Marino","2024-06-23",0,0,0,0,0,0,0,0
"San Marino","2024-06-24",0,0,0,0,0,0,0,0
"San Marino","2024-06-25",0,0,0,0,0,0,0,0
"San Marino","2024-06-26",0,0,0,0,0,0,0,0
"San Marino","2024-06-27",0,0,0,0,0,0,0,0
"San Marino","2024-06-28",0,0,0,0,0,0,0,0
"San Marino","2024-06-29",0,0,0,0,0,0,0,0
"San Marino","2024-06-30",0,0,0,0,0,0,0,0
"San Marino","2024-07-01",0,0,0,0,0,0,0,0
"San Marino","2024-07-02",0,0,0,0,0,0,0,0
"San Marino","2024-07-03",0,0,0,0,0,0,0,0
"San Marino","2024-07-04",0,0,0,0,0,0,0,0
"San Marino","2024-07-05",0,0,0,0,0,0,0,0
"San Marino","2024-07-06",0,0,0,0,0,0,0,0
"San Marino","2024-07-07",0,0,0,0,0,0,0,0
"San Marino","2024-07-08",0,0,0,0,0,0,0,0
"San Marino","2024-07-09",0,0,0,0,0,0,0,0
"San Marino","2024-07-10",0,0,0,0,0,0,0,0
"San Marino","2024-07-11",0,0,0,0,0,0,0,0
"San Marino","2024-07-12",0,0,0,0,0,0,0,0
"San Marino","2024-07-13",0,0,0,0,0,0,0,0
"San Marino","2024-07-14",0,0,0,0,0,0,0,0
"San Marino","2024-07-15",0,0,0,0,0,0,0,0
"San Marino","2024-07-16",0,0,0,0,0,0,0,0
"San Marino","2024-07-17",0,0,0,0,0,0,0,0
"San Marino","2024-07-18",0,0,0,0,0,0,0,0
"San Marino","2024-07-19",0,0,0,0,0,0,0,0
"San Marino","2024-07-20",0,0,0,0,0,0,0,0
"San Marino","2024-07-21",0,0,0,0,0,0,0,0
"San Marino","2024-07-22",0,0,0,0,0,0,0,0
"San Marino","2024-07-23",0,0,0,0,0,0,0,0
"San Marino","2024-07-24",0,0,0,0,0,0,0,0
"San Marino","2024-07-25",0,0,0,0,0,0,0,0
"San Marino","2024-07-26",0,0,0,0,0,0,0,0
"San Marino","2024-07-27",0,0,0,0,0,0,0,0
"San Marino","2024-07-28",0,0,0,0,0,0,0,0
"San Marino","2024-07-29",0,0,0,0,0,0,0,0
"San Marino","2024-07-30",0,0,0,0,0,0,0,0
"San Marino","2024-07-31",0,0,0,0,0,0,0,0
"San Marino","2024-08-01",0,0,0,0,0,0,0,0
"San Marino","2024-08-02",0,0,0,0,0,0,0,0
"San Marino","2024-08-03",0,0,0,0,0,0,0,0
"San Marino","2024-08-04",0,0,0,0,0,0,0,0
"San Marino","2024-08-05",0,0,0,0,0,0,0,0
"San Marino","2024-08-06",0,0,0,0,0,0,0,0
"San Marino","2024-08-07",0,0,0,0,0,0,0,0
"San Marino","2024-08-08",0,0,0,0,0,0,0,0
"San Marino","2024-08-09",0,0,0,0,0,0,0,0
"San Marino","2024-08-10",0,0,0,0,0,0,0,0
"San Marino","2024-08-11",0,0,0,0,0,0,0,0
"San Marino","2024-08-12",0,0,0,0,0,0,0,0
"San Marino","2024-08-13",0,0,0,0,0,0,0,0
"San Marino","2024-08-14",0,0,0,0,0,0,0,0
"San Marino","2024-08-15",0,0,0,0,0,0,0,0
"San Marino","2024-08-16",0,0,0,0,0,0,0,0
"San Marino","2024-08-17",0,0,0,0,0,0,0,0
"San Marino","2024-08-18",0,0,0,0,0,0,0,0
"San Marino","2024-08-19",0,0,0,0,0,0,0,0
"San Marino","2024-08-20",0,0,0,0,0,0,0,0
"San Marino","2024-08-21",0,0,0,0,0,0,0,0
"San Marino","2024-08-22",0,0,0,0,0,0,0,0
"San Marino","2024-08-23",0,0,0,0,0,0,0,0
"San Marino","2024-08-24",0,0,0,0,0,0,0,0
"San Marino","2024-08-25",0,0,0,0,0,0,0,0
"San Marino","2024-08-26",0,0,0,0,0,0,0,0
"San Marino","2024-08-27",0,0,0,0,0,0,0,0
"San Marino","2024-08-28",0,0,0,0,0,0,0,0
"San Marino","2024-08-29",0,0,0,0,0,0,0,0
"San Marino","2024-08-30",0,0,0,0,0,0,0,0
"San Marino","2024-08-31",0,0,0,0,0,0,0,0
"San Marino","2024-09-01",0,0,0,0,0,0,0,0
"San Marino","2024-09-02",0,0,0,0,0,0,0,0
"San Marino","2024-09-03",0,0,0,0,0,0,0,0
"San Marino","2024-09-04",0,0,0,0,0,0,0,0
"San Marino","2024-09-05",0,0,0,0,0,0,0,0
"San Marino","2024-09-06",0,0,0,0,0,0,0,0
"San Marino","2024-09-07",0,0,0,0,0,0,0,0
"San Marino","2024-09-08",0,0,0,0,0,0,0,0
"San Marino","2024-09-09",0,0,0,0,0,0,0,0
"San Marino","2024-09-10",0,0,0,0,0,0,0,0
"San Marino","2024-09-11",0,0,0,0,0,0,0,0
"San Marino","2024-09-12",0,0,0,0,0,0,0,0
"San Marino","2024-09-13",0,0,0,0,0,0,0,0
"San Marino","2024-09-14",0,0,0,0,0,0,0,0
"San Marino","2024-09-15",0,0,0,0,0,0,0,0
"San Marino","2024-09-16",0,0,0,0,0,0,0,0
"San Marino","2024-09-17",0,0,0,0,0,0,0,0
"San Marino","2024-09-18",0,0,0,0,0,0,0,0
"San Marino","2024-09-19",0,0,0,0,0,0,0,0
"San Marino","2024-09-20",0,0,0,0,0,0,0,0
"San Marino","2024-09-21",0,0,0,0,0,0,0,0
"San Marino","2024-09-22",0,0,0,0,0,0,0,0
"San Marino","2024-09-23",0,0,0,0,0,0,0,0
"San Marino","2024-09-24",0,0,0,0,0,0,0,0
"San Marino","2024-09-25",0,0,0,0,0,0,0,0
"San Marino","2024-09-26",0,0,0,0,0,0,0,0
"San Marino","2024-09-27",0,0,0,0,0,0,0,0
"San Marino","2024-09-28",0,0,0,0,0,0,0,0
"San Marino","2024-09-29",0,0,0,0,0,0,0,0
"San Marino","2024-09-30",0,0,0,0,0,0,0,0
"San Marino","2024-10-01",0,0,0,0,0,0,0,0
"San Marino","2024-10-02",0,0,0,0,0,0,0,0
"San Marino","2024-10-03",0,0,0,0,0,0,0,0
"San Marino","2024-10-04",0,0,0,0,0,0,0,0
"San Marino","2024-10-05",0,0,0,0,0,0,0,0
"San Marino","2024-10-06",0,0,0,0,0,0,0,0
"San Marino","2024-10-07",0,0,0,0,0,0,0,0
"San Marino","2024-10-08",0,0,0,0,0,0,0,0
"San Marino","2024-10-09",0,0,0,0,0,0,0,0
"San Marino","2024-10-10",0,0,0,0,0,0,0,0
"San Marino","2024-10-11",0,0,0,0,0,0,0,0
"San Marino","2024-10-12",0,0,0,0,0,0,0,0
"San Marino","2024-10-13",0,0,0,0,0,0,0,0
"San Marino","2024-10-14",0,0,0,0,0,0,0,0
"San Marino","2024-10-15",0,0,0,0,0,0,0,0
"San Marino","2024-10-16",0,0,0,0,0,0,0,0
"San Marino","2024-10-17",0,0,0,0,0,0,0,0
"San Marino","2024-10-18",0,0,0,0,0,0,0,0
"San Marino","2024-10-19",0,0,0,0,0,0,0,0
"San Marino","2024-10-20",0,0,0,0,0,0,0,0
"San Marino","2024-10-21",0,0,0,0,0,0,0,0
"San Marino","2024-10-22",0,0,0,0,0,0,0,0
"San Marino","2024-10-23",0,0,0,0,0,0,0,0
"San Marino","2024-10-24",0,0,0,0,0,0,0,0
"San Marino","2024-10-25",0,0,0,0,0,0,0,0
"San Marino","2024-10-26",0,0,0,0,0,0,0,0
"San Marino","2024-10-27",0,0,0,0,0,0,0,0
"San Marino","2024-10-28",0,0,0,0,0,0,0,0
"San Marino","2024-10-29",0,0,0,0,0,0,0,0
"San Marino","2024-10-30",0,0,0,0,0,0,0,0
"San Marino","2024-10-31",0,0,0,0,0,0,0,0
"San Marino","2024-11-01",0,0,0,0,0,0,0,0
"San Marino","2024-11-02",0,0,0,0,0,0,0,0
"San Marino","2024-11-03",0,0,0,0,0,0,0,0
"San Marino","2024-11-04",0,0,0,0,0,0,0,0
"San Marino","2024-11-05",0,0,0,0,0,0,0,0
"San Marino","2024-11-06",0,0,0,0,0,0,0,0
"San Marino","2024-11-07",0,0,0,0,0,0,0,0
"San Marino","2024-11-08",0,0,0,0,0,0,0,0
"San Marino","2024-11-09",0,0,0,0,0,0,0,0
"San Marino","2024-11-10",0,0,0,0,0,0,0,0
"San Marino","2024-11-11",0,0,0,0,0,0,0,0
"San Marino","2024-11-12",0,0,0,0,0,0,0,0
"San Marino","2024-11-13",0,0,0,0,0,0,0,0
"San Marino","2024-11-14",0,0,0,0,0,0,0,0
"San Marino","2024-11-15",0,0,0,0,0,0,0,0
"San Marino","2024-11-16",0,0,0,0,0,0,0,0
"San Marino","2024-11-17",0,0,0,0,0,0,0,0
"San Marino","2024-11-18",0,0,0,0,0,0,0,0
"San Marino","2024-11-19",0,0,0,0,0,0,0,0
"San Marino","2024-11-20",0,0,0,0,0,0,0,0
"San Marino","2024-11-21",0,0,0,0,0,0,0,0
"San Marino","2024-11-22",0,0,0,0,0,0,0,0
"San Marino","2024-11-23",0,0,0,0,0,0,0,0
"San Marino","2024-11-24",0,0,0,0,0,0,0,0
"San Marino","2024-11-25",0,0,0,0,0,0,0,0
"San Marino","2024-11-26",0,0,0,0,0,0,0,0
"San Marino","2024-11-27",0,0,0,0,0,0,0,0
"San Marino","2024-11-28",0,0,0,0,0,0,0,0
"San Marino","2024-11-29",0,0,0,0,0,0,0,0
"San Marino","2024-11-30",0,0,0,0,0,0,0,0
"San Marino","2024-12-01",0,0,0,0,0,0,0,0
"San Marino","2024-12-02",0,0,0,0,0,0,0,0
"San Marino","2024-12-03",0,0,0,0,0,0,0,0
"San Marino","2024-12-04",0,0,0,0,0,0,0,0
"San Marino","2024-12-05",0,0,0,0,0,0,0,0
"San Marino","2024-12-06",0,0,0,0,0,0,0,0
"San Marino","2024-12-07",0,0,0,0,0,0,0,0
"San Marino","2024-12-08",0,0,0,0,0,0,0,0
"San Marino","2024-12-09",0,0,0,0,0,0,0,0
"San Marino","2024-12-10",0,0,0,0,0,0,0,0
"San Marino","2024-12-11",0,0,0,0,0,0,0,0
"San Marino","2024-12-12",0,0,0,0,0,0,0,0
"San Marino","2024-12-13",0,0,0,0,0,0,0,0
"San Marino","2024-12-14",0,0,0,0,0,0,0,0
"San Marino","2024-12-15",0,0,0,0,0,0,0,0
"San Marino","2024-12-16",0,0,0,0,0,0,0,0
"San Marino","2024-12-17",0,0,0,0,0,0,0,0
"San Marino","2024-12-18",0,0,0,0,0,0,0,0
"San Marino","2024-12-19",0,0,0,0,0,0,0,0
"San Marino","2024-12-20",0,0,0,0,0,0,0,0
"San Marino","2024-12-21",0,0,0,0,0,0,0,0
"San Marino","2024-12-22",0,0,0,0,0,0,0,0
"San Marino","2024-12-23",0,0,0,0,0,0,0,0
"San Marino","2024-12-24",0,0,0,0,0,0,0,0
"San Marino","2024-12-25",0,0,0,0,0,0,0,0
"San Marino","2024-12-26",0,0,0,0,0,0,0,0
"San Marino","2024-12-27",0,0,0,0,0,0,0,0
"San Marino","2024-12-28",0,0,0,0,0,0,0,0
"San Marino","2024-12-29",0,0,0,0,0,0,0,0
"San Marino","2024-12-30",0,0,0,0,0,0,0,0
"San Marino","2024-12-31",0,0,0,0,0,0,0,0
"San Marino","2025-01-01",0,0,0,0,0,0,0,0
"San Marino","2025-01-02",0,0,0,0,0,0,0,0
"San Marino","2025-01-03",0,0,0,0,0,0,0,0
"San Marino","2025-01-04",0,0,0,0,0,0,0,0
"San Marino","2025-01-05",0,0,0,0,0,0,0,0
"San Marino","2025-01-06",0,0,0,0,0,0,0,0
"San Marino","2025-01-07",0,0,0,0,0,0,0,0
"San Marino","2025-01-08",0,0,0,0,0,0,0,0
"San Marino","2025-01-09",0,0,0,0,0,0,0,0
"San Marino","2025-01-10",0,0,0,0,0,0,0,0
"San Marino","2025-01-11",0,0,0,0,0,0,0,0
"San Marino","2025-01-12",0,0,0,0,0,0,0,0
"San Marino","2025-01-13",0,0,0,0,0,0,0,0
"San Marino","2025-01-14",0,0,0,0,0,0,0,0
"San Marino","2025-01-15",0,0,0,0,0,0,0,0
"San Marino","2025-01-16",0,0,0,0,0,0,0,0
"San Marino","2025-01-17",0,0,0,0,0,0,0,0
"San Marino","2025-01-18",0,0,0,0,0,0,0,0
"San Marino","2025-01-19",0,0,0,0,0,0,0,0
"San Marino","2025-01-20",0,0,0,0,0,0,0,0
"San Marino","2025-01-21",0,0,0,0,0,0,0,0
"San Marino","2025-01-22",0,0,0,0,0,0,0,0
"San Marino","2025-01-23",0,0,0,0,0,0,0,0
"San Marino","2025-01-24",0,0,0,0,0,0,0,0
"San Marino","2025-01-25",0,0,0,0,0,0,0,0
"San Marino","2025-01-26",0,0,0,0,0,0,0,0
"San Marino","2025-01-27",0,0,0,0,0,0,0,0
"San Marino","2025-01-28",0,0,0,0,0,0,0,0
"San Marino","2025-01-29",0,0,0,0,0,0,0,0
"San Marino","2025-01-30",0,0,0,0,0,0,0,0
"San Marino","2025-01-31",0,0,0,0,0,0,0,0
"San Marino","2025-02-01",0,0,0,0,0,0,0,0
"San Marino","2025-02-02",0,0,0,0,0,0,0,0
"San Marino","2025-02-03",0,0,0,0,0,0,0,0
"Saudi Arabia","2024-01-01",0,0,0,0,0,0,0,0
"Saudi Arabia","2024-01-02",0,0,0,0,0,0,0,0
"Saudi Arabia","2024-01-03",0,0,0,0,0,0,0,0
"Saudi Arabia","2024-01-04",0,0,0,0,0,0,0,0
"Saudi Arabia","2024-01-05",0,0,0,0,0,0,0,0
"Saudi Arabia","2024-01-06",0,0,0,0,0,0,0,0
"Saudi Arabia","2024-01-07",0,0,0,0,0,0,0,0
"Saudi Arabia","2024-01-08",0,0,0,0,0,0,0,0
"Saudi Arabia","2024-01-09",0,0,0,0,0,0,0,0
"Saudi Arabia","2024-01-10",0,0,0,0,0,0,0,0
"Saudi Arabia","2024-01-11",0,0,0,0,0,0,0,0
"Saudi Arabia","2024-01-12",0,0,0,0,0,0,0,0
"Saudi Arabia","2024-01-13",0,0,0,0,0,0,0,0
"Saudi Arabia","2024-01-14",0,0,0,0,0,0,0,0
"Saudi Arabia","2024-01-15",0,0,0,0,0,0,0,0
"Saudi Arabia","2024-01-16",0,0,0,0,0,0,0,0
"Saudi Arabia","2024-01-17",0,0,0,0,0,0,0,0
"Saudi Arabia","2024-01-18",0,0,0,0,0,0,0,0
"Saudi Arabia","2024-01-19",0,0,0,0,0,0,0,0
"Saudi Arabia","2024-01-20",0,0,0,0,0,0,0,0
"Saudi Arabia","2024-01-21",0,0,0,0,0,0,0,0
"Saudi Arabia","2024-01-22",0,0,0,0,0,0,0,0
"Saudi Arabia","2024-01-23",0,0,0,0,0,0,0,0
"Saudi Arabia","2024-01-24",0,0,0,0,0,0,0,0
"Saudi Arabia","2024-01-25",0,0,0,0,0,0,0,0
"Saudi Arabia","2024-01-26",0,0,0,0,0,0,0,0
"Saudi Arabia","2024-01-27",0,0,0,0,0,0,0,0
"Saudi Arabia","2024-01-28",0,0,0,0,0,0,0,0
"Saudi Arabia","2024-01-29",0,0,0,0,0,0,0,0
"Saudi Arabia","2024-01-30",0,0,0,0,0,0,0,0
"Saudi Arabia","2024-01-31",0,16,16,0,16,16,0,0
"Saudi Arabia","2024-02-01",0,0,16,0,1,17,0,0
"Saudi Arabia","2024-02-02",0,0,16,0,0,17,0,0
"Saudi Arabia","2024-02-03",0,0,16,0,1,18,0,0
"Saudi Arabia","2024-02-04",0,0,16,0,0,18,0,0
"Saudi Arabia","2024-02-05",0,0,16,0,1,19,0,0
"Saudi Arabia","2024-02-06",0,0,16,0,0,19,0,0
"Saudi Arabia","2024-02-07",0,0,16,0,1,20,0,0
"Saudi Arabia","2024-02-08",0,0,16,0,0,20,0,0
"Saudi Arabia","2024-02-09",0,0,16,0,1,21,0,0
"Saudi Arabia","2024-02-10",0,0,16,0,0,21,0,0
"Saudi Arabia","2024-02-11",0,0,16,0,1,22,0,0
"Saudi Arabia","2024-02-12",0,0,16,0,0,22,0,0
"Saudi Arabia","2024-02-13",0,0,16,0,1,23,0,0
"Saudi Arabia","2024-02-14",0,0,16,0,1,24,0,0
"Saudi Arabia","2024-02-15",0,0,16,0,0,24,0,0
"Saudi Arabia","2024-02-16",0,0,16,0,1,25,0,0
"Saudi Arabia","2024-02-17",0,0,16,0,0,25,0,0
"Saudi Arabia","2024-02-18",0,0,16,0,1,26,0,0
"Saudi Arabia","2024-02-19",0,0,16,0,0,26,0,0
"Saudi Arabia","2024-02-20",0,0,16,0,1,27,0,0
"Saudi Arabia","2024-02-21",0,0,16,0,0,27,0,0
"Saudi Arabia","2024-02-22",0,0,16,0,1,28,0,0
"Saudi Arabia","2024-02-23",0,0,16,0,0,28,0,0
"Saudi Arabia","2024-02-24",0,0,16,0,1,29,0,0
"Saudi Arabia","2024-02-25",0,0,16,0,0,29,0,0
"Saudi Arabia","2024-02-26",0,0,16,0,1,30,0,0
"Saudi Arabia","2024-02-27",0,0,16,0,0,30,0,0
"Saudi Arabia","2024-02-28",0,15,31,0,1,31,0,0
"Saudi Arabia","2024-02-29",0,0,31,0,1,32,0,0
"Saudi Arabia","2024-03-01",0,0,31,0,0,32,0,0
"Saudi Arabia","2024-03-02",0,0,31,0,1,33,0,0
"Saudi Arabia","2024-03-03",0,0,31,0,0,33,0,0
"Saudi Arabia","2024-03-04",0,0,31,0,1,34,0,0
"Saudi Arabia","2024-03-05",0,0,31,0,1,35,0,0
"Saudi Arabia","2024-03-06",0,0,31,0,0,35,0,0
"Saudi Arabia","2024-03-07",0,0,31,0,1,36,0,0
"Saudi Arabia","2024-03-08",0,0,31,0,1,37,0,0
"Saudi Arabia","2024-03-09",0,0,31,0,0,37,0,0
"Saudi Arabia","2024-03-10",0,0,31,0,1,38,0,0
"Saudi Arabia","2024-03-11",0,0,31,0,1,39,0,0
"Saudi Arabia","2024-03-12",0,0,31,0,0,39,0,0
"Saudi Arabia","2024-03-13",0,0,31,0,1,40,0,0
"Saudi Arabia","2024-03-14",0,0,31,0,0,40,0,0
"Saudi Arabia","2024-03-15",0,0,31,0,1,41,0,0
"Saudi Arabia","2024-03-16",0,0,31,0,1,42,0,0
"Saudi Arabia","2024-03-17",0,0,31,0,0,42,0,0
"Saudi Arabia","2024-03-18",0,0,31,0,1,43,0,0
"Saudi Arabia","2024-03-19",0,0,31,0,0,43,0,0
"Saudi Arabia","2024-03-20",0,0,31,0,1,44,0,0
"Saudi Arabia","2024-03-21",0,0,31,0,1,45,0,0
"Saudi Arabia","2024-03-22",0,0,31,0,0,45,0,0
"Saudi Arabia","2024-03-23",0,0,31,0,1,46,0,0
"Saudi Arabia","2024-03-24",0,0,31,0,1,47,0,0
"Saudi Arabia","2024-03-25",0,0,31,0,0,47,0,0
"Saudi Arabia","2024-03-26",0,0,31,0,1,48,0,0
"Saudi Arabia","2024-03-27",0,0,31,0,1,49,0,0
"Saudi Arabia","2024-03-28",0,0,31,0,0,49,0,0
"Saudi Arabia","2024-03-29",0,0,31,0,1,50,0,0
"Saudi Arabia","2024-03-30",0,0,31,0,0,50,0,0
"Saudi Arabia","2024-03-31",0,20,51,0,1,51,0,0
"Saudi Arabia","2024-04-01",0,0,51,0,0,51,0,0
"Saudi Arabia","2024-04-02",0,0,51,0,1,52,0,0
"Saudi Arabia","2024-04-03",0,0,51,0,0,52,0,0
"Saudi Arabia","2024-04-04",0,0,51,0,1,53,0,0
"Saudi Arabia","2024-04-05",0,0,51,0,0,53,0,0
"Saudi Arabia","2024-04-06",0,0,51,0,1,54,0,0
"Saudi Arabia","2024-04-07",0,0,51,0,0,54,0,0
"Saudi Arabia","2024-04-08",0,0,51,0,0,54,0,0
"Saudi Arabia","2024-04-09",0,0,51,0,1,55,0,0
"Saudi Arabia","2024-04-10",0,0,51,0,0,55,0,0
"Saudi Arabia","2024-04-11",0,0,51,0,1,56,0,0
"Saudi Arabia","2024-04-12",0,0,51,0,0,56,0,0
"Saudi Arabia","2024-04-13",0,0,51,0,1,57,0,0
"Saudi Arabia","2024-04-14",0,0,51,0,0,57,0,0
"Saudi Arabia","2024-04-15",0,0,51,0,0,57,0,0
"Saudi Arabia","2024-04-16",0,0,51,0,1,58,0,0
"Saudi Arabia","2024-04-17",0,0,51,0,0,58,0,0
"Saudi Arabia","2024-04-18",0,0,51,0,1,59,0,0
"Saudi Arabia","2024-04-19",0,0,51,0,0,59,0,0
"Saudi Arabia","2024-04-20",0,0,51,0,1,60,0,0
"Saudi Arabia","2024-04-21",0,0,51,0,0,60,0,0
"Saudi Arabia","2024-04-22",0,0,51,0,1,61,0,0
"Saudi Arabia","2024-04-23",0,0,51,0,0,61,0,0
"Saudi Arabia","2024-04-24",0,0,51,0,0,61,0,0
"Saudi Arabia","2024-04-25",0,0,51,0,1,62,0,0
"Saudi Arabia","2024-04-26",0,0,51,0,0,62,0,0
"Saudi Arabia","2024-04-27",0,0,51,0,1,63,0,0
"Saudi Arabia","2024-04-28",0,0,51,0,0,63,0,0
"Saudi Arabia","2024-04-29",0,0,51,0,1,64,0,0
"Saudi Arabia","2024-04-30",0,13,64,0,0,64,0,0
"Saudi Arabia","2024-05-01",0,0,64,0,0,64,0,0
"Saudi Arabia","2024-05-02",0,0,64,0,1,65,0,0
"Saudi Arabia","2024-05-03",0,0,64,0,0,65,0,0
"Saudi Arabia","2024-05-04",0,0,64,0,1,66,0,0
"Saudi Arabia","2024-05-05",0,0,64,0,0,66,0,0
"Saudi Arabia","2024-05-06",0,0,64,0,1,67,0,0
"Saudi Arabia","2024-05-07",0,0,64,0,0,67,0,0
"Saudi Arabia","2024-05-08",0,0,64,0,1,68,0,0
"Saudi Arabia","2024-05-09",0,0,64,0,0,68,0,0
"Saudi Arabia","2024-05-10",0,0,64,0,1,69,0,0
"Saudi Arabia","2024-05-11",0,0,64,0,0,69,0,0
"Saudi Arabia","2024-05-12",0,0,64,0,1,70,0,0
"Saudi Arabia","2024-05-13",0,0,64,0,0,70,0,0
"Saudi Arabia","2024-05-14",0,0,64,0,1,71,0,0
"Saudi Arabia","2024-05-15",0,0,64,0,0,71,0,0
"Saudi Arabia","2024-05-16",0,0,64,0,1,72,0,0
"Saudi Arabia","2024-05-17",0,0,64,0,0,72,0,0
"Saudi Arabia","2024-05-18",0,0,64,0,1,73,0,0
"Saudi Arabia","2024-05-19",0,0,64,0,0,73,0,0
"Saudi Arabia","2024-05-20",0,0,64,0,1,74,0,0
"Saudi Arabia","2024-05-21",0,0,64,0,0,74,0,0
"Saudi Arabia","2024-05-22",0,0,64,0,1,75,0,0
"Saudi Arabia","2024-05-23",0,0,64,0,0,75,0,0
"Saudi Arabia","2024-05-24",0,0,64,0,1,76,0,0
"Saudi Arabia","2024-05-25",0,0,64,0,0,76,0,0
"Saudi Arabia","2024-05-26",0,0,64,0,1,77,0,0
"Saudi Arabia","2024-05-27",0,0,64,0,0,77,0,0
"Saudi Arabia","2024-05-28",0,0,64,0,1,78,0,0
"Saudi Arabia","2024-05-29",0,0,64,0,0,78,0,0
"Saudi Arabia","2024-05-30",0,0,64,0,1,79,0,0
"Saudi Arabia","2024-05-31",0,15,79,0,0,79,0,0
"Saudi Arabia","2024-06-01",0,0,79,0,0,79,0,0
"Saudi Arabia","2024-06-02",0,0,79,0,0,79,0,0
"Saudi Arabia","2024-06-03",0,0,79,0,1,80,0,0
"Saudi Arabia","2024-06-04",0,0,79,0,0,80,0,0
"Saudi Arabia","2024-06-05",0,0,79,0,0,80,0,0
"Saudi Arabia","2024-06-06",0,0,79,0,0,80,0,0
"Saudi Arabia","2024-06-07",0,0,79,0,0,80,0,0
"Saudi Arabia","2024-06-08",0,0,79,0,1,81,0,0
"Saudi Arabia","2024-06-09",0,0,79,0,0,81,0,0
"Saudi Arabia","2024-06-10",0,0,79,0,0,81,0,0
"Saudi Arabia","2024-06-11",0,0,79,0,0,81,0,0
"Saudi Arabia","2024-06-12",0,0,79,0,0,81,0,0
"Saudi Arabia","2024-06-13",0,0,79,0,1,82,0,0
"Saudi Arabia","2024-06-14",0,0,79,0,0,82,0,0
"Saudi Arabia","2024-06-15",0,0,79,0,0,82,0,0
"Saudi Arabia","2024-06-16",0,0,79,0,0,82,0,0
"Saudi Arabia","2024-06-17",0,0,79,0,0,82,0,0
"Saudi Arabia","2024-06-18",0,0,79,0,1,83,0,0
"Saudi Arabia","2024-06-19",0,0,79,0,0,83,0,0
"Saudi Arabia","2024-06-20",0,0,79,0,0,83,0,0
"Saudi Arabia","2024-06-21",0,0,79,0,0,83,0,0
"Saudi Arabia","2024-06-22",0,0,79,0,0,83,0,0
"Saudi Arabia","2024-06-23",0,0,79,0,1,84,0,0
"Saudi Arabia","2024-06-24",0,0,79,0,0,84,0,0
"Saudi Arabia","2024-06-25",0,0,79,0,0,84,0,0
"Saudi Arabia","2024-06-26",0,0,79,0,0,84,0,0
"Saudi Arabia","2024-06-27",0,0,79,0,0,84,0,0
"Saudi Arabia","2024-06-28",0,0,79,0,1,85,0,0
"Saudi Arabia","2024-06-29",0,0,79,0,0,85,0,0
"Saudi Arabia","2024-06-30",0,6,85,0,0,85,0,0
"Saudi Arabia","2024-07-01",0,0,85,0,0,85,0,0
"Saudi Arabia","2024-07-02",0,0,85,0,1,86,0,0
"Saudi Arabia","2024-07-03",0,0,85,0,0,86,0,0
"Saudi Arabia","2024-07-04",0,0,85,0,0,86,0,0
"Saudi Arabia","2024-07-05",0,0,85,0,0,86,0,0
"Saudi Arabia","2024-07-06",0,0,85,0,1,87,0,0
"Saudi Arabia","2024-07-07",0,0,85,0,0,87,0,0
"Saudi Arabia","2024-07-08",0,0,85,0,0,87,0,0
"Saudi Arabia","2024-07-09",0,0,85,0,1,88,0,0
"Saudi Arabia","2024-07-10",0,0,85,0,0,88,0,0
"Saudi Arabia","2024-07-11",0,0,85,0,0,88,0,0
"Saudi Arabia","2024-07-12",0,0,85,0,0,88,0,0
"Saudi Arabia","2024-07-13",0,0,85,0,1,89,0,0
"Saudi Arabia","2024-07-14",0,0,85,0,0,89,0,0
"Saudi Arabia","2024-07-15",0,0,85,0,0,89,0,0
"Saudi Arabia","2024-07-16",0,0,85,0,1,90,0,0
"Saudi Arabia","2024-07-17",0,0,85,0,0,90,0,0
"Saudi Arabia","2024-07-18",0,0,85,0,0,90,0,0
"Saudi Arabia","2024-07-19",0,0,85,0,1,91,0,0
"Saudi Arabia","2024-07-20",0,0,85,0,0,91,0,0
"Saudi Arabia","2024-07-21",0,0,85,0,0,91,0,0
"Saudi Arabia","2024-07-22",0,0,85,0,0,91,0,0
"Saudi Arabia","2024-07-23",0,0,85,0,1,92,0,0
"Saudi Arabia","2024-07-24",0,0,85,0,0,92,0,0
"Saudi Arabia","2024-07-25",0,0,85,0,0,92,0,0
"Saudi Arabia","2024-07-26",0,0,85,0,1,93,0,0
"Saudi Arabia","2024-07-27",0,0,85,0,0,93,0,0
"Saudi Arabia","2024-07-28",0,0,85,0,0,93,0,0
"Saudi Arabia","2024-07-29",0,0,85,0,0,93,0,0
"Saudi Arabia","2024-07-30",0,0,85,0,1,94,0,0
"Saudi Arabia","2024-07-31",0,9,94,0,0,94,0,0
"Saudi Arabia","2024-08-01",0,0,94,0,0,94,0,0
"Saudi Arabia","2024-08-02",0,0,94,0,0,94,0,0
"Saudi Arabia","2024-08-03",0,0,94,0,0,94,0,0
"Saudi Arabia","2024-08-04",0,0,94,0,0,94,0,0
"Saudi Arabia","2024-08-05",0,0,94,0,0,94,0,0
"Saudi Arabia","2024-08-06",0,0,94,0,0,94,0,0
"Saudi Arabia","2024-08-07",0,0,94,0,0,94,0,0
"Saudi Arabia","2024-08-08",0,0,94,0,0,94,0,0
"Saudi Arabia","2024-08-09",0,0,94,0,0,94,0,0
"Saudi Arabia","2024-08-10",0,0,94,0,0,94,0,0
"Saudi Arabia","2024-08-11",0,0,94,0,1,95,0,0
"Saudi Arabia","2024-08-12",0,0,94,0,0,95,0,0
"Saudi Arabia","2024-08-13",0,0,94,0,0,95,0,0
"Saudi Arabia","2024-08-14",0,0,94,0,0,95,0,0
"Saudi Arabia","2024-08-15",0,0,94,0,0,95,0,0
"Saudi Arabia","2024-08-16",0,0,94,0,0,95,0,0
"Saudi Arabia","2024-08-17",0,0,94,0,0,95,0,0
"Saudi Arabia","2024-08-18",0,0,94,0,0,95,0,0
"Saudi Arabia","2024-08-19",0,0,94,0,0,95,0,0
"Saudi Arabia","2024-08-20",0,0,94,0,0,95,0,0
"Saudi Arabia","2024-08-21",0,1,95,0,0,95,0,0
"Saudi Arabia","2024-08-22",0,0,95,0,0,95,0,0
"Saudi Arabia","2024-08-23",0,0,95,0,0,95,0,0
"Saudi Arabia","2024-08-24",0,0,95,0,0,95,0,0
"Saudi Arabia","2024-08-25",0,0,95,0,0,95,0,0
"Saudi Arabia","2024-08-26",0,0,95,0,0,95,0,0
"Saudi Arabia","2024-08-27",0,0,95,0,0,95,0,0
"Saudi Arabia","2024-08-28",0,0,95,0,0,95,0,0
"Saudi Arabia","2024-08-29",0,0,95,0,0,95,0,0
"Saudi Arabia","2024-08-30",0,0,95,0,0,95,0,0
"Saudi Arabia","2024-08-31",0,0,95,0,0,95,0,0
"Saudi Arabia","2024-09-01",0,0,95,0,0,95,0,0
"Saudi Arabia","2024-09-02",0,0,95,0,0,95,0,0
"Saudi Arabia","2024-09-03",0,0,95,0,0,95,0,0
"Saudi Arabia","2024-09-04",0,0,95,0,0,95,0,0
"Saudi Arabia","2024-09-05",0,0,95,0,0,95,0,0
"Saudi Arabia","2024-09-06",0,0,95,0,0,95,0,0
"Saudi Arabia","2024-09-07",0,0,95,0,0,95,0,0
"Saudi Arabia","2024-09-08",0,0,95,0,0,95,0,0
"Saudi Arabia","2024-09-09",0,0,95,0,0,95,0,0
"Saudi Arabia","2024-09-10",0,0,95,0,0,95,0,0
"Saudi Arabia","2024-09-11",0,0,95,0,0,95,0,0
"Saudi Arabia","2024-09-12",0,0,95,0,0,95,0,0
"Saudi Arabia","2024-09-13",0,0,95,0,0,95,0,0
"Saudi Arabia","2024-09-14",0,0,95,0,0,95,0,0
"Saudi Arabia","2024-09-15",0,0,95,0,0,95,0,0
"Saudi Arabia","2024-09-16",0,0,95,0,0,95,0,0
"Saudi Arabia","2024-09-17",0,0,95,0,0,95,0,0
"Saudi Arabia","2024-09-18",0,0,95,0,0,95,0,0
"Saudi Arabia","2024-09-19",0,0,95,0,0,95,0,0
"Saudi Arabia","2024-09-20",0,0,95,0,0,95,0,0
"Saudi Arabia","2024-09-21",0,0,95,0,0,95,0,0
"Saudi Arabia","2024-09-22",0,0,95,0,0,95,0,0
"Saudi Arabia","2024-09-23",0,0,95,0,0,95,0,0
"Saudi Arabia","2024-09-24",0,0,95,0,0,95,0,0
"Saudi Arabia","2024-09-25",0,0,95,0,0,95,0,0
"Saudi Arabia","2024-09-26",0,0,95,0,0,95,0,0
"Saudi Arabia","2024-09-27",0,0,95,0,0,95,0,0
"Saudi Arabia","2024-09-28",0,0,95,0,0,95,0,0
"Saudi Arabia","2024-09-29",0,0,95,0,0,95,0,0
"Saudi Arabia","2024-09-30",0,0,95,0,0,95,0,0
"Saudi Arabia","2024-10-01",0,0,95,0,0,95,0,0
"Saudi Arabia","2024-10-02",0,0,95,0,0,95,0,0
"Saudi Arabia","2024-10-03",0,0,95,0,0,95,0,0
"Saudi Arabia","2024-10-04",0,0,95,0,0,95,0,0
"Saudi Arabia","2024-10-05",0,0,95,0,0,95,0,0
"Saudi Arabia","2024-10-06",0,0,95,0,0,95,0,0
"Saudi Arabia","2024-10-07",0,0,95,0,0,95,0,0
"Saudi Arabia","2024-10-08",0,0,95,0,0,95,0,0
"Saudi Arabia","2024-10-09",0,0,95,0,0,95,0,0
"Saudi Arabia","2024-10-10",0,0,95,0,0,95,0,0
"Saudi Arabia","2024-10-11",0,0,95,0,0,95,0,0
"Saudi Arabia","2024-10-12",0,0,95,0,0,95,0,0
"Saudi Arabia","2024-10-13",0,0,95,0,0,95,0,0
"Saudi Arabia","2024-10-14",0,0,95,0,0,95,0,0
"Saudi Arabia","2024-10-15",0,0,95,0,0,95,0,0
"Saudi Arabia","2024-10-16",0,0,95,0,0,95,0,0
"Saudi Arabia","2024-10-17",0,0,95,0,0,95,0,0
"Saudi Arabia","2024-10-18",0,0,95,0,0,95,0,0
"Saudi Arabia","2024-10-19",0,0,95,0,0,95,0,0
"Saudi Arabia","2024-10-20",0,0,95,0,0,95,0,0
"Saudi Arabia","2024-10-21",0,0,95,0,0,95,0,0
"Saudi Arabia","2024-10-22",0,0,95,0,0,95,0,0
"Saudi Arabia","2024-10-23",0,0,95,0,0,95,0,0
"Saudi Arabia","2024-10-24",0,0,95,0,0,95,0,0
"Saudi Arabia","2024-10-25",0,0,95,0,0,95,0,0
"Saudi Arabia","2024-10-26",0,0,95,0,0,95,0,0
"Saudi Arabia","2024-10-27",0,0,95,0,0,95,0,0
"Saudi Arabia","2024-10-28",0,0,95,0,0,95,0,0
"Saudi Arabia","2024-10-29",0,0,95,0,0,95,0,0
"Saudi Arabia","2024-10-30",0,0,95,0,0,95,0,0
"Saudi Arabia","2024-10-31",0,0,95,0,0,95,0,0
"Saudi Arabia","2024-11-01",0,0,95,0,0,95,0,0
"Saudi Arabia","2024-11-02",0,0,95,0,0,95,0,0
"Saudi Arabia","2024-11-03",0,0,95,0,0,95,0,0
"Saudi Arabia","2024-11-04",0,0,95,0,0,95,0,0
"Saudi Arabia","2024-11-05",0,0,95,0,0,95,0,0
"Saudi Arabia","2024-11-06",0,0,95,0,0,95,0,0
"Saudi Arabia","2024-11-07",0,0,95,0,0,95,0,0
"Saudi Arabia","2024-11-08",0,0,95,0,0,95,0,0
"Saudi Arabia","2024-11-09",0,0,95,0,0,95,0,0
"Saudi Arabia","2024-11-10",0,0,95,0,0,95,0,0
"Saudi Arabia","2024-11-11",0,0,95,0,0,95,0,0
"Saudi Arabia","2024-11-12",0,0,95,0,0,95,0,0
"Saudi Arabia","2024-11-13",0,0,95,0,0,95,0,0
"Saudi Arabia","2024-11-14",0,0,95,0,0,95,0,0
"Saudi Arabia","2024-11-15",0,0,95,0,0,95,0,0
"Saudi Arabia","2024-11-16",0,0,95,0,0,95,0,0
"Saudi Arabia","2024-11-17",0,0,95,0,0,95,0,0
"Saudi Arabia","2024-11-18",0,0,95,0,0,95,0,0
"Saudi Arabia","2024-11-19",0,0,95,0,0,95,0,0
"Saudi Arabia","2024-11-20",0,0,95,0,0,95,0,0
"Saudi Arabia","2024-11-21",0,0,95,0,0,95,0,0
"Saudi Arabia","2024-11-22",0,0,95,0,0,95,0,0
"Saudi Arabia","2024-11-23",0,0,95,0,0,95,0,0
"Saudi Arabia","2024-11-24",0,0,95,0,0,95,0,0
"Saudi Arabia","2024-11-25",0,0,95,0,0,95,0,0
"Saudi Arabia","2024-11-26",0,0,95,0,0,95,0,0
"Saudi Arabia","2024-11-27",0,0,95,0,0,95,0,0
"Saudi Arabia","2024-11-28",0,0,95,0,0,95,0,0
"Saudi Arabia","2024-11-29",0,0,95,0,0,95,0,0
"Saudi Arabia","2024-11-30",0,0,95,0,0,95,0,0
"Saudi Arabia","2024-12-01",0,0,95,0,0,95,0,0
"Saudi Arabia","2024-12-02",0,0,95,0,0,95,0,0
"Saudi Arabia","2024-12-03",0,0,95,0,0,95,0,0
"Saudi Arabia","2024-12-04",0,0,95,0,0,95,0,0
"Saudi Arabia","2024-12-05",0,0,95,0,0,95,0,0
"Saudi Arabia","2024-12-06",0,0,95,0,0,95,0,0
"Saudi Arabia","2024-12-07",0,0,95,0,0,95,0,0
"Saudi Arabia","2024-12-08",0,0,95,0,0,95,0,0
"Saudi Arabia","2024-12-09",0,0,95,0,0,95,0,0
"Saudi Arabia","2024-12-10",0,0,95,0,0,95,0,0
"Saudi Arabia","2024-12-11",0,0,95,0,0,95,0,0
"Saudi Arabia","2024-12-12",0,0,95,0,0,95,0,0
"Saudi Arabia","2024-12-13",0,0,95,0,0,95,0,0
"Saudi Arabia","2024-12-14",0,0,95,0,0,95,0,0
"Saudi Arabia","2024-12-15",0,0,95,0,0,95,0,0
"Saudi Arabia","2024-12-16",0,0,95,0,0,95,0,0
"Saudi Arabia","2024-12-17",0,0,95,0,0,95,0,0
"Saudi Arabia","2024-12-18",0,0,95,0,0,95,0,0
"Saudi Arabia","2024-12-19",0,0,95,0,0,95,0,0
"Saudi Arabia","2024-12-20",0,0,95,0,0,95,0,0
"Saudi Arabia","2024-12-21",0,0,95,0,0,95,0,0
"Saudi Arabia","2024-12-22",0,0,95,0,0,95,0,0
"Saudi Arabia","2024-12-23",0,0,95,0,0,95,0,0
"Saudi Arabia","2024-12-24",0,0,95,0,0,95,0,0
"Saudi Arabia","2024-12-25",0,0,95,0,0,95,0,0
"Saudi Arabia","2024-12-26",0,0,95,0,0,95,0,0
"Saudi Arabia","2024-12-27",0,0,95,0,0,95,0,0
"Saudi Arabia","2024-12-28",0,0,95,0,0,95,0,0
"Saudi Arabia","2024-12-29",0,0,95,0,0,95,0,0
"Saudi Arabia","2024-12-30",0,0,95,0,0,95,0,0
"Saudi Arabia","2024-12-31",0,0,95,0,0,95,0,0
"Saudi Arabia","2025-01-01",0,0,95,0,0,95,0,0
"Saudi Arabia","2025-01-02",0,0,95,0,0,95,0,0
"Saudi Arabia","2025-01-03",0,0,95,0,0,95,0,0
"Saudi Arabia","2025-01-04",0,0,95,0,0,95,0,0
"Saudi Arabia","2025-01-05",0,0,95,0,0,95,0,0
"Saudi Arabia","2025-01-06",0,0,95,0,0,95,0,0
"Saudi Arabia","2025-01-07",0,0,95,0,0,95,0,0
"Saudi Arabia","2025-01-08",0,0,95,0,0,95,0,0
"Saudi Arabia","2025-01-09",0,0,95,0,0,95,0,0
"Saudi Arabia","2025-01-10",0,0,95,0,0,95,0,0
"Saudi Arabia","2025-01-11",0,0,95,0,0,95,0,0
"Saudi Arabia","2025-01-12",0,0,95,0,0,95,0,0
"Saudi Arabia","2025-01-13",0,0,95,0,0,95,0,0
"Saudi Arabia","2025-01-14",0,0,95,0,0,95,0,0
"Saudi Arabia","2025-01-15",0,0,95,0,0,95,0,0
"Saudi Arabia","2025-01-16",0,0,95,0,0,95,0,0
"Saudi Arabia","2025-01-17",0,0,95,0,0,95,0,0
"Saudi Arabia","2025-01-18",0,0,95,0,0,95,0,0
"Saudi Arabia","2025-01-19",0,0,95,0,0,95,0,0
"Saudi Arabia","2025-01-20",0,0,95,0,0,95,0,0
"Saudi Arabia","2025-01-21",0,0,95,0,0,95,0,0
"Saudi Arabia","2025-01-22",0,0,95,0,0,95,0,0
"Saudi Arabia","2025-01-23",0,0,95,0,0,95,0,0
"Saudi Arabia","2025-01-24",0,0,95,0,0,95,0,0
"Saudi Arabia","2025-01-25",0,0,95,0,0,95,0,0
"Saudi Arabia","2025-01-26",0,0,95,0,0,95,0,0
"Saudi Arabia","2025-01-27",0,0,95,0,0,95,0,0
"Saudi Arabia","2025-01-28",0,0,95,0,0,95,0,0
"Saudi Arabia","2025-01-29",0,0,95,0,0,95,0,0
"Saudi Arabia","2025-01-30",0,0,95,0,0,95,0,0
"Saudi Arabia","2025-01-31",0,0,95,0,0,95,0,0
"Saudi Arabia","2025-02-01",0,0,95,0,0,95,0,0
"Saudi Arabia","2025-02-02",0,0,95,0,0,95,0,0
"Saudi Arabia","2025-02-03",0,0,95,0,0,95,0,0
"Serbia","2024-01-01",0,0,0,0,0,0,0,0
"Serbia","2024-01-02",0,0,0,0,0,0,0,0
"Serbia","2024-01-03",0,0,0,0,0,0,0,0
"Serbia","2024-01-04",0,0,0,0,0,0,0,0
"Serbia","2024-01-05",0,0,0,0,0,0,0,0
"Serbia","2024-01-06",0,0,0,0,0,0,0,0
"Serbia","2024-01-07",0,0,0,0,0,0,0,0
"Serbia","2024-01-08",0,0,0,0,0,0,0,0
"Serbia","2024-01-09",0,0,0,0,0,0,0,0
"Serbia","2024-01-10",0,0,0,0,0,0,0,0
"Serbia","2024-01-11",0,0,0,0,0,0,0,0
"Serbia","2024-01-12",0,0,0,0,0,0,0,0
"Serbia","2024-01-13",0,0,0,0,0,0,0,0
"Serbia","2024-01-14",0,0,0,0,0,0,0,0
"Serbia","2024-01-15",0,0,0,0,0,0,0,0
"Serbia","2024-01-16",0,0,0,0,0,0,0,0
"Serbia","2024-01-17",0,0,0,0,0,0,0,0
"Serbia","2024-01-18",0,0,0,0,0,0,0,0
"Serbia","2024-01-19",0,0,0,0,0,0,0,0
"Serbia","2024-01-20",0,0,0,0,0,0,0,0
"Serbia","2024-01-21",0,0,0,0,0,0,0,0
"Serbia","2024-01-22",0,0,0,0,0,0,0,0
"Serbia","2024-01-23",0,0,0,0,0,0,0,0
"Serbia","2024-01-24",0,0,0,0,0,0,0,0
"Serbia","2024-01-25",0,0,0,0,0,0,0,0
"Serbia","2024-01-26",0,0,0,0,0,0,0,0
"Serbia","2024-01-27",0,0,0,0,0,0,0,0
"Serbia","2024-01-28",0,0,0,0,0,0,0,0
"Serbia","2024-01-29",0,0,0,0,0,0,0,0
"Serbia","2024-01-30",0,0,0,0,0,0,0,0
"Serbia","2024-01-31",0,0,0,0,0,0,0,0
"Serbia","2024-02-01",0,0,0,0,0,0,0,0
"Serbia","2024-02-02",0,0,0,0,0,0,0,0
"Serbia","2024-02-03",0,0,0,0,0,0,0,0
"Serbia","2024-02-04",0,0,0,0,0,0,0,0
"Serbia","2024-02-05",0,0,0,0,0,0,0,0
"Serbia","2024-02-06",0,0,0,0,0,0,0,0
"Serbia","2024-02-07",0,0,0,0,0,0,0,0
"Serbia","2024-02-08",0,0,0,0,0,0,0,0
"Serbia","2024-02-09",0,0,0,0,0,0,0,0
"Serbia","2024-02-10",0,0,0,0,0,0,0,0
"Serbia","2024-02-11",0,0,0,0,0,0,0,0
"Serbia","2024-02-12",0,0,0,0,0,0,0,0
"Serbia","2024-02-13",0,0,0,0,0,0,0,0
"Serbia","2024-02-14",0,0,0,0,0,0,0,0
"Serbia","2024-02-15",0,0,0,0,0,0,0,0
"Serbia","2024-02-16",0,0,0,0,0,0,0,0
"Serbia","2024-02-17",0,0,0,0,0,0,0,0
"Serbia","2024-02-18",0,0,0,0,0,0,0,0
"Serbia","2024-02-19",0,0,0,0,0,0,0,0
"Serbia","2024-02-20",0,0,0,0,0,0,0,0
"Serbia","2024-02-21",0,0,0,0,0,0,0,0
"Serbia","2024-02-22",0,0,0,0,0,0,0,0
"Serbia","2024-02-23",0,0,0,0,0,0,0,0
"Serbia","2024-02-24",0,0,0,0,0,0,0,0
"Serbia","2024-02-25",0,0,0,0,0,0,0,0
"Serbia","2024-02-26",0,0,0,0,0,0,0,0
"Serbia","2024-02-27",0,0,0,0,0,0,0,0
"Serbia","2024-02-28",0,0,0,0,0,0,0,0
"Serbia","2024-02-29",0,0,0,0,0,0,0,0
"Serbia","2024-03-01",0,0,0,0,0,0,0,0
"Serbia","2024-03-02",0,0,0,0,0,0,0,0
"Serbia","2024-03-03",0,0,0,0,0,0,0,0
"Serbia","2024-03-04",0,0,0,0,0,0,0,0
"Serbia","2024-03-05",0,0,0,0,0,0,0,0
"Serbia","2024-03-06",0,0,0,0,0,0,0,0
"Serbia","2024-03-07",0,0,0,0,0,0,0,0
"Serbia","2024-03-08",0,0,0,0,0,0,0,0
"Serbia","2024-03-09",0,0,0,0,0,0,0,0
"Serbia","2024-03-10",0,0,0,0,0,0,0,0
"Serbia","2024-03-11",0,0,0,0,0,0,0,0
"Serbia","2024-03-12",0,0,0,0,0,0,0,0
"Serbia","2024-03-13",0,0,0,0,0,0,0,0
"Serbia","2024-03-14",0,0,0,0,0,0,0,0
"Serbia","2024-03-15",0,0,0,0,0,0,0,0
"Serbia","2024-03-16",0,0,0,0,0,0,0,0
"Serbia","2024-03-17",0,0,0,0,0,0,0,0
"Serbia","2024-03-18",0,0,0,0,0,0,0,0
"Serbia","2024-03-19",0,0,0,0,0,0,0,0
"Serbia","2024-03-20",0,0,0,0,0,0,0,0
"Serbia","2024-03-21",0,0,0,0,0,0,0,0
"Serbia","2024-03-22",0,0,0,0,0,0,0,0
"Serbia","2024-03-23",0,0,0,0,0,0,0,0
"Serbia","2024-03-24",0,0,0,0,0,0,0,0
"Serbia","2024-03-25",0,0,0,0,0,0,0,0
"Serbia","2024-03-26",0,0,0,0,0,0,0,0
"Serbia","2024-03-27",0,0,0,0,0,0,0,0
"Serbia","2024-03-28",0,0,0,0,0,0,0,0
"Serbia","2024-03-29",0,0,0,0,0,0,0,0
"Serbia","2024-03-30",0,0,0,0,0,0,0,0
"Serbia","2024-03-31",0,0,0,0,0,0,0,0
"Serbia","2024-04-01",0,0,0,0,0,0,0,0
"Serbia","2024-04-02",0,0,0,0,0,0,0,0
"Serbia","2024-04-03",0,0,0,0,0,0,0,0
"Serbia","2024-04-04",0,0,0,0,0,0,0,0
"Serbia","2024-04-05",0,0,0,0,0,0,0,0
"Serbia","2024-04-06",0,0,0,0,0,0,0,0
"Serbia","2024-04-07",0,0,0,0,0,0,0,0
"Serbia","2024-04-08",0,0,0,0,0,0,0,0
"Serbia","2024-04-09",0,0,0,0,0,0,0,0
"Serbia","2024-04-10",0,0,0,0,0,0,0,0
"Serbia","2024-04-11",0,0,0,0,0,0,0,0
"Serbia","2024-04-12",0,0,0,0,0,0,0,0
"Serbia","2024-04-13",0,0,0,0,0,0,0,0
"Serbia","2024-04-14",0,0,0,0,0,0,0,0
"Serbia","2024-04-15",0,0,0,0,0,0,0,0
"Serbia","2024-04-16",0,0,0,0,0,0,0,0
"Serbia","2024-04-17",0,0,0,0,0,0,0,0
"Serbia","2024-04-18",0,0,0,0,0,0,0,0
"Serbia","2024-04-19",0,0,0,0,0,0,0,0
"Serbia","2024-04-20",0,0,0,0,0,0,0,0
"Serbia","2024-04-21",0,0,0,0,0,0,0,0
"Serbia","2024-04-22",0,0,0,0,0,0,0,0
"Serbia","2024-04-23",0,0,0,0,0,0,0,0
"Serbia","2024-04-24",0,0,0,0,0,0,0,0
"Serbia","2024-04-25",0,0,0,0,0,0,0,0
"Serbia","2024-04-26",0,0,0,0,0,0,0,0
"Serbia","2024-04-27",0,0,0,0,0,0,0,0
"Serbia","2024-04-28",0,0,0,0,0,0,0,0
"Serbia","2024-04-29",0,0,0,0,0,0,0,0
"Serbia","2024-04-30",0,0,0,0,0,0,0,0
"Serbia","2024-05-01",0,0,0,0,0,0,0,0
"Serbia","2024-05-02",0,0,0,0,0,0,0,0
"Serbia","2024-05-03",0,0,0,0,0,0,0,0
"Serbia","2024-05-04",0,0,0,0,0,0,0,0
"Serbia","2024-05-05",0,0,0,0,0,0,0,0
"Serbia","2024-05-06",0,0,0,0,0,0,0,0
"Serbia","2024-05-07",0,0,0,0,0,0,0,0
"Serbia","2024-05-08",0,0,0,0,0,0,0,0
"Serbia","2024-05-09",0,0,0,0,0,0,0,0
"Serbia","2024-05-10",0,0,0,0,0,0,0,0
"Serbia","2024-05-11",0,0,0,0,0,0,0,0
"Serbia","2024-05-12",0,0,0,0,0,0,0,0
"Serbia","2024-05-13",0,0,0,0,0,0,0,0
"Serbia","2024-05-14",0,0,0,0,0,0,0,0
"Serbia","2024-05-15",0,0,0,0,0,0,0,0
"Serbia","2024-05-16",0,0,0,0,0,0,0,0
"Serbia","2024-05-17",0,0,0,0,0,0,0,0
"Serbia","2024-05-18",0,0,0,0,0,0,0,0
"Serbia","2024-05-19",0,0,0,0,0,0,0,0
"Serbia","2024-05-20",0,0,0,0,0,0,0,0
"Serbia","2024-05-21",0,0,0,0,0,0,0,0
"Serbia","2024-05-22",0,0,0,0,0,0,0,0
"Serbia","2024-05-23",0,0,0,0,0,0,0,0
"Serbia","2024-05-24",0,0,0,0,0,0,0,0
"Serbia","2024-05-25",0,0,0,0,0,0,0,0
"Serbia","2024-05-26",0,0,0,0,0,0,0,0
"Serbia","2024-05-27",0,0,0,0,0,0,0,0
"Serbia","2024-05-28",0,0,0,0,0,0,0,0
"Serbia","2024-05-29",0,0,0,0,0,0,0,0
"Serbia","2024-05-30",0,0,0,0,0,0,0,0
"Serbia","2024-05-31",0,0,0,0,0,0,0,0
"Serbia","2024-06-01",0,0,0,0,0,0,0,0
"Serbia","2024-06-02",0,0,0,0,0,0,0,0
"Serbia","2024-06-03",0,0,0,0,0,0,0,0
"Serbia","2024-06-04",0,0,0,0,0,0,0,0
"Serbia","2024-06-05",0,0,0,0,0,0,0,0
"Serbia","2024-06-06",0,0,0,0,0,0,0,0
"Serbia","2024-06-07",0,0,0,0,0,0,0,0
"Serbia","2024-06-08",0,0,0,0,0,0,0,0
"Serbia","2024-06-09",0,0,0,0,0,0,0,0
"Serbia","2024-06-10",0,0,0,0,0,0,0,0
"Serbia","2024-06-11",0,0,0,0,0,0,0,0
"Serbia","2024-06-12",0,0,0,0,0,0,0,0
"Serbia","2024-06-13",0,0,0,0,0,0,0,0
"Serbia","2024-06-14",0,0,0,0,0,0,0,0
"Serbia","2024-06-15",0,0,0,0,0,0,0,0
"Serbia","2024-06-16",0,0,0,0,0,0,0,0
"Serbia","2024-06-17",0,0,0,0,0,0,0,0
"Serbia","2024-06-18",0,0,0,0,0,0,0,0
"Serbia","2024-06-19",0,0,0,0,0,0,0,0
"Serbia","2024-06-20",0,0,0,0,0,0,0,0
"Serbia","2024-06-21",0,0,0,0,0,0,0,0
"Serbia","2024-06-22",0,0,0,0,0,0,0,0
"Serbia","2024-06-23",0,0,0,0,0,0,0,0
"Serbia","2024-06-24",0,0,0,0,0,0,0,0
"Serbia","2024-06-25",0,0,0,0,0,0,0,0
"Serbia","2024-06-26",0,0,0,0,0,0,0,0
"Serbia","2024-06-27",0,0,0,0,0,0,0,0
"Serbia","2024-06-28",0,0,0,0,0,0,0,0
"Serbia","2024-06-29",0,0,0,0,0,0,0,0
"Serbia","2024-06-30",0,0,0,0,0,0,0,0
"Serbia","2024-07-01",0,0,0,0,0,0,0,0
"Serbia","2024-07-02",0,0,0,0,0,0,0,0
"Serbia","2024-07-03",0,0,0,0,0,0,0,0
"Serbia","2024-07-04",0,0,0,0,0,0,0,0
"Serbia","2024-07-05",0,0,0,0,0,0,0,0
"Serbia","2024-07-06",0,0,0,0,0,0,0,0
"Serbia","2024-07-07",0,0,0,0,0,0,0,0
"Serbia","2024-07-08",0,0,0,0,0,0,0,0
"Serbia","2024-07-09",0,0,0,0,0,0,0,0
"Serbia","2024-07-10",0,0,0,0,0,0,0,0
"Serbia","2024-07-11",0,0,0,0,0,0,0,0
"Serbia","2024-07-12",0,0,0,0,0,0,0,0
"Serbia","2024-07-13",0,0,0,0,0,0,0,0
"Serbia","2024-07-14",0,0,0,0,0,0,0,0
"Serbia","2024-07-15",0,0,0,0,0,0,0,0
"Serbia","2024-07-16",0,0,0,0,0,0,0,0
"Serbia","2024-07-17",0,0,0,0,0,0,0,0
"Serbia","2024-07-18",0,0,0,0,0,0,0,0
"Serbia","2024-07-19",0,0,0,0,0,0,0,0
"Serbia","2024-07-20",0,0,0,0,0,0,0,0
"Serbia","2024-07-21",0,0,0,0,0,0,0,0
"Serbia","2024-07-22",0,0,0,0,0,0,0,0
"Serbia","2024-07-23",0,0,0,0,0,0,0,0
"Serbia","2024-07-24",0,0,0,0,0,0,0,0
"Serbia","2024-07-25",0,0,0,0,0,0,0,0
"Serbia","2024-07-26",0,0,0,0,0,0,0,0
"Serbia","2024-07-27",0,0,0,0,0,0,0,0
"Serbia","2024-07-28",0,0,0,0,0,0,0,0
"Serbia","2024-07-29",0,0,0,0,0,0,0,0
"Serbia","2024-07-30",0,0,0,0,0,0,0,0
"Serbia","2024-07-31",0,0,0,0,0,0,0,0
"Serbia","2024-08-01",0,0,0,0,0,0,0,0
"Serbia","2024-08-02",0,0,0,0,0,0,0,0
"Serbia","2024-08-03",0,0,0,0,0,0,0,0
"Serbia","2024-08-04",0,0,0,0,0,0,0,0
"Serbia","2024-08-05",0,0,0,0,0,0,0,0
"Serbia","2024-08-06",0,0,0,0,0,0,0,0
"Serbia","2024-08-07",0,0,0,0,0,0,0,0
"Serbia","2024-08-08",0,0,0,0,0,0,0,0
"Serbia","2024-08-09",0,0,0,0,0,0,0,0
"Serbia","2024-08-10",0,0,0,0,0,0,0,0
"Serbia","2024-08-11",0,0,0,0,0,0,0,0
"Serbia","2024-08-12",0,0,0,0,0,0,0,0
"Serbia","2024-08-13",0,0,0,0,0,0,0,0
"Serbia","2024-08-14",0,0,0,0,0,0,0,0
"Serbia","2024-08-15",0,0,0,0,0,0,0,0
"Serbia","2024-08-16",0,0,0,0,0,0,0,0
"Serbia","2024-08-17",0,0,0,0,0,0,0,0
"Serbia","2024-08-18",0,0,0,0,0,0,0,0
"Serbia","2024-08-19",0,0,0,0,0,0,0,0
"Serbia","2024-08-20",0,0,0,0,0,0,0,0
"Serbia","2024-08-21",0,0,0,0,0,0,0,0
"Serbia","2024-08-22",0,0,0,0,0,0,0,0
"Serbia","2024-08-23",0,0,0,0,0,0,0,0
"Serbia","2024-08-24",0,0,0,0,0,0,0,0
"Serbia","2024-08-25",0,0,0,0,0,0,0,0
"Serbia","2024-08-26",0,0,0,0,0,0,0,0
"Serbia","2024-08-27",0,0,0,0,0,0,0,0
"Serbia","2024-08-28",0,0,0,0,0,0,0,0
"Serbia","2024-08-29",0,0,0,0,0,0,0,0
"Serbia","2024-08-30",0,0,0,0,0,0,0,0
"Serbia","2024-08-31",0,0,0,0,0,0,0,0
"Serbia","2024-09-01",0,0,0,0,0,0,0,0
"Serbia","2024-09-02",0,0,0,0,0,0,0,0
"Serbia","2024-09-03",0,0,0,0,0,0,0,0
"Serbia","2024-09-04",0,0,0,0,0,0,0,0
"Serbia","2024-09-05",0,0,0,0,0,0,0,0
"Serbia","2024-09-06",0,0,0,0,0,0,0,0
"Serbia","2024-09-07",0,0,0,0,0,0,0,0
"Serbia","2024-09-08",0,0,0,0,0,0,0,0
"Serbia","2024-09-09",0,0,0,0,0,0,0,0
"Serbia","2024-09-10",0,0,0,0,0,0,0,0
"Serbia","2024-09-11",0,0,0,0,0,0,0,0
"Serbia","2024-09-12",0,0,0,0,0,0,0,0
"Serbia","2024-09-13",0,0,0,0,0,0,0,0
"Serbia","2024-09-14",0,0,0,0,0,0,0,0
"Serbia","2024-09-15",0,0,0,0,0,0,0,0
"Serbia","2024-09-16",0,0,0,0,0,0,0,0
"Serbia","2024-09-17",0,0,0,0,0,0,0,0
"Serbia","2024-09-18",0,0,0,0,0,0,0,0
"Serbia","2024-09-19",0,0,0,0,0,0,0,0
"Serbia","2024-09-20",0,0,0,0,0,0,0,0
"Serbia","2024-09-21",0,0,0,0,0,0,0,0
"Serbia","2024-09-22",0,0,0,0,0,0,0,0
"Serbia","2024-09-23",0,0,0,0,0,0,0,0
"Serbia","2024-09-24",0,0,0,0,0,0,0,0
"Serbia","2024-09-25",0,0,0,0,0,0,0,0
"Serbia","2024-09-26",0,0,0,0,0,0,0,0
"Serbia","2024-09-27",0,0,0,0,0,0,0,0
"Serbia","2024-09-28",0,0,0,0,0,0,0,0
"Serbia","2024-09-29",0,0,0,0,0,0,0,0
"Serbia","2024-09-30",0,0,0,0,0,0,0,0
"Serbia","2024-10-01",0,0,0,0,0,0,0,0
"Serbia","2024-10-02",0,0,0,0,0,0,0,0
"Serbia","2024-10-03",0,0,0,0,0,0,0,0
"Serbia","2024-10-04",0,0,0,0,0,0,0,0
"Serbia","2024-10-05",0,0,0,0,0,0,0,0
"Serbia","2024-10-06",0,0,0,0,0,0,0,0
"Serbia","2024-10-07",0,0,0,0,0,0,0,0
"Serbia","2024-10-08",0,0,0,0,0,0,0,0
"Serbia","2024-10-09",0,0,0,0,0,0,0,0
"Serbia","2024-10-10",0,0,0,0,0,0,0,0
"Serbia","2024-10-11",0,0,0,0,0,0,0,0
"Serbia","2024-10-12",0,0,0,0,0,0,0,0
"Serbia","2024-10-13",0,0,0,0,0,0,0,0
"Serbia","2024-10-14",0,0,0,0,0,0,0,0
"Serbia","2024-10-15",0,0,0,0,0,0,0,0
"Serbia","2024-10-16",0,0,0,0,0,0,0,0
"Serbia","2024-10-17",0,0,0,0,0,0,0,0
"Serbia","2024-10-18",0,0,0,0,0,0,0,0
"Serbia","2024-10-19",0,0,0,0,0,0,0,0
"Serbia","2024-10-20",0,0,0,0,0,0,0,0
"Serbia","2024-10-21",0,0,0,0,0,0,0,0
"Serbia","2024-10-22",0,0,0,0,0,0,0,0
"Serbia","2024-10-23",0,0,0,0,0,0,0,0
"Serbia","2024-10-24",0,0,0,0,0,0,0,0
"Serbia","2024-10-25",0,0,0,0,0,0,0,0
"Serbia","2024-10-26",0,0,0,0,0,0,0,0
"Serbia","2024-10-27",0,0,0,0,0,0,0,0
"Serbia","2024-10-28",0,0,0,0,0,0,0,0
"Serbia","2024-10-29",0,0,0,0,0,0,0,0
"Serbia","2024-10-30",0,0,0,0,0,0,0,0
"Serbia","2024-10-31",0,0,0,0,0,0,0,0
"Serbia","2024-11-01",0,0,0,0,0,0,0,0
"Serbia","2024-11-02",0,0,0,0,0,0,0,0
"Serbia","2024-11-03",0,0,0,0,0,0,0,0
"Serbia","2024-11-04",0,0,0,0,0,0,0,0
"Serbia","2024-11-05",0,0,0,0,0,0,0,0
"Serbia","2024-11-06",0,0,0,0,0,0,0,0
"Serbia","2024-11-07",0,0,0,0,0,0,0,0
"Serbia","2024-11-08",0,0,0,0,0,0,0,0
"Serbia","2024-11-09",0,0,0,0,0,0,0,0
"Serbia","2024-11-10",0,0,0,0,0,0,0,0
"Serbia","2024-11-11",0,0,0,0,0,0,0,0
"Serbia","2024-11-12",0,0,0,0,0,0,0,0
"Serbia","2024-11-13",0,0,0,0,0,0,0,0
"Serbia","2024-11-14",0,0,0,0,0,0,0,0
"Serbia","2024-11-15",0,0,0,0,0,0,0,0
"Serbia","2024-11-16",0,0,0,0,0,0,0,0
"Serbia","2024-11-17",0,0,0,0,0,0,0,0
"Serbia","2024-11-18",0,0,0,0,0,0,0,0
"Serbia","2024-11-19",0,0,0,0,0,0,0,0
"Serbia","2024-11-20",0,0,0,0,0,0,0,0
"Serbia","2024-11-21",0,0,0,0,0,0,0,0
"Serbia","2024-11-22",0,0,0,0,0,0,0,0
"Serbia","2024-11-23",0,0,0,0,0,0,0,0
"Serbia","2024-11-24",0,0,0,0,0,0,0,0
"Serbia","2024-11-25",0,0,0,0,0,0,0,0
"Serbia","2024-11-26",0,0,0,0,0,0,0,0
"Serbia","2024-11-27",0,0,0,0,0,0,0,0
"Serbia","2024-11-28",0,0,0,0,0,0,0,0
"Serbia","2024-11-29",0,0,0,0,0,0,0,0
"Serbia","2024-11-30",0,0,0,0,0,0,0,0
"Serbia","2024-12-01",0,0,0,0,0,0,0,0
"Serbia","2024-12-02",0,0,0,0,0,0,0,0
"Serbia","2024-12-03",0,0,0,0,0,0,0,0
"Serbia","2024-12-04",0,0,0,0,0,0,0,0
"Serbia","2024-12-05",0,0,0,0,0,0,0,0
"Serbia","2024-12-06",0,0,0,0,0,0,0,0
"Serbia","2024-12-07",0,0,0,0,0,0,0,0
"Serbia","2024-12-08",0,0,0,0,0,0,0,0
"Serbia","2024-12-09",0,0,0,0,0,0,0,0
"Serbia","2024-12-10",0,0,0,0,0,0,0,0
"Serbia","2024-12-11",0,0,0,0,0,0,0,0
"Serbia","2024-12-12",0,0,0,0,0,0,0,0
"Serbia","2024-12-13",0,0,0,0,0,0,0,0
"Serbia","2024-12-14",0,0,0,0,0,0,0,0
"Serbia","2024-12-15",0,0,0,0,0,0,0,0
"Serbia","2024-12-16",0,0,0,0,0,0,0,0
"Serbia","2024-12-17",0,0,0,0,0,0,0,0
"Serbia","2024-12-18",0,0,0,0,0,0,0,0
"Serbia","2024-12-19",0,0,0,0,0,0,0,0
"Serbia","2024-12-20",0,0,0,0,0,0,0,0
"Serbia","2024-12-21",0,0,0,0,0,0,0,0
"Serbia","2024-12-22",0,0,0,0,0,0,0,0
"Serbia","2024-12-23",0,0,0,0,0,0,0,0
"Serbia","2024-12-24",0,0,0,0,0,0,0,0
"Serbia","2024-12-25",0,0,0,0,0,0,0,0
"Serbia","2024-12-26",0,0,0,0,0,0,0,0
"Serbia","2024-12-27",0,0,0,0,0,0,0,0
"Serbia","2024-12-28",0,0,0,0,0,0,0,0
"Serbia","2024-12-29",0,0,0,0,0,0,0,0
"Serbia","2024-12-30",0,0,0,0,0,0,0,0
"Serbia","2024-12-31",0,0,0,0,0,0,0,0
"Serbia","2025-01-01",0,0,0,0,0,0,0,0
"Serbia","2025-01-02",0,0,0,0,0,0,0,0
"Serbia","2025-01-03",0,0,0,0,0,0,0,0
"Serbia","2025-01-04",0,0,0,0,0,0,0,0
"Serbia","2025-01-05",0,0,0,0,0,0,0,0
"Serbia","2025-01-06",0,0,0,0,0,0,0,0
"Serbia","2025-01-07",0,0,0,0,0,0,0,0
"Serbia","2025-01-08",0,0,0,0,0,0,0,0
"Serbia","2025-01-09",0,0,0,0,0,0,0,0
"Serbia","2025-01-10",0,0,0,0,0,0,0,0
"Serbia","2025-01-11",0,0,0,0,0,0,0,0
"Serbia","2025-01-12",0,0,0,0,0,0,0,0
"Serbia","2025-01-13",0,0,0,0,0,0,0,0
"Serbia","2025-01-14",0,0,0,0,0,0,0,0
"Serbia","2025-01-15",0,0,0,0,0,0,0,0
"Serbia","2025-01-16",0,0,0,0,0,0,0,0
"Serbia","2025-01-17",0,0,0,0,0,0,0,0
"Serbia","2025-01-18",0,0,0,0,0,0,0,0
"Serbia","2025-01-19",0,0,0,0,0,0,0,0
"Serbia","2025-01-20",0,0,0,0,0,0,0,0
"Serbia","2025-01-21",0,0,0,0,0,0,0,0
"Serbia","2025-01-22",0,0,0,0,0,0,0,0
"Serbia","2025-01-23",0,0,0,0,0,0,0,0
"Serbia","2025-01-24",0,0,0,0,0,0,0,0
"Serbia","2025-01-25",0,0,0,0,0,0,0,0
"Serbia","2025-01-26",0,0,0,0,0,0,0,0
"Serbia","2025-01-27",0,0,0,0,0,0,0,0
"Serbia","2025-01-28",0,0,0,0,0,0,0,0
"Serbia","2025-01-29",0,0,0,0,0,0,0,0
"Serbia","2025-01-30",0,0,0,0,0,0,0,0
"Serbia","2025-01-31",0,0,0,0,0,0,0,0
"Serbia","2025-02-01",0,0,0,0,0,0,0,0
"Serbia","2025-02-02",0,0,0,0,0,0,0,0
"Serbia","2025-02-03",0,0,0,0,0,0,0,0
"Sierra Leone","2024-01-01",0,0,0,0,0,0,0,0
"Sierra Leone","2024-01-02",0,0,0,0,0,0,0,0
"Sierra Leone","2024-01-03",0,0,0,0,0,0,0,0
"Sierra Leone","2024-01-04",0,0,0,0,0,0,0,0
"Sierra Leone","2024-01-05",0,0,0,0,0,0,0,0
"Sierra Leone","2024-01-06",0,0,0,0,0,0,0,0
"Sierra Leone","2024-01-07",0,0,0,0,0,0,0,0
"Sierra Leone","2024-01-08",0,0,0,0,0,0,0,0
"Sierra Leone","2024-01-09",0,0,0,0,0,0,0,0
"Sierra Leone","2024-01-10",0,0,0,0,0,0,0,0
"Sierra Leone","2024-01-11",0,0,0,0,0,0,0,0
"Sierra Leone","2024-01-12",0,0,0,0,0,0,0,0
"Sierra Leone","2024-01-13",0,0,0,0,0,0,0,0
"Sierra Leone","2024-01-14",0,0,0,0,0,0,0,0
"Sierra Leone","2024-01-15",0,0,0,0,0,0,0,0
"Sierra Leone","2024-01-16",0,0,0,0,0,0,0,0
"Sierra Leone","2024-01-17",0,0,0,0,0,0,0,0
"Sierra Leone","2024-01-18",0,0,0,0,0,0,0,0
"Sierra Leone","2024-01-19",0,0,0,0,0,0,0,0
"Sierra Leone","2024-01-20",0,0,0,0,0,0,0,0
"Sierra Leone","2024-01-21",0,0,0,0,0,0,0,0
"Sierra Leone","2024-01-22",0,0,0,0,0,0,0,0
"Sierra Leone","2024-01-23",0,0,0,0,0,0,0,0
"Sierra Leone","2024-01-24",0,0,0,0,0,0,0,0
"Sierra Leone","2024-01-25",0,0,0,0,0,0,0,0
"Sierra Leone","2024-01-26",0,0,0,0,0,0,0,0
"Sierra Leone","2024-01-27",0,0,0,0,0,0,0,0
"Sierra Leone","2024-01-28",0,0,0,0,0,0,0,0
"Sierra Leone","2024-01-29",0,0,0,0,0,0,0,0
"Sierra Leone","2024-01-30",0,0,0,0,0,0,0,0
"Sierra Leone","2024-01-31",0,0,0,0,0,0,0,0
"Sierra Leone","2024-02-01",0,0,0,0,0,0,0,0
"Sierra Leone","2024-02-02",0,0,0,0,0,0,0,0
"Sierra Leone","2024-02-03",0,0,0,0,0,0,0,0
"Sierra Leone","2024-02-04",0,0,0,0,0,0,0,0
"Sierra Leone","2024-02-05",0,0,0,0,0,0,0,0
"Sierra Leone","2024-02-06",0,0,0,0,0,0,0,0
"Sierra Leone","2024-02-07",0,0,0,0,0,0,0,0
"Sierra Leone","2024-02-08",0,0,0,0,0,0,0,0
"Sierra Leone","2024-02-09",0,0,0,0,0,0,0,0
"Sierra Leone","2024-02-10",0,0,0,0,0,0,0,0
"Sierra Leone","2024-02-11",0,0,0,0,0,0,0,0
"Sierra Leone","2024-02-12",0,0,0,0,0,0,0,0
"Sierra Leone","2024-02-13",0,0,0,0,0,0,0,0
"Sierra Leone","2024-02-14",0,0,0,0,0,0,0,0
"Sierra Leone","2024-02-15",0,0,0,0,0,0,0,0
"Sierra Leone","2024-02-16",0,0,0,0,0,0,0,0
"Sierra Leone","2024-02-17",0,0,0,0,0,0,0,0
"Sierra Leone","2024-02-18",0,0,0,0,0,0,0,0
"Sierra Leone","2024-02-19",0,0,0,0,0,0,0,0
"Sierra Leone","2024-02-20",0,0,0,0,0,0,0,0
"Sierra Leone","2024-02-21",0,0,0,0,0,0,0,0
"Sierra Leone","2024-02-22",0,0,0,0,0,0,0,0
"Sierra Leone","2024-02-23",0,0,0,0,0,0,0,0
"Sierra Leone","2024-02-24",0,0,0,0,0,0,0,0
"Sierra Leone","2024-02-25",0,0,0,0,0,0,0,0
"Sierra Leone","2024-02-26",0,0,0,0,0,0,0,0
"Sierra Leone","2024-02-27",0,0,0,0,0,0,0,0
"Sierra Leone","2024-02-28",0,0,0,0,0,0,0,0
"Sierra Leone","2024-02-29",0,0,0,0,0,0,0,0
"Sierra Leone","2024-03-01",0,0,0,0,0,0,0,0
"Sierra Leone","2024-03-02",0,0,0,0,0,0,0,0
"Sierra Leone","2024-03-03",0,0,0,0,0,0,0,0
"Sierra Leone","2024-03-04",0,0,0,0,0,0,0,0
"Sierra Leone","2024-03-05",0,0,0,0,0,0,0,0
"Sierra Leone","2024-03-06",0,0,0,0,0,0,0,0
"Sierra Leone","2024-03-07",0,0,0,0,0,0,0,0
"Sierra Leone","2024-03-08",0,0,0,0,0,0,0,0
"Sierra Leone","2024-03-09",0,0,0,0,0,0,0,0
"Sierra Leone","2024-03-10",0,0,0,0,0,0,0,0
"Sierra Leone","2024-03-11",0,0,0,0,0,0,0,0
"Sierra Leone","2024-03-12",0,0,0,0,0,0,0,0
"Sierra Leone","2024-03-13",0,0,0,0,0,0,0,0
"Sierra Leone","2024-03-14",0,0,0,0,0,0,0,0
"Sierra Leone","2024-03-15",0,0,0,0,0,0,0,0
"Sierra Leone","2024-03-16",0,0,0,0,0,0,0,0
"Sierra Leone","2024-03-17",0,0,0,0,0,0,0,0
"Sierra Leone","2024-03-18",0,0,0,0,0,0,0,0
"Sierra Leone","2024-03-19",0,0,0,0,0,0,0,0
"Sierra Leone","2024-03-20",0,0,0,0,0,0,0,0
"Sierra Leone","2024-03-21",0,0,0,0,0,0,0,0
"Sierra Leone","2024-03-22",0,0,0,0,0,0,0,0
"Sierra Leone","2024-03-23",0,0,0,0,0,0,0,0
"Sierra Leone","2024-03-24",0,0,0,0,0,0,0,0
"Sierra Leone","2024-03-25",0,0,0,0,0,0,0,0
"Sierra Leone","2024-03-26",0,0,0,0,0,0,0,0
"Sierra Leone","2024-03-27",0,0,0,0,0,0,0,0
"Sierra Leone","2024-03-28",0,0,0,0,0,0,0,0
"Sierra Leone","2024-03-29",0,0,0,0,0,0,0,0
"Sierra Leone","2024-03-30",0,0,0,0,0,0,0,0
"Sierra Leone","2024-03-31",0,0,0,0,0,0,0,0
"Sierra Leone","2024-04-01",0,0,0,0,0,0,0,0
"Sierra Leone","2024-04-02",0,0,0,0,0,0,0,0
"Sierra Leone","2024-04-03",0,0,0,0,0,0,0,0
"Sierra Leone","2024-04-04",0,0,0,0,0,0,0,0
"Sierra Leone","2024-04-05",0,0,0,0,0,0,0,0
"Sierra Leone","2024-04-06",0,0,0,0,0,0,0,0
"Sierra Leone","2024-04-07",0,0,0,0,0,0,0,0
"Sierra Leone","2024-04-08",0,0,0,0,0,0,0,0
"Sierra Leone","2024-04-09",0,0,0,0,0,0,0,0
"Sierra Leone","2024-04-10",0,0,0,0,0,0,0,0
"Sierra Leone","2024-04-11",0,0,0,0,0,0,0,0
"Sierra Leone","2024-04-12",0,0,0,0,0,0,0,0
"Sierra Leone","2024-04-13",0,0,0,0,0,0,0,0
"Sierra Leone","2024-04-14",0,0,0,0,0,0,0,0
"Sierra Leone","2024-04-15",0,0,0,0,0,0,0,0
"Sierra Leone","2024-04-16",0,0,0,0,0,0,0,0
"Sierra Leone","2024-04-17",0,0,0,0,0,0,0,0
"Sierra Leone","2024-04-18",0,0,0,0,0,0,0,0
"Sierra Leone","2024-04-19",0,0,0,0,0,0,0,0
"Sierra Leone","2024-04-20",0,0,0,0,0,0,0,0
"Sierra Leone","2024-04-21",0,0,0,0,0,0,0,0
"Sierra Leone","2024-04-22",0,0,0,0,0,0,0,0
"Sierra Leone","2024-04-23",0,0,0,0,0,0,0,0
"Sierra Leone","2024-04-24",0,0,0,0,0,0,0,0
"Sierra Leone","2024-04-25",0,0,0,0,0,0,0,0
"Sierra Leone","2024-04-26",0,0,0,0,0,0,0,0
"Sierra Leone","2024-04-27",0,0,0,0,0,0,0,0
"Sierra Leone","2024-04-28",0,0,0,0,0,0,0,0
"Sierra Leone","2024-04-29",0,0,0,0,0,0,0,0
"Sierra Leone","2024-04-30",0,0,0,0,0,0,0,0
"Sierra Leone","2024-05-01",0,0,0,0,0,0,0,0
"Sierra Leone","2024-05-02",0,0,0,0,0,0,0,0
"Sierra Leone","2024-05-03",0,0,0,0,0,0,0,0
"Sierra Leone","2024-05-04",0,0,0,0,0,0,0,0
"Sierra Leone","2024-05-05",0,0,0,0,0,0,0,0
"Sierra Leone","2024-05-06",0,0,0,0,0,0,0,0
"Sierra Leone","2024-05-07",0,0,0,0,0,0,0,0
"Sierra Leone","2024-05-08",0,0,0,0,0,0,0,0
"Sierra Leone","2024-05-09",0,0,0,0,0,0,0,0
"Sierra Leone","2024-05-10",0,0,0,0,0,0,0,0
"Sierra Leone","2024-05-11",0,0,0,0,0,0,0,0
"Sierra Leone","2024-05-12",0,0,0,0,0,0,0,0
"Sierra Leone","2024-05-13",0,0,0,0,0,0,0,0
"Sierra Leone","2024-05-14",0,0,0,0,0,0,0,0
"Sierra Leone","2024-05-15",0,0,0,0,0,0,0,0
"Sierra Leone","2024-05-16",0,0,0,0,0,0,0,0
"Sierra Leone","2024-05-17",0,0,0,0,0,0,0,0
"Sierra Leone","2024-05-18",0,0,0,0,0,0,0,0
"Sierra Leone","2024-05-19",0,0,0,0,0,0,0,0
"Sierra Leone","2024-05-20",0,0,0,0,0,0,0,0
"Sierra Leone","2024-05-21",0,0,0,0,0,0,0,0
"Sierra Leone","2024-05-22",0,0,0,0,0,0,0,0
"Sierra Leone","2024-05-23",0,0,0,0,0,0,0,0
"Sierra Leone","2024-05-24",0,0,0,0,0,0,0,0
"Sierra Leone","2024-05-25",0,0,0,0,0,0,0,0
"Sierra Leone","2024-05-26",0,0,0,0,0,0,0,0
"Sierra Leone","2024-05-27",0,0,0,0,0,0,0,0
"Sierra Leone","2024-05-28",0,0,0,0,0,0,0,0
"Sierra Leone","2024-05-29",0,0,0,0,0,0,0,0
"Sierra Leone","2024-05-30",0,0,0,0,0,0,0,0
"Sierra Leone","2024-05-31",0,0,0,0,0,0,0,0
"Sierra Leone","2024-06-01",0,0,0,0,0,0,0,0
"Sierra Leone","2024-06-02",0,0,0,0,0,0,0,0
"Sierra Leone","2024-06-03",0,0,0,0,0,0,0,0
"Sierra Leone","2024-06-04",0,0,0,0,0,0,0,0
"Sierra Leone","2024-06-05",0,0,0,0,0,0,0,0
"Sierra Leone","2024-06-06",0,0,0,0,0,0,0,0
"Sierra Leone","2024-06-07",0,0,0,0,0,0,0,0
"Sierra Leone","2024-06-08",0,0,0,0,0,0,0,0
"Sierra Leone","2024-06-09",0,0,0,0,0,0,0,0
"Sierra Leone","2024-06-10",0,0,0,0,0,0,0,0
"Sierra Leone","2024-06-11",0,0,0,0,0,0,0,0
"Sierra Leone","2024-06-12",0,0,0,0,0,0,0,0
"Sierra Leone","2024-06-13",0,0,0,0,0,0,0,0
"Sierra Leone","2024-06-14",0,0,0,0,0,0,0,0
"Sierra Leone","2024-06-15",0,0,0,0,0,0,0,0
"Sierra Leone","2024-06-16",0,0,0,0,0,0,0,0
"Sierra Leone","2024-06-17",0,0,0,0,0,0,0,0
"Sierra Leone","2024-06-18",0,0,0,0,0,0,0,0
"Sierra Leone","2024-06-19",0,0,0,0,0,0,0,0
"Sierra Leone","2024-06-20",0,0,0,0,0,0,0,0
"Sierra Leone","2024-06-21",0,0,0,0,0,0,0,0
"Sierra Leone","2024-06-22",0,0,0,0,0,0,0,0
"Sierra Leone","2024-06-23",0,0,0,0,0,0,0,0
"Sierra Leone","2024-06-24",0,0,0,0,0,0,0,0
"Sierra Leone","2024-06-25",0,0,0,0,0,0,0,0
"Sierra Leone","2024-06-26",0,0,0,0,0,0,0,0
"Sierra Leone","2024-06-27",0,0,0,0,0,0,0,0
"Sierra Leone","2024-06-28",0,0,0,0,0,0,0,0
"Sierra Leone","2024-06-29",0,0,0,0,0,0,0,0
"Sierra Leone","2024-06-30",0,0,0,0,0,0,0,0
"Sierra Leone","2024-07-01",0,0,0,0,0,0,0,0
"Sierra Leone","2024-07-02",0,0,0,0,0,0,0,0
"Sierra Leone","2024-07-03",0,0,0,0,0,0,0,0
"Sierra Leone","2024-07-04",0,0,0,0,0,0,0,0
"Sierra Leone","2024-07-05",0,0,0,0,0,0,0,0
"Sierra Leone","2024-07-06",0,0,0,0,0,0,0,0
"Sierra Leone","2024-07-07",0,0,0,0,0,0,0,0
"Sierra Leone","2024-07-08",0,0,0,0,0,0,0,0
"Sierra Leone","2024-07-09",0,0,0,0,0,0,0,0
"Sierra Leone","2024-07-10",0,0,0,0,0,0,0,0
"Sierra Leone","2024-07-11",0,0,0,0,0,0,0,0
"Sierra Leone","2024-07-12",0,0,0,0,0,0,0,0
"Sierra Leone","2024-07-13",0,0,0,0,0,0,0,0
"Sierra Leone","2024-07-14",0,0,0,0,0,0,0,0
"Sierra Leone","2024-07-15",0,0,0,0,0,0,0,0
"Sierra Leone","2024-07-16",0,0,0,0,0,0,0,0
"Sierra Leone","2024-07-17",0,0,0,0,0,0,0,0
"Sierra Leone","2024-07-18",0,0,0,0,0,0,0,0
"Sierra Leone","2024-07-19",0,0,0,0,0,0,0,0
"Sierra Leone","2024-07-20",0,0,0,0,0,0,0,0
"Sierra Leone","2024-07-21",0,0,0,0,0,0,0,0
"Sierra Leone","2024-07-22",0,0,0,0,0,0,0,0
"Sierra Leone","2024-07-23",0,0,0,0,0,0,0,0
"Sierra Leone","2024-07-24",0,0,0,0,0,0,0,0
"Sierra Leone","2024-07-25",0,0,0,0,0,0,0,0
"Sierra Leone","2024-07-26",0,0,0,0,0,0,0,0
"Sierra Leone","2024-07-27",0,0,0,0,0,0,0,0
"Sierra Leone","2024-07-28",0,0,0,0,0,0,0,0
"Sierra Leone","2024-07-29",0,0,0,0,0,0,0,0
"Sierra Leone","2024-07-30",0,0,0,0,0,0,0,0
"Sierra Leone","2024-07-31",0,0,0,0,0,0,0,0
"Sierra Leone","2024-08-01",0,0,0,0,0,0,0,0
"Sierra Leone","2024-08-02",0,0,0,0,0,0,0,0
"Sierra Leone","2024-08-03",0,0,0,0,0,0,0,0
"Sierra Leone","2024-08-04",0,0,0,0,0,0,0,0
"Sierra Leone","2024-08-05",0,0,0,0,0,0,0,0
"Sierra Leone","2024-08-06",0,0,0,0,0,0,0,0
"Sierra Leone","2024-08-07",0,0,0,0,0,0,0,0
"Sierra Leone","2024-08-08",0,0,0,0,0,0,0,0
"Sierra Leone","2024-08-09",0,0,0,0,0,0,0,0
"Sierra Leone","2024-08-10",0,0,0,0,0,0,0,0
"Sierra Leone","2024-08-11",0,0,0,0,0,0,0,0
"Sierra Leone","2024-08-12",0,0,0,0,0,0,0,0
"Sierra Leone","2024-08-13",0,0,0,0,0,0,0,0
"Sierra Leone","2024-08-14",0,0,0,0,0,0,0,0
"Sierra Leone","2024-08-15",0,0,0,0,0,0,0,0
"Sierra Leone","2024-08-16",0,0,0,0,0,0,0,0
"Sierra Leone","2024-08-17",0,0,0,0,0,0,0,0
"Sierra Leone","2024-08-18",0,0,0,0,0,0,0,0
"Sierra Leone","2024-08-19",0,0,0,0,0,0,0,0
"Sierra Leone","2024-08-20",0,0,0,0,0,0,0,0
"Sierra Leone","2024-08-21",0,0,0,0,0,0,0,0
"Sierra Leone","2024-08-22",0,0,0,0,0,0,0,0
"Sierra Leone","2024-08-23",0,0,0,0,0,0,0,0
"Sierra Leone","2024-08-24",0,0,0,0,0,0,0,0
"Sierra Leone","2024-08-25",0,0,0,0,0,0,0,0
"Sierra Leone","2024-08-26",0,0,0,0,0,0,0,0
"Sierra Leone","2024-08-27",0,0,0,0,0,0,0,0
"Sierra Leone","2024-08-28",0,0,0,0,0,0,0,0
"Sierra Leone","2024-08-29",0,0,0,0,0,0,0,0
"Sierra Leone","2024-08-30",0,0,0,0,0,0,0,0
"Sierra Leone","2024-08-31",0,0,0,0,0,0,0,0
"Sierra Leone","2024-09-01",0,0,0,0,0,0,0,0
"Sierra Leone","2024-09-02",0,0,0,0,0,0,0,0
"Sierra Leone","2024-09-03",0,0,0,0,0,0,0,0
"Sierra Leone","2024-09-04",0,0,0,0,0,0,0,0
"Sierra Leone","2024-09-05",0,0,0,0,0,0,0,0
"Sierra Leone","2024-09-06",0,0,0,0,0,0,0,0
"Sierra Leone","2024-09-07",0,0,0,0,0,0,0,0
"Sierra Leone","2024-09-08",0,0,0,0,0,0,0,0
"Sierra Leone","2024-09-09",0,0,0,0,0,0,0,0
"Sierra Leone","2024-09-10",0,0,0,0,0,0,0,0
"Sierra Leone","2024-09-11",0,0,0,0,0,0,0,0
"Sierra Leone","2024-09-12",0,0,0,0,0,0,0,0
"Sierra Leone","2024-09-13",0,0,0,0,0,0,0,0
"Sierra Leone","2024-09-14",0,0,0,0,0,0,0,0
"Sierra Leone","2024-09-15",0,0,0,0,0,0,0,0
"Sierra Leone","2024-09-16",0,0,0,0,0,0,0,0
"Sierra Leone","2024-09-17",0,0,0,0,0,0,0,0
"Sierra Leone","2024-09-18",0,0,0,0,0,0,0,0
"Sierra Leone","2024-09-19",0,0,0,0,0,0,0,0
"Sierra Leone","2024-09-20",0,0,0,0,0,0,0,0
"Sierra Leone","2024-09-21",0,0,0,0,0,0,0,0
"Sierra Leone","2024-09-22",0,0,0,0,0,0,0,0
"Sierra Leone","2024-09-23",0,0,0,0,0,0,0,0
"Sierra Leone","2024-09-24",0,0,0,0,0,0,0,0
"Sierra Leone","2024-09-25",0,0,0,0,0,0,0,0
"Sierra Leone","2024-09-26",0,0,0,0,0,0,0,0
"Sierra Leone","2024-09-27",0,0,0,0,0,0,0,0
"Sierra Leone","2024-09-28",0,0,0,0,0,0,0,0
"Sierra Leone","2024-09-29",0,0,0,0,0,0,0,0
"Sierra Leone","2024-09-30",0,0,0,0,0,0,0,0
"Sierra Leone","2024-10-01",0,0,0,0,0,0,0,0
"Sierra Leone","2024-10-02",0,0,0,0,0,0,0,0
"Sierra Leone","2024-10-03",0,0,0,0,0,0,0,0
"Sierra Leone","2024-10-04",0,0,0,0,0,0,0,0
"Sierra Leone","2024-10-05",0,0,0,0,0,0,0,0
"Sierra Leone","2024-10-06",0,0,0,0,0,0,0,0
"Sierra Leone","2024-10-07",0,0,0,0,0,0,0,0
"Sierra Leone","2024-10-08",0,0,0,0,0,0,0,0
"Sierra Leone","2024-10-09",0,0,0,0,0,0,0,0
"Sierra Leone","2024-10-10",0,0,0,0,0,0,0,0
"Sierra Leone","2024-10-11",0,0,0,0,0,0,0,0
"Sierra Leone","2024-10-12",0,0,0,0,0,0,0,0
"Sierra Leone","2024-10-13",0,0,0,0,0,0,0,0
"Sierra Leone","2024-10-14",0,0,0,0,0,0,0,0
"Sierra Leone","2024-10-15",0,0,0,0,0,0,0,0
"Sierra Leone","2024-10-16",0,0,0,0,0,0,0,0
"Sierra Leone","2024-10-17",0,0,0,0,0,0,0,0
"Sierra Leone","2024-10-18",0,0,0,0,0,0,0,0
"Sierra Leone","2024-10-19",0,0,0,0,0,0,0,0
"Sierra Leone","2024-10-20",0,0,0,0,0,0,0,0
"Sierra Leone","2024-10-21",0,0,0,0,0,0,0,0
"Sierra Leone","2024-10-22",0,0,0,0,0,0,0,0
"Sierra Leone","2024-10-23",0,0,0,0,0,0,0,0
"Sierra Leone","2024-10-24",0,0,0,0,0,0,0,0
"Sierra Leone","2024-10-25",0,0,0,0,0,0,0,0
"Sierra Leone","2024-10-26",0,0,0,0,0,0,0,0
"Sierra Leone","2024-10-27",0,0,0,0,0,0,0,0
"Sierra Leone","2024-10-28",0,0,0,0,0,0,0,0
"Sierra Leone","2024-10-29",0,0,0,0,0,0,0,0
"Sierra Leone","2024-10-30",0,0,0,0,0,0,0,0
"Sierra Leone","2024-10-31",0,0,0,0,0,0,0,0
"Sierra Leone","2024-11-01",0,0,0,0,0,0,0,0
"Sierra Leone","2024-11-02",0,0,0,0,0,0,0,0
"Sierra Leone","2024-11-03",0,0,0,0,0,0,0,0
"Sierra Leone","2024-11-04",0,0,0,0,0,0,0,0
"Sierra Leone","2024-11-05",0,0,0,0,0,0,0,0
"Sierra Leone","2024-11-06",0,0,0,0,0,0,0,0
"Sierra Leone","2024-11-07",0,0,0,0,0,0,0,0
"Sierra Leone","2024-11-08",0,0,0,0,0,0,0,0
"Sierra Leone","2024-11-09",0,0,0,0,0,0,0,0
"Sierra Leone","2024-11-10",0,0,0,0,0,0,0,0
"Sierra Leone","2024-11-11",0,0,0,0,0,0,0,0
"Sierra Leone","2024-11-12",0,0,0,0,0,0,0,0
"Sierra Leone","2024-11-13",0,0,0,0,0,0,0,0
"Sierra Leone","2024-11-14",0,0,0,0,0,0,0,0
"Sierra Leone","2024-11-15",0,0,0,0,0,0,0,0
"Sierra Leone","2024-11-16",0,0,0,0,0,0,0,0
"Sierra Leone","2024-11-17",0,0,0,0,0,0,0,0
"Sierra Leone","2024-11-18",0,0,0,0,0,0,0,0
"Sierra Leone","2024-11-19",0,0,0,0,0,0,0,0
"Sierra Leone","2024-11-20",0,0,0,0,0,0,0,0
"Sierra Leone","2024-11-21",0,0,0,0,0,0,0,0
"Sierra Leone","2024-11-22",0,0,0,0,0,0,0,0
"Sierra Leone","2024-11-23",0,0,0,0,0,0,0,0
"Sierra Leone","2024-11-24",0,0,0,0,0,0,0,0
"Sierra Leone","2024-11-25",0,0,0,0,0,0,0,0
"Sierra Leone","2024-11-26",0,0,0,0,0,0,0,0
"Sierra Leone","2024-11-27",0,0,0,0,0,0,0,0
"Sierra Leone","2024-11-28",0,0,0,0,0,0,0,0
"Sierra Leone","2024-11-29",0,0,0,0,0,0,0,0
"Sierra Leone","2024-11-30",0,0,0,0,0,0,0,0
"Sierra Leone","2024-12-01",0,0,0,0,0,0,0,0
"Sierra Leone","2024-12-02",0,0,0,0,0,0,0,0
"Sierra Leone","2024-12-03",0,0,0,0,0,0,0,0
"Sierra Leone","2024-12-04",0,0,0,0,0,0,0,0
"Sierra Leone","2024-12-05",0,0,0,0,0,0,0,0
"Sierra Leone","2024-12-06",0,0,0,0,0,0,0,0
"Sierra Leone","2024-12-07",0,0,0,0,0,0,0,0
"Sierra Leone","2024-12-08",0,0,0,0,0,0,0,0
"Sierra Leone","2024-12-09",0,0,0,0,0,0,0,0
"Sierra Leone","2024-12-10",0,0,0,0,0,0,0,0
"Sierra Leone","2024-12-11",0,0,0,0,0,0,0,0
"Sierra Leone","2024-12-12",0,0,0,0,0,0,0,0
"Sierra Leone","2024-12-13",0,0,0,0,0,0,0,0
"Sierra Leone","2024-12-14",0,0,0,0,0,0,0,0
"Sierra Leone","2024-12-15",0,0,0,0,0,0,0,0
"Sierra Leone","2024-12-16",0,0,0,0,0,0,0,0
"Sierra Leone","2024-12-17",0,0,0,0,0,0,0,0
"Sierra Leone","2024-12-18",0,0,0,0,0,0,0,0
"Sierra Leone","2024-12-19",0,0,0,0,0,0,0,0
"Sierra Leone","2024-12-20",0,0,0,0,0,0,0,0
"Sierra Leone","2024-12-21",0,0,0,0,0,0,0,0
"Sierra Leone","2024-12-22",0,0,0,0,0,0,0,0
"Sierra Leone","2024-12-23",0,0,0,0,0,0,0,0
"Sierra Leone","2024-12-24",0,0,0,0,0,0,0,0
"Sierra Leone","2024-12-25",0,0,0,0,0,0,0,0
"Sierra Leone","2024-12-26",0,0,0,0,0,0,0,0
"Sierra Leone","2024-12-27",0,0,0,0,0,0,0,0
"Sierra Leone","2024-12-28",0,0,0,0,0,0,0,0
"Sierra Leone","2024-12-29",0,0,0,0,0,0,0,0
"Sierra Leone","2024-12-30",0,0,0,0,0,0,0,0
"Sierra Leone","2024-12-31",0,0,0,0,0,0,0,0
"Sierra Leone","2025-01-01",0,0,0,0,0,0,0,0
"Sierra Leone","2025-01-02",0,0,0,0,0,0,0,0
"Sierra Leone","2025-01-03",0,0,0,0,0,0,0,0
"Sierra Leone","2025-01-04",0,0,0,0,0,0,0,0
"Sierra Leone","2025-01-05",0,0,0,0,0,0,0,0
"Sierra Leone","2025-01-06",0,0,0,0,0,0,0,0
"Sierra Leone","2025-01-07",0,0,0,0,0,0,0,0
"Sierra Leone","2025-01-08",0,0,0,0,0,0,0,0
"Sierra Leone","2025-01-09",0,0,0,0,0,0,0,0
"Sierra Leone","2025-01-10",0,0,0,0,0,0,0,0
"Sierra Leone","2025-01-11",0,0,0,0,0,0,0,0
"Sierra Leone","2025-01-12",0,2,2,0,2,2,0,0
"Sierra Leone","2025-01-13",0,0,2,0,1,3,0,0
"Sierra Leone","2025-01-14",0,0,2,0,1,4,0,0
"Sierra Leone","2025-01-15",0,0,2,0,1,5,0,0
"Sierra Leone","2025-01-16",0,0,2,0,0,5,0,0
"Sierra Leone","2025-01-17",0,0,2,0,1,6,0,0
"Sierra Leone","2025-01-18",0,0,2,0,1,7,0,0
"Sierra Leone","2025-01-19",0,6,8,0,1,8,0,0
"Sierra Leone","2025-01-20",0,0,8,0,0,8,0,0
"Sierra Leone","2025-01-21",0,0,8,0,0,8,0,0
"Sierra Leone","2025-01-22",0,0,8,0,0,8,0,0
"Sierra Leone","2025-01-23",0,0,8,0,0,8,0,0
"Sierra Leone","2025-01-24",0,0,8,0,0,8,0,0
"Sierra Leone","2025-01-25",0,0,8,0,0,8,0,0
"Sierra Leone","2025-01-26",0,0,8,0,0,8,0,0
"Sierra Leone","2025-01-27",0,0,8,0,0,8,0,0
"Sierra Leone","2025-01-28",0,0,8,0,0,8,0,0
"Sierra Leone","2025-01-29",0,0,8,0,0,8,0,0
"Sierra Leone","2025-01-30",0,0,8,0,0,8,0,0
"Sierra Leone","2025-01-31",0,0,8,0,0,8,0,0
"Sierra Leone","2025-02-01",0,0,8,0,0,8,0,0
"Sierra Leone","2025-02-02",0,0,8,0,0,8,0,0
"Sierra Leone","2025-02-03",0,0,8,0,0,8,0,0
"Singapore","2024-01-01",0,0,0,0,0,0,0,0
"Singapore","2024-01-02",0,0,0,0,0,0,0,0
"Singapore","2024-01-03",0,0,0,0,0,0,0,0
"Singapore","2024-01-04",0,0,0,0,0,0,0,0
"Singapore","2024-01-05",0,1,1,0,1,1,0,0
"Singapore","2024-01-06",0,0,1,0,0,1,0,0
"Singapore","2024-01-07",0,0,1,0,0,1,0,0
"Singapore","2024-01-08",0,0,1,0,0,1,0,0
"Singapore","2024-01-09",0,0,1,0,0,1,0,0
"Singapore","2024-01-10",0,0,1,0,0,1,0,0
"Singapore","2024-01-11",0,0,1,0,0,1,0,0
"Singapore","2024-01-12",0,0,1,0,0,1,0,0
"Singapore","2024-01-13",0,0,1,0,0,1,0,0
"Singapore","2024-01-14",0,0,1,0,0,1,0,0
"Singapore","2024-01-15",0,0,1,0,0,1,0,0
"Singapore","2024-01-16",0,0,1,0,0,1,0,0
"Singapore","2024-01-17",0,0,1,0,0,1,0,0
"Singapore","2024-01-18",0,0,1,0,0,1,0,0
"Singapore","2024-01-19",0,0,1,0,0,1,0,0
"Singapore","2024-01-20",0,0,1,0,0,1,0,0
"Singapore","2024-01-21",0,0,1,0,0,1,0,0
"Singapore","2024-01-22",0,0,1,0,0,1,0,0
"Singapore","2024-01-23",0,0,1,0,0,1,0,0
"Singapore","2024-01-24",0,0,1,0,0,1,0,0
"Singapore","2024-01-25",0,0,1,0,0,1,0,0
"Singapore","2024-01-26",0,0,1,0,0,1,0,0
"Singapore","2024-01-27",0,0,1,0,1,2,0,0
"Singapore","2024-01-28",0,0,1,0,0,2,0,0
"Singapore","2024-01-29",0,0,1,0,0,2,0,0
"Singapore","2024-01-30",0,0,1,0,0,2,0,0
"Singapore","2024-01-31",0,0,1,0,0,2,0,0
"Singapore","2024-02-01",0,0,1,0,0,2,0,0
"Singapore","2024-02-02",0,0,1,0,0,2,0,0
"Singapore","2024-02-03",0,0,1,0,0,2,0,0
"Singapore","2024-02-04",0,0,1,0,0,2,0,0
"Singapore","2024-02-05",0,0,1,0,0,2,0,0
"Singapore","2024-02-06",0,0,1,0,0,2,0,0
"Singapore","2024-02-07",0,0,1,0,0,2,0,0
"Singapore","2024-02-08",0,0,1,0,0,2,0,0
"Singapore","2024-02-09",0,0,1,0,0,2,0,0
"Singapore","2024-02-10",0,0,1,0,0,2,0,0
"Singapore","2024-02-11",0,0,1,0,0,2,0,0
"Singapore","2024-02-12",0,0,1,0,0,2,0,0
"Singapore","2024-02-13",0,0,1,0,0,2,0,0
"Singapore","2024-02-14",0,0,1,0,0,2,0,0
"Singapore","2024-02-15",0,0,1,0,0,2,0,0
"Singapore","2024-02-16",0,1,2,0,0,2,0,0
"Singapore","2024-02-17",0,0,2,0,0,2,0,0
"Singapore","2024-02-18",0,0,2,0,0,2,0,0
"Singapore","2024-02-19",0,0,2,0,0,2,0,0
"Singapore","2024-02-20",0,0,2,0,0,2,0,0
"Singapore","2024-02-21",0,0,2,0,0,2,0,0
"Singapore","2024-02-22",0,0,2,0,1,3,0,0
"Singapore","2024-02-23",0,0,2,0,0,3,0,0
"Singapore","2024-02-24",0,0,2,0,0,3,0,0
"Singapore","2024-02-25",0,0,2,0,0,3,0,0
"Singapore","2024-02-26",0,0,2,0,0,3,0,0
"Singapore","2024-02-27",0,0,2,0,0,3,0,0
"Singapore","2024-02-28",0,0,2,0,0,3,0,0
"Singapore","2024-02-29",0,0,2,0,0,3,0,0
"Singapore","2024-03-01",0,0,2,0,0,3,0,0
"Singapore","2024-03-02",0,0,2,0,0,3,0,0
"Singapore","2024-03-03",0,0,2,0,1,4,0,0
"Singapore","2024-03-04",0,0,2,0,0,4,0,0
"Singapore","2024-03-05",0,0,2,0,0,4,0,0
"Singapore","2024-03-06",0,0,2,0,0,4,0,0
"Singapore","2024-03-07",0,0,2,0,0,4,0,0
"Singapore","2024-03-08",0,2,4,0,0,4,0,0
"Singapore","2024-03-09",0,0,4,0,0,4,0,0
"Singapore","2024-03-10",0,0,4,0,1,5,0,0
"Singapore","2024-03-11",0,0,4,0,0,5,0,0
"Singapore","2024-03-12",0,0,4,0,0,5,0,0
"Singapore","2024-03-13",0,0,4,0,0,5,0,0
"Singapore","2024-03-14",0,0,4,0,1,6,0,0
"Singapore","2024-03-15",0,2,6,0,0,6,0,0
"Singapore","2024-03-16",0,0,6,0,0,6,0,0
"Singapore","2024-03-17",0,0,6,0,0,6,0,0
"Singapore","2024-03-18",0,0,6,0,0,6,0,0
"Singapore","2024-03-19",0,0,6,0,1,7,0,0
"Singapore","2024-03-20",0,0,6,0,0,7,0,0
"Singapore","2024-03-21",0,0,6,0,0,7,0,0
"Singapore","2024-03-22",0,1,7,0,0,7,0,0
"Singapore","2024-03-23",0,0,7,0,0,7,0,0
"Singapore","2024-03-24",0,0,7,0,0,7,0,0
"Singapore","2024-03-25",0,0,7,0,0,7,0,0
"Singapore","2024-03-26",0,0,7,0,0,7,0,0
"Singapore","2024-03-27",0,0,7,0,0,7,0,0
"Singapore","2024-03-28",0,0,7,0,0,7,0,0
"Singapore","2024-03-29",0,0,7,0,0,7,0,0
"Singapore","2024-03-30",0,0,7,0,1,8,0,0
"Singapore","2024-03-31",0,0,7,0,0,8,0,0
"Singapore","2024-04-01",0,0,7,0,0,8,0,0
"Singapore","2024-04-02",0,0,7,0,0,8,0,0
"Singapore","2024-04-03",0,0,7,0,0,8,0,0
"Singapore","2024-04-04",0,0,7,0,0,8,0,0
"Singapore","2024-04-05",0,1,8,0,0,8,0,0
"Singapore","2024-04-06",0,0,8,0,0,8,0,0
"Singapore","2024-04-07",0,0,8,0,0,8,0,0
"Singapore","2024-04-08",0,0,8,0,0,8,0,0
"Singapore","2024-04-09",0,0,8,0,0,8,0,0
"Singapore","2024-04-10",0,0,8,0,0,8,0,0
"Singapore","2024-04-11",0,0,8,0,0,8,0,0
"Singapore","2024-04-12",0,0,8,0,0,8,0,0
"Singapore","2024-04-13",0,0,8,0,0,8,0,0
"Singapore","2024-04-14",0,0,8,0,0,8,0,0
"Singapore","2024-04-15",0,0,8,0,0,8,0,0
"Singapore","2024-04-16",0,0,8,0,1,9,0,0
"Singapore","2024-04-17",0,0,8,0,0,9,0,0
"Singapore","2024-04-18",0,0,8,0,0,9,0,0
"Singapore","2024-04-19",0,0,8,0,0,9,0,0
"Singapore","2024-04-20",0,0,8,0,0,9,0,0
"Singapore","2024-04-21",0,0,8,0,0,9,0,0
"Singapore","2024-04-22",0,0,8,0,0,9,0,0
"Singapore","2024-04-23",0,0,8,0,0,9,0,0
"Singapore","2024-04-24",0,0,8,0,0,9,0,0
"Singapore","2024-04-25",0,0,8,0,0,9,0,0
"Singapore","2024-04-26",0,1,9,0,0,9,0,0
"Singapore","2024-04-27",0,0,9,0,0,9,0,0
"Singapore","2024-04-28",0,0,9,0,0,9,0,0
"Singapore","2024-04-29",0,0,9,0,0,9,0,0
"Singapore","2024-04-30",0,0,9,0,0,9,0,0
"Singapore","2024-05-01",0,0,9,0,0,9,0,0
"Singapore","2024-05-02",0,0,9,0,0,9,0,0
"Singapore","2024-05-03",0,0,9,0,0,9,0,0
"Singapore","2024-05-04",0,0,9,0,0,9,0,0
"Singapore","2024-05-05",0,0,9,0,0,9,0,0
"Singapore","2024-05-06",0,0,9,0,0,9,0,0
"Singapore","2024-05-07",0,0,9,0,0,9,0,0
"Singapore","2024-05-08",0,0,9,0,0,9,0,0
"Singapore","2024-05-09",0,0,9,0,0,9,0,0
"Singapore","2024-05-10",0,0,9,0,0,9,0,0
"Singapore","2024-05-11",0,0,9,0,0,9,0,0
"Singapore","2024-05-12",0,0,9,0,0,9,0,0
"Singapore","2024-05-13",0,0,9,0,0,9,0,0
"Singapore","2024-05-14",0,0,9,0,0,9,0,0
"Singapore","2024-05-15",0,0,9,0,0,9,0,0
"Singapore","2024-05-16",0,0,9,0,0,9,0,0
"Singapore","2024-05-17",0,0,9,0,0,9,0,0
"Singapore","2024-05-18",0,0,9,0,0,9,0,0
"Singapore","2024-05-19",0,0,9,0,0,9,0,0
"Singapore","2024-05-20",0,0,9,0,0,9,0,0
"Singapore","2024-05-21",0,0,9,0,0,9,0,0
"Singapore","2024-05-22",0,0,9,0,0,9,0,0
"Singapore","2024-05-23",0,0,9,0,0,9,0,0
"Singapore","2024-05-24",0,0,9,0,0,9,0,0
"Singapore","2024-05-25",0,0,9,0,0,9,0,0
"Singapore","2024-05-26",0,0,9,0,0,9,0,0
"Singapore","2024-05-27",0,0,9,0,1,10,0,0
"Singapore","2024-05-28",0,0,9,0,0,10,0,0
"Singapore","2024-05-29",0,0,9,0,0,10,0,0
"Singapore","2024-05-30",0,0,9,0,0,10,0,0
"Singapore","2024-05-31",0,0,9,0,0,10,0,0
"Singapore","2024-06-01",0,0,9,0,0,10,0,0
"Singapore","2024-06-02",0,0,9,0,0,10,0,0
"Singapore","2024-06-03",0,0,9,0,0,10,0,0
"Singapore","2024-06-04",0,0,9,0,0,10,0,0
"Singapore","2024-06-05",0,0,9,0,0,10,0,0
"Singapore","2024-06-06",0,0,9,0,0,10,0,0
"Singapore","2024-06-07",0,0,9,0,0,10,0,0
"Singapore","2024-06-08",0,0,9,0,0,10,0,0
"Singapore","2024-06-09",0,0,9,0,0,10,0,0
"Singapore","2024-06-10",0,0,9,0,0,10,0,0
"Singapore","2024-06-11",0,0,9,0,0,10,0,0
"Singapore","2024-06-12",0,0,9,0,0,10,0,0
"Singapore","2024-06-13",0,0,9,0,0,10,0,0
"Singapore","2024-06-14",0,0,9,0,0,10,0,0
"Singapore","2024-06-15",0,0,9,0,0,10,0,0
"Singapore","2024-06-16",0,0,9,0,0,10,0,0
"Singapore","2024-06-17",0,0,9,0,0,10,0,0
"Singapore","2024-06-18",0,0,9,0,0,10,0,0
"Singapore","2024-06-19",0,0,9,0,0,10,0,0
"Singapore","2024-06-20",0,0,9,0,0,10,0,0
"Singapore","2024-06-21",0,0,9,0,0,10,0,0
"Singapore","2024-06-22",0,0,9,0,0,10,0,0
"Singapore","2024-06-23",0,0,9,0,0,10,0,0
"Singapore","2024-06-24",0,0,9,0,0,10,0,0
"Singapore","2024-06-25",0,1,10,0,0,10,0,0
"Singapore","2024-06-26",0,0,10,0,0,10,0,0
"Singapore","2024-06-27",0,0,10,0,0,10,0,0
"Singapore","2024-06-28",0,0,10,0,0,10,0,0
"Singapore","2024-06-29",0,0,10,0,0,10,0,0
"Singapore","2024-06-30",0,0,10,0,0,10,0,0
"Singapore","2024-07-01",0,0,10,0,0,10,0,0
"Singapore","2024-07-02",0,0,10,0,0,10,0,0
"Singapore","2024-07-03",0,0,10,0,0,10,0,0
"Singapore","2024-07-04",0,0,10,0,0,10,0,0
"Singapore","2024-07-05",0,0,10,0,1,11,0,0
"Singapore","2024-07-06",0,0,10,0,0,11,0,0
"Singapore","2024-07-07",0,0,10,0,0,11,0,0
"Singapore","2024-07-08",0,0,10,0,0,11,0,0
"Singapore","2024-07-09",0,0,10,0,0,11,0,0
"Singapore","2024-07-10",0,0,10,0,0,11,0,0
"Singapore","2024-07-11",0,0,10,0,0,11,0,0
"Singapore","2024-07-12",0,0,10,0,0,11,0,0
"Singapore","2024-07-13",0,1,11,0,0,11,0,0
"Singapore","2024-07-14",0,0,11,0,0,11,0,0
"Singapore","2024-07-15",0,0,11,0,0,11,0,0
"Singapore","2024-07-16",0,0,11,0,0,11,0,0
"Singapore","2024-07-17",0,0,11,0,0,11,0,0
"Singapore","2024-07-18",0,0,11,0,0,11,0,0
"Singapore","2024-07-19",0,0,11,0,0,11,0,0
"Singapore","2024-07-20",0,0,11,0,0,11,0,0
"Singapore","2024-07-21",0,0,11,0,0,11,0,0
"Singapore","2024-07-22",0,0,11,0,1,12,0,0
"Singapore","2024-07-23",0,0,11,0,0,12,0,0
"Singapore","2024-07-24",0,0,11,0,0,12,0,0
"Singapore","2024-07-25",0,0,11,0,0,12,0,0
"Singapore","2024-07-26",0,0,11,0,0,12,0,0
"Singapore","2024-07-27",0,0,11,0,0,12,0,0
"Singapore","2024-07-28",0,0,11,0,0,12,0,0
"Singapore","2024-07-29",0,0,11,0,0,12,0,0
"Singapore","2024-07-30",0,0,11,0,0,12,0,0
"Singapore","2024-07-31",0,0,11,0,0,12,0,0
"Singapore","2024-08-01",0,0,11,0,0,12,0,0
"Singapore","2024-08-02",0,0,11,0,0,12,0,0
"Singapore","2024-08-03",0,0,11,0,0,12,0,0
"Singapore","2024-08-04",0,0,11,0,0,12,0,0
"Singapore","2024-08-05",0,0,11,0,0,12,0,0
"Singapore","2024-08-06",0,0,11,0,0,12,0,0
"Singapore","2024-08-07",0,0,11,0,1,13,0,0
"Singapore","2024-08-08",0,0,11,0,0,13,0,0
"Singapore","2024-08-09",0,0,11,0,0,13,0,0
"Singapore","2024-08-10",0,0,11,0,0,13,0,0
"Singapore","2024-08-11",0,0,11,0,0,13,0,0
"Singapore","2024-08-12",0,0,11,0,0,13,0,0
"Singapore","2024-08-13",0,0,11,0,0,13,0,0
"Singapore","2024-08-14",0,0,11,0,0,13,0,0
"Singapore","2024-08-15",0,2,13,0,0,13,0,0
"Singapore","2024-08-16",0,0,13,0,0,13,0,0
"Singapore","2024-08-17",0,0,13,0,0,13,0,0
"Singapore","2024-08-18",0,0,13,0,0,13,0,0
"Singapore","2024-08-19",0,0,13,0,0,13,0,0
"Singapore","2024-08-20",0,0,13,0,1,14,0,0
"Singapore","2024-08-21",0,0,13,0,0,14,0,0
"Singapore","2024-08-22",0,0,13,0,0,14,0,0
"Singapore","2024-08-23",0,1,14,0,0,14,0,0
"Singapore","2024-08-24",0,0,14,0,0,14,0,0
"Singapore","2024-08-25",0,0,14,0,0,14,0,0
"Singapore","2024-08-26",0,0,14,0,0,14,0,0
"Singapore","2024-08-27",0,0,14,0,0,14,0,0
"Singapore","2024-08-28",0,0,14,0,0,14,0,0
"Singapore","2024-08-29",0,0,14,0,0,14,0,0
"Singapore","2024-08-30",0,0,14,0,0,14,0,0
"Singapore","2024-08-31",0,0,14,0,0,14,0,0
"Singapore","2024-09-01",0,0,14,0,1,15,0,0
"Singapore","2024-09-02",0,0,14,0,0,15,0,0
"Singapore","2024-09-03",0,0,14,0,0,15,0,0
"Singapore","2024-09-04",0,0,14,0,0,15,0,0
"Singapore","2024-09-05",0,0,14,0,0,15,0,0
"Singapore","2024-09-06",0,0,14,0,0,15,0,0
"Singapore","2024-09-07",0,0,14,0,0,15,0,0
"Singapore","2024-09-08",0,1,15,0,0,15,0,0
"Singapore","2024-09-09",0,0,15,0,0,15,0,0
"Singapore","2024-09-10",0,0,15,0,0,15,0,0
"Singapore","2024-09-11",0,0,15,0,0,15,0,0
"Singapore","2024-09-12",0,0,15,0,0,15,0,0
"Singapore","2024-09-13",0,0,15,0,0,15,0,0
"Singapore","2024-09-14",0,0,15,0,0,15,0,0
"Singapore","2024-09-15",0,0,15,0,0,15,0,0
"Singapore","2024-09-16",0,0,15,0,0,15,0,0
"Singapore","2024-09-17",0,0,15,0,1,16,0,0
"Singapore","2024-09-18",0,0,15,0,0,16,0,0
"Singapore","2024-09-19",0,0,15,0,0,16,0,0
"Singapore","2024-09-20",0,0,15,0,0,16,0,0
"Singapore","2024-09-21",0,0,15,0,0,16,0,0
"Singapore","2024-09-22",0,0,15,0,0,16,0,0
"Singapore","2024-09-23",0,0,15,0,0,16,0,0
"Singapore","2024-09-24",0,0,15,0,0,16,0,0
"Singapore","2024-09-25",0,0,15,0,0,16,0,0
"Singapore","2024-09-26",0,0,15,0,0,16,0,0
"Singapore","2024-09-27",0,0,15,0,0,16,0,0
"Singapore","2024-09-28",0,0,15,0,0,16,0,0
"Singapore","2024-09-29",0,0,15,0,0,16,0,0
"Singapore","2024-09-30",0,0,15,0,0,16,0,0
"Singapore","2024-10-01",0,0,15,0,0,16,0,0
"Singapore","2024-10-02",0,0,15,0,0,16,0,0
"Singapore","2024-10-03",0,0,15,0,1,17,0,0
"Singapore","2024-10-04",0,0,15,0,0,17,0,0
"Singapore","2024-10-05",0,0,15,0,0,17,0,0
"Singapore","2024-10-06",0,0,15,0,0,17,0,0
"Singapore","2024-10-07",0,0,15,0,0,17,0,0
"Singapore","2024-10-08",0,0,15,0,0,17,0,0
"Singapore","2024-10-09",0,0,15,0,0,17,0,0
"Singapore","2024-10-10",0,0,15,0,0,17,0,0
"Singapore","2024-10-11",0,2,17,0,0,17,0,0
"Singapore","2024-10-12",0,0,17,0,0,17,0,0
"Singapore","2024-10-13",0,0,17,0,0,17,0,0
"Singapore","2024-10-14",0,0,17,0,0,17,0,0
"Singapore","2024-10-15",0,0,17,0,0,17,0,0
"Singapore","2024-10-16",0,0,17,0,0,17,0,0
"Singapore","2024-10-17",0,0,17,0,0,17,0,0
"Singapore","2024-10-18",0,0,17,0,0,17,0,0
"Singapore","2024-10-19",0,0,17,0,0,17,0,0
"Singapore","2024-10-20",0,0,17,0,0,17,0,0
"Singapore","2024-10-21",0,0,17,0,0,17,0,0
"Singapore","2024-10-22",0,0,17,0,0,17,0,0
"Singapore","2024-10-23",0,0,17,0,0,17,0,0
"Singapore","2024-10-24",0,0,17,0,0,17,0,0
"Singapore","2024-10-25",0,0,17,0,0,17,0,0
"Singapore","2024-10-26",0,0,17,0,0,17,0,0
"Singapore","2024-10-27",0,0,17,0,0,17,0,0
"Singapore","2024-10-28",0,0,17,0,0,17,0,0
"Singapore","2024-10-29",0,0,17,0,0,17,0,0
"Singapore","2024-10-30",0,0,17,0,0,17,0,0
"Singapore","2024-10-31",0,0,17,0,0,17,0,0
"Singapore","2024-11-01",0,0,17,0,0,17,0,0
"Singapore","2024-11-02",0,0,17,0,0,17,0,0
"Singapore","2024-11-03",0,0,17,0,0,17,0,0
"Singapore","2024-11-04",0,0,17,0,0,17,0,0
"Singapore","2024-11-05",0,0,17,0,0,17,0,0
"Singapore","2024-11-06",0,0,17,0,0,17,0,0
"Singapore","2024-11-07",0,0,17,0,0,17,0,0
"Singapore","2024-11-08",0,0,17,0,0,17,0,0
"Singapore","2024-11-09",0,0,17,0,0,17,0,0
"Singapore","2024-11-10",0,0,17,0,0,17,0,0
"Singapore","2024-11-11",0,0,17,0,0,17,0,0
"Singapore","2024-11-12",0,0,17,0,0,17,0,0
"Singapore","2024-11-13",0,0,17,0,0,17,0,0
"Singapore","2024-11-14",0,0,17,0,0,17,0,0
"Singapore","2024-11-15",0,0,17,0,0,17,0,0
"Singapore","2024-11-16",0,0,17,0,0,17,0,0
"Singapore","2024-11-17",0,0,17,0,0,17,0,0
"Singapore","2024-11-18",0,0,17,0,0,17,0,0
"Singapore","2024-11-19",0,0,17,0,1,18,0,0
"Singapore","2024-11-20",0,0,17,0,0,18,0,0
"Singapore","2024-11-21",0,0,17,0,0,18,0,0
"Singapore","2024-11-22",0,0,17,0,0,18,0,0
"Singapore","2024-11-23",0,0,17,0,0,18,0,0
"Singapore","2024-11-24",0,0,17,0,0,18,0,0
"Singapore","2024-11-25",0,0,17,0,0,18,0,0
"Singapore","2024-11-26",0,0,17,0,0,18,0,0
"Singapore","2024-11-27",0,0,17,0,0,18,0,0
"Singapore","2024-11-28",0,0,17,0,0,18,0,0
"Singapore","2024-11-29",0,0,17,0,0,18,0,0
"Singapore","2024-11-30",0,0,17,0,0,18,0,0
"Singapore","2024-12-01",0,0,17,0,0,18,0,0
"Singapore","2024-12-02",0,0,17,0,0,18,0,0
"Singapore","2024-12-03",0,0,17,0,0,18,0,0
"Singapore","2024-12-04",0,0,17,0,0,18,0,0
"Singapore","2024-12-05",0,0,17,0,0,18,0,0
"Singapore","2024-12-06",0,0,17,0,0,18,0,0
"Singapore","2024-12-07",0,0,17,0,0,18,0,0
"Singapore","2024-12-08",0,0,17,0,0,18,0,0
"Singapore","2024-12-09",0,0,17,0,0,18,0,0
"Singapore","2024-12-10",0,0,17,0,0,18,0,0
"Singapore","2024-12-11",0,0,17,0,0,18,0,0
"Singapore","2024-12-12",0,0,17,0,0,18,0,0
"Singapore","2024-12-13",0,0,17,0,0,18,0,0
"Singapore","2024-12-14",0,0,17,0,0,18,0,0
"Singapore","2024-12-15",0,0,17,0,0,18,0,0
"Singapore","2024-12-16",0,0,17,0,0,18,0,0
"Singapore","2024-12-17",0,0,17,0,0,18,0,0
"Singapore","2024-12-18",0,0,17,0,0,18,0,0
"Singapore","2024-12-19",0,0,17,0,0,18,0,0
"Singapore","2024-12-20",0,0,17,0,0,18,0,0
"Singapore","2024-12-21",0,0,17,0,0,18,0,0
"Singapore","2024-12-22",0,0,17,0,0,18,0,0
"Singapore","2024-12-23",0,0,17,0,0,18,0,0
"Singapore","2024-12-24",0,0,17,0,0,18,0,0
"Singapore","2024-12-25",0,0,17,0,0,18,0,0
"Singapore","2024-12-26",0,0,17,0,0,18,0,0
"Singapore","2024-12-27",0,1,18,0,0,18,0,0
"Singapore","2024-12-28",0,0,18,0,0,18,0,0
"Singapore","2024-12-29",0,0,18,0,0,18,0,0
"Singapore","2024-12-30",0,0,18,0,0,18,0,0
"Singapore","2024-12-31",0,0,18,0,0,18,0,0
"Singapore","2025-01-01",0,0,18,0,0,18,0,0
"Singapore","2025-01-02",0,0,18,0,0,18,0,0
"Singapore","2025-01-03",0,0,18,0,0,18,0,0
"Singapore","2025-01-04",0,0,18,0,0,18,0,0
"Singapore","2025-01-05",0,0,18,0,0,18,0,0
"Singapore","2025-01-06",0,0,18,0,0,18,0,0
"Singapore","2025-01-07",0,0,18,0,0,18,0,0
"Singapore","2025-01-08",0,0,18,0,0,18,0,0
"Singapore","2025-01-09",0,0,18,0,0,18,0,0
"Singapore","2025-01-10",0,0,18,0,0,18,0,0
"Singapore","2025-01-11",0,0,18,0,0,18,0,0
"Singapore","2025-01-12",0,0,18,0,0,18,0,0
"Singapore","2025-01-13",0,0,18,0,0,18,0,0
"Singapore","2025-01-14",0,0,18,0,0,18,0,0
"Singapore","2025-01-15",0,0,18,0,0,18,0,0
"Singapore","2025-01-16",0,0,18,0,0,18,0,0
"Singapore","2025-01-17",0,0,18,0,0,18,0,0
"Singapore","2025-01-18",0,0,18,0,0,18,0,0
"Singapore","2025-01-19",0,0,18,0,0,18,0,0
"Singapore","2025-01-20",0,0,18,0,0,18,0,0
"Singapore","2025-01-21",0,0,18,0,0,18,0,0
"Singapore","2025-01-22",0,0,18,0,0,18,0,0
"Singapore","2025-01-23",0,0,18,0,0,18,0,0
"Singapore","2025-01-24",0,0,18,0,0,18,0,0
"Singapore","2025-01-25",0,0,18,0,0,18,0,0
"Singapore","2025-01-26",0,0,18,0,0,18,0,0
"Singapore","2025-01-27",0,0,18,0,0,18,0,0
"Singapore","2025-01-28",0,0,18,0,0,18,0,0
"Singapore","2025-01-29",0,0,18,0,0,18,0,0
"Singapore","2025-01-30",0,0,18,0,0,18,0,0
"Singapore","2025-01-31",0,0,18,0,0,18,0,0
"Singapore","2025-02-01",0,0,18,0,0,18,0,0
"Singapore","2025-02-02",0,0,18,0,0,18,0,0
"Singapore","2025-02-03",0,0,18,0,0,18,0,0
"Slovakia","2024-01-01",0,0,0,0,0,0,0,0
"Slovakia","2024-01-02",0,0,0,0,0,0,0,0
"Slovakia","2024-01-03",0,0,0,0,0,0,0,0
"Slovakia","2024-01-04",0,0,0,0,0,0,0,0
"Slovakia","2024-01-05",0,0,0,0,0,0,0,0
"Slovakia","2024-01-06",0,0,0,0,0,0,0,0
"Slovakia","2024-01-07",0,0,0,0,0,0,0,0
"Slovakia","2024-01-08",0,0,0,0,0,0,0,0
"Slovakia","2024-01-09",0,0,0,0,0,0,0,0
"Slovakia","2024-01-10",0,0,0,0,0,0,0,0
"Slovakia","2024-01-11",0,0,0,0,0,0,0,0
"Slovakia","2024-01-12",0,0,0,0,0,0,0,0
"Slovakia","2024-01-13",0,0,0,0,0,0,0,0
"Slovakia","2024-01-14",0,0,0,0,0,0,0,0
"Slovakia","2024-01-15",0,0,0,0,0,0,0,0
"Slovakia","2024-01-16",0,0,0,0,0,0,0,0
"Slovakia","2024-01-17",0,0,0,0,0,0,0,0
"Slovakia","2024-01-18",0,0,0,0,0,0,0,0
"Slovakia","2024-01-19",0,0,0,0,0,0,0,0
"Slovakia","2024-01-20",0,0,0,0,0,0,0,0
"Slovakia","2024-01-21",0,0,0,0,0,0,0,0
"Slovakia","2024-01-22",0,0,0,0,0,0,0,0
"Slovakia","2024-01-23",0,0,0,0,0,0,0,0
"Slovakia","2024-01-24",0,0,0,0,0,0,0,0
"Slovakia","2024-01-25",0,0,0,0,0,0,0,0
"Slovakia","2024-01-26",0,0,0,0,0,0,0,0
"Slovakia","2024-01-27",0,0,0,0,0,0,0,0
"Slovakia","2024-01-28",0,0,0,0,0,0,0,0
"Slovakia","2024-01-29",0,0,0,0,0,0,0,0
"Slovakia","2024-01-30",0,0,0,0,0,0,0,0
"Slovakia","2024-01-31",0,2,2,0,2,2,0,0
"Slovakia","2024-02-01",0,0,2,0,0,2,0,0
"Slovakia","2024-02-02",0,0,2,0,0,2,0,0
"Slovakia","2024-02-03",0,0,2,0,0,2,0,0
"Slovakia","2024-02-04",0,0,2,0,0,2,0,0
"Slovakia","2024-02-05",0,0,2,0,0,2,0,0
"Slovakia","2024-02-06",0,0,2,0,0,2,0,0
"Slovakia","2024-02-07",0,0,2,0,0,2,0,0
"Slovakia","2024-02-08",0,0,2,0,0,2,0,0
"Slovakia","2024-02-09",0,0,2,0,0,2,0,0
"Slovakia","2024-02-10",0,0,2,0,0,2,0,0
"Slovakia","2024-02-11",0,0,2,0,0,2,0,0
"Slovakia","2024-02-12",0,0,2,0,0,2,0,0
"Slovakia","2024-02-13",0,0,2,0,0,2,0,0
"Slovakia","2024-02-14",0,0,2,0,0,2,0,0
"Slovakia","2024-02-15",0,0,2,0,0,2,0,0
"Slovakia","2024-02-16",0,0,2,0,0,2,0,0
"Slovakia","2024-02-17",0,0,2,0,0,2,0,0
"Slovakia","2024-02-18",0,0,2,0,0,2,0,0
"Slovakia","2024-02-19",0,0,2,0,0,2,0,0
"Slovakia","2024-02-20",0,0,2,0,0,2,0,0
"Slovakia","2024-02-21",0,0,2,0,0,2,0,0
"Slovakia","2024-02-22",0,0,2,0,0,2,0,0
"Slovakia","2024-02-23",0,0,2,0,0,2,0,0
"Slovakia","2024-02-24",0,0,2,0,0,2,0,0
"Slovakia","2024-02-25",0,0,2,0,0,2,0,0
"Slovakia","2024-02-26",0,0,2,0,0,2,0,0
"Slovakia","2024-02-27",0,0,2,0,0,2,0,0
"Slovakia","2024-02-28",0,0,2,0,0,2,0,0
"Slovakia","2024-02-29",0,0,2,0,0,2,0,0
"Slovakia","2024-03-01",0,0,2,0,0,2,0,0
"Slovakia","2024-03-02",0,0,2,0,0,2,0,0
"Slovakia","2024-03-03",0,0,2,0,0,2,0,0
"Slovakia","2024-03-04",0,0,2,0,0,2,0,0
"Slovakia","2024-03-05",0,0,2,0,0,2,0,0
"Slovakia","2024-03-06",0,0,2,0,0,2,0,0
"Slovakia","2024-03-07",0,0,2,0,0,2,0,0
"Slovakia","2024-03-08",0,0,2,0,0,2,0,0
"Slovakia","2024-03-09",0,0,2,0,0,2,0,0
"Slovakia","2024-03-10",0,0,2,0,0,2,0,0
"Slovakia","2024-03-11",0,0,2,0,0,2,0,0
"Slovakia","2024-03-12",0,0,2,0,0,2,0,0
"Slovakia","2024-03-13",0,0,2,0,0,2,0,0
"Slovakia","2024-03-14",0,0,2,0,0,2,0,0
"Slovakia","2024-03-15",0,0,2,0,0,2,0,0
"Slovakia","2024-03-16",0,0,2,0,0,2,0,0
"Slovakia","2024-03-17",0,0,2,0,0,2,0,0
"Slovakia","2024-03-18",0,0,2,0,0,2,0,0
"Slovakia","2024-03-19",0,0,2,0,0,2,0,0
"Slovakia","2024-03-20",0,0,2,0,0,2,0,0
"Slovakia","2024-03-21",0,0,2,0,0,2,0,0
"Slovakia","2024-03-22",0,0,2,0,0,2,0,0
"Slovakia","2024-03-23",0,0,2,0,0,2,0,0
"Slovakia","2024-03-24",0,0,2,0,0,2,0,0
"Slovakia","2024-03-25",0,0,2,0,0,2,0,0
"Slovakia","2024-03-26",0,0,2,0,0,2,0,0
"Slovakia","2024-03-27",0,0,2,0,0,2,0,0
"Slovakia","2024-03-28",0,0,2,0,0,2,0,0
"Slovakia","2024-03-29",0,0,2,0,0,2,0,0
"Slovakia","2024-03-30",0,0,2,0,0,2,0,0
"Slovakia","2024-03-31",0,0,2,0,0,2,0,0
"Slovakia","2024-04-01",0,0,2,0,0,2,0,0
"Slovakia","2024-04-02",0,0,2,0,0,2,0,0
"Slovakia","2024-04-03",0,0,2,0,0,2,0,0
"Slovakia","2024-04-04",0,0,2,0,0,2,0,0
"Slovakia","2024-04-05",0,0,2,0,0,2,0,0
"Slovakia","2024-04-06",0,0,2,0,0,2,0,0
"Slovakia","2024-04-07",0,0,2,0,0,2,0,0
"Slovakia","2024-04-08",0,0,2,0,0,2,0,0
"Slovakia","2024-04-09",0,0,2,0,0,2,0,0
"Slovakia","2024-04-10",0,0,2,0,0,2,0,0
"Slovakia","2024-04-11",0,0,2,0,0,2,0,0
"Slovakia","2024-04-12",0,0,2,0,0,2,0,0
"Slovakia","2024-04-13",0,0,2,0,0,2,0,0
"Slovakia","2024-04-14",0,0,2,0,0,2,0,0
"Slovakia","2024-04-15",0,0,2,0,0,2,0,0
"Slovakia","2024-04-16",0,0,2,0,0,2,0,0
"Slovakia","2024-04-17",0,0,2,0,1,3,0,0
"Slovakia","2024-04-18",0,0,2,0,0,3,0,0
"Slovakia","2024-04-19",0,0,2,0,0,3,0,0
"Slovakia","2024-04-20",0,0,2,0,0,3,0,0
"Slovakia","2024-04-21",0,0,2,0,0,3,0,0
"Slovakia","2024-04-22",0,0,2,0,0,3,0,0
"Slovakia","2024-04-23",0,0,2,0,0,3,0,0
"Slovakia","2024-04-24",0,0,2,0,0,3,0,0
"Slovakia","2024-04-25",0,0,2,0,0,3,0,0
"Slovakia","2024-04-26",0,0,2,0,0,3,0,0
"Slovakia","2024-04-27",0,0,2,0,0,3,0,0
"Slovakia","2024-04-28",0,0,2,0,0,3,0,0
"Slovakia","2024-04-29",0,0,2,0,0,3,0,0
"Slovakia","2024-04-30",0,0,2,0,0,3,0,0
"Slovakia","2024-05-01",0,0,2,0,0,3,0,0
"Slovakia","2024-05-02",0,0,2,0,0,3,0,0
"Slovakia","2024-05-03",0,0,2,0,0,3,0,0
"Slovakia","2024-05-04",0,0,2,0,0,3,0,0
"Slovakia","2024-05-05",0,0,2,0,0,3,0,0
"Slovakia","2024-05-06",0,0,2,0,0,3,0,0
"Slovakia","2024-05-07",0,0,2,0,0,3,0,0
"Slovakia","2024-05-08",0,0,2,0,0,3,0,0
"Slovakia","2024-05-09",0,0,2,0,0,3,0,0
"Slovakia","2024-05-10",0,0,2,0,0,3,0,0
"Slovakia","2024-05-11",0,0,2,0,0,3,0,0
"Slovakia","2024-05-12",0,0,2,0,0,3,0,0
"Slovakia","2024-05-13",0,0,2,0,0,3,0,0
"Slovakia","2024-05-14",0,0,2,0,0,3,0,0
"Slovakia","2024-05-15",0,0,2,0,0,3,0,0
"Slovakia","2024-05-16",0,0,2,0,0,3,0,0
"Slovakia","2024-05-17",0,0,2,0,0,3,0,0
"Slovakia","2024-05-18",0,0,2,0,0,3,0,0
"Slovakia","2024-05-19",0,0,2,0,0,3,0,0
"Slovakia","2024-05-20",0,0,2,0,0,3,0,0
"Slovakia","2024-05-21",0,0,2,0,0,3,0,0
"Slovakia","2024-05-22",0,0,2,0,0,3,0,0
"Slovakia","2024-05-23",0,0,2,0,0,3,0,0
"Slovakia","2024-05-24",0,0,2,0,0,3,0,0
"Slovakia","2024-05-25",0,0,2,0,0,3,0,0
"Slovakia","2024-05-26",0,0,2,0,0,3,0,0
"Slovakia","2024-05-27",0,0,2,0,0,3,0,0
"Slovakia","2024-05-28",0,0,2,0,0,3,0,0
"Slovakia","2024-05-29",0,0,2,0,0,3,0,0
"Slovakia","2024-05-30",0,0,2,0,0,3,0,0
"Slovakia","2024-05-31",0,0,2,0,0,3,0,0
"Slovakia","2024-06-01",0,0,2,0,0,3,0,0
"Slovakia","2024-06-02",0,0,2,0,0,3,0,0
"Slovakia","2024-06-03",0,0,2,0,0,3,0,0
"Slovakia","2024-06-04",0,0,2,0,0,3,0,0
"Slovakia","2024-06-05",0,0,2,0,0,3,0,0
"Slovakia","2024-06-06",0,0,2,0,0,3,0,0
"Slovakia","2024-06-07",0,0,2,0,0,3,0,0
"Slovakia","2024-06-08",0,0,2,0,0,3,0,0
"Slovakia","2024-06-09",0,0,2,0,0,3,0,0
"Slovakia","2024-06-10",0,0,2,0,0,3,0,0
"Slovakia","2024-06-11",0,0,2,0,0,3,0,0
"Slovakia","2024-06-12",0,0,2,0,0,3,0,0
"Slovakia","2024-06-13",0,0,2,0,0,3,0,0
"Slovakia","2024-06-14",0,0,2,0,0,3,0,0
"Slovakia","2024-06-15",0,0,2,0,0,3,0,0
"Slovakia","2024-06-16",0,0,2,0,0,3,0,0
"Slovakia","2024-06-17",0,0,2,0,0,3,0,0
"Slovakia","2024-06-18",0,0,2,0,0,3,0,0
"Slovakia","2024-06-19",0,0,2,0,0,3,0,0
"Slovakia","2024-06-20",0,0,2,0,0,3,0,0
"Slovakia","2024-06-21",0,0,2,0,0,3,0,0
"Slovakia","2024-06-22",0,0,2,0,0,3,0,0
"Slovakia","2024-06-23",0,0,2,0,0,3,0,0
"Slovakia","2024-06-24",0,0,2,0,0,3,0,0
"Slovakia","2024-06-25",0,0,2,0,0,3,0,0
"Slovakia","2024-06-26",0,0,2,0,0,3,0,0
"Slovakia","2024-06-27",0,0,2,0,0,3,0,0
"Slovakia","2024-06-28",0,0,2,0,0,3,0,0
"Slovakia","2024-06-29",0,0,2,0,0,3,0,0
"Slovakia","2024-06-30",0,0,2,0,0,3,0,0
"Slovakia","2024-07-01",0,0,2,0,0,3,0,0
"Slovakia","2024-07-02",0,0,2,0,0,3,0,0
"Slovakia","2024-07-03",0,0,2,0,0,3,0,0
"Slovakia","2024-07-04",0,0,2,0,0,3,0,0
"Slovakia","2024-07-05",0,0,2,0,0,3,0,0
"Slovakia","2024-07-06",0,0,2,0,0,3,0,0
"Slovakia","2024-07-07",0,0,2,0,0,3,0,0
"Slovakia","2024-07-08",0,0,2,0,0,3,0,0
"Slovakia","2024-07-09",0,0,2,0,0,3,0,0
"Slovakia","2024-07-10",0,0,2,0,0,3,0,0
"Slovakia","2024-07-11",0,0,2,0,0,3,0,0
"Slovakia","2024-07-12",0,0,2,0,0,3,0,0
"Slovakia","2024-07-13",0,0,2,0,0,3,0,0
"Slovakia","2024-07-14",0,0,2,0,0,3,0,0
"Slovakia","2024-07-15",0,0,2,0,0,3,0,0
"Slovakia","2024-07-16",0,0,2,0,0,3,0,0
"Slovakia","2024-07-17",0,0,2,0,0,3,0,0
"Slovakia","2024-07-18",0,0,2,0,0,3,0,0
"Slovakia","2024-07-19",0,0,2,0,0,3,0,0
"Slovakia","2024-07-20",0,0,2,0,0,3,0,0
"Slovakia","2024-07-21",0,0,2,0,0,3,0,0
"Slovakia","2024-07-22",0,0,2,0,0,3,0,0
"Slovakia","2024-07-23",0,0,2,0,0,3,0,0
"Slovakia","2024-07-24",0,0,2,0,0,3,0,0
"Slovakia","2024-07-25",0,0,2,0,0,3,0,0
"Slovakia","2024-07-26",0,0,2,0,0,3,0,0
"Slovakia","2024-07-27",0,0,2,0,0,3,0,0
"Slovakia","2024-07-28",0,0,2,0,0,3,0,0
"Slovakia","2024-07-29",0,0,2,0,0,3,0,0
"Slovakia","2024-07-30",0,0,2,0,0,3,0,0
"Slovakia","2024-07-31",0,0,2,0,0,3,0,0
"Slovakia","2024-08-01",0,0,2,0,0,3,0,0
"Slovakia","2024-08-02",0,0,2,0,0,3,0,0
"Slovakia","2024-08-03",0,0,2,0,0,3,0,0
"Slovakia","2024-08-04",0,0,2,0,0,3,0,0
"Slovakia","2024-08-05",0,0,2,0,0,3,0,0
"Slovakia","2024-08-06",0,0,2,0,0,3,0,0
"Slovakia","2024-08-07",0,0,2,0,0,3,0,0
"Slovakia","2024-08-08",0,0,2,0,0,3,0,0
"Slovakia","2024-08-09",0,0,2,0,0,3,0,0
"Slovakia","2024-08-10",0,0,2,0,0,3,0,0
"Slovakia","2024-08-11",0,0,2,0,0,3,0,0
"Slovakia","2024-08-12",0,0,2,0,0,3,0,0
"Slovakia","2024-08-13",0,0,2,0,0,3,0,0
"Slovakia","2024-08-14",0,0,2,0,0,3,0,0
"Slovakia","2024-08-15",0,0,2,0,0,3,0,0
"Slovakia","2024-08-16",0,0,2,0,0,3,0,0
"Slovakia","2024-08-17",0,0,2,0,0,3,0,0
"Slovakia","2024-08-18",0,0,2,0,0,3,0,0
"Slovakia","2024-08-19",0,0,2,0,0,3,0,0
"Slovakia","2024-08-20",0,0,2,0,0,3,0,0
"Slovakia","2024-08-21",0,0,2,0,0,3,0,0
"Slovakia","2024-08-22",0,0,2,0,0,3,0,0
"Slovakia","2024-08-23",0,0,2,0,0,3,0,0
"Slovakia","2024-08-24",0,0,2,0,0,3,0,0
"Slovakia","2024-08-25",0,0,2,0,0,3,0,0
"Slovakia","2024-08-26",0,0,2,0,0,3,0,0
"Slovakia","2024-08-27",0,0,2,0,0,3,0,0
"Slovakia","2024-08-28",0,0,2,0,0,3,0,0
"Slovakia","2024-08-29",0,0,2,0,0,3,0,0
"Slovakia","2024-08-30",0,0,2,0,0,3,0,0
"Slovakia","2024-08-31",0,0,2,0,0,3,0,0
"Slovakia","2024-09-01",0,0,2,0,0,3,0,0
"Slovakia","2024-09-02",0,0,2,0,0,3,0,0
"Slovakia","2024-09-03",0,0,2,0,0,3,0,0
"Slovakia","2024-09-04",0,0,2,0,0,3,0,0
"Slovakia","2024-09-05",0,0,2,0,0,3,0,0
"Slovakia","2024-09-06",0,0,2,0,0,3,0,0
"Slovakia","2024-09-07",0,0,2,0,0,3,0,0
"Slovakia","2024-09-08",0,0,2,0,0,3,0,0
"Slovakia","2024-09-09",0,0,2,0,0,3,0,0
"Slovakia","2024-09-10",0,0,2,0,0,3,0,0
"Slovakia","2024-09-11",0,0,2,0,0,3,0,0
"Slovakia","2024-09-12",0,0,2,0,0,3,0,0
"Slovakia","2024-09-13",0,0,2,0,0,3,0,0
"Slovakia","2024-09-14",0,0,2,0,0,3,0,0
"Slovakia","2024-09-15",0,0,2,0,1,4,0,0
"Slovakia","2024-09-16",0,0,2,0,0,4,0,0
"Slovakia","2024-09-17",0,0,2,0,0,4,0,0
"Slovakia","2024-09-18",0,0,2,0,0,4,0,0
"Slovakia","2024-09-19",0,0,2,0,0,4,0,0
"Slovakia","2024-09-20",0,0,2,0,0,4,0,0
"Slovakia","2024-09-21",0,0,2,0,0,4,0,0
"Slovakia","2024-09-22",0,0,2,0,0,4,0,0
"Slovakia","2024-09-23",0,0,2,0,0,4,0,0
"Slovakia","2024-09-24",0,0,2,0,0,4,0,0
"Slovakia","2024-09-25",0,0,2,0,0,4,0,0
"Slovakia","2024-09-26",0,0,2,0,0,4,0,0
"Slovakia","2024-09-27",0,0,2,0,0,4,0,0
"Slovakia","2024-09-28",0,0,2,0,0,4,0,0
"Slovakia","2024-09-29",0,0,2,0,0,4,0,0
"Slovakia","2024-09-30",0,0,2,0,0,4,0,0
"Slovakia","2024-10-01",0,0,2,0,0,4,0,0
"Slovakia","2024-10-02",0,0,2,0,0,4,0,0
"Slovakia","2024-10-03",0,0,2,0,0,4,0,0
"Slovakia","2024-10-04",0,0,2,0,0,4,0,0
"Slovakia","2024-10-05",0,0,2,0,0,4,0,0
"Slovakia","2024-10-06",0,0,2,0,0,4,0,0
"Slovakia","2024-10-07",0,0,2,0,0,4,0,0
"Slovakia","2024-10-08",0,0,2,0,0,4,0,0
"Slovakia","2024-10-09",0,0,2,0,0,4,0,0
"Slovakia","2024-10-10",0,0,2,0,0,4,0,0
"Slovakia","2024-10-11",0,0,2,0,0,4,0,0
"Slovakia","2024-10-12",0,0,2,0,0,4,0,0
"Slovakia","2024-10-13",0,0,2,0,0,4,0,0
"Slovakia","2024-10-14",0,0,2,0,0,4,0,0
"Slovakia","2024-10-15",0,0,2,0,0,4,0,0
"Slovakia","2024-10-16",0,0,2,0,0,4,0,0
"Slovakia","2024-10-17",0,0,2,0,0,4,0,0
"Slovakia","2024-10-18",0,0,2,0,0,4,0,0
"Slovakia","2024-10-19",0,0,2,0,0,4,0,0
"Slovakia","2024-10-20",0,0,2,0,0,4,0,0
"Slovakia","2024-10-21",0,0,2,0,0,4,0,0
"Slovakia","2024-10-22",0,0,2,0,0,4,0,0
"Slovakia","2024-10-23",0,0,2,0,0,4,0,0
"Slovakia","2024-10-24",0,0,2,0,0,4,0,0
"Slovakia","2024-10-25",0,0,2,0,0,4,0,0
"Slovakia","2024-10-26",0,0,2,0,0,4,0,0
"Slovakia","2024-10-27",0,0,2,0,0,4,0,0
"Slovakia","2024-10-28",0,0,2,0,0,4,0,0
"Slovakia","2024-10-29",0,0,2,0,0,4,0,0
"Slovakia","2024-10-30",0,0,2,0,0,4,0,0
"Slovakia","2024-10-31",0,0,2,0,0,4,0,0
"Slovakia","2024-11-01",0,0,2,0,0,4,0,0
"Slovakia","2024-11-02",0,0,2,0,0,4,0,0
"Slovakia","2024-11-03",0,0,2,0,0,4,0,0
"Slovakia","2024-11-04",0,0,2,0,0,4,0,0
"Slovakia","2024-11-05",0,0,2,0,0,4,0,0
"Slovakia","2024-11-06",0,0,2,0,0,4,0,0
"Slovakia","2024-11-07",0,0,2,0,0,4,0,0
"Slovakia","2024-11-08",0,0,2,0,0,4,0,0
"Slovakia","2024-11-09",0,0,2,0,0,4,0,0
"Slovakia","2024-11-10",0,0,2,0,0,4,0,0
"Slovakia","2024-11-11",0,0,2,0,0,4,0,0
"Slovakia","2024-11-12",0,0,2,0,0,4,0,0
"Slovakia","2024-11-13",0,0,2,0,0,4,0,0
"Slovakia","2024-11-14",0,0,2,0,0,4,0,0
"Slovakia","2024-11-15",0,0,2,0,0,4,0,0
"Slovakia","2024-11-16",0,0,2,0,0,4,0,0
"Slovakia","2024-11-17",0,0,2,0,0,4,0,0
"Slovakia","2024-11-18",0,0,2,0,0,4,0,0
"Slovakia","2024-11-19",0,0,2,0,0,4,0,0
"Slovakia","2024-11-20",0,0,2,0,0,4,0,0
"Slovakia","2024-11-21",0,0,2,0,0,4,0,0
"Slovakia","2024-11-22",0,0,2,0,0,4,0,0
"Slovakia","2024-11-23",0,0,2,0,0,4,0,0
"Slovakia","2024-11-24",0,0,2,0,0,4,0,0
"Slovakia","2024-11-25",0,0,2,0,0,4,0,0
"Slovakia","2024-11-26",0,0,2,0,0,4,0,0
"Slovakia","2024-11-27",0,0,2,0,0,4,0,0
"Slovakia","2024-11-28",0,0,2,0,0,4,0,0
"Slovakia","2024-11-29",0,0,2,0,0,4,0,0
"Slovakia","2024-11-30",0,2,4,0,0,4,0,0
"Slovakia","2024-12-01",0,0,4,0,0,4,0,0
"Slovakia","2024-12-02",0,0,4,0,0,4,0,0
"Slovakia","2024-12-03",0,0,4,0,0,4,0,0
"Slovakia","2024-12-04",0,0,4,0,0,4,0,0
"Slovakia","2024-12-05",0,0,4,0,0,4,0,0
"Slovakia","2024-12-06",0,0,4,0,0,4,0,0
"Slovakia","2024-12-07",0,0,4,0,0,4,0,0
"Slovakia","2024-12-08",0,0,4,0,0,4,0,0
"Slovakia","2024-12-09",0,0,4,0,0,4,0,0
"Slovakia","2024-12-10",0,0,4,0,0,4,0,0
"Slovakia","2024-12-11",0,0,4,0,0,4,0,0
"Slovakia","2024-12-12",0,0,4,0,0,4,0,0
"Slovakia","2024-12-13",0,0,4,0,0,4,0,0
"Slovakia","2024-12-14",0,0,4,0,0,4,0,0
"Slovakia","2024-12-15",0,0,4,0,0,4,0,0
"Slovakia","2024-12-16",0,0,4,0,0,4,0,0
"Slovakia","2024-12-17",0,0,4,0,0,4,0,0
"Slovakia","2024-12-18",0,0,4,0,0,4,0,0
"Slovakia","2024-12-19",0,0,4,0,0,4,0,0
"Slovakia","2024-12-20",0,0,4,0,0,4,0,0
"Slovakia","2024-12-21",0,0,4,0,0,4,0,0
"Slovakia","2024-12-22",0,0,4,0,0,4,0,0
"Slovakia","2024-12-23",0,0,4,0,0,4,0,0
"Slovakia","2024-12-24",0,0,4,0,0,4,0,0
"Slovakia","2024-12-25",0,0,4,0,0,4,0,0
"Slovakia","2024-12-26",0,0,4,0,0,4,0,0
"Slovakia","2024-12-27",0,0,4,0,0,4,0,0
"Slovakia","2024-12-28",0,0,4,0,0,4,0,0
"Slovakia","2024-12-29",0,0,4,0,0,4,0,0
"Slovakia","2024-12-30",0,0,4,0,0,4,0,0
"Slovakia","2024-12-31",0,0,4,0,0,4,0,0
"Slovakia","2025-01-01",0,0,4,0,0,4,0,0
"Slovakia","2025-01-02",0,0,4,0,0,4,0,0
"Slovakia","2025-01-03",0,0,4,0,0,4,0,0
"Slovakia","2025-01-04",0,0,4,0,0,4,0,0
"Slovakia","2025-01-05",0,0,4,0,0,4,0,0
"Slovakia","2025-01-06",0,0,4,0,0,4,0,0
"Slovakia","2025-01-07",0,0,4,0,0,4,0,0
"Slovakia","2025-01-08",0,0,4,0,0,4,0,0
"Slovakia","2025-01-09",0,0,4,0,0,4,0,0
"Slovakia","2025-01-10",0,0,4,0,0,4,0,0
"Slovakia","2025-01-11",0,0,4,0,0,4,0,0
"Slovakia","2025-01-12",0,0,4,0,0,4,0,0
"Slovakia","2025-01-13",0,0,4,0,0,4,0,0
"Slovakia","2025-01-14",0,0,4,0,0,4,0,0
"Slovakia","2025-01-15",0,0,4,0,0,4,0,0
"Slovakia","2025-01-16",0,0,4,0,0,4,0,0
"Slovakia","2025-01-17",0,0,4,0,0,4,0,0
"Slovakia","2025-01-18",0,0,4,0,0,4,0,0
"Slovakia","2025-01-19",0,0,4,0,0,4,0,0
"Slovakia","2025-01-20",0,0,4,0,0,4,0,0
"Slovakia","2025-01-21",0,0,4,0,0,4,0,0
"Slovakia","2025-01-22",0,0,4,0,0,4,0,0
"Slovakia","2025-01-23",0,0,4,0,0,4,0,0
"Slovakia","2025-01-24",0,0,4,0,0,4,0,0
"Slovakia","2025-01-25",0,0,4,0,0,4,0,0
"Slovakia","2025-01-26",0,0,4,0,0,4,0,0
"Slovakia","2025-01-27",0,0,4,0,0,4,0,0
"Slovakia","2025-01-28",0,0,4,0,0,4,0,0
"Slovakia","2025-01-29",0,0,4,0,0,4,0,0
"Slovakia","2025-01-30",0,0,4,0,0,4,0,0
"Slovakia","2025-01-31",0,0,4,0,0,4,0,0
"Slovakia","2025-02-01",0,0,4,0,0,4,0,0
"Slovakia","2025-02-02",0,0,4,0,0,4,0,0
"Slovakia","2025-02-03",0,0,4,0,0,4,0,0
"Slovenia","2024-01-01",0,0,0,0,0,0,0,0
"Slovenia","2024-01-02",0,0,0,0,0,0,0,0
"Slovenia","2024-01-03",0,0,0,0,0,0,0,0
"Slovenia","2024-01-04",0,0,0,0,0,0,0,0
"Slovenia","2024-01-05",0,0,0,0,0,0,0,0
"Slovenia","2024-01-06",0,0,0,0,0,0,0,0
"Slovenia","2024-01-07",0,0,0,0,0,0,0,0
"Slovenia","2024-01-08",0,0,0,0,0,0,0,0
"Slovenia","2024-01-09",0,0,0,0,0,0,0,0
"Slovenia","2024-01-10",0,0,0,0,0,0,0,0
"Slovenia","2024-01-11",0,0,0,0,0,0,0,0
"Slovenia","2024-01-12",0,0,0,0,0,0,0,0
"Slovenia","2024-01-13",0,0,0,0,0,0,0,0
"Slovenia","2024-01-14",0,0,0,0,0,0,0,0
"Slovenia","2024-01-15",0,0,0,0,0,0,0,0
"Slovenia","2024-01-16",0,0,0,0,0,0,0,0
"Slovenia","2024-01-17",0,0,0,0,0,0,0,0
"Slovenia","2024-01-18",0,0,0,0,0,0,0,0
"Slovenia","2024-01-19",0,0,0,0,0,0,0,0
"Slovenia","2024-01-20",0,0,0,0,0,0,0,0
"Slovenia","2024-01-21",0,0,0,0,0,0,0,0
"Slovenia","2024-01-22",0,0,0,0,0,0,0,0
"Slovenia","2024-01-23",0,0,0,0,0,0,0,0
"Slovenia","2024-01-24",0,0,0,0,0,0,0,0
"Slovenia","2024-01-25",0,0,0,0,0,0,0,0
"Slovenia","2024-01-26",0,0,0,0,0,0,0,0
"Slovenia","2024-01-27",0,0,0,0,0,0,0,0
"Slovenia","2024-01-28",0,0,0,0,0,0,0,0
"Slovenia","2024-01-29",0,0,0,0,0,0,0,0
"Slovenia","2024-01-30",0,0,0,0,0,0,0,0
"Slovenia","2024-01-31",0,0,0,0,0,0,0,0
"Slovenia","2024-02-01",0,0,0,0,0,0,0,0
"Slovenia","2024-02-02",0,0,0,0,0,0,0,0
"Slovenia","2024-02-03",0,0,0,0,0,0,0,0
"Slovenia","2024-02-04",0,0,0,0,0,0,0,0
"Slovenia","2024-02-05",0,0,0,0,0,0,0,0
"Slovenia","2024-02-06",0,0,0,0,0,0,0,0
"Slovenia","2024-02-07",0,0,0,0,0,0,0,0
"Slovenia","2024-02-08",0,0,0,0,0,0,0,0
"Slovenia","2024-02-09",0,0,0,0,0,0,0,0
"Slovenia","2024-02-10",0,0,0,0,0,0,0,0
"Slovenia","2024-02-11",0,0,0,0,0,0,0,0
"Slovenia","2024-02-12",0,0,0,0,0,0,0,0
"Slovenia","2024-02-13",0,0,0,0,0,0,0,0
"Slovenia","2024-02-14",0,0,0,0,0,0,0,0
"Slovenia","2024-02-15",0,0,0,0,0,0,0,0
"Slovenia","2024-02-16",0,0,0,0,0,0,0,0
"Slovenia","2024-02-17",0,0,0,0,0,0,0,0
"Slovenia","2024-02-18",0,0,0,0,0,0,0,0
"Slovenia","2024-02-19",0,0,0,0,0,0,0,0
"Slovenia","2024-02-20",0,0,0,0,0,0,0,0
"Slovenia","2024-02-21",0,0,0,0,0,0,0,0
"Slovenia","2024-02-22",0,0,0,0,0,0,0,0
"Slovenia","2024-02-23",0,0,0,0,0,0,0,0
"Slovenia","2024-02-24",0,0,0,0,0,0,0,0
"Slovenia","2024-02-25",0,0,0,0,0,0,0,0
"Slovenia","2024-02-26",0,0,0,0,0,0,0,0
"Slovenia","2024-02-27",0,0,0,0,0,0,0,0
"Slovenia","2024-02-28",0,0,0,0,0,0,0,0
"Slovenia","2024-02-29",0,0,0,0,0,0,0,0
"Slovenia","2024-03-01",0,0,0,0,0,0,0,0
"Slovenia","2024-03-02",0,0,0,0,0,0,0,0
"Slovenia","2024-03-03",0,0,0,0,0,0,0,0
"Slovenia","2024-03-04",0,0,0,0,0,0,0,0
"Slovenia","2024-03-05",0,0,0,0,0,0,0,0
"Slovenia","2024-03-06",0,0,0,0,0,0,0,0
"Slovenia","2024-03-07",0,0,0,0,0,0,0,0
"Slovenia","2024-03-08",0,0,0,0,0,0,0,0
"Slovenia","2024-03-09",0,0,0,0,0,0,0,0
"Slovenia","2024-03-10",0,0,0,0,0,0,0,0
"Slovenia","2024-03-11",0,0,0,0,0,0,0,0
"Slovenia","2024-03-12",0,0,0,0,0,0,0,0
"Slovenia","2024-03-13",0,0,0,0,0,0,0,0
"Slovenia","2024-03-14",0,0,0,0,0,0,0,0
"Slovenia","2024-03-15",0,0,0,0,0,0,0,0
"Slovenia","2024-03-16",0,0,0,0,0,0,0,0
"Slovenia","2024-03-17",0,0,0,0,0,0,0,0
"Slovenia","2024-03-18",0,0,0,0,0,0,0,0
"Slovenia","2024-03-19",0,0,0,0,0,0,0,0
"Slovenia","2024-03-20",0,0,0,0,0,0,0,0
"Slovenia","2024-03-21",0,0,0,0,0,0,0,0
"Slovenia","2024-03-22",0,0,0,0,0,0,0,0
"Slovenia","2024-03-23",0,0,0,0,0,0,0,0
"Slovenia","2024-03-24",0,0,0,0,0,0,0,0
"Slovenia","2024-03-25",0,0,0,0,0,0,0,0
"Slovenia","2024-03-26",0,0,0,0,0,0,0,0
"Slovenia","2024-03-27",0,0,0,0,0,0,0,0
"Slovenia","2024-03-28",0,0,0,0,0,0,0,0
"Slovenia","2024-03-29",0,0,0,0,0,0,0,0
"Slovenia","2024-03-30",0,0,0,0,0,0,0,0
"Slovenia","2024-03-31",0,0,0,0,0,0,0,0
"Slovenia","2024-04-01",0,0,0,0,0,0,0,0
"Slovenia","2024-04-02",0,0,0,0,0,0,0,0
"Slovenia","2024-04-03",0,0,0,0,0,0,0,0
"Slovenia","2024-04-04",0,0,0,0,0,0,0,0
"Slovenia","2024-04-05",0,0,0,0,0,0,0,0
"Slovenia","2024-04-06",0,0,0,0,0,0,0,0
"Slovenia","2024-04-07",0,0,0,0,0,0,0,0
"Slovenia","2024-04-08",0,0,0,0,0,0,0,0
"Slovenia","2024-04-09",0,0,0,0,0,0,0,0
"Slovenia","2024-04-10",0,0,0,0,0,0,0,0
"Slovenia","2024-04-11",0,0,0,0,0,0,0,0
"Slovenia","2024-04-12",0,0,0,0,0,0,0,0
"Slovenia","2024-04-13",0,0,0,0,0,0,0,0
"Slovenia","2024-04-14",0,0,0,0,0,0,0,0
"Slovenia","2024-04-15",0,0,0,0,0,0,0,0
"Slovenia","2024-04-16",0,0,0,0,0,0,0,0
"Slovenia","2024-04-17",0,0,0,0,0,0,0,0
"Slovenia","2024-04-18",0,0,0,0,0,0,0,0
"Slovenia","2024-04-19",0,0,0,0,0,0,0,0
"Slovenia","2024-04-20",0,0,0,0,0,0,0,0
"Slovenia","2024-04-21",0,0,0,0,0,0,0,0
"Slovenia","2024-04-22",0,0,0,0,0,0,0,0
"Slovenia","2024-04-23",0,0,0,0,0,0,0,0
"Slovenia","2024-04-24",0,0,0,0,0,0,0,0
"Slovenia","2024-04-25",0,0,0,0,0,0,0,0
"Slovenia","2024-04-26",0,0,0,0,0,0,0,0
"Slovenia","2024-04-27",0,0,0,0,0,0,0,0
"Slovenia","2024-04-28",0,0,0,0,0,0,0,0
"Slovenia","2024-04-29",0,0,0,0,0,0,0,0
"Slovenia","2024-04-30",0,0,0,0,0,0,0,0
"Slovenia","2024-05-01",0,0,0,0,0,0,0,0
"Slovenia","2024-05-02",0,0,0,0,0,0,0,0
"Slovenia","2024-05-03",0,0,0,0,0,0,0,0
"Slovenia","2024-05-04",0,0,0,0,0,0,0,0
"Slovenia","2024-05-05",0,0,0,0,0,0,0,0
"Slovenia","2024-05-06",0,0,0,0,0,0,0,0
"Slovenia","2024-05-07",0,0,0,0,0,0,0,0
"Slovenia","2024-05-08",0,0,0,0,0,0,0,0
"Slovenia","2024-05-09",0,0,0,0,0,0,0,0
"Slovenia","2024-05-10",0,0,0,0,0,0,0,0
"Slovenia","2024-05-11",0,0,0,0,0,0,0,0
"Slovenia","2024-05-12",0,0,0,0,0,0,0,0
"Slovenia","2024-05-13",0,0,0,0,0,0,0,0
"Slovenia","2024-05-14",0,0,0,0,0,0,0,0
"Slovenia","2024-05-15",0,0,0,0,0,0,0,0
"Slovenia","2024-05-16",0,0,0,0,0,0,0,0
"Slovenia","2024-05-17",0,0,0,0,0,0,0,0
"Slovenia","2024-05-18",0,0,0,0,0,0,0,0
"Slovenia","2024-05-19",0,0,0,0,0,0,0,0
"Slovenia","2024-05-20",0,0,0,0,0,0,0,0
"Slovenia","2024-05-21",0,0,0,0,0,0,0,0
"Slovenia","2024-05-22",0,0,0,0,0,0,0,0
"Slovenia","2024-05-23",0,0,0,0,0,0,0,0
"Slovenia","2024-05-24",0,0,0,0,0,0,0,0
"Slovenia","2024-05-25",0,0,0,0,0,0,0,0
"Slovenia","2024-05-26",0,0,0,0,0,0,0,0
"Slovenia","2024-05-27",0,0,0,0,0,0,0,0
"Slovenia","2024-05-28",0,0,0,0,0,0,0,0
"Slovenia","2024-05-29",0,0,0,0,0,0,0,0
"Slovenia","2024-05-30",0,0,0,0,0,0,0,0
"Slovenia","2024-05-31",0,0,0,0,0,0,0,0
"Slovenia","2024-06-01",0,0,0,0,0,0,0,0
"Slovenia","2024-06-02",0,0,0,0,0,0,0,0
"Slovenia","2024-06-03",0,0,0,0,0,0,0,0
"Slovenia","2024-06-04",0,0,0,0,0,0,0,0
"Slovenia","2024-06-05",0,0,0,0,0,0,0,0
"Slovenia","2024-06-06",0,0,0,0,0,0,0,0
"Slovenia","2024-06-07",0,0,0,0,0,0,0,0
"Slovenia","2024-06-08",0,0,0,0,0,0,0,0
"Slovenia","2024-06-09",0,0,0,0,0,0,0,0
"Slovenia","2024-06-10",0,0,0,0,0,0,0,0
"Slovenia","2024-06-11",0,0,0,0,0,0,0,0
"Slovenia","2024-06-12",0,0,0,0,0,0,0,0
"Slovenia","2024-06-13",0,0,0,0,0,0,0,0
"Slovenia","2024-06-14",0,0,0,0,0,0,0,0
"Slovenia","2024-06-15",0,0,0,0,0,0,0,0
"Slovenia","2024-06-16",0,0,0,0,0,0,0,0
"Slovenia","2024-06-17",0,0,0,0,0,0,0,0
"Slovenia","2024-06-18",0,0,0,0,0,0,0,0
"Slovenia","2024-06-19",0,0,0,0,0,0,0,0
"Slovenia","2024-06-20",0,0,0,0,0,0,0,0
"Slovenia","2024-06-21",0,0,0,0,0,0,0,0
"Slovenia","2024-06-22",0,0,0,0,0,0,0,0
"Slovenia","2024-06-23",0,0,0,0,0,0,0,0
"Slovenia","2024-06-24",0,0,0,0,0,0,0,0
"Slovenia","2024-06-25",0,0,0,0,0,0,0,0
"Slovenia","2024-06-26",0,0,0,0,0,0,0,0
"Slovenia","2024-06-27",0,0,0,0,0,0,0,0
"Slovenia","2024-06-28",0,0,0,0,0,0,0,0
"Slovenia","2024-06-29",0,0,0,0,0,0,0,0
"Slovenia","2024-06-30",0,0,0,0,0,0,0,0
"Slovenia","2024-07-01",0,0,0,0,0,0,0,0
"Slovenia","2024-07-02",0,0,0,0,0,0,0,0
"Slovenia","2024-07-03",0,0,0,0,0,0,0,0
"Slovenia","2024-07-04",0,0,0,0,0,0,0,0
"Slovenia","2024-07-05",0,0,0,0,0,0,0,0
"Slovenia","2024-07-06",0,0,0,0,0,0,0,0
"Slovenia","2024-07-07",0,0,0,0,0,0,0,0
"Slovenia","2024-07-08",0,0,0,0,0,0,0,0
"Slovenia","2024-07-09",0,0,0,0,0,0,0,0
"Slovenia","2024-07-10",0,0,0,0,0,0,0,0
"Slovenia","2024-07-11",0,0,0,0,0,0,0,0
"Slovenia","2024-07-12",0,0,0,0,0,0,0,0
"Slovenia","2024-07-13",0,0,0,0,0,0,0,0
"Slovenia","2024-07-14",0,0,0,0,0,0,0,0
"Slovenia","2024-07-15",0,0,0,0,0,0,0,0
"Slovenia","2024-07-16",0,0,0,0,0,0,0,0
"Slovenia","2024-07-17",0,0,0,0,0,0,0,0
"Slovenia","2024-07-18",0,0,0,0,0,0,0,0
"Slovenia","2024-07-19",0,0,0,0,0,0,0,0
"Slovenia","2024-07-20",0,0,0,0,0,0,0,0
"Slovenia","2024-07-21",0,0,0,0,0,0,0,0
"Slovenia","2024-07-22",0,0,0,0,0,0,0,0
"Slovenia","2024-07-23",0,0,0,0,0,0,0,0
"Slovenia","2024-07-24",0,0,0,0,0,0,0,0
"Slovenia","2024-07-25",0,0,0,0,0,0,0,0
"Slovenia","2024-07-26",0,0,0,0,0,0,0,0
"Slovenia","2024-07-27",0,0,0,0,0,0,0,0
"Slovenia","2024-07-28",0,0,0,0,0,0,0,0
"Slovenia","2024-07-29",0,0,0,0,0,0,0,0
"Slovenia","2024-07-30",0,0,0,0,0,0,0,0
"Slovenia","2024-07-31",0,0,0,0,0,0,0,0
"Slovenia","2024-08-01",0,0,0,0,0,0,0,0
"Slovenia","2024-08-02",0,0,0,0,0,0,0,0
"Slovenia","2024-08-03",0,0,0,0,0,0,0,0
"Slovenia","2024-08-04",0,0,0,0,0,0,0,0
"Slovenia","2024-08-05",0,0,0,0,0,0,0,0
"Slovenia","2024-08-06",0,0,0,0,0,0,0,0
"Slovenia","2024-08-07",0,0,0,0,0,0,0,0
"Slovenia","2024-08-08",0,0,0,0,0,0,0,0
"Slovenia","2024-08-09",0,0,0,0,0,0,0,0
"Slovenia","2024-08-10",0,0,0,0,0,0,0,0
"Slovenia","2024-08-11",0,0,0,0,0,0,0,0
"Slovenia","2024-08-12",0,0,0,0,0,0,0,0
"Slovenia","2024-08-13",0,0,0,0,0,0,0,0
"Slovenia","2024-08-14",0,0,0,0,0,0,0,0
"Slovenia","2024-08-15",0,0,0,0,0,0,0,0
"Slovenia","2024-08-16",0,0,0,0,0,0,0,0
"Slovenia","2024-08-17",0,0,0,0,0,0,0,0
"Slovenia","2024-08-18",0,0,0,0,0,0,0,0
"Slovenia","2024-08-19",0,0,0,0,0,0,0,0
"Slovenia","2024-08-20",0,0,0,0,0,0,0,0
"Slovenia","2024-08-21",0,0,0,0,0,0,0,0
"Slovenia","2024-08-22",0,0,0,0,0,0,0,0
"Slovenia","2024-08-23",0,0,0,0,0,0,0,0
"Slovenia","2024-08-24",0,0,0,0,0,0,0,0
"Slovenia","2024-08-25",0,0,0,0,0,0,0,0
"Slovenia","2024-08-26",0,0,0,0,0,0,0,0
"Slovenia","2024-08-27",0,0,0,0,0,0,0,0
"Slovenia","2024-08-28",0,0,0,0,0,0,0,0
"Slovenia","2024-08-29",0,0,0,0,0,0,0,0
"Slovenia","2024-08-30",0,0,0,0,0,0,0,0
"Slovenia","2024-08-31",0,0,0,0,0,0,0,0
"Slovenia","2024-09-01",0,0,0,0,0,0,0,0
"Slovenia","2024-09-02",0,0,0,0,0,0,0,0
"Slovenia","2024-09-03",0,0,0,0,0,0,0,0
"Slovenia","2024-09-04",0,0,0,0,0,0,0,0
"Slovenia","2024-09-05",0,0,0,0,0,0,0,0
"Slovenia","2024-09-06",0,0,0,0,0,0,0,0
"Slovenia","2024-09-07",0,0,0,0,0,0,0,0
"Slovenia","2024-09-08",0,0,0,0,0,0,0,0
"Slovenia","2024-09-09",0,0,0,0,0,0,0,0
"Slovenia","2024-09-10",0,0,0,0,0,0,0,0
"Slovenia","2024-09-11",0,0,0,0,0,0,0,0
"Slovenia","2024-09-12",0,0,0,0,0,0,0,0
"Slovenia","2024-09-13",0,0,0,0,0,0,0,0
"Slovenia","2024-09-14",0,0,0,0,0,0,0,0
"Slovenia","2024-09-15",0,0,0,0,0,0,0,0
"Slovenia","2024-09-16",0,0,0,0,0,0,0,0
"Slovenia","2024-09-17",0,0,0,0,0,0,0,0
"Slovenia","2024-09-18",0,0,0,0,0,0,0,0
"Slovenia","2024-09-19",0,0,0,0,0,0,0,0
"Slovenia","2024-09-20",0,0,0,0,0,0,0,0
"Slovenia","2024-09-21",0,0,0,0,0,0,0,0
"Slovenia","2024-09-22",0,0,0,0,0,0,0,0
"Slovenia","2024-09-23",0,0,0,0,0,0,0,0
"Slovenia","2024-09-24",0,0,0,0,0,0,0,0
"Slovenia","2024-09-25",0,0,0,0,0,0,0,0
"Slovenia","2024-09-26",0,0,0,0,0,0,0,0
"Slovenia","2024-09-27",0,0,0,0,0,0,0,0
"Slovenia","2024-09-28",0,0,0,0,0,0,0,0
"Slovenia","2024-09-29",0,0,0,0,0,0,0,0
"Slovenia","2024-09-30",0,0,0,0,0,0,0,0
"Slovenia","2024-10-01",0,0,0,0,0,0,0,0
"Slovenia","2024-10-02",0,0,0,0,0,0,0,0
"Slovenia","2024-10-03",0,0,0,0,0,0,0,0
"Slovenia","2024-10-04",0,0,0,0,0,0,0,0
"Slovenia","2024-10-05",0,0,0,0,0,0,0,0
"Slovenia","2024-10-06",0,0,0,0,0,0,0,0
"Slovenia","2024-10-07",0,0,0,0,0,0,0,0
"Slovenia","2024-10-08",0,0,0,0,0,0,0,0
"Slovenia","2024-10-09",0,0,0,0,0,0,0,0
"Slovenia","2024-10-10",0,0,0,0,0,0,0,0
"Slovenia","2024-10-11",0,0,0,0,0,0,0,0
"Slovenia","2024-10-12",0,0,0,0,0,0,0,0
"Slovenia","2024-10-13",0,0,0,0,0,0,0,0
"Slovenia","2024-10-14",0,0,0,0,0,0,0,0
"Slovenia","2024-10-15",0,0,0,0,0,0,0,0
"Slovenia","2024-10-16",0,0,0,0,0,0,0,0
"Slovenia","2024-10-17",0,0,0,0,0,0,0,0
"Slovenia","2024-10-18",0,0,0,0,0,0,0,0
"Slovenia","2024-10-19",0,0,0,0,0,0,0,0
"Slovenia","2024-10-20",0,0,0,0,0,0,0,0
"Slovenia","2024-10-21",0,0,0,0,0,0,0,0
"Slovenia","2024-10-22",0,0,0,0,0,0,0,0
"Slovenia","2024-10-23",0,0,0,0,0,0,0,0
"Slovenia","2024-10-24",0,0,0,0,0,0,0,0
"Slovenia","2024-10-25",0,0,0,0,0,0,0,0
"Slovenia","2024-10-26",0,0,0,0,0,0,0,0
"Slovenia","2024-10-27",0,0,0,0,0,0,0,0
"Slovenia","2024-10-28",0,0,0,0,0,0,0,0
"Slovenia","2024-10-29",0,0,0,0,0,0,0,0
"Slovenia","2024-10-30",0,0,0,0,0,0,0,0
"Slovenia","2024-10-31",0,0,0,0,0,0,0,0
"Slovenia","2024-11-01",0,0,0,0,0,0,0,0
"Slovenia","2024-11-02",0,0,0,0,0,0,0,0
"Slovenia","2024-11-03",0,0,0,0,0,0,0,0
"Slovenia","2024-11-04",0,0,0,0,0,0,0,0
"Slovenia","2024-11-05",0,0,0,0,0,0,0,0
"Slovenia","2024-11-06",0,0,0,0,0,0,0,0
"Slovenia","2024-11-07",0,0,0,0,0,0,0,0
"Slovenia","2024-11-08",0,0,0,0,0,0,0,0
"Slovenia","2024-11-09",0,0,0,0,0,0,0,0
"Slovenia","2024-11-10",0,0,0,0,0,0,0,0
"Slovenia","2024-11-11",0,0,0,0,0,0,0,0
"Slovenia","2024-11-12",0,0,0,0,0,0,0,0
"Slovenia","2024-11-13",0,0,0,0,0,0,0,0
"Slovenia","2024-11-14",0,0,0,0,0,0,0,0
"Slovenia","2024-11-15",0,0,0,0,0,0,0,0
"Slovenia","2024-11-16",0,0,0,0,0,0,0,0
"Slovenia","2024-11-17",0,0,0,0,0,0,0,0
"Slovenia","2024-11-18",0,0,0,0,0,0,0,0
"Slovenia","2024-11-19",0,0,0,0,0,0,0,0
"Slovenia","2024-11-20",0,0,0,0,0,0,0,0
"Slovenia","2024-11-21",0,0,0,0,0,0,0,0
"Slovenia","2024-11-22",0,0,0,0,0,0,0,0
"Slovenia","2024-11-23",0,0,0,0,0,0,0,0
"Slovenia","2024-11-24",0,0,0,0,0,0,0,0
"Slovenia","2024-11-25",0,0,0,0,0,0,0,0
"Slovenia","2024-11-26",0,0,0,0,0,0,0,0
"Slovenia","2024-11-27",0,0,0,0,0,0,0,0
"Slovenia","2024-11-28",0,0,0,0,0,0,0,0
"Slovenia","2024-11-29",0,0,0,0,0,0,0,0
"Slovenia","2024-11-30",0,0,0,0,0,0,0,0
"Slovenia","2024-12-01",0,0,0,0,0,0,0,0
"Slovenia","2024-12-02",0,0,0,0,0,0,0,0
"Slovenia","2024-12-03",0,0,0,0,0,0,0,0
"Slovenia","2024-12-04",0,0,0,0,0,0,0,0
"Slovenia","2024-12-05",0,0,0,0,0,0,0,0
"Slovenia","2024-12-06",0,0,0,0,0,0,0,0
"Slovenia","2024-12-07",0,0,0,0,0,0,0,0
"Slovenia","2024-12-08",0,0,0,0,0,0,0,0
"Slovenia","2024-12-09",0,0,0,0,0,0,0,0
"Slovenia","2024-12-10",0,0,0,0,0,0,0,0
"Slovenia","2024-12-11",0,0,0,0,0,0,0,0
"Slovenia","2024-12-12",0,0,0,0,0,0,0,0
"Slovenia","2024-12-13",0,0,0,0,0,0,0,0
"Slovenia","2024-12-14",0,0,0,0,0,0,0,0
"Slovenia","2024-12-15",0,0,0,0,0,0,0,0
"Slovenia","2024-12-16",0,0,0,0,0,0,0,0
"Slovenia","2024-12-17",0,0,0,0,0,0,0,0
"Slovenia","2024-12-18",0,0,0,0,0,0,0,0
"Slovenia","2024-12-19",0,0,0,0,0,0,0,0
"Slovenia","2024-12-20",0,0,0,0,0,0,0,0
"Slovenia","2024-12-21",0,0,0,0,0,0,0,0
"Slovenia","2024-12-22",0,0,0,0,0,0,0,0
"Slovenia","2024-12-23",0,0,0,0,0,0,0,0
"Slovenia","2024-12-24",0,0,0,0,0,0,0,0
"Slovenia","2024-12-25",0,0,0,0,0,0,0,0
"Slovenia","2024-12-26",0,0,0,0,0,0,0,0
"Slovenia","2024-12-27",0,0,0,0,0,0,0,0
"Slovenia","2024-12-28",0,0,0,0,0,0,0,0
"Slovenia","2024-12-29",0,0,0,0,0,0,0,0
"Slovenia","2024-12-30",0,0,0,0,0,0,0,0
"Slovenia","2024-12-31",0,0,0,0,0,0,0,0
"Slovenia","2025-01-01",0,0,0,0,0,0,0,0
"Slovenia","2025-01-02",0,0,0,0,0,0,0,0
"Slovenia","2025-01-03",0,0,0,0,0,0,0,0
"Slovenia","2025-01-04",0,0,0,0,0,0,0,0
"Slovenia","2025-01-05",0,0,0,0,0,0,0,0
"Slovenia","2025-01-06",0,0,0,0,0,0,0,0
"Slovenia","2025-01-07",0,0,0,0,0,0,0,0
"Slovenia","2025-01-08",0,0,0,0,0,0,0,0
"Slovenia","2025-01-09",0,0,0,0,0,0,0,0
"Slovenia","2025-01-10",0,0,0,0,0,0,0,0
"Slovenia","2025-01-11",0,0,0,0,0,0,0,0
"Slovenia","2025-01-12",0,0,0,0,0,0,0,0
"Slovenia","2025-01-13",0,0,0,0,0,0,0,0
"Slovenia","2025-01-14",0,0,0,0,0,0,0,0
"Slovenia","2025-01-15",0,0,0,0,0,0,0,0
"Slovenia","2025-01-16",0,0,0,0,0,0,0,0
"Slovenia","2025-01-17",0,0,0,0,0,0,0,0
"Slovenia","2025-01-18",0,0,0,0,0,0,0,0
"Slovenia","2025-01-19",0,0,0,0,0,0,0,0
"Slovenia","2025-01-20",0,0,0,0,0,0,0,0
"Slovenia","2025-01-21",0,0,0,0,0,0,0,0
"Slovenia","2025-01-22",0,0,0,0,0,0,0,0
"Slovenia","2025-01-23",0,0,0,0,0,0,0,0
"Slovenia","2025-01-24",0,0,0,0,0,0,0,0
"Slovenia","2025-01-25",0,0,0,0,0,0,0,0
"Slovenia","2025-01-26",0,0,0,0,0,0,0,0
"Slovenia","2025-01-27",0,0,0,0,0,0,0,0
"Slovenia","2025-01-28",0,0,0,0,0,0,0,0
"Slovenia","2025-01-29",0,0,0,0,0,0,0,0
"Slovenia","2025-01-30",0,0,0,0,0,0,0,0
"Slovenia","2025-01-31",0,0,0,0,0,0,0,0
"Slovenia","2025-02-01",0,0,0,0,0,0,0,0
"Slovenia","2025-02-02",0,0,0,0,0,0,0,0
"Slovenia","2025-02-03",0,0,0,0,0,0,0,0
"South Africa","2024-01-01",0,0,0,0,0,0,0,0
"South Africa","2024-01-02",0,0,0,0,0,0,0,0
"South Africa","2024-01-03",0,0,0,0,0,0,0,0
"South Africa","2024-01-04",0,0,0,0,0,0,0,0
"South Africa","2024-01-05",0,0,0,0,0,0,0,0
"South Africa","2024-01-06",0,0,0,0,0,0,0,0
"South Africa","2024-01-07",0,0,0,0,0,0,0,0
"South Africa","2024-01-08",0,0,0,0,0,0,0,0
"South Africa","2024-01-09",0,0,0,0,0,0,0,0
"South Africa","2024-01-10",0,0,0,0,0,0,0,0
"South Africa","2024-01-11",0,0,0,0,0,0,0,0
"South Africa","2024-01-12",0,0,0,0,0,0,0,0
"South Africa","2024-01-13",0,0,0,0,0,0,0,0
"South Africa","2024-01-14",0,0,0,0,0,0,0,0
"South Africa","2024-01-15",0,0,0,0,0,0,0,0
"South Africa","2024-01-16",0,0,0,0,0,0,0,0
"South Africa","2024-01-17",0,0,0,0,0,0,0,0
"South Africa","2024-01-18",0,0,0,0,0,0,0,0
"South Africa","2024-01-19",0,0,0,0,0,0,0,0
"South Africa","2024-01-20",0,0,0,0,0,0,0,0
"South Africa","2024-01-21",0,0,0,0,0,0,0,0
"South Africa","2024-01-22",0,0,0,0,0,0,0,0
"South Africa","2024-01-23",0,0,0,0,0,0,0,0
"South Africa","2024-01-24",0,0,0,0,0,0,0,0
"South Africa","2024-01-25",0,0,0,0,0,0,0,0
"South Africa","2024-01-26",0,0,0,0,0,0,0,0
"South Africa","2024-01-27",0,0,0,0,0,0,0,0
"South Africa","2024-01-28",0,0,0,0,0,0,0,0
"South Africa","2024-01-29",0,0,0,0,0,0,0,0
"South Africa","2024-01-30",0,0,0,0,0,0,0,0
"South Africa","2024-01-31",0,0,0,0,0,0,0,0
"South Africa","2024-02-01",0,0,0,0,0,0,0,0
"South Africa","2024-02-02",0,0,0,0,0,0,0,0
"South Africa","2024-02-03",0,0,0,0,0,0,0,0
"South Africa","2024-02-04",0,0,0,0,0,0,0,0
"South Africa","2024-02-05",0,0,0,0,0,0,0,0
"South Africa","2024-02-06",0,0,0,0,0,0,0,0
"South Africa","2024-02-07",0,0,0,0,0,0,0,0
"South Africa","2024-02-08",0,0,0,0,0,0,0,0
"South Africa","2024-02-09",0,0,0,0,0,0,0,0
"South Africa","2024-02-10",0,0,0,0,0,0,0,0
"South Africa","2024-02-11",0,0,0,0,0,0,0,0
"South Africa","2024-02-12",0,0,0,0,0,0,0,0
"South Africa","2024-02-13",0,0,0,0,0,0,0,0
"South Africa","2024-02-14",0,0,0,0,0,0,0,0
"South Africa","2024-02-15",0,0,0,0,0,0,0,0
"South Africa","2024-02-16",0,0,0,0,0,0,0,0
"South Africa","2024-02-17",0,0,0,0,0,0,0,0
"South Africa","2024-02-18",0,0,0,0,0,0,0,0
"South Africa","2024-02-19",0,0,0,0,0,0,0,0
"South Africa","2024-02-20",0,0,0,0,0,0,0,0
"South Africa","2024-02-21",0,0,0,0,0,0,0,0
"South Africa","2024-02-22",0,0,0,0,0,0,0,0
"South Africa","2024-02-23",0,0,0,0,0,0,0,0
"South Africa","2024-02-24",0,0,0,0,0,0,0,0
"South Africa","2024-02-25",0,0,0,0,0,0,0,0
"South Africa","2024-02-26",0,0,0,0,0,0,0,0
"South Africa","2024-02-27",0,0,0,0,0,0,0,0
"South Africa","2024-02-28",0,0,0,0,0,0,0,0
"South Africa","2024-02-29",0,0,0,0,0,0,0,0
"South Africa","2024-03-01",0,0,0,0,0,0,0,0
"South Africa","2024-03-02",0,0,0,0,0,0,0,0
"South Africa","2024-03-03",0,0,0,0,0,0,0,0
"South Africa","2024-03-04",0,0,0,0,0,0,0,0
"South Africa","2024-03-05",0,0,0,0,0,0,0,0
"South Africa","2024-03-06",0,0,0,0,0,0,0,0
"South Africa","2024-03-07",0,0,0,0,0,0,0,0
"South Africa","2024-03-08",0,0,0,0,0,0,0,0
"South Africa","2024-03-09",0,0,0,0,0,0,0,0
"South Africa","2024-03-10",0,0,0,0,0,0,0,0
"South Africa","2024-03-11",0,0,0,0,0,0,0,0
"South Africa","2024-03-12",0,0,0,0,0,0,0,0
"South Africa","2024-03-13",0,0,0,0,0,0,0,0
"South Africa","2024-03-14",0,0,0,0,0,0,0,0
"South Africa","2024-03-15",0,0,0,0,0,0,0,0
"South Africa","2024-03-16",0,0,0,0,0,0,0,0
"South Africa","2024-03-17",0,0,0,0,0,0,0,0
"South Africa","2024-03-18",0,0,0,0,0,0,0,0
"South Africa","2024-03-19",0,0,0,0,0,0,0,0
"South Africa","2024-03-20",0,0,0,0,0,0,0,0
"South Africa","2024-03-21",0,0,0,0,0,0,0,0
"South Africa","2024-03-22",0,0,0,0,0,0,0,0
"South Africa","2024-03-23",0,0,0,0,0,0,0,0
"South Africa","2024-03-24",0,0,0,0,0,0,0,0
"South Africa","2024-03-25",0,0,0,0,0,0,0,0
"South Africa","2024-03-26",0,0,0,0,0,0,0,0
"South Africa","2024-03-27",0,0,0,0,0,0,0,0
"South Africa","2024-03-28",0,0,0,0,0,0,0,0
"South Africa","2024-03-29",0,0,0,0,0,0,0,0
"South Africa","2024-03-30",0,0,0,0,0,0,0,0
"South Africa","2024-03-31",0,0,0,0,0,0,0,0
"South Africa","2024-04-01",0,0,0,0,0,0,0,0
"South Africa","2024-04-02",0,0,0,0,0,0,0,0
"South Africa","2024-04-03",0,0,0,0,0,0,0,0
"South Africa","2024-04-04",0,0,0,0,0,0,0,0
"South Africa","2024-04-05",0,0,0,0,0,0,0,0
"South Africa","2024-04-06",0,0,0,0,0,0,0,0
"South Africa","2024-04-07",0,0,0,0,0,0,0,0
"South Africa","2024-04-08",0,0,0,0,0,0,0,0
"South Africa","2024-04-09",0,0,0,0,0,0,0,0
"South Africa","2024-04-10",0,0,0,0,0,0,0,0
"South Africa","2024-04-11",0,0,0,0,0,0,0,0
"South Africa","2024-04-12",0,0,0,0,0,0,0,0
"South Africa","2024-04-13",0,0,0,0,0,0,0,0
"South Africa","2024-04-14",0,0,0,0,0,0,0,0
"South Africa","2024-04-15",0,0,0,0,0,0,0,0
"South Africa","2024-04-16",0,0,0,0,0,0,0,0
"South Africa","2024-04-17",0,0,0,0,0,0,0,0
"South Africa","2024-04-18",0,0,0,0,0,0,0,0
"South Africa","2024-04-19",0,0,0,0,0,0,0,0
"South Africa","2024-04-20",0,0,0,0,0,0,0,0
"South Africa","2024-04-21",0,0,0,0,0,0,0,0
"South Africa","2024-04-22",0,0,0,0,0,0,0,0
"South Africa","2024-04-23",0,0,0,0,0,0,0,0
"South Africa","2024-04-24",0,0,0,0,0,0,0,0
"South Africa","2024-04-25",0,0,0,0,0,0,0,0
"South Africa","2024-04-26",0,0,0,0,0,0,0,0
"South Africa","2024-04-27",0,0,0,0,0,0,0,0
"South Africa","2024-04-28",0,0,0,0,0,0,0,0
"South Africa","2024-04-29",0,0,0,0,0,0,0,0
"South Africa","2024-04-30",0,0,0,0,0,0,0,0
"South Africa","2024-05-01",0,0,0,0,0,0,0,0
"South Africa","2024-05-02",0,0,0,0,0,0,0,0
"South Africa","2024-05-03",0,0,0,0,0,0,0,0
"South Africa","2024-05-04",0,0,0,0,0,0,0,0
"South Africa","2024-05-05",0,0,0,0,0,0,0,0
"South Africa","2024-05-06",0,0,0,0,0,0,0,0
"South Africa","2024-05-07",0,0,0,0,0,0,0,0
"South Africa","2024-05-08",0,0,0,0,0,0,0,0
"South Africa","2024-05-09",0,0,0,0,0,0,0,0
"South Africa","2024-05-10",0,0,0,0,0,0,0,0
"South Africa","2024-05-11",0,0,0,0,0,0,0,0
"South Africa","2024-05-12",0,1,1,0,1,1,0,0
"South Africa","2024-05-13",0,0,1,0,0,1,0,0
"South Africa","2024-05-14",0,0,1,0,0,1,0,0
"South Africa","2024-05-15",0,0,1,0,0,1,0,0
"South Africa","2024-05-16",0,0,1,0,0,1,0,0
"South Africa","2024-05-17",0,0,1,0,0,1,0,0
"South Africa","2024-05-18",0,0,1,0,0,1,0,0
"South Africa","2024-05-19",0,0,1,0,0,1,0,0
"South Africa","2024-05-20",0,0,1,0,1,2,0,0
"South Africa","2024-05-21",0,0,1,0,0,2,0,0
"South Africa","2024-05-22",0,0,1,0,0,2,0,0
"South Africa","2024-05-23",0,0,1,0,0,2,0,0
"South Africa","2024-05-24",0,0,1,0,0,2,0,0
"South Africa","2024-05-25",0,0,1,0,0,2,0,0
"South Africa","2024-05-26",0,1,2,0,0,2,0,0
"South Africa","2024-05-27",0,0,2,0,0,2,0,0
"South Africa","2024-05-28",0,0,2,0,0,2,0,0
"South Africa","2024-05-29",0,0,2,0,0,2,0,0
"South Africa","2024-05-30",0,0,2,0,1,3,0,0
"South Africa","2024-05-31",0,0,2,0,0,3,0,0
"South Africa","2024-06-01",0,0,2,0,0,3,0,0
"South Africa","2024-06-02",0,1,3,0,0,3,0,0
"South Africa","2024-06-03",0,0,3,0,0,3,0,0
"South Africa","2024-06-04",0,0,3,0,1,4,0,0
"South Africa","2024-06-05",0,0,3,0,0,4,0,0
"South Africa","2024-06-06",0,0,3,0,0,4,0,0
"South Africa","2024-06-07",0,0,3,0,0,4,0,0
"South Africa","2024-06-08",0,0,3,0,1,5,0,0
"South Africa","2024-06-09",0,2,5,0,0,5,0,0
"South Africa","2024-06-10",0,0,5,0,1,6,0,0
"South Africa","2024-06-11",0,0,5,0,1,7,0,0
"South Africa","2024-06-12",0,0,5,0,1,8,0,0
"South Africa","2024-06-13",0,0,5,0,1,9,0,0
"South Africa","2024-06-14",0,0,5,0,1,10,0,0
"South Africa","2024-06-15",0,0,5,0,1,11,0,0
"South Africa","2024-06-16",0,7,12,0,1,12,0,0
"South Africa","2024-06-17",0,0,12,0,1,13,0,0
"South Africa","2024-06-18",0,0,12,0,0,13,0,0
"South Africa","2024-06-19",0,0,12,0,1,14,0,0
"South Africa","2024-06-20",0,0,12,0,0,14,0,0
"South Africa","2024-06-21",0,0,12,0,1,15,0,0
"South Africa","2024-06-22",0,0,12,0,0,15,0,0
"South Africa","2024-06-23",0,4,16,0,1,16,0,0
"South Africa","2024-06-24",0,0,16,0,0,16,0,0
"South Africa","2024-06-25",0,0,16,0,1,17,0,0
"South Africa","2024-06-26",0,0,16,0,0,17,0,0
"South Africa","2024-06-27",0,0,16,0,0,17,0,0
"South Africa","2024-06-28",0,0,16,0,0,17,0,0
"South Africa","2024-06-29",0,0,16,0,1,18,0,0
"South Africa","2024-06-30",0,0,16,0,0,18,0,0
"South Africa","2024-07-01",0,0,16,0,0,18,0,0
"South Africa","2024-07-02",0,0,16,0,1,19,0,0
"South Africa","2024-07-03",0,0,16,0,0,19,0,0
"South Africa","2024-07-04",0,0,16,0,0,19,0,0
"South Africa","2024-07-05",0,0,16,0,0,19,0,0
"South Africa","2024-07-06",0,0,16,0,1,20,0,0
"South Africa","2024-07-07",0,4,20,0,0,20,0,0
"South Africa","2024-07-08",0,0,20,0,0,20,0,0
"South Africa","2024-07-09",0,0,20,0,1,21,0,0
"South Africa","2024-07-10",0,0,20,0,0,21,0,0
"South Africa","2024-07-11",0,0,20,0,0,21,0,0
"South Africa","2024-07-12",0,0,20,0,0,21,0,0
"South Africa","2024-07-13",0,0,20,0,1,22,0,0
"South Africa","2024-07-14",0,2,22,0,0,22,0,0
"South Africa","2024-07-15",0,0,22,0,0,22,0,0
"South Africa","2024-07-16",0,0,22,0,0,22,0,0
"South Africa","2024-07-17",0,0,22,0,0,22,0,0
"South Africa","2024-07-18",0,0,22,0,0,22,0,0
"South Africa","2024-07-19",0,0,22,0,0,22,0,0
"South Africa","2024-07-20",0,0,22,0,1,23,0,0
"South Africa","2024-07-21",0,0,22,0,0,23,0,0
"South Africa","2024-07-22",0,0,22,0,0,23,0,0
"South Africa","2024-07-23",0,0,22,0,0,23,0,0
"South Africa","2024-07-24",0,0,22,0,0,23,0,0
"South Africa","2024-07-25",0,0,22,0,0,23,0,0
"South Africa","2024-07-26",0,0,22,0,0,23,0,0
"South Africa","2024-07-27",0,0,22,0,0,23,0,0
"South Africa","2024-07-28",0,0,22,0,0,23,0,0
"South Africa","2024-07-29",0,0,22,0,0,23,0,0
"South Africa","2024-07-30",0,0,22,0,1,24,0,0
"South Africa","2024-07-31",0,0,22,0,0,24,0,0
"South Africa","2024-08-01",0,0,22,0,0,24,0,0
"South Africa","2024-08-02",0,0,22,0,0,24,0,0
"South Africa","2024-08-03",0,0,22,0,0,24,0,0
"South Africa","2024-08-04",0,2,24,0,0,24,0,0
"South Africa","2024-08-05",0,0,24,0,0,24,0,0
"South Africa","2024-08-06",0,0,24,0,0,24,0,0
"South Africa","2024-08-07",0,0,24,0,0,24,0,0
"South Africa","2024-08-08",0,0,24,0,0,24,0,0
"South Africa","2024-08-09",0,0,24,0,0,24,0,0
"South Africa","2024-08-10",0,0,24,0,0,24,0,0
"South Africa","2024-08-11",0,0,24,0,0,24,0,0
"South Africa","2024-08-12",0,0,24,0,0,24,0,0
"South Africa","2024-08-13",0,0,24,0,0,24,0,0
"South Africa","2024-08-14",0,0,24,0,0,24,0,0
"South Africa","2024-08-15",0,0,24,0,0,24,0,0
"South Africa","2024-08-16",0,0,24,0,0,24,0,0
"South Africa","2024-08-17",0,0,24,0,0,24,0,0
"South Africa","2024-08-18",0,0,24,0,0,24,0,0
"South Africa","2024-08-19",0,0,24,0,0,24,0,0
"South Africa","2024-08-20",0,0,24,0,0,24,0,0
"South Africa","2024-08-21",0,0,24,0,0,24,0,0
"South Africa","2024-08-22",0,0,24,0,1,25,0,0
"South Africa","2024-08-23",0,0,24,0,0,25,0,0
"South Africa","2024-08-24",0,0,24,0,0,25,0,0
"South Africa","2024-08-25",0,0,24,0,0,25,0,0
"South Africa","2024-08-26",0,0,24,0,0,25,0,0
"South Africa","2024-08-27",0,0,24,0,0,25,0,0
"South Africa","2024-08-28",0,0,24,0,0,25,0,0
"South Africa","2024-08-29",0,0,24,0,0,25,0,0
"South Africa","2024-08-30",0,0,24,0,0,25,0,0
"South Africa","2024-08-31",0,0,24,0,0,25,0,0
"South Africa","2024-09-01",0,0,24,0,0,25,0,0
"South Africa","2024-09-02",0,0,24,0,0,25,0,0
"South Africa","2024-09-03",0,0,24,0,0,25,0,0
"South Africa","2024-09-04",0,0,24,0,0,25,0,0
"South Africa","2024-09-05",0,0,24,0,0,25,0,0
"South Africa","2024-09-06",0,0,24,0,0,25,0,0
"South Africa","2024-09-07",0,0,24,0,0,25,0,0
"South Africa","2024-09-08",0,1,25,0,0,25,0,0
"South Africa","2024-09-09",0,0,25,0,0,25,0,0
"South Africa","2024-09-10",0,0,25,0,0,25,0,0
"South Africa","2024-09-11",0,0,25,0,0,25,0,0
"South Africa","2024-09-12",0,0,25,0,0,25,0,0
"South Africa","2024-09-13",0,0,25,0,0,25,0,0
"South Africa","2024-09-14",0,0,25,0,0,25,0,0
"South Africa","2024-09-15",0,0,25,0,0,25,0,0
"South Africa","2024-09-16",0,0,25,0,0,25,0,0
"South Africa","2024-09-17",0,0,25,0,0,25,0,0
"South Africa","2024-09-18",0,0,25,0,0,25,0,0
"South Africa","2024-09-19",0,0,25,0,0,25,0,0
"South Africa","2024-09-20",0,0,25,0,0,25,0,0
"South Africa","2024-09-21",0,0,25,0,0,25,0,0
"South Africa","2024-09-22",0,0,25,0,0,25,0,0
"South Africa","2024-09-23",0,0,25,0,0,25,0,0
"South Africa","2024-09-24",0,0,25,0,0,25,0,0
"South Africa","2024-09-25",0,0,25,0,0,25,0,0
"South Africa","2024-09-26",0,0,25,0,0,25,0,0
"South Africa","2024-09-27",0,0,25,0,0,25,0,0
"South Africa","2024-09-28",0,0,25,0,0,25,0,0
"South Africa","2024-09-29",0,0,25,0,0,25,0,0
"South Africa","2024-09-30",0,0,25,0,0,25,0,0
"South Africa","2024-10-01",0,0,25,0,0,25,0,0
"South Africa","2024-10-02",0,0,25,0,0,25,0,0
"South Africa","2024-10-03",0,0,25,0,0,25,0,0
"South Africa","2024-10-04",0,0,25,0,0,25,0,0
"South Africa","2024-10-05",0,0,25,0,0,25,0,0
"South Africa","2024-10-06",0,0,25,0,0,25,0,0
"South Africa","2024-10-07",0,0,25,0,0,25,0,0
"South Africa","2024-10-08",0,0,25,0,0,25,0,0
"South Africa","2024-10-09",0,0,25,0,0,25,0,0
"South Africa","2024-10-10",0,0,25,0,0,25,0,0
"South Africa","2024-10-11",0,0,25,0,0,25,0,0
"South Africa","2024-10-12",0,0,25,0,0,25,0,0
"South Africa","2024-10-13",0,0,25,0,0,25,0,0
"South Africa","2024-10-14",0,0,25,0,0,25,0,0
"South Africa","2024-10-15",0,0,25,0,0,25,0,0
"South Africa","2024-10-16",0,0,25,0,0,25,0,0
"South Africa","2024-10-17",0,0,25,0,0,25,0,0
"South Africa","2024-10-18",0,0,25,0,0,25,0,0
"South Africa","2024-10-19",0,0,25,0,0,25,0,0
"South Africa","2024-10-20",0,0,25,0,0,25,0,0
"South Africa","2024-10-21",0,0,25,0,0,25,0,0
"South Africa","2024-10-22",0,0,25,0,0,25,0,0
"South Africa","2024-10-23",0,0,25,0,0,25,0,0
"South Africa","2024-10-24",0,0,25,0,0,25,0,0
"South Africa","2024-10-25",0,0,25,0,0,25,0,0
"South Africa","2024-10-26",0,0,25,0,0,25,0,0
"South Africa","2024-10-27",0,0,25,0,0,25,0,0
"South Africa","2024-10-28",0,0,25,0,0,25,0,0
"South Africa","2024-10-29",0,0,25,0,0,25,0,0
"South Africa","2024-10-30",0,0,25,0,0,25,0,0
"South Africa","2024-10-31",0,0,25,0,0,25,0,0
"South Africa","2024-11-01",0,0,25,0,0,25,0,0
"South Africa","2024-11-02",0,0,25,0,0,25,0,0
"South Africa","2024-11-03",0,0,25,0,0,25,0,0
"South Africa","2024-11-04",0,0,25,0,0,25,0,0
"South Africa","2024-11-05",0,0,25,0,0,25,0,0
"South Africa","2024-11-06",0,0,25,0,0,25,0,0
"South Africa","2024-11-07",0,0,25,0,0,25,0,0
"South Africa","2024-11-08",0,0,25,0,0,25,0,0
"South Africa","2024-11-09",0,0,25,0,0,25,0,0
"South Africa","2024-11-10",0,0,25,0,0,25,0,0
"South Africa","2024-11-11",0,0,25,0,0,25,0,0
"South Africa","2024-11-12",0,0,25,0,0,25,0,0
"South Africa","2024-11-13",0,0,25,0,0,25,0,0
"South Africa","2024-11-14",0,0,25,0,0,25,0,0
"South Africa","2024-11-15",0,0,25,0,0,25,0,0
"South Africa","2024-11-16",0,0,25,0,0,25,0,0
"South Africa","2024-11-17",0,0,25,0,0,25,0,0
"South Africa","2024-11-18",0,0,25,0,0,25,0,0
"South Africa","2024-11-19",0,0,25,0,0,25,0,0
"South Africa","2024-11-20",0,0,25,0,0,25,0,0
"South Africa","2024-11-21",0,0,25,0,0,25,0,0
"South Africa","2024-11-22",0,0,25,0,0,25,0,0
"South Africa","2024-11-23",0,0,25,0,0,25,0,0
"South Africa","2024-11-24",0,0,25,0,0,25,0,0
"South Africa","2024-11-25",0,0,25,0,0,25,0,0
"South Africa","2024-11-26",0,0,25,0,0,25,0,0
"South Africa","2024-11-27",0,0,25,0,0,25,0,0
"South Africa","2024-11-28",0,0,25,0,0,25,0,0
"South Africa","2024-11-29",0,0,25,0,0,25,0,0
"South Africa","2024-11-30",0,0,25,0,0,25,0,0
"South Africa","2024-12-01",0,0,25,0,0,25,0,0
"South Africa","2024-12-02",0,0,25,0,0,25,0,0
"South Africa","2024-12-03",0,0,25,0,0,25,0,0
"South Africa","2024-12-04",0,0,25,0,0,25,0,0
"South Africa","2024-12-05",0,0,25,0,0,25,0,0
"South Africa","2024-12-06",0,0,25,0,0,25,0,0
"South Africa","2024-12-07",0,0,25,0,0,25,0,0
"South Africa","2024-12-08",0,0,25,0,0,25,0,0
"South Africa","2024-12-09",0,0,25,0,0,25,0,0
"South Africa","2024-12-10",0,0,25,0,0,25,0,0
"South Africa","2024-12-11",0,0,25,0,0,25,0,0
"South Africa","2024-12-12",0,0,25,0,0,25,0,0
"South Africa","2024-12-13",0,0,25,0,0,25,0,0
"South Africa","2024-12-14",0,0,25,0,0,25,0,0
"South Africa","2024-12-15",0,0,25,0,0,25,0,0
"South Africa","2024-12-16",0,0,25,0,0,25,0,0
"South Africa","2024-12-17",0,0,25,0,0,25,0,0
"South Africa","2024-12-18",0,0,25,0,0,25,0,0
"South Africa","2024-12-19",0,0,25,0,0,25,0,0
"South Africa","2024-12-20",0,0,25,0,0,25,0,0
"South Africa","2024-12-21",0,0,25,0,0,25,0,0
"South Africa","2024-12-22",0,0,25,0,0,25,0,0
"South Africa","2024-12-23",0,0,25,0,0,25,0,0
"South Africa","2024-12-24",0,0,25,0,0,25,0,0
"South Africa","2024-12-25",0,0,25,0,0,25,0,0
"South Africa","2024-12-26",0,0,25,0,0,25,0,0
"South Africa","2024-12-27",0,0,25,0,0,25,0,0
"South Africa","2024-12-28",0,0,25,0,0,25,0,0
"South Africa","2024-12-29",0,0,25,0,0,25,0,0
"South Africa","2024-12-30",0,0,25,0,0,25,0,0
"South Africa","2024-12-31",0,0,25,0,0,25,0,0
"South Africa","2025-01-01",0,0,25,0,0,25,0,0
"South Africa","2025-01-02",0,0,25,0,0,25,0,0
"South Africa","2025-01-03",0,0,25,0,0,25,0,0
"South Africa","2025-01-04",0,0,25,0,0,25,0,0
"South Africa","2025-01-05",0,0,25,0,0,25,0,0
"South Africa","2025-01-06",0,0,25,0,0,25,0,0
"South Africa","2025-01-07",0,0,25,0,0,25,0,0
"South Africa","2025-01-08",0,0,25,0,0,25,0,0
"South Africa","2025-01-09",0,0,25,0,0,25,0,0
"South Africa","2025-01-10",0,0,25,0,0,25,0,0
"South Africa","2025-01-11",0,0,25,0,0,25,0,0
"South Africa","2025-01-12",0,0,25,0,0,25,0,0
"South Africa","2025-01-13",0,0,25,0,0,25,0,0
"South Africa","2025-01-14",0,0,25,0,0,25,0,0
"South Africa","2025-01-15",0,0,25,0,0,25,0,0
"South Africa","2025-01-16",0,0,25,0,0,25,0,0
"South Africa","2025-01-17",0,0,25,0,0,25,0,0
"South Africa","2025-01-18",0,0,25,0,0,25,0,0
"South Africa","2025-01-19",0,0,25,0,0,25,0,0
"South Africa","2025-01-20",0,0,25,0,0,25,0,0
"South Africa","2025-01-21",0,0,25,0,0,25,0,0
"South Africa","2025-01-22",0,0,25,0,0,25,0,0
"South Africa","2025-01-23",0,0,25,0,0,25,0,0
"South Africa","2025-01-24",0,0,25,0,0,25,0,0
"South Africa","2025-01-25",0,0,25,0,0,25,0,0
"South Africa","2025-01-26",0,0,25,0,0,25,0,0
"South Africa","2025-01-27",0,0,25,0,0,25,0,0
"South Africa","2025-01-28",0,0,25,0,0,25,0,0
"South Africa","2025-01-29",0,0,25,0,0,25,0,0
"South Africa","2025-01-30",0,0,25,0,0,25,0,0
"South Africa","2025-01-31",0,0,25,0,0,25,0,0
"South Africa","2025-02-01",0,0,25,0,0,25,0,0
"South Africa","2025-02-02",0,0,25,0,0,25,0,0
"South Africa","2025-02-03",0,0,25,0,0,25,0,0
"South America","2024-01-01",0,0,0,0,0,0,0,0
"South America","2024-01-02",0,61,61,0,61,61,0,0
"South America","2024-01-03",0,0,61,0,7,68,0,0
"South America","2024-01-04",0,0,61,0,7,75,0,0
"South America","2024-01-05",0,0,61,0,7,82,0,0
"South America","2024-01-06",0,0,61,0,8,90,0,0
"South America","2024-01-07",0,0,61,0,7,97,0,0
"South America","2024-01-08",0,0,61,0,7,104,0,0
"South America","2024-01-09",0,50,111,0,7,111,0,0
"South America","2024-01-10",0,0,111,0,7,118,0,0
"South America","2024-01-11",0,0,111,0,8,126,0,0
"South America","2024-01-12",0,0,111,0,7,133,0,0
"South America","2024-01-13",0,0,111,0,7,140,0,0
"South America","2024-01-14",0,0,111,0,7,147,0,0
"South America","2024-01-15",0,0,111,0,8,155,0,0
"South America","2024-01-16",0,51,162,0,7,162,0,0
"South America","2024-01-17",0,0,162,0,6,168,0,0
"South America","2024-01-18",0,0,162,0,5,173,0,0
"South America","2024-01-19",0,0,162,0,6,179,0,0
"South America","2024-01-20",0,0,162,0,6,185,0,0
"South America","2024-01-21",0,0,162,0,6,191,0,0
"South America","2024-01-22",0,0,162,0,5,196,0,0
"South America","2024-01-23",0,40,202,0,6,202,0,0
"South America","2024-01-24",0,0,202,0,6,208,0,0
"South America","2024-01-25",0,0,202,0,7,215,0,0
"South America","2024-01-26",0,0,202,0,6,221,0,0
"South America","2024-01-27",0,0,202,0,7,228,0,0
"South America","2024-01-28",0,0,202,0,6,234,0,0
"South America","2024-01-29",0,0,202,0,7,241,0,0
"South America","2024-01-30",0,45,247,0,6,247,0,0
"South America","2024-01-31",0,0,247,0,5,252,0,0
"South America","2024-02-01",0,0,247,0,5,257,0,0
"South America","2024-02-02",0,0,247,0,5,262,0,0
"South America","2024-02-03",0,0,247,0,6,268,0,0
"South America","2024-02-04",0,0,247,0,5,273,0,0
"South America","2024-02-05",0,0,247,0,5,278,0,0
"South America","2024-02-06",0,36,283,0,5,283,0,0
"South America","2024-02-07",0,0,283,0,5,288,0,0
"South America","2024-02-08",0,0,283,0,5,293,0,0
"South America","2024-02-09",0,0,283,0,5,298,0,0
"South America","2024-02-10",0,0,283,0,6,304,0,0
"South America","2024-02-11",0,0,283,0,5,309,0,0
"South America","2024-02-12",0,0,283,0,5,314,0,0
"South America","2024-02-13",0,36,319,0,5,319,0,0
"South America","2024-02-14",0,0,319,0,6,325,0,0
"South America","2024-02-15",0,0,319,0,7,332,0,0
"South America","2024-02-16",0,0,319,0,6,338,0,0
"South America","2024-02-17",0,0,319,0,6,344,0,0
"South America","2024-02-18",0,0,319,0,6,350,0,0
"South America","2024-02-19",0,0,319,0,7,357,0,0
"South America","2024-02-20",0,44,363,0,6,363,0,0
"South America","2024-02-21",0,0,363,0,6,369,0,0
"South America","2024-02-22",0,0,363,0,6,375,0,0
"South America","2024-02-23",0,0,363,0,6,381,0,0
"South America","2024-02-24",0,0,363,0,6,387,0,0
"South America","2024-02-25",0,0,363,0,6,393,0,0
"South America","2024-02-26",0,0,363,0,6,399,0,0
"South America","2024-02-27",0,42,405,0,6,405,0,0
"South America","2024-02-28",0,0,405,0,4,409,0,0
"South America","2024-02-29",0,0,405,0,4,413,0,0
"South America","2024-03-01",0,0,405,0,4,417,0,0
"South America","2024-03-02",0,0,405,0,4,421,0,0
"South America","2024-03-03",0,0,405,0,4,425,0,0
"South America","2024-03-04",0,0,405,0,4,429,0,0
"South America","2024-03-05",0,28,433,0,4,433,0,0
"South America","2024-03-06",0,0,433,0,4,437,0,0
"South America","2024-03-07",0,0,433,0,4,441,0,0
"South America","2024-03-08",0,0,433,0,4,445,0,0
"South America","2024-03-09",0,0,433,0,5,450,0,0
"South America","2024-03-10",0,0,433,0,4,454,0,0
"South America","2024-03-11",0,0,433,0,4,458,0,0
"South America","2024-03-12",0,29,462,0,4,462,0,0
"South America","2024-03-13",0,0,462,0,4,466,0,0
"South America","2024-03-14",0,0,462,0,5,471,0,0
"South America","2024-03-15",0,0,462,0,4,475,0,0
"South America","2024-03-16",0,0,462,0,5,480,0,0
"South America","2024-03-17",0,0,462,0,4,484,0,0
"South America","2024-03-18",0,0,462,0,5,489,0,0
"South America","2024-03-19",0,31,493,0,4,493,0,0
"South America","2024-03-20",0,0,493,0,4,497,0,0
"South America","2024-03-21",0,0,493,0,4,501,0,0
"South America","2024-03-22",0,0,493,0,4,505,0,0
"South America","2024-03-23",0,0,493,0,5,510,0,0
"South America","2024-03-24",0,0,493,0,4,514,0,0
"South America","2024-03-25",0,0,493,0,4,518,0,0
"South America","2024-03-26",0,29,522,0,4,522,0,0
"South America","2024-03-27",0,0,522,0,4,526,0,0
"South America","2024-03-28",0,0,522,0,5,531,0,0
"South America","2024-03-29",0,0,522,0,4,535,0,0
"South America","2024-03-30",0,0,522,0,4,539,0,0
"South America","2024-03-31",0,0,522,0,4,543,0,0
"South America","2024-04-01",0,0,522,0,5,548,0,0
"South America","2024-04-02",0,30,552,0,4,552,0,0
"South America","2024-04-03",0,0,552,0,3,555,0,0
"South America","2024-04-04",0,0,552,0,4,559,0,0
"South America","2024-04-05",0,0,552,0,3,562,0,0
"South America","2024-04-06",0,0,552,0,4,566,0,0
"South America","2024-04-07",0,0,552,0,3,569,0,0
"South America","2024-04-08",0,0,552,0,4,573,0,0
"South America","2024-04-09",0,24,576,0,3,576,0,0
"South America","2024-04-10",0,0,576,0,3,579,0,0
"South America","2024-04-11",0,0,576,0,3,582,0,0
"South America","2024-04-12",0,0,576,0,3,585,0,0
"South America","2024-04-13",0,0,576,0,2,587,0,0
"South America","2024-04-14",0,0,576,0,3,590,0,0
"South America","2024-04-15",0,0,576,0,3,593,0,0
"South America","2024-04-16",0,20,596,0,3,596,0,0
"South America","2024-04-17",0,0,596,0,5,601,0,0
"South America","2024-04-18",0,0,596,0,4,605,0,0
"South America","2024-04-19",0,0,596,0,5,610,0,0
"South America","2024-04-20",0,0,596,0,4,614,0,0
"South America","2024-04-21",0,0,596,0,5,619,0,0
"South America","2024-04-22",0,0,596,0,4,623,0,0
"South America","2024-04-23",0,32,628,0,5,628,0,0
"South America","2024-04-24",0,0,628,0,4,632,0,0
"South America","2024-04-25",0,0,628,0,3,635,0,0
"South America","2024-04-26",0,0,628,0,4,639,0,0
"South America","2024-04-27",0,0,628,0,4,643,0,0
"South America","2024-04-28",0,0,628,0,4,647,0,0
"South America","2024-04-29",0,0,628,0,3,650,0,0
"South America","2024-04-30",0,26,654,0,4,654,0,0
"South America","2024-05-01",0,0,654,0,3,657,0,0
"South America","2024-05-02",0,0,654,0,3,660,0,0
"South America","2024-05-03",0,0,654,0,3,663,0,0
"South America","2024-05-04",0,0,654,0,3,666,0,0
"South America","2024-05-05",0,0,654,0,3,669,0,0
"South America","2024-05-06",0,0,654,0,3,672,0,0
"South America","2024-05-07",0,21,675,0,3,675,0,0
"South America","2024-05-08",0,0,675,0,3,678,0,0
"South America","2024-05-09",0,0,675,0,3,681,0,0
"South America","2024-05-10",0,0,675,0,3,684,0,0
"South America","2024-05-11",0,0,675,0,4,688,0,0
"South America","2024-05-12",0,0,675,0,3,691,0,0
"South America","2024-05-13",0,0,675,0,3,694,0,0
"South America","2024-05-14",0,22,697,0,3,697,0,0
"South America","2024-05-15",0,0,697,0,1,698,0,0
"South America","2024-05-16",0,0,697,0,2,700,0,0
"South America","2024-05-17",0,0,697,0,1,701,0,0
"South America","2024-05-18",0,0,697,0,2,703,0,0
"South America","2024-05-19",0,0,697,0,1,704,0,0
"South America","2024-05-20",0,0,697,0,2,706,0,0
"South America","2024-05-21",0,10,707,0,1,707,0,0
"South America","2024-05-22",0,0,707,0,3,710,0,0
"South America","2024-05-23",0,0,707,0,3,713,0,0
"South America","2024-05-24",0,0,707,0,3,716,0,0
"South America","2024-05-25",0,0,707,0,2,718,0,0
"South America","2024-05-26",0,0,707,0,3,721,0,0
"South America","2024-05-27",0,0,707,0,3,724,0,0
"South America","2024-05-28",0,20,727,0,3,727,0,0
"South America","2024-05-29",0,0,727,0,2,729,0,0
"South America","2024-05-30",0,0,727,0,3,732,0,0
"South America","2024-05-31",0,0,727,0,2,734,0,0
"South America","2024-06-01",0,0,727,0,3,737,0,0
"South America","2024-06-02",0,0,727,0,2,739,0,0
"South America","2024-06-03",0,0,727,0,3,742,0,0
"South America","2024-06-04",0,17,744,0,2,744,0,0
"South America","2024-06-05",0,0,744,0,2,746,0,0
"South America","2024-06-06",0,0,744,0,3,749,0,0
"South America","2024-06-07",0,0,744,0,2,751,0,0
"South America","2024-06-08",0,0,744,0,2,753,0,0
"South America","2024-06-09",0,0,744,0,2,755,0,0
"South America","2024-06-10",0,0,744,0,3,758,0,0
"South America","2024-06-11",0,16,760,0,2,760,0,0
"South America","2024-06-12",0,0,760,0,2,762,0,0
"South America","2024-06-13",0,0,760,0,1,763,0,0
"South America","2024-06-14",0,0,760,0,2,765,0,0
"South America","2024-06-15",0,0,760,0,1,766,0,0
"South America","2024-06-16",0,0,760,0,2,768,0,0
"South America","2024-06-17",0,0,760,0,1,769,0,0
"South America","2024-06-18",0,11,771,0,2,771,0,0
"South America","2024-06-19",0,0,771,0,2,773,0,0
"South America","2024-06-20",0,0,771,0,3,776,0,0
"South America","2024-06-21",0,0,771,0,2,778,0,0
"South America","2024-06-22",0,0,771,0,2,780,0,0
"South America","2024-06-23",0,0,771,0,2,782,0,0
"South America","2024-06-24",0,0,771,0,3,785,0,0
"South America","2024-06-25",0,16,787,0,2,787,0,0
"South America","2024-06-26",0,0,787,0,4,791,0,0
"South America","2024-06-27",0,0,787,0,4,795,0,0
"South America","2024-06-28",0,0,787,0,4,799,0,0
"South America","2024-06-29",0,0,787,0,3,802,0,0
"South America","2024-06-30",0,0,787,0,4,806,0,0
"South America","2024-07-01",0,0,787,0,4,810,0,0
"South America","2024-07-02",0,27,814,0,4,814,0,0
"South America","2024-07-03",0,0,814,0,4,818,0,0
"South America","2024-07-04",0,0,814,0,4,822,0,0
"South America","2024-07-05",0,0,814,0,4,826,0,0
"South America","2024-07-06",0,0,814,0,4,830,0,0
"South America","2024-07-07",0,0,814,0,4,834,0,0
"South America","2024-07-08",0,0,814,0,4,838,0,0
"South America","2024-07-09",0,28,842,0,4,842,0,0
"South America","2024-07-10",0,0,842,0,4,846,0,0
"South America","2024-07-11",0,0,842,0,5,851,0,0
"South America","2024-07-12",0,0,842,0,4,855,0,0
"South America","2024-07-13",0,0,842,0,5,860,0,0
"South America","2024-07-14",0,0,842,0,4,864,0,0
"South America","2024-07-15",0,0,842,0,5,869,0,0
"South America","2024-07-16",0,31,873,0,4,873,0,0
"South America","2024-07-17",0,0,873,0,5,878,0,0
"South America","2024-07-18",0,0,873,0,5,883,0,0
"South America","2024-07-19",0,0,873,0,5,888,0,0
"South America","2024-07-20",0,0,873,0,6,894,0,0
"South America","2024-07-21",0,0,873,0,5,899,0,0
"South America","2024-07-22",0,0,873,0,5,904,0,0
"South America","2024-07-23",0,36,909,0,5,909,0,0
"South America","2024-07-24",0,0,909,0,6,915,0,0
"South America","2024-07-25",0,0,909,0,6,921,0,0
"South America","2024-07-26",0,0,909,0,6,927,0,0
"South America","2024-07-27",0,0,909,0,5,932,0,0
"South America","2024-07-28",0,0,909,0,6,938,0,0
"South America","2024-07-29",0,0,909,0,6,944,0,0
"South America","2024-07-30",0,41,950,0,6,950,0,0
"South America","2024-07-31",0,0,950,0,9,959,0,0
"South America","2024-08-01",0,0,950,0,9,968,0,0
"South America","2024-08-02",0,0,950,0,9,977,0,0
"South America","2024-08-03",0,0,950,0,10,987,0,0
"South America","2024-08-04",0,0,950,0,9,996,0,0
"South America","2024-08-05",0,0,950,0,9,1005,0,0
"South America","2024-08-06",0,64,1014,0,9,1014,0,0
"South America","2024-08-07",0,0,1014,0,10,1024,0,0
"South America","2024-08-08",0,0,1014,0,10,1034,0,0
"South America","2024-08-09",0,0,1014,0,10,1044,0,0
"South America","2024-08-10",0,0,1014,0,11,1055,0,0
"South America","2024-08-11",0,0,1014,0,10,1065,0,0
"South America","2024-08-12",0,0,1014,0,10,1075,0,0
"South America","2024-08-13",0,71,1085,0,10,1085,0,0
"South America","2024-08-14",0,0,1085,0,15,1100,0,0
"South America","2024-08-15",0,0,1085,0,14,1114,0,0
"South America","2024-08-16",0,0,1085,0,15,1129,0,0
"South America","2024-08-17",0,0,1085,0,14,1143,0,0
"South America","2024-08-18",0,0,1085,0,15,1158,0,0
"South America","2024-08-19",0,0,1085,0,14,1172,0,0
"South America","2024-08-20",0,102,1187,0,15,1187,0,0
"South America","2024-08-21",0,0,1187,0,14,1201,0,0
"South America","2024-08-22",0,0,1187,0,14,1215,0,0
"South America","2024-08-23",0,0,1187,0,14,1229,0,0
"South America","2024-08-24",0,0,1187,0,14,1243,0,0
"South America","2024-08-25",0,0,1187,0,14,1257,0,0
"South America","2024-08-26",0,0,1187,0,14,1271,0,0
"South America","2024-08-27",0,98,1285,0,14,1285,0,0
"South America","2024-08-28",0,0,1285,0,15,1300,0,0
"South America","2024-08-29",0,0,1285,0,14,1314,0,0
"South America","2024-08-30",0,0,1285,0,15,1329,0,0
"South America","2024-08-31",0,0,1285,0,15,1344,0,0
"South America","2024-09-01",0,0,1285,0,15,1359,0,0
"South America","2024-09-02",0,0,1285,0,14,1373,0,0
"South America","2024-09-03",0,103,1388,0,15,1388,0,0
"South America","2024-09-04",0,0,1388,0,10,1398,0,0
"South America","2024-09-05",0,0,1388,0,11,1409,0,0
"South America","2024-09-06",0,0,1388,0,10,1419,0,0
"South America","2024-09-07",0,0,1388,0,11,1430,0,0
"South America","2024-09-08",0,0,1388,0,10,1440,0,0
"South America","2024-09-09",0,0,1388,0,11,1451,0,0
"South America","2024-09-10",0,73,1461,0,10,1461,0,0
"South America","2024-09-11",0,0,1461,0,12,1473,0,0
"South America","2024-09-12",0,0,1461,0,11,1484,0,0
"South America","2024-09-13",0,0,1461,0,12,1496,0,0
"South America","2024-09-14",0,0,1461,0,11,1507,0,0
"South America","2024-09-15",0,0,1461,0,12,1519,0,0
"South America","2024-09-16",0,0,1461,0,11,1530,0,0
"South America","2024-09-17",0,81,1542,0,12,1542,0,0
"South America","2024-09-18",0,0,1542,0,10,1552,0,0
"South America","2024-09-19",0,0,1542,0,11,1563,0,0
"South America","2024-09-20",0,0,1542,0,10,1573,0,0
"South America","2024-09-21",0,0,1542,0,10,1583,0,0
"South America","2024-09-22",0,0,1542,0,10,1593,0,0
"South America","2024-09-23",0,0,1542,0,11,1604,0,0
"South America","2024-09-24",0,72,1614,0,10,1614,0,0
"South America","2024-09-25",0,0,1614,0,13,1627,0,0
"South America","2024-09-26",0,0,1614,0,12,1639,0,0
"South America","2024-09-27",0,0,1614,0,13,1652,0,0
"South America","2024-09-28",0,0,1614,0,13,1665,0,0
"South America","2024-09-29",0,0,1614,0,13,1678,0,0
"South America","2024-09-30",0,0,1614,0,12,1690,0,0
"South America","2024-10-01",0,89,1703,0,13,1703,0,0
"South America","2024-10-02",0,0,1703,0,11,1714,0,0
"South America","2024-10-03",0,0,1703,0,12,1726,0,0
"South America","2024-10-04",0,0,1703,0,11,1737,0,0
"South America","2024-10-05",0,0,1703,0,12,1749,0,0
"South America","2024-10-06",0,0,1703,0,11,1760,0,0
"South America","2024-10-07",0,0,1703,0,12,1772,0,0
"South America","2024-10-08",0,80,1783,0,11,1783,0,0
"South America","2024-10-09",0,0,1783,0,9,1792,0,0
"South America","2024-10-10",0,0,1783,0,10,1802,0,0
"South America","2024-10-11",0,0,1783,0,9,1811,0,0
"South America","2024-10-12",0,0,1783,0,10,1821,0,0
"South America","2024-10-13",0,0,1783,0,9,1830,0,0
"South America","2024-10-14",0,0,1783,0,10,1840,0,0
"South America","2024-10-15",0,66,1849,0,9,1849,0,0
"South America","2024-10-16",0,0,1849,0,11,1860,0,0
"South America","2024-10-17",0,0,1849,0,11,1871,0,0
"South America","2024-10-18",0,0,1849,0,11,1882,0,0
"South America","2024-10-19",0,0,1849,0,11,1893,0,0
"South America","2024-10-20",0,0,1849,0,11,1904,0,0
"South America","2024-10-21",0,0,1849,0,11,1915,0,0
"South America","2024-10-22",0,77,1926,0,11,1926,0,0
"South America","2024-10-23",0,0,1926,0,10,1936,0,0
"South America","2024-10-24",0,0,1926,0,9,1945,0,0
"South America","2024-10-25",0,0,1926,0,10,1955,0,0
"South America","2024-10-26",0,0,1926,0,10,1965,0,0
"South America","2024-10-27",0,0,1926,0,10,1975,0,0
"South America","2024-10-28",0,0,1926,0,9,1984,0,0
"South America","2024-10-29",0,68,1994,0,10,1994,0,0
"South America","2024-10-30",0,0,1994,0,11,2005,0,0
"South America","2024-10-31",0,0,1994,0,11,2016,0,0
"South America","2024-11-01",0,0,1994,0,11,2027,0,0
"South America","2024-11-02",0,0,1994,0,11,2038,0,0
"South America","2024-11-03",0,0,1994,0,11,2049,0,0
"South America","2024-11-04",0,0,1994,0,11,2060,0,0
"South America","2024-11-05",0,77,2071,0,11,2071,0,0
"South America","2024-11-06",0,0,2071,0,8,2079,0,0
"South America","2024-11-07",0,0,2071,0,7,2086,0,0
"South America","2024-11-08",0,0,2071,0,8,2094,0,0
"South America","2024-11-09",0,0,2071,0,7,2101,0,0
"South America","2024-11-10",0,0,2071,0,8,2109,0,0
"South America","2024-11-11",0,0,2071,0,7,2116,0,0
"South America","2024-11-12",0,53,2124,0,8,2124,0,0
"South America","2024-11-13",0,0,2124,0,8,2132,0,0
"South America","2024-11-14",0,0,2124,0,9,2141,0,0
"South America","2024-11-15",0,0,2124,0,8,2149,0,0
"South America","2024-11-16",0,0,2124,0,8,2157,0,0
"South America","2024-11-17",0,0,2124,0,8,2165,0,0
"South America","2024-11-18",0,0,2124,0,9,2174,0,0
"South America","2024-11-19",0,58,2182,0,8,2182,0,0
"South America","2024-11-20",0,0,2182,0,7,2189,0,0
"South America","2024-11-21",0,0,2182,0,8,2197,0,0
"South America","2024-11-22",0,0,2182,0,7,2204,0,0
"South America","2024-11-23",0,0,2182,0,7,2211,0,0
"South America","2024-11-24",0,0,2182,0,7,2218,0,0
"South America","2024-11-25",0,0,2182,0,8,2226,0,0
"South America","2024-11-26",0,51,2233,0,7,2233,0,0
"South America","2024-11-27",0,0,2233,0,6,2239,0,0
"South America","2024-11-28",0,0,2233,0,5,2244,0,0
"South America","2024-11-29",0,0,2233,0,6,2250,0,0
"South America","2024-11-30",0,0,2233,0,6,2256,0,0
"South America","2024-12-01",0,0,2233,0,6,2262,0,0
"South America","2024-12-02",0,0,2233,0,5,2267,0,0
"South America","2024-12-03",0,40,2273,0,6,2273,0,0
"South America","2024-12-04",0,0,2273,0,4,2277,0,0
"South America","2024-12-05",0,0,2273,0,3,2280,0,0
"South America","2024-12-06",0,0,2273,0,4,2284,0,0
"South America","2024-12-07",0,0,2273,0,3,2287,0,0
"South America","2024-12-08",0,0,2273,0,4,2291,0,0
"South America","2024-12-09",0,0,2273,0,3,2294,0,0
"South America","2024-12-10",0,25,2298,0,4,2298,0,0
"South America","2024-12-11",0,0,2298,0,3,2301,0,0
"South America","2024-12-12",0,0,2298,0,3,2304,0,0
"South America","2024-12-13",0,0,2298,0,3,2307,0,0
"South America","2024-12-14",0,0,2298,0,2,2309,0,0
"South America","2024-12-15",0,0,2298,0,3,2312,0,0
"South America","2024-12-16",0,0,2298,0,3,2315,0,0
"South America","2024-12-17",0,20,2318,0,3,2318,0,0
"South America","2024-12-18",0,0,2318,0,1,2319,0,0
"South America","2024-12-19",0,0,2318,0,1,2320,0,0
"South America","2024-12-20",0,0,2318,0,1,2321,0,0
"South America","2024-12-21",0,0,2318,0,0,2321,0,0
"South America","2024-12-22",0,0,2318,0,1,2322,0,0
"South America","2024-12-23",0,0,2318,0,1,2323,0,0
"South America","2024-12-24",0,6,2324,0,1,2324,0,0
"South America","2024-12-25",0,0,2324,0,0,2324,0,0
"South America","2024-12-26",0,0,2324,0,0,2324,0,0
"South America","2024-12-27",0,0,2324,0,0,2324,0,0
"South America","2024-12-28",0,0,2324,0,1,2325,0,0
"South America","2024-12-29",0,0,2324,0,0,2325,0,0
"South America","2024-12-30",0,0,2324,0,0,2325,0,0
"South America","2024-12-31",0,1,2325,0,0,2325,0,0
"South America","2025-01-01",0,0,2325,0,0,2325,0,0
"South America","2025-01-02",0,0,2325,0,0,2325,0,0
"South America","2025-01-03",0,0,2325,0,0,2325,0,0
"South America","2025-01-04",0,0,2325,0,0,2325,0,0
"South America","2025-01-05",0,0,2325,0,0,2325,0,0
"South America","2025-01-06",0,0,2325,0,0,2325,0,0
"South America","2025-01-07",0,0,2325,0,0,2325,0,0
"South America","2025-01-08",0,0,2325,0,0,2325,0,0
"South America","2025-01-09",0,0,2325,0,0,2325,0,0
"South America","2025-01-10",0,0,2325,0,0,2325,0,0
"South America","2025-01-11",0,0,2325,0,0,2325,0,0
"South America","2025-01-12",0,0,2325,0,0,2325,0,0
"South America","2025-01-13",0,0,2325,0,0,2325,0,0
"South America","2025-01-14",0,0,2325,0,0,2325,0,0
"South America","2025-01-15",0,0,2325,0,0,2325,0,0
"South America","2025-01-16",0,0,2325,0,0,2325,0,0
"South America","2025-01-17",0,0,2325,0,0,2325,0,0
"South America","2025-01-18",0,0,2325,0,0,2325,0,0
"South America","2025-01-19",0,0,2325,0,0,2325,0,0
"South America","2025-01-20",0,0,2325,0,0,2325,0,0
"South America","2025-01-21",0,0,2325,0,0,2325,0,0
"South America","2025-01-22",0,0,2325,0,0,2325,0,0
"South America","2025-01-23",0,0,2325,0,0,2325,0,0
"South America","2025-01-24",0,0,2325,0,0,2325,0,0
"South America","2025-01-25",0,0,2325,0,0,2325,0,0
"South America","2025-01-26",0,0,2325,0,0,2325,0,0
"South America","2025-01-27",0,0,2325,0,0,2325,0,0
"South America","2025-01-28",0,0,2325,0,0,2325,0,0
"South America","2025-01-29",0,0,2325,0,0,2325,0,0
"South America","2025-01-30",0,0,2325,0,0,2325,0,0
"South America","2025-01-31",0,0,2325,0,0,2325,0,0
"South America","2025-02-01",0,0,2325,0,0,2325,0,0
"South America","2025-02-02",0,0,2325,0,0,2325,0,0
"South America","2025-02-03",0,0,2325,0,0,2325,0,0
"Republic of Korea","2024-01-01",0,0,0,0,0,0,0,0
"Republic of Korea","2024-01-02",0,0,0,0,0,0,0,0
"Republic of Korea","2024-01-03",0,0,0,0,0,0,0,0
"Republic of Korea","2024-01-04",0,0,0,0,0,0,0,0
"Republic of Korea","2024-01-05",0,0,0,0,0,0,0,0
"Republic of Korea","2024-01-06",0,0,0,0,0,0,0,0
"Republic of Korea","2024-01-07",0,0,0,0,0,0,0,0
"Republic of Korea","2024-01-08",0,0,0,0,0,0,0,0
"Republic of Korea","2024-01-09",0,0,0,0,0,0,0,0
"Republic of Korea","2024-01-10",0,0,0,0,0,0,0,0
"Republic of Korea","2024-01-11",0,0,0,0,0,0,0,0
"Republic of Korea","2024-01-12",0,0,0,0,0,0,0,0
"Republic of Korea","2024-01-13",0,0,0,0,0,0,0,0
"Republic of Korea","2024-01-14",0,0,0,0,0,0,0,0
"Republic of Korea","2024-01-15",0,0,0,0,0,0,0,0
"Republic of Korea","2024-01-16",0,0,0,0,0,0,0,0
"Republic of Korea","2024-01-17",0,0,0,0,0,0,0,0
"Republic of Korea","2024-01-18",0,0,0,0,0,0,0,0
"Republic of Korea","2024-01-19",0,0,0,0,0,0,0,0
"Republic of Korea","2024-01-20",0,0,0,0,0,0,0,0
"Republic of Korea","2024-01-21",0,0,0,0,0,0,0,0
"Republic of Korea","2024-01-22",0,0,0,0,0,0,0,0
"Republic of Korea","2024-01-23",0,0,0,0,0,0,0,0
"Republic of Korea","2024-01-24",0,0,0,0,0,0,0,0
"Republic of Korea","2024-01-25",0,0,0,0,0,0,0,0
"Republic of Korea","2024-01-26",0,0,0,0,0,0,0,0
"Republic of Korea","2024-01-27",0,0,0,0,0,0,0,0
"Republic of Korea","2024-01-28",0,0,0,0,0,0,0,0
"Republic of Korea","2024-01-29",0,0,0,0,0,0,0,0
"Republic of Korea","2024-01-30",0,0,0,0,0,0,0,0
"Republic of Korea","2024-01-31",0,0,0,0,0,0,0,0
"Republic of Korea","2024-02-01",0,0,0,0,0,0,0,0
"Republic of Korea","2024-02-02",0,0,0,0,0,0,0,0
"Republic of Korea","2024-02-03",0,0,0,0,0,0,0,0
"Republic of Korea","2024-02-04",0,0,0,0,0,0,0,0
"Republic of Korea","2024-02-05",0,0,0,0,0,0,0,0
"Republic of Korea","2024-02-06",0,0,0,0,0,0,0,0
"Republic of Korea","2024-02-07",0,0,0,0,0,0,0,0
"Republic of Korea","2024-02-08",0,0,0,0,0,0,0,0
"Republic of Korea","2024-02-09",0,0,0,0,0,0,0,0
"Republic of Korea","2024-02-10",0,0,0,0,0,0,0,0
"Republic of Korea","2024-02-11",0,0,0,0,0,0,0,0
"Republic of Korea","2024-02-12",0,0,0,0,0,0,0,0
"Republic of Korea","2024-02-13",0,0,0,0,0,0,0,0
"Republic of Korea","2024-02-14",0,0,0,0,0,0,0,0
"Republic of Korea","2024-02-15",0,0,0,0,0,0,0,0
"Republic of Korea","2024-02-16",0,0,0,0,0,0,0,0
"Republic of Korea","2024-02-17",0,0,0,0,0,0,0,0
"Republic of Korea","2024-02-18",0,0,0,0,0,0,0,0
"Republic of Korea","2024-02-19",0,0,0,0,0,0,0,0
"Republic of Korea","2024-02-20",0,0,0,0,0,0,0,0
"Republic of Korea","2024-02-21",0,0,0,0,0,0,0,0
"Republic of Korea","2024-02-22",0,0,0,0,0,0,0,0
"Republic of Korea","2024-02-23",0,0,0,0,0,0,0,0
"Republic of Korea","2024-02-24",0,0,0,0,0,0,0,0
"Republic of Korea","2024-02-25",0,0,0,0,0,0,0,0
"Republic of Korea","2024-02-26",0,0,0,0,0,0,0,0
"Republic of Korea","2024-02-27",0,0,0,0,0,0,0,0
"Republic of Korea","2024-02-28",0,0,0,0,0,0,0,0
"Republic of Korea","2024-02-29",0,0,0,0,0,0,0,0
"Republic of Korea","2024-03-01",0,0,0,0,0,0,0,0
"Republic of Korea","2024-03-02",0,0,0,0,0,0,0,0
"Republic of Korea","2024-03-03",0,0,0,0,0,0,0,0
"Republic of Korea","2024-03-04",0,0,0,0,0,0,0,0
"Republic of Korea","2024-03-05",0,0,0,0,0,0,0,0
"Republic of Korea","2024-03-06",0,0,0,0,0,0,0,0
"Republic of Korea","2024-03-07",0,0,0,0,0,0,0,0
"Republic of Korea","2024-03-08",0,0,0,0,0,0,0,0
"Republic of Korea","2024-03-09",0,0,0,0,0,0,0,0
"Republic of Korea","2024-03-10",0,0,0,0,0,0,0,0
"Republic of Korea","2024-03-11",0,0,0,0,0,0,0,0
"Republic of Korea","2024-03-12",0,0,0,0,0,0,0,0
"Republic of Korea","2024-03-13",0,0,0,0,0,0,0,0
"Republic of Korea","2024-03-14",0,0,0,0,0,0,0,0
"Republic of Korea","2024-03-15",0,0,0,0,0,0,0,0
"Republic of Korea","2024-03-16",0,0,0,0,0,0,0,0
"Republic of Korea","2024-03-17",0,0,0,0,0,0,0,0
"Republic of Korea","2024-03-18",0,0,0,0,0,0,0,0
"Republic of Korea","2024-03-19",0,0,0,0,0,0,0,0
"Republic of Korea","2024-03-20",0,0,0,0,0,0,0,0
"Republic of Korea","2024-03-21",0,0,0,0,0,0,0,0
"Republic of Korea","2024-03-22",0,0,0,0,0,0,0,0
"Republic of Korea","2024-03-23",0,0,0,0,0,0,0,0
"Republic of Korea","2024-03-24",0,0,0,0,0,0,0,0
"Republic of Korea","2024-03-25",0,0,0,0,0,0,0,0
"Republic of Korea","2024-03-26",0,0,0,0,0,0,0,0
"Republic of Korea","2024-03-27",0,0,0,0,0,0,0,0
"Republic of Korea","2024-03-28",0,0,0,0,0,0,0,0
"Republic of Korea","2024-03-29",0,0,0,0,0,0,0,0
"Republic of Korea","2024-03-30",0,0,0,0,0,0,0,0
"Republic of Korea","2024-03-31",0,0,0,0,0,0,0,0
"Republic of Korea","2024-04-01",0,0,0,0,0,0,0,0
"Republic of Korea","2024-04-02",0,0,0,0,0,0,0,0
"Republic of Korea","2024-04-03",0,0,0,0,0,0,0,0
"Republic of Korea","2024-04-04",0,0,0,0,0,0,0,0
"Republic of Korea","2024-04-05",0,0,0,0,0,0,0,0
"Republic of Korea","2024-04-06",0,0,0,0,0,0,0,0
"Republic of Korea","2024-04-07",0,0,0,0,0,0,0,0
"Republic of Korea","2024-04-08",0,0,0,0,0,0,0,0
"Republic of Korea","2024-04-09",0,0,0,0,0,0,0,0
"Republic of Korea","2024-04-10",0,0,0,0,0,0,0,0
"Republic of Korea","2024-04-11",0,0,0,0,0,0,0,0
"Republic of Korea","2024-04-12",0,0,0,0,0,0,0,0
"Republic of Korea","2024-04-13",0,0,0,0,0,0,0,0
"Republic of Korea","2024-04-14",0,0,0,0,0,0,0,0
"Republic of Korea","2024-04-15",0,0,0,0,0,0,0,0
"Republic of Korea","2024-04-16",0,0,0,0,0,0,0,0
"Republic of Korea","2024-04-17",0,0,0,0,0,0,0,0
"Republic of Korea","2024-04-18",0,0,0,0,0,0,0,0
"Republic of Korea","2024-04-19",0,0,0,0,0,0,0,0
"Republic of Korea","2024-04-20",0,0,0,0,0,0,0,0
"Republic of Korea","2024-04-21",0,0,0,0,0,0,0,0
"Republic of Korea","2024-04-22",0,0,0,0,0,0,0,0
"Republic of Korea","2024-04-23",0,0,0,0,0,0,0,0
"Republic of Korea","2024-04-24",0,0,0,0,0,0,0,0
"Republic of Korea","2024-04-25",0,0,0,0,0,0,0,0
"Republic of Korea","2024-04-26",0,0,0,0,0,0,0,0
"Republic of Korea","2024-04-27",0,1,1,0,1,1,0,0
"Republic of Korea","2024-04-28",0,0,1,0,0,1,0,0
"Republic of Korea","2024-04-29",0,0,1,0,0,1,0,0
"Republic of Korea","2024-04-30",0,0,1,0,0,1,0,0
"Republic of Korea","2024-05-01",0,0,1,0,0,1,0,0
"Republic of Korea","2024-05-02",0,0,1,0,0,1,0,0
"Republic of Korea","2024-05-03",0,0,1,0,0,1,0,0
"Republic of Korea","2024-05-04",0,0,1,0,0,1,0,0
"Republic of Korea","2024-05-05",0,0,1,0,0,1,0,0
"Republic of Korea","2024-05-06",0,0,1,0,0,1,0,0
"Republic of Korea","2024-05-07",0,0,1,0,0,1,0,0
"Republic of Korea","2024-05-08",0,0,1,0,0,1,0,0
"Republic of Korea","2024-05-09",0,0,1,0,0,1,0,0
"Republic of Korea","2024-05-10",0,0,1,0,0,1,0,0
"Republic of Korea","2024-05-11",0,0,1,0,0,1,0,0
"Republic of Korea","2024-05-12",0,0,1,0,1,2,0,0
"Republic of Korea","2024-05-13",0,0,1,0,0,2,0,0
"Republic of Korea","2024-05-14",0,0,1,0,0,2,0,0
"Republic of Korea","2024-05-15",0,0,1,0,0,2,0,0
"Republic of Korea","2024-05-16",0,0,1,0,0,2,0,0
"Republic of Korea","2024-05-17",0,0,1,0,0,2,0,0
"Republic of Korea","2024-05-18",0,0,1,0,0,2,0,0
"Republic of Korea","2024-05-19",0,0,1,0,0,2,0,0
"Republic of Korea","2024-05-20",0,0,1,0,0,2,0,0
"Republic of Korea","2024-05-21",0,0,1,0,0,2,0,0
"Republic of Korea","2024-05-22",0,0,1,0,0,2,0,0
"Republic of Korea","2024-05-23",0,0,1,0,0,2,0,0
"Republic of Korea","2024-05-24",0,0,1,0,0,2,0,0
"Republic of Korea","2024-05-25",0,0,1,0,0,2,0,0
"Republic of Korea","2024-05-26",0,0,1,0,0,2,0,0
"Republic of Korea","2024-05-27",0,0,1,0,0,2,0,0
"Republic of Korea","2024-05-28",0,0,1,0,0,2,0,0
"Republic of Korea","2024-05-29",0,0,1,0,0,2,0,0
"Republic of Korea","2024-05-30",0,0,1,0,0,2,0,0
"Republic of Korea","2024-05-31",0,0,1,0,0,2,0,0
"Republic of Korea","2024-06-01",0,0,1,0,0,2,0,0
"Republic of Korea","2024-06-02",0,0,1,0,0,2,0,0
"Republic of Korea","2024-06-03",0,0,1,0,0,2,0,0
"Republic of Korea","2024-06-04",0,0,1,0,0,2,0,0
"Republic of Korea","2024-06-05",0,0,1,0,0,2,0,0
"Republic of Korea","2024-06-06",0,0,1,0,0,2,0,0
"Republic of Korea","2024-06-07",0,0,1,0,0,2,0,0
"Republic of Korea","2024-06-08",0,0,1,0,0,2,0,0
"Republic of Korea","2024-06-09",0,0,1,0,0,2,0,0
"Republic of Korea","2024-06-10",0,0,1,0,0,2,0,0
"Republic of Korea","2024-06-11",0,0,1,0,1,3,0,0
"Republic of Korea","2024-06-12",0,0,1,0,0,3,0,0
"Republic of Korea","2024-06-13",0,0,1,0,0,3,0,0
"Republic of Korea","2024-06-14",0,0,1,0,0,3,0,0
"Republic of Korea","2024-06-15",0,0,1,0,0,3,0,0
"Republic of Korea","2024-06-16",0,0,1,0,0,3,0,0
"Republic of Korea","2024-06-17",0,0,1,0,0,3,0,0
"Republic of Korea","2024-06-18",0,0,1,0,0,3,0,0
"Republic of Korea","2024-06-19",0,0,1,0,0,3,0,0
"Republic of Korea","2024-06-20",0,0,1,0,0,3,0,0
"Republic of Korea","2024-06-21",0,0,1,0,0,3,0,0
"Republic of Korea","2024-06-22",0,0,1,0,0,3,0,0
"Republic of Korea","2024-06-23",0,0,1,0,0,3,0,0
"Republic of Korea","2024-06-24",0,0,1,0,0,3,0,0
"Republic of Korea","2024-06-25",0,2,3,0,0,3,0,0
"Republic of Korea","2024-06-26",0,0,3,0,0,3,0,0
"Republic of Korea","2024-06-27",0,0,3,0,1,4,0,0
"Republic of Korea","2024-06-28",0,1,4,0,0,4,0,0
"Republic of Korea","2024-06-29",0,0,4,0,0,4,0,0
"Republic of Korea","2024-06-30",0,0,4,0,0,4,0,0
"Republic of Korea","2024-07-01",0,0,4,0,0,4,0,0
"Republic of Korea","2024-07-02",0,0,4,0,1,5,0,0
"Republic of Korea","2024-07-03",0,0,4,0,0,5,0,0
"Republic of Korea","2024-07-04",0,0,4,0,0,5,0,0
"Republic of Korea","2024-07-05",0,0,4,0,0,5,0,0
"Republic of Korea","2024-07-06",0,0,4,0,0,5,0,0
"Republic of Korea","2024-07-07",0,0,4,0,0,5,0,0
"Republic of Korea","2024-07-08",0,0,4,0,0,5,0,0
"Republic of Korea","2024-07-09",0,0,4,0,1,6,0,0
"Republic of Korea","2024-07-10",0,0,4,0,0,6,0,0
"Republic of Korea","2024-07-11",0,0,4,0,0,6,0,0
"Republic of Korea","2024-07-12",0,2,6,0,0,6,0,0
"Republic of Korea","2024-07-13",0,0,6,0,0,6,0,0
"Republic of Korea","2024-07-14",0,0,6,0,0,6,0,0
"Republic of Korea","2024-07-15",0,0,6,0,1,7,0,0
"Republic of Korea","2024-07-16",0,0,6,0,0,7,0,0
"Republic of Korea","2024-07-17",0,0,6,0,0,7,0,0
"Republic of Korea","2024-07-18",0,0,6,0,0,7,0,0
"Republic of Korea","2024-07-19",0,0,6,0,0,7,0,0
"Republic of Korea","2024-07-20",0,0,6,0,1,8,0,0
"Republic of Korea","2024-07-21",0,0,6,0,0,8,0,0
"Republic of Korea","2024-07-22",0,0,6,0,0,8,0,0
"Republic of Korea","2024-07-23",0,0,6,0,0,8,0,0
"Republic of Korea","2024-07-24",0,0,6,0,0,8,0,0
"Republic of Korea","2024-07-25",0,0,6,0,0,8,0,0
"Republic of Korea","2024-07-26",0,0,6,0,1,9,0,0
"Republic of Korea","2024-07-27",0,0,6,0,0,9,0,0
"Republic of Korea","2024-07-28",0,0,6,0,0,9,0,0
"Republic of Korea","2024-07-29",0,0,6,0,0,9,0,0
"Republic of Korea","2024-07-30",0,0,6,0,0,9,0,0
"Republic of Korea","2024-07-31",0,0,6,0,1,10,0,0
"Republic of Korea","2024-08-01",0,0,6,0,0,10,0,0
"Republic of Korea","2024-08-02",0,4,10,0,0,10,0,0
"Republic of Korea","2024-08-03",0,0,10,0,0,10,0,0
"Republic of Korea","2024-08-04",0,0,10,0,0,10,0,0
"Republic of Korea","2024-08-05",0,0,10,0,0,10,0,0
"Republic of Korea","2024-08-06",0,0,10,0,0,10,0,0
"Republic of Korea","2024-08-07",0,0,10,0,0,10,0,0
"Republic of Korea","2024-08-08",0,0,10,0,0,10,0,0
"Republic of Korea","2024-08-09",0,0,10,0,0,10,0,0
"Republic of Korea","2024-08-10",0,0,10,0,0,10,0,0
"Republic of Korea","2024-08-11",0,0,10,0,0,10,0,0
"Republic of Korea","2024-08-12",0,0,10,0,0,10,0,0
"Republic of Korea","2024-08-13",0,0,10,0,1,11,0,0
"Republic of Korea","2024-08-14",0,0,10,0,0,11,0,0
"Republic of Korea","2024-08-15",0,0,10,0,0,11,0,0
"Republic of Korea","2024-08-16",0,0,10,0,0,11,0,0
"Republic of Korea","2024-08-17",0,0,10,0,0,11,0,0
"Republic of Korea","2024-08-18",0,0,10,0,0,11,0,0
"Republic of Korea","2024-08-19",0,0,10,0,0,11,0,0
"Republic of Korea","2024-08-20",0,0,10,0,0,11,0,0
"Republic of Korea","2024-08-21",0,0,10,0,0,11,0,0
"Republic of Korea","2024-08-22",0,1,11,0,0,11,0,0
"Republic of Korea","2024-08-23",0,0,11,0,0,11,0,0
"Republic of Korea","2024-08-24",0,0,11,0,0,11,0,0
"Republic of Korea","2024-08-25",0,0,11,0,0,11,0,0
"Republic of Korea","2024-08-26",0,0,11,0,0,11,0,0
"Republic of Korea","2024-08-27",0,0,11,0,0,11,0,0
"Republic of Korea","2024-08-28",0,0,11,0,0,11,0,0
"Republic of Korea","2024-08-29",0,0,11,0,1,12,0,0
"Republic of Korea","2024-08-30",0,0,11,0,0,12,0,0
"Republic of Korea","2024-08-31",0,0,11,0,0,12,0,0
"Republic of Korea","2024-09-01",0,0,11,0,0,12,0,0
"Republic of Korea","2024-09-02",0,0,11,0,0,12,0,0
"Republic of Korea","2024-09-03",0,0,11,0,0,12,0,0
"Republic of Korea","2024-09-04",0,0,11,0,0,12,0,0
"Republic of Korea","2024-09-05",0,0,11,0,0,12,0,0
"Republic of Korea","2024-09-06",0,0,11,0,0,12,0,0
"Republic of Korea","2024-09-07",0,0,11,0,0,12,0,0
"Republic of Korea","2024-09-08",0,0,11,0,0,12,0,0
"Republic of Korea","2024-09-09",0,0,11,0,1,13,0,0
"Republic of Korea","2024-09-10",0,0,11,0,0,13,0,0
"Republic of Korea","2024-09-11",0,0,11,0,0,13,0,0
"Republic of Korea","2024-09-12",0,0,11,0,0,13,0,0
"Republic of Korea","2024-09-13",0,0,11,0,0,13,0,0
"Republic of Korea","2024-09-14",0,0,11,0,0,13,0,0
"Republic of Korea","2024-09-15",0,2,13,0,0,13,0,0
"Republic of Korea","2024-09-16",0,0,13,0,0,13,0,0
"Republic of Korea","2024-09-17",0,0,13,0,0,13,0,0
"Republic of Korea","2024-09-18",0,0,13,0,0,13,0,0
"Republic of Korea","2024-09-19",0,0,13,0,0,13,0,0
"Republic of Korea","2024-09-20",0,0,13,0,0,13,0,0
"Republic of Korea","2024-09-21",0,0,13,0,0,13,0,0
"Republic of Korea","2024-09-22",0,0,13,0,0,13,0,0
"Republic of Korea","2024-09-23",0,0,13,0,0,13,0,0
"Republic of Korea","2024-09-24",0,0,13,0,0,13,0,0
"Republic of Korea","2024-09-25",0,0,13,0,0,13,0,0
"Republic of Korea","2024-09-26",0,0,13,0,0,13,0,0
"Republic of Korea","2024-09-27",0,0,13,0,0,13,0,0
"Republic of Korea","2024-09-28",0,0,13,0,0,13,0,0
"Republic of Korea","2024-09-29",0,0,13,0,0,13,0,0
"Republic of Korea","2024-09-30",0,0,13,0,0,13,0,0
"Republic of Korea","2024-10-01",0,0,13,0,0,13,0,0
"Republic of Korea","2024-10-02",0,0,13,0,0,13,0,0
"Republic of Korea","2024-10-03",0,0,13,0,0,13,0,0
"Republic of Korea","2024-10-04",0,0,13,0,0,13,0,0
"Republic of Korea","2024-10-05",0,0,13,0,0,13,0,0
"Republic of Korea","2024-10-06",0,0,13,0,0,13,0,0
"Republic of Korea","2024-10-07",0,0,13,0,0,13,0,0
"Republic of Korea","2024-10-08",0,0,13,0,0,13,0,0
"Republic of Korea","2024-10-09",0,0,13,0,1,14,0,0
"Republic of Korea","2024-10-10",0,0,13,0,0,14,0,0
"Republic of Korea","2024-10-11",0,0,13,0,0,14,0,0
"Republic of Korea","2024-10-12",0,0,13,0,0,14,0,0
"Republic of Korea","2024-10-13",0,0,13,0,0,14,0,0
"Republic of Korea","2024-10-14",0,0,13,0,0,14,0,0
"Republic of Korea","2024-10-15",0,0,13,0,0,14,0,0
"Republic of Korea","2024-10-16",0,0,13,0,0,14,0,0
"Republic of Korea","2024-10-17",0,0,13,0,0,14,0,0
"Republic of Korea","2024-10-18",0,0,13,0,0,14,0,0
"Republic of Korea","2024-10-19",0,0,13,0,0,14,0,0
"Republic of Korea","2024-10-20",0,0,13,0,0,14,0,0
"Republic of Korea","2024-10-21",0,0,13,0,0,14,0,0
"Republic of Korea","2024-10-22",0,0,13,0,0,14,0,0
"Republic of Korea","2024-10-23",0,0,13,0,0,14,0,0
"Republic of Korea","2024-10-24",0,0,13,0,0,14,0,0
"Republic of Korea","2024-10-25",0,0,13,0,0,14,0,0
"Republic of Korea","2024-10-26",0,0,13,0,0,14,0,0
"Republic of Korea","2024-10-27",0,0,13,0,0,14,0,0
"Republic of Korea","2024-10-28",0,0,13,0,0,14,0,0
"Republic of Korea","2024-10-29",0,0,13,0,0,14,0,0
"Republic of Korea","2024-10-30",0,0,13,0,0,14,0,0
"Republic of Korea","2024-10-31",0,1,14,0,0,14,0,0
"Republic of Korea","2024-11-01",0,0,14,0,0,14,0,0
"Republic of Korea","2024-11-02",0,0,14,0,0,14,0,0
"Republic of Korea","2024-11-03",0,0,14,0,1,15,0,0
"Republic of Korea","2024-11-04",0,0,14,0,0,15,0,0
"Republic of Korea","2024-11-05",0,0,14,0,0,15,0,0
"Republic of Korea","2024-11-06",0,0,14,0,0,15,0,0
"Republic of Korea","2024-11-07",0,0,14,0,0,15,0,0
"Republic of Korea","2024-11-08",0,0,14,0,1,16,0,0
"Republic of Korea","2024-11-09",0,0,14,0,0,16,0,0
"Republic of Korea","2024-11-10",0,0,14,0,0,16,0,0
"Republic of Korea","2024-11-11",0,0,14,0,0,16,0,0
"Republic of Korea","2024-11-12",0,0,14,0,0,16,0,0
"Republic of Korea","2024-11-13",0,0,14,0,1,17,0,0
"Republic of Korea","2024-11-14",0,0,14,0,0,17,0,0
"Republic of Korea","2024-11-15",0,3,17,0,0,17,0,0
"Republic of Korea","2024-11-16",0,0,17,0,0,17,0,0
"Republic of Korea","2024-11-17",0,0,17,0,0,17,0,0
"Republic of Korea","2024-11-18",0,0,17,0,0,17,0,0
"Republic of Korea","2024-11-19",0,0,17,0,0,17,0,0
"Republic of Korea","2024-11-20",0,0,17,0,0,17,0,0
"Republic of Korea","2024-11-21",0,0,17,0,0,17,0,0
"Republic of Korea","2024-11-22",0,0,17,0,0,17,0,0
"Republic of Korea","2024-11-23",0,0,17,0,0,17,0,0
"Republic of Korea","2024-11-24",0,0,17,0,0,17,0,0
"Republic of Korea","2024-11-25",0,0,17,0,0,17,0,0
"Republic of Korea","2024-11-26",0,0,17,0,0,17,0,0
"Republic of Korea","2024-11-27",0,0,17,0,0,17,0,0
"Republic of Korea","2024-11-28",0,0,17,0,0,17,0,0
"Republic of Korea","2024-11-29",0,0,17,0,0,17,0,0
"Republic of Korea","2024-11-30",0,0,17,0,0,17,0,0
"Republic of Korea","2024-12-01",0,0,17,0,0,17,0,0
"Republic of Korea","2024-12-02",0,0,17,0,0,17,0,0
"Republic of Korea","2024-12-03",0,0,17,0,0,17,0,0
"Republic of Korea","2024-12-04",0,0,17,0,0,17,0,0
"Republic of Korea","2024-12-05",0,0,17,0,0,17,0,0
"Republic of Korea","2024-12-06",0,0,17,0,0,17,0,0
"Republic of Korea","2024-12-07",0,0,17,0,0,17,0,0
"Republic of Korea","2024-12-08",0,0,17,0,0,17,0,0
"Republic of Korea","2024-12-09",0,0,17,0,0,17,0,0
"Republic of Korea","2024-12-10",0,0,17,0,0,17,0,0
"Republic of Korea","2024-12-11",0,0,17,0,0,17,0,0
"Republic of Korea","2024-12-12",0,0,17,0,0,17,0,0
"Republic of Korea","2024-12-13",0,0,17,0,0,17,0,0
"Republic of Korea","2024-12-14",0,0,17,0,0,17,0,0
"Republic of Korea","2024-12-15",0,0,17,0,0,17,0,0
"Republic of Korea","2024-12-16",0,0,17,0,0,17,0,0
"Republic of Korea","2024-12-17",0,0,17,0,0,17,0,0
"Republic of Korea","2024-12-18",0,0,17,0,0,17,0,0
"Republic of Korea","2024-12-19",0,0,17,0,0,17,0,0
"Republic of Korea","2024-12-20",0,0,17,0,0,17,0,0
"Republic of Korea","2024-12-21",0,0,17,0,0,17,0,0
"Republic of Korea","2024-12-22",0,0,17,0,0,17,0,0
"Republic of Korea","2024-12-23",0,0,17,0,0,17,0,0
"Republic of Korea","2024-12-24",0,0,17,0,0,17,0,0
"Republic of Korea","2024-12-25",0,0,17,0,0,17,0,0
"Republic of Korea","2024-12-26",0,0,17,0,0,17,0,0
"Republic of Korea","2024-12-27",0,0,17,0,0,17,0,0
"Republic of Korea","2024-12-28",0,0,17,0,0,17,0,0
"Republic of Korea","2024-12-29",0,0,17,0,0,17,0,0
"Republic of Korea","2024-12-30",0,0,17,0,0,17,0,0
"Republic of Korea","2024-12-31",0,0,17,0,0,17,0,0
"Republic of Korea","2025-01-01",0,0,17,0,0,17,0,0
"Republic of Korea","2025-01-02",0,0,17,0,0,17,0,0
"Republic of Korea","2025-01-03",0,0,17,0,0,17,0,0
"Republic of Korea","2025-01-04",0,0,17,0,0,17,0,0
"Republic of Korea","2025-01-05",0,0,17,0,0,17,0,0
"Republic of Korea","2025-01-06",0,0,17,0,0,17,0,0
"Republic of Korea","2025-01-07",0,0,17,0,0,17,0,0
"Republic of Korea","2025-01-08",0,0,17,0,0,17,0,0
"Republic of Korea","2025-01-09",0,0,17,0,0,17,0,0
"Republic of Korea","2025-01-10",0,0,17,0,0,17,0,0
"Republic of Korea","2025-01-11",0,0,17,0,0,17,0,0
"Republic of Korea","2025-01-12",0,0,17,0,0,17,0,0
"Republic of Korea","2025-01-13",0,0,17,0,0,17,0,0
"Republic of Korea","2025-01-14",0,0,17,0,0,17,0,0
"Republic of Korea","2025-01-15",0,0,17,0,0,17,0,0
"Republic of Korea","2025-01-16",0,0,17,0,0,17,0,0
"Republic of Korea","2025-01-17",0,0,17,0,0,17,0,0
"Republic of Korea","2025-01-18",0,0,17,0,0,17,0,0
"Republic of Korea","2025-01-19",0,0,17,0,0,17,0,0
"Republic of Korea","2025-01-20",0,0,17,0,0,17,0,0
"Republic of Korea","2025-01-21",0,0,17,0,0,17,0,0
"Republic of Korea","2025-01-22",0,0,17,0,0,17,0,0
"Republic of Korea","2025-01-23",0,0,17,0,0,17,0,0
"Republic of Korea","2025-01-24",0,0,17,0,0,17,0,0
"Republic of Korea","2025-01-25",0,0,17,0,0,17,0,0
"Republic of Korea","2025-01-26",0,0,17,0,0,17,0,0
"Republic of Korea","2025-01-27",0,0,17,0,0,17,0,0
"Republic of Korea","2025-01-28",0,0,17,0,0,17,0,0
"Republic of Korea","2025-01-29",0,0,17,0,0,17,0,0
"Republic of Korea","2025-01-30",0,0,17,0,0,17,0,0
"Republic of Korea","2025-01-31",0,0,17,0,0,17,0,0
"Republic of Korea","2025-02-01",0,0,17,0,0,17,0,0
"Republic of Korea","2025-02-02",0,0,17,0,0,17,0,0
"Republic of Korea","2025-02-03",0,0,17,0,0,17,0,0
"Spain","2024-01-01",0,0,0,0,0,0,0,0
"Spain","2024-01-02",0,0,0,0,0,0,0,0
"Spain","2024-01-03",0,0,0,0,0,0,0,0
"Spain","2024-01-04",0,0,0,0,0,0,0,0
"Spain","2024-01-05",0,0,0,0,0,0,0,0
"Spain","2024-01-06",0,0,0,0,0,0,0,0
"Spain","2024-01-07",0,0,0,0,0,0,0,0
"Spain","2024-01-08",0,0,0,0,0,0,0,0
"Spain","2024-01-09",0,0,0,0,0,0,0,0
"Spain","2024-01-10",0,0,0,0,0,0,0,0
"Spain","2024-01-11",0,0,0,0,0,0,0,0
"Spain","2024-01-12",0,0,0,0,0,0,0,0
"Spain","2024-01-13",0,0,0,0,0,0,0,0
"Spain","2024-01-14",0,0,0,0,0,0,0,0
"Spain","2024-01-15",0,0,0,0,0,0,0,0
"Spain","2024-01-16",0,0,0,0,0,0,0,0
"Spain","2024-01-17",0,0,0,0,0,0,0,0
"Spain","2024-01-18",0,0,0,0,0,0,0,0
"Spain","2024-01-19",0,0,0,0,0,0,0,0
"Spain","2024-01-20",0,0,0,0,0,0,0,0
"Spain","2024-01-21",0,0,0,0,0,0,0,0
"Spain","2024-01-22",0,0,0,0,0,0,0,0
"Spain","2024-01-23",0,0,0,0,0,0,0,0
"Spain","2024-01-24",0,0,0,0,0,0,0,0
"Spain","2024-01-25",0,0,0,0,0,0,0,0
"Spain","2024-01-26",0,0,0,0,0,0,0,0
"Spain","2024-01-27",0,0,0,0,0,0,0,0
"Spain","2024-01-28",0,0,0,0,0,0,0,0
"Spain","2024-01-29",0,0,0,0,0,0,0,0
"Spain","2024-01-30",0,0,0,0,0,0,0,0
"Spain","2024-01-31",0,34,34,0,34,34,0,0
"Spain","2024-02-01",0,0,34,0,4,38,0,0
"Spain","2024-02-02",0,0,34,0,4,42,0,0
"Spain","2024-02-03",0,0,34,0,4,46,0,0
"Spain","2024-02-04",0,0,34,0,3,49,0,0
"Spain","2024-02-05",0,0,34,0,4,53,0,0
"Spain","2024-02-06",0,0,34,0,4,57,0,0
"Spain","2024-02-07",0,0,34,0,4,61,0,0
"Spain","2024-02-08",0,0,34,0,4,65,0,0
"Spain","2024-02-09",0,0,34,0,4,69,0,0
"Spain","2024-02-10",0,0,34,0,4,73,0,0
"Spain","2024-02-11",0,0,34,0,3,76,0,0
"Spain","2024-02-12",0,0,34,0,4,80,0,0
"Spain","2024-02-13",0,0,34,0,4,84,0,0
"Spain","2024-02-14",0,0,34,0,4,88,0,0
"Spain","2024-02-15",0,0,34,0,4,92,0,0
"Spain","2024-02-16",0,0,34,0,4,96,0,0
"Spain","2024-02-17",0,0,34,0,4,100,0,0
"Spain","2024-02-18",0,0,34,0,4,104,0,0
"Spain","2024-02-19",0,0,34,0,3,107,0,0
"Spain","2024-02-20",0,0,34,0,4,111,0,0
"Spain","2024-02-21",0,0,34,0,4,115,0,0
"Spain","2024-02-22",0,0,34,0,4,119,0,0
"Spain","2024-02-23",0,0,34,0,4,123,0,0
"Spain","2024-02-24",0,0,34,0,4,127,0,0
"Spain","2024-02-25",0,0,34,0,4,131,0,0
"Spain","2024-02-26",0,0,34,0,3,134,0,0
"Spain","2024-02-27",0,0,34,0,4,138,0,0
"Spain","2024-02-28",0,0,34,0,4,142,0,0
"Spain","2024-02-29",0,112,146,0,4,146,0,0
"Spain","2024-03-01",0,0,146,0,2,148,0,0
"Spain","2024-03-02",0,0,146,0,2,150,0,0
"Spain","2024-03-03",0,0,146,0,2,152,0,0
"Spain","2024-03-04",0,0,146,0,2,154,0,0
"Spain","2024-03-05",0,0,146,0,2,156,0,0
"Spain","2024-03-06",0,0,146,0,2,158,0,0
"Spain","2024-03-07",0,0,146,0,2,160,0,0
"Spain","2024-03-08",0,0,146,0,2,162,0,0
"Spain","2024-03-09",0,0,146,0,2,164,0,0
"Spain","2024-03-10",0,0,146,0,2,166,0,0
"Spain","2024-03-11",0,0,146,0,2,168,0,0
"Spain","2024-03-12",0,0,146,0,2,170,0,0
"Spain","2024-03-13",0,0,146,0,2,172,0,0
"Spain","2024-03-14",0,0,146,0,2,174,0,0
"Spain","2024-03-15",0,0,146,0,2,176,0,0
"Spain","2024-03-16",0,0,146,0,2,178,0,0
"Spain","2024-03-17",0,0,146,0,2,180,0,0
"Spain","2024-03-18",0,0,146,0,2,182,0,0
"Spain","2024-03-19",0,0,146,0,2,184,0,0
"Spain","2024-03-20",0,0,146,0,2,186,0,0
"Spain","2024-03-21",0,0,146,0,2,188,0,0
"Spain","2024-03-22",0,0,146,0,2,190,0,0
"Spain","2024-03-23",0,0,146,0,2,192,0,0
"Spain","2024-03-24",0,0,146,0,2,194,0,0
"Spain","2024-03-25",0,0,146,0,2,196,0,0
"Spain","2024-03-26",0,0,146,0,2,198,0,0
"Spain","2024-03-27",0,0,146,0,2,200,0,0
"Spain","2024-03-28",0,0,146,0,2,202,0,0
"Spain","2024-03-29",0,0,146,0,2,204,0,0
"Spain","2024-03-30",0,0,146,0,2,206,0,0
"Spain","2024-03-31",0,62,208,0,2,208,0,0
"Spain","2024-04-01",0,0,208,0,1,209,0,0
"Spain","2024-04-02",0,0,208,0,1,210,0,0
"Spain","2024-04-03",0,0,208,0,1,211,0,0
"Spain","2024-04-04",0,0,208,0,1,212,0,0
"Spain","2024-04-05",0,0,208,0,1,213,0,0
"Spain","2024-04-06",0,0,208,0,1,214,0,0
"Spain","2024-04-07",0,0,208,0,1,215,0,0
"Spain","2024-04-08",0,0,208,0,2,217,0,0
"Spain","2024-04-09",0,0,208,0,1,218,0,0
"Spain","2024-04-10",0,0,208,0,1,219,0,0
"Spain","2024-04-11",0,0,208,0,1,220,0,0
"Spain","2024-04-12",0,0,208,0,1,221,0,0
"Spain","2024-04-13",0,0,208,0,1,222,0,0
"Spain","2024-04-14",0,0,208,0,1,223,0,0
"Spain","2024-04-15",0,0,208,0,1,224,0,0
"Spain","2024-04-16",0,0,208,0,1,225,0,0
"Spain","2024-04-17",0,0,208,0,1,226,0,0
"Spain","2024-04-18",0,0,208,0,1,227,0,0
"Spain","2024-04-19",0,0,208,0,1,228,0,0
"Spain","2024-04-20",0,0,208,0,1,229,0,0
"Spain","2024-04-21",0,0,208,0,1,230,0,0
"Spain","2024-04-22",0,0,208,0,1,231,0,0
"Spain","2024-04-23",0,0,208,0,2,233,0,0
"Spain","2024-04-24",0,0,208,0,1,234,0,0
"Spain","2024-04-25",0,0,208,0,1,235,0,0
"Spain","2024-04-26",0,0,208,0,1,236,0,0
"Spain","2024-04-27",0,0,208,0,1,237,0,0
"Spain","2024-04-28",0,0,208,0,1,238,0,0
"Spain","2024-04-29",0,0,208,0,1,239,0,0
"Spain","2024-04-30",0,32,240,0,1,240,0,0
"Spain","2024-05-01",0,0,240,0,1,241,0,0
"Spain","2024-05-02",0,0,240,0,1,242,0,0
"Spain","2024-05-03",0,0,240,0,2,244,0,0
"Spain","2024-05-04",0,0,240,0,1,245,0,0
"Spain","2024-05-05",0,0,240,0,1,246,0,0
"Spain","2024-05-06",0,0,240,0,1,247,0,0
"Spain","2024-05-07",0,0,240,0,2,249,0,0
"Spain","2024-05-08",0,0,240,0,1,250,0,0
"Spain","2024-05-09",0,0,240,0,1,251,0,0
"Spain","2024-05-10",0,0,240,0,1,252,0,0
"Spain","2024-05-11",0,0,240,0,1,253,0,0
"Spain","2024-05-12",0,0,240,0,2,255,0,0
"Spain","2024-05-13",0,0,240,0,1,256,0,0
"Spain","2024-05-14",0,0,240,0,1,257,0,0
"Spain","2024-05-15",0,0,240,0,1,258,0,0
"Spain","2024-05-16",0,0,240,0,2,260,0,0
"Spain","2024-05-17",0,0,240,0,1,261,0,0
"Spain","2024-05-18",0,0,240,0,1,262,0,0
"Spain","2024-05-19",0,0,240,0,1,263,0,0
"Spain","2024-05-20",0,0,240,0,2,265,0,0
"Spain","2024-05-21",0,0,240,0,1,266,0,0
"Spain","2024-05-22",0,0,240,0,1,267,0,0
"Spain","2024-05-23",0,0,240,0,1,268,0,0
"Spain","2024-05-24",0,0,240,0,1,269,0,0
"Spain","2024-05-25",0,0,240,0,2,271,0,0
"Spain","2024-05-26",0,0,240,0,1,272,0,0
"Spain","2024-05-27",0,0,240,0,1,273,0,0
"Spain","2024-05-28",0,0,240,0,1,274,0,0
"Spain","2024-05-29",0,0,240,0,2,276,0,0
"Spain","2024-05-30",0,0,240,0,1,277,0,0
"Spain","2024-05-31",0,38,278,0,1,278,0,0
"Spain","2024-06-01",0,0,278,0,2,280,0,0
"Spain","2024-06-02",0,0,278,0,2,282,0,0
"Spain","2024-06-03",0,0,278,0,1,283,0,0
"Spain","2024-06-04",0,0,278,0,2,285,0,0
"Spain","2024-06-05",0,0,278,0,2,287,0,0
"Spain","2024-06-06",0,0,278,0,2,289,0,0
"Spain","2024-06-07",0,0,278,0,2,291,0,0
"Spain","2024-06-08",0,0,278,0,1,292,0,0
"Spain","2024-06-09",0,0,278,0,2,294,0,0
"Spain","2024-06-10",0,0,278,0,2,296,0,0
"Spain","2024-06-11",0,0,278,0,2,298,0,0
"Spain","2024-06-12",0,0,278,0,2,300,0,0
"Spain","2024-06-13",0,0,278,0,1,301,0,0
"Spain","2024-06-14",0,0,278,0,2,303,0,0
"Spain","2024-06-15",0,0,278,0,2,305,0,0
"Spain","2024-06-16",0,0,278,0,2,307,0,0
"Spain","2024-06-17",0,0,278,0,2,309,0,0
"Spain","2024-06-18",0,0,278,0,1,310,0,0
"Spain","2024-06-19",0,0,278,0,2,312,0,0
"Spain","2024-06-20",0,0,278,0,2,314,0,0
"Spain","2024-06-21",0,0,278,0,2,316,0,0
"Spain","2024-06-22",0,0,278,0,2,318,0,0
"Spain","2024-06-23",0,0,278,0,1,319,0,0
"Spain","2024-06-24",0,0,278,0,2,321,0,0
"Spain","2024-06-25",0,0,278,0,2,323,0,0
"Spain","2024-06-26",0,0,278,0,2,325,0,0
"Spain","2024-06-27",0,0,278,0,2,327,0,0
"Spain","2024-06-28",0,0,278,0,1,328,0,0
"Spain","2024-06-29",0,0,278,0,2,330,0,0
"Spain","2024-06-30",0,54,332,0,2,332,0,0
"Spain","2024-07-01",0,0,332,0,1,333,0,0
"Spain","2024-07-02",0,0,332,0,0,333,0,0
"Spain","2024-07-03",0,0,332,0,1,334,0,0
"Spain","2024-07-04",0,0,332,0,1,335,0,0
"Spain","2024-07-05",0,0,332,0,0,335,0,0
"Spain","2024-07-06",0,0,332,0,1,336,0,0
"Spain","2024-07-07",0,0,332,0,1,337,0,0
"Spain","2024-07-08",0,0,332,0,0,337,0,0
"Spain","2024-07-09",0,0,332,0,1,338,0,0
"Spain","2024-07-10",0,0,332,0,0,338,0,0
"Spain","2024-07-11",0,0,332,0,1,339,0,0
"Spain","2024-07-12",0,0,332,0,1,340,0,0
"Spain","2024-07-13",0,0,332,0,0,340,0,0
"Spain","2024-07-14",0,0,332,0,1,341,0,0
"Spain","2024-07-15",0,0,332,0,1,342,0,0
"Spain","2024-07-16",0,0,332,0,0,342,0,0
"Spain","2024-07-17",0,0,332,0,1,343,0,0
"Spain","2024-07-18",0,0,332,0,1,344,0,0
"Spain","2024-07-19",0,0,332,0,0,344,0,0
"Spain","2024-07-20",0,0,332,0,1,345,0,0
"Spain","2024-07-21",0,0,332,0,1,346,0,0
"Spain","2024-07-22",0,0,332,0,0,346,0,0
"Spain","2024-07-23",0,0,332,0,1,347,0,0
"Spain","2024-07-24",0,0,332,0,0,347,0,0
"Spain","2024-07-25",0,0,332,0,1,348,0,0
"Spain","2024-07-26",0,0,332,0,1,349,0,0
"Spain","2024-07-27",0,0,332,0,0,349,0,0
"Spain","2024-07-28",0,0,332,0,1,350,0,0
"Spain","2024-07-29",0,0,332,0,1,351,0,0
"Spain","2024-07-30",0,0,332,0,0,351,0,0
"Spain","2024-07-31",0,20,352,0,1,352,0,0
"Spain","2024-08-01",0,0,352,0,4,356,0,0
"Spain","2024-08-02",0,0,352,0,5,361,0,0
"Spain","2024-08-03",0,0,352,0,4,365,0,0
"Spain","2024-08-04",0,0,352,0,5,370,0,0
"Spain","2024-08-05",0,0,352,0,4,374,0,0
"Spain","2024-08-06",0,0,352,0,4,378,0,0
"Spain","2024-08-07",0,0,352,0,5,383,0,0
"Spain","2024-08-08",0,0,352,0,4,387,0,0
"Spain","2024-08-09",0,0,352,0,4,391,0,0
"Spain","2024-08-10",0,0,352,0,5,396,0,0
"Spain","2024-08-11",0,0,352,0,4,400,0,0
"Spain","2024-08-12",0,0,352,0,5,405,0,0
"Spain","2024-08-13",0,0,352,0,4,409,0,0
"Spain","2024-08-14",0,0,352,0,4,413,0,0
"Spain","2024-08-15",0,0,352,0,5,418,0,0
"Spain","2024-08-16",0,0,352,0,4,422,0,0
"Spain","2024-08-17",0,0,352,0,5,427,0,0
"Spain","2024-08-18",0,0,352,0,4,431,0,0
"Spain","2024-08-19",0,0,352,0,4,435,0,0
"Spain","2024-08-20",0,0,352,0,5,440,0,0
"Spain","2024-08-21",0,0,352,0,4,444,0,0
"Spain","2024-08-22",0,0,352,0,5,449,0,0
"Spain","2024-08-23",0,0,352,0,4,453,0,0
"Spain","2024-08-24",0,0,352,0,4,457,0,0
"Spain","2024-08-25",0,0,352,0,5,462,0,0
"Spain","2024-08-26",0,0,352,0,4,466,0,0
"Spain","2024-08-27",0,0,352,0,4,470,0,0
"Spain","2024-08-28",0,0,352,0,5,475,0,0
"Spain","2024-08-29",0,0,352,0,4,479,0,0
"Spain","2024-08-30",0,0,352,0,5,484,0,0
"Spain","2024-08-31",0,136,488,0,4,488,0,0
"Spain","2024-09-01",0,0,488,0,1,489,0,0
"Spain","2024-09-02",0,0,488,0,2,491,0,0
"Spain","2024-09-03",0,0,488,0,1,492,0,0
"Spain","2024-09-04",0,0,488,0,2,494,0,0
"Spain","2024-09-05",0,0,488,0,1,495,0,0
"Spain","2024-09-06",0,0,488,0,1,496,0,0
"Spain","2024-09-07",0,0,488,0,2,498,0,0
"Spain","2024-09-08",0,0,488,0,1,499,0,0
"Spain","2024-09-09",0,0,488,0,2,501,0,0
"Spain","2024-09-10",0,0,488,0,1,502,0,0
"Spain","2024-09-11",0,0,488,0,1,503,0,0
"Spain","2024-09-12",0,0,488,0,2,505,0,0
"Spain","2024-09-13",0,0,488,0,1,506,0,0
"Spain","2024-09-14",0,0,488,0,2,508,0,0
"Spain","2024-09-15",0,0,488,0,1,509,0,0
"Spain","2024-09-16",0,0,488,0,1,510,0,0
"Spain","2024-09-17",0,0,488,0,2,512,0,0
"Spain","2024-09-18",0,0,488,0,1,513,0,0
"Spain","2024-09-19",0,0,488,0,2,515,0,0
"Spain","2024-09-20",0,0,488,0,1,516,0,0
"Spain","2024-09-21",0,0,488,0,1,517,0,0
"Spain","2024-09-22",0,0,488,0,2,519,0,0
"Spain","2024-09-23",0,0,488,0,1,520,0,0
"Spain","2024-09-24",0,0,488,0,2,522,0,0
"Spain","2024-09-25",0,0,488,0,1,523,0,0
"Spain","2024-09-26",0,0,488,0,1,524,0,0
"Spain","2024-09-27",0,0,488,0,2,526,0,0
"Spain","2024-09-28",0,0,488,0,1,527,0,0
"Spain","2024-09-29",0,0,488,0,2,529,0,0
"Spain","2024-09-30",0,42,530,0,1,530,0,0
"Spain","2024-10-01",0,0,530,0,2,532,0,0
"Spain","2024-10-02",0,0,530,0,2,534,0,0
"Spain","2024-10-03",0,0,530,0,2,536,0,0
"Spain","2024-10-04",0,0,530,0,2,538,0,0
"Spain","2024-10-05",0,0,530,0,2,540,0,0
"Spain","2024-10-06",0,0,530,0,2,542,0,0
"Spain","2024-10-07",0,0,530,0,2,544,0,0
"Spain","2024-10-08",0,0,530,0,3,547,0,0
"Spain","2024-10-09",0,0,530,0,2,549,0,0
"Spain","2024-10-10",0,0,530,0,2,551,0,0
"Spain","2024-10-11",0,0,530,0,2,553,0,0
"Spain","2024-10-12",0,0,530,0,2,555,0,0
"Spain","2024-10-13",0,0,530,0,2,557,0,0
"Spain","2024-10-14",0,0,530,0,2,559,0,0
"Spain","2024-10-15",0,0,530,0,2,561,0,0
"Spain","2024-10-16",0,0,530,0,2,563,0,0
"Spain","2024-10-17",0,0,530,0,2,565,0,0
"Spain","2024-10-18",0,0,530,0,2,567,0,0
"Spain","2024-10-19",0,0,530,0,2,569,0,0
"Spain","2024-10-20",0,0,530,0,2,571,0,0
"Spain","2024-10-21",0,0,530,0,2,573,0,0
"Spain","2024-10-22",0,0,530,0,2,575,0,0
"Spain","2024-10-23",0,0,530,0,2,577,0,0
"Spain","2024-10-24",0,0,530,0,3,580,0,0
"Spain","2024-10-25",0,0,530,0,2,582,0,0
"Spain","2024-10-26",0,0,530,0,2,584,0,0
"Spain","2024-10-27",0,0,530,0,2,586,0,0
"Spain","2024-10-28",0,0,530,0,2,588,0,0
"Spain","2024-10-29",0,0,530,0,2,590,0,0
"Spain","2024-10-30",0,0,530,0,2,592,0,0
"Spain","2024-10-31",0,64,594,0,2,594,0,0
"Spain","2024-11-01",0,0,594,0,3,597,0,0
"Spain","2024-11-02",0,0,594,0,3,600,0,0
"Spain","2024-11-03",0,0,594,0,4,604,0,0
"Spain","2024-11-04",0,0,594,0,3,607,0,0
"Spain","2024-11-05",0,0,594,0,3,610,0,0
"Spain","2024-11-06",0,0,594,0,3,613,0,0
"Spain","2024-11-07",0,0,594,0,4,617,0,0
"Spain","2024-11-08",0,0,594,0,3,620,0,0
"Spain","2024-11-09",0,0,594,0,3,623,0,0
"Spain","2024-11-10",0,0,594,0,3,626,0,0
"Spain","2024-11-11",0,0,594,0,4,630,0,0
"Spain","2024-11-12",0,0,594,0,3,633,0,0
"Spain","2024-11-13",0,0,594,0,3,636,0,0
"Spain","2024-11-14",0,0,594,0,3,639,0,0
"Spain","2024-11-15",0,0,594,0,3,642,0,0
"Spain","2024-11-16",0,0,594,0,4,646,0,0
"Spain","2024-11-17",0,0,594,0,3,649,0,0
"Spain","2024-11-18",0,0,594,0,3,652,0,0
"Spain","2024-11-19",0,0,594,0,3,655,0,0
"Spain","2024-11-20",0,0,594,0,4,659,0,0
"Spain","2024-11-21",0,0,594,0,3,662,0,0
"Spain","2024-11-22",0,0,594,0,3,665,0,0
"Spain","2024-11-23",0,0,594,0,3,668,0,0
"Spain","2024-11-24",0,0,594,0,4,672,0,0
"Spain","2024-11-25",0,0,594,0,3,675,0,0
"Spain","2024-11-26",0,0,594,0,3,678,0,0
"Spain","2024-11-27",0,0,594,0,3,681,0,0
"Spain","2024-11-28",0,0,594,0,4,685,0,0
"Spain","2024-11-29",0,0,594,0,3,688,0,0
"Spain","2024-11-30",0,97,691,0,3,691,0,0
"Spain","2024-12-01",0,0,691,0,1,692,0,0
"Spain","2024-12-02",0,0,691,0,1,693,0,0
"Spain","2024-12-03",0,0,691,0,2,695,0,0
"Spain","2024-12-04",0,0,691,0,1,696,0,0
"Spain","2024-12-05",0,0,691,0,1,697,0,0
"Spain","2024-12-06",0,0,691,0,1,698,0,0
"Spain","2024-12-07",0,0,691,0,2,700,0,0
"Spain","2024-12-08",0,0,691,0,1,701,0,0
"Spain","2024-12-09",0,0,691,0,1,702,0,0
"Spain","2024-12-10",0,0,691,0,1,703,0,0
"Spain","2024-12-11",0,0,691,0,1,704,0,0
"Spain","2024-12-12",0,0,691,0,2,706,0,0
"Spain","2024-12-13",0,0,691,0,1,707,0,0
"Spain","2024-12-14",0,0,691,0,1,708,0,0
"Spain","2024-12-15",0,0,691,0,1,709,0,0
"Spain","2024-12-16",0,0,691,0,2,711,0,0
"Spain","2024-12-17",0,0,691,0,1,712,0,0
"Spain","2024-12-18",0,0,691,0,1,713,0,0
"Spain","2024-12-19",0,0,691,0,1,714,0,0
"Spain","2024-12-20",0,0,691,0,2,716,0,0
"Spain","2024-12-21",0,0,691,0,1,717,0,0
"Spain","2024-12-22",0,0,691,0,1,718,0,0
"Spain","2024-12-23",0,0,691,0,1,719,0,0
"Spain","2024-12-24",0,0,691,0,1,720,0,0
"Spain","2024-12-25",0,0,691,0,2,722,0,0
"Spain","2024-12-26",0,0,691,0,1,723,0,0
"Spain","2024-12-27",0,0,691,0,1,724,0,0
"Spain","2024-12-28",0,0,691,0,1,725,0,0
"Spain","2024-12-29",0,0,691,0,2,727,0,0
"Spain","2024-12-30",0,0,691,0,1,728,0,0
"Spain","2024-12-31",0,38,729,0,1,729,0,0
"Spain","2025-01-01",0,0,729,0,0,729,0,0
"Spain","2025-01-02",0,0,729,0,0,729,0,0
"Spain","2025-01-03",0,0,729,0,0,729,0,0
"Spain","2025-01-04",0,0,729,0,0,729,0,0
"Spain","2025-01-05",0,0,729,0,0,729,0,0
"Spain","2025-01-06",0,0,729,0,0,729,0,0
"Spain","2025-01-07",0,0,729,0,0,729,0,0
"Spain","2025-01-08",0,0,729,0,0,729,0,0
"Spain","2025-01-09",0,0,729,0,0,729,0,0
"Spain","2025-01-10",0,0,729,0,0,729,0,0
"Spain","2025-01-11",0,0,729,0,0,729,0,0
"Spain","2025-01-12",0,0,729,0,0,729,0,0
"Spain","2025-01-13",0,0,729,0,0,729,0,0
"Spain","2025-01-14",0,0,729,0,0,729,0,0
"Spain","2025-01-15",0,0,729,0,0,729,0,0
"Spain","2025-01-16",0,0,729,0,0,729,0,0
"Spain","2025-01-17",0,0,729,0,0,729,0,0
"Spain","2025-01-18",0,0,729,0,0,729,0,0
"Spain","2025-01-19",0,0,729,0,0,729,0,0
"Spain","2025-01-20",0,0,729,0,0,729,0,0
"Spain","2025-01-21",0,0,729,0,0,729,0,0
"Spain","2025-01-22",0,0,729,0,0,729,0,0
"Spain","2025-01-23",0,0,729,0,0,729,0,0
"Spain","2025-01-24",0,0,729,0,0,729,0,0
"Spain","2025-01-25",0,0,729,0,0,729,0,0
"Spain","2025-01-26",0,0,729,0,0,729,0,0
"Spain","2025-01-27",0,0,729,0,0,729,0,0
"Spain","2025-01-28",0,0,729,0,0,729,0,0
"Spain","2025-01-29",0,0,729,0,0,729,0,0
"Spain","2025-01-30",0,0,729,0,0,729,0,0
"Spain","2025-01-31",0,0,729,0,0,729,0,0
"Spain","2025-02-01",0,0,729,0,0,729,0,0
"Spain","2025-02-02",0,0,729,0,0,729,0,0
"Spain","2025-02-03",0,0,729,0,0,729,0,0
"Sri Lanka","2024-01-01",0,0,0,0,0,0,0,0
"Sri Lanka","2024-01-02",0,0,0,0,0,0,0,0
"Sri Lanka","2024-01-03",0,0,0,0,0,0,0,0
"Sri Lanka","2024-01-04",0,0,0,0,0,0,0,0
"Sri Lanka","2024-01-05",0,0,0,0,0,0,0,0
"Sri Lanka","2024-01-06",0,0,0,0,0,0,0,0
"Sri Lanka","2024-01-07",0,0,0,0,0,0,0,0
"Sri Lanka","2024-01-08",0,0,0,0,0,0,0,0
"Sri Lanka","2024-01-09",0,0,0,0,0,0,0,0
"Sri Lanka","2024-01-10",0,0,0,0,0,0,0,0
"Sri Lanka","2024-01-11",0,0,0,0,0,0,0,0
"Sri Lanka","2024-01-12",0,0,0,0,0,0,0,0
"Sri Lanka","2024-01-13",0,0,0,0,0,0,0,0
"Sri Lanka","2024-01-14",0,0,0,0,0,0,0,0
"Sri Lanka","2024-01-15",0,0,0,0,0,0,0,0
"Sri Lanka","2024-01-16",0,0,0,0,0,0,0,0
"Sri Lanka","2024-01-17",0,0,0,0,0,0,0,0
"Sri Lanka","2024-01-18",0,0,0,0,0,0,0,0
"Sri Lanka","2024-01-19",0,0,0,0,0,0,0,0
"Sri Lanka","2024-01-20",0,0,0,0,0,0,0,0
"Sri Lanka","2024-01-21",0,0,0,0,0,0,0,0
"Sri Lanka","2024-01-22",0,0,0,0,0,0,0,0
"Sri Lanka","2024-01-23",0,0,0,0,0,0,0,0
"Sri Lanka","2024-01-24",0,0,0,0,0,0,0,0
"Sri Lanka","2024-01-25",0,0,0,0,0,0,0,0
"Sri Lanka","2024-01-26",0,0,0,0,0,0,0,0
"Sri Lanka","2024-01-27",0,0,0,0,0,0,0,0
"Sri Lanka","2024-01-28",0,0,0,0,0,0,0,0
"Sri Lanka","2024-01-29",0,0,0,0,0,0,0,0
"Sri Lanka","2024-01-30",0,0,0,0,0,0,0,0
"Sri Lanka","2024-01-31",0,0,0,0,0,0,0,0
"Sri Lanka","2024-02-01",0,0,0,0,0,0,0,0
"Sri Lanka","2024-02-02",0,0,0,0,0,0,0,0
"Sri Lanka","2024-02-03",0,0,0,0,0,0,0,0
"Sri Lanka","2024-02-04",0,0,0,0,0,0,0,0
"Sri Lanka","2024-02-05",0,0,0,0,0,0,0,0
"Sri Lanka","2024-02-06",0,0,0,0,0,0,0,0
"Sri Lanka","2024-02-07",0,0,0,0,0,0,0,0
"Sri Lanka","2024-02-08",0,0,0,0,0,0,0,0
"Sri Lanka","2024-02-09",0,0,0,0,0,0,0,0
"Sri Lanka","2024-02-10",0,0,0,0,0,0,0,0
"Sri Lanka","2024-02-11",0,0,0,0,0,0,0,0
"Sri Lanka","2024-02-12",0,0,0,0,0,0,0,0
"Sri Lanka","2024-02-13",0,0,0,0,0,0,0,0
"Sri Lanka","2024-02-14",0,0,0,0,0,0,0,0
"Sri Lanka","2024-02-15",0,0,0,0,0,0,0,0
"Sri Lanka","2024-02-16",0,0,0,0,0,0,0,0
"Sri Lanka","2024-02-17",0,0,0,0,0,0,0,0
"Sri Lanka","2024-02-18",0,0,0,0,0,0,0,0
"Sri Lanka","2024-02-19",0,0,0,0,0,0,0,0
"Sri Lanka","2024-02-20",0,0,0,0,0,0,0,0
"Sri Lanka","2024-02-21",0,0,0,0,0,0,0,0
"Sri Lanka","2024-02-22",0,0,0,0,0,0,0,0
"Sri Lanka","2024-02-23",0,0,0,0,0,0,0,0
"Sri Lanka","2024-02-24",0,0,0,0,0,0,0,0
"Sri Lanka","2024-02-25",0,0,0,0,0,0,0,0
"Sri Lanka","2024-02-26",0,0,0,0,0,0,0,0
"Sri Lanka","2024-02-27",0,0,0,0,0,0,0,0
"Sri Lanka","2024-02-28",0,0,0,0,0,0,0,0
"Sri Lanka","2024-02-29",0,0,0,0,0,0,0,0
"Sri Lanka","2024-03-01",0,0,0,0,0,0,0,0
"Sri Lanka","2024-03-02",0,0,0,0,0,0,0,0
"Sri Lanka","2024-03-03",0,0,0,0,0,0,0,0
"Sri Lanka","2024-03-04",0,0,0,0,0,0,0,0
"Sri Lanka","2024-03-05",0,0,0,0,0,0,0,0
"Sri Lanka","2024-03-06",0,0,0,0,0,0,0,0
"Sri Lanka","2024-03-07",0,0,0,0,0,0,0,0
"Sri Lanka","2024-03-08",0,0,0,0,0,0,0,0
"Sri Lanka","2024-03-09",0,0,0,0,0,0,0,0
"Sri Lanka","2024-03-10",0,0,0,0,0,0,0,0
"Sri Lanka","2024-03-11",0,0,0,0,0,0,0,0
"Sri Lanka","2024-03-12",0,0,0,0,0,0,0,0
"Sri Lanka","2024-03-13",0,0,0,0,0,0,0,0
"Sri Lanka","2024-03-14",0,0,0,0,0,0,0,0
"Sri Lanka","2024-03-15",0,0,0,0,0,0,0,0
"Sri Lanka","2024-03-16",0,0,0,0,0,0,0,0
"Sri Lanka","2024-03-17",0,0,0,0,0,0,0,0
"Sri Lanka","2024-03-18",0,0,0,0,0,0,0,0
"Sri Lanka","2024-03-19",0,0,0,0,0,0,0,0
"Sri Lanka","2024-03-20",0,0,0,0,0,0,0,0
"Sri Lanka","2024-03-21",0,0,0,0,0,0,0,0
"Sri Lanka","2024-03-22",0,0,0,0,0,0,0,0
"Sri Lanka","2024-03-23",0,0,0,0,0,0,0,0
"Sri Lanka","2024-03-24",0,0,0,0,0,0,0,0
"Sri Lanka","2024-03-25",0,0,0,0,0,0,0,0
"Sri Lanka","2024-03-26",0,0,0,0,0,0,0,0
"Sri Lanka","2024-03-27",0,0,0,0,0,0,0,0
"Sri Lanka","2024-03-28",0,0,0,0,0,0,0,0
"Sri Lanka","2024-03-29",0,0,0,0,0,0,0,0
"Sri Lanka","2024-03-30",0,0,0,0,0,0,0,0
"Sri Lanka","2024-03-31",0,0,0,0,0,0,0,0
"Sri Lanka","2024-04-01",0,0,0,0,0,0,0,0
"Sri Lanka","2024-04-02",0,0,0,0,0,0,0,0
"Sri Lanka","2024-04-03",0,0,0,0,0,0,0,0
"Sri Lanka","2024-04-04",0,0,0,0,0,0,0,0
"Sri Lanka","2024-04-05",0,0,0,0,0,0,0,0
"Sri Lanka","2024-04-06",0,0,0,0,0,0,0,0
"Sri Lanka","2024-04-07",0,0,0,0,0,0,0,0
"Sri Lanka","2024-04-08",0,0,0,0,0,0,0,0
"Sri Lanka","2024-04-09",0,0,0,0,0,0,0,0
"Sri Lanka","2024-04-10",0,0,0,0,0,0,0,0
"Sri Lanka","2024-04-11",0,0,0,0,0,0,0,0
"Sri Lanka","2024-04-12",0,0,0,0,0,0,0,0
"Sri Lanka","2024-04-13",0,0,0,0,0,0,0,0
"Sri Lanka","2024-04-14",0,0,0,0,0,0,0,0
"Sri Lanka","2024-04-15",0,0,0,0,0,0,0,0
"Sri Lanka","2024-04-16",0,0,0,0,0,0,0,0
"Sri Lanka","2024-04-17",0,0,0,0,0,0,0,0
"Sri Lanka","2024-04-18",0,0,0,0,0,0,0,0
"Sri Lanka","2024-04-19",0,0,0,0,0,0,0,0
"Sri Lanka","2024-04-20",0,0,0,0,0,0,0,0
"Sri Lanka","2024-04-21",0,0,0,0,0,0,0,0
"Sri Lanka","2024-04-22",0,0,0,0,0,0,0,0
"Sri Lanka","2024-04-23",0,0,0,0,0,0,0,0
"Sri Lanka","2024-04-24",0,0,0,0,0,0,0,0
"Sri Lanka","2024-04-25",0,0,0,0,0,0,0,0
"Sri Lanka","2024-04-26",0,0,0,0,0,0,0,0
"Sri Lanka","2024-04-27",0,0,0,0,0,0,0,0
"Sri Lanka","2024-04-28",0,0,0,0,0,0,0,0
"Sri Lanka","2024-04-29",0,0,0,0,0,0,0,0
"Sri Lanka","2024-04-30",0,0,0,0,0,0,0,0
"Sri Lanka","2024-05-01",0,0,0,0,0,0,0,0
"Sri Lanka","2024-05-02",0,0,0,0,0,0,0,0
"Sri Lanka","2024-05-03",0,0,0,0,0,0,0,0
"Sri Lanka","2024-05-04",0,0,0,0,0,0,0,0
"Sri Lanka","2024-05-05",0,0,0,0,0,0,0,0
"Sri Lanka","2024-05-06",0,0,0,0,0,0,0,0
"Sri Lanka","2024-05-07",0,0,0,0,0,0,0,0
"Sri Lanka","2024-05-08",0,0,0,0,0,0,0,0
"Sri Lanka","2024-05-09",0,0,0,0,0,0,0,0
"Sri Lanka","2024-05-10",0,0,0,0,0,0,0,0
"Sri Lanka","2024-05-11",0,0,0,0,0,0,0,0
"Sri Lanka","2024-05-12",0,0,0,0,0,0,0,0
"Sri Lanka","2024-05-13",0,0,0,0,0,0,0,0
"Sri Lanka","2024-05-14",0,0,0,0,0,0,0,0
"Sri Lanka","2024-05-15",0,0,0,0,0,0,0,0
"Sri Lanka","2024-05-16",0,0,0,0,0,0,0,0
"Sri Lanka","2024-05-17",0,0,0,0,0,0,0,0
"Sri Lanka","2024-05-18",0,0,0,0,0,0,0,0
"Sri Lanka","2024-05-19",0,0,0,0,0,0,0,0
"Sri Lanka","2024-05-20",0,0,0,0,0,0,0,0
"Sri Lanka","2024-05-21",0,0,0,0,0,0,0,0
"Sri Lanka","2024-05-22",0,0,0,0,0,0,0,0
"Sri Lanka","2024-05-23",0,0,0,0,0,0,0,0
"Sri Lanka","2024-05-24",0,0,0,0,0,0,0,0
"Sri Lanka","2024-05-25",0,0,0,0,0,0,0,0
"Sri Lanka","2024-05-26",0,0,0,0,0,0,0,0
"Sri Lanka","2024-05-27",0,0,0,0,0,0,0,0
"Sri Lanka","2024-05-28",0,0,0,0,0,0,0,0
"Sri Lanka","2024-05-29",0,0,0,0,0,0,0,0
"Sri Lanka","2024-05-30",0,0,0,0,0,0,0,0
"Sri Lanka","2024-05-31",0,0,0,0,0,0,0,0
"Sri Lanka","2024-06-01",0,0,0,0,0,0,0,0
"Sri Lanka","2024-06-02",0,0,0,0,0,0,0,0
"Sri Lanka","2024-06-03",0,0,0,0,0,0,0,0
"Sri Lanka","2024-06-04",0,0,0,0,0,0,0,0
"Sri Lanka","2024-06-05",0,0,0,0,0,0,0,0
"Sri Lanka","2024-06-06",0,0,0,0,0,0,0,0
"Sri Lanka","2024-06-07",0,0,0,0,0,0,0,0
"Sri Lanka","2024-06-08",0,0,0,0,0,0,0,0
"Sri Lanka","2024-06-09",0,0,0,0,0,0,0,0
"Sri Lanka","2024-06-10",0,0,0,0,0,0,0,0
"Sri Lanka","2024-06-11",0,0,0,0,0,0,0,0
"Sri Lanka","2024-06-12",0,0,0,0,0,0,0,0
"Sri Lanka","2024-06-13",0,0,0,0,0,0,0,0
"Sri Lanka","2024-06-14",0,0,0,0,0,0,0,0
"Sri Lanka","2024-06-15",0,0,0,0,0,0,0,0
"Sri Lanka","2024-06-16",0,0,0,0,0,0,0,0
"Sri Lanka","2024-06-17",0,0,0,0,0,0,0,0
"Sri Lanka","2024-06-18",0,0,0,0,0,0,0,0
"Sri Lanka","2024-06-19",0,0,0,0,0,0,0,0
"Sri Lanka","2024-06-20",0,0,0,0,0,0,0,0
"Sri Lanka","2024-06-21",0,0,0,0,0,0,0,0
"Sri Lanka","2024-06-22",0,0,0,0,0,0,0,0
"Sri Lanka","2024-06-23",0,0,0,0,0,0,0,0
"Sri Lanka","2024-06-24",0,0,0,0,0,0,0,0
"Sri Lanka","2024-06-25",0,0,0,0,0,0,0,0
"Sri Lanka","2024-06-26",0,0,0,0,0,0,0,0
"Sri Lanka","2024-06-27",0,0,0,0,0,0,0,0
"Sri Lanka","2024-06-28",0,0,0,0,0,0,0,0
"Sri Lanka","2024-06-29",0,0,0,0,0,0,0,0
"Sri Lanka","2024-06-30",0,0,0,0,0,0,0,0
"Sri Lanka","2024-07-01",0,0,0,0,0,0,0,0
"Sri Lanka","2024-07-02",0,0,0,0,0,0,0,0
"Sri Lanka","2024-07-03",0,0,0,0,0,0,0,0
"Sri Lanka","2024-07-04",0,0,0,0,0,0,0,0
"Sri Lanka","2024-07-05",0,0,0,0,0,0,0,0
"Sri Lanka","2024-07-06",0,0,0,0,0,0,0,0
"Sri Lanka","2024-07-07",0,0,0,0,0,0,0,0
"Sri Lanka","2024-07-08",0,0,0,0,0,0,0,0
"Sri Lanka","2024-07-09",0,0,0,0,0,0,0,0
"Sri Lanka","2024-07-10",0,0,0,0,0,0,0,0
"Sri Lanka","2024-07-11",0,0,0,0,0,0,0,0
"Sri Lanka","2024-07-12",0,0,0,0,0,0,0,0
"Sri Lanka","2024-07-13",0,0,0,0,0,0,0,0
"Sri Lanka","2024-07-14",0,0,0,0,0,0,0,0
"Sri Lanka","2024-07-15",0,0,0,0,0,0,0,0
"Sri Lanka","2024-07-16",0,0,0,0,0,0,0,0
"Sri Lanka","2024-07-17",0,0,0,0,0,0,0,0
"Sri Lanka","2024-07-18",0,0,0,0,0,0,0,0
"Sri Lanka","2024-07-19",0,0,0,0,0,0,0,0
"Sri Lanka","2024-07-20",0,0,0,0,0,0,0,0
"Sri Lanka","2024-07-21",0,0,0,0,0,0,0,0
"Sri Lanka","2024-07-22",0,0,0,0,0,0,0,0
"Sri Lanka","2024-07-23",0,0,0,0,0,0,0,0
"Sri Lanka","2024-07-24",0,0,0,0,0,0,0,0
"Sri Lanka","2024-07-25",0,0,0,0,0,0,0,0
"Sri Lanka","2024-07-26",0,0,0,0,0,0,0,0
"Sri Lanka","2024-07-27",0,0,0,0,0,0,0,0
"Sri Lanka","2024-07-28",0,0,0,0,0,0,0,0
"Sri Lanka","2024-07-29",0,0,0,0,0,0,0,0
"Sri Lanka","2024-07-30",0,0,0,0,0,0,0,0
"Sri Lanka","2024-07-31",0,0,0,0,0,0,0,0
"Sri Lanka","2024-08-01",0,0,0,0,0,0,0,0
"Sri Lanka","2024-08-02",0,0,0,0,0,0,0,0
"Sri Lanka","2024-08-03",0,0,0,0,0,0,0,0
"Sri Lanka","2024-08-04",0,0,0,0,0,0,0,0
"Sri Lanka","2024-08-05",0,0,0,0,0,0,0,0
"Sri Lanka","2024-08-06",0,0,0,0,0,0,0,0
"Sri Lanka","2024-08-07",0,0,0,0,0,0,0,0
"Sri Lanka","2024-08-08",0,0,0,0,0,0,0,0
"Sri Lanka","2024-08-09",0,0,0,0,0,0,0,0
"Sri Lanka","2024-08-10",0,0,0,0,0,0,0,0
"Sri Lanka","2024-08-11",0,0,0,0,0,0,0,0
"Sri Lanka","2024-08-12",0,0,0,0,0,0,0,0
"Sri Lanka","2024-08-13",0,0,0,0,0,0,0,0
"Sri Lanka","2024-08-14",0,0,0,0,0,0,0,0
"Sri Lanka","2024-08-15",0,0,0,0,0,0,0,0
"Sri Lanka","2024-08-16",0,0,0,0,0,0,0,0
"Sri Lanka","2024-08-17",0,0,0,0,0,0,0,0
"Sri Lanka","2024-08-18",0,0,0,0,0,0,0,0
"Sri Lanka","2024-08-19",0,0,0,0,0,0,0,0
"Sri Lanka","2024-08-20",0,0,0,0,0,0,0,0
"Sri Lanka","2024-08-21",0,0,0,0,0,0,0,0
"Sri Lanka","2024-08-22",0,0,0,0,0,0,0,0
"Sri Lanka","2024-08-23",0,0,0,0,0,0,0,0
"Sri Lanka","2024-08-24",0,0,0,0,0,0,0,0
"Sri Lanka","2024-08-25",0,0,0,0,0,0,0,0
"Sri Lanka","2024-08-26",0,0,0,0,0,0,0,0
"Sri Lanka","2024-08-27",0,0,0,0,0,0,0,0
"Sri Lanka","2024-08-28",0,0,0,0,0,0,0,0
"Sri Lanka","2024-08-29",0,0,0,0,0,0,0,0
"Sri Lanka","2024-08-30",0,0,0,0,0,0,0,0
"Sri Lanka","2024-08-31",0,0,0,0,0,0,0,0
"Sri Lanka","2024-09-01",0,0,0,0,0,0,0,0
"Sri Lanka","2024-09-02",0,0,0,0,0,0,0,0
"Sri Lanka","2024-09-03",0,0,0,0,0,0,0,0
"Sri Lanka","2024-09-04",0,0,0,0,0,0,0,0
"Sri Lanka","2024-09-05",0,0,0,0,0,0,0,0
"Sri Lanka","2024-09-06",0,0,0,0,0,0,0,0
"Sri Lanka","2024-09-07",0,0,0,0,0,0,0,0
"Sri Lanka","2024-09-08",0,0,0,0,0,0,0,0
"Sri Lanka","2024-09-09",0,0,0,0,0,0,0,0
"Sri Lanka","2024-09-10",0,0,0,0,0,0,0,0
"Sri Lanka","2024-09-11",0,0,0,0,0,0,0,0
"Sri Lanka","2024-09-12",0,0,0,0,0,0,0,0
"Sri Lanka","2024-09-13",0,0,0,0,0,0,0,0
"Sri Lanka","2024-09-14",0,0,0,0,0,0,0,0
"Sri Lanka","2024-09-15",0,0,0,0,0,0,0,0
"Sri Lanka","2024-09-16",0,0,0,0,0,0,0,0
"Sri Lanka","2024-09-17",0,0,0,0,0,0,0,0
"Sri Lanka","2024-09-18",0,0,0,0,0,0,0,0
"Sri Lanka","2024-09-19",0,0,0,0,0,0,0,0
"Sri Lanka","2024-09-20",0,0,0,0,0,0,0,0
"Sri Lanka","2024-09-21",0,0,0,0,0,0,0,0
"Sri Lanka","2024-09-22",0,0,0,0,0,0,0,0
"Sri Lanka","2024-09-23",0,0,0,0,0,0,0,0
"Sri Lanka","2024-09-24",0,0,0,0,0,0,0,0
"Sri Lanka","2024-09-25",0,0,0,0,0,0,0,0
"Sri Lanka","2024-09-26",0,0,0,0,0,0,0,0
"Sri Lanka","2024-09-27",0,0,0,0,0,0,0,0
"Sri Lanka","2024-09-28",0,0,0,0,0,0,0,0
"Sri Lanka","2024-09-29",0,0,0,0,0,0,0,0
"Sri Lanka","2024-09-30",0,0,0,0,0,0,0,0
"Sri Lanka","2024-10-01",0,0,0,0,0,0,0,0
"Sri Lanka","2024-10-02",0,0,0,0,0,0,0,0
"Sri Lanka","2024-10-03",0,0,0,0,0,0,0,0
"Sri Lanka","2024-10-04",0,0,0,0,0,0,0,0
"Sri Lanka","2024-10-05",0,0,0,0,0,0,0,0
"Sri Lanka","2024-10-06",0,0,0,0,0,0,0,0
"Sri Lanka","2024-10-07",0,0,0,0,0,0,0,0
"Sri Lanka","2024-10-08",0,0,0,0,0,0,0,0
"Sri Lanka","2024-10-09",0,0,0,0,0,0,0,0
"Sri Lanka","2024-10-10",0,0,0,0,0,0,0,0
"Sri Lanka","2024-10-11",0,0,0,0,0,0,0,0
"Sri Lanka","2024-10-12",0,0,0,0,0,0,0,0
"Sri Lanka","2024-10-13",0,0,0,0,0,0,0,0
"Sri Lanka","2024-10-14",0,0,0,0,0,0,0,0
"Sri Lanka","2024-10-15",0,0,0,0,0,0,0,0
"Sri Lanka","2024-10-16",0,0,0,0,0,0,0,0
"Sri Lanka","2024-10-17",0,0,0,0,0,0,0,0
"Sri Lanka","2024-10-18",0,0,0,0,0,0,0,0
"Sri Lanka","2024-10-19",0,0,0,0,0,0,0,0
"Sri Lanka","2024-10-20",0,0,0,0,0,0,0,0
"Sri Lanka","2024-10-21",0,0,0,0,0,0,0,0
"Sri Lanka","2024-10-22",0,0,0,0,0,0,0,0
"Sri Lanka","2024-10-23",0,0,0,0,0,0,0,0
"Sri Lanka","2024-10-24",0,0,0,0,0,0,0,0
"Sri Lanka","2024-10-25",0,0,0,0,0,0,0,0
"Sri Lanka","2024-10-26",0,0,0,0,0,0,0,0
"Sri Lanka","2024-10-27",0,0,0,0,0,0,0,0
"Sri Lanka","2024-10-28",0,0,0,0,0,0,0,0
"Sri Lanka","2024-10-29",0,0,0,0,0,0,0,0
"Sri Lanka","2024-10-30",0,0,0,0,0,0,0,0
"Sri Lanka","2024-10-31",0,0,0,0,0,0,0,0
"Sri Lanka","2024-11-01",0,0,0,0,0,0,0,0
"Sri Lanka","2024-11-02",0,0,0,0,0,0,0,0
"Sri Lanka","2024-11-03",0,0,0,0,0,0,0,0
"Sri Lanka","2024-11-04",0,0,0,0,0,0,0,0
"Sri Lanka","2024-11-05",0,0,0,0,0,0,0,0
"Sri Lanka","2024-11-06",0,0,0,0,0,0,0,0
"Sri Lanka","2024-11-07",0,0,0,0,0,0,0,0
"Sri Lanka","2024-11-08",0,0,0,0,0,0,0,0
"Sri Lanka","2024-11-09",0,0,0,0,0,0,0,0
"Sri Lanka","2024-11-10",0,0,0,0,0,0,0,0
"Sri Lanka","2024-11-11",0,0,0,0,0,0,0,0
"Sri Lanka","2024-11-12",0,0,0,0,0,0,0,0
"Sri Lanka","2024-11-13",0,0,0,0,0,0,0,0
"Sri Lanka","2024-11-14",0,0,0,0,0,0,0,0
"Sri Lanka","2024-11-15",0,0,0,0,0,0,0,0
"Sri Lanka","2024-11-16",0,0,0,0,0,0,0,0
"Sri Lanka","2024-11-17",0,0,0,0,0,0,0,0
"Sri Lanka","2024-11-18",0,0,0,0,0,0,0,0
"Sri Lanka","2024-11-19",0,0,0,0,0,0,0,0
"Sri Lanka","2024-11-20",0,0,0,0,0,0,0,0
"Sri Lanka","2024-11-21",0,0,0,0,0,0,0,0
"Sri Lanka","2024-11-22",0,0,0,0,0,0,0,0
"Sri Lanka","2024-11-23",0,0,0,0,0,0,0,0
"Sri Lanka","2024-11-24",0,0,0,0,0,0,0,0
"Sri Lanka","2024-11-25",0,0,0,0,0,0,0,0
"Sri Lanka","2024-11-26",0,0,0,0,0,0,0,0
"Sri Lanka","2024-11-27",0,0,0,0,0,0,0,0
"Sri Lanka","2024-11-28",0,0,0,0,0,0,0,0
"Sri Lanka","2024-11-29",0,0,0,0,0,0,0,0
"Sri Lanka","2024-11-30",0,0,0,0,0,0,0,0
"Sri Lanka","2024-12-01",0,0,0,0,0,0,0,0
"Sri Lanka","2024-12-02",0,0,0,0,0,0,0,0
"Sri Lanka","2024-12-03",0,0,0,0,0,0,0,0
"Sri Lanka","2024-12-04",0,0,0,0,0,0,0,0
"Sri Lanka","2024-12-05",0,0,0,0,0,0,0,0
"Sri Lanka","2024-12-06",0,0,0,0,0,0,0,0
"Sri Lanka","2024-12-07",0,0,0,0,0,0,0,0
"Sri Lanka","2024-12-08",0,0,0,0,0,0,0,0
"Sri Lanka","2024-12-09",0,0,0,0,0,0,0,0
"Sri Lanka","2024-12-10",0,0,0,0,0,0,0,0
"Sri Lanka","2024-12-11",0,0,0,0,0,0,0,0
"Sri Lanka","2024-12-12",0,0,0,0,0,0,0,0
"Sri Lanka","2024-12-13",0,0,0,0,0,0,0,0
"Sri Lanka","2024-12-14",0,0,0,0,0,0,0,0
"Sri Lanka","2024-12-15",0,0,0,0,0,0,0,0
"Sri Lanka","2024-12-16",0,0,0,0,0,0,0,0
"Sri Lanka","2024-12-17",0,0,0,0,0,0,0,0
"Sri Lanka","2024-12-18",0,0,0,0,0,0,0,0
"Sri Lanka","2024-12-19",0,0,0,0,0,0,0,0
"Sri Lanka","2024-12-20",0,0,0,0,0,0,0,0
"Sri Lanka","2024-12-21",0,0,0,0,0,0,0,0
"Sri Lanka","2024-12-22",0,0,0,0,0,0,0,0
"Sri Lanka","2024-12-23",0,0,0,0,0,0,0,0
"Sri Lanka","2024-12-24",0,0,0,0,0,0,0,0
"Sri Lanka","2024-12-25",0,0,0,0,0,0,0,0
"Sri Lanka","2024-12-26",0,0,0,0,0,0,0,0
"Sri Lanka","2024-12-27",0,0,0,0,0,0,0,0
"Sri Lanka","2024-12-28",0,0,0,0,0,0,0,0
"Sri Lanka","2024-12-29",0,0,0,0,0,0,0,0
"Sri Lanka","2024-12-30",0,0,0,0,0,0,0,0
"Sri Lanka","2024-12-31",0,0,0,0,0,0,0,0
"Sri Lanka","2025-01-01",0,0,0,0,0,0,0,0
"Sri Lanka","2025-01-02",0,0,0,0,0,0,0,0
"Sri Lanka","2025-01-03",0,0,0,0,0,0,0,0
"Sri Lanka","2025-01-04",0,0,0,0,0,0,0,0
"Sri Lanka","2025-01-05",0,0,0,0,0,0,0,0
"Sri Lanka","2025-01-06",0,0,0,0,0,0,0,0
"Sri Lanka","2025-01-07",0,0,0,0,0,0,0,0
"Sri Lanka","2025-01-08",0,0,0,0,0,0,0,0
"Sri Lanka","2025-01-09",0,0,0,0,0,0,0,0
"Sri Lanka","2025-01-10",0,0,0,0,0,0,0,0
"Sri Lanka","2025-01-11",0,0,0,0,0,0,0,0
"Sri Lanka","2025-01-12",0,0,0,0,0,0,0,0
"Sri Lanka","2025-01-13",0,0,0,0,0,0,0,0
"Sri Lanka","2025-01-14",0,0,0,0,0,0,0,0
"Sri Lanka","2025-01-15",0,0,0,0,0,0,0,0
"Sri Lanka","2025-01-16",0,0,0,0,0,0,0,0
"Sri Lanka","2025-01-17",0,0,0,0,0,0,0,0
"Sri Lanka","2025-01-18",0,0,0,0,0,0,0,0
"Sri Lanka","2025-01-19",0,0,0,0,0,0,0,0
"Sri Lanka","2025-01-20",0,0,0,0,0,0,0,0
"Sri Lanka","2025-01-21",0,0,0,0,0,0,0,0
"Sri Lanka","2025-01-22",0,0,0,0,0,0,0,0
"Sri Lanka","2025-01-23",0,0,0,0,0,0,0,0
"Sri Lanka","2025-01-24",0,0,0,0,0,0,0,0
"Sri Lanka","2025-01-25",0,0,0,0,0,0,0,0
"Sri Lanka","2025-01-26",0,0,0,0,0,0,0,0
"Sri Lanka","2025-01-27",0,0,0,0,0,0,0,0
"Sri Lanka","2025-01-28",0,0,0,0,0,0,0,0
"Sri Lanka","2025-01-29",0,0,0,0,0,0,0,0
"Sri Lanka","2025-01-30",0,0,0,0,0,0,0,0
"Sri Lanka","2025-01-31",0,0,0,0,0,0,0,0
"Sri Lanka","2025-02-01",0,0,0,0,0,0,0,0
"Sri Lanka","2025-02-02",0,0,0,0,0,0,0,0
"Sri Lanka","2025-02-03",0,0,0,0,0,0,0,0
"Sweden","2024-01-01",0,0,0,0,0,0,0,0
"Sweden","2024-01-02",0,0,0,0,0,0,0,0
"Sweden","2024-01-03",0,0,0,0,0,0,0,0
"Sweden","2024-01-04",0,0,0,0,0,0,0,0
"Sweden","2024-01-05",0,0,0,0,0,0,0,0
"Sweden","2024-01-06",0,0,0,0,0,0,0,0
"Sweden","2024-01-07",0,0,0,0,0,0,0,0
"Sweden","2024-01-08",0,0,0,0,0,0,0,0
"Sweden","2024-01-09",0,0,0,0,0,0,0,0
"Sweden","2024-01-10",0,0,0,0,0,0,0,0
"Sweden","2024-01-11",0,0,0,0,0,0,0,0
"Sweden","2024-01-12",0,0,0,0,0,0,0,0
"Sweden","2024-01-13",0,0,0,0,0,0,0,0
"Sweden","2024-01-14",0,0,0,0,0,0,0,0
"Sweden","2024-01-15",0,0,0,0,0,0,0,0
"Sweden","2024-01-16",0,0,0,0,0,0,0,0
"Sweden","2024-01-17",0,0,0,0,0,0,0,0
"Sweden","2024-01-18",0,0,0,0,0,0,0,0
"Sweden","2024-01-19",0,0,0,0,0,0,0,0
"Sweden","2024-01-20",0,0,0,0,0,0,0,0
"Sweden","2024-01-21",0,0,0,0,0,0,0,0
"Sweden","2024-01-22",0,0,0,0,0,0,0,0
"Sweden","2024-01-23",0,0,0,0,0,0,0,0
"Sweden","2024-01-24",0,0,0,0,0,0,0,0
"Sweden","2024-01-25",0,0,0,0,0,0,0,0
"Sweden","2024-01-26",0,0,0,0,0,0,0,0
"Sweden","2024-01-27",0,0,0,0,0,0,0,0
"Sweden","2024-01-28",0,0,0,0,0,0,0,0
"Sweden","2024-01-29",0,0,0,0,0,0,0,0
"Sweden","2024-01-30",0,0,0,0,0,0,0,0
"Sweden","2024-01-31",0,3,3,0,3,3,0,0
"Sweden","2024-02-01",0,0,3,0,0,3,0,0
"Sweden","2024-02-02",0,0,3,0,0,3,0,0
"Sweden","2024-02-03",0,0,3,0,0,3,0,0
"Sweden","2024-02-04",0,0,3,0,0,3,0,0
"Sweden","2024-02-05",0,0,3,0,0,3,0,0
"Sweden","2024-02-06",0,0,3,0,0,3,0,0
"Sweden","2024-02-07",0,0,3,0,0,3,0,0
"Sweden","2024-02-08",0,0,3,0,1,4,0,0
"Sweden","2024-02-09",0,0,3,0,0,4,0,0
"Sweden","2024-02-10",0,0,3,0,0,4,0,0
"Sweden","2024-02-11",0,0,3,0,0,4,0,0
"Sweden","2024-02-12",0,0,3,0,0,4,0,0
"Sweden","2024-02-13",0,0,3,0,0,4,0,0
"Sweden","2024-02-14",0,0,3,0,0,4,0,0
"Sweden","2024-02-15",0,0,3,0,0,4,0,0
"Sweden","2024-02-16",0,0,3,0,0,4,0,0
"Sweden","2024-02-17",0,0,3,0,0,4,0,0
"Sweden","2024-02-18",0,0,3,0,0,4,0,0
"Sweden","2024-02-19",0,0,3,0,0,4,0,0
"Sweden","2024-02-20",0,0,3,0,0,4,0,0
"Sweden","2024-02-21",0,0,3,0,0,4,0,0
"Sweden","2024-02-22",0,0,3,0,1,5,0,0
"Sweden","2024-02-23",0,0,3,0,0,5,0,0
"Sweden","2024-02-24",0,0,3,0,0,5,0,0
"Sweden","2024-02-25",0,0,3,0,0,5,0,0
"Sweden","2024-02-26",0,0,3,0,0,5,0,0
"Sweden","2024-02-27",0,0,3,0,0,5,0,0
"Sweden","2024-02-28",0,0,3,0,0,5,0,0
"Sweden","2024-02-29",0,2,5,0,0,5,0,0
"Sweden","2024-03-01",0,0,5,0,0,5,0,0
"Sweden","2024-03-02",0,0,5,0,0,5,0,0
"Sweden","2024-03-03",0,0,5,0,1,6,0,0
"Sweden","2024-03-04",0,0,5,0,0,6,0,0
"Sweden","2024-03-05",0,0,5,0,0,6,0,0
"Sweden","2024-03-06",0,0,5,0,0,6,0,0
"Sweden","2024-03-07",0,0,5,0,1,7,0,0
"Sweden","2024-03-08",0,0,5,0,0,7,0,0
"Sweden","2024-03-09",0,0,5,0,0,7,0,0
"Sweden","2024-03-10",0,0,5,0,0,7,0,0
"Sweden","2024-03-11",0,0,5,0,1,8,0,0
"Sweden","2024-03-12",0,0,5,0,0,8,0,0
"Sweden","2024-03-13",0,0,5,0,0,8,0,0
"Sweden","2024-03-14",0,0,5,0,0,8,0,0
"Sweden","2024-03-15",0,0,5,0,0,8,0,0
"Sweden","2024-03-16",0,0,5,0,1,9,0,0
"Sweden","2024-03-17",0,0,5,0,0,9,0,0
"Sweden","2024-03-18",0,0,5,0,0,9,0,0
"Sweden","2024-03-19",0,0,5,0,0,9,0,0
"Sweden","2024-03-20",0,0,5,0,1,10,0,0
"Sweden","2024-03-21",0,0,5,0,0,10,0,0
"Sweden","2024-03-22",0,0,5,0,0,10,0,0
"Sweden","2024-03-23",0,0,5,0,0,10,0,0
"Sweden","2024-03-24",0,0,5,0,1,11,0,0
"Sweden","2024-03-25",0,0,5,0,0,11,0,0
"Sweden","2024-03-26",0,0,5,0,0,11,0,0
"Sweden","2024-03-27",0,0,5,0,0,11,0,0
"Sweden","2024-03-28",0,0,5,0,0,11,0,0
"Sweden","2024-03-29",0,0,5,0,1,12,0,0
"Sweden","2024-03-30",0,0,5,0,0,12,0,0
"Sweden","2024-03-31",0,0,5,0,0,12,0,0
"Sweden","2024-04-01",0,0,5,0,0,12,0,0
"Sweden","2024-04-02",0,0,5,0,1,13,0,0
"Sweden","2024-04-03",0,0,5,0,0,13,0,0
"Sweden","2024-04-04",0,0,5,0,0,13,0,0
"Sweden","2024-04-05",0,0,5,0,0,13,0,0
"Sweden","2024-04-06",0,0,5,0,0,13,0,0
"Sweden","2024-04-07",0,0,5,0,1,14,0,0
"Sweden","2024-04-08",0,0,5,0,0,14,0,0
"Sweden","2024-04-09",0,0,5,0,0,14,0,0
"Sweden","2024-04-10",0,0,5,0,0,14,0,0
"Sweden","2024-04-11",0,0,5,0,1,15,0,0
"Sweden","2024-04-12",0,0,5,0,0,15,0,0
"Sweden","2024-04-13",0,0,5,0,0,15,0,0
"Sweden","2024-04-14",0,0,5,0,0,15,0,0
"Sweden","2024-04-15",0,0,5,0,1,16,0,0
"Sweden","2024-04-16",0,0,5,0,0,16,0,0
"Sweden","2024-04-17",0,0,5,0,0,16,0,0
"Sweden","2024-04-18",0,0,5,0,0,16,0,0
"Sweden","2024-04-19",0,0,5,0,0,16,0,0
"Sweden","2024-04-20",0,0,5,0,1,17,0,0
"Sweden","2024-04-21",0,0,5,0,0,17,0,0
"Sweden","2024-04-22",0,0,5,0,0,17,0,0
"Sweden","2024-04-23",0,0,5,0,0,17,0,0
"Sweden","2024-04-24",0,0,5,0,1,18,0,0
"Sweden","2024-04-25",0,0,5,0,0,18,0,0
"Sweden","2024-04-26",0,0,5,0,0,18,0,0
"Sweden","2024-04-27",0,0,5,0,0,18,0,0
"Sweden","2024-04-28",0,0,5,0,1,19,0,0
"Sweden","2024-04-29",0,0,5,0,0,19,0,0
"Sweden","2024-04-30",0,14,19,0,0,19,0,0
"Sweden","2024-05-01",0,0,19,0,0,19,0,0
"Sweden","2024-05-02",0,0,19,0,1,20,0,0
"Sweden","2024-05-03",0,0,19,0,0,20,0,0
"Sweden","2024-05-04",0,0,19,0,0,20,0,0
"Sweden","2024-05-05",0,0,19,0,1,21,0,0
"Sweden","2024-05-06",0,0,19,0,0,21,0,0
"Sweden","2024-05-07",0,0,19,0,0,21,0,0
"Sweden","2024-05-08",0,0,19,0,1,22,0,0
"Sweden","2024-05-09",0,0,19,0,0,22,0,0
"Sweden","2024-05-10",0,0,19,0,1,23,0,0
"Sweden","2024-05-11",0,0,19,0,0,23,0,0
"Sweden","2024-05-12",0,0,19,0,0,23,0,0
"Sweden","2024-05-13",0,0,19,0,1,24,0,0
"Sweden","2024-05-14",0,0,19,0,0,24,0,0
"Sweden","2024-05-15",0,0,19,0,0,24,0,0
"Sweden","2024-05-16",0,0,19,0,1,25,0,0
"Sweden","2024-05-17",0,0,19,0,0,25,0,0
"Sweden","2024-05-18",0,0,19,0,0,25,0,0
"Sweden","2024-05-19",0,0,19,0,1,26,0,0
"Sweden","2024-05-20",0,0,19,0,0,26,0,0
"Sweden","2024-05-21",0,0,19,0,0,26,0,0
"Sweden","2024-05-22",0,0,19,0,1,27,0,0
"Sweden","2024-05-23",0,0,19,0,0,27,0,0
"Sweden","2024-05-24",0,0,19,0,1,28,0,0
"Sweden","2024-05-25",0,0,19,0,0,28,0,0
"Sweden","2024-05-26",0,0,19,0,0,28,0,0
"Sweden","2024-05-27",0,0,19,0,1,29,0,0
"Sweden","2024-05-28",0,0,19,0,0,29,0,0
"Sweden","2024-05-29",0,0,19,0,0,29,0,0
"Sweden","2024-05-30",0,0,19,0,1,30,0,0
"Sweden","2024-05-31",0,11,30,0,0,30,0,0
"Sweden","2024-06-01",0,0,30,0,0,30,0,0
"Sweden","2024-06-02",0,0,30,0,0,30,0,0
"Sweden","2024-06-03",0,0,30,0,0,30,0,0
"Sweden","2024-06-04",0,0,30,0,0,30,0,0
"Sweden","2024-06-05",0,0,30,0,0,30,0,0
"Sweden","2024-06-06",0,0,30,0,0,30,0,0
"Sweden","2024-06-07",0,0,30,0,0,30,0,0
"Sweden","2024-06-08",0,0,30,0,1,31,0,0
"Sweden","2024-06-09",0,0,30,0,0,31,0,0
"Sweden","2024-06-10",0,0,30,0,0,31,0,0
"Sweden","2024-06-11",0,0,30,0,0,31,0,0
"Sweden","2024-06-12",0,0,30,0,0,31,0,0
"Sweden","2024-06-13",0,0,30,0,0,31,0,0
"Sweden","2024-06-14",0,0,30,0,0,31,0,0
"Sweden","2024-06-15",0,0,30,0,0,31,0,0
"Sweden","2024-06-16",0,0,30,0,0,31,0,0
"Sweden","2024-06-17",0,0,30,0,0,31,0,0
"Sweden","2024-06-18",0,0,30,0,0,31,0,0
"Sweden","2024-06-19",0,0,30,0,0,31,0,0
"Sweden","2024-06-20",0,0,30,0,0,31,0,0
"Sweden","2024-06-21",0,0,30,0,0,31,0,0
"Sweden","2024-06-22",0,0,30,0,0,31,0,0
"Sweden","2024-06-23",0,0,30,0,1,32,0,0
"Sweden","2024-06-24",0,0,30,0,0,32,0,0
"Sweden","2024-06-25",0,0,30,0,0,32,0,0
"Sweden","2024-06-26",0,0,30,0,0,32,0,0
"Sweden","2024-06-27",0,0,30,0,0,32,0,0
"Sweden","2024-06-28",0,0,30,0,0,32,0,0
"Sweden","2024-06-29",0,0,30,0,0,32,0,0
"Sweden","2024-06-30",0,2,32,0,0,32,0,0
"Sweden","2024-07-01",0,0,32,0,0,32,0,0
"Sweden","2024-07-02",0,0,32,0,0,32,0,0
"Sweden","2024-07-03",0,0,32,0,0,32,0,0
"Sweden","2024-07-04",0,0,32,0,0,32,0,0
"Sweden","2024-07-05",0,0,32,0,0,32,0,0
"Sweden","2024-07-06",0,0,32,0,0,32,0,0
"Sweden","2024-07-07",0,0,32,0,0,32,0,0
"Sweden","2024-07-08",0,0,32,0,0,32,0,0
"Sweden","2024-07-09",0,0,32,0,0,32,0,0
"Sweden","2024-07-10",0,0,32,0,0,32,0,0
"Sweden","2024-07-11",0,0,32,0,0,32,0,0
"Sweden","2024-07-12",0,0,32,0,0,32,0,0
"Sweden","2024-07-13",0,0,32,0,0,32,0,0
"Sweden","2024-07-14",0,0,32,0,0,32,0,0
"Sweden","2024-07-15",0,0,32,0,0,32,0,0
"Sweden","2024-07-16",0,0,32,0,1,33,0,0
"Sweden","2024-07-17",0,0,32,0,0,33,0,0
"Sweden","2024-07-18",0,0,32,0,0,33,0,0
"Sweden","2024-07-19",0,0,32,0,0,33,0,0
"Sweden","2024-07-20",0,0,32,0,0,33,0,0
"Sweden","2024-07-21",0,0,32,0,0,33,0,0
"Sweden","2024-07-22",0,0,32,0,0,33,0,0
"Sweden","2024-07-23",0,0,32,0,0,33,0,0
"Sweden","2024-07-24",0,0,32,0,0,33,0,0
"Sweden","2024-07-25",0,0,32,0,0,33,0,0
"Sweden","2024-07-26",0,0,32,0,0,33,0,0
"Sweden","2024-07-27",0,0,32,0,0,33,0,0
"Sweden","2024-07-28",0,0,32,0,0,33,0,0
"Sweden","2024-07-29",0,0,32,0,0,33,0,0
"Sweden","2024-07-30",0,0,32,0,0,33,0,0
"Sweden","2024-07-31",0,1,33,0,0,33,0,0
"Sweden","2024-08-01",0,0,33,0,0,33,0,0
"Sweden","2024-08-02",0,0,33,0,0,33,0,0
"Sweden","2024-08-03",0,0,33,0,0,33,0,0
"Sweden","2024-08-04",0,0,33,0,0,33,0,0
"Sweden","2024-08-05",0,0,33,0,0,33,0,0
"Sweden","2024-08-06",0,0,33,0,0,33,0,0
"Sweden","2024-08-07",0,0,33,0,0,33,0,0
"Sweden","2024-08-08",0,0,33,0,1,34,0,0
"Sweden","2024-08-09",0,0,33,0,0,34,0,0
"Sweden","2024-08-10",0,0,33,0,0,34,0,0
"Sweden","2024-08-11",0,0,33,0,0,34,0,0
"Sweden","2024-08-12",0,0,33,0,0,34,0,0
"Sweden","2024-08-13",0,0,33,0,0,34,0,0
"Sweden","2024-08-14",0,0,33,0,0,34,0,0
"Sweden","2024-08-15",0,0,33,0,0,34,0,0
"Sweden","2024-08-16",0,0,33,0,0,34,0,0
"Sweden","2024-08-17",0,0,33,0,0,34,0,0
"Sweden","2024-08-18",0,0,33,0,0,34,0,0
"Sweden","2024-08-19",0,0,33,0,0,34,0,0
"Sweden","2024-08-20",0,0,33,0,0,34,0,0
"Sweden","2024-08-21",0,0,33,0,0,34,0,0
"Sweden","2024-08-22",0,0,33,0,0,34,0,0
"Sweden","2024-08-23",0,0,33,0,0,34,0,0
"Sweden","2024-08-24",0,0,33,0,1,35,0,0
"Sweden","2024-08-25",0,0,33,0,0,35,0,0
"Sweden","2024-08-26",0,0,33,0,0,35,0,0
"Sweden","2024-08-27",0,0,33,0,0,35,0,0
"Sweden","2024-08-28",0,0,33,0,0,35,0,0
"Sweden","2024-08-29",0,0,33,0,0,35,0,0
"Sweden","2024-08-30",0,0,33,0,0,35,0,0
"Sweden","2024-08-31",0,2,35,0,0,35,0,0
"Sweden","2024-09-01",0,0,35,0,0,35,0,0
"Sweden","2024-09-02",0,0,35,0,0,35,0,0
"Sweden","2024-09-03",0,0,35,0,0,35,0,0
"Sweden","2024-09-04",0,0,35,0,0,35,0,0
"Sweden","2024-09-05",0,0,35,0,0,35,0,0
"Sweden","2024-09-06",0,0,35,0,0,35,0,0
"Sweden","2024-09-07",0,0,35,0,0,35,0,0
"Sweden","2024-09-08",0,0,35,0,0,35,0,0
"Sweden","2024-09-09",0,0,35,0,0,35,0,0
"Sweden","2024-09-10",0,0,35,0,0,35,0,0
"Sweden","2024-09-11",0,0,35,0,1,36,0,0
"Sweden","2024-09-12",0,0,35,0,0,36,0,0
"Sweden","2024-09-13",0,0,35,0,0,36,0,0
"Sweden","2024-09-14",0,0,35,0,0,36,0,0
"Sweden","2024-09-15",0,0,35,0,0,36,0,0
"Sweden","2024-09-16",0,0,35,0,0,36,0,0
"Sweden","2024-09-17",0,0,35,0,0,36,0,0
"Sweden","2024-09-18",0,0,35,0,0,36,0,0
"Sweden","2024-09-19",0,0,35,0,0,36,0,0
"Sweden","2024-09-20",0,0,35,0,0,36,0,0
"Sweden","2024-09-21",0,0,35,0,0,36,0,0
"Sweden","2024-09-22",0,0,35,0,0,36,0,0
"Sweden","2024-09-23",0,0,35,0,0,36,0,0
"Sweden","2024-09-24",0,0,35,0,0,36,0,0
"Sweden","2024-09-25",0,0,35,0,0,36,0,0
"Sweden","2024-09-26",0,0,35,0,0,36,0,0
"Sweden","2024-09-27",0,0,35,0,0,36,0,0
"Sweden","2024-09-28",0,0,35,0,0,36,0,0
"Sweden","2024-09-29",0,0,35,0,0,36,0,0
"Sweden","2024-09-30",0,0,35,0,0,36,0,0
"Sweden","2024-10-01",0,0,35,0,1,37,0,0
"Sweden","2024-10-02",0,0,35,0,0,37,0,0
"Sweden","2024-10-03",0,0,35,0,0,37,0,0
"Sweden","2024-10-04",0,0,35,0,0,37,0,0
"Sweden","2024-10-05",0,0,35,0,0,37,0,0
"Sweden","2024-10-06",0,0,35,0,0,37,0,0
"Sweden","2024-10-07",0,0,35,0,0,37,0,0
"Sweden","2024-10-08",0,0,35,0,0,37,0,0
"Sweden","2024-10-09",0,0,35,0,0,37,0,0
"Sweden","2024-10-10",0,0,35,0,0,37,0,0
"Sweden","2024-10-11",0,0,35,0,0,37,0,0
"Sweden","2024-10-12",0,0,35,0,0,37,0,0
"Sweden","2024-10-13",0,0,35,0,0,37,0,0
"Sweden","2024-10-14",0,0,35,0,0,37,0,0
"Sweden","2024-10-15",0,0,35,0,0,37,0,0
"Sweden","2024-10-16",0,0,35,0,0,37,0,0
"Sweden","2024-10-17",0,0,35,0,0,37,0,0
"Sweden","2024-10-18",0,0,35,0,0,37,0,0
"Sweden","2024-10-19",0,0,35,0,0,37,0,0
"Sweden","2024-10-20",0,0,35,0,0,37,0,0
"Sweden","2024-10-21",0,0,35,0,1,38,0,0
"Sweden","2024-10-22",0,0,35,0,0,38,0,0
"Sweden","2024-10-23",0,0,35,0,0,38,0,0
"Sweden","2024-10-24",0,0,35,0,0,38,0,0
"Sweden","2024-10-25",0,0,35,0,0,38,0,0
"Sweden","2024-10-26",0,0,35,0,0,38,0,0
"Sweden","2024-10-27",0,0,35,0,0,38,0,0
"Sweden","2024-10-28",0,0,35,0,0,38,0,0
"Sweden","2024-10-29",0,0,35,0,0,38,0,0
"Sweden","2024-10-30",0,0,35,0,0,38,0,0
"Sweden","2024-10-31",0,3,38,0,0,38,0,0
"Sweden","2024-11-01",0,0,38,0,0,38,0,0
"Sweden","2024-11-02",0,0,38,0,0,38,0,0
"Sweden","2024-11-03",0,0,38,0,0,38,0,0
"Sweden","2024-11-04",0,0,38,0,0,38,0,0
"Sweden","2024-11-05",0,0,38,0,0,38,0,0
"Sweden","2024-11-06",0,0,38,0,0,38,0,0
"Sweden","2024-11-07",0,0,38,0,0,38,0,0
"Sweden","2024-11-08",0,0,38,0,0,38,0,0
"Sweden","2024-11-09",0,0,38,0,0,38,0,0
"Sweden","2024-11-10",0,0,38,0,0,38,0,0
"Sweden","2024-11-11",0,0,38,0,0,38,0,0
"Sweden","2024-11-12",0,0,38,0,0,38,0,0
"Sweden","2024-11-13",0,0,38,0,0,38,0,0
"Sweden","2024-11-14",0,0,38,0,0,38,0,0
"Sweden","2024-11-15",0,0,38,0,0,38,0,0
"Sweden","2024-11-16",0,0,38,0,0,38,0,0
"Sweden","2024-11-17",0,0,38,0,0,38,0,0
"Sweden","2024-11-18",0,0,38,0,0,38,0,0
"Sweden","2024-11-19",0,0,38,0,0,38,0,0
"Sweden","2024-11-20",0,0,38,0,0,38,0,0
"Sweden","2024-11-21",0,0,38,0,0,38,0,0
"Sweden","2024-11-22",0,0,38,0,0,38,0,0
"Sweden","2024-11-23",0,0,38,0,0,38,0,0
"Sweden","2024-11-24",0,0,38,0,0,38,0,0
"Sweden","2024-11-25",0,0,38,0,0,38,0,0
"Sweden","2024-11-26",0,0,38,0,0,38,0,0
"Sweden","2024-11-27",0,0,38,0,0,38,0,0
"Sweden","2024-11-28",0,0,38,0,0,38,0,0
"Sweden","2024-11-29",0,0,38,0,0,38,0,0
"Sweden","2024-11-30",0,0,38,0,0,38,0,0
"Sweden","2024-12-01",0,0,38,0,1,39,0,0
"Sweden","2024-12-02",0,0,38,0,0,39,0,0
"Sweden","2024-12-03",0,0,38,0,0,39,0,0
"Sweden","2024-12-04",0,0,38,0,0,39,0,0
"Sweden","2024-12-05",0,0,38,0,0,39,0,0
"Sweden","2024-12-06",0,0,38,0,0,39,0,0
"Sweden","2024-12-07",0,0,38,0,0,39,0,0
"Sweden","2024-12-08",0,0,38,0,0,39,0,0
"Sweden","2024-12-09",0,0,38,0,0,39,0,0
"Sweden","2024-12-10",0,0,38,0,0,39,0,0
"Sweden","2024-12-11",0,0,38,0,0,39,0,0
"Sweden","2024-12-12",0,0,38,0,0,39,0,0
"Sweden","2024-12-13",0,0,38,0,0,39,0,0
"Sweden","2024-12-14",0,0,38,0,0,39,0,0
"Sweden","2024-12-15",0,0,38,0,0,39,0,0
"Sweden","2024-12-16",0,0,38,0,0,39,0,0
"Sweden","2024-12-17",0,0,38,0,0,39,0,0
"Sweden","2024-12-18",0,0,38,0,0,39,0,0
"Sweden","2024-12-19",0,0,38,0,0,39,0,0
"Sweden","2024-12-20",0,0,38,0,0,39,0,0
"Sweden","2024-12-21",0,0,38,0,0,39,0,0
"Sweden","2024-12-22",0,0,38,0,0,39,0,0
"Sweden","2024-12-23",0,0,38,0,0,39,0,0
"Sweden","2024-12-24",0,0,38,0,0,39,0,0
"Sweden","2024-12-25",0,0,38,0,0,39,0,0
"Sweden","2024-12-26",0,0,38,0,0,39,0,0
"Sweden","2024-12-27",0,0,38,0,0,39,0,0
"Sweden","2024-12-28",0,0,38,0,0,39,0,0
"Sweden","2024-12-29",0,0,38,0,0,39,0,0
"Sweden","2024-12-30",0,0,38,0,0,39,0,0
"Sweden","2024-12-31",0,1,39,0,0,39,0,0
"Sweden","2025-01-01",0,0,39,0,0,39,0,0
"Sweden","2025-01-02",0,0,39,0,0,39,0,0
"Sweden","2025-01-03",0,0,39,0,0,39,0,0
"Sweden","2025-01-04",0,0,39,0,0,39,0,0
"Sweden","2025-01-05",0,0,39,0,0,39,0,0
"Sweden","2025-01-06",0,0,39,0,0,39,0,0
"Sweden","2025-01-07",0,0,39,0,0,39,0,0
"Sweden","2025-01-08",0,0,39,0,0,39,0,0
"Sweden","2025-01-09",0,0,39,0,0,39,0,0
"Sweden","2025-01-10",0,0,39,0,0,39,0,0
"Sweden","2025-01-11",0,0,39,0,0,39,0,0
"Sweden","2025-01-12",0,0,39,0,0,39,0,0
"Sweden","2025-01-13",0,0,39,0,0,39,0,0
"Sweden","2025-01-14",0,0,39,0,0,39,0,0
"Sweden","2025-01-15",0,0,39,0,0,39,0,0
"Sweden","2025-01-16",0,0,39,0,0,39,0,0
"Sweden","2025-01-17",0,0,39,0,0,39,0,0
"Sweden","2025-01-18",0,0,39,0,0,39,0,0
"Sweden","2025-01-19",0,0,39,0,0,39,0,0
"Sweden","2025-01-20",0,0,39,0,0,39,0,0
"Sweden","2025-01-21",0,0,39,0,0,39,0,0
"Sweden","2025-01-22",0,0,39,0,0,39,0,0
"Sweden","2025-01-23",0,0,39,0,0,39,0,0
"Sweden","2025-01-24",0,0,39,0,0,39,0,0
"Sweden","2025-01-25",0,0,39,0,0,39,0,0
"Sweden","2025-01-26",0,0,39,0,0,39,0,0
"Sweden","2025-01-27",0,0,39,0,0,39,0,0
"Sweden","2025-01-28",0,0,39,0,0,39,0,0
"Sweden","2025-01-29",0,0,39,0,0,39,0,0
"Sweden","2025-01-30",0,0,39,0,0,39,0,0
"Sweden","2025-01-31",0,0,39,0,0,39,0,0
"Sweden","2025-02-01",0,0,39,0,0,39,0,0
"Sweden","2025-02-02",0,0,39,0,0,39,0,0
"Sweden","2025-02-03",0,0,39,0,0,39,0,0
"Switzerland","2024-01-01",0,0,0,0,0,0,0,0
"Switzerland","2024-01-02",0,0,0,0,0,0,0,0
"Switzerland","2024-01-03",0,0,0,0,0,0,0,0
"Switzerland","2024-01-04",0,0,0,0,0,0,0,0
"Switzerland","2024-01-05",0,0,0,0,0,0,0,0
"Switzerland","2024-01-06",0,0,0,0,0,0,0,0
"Switzerland","2024-01-07",0,0,0,0,0,0,0,0
"Switzerland","2024-01-08",0,0,0,0,0,0,0,0
"Switzerland","2024-01-09",0,0,0,0,0,0,0,0
"Switzerland","2024-01-10",0,0,0,0,0,0,0,0
"Switzerland","2024-01-11",0,0,0,0,0,0,0,0
"Switzerland","2024-01-12",0,0,0,0,0,0,0,0
"Switzerland","2024-01-13",0,0,0,0,0,0,0,0
"Switzerland","2024-01-14",0,0,0,0,0,0,0,0
"Switzerland","2024-01-15",0,0,0,0,0,0,0,0
"Switzerland","2024-01-16",0,0,0,0,0,0,0,0
"Switzerland","2024-01-17",0,0,0,0,0,0,0,0
"Switzerland","2024-01-18",0,0,0,0,0,0,0,0
"Switzerland","2024-01-19",0,0,0,0,0,0,0,0
"Switzerland","2024-01-20",0,0,0,0,0,0,0,0
"Switzerland","2024-01-21",0,0,0,0,0,0,0,0
"Switzerland","2024-01-22",0,0,0,0,0,0,0,0
"Switzerland","2024-01-23",0,0,0,0,0,0,0,0
"Switzerland","2024-01-24",0,0,0,0,0,0,0,0
"Switzerland","2024-01-25",0,0,0,0,0,0,0,0
"Switzerland","2024-01-26",0,0,0,0,0,0,0,0
"Switzerland","2024-01-27",0,0,0,0,0,0,0,0
"Switzerland","2024-01-28",0,0,0,0,0,0,0,0
"Switzerland","2024-01-29",0,0,0,0,0,0,0,0
"Switzerland","2024-01-30",0,0,0,0,0,0,0,0
"Switzerland","2024-01-31",0,9,9,0,9,9,0,0
"Switzerland","2024-02-01",0,0,9,0,0,9,0,0
"Switzerland","2024-02-02",0,0,9,0,0,9,0,0
"Switzerland","2024-02-03",0,0,9,0,1,10,0,0
"Switzerland","2024-02-04",0,0,9,0,0,10,0,0
"Switzerland","2024-02-05",0,0,9,0,0,10,0,0
"Switzerland","2024-02-06",0,0,9,0,0,10,0,0
"Switzerland","2024-02-07",0,0,9,0,1,11,0,0
"Switzerland","2024-02-08",0,0,9,0,0,11,0,0
"Switzerland","2024-02-09",0,0,9,0,0,11,0,0
"Switzerland","2024-02-10",0,0,9,0,0,11,0,0
"Switzerland","2024-02-11",0,0,9,0,1,12,0,0
"Switzerland","2024-02-12",0,0,9,0,0,12,0,0
"Switzerland","2024-02-13",0,0,9,0,0,12,0,0
"Switzerland","2024-02-14",0,0,9,0,0,12,0,0
"Switzerland","2024-02-15",0,0,9,0,1,13,0,0
"Switzerland","2024-02-16",0,0,9,0,0,13,0,0
"Switzerland","2024-02-17",0,0,9,0,0,13,0,0
"Switzerland","2024-02-18",0,0,9,0,0,13,0,0
"Switzerland","2024-02-19",0,0,9,0,1,14,0,0
"Switzerland","2024-02-20",0,0,9,0,0,14,0,0
"Switzerland","2024-02-21",0,0,9,0,0,14,0,0
"Switzerland","2024-02-22",0,0,9,0,0,14,0,0
"Switzerland","2024-02-23",0,0,9,0,1,15,0,0
"Switzerland","2024-02-24",0,0,9,0,0,15,0,0
"Switzerland","2024-02-25",0,0,9,0,0,15,0,0
"Switzerland","2024-02-26",0,0,9,0,0,15,0,0
"Switzerland","2024-02-27",0,0,9,0,1,16,0,0
"Switzerland","2024-02-28",0,0,9,0,0,16,0,0
"Switzerland","2024-02-29",0,7,16,0,0,16,0,0
"Switzerland","2024-03-01",0,0,16,0,0,16,0,0
"Switzerland","2024-03-02",0,0,16,0,0,16,0,0
"Switzerland","2024-03-03",0,0,16,0,0,16,0,0
"Switzerland","2024-03-04",0,0,16,0,0,16,0,0
"Switzerland","2024-03-05",0,0,16,0,0,16,0,0
"Switzerland","2024-03-06",0,0,16,0,0,16,0,0
"Switzerland","2024-03-07",0,0,16,0,0,16,0,0
"Switzerland","2024-03-08",0,0,16,0,0,16,0,0
"Switzerland","2024-03-09",0,0,16,0,0,16,0,0
"Switzerland","2024-03-10",0,0,16,0,0,16,0,0
"Switzerland","2024-03-11",0,0,16,0,1,17,0,0
"Switzerland","2024-03-12",0,0,16,0,0,17,0,0
"Switzerland","2024-03-13",0,0,16,0,0,17,0,0
"Switzerland","2024-03-14",0,0,16,0,0,17,0,0
"Switzerland","2024-03-15",0,0,16,0,0,17,0,0
"Switzerland","2024-03-16",0,0,16,0,0,17,0,0
"Switzerland","2024-03-17",0,0,16,0,0,17,0,0
"Switzerland","2024-03-18",0,0,16,0,0,17,0,0
"Switzerland","2024-03-19",0,0,16,0,0,17,0,0
"Switzerland","2024-03-20",0,0,16,0,0,17,0,0
"Switzerland","2024-03-21",0,0,16,0,0,17,0,0
"Switzerland","2024-03-22",0,0,16,0,0,17,0,0
"Switzerland","2024-03-23",0,0,16,0,0,17,0,0
"Switzerland","2024-03-24",0,0,16,0,0,17,0,0
"Switzerland","2024-03-25",0,0,16,0,0,17,0,0
"Switzerland","2024-03-26",0,0,16,0,0,17,0,0
"Switzerland","2024-03-27",0,0,16,0,0,17,0,0
"Switzerland","2024-03-28",0,0,16,0,0,17,0,0
"Switzerland","2024-03-29",0,0,16,0,0,17,0,0
"Switzerland","2024-03-30",0,0,16,0,0,17,0,0
"Switzerland","2024-03-31",0,0,16,0,1,18,0,0
"Switzerland","2024-04-01",0,0,16,0,0,18,0,0
"Switzerland","2024-04-02",0,0,16,0,0,18,0,0
"Switzerland","2024-04-03",0,0,16,0,0,18,0,0
"Switzerland","2024-04-04",0,0,16,0,0,18,0,0
"Switzerland","2024-04-05",0,0,16,0,0,18,0,0
"Switzerland","2024-04-06",0,0,16,0,0,18,0,0
"Switzerland","2024-04-07",0,0,16,0,0,18,0,0
"Switzerland","2024-04-08",0,0,16,0,0,18,0,0
"Switzerland","2024-04-09",0,0,16,0,0,18,0,0
"Switzerland","2024-04-10",0,0,16,0,0,18,0,0
"Switzerland","2024-04-11",0,0,16,0,0,18,0,0
"Switzerland","2024-04-12",0,0,16,0,0,18,0,0
"Switzerland","2024-04-13",0,0,16,0,0,18,0,0
"Switzerland","2024-04-14",0,0,16,0,0,18,0,0
"Switzerland","2024-04-15",0,0,16,0,0,18,0,0
"Switzerland","2024-04-16",0,0,16,0,0,18,0,0
"Switzerland","2024-04-17",0,0,16,0,0,18,0,0
"Switzerland","2024-04-18",0,0,16,0,0,18,0,0
"Switzerland","2024-04-19",0,0,16,0,0,18,0,0
"Switzerland","2024-04-20",0,0,16,0,0,18,0,0
"Switzerland","2024-04-21",0,0,16,0,1,19,0,0
"Switzerland","2024-04-22",0,0,16,0,0,19,0,0
"Switzerland","2024-04-23",0,0,16,0,0,19,0,0
"Switzerland","2024-04-24",0,0,16,0,0,19,0,0
"Switzerland","2024-04-25",0,0,16,0,0,19,0,0
"Switzerland","2024-04-26",0,0,16,0,0,19,0,0
"Switzerland","2024-04-27",0,0,16,0,0,19,0,0
"Switzerland","2024-04-28",0,0,16,0,0,19,0,0
"Switzerland","2024-04-29",0,0,16,0,0,19,0,0
"Switzerland","2024-04-30",0,0,16,0,0,19,0,0
"Switzerland","2024-05-01",0,0,16,0,0,19,0,0
"Switzerland","2024-05-02",0,0,16,0,0,19,0,0
"Switzerland","2024-05-03",0,0,16,0,0,19,0,0
"Switzerland","2024-05-04",0,0,16,0,0,19,0,0
"Switzerland","2024-05-05",0,0,16,0,0,19,0,0
"Switzerland","2024-05-06",0,0,16,0,0,19,0,0
"Switzerland","2024-05-07",0,0,16,0,0,19,0,0
"Switzerland","2024-05-08",0,0,16,0,0,19,0,0
"Switzerland","2024-05-09",0,0,16,0,0,19,0,0
"Switzerland","2024-05-10",0,0,16,0,0,19,0,0
"Switzerland","2024-05-11",0,0,16,0,1,20,0,0
"Switzerland","2024-05-12",0,0,16,0,0,20,0,0
"Switzerland","2024-05-13",0,0,16,0,0,20,0,0
"Switzerland","2024-05-14",0,0,16,0,0,20,0,0
"Switzerland","2024-05-15",0,0,16,0,0,20,0,0
"Switzerland","2024-05-16",0,0,16,0,0,20,0,0
"Switzerland","2024-05-17",0,0,16,0,0,20,0,0
"Switzerland","2024-05-18",0,0,16,0,0,20,0,0
"Switzerland","2024-05-19",0,0,16,0,0,20,0,0
"Switzerland","2024-05-20",0,0,16,0,0,20,0,0
"Switzerland","2024-05-21",0,0,16,0,0,20,0,0
"Switzerland","2024-05-22",0,0,16,0,0,20,0,0
"Switzerland","2024-05-23",0,0,16,0,0,20,0,0
"Switzerland","2024-05-24",0,0,16,0,0,20,0,0
"Switzerland","2024-05-25",0,0,16,0,0,20,0,0
"Switzerland","2024-05-26",0,0,16,0,0,20,0,0
"Switzerland","2024-05-27",0,0,16,0,0,20,0,0
"Switzerland","2024-05-28",0,0,16,0,0,20,0,0
"Switzerland","2024-05-29",0,0,16,0,0,20,0,0
"Switzerland","2024-05-30",0,0,16,0,0,20,0,0
"Switzerland","2024-05-31",0,0,16,0,0,20,0,0
"Switzerland","2024-06-01",0,0,16,0,1,21,0,0
"Switzerland","2024-06-02",0,0,16,0,0,21,0,0
"Switzerland","2024-06-03",0,0,16,0,0,21,0,0
"Switzerland","2024-06-04",0,0,16,0,0,21,0,0
"Switzerland","2024-06-05",0,0,16,0,0,21,0,0
"Switzerland","2024-06-06",0,0,16,0,0,21,0,0
"Switzerland","2024-06-07",0,0,16,0,0,21,0,0
"Switzerland","2024-06-08",0,0,16,0,0,21,0,0
"Switzerland","2024-06-09",0,0,16,0,0,21,0,0
"Switzerland","2024-06-10",0,0,16,0,0,21,0,0
"Switzerland","2024-06-11",0,0,16,0,0,21,0,0
"Switzerland","2024-06-12",0,0,16,0,0,21,0,0
"Switzerland","2024-06-13",0,0,16,0,0,21,0,0
"Switzerland","2024-06-14",0,0,16,0,0,21,0,0
"Switzerland","2024-06-15",0,0,16,0,0,21,0,0
"Switzerland","2024-06-16",0,0,16,0,0,21,0,0
"Switzerland","2024-06-17",0,0,16,0,0,21,0,0
"Switzerland","2024-06-18",0,0,16,0,0,21,0,0
"Switzerland","2024-06-19",0,0,16,0,0,21,0,0
"Switzerland","2024-06-20",0,0,16,0,0,21,0,0
"Switzerland","2024-06-21",0,0,16,0,1,22,0,0
"Switzerland","2024-06-22",0,0,16,0,0,22,0,0
"Switzerland","2024-06-23",0,0,16,0,0,22,0,0
"Switzerland","2024-06-24",0,0,16,0,0,22,0,0
"Switzerland","2024-06-25",0,0,16,0,0,22,0,0
"Switzerland","2024-06-26",0,0,16,0,0,22,0,0
"Switzerland","2024-06-27",0,0,16,0,0,22,0,0
"Switzerland","2024-06-28",0,0,16,0,0,22,0,0
"Switzerland","2024-06-29",0,0,16,0,0,22,0,0
"Switzerland","2024-06-30",0,0,16,0,0,22,0,0
"Switzerland","2024-07-01",0,0,16,0,0,22,0,0
"Switzerland","2024-07-02",0,0,16,0,0,22,0,0
"Switzerland","2024-07-03",0,0,16,0,0,22,0,0
"Switzerland","2024-07-04",0,0,16,0,0,22,0,0
"Switzerland","2024-07-05",0,0,16,0,0,22,0,0
"Switzerland","2024-07-06",0,0,16,0,0,22,0,0
"Switzerland","2024-07-07",0,0,16,0,0,22,0,0
"Switzerland","2024-07-08",0,0,16,0,0,22,0,0
"Switzerland","2024-07-09",0,0,16,0,0,22,0,0
"Switzerland","2024-07-10",0,0,16,0,0,22,0,0
"Switzerland","2024-07-11",0,0,16,0,1,23,0,0
"Switzerland","2024-07-12",0,0,16,0,0,23,0,0
"Switzerland","2024-07-13",0,0,16,0,0,23,0,0
"Switzerland","2024-07-14",0,0,16,0,0,23,0,0
"Switzerland","2024-07-15",0,0,16,0,0,23,0,0
"Switzerland","2024-07-16",0,0,16,0,0,23,0,0
"Switzerland","2024-07-17",0,0,16,0,0,23,0,0
"Switzerland","2024-07-18",0,0,16,0,0,23,0,0
"Switzerland","2024-07-19",0,0,16,0,0,23,0,0
"Switzerland","2024-07-20",0,0,16,0,0,23,0,0
"Switzerland","2024-07-21",0,0,16,0,0,23,0,0
"Switzerland","2024-07-22",0,0,16,0,0,23,0,0
"Switzerland","2024-07-23",0,0,16,0,0,23,0,0
"Switzerland","2024-07-24",0,0,16,0,0,23,0,0
"Switzerland","2024-07-25",0,0,16,0,0,23,0,0
"Switzerland","2024-07-26",0,0,16,0,0,23,0,0
"Switzerland","2024-07-27",0,0,16,0,0,23,0,0
"Switzerland","2024-07-28",0,0,16,0,0,23,0,0
"Switzerland","2024-07-29",0,0,16,0,0,23,0,0
"Switzerland","2024-07-30",0,0,16,0,0,23,0,0
"Switzerland","2024-07-31",0,0,16,0,0,23,0,0
"Switzerland","2024-08-01",0,0,16,0,1,24,0,0
"Switzerland","2024-08-02",0,0,16,0,0,24,0,0
"Switzerland","2024-08-03",0,0,16,0,0,24,0,0
"Switzerland","2024-08-04",0,0,16,0,0,24,0,0
"Switzerland","2024-08-05",0,0,16,0,0,24,0,0
"Switzerland","2024-08-06",0,0,16,0,0,24,0,0
"Switzerland","2024-08-07",0,0,16,0,0,24,0,0
"Switzerland","2024-08-08",0,0,16,0,0,24,0,0
"Switzerland","2024-08-09",0,0,16,0,0,24,0,0
"Switzerland","2024-08-10",0,0,16,0,0,24,0,0
"Switzerland","2024-08-11",0,0,16,0,0,24,0,0
"Switzerland","2024-08-12",0,0,16,0,0,24,0,0
"Switzerland","2024-08-13",0,0,16,0,0,24,0,0
"Switzerland","2024-08-14",0,0,16,0,0,24,0,0
"Switzerland","2024-08-15",0,0,16,0,0,24,0,0
"Switzerland","2024-08-16",0,0,16,0,0,24,0,0
"Switzerland","2024-08-17",0,0,16,0,0,24,0,0
"Switzerland","2024-08-18",0,0,16,0,0,24,0,0
"Switzerland","2024-08-19",0,0,16,0,0,24,0,0
"Switzerland","2024-08-20",0,0,16,0,0,24,0,0
"Switzerland","2024-08-21",0,0,16,0,1,25,0,0
"Switzerland","2024-08-22",0,0,16,0,0,25,0,0
"Switzerland","2024-08-23",0,0,16,0,0,25,0,0
"Switzerland","2024-08-24",0,0,16,0,0,25,0,0
"Switzerland","2024-08-25",0,0,16,0,0,25,0,0
"Switzerland","2024-08-26",0,0,16,0,0,25,0,0
"Switzerland","2024-08-27",0,0,16,0,0,25,0,0
"Switzerland","2024-08-28",0,0,16,0,0,25,0,0
"Switzerland","2024-08-29",0,0,16,0,0,25,0,0
"Switzerland","2024-08-30",0,0,16,0,0,25,0,0
"Switzerland","2024-08-31",0,9,25,0,0,25,0,0
"Switzerland","2024-09-01",0,0,25,0,0,25,0,0
"Switzerland","2024-09-02",0,0,25,0,0,25,0,0
"Switzerland","2024-09-03",0,0,25,0,0,25,0,0
"Switzerland","2024-09-04",0,0,25,0,1,26,0,0
"Switzerland","2024-09-05",0,0,25,0,0,26,0,0
"Switzerland","2024-09-06",0,0,25,0,0,26,0,0
"Switzerland","2024-09-07",0,0,25,0,0,26,0,0
"Switzerland","2024-09-08",0,0,25,0,0,26,0,0
"Switzerland","2024-09-09",0,0,25,0,0,26,0,0
"Switzerland","2024-09-10",0,0,25,0,0,26,0,0
"Switzerland","2024-09-11",0,0,25,0,0,26,0,0
"Switzerland","2024-09-12",0,0,25,0,1,27,0,0
"Switzerland","2024-09-13",0,0,25,0,0,27,0,0
"Switzerland","2024-09-14",0,0,25,0,0,27,0,0
"Switzerland","2024-09-15",0,0,25,0,0,27,0,0
"Switzerland","2024-09-16",0,0,25,0,0,27,0,0
"Switzerland","2024-09-17",0,0,25,0,0,27,0,0
"Switzerland","2024-09-18",0,0,25,0,0,27,0,0
"Switzerland","2024-09-19",0,0,25,0,1,28,0,0
"Switzerland","2024-09-20",0,0,25,0,0,28,0,0
"Switzerland","2024-09-21",0,0,25,0,0,28,0,0
"Switzerland","2024-09-22",0,0,25,0,0,28,0,0
"Switzerland","2024-09-23",0,0,25,0,0,28,0,0
"Switzerland","2024-09-24",0,0,25,0,0,28,0,0
"Switzerland","2024-09-25",0,0,25,0,0,28,0,0
"Switzerland","2024-09-26",0,0,25,0,0,28,0,0
"Switzerland","2024-09-27",0,0,25,0,1,29,0,0
"Switzerland","2024-09-28",0,0,25,0,0,29,0,0
"Switzerland","2024-09-29",0,0,25,0,0,29,0,0
"Switzerland","2024-09-30",0,4,29,0,0,29,0,0
"Switzerland","2024-10-01",0,0,29,0,0,29,0,0
"Switzerland","2024-10-02",0,0,29,0,0,29,0,0
"Switzerland","2024-10-03",0,0,29,0,0,29,0,0
"Switzerland","2024-10-04",0,0,29,0,1,30,0,0
"Switzerland","2024-10-05",0,0,29,0,0,30,0,0
"Switzerland","2024-10-06",0,0,29,0,0,30,0,0
"Switzerland","2024-10-07",0,0,29,0,0,30,0,0
"Switzerland","2024-10-08",0,0,29,0,0,30,0,0
"Switzerland","2024-10-09",0,0,29,0,0,30,0,0
"Switzerland","2024-10-10",0,0,29,0,0,30,0,0
"Switzerland","2024-10-11",0,0,29,0,0,30,0,0
"Switzerland","2024-10-12",0,0,29,0,1,31,0,0
"Switzerland","2024-10-13",0,0,29,0,0,31,0,0
"Switzerland","2024-10-14",0,0,29,0,0,31,0,0
"Switzerland","2024-10-15",0,0,29,0,0,31,0,0
"Switzerland","2024-10-16",0,0,29,0,0,31,0,0
"Switzerland","2024-10-17",0,0,29,0,0,31,0,0
"Switzerland","2024-10-18",0,0,29,0,0,31,0,0
"Switzerland","2024-10-19",0,0,29,0,0,31,0,0
"Switzerland","2024-10-20",0,0,29,0,1,32,0,0
"Switzerland","2024-10-21",0,0,29,0,0,32,0,0
"Switzerland","2024-10-22",0,0,29,0,0,32,0,0
"Switzerland","2024-10-23",0,0,29,0,0,32,0,0
"Switzerland","2024-10-24",0,0,29,0,0,32,0,0
"Switzerland","2024-10-25",0,0,29,0,0,32,0,0
"Switzerland","2024-10-26",0,0,29,0,0,32,0,0
"Switzerland","2024-10-27",0,0,29,0,0,32,0,0
"Switzerland","2024-10-28",0,0,29,0,1,33,0,0
"Switzerland","2024-10-29",0,0,29,0,0,33,0,0
"Switzerland","2024-10-30",0,0,29,0,0,33,0,0
"Switzerland","2024-10-31",0,4,33,0,0,33,0,0
"Switzerland","2024-11-01",0,0,33,0,0,33,0,0
"Switzerland","2024-11-02",0,0,33,0,0,33,0,0
"Switzerland","2024-11-03",0,0,33,0,0,33,0,0
"Switzerland","2024-11-04",0,0,33,0,0,33,0,0
"Switzerland","2024-11-05",0,0,33,0,0,33,0,0
"Switzerland","2024-11-06",0,0,33,0,0,33,0,0
"Switzerland","2024-11-07",0,0,33,0,0,33,0,0
"Switzerland","2024-11-08",0,0,33,0,1,34,0,0
"Switzerland","2024-11-09",0,0,33,0,0,34,0,0
"Switzerland","2024-11-10",0,0,33,0,0,34,0,0
"Switzerland","2024-11-11",0,0,33,0,0,34,0,0
"Switzerland","2024-11-12",0,0,33,0,0,34,0,0
"Switzerland","2024-11-13",0,0,33,0,0,34,0,0
"Switzerland","2024-11-14",0,0,33,0,0,34,0,0
"Switzerland","2024-11-15",0,0,33,0,0,34,0,0
"Switzerland","2024-11-16",0,0,33,0,0,34,0,0
"Switzerland","2024-11-17",0,0,33,0,0,34,0,0
"Switzerland","2024-11-18",0,0,33,0,0,34,0,0
"Switzerland","2024-11-19",0,0,33,0,0,34,0,0
"Switzerland","2024-11-20",0,0,33,0,0,34,0,0
"Switzerland","2024-11-21",0,0,33,0,0,34,0,0
"Switzerland","2024-11-22",0,0,33,0,0,34,0,0
"Switzerland","2024-11-23",0,0,33,0,1,35,0,0
"Switzerland","2024-11-24",0,0,33,0,0,35,0,0
"Switzerland","2024-11-25",0,0,33,0,0,35,0,0
"Switzerland","2024-11-26",0,0,33,0,0,35,0,0
"Switzerland","2024-11-27",0,0,33,0,0,35,0,0
"Switzerland","2024-11-28",0,0,33,0,0,35,0,0
"Switzerland","2024-11-29",0,0,33,0,0,35,0,0
"Switzerland","2024-11-30",0,0,33,0,0,35,0,0
"Switzerland","2024-12-01",0,0,33,0,0,35,0,0
"Switzerland","2024-12-02",0,0,33,0,0,35,0,0
"Switzerland","2024-12-03",0,0,33,0,0,35,0,0
"Switzerland","2024-12-04",0,0,33,0,0,35,0,0
"Switzerland","2024-12-05",0,0,33,0,0,35,0,0
"Switzerland","2024-12-06",0,0,33,0,0,35,0,0
"Switzerland","2024-12-07",0,0,33,0,0,35,0,0
"Switzerland","2024-12-08",0,0,33,0,0,35,0,0
"Switzerland","2024-12-09",0,0,33,0,1,36,0,0
"Switzerland","2024-12-10",0,0,33,0,0,36,0,0
"Switzerland","2024-12-11",0,0,33,0,0,36,0,0
"Switzerland","2024-12-12",0,0,33,0,0,36,0,0
"Switzerland","2024-12-13",0,0,33,0,0,36,0,0
"Switzerland","2024-12-14",0,0,33,0,0,36,0,0
"Switzerland","2024-12-15",0,0,33,0,0,36,0,0
"Switzerland","2024-12-16",0,0,33,0,0,36,0,0
"Switzerland","2024-12-17",0,0,33,0,0,36,0,0
"Switzerland","2024-12-18",0,0,33,0,0,36,0,0
"Switzerland","2024-12-19",0,0,33,0,0,36,0,0
"Switzerland","2024-12-20",0,0,33,0,0,36,0,0
"Switzerland","2024-12-21",0,0,33,0,0,36,0,0
"Switzerland","2024-12-22",0,0,33,0,0,36,0,0
"Switzerland","2024-12-23",0,0,33,0,0,36,0,0
"Switzerland","2024-12-24",0,0,33,0,1,37,0,0
"Switzerland","2024-12-25",0,0,33,0,0,37,0,0
"Switzerland","2024-12-26",0,0,33,0,0,37,0,0
"Switzerland","2024-12-27",0,0,33,0,0,37,0,0
"Switzerland","2024-12-28",0,0,33,0,0,37,0,0
"Switzerland","2024-12-29",0,0,33,0,0,37,0,0
"Switzerland","2024-12-30",0,0,33,0,0,37,0,0
"Switzerland","2024-12-31",0,4,37,0,0,37,0,0
"Switzerland","2025-01-01",0,0,37,0,0,37,0,0
"Switzerland","2025-01-02",0,0,37,0,0,37,0,0
"Switzerland","2025-01-03",0,0,37,0,0,37,0,0
"Switzerland","2025-01-04",0,0,37,0,0,37,0,0
"Switzerland","2025-01-05",0,0,37,0,0,37,0,0
"Switzerland","2025-01-06",0,0,37,0,0,37,0,0
"Switzerland","2025-01-07",0,0,37,0,0,37,0,0
"Switzerland","2025-01-08",0,0,37,0,0,37,0,0
"Switzerland","2025-01-09",0,0,37,0,0,37,0,0
"Switzerland","2025-01-10",0,0,37,0,0,37,0,0
"Switzerland","2025-01-11",0,0,37,0,0,37,0,0
"Switzerland","2025-01-12",0,0,37,0,0,37,0,0
"Switzerland","2025-01-13",0,0,37,0,0,37,0,0
"Switzerland","2025-01-14",0,0,37,0,0,37,0,0
"Switzerland","2025-01-15",0,0,37,0,0,37,0,0
"Switzerland","2025-01-16",0,0,37,0,0,37,0,0
"Switzerland","2025-01-17",0,0,37,0,0,37,0,0
"Switzerland","2025-01-18",0,0,37,0,0,37,0,0
"Switzerland","2025-01-19",0,0,37,0,0,37,0,0
"Switzerland","2025-01-20",0,0,37,0,0,37,0,0
"Switzerland","2025-01-21",0,0,37,0,0,37,0,0
"Switzerland","2025-01-22",0,0,37,0,0,37,0,0
"Switzerland","2025-01-23",0,0,37,0,0,37,0,0
"Switzerland","2025-01-24",0,0,37,0,0,37,0,0
"Switzerland","2025-01-25",0,0,37,0,0,37,0,0
"Switzerland","2025-01-26",0,0,37,0,0,37,0,0
"Switzerland","2025-01-27",0,0,37,0,0,37,0,0
"Switzerland","2025-01-28",0,0,37,0,0,37,0,0
"Switzerland","2025-01-29",0,0,37,0,0,37,0,0
"Switzerland","2025-01-30",0,0,37,0,0,37,0,0
"Switzerland","2025-01-31",0,0,37,0,0,37,0,0
"Switzerland","2025-02-01",0,0,37,0,0,37,0,0
"Switzerland","2025-02-02",0,0,37,0,0,37,0,0
"Switzerland","2025-02-03",0,0,37,0,0,37,0,0
"Thailand","2024-01-01",0,0,0,0,0,0,0,0
"Thailand","2024-01-02",0,0,0,0,0,0,0,0
"Thailand","2024-01-03",0,0,0,0,0,0,0,0
"Thailand","2024-01-04",0,0,0,0,0,0,0,0
"Thailand","2024-01-05",0,0,0,0,0,0,0,0
"Thailand","2024-01-06",0,0,0,0,0,0,0,0
"Thailand","2024-01-07",0,0,0,0,0,0,0,0
"Thailand","2024-01-08",0,0,0,0,0,0,0,0
"Thailand","2024-01-09",0,0,0,0,0,0,0,0
"Thailand","2024-01-10",0,0,0,0,0,0,0,0
"Thailand","2024-01-11",0,0,0,0,0,0,0,0
"Thailand","2024-01-12",0,0,0,0,0,0,0,0
"Thailand","2024-01-13",0,0,0,0,0,0,0,0
"Thailand","2024-01-14",0,0,0,0,0,0,0,0
"Thailand","2024-01-15",0,0,0,0,0,0,0,0
"Thailand","2024-01-16",0,0,0,0,0,0,0,0
"Thailand","2024-01-17",0,0,0,0,0,0,0,0
"Thailand","2024-01-18",0,0,0,0,0,0,0,0
"Thailand","2024-01-19",0,0,0,0,0,0,0,0
"Thailand","2024-01-20",0,0,0,0,0,0,0,0
"Thailand","2024-01-21",0,0,0,0,0,0,0,0
"Thailand","2024-01-22",0,0,0,0,0,0,0,0
"Thailand","2024-01-23",0,0,0,0,0,0,0,0
"Thailand","2024-01-24",0,0,0,0,0,0,0,0
"Thailand","2024-01-25",0,0,0,0,0,0,0,0
"Thailand","2024-01-26",0,0,0,0,0,0,0,0
"Thailand","2024-01-27",0,0,0,0,0,0,0,0
"Thailand","2024-01-28",0,0,0,0,0,0,0,0
"Thailand","2024-01-29",0,0,0,0,0,0,0,0
"Thailand","2024-01-30",0,0,0,0,0,0,0,0
"Thailand","2024-01-31",0,36,36,0,36,36,0,0
"Thailand","2024-02-01",0,0,36,0,1,37,0,0
"Thailand","2024-02-02",0,0,36,0,1,38,0,0
"Thailand","2024-02-03",0,0,36,0,0,38,0,0
"Thailand","2024-02-04",0,0,36,0,1,39,0,0
"Thailand","2024-02-05",0,0,36,0,1,40,0,0
"Thailand","2024-02-06",0,0,36,0,1,41,0,0
"Thailand","2024-02-07",0,0,36,0,0,41,0,0
"Thailand","2024-02-08",0,0,36,0,1,42,0,0
"Thailand","2024-02-09",0,0,36,0,1,43,0,0
"Thailand","2024-02-10",0,0,36,0,1,44,0,0
"Thailand","2024-02-11",0,0,36,0,0,44,0,0
"Thailand","2024-02-12",0,0,36,0,1,45,0,0
"Thailand","2024-02-13",0,0,36,0,1,46,0,0
"Thailand","2024-02-14",0,0,36,0,1,47,0,0
"Thailand","2024-02-15",0,0,36,0,0,47,0,0
"Thailand","2024-02-16",0,0,36,0,1,48,0,0
"Thailand","2024-02-17",0,0,36,0,1,49,0,0
"Thailand","2024-02-18",0,0,36,0,1,50,0,0
"Thailand","2024-02-19",0,0,36,0,0,50,0,0
"Thailand","2024-02-20",0,0,36,0,1,51,0,0
"Thailand","2024-02-21",0,0,36,0,1,52,0,0
"Thailand","2024-02-22",0,0,36,0,1,53,0,0
"Thailand","2024-02-23",0,0,36,0,0,53,0,0
"Thailand","2024-02-24",0,0,36,0,1,54,0,0
"Thailand","2024-02-25",0,0,36,0,1,55,0,0
"Thailand","2024-02-26",0,0,36,0,1,56,0,0
"Thailand","2024-02-27",0,0,36,0,0,56,0,0
"Thailand","2024-02-28",0,0,36,0,1,57,0,0
"Thailand","2024-02-29",0,22,58,0,1,58,0,0
"Thailand","2024-03-01",0,0,58,0,0,58,0,0
"Thailand","2024-03-02",0,0,58,0,1,59,0,0
"Thailand","2024-03-03",0,0,58,0,0,59,0,0
"Thailand","2024-03-04",0,0,58,0,1,60,0,0
"Thailand","2024-03-05",0,0,58,0,0,60,0,0
"Thailand","2024-03-06",0,0,58,0,0,60,0,0
"Thailand","2024-03-07",0,0,58,0,1,61,0,0
"Thailand","2024-03-08",0,0,58,0,0,61,0,0
"Thailand","2024-03-09",0,0,58,0,0,61,0,0
"Thailand","2024-03-10",0,0,58,0,1,62,0,0
"Thailand","2024-03-11",0,0,58,0,0,62,0,0
"Thailand","2024-03-12",0,0,58,0,1,63,0,0
"Thailand","2024-03-13",0,0,58,0,0,63,0,0
"Thailand","2024-03-14",0,0,58,0,0,63,0,0
"Thailand","2024-03-15",0,0,58,0,1,64,0,0
"Thailand","2024-03-16",0,0,58,0,0,64,0,0
"Thailand","2024-03-17",0,0,58,0,1,65,0,0
"Thailand","2024-03-18",0,0,58,0,0,65,0,0
"Thailand","2024-03-19",0,0,58,0,0,65,0,0
"Thailand","2024-03-20",0,0,58,0,1,66,0,0
"Thailand","2024-03-21",0,0,58,0,0,66,0,0
"Thailand","2024-03-22",0,0,58,0,1,67,0,0
"Thailand","2024-03-23",0,0,58,0,0,67,0,0
"Thailand","2024-03-24",0,0,58,0,0,67,0,0
"Thailand","2024-03-25",0,0,58,0,1,68,0,0
"Thailand","2024-03-26",0,0,58,0,0,68,0,0
"Thailand","2024-03-27",0,0,58,0,0,68,0,0
"Thailand","2024-03-28",0,0,58,0,1,69,0,0
"Thailand","2024-03-29",0,0,58,0,0,69,0,0
"Thailand","2024-03-30",0,0,58,0,1,70,0,0
"Thailand","2024-03-31",0,12,70,0,0,70,0,0
"Thailand","2024-04-01",0,6,76,0,6,76,0,0
"Thailand","2024-04-02",0,0,76,0,0,76,0,0
"Thailand","2024-04-03",0,0,76,0,1,77,0,0
"Thailand","2024-04-04",0,0,76,0,0,77,0,0
"Thailand","2024-04-05",0,0,76,0,1,78,0,0
"Thailand","2024-04-06",0,0,76,0,0,78,0,0
"Thailand","2024-04-07",0,0,76,0,1,79,0,0
"Thailand","2024-04-08",0,0,76,0,0,79,0,0
"Thailand","2024-04-09",0,0,76,0,1,80,0,0
"Thailand","2024-04-10",0,0,76,0,0,80,0,0
"Thailand","2024-04-11",0,0,76,0,0,80,0,0
"Thailand","2024-04-12",0,0,76,0,1,81,0,0
"Thailand","2024-04-13",0,0,76,0,0,81,0,0
"Thailand","2024-04-14",0,0,76,0,1,82,0,0
"Thailand","2024-04-15",0,0,76,0,0,82,0,0
"Thailand","2024-04-16",0,0,76,0,1,83,0,0
"Thailand","2024-04-17",0,0,76,0,0,83,0,0
"Thailand","2024-04-18",0,0,76,0,1,84,0,0
"Thailand","2024-04-19",0,0,76,0,0,84,0,0
"Thailand","2024-04-20",0,0,76,0,1,85,0,0
"Thailand","2024-04-21",0,0,76,0,0,85,0,0
"Thailand","2024-04-22",0,0,76,0,0,85,0,0
"Thailand","2024-04-23",0,0,76,0,1,86,0,0
"Thailand","2024-04-24",0,0,76,0,0,86,0,0
"Thailand","2024-04-25",0,0,76,0,1,87,0,0
"Thailand","2024-04-26",0,0,76,0,0,87,0,0
"Thailand","2024-04-27",0,0,76,0,1,88,0,0
"Thailand","2024-04-28",0,0,76,0,0,88,0,0
"Thailand","2024-04-29",0,0,76,0,1,89,0,0
"Thailand","2024-04-30",0,13,89,0,0,89,0,0
"Thailand","2024-05-01",0,0,89,0,1,90,0,0
"Thailand","2024-05-02",0,0,89,0,0,90,0,0
"Thailand","2024-05-03",0,0,89,0,1,91,0,0
"Thailand","2024-05-04",0,0,89,0,1,92,0,0
"Thailand","2024-05-05",0,0,89,0,0,92,0,0
"Thailand","2024-05-06",0,0,89,0,1,93,0,0
"Thailand","2024-05-07",0,0,89,0,1,94,0,0
"Thailand","2024-05-08",0,0,89,0,0,94,0,0
"Thailand","2024-05-09",0,0,89,0,1,95,0,0
"Thailand","2024-05-10",0,0,89,0,1,96,0,0
"Thailand","2024-05-11",0,0,89,0,0,96,0,0
"Thailand","2024-05-12",0,0,89,0,1,97,0,0
"Thailand","2024-05-13",0,0,89,0,1,98,0,0
"Thailand","2024-05-14",0,0,89,0,0,98,0,0
"Thailand","2024-05-15",0,0,89,0,1,99,0,0
"Thailand","2024-05-16",0,0,89,0,1,100,0,0
"Thailand","2024-05-17",0,0,89,0,1,101,0,0
"Thailand","2024-05-18",0,0,89,0,0,101,0,0
"Thailand","2024-05-19",0,0,89,0,1,102,0,0
"Thailand","2024-05-20",0,0,89,0,1,103,0,0
"Thailand","2024-05-21",0,0,89,0,0,103,0,0
"Thailand","2024-05-22",0,0,89,0,1,104,0,0
"Thailand","2024-05-23",0,0,89,0,1,105,0,0
"Thailand","2024-05-24",0,0,89,0,0,105,0,0
"Thailand","2024-05-25",0,0,89,0,1,106,0,0
"Thailand","2024-05-26",0,0,89,0,1,107,0,0
"Thailand","2024-05-27",0,0,89,0,0,107,0,0
"Thailand","2024-05-28",0,0,89,0,1,108,0,0
"Thailand","2024-05-29",0,0,89,0,1,109,0,0
"Thailand","2024-05-30",0,0,89,0,0,109,0,0
"Thailand","2024-05-31",0,21,110,0,1,110,0,0
"Thailand","2024-06-01",0,0,110,0,0,110,0,0
"Thailand","2024-06-02",0,0,110,0,1,111,0,0
"Thailand","2024-06-03",0,0,110,0,0,111,0,0
"Thailand","2024-06-04",0,0,110,0,0,111,0,0
"Thailand","2024-06-05",0,0,110,0,1,112,0,0
"Thailand","2024-06-06",0,0,110,0,0,112,0,0
"Thailand","2024-06-07",0,0,110,0,0,112,0,0
"Thailand","2024-06-08",0,0,110,0,1,113,0,0
"Thailand","2024-06-09",0,0,110,0,0,113,0,0
"Thailand","2024-06-10",0,0,110,0,0,113,0,0
"Thailand","2024-06-11",0,0,110,0,1,114,0,0
"Thailand","2024-06-12",0,0,110,0,0,114,0,0
"Thailand","2024-06-13",0,0,110,0,0,114,0,0
"Thailand","2024-06-14",0,0,110,0,1,115,0,0
"Thailand","2024-06-15",0,0,110,0,0,115,0,0
"Thailand","2024-06-16",0,0,110,0,0,115,0,0
"Thailand","2024-06-17",0,0,110,0,1,116,0,0
"Thailand","2024-06-18",0,0,110,0,0,116,0,0
"Thailand","2024-06-19",0,0,110,0,0,116,0,0
"Thailand","2024-06-20",0,0,110,0,1,117,0,0
"Thailand","2024-06-21",0,0,110,0,0,117,0,0
"Thailand","2024-06-22",0,0,110,0,0,117,0,0
"Thailand","2024-06-23",0,0,110,0,1,118,0,0
"Thailand","2024-06-24",0,0,110,0,0,118,0,0
"Thailand","2024-06-25",0,0,110,0,0,118,0,0
"Thailand","2024-06-26",0,0,110,0,1,119,0,0
"Thailand","2024-06-27",0,0,110,0,0,119,0,0
"Thailand","2024-06-28",0,0,110,0,0,119,0,0
"Thailand","2024-06-29",0,0,110,0,1,120,0,0
"Thailand","2024-06-30",0,10,120,0,0,120,0,0
"Thailand","2024-07-01",0,0,120,0,0,120,0,0
"Thailand","2024-07-02",0,0,120,0,1,121,0,0
"Thailand","2024-07-03",0,0,120,0,0,121,0,0
"Thailand","2024-07-04",0,0,120,0,1,122,0,0
"Thailand","2024-07-05",0,0,120,0,0,122,0,0
"Thailand","2024-07-06",0,0,120,0,1,123,0,0
"Thailand","2024-07-07",0,0,120,0,0,123,0,0
"Thailand","2024-07-08",0,0,120,0,1,124,0,0
"Thailand","2024-07-09",0,0,120,0,0,124,0,0
"Thailand","2024-07-10",0,0,120,0,1,125,0,0
"Thailand","2024-07-11",0,0,120,0,0,125,0,0
"Thailand","2024-07-12",0,0,120,0,1,126,0,0
"Thailand","2024-07-13",0,0,120,0,0,126,0,0
"Thailand","2024-07-14",0,0,120,0,1,127,0,0
"Thailand","2024-07-15",0,0,120,0,0,127,0,0
"Thailand","2024-07-16",0,0,120,0,1,128,0,0
"Thailand","2024-07-17",0,0,120,0,0,128,0,0
"Thailand","2024-07-18",0,0,120,0,1,129,0,0
"Thailand","2024-07-19",0,0,120,0,0,129,0,0
"Thailand","2024-07-20",0,0,120,0,1,130,0,0
"Thailand","2024-07-21",0,0,120,0,0,130,0,0
"Thailand","2024-07-22",0,0,120,0,1,131,0,0
"Thailand","2024-07-23",0,0,120,0,0,131,0,0
"Thailand","2024-07-24",0,0,120,0,1,132,0,0
"Thailand","2024-07-25",0,0,120,0,0,132,0,0
"Thailand","2024-07-26",0,0,120,0,1,133,0,0
"Thailand","2024-07-27",0,0,120,0,0,133,0,0
"Thailand","2024-07-28",0,0,120,0,1,134,0,0
"Thailand","2024-07-29",0,0,120,0,0,134,0,0
"Thailand","2024-07-30",0,0,120,0,1,135,0,0
"Thailand","2024-07-31",0,15,135,0,0,135,0,0
"Thailand","2024-08-01",0,0,135,0,0,135,0,0
"Thailand","2024-08-02",0,0,135,0,1,136,0,0
"Thailand","2024-08-03",0,0,135,0,0,136,0,0
"Thailand","2024-08-04",0,0,135,0,1,137,0,0
"Thailand","2024-08-05",0,0,135,0,0,137,0,0
"Thailand","2024-08-06",0,0,135,0,1,138,0,0
"Thailand","2024-08-07",0,0,135,0,0,138,0,0
"Thailand","2024-08-08",0,0,135,0,0,138,0,0
"Thailand","2024-08-09",0,0,135,0,1,139,0,0
"Thailand","2024-08-10",0,0,135,0,0,139,0,0
"Thailand","2024-08-11",0,0,135,0,1,140,0,0
"Thailand","2024-08-12",0,0,135,0,0,140,0,0
"Thailand","2024-08-13",0,0,135,0,0,140,0,0
"Thailand","2024-08-14",0,0,135,0,1,141,0,0
"Thailand","2024-08-15",0,0,135,0,0,141,0,0
"Thailand","2024-08-16",0,0,135,0,1,142,0,0
"Thailand","2024-08-17",0,0,135,0,0,142,0,0
"Thailand","2024-08-18",0,0,135,0,1,143,0,0
"Thailand","2024-08-19",0,0,135,0,0,143,0,0
"Thailand","2024-08-20",0,0,135,0,0,143,0,0
"Thailand","2024-08-21",0,0,135,0,1,144,0,0
"Thailand","2024-08-22",0,0,135,0,0,144,0,0
"Thailand","2024-08-23",0,0,135,0,1,145,0,0
"Thailand","2024-08-24",0,0,135,0,0,145,0,0
"Thailand","2024-08-25",0,0,135,0,0,145,0,0
"Thailand","2024-08-26",0,0,135,0,1,146,0,0
"Thailand","2024-08-27",0,0,135,0,0,146,0,0
"Thailand","2024-08-28",0,0,135,0,1,147,0,0
"Thailand","2024-08-29",0,0,135,0,0,147,0,0
"Thailand","2024-08-30",0,0,135,0,1,148,0,0
"Thailand","2024-08-31",0,13,148,0,0,148,0,0
"Thailand","2024-09-01",0,0,148,0,0,148,0,0
"Thailand","2024-09-02",0,0,148,0,1,149,0,0
"Thailand","2024-09-03",0,0,148,0,0,149,0,0
"Thailand","2024-09-04",0,0,148,0,1,150,0,0
"Thailand","2024-09-05",0,0,148,0,0,150,0,0
"Thailand","2024-09-06",0,0,148,0,0,150,0,0
"Thailand","2024-09-07",0,0,148,0,1,151,0,0
"Thailand","2024-09-08",0,0,148,0,0,151,0,0
"Thailand","2024-09-09",0,0,148,0,1,152,0,0
"Thailand","2024-09-10",0,0,148,0,0,152,0,0
"Thailand","2024-09-11",0,0,148,0,0,152,0,0
"Thailand","2024-09-12",0,0,148,0,1,153,0,0
"Thailand","2024-09-13",0,0,148,0,0,153,0,0
"Thailand","2024-09-14",0,0,148,0,1,154,0,0
"Thailand","2024-09-15",0,0,148,0,0,154,0,0
"Thailand","2024-09-16",0,0,148,0,0,154,0,0
"Thailand","2024-09-17",0,0,148,0,1,155,0,0
"Thailand","2024-09-18",0,0,148,0,0,155,0,0
"Thailand","2024-09-19",0,0,148,0,1,156,0,0
"Thailand","2024-09-20",0,0,148,0,0,156,0,0
"Thailand","2024-09-21",0,0,148,0,0,156,0,0
"Thailand","2024-09-22",0,0,148,0,1,157,0,0
"Thailand","2024-09-23",0,0,148,0,0,157,0,0
"Thailand","2024-09-24",0,0,148,0,1,158,0,0
"Thailand","2024-09-25",0,0,148,0,0,158,0,0
"Thailand","2024-09-26",0,0,148,0,0,158,0,0
"Thailand","2024-09-27",0,0,148,0,1,159,0,0
"Thailand","2024-09-28",0,0,148,0,0,159,0,0
"Thailand","2024-09-29",0,0,148,0,1,160,0,0
"Thailand","2024-09-30",0,12,160,0,0,160,0,0
"Thailand","2024-10-01",0,0,160,0,0,160,0,0
"Thailand","2024-10-02",0,0,160,0,1,161,0,0
"Thailand","2024-10-03",0,0,160,0,0,161,0,0
"Thailand","2024-10-04",0,0,160,0,1,162,0,0
"Thailand","2024-10-05",0,0,160,0,0,162,0,0
"Thailand","2024-10-06",0,0,160,0,1,163,0,0
"Thailand","2024-10-07",0,0,160,0,0,163,0,0
"Thailand","2024-10-08",0,0,160,0,0,163,0,0
"Thailand","2024-10-09",0,0,160,0,1,164,0,0
"Thailand","2024-10-10",0,0,160,0,0,164,0,0
"Thailand","2024-10-11",0,0,160,0,1,165,0,0
"Thailand","2024-10-12",0,0,160,0,0,165,0,0
"Thailand","2024-10-13",0,0,160,0,0,165,0,0
"Thailand","2024-10-14",0,0,160,0,1,166,0,0
"Thailand","2024-10-15",0,0,160,0,0,166,0,0
"Thailand","2024-10-16",0,0,160,0,1,167,0,0
"Thailand","2024-10-17",0,0,160,0,0,167,0,0
"Thailand","2024-10-18",0,0,160,0,1,168,0,0
"Thailand","2024-10-19",0,0,160,0,0,168,0,0
"Thailand","2024-10-20",0,0,160,0,0,168,0,0
"Thailand","2024-10-21",0,0,160,0,1,169,0,0
"Thailand","2024-10-22",0,0,160,0,0,169,0,0
"Thailand","2024-10-23",0,0,160,0,1,170,0,0
"Thailand","2024-10-24",0,0,160,0,0,170,0,0
"Thailand","2024-10-25",0,0,160,0,0,170,0,0
"Thailand","2024-10-26",0,0,160,0,1,171,0,0
"Thailand","2024-10-27",0,0,160,0,0,171,0,0
"Thailand","2024-10-28",0,0,160,0,1,172,0,0
"Thailand","2024-10-29",0,0,160,0,0,172,0,0
"Thailand","2024-10-30",0,0,160,0,1,173,0,0
"Thailand","2024-10-31",0,13,173,0,0,173,0,0
"Thailand","2024-11-01",0,0,173,0,0,173,0,0
"Thailand","2024-11-02",0,0,173,0,0,173,0,0
"Thailand","2024-11-03",0,0,173,0,1,174,0,0
"Thailand","2024-11-04",0,0,173,0,0,174,0,0
"Thailand","2024-11-05",0,0,173,0,0,174,0,0
"Thailand","2024-11-06",0,0,173,0,0,174,0,0
"Thailand","2024-11-07",0,0,173,0,1,175,0,0
"Thailand","2024-11-08",0,0,173,0,0,175,0,0
"Thailand","2024-11-09",0,0,173,0,0,175,0,0
"Thailand","2024-11-10",0,0,173,0,0,175,0,0
"Thailand","2024-11-11",0,0,173,0,1,176,0,0
"Thailand","2024-11-12",0,0,173,0,0,176,0,0
"Thailand","2024-11-13",0,0,173,0,0,176,0,0
"Thailand","2024-11-14",0,0,173,0,0,176,0,0
"Thailand","2024-11-15",0,0,173,0,1,177,0,0
"Thailand","2024-11-16",0,0,173,0,0,177,0,0
"Thailand","2024-11-17",0,0,173,0,0,177,0,0
"Thailand","2024-11-18",0,0,173,0,0,177,0,0
"Thailand","2024-11-19",0,0,173,0,0,177,0,0
"Thailand","2024-11-20",0,0,173,0,1,178,0,0
"Thailand","2024-11-21",0,0,173,0,0,178,0,0
"Thailand","2024-11-22",0,0,173,0,0,178,0,0
"Thailand","2024-11-23",0,0,173,0,0,178,0,0
"Thailand","2024-11-24",0,0,173,0,1,179,0,0
"Thailand","2024-11-25",0,0,173,0,0,179,0,0
"Thailand","2024-11-26",0,0,173,0,0,179,0,0
"Thailand","2024-11-27",0,0,173,0,0,179,0,0
"Thailand","2024-11-28",0,0,173,0,1,180,0,0
"Thailand","2024-11-29",0,0,173,0,0,180,0,0
"Thailand","2024-11-30",0,7,180,0,0,180,0,0
"Thailand","2024-12-01",0,0,180,0,0,180,0,0
"Thailand","2024-12-02",0,0,180,0,0,180,0,0
"Thailand","2024-12-03",0,0,180,0,0,180,0,0
"Thailand","2024-12-04",0,0,180,0,0,180,0,0
"Thailand","2024-12-05",0,0,180,0,0,180,0,0
"Thailand","2024-12-06",0,0,180,0,0,180,0,0
"Thailand","2024-12-07",0,0,180,0,0,180,0,0
"Thailand","2024-12-08",0,0,180,0,0,180,0,0
"Thailand","2024-12-09",0,0,180,0,0,180,0,0
"Thailand","2024-12-10",0,0,180,0,0,180,0,0
"Thailand","2024-12-11",0,0,180,0,0,180,0,0
"Thailand","2024-12-12",0,0,180,0,0,180,0,0
"Thailand","2024-12-13",0,0,180,0,0,180,0,0
"Thailand","2024-12-14",0,0,180,0,0,180,0,0
"Thailand","2024-12-15",0,0,180,0,0,180,0,0
"Thailand","2024-12-16",0,0,180,0,0,180,0,0
"Thailand","2024-12-17",0,0,180,0,0,180,0,0
"Thailand","2024-12-18",0,0,180,0,0,180,0,0
"Thailand","2024-12-19",0,0,180,0,0,180,0,0
"Thailand","2024-12-20",0,0,180,0,0,180,0,0
"Thailand","2024-12-21",0,0,180,0,0,180,0,0
"Thailand","2024-12-22",0,0,180,0,0,180,0,0
"Thailand","2024-12-23",0,0,180,0,0,180,0,0
"Thailand","2024-12-24",0,0,180,0,0,180,0,0
"Thailand","2024-12-25",0,0,180,0,0,180,0,0
"Thailand","2024-12-26",0,0,180,0,0,180,0,0
"Thailand","2024-12-27",0,0,180,0,0,180,0,0
"Thailand","2024-12-28",0,0,180,0,0,180,0,0
"Thailand","2024-12-29",0,0,180,0,0,180,0,0
"Thailand","2024-12-30",0,0,180,0,0,180,0,0
"Thailand","2024-12-31",0,0,180,0,0,180,0,0
"Thailand","2025-01-01",0,0,180,0,0,180,0,0
"Thailand","2025-01-02",0,0,180,0,0,180,0,0
"Thailand","2025-01-03",0,0,180,0,0,180,0,0
"Thailand","2025-01-04",0,0,180,0,0,180,0,0
"Thailand","2025-01-05",0,0,180,0,0,180,0,0
"Thailand","2025-01-06",0,0,180,0,0,180,0,0
"Thailand","2025-01-07",0,0,180,0,0,180,0,0
"Thailand","2025-01-08",0,0,180,0,0,180,0,0
"Thailand","2025-01-09",0,0,180,0,0,180,0,0
"Thailand","2025-01-10",0,0,180,0,0,180,0,0
"Thailand","2025-01-11",0,0,180,0,0,180,0,0
"Thailand","2025-01-12",0,0,180,0,0,180,0,0
"Thailand","2025-01-13",0,0,180,0,0,180,0,0
"Thailand","2025-01-14",0,0,180,0,0,180,0,0
"Thailand","2025-01-15",0,0,180,0,0,180,0,0
"Thailand","2025-01-16",0,0,180,0,0,180,0,0
"Thailand","2025-01-17",0,0,180,0,0,180,0,0
"Thailand","2025-01-18",0,0,180,0,0,180,0,0
"Thailand","2025-01-19",0,0,180,0,0,180,0,0
"Thailand","2025-01-20",0,0,180,0,0,180,0,0
"Thailand","2025-01-21",0,0,180,0,0,180,0,0
"Thailand","2025-01-22",0,0,180,0,0,180,0,0
"Thailand","2025-01-23",0,0,180,0,0,180,0,0
"Thailand","2025-01-24",0,0,180,0,0,180,0,0
"Thailand","2025-01-25",0,0,180,0,0,180,0,0
"Thailand","2025-01-26",0,0,180,0,0,180,0,0
"Thailand","2025-01-27",0,0,180,0,0,180,0,0
"Thailand","2025-01-28",0,0,180,0,0,180,0,0
"Thailand","2025-01-29",0,0,180,0,0,180,0,0
"Thailand","2025-01-30",0,0,180,0,0,180,0,0
"Thailand","2025-01-31",0,0,180,0,0,180,0,0
"Thailand","2025-02-01",0,0,180,0,0,180,0,0
"Thailand","2025-02-02",0,0,180,0,0,180,0,0
"Thailand","2025-02-03",0,0,180,0,0,180,0,0
"Trinidad and Tobago","2024-01-01",0,0,0,0,0,0,0,0
"Trinidad and Tobago","2024-01-02",0,0,0,0,0,0,0,0
"Trinidad and Tobago","2024-01-03",0,0,0,0,0,0,0,0
"Trinidad and Tobago","2024-01-04",0,0,0,0,0,0,0,0
"Trinidad and Tobago","2024-01-05",0,0,0,0,0,0,0,0
"Trinidad and Tobago","2024-01-06",0,0,0,0,0,0,0,0
"Trinidad and Tobago","2024-01-07",0,0,0,0,0,0,0,0
"Trinidad and Tobago","2024-01-08",0,0,0,0,0,0,0,0
"Trinidad and Tobago","2024-01-09",0,0,0,0,0,0,0,0
"Trinidad and Tobago","2024-01-10",0,0,0,0,0,0,0,0
"Trinidad and Tobago","2024-01-11",0,0,0,0,0,0,0,0
"Trinidad and Tobago","2024-01-12",0,0,0,0,0,0,0,0
"Trinidad and Tobago","2024-01-13",0,0,0,0,0,0,0,0
"Trinidad and Tobago","2024-01-14",0,0,0,0,0,0,0,0
"Trinidad and Tobago","2024-01-15",0,0,0,0,0,0,0,0
"Trinidad and Tobago","2024-01-16",0,0,0,0,0,0,0,0
"Trinidad and Tobago","2024-01-17",0,0,0,0,0,0,0,0
"Trinidad and Tobago","2024-01-18",0,0,0,0,0,0,0,0
"Trinidad and Tobago","2024-01-19",0,0,0,0,0,0,0,0
"Trinidad and Tobago","2024-01-20",0,0,0,0,0,0,0,0
"Trinidad and Tobago","2024-01-21",0,0,0,0,0,0,0,0
"Trinidad and Tobago","2024-01-22",0,0,0,0,0,0,0,0
"Trinidad and Tobago","2024-01-23",0,0,0,0,0,0,0,0
"Trinidad and Tobago","2024-01-24",0,0,0,0,0,0,0,0
"Trinidad and Tobago","2024-01-25",0,0,0,0,0,0,0,0
"Trinidad and Tobago","2024-01-26",0,0,0,0,0,0,0,0
"Trinidad and Tobago","2024-01-27",0,0,0,0,0,0,0,0
"Trinidad and Tobago","2024-01-28",0,0,0,0,0,0,0,0
"Trinidad and Tobago","2024-01-29",0,0,0,0,0,0,0,0
"Trinidad and Tobago","2024-01-30",0,0,0,0,0,0,0,0
"Trinidad and Tobago","2024-01-31",0,0,0,0,0,0,0,0
"Trinidad and Tobago","2024-02-01",0,0,0,0,0,0,0,0
"Trinidad and Tobago","2024-02-02",0,0,0,0,0,0,0,0
"Trinidad and Tobago","2024-02-03",0,0,0,0,0,0,0,0
"Trinidad and Tobago","2024-02-04",0,0,0,0,0,0,0,0
"Trinidad and Tobago","2024-02-05",0,0,0,0,0,0,0,0
"Trinidad and Tobago","2024-02-06",0,0,0,0,0,0,0,0
"Trinidad and Tobago","2024-02-07",0,0,0,0,0,0,0,0
"Trinidad and Tobago","2024-02-08",0,0,0,0,0,0,0,0
"Trinidad and Tobago","2024-02-09",0,0,0,0,0,0,0,0
"Trinidad and Tobago","2024-02-10",0,0,0,0,0,0,0,0
"Trinidad and Tobago","2024-02-11",0,0,0,0,0,0,0,0
"Trinidad and Tobago","2024-02-12",0,0,0,0,0,0,0,0
"Trinidad and Tobago","2024-02-13",0,0,0,0,0,0,0,0
"Trinidad and Tobago","2024-02-14",0,0,0,0,0,0,0,0
"Trinidad and Tobago","2024-02-15",0,0,0,0,0,0,0,0
"Trinidad and Tobago","2024-02-16",0,0,0,0,0,0,0,0
"Trinidad and Tobago","2024-02-17",0,0,0,0,0,0,0,0
"Trinidad and Tobago","2024-02-18",0,0,0,0,0,0,0,0
"Trinidad and Tobago","2024-02-19",0,0,0,0,0,0,0,0
"Trinidad and Tobago","2024-02-20",0,0,0,0,0,0,0,0
"Trinidad and Tobago","2024-02-21",0,0,0,0,0,0,0,0
"Trinidad and Tobago","2024-02-22",0,0,0,0,0,0,0,0
"Trinidad and Tobago","2024-02-23",0,0,0,0,0,0,0,0
"Trinidad and Tobago","2024-02-24",0,0,0,0,0,0,0,0
"Trinidad and Tobago","2024-02-25",0,0,0,0,0,0,0,0
"Trinidad and Tobago","2024-02-26",0,0,0,0,0,0,0,0
"Trinidad and Tobago","2024-02-27",0,0,0,0,0,0,0,0
"Trinidad and Tobago","2024-02-28",0,0,0,0,0,0,0,0
"Trinidad and Tobago","2024-02-29",0,0,0,0,0,0,0,0
"Trinidad and Tobago","2024-03-01",0,0,0,0,0,0,0,0
"Trinidad and Tobago","2024-03-02",0,0,0,0,0,0,0,0
"Trinidad and Tobago","2024-03-03",0,0,0,0,0,0,0,0
"Trinidad and Tobago","2024-03-04",0,0,0,0,0,0,0,0
"Trinidad and Tobago","2024-03-05",0,0,0,0,0,0,0,0
"Trinidad and Tobago","2024-03-06",0,0,0,0,0,0,0,0
"Trinidad and Tobago","2024-03-07",0,0,0,0,0,0,0,0
"Trinidad and Tobago","2024-03-08",0,0,0,0,0,0,0,0
"Trinidad and Tobago","2024-03-09",0,0,0,0,0,0,0,0
"Trinidad and Tobago","2024-03-10",0,0,0,0,0,0,0,0
"Trinidad and Tobago","2024-03-11",0,0,0,0,0,0,0,0
"Trinidad and Tobago","2024-03-12",0,0,0,0,0,0,0,0
"Trinidad and Tobago","2024-03-13",0,0,0,0,0,0,0,0
"Trinidad and Tobago","2024-03-14",0,0,0,0,0,0,0,0
"Trinidad and Tobago","2024-03-15",0,0,0,0,0,0,0,0
"Trinidad and Tobago","2024-03-16",0,0,0,0,0,0,0,0
"Trinidad and Tobago","2024-03-17",0,0,0,0,0,0,0,0
"Trinidad and Tobago","2024-03-18",0,0,0,0,0,0,0,0
"Trinidad and Tobago","2024-03-19",0,0,0,0,0,0,0,0
"Trinidad and Tobago","2024-03-20",0,0,0,0,0,0,0,0
"Trinidad and Tobago","2024-03-21",0,0,0,0,0,0,0,0
"Trinidad and Tobago","2024-03-22",0,0,0,0,0,0,0,0
"Trinidad and Tobago","2024-03-23",0,0,0,0,0,0,0,0
"Trinidad and Tobago","2024-03-24",0,0,0,0,0,0,0,0
"Trinidad and Tobago","2024-03-25",0,0,0,0,0,0,0,0
"Trinidad and Tobago","2024-03-26",0,0,0,0,0,0,0,0
"Trinidad and Tobago","2024-03-27",0,0,0,0,0,0,0,0
"Trinidad and Tobago","2024-03-28",0,0,0,0,0,0,0,0
"Trinidad and Tobago","2024-03-29",0,0,0,0,0,0,0,0
"Trinidad and Tobago","2024-03-30",0,0,0,0,0,0,0,0
"Trinidad and Tobago","2024-03-31",0,0,0,0,0,0,0,0
"Trinidad and Tobago","2024-04-01",0,0,0,0,0,0,0,0
"Trinidad and Tobago","2024-04-02",0,0,0,0,0,0,0,0
"Trinidad and Tobago","2024-04-03",0,0,0,0,0,0,0,0
"Trinidad and Tobago","2024-04-04",0,0,0,0,0,0,0,0
"Trinidad and Tobago","2024-04-05",0,0,0,0,0,0,0,0
"Trinidad and Tobago","2024-04-06",0,0,0,0,0,0,0,0
"Trinidad and Tobago","2024-04-07",0,0,0,0,0,0,0,0
"Trinidad and Tobago","2024-04-08",0,0,0,0,0,0,0,0
"Trinidad and Tobago","2024-04-09",0,0,0,0,0,0,0,0
"Trinidad and Tobago","2024-04-10",0,0,0,0,0,0,0,0
"Trinidad and Tobago","2024-04-11",0,0,0,0,0,0,0,0
"Trinidad and Tobago","2024-04-12",0,0,0,0,0,0,0,0
"Trinidad and Tobago","2024-04-13",0,0,0,0,0,0,0,0
"Trinidad and Tobago","2024-04-14",0,0,0,0,0,0,0,0
"Trinidad and Tobago","2024-04-15",0,0,0,0,0,0,0,0
"Trinidad and Tobago","2024-04-16",0,0,0,0,0,0,0,0
"Trinidad and Tobago","2024-04-17",0,0,0,0,0,0,0,0
"Trinidad and Tobago","2024-04-18",0,0,0,0,0,0,0,0
"Trinidad and Tobago","2024-04-19",0,0,0,0,0,0,0,0
"Trinidad and Tobago","2024-04-20",0,0,0,0,0,0,0,0
"Trinidad and Tobago","2024-04-21",0,0,0,0,0,0,0,0
"Trinidad and Tobago","2024-04-22",0,0,0,0,0,0,0,0
"Trinidad and Tobago","2024-04-23",0,0,0,0,0,0,0,0
"Trinidad and Tobago","2024-04-24",0,0,0,0,0,0,0,0
"Trinidad and Tobago","2024-04-25",0,0,0,0,0,0,0,0
"Trinidad and Tobago","2024-04-26",0,0,0,0,0,0,0,0
"Trinidad and Tobago","2024-04-27",0,0,0,0,0,0,0,0
"Trinidad and Tobago","2024-04-28",0,0,0,0,0,0,0,0
"Trinidad and Tobago","2024-04-29",0,0,0,0,0,0,0,0
"Trinidad and Tobago","2024-04-30",0,0,0,0,0,0,0,0
"Trinidad and Tobago","2024-05-01",0,0,0,0,0,0,0,0
"Trinidad and Tobago","2024-05-02",0,0,0,0,0,0,0,0
"Trinidad and Tobago","2024-05-03",0,0,0,0,0,0,0,0
"Trinidad and Tobago","2024-05-04",0,0,0,0,0,0,0,0
"Trinidad and Tobago","2024-05-05",0,0,0,0,0,0,0,0
"Trinidad and Tobago","2024-05-06",0,0,0,0,0,0,0,0
"Trinidad and Tobago","2024-05-07",0,0,0,0,0,0,0,0
"Trinidad and Tobago","2024-05-08",0,0,0,0,0,0,0,0
"Trinidad and Tobago","2024-05-09",0,0,0,0,0,0,0,0
"Trinidad and Tobago","2024-05-10",0,0,0,0,0,0,0,0
"Trinidad and Tobago","2024-05-11",0,0,0,0,0,0,0,0
"Trinidad and Tobago","2024-05-12",0,0,0,0,0,0,0,0
"Trinidad and Tobago","2024-05-13",0,0,0,0,0,0,0,0
"Trinidad and Tobago","2024-05-14",0,0,0,0,0,0,0,0
"Trinidad and Tobago","2024-05-15",0,0,0,0,0,0,0,0
"Trinidad and Tobago","2024-05-16",0,0,0,0,0,0,0,0
"Trinidad and Tobago","2024-05-17",0,0,0,0,0,0,0,0
"Trinidad and Tobago","2024-05-18",0,0,0,0,0,0,0,0
"Trinidad and Tobago","2024-05-19",0,0,0,0,0,0,0,0
"Trinidad and Tobago","2024-05-20",0,0,0,0,0,0,0,0
"Trinidad and Tobago","2024-05-21",0,0,0,0,0,0,0,0
"Trinidad and Tobago","2024-05-22",0,0,0,0,0,0,0,0
"Trinidad and Tobago","2024-05-23",0,0,0,0,0,0,0,0
"Trinidad and Tobago","2024-05-24",0,0,0,0,0,0,0,0
"Trinidad and Tobago","2024-05-25",0,0,0,0,0,0,0,0
"Trinidad and Tobago","2024-05-26",0,0,0,0,0,0,0,0
"Trinidad and Tobago","2024-05-27",0,0,0,0,0,0,0,0
"Trinidad and Tobago","2024-05-28",0,0,0,0,0,0,0,0
"Trinidad and Tobago","2024-05-29",0,0,0,0,0,0,0,0
"Trinidad and Tobago","2024-05-30",0,0,0,0,0,0,0,0
"Trinidad and Tobago","2024-05-31",0,0,0,0,0,0,0,0
"Trinidad and Tobago","2024-06-01",0,0,0,0,0,0,0,0
"Trinidad and Tobago","2024-06-02",0,0,0,0,0,0,0,0
"Trinidad and Tobago","2024-06-03",0,0,0,0,0,0,0,0
"Trinidad and Tobago","2024-06-04",0,0,0,0,0,0,0,0
"Trinidad and Tobago","2024-06-05",0,0,0,0,0,0,0,0
"Trinidad and Tobago","2024-06-06",0,0,0,0,0,0,0,0
"Trinidad and Tobago","2024-06-07",0,0,0,0,0,0,0,0
"Trinidad and Tobago","2024-06-08",0,0,0,0,0,0,0,0
"Trinidad and Tobago","2024-06-09",0,0,0,0,0,0,0,0
"Trinidad and Tobago","2024-06-10",0,0,0,0,0,0,0,0
"Trinidad and Tobago","2024-06-11",0,0,0,0,0,0,0,0
"Trinidad and Tobago","2024-06-12",0,0,0,0,0,0,0,0
"Trinidad and Tobago","2024-06-13",0,0,0,0,0,0,0,0
"Trinidad and Tobago","2024-06-14",0,0,0,0,0,0,0,0
"Trinidad and Tobago","2024-06-15",0,0,0,0,0,0,0,0
"Trinidad and Tobago","2024-06-16",0,0,0,0,0,0,0,0
"Trinidad and Tobago","2024-06-17",0,0,0,0,0,0,0,0
"Trinidad and Tobago","2024-06-18",0,0,0,0,0,0,0,0
"Trinidad and Tobago","2024-06-19",0,0,0,0,0,0,0,0
"Trinidad and Tobago","2024-06-20",0,0,0,0,0,0,0,0
"Trinidad and Tobago","2024-06-21",0,0,0,0,0,0,0,0
"Trinidad and Tobago","2024-06-22",0,0,0,0,0,0,0,0
"Trinidad and Tobago","2024-06-23",0,0,0,0,0,0,0,0
"Trinidad and Tobago","2024-06-24",0,0,0,0,0,0,0,0
"Trinidad and Tobago","2024-06-25",0,0,0,0,0,0,0,0
"Trinidad and Tobago","2024-06-26",0,0,0,0,0,0,0,0
"Trinidad and Tobago","2024-06-27",0,0,0,0,0,0,0,0
"Trinidad and Tobago","2024-06-28",0,0,0,0,0,0,0,0
"Trinidad and Tobago","2024-06-29",0,0,0,0,0,0,0,0
"Trinidad and Tobago","2024-06-30",0,0,0,0,0,0,0,0
"Trinidad and Tobago","2024-07-01",0,0,0,0,0,0,0,0
"Trinidad and Tobago","2024-07-02",0,0,0,0,0,0,0,0
"Trinidad and Tobago","2024-07-03",0,0,0,0,0,0,0,0
"Trinidad and Tobago","2024-07-04",0,0,0,0,0,0,0,0
"Trinidad and Tobago","2024-07-05",0,0,0,0,0,0,0,0
"Trinidad and Tobago","2024-07-06",0,0,0,0,0,0,0,0
"Trinidad and Tobago","2024-07-07",0,0,0,0,0,0,0,0
"Trinidad and Tobago","2024-07-08",0,0,0,0,0,0,0,0
"Trinidad and Tobago","2024-07-09",0,0,0,0,0,0,0,0
"Trinidad and Tobago","2024-07-10",0,0,0,0,0,0,0,0
"Trinidad and Tobago","2024-07-11",0,0,0,0,0,0,0,0
"Trinidad and Tobago","2024-07-12",0,0,0,0,0,0,0,0
"Trinidad and Tobago","2024-07-13",0,0,0,0,0,0,0,0
"Trinidad and Tobago","2024-07-14",0,0,0,0,0,0,0,0
"Trinidad and Tobago","2024-07-15",0,0,0,0,0,0,0,0
"Trinidad and Tobago","2024-07-16",0,0,0,0,0,0,0,0
"Trinidad and Tobago","2024-07-17",0,0,0,0,0,0,0,0
"Trinidad and Tobago","2024-07-18",0,0,0,0,0,0,0,0
"Trinidad and Tobago","2024-07-19",0,0,0,0,0,0,0,0
"Trinidad and Tobago","2024-07-20",0,0,0,0,0,0,0,0
"Trinidad and Tobago","2024-07-21",0,0,0,0,0,0,0,0
"Trinidad and Tobago","2024-07-22",0,0,0,0,0,0,0,0
"Trinidad and Tobago","2024-07-23",0,0,0,0,0,0,0,0
"Trinidad and Tobago","2024-07-24",0,0,0,0,0,0,0,0
"Trinidad and Tobago","2024-07-25",0,0,0,0,0,0,0,0
"Trinidad and Tobago","2024-07-26",0,0,0,0,0,0,0,0
"Trinidad and Tobago","2024-07-27",0,0,0,0,0,0,0,0
"Trinidad and Tobago","2024-07-28",0,0,0,0,0,0,0,0
"Trinidad and Tobago","2024-07-29",0,0,0,0,0,0,0,0
"Trinidad and Tobago","2024-07-30",0,0,0,0,0,0,0,0
"Trinidad and Tobago","2024-07-31",0,0,0,0,0,0,0,0
"Trinidad and Tobago","2024-08-01",0,0,0,0,0,0,0,0
"Trinidad and Tobago","2024-08-02",0,0,0,0,0,0,0,0
"Trinidad and Tobago","2024-08-03",0,0,0,0,0,0,0,0
"Trinidad and Tobago","2024-08-04",0,0,0,0,0,0,0,0
"Trinidad and Tobago","2024-08-05",0,0,0,0,0,0,0,0
"Trinidad and Tobago","2024-08-06",0,0,0,0,0,0,0,0
"Trinidad and Tobago","2024-08-07",0,0,0,0,0,0,0,0
"Trinidad and Tobago","2024-08-08",0,0,0,0,0,0,0,0
"Trinidad and Tobago","2024-08-09",0,0,0,0,0,0,0,0
"Trinidad and Tobago","2024-08-10",0,0,0,0,0,0,0,0
"Trinidad and Tobago","2024-08-11",0,0,0,0,0,0,0,0
"Trinidad and Tobago","2024-08-12",0,0,0,0,0,0,0,0
"Trinidad and Tobago","2024-08-13",0,0,0,0,0,0,0,0
"Trinidad and Tobago","2024-08-14",0,0,0,0,0,0,0,0
"Trinidad and Tobago","2024-08-15",0,0,0,0,0,0,0,0
"Trinidad and Tobago","2024-08-16",0,0,0,0,0,0,0,0
"Trinidad and Tobago","2024-08-17",0,0,0,0,0,0,0,0
"Trinidad and Tobago","2024-08-18",0,0,0,0,0,0,0,0
"Trinidad and Tobago","2024-08-19",0,0,0,0,0,0,0,0
"Trinidad and Tobago","2024-08-20",0,0,0,0,0,0,0,0
"Trinidad and Tobago","2024-08-21",0,0,0,0,0,0,0,0
"Trinidad and Tobago","2024-08-22",0,0,0,0,0,0,0,0
"Trinidad and Tobago","2024-08-23",0,0,0,0,0,0,0,0
"Trinidad and Tobago","2024-08-24",0,0,0,0,0,0,0,0
"Trinidad and Tobago","2024-08-25",0,0,0,0,0,0,0,0
"Trinidad and Tobago","2024-08-26",0,0,0,0,0,0,0,0
"Trinidad and Tobago","2024-08-27",0,0,0,0,0,0,0,0
"Trinidad and Tobago","2024-08-28",0,0,0,0,0,0,0,0
"Trinidad and Tobago","2024-08-29",0,0,0,0,0,0,0,0
"Trinidad and Tobago","2024-08-30",0,0,0,0,0,0,0,0
"Trinidad and Tobago","2024-08-31",0,0,0,0,0,0,0,0
"Trinidad and Tobago","2024-09-01",0,0,0,0,0,0,0,0
"Trinidad and Tobago","2024-09-02",0,0,0,0,0,0,0,0
"Trinidad and Tobago","2024-09-03",0,0,0,0,0,0,0,0
"Trinidad and Tobago","2024-09-04",0,0,0,0,0,0,0,0
"Trinidad and Tobago","2024-09-05",0,0,0,0,0,0,0,0
"Trinidad and Tobago","2024-09-06",0,0,0,0,0,0,0,0
"Trinidad and Tobago","2024-09-07",0,0,0,0,0,0,0,0
"Trinidad and Tobago","2024-09-08",0,0,0,0,0,0,0,0
"Trinidad and Tobago","2024-09-09",0,0,0,0,0,0,0,0
"Trinidad and Tobago","2024-09-10",0,0,0,0,0,0,0,0
"Trinidad and Tobago","2024-09-11",0,0,0,0,0,0,0,0
"Trinidad and Tobago","2024-09-12",0,0,0,0,0,0,0,0
"Trinidad and Tobago","2024-09-13",0,0,0,0,0,0,0,0
"Trinidad and Tobago","2024-09-14",0,0,0,0,0,0,0,0
"Trinidad and Tobago","2024-09-15",0,0,0,0,0,0,0,0
"Trinidad and Tobago","2024-09-16",0,0,0,0,0,0,0,0
"Trinidad and Tobago","2024-09-17",0,0,0,0,0,0,0,0
"Trinidad and Tobago","2024-09-18",0,0,0,0,0,0,0,0
"Trinidad and Tobago","2024-09-19",0,0,0,0,0,0,0,0
"Trinidad and Tobago","2024-09-20",0,0,0,0,0,0,0,0
"Trinidad and Tobago","2024-09-21",0,0,0,0,0,0,0,0
"Trinidad and Tobago","2024-09-22",0,0,0,0,0,0,0,0
"Trinidad and Tobago","2024-09-23",0,0,0,0,0,0,0,0
"Trinidad and Tobago","2024-09-24",0,0,0,0,0,0,0,0
"Trinidad and Tobago","2024-09-25",0,0,0,0,0,0,0,0
"Trinidad and Tobago","2024-09-26",0,0,0,0,0,0,0,0
"Trinidad and Tobago","2024-09-27",0,0,0,0,0,0,0,0
"Trinidad and Tobago","2024-09-28",0,0,0,0,0,0,0,0
"Trinidad and Tobago","2024-09-29",0,0,0,0,0,0,0,0
"Trinidad and Tobago","2024-09-30",0,0,0,0,0,0,0,0
"Trinidad and Tobago","2024-10-01",0,0,0,0,0,0,0,0
"Trinidad and Tobago","2024-10-02",0,0,0,0,0,0,0,0
"Trinidad and Tobago","2024-10-03",0,0,0,0,0,0,0,0
"Trinidad and Tobago","2024-10-04",0,0,0,0,0,0,0,0
"Trinidad and Tobago","2024-10-05",0,0,0,0,0,0,0,0
"Trinidad and Tobago","2024-10-06",0,0,0,0,0,0,0,0
"Trinidad and Tobago","2024-10-07",0,0,0,0,0,0,0,0
"Trinidad and Tobago","2024-10-08",0,0,0,0,0,0,0,0
"Trinidad and Tobago","2024-10-09",0,0,0,0,0,0,0,0
"Trinidad and Tobago","2024-10-10",0,0,0,0,0,0,0,0
"Trinidad and Tobago","2024-10-11",0,0,0,0,0,0,0,0
"Trinidad and Tobago","2024-10-12",0,0,0,0,0,0,0,0
"Trinidad and Tobago","2024-10-13",0,0,0,0,0,0,0,0
"Trinidad and Tobago","2024-10-14",0,0,0,0,0,0,0,0
"Trinidad and Tobago","2024-10-15",0,0,0,0,0,0,0,0
"Trinidad and Tobago","2024-10-16",0,0,0,0,0,0,0,0
"Trinidad and Tobago","2024-10-17",0,0,0,0,0,0,0,0
"Trinidad and Tobago","2024-10-18",0,0,0,0,0,0,0,0
"Trinidad and Tobago","2024-10-19",0,0,0,0,0,0,0,0
"Trinidad and Tobago","2024-10-20",0,0,0,0,0,0,0,0
"Trinidad and Tobago","2024-10-21",0,0,0,0,0,0,0,0
"Trinidad and Tobago","2024-10-22",0,0,0,0,0,0,0,0
"Trinidad and Tobago","2024-10-23",0,0,0,0,0,0,0,0
"Trinidad and Tobago","2024-10-24",0,0,0,0,0,0,0,0
"Trinidad and Tobago","2024-10-25",0,0,0,0,0,0,0,0
"Trinidad and Tobago","2024-10-26",0,0,0,0,0,0,0,0
"Trinidad and Tobago","2024-10-27",0,0,0,0,0,0,0,0
"Trinidad and Tobago","2024-10-28",0,0,0,0,0,0,0,0
"Trinidad and Tobago","2024-10-29",0,0,0,0,0,0,0,0
"Trinidad and Tobago","2024-10-30",0,0,0,0,0,0,0,0
"Trinidad and Tobago","2024-10-31",0,0,0,0,0,0,0,0
"Trinidad and Tobago","2024-11-01",0,0,0,0,0,0,0,0
"Trinidad and Tobago","2024-11-02",0,0,0,0,0,0,0,0
"Trinidad and Tobago","2024-11-03",0,0,0,0,0,0,0,0
"Trinidad and Tobago","2024-11-04",0,0,0,0,0,0,0,0
"Trinidad and Tobago","2024-11-05",0,0,0,0,0,0,0,0
"Trinidad and Tobago","2024-11-06",0,0,0,0,0,0,0,0
"Trinidad and Tobago","2024-11-07",0,0,0,0,0,0,0,0
"Trinidad and Tobago","2024-11-08",0,0,0,0,0,0,0,0
"Trinidad and Tobago","2024-11-09",0,0,0,0,0,0,0,0
"Trinidad and Tobago","2024-11-10",0,0,0,0,0,0,0,0
"Trinidad and Tobago","2024-11-11",0,0,0,0,0,0,0,0
"Trinidad and Tobago","2024-11-12",0,0,0,0,0,0,0,0
"Trinidad and Tobago","2024-11-13",0,0,0,0,0,0,0,0
"Trinidad and Tobago","2024-11-14",0,0,0,0,0,0,0,0
"Trinidad and Tobago","2024-11-15",0,0,0,0,0,0,0,0
"Trinidad and Tobago","2024-11-16",0,0,0,0,0,0,0,0
"Trinidad and Tobago","2024-11-17",0,0,0,0,0,0,0,0
"Trinidad and Tobago","2024-11-18",0,0,0,0,0,0,0,0
"Trinidad and Tobago","2024-11-19",0,0,0,0,0,0,0,0
"Trinidad and Tobago","2024-11-20",0,0,0,0,0,0,0,0
"Trinidad and Tobago","2024-11-21",0,0,0,0,0,0,0,0
"Trinidad and Tobago","2024-11-22",0,0,0,0,0,0,0,0
"Trinidad and Tobago","2024-11-23",0,0,0,0,0,0,0,0
"Trinidad and Tobago","2024-11-24",0,0,0,0,0,0,0,0
"Trinidad and Tobago","2024-11-25",0,0,0,0,0,0,0,0
"Trinidad and Tobago","2024-11-26",0,0,0,0,0,0,0,0
"Trinidad and Tobago","2024-11-27",0,0,0,0,0,0,0,0
"Trinidad and Tobago","2024-11-28",0,0,0,0,0,0,0,0
"Trinidad and Tobago","2024-11-29",0,0,0,0,0,0,0,0
"Trinidad and Tobago","2024-11-30",0,0,0,0,0,0,0,0
"Trinidad and Tobago","2024-12-01",0,0,0,0,0,0,0,0
"Trinidad and Tobago","2024-12-02",0,0,0,0,0,0,0,0
"Trinidad and Tobago","2024-12-03",0,0,0,0,0,0,0,0
"Trinidad and Tobago","2024-12-04",0,0,0,0,0,0,0,0
"Trinidad and Tobago","2024-12-05",0,0,0,0,0,0,0,0
"Trinidad and Tobago","2024-12-06",0,0,0,0,0,0,0,0
"Trinidad and Tobago","2024-12-07",0,0,0,0,0,0,0,0
"Trinidad and Tobago","2024-12-08",0,0,0,0,0,0,0,0
"Trinidad and Tobago","2024-12-09",0,0,0,0,0,0,0,0
"Trinidad and Tobago","2024-12-10",0,0,0,0,0,0,0,0
"Trinidad and Tobago","2024-12-11",0,0,0,0,0,0,0,0
"Trinidad and Tobago","2024-12-12",0,0,0,0,0,0,0,0
"Trinidad and Tobago","2024-12-13",0,0,0,0,0,0,0,0
"Trinidad and Tobago","2024-12-14",0,0,0,0,0,0,0,0
"Trinidad and Tobago","2024-12-15",0,0,0,0,0,0,0,0
"Trinidad and Tobago","2024-12-16",0,0,0,0,0,0,0,0
"Trinidad and Tobago","2024-12-17",0,0,0,0,0,0,0,0
"Trinidad and Tobago","2024-12-18",0,0,0,0,0,0,0,0
"Trinidad and Tobago","2024-12-19",0,0,0,0,0,0,0,0
"Trinidad and Tobago","2024-12-20",0,0,0,0,0,0,0,0
"Trinidad and Tobago","2024-12-21",0,0,0,0,0,0,0,0
"Trinidad and Tobago","2024-12-22",0,0,0,0,0,0,0,0
"Trinidad and Tobago","2024-12-23",0,0,0,0,0,0,0,0
"Trinidad and Tobago","2024-12-24",0,0,0,0,0,0,0,0
"Trinidad and Tobago","2024-12-25",0,0,0,0,0,0,0,0
"Trinidad and Tobago","2024-12-26",0,0,0,0,0,0,0,0
"Trinidad and Tobago","2024-12-27",0,0,0,0,0,0,0,0
"Trinidad and Tobago","2024-12-28",0,0,0,0,0,0,0,0
"Trinidad and Tobago","2024-12-29",0,0,0,0,0,0,0,0
"Trinidad and Tobago","2024-12-30",0,0,0,0,0,0,0,0
"Trinidad and Tobago","2024-12-31",0,0,0,0,0,0,0,0
"Trinidad and Tobago","2025-01-01",0,0,0,0,0,0,0,0
"Trinidad and Tobago","2025-01-02",0,0,0,0,0,0,0,0
"Trinidad and Tobago","2025-01-03",0,0,0,0,0,0,0,0
"Trinidad and Tobago","2025-01-04",0,0,0,0,0,0,0,0
"Trinidad and Tobago","2025-01-05",0,0,0,0,0,0,0,0
"Trinidad and Tobago","2025-01-06",0,0,0,0,0,0,0,0
"Trinidad and Tobago","2025-01-07",0,0,0,0,0,0,0,0
"Trinidad and Tobago","2025-01-08",0,0,0,0,0,0,0,0
"Trinidad and Tobago","2025-01-09",0,0,0,0,0,0,0,0
"Trinidad and Tobago","2025-01-10",0,0,0,0,0,0,0,0
"Trinidad and Tobago","2025-01-11",0,0,0,0,0,0,0,0
"Trinidad and Tobago","2025-01-12",0,0,0,0,0,0,0,0
"Trinidad and Tobago","2025-01-13",0,0,0,0,0,0,0,0
"Trinidad and Tobago","2025-01-14",0,0,0,0,0,0,0,0
"Trinidad and Tobago","2025-01-15",0,0,0,0,0,0,0,0
"Trinidad and Tobago","2025-01-16",0,0,0,0,0,0,0,0
"Trinidad and Tobago","2025-01-17",0,0,0,0,0,0,0,0
"Trinidad and Tobago","2025-01-18",0,0,0,0,0,0,0,0
"Trinidad and Tobago","2025-01-19",0,0,0,0,0,0,0,0
"Trinidad and Tobago","2025-01-20",0,0,0,0,0,0,0,0
"Trinidad and Tobago","2025-01-21",0,0,0,0,0,0,0,0
"Trinidad and Tobago","2025-01-22",0,0,0,0,0,0,0,0
"Trinidad and Tobago","2025-01-23",0,0,0,0,0,0,0,0
"Trinidad and Tobago","2025-01-24",0,0,0,0,0,0,0,0
"Trinidad and Tobago","2025-01-25",0,0,0,0,0,0,0,0
"Trinidad and Tobago","2025-01-26",0,0,0,0,0,0,0,0
"Trinidad and Tobago","2025-01-27",0,0,0,0,0,0,0,0
"Trinidad and Tobago","2025-01-28",0,0,0,0,0,0,0,0
"Trinidad and Tobago","2025-01-29",0,0,0,0,0,0,0,0
"Trinidad and Tobago","2025-01-30",0,0,0,0,0,0,0,0
"Trinidad and Tobago","2025-01-31",0,0,0,0,0,0,0,0
"Trinidad and Tobago","2025-02-01",0,0,0,0,0,0,0,0
"Trinidad and Tobago","2025-02-02",0,0,0,0,0,0,0,0
"Trinidad and Tobago","2025-02-03",0,0,0,0,0,0,0,0
"Türkiye","2024-01-01",0,0,0,0,0,0,0,0
"Türkiye","2024-01-02",0,0,0,0,0,0,0,0
"Türkiye","2024-01-03",0,0,0,0,0,0,0,0
"Türkiye","2024-01-04",0,0,0,0,0,0,0,0
"Türkiye","2024-01-05",0,0,0,0,0,0,0,0
"Türkiye","2024-01-06",0,0,0,0,0,0,0,0
"Türkiye","2024-01-07",0,0,0,0,0,0,0,0
"Türkiye","2024-01-08",0,0,0,0,0,0,0,0
"Türkiye","2024-01-09",0,0,0,0,0,0,0,0
"Türkiye","2024-01-10",0,0,0,0,0,0,0,0
"Türkiye","2024-01-11",0,0,0,0,0,0,0,0
"Türkiye","2024-01-12",0,0,0,0,0,0,0,0
"Türkiye","2024-01-13",0,0,0,0,0,0,0,0
"Türkiye","2024-01-14",0,0,0,0,0,0,0,0
"Türkiye","2024-01-15",0,0,0,0,0,0,0,0
"Türkiye","2024-01-16",0,0,0,0,0,0,0,0
"Türkiye","2024-01-17",0,0,0,0,0,0,0,0
"Türkiye","2024-01-18",0,0,0,0,0,0,0,0
"Türkiye","2024-01-19",0,0,0,0,0,0,0,0
"Türkiye","2024-01-20",0,0,0,0,0,0,0,0
"Türkiye","2024-01-21",0,0,0,0,0,0,0,0
"Türkiye","2024-01-22",0,0,0,0,0,0,0,0
"Türkiye","2024-01-23",0,0,0,0,0,0,0,0
"Türkiye","2024-01-24",0,0,0,0,0,0,0,0
"Türkiye","2024-01-25",0,0,0,0,0,0,0,0
"Türkiye","2024-01-26",0,0,0,0,0,0,0,0
"Türkiye","2024-01-27",0,0,0,0,0,0,0,0
"Türkiye","2024-01-28",0,0,0,0,0,0,0,0
"Türkiye","2024-01-29",0,0,0,0,0,0,0,0
"Türkiye","2024-01-30",0,0,0,0,0,0,0,0
"Türkiye","2024-01-31",0,0,0,0,0,0,0,0
"Türkiye","2024-02-01",0,0,0,0,0,0,0,0
"Türkiye","2024-02-02",0,0,0,0,0,0,0,0
"Türkiye","2024-02-03",0,0,0,0,0,0,0,0
"Türkiye","2024-02-04",0,0,0,0,0,0,0,0
"Türkiye","2024-02-05",0,0,0,0,0,0,0,0
"Türkiye","2024-02-06",0,0,0,0,0,0,0,0
"Türkiye","2024-02-07",0,0,0,0,0,0,0,0
"Türkiye","2024-02-08",0,0,0,0,0,0,0,0
"Türkiye","2024-02-09",0,0,0,0,0,0,0,0
"Türkiye","2024-02-10",0,0,0,0,0,0,0,0
"Türkiye","2024-02-11",0,0,0,0,0,0,0,0
"Türkiye","2024-02-12",0,0,0,0,0,0,0,0
"Türkiye","2024-02-13",0,0,0,0,0,0,0,0
"Türkiye","2024-02-14",0,0,0,0,0,0,0,0
"Türkiye","2024-02-15",0,0,0,0,0,0,0,0
"Türkiye","2024-02-16",0,0,0,0,0,0,0,0
"Türkiye","2024-02-17",0,0,0,0,0,0,0,0
"Türkiye","2024-02-18",0,0,0,0,0,0,0,0
"Türkiye","2024-02-19",0,0,0,0,0,0,0,0
"Türkiye","2024-02-20",0,0,0,0,0,0,0,0
"Türkiye","2024-02-21",0,0,0,0,0,0,0,0
"Türkiye","2024-02-22",0,0,0,0,0,0,0,0
"Türkiye","2024-02-23",0,0,0,0,0,0,0,0
"Türkiye","2024-02-24",0,0,0,0,0,0,0,0
"Türkiye","2024-02-25",0,0,0,0,0,0,0,0
"Türkiye","2024-02-26",0,0,0,0,0,0,0,0
"Türkiye","2024-02-27",0,0,0,0,0,0,0,0
"Türkiye","2024-02-28",0,0,0,0,0,0,0,0
"Türkiye","2024-02-29",0,0,0,0,0,0,0,0
"Türkiye","2024-03-01",0,0,0,0,0,0,0,0
"Türkiye","2024-03-02",0,0,0,0,0,0,0,0
"Türkiye","2024-03-03",0,0,0,0,0,0,0,0
"Türkiye","2024-03-04",0,0,0,0,0,0,0,0
"Türkiye","2024-03-05",0,0,0,0,0,0,0,0
"Türkiye","2024-03-06",0,0,0,0,0,0,0,0
"Türkiye","2024-03-07",0,0,0,0,0,0,0,0
"Türkiye","2024-03-08",0,0,0,0,0,0,0,0
"Türkiye","2024-03-09",0,0,0,0,0,0,0,0
"Türkiye","2024-03-10",0,0,0,0,0,0,0,0
"Türkiye","2024-03-11",0,0,0,0,0,0,0,0
"Türkiye","2024-03-12",0,0,0,0,0,0,0,0
"Türkiye","2024-03-13",0,0,0,0,0,0,0,0
"Türkiye","2024-03-14",0,0,0,0,0,0,0,0
"Türkiye","2024-03-15",0,0,0,0,0,0,0,0
"Türkiye","2024-03-16",0,0,0,0,0,0,0,0
"Türkiye","2024-03-17",0,0,0,0,0,0,0,0
"Türkiye","2024-03-18",0,0,0,0,0,0,0,0
"Türkiye","2024-03-19",0,0,0,0,0,0,0,0
"Türkiye","2024-03-20",0,0,0,0,0,0,0,0
"Türkiye","2024-03-21",0,0,0,0,0,0,0,0
"Türkiye","2024-03-22",0,0,0,0,0,0,0,0
"Türkiye","2024-03-23",0,0,0,0,0,0,0,0
"Türkiye","2024-03-24",0,0,0,0,0,0,0,0
"Türkiye","2024-03-25",0,0,0,0,0,0,0,0
"Türkiye","2024-03-26",0,0,0,0,0,0,0,0
"Türkiye","2024-03-27",0,0,0,0,0,0,0,0
"Türkiye","2024-03-28",0,0,0,0,0,0,0,0
"Türkiye","2024-03-29",0,0,0,0,0,0,0,0
"Türkiye","2024-03-30",0,0,0,0,0,0,0,0
"Türkiye","2024-03-31",0,0,0,0,0,0,0,0
"Türkiye","2024-04-01",0,0,0,0,0,0,0,0
"Türkiye","2024-04-02",0,0,0,0,0,0,0,0
"Türkiye","2024-04-03",0,0,0,0,0,0,0,0
"Türkiye","2024-04-04",0,0,0,0,0,0,0,0
"Türkiye","2024-04-05",0,0,0,0,0,0,0,0
"Türkiye","2024-04-06",0,0,0,0,0,0,0,0
"Türkiye","2024-04-07",0,0,0,0,0,0,0,0
"Türkiye","2024-04-08",0,0,0,0,0,0,0,0
"Türkiye","2024-04-09",0,0,0,0,0,0,0,0
"Türkiye","2024-04-10",0,0,0,0,0,0,0,0
"Türkiye","2024-04-11",0,0,0,0,0,0,0,0
"Türkiye","2024-04-12",0,0,0,0,0,0,0,0
"Türkiye","2024-04-13",0,0,0,0,0,0,0,0
"Türkiye","2024-04-14",0,0,0,0,0,0,0,0
"Türkiye","2024-04-15",0,0,0,0,0,0,0,0
"Türkiye","2024-04-16",0,0,0,0,0,0,0,0
"Türkiye","2024-04-17",0,0,0,0,0,0,0,0
"Türkiye","2024-04-18",0,0,0,0,0,0,0,0
"Türkiye","2024-04-19",0,0,0,0,0,0,0,0
"Türkiye","2024-04-20",0,0,0,0,0,0,0,0
"Türkiye","2024-04-21",0,0,0,0,0,0,0,0
"Türkiye","2024-04-22",0,0,0,0,0,0,0,0
"Türkiye","2024-04-23",0,0,0,0,0,0,0,0
"Türkiye","2024-04-24",0,0,0,0,0,0,0,0
"Türkiye","2024-04-25",0,0,0,0,0,0,0,0
"Türkiye","2024-04-26",0,0,0,0,0,0,0,0
"Türkiye","2024-04-27",0,0,0,0,0,0,0,0
"Türkiye","2024-04-28",0,0,0,0,0,0,0,0
"Türkiye","2024-04-29",0,0,0,0,0,0,0,0
"Türkiye","2024-04-30",0,0,0,0,0,0,0,0
"Türkiye","2024-05-01",0,0,0,0,0,0,0,0
"Türkiye","2024-05-02",0,0,0,0,0,0,0,0
"Türkiye","2024-05-03",0,0,0,0,0,0,0,0
"Türkiye","2024-05-04",0,0,0,0,0,0,0,0
"Türkiye","2024-05-05",0,0,0,0,0,0,0,0
"Türkiye","2024-05-06",0,0,0,0,0,0,0,0
"Türkiye","2024-05-07",0,0,0,0,0,0,0,0
"Türkiye","2024-05-08",0,0,0,0,0,0,0,0
"Türkiye","2024-05-09",0,0,0,0,0,0,0,0
"Türkiye","2024-05-10",0,0,0,0,0,0,0,0
"Türkiye","2024-05-11",0,0,0,0,0,0,0,0
"Türkiye","2024-05-12",0,0,0,0,0,0,0,0
"Türkiye","2024-05-13",0,0,0,0,0,0,0,0
"Türkiye","2024-05-14",0,0,0,0,0,0,0,0
"Türkiye","2024-05-15",0,0,0,0,0,0,0,0
"Türkiye","2024-05-16",0,0,0,0,0,0,0,0
"Türkiye","2024-05-17",0,0,0,0,0,0,0,0
"Türkiye","2024-05-18",0,0,0,0,0,0,0,0
"Türkiye","2024-05-19",0,0,0,0,0,0,0,0
"Türkiye","2024-05-20",0,0,0,0,0,0,0,0
"Türkiye","2024-05-21",0,0,0,0,0,0,0,0
"Türkiye","2024-05-22",0,0,0,0,0,0,0,0
"Türkiye","2024-05-23",0,0,0,0,0,0,0,0
"Türkiye","2024-05-24",0,0,0,0,0,0,0,0
"Türkiye","2024-05-25",0,0,0,0,0,0,0,0
"Türkiye","2024-05-26",0,0,0,0,0,0,0,0
"Türkiye","2024-05-27",0,0,0,0,0,0,0,0
"Türkiye","2024-05-28",0,0,0,0,0,0,0,0
"Türkiye","2024-05-29",0,0,0,0,0,0,0,0
"Türkiye","2024-05-30",0,0,0,0,0,0,0,0
"Türkiye","2024-05-31",0,0,0,0,0,0,0,0
"Türkiye","2024-06-01",0,0,0,0,0,0,0,0
"Türkiye","2024-06-02",0,0,0,0,0,0,0,0
"Türkiye","2024-06-03",0,0,0,0,0,0,0,0
"Türkiye","2024-06-04",0,0,0,0,0,0,0,0
"Türkiye","2024-06-05",0,0,0,0,0,0,0,0
"Türkiye","2024-06-06",0,0,0,0,0,0,0,0
"Türkiye","2024-06-07",0,0,0,0,0,0,0,0
"Türkiye","2024-06-08",0,0,0,0,0,0,0,0
"Türkiye","2024-06-09",0,0,0,0,0,0,0,0
"Türkiye","2024-06-10",0,0,0,0,0,0,0,0
"Türkiye","2024-06-11",0,0,0,0,0,0,0,0
"Türkiye","2024-06-12",0,0,0,0,0,0,0,0
"Türkiye","2024-06-13",0,0,0,0,0,0,0,0
"Türkiye","2024-06-14",0,0,0,0,0,0,0,0
"Türkiye","2024-06-15",0,0,0,0,0,0,0,0
"Türkiye","2024-06-16",0,0,0,0,0,0,0,0
"Türkiye","2024-06-17",0,0,0,0,0,0,0,0
"Türkiye","2024-06-18",0,0,0,0,0,0,0,0
"Türkiye","2024-06-19",0,0,0,0,0,0,0,0
"Türkiye","2024-06-20",0,0,0,0,0,0,0,0
"Türkiye","2024-06-21",0,0,0,0,0,0,0,0
"Türkiye","2024-06-22",0,0,0,0,0,0,0,0
"Türkiye","2024-06-23",0,0,0,0,0,0,0,0
"Türkiye","2024-06-24",0,0,0,0,0,0,0,0
"Türkiye","2024-06-25",0,0,0,0,0,0,0,0
"Türkiye","2024-06-26",0,0,0,0,0,0,0,0
"Türkiye","2024-06-27",0,0,0,0,0,0,0,0
"Türkiye","2024-06-28",0,0,0,0,0,0,0,0
"Türkiye","2024-06-29",0,0,0,0,0,0,0,0
"Türkiye","2024-06-30",0,0,0,0,0,0,0,0
"Türkiye","2024-07-01",0,0,0,0,0,0,0,0
"Türkiye","2024-07-02",0,0,0,0,0,0,0,0
"Türkiye","2024-07-03",0,0,0,0,0,0,0,0
"Türkiye","2024-07-04",0,0,0,0,0,0,0,0
"Türkiye","2024-07-05",0,0,0,0,0,0,0,0
"Türkiye","2024-07-06",0,0,0,0,0,0,0,0
"Türkiye","2024-07-07",0,0,0,0,0,0,0,0
"Türkiye","2024-07-08",0,0,0,0,0,0,0,0
"Türkiye","2024-07-09",0,0,0,0,0,0,0,0
"Türkiye","2024-07-10",0,0,0,0,0,0,0,0
"Türkiye","2024-07-11",0,0,0,0,0,0,0,0
"Türkiye","2024-07-12",0,0,0,0,0,0,0,0
"Türkiye","2024-07-13",0,0,0,0,0,0,0,0
"Türkiye","2024-07-14",0,0,0,0,0,0,0,0
"Türkiye","2024-07-15",0,0,0,0,0,0,0,0
"Türkiye","2024-07-16",0,0,0,0,0,0,0,0
"Türkiye","2024-07-17",0,0,0,0,0,0,0,0
"Türkiye","2024-07-18",0,0,0,0,0,0,0,0
"Türkiye","2024-07-19",0,0,0,0,0,0,0,0
"Türkiye","2024-07-20",0,0,0,0,0,0,0,0
"Türkiye","2024-07-21",0,0,0,0,0,0,0,0
"Türkiye","2024-07-22",0,0,0,0,0,0,0,0
"Türkiye","2024-07-23",0,0,0,0,0,0,0,0
"Türkiye","2024-07-24",0,0,0,0,0,0,0,0
"Türkiye","2024-07-25",0,0,0,0,0,0,0,0
"Türkiye","2024-07-26",0,0,0,0,0,0,0,0
"Türkiye","2024-07-27",0,0,0,0,0,0,0,0
"Türkiye","2024-07-28",0,0,0,0,0,0,0,0
"Türkiye","2024-07-29",0,0,0,0,0,0,0,0
"Türkiye","2024-07-30",0,0,0,0,0,0,0,0
"Türkiye","2024-07-31",0,0,0,0,0,0,0,0
"Türkiye","2024-08-01",0,0,0,0,0,0,0,0
"Türkiye","2024-08-02",0,0,0,0,0,0,0,0
"Türkiye","2024-08-03",0,0,0,0,0,0,0,0
"Türkiye","2024-08-04",0,0,0,0,0,0,0,0
"Türkiye","2024-08-05",0,0,0,0,0,0,0,0
"Türkiye","2024-08-06",0,0,0,0,0,0,0,0
"Türkiye","2024-08-07",0,0,0,0,0,0,0,0
"Türkiye","2024-08-08",0,0,0,0,0,0,0,0
"Türkiye","2024-08-09",0,0,0,0,0,0,0,0
"Türkiye","2024-08-10",0,0,0,0,0,0,0,0
"Türkiye","2024-08-11",0,0,0,0,0,0,0,0
"Türkiye","2024-08-12",0,0,0,0,0,0,0,0
"Türkiye","2024-08-13",0,0,0,0,0,0,0,0
"Türkiye","2024-08-14",0,0,0,0,0,0,0,0
"Türkiye","2024-08-15",0,0,0,0,0,0,0,0
"Türkiye","2024-08-16",0,0,0,0,0,0,0,0
"Türkiye","2024-08-17",0,0,0,0,0,0,0,0
"Türkiye","2024-08-18",0,0,0,0,0,0,0,0
"Türkiye","2024-08-19",0,0,0,0,0,0,0,0
"Türkiye","2024-08-20",0,0,0,0,0,0,0,0
"Türkiye","2024-08-21",0,0,0,0,0,0,0,0
"Türkiye","2024-08-22",0,0,0,0,0,0,0,0
"Türkiye","2024-08-23",0,0,0,0,0,0,0,0
"Türkiye","2024-08-24",0,0,0,0,0,0,0,0
"Türkiye","2024-08-25",0,0,0,0,0,0,0,0
"Türkiye","2024-08-26",0,0,0,0,0,0,0,0
"Türkiye","2024-08-27",0,0,0,0,0,0,0,0
"Türkiye","2024-08-28",0,0,0,0,0,0,0,0
"Türkiye","2024-08-29",0,0,0,0,0,0,0,0
"Türkiye","2024-08-30",0,0,0,0,0,0,0,0
"Türkiye","2024-08-31",0,0,0,0,0,0,0,0
"Türkiye","2024-09-01",0,0,0,0,0,0,0,0
"Türkiye","2024-09-02",0,0,0,0,0,0,0,0
"Türkiye","2024-09-03",0,0,0,0,0,0,0,0
"Türkiye","2024-09-04",0,0,0,0,0,0,0,0
"Türkiye","2024-09-05",0,0,0,0,0,0,0,0
"Türkiye","2024-09-06",0,0,0,0,0,0,0,0
"Türkiye","2024-09-07",0,0,0,0,0,0,0,0
"Türkiye","2024-09-08",0,0,0,0,0,0,0,0
"Türkiye","2024-09-09",0,0,0,0,0,0,0,0
"Türkiye","2024-09-10",0,0,0,0,0,0,0,0
"Türkiye","2024-09-11",0,0,0,0,0,0,0,0
"Türkiye","2024-09-12",0,0,0,0,0,0,0,0
"Türkiye","2024-09-13",0,0,0,0,0,0,0,0
"Türkiye","2024-09-14",0,0,0,0,0,0,0,0
"Türkiye","2024-09-15",0,0,0,0,0,0,0,0
"Türkiye","2024-09-16",0,0,0,0,0,0,0,0
"Türkiye","2024-09-17",0,0,0,0,0,0,0,0
"Türkiye","2024-09-18",0,0,0,0,0,0,0,0
"Türkiye","2024-09-19",0,0,0,0,0,0,0,0
"Türkiye","2024-09-20",0,0,0,0,0,0,0,0
"Türkiye","2024-09-21",0,0,0,0,0,0,0,0
"Türkiye","2024-09-22",0,0,0,0,0,0,0,0
"Türkiye","2024-09-23",0,0,0,0,0,0,0,0
"Türkiye","2024-09-24",0,0,0,0,0,0,0,0
"Türkiye","2024-09-25",0,0,0,0,0,0,0,0
"Türkiye","2024-09-26",0,0,0,0,0,0,0,0
"Türkiye","2024-09-27",0,0,0,0,0,0,0,0
"Türkiye","2024-09-28",0,0,0,0,0,0,0,0
"Türkiye","2024-09-29",0,0,0,0,0,0,0,0
"Türkiye","2024-09-30",0,0,0,0,0,0,0,0
"Türkiye","2024-10-01",0,0,0,0,0,0,0,0
"Türkiye","2024-10-02",0,0,0,0,0,0,0,0
"Türkiye","2024-10-03",0,0,0,0,0,0,0,0
"Türkiye","2024-10-04",0,0,0,0,0,0,0,0
"Türkiye","2024-10-05",0,0,0,0,0,0,0,0
"Türkiye","2024-10-06",0,0,0,0,0,0,0,0
"Türkiye","2024-10-07",0,0,0,0,0,0,0,0
"Türkiye","2024-10-08",0,0,0,0,0,0,0,0
"Türkiye","2024-10-09",0,0,0,0,0,0,0,0
"Türkiye","2024-10-10",0,0,0,0,0,0,0,0
"Türkiye","2024-10-11",0,0,0,0,0,0,0,0
"Türkiye","2024-10-12",0,0,0,0,0,0,0,0
"Türkiye","2024-10-13",0,0,0,0,0,0,0,0
"Türkiye","2024-10-14",0,0,0,0,0,0,0,0
"Türkiye","2024-10-15",0,0,0,0,0,0,0,0
"Türkiye","2024-10-16",0,0,0,0,0,0,0,0
"Türkiye","2024-10-17",0,0,0,0,0,0,0,0
"Türkiye","2024-10-18",0,0,0,0,0,0,0,0
"Türkiye","2024-10-19",0,0,0,0,0,0,0,0
"Türkiye","2024-10-20",0,0,0,0,0,0,0,0
"Türkiye","2024-10-21",0,0,0,0,0,0,0,0
"Türkiye","2024-10-22",0,0,0,0,0,0,0,0
"Türkiye","2024-10-23",0,0,0,0,0,0,0,0
"Türkiye","2024-10-24",0,0,0,0,0,0,0,0
"Türkiye","2024-10-25",0,0,0,0,0,0,0,0
"Türkiye","2024-10-26",0,0,0,0,0,0,0,0
"Türkiye","2024-10-27",0,0,0,0,0,0,0,0
"Türkiye","2024-10-28",0,0,0,0,0,0,0,0
"Türkiye","2024-10-29",0,0,0,0,0,0,0,0
"Türkiye","2024-10-30",0,0,0,0,0,0,0,0
"Türkiye","2024-10-31",0,0,0,0,0,0,0,0
"Türkiye","2024-11-01",0,0,0,0,0,0,0,0
"Türkiye","2024-11-02",0,0,0,0,0,0,0,0
"Türkiye","2024-11-03",0,0,0,0,0,0,0,0
"Türkiye","2024-11-04",0,0,0,0,0,0,0,0
"Türkiye","2024-11-05",0,0,0,0,0,0,0,0
"Türkiye","2024-11-06",0,0,0,0,0,0,0,0
"Türkiye","2024-11-07",0,0,0,0,0,0,0,0
"Türkiye","2024-11-08",0,0,0,0,0,0,0,0
"Türkiye","2024-11-09",0,0,0,0,0,0,0,0
"Türkiye","2024-11-10",0,0,0,0,0,0,0,0
"Türkiye","2024-11-11",0,0,0,0,0,0,0,0
"Türkiye","2024-11-12",0,0,0,0,0,0,0,0
"Türkiye","2024-11-13",0,0,0,0,0,0,0,0
"Türkiye","2024-11-14",0,0,0,0,0,0,0,0
"Türkiye","2024-11-15",0,0,0,0,0,0,0,0
"Türkiye","2024-11-16",0,0,0,0,0,0,0,0
"Türkiye","2024-11-17",0,0,0,0,0,0,0,0
"Türkiye","2024-11-18",0,0,0,0,0,0,0,0
"Türkiye","2024-11-19",0,0,0,0,0,0,0,0
"Türkiye","2024-11-20",0,0,0,0,0,0,0,0
"Türkiye","2024-11-21",0,0,0,0,0,0,0,0
"Türkiye","2024-11-22",0,0,0,0,0,0,0,0
"Türkiye","2024-11-23",0,0,0,0,0,0,0,0
"Türkiye","2024-11-24",0,0,0,0,0,0,0,0
"Türkiye","2024-11-25",0,0,0,0,0,0,0,0
"Türkiye","2024-11-26",0,0,0,0,0,0,0,0
"Türkiye","2024-11-27",0,0,0,0,0,0,0,0
"Türkiye","2024-11-28",0,0,0,0,0,0,0,0
"Türkiye","2024-11-29",0,0,0,0,0,0,0,0
"Türkiye","2024-11-30",0,0,0,0,0,0,0,0
"Türkiye","2024-12-01",0,0,0,0,0,0,0,0
"Türkiye","2024-12-02",0,0,0,0,0,0,0,0
"Türkiye","2024-12-03",0,0,0,0,0,0,0,0
"Türkiye","2024-12-04",0,0,0,0,0,0,0,0
"Türkiye","2024-12-05",0,0,0,0,0,0,0,0
"Türkiye","2024-12-06",0,0,0,0,0,0,0,0
"Türkiye","2024-12-07",0,0,0,0,0,0,0,0
"Türkiye","2024-12-08",0,0,0,0,0,0,0,0
"Türkiye","2024-12-09",0,0,0,0,0,0,0,0
"Türkiye","2024-12-10",0,0,0,0,0,0,0,0
"Türkiye","2024-12-11",0,0,0,0,0,0,0,0
"Türkiye","2024-12-12",0,0,0,0,0,0,0,0
"Türkiye","2024-12-13",0,0,0,0,0,0,0,0
"Türkiye","2024-12-14",0,0,0,0,0,0,0,0
"Türkiye","2024-12-15",0,0,0,0,0,0,0,0
"Türkiye","2024-12-16",0,0,0,0,0,0,0,0
"Türkiye","2024-12-17",0,0,0,0,0,0,0,0
"Türkiye","2024-12-18",0,0,0,0,0,0,0,0
"Türkiye","2024-12-19",0,0,0,0,0,0,0,0
"Türkiye","2024-12-20",0,0,0,0,0,0,0,0
"Türkiye","2024-12-21",0,0,0,0,0,0,0,0
"Türkiye","2024-12-22",0,0,0,0,0,0,0,0
"Türkiye","2024-12-23",0,0,0,0,0,0,0,0
"Türkiye","2024-12-24",0,0,0,0,0,0,0,0
"Türkiye","2024-12-25",0,0,0,0,0,0,0,0
"Türkiye","2024-12-26",0,0,0,0,0,0,0,0
"Türkiye","2024-12-27",0,0,0,0,0,0,0,0
"Türkiye","2024-12-28",0,0,0,0,0,0,0,0
"Türkiye","2024-12-29",0,0,0,0,0,0,0,0
"Türkiye","2024-12-30",0,0,0,0,0,0,0,0
"Türkiye","2024-12-31",0,0,0,0,0,0,0,0
"Türkiye","2025-01-01",0,0,0,0,0,0,0,0
"Türkiye","2025-01-02",0,0,0,0,0,0,0,0
"Türkiye","2025-01-03",0,0,0,0,0,0,0,0
"Türkiye","2025-01-04",0,0,0,0,0,0,0,0
"Türkiye","2025-01-05",0,0,0,0,0,0,0,0
"Türkiye","2025-01-06",0,0,0,0,0,0,0,0
"Türkiye","2025-01-07",0,0,0,0,0,0,0,0
"Türkiye","2025-01-08",0,0,0,0,0,0,0,0
"Türkiye","2025-01-09",0,0,0,0,0,0,0,0
"Türkiye","2025-01-10",0,0,0,0,0,0,0,0
"Türkiye","2025-01-11",0,0,0,0,0,0,0,0
"Türkiye","2025-01-12",0,0,0,0,0,0,0,0
"Türkiye","2025-01-13",0,0,0,0,0,0,0,0
"Türkiye","2025-01-14",0,0,0,0,0,0,0,0
"Türkiye","2025-01-15",0,0,0,0,0,0,0,0
"Türkiye","2025-01-16",0,0,0,0,0,0,0,0
"Türkiye","2025-01-17",0,0,0,0,0,0,0,0
"Türkiye","2025-01-18",0,0,0,0,0,0,0,0
"Türkiye","2025-01-19",0,0,0,0,0,0,0,0
"Türkiye","2025-01-20",0,0,0,0,0,0,0,0
"Türkiye","2025-01-21",0,0,0,0,0,0,0,0
"Türkiye","2025-01-22",0,0,0,0,0,0,0,0
"Türkiye","2025-01-23",0,0,0,0,0,0,0,0
"Türkiye","2025-01-24",0,0,0,0,0,0,0,0
"Türkiye","2025-01-25",0,0,0,0,0,0,0,0
"Türkiye","2025-01-26",0,0,0,0,0,0,0,0
"Türkiye","2025-01-27",0,0,0,0,0,0,0,0
"Türkiye","2025-01-28",0,0,0,0,0,0,0,0
"Türkiye","2025-01-29",0,0,0,0,0,0,0,0
"Türkiye","2025-01-30",0,0,0,0,0,0,0,0
"Türkiye","2025-01-31",0,0,0,0,0,0,0,0
"Türkiye","2025-02-01",0,0,0,0,0,0,0,0
"Türkiye","2025-02-02",0,0,0,0,0,0,0,0
"Türkiye","2025-02-03",0,0,0,0,0,0,0,0
"Uganda","2024-01-01",0,0,0,0,0,0,0,0
"Uganda","2024-01-02",0,0,0,0,0,0,0,0
"Uganda","2024-01-03",0,0,0,0,0,0,0,0
"Uganda","2024-01-04",0,0,0,0,0,0,0,0
"Uganda","2024-01-05",0,0,0,0,0,0,0,0
"Uganda","2024-01-06",0,0,0,0,0,0,0,0
"Uganda","2024-01-07",0,0,0,0,0,0,0,0
"Uganda","2024-01-08",0,0,0,0,0,0,0,0
"Uganda","2024-01-09",0,0,0,0,0,0,0,0
"Uganda","2024-01-10",0,0,0,0,0,0,0,0
"Uganda","2024-01-11",0,0,0,0,0,0,0,0
"Uganda","2024-01-12",0,0,0,0,0,0,0,0
"Uganda","2024-01-13",0,0,0,0,0,0,0,0
"Uganda","2024-01-14",0,0,0,0,0,0,0,0
"Uganda","2024-01-15",0,0,0,0,0,0,0,0
"Uganda","2024-01-16",0,0,0,0,0,0,0,0
"Uganda","2024-01-17",0,0,0,0,0,0,0,0
"Uganda","2024-01-18",0,0,0,0,0,0,0,0
"Uganda","2024-01-19",0,0,0,0,0,0,0,0
"Uganda","2024-01-20",0,0,0,0,0,0,0,0
"Uganda","2024-01-21",0,0,0,0,0,0,0,0
"Uganda","2024-01-22",0,0,0,0,0,0,0,0
"Uganda","2024-01-23",0,0,0,0,0,0,0,0
"Uganda","2024-01-24",0,0,0,0,0,0,0,0
"Uganda","2024-01-25",0,0,0,0,0,0,0,0
"Uganda","2024-01-26",0,0,0,0,0,0,0,0
"Uganda","2024-01-27",0,0,0,0,0,0,0,0
"Uganda","2024-01-28",0,0,0,0,0,0,0,0
"Uganda","2024-01-29",0,0,0,0,0,0,0,0
"Uganda","2024-01-30",0,0,0,0,0,0,0,0
"Uganda","2024-01-31",0,0,0,0,0,0,0,0
"Uganda","2024-02-01",0,0,0,0,0,0,0,0
"Uganda","2024-02-02",0,0,0,0,0,0,0,0
"Uganda","2024-02-03",0,0,0,0,0,0,0,0
"Uganda","2024-02-04",0,0,0,0,0,0,0,0
"Uganda","2024-02-05",0,0,0,0,0,0,0,0
"Uganda","2024-02-06",0,0,0,0,0,0,0,0
"Uganda","2024-02-07",0,0,0,0,0,0,0,0
"Uganda","2024-02-08",0,0,0,0,0,0,0,0
"Uganda","2024-02-09",0,0,0,0,0,0,0,0
"Uganda","2024-02-10",0,0,0,0,0,0,0,0
"Uganda","2024-02-11",0,0,0,0,0,0,0,0
"Uganda","2024-02-12",0,0,0,0,0,0,0,0
"Uganda","2024-02-13",0,0,0,0,0,0,0,0
"Uganda","2024-02-14",0,0,0,0,0,0,0,0
"Uganda","2024-02-15",0,0,0,0,0,0,0,0
"Uganda","2024-02-16",0,0,0,0,0,0,0,0
"Uganda","2024-02-17",0,0,0,0,0,0,0,0
"Uganda","2024-02-18",0,0,0,0,0,0,0,0
"Uganda","2024-02-19",0,0,0,0,0,0,0,0
"Uganda","2024-02-20",0,0,0,0,0,0,0,0
"Uganda","2024-02-21",0,0,0,0,0,0,0,0
"Uganda","2024-02-22",0,0,0,0,0,0,0,0
"Uganda","2024-02-23",0,0,0,0,0,0,0,0
"Uganda","2024-02-24",0,0,0,0,0,0,0,0
"Uganda","2024-02-25",0,0,0,0,0,0,0,0
"Uganda","2024-02-26",0,0,0,0,0,0,0,0
"Uganda","2024-02-27",0,0,0,0,0,0,0,0
"Uganda","2024-02-28",0,0,0,0,0,0,0,0
"Uganda","2024-02-29",0,0,0,0,0,0,0,0
"Uganda","2024-03-01",0,0,0,0,0,0,0,0
"Uganda","2024-03-02",0,0,0,0,0,0,0,0
"Uganda","2024-03-03",0,0,0,0,0,0,0,0
"Uganda","2024-03-04",0,0,0,0,0,0,0,0
"Uganda","2024-03-05",0,0,0,0,0,0,0,0
"Uganda","2024-03-06",0,0,0,0,0,0,0,0
"Uganda","2024-03-07",0,0,0,0,0,0,0,0
"Uganda","2024-03-08",0,0,0,0,0,0,0,0
"Uganda","2024-03-09",0,0,0,0,0,0,0,0
"Uganda","2024-03-10",0,0,0,0,0,0,0,0
"Uganda","2024-03-11",0,0,0,0,0,0,0,0
"Uganda","2024-03-12",0,0,0,0,0,0,0,0
"Uganda","2024-03-13",0,0,0,0,0,0,0,0
"Uganda","2024-03-14",0,0,0,0,0,0,0,0
"Uganda","2024-03-15",0,0,0,0,0,0,0,0
"Uganda","2024-03-16",0,0,0,0,0,0,0,0
"Uganda","2024-03-17",0,0,0,0,0,0,0,0
"Uganda","2024-03-18",0,0,0,0,0,0,0,0
"Uganda","2024-03-19",0,0,0,0,0,0,0,0
"Uganda","2024-03-20",0,0,0,0,0,0,0,0
"Uganda","2024-03-21",0,0,0,0,0,0,0,0
"Uganda","2024-03-22",0,0,0,0,0,0,0,0
"Uganda","2024-03-23",0,0,0,0,0,0,0,0
"Uganda","2024-03-24",0,0,0,0,0,0,0,0
"Uganda","2024-03-25",0,0,0,0,0,0,0,0
"Uganda","2024-03-26",0,0,0,0,0,0,0,0
"Uganda","2024-03-27",0,0,0,0,0,0,0,0
"Uganda","2024-03-28",0,0,0,0,0,0,0,0
"Uganda","2024-03-29",0,0,0,0,0,0,0,0
"Uganda","2024-03-30",0,0,0,0,0,0,0,0
"Uganda","2024-03-31",0,0,0,0,0,0,0,0
"Uganda","2024-04-01",0,0,0,0,0,0,0,0
"Uganda","2024-04-02",0,0,0,0,0,0,0,0
"Uganda","2024-04-03",0,0,0,0,0,0,0,0
"Uganda","2024-04-04",0,0,0,0,0,0,0,0
"Uganda","2024-04-05",0,0,0,0,0,0,0,0
"Uganda","2024-04-06",0,0,0,0,0,0,0,0
"Uganda","2024-04-07",0,0,0,0,0,0,0,0
"Uganda","2024-04-08",0,0,0,0,0,0,0,0
"Uganda","2024-04-09",0,0,0,0,0,0,0,0
"Uganda","2024-04-10",0,0,0,0,0,0,0,0
"Uganda","2024-04-11",0,0,0,0,0,0,0,0
"Uganda","2024-04-12",0,0,0,0,0,0,0,0
"Uganda","2024-04-13",0,0,0,0,0,0,0,0
"Uganda","2024-04-14",0,0,0,0,0,0,0,0
"Uganda","2024-04-15",0,0,0,0,0,0,0,0
"Uganda","2024-04-16",0,0,0,0,0,0,0,0
"Uganda","2024-04-17",0,0,0,0,0,0,0,0
"Uganda","2024-04-18",0,0,0,0,0,0,0,0
"Uganda","2024-04-19",0,0,0,0,0,0,0,0
"Uganda","2024-04-20",0,0,0,0,0,0,0,0
"Uganda","2024-04-21",0,0,0,0,0,0,0,0
"Uganda","2024-04-22",0,0,0,0,0,0,0,0
"Uganda","2024-04-23",0,0,0,0,0,0,0,0
"Uganda","2024-04-24",0,0,0,0,0,0,0,0
"Uganda","2024-04-25",0,0,0,0,0,0,0,0
"Uganda","2024-04-26",0,0,0,0,0,0,0,0
"Uganda","2024-04-27",0,0,0,0,0,0,0,0
"Uganda","2024-04-28",0,0,0,0,0,0,0,0
"Uganda","2024-04-29",0,0,0,0,0,0,0,0
"Uganda","2024-04-30",0,0,0,0,0,0,0,0
"Uganda","2024-05-01",0,0,0,0,0,0,0,0
"Uganda","2024-05-02",0,0,0,0,0,0,0,0
"Uganda","2024-05-03",0,0,0,0,0,0,0,0
"Uganda","2024-05-04",0,0,0,0,0,0,0,0
"Uganda","2024-05-05",0,0,0,0,0,0,0,0
"Uganda","2024-05-06",0,0,0,0,0,0,0,0
"Uganda","2024-05-07",0,0,0,0,0,0,0,0
"Uganda","2024-05-08",0,0,0,0,0,0,0,0
"Uganda","2024-05-09",0,0,0,0,0,0,0,0
"Uganda","2024-05-10",0,0,0,0,0,0,0,0
"Uganda","2024-05-11",0,0,0,0,0,0,0,0
"Uganda","2024-05-12",0,0,0,0,0,0,0,0
"Uganda","2024-05-13",0,0,0,0,0,0,0,0
"Uganda","2024-05-14",0,0,0,0,0,0,0,0
"Uganda","2024-05-15",0,0,0,0,0,0,0,0
"Uganda","2024-05-16",0,0,0,0,0,0,0,0
"Uganda","2024-05-17",0,0,0,0,0,0,0,0
"Uganda","2024-05-18",0,0,0,0,0,0,0,0
"Uganda","2024-05-19",0,0,0,0,0,0,0,0
"Uganda","2024-05-20",0,0,0,0,0,0,0,0
"Uganda","2024-05-21",0,0,0,0,0,0,0,0
"Uganda","2024-05-22",0,0,0,0,0,0,0,0
"Uganda","2024-05-23",0,0,0,0,0,0,0,0
"Uganda","2024-05-24",0,0,0,0,0,0,0,0
"Uganda","2024-05-25",0,0,0,0,0,0,0,0
"Uganda","2024-05-26",0,0,0,0,0,0,0,0
"Uganda","2024-05-27",0,0,0,0,0,0,0,0
"Uganda","2024-05-28",0,0,0,0,0,0,0,0
"Uganda","2024-05-29",0,0,0,0,0,0,0,0
"Uganda","2024-05-30",0,0,0,0,0,0,0,0
"Uganda","2024-05-31",0,0,0,0,0,0,0,0
"Uganda","2024-06-01",0,0,0,0,0,0,0,0
"Uganda","2024-06-02",0,0,0,0,0,0,0,0
"Uganda","2024-06-03",0,0,0,0,0,0,0,0
"Uganda","2024-06-04",0,0,0,0,0,0,0,0
"Uganda","2024-06-05",0,0,0,0,0,0,0,0
"Uganda","2024-06-06",0,0,0,0,0,0,0,0
"Uganda","2024-06-07",0,0,0,0,0,0,0,0
"Uganda","2024-06-08",0,0,0,0,0,0,0,0
"Uganda","2024-06-09",0,0,0,0,0,0,0,0
"Uganda","2024-06-10",0,0,0,0,0,0,0,0
"Uganda","2024-06-11",0,0,0,0,0,0,0,0
"Uganda","2024-06-12",0,0,0,0,0,0,0,0
"Uganda","2024-06-13",0,0,0,0,0,0,0,0
"Uganda","2024-06-14",0,0,0,0,0,0,0,0
"Uganda","2024-06-15",0,0,0,0,0,0,0,0
"Uganda","2024-06-16",0,0,0,0,0,0,0,0
"Uganda","2024-06-17",0,0,0,0,0,0,0,0
"Uganda","2024-06-18",0,0,0,0,0,0,0,0
"Uganda","2024-06-19",0,0,0,0,0,0,0,0
"Uganda","2024-06-20",0,0,0,0,0,0,0,0
"Uganda","2024-06-21",0,0,0,0,0,0,0,0
"Uganda","2024-06-22",0,0,0,0,0,0,0,0
"Uganda","2024-06-23",0,0,0,0,0,0,0,0
"Uganda","2024-06-24",0,0,0,0,0,0,0,0
"Uganda","2024-06-25",0,0,0,0,0,0,0,0
"Uganda","2024-06-26",0,0,0,0,0,0,0,0
"Uganda","2024-06-27",0,0,0,0,0,0,0,0
"Uganda","2024-06-28",0,0,0,0,0,0,0,0
"Uganda","2024-06-29",0,0,0,0,0,0,0,0
"Uganda","2024-06-30",0,0,0,0,0,0,0,0
"Uganda","2024-07-01",0,0,0,0,0,0,0,0
"Uganda","2024-07-02",0,0,0,0,0,0,0,0
"Uganda","2024-07-03",0,0,0,0,0,0,0,0
"Uganda","2024-07-04",0,0,0,0,0,0,0,0
"Uganda","2024-07-05",0,0,0,0,0,0,0,0
"Uganda","2024-07-06",0,0,0,0,0,0,0,0
"Uganda","2024-07-07",0,0,0,0,0,0,0,0
"Uganda","2024-07-08",0,0,0,0,0,0,0,0
"Uganda","2024-07-09",0,0,0,0,0,0,0,0
"Uganda","2024-07-10",0,0,0,0,0,0,0,0
"Uganda","2024-07-11",0,0,0,0,0,0,0,0
"Uganda","2024-07-12",0,0,0,0,0,0,0,0
"Uganda","2024-07-13",0,0,0,0,0,0,0,0
"Uganda","2024-07-14",0,0,0,0,0,0,0,0
"Uganda","2024-07-15",0,0,0,0,0,0,0,0
"Uganda","2024-07-16",0,0,0,0,0,0,0,0
"Uganda","2024-07-17",0,0,0,0,0,0,0,0
"Uganda","2024-07-18",0,0,0,0,0,0,0,0
"Uganda","2024-07-19",0,0,0,0,0,0,0,0
"Uganda","2024-07-20",0,0,0,0,0,0,0,0
"Uganda","2024-07-21",0,0,0,0,0,0,0,0
"Uganda","2024-07-22",0,0,0,0,0,0,0,0
"Uganda","2024-07-23",0,0,0,0,0,0,0,0
"Uganda","2024-07-24",0,0,0,0,0,0,0,0
"Uganda","2024-07-25",0,0,0,0,0,0,0,0
"Uganda","2024-07-26",0,0,0,0,0,0,0,0
"Uganda","2024-07-27",0,0,0,0,0,0,0,0
"Uganda","2024-07-28",0,2,2,0,2,2,0,0
"Uganda","2024-07-29",0,0,2,0,0,2,0,0
"Uganda","2024-07-30",0,0,2,0,0,2,0,0
"Uganda","2024-07-31",0,0,2,0,0,2,0,0
"Uganda","2024-08-01",0,0,2,0,1,3,0,0
"Uganda","2024-08-02",0,0,2,0,0,3,0,0
"Uganda","2024-08-03",0,0,2,0,0,3,0,0
"Uganda","2024-08-04",0,1,3,0,0,3,0,0
"Uganda","2024-08-05",0,0,3,0,0,3,0,0
"Uganda","2024-08-06",0,0,3,0,0,3,0,0
"Uganda","2024-08-07",0,0,3,0,0,3,0,0
"Uganda","2024-08-08",0,0,3,0,1,4,0,0
"Uganda","2024-08-09",0,0,3,0,0,4,0,0
"Uganda","2024-08-10",0,0,3,0,0,4,0,0
"Uganda","2024-08-11",0,1,4,0,0,4,0,0
"Uganda","2024-08-12",0,0,4,0,1,5,0,0
"Uganda","2024-08-13",0,0,4,0,0,5,0,0
"Uganda","2024-08-14",0,0,4,0,1,6,0,0
"Uganda","2024-08-15",0,0,4,0,1,7,0,0
"Uganda","2024-08-16",0,0,4,0,1,8,0,0
"Uganda","2024-08-17",0,0,4,0,0,8,0,0
"Uganda","2024-08-18",0,5,9,0,1,9,0,0
"Uganda","2024-08-19",0,0,9,0,0,9,0,0
"Uganda","2024-08-20",0,0,9,0,1,10,0,0
"Uganda","2024-08-21",0,0,9,0,0,10,0,0
"Uganda","2024-08-22",0,0,9,0,1,11,0,0
"Uganda","2024-08-23",0,0,9,0,0,11,0,0
"Uganda","2024-08-24",0,0,9,0,1,12,0,0
"Uganda","2024-08-25",0,3,12,0,0,12,0,0
"Uganda","2024-08-26",0,0,12,0,1,13,0,0
"Uganda","2024-08-27",0,0,12,0,0,13,0,0
"Uganda","2024-08-28",0,0,12,0,1,14,0,0
"Uganda","2024-08-29",0,0,12,0,0,14,0,0
"Uganda","2024-08-30",0,0,12,0,1,15,0,0
"Uganda","2024-08-31",0,0,12,0,0,15,0,0
"Uganda","2024-09-01",0,4,16,0,1,16,0,0
"Uganda","2024-09-02",0,0,16,0,1,17,0,0
"Uganda","2024-09-03",0,0,16,0,2,19,0,0
"Uganda","2024-09-04",0,0,16,0,1,20,0,0
"Uganda","2024-09-05",0,0,16,0,1,21,0,0
"Uganda","2024-09-06",0,0,16,0,1,22,0,0
"Uganda","2024-09-07",0,0,16,0,2,24,0,0
"Uganda","2024-09-08",0,9,25,0,1,25,0,0
"Uganda","2024-09-09",0,0,25,0,1,26,0,0
"Uganda","2024-09-10",0,0,25,0,1,27,0,0
"Uganda","2024-09-11",0,0,25,0,1,28,0,0
"Uganda","2024-09-12",0,0,25,0,2,30,0,0
"Uganda","2024-09-13",0,0,25,0,1,31,0,0
"Uganda","2024-09-14",0,0,25,0,1,32,0,0
"Uganda","2024-09-15",0,8,33,0,1,33,0,0
"Uganda","2024-09-16",0,0,33,0,3,36,0,0
"Uganda","2024-09-17",0,0,33,0,2,38,0,0
"Uganda","2024-09-18",0,0,33,0,3,41,0,0
"Uganda","2024-09-19",0,0,33,0,3,44,0,0
"Uganda","2024-09-20",0,0,33,0,3,47,0,0
"Uganda","2024-09-21",0,0,33,0,2,49,0,0
"Uganda","2024-09-22",0,19,52,0,3,52,0,0
"Uganda","2024-09-23",0,0,52,0,3,55,0,0
"Uganda","2024-09-24",0,0,52,0,3,58,0,0
"Uganda","2024-09-25",0,0,52,0,3,61,0,0
"Uganda","2024-09-26",0,0,52,0,2,63,0,0
"Uganda","2024-09-27",0,0,52,0,3,66,0,0
"Uganda","2024-09-28",0,0,52,0,3,69,0,0
"Uganda","2024-09-29",0,20,72,0,3,72,0,0
"Uganda","2024-09-30",0,0,72,0,5,77,0,0
"Uganda","2024-10-01",0,0,72,0,6,83,0,0
"Uganda","2024-10-02",0,0,72,0,5,88,0,0
"Uganda","2024-10-03",0,0,72,0,5,93,0,0
"Uganda","2024-10-04",0,0,72,0,5,98,0,0
"Uganda","2024-10-05",0,0,72,0,6,104,0,0
"Uganda","2024-10-06",0,37,109,0,5,109,0,0
"Uganda","2024-10-07",0,0,109,0,6,115,0,0
"Uganda","2024-10-08",0,0,109,0,5,120,0,0
"Uganda","2024-10-09",0,0,109,0,6,126,0,0
"Uganda","2024-10-10",0,0,109,0,6,132,0,0
"Uganda","2024-10-11",0,0,109,0,6,138,0,0
"Uganda","2024-10-12",0,0,109,0,5,143,0,0
"Uganda","2024-10-13",0,40,149,0,6,149,0,0
"Uganda","2024-10-14",0,0,149,0,6,155,0,0
"Uganda","2024-10-15",0,0,149,0,6,161,0,0
"Uganda","2024-10-16",0,0,149,0,6,167,0,0
"Uganda","2024-10-17",0,0,149,0,5,172,0,0
"Uganda","2024-10-18",0,0,149,0,6,178,0,0
"Uganda","2024-10-19",0,0,149,0,6,184,0,0
"Uganda","2024-10-20",0,41,190,0,6,190,0,0
"Uganda","2024-10-21",0,0,190,0,18,208,0,0
"Uganda","2024-10-22",0,0,190,0,19,227,0,0
"Uganda","2024-10-23",0,0,190,0,18,245,0,0
"Uganda","2024-10-24",0,0,190,0,18,263,0,0
"Uganda","2024-10-25",0,0,190,0,18,281,0,0
"Uganda","2024-10-26",0,0,190,0,19,300,0,0
"Uganda","2024-10-27",0,128,318,0,18,318,0,0
"Uganda","2024-10-28",0,0,318,0,11,329,0,0
"Uganda","2024-10-29",0,0,318,0,12,341,0,0
"Uganda","2024-10-30",0,0,318,0,11,352,0,0
"Uganda","2024-10-31",0,0,318,0,12,364,0,0
"Uganda","2024-11-01",0,0,318,0,11,375,0,0
"Uganda","2024-11-02",0,0,318,0,12,387,0,0
"Uganda","2024-11-03",0,80,398,0,11,398,0,0
"Uganda","2024-11-04",0,0,398,0,14,412,0,0
"Uganda","2024-11-05",0,0,398,0,15,427,0,0
"Uganda","2024-11-06",0,0,398,0,14,441,0,0
"Uganda","2024-11-07",0,0,398,0,15,456,0,0
"Uganda","2024-11-08",0,0,398,0,14,470,0,0
"Uganda","2024-11-09",0,0,398,0,15,485,0,0
"Uganda","2024-11-10",0,101,499,0,14,499,0,0
"Uganda","2024-11-11",0,0,499,0,20,519,0,0
"Uganda","2024-11-12",0,0,499,0,20,539,0,0
"Uganda","2024-11-13",0,0,499,0,20,559,0,0
"Uganda","2024-11-14",0,0,499,0,19,578,0,0
"Uganda","2024-11-15",0,0,499,0,20,598,0,0
"Uganda","2024-11-16",0,0,499,0,20,618,0,0
"Uganda","2024-11-17",0,139,638,0,20,638,0,0
"Uganda","2024-11-18",0,0,638,0,21,659,0,0
"Uganda","2024-11-19",0,0,638,0,20,679,0,0
"Uganda","2024-11-20",0,0,638,0,21,700,0,0
"Uganda","2024-11-21",0,0,638,0,20,720,0,0
"Uganda","2024-11-22",0,0,638,0,21,741,0,0
"Uganda","2024-11-23",0,0,638,0,20,761,0,0
"Uganda","2024-11-24",0,144,782,0,21,782,0,0
"Uganda","2024-11-25",0,0,782,0,11,793,0,0
"Uganda","2024-11-26",0,0,782,0,12,805,0,0
"Uganda","2024-11-27",0,0,782,0,11,816,0,0
"Uganda","2024-11-28",0,0,782,0,12,828,0,0
"Uganda","2024-11-29",0,0,782,0,11,839,0,0
"Uganda","2024-11-30",0,0,782,0,12,851,0,0
"Uganda","2024-12-01",0,80,862,0,11,862,0,0
"Uganda","2024-12-02",0,0,862,0,26,888,0,0
"Uganda","2024-12-03",0,0,862,0,27,915,0,0
"Uganda","2024-12-04",0,0,862,0,26,941,0,0
"Uganda","2024-12-05",0,0,862,0,27,968,0,0
"Uganda","2024-12-06",0,0,862,0,26,994,0,0
"Uganda","2024-12-07",0,0,862,0,27,1021,0,0
"Uganda","2024-12-08",0,185,1047,0,26,1047,0,0
"Uganda","2024-12-09",0,0,1047,0,20,1067,0,0
"Uganda","2024-12-10",0,0,1047,0,19,1086,0,0
"Uganda","2024-12-11",0,0,1047,0,20,1106,0,0
"Uganda","2024-12-12",0,0,1047,0,19,1125,0,0
"Uganda","2024-12-13",0,0,1047,0,20,1145,0,0
"Uganda","2024-12-14",0,0,1047,0,19,1164,0,0
"Uganda","2024-12-15",0,137,1184,0,20,1184,0,0
"Uganda","2024-12-16",0,0,1184,0,23,1207,0,0
"Uganda","2024-12-17",0,0,1184,0,22,1229,0,0
"Uganda","2024-12-18",0,0,1184,0,23,1252,0,0
"Uganda","2024-12-19",0,0,1184,0,23,1275,0,0
"Uganda","2024-12-20",0,0,1184,0,23,1298,0,0
"Uganda","2024-12-21",0,0,1184,0,22,1320,0,0
"Uganda","2024-12-22",0,159,1343,0,23,1343,0,0
"Uganda","2024-12-23",0,0,1343,0,22,1365,0,0
"Uganda","2024-12-24",0,0,1343,0,22,1387,0,0
"Uganda","2024-12-25",0,0,1343,0,22,1409,0,0
"Uganda","2024-12-26",0,0,1343,0,21,1430,0,0
"Uganda","2024-12-27",0,0,1343,0,22,1452,0,0
"Uganda","2024-12-28",0,0,1343,0,22,1474,0,0
"Uganda","2024-12-29",0,153,1496,0,22,1496,0,0
"Uganda","2024-12-30",0,0,1496,0,29,1525,0,0
"Uganda","2024-12-31",0,0,1496,0,30,1555,0,0
"Uganda","2025-01-01",0,0,1496,0,29,1584,0,0
"Uganda","2025-01-02",0,0,1496,0,30,1614,0,0
"Uganda","2025-01-03",0,0,1496,0,29,1643,0,0
"Uganda","2025-01-04",0,0,1496,0,30,1673,0,0
"Uganda","2025-01-05",0,206,1702,0,29,1702,0,0
"Uganda","2025-01-06",0,0,1702,0,40,1742,0,0
"Uganda","2025-01-07",0,0,1702,0,39,1781,0,0
"Uganda","2025-01-08",0,0,1702,0,40,1821,0,0
"Uganda","2025-01-09",0,0,1702,0,40,1861,0,0
"Uganda","2025-01-10",0,0,1702,0,40,1901,0,0
"Uganda","2025-01-11",0,0,1702,0,39,1940,0,0
"Uganda","2025-01-12",0,278,1980,0,40,1980,0,0
"Uganda","2025-01-13",0,0,1980,0,13,1993,0,0
"Uganda","2025-01-14",0,0,1980,0,13,2006,0,0
"Uganda","2025-01-15",0,0,1980,0,12,2018,0,0
"Uganda","2025-01-16",0,51,2031,0,13,2031,0,0
"Uganda","2025-01-17",0,0,2031,0,0,2031,0,0
"Uganda","2025-01-18",0,0,2031,0,0,2031,0,0
"Uganda","2025-01-19",0,0,2031,0,0,2031,0,0
"Uganda","2025-01-20",0,0,2031,0,0,2031,0,0
"Uganda","2025-01-21",0,0,2031,0,0,2031,0,0
"Uganda","2025-01-22",0,0,2031,0,0,2031,0,0
"Uganda","2025-01-23",0,0,2031,0,0,2031,0,0
"Uganda","2025-01-24",0,0,2031,0,0,2031,0,0
"Uganda","2025-01-25",0,0,2031,0,0,2031,0,0
"Uganda","2025-01-26",0,0,2031,0,0,2031,0,0
"Uganda","2025-01-27",0,0,2031,0,0,2031,0,0
"Uganda","2025-01-28",0,0,2031,0,0,2031,0,0
"Uganda","2025-01-29",0,0,2031,0,0,2031,0,0
"Uganda","2025-01-30",0,0,2031,0,0,2031,0,0
"Uganda","2025-01-31",0,0,2031,0,0,2031,0,0
"Uganda","2025-02-01",0,0,2031,0,0,2031,0,0
"Uganda","2025-02-02",0,0,2031,0,0,2031,0,0
"Uganda","2025-02-03",0,0,2031,0,0,2031,0,0
"Ukraine","2024-01-01",0,0,0,0,0,0,0,0
"Ukraine","2024-01-02",0,0,0,0,0,0,0,0
"Ukraine","2024-01-03",0,0,0,0,0,0,0,0
"Ukraine","2024-01-04",0,0,0,0,0,0,0,0
"Ukraine","2024-01-05",0,0,0,0,0,0,0,0
"Ukraine","2024-01-06",0,0,0,0,0,0,0,0
"Ukraine","2024-01-07",0,0,0,0,0,0,0,0
"Ukraine","2024-01-08",0,0,0,0,0,0,0,0
"Ukraine","2024-01-09",0,0,0,0,0,0,0,0
"Ukraine","2024-01-10",0,0,0,0,0,0,0,0
"Ukraine","2024-01-11",0,0,0,0,0,0,0,0
"Ukraine","2024-01-12",0,0,0,0,0,0,0,0
"Ukraine","2024-01-13",0,0,0,0,0,0,0,0
"Ukraine","2024-01-14",0,0,0,0,0,0,0,0
"Ukraine","2024-01-15",0,0,0,0,0,0,0,0
"Ukraine","2024-01-16",0,0,0,0,0,0,0,0
"Ukraine","2024-01-17",0,0,0,0,0,0,0,0
"Ukraine","2024-01-18",0,0,0,0,0,0,0,0
"Ukraine","2024-01-19",0,0,0,0,0,0,0,0
"Ukraine","2024-01-20",0,0,0,0,0,0,0,0
"Ukraine","2024-01-21",0,0,0,0,0,0,0,0
"Ukraine","2024-01-22",0,0,0,0,0,0,0,0
"Ukraine","2024-01-23",0,0,0,0,0,0,0,0
"Ukraine","2024-01-24",0,0,0,0,0,0,0,0
"Ukraine","2024-01-25",0,0,0,0,0,0,0,0
"Ukraine","2024-01-26",0,0,0,0,0,0,0,0
"Ukraine","2024-01-27",0,0,0,0,0,0,0,0
"Ukraine","2024-01-28",0,0,0,0,0,0,0,0
"Ukraine","2024-01-29",0,0,0,0,0,0,0,0
"Ukraine","2024-01-30",0,0,0,0,0,0,0,0
"Ukraine","2024-01-31",0,0,0,0,0,0,0,0
"Ukraine","2024-02-01",0,0,0,0,0,0,0,0
"Ukraine","2024-02-02",0,0,0,0,0,0,0,0
"Ukraine","2024-02-03",0,0,0,0,0,0,0,0
"Ukraine","2024-02-04",0,0,0,0,0,0,0,0
"Ukraine","2024-02-05",0,0,0,0,0,0,0,0
"Ukraine","2024-02-06",0,0,0,0,0,0,0,0
"Ukraine","2024-02-07",0,0,0,0,0,0,0,0
"Ukraine","2024-02-08",0,0,0,0,0,0,0,0
"Ukraine","2024-02-09",0,0,0,0,0,0,0,0
"Ukraine","2024-02-10",0,0,0,0,0,0,0,0
"Ukraine","2024-02-11",0,0,0,0,0,0,0,0
"Ukraine","2024-02-12",0,0,0,0,0,0,0,0
"Ukraine","2024-02-13",0,0,0,0,0,0,0,0
"Ukraine","2024-02-14",0,0,0,0,0,0,0,0
"Ukraine","2024-02-15",0,0,0,0,0,0,0,0
"Ukraine","2024-02-16",0,0,0,0,0,0,0,0
"Ukraine","2024-02-17",0,0,0,0,0,0,0,0
"Ukraine","2024-02-18",0,0,0,0,0,0,0,0
"Ukraine","2024-02-19",0,0,0,0,0,0,0,0
"Ukraine","2024-02-20",0,0,0,0,0,0,0,0
"Ukraine","2024-02-21",0,0,0,0,0,0,0,0
"Ukraine","2024-02-22",0,0,0,0,0,0,0,0
"Ukraine","2024-02-23",0,0,0,0,0,0,0,0
"Ukraine","2024-02-24",0,0,0,0,0,0,0,0
"Ukraine","2024-02-25",0,0,0,0,0,0,0,0
"Ukraine","2024-02-26",0,0,0,0,0,0,0,0
"Ukraine","2024-02-27",0,0,0,0,0,0,0,0
"Ukraine","2024-02-28",0,0,0,0,0,0,0,0
"Ukraine","2024-02-29",0,0,0,0,0,0,0,0
"Ukraine","2024-03-01",0,0,0,0,0,0,0,0
"Ukraine","2024-03-02",0,0,0,0,0,0,0,0
"Ukraine","2024-03-03",0,0,0,0,0,0,0,0
"Ukraine","2024-03-04",0,0,0,0,0,0,0,0
"Ukraine","2024-03-05",0,0,0,0,0,0,0,0
"Ukraine","2024-03-06",0,0,0,0,0,0,0,0
"Ukraine","2024-03-07",0,0,0,0,0,0,0,0
"Ukraine","2024-03-08",0,0,0,0,0,0,0,0
"Ukraine","2024-03-09",0,0,0,0,0,0,0,0
"Ukraine","2024-03-10",0,0,0,0,0,0,0,0
"Ukraine","2024-03-11",0,0,0,0,0,0,0,0
"Ukraine","2024-03-12",0,0,0,0,0,0,0,0
"Ukraine","2024-03-13",0,0,0,0,0,0,0,0
"Ukraine","2024-03-14",0,0,0,0,0,0,0,0
"Ukraine","2024-03-15",0,0,0,0,0,0,0,0
"Ukraine","2024-03-16",0,0,0,0,0,0,0,0
"Ukraine","2024-03-17",0,0,0,0,0,0,0,0
"Ukraine","2024-03-18",0,0,0,0,0,0,0,0
"Ukraine","2024-03-19",0,0,0,0,0,0,0,0
"Ukraine","2024-03-20",0,0,0,0,0,0,0,0
"Ukraine","2024-03-21",0,0,0,0,0,0,0,0
"Ukraine","2024-03-22",0,0,0,0,0,0,0,0
"Ukraine","2024-03-23",0,0,0,0,0,0,0,0
"Ukraine","2024-03-24",0,0,0,0,0,0,0,0
"Ukraine","2024-03-25",0,0,0,0,0,0,0,0
"Ukraine","2024-03-26",0,0,0,0,0,0,0,0
"Ukraine","2024-03-27",0,0,0,0,0,0,0,0
"Ukraine","2024-03-28",0,0,0,0,0,0,0,0
"Ukraine","2024-03-29",0,0,0,0,0,0,0,0
"Ukraine","2024-03-30",0,0,0,0,0,0,0,0
"Ukraine","2024-03-31",0,0,0,0,0,0,0,0
"Ukraine","2024-04-01",0,0,0,0,0,0,0,0
"Ukraine","2024-04-02",0,0,0,0,0,0,0,0
"Ukraine","2024-04-03",0,0,0,0,0,0,0,0
"Ukraine","2024-04-04",0,0,0,0,0,0,0,0
"Ukraine","2024-04-05",0,0,0,0,0,0,0,0
"Ukraine","2024-04-06",0,0,0,0,0,0,0,0
"Ukraine","2024-04-07",0,0,0,0,0,0,0,0
"Ukraine","2024-04-08",0,0,0,0,0,0,0,0
"Ukraine","2024-04-09",0,0,0,0,0,0,0,0
"Ukraine","2024-04-10",0,0,0,0,0,0,0,0
"Ukraine","2024-04-11",0,0,0,0,0,0,0,0
"Ukraine","2024-04-12",0,0,0,0,0,0,0,0
"Ukraine","2024-04-13",0,0,0,0,0,0,0,0
"Ukraine","2024-04-14",0,0,0,0,0,0,0,0
"Ukraine","2024-04-15",0,0,0,0,0,0,0,0
"Ukraine","2024-04-16",0,0,0,0,0,0,0,0
"Ukraine","2024-04-17",0,0,0,0,0,0,0,0
"Ukraine","2024-04-18",0,0,0,0,0,0,0,0
"Ukraine","2024-04-19",0,0,0,0,0,0,0,0
"Ukraine","2024-04-20",0,0,0,0,0,0,0,0
"Ukraine","2024-04-21",0,0,0,0,0,0,0,0
"Ukraine","2024-04-22",0,0,0,0,0,0,0,0
"Ukraine","2024-04-23",0,0,0,0,0,0,0,0
"Ukraine","2024-04-24",0,0,0,0,0,0,0,0
"Ukraine","2024-04-25",0,0,0,0,0,0,0,0
"Ukraine","2024-04-26",0,0,0,0,0,0,0,0
"Ukraine","2024-04-27",0,0,0,0,0,0,0,0
"Ukraine","2024-04-28",0,0,0,0,0,0,0,0
"Ukraine","2024-04-29",0,0,0,0,0,0,0,0
"Ukraine","2024-04-30",0,0,0,0,0,0,0,0
"Ukraine","2024-05-01",0,0,0,0,0,0,0,0
"Ukraine","2024-05-02",0,0,0,0,0,0,0,0
"Ukraine","2024-05-03",0,0,0,0,0,0,0,0
"Ukraine","2024-05-04",0,0,0,0,0,0,0,0
"Ukraine","2024-05-05",0,0,0,0,0,0,0,0
"Ukraine","2024-05-06",0,0,0,0,0,0,0,0
"Ukraine","2024-05-07",0,0,0,0,0,0,0,0
"Ukraine","2024-05-08",0,0,0,0,0,0,0,0
"Ukraine","2024-05-09",0,0,0,0,0,0,0,0
"Ukraine","2024-05-10",0,0,0,0,0,0,0,0
"Ukraine","2024-05-11",0,0,0,0,0,0,0,0
"Ukraine","2024-05-12",0,0,0,0,0,0,0,0
"Ukraine","2024-05-13",0,0,0,0,0,0,0,0
"Ukraine","2024-05-14",0,0,0,0,0,0,0,0
"Ukraine","2024-05-15",0,0,0,0,0,0,0,0
"Ukraine","2024-05-16",0,0,0,0,0,0,0,0
"Ukraine","2024-05-17",0,0,0,0,0,0,0,0
"Ukraine","2024-05-18",0,0,0,0,0,0,0,0
"Ukraine","2024-05-19",0,0,0,0,0,0,0,0
"Ukraine","2024-05-20",0,0,0,0,0,0,0,0
"Ukraine","2024-05-21",0,0,0,0,0,0,0,0
"Ukraine","2024-05-22",0,0,0,0,0,0,0,0
"Ukraine","2024-05-23",0,0,0,0,0,0,0,0
"Ukraine","2024-05-24",0,0,0,0,0,0,0,0
"Ukraine","2024-05-25",0,0,0,0,0,0,0,0
"Ukraine","2024-05-26",0,0,0,0,0,0,0,0
"Ukraine","2024-05-27",0,0,0,0,0,0,0,0
"Ukraine","2024-05-28",0,0,0,0,0,0,0,0
"Ukraine","2024-05-29",0,0,0,0,0,0,0,0
"Ukraine","2024-05-30",0,0,0,0,0,0,0,0
"Ukraine","2024-05-31",0,0,0,0,0,0,0,0
"Ukraine","2024-06-01",0,0,0,0,0,0,0,0
"Ukraine","2024-06-02",0,0,0,0,0,0,0,0
"Ukraine","2024-06-03",0,0,0,0,0,0,0,0
"Ukraine","2024-06-04",0,0,0,0,0,0,0,0
"Ukraine","2024-06-05",0,0,0,0,0,0,0,0
"Ukraine","2024-06-06",0,0,0,0,0,0,0,0
"Ukraine","2024-06-07",0,0,0,0,0,0,0,0
"Ukraine","2024-06-08",0,0,0,0,0,0,0,0
"Ukraine","2024-06-09",0,0,0,0,0,0,0,0
"Ukraine","2024-06-10",0,0,0,0,0,0,0,0
"Ukraine","2024-06-11",0,0,0,0,0,0,0,0
"Ukraine","2024-06-12",0,0,0,0,0,0,0,0
"Ukraine","2024-06-13",0,0,0,0,0,0,0,0
"Ukraine","2024-06-14",0,0,0,0,0,0,0,0
"Ukraine","2024-06-15",0,0,0,0,0,0,0,0
"Ukraine","2024-06-16",0,0,0,0,0,0,0,0
"Ukraine","2024-06-17",0,0,0,0,0,0,0,0
"Ukraine","2024-06-18",0,0,0,0,0,0,0,0
"Ukraine","2024-06-19",0,0,0,0,0,0,0,0
"Ukraine","2024-06-20",0,0,0,0,0,0,0,0
"Ukraine","2024-06-21",0,0,0,0,0,0,0,0
"Ukraine","2024-06-22",0,0,0,0,0,0,0,0
"Ukraine","2024-06-23",0,0,0,0,0,0,0,0
"Ukraine","2024-06-24",0,0,0,0,0,0,0,0
"Ukraine","2024-06-25",0,0,0,0,0,0,0,0
"Ukraine","2024-06-26",0,0,0,0,0,0,0,0
"Ukraine","2024-06-27",0,0,0,0,0,0,0,0
"Ukraine","2024-06-28",0,0,0,0,0,0,0,0
"Ukraine","2024-06-29",0,0,0,0,0,0,0,0
"Ukraine","2024-06-30",0,0,0,0,0,0,0,0
"Ukraine","2024-07-01",0,0,0,0,0,0,0,0
"Ukraine","2024-07-02",0,0,0,0,0,0,0,0
"Ukraine","2024-07-03",0,0,0,0,0,0,0,0
"Ukraine","2024-07-04",0,0,0,0,0,0,0,0
"Ukraine","2024-07-05",0,0,0,0,0,0,0,0
"Ukraine","2024-07-06",0,0,0,0,0,0,0,0
"Ukraine","2024-07-07",0,0,0,0,0,0,0,0
"Ukraine","2024-07-08",0,0,0,0,0,0,0,0
"Ukraine","2024-07-09",0,0,0,0,0,0,0,0
"Ukraine","2024-07-10",0,0,0,0,0,0,0,0
"Ukraine","2024-07-11",0,0,0,0,0,0,0,0
"Ukraine","2024-07-12",0,0,0,0,0,0,0,0
"Ukraine","2024-07-13",0,0,0,0,0,0,0,0
"Ukraine","2024-07-14",0,0,0,0,0,0,0,0
"Ukraine","2024-07-15",0,0,0,0,0,0,0,0
"Ukraine","2024-07-16",0,0,0,0,0,0,0,0
"Ukraine","2024-07-17",0,0,0,0,0,0,0,0
"Ukraine","2024-07-18",0,0,0,0,0,0,0,0
"Ukraine","2024-07-19",0,0,0,0,0,0,0,0
"Ukraine","2024-07-20",0,0,0,0,0,0,0,0
"Ukraine","2024-07-21",0,0,0,0,0,0,0,0
"Ukraine","2024-07-22",0,0,0,0,0,0,0,0
"Ukraine","2024-07-23",0,0,0,0,0,0,0,0
"Ukraine","2024-07-24",0,0,0,0,0,0,0,0
"Ukraine","2024-07-25",0,0,0,0,0,0,0,0
"Ukraine","2024-07-26",0,0,0,0,0,0,0,0
"Ukraine","2024-07-27",0,0,0,0,0,0,0,0
"Ukraine","2024-07-28",0,0,0,0,0,0,0,0
"Ukraine","2024-07-29",0,0,0,0,0,0,0,0
"Ukraine","2024-07-30",0,0,0,0,0,0,0,0
"Ukraine","2024-07-31",0,0,0,0,0,0,0,0
"Ukraine","2024-08-01",0,0,0,0,0,0,0,0
"Ukraine","2024-08-02",0,0,0,0,0,0,0,0
"Ukraine","2024-08-03",0,0,0,0,0,0,0,0
"Ukraine","2024-08-04",0,0,0,0,0,0,0,0
"Ukraine","2024-08-05",0,0,0,0,0,0,0,0
"Ukraine","2024-08-06",0,0,0,0,0,0,0,0
"Ukraine","2024-08-07",0,0,0,0,0,0,0,0
"Ukraine","2024-08-08",0,0,0,0,0,0,0,0
"Ukraine","2024-08-09",0,0,0,0,0,0,0,0
"Ukraine","2024-08-10",0,0,0,0,0,0,0,0
"Ukraine","2024-08-11",0,0,0,0,0,0,0,0
"Ukraine","2024-08-12",0,0,0,0,0,0,0,0
"Ukraine","2024-08-13",0,0,0,0,0,0,0,0
"Ukraine","2024-08-14",0,0,0,0,0,0,0,0
"Ukraine","2024-08-15",0,0,0,0,0,0,0,0
"Ukraine","2024-08-16",0,0,0,0,0,0,0,0
"Ukraine","2024-08-17",0,0,0,0,0,0,0,0
"Ukraine","2024-08-18",0,0,0,0,0,0,0,0
"Ukraine","2024-08-19",0,0,0,0,0,0,0,0
"Ukraine","2024-08-20",0,0,0,0,0,0,0,0
"Ukraine","2024-08-21",0,0,0,0,0,0,0,0
"Ukraine","2024-08-22",0,0,0,0,0,0,0,0
"Ukraine","2024-08-23",0,0,0,0,0,0,0,0
"Ukraine","2024-08-24",0,0,0,0,0,0,0,0
"Ukraine","2024-08-25",0,0,0,0,0,0,0,0
"Ukraine","2024-08-26",0,0,0,0,0,0,0,0
"Ukraine","2024-08-27",0,0,0,0,0,0,0,0
"Ukraine","2024-08-28",0,0,0,0,0,0,0,0
"Ukraine","2024-08-29",0,0,0,0,0,0,0,0
"Ukraine","2024-08-30",0,0,0,0,0,0,0,0
"Ukraine","2024-08-31",0,0,0,0,0,0,0,0
"Ukraine","2024-09-01",0,0,0,0,0,0,0,0
"Ukraine","2024-09-02",0,0,0,0,0,0,0,0
"Ukraine","2024-09-03",0,0,0,0,0,0,0,0
"Ukraine","2024-09-04",0,0,0,0,0,0,0,0
"Ukraine","2024-09-05",0,0,0,0,0,0,0,0
"Ukraine","2024-09-06",0,0,0,0,0,0,0,0
"Ukraine","2024-09-07",0,0,0,0,0,0,0,0
"Ukraine","2024-09-08",0,0,0,0,0,0,0,0
"Ukraine","2024-09-09",0,0,0,0,0,0,0,0
"Ukraine","2024-09-10",0,0,0,0,0,0,0,0
"Ukraine","2024-09-11",0,0,0,0,0,0,0,0
"Ukraine","2024-09-12",0,0,0,0,0,0,0,0
"Ukraine","2024-09-13",0,0,0,0,0,0,0,0
"Ukraine","2024-09-14",0,0,0,0,0,0,0,0
"Ukraine","2024-09-15",0,0,0,0,0,0,0,0
"Ukraine","2024-09-16",0,0,0,0,0,0,0,0
"Ukraine","2024-09-17",0,0,0,0,0,0,0,0
"Ukraine","2024-09-18",0,0,0,0,0,0,0,0
"Ukraine","2024-09-19",0,0,0,0,0,0,0,0
"Ukraine","2024-09-20",0,0,0,0,0,0,0,0
"Ukraine","2024-09-21",0,0,0,0,0,0,0,0
"Ukraine","2024-09-22",0,0,0,0,0,0,0,0
"Ukraine","2024-09-23",0,0,0,0,0,0,0,0
"Ukraine","2024-09-24",0,0,0,0,0,0,0,0
"Ukraine","2024-09-25",0,0,0,0,0,0,0,0
"Ukraine","2024-09-26",0,0,0,0,0,0,0,0
"Ukraine","2024-09-27",0,0,0,0,0,0,0,0
"Ukraine","2024-09-28",0,0,0,0,0,0,0,0
"Ukraine","2024-09-29",0,0,0,0,0,0,0,0
"Ukraine","2024-09-30",0,0,0,0,0,0,0,0
"Ukraine","2024-10-01",0,0,0,0,0,0,0,0
"Ukraine","2024-10-02",0,0,0,0,0,0,0,0
"Ukraine","2024-10-03",0,0,0,0,0,0,0,0
"Ukraine","2024-10-04",0,0,0,0,0,0,0,0
"Ukraine","2024-10-05",0,0,0,0,0,0,0,0
"Ukraine","2024-10-06",0,0,0,0,0,0,0,0
"Ukraine","2024-10-07",0,0,0,0,0,0,0,0
"Ukraine","2024-10-08",0,0,0,0,0,0,0,0
"Ukraine","2024-10-09",0,0,0,0,0,0,0,0
"Ukraine","2024-10-10",0,0,0,0,0,0,0,0
"Ukraine","2024-10-11",0,0,0,0,0,0,0,0
"Ukraine","2024-10-12",0,0,0,0,0,0,0,0
"Ukraine","2024-10-13",0,0,0,0,0,0,0,0
"Ukraine","2024-10-14",0,0,0,0,0,0,0,0
"Ukraine","2024-10-15",0,0,0,0,0,0,0,0
"Ukraine","2024-10-16",0,0,0,0,0,0,0,0
"Ukraine","2024-10-17",0,0,0,0,0,0,0,0
"Ukraine","2024-10-18",0,0,0,0,0,0,0,0
"Ukraine","2024-10-19",0,0,0,0,0,0,0,0
"Ukraine","2024-10-20",0,0,0,0,0,0,0,0
"Ukraine","2024-10-21",0,0,0,0,0,0,0,0
"Ukraine","2024-10-22",0,0,0,0,0,0,0,0
"Ukraine","2024-10-23",0,0,0,0,0,0,0,0
"Ukraine","2024-10-24",0,0,0,0,0,0,0,0
"Ukraine","2024-10-25",0,0,0,0,0,0,0,0
"Ukraine","2024-10-26",0,0,0,0,0,0,0,0
"Ukraine","2024-10-27",0,0,0,0,0,0,0,0
"Ukraine","2024-10-28",0,0,0,0,0,0,0,0
"Ukraine","2024-10-29",0,0,0,0,0,0,0,0
"Ukraine","2024-10-30",0,0,0,0,0,0,0,0
"Ukraine","2024-10-31",0,0,0,0,0,0,0,0
"Ukraine","2024-11-01",0,0,0,0,0,0,0,0
"Ukraine","2024-11-02",0,0,0,0,0,0,0,0
"Ukraine","2024-11-03",0,0,0,0,0,0,0,0
"Ukraine","2024-11-04",0,0,0,0,0,0,0,0
"Ukraine","2024-11-05",0,0,0,0,0,0,0,0
"Ukraine","2024-11-06",0,0,0,0,0,0,0,0
"Ukraine","2024-11-07",0,0,0,0,0,0,0,0
"Ukraine","2024-11-08",0,0,0,0,0,0,0,0
"Ukraine","2024-11-09",0,0,0,0,0,0,0,0
"Ukraine","2024-11-10",0,0,0,0,0,0,0,0
"Ukraine","2024-11-11",0,0,0,0,0,0,0,0
"Ukraine","2024-11-12",0,0,0,0,0,0,0,0
"Ukraine","2024-11-13",0,0,0,0,0,0,0,0
"Ukraine","2024-11-14",0,0,0,0,0,0,0,0
"Ukraine","2024-11-15",0,0,0,0,0,0,0,0
"Ukraine","2024-11-16",0,0,0,0,0,0,0,0
"Ukraine","2024-11-17",0,0,0,0,0,0,0,0
"Ukraine","2024-11-18",0,0,0,0,0,0,0,0
"Ukraine","2024-11-19",0,0,0,0,0,0,0,0
"Ukraine","2024-11-20",0,0,0,0,0,0,0,0
"Ukraine","2024-11-21",0,0,0,0,0,0,0,0
"Ukraine","2024-11-22",0,0,0,0,0,0,0,0
"Ukraine","2024-11-23",0,0,0,0,0,0,0,0
"Ukraine","2024-11-24",0,0,0,0,0,0,0,0
"Ukraine","2024-11-25",0,0,0,0,0,0,0,0
"Ukraine","2024-11-26",0,0,0,0,0,0,0,0
"Ukraine","2024-11-27",0,0,0,0,0,0,0,0
"Ukraine","2024-11-28",0,0,0,0,0,0,0,0
"Ukraine","2024-11-29",0,0,0,0,0,0,0,0
"Ukraine","2024-11-30",0,0,0,0,0,0,0,0
"Ukraine","2024-12-01",0,0,0,0,0,0,0,0
"Ukraine","2024-12-02",0,0,0,0,0,0,0,0
"Ukraine","2024-12-03",0,0,0,0,0,0,0,0
"Ukraine","2024-12-04",0,0,0,0,0,0,0,0
"Ukraine","2024-12-05",0,0,0,0,0,0,0,0
"Ukraine","2024-12-06",0,0,0,0,0,0,0,0
"Ukraine","2024-12-07",0,0,0,0,0,0,0,0
"Ukraine","2024-12-08",0,0,0,0,0,0,0,0
"Ukraine","2024-12-09",0,0,0,0,0,0,0,0
"Ukraine","2024-12-10",0,0,0,0,0,0,0,0
"Ukraine","2024-12-11",0,0,0,0,0,0,0,0
"Ukraine","2024-12-12",0,0,0,0,0,0,0,0
"Ukraine","2024-12-13",0,0,0,0,0,0,0,0
"Ukraine","2024-12-14",0,0,0,0,0,0,0,0
"Ukraine","2024-12-15",0,0,0,0,0,0,0,0
"Ukraine","2024-12-16",0,0,0,0,0,0,0,0
"Ukraine","2024-12-17",0,0,0,0,0,0,0,0
"Ukraine","2024-12-18",0,0,0,0,0,0,0,0
"Ukraine","2024-12-19",0,0,0,0,0,0,0,0
"Ukraine","2024-12-20",0,0,0,0,0,0,0,0
"Ukraine","2024-12-21",0,0,0,0,0,0,0,0
"Ukraine","2024-12-22",0,0,0,0,0,0,0,0
"Ukraine","2024-12-23",0,0,0,0,0,0,0,0
"Ukraine","2024-12-24",0,0,0,0,0,0,0,0
"Ukraine","2024-12-25",0,0,0,0,0,0,0,0
"Ukraine","2024-12-26",0,0,0,0,0,0,0,0
"Ukraine","2024-12-27",0,0,0,0,0,0,0,0
"Ukraine","2024-12-28",0,0,0,0,0,0,0,0
"Ukraine","2024-12-29",0,0,0,0,0,0,0,0
"Ukraine","2024-12-30",0,0,0,0,0,0,0,0
"Ukraine","2024-12-31",0,0,0,0,0,0,0,0
"Ukraine","2025-01-01",0,0,0,0,0,0,0,0
"Ukraine","2025-01-02",0,0,0,0,0,0,0,0
"Ukraine","2025-01-03",0,0,0,0,0,0,0,0
"Ukraine","2025-01-04",0,0,0,0,0,0,0,0
"Ukraine","2025-01-05",0,0,0,0,0,0,0,0
"Ukraine","2025-01-06",0,0,0,0,0,0,0,0
"Ukraine","2025-01-07",0,0,0,0,0,0,0,0
"Ukraine","2025-01-08",0,0,0,0,0,0,0,0
"Ukraine","2025-01-09",0,0,0,0,0,0,0,0
"Ukraine","2025-01-10",0,0,0,0,0,0,0,0
"Ukraine","2025-01-11",0,0,0,0,0,0,0,0
"Ukraine","2025-01-12",0,0,0,0,0,0,0,0
"Ukraine","2025-01-13",0,0,0,0,0,0,0,0
"Ukraine","2025-01-14",0,0,0,0,0,0,0,0
"Ukraine","2025-01-15",0,0,0,0,0,0,0,0
"Ukraine","2025-01-16",0,0,0,0,0,0,0,0
"Ukraine","2025-01-17",0,0,0,0,0,0,0,0
"Ukraine","2025-01-18",0,0,0,0,0,0,0,0
"Ukraine","2025-01-19",0,0,0,0,0,0,0,0
"Ukraine","2025-01-20",0,0,0,0,0,0,0,0
"Ukraine","2025-01-21",0,0,0,0,0,0,0,0
"Ukraine","2025-01-22",0,0,0,0,0,0,0,0
"Ukraine","2025-01-23",0,0,0,0,0,0,0,0
"Ukraine","2025-01-24",0,0,0,0,0,0,0,0
"Ukraine","2025-01-25",0,0,0,0,0,0,0,0
"Ukraine","2025-01-26",0,0,0,0,0,0,0,0
"Ukraine","2025-01-27",0,0,0,0,0,0,0,0
"Ukraine","2025-01-28",0,0,0,0,0,0,0,0
"Ukraine","2025-01-29",0,0,0,0,0,0,0,0
"Ukraine","2025-01-30",0,0,0,0,0,0,0,0
"Ukraine","2025-01-31",0,0,0,0,0,0,0,0
"Ukraine","2025-02-01",0,0,0,0,0,0,0,0
"Ukraine","2025-02-02",0,0,0,0,0,0,0,0
"Ukraine","2025-02-03",0,0,0,0,0,0,0,0
"United Arab Emirates","2024-01-01",0,0,0,0,0,0,0,0
"United Arab Emirates","2024-01-02",0,0,0,0,0,0,0,0
"United Arab Emirates","2024-01-03",0,0,0,0,0,0,0,0
"United Arab Emirates","2024-01-04",0,0,0,0,0,0,0,0
"United Arab Emirates","2024-01-05",0,0,0,0,0,0,0,0
"United Arab Emirates","2024-01-06",0,0,0,0,0,0,0,0
"United Arab Emirates","2024-01-07",0,0,0,0,0,0,0,0
"United Arab Emirates","2024-01-08",0,0,0,0,0,0,0,0
"United Arab Emirates","2024-01-09",0,0,0,0,0,0,0,0
"United Arab Emirates","2024-01-10",0,0,0,0,0,0,0,0
"United Arab Emirates","2024-01-11",0,1,1,0,1,1,0,0
"United Arab Emirates","2024-01-12",0,0,1,0,0,1,0,0
"United Arab Emirates","2024-01-13",0,0,1,0,0,1,0,0
"United Arab Emirates","2024-01-14",0,0,1,0,0,1,0,0
"United Arab Emirates","2024-01-15",0,0,1,0,0,1,0,0
"United Arab Emirates","2024-01-16",0,0,1,0,0,1,0,0
"United Arab Emirates","2024-01-17",0,0,1,0,0,1,0,0
"United Arab Emirates","2024-01-18",0,0,1,0,0,1,0,0
"United Arab Emirates","2024-01-19",0,0,1,0,0,1,0,0
"United Arab Emirates","2024-01-20",0,0,1,0,0,1,0,0
"United Arab Emirates","2024-01-21",0,0,1,0,0,1,0,0
"United Arab Emirates","2024-01-22",0,0,1,0,0,1,0,0
"United Arab Emirates","2024-01-23",0,0,1,0,0,1,0,0
"United Arab Emirates","2024-01-24",0,0,1,0,0,1,0,0
"United Arab Emirates","2024-01-25",0,0,1,0,0,1,0,0
"United Arab Emirates","2024-01-26",0,0,1,0,0,1,0,0
"United Arab Emirates","2024-01-27",0,0,1,0,0,1,0,0
"United Arab Emirates","2024-01-28",0,0,1,0,0,1,0,0
"United Arab Emirates","2024-01-29",0,0,1,0,0,1,0,0
"United Arab Emirates","2024-01-30",0,0,1,0,0,1,0,0
"United Arab Emirates","2024-01-31",0,0,1,0,0,1,0,0
"United Arab Emirates","2024-02-01",0,0,1,0,0,1,0,0
"United Arab Emirates","2024-02-02",0,0,1,0,0,1,0,0
"United Arab Emirates","2024-02-03",0,0,1,0,0,1,0,0
"United Arab Emirates","2024-02-04",0,0,1,0,0,1,0,0
"United Arab Emirates","2024-02-05",0,0,1,0,0,1,0,0
"United Arab Emirates","2024-02-06",0,0,1,0,1,2,0,0
"United Arab Emirates","2024-02-07",0,0,1,0,0,2,0,0
"United Arab Emirates","2024-02-08",0,0,1,0,0,2,0,0
"United Arab Emirates","2024-02-09",0,0,1,0,0,2,0,0
"United Arab Emirates","2024-02-10",0,0,1,0,0,2,0,0
"United Arab Emirates","2024-02-11",0,0,1,0,0,2,0,0
"United Arab Emirates","2024-02-12",0,0,1,0,0,2,0,0
"United Arab Emirates","2024-02-13",0,0,1,0,0,2,0,0
"United Arab Emirates","2024-02-14",0,0,1,0,0,2,0,0
"United Arab Emirates","2024-02-15",0,0,1,0,0,2,0,0
"United Arab Emirates","2024-02-16",0,0,1,0,0,2,0,0
"United Arab Emirates","2024-02-17",0,0,1,0,0,2,0,0
"United Arab Emirates","2024-02-18",0,0,1,0,0,2,0,0
"United Arab Emirates","2024-02-19",0,0,1,0,0,2,0,0
"United Arab Emirates","2024-02-20",0,0,1,0,0,2,0,0
"United Arab Emirates","2024-02-21",0,0,1,0,0,2,0,0
"United Arab Emirates","2024-02-22",0,0,1,0,0,2,0,0
"United Arab Emirates","2024-02-23",0,0,1,0,0,2,0,0
"United Arab Emirates","2024-02-24",0,0,1,0,0,2,0,0
"United Arab Emirates","2024-02-25",0,0,1,0,0,2,0,0
"United Arab Emirates","2024-02-26",0,0,1,0,0,2,0,0
"United Arab Emirates","2024-02-27",0,0,1,0,0,2,0,0
"United Arab Emirates","2024-02-28",0,0,1,0,0,2,0,0
"United Arab Emirates","2024-02-29",0,0,1,0,0,2,0,0
"United Arab Emirates","2024-03-01",0,0,1,0,0,2,0,0
"United Arab Emirates","2024-03-02",0,1,2,0,0,2,0,0
"United Arab Emirates","2024-03-03",0,0,2,0,0,2,0,0
"United Arab Emirates","2024-03-04",0,0,2,0,0,2,0,0
"United Arab Emirates","2024-03-05",0,0,2,0,0,2,0,0
"United Arab Emirates","2024-03-06",0,0,2,0,0,2,0,0
"United Arab Emirates","2024-03-07",0,0,2,0,0,2,0,0
"United Arab Emirates","2024-03-08",0,0,2,0,0,2,0,0
"United Arab Emirates","2024-03-09",0,0,2,0,0,2,0,0
"United Arab Emirates","2024-03-10",0,0,2,0,0,2,0,0
"United Arab Emirates","2024-03-11",0,0,2,0,0,2,0,0
"United Arab Emirates","2024-03-12",0,0,2,0,0,2,0,0
"United Arab Emirates","2024-03-13",0,0,2,0,0,2,0,0
"United Arab Emirates","2024-03-14",0,0,2,0,0,2,0,0
"United Arab Emirates","2024-03-15",0,0,2,0,0,2,0,0
"United Arab Emirates","2024-03-16",0,0,2,0,0,2,0,0
"United Arab Emirates","2024-03-17",0,0,2,0,0,2,0,0
"United Arab Emirates","2024-03-18",0,0,2,0,0,2,0,0
"United Arab Emirates","2024-03-19",0,0,2,0,0,2,0,0
"United Arab Emirates","2024-03-20",0,0,2,0,0,2,0,0
"United Arab Emirates","2024-03-21",0,0,2,0,0,2,0,0
"United Arab Emirates","2024-03-22",0,0,2,0,0,2,0,0
"United Arab Emirates","2024-03-23",0,0,2,0,0,2,0,0
"United Arab Emirates","2024-03-24",0,0,2,0,0,2,0,0
"United Arab Emirates","2024-03-25",0,0,2,0,0,2,0,0
"United Arab Emirates","2024-03-26",0,0,2,0,0,2,0,0
"United Arab Emirates","2024-03-27",0,0,2,0,1,3,0,0
"United Arab Emirates","2024-03-28",0,0,2,0,0,3,0,0
"United Arab Emirates","2024-03-29",0,0,2,0,0,3,0,0
"United Arab Emirates","2024-03-30",0,0,2,0,0,3,0,0
"United Arab Emirates","2024-03-31",0,0,2,0,0,3,0,0
"United Arab Emirates","2024-04-01",0,0,2,0,0,3,0,0
"United Arab Emirates","2024-04-02",0,0,2,0,0,3,0,0
"United Arab Emirates","2024-04-03",0,0,2,0,0,3,0,0
"United Arab Emirates","2024-04-04",0,0,2,0,0,3,0,0
"United Arab Emirates","2024-04-05",0,0,2,0,0,3,0,0
"United Arab Emirates","2024-04-06",0,0,2,0,0,3,0,0
"United Arab Emirates","2024-04-07",0,0,2,0,0,3,0,0
"United Arab Emirates","2024-04-08",0,0,2,0,0,3,0,0
"United Arab Emirates","2024-04-09",0,0,2,0,0,3,0,0
"United Arab Emirates","2024-04-10",0,0,2,0,0,3,0,0
"United Arab Emirates","2024-04-11",0,0,2,0,0,3,0,0
"United Arab Emirates","2024-04-12",0,0,2,0,0,3,0,0
"United Arab Emirates","2024-04-13",0,0,2,0,0,3,0,0
"United Arab Emirates","2024-04-14",0,0,2,0,0,3,0,0
"United Arab Emirates","2024-04-15",0,0,2,0,0,3,0,0
"United Arab Emirates","2024-04-16",0,0,2,0,0,3,0,0
"United Arab Emirates","2024-04-17",0,0,2,0,0,3,0,0
"United Arab Emirates","2024-04-18",0,0,2,0,0,3,0,0
"United Arab Emirates","2024-04-19",0,0,2,0,0,3,0,0
"United Arab Emirates","2024-04-20",0,1,3,0,0,3,0,0
"United Arab Emirates","2024-04-21",0,0,3,0,0,3,0,0
"United Arab Emirates","2024-04-22",0,0,3,0,0,3,0,0
"United Arab Emirates","2024-04-23",0,0,3,0,0,3,0,0
"United Arab Emirates","2024-04-24",0,0,3,0,0,3,0,0
"United Arab Emirates","2024-04-25",0,0,3,0,0,3,0,0
"United Arab Emirates","2024-04-26",0,0,3,0,0,3,0,0
"United Arab Emirates","2024-04-27",0,0,3,0,0,3,0,0
"United Arab Emirates","2024-04-28",0,0,3,0,0,3,0,0
"United Arab Emirates","2024-04-29",0,0,3,0,0,3,0,0
"United Arab Emirates","2024-04-30",0,0,3,0,0,3,0,0
"United Arab Emirates","2024-05-01",0,0,3,0,0,3,0,0
"United Arab Emirates","2024-05-02",0,0,3,0,0,3,0,0
"United Arab Emirates","2024-05-03",0,0,3,0,0,3,0,0
"United Arab Emirates","2024-05-04",0,0,3,0,0,3,0,0
"United Arab Emirates","2024-05-05",0,0,3,0,0,3,0,0
"United Arab Emirates","2024-05-06",0,0,3,0,0,3,0,0
"United Arab Emirates","2024-05-07",0,0,3,0,0,3,0,0
"United Arab Emirates","2024-05-08",0,0,3,0,0,3,0,0
"United Arab Emirates","2024-05-09",0,0,3,0,0,3,0,0
"United Arab Emirates","2024-05-10",0,0,3,0,0,3,0,0
"United Arab Emirates","2024-05-11",0,0,3,0,0,3,0,0
"United Arab Emirates","2024-05-12",0,0,3,0,0,3,0,0
"United Arab Emirates","2024-05-13",0,0,3,0,0,3,0,0
"United Arab Emirates","2024-05-14",0,0,3,0,0,3,0,0
"United Arab Emirates","2024-05-15",0,0,3,0,0,3,0,0
"United Arab Emirates","2024-05-16",0,0,3,0,0,3,0,0
"United Arab Emirates","2024-05-17",0,0,3,0,0,3,0,0
"United Arab Emirates","2024-05-18",0,0,3,0,0,3,0,0
"United Arab Emirates","2024-05-19",0,0,3,0,0,3,0,0
"United Arab Emirates","2024-05-20",0,0,3,0,0,3,0,0
"United Arab Emirates","2024-05-21",0,0,3,0,0,3,0,0
"United Arab Emirates","2024-05-22",0,0,3,0,0,3,0,0
"United Arab Emirates","2024-05-23",0,0,3,0,0,3,0,0
"United Arab Emirates","2024-05-24",0,0,3,0,0,3,0,0
"United Arab Emirates","2024-05-25",0,0,3,0,0,3,0,0
"United Arab Emirates","2024-05-26",0,0,3,0,0,3,0,0
"United Arab Emirates","2024-05-27",0,0,3,0,0,3,0,0
"United Arab Emirates","2024-05-28",0,0,3,0,0,3,0,0
"United Arab Emirates","2024-05-29",0,0,3,0,0,3,0,0
"United Arab Emirates","2024-05-30",0,0,3,0,0,3,0,0
"United Arab Emirates","2024-05-31",0,0,3,0,0,3,0,0
"United Arab Emirates","2024-06-01",0,0,3,0,0,3,0,0
"United Arab Emirates","2024-06-02",0,0,3,0,0,3,0,0
"United Arab Emirates","2024-06-03",0,0,3,0,0,3,0,0
"United Arab Emirates","2024-06-04",0,0,3,0,0,3,0,0
"United Arab Emirates","2024-06-05",0,0,3,0,0,3,0,0
"United Arab Emirates","2024-06-06",0,0,3,0,0,3,0,0
"United Arab Emirates","2024-06-07",0,0,3,0,0,3,0,0
"United Arab Emirates","2024-06-08",0,0,3,0,0,3,0,0
"United Arab Emirates","2024-06-09",0,0,3,0,0,3,0,0
"United Arab Emirates","2024-06-10",0,0,3,0,0,3,0,0
"United Arab Emirates","2024-06-11",0,0,3,0,0,3,0,0
"United Arab Emirates","2024-06-12",0,0,3,0,0,3,0,0
"United Arab Emirates","2024-06-13",0,0,3,0,0,3,0,0
"United Arab Emirates","2024-06-14",0,0,3,0,0,3,0,0
"United Arab Emirates","2024-06-15",0,0,3,0,0,3,0,0
"United Arab Emirates","2024-06-16",0,0,3,0,0,3,0,0
"United Arab Emirates","2024-06-17",0,0,3,0,0,3,0,0
"United Arab Emirates","2024-06-18",0,0,3,0,0,3,0,0
"United Arab Emirates","2024-06-19",0,0,3,0,0,3,0,0
"United Arab Emirates","2024-06-20",0,0,3,0,0,3,0,0
"United Arab Emirates","2024-06-21",0,0,3,0,0,3,0,0
"United Arab Emirates","2024-06-22",0,0,3,0,0,3,0,0
"United Arab Emirates","2024-06-23",0,0,3,0,0,3,0,0
"United Arab Emirates","2024-06-24",0,0,3,0,0,3,0,0
"United Arab Emirates","2024-06-25",0,0,3,0,0,3,0,0
"United Arab Emirates","2024-06-26",0,0,3,0,0,3,0,0
"United Arab Emirates","2024-06-27",0,0,3,0,0,3,0,0
"United Arab Emirates","2024-06-28",0,0,3,0,0,3,0,0
"United Arab Emirates","2024-06-29",0,0,3,0,0,3,0,0
"United Arab Emirates","2024-06-30",0,0,3,0,0,3,0,0
"United Arab Emirates","2024-07-01",0,0,3,0,0,3,0,0
"United Arab Emirates","2024-07-02",0,0,3,0,0,3,0,0
"United Arab Emirates","2024-07-03",0,0,3,0,0,3,0,0
"United Arab Emirates","2024-07-04",0,0,3,0,0,3,0,0
"United Arab Emirates","2024-07-05",0,0,3,0,0,3,0,0
"United Arab Emirates","2024-07-06",0,0,3,0,0,3,0,0
"United Arab Emirates","2024-07-07",0,0,3,0,0,3,0,0
"United Arab Emirates","2024-07-08",0,0,3,0,0,3,0,0
"United Arab Emirates","2024-07-09",0,0,3,0,0,3,0,0
"United Arab Emirates","2024-07-10",0,0,3,0,0,3,0,0
"United Arab Emirates","2024-07-11",0,0,3,0,1,4,0,0
"United Arab Emirates","2024-07-12",0,0,3,0,0,4,0,0
"United Arab Emirates","2024-07-13",0,0,3,0,0,4,0,0
"United Arab Emirates","2024-07-14",0,0,3,0,0,4,0,0
"United Arab Emirates","2024-07-15",0,0,3,0,0,4,0,0
"United Arab Emirates","2024-07-16",0,0,3,0,0,4,0,0
"United Arab Emirates","2024-07-17",0,0,3,0,0,4,0,0
"United Arab Emirates","2024-07-18",0,0,3,0,0,4,0,0
"United Arab Emirates","2024-07-19",0,0,3,0,0,4,0,0
"United Arab Emirates","2024-07-20",0,0,3,0,0,4,0,0
"United Arab Emirates","2024-07-21",0,0,3,0,0,4,0,0
"United Arab Emirates","2024-07-22",0,0,3,0,0,4,0,0
"United Arab Emirates","2024-07-23",0,0,3,0,0,4,0,0
"United Arab Emirates","2024-07-24",0,0,3,0,0,4,0,0
"United Arab Emirates","2024-07-25",0,0,3,0,0,4,0,0
"United Arab Emirates","2024-07-26",0,0,3,0,0,4,0,0
"United Arab Emirates","2024-07-27",0,0,3,0,0,4,0,0
"United Arab Emirates","2024-07-28",0,0,3,0,0,4,0,0
"United Arab Emirates","2024-07-29",0,0,3,0,0,4,0,0
"United Arab Emirates","2024-07-30",0,0,3,0,0,4,0,0
"United Arab Emirates","2024-07-31",0,0,3,0,0,4,0,0
"United Arab Emirates","2024-08-01",0,0,3,0,0,4,0,0
"United Arab Emirates","2024-08-02",0,0,3,0,0,4,0,0
"United Arab Emirates","2024-08-03",0,0,3,0,0,4,0,0
"United Arab Emirates","2024-08-04",0,0,3,0,0,4,0,0
"United Arab Emirates","2024-08-05",0,0,3,0,0,4,0,0
"United Arab Emirates","2024-08-06",0,0,3,0,0,4,0,0
"United Arab Emirates","2024-08-07",0,0,3,0,0,4,0,0
"United Arab Emirates","2024-08-08",0,0,3,0,0,4,0,0
"United Arab Emirates","2024-08-09",0,0,3,0,0,4,0,0
"United Arab Emirates","2024-08-10",0,0,3,0,0,4,0,0
"United Arab Emirates","2024-08-11",0,0,3,0,0,4,0,0
"United Arab Emirates","2024-08-12",0,0,3,0,0,4,0,0
"United Arab Emirates","2024-08-13",0,0,3,0,0,4,0,0
"United Arab Emirates","2024-08-14",0,0,3,0,0,4,0,0
"United Arab Emirates","2024-08-15",0,0,3,0,0,4,0,0
"United Arab Emirates","2024-08-16",0,0,3,0,0,4,0,0
"United Arab Emirates","2024-08-17",0,0,3,0,0,4,0,0
"United Arab Emirates","2024-08-18",0,0,3,0,0,4,0,0
"United Arab Emirates","2024-08-19",0,0,3,0,0,4,0,0
"United Arab Emirates","2024-08-20",0,0,3,0,0,4,0,0
"United Arab Emirates","2024-08-21",0,0,3,0,0,4,0,0
"United Arab Emirates","2024-08-22",0,0,3,0,0,4,0,0
"United Arab Emirates","2024-08-23",0,0,3,0,0,4,0,0
"United Arab Emirates","2024-08-24",0,0,3,0,0,4,0,0
"United Arab Emirates","2024-08-25",0,0,3,0,0,4,0,0
"United Arab Emirates","2024-08-26",0,0,3,0,0,4,0,0
"United Arab Emirates","2024-08-27",0,0,3,0,0,4,0,0
"United Arab Emirates","2024-08-28",0,0,3,0,0,4,0,0
"United Arab Emirates","2024-08-29",0,0,3,0,0,4,0,0
"United Arab Emirates","2024-08-30",0,0,3,0,0,4,0,0
"United Arab Emirates","2024-08-31",0,0,3,0,0,4,0,0
"United Arab Emirates","2024-09-01",0,0,3,0,0,4,0,0
"United Arab Emirates","2024-09-02",0,0,3,0,0,4,0,0
"United Arab Emirates","2024-09-03",0,0,3,0,0,4,0,0
"United Arab Emirates","2024-09-04",0,0,3,0,0,4,0,0
"United Arab Emirates","2024-09-05",0,0,3,0,0,4,0,0
"United Arab Emirates","2024-09-06",0,0,3,0,0,4,0,0
"United Arab Emirates","2024-09-07",0,0,3,0,0,4,0,0
"United Arab Emirates","2024-09-08",0,0,3,0,0,4,0,0
"United Arab Emirates","2024-09-09",0,0,3,0,0,4,0,0
"United Arab Emirates","2024-09-10",0,0,3,0,0,4,0,0
"United Arab Emirates","2024-09-11",0,0,3,0,0,4,0,0
"United Arab Emirates","2024-09-12",0,0,3,0,0,4,0,0
"United Arab Emirates","2024-09-13",0,0,3,0,0,4,0,0
"United Arab Emirates","2024-09-14",0,0,3,0,0,4,0,0
"United Arab Emirates","2024-09-15",0,0,3,0,0,4,0,0
"United Arab Emirates","2024-09-16",0,0,3,0,0,4,0,0
"United Arab Emirates","2024-09-17",0,0,3,0,0,4,0,0
"United Arab Emirates","2024-09-18",0,0,3,0,0,4,0,0
"United Arab Emirates","2024-09-19",0,0,3,0,0,4,0,0
"United Arab Emirates","2024-09-20",0,0,3,0,0,4,0,0
"United Arab Emirates","2024-09-21",0,0,3,0,0,4,0,0
"United Arab Emirates","2024-09-22",0,0,3,0,0,4,0,0
"United Arab Emirates","2024-09-23",0,0,3,0,0,4,0,0
"United Arab Emirates","2024-09-24",0,0,3,0,0,4,0,0
"United Arab Emirates","2024-09-25",0,0,3,0,0,4,0,0
"United Arab Emirates","2024-09-26",0,0,3,0,0,4,0,0
"United Arab Emirates","2024-09-27",0,0,3,0,0,4,0,0
"United Arab Emirates","2024-09-28",0,0,3,0,0,4,0,0
"United Arab Emirates","2024-09-29",0,0,3,0,0,4,0,0
"United Arab Emirates","2024-09-30",0,1,4,0,0,4,0,0
"United Arab Emirates","2024-10-01",0,0,4,0,0,4,0,0
"United Arab Emirates","2024-10-02",0,0,4,0,0,4,0,0
"United Arab Emirates","2024-10-03",0,0,4,0,0,4,0,0
"United Arab Emirates","2024-10-04",0,0,4,0,0,4,0,0
"United Arab Emirates","2024-10-05",0,0,4,0,0,4,0,0
"United Arab Emirates","2024-10-06",0,0,4,0,0,4,0,0
"United Arab Emirates","2024-10-07",0,0,4,0,0,4,0,0
"United Arab Emirates","2024-10-08",0,0,4,0,0,4,0,0
"United Arab Emirates","2024-10-09",0,0,4,0,0,4,0,0
"United Arab Emirates","2024-10-10",0,0,4,0,0,4,0,0
"United Arab Emirates","2024-10-11",0,0,4,0,0,4,0,0
"United Arab Emirates","2024-10-12",0,0,4,0,0,4,0,0
"United Arab Emirates","2024-10-13",0,0,4,0,0,4,0,0
"United Arab Emirates","2024-10-14",0,0,4,0,0,4,0,0
"United Arab Emirates","2024-10-15",0,0,4,0,0,4,0,0
"United Arab Emirates","2024-10-16",0,0,4,0,1,5,0,0
"United Arab Emirates","2024-10-17",0,0,4,0,0,5,0,0
"United Arab Emirates","2024-10-18",0,0,4,0,0,5,0,0
"United Arab Emirates","2024-10-19",0,0,4,0,0,5,0,0
"United Arab Emirates","2024-10-20",0,0,4,0,0,5,0,0
"United Arab Emirates","2024-10-21",0,0,4,0,0,5,0,0
"United Arab Emirates","2024-10-22",0,0,4,0,0,5,0,0
"United Arab Emirates","2024-10-23",0,0,4,0,0,5,0,0
"United Arab Emirates","2024-10-24",0,0,4,0,0,5,0,0
"United Arab Emirates","2024-10-25",0,0,4,0,0,5,0,0
"United Arab Emirates","2024-10-26",0,0,4,0,0,5,0,0
"United Arab Emirates","2024-10-27",0,0,4,0,0,5,0,0
"United Arab Emirates","2024-10-28",0,0,4,0,0,5,0,0
"United Arab Emirates","2024-10-29",0,0,4,0,0,5,0,0
"United Arab Emirates","2024-10-30",0,1,5,0,0,5,0,0
"United Arab Emirates","2024-10-31",0,0,5,0,0,5,0,0
"United Arab Emirates","2024-11-01",0,0,5,0,0,5,0,0
"United Arab Emirates","2024-11-02",0,0,5,0,0,5,0,0
"United Arab Emirates","2024-11-03",0,0,5,0,0,5,0,0
"United Arab Emirates","2024-11-04",0,0,5,0,0,5,0,0
"United Arab Emirates","2024-11-05",0,0,5,0,0,5,0,0
"United Arab Emirates","2024-11-06",0,0,5,0,0,5,0,0
"United Arab Emirates","2024-11-07",0,0,5,0,0,5,0,0
"United Arab Emirates","2024-11-08",0,0,5,0,0,5,0,0
"United Arab Emirates","2024-11-09",0,0,5,0,0,5,0,0
"United Arab Emirates","2024-11-10",0,0,5,0,0,5,0,0
"United Arab Emirates","2024-11-11",0,0,5,0,0,5,0,0
"United Arab Emirates","2024-11-12",0,0,5,0,0,5,0,0
"United Arab Emirates","2024-11-13",0,0,5,0,0,5,0,0
"United Arab Emirates","2024-11-14",0,0,5,0,0,5,0,0
"United Arab Emirates","2024-11-15",0,0,5,0,0,5,0,0
"United Arab Emirates","2024-11-16",0,0,5,0,0,5,0,0
"United Arab Emirates","2024-11-17",0,0,5,0,0,5,0,0
"United Arab Emirates","2024-11-18",0,0,5,0,0,5,0,0
"United Arab Emirates","2024-11-19",0,0,5,0,0,5,0,0
"United Arab Emirates","2024-11-20",0,0,5,0,0,5,0,0
"United Arab Emirates","2024-11-21",0,0,5,0,0,5,0,0
"United Arab Emirates","2024-11-22",0,0,5,0,0,5,0,0
"United Arab Emirates","2024-11-23",0,0,5,0,0,5,0,0
"United Arab Emirates","2024-11-24",0,0,5,0,0,5,0,0
"United Arab Emirates","2024-11-25",0,0,5,0,0,5,0,0
"United Arab Emirates","2024-11-26",0,0,5,0,0,5,0,0
"United Arab Emirates","2024-11-27",0,0,5,0,0,5,0,0
"United Arab Emirates","2024-11-28",0,0,5,0,0,5,0,0
"United Arab Emirates","2024-11-29",0,0,5,0,0,5,0,0
"United Arab Emirates","2024-11-30",0,0,5,0,0,5,0,0
"United Arab Emirates","2024-12-01",0,0,5,0,0,5,0,0
"United Arab Emirates","2024-12-02",0,0,5,0,0,5,0,0
"United Arab Emirates","2024-12-03",0,0,5,0,0,5,0,0
"United Arab Emirates","2024-12-04",0,0,5,0,0,5,0,0
"United Arab Emirates","2024-12-05",0,0,5,0,0,5,0,0
"United Arab Emirates","2024-12-06",0,0,5,0,0,5,0,0
"United Arab Emirates","2024-12-07",0,0,5,0,0,5,0,0
"United Arab Emirates","2024-12-08",0,0,5,0,0,5,0,0
"United Arab Emirates","2024-12-09",0,0,5,0,0,5,0,0
"United Arab Emirates","2024-12-10",0,0,5,0,0,5,0,0
"United Arab Emirates","2024-12-11",0,0,5,0,0,5,0,0
"United Arab Emirates","2024-12-12",0,0,5,0,0,5,0,0
"United Arab Emirates","2024-12-13",0,0,5,0,0,5,0,0
"United Arab Emirates","2024-12-14",0,0,5,0,0,5,0,0
"United Arab Emirates","2024-12-15",0,0,5,0,0,5,0,0
"United Arab Emirates","2024-12-16",0,0,5,0,0,5,0,0
"United Arab Emirates","2024-12-17",0,0,5,0,0,5,0,0
"United Arab Emirates","2024-12-18",0,0,5,0,0,5,0,0
"United Arab Emirates","2024-12-19",0,0,5,0,0,5,0,0
"United Arab Emirates","2024-12-20",0,0,5,0,0,5,0,0
"United Arab Emirates","2024-12-21",0,0,5,0,0,5,0,0
"United Arab Emirates","2024-12-22",0,0,5,0,0,5,0,0
"United Arab Emirates","2024-12-23",0,0,5,0,0,5,0,0
"United Arab Emirates","2024-12-24",0,0,5,0,0,5,0,0
"United Arab Emirates","2024-12-25",0,0,5,0,0,5,0,0
"United Arab Emirates","2024-12-26",0,0,5,0,0,5,0,0
"United Arab Emirates","2024-12-27",0,0,5,0,0,5,0,0
"United Arab Emirates","2024-12-28",0,0,5,0,0,5,0,0
"United Arab Emirates","2024-12-29",0,0,5,0,0,5,0,0
"United Arab Emirates","2024-12-30",0,0,5,0,0,5,0,0
"United Arab Emirates","2024-12-31",0,0,5,0,0,5,0,0
"United Arab Emirates","2025-01-01",0,0,5,0,0,5,0,0
"United Arab Emirates","2025-01-02",0,0,5,0,0,5,0,0
"United Arab Emirates","2025-01-03",0,0,5,0,0,5,0,0
"United Arab Emirates","2025-01-04",0,0,5,0,0,5,0,0
"United Arab Emirates","2025-01-05",0,0,5,0,0,5,0,0
"United Arab Emirates","2025-01-06",0,0,5,0,0,5,0,0
"United Arab Emirates","2025-01-07",0,0,5,0,0,5,0,0
"United Arab Emirates","2025-01-08",0,0,5,0,0,5,0,0
"United Arab Emirates","2025-01-09",0,0,5,0,0,5,0,0
"United Arab Emirates","2025-01-10",0,0,5,0,0,5,0,0
"United Arab Emirates","2025-01-11",0,0,5,0,0,5,0,0
"United Arab Emirates","2025-01-12",0,0,5,0,0,5,0,0
"United Arab Emirates","2025-01-13",0,0,5,0,0,5,0,0
"United Arab Emirates","2025-01-14",0,0,5,0,0,5,0,0
"United Arab Emirates","2025-01-15",0,0,5,0,0,5,0,0
"United Arab Emirates","2025-01-16",0,0,5,0,0,5,0,0
"United Arab Emirates","2025-01-17",0,0,5,0,0,5,0,0
"United Arab Emirates","2025-01-18",0,0,5,0,0,5,0,0
"United Arab Emirates","2025-01-19",0,0,5,0,0,5,0,0
"United Arab Emirates","2025-01-20",0,0,5,0,0,5,0,0
"United Arab Emirates","2025-01-21",0,0,5,0,0,5,0,0
"United Arab Emirates","2025-01-22",0,0,5,0,0,5,0,0
"United Arab Emirates","2025-01-23",0,0,5,0,0,5,0,0
"United Arab Emirates","2025-01-24",0,0,5,0,0,5,0,0
"United Arab Emirates","2025-01-25",0,0,5,0,0,5,0,0
"United Arab Emirates","2025-01-26",0,0,5,0,0,5,0,0
"United Arab Emirates","2025-01-27",0,0,5,0,0,5,0,0
"United Arab Emirates","2025-01-28",0,0,5,0,0,5,0,0
"United Arab Emirates","2025-01-29",0,0,5,0,0,5,0,0
"United Arab Emirates","2025-01-30",0,0,5,0,0,5,0,0
"United Arab Emirates","2025-01-31",0,0,5,0,0,5,0,0
"United Arab Emirates","2025-02-01",0,0,5,0,0,5,0,0
"United Arab Emirates","2025-02-02",0,0,5,0,0,5,0,0
"United Arab Emirates","2025-02-03",0,0,5,0,0,5,0,0
"United Kingdom of Great Britain and Northern Ireland","2024-01-01",0,0,0,0,0,0,0,0
"United Kingdom of Great Britain and Northern Ireland","2024-01-02",0,0,0,0,0,0,0,0
"United Kingdom of Great Britain and Northern Ireland","2024-01-03",0,0,0,0,0,0,0,0
"United Kingdom of Great Britain and Northern Ireland","2024-01-04",0,0,0,0,0,0,0,0
"United Kingdom of Great Britain and Northern Ireland","2024-01-05",0,0,0,0,0,0,0,0
"United Kingdom of Great Britain and Northern Ireland","2024-01-06",0,0,0,0,0,0,0,0
"United Kingdom of Great Britain and Northern Ireland","2024-01-07",0,0,0,0,0,0,0,0
"United Kingdom of Great Britain and Northern Ireland","2024-01-08",0,0,0,0,0,0,0,0
"United Kingdom of Great Britain and Northern Ireland","2024-01-09",0,0,0,0,0,0,0,0
"United Kingdom of Great Britain and Northern Ireland","2024-01-10",0,0,0,0,0,0,0,0
"United Kingdom of Great Britain and Northern Ireland","2024-01-11",0,0,0,0,0,0,0,0
"United Kingdom of Great Britain and Northern Ireland","2024-01-12",0,0,0,0,0,0,0,0
"United Kingdom of Great Britain and Northern Ireland","2024-01-13",0,0,0,0,0,0,0,0
"United Kingdom of Great Britain and Northern Ireland","2024-01-14",0,0,0,0,0,0,0,0
"United Kingdom of Great Britain and Northern Ireland","2024-01-15",0,0,0,0,0,0,0,0
"United Kingdom of Great Britain and Northern Ireland","2024-01-16",0,0,0,0,0,0,0,0
"United Kingdom of Great Britain and Northern Ireland","2024-01-17",0,0,0,0,0,0,0,0
"United Kingdom of Great Britain and Northern Ireland","2024-01-18",0,0,0,0,0,0,0,0
"United Kingdom of Great Britain and Northern Ireland","2024-01-19",0,0,0,0,0,0,0,0
"United Kingdom of Great Britain and Northern Ireland","2024-01-20",0,0,0,0,0,0,0,0
"United Kingdom of Great Britain and Northern Ireland","2024-01-21",0,0,0,0,0,0,0,0
"United Kingdom of Great Britain and Northern Ireland","2024-01-22",0,0,0,0,0,0,0,0
"United Kingdom of Great Britain and Northern Ireland","2024-01-23",0,0,0,0,0,0,0,0
"United Kingdom of Great Britain and Northern Ireland","2024-01-24",0,0,0,0,0,0,0,0
"United Kingdom of Great Britain and Northern Ireland","2024-01-25",0,0,0,0,0,0,0,0
"United Kingdom of Great Britain and Northern Ireland","2024-01-26",0,0,0,0,0,0,0,0
"United Kingdom of Great Britain and Northern Ireland","2024-01-27",0,0,0,0,0,0,0,0
"United Kingdom of Great Britain and Northern Ireland","2024-01-28",0,0,0,0,0,0,0,0
"United Kingdom of Great Britain and Northern Ireland","2024-01-29",0,0,0,0,0,0,0,0
"United Kingdom of Great Britain and Northern Ireland","2024-01-30",0,0,0,0,0,0,0,0
"United Kingdom of Great Britain and Northern Ireland","2024-01-31",0,7,7,0,7,7,0,0
"United Kingdom of Great Britain and Northern Ireland","2024-02-01",0,0,7,0,0,7,0,0
"United Kingdom of Great Britain and Northern Ireland","2024-02-02",0,0,7,0,1,8,0,0
"United Kingdom of Great Britain and Northern Ireland","2024-02-03",0,0,7,0,0,8,0,0
"United Kingdom of Great Britain and Northern Ireland","2024-02-04",0,0,7,0,0,8,0,0
"United Kingdom of Great Britain and Northern Ireland","2024-02-05",0,0,7,0,1,9,0,0
"United Kingdom of Great Britain and Northern Ireland","2024-02-06",0,0,7,0,0,9,0,0
"United Kingdom of Great Britain and Northern Ireland","2024-02-07",0,0,7,0,0,9,0,0
"United Kingdom of Great Britain and Northern Ireland","2024-02-08",0,0,7,0,1,10,0,0
"United Kingdom of Great Britain and Northern Ireland","2024-02-09",0,0,7,0,0,10,0,0
"United Kingdom of Great Britain and Northern Ireland","2024-02-10",0,0,7,0,0,10,0,0
"United Kingdom of Great Britain and Northern Ireland","2024-02-11",0,0,7,0,1,11,0,0
"United Kingdom of Great Britain and Northern Ireland","2024-02-12",0,0,7,0,0,11,0,0
"United Kingdom of Great Britain and Northern Ireland","2024-02-13",0,0,7,0,0,11,0,0
"United Kingdom of Great Britain and Northern Ireland","2024-02-14",0,0,7,0,1,12,0,0
"United Kingdom of Great Britain and Northern Ireland","2024-02-15",0,0,7,0,0,12,0,0
"United Kingdom of Great Britain and Northern Ireland","2024-02-16",0,0,7,0,1,13,0,0
"United Kingdom of Great Britain and Northern Ireland","2024-02-17",0,0,7,0,0,13,0,0
"United Kingdom of Great Britain and Northern Ireland","2024-02-18",0,0,7,0,0,13,0,0
"United Kingdom of Great Britain and Northern Ireland","2024-02-19",0,0,7,0,1,14,0,0
"United Kingdom of Great Britain and Northern Ireland","2024-02-20",0,0,7,0,0,14,0,0
"United Kingdom of Great Britain and Northern Ireland","2024-02-21",0,0,7,0,0,14,0,0
"United Kingdom of Great Britain and Northern Ireland","2024-02-22",0,0,7,0,1,15,0,0
"United Kingdom of Great Britain and Northern Ireland","2024-02-23",0,0,7,0,0,15,0,0
"United Kingdom of Great Britain and Northern Ireland","2024-02-24",0,0,7,0,0,15,0,0
"United Kingdom of Great Britain and Northern Ireland","2024-02-25",0,0,7,0,1,16,0,0
"United Kingdom of Great Britain and Northern Ireland","2024-02-26",0,0,7,0,0,16,0,0
"United Kingdom of Great Britain and Northern Ireland","2024-02-27",0,0,7,0,0,16,0,0
"United Kingdom of Great Britain and Northern Ireland","2024-02-28",0,0,7,0,1,17,0,0
"United Kingdom of Great Britain and Northern Ireland","2024-02-29",0,10,17,0,0,17,0,0
"United Kingdom of Great Britain and Northern Ireland","2024-03-01",0,0,17,0,1,18,0,0
"United Kingdom of Great Britain and Northern Ireland","2024-03-02",0,0,17,0,0,18,0,0
"United Kingdom of Great Britain and Northern Ireland","2024-03-03",0,0,17,0,1,19,0,0
"United Kingdom of Great Britain and Northern Ireland","2024-03-04",0,0,17,0,0,19,0,0
"United Kingdom of Great Britain and Northern Ireland","2024-03-05",0,0,17,0,1,20,0,0
"United Kingdom of Great Britain and Northern Ireland","2024-03-06",0,0,17,0,0,20,0,0
"United Kingdom of Great Britain and Northern Ireland","2024-03-07",0,0,17,0,1,21,0,0
"United Kingdom of Great Britain and Northern Ireland","2024-03-08",0,0,17,0,0,21,0,0
"United Kingdom of Great Britain and Northern Ireland","2024-03-09",0,0,17,0,1,22,0,0
"United Kingdom of Great Britain and Northern Ireland","2024-03-10",0,0,17,0,0,22,0,0
"United Kingdom of Great Britain and Northern Ireland","2024-03-11",0,0,17,0,1,23,0,0
"United Kingdom of Great Britain and Northern Ireland","2024-03-12",0,0,17,0,0,23,0,0
"United Kingdom of Great Britain and Northern Ireland","2024-03-13",0,0,17,0,1,24,0,0
"United Kingdom of Great Britain and Northern Ireland","2024-03-14",0,0,17,0,0,24,0,0
"United Kingdom of Great Britain and Northern Ireland","2024-03-15",0,0,17,0,1,25,0,0
"United Kingdom of Great Britain and Northern Ireland","2024-03-16",0,0,17,0,0,25,0,0
"United Kingdom of Great Britain and Northern Ireland","2024-03-17",0,0,17,0,1,26,0,0
"United Kingdom of Great Britain and Northern Ireland","2024-03-18",0,0,17,0,0,26,0,0
"United Kingdom of Great Britain and Northern Ireland","2024-03-19",0,0,17,0,1,27,0,0
"United Kingdom of Great Britain and Northern Ireland","2024-03-20",0,0,17,0,0,27,0,0
"United Kingdom of Great Britain and Northern Ireland","2024-03-21",0,0,17,0,1,28,0,0
"United Kingdom of Great Britain and Northern Ireland","2024-03-22",0,0,17,0,0,28,0,0
"United Kingdom of Great Britain and Northern Ireland","2024-03-23",0,0,17,0,1,29,0,0
"United Kingdom of Great Britain and Northern Ireland","2024-03-24",0,0,17,0,0,29,0,0
"United Kingdom of Great Britain and Northern Ireland","2024-03-25",0,0,17,0,1,30,0,0
"United Kingdom of Great Britain and Northern Ireland","2024-03-26",0,0,17,0,0,30,0,0
"United Kingdom of Great Britain and Northern Ireland","2024-03-27",0,0,17,0,1,31,0,0
"United Kingdom of Great Britain and Northern Ireland","2024-03-28",0,0,17,0,0,31,0,0
"United Kingdom of Great Britain and Northern Ireland","2024-03-29",0,0,17,0,1,32,0,0
"United Kingdom of Great Britain and Northern Ireland","2024-03-30",0,0,17,0,0,32,0,0
"United Kingdom of Great Britain and Northern Ireland","2024-03-31",0,16,33,0,1,33,0,0
"United Kingdom of Great Britain and Northern Ireland","2024-04-01",0,0,33,0,1,34,0,0
"United Kingdom of Great Britain and Northern Ireland","2024-04-02",0,0,33,0,0,34,0,0
"United Kingdom of Great Britain and Northern Ireland","2024-04-03",0,0,33,0,1,35,0,0
"United Kingdom of Great Britain and Northern Ireland","2024-04-04",0,0,33,0,1,36,0,0
"United Kingdom of Great Britain and Northern Ireland","2024-04-05",0,0,33,0,0,36,0,0
"United Kingdom of Great Britain and Northern Ireland","2024-04-06",0,0,33,0,1,37,0,0
"United Kingdom of Great Britain and Northern Ireland","2024-04-07",0,0,33,0,1,38,0,0
"United Kingdom of Great Britain and Northern Ireland","2024-04-08",0,0,33,0,0,38,0,0
"United Kingdom of Great Britain and Northern Ireland","2024-04-09",0,0,33,0,1,39,0,0
"United Kingdom of Great Britain and Northern Ireland","2024-04-10",0,0,33,0,1,40,0,0
"United Kingdom of Great Britain and Northern Ireland","2024-04-11",0,0,33,0,0,40,0,0
"United Kingdom of Great Britain and Northern Ireland","2024-04-12",0,0,33,0,1,41,0,0
"United Kingdom of Great Britain and Northern Ireland","2024-04-13",0,0,33,0,1,42,0,0
"United Kingdom of Great Britain and Northern Ireland","2024-04-14",0,0,33,0,0,42,0,0
"United Kingdom of Great Britain and Northern Ireland","2024-04-15",0,0,33,0,1,43,0,0
"United Kingdom of Great Britain and Northern Ireland","2024-04-16",0,0,33,0,1,44,0,0
"United Kingdom of Great Britain and Northern Ireland","2024-04-17",0,0,33,0,0,44,0,0
"United Kingdom of Great Britain and Northern Ireland","2024-04-18",0,0,33,0,1,45,0,0
"United Kingdom of Great Britain and Northern Ireland","2024-04-19",0,0,33,0,1,46,0,0
"United Kingdom of Great Britain and Northern Ireland","2024-04-20",0,0,33,0,0,46,0,0
"United Kingdom of Great Britain and Northern Ireland","2024-04-21",0,0,33,0,1,47,0,0
"United Kingdom of Great Britain and Northern Ireland","2024-04-22",0,0,33,0,1,48,0,0
"United Kingdom of Great Britain and Northern Ireland","2024-04-23",0,0,33,0,0,48,0,0
"United Kingdom of Great Britain and Northern Ireland","2024-04-24",0,0,33,0,1,49,0,0
"United Kingdom of Great Britain and Northern Ireland","2024-04-25",0,0,33,0,1,50,0,0
"United Kingdom of Great Britain and Northern Ireland","2024-04-26",0,0,33,0,0,50,0,0
"United Kingdom of Great Britain and Northern Ireland","2024-04-27",0,0,33,0,1,51,0,0
"United Kingdom of Great Britain and Northern Ireland","2024-04-28",0,0,33,0,1,52,0,0
"United Kingdom of Great Britain and Northern Ireland","2024-04-29",0,0,33,0,0,52,0,0
"United Kingdom of Great Britain and Northern Ireland","2024-04-30",0,20,53,0,1,53,0,0
"United Kingdom of Great Britain and Northern Ireland","2024-05-01",0,0,53,0,1,54,0,0
"United Kingdom of Great Britain and Northern Ireland","2024-05-02",0,0,53,0,1,55,0,0
"United Kingdom of Great Britain and Northern Ireland","2024-05-03",0,0,53,0,0,55,0,0
"United Kingdom of Great Britain and Northern Ireland","2024-05-04",0,0,53,0,1,56,0,0
"United Kingdom of Great Britain and Northern Ireland","2024-05-05",0,0,53,0,1,57,0,0
"United Kingdom of Great Britain and Northern Ireland","2024-05-06",0,0,53,0,1,58,0,0
"United Kingdom of Great Britain and Northern Ireland","2024-05-07",0,0,53,0,0,58,0,0
"United Kingdom of Great Britain and Northern Ireland","2024-05-08",0,0,53,0,1,59,0,0
"United Kingdom of Great Britain and Northern Ireland","2024-05-09",0,0,53,0,1,60,0,0
"United Kingdom of Great Britain and Northern Ireland","2024-05-10",0,0,53,0,1,61,0,0
"United Kingdom of Great Britain and Northern Ireland","2024-05-11",0,0,53,0,1,62,0,0
"United Kingdom of Great Britain and Northern Ireland","2024-05-12",0,0,53,0,0,62,0,0
"United Kingdom of Great Britain and Northern Ireland","2024-05-13",0,0,53,0,1,63,0,0
"United Kingdom of Great Britain and Northern Ireland","2024-05-14",0,0,53,0,1,64,0,0
"United Kingdom of Great Britain and Northern Ireland","2024-05-15",0,0,53,0,1,65,0,0
"United Kingdom of Great Britain and Northern Ireland","2024-05-16",0,0,53,0,0,65,0,0
"United Kingdom of Great Britain and Northern Ireland","2024-05-17",0,0,53,0,1,66,0,0
"United Kingdom of Great Britain and Northern Ireland","2024-05-18",0,0,53,0,1,67,0,0
"United Kingdom of Great Britain and Northern Ireland","2024-05-19",0,0,53,0,1,68,0,0
"United Kingdom of Great Britain and Northern Ireland","2024-05-20",0,0,53,0,0,68,0,0
"United Kingdom of Great Britain and Northern Ireland","2024-05-21",0,0,53,0,1,69,0,0
"United Kingdom of Great Britain and Northern Ireland","2024-05-22",0,0,53,0,1,70,0,0
"United Kingdom of Great Britain and Northern Ireland","2024-05-23",0,0,53,0,1,71,0,0
"United Kingdom of Great Britain and Northern Ireland","2024-05-24",0,0,53,0,1,72,0,0
"United Kingdom of Great Britain and Northern Ireland","2024-05-25",0,0,53,0,0,72,0,0
"United Kingdom of Great Britain and Northern Ireland","2024-05-26",0,0,53,0,1,73,0,0
"United Kingdom of Great Britain and Northern Ireland","2024-05-27",0,0,53,0,1,74,0,0
"United Kingdom of Great Britain and Northern Ireland","2024-05-28",0,0,53,0,1,75,0,0
"United Kingdom of Great Britain and Northern Ireland","2024-05-29",0,0,53,0,0,75,0,0
"United Kingdom of Great Britain and Northern Ireland","2024-05-30",0,0,53,0,1,76,0,0
"United Kingdom of Great Britain and Northern Ireland","2024-05-31",0,24,77,0,1,77,0,0
"United Kingdom of Great Britain and Northern Ireland","2024-06-01",0,0,77,0,1,78,0,0
"United Kingdom of Great Britain and Northern Ireland","2024-06-02",0,0,77,0,1,79,0,0
"United Kingdom of Great Britain and Northern Ireland","2024-06-03",0,0,77,0,1,80,0,0
"United Kingdom of Great Britain and Northern Ireland","2024-06-04",0,0,77,0,1,81,0,0
"United Kingdom of Great Britain and Northern Ireland","2024-06-05",0,0,77,0,1,82,0,0
"United Kingdom of Great Britain and Northern Ireland","2024-06-06",0,0,77,0,1,83,0,0
"United Kingdom of Great Britain and Northern Ireland","2024-06-07",0,0,77,0,2,85,0,0
"United Kingdom of Great Britain and Northern Ireland","2024-06-08",0,0,77,0,1,86,0,0
"United Kingdom of Great Britain and Northern Ireland","2024-06-09",0,0,77,0,1,87,0,0
"United Kingdom of Great Britain and Northern Ireland","2024-06-10",0,0,77,0,1,88,0,0
"United Kingdom of Great Britain and Northern Ireland","2024-06-11",0,0,77,0,1,89,0,0
"United Kingdom of Great Britain and Northern Ireland","2024-06-12",0,0,77,0,1,90,0,0
"United Kingdom of Great Britain and Northern Ireland","2024-06-13",0,0,77,0,1,91,0,0
"United Kingdom of Great Britain and Northern Ireland","2024-06-14",0,0,77,0,1,92,0,0
"United Kingdom of Great Britain and Northern Ireland","2024-06-15",0,0,77,0,1,93,0,0
"United Kingdom of Great Britain and Northern Ireland","2024-06-16",0,0,77,0,1,94,0,0
"United Kingdom of Great Britain and Northern Ireland","2024-06-17",0,0,77,0,1,95,0,0
"United Kingdom of Great Britain and Northern Ireland","2024-06-18",0,0,77,0,1,96,0,0
"United Kingdom of Great Britain and Northern Ireland","2024-06-19",0,0,77,0,2,98,0,0
"United Kingdom of Great Britain and Northern Ireland","2024-06-20",0,0,77,0,1,99,0,0
"United Kingdom of Great Britain and Northern Ireland","2024-06-21",0,0,77,0,1,100,0,0
"United Kingdom of Great Britain and Northern Ireland","2024-06-22",0,0,77,0,1,101,0,0
"United Kingdom of Great Britain and Northern Ireland","2024-06-23",0,0,77,0,1,102,0,0
"United Kingdom of Great Britain and Northern Ireland","2024-06-24",0,0,77,0,1,103,0,0
"United Kingdom of Great Britain and Northern Ireland","2024-06-25",0,0,77,0,1,104,0,0
"United Kingdom of Great Britain and Northern Ireland","2024-06-26",0,0,77,0,1,105,0,0
"United Kingdom of Great Britain and Northern Ireland","2024-06-27",0,0,77,0,1,106,0,0
"United Kingdom of Great Britain and Northern Ireland","2024-06-28",0,0,77,0,1,107,0,0
"United Kingdom of Great Britain and Northern Ireland","2024-06-29",0,0,77,0,1,108,0,0
"United Kingdom of Great Britain and Northern Ireland","2024-06-30",0,0,77,0,1,109,0,0
"United Kingdom of Great Britain and Northern Ireland","2024-07-01",0,0,77,0,2,111,0,0
"United Kingdom of Great Britain and Northern Ireland","2024-07-02",0,0,77,0,1,112,0,0
"United Kingdom of Great Britain and Northern Ireland","2024-07-03",0,0,77,0,1,113,0,0
"United Kingdom of Great Britain and Northern Ireland","2024-07-04",0,0,77,0,1,114,0,0
"United Kingdom of Great Britain and Northern Ireland","2024-07-05",0,0,77,0,1,115,0,0
"United Kingdom of Great Britain and Northern Ireland","2024-07-06",0,0,77,0,1,116,0,0
"United Kingdom of Great Britain and Northern Ireland","2024-07-07",0,0,77,0,1,117,0,0
"United Kingdom of Great Britain and Northern Ireland","2024-07-08",0,0,77,0,1,118,0,0
"United Kingdom of Great Britain and Northern Ireland","2024-07-09",0,0,77,0,1,119,0,0
"United Kingdom of Great Britain and Northern Ireland","2024-07-10",0,0,77,0,1,120,0,0
"United Kingdom of Great Britain and Northern Ireland","2024-07-11",0,0,77,0,1,121,0,0
"United Kingdom of Great Britain and Northern Ireland","2024-07-12",0,0,77,0,1,122,0,0
"United Kingdom of Great Britain and Northern Ireland","2024-07-13",0,0,77,0,2,124,0,0
"United Kingdom of Great Britain and Northern Ireland","2024-07-14",0,0,77,0,1,125,0,0
"United Kingdom of Great Britain and Northern Ireland","2024-07-15",0,0,77,0,1,126,0,0
"United Kingdom of Great Britain and Northern Ireland","2024-07-16",0,0,77,0,1,127,0,0
"United Kingdom of Great Britain and Northern Ireland","2024-07-17",0,0,77,0,1,128,0,0
"United Kingdom of Great Britain and Northern Ireland","2024-07-18",0,0,77,0,1,129,0,0
"United Kingdom of Great Britain and Northern Ireland","2024-07-19",0,0,77,0,1,130,0,0
"United Kingdom of Great Britain and Northern Ireland","2024-07-20",0,0,77,0,1,131,0,0
"United Kingdom of Great Britain and Northern Ireland","2024-07-21",0,0,77,0,1,132,0,0
"United Kingdom of Great Britain and Northern Ireland","2024-07-22",0,0,77,0,1,133,0,0
"United Kingdom of Great Britain and Northern Ireland","2024-07-23",0,0,77,0,1,134,0,0
"United Kingdom of Great Britain and Northern Ireland","2024-07-24",0,0,77,0,1,135,0,0
"United Kingdom of Great Britain and Northern Ireland","2024-07-25",0,0,77,0,2,137,0,0
"United Kingdom of Great Britain and Northern Ireland","2024-07-26",0,0,77,0,1,138,0,0
"United Kingdom of Great Britain and Northern Ireland","2024-07-27",0,0,77,0,1,139,0,0
"United Kingdom of Great Britain and Northern Ireland","2024-07-28",0,0,77,0,1,140,0,0
"United Kingdom of Great Britain and Northern Ireland","2024-07-29",0,0,77,0,1,141,0,0
"United Kingdom of Great Britain and Northern Ireland","2024-07-30",0,0,77,0,1,142,0,0
"United Kingdom of Great Britain and Northern Ireland","2024-07-31",0,66,143,0,1,143,0,0
"United Kingdom of Great Britain and Northern Ireland","2024-08-01",0,0,143,0,1,144,0,0
"United Kingdom of Great Britain and Northern Ireland","2024-08-02",0,0,143,0,2,146,0,0
"United Kingdom of Great Britain and Northern Ireland","2024-08-03",0,0,143,0,1,147,0,0
"United Kingdom of Great Britain and Northern Ireland","2024-08-04",0,0,143,0,1,148,0,0
"United Kingdom of Great Britain and Northern Ireland","2024-08-05",0,0,143,0,1,149,0,0
"United Kingdom of Great Britain and Northern Ireland","2024-08-06",0,0,143,0,2,151,0,0
"United Kingdom of Great Britain and Northern Ireland","2024-08-07",0,0,143,0,1,152,0,0
"United Kingdom of Great Britain and Northern Ireland","2024-08-08",0,0,143,0,1,153,0,0
"United Kingdom of Great Britain and Northern Ireland","2024-08-09",0,0,143,0,2,155,0,0
"United Kingdom of Great Britain and Northern Ireland","2024-08-10",0,0,143,0,1,156,0,0
"United Kingdom of Great Britain and Northern Ireland","2024-08-11",0,0,143,0,1,157,0,0
"United Kingdom of Great Britain and Northern Ireland","2024-08-12",0,0,143,0,1,158,0,0
"United Kingdom of Great Britain and Northern Ireland","2024-08-13",0,0,143,0,2,160,0,0
"United Kingdom of Great Britain and Northern Ireland","2024-08-14",0,0,143,0,1,161,0,0
"United Kingdom of Great Britain and Northern Ireland","2024-08-15",0,0,143,0,1,162,0,0
"United Kingdom of Great Britain and Northern Ireland","2024-08-16",0,0,143,0,2,164,0,0
"United Kingdom of Great Britain and Northern Ireland","2024-08-17",0,0,143,0,1,165,0,0
"United Kingdom of Great Britain and Northern Ireland","2024-08-18",0,0,143,0,1,166,0,0
"United Kingdom of Great Britain and Northern Ireland","2024-08-19",0,0,143,0,2,168,0,0
"United Kingdom of Great Britain and Northern Ireland","2024-08-20",0,0,143,0,1,169,0,0
"United Kingdom of Great Britain and Northern Ireland","2024-08-21",0,0,143,0,1,170,0,0
"United Kingdom of Great Britain and Northern Ireland","2024-08-22",0,0,143,0,1,171,0,0
"United Kingdom of Great Britain and Northern Ireland","2024-08-23",0,0,143,0,2,173,0,0
"United Kingdom of Great Britain and Northern Ireland","2024-08-24",0,0,143,0,1,174,0,0
"United Kingdom of Great Britain and Northern Ireland","2024-08-25",0,0,143,0,1,175,0,0
"United Kingdom of Great Britain and Northern Ireland","2024-08-26",0,0,143,0,2,177,0,0
"United Kingdom of Great Britain and Northern Ireland","2024-08-27",0,0,143,0,1,178,0,0
"United Kingdom of Great Britain and Northern Ireland","2024-08-28",0,0,143,0,1,179,0,0
"United Kingdom of Great Britain and Northern Ireland","2024-08-29",0,0,143,0,1,180,0,0
"United Kingdom of Great Britain and Northern Ireland","2024-08-30",0,0,143,0,2,182,0,0
"United Kingdom of Great Britain and Northern Ireland","2024-08-31",0,40,183,0,1,183,0,0
"United Kingdom of Great Britain and Northern Ireland","2024-09-01",0,0,183,0,1,184,0,0
"United Kingdom of Great Britain and Northern Ireland","2024-09-02",0,0,183,0,2,186,0,0
"United Kingdom of Great Britain and Northern Ireland","2024-09-03",0,0,183,0,1,187,0,0
"United Kingdom of Great Britain and Northern Ireland","2024-09-04",0,0,183,0,2,189,0,0
"United Kingdom of Great Britain and Northern Ireland","2024-09-05",0,0,183,0,1,190,0,0
"United Kingdom of Great Britain and Northern Ireland","2024-09-06",0,0,183,0,1,191,0,0
"United Kingdom of Great Britain and Northern Ireland","2024-09-07",0,0,183,0,2,193,0,0
"United Kingdom of Great Britain and Northern Ireland","2024-09-08",0,0,183,0,1,194,0,0
"United Kingdom of Great Britain and Northern Ireland","2024-09-09",0,0,183,0,2,196,0,0
"United Kingdom of Great Britain and Northern Ireland","2024-09-10",0,0,183,0,1,197,0,0
"United Kingdom of Great Britain and Northern Ireland","2024-09-11",0,0,183,0,1,198,0,0
"United Kingdom of Great Britain and Northern Ireland","2024-09-12",0,0,183,0,2,200,0,0
"United Kingdom of Great Britain and Northern Ireland","2024-09-13",0,0,183,0,1,201,0,0
"United Kingdom of Great Britain and Northern Ireland","2024-09-14",0,0,183,0,2,203,0,0
"United Kingdom of Great Britain and Northern Ireland","2024-09-15",0,0,183,0,1,204,0,0
"United Kingdom of Great Britain and Northern Ireland","2024-09-16",0,0,183,0,1,205,0,0
"United Kingdom of Great Britain and Northern Ireland","2024-09-17",0,0,183,0,2,207,0,0
"United Kingdom of Great Britain and Northern Ireland","2024-09-18",0,0,183,0,1,208,0,0
"United Kingdom of Great Britain and Northern Ireland","2024-09-19",0,0,183,0,2,210,0,0
"United Kingdom of Great Britain and Northern Ireland","2024-09-20",0,0,183,0,1,211,0,0
"United Kingdom of Great Britain and Northern Ireland","2024-09-21",0,0,183,0,1,212,0,0
"United Kingdom of Great Britain and Northern Ireland","2024-09-22",0,0,183,0,2,214,0,0
"United Kingdom of Great Britain and Northern Ireland","2024-09-23",0,0,183,0,1,215,0,0
"United Kingdom of Great Britain and Northern Ireland","2024-09-24",0,0,183,0,2,217,0,0
"United Kingdom of Great Britain and Northern Ireland","2024-09-25",0,0,183,0,1,218,0,0
"United Kingdom of Great Britain and Northern Ireland","2024-09-26",0,0,183,0,1,219,0,0
"United Kingdom of Great Britain and Northern Ireland","2024-09-27",0,0,183,0,2,221,0,0
"United Kingdom of Great Britain and Northern Ireland","2024-09-28",0,0,183,0,1,222,0,0
"United Kingdom of Great Britain and Northern Ireland","2024-09-29",0,0,183,0,2,224,0,0
"United Kingdom of Great Britain and Northern Ireland","2024-09-30",0,42,225,0,1,225,0,0
"United Kingdom of Great Britain and Northern Ireland","2024-10-01",0,0,225,0,0,225,0,0
"United Kingdom of Great Britain and Northern Ireland","2024-10-02",0,0,225,0,1,226,0,0
"United Kingdom of Great Britain and Northern Ireland","2024-10-03",0,0,225,0,0,226,0,0
"United Kingdom of Great Britain and Northern Ireland","2024-10-04",0,0,225,0,0,226,0,0
"United Kingdom of Great Britain and Northern Ireland","2024-10-05",0,0,225,0,1,227,0,0
"United Kingdom of Great Britain and Northern Ireland","2024-10-06",0,0,225,0,0,227,0,0
"United Kingdom of Great Britain and Northern Ireland","2024-10-07",0,0,225,0,0,227,0,0
"United Kingdom of Great Britain and Northern Ireland","2024-10-08",0,0,225,0,1,228,0,0
"United Kingdom of Great Britain and Northern Ireland","2024-10-09",0,0,225,0,0,228,0,0
"United Kingdom of Great Britain and Northern Ireland","2024-10-10",0,0,225,0,0,228,0,0
"United Kingdom of Great Britain and Northern Ireland","2024-10-11",0,0,225,0,1,229,0,0
"United Kingdom of Great Britain and Northern Ireland","2024-10-12",0,0,225,0,0,229,0,0
"United Kingdom of Great Britain and Northern Ireland","2024-10-13",0,0,225,0,0,229,0,0
"United Kingdom of Great Britain and Northern Ireland","2024-10-14",0,0,225,0,1,230,0,0
"United Kingdom of Great Britain and Northern Ireland","2024-10-15",0,0,225,0,0,230,0,0
"United Kingdom of Great Britain and Northern Ireland","2024-10-16",0,0,225,0,0,230,0,0
"United Kingdom of Great Britain and Northern Ireland","2024-10-17",0,0,225,0,0,230,0,0
"United Kingdom of Great Britain and Northern Ireland","2024-10-18",0,0,225,0,1,231,0,0
"United Kingdom of Great Britain and Northern Ireland","2024-10-19",0,0,225,0,0,231,0,0
"United Kingdom of Great Britain and Northern Ireland","2024-10-20",0,0,225,0,0,231,0,0
"United Kingdom of Great Britain and Northern Ireland","2024-10-21",0,0,225,0,1,232,0,0
"United Kingdom of Great Britain and Northern Ireland","2024-10-22",0,0,225,0,0,232,0,0
"United Kingdom of Great Britain and Northern Ireland","2024-10-23",0,0,225,0,0,232,0,0
"United Kingdom of Great Britain and Northern Ireland","2024-10-24",0,0,225,0,1,233,0,0
"United Kingdom of Great Britain and Northern Ireland","2024-10-25",0,0,225,0,0,233,0,0
"United Kingdom of Great Britain and Northern Ireland","2024-10-26",0,0,225,0,0,233,0,0
"United Kingdom of Great Britain and Northern Ireland","2024-10-27",0,0,225,0,1,234,0,0
"United Kingdom of Great Britain and Northern Ireland","2024-10-28",0,0,225,0,0,234,0,0
"United Kingdom of Great Britain and Northern Ireland","2024-10-29",0,0,225,0,0,234,0,0
"United Kingdom of Great Britain and Northern Ireland","2024-10-30",0,0,225,0,1,235,0,0
"United Kingdom of Great Britain and Northern Ireland","2024-10-31",0,10,235,0,0,235,0,0
"United Kingdom of Great Britain and Northern Ireland","2024-11-01",0,0,235,0,1,236,0,0
"United Kingdom of Great Britain and Northern Ireland","2024-11-02",0,0,235,0,1,237,0,0
"United Kingdom of Great Britain and Northern Ireland","2024-11-03",0,0,235,0,2,239,0,0
"United Kingdom of Great Britain and Northern Ireland","2024-11-04",0,0,235,0,1,240,0,0
"United Kingdom of Great Britain and Northern Ireland","2024-11-05",0,0,235,0,1,241,0,0
"United Kingdom of Great Britain and Northern Ireland","2024-11-06",0,0,235,0,1,242,0,0
"United Kingdom of Great Britain and Northern Ireland","2024-11-07",0,0,235,0,1,243,0,0
"United Kingdom of Great Britain and Northern Ireland","2024-11-08",0,0,235,0,2,245,0,0
"United Kingdom of Great Britain and Northern Ireland","2024-11-09",0,0,235,0,1,246,0,0
"United Kingdom of Great Britain and Northern Ireland","2024-11-10",0,0,235,0,1,247,0,0
"United Kingdom of Great Britain and Northern Ireland","2024-11-11",0,0,235,0,1,248,0,0
"United Kingdom of Great Britain and Northern Ireland","2024-11-12",0,0,235,0,1,249,0,0
"United Kingdom of Great Britain and Northern Ireland","2024-11-13",0,0,235,0,2,251,0,0
"United Kingdom of Great Britain and Northern Ireland","2024-11-14",0,0,235,0,1,252,0,0
"United Kingdom of Great Britain and Northern Ireland","2024-11-15",0,0,235,0,1,253,0,0
"United Kingdom of Great Britain and Northern Ireland","2024-11-16",0,0,235,0,1,254,0,0
"United Kingdom of Great Britain and Northern Ireland","2024-11-17",0,0,235,0,1,255,0,0
"United Kingdom of Great Britain and Northern Ireland","2024-11-18",0,0,235,0,2,257,0,0
"United Kingdom of Great Britain and Northern Ireland","2024-11-19",0,0,235,0,1,258,0,0
"United Kingdom of Great Britain and Northern Ireland","2024-11-20",0,0,235,0,1,259,0,0
"United Kingdom of Great Britain and Northern Ireland","2024-11-21",0,0,235,0,1,260,0,0
"United Kingdom of Great Britain and Northern Ireland","2024-11-22",0,0,235,0,1,261,0,0
"United Kingdom of Great Britain and Northern Ireland","2024-11-23",0,0,235,0,2,263,0,0
"United Kingdom of Great Britain and Northern Ireland","2024-11-24",0,0,235,0,1,264,0,0
"United Kingdom of Great Britain and Northern Ireland","2024-11-25",0,0,235,0,1,265,0,0
"United Kingdom of Great Britain and Northern Ireland","2024-11-26",0,0,235,0,1,266,0,0
"United Kingdom of Great Britain and Northern Ireland","2024-11-27",0,0,235,0,1,267,0,0
"United Kingdom of Great Britain and Northern Ireland","2024-11-28",0,0,235,0,2,269,0,0
"United Kingdom of Great Britain and Northern Ireland","2024-11-29",0,0,235,0,1,270,0,0
"United Kingdom of Great Britain and Northern Ireland","2024-11-30",0,36,271,0,1,271,0,0
"United Kingdom of Great Britain and Northern Ireland","2024-12-01",0,0,271,0,1,272,0,0
"United Kingdom of Great Britain and Northern Ireland","2024-12-02",0,0,271,0,0,272,0,0
"United Kingdom of Great Britain and Northern Ireland","2024-12-03",0,0,271,0,1,273,0,0
"United Kingdom of Great Britain and Northern Ireland","2024-12-04",0,0,271,0,1,274,0,0
"United Kingdom of Great Britain and Northern Ireland","2024-12-05",0,0,271,0,0,274,0,0
"United Kingdom of Great Britain and Northern Ireland","2024-12-06",0,0,271,0,1,275,0,0
"United Kingdom of Great Britain and Northern Ireland","2024-12-07",0,0,271,0,1,276,0,0
"United Kingdom of Great Britain and Northern Ireland","2024-12-08",0,0,271,0,0,276,0,0
"United Kingdom of Great Britain and Northern Ireland","2024-12-09",0,0,271,0,1,277,0,0
"United Kingdom of Great Britain and Northern Ireland","2024-12-10",0,0,271,0,0,277,0,0
"United Kingdom of Great Britain and Northern Ireland","2024-12-11",0,0,271,0,1,278,0,0
"United Kingdom of Great Britain and Northern Ireland","2024-12-12",0,0,271,0,1,279,0,0
"United Kingdom of Great Britain and Northern Ireland","2024-12-13",0,0,271,0,0,279,0,0
"United Kingdom of Great Britain and Northern Ireland","2024-12-14",0,0,271,0,1,280,0,0
"United Kingdom of Great Britain and Northern Ireland","2024-12-15",0,0,271,0,1,281,0,0
"United Kingdom of Great Britain and Northern Ireland","2024-12-16",0,0,271,0,0,281,0,0
"United Kingdom of Great Britain and Northern Ireland","2024-12-17",0,0,271,0,1,282,0,0
"United Kingdom of Great Britain and Northern Ireland","2024-12-18",0,0,271,0,1,283,0,0
"United Kingdom of Great Britain and Northern Ireland","2024-12-19",0,0,271,0,0,283,0,0
"United Kingdom of Great Britain and Northern Ireland","2024-12-20",0,0,271,0,1,284,0,0
"United Kingdom of Great Britain and Northern Ireland","2024-12-21",0,0,271,0,1,285,0,0
"United Kingdom of Great Britain and Northern Ireland","2024-12-22",0,0,271,0,0,285,0,0
"United Kingdom of Great Britain and Northern Ireland","2024-12-23",0,0,271,0,1,286,0,0
"United Kingdom of Great Britain and Northern Ireland","2024-12-24",0,0,271,0,0,286,0,0
"United Kingdom of Great Britain and Northern Ireland","2024-12-25",0,0,271,0,1,287,0,0
"United Kingdom of Great Britain and Northern Ireland","2024-12-26",0,0,271,0,1,288,0,0
"United Kingdom of Great Britain and Northern Ireland","2024-12-27",0,0,271,0,0,288,0,0
"United Kingdom of Great Britain and Northern Ireland","2024-12-28",0,0,271,0,1,289,0,0
"United Kingdom of Great Britain and Northern Ireland","2024-12-29",0,0,271,0,1,290,0,0
"United Kingdom of Great Britain and Northern Ireland","2024-12-30",0,0,271,0,0,290,0,0
"United Kingdom of Great Britain and Northern Ireland","2024-12-31",0,20,291,0,1,291,0,0
"United Kingdom of Great Britain and Northern Ireland","2025-01-01",0,0,291,0,0,291,0,0
"United Kingdom of Great Britain and Northern Ireland","2025-01-02",0,0,291,0,0,291,0,0
"United Kingdom of Great Britain and Northern Ireland","2025-01-03",0,0,291,0,0,291,0,0
"United Kingdom of Great Britain and Northern Ireland","2025-01-04",0,0,291,0,0,291,0,0
"United Kingdom of Great Britain and Northern Ireland","2025-01-05",0,0,291,0,0,291,0,0
"United Kingdom of Great Britain and Northern Ireland","2025-01-06",0,0,291,0,0,291,0,0
"United Kingdom of Great Britain and Northern Ireland","2025-01-07",0,0,291,0,0,291,0,0
"United Kingdom of Great Britain and Northern Ireland","2025-01-08",0,0,291,0,0,291,0,0
"United Kingdom of Great Britain and Northern Ireland","2025-01-09",0,0,291,0,0,291,0,0
"United Kingdom of Great Britain and Northern Ireland","2025-01-10",0,0,291,0,0,291,0,0
"United Kingdom of Great Britain and Northern Ireland","2025-01-11",0,0,291,0,0,291,0,0
"United Kingdom of Great Britain and Northern Ireland","2025-01-12",0,0,291,0,0,291,0,0
"United Kingdom of Great Britain and Northern Ireland","2025-01-13",0,0,291,0,0,291,0,0
"United Kingdom of Great Britain and Northern Ireland","2025-01-14",0,0,291,0,0,291,0,0
"United Kingdom of Great Britain and Northern Ireland","2025-01-15",0,0,291,0,0,291,0,0
"United Kingdom of Great Britain and Northern Ireland","2025-01-16",0,0,291,0,0,291,0,0
"United Kingdom of Great Britain and Northern Ireland","2025-01-17",0,0,291,0,0,291,0,0
"United Kingdom of Great Britain and Northern Ireland","2025-01-18",0,0,291,0,0,291,0,0
"United Kingdom of Great Britain and Northern Ireland","2025-01-19",0,0,291,0,0,291,0,0
"United Kingdom of Great Britain and Northern Ireland","2025-01-20",0,0,291,0,0,291,0,0
"United Kingdom of Great Britain and Northern Ireland","2025-01-21",0,0,291,0,0,291,0,0
"United Kingdom of Great Britain and Northern Ireland","2025-01-22",0,0,291,0,0,291,0,0
"United Kingdom of Great Britain and Northern Ireland","2025-01-23",0,0,291,0,0,291,0,0
"United Kingdom of Great Britain and Northern Ireland","2025-01-24",0,0,291,0,0,291,0,0
"United Kingdom of Great Britain and Northern Ireland","2025-01-25",0,0,291,0,0,291,0,0
"United Kingdom of Great Britain and Northern Ireland","2025-01-26",0,0,291,0,0,291,0,0
"United Kingdom of Great Britain and Northern Ireland","2025-01-27",0,0,291,0,0,291,0,0
"United Kingdom of Great Britain and Northern Ireland","2025-01-28",0,0,291,0,0,291,0,0
"United Kingdom of Great Britain and Northern Ireland","2025-01-29",0,0,291,0,0,291,0,0
"United Kingdom of Great Britain and Northern Ireland","2025-01-30",0,0,291,0,0,291,0,0
"United Kingdom of Great Britain and Northern Ireland","2025-01-31",0,0,291,0,0,291,0,0
"United Kingdom of Great Britain and Northern Ireland","2025-02-01",0,0,291,0,0,291,0,0
"United Kingdom of Great Britain and Northern Ireland","2025-02-02",0,0,291,0,0,291,0,0
"United Kingdom of Great Britain and Northern Ireland","2025-02-03",0,0,291,0,0,291,0,0
"United States of America","2024-01-01",0,0,0,0,0,0,0,0
"United States of America","2024-01-02",0,50,50,0,50,50,0,0
"United States of America","2024-01-03",0,0,50,0,8,58,0,0
"United States of America","2024-01-04",0,0,50,0,8,66,0,0
"United States of America","2024-01-05",0,0,50,0,8,74,0,0
"United States of America","2024-01-06",0,0,50,0,8,82,0,0
"United States of America","2024-01-07",0,0,50,0,8,90,0,0
"United States of America","2024-01-08",0,0,50,0,8,98,0,0
"United States of America","2024-01-09",0,56,106,0,8,106,0,0
"United States of America","2024-01-10",0,0,106,0,10,116,0,0
"United States of America","2024-01-11",0,0,106,0,10,126,0,0
"United States of America","2024-01-12",0,0,106,0,10,136,0,0
"United States of America","2024-01-13",0,0,106,0,11,147,0,0
"United States of America","2024-01-14",0,0,106,0,10,157,0,0
"United States of America","2024-01-15",0,0,106,0,10,167,0,0
"United States of America","2024-01-16",0,71,177,0,10,177,0,0
"United States of America","2024-01-17",0,0,177,0,7,184,0,0
"United States of America","2024-01-18",0,0,177,0,7,191,0,0
"United States of America","2024-01-19",0,0,177,0,7,198,0,0
"United States of America","2024-01-20",0,0,177,0,7,205,0,0
"United States of America","2024-01-21",0,0,177,0,7,212,0,0
"United States of America","2024-01-22",0,0,177,0,7,219,0,0
"United States of America","2024-01-23",0,49,226,0,7,226,0,0
"United States of America","2024-01-24",0,0,226,0,12,238,0,0
"United States of America","2024-01-25",0,0,226,0,12,250,0,0
"United States of America","2024-01-26",0,0,226,0,12,262,0,0
"United States of America","2024-01-27",0,0,226,0,11,273,0,0
"United States of America","2024-01-28",0,0,226,0,12,285,0,0
"United States of America","2024-01-29",0,0,226,0,12,297,0,0
"United States of America","2024-01-30",0,83,309,0,12,309,0,0
"United States of America","2024-01-31",0,0,309,0,8,317,0,0
"United States of America","2024-02-01",0,0,309,0,9,326,0,0
"United States of America","2024-02-02",0,0,309,0,8,334,0,0
"United States of America","2024-02-03",0,0,309,0,9,343,0,0
"United States of America","2024-02-04",0,0,309,0,8,351,0,0
"United States of America","2024-02-05",0,0,309,0,9,360,0,0
"United States of America","2024-02-06",0,59,368,0,8,368,0,0
"United States of America","2024-02-07",0,0,368,0,8,376,0,0
"United States of America","2024-02-08",0,0,368,0,9,385,0,0
"United States of America","2024-02-09",0,0,368,0,8,393,0,0
"United States of America","2024-02-10",0,0,368,0,8,401,0,0
"United States of America","2024-02-11",0,0,368,0,8,409,0,0
"United States of America","2024-02-12",0,0,368,0,9,418,0,0
"United States of America","2024-02-13",0,58,426,0,8,426,0,0
"United States of America","2024-02-14",0,0,426,0,8,434,0,0
"United States of America","2024-02-15",0,0,426,0,9,443,0,0
"United States of America","2024-02-16",0,0,426,0,8,451,0,0
"United States of America","2024-02-17",0,0,426,0,8,459,0,0
"United States of America","2024-02-18",0,0,426,0,8,467,0,0
"United States of America","2024-02-19",0,0,426,0,9,476,0,0
"United States of America","2024-02-20",0,58,484,0,8,484,0,0
"United States of America","2024-02-21",0,0,484,0,11,495,0,0
"United States of America","2024-02-22",0,0,484,0,10,505,0,0
"United States of America","2024-02-23",0,0,484,0,11,516,0,0
"United States of America","2024-02-24",0,0,484,0,10,526,0,0
"United States of America","2024-02-25",0,0,484,0,11,537,0,0
"United States of America","2024-02-26",0,0,484,0,10,547,0,0
"United States of America","2024-02-27",0,74,558,0,11,558,0,0
"United States of America","2024-02-28",0,0,558,0,10,568,0,0
"United States of America","2024-02-29",0,0,558,0,10,578,0,0
"United States of America","2024-03-01",0,0,558,0,10,588,0,0
"United States of America","2024-03-02",0,0,558,0,9,597,0,0
"United States of America","2024-03-03",0,0,558,0,10,607,0,0
"United States of America","2024-03-04",0,0,558,0,10,617,0,0
"United States of America","2024-03-05",0,69,627,0,10,627,0,0
"United States of America","2024-03-06",0,0,627,0,11,638,0,0
"United States of America","2024-03-07",0,0,627,0,12,650,0,0
"United States of America","2024-03-08",0,0,627,0,11,661,0,0
"United States of America","2024-03-09",0,0,627,0,12,673,0,0
"United States of America","2024-03-10",0,0,627,0,11,684,0,0
"United States of America","2024-03-11",0,0,627,0,12,696,0,0
"United States of America","2024-03-12",0,80,707,0,11,707,0,0
"United States of America","2024-03-13",0,0,707,0,8,715,0,0
"United States of America","2024-03-14",0,0,707,0,8,723,0,0
"United States of America","2024-03-15",0,0,707,0,8,731,0,0
"United States of America","2024-03-16",0,0,707,0,7,738,0,0
"United States of America","2024-03-17",0,0,707,0,8,746,0,0
"United States of America","2024-03-18",0,0,707,0,8,754,0,0
"United States of America","2024-03-19",0,55,762,0,8,762,0,0
"United States of America","2024-03-20",0,0,762,0,9,771,0,0
"United States of America","2024-03-21",0,0,762,0,9,780,0,0
"United States of America","2024-03-22",0,0,762,0,9,789,0,0
"United States of America","2024-03-23",0,0,762,0,8,797,0,0
"United States of America","2024-03-24",0,0,762,0,9,806,0,0
"United States of America","2024-03-25",0,0,762,0,9,815,0,0
"United States of America","2024-03-26",0,62,824,0,9,824,0,0
"United States of America","2024-03-27",0,0,824,0,7,831,0,0
"United States of America","2024-03-28",0,0,824,0,6,837,0,0
"United States of America","2024-03-29",0,0,824,0,7,844,0,0
"United States of America","2024-03-30",0,0,824,0,7,851,0,0
"United States of America","2024-03-31",0,0,824,0,7,858,0,0
"United States of America","2024-04-01",0,0,824,0,6,864,0,0
"United States of America","2024-04-02",0,47,871,0,7,871,0,0
"United States of America","2024-04-03",0,0,871,0,10,881,0,0
"United States of America","2024-04-04",0,0,871,0,9,890,0,0
"United States of America","2024-04-05",0,0,871,0,10,900,0,0
"United States of America","2024-04-06",0,0,871,0,10,910,0,0
"United States of America","2024-04-07",0,0,871,0,10,920,0,0
"United States of America","2024-04-08",0,0,871,0,9,929,0,0
"United States of America","2024-04-09",0,68,939,0,10,939,0,0
"United States of America","2024-04-10",0,0,939,0,11,950,0,0
"United States of America","2024-04-11",0,0,939,0,11,961,0,0
"United States of America","2024-04-12",0,0,939,0,11,972,0,0
"United States of America","2024-04-13",0,0,939,0,11,983,0,0
"United States of America","2024-04-14",0,0,939,0,11,994,0,0
"United States of America","2024-04-15",0,0,939,0,11,1005,0,0
"United States of America","2024-04-16",0,77,1016,0,11,1016,0,0
"United States of America","2024-04-17",0,0,1016,0,11,1027,0,0
"United States of America","2024-04-18",0,0,1016,0,12,1039,0,0
"United States of America","2024-04-19",0,0,1016,0,11,1050,0,0
"United States of America","2024-04-20",0,0,1016,0,11,1061,0,0
"United States of America","2024-04-21",0,0,1016,0,11,1072,0,0
"United States of America","2024-04-22",0,0,1016,0,12,1084,0,0
"United States of America","2024-04-23",0,79,1095,0,11,1095,0,0
"United States of America","2024-04-24",0,0,1095,0,7,1102,0,0
"United States of America","2024-04-25",0,0,1095,0,8,1110,0,0
"United States of America","2024-04-26",0,0,1095,0,7,1117,0,0
"United States of America","2024-04-27",0,0,1095,0,8,1125,0,0
"United States of America","2024-04-28",0,0,1095,0,7,1132,0,0
"United States of America","2024-04-29",0,0,1095,0,8,1140,0,0
"United States of America","2024-04-30",0,52,1147,0,7,1147,0,0
"United States of America","2024-05-01",0,0,1147,0,8,1155,0,0
"United States of America","2024-05-02",0,0,1147,0,8,1163,0,0
"United States of America","2024-05-03",0,0,1147,0,8,1171,0,0
"United States of America","2024-05-04",0,0,1147,0,7,1178,0,0
"United States of America","2024-05-05",0,0,1147,0,8,1186,0,0
"United States of America","2024-05-06",0,0,1147,0,8,1194,0,0
"United States of America","2024-05-07",0,55,1202,0,8,1202,0,0
"United States of America","2024-05-08",0,0,1202,0,7,1209,0,0
"United States of America","2024-05-09",0,0,1202,0,7,1216,0,0
"United States of America","2024-05-10",0,0,1202,0,7,1223,0,0
"United States of America","2024-05-11",0,0,1202,0,7,1230,0,0
"United States of America","2024-05-12",0,0,1202,0,7,1237,0,0
"United States of America","2024-05-13",0,0,1202,0,7,1244,0,0
"United States of America","2024-05-14",0,49,1251,0,7,1251,0,0
"United States of America","2024-05-15",0,0,1251,0,8,1259,0,0
"United States of America","2024-05-16",0,0,1251,0,9,1268,0,0
"United States of America","2024-05-17",0,0,1251,0,8,1276,0,0
"United States of America","2024-05-18",0,0,1251,0,8,1284,0,0
"United States of America","2024-05-19",0,0,1251,0,8,1292,0,0
"United States of America","2024-05-20",0,0,1251,0,9,1301,0,0
"United States of America","2024-05-21",0,58,1309,0,8,1309,0,0
"United States of America","2024-05-22",0,0,1309,0,8,1317,0,0
"United States of America","2024-05-23",0,0,1309,0,9,1326,0,0
"United States of America","2024-05-24",0,0,1309,0,8,1334,0,0
"United States of America","2024-05-25",0,0,1309,0,8,1342,0,0
"United States of America","2024-05-26",0,0,1309,0,8,1350,0,0
"United States of America","2024-05-27",0,0,1309,0,9,1359,0,0
"United States of America","2024-05-28",0,58,1367,0,8,1367,0,0
"United States of America","2024-05-29",0,0,1367,0,9,1376,0,0
"United States of America","2024-05-30",0,0,1367,0,8,1384,0,0
"United States of America","2024-05-31",0,0,1367,0,9,1393,0,0
"United States of America","2024-06-01",0,0,1367,0,8,1401,0,0
"United States of America","2024-06-02",0,0,1367,0,9,1410,0,0
"United States of America","2024-06-03",0,0,1367,0,8,1418,0,0
"United States of America","2024-06-04",0,60,1427,0,9,1427,0,0
"United States of America","2024-06-05",0,0,1427,0,10,1437,0,0
"United States of America","2024-06-06",0,0,1427,0,11,1448,0,0
"United States of America","2024-06-07",0,0,1427,0,10,1458,0,0
"United States of America","2024-06-08",0,0,1427,0,10,1468,0,0
"United States of America","2024-06-09",0,0,1427,0,10,1478,0,0
"United States of America","2024-06-10",0,0,1427,0,11,1489,0,0
"United States of America","2024-06-11",0,72,1499,0,10,1499,0,0
"United States of America","2024-06-12",0,0,1499,0,7,1506,0,0
"United States of America","2024-06-13",0,0,1499,0,7,1513,0,0
"United States of America","2024-06-14",0,0,1499,0,7,1520,0,0
"United States of America","2024-06-15",0,0,1499,0,6,1526,0,0
"United States of America","2024-06-16",0,0,1499,0,7,1533,0,0
"United States of America","2024-06-17",0,0,1499,0,7,1540,0,0
"United States of America","2024-06-18",0,48,1547,0,7,1547,0,0
"United States of America","2024-06-19",0,0,1547,0,7,1554,0,0
"United States of America","2024-06-20",0,0,1547,0,7,1561,0,0
"United States of America","2024-06-21",0,0,1547,0,7,1568,0,0
"United States of America","2024-06-22",0,0,1547,0,6,1574,0,0
"United States of America","2024-06-23",0,0,1547,0,7,1581,0,0
"United States of America","2024-06-24",0,0,1547,0,7,1588,0,0
"United States of America","2024-06-25",0,48,1595,0,7,1595,0,0
"United States of America","2024-06-26",0,0,1595,0,7,1602,0,0
"United States of America","2024-06-27",0,0,1595,0,7,1609,0,0
"United States of America","2024-06-28",0,0,1595,0,7,1616,0,0
"United States of America","2024-06-29",0,0,1595,0,8,1624,0,0
"United States of America","2024-06-30",0,0,1595,0,7,1631,0,0
"United States of America","2024-07-01",0,0,1595,0,7,1638,0,0
"United States of America","2024-07-02",0,50,1645,0,7,1645,0,0
"United States of America","2024-07-03",0,0,1645,0,8,1653,0,0
"United States of America","2024-07-04",0,0,1645,0,8,1661,0,0
"United States of America","2024-07-05",0,0,1645,0,8,1669,0,0
"United States of America","2024-07-06",0,0,1645,0,9,1678,0,0
"United States of America","2024-07-07",0,0,1645,0,8,1686,0,0
"United States of America","2024-07-08",0,0,1645,0,8,1694,0,0
"United States of America","2024-07-09",0,57,1702,0,8,1702,0,0
"United States of America","2024-07-10",0,0,1702,0,9,1711,0,0
"United States of America","2024-07-11",0,0,1702,0,10,1721,0,0
"United States of America","2024-07-12",0,0,1702,0,9,1730,0,0
"United States of America","2024-07-13",0,0,1702,0,9,1739,0,0
"United States of America","2024-07-14",0,0,1702,0,9,1748,0,0
"United States of America","2024-07-15",0,0,1702,0,10,1758,0,0
"United States of America","2024-07-16",0,65,1767,0,9,1767,0,0
"United States of America","2024-07-17",0,0,1767,0,6,1773,0,0
"United States of America","2024-07-18",0,0,1767,0,6,1779,0,0
"United States of America","2024-07-19",0,0,1767,0,6,1785,0,0
"United States of America","2024-07-20",0,0,1767,0,7,1792,0,0
"United States of America","2024-07-21",0,0,1767,0,6,1798,0,0
"United States of America","2024-07-22",0,0,1767,0,6,1804,0,0
"United States of America","2024-07-23",0,43,1810,0,6,1810,0,0
"United States of America","2024-07-24",0,0,1810,0,8,1818,0,0
"United States of America","2024-07-25",0,0,1810,0,8,1826,0,0
"United States of America","2024-07-26",0,0,1810,0,8,1834,0,0
"United States of America","2024-07-27",0,0,1810,0,7,1841,0,0
"United States of America","2024-07-28",0,0,1810,0,8,1849,0,0
"United States of America","2024-07-29",0,0,1810,0,8,1857,0,0
"United States of America","2024-07-30",0,55,1865,0,8,1865,0,0
"United States of America","2024-07-31",0,0,1865,0,8,1873,0,0
"United States of America","2024-08-01",0,0,1865,0,8,1881,0,0
"United States of America","2024-08-02",0,0,1865,0,8,1889,0,0
"United States of America","2024-08-03",0,0,1865,0,8,1897,0,0
"United States of America","2024-08-04",0,0,1865,0,8,1905,0,0
"United States of America","2024-08-05",0,0,1865,0,8,1913,0,0
"United States of America","2024-08-06",0,56,1921,0,8,1921,0,0
"United States of America","2024-08-07",0,0,1921,0,10,1931,0,0
"United States of America","2024-08-08",0,0,1921,0,9,1940,0,0
"United States of America","2024-08-09",0,0,1921,0,10,1950,0,0
"United States of America","2024-08-10",0,0,1921,0,10,1960,0,0
"United States of America","2024-08-11",0,0,1921,0,10,1970,0,0
"United States of America","2024-08-12",0,0,1921,0,9,1979,0,0
"United States of America","2024-08-13",0,68,1989,0,10,1989,0,0
"United States of America","2024-08-14",0,0,1989,0,9,1998,0,0
"United States of America","2024-08-15",0,0,1989,0,9,2007,0,0
"United States of America","2024-08-16",0,0,1989,0,9,2016,0,0
"United States of America","2024-08-17",0,0,1989,0,9,2025,0,0
"United States of America","2024-08-18",0,0,1989,0,9,2034,0,0
"United States of America","2024-08-19",0,0,1989,0,9,2043,0,0
"United States of America","2024-08-20",0,63,2052,0,9,2052,0,0
"United States of America","2024-08-21",0,0,2052,0,8,2060,0,0
"United States of America","2024-08-22",0,0,2052,0,9,2069,0,0
"United States of America","2024-08-23",0,0,2052,0,8,2077,0,0
"United States of America","2024-08-24",0,0,2052,0,9,2086,0,0
"United States of America","2024-08-25",0,0,2052,0,8,2094,0,0
"United States of America","2024-08-26",0,0,2052,0,9,2103,0,0
"United States of America","2024-08-27",0,59,2111,0,8,2111,0,0
"United States of America","2024-08-28",0,0,2111,0,10,2121,0,0
"United States of America","2024-08-29",0,0,2111,0,9,2130,0,0
"United States of America","2024-08-30",0,0,2111,0,10,2140,0,0
"United States of America","2024-08-31",0,0,2111,0,9,2149,0,0
"United States of America","2024-09-01",0,0,2111,0,10,2159,0,0
"United States of America","2024-09-02",0,0,2111,0,9,2168,0,0
"United States of America","2024-09-03",0,67,2178,0,10,2178,0,0
"United States of America","2024-09-04",0,0,2178,0,10,2188,0,0
"United States of America","2024-09-05",0,0,2178,0,9,2197,0,0
"United States of America","2024-09-06",0,0,2178,0,10,2207,0,0
"United States of America","2024-09-07",0,0,2178,0,9,2216,0,0
"United States of America","2024-09-08",0,0,2178,0,10,2226,0,0
"United States of America","2024-09-09",0,0,2178,0,9,2235,0,0
"United States of America","2024-09-10",0,67,2245,0,10,2245,0,0
"United States of America","2024-09-11",0,0,2245,0,7,2252,0,0
"United States of America","2024-09-12",0,0,2245,0,6,2258,0,0
"United States of America","2024-09-13",0,0,2245,0,7,2265,0,0
"United States of America","2024-09-14",0,0,2245,0,6,2271,0,0
"United States of America","2024-09-15",0,0,2245,0,7,2278,0,0
"United States of America","2024-09-16",0,0,2245,0,6,2284,0,0
"United States of America","2024-09-17",0,46,2291,0,7,2291,0,0
"United States of America","2024-09-18",0,0,2291,0,9,2300,0,0
"United States of America","2024-09-19",0,0,2291,0,8,2308,0,0
"United States of America","2024-09-20",0,0,2291,0,9,2317,0,0
"United States of America","2024-09-21",0,0,2291,0,8,2325,0,0
"United States of America","2024-09-22",0,0,2291,0,9,2334,0,0
"United States of America","2024-09-23",0,0,2291,0,8,2342,0,0
"United States of America","2024-09-24",0,60,2351,0,9,2351,0,0
"United States of America","2024-09-25",0,0,2351,0,6,2357,0,0
"United States of America","2024-09-26",0,0,2351,0,7,2364,0,0
"United States of America","2024-09-27",0,0,2351,0,6,2370,0,0
"United States of America","2024-09-28",0,0,2351,0,7,2377,0,0
"United States of America","2024-09-29",0,0,2351,0,6,2383,0,0
"United States of America","2024-09-30",0,0,2351,0,7,2390,0,0
"United States of America","2024-10-01",0,45,2396,0,6,2396,0,0
"United States of America","2024-10-02",0,0,2396,0,5,2401,0,0
"United States of America","2024-10-03",0,0,2396,0,6,2407,0,0
"United States of America","2024-10-04",0,0,2396,0,5,2412,0,0
"United States of America","2024-10-05",0,0,2396,0,5,2417,0,0
"United States of America","2024-10-06",0,0,2396,0,5,2422,0,0
"United States of America","2024-10-07",0,0,2396,0,6,2428,0,0
"United States of America","2024-10-08",0,37,2433,0,5,2433,0,0
"United States of America","2024-10-09",0,0,2433,0,3,2436,0,0
"United States of America","2024-10-10",0,0,2433,0,4,2440,0,0
"United States of America","2024-10-11",0,0,2433,0,3,2443,0,0
"United States of America","2024-10-12",0,0,2433,0,3,2446,0,0
"United States of America","2024-10-13",0,0,2433,0,3,2449,0,0
"United States of America","2024-10-14",0,0,2433,0,4,2453,0,0
"United States of America","2024-10-15",0,23,2456,0,3,2456,0,0
"United States of America","2024-10-16",0,0,2456,0,5,2461,0,0
"United States of America","2024-10-17",0,0,2456,0,6,2467,0,0
"United States of America","2024-10-18",0,0,2456,0,5,2472,0,0
"United States of America","2024-10-19",0,0,2456,0,5,2477,0,0
"United States of America","2024-10-20",0,0,2456,0,5,2482,0,0
"United States of America","2024-10-21",0,0,2456,0,6,2488,0,0
"United States of America","2024-10-22",0,37,2493,0,5,2493,0,0
"United States of America","2024-10-23",0,0,2493,0,4,2497,0,0
"United States of America","2024-10-24",0,0,2493,0,4,2501,0,0
"United States of America","2024-10-25",0,0,2493,0,4,2505,0,0
"United States of America","2024-10-26",0,0,2493,0,5,2510,0,0
"United States of America","2024-10-27",0,0,2493,0,4,2514,0,0
"United States of America","2024-10-28",0,0,2493,0,4,2518,0,0
"United States of America","2024-10-29",0,29,2522,0,4,2522,0,0
"United States of America","2024-10-30",0,0,2522,0,4,2526,0,0
"United States of America","2024-10-31",0,0,2522,0,4,2530,0,0
"United States of America","2024-11-01",0,0,2522,0,4,2534,0,0
"United States of America","2024-11-02",0,0,2522,0,5,2539,0,0
"United States of America","2024-11-03",0,0,2522,0,4,2543,0,0
"United States of America","2024-11-04",0,0,2522,0,4,2547,0,0
"United States of America","2024-11-05",0,29,2551,0,4,2551,0,0
"United States of America","2024-11-06",0,0,2551,0,5,2556,0,0
"United States of America","2024-11-07",0,0,2551,0,4,2560,0,0
"United States of America","2024-11-08",0,0,2551,0,5,2565,0,0
"United States of America","2024-11-09",0,0,2551,0,5,2570,0,0
"United States of America","2024-11-10",0,0,2551,0,5,2575,0,0
"United States of America","2024-11-11",0,0,2551,0,4,2579,0,0
"United States of America","2024-11-12",0,33,2584,0,5,2584,0,0
"United States of America","2024-11-13",0,0,2584,0,4,2588,0,0
"United States of America","2024-11-14",0,0,2584,0,3,2591,0,0
"United States of America","2024-11-15",0,0,2584,0,4,2595,0,0
"United States of America","2024-11-16",0,0,2584,0,4,2599,0,0
"United States of America","2024-11-17",0,0,2584,0,4,2603,0,0
"United States of America","2024-11-18",0,0,2584,0,3,2606,0,0
"United States of America","2024-11-19",0,26,2610,0,4,2610,0,0
"United States of America","2024-11-20",0,0,2610,0,3,2613,0,0
"United States of America","2024-11-21",0,0,2610,0,2,2615,0,0
"United States of America","2024-11-22",0,0,2610,0,3,2618,0,0
"United States of America","2024-11-23",0,0,2610,0,2,2620,0,0
"United States of America","2024-11-24",0,0,2610,0,3,2623,0,0
"United States of America","2024-11-25",0,0,2610,0,2,2625,0,0
"United States of America","2024-11-26",0,18,2628,0,3,2628,0,0
"United States of America","2024-11-27",0,0,2628,0,2,2630,0,0
"United States of America","2024-11-28",0,0,2628,0,2,2632,0,0
"United States of America","2024-11-29",0,0,2628,0,2,2634,0,0
"United States of America","2024-11-30",0,0,2628,0,1,2635,0,0
"United States of America","2024-12-01",0,0,2628,0,2,2637,0,0
"United States of America","2024-12-02",0,0,2628,0,2,2639,0,0
"United States of America","2024-12-03",0,13,2641,0,2,2641,0,0
"United States of America","2024-12-04",0,0,2641,0,2,2643,0,0
"United States of America","2024-12-05",0,0,2641,0,2,2645,0,0
"United States of America","2024-12-06",0,0,2641,0,2,2647,0,0
"United States of America","2024-12-07",0,0,2641,0,3,2650,0,0
"United States of America","2024-12-08",0,0,2641,0,2,2652,0,0
"United States of America","2024-12-09",0,0,2641,0,2,2654,0,0
"United States of America","2024-12-10",0,15,2656,0,2,2656,0,0
"United States of America","2024-12-11",0,0,2656,0,1,2657,0,0
"United States of America","2024-12-12",0,0,2656,0,1,2658,0,0
"United States of America","2024-12-13",0,0,2656,0,1,2659,0,0
"United States of America","2024-12-14",0,0,2656,0,0,2659,0,0
"United States of America","2024-12-15",0,0,2656,0,1,2660,0,0
"United States of America","2024-12-16",0,0,2656,0,1,2661,0,0
"United States of America","2024-12-17",0,6,2662,0,1,2662,0,0
"United States of America","2024-12-18",0,0,2662,0,1,2663,0,0
"United States of America","2024-12-19",0,0,2662,0,1,2664,0,0
"United States of America","2024-12-20",0,0,2662,0,1,2665,0,0
"United States of America","2024-12-21",0,0,2662,0,0,2665,0,0
"United States of America","2024-12-22",0,0,2662,0,1,2666,0,0
"United States of America","2024-12-23",0,0,2662,0,1,2667,0,0
"United States of America","2024-12-24",0,6,2668,0,1,2668,0,0
"United States of America","2024-12-25",0,0,2668,0,0,2668,0,0
"United States of America","2024-12-26",0,0,2668,0,1,2669,0,0
"United States of America","2024-12-27",0,0,2668,0,0,2669,0,0
"United States of America","2024-12-28",0,0,2668,0,0,2669,0,0
"United States of America","2024-12-29",0,0,2668,0,0,2669,0,0
"United States of America","2024-12-30",0,0,2668,0,1,2670,0,0
"United States of America","2024-12-31",0,2,2670,0,0,2670,0,0
"United States of America","2025-01-01",0,0,2670,0,0,2670,0,0
"United States of America","2025-01-02",0,0,2670,0,0,2670,0,0
"United States of America","2025-01-03",0,0,2670,0,0,2670,0,0
"United States of America","2025-01-04",0,0,2670,0,0,2670,0,0
"United States of America","2025-01-05",0,0,2670,0,0,2670,0,0
"United States of America","2025-01-06",0,0,2670,0,0,2670,0,0
"United States of America","2025-01-07",0,0,2670,0,0,2670,0,0
"United States of America","2025-01-08",0,0,2670,0,0,2670,0,0
"United States of America","2025-01-09",0,0,2670,0,0,2670,0,0
"United States of America","2025-01-10",0,0,2670,0,0,2670,0,0
"United States of America","2025-01-11",0,0,2670,0,0,2670,0,0
"United States of America","2025-01-12",0,0,2670,0,0,2670,0,0
"United States of America","2025-01-13",0,0,2670,0,0,2670,0,0
"United States of America","2025-01-14",0,0,2670,0,0,2670,0,0
"United States of America","2025-01-15",0,0,2670,0,0,2670,0,0
"United States of America","2025-01-16",0,0,2670,0,0,2670,0,0
"United States of America","2025-01-17",0,0,2670,0,0,2670,0,0
"United States of America","2025-01-18",0,0,2670,0,0,2670,0,0
"United States of America","2025-01-19",0,0,2670,0,0,2670,0,0
"United States of America","2025-01-20",0,0,2670,0,0,2670,0,0
"United States of America","2025-01-21",0,0,2670,0,0,2670,0,0
"United States of America","2025-01-22",0,0,2670,0,0,2670,0,0
"United States of America","2025-01-23",0,0,2670,0,0,2670,0,0
"United States of America","2025-01-24",0,0,2670,0,0,2670,0,0
"United States of America","2025-01-25",0,0,2670,0,0,2670,0,0
"United States of America","2025-01-26",0,0,2670,0,0,2670,0,0
"United States of America","2025-01-27",0,0,2670,0,0,2670,0,0
"United States of America","2025-01-28",0,0,2670,0,0,2670,0,0
"United States of America","2025-01-29",0,0,2670,0,0,2670,0,0
"United States of America","2025-01-30",0,0,2670,0,0,2670,0,0
"United States of America","2025-01-31",0,0,2670,0,0,2670,0,0
"United States of America","2025-02-01",0,0,2670,0,0,2670,0,0
"United States of America","2025-02-02",0,0,2670,0,0,2670,0,0
"United States of America","2025-02-03",0,0,2670,0,0,2670,0,0
"Uruguay","2024-01-01",0,0,0,0,0,0,0,0
"Uruguay","2024-01-02",0,0,0,0,0,0,0,0
"Uruguay","2024-01-03",0,0,0,0,0,0,0,0
"Uruguay","2024-01-04",0,0,0,0,0,0,0,0
"Uruguay","2024-01-05",0,0,0,0,0,0,0,0
"Uruguay","2024-01-06",0,0,0,0,0,0,0,0
"Uruguay","2024-01-07",0,0,0,0,0,0,0,0
"Uruguay","2024-01-08",0,0,0,0,0,0,0,0
"Uruguay","2024-01-09",0,0,0,0,0,0,0,0
"Uruguay","2024-01-10",0,0,0,0,0,0,0,0
"Uruguay","2024-01-11",0,0,0,0,0,0,0,0
"Uruguay","2024-01-12",0,0,0,0,0,0,0,0
"Uruguay","2024-01-13",0,0,0,0,0,0,0,0
"Uruguay","2024-01-14",0,0,0,0,0,0,0,0
"Uruguay","2024-01-15",0,0,0,0,0,0,0,0
"Uruguay","2024-01-16",0,0,0,0,0,0,0,0
"Uruguay","2024-01-17",0,0,0,0,0,0,0,0
"Uruguay","2024-01-18",0,0,0,0,0,0,0,0
"Uruguay","2024-01-19",0,0,0,0,0,0,0,0
"Uruguay","2024-01-20",0,0,0,0,0,0,0,0
"Uruguay","2024-01-21",0,0,0,0,0,0,0,0
"Uruguay","2024-01-22",0,0,0,0,0,0,0,0
"Uruguay","2024-01-23",0,0,0,0,0,0,0,0
"Uruguay","2024-01-24",0,0,0,0,0,0,0,0
"Uruguay","2024-01-25",0,0,0,0,0,0,0,0
"Uruguay","2024-01-26",0,0,0,0,0,0,0,0
"Uruguay","2024-01-27",0,0,0,0,0,0,0,0
"Uruguay","2024-01-28",0,0,0,0,0,0,0,0
"Uruguay","2024-01-29",0,0,0,0,0,0,0,0
"Uruguay","2024-01-30",0,0,0,0,0,0,0,0
"Uruguay","2024-01-31",0,0,0,0,0,0,0,0
"Uruguay","2024-02-01",0,0,0,0,0,0,0,0
"Uruguay","2024-02-02",0,0,0,0,0,0,0,0
"Uruguay","2024-02-03",0,0,0,0,0,0,0,0
"Uruguay","2024-02-04",0,0,0,0,0,0,0,0
"Uruguay","2024-02-05",0,0,0,0,0,0,0,0
"Uruguay","2024-02-06",0,0,0,0,0,0,0,0
"Uruguay","2024-02-07",0,0,0,0,0,0,0,0
"Uruguay","2024-02-08",0,0,0,0,0,0,0,0
"Uruguay","2024-02-09",0,0,0,0,0,0,0,0
"Uruguay","2024-02-10",0,0,0,0,0,0,0,0
"Uruguay","2024-02-11",0,0,0,0,0,0,0,0
"Uruguay","2024-02-12",0,0,0,0,0,0,0,0
"Uruguay","2024-02-13",0,0,0,0,0,0,0,0
"Uruguay","2024-02-14",0,0,0,0,0,0,0,0
"Uruguay","2024-02-15",0,0,0,0,0,0,0,0
"Uruguay","2024-02-16",0,0,0,0,0,0,0,0
"Uruguay","2024-02-17",0,0,0,0,0,0,0,0
"Uruguay","2024-02-18",0,0,0,0,0,0,0,0
"Uruguay","2024-02-19",0,0,0,0,0,0,0,0
"Uruguay","2024-02-20",0,0,0,0,0,0,0,0
"Uruguay","2024-02-21",0,0,0,0,0,0,0,0
"Uruguay","2024-02-22",0,0,0,0,0,0,0,0
"Uruguay","2024-02-23",0,0,0,0,0,0,0,0
"Uruguay","2024-02-24",0,0,0,0,0,0,0,0
"Uruguay","2024-02-25",0,0,0,0,0,0,0,0
"Uruguay","2024-02-26",0,0,0,0,0,0,0,0
"Uruguay","2024-02-27",0,0,0,0,0,0,0,0
"Uruguay","2024-02-28",0,0,0,0,0,0,0,0
"Uruguay","2024-02-29",0,0,0,0,0,0,0,0
"Uruguay","2024-03-01",0,0,0,0,0,0,0,0
"Uruguay","2024-03-02",0,0,0,0,0,0,0,0
"Uruguay","2024-03-03",0,0,0,0,0,0,0,0
"Uruguay","2024-03-04",0,0,0,0,0,0,0,0
"Uruguay","2024-03-05",0,0,0,0,0,0,0,0
"Uruguay","2024-03-06",0,0,0,0,0,0,0,0
"Uruguay","2024-03-07",0,0,0,0,0,0,0,0
"Uruguay","2024-03-08",0,0,0,0,0,0,0,0
"Uruguay","2024-03-09",0,0,0,0,0,0,0,0
"Uruguay","2024-03-10",0,0,0,0,0,0,0,0
"Uruguay","2024-03-11",0,0,0,0,0,0,0,0
"Uruguay","2024-03-12",0,0,0,0,0,0,0,0
"Uruguay","2024-03-13",0,0,0,0,0,0,0,0
"Uruguay","2024-03-14",0,0,0,0,0,0,0,0
"Uruguay","2024-03-15",0,0,0,0,0,0,0,0
"Uruguay","2024-03-16",0,0,0,0,0,0,0,0
"Uruguay","2024-03-17",0,0,0,0,0,0,0,0
"Uruguay","2024-03-18",0,0,0,0,0,0,0,0
"Uruguay","2024-03-19",0,0,0,0,0,0,0,0
"Uruguay","2024-03-20",0,0,0,0,0,0,0,0
"Uruguay","2024-03-21",0,0,0,0,0,0,0,0
"Uruguay","2024-03-22",0,0,0,0,0,0,0,0
"Uruguay","2024-03-23",0,0,0,0,0,0,0,0
"Uruguay","2024-03-24",0,0,0,0,0,0,0,0
"Uruguay","2024-03-25",0,0,0,0,0,0,0,0
"Uruguay","2024-03-26",0,0,0,0,0,0,0,0
"Uruguay","2024-03-27",0,0,0,0,0,0,0,0
"Uruguay","2024-03-28",0,0,0,0,0,0,0,0
"Uruguay","2024-03-29",0,0,0,0,0,0,0,0
"Uruguay","2024-03-30",0,0,0,0,0,0,0,0
"Uruguay","2024-03-31",0,0,0,0,0,0,0,0
"Uruguay","2024-04-01",0,0,0,0,0,0,0,0
"Uruguay","2024-04-02",0,0,0,0,0,0,0,0
"Uruguay","2024-04-03",0,0,0,0,0,0,0,0
"Uruguay","2024-04-04",0,0,0,0,0,0,0,0
"Uruguay","2024-04-05",0,0,0,0,0,0,0,0
"Uruguay","2024-04-06",0,0,0,0,0,0,0,0
"Uruguay","2024-04-07",0,0,0,0,0,0,0,0
"Uruguay","2024-04-08",0,0,0,0,0,0,0,0
"Uruguay","2024-04-09",0,0,0,0,0,0,0,0
"Uruguay","2024-04-10",0,0,0,0,0,0,0,0
"Uruguay","2024-04-11",0,0,0,0,0,0,0,0
"Uruguay","2024-04-12",0,0,0,0,0,0,0,0
"Uruguay","2024-04-13",0,0,0,0,0,0,0,0
"Uruguay","2024-04-14",0,0,0,0,0,0,0,0
"Uruguay","2024-04-15",0,0,0,0,0,0,0,0
"Uruguay","2024-04-16",0,0,0,0,0,0,0,0
"Uruguay","2024-04-17",0,0,0,0,0,0,0,0
"Uruguay","2024-04-18",0,0,0,0,0,0,0,0
"Uruguay","2024-04-19",0,0,0,0,0,0,0,0
"Uruguay","2024-04-20",0,0,0,0,0,0,0,0
"Uruguay","2024-04-21",0,0,0,0,0,0,0,0
"Uruguay","2024-04-22",0,0,0,0,0,0,0,0
"Uruguay","2024-04-23",0,0,0,0,0,0,0,0
"Uruguay","2024-04-24",0,0,0,0,0,0,0,0
"Uruguay","2024-04-25",0,0,0,0,0,0,0,0
"Uruguay","2024-04-26",0,0,0,0,0,0,0,0
"Uruguay","2024-04-27",0,0,0,0,0,0,0,0
"Uruguay","2024-04-28",0,0,0,0,0,0,0,0
"Uruguay","2024-04-29",0,0,0,0,0,0,0,0
"Uruguay","2024-04-30",0,0,0,0,0,0,0,0
"Uruguay","2024-05-01",0,0,0,0,0,0,0,0
"Uruguay","2024-05-02",0,0,0,0,0,0,0,0
"Uruguay","2024-05-03",0,0,0,0,0,0,0,0
"Uruguay","2024-05-04",0,0,0,0,0,0,0,0
"Uruguay","2024-05-05",0,0,0,0,0,0,0,0
"Uruguay","2024-05-06",0,0,0,0,0,0,0,0
"Uruguay","2024-05-07",0,0,0,0,0,0,0,0
"Uruguay","2024-05-08",0,0,0,0,0,0,0,0
"Uruguay","2024-05-09",0,0,0,0,0,0,0,0
"Uruguay","2024-05-10",0,0,0,0,0,0,0,0
"Uruguay","2024-05-11",0,0,0,0,0,0,0,0
"Uruguay","2024-05-12",0,0,0,0,0,0,0,0
"Uruguay","2024-05-13",0,0,0,0,0,0,0,0
"Uruguay","2024-05-14",0,0,0,0,0,0,0,0
"Uruguay","2024-05-15",0,0,0,0,0,0,0,0
"Uruguay","2024-05-16",0,0,0,0,0,0,0,0
"Uruguay","2024-05-17",0,0,0,0,0,0,0,0
"Uruguay","2024-05-18",0,0,0,0,0,0,0,0
"Uruguay","2024-05-19",0,0,0,0,0,0,0,0
"Uruguay","2024-05-20",0,0,0,0,0,0,0,0
"Uruguay","2024-05-21",0,0,0,0,0,0,0,0
"Uruguay","2024-05-22",0,0,0,0,0,0,0,0
"Uruguay","2024-05-23",0,0,0,0,0,0,0,0
"Uruguay","2024-05-24",0,0,0,0,0,0,0,0
"Uruguay","2024-05-25",0,0,0,0,0,0,0,0
"Uruguay","2024-05-26",0,0,0,0,0,0,0,0
"Uruguay","2024-05-27",0,0,0,0,0,0,0,0
"Uruguay","2024-05-28",0,0,0,0,0,0,0,0
"Uruguay","2024-05-29",0,0,0,0,0,0,0,0
"Uruguay","2024-05-30",0,0,0,0,0,0,0,0
"Uruguay","2024-05-31",0,0,0,0,0,0,0,0
"Uruguay","2024-06-01",0,0,0,0,0,0,0,0
"Uruguay","2024-06-02",0,0,0,0,0,0,0,0
"Uruguay","2024-06-03",0,0,0,0,0,0,0,0
"Uruguay","2024-06-04",0,0,0,0,0,0,0,0
"Uruguay","2024-06-05",0,0,0,0,0,0,0,0
"Uruguay","2024-06-06",0,0,0,0,0,0,0,0
"Uruguay","2024-06-07",0,0,0,0,0,0,0,0
"Uruguay","2024-06-08",0,0,0,0,0,0,0,0
"Uruguay","2024-06-09",0,0,0,0,0,0,0,0
"Uruguay","2024-06-10",0,0,0,0,0,0,0,0
"Uruguay","2024-06-11",0,0,0,0,0,0,0,0
"Uruguay","2024-06-12",0,0,0,0,0,0,0,0
"Uruguay","2024-06-13",0,0,0,0,0,0,0,0
"Uruguay","2024-06-14",0,0,0,0,0,0,0,0
"Uruguay","2024-06-15",0,0,0,0,0,0,0,0
"Uruguay","2024-06-16",0,0,0,0,0,0,0,0
"Uruguay","2024-06-17",0,0,0,0,0,0,0,0
"Uruguay","2024-06-18",0,0,0,0,0,0,0,0
"Uruguay","2024-06-19",0,0,0,0,0,0,0,0
"Uruguay","2024-06-20",0,0,0,0,0,0,0,0
"Uruguay","2024-06-21",0,0,0,0,0,0,0,0
"Uruguay","2024-06-22",0,0,0,0,0,0,0,0
"Uruguay","2024-06-23",0,0,0,0,0,0,0,0
"Uruguay","2024-06-24",0,0,0,0,0,0,0,0
"Uruguay","2024-06-25",0,0,0,0,0,0,0,0
"Uruguay","2024-06-26",0,0,0,0,0,0,0,0
"Uruguay","2024-06-27",0,0,0,0,0,0,0,0
"Uruguay","2024-06-28",0,0,0,0,0,0,0,0
"Uruguay","2024-06-29",0,0,0,0,0,0,0,0
"Uruguay","2024-06-30",0,0,0,0,0,0,0,0
"Uruguay","2024-07-01",0,0,0,0,0,0,0,0
"Uruguay","2024-07-02",0,0,0,0,0,0,0,0
"Uruguay","2024-07-03",0,0,0,0,0,0,0,0
"Uruguay","2024-07-04",0,0,0,0,0,0,0,0
"Uruguay","2024-07-05",0,0,0,0,0,0,0,0
"Uruguay","2024-07-06",0,0,0,0,0,0,0,0
"Uruguay","2024-07-07",0,0,0,0,0,0,0,0
"Uruguay","2024-07-08",0,0,0,0,0,0,0,0
"Uruguay","2024-07-09",0,0,0,0,0,0,0,0
"Uruguay","2024-07-10",0,0,0,0,0,0,0,0
"Uruguay","2024-07-11",0,0,0,0,0,0,0,0
"Uruguay","2024-07-12",0,0,0,0,0,0,0,0
"Uruguay","2024-07-13",0,0,0,0,0,0,0,0
"Uruguay","2024-07-14",0,0,0,0,0,0,0,0
"Uruguay","2024-07-15",0,0,0,0,0,0,0,0
"Uruguay","2024-07-16",0,0,0,0,0,0,0,0
"Uruguay","2024-07-17",0,0,0,0,0,0,0,0
"Uruguay","2024-07-18",0,0,0,0,0,0,0,0
"Uruguay","2024-07-19",0,0,0,0,0,0,0,0
"Uruguay","2024-07-20",0,0,0,0,0,0,0,0
"Uruguay","2024-07-21",0,0,0,0,0,0,0,0
"Uruguay","2024-07-22",0,0,0,0,0,0,0,0
"Uruguay","2024-07-23",0,0,0,0,0,0,0,0
"Uruguay","2024-07-24",0,0,0,0,0,0,0,0
"Uruguay","2024-07-25",0,0,0,0,0,0,0,0
"Uruguay","2024-07-26",0,0,0,0,0,0,0,0
"Uruguay","2024-07-27",0,0,0,0,0,0,0,0
"Uruguay","2024-07-28",0,0,0,0,0,0,0,0
"Uruguay","2024-07-29",0,0,0,0,0,0,0,0
"Uruguay","2024-07-30",0,0,0,0,0,0,0,0
"Uruguay","2024-07-31",0,0,0,0,0,0,0,0
"Uruguay","2024-08-01",0,0,0,0,0,0,0,0
"Uruguay","2024-08-02",0,0,0,0,0,0,0,0
"Uruguay","2024-08-03",0,0,0,0,0,0,0,0
"Uruguay","2024-08-04",0,0,0,0,0,0,0,0
"Uruguay","2024-08-05",0,0,0,0,0,0,0,0
"Uruguay","2024-08-06",0,0,0,0,0,0,0,0
"Uruguay","2024-08-07",0,0,0,0,0,0,0,0
"Uruguay","2024-08-08",0,0,0,0,0,0,0,0
"Uruguay","2024-08-09",0,0,0,0,0,0,0,0
"Uruguay","2024-08-10",0,0,0,0,0,0,0,0
"Uruguay","2024-08-11",0,0,0,0,0,0,0,0
"Uruguay","2024-08-12",0,0,0,0,0,0,0,0
"Uruguay","2024-08-13",0,0,0,0,0,0,0,0
"Uruguay","2024-08-14",0,0,0,0,0,0,0,0
"Uruguay","2024-08-15",0,0,0,0,0,0,0,0
"Uruguay","2024-08-16",0,0,0,0,0,0,0,0
"Uruguay","2024-08-17",0,0,0,0,0,0,0,0
"Uruguay","2024-08-18",0,0,0,0,0,0,0,0
"Uruguay","2024-08-19",0,0,0,0,0,0,0,0
"Uruguay","2024-08-20",0,0,0,0,0,0,0,0
"Uruguay","2024-08-21",0,0,0,0,0,0,0,0
"Uruguay","2024-08-22",0,0,0,0,0,0,0,0
"Uruguay","2024-08-23",0,0,0,0,0,0,0,0
"Uruguay","2024-08-24",0,0,0,0,0,0,0,0
"Uruguay","2024-08-25",0,0,0,0,0,0,0,0
"Uruguay","2024-08-26",0,0,0,0,0,0,0,0
"Uruguay","2024-08-27",0,0,0,0,0,0,0,0
"Uruguay","2024-08-28",0,0,0,0,0,0,0,0
"Uruguay","2024-08-29",0,0,0,0,0,0,0,0
"Uruguay","2024-08-30",0,0,0,0,0,0,0,0
"Uruguay","2024-08-31",0,0,0,0,0,0,0,0
"Uruguay","2024-09-01",0,0,0,0,0,0,0,0
"Uruguay","2024-09-02",0,0,0,0,0,0,0,0
"Uruguay","2024-09-03",0,0,0,0,0,0,0,0
"Uruguay","2024-09-04",0,0,0,0,0,0,0,0
"Uruguay","2024-09-05",0,0,0,0,0,0,0,0
"Uruguay","2024-09-06",0,0,0,0,0,0,0,0
"Uruguay","2024-09-07",0,0,0,0,0,0,0,0
"Uruguay","2024-09-08",0,0,0,0,0,0,0,0
"Uruguay","2024-09-09",0,0,0,0,0,0,0,0
"Uruguay","2024-09-10",0,0,0,0,0,0,0,0
"Uruguay","2024-09-11",0,0,0,0,0,0,0,0
"Uruguay","2024-09-12",0,0,0,0,0,0,0,0
"Uruguay","2024-09-13",0,0,0,0,0,0,0,0
"Uruguay","2024-09-14",0,0,0,0,0,0,0,0
"Uruguay","2024-09-15",0,0,0,0,0,0,0,0
"Uruguay","2024-09-16",0,0,0,0,0,0,0,0
"Uruguay","2024-09-17",0,0,0,0,0,0,0,0
"Uruguay","2024-09-18",0,0,0,0,0,0,0,0
"Uruguay","2024-09-19",0,0,0,0,0,0,0,0
"Uruguay","2024-09-20",0,0,0,0,0,0,0,0
"Uruguay","2024-09-21",0,0,0,0,0,0,0,0
"Uruguay","2024-09-22",0,0,0,0,0,0,0,0
"Uruguay","2024-09-23",0,0,0,0,0,0,0,0
"Uruguay","2024-09-24",0,1,1,0,1,1,0,0
"Uruguay","2024-09-25",0,0,1,0,0,1,0,0
"Uruguay","2024-09-26",0,0,1,0,0,1,0,0
"Uruguay","2024-09-27",0,0,1,0,0,1,0,0
"Uruguay","2024-09-28",0,0,1,0,0,1,0,0
"Uruguay","2024-09-29",0,0,1,0,0,1,0,0
"Uruguay","2024-09-30",0,0,1,0,0,1,0,0
"Uruguay","2024-10-01",0,0,1,0,0,1,0,0
"Uruguay","2024-10-02",0,0,1,0,0,1,0,0
"Uruguay","2024-10-03",0,0,1,0,0,1,0,0
"Uruguay","2024-10-04",0,0,1,0,0,1,0,0
"Uruguay","2024-10-05",0,0,1,0,0,1,0,0
"Uruguay","2024-10-06",0,0,1,0,0,1,0,0
"Uruguay","2024-10-07",0,0,1,0,0,1,0,0
"Uruguay","2024-10-08",0,0,1,0,0,1,0,0
"Uruguay","2024-10-09",0,0,1,0,0,1,0,0
"Uruguay","2024-10-10",0,0,1,0,0,1,0,0
"Uruguay","2024-10-11",0,0,1,0,0,1,0,0
"Uruguay","2024-10-12",0,0,1,0,0,1,0,0
"Uruguay","2024-10-13",0,0,1,0,0,1,0,0
"Uruguay","2024-10-14",0,0,1,0,0,1,0,0
"Uruguay","2024-10-15",0,0,1,0,0,1,0,0
"Uruguay","2024-10-16",0,0,1,0,0,1,0,0
"Uruguay","2024-10-17",0,0,1,0,0,1,0,0
"Uruguay","2024-10-18",0,0,1,0,0,1,0,0
"Uruguay","2024-10-19",0,0,1,0,0,1,0,0
"Uruguay","2024-10-20",0,0,1,0,0,1,0,0
"Uruguay","2024-10-21",0,0,1,0,0,1,0,0
"Uruguay","2024-10-22",0,0,1,0,0,1,0,0
"Uruguay","2024-10-23",0,0,1,0,0,1,0,0
"Uruguay","2024-10-24",0,0,1,0,0,1,0,0
"Uruguay","2024-10-25",0,0,1,0,0,1,0,0
"Uruguay","2024-10-26",0,0,1,0,0,1,0,0
"Uruguay","2024-10-27",0,0,1,0,0,1,0,0
"Uruguay","2024-10-28",0,0,1,0,0,1,0,0
"Uruguay","2024-10-29",0,0,1,0,0,1,0,0
"Uruguay","2024-10-30",0,0,1,0,0,1,0,0
"Uruguay","2024-10-31",0,0,1,0,0,1,0,0
"Uruguay","2024-11-01",0,0,1,0,0,1,0,0
"Uruguay","2024-11-02",0,0,1,0,0,1,0,0
"Uruguay","2024-11-03",0,0,1,0,0,1,0,0
"Uruguay","2024-11-04",0,0,1,0,0,1,0,0
"Uruguay","2024-11-05",0,0,1,0,0,1,0,0
"Uruguay","2024-11-06",0,0,1,0,0,1,0,0
"Uruguay","2024-11-07",0,0,1,0,0,1,0,0
"Uruguay","2024-11-08",0,0,1,0,0,1,0,0
"Uruguay","2024-11-09",0,0,1,0,0,1,0,0
"Uruguay","2024-11-10",0,0,1,0,0,1,0,0
"Uruguay","2024-11-11",0,0,1,0,0,1,0,0
"Uruguay","2024-11-12",0,0,1,0,0,1,0,0
"Uruguay","2024-11-13",0,0,1,0,0,1,0,0
"Uruguay","2024-11-14",0,0,1,0,0,1,0,0
"Uruguay","2024-11-15",0,0,1,0,0,1,0,0
"Uruguay","2024-11-16",0,0,1,0,0,1,0,0
"Uruguay","2024-11-17",0,0,1,0,0,1,0,0
"Uruguay","2024-11-18",0,0,1,0,0,1,0,0
"Uruguay","2024-11-19",0,0,1,0,0,1,0,0
"Uruguay","2024-11-20",0,0,1,0,0,1,0,0
"Uruguay","2024-11-21",0,0,1,0,0,1,0,0
"Uruguay","2024-11-22",0,0,1,0,0,1,0,0
"Uruguay","2024-11-23",0,0,1,0,0,1,0,0
"Uruguay","2024-11-24",0,0,1,0,0,1,0,0
"Uruguay","2024-11-25",0,0,1,0,0,1,0,0
"Uruguay","2024-11-26",0,0,1,0,0,1,0,0
"Uruguay","2024-11-27",0,0,1,0,0,1,0,0
"Uruguay","2024-11-28",0,0,1,0,0,1,0,0
"Uruguay","2024-11-29",0,0,1,0,0,1,0,0
"Uruguay","2024-11-30",0,0,1,0,0,1,0,0
"Uruguay","2024-12-01",0,0,1,0,0,1,0,0
"Uruguay","2024-12-02",0,0,1,0,0,1,0,0
"Uruguay","2024-12-03",0,0,1,0,0,1,0,0
"Uruguay","2024-12-04",0,0,1,0,0,1,0,0
"Uruguay","2024-12-05",0,0,1,0,0,1,0,0
"Uruguay","2024-12-06",0,0,1,0,0,1,0,0
"Uruguay","2024-12-07",0,0,1,0,0,1,0,0
"Uruguay","2024-12-08",0,0,1,0,0,1,0,0
"Uruguay","2024-12-09",0,0,1,0,0,1,0,0
"Uruguay","2024-12-10",0,0,1,0,0,1,0,0
"Uruguay","2024-12-11",0,0,1,0,0,1,0,0
"Uruguay","2024-12-12",0,0,1,0,0,1,0,0
"Uruguay","2024-12-13",0,0,1,0,0,1,0,0
"Uruguay","2024-12-14",0,0,1,0,0,1,0,0
"Uruguay","2024-12-15",0,0,1,0,0,1,0,0
"Uruguay","2024-12-16",0,0,1,0,0,1,0,0
"Uruguay","2024-12-17",0,0,1,0,0,1,0,0
"Uruguay","2024-12-18",0,0,1,0,0,1,0,0
"Uruguay","2024-12-19",0,0,1,0,0,1,0,0
"Uruguay","2024-12-20",0,0,1,0,0,1,0,0
"Uruguay","2024-12-21",0,0,1,0,0,1,0,0
"Uruguay","2024-12-22",0,0,1,0,0,1,0,0
"Uruguay","2024-12-23",0,0,1,0,0,1,0,0
"Uruguay","2024-12-24",0,0,1,0,0,1,0,0
"Uruguay","2024-12-25",0,0,1,0,0,1,0,0
"Uruguay","2024-12-26",0,0,1,0,0,1,0,0
"Uruguay","2024-12-27",0,0,1,0,0,1,0,0
"Uruguay","2024-12-28",0,0,1,0,0,1,0,0
"Uruguay","2024-12-29",0,0,1,0,0,1,0,0
"Uruguay","2024-12-30",0,0,1,0,0,1,0,0
"Uruguay","2024-12-31",0,0,1,0,0,1,0,0
"Uruguay","2025-01-01",0,0,1,0,0,1,0,0
"Uruguay","2025-01-02",0,0,1,0,0,1,0,0
"Uruguay","2025-01-03",0,0,1,0,0,1,0,0
"Uruguay","2025-01-04",0,0,1,0,0,1,0,0
"Uruguay","2025-01-05",0,0,1,0,0,1,0,0
"Uruguay","2025-01-06",0,0,1,0,0,1,0,0
"Uruguay","2025-01-07",0,0,1,0,0,1,0,0
"Uruguay","2025-01-08",0,0,1,0,0,1,0,0
"Uruguay","2025-01-09",0,0,1,0,0,1,0,0
"Uruguay","2025-01-10",0,0,1,0,0,1,0,0
"Uruguay","2025-01-11",0,0,1,0,0,1,0,0
"Uruguay","2025-01-12",0,0,1,0,0,1,0,0
"Uruguay","2025-01-13",0,0,1,0,0,1,0,0
"Uruguay","2025-01-14",0,0,1,0,0,1,0,0
"Uruguay","2025-01-15",0,0,1,0,0,1,0,0
"Uruguay","2025-01-16",0,0,1,0,0,1,0,0
"Uruguay","2025-01-17",0,0,1,0,0,1,0,0
"Uruguay","2025-01-18",0,0,1,0,0,1,0,0
"Uruguay","2025-01-19",0,0,1,0,0,1,0,0
"Uruguay","2025-01-20",0,0,1,0,0,1,0,0
"Uruguay","2025-01-21",0,0,1,0,0,1,0,0
"Uruguay","2025-01-22",0,0,1,0,0,1,0,0
"Uruguay","2025-01-23",0,0,1,0,0,1,0,0
"Uruguay","2025-01-24",0,0,1,0,0,1,0,0
"Uruguay","2025-01-25",0,0,1,0,0,1,0,0
"Uruguay","2025-01-26",0,0,1,0,0,1,0,0
"Uruguay","2025-01-27",0,0,1,0,0,1,0,0
"Uruguay","2025-01-28",0,0,1,0,0,1,0,0
"Uruguay","2025-01-29",0,0,1,0,0,1,0,0
"Uruguay","2025-01-30",0,0,1,0,0,1,0,0
"Uruguay","2025-01-31",0,0,1,0,0,1,0,0
"Uruguay","2025-02-01",0,0,1,0,0,1,0,0
"Uruguay","2025-02-02",0,0,1,0,0,1,0,0
"Uruguay","2025-02-03",0,0,1,0,0,1,0,0
"Venezuela (Bolivarian Republic of)","2024-01-01",0,0,0,0,0,0,0,0
"Venezuela (Bolivarian Republic of)","2024-01-02",0,0,0,0,0,0,0,0
"Venezuela (Bolivarian Republic of)","2024-01-03",0,0,0,0,0,0,0,0
"Venezuela (Bolivarian Republic of)","2024-01-04",0,0,0,0,0,0,0,0
"Venezuela (Bolivarian Republic of)","2024-01-05",0,0,0,0,0,0,0,0
"Venezuela (Bolivarian Republic of)","2024-01-06",0,0,0,0,0,0,0,0
"Venezuela (Bolivarian Republic of)","2024-01-07",0,0,0,0,0,0,0,0
"Venezuela (Bolivarian Republic of)","2024-01-08",0,0,0,0,0,0,0,0
"Venezuela (Bolivarian Republic of)","2024-01-09",0,0,0,0,0,0,0,0
"Venezuela (Bolivarian Republic of)","2024-01-10",0,0,0,0,0,0,0,0
"Venezuela (Bolivarian Republic of)","2024-01-11",0,0,0,0,0,0,0,0
"Venezuela (Bolivarian Republic of)","2024-01-12",0,0,0,0,0,0,0,0
"Venezuela (Bolivarian Republic of)","2024-01-13",0,0,0,0,0,0,0,0
"Venezuela (Bolivarian Republic of)","2024-01-14",0,0,0,0,0,0,0,0
"Venezuela (Bolivarian Republic of)","2024-01-15",0,0,0,0,0,0,0,0
"Venezuela (Bolivarian Republic of)","2024-01-16",0,0,0,0,0,0,0,0
"Venezuela (Bolivarian Republic of)","2024-01-17",0,0,0,0,0,0,0,0
"Venezuela (Bolivarian Republic of)","2024-01-18",0,0,0,0,0,0,0,0
"Venezuela (Bolivarian Republic of)","2024-01-19",0,0,0,0,0,0,0,0
"Venezuela (Bolivarian Republic of)","2024-01-20",0,0,0,0,0,0,0,0
"Venezuela (Bolivarian Republic of)","2024-01-21",0,0,0,0,0,0,0,0
"Venezuela (Bolivarian Republic of)","2024-01-22",0,0,0,0,0,0,0,0
"Venezuela (Bolivarian Republic of)","2024-01-23",0,0,0,0,0,0,0,0
"Venezuela (Bolivarian Republic of)","2024-01-24",0,0,0,0,0,0,0,0
"Venezuela (Bolivarian Republic of)","2024-01-25",0,0,0,0,0,0,0,0
"Venezuela (Bolivarian Republic of)","2024-01-26",0,0,0,0,0,0,0,0
"Venezuela (Bolivarian Republic of)","2024-01-27",0,0,0,0,0,0,0,0
"Venezuela (Bolivarian Republic of)","2024-01-28",0,0,0,0,0,0,0,0
"Venezuela (Bolivarian Republic of)","2024-01-29",0,0,0,0,0,0,0,0
"Venezuela (Bolivarian Republic of)","2024-01-30",0,0,0,0,0,0,0,0
"Venezuela (Bolivarian Republic of)","2024-01-31",0,0,0,0,0,0,0,0
"Venezuela (Bolivarian Republic of)","2024-02-01",0,0,0,0,0,0,0,0
"Venezuela (Bolivarian Republic of)","2024-02-02",0,0,0,0,0,0,0,0
"Venezuela (Bolivarian Republic of)","2024-02-03",0,0,0,0,0,0,0,0
"Venezuela (Bolivarian Republic of)","2024-02-04",0,0,0,0,0,0,0,0
"Venezuela (Bolivarian Republic of)","2024-02-05",0,0,0,0,0,0,0,0
"Venezuela (Bolivarian Republic of)","2024-02-06",0,0,0,0,0,0,0,0
"Venezuela (Bolivarian Republic of)","2024-02-07",0,0,0,0,0,0,0,0
"Venezuela (Bolivarian Republic of)","2024-02-08",0,0,0,0,0,0,0,0
"Venezuela (Bolivarian Republic of)","2024-02-09",0,0,0,0,0,0,0,0
"Venezuela (Bolivarian Republic of)","2024-02-10",0,0,0,0,0,0,0,0
"Venezuela (Bolivarian Republic of)","2024-02-11",0,0,0,0,0,0,0,0
"Venezuela (Bolivarian Republic of)","2024-02-12",0,0,0,0,0,0,0,0
"Venezuela (Bolivarian Republic of)","2024-02-13",0,0,0,0,0,0,0,0
"Venezuela (Bolivarian Republic of)","2024-02-14",0,0,0,0,0,0,0,0
"Venezuela (Bolivarian Republic of)","2024-02-15",0,0,0,0,0,0,0,0
"Venezuela (Bolivarian Republic of)","2024-02-16",0,0,0,0,0,0,0,0
"Venezuela (Bolivarian Republic of)","2024-02-17",0,0,0,0,0,0,0,0
"Venezuela (Bolivarian Republic of)","2024-02-18",0,0,0,0,0,0,0,0
"Venezuela (Bolivarian Republic of)","2024-02-19",0,0,0,0,0,0,0,0
"Venezuela (Bolivarian Republic of)","2024-02-20",0,0,0,0,0,0,0,0
"Venezuela (Bolivarian Republic of)","2024-02-21",0,0,0,0,0,0,0,0
"Venezuela (Bolivarian Republic of)","2024-02-22",0,0,0,0,0,0,0,0
"Venezuela (Bolivarian Republic of)","2024-02-23",0,0,0,0,0,0,0,0
"Venezuela (Bolivarian Republic of)","2024-02-24",0,0,0,0,0,0,0,0
"Venezuela (Bolivarian Republic of)","2024-02-25",0,0,0,0,0,0,0,0
"Venezuela (Bolivarian Republic of)","2024-02-26",0,0,0,0,0,0,0,0
"Venezuela (Bolivarian Republic of)","2024-02-27",0,0,0,0,0,0,0,0
"Venezuela (Bolivarian Republic of)","2024-02-28",0,0,0,0,0,0,0,0
"Venezuela (Bolivarian Republic of)","2024-02-29",0,0,0,0,0,0,0,0
"Venezuela (Bolivarian Republic of)","2024-03-01",0,0,0,0,0,0,0,0
"Venezuela (Bolivarian Republic of)","2024-03-02",0,0,0,0,0,0,0,0
"Venezuela (Bolivarian Republic of)","2024-03-03",0,0,0,0,0,0,0,0
"Venezuela (Bolivarian Republic of)","2024-03-04",0,0,0,0,0,0,0,0
"Venezuela (Bolivarian Republic of)","2024-03-05",0,0,0,0,0,0,0,0
"Venezuela (Bolivarian Republic of)","2024-03-06",0,0,0,0,0,0,0,0
"Venezuela (Bolivarian Republic of)","2024-03-07",0,0,0,0,0,0,0,0
"Venezuela (Bolivarian Republic of)","2024-03-08",0,0,0,0,0,0,0,0
"Venezuela (Bolivarian Republic of)","2024-03-09",0,0,0,0,0,0,0,0
"Venezuela (Bolivarian Republic of)","2024-03-10",0,0,0,0,0,0,0,0
"Venezuela (Bolivarian Republic of)","2024-03-11",0,0,0,0,0,0,0,0
"Venezuela (Bolivarian Republic of)","2024-03-12",0,0,0,0,0,0,0,0
"Venezuela (Bolivarian Republic of)","2024-03-13",0,0,0,0,0,0,0,0
"Venezuela (Bolivarian Republic of)","2024-03-14",0,0,0,0,0,0,0,0
"Venezuela (Bolivarian Republic of)","2024-03-15",0,0,0,0,0,0,0,0
"Venezuela (Bolivarian Republic of)","2024-03-16",0,0,0,0,0,0,0,0
"Venezuela (Bolivarian Republic of)","2024-03-17",0,0,0,0,0,0,0,0
"Venezuela (Bolivarian Republic of)","2024-03-18",0,0,0,0,0,0,0,0
"Venezuela (Bolivarian Republic of)","2024-03-19",0,0,0,0,0,0,0,0
"Venezuela (Bolivarian Republic of)","2024-03-20",0,0,0,0,0,0,0,0
"Venezuela (Bolivarian Republic of)","2024-03-21",0,0,0,0,0,0,0,0
"Venezuela (Bolivarian Republic of)","2024-03-22",0,0,0,0,0,0,0,0
"Venezuela (Bolivarian Republic of)","2024-03-23",0,0,0,0,0,0,0,0
"Venezuela (Bolivarian Republic of)","2024-03-24",0,0,0,0,0,0,0,0
"Venezuela (Bolivarian Republic of)","2024-03-25",0,0,0,0,0,0,0,0
"Venezuela (Bolivarian Republic of)","2024-03-26",0,0,0,0,0,0,0,0
"Venezuela (Bolivarian Republic of)","2024-03-27",0,0,0,0,0,0,0,0
"Venezuela (Bolivarian Republic of)","2024-03-28",0,0,0,0,0,0,0,0
"Venezuela (Bolivarian Republic of)","2024-03-29",0,0,0,0,0,0,0,0
"Venezuela (Bolivarian Republic of)","2024-03-30",0,0,0,0,0,0,0,0
"Venezuela (Bolivarian Republic of)","2024-03-31",0,0,0,0,0,0,0,0
"Venezuela (Bolivarian Republic of)","2024-04-01",0,0,0,0,0,0,0,0
"Venezuela (Bolivarian Republic of)","2024-04-02",0,0,0,0,0,0,0,0
"Venezuela (Bolivarian Republic of)","2024-04-03",0,0,0,0,0,0,0,0
"Venezuela (Bolivarian Republic of)","2024-04-04",0,0,0,0,0,0,0,0
"Venezuela (Bolivarian Republic of)","2024-04-05",0,0,0,0,0,0,0,0
"Venezuela (Bolivarian Republic of)","2024-04-06",0,0,0,0,0,0,0,0
"Venezuela (Bolivarian Republic of)","2024-04-07",0,0,0,0,0,0,0,0
"Venezuela (Bolivarian Republic of)","2024-04-08",0,0,0,0,0,0,0,0
"Venezuela (Bolivarian Republic of)","2024-04-09",0,0,0,0,0,0,0,0
"Venezuela (Bolivarian Republic of)","2024-04-10",0,0,0,0,0,0,0,0
"Venezuela (Bolivarian Republic of)","2024-04-11",0,0,0,0,0,0,0,0
"Venezuela (Bolivarian Republic of)","2024-04-12",0,0,0,0,0,0,0,0
"Venezuela (Bolivarian Republic of)","2024-04-13",0,0,0,0,0,0,0,0
"Venezuela (Bolivarian Republic of)","2024-04-14",0,0,0,0,0,0,0,0
"Venezuela (Bolivarian Republic of)","2024-04-15",0,0,0,0,0,0,0,0
"Venezuela (Bolivarian Republic of)","2024-04-16",0,0,0,0,0,0,0,0
"Venezuela (Bolivarian Republic of)","2024-04-17",0,0,0,0,0,0,0,0
"Venezuela (Bolivarian Republic of)","2024-04-18",0,0,0,0,0,0,0,0
"Venezuela (Bolivarian Republic of)","2024-04-19",0,0,0,0,0,0,0,0
"Venezuela (Bolivarian Republic of)","2024-04-20",0,0,0,0,0,0,0,0
"Venezuela (Bolivarian Republic of)","2024-04-21",0,0,0,0,0,0,0,0
"Venezuela (Bolivarian Republic of)","2024-04-22",0,0,0,0,0,0,0,0
"Venezuela (Bolivarian Republic of)","2024-04-23",0,0,0,0,0,0,0,0
"Venezuela (Bolivarian Republic of)","2024-04-24",0,0,0,0,0,0,0,0
"Venezuela (Bolivarian Republic of)","2024-04-25",0,0,0,0,0,0,0,0
"Venezuela (Bolivarian Republic of)","2024-04-26",0,0,0,0,0,0,0,0
"Venezuela (Bolivarian Republic of)","2024-04-27",0,0,0,0,0,0,0,0
"Venezuela (Bolivarian Republic of)","2024-04-28",0,0,0,0,0,0,0,0
"Venezuela (Bolivarian Republic of)","2024-04-29",0,0,0,0,0,0,0,0
"Venezuela (Bolivarian Republic of)","2024-04-30",0,0,0,0,0,0,0,0
"Venezuela (Bolivarian Republic of)","2024-05-01",0,0,0,0,0,0,0,0
"Venezuela (Bolivarian Republic of)","2024-05-02",0,0,0,0,0,0,0,0
"Venezuela (Bolivarian Republic of)","2024-05-03",0,0,0,0,0,0,0,0
"Venezuela (Bolivarian Republic of)","2024-05-04",0,0,0,0,0,0,0,0
"Venezuela (Bolivarian Republic of)","2024-05-05",0,0,0,0,0,0,0,0
"Venezuela (Bolivarian Republic of)","2024-05-06",0,0,0,0,0,0,0,0
"Venezuela (Bolivarian Republic of)","2024-05-07",0,0,0,0,0,0,0,0
"Venezuela (Bolivarian Republic of)","2024-05-08",0,0,0,0,0,0,0,0
"Venezuela (Bolivarian Republic of)","2024-05-09",0,0,0,0,0,0,0,0
"Venezuela (Bolivarian Republic of)","2024-05-10",0,0,0,0,0,0,0,0
"Venezuela (Bolivarian Republic of)","2024-05-11",0,0,0,0,0,0,0,0
"Venezuela (Bolivarian Republic of)","2024-05-12",0,0,0,0,0,0,0,0
"Venezuela (Bolivarian Republic of)","2024-05-13",0,0,0,0,0,0,0,0
"Venezuela (Bolivarian Republic of)","2024-05-14",0,0,0,0,0,0,0,0
"Venezuela (Bolivarian Republic of)","2024-05-15",0,0,0,0,0,0,0,0
"Venezuela (Bolivarian Republic of)","2024-05-16",0,0,0,0,0,0,0,0
"Venezuela (Bolivarian Republic of)","2024-05-17",0,0,0,0,0,0,0,0
"Venezuela (Bolivarian Republic of)","2024-05-18",0,0,0,0,0,0,0,0
"Venezuela (Bolivarian Republic of)","2024-05-19",0,0,0,0,0,0,0,0
"Venezuela (Bolivarian Republic of)","2024-05-20",0,0,0,0,0,0,0,0
"Venezuela (Bolivarian Republic of)","2024-05-21",0,0,0,0,0,0,0,0
"Venezuela (Bolivarian Republic of)","2024-05-22",0,0,0,0,0,0,0,0
"Venezuela (Bolivarian Republic of)","2024-05-23",0,0,0,0,0,0,0,0
"Venezuela (Bolivarian Republic of)","2024-05-24",0,0,0,0,0,0,0,0
"Venezuela (Bolivarian Republic of)","2024-05-25",0,0,0,0,0,0,0,0
"Venezuela (Bolivarian Republic of)","2024-05-26",0,0,0,0,0,0,0,0
"Venezuela (Bolivarian Republic of)","2024-05-27",0,0,0,0,0,0,0,0
"Venezuela (Bolivarian Republic of)","2024-05-28",0,0,0,0,0,0,0,0
"Venezuela (Bolivarian Republic of)","2024-05-29",0,0,0,0,0,0,0,0
"Venezuela (Bolivarian Republic of)","2024-05-30",0,0,0,0,0,0,0,0
"Venezuela (Bolivarian Republic of)","2024-05-31",0,0,0,0,0,0,0,0
"Venezuela (Bolivarian Republic of)","2024-06-01",0,0,0,0,0,0,0,0
"Venezuela (Bolivarian Republic of)","2024-06-02",0,0,0,0,0,0,0,0
"Venezuela (Bolivarian Republic of)","2024-06-03",0,0,0,0,0,0,0,0
"Venezuela (Bolivarian Republic of)","2024-06-04",0,0,0,0,0,0,0,0
"Venezuela (Bolivarian Republic of)","2024-06-05",0,0,0,0,0,0,0,0
"Venezuela (Bolivarian Republic of)","2024-06-06",0,0,0,0,0,0,0,0
"Venezuela (Bolivarian Republic of)","2024-06-07",0,0,0,0,0,0,0,0
"Venezuela (Bolivarian Republic of)","2024-06-08",0,0,0,0,0,0,0,0
"Venezuela (Bolivarian Republic of)","2024-06-09",0,0,0,0,0,0,0,0
"Venezuela (Bolivarian Republic of)","2024-06-10",0,0,0,0,0,0,0,0
"Venezuela (Bolivarian Republic of)","2024-06-11",0,0,0,0,0,0,0,0
"Venezuela (Bolivarian Republic of)","2024-06-12",0,0,0,0,0,0,0,0
"Venezuela (Bolivarian Republic of)","2024-06-13",0,0,0,0,0,0,0,0
"Venezuela (Bolivarian Republic of)","2024-06-14",0,0,0,0,0,0,0,0
"Venezuela (Bolivarian Republic of)","2024-06-15",0,0,0,0,0,0,0,0
"Venezuela (Bolivarian Republic of)","2024-06-16",0,0,0,0,0,0,0,0
"Venezuela (Bolivarian Republic of)","2024-06-17",0,0,0,0,0,0,0,0
"Venezuela (Bolivarian Republic of)","2024-06-18",0,0,0,0,0,0,0,0
"Venezuela (Bolivarian Republic of)","2024-06-19",0,0,0,0,0,0,0,0
"Venezuela (Bolivarian Republic of)","2024-06-20",0,0,0,0,0,0,0,0
"Venezuela (Bolivarian Republic of)","2024-06-21",0,0,0,0,0,0,0,0
"Venezuela (Bolivarian Republic of)","2024-06-22",0,0,0,0,0,0,0,0
"Venezuela (Bolivarian Republic of)","2024-06-23",0,0,0,0,0,0,0,0
"Venezuela (Bolivarian Republic of)","2024-06-24",0,0,0,0,0,0,0,0
"Venezuela (Bolivarian Republic of)","2024-06-25",0,0,0,0,0,0,0,0
"Venezuela (Bolivarian Republic of)","2024-06-26",0,0,0,0,0,0,0,0
"Venezuela (Bolivarian Republic of)","2024-06-27",0,0,0,0,0,0,0,0
"Venezuela (Bolivarian Republic of)","2024-06-28",0,0,0,0,0,0,0,0
"Venezuela (Bolivarian Republic of)","2024-06-29",0,0,0,0,0,0,0,0
"Venezuela (Bolivarian Republic of)","2024-06-30",0,0,0,0,0,0,0,0
"Venezuela (Bolivarian Republic of)","2024-07-01",0,0,0,0,0,0,0,0
"Venezuela (Bolivarian Republic of)","2024-07-02",0,0,0,0,0,0,0,0
"Venezuela (Bolivarian Republic of)","2024-07-03",0,0,0,0,0,0,0,0
"Venezuela (Bolivarian Republic of)","2024-07-04",0,0,0,0,0,0,0,0
"Venezuela (Bolivarian Republic of)","2024-07-05",0,0,0,0,0,0,0,0
"Venezuela (Bolivarian Republic of)","2024-07-06",0,0,0,0,0,0,0,0
"Venezuela (Bolivarian Republic of)","2024-07-07",0,0,0,0,0,0,0,0
"Venezuela (Bolivarian Republic of)","2024-07-08",0,0,0,0,0,0,0,0
"Venezuela (Bolivarian Republic of)","2024-07-09",0,0,0,0,0,0,0,0
"Venezuela (Bolivarian Republic of)","2024-07-10",0,0,0,0,0,0,0,0
"Venezuela (Bolivarian Republic of)","2024-07-11",0,0,0,0,0,0,0,0
"Venezuela (Bolivarian Republic of)","2024-07-12",0,0,0,0,0,0,0,0
"Venezuela (Bolivarian Republic of)","2024-07-13",0,0,0,0,0,0,0,0
"Venezuela (Bolivarian Republic of)","2024-07-14",0,0,0,0,0,0,0,0
"Venezuela (Bolivarian Republic of)","2024-07-15",0,0,0,0,0,0,0,0
"Venezuela (Bolivarian Republic of)","2024-07-16",0,0,0,0,0,0,0,0
"Venezuela (Bolivarian Republic of)","2024-07-17",0,0,0,0,0,0,0,0
"Venezuela (Bolivarian Republic of)","2024-07-18",0,0,0,0,0,0,0,0
"Venezuela (Bolivarian Republic of)","2024-07-19",0,0,0,0,0,0,0,0
"Venezuela (Bolivarian Republic of)","2024-07-20",0,0,0,0,0,0,0,0
"Venezuela (Bolivarian Republic of)","2024-07-21",0,0,0,0,0,0,0,0
"Venezuela (Bolivarian Republic of)","2024-07-22",0,0,0,0,0,0,0,0
"Venezuela (Bolivarian Republic of)","2024-07-23",0,0,0,0,0,0,0,0
"Venezuela (Bolivarian Republic of)","2024-07-24",0,0,0,0,0,0,0,0
"Venezuela (Bolivarian Republic of)","2024-07-25",0,0,0,0,0,0,0,0
"Venezuela (Bolivarian Republic of)","2024-07-26",0,0,0,0,0,0,0,0
"Venezuela (Bolivarian Republic of)","2024-07-27",0,0,0,0,0,0,0,0
"Venezuela (Bolivarian Republic of)","2024-07-28",0,0,0,0,0,0,0,0
"Venezuela (Bolivarian Republic of)","2024-07-29",0,0,0,0,0,0,0,0
"Venezuela (Bolivarian Republic of)","2024-07-30",0,0,0,0,0,0,0,0
"Venezuela (Bolivarian Republic of)","2024-07-31",0,0,0,0,0,0,0,0
"Venezuela (Bolivarian Republic of)","2024-08-01",0,0,0,0,0,0,0,0
"Venezuela (Bolivarian Republic of)","2024-08-02",0,0,0,0,0,0,0,0
"Venezuela (Bolivarian Republic of)","2024-08-03",0,0,0,0,0,0,0,0
"Venezuela (Bolivarian Republic of)","2024-08-04",0,0,0,0,0,0,0,0
"Venezuela (Bolivarian Republic of)","2024-08-05",0,0,0,0,0,0,0,0
"Venezuela (Bolivarian Republic of)","2024-08-06",0,0,0,0,0,0,0,0
"Venezuela (Bolivarian Republic of)","2024-08-07",0,0,0,0,0,0,0,0
"Venezuela (Bolivarian Republic of)","2024-08-08",0,0,0,0,0,0,0,0
"Venezuela (Bolivarian Republic of)","2024-08-09",0,0,0,0,0,0,0,0
"Venezuela (Bolivarian Republic of)","2024-08-10",0,0,0,0,0,0,0,0
"Venezuela (Bolivarian Republic of)","2024-08-11",0,0,0,0,0,0,0,0
"Venezuela (Bolivarian Republic of)","2024-08-12",0,0,0,0,0,0,0,0
"Venezuela (Bolivarian Republic of)","2024-08-13",0,0,0,0,0,0,0,0
"Venezuela (Bolivarian Republic of)","2024-08-14",0,0,0,0,0,0,0,0
"Venezuela (Bolivarian Republic of)","2024-08-15",0,0,0,0,0,0,0,0
"Venezuela (Bolivarian Republic of)","2024-08-16",0,0,0,0,0,0,0,0
"Venezuela (Bolivarian Republic of)","2024-08-17",0,0,0,0,0,0,0,0
"Venezuela (Bolivarian Republic of)","2024-08-18",0,0,0,0,0,0,0,0
"Venezuela (Bolivarian Republic of)","2024-08-19",0,0,0,0,0,0,0,0
"Venezuela (Bolivarian Republic of)","2024-08-20",0,0,0,0,0,0,0,0
"Venezuela (Bolivarian Republic of)","2024-08-21",0,0,0,0,0,0,0,0
"Venezuela (Bolivarian Republic of)","2024-08-22",0,0,0,0,0,0,0,0
"Venezuela (Bolivarian Republic of)","2024-08-23",0,0,0,0,0,0,0,0
"Venezuela (Bolivarian Republic of)","2024-08-24",0,0,0,0,0,0,0,0
"Venezuela (Bolivarian Republic of)","2024-08-25",0,0,0,0,0,0,0,0
"Venezuela (Bolivarian Republic of)","2024-08-26",0,0,0,0,0,0,0,0
"Venezuela (Bolivarian Republic of)","2024-08-27",0,0,0,0,0,0,0,0
"Venezuela (Bolivarian Republic of)","2024-08-28",0,0,0,0,0,0,0,0
"Venezuela (Bolivarian Republic of)","2024-08-29",0,0,0,0,0,0,0,0
"Venezuela (Bolivarian Republic of)","2024-08-30",0,0,0,0,0,0,0,0
"Venezuela (Bolivarian Republic of)","2024-08-31",0,0,0,0,0,0,0,0
"Venezuela (Bolivarian Republic of)","2024-09-01",0,0,0,0,0,0,0,0
"Venezuela (Bolivarian Republic of)","2024-09-02",0,0,0,0,0,0,0,0
"Venezuela (Bolivarian Republic of)","2024-09-03",0,0,0,0,0,0,0,0
"Venezuela (Bolivarian Republic of)","2024-09-04",0,0,0,0,0,0,0,0
"Venezuela (Bolivarian Republic of)","2024-09-05",0,0,0,0,0,0,0,0
"Venezuela (Bolivarian Republic of)","2024-09-06",0,0,0,0,0,0,0,0
"Venezuela (Bolivarian Republic of)","2024-09-07",0,0,0,0,0,0,0,0
"Venezuela (Bolivarian Republic of)","2024-09-08",0,0,0,0,0,0,0,0
"Venezuela (Bolivarian Republic of)","2024-09-09",0,0,0,0,0,0,0,0
"Venezuela (Bolivarian Republic of)","2024-09-10",0,0,0,0,0,0,0,0
"Venezuela (Bolivarian Republic of)","2024-09-11",0,0,0,0,0,0,0,0
"Venezuela (Bolivarian Republic of)","2024-09-12",0,0,0,0,0,0,0,0
"Venezuela (Bolivarian Republic of)","2024-09-13",0,0,0,0,0,0,0,0
"Venezuela (Bolivarian Republic of)","2024-09-14",0,0,0,0,0,0,0,0
"Venezuela (Bolivarian Republic of)","2024-09-15",0,0,0,0,0,0,0,0
"Venezuela (Bolivarian Republic of)","2024-09-16",0,0,0,0,0,0,0,0
"Venezuela (Bolivarian Republic of)","2024-09-17",0,0,0,0,0,0,0,0
"Venezuela (Bolivarian Republic of)","2024-09-18",0,0,0,0,0,0,0,0
"Venezuela (Bolivarian Republic of)","2024-09-19",0,0,0,0,0,0,0,0
"Venezuela (Bolivarian Republic of)","2024-09-20",0,0,0,0,0,0,0,0
"Venezuela (Bolivarian Republic of)","2024-09-21",0,0,0,0,0,0,0,0
"Venezuela (Bolivarian Republic of)","2024-09-22",0,0,0,0,0,0,0,0
"Venezuela (Bolivarian Republic of)","2024-09-23",0,0,0,0,0,0,0,0
"Venezuela (Bolivarian Republic of)","2024-09-24",0,0,0,0,0,0,0,0
"Venezuela (Bolivarian Republic of)","2024-09-25",0,0,0,0,0,0,0,0
"Venezuela (Bolivarian Republic of)","2024-09-26",0,0,0,0,0,0,0,0
"Venezuela (Bolivarian Republic of)","2024-09-27",0,0,0,0,0,0,0,0
"Venezuela (Bolivarian Republic of)","2024-09-28",0,0,0,0,0,0,0,0
"Venezuela (Bolivarian Republic of)","2024-09-29",0,0,0,0,0,0,0,0
"Venezuela (Bolivarian Republic of)","2024-09-30",0,0,0,0,0,0,0,0
"Venezuela (Bolivarian Republic of)","2024-10-01",0,0,0,0,0,0,0,0
"Venezuela (Bolivarian Republic of)","2024-10-02",0,0,0,0,0,0,0,0
"Venezuela (Bolivarian Republic of)","2024-10-03",0,0,0,0,0,0,0,0
"Venezuela (Bolivarian Republic of)","2024-10-04",0,0,0,0,0,0,0,0
"Venezuela (Bolivarian Republic of)","2024-10-05",0,0,0,0,0,0,0,0
"Venezuela (Bolivarian Republic of)","2024-10-06",0,0,0,0,0,0,0,0
"Venezuela (Bolivarian Republic of)","2024-10-07",0,0,0,0,0,0,0,0
"Venezuela (Bolivarian Republic of)","2024-10-08",0,0,0,0,0,0,0,0
"Venezuela (Bolivarian Republic of)","2024-10-09",0,0,0,0,0,0,0,0
"Venezuela (Bolivarian Republic of)","2024-10-10",0,0,0,0,0,0,0,0
"Venezuela (Bolivarian Republic of)","2024-10-11",0,0,0,0,0,0,0,0
"Venezuela (Bolivarian Republic of)","2024-10-12",0,0,0,0,0,0,0,0
"Venezuela (Bolivarian Republic of)","2024-10-13",0,0,0,0,0,0,0,0
"Venezuela (Bolivarian Republic of)","2024-10-14",0,0,0,0,0,0,0,0
"Venezuela (Bolivarian Republic of)","2024-10-15",0,0,0,0,0,0,0,0
"Venezuela (Bolivarian Republic of)","2024-10-16",0,0,0,0,0,0,0,0
"Venezuela (Bolivarian Republic of)","2024-10-17",0,0,0,0,0,0,0,0
"Venezuela (Bolivarian Republic of)","2024-10-18",0,0,0,0,0,0,0,0
"Venezuela (Bolivarian Republic of)","2024-10-19",0,0,0,0,0,0,0,0
"Venezuela (Bolivarian Republic of)","2024-10-20",0,0,0,0,0,0,0,0
"Venezuela (Bolivarian Republic of)","2024-10-21",0,0,0,0,0,0,0,0
"Venezuela (Bolivarian Republic of)","2024-10-22",0,0,0,0,0,0,0,0
"Venezuela (Bolivarian Republic of)","2024-10-23",0,0,0,0,0,0,0,0
"Venezuela (Bolivarian Republic of)","2024-10-24",0,0,0,0,0,0,0,0
"Venezuela (Bolivarian Republic of)","2024-10-25",0,0,0,0,0,0,0,0
"Venezuela (Bolivarian Republic of)","2024-10-26",0,0,0,0,0,0,0,0
"Venezuela (Bolivarian Republic of)","2024-10-27",0,0,0,0,0,0,0,0
"Venezuela (Bolivarian Republic of)","2024-10-28",0,0,0,0,0,0,0,0
"Venezuela (Bolivarian Republic of)","2024-10-29",0,0,0,0,0,0,0,0
"Venezuela (Bolivarian Republic of)","2024-10-30",0,0,0,0,0,0,0,0
"Venezuela (Bolivarian Republic of)","2024-10-31",0,0,0,0,0,0,0,0
"Venezuela (Bolivarian Republic of)","2024-11-01",0,0,0,0,0,0,0,0
"Venezuela (Bolivarian Republic of)","2024-11-02",0,0,0,0,0,0,0,0
"Venezuela (Bolivarian Republic of)","2024-11-03",0,0,0,0,0,0,0,0
"Venezuela (Bolivarian Republic of)","2024-11-04",0,0,0,0,0,0,0,0
"Venezuela (Bolivarian Republic of)","2024-11-05",0,0,0,0,0,0,0,0
"Venezuela (Bolivarian Republic of)","2024-11-06",0,0,0,0,0,0,0,0
"Venezuela (Bolivarian Republic of)","2024-11-07",0,0,0,0,0,0,0,0
"Venezuela (Bolivarian Republic of)","2024-11-08",0,0,0,0,0,0,0,0
"Venezuela (Bolivarian Republic of)","2024-11-09",0,0,0,0,0,0,0,0
"Venezuela (Bolivarian Republic of)","2024-11-10",0,0,0,0,0,0,0,0
"Venezuela (Bolivarian Republic of)","2024-11-11",0,0,0,0,0,0,0,0
"Venezuela (Bolivarian Republic of)","2024-11-12",0,0,0,0,0,0,0,0
"Venezuela (Bolivarian Republic of)","2024-11-13",0,0,0,0,0,0,0,0
"Venezuela (Bolivarian Republic of)","2024-11-14",0,0,0,0,0,0,0,0
"Venezuela (Bolivarian Republic of)","2024-11-15",0,0,0,0,0,0,0,0
"Venezuela (Bolivarian Republic of)","2024-11-16",0,0,0,0,0,0,0,0
"Venezuela (Bolivarian Republic of)","2024-11-17",0,0,0,0,0,0,0,0
"Venezuela (Bolivarian Republic of)","2024-11-18",0,0,0,0,0,0,0,0
"Venezuela (Bolivarian Republic of)","2024-11-19",0,0,0,0,0,0,0,0
"Venezuela (Bolivarian Republic of)","2024-11-20",0,0,0,0,0,0,0,0
"Venezuela (Bolivarian Republic of)","2024-11-21",0,0,0,0,0,0,0,0
"Venezuela (Bolivarian Republic of)","2024-11-22",0,0,0,0,0,0,0,0
"Venezuela (Bolivarian Republic of)","2024-11-23",0,0,0,0,0,0,0,0
"Venezuela (Bolivarian Republic of)","2024-11-24",0,0,0,0,0,0,0,0
"Venezuela (Bolivarian Republic of)","2024-11-25",0,0,0,0,0,0,0,0
"Venezuela (Bolivarian Republic of)","2024-11-26",0,0,0,0,0,0,0,0
"Venezuela (Bolivarian Republic of)","2024-11-27",0,0,0,0,0,0,0,0
"Venezuela (Bolivarian Republic of)","2024-11-28",0,0,0,0,0,0,0,0
"Venezuela (Bolivarian Republic of)","2024-11-29",0,0,0,0,0,0,0,0
"Venezuela (Bolivarian Republic of)","2024-11-30",0,0,0,0,0,0,0,0
"Venezuela (Bolivarian Republic of)","2024-12-01",0,0,0,0,0,0,0,0
"Venezuela (Bolivarian Republic of)","2024-12-02",0,0,0,0,0,0,0,0
"Venezuela (Bolivarian Republic of)","2024-12-03",0,0,0,0,0,0,0,0
"Venezuela (Bolivarian Republic of)","2024-12-04",0,0,0,0,0,0,0,0
"Venezuela (Bolivarian Republic of)","2024-12-05",0,0,0,0,0,0,0,0
"Venezuela (Bolivarian Republic of)","2024-12-06",0,0,0,0,0,0,0,0
"Venezuela (Bolivarian Republic of)","2024-12-07",0,0,0,0,0,0,0,0
"Venezuela (Bolivarian Republic of)","2024-12-08",0,0,0,0,0,0,0,0
"Venezuela (Bolivarian Republic of)","2024-12-09",0,0,0,0,0,0,0,0
"Venezuela (Bolivarian Republic of)","2024-12-10",0,0,0,0,0,0,0,0
"Venezuela (Bolivarian Republic of)","2024-12-11",0,0,0,0,0,0,0,0
"Venezuela (Bolivarian Republic of)","2024-12-12",0,0,0,0,0,0,0,0
"Venezuela (Bolivarian Republic of)","2024-12-13",0,0,0,0,0,0,0,0
"Venezuela (Bolivarian Republic of)","2024-12-14",0,0,0,0,0,0,0,0
"Venezuela (Bolivarian Republic of)","2024-12-15",0,0,0,0,0,0,0,0
"Venezuela (Bolivarian Republic of)","2024-12-16",0,0,0,0,0,0,0,0
"Venezuela (Bolivarian Republic of)","2024-12-17",0,0,0,0,0,0,0,0
"Venezuela (Bolivarian Republic of)","2024-12-18",0,0,0,0,0,0,0,0
"Venezuela (Bolivarian Republic of)","2024-12-19",0,0,0,0,0,0,0,0
"Venezuela (Bolivarian Republic of)","2024-12-20",0,0,0,0,0,0,0,0
"Venezuela (Bolivarian Republic of)","2024-12-21",0,0,0,0,0,0,0,0
"Venezuela (Bolivarian Republic of)","2024-12-22",0,0,0,0,0,0,0,0
"Venezuela (Bolivarian Republic of)","2024-12-23",0,0,0,0,0,0,0,0
"Venezuela (Bolivarian Republic of)","2024-12-24",0,0,0,0,0,0,0,0
"Venezuela (Bolivarian Republic of)","2024-12-25",0,0,0,0,0,0,0,0
"Venezuela (Bolivarian Republic of)","2024-12-26",0,0,0,0,0,0,0,0
"Venezuela (Bolivarian Republic of)","2024-12-27",0,0,0,0,0,0,0,0
"Venezuela (Bolivarian Republic of)","2024-12-28",0,0,0,0,0,0,0,0
"Venezuela (Bolivarian Republic of)","2024-12-29",0,0,0,0,0,0,0,0
"Venezuela (Bolivarian Republic of)","2024-12-30",0,0,0,0,0,0,0,0
"Venezuela (Bolivarian Republic of)","2024-12-31",0,0,0,0,0,0,0,0
"Venezuela (Bolivarian Republic of)","2025-01-01",0,0,0,0,0,0,0,0
"Venezuela (Bolivarian Republic of)","2025-01-02",0,0,0,0,0,0,0,0
"Venezuela (Bolivarian Republic of)","2025-01-03",0,0,0,0,0,0,0,0
"Venezuela (Bolivarian Republic of)","2025-01-04",0,0,0,0,0,0,0,0
"Venezuela (Bolivarian Republic of)","2025-01-05",0,0,0,0,0,0,0,0
"Venezuela (Bolivarian Republic of)","2025-01-06",0,0,0,0,0,0,0,0
"Venezuela (Bolivarian Republic of)","2025-01-07",0,0,0,0,0,0,0,0
"Venezuela (Bolivarian Republic of)","2025-01-08",0,0,0,0,0,0,0,0
"Venezuela (Bolivarian Republic of)","2025-01-09",0,0,0,0,0,0,0,0
"Venezuela (Bolivarian Republic of)","2025-01-10",0,0,0,0,0,0,0,0
"Venezuela (Bolivarian Republic of)","2025-01-11",0,0,0,0,0,0,0,0
"Venezuela (Bolivarian Republic of)","2025-01-12",0,0,0,0,0,0,0,0
"Venezuela (Bolivarian Republic of)","2025-01-13",0,0,0,0,0,0,0,0
"Venezuela (Bolivarian Republic of)","2025-01-14",0,0,0,0,0,0,0,0
"Venezuela (Bolivarian Republic of)","2025-01-15",0,0,0,0,0,0,0,0
"Venezuela (Bolivarian Republic of)","2025-01-16",0,0,0,0,0,0,0,0
"Venezuela (Bolivarian Republic of)","2025-01-17",0,0,0,0,0,0,0,0
"Venezuela (Bolivarian Republic of)","2025-01-18",0,0,0,0,0,0,0,0
"Venezuela (Bolivarian Republic of)","2025-01-19",0,0,0,0,0,0,0,0
"Venezuela (Bolivarian Republic of)","2025-01-20",0,0,0,0,0,0,0,0
"Venezuela (Bolivarian Republic of)","2025-01-21",0,0,0,0,0,0,0,0
"Venezuela (Bolivarian Republic of)","2025-01-22",0,0,0,0,0,0,0,0
"Venezuela (Bolivarian Republic of)","2025-01-23",0,0,0,0,0,0,0,0
"Venezuela (Bolivarian Republic of)","2025-01-24",0,0,0,0,0,0,0,0
"Venezuela (Bolivarian Republic of)","2025-01-25",0,0,0,0,0,0,0,0
"Venezuela (Bolivarian Republic of)","2025-01-26",0,0,0,0,0,0,0,0
"Venezuela (Bolivarian Republic of)","2025-01-27",0,0,0,0,0,0,0,0
"Venezuela (Bolivarian Republic of)","2025-01-28",0,0,0,0,0,0,0,0
"Venezuela (Bolivarian Republic of)","2025-01-29",0,0,0,0,0,0,0,0
"Venezuela (Bolivarian Republic of)","2025-01-30",0,0,0,0,0,0,0,0
"Venezuela (Bolivarian Republic of)","2025-01-31",0,0,0,0,0,0,0,0
"Venezuela (Bolivarian Republic of)","2025-02-01",0,0,0,0,0,0,0,0
"Venezuela (Bolivarian Republic of)","2025-02-02",0,0,0,0,0,0,0,0
"Venezuela (Bolivarian Republic of)","2025-02-03",0,0,0,0,0,0,0,0
"Viet Nam","2024-01-01",0,0,0,0,0,0,0,0
"Viet Nam","2024-01-02",0,0,0,0,0,0,0,0
"Viet Nam","2024-01-03",0,0,0,0,0,0,0,0
"Viet Nam","2024-01-04",0,0,0,0,0,0,0,0
"Viet Nam","2024-01-05",0,0,0,0,0,0,0,0
"Viet Nam","2024-01-06",0,0,0,0,0,0,0,0
"Viet Nam","2024-01-07",0,0,0,0,0,0,0,0
"Viet Nam","2024-01-08",0,0,0,0,0,0,0,0
"Viet Nam","2024-01-09",0,0,0,0,0,0,0,0
"Viet Nam","2024-01-10",0,14,14,0,14,14,0,0
"Viet Nam","2024-01-11",0,0,14,0,0,14,0,0
"Viet Nam","2024-01-12",0,0,14,0,0,14,0,0
"Viet Nam","2024-01-13",0,0,14,0,1,15,0,0
"Viet Nam","2024-01-14",0,0,14,0,0,15,0,0
"Viet Nam","2024-01-15",0,0,14,0,0,15,0,0
"Viet Nam","2024-01-16",0,0,14,0,0,15,0,0
"Viet Nam","2024-01-17",0,0,14,0,0,15,0,0
"Viet Nam","2024-01-18",0,0,14,0,1,16,0,0
"Viet Nam","2024-01-19",0,0,14,0,0,16,0,0
"Viet Nam","2024-01-20",0,2,16,0,0,16,0,0
"Viet Nam","2024-01-21",0,0,16,0,1,17,0,0
"Viet Nam","2024-01-22",0,0,16,0,1,18,0,0
"Viet Nam","2024-01-23",0,0,16,0,2,20,0,0
"Viet Nam","2024-01-24",0,5,21,0,1,21,0,0
"Viet Nam","2024-01-25",0,0,21,0,0,21,0,0
"Viet Nam","2024-01-26",0,0,21,0,1,22,0,0
"Viet Nam","2024-01-27",0,0,21,0,0,22,0,0
"Viet Nam","2024-01-28",0,0,21,0,0,22,0,0
"Viet Nam","2024-01-29",0,0,21,0,1,23,0,0
"Viet Nam","2024-01-30",0,0,21,0,0,23,0,0
"Viet Nam","2024-01-31",0,0,21,0,0,23,0,0
"Viet Nam","2024-02-01",0,0,21,0,0,23,0,0
"Viet Nam","2024-02-02",0,0,21,0,1,24,0,0
"Viet Nam","2024-02-03",0,0,21,0,0,24,0,0
"Viet Nam","2024-02-04",0,0,21,0,0,24,0,0
"Viet Nam","2024-02-05",0,0,21,0,1,25,0,0
"Viet Nam","2024-02-06",0,0,21,0,0,25,0,0
"Viet Nam","2024-02-07",0,0,21,0,0,25,0,0
"Viet Nam","2024-02-08",0,0,21,0,1,26,0,0
"Viet Nam","2024-02-09",0,5,26,0,0,26,0,0
"Viet Nam","2024-02-10",0,0,26,0,0,26,0,0
"Viet Nam","2024-02-11",0,0,26,0,1,27,0,0
"Viet Nam","2024-02-12",0,0,26,0,0,27,0,0
"Viet Nam","2024-02-13",0,0,26,0,1,28,0,0
"Viet Nam","2024-02-14",0,0,26,0,0,28,0,0
"Viet Nam","2024-02-15",0,0,26,0,0,28,0,0
"Viet Nam","2024-02-16",0,0,26,0,1,29,0,0
"Viet Nam","2024-02-17",0,0,26,0,0,29,0,0
"Viet Nam","2024-02-18",0,0,26,0,0,29,0,0
"Viet Nam","2024-02-19",0,0,26,0,1,30,0,0
"Viet Nam","2024-02-20",0,0,26,0,0,30,0,0
"Viet Nam","2024-02-21",0,0,26,0,1,31,0,0
"Viet Nam","2024-02-22",0,0,26,0,0,31,0,0
"Viet Nam","2024-02-23",0,0,26,0,0,31,0,0
"Viet Nam","2024-02-24",0,0,26,0,1,32,0,0
"Viet Nam","2024-02-25",0,0,26,0,0,32,0,0
"Viet Nam","2024-02-26",0,0,26,0,1,33,0,0
"Viet Nam","2024-02-27",0,0,26,0,0,33,0,0
"Viet Nam","2024-02-28",0,0,26,0,0,33,0,0
"Viet Nam","2024-02-29",0,0,26,0,1,34,0,0
"Viet Nam","2024-03-01",0,0,26,0,0,34,0,0
"Viet Nam","2024-03-02",0,0,26,0,0,34,0,0
"Viet Nam","2024-03-03",0,0,26,0,1,35,0,0
"Viet Nam","2024-03-04",0,0,26,0,0,35,0,0
"Viet Nam","2024-03-05",0,0,26,0,1,36,0,0
"Viet Nam","2024-03-06",0,10,36,0,0,36,0,0
"Viet Nam","2024-03-07",0,0,36,0,1,37,0,0
"Viet Nam","2024-03-08",0,0,36,0,0,37,0,0
"Viet Nam","2024-03-09",0,0,36,0,1,38,0,0
"Viet Nam","2024-03-10",0,0,36,0,0,38,0,0
"Viet Nam","2024-03-11",0,0,36,0,1,39,0,0
"Viet Nam","2024-03-12",0,0,36,0,1,40,0,0
"Viet Nam","2024-03-13",0,0,36,0,0,40,0,0
"Viet Nam","2024-03-14",0,0,36,0,1,41,0,0
"Viet Nam","2024-03-15",0,0,36,0,0,41,0,0
"Viet Nam","2024-03-16",0,0,36,0,1,42,0,0
"Viet Nam","2024-03-17",0,0,36,0,1,43,0,0
"Viet Nam","2024-03-18",0,0,36,0,0,43,0,0
"Viet Nam","2024-03-19",0,0,36,0,1,44,0,0
"Viet Nam","2024-03-20",0,0,36,0,0,44,0,0
"Viet Nam","2024-03-21",0,0,36,0,1,45,0,0
"Viet Nam","2024-03-22",0,0,36,0,1,46,0,0
"Viet Nam","2024-03-23",0,0,36,0,0,46,0,0
"Viet Nam","2024-03-24",0,0,36,0,1,47,0,0
"Viet Nam","2024-03-25",0,0,36,0,0,47,0,0
"Viet Nam","2024-03-26",0,12,48,0,1,48,0,0
"Viet Nam","2024-03-27",0,0,48,0,1,49,0,0
"Viet Nam","2024-03-28",0,0,48,0,0,49,0,0
"Viet Nam","2024-03-29",0,0,48,0,1,50,0,0
"Viet Nam","2024-03-30",0,0,48,0,0,50,0,0
"Viet Nam","2024-03-31",0,0,48,0,1,51,0,0
"Viet Nam","2024-04-01",0,0,48,0,0,51,0,0
"Viet Nam","2024-04-02",0,0,48,0,1,52,0,0
"Viet Nam","2024-04-03",0,0,48,0,0,52,0,0
"Viet Nam","2024-04-04",0,0,48,0,1,53,0,0
"Viet Nam","2024-04-05",0,0,48,0,0,53,0,0
"Viet Nam","2024-04-06",0,0,48,0,1,54,0,0
"Viet Nam","2024-04-07",0,0,48,0,0,54,0,0
"Viet Nam","2024-04-08",0,0,48,0,1,55,0,0
"Viet Nam","2024-04-09",0,0,48,0,0,55,0,0
"Viet Nam","2024-04-10",0,0,48,0,1,56,0,0
"Viet Nam","2024-04-11",0,0,48,0,1,57,0,0
"Viet Nam","2024-04-12",0,0,48,0,0,57,0,0
"Viet Nam","2024-04-13",0,0,48,0,1,58,0,0
"Viet Nam","2024-04-14",0,0,48,0,0,58,0,0
"Viet Nam","2024-04-15",0,0,48,0,1,59,0,0
"Viet Nam","2024-04-16",0,0,48,0,0,59,0,0
"Viet Nam","2024-04-17",0,0,48,0,1,60,0,0
"Viet Nam","2024-04-18",0,0,48,0,0,60,0,0
"Viet Nam","2024-04-19",0,0,48,0,1,61,0,0
"Viet Nam","2024-04-20",0,0,48,0,0,61,0,0
"Viet Nam","2024-04-21",0,0,48,0,1,62,0,0
"Viet Nam","2024-04-22",0,0,48,0,0,62,0,0
"Viet Nam","2024-04-23",0,0,48,0,1,63,0,0
"Viet Nam","2024-04-24",0,0,48,0,0,63,0,0
"Viet Nam","2024-04-25",0,0,48,0,1,64,0,0
"Viet Nam","2024-04-26",0,0,48,0,1,65,0,0
"Viet Nam","2024-04-27",0,0,48,0,0,65,0,0
"Viet Nam","2024-04-28",0,0,48,0,1,66,0,0
"Viet Nam","2024-04-29",0,0,48,0,0,66,0,0
"Viet Nam","2024-04-30",0,0,48,0,1,67,0,0
"Viet Nam","2024-05-01",0,0,48,0,0,67,0,0
"Viet Nam","2024-05-02",0,0,48,0,1,68,0,0
"Viet Nam","2024-05-03",0,0,48,0,0,68,0,0
"Viet Nam","2024-05-04",0,0,48,0,1,69,0,0
"Viet Nam","2024-05-05",0,0,48,0,0,69,0,0
"Viet Nam","2024-05-06",0,0,48,0,1,70,0,0
"Viet Nam","2024-05-07",0,0,48,0,0,70,0,0
"Viet Nam","2024-05-08",0,0,48,0,1,71,0,0
"Viet Nam","2024-05-09",0,0,48,0,0,71,0,0
"Viet Nam","2024-05-10",0,24,72,0,1,72,0,0
"Viet Nam","2024-05-11",0,0,72,0,0,72,0,0
"Viet Nam","2024-05-12",0,0,72,0,0,72,0,0
"Viet Nam","2024-05-13",0,0,72,0,0,72,0,0
"Viet Nam","2024-05-14",0,0,72,0,1,73,0,0
"Viet Nam","2024-05-15",0,0,72,0,0,73,0,0
"Viet Nam","2024-05-16",0,0,72,0,0,73,0,0
"Viet Nam","2024-05-17",0,0,72,0,0,73,0,0
"Viet Nam","2024-05-18",0,0,72,0,0,73,0,0
"Viet Nam","2024-05-19",0,0,72,0,0,73,0,0
"Viet Nam","2024-05-20",0,0,72,0,0,73,0,0
"Viet Nam","2024-05-21",0,0,72,0,1,74,0,0
"Viet Nam","2024-05-22",0,0,72,0,0,74,0,0
"Viet Nam","2024-05-23",0,0,72,0,0,74,0,0
"Viet Nam","2024-05-24",0,0,72,0,0,74,0,0
"Viet Nam","2024-05-25",0,0,72,0,0,74,0,0
"Viet Nam","2024-05-26",0,0,72,0,0,74,0,0
"Viet Nam","2024-05-27",0,0,72,0,0,74,0,0
"Viet Nam","2024-05-28",0,0,72,0,1,75,0,0
"Viet Nam","2024-05-29",0,0,72,0,0,75,0,0
"Viet Nam","2024-05-30",0,0,72,0,0,75,0,0
"Viet Nam","2024-05-31",0,3,75,0,0,75,0,0
"Viet Nam","2024-06-01",0,0,75,0,0,75,0,0
"Viet Nam","2024-06-02",0,0,75,0,0,75,0,0
"Viet Nam","2024-06-03",0,0,75,0,1,76,0,0
"Viet Nam","2024-06-04",0,0,75,0,0,76,0,0
"Viet Nam","2024-06-05",0,0,75,0,0,76,0,0
"Viet Nam","2024-06-06",0,0,75,0,0,76,0,0
"Viet Nam","2024-06-07",0,0,75,0,1,77,0,0
"Viet Nam","2024-06-08",0,0,75,0,0,77,0,0
"Viet Nam","2024-06-09",0,0,75,0,0,77,0,0
"Viet Nam","2024-06-10",0,0,75,0,0,77,0,0
"Viet Nam","2024-06-11",0,0,75,0,0,77,0,0
"Viet Nam","2024-06-12",0,0,75,0,1,78,0,0
"Viet Nam","2024-06-13",0,0,75,0,0,78,0,0
"Viet Nam","2024-06-14",0,0,75,0,0,78,0,0
"Viet Nam","2024-06-15",0,0,75,0,0,78,0,0
"Viet Nam","2024-06-16",0,0,75,0,0,78,0,0
"Viet Nam","2024-06-17",0,0,75,0,1,79,0,0
"Viet Nam","2024-06-18",0,0,75,0,0,79,0,0
"Viet Nam","2024-06-19",0,0,75,0,0,79,0,0
"Viet Nam","2024-06-20",0,0,75,0,0,79,0,0
"Viet Nam","2024-06-21",0,0,75,0,0,79,0,0
"Viet Nam","2024-06-22",0,0,75,0,1,80,0,0
"Viet Nam","2024-06-23",0,0,75,0,0,80,0,0
"Viet Nam","2024-06-24",0,0,75,0,0,80,0,0
"Viet Nam","2024-06-25",0,0,75,0,0,80,0,0
"Viet Nam","2024-06-26",0,0,75,0,1,81,0,0
"Viet Nam","2024-06-27",0,0,75,0,0,81,0,0
"Viet Nam","2024-06-28",0,6,81,0,0,81,0,0
"Viet Nam","2024-06-29",0,0,81,0,0,81,0,0
"Viet Nam","2024-06-30",0,0,81,0,0,81,0,0
"Viet Nam","2024-07-01",0,0,81,0,0,81,0,0
"Viet Nam","2024-07-02",0,0,81,0,0,81,0,0
"Viet Nam","2024-07-03",0,0,81,0,0,81,0,0
"Viet Nam","2024-07-04",0,0,81,0,0,81,0,0
"Viet Nam","2024-07-05",0,0,81,0,0,81,0,0
"Viet Nam","2024-07-06",0,0,81,0,0,81,0,0
"Viet Nam","2024-07-07",0,0,81,0,0,81,0,0
"Viet Nam","2024-07-08",0,0,81,0,1,82,0,0
"Viet Nam","2024-07-09",0,0,81,0,0,82,0,0
"Viet Nam","2024-07-10",0,0,81,0,0,82,0,0
"Viet Nam","2024-07-11",0,0,81,0,0,82,0,0
"Viet Nam","2024-07-12",0,0,81,0,0,82,0,0
"Viet Nam","2024-07-13",0,0,81,0,0,82,0,0
"Viet Nam","2024-07-14",0,0,81,0,0,82,0,0
"Viet Nam","2024-07-15",0,0,81,0,0,82,0,0
"Viet Nam","2024-07-16",0,1,82,0,0,82,0,0
"Viet Nam","2024-07-17",0,0,82,0,0,82,0,0
"Viet Nam","2024-07-18",0,0,82,0,0,82,0,0
"Viet Nam","2024-07-19",0,0,82,0,0,82,0,0
"Viet Nam","2024-07-20",0,0,82,0,0,82,0,0
"Viet Nam","2024-07-21",0,0,82,0,0,82,0,0
"Viet Nam","2024-07-22",0,0,82,0,0,82,0,0
"Viet Nam","2024-07-23",0,0,82,0,0,82,0,0
"Viet Nam","2024-07-24",0,0,82,0,0,82,0,0
"Viet Nam","2024-07-25",0,0,82,0,0,82,0,0
"Viet Nam","2024-07-26",0,0,82,0,0,82,0,0
"Viet Nam","2024-07-27",0,0,82,0,0,82,0,0
"Viet Nam","2024-07-28",0,0,82,0,0,82,0,0
"Viet Nam","2024-07-29",0,0,82,0,0,82,0,0
"Viet Nam","2024-07-30",0,0,82,0,0,82,0,0
"Viet Nam","2024-07-31",0,0,82,0,0,82,0,0
"Viet Nam","2024-08-01",0,0,82,0,0,82,0,0
"Viet Nam","2024-08-02",0,0,82,0,0,82,0,0
"Viet Nam","2024-08-03",0,0,82,0,0,82,0,0
"Viet Nam","2024-08-04",0,0,82,0,0,82,0,0
"Viet Nam","2024-08-05",0,0,82,0,0,82,0,0
"Viet Nam","2024-08-06",0,0,82,0,0,82,0,0
"Viet Nam","2024-08-07",0,0,82,0,0,82,0,0
"Viet Nam","2024-08-08",0,0,82,0,0,82,0,0
"Viet Nam","2024-08-09",0,0,82,0,0,82,0,0
"Viet Nam","2024-08-10",0,0,82,0,0,82,0,0
"Viet Nam","2024-08-11",0,0,82,0,0,82,0,0
"Viet Nam","2024-08-12",0,0,82,0,0,82,0,0
"Viet Nam","2024-08-13",0,0,82,0,1,83,0,0
"Viet Nam","2024-08-14",0,0,82,0,0,83,0,0
"Viet Nam","2024-08-15",0,0,82,0,0,83,0,0
"Viet Nam","2024-08-16",0,0,82,0,0,83,0,0
"Viet Nam","2024-08-17",0,0,82,0,0,83,0,0
"Viet Nam","2024-08-18",0,0,82,0,0,83,0,0
"Viet Nam","2024-08-19",0,0,82,0,0,83,0,0
"Viet Nam","2024-08-20",0,0,82,0,0,83,0,0
"Viet Nam","2024-08-21",0,0,82,0,0,83,0,0
"Viet Nam","2024-08-22",0,0,82,0,0,83,0,0
"Viet Nam","2024-08-23",0,0,82,0,0,83,0,0
"Viet Nam","2024-08-24",0,0,82,0,0,83,0,0
"Viet Nam","2024-08-25",0,0,82,0,0,83,0,0
"Viet Nam","2024-08-26",0,0,82,0,0,83,0,0
"Viet Nam","2024-08-27",0,0,82,0,0,83,0,0
"Viet Nam","2024-08-28",0,0,82,0,0,83,0,0
"Viet Nam","2024-08-29",0,0,82,0,0,83,0,0
"Viet Nam","2024-08-30",0,0,82,0,0,83,0,0
"Viet Nam","2024-08-31",0,0,82,0,0,83,0,0
"Viet Nam","2024-09-01",0,0,82,0,0,83,0,0
"Viet Nam","2024-09-02",0,0,82,0,0,83,0,0
"Viet Nam","2024-09-03",0,0,82,0,0,83,0,0
"Viet Nam","2024-09-04",0,0,82,0,0,83,0,0
"Viet Nam","2024-09-05",0,0,82,0,0,83,0,0
"Viet Nam","2024-09-06",0,0,82,0,0,83,0,0
"Viet Nam","2024-09-07",0,0,82,0,0,83,0,0
"Viet Nam","2024-09-08",0,0,82,0,0,83,0,0
"Viet Nam","2024-09-09",0,0,82,0,0,83,0,0
"Viet Nam","2024-09-10",0,0,82,0,0,83,0,0
"Viet Nam","2024-09-11",0,0,82,0,0,83,0,0
"Viet Nam","2024-09-12",0,0,82,0,0,83,0,0
"Viet Nam","2024-09-13",0,0,82,0,0,83,0,0
"Viet Nam","2024-09-14",0,0,82,0,0,83,0,0
"Viet Nam","2024-09-15",0,0,82,0,0,83,0,0
"Viet Nam","2024-09-16",0,0,82,0,0,83,0,0
"Viet Nam","2024-09-17",0,0,82,0,0,83,0,0
"Viet Nam","2024-09-18",0,0,82,0,0,83,0,0
"Viet Nam","2024-09-19",0,0,82,0,0,83,0,0
"Viet Nam","2024-09-20",0,0,82,0,0,83,0,0
"Viet Nam","2024-09-21",0,0,82,0,0,83,0,0
"Viet Nam","2024-09-22",0,0,82,0,0,83,0,0
"Viet Nam","2024-09-23",0,0,82,0,0,83,0,0
"Viet Nam","2024-09-24",0,0,82,0,0,83,0,0
"Viet Nam","2024-09-25",0,0,82,0,0,83,0,0
"Viet Nam","2024-09-26",0,0,82,0,0,83,0,0
"Viet Nam","2024-09-27",0,0,82,0,0,83,0,0
"Viet Nam","2024-09-28",0,0,82,0,0,83,0,0
"Viet Nam","2024-09-29",0,0,82,0,0,83,0,0
"Viet Nam","2024-09-30",0,0,82,0,0,83,0,0
"Viet Nam","2024-10-01",0,0,82,0,0,83,0,0
"Viet Nam","2024-10-02",0,0,82,0,0,83,0,0
"Viet Nam","2024-10-03",0,0,82,0,0,83,0,0
"Viet Nam","2024-10-04",0,0,82,0,0,83,0,0
"Viet Nam","2024-10-05",0,0,82,0,1,84,0,0
"Viet Nam","2024-10-06",0,0,82,0,0,84,0,0
"Viet Nam","2024-10-07",0,0,82,0,0,84,0,0
"Viet Nam","2024-10-08",0,0,82,0,0,84,0,0
"Viet Nam","2024-10-09",0,0,82,0,0,84,0,0
"Viet Nam","2024-10-10",0,0,82,0,0,84,0,0
"Viet Nam","2024-10-11",0,0,82,0,0,84,0,0
"Viet Nam","2024-10-12",0,0,82,0,0,84,0,0
"Viet Nam","2024-10-13",0,0,82,0,0,84,0,0
"Viet Nam","2024-10-14",0,0,82,0,0,84,0,0
"Viet Nam","2024-10-15",0,0,82,0,0,84,0,0
"Viet Nam","2024-10-16",0,0,82,0,0,84,0,0
"Viet Nam","2024-10-17",0,0,82,0,0,84,0,0
"Viet Nam","2024-10-18",0,0,82,0,0,84,0,0
"Viet Nam","2024-10-19",0,0,82,0,0,84,0,0
"Viet Nam","2024-10-20",0,0,82,0,0,84,0,0
"Viet Nam","2024-10-21",0,0,82,0,0,84,0,0
"Viet Nam","2024-10-22",0,0,82,0,0,84,0,0
"Viet Nam","2024-10-23",0,0,82,0,0,84,0,0
"Viet Nam","2024-10-24",0,0,82,0,0,84,0,0
"Viet Nam","2024-10-25",0,0,82,0,0,84,0,0
"Viet Nam","2024-10-26",0,0,82,0,0,84,0,0
"Viet Nam","2024-10-27",0,0,82,0,0,84,0,0
"Viet Nam","2024-10-28",0,0,82,0,0,84,0,0
"Viet Nam","2024-10-29",0,0,82,0,0,84,0,0
"Viet Nam","2024-10-30",0,0,82,0,0,84,0,0
"Viet Nam","2024-10-31",0,0,82,0,0,84,0,0
"Viet Nam","2024-11-01",0,2,84,0,0,84,0,0
"Viet Nam","2024-11-02",0,0,84,0,0,84,0,0
"Viet Nam","2024-11-03",0,0,84,0,0,84,0,0
"Viet Nam","2024-11-04",0,0,84,0,0,84,0,0
"Viet Nam","2024-11-05",0,0,84,0,1,85,0,0
"Viet Nam","2024-11-06",0,0,84,0,0,85,0,0
"Viet Nam","2024-11-07",0,0,84,0,0,85,0,0
"Viet Nam","2024-11-08",0,0,84,0,0,85,0,0
"Viet Nam","2024-11-09",0,0,84,0,0,85,0,0
"Viet Nam","2024-11-10",0,0,84,0,0,85,0,0
"Viet Nam","2024-11-11",0,0,84,0,1,86,0,0
"Viet Nam","2024-11-12",0,0,84,0,0,86,0,0
"Viet Nam","2024-11-13",0,0,84,0,0,86,0,0
"Viet Nam","2024-11-14",0,0,84,0,0,86,0,0
"Viet Nam","2024-11-15",0,0,84,0,0,86,0,0
"Viet Nam","2024-11-16",0,0,84,0,0,86,0,0
"Viet Nam","2024-11-17",0,0,84,0,1,87,0,0
"Viet Nam","2024-11-18",0,0,84,0,0,87,0,0
"Viet Nam","2024-11-19",0,0,84,0,0,87,0,0
"Viet Nam","2024-11-20",0,0,84,0,0,87,0,0
"Viet Nam","2024-11-21",0,0,84,0,0,87,0,0
"Viet Nam","2024-11-22",0,0,84,0,0,87,0,0
"Viet Nam","2024-11-23",0,0,84,0,1,88,0,0
"Viet Nam","2024-11-24",0,0,84,0,0,88,0,0
"Viet Nam","2024-11-25",0,0,84,0,0,88,0,0
"Viet Nam","2024-11-26",0,4,88,0,0,88,0,0
"Viet Nam","2024-11-27",0,0,88,0,0,88,0,0
"Viet Nam","2024-11-28",0,0,88,0,0,88,0,0
"Viet Nam","2024-11-29",0,0,88,0,0,88,0,0
"Viet Nam","2024-11-30",0,0,88,0,0,88,0,0
"Viet Nam","2024-12-01",0,0,88,0,0,88,0,0
"Viet Nam","2024-12-02",0,0,88,0,0,88,0,0
"Viet Nam","2024-12-03",0,0,88,0,0,88,0,0
"Viet Nam","2024-12-04",0,0,88,0,0,88,0,0
"Viet Nam","2024-12-05",0,0,88,0,0,88,0,0
"Viet Nam","2024-12-06",0,0,88,0,0,88,0,0
"Viet Nam","2024-12-07",0,0,88,0,0,88,0,0
"Viet Nam","2024-12-08",0,0,88,0,0,88,0,0
"Viet Nam","2024-12-09",0,0,88,0,0,88,0,0
"Viet Nam","2024-12-10",0,0,88,0,0,88,0,0
"Viet Nam","2024-12-11",0,0,88,0,0,88,0,0
"Viet Nam","2024-12-12",0,0,88,0,0,88,0,0
"Viet Nam","2024-12-13",0,0,88,0,0,88,0,0
"Viet Nam","2024-12-14",0,0,88,0,0,88,0,0
"Viet Nam","2024-12-15",0,0,88,0,0,88,0,0
"Viet Nam","2024-12-16",0,0,88,0,0,88,0,0
"Viet Nam","2024-12-17",0,0,88,0,0,88,0,0
"Viet Nam","2024-12-18",0,0,88,0,0,88,0,0
"Viet Nam","2024-12-19",0,0,88,0,0,88,0,0
"Viet Nam","2024-12-20",0,0,88,0,0,88,0,0
"Viet Nam","2024-12-21",0,0,88,0,0,88,0,0
"Viet Nam","2024-12-22",0,0,88,0,0,88,0,0
"Viet Nam","2024-12-23",0,0,88,0,0,88,0,0
"Viet Nam","2024-12-24",0,0,88,0,0,88,0,0
"Viet Nam","2024-12-25",0,0,88,0,0,88,0,0
"Viet Nam","2024-12-26",0,0,88,0,0,88,0,0
"Viet Nam","2024-12-27",0,0,88,0,0,88,0,0
"Viet Nam","2024-12-28",0,0,88,0,0,88,0,0
"Viet Nam","2024-12-29",0,0,88,0,0,88,0,0
"Viet Nam","2024-12-30",0,0,88,0,0,88,0,0
"Viet Nam","2024-12-31",0,0,88,0,0,88,0,0
"Viet Nam","2025-01-01",0,0,88,0,0,88,0,0
"Viet Nam","2025-01-02",0,0,88,0,0,88,0,0
"Viet Nam","2025-01-03",0,0,88,0,0,88,0,0
"Viet Nam","2025-01-04",0,0,88,0,0,88,0,0
"Viet Nam","2025-01-05",0,0,88,0,0,88,0,0
"Viet Nam","2025-01-06",0,0,88,0,0,88,0,0
"Viet Nam","2025-01-07",0,0,88,0,0,88,0,0
"Viet Nam","2025-01-08",0,0,88,0,0,88,0,0
"Viet Nam","2025-01-09",0,0,88,0,0,88,0,0
"Viet Nam","2025-01-10",0,0,88,0,0,88,0,0
"Viet Nam","2025-01-11",0,0,88,0,0,88,0,0
"Viet Nam","2025-01-12",0,0,88,0,0,88,0,0
"Viet Nam","2025-01-13",0,0,88,0,0,88,0,0
"Viet Nam","2025-01-14",0,0,88,0,0,88,0,0
"Viet Nam","2025-01-15",0,0,88,0,0,88,0,0
"Viet Nam","2025-01-16",0,0,88,0,0,88,0,0
"Viet Nam","2025-01-17",0,0,88,0,0,88,0,0
"Viet Nam","2025-01-18",0,0,88,0,0,88,0,0
"Viet Nam","2025-01-19",0,0,88,0,0,88,0,0
"Viet Nam","2025-01-20",0,0,88,0,0,88,0,0
"Viet Nam","2025-01-21",0,0,88,0,0,88,0,0
"Viet Nam","2025-01-22",0,0,88,0,0,88,0,0
"Viet Nam","2025-01-23",0,0,88,0,0,88,0,0
"Viet Nam","2025-01-24",0,0,88,0,0,88,0,0
"Viet Nam","2025-01-25",0,0,88,0,0,88,0,0
"Viet Nam","2025-01-26",0,0,88,0,0,88,0,0
"Viet Nam","2025-01-27",0,0,88,0,0,88,0,0
"Viet Nam","2025-01-28",0,0,88,0,0,88,0,0
"Viet Nam","2025-01-29",0,0,88,0,0,88,0,0
"Viet Nam","2025-01-30",0,0,88,0,0,88,0,0
"Viet Nam","2025-01-31",0,0,88,0,0,88,0,0
"Viet Nam","2025-02-01",0,0,88,0,0,88,0,0
"Viet Nam","2025-02-02",0,0,88,0,0,88,0,0
"Viet Nam","2025-02-03",0,0,88,0,0,88,0,0
"World","2024-01-01",0,0,0,0,0,0,0,0
"World","2024-01-02",0,112,112,0,112,112,0,0
"World","2024-01-03",0,0,112,0,1,113,0,0
"World","2024-01-04",0,2,114,0,1,114,0,0
"World","2024-01-05",0,1,115,0,1,115,0,0
"World","2024-01-06",0,0,115,0,28,143,0,0
"World","2024-01-07",0,57,172,0,29,172,0,0
"World","2024-01-08",0,0,172,0,54,226,0,0
"World","2024-01-09",0,108,280,0,54,280,0,0
"World","2024-01-10",0,14,294,0,14,294,0,0
"World","2024-01-11",0,1,295,0,1,295,0,0
"World","2024-01-12",0,1,296,0,1,296,0,0
"World","2024-01-13",0,0,296,0,39,335,0,0
"World","2024-01-14",0,78,374,0,39,374,0,0
"World","2024-01-15",0,0,374,0,67,441,0,0
"World","2024-01-16",0,134,508,0,67,508,0,0
"World","2024-01-17",0,1,509,0,1,509,0,0
"World","2024-01-18",0,0,509,0,1,510,0,0
"World","2024-01-19",0,2,511,0,1,511,0,0
"World","2024-01-20",0,2,513,0,2,513,0,0
"World","2024-01-21",0,90,603,0,90,603,0,0
"World","2024-01-22",0,0,603,0,48,651,0,0
"World","2024-01-23",0,95,698,0,47,698,0,0
"World","2024-01-24",0,6,704,0,6,704,0,0
"World","2024-01-25",0,0,704,0,20,724,0,0
"World","2024-01-26",0,0,704,0,20,744,0,0
"World","2024-01-27",0,0,704,0,19,763,0,0
"World","2024-01-28",0,79,783,0,20,783,0,0
"World","2024-01-29",0,0,783,0,68,851,0,0
"World","2024-01-30",0,136,919,0,68,919,0,0
"World","2024-01-31",0,303,1222,0,303,1222,0,0
"World","2024-02-01",0,0,1222,0,2,1224,0,0
"World","2024-02-02",0,5,1227,0,3,1227,0,0
"World","2024-02-03",0,0,1227,0,32,1259,0,0
"World","2024-02-04",0,63,1290,0,31,1290,0,0
"World","2024-02-05",0,3,1293,0,3,1293,0,0
"World","2024-02-06",0,104,1397,0,104,1397,0,0
"World","2024-02-07",0,0,1397,0,2,1399,0,0
"World","2024-02-08",0,0,1397,0,1,1400,0,0
"World","2024-02-09",0,5,1402,0,2,1402,0,0
"World","2024-02-10",0,0,1402,0,32,1434,0,0
"World","2024-02-11",0,65,1467,0,33,1467,0,0
"World","2024-02-12",0,0,1467,0,52,1519,0,0
"World","2024-02-13",0,104,1571,0,52,1571,0,0
"World","2024-02-14",0,0,1571,0,0,1571,0,0
"World","2024-02-15",0,1,1572,0,1,1572,0,0
"World","2024-02-16",0,1,1573,0,1,1573,0,0
"World","2024-02-17",0,0,1573,0,32,1605,0,0
"World","2024-02-18",0,64,1637,0,32,1637,0,0
"World","2024-02-19",0,0,1637,0,53,1690,0,0
"World","2024-02-20",0,106,1743,0,53,1743,0,0
"World","2024-02-21",0,0,1743,0,3,1746,0,0
"World","2024-02-22",0,0,1743,0,4,1750,0,0
"World","2024-02-23",0,10,1753,0,3,1753,0,0
"World","2024-02-24",0,0,1753,0,23,1776,0,0
"World","2024-02-25",0,46,1799,0,23,1799,0,0
"World","2024-02-26",0,0,1799,0,62,1861,0,0
"World","2024-02-27",0,124,1923,0,62,1923,0,0
"World","2024-02-28",0,15,1938,0,15,1938,0,0
"World","2024-02-29",0,309,2247,0,309,2247,0,0
"World","2024-03-01",0,4,2251,0,4,2251,0,0
"World","2024-03-02",0,1,2252,0,1,2252,0,0
"World","2024-03-03",0,81,2333,0,81,2333,0,0
"World","2024-03-04",0,0,2333,0,49,2382,0,0
"World","2024-03-05",0,98,2431,0,49,2431,0,0
"World","2024-03-06",0,10,2441,0,10,2441,0,0
"World","2024-03-07",0,0,2441,0,2,2443,0,0
"World","2024-03-08",0,3,2444,0,1,2444,0,0
"World","2024-03-09",0,0,2444,0,34,2478,0,0
"World","2024-03-10",0,69,2513,0,35,2513,0,0
"World","2024-03-11",0,0,2513,0,56,2569,0,0
"World","2024-03-12",0,112,2625,0,56,2625,0,0
"World","2024-03-13",0,0,2625,0,0,2625,0,0
"World","2024-03-14",0,1,2626,0,1,2626,0,0
"World","2024-03-15",0,3,2629,0,3,2629,0,0
"World","2024-03-16",0,0,2629,0,37,2666,0,0
"World","2024-03-17",0,74,2703,0,37,2703,0,0
"World","2024-03-18",0,0,2703,0,46,2749,0,0
"World","2024-03-19",0,91,2794,0,45,2794,0,0
"World","2024-03-20",0,0,2794,0,0,2794,0,0
"World","2024-03-21",0,0,2794,0,1,2795,0,0
"World","2024-03-22",0,1,2795,0,0,2795,0,0
"World","2024-03-23",0,0,2795,0,34,2829,0,0
"World","2024-03-24",0,69,2864,0,35,2864,0,0
"World","2024-03-25",0,0,2864,0,54,2918,0,0
"World","2024-03-26",0,107,2971,0,53,2971,0,0
"World","2024-03-27",0,0,2971,0,55,3026,0,0
"World","2024-03-28",0,0,2971,0,55,3081,0,0
"World","2024-03-29",0,0,2971,0,55,3136,0,0
"World","2024-03-30",0,0,2971,0,55,3191,0,0
"World","2024-03-31",0,275,3246,0,55,3246,0,0
"World","2024-04-01",0,6,3252,0,6,3252,0,0
"World","2024-04-02",0,84,3336,0,84,3336,0,0
"World","2024-04-03",0,0,3336,0,1,3337,0,0
"World","2024-04-04",0,0,3336,0,1,3338,0,0
"World","2024-04-05",0,3,3339,0,1,3339,0,0
"World","2024-04-06",0,0,3339,0,40,3379,0,0
"World","2024-04-07",0,80,3419,0,40,3419,0,0
"World","2024-04-08",0,0,3419,0,49,3468,0,0
"World","2024-04-09",0,98,3517,0,49,3517,0,0
"World","2024-04-10",0,0,3517,0,1,3518,0,0
"World","2024-04-11",0,0,3517,0,0,3518,0,0
"World","2024-04-12",0,2,3519,0,1,3519,0,0
"World","2024-04-13",0,0,3519,0,58,3577,0,0
"World","2024-04-14",0,116,3635,0,58,3635,0,0
"World","2024-04-15",0,0,3635,0,50,3685,0,0
"World","2024-04-16",0,100,3735,0,50,3735,0,0
"World","2024-04-17",0,0,3735,0,0,3735,0,0
"World","2024-04-18",0,0,3735,0,1,3736,0,0
"World","2024-04-19",0,1,3736,0,0,3736,0,0
"World","2024-04-20",0,1,3737,0,1,3737,0,0
"World","2024-04-21",0,159,3896,0,159,3896,0,0
"World","2024-04-22",0,0,3896,0,57,3953,0,0
"World","2024-04-23",0,114,4010,0,57,4010,0,0
"World","2024-04-24",0,0,4010,0,1,4011,0,0
"World","2024-04-25",0,0,4010,0,0,4011,0,0
"World","2024-04-26",0,2,4012,0,1,4012,0,0
"World","2024-04-27",0,1,4013,0,1,4013,0,0
"World","2024-04-28",0,178,4191,0,178,4191,0,0
"World","2024-04-29",0,0,4191,0,132,4323,0,0
"World","2024-04-30",0,265,4456,0,133,4456,0,0
"World","2024-05-01",0,0,4456,0,50,4506,0,0
"World","2024-05-02",0,0,4456,0,50,4556,0,0
"World","2024-05-03",0,0,4456,0,49,4605,0,0
"World","2024-05-04",0,0,4456,0,50,4655,0,0
"World","2024-05-05",0,249,4705,0,50,4705,0,0
"World","2024-05-06",0,0,4705,0,43,4748,0,0
"World","2024-05-07",0,86,4791,0,43,4791,0,0
"World","2024-05-08",0,0,4791,0,0,4791,0,0
"World","2024-05-09",0,1,4792,0,1,4792,0,0
"World","2024-05-10",0,25,4817,0,25,4817,0,0
"World","2024-05-11",0,0,4817,0,105,4922,0,0
"World","2024-05-12",0,210,5027,0,105,5027,0,0
"World","2024-05-13",0,0,5027,0,39,5066,0,0
"World","2024-05-14",0,78,5105,0,39,5105,0,0
"World","2024-05-15",0,0,5105,0,47,5152,0,0
"World","2024-05-16",0,0,5105,0,47,5199,0,0
"World","2024-05-17",0,0,5105,0,48,5247,0,0
"World","2024-05-18",0,0,5105,0,47,5294,0,0
"World","2024-05-19",0,236,5341,0,47,5341,0,0
"World","2024-05-20",0,0,5341,0,39,5380,0,0
"World","2024-05-21",0,78,5419,0,39,5419,0,0
"World","2024-05-22",0,1,5420,0,1,5420,0,0
"World","2024-05-23",0,0,5420,0,2,5422,0,0
"World","2024-05-24",0,4,5424,0,2,5424,0,0
"World","2024-05-25",0,0,5424,0,107,5531,0,0
"World","2024-05-26",0,214,5638,0,107,5638,0,0
"World","2024-05-27",0,1,5639,0,1,5639,0,0
"World","2024-05-28",0,87,5726,0,87,5726,0,0
"World","2024-05-29",0,0,5726,0,24,5750,0,0
"World","2024-05-30",0,49,5775,0,25,5775,0,0
"World","2024-05-31",0,215,5990,0,215,5990,0,0
"World","2024-06-01",0,0,5990,0,128,6118,0,0
"World","2024-06-02",0,257,6247,0,129,6247,0,0
"World","2024-06-03",0,0,6247,0,46,6293,0,0
"World","2024-06-04",0,92,6339,0,46,6339,0,0
"World","2024-06-05",0,0,6339,0,71,6410,0,0
"World","2024-06-06",0,0,6339,0,71,6481,0,0
"World","2024-06-07",0,0,6339,0,70,6551,0,0
"World","2024-06-08",0,0,6339,0,71,6622,0,0
"World","2024-06-09",0,354,6693,0,71,6693,0,0
"World","2024-06-10",0,0,6693,0,46,6739,0,0
"World","2024-06-11",0,93,6786,0,47,6786,0,0
"World","2024-06-12",0,0,6786,0,77,6863,0,0
"World","2024-06-13",0,0,6786,0,77,6940,0,0
"World","2024-06-14",0,0,6786,0,76,7016,0,0
"World","2024-06-15",0,0,6786,0,77,7093,0,0
"World","2024-06-16",0,384,7170,0,77,7170,0,0
"World","2024-06-17",0,0,7170,0,37,7207,0,0
"World","2024-06-18",0,74,7244,0,37,7244,0,0
"World","2024-06-19",0,0,7244,0,69,7313,0,0
"World","2024-06-20",0,0,7244,0,68,7381,0,0
"World","2024-06-21",0,0,7244,0,69,7450,0,0
"World","2024-06-22",0,0,7244,0,68,7518,0,0
"World","2024-06-23",0,343,7587,0,69,7587,0,0
"World","2024-06-24",0,4,7591,0,4,7591,0,0
"World","2024-06-25",0,84,7675,0,84,7675,0,0
"World","2024-06-26",0,0,7675,0,2,7677,0,0
"World","2024-06-27",0,0,7675,0,3,7680,0,0
"World","2024-06-28",0,7,7682,0,2,7682,0,0
"World","2024-06-29",0,0,7682,0,346,8028,0,0
"World","2024-06-30",0,693,8375,0,347,8375,0,0
"World","2024-07-01",0,2,8377,0,2,8377,0,0
"World","2024-07-02",0,92,8469,0,92,8469,0,0
"World","2024-07-03",0,0,8469,0,85,8554,0,0
"World","2024-07-04",0,0,8469,0,84,8638,0,0
"World","2024-07-05",0,0,8469,0,85,8723,0,0
"World","2024-07-06",0,0,8469,0,84,8807,0,0
"World","2024-07-07",0,423,8892,0,85,8892,0,0
"World","2024-07-08",0,2,8894,0,2,8894,0,0
"World","2024-07-09",0,102,8996,0,102,8996,0,0
"World","2024-07-10",0,0,8996,0,1,8997,0,0
"World","2024-07-11",0,0,8996,0,0,8997,0,0
"World","2024-07-12",0,2,8998,0,1,8998,0,0
"World","2024-07-13",0,1,8999,0,1,8999,0,0
"World","2024-07-14",0,590,9589,0,590,9589,0,0
"World","2024-07-15",0,14,9603,0,14,9603,0,0
"World","2024-07-16",0,122,9725,0,122,9725,0,0
"World","2024-07-17",0,0,9725,0,105,9830,0,0
"World","2024-07-18",0,0,9725,0,105,9935,0,0
"World","2024-07-19",0,0,9725,0,105,10040,0,0
"World","2024-07-20",0,0,9725,0,105,10145,0,0
"World","2024-07-21",0,525,10250,0,105,10250,0,0
"World","2024-07-22",0,21,10271,0,21,10271,0,0
"World","2024-07-23",0,93,10364,0,93,10364,0,0
"World","2024-07-24",0,0,10364,0,5,10369,0,0
"World","2024-07-25",0,0,10364,0,5,10374,0,0
"World","2024-07-26",0,0,10364,0,6,10380,0,0
"World","2024-07-27",0,21,10385,0,5,10385,0,0
"World","2024-07-28",0,474,10859,0,474,10859,0,0
"World","2024-07-29",0,0,10859,0,96,10955,0,0
"World","2024-07-30",0,192,11051,0,96,11051,0,0
"World","2024-07-31",0,188,11239,0,188,11239,0,0
"World","2024-08-01",0,0,11239,0,3,11242,0,0
"World","2024-08-02",0,6,11245,0,3,11245,0,0
"World","2024-08-03",0,0,11245,0,134,11379,0,0
"World","2024-08-04",0,269,11514,0,135,11514,0,0
"World","2024-08-05",0,1,11515,0,1,11515,0,0
"World","2024-08-06",0,143,11658,0,143,11658,0,0
"World","2024-08-07",0,0,11658,0,59,11717,0,0
"World","2024-08-08",0,0,11658,0,59,11776,0,0
"World","2024-08-09",0,0,11658,0,60,11836,0,0
"World","2024-08-10",0,0,11658,0,59,11895,0,0
"World","2024-08-11",0,296,11954,0,59,11954,0,0
"World","2024-08-12",0,0,11954,0,76,12030,0,0
"World","2024-08-13",0,153,12107,0,77,12107,0,0
"World","2024-08-14",0,1,12108,0,1,12108,0,0
"World","2024-08-15",0,2,12110,0,2,12110,0,0
"World","2024-08-16",0,0,12110,0,99,12209,0,0
"World","2024-08-17",0,0,12110,0,100,12309,0,0
"World","2024-08-18",0,298,12408,0,99,12408,0,0
"World","2024-08-19",0,1,12409,0,1,12409,0,0
"World","2024-08-20",0,193,12602,0,193,12602,0,0
"World","2024-08-21",0,75,12677,0,75,12677,0,0
"World","2024-08-22",0,2,12679,0,2,12679,0,0
"World","2024-08-23",0,1,12680,0,1,12680,0,0
"World","2024-08-24",0,0,12680,0,154,12834,0,0
"World","2024-08-25",0,307,12987,0,153,12987,0,0
"World","2024-08-26",0,0,12987,0,92,13079,0,0
"World","2024-08-27",0,184,13171,0,92,13171,0,0
"World","2024-08-28",0,4,13175,0,4,13175,0,0
"World","2024-08-29",0,70,13245,0,70,13245,0,0
"World","2024-08-30",0,0,13245,0,226,13471,0,0
"World","2024-08-31",0,451,13696,0,225,13696,0,0
"World","2024-09-01",0,382,14078,0,382,14078,0,0
"World","2024-09-02",0,1,14079,0,1,14079,0,0
"World","2024-09-03",0,191,14270,0,191,14270,0,0
"World","2024-09-04",0,0,14270,0,78,14348,0,0
"World","2024-09-05",0,0,14270,0,78,14426,0,0
"World","2024-09-06",0,0,14270,0,79,14505,0,0
"World","2024-09-07",0,0,14270,0,78,14583,0,0
"World","2024-09-08",0,391,14661,0,78,14661,0,0
"World","2024-09-09",0,0,14661,0,82,14743,0,0
"World","2024-09-10",0,163,14824,0,81,14824,0,0
"World","2024-09-11",0,0,14824,0,0,14824,0,0
"World","2024-09-12",0,1,14825,0,1,14825,0,0
"World","2024-09-13",0,0,14825,0,188,15013,0,0
"World","2024-09-14",0,0,14825,0,188,15201,0,0
"World","2024-09-15",0,564,15389,0,188,15389,0,0
"World","2024-09-16",0,0,15389,0,73,15462,0,0
"World","2024-09-17",0,146,15535,0,73,15535,0,0
"World","2024-09-18",0,1,15536,0,1,15536,0,0
"World","2024-09-19",0,0,15536,0,140,15676,0,0
"World","2024-09-20",0,0,15536,0,140,15816,0,0
"World","2024-09-21",0,0,15536,0,141,15957,0,0
"World","2024-09-22",0,561,16097,0,140,16097,0,0
"World","2024-09-23",0,3,16100,0,3,16100,0,0
"World","2024-09-24",0,150,16250,0,150,16250,0,0
"World","2024-09-25",0,0,16250,0,8,16258,0,0
"World","2024-09-26",0,15,16265,0,7,16265,0,0
"World","2024-09-27",0,0,16265,0,2,16267,0,0
"World","2024-09-28",0,3,16268,0,1,16268,0,0
"World","2024-09-29",0,476,16744,0,476,16744,0,0
"World","2024-09-30",0,257,17001,0,257,17001,0,0
"World","2024-10-01",0,162,17163,0,162,17163,0,0
"World","2024-10-02",0,1,17164,0,1,17164,0,0
"World","2024-10-03",0,2,17166,0,2,17166,0,0
"World","2024-10-04",0,1,17167,0,1,17167,0,0
"World","2024-10-05",0,0,17167,0,217,17384,0,0
"World","2024-10-06",0,434,17601,0,217,17601,0,0
"World","2024-10-07",0,23,17624,0,23,17624,0,0
"World","2024-10-08",0,131,17755,0,131,17755,0,0
"World","2024-10-09",0,0,17755,0,1,17756,0,0
"World","2024-10-10",0,2,17757,0,1,17757,0,0
"World","2024-10-11",0,2,17759,0,2,17759,0,0
"World","2024-10-12",0,1,17760,0,1,17760,0,0
"World","2024-10-13",0,556,18316,0,556,18316,0,0
"World","2024-10-14",0,0,18316,0,58,18374,0,0
"World","2024-10-15",0,117,18433,0,59,18433,0,0
"World","2024-10-16",0,0,18433,0,1,18434,0,0
"World","2024-10-17",0,0,18433,0,0,18434,0,0
"World","2024-10-18",0,2,18435,0,1,18435,0,0
"World","2024-10-19",0,0,18435,0,285,18720,0,0
"World","2024-10-20",0,570,19005,0,285,19005,0,0
"World","2024-10-21",0,0,19005,0,66,19071,0,0
"World","2024-10-22",0,131,19136,0,65,19136,0,0
"World","2024-10-23",0,2,19138,0,2,19138,0,0
"World","2024-10-24",0,0,19138,0,1,19139,0,0
"World","2024-10-25",0,0,19138,0,1,19140,0,0
"World","2024-10-26",0,3,19141,0,1,19141,0,0
"World","2024-10-27",0,652,19793,0,652,19793,0,0
"World","2024-10-28",0,0,19793,0,58,19851,0,0
"World","2024-10-29",0,115,19908,0,57,19908,0,0
"World","2024-10-30",0,5,19913,0,5,19913,0,0
"World","2024-10-31",0,286,20199,0,286,20199,0,0
"World","2024-11-01",0,2,20201,0,2,20201,0,0
"World","2024-11-02",0,0,20201,0,313,20514,0,0
"World","2024-11-03",0,626,20827,0,313,20827,0,0
"World","2024-11-04",0,1,20828,0,1,20828,0,0
"World","2024-11-05",0,117,20945,0,117,20945,0,0
"World","2024-11-06",0,3,20948,0,3,20948,0,0
"World","2024-11-07",0,0,20948,0,160,21108,0,0
"World","2024-11-08",0,0,20948,0,160,21268,0,0
"World","2024-11-09",0,0,20948,0,160,21428,0,0
"World","2024-11-10",0,640,21588,0,160,21588,0,0
"World","2024-11-11",0,0,21588,0,47,21635,0,0
"World","2024-11-12",0,94,21682,0,47,21682,0,0
"World","2024-11-13",0,0,21682,0,2,21684,0,0
"World","2024-11-14",0,0,21682,0,3,21687,0,0
"World","2024-11-15",0,7,21689,0,2,21689,0,0
"World","2024-11-16",0,0,21689,0,334,22023,0,0
"World","2024-11-17",0,667,22356,0,333,22356,0,0
"World","2024-11-18",0,0,22356,0,48,22404,0,0
"World","2024-11-19",0,96,22452,0,48,22452,0,0
"World","2024-11-20",0,1,22453,0,1,22453,0,0
"World","2024-11-21",0,0,22453,0,164,22617,0,0
"World","2024-11-22",0,0,22453,0,165,22782,0,0
"World","2024-11-23",0,0,22453,0,165,22947,0,0
"World","2024-11-24",0,658,23111,0,164,23111,0,0
"World","2024-11-25",0,0,23111,0,40,23151,0,0
"World","2024-11-26",0,80,23191,0,40,23191,0,0
"World","2024-11-27",0,24,23215,0,24,23215,0,0
"World","2024-11-28",0,0,23215,0,0,23215,0,0
"World","2024-11-29",0,1,23216,0,1,23216,0,0
"World","2024-11-30",0,307,23523,0,307,23523,0,0
"World","2024-12-01",0,576,24099,0,576,24099,0,0
"World","2024-12-02",0,0,24099,0,28,24127,0,0
"World","2024-12-03",0,56,24155,0,28,24155,0,0
"World","2024-12-04",0,0,24155,0,2,24157,0,0
"World","2024-12-05",0,3,24158,0,1,24158,0,0
"World","2024-12-06",0,0,24158,0,205,24363,0,0
"World","2024-12-07",0,0,24158,0,206,24569,0,0
"World","2024-12-08",0,616,24774,0,205,24774,0,0
"World","2024-12-09",0,27,24801,0,27,24801,0,0
"World","2024-12-10",0,43,24844,0,43,24844,0,0
"World","2024-12-11",0,0,24844,0,118,24962,0,0
"World","2024-12-12",0,0,24844,0,118,25080,0,0
"World","2024-12-13",0,0,24844,0,117,25197,0,0
"World","2024-12-14",0,0,24844,0,118,25315,0,0
"World","2024-12-15",0,589,25433,0,118,25433,0,0
"World","2024-12-16",0,0,25433,0,16,25449,0,0
"World","2024-12-17",0,32,25465,0,16,25465,0,0
"World","2024-12-18",0,0,25465,0,107,25572,0,0
"World","2024-12-19",0,0,25465,0,107,25679,0,0
"World","2024-12-20",0,0,25465,0,106,25785,0,0
"World","2024-12-21",0,0,25465,0,107,25892,0,0
"World","2024-12-22",0,534,25999,0,107,25999,0,0
"World","2024-12-23",0,0,25999,0,8,26007,0,0
"World","2024-12-24",0,16,26015,0,8,26015,0,0
"World","2024-12-25",0,0,26015,0,4,26019,0,0
"World","2024-12-26",0,7,26022,0,3,26022,0,0
"World","2024-12-27",0,1,26023,0,1,26023,0,0
"World","2024-12-28",0,0,26023,0,228,26251,0,0
"World","2024-12-29",0,455,26478,0,227,26478,0,0
"World","2024-12-30",0,0,26478,0,111,26589,0,0
"World","2024-12-31",0,222,26700,0,111,26700,0,0
"World","2025-01-01",0,0,26700,0,63,26763,0,0
"World","2025-01-02",0,0,26700,0,63,26826,0,0
"World","2025-01-03",0,0,26700,0,62,26888,0,0
"World","2025-01-04",0,0,26700,0,63,26951,0,0
"World","2025-01-05",0,314,27014,0,63,27014,0,0
"World","2025-01-06",0,0,27014,0,12,27026,0,0
"World","2025-01-07",0,0,27014,0,11,27037,0,0
"World","2025-01-08",0,35,27049,0,12,27049,0,0
"World","2025-01-09",0,0,27049,0,1,27050,0,0
"World","2025-01-10",0,2,27051,0,1,27051,0,0
"World","2025-01-11",0,0,27051,0,196,27247,0,0
"World","2025-01-12",0,392,27443,0,196,27443,0,0
"World","2025-01-13",0,0,27443,0,13,27456,0,0
"World","2025-01-14",0,0,27443,0,13,27469,0,0
"World","2025-01-15",0,0,27443,0,14,27483,0,0
"World","2025-01-16",0,53,27496,0,13,27496,0,0
"World","2025-01-17",0,0,27496,0,13,27509,0,0
"World","2025-01-18",0,0,27496,0,13,27522,0,0
"World","2025-01-19",0,39,27535,0,13,27535,0,0
"World","2025-01-20",0,0,27535,0,1,27536,0,0
"World","2025-01-21",0,2,27537,0,1,27537,0,0
"World","2025-01-22",0,0,27537,0,0,27537,0,0
"World","2025-01-23",0,0,27537,0,0,27537,0,0
"World","2025-01-24",0,0,27537,0,0,27537,0,0
"World","2025-01-25",0,0,27537,0,0,27537,0,0
"World","2025-01-26",0,0,27537,0,0,27537,0,0
"World","2025-01-27",0,0,27537,0,0,27537,0,0
"World","2025-01-28",0,0,27537,0,0,27537,0,0
"World","2025-01-29",0,0,27537,0,0,27537,0,0
"World","2025-01-30",0,0,27537,0,0,27537,0,0
"World","2025-01-31",0,0,27537,0,0,27537,0,0
"World","2025-02-01",0,0,27537,0,0,27537,0,0
"World","2025-02-02",0,0,27537,0,0,27537,0,0
"World","2025-02-03",0,0,27537,0,0,27537,0,0
"Zambia","2024-01-01",0,0,0,0,0,0,0,0
"Zambia","2024-01-02",0,0,0,0,0,0,0,0
"Zambia","2024-01-03",0,0,0,0,0,0,0,0
"Zambia","2024-01-04",0,0,0,0,0,0,0,0
"Zambia","2024-01-05",0,0,0,0,0,0,0,0
"Zambia","2024-01-06",0,0,0,0,0,0,0,0
"Zambia","2024-01-07",0,0,0,0,0,0,0,0
"Zambia","2024-01-08",0,0,0,0,0,0,0,0
"Zambia","2024-01-09",0,0,0,0,0,0,0,0
"Zambia","2024-01-10",0,0,0,0,0,0,0,0
"Zambia","2024-01-11",0,0,0,0,0,0,0,0
"Zambia","2024-01-12",0,0,0,0,0,0,0,0
"Zambia","2024-01-13",0,0,0,0,0,0,0,0
"Zambia","2024-01-14",0,0,0,0,0,0,0,0
"Zambia","2024-01-15",0,0,0,0,0,0,0,0
"Zambia","2024-01-16",0,0,0,0,0,0,0,0
"Zambia","2024-01-17",0,0,0,0,0,0,0,0
"Zambia","2024-01-18",0,0,0,0,0,0,0,0
"Zambia","2024-01-19",0,0,0,0,0,0,0,0
"Zambia","2024-01-20",0,0,0,0,0,0,0,0
"Zambia","2024-01-21",0,0,0,0,0,0,0,0
"Zambia","2024-01-22",0,0,0,0,0,0,0,0
"Zambia","2024-01-23",0,0,0,0,0,0,0,0
"Zambia","2024-01-24",0,0,0,0,0,0,0,0
"Zambia","2024-01-25",0,0,0,0,0,0,0,0
"Zambia","2024-01-26",0,0,0,0,0,0,0,0
"Zambia","2024-01-27",0,0,0,0,0,0,0,0
"Zambia","2024-01-28",0,0,0,0,0,0,0,0
"Zambia","2024-01-29",0,0,0,0,0,0,0,0
"Zambia","2024-01-30",0,0,0,0,0,0,0,0
"Zambia","2024-01-31",0,0,0,0,0,0,0,0
"Zambia","2024-02-01",0,0,0,0,0,0,0,0
"Zambia","2024-02-02",0,0,0,0,0,0,0,0
"Zambia","2024-02-03",0,0,0,0,0,0,0,0
"Zambia","2024-02-04",0,0,0,0,0,0,0,0
"Zambia","2024-02-05",0,0,0,0,0,0,0,0
"Zambia","2024-02-06",0,0,0,0,0,0,0,0
"Zambia","2024-02-07",0,0,0,0,0,0,0,0
"Zambia","2024-02-08",0,0,0,0,0,0,0,0
"Zambia","2024-02-09",0,0,0,0,0,0,0,0
"Zambia","2024-02-10",0,0,0,0,0,0,0,0
"Zambia","2024-02-11",0,0,0,0,0,0,0,0
"Zambia","2024-02-12",0,0,0,0,0,0,0,0
"Zambia","2024-02-13",0,0,0,0,0,0,0,0
"Zambia","2024-02-14",0,0,0,0,0,0,0,0
"Zambia","2024-02-15",0,0,0,0,0,0,0,0
"Zambia","2024-02-16",0,0,0,0,0,0,0,0
"Zambia","2024-02-17",0,0,0,0,0,0,0,0
"Zambia","2024-02-18",0,0,0,0,0,0,0,0
"Zambia","2024-02-19",0,0,0,0,0,0,0,0
"Zambia","2024-02-20",0,0,0,0,0,0,0,0
"Zambia","2024-02-21",0,0,0,0,0,0,0,0
"Zambia","2024-02-22",0,0,0,0,0,0,0,0
"Zambia","2024-02-23",0,0,0,0,0,0,0,0
"Zambia","2024-02-24",0,0,0,0,0,0,0,0
"Zambia","2024-02-25",0,0,0,0,0,0,0,0
"Zambia","2024-02-26",0,0,0,0,0,0,0,0
"Zambia","2024-02-27",0,0,0,0,0,0,0,0
"Zambia","2024-02-28",0,0,0,0,0,0,0,0
"Zambia","2024-02-29",0,0,0,0,0,0,0,0
"Zambia","2024-03-01",0,0,0,0,0,0,0,0
"Zambia","2024-03-02",0,0,0,0,0,0,0,0
"Zambia","2024-03-03",0,0,0,0,0,0,0,0
"Zambia","2024-03-04",0,0,0,0,0,0,0,0
"Zambia","2024-03-05",0,0,0,0,0,0,0,0
"Zambia","2024-03-06",0,0,0,0,0,0,0,0
"Zambia","2024-03-07",0,0,0,0,0,0,0,0
"Zambia","2024-03-08",0,0,0,0,0,0,0,0
"Zambia","2024-03-09",0,0,0,0,0,0,0,0
"Zambia","2024-03-10",0,0,0,0,0,0,0,0
"Zambia","2024-03-11",0,0,0,0,0,0,0,0
"Zambia","2024-03-12",0,0,0,0,0,0,0,0
"Zambia","2024-03-13",0,0,0,0,0,0,0,0
"Zambia","2024-03-14",0,0,0,0,0,0,0,0
"Zambia","2024-03-15",0,0,0,0,0,0,0,0
"Zambia","2024-03-16",0,0,0,0,0,0,0,0
"Zambia","2024-03-17",0,0,0,0,0,0,0,0
"Zambia","2024-03-18",0,0,0,0,0,0,0,0
"Zambia","2024-03-19",0,0,0,0,0,0,0,0
"Zambia","2024-03-20",0,0,0,0,0,0,0,0
"Zambia","2024-03-21",0,0,0,0,0,0,0,0
"Zambia","2024-03-22",0,0,0,0,0,0,0,0
"Zambia","2024-03-23",0,0,0,0,0,0,0,0
"Zambia","2024-03-24",0,0,0,0,0,0,0,0
"Zambia","2024-03-25",0,0,0,0,0,0,0,0
"Zambia","2024-03-26",0,0,0,0,0,0,0,0
"Zambia","2024-03-27",0,0,0,0,0,0,0,0
"Zambia","2024-03-28",0,0,0,0,0,0,0,0
"Zambia","2024-03-29",0,0,0,0,0,0,0,0
"Zambia","2024-03-30",0,0,0,0,0,0,0,0
"Zambia","2024-03-31",0,0,0,0,0,0,0,0
"Zambia","2024-04-01",0,0,0,0,0,0,0,0
"Zambia","2024-04-02",0,0,0,0,0,0,0,0
"Zambia","2024-04-03",0,0,0,0,0,0,0,0
"Zambia","2024-04-04",0,0,0,0,0,0,0,0
"Zambia","2024-04-05",0,0,0,0,0,0,0,0
"Zambia","2024-04-06",0,0,0,0,0,0,0,0
"Zambia","2024-04-07",0,0,0,0,0,0,0,0
"Zambia","2024-04-08",0,0,0,0,0,0,0,0
"Zambia","2024-04-09",0,0,0,0,0,0,0,0
"Zambia","2024-04-10",0,0,0,0,0,0,0,0
"Zambia","2024-04-11",0,0,0,0,0,0,0,0
"Zambia","2024-04-12",0,0,0,0,0,0,0,0
"Zambia","2024-04-13",0,0,0,0,0,0,0,0
"Zambia","2024-04-14",0,0,0,0,0,0,0,0
"Zambia","2024-04-15",0,0,0,0,0,0,0,0
"Zambia","2024-04-16",0,0,0,0,0,0,0,0
"Zambia","2024-04-17",0,0,0,0,0,0,0,0
"Zambia","2024-04-18",0,0,0,0,0,0,0,0
"Zambia","2024-04-19",0,0,0,0,0,0,0,0
"Zambia","2024-04-20",0,0,0,0,0,0,0,0
"Zambia","2024-04-21",0,0,0,0,0,0,0,0
"Zambia","2024-04-22",0,0,0,0,0,0,0,0
"Zambia","2024-04-23",0,0,0,0,0,0,0,0
"Zambia","2024-04-24",0,0,0,0,0,0,0,0
"Zambia","2024-04-25",0,0,0,0,0,0,0,0
"Zambia","2024-04-26",0,0,0,0,0,0,0,0
"Zambia","2024-04-27",0,0,0,0,0,0,0,0
"Zambia","2024-04-28",0,0,0,0,0,0,0,0
"Zambia","2024-04-29",0,0,0,0,0,0,0,0
"Zambia","2024-04-30",0,0,0,0,0,0,0,0
"Zambia","2024-05-01",0,0,0,0,0,0,0,0
"Zambia","2024-05-02",0,0,0,0,0,0,0,0
"Zambia","2024-05-03",0,0,0,0,0,0,0,0
"Zambia","2024-05-04",0,0,0,0,0,0,0,0
"Zambia","2024-05-05",0,0,0,0,0,0,0,0
"Zambia","2024-05-06",0,0,0,0,0,0,0,0
"Zambia","2024-05-07",0,0,0,0,0,0,0,0
"Zambia","2024-05-08",0,0,0,0,0,0,0,0
"Zambia","2024-05-09",0,0,0,0,0,0,0,0
"Zambia","2024-05-10",0,0,0,0,0,0,0,0
"Zambia","2024-05-11",0,0,0,0,0,0,0,0
"Zambia","2024-05-12",0,0,0,0,0,0,0,0
"Zambia","2024-05-13",0,0,0,0,0,0,0,0
"Zambia","2024-05-14",0,0,0,0,0,0,0,0
"Zambia","2024-05-15",0,0,0,0,0,0,0,0
"Zambia","2024-05-16",0,0,0,0,0,0,0,0
"Zambia","2024-05-17",0,0,0,0,0,0,0,0
"Zambia","2024-05-18",0,0,0,0,0,0,0,0
"Zambia","2024-05-19",0,0,0,0,0,0,0,0
"Zambia","2024-05-20",0,0,0,0,0,0,0,0
"Zambia","2024-05-21",0,0,0,0,0,0,0,0
"Zambia","2024-05-22",0,0,0,0,0,0,0,0
"Zambia","2024-05-23",0,0,0,0,0,0,0,0
"Zambia","2024-05-24",0,0,0,0,0,0,0,0
"Zambia","2024-05-25",0,0,0,0,0,0,0,0
"Zambia","2024-05-26",0,0,0,0,0,0,0,0
"Zambia","2024-05-27",0,0,0,0,0,0,0,0
"Zambia","2024-05-28",0,0,0,0,0,0,0,0
"Zambia","2024-05-29",0,0,0,0,0,0,0,0
"Zambia","2024-05-30",0,0,0,0,0,0,0,0
"Zambia","2024-05-31",0,0,0,0,0,0,0,0
"Zambia","2024-06-01",0,0,0,0,0,0,0,0
"Zambia","2024-06-02",0,0,0,0,0,0,0,0
"Zambia","2024-06-03",0,0,0,0,0,0,0,0
"Zambia","2024-06-04",0,0,0,0,0,0,0,0
"Zambia","2024-06-05",0,0,0,0,0,0,0,0
"Zambia","2024-06-06",0,0,0,0,0,0,0,0
"Zambia","2024-06-07",0,0,0,0,0,0,0,0
"Zambia","2024-06-08",0,0,0,0,0,0,0,0
"Zambia","2024-06-09",0,0,0,0,0,0,0,0
"Zambia","2024-06-10",0,0,0,0,0,0,0,0
"Zambia","2024-06-11",0,0,0,0,0,0,0,0
"Zambia","2024-06-12",0,0,0,0,0,0,0,0
"Zambia","2024-06-13",0,0,0,0,0,0,0,0
"Zambia","2024-06-14",0,0,0,0,0,0,0,0
"Zambia","2024-06-15",0,0,0,0,0,0,0,0
"Zambia","2024-06-16",0,0,0,0,0,0,0,0
"Zambia","2024-06-17",0,0,0,0,0,0,0,0
"Zambia","2024-06-18",0,0,0,0,0,0,0,0
"Zambia","2024-06-19",0,0,0,0,0,0,0,0
"Zambia","2024-06-20",0,0,0,0,0,0,0,0
"Zambia","2024-06-21",0,0,0,0,0,0,0,0
"Zambia","2024-06-22",0,0,0,0,0,0,0,0
"Zambia","2024-06-23",0,0,0,0,0,0,0,0
"Zambia","2024-06-24",0,0,0,0,0,0,0,0
"Zambia","2024-06-25",0,0,0,0,0,0,0,0
"Zambia","2024-06-26",0,0,0,0,0,0,0,0
"Zambia","2024-06-27",0,0,0,0,0,0,0,0
"Zambia","2024-06-28",0,0,0,0,0,0,0,0
"Zambia","2024-06-29",0,0,0,0,0,0,0,0
"Zambia","2024-06-30",0,0,0,0,0,0,0,0
"Zambia","2024-07-01",0,0,0,0,0,0,0,0
"Zambia","2024-07-02",0,0,0,0,0,0,0,0
"Zambia","2024-07-03",0,0,0,0,0,0,0,0
"Zambia","2024-07-04",0,0,0,0,0,0,0,0
"Zambia","2024-07-05",0,0,0,0,0,0,0,0
"Zambia","2024-07-06",0,0,0,0,0,0,0,0
"Zambia","2024-07-07",0,0,0,0,0,0,0,0
"Zambia","2024-07-08",0,0,0,0,0,0,0,0
"Zambia","2024-07-09",0,0,0,0,0,0,0,0
"Zambia","2024-07-10",0,0,0,0,0,0,0,0
"Zambia","2024-07-11",0,0,0,0,0,0,0,0
"Zambia","2024-07-12",0,0,0,0,0,0,0,0
"Zambia","2024-07-13",0,0,0,0,0,0,0,0
"Zambia","2024-07-14",0,0,0,0,0,0,0,0
"Zambia","2024-07-15",0,0,0,0,0,0,0,0
"Zambia","2024-07-16",0,0,0,0,0,0,0,0
"Zambia","2024-07-17",0,0,0,0,0,0,0,0
"Zambia","2024-07-18",0,0,0,0,0,0,0,0
"Zambia","2024-07-19",0,0,0,0,0,0,0,0
"Zambia","2024-07-20",0,0,0,0,0,0,0,0
"Zambia","2024-07-21",0,0,0,0,0,0,0,0
"Zambia","2024-07-22",0,0,0,0,0,0,0,0
"Zambia","2024-07-23",0,0,0,0,0,0,0,0
"Zambia","2024-07-24",0,0,0,0,0,0,0,0
"Zambia","2024-07-25",0,0,0,0,0,0,0,0
"Zambia","2024-07-26",0,0,0,0,0,0,0,0
"Zambia","2024-07-27",0,0,0,0,0,0,0,0
"Zambia","2024-07-28",0,0,0,0,0,0,0,0
"Zambia","2024-07-29",0,0,0,0,0,0,0,0
"Zambia","2024-07-30",0,0,0,0,0,0,0,0
"Zambia","2024-07-31",0,0,0,0,0,0,0,0
"Zambia","2024-08-01",0,0,0,0,0,0,0,0
"Zambia","2024-08-02",0,0,0,0,0,0,0,0
"Zambia","2024-08-03",0,0,0,0,0,0,0,0
"Zambia","2024-08-04",0,0,0,0,0,0,0,0
"Zambia","2024-08-05",0,0,0,0,0,0,0,0
"Zambia","2024-08-06",0,0,0,0,0,0,0,0
"Zambia","2024-08-07",0,0,0,0,0,0,0,0
"Zambia","2024-08-08",0,0,0,0,0,0,0,0
"Zambia","2024-08-09",0,0,0,0,0,0,0,0
"Zambia","2024-08-10",0,0,0,0,0,0,0,0
"Zambia","2024-08-11",0,0,0,0,0,0,0,0
"Zambia","2024-08-12",0,0,0,0,0,0,0,0
"Zambia","2024-08-13",0,0,0,0,0,0,0,0
"Zambia","2024-08-14",0,0,0,0,0,0,0,0
"Zambia","2024-08-15",0,0,0,0,0,0,0,0
"Zambia","2024-08-16",0,0,0,0,0,0,0,0
"Zambia","2024-08-17",0,0,0,0,0,0,0,0
"Zambia","2024-08-18",0,0,0,0,0,0,0,0
"Zambia","2024-08-19",0,0,0,0,0,0,0,0
"Zambia","2024-08-20",0,0,0,0,0,0,0,0
"Zambia","2024-08-21",0,0,0,0,0,0,0,0
"Zambia","2024-08-22",0,0,0,0,0,0,0,0
"Zambia","2024-08-23",0,0,0,0,0,0,0,0
"Zambia","2024-08-24",0,0,0,0,0,0,0,0
"Zambia","2024-08-25",0,0,0,0,0,0,0,0
"Zambia","2024-08-26",0,0,0,0,0,0,0,0
"Zambia","2024-08-27",0,0,0,0,0,0,0,0
"Zambia","2024-08-28",0,0,0,0,0,0,0,0
"Zambia","2024-08-29",0,0,0,0,0,0,0,0
"Zambia","2024-08-30",0,0,0,0,0,0,0,0
"Zambia","2024-08-31",0,0,0,0,0,0,0,0
"Zambia","2024-09-01",0,0,0,0,0,0,0,0
"Zambia","2024-09-02",0,0,0,0,0,0,0,0
"Zambia","2024-09-03",0,0,0,0,0,0,0,0
"Zambia","2024-09-04",0,0,0,0,0,0,0,0
"Zambia","2024-09-05",0,0,0,0,0,0,0,0
"Zambia","2024-09-06",0,0,0,0,0,0,0,0
"Zambia","2024-09-07",0,0,0,0,0,0,0,0
"Zambia","2024-09-08",0,0,0,0,0,0,0,0
"Zambia","2024-09-09",0,0,0,0,0,0,0,0
"Zambia","2024-09-10",0,0,0,0,0,0,0,0
"Zambia","2024-09-11",0,0,0,0,0,0,0,0
"Zambia","2024-09-12",0,0,0,0,0,0,0,0
"Zambia","2024-09-13",0,0,0,0,0,0,0,0
"Zambia","2024-09-14",0,0,0,0,0,0,0,0
"Zambia","2024-09-15",0,0,0,0,0,0,0,0
"Zambia","2024-09-16",0,0,0,0,0,0,0,0
"Zambia","2024-09-17",0,0,0,0,0,0,0,0
"Zambia","2024-09-18",0,0,0,0,0,0,0,0
"Zambia","2024-09-19",0,0,0,0,0,0,0,0
"Zambia","2024-09-20",0,0,0,0,0,0,0,0
"Zambia","2024-09-21",0,0,0,0,0,0,0,0
"Zambia","2024-09-22",0,0,0,0,0,0,0,0
"Zambia","2024-09-23",0,0,0,0,0,0,0,0
"Zambia","2024-09-24",0,0,0,0,0,0,0,0
"Zambia","2024-09-25",0,0,0,0,0,0,0,0
"Zambia","2024-09-26",0,0,0,0,0,0,0,0
"Zambia","2024-09-27",0,0,0,0,0,0,0,0
"Zambia","2024-09-28",0,0,0,0,0,0,0,0
"Zambia","2024-09-29",0,0,0,0,0,0,0,0
"Zambia","2024-09-30",0,0,0,0,0,0,0,0
"Zambia","2024-10-01",0,0,0,0,0,0,0,0
"Zambia","2024-10-02",0,0,0,0,0,0,0,0
"Zambia","2024-10-03",0,0,0,0,0,0,0,0
"Zambia","2024-10-04",0,0,0,0,0,0,0,0
"Zambia","2024-10-05",0,0,0,0,0,0,0,0
"Zambia","2024-10-06",0,0,0,0,0,0,0,0
"Zambia","2024-10-07",0,0,0,0,0,0,0,0
"Zambia","2024-10-08",0,0,0,0,0,0,0,0
"Zambia","2024-10-09",0,0,0,0,0,0,0,0
"Zambia","2024-10-10",0,0,0,0,0,0,0,0
"Zambia","2024-10-11",0,0,0,0,0,0,0,0
"Zambia","2024-10-12",0,1,1,0,1,1,0,0
"Zambia","2024-10-13",0,0,1,0,0,1,0,0
"Zambia","2024-10-14",0,0,1,0,0,1,0,0
"Zambia","2024-10-15",0,0,1,0,0,1,0,0
"Zambia","2024-10-16",0,0,1,0,0,1,0,0
"Zambia","2024-10-17",0,0,1,0,0,1,0,0
"Zambia","2024-10-18",0,0,1,0,0,1,0,0
"Zambia","2024-10-19",0,0,1,0,0,1,0,0
"Zambia","2024-10-20",0,0,1,0,0,1,0,0
"Zambia","2024-10-21",0,0,1,0,0,1,0,0
"Zambia","2024-10-22",0,0,1,0,0,1,0,0
"Zambia","2024-10-23",0,0,1,0,0,1,0,0
"Zambia","2024-10-24",0,0,1,0,0,1,0,0
"Zambia","2024-10-25",0,0,1,0,0,1,0,0
"Zambia","2024-10-26",0,0,1,0,0,1,0,0
"Zambia","2024-10-27",0,0,1,0,0,1,0,0
"Zambia","2024-10-28",0,0,1,0,0,1,0,0
"Zambia","2024-10-29",0,0,1,0,0,1,0,0
"Zambia","2024-10-30",0,0,1,0,0,1,0,0
"Zambia","2024-10-31",0,0,1,0,0,1,0,0
"Zambia","2024-11-01",0,0,1,0,1,2,0,0
"Zambia","2024-11-02",0,0,1,0,0,2,0,0
"Zambia","2024-11-03",0,0,1,0,0,2,0,0
"Zambia","2024-11-04",0,0,1,0,0,2,0,0
"Zambia","2024-11-05",0,0,1,0,0,2,0,0
"Zambia","2024-11-06",0,0,1,0,0,2,0,0
"Zambia","2024-11-07",0,0,1,0,0,2,0,0
"Zambia","2024-11-08",0,0,1,0,0,2,0,0
"Zambia","2024-11-09",0,0,1,0,0,2,0,0
"Zambia","2024-11-10",0,0,1,0,0,2,0,0
"Zambia","2024-11-11",0,0,1,0,0,2,0,0
"Zambia","2024-11-12",0,0,1,0,0,2,0,0
"Zambia","2024-11-13",0,0,1,0,0,2,0,0
"Zambia","2024-11-14",0,0,1,0,0,2,0,0
"Zambia","2024-11-15",0,0,1,0,0,2,0,0
"Zambia","2024-11-16",0,0,1,0,0,2,0,0
"Zambia","2024-11-17",0,0,1,0,0,2,0,0
"Zambia","2024-11-18",0,0,1,0,0,2,0,0
"Zambia","2024-11-19",0,0,1,0,0,2,0,0
"Zambia","2024-11-20",0,0,1,0,0,2,0,0
"Zambia","2024-11-21",0,0,1,0,0,2,0,0
"Zambia","2024-11-22",0,0,1,0,0,2,0,0
"Zambia","2024-11-23",0,0,1,0,0,2,0,0
"Zambia","2024-11-24",0,0,1,0,0,2,0,0
"Zambia","2024-11-25",0,0,1,0,0,2,0,0
"Zambia","2024-11-26",0,0,1,0,0,2,0,0
"Zambia","2024-11-27",0,0,1,0,0,2,0,0
"Zambia","2024-11-28",0,0,1,0,0,2,0,0
"Zambia","2024-11-29",0,0,1,0,0,2,0,0
"Zambia","2024-11-30",0,0,1,0,0,2,0,0
"Zambia","2024-12-01",0,0,1,0,0,2,0,0
"Zambia","2024-12-02",0,0,1,0,0,2,0,0
"Zambia","2024-12-03",0,0,1,0,0,2,0,0
"Zambia","2024-12-04",0,0,1,0,0,2,0,0
"Zambia","2024-12-05",0,0,1,0,0,2,0,0
"Zambia","2024-12-06",0,0,1,0,0,2,0,0
"Zambia","2024-12-07",0,0,1,0,0,2,0,0
"Zambia","2024-12-08",0,0,1,0,0,2,0,0
"Zambia","2024-12-09",0,0,1,0,0,2,0,0
"Zambia","2024-12-10",0,0,1,0,1,3,0,0
"Zambia","2024-12-11",0,0,1,0,0,3,0,0
"Zambia","2024-12-12",0,0,1,0,0,3,0,0
"Zambia","2024-12-13",0,0,1,0,0,3,0,0
"Zambia","2024-12-14",0,0,1,0,0,3,0,0
"Zambia","2024-12-15",0,0,1,0,0,3,0,0
"Zambia","2024-12-16",0,0,1,0,0,3,0,0
"Zambia","2024-12-17",0,0,1,0,0,3,0,0
"Zambia","2024-12-18",0,0,1,0,0,3,0,0
"Zambia","2024-12-19",0,0,1,0,0,3,0,0
"Zambia","2024-12-20",0,0,1,0,0,3,0,0
"Zambia","2024-12-21",0,0,1,0,0,3,0,0
"Zambia","2024-12-22",0,0,1,0,0,3,0,0
"Zambia","2024-12-23",0,0,1,0,0,3,0,0
"Zambia","2024-12-24",0,0,1,0,0,3,0,0
"Zambia","2024-12-25",0,0,1,0,0,3,0,0
"Zambia","2024-12-26",0,0,1,0,0,3,0,0
"Zambia","2024-12-27",0,0,1,0,0,3,0,0
"Zambia","2024-12-28",0,0,1,0,0,3,0,0
"Zambia","2024-12-29",0,2,3,0,0,3,0,0
"Zambia","2024-12-30",0,0,3,0,0,3,0,0
"Zambia","2024-12-31",0,0,3,0,0,3,0,0
"Zambia","2025-01-01",0,0,3,0,0,3,0,0
"Zambia","2025-01-02",0,0,3,0,1,4,0,0
"Zambia","2025-01-03",0,0,3,0,0,4,0,0
"Zambia","2025-01-04",0,0,3,0,0,4,0,0
"Zambia","2025-01-05",0,1,4,0,0,4,0,0
"Zambia","2025-01-06",0,0,4,0,0,4,0,0
"Zambia","2025-01-07",0,0,4,0,0,4,0,0
"Zambia","2025-01-08",0,0,4,0,0,4,0,0
"Zambia","2025-01-09",0,0,4,0,0,4,0,0
"Zambia","2025-01-10",0,0,4,0,0,4,0,0
"Zambia","2025-01-11",0,0,4,0,0,4,0,0
"Zambia","2025-01-12",0,0,4,0,0,4,0,0
"Zambia","2025-01-13",0,0,4,0,0,4,0,0
"Zambia","2025-01-14",0,0,4,0,0,4,0,0
"Zambia","2025-01-15",0,0,4,0,0,4,0,0
"Zambia","2025-01-16",0,0,4,0,0,4,0,0
"Zambia","2025-01-17",0,0,4,0,0,4,0,0
"Zambia","2025-01-18",0,0,4,0,0,4,0,0
"Zambia","2025-01-19",0,0,4,0,0,4,0,0
"Zambia","2025-01-20",0,0,4,0,0,4,0,0
"Zambia","2025-01-21",0,0,4,0,0,4,0,0
"Zambia","2025-01-22",0,0,4,0,0,4,0,0
"Zambia","2025-01-23",0,0,4,0,0,4,0,0
"Zambia","2025-01-24",0,0,4,0,0,4,0,0
"Zambia","2025-01-25",0,0,4,0,0,4,0,0
"Zambia","2025-01-26",0,0,4,0,0,4,0,0
"Zambia","2025-01-27",0,0,4,0,0,4,0,0
"Zambia","2025-01-28",0,0,4,0,0,4,0,0
"Zambia","2025-01-29",0,0,4,0,0,4,0,0
"Zambia","2025-01-30",0,0,4,0,0,4,0,0
"Zambia","2025-01-31",0,0,4,0,0,4,0,0
"Zambia","2025-02-01",0,0,4,0,0,4,0,0
"Zambia","2025-02-02",0,0,4,0,0,4,0,0
"Zambia","2025-02-03",0,0,4,0,0,4,0,0
"Zimbabwe","2024-01-01",0,0,0,0,0,0,0,0
"Zimbabwe","2024-01-02",0,0,0,0,0,0,0,0
"Zimbabwe","2024-01-03",0,0,0,0,0,0,0,0
"Zimbabwe","2024-01-04",0,0,0,0,0,0,0,0
"Zimbabwe","2024-01-05",0,0,0,0,0,0,0,0
"Zimbabwe","2024-01-06",0,0,0,0,0,0,0,0
"Zimbabwe","2024-01-07",0,0,0,0,0,0,0,0
"Zimbabwe","2024-01-08",0,0,0,0,0,0,0,0
"Zimbabwe","2024-01-09",0,0,0,0,0,0,0,0
"Zimbabwe","2024-01-10",0,0,0,0,0,0,0,0
"Zimbabwe","2024-01-11",0,0,0,0,0,0,0,0
"Zimbabwe","2024-01-12",0,0,0,0,0,0,0,0
"Zimbabwe","2024-01-13",0,0,0,0,0,0,0,0
"Zimbabwe","2024-01-14",0,0,0,0,0,0,0,0
"Zimbabwe","2024-01-15",0,0,0,0,0,0,0,0
"Zimbabwe","2024-01-16",0,0,0,0,0,0,0,0
"Zimbabwe","2024-01-17",0,0,0,0,0,0,0,0
"Zimbabwe","2024-01-18",0,0,0,0,0,0,0,0
"Zimbabwe","2024-01-19",0,0,0,0,0,0,0,0
"Zimbabwe","2024-01-20",0,0,0,0,0,0,0,0
"Zimbabwe","2024-01-21",0,0,0,0,0,0,0,0
"Zimbabwe","2024-01-22",0,0,0,0,0,0,0,0
"Zimbabwe","2024-01-23",0,0,0,0,0,0,0,0
"Zimbabwe","2024-01-24",0,0,0,0,0,0,0,0
"Zimbabwe","2024-01-25",0,0,0,0,0,0,0,0
"Zimbabwe","2024-01-26",0,0,0,0,0,0,0,0
"Zimbabwe","2024-01-27",0,0,0,0,0,0,0,0
"Zimbabwe","2024-01-28",0,0,0,0,0,0,0,0
"Zimbabwe","2024-01-29",0,0,0,0,0,0,0,0
"Zimbabwe","2024-01-30",0,0,0,0,0,0,0,0
"Zimbabwe","2024-01-31",0,0,0,0,0,0,0,0
"Zimbabwe","2024-02-01",0,0,0,0,0,0,0,0
"Zimbabwe","2024-02-02",0,0,0,0,0,0,0,0
"Zimbabwe","2024-02-03",0,0,0,0,0,0,0,0
"Zimbabwe","2024-02-04",0,0,0,0,0,0,0,0
"Zimbabwe","2024-02-05",0,0,0,0,0,0,0,0
"Zimbabwe","2024-02-06",0,0,0,0,0,0,0,0
"Zimbabwe","2024-02-07",0,0,0,0,0,0,0,0
"Zimbabwe","2024-02-08",0,0,0,0,0,0,0,0
"Zimbabwe","2024-02-09",0,0,0,0,0,0,0,0
"Zimbabwe","2024-02-10",0,0,0,0,0,0,0,0
"Zimbabwe","2024-02-11",0,0,0,0,0,0,0,0
"Zimbabwe","2024-02-12",0,0,0,0,0,0,0,0
"Zimbabwe","2024-02-13",0,0,0,0,0,0,0,0
"Zimbabwe","2024-02-14",0,0,0,0,0,0,0,0
"Zimbabwe","2024-02-15",0,0,0,0,0,0,0,0
"Zimbabwe","2024-02-16",0,0,0,0,0,0,0,0
"Zimbabwe","2024-02-17",0,0,0,0,0,0,0,0
"Zimbabwe","2024-02-18",0,0,0,0,0,0,0,0
"Zimbabwe","2024-02-19",0,0,0,0,0,0,0,0
"Zimbabwe","2024-02-20",0,0,0,0,0,0,0,0
"Zimbabwe","2024-02-21",0,0,0,0,0,0,0,0
"Zimbabwe","2024-02-22",0,0,0,0,0,0,0,0
"Zimbabwe","2024-02-23",0,0,0,0,0,0,0,0
"Zimbabwe","2024-02-24",0,0,0,0,0,0,0,0
"Zimbabwe","2024-02-25",0,0,0,0,0,0,0,0
"Zimbabwe","2024-02-26",0,0,0,0,0,0,0,0
"Zimbabwe","2024-02-27",0,0,0,0,0,0,0,0
"Zimbabwe","2024-02-28",0,0,0,0,0,0,0,0
"Zimbabwe","2024-02-29",0,0,0,0,0,0,0,0
"Zimbabwe","2024-03-01",0,0,0,0,0,0,0,0
"Zimbabwe","2024-03-02",0,0,0,0,0,0,0,0
"Zimbabwe","2024-03-03",0,0,0,0,0,0,0,0
"Zimbabwe","2024-03-04",0,0,0,0,0,0,0,0
"Zimbabwe","2024-03-05",0,0,0,0,0,0,0,0
"Zimbabwe","2024-03-06",0,0,0,0,0,0,0,0
"Zimbabwe","2024-03-07",0,0,0,0,0,0,0,0
"Zimbabwe","2024-03-08",0,0,0,0,0,0,0,0
"Zimbabwe","2024-03-09",0,0,0,0,0,0,0,0
"Zimbabwe","2024-03-10",0,0,0,0,0,0,0,0
"Zimbabwe","2024-03-11",0,0,0,0,0,0,0,0
"Zimbabwe","2024-03-12",0,0,0,0,0,0,0,0
"Zimbabwe","2024-03-13",0,0,0,0,0,0,0,0
"Zimbabwe","2024-03-14",0,0,0,0,0,0,0,0
"Zimbabwe","2024-03-15",0,0,0,0,0,0,0,0
"Zimbabwe","2024-03-16",0,0,0,0,0,0,0,0
"Zimbabwe","2024-03-17",0,0,0,0,0,0,0,0
"Zimbabwe","2024-03-18",0,0,0,0,0,0,0,0
"Zimbabwe","2024-03-19",0,0,0,0,0,0,0,0
"Zimbabwe","2024-03-20",0,0,0,0,0,0,0,0
"Zimbabwe","2024-03-21",0,0,0,0,0,0,0,0
"Zimbabwe","2024-03-22",0,0,0,0,0,0,0,0
"Zimbabwe","2024-03-23",0,0,0,0,0,0,0,0
"Zimbabwe","2024-03-24",0,0,0,0,0,0,0,0
"Zimbabwe","2024-03-25",0,0,0,0,0,0,0,0
"Zimbabwe","2024-03-26",0,0,0,0,0,0,0,0
"Zimbabwe","2024-03-27",0,0,0,0,0,0,0,0
"Zimbabwe","2024-03-28",0,0,0,0,0,0,0,0
"Zimbabwe","2024-03-29",0,0,0,0,0,0,0,0
"Zimbabwe","2024-03-30",0,0,0,0,0,0,0,0
"Zimbabwe","2024-03-31",0,0,0,0,0,0,0,0
"Zimbabwe","2024-04-01",0,0,0,0,0,0,0,0
"Zimbabwe","2024-04-02",0,0,0,0,0,0,0,0
"Zimbabwe","2024-04-03",0,0,0,0,0,0,0,0
"Zimbabwe","2024-04-04",0,0,0,0,0,0,0,0
"Zimbabwe","2024-04-05",0,0,0,0,0,0,0,0
"Zimbabwe","2024-04-06",0,0,0,0,0,0,0,0
"Zimbabwe","2024-04-07",0,0,0,0,0,0,0,0
"Zimbabwe","2024-04-08",0,0,0,0,0,0,0,0
"Zimbabwe","2024-04-09",0,0,0,0,0,0,0,0
"Zimbabwe","2024-04-10",0,0,0,0,0,0,0,0
"Zimbabwe","2024-04-11",0,0,0,0,0,0,0,0
"Zimbabwe","2024-04-12",0,0,0,0,0,0,0,0
"Zimbabwe","2024-04-13",0,0,0,0,0,0,0,0
"Zimbabwe","2024-04-14",0,0,0,0,0,0,0,0
"Zimbabwe","2024-04-15",0,0,0,0,0,0,0,0
"Zimbabwe","2024-04-16",0,0,0,0,0,0,0,0
"Zimbabwe","2024-04-17",0,0,0,0,0,0,0,0
"Zimbabwe","2024-04-18",0,0,0,0,0,0,0,0
"Zimbabwe","2024-04-19",0,0,0,0,0,0,0,0
"Zimbabwe","2024-04-20",0,0,0,0,0,0,0,0
"Zimbabwe","2024-04-21",0,0,0,0,0,0,0,0
"Zimbabwe","2024-04-22",0,0,0,0,0,0,0,0
"Zimbabwe","2024-04-23",0,0,0,0,0,0,0,0
"Zimbabwe","2024-04-24",0,0,0,0,0,0,0,0
"Zimbabwe","2024-04-25",0,0,0,0,0,0,0,0
"Zimbabwe","2024-04-26",0,0,0,0,0,0,0,0
"Zimbabwe","2024-04-27",0,0,0,0,0,0,0,0
"Zimbabwe","2024-04-28",0,0,0,0,0,0,0,0
"Zimbabwe","2024-04-29",0,0,0,0,0,0,0,0
"Zimbabwe","2024-04-30",0,0,0,0,0,0,0,0
"Zimbabwe","2024-05-01",0,0,0,0,0,0,0,0
"Zimbabwe","2024-05-02",0,0,0,0,0,0,0,0
"Zimbabwe","2024-05-03",0,0,0,0,0,0,0,0
"Zimbabwe","2024-05-04",0,0,0,0,0,0,0,0
"Zimbabwe","2024-05-05",0,0,0,0,0,0,0,0
"Zimbabwe","2024-05-06",0,0,0,0,0,0,0,0
"Zimbabwe","2024-05-07",0,0,0,0,0,0,0,0
"Zimbabwe","2024-05-08",0,0,0,0,0,0,0,0
"Zimbabwe","2024-05-09",0,0,0,0,0,0,0,0
"Zimbabwe","2024-05-10",0,0,0,0,0,0,0,0
"Zimbabwe","2024-05-11",0,0,0,0,0,0,0,0
"Zimbabwe","2024-05-12",0,0,0,0,0,0,0,0
"Zimbabwe","2024-05-13",0,0,0,0,0,0,0,0
"Zimbabwe","2024-05-14",0,0,0,0,0,0,0,0
"Zimbabwe","2024-05-15",0,0,0,0,0,0,0,0
"Zimbabwe","2024-05-16",0,0,0,0,0,0,0,0
"Zimbabwe","2024-05-17",0,0,0,0,0,0,0,0
"Zimbabwe","2024-05-18",0,0,0,0,0,0,0,0
"Zimbabwe","2024-05-19",0,0,0,0,0,0,0,0
"Zimbabwe","2024-05-20",0,0,0,0,0,0,0,0
"Zimbabwe","2024-05-21",0,0,0,0,0,0,0,0
"Zimbabwe","2024-05-22",0,0,0,0,0,0,0,0
"Zimbabwe","2024-05-23",0,0,0,0,0,0,0,0
"Zimbabwe","2024-05-24",0,0,0,0,0,0,0,0
"Zimbabwe","2024-05-25",0,0,0,0,0,0,0,0
"Zimbabwe","2024-05-26",0,0,0,0,0,0,0,0
"Zimbabwe","2024-05-27",0,0,0,0,0,0,0,0
"Zimbabwe","2024-05-28",0,0,0,0,0,0,0,0
"Zimbabwe","2024-05-29",0,0,0,0,0,0,0,0
"Zimbabwe","2024-05-30",0,0,0,0,0,0,0,0
"Zimbabwe","2024-05-31",0,0,0,0,0,0,0,0
"Zimbabwe","2024-06-01",0,0,0,0,0,0,0,0
"Zimbabwe","2024-06-02",0,0,0,0,0,0,0,0
"Zimbabwe","2024-06-03",0,0,0,0,0,0,0,0
"Zimbabwe","2024-06-04",0,0,0,0,0,0,0,0
"Zimbabwe","2024-06-05",0,0,0,0,0,0,0,0
"Zimbabwe","2024-06-06",0,0,0,0,0,0,0,0
"Zimbabwe","2024-06-07",0,0,0,0,0,0,0,0
"Zimbabwe","2024-06-08",0,0,0,0,0,0,0,0
"Zimbabwe","2024-06-09",0,0,0,0,0,0,0,0
"Zimbabwe","2024-06-10",0,0,0,0,0,0,0,0
"Zimbabwe","2024-06-11",0,0,0,0,0,0,0,0
"Zimbabwe","2024-06-12",0,0,0,0,0,0,0,0
"Zimbabwe","2024-06-13",0,0,0,0,0,0,0,0
"Zimbabwe","2024-06-14",0,0,0,0,0,0,0,0
"Zimbabwe","2024-06-15",0,0,0,0,0,0,0,0
"Zimbabwe","2024-06-16",0,0,0,0,0,0,0,0
"Zimbabwe","2024-06-17",0,0,0,0,0,0,0,0
"Zimbabwe","2024-06-18",0,0,0,0,0,0,0,0
"Zimbabwe","2024-06-19",0,0,0,0,0,0,0,0
"Zimbabwe","2024-06-20",0,0,0,0,0,0,0,0
"Zimbabwe","2024-06-21",0,0,0,0,0,0,0,0
"Zimbabwe","2024-06-22",0,0,0,0,0,0,0,0
"Zimbabwe","2024-06-23",0,0,0,0,0,0,0,0
"Zimbabwe","2024-06-24",0,0,0,0,0,0,0,0
"Zimbabwe","2024-06-25",0,0,0,0,0,0,0,0
"Zimbabwe","2024-06-26",0,0,0,0,0,0,0,0
"Zimbabwe","2024-06-27",0,0,0,0,0,0,0,0
"Zimbabwe","2024-06-28",0,0,0,0,0,0,0,0
"Zimbabwe","2024-06-29",0,0,0,0,0,0,0,0
"Zimbabwe","2024-06-30",0,0,0,0,0,0,0,0
"Zimbabwe","2024-07-01",0,0,0,0,0,0,0,0
"Zimbabwe","2024-07-02",0,0,0,0,0,0,0,0
"Zimbabwe","2024-07-03",0,0,0,0,0,0,0,0
"Zimbabwe","2024-07-04",0,0,0,0,0,0,0,0
"Zimbabwe","2024-07-05",0,0,0,0,0,0,0,0
"Zimbabwe","2024-07-06",0,0,0,0,0,0,0,0
"Zimbabwe","2024-07-07",0,0,0,0,0,0,0,0
"Zimbabwe","2024-07-08",0,0,0,0,0,0,0,0
"Zimbabwe","2024-07-09",0,0,0,0,0,0,0,0
"Zimbabwe","2024-07-10",0,0,0,0,0,0,0,0
"Zimbabwe","2024-07-11",0,0,0,0,0,0,0,0
"Zimbabwe","2024-07-12",0,0,0,0,0,0,0,0
"Zimbabwe","2024-07-13",0,0,0,0,0,0,0,0
"Zimbabwe","2024-07-14",0,0,0,0,0,0,0,0
"Zimbabwe","2024-07-15",0,0,0,0,0,0,0,0
"Zimbabwe","2024-07-16",0,0,0,0,0,0,0,0
"Zimbabwe","2024-07-17",0,0,0,0,0,0,0,0
"Zimbabwe","2024-07-18",0,0,0,0,0,0,0,0
"Zimbabwe","2024-07-19",0,0,0,0,0,0,0,0
"Zimbabwe","2024-07-20",0,0,0,0,0,0,0,0
"Zimbabwe","2024-07-21",0,0,0,0,0,0,0,0
"Zimbabwe","2024-07-22",0,0,0,0,0,0,0,0
"Zimbabwe","2024-07-23",0,0,0,0,0,0,0,0
"Zimbabwe","2024-07-24",0,0,0,0,0,0,0,0
"Zimbabwe","2024-07-25",0,0,0,0,0,0,0,0
"Zimbabwe","2024-07-26",0,0,0,0,0,0,0,0
"Zimbabwe","2024-07-27",0,0,0,0,0,0,0,0
"Zimbabwe","2024-07-28",0,0,0,0,0,0,0,0
"Zimbabwe","2024-07-29",0,0,0,0,0,0,0,0
"Zimbabwe","2024-07-30",0,0,0,0,0,0,0,0
"Zimbabwe","2024-07-31",0,0,0,0,0,0,0,0
"Zimbabwe","2024-08-01",0,0,0,0,0,0,0,0
"Zimbabwe","2024-08-02",0,0,0,0,0,0,0,0
"Zimbabwe","2024-08-03",0,0,0,0,0,0,0,0
"Zimbabwe","2024-08-04",0,0,0,0,0,0,0,0
"Zimbabwe","2024-08-05",0,0,0,0,0,0,0,0
"Zimbabwe","2024-08-06",0,0,0,0,0,0,0,0
"Zimbabwe","2024-08-07",0,0,0,0,0,0,0,0
"Zimbabwe","2024-08-08",0,0,0,0,0,0,0,0
"Zimbabwe","2024-08-09",0,0,0,0,0,0,0,0
"Zimbabwe","2024-08-10",0,0,0,0,0,0,0,0
"Zimbabwe","2024-08-11",0,0,0,0,0,0,0,0
"Zimbabwe","2024-08-12",0,0,0,0,0,0,0,0
"Zimbabwe","2024-08-13",0,0,0,0,0,0,0,0
"Zimbabwe","2024-08-14",0,0,0,0,0,0,0,0
"Zimbabwe","2024-08-15",0,0,0,0,0,0,0,0
"Zimbabwe","2024-08-16",0,0,0,0,0,0,0,0
"Zimbabwe","2024-08-17",0,0,0,0,0,0,0,0
"Zimbabwe","2024-08-18",0,0,0,0,0,0,0,0
"Zimbabwe","2024-08-19",0,0,0,0,0,0,0,0
"Zimbabwe","2024-08-20",0,0,0,0,0,0,0,0
"Zimbabwe","2024-08-21",0,0,0,0,0,0,0,0
"Zimbabwe","2024-08-22",0,0,0,0,0,0,0,0
"Zimbabwe","2024-08-23",0,0,0,0,0,0,0,0
"Zimbabwe","2024-08-24",0,0,0,0,0,0,0,0
"Zimbabwe","2024-08-25",0,0,0,0,0,0,0,0
"Zimbabwe","2024-08-26",0,0,0,0,0,0,0,0
"Zimbabwe","2024-08-27",0,0,0,0,0,0,0,0
"Zimbabwe","2024-08-28",0,0,0,0,0,0,0,0
"Zimbabwe","2024-08-29",0,0,0,0,0,0,0,0
"Zimbabwe","2024-08-30",0,0,0,0,0,0,0,0
"Zimbabwe","2024-08-31",0,0,0,0,0,0,0,0
"Zimbabwe","2024-09-01",0,0,0,0,0,0,0,0
"Zimbabwe","2024-09-02",0,0,0,0,0,0,0,0
"Zimbabwe","2024-09-03",0,0,0,0,0,0,0,0
"Zimbabwe","2024-09-04",0,0,0,0,0,0,0,0
"Zimbabwe","2024-09-05",0,0,0,0,0,0,0,0
"Zimbabwe","2024-09-06",0,0,0,0,0,0,0,0
"Zimbabwe","2024-09-07",0,0,0,0,0,0,0,0
"Zimbabwe","2024-09-08",0,0,0,0,0,0,0,0
"Zimbabwe","2024-09-09",0,0,0,0,0,0,0,0
"Zimbabwe","2024-09-10",0,0,0,0,0,0,0,0
"Zimbabwe","2024-09-11",0,0,0,0,0,0,0,0
"Zimbabwe","2024-09-12",0,0,0,0,0,0,0,0
"Zimbabwe","2024-09-13",0,0,0,0,0,0,0,0
"Zimbabwe","2024-09-14",0,0,0,0,0,0,0,0
"Zimbabwe","2024-09-15",0,0,0,0,0,0,0,0
"Zimbabwe","2024-09-16",0,0,0,0,0,0,0,0
"Zimbabwe","2024-09-17",0,0,0,0,0,0,0,0
"Zimbabwe","2024-09-18",0,0,0,0,0,0,0,0
"Zimbabwe","2024-09-19",0,0,0,0,0,0,0,0
"Zimbabwe","2024-09-20",0,0,0,0,0,0,0,0
"Zimbabwe","2024-09-21",0,0,0,0,0,0,0,0
"Zimbabwe","2024-09-22",0,0,0,0,0,0,0,0
"Zimbabwe","2024-09-23",0,0,0,0,0,0,0,0
"Zimbabwe","2024-09-24",0,0,0,0,0,0,0,0
"Zimbabwe","2024-09-25",0,0,0,0,0,0,0,0
"Zimbabwe","2024-09-26",0,0,0,0,0,0,0,0
"Zimbabwe","2024-09-27",0,0,0,0,0,0,0,0
"Zimbabwe","2024-09-28",0,0,0,0,0,0,0,0
"Zimbabwe","2024-09-29",0,0,0,0,0,0,0,0
"Zimbabwe","2024-09-30",0,0,0,0,0,0,0,0
"Zimbabwe","2024-10-01",0,0,0,0,0,0,0,0
"Zimbabwe","2024-10-02",0,0,0,0,0,0,0,0
"Zimbabwe","2024-10-03",0,0,0,0,0,0,0,0
"Zimbabwe","2024-10-04",0,0,0,0,0,0,0,0
"Zimbabwe","2024-10-05",0,0,0,0,0,0,0,0
"Zimbabwe","2024-10-06",0,0,0,0,0,0,0,0
"Zimbabwe","2024-10-07",0,0,0,0,0,0,0,0
"Zimbabwe","2024-10-08",0,0,0,0,0,0,0,0
"Zimbabwe","2024-10-09",0,0,0,0,0,0,0,0
"Zimbabwe","2024-10-10",0,0,0,0,0,0,0,0
"Zimbabwe","2024-10-11",0,0,0,0,0,0,0,0
"Zimbabwe","2024-10-12",0,0,0,0,0,0,0,0
"Zimbabwe","2024-10-13",0,2,2,0,2,2,0,0
"Zimbabwe","2024-10-14",0,0,2,0,0,2,0,0
"Zimbabwe","2024-10-15",0,0,2,0,0,2,0,0
"Zimbabwe","2024-10-16",0,0,2,0,0,2,0,0
"Zimbabwe","2024-10-17",0,0,2,0,0,2,0,0
"Zimbabwe","2024-10-18",0,0,2,0,0,2,0,0
"Zimbabwe","2024-10-19",0,0,2,0,0,2,0,0
"Zimbabwe","2024-10-20",0,0,2,0,0,2,0,0
"Zimbabwe","2024-10-21",0,0,2,0,0,2,0,0
"Zimbabwe","2024-10-22",0,0,2,0,0,2,0,0
"Zimbabwe","2024-10-23",0,0,2,0,0,2,0,0
"Zimbabwe","2024-10-24",0,0,2,0,0,2,0,0
"Zimbabwe","2024-10-25",0,0,2,0,0,2,0,0
"Zimbabwe","2024-10-26",0,0,2,0,0,2,0,0
"Zimbabwe","2024-10-27",0,0,2,0,0,2,0,0
"Zimbabwe","2024-10-28",0,0,2,0,0,2,0,0
"Zimbabwe","2024-10-29",0,0,2,0,0,2,0,0
"Zimbabwe","2024-10-30",0,0,2,0,0,2,0,0
"Zimbabwe","2024-10-31",0,0,2,0,0,2,0,0
"Zimbabwe","2024-11-01",0,0,2,0,0,2,0,0
"Zimbabwe","2024-11-02",0,0,2,0,0,2,0,0
"Zimbabwe","2024-11-03",0,0,2,0,0,2,0,0
"Zimbabwe","2024-11-04",0,0,2,0,0,2,0,0
"Zimbabwe","2024-11-05",0,0,2,0,0,2,0,0
"Zimbabwe","2024-11-06",0,0,2,0,0,2,0,0
"Zimbabwe","2024-11-07",0,0,2,0,0,2,0,0
"Zimbabwe","2024-11-08",0,0,2,0,0,2,0,0
"Zimbabwe","2024-11-09",0,0,2,0,0,2,0,0
"Zimbabwe","2024-11-10",0,0,2,0,0,2,0,0
"Zimbabwe","2024-11-11",0,0,2,0,0,2,0,0
"Zimbabwe","2024-11-12",0,0,2,0,0,2,0,0
"Zimbabwe","2024-11-13",0,0,2,0,0,2,0,0
"Zimbabwe","2024-11-14",0,0,2,0,0,2,0,0
"Zimbabwe","2024-11-15",0,0,2,0,0,2,0,0
"Zimbabwe","2024-11-16",0,0,2,0,0,2,0,0
"Zimbabwe","2024-11-17",0,0,2,0,0,2,0,0
"Zimbabwe","2024-11-18",0,0,2,0,0,2,0,0
"Zimbabwe","2024-11-19",0,0,2,0,0,2,0,0
"Zimbabwe","2024-11-20",0,0,2,0,0,2,0,0
"Zimbabwe","2024-11-21",0,0,2,0,0,2,0,0
"Zimbabwe","2024-11-22",0,0,2,0,0,2,0,0
"Zimbabwe","2024-11-23",0,0,2,0,0,2,0,0
"Zimbabwe","2024-11-24",0,0,2,0,0,2,0,0
"Zimbabwe","2024-11-25",0,0,2,0,0,2,0,0
"Zimbabwe","2024-11-26",0,0,2,0,0,2,0,0
"Zimbabwe","2024-11-27",0,0,2,0,0,2,0,0
"Zimbabwe","2024-11-28",0,0,2,0,0,2,0,0
"Zimbabwe","2024-11-29",0,0,2,0,0,2,0,0
"Zimbabwe","2024-11-30",0,0,2,0,0,2,0,0
"Zimbabwe","2024-12-01",0,0,2,0,0,2,0,0
"Zimbabwe","2024-12-02",0,0,2,0,0,2,0,0
"Zimbabwe","2024-12-03",0,0,2,0,0,2,0,0
"Zimbabwe","2024-12-04",0,0,2,0,0,2,0,0
"Zimbabwe","2024-12-05",0,0,2,0,0,2,0,0
"Zimbabwe","2024-12-06",0,0,2,0,0,2,0,0
"Zimbabwe","2024-12-07",0,0,2,0,0,2,0,0
"Zimbabwe","2024-12-08",0,0,2,0,0,2,0,0
"Zimbabwe","2024-12-09",0,0,2,0,0,2,0,0
"Zimbabwe","2024-12-10",0,0,2,0,0,2,0,0
"Zimbabwe","2024-12-11",0,0,2,0,0,2,0,0
"Zimbabwe","2024-12-12",0,0,2,0,0,2,0,0
"Zimbabwe","2024-12-13",0,0,2,0,0,2,0,0
"Zimbabwe","2024-12-14",0,0,2,0,0,2,0,0
"Zimbabwe","2024-12-15",0,0,2,0,0,2,0,0
"Zimbabwe","2024-12-16",0,0,2,0,0,2,0,0
"Zimbabwe","2024-12-17",0,0,2,0,0,2,0,0
"Zimbabwe","2024-12-18",0,0,2,0,0,2,0,0
"Zimbabwe","2024-12-19",0,0,2,0,0,2,0,0
"Zimbabwe","2024-12-20",0,0,2,0,0,2,0,0
"Zimbabwe","2024-12-21",0,0,2,0,0,2,0,0
"Zimbabwe","2024-12-22",0,0,2,0,0,2,0,0
"Zimbabwe","2024-12-23",0,0,2,0,0,2,0,0
"Zimbabwe","2024-12-24",0,0,2,0,0,2,0,0
"Zimbabwe","2024-12-25",0,0,2,0,0,2,0,0
"Zimbabwe","2024-12-26",0,0,2,0,0,2,0,0
"Zimbabwe","2024-12-27",0,0,2,0,0,2,0,0
"Zimbabwe","2024-12-28",0,0,2,0,0,2,0,0
"Zimbabwe","2024-12-29",0,0,2,0,0,2,0,0
"Zimbabwe","2024-12-30",0,0,2,0,0,2,0,0
"Zimbabwe","2024-12-31",0,0,2,0,0,2,0,0
"Zimbabwe","2025-01-01",0,0,2,0,0,2,0,0
"Zimbabwe","2025-01-02",0,0,2,0,0,2,0,0
"Zimbabwe","2025-01-03",0,0,2,0,0,2,0,0
"Zimbabwe","2025-01-04",0,0,2,0,0,2,0,0
"Zimbabwe","2025-01-05",0,0,2,0,0,2,0,0
"Zimbabwe","2025-01-06",0,0,2,0,0,2,0,0
"Zimbabwe","2025-01-07",0,0,2,0,0,2,0,0
"Zimbabwe","2025-01-08",0,0,2,0,0,2,0,0
"Zimbabwe","2025-01-09",0,0,2,0,0,2,0,0
"Zimbabwe","2025-01-10",0,0,2,0,0,2,0,0
"Zimbabwe","2025-01-11",0,0,2,0,0,2,0,0
"Zimbabwe","2025-01-12",0,0,2,0,0,2,0,0
"Zimbabwe","2025-01-13",0,0,2,0,0,2,0,0
"Zimbabwe","2025-01-14",0,0,2,0,0,2,0,0
"Zimbabwe","2025-01-15",0,0,2,0,0,2,0,0
"Zimbabwe","2025-01-16",0,0,2,0,0,2,0,0
"Zimbabwe","2025-01-17",0,0,2,0,0,2,0,0
"Zimbabwe","2025-01-18",0,0,2,0,0,2,0,0
"Zimbabwe","2025-01-19",0,0,2,0,0,2,0,0
"Zimbabwe","2025-01-20",0,0,2,0,0,2,0,0
"Zimbabwe","2025-01-21",0,0,2,0,0,2,0,0
"Zimbabwe","2025-01-22",0,0,2,0,0,2,0,0
"Zimbabwe","2025-01-23",0,0,2,0,0,2,0,0
"Zimbabwe","2025-01-24",0,0,2,0,0,2,0,0
"Zimbabwe","2025-01-25",0,0,2,0,0,2,0,0
"Zimbabwe","2025-01-26",0,0,2,0,0,2,0,0
"Zimbabwe","2025-01-27",0,0,2,0,0,2,0,0
"Zimbabwe","2025-01-28",0,0,2,0,0,2,0,0
"Zimbabwe","2025-01-29",0,0,2,0,0,2,0,0
"Zimbabwe","2025-01-30",0,0,2,0,0,2,0,0
"Zimbabwe","2025-01-31",0,0,2,0,0,2,0,0
"Zimbabwe","2025-02-01",0,0,2,0,0,2,0,0
"Zimbabwe","2025-02-02",0,0,2,0,0,2,0,0
"Zimbabwe","2025-02-03",0,0,2,0,0,2,0,0
