"location","date","new_suspected_cases_calc_owd","new_confirmed_cases_calc_owd","cum_confirmed_cases_calc_owd","cum_suspected_cases_calc_owd","all_new_confirmed_cases_owd","all_cum_confirmed_cases_owd","all_new_suspected_cases_owd","all_cum_suspected_cases_owd"
"Africa","2024-01-01",0,0,0,0,0,0,0,0
"Africa","2024-01-02",0,0,0,0,0,0,0,0
"Africa","2024-01-03",0,0,0,0,0,0,0,0
"Africa","2024-01-04",0,0,0,0,0,0,0,0
"Africa","2024-01-05",0,0,0,0,0,0,0,0
"Africa","2024-01-06",0,0,0,0,0,0,0,0
"Africa","2024-01-07",0,57,57,0,57,57,0,0
"Africa","2024-01-08",0,0,57,0,11,68,0,0
"Africa","2024-01-09",0,0,57,0,11,79,0,0
"Africa","2024-01-10",0,0,57,0,11,90,0,0
"Africa","2024-01-11",0,0,57,0,12,102,0,0
"Africa","2024-01-12",0,0,57,0,11,113,0,0
"Africa","2024-01-13",0,0,57,0,11,124,0,0
"Africa","2024-01-14",0,78,135,0,11,135,0,0
"Africa","2024-01-15",0,0,135,0,13,148,0,0
"Africa","2024-01-16",0,0,135,0,13,161,0,0
"Africa","2024-01-17",0,0,135,0,13,174,0,0
"Africa","2024-01-18",0,0,135,0,12,186,0,0
"Africa","2024-01-19",0,0,135,0,13,199,0,0
"Africa","2024-01-20",0,0,135,0,13,212,0,0
"Africa","2024-01-21",0,90,225,0,13,225,0,0
"Africa","2024-01-22",0,0,225,0,11,236,0,0
"Africa","2024-01-23",0,0,225,0,12,248,0,0
"Africa","2024-01-24",0,0,225,0,11,259,0,0
"Africa","2024-01-25",0,0,225,0,11,270,0,0
"Africa","2024-01-26",0,0,225,0,11,281,0,0
"Africa","2024-01-27",0,0,225,0,12,293,0,0
"Africa","2024-01-28",0,79,304,0,11,304,0,0
"Africa","2024-01-29",0,0,304,0,9,313,0,0
"Africa","2024-01-30",0,0,304,0,9,322,0,0
"Africa","2024-01-31",0,0,304,0,9,331,0,0
"Africa","2024-02-01",0,0,304,0,9,340,0,0
"Africa","2024-02-02",0,0,304,0,9,349,0,0
"Africa","2024-02-03",0,0,304,0,9,358,0,0
"Africa","2024-02-04",0,63,367,0,9,367,0,0
"Africa","2024-02-05",0,0,367,0,9,376,0,0
"Africa","2024-02-06",0,0,367,0,10,386,0,0
"Africa","2024-02-07",0,0,367,0,9,395,0,0
"Africa","2024-02-08",0,0,367,0,9,404,0,0
"Africa","2024-02-09",0,0,367,0,9,413,0,0
"Africa","2024-02-10",0,0,367,0,10,423,0,0
"Africa","2024-02-11",0,65,432,0,9,432,0,0
"Africa","2024-02-12",0,0,432,0,11,443,0,0
"Africa","2024-02-13",0,0,432,0,11,454,0,0
"Africa","2024-02-14",0,0,432,0,11,465,0,0
"Africa","2024-02-15",0,0,432,0,10,475,0,0
"Africa","2024-02-16",0,0,432,0,11,486,0,0
"Africa","2024-02-17",0,0,432,0,11,497,0,0
"Africa","2024-02-18",0,76,508,0,11,508,0,0
"Africa","2024-02-19",0,0,508,0,7,515,0,0
"Africa","2024-02-20",0,0,508,0,6,521,0,0
"Africa","2024-02-21",0,0,508,0,7,528,0,0
"Africa","2024-02-22",0,0,508,0,6,534,0,0
"Africa","2024-02-23",0,0,508,0,7,541,0,0
"Africa","2024-02-24",0,0,508,0,6,547,0,0
"Africa","2024-02-25",0,46,554,0,7,554,0,0
"Africa","2024-02-26",0,0,554,0,12,566,0,0
"Africa","2024-02-27",0,0,554,0,11,577,0,0
"Africa","2024-02-28",0,0,554,0,12,589,0,0
"Africa","2024-02-29",0,0,554,0,11,600,0,0
"Africa","2024-03-01",0,0,554,0,12,612,0,0
"Africa","2024-03-02",0,0,554,0,11,623,0,0
"Africa","2024-03-03",0,81,635,0,12,635,0,0
"Africa","2024-03-04",0,0,635,0,10,645,0,0
"Africa","2024-03-05",0,0,635,0,10,655,0,0
"Africa","2024-03-06",0,0,635,0,10,665,0,0
"Africa","2024-03-07",0,0,635,0,9,674,0,0
"Africa","2024-03-08",0,0,635,0,10,684,0,0
"Africa","2024-03-09",0,0,635,0,10,694,0,0
"Africa","2024-03-10",0,69,704,0,10,704,0,0
"Africa","2024-03-11",0,0,704,0,0,704,0,0
"Africa","2024-03-12",0,0,704,0,0,704,0,0
"Africa","2024-03-13",0,0,704,0,1,705,0,0
"Africa","2024-03-14",0,0,704,0,0,705,0,0
"Africa","2024-03-15",0,1,705,0,0,705,0,0
"Africa","2024-03-16",0,0,705,0,37,742,0,0
"Africa","2024-03-17",0,74,779,0,37,779,0,0
"Africa","2024-03-18",0,0,779,0,10,789,0,0
"Africa","2024-03-19",0,0,779,0,10,799,0,0
"Africa","2024-03-20",0,0,779,0,10,809,0,0
"Africa","2024-03-21",0,0,779,0,9,818,0,0
"Africa","2024-03-22",0,0,779,0,10,828,0,0
"Africa","2024-03-23",0,0,779,0,10,838,0,0
"Africa","2024-03-24",0,69,848,0,10,848,0,0
"Africa","2024-03-25",0,0,848,0,10,858,0,0
"Africa","2024-03-26",0,0,848,0,10,868,0,0
"Africa","2024-03-27",0,0,848,0,10,878,0,0
"Africa","2024-03-28",0,0,848,0,9,887,0,0
"Africa","2024-03-29",0,0,848,0,10,897,0,0
"Africa","2024-03-30",0,0,848,0,10,907,0,0
"Africa","2024-03-31",0,69,917,0,10,917,0,0
"Africa","2024-04-01",0,0,917,0,13,930,0,0
"Africa","2024-04-02",0,0,917,0,12,942,0,0
"Africa","2024-04-03",0,0,917,0,13,955,0,0
"Africa","2024-04-04",0,0,917,0,12,967,0,0
"Africa","2024-04-05",0,0,917,0,13,980,0,0
"Africa","2024-04-06",0,0,917,0,12,992,0,0
"Africa","2024-04-07",0,88,1005,0,13,1005,0,0
"Africa","2024-04-08",0,0,1005,0,20,1025,0,0
"Africa","2024-04-09",0,0,1005,0,19,1044,0,0
"Africa","2024-04-10",0,0,1005,0,20,1064,0,0
"Africa","2024-04-11",0,0,1005,0,19,1083,0,0
"Africa","2024-04-12",0,0,1005,0,20,1103,0,0
"Africa","2024-04-13",0,0,1005,0,19,1122,0,0
"Africa","2024-04-14",0,137,1142,0,20,1142,0,0
"Africa","2024-04-15",0,0,1142,0,21,1163,0,0
"Africa","2024-04-16",0,0,1142,0,21,1184,0,0
"Africa","2024-04-17",0,0,1142,0,21,1205,0,0
"Africa","2024-04-18",0,0,1142,0,22,1227,0,0
"Africa","2024-04-19",0,0,1142,0,21,1248,0,0
"Africa","2024-04-20",0,0,1142,0,21,1269,0,0
"Africa","2024-04-21",0,148,1290,0,21,1290,0,0
"Africa","2024-04-22",0,0,1290,0,24,1314,0,0
"Africa","2024-04-23",0,0,1290,0,25,1339,0,0
"Africa","2024-04-24",0,0,1290,0,24,1363,0,0
"Africa","2024-04-25",0,0,1290,0,24,1387,0,0
"Africa","2024-04-26",0,0,1290,0,24,1411,0,0
"Africa","2024-04-27",0,0,1290,0,25,1436,0,0
"Africa","2024-04-28",0,170,1460,0,24,1460,0,0
"Africa","2024-04-29",0,0,1460,0,36,1496,0,0
"Africa","2024-04-30",0,0,1460,0,35,1531,0,0
"Africa","2024-05-01",0,0,1460,0,36,1567,0,0
"Africa","2024-05-02",0,0,1460,0,35,1602,0,0
"Africa","2024-05-03",0,0,1460,0,36,1638,0,0
"Africa","2024-05-04",0,0,1460,0,35,1673,0,0
"Africa","2024-05-05",0,249,1709,0,36,1709,0,0
"Africa","2024-05-06",0,0,1709,0,25,1734,0,0
"Africa","2024-05-07",0,0,1709,0,26,1760,0,0
"Africa","2024-05-08",0,0,1709,0,25,1785,0,0
"Africa","2024-05-09",0,0,1709,0,25,1810,0,0
"Africa","2024-05-10",0,0,1709,0,25,1835,0,0
"Africa","2024-05-11",0,0,1709,0,26,1861,0,0
"Africa","2024-05-12",0,177,1886,0,25,1886,0,0
"Africa","2024-05-13",0,0,1886,0,29,1915,0,0
"Africa","2024-05-14",0,0,1886,0,29,1944,0,0
"Africa","2024-05-15",0,0,1886,0,29,1973,0,0
"Africa","2024-05-16",0,0,1886,0,28,2001,0,0
"Africa","2024-05-17",0,0,1886,0,29,2030,0,0
"Africa","2024-05-18",0,0,1886,0,29,2059,0,0
"Africa","2024-05-19",0,202,2088,0,29,2088,0,0
"Africa","2024-05-20",0,0,2088,0,31,2119,0,0
"Africa","2024-05-21",0,0,2088,0,30,2149,0,0
"Africa","2024-05-22",0,0,2088,0,31,2180,0,0
"Africa","2024-05-23",0,0,2088,0,30,2210,0,0
"Africa","2024-05-24",0,0,2088,0,31,2241,0,0
"Africa","2024-05-25",0,0,2088,0,30,2271,0,0
"Africa","2024-05-26",0,214,2302,0,31,2302,0,0
"Africa","2024-05-27",0,0,2302,0,37,2339,0,0
"Africa","2024-05-28",0,0,2302,0,36,2375,0,0
"Africa","2024-05-29",0,0,2302,0,37,2412,0,0
"Africa","2024-05-30",0,0,2302,0,37,2449,0,0
"Africa","2024-05-31",0,0,2302,0,37,2486,0,0
"Africa","2024-06-01",0,0,2302,0,36,2522,0,0
"Africa","2024-06-02",0,257,2559,0,37,2559,0,0
"Africa","2024-06-03",0,0,2559,0,33,2592,0,0
"Africa","2024-06-04",0,0,2559,0,32,2624,0,0
"Africa","2024-06-05",0,0,2559,0,33,2657,0,0
"Africa","2024-06-06",0,0,2559,0,33,2690,0,0
"Africa","2024-06-07",0,0,2559,0,33,2723,0,0
"Africa","2024-06-08",0,0,2559,0,32,2755,0,0
"Africa","2024-06-09",0,229,2788,0,33,2788,0,0
"Africa","2024-06-10",0,0,2788,0,55,2843,0,0
"Africa","2024-06-11",0,0,2788,0,55,2898,0,0
"Africa","2024-06-12",0,0,2788,0,55,2953,0,0
"Africa","2024-06-13",0,0,2788,0,54,3007,0,0
"Africa","2024-06-14",0,0,2788,0,55,3062,0,0
"Africa","2024-06-15",0,0,2788,0,55,3117,0,0
"Africa","2024-06-16",0,384,3172,0,55,3172,0,0
"Africa","2024-06-17",0,0,3172,0,49,3221,0,0
"Africa","2024-06-18",0,0,3172,0,49,3270,0,0
"Africa","2024-06-19",0,0,3172,0,49,3319,0,0
"Africa","2024-06-20",0,0,3172,0,48,3367,0,0
"Africa","2024-06-21",0,0,3172,0,49,3416,0,0
"Africa","2024-06-22",0,0,3172,0,49,3465,0,0
"Africa","2024-06-23",0,342,3514,0,49,3514,0,0
"Africa","2024-06-24",0,0,3514,0,66,3580,0,0
"Africa","2024-06-25",0,0,3514,0,66,3646,0,0
"Africa","2024-06-26",0,0,3514,0,66,3712,0,0
"Africa","2024-06-27",0,0,3514,0,65,3777,0,0
"Africa","2024-06-28",0,0,3514,0,66,3843,0,0
"Africa","2024-06-29",0,0,3514,0,66,3909,0,0
"Africa","2024-06-30",0,461,3975,0,66,3975,0,0
"Africa","2024-07-01",0,0,3975,0,61,4036,0,0
"Africa","2024-07-02",0,0,3975,0,60,4096,0,0
"Africa","2024-07-03",0,0,3975,0,61,4157,0,0
"Africa","2024-07-04",0,0,3975,0,60,4217,0,0
"Africa","2024-07-05",0,0,3975,0,61,4278,0,0
"Africa","2024-07-06",0,0,3975,0,60,4338,0,0
"Africa","2024-07-07",0,424,4399,0,61,4399,0,0
"Africa","2024-07-08",0,0,4399,0,48,4447,0,0
"Africa","2024-07-09",0,0,4399,0,48,4495,0,0
"Africa","2024-07-10",0,0,4399,0,48,4543,0,0
"Africa","2024-07-11",0,0,4399,0,49,4592,0,0
"Africa","2024-07-12",0,0,4399,0,48,4640,0,0
"Africa","2024-07-13",0,0,4399,0,48,4688,0,0
"Africa","2024-07-14",0,337,4736,0,48,4736,0,0
"Africa","2024-07-15",0,0,4736,0,75,4811,0,0
"Africa","2024-07-16",0,0,4736,0,75,4886,0,0
"Africa","2024-07-17",0,0,4736,0,75,4961,0,0
"Africa","2024-07-18",0,0,4736,0,76,5037,0,0
"Africa","2024-07-19",0,0,4736,0,75,5112,0,0
"Africa","2024-07-20",0,0,4736,0,75,5187,0,0
"Africa","2024-07-21",0,526,5262,0,75,5262,0,0
"Africa","2024-07-22",0,0,5262,0,58,5320,0,0
"Africa","2024-07-23",0,0,5262,0,57,5377,0,0
"Africa","2024-07-24",0,0,5262,0,58,5435,0,0
"Africa","2024-07-25",0,0,5262,0,58,5493,0,0
"Africa","2024-07-26",0,0,5262,0,58,5551,0,0
"Africa","2024-07-27",0,0,5262,0,57,5608,0,0
"Africa","2024-07-28",0,404,5666,0,58,5666,0,0
"Africa","2024-07-29",0,0,5666,0,38,5704,0,0
"Africa","2024-07-30",0,0,5666,0,39,5743,0,0
"Africa","2024-07-31",0,0,5666,0,38,5781,0,0
"Africa","2024-08-01",0,0,5666,0,38,5819,0,0
"Africa","2024-08-02",0,0,5666,0,38,5857,0,0
"Africa","2024-08-03",0,0,5666,0,39,5896,0,0
"Africa","2024-08-04",0,268,5934,0,38,5934,0,0
"Africa","2024-08-05",0,0,5934,0,42,5976,0,0
"Africa","2024-08-06",0,0,5934,0,43,6019,0,0
"Africa","2024-08-07",0,0,5934,0,42,6061,0,0
"Africa","2024-08-08",0,0,5934,0,42,6103,0,0
"Africa","2024-08-09",0,0,5934,0,42,6145,0,0
"Africa","2024-08-10",0,0,5934,0,43,6188,0,0
"Africa","2024-08-11",0,296,6230,0,42,6230,0,0
"Africa","2024-08-12",0,0,6230,0,42,6272,0,0
"Africa","2024-08-13",0,0,6230,0,42,6314,0,0
"Africa","2024-08-14",0,0,6230,0,42,6356,0,0
"Africa","2024-08-15",0,0,6230,0,42,6398,0,0
"Africa","2024-08-16",0,0,6230,0,42,6440,0,0
"Africa","2024-08-17",0,0,6230,0,42,6482,0,0
"Africa","2024-08-18",0,294,6524,0,42,6524,0,0
"Africa","2024-08-19",0,0,6524,0,45,6569,0,0
"Africa","2024-08-20",0,0,6524,0,44,6613,0,0
"Africa","2024-08-21",0,0,6524,0,45,6658,0,0
"Africa","2024-08-22",0,0,6524,0,45,6703,0,0
"Africa","2024-08-23",0,0,6524,0,45,6748,0,0
"Africa","2024-08-24",0,0,6524,0,44,6792,0,0
"Africa","2024-08-25",0,313,6837,0,45,6837,0,0
"Africa","2024-08-26",0,0,6837,0,63,6900,0,0
"Africa","2024-08-27",0,0,6837,0,62,6962,0,0
"Africa","2024-08-28",0,0,6837,0,63,7025,0,0
"Africa","2024-08-29",0,0,6837,0,63,7088,0,0
"Africa","2024-08-30",0,0,6837,0,63,7151,0,0
"Africa","2024-08-31",0,0,6837,0,62,7213,0,0
"Africa","2024-09-01",0,439,7276,0,63,7276,0,0
"Africa","2024-09-02",0,0,7276,0,58,7334,0,0
"Africa","2024-09-03",0,0,7276,0,58,7392,0,0
"Africa","2024-09-04",0,0,7276,0,58,7450,0,0
"Africa","2024-09-05",0,0,7276,0,58,7508,0,0
"Africa","2024-09-06",0,0,7276,0,58,7566,0,0
"Africa","2024-09-07",0,0,7276,0,58,7624,0,0
"Africa","2024-09-08",0,406,7682,0,58,7682,0,0
"Africa","2024-09-09",0,0,7682,0,0,7682,0,0
"Africa","2024-09-10",0,0,7682,0,0,7682,0,0
"Africa","2024-09-11",0,0,7682,0,1,7683,0,0
"Africa","2024-09-12",0,1,7683,0,0,7683,0,0
"Africa","2024-09-13",0,0,7683,0,167,7850,0,0
"Africa","2024-09-14",0,0,7683,0,167,8017,0,0
"Africa","2024-09-15",0,501,8184,0,167,8184,0,0
"Africa","2024-09-16",0,0,8184,0,65,8249,0,0
"Africa","2024-09-17",0,0,8184,0,66,8315,0,0
"Africa","2024-09-18",0,0,8184,0,65,8380,0,0
"Africa","2024-09-19",0,0,8184,0,65,8445,0,0
"Africa","2024-09-20",0,0,8184,0,65,8510,0,0
"Africa","2024-09-21",0,0,8184,0,66,8576,0,0
"Africa","2024-09-22",0,457,8641,0,65,8641,0,0
"Africa","2024-09-23",0,0,8641,0,0,8641,0,0
"Africa","2024-09-24",0,0,8641,0,1,8642,0,0
"Africa","2024-09-25",0,0,8641,0,1,8643,0,0
"Africa","2024-09-26",0,0,8641,0,0,8643,0,0
"Africa","2024-09-27",0,0,8641,0,0,8643,0,0
"Africa","2024-09-28",0,3,8644,0,1,8644,0,0
"Africa","2024-09-29",0,371,9015,0,371,9015,0,0
"Africa","2024-09-30",0,0,9015,0,0,9015,0,0
"Africa","2024-10-01",0,0,9015,0,0,9015,0,0
"Africa","2024-10-02",0,0,9015,0,1,9016,0,0
"Africa","2024-10-03",0,1,9016,0,0,9016,0,0
"Africa","2024-10-04",0,0,9016,0,115,9131,0,0
"Africa","2024-10-05",0,0,9016,0,115,9246,0,0
"Africa","2024-10-06",0,345,9361,0,115,9361,0,0
"Africa","2024-10-07",0,0,9361,0,0,9361,0,0
"Africa","2024-10-08",0,0,9361,0,0,9361,0,0
"Africa","2024-10-09",0,0,9361,0,0,9361,0,0
"Africa","2024-10-10",0,0,9361,0,1,9362,0,0
"Africa","2024-10-11",0,0,9361,0,0,9362,0,0
"Africa","2024-10-12",0,1,9362,0,0,9362,0,0
"Africa","2024-10-13",0,495,9857,0,495,9857,0,0
"Africa","2024-10-14",0,0,9857,0,70,9927,0,0
"Africa","2024-10-15",0,0,9857,0,70,9997,0,0
"Africa","2024-10-16",0,0,9857,0,70,10067,0,0
"Africa","2024-10-17",0,0,9857,0,71,10138,0,0
"Africa","2024-10-18",0,0,9857,0,70,10208,0,0
"Africa","2024-10-19",0,0,9857,0,70,10278,0,0
"Africa","2024-10-20",0,491,10348,0,70,10348,0,0
"Africa","2024-10-21",0,0,10348,0,0,10348,0,0
"Africa","2024-10-22",0,0,10348,0,1,10349,0,0
"Africa","2024-10-23",0,0,10348,0,1,10350,0,0
"Africa","2024-10-24",0,0,10348,0,0,10350,0,0
"Africa","2024-10-25",0,0,10348,0,0,10350,0,0
"Africa","2024-10-26",0,3,10351,0,1,10351,0,0
"Africa","2024-10-27",0,598,10949,0,598,10949,0,0
"Africa","2024-10-28",0,0,10949,0,1,10950,0,0
"Africa","2024-10-29",0,0,10949,0,0,10950,0,0
"Africa","2024-10-30",0,2,10951,0,1,10951,0,0
"Africa","2024-10-31",0,0,10951,0,111,11062,0,0
"Africa","2024-11-01",0,0,10951,0,111,11173,0,0
"Africa","2024-11-02",0,0,10951,0,111,11284,0,0
"Africa","2024-11-03",0,444,11395,0,111,11395,0,0
"Africa","2024-11-04",0,0,11395,0,81,11476,0,0
"Africa","2024-11-05",0,0,11395,0,81,11557,0,0
"Africa","2024-11-06",0,0,11395,0,81,11638,0,0
"Africa","2024-11-07",0,0,11395,0,81,11719,0,0
"Africa","2024-11-08",0,0,11395,0,81,11800,0,0
"Africa","2024-11-09",0,0,11395,0,81,11881,0,0
"Africa","2024-11-10",0,567,11962,0,81,11962,0,0
"Africa","2024-11-11",0,0,11962,0,52,12014,0,0
"Africa","2024-11-12",0,0,11962,0,53,12067,0,0
"Africa","2024-11-13",0,0,11962,0,52,12119,0,0
"Africa","2024-11-14",0,0,11962,0,52,12171,0,0
"Africa","2024-11-15",0,0,11962,0,52,12223,0,0
"Africa","2024-11-16",0,0,11962,0,53,12276,0,0
"Africa","2024-11-17",0,366,12328,0,52,12328,0,0
"Africa","2024-11-18",0,0,12328,0,0,12328,0,0
"Africa","2024-11-19",0,0,12328,0,1,12329,0,0
"Africa","2024-11-20",0,1,12329,0,0,12329,0,0
"Africa","2024-11-21",0,0,12329,0,88,12417,0,0
"Africa","2024-11-22",0,0,12329,0,88,12505,0,0
"Africa","2024-11-23",0,0,12329,0,89,12594,0,0
"Africa","2024-11-24",0,353,12682,0,88,12682,0,0
"Africa","2024-11-25",0,0,12682,0,32,12714,0,0
"Africa","2024-11-26",0,0,12682,0,33,12747,0,0
"Africa","2024-11-27",0,97,12779,0,32,12779,0,0
"Africa","2024-11-28",0,0,12779,0,38,12817,0,0
"Africa","2024-11-29",0,0,12779,0,37,12854,0,0
"Africa","2024-11-30",0,113,12892,0,38,12892,0,0
"Africa","2024-12-01",0,79,12971,0,79,12971,0,0
"Africa","2024-12-02",0,0,12971,0,43,13014,0,0
"Africa","2024-12-03",0,0,12971,0,43,13057,0,0
"Africa","2024-12-04",0,0,12971,0,43,13100,0,0
"Africa","2024-12-05",0,0,12971,0,44,13144,0,0
"Africa","2024-12-06",0,0,12971,0,43,13187,0,0
"Africa","2024-12-07",0,0,12971,0,43,13230,0,0
"Africa","2024-12-08",0,302,13273,0,43,13273,0,0
"Africa","2024-12-09",0,0,13273,0,32,13305,0,0
"Africa","2024-12-10",0,0,13273,0,32,13337,0,0
"Africa","2024-12-11",0,0,13273,0,31,13368,0,0
"Africa","2024-12-12",0,127,13400,0,32,13400,0,0
"Africa","2024-12-13",0,102,13502,0,102,13502,0,0
"Africa","2024-12-14",0,0,13502,0,0,13502,0,0
"Africa","2024-12-15",0,1,13503,0,1,13503,0,0
"Africa","2024-12-16",0,0,13503,0,0,13503,0,0
"Africa","2024-12-17",0,0,13503,0,0,13503,0,0
"Africa","2024-12-18",0,0,13503,0,0,13503,0,0
"Africa","2024-12-19",0,0,13503,0,0,13503,0,0
"Africa","2024-12-20",0,0,13503,0,0,13503,0,0
"Africa","2024-12-21",0,0,13503,0,0,13503,0,0
"Africa","2024-12-22",0,0,13503,0,0,13503,0,0
"Africa","2024-12-23",0,0,13503,0,0,13503,0,0
"Africa","2024-12-24",0,0,13503,0,0,13503,0,0
"Africa","2024-12-25",0,0,13503,0,0,13503,0,0
"Africa","2024-12-26",0,0,13503,0,0,13503,0,0
"Africa","2024-12-27",0,0,13503,0,0,13503,0,0
"Africa","2024-12-28",0,0,13503,0,0,13503,0,0
"Africa","2024-12-29",0,0,13503,0,0,13503,0,0
"Africa","2024-12-30",0,0,13503,0,0,13503,0,0
"Africa","2024-12-31",0,0,13503,0,0,13503,0,0
"Africa","2025-01-01",0,0,13503,0,0,13503,0,0
"Africa","2025-01-02",0,0,13503,0,0,13503,0,0
"Africa","2025-01-03",0,0,13503,0,0,13503,0,0
"Africa","2025-01-04",0,0,13503,0,0,13503,0,0
"Africa","2025-01-05",0,0,13503,0,0,13503,0,0
"Africa","2025-01-06",0,0,13503,0,0,13503,0,0
"Africa","2025-01-07",0,0,13503,0,0,13503,0,0
"Africa","2025-01-08",0,0,13503,0,0,13503,0,0
"Africa","2025-01-09",0,0,13503,0,0,13503,0,0
"Africa","2025-01-10",0,0,13503,0,0,13503,0,0
"Africa","2025-01-11",0,0,13503,0,0,13503,0,0
"Africa","2025-01-12",0,0,13503,0,0,13503,0,0
"Africa","2025-01-13",0,0,13503,0,0,13503,0,0
"Andorra","2024-01-01",0,0,0,0,0,0,0,0
"Andorra","2024-01-02",0,0,0,0,0,0,0,0
"Andorra","2024-01-03",0,0,0,0,0,0,0,0
"Andorra","2024-01-04",0,0,0,0,0,0,0,0
"Andorra","2024-01-05",0,0,0,0,0,0,0,0
"Andorra","2024-01-06",0,0,0,0,0,0,0,0
"Andorra","2024-01-07",0,0,0,0,0,0,0,0
"Andorra","2024-01-08",0,0,0,0,0,0,0,0
"Andorra","2024-01-09",0,0,0,0,0,0,0,0
"Andorra","2024-01-10",0,0,0,0,0,0,0,0
"Andorra","2024-01-11",0,0,0,0,0,0,0,0
"Andorra","2024-01-12",0,0,0,0,0,0,0,0
"Andorra","2024-01-13",0,0,0,0,0,0,0,0
"Andorra","2024-01-14",0,0,0,0,0,0,0,0
"Andorra","2024-01-15",0,0,0,0,0,0,0,0
"Andorra","2024-01-16",0,0,0,0,0,0,0,0
"Andorra","2024-01-17",0,0,0,0,0,0,0,0
"Andorra","2024-01-18",0,0,0,0,0,0,0,0
"Andorra","2024-01-19",0,0,0,0,0,0,0,0
"Andorra","2024-01-20",0,0,0,0,0,0,0,0
"Andorra","2024-01-21",0,0,0,0,0,0,0,0
"Andorra","2024-01-22",0,0,0,0,0,0,0,0
"Andorra","2024-01-23",0,0,0,0,0,0,0,0
"Andorra","2024-01-24",0,0,0,0,0,0,0,0
"Andorra","2024-01-25",0,0,0,0,0,0,0,0
"Andorra","2024-01-26",0,0,0,0,0,0,0,0
"Andorra","2024-01-27",0,0,0,0,0,0,0,0
"Andorra","2024-01-28",0,0,0,0,0,0,0,0
"Andorra","2024-01-29",0,0,0,0,0,0,0,0
"Andorra","2024-01-30",0,0,0,0,0,0,0,0
"Andorra","2024-01-31",0,0,0,0,0,0,0,0
"Andorra","2024-02-01",0,0,0,0,0,0,0,0
"Andorra","2024-02-02",0,0,0,0,0,0,0,0
"Andorra","2024-02-03",0,0,0,0,0,0,0,0
"Andorra","2024-02-04",0,0,0,0,0,0,0,0
"Andorra","2024-02-05",0,0,0,0,0,0,0,0
"Andorra","2024-02-06",0,0,0,0,0,0,0,0
"Andorra","2024-02-07",0,0,0,0,0,0,0,0
"Andorra","2024-02-08",0,0,0,0,0,0,0,0
"Andorra","2024-02-09",0,0,0,0,0,0,0,0
"Andorra","2024-02-10",0,0,0,0,0,0,0,0
"Andorra","2024-02-11",0,0,0,0,0,0,0,0
"Andorra","2024-02-12",0,0,0,0,0,0,0,0
"Andorra","2024-02-13",0,0,0,0,0,0,0,0
"Andorra","2024-02-14",0,0,0,0,0,0,0,0
"Andorra","2024-02-15",0,0,0,0,0,0,0,0
"Andorra","2024-02-16",0,0,0,0,0,0,0,0
"Andorra","2024-02-17",0,0,0,0,0,0,0,0
"Andorra","2024-02-18",0,0,0,0,0,0,0,0
"Andorra","2024-02-19",0,0,0,0,0,0,0,0
"Andorra","2024-02-20",0,0,0,0,0,0,0,0
"Andorra","2024-02-21",0,0,0,0,0,0,0,0
"Andorra","2024-02-22",0,0,0,0,0,0,0,0
"Andorra","2024-02-23",0,0,0,0,0,0,0,0
"Andorra","2024-02-24",0,0,0,0,0,0,0,0
"Andorra","2024-02-25",0,0,0,0,0,0,0,0
"Andorra","2024-02-26",0,0,0,0,0,0,0,0
"Andorra","2024-02-27",0,0,0,0,0,0,0,0
"Andorra","2024-02-28",0,0,0,0,0,0,0,0
"Andorra","2024-02-29",0,0,0,0,0,0,0,0
"Andorra","2024-03-01",0,0,0,0,0,0,0,0
"Andorra","2024-03-02",0,0,0,0,0,0,0,0
"Andorra","2024-03-03",0,0,0,0,0,0,0,0
"Andorra","2024-03-04",0,0,0,0,0,0,0,0
"Andorra","2024-03-05",0,0,0,0,0,0,0,0
"Andorra","2024-03-06",0,0,0,0,0,0,0,0
"Andorra","2024-03-07",0,0,0,0,0,0,0,0
"Andorra","2024-03-08",0,0,0,0,0,0,0,0
"Andorra","2024-03-09",0,0,0,0,0,0,0,0
"Andorra","2024-03-10",0,0,0,0,0,0,0,0
"Andorra","2024-03-11",0,0,0,0,0,0,0,0
"Andorra","2024-03-12",0,0,0,0,0,0,0,0
"Andorra","2024-03-13",0,0,0,0,0,0,0,0
"Andorra","2024-03-14",0,0,0,0,0,0,0,0
"Andorra","2024-03-15",0,0,0,0,0,0,0,0
"Andorra","2024-03-16",0,0,0,0,0,0,0,0
"Andorra","2024-03-17",0,0,0,0,0,0,0,0
"Andorra","2024-03-18",0,0,0,0,0,0,0,0
"Andorra","2024-03-19",0,0,0,0,0,0,0,0
"Andorra","2024-03-20",0,0,0,0,0,0,0,0
"Andorra","2024-03-21",0,0,0,0,0,0,0,0
"Andorra","2024-03-22",0,0,0,0,0,0,0,0
"Andorra","2024-03-23",0,0,0,0,0,0,0,0
"Andorra","2024-03-24",0,0,0,0,0,0,0,0
"Andorra","2024-03-25",0,0,0,0,0,0,0,0
"Andorra","2024-03-26",0,0,0,0,0,0,0,0
"Andorra","2024-03-27",0,0,0,0,0,0,0,0
"Andorra","2024-03-28",0,0,0,0,0,0,0,0
"Andorra","2024-03-29",0,0,0,0,0,0,0,0
"Andorra","2024-03-30",0,0,0,0,0,0,0,0
"Andorra","2024-03-31",0,0,0,0,0,0,0,0
"Andorra","2024-04-01",0,0,0,0,0,0,0,0
"Andorra","2024-04-02",0,0,0,0,0,0,0,0
"Andorra","2024-04-03",0,0,0,0,0,0,0,0
"Andorra","2024-04-04",0,0,0,0,0,0,0,0
"Andorra","2024-04-05",0,0,0,0,0,0,0,0
"Andorra","2024-04-06",0,0,0,0,0,0,0,0
"Andorra","2024-04-07",0,0,0,0,0,0,0,0
"Andorra","2024-04-08",0,0,0,0,0,0,0,0
"Andorra","2024-04-09",0,0,0,0,0,0,0,0
"Andorra","2024-04-10",0,0,0,0,0,0,0,0
"Andorra","2024-04-11",0,0,0,0,0,0,0,0
"Andorra","2024-04-12",0,0,0,0,0,0,0,0
"Andorra","2024-04-13",0,0,0,0,0,0,0,0
"Andorra","2024-04-14",0,0,0,0,0,0,0,0
"Andorra","2024-04-15",0,0,0,0,0,0,0,0
"Andorra","2024-04-16",0,0,0,0,0,0,0,0
"Andorra","2024-04-17",0,0,0,0,0,0,0,0
"Andorra","2024-04-18",0,0,0,0,0,0,0,0
"Andorra","2024-04-19",0,0,0,0,0,0,0,0
"Andorra","2024-04-20",0,0,0,0,0,0,0,0
"Andorra","2024-04-21",0,0,0,0,0,0,0,0
"Andorra","2024-04-22",0,0,0,0,0,0,0,0
"Andorra","2024-04-23",0,0,0,0,0,0,0,0
"Andorra","2024-04-24",0,0,0,0,0,0,0,0
"Andorra","2024-04-25",0,0,0,0,0,0,0,0
"Andorra","2024-04-26",0,0,0,0,0,0,0,0
"Andorra","2024-04-27",0,0,0,0,0,0,0,0
"Andorra","2024-04-28",0,0,0,0,0,0,0,0
"Andorra","2024-04-29",0,0,0,0,0,0,0,0
"Andorra","2024-04-30",0,0,0,0,0,0,0,0
"Andorra","2024-05-01",0,0,0,0,0,0,0,0
"Andorra","2024-05-02",0,0,0,0,0,0,0,0
"Andorra","2024-05-03",0,0,0,0,0,0,0,0
"Andorra","2024-05-04",0,0,0,0,0,0,0,0
"Andorra","2024-05-05",0,0,0,0,0,0,0,0
"Andorra","2024-05-06",0,0,0,0,0,0,0,0
"Andorra","2024-05-07",0,0,0,0,0,0,0,0
"Andorra","2024-05-08",0,0,0,0,0,0,0,0
"Andorra","2024-05-09",0,0,0,0,0,0,0,0
"Andorra","2024-05-10",0,0,0,0,0,0,0,0
"Andorra","2024-05-11",0,0,0,0,0,0,0,0
"Andorra","2024-05-12",0,0,0,0,0,0,0,0
"Andorra","2024-05-13",0,0,0,0,0,0,0,0
"Andorra","2024-05-14",0,0,0,0,0,0,0,0
"Andorra","2024-05-15",0,0,0,0,0,0,0,0
"Andorra","2024-05-16",0,0,0,0,0,0,0,0
"Andorra","2024-05-17",0,0,0,0,0,0,0,0
"Andorra","2024-05-18",0,0,0,0,0,0,0,0
"Andorra","2024-05-19",0,0,0,0,0,0,0,0
"Andorra","2024-05-20",0,0,0,0,0,0,0,0
"Andorra","2024-05-21",0,0,0,0,0,0,0,0
"Andorra","2024-05-22",0,0,0,0,0,0,0,0
"Andorra","2024-05-23",0,0,0,0,0,0,0,0
"Andorra","2024-05-24",0,0,0,0,0,0,0,0
"Andorra","2024-05-25",0,0,0,0,0,0,0,0
"Andorra","2024-05-26",0,0,0,0,0,0,0,0
"Andorra","2024-05-27",0,0,0,0,0,0,0,0
"Andorra","2024-05-28",0,0,0,0,0,0,0,0
"Andorra","2024-05-29",0,0,0,0,0,0,0,0
"Andorra","2024-05-30",0,0,0,0,0,0,0,0
"Andorra","2024-05-31",0,0,0,0,0,0,0,0
"Andorra","2024-06-01",0,0,0,0,0,0,0,0
"Andorra","2024-06-02",0,0,0,0,0,0,0,0
"Andorra","2024-06-03",0,0,0,0,0,0,0,0
"Andorra","2024-06-04",0,0,0,0,0,0,0,0
"Andorra","2024-06-05",0,0,0,0,0,0,0,0
"Andorra","2024-06-06",0,0,0,0,0,0,0,0
"Andorra","2024-06-07",0,0,0,0,0,0,0,0
"Andorra","2024-06-08",0,0,0,0,0,0,0,0
"Andorra","2024-06-09",0,0,0,0,0,0,0,0
"Andorra","2024-06-10",0,0,0,0,0,0,0,0
"Andorra","2024-06-11",0,0,0,0,0,0,0,0
"Andorra","2024-06-12",0,0,0,0,0,0,0,0
"Andorra","2024-06-13",0,0,0,0,0,0,0,0
"Andorra","2024-06-14",0,0,0,0,0,0,0,0
"Andorra","2024-06-15",0,0,0,0,0,0,0,0
"Andorra","2024-06-16",0,0,0,0,0,0,0,0
"Andorra","2024-06-17",0,0,0,0,0,0,0,0
"Andorra","2024-06-18",0,0,0,0,0,0,0,0
"Andorra","2024-06-19",0,0,0,0,0,0,0,0
"Andorra","2024-06-20",0,0,0,0,0,0,0,0
"Andorra","2024-06-21",0,0,0,0,0,0,0,0
"Andorra","2024-06-22",0,0,0,0,0,0,0,0
"Andorra","2024-06-23",0,0,0,0,0,0,0,0
"Andorra","2024-06-24",0,0,0,0,0,0,0,0
"Andorra","2024-06-25",0,0,0,0,0,0,0,0
"Andorra","2024-06-26",0,0,0,0,0,0,0,0
"Andorra","2024-06-27",0,0,0,0,0,0,0,0
"Andorra","2024-06-28",0,0,0,0,0,0,0,0
"Andorra","2024-06-29",0,0,0,0,0,0,0,0
"Andorra","2024-06-30",0,0,0,0,0,0,0,0
"Andorra","2024-07-01",0,0,0,0,0,0,0,0
"Andorra","2024-07-02",0,0,0,0,0,0,0,0
"Andorra","2024-07-03",0,0,0,0,0,0,0,0
"Andorra","2024-07-04",0,0,0,0,0,0,0,0
"Andorra","2024-07-05",0,0,0,0,0,0,0,0
"Andorra","2024-07-06",0,0,0,0,0,0,0,0
"Andorra","2024-07-07",0,0,0,0,0,0,0,0
"Andorra","2024-07-08",0,0,0,0,0,0,0,0
"Andorra","2024-07-09",0,0,0,0,0,0,0,0
"Andorra","2024-07-10",0,0,0,0,0,0,0,0
"Andorra","2024-07-11",0,0,0,0,0,0,0,0
"Andorra","2024-07-12",0,0,0,0,0,0,0,0
"Andorra","2024-07-13",0,0,0,0,0,0,0,0
"Andorra","2024-07-14",0,0,0,0,0,0,0,0
"Andorra","2024-07-15",0,0,0,0,0,0,0,0
"Andorra","2024-07-16",0,0,0,0,0,0,0,0
"Andorra","2024-07-17",0,0,0,0,0,0,0,0
"Andorra","2024-07-18",0,0,0,0,0,0,0,0
"Andorra","2024-07-19",0,0,0,0,0,0,0,0
"Andorra","2024-07-20",0,0,0,0,0,0,0,0
"Andorra","2024-07-21",0,0,0,0,0,0,0,0
"Andorra","2024-07-22",0,0,0,0,0,0,0,0
"Andorra","2024-07-23",0,0,0,0,0,0,0,0
"Andorra","2024-07-24",0,0,0,0,0,0,0,0
"Andorra","2024-07-25",0,0,0,0,0,0,0,0
"Andorra","2024-07-26",0,0,0,0,0,0,0,0
"Andorra","2024-07-27",0,0,0,0,0,0,0,0
"Andorra","2024-07-28",0,0,0,0,0,0,0,0
"Andorra","2024-07-29",0,0,0,0,0,0,0,0
"Andorra","2024-07-30",0,0,0,0,0,0,0,0
"Andorra","2024-07-31",0,0,0,0,0,0,0,0
"Andorra","2024-08-01",0,0,0,0,0,0,0,0
"Andorra","2024-08-02",0,0,0,0,0,0,0,0
"Andorra","2024-08-03",0,0,0,0,0,0,0,0
"Andorra","2024-08-04",0,0,0,0,0,0,0,0
"Andorra","2024-08-05",0,0,0,0,0,0,0,0
"Andorra","2024-08-06",0,0,0,0,0,0,0,0
"Andorra","2024-08-07",0,0,0,0,0,0,0,0
"Andorra","2024-08-08",0,0,0,0,0,0,0,0
"Andorra","2024-08-09",0,0,0,0,0,0,0,0
"Andorra","2024-08-10",0,0,0,0,0,0,0,0
"Andorra","2024-08-11",0,0,0,0,0,0,0,0
"Andorra","2024-08-12",0,0,0,0,0,0,0,0
"Andorra","2024-08-13",0,0,0,0,0,0,0,0
"Andorra","2024-08-14",0,0,0,0,0,0,0,0
"Andorra","2024-08-15",0,0,0,0,0,0,0,0
"Andorra","2024-08-16",0,0,0,0,0,0,0,0
"Andorra","2024-08-17",0,0,0,0,0,0,0,0
"Andorra","2024-08-18",0,0,0,0,0,0,0,0
"Andorra","2024-08-19",0,0,0,0,0,0,0,0
"Andorra","2024-08-20",0,0,0,0,0,0,0,0
"Andorra","2024-08-21",0,0,0,0,0,0,0,0
"Andorra","2024-08-22",0,0,0,0,0,0,0,0
"Andorra","2024-08-23",0,0,0,0,0,0,0,0
"Andorra","2024-08-24",0,0,0,0,0,0,0,0
"Andorra","2024-08-25",0,0,0,0,0,0,0,0
"Andorra","2024-08-26",0,0,0,0,0,0,0,0
"Andorra","2024-08-27",0,0,0,0,0,0,0,0
"Andorra","2024-08-28",0,0,0,0,0,0,0,0
"Andorra","2024-08-29",0,0,0,0,0,0,0,0
"Andorra","2024-08-30",0,0,0,0,0,0,0,0
"Andorra","2024-08-31",0,0,0,0,0,0,0,0
"Andorra","2024-09-01",0,0,0,0,0,0,0,0
"Andorra","2024-09-02",0,0,0,0,0,0,0,0
"Andorra","2024-09-03",0,0,0,0,0,0,0,0
"Andorra","2024-09-04",0,0,0,0,0,0,0,0
"Andorra","2024-09-05",0,0,0,0,0,0,0,0
"Andorra","2024-09-06",0,0,0,0,0,0,0,0
"Andorra","2024-09-07",0,0,0,0,0,0,0,0
"Andorra","2024-09-08",0,0,0,0,0,0,0,0
"Andorra","2024-09-09",0,0,0,0,0,0,0,0
"Andorra","2024-09-10",0,0,0,0,0,0,0,0
"Andorra","2024-09-11",0,0,0,0,0,0,0,0
"Andorra","2024-09-12",0,0,0,0,0,0,0,0
"Andorra","2024-09-13",0,0,0,0,0,0,0,0
"Andorra","2024-09-14",0,0,0,0,0,0,0,0
"Andorra","2024-09-15",0,0,0,0,0,0,0,0
"Andorra","2024-09-16",0,0,0,0,0,0,0,0
"Andorra","2024-09-17",0,0,0,0,0,0,0,0
"Andorra","2024-09-18",0,0,0,0,0,0,0,0
"Andorra","2024-09-19",0,0,0,0,0,0,0,0
"Andorra","2024-09-20",0,0,0,0,0,0,0,0
"Andorra","2024-09-21",0,0,0,0,0,0,0,0
"Andorra","2024-09-22",0,0,0,0,0,0,0,0
"Andorra","2024-09-23",0,0,0,0,0,0,0,0
"Andorra","2024-09-24",0,0,0,0,0,0,0,0
"Andorra","2024-09-25",0,0,0,0,0,0,0,0
"Andorra","2024-09-26",0,0,0,0,0,0,0,0
"Andorra","2024-09-27",0,0,0,0,0,0,0,0
"Andorra","2024-09-28",0,0,0,0,0,0,0,0
"Andorra","2024-09-29",0,0,0,0,0,0,0,0
"Andorra","2024-09-30",0,0,0,0,0,0,0,0
"Andorra","2024-10-01",0,0,0,0,0,0,0,0
"Andorra","2024-10-02",0,0,0,0,0,0,0,0
"Andorra","2024-10-03",0,0,0,0,0,0,0,0
"Andorra","2024-10-04",0,0,0,0,0,0,0,0
"Andorra","2024-10-05",0,0,0,0,0,0,0,0
"Andorra","2024-10-06",0,0,0,0,0,0,0,0
"Andorra","2024-10-07",0,0,0,0,0,0,0,0
"Andorra","2024-10-08",0,0,0,0,0,0,0,0
"Andorra","2024-10-09",0,0,0,0,0,0,0,0
"Andorra","2024-10-10",0,0,0,0,0,0,0,0
"Andorra","2024-10-11",0,0,0,0,0,0,0,0
"Andorra","2024-10-12",0,0,0,0,0,0,0,0
"Andorra","2024-10-13",0,0,0,0,0,0,0,0
"Andorra","2024-10-14",0,0,0,0,0,0,0,0
"Andorra","2024-10-15",0,0,0,0,0,0,0,0
"Andorra","2024-10-16",0,0,0,0,0,0,0,0
"Andorra","2024-10-17",0,0,0,0,0,0,0,0
"Andorra","2024-10-18",0,0,0,0,0,0,0,0
"Andorra","2024-10-19",0,0,0,0,0,0,0,0
"Andorra","2024-10-20",0,0,0,0,0,0,0,0
"Andorra","2024-10-21",0,0,0,0,0,0,0,0
"Andorra","2024-10-22",0,0,0,0,0,0,0,0
"Andorra","2024-10-23",0,0,0,0,0,0,0,0
"Andorra","2024-10-24",0,0,0,0,0,0,0,0
"Andorra","2024-10-25",0,0,0,0,0,0,0,0
"Andorra","2024-10-26",0,0,0,0,0,0,0,0
"Andorra","2024-10-27",0,0,0,0,0,0,0,0
"Andorra","2024-10-28",0,0,0,0,0,0,0,0
"Andorra","2024-10-29",0,0,0,0,0,0,0,0
"Andorra","2024-10-30",0,0,0,0,0,0,0,0
"Andorra","2024-10-31",0,0,0,0,0,0,0,0
"Andorra","2024-11-01",0,0,0,0,0,0,0,0
"Andorra","2024-11-02",0,0,0,0,0,0,0,0
"Andorra","2024-11-03",0,0,0,0,0,0,0,0
"Andorra","2024-11-04",0,0,0,0,0,0,0,0
"Andorra","2024-11-05",0,0,0,0,0,0,0,0
"Andorra","2024-11-06",0,0,0,0,0,0,0,0
"Andorra","2024-11-07",0,0,0,0,0,0,0,0
"Andorra","2024-11-08",0,0,0,0,0,0,0,0
"Andorra","2024-11-09",0,0,0,0,0,0,0,0
"Andorra","2024-11-10",0,0,0,0,0,0,0,0
"Andorra","2024-11-11",0,0,0,0,0,0,0,0
"Andorra","2024-11-12",0,0,0,0,0,0,0,0
"Andorra","2024-11-13",0,0,0,0,0,0,0,0
"Andorra","2024-11-14",0,0,0,0,0,0,0,0
"Andorra","2024-11-15",0,0,0,0,0,0,0,0
"Andorra","2024-11-16",0,0,0,0,0,0,0,0
"Andorra","2024-11-17",0,0,0,0,0,0,0,0
"Andorra","2024-11-18",0,0,0,0,0,0,0,0
"Andorra","2024-11-19",0,0,0,0,0,0,0,0
"Andorra","2024-11-20",0,0,0,0,0,0,0,0
"Andorra","2024-11-21",0,0,0,0,0,0,0,0
"Andorra","2024-11-22",0,0,0,0,0,0,0,0
"Andorra","2024-11-23",0,0,0,0,0,0,0,0
"Andorra","2024-11-24",0,0,0,0,0,0,0,0
"Andorra","2024-11-25",0,0,0,0,0,0,0,0
"Andorra","2024-11-26",0,0,0,0,0,0,0,0
"Andorra","2024-11-27",0,0,0,0,0,0,0,0
"Andorra","2024-11-28",0,0,0,0,0,0,0,0
"Andorra","2024-11-29",0,0,0,0,0,0,0,0
"Andorra","2024-11-30",0,0,0,0,0,0,0,0
"Andorra","2024-12-01",0,0,0,0,0,0,0,0
"Andorra","2024-12-02",0,0,0,0,0,0,0,0
"Andorra","2024-12-03",0,0,0,0,0,0,0,0
"Andorra","2024-12-04",0,0,0,0,0,0,0,0
"Andorra","2024-12-05",0,0,0,0,0,0,0,0
"Andorra","2024-12-06",0,0,0,0,0,0,0,0
"Andorra","2024-12-07",0,0,0,0,0,0,0,0
"Andorra","2024-12-08",0,0,0,0,0,0,0,0
"Andorra","2024-12-09",0,0,0,0,0,0,0,0
"Andorra","2024-12-10",0,0,0,0,0,0,0,0
"Andorra","2024-12-11",0,0,0,0,0,0,0,0
"Andorra","2024-12-12",0,0,0,0,0,0,0,0
"Andorra","2024-12-13",0,0,0,0,0,0,0,0
"Andorra","2024-12-14",0,0,0,0,0,0,0,0
"Andorra","2024-12-15",0,0,0,0,0,0,0,0
"Andorra","2024-12-16",0,0,0,0,0,0,0,0
"Andorra","2024-12-17",0,0,0,0,0,0,0,0
"Andorra","2024-12-18",0,0,0,0,0,0,0,0
"Andorra","2024-12-19",0,0,0,0,0,0,0,0
"Andorra","2024-12-20",0,0,0,0,0,0,0,0
"Andorra","2024-12-21",0,0,0,0,0,0,0,0
"Andorra","2024-12-22",0,0,0,0,0,0,0,0
"Andorra","2024-12-23",0,0,0,0,0,0,0,0
"Andorra","2024-12-24",0,0,0,0,0,0,0,0
"Andorra","2024-12-25",0,0,0,0,0,0,0,0
"Andorra","2024-12-26",0,0,0,0,0,0,0,0
"Andorra","2024-12-27",0,0,0,0,0,0,0,0
"Andorra","2024-12-28",0,0,0,0,0,0,0,0
"Andorra","2024-12-29",0,0,0,0,0,0,0,0
"Andorra","2024-12-30",0,0,0,0,0,0,0,0
"Andorra","2024-12-31",0,0,0,0,0,0,0,0
"Andorra","2025-01-01",0,0,0,0,0,0,0,0
"Andorra","2025-01-02",0,0,0,0,0,0,0,0
"Andorra","2025-01-03",0,0,0,0,0,0,0,0
"Andorra","2025-01-04",0,0,0,0,0,0,0,0
"Andorra","2025-01-05",0,0,0,0,0,0,0,0
"Andorra","2025-01-06",0,0,0,0,0,0,0,0
"Andorra","2025-01-07",0,0,0,0,0,0,0,0
"Andorra","2025-01-08",0,0,0,0,0,0,0,0
"Andorra","2025-01-09",0,0,0,0,0,0,0,0
"Andorra","2025-01-10",0,0,0,0,0,0,0,0
"Andorra","2025-01-11",0,0,0,0,0,0,0,0
"Andorra","2025-01-12",0,0,0,0,0,0,0,0
"Andorra","2025-01-13",0,0,0,0,0,0,0,0
"Angola","2024-01-01",0,0,0,0,0,0,0,0
"Angola","2024-01-02",0,0,0,0,0,0,0,0
"Angola","2024-01-03",0,0,0,0,0,0,0,0
"Angola","2024-01-04",0,0,0,0,0,0,0,0
"Angola","2024-01-05",0,0,0,0,0,0,0,0
"Angola","2024-01-06",0,0,0,0,0,0,0,0
"Angola","2024-01-07",0,0,0,0,0,0,0,0
"Angola","2024-01-08",0,0,0,0,0,0,0,0
"Angola","2024-01-09",0,0,0,0,0,0,0,0
"Angola","2024-01-10",0,0,0,0,0,0,0,0
"Angola","2024-01-11",0,0,0,0,0,0,0,0
"Angola","2024-01-12",0,0,0,0,0,0,0,0
"Angola","2024-01-13",0,0,0,0,0,0,0,0
"Angola","2024-01-14",0,0,0,0,0,0,0,0
"Angola","2024-01-15",0,0,0,0,0,0,0,0
"Angola","2024-01-16",0,0,0,0,0,0,0,0
"Angola","2024-01-17",0,0,0,0,0,0,0,0
"Angola","2024-01-18",0,0,0,0,0,0,0,0
"Angola","2024-01-19",0,0,0,0,0,0,0,0
"Angola","2024-01-20",0,0,0,0,0,0,0,0
"Angola","2024-01-21",0,0,0,0,0,0,0,0
"Angola","2024-01-22",0,0,0,0,0,0,0,0
"Angola","2024-01-23",0,0,0,0,0,0,0,0
"Angola","2024-01-24",0,0,0,0,0,0,0,0
"Angola","2024-01-25",0,0,0,0,0,0,0,0
"Angola","2024-01-26",0,0,0,0,0,0,0,0
"Angola","2024-01-27",0,0,0,0,0,0,0,0
"Angola","2024-01-28",0,0,0,0,0,0,0,0
"Angola","2024-01-29",0,0,0,0,0,0,0,0
"Angola","2024-01-30",0,0,0,0,0,0,0,0
"Angola","2024-01-31",0,0,0,0,0,0,0,0
"Angola","2024-02-01",0,0,0,0,0,0,0,0
"Angola","2024-02-02",0,0,0,0,0,0,0,0
"Angola","2024-02-03",0,0,0,0,0,0,0,0
"Angola","2024-02-04",0,0,0,0,0,0,0,0
"Angola","2024-02-05",0,0,0,0,0,0,0,0
"Angola","2024-02-06",0,0,0,0,0,0,0,0
"Angola","2024-02-07",0,0,0,0,0,0,0,0
"Angola","2024-02-08",0,0,0,0,0,0,0,0
"Angola","2024-02-09",0,0,0,0,0,0,0,0
"Angola","2024-02-10",0,0,0,0,0,0,0,0
"Angola","2024-02-11",0,0,0,0,0,0,0,0
"Angola","2024-02-12",0,0,0,0,0,0,0,0
"Angola","2024-02-13",0,0,0,0,0,0,0,0
"Angola","2024-02-14",0,0,0,0,0,0,0,0
"Angola","2024-02-15",0,0,0,0,0,0,0,0
"Angola","2024-02-16",0,0,0,0,0,0,0,0
"Angola","2024-02-17",0,0,0,0,0,0,0,0
"Angola","2024-02-18",0,0,0,0,0,0,0,0
"Angola","2024-02-19",0,0,0,0,0,0,0,0
"Angola","2024-02-20",0,0,0,0,0,0,0,0
"Angola","2024-02-21",0,0,0,0,0,0,0,0
"Angola","2024-02-22",0,0,0,0,0,0,0,0
"Angola","2024-02-23",0,0,0,0,0,0,0,0
"Angola","2024-02-24",0,0,0,0,0,0,0,0
"Angola","2024-02-25",0,0,0,0,0,0,0,0
"Angola","2024-02-26",0,0,0,0,0,0,0,0
"Angola","2024-02-27",0,0,0,0,0,0,0,0
"Angola","2024-02-28",0,0,0,0,0,0,0,0
"Angola","2024-02-29",0,0,0,0,0,0,0,0
"Angola","2024-03-01",0,0,0,0,0,0,0,0
"Angola","2024-03-02",0,0,0,0,0,0,0,0
"Angola","2024-03-03",0,0,0,0,0,0,0,0
"Angola","2024-03-04",0,0,0,0,0,0,0,0
"Angola","2024-03-05",0,0,0,0,0,0,0,0
"Angola","2024-03-06",0,0,0,0,0,0,0,0
"Angola","2024-03-07",0,0,0,0,0,0,0,0
"Angola","2024-03-08",0,0,0,0,0,0,0,0
"Angola","2024-03-09",0,0,0,0,0,0,0,0
"Angola","2024-03-10",0,0,0,0,0,0,0,0
"Angola","2024-03-11",0,0,0,0,0,0,0,0
"Angola","2024-03-12",0,0,0,0,0,0,0,0
"Angola","2024-03-13",0,0,0,0,0,0,0,0
"Angola","2024-03-14",0,0,0,0,0,0,0,0
"Angola","2024-03-15",0,0,0,0,0,0,0,0
"Angola","2024-03-16",0,0,0,0,0,0,0,0
"Angola","2024-03-17",0,0,0,0,0,0,0,0
"Angola","2024-03-18",0,0,0,0,0,0,0,0
"Angola","2024-03-19",0,0,0,0,0,0,0,0
"Angola","2024-03-20",0,0,0,0,0,0,0,0
"Angola","2024-03-21",0,0,0,0,0,0,0,0
"Angola","2024-03-22",0,0,0,0,0,0,0,0
"Angola","2024-03-23",0,0,0,0,0,0,0,0
"Angola","2024-03-24",0,0,0,0,0,0,0,0
"Angola","2024-03-25",0,0,0,0,0,0,0,0
"Angola","2024-03-26",0,0,0,0,0,0,0,0
"Angola","2024-03-27",0,0,0,0,0,0,0,0
"Angola","2024-03-28",0,0,0,0,0,0,0,0
"Angola","2024-03-29",0,0,0,0,0,0,0,0
"Angola","2024-03-30",0,0,0,0,0,0,0,0
"Angola","2024-03-31",0,0,0,0,0,0,0,0
"Angola","2024-04-01",0,0,0,0,0,0,0,0
"Angola","2024-04-02",0,0,0,0,0,0,0,0
"Angola","2024-04-03",0,0,0,0,0,0,0,0
"Angola","2024-04-04",0,0,0,0,0,0,0,0
"Angola","2024-04-05",0,0,0,0,0,0,0,0
"Angola","2024-04-06",0,0,0,0,0,0,0,0
"Angola","2024-04-07",0,0,0,0,0,0,0,0
"Angola","2024-04-08",0,0,0,0,0,0,0,0
"Angola","2024-04-09",0,0,0,0,0,0,0,0
"Angola","2024-04-10",0,0,0,0,0,0,0,0
"Angola","2024-04-11",0,0,0,0,0,0,0,0
"Angola","2024-04-12",0,0,0,0,0,0,0,0
"Angola","2024-04-13",0,0,0,0,0,0,0,0
"Angola","2024-04-14",0,0,0,0,0,0,0,0
"Angola","2024-04-15",0,0,0,0,0,0,0,0
"Angola","2024-04-16",0,0,0,0,0,0,0,0
"Angola","2024-04-17",0,0,0,0,0,0,0,0
"Angola","2024-04-18",0,0,0,0,0,0,0,0
"Angola","2024-04-19",0,0,0,0,0,0,0,0
"Angola","2024-04-20",0,0,0,0,0,0,0,0
"Angola","2024-04-21",0,0,0,0,0,0,0,0
"Angola","2024-04-22",0,0,0,0,0,0,0,0
"Angola","2024-04-23",0,0,0,0,0,0,0,0
"Angola","2024-04-24",0,0,0,0,0,0,0,0
"Angola","2024-04-25",0,0,0,0,0,0,0,0
"Angola","2024-04-26",0,0,0,0,0,0,0,0
"Angola","2024-04-27",0,0,0,0,0,0,0,0
"Angola","2024-04-28",0,0,0,0,0,0,0,0
"Angola","2024-04-29",0,0,0,0,0,0,0,0
"Angola","2024-04-30",0,0,0,0,0,0,0,0
"Angola","2024-05-01",0,0,0,0,0,0,0,0
"Angola","2024-05-02",0,0,0,0,0,0,0,0
"Angola","2024-05-03",0,0,0,0,0,0,0,0
"Angola","2024-05-04",0,0,0,0,0,0,0,0
"Angola","2024-05-05",0,0,0,0,0,0,0,0
"Angola","2024-05-06",0,0,0,0,0,0,0,0
"Angola","2024-05-07",0,0,0,0,0,0,0,0
"Angola","2024-05-08",0,0,0,0,0,0,0,0
"Angola","2024-05-09",0,0,0,0,0,0,0,0
"Angola","2024-05-10",0,0,0,0,0,0,0,0
"Angola","2024-05-11",0,0,0,0,0,0,0,0
"Angola","2024-05-12",0,0,0,0,0,0,0,0
"Angola","2024-05-13",0,0,0,0,0,0,0,0
"Angola","2024-05-14",0,0,0,0,0,0,0,0
"Angola","2024-05-15",0,0,0,0,0,0,0,0
"Angola","2024-05-16",0,0,0,0,0,0,0,0
"Angola","2024-05-17",0,0,0,0,0,0,0,0
"Angola","2024-05-18",0,0,0,0,0,0,0,0
"Angola","2024-05-19",0,0,0,0,0,0,0,0
"Angola","2024-05-20",0,0,0,0,0,0,0,0
"Angola","2024-05-21",0,0,0,0,0,0,0,0
"Angola","2024-05-22",0,0,0,0,0,0,0,0
"Angola","2024-05-23",0,0,0,0,0,0,0,0
"Angola","2024-05-24",0,0,0,0,0,0,0,0
"Angola","2024-05-25",0,0,0,0,0,0,0,0
"Angola","2024-05-26",0,0,0,0,0,0,0,0
"Angola","2024-05-27",0,0,0,0,0,0,0,0
"Angola","2024-05-28",0,0,0,0,0,0,0,0
"Angola","2024-05-29",0,0,0,0,0,0,0,0
"Angola","2024-05-30",0,0,0,0,0,0,0,0
"Angola","2024-05-31",0,0,0,0,0,0,0,0
"Angola","2024-06-01",0,0,0,0,0,0,0,0
"Angola","2024-06-02",0,0,0,0,0,0,0,0
"Angola","2024-06-03",0,0,0,0,0,0,0,0
"Angola","2024-06-04",0,0,0,0,0,0,0,0
"Angola","2024-06-05",0,0,0,0,0,0,0,0
"Angola","2024-06-06",0,0,0,0,0,0,0,0
"Angola","2024-06-07",0,0,0,0,0,0,0,0
"Angola","2024-06-08",0,0,0,0,0,0,0,0
"Angola","2024-06-09",0,0,0,0,0,0,0,0
"Angola","2024-06-10",0,0,0,0,0,0,0,0
"Angola","2024-06-11",0,0,0,0,0,0,0,0
"Angola","2024-06-12",0,0,0,0,0,0,0,0
"Angola","2024-06-13",0,0,0,0,0,0,0,0
"Angola","2024-06-14",0,0,0,0,0,0,0,0
"Angola","2024-06-15",0,0,0,0,0,0,0,0
"Angola","2024-06-16",0,0,0,0,0,0,0,0
"Angola","2024-06-17",0,0,0,0,0,0,0,0
"Angola","2024-06-18",0,0,0,0,0,0,0,0
"Angola","2024-06-19",0,0,0,0,0,0,0,0
"Angola","2024-06-20",0,0,0,0,0,0,0,0
"Angola","2024-06-21",0,0,0,0,0,0,0,0
"Angola","2024-06-22",0,0,0,0,0,0,0,0
"Angola","2024-06-23",0,0,0,0,0,0,0,0
"Angola","2024-06-24",0,0,0,0,0,0,0,0
"Angola","2024-06-25",0,0,0,0,0,0,0,0
"Angola","2024-06-26",0,0,0,0,0,0,0,0
"Angola","2024-06-27",0,0,0,0,0,0,0,0
"Angola","2024-06-28",0,0,0,0,0,0,0,0
"Angola","2024-06-29",0,0,0,0,0,0,0,0
"Angola","2024-06-30",0,0,0,0,0,0,0,0
"Angola","2024-07-01",0,0,0,0,0,0,0,0
"Angola","2024-07-02",0,0,0,0,0,0,0,0
"Angola","2024-07-03",0,0,0,0,0,0,0,0
"Angola","2024-07-04",0,0,0,0,0,0,0,0
"Angola","2024-07-05",0,0,0,0,0,0,0,0
"Angola","2024-07-06",0,0,0,0,0,0,0,0
"Angola","2024-07-07",0,0,0,0,0,0,0,0
"Angola","2024-07-08",0,0,0,0,0,0,0,0
"Angola","2024-07-09",0,0,0,0,0,0,0,0
"Angola","2024-07-10",0,0,0,0,0,0,0,0
"Angola","2024-07-11",0,0,0,0,0,0,0,0
"Angola","2024-07-12",0,0,0,0,0,0,0,0
"Angola","2024-07-13",0,0,0,0,0,0,0,0
"Angola","2024-07-14",0,0,0,0,0,0,0,0
"Angola","2024-07-15",0,0,0,0,0,0,0,0
"Angola","2024-07-16",0,0,0,0,0,0,0,0
"Angola","2024-07-17",0,0,0,0,0,0,0,0
"Angola","2024-07-18",0,0,0,0,0,0,0,0
"Angola","2024-07-19",0,0,0,0,0,0,0,0
"Angola","2024-07-20",0,0,0,0,0,0,0,0
"Angola","2024-07-21",0,0,0,0,0,0,0,0
"Angola","2024-07-22",0,0,0,0,0,0,0,0
"Angola","2024-07-23",0,0,0,0,0,0,0,0
"Angola","2024-07-24",0,0,0,0,0,0,0,0
"Angola","2024-07-25",0,0,0,0,0,0,0,0
"Angola","2024-07-26",0,0,0,0,0,0,0,0
"Angola","2024-07-27",0,0,0,0,0,0,0,0
"Angola","2024-07-28",0,0,0,0,0,0,0,0
"Angola","2024-07-29",0,0,0,0,0,0,0,0
"Angola","2024-07-30",0,0,0,0,0,0,0,0
"Angola","2024-07-31",0,0,0,0,0,0,0,0
"Angola","2024-08-01",0,0,0,0,0,0,0,0
"Angola","2024-08-02",0,0,0,0,0,0,0,0
"Angola","2024-08-03",0,0,0,0,0,0,0,0
"Angola","2024-08-04",0,0,0,0,0,0,0,0
"Angola","2024-08-05",0,0,0,0,0,0,0,0
"Angola","2024-08-06",0,0,0,0,0,0,0,0
"Angola","2024-08-07",0,0,0,0,0,0,0,0
"Angola","2024-08-08",0,0,0,0,0,0,0,0
"Angola","2024-08-09",0,0,0,0,0,0,0,0
"Angola","2024-08-10",0,0,0,0,0,0,0,0
"Angola","2024-08-11",0,0,0,0,0,0,0,0
"Angola","2024-08-12",0,0,0,0,0,0,0,0
"Angola","2024-08-13",0,0,0,0,0,0,0,0
"Angola","2024-08-14",0,0,0,0,0,0,0,0
"Angola","2024-08-15",0,0,0,0,0,0,0,0
"Angola","2024-08-16",0,0,0,0,0,0,0,0
"Angola","2024-08-17",0,0,0,0,0,0,0,0
"Angola","2024-08-18",0,0,0,0,0,0,0,0
"Angola","2024-08-19",0,0,0,0,0,0,0,0
"Angola","2024-08-20",0,0,0,0,0,0,0,0
"Angola","2024-08-21",0,0,0,0,0,0,0,0
"Angola","2024-08-22",0,0,0,0,0,0,0,0
"Angola","2024-08-23",0,0,0,0,0,0,0,0
"Angola","2024-08-24",0,0,0,0,0,0,0,0
"Angola","2024-08-25",0,0,0,0,0,0,0,0
"Angola","2024-08-26",0,0,0,0,0,0,0,0
"Angola","2024-08-27",0,0,0,0,0,0,0,0
"Angola","2024-08-28",0,0,0,0,0,0,0,0
"Angola","2024-08-29",0,0,0,0,0,0,0,0
"Angola","2024-08-30",0,0,0,0,0,0,0,0
"Angola","2024-08-31",0,0,0,0,0,0,0,0
"Angola","2024-09-01",0,0,0,0,0,0,0,0
"Angola","2024-09-02",0,0,0,0,0,0,0,0
"Angola","2024-09-03",0,0,0,0,0,0,0,0
"Angola","2024-09-04",0,0,0,0,0,0,0,0
"Angola","2024-09-05",0,0,0,0,0,0,0,0
"Angola","2024-09-06",0,0,0,0,0,0,0,0
"Angola","2024-09-07",0,0,0,0,0,0,0,0
"Angola","2024-09-08",0,0,0,0,0,0,0,0
"Angola","2024-09-09",0,0,0,0,0,0,0,0
"Angola","2024-09-10",0,0,0,0,0,0,0,0
"Angola","2024-09-11",0,0,0,0,0,0,0,0
"Angola","2024-09-12",0,0,0,0,0,0,0,0
"Angola","2024-09-13",0,0,0,0,0,0,0,0
"Angola","2024-09-14",0,0,0,0,0,0,0,0
"Angola","2024-09-15",0,0,0,0,0,0,0,0
"Angola","2024-09-16",0,0,0,0,0,0,0,0
"Angola","2024-09-17",0,0,0,0,0,0,0,0
"Angola","2024-09-18",0,0,0,0,0,0,0,0
"Angola","2024-09-19",0,0,0,0,0,0,0,0
"Angola","2024-09-20",0,0,0,0,0,0,0,0
"Angola","2024-09-21",0,0,0,0,0,0,0,0
"Angola","2024-09-22",0,0,0,0,0,0,0,0
"Angola","2024-09-23",0,0,0,0,0,0,0,0
"Angola","2024-09-24",0,0,0,0,0,0,0,0
"Angola","2024-09-25",0,0,0,0,0,0,0,0
"Angola","2024-09-26",0,0,0,0,0,0,0,0
"Angola","2024-09-27",0,0,0,0,0,0,0,0
"Angola","2024-09-28",0,0,0,0,0,0,0,0
"Angola","2024-09-29",0,0,0,0,0,0,0,0
"Angola","2024-09-30",0,0,0,0,0,0,0,0
"Angola","2024-10-01",0,0,0,0,0,0,0,0
"Angola","2024-10-02",0,0,0,0,0,0,0,0
"Angola","2024-10-03",0,0,0,0,0,0,0,0
"Angola","2024-10-04",0,0,0,0,0,0,0,0
"Angola","2024-10-05",0,0,0,0,0,0,0,0
"Angola","2024-10-06",0,0,0,0,0,0,0,0
"Angola","2024-10-07",0,0,0,0,0,0,0,0
"Angola","2024-10-08",0,0,0,0,0,0,0,0
"Angola","2024-10-09",0,0,0,0,0,0,0,0
"Angola","2024-10-10",0,0,0,0,0,0,0,0
"Angola","2024-10-11",0,0,0,0,0,0,0,0
"Angola","2024-10-12",0,0,0,0,0,0,0,0
"Angola","2024-10-13",0,0,0,0,0,0,0,0
"Angola","2024-10-14",0,0,0,0,0,0,0,0
"Angola","2024-10-15",0,0,0,0,0,0,0,0
"Angola","2024-10-16",0,0,0,0,0,0,0,0
"Angola","2024-10-17",0,0,0,0,0,0,0,0
"Angola","2024-10-18",0,0,0,0,0,0,0,0
"Angola","2024-10-19",0,0,0,0,0,0,0,0
"Angola","2024-10-20",0,0,0,0,0,0,0,0
"Angola","2024-10-21",0,0,0,0,0,0,0,0
"Angola","2024-10-22",0,0,0,0,0,0,0,0
"Angola","2024-10-23",0,0,0,0,0,0,0,0
"Angola","2024-10-24",0,0,0,0,0,0,0,0
"Angola","2024-10-25",0,0,0,0,0,0,0,0
"Angola","2024-10-26",0,0,0,0,0,0,0,0
"Angola","2024-10-27",0,0,0,0,0,0,0,0
"Angola","2024-10-28",0,0,0,0,0,0,0,0
"Angola","2024-10-29",0,0,0,0,0,0,0,0
"Angola","2024-10-30",0,0,0,0,0,0,0,0
"Angola","2024-10-31",0,0,0,0,0,0,0,0
"Angola","2024-11-01",0,0,0,0,0,0,0,0
"Angola","2024-11-02",0,0,0,0,0,0,0,0
"Angola","2024-11-03",0,0,0,0,0,0,0,0
"Angola","2024-11-04",0,0,0,0,0,0,0,0
"Angola","2024-11-05",0,0,0,0,0,0,0,0
"Angola","2024-11-06",0,0,0,0,0,0,0,0
"Angola","2024-11-07",0,0,0,0,0,0,0,0
"Angola","2024-11-08",0,0,0,0,0,0,0,0
"Angola","2024-11-09",0,0,0,0,0,0,0,0
"Angola","2024-11-10",0,0,0,0,0,0,0,0
"Angola","2024-11-11",0,0,0,0,0,0,0,0
"Angola","2024-11-12",0,0,0,0,0,0,0,0
"Angola","2024-11-13",0,0,0,0,0,0,0,0
"Angola","2024-11-14",0,0,0,0,0,0,0,0
"Angola","2024-11-15",0,0,0,0,0,0,0,0
"Angola","2024-11-16",0,0,0,0,0,0,0,0
"Angola","2024-11-17",0,1,1,0,1,1,0,0
"Angola","2024-11-18",0,0,1,0,0,1,0,0
"Angola","2024-11-19",0,0,1,0,1,2,0,0
"Angola","2024-11-20",0,1,2,0,0,2,0,0
"Angola","2024-11-21",0,0,2,0,0,2,0,0
"Angola","2024-11-22",0,0,2,0,0,2,0,0
"Angola","2024-11-23",0,0,2,0,0,2,0,0
"Angola","2024-11-24",0,0,2,0,0,2,0,0
"Angola","2024-11-25",0,0,2,0,0,2,0,0
"Angola","2024-11-26",0,0,2,0,0,2,0,0
"Angola","2024-11-27",0,0,2,0,0,2,0,0
"Angola","2024-11-28",0,0,2,0,0,2,0,0
"Angola","2024-11-29",0,0,2,0,0,2,0,0
"Angola","2024-11-30",0,0,2,0,0,2,0,0
"Angola","2024-12-01",0,0,2,0,0,2,0,0
"Angola","2024-12-02",0,0,2,0,0,2,0,0
"Angola","2024-12-03",0,0,2,0,0,2,0,0
"Angola","2024-12-04",0,0,2,0,0,2,0,0
"Angola","2024-12-05",0,0,2,0,0,2,0,0
"Angola","2024-12-06",0,0,2,0,0,2,0,0
"Angola","2024-12-07",0,0,2,0,0,2,0,0
"Angola","2024-12-08",0,0,2,0,0,2,0,0
"Angola","2024-12-09",0,0,2,0,0,2,0,0
"Angola","2024-12-10",0,0,2,0,0,2,0,0
"Angola","2024-12-11",0,0,2,0,0,2,0,0
"Angola","2024-12-12",0,0,2,0,0,2,0,0
"Angola","2024-12-13",0,0,2,0,0,2,0,0
"Angola","2024-12-14",0,0,2,0,0,2,0,0
"Angola","2024-12-15",0,0,2,0,0,2,0,0
"Angola","2024-12-16",0,0,2,0,0,2,0,0
"Angola","2024-12-17",0,0,2,0,0,2,0,0
"Angola","2024-12-18",0,0,2,0,0,2,0,0
"Angola","2024-12-19",0,0,2,0,0,2,0,0
"Angola","2024-12-20",0,0,2,0,0,2,0,0
"Angola","2024-12-21",0,0,2,0,0,2,0,0
"Angola","2024-12-22",0,0,2,0,0,2,0,0
"Angola","2024-12-23",0,0,2,0,0,2,0,0
"Angola","2024-12-24",0,0,2,0,0,2,0,0
"Angola","2024-12-25",0,0,2,0,0,2,0,0
"Angola","2024-12-26",0,0,2,0,0,2,0,0
"Angola","2024-12-27",0,0,2,0,0,2,0,0
"Angola","2024-12-28",0,0,2,0,0,2,0,0
"Angola","2024-12-29",0,0,2,0,0,2,0,0
"Angola","2024-12-30",0,0,2,0,0,2,0,0
"Angola","2024-12-31",0,0,2,0,0,2,0,0
"Angola","2025-01-01",0,0,2,0,0,2,0,0
"Angola","2025-01-02",0,0,2,0,0,2,0,0
"Angola","2025-01-03",0,0,2,0,0,2,0,0
"Angola","2025-01-04",0,0,2,0,0,2,0,0
"Angola","2025-01-05",0,0,2,0,0,2,0,0
"Angola","2025-01-06",0,0,2,0,0,2,0,0
"Angola","2025-01-07",0,0,2,0,0,2,0,0
"Angola","2025-01-08",0,0,2,0,0,2,0,0
"Angola","2025-01-09",0,0,2,0,0,2,0,0
"Angola","2025-01-10",0,0,2,0,0,2,0,0
"Angola","2025-01-11",0,0,2,0,0,2,0,0
"Angola","2025-01-12",0,0,2,0,0,2,0,0
"Angola","2025-01-13",0,0,2,0,0,2,0,0
"Argentina","2024-01-01",0,0,0,0,0,0,0,0
"Argentina","2024-01-02",0,0,0,0,0,0,0,0
"Argentina","2024-01-03",0,0,0,0,0,0,0,0
"Argentina","2024-01-04",0,0,0,0,0,0,0,0
"Argentina","2024-01-05",0,0,0,0,0,0,0,0
"Argentina","2024-01-06",0,0,0,0,0,0,0,0
"Argentina","2024-01-07",0,0,0,0,0,0,0,0
"Argentina","2024-01-08",0,0,0,0,0,0,0,0
"Argentina","2024-01-09",0,0,0,0,0,0,0,0
"Argentina","2024-01-10",0,0,0,0,0,0,0,0
"Argentina","2024-01-11",0,0,0,0,0,0,0,0
"Argentina","2024-01-12",0,0,0,0,0,0,0,0
"Argentina","2024-01-13",0,0,0,0,0,0,0,0
"Argentina","2024-01-14",0,0,0,0,0,0,0,0
"Argentina","2024-01-15",0,0,0,0,0,0,0,0
"Argentina","2024-01-16",0,0,0,0,0,0,0,0
"Argentina","2024-01-17",0,0,0,0,0,0,0,0
"Argentina","2024-01-18",0,0,0,0,0,0,0,0
"Argentina","2024-01-19",0,0,0,0,0,0,0,0
"Argentina","2024-01-20",0,0,0,0,0,0,0,0
"Argentina","2024-01-21",0,0,0,0,0,0,0,0
"Argentina","2024-01-22",0,0,0,0,0,0,0,0
"Argentina","2024-01-23",0,1,1,0,1,1,0,0
"Argentina","2024-01-24",0,0,1,0,0,1,0,0
"Argentina","2024-01-25",0,0,1,0,0,1,0,0
"Argentina","2024-01-26",0,0,1,0,0,1,0,0
"Argentina","2024-01-27",0,0,1,0,0,1,0,0
"Argentina","2024-01-28",0,0,1,0,0,1,0,0
"Argentina","2024-01-29",0,0,1,0,0,1,0,0
"Argentina","2024-01-30",0,0,1,0,0,1,0,0
"Argentina","2024-01-31",0,0,1,0,0,1,0,0
"Argentina","2024-02-01",0,0,1,0,0,1,0,0
"Argentina","2024-02-02",0,0,1,0,0,1,0,0
"Argentina","2024-02-03",0,0,1,0,0,1,0,0
"Argentina","2024-02-04",0,0,1,0,0,1,0,0
"Argentina","2024-02-05",0,0,1,0,0,1,0,0
"Argentina","2024-02-06",0,0,1,0,0,1,0,0
"Argentina","2024-02-07",0,0,1,0,0,1,0,0
"Argentina","2024-02-08",0,0,1,0,0,1,0,0
"Argentina","2024-02-09",0,0,1,0,0,1,0,0
"Argentina","2024-02-10",0,0,1,0,0,1,0,0
"Argentina","2024-02-11",0,0,1,0,0,1,0,0
"Argentina","2024-02-12",0,0,1,0,0,1,0,0
"Argentina","2024-02-13",0,0,1,0,0,1,0,0
"Argentina","2024-02-14",0,0,1,0,0,1,0,0
"Argentina","2024-02-15",0,0,1,0,0,1,0,0
"Argentina","2024-02-16",0,0,1,0,0,1,0,0
"Argentina","2024-02-17",0,0,1,0,0,1,0,0
"Argentina","2024-02-18",0,0,1,0,0,1,0,0
"Argentina","2024-02-19",0,0,1,0,0,1,0,0
"Argentina","2024-02-20",0,0,1,0,0,1,0,0
"Argentina","2024-02-21",0,0,1,0,0,1,0,0
"Argentina","2024-02-22",0,0,1,0,0,1,0,0
"Argentina","2024-02-23",0,0,1,0,0,1,0,0
"Argentina","2024-02-24",0,0,1,0,0,1,0,0
"Argentina","2024-02-25",0,0,1,0,0,1,0,0
"Argentina","2024-02-26",0,0,1,0,0,1,0,0
"Argentina","2024-02-27",0,0,1,0,0,1,0,0
"Argentina","2024-02-28",0,0,1,0,0,1,0,0
"Argentina","2024-02-29",0,0,1,0,0,1,0,0
"Argentina","2024-03-01",0,0,1,0,0,1,0,0
"Argentina","2024-03-02",0,0,1,0,0,1,0,0
"Argentina","2024-03-03",0,0,1,0,0,1,0,0
"Argentina","2024-03-04",0,0,1,0,1,2,0,0
"Argentina","2024-03-05",0,0,1,0,0,2,0,0
"Argentina","2024-03-06",0,0,1,0,0,2,0,0
"Argentina","2024-03-07",0,0,1,0,0,2,0,0
"Argentina","2024-03-08",0,0,1,0,0,2,0,0
"Argentina","2024-03-09",0,0,1,0,0,2,0,0
"Argentina","2024-03-10",0,0,1,0,0,2,0,0
"Argentina","2024-03-11",0,0,1,0,0,2,0,0
"Argentina","2024-03-12",0,0,1,0,0,2,0,0
"Argentina","2024-03-13",0,0,1,0,0,2,0,0
"Argentina","2024-03-14",0,0,1,0,0,2,0,0
"Argentina","2024-03-15",0,0,1,0,0,2,0,0
"Argentina","2024-03-16",0,0,1,0,0,2,0,0
"Argentina","2024-03-17",0,0,1,0,0,2,0,0
"Argentina","2024-03-18",0,0,1,0,0,2,0,0
"Argentina","2024-03-19",0,0,1,0,0,2,0,0
"Argentina","2024-03-20",0,0,1,0,0,2,0,0
"Argentina","2024-03-21",0,0,1,0,0,2,0,0
"Argentina","2024-03-22",0,0,1,0,0,2,0,0
"Argentina","2024-03-23",0,0,1,0,0,2,0,0
"Argentina","2024-03-24",0,0,1,0,0,2,0,0
"Argentina","2024-03-25",0,0,1,0,0,2,0,0
"Argentina","2024-03-26",0,0,1,0,0,2,0,0
"Argentina","2024-03-27",0,0,1,0,0,2,0,0
"Argentina","2024-03-28",0,0,1,0,0,2,0,0
"Argentina","2024-03-29",0,0,1,0,0,2,0,0
"Argentina","2024-03-30",0,0,1,0,0,2,0,0
"Argentina","2024-03-31",0,0,1,0,0,2,0,0
"Argentina","2024-04-01",0,0,1,0,0,2,0,0
"Argentina","2024-04-02",0,0,1,0,0,2,0,0
"Argentina","2024-04-03",0,0,1,0,0,2,0,0
"Argentina","2024-04-04",0,0,1,0,0,2,0,0
"Argentina","2024-04-05",0,0,1,0,0,2,0,0
"Argentina","2024-04-06",0,0,1,0,0,2,0,0
"Argentina","2024-04-07",0,0,1,0,0,2,0,0
"Argentina","2024-04-08",0,0,1,0,0,2,0,0
"Argentina","2024-04-09",0,0,1,0,0,2,0,0
"Argentina","2024-04-10",0,0,1,0,0,2,0,0
"Argentina","2024-04-11",0,0,1,0,0,2,0,0
"Argentina","2024-04-12",0,0,1,0,0,2,0,0
"Argentina","2024-04-13",0,0,1,0,0,2,0,0
"Argentina","2024-04-14",0,0,1,0,0,2,0,0
"Argentina","2024-04-15",0,0,1,0,0,2,0,0
"Argentina","2024-04-16",0,0,1,0,0,2,0,0
"Argentina","2024-04-17",0,0,1,0,0,2,0,0
"Argentina","2024-04-18",0,0,1,0,0,2,0,0
"Argentina","2024-04-19",0,0,1,0,0,2,0,0
"Argentina","2024-04-20",0,0,1,0,0,2,0,0
"Argentina","2024-04-21",0,0,1,0,0,2,0,0
"Argentina","2024-04-22",0,0,1,0,0,2,0,0
"Argentina","2024-04-23",0,0,1,0,0,2,0,0
"Argentina","2024-04-24",0,0,1,0,0,2,0,0
"Argentina","2024-04-25",0,0,1,0,0,2,0,0
"Argentina","2024-04-26",0,0,1,0,0,2,0,0
"Argentina","2024-04-27",0,0,1,0,0,2,0,0
"Argentina","2024-04-28",0,0,1,0,0,2,0,0
"Argentina","2024-04-29",0,0,1,0,0,2,0,0
"Argentina","2024-04-30",0,0,1,0,0,2,0,0
"Argentina","2024-05-01",0,0,1,0,0,2,0,0
"Argentina","2024-05-02",0,0,1,0,0,2,0,0
"Argentina","2024-05-03",0,0,1,0,0,2,0,0
"Argentina","2024-05-04",0,0,1,0,0,2,0,0
"Argentina","2024-05-05",0,0,1,0,0,2,0,0
"Argentina","2024-05-06",0,0,1,0,0,2,0,0
"Argentina","2024-05-07",0,0,1,0,0,2,0,0
"Argentina","2024-05-08",0,0,1,0,0,2,0,0
"Argentina","2024-05-09",0,0,1,0,0,2,0,0
"Argentina","2024-05-10",0,0,1,0,0,2,0,0
"Argentina","2024-05-11",0,0,1,0,0,2,0,0
"Argentina","2024-05-12",0,0,1,0,0,2,0,0
"Argentina","2024-05-13",0,0,1,0,0,2,0,0
"Argentina","2024-05-14",0,0,1,0,0,2,0,0
"Argentina","2024-05-15",0,0,1,0,0,2,0,0
"Argentina","2024-05-16",0,0,1,0,0,2,0,0
"Argentina","2024-05-17",0,0,1,0,0,2,0,0
"Argentina","2024-05-18",0,0,1,0,0,2,0,0
"Argentina","2024-05-19",0,0,1,0,0,2,0,0
"Argentina","2024-05-20",0,0,1,0,0,2,0,0
"Argentina","2024-05-21",0,0,1,0,0,2,0,0
"Argentina","2024-05-22",0,0,1,0,0,2,0,0
"Argentina","2024-05-23",0,0,1,0,1,3,0,0
"Argentina","2024-05-24",0,0,1,0,0,3,0,0
"Argentina","2024-05-25",0,0,1,0,0,3,0,0
"Argentina","2024-05-26",0,0,1,0,0,3,0,0
"Argentina","2024-05-27",0,0,1,0,0,3,0,0
"Argentina","2024-05-28",0,0,1,0,0,3,0,0
"Argentina","2024-05-29",0,0,1,0,0,3,0,0
"Argentina","2024-05-30",0,0,1,0,0,3,0,0
"Argentina","2024-05-31",0,0,1,0,0,3,0,0
"Argentina","2024-06-01",0,0,1,0,0,3,0,0
"Argentina","2024-06-02",0,0,1,0,0,3,0,0
"Argentina","2024-06-03",0,0,1,0,0,3,0,0
"Argentina","2024-06-04",0,0,1,0,0,3,0,0
"Argentina","2024-06-05",0,0,1,0,0,3,0,0
"Argentina","2024-06-06",0,0,1,0,0,3,0,0
"Argentina","2024-06-07",0,0,1,0,0,3,0,0
"Argentina","2024-06-08",0,0,1,0,0,3,0,0
"Argentina","2024-06-09",0,0,1,0,0,3,0,0
"Argentina","2024-06-10",0,0,1,0,0,3,0,0
"Argentina","2024-06-11",0,0,1,0,0,3,0,0
"Argentina","2024-06-12",0,0,1,0,0,3,0,0
"Argentina","2024-06-13",0,0,1,0,0,3,0,0
"Argentina","2024-06-14",0,0,1,0,0,3,0,0
"Argentina","2024-06-15",0,0,1,0,0,3,0,0
"Argentina","2024-06-16",0,0,1,0,0,3,0,0
"Argentina","2024-06-17",0,0,1,0,0,3,0,0
"Argentina","2024-06-18",0,0,1,0,0,3,0,0
"Argentina","2024-06-19",0,0,1,0,0,3,0,0
"Argentina","2024-06-20",0,0,1,0,0,3,0,0
"Argentina","2024-06-21",0,0,1,0,0,3,0,0
"Argentina","2024-06-22",0,0,1,0,0,3,0,0
"Argentina","2024-06-23",0,0,1,0,0,3,0,0
"Argentina","2024-06-24",0,0,1,0,0,3,0,0
"Argentina","2024-06-25",0,0,1,0,0,3,0,0
"Argentina","2024-06-26",0,0,1,0,0,3,0,0
"Argentina","2024-06-27",0,0,1,0,0,3,0,0
"Argentina","2024-06-28",0,0,1,0,0,3,0,0
"Argentina","2024-06-29",0,0,1,0,0,3,0,0
"Argentina","2024-06-30",0,0,1,0,0,3,0,0
"Argentina","2024-07-01",0,0,1,0,0,3,0,0
"Argentina","2024-07-02",0,2,3,0,0,3,0,0
"Argentina","2024-07-03",0,0,3,0,0,3,0,0
"Argentina","2024-07-04",0,0,3,0,0,3,0,0
"Argentina","2024-07-05",0,0,3,0,0,3,0,0
"Argentina","2024-07-06",0,0,3,0,0,3,0,0
"Argentina","2024-07-07",0,0,3,0,0,3,0,0
"Argentina","2024-07-08",0,0,3,0,0,3,0,0
"Argentina","2024-07-09",0,0,3,0,0,3,0,0
"Argentina","2024-07-10",0,0,3,0,0,3,0,0
"Argentina","2024-07-11",0,0,3,0,0,3,0,0
"Argentina","2024-07-12",0,0,3,0,0,3,0,0
"Argentina","2024-07-13",0,0,3,0,1,4,0,0
"Argentina","2024-07-14",0,0,3,0,0,4,0,0
"Argentina","2024-07-15",0,0,3,0,0,4,0,0
"Argentina","2024-07-16",0,0,3,0,0,4,0,0
"Argentina","2024-07-17",0,0,3,0,0,4,0,0
"Argentina","2024-07-18",0,0,3,0,0,4,0,0
"Argentina","2024-07-19",0,0,3,0,0,4,0,0
"Argentina","2024-07-20",0,0,3,0,0,4,0,0
"Argentina","2024-07-21",0,0,3,0,0,4,0,0
"Argentina","2024-07-22",0,0,3,0,0,4,0,0
"Argentina","2024-07-23",0,1,4,0,0,4,0,0
"Argentina","2024-07-24",0,0,4,0,0,4,0,0
"Argentina","2024-07-25",0,0,4,0,1,5,0,0
"Argentina","2024-07-26",0,0,4,0,0,5,0,0
"Argentina","2024-07-27",0,0,4,0,0,5,0,0
"Argentina","2024-07-28",0,0,4,0,0,5,0,0
"Argentina","2024-07-29",0,0,4,0,1,6,0,0
"Argentina","2024-07-30",0,2,6,0,0,6,0,0
"Argentina","2024-07-31",0,0,6,0,0,6,0,0
"Argentina","2024-08-01",0,0,6,0,1,7,0,0
"Argentina","2024-08-02",0,0,6,0,0,7,0,0
"Argentina","2024-08-03",0,0,6,0,1,8,0,0
"Argentina","2024-08-04",0,0,6,0,0,8,0,0
"Argentina","2024-08-05",0,0,6,0,1,9,0,0
"Argentina","2024-08-06",0,3,9,0,0,9,0,0
"Argentina","2024-08-07",0,0,9,0,1,10,0,0
"Argentina","2024-08-08",0,0,9,0,0,10,0,0
"Argentina","2024-08-09",0,0,9,0,1,11,0,0
"Argentina","2024-08-10",0,0,9,0,0,11,0,0
"Argentina","2024-08-11",0,0,9,0,1,12,0,0
"Argentina","2024-08-12",0,0,9,0,0,12,0,0
"Argentina","2024-08-13",0,4,13,0,1,13,0,0
"Argentina","2024-08-14",0,0,13,0,2,15,0,0
"Argentina","2024-08-15",0,0,13,0,1,16,0,0
"Argentina","2024-08-16",0,0,13,0,2,18,0,0
"Argentina","2024-08-17",0,0,13,0,2,20,0,0
"Argentina","2024-08-18",0,0,13,0,2,22,0,0
"Argentina","2024-08-19",0,0,13,0,1,23,0,0
"Argentina","2024-08-20",0,12,25,0,2,25,0,0
"Argentina","2024-08-21",0,0,25,0,1,26,0,0
"Argentina","2024-08-22",0,0,25,0,1,27,0,0
"Argentina","2024-08-23",0,0,25,0,1,28,0,0
"Argentina","2024-08-24",0,0,25,0,1,29,0,0
"Argentina","2024-08-25",0,0,25,0,1,30,0,0
"Argentina","2024-08-26",0,0,25,0,1,31,0,0
"Argentina","2024-08-27",0,7,32,0,1,32,0,0
"Argentina","2024-08-28",0,0,32,0,2,34,0,0
"Argentina","2024-08-29",0,0,32,0,2,36,0,0
"Argentina","2024-08-30",0,0,32,0,2,38,0,0
"Argentina","2024-08-31",0,0,32,0,1,39,0,0
"Argentina","2024-09-01",0,0,32,0,2,41,0,0
"Argentina","2024-09-02",0,0,32,0,2,43,0,0
"Argentina","2024-09-03",0,13,45,0,2,45,0,0
"Argentina","2024-09-04",0,0,45,0,1,46,0,0
"Argentina","2024-09-05",0,0,45,0,2,48,0,0
"Argentina","2024-09-06",0,0,45,0,1,49,0,0
"Argentina","2024-09-07",0,0,45,0,1,50,0,0
"Argentina","2024-09-08",0,0,45,0,1,51,0,0
"Argentina","2024-09-09",0,0,45,0,2,53,0,0
"Argentina","2024-09-10",0,9,54,0,1,54,0,0
"Argentina","2024-09-11",0,0,54,0,2,56,0,0
"Argentina","2024-09-12",0,0,54,0,2,58,0,0
"Argentina","2024-09-13",0,0,54,0,2,60,0,0
"Argentina","2024-09-14",0,0,54,0,1,61,0,0
"Argentina","2024-09-15",0,0,54,0,2,63,0,0
"Argentina","2024-09-16",0,0,54,0,2,65,0,0
"Argentina","2024-09-17",0,13,67,0,2,67,0,0
"Argentina","2024-09-18",0,0,67,0,1,68,0,0
"Argentina","2024-09-19",0,0,67,0,0,68,0,0
"Argentina","2024-09-20",0,0,67,0,1,69,0,0
"Argentina","2024-09-21",0,0,67,0,1,70,0,0
"Argentina","2024-09-22",0,0,67,0,1,71,0,0
"Argentina","2024-09-23",0,0,67,0,0,71,0,0
"Argentina","2024-09-24",0,5,72,0,1,72,0,0
"Argentina","2024-09-25",0,0,72,0,1,73,0,0
"Argentina","2024-09-26",0,0,72,0,1,74,0,0
"Argentina","2024-09-27",0,0,72,0,1,75,0,0
"Argentina","2024-09-28",0,0,72,0,1,76,0,0
"Argentina","2024-09-29",0,0,72,0,1,77,0,0
"Argentina","2024-09-30",0,0,72,0,1,78,0,0
"Argentina","2024-10-01",0,7,79,0,1,79,0,0
"Argentina","2024-10-02",0,0,79,0,0,79,0,0
"Argentina","2024-10-03",0,0,79,0,1,80,0,0
"Argentina","2024-10-04",0,0,79,0,0,80,0,0
"Argentina","2024-10-05",0,0,79,0,1,81,0,0
"Argentina","2024-10-06",0,0,79,0,0,81,0,0
"Argentina","2024-10-07",0,0,79,0,1,82,0,0
"Argentina","2024-10-08",0,3,82,0,0,82,0,0
"Argentina","2024-10-09",0,0,82,0,0,82,0,0
"Argentina","2024-10-10",0,0,82,0,1,83,0,0
"Argentina","2024-10-11",0,0,82,0,0,83,0,0
"Argentina","2024-10-12",0,0,82,0,0,83,0,0
"Argentina","2024-10-13",0,0,82,0,0,83,0,0
"Argentina","2024-10-14",0,0,82,0,1,84,0,0
"Argentina","2024-10-15",0,2,84,0,0,84,0,0
"Argentina","2024-10-16",0,0,84,0,0,84,0,0
"Argentina","2024-10-17",0,0,84,0,0,84,0,0
"Argentina","2024-10-18",0,0,84,0,0,84,0,0
"Argentina","2024-10-19",0,0,84,0,1,85,0,0
"Argentina","2024-10-20",0,0,84,0,0,85,0,0
"Argentina","2024-10-21",0,0,84,0,0,85,0,0
"Argentina","2024-10-22",0,1,85,0,0,85,0,0
"Argentina","2024-10-23",0,0,85,0,0,85,0,0
"Argentina","2024-10-24",0,0,85,0,1,86,0,0
"Argentina","2024-10-25",0,0,85,0,0,86,0,0
"Argentina","2024-10-26",0,0,85,0,0,86,0,0
"Argentina","2024-10-27",0,0,85,0,0,86,0,0
"Argentina","2024-10-28",0,0,85,0,1,87,0,0
"Argentina","2024-10-29",0,2,87,0,0,87,0,0
"Argentina","2024-10-30",0,0,87,0,0,87,0,0
"Argentina","2024-10-31",0,0,87,0,1,88,0,0
"Argentina","2024-11-01",0,0,87,0,0,88,0,0
"Argentina","2024-11-02",0,0,87,0,0,88,0,0
"Argentina","2024-11-03",0,0,87,0,0,88,0,0
"Argentina","2024-11-04",0,0,87,0,1,89,0,0
"Argentina","2024-11-05",0,2,89,0,0,89,0,0
"Argentina","2024-11-06",0,0,89,0,1,90,0,0
"Argentina","2024-11-07",0,0,89,0,1,91,0,0
"Argentina","2024-11-08",0,0,89,0,1,92,0,0
"Argentina","2024-11-09",0,0,89,0,2,94,0,0
"Argentina","2024-11-10",0,0,89,0,1,95,0,0
"Argentina","2024-11-11",0,0,89,0,1,96,0,0
"Argentina","2024-11-12",0,8,97,0,1,97,0,0
"Argentina","2024-11-13",0,0,97,0,0,97,0,0
"Argentina","2024-11-14",0,0,97,0,1,98,0,0
"Argentina","2024-11-15",0,0,97,0,0,98,0,0
"Argentina","2024-11-16",0,0,97,0,1,99,0,0
"Argentina","2024-11-17",0,0,97,0,0,99,0,0
"Argentina","2024-11-18",0,0,97,0,1,100,0,0
"Argentina","2024-11-19",0,3,100,0,0,100,0,0
"Argentina","2024-11-20",0,0,100,0,0,100,0,0
"Argentina","2024-11-21",0,0,100,0,0,100,0,0
"Argentina","2024-11-22",0,0,100,0,0,100,0,0
"Argentina","2024-11-23",0,0,100,0,1,101,0,0
"Argentina","2024-11-24",0,0,100,0,0,101,0,0
"Argentina","2024-11-25",0,0,100,0,0,101,0,0
"Argentina","2024-11-26",0,1,101,0,0,101,0,0
"Argentina","2024-11-27",0,0,101,0,0,101,0,0
"Argentina","2024-11-28",0,0,101,0,0,101,0,0
"Argentina","2024-11-29",0,0,101,0,0,101,0,0
"Argentina","2024-11-30",0,0,101,0,0,101,0,0
"Argentina","2024-12-01",0,0,101,0,0,101,0,0
"Argentina","2024-12-02",0,0,101,0,0,101,0,0
"Argentina","2024-12-03",0,0,101,0,0,101,0,0
"Argentina","2024-12-04",0,0,101,0,0,101,0,0
"Argentina","2024-12-05",0,0,101,0,0,101,0,0
"Argentina","2024-12-06",0,0,101,0,0,101,0,0
"Argentina","2024-12-07",0,0,101,0,0,101,0,0
"Argentina","2024-12-08",0,0,101,0,0,101,0,0
"Argentina","2024-12-09",0,0,101,0,0,101,0,0
"Argentina","2024-12-10",0,0,101,0,0,101,0,0
"Argentina","2024-12-11",0,0,101,0,0,101,0,0
"Argentina","2024-12-12",0,0,101,0,0,101,0,0
"Argentina","2024-12-13",0,0,101,0,0,101,0,0
"Argentina","2024-12-14",0,0,101,0,0,101,0,0
"Argentina","2024-12-15",0,0,101,0,0,101,0,0
"Argentina","2024-12-16",0,0,101,0,0,101,0,0
"Argentina","2024-12-17",0,0,101,0,0,101,0,0
"Argentina","2024-12-18",0,0,101,0,0,101,0,0
"Argentina","2024-12-19",0,0,101,0,0,101,0,0
"Argentina","2024-12-20",0,0,101,0,0,101,0,0
"Argentina","2024-12-21",0,0,101,0,0,101,0,0
"Argentina","2024-12-22",0,0,101,0,0,101,0,0
"Argentina","2024-12-23",0,0,101,0,0,101,0,0
"Argentina","2024-12-24",0,0,101,0,0,101,0,0
"Argentina","2024-12-25",0,0,101,0,0,101,0,0
"Argentina","2024-12-26",0,0,101,0,0,101,0,0
"Argentina","2024-12-27",0,0,101,0,0,101,0,0
"Argentina","2024-12-28",0,0,101,0,0,101,0,0
"Argentina","2024-12-29",0,0,101,0,0,101,0,0
"Argentina","2024-12-30",0,0,101,0,0,101,0,0
"Argentina","2024-12-31",0,0,101,0,0,101,0,0
"Argentina","2025-01-01",0,0,101,0,0,101,0,0
"Argentina","2025-01-02",0,0,101,0,0,101,0,0
"Argentina","2025-01-03",0,0,101,0,0,101,0,0
"Argentina","2025-01-04",0,0,101,0,0,101,0,0
"Argentina","2025-01-05",0,0,101,0,0,101,0,0
"Argentina","2025-01-06",0,0,101,0,0,101,0,0
"Argentina","2025-01-07",0,0,101,0,0,101,0,0
"Argentina","2025-01-08",0,0,101,0,0,101,0,0
"Argentina","2025-01-09",0,0,101,0,0,101,0,0
"Argentina","2025-01-10",0,0,101,0,0,101,0,0
"Argentina","2025-01-11",0,0,101,0,0,101,0,0
"Argentina","2025-01-12",0,0,101,0,0,101,0,0
"Argentina","2025-01-13",0,0,101,0,0,101,0,0
"Aruba","2024-01-01",0,0,0,0,0,0,0,0
"Aruba","2024-01-02",0,0,0,0,0,0,0,0
"Aruba","2024-01-03",0,0,0,0,0,0,0,0
"Aruba","2024-01-04",0,0,0,0,0,0,0,0
"Aruba","2024-01-05",0,0,0,0,0,0,0,0
"Aruba","2024-01-06",0,0,0,0,0,0,0,0
"Aruba","2024-01-07",0,0,0,0,0,0,0,0
"Aruba","2024-01-08",0,0,0,0,0,0,0,0
"Aruba","2024-01-09",0,0,0,0,0,0,0,0
"Aruba","2024-01-10",0,0,0,0,0,0,0,0
"Aruba","2024-01-11",0,0,0,0,0,0,0,0
"Aruba","2024-01-12",0,0,0,0,0,0,0,0
"Aruba","2024-01-13",0,0,0,0,0,0,0,0
"Aruba","2024-01-14",0,0,0,0,0,0,0,0
"Aruba","2024-01-15",0,0,0,0,0,0,0,0
"Aruba","2024-01-16",0,0,0,0,0,0,0,0
"Aruba","2024-01-17",0,0,0,0,0,0,0,0
"Aruba","2024-01-18",0,0,0,0,0,0,0,0
"Aruba","2024-01-19",0,0,0,0,0,0,0,0
"Aruba","2024-01-20",0,0,0,0,0,0,0,0
"Aruba","2024-01-21",0,0,0,0,0,0,0,0
"Aruba","2024-01-22",0,0,0,0,0,0,0,0
"Aruba","2024-01-23",0,0,0,0,0,0,0,0
"Aruba","2024-01-24",0,0,0,0,0,0,0,0
"Aruba","2024-01-25",0,0,0,0,0,0,0,0
"Aruba","2024-01-26",0,0,0,0,0,0,0,0
"Aruba","2024-01-27",0,0,0,0,0,0,0,0
"Aruba","2024-01-28",0,0,0,0,0,0,0,0
"Aruba","2024-01-29",0,0,0,0,0,0,0,0
"Aruba","2024-01-30",0,0,0,0,0,0,0,0
"Aruba","2024-01-31",0,0,0,0,0,0,0,0
"Aruba","2024-02-01",0,0,0,0,0,0,0,0
"Aruba","2024-02-02",0,0,0,0,0,0,0,0
"Aruba","2024-02-03",0,0,0,0,0,0,0,0
"Aruba","2024-02-04",0,0,0,0,0,0,0,0
"Aruba","2024-02-05",0,0,0,0,0,0,0,0
"Aruba","2024-02-06",0,0,0,0,0,0,0,0
"Aruba","2024-02-07",0,0,0,0,0,0,0,0
"Aruba","2024-02-08",0,0,0,0,0,0,0,0
"Aruba","2024-02-09",0,0,0,0,0,0,0,0
"Aruba","2024-02-10",0,0,0,0,0,0,0,0
"Aruba","2024-02-11",0,0,0,0,0,0,0,0
"Aruba","2024-02-12",0,0,0,0,0,0,0,0
"Aruba","2024-02-13",0,0,0,0,0,0,0,0
"Aruba","2024-02-14",0,0,0,0,0,0,0,0
"Aruba","2024-02-15",0,0,0,0,0,0,0,0
"Aruba","2024-02-16",0,0,0,0,0,0,0,0
"Aruba","2024-02-17",0,0,0,0,0,0,0,0
"Aruba","2024-02-18",0,0,0,0,0,0,0,0
"Aruba","2024-02-19",0,0,0,0,0,0,0,0
"Aruba","2024-02-20",0,0,0,0,0,0,0,0
"Aruba","2024-02-21",0,0,0,0,0,0,0,0
"Aruba","2024-02-22",0,0,0,0,0,0,0,0
"Aruba","2024-02-23",0,0,0,0,0,0,0,0
"Aruba","2024-02-24",0,0,0,0,0,0,0,0
"Aruba","2024-02-25",0,0,0,0,0,0,0,0
"Aruba","2024-02-26",0,0,0,0,0,0,0,0
"Aruba","2024-02-27",0,0,0,0,0,0,0,0
"Aruba","2024-02-28",0,0,0,0,0,0,0,0
"Aruba","2024-02-29",0,0,0,0,0,0,0,0
"Aruba","2024-03-01",0,0,0,0,0,0,0,0
"Aruba","2024-03-02",0,0,0,0,0,0,0,0
"Aruba","2024-03-03",0,0,0,0,0,0,0,0
"Aruba","2024-03-04",0,0,0,0,0,0,0,0
"Aruba","2024-03-05",0,0,0,0,0,0,0,0
"Aruba","2024-03-06",0,0,0,0,0,0,0,0
"Aruba","2024-03-07",0,0,0,0,0,0,0,0
"Aruba","2024-03-08",0,0,0,0,0,0,0,0
"Aruba","2024-03-09",0,0,0,0,0,0,0,0
"Aruba","2024-03-10",0,0,0,0,0,0,0,0
"Aruba","2024-03-11",0,0,0,0,0,0,0,0
"Aruba","2024-03-12",0,0,0,0,0,0,0,0
"Aruba","2024-03-13",0,0,0,0,0,0,0,0
"Aruba","2024-03-14",0,0,0,0,0,0,0,0
"Aruba","2024-03-15",0,0,0,0,0,0,0,0
"Aruba","2024-03-16",0,0,0,0,0,0,0,0
"Aruba","2024-03-17",0,0,0,0,0,0,0,0
"Aruba","2024-03-18",0,0,0,0,0,0,0,0
"Aruba","2024-03-19",0,0,0,0,0,0,0,0
"Aruba","2024-03-20",0,0,0,0,0,0,0,0
"Aruba","2024-03-21",0,0,0,0,0,0,0,0
"Aruba","2024-03-22",0,0,0,0,0,0,0,0
"Aruba","2024-03-23",0,0,0,0,0,0,0,0
"Aruba","2024-03-24",0,0,0,0,0,0,0,0
"Aruba","2024-03-25",0,0,0,0,0,0,0,0
"Aruba","2024-03-26",0,0,0,0,0,0,0,0
"Aruba","2024-03-27",0,0,0,0,0,0,0,0
"Aruba","2024-03-28",0,0,0,0,0,0,0,0
"Aruba","2024-03-29",0,0,0,0,0,0,0,0
"Aruba","2024-03-30",0,0,0,0,0,0,0,0
"Aruba","2024-03-31",0,0,0,0,0,0,0,0
"Aruba","2024-04-01",0,0,0,0,0,0,0,0
"Aruba","2024-04-02",0,0,0,0,0,0,0,0
"Aruba","2024-04-03",0,0,0,0,0,0,0,0
"Aruba","2024-04-04",0,0,0,0,0,0,0,0
"Aruba","2024-04-05",0,0,0,0,0,0,0,0
"Aruba","2024-04-06",0,0,0,0,0,0,0,0
"Aruba","2024-04-07",0,0,0,0,0,0,0,0
"Aruba","2024-04-08",0,0,0,0,0,0,0,0
"Aruba","2024-04-09",0,0,0,0,0,0,0,0
"Aruba","2024-04-10",0,0,0,0,0,0,0,0
"Aruba","2024-04-11",0,0,0,0,0,0,0,0
"Aruba","2024-04-12",0,0,0,0,0,0,0,0
"Aruba","2024-04-13",0,0,0,0,0,0,0,0
"Aruba","2024-04-14",0,0,0,0,0,0,0,0
"Aruba","2024-04-15",0,0,0,0,0,0,0,0
"Aruba","2024-04-16",0,0,0,0,0,0,0,0
"Aruba","2024-04-17",0,0,0,0,0,0,0,0
"Aruba","2024-04-18",0,0,0,0,0,0,0,0
"Aruba","2024-04-19",0,0,0,0,0,0,0,0
"Aruba","2024-04-20",0,0,0,0,0,0,0,0
"Aruba","2024-04-21",0,0,0,0,0,0,0,0
"Aruba","2024-04-22",0,0,0,0,0,0,0,0
"Aruba","2024-04-23",0,0,0,0,0,0,0,0
"Aruba","2024-04-24",0,0,0,0,0,0,0,0
"Aruba","2024-04-25",0,0,0,0,0,0,0,0
"Aruba","2024-04-26",0,0,0,0,0,0,0,0
"Aruba","2024-04-27",0,0,0,0,0,0,0,0
"Aruba","2024-04-28",0,0,0,0,0,0,0,0
"Aruba","2024-04-29",0,0,0,0,0,0,0,0
"Aruba","2024-04-30",0,0,0,0,0,0,0,0
"Aruba","2024-05-01",0,0,0,0,0,0,0,0
"Aruba","2024-05-02",0,0,0,0,0,0,0,0
"Aruba","2024-05-03",0,0,0,0,0,0,0,0
"Aruba","2024-05-04",0,0,0,0,0,0,0,0
"Aruba","2024-05-05",0,0,0,0,0,0,0,0
"Aruba","2024-05-06",0,0,0,0,0,0,0,0
"Aruba","2024-05-07",0,0,0,0,0,0,0,0
"Aruba","2024-05-08",0,0,0,0,0,0,0,0
"Aruba","2024-05-09",0,0,0,0,0,0,0,0
"Aruba","2024-05-10",0,0,0,0,0,0,0,0
"Aruba","2024-05-11",0,0,0,0,0,0,0,0
"Aruba","2024-05-12",0,0,0,0,0,0,0,0
"Aruba","2024-05-13",0,0,0,0,0,0,0,0
"Aruba","2024-05-14",0,0,0,0,0,0,0,0
"Aruba","2024-05-15",0,0,0,0,0,0,0,0
"Aruba","2024-05-16",0,0,0,0,0,0,0,0
"Aruba","2024-05-17",0,0,0,0,0,0,0,0
"Aruba","2024-05-18",0,0,0,0,0,0,0,0
"Aruba","2024-05-19",0,0,0,0,0,0,0,0
"Aruba","2024-05-20",0,0,0,0,0,0,0,0
"Aruba","2024-05-21",0,0,0,0,0,0,0,0
"Aruba","2024-05-22",0,0,0,0,0,0,0,0
"Aruba","2024-05-23",0,0,0,0,0,0,0,0
"Aruba","2024-05-24",0,0,0,0,0,0,0,0
"Aruba","2024-05-25",0,0,0,0,0,0,0,0
"Aruba","2024-05-26",0,0,0,0,0,0,0,0
"Aruba","2024-05-27",0,0,0,0,0,0,0,0
"Aruba","2024-05-28",0,0,0,0,0,0,0,0
"Aruba","2024-05-29",0,0,0,0,0,0,0,0
"Aruba","2024-05-30",0,0,0,0,0,0,0,0
"Aruba","2024-05-31",0,0,0,0,0,0,0,0
"Aruba","2024-06-01",0,0,0,0,0,0,0,0
"Aruba","2024-06-02",0,0,0,0,0,0,0,0
"Aruba","2024-06-03",0,0,0,0,0,0,0,0
"Aruba","2024-06-04",0,0,0,0,0,0,0,0
"Aruba","2024-06-05",0,0,0,0,0,0,0,0
"Aruba","2024-06-06",0,0,0,0,0,0,0,0
"Aruba","2024-06-07",0,0,0,0,0,0,0,0
"Aruba","2024-06-08",0,0,0,0,0,0,0,0
"Aruba","2024-06-09",0,0,0,0,0,0,0,0
"Aruba","2024-06-10",0,0,0,0,0,0,0,0
"Aruba","2024-06-11",0,0,0,0,0,0,0,0
"Aruba","2024-06-12",0,0,0,0,0,0,0,0
"Aruba","2024-06-13",0,0,0,0,0,0,0,0
"Aruba","2024-06-14",0,0,0,0,0,0,0,0
"Aruba","2024-06-15",0,0,0,0,0,0,0,0
"Aruba","2024-06-16",0,0,0,0,0,0,0,0
"Aruba","2024-06-17",0,0,0,0,0,0,0,0
"Aruba","2024-06-18",0,0,0,0,0,0,0,0
"Aruba","2024-06-19",0,0,0,0,0,0,0,0
"Aruba","2024-06-20",0,0,0,0,0,0,0,0
"Aruba","2024-06-21",0,0,0,0,0,0,0,0
"Aruba","2024-06-22",0,0,0,0,0,0,0,0
"Aruba","2024-06-23",0,0,0,0,0,0,0,0
"Aruba","2024-06-24",0,0,0,0,0,0,0,0
"Aruba","2024-06-25",0,0,0,0,0,0,0,0
"Aruba","2024-06-26",0,0,0,0,0,0,0,0
"Aruba","2024-06-27",0,0,0,0,0,0,0,0
"Aruba","2024-06-28",0,0,0,0,0,0,0,0
"Aruba","2024-06-29",0,0,0,0,0,0,0,0
"Aruba","2024-06-30",0,0,0,0,0,0,0,0
"Aruba","2024-07-01",0,0,0,0,0,0,0,0
"Aruba","2024-07-02",0,0,0,0,0,0,0,0
"Aruba","2024-07-03",0,0,0,0,0,0,0,0
"Aruba","2024-07-04",0,0,0,0,0,0,0,0
"Aruba","2024-07-05",0,0,0,0,0,0,0,0
"Aruba","2024-07-06",0,0,0,0,0,0,0,0
"Aruba","2024-07-07",0,0,0,0,0,0,0,0
"Aruba","2024-07-08",0,0,0,0,0,0,0,0
"Aruba","2024-07-09",0,0,0,0,0,0,0,0
"Aruba","2024-07-10",0,0,0,0,0,0,0,0
"Aruba","2024-07-11",0,0,0,0,0,0,0,0
"Aruba","2024-07-12",0,0,0,0,0,0,0,0
"Aruba","2024-07-13",0,0,0,0,0,0,0,0
"Aruba","2024-07-14",0,0,0,0,0,0,0,0
"Aruba","2024-07-15",0,0,0,0,0,0,0,0
"Aruba","2024-07-16",0,0,0,0,0,0,0,0
"Aruba","2024-07-17",0,0,0,0,0,0,0,0
"Aruba","2024-07-18",0,0,0,0,0,0,0,0
"Aruba","2024-07-19",0,0,0,0,0,0,0,0
"Aruba","2024-07-20",0,0,0,0,0,0,0,0
"Aruba","2024-07-21",0,0,0,0,0,0,0,0
"Aruba","2024-07-22",0,0,0,0,0,0,0,0
"Aruba","2024-07-23",0,0,0,0,0,0,0,0
"Aruba","2024-07-24",0,0,0,0,0,0,0,0
"Aruba","2024-07-25",0,0,0,0,0,0,0,0
"Aruba","2024-07-26",0,0,0,0,0,0,0,0
"Aruba","2024-07-27",0,0,0,0,0,0,0,0
"Aruba","2024-07-28",0,0,0,0,0,0,0,0
"Aruba","2024-07-29",0,0,0,0,0,0,0,0
"Aruba","2024-07-30",0,0,0,0,0,0,0,0
"Aruba","2024-07-31",0,0,0,0,0,0,0,0
"Aruba","2024-08-01",0,0,0,0,0,0,0,0
"Aruba","2024-08-02",0,0,0,0,0,0,0,0
"Aruba","2024-08-03",0,0,0,0,0,0,0,0
"Aruba","2024-08-04",0,0,0,0,0,0,0,0
"Aruba","2024-08-05",0,0,0,0,0,0,0,0
"Aruba","2024-08-06",0,0,0,0,0,0,0,0
"Aruba","2024-08-07",0,0,0,0,0,0,0,0
"Aruba","2024-08-08",0,0,0,0,0,0,0,0
"Aruba","2024-08-09",0,0,0,0,0,0,0,0
"Aruba","2024-08-10",0,0,0,0,0,0,0,0
"Aruba","2024-08-11",0,0,0,0,0,0,0,0
"Aruba","2024-08-12",0,0,0,0,0,0,0,0
"Aruba","2024-08-13",0,0,0,0,0,0,0,0
"Aruba","2024-08-14",0,0,0,0,0,0,0,0
"Aruba","2024-08-15",0,0,0,0,0,0,0,0
"Aruba","2024-08-16",0,0,0,0,0,0,0,0
"Aruba","2024-08-17",0,0,0,0,0,0,0,0
"Aruba","2024-08-18",0,0,0,0,0,0,0,0
"Aruba","2024-08-19",0,0,0,0,0,0,0,0
"Aruba","2024-08-20",0,0,0,0,0,0,0,0
"Aruba","2024-08-21",0,0,0,0,0,0,0,0
"Aruba","2024-08-22",0,0,0,0,0,0,0,0
"Aruba","2024-08-23",0,0,0,0,0,0,0,0
"Aruba","2024-08-24",0,0,0,0,0,0,0,0
"Aruba","2024-08-25",0,0,0,0,0,0,0,0
"Aruba","2024-08-26",0,0,0,0,0,0,0,0
"Aruba","2024-08-27",0,0,0,0,0,0,0,0
"Aruba","2024-08-28",0,0,0,0,0,0,0,0
"Aruba","2024-08-29",0,0,0,0,0,0,0,0
"Aruba","2024-08-30",0,0,0,0,0,0,0,0
"Aruba","2024-08-31",0,0,0,0,0,0,0,0
"Aruba","2024-09-01",0,0,0,0,0,0,0,0
"Aruba","2024-09-02",0,0,0,0,0,0,0,0
"Aruba","2024-09-03",0,0,0,0,0,0,0,0
"Aruba","2024-09-04",0,0,0,0,0,0,0,0
"Aruba","2024-09-05",0,0,0,0,0,0,0,0
"Aruba","2024-09-06",0,0,0,0,0,0,0,0
"Aruba","2024-09-07",0,0,0,0,0,0,0,0
"Aruba","2024-09-08",0,0,0,0,0,0,0,0
"Aruba","2024-09-09",0,0,0,0,0,0,0,0
"Aruba","2024-09-10",0,0,0,0,0,0,0,0
"Aruba","2024-09-11",0,0,0,0,0,0,0,0
"Aruba","2024-09-12",0,0,0,0,0,0,0,0
"Aruba","2024-09-13",0,0,0,0,0,0,0,0
"Aruba","2024-09-14",0,0,0,0,0,0,0,0
"Aruba","2024-09-15",0,0,0,0,0,0,0,0
"Aruba","2024-09-16",0,0,0,0,0,0,0,0
"Aruba","2024-09-17",0,0,0,0,0,0,0,0
"Aruba","2024-09-18",0,0,0,0,0,0,0,0
"Aruba","2024-09-19",0,0,0,0,0,0,0,0
"Aruba","2024-09-20",0,0,0,0,0,0,0,0
"Aruba","2024-09-21",0,0,0,0,0,0,0,0
"Aruba","2024-09-22",0,0,0,0,0,0,0,0
"Aruba","2024-09-23",0,0,0,0,0,0,0,0
"Aruba","2024-09-24",0,0,0,0,0,0,0,0
"Aruba","2024-09-25",0,0,0,0,0,0,0,0
"Aruba","2024-09-26",0,0,0,0,0,0,0,0
"Aruba","2024-09-27",0,0,0,0,0,0,0,0
"Aruba","2024-09-28",0,0,0,0,0,0,0,0
"Aruba","2024-09-29",0,0,0,0,0,0,0,0
"Aruba","2024-09-30",0,0,0,0,0,0,0,0
"Aruba","2024-10-01",0,0,0,0,0,0,0,0
"Aruba","2024-10-02",0,0,0,0,0,0,0,0
"Aruba","2024-10-03",0,0,0,0,0,0,0,0
"Aruba","2024-10-04",0,0,0,0,0,0,0,0
"Aruba","2024-10-05",0,0,0,0,0,0,0,0
"Aruba","2024-10-06",0,0,0,0,0,0,0,0
"Aruba","2024-10-07",0,0,0,0,0,0,0,0
"Aruba","2024-10-08",0,0,0,0,0,0,0,0
"Aruba","2024-10-09",0,0,0,0,0,0,0,0
"Aruba","2024-10-10",0,0,0,0,0,0,0,0
"Aruba","2024-10-11",0,0,0,0,0,0,0,0
"Aruba","2024-10-12",0,0,0,0,0,0,0,0
"Aruba","2024-10-13",0,0,0,0,0,0,0,0
"Aruba","2024-10-14",0,0,0,0,0,0,0,0
"Aruba","2024-10-15",0,0,0,0,0,0,0,0
"Aruba","2024-10-16",0,0,0,0,0,0,0,0
"Aruba","2024-10-17",0,0,0,0,0,0,0,0
"Aruba","2024-10-18",0,0,0,0,0,0,0,0
"Aruba","2024-10-19",0,0,0,0,0,0,0,0
"Aruba","2024-10-20",0,0,0,0,0,0,0,0
"Aruba","2024-10-21",0,0,0,0,0,0,0,0
"Aruba","2024-10-22",0,0,0,0,0,0,0,0
"Aruba","2024-10-23",0,0,0,0,0,0,0,0
"Aruba","2024-10-24",0,0,0,0,0,0,0,0
"Aruba","2024-10-25",0,0,0,0,0,0,0,0
"Aruba","2024-10-26",0,0,0,0,0,0,0,0
"Aruba","2024-10-27",0,0,0,0,0,0,0,0
"Aruba","2024-10-28",0,0,0,0,0,0,0,0
"Aruba","2024-10-29",0,0,0,0,0,0,0,0
"Aruba","2024-10-30",0,0,0,0,0,0,0,0
"Aruba","2024-10-31",0,0,0,0,0,0,0,0
"Aruba","2024-11-01",0,0,0,0,0,0,0,0
"Aruba","2024-11-02",0,0,0,0,0,0,0,0
"Aruba","2024-11-03",0,0,0,0,0,0,0,0
"Aruba","2024-11-04",0,0,0,0,0,0,0,0
"Aruba","2024-11-05",0,0,0,0,0,0,0,0
"Aruba","2024-11-06",0,0,0,0,0,0,0,0
"Aruba","2024-11-07",0,0,0,0,0,0,0,0
"Aruba","2024-11-08",0,0,0,0,0,0,0,0
"Aruba","2024-11-09",0,0,0,0,0,0,0,0
"Aruba","2024-11-10",0,0,0,0,0,0,0,0
"Aruba","2024-11-11",0,0,0,0,0,0,0,0
"Aruba","2024-11-12",0,0,0,0,0,0,0,0
"Aruba","2024-11-13",0,0,0,0,0,0,0,0
"Aruba","2024-11-14",0,0,0,0,0,0,0,0
"Aruba","2024-11-15",0,0,0,0,0,0,0,0
"Aruba","2024-11-16",0,0,0,0,0,0,0,0
"Aruba","2024-11-17",0,0,0,0,0,0,0,0
"Aruba","2024-11-18",0,0,0,0,0,0,0,0
"Aruba","2024-11-19",0,0,0,0,0,0,0,0
"Aruba","2024-11-20",0,0,0,0,0,0,0,0
"Aruba","2024-11-21",0,0,0,0,0,0,0,0
"Aruba","2024-11-22",0,0,0,0,0,0,0,0
"Aruba","2024-11-23",0,0,0,0,0,0,0,0
"Aruba","2024-11-24",0,0,0,0,0,0,0,0
"Aruba","2024-11-25",0,0,0,0,0,0,0,0
"Aruba","2024-11-26",0,0,0,0,0,0,0,0
"Aruba","2024-11-27",0,0,0,0,0,0,0,0
"Aruba","2024-11-28",0,0,0,0,0,0,0,0
"Aruba","2024-11-29",0,0,0,0,0,0,0,0
"Aruba","2024-11-30",0,0,0,0,0,0,0,0
"Aruba","2024-12-01",0,0,0,0,0,0,0,0
"Aruba","2024-12-02",0,0,0,0,0,0,0,0
"Aruba","2024-12-03",0,0,0,0,0,0,0,0
"Aruba","2024-12-04",0,0,0,0,0,0,0,0
"Aruba","2024-12-05",0,0,0,0,0,0,0,0
"Aruba","2024-12-06",0,0,0,0,0,0,0,0
"Aruba","2024-12-07",0,0,0,0,0,0,0,0
"Aruba","2024-12-08",0,0,0,0,0,0,0,0
"Aruba","2024-12-09",0,0,0,0,0,0,0,0
"Aruba","2024-12-10",0,0,0,0,0,0,0,0
"Aruba","2024-12-11",0,0,0,0,0,0,0,0
"Aruba","2024-12-12",0,0,0,0,0,0,0,0
"Aruba","2024-12-13",0,0,0,0,0,0,0,0
"Aruba","2024-12-14",0,0,0,0,0,0,0,0
"Aruba","2024-12-15",0,0,0,0,0,0,0,0
"Aruba","2024-12-16",0,0,0,0,0,0,0,0
"Aruba","2024-12-17",0,0,0,0,0,0,0,0
"Aruba","2024-12-18",0,0,0,0,0,0,0,0
"Aruba","2024-12-19",0,0,0,0,0,0,0,0
"Aruba","2024-12-20",0,0,0,0,0,0,0,0
"Aruba","2024-12-21",0,0,0,0,0,0,0,0
"Aruba","2024-12-22",0,0,0,0,0,0,0,0
"Aruba","2024-12-23",0,0,0,0,0,0,0,0
"Aruba","2024-12-24",0,0,0,0,0,0,0,0
"Aruba","2024-12-25",0,0,0,0,0,0,0,0
"Aruba","2024-12-26",0,0,0,0,0,0,0,0
"Aruba","2024-12-27",0,0,0,0,0,0,0,0
"Aruba","2024-12-28",0,0,0,0,0,0,0,0
"Aruba","2024-12-29",0,0,0,0,0,0,0,0
"Aruba","2024-12-30",0,0,0,0,0,0,0,0
"Aruba","2024-12-31",0,0,0,0,0,0,0,0
"Aruba","2025-01-01",0,0,0,0,0,0,0,0
"Aruba","2025-01-02",0,0,0,0,0,0,0,0
"Aruba","2025-01-03",0,0,0,0,0,0,0,0
"Aruba","2025-01-04",0,0,0,0,0,0,0,0
"Aruba","2025-01-05",0,0,0,0,0,0,0,0
"Aruba","2025-01-06",0,0,0,0,0,0,0,0
"Aruba","2025-01-07",0,0,0,0,0,0,0,0
"Aruba","2025-01-08",0,0,0,0,0,0,0,0
"Aruba","2025-01-09",0,0,0,0,0,0,0,0
"Aruba","2025-01-10",0,0,0,0,0,0,0,0
"Aruba","2025-01-11",0,0,0,0,0,0,0,0
"Aruba","2025-01-12",0,0,0,0,0,0,0,0
"Aruba","2025-01-13",0,0,0,0,0,0,0,0
"Asia","2024-01-01",0,0,0,0,0,0,0,0
"Asia","2024-01-02",0,0,0,0,0,0,0,0
"Asia","2024-01-03",0,0,0,0,0,0,0,0
"Asia","2024-01-04",0,2,2,0,2,2,0,0
"Asia","2024-01-05",0,1,3,0,1,3,0,0
"Asia","2024-01-06",0,0,3,0,0,3,0,0
"Asia","2024-01-07",0,0,3,0,0,3,0,0
"Asia","2024-01-08",0,0,3,0,1,4,0,0
"Asia","2024-01-09",0,1,4,0,0,4,0,0
"Asia","2024-01-10",0,14,18,0,14,18,0,0
"Asia","2024-01-11",0,1,19,0,1,19,0,0
"Asia","2024-01-12",0,1,20,0,1,20,0,0
"Asia","2024-01-13",0,0,20,0,0,20,0,0
"Asia","2024-01-14",0,0,20,0,0,20,0,0
"Asia","2024-01-15",0,0,20,0,1,21,0,0
"Asia","2024-01-16",0,0,20,0,0,21,0,0
"Asia","2024-01-17",0,1,21,0,0,21,0,0
"Asia","2024-01-18",0,0,21,0,1,22,0,0
"Asia","2024-01-19",0,2,23,0,1,23,0,0
"Asia","2024-01-20",0,2,25,0,2,25,0,0
"Asia","2024-01-21",0,0,25,0,2,27,0,0
"Asia","2024-01-22",0,0,25,0,1,28,0,0
"Asia","2024-01-23",0,0,25,0,1,29,0,0
"Asia","2024-01-24",0,6,31,0,2,31,0,0
"Asia","2024-01-25",0,0,31,0,22,53,0,0
"Asia","2024-01-26",0,0,31,0,23,76,0,0
"Asia","2024-01-27",0,0,31,0,22,98,0,0
"Asia","2024-01-28",0,0,31,0,22,120,0,0
"Asia","2024-01-29",0,0,31,0,22,142,0,0
"Asia","2024-01-30",0,0,31,0,23,165,0,0
"Asia","2024-01-31",0,156,187,0,22,187,0,0
"Asia","2024-02-01",0,0,187,0,2,189,0,0
"Asia","2024-02-02",0,5,192,0,3,192,0,0
"Asia","2024-02-03",0,0,192,0,1,193,0,0
"Asia","2024-02-04",0,0,192,0,1,194,0,0
"Asia","2024-02-05",0,3,195,0,1,195,0,0
"Asia","2024-02-06",0,0,195,0,1,196,0,0
"Asia","2024-02-07",0,0,195,0,1,197,0,0
"Asia","2024-02-08",0,0,195,0,2,199,0,0
"Asia","2024-02-09",0,5,200,0,1,200,0,0
"Asia","2024-02-10",0,0,200,0,0,200,0,0
"Asia","2024-02-11",0,0,200,0,0,200,0,0
"Asia","2024-02-12",0,0,200,0,0,200,0,0
"Asia","2024-02-13",0,0,200,0,1,201,0,0
"Asia","2024-02-14",0,0,200,0,0,201,0,0
"Asia","2024-02-15",0,1,201,0,0,201,0,0
"Asia","2024-02-16",0,1,202,0,1,202,0,0
"Asia","2024-02-17",0,0,202,0,1,203,0,0
"Asia","2024-02-18",0,0,202,0,2,205,0,0
"Asia","2024-02-19",0,0,202,0,1,206,0,0
"Asia","2024-02-20",0,0,202,0,2,208,0,0
"Asia","2024-02-21",0,0,202,0,1,209,0,0
"Asia","2024-02-22",0,0,202,0,2,211,0,0
"Asia","2024-02-23",0,10,212,0,1,212,0,0
"Asia","2024-02-24",0,0,212,0,3,215,0,0
"Asia","2024-02-25",0,0,212,0,3,218,0,0
"Asia","2024-02-26",0,0,212,0,3,221,0,0
"Asia","2024-02-27",0,0,212,0,3,224,0,0
"Asia","2024-02-28",0,15,227,0,3,227,0,0
"Asia","2024-02-29",0,114,341,0,114,341,0,0
"Asia","2024-03-01",0,4,345,0,4,345,0,0
"Asia","2024-03-02",0,1,346,0,1,346,0,0
"Asia","2024-03-03",0,0,346,0,2,348,0,0
"Asia","2024-03-04",0,0,346,0,3,351,0,0
"Asia","2024-03-05",0,0,346,0,3,354,0,0
"Asia","2024-03-06",0,10,356,0,2,356,0,0
"Asia","2024-03-07",0,0,356,0,2,358,0,0
"Asia","2024-03-08",0,3,359,0,1,359,0,0
"Asia","2024-03-09",0,0,359,0,0,359,0,0
"Asia","2024-03-10",0,0,359,0,0,359,0,0
"Asia","2024-03-11",0,0,359,0,0,359,0,0
"Asia","2024-03-12",0,0,359,0,1,360,0,0
"Asia","2024-03-13",0,0,359,0,0,360,0,0
"Asia","2024-03-14",0,1,360,0,0,360,0,0
"Asia","2024-03-15",0,2,362,0,2,362,0,0
"Asia","2024-03-16",0,0,362,0,0,362,0,0
"Asia","2024-03-17",0,0,362,0,0,362,0,0
"Asia","2024-03-18",0,0,362,0,0,362,0,0
"Asia","2024-03-19",0,0,362,0,1,363,0,0
"Asia","2024-03-20",0,0,362,0,0,363,0,0
"Asia","2024-03-21",0,0,362,0,0,363,0,0
"Asia","2024-03-22",0,1,363,0,0,363,0,0
"Asia","2024-03-23",0,0,363,0,3,366,0,0
"Asia","2024-03-24",0,0,363,0,3,369,0,0
"Asia","2024-03-25",0,0,363,0,3,372,0,0
"Asia","2024-03-26",0,12,375,0,3,375,0,0
"Asia","2024-03-27",0,0,375,0,17,392,0,0
"Asia","2024-03-28",0,0,375,0,16,408,0,0
"Asia","2024-03-29",0,0,375,0,17,425,0,0
"Asia","2024-03-30",0,0,375,0,16,441,0,0
"Asia","2024-03-31",0,83,458,0,17,458,0,0
"Asia","2024-04-01",0,6,464,0,6,464,0,0
"Asia","2024-04-02",0,1,465,0,1,465,0,0
"Asia","2024-04-03",0,0,465,0,1,466,0,0
"Asia","2024-04-04",0,0,465,0,1,467,0,0
"Asia","2024-04-05",0,3,468,0,1,468,0,0
"Asia","2024-04-06",0,0,468,0,0,468,0,0
"Asia","2024-04-07",0,0,468,0,0,468,0,0
"Asia","2024-04-08",0,0,468,0,1,469,0,0
"Asia","2024-04-09",0,1,469,0,0,469,0,0
"Asia","2024-04-10",0,0,469,0,1,470,0,0
"Asia","2024-04-11",0,0,469,0,0,470,0,0
"Asia","2024-04-12",0,2,471,0,1,471,0,0
"Asia","2024-04-13",0,0,471,0,0,471,0,0
"Asia","2024-04-14",0,0,471,0,0,471,0,0
"Asia","2024-04-15",0,0,471,0,0,471,0,0
"Asia","2024-04-16",0,0,471,0,1,472,0,0
"Asia","2024-04-17",0,0,471,0,0,472,0,0
"Asia","2024-04-18",0,0,471,0,0,472,0,0
"Asia","2024-04-19",0,1,472,0,0,472,0,0
"Asia","2024-04-20",0,1,473,0,1,473,0,0
"Asia","2024-04-21",0,0,473,0,0,473,0,0
"Asia","2024-04-22",0,0,473,0,1,474,0,0
"Asia","2024-04-23",0,0,473,0,0,474,0,0
"Asia","2024-04-24",0,0,473,0,0,474,0,0
"Asia","2024-04-25",0,0,473,0,1,475,0,0
"Asia","2024-04-26",0,2,475,0,0,475,0,0
"Asia","2024-04-27",0,1,476,0,1,476,0,0
"Asia","2024-04-28",0,0,476,0,22,498,0,0
"Asia","2024-04-29",0,0,476,0,22,520,0,0
"Asia","2024-04-30",0,66,542,0,22,542,0,0
"Asia","2024-05-01",0,0,542,0,0,542,0,0
"Asia","2024-05-02",0,0,542,0,0,542,0,0
"Asia","2024-05-03",0,0,542,0,0,542,0,0
"Asia","2024-05-04",0,0,542,0,1,543,0,0
"Asia","2024-05-05",0,0,542,0,0,543,0,0
"Asia","2024-05-06",0,0,542,0,0,543,0,0
"Asia","2024-05-07",0,1,543,0,0,543,0,0
"Asia","2024-05-08",0,0,543,0,8,551,0,0
"Asia","2024-05-09",0,0,543,0,9,560,0,0
"Asia","2024-05-10",0,25,568,0,8,568,0,0
"Asia","2024-05-11",0,0,568,0,0,568,0,0
"Asia","2024-05-12",0,0,568,0,0,568,0,0
"Asia","2024-05-13",0,0,568,0,1,569,0,0
"Asia","2024-05-14",0,1,569,0,0,569,0,0
"Asia","2024-05-15",0,0,569,0,0,569,0,0
"Asia","2024-05-16",0,0,569,0,0,569,0,0
"Asia","2024-05-17",0,0,569,0,0,569,0,0
"Asia","2024-05-18",0,0,569,0,0,569,0,0
"Asia","2024-05-19",0,0,569,0,1,570,0,0
"Asia","2024-05-20",0,0,569,0,0,570,0,0
"Asia","2024-05-21",0,0,569,0,0,570,0,0
"Asia","2024-05-22",0,1,570,0,0,570,0,0
"Asia","2024-05-23",0,0,570,0,2,572,0,0
"Asia","2024-05-24",0,4,574,0,2,574,0,0
"Asia","2024-05-25",0,0,574,0,0,574,0,0
"Asia","2024-05-26",0,0,574,0,1,575,0,0
"Asia","2024-05-27",0,1,575,0,0,575,0,0
"Asia","2024-05-28",0,0,575,0,16,591,0,0
"Asia","2024-05-29",0,0,575,0,17,608,0,0
"Asia","2024-05-30",0,49,624,0,16,624,0,0
"Asia","2024-05-31",0,59,683,0,59,683,0,0
"Asia","2024-06-01",0,0,683,0,0,683,0,0
"Asia","2024-06-02",0,0,683,0,0,683,0,0
"Asia","2024-06-03",0,0,683,0,0,683,0,0
"Asia","2024-06-04",0,0,683,0,1,684,0,0
"Asia","2024-06-05",0,0,683,0,0,684,0,0
"Asia","2024-06-06",0,0,683,0,0,684,0,0
"Asia","2024-06-07",0,0,683,0,0,684,0,0
"Asia","2024-06-08",0,0,683,0,0,684,0,0
"Asia","2024-06-09",0,0,683,0,1,685,0,0
"Asia","2024-06-10",0,0,683,0,0,685,0,0
"Asia","2024-06-11",0,0,683,0,0,685,0,0
"Asia","2024-06-12",0,0,683,0,0,685,0,0
"Asia","2024-06-13",0,0,683,0,0,685,0,0
"Asia","2024-06-14",0,0,683,0,0,685,0,0
"Asia","2024-06-15",0,0,683,0,0,685,0,0
"Asia","2024-06-16",0,0,683,0,1,686,0,0
"Asia","2024-06-17",0,0,683,0,0,686,0,0
"Asia","2024-06-18",0,0,683,0,0,686,0,0
"Asia","2024-06-19",0,0,683,0,0,686,0,0
"Asia","2024-06-20",0,0,683,0,0,686,0,0
"Asia","2024-06-21",0,0,683,0,1,687,0,0
"Asia","2024-06-22",0,0,683,0,0,687,0,0
"Asia","2024-06-23",0,0,683,0,0,687,0,0
"Asia","2024-06-24",0,4,687,0,0,687,0,0
"Asia","2024-06-25",0,6,693,0,6,693,0,0
"Asia","2024-06-26",0,0,693,0,2,695,0,0
"Asia","2024-06-27",0,0,693,0,3,698,0,0
"Asia","2024-06-28",0,7,700,0,2,700,0,0
"Asia","2024-06-29",0,0,700,0,35,735,0,0
"Asia","2024-06-30",0,70,770,0,35,770,0,0
"Asia","2024-07-01",0,0,770,0,0,770,0,0
"Asia","2024-07-02",0,0,770,0,0,770,0,0
"Asia","2024-07-03",0,0,770,0,1,771,0,0
"Asia","2024-07-04",0,0,770,0,0,771,0,0
"Asia","2024-07-05",0,0,770,0,0,771,0,0
"Asia","2024-07-06",0,0,770,0,1,772,0,0
"Asia","2024-07-07",0,0,770,0,0,772,0,0
"Asia","2024-07-08",0,2,772,0,0,772,0,0
"Asia","2024-07-09",0,0,772,0,0,772,0,0
"Asia","2024-07-10",0,0,772,0,1,773,0,0
"Asia","2024-07-11",0,0,772,0,1,774,0,0
"Asia","2024-07-12",0,2,774,0,0,774,0,0
"Asia","2024-07-13",0,1,775,0,1,775,0,0
"Asia","2024-07-14",0,0,775,0,2,777,0,0
"Asia","2024-07-15",0,0,775,0,3,780,0,0
"Asia","2024-07-16",0,7,782,0,2,782,0,0
"Asia","2024-07-17",0,0,782,0,1,783,0,0
"Asia","2024-07-18",0,0,782,0,1,784,0,0
"Asia","2024-07-19",0,0,782,0,0,784,0,0
"Asia","2024-07-20",0,0,782,0,1,785,0,0
"Asia","2024-07-21",0,0,782,0,1,786,0,0
"Asia","2024-07-22",0,0,782,0,0,786,0,0
"Asia","2024-07-23",0,0,782,0,1,787,0,0
"Asia","2024-07-24",0,0,782,0,1,788,0,0
"Asia","2024-07-25",0,0,782,0,1,789,0,0
"Asia","2024-07-26",0,0,782,0,1,790,0,0
"Asia","2024-07-27",0,0,782,0,0,790,0,0
"Asia","2024-07-28",0,9,791,0,1,791,0,0
"Asia","2024-07-29",0,0,791,0,20,811,0,0
"Asia","2024-07-30",0,39,830,0,19,830,0,0
"Asia","2024-07-31",0,27,857,0,27,857,0,0
"Asia","2024-08-01",0,0,857,0,3,860,0,0
"Asia","2024-08-02",0,6,863,0,3,863,0,0
"Asia","2024-08-03",0,0,863,0,0,863,0,0
"Asia","2024-08-04",0,0,863,0,1,864,0,0
"Asia","2024-08-05",0,1,864,0,0,864,0,0
"Asia","2024-08-06",0,2,866,0,2,866,0,0
"Asia","2024-08-07",0,0,866,0,1,867,0,0
"Asia","2024-08-08",0,0,866,0,0,867,0,0
"Asia","2024-08-09",0,0,866,0,1,868,0,0
"Asia","2024-08-10",0,0,866,0,1,869,0,0
"Asia","2024-08-11",0,0,866,0,1,870,0,0
"Asia","2024-08-12",0,0,866,0,0,870,0,0
"Asia","2024-08-13",0,5,871,0,1,871,0,0
"Asia","2024-08-14",0,1,872,0,1,872,0,0
"Asia","2024-08-15",0,2,874,0,2,874,0,0
"Asia","2024-08-16",0,0,874,0,0,874,0,0
"Asia","2024-08-17",0,0,874,0,0,874,0,0
"Asia","2024-08-18",0,0,874,0,1,875,0,0
"Asia","2024-08-19",0,1,875,0,0,875,0,0
"Asia","2024-08-20",0,4,879,0,4,879,0,0
"Asia","2024-08-21",0,1,880,0,1,880,0,0
"Asia","2024-08-22",0,2,882,0,2,882,0,0
"Asia","2024-08-23",0,1,883,0,1,883,0,0
"Asia","2024-08-24",0,0,883,0,0,883,0,0
"Asia","2024-08-25",0,0,883,0,0,883,0,0
"Asia","2024-08-26",0,0,883,0,1,884,0,0
"Asia","2024-08-27",0,1,884,0,0,884,0,0
"Asia","2024-08-28",0,4,888,0,4,888,0,0
"Asia","2024-08-29",0,0,888,0,23,911,0,0
"Asia","2024-08-30",0,0,888,0,23,934,0,0
"Asia","2024-08-31",0,69,957,0,23,957,0,0
"Asia","2024-09-01",0,3,960,0,3,960,0,0
"Asia","2024-09-02",0,1,961,0,1,961,0,0
"Asia","2024-09-03",0,0,961,0,0,961,0,0
"Asia","2024-09-04",0,0,961,0,0,961,0,0
"Asia","2024-09-05",0,0,961,0,0,961,0,0
"Asia","2024-09-06",0,0,961,0,1,962,0,0
"Asia","2024-09-07",0,0,961,0,0,962,0,0
"Asia","2024-09-08",0,1,962,0,0,962,0,0
"Asia","2024-09-09",0,0,962,0,2,964,0,0
"Asia","2024-09-10",0,0,962,0,1,965,0,0
"Asia","2024-09-11",0,0,962,0,2,967,0,0
"Asia","2024-09-12",0,0,962,0,2,969,0,0
"Asia","2024-09-13",0,0,962,0,2,971,0,0
"Asia","2024-09-14",0,0,962,0,1,972,0,0
"Asia","2024-09-15",0,12,974,0,2,974,0,0
"Asia","2024-09-16",0,0,974,0,0,974,0,0
"Asia","2024-09-17",0,0,974,0,1,975,0,0
"Asia","2024-09-18",0,1,975,0,0,975,0,0
"Asia","2024-09-19",0,0,975,0,1,976,0,0
"Asia","2024-09-20",0,0,975,0,0,976,0,0
"Asia","2024-09-21",0,0,975,0,1,977,0,0
"Asia","2024-09-22",0,0,975,0,0,977,0,0
"Asia","2024-09-23",0,3,978,0,1,978,0,0
"Asia","2024-09-24",0,0,978,0,5,983,0,0
"Asia","2024-09-25",0,0,978,0,5,988,0,0
"Asia","2024-09-26",0,15,993,0,5,993,0,0
"Asia","2024-09-27",0,0,993,0,2,995,0,0
"Asia","2024-09-28",0,0,993,0,2,997,0,0
"Asia","2024-09-29",0,6,999,0,2,999,0,0
"Asia","2024-09-30",0,20,1019,0,20,1019,0,0
"Asia","2024-10-01",0,6,1025,0,6,1025,0,0
"Asia","2024-10-02",0,1,1026,0,1,1026,0,0
"Asia","2024-10-03",0,1,1027,0,1,1027,0,0
"Asia","2024-10-04",0,1,1028,0,1,1028,0,0
"Asia","2024-10-05",0,0,1028,0,0,1028,0,0
"Asia","2024-10-06",0,0,1028,0,1,1029,0,0
"Asia","2024-10-07",0,0,1028,0,0,1029,0,0
"Asia","2024-10-08",0,0,1028,0,0,1029,0,0
"Asia","2024-10-09",0,0,1028,0,1,1030,0,0
"Asia","2024-10-10",0,2,1030,0,0,1030,0,0
"Asia","2024-10-11",0,2,1032,0,2,1032,0,0
"Asia","2024-10-12",0,0,1032,0,0,1032,0,0
"Asia","2024-10-13",0,0,1032,0,1,1033,0,0
"Asia","2024-10-14",0,0,1032,0,0,1033,0,0
"Asia","2024-10-15",0,0,1032,0,0,1033,0,0
"Asia","2024-10-16",0,0,1032,0,0,1033,0,0
"Asia","2024-10-17",0,0,1032,0,1,1034,0,0
"Asia","2024-10-18",0,2,1034,0,0,1034,0,0
"Asia","2024-10-19",0,0,1034,0,15,1049,0,0
"Asia","2024-10-20",0,0,1034,0,16,1065,0,0
"Asia","2024-10-21",0,46,1080,0,15,1080,0,0
"Asia","2024-10-22",0,0,1080,0,1,1081,0,0
"Asia","2024-10-23",0,2,1082,0,1,1082,0,0
"Asia","2024-10-24",0,0,1082,0,1,1083,0,0
"Asia","2024-10-25",0,0,1082,0,0,1083,0,0
"Asia","2024-10-26",0,0,1082,0,1,1084,0,0
"Asia","2024-10-27",0,0,1082,0,1,1085,0,0
"Asia","2024-10-28",0,0,1082,0,0,1085,0,0
"Asia","2024-10-29",0,4,1086,0,1,1086,0,0
"Asia","2024-10-30",0,1,1087,0,1,1087,0,0
"Asia","2024-10-31",0,14,1101,0,14,1101,0,0
"Asia","2024-11-01",0,2,1103,0,2,1103,0,0
"Asia","2024-11-02",0,0,1103,0,1,1104,0,0
"Asia","2024-11-03",0,0,1103,0,0,1104,0,0
"Asia","2024-11-04",0,0,1103,0,1,1105,0,0
"Asia","2024-11-05",0,0,1103,0,0,1105,0,0
"Asia","2024-11-06",0,3,1106,0,1,1106,0,0
"Asia","2024-11-07",0,0,1106,0,1,1107,0,0
"Asia","2024-11-08",0,0,1106,0,1,1108,0,0
"Asia","2024-11-09",0,0,1106,0,0,1108,0,0
"Asia","2024-11-10",0,0,1106,0,1,1109,0,0
"Asia","2024-11-11",0,0,1106,0,1,1110,0,0
"Asia","2024-11-12",0,0,1106,0,1,1111,0,0
"Asia","2024-11-13",0,0,1106,0,0,1111,0,0
"Asia","2024-11-14",0,0,1106,0,1,1112,0,0
"Asia","2024-11-15",0,7,1113,0,1,1113,0,0
"Asia","2024-11-16",0,0,1113,0,0,1113,0,0
"Asia","2024-11-17",0,0,1113,0,0,1113,0,0
"Asia","2024-11-18",0,0,1113,0,1,1114,0,0
"Asia","2024-11-19",0,1,1114,0,0,1114,0,0
"Asia","2024-11-20",0,0,1114,0,19,1133,0,0
"Asia","2024-11-21",0,38,1152,0,19,1152,0,0
"Asia","2024-11-22",0,0,1152,0,1,1153,0,0
"Asia","2024-11-23",0,0,1152,0,1,1154,0,0
"Asia","2024-11-24",0,0,1152,0,0,1154,0,0
"Asia","2024-11-25",0,0,1152,0,1,1155,0,0
"Asia","2024-11-26",0,4,1156,0,1,1156,0,0
"Asia","2024-11-27",0,24,1180,0,24,1180,0,0
"Asia","2024-11-28",0,0,1180,0,0,1180,0,0
"Asia","2024-11-29",0,1,1181,0,1,1181,0,0
"Asia","2024-11-30",0,7,1188,0,7,1188,0,0
"Asia","2024-12-01",0,0,1188,0,1,1189,0,0
"Asia","2024-12-02",0,0,1188,0,0,1189,0,0
"Asia","2024-12-03",0,2,1190,0,1,1190,0,0
"Asia","2024-12-04",0,0,1190,0,0,1190,0,0
"Asia","2024-12-05",0,0,1190,0,0,1190,0,0
"Asia","2024-12-06",0,0,1190,0,0,1190,0,0
"Asia","2024-12-07",0,0,1190,0,1,1191,0,0
"Asia","2024-12-08",0,0,1190,0,0,1191,0,0
"Asia","2024-12-09",0,1,1191,0,0,1191,0,0
"Asia","2024-12-10",0,1,1192,0,1,1192,0,0
"Asia","2024-12-11",0,0,1192,0,0,1192,0,0
"Asia","2024-12-12",0,0,1192,0,0,1192,0,0
"Asia","2024-12-13",0,0,1192,0,0,1192,0,0
"Asia","2024-12-14",0,0,1192,0,0,1192,0,0
"Asia","2024-12-15",0,0,1192,0,0,1192,0,0
"Asia","2024-12-16",0,0,1192,0,0,1192,0,0
"Asia","2024-12-17",0,0,1192,0,0,1192,0,0
"Asia","2024-12-18",0,0,1192,0,0,1192,0,0
"Asia","2024-12-19",0,0,1192,0,0,1192,0,0
"Asia","2024-12-20",0,0,1192,0,0,1192,0,0
"Asia","2024-12-21",0,0,1192,0,0,1192,0,0
"Asia","2024-12-22",0,0,1192,0,0,1192,0,0
"Asia","2024-12-23",0,0,1192,0,0,1192,0,0
"Asia","2024-12-24",0,0,1192,0,0,1192,0,0
"Asia","2024-12-25",0,0,1192,0,0,1192,0,0
"Asia","2024-12-26",0,0,1192,0,0,1192,0,0
"Asia","2024-12-27",0,0,1192,0,0,1192,0,0
"Asia","2024-12-28",0,0,1192,0,0,1192,0,0
"Asia","2024-12-29",0,0,1192,0,0,1192,0,0
"Asia","2024-12-30",0,0,1192,0,0,1192,0,0
"Asia","2024-12-31",0,0,1192,0,0,1192,0,0
"Asia","2025-01-01",0,0,1192,0,0,1192,0,0
"Asia","2025-01-02",0,0,1192,0,0,1192,0,0
"Asia","2025-01-03",0,0,1192,0,0,1192,0,0
"Asia","2025-01-04",0,0,1192,0,0,1192,0,0
"Asia","2025-01-05",0,0,1192,0,0,1192,0,0
"Asia","2025-01-06",0,0,1192,0,0,1192,0,0
"Asia","2025-01-07",0,0,1192,0,0,1192,0,0
"Asia","2025-01-08",0,0,1192,0,0,1192,0,0
"Asia","2025-01-09",0,0,1192,0,0,1192,0,0
"Asia","2025-01-10",0,0,1192,0,0,1192,0,0
"Asia","2025-01-11",0,0,1192,0,0,1192,0,0
"Asia","2025-01-12",0,0,1192,0,0,1192,0,0
"Asia","2025-01-13",0,0,1192,0,0,1192,0,0
"Australia","2024-01-01",0,0,0,0,0,0,0,0
"Australia","2024-01-02",0,0,0,0,0,0,0,0
"Australia","2024-01-03",0,0,0,0,0,0,0,0
"Australia","2024-01-04",0,0,0,0,0,0,0,0
"Australia","2024-01-05",0,0,0,0,0,0,0,0
"Australia","2024-01-06",0,0,0,0,0,0,0,0
"Australia","2024-01-07",0,0,0,0,0,0,0,0
"Australia","2024-01-08",0,0,0,0,0,0,0,0
"Australia","2024-01-09",0,0,0,0,0,0,0,0
"Australia","2024-01-10",0,0,0,0,0,0,0,0
"Australia","2024-01-11",0,0,0,0,0,0,0,0
"Australia","2024-01-12",0,0,0,0,0,0,0,0
"Australia","2024-01-13",0,0,0,0,0,0,0,0
"Australia","2024-01-14",0,0,0,0,0,0,0,0
"Australia","2024-01-15",0,0,0,0,0,0,0,0
"Australia","2024-01-16",0,0,0,0,0,0,0,0
"Australia","2024-01-17",0,0,0,0,0,0,0,0
"Australia","2024-01-18",0,0,0,0,0,0,0,0
"Australia","2024-01-19",0,0,0,0,0,0,0,0
"Australia","2024-01-20",0,0,0,0,0,0,0,0
"Australia","2024-01-21",0,0,0,0,0,0,0,0
"Australia","2024-01-22",0,0,0,0,0,0,0,0
"Australia","2024-01-23",0,0,0,0,0,0,0,0
"Australia","2024-01-24",0,0,0,0,0,0,0,0
"Australia","2024-01-25",0,0,0,0,0,0,0,0
"Australia","2024-01-26",0,0,0,0,0,0,0,0
"Australia","2024-01-27",0,0,0,0,0,0,0,0
"Australia","2024-01-28",0,0,0,0,0,0,0,0
"Australia","2024-01-29",0,0,0,0,0,0,0,0
"Australia","2024-01-30",0,0,0,0,0,0,0,0
"Australia","2024-01-31",0,6,6,0,6,6,0,0
"Australia","2024-02-01",0,0,6,0,0,6,0,0
"Australia","2024-02-02",0,0,6,0,0,6,0,0
"Australia","2024-02-03",0,0,6,0,0,6,0,0
"Australia","2024-02-04",0,0,6,0,0,6,0,0
"Australia","2024-02-05",0,0,6,0,0,6,0,0
"Australia","2024-02-06",0,0,6,0,0,6,0,0
"Australia","2024-02-07",0,0,6,0,0,6,0,0
"Australia","2024-02-08",0,0,6,0,0,6,0,0
"Australia","2024-02-09",0,0,6,0,0,6,0,0
"Australia","2024-02-10",0,0,6,0,1,7,0,0
"Australia","2024-02-11",0,0,6,0,0,7,0,0
"Australia","2024-02-12",0,0,6,0,0,7,0,0
"Australia","2024-02-13",0,0,6,0,0,7,0,0
"Australia","2024-02-14",0,0,6,0,0,7,0,0
"Australia","2024-02-15",0,0,6,0,0,7,0,0
"Australia","2024-02-16",0,0,6,0,0,7,0,0
"Australia","2024-02-17",0,0,6,0,0,7,0,0
"Australia","2024-02-18",0,0,6,0,0,7,0,0
"Australia","2024-02-19",0,0,6,0,0,7,0,0
"Australia","2024-02-20",0,0,6,0,0,7,0,0
"Australia","2024-02-21",0,0,6,0,0,7,0,0
"Australia","2024-02-22",0,0,6,0,0,7,0,0
"Australia","2024-02-23",0,0,6,0,0,7,0,0
"Australia","2024-02-24",0,0,6,0,0,7,0,0
"Australia","2024-02-25",0,0,6,0,0,7,0,0
"Australia","2024-02-26",0,0,6,0,0,7,0,0
"Australia","2024-02-27",0,0,6,0,1,8,0,0
"Australia","2024-02-28",0,0,6,0,0,8,0,0
"Australia","2024-02-29",0,0,6,0,0,8,0,0
"Australia","2024-03-01",0,0,6,0,0,8,0,0
"Australia","2024-03-02",0,0,6,0,0,8,0,0
"Australia","2024-03-03",0,0,6,0,0,8,0,0
"Australia","2024-03-04",0,0,6,0,0,8,0,0
"Australia","2024-03-05",0,0,6,0,0,8,0,0
"Australia","2024-03-06",0,0,6,0,0,8,0,0
"Australia","2024-03-07",0,0,6,0,0,8,0,0
"Australia","2024-03-08",0,0,6,0,0,8,0,0
"Australia","2024-03-09",0,0,6,0,0,8,0,0
"Australia","2024-03-10",0,0,6,0,0,8,0,0
"Australia","2024-03-11",0,0,6,0,0,8,0,0
"Australia","2024-03-12",0,0,6,0,0,8,0,0
"Australia","2024-03-13",0,0,6,0,0,8,0,0
"Australia","2024-03-14",0,0,6,0,0,8,0,0
"Australia","2024-03-15",0,0,6,0,0,8,0,0
"Australia","2024-03-16",0,0,6,0,0,8,0,0
"Australia","2024-03-17",0,0,6,0,1,9,0,0
"Australia","2024-03-18",0,0,6,0,0,9,0,0
"Australia","2024-03-19",0,0,6,0,0,9,0,0
"Australia","2024-03-20",0,0,6,0,0,9,0,0
"Australia","2024-03-21",0,0,6,0,0,9,0,0
"Australia","2024-03-22",0,0,6,0,0,9,0,0
"Australia","2024-03-23",0,0,6,0,0,9,0,0
"Australia","2024-03-24",0,0,6,0,0,9,0,0
"Australia","2024-03-25",0,0,6,0,0,9,0,0
"Australia","2024-03-26",0,0,6,0,0,9,0,0
"Australia","2024-03-27",0,0,6,0,0,9,0,0
"Australia","2024-03-28",0,0,6,0,0,9,0,0
"Australia","2024-03-29",0,0,6,0,0,9,0,0
"Australia","2024-03-30",0,0,6,0,0,9,0,0
"Australia","2024-03-31",0,0,6,0,0,9,0,0
"Australia","2024-04-01",0,0,6,0,0,9,0,0
"Australia","2024-04-02",0,0,6,0,0,9,0,0
"Australia","2024-04-03",0,0,6,0,1,10,0,0
"Australia","2024-04-04",0,0,6,0,0,10,0,0
"Australia","2024-04-05",0,0,6,0,0,10,0,0
"Australia","2024-04-06",0,0,6,0,0,10,0,0
"Australia","2024-04-07",0,0,6,0,0,10,0,0
"Australia","2024-04-08",0,0,6,0,0,10,0,0
"Australia","2024-04-09",0,0,6,0,0,10,0,0
"Australia","2024-04-10",0,0,6,0,0,10,0,0
"Australia","2024-04-11",0,0,6,0,0,10,0,0
"Australia","2024-04-12",0,0,6,0,0,10,0,0
"Australia","2024-04-13",0,0,6,0,0,10,0,0
"Australia","2024-04-14",0,0,6,0,0,10,0,0
"Australia","2024-04-15",0,0,6,0,0,10,0,0
"Australia","2024-04-16",0,0,6,0,0,10,0,0
"Australia","2024-04-17",0,0,6,0,0,10,0,0
"Australia","2024-04-18",0,0,6,0,0,10,0,0
"Australia","2024-04-19",0,0,6,0,0,10,0,0
"Australia","2024-04-20",0,0,6,0,0,10,0,0
"Australia","2024-04-21",0,0,6,0,0,10,0,0
"Australia","2024-04-22",0,0,6,0,1,11,0,0
"Australia","2024-04-23",0,0,6,0,0,11,0,0
"Australia","2024-04-24",0,0,6,0,0,11,0,0
"Australia","2024-04-25",0,0,6,0,0,11,0,0
"Australia","2024-04-26",0,0,6,0,0,11,0,0
"Australia","2024-04-27",0,0,6,0,0,11,0,0
"Australia","2024-04-28",0,0,6,0,0,11,0,0
"Australia","2024-04-29",0,0,6,0,0,11,0,0
"Australia","2024-04-30",0,5,11,0,0,11,0,0
"Australia","2024-05-01",0,0,11,0,1,12,0,0
"Australia","2024-05-02",0,0,11,0,1,13,0,0
"Australia","2024-05-03",0,0,11,0,1,14,0,0
"Australia","2024-05-04",0,0,11,0,1,15,0,0
"Australia","2024-05-05",0,0,11,0,1,16,0,0
"Australia","2024-05-06",0,0,11,0,1,17,0,0
"Australia","2024-05-07",0,0,11,0,1,18,0,0
"Australia","2024-05-08",0,0,11,0,2,20,0,0
"Australia","2024-05-09",0,0,11,0,1,21,0,0
"Australia","2024-05-10",0,0,11,0,1,22,0,0
"Australia","2024-05-11",0,0,11,0,1,23,0,0
"Australia","2024-05-12",0,0,11,0,1,24,0,0
"Australia","2024-05-13",0,0,11,0,1,25,0,0
"Australia","2024-05-14",0,0,11,0,1,26,0,0
"Australia","2024-05-15",0,0,11,0,1,27,0,0
"Australia","2024-05-16",0,0,11,0,1,28,0,0
"Australia","2024-05-17",0,0,11,0,1,29,0,0
"Australia","2024-05-18",0,0,11,0,1,30,0,0
"Australia","2024-05-19",0,0,11,0,1,31,0,0
"Australia","2024-05-20",0,0,11,0,1,32,0,0
"Australia","2024-05-21",0,0,11,0,1,33,0,0
"Australia","2024-05-22",0,0,11,0,1,34,0,0
"Australia","2024-05-23",0,0,11,0,1,35,0,0
"Australia","2024-05-24",0,0,11,0,2,37,0,0
"Australia","2024-05-25",0,0,11,0,1,38,0,0
"Australia","2024-05-26",0,0,11,0,1,39,0,0
"Australia","2024-05-27",0,0,11,0,1,40,0,0
"Australia","2024-05-28",0,0,11,0,1,41,0,0
"Australia","2024-05-29",0,0,11,0,1,42,0,0
"Australia","2024-05-30",0,0,11,0,1,43,0,0
"Australia","2024-05-31",0,33,44,0,1,44,0,0
"Australia","2024-06-01",0,0,44,0,2,46,0,0
"Australia","2024-06-02",0,0,44,0,2,48,0,0
"Australia","2024-06-03",0,0,44,0,2,50,0,0
"Australia","2024-06-04",0,0,44,0,3,53,0,0
"Australia","2024-06-05",0,0,44,0,2,55,0,0
"Australia","2024-06-06",0,0,44,0,2,57,0,0
"Australia","2024-06-07",0,0,44,0,2,59,0,0
"Australia","2024-06-08",0,0,44,0,2,61,0,0
"Australia","2024-06-09",0,0,44,0,2,63,0,0
"Australia","2024-06-10",0,0,44,0,2,65,0,0
"Australia","2024-06-11",0,0,44,0,2,67,0,0
"Australia","2024-06-12",0,0,44,0,3,70,0,0
"Australia","2024-06-13",0,0,44,0,2,72,0,0
"Australia","2024-06-14",0,0,44,0,2,74,0,0
"Australia","2024-06-15",0,0,44,0,2,76,0,0
"Australia","2024-06-16",0,0,44,0,2,78,0,0
"Australia","2024-06-17",0,0,44,0,2,80,0,0
"Australia","2024-06-18",0,0,44,0,2,82,0,0
"Australia","2024-06-19",0,0,44,0,3,85,0,0
"Australia","2024-06-20",0,0,44,0,2,87,0,0
"Australia","2024-06-21",0,0,44,0,2,89,0,0
"Australia","2024-06-22",0,0,44,0,2,91,0,0
"Australia","2024-06-23",0,0,44,0,2,93,0,0
"Australia","2024-06-24",0,0,44,0,2,95,0,0
"Australia","2024-06-25",0,0,44,0,2,97,0,0
"Australia","2024-06-26",0,0,44,0,2,99,0,0
"Australia","2024-06-27",0,0,44,0,3,102,0,0
"Australia","2024-06-28",0,0,44,0,2,104,0,0
"Australia","2024-06-29",0,0,44,0,2,106,0,0
"Australia","2024-06-30",0,64,108,0,2,108,0,0
"Australia","2024-07-01",0,0,108,0,1,109,0,0
"Australia","2024-07-02",0,0,108,0,1,110,0,0
"Australia","2024-07-03",0,0,108,0,1,111,0,0
"Australia","2024-07-04",0,0,108,0,1,112,0,0
"Australia","2024-07-05",0,0,108,0,1,113,0,0
"Australia","2024-07-06",0,0,108,0,1,114,0,0
"Australia","2024-07-07",0,0,108,0,1,115,0,0
"Australia","2024-07-08",0,0,108,0,0,115,0,0
"Australia","2024-07-09",0,0,108,0,1,116,0,0
"Australia","2024-07-10",0,0,108,0,1,117,0,0
"Australia","2024-07-11",0,0,108,0,1,118,0,0
"Australia","2024-07-12",0,0,108,0,1,119,0,0
"Australia","2024-07-13",0,0,108,0,1,120,0,0
"Australia","2024-07-14",0,0,108,0,1,121,0,0
"Australia","2024-07-15",0,14,122,0,1,122,0,0
"Australia","2024-07-16",0,0,122,0,3,125,0,0
"Australia","2024-07-17",0,0,122,0,3,128,0,0
"Australia","2024-07-18",0,0,122,0,3,131,0,0
"Australia","2024-07-19",0,0,122,0,3,134,0,0
"Australia","2024-07-20",0,0,122,0,3,137,0,0
"Australia","2024-07-21",0,0,122,0,3,140,0,0
"Australia","2024-07-22",0,21,143,0,3,143,0,0
"Australia","2024-07-23",0,0,143,0,4,147,0,0
"Australia","2024-07-24",0,0,143,0,4,151,0,0
"Australia","2024-07-25",0,0,143,0,5,156,0,0
"Australia","2024-07-26",0,0,143,0,4,160,0,0
"Australia","2024-07-27",0,21,164,0,4,164,0,0
"Australia","2024-07-28",0,0,164,0,11,175,0,0
"Australia","2024-07-29",0,0,164,0,10,185,0,0
"Australia","2024-07-30",0,32,196,0,11,196,0,0
"Australia","2024-07-31",0,13,209,0,13,209,0,0
"Australia","2024-08-01",0,0,209,0,4,213,0,0
"Australia","2024-08-02",0,0,209,0,3,216,0,0
"Australia","2024-08-03",0,0,209,0,4,220,0,0
"Australia","2024-08-04",0,0,209,0,3,223,0,0
"Australia","2024-08-05",0,0,209,0,4,227,0,0
"Australia","2024-08-06",0,0,209,0,3,230,0,0
"Australia","2024-08-07",0,0,209,0,4,234,0,0
"Australia","2024-08-08",0,0,209,0,3,237,0,0
"Australia","2024-08-09",0,0,209,0,4,241,0,0
"Australia","2024-08-10",0,0,209,0,3,244,0,0
"Australia","2024-08-11",0,0,209,0,4,248,0,0
"Australia","2024-08-12",0,0,209,0,3,251,0,0
"Australia","2024-08-13",0,0,209,0,4,255,0,0
"Australia","2024-08-14",0,0,209,0,3,258,0,0
"Australia","2024-08-15",0,0,209,0,4,262,0,0
"Australia","2024-08-16",0,0,209,0,3,265,0,0
"Australia","2024-08-17",0,0,209,0,4,269,0,0
"Australia","2024-08-18",0,0,209,0,3,272,0,0
"Australia","2024-08-19",0,0,209,0,4,276,0,0
"Australia","2024-08-20",0,0,209,0,3,279,0,0
"Australia","2024-08-21",0,74,283,0,4,283,0,0
"Australia","2024-08-22",0,0,283,0,9,292,0,0
"Australia","2024-08-23",0,0,283,0,9,301,0,0
"Australia","2024-08-24",0,0,283,0,8,309,0,0
"Australia","2024-08-25",0,0,283,0,9,318,0,0
"Australia","2024-08-26",0,0,283,0,9,327,0,0
"Australia","2024-08-27",0,0,283,0,8,335,0,0
"Australia","2024-08-28",0,0,283,0,9,344,0,0
"Australia","2024-08-29",0,70,353,0,9,353,0,0
"Australia","2024-08-30",0,0,353,0,50,403,0,0
"Australia","2024-08-31",0,101,454,0,51,454,0,0
"Australia","2024-09-01",0,0,454,0,4,458,0,0
"Australia","2024-09-02",0,0,454,0,5,463,0,0
"Australia","2024-09-03",0,0,454,0,4,467,0,0
"Australia","2024-09-04",0,0,454,0,5,472,0,0
"Australia","2024-09-05",0,0,454,0,4,476,0,0
"Australia","2024-09-06",0,0,454,0,4,480,0,0
"Australia","2024-09-07",0,0,454,0,5,485,0,0
"Australia","2024-09-08",0,35,489,0,4,489,0,0
"Australia","2024-09-09",0,0,489,0,12,501,0,0
"Australia","2024-09-10",0,0,489,0,12,513,0,0
"Australia","2024-09-11",0,0,489,0,12,525,0,0
"Australia","2024-09-12",0,0,489,0,12,537,0,0
"Australia","2024-09-13",0,0,489,0,12,549,0,0
"Australia","2024-09-14",0,0,489,0,12,561,0,0
"Australia","2024-09-15",0,84,573,0,12,573,0,0
"Australia","2024-09-16",0,0,573,0,13,586,0,0
"Australia","2024-09-17",0,0,573,0,13,599,0,0
"Australia","2024-09-18",0,0,573,0,13,612,0,0
"Australia","2024-09-19",0,0,573,0,14,626,0,0
"Australia","2024-09-20",0,0,573,0,13,639,0,0
"Australia","2024-09-21",0,0,573,0,13,652,0,0
"Australia","2024-09-22",0,92,665,0,13,665,0,0
"Australia","2024-09-23",0,0,665,0,13,678,0,0
"Australia","2024-09-24",0,0,665,0,13,691,0,0
"Australia","2024-09-25",0,0,665,0,13,704,0,0
"Australia","2024-09-26",0,0,665,0,13,717,0,0
"Australia","2024-09-27",0,0,665,0,13,730,0,0
"Australia","2024-09-28",0,0,665,0,13,743,0,0
"Australia","2024-09-29",0,91,756,0,13,756,0,0
"Australia","2024-09-30",0,0,756,0,10,766,0,0
"Australia","2024-10-01",0,0,756,0,11,777,0,0
"Australia","2024-10-02",0,0,756,0,10,787,0,0
"Australia","2024-10-03",0,0,756,0,10,797,0,0
"Australia","2024-10-04",0,0,756,0,10,807,0,0
"Australia","2024-10-05",0,0,756,0,11,818,0,0
"Australia","2024-10-06",0,72,828,0,10,828,0,0
"Australia","2024-10-07",0,23,851,0,23,851,0,0
"Australia","2024-10-08",0,0,851,0,9,860,0,0
"Australia","2024-10-09",0,0,851,0,9,869,0,0
"Australia","2024-10-10",0,0,851,0,9,878,0,0
"Australia","2024-10-11",0,0,851,0,9,887,0,0
"Australia","2024-10-12",0,0,851,0,9,896,0,0
"Australia","2024-10-13",0,54,905,0,9,905,0,0
"Australia","2024-10-14",0,0,905,0,11,916,0,0
"Australia","2024-10-15",0,0,905,0,12,928,0,0
"Australia","2024-10-16",0,0,905,0,11,939,0,0
"Australia","2024-10-17",0,0,905,0,11,950,0,0
"Australia","2024-10-18",0,0,905,0,11,961,0,0
"Australia","2024-10-19",0,0,905,0,12,973,0,0
"Australia","2024-10-20",0,79,984,0,11,984,0,0
"Australia","2024-10-21",0,0,984,0,10,994,0,0
"Australia","2024-10-22",0,0,984,0,9,1003,0,0
"Australia","2024-10-23",0,0,984,0,10,1013,0,0
"Australia","2024-10-24",0,0,984,0,10,1023,0,0
"Australia","2024-10-25",0,0,984,0,10,1033,0,0
"Australia","2024-10-26",0,0,984,0,9,1042,0,0
"Australia","2024-10-27",0,68,1052,0,10,1052,0,0
"Australia","2024-10-28",0,0,1052,0,11,1063,0,0
"Australia","2024-10-29",0,0,1052,0,12,1075,0,0
"Australia","2024-10-30",0,0,1052,0,11,1086,0,0
"Australia","2024-10-31",0,0,1052,0,11,1097,0,0
"Australia","2024-11-01",0,0,1052,0,11,1108,0,0
"Australia","2024-11-02",0,0,1052,0,12,1120,0,0
"Australia","2024-11-03",0,79,1131,0,11,1131,0,0
"Australia","2024-11-04",0,0,1131,0,8,1139,0,0
"Australia","2024-11-05",0,0,1131,0,8,1147,0,0
"Australia","2024-11-06",0,0,1131,0,8,1155,0,0
"Australia","2024-11-07",0,0,1131,0,9,1164,0,0
"Australia","2024-11-08",0,0,1131,0,8,1172,0,0
"Australia","2024-11-09",0,0,1131,0,8,1180,0,0
"Australia","2024-11-10",0,57,1188,0,8,1188,0,0
"Australia","2024-11-11",0,0,1188,0,7,1195,0,0
"Australia","2024-11-12",0,0,1188,0,7,1202,0,0
"Australia","2024-11-13",0,0,1188,0,7,1209,0,0
"Australia","2024-11-14",0,0,1188,0,7,1216,0,0
"Australia","2024-11-15",0,0,1188,0,7,1223,0,0
"Australia","2024-11-16",0,0,1188,0,7,1230,0,0
"Australia","2024-11-17",0,49,1237,0,7,1237,0,0
"Australia","2024-11-18",0,0,1237,0,4,1241,0,0
"Australia","2024-11-19",0,0,1237,0,4,1245,0,0
"Australia","2024-11-20",0,0,1237,0,4,1249,0,0
"Australia","2024-11-21",0,0,1237,0,5,1254,0,0
"Australia","2024-11-22",0,0,1237,0,4,1258,0,0
"Australia","2024-11-23",0,0,1237,0,4,1262,0,0
"Australia","2024-11-24",0,29,1266,0,4,1266,0,0
"Australia","2024-11-25",0,0,1266,0,5,1271,0,0
"Australia","2024-11-26",0,0,1266,0,5,1276,0,0
"Australia","2024-11-27",0,0,1266,0,5,1281,0,0
"Australia","2024-11-28",0,0,1266,0,4,1285,0,0
"Australia","2024-11-29",0,0,1266,0,5,1290,0,0
"Australia","2024-11-30",0,0,1266,0,5,1295,0,0
"Australia","2024-12-01",0,34,1300,0,5,1300,0,0
"Australia","2024-12-02",0,0,1300,0,3,1303,0,0
"Australia","2024-12-03",0,0,1300,0,3,1306,0,0
"Australia","2024-12-04",0,0,1300,0,4,1310,0,0
"Australia","2024-12-05",0,0,1300,0,3,1313,0,0
"Australia","2024-12-06",0,0,1300,0,3,1316,0,0
"Australia","2024-12-07",0,0,1300,0,4,1320,0,0
"Australia","2024-12-08",0,0,1300,0,3,1323,0,0
"Australia","2024-12-09",0,26,1326,0,3,1326,0,0
"Australia","2024-12-10",0,0,1326,0,4,1330,0,0
"Australia","2024-12-11",0,0,1326,0,5,1335,0,0
"Australia","2024-12-12",0,0,1326,0,4,1339,0,0
"Australia","2024-12-13",0,0,1326,0,4,1343,0,0
"Australia","2024-12-14",0,0,1326,0,5,1348,0,0
"Australia","2024-12-15",0,26,1352,0,4,1352,0,0
"Australia","2024-12-16",0,0,1352,0,0,1352,0,0
"Australia","2024-12-17",0,0,1352,0,0,1352,0,0
"Australia","2024-12-18",0,0,1352,0,0,1352,0,0
"Australia","2024-12-19",0,0,1352,0,0,1352,0,0
"Australia","2024-12-20",0,0,1352,0,0,1352,0,0
"Australia","2024-12-21",0,0,1352,0,0,1352,0,0
"Australia","2024-12-22",0,0,1352,0,0,1352,0,0
"Australia","2024-12-23",0,0,1352,0,0,1352,0,0
"Australia","2024-12-24",0,0,1352,0,0,1352,0,0
"Australia","2024-12-25",0,0,1352,0,0,1352,0,0
"Australia","2024-12-26",0,0,1352,0,0,1352,0,0
"Australia","2024-12-27",0,0,1352,0,0,1352,0,0
"Australia","2024-12-28",0,0,1352,0,0,1352,0,0
"Australia","2024-12-29",0,0,1352,0,0,1352,0,0
"Australia","2024-12-30",0,0,1352,0,0,1352,0,0
"Australia","2024-12-31",0,0,1352,0,0,1352,0,0
"Australia","2025-01-01",0,0,1352,0,0,1352,0,0
"Australia","2025-01-02",0,0,1352,0,0,1352,0,0
"Australia","2025-01-03",0,0,1352,0,0,1352,0,0
"Australia","2025-01-04",0,0,1352,0,0,1352,0,0
"Australia","2025-01-05",0,0,1352,0,0,1352,0,0
"Australia","2025-01-06",0,0,1352,0,0,1352,0,0
"Australia","2025-01-07",0,0,1352,0,0,1352,0,0
"Australia","2025-01-08",0,0,1352,0,0,1352,0,0
"Australia","2025-01-09",0,0,1352,0,0,1352,0,0
"Australia","2025-01-10",0,0,1352,0,0,1352,0,0
"Australia","2025-01-11",0,0,1352,0,0,1352,0,0
"Australia","2025-01-12",0,0,1352,0,0,1352,0,0
"Australia","2025-01-13",0,0,1352,0,0,1352,0,0
"Austria","2024-01-01",0,0,0,0,0,0,0,0
"Austria","2024-01-02",0,0,0,0,0,0,0,0
"Austria","2024-01-03",0,0,0,0,0,0,0,0
"Austria","2024-01-04",0,0,0,0,0,0,0,0
"Austria","2024-01-05",0,0,0,0,0,0,0,0
"Austria","2024-01-06",0,0,0,0,0,0,0,0
"Austria","2024-01-07",0,0,0,0,0,0,0,0
"Austria","2024-01-08",0,0,0,0,0,0,0,0
"Austria","2024-01-09",0,0,0,0,0,0,0,0
"Austria","2024-01-10",0,0,0,0,0,0,0,0
"Austria","2024-01-11",0,0,0,0,0,0,0,0
"Austria","2024-01-12",0,0,0,0,0,0,0,0
"Austria","2024-01-13",0,0,0,0,0,0,0,0
"Austria","2024-01-14",0,0,0,0,0,0,0,0
"Austria","2024-01-15",0,0,0,0,0,0,0,0
"Austria","2024-01-16",0,0,0,0,0,0,0,0
"Austria","2024-01-17",0,0,0,0,0,0,0,0
"Austria","2024-01-18",0,0,0,0,0,0,0,0
"Austria","2024-01-19",0,0,0,0,0,0,0,0
"Austria","2024-01-20",0,0,0,0,0,0,0,0
"Austria","2024-01-21",0,0,0,0,0,0,0,0
"Austria","2024-01-22",0,0,0,0,0,0,0,0
"Austria","2024-01-23",0,0,0,0,0,0,0,0
"Austria","2024-01-24",0,0,0,0,0,0,0,0
"Austria","2024-01-25",0,0,0,0,0,0,0,0
"Austria","2024-01-26",0,0,0,0,0,0,0,0
"Austria","2024-01-27",0,0,0,0,0,0,0,0
"Austria","2024-01-28",0,0,0,0,0,0,0,0
"Austria","2024-01-29",0,0,0,0,0,0,0,0
"Austria","2024-01-30",0,0,0,0,0,0,0,0
"Austria","2024-01-31",0,3,3,0,3,3,0,0
"Austria","2024-02-01",0,0,3,0,0,3,0,0
"Austria","2024-02-02",0,0,3,0,0,3,0,0
"Austria","2024-02-03",0,0,3,0,0,3,0,0
"Austria","2024-02-04",0,0,3,0,1,4,0,0
"Austria","2024-02-05",0,0,3,0,0,4,0,0
"Austria","2024-02-06",0,0,3,0,0,4,0,0
"Austria","2024-02-07",0,0,3,0,0,4,0,0
"Austria","2024-02-08",0,0,3,0,0,4,0,0
"Austria","2024-02-09",0,0,3,0,0,4,0,0
"Austria","2024-02-10",0,0,3,0,0,4,0,0
"Austria","2024-02-11",0,0,3,0,1,5,0,0
"Austria","2024-02-12",0,0,3,0,0,5,0,0
"Austria","2024-02-13",0,0,3,0,0,5,0,0
"Austria","2024-02-14",0,0,3,0,0,5,0,0
"Austria","2024-02-15",0,0,3,0,0,5,0,0
"Austria","2024-02-16",0,0,3,0,0,5,0,0
"Austria","2024-02-17",0,0,3,0,0,5,0,0
"Austria","2024-02-18",0,0,3,0,0,5,0,0
"Austria","2024-02-19",0,0,3,0,1,6,0,0
"Austria","2024-02-20",0,0,3,0,0,6,0,0
"Austria","2024-02-21",0,0,3,0,0,6,0,0
"Austria","2024-02-22",0,0,3,0,0,6,0,0
"Austria","2024-02-23",0,0,3,0,0,6,0,0
"Austria","2024-02-24",0,0,3,0,0,6,0,0
"Austria","2024-02-25",0,0,3,0,0,6,0,0
"Austria","2024-02-26",0,0,3,0,1,7,0,0
"Austria","2024-02-27",0,0,3,0,0,7,0,0
"Austria","2024-02-28",0,0,3,0,0,7,0,0
"Austria","2024-02-29",0,4,7,0,0,7,0,0
"Austria","2024-03-01",0,0,7,0,0,7,0,0
"Austria","2024-03-02",0,0,7,0,0,7,0,0
"Austria","2024-03-03",0,0,7,0,0,7,0,0
"Austria","2024-03-04",0,0,7,0,0,7,0,0
"Austria","2024-03-05",0,0,7,0,0,7,0,0
"Austria","2024-03-06",0,0,7,0,0,7,0,0
"Austria","2024-03-07",0,0,7,0,0,7,0,0
"Austria","2024-03-08",0,0,7,0,0,7,0,0
"Austria","2024-03-09",0,0,7,0,0,7,0,0
"Austria","2024-03-10",0,0,7,0,0,7,0,0
"Austria","2024-03-11",0,0,7,0,0,7,0,0
"Austria","2024-03-12",0,0,7,0,0,7,0,0
"Austria","2024-03-13",0,0,7,0,0,7,0,0
"Austria","2024-03-14",0,0,7,0,0,7,0,0
"Austria","2024-03-15",0,0,7,0,0,7,0,0
"Austria","2024-03-16",0,0,7,0,0,7,0,0
"Austria","2024-03-17",0,0,7,0,0,7,0,0
"Austria","2024-03-18",0,0,7,0,0,7,0,0
"Austria","2024-03-19",0,0,7,0,0,7,0,0
"Austria","2024-03-20",0,0,7,0,0,7,0,0
"Austria","2024-03-21",0,0,7,0,0,7,0,0
"Austria","2024-03-22",0,0,7,0,0,7,0,0
"Austria","2024-03-23",0,0,7,0,0,7,0,0
"Austria","2024-03-24",0,0,7,0,0,7,0,0
"Austria","2024-03-25",0,0,7,0,0,7,0,0
"Austria","2024-03-26",0,0,7,0,0,7,0,0
"Austria","2024-03-27",0,0,7,0,0,7,0,0
"Austria","2024-03-28",0,0,7,0,0,7,0,0
"Austria","2024-03-29",0,0,7,0,0,7,0,0
"Austria","2024-03-30",0,0,7,0,0,7,0,0
"Austria","2024-03-31",0,0,7,0,1,8,0,0
"Austria","2024-04-01",0,0,7,0,0,8,0,0
"Austria","2024-04-02",0,0,7,0,0,8,0,0
"Austria","2024-04-03",0,0,7,0,0,8,0,0
"Austria","2024-04-04",0,0,7,0,0,8,0,0
"Austria","2024-04-05",0,0,7,0,0,8,0,0
"Austria","2024-04-06",0,0,7,0,0,8,0,0
"Austria","2024-04-07",0,0,7,0,0,8,0,0
"Austria","2024-04-08",0,0,7,0,0,8,0,0
"Austria","2024-04-09",0,0,7,0,0,8,0,0
"Austria","2024-04-10",0,0,7,0,0,8,0,0
"Austria","2024-04-11",0,0,7,0,0,8,0,0
"Austria","2024-04-12",0,0,7,0,0,8,0,0
"Austria","2024-04-13",0,0,7,0,0,8,0,0
"Austria","2024-04-14",0,0,7,0,0,8,0,0
"Austria","2024-04-15",0,0,7,0,0,8,0,0
"Austria","2024-04-16",0,0,7,0,0,8,0,0
"Austria","2024-04-17",0,0,7,0,0,8,0,0
"Austria","2024-04-18",0,0,7,0,0,8,0,0
"Austria","2024-04-19",0,0,7,0,0,8,0,0
"Austria","2024-04-20",0,0,7,0,0,8,0,0
"Austria","2024-04-21",0,0,7,0,0,8,0,0
"Austria","2024-04-22",0,0,7,0,0,8,0,0
"Austria","2024-04-23",0,0,7,0,0,8,0,0
"Austria","2024-04-24",0,0,7,0,0,8,0,0
"Austria","2024-04-25",0,0,7,0,0,8,0,0
"Austria","2024-04-26",0,0,7,0,0,8,0,0
"Austria","2024-04-27",0,0,7,0,0,8,0,0
"Austria","2024-04-28",0,0,7,0,0,8,0,0
"Austria","2024-04-29",0,0,7,0,0,8,0,0
"Austria","2024-04-30",0,1,8,0,0,8,0,0
"Austria","2024-05-01",0,0,8,0,0,8,0,0
"Austria","2024-05-02",0,0,8,0,0,8,0,0
"Austria","2024-05-03",0,0,8,0,0,8,0,0
"Austria","2024-05-04",0,0,8,0,0,8,0,0
"Austria","2024-05-05",0,0,8,0,0,8,0,0
"Austria","2024-05-06",0,0,8,0,0,8,0,0
"Austria","2024-05-07",0,0,8,0,0,8,0,0
"Austria","2024-05-08",0,0,8,0,1,9,0,0
"Austria","2024-05-09",0,0,8,0,0,9,0,0
"Austria","2024-05-10",0,0,8,0,0,9,0,0
"Austria","2024-05-11",0,0,8,0,0,9,0,0
"Austria","2024-05-12",0,0,8,0,0,9,0,0
"Austria","2024-05-13",0,0,8,0,0,9,0,0
"Austria","2024-05-14",0,0,8,0,0,9,0,0
"Austria","2024-05-15",0,0,8,0,0,9,0,0
"Austria","2024-05-16",0,0,8,0,0,9,0,0
"Austria","2024-05-17",0,0,8,0,0,9,0,0
"Austria","2024-05-18",0,0,8,0,0,9,0,0
"Austria","2024-05-19",0,0,8,0,0,9,0,0
"Austria","2024-05-20",0,0,8,0,0,9,0,0
"Austria","2024-05-21",0,0,8,0,0,9,0,0
"Austria","2024-05-22",0,0,8,0,0,9,0,0
"Austria","2024-05-23",0,0,8,0,0,9,0,0
"Austria","2024-05-24",0,0,8,0,1,10,0,0
"Austria","2024-05-25",0,0,8,0,0,10,0,0
"Austria","2024-05-26",0,0,8,0,0,10,0,0
"Austria","2024-05-27",0,0,8,0,0,10,0,0
"Austria","2024-05-28",0,0,8,0,0,10,0,0
"Austria","2024-05-29",0,0,8,0,0,10,0,0
"Austria","2024-05-30",0,0,8,0,0,10,0,0
"Austria","2024-05-31",0,2,10,0,0,10,0,0
"Austria","2024-06-01",0,0,10,0,0,10,0,0
"Austria","2024-06-02",0,0,10,0,0,10,0,0
"Austria","2024-06-03",0,0,10,0,0,10,0,0
"Austria","2024-06-04",0,0,10,0,0,10,0,0
"Austria","2024-06-05",0,0,10,0,0,10,0,0
"Austria","2024-06-06",0,0,10,0,0,10,0,0
"Austria","2024-06-07",0,0,10,0,0,10,0,0
"Austria","2024-06-08",0,0,10,0,0,10,0,0
"Austria","2024-06-09",0,0,10,0,0,10,0,0
"Austria","2024-06-10",0,0,10,0,0,10,0,0
"Austria","2024-06-11",0,0,10,0,0,10,0,0
"Austria","2024-06-12",0,0,10,0,0,10,0,0
"Austria","2024-06-13",0,0,10,0,0,10,0,0
"Austria","2024-06-14",0,0,10,0,0,10,0,0
"Austria","2024-06-15",0,0,10,0,0,10,0,0
"Austria","2024-06-16",0,0,10,0,0,10,0,0
"Austria","2024-06-17",0,0,10,0,0,10,0,0
"Austria","2024-06-18",0,0,10,0,0,10,0,0
"Austria","2024-06-19",0,0,10,0,0,10,0,0
"Austria","2024-06-20",0,0,10,0,0,10,0,0
"Austria","2024-06-21",0,0,10,0,0,10,0,0
"Austria","2024-06-22",0,0,10,0,0,10,0,0
"Austria","2024-06-23",0,0,10,0,0,10,0,0
"Austria","2024-06-24",0,0,10,0,1,11,0,0
"Austria","2024-06-25",0,0,10,0,0,11,0,0
"Austria","2024-06-26",0,0,10,0,0,11,0,0
"Austria","2024-06-27",0,0,10,0,0,11,0,0
"Austria","2024-06-28",0,0,10,0,0,11,0,0
"Austria","2024-06-29",0,0,10,0,0,11,0,0
"Austria","2024-06-30",0,0,10,0,0,11,0,0
"Austria","2024-07-01",0,0,10,0,0,11,0,0
"Austria","2024-07-02",0,0,10,0,0,11,0,0
"Austria","2024-07-03",0,0,10,0,0,11,0,0
"Austria","2024-07-04",0,0,10,0,0,11,0,0
"Austria","2024-07-05",0,0,10,0,0,11,0,0
"Austria","2024-07-06",0,0,10,0,0,11,0,0
"Austria","2024-07-07",0,0,10,0,0,11,0,0
"Austria","2024-07-08",0,0,10,0,0,11,0,0
"Austria","2024-07-09",0,0,10,0,0,11,0,0
"Austria","2024-07-10",0,0,10,0,0,11,0,0
"Austria","2024-07-11",0,0,10,0,0,11,0,0
"Austria","2024-07-12",0,0,10,0,0,11,0,0
"Austria","2024-07-13",0,0,10,0,0,11,0,0
"Austria","2024-07-14",0,0,10,0,0,11,0,0
"Austria","2024-07-15",0,0,10,0,0,11,0,0
"Austria","2024-07-16",0,0,10,0,0,11,0,0
"Austria","2024-07-17",0,0,10,0,0,11,0,0
"Austria","2024-07-18",0,0,10,0,0,11,0,0
"Austria","2024-07-19",0,0,10,0,0,11,0,0
"Austria","2024-07-20",0,0,10,0,0,11,0,0
"Austria","2024-07-21",0,0,10,0,0,11,0,0
"Austria","2024-07-22",0,0,10,0,0,11,0,0
"Austria","2024-07-23",0,0,10,0,0,11,0,0
"Austria","2024-07-24",0,0,10,0,0,11,0,0
"Austria","2024-07-25",0,0,10,0,0,11,0,0
"Austria","2024-07-26",0,0,10,0,0,11,0,0
"Austria","2024-07-27",0,0,10,0,0,11,0,0
"Austria","2024-07-28",0,0,10,0,0,11,0,0
"Austria","2024-07-29",0,0,10,0,0,11,0,0
"Austria","2024-07-30",0,0,10,0,0,11,0,0
"Austria","2024-07-31",0,0,10,0,0,11,0,0
"Austria","2024-08-01",0,0,10,0,0,11,0,0
"Austria","2024-08-02",0,0,10,0,0,11,0,0
"Austria","2024-08-03",0,0,10,0,0,11,0,0
"Austria","2024-08-04",0,0,10,0,0,11,0,0
"Austria","2024-08-05",0,0,10,0,0,11,0,0
"Austria","2024-08-06",0,0,10,0,0,11,0,0
"Austria","2024-08-07",0,0,10,0,0,11,0,0
"Austria","2024-08-08",0,0,10,0,1,12,0,0
"Austria","2024-08-09",0,0,10,0,0,12,0,0
"Austria","2024-08-10",0,0,10,0,0,12,0,0
"Austria","2024-08-11",0,0,10,0,0,12,0,0
"Austria","2024-08-12",0,0,10,0,0,12,0,0
"Austria","2024-08-13",0,0,10,0,0,12,0,0
"Austria","2024-08-14",0,0,10,0,0,12,0,0
"Austria","2024-08-15",0,0,10,0,0,12,0,0
"Austria","2024-08-16",0,0,10,0,0,12,0,0
"Austria","2024-08-17",0,0,10,0,0,12,0,0
"Austria","2024-08-18",0,0,10,0,0,12,0,0
"Austria","2024-08-19",0,0,10,0,0,12,0,0
"Austria","2024-08-20",0,0,10,0,0,12,0,0
"Austria","2024-08-21",0,0,10,0,0,12,0,0
"Austria","2024-08-22",0,0,10,0,0,12,0,0
"Austria","2024-08-23",0,0,10,0,0,12,0,0
"Austria","2024-08-24",0,0,10,0,0,12,0,0
"Austria","2024-08-25",0,0,10,0,0,12,0,0
"Austria","2024-08-26",0,0,10,0,0,12,0,0
"Austria","2024-08-27",0,0,10,0,0,12,0,0
"Austria","2024-08-28",0,0,10,0,0,12,0,0
"Austria","2024-08-29",0,0,10,0,0,12,0,0
"Austria","2024-08-30",0,0,10,0,0,12,0,0
"Austria","2024-08-31",0,2,12,0,0,12,0,0
"Austria","2024-09-01",0,0,12,0,0,12,0,0
"Austria","2024-09-02",0,0,12,0,0,12,0,0
"Austria","2024-09-03",0,0,12,0,0,12,0,0
"Austria","2024-09-04",0,0,12,0,0,12,0,0
"Austria","2024-09-05",0,0,12,0,0,12,0,0
"Austria","2024-09-06",0,0,12,0,1,13,0,0
"Austria","2024-09-07",0,0,12,0,0,13,0,0
"Austria","2024-09-08",0,0,12,0,0,13,0,0
"Austria","2024-09-09",0,0,12,0,0,13,0,0
"Austria","2024-09-10",0,0,12,0,0,13,0,0
"Austria","2024-09-11",0,0,12,0,0,13,0,0
"Austria","2024-09-12",0,0,12,0,0,13,0,0
"Austria","2024-09-13",0,0,12,0,0,13,0,0
"Austria","2024-09-14",0,0,12,0,0,13,0,0
"Austria","2024-09-15",0,0,12,0,1,14,0,0
"Austria","2024-09-16",0,0,12,0,0,14,0,0
"Austria","2024-09-17",0,0,12,0,0,14,0,0
"Austria","2024-09-18",0,0,12,0,0,14,0,0
"Austria","2024-09-19",0,0,12,0,0,14,0,0
"Austria","2024-09-20",0,0,12,0,0,14,0,0
"Austria","2024-09-21",0,0,12,0,0,14,0,0
"Austria","2024-09-22",0,0,12,0,0,14,0,0
"Austria","2024-09-23",0,0,12,0,0,14,0,0
"Austria","2024-09-24",0,0,12,0,0,14,0,0
"Austria","2024-09-25",0,0,12,0,0,14,0,0
"Austria","2024-09-26",0,0,12,0,1,15,0,0
"Austria","2024-09-27",0,0,12,0,0,15,0,0
"Austria","2024-09-28",0,0,12,0,0,15,0,0
"Austria","2024-09-29",0,0,12,0,0,15,0,0
"Austria","2024-09-30",0,3,15,0,0,15,0,0
"Austria","2024-10-01",0,0,15,0,0,15,0,0
"Austria","2024-10-02",0,0,15,0,0,15,0,0
"Austria","2024-10-03",0,0,15,0,0,15,0,0
"Austria","2024-10-04",0,0,15,0,0,15,0,0
"Austria","2024-10-05",0,0,15,0,0,15,0,0
"Austria","2024-10-06",0,0,15,0,1,16,0,0
"Austria","2024-10-07",0,0,15,0,0,16,0,0
"Austria","2024-10-08",0,0,15,0,0,16,0,0
"Austria","2024-10-09",0,0,15,0,0,16,0,0
"Austria","2024-10-10",0,0,15,0,0,16,0,0
"Austria","2024-10-11",0,0,15,0,0,16,0,0
"Austria","2024-10-12",0,0,15,0,0,16,0,0
"Austria","2024-10-13",0,0,15,0,0,16,0,0
"Austria","2024-10-14",0,0,15,0,0,16,0,0
"Austria","2024-10-15",0,0,15,0,0,16,0,0
"Austria","2024-10-16",0,0,15,0,1,17,0,0
"Austria","2024-10-17",0,0,15,0,0,17,0,0
"Austria","2024-10-18",0,0,15,0,0,17,0,0
"Austria","2024-10-19",0,0,15,0,0,17,0,0
"Austria","2024-10-20",0,0,15,0,0,17,0,0
"Austria","2024-10-21",0,0,15,0,0,17,0,0
"Austria","2024-10-22",0,0,15,0,0,17,0,0
"Austria","2024-10-23",0,0,15,0,0,17,0,0
"Austria","2024-10-24",0,0,15,0,0,17,0,0
"Austria","2024-10-25",0,0,15,0,0,17,0,0
"Austria","2024-10-26",0,0,15,0,1,18,0,0
"Austria","2024-10-27",0,0,15,0,0,18,0,0
"Austria","2024-10-28",0,0,15,0,0,18,0,0
"Austria","2024-10-29",0,0,15,0,0,18,0,0
"Austria","2024-10-30",0,0,15,0,0,18,0,0
"Austria","2024-10-31",0,3,18,0,0,18,0,0
"Austria","2024-11-01",0,0,18,0,0,18,0,0
"Austria","2024-11-02",0,0,18,0,0,18,0,0
"Austria","2024-11-03",0,0,18,0,1,19,0,0
"Austria","2024-11-04",0,0,18,0,0,19,0,0
"Austria","2024-11-05",0,0,18,0,0,19,0,0
"Austria","2024-11-06",0,0,18,0,0,19,0,0
"Austria","2024-11-07",0,0,18,0,1,20,0,0
"Austria","2024-11-08",0,0,18,0,0,20,0,0
"Austria","2024-11-09",0,0,18,0,0,20,0,0
"Austria","2024-11-10",0,0,18,0,0,20,0,0
"Austria","2024-11-11",0,0,18,0,1,21,0,0
"Austria","2024-11-12",0,0,18,0,0,21,0,0
"Austria","2024-11-13",0,0,18,0,0,21,0,0
"Austria","2024-11-14",0,0,18,0,0,21,0,0
"Austria","2024-11-15",0,0,18,0,1,22,0,0
"Austria","2024-11-16",0,0,18,0,0,22,0,0
"Austria","2024-11-17",0,0,18,0,0,22,0,0
"Austria","2024-11-18",0,0,18,0,0,22,0,0
"Austria","2024-11-19",0,0,18,0,0,22,0,0
"Austria","2024-11-20",0,0,18,0,1,23,0,0
"Austria","2024-11-21",0,0,18,0,0,23,0,0
"Austria","2024-11-22",0,0,18,0,0,23,0,0
"Austria","2024-11-23",0,0,18,0,0,23,0,0
"Austria","2024-11-24",0,0,18,0,1,24,0,0
"Austria","2024-11-25",0,0,18,0,0,24,0,0
"Austria","2024-11-26",0,0,18,0,0,24,0,0
"Austria","2024-11-27",0,0,18,0,0,24,0,0
"Austria","2024-11-28",0,0,18,0,1,25,0,0
"Austria","2024-11-29",0,0,18,0,0,25,0,0
"Austria","2024-11-30",0,7,25,0,0,25,0,0
"Austria","2024-12-01",0,0,25,0,0,25,0,0
"Austria","2024-12-02",0,0,25,0,0,25,0,0
"Austria","2024-12-03",0,0,25,0,0,25,0,0
"Austria","2024-12-04",0,0,25,0,0,25,0,0
"Austria","2024-12-05",0,0,25,0,0,25,0,0
"Austria","2024-12-06",0,0,25,0,0,25,0,0
"Austria","2024-12-07",0,0,25,0,0,25,0,0
"Austria","2024-12-08",0,0,25,0,0,25,0,0
"Austria","2024-12-09",0,0,25,0,0,25,0,0
"Austria","2024-12-10",0,0,25,0,0,25,0,0
"Austria","2024-12-11",0,0,25,0,0,25,0,0
"Austria","2024-12-12",0,0,25,0,0,25,0,0
"Austria","2024-12-13",0,0,25,0,0,25,0,0
"Austria","2024-12-14",0,0,25,0,0,25,0,0
"Austria","2024-12-15",0,0,25,0,0,25,0,0
"Austria","2024-12-16",0,0,25,0,0,25,0,0
"Austria","2024-12-17",0,0,25,0,0,25,0,0
"Austria","2024-12-18",0,0,25,0,0,25,0,0
"Austria","2024-12-19",0,0,25,0,0,25,0,0
"Austria","2024-12-20",0,0,25,0,0,25,0,0
"Austria","2024-12-21",0,0,25,0,0,25,0,0
"Austria","2024-12-22",0,0,25,0,0,25,0,0
"Austria","2024-12-23",0,0,25,0,0,25,0,0
"Austria","2024-12-24",0,0,25,0,0,25,0,0
"Austria","2024-12-25",0,0,25,0,0,25,0,0
"Austria","2024-12-26",0,0,25,0,0,25,0,0
"Austria","2024-12-27",0,0,25,0,0,25,0,0
"Austria","2024-12-28",0,0,25,0,0,25,0,0
"Austria","2024-12-29",0,0,25,0,0,25,0,0
"Austria","2024-12-30",0,0,25,0,0,25,0,0
"Austria","2024-12-31",0,0,25,0,0,25,0,0
"Austria","2025-01-01",0,0,25,0,0,25,0,0
"Austria","2025-01-02",0,0,25,0,0,25,0,0
"Austria","2025-01-03",0,0,25,0,0,25,0,0
"Austria","2025-01-04",0,0,25,0,0,25,0,0
"Austria","2025-01-05",0,0,25,0,0,25,0,0
"Austria","2025-01-06",0,0,25,0,0,25,0,0
"Austria","2025-01-07",0,0,25,0,0,25,0,0
"Austria","2025-01-08",0,0,25,0,0,25,0,0
"Austria","2025-01-09",0,0,25,0,0,25,0,0
"Austria","2025-01-10",0,0,25,0,0,25,0,0
"Austria","2025-01-11",0,0,25,0,0,25,0,0
"Austria","2025-01-12",0,0,25,0,0,25,0,0
"Austria","2025-01-13",0,0,25,0,0,25,0,0
"Bahamas","2024-01-01",0,0,0,0,0,0,0,0
"Bahamas","2024-01-02",0,0,0,0,0,0,0,0
"Bahamas","2024-01-03",0,0,0,0,0,0,0,0
"Bahamas","2024-01-04",0,0,0,0,0,0,0,0
"Bahamas","2024-01-05",0,0,0,0,0,0,0,0
"Bahamas","2024-01-06",0,0,0,0,0,0,0,0
"Bahamas","2024-01-07",0,0,0,0,0,0,0,0
"Bahamas","2024-01-08",0,0,0,0,0,0,0,0
"Bahamas","2024-01-09",0,0,0,0,0,0,0,0
"Bahamas","2024-01-10",0,0,0,0,0,0,0,0
"Bahamas","2024-01-11",0,0,0,0,0,0,0,0
"Bahamas","2024-01-12",0,0,0,0,0,0,0,0
"Bahamas","2024-01-13",0,0,0,0,0,0,0,0
"Bahamas","2024-01-14",0,0,0,0,0,0,0,0
"Bahamas","2024-01-15",0,0,0,0,0,0,0,0
"Bahamas","2024-01-16",0,0,0,0,0,0,0,0
"Bahamas","2024-01-17",0,0,0,0,0,0,0,0
"Bahamas","2024-01-18",0,0,0,0,0,0,0,0
"Bahamas","2024-01-19",0,0,0,0,0,0,0,0
"Bahamas","2024-01-20",0,0,0,0,0,0,0,0
"Bahamas","2024-01-21",0,0,0,0,0,0,0,0
"Bahamas","2024-01-22",0,0,0,0,0,0,0,0
"Bahamas","2024-01-23",0,0,0,0,0,0,0,0
"Bahamas","2024-01-24",0,0,0,0,0,0,0,0
"Bahamas","2024-01-25",0,0,0,0,0,0,0,0
"Bahamas","2024-01-26",0,0,0,0,0,0,0,0
"Bahamas","2024-01-27",0,0,0,0,0,0,0,0
"Bahamas","2024-01-28",0,0,0,0,0,0,0,0
"Bahamas","2024-01-29",0,0,0,0,0,0,0,0
"Bahamas","2024-01-30",0,0,0,0,0,0,0,0
"Bahamas","2024-01-31",0,0,0,0,0,0,0,0
"Bahamas","2024-02-01",0,0,0,0,0,0,0,0
"Bahamas","2024-02-02",0,0,0,0,0,0,0,0
"Bahamas","2024-02-03",0,0,0,0,0,0,0,0
"Bahamas","2024-02-04",0,0,0,0,0,0,0,0
"Bahamas","2024-02-05",0,0,0,0,0,0,0,0
"Bahamas","2024-02-06",0,0,0,0,0,0,0,0
"Bahamas","2024-02-07",0,0,0,0,0,0,0,0
"Bahamas","2024-02-08",0,0,0,0,0,0,0,0
"Bahamas","2024-02-09",0,0,0,0,0,0,0,0
"Bahamas","2024-02-10",0,0,0,0,0,0,0,0
"Bahamas","2024-02-11",0,0,0,0,0,0,0,0
"Bahamas","2024-02-12",0,0,0,0,0,0,0,0
"Bahamas","2024-02-13",0,0,0,0,0,0,0,0
"Bahamas","2024-02-14",0,0,0,0,0,0,0,0
"Bahamas","2024-02-15",0,0,0,0,0,0,0,0
"Bahamas","2024-02-16",0,0,0,0,0,0,0,0
"Bahamas","2024-02-17",0,0,0,0,0,0,0,0
"Bahamas","2024-02-18",0,0,0,0,0,0,0,0
"Bahamas","2024-02-19",0,0,0,0,0,0,0,0
"Bahamas","2024-02-20",0,0,0,0,0,0,0,0
"Bahamas","2024-02-21",0,0,0,0,0,0,0,0
"Bahamas","2024-02-22",0,0,0,0,0,0,0,0
"Bahamas","2024-02-23",0,0,0,0,0,0,0,0
"Bahamas","2024-02-24",0,0,0,0,0,0,0,0
"Bahamas","2024-02-25",0,0,0,0,0,0,0,0
"Bahamas","2024-02-26",0,0,0,0,0,0,0,0
"Bahamas","2024-02-27",0,0,0,0,0,0,0,0
"Bahamas","2024-02-28",0,0,0,0,0,0,0,0
"Bahamas","2024-02-29",0,0,0,0,0,0,0,0
"Bahamas","2024-03-01",0,0,0,0,0,0,0,0
"Bahamas","2024-03-02",0,0,0,0,0,0,0,0
"Bahamas","2024-03-03",0,0,0,0,0,0,0,0
"Bahamas","2024-03-04",0,0,0,0,0,0,0,0
"Bahamas","2024-03-05",0,0,0,0,0,0,0,0
"Bahamas","2024-03-06",0,0,0,0,0,0,0,0
"Bahamas","2024-03-07",0,0,0,0,0,0,0,0
"Bahamas","2024-03-08",0,0,0,0,0,0,0,0
"Bahamas","2024-03-09",0,0,0,0,0,0,0,0
"Bahamas","2024-03-10",0,0,0,0,0,0,0,0
"Bahamas","2024-03-11",0,0,0,0,0,0,0,0
"Bahamas","2024-03-12",0,0,0,0,0,0,0,0
"Bahamas","2024-03-13",0,0,0,0,0,0,0,0
"Bahamas","2024-03-14",0,0,0,0,0,0,0,0
"Bahamas","2024-03-15",0,0,0,0,0,0,0,0
"Bahamas","2024-03-16",0,0,0,0,0,0,0,0
"Bahamas","2024-03-17",0,0,0,0,0,0,0,0
"Bahamas","2024-03-18",0,0,0,0,0,0,0,0
"Bahamas","2024-03-19",0,0,0,0,0,0,0,0
"Bahamas","2024-03-20",0,0,0,0,0,0,0,0
"Bahamas","2024-03-21",0,0,0,0,0,0,0,0
"Bahamas","2024-03-22",0,0,0,0,0,0,0,0
"Bahamas","2024-03-23",0,0,0,0,0,0,0,0
"Bahamas","2024-03-24",0,0,0,0,0,0,0,0
"Bahamas","2024-03-25",0,0,0,0,0,0,0,0
"Bahamas","2024-03-26",0,0,0,0,0,0,0,0
"Bahamas","2024-03-27",0,0,0,0,0,0,0,0
"Bahamas","2024-03-28",0,0,0,0,0,0,0,0
"Bahamas","2024-03-29",0,0,0,0,0,0,0,0
"Bahamas","2024-03-30",0,0,0,0,0,0,0,0
"Bahamas","2024-03-31",0,0,0,0,0,0,0,0
"Bahamas","2024-04-01",0,0,0,0,0,0,0,0
"Bahamas","2024-04-02",0,0,0,0,0,0,0,0
"Bahamas","2024-04-03",0,0,0,0,0,0,0,0
"Bahamas","2024-04-04",0,0,0,0,0,0,0,0
"Bahamas","2024-04-05",0,0,0,0,0,0,0,0
"Bahamas","2024-04-06",0,0,0,0,0,0,0,0
"Bahamas","2024-04-07",0,0,0,0,0,0,0,0
"Bahamas","2024-04-08",0,0,0,0,0,0,0,0
"Bahamas","2024-04-09",0,0,0,0,0,0,0,0
"Bahamas","2024-04-10",0,0,0,0,0,0,0,0
"Bahamas","2024-04-11",0,0,0,0,0,0,0,0
"Bahamas","2024-04-12",0,0,0,0,0,0,0,0
"Bahamas","2024-04-13",0,0,0,0,0,0,0,0
"Bahamas","2024-04-14",0,0,0,0,0,0,0,0
"Bahamas","2024-04-15",0,0,0,0,0,0,0,0
"Bahamas","2024-04-16",0,0,0,0,0,0,0,0
"Bahamas","2024-04-17",0,0,0,0,0,0,0,0
"Bahamas","2024-04-18",0,0,0,0,0,0,0,0
"Bahamas","2024-04-19",0,0,0,0,0,0,0,0
"Bahamas","2024-04-20",0,0,0,0,0,0,0,0
"Bahamas","2024-04-21",0,0,0,0,0,0,0,0
"Bahamas","2024-04-22",0,0,0,0,0,0,0,0
"Bahamas","2024-04-23",0,0,0,0,0,0,0,0
"Bahamas","2024-04-24",0,0,0,0,0,0,0,0
"Bahamas","2024-04-25",0,0,0,0,0,0,0,0
"Bahamas","2024-04-26",0,0,0,0,0,0,0,0
"Bahamas","2024-04-27",0,0,0,0,0,0,0,0
"Bahamas","2024-04-28",0,0,0,0,0,0,0,0
"Bahamas","2024-04-29",0,0,0,0,0,0,0,0
"Bahamas","2024-04-30",0,0,0,0,0,0,0,0
"Bahamas","2024-05-01",0,0,0,0,0,0,0,0
"Bahamas","2024-05-02",0,0,0,0,0,0,0,0
"Bahamas","2024-05-03",0,0,0,0,0,0,0,0
"Bahamas","2024-05-04",0,0,0,0,0,0,0,0
"Bahamas","2024-05-05",0,0,0,0,0,0,0,0
"Bahamas","2024-05-06",0,0,0,0,0,0,0,0
"Bahamas","2024-05-07",0,0,0,0,0,0,0,0
"Bahamas","2024-05-08",0,0,0,0,0,0,0,0
"Bahamas","2024-05-09",0,0,0,0,0,0,0,0
"Bahamas","2024-05-10",0,0,0,0,0,0,0,0
"Bahamas","2024-05-11",0,0,0,0,0,0,0,0
"Bahamas","2024-05-12",0,0,0,0,0,0,0,0
"Bahamas","2024-05-13",0,0,0,0,0,0,0,0
"Bahamas","2024-05-14",0,0,0,0,0,0,0,0
"Bahamas","2024-05-15",0,0,0,0,0,0,0,0
"Bahamas","2024-05-16",0,0,0,0,0,0,0,0
"Bahamas","2024-05-17",0,0,0,0,0,0,0,0
"Bahamas","2024-05-18",0,0,0,0,0,0,0,0
"Bahamas","2024-05-19",0,0,0,0,0,0,0,0
"Bahamas","2024-05-20",0,0,0,0,0,0,0,0
"Bahamas","2024-05-21",0,0,0,0,0,0,0,0
"Bahamas","2024-05-22",0,0,0,0,0,0,0,0
"Bahamas","2024-05-23",0,0,0,0,0,0,0,0
"Bahamas","2024-05-24",0,0,0,0,0,0,0,0
"Bahamas","2024-05-25",0,0,0,0,0,0,0,0
"Bahamas","2024-05-26",0,0,0,0,0,0,0,0
"Bahamas","2024-05-27",0,0,0,0,0,0,0,0
"Bahamas","2024-05-28",0,0,0,0,0,0,0,0
"Bahamas","2024-05-29",0,0,0,0,0,0,0,0
"Bahamas","2024-05-30",0,0,0,0,0,0,0,0
"Bahamas","2024-05-31",0,0,0,0,0,0,0,0
"Bahamas","2024-06-01",0,0,0,0,0,0,0,0
"Bahamas","2024-06-02",0,0,0,0,0,0,0,0
"Bahamas","2024-06-03",0,0,0,0,0,0,0,0
"Bahamas","2024-06-04",0,0,0,0,0,0,0,0
"Bahamas","2024-06-05",0,0,0,0,0,0,0,0
"Bahamas","2024-06-06",0,0,0,0,0,0,0,0
"Bahamas","2024-06-07",0,0,0,0,0,0,0,0
"Bahamas","2024-06-08",0,0,0,0,0,0,0,0
"Bahamas","2024-06-09",0,0,0,0,0,0,0,0
"Bahamas","2024-06-10",0,0,0,0,0,0,0,0
"Bahamas","2024-06-11",0,0,0,0,0,0,0,0
"Bahamas","2024-06-12",0,0,0,0,0,0,0,0
"Bahamas","2024-06-13",0,0,0,0,0,0,0,0
"Bahamas","2024-06-14",0,0,0,0,0,0,0,0
"Bahamas","2024-06-15",0,0,0,0,0,0,0,0
"Bahamas","2024-06-16",0,0,0,0,0,0,0,0
"Bahamas","2024-06-17",0,0,0,0,0,0,0,0
"Bahamas","2024-06-18",0,0,0,0,0,0,0,0
"Bahamas","2024-06-19",0,0,0,0,0,0,0,0
"Bahamas","2024-06-20",0,0,0,0,0,0,0,0
"Bahamas","2024-06-21",0,0,0,0,0,0,0,0
"Bahamas","2024-06-22",0,0,0,0,0,0,0,0
"Bahamas","2024-06-23",0,0,0,0,0,0,0,0
"Bahamas","2024-06-24",0,0,0,0,0,0,0,0
"Bahamas","2024-06-25",0,0,0,0,0,0,0,0
"Bahamas","2024-06-26",0,0,0,0,0,0,0,0
"Bahamas","2024-06-27",0,0,0,0,0,0,0,0
"Bahamas","2024-06-28",0,0,0,0,0,0,0,0
"Bahamas","2024-06-29",0,0,0,0,0,0,0,0
"Bahamas","2024-06-30",0,0,0,0,0,0,0,0
"Bahamas","2024-07-01",0,0,0,0,0,0,0,0
"Bahamas","2024-07-02",0,0,0,0,0,0,0,0
"Bahamas","2024-07-03",0,0,0,0,0,0,0,0
"Bahamas","2024-07-04",0,0,0,0,0,0,0,0
"Bahamas","2024-07-05",0,0,0,0,0,0,0,0
"Bahamas","2024-07-06",0,0,0,0,0,0,0,0
"Bahamas","2024-07-07",0,0,0,0,0,0,0,0
"Bahamas","2024-07-08",0,0,0,0,0,0,0,0
"Bahamas","2024-07-09",0,0,0,0,0,0,0,0
"Bahamas","2024-07-10",0,0,0,0,0,0,0,0
"Bahamas","2024-07-11",0,0,0,0,0,0,0,0
"Bahamas","2024-07-12",0,0,0,0,0,0,0,0
"Bahamas","2024-07-13",0,0,0,0,0,0,0,0
"Bahamas","2024-07-14",0,0,0,0,0,0,0,0
"Bahamas","2024-07-15",0,0,0,0,0,0,0,0
"Bahamas","2024-07-16",0,0,0,0,0,0,0,0
"Bahamas","2024-07-17",0,0,0,0,0,0,0,0
"Bahamas","2024-07-18",0,0,0,0,0,0,0,0
"Bahamas","2024-07-19",0,0,0,0,0,0,0,0
"Bahamas","2024-07-20",0,0,0,0,0,0,0,0
"Bahamas","2024-07-21",0,0,0,0,0,0,0,0
"Bahamas","2024-07-22",0,0,0,0,0,0,0,0
"Bahamas","2024-07-23",0,0,0,0,0,0,0,0
"Bahamas","2024-07-24",0,0,0,0,0,0,0,0
"Bahamas","2024-07-25",0,0,0,0,0,0,0,0
"Bahamas","2024-07-26",0,0,0,0,0,0,0,0
"Bahamas","2024-07-27",0,0,0,0,0,0,0,0
"Bahamas","2024-07-28",0,0,0,0,0,0,0,0
"Bahamas","2024-07-29",0,0,0,0,0,0,0,0
"Bahamas","2024-07-30",0,0,0,0,0,0,0,0
"Bahamas","2024-07-31",0,0,0,0,0,0,0,0
"Bahamas","2024-08-01",0,0,0,0,0,0,0,0
"Bahamas","2024-08-02",0,0,0,0,0,0,0,0
"Bahamas","2024-08-03",0,0,0,0,0,0,0,0
"Bahamas","2024-08-04",0,0,0,0,0,0,0,0
"Bahamas","2024-08-05",0,0,0,0,0,0,0,0
"Bahamas","2024-08-06",0,0,0,0,0,0,0,0
"Bahamas","2024-08-07",0,0,0,0,0,0,0,0
"Bahamas","2024-08-08",0,0,0,0,0,0,0,0
"Bahamas","2024-08-09",0,0,0,0,0,0,0,0
"Bahamas","2024-08-10",0,0,0,0,0,0,0,0
"Bahamas","2024-08-11",0,0,0,0,0,0,0,0
"Bahamas","2024-08-12",0,0,0,0,0,0,0,0
"Bahamas","2024-08-13",0,0,0,0,0,0,0,0
"Bahamas","2024-08-14",0,0,0,0,0,0,0,0
"Bahamas","2024-08-15",0,0,0,0,0,0,0,0
"Bahamas","2024-08-16",0,0,0,0,0,0,0,0
"Bahamas","2024-08-17",0,0,0,0,0,0,0,0
"Bahamas","2024-08-18",0,0,0,0,0,0,0,0
"Bahamas","2024-08-19",0,0,0,0,0,0,0,0
"Bahamas","2024-08-20",0,0,0,0,0,0,0,0
"Bahamas","2024-08-21",0,0,0,0,0,0,0,0
"Bahamas","2024-08-22",0,0,0,0,0,0,0,0
"Bahamas","2024-08-23",0,0,0,0,0,0,0,0
"Bahamas","2024-08-24",0,0,0,0,0,0,0,0
"Bahamas","2024-08-25",0,0,0,0,0,0,0,0
"Bahamas","2024-08-26",0,0,0,0,0,0,0,0
"Bahamas","2024-08-27",0,0,0,0,0,0,0,0
"Bahamas","2024-08-28",0,0,0,0,0,0,0,0
"Bahamas","2024-08-29",0,0,0,0,0,0,0,0
"Bahamas","2024-08-30",0,0,0,0,0,0,0,0
"Bahamas","2024-08-31",0,0,0,0,0,0,0,0
"Bahamas","2024-09-01",0,0,0,0,0,0,0,0
"Bahamas","2024-09-02",0,0,0,0,0,0,0,0
"Bahamas","2024-09-03",0,0,0,0,0,0,0,0
"Bahamas","2024-09-04",0,0,0,0,0,0,0,0
"Bahamas","2024-09-05",0,0,0,0,0,0,0,0
"Bahamas","2024-09-06",0,0,0,0,0,0,0,0
"Bahamas","2024-09-07",0,0,0,0,0,0,0,0
"Bahamas","2024-09-08",0,0,0,0,0,0,0,0
"Bahamas","2024-09-09",0,0,0,0,0,0,0,0
"Bahamas","2024-09-10",0,0,0,0,0,0,0,0
"Bahamas","2024-09-11",0,0,0,0,0,0,0,0
"Bahamas","2024-09-12",0,0,0,0,0,0,0,0
"Bahamas","2024-09-13",0,0,0,0,0,0,0,0
"Bahamas","2024-09-14",0,0,0,0,0,0,0,0
"Bahamas","2024-09-15",0,0,0,0,0,0,0,0
"Bahamas","2024-09-16",0,0,0,0,0,0,0,0
"Bahamas","2024-09-17",0,0,0,0,0,0,0,0
"Bahamas","2024-09-18",0,0,0,0,0,0,0,0
"Bahamas","2024-09-19",0,0,0,0,0,0,0,0
"Bahamas","2024-09-20",0,0,0,0,0,0,0,0
"Bahamas","2024-09-21",0,0,0,0,0,0,0,0
"Bahamas","2024-09-22",0,0,0,0,0,0,0,0
"Bahamas","2024-09-23",0,0,0,0,0,0,0,0
"Bahamas","2024-09-24",0,0,0,0,0,0,0,0
"Bahamas","2024-09-25",0,0,0,0,0,0,0,0
"Bahamas","2024-09-26",0,0,0,0,0,0,0,0
"Bahamas","2024-09-27",0,0,0,0,0,0,0,0
"Bahamas","2024-09-28",0,0,0,0,0,0,0,0
"Bahamas","2024-09-29",0,0,0,0,0,0,0,0
"Bahamas","2024-09-30",0,0,0,0,0,0,0,0
"Bahamas","2024-10-01",0,0,0,0,0,0,0,0
"Bahamas","2024-10-02",0,0,0,0,0,0,0,0
"Bahamas","2024-10-03",0,0,0,0,0,0,0,0
"Bahamas","2024-10-04",0,0,0,0,0,0,0,0
"Bahamas","2024-10-05",0,0,0,0,0,0,0,0
"Bahamas","2024-10-06",0,0,0,0,0,0,0,0
"Bahamas","2024-10-07",0,0,0,0,0,0,0,0
"Bahamas","2024-10-08",0,0,0,0,0,0,0,0
"Bahamas","2024-10-09",0,0,0,0,0,0,0,0
"Bahamas","2024-10-10",0,0,0,0,0,0,0,0
"Bahamas","2024-10-11",0,0,0,0,0,0,0,0
"Bahamas","2024-10-12",0,0,0,0,0,0,0,0
"Bahamas","2024-10-13",0,0,0,0,0,0,0,0
"Bahamas","2024-10-14",0,0,0,0,0,0,0,0
"Bahamas","2024-10-15",0,0,0,0,0,0,0,0
"Bahamas","2024-10-16",0,0,0,0,0,0,0,0
"Bahamas","2024-10-17",0,0,0,0,0,0,0,0
"Bahamas","2024-10-18",0,0,0,0,0,0,0,0
"Bahamas","2024-10-19",0,0,0,0,0,0,0,0
"Bahamas","2024-10-20",0,0,0,0,0,0,0,0
"Bahamas","2024-10-21",0,0,0,0,0,0,0,0
"Bahamas","2024-10-22",0,0,0,0,0,0,0,0
"Bahamas","2024-10-23",0,0,0,0,0,0,0,0
"Bahamas","2024-10-24",0,0,0,0,0,0,0,0
"Bahamas","2024-10-25",0,0,0,0,0,0,0,0
"Bahamas","2024-10-26",0,0,0,0,0,0,0,0
"Bahamas","2024-10-27",0,0,0,0,0,0,0,0
"Bahamas","2024-10-28",0,0,0,0,0,0,0,0
"Bahamas","2024-10-29",0,0,0,0,0,0,0,0
"Bahamas","2024-10-30",0,0,0,0,0,0,0,0
"Bahamas","2024-10-31",0,0,0,0,0,0,0,0
"Bahamas","2024-11-01",0,0,0,0,0,0,0,0
"Bahamas","2024-11-02",0,0,0,0,0,0,0,0
"Bahamas","2024-11-03",0,0,0,0,0,0,0,0
"Bahamas","2024-11-04",0,0,0,0,0,0,0,0
"Bahamas","2024-11-05",0,0,0,0,0,0,0,0
"Bahamas","2024-11-06",0,0,0,0,0,0,0,0
"Bahamas","2024-11-07",0,0,0,0,0,0,0,0
"Bahamas","2024-11-08",0,0,0,0,0,0,0,0
"Bahamas","2024-11-09",0,0,0,0,0,0,0,0
"Bahamas","2024-11-10",0,0,0,0,0,0,0,0
"Bahamas","2024-11-11",0,0,0,0,0,0,0,0
"Bahamas","2024-11-12",0,0,0,0,0,0,0,0
"Bahamas","2024-11-13",0,0,0,0,0,0,0,0
"Bahamas","2024-11-14",0,0,0,0,0,0,0,0
"Bahamas","2024-11-15",0,0,0,0,0,0,0,0
"Bahamas","2024-11-16",0,0,0,0,0,0,0,0
"Bahamas","2024-11-17",0,0,0,0,0,0,0,0
"Bahamas","2024-11-18",0,0,0,0,0,0,0,0
"Bahamas","2024-11-19",0,0,0,0,0,0,0,0
"Bahamas","2024-11-20",0,0,0,0,0,0,0,0
"Bahamas","2024-11-21",0,0,0,0,0,0,0,0
"Bahamas","2024-11-22",0,0,0,0,0,0,0,0
"Bahamas","2024-11-23",0,0,0,0,0,0,0,0
"Bahamas","2024-11-24",0,0,0,0,0,0,0,0
"Bahamas","2024-11-25",0,0,0,0,0,0,0,0
"Bahamas","2024-11-26",0,0,0,0,0,0,0,0
"Bahamas","2024-11-27",0,0,0,0,0,0,0,0
"Bahamas","2024-11-28",0,0,0,0,0,0,0,0
"Bahamas","2024-11-29",0,0,0,0,0,0,0,0
"Bahamas","2024-11-30",0,0,0,0,0,0,0,0
"Bahamas","2024-12-01",0,0,0,0,0,0,0,0
"Bahamas","2024-12-02",0,0,0,0,0,0,0,0
"Bahamas","2024-12-03",0,0,0,0,0,0,0,0
"Bahamas","2024-12-04",0,0,0,0,0,0,0,0
"Bahamas","2024-12-05",0,0,0,0,0,0,0,0
"Bahamas","2024-12-06",0,0,0,0,0,0,0,0
"Bahamas","2024-12-07",0,0,0,0,0,0,0,0
"Bahamas","2024-12-08",0,0,0,0,0,0,0,0
"Bahamas","2024-12-09",0,0,0,0,0,0,0,0
"Bahamas","2024-12-10",0,0,0,0,0,0,0,0
"Bahamas","2024-12-11",0,0,0,0,0,0,0,0
"Bahamas","2024-12-12",0,0,0,0,0,0,0,0
"Bahamas","2024-12-13",0,0,0,0,0,0,0,0
"Bahamas","2024-12-14",0,0,0,0,0,0,0,0
"Bahamas","2024-12-15",0,0,0,0,0,0,0,0
"Bahamas","2024-12-16",0,0,0,0,0,0,0,0
"Bahamas","2024-12-17",0,0,0,0,0,0,0,0
"Bahamas","2024-12-18",0,0,0,0,0,0,0,0
"Bahamas","2024-12-19",0,0,0,0,0,0,0,0
"Bahamas","2024-12-20",0,0,0,0,0,0,0,0
"Bahamas","2024-12-21",0,0,0,0,0,0,0,0
"Bahamas","2024-12-22",0,0,0,0,0,0,0,0
"Bahamas","2024-12-23",0,0,0,0,0,0,0,0
"Bahamas","2024-12-24",0,0,0,0,0,0,0,0
"Bahamas","2024-12-25",0,0,0,0,0,0,0,0
"Bahamas","2024-12-26",0,0,0,0,0,0,0,0
"Bahamas","2024-12-27",0,0,0,0,0,0,0,0
"Bahamas","2024-12-28",0,0,0,0,0,0,0,0
"Bahamas","2024-12-29",0,0,0,0,0,0,0,0
"Bahamas","2024-12-30",0,0,0,0,0,0,0,0
"Bahamas","2024-12-31",0,0,0,0,0,0,0,0
"Bahamas","2025-01-01",0,0,0,0,0,0,0,0
"Bahamas","2025-01-02",0,0,0,0,0,0,0,0
"Bahamas","2025-01-03",0,0,0,0,0,0,0,0
"Bahamas","2025-01-04",0,0,0,0,0,0,0,0
"Bahamas","2025-01-05",0,0,0,0,0,0,0,0
"Bahamas","2025-01-06",0,0,0,0,0,0,0,0
"Bahamas","2025-01-07",0,0,0,0,0,0,0,0
"Bahamas","2025-01-08",0,0,0,0,0,0,0,0
"Bahamas","2025-01-09",0,0,0,0,0,0,0,0
"Bahamas","2025-01-10",0,0,0,0,0,0,0,0
"Bahamas","2025-01-11",0,0,0,0,0,0,0,0
"Bahamas","2025-01-12",0,0,0,0,0,0,0,0
"Bahamas","2025-01-13",0,0,0,0,0,0,0,0
"Barbados","2024-01-01",0,0,0,0,0,0,0,0
"Barbados","2024-01-02",0,0,0,0,0,0,0,0
"Barbados","2024-01-03",0,0,0,0,0,0,0,0
"Barbados","2024-01-04",0,0,0,0,0,0,0,0
"Barbados","2024-01-05",0,0,0,0,0,0,0,0
"Barbados","2024-01-06",0,0,0,0,0,0,0,0
"Barbados","2024-01-07",0,0,0,0,0,0,0,0
"Barbados","2024-01-08",0,0,0,0,0,0,0,0
"Barbados","2024-01-09",0,0,0,0,0,0,0,0
"Barbados","2024-01-10",0,0,0,0,0,0,0,0
"Barbados","2024-01-11",0,0,0,0,0,0,0,0
"Barbados","2024-01-12",0,0,0,0,0,0,0,0
"Barbados","2024-01-13",0,0,0,0,0,0,0,0
"Barbados","2024-01-14",0,0,0,0,0,0,0,0
"Barbados","2024-01-15",0,0,0,0,0,0,0,0
"Barbados","2024-01-16",0,0,0,0,0,0,0,0
"Barbados","2024-01-17",0,0,0,0,0,0,0,0
"Barbados","2024-01-18",0,0,0,0,0,0,0,0
"Barbados","2024-01-19",0,0,0,0,0,0,0,0
"Barbados","2024-01-20",0,0,0,0,0,0,0,0
"Barbados","2024-01-21",0,0,0,0,0,0,0,0
"Barbados","2024-01-22",0,0,0,0,0,0,0,0
"Barbados","2024-01-23",0,0,0,0,0,0,0,0
"Barbados","2024-01-24",0,0,0,0,0,0,0,0
"Barbados","2024-01-25",0,0,0,0,0,0,0,0
"Barbados","2024-01-26",0,0,0,0,0,0,0,0
"Barbados","2024-01-27",0,0,0,0,0,0,0,0
"Barbados","2024-01-28",0,0,0,0,0,0,0,0
"Barbados","2024-01-29",0,0,0,0,0,0,0,0
"Barbados","2024-01-30",0,0,0,0,0,0,0,0
"Barbados","2024-01-31",0,0,0,0,0,0,0,0
"Barbados","2024-02-01",0,0,0,0,0,0,0,0
"Barbados","2024-02-02",0,0,0,0,0,0,0,0
"Barbados","2024-02-03",0,0,0,0,0,0,0,0
"Barbados","2024-02-04",0,0,0,0,0,0,0,0
"Barbados","2024-02-05",0,0,0,0,0,0,0,0
"Barbados","2024-02-06",0,0,0,0,0,0,0,0
"Barbados","2024-02-07",0,0,0,0,0,0,0,0
"Barbados","2024-02-08",0,0,0,0,0,0,0,0
"Barbados","2024-02-09",0,0,0,0,0,0,0,0
"Barbados","2024-02-10",0,0,0,0,0,0,0,0
"Barbados","2024-02-11",0,0,0,0,0,0,0,0
"Barbados","2024-02-12",0,0,0,0,0,0,0,0
"Barbados","2024-02-13",0,0,0,0,0,0,0,0
"Barbados","2024-02-14",0,0,0,0,0,0,0,0
"Barbados","2024-02-15",0,0,0,0,0,0,0,0
"Barbados","2024-02-16",0,0,0,0,0,0,0,0
"Barbados","2024-02-17",0,0,0,0,0,0,0,0
"Barbados","2024-02-18",0,0,0,0,0,0,0,0
"Barbados","2024-02-19",0,0,0,0,0,0,0,0
"Barbados","2024-02-20",0,0,0,0,0,0,0,0
"Barbados","2024-02-21",0,0,0,0,0,0,0,0
"Barbados","2024-02-22",0,0,0,0,0,0,0,0
"Barbados","2024-02-23",0,0,0,0,0,0,0,0
"Barbados","2024-02-24",0,0,0,0,0,0,0,0
"Barbados","2024-02-25",0,0,0,0,0,0,0,0
"Barbados","2024-02-26",0,0,0,0,0,0,0,0
"Barbados","2024-02-27",0,0,0,0,0,0,0,0
"Barbados","2024-02-28",0,0,0,0,0,0,0,0
"Barbados","2024-02-29",0,0,0,0,0,0,0,0
"Barbados","2024-03-01",0,0,0,0,0,0,0,0
"Barbados","2024-03-02",0,0,0,0,0,0,0,0
"Barbados","2024-03-03",0,0,0,0,0,0,0,0
"Barbados","2024-03-04",0,0,0,0,0,0,0,0
"Barbados","2024-03-05",0,0,0,0,0,0,0,0
"Barbados","2024-03-06",0,0,0,0,0,0,0,0
"Barbados","2024-03-07",0,0,0,0,0,0,0,0
"Barbados","2024-03-08",0,0,0,0,0,0,0,0
"Barbados","2024-03-09",0,0,0,0,0,0,0,0
"Barbados","2024-03-10",0,0,0,0,0,0,0,0
"Barbados","2024-03-11",0,0,0,0,0,0,0,0
"Barbados","2024-03-12",0,0,0,0,0,0,0,0
"Barbados","2024-03-13",0,0,0,0,0,0,0,0
"Barbados","2024-03-14",0,0,0,0,0,0,0,0
"Barbados","2024-03-15",0,0,0,0,0,0,0,0
"Barbados","2024-03-16",0,0,0,0,0,0,0,0
"Barbados","2024-03-17",0,0,0,0,0,0,0,0
"Barbados","2024-03-18",0,0,0,0,0,0,0,0
"Barbados","2024-03-19",0,0,0,0,0,0,0,0
"Barbados","2024-03-20",0,0,0,0,0,0,0,0
"Barbados","2024-03-21",0,0,0,0,0,0,0,0
"Barbados","2024-03-22",0,0,0,0,0,0,0,0
"Barbados","2024-03-23",0,0,0,0,0,0,0,0
"Barbados","2024-03-24",0,0,0,0,0,0,0,0
"Barbados","2024-03-25",0,0,0,0,0,0,0,0
"Barbados","2024-03-26",0,0,0,0,0,0,0,0
"Barbados","2024-03-27",0,0,0,0,0,0,0,0
"Barbados","2024-03-28",0,0,0,0,0,0,0,0
"Barbados","2024-03-29",0,0,0,0,0,0,0,0
"Barbados","2024-03-30",0,0,0,0,0,0,0,0
"Barbados","2024-03-31",0,0,0,0,0,0,0,0
"Barbados","2024-04-01",0,0,0,0,0,0,0,0
"Barbados","2024-04-02",0,0,0,0,0,0,0,0
"Barbados","2024-04-03",0,0,0,0,0,0,0,0
"Barbados","2024-04-04",0,0,0,0,0,0,0,0
"Barbados","2024-04-05",0,0,0,0,0,0,0,0
"Barbados","2024-04-06",0,0,0,0,0,0,0,0
"Barbados","2024-04-07",0,0,0,0,0,0,0,0
"Barbados","2024-04-08",0,0,0,0,0,0,0,0
"Barbados","2024-04-09",0,0,0,0,0,0,0,0
"Barbados","2024-04-10",0,0,0,0,0,0,0,0
"Barbados","2024-04-11",0,0,0,0,0,0,0,0
"Barbados","2024-04-12",0,0,0,0,0,0,0,0
"Barbados","2024-04-13",0,0,0,0,0,0,0,0
"Barbados","2024-04-14",0,0,0,0,0,0,0,0
"Barbados","2024-04-15",0,0,0,0,0,0,0,0
"Barbados","2024-04-16",0,0,0,0,0,0,0,0
"Barbados","2024-04-17",0,0,0,0,0,0,0,0
"Barbados","2024-04-18",0,0,0,0,0,0,0,0
"Barbados","2024-04-19",0,0,0,0,0,0,0,0
"Barbados","2024-04-20",0,0,0,0,0,0,0,0
"Barbados","2024-04-21",0,0,0,0,0,0,0,0
"Barbados","2024-04-22",0,0,0,0,0,0,0,0
"Barbados","2024-04-23",0,0,0,0,0,0,0,0
"Barbados","2024-04-24",0,0,0,0,0,0,0,0
"Barbados","2024-04-25",0,0,0,0,0,0,0,0
"Barbados","2024-04-26",0,0,0,0,0,0,0,0
"Barbados","2024-04-27",0,0,0,0,0,0,0,0
"Barbados","2024-04-28",0,0,0,0,0,0,0,0
"Barbados","2024-04-29",0,0,0,0,0,0,0,0
"Barbados","2024-04-30",0,0,0,0,0,0,0,0
"Barbados","2024-05-01",0,0,0,0,0,0,0,0
"Barbados","2024-05-02",0,0,0,0,0,0,0,0
"Barbados","2024-05-03",0,0,0,0,0,0,0,0
"Barbados","2024-05-04",0,0,0,0,0,0,0,0
"Barbados","2024-05-05",0,0,0,0,0,0,0,0
"Barbados","2024-05-06",0,0,0,0,0,0,0,0
"Barbados","2024-05-07",0,0,0,0,0,0,0,0
"Barbados","2024-05-08",0,0,0,0,0,0,0,0
"Barbados","2024-05-09",0,0,0,0,0,0,0,0
"Barbados","2024-05-10",0,0,0,0,0,0,0,0
"Barbados","2024-05-11",0,0,0,0,0,0,0,0
"Barbados","2024-05-12",0,0,0,0,0,0,0,0
"Barbados","2024-05-13",0,0,0,0,0,0,0,0
"Barbados","2024-05-14",0,0,0,0,0,0,0,0
"Barbados","2024-05-15",0,0,0,0,0,0,0,0
"Barbados","2024-05-16",0,0,0,0,0,0,0,0
"Barbados","2024-05-17",0,0,0,0,0,0,0,0
"Barbados","2024-05-18",0,0,0,0,0,0,0,0
"Barbados","2024-05-19",0,0,0,0,0,0,0,0
"Barbados","2024-05-20",0,0,0,0,0,0,0,0
"Barbados","2024-05-21",0,0,0,0,0,0,0,0
"Barbados","2024-05-22",0,0,0,0,0,0,0,0
"Barbados","2024-05-23",0,0,0,0,0,0,0,0
"Barbados","2024-05-24",0,0,0,0,0,0,0,0
"Barbados","2024-05-25",0,0,0,0,0,0,0,0
"Barbados","2024-05-26",0,0,0,0,0,0,0,0
"Barbados","2024-05-27",0,0,0,0,0,0,0,0
"Barbados","2024-05-28",0,0,0,0,0,0,0,0
"Barbados","2024-05-29",0,0,0,0,0,0,0,0
"Barbados","2024-05-30",0,0,0,0,0,0,0,0
"Barbados","2024-05-31",0,0,0,0,0,0,0,0
"Barbados","2024-06-01",0,0,0,0,0,0,0,0
"Barbados","2024-06-02",0,0,0,0,0,0,0,0
"Barbados","2024-06-03",0,0,0,0,0,0,0,0
"Barbados","2024-06-04",0,0,0,0,0,0,0,0
"Barbados","2024-06-05",0,0,0,0,0,0,0,0
"Barbados","2024-06-06",0,0,0,0,0,0,0,0
"Barbados","2024-06-07",0,0,0,0,0,0,0,0
"Barbados","2024-06-08",0,0,0,0,0,0,0,0
"Barbados","2024-06-09",0,0,0,0,0,0,0,0
"Barbados","2024-06-10",0,0,0,0,0,0,0,0
"Barbados","2024-06-11",0,0,0,0,0,0,0,0
"Barbados","2024-06-12",0,0,0,0,0,0,0,0
"Barbados","2024-06-13",0,0,0,0,0,0,0,0
"Barbados","2024-06-14",0,0,0,0,0,0,0,0
"Barbados","2024-06-15",0,0,0,0,0,0,0,0
"Barbados","2024-06-16",0,0,0,0,0,0,0,0
"Barbados","2024-06-17",0,0,0,0,0,0,0,0
"Barbados","2024-06-18",0,0,0,0,0,0,0,0
"Barbados","2024-06-19",0,0,0,0,0,0,0,0
"Barbados","2024-06-20",0,0,0,0,0,0,0,0
"Barbados","2024-06-21",0,0,0,0,0,0,0,0
"Barbados","2024-06-22",0,0,0,0,0,0,0,0
"Barbados","2024-06-23",0,0,0,0,0,0,0,0
"Barbados","2024-06-24",0,0,0,0,0,0,0,0
"Barbados","2024-06-25",0,0,0,0,0,0,0,0
"Barbados","2024-06-26",0,0,0,0,0,0,0,0
"Barbados","2024-06-27",0,0,0,0,0,0,0,0
"Barbados","2024-06-28",0,0,0,0,0,0,0,0
"Barbados","2024-06-29",0,0,0,0,0,0,0,0
"Barbados","2024-06-30",0,0,0,0,0,0,0,0
"Barbados","2024-07-01",0,0,0,0,0,0,0,0
"Barbados","2024-07-02",0,0,0,0,0,0,0,0
"Barbados","2024-07-03",0,0,0,0,0,0,0,0
"Barbados","2024-07-04",0,0,0,0,0,0,0,0
"Barbados","2024-07-05",0,0,0,0,0,0,0,0
"Barbados","2024-07-06",0,0,0,0,0,0,0,0
"Barbados","2024-07-07",0,0,0,0,0,0,0,0
"Barbados","2024-07-08",0,0,0,0,0,0,0,0
"Barbados","2024-07-09",0,0,0,0,0,0,0,0
"Barbados","2024-07-10",0,0,0,0,0,0,0,0
"Barbados","2024-07-11",0,0,0,0,0,0,0,0
"Barbados","2024-07-12",0,0,0,0,0,0,0,0
"Barbados","2024-07-13",0,0,0,0,0,0,0,0
"Barbados","2024-07-14",0,0,0,0,0,0,0,0
"Barbados","2024-07-15",0,0,0,0,0,0,0,0
"Barbados","2024-07-16",0,0,0,0,0,0,0,0
"Barbados","2024-07-17",0,0,0,0,0,0,0,0
"Barbados","2024-07-18",0,0,0,0,0,0,0,0
"Barbados","2024-07-19",0,0,0,0,0,0,0,0
"Barbados","2024-07-20",0,0,0,0,0,0,0,0
"Barbados","2024-07-21",0,0,0,0,0,0,0,0
"Barbados","2024-07-22",0,0,0,0,0,0,0,0
"Barbados","2024-07-23",0,0,0,0,0,0,0,0
"Barbados","2024-07-24",0,0,0,0,0,0,0,0
"Barbados","2024-07-25",0,0,0,0,0,0,0,0
"Barbados","2024-07-26",0,0,0,0,0,0,0,0
"Barbados","2024-07-27",0,0,0,0,0,0,0,0
"Barbados","2024-07-28",0,0,0,0,0,0,0,0
"Barbados","2024-07-29",0,0,0,0,0,0,0,0
"Barbados","2024-07-30",0,0,0,0,0,0,0,0
"Barbados","2024-07-31",0,0,0,0,0,0,0,0
"Barbados","2024-08-01",0,0,0,0,0,0,0,0
"Barbados","2024-08-02",0,0,0,0,0,0,0,0
"Barbados","2024-08-03",0,0,0,0,0,0,0,0
"Barbados","2024-08-04",0,0,0,0,0,0,0,0
"Barbados","2024-08-05",0,0,0,0,0,0,0,0
"Barbados","2024-08-06",0,0,0,0,0,0,0,0
"Barbados","2024-08-07",0,0,0,0,0,0,0,0
"Barbados","2024-08-08",0,0,0,0,0,0,0,0
"Barbados","2024-08-09",0,0,0,0,0,0,0,0
"Barbados","2024-08-10",0,0,0,0,0,0,0,0
"Barbados","2024-08-11",0,0,0,0,0,0,0,0
"Barbados","2024-08-12",0,0,0,0,0,0,0,0
"Barbados","2024-08-13",0,0,0,0,0,0,0,0
"Barbados","2024-08-14",0,0,0,0,0,0,0,0
"Barbados","2024-08-15",0,0,0,0,0,0,0,0
"Barbados","2024-08-16",0,0,0,0,0,0,0,0
"Barbados","2024-08-17",0,0,0,0,0,0,0,0
"Barbados","2024-08-18",0,0,0,0,0,0,0,0
"Barbados","2024-08-19",0,0,0,0,0,0,0,0
"Barbados","2024-08-20",0,0,0,0,0,0,0,0
"Barbados","2024-08-21",0,0,0,0,0,0,0,0
"Barbados","2024-08-22",0,0,0,0,0,0,0,0
"Barbados","2024-08-23",0,0,0,0,0,0,0,0
"Barbados","2024-08-24",0,0,0,0,0,0,0,0
"Barbados","2024-08-25",0,0,0,0,0,0,0,0
"Barbados","2024-08-26",0,0,0,0,0,0,0,0
"Barbados","2024-08-27",0,0,0,0,0,0,0,0
"Barbados","2024-08-28",0,0,0,0,0,0,0,0
"Barbados","2024-08-29",0,0,0,0,0,0,0,0
"Barbados","2024-08-30",0,0,0,0,0,0,0,0
"Barbados","2024-08-31",0,0,0,0,0,0,0,0
"Barbados","2024-09-01",0,0,0,0,0,0,0,0
"Barbados","2024-09-02",0,0,0,0,0,0,0,0
"Barbados","2024-09-03",0,0,0,0,0,0,0,0
"Barbados","2024-09-04",0,0,0,0,0,0,0,0
"Barbados","2024-09-05",0,0,0,0,0,0,0,0
"Barbados","2024-09-06",0,0,0,0,0,0,0,0
"Barbados","2024-09-07",0,0,0,0,0,0,0,0
"Barbados","2024-09-08",0,0,0,0,0,0,0,0
"Barbados","2024-09-09",0,0,0,0,0,0,0,0
"Barbados","2024-09-10",0,0,0,0,0,0,0,0
"Barbados","2024-09-11",0,0,0,0,0,0,0,0
"Barbados","2024-09-12",0,0,0,0,0,0,0,0
"Barbados","2024-09-13",0,0,0,0,0,0,0,0
"Barbados","2024-09-14",0,0,0,0,0,0,0,0
"Barbados","2024-09-15",0,0,0,0,0,0,0,0
"Barbados","2024-09-16",0,0,0,0,0,0,0,0
"Barbados","2024-09-17",0,0,0,0,0,0,0,0
"Barbados","2024-09-18",0,0,0,0,0,0,0,0
"Barbados","2024-09-19",0,0,0,0,0,0,0,0
"Barbados","2024-09-20",0,0,0,0,0,0,0,0
"Barbados","2024-09-21",0,0,0,0,0,0,0,0
"Barbados","2024-09-22",0,0,0,0,0,0,0,0
"Barbados","2024-09-23",0,0,0,0,0,0,0,0
"Barbados","2024-09-24",0,0,0,0,0,0,0,0
"Barbados","2024-09-25",0,0,0,0,0,0,0,0
"Barbados","2024-09-26",0,0,0,0,0,0,0,0
"Barbados","2024-09-27",0,0,0,0,0,0,0,0
"Barbados","2024-09-28",0,0,0,0,0,0,0,0
"Barbados","2024-09-29",0,0,0,0,0,0,0,0
"Barbados","2024-09-30",0,0,0,0,0,0,0,0
"Barbados","2024-10-01",0,0,0,0,0,0,0,0
"Barbados","2024-10-02",0,0,0,0,0,0,0,0
"Barbados","2024-10-03",0,0,0,0,0,0,0,0
"Barbados","2024-10-04",0,0,0,0,0,0,0,0
"Barbados","2024-10-05",0,0,0,0,0,0,0,0
"Barbados","2024-10-06",0,0,0,0,0,0,0,0
"Barbados","2024-10-07",0,0,0,0,0,0,0,0
"Barbados","2024-10-08",0,0,0,0,0,0,0,0
"Barbados","2024-10-09",0,0,0,0,0,0,0,0
"Barbados","2024-10-10",0,0,0,0,0,0,0,0
"Barbados","2024-10-11",0,0,0,0,0,0,0,0
"Barbados","2024-10-12",0,0,0,0,0,0,0,0
"Barbados","2024-10-13",0,0,0,0,0,0,0,0
"Barbados","2024-10-14",0,0,0,0,0,0,0,0
"Barbados","2024-10-15",0,0,0,0,0,0,0,0
"Barbados","2024-10-16",0,0,0,0,0,0,0,0
"Barbados","2024-10-17",0,0,0,0,0,0,0,0
"Barbados","2024-10-18",0,0,0,0,0,0,0,0
"Barbados","2024-10-19",0,0,0,0,0,0,0,0
"Barbados","2024-10-20",0,0,0,0,0,0,0,0
"Barbados","2024-10-21",0,0,0,0,0,0,0,0
"Barbados","2024-10-22",0,0,0,0,0,0,0,0
"Barbados","2024-10-23",0,0,0,0,0,0,0,0
"Barbados","2024-10-24",0,0,0,0,0,0,0,0
"Barbados","2024-10-25",0,0,0,0,0,0,0,0
"Barbados","2024-10-26",0,0,0,0,0,0,0,0
"Barbados","2024-10-27",0,0,0,0,0,0,0,0
"Barbados","2024-10-28",0,0,0,0,0,0,0,0
"Barbados","2024-10-29",0,0,0,0,0,0,0,0
"Barbados","2024-10-30",0,0,0,0,0,0,0,0
"Barbados","2024-10-31",0,0,0,0,0,0,0,0
"Barbados","2024-11-01",0,0,0,0,0,0,0,0
"Barbados","2024-11-02",0,0,0,0,0,0,0,0
"Barbados","2024-11-03",0,0,0,0,0,0,0,0
"Barbados","2024-11-04",0,0,0,0,0,0,0,0
"Barbados","2024-11-05",0,0,0,0,0,0,0,0
"Barbados","2024-11-06",0,0,0,0,0,0,0,0
"Barbados","2024-11-07",0,0,0,0,0,0,0,0
"Barbados","2024-11-08",0,0,0,0,0,0,0,0
"Barbados","2024-11-09",0,0,0,0,0,0,0,0
"Barbados","2024-11-10",0,0,0,0,0,0,0,0
"Barbados","2024-11-11",0,0,0,0,0,0,0,0
"Barbados","2024-11-12",0,0,0,0,0,0,0,0
"Barbados","2024-11-13",0,0,0,0,0,0,0,0
"Barbados","2024-11-14",0,0,0,0,0,0,0,0
"Barbados","2024-11-15",0,0,0,0,0,0,0,0
"Barbados","2024-11-16",0,0,0,0,0,0,0,0
"Barbados","2024-11-17",0,0,0,0,0,0,0,0
"Barbados","2024-11-18",0,0,0,0,0,0,0,0
"Barbados","2024-11-19",0,0,0,0,0,0,0,0
"Barbados","2024-11-20",0,0,0,0,0,0,0,0
"Barbados","2024-11-21",0,0,0,0,0,0,0,0
"Barbados","2024-11-22",0,0,0,0,0,0,0,0
"Barbados","2024-11-23",0,0,0,0,0,0,0,0
"Barbados","2024-11-24",0,0,0,0,0,0,0,0
"Barbados","2024-11-25",0,0,0,0,0,0,0,0
"Barbados","2024-11-26",0,0,0,0,0,0,0,0
"Barbados","2024-11-27",0,0,0,0,0,0,0,0
"Barbados","2024-11-28",0,0,0,0,0,0,0,0
"Barbados","2024-11-29",0,0,0,0,0,0,0,0
"Barbados","2024-11-30",0,0,0,0,0,0,0,0
"Barbados","2024-12-01",0,0,0,0,0,0,0,0
"Barbados","2024-12-02",0,0,0,0,0,0,0,0
"Barbados","2024-12-03",0,0,0,0,0,0,0,0
"Barbados","2024-12-04",0,0,0,0,0,0,0,0
"Barbados","2024-12-05",0,0,0,0,0,0,0,0
"Barbados","2024-12-06",0,0,0,0,0,0,0,0
"Barbados","2024-12-07",0,0,0,0,0,0,0,0
"Barbados","2024-12-08",0,0,0,0,0,0,0,0
"Barbados","2024-12-09",0,0,0,0,0,0,0,0
"Barbados","2024-12-10",0,0,0,0,0,0,0,0
"Barbados","2024-12-11",0,0,0,0,0,0,0,0
"Barbados","2024-12-12",0,0,0,0,0,0,0,0
"Barbados","2024-12-13",0,0,0,0,0,0,0,0
"Barbados","2024-12-14",0,0,0,0,0,0,0,0
"Barbados","2024-12-15",0,0,0,0,0,0,0,0
"Barbados","2024-12-16",0,0,0,0,0,0,0,0
"Barbados","2024-12-17",0,0,0,0,0,0,0,0
"Barbados","2024-12-18",0,0,0,0,0,0,0,0
"Barbados","2024-12-19",0,0,0,0,0,0,0,0
"Barbados","2024-12-20",0,0,0,0,0,0,0,0
"Barbados","2024-12-21",0,0,0,0,0,0,0,0
"Barbados","2024-12-22",0,0,0,0,0,0,0,0
"Barbados","2024-12-23",0,0,0,0,0,0,0,0
"Barbados","2024-12-24",0,0,0,0,0,0,0,0
"Barbados","2024-12-25",0,0,0,0,0,0,0,0
"Barbados","2024-12-26",0,0,0,0,0,0,0,0
"Barbados","2024-12-27",0,0,0,0,0,0,0,0
"Barbados","2024-12-28",0,0,0,0,0,0,0,0
"Barbados","2024-12-29",0,0,0,0,0,0,0,0
"Barbados","2024-12-30",0,0,0,0,0,0,0,0
"Barbados","2024-12-31",0,0,0,0,0,0,0,0
"Barbados","2025-01-01",0,0,0,0,0,0,0,0
"Barbados","2025-01-02",0,0,0,0,0,0,0,0
"Barbados","2025-01-03",0,0,0,0,0,0,0,0
"Barbados","2025-01-04",0,0,0,0,0,0,0,0
"Barbados","2025-01-05",0,0,0,0,0,0,0,0
"Barbados","2025-01-06",0,0,0,0,0,0,0,0
"Barbados","2025-01-07",0,0,0,0,0,0,0,0
"Barbados","2025-01-08",0,0,0,0,0,0,0,0
"Barbados","2025-01-09",0,0,0,0,0,0,0,0
"Barbados","2025-01-10",0,0,0,0,0,0,0,0
"Barbados","2025-01-11",0,0,0,0,0,0,0,0
"Barbados","2025-01-12",0,0,0,0,0,0,0,0
"Barbados","2025-01-13",0,0,0,0,0,0,0,0
"Belgium","2024-01-01",0,0,0,0,0,0,0,0
"Belgium","2024-01-02",0,0,0,0,0,0,0,0
"Belgium","2024-01-03",0,0,0,0,0,0,0,0
"Belgium","2024-01-04",0,0,0,0,0,0,0,0
"Belgium","2024-01-05",0,0,0,0,0,0,0,0
"Belgium","2024-01-06",0,0,0,0,0,0,0,0
"Belgium","2024-01-07",0,0,0,0,0,0,0,0
"Belgium","2024-01-08",0,0,0,0,0,0,0,0
"Belgium","2024-01-09",0,0,0,0,0,0,0,0
"Belgium","2024-01-10",0,0,0,0,0,0,0,0
"Belgium","2024-01-11",0,0,0,0,0,0,0,0
"Belgium","2024-01-12",0,0,0,0,0,0,0,0
"Belgium","2024-01-13",0,0,0,0,0,0,0,0
"Belgium","2024-01-14",0,0,0,0,0,0,0,0
"Belgium","2024-01-15",0,0,0,0,0,0,0,0
"Belgium","2024-01-16",0,0,0,0,0,0,0,0
"Belgium","2024-01-17",0,0,0,0,0,0,0,0
"Belgium","2024-01-18",0,0,0,0,0,0,0,0
"Belgium","2024-01-19",0,0,0,0,0,0,0,0
"Belgium","2024-01-20",0,0,0,0,0,0,0,0
"Belgium","2024-01-21",0,0,0,0,0,0,0,0
"Belgium","2024-01-22",0,0,0,0,0,0,0,0
"Belgium","2024-01-23",0,0,0,0,0,0,0,0
"Belgium","2024-01-24",0,0,0,0,0,0,0,0
"Belgium","2024-01-25",0,0,0,0,0,0,0,0
"Belgium","2024-01-26",0,0,0,0,0,0,0,0
"Belgium","2024-01-27",0,0,0,0,0,0,0,0
"Belgium","2024-01-28",0,0,0,0,0,0,0,0
"Belgium","2024-01-29",0,0,0,0,0,0,0,0
"Belgium","2024-01-30",0,0,0,0,0,0,0,0
"Belgium","2024-01-31",0,3,3,0,3,3,0,0
"Belgium","2024-02-01",0,0,3,0,0,3,0,0
"Belgium","2024-02-02",0,0,3,0,0,3,0,0
"Belgium","2024-02-03",0,0,3,0,0,3,0,0
"Belgium","2024-02-04",0,0,3,0,0,3,0,0
"Belgium","2024-02-05",0,0,3,0,0,3,0,0
"Belgium","2024-02-06",0,0,3,0,0,3,0,0
"Belgium","2024-02-07",0,0,3,0,0,3,0,0
"Belgium","2024-02-08",0,0,3,0,1,4,0,0
"Belgium","2024-02-09",0,0,3,0,0,4,0,0
"Belgium","2024-02-10",0,0,3,0,0,4,0,0
"Belgium","2024-02-11",0,0,3,0,0,4,0,0
"Belgium","2024-02-12",0,0,3,0,0,4,0,0
"Belgium","2024-02-13",0,0,3,0,0,4,0,0
"Belgium","2024-02-14",0,0,3,0,0,4,0,0
"Belgium","2024-02-15",0,0,3,0,0,4,0,0
"Belgium","2024-02-16",0,0,3,0,0,4,0,0
"Belgium","2024-02-17",0,0,3,0,0,4,0,0
"Belgium","2024-02-18",0,0,3,0,0,4,0,0
"Belgium","2024-02-19",0,0,3,0,0,4,0,0
"Belgium","2024-02-20",0,0,3,0,0,4,0,0
"Belgium","2024-02-21",0,0,3,0,0,4,0,0
"Belgium","2024-02-22",0,0,3,0,1,5,0,0
"Belgium","2024-02-23",0,0,3,0,0,5,0,0
"Belgium","2024-02-24",0,0,3,0,0,5,0,0
"Belgium","2024-02-25",0,0,3,0,0,5,0,0
"Belgium","2024-02-26",0,0,3,0,0,5,0,0
"Belgium","2024-02-27",0,0,3,0,0,5,0,0
"Belgium","2024-02-28",0,0,3,0,0,5,0,0
"Belgium","2024-02-29",0,2,5,0,0,5,0,0
"Belgium","2024-03-01",0,0,5,0,0,5,0,0
"Belgium","2024-03-02",0,0,5,0,0,5,0,0
"Belgium","2024-03-03",0,0,5,0,0,5,0,0
"Belgium","2024-03-04",0,0,5,0,0,5,0,0
"Belgium","2024-03-05",0,0,5,0,0,5,0,0
"Belgium","2024-03-06",0,0,5,0,0,5,0,0
"Belgium","2024-03-07",0,0,5,0,0,5,0,0
"Belgium","2024-03-08",0,0,5,0,0,5,0,0
"Belgium","2024-03-09",0,0,5,0,0,5,0,0
"Belgium","2024-03-10",0,0,5,0,0,5,0,0
"Belgium","2024-03-11",0,0,5,0,0,5,0,0
"Belgium","2024-03-12",0,0,5,0,0,5,0,0
"Belgium","2024-03-13",0,0,5,0,0,5,0,0
"Belgium","2024-03-14",0,0,5,0,0,5,0,0
"Belgium","2024-03-15",0,0,5,0,0,5,0,0
"Belgium","2024-03-16",0,0,5,0,1,6,0,0
"Belgium","2024-03-17",0,0,5,0,0,6,0,0
"Belgium","2024-03-18",0,0,5,0,0,6,0,0
"Belgium","2024-03-19",0,0,5,0,0,6,0,0
"Belgium","2024-03-20",0,0,5,0,0,6,0,0
"Belgium","2024-03-21",0,0,5,0,0,6,0,0
"Belgium","2024-03-22",0,0,5,0,0,6,0,0
"Belgium","2024-03-23",0,0,5,0,0,6,0,0
"Belgium","2024-03-24",0,0,5,0,0,6,0,0
"Belgium","2024-03-25",0,0,5,0,0,6,0,0
"Belgium","2024-03-26",0,0,5,0,0,6,0,0
"Belgium","2024-03-27",0,0,5,0,0,6,0,0
"Belgium","2024-03-28",0,0,5,0,0,6,0,0
"Belgium","2024-03-29",0,0,5,0,0,6,0,0
"Belgium","2024-03-30",0,0,5,0,0,6,0,0
"Belgium","2024-03-31",0,1,6,0,0,6,0,0
"Belgium","2024-04-01",0,0,6,0,0,6,0,0
"Belgium","2024-04-02",0,0,6,0,0,6,0,0
"Belgium","2024-04-03",0,0,6,0,0,6,0,0
"Belgium","2024-04-04",0,0,6,0,0,6,0,0
"Belgium","2024-04-05",0,0,6,0,0,6,0,0
"Belgium","2024-04-06",0,0,6,0,1,7,0,0
"Belgium","2024-04-07",0,0,6,0,0,7,0,0
"Belgium","2024-04-08",0,0,6,0,0,7,0,0
"Belgium","2024-04-09",0,0,6,0,0,7,0,0
"Belgium","2024-04-10",0,0,6,0,0,7,0,0
"Belgium","2024-04-11",0,0,6,0,0,7,0,0
"Belgium","2024-04-12",0,0,6,0,0,7,0,0
"Belgium","2024-04-13",0,0,6,0,0,7,0,0
"Belgium","2024-04-14",0,0,6,0,0,7,0,0
"Belgium","2024-04-15",0,0,6,0,1,8,0,0
"Belgium","2024-04-16",0,0,6,0,0,8,0,0
"Belgium","2024-04-17",0,0,6,0,0,8,0,0
"Belgium","2024-04-18",0,0,6,0,0,8,0,0
"Belgium","2024-04-19",0,0,6,0,0,8,0,0
"Belgium","2024-04-20",0,0,6,0,0,8,0,0
"Belgium","2024-04-21",0,0,6,0,0,8,0,0
"Belgium","2024-04-22",0,0,6,0,0,8,0,0
"Belgium","2024-04-23",0,0,6,0,0,8,0,0
"Belgium","2024-04-24",0,0,6,0,0,8,0,0
"Belgium","2024-04-25",0,0,6,0,0,8,0,0
"Belgium","2024-04-26",0,0,6,0,1,9,0,0
"Belgium","2024-04-27",0,0,6,0,0,9,0,0
"Belgium","2024-04-28",0,0,6,0,0,9,0,0
"Belgium","2024-04-29",0,0,6,0,0,9,0,0
"Belgium","2024-04-30",0,3,9,0,0,9,0,0
"Belgium","2024-05-01",0,0,9,0,0,9,0,0
"Belgium","2024-05-02",0,0,9,0,0,9,0,0
"Belgium","2024-05-03",0,0,9,0,0,9,0,0
"Belgium","2024-05-04",0,0,9,0,0,9,0,0
"Belgium","2024-05-05",0,0,9,0,0,9,0,0
"Belgium","2024-05-06",0,0,9,0,0,9,0,0
"Belgium","2024-05-07",0,0,9,0,0,9,0,0
"Belgium","2024-05-08",0,0,9,0,0,9,0,0
"Belgium","2024-05-09",0,0,9,0,0,9,0,0
"Belgium","2024-05-10",0,0,9,0,0,9,0,0
"Belgium","2024-05-11",0,0,9,0,0,9,0,0
"Belgium","2024-05-12",0,0,9,0,0,9,0,0
"Belgium","2024-05-13",0,0,9,0,0,9,0,0
"Belgium","2024-05-14",0,0,9,0,0,9,0,0
"Belgium","2024-05-15",0,0,9,0,0,9,0,0
"Belgium","2024-05-16",0,0,9,0,0,9,0,0
"Belgium","2024-05-17",0,0,9,0,0,9,0,0
"Belgium","2024-05-18",0,0,9,0,0,9,0,0
"Belgium","2024-05-19",0,0,9,0,0,9,0,0
"Belgium","2024-05-20",0,0,9,0,0,9,0,0
"Belgium","2024-05-21",0,0,9,0,0,9,0,0
"Belgium","2024-05-22",0,0,9,0,0,9,0,0
"Belgium","2024-05-23",0,0,9,0,0,9,0,0
"Belgium","2024-05-24",0,0,9,0,0,9,0,0
"Belgium","2024-05-25",0,0,9,0,0,9,0,0
"Belgium","2024-05-26",0,0,9,0,0,9,0,0
"Belgium","2024-05-27",0,0,9,0,0,9,0,0
"Belgium","2024-05-28",0,0,9,0,0,9,0,0
"Belgium","2024-05-29",0,0,9,0,0,9,0,0
"Belgium","2024-05-30",0,0,9,0,0,9,0,0
"Belgium","2024-05-31",0,0,9,0,1,10,0,0
"Belgium","2024-06-01",0,0,9,0,0,10,0,0
"Belgium","2024-06-02",0,0,9,0,0,10,0,0
"Belgium","2024-06-03",0,0,9,0,0,10,0,0
"Belgium","2024-06-04",0,0,9,0,0,10,0,0
"Belgium","2024-06-05",0,0,9,0,0,10,0,0
"Belgium","2024-06-06",0,0,9,0,0,10,0,0
"Belgium","2024-06-07",0,0,9,0,0,10,0,0
"Belgium","2024-06-08",0,0,9,0,0,10,0,0
"Belgium","2024-06-09",0,0,9,0,0,10,0,0
"Belgium","2024-06-10",0,0,9,0,0,10,0,0
"Belgium","2024-06-11",0,0,9,0,0,10,0,0
"Belgium","2024-06-12",0,0,9,0,0,10,0,0
"Belgium","2024-06-13",0,0,9,0,0,10,0,0
"Belgium","2024-06-14",0,0,9,0,0,10,0,0
"Belgium","2024-06-15",0,0,9,0,0,10,0,0
"Belgium","2024-06-16",0,0,9,0,0,10,0,0
"Belgium","2024-06-17",0,0,9,0,0,10,0,0
"Belgium","2024-06-18",0,0,9,0,0,10,0,0
"Belgium","2024-06-19",0,0,9,0,0,10,0,0
"Belgium","2024-06-20",0,0,9,0,0,10,0,0
"Belgium","2024-06-21",0,0,9,0,0,10,0,0
"Belgium","2024-06-22",0,0,9,0,0,10,0,0
"Belgium","2024-06-23",0,0,9,0,0,10,0,0
"Belgium","2024-06-24",0,0,9,0,0,10,0,0
"Belgium","2024-06-25",0,0,9,0,0,10,0,0
"Belgium","2024-06-26",0,0,9,0,0,10,0,0
"Belgium","2024-06-27",0,0,9,0,0,10,0,0
"Belgium","2024-06-28",0,0,9,0,0,10,0,0
"Belgium","2024-06-29",0,0,9,0,0,10,0,0
"Belgium","2024-06-30",0,1,10,0,0,10,0,0
"Belgium","2024-07-01",0,0,10,0,0,10,0,0
"Belgium","2024-07-02",0,0,10,0,0,10,0,0
"Belgium","2024-07-03",0,0,10,0,0,10,0,0
"Belgium","2024-07-04",0,0,10,0,0,10,0,0
"Belgium","2024-07-05",0,0,10,0,0,10,0,0
"Belgium","2024-07-06",0,0,10,0,0,10,0,0
"Belgium","2024-07-07",0,0,10,0,0,10,0,0
"Belgium","2024-07-08",0,0,10,0,0,10,0,0
"Belgium","2024-07-09",0,0,10,0,0,10,0,0
"Belgium","2024-07-10",0,0,10,0,0,10,0,0
"Belgium","2024-07-11",0,0,10,0,0,10,0,0
"Belgium","2024-07-12",0,0,10,0,0,10,0,0
"Belgium","2024-07-13",0,0,10,0,0,10,0,0
"Belgium","2024-07-14",0,0,10,0,0,10,0,0
"Belgium","2024-07-15",0,0,10,0,0,10,0,0
"Belgium","2024-07-16",0,0,10,0,1,11,0,0
"Belgium","2024-07-17",0,0,10,0,0,11,0,0
"Belgium","2024-07-18",0,0,10,0,0,11,0,0
"Belgium","2024-07-19",0,0,10,0,0,11,0,0
"Belgium","2024-07-20",0,0,10,0,0,11,0,0
"Belgium","2024-07-21",0,0,10,0,0,11,0,0
"Belgium","2024-07-22",0,0,10,0,0,11,0,0
"Belgium","2024-07-23",0,0,10,0,0,11,0,0
"Belgium","2024-07-24",0,0,10,0,0,11,0,0
"Belgium","2024-07-25",0,0,10,0,0,11,0,0
"Belgium","2024-07-26",0,0,10,0,0,11,0,0
"Belgium","2024-07-27",0,0,10,0,0,11,0,0
"Belgium","2024-07-28",0,0,10,0,0,11,0,0
"Belgium","2024-07-29",0,0,10,0,0,11,0,0
"Belgium","2024-07-30",0,0,10,0,0,11,0,0
"Belgium","2024-07-31",0,1,11,0,0,11,0,0
"Belgium","2024-08-01",0,0,11,0,0,11,0,0
"Belgium","2024-08-02",0,0,11,0,0,11,0,0
"Belgium","2024-08-03",0,0,11,0,0,11,0,0
"Belgium","2024-08-04",0,0,11,0,0,11,0,0
"Belgium","2024-08-05",0,0,11,0,0,11,0,0
"Belgium","2024-08-06",0,0,11,0,1,12,0,0
"Belgium","2024-08-07",0,0,11,0,0,12,0,0
"Belgium","2024-08-08",0,0,11,0,0,12,0,0
"Belgium","2024-08-09",0,0,11,0,0,12,0,0
"Belgium","2024-08-10",0,0,11,0,0,12,0,0
"Belgium","2024-08-11",0,0,11,0,0,12,0,0
"Belgium","2024-08-12",0,0,11,0,0,12,0,0
"Belgium","2024-08-13",0,0,11,0,0,12,0,0
"Belgium","2024-08-14",0,0,11,0,0,12,0,0
"Belgium","2024-08-15",0,0,11,0,0,12,0,0
"Belgium","2024-08-16",0,0,11,0,1,13,0,0
"Belgium","2024-08-17",0,0,11,0,0,13,0,0
"Belgium","2024-08-18",0,0,11,0,0,13,0,0
"Belgium","2024-08-19",0,0,11,0,0,13,0,0
"Belgium","2024-08-20",0,0,11,0,0,13,0,0
"Belgium","2024-08-21",0,0,11,0,0,13,0,0
"Belgium","2024-08-22",0,0,11,0,0,13,0,0
"Belgium","2024-08-23",0,0,11,0,0,13,0,0
"Belgium","2024-08-24",0,0,11,0,0,13,0,0
"Belgium","2024-08-25",0,0,11,0,0,13,0,0
"Belgium","2024-08-26",0,0,11,0,1,14,0,0
"Belgium","2024-08-27",0,0,11,0,0,14,0,0
"Belgium","2024-08-28",0,0,11,0,0,14,0,0
"Belgium","2024-08-29",0,0,11,0,0,14,0,0
"Belgium","2024-08-30",0,0,11,0,0,14,0,0
"Belgium","2024-08-31",0,3,14,0,0,14,0,0
"Belgium","2024-09-01",0,0,14,0,0,14,0,0
"Belgium","2024-09-02",0,0,14,0,1,15,0,0
"Belgium","2024-09-03",0,0,14,0,0,15,0,0
"Belgium","2024-09-04",0,0,14,0,0,15,0,0
"Belgium","2024-09-05",0,0,14,0,0,15,0,0
"Belgium","2024-09-06",0,0,14,0,1,16,0,0
"Belgium","2024-09-07",0,0,14,0,0,16,0,0
"Belgium","2024-09-08",0,0,14,0,0,16,0,0
"Belgium","2024-09-09",0,0,14,0,0,16,0,0
"Belgium","2024-09-10",0,0,14,0,1,17,0,0
"Belgium","2024-09-11",0,0,14,0,0,17,0,0
"Belgium","2024-09-12",0,0,14,0,0,17,0,0
"Belgium","2024-09-13",0,0,14,0,0,17,0,0
"Belgium","2024-09-14",0,0,14,0,1,18,0,0
"Belgium","2024-09-15",0,0,14,0,0,18,0,0
"Belgium","2024-09-16",0,0,14,0,0,18,0,0
"Belgium","2024-09-17",0,0,14,0,1,19,0,0
"Belgium","2024-09-18",0,0,14,0,0,19,0,0
"Belgium","2024-09-19",0,0,14,0,0,19,0,0
"Belgium","2024-09-20",0,0,14,0,0,19,0,0
"Belgium","2024-09-21",0,0,14,0,1,20,0,0
"Belgium","2024-09-22",0,0,14,0,0,20,0,0
"Belgium","2024-09-23",0,0,14,0,0,20,0,0
"Belgium","2024-09-24",0,0,14,0,0,20,0,0
"Belgium","2024-09-25",0,0,14,0,1,21,0,0
"Belgium","2024-09-26",0,0,14,0,0,21,0,0
"Belgium","2024-09-27",0,0,14,0,0,21,0,0
"Belgium","2024-09-28",0,0,14,0,0,21,0,0
"Belgium","2024-09-29",0,0,14,0,1,22,0,0
"Belgium","2024-09-30",0,8,22,0,0,22,0,0
"Belgium","2024-10-01",0,0,22,0,1,23,0,0
"Belgium","2024-10-02",0,0,22,0,0,23,0,0
"Belgium","2024-10-03",0,0,22,0,1,24,0,0
"Belgium","2024-10-04",0,0,22,0,0,24,0,0
"Belgium","2024-10-05",0,0,22,0,1,25,0,0
"Belgium","2024-10-06",0,0,22,0,0,25,0,0
"Belgium","2024-10-07",0,0,22,0,1,26,0,0
"Belgium","2024-10-08",0,0,22,0,0,26,0,0
"Belgium","2024-10-09",0,0,22,0,1,27,0,0
"Belgium","2024-10-10",0,0,22,0,0,27,0,0
"Belgium","2024-10-11",0,0,22,0,1,28,0,0
"Belgium","2024-10-12",0,0,22,0,1,29,0,0
"Belgium","2024-10-13",0,0,22,0,0,29,0,0
"Belgium","2024-10-14",0,0,22,0,1,30,0,0
"Belgium","2024-10-15",0,0,22,0,0,30,0,0
"Belgium","2024-10-16",0,0,22,0,1,31,0,0
"Belgium","2024-10-17",0,0,22,0,0,31,0,0
"Belgium","2024-10-18",0,0,22,0,1,32,0,0
"Belgium","2024-10-19",0,0,22,0,0,32,0,0
"Belgium","2024-10-20",0,0,22,0,1,33,0,0
"Belgium","2024-10-21",0,0,22,0,1,34,0,0
"Belgium","2024-10-22",0,0,22,0,0,34,0,0
"Belgium","2024-10-23",0,0,22,0,1,35,0,0
"Belgium","2024-10-24",0,0,22,0,0,35,0,0
"Belgium","2024-10-25",0,0,22,0,1,36,0,0
"Belgium","2024-10-26",0,0,22,0,0,36,0,0
"Belgium","2024-10-27",0,0,22,0,1,37,0,0
"Belgium","2024-10-28",0,0,22,0,0,37,0,0
"Belgium","2024-10-29",0,0,22,0,1,38,0,0
"Belgium","2024-10-30",0,0,22,0,0,38,0,0
"Belgium","2024-10-31",0,17,39,0,1,39,0,0
"Belgium","2024-11-01",0,0,39,0,0,39,0,0
"Belgium","2024-11-02",0,0,39,0,0,39,0,0
"Belgium","2024-11-03",0,0,39,0,1,40,0,0
"Belgium","2024-11-04",0,0,39,0,0,40,0,0
"Belgium","2024-11-05",0,0,39,0,0,40,0,0
"Belgium","2024-11-06",0,0,39,0,0,40,0,0
"Belgium","2024-11-07",0,0,39,0,0,40,0,0
"Belgium","2024-11-08",0,0,39,0,1,41,0,0
"Belgium","2024-11-09",0,0,39,0,0,41,0,0
"Belgium","2024-11-10",0,0,39,0,0,41,0,0
"Belgium","2024-11-11",0,0,39,0,0,41,0,0
"Belgium","2024-11-12",0,0,39,0,0,41,0,0
"Belgium","2024-11-13",0,0,39,0,1,42,0,0
"Belgium","2024-11-14",0,0,39,0,0,42,0,0
"Belgium","2024-11-15",0,0,39,0,0,42,0,0
"Belgium","2024-11-16",0,0,39,0,0,42,0,0
"Belgium","2024-11-17",0,0,39,0,0,42,0,0
"Belgium","2024-11-18",0,0,39,0,1,43,0,0
"Belgium","2024-11-19",0,0,39,0,0,43,0,0
"Belgium","2024-11-20",0,0,39,0,0,43,0,0
"Belgium","2024-11-21",0,0,39,0,0,43,0,0
"Belgium","2024-11-22",0,0,39,0,0,43,0,0
"Belgium","2024-11-23",0,0,39,0,1,44,0,0
"Belgium","2024-11-24",0,0,39,0,0,44,0,0
"Belgium","2024-11-25",0,0,39,0,0,44,0,0
"Belgium","2024-11-26",0,0,39,0,0,44,0,0
"Belgium","2024-11-27",0,0,39,0,0,44,0,0
"Belgium","2024-11-28",0,0,39,0,1,45,0,0
"Belgium","2024-11-29",0,0,39,0,0,45,0,0
"Belgium","2024-11-30",0,6,45,0,0,45,0,0
"Belgium","2024-12-01",0,0,45,0,0,45,0,0
"Belgium","2024-12-02",0,0,45,0,0,45,0,0
"Belgium","2024-12-03",0,0,45,0,0,45,0,0
"Belgium","2024-12-04",0,0,45,0,0,45,0,0
"Belgium","2024-12-05",0,0,45,0,0,45,0,0
"Belgium","2024-12-06",0,0,45,0,0,45,0,0
"Belgium","2024-12-07",0,0,45,0,0,45,0,0
"Belgium","2024-12-08",0,0,45,0,0,45,0,0
"Belgium","2024-12-09",0,0,45,0,0,45,0,0
"Belgium","2024-12-10",0,0,45,0,0,45,0,0
"Belgium","2024-12-11",0,0,45,0,0,45,0,0
"Belgium","2024-12-12",0,0,45,0,0,45,0,0
"Belgium","2024-12-13",0,0,45,0,0,45,0,0
"Belgium","2024-12-14",0,0,45,0,0,45,0,0
"Belgium","2024-12-15",0,0,45,0,0,45,0,0
"Belgium","2024-12-16",0,0,45,0,0,45,0,0
"Belgium","2024-12-17",0,0,45,0,0,45,0,0
"Belgium","2024-12-18",0,0,45,0,0,45,0,0
"Belgium","2024-12-19",0,0,45,0,0,45,0,0
"Belgium","2024-12-20",0,0,45,0,0,45,0,0
"Belgium","2024-12-21",0,0,45,0,0,45,0,0
"Belgium","2024-12-22",0,0,45,0,0,45,0,0
"Belgium","2024-12-23",0,0,45,0,0,45,0,0
"Belgium","2024-12-24",0,0,45,0,0,45,0,0
"Belgium","2024-12-25",0,0,45,0,0,45,0,0
"Belgium","2024-12-26",0,0,45,0,0,45,0,0
"Belgium","2024-12-27",0,0,45,0,0,45,0,0
"Belgium","2024-12-28",0,0,45,0,0,45,0,0
"Belgium","2024-12-29",0,0,45,0,0,45,0,0
"Belgium","2024-12-30",0,0,45,0,0,45,0,0
"Belgium","2024-12-31",0,0,45,0,0,45,0,0
"Belgium","2025-01-01",0,0,45,0,0,45,0,0
"Belgium","2025-01-02",0,0,45,0,0,45,0,0
"Belgium","2025-01-03",0,0,45,0,0,45,0,0
"Belgium","2025-01-04",0,0,45,0,0,45,0,0
"Belgium","2025-01-05",0,0,45,0,0,45,0,0
"Belgium","2025-01-06",0,0,45,0,0,45,0,0
"Belgium","2025-01-07",0,0,45,0,0,45,0,0
"Belgium","2025-01-08",0,0,45,0,0,45,0,0
"Belgium","2025-01-09",0,0,45,0,0,45,0,0
"Belgium","2025-01-10",0,0,45,0,0,45,0,0
"Belgium","2025-01-11",0,0,45,0,0,45,0,0
"Belgium","2025-01-12",0,0,45,0,0,45,0,0
"Belgium","2025-01-13",0,0,45,0,0,45,0,0
"Benin","2024-01-01",0,0,0,0,0,0,0,0
"Benin","2024-01-02",0,0,0,0,0,0,0,0
"Benin","2024-01-03",0,0,0,0,0,0,0,0
"Benin","2024-01-04",0,0,0,0,0,0,0,0
"Benin","2024-01-05",0,0,0,0,0,0,0,0
"Benin","2024-01-06",0,0,0,0,0,0,0,0
"Benin","2024-01-07",0,0,0,0,0,0,0,0
"Benin","2024-01-08",0,0,0,0,0,0,0,0
"Benin","2024-01-09",0,0,0,0,0,0,0,0
"Benin","2024-01-10",0,0,0,0,0,0,0,0
"Benin","2024-01-11",0,0,0,0,0,0,0,0
"Benin","2024-01-12",0,0,0,0,0,0,0,0
"Benin","2024-01-13",0,0,0,0,0,0,0,0
"Benin","2024-01-14",0,0,0,0,0,0,0,0
"Benin","2024-01-15",0,0,0,0,0,0,0,0
"Benin","2024-01-16",0,0,0,0,0,0,0,0
"Benin","2024-01-17",0,0,0,0,0,0,0,0
"Benin","2024-01-18",0,0,0,0,0,0,0,0
"Benin","2024-01-19",0,0,0,0,0,0,0,0
"Benin","2024-01-20",0,0,0,0,0,0,0,0
"Benin","2024-01-21",0,0,0,0,0,0,0,0
"Benin","2024-01-22",0,0,0,0,0,0,0,0
"Benin","2024-01-23",0,0,0,0,0,0,0,0
"Benin","2024-01-24",0,0,0,0,0,0,0,0
"Benin","2024-01-25",0,0,0,0,0,0,0,0
"Benin","2024-01-26",0,0,0,0,0,0,0,0
"Benin","2024-01-27",0,0,0,0,0,0,0,0
"Benin","2024-01-28",0,0,0,0,0,0,0,0
"Benin","2024-01-29",0,0,0,0,0,0,0,0
"Benin","2024-01-30",0,0,0,0,0,0,0,0
"Benin","2024-01-31",0,0,0,0,0,0,0,0
"Benin","2024-02-01",0,0,0,0,0,0,0,0
"Benin","2024-02-02",0,0,0,0,0,0,0,0
"Benin","2024-02-03",0,0,0,0,0,0,0,0
"Benin","2024-02-04",0,0,0,0,0,0,0,0
"Benin","2024-02-05",0,0,0,0,0,0,0,0
"Benin","2024-02-06",0,0,0,0,0,0,0,0
"Benin","2024-02-07",0,0,0,0,0,0,0,0
"Benin","2024-02-08",0,0,0,0,0,0,0,0
"Benin","2024-02-09",0,0,0,0,0,0,0,0
"Benin","2024-02-10",0,0,0,0,0,0,0,0
"Benin","2024-02-11",0,0,0,0,0,0,0,0
"Benin","2024-02-12",0,0,0,0,0,0,0,0
"Benin","2024-02-13",0,0,0,0,0,0,0,0
"Benin","2024-02-14",0,0,0,0,0,0,0,0
"Benin","2024-02-15",0,0,0,0,0,0,0,0
"Benin","2024-02-16",0,0,0,0,0,0,0,0
"Benin","2024-02-17",0,0,0,0,0,0,0,0
"Benin","2024-02-18",0,0,0,0,0,0,0,0
"Benin","2024-02-19",0,0,0,0,0,0,0,0
"Benin","2024-02-20",0,0,0,0,0,0,0,0
"Benin","2024-02-21",0,0,0,0,0,0,0,0
"Benin","2024-02-22",0,0,0,0,0,0,0,0
"Benin","2024-02-23",0,0,0,0,0,0,0,0
"Benin","2024-02-24",0,0,0,0,0,0,0,0
"Benin","2024-02-25",0,0,0,0,0,0,0,0
"Benin","2024-02-26",0,0,0,0,0,0,0,0
"Benin","2024-02-27",0,0,0,0,0,0,0,0
"Benin","2024-02-28",0,0,0,0,0,0,0,0
"Benin","2024-02-29",0,0,0,0,0,0,0,0
"Benin","2024-03-01",0,0,0,0,0,0,0,0
"Benin","2024-03-02",0,0,0,0,0,0,0,0
"Benin","2024-03-03",0,0,0,0,0,0,0,0
"Benin","2024-03-04",0,0,0,0,0,0,0,0
"Benin","2024-03-05",0,0,0,0,0,0,0,0
"Benin","2024-03-06",0,0,0,0,0,0,0,0
"Benin","2024-03-07",0,0,0,0,0,0,0,0
"Benin","2024-03-08",0,0,0,0,0,0,0,0
"Benin","2024-03-09",0,0,0,0,0,0,0,0
"Benin","2024-03-10",0,0,0,0,0,0,0,0
"Benin","2024-03-11",0,0,0,0,0,0,0,0
"Benin","2024-03-12",0,0,0,0,0,0,0,0
"Benin","2024-03-13",0,0,0,0,0,0,0,0
"Benin","2024-03-14",0,0,0,0,0,0,0,0
"Benin","2024-03-15",0,0,0,0,0,0,0,0
"Benin","2024-03-16",0,0,0,0,0,0,0,0
"Benin","2024-03-17",0,0,0,0,0,0,0,0
"Benin","2024-03-18",0,0,0,0,0,0,0,0
"Benin","2024-03-19",0,0,0,0,0,0,0,0
"Benin","2024-03-20",0,0,0,0,0,0,0,0
"Benin","2024-03-21",0,0,0,0,0,0,0,0
"Benin","2024-03-22",0,0,0,0,0,0,0,0
"Benin","2024-03-23",0,0,0,0,0,0,0,0
"Benin","2024-03-24",0,0,0,0,0,0,0,0
"Benin","2024-03-25",0,0,0,0,0,0,0,0
"Benin","2024-03-26",0,0,0,0,0,0,0,0
"Benin","2024-03-27",0,0,0,0,0,0,0,0
"Benin","2024-03-28",0,0,0,0,0,0,0,0
"Benin","2024-03-29",0,0,0,0,0,0,0,0
"Benin","2024-03-30",0,0,0,0,0,0,0,0
"Benin","2024-03-31",0,0,0,0,0,0,0,0
"Benin","2024-04-01",0,0,0,0,0,0,0,0
"Benin","2024-04-02",0,0,0,0,0,0,0,0
"Benin","2024-04-03",0,0,0,0,0,0,0,0
"Benin","2024-04-04",0,0,0,0,0,0,0,0
"Benin","2024-04-05",0,0,0,0,0,0,0,0
"Benin","2024-04-06",0,0,0,0,0,0,0,0
"Benin","2024-04-07",0,0,0,0,0,0,0,0
"Benin","2024-04-08",0,0,0,0,0,0,0,0
"Benin","2024-04-09",0,0,0,0,0,0,0,0
"Benin","2024-04-10",0,0,0,0,0,0,0,0
"Benin","2024-04-11",0,0,0,0,0,0,0,0
"Benin","2024-04-12",0,0,0,0,0,0,0,0
"Benin","2024-04-13",0,0,0,0,0,0,0,0
"Benin","2024-04-14",0,0,0,0,0,0,0,0
"Benin","2024-04-15",0,0,0,0,0,0,0,0
"Benin","2024-04-16",0,0,0,0,0,0,0,0
"Benin","2024-04-17",0,0,0,0,0,0,0,0
"Benin","2024-04-18",0,0,0,0,0,0,0,0
"Benin","2024-04-19",0,0,0,0,0,0,0,0
"Benin","2024-04-20",0,0,0,0,0,0,0,0
"Benin","2024-04-21",0,0,0,0,0,0,0,0
"Benin","2024-04-22",0,0,0,0,0,0,0,0
"Benin","2024-04-23",0,0,0,0,0,0,0,0
"Benin","2024-04-24",0,0,0,0,0,0,0,0
"Benin","2024-04-25",0,0,0,0,0,0,0,0
"Benin","2024-04-26",0,0,0,0,0,0,0,0
"Benin","2024-04-27",0,0,0,0,0,0,0,0
"Benin","2024-04-28",0,0,0,0,0,0,0,0
"Benin","2024-04-29",0,0,0,0,0,0,0,0
"Benin","2024-04-30",0,0,0,0,0,0,0,0
"Benin","2024-05-01",0,0,0,0,0,0,0,0
"Benin","2024-05-02",0,0,0,0,0,0,0,0
"Benin","2024-05-03",0,0,0,0,0,0,0,0
"Benin","2024-05-04",0,0,0,0,0,0,0,0
"Benin","2024-05-05",0,0,0,0,0,0,0,0
"Benin","2024-05-06",0,0,0,0,0,0,0,0
"Benin","2024-05-07",0,0,0,0,0,0,0,0
"Benin","2024-05-08",0,0,0,0,0,0,0,0
"Benin","2024-05-09",0,0,0,0,0,0,0,0
"Benin","2024-05-10",0,0,0,0,0,0,0,0
"Benin","2024-05-11",0,0,0,0,0,0,0,0
"Benin","2024-05-12",0,0,0,0,0,0,0,0
"Benin","2024-05-13",0,0,0,0,0,0,0,0
"Benin","2024-05-14",0,0,0,0,0,0,0,0
"Benin","2024-05-15",0,0,0,0,0,0,0,0
"Benin","2024-05-16",0,0,0,0,0,0,0,0
"Benin","2024-05-17",0,0,0,0,0,0,0,0
"Benin","2024-05-18",0,0,0,0,0,0,0,0
"Benin","2024-05-19",0,0,0,0,0,0,0,0
"Benin","2024-05-20",0,0,0,0,0,0,0,0
"Benin","2024-05-21",0,0,0,0,0,0,0,0
"Benin","2024-05-22",0,0,0,0,0,0,0,0
"Benin","2024-05-23",0,0,0,0,0,0,0,0
"Benin","2024-05-24",0,0,0,0,0,0,0,0
"Benin","2024-05-25",0,0,0,0,0,0,0,0
"Benin","2024-05-26",0,0,0,0,0,0,0,0
"Benin","2024-05-27",0,0,0,0,0,0,0,0
"Benin","2024-05-28",0,0,0,0,0,0,0,0
"Benin","2024-05-29",0,0,0,0,0,0,0,0
"Benin","2024-05-30",0,0,0,0,0,0,0,0
"Benin","2024-05-31",0,0,0,0,0,0,0,0
"Benin","2024-06-01",0,0,0,0,0,0,0,0
"Benin","2024-06-02",0,0,0,0,0,0,0,0
"Benin","2024-06-03",0,0,0,0,0,0,0,0
"Benin","2024-06-04",0,0,0,0,0,0,0,0
"Benin","2024-06-05",0,0,0,0,0,0,0,0
"Benin","2024-06-06",0,0,0,0,0,0,0,0
"Benin","2024-06-07",0,0,0,0,0,0,0,0
"Benin","2024-06-08",0,0,0,0,0,0,0,0
"Benin","2024-06-09",0,0,0,0,0,0,0,0
"Benin","2024-06-10",0,0,0,0,0,0,0,0
"Benin","2024-06-11",0,0,0,0,0,0,0,0
"Benin","2024-06-12",0,0,0,0,0,0,0,0
"Benin","2024-06-13",0,0,0,0,0,0,0,0
"Benin","2024-06-14",0,0,0,0,0,0,0,0
"Benin","2024-06-15",0,0,0,0,0,0,0,0
"Benin","2024-06-16",0,0,0,0,0,0,0,0
"Benin","2024-06-17",0,0,0,0,0,0,0,0
"Benin","2024-06-18",0,0,0,0,0,0,0,0
"Benin","2024-06-19",0,0,0,0,0,0,0,0
"Benin","2024-06-20",0,0,0,0,0,0,0,0
"Benin","2024-06-21",0,0,0,0,0,0,0,0
"Benin","2024-06-22",0,0,0,0,0,0,0,0
"Benin","2024-06-23",0,0,0,0,0,0,0,0
"Benin","2024-06-24",0,0,0,0,0,0,0,0
"Benin","2024-06-25",0,0,0,0,0,0,0,0
"Benin","2024-06-26",0,0,0,0,0,0,0,0
"Benin","2024-06-27",0,0,0,0,0,0,0,0
"Benin","2024-06-28",0,0,0,0,0,0,0,0
"Benin","2024-06-29",0,0,0,0,0,0,0,0
"Benin","2024-06-30",0,0,0,0,0,0,0,0
"Benin","2024-07-01",0,0,0,0,0,0,0,0
"Benin","2024-07-02",0,0,0,0,0,0,0,0
"Benin","2024-07-03",0,0,0,0,0,0,0,0
"Benin","2024-07-04",0,0,0,0,0,0,0,0
"Benin","2024-07-05",0,0,0,0,0,0,0,0
"Benin","2024-07-06",0,0,0,0,0,0,0,0
"Benin","2024-07-07",0,0,0,0,0,0,0,0
"Benin","2024-07-08",0,0,0,0,0,0,0,0
"Benin","2024-07-09",0,0,0,0,0,0,0,0
"Benin","2024-07-10",0,0,0,0,0,0,0,0
"Benin","2024-07-11",0,0,0,0,0,0,0,0
"Benin","2024-07-12",0,0,0,0,0,0,0,0
"Benin","2024-07-13",0,0,0,0,0,0,0,0
"Benin","2024-07-14",0,0,0,0,0,0,0,0
"Benin","2024-07-15",0,0,0,0,0,0,0,0
"Benin","2024-07-16",0,0,0,0,0,0,0,0
"Benin","2024-07-17",0,0,0,0,0,0,0,0
"Benin","2024-07-18",0,0,0,0,0,0,0,0
"Benin","2024-07-19",0,0,0,0,0,0,0,0
"Benin","2024-07-20",0,0,0,0,0,0,0,0
"Benin","2024-07-21",0,0,0,0,0,0,0,0
"Benin","2024-07-22",0,0,0,0,0,0,0,0
"Benin","2024-07-23",0,0,0,0,0,0,0,0
"Benin","2024-07-24",0,0,0,0,0,0,0,0
"Benin","2024-07-25",0,0,0,0,0,0,0,0
"Benin","2024-07-26",0,0,0,0,0,0,0,0
"Benin","2024-07-27",0,0,0,0,0,0,0,0
"Benin","2024-07-28",0,0,0,0,0,0,0,0
"Benin","2024-07-29",0,0,0,0,0,0,0,0
"Benin","2024-07-30",0,0,0,0,0,0,0,0
"Benin","2024-07-31",0,0,0,0,0,0,0,0
"Benin","2024-08-01",0,0,0,0,0,0,0,0
"Benin","2024-08-02",0,0,0,0,0,0,0,0
"Benin","2024-08-03",0,0,0,0,0,0,0,0
"Benin","2024-08-04",0,0,0,0,0,0,0,0
"Benin","2024-08-05",0,0,0,0,0,0,0,0
"Benin","2024-08-06",0,0,0,0,0,0,0,0
"Benin","2024-08-07",0,0,0,0,0,0,0,0
"Benin","2024-08-08",0,0,0,0,0,0,0,0
"Benin","2024-08-09",0,0,0,0,0,0,0,0
"Benin","2024-08-10",0,0,0,0,0,0,0,0
"Benin","2024-08-11",0,0,0,0,0,0,0,0
"Benin","2024-08-12",0,0,0,0,0,0,0,0
"Benin","2024-08-13",0,0,0,0,0,0,0,0
"Benin","2024-08-14",0,0,0,0,0,0,0,0
"Benin","2024-08-15",0,0,0,0,0,0,0,0
"Benin","2024-08-16",0,0,0,0,0,0,0,0
"Benin","2024-08-17",0,0,0,0,0,0,0,0
"Benin","2024-08-18",0,0,0,0,0,0,0,0
"Benin","2024-08-19",0,0,0,0,0,0,0,0
"Benin","2024-08-20",0,0,0,0,0,0,0,0
"Benin","2024-08-21",0,0,0,0,0,0,0,0
"Benin","2024-08-22",0,0,0,0,0,0,0,0
"Benin","2024-08-23",0,0,0,0,0,0,0,0
"Benin","2024-08-24",0,0,0,0,0,0,0,0
"Benin","2024-08-25",0,0,0,0,0,0,0,0
"Benin","2024-08-26",0,0,0,0,0,0,0,0
"Benin","2024-08-27",0,0,0,0,0,0,0,0
"Benin","2024-08-28",0,0,0,0,0,0,0,0
"Benin","2024-08-29",0,0,0,0,0,0,0,0
"Benin","2024-08-30",0,0,0,0,0,0,0,0
"Benin","2024-08-31",0,0,0,0,0,0,0,0
"Benin","2024-09-01",0,0,0,0,0,0,0,0
"Benin","2024-09-02",0,0,0,0,0,0,0,0
"Benin","2024-09-03",0,0,0,0,0,0,0,0
"Benin","2024-09-04",0,0,0,0,0,0,0,0
"Benin","2024-09-05",0,0,0,0,0,0,0,0
"Benin","2024-09-06",0,0,0,0,0,0,0,0
"Benin","2024-09-07",0,0,0,0,0,0,0,0
"Benin","2024-09-08",0,0,0,0,0,0,0,0
"Benin","2024-09-09",0,0,0,0,0,0,0,0
"Benin","2024-09-10",0,0,0,0,0,0,0,0
"Benin","2024-09-11",0,0,0,0,0,0,0,0
"Benin","2024-09-12",0,0,0,0,0,0,0,0
"Benin","2024-09-13",0,0,0,0,0,0,0,0
"Benin","2024-09-14",0,0,0,0,0,0,0,0
"Benin","2024-09-15",0,0,0,0,0,0,0,0
"Benin","2024-09-16",0,0,0,0,0,0,0,0
"Benin","2024-09-17",0,0,0,0,0,0,0,0
"Benin","2024-09-18",0,0,0,0,0,0,0,0
"Benin","2024-09-19",0,0,0,0,0,0,0,0
"Benin","2024-09-20",0,0,0,0,0,0,0,0
"Benin","2024-09-21",0,0,0,0,0,0,0,0
"Benin","2024-09-22",0,0,0,0,0,0,0,0
"Benin","2024-09-23",0,0,0,0,0,0,0,0
"Benin","2024-09-24",0,0,0,0,0,0,0,0
"Benin","2024-09-25",0,0,0,0,0,0,0,0
"Benin","2024-09-26",0,0,0,0,0,0,0,0
"Benin","2024-09-27",0,0,0,0,0,0,0,0
"Benin","2024-09-28",0,0,0,0,0,0,0,0
"Benin","2024-09-29",0,0,0,0,0,0,0,0
"Benin","2024-09-30",0,0,0,0,0,0,0,0
"Benin","2024-10-01",0,0,0,0,0,0,0,0
"Benin","2024-10-02",0,0,0,0,0,0,0,0
"Benin","2024-10-03",0,0,0,0,0,0,0,0
"Benin","2024-10-04",0,0,0,0,0,0,0,0
"Benin","2024-10-05",0,0,0,0,0,0,0,0
"Benin","2024-10-06",0,0,0,0,0,0,0,0
"Benin","2024-10-07",0,0,0,0,0,0,0,0
"Benin","2024-10-08",0,0,0,0,0,0,0,0
"Benin","2024-10-09",0,0,0,0,0,0,0,0
"Benin","2024-10-10",0,0,0,0,0,0,0,0
"Benin","2024-10-11",0,0,0,0,0,0,0,0
"Benin","2024-10-12",0,0,0,0,0,0,0,0
"Benin","2024-10-13",0,0,0,0,0,0,0,0
"Benin","2024-10-14",0,0,0,0,0,0,0,0
"Benin","2024-10-15",0,0,0,0,0,0,0,0
"Benin","2024-10-16",0,0,0,0,0,0,0,0
"Benin","2024-10-17",0,0,0,0,0,0,0,0
"Benin","2024-10-18",0,0,0,0,0,0,0,0
"Benin","2024-10-19",0,0,0,0,0,0,0,0
"Benin","2024-10-20",0,0,0,0,0,0,0,0
"Benin","2024-10-21",0,0,0,0,0,0,0,0
"Benin","2024-10-22",0,0,0,0,0,0,0,0
"Benin","2024-10-23",0,0,0,0,0,0,0,0
"Benin","2024-10-24",0,0,0,0,0,0,0,0
"Benin","2024-10-25",0,0,0,0,0,0,0,0
"Benin","2024-10-26",0,0,0,0,0,0,0,0
"Benin","2024-10-27",0,0,0,0,0,0,0,0
"Benin","2024-10-28",0,0,0,0,0,0,0,0
"Benin","2024-10-29",0,0,0,0,0,0,0,0
"Benin","2024-10-30",0,0,0,0,0,0,0,0
"Benin","2024-10-31",0,0,0,0,0,0,0,0
"Benin","2024-11-01",0,0,0,0,0,0,0,0
"Benin","2024-11-02",0,0,0,0,0,0,0,0
"Benin","2024-11-03",0,0,0,0,0,0,0,0
"Benin","2024-11-04",0,0,0,0,0,0,0,0
"Benin","2024-11-05",0,0,0,0,0,0,0,0
"Benin","2024-11-06",0,0,0,0,0,0,0,0
"Benin","2024-11-07",0,0,0,0,0,0,0,0
"Benin","2024-11-08",0,0,0,0,0,0,0,0
"Benin","2024-11-09",0,0,0,0,0,0,0,0
"Benin","2024-11-10",0,0,0,0,0,0,0,0
"Benin","2024-11-11",0,0,0,0,0,0,0,0
"Benin","2024-11-12",0,0,0,0,0,0,0,0
"Benin","2024-11-13",0,0,0,0,0,0,0,0
"Benin","2024-11-14",0,0,0,0,0,0,0,0
"Benin","2024-11-15",0,0,0,0,0,0,0,0
"Benin","2024-11-16",0,0,0,0,0,0,0,0
"Benin","2024-11-17",0,0,0,0,0,0,0,0
"Benin","2024-11-18",0,0,0,0,0,0,0,0
"Benin","2024-11-19",0,0,0,0,0,0,0,0
"Benin","2024-11-20",0,0,0,0,0,0,0,0
"Benin","2024-11-21",0,0,0,0,0,0,0,0
"Benin","2024-11-22",0,0,0,0,0,0,0,0
"Benin","2024-11-23",0,0,0,0,0,0,0,0
"Benin","2024-11-24",0,0,0,0,0,0,0,0
"Benin","2024-11-25",0,0,0,0,0,0,0,0
"Benin","2024-11-26",0,0,0,0,0,0,0,0
"Benin","2024-11-27",0,0,0,0,0,0,0,0
"Benin","2024-11-28",0,0,0,0,0,0,0,0
"Benin","2024-11-29",0,0,0,0,0,0,0,0
"Benin","2024-11-30",0,0,0,0,0,0,0,0
"Benin","2024-12-01",0,0,0,0,0,0,0,0
"Benin","2024-12-02",0,0,0,0,0,0,0,0
"Benin","2024-12-03",0,0,0,0,0,0,0,0
"Benin","2024-12-04",0,0,0,0,0,0,0,0
"Benin","2024-12-05",0,0,0,0,0,0,0,0
"Benin","2024-12-06",0,0,0,0,0,0,0,0
"Benin","2024-12-07",0,0,0,0,0,0,0,0
"Benin","2024-12-08",0,0,0,0,0,0,0,0
"Benin","2024-12-09",0,0,0,0,0,0,0,0
"Benin","2024-12-10",0,0,0,0,0,0,0,0
"Benin","2024-12-11",0,0,0,0,0,0,0,0
"Benin","2024-12-12",0,0,0,0,0,0,0,0
"Benin","2024-12-13",0,0,0,0,0,0,0,0
"Benin","2024-12-14",0,0,0,0,0,0,0,0
"Benin","2024-12-15",0,0,0,0,0,0,0,0
"Benin","2024-12-16",0,0,0,0,0,0,0,0
"Benin","2024-12-17",0,0,0,0,0,0,0,0
"Benin","2024-12-18",0,0,0,0,0,0,0,0
"Benin","2024-12-19",0,0,0,0,0,0,0,0
"Benin","2024-12-20",0,0,0,0,0,0,0,0
"Benin","2024-12-21",0,0,0,0,0,0,0,0
"Benin","2024-12-22",0,0,0,0,0,0,0,0
"Benin","2024-12-23",0,0,0,0,0,0,0,0
"Benin","2024-12-24",0,0,0,0,0,0,0,0
"Benin","2024-12-25",0,0,0,0,0,0,0,0
"Benin","2024-12-26",0,0,0,0,0,0,0,0
"Benin","2024-12-27",0,0,0,0,0,0,0,0
"Benin","2024-12-28",0,0,0,0,0,0,0,0
"Benin","2024-12-29",0,0,0,0,0,0,0,0
"Benin","2024-12-30",0,0,0,0,0,0,0,0
"Benin","2024-12-31",0,0,0,0,0,0,0,0
"Benin","2025-01-01",0,0,0,0,0,0,0,0
"Benin","2025-01-02",0,0,0,0,0,0,0,0
"Benin","2025-01-03",0,0,0,0,0,0,0,0
"Benin","2025-01-04",0,0,0,0,0,0,0,0
"Benin","2025-01-05",0,0,0,0,0,0,0,0
"Benin","2025-01-06",0,0,0,0,0,0,0,0
"Benin","2025-01-07",0,0,0,0,0,0,0,0
"Benin","2025-01-08",0,0,0,0,0,0,0,0
"Benin","2025-01-09",0,0,0,0,0,0,0,0
"Benin","2025-01-10",0,0,0,0,0,0,0,0
"Benin","2025-01-11",0,0,0,0,0,0,0,0
"Benin","2025-01-12",0,0,0,0,0,0,0,0
"Benin","2025-01-13",0,0,0,0,0,0,0,0
"Bermuda","2024-01-01",0,0,0,0,0,0,0,0
"Bermuda","2024-01-02",0,0,0,0,0,0,0,0
"Bermuda","2024-01-03",0,0,0,0,0,0,0,0
"Bermuda","2024-01-04",0,0,0,0,0,0,0,0
"Bermuda","2024-01-05",0,0,0,0,0,0,0,0
"Bermuda","2024-01-06",0,0,0,0,0,0,0,0
"Bermuda","2024-01-07",0,0,0,0,0,0,0,0
"Bermuda","2024-01-08",0,0,0,0,0,0,0,0
"Bermuda","2024-01-09",0,0,0,0,0,0,0,0
"Bermuda","2024-01-10",0,0,0,0,0,0,0,0
"Bermuda","2024-01-11",0,0,0,0,0,0,0,0
"Bermuda","2024-01-12",0,0,0,0,0,0,0,0
"Bermuda","2024-01-13",0,0,0,0,0,0,0,0
"Bermuda","2024-01-14",0,0,0,0,0,0,0,0
"Bermuda","2024-01-15",0,0,0,0,0,0,0,0
"Bermuda","2024-01-16",0,0,0,0,0,0,0,0
"Bermuda","2024-01-17",0,0,0,0,0,0,0,0
"Bermuda","2024-01-18",0,0,0,0,0,0,0,0
"Bermuda","2024-01-19",0,0,0,0,0,0,0,0
"Bermuda","2024-01-20",0,0,0,0,0,0,0,0
"Bermuda","2024-01-21",0,0,0,0,0,0,0,0
"Bermuda","2024-01-22",0,0,0,0,0,0,0,0
"Bermuda","2024-01-23",0,0,0,0,0,0,0,0
"Bermuda","2024-01-24",0,0,0,0,0,0,0,0
"Bermuda","2024-01-25",0,0,0,0,0,0,0,0
"Bermuda","2024-01-26",0,0,0,0,0,0,0,0
"Bermuda","2024-01-27",0,0,0,0,0,0,0,0
"Bermuda","2024-01-28",0,0,0,0,0,0,0,0
"Bermuda","2024-01-29",0,0,0,0,0,0,0,0
"Bermuda","2024-01-30",0,0,0,0,0,0,0,0
"Bermuda","2024-01-31",0,0,0,0,0,0,0,0
"Bermuda","2024-02-01",0,0,0,0,0,0,0,0
"Bermuda","2024-02-02",0,0,0,0,0,0,0,0
"Bermuda","2024-02-03",0,0,0,0,0,0,0,0
"Bermuda","2024-02-04",0,0,0,0,0,0,0,0
"Bermuda","2024-02-05",0,0,0,0,0,0,0,0
"Bermuda","2024-02-06",0,0,0,0,0,0,0,0
"Bermuda","2024-02-07",0,0,0,0,0,0,0,0
"Bermuda","2024-02-08",0,0,0,0,0,0,0,0
"Bermuda","2024-02-09",0,0,0,0,0,0,0,0
"Bermuda","2024-02-10",0,0,0,0,0,0,0,0
"Bermuda","2024-02-11",0,0,0,0,0,0,0,0
"Bermuda","2024-02-12",0,0,0,0,0,0,0,0
"Bermuda","2024-02-13",0,0,0,0,0,0,0,0
"Bermuda","2024-02-14",0,0,0,0,0,0,0,0
"Bermuda","2024-02-15",0,0,0,0,0,0,0,0
"Bermuda","2024-02-16",0,0,0,0,0,0,0,0
"Bermuda","2024-02-17",0,0,0,0,0,0,0,0
"Bermuda","2024-02-18",0,0,0,0,0,0,0,0
"Bermuda","2024-02-19",0,0,0,0,0,0,0,0
"Bermuda","2024-02-20",0,0,0,0,0,0,0,0
"Bermuda","2024-02-21",0,0,0,0,0,0,0,0
"Bermuda","2024-02-22",0,0,0,0,0,0,0,0
"Bermuda","2024-02-23",0,0,0,0,0,0,0,0
"Bermuda","2024-02-24",0,0,0,0,0,0,0,0
"Bermuda","2024-02-25",0,0,0,0,0,0,0,0
"Bermuda","2024-02-26",0,0,0,0,0,0,0,0
"Bermuda","2024-02-27",0,0,0,0,0,0,0,0
"Bermuda","2024-02-28",0,0,0,0,0,0,0,0
"Bermuda","2024-02-29",0,0,0,0,0,0,0,0
"Bermuda","2024-03-01",0,0,0,0,0,0,0,0
"Bermuda","2024-03-02",0,0,0,0,0,0,0,0
"Bermuda","2024-03-03",0,0,0,0,0,0,0,0
"Bermuda","2024-03-04",0,0,0,0,0,0,0,0
"Bermuda","2024-03-05",0,0,0,0,0,0,0,0
"Bermuda","2024-03-06",0,0,0,0,0,0,0,0
"Bermuda","2024-03-07",0,0,0,0,0,0,0,0
"Bermuda","2024-03-08",0,0,0,0,0,0,0,0
"Bermuda","2024-03-09",0,0,0,0,0,0,0,0
"Bermuda","2024-03-10",0,0,0,0,0,0,0,0
"Bermuda","2024-03-11",0,0,0,0,0,0,0,0
"Bermuda","2024-03-12",0,0,0,0,0,0,0,0
"Bermuda","2024-03-13",0,0,0,0,0,0,0,0
"Bermuda","2024-03-14",0,0,0,0,0,0,0,0
"Bermuda","2024-03-15",0,0,0,0,0,0,0,0
"Bermuda","2024-03-16",0,0,0,0,0,0,0,0
"Bermuda","2024-03-17",0,0,0,0,0,0,0,0
"Bermuda","2024-03-18",0,0,0,0,0,0,0,0
"Bermuda","2024-03-19",0,0,0,0,0,0,0,0
"Bermuda","2024-03-20",0,0,0,0,0,0,0,0
"Bermuda","2024-03-21",0,0,0,0,0,0,0,0
"Bermuda","2024-03-22",0,0,0,0,0,0,0,0
"Bermuda","2024-03-23",0,0,0,0,0,0,0,0
"Bermuda","2024-03-24",0,0,0,0,0,0,0,0
"Bermuda","2024-03-25",0,0,0,0,0,0,0,0
"Bermuda","2024-03-26",0,0,0,0,0,0,0,0
"Bermuda","2024-03-27",0,0,0,0,0,0,0,0
"Bermuda","2024-03-28",0,0,0,0,0,0,0,0
"Bermuda","2024-03-29",0,0,0,0,0,0,0,0
"Bermuda","2024-03-30",0,0,0,0,0,0,0,0
"Bermuda","2024-03-31",0,0,0,0,0,0,0,0
"Bermuda","2024-04-01",0,0,0,0,0,0,0,0
"Bermuda","2024-04-02",0,0,0,0,0,0,0,0
"Bermuda","2024-04-03",0,0,0,0,0,0,0,0
"Bermuda","2024-04-04",0,0,0,0,0,0,0,0
"Bermuda","2024-04-05",0,0,0,0,0,0,0,0
"Bermuda","2024-04-06",0,0,0,0,0,0,0,0
"Bermuda","2024-04-07",0,0,0,0,0,0,0,0
"Bermuda","2024-04-08",0,0,0,0,0,0,0,0
"Bermuda","2024-04-09",0,0,0,0,0,0,0,0
"Bermuda","2024-04-10",0,0,0,0,0,0,0,0
"Bermuda","2024-04-11",0,0,0,0,0,0,0,0
"Bermuda","2024-04-12",0,0,0,0,0,0,0,0
"Bermuda","2024-04-13",0,0,0,0,0,0,0,0
"Bermuda","2024-04-14",0,0,0,0,0,0,0,0
"Bermuda","2024-04-15",0,0,0,0,0,0,0,0
"Bermuda","2024-04-16",0,0,0,0,0,0,0,0
"Bermuda","2024-04-17",0,0,0,0,0,0,0,0
"Bermuda","2024-04-18",0,0,0,0,0,0,0,0
"Bermuda","2024-04-19",0,0,0,0,0,0,0,0
"Bermuda","2024-04-20",0,0,0,0,0,0,0,0
"Bermuda","2024-04-21",0,0,0,0,0,0,0,0
"Bermuda","2024-04-22",0,0,0,0,0,0,0,0
"Bermuda","2024-04-23",0,0,0,0,0,0,0,0
"Bermuda","2024-04-24",0,0,0,0,0,0,0,0
"Bermuda","2024-04-25",0,0,0,0,0,0,0,0
"Bermuda","2024-04-26",0,0,0,0,0,0,0,0
"Bermuda","2024-04-27",0,0,0,0,0,0,0,0
"Bermuda","2024-04-28",0,0,0,0,0,0,0,0
"Bermuda","2024-04-29",0,0,0,0,0,0,0,0
"Bermuda","2024-04-30",0,0,0,0,0,0,0,0
"Bermuda","2024-05-01",0,0,0,0,0,0,0,0
"Bermuda","2024-05-02",0,0,0,0,0,0,0,0
"Bermuda","2024-05-03",0,0,0,0,0,0,0,0
"Bermuda","2024-05-04",0,0,0,0,0,0,0,0
"Bermuda","2024-05-05",0,0,0,0,0,0,0,0
"Bermuda","2024-05-06",0,0,0,0,0,0,0,0
"Bermuda","2024-05-07",0,0,0,0,0,0,0,0
"Bermuda","2024-05-08",0,0,0,0,0,0,0,0
"Bermuda","2024-05-09",0,0,0,0,0,0,0,0
"Bermuda","2024-05-10",0,0,0,0,0,0,0,0
"Bermuda","2024-05-11",0,0,0,0,0,0,0,0
"Bermuda","2024-05-12",0,0,0,0,0,0,0,0
"Bermuda","2024-05-13",0,0,0,0,0,0,0,0
"Bermuda","2024-05-14",0,0,0,0,0,0,0,0
"Bermuda","2024-05-15",0,0,0,0,0,0,0,0
"Bermuda","2024-05-16",0,0,0,0,0,0,0,0
"Bermuda","2024-05-17",0,0,0,0,0,0,0,0
"Bermuda","2024-05-18",0,0,0,0,0,0,0,0
"Bermuda","2024-05-19",0,0,0,0,0,0,0,0
"Bermuda","2024-05-20",0,0,0,0,0,0,0,0
"Bermuda","2024-05-21",0,0,0,0,0,0,0,0
"Bermuda","2024-05-22",0,0,0,0,0,0,0,0
"Bermuda","2024-05-23",0,0,0,0,0,0,0,0
"Bermuda","2024-05-24",0,0,0,0,0,0,0,0
"Bermuda","2024-05-25",0,0,0,0,0,0,0,0
"Bermuda","2024-05-26",0,0,0,0,0,0,0,0
"Bermuda","2024-05-27",0,0,0,0,0,0,0,0
"Bermuda","2024-05-28",0,0,0,0,0,0,0,0
"Bermuda","2024-05-29",0,0,0,0,0,0,0,0
"Bermuda","2024-05-30",0,0,0,0,0,0,0,0
"Bermuda","2024-05-31",0,0,0,0,0,0,0,0
"Bermuda","2024-06-01",0,0,0,0,0,0,0,0
"Bermuda","2024-06-02",0,0,0,0,0,0,0,0
"Bermuda","2024-06-03",0,0,0,0,0,0,0,0
"Bermuda","2024-06-04",0,0,0,0,0,0,0,0
"Bermuda","2024-06-05",0,0,0,0,0,0,0,0
"Bermuda","2024-06-06",0,0,0,0,0,0,0,0
"Bermuda","2024-06-07",0,0,0,0,0,0,0,0
"Bermuda","2024-06-08",0,0,0,0,0,0,0,0
"Bermuda","2024-06-09",0,0,0,0,0,0,0,0
"Bermuda","2024-06-10",0,0,0,0,0,0,0,0
"Bermuda","2024-06-11",0,0,0,0,0,0,0,0
"Bermuda","2024-06-12",0,0,0,0,0,0,0,0
"Bermuda","2024-06-13",0,0,0,0,0,0,0,0
"Bermuda","2024-06-14",0,0,0,0,0,0,0,0
"Bermuda","2024-06-15",0,0,0,0,0,0,0,0
"Bermuda","2024-06-16",0,0,0,0,0,0,0,0
"Bermuda","2024-06-17",0,0,0,0,0,0,0,0
"Bermuda","2024-06-18",0,0,0,0,0,0,0,0
"Bermuda","2024-06-19",0,0,0,0,0,0,0,0
"Bermuda","2024-06-20",0,0,0,0,0,0,0,0
"Bermuda","2024-06-21",0,0,0,0,0,0,0,0
"Bermuda","2024-06-22",0,0,0,0,0,0,0,0
"Bermuda","2024-06-23",0,0,0,0,0,0,0,0
"Bermuda","2024-06-24",0,0,0,0,0,0,0,0
"Bermuda","2024-06-25",0,0,0,0,0,0,0,0
"Bermuda","2024-06-26",0,0,0,0,0,0,0,0
"Bermuda","2024-06-27",0,0,0,0,0,0,0,0
"Bermuda","2024-06-28",0,0,0,0,0,0,0,0
"Bermuda","2024-06-29",0,0,0,0,0,0,0,0
"Bermuda","2024-06-30",0,0,0,0,0,0,0,0
"Bermuda","2024-07-01",0,0,0,0,0,0,0,0
"Bermuda","2024-07-02",0,0,0,0,0,0,0,0
"Bermuda","2024-07-03",0,0,0,0,0,0,0,0
"Bermuda","2024-07-04",0,0,0,0,0,0,0,0
"Bermuda","2024-07-05",0,0,0,0,0,0,0,0
"Bermuda","2024-07-06",0,0,0,0,0,0,0,0
"Bermuda","2024-07-07",0,0,0,0,0,0,0,0
"Bermuda","2024-07-08",0,0,0,0,0,0,0,0
"Bermuda","2024-07-09",0,0,0,0,0,0,0,0
"Bermuda","2024-07-10",0,0,0,0,0,0,0,0
"Bermuda","2024-07-11",0,0,0,0,0,0,0,0
"Bermuda","2024-07-12",0,0,0,0,0,0,0,0
"Bermuda","2024-07-13",0,0,0,0,0,0,0,0
"Bermuda","2024-07-14",0,0,0,0,0,0,0,0
"Bermuda","2024-07-15",0,0,0,0,0,0,0,0
"Bermuda","2024-07-16",0,0,0,0,0,0,0,0
"Bermuda","2024-07-17",0,0,0,0,0,0,0,0
"Bermuda","2024-07-18",0,0,0,0,0,0,0,0
"Bermuda","2024-07-19",0,0,0,0,0,0,0,0
"Bermuda","2024-07-20",0,0,0,0,0,0,0,0
"Bermuda","2024-07-21",0,0,0,0,0,0,0,0
"Bermuda","2024-07-22",0,0,0,0,0,0,0,0
"Bermuda","2024-07-23",0,0,0,0,0,0,0,0
"Bermuda","2024-07-24",0,0,0,0,0,0,0,0
"Bermuda","2024-07-25",0,0,0,0,0,0,0,0
"Bermuda","2024-07-26",0,0,0,0,0,0,0,0
"Bermuda","2024-07-27",0,0,0,0,0,0,0,0
"Bermuda","2024-07-28",0,0,0,0,0,0,0,0
"Bermuda","2024-07-29",0,0,0,0,0,0,0,0
"Bermuda","2024-07-30",0,0,0,0,0,0,0,0
"Bermuda","2024-07-31",0,0,0,0,0,0,0,0
"Bermuda","2024-08-01",0,0,0,0,0,0,0,0
"Bermuda","2024-08-02",0,0,0,0,0,0,0,0
"Bermuda","2024-08-03",0,0,0,0,0,0,0,0
"Bermuda","2024-08-04",0,0,0,0,0,0,0,0
"Bermuda","2024-08-05",0,0,0,0,0,0,0,0
"Bermuda","2024-08-06",0,0,0,0,0,0,0,0
"Bermuda","2024-08-07",0,0,0,0,0,0,0,0
"Bermuda","2024-08-08",0,0,0,0,0,0,0,0
"Bermuda","2024-08-09",0,0,0,0,0,0,0,0
"Bermuda","2024-08-10",0,0,0,0,0,0,0,0
"Bermuda","2024-08-11",0,0,0,0,0,0,0,0
"Bermuda","2024-08-12",0,0,0,0,0,0,0,0
"Bermuda","2024-08-13",0,0,0,0,0,0,0,0
"Bermuda","2024-08-14",0,0,0,0,0,0,0,0
"Bermuda","2024-08-15",0,0,0,0,0,0,0,0
"Bermuda","2024-08-16",0,0,0,0,0,0,0,0
"Bermuda","2024-08-17",0,0,0,0,0,0,0,0
"Bermuda","2024-08-18",0,0,0,0,0,0,0,0
"Bermuda","2024-08-19",0,0,0,0,0,0,0,0
"Bermuda","2024-08-20",0,0,0,0,0,0,0,0
"Bermuda","2024-08-21",0,0,0,0,0,0,0,0
"Bermuda","2024-08-22",0,0,0,0,0,0,0,0
"Bermuda","2024-08-23",0,0,0,0,0,0,0,0
"Bermuda","2024-08-24",0,0,0,0,0,0,0,0
"Bermuda","2024-08-25",0,0,0,0,0,0,0,0
"Bermuda","2024-08-26",0,0,0,0,0,0,0,0
"Bermuda","2024-08-27",0,0,0,0,0,0,0,0
"Bermuda","2024-08-28",0,0,0,0,0,0,0,0
"Bermuda","2024-08-29",0,0,0,0,0,0,0,0
"Bermuda","2024-08-30",0,0,0,0,0,0,0,0
"Bermuda","2024-08-31",0,0,0,0,0,0,0,0
"Bermuda","2024-09-01",0,0,0,0,0,0,0,0
"Bermuda","2024-09-02",0,0,0,0,0,0,0,0
"Bermuda","2024-09-03",0,0,0,0,0,0,0,0
"Bermuda","2024-09-04",0,0,0,0,0,0,0,0
"Bermuda","2024-09-05",0,0,0,0,0,0,0,0
"Bermuda","2024-09-06",0,0,0,0,0,0,0,0
"Bermuda","2024-09-07",0,0,0,0,0,0,0,0
"Bermuda","2024-09-08",0,0,0,0,0,0,0,0
"Bermuda","2024-09-09",0,0,0,0,0,0,0,0
"Bermuda","2024-09-10",0,0,0,0,0,0,0,0
"Bermuda","2024-09-11",0,0,0,0,0,0,0,0
"Bermuda","2024-09-12",0,0,0,0,0,0,0,0
"Bermuda","2024-09-13",0,0,0,0,0,0,0,0
"Bermuda","2024-09-14",0,0,0,0,0,0,0,0
"Bermuda","2024-09-15",0,0,0,0,0,0,0,0
"Bermuda","2024-09-16",0,0,0,0,0,0,0,0
"Bermuda","2024-09-17",0,0,0,0,0,0,0,0
"Bermuda","2024-09-18",0,0,0,0,0,0,0,0
"Bermuda","2024-09-19",0,0,0,0,0,0,0,0
"Bermuda","2024-09-20",0,0,0,0,0,0,0,0
"Bermuda","2024-09-21",0,0,0,0,0,0,0,0
"Bermuda","2024-09-22",0,0,0,0,0,0,0,0
"Bermuda","2024-09-23",0,0,0,0,0,0,0,0
"Bermuda","2024-09-24",0,0,0,0,0,0,0,0
"Bermuda","2024-09-25",0,0,0,0,0,0,0,0
"Bermuda","2024-09-26",0,0,0,0,0,0,0,0
"Bermuda","2024-09-27",0,0,0,0,0,0,0,0
"Bermuda","2024-09-28",0,0,0,0,0,0,0,0
"Bermuda","2024-09-29",0,0,0,0,0,0,0,0
"Bermuda","2024-09-30",0,0,0,0,0,0,0,0
"Bermuda","2024-10-01",0,0,0,0,0,0,0,0
"Bermuda","2024-10-02",0,0,0,0,0,0,0,0
"Bermuda","2024-10-03",0,0,0,0,0,0,0,0
"Bermuda","2024-10-04",0,0,0,0,0,0,0,0
"Bermuda","2024-10-05",0,0,0,0,0,0,0,0
"Bermuda","2024-10-06",0,0,0,0,0,0,0,0
"Bermuda","2024-10-07",0,0,0,0,0,0,0,0
"Bermuda","2024-10-08",0,0,0,0,0,0,0,0
"Bermuda","2024-10-09",0,0,0,0,0,0,0,0
"Bermuda","2024-10-10",0,0,0,0,0,0,0,0
"Bermuda","2024-10-11",0,0,0,0,0,0,0,0
"Bermuda","2024-10-12",0,0,0,0,0,0,0,0
"Bermuda","2024-10-13",0,0,0,0,0,0,0,0
"Bermuda","2024-10-14",0,0,0,0,0,0,0,0
"Bermuda","2024-10-15",0,0,0,0,0,0,0,0
"Bermuda","2024-10-16",0,0,0,0,0,0,0,0
"Bermuda","2024-10-17",0,0,0,0,0,0,0,0
"Bermuda","2024-10-18",0,0,0,0,0,0,0,0
"Bermuda","2024-10-19",0,0,0,0,0,0,0,0
"Bermuda","2024-10-20",0,0,0,0,0,0,0,0
"Bermuda","2024-10-21",0,0,0,0,0,0,0,0
"Bermuda","2024-10-22",0,0,0,0,0,0,0,0
"Bermuda","2024-10-23",0,0,0,0,0,0,0,0
"Bermuda","2024-10-24",0,0,0,0,0,0,0,0
"Bermuda","2024-10-25",0,0,0,0,0,0,0,0
"Bermuda","2024-10-26",0,0,0,0,0,0,0,0
"Bermuda","2024-10-27",0,0,0,0,0,0,0,0
"Bermuda","2024-10-28",0,0,0,0,0,0,0,0
"Bermuda","2024-10-29",0,0,0,0,0,0,0,0
"Bermuda","2024-10-30",0,0,0,0,0,0,0,0
"Bermuda","2024-10-31",0,0,0,0,0,0,0,0
"Bermuda","2024-11-01",0,0,0,0,0,0,0,0
"Bermuda","2024-11-02",0,0,0,0,0,0,0,0
"Bermuda","2024-11-03",0,0,0,0,0,0,0,0
"Bermuda","2024-11-04",0,0,0,0,0,0,0,0
"Bermuda","2024-11-05",0,0,0,0,0,0,0,0
"Bermuda","2024-11-06",0,0,0,0,0,0,0,0
"Bermuda","2024-11-07",0,0,0,0,0,0,0,0
"Bermuda","2024-11-08",0,0,0,0,0,0,0,0
"Bermuda","2024-11-09",0,0,0,0,0,0,0,0
"Bermuda","2024-11-10",0,0,0,0,0,0,0,0
"Bermuda","2024-11-11",0,0,0,0,0,0,0,0
"Bermuda","2024-11-12",0,0,0,0,0,0,0,0
"Bermuda","2024-11-13",0,0,0,0,0,0,0,0
"Bermuda","2024-11-14",0,0,0,0,0,0,0,0
"Bermuda","2024-11-15",0,0,0,0,0,0,0,0
"Bermuda","2024-11-16",0,0,0,0,0,0,0,0
"Bermuda","2024-11-17",0,0,0,0,0,0,0,0
"Bermuda","2024-11-18",0,0,0,0,0,0,0,0
"Bermuda","2024-11-19",0,0,0,0,0,0,0,0
"Bermuda","2024-11-20",0,0,0,0,0,0,0,0
"Bermuda","2024-11-21",0,0,0,0,0,0,0,0
"Bermuda","2024-11-22",0,0,0,0,0,0,0,0
"Bermuda","2024-11-23",0,0,0,0,0,0,0,0
"Bermuda","2024-11-24",0,0,0,0,0,0,0,0
"Bermuda","2024-11-25",0,0,0,0,0,0,0,0
"Bermuda","2024-11-26",0,0,0,0,0,0,0,0
"Bermuda","2024-11-27",0,0,0,0,0,0,0,0
"Bermuda","2024-11-28",0,0,0,0,0,0,0,0
"Bermuda","2024-11-29",0,0,0,0,0,0,0,0
"Bermuda","2024-11-30",0,0,0,0,0,0,0,0
"Bermuda","2024-12-01",0,0,0,0,0,0,0,0
"Bermuda","2024-12-02",0,0,0,0,0,0,0,0
"Bermuda","2024-12-03",0,0,0,0,0,0,0,0
"Bermuda","2024-12-04",0,0,0,0,0,0,0,0
"Bermuda","2024-12-05",0,0,0,0,0,0,0,0
"Bermuda","2024-12-06",0,0,0,0,0,0,0,0
"Bermuda","2024-12-07",0,0,0,0,0,0,0,0
"Bermuda","2024-12-08",0,0,0,0,0,0,0,0
"Bermuda","2024-12-09",0,0,0,0,0,0,0,0
"Bermuda","2024-12-10",0,0,0,0,0,0,0,0
"Bermuda","2024-12-11",0,0,0,0,0,0,0,0
"Bermuda","2024-12-12",0,0,0,0,0,0,0,0
"Bermuda","2024-12-13",0,0,0,0,0,0,0,0
"Bermuda","2024-12-14",0,0,0,0,0,0,0,0
"Bermuda","2024-12-15",0,0,0,0,0,0,0,0
"Bermuda","2024-12-16",0,0,0,0,0,0,0,0
"Bermuda","2024-12-17",0,0,0,0,0,0,0,0
"Bermuda","2024-12-18",0,0,0,0,0,0,0,0
"Bermuda","2024-12-19",0,0,0,0,0,0,0,0
"Bermuda","2024-12-20",0,0,0,0,0,0,0,0
"Bermuda","2024-12-21",0,0,0,0,0,0,0,0
"Bermuda","2024-12-22",0,0,0,0,0,0,0,0
"Bermuda","2024-12-23",0,0,0,0,0,0,0,0
"Bermuda","2024-12-24",0,0,0,0,0,0,0,0
"Bermuda","2024-12-25",0,0,0,0,0,0,0,0
"Bermuda","2024-12-26",0,0,0,0,0,0,0,0
"Bermuda","2024-12-27",0,0,0,0,0,0,0,0
"Bermuda","2024-12-28",0,0,0,0,0,0,0,0
"Bermuda","2024-12-29",0,0,0,0,0,0,0,0
"Bermuda","2024-12-30",0,0,0,0,0,0,0,0
"Bermuda","2024-12-31",0,0,0,0,0,0,0,0
"Bermuda","2025-01-01",0,0,0,0,0,0,0,0
"Bermuda","2025-01-02",0,0,0,0,0,0,0,0
"Bermuda","2025-01-03",0,0,0,0,0,0,0,0
"Bermuda","2025-01-04",0,0,0,0,0,0,0,0
"Bermuda","2025-01-05",0,0,0,0,0,0,0,0
"Bermuda","2025-01-06",0,0,0,0,0,0,0,0
"Bermuda","2025-01-07",0,0,0,0,0,0,0,0
"Bermuda","2025-01-08",0,0,0,0,0,0,0,0
"Bermuda","2025-01-09",0,0,0,0,0,0,0,0
"Bermuda","2025-01-10",0,0,0,0,0,0,0,0
"Bermuda","2025-01-11",0,0,0,0,0,0,0,0
"Bermuda","2025-01-12",0,0,0,0,0,0,0,0
"Bermuda","2025-01-13",0,0,0,0,0,0,0,0
"Bolivia (Plurinational State of)","2024-01-01",0,0,0,0,0,0,0,0
"Bolivia (Plurinational State of)","2024-01-02",0,0,0,0,0,0,0,0
"Bolivia (Plurinational State of)","2024-01-03",0,0,0,0,0,0,0,0
"Bolivia (Plurinational State of)","2024-01-04",0,0,0,0,0,0,0,0
"Bolivia (Plurinational State of)","2024-01-05",0,0,0,0,0,0,0,0
"Bolivia (Plurinational State of)","2024-01-06",0,0,0,0,0,0,0,0
"Bolivia (Plurinational State of)","2024-01-07",0,0,0,0,0,0,0,0
"Bolivia (Plurinational State of)","2024-01-08",0,0,0,0,0,0,0,0
"Bolivia (Plurinational State of)","2024-01-09",0,0,0,0,0,0,0,0
"Bolivia (Plurinational State of)","2024-01-10",0,0,0,0,0,0,0,0
"Bolivia (Plurinational State of)","2024-01-11",0,0,0,0,0,0,0,0
"Bolivia (Plurinational State of)","2024-01-12",0,0,0,0,0,0,0,0
"Bolivia (Plurinational State of)","2024-01-13",0,0,0,0,0,0,0,0
"Bolivia (Plurinational State of)","2024-01-14",0,0,0,0,0,0,0,0
"Bolivia (Plurinational State of)","2024-01-15",0,0,0,0,0,0,0,0
"Bolivia (Plurinational State of)","2024-01-16",0,0,0,0,0,0,0,0
"Bolivia (Plurinational State of)","2024-01-17",0,0,0,0,0,0,0,0
"Bolivia (Plurinational State of)","2024-01-18",0,0,0,0,0,0,0,0
"Bolivia (Plurinational State of)","2024-01-19",0,0,0,0,0,0,0,0
"Bolivia (Plurinational State of)","2024-01-20",0,0,0,0,0,0,0,0
"Bolivia (Plurinational State of)","2024-01-21",0,0,0,0,0,0,0,0
"Bolivia (Plurinational State of)","2024-01-22",0,0,0,0,0,0,0,0
"Bolivia (Plurinational State of)","2024-01-23",0,0,0,0,0,0,0,0
"Bolivia (Plurinational State of)","2024-01-24",0,0,0,0,0,0,0,0
"Bolivia (Plurinational State of)","2024-01-25",0,0,0,0,0,0,0,0
"Bolivia (Plurinational State of)","2024-01-26",0,0,0,0,0,0,0,0
"Bolivia (Plurinational State of)","2024-01-27",0,0,0,0,0,0,0,0
"Bolivia (Plurinational State of)","2024-01-28",0,0,0,0,0,0,0,0
"Bolivia (Plurinational State of)","2024-01-29",0,0,0,0,0,0,0,0
"Bolivia (Plurinational State of)","2024-01-30",0,0,0,0,0,0,0,0
"Bolivia (Plurinational State of)","2024-01-31",0,0,0,0,0,0,0,0
"Bolivia (Plurinational State of)","2024-02-01",0,0,0,0,0,0,0,0
"Bolivia (Plurinational State of)","2024-02-02",0,0,0,0,0,0,0,0
"Bolivia (Plurinational State of)","2024-02-03",0,0,0,0,0,0,0,0
"Bolivia (Plurinational State of)","2024-02-04",0,0,0,0,0,0,0,0
"Bolivia (Plurinational State of)","2024-02-05",0,0,0,0,0,0,0,0
"Bolivia (Plurinational State of)","2024-02-06",0,1,1,0,1,1,0,0
"Bolivia (Plurinational State of)","2024-02-07",0,0,1,0,0,1,0,0
"Bolivia (Plurinational State of)","2024-02-08",0,0,1,0,0,1,0,0
"Bolivia (Plurinational State of)","2024-02-09",0,0,1,0,0,1,0,0
"Bolivia (Plurinational State of)","2024-02-10",0,0,1,0,0,1,0,0
"Bolivia (Plurinational State of)","2024-02-11",0,0,1,0,0,1,0,0
"Bolivia (Plurinational State of)","2024-02-12",0,0,1,0,0,1,0,0
"Bolivia (Plurinational State of)","2024-02-13",0,0,1,0,0,1,0,0
"Bolivia (Plurinational State of)","2024-02-14",0,0,1,0,0,1,0,0
"Bolivia (Plurinational State of)","2024-02-15",0,0,1,0,0,1,0,0
"Bolivia (Plurinational State of)","2024-02-16",0,0,1,0,0,1,0,0
"Bolivia (Plurinational State of)","2024-02-17",0,0,1,0,0,1,0,0
"Bolivia (Plurinational State of)","2024-02-18",0,0,1,0,0,1,0,0
"Bolivia (Plurinational State of)","2024-02-19",0,0,1,0,0,1,0,0
"Bolivia (Plurinational State of)","2024-02-20",0,0,1,0,0,1,0,0
"Bolivia (Plurinational State of)","2024-02-21",0,0,1,0,0,1,0,0
"Bolivia (Plurinational State of)","2024-02-22",0,0,1,0,0,1,0,0
"Bolivia (Plurinational State of)","2024-02-23",0,0,1,0,0,1,0,0
"Bolivia (Plurinational State of)","2024-02-24",0,0,1,0,0,1,0,0
"Bolivia (Plurinational State of)","2024-02-25",0,0,1,0,0,1,0,0
"Bolivia (Plurinational State of)","2024-02-26",0,0,1,0,0,1,0,0
"Bolivia (Plurinational State of)","2024-02-27",0,0,1,0,0,1,0,0
"Bolivia (Plurinational State of)","2024-02-28",0,0,1,0,0,1,0,0
"Bolivia (Plurinational State of)","2024-02-29",0,0,1,0,0,1,0,0
"Bolivia (Plurinational State of)","2024-03-01",0,0,1,0,0,1,0,0
"Bolivia (Plurinational State of)","2024-03-02",0,0,1,0,0,1,0,0
"Bolivia (Plurinational State of)","2024-03-03",0,0,1,0,0,1,0,0
"Bolivia (Plurinational State of)","2024-03-04",0,0,1,0,0,1,0,0
"Bolivia (Plurinational State of)","2024-03-05",0,0,1,0,0,1,0,0
"Bolivia (Plurinational State of)","2024-03-06",0,0,1,0,0,1,0,0
"Bolivia (Plurinational State of)","2024-03-07",0,0,1,0,0,1,0,0
"Bolivia (Plurinational State of)","2024-03-08",0,0,1,0,0,1,0,0
"Bolivia (Plurinational State of)","2024-03-09",0,0,1,0,0,1,0,0
"Bolivia (Plurinational State of)","2024-03-10",0,0,1,0,0,1,0,0
"Bolivia (Plurinational State of)","2024-03-11",0,0,1,0,0,1,0,0
"Bolivia (Plurinational State of)","2024-03-12",0,0,1,0,0,1,0,0
"Bolivia (Plurinational State of)","2024-03-13",0,0,1,0,0,1,0,0
"Bolivia (Plurinational State of)","2024-03-14",0,0,1,0,0,1,0,0
"Bolivia (Plurinational State of)","2024-03-15",0,0,1,0,0,1,0,0
"Bolivia (Plurinational State of)","2024-03-16",0,0,1,0,0,1,0,0
"Bolivia (Plurinational State of)","2024-03-17",0,0,1,0,0,1,0,0
"Bolivia (Plurinational State of)","2024-03-18",0,0,1,0,0,1,0,0
"Bolivia (Plurinational State of)","2024-03-19",0,0,1,0,0,1,0,0
"Bolivia (Plurinational State of)","2024-03-20",0,0,1,0,0,1,0,0
"Bolivia (Plurinational State of)","2024-03-21",0,0,1,0,0,1,0,0
"Bolivia (Plurinational State of)","2024-03-22",0,0,1,0,0,1,0,0
"Bolivia (Plurinational State of)","2024-03-23",0,0,1,0,0,1,0,0
"Bolivia (Plurinational State of)","2024-03-24",0,0,1,0,0,1,0,0
"Bolivia (Plurinational State of)","2024-03-25",0,0,1,0,0,1,0,0
"Bolivia (Plurinational State of)","2024-03-26",0,0,1,0,0,1,0,0
"Bolivia (Plurinational State of)","2024-03-27",0,0,1,0,0,1,0,0
"Bolivia (Plurinational State of)","2024-03-28",0,0,1,0,0,1,0,0
"Bolivia (Plurinational State of)","2024-03-29",0,0,1,0,0,1,0,0
"Bolivia (Plurinational State of)","2024-03-30",0,0,1,0,0,1,0,0
"Bolivia (Plurinational State of)","2024-03-31",0,0,1,0,0,1,0,0
"Bolivia (Plurinational State of)","2024-04-01",0,0,1,0,0,1,0,0
"Bolivia (Plurinational State of)","2024-04-02",0,0,1,0,0,1,0,0
"Bolivia (Plurinational State of)","2024-04-03",0,0,1,0,0,1,0,0
"Bolivia (Plurinational State of)","2024-04-04",0,0,1,0,0,1,0,0
"Bolivia (Plurinational State of)","2024-04-05",0,0,1,0,0,1,0,0
"Bolivia (Plurinational State of)","2024-04-06",0,0,1,0,0,1,0,0
"Bolivia (Plurinational State of)","2024-04-07",0,0,1,0,0,1,0,0
"Bolivia (Plurinational State of)","2024-04-08",0,0,1,0,0,1,0,0
"Bolivia (Plurinational State of)","2024-04-09",0,0,1,0,0,1,0,0
"Bolivia (Plurinational State of)","2024-04-10",0,0,1,0,0,1,0,0
"Bolivia (Plurinational State of)","2024-04-11",0,0,1,0,0,1,0,0
"Bolivia (Plurinational State of)","2024-04-12",0,0,1,0,0,1,0,0
"Bolivia (Plurinational State of)","2024-04-13",0,0,1,0,0,1,0,0
"Bolivia (Plurinational State of)","2024-04-14",0,0,1,0,0,1,0,0
"Bolivia (Plurinational State of)","2024-04-15",0,0,1,0,0,1,0,0
"Bolivia (Plurinational State of)","2024-04-16",0,0,1,0,0,1,0,0
"Bolivia (Plurinational State of)","2024-04-17",0,0,1,0,0,1,0,0
"Bolivia (Plurinational State of)","2024-04-18",0,0,1,0,0,1,0,0
"Bolivia (Plurinational State of)","2024-04-19",0,0,1,0,0,1,0,0
"Bolivia (Plurinational State of)","2024-04-20",0,0,1,0,0,1,0,0
"Bolivia (Plurinational State of)","2024-04-21",0,0,1,0,0,1,0,0
"Bolivia (Plurinational State of)","2024-04-22",0,0,1,0,0,1,0,0
"Bolivia (Plurinational State of)","2024-04-23",0,0,1,0,0,1,0,0
"Bolivia (Plurinational State of)","2024-04-24",0,0,1,0,0,1,0,0
"Bolivia (Plurinational State of)","2024-04-25",0,0,1,0,0,1,0,0
"Bolivia (Plurinational State of)","2024-04-26",0,0,1,0,0,1,0,0
"Bolivia (Plurinational State of)","2024-04-27",0,0,1,0,0,1,0,0
"Bolivia (Plurinational State of)","2024-04-28",0,0,1,0,0,1,0,0
"Bolivia (Plurinational State of)","2024-04-29",0,0,1,0,0,1,0,0
"Bolivia (Plurinational State of)","2024-04-30",0,0,1,0,0,1,0,0
"Bolivia (Plurinational State of)","2024-05-01",0,0,1,0,0,1,0,0
"Bolivia (Plurinational State of)","2024-05-02",0,0,1,0,0,1,0,0
"Bolivia (Plurinational State of)","2024-05-03",0,0,1,0,0,1,0,0
"Bolivia (Plurinational State of)","2024-05-04",0,0,1,0,0,1,0,0
"Bolivia (Plurinational State of)","2024-05-05",0,0,1,0,0,1,0,0
"Bolivia (Plurinational State of)","2024-05-06",0,0,1,0,0,1,0,0
"Bolivia (Plurinational State of)","2024-05-07",0,0,1,0,0,1,0,0
"Bolivia (Plurinational State of)","2024-05-08",0,0,1,0,0,1,0,0
"Bolivia (Plurinational State of)","2024-05-09",0,0,1,0,0,1,0,0
"Bolivia (Plurinational State of)","2024-05-10",0,0,1,0,0,1,0,0
"Bolivia (Plurinational State of)","2024-05-11",0,0,1,0,0,1,0,0
"Bolivia (Plurinational State of)","2024-05-12",0,0,1,0,0,1,0,0
"Bolivia (Plurinational State of)","2024-05-13",0,0,1,0,0,1,0,0
"Bolivia (Plurinational State of)","2024-05-14",0,0,1,0,0,1,0,0
"Bolivia (Plurinational State of)","2024-05-15",0,0,1,0,0,1,0,0
"Bolivia (Plurinational State of)","2024-05-16",0,0,1,0,0,1,0,0
"Bolivia (Plurinational State of)","2024-05-17",0,0,1,0,0,1,0,0
"Bolivia (Plurinational State of)","2024-05-18",0,0,1,0,0,1,0,0
"Bolivia (Plurinational State of)","2024-05-19",0,0,1,0,0,1,0,0
"Bolivia (Plurinational State of)","2024-05-20",0,0,1,0,0,1,0,0
"Bolivia (Plurinational State of)","2024-05-21",0,0,1,0,0,1,0,0
"Bolivia (Plurinational State of)","2024-05-22",0,0,1,0,0,1,0,0
"Bolivia (Plurinational State of)","2024-05-23",0,0,1,0,0,1,0,0
"Bolivia (Plurinational State of)","2024-05-24",0,0,1,0,0,1,0,0
"Bolivia (Plurinational State of)","2024-05-25",0,0,1,0,0,1,0,0
"Bolivia (Plurinational State of)","2024-05-26",0,0,1,0,0,1,0,0
"Bolivia (Plurinational State of)","2024-05-27",0,0,1,0,0,1,0,0
"Bolivia (Plurinational State of)","2024-05-28",0,0,1,0,0,1,0,0
"Bolivia (Plurinational State of)","2024-05-29",0,0,1,0,0,1,0,0
"Bolivia (Plurinational State of)","2024-05-30",0,0,1,0,0,1,0,0
"Bolivia (Plurinational State of)","2024-05-31",0,0,1,0,0,1,0,0
"Bolivia (Plurinational State of)","2024-06-01",0,0,1,0,0,1,0,0
"Bolivia (Plurinational State of)","2024-06-02",0,0,1,0,0,1,0,0
"Bolivia (Plurinational State of)","2024-06-03",0,0,1,0,0,1,0,0
"Bolivia (Plurinational State of)","2024-06-04",0,0,1,0,0,1,0,0
"Bolivia (Plurinational State of)","2024-06-05",0,0,1,0,0,1,0,0
"Bolivia (Plurinational State of)","2024-06-06",0,0,1,0,0,1,0,0
"Bolivia (Plurinational State of)","2024-06-07",0,0,1,0,0,1,0,0
"Bolivia (Plurinational State of)","2024-06-08",0,0,1,0,0,1,0,0
"Bolivia (Plurinational State of)","2024-06-09",0,0,1,0,0,1,0,0
"Bolivia (Plurinational State of)","2024-06-10",0,0,1,0,0,1,0,0
"Bolivia (Plurinational State of)","2024-06-11",0,0,1,0,0,1,0,0
"Bolivia (Plurinational State of)","2024-06-12",0,0,1,0,0,1,0,0
"Bolivia (Plurinational State of)","2024-06-13",0,0,1,0,0,1,0,0
"Bolivia (Plurinational State of)","2024-06-14",0,0,1,0,0,1,0,0
"Bolivia (Plurinational State of)","2024-06-15",0,0,1,0,0,1,0,0
"Bolivia (Plurinational State of)","2024-06-16",0,0,1,0,0,1,0,0
"Bolivia (Plurinational State of)","2024-06-17",0,0,1,0,0,1,0,0
"Bolivia (Plurinational State of)","2024-06-18",0,0,1,0,0,1,0,0
"Bolivia (Plurinational State of)","2024-06-19",0,0,1,0,0,1,0,0
"Bolivia (Plurinational State of)","2024-06-20",0,0,1,0,0,1,0,0
"Bolivia (Plurinational State of)","2024-06-21",0,0,1,0,0,1,0,0
"Bolivia (Plurinational State of)","2024-06-22",0,0,1,0,0,1,0,0
"Bolivia (Plurinational State of)","2024-06-23",0,0,1,0,0,1,0,0
"Bolivia (Plurinational State of)","2024-06-24",0,0,1,0,0,1,0,0
"Bolivia (Plurinational State of)","2024-06-25",0,0,1,0,0,1,0,0
"Bolivia (Plurinational State of)","2024-06-26",0,0,1,0,0,1,0,0
"Bolivia (Plurinational State of)","2024-06-27",0,0,1,0,0,1,0,0
"Bolivia (Plurinational State of)","2024-06-28",0,0,1,0,0,1,0,0
"Bolivia (Plurinational State of)","2024-06-29",0,0,1,0,0,1,0,0
"Bolivia (Plurinational State of)","2024-06-30",0,0,1,0,0,1,0,0
"Bolivia (Plurinational State of)","2024-07-01",0,0,1,0,0,1,0,0
"Bolivia (Plurinational State of)","2024-07-02",0,0,1,0,0,1,0,0
"Bolivia (Plurinational State of)","2024-07-03",0,0,1,0,0,1,0,0
"Bolivia (Plurinational State of)","2024-07-04",0,0,1,0,0,1,0,0
"Bolivia (Plurinational State of)","2024-07-05",0,0,1,0,0,1,0,0
"Bolivia (Plurinational State of)","2024-07-06",0,0,1,0,0,1,0,0
"Bolivia (Plurinational State of)","2024-07-07",0,0,1,0,0,1,0,0
"Bolivia (Plurinational State of)","2024-07-08",0,0,1,0,0,1,0,0
"Bolivia (Plurinational State of)","2024-07-09",0,0,1,0,0,1,0,0
"Bolivia (Plurinational State of)","2024-07-10",0,0,1,0,0,1,0,0
"Bolivia (Plurinational State of)","2024-07-11",0,0,1,0,0,1,0,0
"Bolivia (Plurinational State of)","2024-07-12",0,0,1,0,0,1,0,0
"Bolivia (Plurinational State of)","2024-07-13",0,0,1,0,0,1,0,0
"Bolivia (Plurinational State of)","2024-07-14",0,0,1,0,0,1,0,0
"Bolivia (Plurinational State of)","2024-07-15",0,0,1,0,0,1,0,0
"Bolivia (Plurinational State of)","2024-07-16",0,0,1,0,0,1,0,0
"Bolivia (Plurinational State of)","2024-07-17",0,0,1,0,0,1,0,0
"Bolivia (Plurinational State of)","2024-07-18",0,0,1,0,0,1,0,0
"Bolivia (Plurinational State of)","2024-07-19",0,0,1,0,0,1,0,0
"Bolivia (Plurinational State of)","2024-07-20",0,0,1,0,0,1,0,0
"Bolivia (Plurinational State of)","2024-07-21",0,0,1,0,0,1,0,0
"Bolivia (Plurinational State of)","2024-07-22",0,0,1,0,0,1,0,0
"Bolivia (Plurinational State of)","2024-07-23",0,0,1,0,0,1,0,0
"Bolivia (Plurinational State of)","2024-07-24",0,0,1,0,0,1,0,0
"Bolivia (Plurinational State of)","2024-07-25",0,0,1,0,0,1,0,0
"Bolivia (Plurinational State of)","2024-07-26",0,0,1,0,0,1,0,0
"Bolivia (Plurinational State of)","2024-07-27",0,0,1,0,0,1,0,0
"Bolivia (Plurinational State of)","2024-07-28",0,0,1,0,0,1,0,0
"Bolivia (Plurinational State of)","2024-07-29",0,0,1,0,0,1,0,0
"Bolivia (Plurinational State of)","2024-07-30",0,0,1,0,0,1,0,0
"Bolivia (Plurinational State of)","2024-07-31",0,0,1,0,0,1,0,0
"Bolivia (Plurinational State of)","2024-08-01",0,0,1,0,0,1,0,0
"Bolivia (Plurinational State of)","2024-08-02",0,0,1,0,0,1,0,0
"Bolivia (Plurinational State of)","2024-08-03",0,0,1,0,0,1,0,0
"Bolivia (Plurinational State of)","2024-08-04",0,0,1,0,0,1,0,0
"Bolivia (Plurinational State of)","2024-08-05",0,0,1,0,0,1,0,0
"Bolivia (Plurinational State of)","2024-08-06",0,0,1,0,0,1,0,0
"Bolivia (Plurinational State of)","2024-08-07",0,0,1,0,0,1,0,0
"Bolivia (Plurinational State of)","2024-08-08",0,0,1,0,0,1,0,0
"Bolivia (Plurinational State of)","2024-08-09",0,0,1,0,0,1,0,0
"Bolivia (Plurinational State of)","2024-08-10",0,0,1,0,0,1,0,0
"Bolivia (Plurinational State of)","2024-08-11",0,0,1,0,0,1,0,0
"Bolivia (Plurinational State of)","2024-08-12",0,0,1,0,0,1,0,0
"Bolivia (Plurinational State of)","2024-08-13",0,0,1,0,0,1,0,0
"Bolivia (Plurinational State of)","2024-08-14",0,0,1,0,0,1,0,0
"Bolivia (Plurinational State of)","2024-08-15",0,0,1,0,0,1,0,0
"Bolivia (Plurinational State of)","2024-08-16",0,0,1,0,0,1,0,0
"Bolivia (Plurinational State of)","2024-08-17",0,0,1,0,0,1,0,0
"Bolivia (Plurinational State of)","2024-08-18",0,0,1,0,0,1,0,0
"Bolivia (Plurinational State of)","2024-08-19",0,0,1,0,0,1,0,0
"Bolivia (Plurinational State of)","2024-08-20",0,0,1,0,0,1,0,0
"Bolivia (Plurinational State of)","2024-08-21",0,0,1,0,0,1,0,0
"Bolivia (Plurinational State of)","2024-08-22",0,0,1,0,0,1,0,0
"Bolivia (Plurinational State of)","2024-08-23",0,0,1,0,0,1,0,0
"Bolivia (Plurinational State of)","2024-08-24",0,0,1,0,0,1,0,0
"Bolivia (Plurinational State of)","2024-08-25",0,0,1,0,0,1,0,0
"Bolivia (Plurinational State of)","2024-08-26",0,0,1,0,0,1,0,0
"Bolivia (Plurinational State of)","2024-08-27",0,0,1,0,0,1,0,0
"Bolivia (Plurinational State of)","2024-08-28",0,0,1,0,0,1,0,0
"Bolivia (Plurinational State of)","2024-08-29",0,0,1,0,0,1,0,0
"Bolivia (Plurinational State of)","2024-08-30",0,0,1,0,0,1,0,0
"Bolivia (Plurinational State of)","2024-08-31",0,0,1,0,0,1,0,0
"Bolivia (Plurinational State of)","2024-09-01",0,0,1,0,0,1,0,0
"Bolivia (Plurinational State of)","2024-09-02",0,0,1,0,0,1,0,0
"Bolivia (Plurinational State of)","2024-09-03",0,0,1,0,0,1,0,0
"Bolivia (Plurinational State of)","2024-09-04",0,0,1,0,0,1,0,0
"Bolivia (Plurinational State of)","2024-09-05",0,0,1,0,0,1,0,0
"Bolivia (Plurinational State of)","2024-09-06",0,0,1,0,0,1,0,0
"Bolivia (Plurinational State of)","2024-09-07",0,0,1,0,0,1,0,0
"Bolivia (Plurinational State of)","2024-09-08",0,0,1,0,0,1,0,0
"Bolivia (Plurinational State of)","2024-09-09",0,0,1,0,0,1,0,0
"Bolivia (Plurinational State of)","2024-09-10",0,0,1,0,0,1,0,0
"Bolivia (Plurinational State of)","2024-09-11",0,0,1,0,0,1,0,0
"Bolivia (Plurinational State of)","2024-09-12",0,0,1,0,0,1,0,0
"Bolivia (Plurinational State of)","2024-09-13",0,0,1,0,0,1,0,0
"Bolivia (Plurinational State of)","2024-09-14",0,0,1,0,0,1,0,0
"Bolivia (Plurinational State of)","2024-09-15",0,0,1,0,0,1,0,0
"Bolivia (Plurinational State of)","2024-09-16",0,0,1,0,0,1,0,0
"Bolivia (Plurinational State of)","2024-09-17",0,0,1,0,0,1,0,0
"Bolivia (Plurinational State of)","2024-09-18",0,0,1,0,0,1,0,0
"Bolivia (Plurinational State of)","2024-09-19",0,0,1,0,0,1,0,0
"Bolivia (Plurinational State of)","2024-09-20",0,0,1,0,0,1,0,0
"Bolivia (Plurinational State of)","2024-09-21",0,0,1,0,0,1,0,0
"Bolivia (Plurinational State of)","2024-09-22",0,0,1,0,0,1,0,0
"Bolivia (Plurinational State of)","2024-09-23",0,0,1,0,0,1,0,0
"Bolivia (Plurinational State of)","2024-09-24",0,0,1,0,0,1,0,0
"Bolivia (Plurinational State of)","2024-09-25",0,0,1,0,0,1,0,0
"Bolivia (Plurinational State of)","2024-09-26",0,0,1,0,0,1,0,0
"Bolivia (Plurinational State of)","2024-09-27",0,0,1,0,0,1,0,0
"Bolivia (Plurinational State of)","2024-09-28",0,0,1,0,0,1,0,0
"Bolivia (Plurinational State of)","2024-09-29",0,0,1,0,0,1,0,0
"Bolivia (Plurinational State of)","2024-09-30",0,0,1,0,0,1,0,0
"Bolivia (Plurinational State of)","2024-10-01",0,0,1,0,0,1,0,0
"Bolivia (Plurinational State of)","2024-10-02",0,0,1,0,0,1,0,0
"Bolivia (Plurinational State of)","2024-10-03",0,0,1,0,0,1,0,0
"Bolivia (Plurinational State of)","2024-10-04",0,0,1,0,0,1,0,0
"Bolivia (Plurinational State of)","2024-10-05",0,0,1,0,0,1,0,0
"Bolivia (Plurinational State of)","2024-10-06",0,0,1,0,0,1,0,0
"Bolivia (Plurinational State of)","2024-10-07",0,0,1,0,0,1,0,0
"Bolivia (Plurinational State of)","2024-10-08",0,0,1,0,0,1,0,0
"Bolivia (Plurinational State of)","2024-10-09",0,0,1,0,0,1,0,0
"Bolivia (Plurinational State of)","2024-10-10",0,0,1,0,0,1,0,0
"Bolivia (Plurinational State of)","2024-10-11",0,0,1,0,0,1,0,0
"Bolivia (Plurinational State of)","2024-10-12",0,0,1,0,0,1,0,0
"Bolivia (Plurinational State of)","2024-10-13",0,0,1,0,0,1,0,0
"Bolivia (Plurinational State of)","2024-10-14",0,0,1,0,0,1,0,0
"Bolivia (Plurinational State of)","2024-10-15",0,0,1,0,0,1,0,0
"Bolivia (Plurinational State of)","2024-10-16",0,0,1,0,0,1,0,0
"Bolivia (Plurinational State of)","2024-10-17",0,0,1,0,0,1,0,0
"Bolivia (Plurinational State of)","2024-10-18",0,0,1,0,0,1,0,0
"Bolivia (Plurinational State of)","2024-10-19",0,0,1,0,0,1,0,0
"Bolivia (Plurinational State of)","2024-10-20",0,0,1,0,0,1,0,0
"Bolivia (Plurinational State of)","2024-10-21",0,0,1,0,0,1,0,0
"Bolivia (Plurinational State of)","2024-10-22",0,0,1,0,0,1,0,0
"Bolivia (Plurinational State of)","2024-10-23",0,0,1,0,0,1,0,0
"Bolivia (Plurinational State of)","2024-10-24",0,0,1,0,0,1,0,0
"Bolivia (Plurinational State of)","2024-10-25",0,0,1,0,0,1,0,0
"Bolivia (Plurinational State of)","2024-10-26",0,0,1,0,0,1,0,0
"Bolivia (Plurinational State of)","2024-10-27",0,0,1,0,0,1,0,0
"Bolivia (Plurinational State of)","2024-10-28",0,0,1,0,0,1,0,0
"Bolivia (Plurinational State of)","2024-10-29",0,0,1,0,0,1,0,0
"Bolivia (Plurinational State of)","2024-10-30",0,0,1,0,0,1,0,0
"Bolivia (Plurinational State of)","2024-10-31",0,0,1,0,0,1,0,0
"Bolivia (Plurinational State of)","2024-11-01",0,0,1,0,0,1,0,0
"Bolivia (Plurinational State of)","2024-11-02",0,0,1,0,0,1,0,0
"Bolivia (Plurinational State of)","2024-11-03",0,0,1,0,0,1,0,0
"Bolivia (Plurinational State of)","2024-11-04",0,0,1,0,0,1,0,0
"Bolivia (Plurinational State of)","2024-11-05",0,0,1,0,0,1,0,0
"Bolivia (Plurinational State of)","2024-11-06",0,0,1,0,0,1,0,0
"Bolivia (Plurinational State of)","2024-11-07",0,0,1,0,0,1,0,0
"Bolivia (Plurinational State of)","2024-11-08",0,0,1,0,0,1,0,0
"Bolivia (Plurinational State of)","2024-11-09",0,0,1,0,0,1,0,0
"Bolivia (Plurinational State of)","2024-11-10",0,0,1,0,0,1,0,0
"Bolivia (Plurinational State of)","2024-11-11",0,0,1,0,0,1,0,0
"Bolivia (Plurinational State of)","2024-11-12",0,0,1,0,0,1,0,0
"Bolivia (Plurinational State of)","2024-11-13",0,0,1,0,0,1,0,0
"Bolivia (Plurinational State of)","2024-11-14",0,0,1,0,0,1,0,0
"Bolivia (Plurinational State of)","2024-11-15",0,0,1,0,0,1,0,0
"Bolivia (Plurinational State of)","2024-11-16",0,0,1,0,0,1,0,0
"Bolivia (Plurinational State of)","2024-11-17",0,0,1,0,0,1,0,0
"Bolivia (Plurinational State of)","2024-11-18",0,0,1,0,0,1,0,0
"Bolivia (Plurinational State of)","2024-11-19",0,0,1,0,0,1,0,0
"Bolivia (Plurinational State of)","2024-11-20",0,0,1,0,0,1,0,0
"Bolivia (Plurinational State of)","2024-11-21",0,0,1,0,0,1,0,0
"Bolivia (Plurinational State of)","2024-11-22",0,0,1,0,0,1,0,0
"Bolivia (Plurinational State of)","2024-11-23",0,0,1,0,0,1,0,0
"Bolivia (Plurinational State of)","2024-11-24",0,0,1,0,0,1,0,0
"Bolivia (Plurinational State of)","2024-11-25",0,0,1,0,0,1,0,0
"Bolivia (Plurinational State of)","2024-11-26",0,0,1,0,0,1,0,0
"Bolivia (Plurinational State of)","2024-11-27",0,0,1,0,0,1,0,0
"Bolivia (Plurinational State of)","2024-11-28",0,0,1,0,0,1,0,0
"Bolivia (Plurinational State of)","2024-11-29",0,0,1,0,0,1,0,0
"Bolivia (Plurinational State of)","2024-11-30",0,0,1,0,0,1,0,0
"Bolivia (Plurinational State of)","2024-12-01",0,0,1,0,0,1,0,0
"Bolivia (Plurinational State of)","2024-12-02",0,0,1,0,0,1,0,0
"Bolivia (Plurinational State of)","2024-12-03",0,0,1,0,0,1,0,0
"Bolivia (Plurinational State of)","2024-12-04",0,0,1,0,0,1,0,0
"Bolivia (Plurinational State of)","2024-12-05",0,0,1,0,0,1,0,0
"Bolivia (Plurinational State of)","2024-12-06",0,0,1,0,0,1,0,0
"Bolivia (Plurinational State of)","2024-12-07",0,0,1,0,0,1,0,0
"Bolivia (Plurinational State of)","2024-12-08",0,0,1,0,0,1,0,0
"Bolivia (Plurinational State of)","2024-12-09",0,0,1,0,0,1,0,0
"Bolivia (Plurinational State of)","2024-12-10",0,0,1,0,0,1,0,0
"Bolivia (Plurinational State of)","2024-12-11",0,0,1,0,0,1,0,0
"Bolivia (Plurinational State of)","2024-12-12",0,0,1,0,0,1,0,0
"Bolivia (Plurinational State of)","2024-12-13",0,0,1,0,0,1,0,0
"Bolivia (Plurinational State of)","2024-12-14",0,0,1,0,0,1,0,0
"Bolivia (Plurinational State of)","2024-12-15",0,0,1,0,0,1,0,0
"Bolivia (Plurinational State of)","2024-12-16",0,0,1,0,0,1,0,0
"Bolivia (Plurinational State of)","2024-12-17",0,0,1,0,0,1,0,0
"Bolivia (Plurinational State of)","2024-12-18",0,0,1,0,0,1,0,0
"Bolivia (Plurinational State of)","2024-12-19",0,0,1,0,0,1,0,0
"Bolivia (Plurinational State of)","2024-12-20",0,0,1,0,0,1,0,0
"Bolivia (Plurinational State of)","2024-12-21",0,0,1,0,0,1,0,0
"Bolivia (Plurinational State of)","2024-12-22",0,0,1,0,0,1,0,0
"Bolivia (Plurinational State of)","2024-12-23",0,0,1,0,0,1,0,0
"Bolivia (Plurinational State of)","2024-12-24",0,0,1,0,0,1,0,0
"Bolivia (Plurinational State of)","2024-12-25",0,0,1,0,0,1,0,0
"Bolivia (Plurinational State of)","2024-12-26",0,0,1,0,0,1,0,0
"Bolivia (Plurinational State of)","2024-12-27",0,0,1,0,0,1,0,0
"Bolivia (Plurinational State of)","2024-12-28",0,0,1,0,0,1,0,0
"Bolivia (Plurinational State of)","2024-12-29",0,0,1,0,0,1,0,0
"Bolivia (Plurinational State of)","2024-12-30",0,0,1,0,0,1,0,0
"Bolivia (Plurinational State of)","2024-12-31",0,0,1,0,0,1,0,0
"Bolivia (Plurinational State of)","2025-01-01",0,0,1,0,0,1,0,0
"Bolivia (Plurinational State of)","2025-01-02",0,0,1,0,0,1,0,0
"Bolivia (Plurinational State of)","2025-01-03",0,0,1,0,0,1,0,0
"Bolivia (Plurinational State of)","2025-01-04",0,0,1,0,0,1,0,0
"Bolivia (Plurinational State of)","2025-01-05",0,0,1,0,0,1,0,0
"Bolivia (Plurinational State of)","2025-01-06",0,0,1,0,0,1,0,0
"Bolivia (Plurinational State of)","2025-01-07",0,0,1,0,0,1,0,0
"Bolivia (Plurinational State of)","2025-01-08",0,0,1,0,0,1,0,0
"Bolivia (Plurinational State of)","2025-01-09",0,0,1,0,0,1,0,0
"Bolivia (Plurinational State of)","2025-01-10",0,0,1,0,0,1,0,0
"Bolivia (Plurinational State of)","2025-01-11",0,0,1,0,0,1,0,0
"Bolivia (Plurinational State of)","2025-01-12",0,0,1,0,0,1,0,0
"Bolivia (Plurinational State of)","2025-01-13",0,0,1,0,0,1,0,0
"Bosnia and Herzegovina","2024-01-01",0,0,0,0,0,0,0,0
"Bosnia and Herzegovina","2024-01-02",0,0,0,0,0,0,0,0
"Bosnia and Herzegovina","2024-01-03",0,0,0,0,0,0,0,0
"Bosnia and Herzegovina","2024-01-04",0,0,0,0,0,0,0,0
"Bosnia and Herzegovina","2024-01-05",0,0,0,0,0,0,0,0
"Bosnia and Herzegovina","2024-01-06",0,0,0,0,0,0,0,0
"Bosnia and Herzegovina","2024-01-07",0,0,0,0,0,0,0,0
"Bosnia and Herzegovina","2024-01-08",0,0,0,0,0,0,0,0
"Bosnia and Herzegovina","2024-01-09",0,0,0,0,0,0,0,0
"Bosnia and Herzegovina","2024-01-10",0,0,0,0,0,0,0,0
"Bosnia and Herzegovina","2024-01-11",0,0,0,0,0,0,0,0
"Bosnia and Herzegovina","2024-01-12",0,0,0,0,0,0,0,0
"Bosnia and Herzegovina","2024-01-13",0,0,0,0,0,0,0,0
"Bosnia and Herzegovina","2024-01-14",0,0,0,0,0,0,0,0
"Bosnia and Herzegovina","2024-01-15",0,0,0,0,0,0,0,0
"Bosnia and Herzegovina","2024-01-16",0,0,0,0,0,0,0,0
"Bosnia and Herzegovina","2024-01-17",0,0,0,0,0,0,0,0
"Bosnia and Herzegovina","2024-01-18",0,0,0,0,0,0,0,0
"Bosnia and Herzegovina","2024-01-19",0,0,0,0,0,0,0,0
"Bosnia and Herzegovina","2024-01-20",0,0,0,0,0,0,0,0
"Bosnia and Herzegovina","2024-01-21",0,0,0,0,0,0,0,0
"Bosnia and Herzegovina","2024-01-22",0,0,0,0,0,0,0,0
"Bosnia and Herzegovina","2024-01-23",0,0,0,0,0,0,0,0
"Bosnia and Herzegovina","2024-01-24",0,0,0,0,0,0,0,0
"Bosnia and Herzegovina","2024-01-25",0,0,0,0,0,0,0,0
"Bosnia and Herzegovina","2024-01-26",0,0,0,0,0,0,0,0
"Bosnia and Herzegovina","2024-01-27",0,0,0,0,0,0,0,0
"Bosnia and Herzegovina","2024-01-28",0,0,0,0,0,0,0,0
"Bosnia and Herzegovina","2024-01-29",0,0,0,0,0,0,0,0
"Bosnia and Herzegovina","2024-01-30",0,0,0,0,0,0,0,0
"Bosnia and Herzegovina","2024-01-31",0,0,0,0,0,0,0,0
"Bosnia and Herzegovina","2024-02-01",0,0,0,0,0,0,0,0
"Bosnia and Herzegovina","2024-02-02",0,0,0,0,0,0,0,0
"Bosnia and Herzegovina","2024-02-03",0,0,0,0,0,0,0,0
"Bosnia and Herzegovina","2024-02-04",0,0,0,0,0,0,0,0
"Bosnia and Herzegovina","2024-02-05",0,0,0,0,0,0,0,0
"Bosnia and Herzegovina","2024-02-06",0,0,0,0,0,0,0,0
"Bosnia and Herzegovina","2024-02-07",0,0,0,0,0,0,0,0
"Bosnia and Herzegovina","2024-02-08",0,0,0,0,0,0,0,0
"Bosnia and Herzegovina","2024-02-09",0,0,0,0,0,0,0,0
"Bosnia and Herzegovina","2024-02-10",0,0,0,0,0,0,0,0
"Bosnia and Herzegovina","2024-02-11",0,0,0,0,0,0,0,0
"Bosnia and Herzegovina","2024-02-12",0,0,0,0,0,0,0,0
"Bosnia and Herzegovina","2024-02-13",0,0,0,0,0,0,0,0
"Bosnia and Herzegovina","2024-02-14",0,0,0,0,0,0,0,0
"Bosnia and Herzegovina","2024-02-15",0,0,0,0,0,0,0,0
"Bosnia and Herzegovina","2024-02-16",0,0,0,0,0,0,0,0
"Bosnia and Herzegovina","2024-02-17",0,0,0,0,0,0,0,0
"Bosnia and Herzegovina","2024-02-18",0,0,0,0,0,0,0,0
"Bosnia and Herzegovina","2024-02-19",0,0,0,0,0,0,0,0
"Bosnia and Herzegovina","2024-02-20",0,0,0,0,0,0,0,0
"Bosnia and Herzegovina","2024-02-21",0,0,0,0,0,0,0,0
"Bosnia and Herzegovina","2024-02-22",0,0,0,0,0,0,0,0
"Bosnia and Herzegovina","2024-02-23",0,0,0,0,0,0,0,0
"Bosnia and Herzegovina","2024-02-24",0,0,0,0,0,0,0,0
"Bosnia and Herzegovina","2024-02-25",0,0,0,0,0,0,0,0
"Bosnia and Herzegovina","2024-02-26",0,0,0,0,0,0,0,0
"Bosnia and Herzegovina","2024-02-27",0,0,0,0,0,0,0,0
"Bosnia and Herzegovina","2024-02-28",0,0,0,0,0,0,0,0
"Bosnia and Herzegovina","2024-02-29",0,0,0,0,0,0,0,0
"Bosnia and Herzegovina","2024-03-01",0,0,0,0,0,0,0,0
"Bosnia and Herzegovina","2024-03-02",0,0,0,0,0,0,0,0
"Bosnia and Herzegovina","2024-03-03",0,0,0,0,0,0,0,0
"Bosnia and Herzegovina","2024-03-04",0,0,0,0,0,0,0,0
"Bosnia and Herzegovina","2024-03-05",0,0,0,0,0,0,0,0
"Bosnia and Herzegovina","2024-03-06",0,0,0,0,0,0,0,0
"Bosnia and Herzegovina","2024-03-07",0,0,0,0,0,0,0,0
"Bosnia and Herzegovina","2024-03-08",0,0,0,0,0,0,0,0
"Bosnia and Herzegovina","2024-03-09",0,0,0,0,0,0,0,0
"Bosnia and Herzegovina","2024-03-10",0,0,0,0,0,0,0,0
"Bosnia and Herzegovina","2024-03-11",0,0,0,0,0,0,0,0
"Bosnia and Herzegovina","2024-03-12",0,0,0,0,0,0,0,0
"Bosnia and Herzegovina","2024-03-13",0,0,0,0,0,0,0,0
"Bosnia and Herzegovina","2024-03-14",0,0,0,0,0,0,0,0
"Bosnia and Herzegovina","2024-03-15",0,0,0,0,0,0,0,0
"Bosnia and Herzegovina","2024-03-16",0,0,0,0,0,0,0,0
"Bosnia and Herzegovina","2024-03-17",0,0,0,0,0,0,0,0
"Bosnia and Herzegovina","2024-03-18",0,0,0,0,0,0,0,0
"Bosnia and Herzegovina","2024-03-19",0,0,0,0,0,0,0,0
"Bosnia and Herzegovina","2024-03-20",0,0,0,0,0,0,0,0
"Bosnia and Herzegovina","2024-03-21",0,0,0,0,0,0,0,0
"Bosnia and Herzegovina","2024-03-22",0,0,0,0,0,0,0,0
"Bosnia and Herzegovina","2024-03-23",0,0,0,0,0,0,0,0
"Bosnia and Herzegovina","2024-03-24",0,0,0,0,0,0,0,0
"Bosnia and Herzegovina","2024-03-25",0,0,0,0,0,0,0,0
"Bosnia and Herzegovina","2024-03-26",0,0,0,0,0,0,0,0
"Bosnia and Herzegovina","2024-03-27",0,0,0,0,0,0,0,0
"Bosnia and Herzegovina","2024-03-28",0,0,0,0,0,0,0,0
"Bosnia and Herzegovina","2024-03-29",0,0,0,0,0,0,0,0
"Bosnia and Herzegovina","2024-03-30",0,0,0,0,0,0,0,0
"Bosnia and Herzegovina","2024-03-31",0,0,0,0,0,0,0,0
"Bosnia and Herzegovina","2024-04-01",0,0,0,0,0,0,0,0
"Bosnia and Herzegovina","2024-04-02",0,0,0,0,0,0,0,0
"Bosnia and Herzegovina","2024-04-03",0,0,0,0,0,0,0,0
"Bosnia and Herzegovina","2024-04-04",0,0,0,0,0,0,0,0
"Bosnia and Herzegovina","2024-04-05",0,0,0,0,0,0,0,0
"Bosnia and Herzegovina","2024-04-06",0,0,0,0,0,0,0,0
"Bosnia and Herzegovina","2024-04-07",0,0,0,0,0,0,0,0
"Bosnia and Herzegovina","2024-04-08",0,0,0,0,0,0,0,0
"Bosnia and Herzegovina","2024-04-09",0,0,0,0,0,0,0,0
"Bosnia and Herzegovina","2024-04-10",0,0,0,0,0,0,0,0
"Bosnia and Herzegovina","2024-04-11",0,0,0,0,0,0,0,0
"Bosnia and Herzegovina","2024-04-12",0,0,0,0,0,0,0,0
"Bosnia and Herzegovina","2024-04-13",0,0,0,0,0,0,0,0
"Bosnia and Herzegovina","2024-04-14",0,0,0,0,0,0,0,0
"Bosnia and Herzegovina","2024-04-15",0,0,0,0,0,0,0,0
"Bosnia and Herzegovina","2024-04-16",0,0,0,0,0,0,0,0
"Bosnia and Herzegovina","2024-04-17",0,0,0,0,0,0,0,0
"Bosnia and Herzegovina","2024-04-18",0,0,0,0,0,0,0,0
"Bosnia and Herzegovina","2024-04-19",0,0,0,0,0,0,0,0
"Bosnia and Herzegovina","2024-04-20",0,0,0,0,0,0,0,0
"Bosnia and Herzegovina","2024-04-21",0,0,0,0,0,0,0,0
"Bosnia and Herzegovina","2024-04-22",0,0,0,0,0,0,0,0
"Bosnia and Herzegovina","2024-04-23",0,0,0,0,0,0,0,0
"Bosnia and Herzegovina","2024-04-24",0,0,0,0,0,0,0,0
"Bosnia and Herzegovina","2024-04-25",0,0,0,0,0,0,0,0
"Bosnia and Herzegovina","2024-04-26",0,0,0,0,0,0,0,0
"Bosnia and Herzegovina","2024-04-27",0,0,0,0,0,0,0,0
"Bosnia and Herzegovina","2024-04-28",0,0,0,0,0,0,0,0
"Bosnia and Herzegovina","2024-04-29",0,0,0,0,0,0,0,0
"Bosnia and Herzegovina","2024-04-30",0,0,0,0,0,0,0,0
"Bosnia and Herzegovina","2024-05-01",0,0,0,0,0,0,0,0
"Bosnia and Herzegovina","2024-05-02",0,0,0,0,0,0,0,0
"Bosnia and Herzegovina","2024-05-03",0,0,0,0,0,0,0,0
"Bosnia and Herzegovina","2024-05-04",0,0,0,0,0,0,0,0
"Bosnia and Herzegovina","2024-05-05",0,0,0,0,0,0,0,0
"Bosnia and Herzegovina","2024-05-06",0,0,0,0,0,0,0,0
"Bosnia and Herzegovina","2024-05-07",0,0,0,0,0,0,0,0
"Bosnia and Herzegovina","2024-05-08",0,0,0,0,0,0,0,0
"Bosnia and Herzegovina","2024-05-09",0,0,0,0,0,0,0,0
"Bosnia and Herzegovina","2024-05-10",0,0,0,0,0,0,0,0
"Bosnia and Herzegovina","2024-05-11",0,0,0,0,0,0,0,0
"Bosnia and Herzegovina","2024-05-12",0,0,0,0,0,0,0,0
"Bosnia and Herzegovina","2024-05-13",0,0,0,0,0,0,0,0
"Bosnia and Herzegovina","2024-05-14",0,0,0,0,0,0,0,0
"Bosnia and Herzegovina","2024-05-15",0,0,0,0,0,0,0,0
"Bosnia and Herzegovina","2024-05-16",0,0,0,0,0,0,0,0
"Bosnia and Herzegovina","2024-05-17",0,0,0,0,0,0,0,0
"Bosnia and Herzegovina","2024-05-18",0,0,0,0,0,0,0,0
"Bosnia and Herzegovina","2024-05-19",0,0,0,0,0,0,0,0
"Bosnia and Herzegovina","2024-05-20",0,0,0,0,0,0,0,0
"Bosnia and Herzegovina","2024-05-21",0,0,0,0,0,0,0,0
"Bosnia and Herzegovina","2024-05-22",0,0,0,0,0,0,0,0
"Bosnia and Herzegovina","2024-05-23",0,0,0,0,0,0,0,0
"Bosnia and Herzegovina","2024-05-24",0,0,0,0,0,0,0,0
"Bosnia and Herzegovina","2024-05-25",0,0,0,0,0,0,0,0
"Bosnia and Herzegovina","2024-05-26",0,0,0,0,0,0,0,0
"Bosnia and Herzegovina","2024-05-27",0,0,0,0,0,0,0,0
"Bosnia and Herzegovina","2024-05-28",0,0,0,0,0,0,0,0
"Bosnia and Herzegovina","2024-05-29",0,0,0,0,0,0,0,0
"Bosnia and Herzegovina","2024-05-30",0,0,0,0,0,0,0,0
"Bosnia and Herzegovina","2024-05-31",0,0,0,0,0,0,0,0
"Bosnia and Herzegovina","2024-06-01",0,0,0,0,0,0,0,0
"Bosnia and Herzegovina","2024-06-02",0,0,0,0,0,0,0,0
"Bosnia and Herzegovina","2024-06-03",0,0,0,0,0,0,0,0
"Bosnia and Herzegovina","2024-06-04",0,0,0,0,0,0,0,0
"Bosnia and Herzegovina","2024-06-05",0,0,0,0,0,0,0,0
"Bosnia and Herzegovina","2024-06-06",0,0,0,0,0,0,0,0
"Bosnia and Herzegovina","2024-06-07",0,0,0,0,0,0,0,0
"Bosnia and Herzegovina","2024-06-08",0,0,0,0,0,0,0,0
"Bosnia and Herzegovina","2024-06-09",0,0,0,0,0,0,0,0
"Bosnia and Herzegovina","2024-06-10",0,0,0,0,0,0,0,0
"Bosnia and Herzegovina","2024-06-11",0,0,0,0,0,0,0,0
"Bosnia and Herzegovina","2024-06-12",0,0,0,0,0,0,0,0
"Bosnia and Herzegovina","2024-06-13",0,0,0,0,0,0,0,0
"Bosnia and Herzegovina","2024-06-14",0,0,0,0,0,0,0,0
"Bosnia and Herzegovina","2024-06-15",0,0,0,0,0,0,0,0
"Bosnia and Herzegovina","2024-06-16",0,0,0,0,0,0,0,0
"Bosnia and Herzegovina","2024-06-17",0,0,0,0,0,0,0,0
"Bosnia and Herzegovina","2024-06-18",0,0,0,0,0,0,0,0
"Bosnia and Herzegovina","2024-06-19",0,0,0,0,0,0,0,0
"Bosnia and Herzegovina","2024-06-20",0,0,0,0,0,0,0,0
"Bosnia and Herzegovina","2024-06-21",0,0,0,0,0,0,0,0
"Bosnia and Herzegovina","2024-06-22",0,0,0,0,0,0,0,0
"Bosnia and Herzegovina","2024-06-23",0,0,0,0,0,0,0,0
"Bosnia and Herzegovina","2024-06-24",0,0,0,0,0,0,0,0
"Bosnia and Herzegovina","2024-06-25",0,0,0,0,0,0,0,0
"Bosnia and Herzegovina","2024-06-26",0,0,0,0,0,0,0,0
"Bosnia and Herzegovina","2024-06-27",0,0,0,0,0,0,0,0
"Bosnia and Herzegovina","2024-06-28",0,0,0,0,0,0,0,0
"Bosnia and Herzegovina","2024-06-29",0,0,0,0,0,0,0,0
"Bosnia and Herzegovina","2024-06-30",0,0,0,0,0,0,0,0
"Bosnia and Herzegovina","2024-07-01",0,0,0,0,0,0,0,0
"Bosnia and Herzegovina","2024-07-02",0,0,0,0,0,0,0,0
"Bosnia and Herzegovina","2024-07-03",0,0,0,0,0,0,0,0
"Bosnia and Herzegovina","2024-07-04",0,0,0,0,0,0,0,0
"Bosnia and Herzegovina","2024-07-05",0,0,0,0,0,0,0,0
"Bosnia and Herzegovina","2024-07-06",0,0,0,0,0,0,0,0
"Bosnia and Herzegovina","2024-07-07",0,0,0,0,0,0,0,0
"Bosnia and Herzegovina","2024-07-08",0,0,0,0,0,0,0,0
"Bosnia and Herzegovina","2024-07-09",0,0,0,0,0,0,0,0
"Bosnia and Herzegovina","2024-07-10",0,0,0,0,0,0,0,0
"Bosnia and Herzegovina","2024-07-11",0,0,0,0,0,0,0,0
"Bosnia and Herzegovina","2024-07-12",0,0,0,0,0,0,0,0
"Bosnia and Herzegovina","2024-07-13",0,0,0,0,0,0,0,0
"Bosnia and Herzegovina","2024-07-14",0,0,0,0,0,0,0,0
"Bosnia and Herzegovina","2024-07-15",0,0,0,0,0,0,0,0
"Bosnia and Herzegovina","2024-07-16",0,0,0,0,0,0,0,0
"Bosnia and Herzegovina","2024-07-17",0,0,0,0,0,0,0,0
"Bosnia and Herzegovina","2024-07-18",0,0,0,0,0,0,0,0
"Bosnia and Herzegovina","2024-07-19",0,0,0,0,0,0,0,0
"Bosnia and Herzegovina","2024-07-20",0,0,0,0,0,0,0,0
"Bosnia and Herzegovina","2024-07-21",0,0,0,0,0,0,0,0
"Bosnia and Herzegovina","2024-07-22",0,0,0,0,0,0,0,0
"Bosnia and Herzegovina","2024-07-23",0,0,0,0,0,0,0,0
"Bosnia and Herzegovina","2024-07-24",0,0,0,0,0,0,0,0
"Bosnia and Herzegovina","2024-07-25",0,0,0,0,0,0,0,0
"Bosnia and Herzegovina","2024-07-26",0,0,0,0,0,0,0,0
"Bosnia and Herzegovina","2024-07-27",0,0,0,0,0,0,0,0
"Bosnia and Herzegovina","2024-07-28",0,0,0,0,0,0,0,0
"Bosnia and Herzegovina","2024-07-29",0,0,0,0,0,0,0,0
"Bosnia and Herzegovina","2024-07-30",0,0,0,0,0,0,0,0
"Bosnia and Herzegovina","2024-07-31",0,0,0,0,0,0,0,0
"Bosnia and Herzegovina","2024-08-01",0,0,0,0,0,0,0,0
"Bosnia and Herzegovina","2024-08-02",0,0,0,0,0,0,0,0
"Bosnia and Herzegovina","2024-08-03",0,0,0,0,0,0,0,0
"Bosnia and Herzegovina","2024-08-04",0,0,0,0,0,0,0,0
"Bosnia and Herzegovina","2024-08-05",0,0,0,0,0,0,0,0
"Bosnia and Herzegovina","2024-08-06",0,0,0,0,0,0,0,0
"Bosnia and Herzegovina","2024-08-07",0,0,0,0,0,0,0,0
"Bosnia and Herzegovina","2024-08-08",0,0,0,0,0,0,0,0
"Bosnia and Herzegovina","2024-08-09",0,0,0,0,0,0,0,0
"Bosnia and Herzegovina","2024-08-10",0,0,0,0,0,0,0,0
"Bosnia and Herzegovina","2024-08-11",0,0,0,0,0,0,0,0
"Bosnia and Herzegovina","2024-08-12",0,0,0,0,0,0,0,0
"Bosnia and Herzegovina","2024-08-13",0,0,0,0,0,0,0,0
"Bosnia and Herzegovina","2024-08-14",0,0,0,0,0,0,0,0
"Bosnia and Herzegovina","2024-08-15",0,0,0,0,0,0,0,0
"Bosnia and Herzegovina","2024-08-16",0,0,0,0,0,0,0,0
"Bosnia and Herzegovina","2024-08-17",0,0,0,0,0,0,0,0
"Bosnia and Herzegovina","2024-08-18",0,0,0,0,0,0,0,0
"Bosnia and Herzegovina","2024-08-19",0,0,0,0,0,0,0,0
"Bosnia and Herzegovina","2024-08-20",0,0,0,0,0,0,0,0
"Bosnia and Herzegovina","2024-08-21",0,0,0,0,0,0,0,0
"Bosnia and Herzegovina","2024-08-22",0,0,0,0,0,0,0,0
"Bosnia and Herzegovina","2024-08-23",0,0,0,0,0,0,0,0
"Bosnia and Herzegovina","2024-08-24",0,0,0,0,0,0,0,0
"Bosnia and Herzegovina","2024-08-25",0,0,0,0,0,0,0,0
"Bosnia and Herzegovina","2024-08-26",0,0,0,0,0,0,0,0
"Bosnia and Herzegovina","2024-08-27",0,0,0,0,0,0,0,0
"Bosnia and Herzegovina","2024-08-28",0,0,0,0,0,0,0,0
"Bosnia and Herzegovina","2024-08-29",0,0,0,0,0,0,0,0
"Bosnia and Herzegovina","2024-08-30",0,0,0,0,0,0,0,0
"Bosnia and Herzegovina","2024-08-31",0,0,0,0,0,0,0,0
"Bosnia and Herzegovina","2024-09-01",0,0,0,0,0,0,0,0
"Bosnia and Herzegovina","2024-09-02",0,0,0,0,0,0,0,0
"Bosnia and Herzegovina","2024-09-03",0,0,0,0,0,0,0,0
"Bosnia and Herzegovina","2024-09-04",0,0,0,0,0,0,0,0
"Bosnia and Herzegovina","2024-09-05",0,0,0,0,0,0,0,0
"Bosnia and Herzegovina","2024-09-06",0,0,0,0,0,0,0,0
"Bosnia and Herzegovina","2024-09-07",0,0,0,0,0,0,0,0
"Bosnia and Herzegovina","2024-09-08",0,0,0,0,0,0,0,0
"Bosnia and Herzegovina","2024-09-09",0,0,0,0,0,0,0,0
"Bosnia and Herzegovina","2024-09-10",0,0,0,0,0,0,0,0
"Bosnia and Herzegovina","2024-09-11",0,0,0,0,0,0,0,0
"Bosnia and Herzegovina","2024-09-12",0,0,0,0,0,0,0,0
"Bosnia and Herzegovina","2024-09-13",0,0,0,0,0,0,0,0
"Bosnia and Herzegovina","2024-09-14",0,0,0,0,0,0,0,0
"Bosnia and Herzegovina","2024-09-15",0,0,0,0,0,0,0,0
"Bosnia and Herzegovina","2024-09-16",0,0,0,0,0,0,0,0
"Bosnia and Herzegovina","2024-09-17",0,0,0,0,0,0,0,0
"Bosnia and Herzegovina","2024-09-18",0,0,0,0,0,0,0,0
"Bosnia and Herzegovina","2024-09-19",0,0,0,0,0,0,0,0
"Bosnia and Herzegovina","2024-09-20",0,0,0,0,0,0,0,0
"Bosnia and Herzegovina","2024-09-21",0,0,0,0,0,0,0,0
"Bosnia and Herzegovina","2024-09-22",0,0,0,0,0,0,0,0
"Bosnia and Herzegovina","2024-09-23",0,0,0,0,0,0,0,0
"Bosnia and Herzegovina","2024-09-24",0,0,0,0,0,0,0,0
"Bosnia and Herzegovina","2024-09-25",0,0,0,0,0,0,0,0
"Bosnia and Herzegovina","2024-09-26",0,0,0,0,0,0,0,0
"Bosnia and Herzegovina","2024-09-27",0,0,0,0,0,0,0,0
"Bosnia and Herzegovina","2024-09-28",0,0,0,0,0,0,0,0
"Bosnia and Herzegovina","2024-09-29",0,0,0,0,0,0,0,0
"Bosnia and Herzegovina","2024-09-30",0,0,0,0,0,0,0,0
"Bosnia and Herzegovina","2024-10-01",0,0,0,0,0,0,0,0
"Bosnia and Herzegovina","2024-10-02",0,0,0,0,0,0,0,0
"Bosnia and Herzegovina","2024-10-03",0,0,0,0,0,0,0,0
"Bosnia and Herzegovina","2024-10-04",0,0,0,0,0,0,0,0
"Bosnia and Herzegovina","2024-10-05",0,0,0,0,0,0,0,0
"Bosnia and Herzegovina","2024-10-06",0,0,0,0,0,0,0,0
"Bosnia and Herzegovina","2024-10-07",0,0,0,0,0,0,0,0
"Bosnia and Herzegovina","2024-10-08",0,0,0,0,0,0,0,0
"Bosnia and Herzegovina","2024-10-09",0,0,0,0,0,0,0,0
"Bosnia and Herzegovina","2024-10-10",0,0,0,0,0,0,0,0
"Bosnia and Herzegovina","2024-10-11",0,0,0,0,0,0,0,0
"Bosnia and Herzegovina","2024-10-12",0,0,0,0,0,0,0,0
"Bosnia and Herzegovina","2024-10-13",0,0,0,0,0,0,0,0
"Bosnia and Herzegovina","2024-10-14",0,0,0,0,0,0,0,0
"Bosnia and Herzegovina","2024-10-15",0,0,0,0,0,0,0,0
"Bosnia and Herzegovina","2024-10-16",0,0,0,0,0,0,0,0
"Bosnia and Herzegovina","2024-10-17",0,0,0,0,0,0,0,0
"Bosnia and Herzegovina","2024-10-18",0,0,0,0,0,0,0,0
"Bosnia and Herzegovina","2024-10-19",0,0,0,0,0,0,0,0
"Bosnia and Herzegovina","2024-10-20",0,0,0,0,0,0,0,0
"Bosnia and Herzegovina","2024-10-21",0,0,0,0,0,0,0,0
"Bosnia and Herzegovina","2024-10-22",0,0,0,0,0,0,0,0
"Bosnia and Herzegovina","2024-10-23",0,0,0,0,0,0,0,0
"Bosnia and Herzegovina","2024-10-24",0,0,0,0,0,0,0,0
"Bosnia and Herzegovina","2024-10-25",0,0,0,0,0,0,0,0
"Bosnia and Herzegovina","2024-10-26",0,0,0,0,0,0,0,0
"Bosnia and Herzegovina","2024-10-27",0,0,0,0,0,0,0,0
"Bosnia and Herzegovina","2024-10-28",0,0,0,0,0,0,0,0
"Bosnia and Herzegovina","2024-10-29",0,0,0,0,0,0,0,0
"Bosnia and Herzegovina","2024-10-30",0,0,0,0,0,0,0,0
"Bosnia and Herzegovina","2024-10-31",0,0,0,0,0,0,0,0
"Bosnia and Herzegovina","2024-11-01",0,0,0,0,0,0,0,0
"Bosnia and Herzegovina","2024-11-02",0,0,0,0,0,0,0,0
"Bosnia and Herzegovina","2024-11-03",0,0,0,0,0,0,0,0
"Bosnia and Herzegovina","2024-11-04",0,0,0,0,0,0,0,0
"Bosnia and Herzegovina","2024-11-05",0,0,0,0,0,0,0,0
"Bosnia and Herzegovina","2024-11-06",0,0,0,0,0,0,0,0
"Bosnia and Herzegovina","2024-11-07",0,0,0,0,0,0,0,0
"Bosnia and Herzegovina","2024-11-08",0,0,0,0,0,0,0,0
"Bosnia and Herzegovina","2024-11-09",0,0,0,0,0,0,0,0
"Bosnia and Herzegovina","2024-11-10",0,0,0,0,0,0,0,0
"Bosnia and Herzegovina","2024-11-11",0,0,0,0,0,0,0,0
"Bosnia and Herzegovina","2024-11-12",0,0,0,0,0,0,0,0
"Bosnia and Herzegovina","2024-11-13",0,0,0,0,0,0,0,0
"Bosnia and Herzegovina","2024-11-14",0,0,0,0,0,0,0,0
"Bosnia and Herzegovina","2024-11-15",0,0,0,0,0,0,0,0
"Bosnia and Herzegovina","2024-11-16",0,0,0,0,0,0,0,0
"Bosnia and Herzegovina","2024-11-17",0,0,0,0,0,0,0,0
"Bosnia and Herzegovina","2024-11-18",0,0,0,0,0,0,0,0
"Bosnia and Herzegovina","2024-11-19",0,0,0,0,0,0,0,0
"Bosnia and Herzegovina","2024-11-20",0,0,0,0,0,0,0,0
"Bosnia and Herzegovina","2024-11-21",0,0,0,0,0,0,0,0
"Bosnia and Herzegovina","2024-11-22",0,0,0,0,0,0,0,0
"Bosnia and Herzegovina","2024-11-23",0,0,0,0,0,0,0,0
"Bosnia and Herzegovina","2024-11-24",0,0,0,0,0,0,0,0
"Bosnia and Herzegovina","2024-11-25",0,0,0,0,0,0,0,0
"Bosnia and Herzegovina","2024-11-26",0,0,0,0,0,0,0,0
"Bosnia and Herzegovina","2024-11-27",0,0,0,0,0,0,0,0
"Bosnia and Herzegovina","2024-11-28",0,0,0,0,0,0,0,0
"Bosnia and Herzegovina","2024-11-29",0,0,0,0,0,0,0,0
"Bosnia and Herzegovina","2024-11-30",0,0,0,0,0,0,0,0
"Bosnia and Herzegovina","2024-12-01",0,0,0,0,0,0,0,0
"Bosnia and Herzegovina","2024-12-02",0,0,0,0,0,0,0,0
"Bosnia and Herzegovina","2024-12-03",0,0,0,0,0,0,0,0
"Bosnia and Herzegovina","2024-12-04",0,0,0,0,0,0,0,0
"Bosnia and Herzegovina","2024-12-05",0,0,0,0,0,0,0,0
"Bosnia and Herzegovina","2024-12-06",0,0,0,0,0,0,0,0
"Bosnia and Herzegovina","2024-12-07",0,0,0,0,0,0,0,0
"Bosnia and Herzegovina","2024-12-08",0,0,0,0,0,0,0,0
"Bosnia and Herzegovina","2024-12-09",0,0,0,0,0,0,0,0
"Bosnia and Herzegovina","2024-12-10",0,0,0,0,0,0,0,0
"Bosnia and Herzegovina","2024-12-11",0,0,0,0,0,0,0,0
"Bosnia and Herzegovina","2024-12-12",0,0,0,0,0,0,0,0
"Bosnia and Herzegovina","2024-12-13",0,0,0,0,0,0,0,0
"Bosnia and Herzegovina","2024-12-14",0,0,0,0,0,0,0,0
"Bosnia and Herzegovina","2024-12-15",0,0,0,0,0,0,0,0
"Bosnia and Herzegovina","2024-12-16",0,0,0,0,0,0,0,0
"Bosnia and Herzegovina","2024-12-17",0,0,0,0,0,0,0,0
"Bosnia and Herzegovina","2024-12-18",0,0,0,0,0,0,0,0
"Bosnia and Herzegovina","2024-12-19",0,0,0,0,0,0,0,0
"Bosnia and Herzegovina","2024-12-20",0,0,0,0,0,0,0,0
"Bosnia and Herzegovina","2024-12-21",0,0,0,0,0,0,0,0
"Bosnia and Herzegovina","2024-12-22",0,0,0,0,0,0,0,0
"Bosnia and Herzegovina","2024-12-23",0,0,0,0,0,0,0,0
"Bosnia and Herzegovina","2024-12-24",0,0,0,0,0,0,0,0
"Bosnia and Herzegovina","2024-12-25",0,0,0,0,0,0,0,0
"Bosnia and Herzegovina","2024-12-26",0,0,0,0,0,0,0,0
"Bosnia and Herzegovina","2024-12-27",0,0,0,0,0,0,0,0
"Bosnia and Herzegovina","2024-12-28",0,0,0,0,0,0,0,0
"Bosnia and Herzegovina","2024-12-29",0,0,0,0,0,0,0,0
"Bosnia and Herzegovina","2024-12-30",0,0,0,0,0,0,0,0
"Bosnia and Herzegovina","2024-12-31",0,0,0,0,0,0,0,0
"Bosnia and Herzegovina","2025-01-01",0,0,0,0,0,0,0,0
"Bosnia and Herzegovina","2025-01-02",0,0,0,0,0,0,0,0
"Bosnia and Herzegovina","2025-01-03",0,0,0,0,0,0,0,0
"Bosnia and Herzegovina","2025-01-04",0,0,0,0,0,0,0,0
"Bosnia and Herzegovina","2025-01-05",0,0,0,0,0,0,0,0
"Bosnia and Herzegovina","2025-01-06",0,0,0,0,0,0,0,0
"Bosnia and Herzegovina","2025-01-07",0,0,0,0,0,0,0,0
"Bosnia and Herzegovina","2025-01-08",0,0,0,0,0,0,0,0
"Bosnia and Herzegovina","2025-01-09",0,0,0,0,0,0,0,0
"Bosnia and Herzegovina","2025-01-10",0,0,0,0,0,0,0,0
"Bosnia and Herzegovina","2025-01-11",0,0,0,0,0,0,0,0
"Bosnia and Herzegovina","2025-01-12",0,0,0,0,0,0,0,0
"Bosnia and Herzegovina","2025-01-13",0,0,0,0,0,0,0,0
"Brazil","2024-01-01",0,0,0,0,0,0,0,0
"Brazil","2024-01-02",0,47,47,0,47,47,0,0
"Brazil","2024-01-03",0,0,47,0,6,53,0,0
"Brazil","2024-01-04",0,0,47,0,6,59,0,0
"Brazil","2024-01-05",0,0,47,0,6,65,0,0
"Brazil","2024-01-06",0,0,47,0,5,70,0,0
"Brazil","2024-01-07",0,0,47,0,6,76,0,0
"Brazil","2024-01-08",0,0,47,0,6,82,0,0
"Brazil","2024-01-09",0,41,88,0,6,88,0,0
"Brazil","2024-01-10",0,0,88,0,6,94,0,0
"Brazil","2024-01-11",0,0,88,0,6,100,0,0
"Brazil","2024-01-12",0,0,88,0,6,106,0,0
"Brazil","2024-01-13",0,0,88,0,5,111,0,0
"Brazil","2024-01-14",0,0,88,0,6,117,0,0
"Brazil","2024-01-15",0,0,88,0,6,123,0,0
"Brazil","2024-01-16",0,41,129,0,6,129,0,0
"Brazil","2024-01-17",0,0,129,0,5,134,0,0
"Brazil","2024-01-18",0,0,129,0,4,138,0,0
"Brazil","2024-01-19",0,0,129,0,5,143,0,0
"Brazil","2024-01-20",0,0,129,0,5,148,0,0
"Brazil","2024-01-21",0,0,129,0,5,153,0,0
"Brazil","2024-01-22",0,0,129,0,4,157,0,0
"Brazil","2024-01-23",0,33,162,0,5,162,0,0
"Brazil","2024-01-24",0,0,162,0,5,167,0,0
"Brazil","2024-01-25",0,0,162,0,5,172,0,0
"Brazil","2024-01-26",0,0,162,0,5,177,0,0
"Brazil","2024-01-27",0,0,162,0,4,181,0,0
"Brazil","2024-01-28",0,0,162,0,5,186,0,0
"Brazil","2024-01-29",0,0,162,0,5,191,0,0
"Brazil","2024-01-30",0,34,196,0,5,196,0,0
"Brazil","2024-01-31",0,0,196,0,5,201,0,0
"Brazil","2024-02-01",0,0,196,0,4,205,0,0
"Brazil","2024-02-02",0,0,196,0,5,210,0,0
"Brazil","2024-02-03",0,0,196,0,4,214,0,0
"Brazil","2024-02-04",0,0,196,0,5,219,0,0
"Brazil","2024-02-05",0,0,196,0,4,223,0,0
"Brazil","2024-02-06",0,32,228,0,5,228,0,0
"Brazil","2024-02-07",0,0,228,0,5,233,0,0
"Brazil","2024-02-08",0,0,228,0,4,237,0,0
"Brazil","2024-02-09",0,0,228,0,5,242,0,0
"Brazil","2024-02-10",0,0,228,0,5,247,0,0
"Brazil","2024-02-11",0,0,228,0,5,252,0,0
"Brazil","2024-02-12",0,0,228,0,4,256,0,0
"Brazil","2024-02-13",0,33,261,0,5,261,0,0
"Brazil","2024-02-14",0,0,261,0,5,266,0,0
"Brazil","2024-02-15",0,0,261,0,5,271,0,0
"Brazil","2024-02-16",0,0,261,0,5,276,0,0
"Brazil","2024-02-17",0,0,261,0,6,282,0,0
"Brazil","2024-02-18",0,0,261,0,5,287,0,0
"Brazil","2024-02-19",0,0,261,0,5,292,0,0
"Brazil","2024-02-20",0,36,297,0,5,297,0,0
"Brazil","2024-02-21",0,0,297,0,4,301,0,0
"Brazil","2024-02-22",0,0,297,0,3,304,0,0
"Brazil","2024-02-23",0,0,297,0,4,308,0,0
"Brazil","2024-02-24",0,0,297,0,4,312,0,0
"Brazil","2024-02-25",0,0,297,0,4,316,0,0
"Brazil","2024-02-26",0,0,297,0,3,319,0,0
"Brazil","2024-02-27",0,26,323,0,4,323,0,0
"Brazil","2024-02-28",0,0,323,0,3,326,0,0
"Brazil","2024-02-29",0,0,323,0,3,329,0,0
"Brazil","2024-03-01",0,0,323,0,3,332,0,0
"Brazil","2024-03-02",0,0,323,0,3,335,0,0
"Brazil","2024-03-03",0,0,323,0,3,338,0,0
"Brazil","2024-03-04",0,0,323,0,3,341,0,0
"Brazil","2024-03-05",0,21,344,0,3,344,0,0
"Brazil","2024-03-06",0,0,344,0,3,347,0,0
"Brazil","2024-03-07",0,0,344,0,3,350,0,0
"Brazil","2024-03-08",0,0,344,0,3,353,0,0
"Brazil","2024-03-09",0,0,344,0,4,357,0,0
"Brazil","2024-03-10",0,0,344,0,3,360,0,0
"Brazil","2024-03-11",0,0,344,0,3,363,0,0
"Brazil","2024-03-12",0,22,366,0,3,366,0,0
"Brazil","2024-03-13",0,0,366,0,3,369,0,0
"Brazil","2024-03-14",0,0,366,0,3,372,0,0
"Brazil","2024-03-15",0,0,366,0,3,375,0,0
"Brazil","2024-03-16",0,0,366,0,4,379,0,0
"Brazil","2024-03-17",0,0,366,0,3,382,0,0
"Brazil","2024-03-18",0,0,366,0,3,385,0,0
"Brazil","2024-03-19",0,22,388,0,3,388,0,0
"Brazil","2024-03-20",0,0,388,0,3,391,0,0
"Brazil","2024-03-21",0,0,388,0,3,394,0,0
"Brazil","2024-03-22",0,0,388,0,3,397,0,0
"Brazil","2024-03-23",0,0,388,0,3,400,0,0
"Brazil","2024-03-24",0,0,388,0,3,403,0,0
"Brazil","2024-03-25",0,0,388,0,3,406,0,0
"Brazil","2024-03-26",0,21,409,0,3,409,0,0
"Brazil","2024-03-27",0,0,409,0,4,413,0,0
"Brazil","2024-03-28",0,0,409,0,3,416,0,0
"Brazil","2024-03-29",0,0,409,0,4,420,0,0
"Brazil","2024-03-30",0,0,409,0,3,423,0,0
"Brazil","2024-03-31",0,0,409,0,4,427,0,0
"Brazil","2024-04-01",0,0,409,0,3,430,0,0
"Brazil","2024-04-02",0,25,434,0,4,434,0,0
"Brazil","2024-04-03",0,0,434,0,3,437,0,0
"Brazil","2024-04-04",0,0,434,0,2,439,0,0
"Brazil","2024-04-05",0,0,434,0,3,442,0,0
"Brazil","2024-04-06",0,0,434,0,2,444,0,0
"Brazil","2024-04-07",0,0,434,0,3,447,0,0
"Brazil","2024-04-08",0,0,434,0,2,449,0,0
"Brazil","2024-04-09",0,18,452,0,3,452,0,0
"Brazil","2024-04-10",0,0,452,0,2,454,0,0
"Brazil","2024-04-11",0,0,452,0,1,455,0,0
"Brazil","2024-04-12",0,0,452,0,2,457,0,0
"Brazil","2024-04-13",0,0,452,0,1,458,0,0
"Brazil","2024-04-14",0,0,452,0,2,460,0,0
"Brazil","2024-04-15",0,0,452,0,1,461,0,0
"Brazil","2024-04-16",0,11,463,0,2,463,0,0
"Brazil","2024-04-17",0,0,463,0,3,466,0,0
"Brazil","2024-04-18",0,0,463,0,3,469,0,0
"Brazil","2024-04-19",0,0,463,0,3,472,0,0
"Brazil","2024-04-20",0,0,463,0,2,474,0,0
"Brazil","2024-04-21",0,0,463,0,3,477,0,0
"Brazil","2024-04-22",0,0,463,0,3,480,0,0
"Brazil","2024-04-23",0,20,483,0,3,483,0,0
"Brazil","2024-04-24",0,0,483,0,3,486,0,0
"Brazil","2024-04-25",0,0,483,0,2,488,0,0
"Brazil","2024-04-26",0,0,483,0,3,491,0,0
"Brazil","2024-04-27",0,0,483,0,3,494,0,0
"Brazil","2024-04-28",0,0,483,0,3,497,0,0
"Brazil","2024-04-29",0,0,483,0,2,499,0,0
"Brazil","2024-04-30",0,19,502,0,3,502,0,0
"Brazil","2024-05-01",0,0,502,0,2,504,0,0
"Brazil","2024-05-02",0,0,502,0,3,507,0,0
"Brazil","2024-05-03",0,0,502,0,2,509,0,0
"Brazil","2024-05-04",0,0,502,0,3,512,0,0
"Brazil","2024-05-05",0,0,502,0,2,514,0,0
"Brazil","2024-05-06",0,0,502,0,3,517,0,0
"Brazil","2024-05-07",0,17,519,0,2,519,0,0
"Brazil","2024-05-08",0,0,519,0,3,522,0,0
"Brazil","2024-05-09",0,0,519,0,2,524,0,0
"Brazil","2024-05-10",0,0,519,0,3,527,0,0
"Brazil","2024-05-11",0,0,519,0,2,529,0,0
"Brazil","2024-05-12",0,0,519,0,3,532,0,0
"Brazil","2024-05-13",0,0,519,0,2,534,0,0
"Brazil","2024-05-14",0,18,537,0,3,537,0,0
"Brazil","2024-05-15",0,0,537,0,1,538,0,0
"Brazil","2024-05-16",0,0,537,0,1,539,0,0
"Brazil","2024-05-17",0,0,537,0,1,540,0,0
"Brazil","2024-05-18",0,0,537,0,1,541,0,0
"Brazil","2024-05-19",0,0,537,0,1,542,0,0
"Brazil","2024-05-20",0,0,537,0,1,543,0,0
"Brazil","2024-05-21",0,7,544,0,1,544,0,0
"Brazil","2024-05-22",0,0,544,0,2,546,0,0
"Brazil","2024-05-23",0,0,544,0,2,548,0,0
"Brazil","2024-05-24",0,0,544,0,2,550,0,0
"Brazil","2024-05-25",0,0,544,0,3,553,0,0
"Brazil","2024-05-26",0,0,544,0,2,555,0,0
"Brazil","2024-05-27",0,0,544,0,2,557,0,0
"Brazil","2024-05-28",0,15,559,0,2,559,0,0
"Brazil","2024-05-29",0,0,559,0,2,561,0,0
"Brazil","2024-05-30",0,0,559,0,2,563,0,0
"Brazil","2024-05-31",0,0,559,0,2,565,0,0
"Brazil","2024-06-01",0,0,559,0,1,566,0,0
"Brazil","2024-06-02",0,0,559,0,2,568,0,0
"Brazil","2024-06-03",0,0,559,0,2,570,0,0
"Brazil","2024-06-04",0,13,572,0,2,572,0,0
"Brazil","2024-06-05",0,0,572,0,1,573,0,0
"Brazil","2024-06-06",0,0,572,0,1,574,0,0
"Brazil","2024-06-07",0,0,572,0,1,575,0,0
"Brazil","2024-06-08",0,0,572,0,2,577,0,0
"Brazil","2024-06-09",0,0,572,0,1,578,0,0
"Brazil","2024-06-10",0,0,572,0,1,579,0,0
"Brazil","2024-06-11",0,8,580,0,1,580,0,0
"Brazil","2024-06-12",0,0,580,0,1,581,0,0
"Brazil","2024-06-13",0,0,580,0,1,582,0,0
"Brazil","2024-06-14",0,0,580,0,1,583,0,0
"Brazil","2024-06-15",0,0,580,0,1,584,0,0
"Brazil","2024-06-16",0,0,580,0,1,585,0,0
"Brazil","2024-06-17",0,0,580,0,1,586,0,0
"Brazil","2024-06-18",0,7,587,0,1,587,0,0
"Brazil","2024-06-19",0,0,587,0,2,589,0,0
"Brazil","2024-06-20",0,0,587,0,2,591,0,0
"Brazil","2024-06-21",0,0,587,0,2,593,0,0
"Brazil","2024-06-22",0,0,587,0,3,596,0,0
"Brazil","2024-06-23",0,0,587,0,2,598,0,0
"Brazil","2024-06-24",0,0,587,0,2,600,0,0
"Brazil","2024-06-25",0,15,602,0,2,602,0,0
"Brazil","2024-06-26",0,0,602,0,2,604,0,0
"Brazil","2024-06-27",0,0,602,0,2,606,0,0
"Brazil","2024-06-28",0,0,602,0,2,608,0,0
"Brazil","2024-06-29",0,0,602,0,3,611,0,0
"Brazil","2024-06-30",0,0,602,0,2,613,0,0
"Brazil","2024-07-01",0,0,602,0,2,615,0,0
"Brazil","2024-07-02",0,15,617,0,2,617,0,0
"Brazil","2024-07-03",0,0,617,0,3,620,0,0
"Brazil","2024-07-04",0,0,617,0,3,623,0,0
"Brazil","2024-07-05",0,0,617,0,3,626,0,0
"Brazil","2024-07-06",0,0,617,0,4,630,0,0
"Brazil","2024-07-07",0,0,617,0,3,633,0,0
"Brazil","2024-07-08",0,0,617,0,3,636,0,0
"Brazil","2024-07-09",0,22,639,0,3,639,0,0
"Brazil","2024-07-10",0,0,639,0,4,643,0,0
"Brazil","2024-07-11",0,0,639,0,3,646,0,0
"Brazil","2024-07-12",0,0,639,0,4,650,0,0
"Brazil","2024-07-13",0,0,639,0,3,653,0,0
"Brazil","2024-07-14",0,0,639,0,4,657,0,0
"Brazil","2024-07-15",0,0,639,0,3,660,0,0
"Brazil","2024-07-16",0,25,664,0,4,664,0,0
"Brazil","2024-07-17",0,0,664,0,5,669,0,0
"Brazil","2024-07-18",0,0,664,0,4,673,0,0
"Brazil","2024-07-19",0,0,664,0,5,678,0,0
"Brazil","2024-07-20",0,0,664,0,4,682,0,0
"Brazil","2024-07-21",0,0,664,0,5,687,0,0
"Brazil","2024-07-22",0,0,664,0,4,691,0,0
"Brazil","2024-07-23",0,32,696,0,5,696,0,0
"Brazil","2024-07-24",0,0,696,0,5,701,0,0
"Brazil","2024-07-25",0,0,696,0,5,706,0,0
"Brazil","2024-07-26",0,0,696,0,5,711,0,0
"Brazil","2024-07-27",0,0,696,0,5,716,0,0
"Brazil","2024-07-28",0,0,696,0,5,721,0,0
"Brazil","2024-07-29",0,0,696,0,5,726,0,0
"Brazil","2024-07-30",0,35,731,0,5,731,0,0
"Brazil","2024-07-31",0,0,731,0,8,739,0,0
"Brazil","2024-08-01",0,0,731,0,9,748,0,0
"Brazil","2024-08-02",0,0,731,0,8,756,0,0
"Brazil","2024-08-03",0,0,731,0,8,764,0,0
"Brazil","2024-08-04",0,0,731,0,8,772,0,0
"Brazil","2024-08-05",0,0,731,0,9,781,0,0
"Brazil","2024-08-06",0,58,789,0,8,789,0,0
"Brazil","2024-08-07",0,0,789,0,9,798,0,0
"Brazil","2024-08-08",0,0,789,0,10,808,0,0
"Brazil","2024-08-09",0,0,789,0,9,817,0,0
"Brazil","2024-08-10",0,0,789,0,9,826,0,0
"Brazil","2024-08-11",0,0,789,0,9,835,0,0
"Brazil","2024-08-12",0,0,789,0,10,845,0,0
"Brazil","2024-08-13",0,65,854,0,9,854,0,0
"Brazil","2024-08-14",0,0,854,0,12,866,0,0
"Brazil","2024-08-15",0,0,854,0,13,879,0,0
"Brazil","2024-08-16",0,0,854,0,12,891,0,0
"Brazil","2024-08-17",0,0,854,0,12,903,0,0
"Brazil","2024-08-18",0,0,854,0,12,915,0,0
"Brazil","2024-08-19",0,0,854,0,13,928,0,0
"Brazil","2024-08-20",0,86,940,0,12,940,0,0
"Brazil","2024-08-21",0,0,940,0,12,952,0,0
"Brazil","2024-08-22",0,0,940,0,11,963,0,0
"Brazil","2024-08-23",0,0,940,0,12,975,0,0
"Brazil","2024-08-24",0,0,940,0,12,987,0,0
"Brazil","2024-08-25",0,0,940,0,12,999,0,0
"Brazil","2024-08-26",0,0,940,0,11,1010,0,0
"Brazil","2024-08-27",0,82,1022,0,12,1022,0,0
"Brazil","2024-08-28",0,0,1022,0,13,1035,0,0
"Brazil","2024-08-29",0,0,1022,0,12,1047,0,0
"Brazil","2024-08-30",0,0,1022,0,13,1060,0,0
"Brazil","2024-08-31",0,0,1022,0,12,1072,0,0
"Brazil","2024-09-01",0,0,1022,0,13,1085,0,0
"Brazil","2024-09-02",0,0,1022,0,12,1097,0,0
"Brazil","2024-09-03",0,88,1110,0,13,1110,0,0
"Brazil","2024-09-04",0,0,1110,0,9,1119,0,0
"Brazil","2024-09-05",0,0,1110,0,8,1127,0,0
"Brazil","2024-09-06",0,0,1110,0,9,1136,0,0
"Brazil","2024-09-07",0,0,1110,0,9,1145,0,0
"Brazil","2024-09-08",0,0,1110,0,9,1154,0,0
"Brazil","2024-09-09",0,0,1110,0,8,1162,0,0
"Brazil","2024-09-10",0,61,1171,0,9,1171,0,0
"Brazil","2024-09-11",0,0,1171,0,9,1180,0,0
"Brazil","2024-09-12",0,0,1171,0,8,1188,0,0
"Brazil","2024-09-13",0,0,1171,0,9,1197,0,0
"Brazil","2024-09-14",0,0,1171,0,9,1206,0,0
"Brazil","2024-09-15",0,0,1171,0,9,1215,0,0
"Brazil","2024-09-16",0,0,1171,0,8,1223,0,0
"Brazil","2024-09-17",0,61,1232,0,9,1232,0,0
"Brazil","2024-09-18",0,0,1232,0,9,1241,0,0
"Brazil","2024-09-19",0,0,1232,0,8,1249,0,0
"Brazil","2024-09-20",0,0,1232,0,9,1258,0,0
"Brazil","2024-09-21",0,0,1232,0,9,1267,0,0
"Brazil","2024-09-22",0,0,1232,0,9,1276,0,0
"Brazil","2024-09-23",0,0,1232,0,8,1284,0,0
"Brazil","2024-09-24",0,61,1293,0,9,1293,0,0
"Brazil","2024-09-25",0,0,1293,0,11,1304,0,0
"Brazil","2024-09-26",0,0,1293,0,11,1315,0,0
"Brazil","2024-09-27",0,0,1293,0,11,1326,0,0
"Brazil","2024-09-28",0,0,1293,0,12,1338,0,0
"Brazil","2024-09-29",0,0,1293,0,11,1349,0,0
"Brazil","2024-09-30",0,0,1293,0,11,1360,0,0
"Brazil","2024-10-01",0,78,1371,0,11,1371,0,0
"Brazil","2024-10-02",0,0,1371,0,11,1382,0,0
"Brazil","2024-10-03",0,0,1371,0,10,1392,0,0
"Brazil","2024-10-04",0,0,1371,0,11,1403,0,0
"Brazil","2024-10-05",0,0,1371,0,10,1413,0,0
"Brazil","2024-10-06",0,0,1371,0,11,1424,0,0
"Brazil","2024-10-07",0,0,1371,0,10,1434,0,0
"Brazil","2024-10-08",0,74,1445,0,11,1445,0,0
"Brazil","2024-10-09",0,0,1445,0,8,1453,0,0
"Brazil","2024-10-10",0,0,1445,0,8,1461,0,0
"Brazil","2024-10-11",0,0,1445,0,8,1469,0,0
"Brazil","2024-10-12",0,0,1445,0,7,1476,0,0
"Brazil","2024-10-13",0,0,1445,0,8,1484,0,0
"Brazil","2024-10-14",0,0,1445,0,8,1492,0,0
"Brazil","2024-10-15",0,55,1500,0,8,1500,0,0
"Brazil","2024-10-16",0,0,1500,0,10,1510,0,0
"Brazil","2024-10-17",0,0,1500,0,10,1520,0,0
"Brazil","2024-10-18",0,0,1500,0,10,1530,0,0
"Brazil","2024-10-19",0,0,1500,0,11,1541,0,0
"Brazil","2024-10-20",0,0,1500,0,10,1551,0,0
"Brazil","2024-10-21",0,0,1500,0,10,1561,0,0
"Brazil","2024-10-22",0,71,1571,0,10,1571,0,0
"Brazil","2024-10-23",0,0,1571,0,7,1578,0,0
"Brazil","2024-10-24",0,0,1571,0,8,1586,0,0
"Brazil","2024-10-25",0,0,1571,0,7,1593,0,0
"Brazil","2024-10-26",0,0,1571,0,8,1601,0,0
"Brazil","2024-10-27",0,0,1571,0,7,1608,0,0
"Brazil","2024-10-28",0,0,1571,0,8,1616,0,0
"Brazil","2024-10-29",0,52,1623,0,7,1623,0,0
"Brazil","2024-10-30",0,0,1623,0,8,1631,0,0
"Brazil","2024-10-31",0,0,1623,0,8,1639,0,0
"Brazil","2024-11-01",0,0,1623,0,8,1647,0,0
"Brazil","2024-11-02",0,0,1623,0,9,1656,0,0
"Brazil","2024-11-03",0,0,1623,0,8,1664,0,0
"Brazil","2024-11-04",0,0,1623,0,8,1672,0,0
"Brazil","2024-11-05",0,57,1680,0,8,1680,0,0
"Brazil","2024-11-06",0,0,1680,0,5,1685,0,0
"Brazil","2024-11-07",0,0,1680,0,5,1690,0,0
"Brazil","2024-11-08",0,0,1680,0,5,1695,0,0
"Brazil","2024-11-09",0,0,1680,0,6,1701,0,0
"Brazil","2024-11-10",0,0,1680,0,5,1706,0,0
"Brazil","2024-11-11",0,0,1680,0,5,1711,0,0
"Brazil","2024-11-12",0,36,1716,0,5,1716,0,0
"Brazil","2024-11-13",0,0,1716,0,3,1719,0,0
"Brazil","2024-11-14",0,0,1716,0,3,1722,0,0
"Brazil","2024-11-15",0,0,1716,0,3,1725,0,0
"Brazil","2024-11-16",0,0,1716,0,4,1729,0,0
"Brazil","2024-11-17",0,0,1716,0,3,1732,0,0
"Brazil","2024-11-18",0,0,1716,0,3,1735,0,0
"Brazil","2024-11-19",0,22,1738,0,3,1738,0,0
"Brazil","2024-11-20",0,0,1738,0,0,1738,0,0
"Brazil","2024-11-21",0,0,1738,0,1,1739,0,0
"Brazil","2024-11-22",0,0,1738,0,0,1739,0,0
"Brazil","2024-11-23",0,0,1738,0,0,1739,0,0
"Brazil","2024-11-24",0,0,1738,0,0,1739,0,0
"Brazil","2024-11-25",0,0,1738,0,1,1740,0,0
"Brazil","2024-11-26",0,2,1740,0,0,1740,0,0
"Brazil","2024-11-27",0,0,1740,0,0,1740,0,0
"Brazil","2024-11-28",0,0,1740,0,0,1740,0,0
"Brazil","2024-11-29",0,0,1740,0,0,1740,0,0
"Brazil","2024-11-30",0,0,1740,0,0,1740,0,0
"Brazil","2024-12-01",0,0,1740,0,0,1740,0,0
"Brazil","2024-12-02",0,0,1740,0,0,1740,0,0
"Brazil","2024-12-03",0,0,1740,0,0,1740,0,0
"Brazil","2024-12-04",0,0,1740,0,0,1740,0,0
"Brazil","2024-12-05",0,0,1740,0,0,1740,0,0
"Brazil","2024-12-06",0,0,1740,0,0,1740,0,0
"Brazil","2024-12-07",0,0,1740,0,0,1740,0,0
"Brazil","2024-12-08",0,0,1740,0,0,1740,0,0
"Brazil","2024-12-09",0,0,1740,0,0,1740,0,0
"Brazil","2024-12-10",0,0,1740,0,0,1740,0,0
"Brazil","2024-12-11",0,0,1740,0,0,1740,0,0
"Brazil","2024-12-12",0,0,1740,0,0,1740,0,0
"Brazil","2024-12-13",0,0,1740,0,0,1740,0,0
"Brazil","2024-12-14",0,0,1740,0,0,1740,0,0
"Brazil","2024-12-15",0,0,1740,0,0,1740,0,0
"Brazil","2024-12-16",0,0,1740,0,0,1740,0,0
"Brazil","2024-12-17",0,0,1740,0,0,1740,0,0
"Brazil","2024-12-18",0,0,1740,0,0,1740,0,0
"Brazil","2024-12-19",0,0,1740,0,0,1740,0,0
"Brazil","2024-12-20",0,0,1740,0,0,1740,0,0
"Brazil","2024-12-21",0,0,1740,0,0,1740,0,0
"Brazil","2024-12-22",0,0,1740,0,0,1740,0,0
"Brazil","2024-12-23",0,0,1740,0,0,1740,0,0
"Brazil","2024-12-24",0,0,1740,0,0,1740,0,0
"Brazil","2024-12-25",0,0,1740,0,0,1740,0,0
"Brazil","2024-12-26",0,0,1740,0,0,1740,0,0
"Brazil","2024-12-27",0,0,1740,0,0,1740,0,0
"Brazil","2024-12-28",0,0,1740,0,0,1740,0,0
"Brazil","2024-12-29",0,0,1740,0,0,1740,0,0
"Brazil","2024-12-30",0,0,1740,0,0,1740,0,0
"Brazil","2024-12-31",0,0,1740,0,0,1740,0,0
"Brazil","2025-01-01",0,0,1740,0,0,1740,0,0
"Brazil","2025-01-02",0,0,1740,0,0,1740,0,0
"Brazil","2025-01-03",0,0,1740,0,0,1740,0,0
"Brazil","2025-01-04",0,0,1740,0,0,1740,0,0
"Brazil","2025-01-05",0,0,1740,0,0,1740,0,0
"Brazil","2025-01-06",0,0,1740,0,0,1740,0,0
"Brazil","2025-01-07",0,0,1740,0,0,1740,0,0
"Brazil","2025-01-08",0,0,1740,0,0,1740,0,0
"Brazil","2025-01-09",0,0,1740,0,0,1740,0,0
"Brazil","2025-01-10",0,0,1740,0,0,1740,0,0
"Brazil","2025-01-11",0,0,1740,0,0,1740,0,0
"Brazil","2025-01-12",0,0,1740,0,0,1740,0,0
"Brazil","2025-01-13",0,0,1740,0,0,1740,0,0
"Bulgaria","2024-01-01",0,0,0,0,0,0,0,0
"Bulgaria","2024-01-02",0,0,0,0,0,0,0,0
"Bulgaria","2024-01-03",0,0,0,0,0,0,0,0
"Bulgaria","2024-01-04",0,0,0,0,0,0,0,0
"Bulgaria","2024-01-05",0,0,0,0,0,0,0,0
"Bulgaria","2024-01-06",0,0,0,0,0,0,0,0
"Bulgaria","2024-01-07",0,0,0,0,0,0,0,0
"Bulgaria","2024-01-08",0,0,0,0,0,0,0,0
"Bulgaria","2024-01-09",0,0,0,0,0,0,0,0
"Bulgaria","2024-01-10",0,0,0,0,0,0,0,0
"Bulgaria","2024-01-11",0,0,0,0,0,0,0,0
"Bulgaria","2024-01-12",0,0,0,0,0,0,0,0
"Bulgaria","2024-01-13",0,0,0,0,0,0,0,0
"Bulgaria","2024-01-14",0,0,0,0,0,0,0,0
"Bulgaria","2024-01-15",0,0,0,0,0,0,0,0
"Bulgaria","2024-01-16",0,0,0,0,0,0,0,0
"Bulgaria","2024-01-17",0,0,0,0,0,0,0,0
"Bulgaria","2024-01-18",0,0,0,0,0,0,0,0
"Bulgaria","2024-01-19",0,0,0,0,0,0,0,0
"Bulgaria","2024-01-20",0,0,0,0,0,0,0,0
"Bulgaria","2024-01-21",0,0,0,0,0,0,0,0
"Bulgaria","2024-01-22",0,0,0,0,0,0,0,0
"Bulgaria","2024-01-23",0,0,0,0,0,0,0,0
"Bulgaria","2024-01-24",0,0,0,0,0,0,0,0
"Bulgaria","2024-01-25",0,0,0,0,0,0,0,0
"Bulgaria","2024-01-26",0,0,0,0,0,0,0,0
"Bulgaria","2024-01-27",0,0,0,0,0,0,0,0
"Bulgaria","2024-01-28",0,0,0,0,0,0,0,0
"Bulgaria","2024-01-29",0,0,0,0,0,0,0,0
"Bulgaria","2024-01-30",0,0,0,0,0,0,0,0
"Bulgaria","2024-01-31",0,0,0,0,0,0,0,0
"Bulgaria","2024-02-01",0,0,0,0,0,0,0,0
"Bulgaria","2024-02-02",0,0,0,0,0,0,0,0
"Bulgaria","2024-02-03",0,0,0,0,0,0,0,0
"Bulgaria","2024-02-04",0,0,0,0,0,0,0,0
"Bulgaria","2024-02-05",0,0,0,0,0,0,0,0
"Bulgaria","2024-02-06",0,0,0,0,0,0,0,0
"Bulgaria","2024-02-07",0,0,0,0,0,0,0,0
"Bulgaria","2024-02-08",0,0,0,0,0,0,0,0
"Bulgaria","2024-02-09",0,0,0,0,0,0,0,0
"Bulgaria","2024-02-10",0,0,0,0,0,0,0,0
"Bulgaria","2024-02-11",0,0,0,0,0,0,0,0
"Bulgaria","2024-02-12",0,0,0,0,0,0,0,0
"Bulgaria","2024-02-13",0,0,0,0,0,0,0,0
"Bulgaria","2024-02-14",0,0,0,0,0,0,0,0
"Bulgaria","2024-02-15",0,0,0,0,0,0,0,0
"Bulgaria","2024-02-16",0,0,0,0,0,0,0,0
"Bulgaria","2024-02-17",0,0,0,0,0,0,0,0
"Bulgaria","2024-02-18",0,0,0,0,0,0,0,0
"Bulgaria","2024-02-19",0,0,0,0,0,0,0,0
"Bulgaria","2024-02-20",0,0,0,0,0,0,0,0
"Bulgaria","2024-02-21",0,0,0,0,0,0,0,0
"Bulgaria","2024-02-22",0,0,0,0,0,0,0,0
"Bulgaria","2024-02-23",0,0,0,0,0,0,0,0
"Bulgaria","2024-02-24",0,0,0,0,0,0,0,0
"Bulgaria","2024-02-25",0,0,0,0,0,0,0,0
"Bulgaria","2024-02-26",0,0,0,0,0,0,0,0
"Bulgaria","2024-02-27",0,0,0,0,0,0,0,0
"Bulgaria","2024-02-28",0,0,0,0,0,0,0,0
"Bulgaria","2024-02-29",0,0,0,0,0,0,0,0
"Bulgaria","2024-03-01",0,0,0,0,0,0,0,0
"Bulgaria","2024-03-02",0,0,0,0,0,0,0,0
"Bulgaria","2024-03-03",0,0,0,0,0,0,0,0
"Bulgaria","2024-03-04",0,0,0,0,0,0,0,0
"Bulgaria","2024-03-05",0,0,0,0,0,0,0,0
"Bulgaria","2024-03-06",0,0,0,0,0,0,0,0
"Bulgaria","2024-03-07",0,0,0,0,0,0,0,0
"Bulgaria","2024-03-08",0,0,0,0,0,0,0,0
"Bulgaria","2024-03-09",0,0,0,0,0,0,0,0
"Bulgaria","2024-03-10",0,0,0,0,0,0,0,0
"Bulgaria","2024-03-11",0,0,0,0,0,0,0,0
"Bulgaria","2024-03-12",0,0,0,0,0,0,0,0
"Bulgaria","2024-03-13",0,0,0,0,0,0,0,0
"Bulgaria","2024-03-14",0,0,0,0,0,0,0,0
"Bulgaria","2024-03-15",0,0,0,0,0,0,0,0
"Bulgaria","2024-03-16",0,0,0,0,0,0,0,0
"Bulgaria","2024-03-17",0,0,0,0,0,0,0,0
"Bulgaria","2024-03-18",0,0,0,0,0,0,0,0
"Bulgaria","2024-03-19",0,0,0,0,0,0,0,0
"Bulgaria","2024-03-20",0,0,0,0,0,0,0,0
"Bulgaria","2024-03-21",0,0,0,0,0,0,0,0
"Bulgaria","2024-03-22",0,0,0,0,0,0,0,0
"Bulgaria","2024-03-23",0,0,0,0,0,0,0,0
"Bulgaria","2024-03-24",0,0,0,0,0,0,0,0
"Bulgaria","2024-03-25",0,0,0,0,0,0,0,0
"Bulgaria","2024-03-26",0,0,0,0,0,0,0,0
"Bulgaria","2024-03-27",0,0,0,0,0,0,0,0
"Bulgaria","2024-03-28",0,0,0,0,0,0,0,0
"Bulgaria","2024-03-29",0,0,0,0,0,0,0,0
"Bulgaria","2024-03-30",0,0,0,0,0,0,0,0
"Bulgaria","2024-03-31",0,0,0,0,0,0,0,0
"Bulgaria","2024-04-01",0,0,0,0,0,0,0,0
"Bulgaria","2024-04-02",0,0,0,0,0,0,0,0
"Bulgaria","2024-04-03",0,0,0,0,0,0,0,0
"Bulgaria","2024-04-04",0,0,0,0,0,0,0,0
"Bulgaria","2024-04-05",0,0,0,0,0,0,0,0
"Bulgaria","2024-04-06",0,0,0,0,0,0,0,0
"Bulgaria","2024-04-07",0,0,0,0,0,0,0,0
"Bulgaria","2024-04-08",0,0,0,0,0,0,0,0
"Bulgaria","2024-04-09",0,0,0,0,0,0,0,0
"Bulgaria","2024-04-10",0,0,0,0,0,0,0,0
"Bulgaria","2024-04-11",0,0,0,0,0,0,0,0
"Bulgaria","2024-04-12",0,0,0,0,0,0,0,0
"Bulgaria","2024-04-13",0,0,0,0,0,0,0,0
"Bulgaria","2024-04-14",0,0,0,0,0,0,0,0
"Bulgaria","2024-04-15",0,0,0,0,0,0,0,0
"Bulgaria","2024-04-16",0,0,0,0,0,0,0,0
"Bulgaria","2024-04-17",0,0,0,0,0,0,0,0
"Bulgaria","2024-04-18",0,0,0,0,0,0,0,0
"Bulgaria","2024-04-19",0,0,0,0,0,0,0,0
"Bulgaria","2024-04-20",0,0,0,0,0,0,0,0
"Bulgaria","2024-04-21",0,0,0,0,0,0,0,0
"Bulgaria","2024-04-22",0,0,0,0,0,0,0,0
"Bulgaria","2024-04-23",0,0,0,0,0,0,0,0
"Bulgaria","2024-04-24",0,0,0,0,0,0,0,0
"Bulgaria","2024-04-25",0,0,0,0,0,0,0,0
"Bulgaria","2024-04-26",0,0,0,0,0,0,0,0
"Bulgaria","2024-04-27",0,0,0,0,0,0,0,0
"Bulgaria","2024-04-28",0,0,0,0,0,0,0,0
"Bulgaria","2024-04-29",0,0,0,0,0,0,0,0
"Bulgaria","2024-04-30",0,0,0,0,0,0,0,0
"Bulgaria","2024-05-01",0,0,0,0,0,0,0,0
"Bulgaria","2024-05-02",0,0,0,0,0,0,0,0
"Bulgaria","2024-05-03",0,0,0,0,0,0,0,0
"Bulgaria","2024-05-04",0,0,0,0,0,0,0,0
"Bulgaria","2024-05-05",0,0,0,0,0,0,0,0
"Bulgaria","2024-05-06",0,0,0,0,0,0,0,0
"Bulgaria","2024-05-07",0,0,0,0,0,0,0,0
"Bulgaria","2024-05-08",0,0,0,0,0,0,0,0
"Bulgaria","2024-05-09",0,0,0,0,0,0,0,0
"Bulgaria","2024-05-10",0,0,0,0,0,0,0,0
"Bulgaria","2024-05-11",0,0,0,0,0,0,0,0
"Bulgaria","2024-05-12",0,0,0,0,0,0,0,0
"Bulgaria","2024-05-13",0,0,0,0,0,0,0,0
"Bulgaria","2024-05-14",0,0,0,0,0,0,0,0
"Bulgaria","2024-05-15",0,0,0,0,0,0,0,0
"Bulgaria","2024-05-16",0,0,0,0,0,0,0,0
"Bulgaria","2024-05-17",0,0,0,0,0,0,0,0
"Bulgaria","2024-05-18",0,0,0,0,0,0,0,0
"Bulgaria","2024-05-19",0,0,0,0,0,0,0,0
"Bulgaria","2024-05-20",0,0,0,0,0,0,0,0
"Bulgaria","2024-05-21",0,0,0,0,0,0,0,0
"Bulgaria","2024-05-22",0,0,0,0,0,0,0,0
"Bulgaria","2024-05-23",0,0,0,0,0,0,0,0
"Bulgaria","2024-05-24",0,0,0,0,0,0,0,0
"Bulgaria","2024-05-25",0,0,0,0,0,0,0,0
"Bulgaria","2024-05-26",0,0,0,0,0,0,0,0
"Bulgaria","2024-05-27",0,0,0,0,0,0,0,0
"Bulgaria","2024-05-28",0,0,0,0,0,0,0,0
"Bulgaria","2024-05-29",0,0,0,0,0,0,0,0
"Bulgaria","2024-05-30",0,0,0,0,0,0,0,0
"Bulgaria","2024-05-31",0,1,1,0,1,1,0,0
"Bulgaria","2024-06-01",0,0,1,0,0,1,0,0
"Bulgaria","2024-06-02",0,0,1,0,0,1,0,0
"Bulgaria","2024-06-03",0,0,1,0,0,1,0,0
"Bulgaria","2024-06-04",0,0,1,0,0,1,0,0
"Bulgaria","2024-06-05",0,0,1,0,0,1,0,0
"Bulgaria","2024-06-06",0,0,1,0,0,1,0,0
"Bulgaria","2024-06-07",0,0,1,0,0,1,0,0
"Bulgaria","2024-06-08",0,0,1,0,0,1,0,0
"Bulgaria","2024-06-09",0,0,1,0,0,1,0,0
"Bulgaria","2024-06-10",0,0,1,0,0,1,0,0
"Bulgaria","2024-06-11",0,0,1,0,0,1,0,0
"Bulgaria","2024-06-12",0,0,1,0,0,1,0,0
"Bulgaria","2024-06-13",0,0,1,0,0,1,0,0
"Bulgaria","2024-06-14",0,0,1,0,0,1,0,0
"Bulgaria","2024-06-15",0,0,1,0,0,1,0,0
"Bulgaria","2024-06-16",0,0,1,0,0,1,0,0
"Bulgaria","2024-06-17",0,0,1,0,0,1,0,0
"Bulgaria","2024-06-18",0,0,1,0,0,1,0,0
"Bulgaria","2024-06-19",0,0,1,0,0,1,0,0
"Bulgaria","2024-06-20",0,0,1,0,0,1,0,0
"Bulgaria","2024-06-21",0,0,1,0,0,1,0,0
"Bulgaria","2024-06-22",0,0,1,0,0,1,0,0
"Bulgaria","2024-06-23",0,0,1,0,0,1,0,0
"Bulgaria","2024-06-24",0,0,1,0,0,1,0,0
"Bulgaria","2024-06-25",0,0,1,0,0,1,0,0
"Bulgaria","2024-06-26",0,0,1,0,0,1,0,0
"Bulgaria","2024-06-27",0,0,1,0,0,1,0,0
"Bulgaria","2024-06-28",0,0,1,0,0,1,0,0
"Bulgaria","2024-06-29",0,0,1,0,0,1,0,0
"Bulgaria","2024-06-30",0,0,1,0,0,1,0,0
"Bulgaria","2024-07-01",0,0,1,0,0,1,0,0
"Bulgaria","2024-07-02",0,0,1,0,0,1,0,0
"Bulgaria","2024-07-03",0,0,1,0,0,1,0,0
"Bulgaria","2024-07-04",0,0,1,0,0,1,0,0
"Bulgaria","2024-07-05",0,0,1,0,0,1,0,0
"Bulgaria","2024-07-06",0,0,1,0,0,1,0,0
"Bulgaria","2024-07-07",0,0,1,0,0,1,0,0
"Bulgaria","2024-07-08",0,0,1,0,0,1,0,0
"Bulgaria","2024-07-09",0,0,1,0,0,1,0,0
"Bulgaria","2024-07-10",0,0,1,0,0,1,0,0
"Bulgaria","2024-07-11",0,0,1,0,0,1,0,0
"Bulgaria","2024-07-12",0,0,1,0,0,1,0,0
"Bulgaria","2024-07-13",0,0,1,0,0,1,0,0
"Bulgaria","2024-07-14",0,0,1,0,0,1,0,0
"Bulgaria","2024-07-15",0,0,1,0,0,1,0,0
"Bulgaria","2024-07-16",0,0,1,0,0,1,0,0
"Bulgaria","2024-07-17",0,0,1,0,0,1,0,0
"Bulgaria","2024-07-18",0,0,1,0,0,1,0,0
"Bulgaria","2024-07-19",0,0,1,0,0,1,0,0
"Bulgaria","2024-07-20",0,0,1,0,0,1,0,0
"Bulgaria","2024-07-21",0,0,1,0,0,1,0,0
"Bulgaria","2024-07-22",0,0,1,0,0,1,0,0
"Bulgaria","2024-07-23",0,0,1,0,0,1,0,0
"Bulgaria","2024-07-24",0,0,1,0,0,1,0,0
"Bulgaria","2024-07-25",0,0,1,0,0,1,0,0
"Bulgaria","2024-07-26",0,0,1,0,0,1,0,0
"Bulgaria","2024-07-27",0,0,1,0,0,1,0,0
"Bulgaria","2024-07-28",0,0,1,0,0,1,0,0
"Bulgaria","2024-07-29",0,0,1,0,0,1,0,0
"Bulgaria","2024-07-30",0,0,1,0,0,1,0,0
"Bulgaria","2024-07-31",0,0,1,0,0,1,0,0
"Bulgaria","2024-08-01",0,0,1,0,0,1,0,0
"Bulgaria","2024-08-02",0,0,1,0,0,1,0,0
"Bulgaria","2024-08-03",0,0,1,0,0,1,0,0
"Bulgaria","2024-08-04",0,0,1,0,0,1,0,0
"Bulgaria","2024-08-05",0,0,1,0,0,1,0,0
"Bulgaria","2024-08-06",0,0,1,0,0,1,0,0
"Bulgaria","2024-08-07",0,0,1,0,0,1,0,0
"Bulgaria","2024-08-08",0,0,1,0,0,1,0,0
"Bulgaria","2024-08-09",0,0,1,0,0,1,0,0
"Bulgaria","2024-08-10",0,0,1,0,0,1,0,0
"Bulgaria","2024-08-11",0,0,1,0,0,1,0,0
"Bulgaria","2024-08-12",0,0,1,0,0,1,0,0
"Bulgaria","2024-08-13",0,0,1,0,0,1,0,0
"Bulgaria","2024-08-14",0,0,1,0,0,1,0,0
"Bulgaria","2024-08-15",0,0,1,0,0,1,0,0
"Bulgaria","2024-08-16",0,0,1,0,0,1,0,0
"Bulgaria","2024-08-17",0,0,1,0,0,1,0,0
"Bulgaria","2024-08-18",0,0,1,0,0,1,0,0
"Bulgaria","2024-08-19",0,0,1,0,0,1,0,0
"Bulgaria","2024-08-20",0,0,1,0,0,1,0,0
"Bulgaria","2024-08-21",0,0,1,0,0,1,0,0
"Bulgaria","2024-08-22",0,0,1,0,0,1,0,0
"Bulgaria","2024-08-23",0,0,1,0,0,1,0,0
"Bulgaria","2024-08-24",0,0,1,0,0,1,0,0
"Bulgaria","2024-08-25",0,0,1,0,0,1,0,0
"Bulgaria","2024-08-26",0,0,1,0,0,1,0,0
"Bulgaria","2024-08-27",0,0,1,0,0,1,0,0
"Bulgaria","2024-08-28",0,0,1,0,0,1,0,0
"Bulgaria","2024-08-29",0,0,1,0,0,1,0,0
"Bulgaria","2024-08-30",0,0,1,0,0,1,0,0
"Bulgaria","2024-08-31",0,0,1,0,1,2,0,0
"Bulgaria","2024-09-01",0,0,1,0,0,2,0,0
"Bulgaria","2024-09-02",0,0,1,0,0,2,0,0
"Bulgaria","2024-09-03",0,0,1,0,0,2,0,0
"Bulgaria","2024-09-04",0,0,1,0,0,2,0,0
"Bulgaria","2024-09-05",0,0,1,0,0,2,0,0
"Bulgaria","2024-09-06",0,0,1,0,0,2,0,0
"Bulgaria","2024-09-07",0,0,1,0,0,2,0,0
"Bulgaria","2024-09-08",0,0,1,0,0,2,0,0
"Bulgaria","2024-09-09",0,0,1,0,0,2,0,0
"Bulgaria","2024-09-10",0,0,1,0,0,2,0,0
"Bulgaria","2024-09-11",0,0,1,0,0,2,0,0
"Bulgaria","2024-09-12",0,0,1,0,0,2,0,0
"Bulgaria","2024-09-13",0,0,1,0,0,2,0,0
"Bulgaria","2024-09-14",0,0,1,0,0,2,0,0
"Bulgaria","2024-09-15",0,0,1,0,0,2,0,0
"Bulgaria","2024-09-16",0,0,1,0,0,2,0,0
"Bulgaria","2024-09-17",0,0,1,0,0,2,0,0
"Bulgaria","2024-09-18",0,0,1,0,0,2,0,0
"Bulgaria","2024-09-19",0,0,1,0,0,2,0,0
"Bulgaria","2024-09-20",0,0,1,0,0,2,0,0
"Bulgaria","2024-09-21",0,0,1,0,0,2,0,0
"Bulgaria","2024-09-22",0,0,1,0,0,2,0,0
"Bulgaria","2024-09-23",0,0,1,0,0,2,0,0
"Bulgaria","2024-09-24",0,0,1,0,0,2,0,0
"Bulgaria","2024-09-25",0,0,1,0,0,2,0,0
"Bulgaria","2024-09-26",0,0,1,0,0,2,0,0
"Bulgaria","2024-09-27",0,0,1,0,0,2,0,0
"Bulgaria","2024-09-28",0,0,1,0,0,2,0,0
"Bulgaria","2024-09-29",0,0,1,0,0,2,0,0
"Bulgaria","2024-09-30",0,0,1,0,0,2,0,0
"Bulgaria","2024-10-01",0,0,1,0,0,2,0,0
"Bulgaria","2024-10-02",0,0,1,0,0,2,0,0
"Bulgaria","2024-10-03",0,0,1,0,0,2,0,0
"Bulgaria","2024-10-04",0,0,1,0,0,2,0,0
"Bulgaria","2024-10-05",0,0,1,0,0,2,0,0
"Bulgaria","2024-10-06",0,0,1,0,0,2,0,0
"Bulgaria","2024-10-07",0,0,1,0,0,2,0,0
"Bulgaria","2024-10-08",0,0,1,0,0,2,0,0
"Bulgaria","2024-10-09",0,0,1,0,0,2,0,0
"Bulgaria","2024-10-10",0,0,1,0,0,2,0,0
"Bulgaria","2024-10-11",0,0,1,0,0,2,0,0
"Bulgaria","2024-10-12",0,0,1,0,0,2,0,0
"Bulgaria","2024-10-13",0,0,1,0,0,2,0,0
"Bulgaria","2024-10-14",0,0,1,0,0,2,0,0
"Bulgaria","2024-10-15",0,0,1,0,0,2,0,0
"Bulgaria","2024-10-16",0,0,1,0,0,2,0,0
"Bulgaria","2024-10-17",0,0,1,0,0,2,0,0
"Bulgaria","2024-10-18",0,0,1,0,0,2,0,0
"Bulgaria","2024-10-19",0,0,1,0,0,2,0,0
"Bulgaria","2024-10-20",0,0,1,0,0,2,0,0
"Bulgaria","2024-10-21",0,0,1,0,0,2,0,0
"Bulgaria","2024-10-22",0,0,1,0,0,2,0,0
"Bulgaria","2024-10-23",0,0,1,0,0,2,0,0
"Bulgaria","2024-10-24",0,0,1,0,0,2,0,0
"Bulgaria","2024-10-25",0,0,1,0,0,2,0,0
"Bulgaria","2024-10-26",0,0,1,0,0,2,0,0
"Bulgaria","2024-10-27",0,0,1,0,0,2,0,0
"Bulgaria","2024-10-28",0,0,1,0,0,2,0,0
"Bulgaria","2024-10-29",0,0,1,0,0,2,0,0
"Bulgaria","2024-10-30",0,0,1,0,0,2,0,0
"Bulgaria","2024-10-31",0,0,1,0,0,2,0,0
"Bulgaria","2024-11-01",0,0,1,0,0,2,0,0
"Bulgaria","2024-11-02",0,0,1,0,0,2,0,0
"Bulgaria","2024-11-03",0,0,1,0,0,2,0,0
"Bulgaria","2024-11-04",0,0,1,0,0,2,0,0
"Bulgaria","2024-11-05",0,0,1,0,0,2,0,0
"Bulgaria","2024-11-06",0,0,1,0,0,2,0,0
"Bulgaria","2024-11-07",0,0,1,0,0,2,0,0
"Bulgaria","2024-11-08",0,0,1,0,0,2,0,0
"Bulgaria","2024-11-09",0,0,1,0,0,2,0,0
"Bulgaria","2024-11-10",0,0,1,0,0,2,0,0
"Bulgaria","2024-11-11",0,0,1,0,0,2,0,0
"Bulgaria","2024-11-12",0,0,1,0,0,2,0,0
"Bulgaria","2024-11-13",0,0,1,0,0,2,0,0
"Bulgaria","2024-11-14",0,0,1,0,0,2,0,0
"Bulgaria","2024-11-15",0,0,1,0,0,2,0,0
"Bulgaria","2024-11-16",0,0,1,0,0,2,0,0
"Bulgaria","2024-11-17",0,0,1,0,0,2,0,0
"Bulgaria","2024-11-18",0,0,1,0,0,2,0,0
"Bulgaria","2024-11-19",0,0,1,0,0,2,0,0
"Bulgaria","2024-11-20",0,0,1,0,0,2,0,0
"Bulgaria","2024-11-21",0,0,1,0,0,2,0,0
"Bulgaria","2024-11-22",0,0,1,0,0,2,0,0
"Bulgaria","2024-11-23",0,0,1,0,0,2,0,0
"Bulgaria","2024-11-24",0,0,1,0,0,2,0,0
"Bulgaria","2024-11-25",0,0,1,0,0,2,0,0
"Bulgaria","2024-11-26",0,0,1,0,0,2,0,0
"Bulgaria","2024-11-27",0,0,1,0,0,2,0,0
"Bulgaria","2024-11-28",0,0,1,0,0,2,0,0
"Bulgaria","2024-11-29",0,0,1,0,0,2,0,0
"Bulgaria","2024-11-30",0,1,2,0,0,2,0,0
"Bulgaria","2024-12-01",0,0,2,0,0,2,0,0
"Bulgaria","2024-12-02",0,0,2,0,0,2,0,0
"Bulgaria","2024-12-03",0,0,2,0,0,2,0,0
"Bulgaria","2024-12-04",0,0,2,0,0,2,0,0
"Bulgaria","2024-12-05",0,0,2,0,0,2,0,0
"Bulgaria","2024-12-06",0,0,2,0,0,2,0,0
"Bulgaria","2024-12-07",0,0,2,0,0,2,0,0
"Bulgaria","2024-12-08",0,0,2,0,0,2,0,0
"Bulgaria","2024-12-09",0,0,2,0,0,2,0,0
"Bulgaria","2024-12-10",0,0,2,0,0,2,0,0
"Bulgaria","2024-12-11",0,0,2,0,0,2,0,0
"Bulgaria","2024-12-12",0,0,2,0,0,2,0,0
"Bulgaria","2024-12-13",0,0,2,0,0,2,0,0
"Bulgaria","2024-12-14",0,0,2,0,0,2,0,0
"Bulgaria","2024-12-15",0,0,2,0,0,2,0,0
"Bulgaria","2024-12-16",0,0,2,0,0,2,0,0
"Bulgaria","2024-12-17",0,0,2,0,0,2,0,0
"Bulgaria","2024-12-18",0,0,2,0,0,2,0,0
"Bulgaria","2024-12-19",0,0,2,0,0,2,0,0
"Bulgaria","2024-12-20",0,0,2,0,0,2,0,0
"Bulgaria","2024-12-21",0,0,2,0,0,2,0,0
"Bulgaria","2024-12-22",0,0,2,0,0,2,0,0
"Bulgaria","2024-12-23",0,0,2,0,0,2,0,0
"Bulgaria","2024-12-24",0,0,2,0,0,2,0,0
"Bulgaria","2024-12-25",0,0,2,0,0,2,0,0
"Bulgaria","2024-12-26",0,0,2,0,0,2,0,0
"Bulgaria","2024-12-27",0,0,2,0,0,2,0,0
"Bulgaria","2024-12-28",0,0,2,0,0,2,0,0
"Bulgaria","2024-12-29",0,0,2,0,0,2,0,0
"Bulgaria","2024-12-30",0,0,2,0,0,2,0,0
"Bulgaria","2024-12-31",0,0,2,0,0,2,0,0
"Bulgaria","2025-01-01",0,0,2,0,0,2,0,0
"Bulgaria","2025-01-02",0,0,2,0,0,2,0,0
"Bulgaria","2025-01-03",0,0,2,0,0,2,0,0
"Bulgaria","2025-01-04",0,0,2,0,0,2,0,0
"Bulgaria","2025-01-05",0,0,2,0,0,2,0,0
"Bulgaria","2025-01-06",0,0,2,0,0,2,0,0
"Bulgaria","2025-01-07",0,0,2,0,0,2,0,0
"Bulgaria","2025-01-08",0,0,2,0,0,2,0,0
"Bulgaria","2025-01-09",0,0,2,0,0,2,0,0
"Bulgaria","2025-01-10",0,0,2,0,0,2,0,0
"Bulgaria","2025-01-11",0,0,2,0,0,2,0,0
"Bulgaria","2025-01-12",0,0,2,0,0,2,0,0
"Bulgaria","2025-01-13",0,0,2,0,0,2,0,0
"Burundi","2024-01-01",0,0,0,0,0,0,0,0
"Burundi","2024-01-02",0,0,0,0,0,0,0,0
"Burundi","2024-01-03",0,0,0,0,0,0,0,0
"Burundi","2024-01-04",0,0,0,0,0,0,0,0
"Burundi","2024-01-05",0,0,0,0,0,0,0,0
"Burundi","2024-01-06",0,0,0,0,0,0,0,0
"Burundi","2024-01-07",0,0,0,0,0,0,0,0
"Burundi","2024-01-08",0,0,0,0,0,0,0,0
"Burundi","2024-01-09",0,0,0,0,0,0,0,0
"Burundi","2024-01-10",0,0,0,0,0,0,0,0
"Burundi","2024-01-11",0,0,0,0,0,0,0,0
"Burundi","2024-01-12",0,0,0,0,0,0,0,0
"Burundi","2024-01-13",0,0,0,0,0,0,0,0
"Burundi","2024-01-14",0,0,0,0,0,0,0,0
"Burundi","2024-01-15",0,0,0,0,0,0,0,0
"Burundi","2024-01-16",0,0,0,0,0,0,0,0
"Burundi","2024-01-17",0,0,0,0,0,0,0,0
"Burundi","2024-01-18",0,0,0,0,0,0,0,0
"Burundi","2024-01-19",0,0,0,0,0,0,0,0
"Burundi","2024-01-20",0,0,0,0,0,0,0,0
"Burundi","2024-01-21",0,0,0,0,0,0,0,0
"Burundi","2024-01-22",0,0,0,0,0,0,0,0
"Burundi","2024-01-23",0,0,0,0,0,0,0,0
"Burundi","2024-01-24",0,0,0,0,0,0,0,0
"Burundi","2024-01-25",0,0,0,0,0,0,0,0
"Burundi","2024-01-26",0,0,0,0,0,0,0,0
"Burundi","2024-01-27",0,0,0,0,0,0,0,0
"Burundi","2024-01-28",0,0,0,0,0,0,0,0
"Burundi","2024-01-29",0,0,0,0,0,0,0,0
"Burundi","2024-01-30",0,0,0,0,0,0,0,0
"Burundi","2024-01-31",0,0,0,0,0,0,0,0
"Burundi","2024-02-01",0,0,0,0,0,0,0,0
"Burundi","2024-02-02",0,0,0,0,0,0,0,0
"Burundi","2024-02-03",0,0,0,0,0,0,0,0
"Burundi","2024-02-04",0,0,0,0,0,0,0,0
"Burundi","2024-02-05",0,0,0,0,0,0,0,0
"Burundi","2024-02-06",0,0,0,0,0,0,0,0
"Burundi","2024-02-07",0,0,0,0,0,0,0,0
"Burundi","2024-02-08",0,0,0,0,0,0,0,0
"Burundi","2024-02-09",0,0,0,0,0,0,0,0
"Burundi","2024-02-10",0,0,0,0,0,0,0,0
"Burundi","2024-02-11",0,0,0,0,0,0,0,0
"Burundi","2024-02-12",0,0,0,0,0,0,0,0
"Burundi","2024-02-13",0,0,0,0,0,0,0,0
"Burundi","2024-02-14",0,0,0,0,0,0,0,0
"Burundi","2024-02-15",0,0,0,0,0,0,0,0
"Burundi","2024-02-16",0,0,0,0,0,0,0,0
"Burundi","2024-02-17",0,0,0,0,0,0,0,0
"Burundi","2024-02-18",0,0,0,0,0,0,0,0
"Burundi","2024-02-19",0,0,0,0,0,0,0,0
"Burundi","2024-02-20",0,0,0,0,0,0,0,0
"Burundi","2024-02-21",0,0,0,0,0,0,0,0
"Burundi","2024-02-22",0,0,0,0,0,0,0,0
"Burundi","2024-02-23",0,0,0,0,0,0,0,0
"Burundi","2024-02-24",0,0,0,0,0,0,0,0
"Burundi","2024-02-25",0,0,0,0,0,0,0,0
"Burundi","2024-02-26",0,0,0,0,0,0,0,0
"Burundi","2024-02-27",0,0,0,0,0,0,0,0
"Burundi","2024-02-28",0,0,0,0,0,0,0,0
"Burundi","2024-02-29",0,0,0,0,0,0,0,0
"Burundi","2024-03-01",0,0,0,0,0,0,0,0
"Burundi","2024-03-02",0,0,0,0,0,0,0,0
"Burundi","2024-03-03",0,0,0,0,0,0,0,0
"Burundi","2024-03-04",0,0,0,0,0,0,0,0
"Burundi","2024-03-05",0,0,0,0,0,0,0,0
"Burundi","2024-03-06",0,0,0,0,0,0,0,0
"Burundi","2024-03-07",0,0,0,0,0,0,0,0
"Burundi","2024-03-08",0,0,0,0,0,0,0,0
"Burundi","2024-03-09",0,0,0,0,0,0,0,0
"Burundi","2024-03-10",0,0,0,0,0,0,0,0
"Burundi","2024-03-11",0,0,0,0,0,0,0,0
"Burundi","2024-03-12",0,0,0,0,0,0,0,0
"Burundi","2024-03-13",0,0,0,0,0,0,0,0
"Burundi","2024-03-14",0,0,0,0,0,0,0,0
"Burundi","2024-03-15",0,0,0,0,0,0,0,0
"Burundi","2024-03-16",0,0,0,0,0,0,0,0
"Burundi","2024-03-17",0,0,0,0,0,0,0,0
"Burundi","2024-03-18",0,0,0,0,0,0,0,0
"Burundi","2024-03-19",0,0,0,0,0,0,0,0
"Burundi","2024-03-20",0,0,0,0,0,0,0,0
"Burundi","2024-03-21",0,0,0,0,0,0,0,0
"Burundi","2024-03-22",0,0,0,0,0,0,0,0
"Burundi","2024-03-23",0,0,0,0,0,0,0,0
"Burundi","2024-03-24",0,0,0,0,0,0,0,0
"Burundi","2024-03-25",0,0,0,0,0,0,0,0
"Burundi","2024-03-26",0,0,0,0,0,0,0,0
"Burundi","2024-03-27",0,0,0,0,0,0,0,0
"Burundi","2024-03-28",0,0,0,0,0,0,0,0
"Burundi","2024-03-29",0,0,0,0,0,0,0,0
"Burundi","2024-03-30",0,0,0,0,0,0,0,0
"Burundi","2024-03-31",0,0,0,0,0,0,0,0
"Burundi","2024-04-01",0,0,0,0,0,0,0,0
"Burundi","2024-04-02",0,0,0,0,0,0,0,0
"Burundi","2024-04-03",0,0,0,0,0,0,0,0
"Burundi","2024-04-04",0,0,0,0,0,0,0,0
"Burundi","2024-04-05",0,0,0,0,0,0,0,0
"Burundi","2024-04-06",0,0,0,0,0,0,0,0
"Burundi","2024-04-07",0,0,0,0,0,0,0,0
"Burundi","2024-04-08",0,0,0,0,0,0,0,0
"Burundi","2024-04-09",0,0,0,0,0,0,0,0
"Burundi","2024-04-10",0,0,0,0,0,0,0,0
"Burundi","2024-04-11",0,0,0,0,0,0,0,0
"Burundi","2024-04-12",0,0,0,0,0,0,0,0
"Burundi","2024-04-13",0,0,0,0,0,0,0,0
"Burundi","2024-04-14",0,0,0,0,0,0,0,0
"Burundi","2024-04-15",0,0,0,0,0,0,0,0
"Burundi","2024-04-16",0,0,0,0,0,0,0,0
"Burundi","2024-04-17",0,0,0,0,0,0,0,0
"Burundi","2024-04-18",0,0,0,0,0,0,0,0
"Burundi","2024-04-19",0,0,0,0,0,0,0,0
"Burundi","2024-04-20",0,0,0,0,0,0,0,0
"Burundi","2024-04-21",0,0,0,0,0,0,0,0
"Burundi","2024-04-22",0,0,0,0,0,0,0,0
"Burundi","2024-04-23",0,0,0,0,0,0,0,0
"Burundi","2024-04-24",0,0,0,0,0,0,0,0
"Burundi","2024-04-25",0,0,0,0,0,0,0,0
"Burundi","2024-04-26",0,0,0,0,0,0,0,0
"Burundi","2024-04-27",0,0,0,0,0,0,0,0
"Burundi","2024-04-28",0,0,0,0,0,0,0,0
"Burundi","2024-04-29",0,0,0,0,0,0,0,0
"Burundi","2024-04-30",0,0,0,0,0,0,0,0
"Burundi","2024-05-01",0,0,0,0,0,0,0,0
"Burundi","2024-05-02",0,0,0,0,0,0,0,0
"Burundi","2024-05-03",0,0,0,0,0,0,0,0
"Burundi","2024-05-04",0,0,0,0,0,0,0,0
"Burundi","2024-05-05",0,0,0,0,0,0,0,0
"Burundi","2024-05-06",0,0,0,0,0,0,0,0
"Burundi","2024-05-07",0,0,0,0,0,0,0,0
"Burundi","2024-05-08",0,0,0,0,0,0,0,0
"Burundi","2024-05-09",0,0,0,0,0,0,0,0
"Burundi","2024-05-10",0,0,0,0,0,0,0,0
"Burundi","2024-05-11",0,0,0,0,0,0,0,0
"Burundi","2024-05-12",0,0,0,0,0,0,0,0
"Burundi","2024-05-13",0,0,0,0,0,0,0,0
"Burundi","2024-05-14",0,0,0,0,0,0,0,0
"Burundi","2024-05-15",0,0,0,0,0,0,0,0
"Burundi","2024-05-16",0,0,0,0,0,0,0,0
"Burundi","2024-05-17",0,0,0,0,0,0,0,0
"Burundi","2024-05-18",0,0,0,0,0,0,0,0
"Burundi","2024-05-19",0,0,0,0,0,0,0,0
"Burundi","2024-05-20",0,0,0,0,0,0,0,0
"Burundi","2024-05-21",0,0,0,0,0,0,0,0
"Burundi","2024-05-22",0,0,0,0,0,0,0,0
"Burundi","2024-05-23",0,0,0,0,0,0,0,0
"Burundi","2024-05-24",0,0,0,0,0,0,0,0
"Burundi","2024-05-25",0,0,0,0,0,0,0,0
"Burundi","2024-05-26",0,0,0,0,0,0,0,0
"Burundi","2024-05-27",0,0,0,0,0,0,0,0
"Burundi","2024-05-28",0,0,0,0,0,0,0,0
"Burundi","2024-05-29",0,0,0,0,0,0,0,0
"Burundi","2024-05-30",0,0,0,0,0,0,0,0
"Burundi","2024-05-31",0,0,0,0,0,0,0,0
"Burundi","2024-06-01",0,0,0,0,0,0,0,0
"Burundi","2024-06-02",0,0,0,0,0,0,0,0
"Burundi","2024-06-03",0,0,0,0,0,0,0,0
"Burundi","2024-06-04",0,0,0,0,0,0,0,0
"Burundi","2024-06-05",0,0,0,0,0,0,0,0
"Burundi","2024-06-06",0,0,0,0,0,0,0,0
"Burundi","2024-06-07",0,0,0,0,0,0,0,0
"Burundi","2024-06-08",0,0,0,0,0,0,0,0
"Burundi","2024-06-09",0,0,0,0,0,0,0,0
"Burundi","2024-06-10",0,0,0,0,0,0,0,0
"Burundi","2024-06-11",0,0,0,0,0,0,0,0
"Burundi","2024-06-12",0,0,0,0,0,0,0,0
"Burundi","2024-06-13",0,0,0,0,0,0,0,0
"Burundi","2024-06-14",0,0,0,0,0,0,0,0
"Burundi","2024-06-15",0,0,0,0,0,0,0,0
"Burundi","2024-06-16",0,0,0,0,0,0,0,0
"Burundi","2024-06-17",0,0,0,0,0,0,0,0
"Burundi","2024-06-18",0,0,0,0,0,0,0,0
"Burundi","2024-06-19",0,0,0,0,0,0,0,0
"Burundi","2024-06-20",0,0,0,0,0,0,0,0
"Burundi","2024-06-21",0,0,0,0,0,0,0,0
"Burundi","2024-06-22",0,0,0,0,0,0,0,0
"Burundi","2024-06-23",0,0,0,0,0,0,0,0
"Burundi","2024-06-24",0,0,0,0,0,0,0,0
"Burundi","2024-06-25",0,0,0,0,0,0,0,0
"Burundi","2024-06-26",0,0,0,0,0,0,0,0
"Burundi","2024-06-27",0,0,0,0,0,0,0,0
"Burundi","2024-06-28",0,0,0,0,0,0,0,0
"Burundi","2024-06-29",0,0,0,0,0,0,0,0
"Burundi","2024-06-30",0,0,0,0,0,0,0,0
"Burundi","2024-07-01",0,0,0,0,0,0,0,0
"Burundi","2024-07-02",0,0,0,0,0,0,0,0
"Burundi","2024-07-03",0,0,0,0,0,0,0,0
"Burundi","2024-07-04",0,0,0,0,0,0,0,0
"Burundi","2024-07-05",0,0,0,0,0,0,0,0
"Burundi","2024-07-06",0,0,0,0,0,0,0,0
"Burundi","2024-07-07",0,0,0,0,0,0,0,0
"Burundi","2024-07-08",0,0,0,0,0,0,0,0
"Burundi","2024-07-09",0,0,0,0,0,0,0,0
"Burundi","2024-07-10",0,0,0,0,0,0,0,0
"Burundi","2024-07-11",0,0,0,0,0,0,0,0
"Burundi","2024-07-12",0,0,0,0,0,0,0,0
"Burundi","2024-07-13",0,0,0,0,0,0,0,0
"Burundi","2024-07-14",0,0,0,0,0,0,0,0
"Burundi","2024-07-15",0,0,0,0,0,0,0,0
"Burundi","2024-07-16",0,0,0,0,0,0,0,0
"Burundi","2024-07-17",0,0,0,0,0,0,0,0
"Burundi","2024-07-18",0,0,0,0,0,0,0,0
"Burundi","2024-07-19",5,0,0,5,0,0,5,5
"Burundi","2024-07-20",0,0,0,5,0,0,3,8
"Burundi","2024-07-21",0,0,0,5,0,0,4,12
"Burundi","2024-07-22",0,0,0,5,0,0,3,15
"Burundi","2024-07-23",0,0,0,5,0,0,3,18
"Burundi","2024-07-24",0,0,0,5,0,0,3,21
"Burundi","2024-07-25",0,0,0,5,0,0,4,25
"Burundi","2024-07-26",0,0,0,5,0,0,3,28
"Burundi","2024-07-27",0,0,0,5,0,0,3,31
"Burundi","2024-07-28",0,9,9,5,9,9,3,34
"Burundi","2024-07-29",0,0,9,5,4,13,4,38
"Burundi","2024-07-30",0,0,9,5,5,18,3,41
"Burundi","2024-07-31",0,0,9,5,4,22,3,44
"Burundi","2024-08-01",0,0,9,5,5,27,3,47
"Burundi","2024-08-02",0,0,9,5,4,31,4,51
"Burundi","2024-08-03",49,0,9,54,5,36,3,54
"Burundi","2024-08-04",0,31,40,54,4,40,10,64
"Burundi","2024-08-05",0,0,40,54,6,46,10,74
"Burundi","2024-08-06",0,0,40,54,6,52,10,84
"Burundi","2024-08-07",0,0,40,54,6,58,10,94
"Burundi","2024-08-08",0,0,40,54,7,65,10,104
"Burundi","2024-08-09",60,0,40,114,6,71,10,114
"Burundi","2024-08-10",0,0,40,114,6,77,19,133
"Burundi","2024-08-11",0,43,83,114,6,83,19,152
"Burundi","2024-08-12",0,0,83,114,10,93,19,171
"Burundi","2024-08-13",0,0,83,114,10,103,20,191
"Burundi","2024-08-14",0,0,83,114,10,113,19,210
"Burundi","2024-08-15",0,0,83,114,10,123,19,229
"Burundi","2024-08-16",134,0,83,248,10,133,19,248
"Burundi","2024-08-17",0,0,83,248,10,143,24,272
"Burundi","2024-08-18",0,70,153,248,10,153,23,295
"Burundi","2024-08-19",0,0,153,248,11,164,24,319
"Burundi","2024-08-20",0,0,153,248,11,175,24,343
"Burundi","2024-08-21",0,0,153,248,11,186,23,366
"Burundi","2024-08-22",0,0,153,248,12,198,24,390
"Burundi","2024-08-23",0,0,153,248,11,209,24,414
"Burundi","2024-08-24",0,0,153,248,11,220,23,437
"Burundi","2024-08-25",213,78,231,461,11,231,24,461
"Burundi","2024-08-26",0,0,231,461,14,245,39,500
"Burundi","2024-08-27",0,0,231,461,14,259,40,540
"Burundi","2024-08-28",0,0,231,461,14,273,39,579
"Burundi","2024-08-29",0,0,231,461,13,286,39,618
"Burundi","2024-08-30",0,0,231,461,14,300,40,658
"Burundi","2024-08-31",236,0,231,697,14,314,39,697
"Burundi","2024-09-01",0,97,328,697,14,328,8,705
"Burundi","2024-09-02",0,0,328,697,8,336,8,713
"Burundi","2024-09-03",0,0,328,697,8,344,8,721
"Burundi","2024-09-04",0,0,328,697,8,352,8,729
"Burundi","2024-09-05",0,0,328,697,9,361,7,736
"Burundi","2024-09-06",0,0,328,697,8,369,8,744
"Burundi","2024-09-07",0,0,328,697,8,377,8,752
"Burundi","2024-09-08",63,57,385,760,8,385,8,760
"Burundi","2024-09-09",0,0,385,760,26,411,40,800
"Burundi","2024-09-10",0,0,385,760,25,436,40,840
"Burundi","2024-09-11",0,0,385,760,26,462,40,880
"Burundi","2024-09-12",0,0,385,760,25,487,40,920
"Burundi","2024-09-13",0,0,385,760,26,513,41,961
"Burundi","2024-09-14",0,0,385,760,25,538,40,1001
"Burundi","2024-09-15",0,179,564,760,26,564,40,1041
"Burundi","2024-09-16",321,0,564,1081,19,583,40,1081
"Burundi","2024-09-17",0,0,564,1081,19,602,37,1118
"Burundi","2024-09-18",0,0,564,1081,19,621,37,1155
"Burundi","2024-09-19",0,0,564,1081,18,639,37,1192
"Burundi","2024-09-20",0,0,564,1081,19,658,37,1229
"Burundi","2024-09-21",0,0,564,1081,19,677,37,1266
"Burundi","2024-09-22",0,132,696,1081,19,696,37,1303
"Burundi","2024-09-23",259,0,696,1340,22,718,37,1340
"Burundi","2024-09-24",0,0,696,1340,23,741,10,1350
"Burundi","2024-09-25",0,0,696,1340,22,763,10,1360
"Burundi","2024-09-26",0,0,696,1340,23,786,9,1369
"Burundi","2024-09-27",0,0,696,1340,22,808,10,1379
"Burundi","2024-09-28",0,0,696,1340,23,831,10,1389
"Burundi","2024-09-29",0,157,853,1340,22,853,10,1399
"Burundi","2024-09-30",0,0,853,1340,19,872,10,1409
"Burundi","2024-10-01",0,0,853,1340,19,891,9,1418
"Burundi","2024-10-02",0,0,853,1340,19,910,10,1428
"Burundi","2024-10-03",0,0,853,1340,20,930,10,1438
"Burundi","2024-10-04",0,0,853,1340,19,949,10,1448
"Burundi","2024-10-05",0,0,853,1340,19,968,9,1457
"Burundi","2024-10-06",0,134,987,1340,19,987,10,1467
"Burundi","2024-10-07",0,0,987,1340,26,1013,10,1477
"Burundi","2024-10-08",0,0,987,1340,26,1039,10,1487
"Burundi","2024-10-09",0,0,987,1340,26,1065,10,1497
"Burundi","2024-10-10",0,0,987,1340,27,1092,9,1506
"Burundi","2024-10-11",0,0,987,1340,26,1118,10,1516
"Burundi","2024-10-12",186,0,987,1526,26,1144,10,1526
"Burundi","2024-10-13",98,183,1170,1624,26,1170,98,1624
"Burundi","2024-10-14",0,0,1170,1624,17,1187,16,1640
"Burundi","2024-10-15",0,0,1170,1624,16,1203,17,1657
"Burundi","2024-10-16",0,0,1170,1624,17,1220,16,1673
"Burundi","2024-10-17",0,0,1170,1624,17,1237,17,1690
"Burundi","2024-10-18",0,0,1170,1624,17,1254,16,1706
"Burundi","2024-10-19",0,0,1170,1624,16,1270,17,1723
"Burundi","2024-10-20",115,117,1287,1739,17,1287,16,1739
"Burundi","2024-10-21",0,0,1287,1739,32,1319,16,1755
"Burundi","2024-10-22",0,0,1287,1739,31,1350,16,1771
"Burundi","2024-10-23",0,0,1287,1739,32,1382,16,1787
"Burundi","2024-10-24",0,0,1287,1739,32,1414,17,1804
"Burundi","2024-10-25",0,0,1287,1739,32,1446,16,1820
"Burundi","2024-10-26",0,0,1287,1739,31,1477,16,1836
"Burundi","2024-10-27",113,222,1509,1852,32,1509,16,1852
"Burundi","2024-10-28",0,0,1509,1852,31,1540,14,1866
"Burundi","2024-10-29",0,0,1509,1852,31,1571,15,1881
"Burundi","2024-10-30",0,0,1509,1852,31,1602,14,1895
"Burundi","2024-10-31",0,0,1509,1852,31,1633,15,1910
"Burundi","2024-11-01",0,0,1509,1852,31,1664,14,1924
"Burundi","2024-11-02",0,0,1509,1852,31,1695,15,1939
"Burundi","2024-11-03",101,217,1726,1953,31,1726,14,1953
"Burundi","2024-11-04",0,0,1726,1953,20,1746,11,1964
"Burundi","2024-11-05",0,0,1726,1953,19,1765,11,1975
"Burundi","2024-11-06",0,0,1726,1953,20,1785,10,1985
"Burundi","2024-11-07",0,0,1726,1953,19,1804,11,1996
"Burundi","2024-11-08",0,0,1726,1953,20,1824,11,2007
"Burundi","2024-11-09",0,0,1726,1953,19,1843,11,2018
"Burundi","2024-11-10",0,137,1863,1953,20,1863,11,2029
"Burundi","2024-11-11",0,0,1863,1953,27,1890,10,2039
"Burundi","2024-11-12",0,0,1863,1953,26,1916,11,2050
"Burundi","2024-11-13",108,0,1863,2061,27,1943,11,2061
"Burundi","2024-11-14",0,0,1863,2061,27,1970,0,2061
"Burundi","2024-11-15",0,0,1863,2061,27,1997,0,2061
"Burundi","2024-11-16",0,0,1863,2061,26,2023,0,2061
"Burundi","2024-11-17",0,187,2050,2061,27,2050,0,2061
"Burundi","2024-11-18",0,0,2050,2061,27,2077,0,2061
"Burundi","2024-11-19",0,0,2050,2061,26,2103,0,2061
"Burundi","2024-11-20",0,0,2050,2061,27,2130,0,2061
"Burundi","2024-11-21",0,0,2050,2061,27,2157,0,2061
"Burundi","2024-11-22",0,0,2050,2061,27,2184,0,2061
"Burundi","2024-11-23",0,0,2050,2061,26,2210,0,2061
"Burundi","2024-11-24",0,187,2237,2061,27,2237,0,2061
"Burundi","2024-11-25",0,0,2237,2061,32,2269,0,2061
"Burundi","2024-11-26",0,0,2237,2061,33,2302,0,2061
"Burundi","2024-11-27",0,97,2334,2061,32,2334,0,2061
"Burundi","2024-11-28",0,0,2334,2061,4,2338,0,2061
"Burundi","2024-11-29",0,0,2334,2061,4,2342,0,2061
"Burundi","2024-11-30",0,0,2334,2061,5,2347,0,2061
"Burundi","2024-12-01",0,17,2351,2061,4,2351,0,2061
"Burundi","2024-12-02",0,0,2351,2061,25,2376,0,2061
"Burundi","2024-12-03",0,0,2351,2061,24,2400,0,2061
"Burundi","2024-12-04",0,0,2351,2061,25,2425,0,2061
"Burundi","2024-12-05",0,0,2351,2061,24,2449,0,2061
"Burundi","2024-12-06",0,0,2351,2061,25,2474,0,2061
"Burundi","2024-12-07",0,0,2351,2061,24,2498,0,2061
"Burundi","2024-12-08",0,172,2523,2061,25,2523,0,2061
"Burundi","2024-12-09",0,0,2523,2061,32,2555,0,2061
"Burundi","2024-12-10",0,0,2523,2061,32,2587,0,2061
"Burundi","2024-12-11",0,0,2523,2061,31,2618,0,2061
"Burundi","2024-12-12",0,127,2650,2061,32,2650,0,2061
"Burundi","2024-12-13",0,0,2650,2061,0,2650,0,2061
"Burundi","2024-12-14",0,0,2650,2061,0,2650,0,2061
"Burundi","2024-12-15",0,0,2650,2061,0,2650,0,2061
"Burundi","2024-12-16",0,0,2650,2061,0,2650,0,2061
"Burundi","2024-12-17",0,0,2650,2061,0,2650,0,2061
"Burundi","2024-12-18",0,0,2650,2061,0,2650,0,2061
"Burundi","2024-12-19",0,0,2650,2061,0,2650,0,2061
"Burundi","2024-12-20",0,0,2650,2061,0,2650,0,2061
"Burundi","2024-12-21",0,0,2650,2061,0,2650,0,2061
"Burundi","2024-12-22",0,0,2650,2061,0,2650,0,2061
"Burundi","2024-12-23",0,0,2650,2061,0,2650,0,2061
"Burundi","2024-12-24",0,0,2650,2061,0,2650,0,2061
"Burundi","2024-12-25",0,0,2650,2061,0,2650,0,2061
"Burundi","2024-12-26",0,0,2650,2061,0,2650,0,2061
"Burundi","2024-12-27",0,0,2650,2061,0,2650,0,2061
"Burundi","2024-12-28",0,0,2650,2061,0,2650,0,2061
"Burundi","2024-12-29",0,0,2650,2061,0,2650,0,2061
"Burundi","2024-12-30",0,0,2650,2061,0,2650,0,2061
"Burundi","2024-12-31",0,0,2650,2061,0,2650,0,2061
"Burundi","2025-01-01",0,0,2650,2061,0,2650,0,2061
"Burundi","2025-01-02",0,0,2650,2061,0,2650,0,2061
"Burundi","2025-01-03",0,0,2650,2061,0,2650,0,2061
"Burundi","2025-01-04",0,0,2650,2061,0,2650,0,2061
"Burundi","2025-01-05",0,0,2650,2061,0,2650,0,2061
"Burundi","2025-01-06",0,0,2650,2061,0,2650,0,2061
"Burundi","2025-01-07",0,0,2650,2061,0,2650,0,2061
"Burundi","2025-01-08",0,0,2650,2061,0,2650,0,2061
"Burundi","2025-01-09",0,0,2650,2061,0,2650,0,2061
"Burundi","2025-01-10",0,0,2650,2061,0,2650,0,2061
"Burundi","2025-01-11",0,0,2650,2061,0,2650,0,2061
"Burundi","2025-01-12",0,0,2650,2061,0,2650,0,2061
"Burundi","2025-01-13",0,0,2650,2061,0,2650,0,2061
"Cambodia","2024-01-01",0,0,0,0,0,0,0,0
"Cambodia","2024-01-02",0,0,0,0,0,0,0,0
"Cambodia","2024-01-03",0,0,0,0,0,0,0,0
"Cambodia","2024-01-04",0,2,2,0,2,2,0,0
"Cambodia","2024-01-05",0,0,2,0,0,2,0,0
"Cambodia","2024-01-06",0,0,2,0,0,2,0,0
"Cambodia","2024-01-07",0,0,2,0,0,2,0,0
"Cambodia","2024-01-08",0,0,2,0,0,2,0,0
"Cambodia","2024-01-09",0,0,2,0,0,2,0,0
"Cambodia","2024-01-10",0,0,2,0,0,2,0,0
"Cambodia","2024-01-11",0,0,2,0,0,2,0,0
"Cambodia","2024-01-12",0,0,2,0,0,2,0,0
"Cambodia","2024-01-13",0,0,2,0,0,2,0,0
"Cambodia","2024-01-14",0,0,2,0,0,2,0,0
"Cambodia","2024-01-15",0,0,2,0,0,2,0,0
"Cambodia","2024-01-16",0,0,2,0,0,2,0,0
"Cambodia","2024-01-17",0,0,2,0,0,2,0,0
"Cambodia","2024-01-18",0,0,2,0,0,2,0,0
"Cambodia","2024-01-19",0,0,2,0,1,3,0,0
"Cambodia","2024-01-20",0,0,2,0,0,3,0,0
"Cambodia","2024-01-21",0,0,2,0,0,3,0,0
"Cambodia","2024-01-22",0,0,2,0,0,3,0,0
"Cambodia","2024-01-23",0,0,2,0,0,3,0,0
"Cambodia","2024-01-24",0,0,2,0,0,3,0,0
"Cambodia","2024-01-25",0,0,2,0,0,3,0,0
"Cambodia","2024-01-26",0,0,2,0,0,3,0,0
"Cambodia","2024-01-27",0,0,2,0,0,3,0,0
"Cambodia","2024-01-28",0,0,2,0,0,3,0,0
"Cambodia","2024-01-29",0,0,2,0,0,3,0,0
"Cambodia","2024-01-30",0,0,2,0,0,3,0,0
"Cambodia","2024-01-31",0,0,2,0,0,3,0,0
"Cambodia","2024-02-01",0,0,2,0,0,3,0,0
"Cambodia","2024-02-02",0,1,3,0,0,3,0,0
"Cambodia","2024-02-03",0,0,3,0,0,3,0,0
"Cambodia","2024-02-04",0,0,3,0,1,4,0,0
"Cambodia","2024-02-05",0,0,3,0,0,4,0,0
"Cambodia","2024-02-06",0,0,3,0,1,5,0,0
"Cambodia","2024-02-07",0,0,3,0,0,5,0,0
"Cambodia","2024-02-08",0,0,3,0,1,6,0,0
"Cambodia","2024-02-09",0,0,3,0,0,6,0,0
"Cambodia","2024-02-10",0,0,3,0,0,6,0,0
"Cambodia","2024-02-11",0,0,3,0,1,7,0,0
"Cambodia","2024-02-12",0,0,3,0,0,7,0,0
"Cambodia","2024-02-13",0,0,3,0,1,8,0,0
"Cambodia","2024-02-14",0,0,3,0,0,8,0,0
"Cambodia","2024-02-15",0,0,3,0,1,9,0,0
"Cambodia","2024-02-16",0,0,3,0,0,9,0,0
"Cambodia","2024-02-17",0,0,3,0,0,9,0,0
"Cambodia","2024-02-18",0,0,3,0,1,10,0,0
"Cambodia","2024-02-19",0,0,3,0,0,10,0,0
"Cambodia","2024-02-20",0,0,3,0,1,11,0,0
"Cambodia","2024-02-21",0,0,3,0,0,11,0,0
"Cambodia","2024-02-22",0,0,3,0,1,12,0,0
"Cambodia","2024-02-23",0,9,12,0,0,12,0,0
"Cambodia","2024-02-24",0,0,12,0,0,12,0,0
"Cambodia","2024-02-25",0,0,12,0,0,12,0,0
"Cambodia","2024-02-26",0,0,12,0,0,12,0,0
"Cambodia","2024-02-27",0,0,12,0,0,12,0,0
"Cambodia","2024-02-28",0,0,12,0,0,12,0,0
"Cambodia","2024-02-29",0,0,12,0,0,12,0,0
"Cambodia","2024-03-01",0,0,12,0,0,12,0,0
"Cambodia","2024-03-02",0,0,12,0,0,12,0,0
"Cambodia","2024-03-03",0,0,12,0,0,12,0,0
"Cambodia","2024-03-04",0,0,12,0,0,12,0,0
"Cambodia","2024-03-05",0,0,12,0,0,12,0,0
"Cambodia","2024-03-06",0,0,12,0,0,12,0,0
"Cambodia","2024-03-07",0,0,12,0,0,12,0,0
"Cambodia","2024-03-08",0,0,12,0,0,12,0,0
"Cambodia","2024-03-09",0,0,12,0,0,12,0,0
"Cambodia","2024-03-10",0,0,12,0,0,12,0,0
"Cambodia","2024-03-11",0,0,12,0,0,12,0,0
"Cambodia","2024-03-12",0,0,12,0,0,12,0,0
"Cambodia","2024-03-13",0,0,12,0,0,12,0,0
"Cambodia","2024-03-14",0,0,12,0,0,12,0,0
"Cambodia","2024-03-15",0,0,12,0,0,12,0,0
"Cambodia","2024-03-16",0,0,12,0,0,12,0,0
"Cambodia","2024-03-17",0,0,12,0,0,12,0,0
"Cambodia","2024-03-18",0,0,12,0,0,12,0,0
"Cambodia","2024-03-19",0,0,12,0,0,12,0,0
"Cambodia","2024-03-20",0,0,12,0,0,12,0,0
"Cambodia","2024-03-21",0,0,12,0,0,12,0,0
"Cambodia","2024-03-22",0,0,12,0,0,12,0,0
"Cambodia","2024-03-23",0,0,12,0,0,12,0,0
"Cambodia","2024-03-24",0,0,12,0,0,12,0,0
"Cambodia","2024-03-25",0,0,12,0,0,12,0,0
"Cambodia","2024-03-26",0,0,12,0,0,12,0,0
"Cambodia","2024-03-27",0,0,12,0,0,12,0,0
"Cambodia","2024-03-28",0,0,12,0,0,12,0,0
"Cambodia","2024-03-29",0,0,12,0,0,12,0,0
"Cambodia","2024-03-30",0,0,12,0,0,12,0,0
"Cambodia","2024-03-31",0,0,12,0,0,12,0,0
"Cambodia","2024-04-01",0,0,12,0,0,12,0,0
"Cambodia","2024-04-02",0,0,12,0,0,12,0,0
"Cambodia","2024-04-03",0,0,12,0,0,12,0,0
"Cambodia","2024-04-04",0,0,12,0,0,12,0,0
"Cambodia","2024-04-05",0,0,12,0,0,12,0,0
"Cambodia","2024-04-06",0,0,12,0,0,12,0,0
"Cambodia","2024-04-07",0,0,12,0,0,12,0,0
"Cambodia","2024-04-08",0,0,12,0,0,12,0,0
"Cambodia","2024-04-09",0,0,12,0,0,12,0,0
"Cambodia","2024-04-10",0,0,12,0,0,12,0,0
"Cambodia","2024-04-11",0,0,12,0,0,12,0,0
"Cambodia","2024-04-12",0,0,12,0,0,12,0,0
"Cambodia","2024-04-13",0,0,12,0,0,12,0,0
"Cambodia","2024-04-14",0,0,12,0,0,12,0,0
"Cambodia","2024-04-15",0,0,12,0,0,12,0,0
"Cambodia","2024-04-16",0,0,12,0,0,12,0,0
"Cambodia","2024-04-17",0,0,12,0,0,12,0,0
"Cambodia","2024-04-18",0,0,12,0,0,12,0,0
"Cambodia","2024-04-19",0,0,12,0,0,12,0,0
"Cambodia","2024-04-20",0,0,12,0,0,12,0,0
"Cambodia","2024-04-21",0,0,12,0,0,12,0,0
"Cambodia","2024-04-22",0,0,12,0,0,12,0,0
"Cambodia","2024-04-23",0,0,12,0,0,12,0,0
"Cambodia","2024-04-24",0,0,12,0,0,12,0,0
"Cambodia","2024-04-25",0,0,12,0,0,12,0,0
"Cambodia","2024-04-26",0,0,12,0,0,12,0,0
"Cambodia","2024-04-27",0,0,12,0,0,12,0,0
"Cambodia","2024-04-28",0,0,12,0,0,12,0,0
"Cambodia","2024-04-29",0,0,12,0,0,12,0,0
"Cambodia","2024-04-30",0,0,12,0,0,12,0,0
"Cambodia","2024-05-01",0,0,12,0,0,12,0,0
"Cambodia","2024-05-02",0,0,12,0,0,12,0,0
"Cambodia","2024-05-03",0,0,12,0,0,12,0,0
"Cambodia","2024-05-04",0,0,12,0,0,12,0,0
"Cambodia","2024-05-05",0,0,12,0,0,12,0,0
"Cambodia","2024-05-06",0,0,12,0,0,12,0,0
"Cambodia","2024-05-07",0,0,12,0,0,12,0,0
"Cambodia","2024-05-08",0,0,12,0,0,12,0,0
"Cambodia","2024-05-09",0,0,12,0,0,12,0,0
"Cambodia","2024-05-10",0,0,12,0,0,12,0,0
"Cambodia","2024-05-11",0,0,12,0,0,12,0,0
"Cambodia","2024-05-12",0,0,12,0,0,12,0,0
"Cambodia","2024-05-13",0,0,12,0,0,12,0,0
"Cambodia","2024-05-14",0,0,12,0,0,12,0,0
"Cambodia","2024-05-15",0,0,12,0,0,12,0,0
"Cambodia","2024-05-16",0,0,12,0,0,12,0,0
"Cambodia","2024-05-17",0,0,12,0,0,12,0,0
"Cambodia","2024-05-18",0,0,12,0,0,12,0,0
"Cambodia","2024-05-19",0,0,12,0,0,12,0,0
"Cambodia","2024-05-20",0,0,12,0,0,12,0,0
"Cambodia","2024-05-21",0,0,12,0,0,12,0,0
"Cambodia","2024-05-22",0,0,12,0,0,12,0,0
"Cambodia","2024-05-23",0,0,12,0,0,12,0,0
"Cambodia","2024-05-24",0,0,12,0,0,12,0,0
"Cambodia","2024-05-25",0,0,12,0,0,12,0,0
"Cambodia","2024-05-26",0,0,12,0,0,12,0,0
"Cambodia","2024-05-27",0,0,12,0,0,12,0,0
"Cambodia","2024-05-28",0,0,12,0,0,12,0,0
"Cambodia","2024-05-29",0,0,12,0,0,12,0,0
"Cambodia","2024-05-30",0,0,12,0,0,12,0,0
"Cambodia","2024-05-31",0,0,12,0,0,12,0,0
"Cambodia","2024-06-01",0,0,12,0,0,12,0,0
"Cambodia","2024-06-02",0,0,12,0,0,12,0,0
"Cambodia","2024-06-03",0,0,12,0,0,12,0,0
"Cambodia","2024-06-04",0,0,12,0,0,12,0,0
"Cambodia","2024-06-05",0,0,12,0,0,12,0,0
"Cambodia","2024-06-06",0,0,12,0,0,12,0,0
"Cambodia","2024-06-07",0,0,12,0,0,12,0,0
"Cambodia","2024-06-08",0,0,12,0,0,12,0,0
"Cambodia","2024-06-09",0,0,12,0,0,12,0,0
"Cambodia","2024-06-10",0,0,12,0,0,12,0,0
"Cambodia","2024-06-11",0,0,12,0,0,12,0,0
"Cambodia","2024-06-12",0,0,12,0,0,12,0,0
"Cambodia","2024-06-13",0,0,12,0,0,12,0,0
"Cambodia","2024-06-14",0,0,12,0,0,12,0,0
"Cambodia","2024-06-15",0,0,12,0,0,12,0,0
"Cambodia","2024-06-16",0,0,12,0,0,12,0,0
"Cambodia","2024-06-17",0,0,12,0,0,12,0,0
"Cambodia","2024-06-18",0,0,12,0,0,12,0,0
"Cambodia","2024-06-19",0,0,12,0,0,12,0,0
"Cambodia","2024-06-20",0,0,12,0,0,12,0,0
"Cambodia","2024-06-21",0,0,12,0,0,12,0,0
"Cambodia","2024-06-22",0,0,12,0,0,12,0,0
"Cambodia","2024-06-23",0,0,12,0,0,12,0,0
"Cambodia","2024-06-24",0,0,12,0,0,12,0,0
"Cambodia","2024-06-25",0,0,12,0,0,12,0,0
"Cambodia","2024-06-26",0,0,12,0,0,12,0,0
"Cambodia","2024-06-27",0,0,12,0,0,12,0,0
"Cambodia","2024-06-28",0,0,12,0,0,12,0,0
"Cambodia","2024-06-29",0,0,12,0,0,12,0,0
"Cambodia","2024-06-30",0,0,12,0,0,12,0,0
"Cambodia","2024-07-01",0,0,12,0,0,12,0,0
"Cambodia","2024-07-02",0,0,12,0,0,12,0,0
"Cambodia","2024-07-03",0,0,12,0,0,12,0,0
"Cambodia","2024-07-04",0,0,12,0,0,12,0,0
"Cambodia","2024-07-05",0,0,12,0,0,12,0,0
"Cambodia","2024-07-06",0,0,12,0,0,12,0,0
"Cambodia","2024-07-07",0,0,12,0,0,12,0,0
"Cambodia","2024-07-08",0,0,12,0,0,12,0,0
"Cambodia","2024-07-09",0,0,12,0,0,12,0,0
"Cambodia","2024-07-10",0,0,12,0,0,12,0,0
"Cambodia","2024-07-11",0,0,12,0,0,12,0,0
"Cambodia","2024-07-12",0,0,12,0,0,12,0,0
"Cambodia","2024-07-13",0,0,12,0,0,12,0,0
"Cambodia","2024-07-14",0,0,12,0,0,12,0,0
"Cambodia","2024-07-15",0,0,12,0,0,12,0,0
"Cambodia","2024-07-16",0,0,12,0,0,12,0,0
"Cambodia","2024-07-17",0,0,12,0,0,12,0,0
"Cambodia","2024-07-18",0,0,12,0,0,12,0,0
"Cambodia","2024-07-19",0,0,12,0,0,12,0,0
"Cambodia","2024-07-20",0,0,12,0,0,12,0,0
"Cambodia","2024-07-21",0,0,12,0,0,12,0,0
"Cambodia","2024-07-22",0,0,12,0,0,12,0,0
"Cambodia","2024-07-23",0,0,12,0,0,12,0,0
"Cambodia","2024-07-24",0,0,12,0,0,12,0,0
"Cambodia","2024-07-25",0,0,12,0,0,12,0,0
"Cambodia","2024-07-26",0,0,12,0,0,12,0,0
"Cambodia","2024-07-27",0,0,12,0,0,12,0,0
"Cambodia","2024-07-28",0,0,12,0,0,12,0,0
"Cambodia","2024-07-29",0,0,12,0,0,12,0,0
"Cambodia","2024-07-30",0,0,12,0,0,12,0,0
"Cambodia","2024-07-31",0,0,12,0,0,12,0,0
"Cambodia","2024-08-01",0,0,12,0,0,12,0,0
"Cambodia","2024-08-02",0,0,12,0,0,12,0,0
"Cambodia","2024-08-03",0,0,12,0,0,12,0,0
"Cambodia","2024-08-04",0,0,12,0,0,12,0,0
"Cambodia","2024-08-05",0,0,12,0,0,12,0,0
"Cambodia","2024-08-06",0,0,12,0,0,12,0,0
"Cambodia","2024-08-07",0,0,12,0,0,12,0,0
"Cambodia","2024-08-08",0,0,12,0,0,12,0,0
"Cambodia","2024-08-09",0,0,12,0,0,12,0,0
"Cambodia","2024-08-10",0,0,12,0,0,12,0,0
"Cambodia","2024-08-11",0,0,12,0,0,12,0,0
"Cambodia","2024-08-12",0,0,12,0,0,12,0,0
"Cambodia","2024-08-13",0,0,12,0,0,12,0,0
"Cambodia","2024-08-14",0,0,12,0,0,12,0,0
"Cambodia","2024-08-15",0,0,12,0,0,12,0,0
"Cambodia","2024-08-16",0,0,12,0,0,12,0,0
"Cambodia","2024-08-17",0,0,12,0,0,12,0,0
"Cambodia","2024-08-18",0,0,12,0,0,12,0,0
"Cambodia","2024-08-19",0,0,12,0,0,12,0,0
"Cambodia","2024-08-20",0,0,12,0,0,12,0,0
"Cambodia","2024-08-21",0,0,12,0,0,12,0,0
"Cambodia","2024-08-22",0,0,12,0,0,12,0,0
"Cambodia","2024-08-23",0,0,12,0,0,12,0,0
"Cambodia","2024-08-24",0,0,12,0,0,12,0,0
"Cambodia","2024-08-25",0,0,12,0,0,12,0,0
"Cambodia","2024-08-26",0,0,12,0,0,12,0,0
"Cambodia","2024-08-27",0,0,12,0,0,12,0,0
"Cambodia","2024-08-28",0,0,12,0,0,12,0,0
"Cambodia","2024-08-29",0,0,12,0,0,12,0,0
"Cambodia","2024-08-30",0,0,12,0,0,12,0,0
"Cambodia","2024-08-31",0,0,12,0,0,12,0,0
"Cambodia","2024-09-01",0,0,12,0,0,12,0,0
"Cambodia","2024-09-02",0,0,12,0,0,12,0,0
"Cambodia","2024-09-03",0,0,12,0,0,12,0,0
"Cambodia","2024-09-04",0,0,12,0,0,12,0,0
"Cambodia","2024-09-05",0,0,12,0,0,12,0,0
"Cambodia","2024-09-06",0,0,12,0,0,12,0,0
"Cambodia","2024-09-07",0,0,12,0,0,12,0,0
"Cambodia","2024-09-08",0,0,12,0,0,12,0,0
"Cambodia","2024-09-09",0,0,12,0,0,12,0,0
"Cambodia","2024-09-10",0,0,12,0,0,12,0,0
"Cambodia","2024-09-11",0,0,12,0,0,12,0,0
"Cambodia","2024-09-12",0,0,12,0,0,12,0,0
"Cambodia","2024-09-13",0,0,12,0,0,12,0,0
"Cambodia","2024-09-14",0,0,12,0,0,12,0,0
"Cambodia","2024-09-15",0,0,12,0,0,12,0,0
"Cambodia","2024-09-16",0,0,12,0,0,12,0,0
"Cambodia","2024-09-17",0,0,12,0,0,12,0,0
"Cambodia","2024-09-18",0,0,12,0,0,12,0,0
"Cambodia","2024-09-19",0,0,12,0,0,12,0,0
"Cambodia","2024-09-20",0,0,12,0,0,12,0,0
"Cambodia","2024-09-21",0,0,12,0,0,12,0,0
"Cambodia","2024-09-22",0,0,12,0,0,12,0,0
"Cambodia","2024-09-23",0,0,12,0,0,12,0,0
"Cambodia","2024-09-24",0,0,12,0,0,12,0,0
"Cambodia","2024-09-25",0,0,12,0,0,12,0,0
"Cambodia","2024-09-26",0,0,12,0,0,12,0,0
"Cambodia","2024-09-27",0,0,12,0,0,12,0,0
"Cambodia","2024-09-28",0,0,12,0,0,12,0,0
"Cambodia","2024-09-29",0,0,12,0,0,12,0,0
"Cambodia","2024-09-30",0,0,12,0,0,12,0,0
"Cambodia","2024-10-01",0,0,12,0,0,12,0,0
"Cambodia","2024-10-02",0,0,12,0,0,12,0,0
"Cambodia","2024-10-03",0,0,12,0,0,12,0,0
"Cambodia","2024-10-04",0,0,12,0,0,12,0,0
"Cambodia","2024-10-05",0,0,12,0,0,12,0,0
"Cambodia","2024-10-06",0,0,12,0,0,12,0,0
"Cambodia","2024-10-07",0,0,12,0,0,12,0,0
"Cambodia","2024-10-08",0,0,12,0,0,12,0,0
"Cambodia","2024-10-09",0,0,12,0,0,12,0,0
"Cambodia","2024-10-10",0,0,12,0,0,12,0,0
"Cambodia","2024-10-11",0,0,12,0,0,12,0,0
"Cambodia","2024-10-12",0,0,12,0,0,12,0,0
"Cambodia","2024-10-13",0,0,12,0,0,12,0,0
"Cambodia","2024-10-14",0,0,12,0,0,12,0,0
"Cambodia","2024-10-15",0,0,12,0,0,12,0,0
"Cambodia","2024-10-16",0,0,12,0,0,12,0,0
"Cambodia","2024-10-17",0,0,12,0,0,12,0,0
"Cambodia","2024-10-18",0,0,12,0,0,12,0,0
"Cambodia","2024-10-19",0,0,12,0,0,12,0,0
"Cambodia","2024-10-20",0,0,12,0,0,12,0,0
"Cambodia","2024-10-21",0,0,12,0,0,12,0,0
"Cambodia","2024-10-22",0,0,12,0,0,12,0,0
"Cambodia","2024-10-23",0,0,12,0,0,12,0,0
"Cambodia","2024-10-24",0,0,12,0,0,12,0,0
"Cambodia","2024-10-25",0,0,12,0,0,12,0,0
"Cambodia","2024-10-26",0,0,12,0,0,12,0,0
"Cambodia","2024-10-27",0,0,12,0,0,12,0,0
"Cambodia","2024-10-28",0,0,12,0,0,12,0,0
"Cambodia","2024-10-29",0,0,12,0,0,12,0,0
"Cambodia","2024-10-30",0,0,12,0,0,12,0,0
"Cambodia","2024-10-31",0,0,12,0,0,12,0,0
"Cambodia","2024-11-01",0,0,12,0,0,12,0,0
"Cambodia","2024-11-02",0,0,12,0,0,12,0,0
"Cambodia","2024-11-03",0,0,12,0,0,12,0,0
"Cambodia","2024-11-04",0,0,12,0,0,12,0,0
"Cambodia","2024-11-05",0,0,12,0,0,12,0,0
"Cambodia","2024-11-06",0,0,12,0,0,12,0,0
"Cambodia","2024-11-07",0,0,12,0,0,12,0,0
"Cambodia","2024-11-08",0,0,12,0,0,12,0,0
"Cambodia","2024-11-09",0,0,12,0,0,12,0,0
"Cambodia","2024-11-10",0,0,12,0,0,12,0,0
"Cambodia","2024-11-11",0,0,12,0,0,12,0,0
"Cambodia","2024-11-12",0,0,12,0,0,12,0,0
"Cambodia","2024-11-13",0,0,12,0,0,12,0,0
"Cambodia","2024-11-14",0,0,12,0,0,12,0,0
"Cambodia","2024-11-15",0,0,12,0,0,12,0,0
"Cambodia","2024-11-16",0,0,12,0,0,12,0,0
"Cambodia","2024-11-17",0,0,12,0,0,12,0,0
"Cambodia","2024-11-18",0,0,12,0,0,12,0,0
"Cambodia","2024-11-19",0,0,12,0,0,12,0,0
"Cambodia","2024-11-20",0,0,12,0,0,12,0,0
"Cambodia","2024-11-21",0,0,12,0,0,12,0,0
"Cambodia","2024-11-22",0,0,12,0,0,12,0,0
"Cambodia","2024-11-23",0,0,12,0,0,12,0,0
"Cambodia","2024-11-24",0,0,12,0,0,12,0,0
"Cambodia","2024-11-25",0,0,12,0,0,12,0,0
"Cambodia","2024-11-26",0,0,12,0,0,12,0,0
"Cambodia","2024-11-27",0,0,12,0,0,12,0,0
"Cambodia","2024-11-28",0,0,12,0,0,12,0,0
"Cambodia","2024-11-29",0,0,12,0,0,12,0,0
"Cambodia","2024-11-30",0,0,12,0,0,12,0,0
"Cambodia","2024-12-01",0,0,12,0,0,12,0,0
"Cambodia","2024-12-02",0,0,12,0,0,12,0,0
"Cambodia","2024-12-03",0,0,12,0,0,12,0,0
"Cambodia","2024-12-04",0,0,12,0,0,12,0,0
"Cambodia","2024-12-05",0,0,12,0,0,12,0,0
"Cambodia","2024-12-06",0,0,12,0,0,12,0,0
"Cambodia","2024-12-07",0,0,12,0,0,12,0,0
"Cambodia","2024-12-08",0,0,12,0,0,12,0,0
"Cambodia","2024-12-09",0,0,12,0,0,12,0,0
"Cambodia","2024-12-10",0,0,12,0,0,12,0,0
"Cambodia","2024-12-11",0,0,12,0,0,12,0,0
"Cambodia","2024-12-12",0,0,12,0,0,12,0,0
"Cambodia","2024-12-13",0,0,12,0,0,12,0,0
"Cambodia","2024-12-14",0,0,12,0,0,12,0,0
"Cambodia","2024-12-15",0,0,12,0,0,12,0,0
"Cambodia","2024-12-16",0,0,12,0,0,12,0,0
"Cambodia","2024-12-17",0,0,12,0,0,12,0,0
"Cambodia","2024-12-18",0,0,12,0,0,12,0,0
"Cambodia","2024-12-19",0,0,12,0,0,12,0,0
"Cambodia","2024-12-20",0,0,12,0,0,12,0,0
"Cambodia","2024-12-21",0,0,12,0,0,12,0,0
"Cambodia","2024-12-22",0,0,12,0,0,12,0,0
"Cambodia","2024-12-23",0,0,12,0,0,12,0,0
"Cambodia","2024-12-24",0,0,12,0,0,12,0,0
"Cambodia","2024-12-25",0,0,12,0,0,12,0,0
"Cambodia","2024-12-26",0,0,12,0,0,12,0,0
"Cambodia","2024-12-27",0,0,12,0,0,12,0,0
"Cambodia","2024-12-28",0,0,12,0,0,12,0,0
"Cambodia","2024-12-29",0,0,12,0,0,12,0,0
"Cambodia","2024-12-30",0,0,12,0,0,12,0,0
"Cambodia","2024-12-31",0,0,12,0,0,12,0,0
"Cambodia","2025-01-01",0,0,12,0,0,12,0,0
"Cambodia","2025-01-02",0,0,12,0,0,12,0,0
"Cambodia","2025-01-03",0,0,12,0,0,12,0,0
"Cambodia","2025-01-04",0,0,12,0,0,12,0,0
"Cambodia","2025-01-05",0,0,12,0,0,12,0,0
"Cambodia","2025-01-06",0,0,12,0,0,12,0,0
"Cambodia","2025-01-07",0,0,12,0,0,12,0,0
"Cambodia","2025-01-08",0,0,12,0,0,12,0,0
"Cambodia","2025-01-09",0,0,12,0,0,12,0,0
"Cambodia","2025-01-10",0,0,12,0,0,12,0,0
"Cambodia","2025-01-11",0,0,12,0,0,12,0,0
"Cambodia","2025-01-12",0,0,12,0,0,12,0,0
"Cambodia","2025-01-13",0,0,12,0,0,12,0,0
"Cameroon","2024-01-01",0,0,0,0,0,0,0,0
"Cameroon","2024-01-02",0,0,0,0,0,0,0,0
"Cameroon","2024-01-03",0,0,0,0,0,0,0,0
"Cameroon","2024-01-04",0,0,0,0,0,0,0,0
"Cameroon","2024-01-05",0,0,0,0,0,0,0,0
"Cameroon","2024-01-06",0,0,0,0,0,0,0,0
"Cameroon","2024-01-07",0,0,0,0,0,0,0,0
"Cameroon","2024-01-08",0,0,0,0,0,0,0,0
"Cameroon","2024-01-09",0,0,0,0,0,0,0,0
"Cameroon","2024-01-10",0,0,0,0,0,0,0,0
"Cameroon","2024-01-11",0,0,0,0,0,0,0,0
"Cameroon","2024-01-12",0,0,0,0,0,0,0,0
"Cameroon","2024-01-13",0,0,0,0,0,0,0,0
"Cameroon","2024-01-14",0,2,2,0,2,2,0,0
"Cameroon","2024-01-15",0,0,2,0,0,2,0,0
"Cameroon","2024-01-16",0,0,2,0,0,2,0,0
"Cameroon","2024-01-17",0,0,2,0,0,2,0,0
"Cameroon","2024-01-18",0,0,2,0,0,2,0,0
"Cameroon","2024-01-19",0,0,2,0,0,2,0,0
"Cameroon","2024-01-20",0,0,2,0,0,2,0,0
"Cameroon","2024-01-21",0,0,2,0,0,2,0,0
"Cameroon","2024-01-22",0,0,2,0,0,2,0,0
"Cameroon","2024-01-23",0,0,2,0,0,2,0,0
"Cameroon","2024-01-24",0,0,2,0,0,2,0,0
"Cameroon","2024-01-25",0,0,2,0,0,2,0,0
"Cameroon","2024-01-26",0,0,2,0,0,2,0,0
"Cameroon","2024-01-27",0,0,2,0,0,2,0,0
"Cameroon","2024-01-28",0,0,2,0,0,2,0,0
"Cameroon","2024-01-29",0,0,2,0,0,2,0,0
"Cameroon","2024-01-30",0,0,2,0,0,2,0,0
"Cameroon","2024-01-31",0,0,2,0,0,2,0,0
"Cameroon","2024-02-01",0,0,2,0,0,2,0,0
"Cameroon","2024-02-02",0,0,2,0,0,2,0,0
"Cameroon","2024-02-03",0,0,2,0,0,2,0,0
"Cameroon","2024-02-04",0,0,2,0,0,2,0,0
"Cameroon","2024-02-05",0,0,2,0,0,2,0,0
"Cameroon","2024-02-06",0,0,2,0,0,2,0,0
"Cameroon","2024-02-07",0,0,2,0,0,2,0,0
"Cameroon","2024-02-08",0,0,2,0,0,2,0,0
"Cameroon","2024-02-09",0,0,2,0,0,2,0,0
"Cameroon","2024-02-10",0,0,2,0,0,2,0,0
"Cameroon","2024-02-11",0,0,2,0,0,2,0,0
"Cameroon","2024-02-12",0,0,2,0,0,2,0,0
"Cameroon","2024-02-13",0,0,2,0,0,2,0,0
"Cameroon","2024-02-14",0,0,2,0,0,2,0,0
"Cameroon","2024-02-15",0,0,2,0,0,2,0,0
"Cameroon","2024-02-16",0,0,2,0,0,2,0,0
"Cameroon","2024-02-17",0,0,2,0,0,2,0,0
"Cameroon","2024-02-18",0,0,2,0,0,2,0,0
"Cameroon","2024-02-19",0,0,2,0,0,2,0,0
"Cameroon","2024-02-20",0,0,2,0,0,2,0,0
"Cameroon","2024-02-21",0,0,2,0,0,2,0,0
"Cameroon","2024-02-22",0,0,2,0,0,2,0,0
"Cameroon","2024-02-23",0,0,2,0,0,2,0,0
"Cameroon","2024-02-24",0,0,2,0,0,2,0,0
"Cameroon","2024-02-25",0,0,2,0,0,2,0,0
"Cameroon","2024-02-26",0,0,2,0,1,3,0,0
"Cameroon","2024-02-27",0,0,2,0,0,3,0,0
"Cameroon","2024-02-28",0,0,2,0,0,3,0,0
"Cameroon","2024-02-29",0,0,2,0,0,3,0,0
"Cameroon","2024-03-01",0,0,2,0,0,3,0,0
"Cameroon","2024-03-02",0,0,2,0,0,3,0,0
"Cameroon","2024-03-03",0,0,2,0,0,3,0,0
"Cameroon","2024-03-04",0,0,2,0,0,3,0,0
"Cameroon","2024-03-05",0,0,2,0,0,3,0,0
"Cameroon","2024-03-06",0,0,2,0,0,3,0,0
"Cameroon","2024-03-07",0,0,2,0,0,3,0,0
"Cameroon","2024-03-08",0,0,2,0,0,3,0,0
"Cameroon","2024-03-09",0,0,2,0,0,3,0,0
"Cameroon","2024-03-10",0,0,2,0,0,3,0,0
"Cameroon","2024-03-11",0,0,2,0,0,3,0,0
"Cameroon","2024-03-12",0,0,2,0,0,3,0,0
"Cameroon","2024-03-13",0,0,2,0,0,3,0,0
"Cameroon","2024-03-14",0,0,2,0,0,3,0,0
"Cameroon","2024-03-15",0,0,2,0,0,3,0,0
"Cameroon","2024-03-16",0,0,2,0,0,3,0,0
"Cameroon","2024-03-17",0,0,2,0,0,3,0,0
"Cameroon","2024-03-18",0,0,2,0,0,3,0,0
"Cameroon","2024-03-19",0,0,2,0,0,3,0,0
"Cameroon","2024-03-20",0,0,2,0,0,3,0,0
"Cameroon","2024-03-21",0,0,2,0,0,3,0,0
"Cameroon","2024-03-22",0,0,2,0,0,3,0,0
"Cameroon","2024-03-23",0,0,2,0,0,3,0,0
"Cameroon","2024-03-24",0,0,2,0,0,3,0,0
"Cameroon","2024-03-25",0,0,2,0,0,3,0,0
"Cameroon","2024-03-26",0,0,2,0,0,3,0,0
"Cameroon","2024-03-27",0,0,2,0,0,3,0,0
"Cameroon","2024-03-28",0,0,2,0,0,3,0,0
"Cameroon","2024-03-29",0,0,2,0,0,3,0,0
"Cameroon","2024-03-30",0,0,2,0,0,3,0,0
"Cameroon","2024-03-31",0,0,2,0,0,3,0,0
"Cameroon","2024-04-01",0,0,2,0,0,3,0,0
"Cameroon","2024-04-02",0,0,2,0,0,3,0,0
"Cameroon","2024-04-03",0,0,2,0,0,3,0,0
"Cameroon","2024-04-04",0,0,2,0,0,3,0,0
"Cameroon","2024-04-05",0,0,2,0,0,3,0,0
"Cameroon","2024-04-06",0,0,2,0,0,3,0,0
"Cameroon","2024-04-07",0,1,3,0,0,3,0,0
"Cameroon","2024-04-08",0,0,3,0,0,3,0,0
"Cameroon","2024-04-09",0,0,3,0,1,4,0,0
"Cameroon","2024-04-10",0,0,3,0,0,4,0,0
"Cameroon","2024-04-11",0,0,3,0,0,4,0,0
"Cameroon","2024-04-12",0,0,3,0,0,4,0,0
"Cameroon","2024-04-13",0,0,3,0,1,5,0,0
"Cameroon","2024-04-14",0,2,5,0,0,5,0,0
"Cameroon","2024-04-15",0,0,5,0,0,5,0,0
"Cameroon","2024-04-16",0,0,5,0,0,5,0,0
"Cameroon","2024-04-17",0,0,5,0,0,5,0,0
"Cameroon","2024-04-18",0,0,5,0,0,5,0,0
"Cameroon","2024-04-19",0,0,5,0,0,5,0,0
"Cameroon","2024-04-20",0,0,5,0,0,5,0,0
"Cameroon","2024-04-21",0,0,5,0,0,5,0,0
"Cameroon","2024-04-22",0,0,5,0,0,5,0,0
"Cameroon","2024-04-23",0,0,5,0,0,5,0,0
"Cameroon","2024-04-24",0,0,5,0,0,5,0,0
"Cameroon","2024-04-25",0,0,5,0,0,5,0,0
"Cameroon","2024-04-26",0,0,5,0,0,5,0,0
"Cameroon","2024-04-27",0,0,5,0,0,5,0,0
"Cameroon","2024-04-28",0,0,5,0,0,5,0,0
"Cameroon","2024-04-29",0,0,5,0,0,5,0,0
"Cameroon","2024-04-30",0,0,5,0,0,5,0,0
"Cameroon","2024-05-01",0,0,5,0,0,5,0,0
"Cameroon","2024-05-02",0,0,5,0,0,5,0,0
"Cameroon","2024-05-03",0,0,5,0,0,5,0,0
"Cameroon","2024-05-04",0,0,5,0,0,5,0,0
"Cameroon","2024-05-05",0,0,5,0,0,5,0,0
"Cameroon","2024-05-06",0,0,5,0,0,5,0,0
"Cameroon","2024-05-07",0,0,5,0,0,5,0,0
"Cameroon","2024-05-08",0,0,5,0,0,5,0,0
"Cameroon","2024-05-09",0,0,5,0,0,5,0,0
"Cameroon","2024-05-10",0,0,5,0,0,5,0,0
"Cameroon","2024-05-11",0,0,5,0,0,5,0,0
"Cameroon","2024-05-12",0,0,5,0,0,5,0,0
"Cameroon","2024-05-13",0,0,5,0,0,5,0,0
"Cameroon","2024-05-14",0,0,5,0,0,5,0,0
"Cameroon","2024-05-15",0,0,5,0,0,5,0,0
"Cameroon","2024-05-16",0,0,5,0,0,5,0,0
"Cameroon","2024-05-17",0,0,5,0,0,5,0,0
"Cameroon","2024-05-18",0,0,5,0,0,5,0,0
"Cameroon","2024-05-19",0,0,5,0,0,5,0,0
"Cameroon","2024-05-20",0,0,5,0,0,5,0,0
"Cameroon","2024-05-21",0,0,5,0,0,5,0,0
"Cameroon","2024-05-22",0,0,5,0,0,5,0,0
"Cameroon","2024-05-23",0,0,5,0,0,5,0,0
"Cameroon","2024-05-24",0,0,5,0,0,5,0,0
"Cameroon","2024-05-25",0,0,5,0,0,5,0,0
"Cameroon","2024-05-26",0,0,5,0,0,5,0,0
"Cameroon","2024-05-27",0,0,5,0,0,5,0,0
"Cameroon","2024-05-28",0,0,5,0,0,5,0,0
"Cameroon","2024-05-29",0,0,5,0,0,5,0,0
"Cameroon","2024-05-30",0,0,5,0,0,5,0,0
"Cameroon","2024-05-31",0,0,5,0,0,5,0,0
"Cameroon","2024-06-01",0,0,5,0,0,5,0,0
"Cameroon","2024-06-02",0,0,5,0,0,5,0,0
"Cameroon","2024-06-03",0,0,5,0,0,5,0,0
"Cameroon","2024-06-04",0,0,5,0,0,5,0,0
"Cameroon","2024-06-05",0,0,5,0,0,5,0,0
"Cameroon","2024-06-06",0,0,5,0,0,5,0,0
"Cameroon","2024-06-07",0,0,5,0,0,5,0,0
"Cameroon","2024-06-08",0,0,5,0,0,5,0,0
"Cameroon","2024-06-09",0,0,5,0,0,5,0,0
"Cameroon","2024-06-10",0,0,5,0,0,5,0,0
"Cameroon","2024-06-11",0,0,5,0,0,5,0,0
"Cameroon","2024-06-12",0,0,5,0,0,5,0,0
"Cameroon","2024-06-13",0,0,5,0,0,5,0,0
"Cameroon","2024-06-14",0,0,5,0,0,5,0,0
"Cameroon","2024-06-15",0,0,5,0,0,5,0,0
"Cameroon","2024-06-16",0,0,5,0,0,5,0,0
"Cameroon","2024-06-17",0,0,5,0,0,5,0,0
"Cameroon","2024-06-18",0,0,5,0,0,5,0,0
"Cameroon","2024-06-19",0,0,5,0,0,5,0,0
"Cameroon","2024-06-20",0,0,5,0,0,5,0,0
"Cameroon","2024-06-21",0,0,5,0,0,5,0,0
"Cameroon","2024-06-22",0,0,5,0,0,5,0,0
"Cameroon","2024-06-23",0,0,5,0,0,5,0,0
"Cameroon","2024-06-24",0,0,5,0,1,6,0,0
"Cameroon","2024-06-25",0,0,5,0,0,6,0,0
"Cameroon","2024-06-26",0,0,5,0,0,6,0,0
"Cameroon","2024-06-27",0,0,5,0,0,6,0,0
"Cameroon","2024-06-28",0,0,5,0,0,6,0,0
"Cameroon","2024-06-29",0,0,5,0,0,6,0,0
"Cameroon","2024-06-30",0,0,5,0,0,6,0,0
"Cameroon","2024-07-01",0,0,5,0,0,6,0,0
"Cameroon","2024-07-02",0,0,5,0,0,6,0,0
"Cameroon","2024-07-03",0,0,5,0,0,6,0,0
"Cameroon","2024-07-04",0,0,5,0,0,6,0,0
"Cameroon","2024-07-05",0,0,5,0,0,6,0,0
"Cameroon","2024-07-06",0,0,5,0,0,6,0,0
"Cameroon","2024-07-07",0,0,5,0,0,6,0,0
"Cameroon","2024-07-08",0,0,5,0,0,6,0,0
"Cameroon","2024-07-09",0,0,5,0,0,6,0,0
"Cameroon","2024-07-10",0,0,5,0,0,6,0,0
"Cameroon","2024-07-11",0,0,5,0,0,6,0,0
"Cameroon","2024-07-12",0,0,5,0,0,6,0,0
"Cameroon","2024-07-13",0,0,5,0,0,6,0,0
"Cameroon","2024-07-14",0,0,5,0,0,6,0,0
"Cameroon","2024-07-15",0,0,5,0,0,6,0,0
"Cameroon","2024-07-16",0,0,5,0,0,6,0,0
"Cameroon","2024-07-17",0,0,5,0,0,6,0,0
"Cameroon","2024-07-18",0,0,5,0,0,6,0,0
"Cameroon","2024-07-19",0,0,5,0,0,6,0,0
"Cameroon","2024-07-20",0,0,5,0,0,6,0,0
"Cameroon","2024-07-21",0,0,5,0,0,6,0,0
"Cameroon","2024-07-22",0,0,5,0,0,6,0,0
"Cameroon","2024-07-23",0,0,5,0,0,6,0,0
"Cameroon","2024-07-24",0,0,5,0,0,6,0,0
"Cameroon","2024-07-25",0,0,5,0,0,6,0,0
"Cameroon","2024-07-26",0,0,5,0,0,6,0,0
"Cameroon","2024-07-27",0,0,5,0,0,6,0,0
"Cameroon","2024-07-28",0,0,5,0,0,6,0,0
"Cameroon","2024-07-29",0,0,5,0,0,6,0,0
"Cameroon","2024-07-30",0,0,5,0,0,6,0,0
"Cameroon","2024-07-31",0,0,5,0,0,6,0,0
"Cameroon","2024-08-01",0,0,5,0,0,6,0,0
"Cameroon","2024-08-02",0,0,5,0,0,6,0,0
"Cameroon","2024-08-03",0,0,5,0,0,6,0,0
"Cameroon","2024-08-04",0,0,5,0,0,6,0,0
"Cameroon","2024-08-05",0,0,5,0,0,6,0,0
"Cameroon","2024-08-06",0,0,5,0,0,6,0,0
"Cameroon","2024-08-07",0,0,5,0,0,6,0,0
"Cameroon","2024-08-08",0,0,5,0,0,6,0,0
"Cameroon","2024-08-09",0,0,5,0,0,6,0,0
"Cameroon","2024-08-10",0,0,5,0,0,6,0,0
"Cameroon","2024-08-11",0,0,5,0,0,6,0,0
"Cameroon","2024-08-12",0,0,5,0,0,6,0,0
"Cameroon","2024-08-13",0,0,5,0,0,6,0,0
"Cameroon","2024-08-14",0,0,5,0,0,6,0,0
"Cameroon","2024-08-15",0,0,5,0,0,6,0,0
"Cameroon","2024-08-16",30,0,5,30,0,6,30,30
"Cameroon","2024-08-17",0,0,5,30,0,6,0,30
"Cameroon","2024-08-18",0,0,5,30,0,6,1,31
"Cameroon","2024-08-19",0,0,5,30,0,6,0,31
"Cameroon","2024-08-20",0,0,5,30,0,6,0,31
"Cameroon","2024-08-21",0,0,5,30,0,6,1,32
"Cameroon","2024-08-22",0,0,5,30,0,6,0,32
"Cameroon","2024-08-23",0,0,5,30,0,6,0,32
"Cameroon","2024-08-24",0,0,5,30,0,6,0,32
"Cameroon","2024-08-25",0,0,5,30,0,6,1,33
"Cameroon","2024-08-26",0,0,5,30,0,6,0,33
"Cameroon","2024-08-27",0,0,5,30,0,6,0,33
"Cameroon","2024-08-28",0,0,5,30,0,6,1,34
"Cameroon","2024-08-29",0,0,5,30,0,6,0,34
"Cameroon","2024-08-30",0,0,5,30,0,6,0,34
"Cameroon","2024-08-31",0,0,5,30,0,6,1,35
"Cameroon","2024-09-01",0,1,6,30,0,6,0,35
"Cameroon","2024-09-02",0,0,6,30,0,6,0,35
"Cameroon","2024-09-03",0,0,6,30,0,6,0,35
"Cameroon","2024-09-04",0,0,6,30,0,6,1,36
"Cameroon","2024-09-05",0,0,6,30,0,6,0,36
"Cameroon","2024-09-06",0,0,6,30,0,6,0,36
"Cameroon","2024-09-07",0,0,6,30,0,6,1,37
"Cameroon","2024-09-08",7,0,6,37,0,6,0,37
"Cameroon","2024-09-09",0,0,6,37,0,6,1,38
"Cameroon","2024-09-10",0,0,6,37,0,6,1,39
"Cameroon","2024-09-11",0,0,6,37,0,6,0,39
"Cameroon","2024-09-12",3,0,6,40,0,6,1,40
"Cameroon","2024-09-13",0,0,6,40,0,6,2,42
"Cameroon","2024-09-14",0,0,6,40,1,7,2,44
"Cameroon","2024-09-15",0,0,6,40,0,7,2,46
"Cameroon","2024-09-16",0,0,6,40,0,7,2,48
"Cameroon","2024-09-17",0,0,6,40,0,7,2,50
"Cameroon","2024-09-18",0,0,6,40,0,7,2,52
"Cameroon","2024-09-19",0,0,6,40,0,7,2,54
"Cameroon","2024-09-20",0,0,6,40,0,7,2,56
"Cameroon","2024-09-21",0,0,6,40,0,7,2,58
"Cameroon","2024-09-22",0,0,6,40,0,7,1,59
"Cameroon","2024-09-23",0,0,6,40,0,7,2,61
"Cameroon","2024-09-24",0,0,6,40,0,7,2,63
"Cameroon","2024-09-25",0,0,6,40,0,7,2,65
"Cameroon","2024-09-26",0,0,6,40,0,7,2,67
"Cameroon","2024-09-27",0,0,6,40,0,7,2,69
"Cameroon","2024-09-28",0,0,6,40,0,7,2,71
"Cameroon","2024-09-29",0,0,6,40,0,7,2,73
"Cameroon","2024-09-30",35,0,6,75,0,7,2,75
"Cameroon","2024-10-01",0,0,6,75,0,7,1,76
"Cameroon","2024-10-02",0,0,6,75,0,7,2,78
"Cameroon","2024-10-03",0,0,6,75,0,7,1,79
"Cameroon","2024-10-04",0,0,6,75,0,7,1,80
"Cameroon","2024-10-05",0,0,6,75,0,7,2,82
"Cameroon","2024-10-06",8,0,6,83,0,7,1,83
"Cameroon","2024-10-07",0,0,6,83,0,7,2,85
"Cameroon","2024-10-08",0,0,6,83,0,7,1,86
"Cameroon","2024-10-09",0,0,6,83,0,7,1,87
"Cameroon","2024-10-10",0,0,6,83,1,8,2,89
"Cameroon","2024-10-11",0,0,6,83,0,8,2,91
"Cameroon","2024-10-12",9,0,6,92,0,8,1,92
"Cameroon","2024-10-13",2,0,6,94,0,8,2,94
"Cameroon","2024-10-14",0,0,6,94,0,8,0,94
"Cameroon","2024-10-15",0,0,6,94,0,8,1,95
"Cameroon","2024-10-16",0,0,6,94,0,8,0,95
"Cameroon","2024-10-17",0,0,6,94,0,8,1,96
"Cameroon","2024-10-18",0,0,6,94,0,8,0,96
"Cameroon","2024-10-19",0,0,6,94,0,8,1,97
"Cameroon","2024-10-20",3,0,6,97,0,8,0,97
"Cameroon","2024-10-21",0,0,6,97,0,8,0,97
"Cameroon","2024-10-22",0,0,6,97,0,8,1,98
"Cameroon","2024-10-23",0,0,6,97,0,8,0,98
"Cameroon","2024-10-24",0,0,6,97,0,8,0,98
"Cameroon","2024-10-25",0,0,6,97,0,8,0,98
"Cameroon","2024-10-26",0,0,6,97,0,8,1,99
"Cameroon","2024-10-27",2,0,6,99,0,8,0,99
"Cameroon","2024-10-28",0,0,6,99,0,8,1,100
"Cameroon","2024-10-29",0,0,6,99,0,8,0,100
"Cameroon","2024-10-30",0,0,6,99,0,8,1,101
"Cameroon","2024-10-31",0,0,6,99,0,8,0,101
"Cameroon","2024-11-01",0,0,6,99,0,8,1,102
"Cameroon","2024-11-02",0,0,6,99,0,8,0,102
"Cameroon","2024-11-03",4,0,6,103,0,8,1,103
"Cameroon","2024-11-04",0,0,6,103,0,8,0,103
"Cameroon","2024-11-05",0,0,6,103,1,9,0,103
"Cameroon","2024-11-06",0,0,6,103,0,9,0,103
"Cameroon","2024-11-07",0,0,6,103,0,9,0,103
"Cameroon","2024-11-08",0,0,6,103,0,9,0,103
"Cameroon","2024-11-09",0,0,6,103,0,9,0,103
"Cameroon","2024-11-10",0,0,6,103,0,9,0,103
"Cameroon","2024-11-11",0,0,6,103,0,9,0,103
"Cameroon","2024-11-12",0,0,6,103,0,9,0,103
"Cameroon","2024-11-13",0,0,6,103,0,9,0,103
"Cameroon","2024-11-14",0,0,6,103,0,9,0,103
"Cameroon","2024-11-15",0,0,6,103,0,9,0,103
"Cameroon","2024-11-16",0,0,6,103,0,9,0,103
"Cameroon","2024-11-17",0,3,9,103,0,9,0,103
"Cameroon","2024-11-18",0,0,9,103,0,9,0,103
"Cameroon","2024-11-19",0,0,9,103,0,9,0,103
"Cameroon","2024-11-20",0,0,9,103,0,9,0,103
"Cameroon","2024-11-21",0,0,9,103,0,9,0,103
"Cameroon","2024-11-22",0,0,9,103,0,9,0,103
"Cameroon","2024-11-23",0,0,9,103,0,9,0,103
"Cameroon","2024-11-24",0,0,9,103,0,9,0,103
"Cameroon","2024-11-25",0,0,9,103,0,9,0,103
"Cameroon","2024-11-26",0,0,9,103,0,9,0,103
"Cameroon","2024-11-27",0,0,9,103,0,9,0,103
"Cameroon","2024-11-28",0,0,9,103,0,9,0,103
"Cameroon","2024-11-29",0,0,9,103,0,9,0,103
"Cameroon","2024-11-30",0,0,9,103,0,9,0,103
"Cameroon","2024-12-01",0,0,9,103,0,9,0,103
"Cameroon","2024-12-02",0,0,9,103,0,9,0,103
"Cameroon","2024-12-03",0,0,9,103,0,9,0,103
"Cameroon","2024-12-04",0,0,9,103,0,9,0,103
"Cameroon","2024-12-05",0,0,9,103,0,9,0,103
"Cameroon","2024-12-06",0,0,9,103,0,9,0,103
"Cameroon","2024-12-07",0,0,9,103,0,9,0,103
"Cameroon","2024-12-08",0,0,9,103,0,9,0,103
"Cameroon","2024-12-09",0,0,9,103,0,9,0,103
"Cameroon","2024-12-10",0,0,9,103,0,9,0,103
"Cameroon","2024-12-11",0,0,9,103,0,9,0,103
"Cameroon","2024-12-12",0,0,9,103,0,9,0,103
"Cameroon","2024-12-13",0,0,9,103,0,9,0,103
"Cameroon","2024-12-14",0,0,9,103,0,9,0,103
"Cameroon","2024-12-15",0,0,9,103,0,9,0,103
"Cameroon","2024-12-16",0,0,9,103,0,9,0,103
"Cameroon","2024-12-17",0,0,9,103,0,9,0,103
"Cameroon","2024-12-18",0,0,9,103,0,9,0,103
"Cameroon","2024-12-19",0,0,9,103,0,9,0,103
"Cameroon","2024-12-20",0,0,9,103,0,9,0,103
"Cameroon","2024-12-21",0,0,9,103,0,9,0,103
"Cameroon","2024-12-22",0,0,9,103,0,9,0,103
"Cameroon","2024-12-23",0,0,9,103,0,9,0,103
"Cameroon","2024-12-24",0,0,9,103,0,9,0,103
"Cameroon","2024-12-25",0,0,9,103,0,9,0,103
"Cameroon","2024-12-26",0,0,9,103,0,9,0,103
"Cameroon","2024-12-27",0,0,9,103,0,9,0,103
"Cameroon","2024-12-28",0,0,9,103,0,9,0,103
"Cameroon","2024-12-29",0,0,9,103,0,9,0,103
"Cameroon","2024-12-30",0,0,9,103,0,9,0,103
"Cameroon","2024-12-31",0,0,9,103,0,9,0,103
"Cameroon","2025-01-01",0,0,9,103,0,9,0,103
"Cameroon","2025-01-02",0,0,9,103,0,9,0,103
"Cameroon","2025-01-03",0,0,9,103,0,9,0,103
"Cameroon","2025-01-04",0,0,9,103,0,9,0,103
"Cameroon","2025-01-05",0,0,9,103,0,9,0,103
"Cameroon","2025-01-06",0,0,9,103,0,9,0,103
"Cameroon","2025-01-07",0,0,9,103,0,9,0,103
"Cameroon","2025-01-08",0,0,9,103,0,9,0,103
"Cameroon","2025-01-09",0,0,9,103,0,9,0,103
"Cameroon","2025-01-10",0,0,9,103,0,9,0,103
"Cameroon","2025-01-11",0,0,9,103,0,9,0,103
"Cameroon","2025-01-12",0,0,9,103,0,9,0,103
"Cameroon","2025-01-13",0,0,9,103,0,9,0,103
"Canada","2024-01-01",0,0,0,0,0,0,0,0
"Canada","2024-01-02",0,0,0,0,0,0,0,0
"Canada","2024-01-03",0,0,0,0,0,0,0,0
"Canada","2024-01-04",0,0,0,0,0,0,0,0
"Canada","2024-01-05",0,0,0,0,0,0,0,0
"Canada","2024-01-06",0,0,0,0,0,0,0,0
"Canada","2024-01-07",0,0,0,0,0,0,0,0
"Canada","2024-01-08",0,0,0,0,0,0,0,0
"Canada","2024-01-09",0,1,1,0,1,1,0,0
"Canada","2024-01-10",0,0,1,0,0,1,0,0
"Canada","2024-01-11",0,0,1,0,0,1,0,0
"Canada","2024-01-12",0,0,1,0,1,2,0,0
"Canada","2024-01-13",0,0,1,0,0,2,0,0
"Canada","2024-01-14",0,0,1,0,0,2,0,0
"Canada","2024-01-15",0,0,1,0,0,2,0,0
"Canada","2024-01-16",0,0,1,0,1,3,0,0
"Canada","2024-01-17",0,0,1,0,0,3,0,0
"Canada","2024-01-18",0,0,1,0,0,3,0,0
"Canada","2024-01-19",0,0,1,0,0,3,0,0
"Canada","2024-01-20",0,0,1,0,0,3,0,0
"Canada","2024-01-21",0,0,1,0,1,4,0,0
"Canada","2024-01-22",0,0,1,0,0,4,0,0
"Canada","2024-01-23",0,3,4,0,0,4,0,0
"Canada","2024-01-24",0,0,4,0,1,5,0,0
"Canada","2024-01-25",0,0,4,0,0,5,0,0
"Canada","2024-01-26",0,0,4,0,1,6,0,0
"Canada","2024-01-27",0,0,4,0,0,6,0,0
"Canada","2024-01-28",0,0,4,0,1,7,0,0
"Canada","2024-01-29",0,0,4,0,0,7,0,0
"Canada","2024-01-30",0,4,8,0,1,8,0,0
"Canada","2024-01-31",0,0,8,0,1,9,0,0
"Canada","2024-02-01",0,0,8,0,1,10,0,0
"Canada","2024-02-02",0,0,8,0,1,11,0,0
"Canada","2024-02-03",0,0,8,0,1,12,0,0
"Canada","2024-02-04",0,0,8,0,1,13,0,0
"Canada","2024-02-05",0,0,8,0,1,14,0,0
"Canada","2024-02-06",0,7,15,0,1,15,0,0
"Canada","2024-02-07",0,0,15,0,1,16,0,0
"Canada","2024-02-08",0,0,15,0,1,17,0,0
"Canada","2024-02-09",0,0,15,0,1,18,0,0
"Canada","2024-02-10",0,0,15,0,2,20,0,0
"Canada","2024-02-11",0,0,15,0,1,21,0,0
"Canada","2024-02-12",0,0,15,0,1,22,0,0
"Canada","2024-02-13",0,8,23,0,1,23,0,0
"Canada","2024-02-14",0,0,23,0,1,24,0,0
"Canada","2024-02-15",0,0,23,0,1,25,0,0
"Canada","2024-02-16",0,0,23,0,1,26,0,0
"Canada","2024-02-17",0,0,23,0,2,28,0,0
"Canada","2024-02-18",0,0,23,0,1,29,0,0
"Canada","2024-02-19",0,0,23,0,1,30,0,0
"Canada","2024-02-20",0,8,31,0,1,31,0,0
"Canada","2024-02-21",0,0,31,0,0,31,0,0
"Canada","2024-02-22",0,0,31,0,0,31,0,0
"Canada","2024-02-23",0,0,31,0,0,31,0,0
"Canada","2024-02-24",0,0,31,0,1,32,0,0
"Canada","2024-02-25",0,0,31,0,0,32,0,0
"Canada","2024-02-26",0,0,31,0,0,32,0,0
"Canada","2024-02-27",0,1,32,0,0,32,0,0
"Canada","2024-02-28",0,0,32,0,1,33,0,0
"Canada","2024-02-29",0,0,32,0,1,34,0,0
"Canada","2024-03-01",0,0,32,0,1,35,0,0
"Canada","2024-03-02",0,0,32,0,0,35,0,0
"Canada","2024-03-03",0,0,32,0,1,36,0,0
"Canada","2024-03-04",0,0,32,0,1,37,0,0
"Canada","2024-03-05",0,6,38,0,1,38,0,0
"Canada","2024-03-06",0,0,38,0,0,38,0,0
"Canada","2024-03-07",0,0,38,0,0,38,0,0
"Canada","2024-03-08",0,0,38,0,0,38,0,0
"Canada","2024-03-09",0,0,38,0,1,39,0,0
"Canada","2024-03-10",0,0,38,0,0,39,0,0
"Canada","2024-03-11",0,0,38,0,0,39,0,0
"Canada","2024-03-12",0,0,38,0,0,39,0,0
"Canada","2024-03-13",0,0,38,0,0,39,0,0
"Canada","2024-03-14",0,0,38,0,0,39,0,0
"Canada","2024-03-15",0,0,38,0,0,39,0,0
"Canada","2024-03-16",0,0,38,0,1,40,0,0
"Canada","2024-03-17",0,0,38,0,0,40,0,0
"Canada","2024-03-18",0,0,38,0,0,40,0,0
"Canada","2024-03-19",0,2,40,0,0,40,0,0
"Canada","2024-03-20",0,0,40,0,1,41,0,0
"Canada","2024-03-21",0,0,40,0,0,41,0,0
"Canada","2024-03-22",0,0,40,0,1,42,0,0
"Canada","2024-03-23",0,0,40,0,0,42,0,0
"Canada","2024-03-24",0,0,40,0,1,43,0,0
"Canada","2024-03-25",0,0,40,0,0,43,0,0
"Canada","2024-03-26",0,4,44,0,1,44,0,0
"Canada","2024-03-27",0,0,44,0,1,45,0,0
"Canada","2024-03-28",0,0,44,0,0,45,0,0
"Canada","2024-03-29",0,0,44,0,1,46,0,0
"Canada","2024-03-30",0,0,44,0,0,46,0,0
"Canada","2024-03-31",0,0,44,0,1,47,0,0
"Canada","2024-04-01",0,0,44,0,0,47,0,0
"Canada","2024-04-02",0,4,48,0,1,48,0,0
"Canada","2024-04-03",0,0,48,0,1,49,0,0
"Canada","2024-04-04",0,0,48,0,0,49,0,0
"Canada","2024-04-05",0,0,48,0,1,50,0,0
"Canada","2024-04-06",0,0,48,0,0,50,0,0
"Canada","2024-04-07",0,0,48,0,1,51,0,0
"Canada","2024-04-08",0,0,48,0,0,51,0,0
"Canada","2024-04-09",0,4,52,0,1,52,0,0
"Canada","2024-04-10",0,0,52,0,0,52,0,0
"Canada","2024-04-11",0,0,52,0,1,53,0,0
"Canada","2024-04-12",0,0,52,0,0,53,0,0
"Canada","2024-04-13",0,0,52,0,1,54,0,0
"Canada","2024-04-14",0,0,52,0,0,54,0,0
"Canada","2024-04-15",0,0,52,0,1,55,0,0
"Canada","2024-04-16",0,3,55,0,0,55,0,0
"Canada","2024-04-17",0,0,55,0,0,55,0,0
"Canada","2024-04-18",0,0,55,0,0,55,0,0
"Canada","2024-04-19",0,0,55,0,0,55,0,0
"Canada","2024-04-20",0,0,55,0,1,56,0,0
"Canada","2024-04-21",0,0,55,0,0,56,0,0
"Canada","2024-04-22",0,0,55,0,0,56,0,0
"Canada","2024-04-23",0,1,56,0,0,56,0,0
"Canada","2024-04-24",0,0,56,0,0,56,0,0
"Canada","2024-04-25",0,0,56,0,1,57,0,0
"Canada","2024-04-26",0,0,56,0,0,57,0,0
"Canada","2024-04-27",0,0,56,0,0,57,0,0
"Canada","2024-04-28",0,0,56,0,0,57,0,0
"Canada","2024-04-29",0,0,56,0,1,58,0,0
"Canada","2024-04-30",0,2,58,0,0,58,0,0
"Canada","2024-05-01",0,0,58,0,1,59,0,0
"Canada","2024-05-02",0,0,58,0,0,59,0,0
"Canada","2024-05-03",0,0,58,0,1,60,0,0
"Canada","2024-05-04",0,0,58,0,0,60,0,0
"Canada","2024-05-05",0,0,58,0,1,61,0,0
"Canada","2024-05-06",0,0,58,0,0,61,0,0
"Canada","2024-05-07",0,4,62,0,1,62,0,0
"Canada","2024-05-08",0,0,62,0,1,63,0,0
"Canada","2024-05-09",0,0,62,0,1,64,0,0
"Canada","2024-05-10",0,0,62,0,1,65,0,0
"Canada","2024-05-11",0,0,62,0,2,67,0,0
"Canada","2024-05-12",0,0,62,0,1,68,0,0
"Canada","2024-05-13",0,0,62,0,1,69,0,0
"Canada","2024-05-14",0,8,70,0,1,70,0,0
"Canada","2024-05-15",0,0,70,0,0,70,0,0
"Canada","2024-05-16",0,0,70,0,1,71,0,0
"Canada","2024-05-17",0,0,70,0,0,71,0,0
"Canada","2024-05-18",0,0,70,0,1,72,0,0
"Canada","2024-05-19",0,0,70,0,0,72,0,0
"Canada","2024-05-20",0,0,70,0,1,73,0,0
"Canada","2024-05-21",0,3,73,0,0,73,0,0
"Canada","2024-05-22",0,0,73,0,1,74,0,0
"Canada","2024-05-23",0,0,73,0,1,75,0,0
"Canada","2024-05-24",0,0,73,0,1,76,0,0
"Canada","2024-05-25",0,0,73,0,0,76,0,0
"Canada","2024-05-26",0,0,73,0,1,77,0,0
"Canada","2024-05-27",0,0,73,0,1,78,0,0
"Canada","2024-05-28",0,6,79,0,1,79,0,0
"Canada","2024-05-29",0,0,79,0,1,80,0,0
"Canada","2024-05-30",0,0,79,0,1,81,0,0
"Canada","2024-05-31",0,0,79,0,1,82,0,0
"Canada","2024-06-01",0,0,79,0,2,84,0,0
"Canada","2024-06-02",0,0,79,0,1,85,0,0
"Canada","2024-06-03",0,0,79,0,1,86,0,0
"Canada","2024-06-04",0,8,87,0,1,87,0,0
"Canada","2024-06-05",0,0,87,0,1,88,0,0
"Canada","2024-06-06",0,0,87,0,1,89,0,0
"Canada","2024-06-07",0,0,87,0,1,90,0,0
"Canada","2024-06-08",0,0,87,0,2,92,0,0
"Canada","2024-06-09",0,0,87,0,1,93,0,0
"Canada","2024-06-10",0,0,87,0,1,94,0,0
"Canada","2024-06-11",0,8,95,0,1,95,0,0
"Canada","2024-06-12",0,0,95,0,0,95,0,0
"Canada","2024-06-13",0,0,95,0,1,96,0,0
"Canada","2024-06-14",0,0,95,0,0,96,0,0
"Canada","2024-06-15",0,0,95,0,0,96,0,0
"Canada","2024-06-16",0,0,95,0,0,96,0,0
"Canada","2024-06-17",0,0,95,0,1,97,0,0
"Canada","2024-06-18",0,2,97,0,0,97,0,0
"Canada","2024-06-19",0,0,97,0,2,99,0,0
"Canada","2024-06-20",0,0,97,0,1,100,0,0
"Canada","2024-06-21",0,0,97,0,2,102,0,0
"Canada","2024-06-22",0,0,97,0,1,103,0,0
"Canada","2024-06-23",0,0,97,0,2,105,0,0
"Canada","2024-06-24",0,0,97,0,1,106,0,0
"Canada","2024-06-25",0,11,108,0,2,108,0,0
"Canada","2024-06-26",0,0,108,0,2,110,0,0
"Canada","2024-06-27",0,0,108,0,1,111,0,0
"Canada","2024-06-28",0,0,108,0,2,113,0,0
"Canada","2024-06-29",0,0,108,0,2,115,0,0
"Canada","2024-06-30",0,0,108,0,2,117,0,0
"Canada","2024-07-01",0,0,108,0,1,118,0,0
"Canada","2024-07-02",0,12,120,0,2,120,0,0
"Canada","2024-07-03",0,0,120,0,2,122,0,0
"Canada","2024-07-04",0,0,120,0,1,123,0,0
"Canada","2024-07-05",0,0,120,0,2,125,0,0
"Canada","2024-07-06",0,0,120,0,1,126,0,0
"Canada","2024-07-07",0,0,120,0,2,128,0,0
"Canada","2024-07-08",0,0,120,0,1,129,0,0
"Canada","2024-07-09",0,11,131,0,2,131,0,0
"Canada","2024-07-10",0,0,131,0,2,133,0,0
"Canada","2024-07-11",0,0,131,0,2,135,0,0
"Canada","2024-07-12",0,0,131,0,2,137,0,0
"Canada","2024-07-13",0,0,131,0,2,139,0,0
"Canada","2024-07-14",0,0,131,0,2,141,0,0
"Canada","2024-07-15",0,0,131,0,2,143,0,0
"Canada","2024-07-16",0,14,145,0,2,145,0,0
"Canada","2024-07-17",0,0,145,0,3,148,0,0
"Canada","2024-07-18",0,0,145,0,2,150,0,0
"Canada","2024-07-19",0,0,145,0,3,153,0,0
"Canada","2024-07-20",0,0,145,0,2,155,0,0
"Canada","2024-07-21",0,0,145,0,3,158,0,0
"Canada","2024-07-22",0,0,145,0,2,160,0,0
"Canada","2024-07-23",0,18,163,0,3,163,0,0
"Canada","2024-07-24",0,0,163,0,2,165,0,0
"Canada","2024-07-25",0,0,163,0,2,167,0,0
"Canada","2024-07-26",0,0,163,0,2,169,0,0
"Canada","2024-07-27",0,0,163,0,2,171,0,0
"Canada","2024-07-28",0,0,163,0,2,173,0,0
"Canada","2024-07-29",0,0,163,0,2,175,0,0
"Canada","2024-07-30",0,14,177,0,2,177,0,0
"Canada","2024-07-31",0,0,177,0,3,180,0,0
"Canada","2024-08-01",0,0,177,0,3,183,0,0
"Canada","2024-08-02",0,0,177,0,3,186,0,0
"Canada","2024-08-03",0,0,177,0,3,189,0,0
"Canada","2024-08-04",0,0,177,0,3,192,0,0
"Canada","2024-08-05",0,0,177,0,3,195,0,0
"Canada","2024-08-06",0,21,198,0,3,198,0,0
"Canada","2024-08-07",0,0,198,0,2,200,0,0
"Canada","2024-08-08",0,0,198,0,3,203,0,0
"Canada","2024-08-09",0,0,198,0,2,205,0,0
"Canada","2024-08-10",0,0,198,0,3,208,0,0
"Canada","2024-08-11",0,0,198,0,2,210,0,0
"Canada","2024-08-12",0,0,198,0,3,213,0,0
"Canada","2024-08-13",0,17,215,0,2,215,0,0
"Canada","2024-08-14",0,0,215,0,1,216,0,0
"Canada","2024-08-15",0,0,215,0,1,217,0,0
"Canada","2024-08-16",0,0,215,0,1,218,0,0
"Canada","2024-08-17",0,0,215,0,1,219,0,0
"Canada","2024-08-18",0,0,215,0,1,220,0,0
"Canada","2024-08-19",0,0,215,0,1,221,0,0
"Canada","2024-08-20",0,7,222,0,1,222,0,0
"Canada","2024-08-21",0,0,222,0,3,225,0,0
"Canada","2024-08-22",0,0,222,0,2,227,0,0
"Canada","2024-08-23",0,0,222,0,3,230,0,0
"Canada","2024-08-24",0,0,222,0,2,232,0,0
"Canada","2024-08-25",0,0,222,0,3,235,0,0
"Canada","2024-08-26",0,0,222,0,2,237,0,0
"Canada","2024-08-27",0,18,240,0,3,240,0,0
"Canada","2024-08-28",0,0,240,0,2,242,0,0
"Canada","2024-08-29",0,0,240,0,2,244,0,0
"Canada","2024-08-30",0,0,240,0,2,246,0,0
"Canada","2024-08-31",0,0,240,0,3,249,0,0
"Canada","2024-09-01",0,0,240,0,2,251,0,0
"Canada","2024-09-02",0,0,240,0,2,253,0,0
"Canada","2024-09-03",0,15,255,0,2,255,0,0
"Canada","2024-09-04",0,0,255,0,2,257,0,0
"Canada","2024-09-05",0,0,255,0,3,260,0,0
"Canada","2024-09-06",0,0,255,0,2,262,0,0
"Canada","2024-09-07",0,0,255,0,3,265,0,0
"Canada","2024-09-08",0,0,255,0,2,267,0,0
"Canada","2024-09-09",0,0,255,0,3,270,0,0
"Canada","2024-09-10",0,17,272,0,2,272,0,0
"Canada","2024-09-11",0,0,272,0,2,274,0,0
"Canada","2024-09-12",0,0,272,0,3,277,0,0
"Canada","2024-09-13",0,0,272,0,2,279,0,0
"Canada","2024-09-14",0,0,272,0,2,281,0,0
"Canada","2024-09-15",0,0,272,0,2,283,0,0
"Canada","2024-09-16",0,0,272,0,3,286,0,0
"Canada","2024-09-17",0,16,288,0,2,288,0,0
"Canada","2024-09-18",0,0,288,0,2,290,0,0
"Canada","2024-09-19",0,0,288,0,3,293,0,0
"Canada","2024-09-20",0,0,288,0,2,295,0,0
"Canada","2024-09-21",0,0,288,0,2,297,0,0
"Canada","2024-09-22",0,0,288,0,2,299,0,0
"Canada","2024-09-23",0,0,288,0,3,302,0,0
"Canada","2024-09-24",0,16,304,0,2,304,0,0
"Canada","2024-09-25",0,0,304,0,2,306,0,0
"Canada","2024-09-26",0,0,304,0,2,308,0,0
"Canada","2024-09-27",0,0,304,0,2,310,0,0
"Canada","2024-09-28",0,0,304,0,3,313,0,0
"Canada","2024-09-29",0,0,304,0,2,315,0,0
"Canada","2024-09-30",0,0,304,0,2,317,0,0
"Canada","2024-10-01",0,15,319,0,2,319,0,0
"Canada","2024-10-02",0,0,319,0,2,321,0,0
"Canada","2024-10-03",0,0,319,0,1,322,0,0
"Canada","2024-10-04",0,0,319,0,2,324,0,0
"Canada","2024-10-05",0,0,319,0,1,325,0,0
"Canada","2024-10-06",0,0,319,0,2,327,0,0
"Canada","2024-10-07",0,0,319,0,1,328,0,0
"Canada","2024-10-08",0,11,330,0,2,330,0,0
"Canada","2024-10-09",0,0,330,0,1,331,0,0
"Canada","2024-10-10",0,0,330,0,2,333,0,0
"Canada","2024-10-11",0,0,330,0,1,334,0,0
"Canada","2024-10-12",0,0,330,0,2,336,0,0
"Canada","2024-10-13",0,0,330,0,1,337,0,0
"Canada","2024-10-14",0,0,330,0,2,339,0,0
"Canada","2024-10-15",0,10,340,0,1,340,0,0
"Canada","2024-10-16",0,0,340,0,2,342,0,0
"Canada","2024-10-17",0,0,340,0,1,343,0,0
"Canada","2024-10-18",0,0,340,0,2,345,0,0
"Canada","2024-10-19",0,0,340,0,1,346,0,0
"Canada","2024-10-20",0,0,340,0,2,348,0,0
"Canada","2024-10-21",0,0,340,0,1,349,0,0
"Canada","2024-10-22",0,11,351,0,2,351,0,0
"Canada","2024-10-23",0,0,351,0,1,352,0,0
"Canada","2024-10-24",0,0,351,0,1,353,0,0
"Canada","2024-10-25",0,0,351,0,1,354,0,0
"Canada","2024-10-26",0,0,351,0,2,356,0,0
"Canada","2024-10-27",0,0,351,0,1,357,0,0
"Canada","2024-10-28",0,0,351,0,1,358,0,0
"Canada","2024-10-29",0,8,359,0,1,359,0,0
"Canada","2024-10-30",0,0,359,0,0,359,0,0
"Canada","2024-10-31",0,0,359,0,1,360,0,0
"Canada","2024-11-01",0,0,359,0,0,360,0,0
"Canada","2024-11-02",0,0,359,0,1,361,0,0
"Canada","2024-11-03",0,0,359,0,0,361,0,0
"Canada","2024-11-04",0,0,359,0,1,362,0,0
"Canada","2024-11-05",0,3,362,0,0,362,0,0
"Canada","2024-11-06",0,0,362,0,0,362,0,0
"Canada","2024-11-07",0,0,362,0,1,363,0,0
"Canada","2024-11-08",0,0,362,0,0,363,0,0
"Canada","2024-11-09",0,0,362,0,1,364,0,0
"Canada","2024-11-10",0,0,362,0,0,364,0,0
"Canada","2024-11-11",0,0,362,0,1,365,0,0
"Canada","2024-11-12",0,3,365,0,0,365,0,0
"Canada","2024-11-13",0,0,365,0,0,365,0,0
"Canada","2024-11-14",0,0,365,0,0,365,0,0
"Canada","2024-11-15",0,0,365,0,0,365,0,0
"Canada","2024-11-16",0,0,365,0,0,365,0,0
"Canada","2024-11-17",0,0,365,0,0,365,0,0
"Canada","2024-11-18",0,0,365,0,0,365,0,0
"Canada","2024-11-19",0,0,365,0,0,365,0,0
"Canada","2024-11-20",0,0,365,0,0,365,0,0
"Canada","2024-11-21",0,0,365,0,0,365,0,0
"Canada","2024-11-22",0,0,365,0,0,365,0,0
"Canada","2024-11-23",0,0,365,0,0,365,0,0
"Canada","2024-11-24",0,0,365,0,0,365,0,0
"Canada","2024-11-25",0,0,365,0,0,365,0,0
"Canada","2024-11-26",0,0,365,0,0,365,0,0
"Canada","2024-11-27",0,0,365,0,0,365,0,0
"Canada","2024-11-28",0,0,365,0,0,365,0,0
"Canada","2024-11-29",0,0,365,0,0,365,0,0
"Canada","2024-11-30",0,0,365,0,0,365,0,0
"Canada","2024-12-01",0,0,365,0,0,365,0,0
"Canada","2024-12-02",0,0,365,0,0,365,0,0
"Canada","2024-12-03",0,0,365,0,0,365,0,0
"Canada","2024-12-04",0,0,365,0,0,365,0,0
"Canada","2024-12-05",0,0,365,0,0,365,0,0
"Canada","2024-12-06",0,0,365,0,0,365,0,0
"Canada","2024-12-07",0,0,365,0,0,365,0,0
"Canada","2024-12-08",0,0,365,0,0,365,0,0
"Canada","2024-12-09",0,0,365,0,0,365,0,0
"Canada","2024-12-10",0,0,365,0,0,365,0,0
"Canada","2024-12-11",0,0,365,0,0,365,0,0
"Canada","2024-12-12",0,0,365,0,0,365,0,0
"Canada","2024-12-13",0,0,365,0,0,365,0,0
"Canada","2024-12-14",0,0,365,0,0,365,0,0
"Canada","2024-12-15",0,0,365,0,0,365,0,0
"Canada","2024-12-16",0,0,365,0,0,365,0,0
"Canada","2024-12-17",0,0,365,0,0,365,0,0
"Canada","2024-12-18",0,0,365,0,0,365,0,0
"Canada","2024-12-19",0,0,365,0,0,365,0,0
"Canada","2024-12-20",0,0,365,0,0,365,0,0
"Canada","2024-12-21",0,0,365,0,0,365,0,0
"Canada","2024-12-22",0,0,365,0,0,365,0,0
"Canada","2024-12-23",0,0,365,0,0,365,0,0
"Canada","2024-12-24",0,0,365,0,0,365,0,0
"Canada","2024-12-25",0,0,365,0,0,365,0,0
"Canada","2024-12-26",0,0,365,0,0,365,0,0
"Canada","2024-12-27",0,0,365,0,0,365,0,0
"Canada","2024-12-28",0,0,365,0,0,365,0,0
"Canada","2024-12-29",0,0,365,0,0,365,0,0
"Canada","2024-12-30",0,0,365,0,0,365,0,0
"Canada","2024-12-31",0,0,365,0,0,365,0,0
"Canada","2025-01-01",0,0,365,0,0,365,0,0
"Canada","2025-01-02",0,0,365,0,0,365,0,0
"Canada","2025-01-03",0,0,365,0,0,365,0,0
"Canada","2025-01-04",0,0,365,0,0,365,0,0
"Canada","2025-01-05",0,0,365,0,0,365,0,0
"Canada","2025-01-06",0,0,365,0,0,365,0,0
"Canada","2025-01-07",0,0,365,0,0,365,0,0
"Canada","2025-01-08",0,0,365,0,0,365,0,0
"Canada","2025-01-09",0,0,365,0,0,365,0,0
"Canada","2025-01-10",0,0,365,0,0,365,0,0
"Canada","2025-01-11",0,0,365,0,0,365,0,0
"Canada","2025-01-12",0,0,365,0,0,365,0,0
"Canada","2025-01-13",0,0,365,0,0,365,0,0
"Central African Republic","2024-01-01",0,0,0,0,0,0,0,0
"Central African Republic","2024-01-02",0,0,0,0,0,0,0,0
"Central African Republic","2024-01-03",0,0,0,0,0,0,0,0
"Central African Republic","2024-01-04",0,0,0,0,0,0,0,0
"Central African Republic","2024-01-05",0,0,0,0,0,0,0,0
"Central African Republic","2024-01-06",0,0,0,0,0,0,0,0
"Central African Republic","2024-01-07",0,0,0,0,0,0,0,0
"Central African Republic","2024-01-08",0,0,0,0,0,0,0,0
"Central African Republic","2024-01-09",0,0,0,0,0,0,0,0
"Central African Republic","2024-01-10",0,0,0,0,0,0,0,0
"Central African Republic","2024-01-11",0,0,0,0,0,0,0,0
"Central African Republic","2024-01-12",0,0,0,0,0,0,0,0
"Central African Republic","2024-01-13",0,0,0,0,0,0,0,0
"Central African Republic","2024-01-14",0,4,4,0,4,4,0,0
"Central African Republic","2024-01-15",0,0,4,0,0,4,0,0
"Central African Republic","2024-01-16",0,0,4,0,0,4,0,0
"Central African Republic","2024-01-17",0,0,4,0,0,4,0,0
"Central African Republic","2024-01-18",0,0,4,0,0,4,0,0
"Central African Republic","2024-01-19",0,0,4,0,0,4,0,0
"Central African Republic","2024-01-20",0,0,4,0,0,4,0,0
"Central African Republic","2024-01-21",0,0,4,0,0,4,0,0
"Central African Republic","2024-01-22",0,0,4,0,1,5,0,0
"Central African Republic","2024-01-23",0,0,4,0,0,5,0,0
"Central African Republic","2024-01-24",0,0,4,0,0,5,0,0
"Central African Republic","2024-01-25",0,0,4,0,0,5,0,0
"Central African Republic","2024-01-26",0,0,4,0,0,5,0,0
"Central African Republic","2024-01-27",0,0,4,0,0,5,0,0
"Central African Republic","2024-01-28",0,1,5,0,0,5,0,0
"Central African Republic","2024-01-29",0,0,5,0,0,5,0,0
"Central African Republic","2024-01-30",0,0,5,0,0,5,0,0
"Central African Republic","2024-01-31",0,0,5,0,1,6,0,0
"Central African Republic","2024-02-01",0,0,5,0,0,6,0,0
"Central African Republic","2024-02-02",0,0,5,0,0,6,0,0
"Central African Republic","2024-02-03",0,0,5,0,0,6,0,0
"Central African Republic","2024-02-04",0,0,5,0,1,7,0,0
"Central African Republic","2024-02-05",0,0,5,0,0,7,0,0
"Central African Republic","2024-02-06",0,0,5,0,0,7,0,0
"Central African Republic","2024-02-07",0,0,5,0,0,7,0,0
"Central African Republic","2024-02-08",0,0,5,0,0,7,0,0
"Central African Republic","2024-02-09",0,0,5,0,1,8,0,0
"Central African Republic","2024-02-10",0,0,5,0,0,8,0,0
"Central African Republic","2024-02-11",0,3,8,0,0,8,0,0
"Central African Republic","2024-02-12",0,0,8,0,1,9,0,0
"Central African Republic","2024-02-13",0,0,8,0,0,9,0,0
"Central African Republic","2024-02-14",0,0,8,0,1,10,0,0
"Central African Republic","2024-02-15",0,0,8,0,0,10,0,0
"Central African Republic","2024-02-16",0,0,8,0,1,11,0,0
"Central African Republic","2024-02-17",0,0,8,0,0,11,0,0
"Central African Republic","2024-02-18",0,4,12,0,1,12,0,0
"Central African Republic","2024-02-19",0,0,12,0,0,12,0,0
"Central African Republic","2024-02-20",0,0,12,0,0,12,0,0
"Central African Republic","2024-02-21",0,0,12,0,0,12,0,0
"Central African Republic","2024-02-22",0,0,12,0,1,13,0,0
"Central African Republic","2024-02-23",0,0,12,0,0,13,0,0
"Central African Republic","2024-02-24",0,0,12,0,0,13,0,0
"Central African Republic","2024-02-25",0,0,12,0,0,13,0,0
"Central African Republic","2024-02-26",0,0,12,0,0,13,0,0
"Central African Republic","2024-02-27",0,0,12,0,0,13,0,0
"Central African Republic","2024-02-28",0,0,12,0,0,13,0,0
"Central African Republic","2024-02-29",0,0,12,0,1,14,0,0
"Central African Republic","2024-03-01",0,0,12,0,0,14,0,0
"Central African Republic","2024-03-02",0,0,12,0,0,14,0,0
"Central African Republic","2024-03-03",0,0,12,0,0,14,0,0
"Central African Republic","2024-03-04",0,0,12,0,0,14,0,0
"Central African Republic","2024-03-05",0,0,12,0,0,14,0,0
"Central African Republic","2024-03-06",0,0,12,0,0,14,0,0
"Central African Republic","2024-03-07",0,0,12,0,1,15,0,0
"Central African Republic","2024-03-08",0,0,12,0,0,15,0,0
"Central African Republic","2024-03-09",0,0,12,0,0,15,0,0
"Central African Republic","2024-03-10",0,0,12,0,0,15,0,0
"Central African Republic","2024-03-11",0,0,12,0,0,15,0,0
"Central African Republic","2024-03-12",0,0,12,0,0,15,0,0
"Central African Republic","2024-03-13",0,0,12,0,0,15,0,0
"Central African Republic","2024-03-14",0,0,12,0,1,16,0,0
"Central African Republic","2024-03-15",0,0,12,0,0,16,0,0
"Central African Republic","2024-03-16",0,0,12,0,0,16,0,0
"Central African Republic","2024-03-17",45,4,16,45,0,16,45,45
"Central African Republic","2024-03-18",0,0,16,45,0,16,0,45
"Central African Republic","2024-03-19",0,0,16,45,1,17,1,46
"Central African Republic","2024-03-20",0,0,16,45,0,17,0,46
"Central African Republic","2024-03-21",0,0,16,45,0,17,0,46
"Central African Republic","2024-03-22",0,0,16,45,0,17,0,46
"Central African Republic","2024-03-23",0,0,16,45,1,18,1,47
"Central African Republic","2024-03-24",2,2,18,47,0,18,0,47
"Central African Republic","2024-03-25",0,0,18,47,0,18,1,48
"Central African Republic","2024-03-26",0,0,18,47,0,18,1,49
"Central African Republic","2024-03-27",0,0,18,47,0,18,2,51
"Central African Republic","2024-03-28",0,0,18,47,1,19,1,52
"Central African Republic","2024-03-29",0,0,18,47,0,19,1,53
"Central African Republic","2024-03-30",0,0,18,47,0,19,1,54
"Central African Republic","2024-03-31",0,1,19,47,0,19,2,56
"Central African Republic","2024-04-01",0,0,19,47,0,19,1,57
"Central African Republic","2024-04-02",0,0,19,47,0,19,1,58
"Central African Republic","2024-04-03",0,0,19,47,0,19,1,59
"Central African Republic","2024-04-04",0,0,19,47,0,19,2,61
"Central African Republic","2024-04-05",0,0,19,47,0,19,1,62
"Central African Republic","2024-04-06",0,0,19,47,0,19,1,63
"Central African Republic","2024-04-07",0,0,19,47,0,19,1,64
"Central African Republic","2024-04-08",0,0,19,47,0,19,2,66
"Central African Republic","2024-04-09",0,0,19,47,0,19,1,67
"Central African Republic","2024-04-10",0,0,19,47,0,19,1,68
"Central African Republic","2024-04-11",0,0,19,47,0,19,1,69
"Central African Republic","2024-04-12",0,0,19,47,0,19,2,71
"Central African Republic","2024-04-13",0,0,19,47,0,19,1,72
"Central African Republic","2024-04-14",26,0,19,73,0,19,1,73
"Central African Republic","2024-04-15",0,0,19,73,0,19,0,73
"Central African Republic","2024-04-16",0,0,19,73,0,19,1,74
"Central African Republic","2024-04-17",0,0,19,73,0,19,0,74
"Central African Republic","2024-04-18",0,0,19,73,0,19,1,75
"Central African Republic","2024-04-19",0,0,19,73,0,19,0,75
"Central African Republic","2024-04-20",0,0,19,73,0,19,1,76
"Central African Republic","2024-04-21",0,0,19,73,0,19,0,76
"Central African Republic","2024-04-22",0,0,19,73,0,19,1,77
"Central African Republic","2024-04-23",0,0,19,73,0,19,0,77
"Central African Republic","2024-04-24",0,0,19,73,0,19,0,77
"Central African Republic","2024-04-25",0,0,19,73,0,19,1,78
"Central African Republic","2024-04-26",0,0,19,73,0,19,0,78
"Central African Republic","2024-04-27",0,0,19,73,0,19,1,79
"Central African Republic","2024-04-28",0,0,19,73,0,19,0,79
"Central African Republic","2024-04-29",0,0,19,73,0,19,1,80
"Central African Republic","2024-04-30",0,0,19,73,0,19,0,80
"Central African Republic","2024-05-01",0,0,19,73,0,19,1,81
"Central African Republic","2024-05-02",0,0,19,73,0,19,0,81
"Central African Republic","2024-05-03",0,0,19,73,0,19,0,81
"Central African Republic","2024-05-04",0,0,19,73,0,19,1,82
"Central African Republic","2024-05-05",0,0,19,73,0,19,0,82
"Central African Republic","2024-05-06",0,0,19,73,1,20,1,83
"Central African Republic","2024-05-07",0,0,19,73,0,20,0,83
"Central African Republic","2024-05-08",0,0,19,73,0,20,1,84
"Central African Republic","2024-05-09",0,0,19,73,0,20,0,84
"Central African Republic","2024-05-10",0,0,19,73,0,20,0,84
"Central African Republic","2024-05-11",0,0,19,73,0,20,1,85
"Central African Republic","2024-05-12",0,0,19,73,0,20,0,85
"Central African Republic","2024-05-13",0,0,19,73,0,20,1,86
"Central African Republic","2024-05-14",0,0,19,73,0,20,0,86
"Central African Republic","2024-05-15",0,0,19,73,0,20,1,87
"Central African Republic","2024-05-16",0,0,19,73,0,20,0,87
"Central African Republic","2024-05-17",0,0,19,73,0,20,1,88
"Central African Republic","2024-05-18",15,0,19,88,0,20,0,88
"Central African Republic","2024-05-19",0,0,19,88,0,20,0,88
"Central African Republic","2024-05-20",0,0,19,88,0,20,0,88
"Central African Republic","2024-05-21",0,0,19,88,0,20,0,88
"Central African Republic","2024-05-22",0,0,19,88,0,20,1,89
"Central African Republic","2024-05-23",0,0,19,88,0,20,0,89
"Central African Republic","2024-05-24",0,0,19,88,0,20,0,89
"Central African Republic","2024-05-25",1,0,19,89,0,20,0,89
"Central African Republic","2024-05-26",0,0,19,89,0,20,4,93
"Central African Republic","2024-05-27",0,0,19,89,0,20,3,96
"Central African Republic","2024-05-28",0,0,19,89,0,20,3,99
"Central African Republic","2024-05-29",0,0,19,89,0,20,4,103
"Central African Republic","2024-05-30",0,0,19,89,0,20,4,107
"Central African Republic","2024-05-31",0,0,19,89,0,20,3,110
"Central African Republic","2024-06-01",0,0,19,89,0,20,3,113
"Central African Republic","2024-06-02",0,0,19,89,0,20,4,117
"Central African Republic","2024-06-03",0,0,19,89,0,20,4,121
"Central African Republic","2024-06-04",0,0,19,89,0,20,3,124
"Central African Republic","2024-06-05",0,0,19,89,0,20,3,127
"Central African Republic","2024-06-06",0,0,19,89,0,20,4,131
"Central African Republic","2024-06-07",0,0,19,89,0,20,4,135
"Central African Republic","2024-06-08",0,0,19,89,0,20,3,138
"Central African Republic","2024-06-09",0,1,20,89,0,20,3,141
"Central African Republic","2024-06-10",0,0,20,89,0,20,4,145
"Central African Republic","2024-06-11",0,0,20,89,0,20,4,149
"Central African Republic","2024-06-12",0,0,20,89,0,20,3,152
"Central African Republic","2024-06-13",0,0,20,89,1,21,3,155
"Central African Republic","2024-06-14",0,0,20,89,0,21,4,159
"Central African Republic","2024-06-15",0,0,20,89,0,21,4,163
"Central African Republic","2024-06-16",77,1,21,166,0,21,3,166
"Central African Republic","2024-06-17",0,0,21,166,0,21,0,166
"Central African Republic","2024-06-18",0,0,21,166,0,21,1,167
"Central African Republic","2024-06-19",0,0,21,166,0,21,0,167
"Central African Republic","2024-06-20",0,0,21,166,1,22,1,168
"Central African Republic","2024-06-21",0,0,21,166,0,22,0,168
"Central African Republic","2024-06-22",0,0,21,166,0,22,1,169
"Central African Republic","2024-06-23",0,1,22,166,0,22,0,169
"Central African Republic","2024-06-24",0,0,22,166,0,22,1,170
"Central African Republic","2024-06-25",0,0,22,166,0,22,0,170
"Central African Republic","2024-06-26",0,0,22,166,0,22,1,171
"Central African Republic","2024-06-27",0,0,22,166,1,23,0,171
"Central African Republic","2024-06-28",0,0,22,166,0,23,0,171
"Central African Republic","2024-06-29",0,0,22,166,0,23,1,172
"Central African Republic","2024-06-30",0,1,23,166,0,23,0,172
"Central African Republic","2024-07-01",0,0,23,166,0,23,1,173
"Central African Republic","2024-07-02",0,0,23,166,0,23,0,173
"Central African Republic","2024-07-03",0,0,23,166,0,23,1,174
"Central African Republic","2024-07-04",0,0,23,166,1,24,0,174
"Central African Republic","2024-07-05",0,0,23,166,0,24,1,175
"Central African Republic","2024-07-06",0,0,23,166,0,24,0,175
"Central African Republic","2024-07-07",0,1,24,166,0,24,1,176
"Central African Republic","2024-07-08",0,0,24,166,0,24,0,176
"Central African Republic","2024-07-09",0,0,24,166,0,24,0,176
"Central African Republic","2024-07-10",0,0,24,166,0,24,1,177
"Central African Republic","2024-07-11",0,0,24,166,1,25,0,177
"Central African Republic","2024-07-12",0,0,24,166,0,25,1,178
"Central African Republic","2024-07-13",0,0,24,166,0,25,0,178
"Central African Republic","2024-07-14",0,1,25,166,0,25,1,179
"Central African Republic","2024-07-15",0,0,25,166,1,26,0,179
"Central African Republic","2024-07-16",0,0,25,166,0,26,1,180
"Central African Republic","2024-07-17",0,0,25,166,1,27,0,180
"Central African Republic","2024-07-18",0,0,25,166,1,28,0,180
"Central African Republic","2024-07-19",0,0,25,166,1,29,1,181
"Central African Republic","2024-07-20",0,0,25,166,0,29,0,181
"Central African Republic","2024-07-21",0,5,30,166,1,30,1,182
"Central African Republic","2024-07-22",0,0,30,166,1,31,0,182
"Central African Republic","2024-07-23",0,0,30,166,2,33,1,183
"Central African Republic","2024-07-24",0,0,30,166,1,34,0,183
"Central African Republic","2024-07-25",0,0,30,166,1,35,1,184
"Central African Republic","2024-07-26",0,0,30,166,1,36,0,184
"Central African Republic","2024-07-27",0,0,30,166,2,38,1,185
"Central African Republic","2024-07-28",19,9,39,185,1,39,0,185
"Central African Republic","2024-07-29",0,0,39,185,0,39,2,187
"Central African Republic","2024-07-30",0,0,39,185,1,40,1,188
"Central African Republic","2024-07-31",0,0,39,185,0,40,2,190
"Central African Republic","2024-08-01",0,0,39,185,1,41,2,192
"Central African Republic","2024-08-02",0,0,39,185,0,41,1,193
"Central African Republic","2024-08-03",10,0,39,195,1,42,2,195
"Central African Republic","2024-08-04",0,3,42,195,0,42,5,200
"Central African Republic","2024-08-05",0,0,42,195,0,42,4,204
"Central African Republic","2024-08-06",0,0,42,195,1,43,5,209
"Central African Republic","2024-08-07",0,0,42,195,0,43,5,214
"Central African Republic","2024-08-08",0,0,42,195,0,43,4,218
"Central African Republic","2024-08-09",28,0,42,223,0,43,5,223
"Central African Republic","2024-08-10",0,0,42,223,1,44,1,224
"Central African Republic","2024-08-11",0,2,44,223,0,44,0,224
"Central African Republic","2024-08-12",0,0,44,223,0,44,1,225
"Central African Republic","2024-08-13",0,0,44,223,1,45,1,226
"Central African Republic","2024-08-14",0,0,44,223,0,45,0,226
"Central African Republic","2024-08-15",0,0,44,223,0,45,1,227
"Central African Republic","2024-08-16",0,0,44,223,0,45,1,228
"Central African Republic","2024-08-17",0,0,44,223,1,46,0,228
"Central African Republic","2024-08-18",0,2,46,223,0,46,1,229
"Central African Republic","2024-08-19",0,0,46,223,0,46,1,230
"Central African Republic","2024-08-20",0,0,46,223,1,47,0,230
"Central African Republic","2024-08-21",0,0,46,223,0,47,1,231
"Central African Republic","2024-08-22",0,0,46,223,1,48,1,232
"Central African Republic","2024-08-23",0,0,46,223,0,48,0,232
"Central African Republic","2024-08-24",0,0,46,223,1,49,1,233
"Central African Republic","2024-08-25",0,3,49,223,0,49,1,234
"Central African Republic","2024-08-26",0,0,49,223,0,49,0,234
"Central African Republic","2024-08-27",0,0,49,223,0,49,1,235
"Central African Republic","2024-08-28",0,0,49,223,0,49,1,236
"Central African Republic","2024-08-29",0,0,49,223,1,50,0,236
"Central African Republic","2024-08-30",0,0,49,223,0,50,1,237
"Central African Republic","2024-08-31",0,0,49,223,0,50,1,238
"Central African Republic","2024-09-01",0,1,50,223,0,50,0,238
"Central African Republic","2024-09-02",0,0,50,223,0,50,1,239
"Central African Republic","2024-09-03",0,0,50,223,1,51,1,240
"Central African Republic","2024-09-04",0,0,50,223,0,51,0,240
"Central African Republic","2024-09-05",0,0,50,223,0,51,1,241
"Central African Republic","2024-09-06",0,0,50,223,0,51,1,242
"Central African Republic","2024-09-07",0,0,50,223,1,52,0,242
"Central African Republic","2024-09-08",20,2,52,243,0,52,1,243
"Central African Republic","2024-09-09",0,0,52,243,0,52,1,244
"Central African Republic","2024-09-10",0,0,52,243,0,52,1,245
"Central African Republic","2024-09-11",0,0,52,243,0,52,0,245
"Central African Republic","2024-09-12",0,0,52,243,1,53,1,246
"Central African Republic","2024-09-13",0,0,52,243,0,53,1,247
"Central African Republic","2024-09-14",0,0,52,243,0,53,1,248
"Central African Republic","2024-09-15",0,1,53,243,0,53,1,249
"Central African Republic","2024-09-16",0,0,53,243,0,53,0,249
"Central African Republic","2024-09-17",0,0,53,243,1,54,1,250
"Central African Republic","2024-09-18",0,0,53,243,0,54,1,251
"Central African Republic","2024-09-19",0,0,53,243,0,54,1,252
"Central African Republic","2024-09-20",0,0,53,243,0,54,1,253
"Central African Republic","2024-09-21",0,0,53,243,1,55,0,253
"Central African Republic","2024-09-22",0,2,55,243,0,55,1,254
"Central African Republic","2024-09-23",12,0,55,255,0,55,1,255
"Central African Republic","2024-09-24",0,0,55,255,0,55,2,257
"Central African Republic","2024-09-25",0,0,55,255,0,55,2,259
"Central African Republic","2024-09-26",0,0,55,255,1,56,2,261
"Central African Republic","2024-09-27",0,0,55,255,0,56,2,263
"Central African Republic","2024-09-28",0,0,55,255,0,56,2,265
"Central African Republic","2024-09-29",0,0,55,255,0,56,2,267
"Central African Republic","2024-09-30",14,0,55,269,0,56,2,269
"Central African Republic","2024-10-01",0,0,55,269,0,56,2,271
"Central African Republic","2024-10-02",0,0,55,269,0,56,1,272
"Central African Republic","2024-10-03",0,0,55,269,1,57,2,274
"Central African Republic","2024-10-04",0,0,55,269,0,57,2,276
"Central African Republic","2024-10-05",0,0,55,269,0,57,1,277
"Central African Republic","2024-10-06",10,2,57,279,0,57,2,279
"Central African Republic","2024-10-07",0,0,57,279,1,58,3,282
"Central African Republic","2024-10-08",0,0,57,279,0,58,3,285
"Central African Republic","2024-10-09",0,0,57,279,1,59,2,287
"Central African Republic","2024-10-10",0,0,57,279,1,60,3,290
"Central African Republic","2024-10-11",0,0,57,279,1,61,3,293
"Central African Republic","2024-10-12",0,0,57,279,0,61,3,296
"Central African Republic","2024-10-13",0,5,62,279,1,62,3,299
"Central African Republic","2024-10-14",0,0,62,279,0,62,2,301
"Central African Republic","2024-10-15",0,0,62,279,1,63,3,304
"Central African Republic","2024-10-16",0,0,62,279,0,63,3,307
"Central African Republic","2024-10-17",0,0,62,279,0,63,3,310
"Central African Republic","2024-10-18",0,0,62,279,0,63,2,312
"Central African Republic","2024-10-19",0,0,62,279,1,64,3,315
"Central African Republic","2024-10-20",39,2,64,318,0,64,3,318
"Central African Republic","2024-10-21",0,0,64,318,0,64,1,319
"Central African Republic","2024-10-22",0,0,64,318,1,65,0,319
"Central African Republic","2024-10-23",0,0,64,318,1,66,1,320
"Central African Republic","2024-10-24",0,0,64,318,0,66,1,321
"Central African Republic","2024-10-25",0,0,64,318,0,66,1,322
"Central African Republic","2024-10-26",0,3,67,318,1,67,0,322
"Central African Republic","2024-10-27",5,0,67,323,1,68,1,323
"Central African Republic","2024-10-28",0,0,67,323,1,69,0,323
"Central African Republic","2024-10-29",0,0,67,323,0,69,1,324
"Central African Republic","2024-10-30",0,0,67,323,1,70,0,324
"Central African Republic","2024-10-31",0,0,67,323,1,71,0,324
"Central African Republic","2024-11-01",0,0,67,323,0,71,1,325
"Central African Republic","2024-11-02",0,0,67,323,1,72,0,325
"Central African Republic","2024-11-03",0,6,73,323,1,73,0,325
"Central African Republic","2024-11-04",0,0,73,323,0,73,1,326
"Central African Republic","2024-11-05",0,0,73,323,1,74,0,326
"Central African Republic","2024-11-06",0,0,73,323,0,74,1,327
"Central African Republic","2024-11-07",0,0,73,323,1,75,0,327
"Central African Republic","2024-11-08",0,0,73,323,0,75,0,327
"Central African Republic","2024-11-09",0,0,73,323,1,76,1,328
"Central African Republic","2024-11-10",0,3,76,323,0,76,0,328
"Central African Republic","2024-11-11",0,0,76,323,0,76,0,328
"Central African Republic","2024-11-12",0,0,76,323,1,77,1,329
"Central African Republic","2024-11-13",6,0,76,329,0,77,0,329
"Central African Republic","2024-11-14",0,0,76,329,1,78,0,329
"Central African Republic","2024-11-15",0,0,76,329,0,78,0,329
"Central African Republic","2024-11-16",0,0,76,329,1,79,0,329
"Central African Republic","2024-11-17",0,3,79,329,0,79,0,329
"Central African Republic","2024-11-18",0,0,79,329,0,79,0,329
"Central African Republic","2024-11-19",0,0,79,329,1,80,0,329
"Central African Republic","2024-11-20",0,0,79,329,0,80,0,329
"Central African Republic","2024-11-21",0,0,79,329,1,81,0,329
"Central African Republic","2024-11-22",0,0,79,329,0,81,0,329
"Central African Republic","2024-11-23",0,0,79,329,1,82,0,329
"Central African Republic","2024-11-24",0,0,79,329,0,82,0,329
"Central African Republic","2024-11-25",0,0,79,329,0,82,0,329
"Central African Republic","2024-11-26",0,0,79,329,1,83,0,329
"Central African Republic","2024-11-27",0,0,79,329,0,83,0,329
"Central African Republic","2024-11-28",0,0,79,329,1,84,0,329
"Central African Republic","2024-11-29",0,0,79,329,0,84,0,329
"Central African Republic","2024-11-30",0,0,79,329,1,85,0,329
"Central African Republic","2024-12-01",0,6,85,329,0,85,0,329
"Central African Republic","2024-12-02",0,0,85,329,0,85,0,329
"Central African Republic","2024-12-03",0,0,85,329,0,85,0,329
"Central African Republic","2024-12-04",0,0,85,329,0,85,0,329
"Central African Republic","2024-12-05",0,0,85,329,0,85,0,329
"Central African Republic","2024-12-06",0,0,85,329,0,85,0,329
"Central African Republic","2024-12-07",0,0,85,329,0,85,0,329
"Central African Republic","2024-12-08",0,0,85,329,0,85,0,329
"Central African Republic","2024-12-09",0,0,85,329,0,85,0,329
"Central African Republic","2024-12-10",0,0,85,329,0,85,0,329
"Central African Republic","2024-12-11",0,0,85,329,0,85,0,329
"Central African Republic","2024-12-12",0,0,85,329,0,85,0,329
"Central African Republic","2024-12-13",0,0,85,329,0,85,0,329
"Central African Republic","2024-12-14",0,0,85,329,0,85,0,329
"Central African Republic","2024-12-15",0,0,85,329,0,85,0,329
"Central African Republic","2024-12-16",0,0,85,329,0,85,0,329
"Central African Republic","2024-12-17",0,0,85,329,0,85,0,329
"Central African Republic","2024-12-18",0,0,85,329,0,85,0,329
"Central African Republic","2024-12-19",0,0,85,329,0,85,0,329
"Central African Republic","2024-12-20",0,0,85,329,0,85,0,329
"Central African Republic","2024-12-21",0,0,85,329,0,85,0,329
"Central African Republic","2024-12-22",0,0,85,329,0,85,0,329
"Central African Republic","2024-12-23",0,0,85,329,0,85,0,329
"Central African Republic","2024-12-24",0,0,85,329,0,85,0,329
"Central African Republic","2024-12-25",0,0,85,329,0,85,0,329
"Central African Republic","2024-12-26",0,0,85,329,0,85,0,329
"Central African Republic","2024-12-27",0,0,85,329,0,85,0,329
"Central African Republic","2024-12-28",0,0,85,329,0,85,0,329
"Central African Republic","2024-12-29",0,0,85,329,0,85,0,329
"Central African Republic","2024-12-30",0,0,85,329,0,85,0,329
"Central African Republic","2024-12-31",0,0,85,329,0,85,0,329
"Central African Republic","2025-01-01",0,0,85,329,0,85,0,329
"Central African Republic","2025-01-02",0,0,85,329,0,85,0,329
"Central African Republic","2025-01-03",0,0,85,329,0,85,0,329
"Central African Republic","2025-01-04",0,0,85,329,0,85,0,329
"Central African Republic","2025-01-05",0,0,85,329,0,85,0,329
"Central African Republic","2025-01-06",0,0,85,329,0,85,0,329
"Central African Republic","2025-01-07",0,0,85,329,0,85,0,329
"Central African Republic","2025-01-08",0,0,85,329,0,85,0,329
"Central African Republic","2025-01-09",0,0,85,329,0,85,0,329
"Central African Republic","2025-01-10",0,0,85,329,0,85,0,329
"Central African Republic","2025-01-11",0,0,85,329,0,85,0,329
"Central African Republic","2025-01-12",0,0,85,329,0,85,0,329
"Central African Republic","2025-01-13",0,0,85,329,0,85,0,329
"Chile","2024-01-01",0,0,0,0,0,0,0,0
"Chile","2024-01-02",0,1,1,0,1,1,0,0
"Chile","2024-01-03",0,0,1,0,0,1,0,0
"Chile","2024-01-04",0,0,1,0,0,1,0,0
"Chile","2024-01-05",0,0,1,0,0,1,0,0
"Chile","2024-01-06",0,0,1,0,0,1,0,0
"Chile","2024-01-07",0,0,1,0,0,1,0,0
"Chile","2024-01-08",0,0,1,0,0,1,0,0
"Chile","2024-01-09",0,0,1,0,0,1,0,0
"Chile","2024-01-10",0,0,1,0,0,1,0,0
"Chile","2024-01-11",0,0,1,0,0,1,0,0
"Chile","2024-01-12",0,0,1,0,0,1,0,0
"Chile","2024-01-13",0,0,1,0,0,1,0,0
"Chile","2024-01-14",0,0,1,0,0,1,0,0
"Chile","2024-01-15",0,0,1,0,0,1,0,0
"Chile","2024-01-16",0,0,1,0,0,1,0,0
"Chile","2024-01-17",0,0,1,0,0,1,0,0
"Chile","2024-01-18",0,0,1,0,0,1,0,0
"Chile","2024-01-19",0,0,1,0,0,1,0,0
"Chile","2024-01-20",0,0,1,0,1,2,0,0
"Chile","2024-01-21",0,0,1,0,0,2,0,0
"Chile","2024-01-22",0,0,1,0,0,2,0,0
"Chile","2024-01-23",0,0,1,0,0,2,0,0
"Chile","2024-01-24",0,0,1,0,0,2,0,0
"Chile","2024-01-25",0,0,1,0,0,2,0,0
"Chile","2024-01-26",0,0,1,0,0,2,0,0
"Chile","2024-01-27",0,0,1,0,0,2,0,0
"Chile","2024-01-28",0,0,1,0,0,2,0,0
"Chile","2024-01-29",0,0,1,0,0,2,0,0
"Chile","2024-01-30",0,0,1,0,0,2,0,0
"Chile","2024-01-31",0,0,1,0,0,2,0,0
"Chile","2024-02-01",0,0,1,0,0,2,0,0
"Chile","2024-02-02",0,0,1,0,0,2,0,0
"Chile","2024-02-03",0,0,1,0,0,2,0,0
"Chile","2024-02-04",0,0,1,0,0,2,0,0
"Chile","2024-02-05",0,0,1,0,0,2,0,0
"Chile","2024-02-06",0,1,2,0,0,2,0,0
"Chile","2024-02-07",0,0,2,0,0,2,0,0
"Chile","2024-02-08",0,0,2,0,0,2,0,0
"Chile","2024-02-09",0,0,2,0,0,2,0,0
"Chile","2024-02-10",0,0,2,0,0,2,0,0
"Chile","2024-02-11",0,0,2,0,0,2,0,0
"Chile","2024-02-12",0,0,2,0,0,2,0,0
"Chile","2024-02-13",0,0,2,0,0,2,0,0
"Chile","2024-02-14",0,0,2,0,1,3,0,0
"Chile","2024-02-15",0,0,2,0,0,3,0,0
"Chile","2024-02-16",0,0,2,0,0,3,0,0
"Chile","2024-02-17",0,0,2,0,0,3,0,0
"Chile","2024-02-18",0,0,2,0,0,3,0,0
"Chile","2024-02-19",0,0,2,0,0,3,0,0
"Chile","2024-02-20",0,1,3,0,0,3,0,0
"Chile","2024-02-21",0,0,3,0,0,3,0,0
"Chile","2024-02-22",0,0,3,0,0,3,0,0
"Chile","2024-02-23",0,0,3,0,0,3,0,0
"Chile","2024-02-24",0,0,3,0,1,4,0,0
"Chile","2024-02-25",0,0,3,0,0,4,0,0
"Chile","2024-02-26",0,0,3,0,0,4,0,0
"Chile","2024-02-27",0,1,4,0,0,4,0,0
"Chile","2024-02-28",0,0,4,0,0,4,0,0
"Chile","2024-02-29",0,0,4,0,1,5,0,0
"Chile","2024-03-01",0,0,4,0,0,5,0,0
"Chile","2024-03-02",0,0,4,0,0,5,0,0
"Chile","2024-03-03",0,0,4,0,0,5,0,0
"Chile","2024-03-04",0,0,4,0,1,6,0,0
"Chile","2024-03-05",0,2,6,0,0,6,0,0
"Chile","2024-03-06",0,0,6,0,0,6,0,0
"Chile","2024-03-07",0,0,6,0,0,6,0,0
"Chile","2024-03-08",0,0,6,0,0,6,0,0
"Chile","2024-03-09",0,0,6,0,0,6,0,0
"Chile","2024-03-10",0,0,6,0,0,6,0,0
"Chile","2024-03-11",0,0,6,0,0,6,0,0
"Chile","2024-03-12",0,0,6,0,0,6,0,0
"Chile","2024-03-13",0,0,6,0,0,6,0,0
"Chile","2024-03-14",0,0,6,0,0,6,0,0
"Chile","2024-03-15",0,0,6,0,0,6,0,0
"Chile","2024-03-16",0,0,6,0,0,6,0,0
"Chile","2024-03-17",0,0,6,0,0,6,0,0
"Chile","2024-03-18",0,0,6,0,0,6,0,0
"Chile","2024-03-19",0,0,6,0,0,6,0,0
"Chile","2024-03-20",0,0,6,0,0,6,0,0
"Chile","2024-03-21",0,0,6,0,0,6,0,0
"Chile","2024-03-22",0,0,6,0,0,6,0,0
"Chile","2024-03-23",0,0,6,0,0,6,0,0
"Chile","2024-03-24",0,0,6,0,0,6,0,0
"Chile","2024-03-25",0,0,6,0,0,6,0,0
"Chile","2024-03-26",0,0,6,0,0,6,0,0
"Chile","2024-03-27",0,0,6,0,0,6,0,0
"Chile","2024-03-28",0,0,6,0,0,6,0,0
"Chile","2024-03-29",0,0,6,0,0,6,0,0
"Chile","2024-03-30",0,0,6,0,0,6,0,0
"Chile","2024-03-31",0,0,6,0,0,6,0,0
"Chile","2024-04-01",0,0,6,0,0,6,0,0
"Chile","2024-04-02",0,0,6,0,0,6,0,0
"Chile","2024-04-03",0,0,6,0,0,6,0,0
"Chile","2024-04-04",0,0,6,0,0,6,0,0
"Chile","2024-04-05",0,0,6,0,0,6,0,0
"Chile","2024-04-06",0,0,6,0,0,6,0,0
"Chile","2024-04-07",0,0,6,0,0,6,0,0
"Chile","2024-04-08",0,0,6,0,0,6,0,0
"Chile","2024-04-09",0,0,6,0,0,6,0,0
"Chile","2024-04-10",0,0,6,0,0,6,0,0
"Chile","2024-04-11",0,0,6,0,0,6,0,0
"Chile","2024-04-12",0,0,6,0,0,6,0,0
"Chile","2024-04-13",0,0,6,0,0,6,0,0
"Chile","2024-04-14",0,0,6,0,0,6,0,0
"Chile","2024-04-15",0,0,6,0,0,6,0,0
"Chile","2024-04-16",0,0,6,0,0,6,0,0
"Chile","2024-04-17",0,0,6,0,0,6,0,0
"Chile","2024-04-18",0,0,6,0,0,6,0,0
"Chile","2024-04-19",0,0,6,0,0,6,0,0
"Chile","2024-04-20",0,0,6,0,0,6,0,0
"Chile","2024-04-21",0,0,6,0,0,6,0,0
"Chile","2024-04-22",0,0,6,0,0,6,0,0
"Chile","2024-04-23",0,0,6,0,0,6,0,0
"Chile","2024-04-24",0,0,6,0,0,6,0,0
"Chile","2024-04-25",0,0,6,0,0,6,0,0
"Chile","2024-04-26",0,0,6,0,0,6,0,0
"Chile","2024-04-27",0,0,6,0,0,6,0,0
"Chile","2024-04-28",0,0,6,0,0,6,0,0
"Chile","2024-04-29",0,0,6,0,0,6,0,0
"Chile","2024-04-30",0,0,6,0,0,6,0,0
"Chile","2024-05-01",0,0,6,0,0,6,0,0
"Chile","2024-05-02",0,0,6,0,0,6,0,0
"Chile","2024-05-03",0,0,6,0,0,6,0,0
"Chile","2024-05-04",0,0,6,0,0,6,0,0
"Chile","2024-05-05",0,0,6,0,0,6,0,0
"Chile","2024-05-06",0,0,6,0,0,6,0,0
"Chile","2024-05-07",0,0,6,0,0,6,0,0
"Chile","2024-05-08",0,0,6,0,0,6,0,0
"Chile","2024-05-09",0,0,6,0,0,6,0,0
"Chile","2024-05-10",0,0,6,0,0,6,0,0
"Chile","2024-05-11",0,0,6,0,0,6,0,0
"Chile","2024-05-12",0,0,6,0,0,6,0,0
"Chile","2024-05-13",0,0,6,0,0,6,0,0
"Chile","2024-05-14",0,0,6,0,0,6,0,0
"Chile","2024-05-15",0,0,6,0,1,7,0,0
"Chile","2024-05-16",0,0,6,0,0,7,0,0
"Chile","2024-05-17",0,0,6,0,0,7,0,0
"Chile","2024-05-18",0,0,6,0,0,7,0,0
"Chile","2024-05-19",0,0,6,0,0,7,0,0
"Chile","2024-05-20",0,0,6,0,0,7,0,0
"Chile","2024-05-21",0,0,6,0,0,7,0,0
"Chile","2024-05-22",0,0,6,0,0,7,0,0
"Chile","2024-05-23",0,0,6,0,0,7,0,0
"Chile","2024-05-24",0,0,6,0,0,7,0,0
"Chile","2024-05-25",0,0,6,0,0,7,0,0
"Chile","2024-05-26",0,0,6,0,0,7,0,0
"Chile","2024-05-27",0,0,6,0,0,7,0,0
"Chile","2024-05-28",0,0,6,0,0,7,0,0
"Chile","2024-05-29",0,0,6,0,0,7,0,0
"Chile","2024-05-30",0,0,6,0,0,7,0,0
"Chile","2024-05-31",0,0,6,0,0,7,0,0
"Chile","2024-06-01",0,0,6,0,0,7,0,0
"Chile","2024-06-02",0,0,6,0,0,7,0,0
"Chile","2024-06-03",0,0,6,0,0,7,0,0
"Chile","2024-06-04",0,0,6,0,0,7,0,0
"Chile","2024-06-05",0,0,6,0,0,7,0,0
"Chile","2024-06-06",0,0,6,0,0,7,0,0
"Chile","2024-06-07",0,0,6,0,0,7,0,0
"Chile","2024-06-08",0,0,6,0,0,7,0,0
"Chile","2024-06-09",0,0,6,0,0,7,0,0
"Chile","2024-06-10",0,0,6,0,0,7,0,0
"Chile","2024-06-11",0,0,6,0,0,7,0,0
"Chile","2024-06-12",0,0,6,0,0,7,0,0
"Chile","2024-06-13",0,0,6,0,0,7,0,0
"Chile","2024-06-14",0,0,6,0,0,7,0,0
"Chile","2024-06-15",0,0,6,0,0,7,0,0
"Chile","2024-06-16",0,0,6,0,0,7,0,0
"Chile","2024-06-17",0,0,6,0,0,7,0,0
"Chile","2024-06-18",0,0,6,0,0,7,0,0
"Chile","2024-06-19",0,0,6,0,0,7,0,0
"Chile","2024-06-20",0,0,6,0,0,7,0,0
"Chile","2024-06-21",0,0,6,0,0,7,0,0
"Chile","2024-06-22",0,0,6,0,0,7,0,0
"Chile","2024-06-23",0,0,6,0,0,7,0,0
"Chile","2024-06-24",0,0,6,0,0,7,0,0
"Chile","2024-06-25",0,0,6,0,0,7,0,0
"Chile","2024-06-26",0,0,6,0,0,7,0,0
"Chile","2024-06-27",0,0,6,0,0,7,0,0
"Chile","2024-06-28",0,0,6,0,0,7,0,0
"Chile","2024-06-29",0,0,6,0,0,7,0,0
"Chile","2024-06-30",0,0,6,0,0,7,0,0
"Chile","2024-07-01",0,0,6,0,0,7,0,0
"Chile","2024-07-02",0,0,6,0,0,7,0,0
"Chile","2024-07-03",0,0,6,0,0,7,0,0
"Chile","2024-07-04",0,0,6,0,0,7,0,0
"Chile","2024-07-05",0,0,6,0,0,7,0,0
"Chile","2024-07-06",0,0,6,0,0,7,0,0
"Chile","2024-07-07",0,0,6,0,0,7,0,0
"Chile","2024-07-08",0,0,6,0,0,7,0,0
"Chile","2024-07-09",0,0,6,0,0,7,0,0
"Chile","2024-07-10",0,0,6,0,0,7,0,0
"Chile","2024-07-11",0,0,6,0,0,7,0,0
"Chile","2024-07-12",0,0,6,0,0,7,0,0
"Chile","2024-07-13",0,0,6,0,0,7,0,0
"Chile","2024-07-14",0,0,6,0,0,7,0,0
"Chile","2024-07-15",0,0,6,0,0,7,0,0
"Chile","2024-07-16",0,0,6,0,0,7,0,0
"Chile","2024-07-17",0,0,6,0,0,7,0,0
"Chile","2024-07-18",0,0,6,0,0,7,0,0
"Chile","2024-07-19",0,0,6,0,0,7,0,0
"Chile","2024-07-20",0,0,6,0,0,7,0,0
"Chile","2024-07-21",0,0,6,0,0,7,0,0
"Chile","2024-07-22",0,0,6,0,0,7,0,0
"Chile","2024-07-23",0,1,7,0,0,7,0,0
"Chile","2024-07-24",0,0,7,0,0,7,0,0
"Chile","2024-07-25",0,0,7,0,0,7,0,0
"Chile","2024-07-26",0,0,7,0,0,7,0,0
"Chile","2024-07-27",0,0,7,0,0,7,0,0
"Chile","2024-07-28",0,0,7,0,0,7,0,0
"Chile","2024-07-29",0,0,7,0,0,7,0,0
"Chile","2024-07-30",0,0,7,0,0,7,0,0
"Chile","2024-07-31",0,0,7,0,0,7,0,0
"Chile","2024-08-01",0,0,7,0,0,7,0,0
"Chile","2024-08-02",0,0,7,0,0,7,0,0
"Chile","2024-08-03",0,0,7,0,0,7,0,0
"Chile","2024-08-04",0,0,7,0,0,7,0,0
"Chile","2024-08-05",0,0,7,0,0,7,0,0
"Chile","2024-08-06",0,0,7,0,0,7,0,0
"Chile","2024-08-07",0,0,7,0,0,7,0,0
"Chile","2024-08-08",0,0,7,0,0,7,0,0
"Chile","2024-08-09",0,0,7,0,0,7,0,0
"Chile","2024-08-10",0,0,7,0,1,8,0,0
"Chile","2024-08-11",0,0,7,0,0,8,0,0
"Chile","2024-08-12",0,0,7,0,0,8,0,0
"Chile","2024-08-13",0,0,7,0,0,8,0,0
"Chile","2024-08-14",0,0,7,0,0,8,0,0
"Chile","2024-08-15",0,0,7,0,0,8,0,0
"Chile","2024-08-16",0,0,7,0,0,8,0,0
"Chile","2024-08-17",0,0,7,0,0,8,0,0
"Chile","2024-08-18",0,0,7,0,0,8,0,0
"Chile","2024-08-19",0,0,7,0,0,8,0,0
"Chile","2024-08-20",0,0,7,0,0,8,0,0
"Chile","2024-08-21",0,0,7,0,0,8,0,0
"Chile","2024-08-22",0,0,7,0,0,8,0,0
"Chile","2024-08-23",0,0,7,0,0,8,0,0
"Chile","2024-08-24",0,0,7,0,0,8,0,0
"Chile","2024-08-25",0,0,7,0,0,8,0,0
"Chile","2024-08-26",0,0,7,0,0,8,0,0
"Chile","2024-08-27",0,1,8,0,0,8,0,0
"Chile","2024-08-28",0,0,8,0,0,8,0,0
"Chile","2024-08-29",0,0,8,0,0,8,0,0
"Chile","2024-08-30",0,0,8,0,0,8,0,0
"Chile","2024-08-31",0,0,8,0,1,9,0,0
"Chile","2024-09-01",0,0,8,0,0,9,0,0
"Chile","2024-09-02",0,0,8,0,0,9,0,0
"Chile","2024-09-03",0,1,9,0,0,9,0,0
"Chile","2024-09-04",0,0,9,0,0,9,0,0
"Chile","2024-09-05",0,0,9,0,0,9,0,0
"Chile","2024-09-06",0,0,9,0,0,9,0,0
"Chile","2024-09-07",0,0,9,0,0,9,0,0
"Chile","2024-09-08",0,0,9,0,0,9,0,0
"Chile","2024-09-09",0,0,9,0,0,9,0,0
"Chile","2024-09-10",0,0,9,0,0,9,0,0
"Chile","2024-09-11",0,0,9,0,0,9,0,0
"Chile","2024-09-12",0,0,9,0,0,9,0,0
"Chile","2024-09-13",0,0,9,0,0,9,0,0
"Chile","2024-09-14",0,0,9,0,1,10,0,0
"Chile","2024-09-15",0,0,9,0,0,10,0,0
"Chile","2024-09-16",0,0,9,0,0,10,0,0
"Chile","2024-09-17",0,0,9,0,0,10,0,0
"Chile","2024-09-18",0,0,9,0,0,10,0,0
"Chile","2024-09-19",0,0,9,0,0,10,0,0
"Chile","2024-09-20",0,0,9,0,0,10,0,0
"Chile","2024-09-21",0,0,9,0,0,10,0,0
"Chile","2024-09-22",0,0,9,0,0,10,0,0
"Chile","2024-09-23",0,0,9,0,0,10,0,0
"Chile","2024-09-24",0,1,10,0,0,10,0,0
"Chile","2024-09-25",0,0,10,0,0,10,0,0
"Chile","2024-09-26",0,0,10,0,0,10,0,0
"Chile","2024-09-27",0,0,10,0,0,10,0,0
"Chile","2024-09-28",0,0,10,0,1,11,0,0
"Chile","2024-09-29",0,0,10,0,0,11,0,0
"Chile","2024-09-30",0,0,10,0,0,11,0,0
"Chile","2024-10-01",0,1,11,0,0,11,0,0
"Chile","2024-10-02",0,0,11,0,0,11,0,0
"Chile","2024-10-03",0,0,11,0,1,12,0,0
"Chile","2024-10-04",0,0,11,0,0,12,0,0
"Chile","2024-10-05",0,0,11,0,0,12,0,0
"Chile","2024-10-06",0,0,11,0,0,12,0,0
"Chile","2024-10-07",0,0,11,0,1,13,0,0
"Chile","2024-10-08",0,2,13,0,0,13,0,0
"Chile","2024-10-09",0,0,13,0,0,13,0,0
"Chile","2024-10-10",0,0,13,0,0,13,0,0
"Chile","2024-10-11",0,0,13,0,0,13,0,0
"Chile","2024-10-12",0,0,13,0,1,14,0,0
"Chile","2024-10-13",0,0,13,0,0,14,0,0
"Chile","2024-10-14",0,0,13,0,0,14,0,0
"Chile","2024-10-15",0,0,13,0,0,14,0,0
"Chile","2024-10-16",0,0,13,0,0,14,0,0
"Chile","2024-10-17",0,0,13,0,0,14,0,0
"Chile","2024-10-18",0,0,13,0,0,14,0,0
"Chile","2024-10-19",0,0,13,0,1,15,0,0
"Chile","2024-10-20",0,0,13,0,0,15,0,0
"Chile","2024-10-21",0,0,13,0,0,15,0,0
"Chile","2024-10-22",0,2,15,0,0,15,0,0
"Chile","2024-10-23",0,0,15,0,1,16,0,0
"Chile","2024-10-24",0,0,15,0,0,16,0,0
"Chile","2024-10-25",0,0,15,0,1,17,0,0
"Chile","2024-10-26",0,0,15,0,0,17,0,0
"Chile","2024-10-27",0,0,15,0,1,18,0,0
"Chile","2024-10-28",0,0,15,0,0,18,0,0
"Chile","2024-10-29",0,4,19,0,1,19,0,0
"Chile","2024-10-30",0,0,19,0,1,20,0,0
"Chile","2024-10-31",0,0,19,0,0,20,0,0
"Chile","2024-11-01",0,0,19,0,1,21,0,0
"Chile","2024-11-02",0,0,19,0,0,21,0,0
"Chile","2024-11-03",0,0,19,0,1,22,0,0
"Chile","2024-11-04",0,0,19,0,0,22,0,0
"Chile","2024-11-05",0,4,23,0,1,23,0,0
"Chile","2024-11-06",0,0,23,0,0,23,0,0
"Chile","2024-11-07",0,0,23,0,1,24,0,0
"Chile","2024-11-08",0,0,23,0,0,24,0,0
"Chile","2024-11-09",0,0,23,0,0,24,0,0
"Chile","2024-11-10",0,0,23,0,0,24,0,0
"Chile","2024-11-11",0,0,23,0,1,25,0,0
"Chile","2024-11-12",0,2,25,0,0,25,0,0
"Chile","2024-11-13",0,0,25,0,0,25,0,0
"Chile","2024-11-14",0,0,25,0,0,25,0,0
"Chile","2024-11-15",0,0,25,0,0,25,0,0
"Chile","2024-11-16",0,0,25,0,1,26,0,0
"Chile","2024-11-17",0,0,25,0,0,26,0,0
"Chile","2024-11-18",0,0,25,0,0,26,0,0
"Chile","2024-11-19",0,1,26,0,0,26,0,0
"Chile","2024-11-20",0,0,26,0,0,26,0,0
"Chile","2024-11-21",0,0,26,0,0,26,0,0
"Chile","2024-11-22",0,0,26,0,0,26,0,0
"Chile","2024-11-23",0,0,26,0,0,26,0,0
"Chile","2024-11-24",0,0,26,0,0,26,0,0
"Chile","2024-11-25",0,0,26,0,0,26,0,0
"Chile","2024-11-26",0,0,26,0,0,26,0,0
"Chile","2024-11-27",0,0,26,0,0,26,0,0
"Chile","2024-11-28",0,0,26,0,0,26,0,0
"Chile","2024-11-29",0,0,26,0,0,26,0,0
"Chile","2024-11-30",0,0,26,0,0,26,0,0
"Chile","2024-12-01",0,0,26,0,0,26,0,0
"Chile","2024-12-02",0,0,26,0,0,26,0,0
"Chile","2024-12-03",0,0,26,0,0,26,0,0
"Chile","2024-12-04",0,0,26,0,0,26,0,0
"Chile","2024-12-05",0,0,26,0,0,26,0,0
"Chile","2024-12-06",0,0,26,0,0,26,0,0
"Chile","2024-12-07",0,0,26,0,0,26,0,0
"Chile","2024-12-08",0,0,26,0,0,26,0,0
"Chile","2024-12-09",0,0,26,0,0,26,0,0
"Chile","2024-12-10",0,0,26,0,0,26,0,0
"Chile","2024-12-11",0,0,26,0,0,26,0,0
"Chile","2024-12-12",0,0,26,0,0,26,0,0
"Chile","2024-12-13",0,0,26,0,0,26,0,0
"Chile","2024-12-14",0,0,26,0,0,26,0,0
"Chile","2024-12-15",0,0,26,0,0,26,0,0
"Chile","2024-12-16",0,0,26,0,0,26,0,0
"Chile","2024-12-17",0,0,26,0,0,26,0,0
"Chile","2024-12-18",0,0,26,0,0,26,0,0
"Chile","2024-12-19",0,0,26,0,0,26,0,0
"Chile","2024-12-20",0,0,26,0,0,26,0,0
"Chile","2024-12-21",0,0,26,0,0,26,0,0
"Chile","2024-12-22",0,0,26,0,0,26,0,0
"Chile","2024-12-23",0,0,26,0,0,26,0,0
"Chile","2024-12-24",0,0,26,0,0,26,0,0
"Chile","2024-12-25",0,0,26,0,0,26,0,0
"Chile","2024-12-26",0,0,26,0,0,26,0,0
"Chile","2024-12-27",0,0,26,0,0,26,0,0
"Chile","2024-12-28",0,0,26,0,0,26,0,0
"Chile","2024-12-29",0,0,26,0,0,26,0,0
"Chile","2024-12-30",0,0,26,0,0,26,0,0
"Chile","2024-12-31",0,0,26,0,0,26,0,0
"Chile","2025-01-01",0,0,26,0,0,26,0,0
"Chile","2025-01-02",0,0,26,0,0,26,0,0
"Chile","2025-01-03",0,0,26,0,0,26,0,0
"Chile","2025-01-04",0,0,26,0,0,26,0,0
"Chile","2025-01-05",0,0,26,0,0,26,0,0
"Chile","2025-01-06",0,0,26,0,0,26,0,0
"Chile","2025-01-07",0,0,26,0,0,26,0,0
"Chile","2025-01-08",0,0,26,0,0,26,0,0
"Chile","2025-01-09",0,0,26,0,0,26,0,0
"Chile","2025-01-10",0,0,26,0,0,26,0,0
"Chile","2025-01-11",0,0,26,0,0,26,0,0
"Chile","2025-01-12",0,0,26,0,0,26,0,0
"Chile","2025-01-13",0,0,26,0,0,26,0,0
"China","2024-01-01",0,0,0,0,0,0,0,0
"China","2024-01-02",0,0,0,0,0,0,0,0
"China","2024-01-03",0,0,0,0,0,0,0,0
"China","2024-01-04",0,0,0,0,0,0,0,0
"China","2024-01-05",0,0,0,0,0,0,0,0
"China","2024-01-06",0,0,0,0,0,0,0,0
"China","2024-01-07",0,0,0,0,0,0,0,0
"China","2024-01-08",0,0,0,0,0,0,0,0
"China","2024-01-09",0,0,0,0,0,0,0,0
"China","2024-01-10",0,0,0,0,0,0,0,0
"China","2024-01-11",0,0,0,0,0,0,0,0
"China","2024-01-12",0,1,1,0,1,1,0,0
"China","2024-01-13",0,0,1,0,0,1,0,0
"China","2024-01-14",0,0,1,0,0,1,0,0
"China","2024-01-15",0,0,1,0,1,2,0,0
"China","2024-01-16",0,0,1,0,0,2,0,0
"China","2024-01-17",0,1,2,0,0,2,0,0
"China","2024-01-18",0,0,2,0,0,2,0,0
"China","2024-01-19",0,0,2,0,0,2,0,0
"China","2024-01-20",0,0,2,0,0,2,0,0
"China","2024-01-21",0,0,2,0,1,3,0,0
"China","2024-01-22",0,0,2,0,0,3,0,0
"China","2024-01-23",0,0,2,0,0,3,0,0
"China","2024-01-24",0,1,3,0,0,3,0,0
"China","2024-01-25",0,0,3,0,14,17,0,0
"China","2024-01-26",0,0,3,0,14,31,0,0
"China","2024-01-27",0,0,3,0,14,45,0,0
"China","2024-01-28",0,0,3,0,13,58,0,0
"China","2024-01-29",0,0,3,0,14,72,0,0
"China","2024-01-30",0,0,3,0,14,86,0,0
"China","2024-01-31",0,97,100,0,14,100,0,0
"China","2024-02-01",0,0,100,0,0,100,0,0
"China","2024-02-02",0,1,101,0,1,101,0,0
"China","2024-02-03",0,0,101,0,0,101,0,0
"China","2024-02-04",0,0,101,0,0,101,0,0
"China","2024-02-05",0,0,101,0,0,101,0,0
"China","2024-02-06",0,0,101,0,0,101,0,0
"China","2024-02-07",0,0,101,0,0,101,0,0
"China","2024-02-08",0,0,101,0,0,101,0,0
"China","2024-02-09",0,0,101,0,1,102,0,0
"China","2024-02-10",0,0,101,0,0,102,0,0
"China","2024-02-11",0,0,101,0,0,102,0,0
"China","2024-02-12",0,0,101,0,0,102,0,0
"China","2024-02-13",0,0,101,0,0,102,0,0
"China","2024-02-14",0,0,101,0,0,102,0,0
"China","2024-02-15",0,1,102,0,0,102,0,0
"China","2024-02-16",0,0,102,0,0,102,0,0
"China","2024-02-17",0,0,102,0,0,102,0,0
"China","2024-02-18",0,0,102,0,0,102,0,0
"China","2024-02-19",0,0,102,0,0,102,0,0
"China","2024-02-20",0,0,102,0,1,103,0,0
"China","2024-02-21",0,0,102,0,0,103,0,0
"China","2024-02-22",0,0,102,0,0,103,0,0
"China","2024-02-23",0,1,103,0,0,103,0,0
"China","2024-02-24",0,0,103,0,12,115,0,0
"China","2024-02-25",0,0,103,0,11,126,0,0
"China","2024-02-26",0,0,103,0,12,138,0,0
"China","2024-02-27",0,0,103,0,12,150,0,0
"China","2024-02-28",0,0,103,0,11,161,0,0
"China","2024-02-29",0,70,173,0,12,173,0,0
"China","2024-03-01",0,3,176,0,3,176,0,0
"China","2024-03-02",0,0,176,0,2,178,0,0
"China","2024-03-03",0,0,176,0,1,179,0,0
"China","2024-03-04",0,0,176,0,2,181,0,0
"China","2024-03-05",0,0,176,0,2,183,0,0
"China","2024-03-06",0,0,176,0,1,184,0,0
"China","2024-03-07",0,0,176,0,2,186,0,0
"China","2024-03-08",0,0,176,0,2,188,0,0
"China","2024-03-09",0,0,176,0,2,190,0,0
"China","2024-03-10",0,0,176,0,1,191,0,0
"China","2024-03-11",0,0,176,0,2,193,0,0
"China","2024-03-12",0,0,176,0,2,195,0,0
"China","2024-03-13",0,0,176,0,1,196,0,0
"China","2024-03-14",0,0,176,0,2,198,0,0
"China","2024-03-15",0,0,176,0,2,200,0,0
"China","2024-03-16",0,0,176,0,2,202,0,0
"China","2024-03-17",0,0,176,0,1,203,0,0
"China","2024-03-18",0,0,176,0,2,205,0,0
"China","2024-03-19",0,0,176,0,2,207,0,0
"China","2024-03-20",0,0,176,0,1,208,0,0
"China","2024-03-21",0,0,176,0,2,210,0,0
"China","2024-03-22",0,0,176,0,2,212,0,0
"China","2024-03-23",0,0,176,0,1,213,0,0
"China","2024-03-24",0,0,176,0,2,215,0,0
"China","2024-03-25",0,0,176,0,2,217,0,0
"China","2024-03-26",0,0,176,0,1,218,0,0
"China","2024-03-27",0,0,176,0,2,220,0,0
"China","2024-03-28",0,0,176,0,2,222,0,0
"China","2024-03-29",0,0,176,0,2,224,0,0
"China","2024-03-30",0,0,176,0,1,225,0,0
"China","2024-03-31",0,51,227,0,2,227,0,0
"China","2024-04-01",0,0,227,0,0,227,0,0
"China","2024-04-02",0,0,227,0,0,227,0,0
"China","2024-04-03",0,0,227,0,1,228,0,0
"China","2024-04-04",0,0,227,0,0,228,0,0
"China","2024-04-05",0,1,228,0,0,228,0,0
"China","2024-04-06",0,0,228,0,0,228,0,0
"China","2024-04-07",0,0,228,0,0,228,0,0
"China","2024-04-08",0,0,228,0,0,228,0,0
"China","2024-04-09",0,0,228,0,1,229,0,0
"China","2024-04-10",0,0,228,0,0,229,0,0
"China","2024-04-11",0,0,228,0,0,229,0,0
"China","2024-04-12",0,1,229,0,0,229,0,0
"China","2024-04-13",0,0,229,0,0,229,0,0
"China","2024-04-14",0,0,229,0,0,229,0,0
"China","2024-04-15",0,0,229,0,0,229,0,0
"China","2024-04-16",0,0,229,0,0,229,0,0
"China","2024-04-17",0,0,229,0,0,229,0,0
"China","2024-04-18",0,0,229,0,0,229,0,0
"China","2024-04-19",0,0,229,0,0,229,0,0
"China","2024-04-20",0,0,229,0,1,230,0,0
"China","2024-04-21",0,0,229,0,0,230,0,0
"China","2024-04-22",0,0,229,0,0,230,0,0
"China","2024-04-23",0,0,229,0,0,230,0,0
"China","2024-04-24",0,0,229,0,0,230,0,0
"China","2024-04-25",0,0,229,0,0,230,0,0
"China","2024-04-26",0,1,230,0,0,230,0,0
"China","2024-04-27",0,0,230,0,10,240,0,0
"China","2024-04-28",0,0,230,0,10,250,0,0
"China","2024-04-29",0,0,230,0,9,259,0,0
"China","2024-04-30",0,39,269,0,10,269,0,0
"China","2024-05-01",0,0,269,0,0,269,0,0
"China","2024-05-02",0,0,269,0,0,269,0,0
"China","2024-05-03",0,0,269,0,0,269,0,0
"China","2024-05-04",0,0,269,0,1,270,0,0
"China","2024-05-05",0,0,269,0,0,270,0,0
"China","2024-05-06",0,0,269,0,0,270,0,0
"China","2024-05-07",0,1,270,0,0,270,0,0
"China","2024-05-08",0,0,270,0,0,270,0,0
"China","2024-05-09",0,0,270,0,0,270,0,0
"China","2024-05-10",0,0,270,0,0,270,0,0
"China","2024-05-11",0,0,270,0,1,271,0,0
"China","2024-05-12",0,0,270,0,0,271,0,0
"China","2024-05-13",0,0,270,0,0,271,0,0
"China","2024-05-14",0,1,271,0,0,271,0,0
"China","2024-05-15",0,0,271,0,0,271,0,0
"China","2024-05-16",0,0,271,0,0,271,0,0
"China","2024-05-17",0,0,271,0,0,271,0,0
"China","2024-05-18",0,0,271,0,0,271,0,0
"China","2024-05-19",0,0,271,0,1,272,0,0
"China","2024-05-20",0,0,271,0,0,272,0,0
"China","2024-05-21",0,0,271,0,0,272,0,0
"China","2024-05-22",0,1,272,0,0,272,0,0
"China","2024-05-23",0,0,272,0,2,274,0,0
"China","2024-05-24",0,3,275,0,1,275,0,0
"China","2024-05-25",0,0,275,0,0,275,0,0
"China","2024-05-26",0,0,275,0,1,276,0,0
"China","2024-05-27",0,1,276,0,0,276,0,0
"China","2024-05-28",0,0,276,0,16,292,0,0
"China","2024-05-29",0,0,276,0,17,309,0,0
"China","2024-05-30",0,49,325,0,16,325,0,0
"China","2024-05-31",0,1,326,0,1,326,0,0
"China","2024-06-01",0,0,326,0,0,326,0,0
"China","2024-06-02",0,0,326,0,0,326,0,0
"China","2024-06-03",0,0,326,0,0,326,0,0
"China","2024-06-04",0,0,326,0,1,327,0,0
"China","2024-06-05",0,0,326,0,0,327,0,0
"China","2024-06-06",0,0,326,0,0,327,0,0
"China","2024-06-07",0,0,326,0,0,327,0,0
"China","2024-06-08",0,0,326,0,0,327,0,0
"China","2024-06-09",0,0,326,0,1,328,0,0
"China","2024-06-10",0,0,326,0,0,328,0,0
"China","2024-06-11",0,0,326,0,0,328,0,0
"China","2024-06-12",0,0,326,0,0,328,0,0
"China","2024-06-13",0,0,326,0,0,328,0,0
"China","2024-06-14",0,0,326,0,0,328,0,0
"China","2024-06-15",0,0,326,0,0,328,0,0
"China","2024-06-16",0,0,326,0,1,329,0,0
"China","2024-06-17",0,0,326,0,0,329,0,0
"China","2024-06-18",0,0,326,0,0,329,0,0
"China","2024-06-19",0,0,326,0,0,329,0,0
"China","2024-06-20",0,0,326,0,0,329,0,0
"China","2024-06-21",0,0,326,0,1,330,0,0
"China","2024-06-22",0,0,326,0,0,330,0,0
"China","2024-06-23",0,0,326,0,0,330,0,0
"China","2024-06-24",0,4,330,0,0,330,0,0
"China","2024-06-25",0,3,333,0,3,333,0,0
"China","2024-06-26",0,0,333,0,10,343,0,0
"China","2024-06-27",0,0,333,0,10,353,0,0
"China","2024-06-28",0,0,333,0,11,364,0,0
"China","2024-06-29",0,0,333,0,10,374,0,0
"China","2024-06-30",0,51,384,0,10,384,0,0
"China","2024-07-01",0,0,384,0,0,384,0,0
"China","2024-07-02",0,0,384,0,0,384,0,0
"China","2024-07-03",0,0,384,0,1,385,0,0
"China","2024-07-04",0,0,384,0,0,385,0,0
"China","2024-07-05",0,0,384,0,0,385,0,0
"China","2024-07-06",0,0,384,0,1,386,0,0
"China","2024-07-07",0,0,384,0,0,386,0,0
"China","2024-07-08",0,2,386,0,0,386,0,0
"China","2024-07-09",0,0,386,0,1,387,0,0
"China","2024-07-10",0,0,386,0,1,388,0,0
"China","2024-07-11",0,0,386,0,0,388,0,0
"China","2024-07-12",0,0,386,0,1,389,0,0
"China","2024-07-13",0,0,386,0,1,390,0,0
"China","2024-07-14",0,0,386,0,0,390,0,0
"China","2024-07-15",0,0,386,0,1,391,0,0
"China","2024-07-16",0,6,392,0,1,392,0,0
"China","2024-07-17",0,0,392,0,1,393,0,0
"China","2024-07-18",0,0,392,0,1,394,0,0
"China","2024-07-19",0,0,392,0,0,394,0,0
"China","2024-07-20",0,0,392,0,1,395,0,0
"China","2024-07-21",0,0,392,0,1,396,0,0
"China","2024-07-22",0,0,392,0,0,396,0,0
"China","2024-07-23",0,0,392,0,1,397,0,0
"China","2024-07-24",0,0,392,0,1,398,0,0
"China","2024-07-25",0,0,392,0,1,399,0,0
"China","2024-07-26",0,0,392,0,1,400,0,0
"China","2024-07-27",0,0,392,0,0,400,0,0
"China","2024-07-28",0,9,401,0,1,401,0,0
"China","2024-07-29",0,0,401,0,20,421,0,0
"China","2024-07-30",0,39,440,0,19,440,0,0
"China","2024-07-31",0,0,440,0,1,441,0,0
"China","2024-08-01",0,0,440,0,0,441,0,0
"China","2024-08-02",0,2,442,0,1,442,0,0
"China","2024-08-03",0,0,442,0,0,442,0,0
"China","2024-08-04",0,0,442,0,1,443,0,0
"China","2024-08-05",0,0,442,0,1,444,0,0
"China","2024-08-06",0,2,444,0,0,444,0,0
"China","2024-08-07",0,0,444,0,1,445,0,0
"China","2024-08-08",0,0,444,0,0,445,0,0
"China","2024-08-09",0,0,444,0,1,446,0,0
"China","2024-08-10",0,0,444,0,1,447,0,0
"China","2024-08-11",0,0,444,0,1,448,0,0
"China","2024-08-12",0,0,444,0,0,448,0,0
"China","2024-08-13",0,5,449,0,1,449,0,0
"China","2024-08-14",0,0,449,0,1,450,0,0
"China","2024-08-15",0,0,449,0,0,450,0,0
"China","2024-08-16",0,0,449,0,1,451,0,0
"China","2024-08-17",0,0,449,0,0,451,0,0
"China","2024-08-18",0,0,449,0,1,452,0,0
"China","2024-08-19",0,0,449,0,0,452,0,0
"China","2024-08-20",0,4,453,0,1,453,0,0
"China","2024-08-21",0,0,453,0,0,453,0,0
"China","2024-08-22",0,0,453,0,0,453,0,0
"China","2024-08-23",0,0,453,0,0,453,0,0
"China","2024-08-24",0,0,453,0,1,454,0,0
"China","2024-08-25",0,0,453,0,0,454,0,0
"China","2024-08-26",0,0,453,0,0,454,0,0
"China","2024-08-27",0,1,454,0,0,454,0,0
"China","2024-08-28",0,0,454,0,12,466,0,0
"China","2024-08-29",0,0,454,0,12,478,0,0
"China","2024-08-30",0,0,454,0,13,491,0,0
"China","2024-08-31",0,49,503,0,12,503,0,0
"China","2024-09-01",0,0,503,0,1,504,0,0
"China","2024-09-02",0,0,503,0,0,504,0,0
"China","2024-09-03",0,0,503,0,1,505,0,0
"China","2024-09-04",0,0,503,0,1,506,0,0
"China","2024-09-05",0,0,503,0,0,506,0,0
"China","2024-09-06",0,0,503,0,1,507,0,0
"China","2024-09-07",0,0,503,0,1,508,0,0
"China","2024-09-08",0,0,503,0,0,508,0,0
"China","2024-09-09",0,0,503,0,1,509,0,0
"China","2024-09-10",0,0,503,0,1,510,0,0
"China","2024-09-11",0,0,503,0,0,510,0,0
"China","2024-09-12",0,0,503,0,1,511,0,0
"China","2024-09-13",0,0,503,0,1,512,0,0
"China","2024-09-14",0,0,503,0,0,512,0,0
"China","2024-09-15",0,10,513,0,1,513,0,0
"China","2024-09-16",0,0,513,0,0,513,0,0
"China","2024-09-17",0,0,513,0,1,514,0,0
"China","2024-09-18",0,0,513,0,0,514,0,0
"China","2024-09-19",0,0,513,0,1,515,0,0
"China","2024-09-20",0,0,513,0,0,515,0,0
"China","2024-09-21",0,0,513,0,0,515,0,0
"China","2024-09-22",0,0,513,0,1,516,0,0
"China","2024-09-23",0,3,516,0,0,516,0,0
"China","2024-09-24",0,0,516,0,1,517,0,0
"China","2024-09-25",0,0,516,0,1,518,0,0
"China","2024-09-26",0,0,516,0,1,519,0,0
"China","2024-09-27",0,0,516,0,1,520,0,0
"China","2024-09-28",0,0,516,0,1,521,0,0
"China","2024-09-29",0,6,522,0,1,522,0,0
"China","2024-09-30",0,0,522,0,3,525,0,0
"China","2024-10-01",0,6,528,0,3,528,0,0
"China","2024-10-02",0,0,528,0,0,528,0,0
"China","2024-10-03",0,1,529,0,1,529,0,0
"China","2024-10-04",0,0,529,0,0,529,0,0
"China","2024-10-05",0,0,529,0,1,530,0,0
"China","2024-10-06",0,0,529,0,0,530,0,0
"China","2024-10-07",0,0,529,0,0,530,0,0
"China","2024-10-08",0,0,529,0,0,530,0,0
"China","2024-10-09",0,0,529,0,1,531,0,0
"China","2024-10-10",0,2,531,0,0,531,0,0
"China","2024-10-11",0,0,531,0,4,535,0,0
"China","2024-10-12",0,0,531,0,4,539,0,0
"China","2024-10-13",0,0,531,0,5,544,0,0
"China","2024-10-14",0,0,531,0,4,548,0,0
"China","2024-10-15",0,0,531,0,4,552,0,0
"China","2024-10-16",0,0,531,0,4,556,0,0
"China","2024-10-17",0,0,531,0,4,560,0,0
"China","2024-10-18",0,0,531,0,4,564,0,0
"China","2024-10-19",0,0,531,0,5,569,0,0
"China","2024-10-20",0,0,531,0,4,573,0,0
"China","2024-10-21",0,46,577,0,4,577,0,0
"China","2024-10-22",0,0,577,0,1,578,0,0
"China","2024-10-23",0,2,579,0,1,579,0,0
"China","2024-10-24",0,0,579,0,1,580,0,0
"China","2024-10-25",0,0,579,0,0,580,0,0
"China","2024-10-26",0,0,579,0,1,581,0,0
"China","2024-10-27",0,0,579,0,1,582,0,0
"China","2024-10-28",0,0,579,0,0,582,0,0
"China","2024-10-29",0,4,583,0,1,583,0,0
"China","2024-10-30",0,0,583,0,0,583,0,0
"China","2024-10-31",0,0,583,0,1,584,0,0
"China","2024-11-01",0,0,583,0,0,584,0,0
"China","2024-11-02",0,0,583,0,1,585,0,0
"China","2024-11-03",0,0,583,0,0,585,0,0
"China","2024-11-04",0,0,583,0,0,585,0,0
"China","2024-11-05",0,0,583,0,1,586,0,0
"China","2024-11-06",0,3,586,0,0,586,0,0
"China","2024-11-07",0,0,586,0,0,586,0,0
"China","2024-11-08",0,0,586,0,1,587,0,0
"China","2024-11-09",0,0,586,0,0,587,0,0
"China","2024-11-10",0,0,586,0,0,587,0,0
"China","2024-11-11",0,0,586,0,1,588,0,0
"China","2024-11-12",0,0,586,0,0,588,0,0
"China","2024-11-13",0,0,586,0,0,588,0,0
"China","2024-11-14",0,0,586,0,1,589,0,0
"China","2024-11-15",0,3,589,0,0,589,0,0
"China","2024-11-16",0,0,589,0,0,589,0,0
"China","2024-11-17",0,0,589,0,0,589,0,0
"China","2024-11-18",0,0,589,0,1,590,0,0
"China","2024-11-19",0,1,590,0,0,590,0,0
"China","2024-11-20",0,0,590,0,19,609,0,0
"China","2024-11-21",0,38,628,0,19,628,0,0
"China","2024-11-22",0,0,628,0,0,628,0,0
"China","2024-11-23",0,0,628,0,0,628,0,0
"China","2024-11-24",0,0,628,0,0,628,0,0
"China","2024-11-25",0,0,628,0,1,629,0,0
"China","2024-11-26",0,0,628,0,0,629,0,0
"China","2024-11-27",0,0,628,0,0,629,0,0
"China","2024-11-28",0,0,628,0,0,629,0,0
"China","2024-11-29",0,0,628,0,0,629,0,0
"China","2024-11-30",0,0,628,0,1,630,0,0
"China","2024-12-01",0,0,628,0,0,630,0,0
"China","2024-12-02",0,0,628,0,0,630,0,0
"China","2024-12-03",0,2,630,0,0,630,0,0
"China","2024-12-04",0,0,630,0,0,630,0,0
"China","2024-12-05",0,0,630,0,0,630,0,0
"China","2024-12-06",0,0,630,0,0,630,0,0
"China","2024-12-07",0,0,630,0,1,631,0,0
"China","2024-12-08",0,0,630,0,0,631,0,0
"China","2024-12-09",0,0,630,0,0,631,0,0
"China","2024-12-10",0,1,631,0,0,631,0,0
"China","2024-12-11",0,0,631,0,0,631,0,0
"China","2024-12-12",0,0,631,0,0,631,0,0
"China","2024-12-13",0,0,631,0,0,631,0,0
"China","2024-12-14",0,0,631,0,0,631,0,0
"China","2024-12-15",0,0,631,0,0,631,0,0
"China","2024-12-16",0,0,631,0,0,631,0,0
"China","2024-12-17",0,0,631,0,0,631,0,0
"China","2024-12-18",0,0,631,0,0,631,0,0
"China","2024-12-19",0,0,631,0,0,631,0,0
"China","2024-12-20",0,0,631,0,0,631,0,0
"China","2024-12-21",0,0,631,0,0,631,0,0
"China","2024-12-22",0,0,631,0,0,631,0,0
"China","2024-12-23",0,0,631,0,0,631,0,0
"China","2024-12-24",0,0,631,0,0,631,0,0
"China","2024-12-25",0,0,631,0,0,631,0,0
"China","2024-12-26",0,0,631,0,0,631,0,0
"China","2024-12-27",0,0,631,0,0,631,0,0
"China","2024-12-28",0,0,631,0,0,631,0,0
"China","2024-12-29",0,0,631,0,0,631,0,0
"China","2024-12-30",0,0,631,0,0,631,0,0
"China","2024-12-31",0,0,631,0,0,631,0,0
"China","2025-01-01",0,0,631,0,0,631,0,0
"China","2025-01-02",0,0,631,0,0,631,0,0
"China","2025-01-03",0,0,631,0,0,631,0,0
"China","2025-01-04",0,0,631,0,0,631,0,0
"China","2025-01-05",0,0,631,0,0,631,0,0
"China","2025-01-06",0,0,631,0,0,631,0,0
"China","2025-01-07",0,0,631,0,0,631,0,0
"China","2025-01-08",0,0,631,0,0,631,0,0
"China","2025-01-09",0,0,631,0,0,631,0,0
"China","2025-01-10",0,0,631,0,0,631,0,0
"China","2025-01-11",0,0,631,0,0,631,0,0
"China","2025-01-12",0,0,631,0,0,631,0,0
"China","2025-01-13",0,0,631,0,0,631,0,0
"Colombia","2024-01-01",0,0,0,0,0,0,0,0
"Colombia","2024-01-02",0,10,10,0,10,10,0,0
"Colombia","2024-01-03",0,0,10,0,1,11,0,0
"Colombia","2024-01-04",0,0,10,0,1,12,0,0
"Colombia","2024-01-05",0,0,10,0,1,13,0,0
"Colombia","2024-01-06",0,0,10,0,2,15,0,0
"Colombia","2024-01-07",0,0,10,0,1,16,0,0
"Colombia","2024-01-08",0,0,10,0,1,17,0,0
"Colombia","2024-01-09",0,8,18,0,1,18,0,0
"Colombia","2024-01-10",0,0,18,0,1,19,0,0
"Colombia","2024-01-11",0,0,18,0,1,20,0,0
"Colombia","2024-01-12",0,0,18,0,1,21,0,0
"Colombia","2024-01-13",0,0,18,0,2,23,0,0
"Colombia","2024-01-14",0,0,18,0,1,24,0,0
"Colombia","2024-01-15",0,0,18,0,1,25,0,0
"Colombia","2024-01-16",0,8,26,0,1,26,0,0
"Colombia","2024-01-17",0,0,26,0,1,27,0,0
"Colombia","2024-01-18",0,0,26,0,1,28,0,0
"Colombia","2024-01-19",0,0,26,0,1,29,0,0
"Colombia","2024-01-20",0,0,26,0,0,29,0,0
"Colombia","2024-01-21",0,0,26,0,1,30,0,0
"Colombia","2024-01-22",0,0,26,0,1,31,0,0
"Colombia","2024-01-23",0,6,32,0,1,32,0,0
"Colombia","2024-01-24",0,0,32,0,1,33,0,0
"Colombia","2024-01-25",0,0,32,0,1,34,0,0
"Colombia","2024-01-26",0,0,32,0,1,35,0,0
"Colombia","2024-01-27",0,0,32,0,2,37,0,0
"Colombia","2024-01-28",0,0,32,0,1,38,0,0
"Colombia","2024-01-29",0,0,32,0,1,39,0,0
"Colombia","2024-01-30",0,8,40,0,1,40,0,0
"Colombia","2024-01-31",0,0,40,0,0,40,0,0
"Colombia","2024-02-01",0,0,40,0,0,40,0,0
"Colombia","2024-02-02",0,0,40,0,0,40,0,0
"Colombia","2024-02-03",0,0,40,0,1,41,0,0
"Colombia","2024-02-04",0,0,40,0,0,41,0,0
"Colombia","2024-02-05",0,0,40,0,0,41,0,0
"Colombia","2024-02-06",0,1,41,0,0,41,0,0
"Colombia","2024-02-07",0,0,41,0,0,41,0,0
"Colombia","2024-02-08",0,0,41,0,0,41,0,0
"Colombia","2024-02-09",0,0,41,0,0,41,0,0
"Colombia","2024-02-10",0,0,41,0,1,42,0,0
"Colombia","2024-02-11",0,0,41,0,0,42,0,0
"Colombia","2024-02-12",0,0,41,0,0,42,0,0
"Colombia","2024-02-13",0,1,42,0,0,42,0,0
"Colombia","2024-02-14",0,0,42,0,1,43,0,0
"Colombia","2024-02-15",0,0,42,0,0,43,0,0
"Colombia","2024-02-16",0,0,42,0,1,44,0,0
"Colombia","2024-02-17",0,0,42,0,0,44,0,0
"Colombia","2024-02-18",0,0,42,0,1,45,0,0
"Colombia","2024-02-19",0,0,42,0,0,45,0,0
"Colombia","2024-02-20",0,4,46,0,1,46,0,0
"Colombia","2024-02-21",0,0,46,0,1,47,0,0
"Colombia","2024-02-22",0,0,46,0,2,49,0,0
"Colombia","2024-02-23",0,0,46,0,1,50,0,0
"Colombia","2024-02-24",0,0,46,0,1,51,0,0
"Colombia","2024-02-25",0,0,46,0,1,52,0,0
"Colombia","2024-02-26",0,0,46,0,2,54,0,0
"Colombia","2024-02-27",0,9,55,0,1,55,0,0
"Colombia","2024-02-28",0,0,55,0,0,55,0,0
"Colombia","2024-02-29",0,0,55,0,1,56,0,0
"Colombia","2024-03-01",0,0,55,0,0,56,0,0
"Colombia","2024-03-02",0,0,55,0,1,57,0,0
"Colombia","2024-03-03",0,0,55,0,0,57,0,0
"Colombia","2024-03-04",0,0,55,0,1,58,0,0
"Colombia","2024-03-05",0,3,58,0,0,58,0,0
"Colombia","2024-03-06",0,0,58,0,1,59,0,0
"Colombia","2024-03-07",0,0,58,0,0,59,0,0
"Colombia","2024-03-08",0,0,58,0,1,60,0,0
"Colombia","2024-03-09",0,0,58,0,0,60,0,0
"Colombia","2024-03-10",0,0,58,0,1,61,0,0
"Colombia","2024-03-11",0,0,58,0,0,61,0,0
"Colombia","2024-03-12",0,4,62,0,1,62,0,0
"Colombia","2024-03-13",0,0,62,0,1,63,0,0
"Colombia","2024-03-14",0,0,62,0,0,63,0,0
"Colombia","2024-03-15",0,0,62,0,1,64,0,0
"Colombia","2024-03-16",0,0,62,0,0,64,0,0
"Colombia","2024-03-17",0,0,62,0,1,65,0,0
"Colombia","2024-03-18",0,0,62,0,0,65,0,0
"Colombia","2024-03-19",0,4,66,0,1,66,0,0
"Colombia","2024-03-20",0,0,66,0,0,66,0,0
"Colombia","2024-03-21",0,0,66,0,1,67,0,0
"Colombia","2024-03-22",0,0,66,0,0,67,0,0
"Colombia","2024-03-23",0,0,66,0,0,67,0,0
"Colombia","2024-03-24",0,0,66,0,0,67,0,0
"Colombia","2024-03-25",0,0,66,0,1,68,0,0
"Colombia","2024-03-26",0,2,68,0,0,68,0,0
"Colombia","2024-03-27",0,0,68,0,1,69,0,0
"Colombia","2024-03-28",0,0,68,0,0,69,0,0
"Colombia","2024-03-29",0,0,68,0,1,70,0,0
"Colombia","2024-03-30",0,0,68,0,1,71,0,0
"Colombia","2024-03-31",0,0,68,0,1,72,0,0
"Colombia","2024-04-01",0,0,68,0,0,72,0,0
"Colombia","2024-04-02",0,5,73,0,1,73,0,0
"Colombia","2024-04-03",0,0,73,0,1,74,0,0
"Colombia","2024-04-04",0,0,73,0,0,74,0,0
"Colombia","2024-04-05",0,0,73,0,1,75,0,0
"Colombia","2024-04-06",0,0,73,0,1,76,0,0
"Colombia","2024-04-07",0,0,73,0,1,77,0,0
"Colombia","2024-04-08",0,0,73,0,0,77,0,0
"Colombia","2024-04-09",0,5,78,0,1,78,0,0
"Colombia","2024-04-10",0,0,78,0,0,78,0,0
"Colombia","2024-04-11",0,0,78,0,1,79,0,0
"Colombia","2024-04-12",0,0,78,0,0,79,0,0
"Colombia","2024-04-13",0,0,78,0,1,80,0,0
"Colombia","2024-04-14",0,0,78,0,0,80,0,0
"Colombia","2024-04-15",0,0,78,0,1,81,0,0
"Colombia","2024-04-16",0,3,81,0,0,81,0,0
"Colombia","2024-04-17",0,0,81,0,1,82,0,0
"Colombia","2024-04-18",0,0,81,0,2,84,0,0
"Colombia","2024-04-19",0,0,81,0,1,85,0,0
"Colombia","2024-04-20",0,0,81,0,1,86,0,0
"Colombia","2024-04-21",0,0,81,0,1,87,0,0
"Colombia","2024-04-22",0,0,81,0,2,89,0,0
"Colombia","2024-04-23",0,9,90,0,1,90,0,0
"Colombia","2024-04-24",0,0,90,0,0,90,0,0
"Colombia","2024-04-25",0,0,90,0,1,91,0,0
"Colombia","2024-04-26",0,0,90,0,0,91,0,0
"Colombia","2024-04-27",0,0,90,0,0,91,0,0
"Colombia","2024-04-28",0,0,90,0,0,91,0,0
"Colombia","2024-04-29",0,0,90,0,1,92,0,0
"Colombia","2024-04-30",0,2,92,0,0,92,0,0
"Colombia","2024-05-01",0,0,92,0,0,92,0,0
"Colombia","2024-05-02",0,0,92,0,0,92,0,0
"Colombia","2024-05-03",0,0,92,0,0,92,0,0
"Colombia","2024-05-04",0,0,92,0,1,93,0,0
"Colombia","2024-05-05",0,0,92,0,0,93,0,0
"Colombia","2024-05-06",0,0,92,0,0,93,0,0
"Colombia","2024-05-07",0,0,92,0,0,93,0,0
"Colombia","2024-05-08",0,0,92,0,0,93,0,0
"Colombia","2024-05-09",0,0,92,0,0,93,0,0
"Colombia","2024-05-10",0,0,92,0,0,93,0,0
"Colombia","2024-05-11",0,0,92,0,1,94,0,0
"Colombia","2024-05-12",0,0,92,0,0,94,0,0
"Colombia","2024-05-13",0,0,92,0,0,94,0,0
"Colombia","2024-05-14",0,2,94,0,0,94,0,0
"Colombia","2024-05-15",0,0,94,0,0,94,0,0
"Colombia","2024-05-16",0,0,94,0,1,95,0,0
"Colombia","2024-05-17",0,0,94,0,0,95,0,0
"Colombia","2024-05-18",0,0,94,0,0,95,0,0
"Colombia","2024-05-19",0,0,94,0,0,95,0,0
"Colombia","2024-05-20",0,0,94,0,1,96,0,0
"Colombia","2024-05-21",0,2,96,0,0,96,0,0
"Colombia","2024-05-22",0,0,96,0,0,96,0,0
"Colombia","2024-05-23",0,0,96,0,0,96,0,0
"Colombia","2024-05-24",0,0,96,0,0,96,0,0
"Colombia","2024-05-25",0,0,96,0,1,97,0,0
"Colombia","2024-05-26",0,0,96,0,0,97,0,0
"Colombia","2024-05-27",0,0,96,0,0,97,0,0
"Colombia","2024-05-28",0,0,96,0,0,97,0,0
"Colombia","2024-05-29",0,0,96,0,0,97,0,0
"Colombia","2024-05-30",0,0,96,0,0,97,0,0
"Colombia","2024-05-31",0,0,96,0,0,97,0,0
"Colombia","2024-06-01",0,0,96,0,1,98,0,0
"Colombia","2024-06-02",0,0,96,0,0,98,0,0
"Colombia","2024-06-03",0,0,96,0,0,98,0,0
"Colombia","2024-06-04",0,2,98,0,0,98,0,0
"Colombia","2024-06-05",0,0,98,0,1,99,0,0
"Colombia","2024-06-06",0,0,98,0,0,99,0,0
"Colombia","2024-06-07",0,0,98,0,1,100,0,0
"Colombia","2024-06-08",0,0,98,0,0,100,0,0
"Colombia","2024-06-09",0,0,98,0,1,101,0,0
"Colombia","2024-06-10",0,0,98,0,0,101,0,0
"Colombia","2024-06-11",0,4,102,0,1,102,0,0
"Colombia","2024-06-12",0,0,102,0,0,102,0,0
"Colombia","2024-06-13",0,0,102,0,1,103,0,0
"Colombia","2024-06-14",0,0,102,0,0,103,0,0
"Colombia","2024-06-15",0,0,102,0,0,103,0,0
"Colombia","2024-06-16",0,0,102,0,0,103,0,0
"Colombia","2024-06-17",0,0,102,0,1,104,0,0
"Colombia","2024-06-18",0,2,104,0,0,104,0,0
"Colombia","2024-06-19",0,0,104,0,0,104,0,0
"Colombia","2024-06-20",0,0,104,0,1,105,0,0
"Colombia","2024-06-21",0,0,104,0,0,105,0,0
"Colombia","2024-06-22",0,0,104,0,0,105,0,0
"Colombia","2024-06-23",0,0,104,0,0,105,0,0
"Colombia","2024-06-24",0,0,104,0,1,106,0,0
"Colombia","2024-06-25",0,0,104,0,0,106,0,0
"Colombia","2024-06-26",0,0,104,0,0,106,0,0
"Colombia","2024-06-27",0,0,104,0,1,107,0,0
"Colombia","2024-06-28",0,0,104,0,0,107,0,0
"Colombia","2024-06-29",0,0,104,0,0,107,0,0
"Colombia","2024-06-30",0,0,104,0,0,107,0,0
"Colombia","2024-07-01",0,0,104,0,1,108,0,0
"Colombia","2024-07-02",0,4,108,0,0,108,0,0
"Colombia","2024-07-03",0,0,108,0,0,108,0,0
"Colombia","2024-07-04",0,0,108,0,1,109,0,0
"Colombia","2024-07-05",0,0,108,0,0,109,0,0
"Colombia","2024-07-06",0,0,108,0,0,109,0,0
"Colombia","2024-07-07",0,0,108,0,0,109,0,0
"Colombia","2024-07-08",0,0,108,0,1,110,0,0
"Colombia","2024-07-09",0,2,110,0,0,110,0,0
"Colombia","2024-07-10",0,0,110,0,0,110,0,0
"Colombia","2024-07-11",0,0,110,0,1,111,0,0
"Colombia","2024-07-12",0,0,110,0,0,111,0,0
"Colombia","2024-07-13",0,0,110,0,1,112,0,0
"Colombia","2024-07-14",0,0,110,0,0,112,0,0
"Colombia","2024-07-15",0,0,110,0,1,113,0,0
"Colombia","2024-07-16",0,3,113,0,0,113,0,0
"Colombia","2024-07-17",0,0,113,0,0,113,0,0
"Colombia","2024-07-18",0,0,113,0,0,113,0,0
"Colombia","2024-07-19",0,0,113,0,0,113,0,0
"Colombia","2024-07-20",0,0,113,0,0,113,0,0
"Colombia","2024-07-21",0,0,113,0,0,113,0,0
"Colombia","2024-07-22",0,0,113,0,0,113,0,0
"Colombia","2024-07-23",0,0,113,0,0,113,0,0
"Colombia","2024-07-24",0,0,113,0,1,114,0,0
"Colombia","2024-07-25",0,0,113,0,0,114,0,0
"Colombia","2024-07-26",0,0,113,0,0,114,0,0
"Colombia","2024-07-27",0,0,113,0,0,114,0,0
"Colombia","2024-07-28",0,0,113,0,0,114,0,0
"Colombia","2024-07-29",0,0,113,0,0,114,0,0
"Colombia","2024-07-30",0,1,114,0,0,114,0,0
"Colombia","2024-07-31",0,0,114,0,0,114,0,0
"Colombia","2024-08-01",0,0,114,0,1,115,0,0
"Colombia","2024-08-02",0,0,114,0,0,115,0,0
"Colombia","2024-08-03",0,0,114,0,0,115,0,0
"Colombia","2024-08-04",0,0,114,0,0,115,0,0
"Colombia","2024-08-05",0,0,114,0,1,116,0,0
"Colombia","2024-08-06",0,2,116,0,0,116,0,0
"Colombia","2024-08-07",0,0,116,0,0,116,0,0
"Colombia","2024-08-08",0,0,116,0,0,116,0,0
"Colombia","2024-08-09",0,0,116,0,0,116,0,0
"Colombia","2024-08-10",0,0,116,0,1,117,0,0
"Colombia","2024-08-11",0,0,116,0,0,117,0,0
"Colombia","2024-08-12",0,0,116,0,0,117,0,0
"Colombia","2024-08-13",0,0,116,0,0,117,0,0
"Colombia","2024-08-14",0,0,116,0,0,117,0,0
"Colombia","2024-08-15",0,0,116,0,0,117,0,0
"Colombia","2024-08-16",0,0,116,0,0,117,0,0
"Colombia","2024-08-17",0,0,116,0,1,118,0,0
"Colombia","2024-08-18",0,0,116,0,0,118,0,0
"Colombia","2024-08-19",0,0,116,0,0,118,0,0
"Colombia","2024-08-20",0,2,118,0,0,118,0,0
"Colombia","2024-08-21",0,0,118,0,0,118,0,0
"Colombia","2024-08-22",0,0,118,0,1,119,0,0
"Colombia","2024-08-23",0,0,118,0,0,119,0,0
"Colombia","2024-08-24",0,0,118,0,1,120,0,0
"Colombia","2024-08-25",0,0,118,0,0,120,0,0
"Colombia","2024-08-26",0,0,118,0,1,121,0,0
"Colombia","2024-08-27",0,3,121,0,0,121,0,0
"Colombia","2024-08-28",0,0,121,0,0,121,0,0
"Colombia","2024-08-29",0,0,121,0,0,121,0,0
"Colombia","2024-08-30",0,0,121,0,0,121,0,0
"Colombia","2024-08-31",0,0,121,0,0,121,0,0
"Colombia","2024-09-01",0,0,121,0,0,121,0,0
"Colombia","2024-09-02",0,0,121,0,1,122,0,0
"Colombia","2024-09-03",0,0,121,0,0,122,0,0
"Colombia","2024-09-04",0,0,121,0,0,122,0,0
"Colombia","2024-09-05",0,0,121,0,0,122,0,0
"Colombia","2024-09-06",0,0,121,0,0,122,0,0
"Colombia","2024-09-07",0,0,121,0,0,122,0,0
"Colombia","2024-09-08",0,0,121,0,0,122,0,0
"Colombia","2024-09-09",0,0,121,0,0,122,0,0
"Colombia","2024-09-10",0,0,121,0,0,122,0,0
"Colombia","2024-09-11",0,0,121,0,0,122,0,0
"Colombia","2024-09-12",0,0,121,0,1,123,0,0
"Colombia","2024-09-13",0,0,121,0,0,123,0,0
"Colombia","2024-09-14",0,0,121,0,0,123,0,0
"Colombia","2024-09-15",0,0,121,0,0,123,0,0
"Colombia","2024-09-16",0,0,121,0,0,123,0,0
"Colombia","2024-09-17",0,2,123,0,0,123,0,0
"Colombia","2024-09-18",0,0,123,0,0,123,0,0
"Colombia","2024-09-19",0,0,123,0,0,123,0,0
"Colombia","2024-09-20",0,0,123,0,0,123,0,0
"Colombia","2024-09-21",0,0,123,0,1,124,0,0
"Colombia","2024-09-22",0,0,123,0,0,124,0,0
"Colombia","2024-09-23",0,0,123,0,0,124,0,0
"Colombia","2024-09-24",0,1,124,0,0,124,0,0
"Colombia","2024-09-25",0,0,124,0,0,124,0,0
"Colombia","2024-09-26",0,0,124,0,0,124,0,0
"Colombia","2024-09-27",0,0,124,0,1,125,0,0
"Colombia","2024-09-28",0,0,124,0,0,125,0,0
"Colombia","2024-09-29",0,0,124,0,0,125,0,0
"Colombia","2024-09-30",0,0,124,0,0,125,0,0
"Colombia","2024-10-01",0,0,124,0,1,126,0,0
"Colombia","2024-10-02",0,0,124,0,0,126,0,0
"Colombia","2024-10-03",0,0,124,0,0,126,0,0
"Colombia","2024-10-04",0,0,124,0,0,126,0,0
"Colombia","2024-10-05",0,0,124,0,0,126,0,0
"Colombia","2024-10-06",0,0,124,0,1,127,0,0
"Colombia","2024-10-07",0,0,124,0,0,127,0,0
"Colombia","2024-10-08",0,3,127,0,0,127,0,0
"Colombia","2024-10-09",0,0,127,0,0,127,0,0
"Colombia","2024-10-10",0,0,127,0,1,128,0,0
"Colombia","2024-10-11",0,0,127,0,0,128,0,0
"Colombia","2024-10-12",0,0,127,0,1,129,0,0
"Colombia","2024-10-13",0,0,127,0,0,129,0,0
"Colombia","2024-10-14",0,0,127,0,1,130,0,0
"Colombia","2024-10-15",0,3,130,0,0,130,0,0
"Colombia","2024-10-16",0,0,130,0,0,130,0,0
"Colombia","2024-10-17",0,0,130,0,0,130,0,0
"Colombia","2024-10-18",0,0,130,0,0,130,0,0
"Colombia","2024-10-19",0,0,130,0,1,131,0,0
"Colombia","2024-10-20",0,0,130,0,0,131,0,0
"Colombia","2024-10-21",0,0,130,0,0,131,0,0
"Colombia","2024-10-22",0,1,131,0,0,131,0,0
"Colombia","2024-10-23",0,0,131,0,0,131,0,0
"Colombia","2024-10-24",0,0,131,0,0,131,0,0
"Colombia","2024-10-25",0,0,131,0,0,131,0,0
"Colombia","2024-10-26",0,0,131,0,0,131,0,0
"Colombia","2024-10-27",0,0,131,0,0,131,0,0
"Colombia","2024-10-28",0,0,131,0,0,131,0,0
"Colombia","2024-10-29",0,0,131,0,0,131,0,0
"Colombia","2024-10-30",0,0,131,0,1,132,0,0
"Colombia","2024-10-31",0,0,131,0,0,132,0,0
"Colombia","2024-11-01",0,0,131,0,0,132,0,0
"Colombia","2024-11-02",0,0,131,0,0,132,0,0
"Colombia","2024-11-03",0,0,131,0,0,132,0,0
"Colombia","2024-11-04",0,0,131,0,0,132,0,0
"Colombia","2024-11-05",0,1,132,0,0,132,0,0
"Colombia","2024-11-06",0,0,132,0,0,132,0,0
"Colombia","2024-11-07",0,0,132,0,0,132,0,0
"Colombia","2024-11-08",0,0,132,0,0,132,0,0
"Colombia","2024-11-09",0,0,132,0,0,132,0,0
"Colombia","2024-11-10",0,0,132,0,0,132,0,0
"Colombia","2024-11-11",0,0,132,0,0,132,0,0
"Colombia","2024-11-12",0,0,132,0,0,132,0,0
"Colombia","2024-11-13",0,0,132,0,0,132,0,0
"Colombia","2024-11-14",0,0,132,0,0,132,0,0
"Colombia","2024-11-15",0,0,132,0,0,132,0,0
"Colombia","2024-11-16",0,0,132,0,0,132,0,0
"Colombia","2024-11-17",0,0,132,0,0,132,0,0
"Colombia","2024-11-18",0,0,132,0,0,132,0,0
"Colombia","2024-11-19",0,0,132,0,0,132,0,0
"Colombia","2024-11-20",0,0,132,0,0,132,0,0
"Colombia","2024-11-21",0,0,132,0,0,132,0,0
"Colombia","2024-11-22",0,0,132,0,0,132,0,0
"Colombia","2024-11-23",0,0,132,0,0,132,0,0
"Colombia","2024-11-24",0,0,132,0,0,132,0,0
"Colombia","2024-11-25",0,0,132,0,0,132,0,0
"Colombia","2024-11-26",0,0,132,0,0,132,0,0
"Colombia","2024-11-27",0,0,132,0,0,132,0,0
"Colombia","2024-11-28",0,0,132,0,0,132,0,0
"Colombia","2024-11-29",0,0,132,0,0,132,0,0
"Colombia","2024-11-30",0,0,132,0,0,132,0,0
"Colombia","2024-12-01",0,0,132,0,0,132,0,0
"Colombia","2024-12-02",0,0,132,0,0,132,0,0
"Colombia","2024-12-03",0,0,132,0,0,132,0,0
"Colombia","2024-12-04",0,0,132,0,0,132,0,0
"Colombia","2024-12-05",0,0,132,0,0,132,0,0
"Colombia","2024-12-06",0,0,132,0,0,132,0,0
"Colombia","2024-12-07",0,0,132,0,0,132,0,0
"Colombia","2024-12-08",0,0,132,0,0,132,0,0
"Colombia","2024-12-09",0,0,132,0,0,132,0,0
"Colombia","2024-12-10",0,0,132,0,0,132,0,0
"Colombia","2024-12-11",0,0,132,0,0,132,0,0
"Colombia","2024-12-12",0,0,132,0,0,132,0,0
"Colombia","2024-12-13",0,0,132,0,0,132,0,0
"Colombia","2024-12-14",0,0,132,0,0,132,0,0
"Colombia","2024-12-15",0,0,132,0,0,132,0,0
"Colombia","2024-12-16",0,0,132,0,0,132,0,0
"Colombia","2024-12-17",0,0,132,0,0,132,0,0
"Colombia","2024-12-18",0,0,132,0,0,132,0,0
"Colombia","2024-12-19",0,0,132,0,0,132,0,0
"Colombia","2024-12-20",0,0,132,0,0,132,0,0
"Colombia","2024-12-21",0,0,132,0,0,132,0,0
"Colombia","2024-12-22",0,0,132,0,0,132,0,0
"Colombia","2024-12-23",0,0,132,0,0,132,0,0
"Colombia","2024-12-24",0,0,132,0,0,132,0,0
"Colombia","2024-12-25",0,0,132,0,0,132,0,0
"Colombia","2024-12-26",0,0,132,0,0,132,0,0
"Colombia","2024-12-27",0,0,132,0,0,132,0,0
"Colombia","2024-12-28",0,0,132,0,0,132,0,0
"Colombia","2024-12-29",0,0,132,0,0,132,0,0
"Colombia","2024-12-30",0,0,132,0,0,132,0,0
"Colombia","2024-12-31",0,0,132,0,0,132,0,0
"Colombia","2025-01-01",0,0,132,0,0,132,0,0
"Colombia","2025-01-02",0,0,132,0,0,132,0,0
"Colombia","2025-01-03",0,0,132,0,0,132,0,0
"Colombia","2025-01-04",0,0,132,0,0,132,0,0
"Colombia","2025-01-05",0,0,132,0,0,132,0,0
"Colombia","2025-01-06",0,0,132,0,0,132,0,0
"Colombia","2025-01-07",0,0,132,0,0,132,0,0
"Colombia","2025-01-08",0,0,132,0,0,132,0,0
"Colombia","2025-01-09",0,0,132,0,0,132,0,0
"Colombia","2025-01-10",0,0,132,0,0,132,0,0
"Colombia","2025-01-11",0,0,132,0,0,132,0,0
"Colombia","2025-01-12",0,0,132,0,0,132,0,0
"Colombia","2025-01-13",0,0,132,0,0,132,0,0
"Congo","2024-01-01",0,0,0,0,0,0,0,0
"Congo","2024-01-02",0,0,0,0,0,0,0,0
"Congo","2024-01-03",0,0,0,0,0,0,0,0
"Congo","2024-01-04",0,0,0,0,0,0,0,0
"Congo","2024-01-05",0,0,0,0,0,0,0,0
"Congo","2024-01-06",0,0,0,0,0,0,0,0
"Congo","2024-01-07",0,0,0,0,0,0,0,0
"Congo","2024-01-08",0,0,0,0,0,0,0,0
"Congo","2024-01-09",0,0,0,0,0,0,0,0
"Congo","2024-01-10",0,0,0,0,0,0,0,0
"Congo","2024-01-11",0,0,0,0,0,0,0,0
"Congo","2024-01-12",0,0,0,0,0,0,0,0
"Congo","2024-01-13",0,0,0,0,0,0,0,0
"Congo","2024-01-14",0,1,1,0,1,1,0,0
"Congo","2024-01-15",0,0,1,0,0,1,0,0
"Congo","2024-01-16",0,0,1,0,0,1,0,0
"Congo","2024-01-17",0,0,1,0,0,1,0,0
"Congo","2024-01-18",0,0,1,0,1,2,0,0
"Congo","2024-01-19",0,0,1,0,0,2,0,0
"Congo","2024-01-20",0,0,1,0,0,2,0,0
"Congo","2024-01-21",0,1,2,0,0,2,0,0
"Congo","2024-01-22",0,0,2,0,0,2,0,0
"Congo","2024-01-23",0,0,2,0,1,3,0,0
"Congo","2024-01-24",0,0,2,0,0,3,0,0
"Congo","2024-01-25",0,0,2,0,0,3,0,0
"Congo","2024-01-26",0,0,2,0,0,3,0,0
"Congo","2024-01-27",0,0,2,0,1,4,0,0
"Congo","2024-01-28",0,2,4,0,0,4,0,0
"Congo","2024-01-29",0,0,4,0,0,4,0,0
"Congo","2024-01-30",0,0,4,0,0,4,0,0
"Congo","2024-01-31",0,0,4,0,1,5,0,0
"Congo","2024-02-01",0,0,4,0,0,5,0,0
"Congo","2024-02-02",0,0,4,0,0,5,0,0
"Congo","2024-02-03",0,0,4,0,0,5,0,0
"Congo","2024-02-04",0,0,4,0,1,6,0,0
"Congo","2024-02-05",0,0,4,0,0,6,0,0
"Congo","2024-02-06",0,0,4,0,0,6,0,0
"Congo","2024-02-07",0,0,4,0,0,6,0,0
"Congo","2024-02-08",0,0,4,0,1,7,0,0
"Congo","2024-02-09",0,0,4,0,0,7,0,0
"Congo","2024-02-10",0,0,4,0,0,7,0,0
"Congo","2024-02-11",0,0,4,0,0,7,0,0
"Congo","2024-02-12",0,0,4,0,1,8,0,0
"Congo","2024-02-13",0,0,4,0,0,8,0,0
"Congo","2024-02-14",0,0,4,0,0,8,0,0
"Congo","2024-02-15",0,0,4,0,0,8,0,0
"Congo","2024-02-16",0,0,4,0,1,9,0,0
"Congo","2024-02-17",0,0,4,0,0,9,0,0
"Congo","2024-02-18",0,5,9,0,0,9,0,0
"Congo","2024-02-19",0,0,9,0,0,9,0,0
"Congo","2024-02-20",0,0,9,0,1,10,0,0
"Congo","2024-02-21",0,0,9,0,0,10,0,0
"Congo","2024-02-22",0,0,9,0,0,10,0,0
"Congo","2024-02-23",0,0,9,0,0,10,0,0
"Congo","2024-02-24",0,0,9,0,1,11,0,0
"Congo","2024-02-25",0,2,11,0,0,11,0,0
"Congo","2024-02-26",0,0,11,0,1,12,0,0
"Congo","2024-02-27",0,0,11,0,0,12,0,0
"Congo","2024-02-28",0,0,11,0,1,13,0,0
"Congo","2024-02-29",0,0,11,0,0,13,0,0
"Congo","2024-03-01",0,0,11,0,1,14,0,0
"Congo","2024-03-02",0,0,11,0,0,14,0,0
"Congo","2024-03-03",0,0,11,0,1,15,0,0
"Congo","2024-03-04",0,0,11,0,1,16,0,0
"Congo","2024-03-05",0,0,11,0,0,16,0,0
"Congo","2024-03-06",0,0,11,0,1,17,0,0
"Congo","2024-03-07",0,0,11,0,0,17,0,0
"Congo","2024-03-08",0,0,11,0,1,18,0,0
"Congo","2024-03-09",0,0,11,0,0,18,0,0
"Congo","2024-03-10",0,8,19,0,1,19,0,0
"Congo","2024-03-11",0,0,19,0,0,19,0,0
"Congo","2024-03-12",0,0,19,0,0,19,0,0
"Congo","2024-03-13",0,0,19,0,0,19,0,0
"Congo","2024-03-14",0,0,19,0,0,19,0,0
"Congo","2024-03-15",0,0,19,0,0,19,0,0
"Congo","2024-03-16",0,0,19,0,0,19,0,0
"Congo","2024-03-17",24,0,19,24,0,19,24,24
"Congo","2024-03-18",0,0,19,24,0,19,1,25
"Congo","2024-03-19",0,0,19,24,0,19,1,26
"Congo","2024-03-20",0,0,19,24,0,19,1,27
"Congo","2024-03-21",0,0,19,24,0,19,0,27
"Congo","2024-03-22",0,0,19,24,0,19,1,28
"Congo","2024-03-23",0,0,19,24,0,19,1,29
"Congo","2024-03-24",0,0,19,24,0,19,1,30
"Congo","2024-03-25",0,0,19,24,0,19,1,31
"Congo","2024-03-26",0,0,19,24,0,19,1,32
"Congo","2024-03-27",0,0,19,24,0,19,0,32
"Congo","2024-03-28",0,0,19,24,0,19,1,33
"Congo","2024-03-29",0,0,19,24,0,19,1,34
"Congo","2024-03-30",0,0,19,24,0,19,1,35
"Congo","2024-03-31",0,0,19,24,0,19,1,36
"Congo","2024-04-01",0,0,19,24,0,19,1,37
"Congo","2024-04-02",0,0,19,24,0,19,1,38
"Congo","2024-04-03",0,0,19,24,0,19,0,38
"Congo","2024-04-04",0,0,19,24,0,19,1,39
"Congo","2024-04-05",0,0,19,24,0,19,1,40
"Congo","2024-04-06",17,0,19,41,0,19,1,41
"Congo","2024-04-07",0,0,19,41,0,19,0,41
"Congo","2024-04-08",0,0,19,41,0,19,1,42
"Congo","2024-04-09",0,0,19,41,0,19,1,43
"Congo","2024-04-10",0,0,19,41,0,19,0,43
"Congo","2024-04-11",0,0,19,41,0,19,0,43
"Congo","2024-04-12",0,0,19,41,0,19,1,44
"Congo","2024-04-13",0,0,19,41,0,19,1,45
"Congo","2024-04-14",0,0,19,41,0,19,0,45
"Congo","2024-04-15",0,0,19,41,0,19,0,45
"Congo","2024-04-16",0,0,19,41,0,19,1,46
"Congo","2024-04-17",0,0,19,41,0,19,1,47
"Congo","2024-04-18",0,0,19,41,1,20,0,47
"Congo","2024-04-19",0,0,19,41,0,20,0,47
"Congo","2024-04-20",0,0,19,41,0,20,1,48
"Congo","2024-04-21",0,0,19,41,0,20,1,49
"Congo","2024-04-22",0,0,19,41,0,20,0,49
"Congo","2024-04-23",0,0,19,41,0,20,0,49
"Congo","2024-04-24",0,0,19,41,0,20,1,50
"Congo","2024-04-25",0,0,19,41,0,20,1,51
"Congo","2024-04-26",0,0,19,41,0,20,0,51
"Congo","2024-04-27",0,0,19,41,0,20,0,51
"Congo","2024-04-28",0,0,19,41,0,20,1,52
"Congo","2024-04-29",0,0,19,41,0,20,1,53
"Congo","2024-04-30",0,0,19,41,0,20,0,53
"Congo","2024-05-01",0,0,19,41,0,20,0,53
"Congo","2024-05-02",0,0,19,41,0,20,1,54
"Congo","2024-05-03",0,0,19,41,0,20,1,55
"Congo","2024-05-04",0,0,19,41,0,20,0,55
"Congo","2024-05-05",0,0,19,41,0,20,0,55
"Congo","2024-05-06",0,0,19,41,0,20,1,56
"Congo","2024-05-07",0,0,19,41,0,20,1,57
"Congo","2024-05-08",0,0,19,41,0,20,0,57
"Congo","2024-05-09",0,0,19,41,0,20,0,57
"Congo","2024-05-10",0,0,19,41,0,20,1,58
"Congo","2024-05-11",0,0,19,41,0,20,1,59
"Congo","2024-05-12",18,0,19,59,0,20,0,59
"Congo","2024-05-13",0,0,19,59,0,20,2,61
"Congo","2024-05-14",0,0,19,59,0,20,1,62
"Congo","2024-05-15",0,0,19,59,0,20,1,63
"Congo","2024-05-16",0,0,19,59,0,20,2,65
"Congo","2024-05-17",0,0,19,59,0,20,2,67
"Congo","2024-05-18",9,0,19,68,0,20,1,68
"Congo","2024-05-19",0,0,19,68,0,20,2,70
"Congo","2024-05-20",0,0,19,68,0,20,1,71
"Congo","2024-05-21",0,0,19,68,0,20,2,73
"Congo","2024-05-22",0,0,19,68,0,20,1,74
"Congo","2024-05-23",0,0,19,68,0,20,2,76
"Congo","2024-05-24",0,0,19,68,0,20,1,77
"Congo","2024-05-25",0,0,19,68,0,20,2,79
"Congo","2024-05-26",0,0,19,68,0,20,2,81
"Congo","2024-05-27",0,0,19,68,0,20,1,82
"Congo","2024-05-28",0,0,19,68,0,20,2,84
"Congo","2024-05-29",0,0,19,68,0,20,1,85
"Congo","2024-05-30",0,0,19,68,0,20,2,87
"Congo","2024-05-31",0,0,19,68,0,20,1,88
"Congo","2024-06-01",22,0,19,90,0,20,2,90
"Congo","2024-06-02",0,0,19,90,0,20,1,91
"Congo","2024-06-03",0,0,19,90,0,20,1,92
"Congo","2024-06-04",0,0,19,90,0,20,1,93
"Congo","2024-06-05",0,0,19,90,0,20,2,95
"Congo","2024-06-06",0,0,19,90,0,20,1,96
"Congo","2024-06-07",0,0,19,90,0,20,1,97
"Congo","2024-06-08",0,0,19,90,0,20,1,98
"Congo","2024-06-09",0,0,19,90,0,20,1,99
"Congo","2024-06-10",0,0,19,90,0,20,1,100
"Congo","2024-06-11",0,0,19,90,0,20,1,101
"Congo","2024-06-12",0,0,19,90,0,20,2,103
"Congo","2024-06-13",0,0,19,90,0,20,1,104
"Congo","2024-06-14",0,0,19,90,0,20,1,105
"Congo","2024-06-15",0,0,19,90,0,20,1,106
"Congo","2024-06-16",0,0,19,90,0,20,1,107
"Congo","2024-06-17",0,0,19,90,0,20,1,108
"Congo","2024-06-18",0,0,19,90,0,20,1,109
"Congo","2024-06-19",0,0,19,90,0,20,2,111
"Congo","2024-06-20",0,0,19,90,0,20,1,112
"Congo","2024-06-21",0,0,19,90,0,20,1,113
"Congo","2024-06-22",24,0,19,114,0,20,1,114
"Congo","2024-06-23",0,0,19,114,0,20,2,116
"Congo","2024-06-24",0,0,19,114,0,20,1,117
"Congo","2024-06-25",0,0,19,114,0,20,2,119
"Congo","2024-06-26",0,0,19,114,0,20,1,120
"Congo","2024-06-27",0,0,19,114,0,20,2,122
"Congo","2024-06-28",0,0,19,114,0,20,2,124
"Congo","2024-06-29",0,0,19,114,0,20,1,125
"Congo","2024-06-30",13,0,19,127,0,20,2,127
"Congo","2024-07-01",0,0,19,127,0,20,0,127
"Congo","2024-07-02",0,0,19,127,0,20,1,128
"Congo","2024-07-03",0,0,19,127,0,20,0,128
"Congo","2024-07-04",0,0,19,127,1,21,0,128
"Congo","2024-07-05",0,0,19,127,0,21,1,129
"Congo","2024-07-06",0,0,19,127,0,21,0,129
"Congo","2024-07-07",0,0,19,127,0,21,0,129
"Congo","2024-07-08",0,0,19,127,0,21,1,130
"Congo","2024-07-09",0,0,19,127,0,21,0,130
"Congo","2024-07-10",0,0,19,127,0,21,1,131
"Congo","2024-07-11",0,0,19,127,0,21,0,131
"Congo","2024-07-12",0,0,19,127,0,21,0,131
"Congo","2024-07-13",0,0,19,127,0,21,1,132
"Congo","2024-07-14",0,0,19,127,0,21,0,132
"Congo","2024-07-15",0,0,19,127,0,21,0,132
"Congo","2024-07-16",0,0,19,127,0,21,1,133
"Congo","2024-07-17",0,0,19,127,0,21,0,133
"Congo","2024-07-18",0,0,19,127,0,21,0,133
"Congo","2024-07-19",0,0,19,127,0,21,1,134
"Congo","2024-07-20",0,0,19,127,0,21,0,134
"Congo","2024-07-21",0,0,19,127,0,21,0,134
"Congo","2024-07-22",0,0,19,127,0,21,1,135
"Congo","2024-07-23",0,0,19,127,0,21,0,135
"Congo","2024-07-24",0,0,19,127,0,21,0,135
"Congo","2024-07-25",0,0,19,127,0,21,1,136
"Congo","2024-07-26",0,0,19,127,0,21,0,136
"Congo","2024-07-27",0,0,19,127,0,21,0,136
"Congo","2024-07-28",0,0,19,127,0,21,1,137
"Congo","2024-07-29",0,0,19,127,0,21,0,137
"Congo","2024-07-30",0,0,19,127,0,21,0,137
"Congo","2024-07-31",0,0,19,127,0,21,1,138
"Congo","2024-08-01",0,0,19,127,0,21,0,138
"Congo","2024-08-02",0,0,19,127,0,21,1,139
"Congo","2024-08-03",0,0,19,127,0,21,0,139
"Congo","2024-08-04",0,0,19,127,0,21,0,139
"Congo","2024-08-05",0,0,19,127,0,21,1,140
"Congo","2024-08-06",0,0,19,127,0,21,0,140
"Congo","2024-08-07",0,0,19,127,0,21,0,140
"Congo","2024-08-08",0,0,19,127,0,21,1,141
"Congo","2024-08-09",14,0,19,141,0,21,0,141
"Congo","2024-08-10",0,0,19,141,0,21,1,142
"Congo","2024-08-11",0,2,21,141,0,21,0,142
"Congo","2024-08-12",0,0,21,141,0,21,1,143
"Congo","2024-08-13",0,0,21,141,0,21,0,143
"Congo","2024-08-14",0,0,21,141,0,21,1,144
"Congo","2024-08-15",0,0,21,141,0,21,0,144
"Congo","2024-08-16",0,0,21,141,0,21,1,145
"Congo","2024-08-17",0,0,21,141,0,21,1,146
"Congo","2024-08-18",0,0,21,141,0,21,0,146
"Congo","2024-08-19",0,0,21,141,0,21,1,147
"Congo","2024-08-20",0,0,21,141,0,21,0,147
"Congo","2024-08-21",0,0,21,141,0,21,1,148
"Congo","2024-08-22",0,0,21,141,0,21,1,149
"Congo","2024-08-23",0,0,21,141,0,21,0,149
"Congo","2024-08-24",0,0,21,141,0,21,1,150
"Congo","2024-08-25",0,0,21,141,0,21,0,150
"Congo","2024-08-26",0,0,21,141,0,21,1,151
"Congo","2024-08-27",0,0,21,141,0,21,0,151
"Congo","2024-08-28",0,0,21,141,0,21,1,152
"Congo","2024-08-29",0,0,21,141,0,21,1,153
"Congo","2024-08-30",0,0,21,141,0,21,0,153
"Congo","2024-08-31",0,0,21,141,0,21,1,154
"Congo","2024-09-01",0,0,21,141,0,21,0,154
"Congo","2024-09-02",0,0,21,141,0,21,1,155
"Congo","2024-09-03",0,0,21,141,0,21,0,155
"Congo","2024-09-04",0,0,21,141,0,21,1,156
"Congo","2024-09-05",0,0,21,141,1,22,1,157
"Congo","2024-09-06",0,0,21,141,0,22,0,157
"Congo","2024-09-07",0,0,21,141,0,22,1,158
"Congo","2024-09-08",0,0,21,141,0,22,0,158
"Congo","2024-09-09",0,0,21,141,0,22,1,159
"Congo","2024-09-10",0,0,21,141,0,22,1,160
"Congo","2024-09-11",0,0,21,141,0,22,0,160
"Congo","2024-09-12",0,0,21,141,0,22,1,161
"Congo","2024-09-13",0,0,21,141,0,22,0,161
"Congo","2024-09-14",0,0,21,141,0,22,1,162
"Congo","2024-09-15",0,0,21,141,0,22,0,162
"Congo","2024-09-16",22,0,21,163,0,22,1,163
"Congo","2024-09-17",0,0,21,163,0,22,1,164
"Congo","2024-09-18",0,0,21,163,0,22,1,165
"Congo","2024-09-19",0,0,21,163,0,22,1,166
"Congo","2024-09-20",0,0,21,163,0,22,1,167
"Congo","2024-09-21",0,0,21,163,0,22,1,168
"Congo","2024-09-22",0,0,21,163,0,22,1,169
"Congo","2024-09-23",0,0,21,163,0,22,1,170
"Congo","2024-09-24",0,0,21,163,0,22,1,171
"Congo","2024-09-25",0,0,21,163,0,22,1,172
"Congo","2024-09-26",0,0,21,163,0,22,1,173
"Congo","2024-09-27",0,0,21,163,0,22,1,174
"Congo","2024-09-28",0,0,21,163,0,22,1,175
"Congo","2024-09-29",0,1,22,163,0,22,1,176
"Congo","2024-09-30",14,0,22,177,0,22,1,177
"Congo","2024-10-01",0,0,22,177,0,22,2,179
"Congo","2024-10-02",0,0,22,177,0,22,1,180
"Congo","2024-10-03",0,0,22,177,0,22,1,181
"Congo","2024-10-04",0,0,22,177,0,22,2,183
"Congo","2024-10-05",0,0,22,177,0,22,2,185
"Congo","2024-10-06",0,0,22,177,0,22,1,186
"Congo","2024-10-07",0,0,22,177,0,22,1,187
"Congo","2024-10-08",0,0,22,177,0,22,2,189
"Congo","2024-10-09",0,0,22,177,0,22,2,191
"Congo","2024-10-10",0,0,22,177,0,22,1,192
"Congo","2024-10-11",0,0,22,177,0,22,1,193
"Congo","2024-10-12",0,0,22,177,0,22,2,195
"Congo","2024-10-13",0,0,22,177,0,22,2,197
"Congo","2024-10-14",0,0,22,177,0,22,1,198
"Congo","2024-10-15",0,0,22,177,0,22,1,199
"Congo","2024-10-16",0,0,22,177,0,22,2,201
"Congo","2024-10-17",0,0,22,177,0,22,2,203
"Congo","2024-10-18",0,0,22,177,0,22,1,204
"Congo","2024-10-19",0,0,22,177,0,22,1,205
"Congo","2024-10-20",30,0,22,207,0,22,2,207
"Congo","2024-10-21",0,0,22,207,0,22,1,208
"Congo","2024-10-22",0,0,22,207,0,22,1,209
"Congo","2024-10-23",0,0,22,207,0,22,1,210
"Congo","2024-10-24",0,0,22,207,0,22,1,211
"Congo","2024-10-25",0,0,22,207,0,22,1,212
"Congo","2024-10-26",0,0,22,207,0,22,1,213
"Congo","2024-10-27",7,0,22,214,0,22,1,214
"Congo","2024-10-28",0,0,22,214,0,22,1,215
"Congo","2024-10-29",0,0,22,214,0,22,0,215
"Congo","2024-10-30",0,0,22,214,0,22,1,216
"Congo","2024-10-31",0,0,22,214,1,23,1,217
"Congo","2024-11-01",0,0,22,214,0,23,1,218
"Congo","2024-11-02",0,0,22,214,0,23,0,218
"Congo","2024-11-03",5,0,22,219,0,23,1,219
"Congo","2024-11-04",0,0,22,219,0,23,0,219
"Congo","2024-11-05",0,0,22,219,0,23,0,219
"Congo","2024-11-06",0,0,22,219,0,23,0,219
"Congo","2024-11-07",0,0,22,219,0,23,0,219
"Congo","2024-11-08",0,0,22,219,0,23,0,219
"Congo","2024-11-09",0,0,22,219,0,23,0,219
"Congo","2024-11-10",0,0,22,219,0,23,0,219
"Congo","2024-11-11",0,0,22,219,0,23,0,219
"Congo","2024-11-12",0,0,22,219,0,23,0,219
"Congo","2024-11-13",0,0,22,219,0,23,0,219
"Congo","2024-11-14",0,0,22,219,0,23,0,219
"Congo","2024-11-15",0,0,22,219,0,23,0,219
"Congo","2024-11-16",0,0,22,219,0,23,0,219
"Congo","2024-11-17",0,0,22,219,0,23,0,219
"Congo","2024-11-18",0,0,22,219,0,23,0,219
"Congo","2024-11-19",0,0,22,219,0,23,0,219
"Congo","2024-11-20",0,0,22,219,0,23,0,219
"Congo","2024-11-21",0,0,22,219,0,23,0,219
"Congo","2024-11-22",0,0,22,219,0,23,0,219
"Congo","2024-11-23",0,0,22,219,0,23,0,219
"Congo","2024-11-24",0,0,22,219,0,23,0,219
"Congo","2024-11-25",0,0,22,219,0,23,0,219
"Congo","2024-11-26",0,0,22,219,0,23,0,219
"Congo","2024-11-27",0,0,22,219,0,23,0,219
"Congo","2024-11-28",0,0,22,219,0,23,0,219
"Congo","2024-11-29",0,0,22,219,0,23,0,219
"Congo","2024-11-30",0,0,22,219,0,23,0,219
"Congo","2024-12-01",0,1,23,219,0,23,0,219
"Congo","2024-12-02",0,0,23,219,0,23,0,219
"Congo","2024-12-03",0,0,23,219,0,23,0,219
"Congo","2024-12-04",0,0,23,219,0,23,0,219
"Congo","2024-12-05",0,0,23,219,0,23,0,219
"Congo","2024-12-06",0,0,23,219,0,23,0,219
"Congo","2024-12-07",0,0,23,219,0,23,0,219
"Congo","2024-12-08",0,0,23,219,0,23,0,219
"Congo","2024-12-09",0,0,23,219,0,23,0,219
"Congo","2024-12-10",0,0,23,219,0,23,0,219
"Congo","2024-12-11",0,0,23,219,0,23,0,219
"Congo","2024-12-12",0,0,23,219,0,23,0,219
"Congo","2024-12-13",0,0,23,219,0,23,0,219
"Congo","2024-12-14",0,0,23,219,0,23,0,219
"Congo","2024-12-15",0,0,23,219,0,23,0,219
"Congo","2024-12-16",0,0,23,219,0,23,0,219
"Congo","2024-12-17",0,0,23,219,0,23,0,219
"Congo","2024-12-18",0,0,23,219,0,23,0,219
"Congo","2024-12-19",0,0,23,219,0,23,0,219
"Congo","2024-12-20",0,0,23,219,0,23,0,219
"Congo","2024-12-21",0,0,23,219,0,23,0,219
"Congo","2024-12-22",0,0,23,219,0,23,0,219
"Congo","2024-12-23",0,0,23,219,0,23,0,219
"Congo","2024-12-24",0,0,23,219,0,23,0,219
"Congo","2024-12-25",0,0,23,219,0,23,0,219
"Congo","2024-12-26",0,0,23,219,0,23,0,219
"Congo","2024-12-27",0,0,23,219,0,23,0,219
"Congo","2024-12-28",0,0,23,219,0,23,0,219
"Congo","2024-12-29",0,0,23,219,0,23,0,219
"Congo","2024-12-30",0,0,23,219,0,23,0,219
"Congo","2024-12-31",0,0,23,219,0,23,0,219
"Congo","2025-01-01",0,0,23,219,0,23,0,219
"Congo","2025-01-02",0,0,23,219,0,23,0,219
"Congo","2025-01-03",0,0,23,219,0,23,0,219
"Congo","2025-01-04",0,0,23,219,0,23,0,219
"Congo","2025-01-05",0,0,23,219,0,23,0,219
"Congo","2025-01-06",0,0,23,219,0,23,0,219
"Congo","2025-01-07",0,0,23,219,0,23,0,219
"Congo","2025-01-08",0,0,23,219,0,23,0,219
"Congo","2025-01-09",0,0,23,219,0,23,0,219
"Congo","2025-01-10",0,0,23,219,0,23,0,219
"Congo","2025-01-11",0,0,23,219,0,23,0,219
"Congo","2025-01-12",0,0,23,219,0,23,0,219
"Congo","2025-01-13",0,0,23,219,0,23,0,219
"Costa Rica","2024-01-01",0,0,0,0,0,0,0,0
"Costa Rica","2024-01-02",0,0,0,0,0,0,0,0
"Costa Rica","2024-01-03",0,0,0,0,0,0,0,0
"Costa Rica","2024-01-04",0,0,0,0,0,0,0,0
"Costa Rica","2024-01-05",0,0,0,0,0,0,0,0
"Costa Rica","2024-01-06",0,0,0,0,0,0,0,0
"Costa Rica","2024-01-07",0,0,0,0,0,0,0,0
"Costa Rica","2024-01-08",0,0,0,0,0,0,0,0
"Costa Rica","2024-01-09",0,0,0,0,0,0,0,0
"Costa Rica","2024-01-10",0,0,0,0,0,0,0,0
"Costa Rica","2024-01-11",0,0,0,0,0,0,0,0
"Costa Rica","2024-01-12",0,0,0,0,0,0,0,0
"Costa Rica","2024-01-13",0,0,0,0,0,0,0,0
"Costa Rica","2024-01-14",0,0,0,0,0,0,0,0
"Costa Rica","2024-01-15",0,0,0,0,0,0,0,0
"Costa Rica","2024-01-16",0,0,0,0,0,0,0,0
"Costa Rica","2024-01-17",0,0,0,0,0,0,0,0
"Costa Rica","2024-01-18",0,0,0,0,0,0,0,0
"Costa Rica","2024-01-19",0,0,0,0,0,0,0,0
"Costa Rica","2024-01-20",0,0,0,0,0,0,0,0
"Costa Rica","2024-01-21",0,0,0,0,0,0,0,0
"Costa Rica","2024-01-22",0,0,0,0,0,0,0,0
"Costa Rica","2024-01-23",0,0,0,0,0,0,0,0
"Costa Rica","2024-01-24",0,0,0,0,0,0,0,0
"Costa Rica","2024-01-25",0,0,0,0,0,0,0,0
"Costa Rica","2024-01-26",0,0,0,0,0,0,0,0
"Costa Rica","2024-01-27",0,0,0,0,0,0,0,0
"Costa Rica","2024-01-28",0,0,0,0,0,0,0,0
"Costa Rica","2024-01-29",0,0,0,0,0,0,0,0
"Costa Rica","2024-01-30",0,0,0,0,0,0,0,0
"Costa Rica","2024-01-31",0,0,0,0,0,0,0,0
"Costa Rica","2024-02-01",0,0,0,0,0,0,0,0
"Costa Rica","2024-02-02",0,0,0,0,0,0,0,0
"Costa Rica","2024-02-03",0,0,0,0,0,0,0,0
"Costa Rica","2024-02-04",0,0,0,0,0,0,0,0
"Costa Rica","2024-02-05",0,0,0,0,0,0,0,0
"Costa Rica","2024-02-06",0,0,0,0,0,0,0,0
"Costa Rica","2024-02-07",0,0,0,0,0,0,0,0
"Costa Rica","2024-02-08",0,0,0,0,0,0,0,0
"Costa Rica","2024-02-09",0,0,0,0,0,0,0,0
"Costa Rica","2024-02-10",0,0,0,0,0,0,0,0
"Costa Rica","2024-02-11",0,0,0,0,0,0,0,0
"Costa Rica","2024-02-12",0,0,0,0,0,0,0,0
"Costa Rica","2024-02-13",0,0,0,0,0,0,0,0
"Costa Rica","2024-02-14",0,0,0,0,0,0,0,0
"Costa Rica","2024-02-15",0,0,0,0,0,0,0,0
"Costa Rica","2024-02-16",0,0,0,0,0,0,0,0
"Costa Rica","2024-02-17",0,0,0,0,0,0,0,0
"Costa Rica","2024-02-18",0,0,0,0,0,0,0,0
"Costa Rica","2024-02-19",0,0,0,0,0,0,0,0
"Costa Rica","2024-02-20",0,0,0,0,0,0,0,0
"Costa Rica","2024-02-21",0,0,0,0,0,0,0,0
"Costa Rica","2024-02-22",0,0,0,0,0,0,0,0
"Costa Rica","2024-02-23",0,0,0,0,0,0,0,0
"Costa Rica","2024-02-24",0,0,0,0,0,0,0,0
"Costa Rica","2024-02-25",0,0,0,0,0,0,0,0
"Costa Rica","2024-02-26",0,0,0,0,0,0,0,0
"Costa Rica","2024-02-27",0,0,0,0,0,0,0,0
"Costa Rica","2024-02-28",0,0,0,0,0,0,0,0
"Costa Rica","2024-02-29",0,0,0,0,0,0,0,0
"Costa Rica","2024-03-01",0,0,0,0,0,0,0,0
"Costa Rica","2024-03-02",0,0,0,0,0,0,0,0
"Costa Rica","2024-03-03",0,0,0,0,0,0,0,0
"Costa Rica","2024-03-04",0,0,0,0,0,0,0,0
"Costa Rica","2024-03-05",0,1,1,0,1,1,0,0
"Costa Rica","2024-03-06",0,0,1,0,0,1,0,0
"Costa Rica","2024-03-07",0,0,1,0,0,1,0,0
"Costa Rica","2024-03-08",0,0,1,0,0,1,0,0
"Costa Rica","2024-03-09",0,0,1,0,0,1,0,0
"Costa Rica","2024-03-10",0,0,1,0,0,1,0,0
"Costa Rica","2024-03-11",0,0,1,0,0,1,0,0
"Costa Rica","2024-03-12",0,0,1,0,0,1,0,0
"Costa Rica","2024-03-13",0,0,1,0,0,1,0,0
"Costa Rica","2024-03-14",0,0,1,0,0,1,0,0
"Costa Rica","2024-03-15",0,0,1,0,0,1,0,0
"Costa Rica","2024-03-16",0,0,1,0,0,1,0,0
"Costa Rica","2024-03-17",0,0,1,0,0,1,0,0
"Costa Rica","2024-03-18",0,0,1,0,0,1,0,0
"Costa Rica","2024-03-19",0,0,1,0,0,1,0,0
"Costa Rica","2024-03-20",0,0,1,0,0,1,0,0
"Costa Rica","2024-03-21",0,0,1,0,0,1,0,0
"Costa Rica","2024-03-22",0,0,1,0,0,1,0,0
"Costa Rica","2024-03-23",0,0,1,0,0,1,0,0
"Costa Rica","2024-03-24",0,0,1,0,0,1,0,0
"Costa Rica","2024-03-25",0,0,1,0,0,1,0,0
"Costa Rica","2024-03-26",0,0,1,0,0,1,0,0
"Costa Rica","2024-03-27",0,0,1,0,0,1,0,0
"Costa Rica","2024-03-28",0,0,1,0,0,1,0,0
"Costa Rica","2024-03-29",0,0,1,0,0,1,0,0
"Costa Rica","2024-03-30",0,0,1,0,0,1,0,0
"Costa Rica","2024-03-31",0,0,1,0,0,1,0,0
"Costa Rica","2024-04-01",0,0,1,0,0,1,0,0
"Costa Rica","2024-04-02",0,0,1,0,0,1,0,0
"Costa Rica","2024-04-03",0,0,1,0,0,1,0,0
"Costa Rica","2024-04-04",0,0,1,0,0,1,0,0
"Costa Rica","2024-04-05",0,0,1,0,0,1,0,0
"Costa Rica","2024-04-06",0,0,1,0,0,1,0,0
"Costa Rica","2024-04-07",0,0,1,0,0,1,0,0
"Costa Rica","2024-04-08",0,0,1,0,0,1,0,0
"Costa Rica","2024-04-09",0,0,1,0,0,1,0,0
"Costa Rica","2024-04-10",0,0,1,0,0,1,0,0
"Costa Rica","2024-04-11",0,0,1,0,0,1,0,0
"Costa Rica","2024-04-12",0,0,1,0,0,1,0,0
"Costa Rica","2024-04-13",0,0,1,0,0,1,0,0
"Costa Rica","2024-04-14",0,0,1,0,0,1,0,0
"Costa Rica","2024-04-15",0,0,1,0,0,1,0,0
"Costa Rica","2024-04-16",0,0,1,0,0,1,0,0
"Costa Rica","2024-04-17",0,0,1,0,0,1,0,0
"Costa Rica","2024-04-18",0,0,1,0,0,1,0,0
"Costa Rica","2024-04-19",0,0,1,0,0,1,0,0
"Costa Rica","2024-04-20",0,0,1,0,0,1,0,0
"Costa Rica","2024-04-21",0,0,1,0,0,1,0,0
"Costa Rica","2024-04-22",0,0,1,0,0,1,0,0
"Costa Rica","2024-04-23",0,0,1,0,0,1,0,0
"Costa Rica","2024-04-24",0,0,1,0,0,1,0,0
"Costa Rica","2024-04-25",0,0,1,0,0,1,0,0
"Costa Rica","2024-04-26",0,0,1,0,0,1,0,0
"Costa Rica","2024-04-27",0,0,1,0,0,1,0,0
"Costa Rica","2024-04-28",0,0,1,0,0,1,0,0
"Costa Rica","2024-04-29",0,0,1,0,0,1,0,0
"Costa Rica","2024-04-30",0,0,1,0,0,1,0,0
"Costa Rica","2024-05-01",0,0,1,0,0,1,0,0
"Costa Rica","2024-05-02",0,0,1,0,0,1,0,0
"Costa Rica","2024-05-03",0,0,1,0,0,1,0,0
"Costa Rica","2024-05-04",0,0,1,0,0,1,0,0
"Costa Rica","2024-05-05",0,0,1,0,0,1,0,0
"Costa Rica","2024-05-06",0,0,1,0,0,1,0,0
"Costa Rica","2024-05-07",0,0,1,0,0,1,0,0
"Costa Rica","2024-05-08",0,0,1,0,0,1,0,0
"Costa Rica","2024-05-09",0,0,1,0,0,1,0,0
"Costa Rica","2024-05-10",0,0,1,0,0,1,0,0
"Costa Rica","2024-05-11",0,0,1,0,0,1,0,0
"Costa Rica","2024-05-12",0,0,1,0,0,1,0,0
"Costa Rica","2024-05-13",0,0,1,0,0,1,0,0
"Costa Rica","2024-05-14",0,0,1,0,0,1,0,0
"Costa Rica","2024-05-15",0,0,1,0,0,1,0,0
"Costa Rica","2024-05-16",0,0,1,0,0,1,0,0
"Costa Rica","2024-05-17",0,0,1,0,0,1,0,0
"Costa Rica","2024-05-18",0,0,1,0,0,1,0,0
"Costa Rica","2024-05-19",0,0,1,0,0,1,0,0
"Costa Rica","2024-05-20",0,0,1,0,0,1,0,0
"Costa Rica","2024-05-21",0,0,1,0,0,1,0,0
"Costa Rica","2024-05-22",0,0,1,0,0,1,0,0
"Costa Rica","2024-05-23",0,0,1,0,0,1,0,0
"Costa Rica","2024-05-24",0,0,1,0,0,1,0,0
"Costa Rica","2024-05-25",0,0,1,0,0,1,0,0
"Costa Rica","2024-05-26",0,0,1,0,0,1,0,0
"Costa Rica","2024-05-27",0,0,1,0,0,1,0,0
"Costa Rica","2024-05-28",0,0,1,0,0,1,0,0
"Costa Rica","2024-05-29",0,0,1,0,0,1,0,0
"Costa Rica","2024-05-30",0,0,1,0,0,1,0,0
"Costa Rica","2024-05-31",0,0,1,0,0,1,0,0
"Costa Rica","2024-06-01",0,0,1,0,0,1,0,0
"Costa Rica","2024-06-02",0,0,1,0,0,1,0,0
"Costa Rica","2024-06-03",0,0,1,0,0,1,0,0
"Costa Rica","2024-06-04",0,0,1,0,0,1,0,0
"Costa Rica","2024-06-05",0,0,1,0,0,1,0,0
"Costa Rica","2024-06-06",0,0,1,0,0,1,0,0
"Costa Rica","2024-06-07",0,0,1,0,0,1,0,0
"Costa Rica","2024-06-08",0,0,1,0,0,1,0,0
"Costa Rica","2024-06-09",0,0,1,0,0,1,0,0
"Costa Rica","2024-06-10",0,0,1,0,0,1,0,0
"Costa Rica","2024-06-11",0,0,1,0,0,1,0,0
"Costa Rica","2024-06-12",0,0,1,0,0,1,0,0
"Costa Rica","2024-06-13",0,0,1,0,0,1,0,0
"Costa Rica","2024-06-14",0,0,1,0,0,1,0,0
"Costa Rica","2024-06-15",0,0,1,0,0,1,0,0
"Costa Rica","2024-06-16",0,0,1,0,0,1,0,0
"Costa Rica","2024-06-17",0,0,1,0,0,1,0,0
"Costa Rica","2024-06-18",0,0,1,0,0,1,0,0
"Costa Rica","2024-06-19",0,0,1,0,0,1,0,0
"Costa Rica","2024-06-20",0,0,1,0,0,1,0,0
"Costa Rica","2024-06-21",0,0,1,0,0,1,0,0
"Costa Rica","2024-06-22",0,0,1,0,0,1,0,0
"Costa Rica","2024-06-23",0,0,1,0,0,1,0,0
"Costa Rica","2024-06-24",0,0,1,0,0,1,0,0
"Costa Rica","2024-06-25",0,0,1,0,0,1,0,0
"Costa Rica","2024-06-26",0,0,1,0,0,1,0,0
"Costa Rica","2024-06-27",0,0,1,0,0,1,0,0
"Costa Rica","2024-06-28",0,0,1,0,0,1,0,0
"Costa Rica","2024-06-29",0,0,1,0,0,1,0,0
"Costa Rica","2024-06-30",0,0,1,0,0,1,0,0
"Costa Rica","2024-07-01",0,0,1,0,0,1,0,0
"Costa Rica","2024-07-02",0,0,1,0,0,1,0,0
"Costa Rica","2024-07-03",0,0,1,0,0,1,0,0
"Costa Rica","2024-07-04",0,0,1,0,0,1,0,0
"Costa Rica","2024-07-05",0,0,1,0,0,1,0,0
"Costa Rica","2024-07-06",0,0,1,0,0,1,0,0
"Costa Rica","2024-07-07",0,0,1,0,0,1,0,0
"Costa Rica","2024-07-08",0,0,1,0,0,1,0,0
"Costa Rica","2024-07-09",0,0,1,0,0,1,0,0
"Costa Rica","2024-07-10",0,0,1,0,0,1,0,0
"Costa Rica","2024-07-11",0,0,1,0,0,1,0,0
"Costa Rica","2024-07-12",0,0,1,0,0,1,0,0
"Costa Rica","2024-07-13",0,0,1,0,0,1,0,0
"Costa Rica","2024-07-14",0,0,1,0,0,1,0,0
"Costa Rica","2024-07-15",0,0,1,0,0,1,0,0
"Costa Rica","2024-07-16",0,0,1,0,0,1,0,0
"Costa Rica","2024-07-17",0,0,1,0,0,1,0,0
"Costa Rica","2024-07-18",0,0,1,0,0,1,0,0
"Costa Rica","2024-07-19",0,0,1,0,0,1,0,0
"Costa Rica","2024-07-20",0,0,1,0,0,1,0,0
"Costa Rica","2024-07-21",0,0,1,0,0,1,0,0
"Costa Rica","2024-07-22",0,0,1,0,0,1,0,0
"Costa Rica","2024-07-23",0,0,1,0,0,1,0,0
"Costa Rica","2024-07-24",0,0,1,0,0,1,0,0
"Costa Rica","2024-07-25",0,0,1,0,0,1,0,0
"Costa Rica","2024-07-26",0,0,1,0,0,1,0,0
"Costa Rica","2024-07-27",0,0,1,0,0,1,0,0
"Costa Rica","2024-07-28",0,0,1,0,0,1,0,0
"Costa Rica","2024-07-29",0,0,1,0,0,1,0,0
"Costa Rica","2024-07-30",0,0,1,0,0,1,0,0
"Costa Rica","2024-07-31",0,0,1,0,0,1,0,0
"Costa Rica","2024-08-01",0,0,1,0,0,1,0,0
"Costa Rica","2024-08-02",0,0,1,0,0,1,0,0
"Costa Rica","2024-08-03",0,0,1,0,0,1,0,0
"Costa Rica","2024-08-04",0,0,1,0,0,1,0,0
"Costa Rica","2024-08-05",0,0,1,0,0,1,0,0
"Costa Rica","2024-08-06",0,0,1,0,0,1,0,0
"Costa Rica","2024-08-07",0,0,1,0,0,1,0,0
"Costa Rica","2024-08-08",0,0,1,0,0,1,0,0
"Costa Rica","2024-08-09",0,0,1,0,0,1,0,0
"Costa Rica","2024-08-10",0,0,1,0,0,1,0,0
"Costa Rica","2024-08-11",0,0,1,0,0,1,0,0
"Costa Rica","2024-08-12",0,0,1,0,0,1,0,0
"Costa Rica","2024-08-13",0,0,1,0,0,1,0,0
"Costa Rica","2024-08-14",0,0,1,0,0,1,0,0
"Costa Rica","2024-08-15",0,0,1,0,0,1,0,0
"Costa Rica","2024-08-16",0,0,1,0,0,1,0,0
"Costa Rica","2024-08-17",0,0,1,0,0,1,0,0
"Costa Rica","2024-08-18",0,0,1,0,0,1,0,0
"Costa Rica","2024-08-19",0,0,1,0,0,1,0,0
"Costa Rica","2024-08-20",0,0,1,0,0,1,0,0
"Costa Rica","2024-08-21",0,0,1,0,0,1,0,0
"Costa Rica","2024-08-22",0,0,1,0,0,1,0,0
"Costa Rica","2024-08-23",0,0,1,0,0,1,0,0
"Costa Rica","2024-08-24",0,0,1,0,0,1,0,0
"Costa Rica","2024-08-25",0,0,1,0,0,1,0,0
"Costa Rica","2024-08-26",0,0,1,0,0,1,0,0
"Costa Rica","2024-08-27",0,0,1,0,0,1,0,0
"Costa Rica","2024-08-28",0,0,1,0,0,1,0,0
"Costa Rica","2024-08-29",0,0,1,0,0,1,0,0
"Costa Rica","2024-08-30",0,0,1,0,0,1,0,0
"Costa Rica","2024-08-31",0,0,1,0,0,1,0,0
"Costa Rica","2024-09-01",0,0,1,0,0,1,0,0
"Costa Rica","2024-09-02",0,0,1,0,0,1,0,0
"Costa Rica","2024-09-03",0,0,1,0,0,1,0,0
"Costa Rica","2024-09-04",0,0,1,0,0,1,0,0
"Costa Rica","2024-09-05",0,0,1,0,0,1,0,0
"Costa Rica","2024-09-06",0,0,1,0,0,1,0,0
"Costa Rica","2024-09-07",0,0,1,0,0,1,0,0
"Costa Rica","2024-09-08",0,0,1,0,0,1,0,0
"Costa Rica","2024-09-09",0,0,1,0,0,1,0,0
"Costa Rica","2024-09-10",0,0,1,0,0,1,0,0
"Costa Rica","2024-09-11",0,0,1,0,0,1,0,0
"Costa Rica","2024-09-12",0,0,1,0,0,1,0,0
"Costa Rica","2024-09-13",0,0,1,0,0,1,0,0
"Costa Rica","2024-09-14",0,0,1,0,0,1,0,0
"Costa Rica","2024-09-15",0,0,1,0,0,1,0,0
"Costa Rica","2024-09-16",0,0,1,0,0,1,0,0
"Costa Rica","2024-09-17",0,0,1,0,0,1,0,0
"Costa Rica","2024-09-18",0,0,1,0,0,1,0,0
"Costa Rica","2024-09-19",0,0,1,0,0,1,0,0
"Costa Rica","2024-09-20",0,0,1,0,0,1,0,0
"Costa Rica","2024-09-21",0,0,1,0,0,1,0,0
"Costa Rica","2024-09-22",0,0,1,0,0,1,0,0
"Costa Rica","2024-09-23",0,0,1,0,0,1,0,0
"Costa Rica","2024-09-24",0,0,1,0,0,1,0,0
"Costa Rica","2024-09-25",0,0,1,0,0,1,0,0
"Costa Rica","2024-09-26",0,0,1,0,0,1,0,0
"Costa Rica","2024-09-27",0,0,1,0,0,1,0,0
"Costa Rica","2024-09-28",0,0,1,0,0,1,0,0
"Costa Rica","2024-09-29",0,0,1,0,0,1,0,0
"Costa Rica","2024-09-30",0,0,1,0,0,1,0,0
"Costa Rica","2024-10-01",0,0,1,0,0,1,0,0
"Costa Rica","2024-10-02",0,0,1,0,0,1,0,0
"Costa Rica","2024-10-03",0,0,1,0,0,1,0,0
"Costa Rica","2024-10-04",0,0,1,0,0,1,0,0
"Costa Rica","2024-10-05",0,0,1,0,0,1,0,0
"Costa Rica","2024-10-06",0,0,1,0,0,1,0,0
"Costa Rica","2024-10-07",0,0,1,0,0,1,0,0
"Costa Rica","2024-10-08",0,0,1,0,0,1,0,0
"Costa Rica","2024-10-09",0,0,1,0,0,1,0,0
"Costa Rica","2024-10-10",0,0,1,0,0,1,0,0
"Costa Rica","2024-10-11",0,0,1,0,0,1,0,0
"Costa Rica","2024-10-12",0,0,1,0,0,1,0,0
"Costa Rica","2024-10-13",0,0,1,0,0,1,0,0
"Costa Rica","2024-10-14",0,0,1,0,0,1,0,0
"Costa Rica","2024-10-15",0,0,1,0,0,1,0,0
"Costa Rica","2024-10-16",0,0,1,0,0,1,0,0
"Costa Rica","2024-10-17",0,0,1,0,0,1,0,0
"Costa Rica","2024-10-18",0,0,1,0,0,1,0,0
"Costa Rica","2024-10-19",0,0,1,0,0,1,0,0
"Costa Rica","2024-10-20",0,0,1,0,0,1,0,0
"Costa Rica","2024-10-21",0,0,1,0,0,1,0,0
"Costa Rica","2024-10-22",0,0,1,0,0,1,0,0
"Costa Rica","2024-10-23",0,0,1,0,0,1,0,0
"Costa Rica","2024-10-24",0,0,1,0,0,1,0,0
"Costa Rica","2024-10-25",0,0,1,0,0,1,0,0
"Costa Rica","2024-10-26",0,0,1,0,0,1,0,0
"Costa Rica","2024-10-27",0,0,1,0,0,1,0,0
"Costa Rica","2024-10-28",0,0,1,0,0,1,0,0
"Costa Rica","2024-10-29",0,0,1,0,0,1,0,0
"Costa Rica","2024-10-30",0,0,1,0,0,1,0,0
"Costa Rica","2024-10-31",0,0,1,0,0,1,0,0
"Costa Rica","2024-11-01",0,0,1,0,0,1,0,0
"Costa Rica","2024-11-02",0,0,1,0,0,1,0,0
"Costa Rica","2024-11-03",0,0,1,0,0,1,0,0
"Costa Rica","2024-11-04",0,0,1,0,0,1,0,0
"Costa Rica","2024-11-05",0,0,1,0,0,1,0,0
"Costa Rica","2024-11-06",0,0,1,0,0,1,0,0
"Costa Rica","2024-11-07",0,0,1,0,0,1,0,0
"Costa Rica","2024-11-08",0,0,1,0,0,1,0,0
"Costa Rica","2024-11-09",0,0,1,0,0,1,0,0
"Costa Rica","2024-11-10",0,0,1,0,0,1,0,0
"Costa Rica","2024-11-11",0,0,1,0,0,1,0,0
"Costa Rica","2024-11-12",0,0,1,0,0,1,0,0
"Costa Rica","2024-11-13",0,0,1,0,0,1,0,0
"Costa Rica","2024-11-14",0,0,1,0,0,1,0,0
"Costa Rica","2024-11-15",0,0,1,0,0,1,0,0
"Costa Rica","2024-11-16",0,0,1,0,0,1,0,0
"Costa Rica","2024-11-17",0,0,1,0,0,1,0,0
"Costa Rica","2024-11-18",0,0,1,0,0,1,0,0
"Costa Rica","2024-11-19",0,0,1,0,0,1,0,0
"Costa Rica","2024-11-20",0,0,1,0,0,1,0,0
"Costa Rica","2024-11-21",0,0,1,0,0,1,0,0
"Costa Rica","2024-11-22",0,0,1,0,0,1,0,0
"Costa Rica","2024-11-23",0,0,1,0,0,1,0,0
"Costa Rica","2024-11-24",0,0,1,0,0,1,0,0
"Costa Rica","2024-11-25",0,0,1,0,0,1,0,0
"Costa Rica","2024-11-26",0,0,1,0,0,1,0,0
"Costa Rica","2024-11-27",0,0,1,0,0,1,0,0
"Costa Rica","2024-11-28",0,0,1,0,0,1,0,0
"Costa Rica","2024-11-29",0,0,1,0,0,1,0,0
"Costa Rica","2024-11-30",0,0,1,0,0,1,0,0
"Costa Rica","2024-12-01",0,0,1,0,0,1,0,0
"Costa Rica","2024-12-02",0,0,1,0,0,1,0,0
"Costa Rica","2024-12-03",0,0,1,0,0,1,0,0
"Costa Rica","2024-12-04",0,0,1,0,0,1,0,0
"Costa Rica","2024-12-05",0,0,1,0,0,1,0,0
"Costa Rica","2024-12-06",0,0,1,0,0,1,0,0
"Costa Rica","2024-12-07",0,0,1,0,0,1,0,0
"Costa Rica","2024-12-08",0,0,1,0,0,1,0,0
"Costa Rica","2024-12-09",0,0,1,0,0,1,0,0
"Costa Rica","2024-12-10",0,0,1,0,0,1,0,0
"Costa Rica","2024-12-11",0,0,1,0,0,1,0,0
"Costa Rica","2024-12-12",0,0,1,0,0,1,0,0
"Costa Rica","2024-12-13",0,0,1,0,0,1,0,0
"Costa Rica","2024-12-14",0,0,1,0,0,1,0,0
"Costa Rica","2024-12-15",0,0,1,0,0,1,0,0
"Costa Rica","2024-12-16",0,0,1,0,0,1,0,0
"Costa Rica","2024-12-17",0,0,1,0,0,1,0,0
"Costa Rica","2024-12-18",0,0,1,0,0,1,0,0
"Costa Rica","2024-12-19",0,0,1,0,0,1,0,0
"Costa Rica","2024-12-20",0,0,1,0,0,1,0,0
"Costa Rica","2024-12-21",0,0,1,0,0,1,0,0
"Costa Rica","2024-12-22",0,0,1,0,0,1,0,0
"Costa Rica","2024-12-23",0,0,1,0,0,1,0,0
"Costa Rica","2024-12-24",0,0,1,0,0,1,0,0
"Costa Rica","2024-12-25",0,0,1,0,0,1,0,0
"Costa Rica","2024-12-26",0,0,1,0,0,1,0,0
"Costa Rica","2024-12-27",0,0,1,0,0,1,0,0
"Costa Rica","2024-12-28",0,0,1,0,0,1,0,0
"Costa Rica","2024-12-29",0,0,1,0,0,1,0,0
"Costa Rica","2024-12-30",0,0,1,0,0,1,0,0
"Costa Rica","2024-12-31",0,0,1,0,0,1,0,0
"Costa Rica","2025-01-01",0,0,1,0,0,1,0,0
"Costa Rica","2025-01-02",0,0,1,0,0,1,0,0
"Costa Rica","2025-01-03",0,0,1,0,0,1,0,0
"Costa Rica","2025-01-04",0,0,1,0,0,1,0,0
"Costa Rica","2025-01-05",0,0,1,0,0,1,0,0
"Costa Rica","2025-01-06",0,0,1,0,0,1,0,0
"Costa Rica","2025-01-07",0,0,1,0,0,1,0,0
"Costa Rica","2025-01-08",0,0,1,0,0,1,0,0
"Costa Rica","2025-01-09",0,0,1,0,0,1,0,0
"Costa Rica","2025-01-10",0,0,1,0,0,1,0,0
"Costa Rica","2025-01-11",0,0,1,0,0,1,0,0
"Costa Rica","2025-01-12",0,0,1,0,0,1,0,0
"Costa Rica","2025-01-13",0,0,1,0,0,1,0,0
"Côte d’Ivoire","2024-01-01",0,0,0,0,0,0,0,0
"Côte d’Ivoire","2024-01-02",0,0,0,0,0,0,0,0
"Côte d’Ivoire","2024-01-03",0,0,0,0,0,0,0,0
"Côte d’Ivoire","2024-01-04",0,0,0,0,0,0,0,0
"Côte d’Ivoire","2024-01-05",0,0,0,0,0,0,0,0
"Côte d’Ivoire","2024-01-06",0,0,0,0,0,0,0,0
"Côte d’Ivoire","2024-01-07",0,0,0,0,0,0,0,0
"Côte d’Ivoire","2024-01-08",0,0,0,0,0,0,0,0
"Côte d’Ivoire","2024-01-09",0,0,0,0,0,0,0,0
"Côte d’Ivoire","2024-01-10",0,0,0,0,0,0,0,0
"Côte d’Ivoire","2024-01-11",0,0,0,0,0,0,0,0
"Côte d’Ivoire","2024-01-12",0,0,0,0,0,0,0,0
"Côte d’Ivoire","2024-01-13",0,0,0,0,0,0,0,0
"Côte d’Ivoire","2024-01-14",0,0,0,0,0,0,0,0
"Côte d’Ivoire","2024-01-15",0,0,0,0,0,0,0,0
"Côte d’Ivoire","2024-01-16",0,0,0,0,0,0,0,0
"Côte d’Ivoire","2024-01-17",0,0,0,0,0,0,0,0
"Côte d’Ivoire","2024-01-18",0,0,0,0,0,0,0,0
"Côte d’Ivoire","2024-01-19",0,0,0,0,0,0,0,0
"Côte d’Ivoire","2024-01-20",0,0,0,0,0,0,0,0
"Côte d’Ivoire","2024-01-21",0,0,0,0,0,0,0,0
"Côte d’Ivoire","2024-01-22",0,0,0,0,0,0,0,0
"Côte d’Ivoire","2024-01-23",0,0,0,0,0,0,0,0
"Côte d’Ivoire","2024-01-24",0,0,0,0,0,0,0,0
"Côte d’Ivoire","2024-01-25",0,0,0,0,0,0,0,0
"Côte d’Ivoire","2024-01-26",0,0,0,0,0,0,0,0
"Côte d’Ivoire","2024-01-27",0,0,0,0,0,0,0,0
"Côte d’Ivoire","2024-01-28",0,0,0,0,0,0,0,0
"Côte d’Ivoire","2024-01-29",0,0,0,0,0,0,0,0
"Côte d’Ivoire","2024-01-30",0,0,0,0,0,0,0,0
"Côte d’Ivoire","2024-01-31",0,0,0,0,0,0,0,0
"Côte d’Ivoire","2024-02-01",0,0,0,0,0,0,0,0
"Côte d’Ivoire","2024-02-02",0,0,0,0,0,0,0,0
"Côte d’Ivoire","2024-02-03",0,0,0,0,0,0,0,0
"Côte d’Ivoire","2024-02-04",0,0,0,0,0,0,0,0
"Côte d’Ivoire","2024-02-05",0,0,0,0,0,0,0,0
"Côte d’Ivoire","2024-02-06",0,0,0,0,0,0,0,0
"Côte d’Ivoire","2024-02-07",0,0,0,0,0,0,0,0
"Côte d’Ivoire","2024-02-08",0,0,0,0,0,0,0,0
"Côte d’Ivoire","2024-02-09",0,0,0,0,0,0,0,0
"Côte d’Ivoire","2024-02-10",0,0,0,0,0,0,0,0
"Côte d’Ivoire","2024-02-11",0,0,0,0,0,0,0,0
"Côte d’Ivoire","2024-02-12",0,0,0,0,0,0,0,0
"Côte d’Ivoire","2024-02-13",0,0,0,0,0,0,0,0
"Côte d’Ivoire","2024-02-14",0,0,0,0,0,0,0,0
"Côte d’Ivoire","2024-02-15",0,0,0,0,0,0,0,0
"Côte d’Ivoire","2024-02-16",0,0,0,0,0,0,0,0
"Côte d’Ivoire","2024-02-17",0,0,0,0,0,0,0,0
"Côte d’Ivoire","2024-02-18",0,0,0,0,0,0,0,0
"Côte d’Ivoire","2024-02-19",0,0,0,0,0,0,0,0
"Côte d’Ivoire","2024-02-20",0,0,0,0,0,0,0,0
"Côte d’Ivoire","2024-02-21",0,0,0,0,0,0,0,0
"Côte d’Ivoire","2024-02-22",0,0,0,0,0,0,0,0
"Côte d’Ivoire","2024-02-23",0,0,0,0,0,0,0,0
"Côte d’Ivoire","2024-02-24",0,0,0,0,0,0,0,0
"Côte d’Ivoire","2024-02-25",0,0,0,0,0,0,0,0
"Côte d’Ivoire","2024-02-26",0,0,0,0,0,0,0,0
"Côte d’Ivoire","2024-02-27",0,0,0,0,0,0,0,0
"Côte d’Ivoire","2024-02-28",0,0,0,0,0,0,0,0
"Côte d’Ivoire","2024-02-29",0,0,0,0,0,0,0,0
"Côte d’Ivoire","2024-03-01",0,0,0,0,0,0,0,0
"Côte d’Ivoire","2024-03-02",0,0,0,0,0,0,0,0
"Côte d’Ivoire","2024-03-03",0,0,0,0,0,0,0,0
"Côte d’Ivoire","2024-03-04",0,0,0,0,0,0,0,0
"Côte d’Ivoire","2024-03-05",0,0,0,0,0,0,0,0
"Côte d’Ivoire","2024-03-06",0,0,0,0,0,0,0,0
"Côte d’Ivoire","2024-03-07",0,0,0,0,0,0,0,0
"Côte d’Ivoire","2024-03-08",0,0,0,0,0,0,0,0
"Côte d’Ivoire","2024-03-09",0,0,0,0,0,0,0,0
"Côte d’Ivoire","2024-03-10",0,0,0,0,0,0,0,0
"Côte d’Ivoire","2024-03-11",0,0,0,0,0,0,0,0
"Côte d’Ivoire","2024-03-12",0,0,0,0,0,0,0,0
"Côte d’Ivoire","2024-03-13",0,0,0,0,0,0,0,0
"Côte d’Ivoire","2024-03-14",0,0,0,0,0,0,0,0
"Côte d’Ivoire","2024-03-15",0,0,0,0,0,0,0,0
"Côte d’Ivoire","2024-03-16",0,0,0,0,0,0,0,0
"Côte d’Ivoire","2024-03-17",0,0,0,0,0,0,0,0
"Côte d’Ivoire","2024-03-18",0,0,0,0,0,0,0,0
"Côte d’Ivoire","2024-03-19",0,0,0,0,0,0,0,0
"Côte d’Ivoire","2024-03-20",0,0,0,0,0,0,0,0
"Côte d’Ivoire","2024-03-21",0,0,0,0,0,0,0,0
"Côte d’Ivoire","2024-03-22",0,0,0,0,0,0,0,0
"Côte d’Ivoire","2024-03-23",0,0,0,0,0,0,0,0
"Côte d’Ivoire","2024-03-24",0,0,0,0,0,0,0,0
"Côte d’Ivoire","2024-03-25",0,0,0,0,0,0,0,0
"Côte d’Ivoire","2024-03-26",0,0,0,0,0,0,0,0
"Côte d’Ivoire","2024-03-27",0,0,0,0,0,0,0,0
"Côte d’Ivoire","2024-03-28",0,0,0,0,0,0,0,0
"Côte d’Ivoire","2024-03-29",0,0,0,0,0,0,0,0
"Côte d’Ivoire","2024-03-30",0,0,0,0,0,0,0,0
"Côte d’Ivoire","2024-03-31",0,0,0,0,0,0,0,0
"Côte d’Ivoire","2024-04-01",0,0,0,0,0,0,0,0
"Côte d’Ivoire","2024-04-02",0,0,0,0,0,0,0,0
"Côte d’Ivoire","2024-04-03",0,0,0,0,0,0,0,0
"Côte d’Ivoire","2024-04-04",0,0,0,0,0,0,0,0
"Côte d’Ivoire","2024-04-05",0,0,0,0,0,0,0,0
"Côte d’Ivoire","2024-04-06",0,0,0,0,0,0,0,0
"Côte d’Ivoire","2024-04-07",0,0,0,0,0,0,0,0
"Côte d’Ivoire","2024-04-08",0,0,0,0,0,0,0,0
"Côte d’Ivoire","2024-04-09",0,0,0,0,0,0,0,0
"Côte d’Ivoire","2024-04-10",0,0,0,0,0,0,0,0
"Côte d’Ivoire","2024-04-11",0,0,0,0,0,0,0,0
"Côte d’Ivoire","2024-04-12",0,0,0,0,0,0,0,0
"Côte d’Ivoire","2024-04-13",0,0,0,0,0,0,0,0
"Côte d’Ivoire","2024-04-14",0,0,0,0,0,0,0,0
"Côte d’Ivoire","2024-04-15",0,0,0,0,0,0,0,0
"Côte d’Ivoire","2024-04-16",0,0,0,0,0,0,0,0
"Côte d’Ivoire","2024-04-17",0,0,0,0,0,0,0,0
"Côte d’Ivoire","2024-04-18",0,0,0,0,0,0,0,0
"Côte d’Ivoire","2024-04-19",0,0,0,0,0,0,0,0
"Côte d’Ivoire","2024-04-20",0,0,0,0,0,0,0,0
"Côte d’Ivoire","2024-04-21",0,0,0,0,0,0,0,0
"Côte d’Ivoire","2024-04-22",0,0,0,0,0,0,0,0
"Côte d’Ivoire","2024-04-23",0,0,0,0,0,0,0,0
"Côte d’Ivoire","2024-04-24",0,0,0,0,0,0,0,0
"Côte d’Ivoire","2024-04-25",0,0,0,0,0,0,0,0
"Côte d’Ivoire","2024-04-26",0,0,0,0,0,0,0,0
"Côte d’Ivoire","2024-04-27",0,0,0,0,0,0,0,0
"Côte d’Ivoire","2024-04-28",0,0,0,0,0,0,0,0
"Côte d’Ivoire","2024-04-29",0,0,0,0,0,0,0,0
"Côte d’Ivoire","2024-04-30",0,0,0,0,0,0,0,0
"Côte d’Ivoire","2024-05-01",0,0,0,0,0,0,0,0
"Côte d’Ivoire","2024-05-02",0,0,0,0,0,0,0,0
"Côte d’Ivoire","2024-05-03",0,0,0,0,0,0,0,0
"Côte d’Ivoire","2024-05-04",0,0,0,0,0,0,0,0
"Côte d’Ivoire","2024-05-05",0,0,0,0,0,0,0,0
"Côte d’Ivoire","2024-05-06",0,0,0,0,0,0,0,0
"Côte d’Ivoire","2024-05-07",0,0,0,0,0,0,0,0
"Côte d’Ivoire","2024-05-08",0,0,0,0,0,0,0,0
"Côte d’Ivoire","2024-05-09",0,0,0,0,0,0,0,0
"Côte d’Ivoire","2024-05-10",0,0,0,0,0,0,0,0
"Côte d’Ivoire","2024-05-11",0,0,0,0,0,0,0,0
"Côte d’Ivoire","2024-05-12",0,0,0,0,0,0,0,0
"Côte d’Ivoire","2024-05-13",0,0,0,0,0,0,0,0
"Côte d’Ivoire","2024-05-14",0,0,0,0,0,0,0,0
"Côte d’Ivoire","2024-05-15",0,0,0,0,0,0,0,0
"Côte d’Ivoire","2024-05-16",0,0,0,0,0,0,0,0
"Côte d’Ivoire","2024-05-17",0,0,0,0,0,0,0,0
"Côte d’Ivoire","2024-05-18",0,0,0,0,0,0,0,0
"Côte d’Ivoire","2024-05-19",0,0,0,0,0,0,0,0
"Côte d’Ivoire","2024-05-20",0,0,0,0,0,0,0,0
"Côte d’Ivoire","2024-05-21",0,0,0,0,0,0,0,0
"Côte d’Ivoire","2024-05-22",0,0,0,0,0,0,0,0
"Côte d’Ivoire","2024-05-23",0,0,0,0,0,0,0,0
"Côte d’Ivoire","2024-05-24",0,0,0,0,0,0,0,0
"Côte d’Ivoire","2024-05-25",0,0,0,0,0,0,0,0
"Côte d’Ivoire","2024-05-26",0,0,0,0,0,0,0,0
"Côte d’Ivoire","2024-05-27",0,0,0,0,0,0,0,0
"Côte d’Ivoire","2024-05-28",0,0,0,0,0,0,0,0
"Côte d’Ivoire","2024-05-29",0,0,0,0,0,0,0,0
"Côte d’Ivoire","2024-05-30",0,0,0,0,0,0,0,0
"Côte d’Ivoire","2024-05-31",0,0,0,0,0,0,0,0
"Côte d’Ivoire","2024-06-01",0,0,0,0,0,0,0,0
"Côte d’Ivoire","2024-06-02",0,0,0,0,0,0,0,0
"Côte d’Ivoire","2024-06-03",0,0,0,0,0,0,0,0
"Côte d’Ivoire","2024-06-04",0,0,0,0,0,0,0,0
"Côte d’Ivoire","2024-06-05",0,0,0,0,0,0,0,0
"Côte d’Ivoire","2024-06-06",0,0,0,0,0,0,0,0
"Côte d’Ivoire","2024-06-07",0,0,0,0,0,0,0,0
"Côte d’Ivoire","2024-06-08",0,0,0,0,0,0,0,0
"Côte d’Ivoire","2024-06-09",0,0,0,0,0,0,0,0
"Côte d’Ivoire","2024-06-10",0,0,0,0,0,0,0,0
"Côte d’Ivoire","2024-06-11",0,0,0,0,0,0,0,0
"Côte d’Ivoire","2024-06-12",0,0,0,0,0,0,0,0
"Côte d’Ivoire","2024-06-13",0,0,0,0,0,0,0,0
"Côte d’Ivoire","2024-06-14",0,0,0,0,0,0,0,0
"Côte d’Ivoire","2024-06-15",0,0,0,0,0,0,0,0
"Côte d’Ivoire","2024-06-16",0,0,0,0,0,0,0,0
"Côte d’Ivoire","2024-06-17",0,0,0,0,0,0,0,0
"Côte d’Ivoire","2024-06-18",0,0,0,0,0,0,0,0
"Côte d’Ivoire","2024-06-19",0,0,0,0,0,0,0,0
"Côte d’Ivoire","2024-06-20",0,0,0,0,0,0,0,0
"Côte d’Ivoire","2024-06-21",0,0,0,0,0,0,0,0
"Côte d’Ivoire","2024-06-22",0,0,0,0,0,0,0,0
"Côte d’Ivoire","2024-06-23",0,0,0,0,0,0,0,0
"Côte d’Ivoire","2024-06-24",0,0,0,0,0,0,0,0
"Côte d’Ivoire","2024-06-25",0,0,0,0,0,0,0,0
"Côte d’Ivoire","2024-06-26",0,0,0,0,0,0,0,0
"Côte d’Ivoire","2024-06-27",0,0,0,0,0,0,0,0
"Côte d’Ivoire","2024-06-28",0,0,0,0,0,0,0,0
"Côte d’Ivoire","2024-06-29",0,0,0,0,0,0,0,0
"Côte d’Ivoire","2024-06-30",0,0,0,0,0,0,0,0
"Côte d’Ivoire","2024-07-01",0,0,0,0,0,0,0,0
"Côte d’Ivoire","2024-07-02",0,0,0,0,0,0,0,0
"Côte d’Ivoire","2024-07-03",0,0,0,0,0,0,0,0
"Côte d’Ivoire","2024-07-04",0,0,0,0,0,0,0,0
"Côte d’Ivoire","2024-07-05",0,0,0,0,0,0,0,0
"Côte d’Ivoire","2024-07-06",0,0,0,0,0,0,0,0
"Côte d’Ivoire","2024-07-07",0,1,1,0,1,1,0,0
"Côte d’Ivoire","2024-07-08",0,0,1,0,0,1,0,0
"Côte d’Ivoire","2024-07-09",0,0,1,0,0,1,0,0
"Côte d’Ivoire","2024-07-10",0,0,1,0,0,1,0,0
"Côte d’Ivoire","2024-07-11",0,0,1,0,1,2,0,0
"Côte d’Ivoire","2024-07-12",0,0,1,0,0,2,0,0
"Côte d’Ivoire","2024-07-13",0,0,1,0,0,2,0,0
"Côte d’Ivoire","2024-07-14",0,1,2,0,0,2,0,0
"Côte d’Ivoire","2024-07-15",0,0,2,0,0,2,0,0
"Côte d’Ivoire","2024-07-16",0,0,2,0,1,3,0,0
"Côte d’Ivoire","2024-07-17",0,0,2,0,0,3,0,0
"Côte d’Ivoire","2024-07-18",0,0,2,0,1,4,0,0
"Côte d’Ivoire","2024-07-19",0,0,2,0,0,4,0,0
"Côte d’Ivoire","2024-07-20",0,0,2,0,1,5,0,0
"Côte d’Ivoire","2024-07-21",0,3,5,0,0,5,0,0
"Côte d’Ivoire","2024-07-22",0,0,5,0,1,6,0,0
"Côte d’Ivoire","2024-07-23",0,0,5,0,0,6,0,0
"Côte d’Ivoire","2024-07-24",0,0,5,0,1,7,0,0
"Côte d’Ivoire","2024-07-25",0,0,5,0,0,7,0,0
"Côte d’Ivoire","2024-07-26",0,0,5,0,1,8,0,0
"Côte d’Ivoire","2024-07-27",0,0,5,0,0,8,0,0
"Côte d’Ivoire","2024-07-28",0,4,9,0,1,9,0,0
"Côte d’Ivoire","2024-07-29",0,0,9,0,1,10,0,0
"Côte d’Ivoire","2024-07-30",0,0,9,0,0,10,0,0
"Côte d’Ivoire","2024-07-31",0,0,9,0,1,11,0,0
"Côte d’Ivoire","2024-08-01",0,0,9,0,0,11,0,0
"Côte d’Ivoire","2024-08-02",0,0,9,0,1,12,0,0
"Côte d’Ivoire","2024-08-03",0,0,9,0,0,12,0,0
"Côte d’Ivoire","2024-08-04",0,4,13,0,1,13,0,0
"Côte d’Ivoire","2024-08-05",0,0,13,0,1,14,0,0
"Côte d’Ivoire","2024-08-06",0,0,13,0,1,15,0,0
"Côte d’Ivoire","2024-08-07",0,0,13,0,1,16,0,0
"Côte d’Ivoire","2024-08-08",0,0,13,0,1,17,0,0
"Côte d’Ivoire","2024-08-09",0,0,13,0,1,18,0,0
"Côte d’Ivoire","2024-08-10",0,0,13,0,1,19,0,0
"Côte d’Ivoire","2024-08-11",0,7,20,0,1,20,0,0
"Côte d’Ivoire","2024-08-12",0,0,20,0,2,22,0,0
"Côte d’Ivoire","2024-08-13",0,0,20,0,2,24,0,0
"Côte d’Ivoire","2024-08-14",0,0,20,0,2,26,0,0
"Côte d’Ivoire","2024-08-15",0,0,20,0,1,27,0,0
"Côte d’Ivoire","2024-08-16",0,0,20,0,2,29,0,0
"Côte d’Ivoire","2024-08-17",0,0,20,0,2,31,0,0
"Côte d’Ivoire","2024-08-18",0,13,33,0,2,33,0,0
"Côte d’Ivoire","2024-08-19",0,0,33,0,1,34,0,0
"Côte d’Ivoire","2024-08-20",0,0,33,0,2,36,0,0
"Côte d’Ivoire","2024-08-21",0,0,33,0,1,37,0,0
"Côte d’Ivoire","2024-08-22",0,0,33,0,2,39,0,0
"Côte d’Ivoire","2024-08-23",0,0,33,0,1,40,0,0
"Côte d’Ivoire","2024-08-24",0,0,33,0,2,42,0,0
"Côte d’Ivoire","2024-08-25",0,10,43,0,1,43,0,0
"Côte d’Ivoire","2024-08-26",0,0,43,0,1,44,0,0
"Côte d’Ivoire","2024-08-27",0,0,43,0,1,45,0,0
"Côte d’Ivoire","2024-08-28",0,0,43,0,1,46,0,0
"Côte d’Ivoire","2024-08-29",0,0,43,0,0,46,0,0
"Côte d’Ivoire","2024-08-30",0,0,43,0,1,47,0,0
"Côte d’Ivoire","2024-08-31",0,0,43,0,1,48,0,0
"Côte d’Ivoire","2024-09-01",0,6,49,0,1,49,0,0
"Côte d’Ivoire","2024-09-02",0,0,49,0,0,49,0,0
"Côte d’Ivoire","2024-09-03",0,0,49,0,1,50,0,0
"Côte d’Ivoire","2024-09-04",0,0,49,0,0,50,0,0
"Côte d’Ivoire","2024-09-05",0,0,49,0,1,51,0,0
"Côte d’Ivoire","2024-09-06",0,0,49,0,0,51,0,0
"Côte d’Ivoire","2024-09-07",0,0,49,0,1,52,0,0
"Côte d’Ivoire","2024-09-08",138,3,52,138,0,52,138,138
"Côte d’Ivoire","2024-09-09",0,0,52,138,1,53,6,144
"Côte d’Ivoire","2024-09-10",0,0,52,138,2,55,7,151
"Côte d’Ivoire","2024-09-11",0,0,52,138,1,56,6,157
"Côte d’Ivoire","2024-09-12",0,0,52,138,2,58,7,164
"Côte d’Ivoire","2024-09-13",0,0,52,138,1,59,6,170
"Côte d’Ivoire","2024-09-14",0,0,52,138,2,61,6,176
"Côte d’Ivoire","2024-09-15",0,10,62,138,1,62,7,183
"Côte d’Ivoire","2024-09-16",51,0,62,189,1,63,6,189
"Côte d’Ivoire","2024-09-17",0,0,62,189,1,64,2,191
"Côte d’Ivoire","2024-09-18",0,0,62,189,1,65,3,194
"Côte d’Ivoire","2024-09-19",0,0,62,189,2,67,2,196
"Côte d’Ivoire","2024-09-20",0,0,62,189,1,68,3,199
"Côte d’Ivoire","2024-09-21",0,0,62,189,1,69,2,201
"Côte d’Ivoire","2024-09-22",0,8,70,189,1,70,2,203
"Côte d’Ivoire","2024-09-23",0,0,70,189,0,70,3,206
"Côte d’Ivoire","2024-09-24",0,0,70,189,1,71,2,208
"Côte d’Ivoire","2024-09-25",0,0,70,189,0,71,3,211
"Côte d’Ivoire","2024-09-26",0,0,70,189,0,71,2,213
"Côte d’Ivoire","2024-09-27",0,0,70,189,0,71,2,215
"Côte d’Ivoire","2024-09-28",0,0,70,189,1,72,3,218
"Côte d’Ivoire","2024-09-29",0,2,72,189,0,72,2,220
"Côte d’Ivoire","2024-09-30",0,0,72,189,1,73,3,223
"Côte d’Ivoire","2024-10-01",0,0,72,189,1,74,2,225
"Côte d’Ivoire","2024-10-02",0,0,72,189,1,75,2,227
"Côte d’Ivoire","2024-10-03",0,0,72,189,1,76,3,230
"Côte d’Ivoire","2024-10-04",0,0,72,189,1,77,2,232
"Côte d’Ivoire","2024-10-05",0,0,72,189,1,78,3,235
"Côte d’Ivoire","2024-10-06",48,7,79,237,1,79,2,237
"Côte d’Ivoire","2024-10-07",0,0,79,237,0,79,5,242
"Côte d’Ivoire","2024-10-08",0,0,79,237,0,79,6,248
"Côte d’Ivoire","2024-10-09",0,0,79,237,0,79,5,253
"Côte d’Ivoire","2024-10-10",0,0,79,237,0,79,5,258
"Côte d’Ivoire","2024-10-11",0,0,79,237,0,79,6,264
"Côte d’Ivoire","2024-10-12",32,0,79,269,0,79,5,269
"Côte d’Ivoire","2024-10-13",0,0,79,269,0,79,3,272
"Côte d’Ivoire","2024-10-14",0,0,79,269,1,80,3,275
"Côte d’Ivoire","2024-10-15",0,0,79,269,0,80,2,277
"Côte d’Ivoire","2024-10-16",0,0,79,269,0,80,3,280
"Côte d’Ivoire","2024-10-17",0,0,79,269,0,80,3,283
"Côte d’Ivoire","2024-10-18",0,0,79,269,0,80,3,286
"Côte d’Ivoire","2024-10-19",0,0,79,269,0,80,3,289
"Côte d’Ivoire","2024-10-20",0,1,80,269,0,80,2,291
"Côte d’Ivoire","2024-10-21",0,0,80,269,1,81,3,294
"Côte d’Ivoire","2024-10-22",0,0,80,269,2,83,3,297
"Côte d’Ivoire","2024-10-23",0,0,80,269,1,84,3,300
"Côte d’Ivoire","2024-10-24",0,0,80,269,1,85,3,303
"Côte d’Ivoire","2024-10-25",0,0,80,269,1,86,2,305
"Côte d’Ivoire","2024-10-26",0,0,80,269,2,88,3,308
"Côte d’Ivoire","2024-10-27",42,9,89,311,1,89,3,311
"Côte d’Ivoire","2024-10-28",0,0,89,311,1,90,0,311
"Côte d’Ivoire","2024-10-29",0,0,89,311,0,90,0,311
"Côte d’Ivoire","2024-10-30",0,2,91,311,1,91,0,311
"Côte d’Ivoire","2024-10-31",0,0,91,311,0,91,0,311
"Côte d’Ivoire","2024-11-01",0,0,91,311,0,91,0,311
"Côte d’Ivoire","2024-11-02",0,0,91,311,1,92,0,311
"Côte d’Ivoire","2024-11-03",0,0,91,311,0,92,0,311
"Côte d’Ivoire","2024-11-04",0,0,91,311,0,92,0,311
"Côte d’Ivoire","2024-11-05",0,0,91,311,0,92,0,311
"Côte d’Ivoire","2024-11-06",0,0,91,311,1,93,0,311
"Côte d’Ivoire","2024-11-07",0,0,91,311,0,93,0,311
"Côte d’Ivoire","2024-11-08",0,0,91,311,0,93,0,311
"Côte d’Ivoire","2024-11-09",0,0,91,311,0,93,0,311
"Côte d’Ivoire","2024-11-10",0,0,91,311,0,93,0,311
"Côte d’Ivoire","2024-11-11",0,0,91,311,1,94,0,311
"Côte d’Ivoire","2024-11-12",0,0,91,311,0,94,0,311
"Côte d’Ivoire","2024-11-13",0,0,91,311,0,94,0,311
"Côte d’Ivoire","2024-11-14",0,0,91,311,0,94,0,311
"Côte d’Ivoire","2024-11-15",0,0,91,311,1,95,0,311
"Côte d’Ivoire","2024-11-16",0,0,91,311,0,95,0,311
"Côte d’Ivoire","2024-11-17",0,4,95,311,0,95,0,311
"Côte d’Ivoire","2024-11-18",0,0,95,311,1,96,0,311
"Côte d’Ivoire","2024-11-19",0,0,95,311,1,97,0,311
"Côte d’Ivoire","2024-11-20",0,0,95,311,1,98,0,311
"Côte d’Ivoire","2024-11-21",0,0,95,311,0,98,0,311
"Côte d’Ivoire","2024-11-22",0,0,95,311,1,99,0,311
"Côte d’Ivoire","2024-11-23",0,0,95,311,1,100,0,311
"Côte d’Ivoire","2024-11-24",0,6,101,311,1,101,0,311
"Côte d’Ivoire","2024-11-25",0,0,101,311,0,101,0,311
"Côte d’Ivoire","2024-11-26",0,0,101,311,0,101,0,311
"Côte d’Ivoire","2024-11-27",0,0,101,311,0,101,0,311
"Côte d’Ivoire","2024-11-28",0,0,101,311,0,101,0,311
"Côte d’Ivoire","2024-11-29",0,0,101,311,0,101,0,311
"Côte d’Ivoire","2024-11-30",0,0,101,311,0,101,0,311
"Côte d’Ivoire","2024-12-01",0,0,101,311,0,101,0,311
"Côte d’Ivoire","2024-12-02",0,0,101,311,0,101,0,311
"Côte d’Ivoire","2024-12-03",0,0,101,311,0,101,0,311
"Côte d’Ivoire","2024-12-04",0,0,101,311,0,101,0,311
"Côte d’Ivoire","2024-12-05",0,0,101,311,0,101,0,311
"Côte d’Ivoire","2024-12-06",0,0,101,311,0,101,0,311
"Côte d’Ivoire","2024-12-07",0,0,101,311,0,101,0,311
"Côte d’Ivoire","2024-12-08",0,0,101,311,0,101,0,311
"Côte d’Ivoire","2024-12-09",0,0,101,311,0,101,0,311
"Côte d’Ivoire","2024-12-10",0,0,101,311,0,101,0,311
"Côte d’Ivoire","2024-12-11",0,0,101,311,0,101,0,311
"Côte d’Ivoire","2024-12-12",0,0,101,311,0,101,0,311
"Côte d’Ivoire","2024-12-13",0,0,101,311,0,101,0,311
"Côte d’Ivoire","2024-12-14",0,0,101,311,0,101,0,311
"Côte d’Ivoire","2024-12-15",0,0,101,311,0,101,0,311
"Côte d’Ivoire","2024-12-16",0,0,101,311,0,101,0,311
"Côte d’Ivoire","2024-12-17",0,0,101,311,0,101,0,311
"Côte d’Ivoire","2024-12-18",0,0,101,311,0,101,0,311
"Côte d’Ivoire","2024-12-19",0,0,101,311,0,101,0,311
"Côte d’Ivoire","2024-12-20",0,0,101,311,0,101,0,311
"Côte d’Ivoire","2024-12-21",0,0,101,311,0,101,0,311
"Côte d’Ivoire","2024-12-22",0,0,101,311,0,101,0,311
"Côte d’Ivoire","2024-12-23",0,0,101,311,0,101,0,311
"Côte d’Ivoire","2024-12-24",0,0,101,311,0,101,0,311
"Côte d’Ivoire","2024-12-25",0,0,101,311,0,101,0,311
"Côte d’Ivoire","2024-12-26",0,0,101,311,0,101,0,311
"Côte d’Ivoire","2024-12-27",0,0,101,311,0,101,0,311
"Côte d’Ivoire","2024-12-28",0,0,101,311,0,101,0,311
"Côte d’Ivoire","2024-12-29",0,0,101,311,0,101,0,311
"Côte d’Ivoire","2024-12-30",0,0,101,311,0,101,0,311
"Côte d’Ivoire","2024-12-31",0,0,101,311,0,101,0,311
"Côte d’Ivoire","2025-01-01",0,0,101,311,0,101,0,311
"Côte d’Ivoire","2025-01-02",0,0,101,311,0,101,0,311
"Côte d’Ivoire","2025-01-03",0,0,101,311,0,101,0,311
"Côte d’Ivoire","2025-01-04",0,0,101,311,0,101,0,311
"Côte d’Ivoire","2025-01-05",0,0,101,311,0,101,0,311
"Côte d’Ivoire","2025-01-06",0,0,101,311,0,101,0,311
"Côte d’Ivoire","2025-01-07",0,0,101,311,0,101,0,311
"Côte d’Ivoire","2025-01-08",0,0,101,311,0,101,0,311
"Côte d’Ivoire","2025-01-09",0,0,101,311,0,101,0,311
"Côte d’Ivoire","2025-01-10",0,0,101,311,0,101,0,311
"Côte d’Ivoire","2025-01-11",0,0,101,311,0,101,0,311
"Côte d’Ivoire","2025-01-12",0,0,101,311,0,101,0,311
"Côte d’Ivoire","2025-01-13",0,0,101,311,0,101,0,311
"Croatia","2024-01-01",0,0,0,0,0,0,0,0
"Croatia","2024-01-02",0,0,0,0,0,0,0,0
"Croatia","2024-01-03",0,0,0,0,0,0,0,0
"Croatia","2024-01-04",0,0,0,0,0,0,0,0
"Croatia","2024-01-05",0,0,0,0,0,0,0,0
"Croatia","2024-01-06",0,0,0,0,0,0,0,0
"Croatia","2024-01-07",0,0,0,0,0,0,0,0
"Croatia","2024-01-08",0,0,0,0,0,0,0,0
"Croatia","2024-01-09",0,0,0,0,0,0,0,0
"Croatia","2024-01-10",0,0,0,0,0,0,0,0
"Croatia","2024-01-11",0,0,0,0,0,0,0,0
"Croatia","2024-01-12",0,0,0,0,0,0,0,0
"Croatia","2024-01-13",0,0,0,0,0,0,0,0
"Croatia","2024-01-14",0,0,0,0,0,0,0,0
"Croatia","2024-01-15",0,0,0,0,0,0,0,0
"Croatia","2024-01-16",0,0,0,0,0,0,0,0
"Croatia","2024-01-17",0,0,0,0,0,0,0,0
"Croatia","2024-01-18",0,0,0,0,0,0,0,0
"Croatia","2024-01-19",0,0,0,0,0,0,0,0
"Croatia","2024-01-20",0,0,0,0,0,0,0,0
"Croatia","2024-01-21",0,0,0,0,0,0,0,0
"Croatia","2024-01-22",0,0,0,0,0,0,0,0
"Croatia","2024-01-23",0,0,0,0,0,0,0,0
"Croatia","2024-01-24",0,0,0,0,0,0,0,0
"Croatia","2024-01-25",0,0,0,0,0,0,0,0
"Croatia","2024-01-26",0,0,0,0,0,0,0,0
"Croatia","2024-01-27",0,0,0,0,0,0,0,0
"Croatia","2024-01-28",0,0,0,0,0,0,0,0
"Croatia","2024-01-29",0,0,0,0,0,0,0,0
"Croatia","2024-01-30",0,0,0,0,0,0,0,0
"Croatia","2024-01-31",0,0,0,0,0,0,0,0
"Croatia","2024-02-01",0,0,0,0,0,0,0,0
"Croatia","2024-02-02",0,0,0,0,0,0,0,0
"Croatia","2024-02-03",0,0,0,0,0,0,0,0
"Croatia","2024-02-04",0,0,0,0,0,0,0,0
"Croatia","2024-02-05",0,0,0,0,0,0,0,0
"Croatia","2024-02-06",0,0,0,0,0,0,0,0
"Croatia","2024-02-07",0,0,0,0,0,0,0,0
"Croatia","2024-02-08",0,0,0,0,0,0,0,0
"Croatia","2024-02-09",0,0,0,0,0,0,0,0
"Croatia","2024-02-10",0,0,0,0,0,0,0,0
"Croatia","2024-02-11",0,0,0,0,0,0,0,0
"Croatia","2024-02-12",0,0,0,0,0,0,0,0
"Croatia","2024-02-13",0,0,0,0,0,0,0,0
"Croatia","2024-02-14",0,0,0,0,0,0,0,0
"Croatia","2024-02-15",0,0,0,0,0,0,0,0
"Croatia","2024-02-16",0,0,0,0,0,0,0,0
"Croatia","2024-02-17",0,0,0,0,0,0,0,0
"Croatia","2024-02-18",0,0,0,0,0,0,0,0
"Croatia","2024-02-19",0,0,0,0,0,0,0,0
"Croatia","2024-02-20",0,0,0,0,0,0,0,0
"Croatia","2024-02-21",0,0,0,0,0,0,0,0
"Croatia","2024-02-22",0,0,0,0,0,0,0,0
"Croatia","2024-02-23",0,0,0,0,0,0,0,0
"Croatia","2024-02-24",0,0,0,0,0,0,0,0
"Croatia","2024-02-25",0,0,0,0,0,0,0,0
"Croatia","2024-02-26",0,0,0,0,0,0,0,0
"Croatia","2024-02-27",0,0,0,0,0,0,0,0
"Croatia","2024-02-28",0,0,0,0,0,0,0,0
"Croatia","2024-02-29",0,0,0,0,0,0,0,0
"Croatia","2024-03-01",0,0,0,0,0,0,0,0
"Croatia","2024-03-02",0,0,0,0,0,0,0,0
"Croatia","2024-03-03",0,0,0,0,0,0,0,0
"Croatia","2024-03-04",0,0,0,0,0,0,0,0
"Croatia","2024-03-05",0,0,0,0,0,0,0,0
"Croatia","2024-03-06",0,0,0,0,0,0,0,0
"Croatia","2024-03-07",0,0,0,0,0,0,0,0
"Croatia","2024-03-08",0,0,0,0,0,0,0,0
"Croatia","2024-03-09",0,0,0,0,0,0,0,0
"Croatia","2024-03-10",0,0,0,0,0,0,0,0
"Croatia","2024-03-11",0,0,0,0,0,0,0,0
"Croatia","2024-03-12",0,0,0,0,0,0,0,0
"Croatia","2024-03-13",0,0,0,0,0,0,0,0
"Croatia","2024-03-14",0,0,0,0,0,0,0,0
"Croatia","2024-03-15",0,0,0,0,0,0,0,0
"Croatia","2024-03-16",0,0,0,0,0,0,0,0
"Croatia","2024-03-17",0,0,0,0,0,0,0,0
"Croatia","2024-03-18",0,0,0,0,0,0,0,0
"Croatia","2024-03-19",0,0,0,0,0,0,0,0
"Croatia","2024-03-20",0,0,0,0,0,0,0,0
"Croatia","2024-03-21",0,0,0,0,0,0,0,0
"Croatia","2024-03-22",0,0,0,0,0,0,0,0
"Croatia","2024-03-23",0,0,0,0,0,0,0,0
"Croatia","2024-03-24",0,0,0,0,0,0,0,0
"Croatia","2024-03-25",0,0,0,0,0,0,0,0
"Croatia","2024-03-26",0,0,0,0,0,0,0,0
"Croatia","2024-03-27",0,0,0,0,0,0,0,0
"Croatia","2024-03-28",0,0,0,0,0,0,0,0
"Croatia","2024-03-29",0,0,0,0,0,0,0,0
"Croatia","2024-03-30",0,0,0,0,0,0,0,0
"Croatia","2024-03-31",0,0,0,0,0,0,0,0
"Croatia","2024-04-01",0,0,0,0,0,0,0,0
"Croatia","2024-04-02",0,0,0,0,0,0,0,0
"Croatia","2024-04-03",0,0,0,0,0,0,0,0
"Croatia","2024-04-04",0,0,0,0,0,0,0,0
"Croatia","2024-04-05",0,0,0,0,0,0,0,0
"Croatia","2024-04-06",0,0,0,0,0,0,0,0
"Croatia","2024-04-07",0,0,0,0,0,0,0,0
"Croatia","2024-04-08",0,0,0,0,0,0,0,0
"Croatia","2024-04-09",0,0,0,0,0,0,0,0
"Croatia","2024-04-10",0,0,0,0,0,0,0,0
"Croatia","2024-04-11",0,0,0,0,0,0,0,0
"Croatia","2024-04-12",0,0,0,0,0,0,0,0
"Croatia","2024-04-13",0,0,0,0,0,0,0,0
"Croatia","2024-04-14",0,0,0,0,0,0,0,0
"Croatia","2024-04-15",0,0,0,0,0,0,0,0
"Croatia","2024-04-16",0,0,0,0,0,0,0,0
"Croatia","2024-04-17",0,0,0,0,0,0,0,0
"Croatia","2024-04-18",0,0,0,0,0,0,0,0
"Croatia","2024-04-19",0,0,0,0,0,0,0,0
"Croatia","2024-04-20",0,0,0,0,0,0,0,0
"Croatia","2024-04-21",0,0,0,0,0,0,0,0
"Croatia","2024-04-22",0,0,0,0,0,0,0,0
"Croatia","2024-04-23",0,0,0,0,0,0,0,0
"Croatia","2024-04-24",0,0,0,0,0,0,0,0
"Croatia","2024-04-25",0,0,0,0,0,0,0,0
"Croatia","2024-04-26",0,0,0,0,0,0,0,0
"Croatia","2024-04-27",0,0,0,0,0,0,0,0
"Croatia","2024-04-28",0,0,0,0,0,0,0,0
"Croatia","2024-04-29",0,0,0,0,0,0,0,0
"Croatia","2024-04-30",0,1,1,0,1,1,0,0
"Croatia","2024-05-01",0,0,1,0,0,1,0,0
"Croatia","2024-05-02",0,0,1,0,0,1,0,0
"Croatia","2024-05-03",0,0,1,0,0,1,0,0
"Croatia","2024-05-04",0,0,1,0,0,1,0,0
"Croatia","2024-05-05",0,0,1,0,0,1,0,0
"Croatia","2024-05-06",0,0,1,0,0,1,0,0
"Croatia","2024-05-07",0,0,1,0,0,1,0,0
"Croatia","2024-05-08",0,0,1,0,0,1,0,0
"Croatia","2024-05-09",0,0,1,0,0,1,0,0
"Croatia","2024-05-10",0,0,1,0,0,1,0,0
"Croatia","2024-05-11",0,0,1,0,0,1,0,0
"Croatia","2024-05-12",0,0,1,0,0,1,0,0
"Croatia","2024-05-13",0,0,1,0,0,1,0,0
"Croatia","2024-05-14",0,0,1,0,0,1,0,0
"Croatia","2024-05-15",0,0,1,0,0,1,0,0
"Croatia","2024-05-16",0,0,1,0,0,1,0,0
"Croatia","2024-05-17",0,0,1,0,0,1,0,0
"Croatia","2024-05-18",0,0,1,0,0,1,0,0
"Croatia","2024-05-19",0,0,1,0,0,1,0,0
"Croatia","2024-05-20",0,0,1,0,0,1,0,0
"Croatia","2024-05-21",0,0,1,0,0,1,0,0
"Croatia","2024-05-22",0,0,1,0,0,1,0,0
"Croatia","2024-05-23",0,0,1,0,0,1,0,0
"Croatia","2024-05-24",0,0,1,0,0,1,0,0
"Croatia","2024-05-25",0,0,1,0,0,1,0,0
"Croatia","2024-05-26",0,0,1,0,0,1,0,0
"Croatia","2024-05-27",0,0,1,0,0,1,0,0
"Croatia","2024-05-28",0,0,1,0,0,1,0,0
"Croatia","2024-05-29",0,0,1,0,0,1,0,0
"Croatia","2024-05-30",0,0,1,0,0,1,0,0
"Croatia","2024-05-31",0,0,1,0,0,1,0,0
"Croatia","2024-06-01",0,0,1,0,0,1,0,0
"Croatia","2024-06-02",0,0,1,0,0,1,0,0
"Croatia","2024-06-03",0,0,1,0,0,1,0,0
"Croatia","2024-06-04",0,0,1,0,0,1,0,0
"Croatia","2024-06-05",0,0,1,0,0,1,0,0
"Croatia","2024-06-06",0,0,1,0,0,1,0,0
"Croatia","2024-06-07",0,0,1,0,0,1,0,0
"Croatia","2024-06-08",0,0,1,0,0,1,0,0
"Croatia","2024-06-09",0,0,1,0,0,1,0,0
"Croatia","2024-06-10",0,0,1,0,0,1,0,0
"Croatia","2024-06-11",0,0,1,0,0,1,0,0
"Croatia","2024-06-12",0,0,1,0,0,1,0,0
"Croatia","2024-06-13",0,0,1,0,0,1,0,0
"Croatia","2024-06-14",0,0,1,0,0,1,0,0
"Croatia","2024-06-15",0,0,1,0,0,1,0,0
"Croatia","2024-06-16",0,0,1,0,0,1,0,0
"Croatia","2024-06-17",0,0,1,0,0,1,0,0
"Croatia","2024-06-18",0,0,1,0,0,1,0,0
"Croatia","2024-06-19",0,0,1,0,0,1,0,0
"Croatia","2024-06-20",0,0,1,0,0,1,0,0
"Croatia","2024-06-21",0,0,1,0,0,1,0,0
"Croatia","2024-06-22",0,0,1,0,0,1,0,0
"Croatia","2024-06-23",0,0,1,0,0,1,0,0
"Croatia","2024-06-24",0,0,1,0,0,1,0,0
"Croatia","2024-06-25",0,0,1,0,0,1,0,0
"Croatia","2024-06-26",0,0,1,0,0,1,0,0
"Croatia","2024-06-27",0,0,1,0,0,1,0,0
"Croatia","2024-06-28",0,0,1,0,0,1,0,0
"Croatia","2024-06-29",0,0,1,0,0,1,0,0
"Croatia","2024-06-30",0,0,1,0,0,1,0,0
"Croatia","2024-07-01",0,0,1,0,0,1,0,0
"Croatia","2024-07-02",0,0,1,0,0,1,0,0
"Croatia","2024-07-03",0,0,1,0,0,1,0,0
"Croatia","2024-07-04",0,0,1,0,0,1,0,0
"Croatia","2024-07-05",0,0,1,0,0,1,0,0
"Croatia","2024-07-06",0,0,1,0,0,1,0,0
"Croatia","2024-07-07",0,0,1,0,0,1,0,0
"Croatia","2024-07-08",0,0,1,0,0,1,0,0
"Croatia","2024-07-09",0,0,1,0,0,1,0,0
"Croatia","2024-07-10",0,0,1,0,0,1,0,0
"Croatia","2024-07-11",0,0,1,0,0,1,0,0
"Croatia","2024-07-12",0,0,1,0,0,1,0,0
"Croatia","2024-07-13",0,0,1,0,0,1,0,0
"Croatia","2024-07-14",0,0,1,0,0,1,0,0
"Croatia","2024-07-15",0,0,1,0,0,1,0,0
"Croatia","2024-07-16",0,0,1,0,0,1,0,0
"Croatia","2024-07-17",0,0,1,0,0,1,0,0
"Croatia","2024-07-18",0,0,1,0,0,1,0,0
"Croatia","2024-07-19",0,0,1,0,0,1,0,0
"Croatia","2024-07-20",0,0,1,0,0,1,0,0
"Croatia","2024-07-21",0,0,1,0,0,1,0,0
"Croatia","2024-07-22",0,0,1,0,0,1,0,0
"Croatia","2024-07-23",0,0,1,0,0,1,0,0
"Croatia","2024-07-24",0,0,1,0,0,1,0,0
"Croatia","2024-07-25",0,0,1,0,0,1,0,0
"Croatia","2024-07-26",0,0,1,0,0,1,0,0
"Croatia","2024-07-27",0,0,1,0,0,1,0,0
"Croatia","2024-07-28",0,0,1,0,0,1,0,0
"Croatia","2024-07-29",0,0,1,0,0,1,0,0
"Croatia","2024-07-30",0,0,1,0,0,1,0,0
"Croatia","2024-07-31",0,0,1,0,0,1,0,0
"Croatia","2024-08-01",0,0,1,0,0,1,0,0
"Croatia","2024-08-02",0,0,1,0,0,1,0,0
"Croatia","2024-08-03",0,0,1,0,0,1,0,0
"Croatia","2024-08-04",0,0,1,0,0,1,0,0
"Croatia","2024-08-05",0,0,1,0,0,1,0,0
"Croatia","2024-08-06",0,0,1,0,0,1,0,0
"Croatia","2024-08-07",0,0,1,0,0,1,0,0
"Croatia","2024-08-08",0,0,1,0,0,1,0,0
"Croatia","2024-08-09",0,0,1,0,0,1,0,0
"Croatia","2024-08-10",0,0,1,0,0,1,0,0
"Croatia","2024-08-11",0,0,1,0,0,1,0,0
"Croatia","2024-08-12",0,0,1,0,0,1,0,0
"Croatia","2024-08-13",0,0,1,0,0,1,0,0
"Croatia","2024-08-14",0,0,1,0,0,1,0,0
"Croatia","2024-08-15",0,0,1,0,0,1,0,0
"Croatia","2024-08-16",0,0,1,0,1,2,0,0
"Croatia","2024-08-17",0,0,1,0,0,2,0,0
"Croatia","2024-08-18",0,0,1,0,0,2,0,0
"Croatia","2024-08-19",0,0,1,0,0,2,0,0
"Croatia","2024-08-20",0,0,1,0,0,2,0,0
"Croatia","2024-08-21",0,0,1,0,0,2,0,0
"Croatia","2024-08-22",0,0,1,0,0,2,0,0
"Croatia","2024-08-23",0,0,1,0,0,2,0,0
"Croatia","2024-08-24",0,0,1,0,0,2,0,0
"Croatia","2024-08-25",0,0,1,0,0,2,0,0
"Croatia","2024-08-26",0,0,1,0,0,2,0,0
"Croatia","2024-08-27",0,0,1,0,0,2,0,0
"Croatia","2024-08-28",0,0,1,0,0,2,0,0
"Croatia","2024-08-29",0,0,1,0,0,2,0,0
"Croatia","2024-08-30",0,0,1,0,0,2,0,0
"Croatia","2024-08-31",0,0,1,0,0,2,0,0
"Croatia","2024-09-01",0,0,1,0,0,2,0,0
"Croatia","2024-09-02",0,0,1,0,0,2,0,0
"Croatia","2024-09-03",0,0,1,0,0,2,0,0
"Croatia","2024-09-04",0,0,1,0,0,2,0,0
"Croatia","2024-09-05",0,0,1,0,0,2,0,0
"Croatia","2024-09-06",0,0,1,0,0,2,0,0
"Croatia","2024-09-07",0,0,1,0,0,2,0,0
"Croatia","2024-09-08",0,0,1,0,0,2,0,0
"Croatia","2024-09-09",0,0,1,0,0,2,0,0
"Croatia","2024-09-10",0,0,1,0,0,2,0,0
"Croatia","2024-09-11",0,0,1,0,0,2,0,0
"Croatia","2024-09-12",0,0,1,0,0,2,0,0
"Croatia","2024-09-13",0,0,1,0,0,2,0,0
"Croatia","2024-09-14",0,0,1,0,0,2,0,0
"Croatia","2024-09-15",0,0,1,0,0,2,0,0
"Croatia","2024-09-16",0,0,1,0,0,2,0,0
"Croatia","2024-09-17",0,0,1,0,0,2,0,0
"Croatia","2024-09-18",0,0,1,0,0,2,0,0
"Croatia","2024-09-19",0,0,1,0,0,2,0,0
"Croatia","2024-09-20",0,0,1,0,0,2,0,0
"Croatia","2024-09-21",0,0,1,0,0,2,0,0
"Croatia","2024-09-22",0,0,1,0,0,2,0,0
"Croatia","2024-09-23",0,0,1,0,0,2,0,0
"Croatia","2024-09-24",0,0,1,0,0,2,0,0
"Croatia","2024-09-25",0,0,1,0,0,2,0,0
"Croatia","2024-09-26",0,0,1,0,0,2,0,0
"Croatia","2024-09-27",0,0,1,0,0,2,0,0
"Croatia","2024-09-28",0,0,1,0,0,2,0,0
"Croatia","2024-09-29",0,0,1,0,0,2,0,0
"Croatia","2024-09-30",0,0,1,0,0,2,0,0
"Croatia","2024-10-01",0,0,1,0,0,2,0,0
"Croatia","2024-10-02",0,0,1,0,0,2,0,0
"Croatia","2024-10-03",0,0,1,0,0,2,0,0
"Croatia","2024-10-04",0,0,1,0,0,2,0,0
"Croatia","2024-10-05",0,0,1,0,0,2,0,0
"Croatia","2024-10-06",0,0,1,0,0,2,0,0
"Croatia","2024-10-07",0,0,1,0,0,2,0,0
"Croatia","2024-10-08",0,0,1,0,0,2,0,0
"Croatia","2024-10-09",0,0,1,0,0,2,0,0
"Croatia","2024-10-10",0,0,1,0,0,2,0,0
"Croatia","2024-10-11",0,0,1,0,0,2,0,0
"Croatia","2024-10-12",0,0,1,0,0,2,0,0
"Croatia","2024-10-13",0,0,1,0,0,2,0,0
"Croatia","2024-10-14",0,0,1,0,0,2,0,0
"Croatia","2024-10-15",0,0,1,0,0,2,0,0
"Croatia","2024-10-16",0,0,1,0,0,2,0,0
"Croatia","2024-10-17",0,0,1,0,0,2,0,0
"Croatia","2024-10-18",0,0,1,0,0,2,0,0
"Croatia","2024-10-19",0,0,1,0,0,2,0,0
"Croatia","2024-10-20",0,0,1,0,0,2,0,0
"Croatia","2024-10-21",0,0,1,0,0,2,0,0
"Croatia","2024-10-22",0,0,1,0,0,2,0,0
"Croatia","2024-10-23",0,0,1,0,0,2,0,0
"Croatia","2024-10-24",0,0,1,0,0,2,0,0
"Croatia","2024-10-25",0,0,1,0,0,2,0,0
"Croatia","2024-10-26",0,0,1,0,0,2,0,0
"Croatia","2024-10-27",0,0,1,0,0,2,0,0
"Croatia","2024-10-28",0,0,1,0,0,2,0,0
"Croatia","2024-10-29",0,0,1,0,0,2,0,0
"Croatia","2024-10-30",0,0,1,0,0,2,0,0
"Croatia","2024-10-31",0,0,1,0,0,2,0,0
"Croatia","2024-11-01",0,0,1,0,0,2,0,0
"Croatia","2024-11-02",0,0,1,0,0,2,0,0
"Croatia","2024-11-03",0,0,1,0,0,2,0,0
"Croatia","2024-11-04",0,0,1,0,0,2,0,0
"Croatia","2024-11-05",0,0,1,0,0,2,0,0
"Croatia","2024-11-06",0,0,1,0,0,2,0,0
"Croatia","2024-11-07",0,0,1,0,0,2,0,0
"Croatia","2024-11-08",0,0,1,0,0,2,0,0
"Croatia","2024-11-09",0,0,1,0,0,2,0,0
"Croatia","2024-11-10",0,0,1,0,0,2,0,0
"Croatia","2024-11-11",0,0,1,0,0,2,0,0
"Croatia","2024-11-12",0,0,1,0,0,2,0,0
"Croatia","2024-11-13",0,0,1,0,0,2,0,0
"Croatia","2024-11-14",0,0,1,0,0,2,0,0
"Croatia","2024-11-15",0,0,1,0,0,2,0,0
"Croatia","2024-11-16",0,0,1,0,0,2,0,0
"Croatia","2024-11-17",0,0,1,0,0,2,0,0
"Croatia","2024-11-18",0,0,1,0,0,2,0,0
"Croatia","2024-11-19",0,0,1,0,0,2,0,0
"Croatia","2024-11-20",0,0,1,0,0,2,0,0
"Croatia","2024-11-21",0,0,1,0,0,2,0,0
"Croatia","2024-11-22",0,0,1,0,0,2,0,0
"Croatia","2024-11-23",0,0,1,0,0,2,0,0
"Croatia","2024-11-24",0,0,1,0,0,2,0,0
"Croatia","2024-11-25",0,0,1,0,0,2,0,0
"Croatia","2024-11-26",0,0,1,0,0,2,0,0
"Croatia","2024-11-27",0,0,1,0,0,2,0,0
"Croatia","2024-11-28",0,0,1,0,0,2,0,0
"Croatia","2024-11-29",0,0,1,0,0,2,0,0
"Croatia","2024-11-30",0,1,2,0,0,2,0,0
"Croatia","2024-12-01",0,0,2,0,0,2,0,0
"Croatia","2024-12-02",0,0,2,0,0,2,0,0
"Croatia","2024-12-03",0,0,2,0,0,2,0,0
"Croatia","2024-12-04",0,0,2,0,0,2,0,0
"Croatia","2024-12-05",0,0,2,0,0,2,0,0
"Croatia","2024-12-06",0,0,2,0,0,2,0,0
"Croatia","2024-12-07",0,0,2,0,0,2,0,0
"Croatia","2024-12-08",0,0,2,0,0,2,0,0
"Croatia","2024-12-09",0,0,2,0,0,2,0,0
"Croatia","2024-12-10",0,0,2,0,0,2,0,0
"Croatia","2024-12-11",0,0,2,0,0,2,0,0
"Croatia","2024-12-12",0,0,2,0,0,2,0,0
"Croatia","2024-12-13",0,0,2,0,0,2,0,0
"Croatia","2024-12-14",0,0,2,0,0,2,0,0
"Croatia","2024-12-15",0,0,2,0,0,2,0,0
"Croatia","2024-12-16",0,0,2,0,0,2,0,0
"Croatia","2024-12-17",0,0,2,0,0,2,0,0
"Croatia","2024-12-18",0,0,2,0,0,2,0,0
"Croatia","2024-12-19",0,0,2,0,0,2,0,0
"Croatia","2024-12-20",0,0,2,0,0,2,0,0
"Croatia","2024-12-21",0,0,2,0,0,2,0,0
"Croatia","2024-12-22",0,0,2,0,0,2,0,0
"Croatia","2024-12-23",0,0,2,0,0,2,0,0
"Croatia","2024-12-24",0,0,2,0,0,2,0,0
"Croatia","2024-12-25",0,0,2,0,0,2,0,0
"Croatia","2024-12-26",0,0,2,0,0,2,0,0
"Croatia","2024-12-27",0,0,2,0,0,2,0,0
"Croatia","2024-12-28",0,0,2,0,0,2,0,0
"Croatia","2024-12-29",0,0,2,0,0,2,0,0
"Croatia","2024-12-30",0,0,2,0,0,2,0,0
"Croatia","2024-12-31",0,0,2,0,0,2,0,0
"Croatia","2025-01-01",0,0,2,0,0,2,0,0
"Croatia","2025-01-02",0,0,2,0,0,2,0,0
"Croatia","2025-01-03",0,0,2,0,0,2,0,0
"Croatia","2025-01-04",0,0,2,0,0,2,0,0
"Croatia","2025-01-05",0,0,2,0,0,2,0,0
"Croatia","2025-01-06",0,0,2,0,0,2,0,0
"Croatia","2025-01-07",0,0,2,0,0,2,0,0
"Croatia","2025-01-08",0,0,2,0,0,2,0,0
"Croatia","2025-01-09",0,0,2,0,0,2,0,0
"Croatia","2025-01-10",0,0,2,0,0,2,0,0
"Croatia","2025-01-11",0,0,2,0,0,2,0,0
"Croatia","2025-01-12",0,0,2,0,0,2,0,0
"Croatia","2025-01-13",0,0,2,0,0,2,0,0
"Cuba","2024-01-01",0,0,0,0,0,0,0,0
"Cuba","2024-01-02",0,0,0,0,0,0,0,0
"Cuba","2024-01-03",0,0,0,0,0,0,0,0
"Cuba","2024-01-04",0,0,0,0,0,0,0,0
"Cuba","2024-01-05",0,0,0,0,0,0,0,0
"Cuba","2024-01-06",0,0,0,0,0,0,0,0
"Cuba","2024-01-07",0,0,0,0,0,0,0,0
"Cuba","2024-01-08",0,0,0,0,0,0,0,0
"Cuba","2024-01-09",0,0,0,0,0,0,0,0
"Cuba","2024-01-10",0,0,0,0,0,0,0,0
"Cuba","2024-01-11",0,0,0,0,0,0,0,0
"Cuba","2024-01-12",0,0,0,0,0,0,0,0
"Cuba","2024-01-13",0,0,0,0,0,0,0,0
"Cuba","2024-01-14",0,0,0,0,0,0,0,0
"Cuba","2024-01-15",0,0,0,0,0,0,0,0
"Cuba","2024-01-16",0,0,0,0,0,0,0,0
"Cuba","2024-01-17",0,0,0,0,0,0,0,0
"Cuba","2024-01-18",0,0,0,0,0,0,0,0
"Cuba","2024-01-19",0,0,0,0,0,0,0,0
"Cuba","2024-01-20",0,0,0,0,0,0,0,0
"Cuba","2024-01-21",0,0,0,0,0,0,0,0
"Cuba","2024-01-22",0,0,0,0,0,0,0,0
"Cuba","2024-01-23",0,0,0,0,0,0,0,0
"Cuba","2024-01-24",0,0,0,0,0,0,0,0
"Cuba","2024-01-25",0,0,0,0,0,0,0,0
"Cuba","2024-01-26",0,0,0,0,0,0,0,0
"Cuba","2024-01-27",0,0,0,0,0,0,0,0
"Cuba","2024-01-28",0,0,0,0,0,0,0,0
"Cuba","2024-01-29",0,0,0,0,0,0,0,0
"Cuba","2024-01-30",0,0,0,0,0,0,0,0
"Cuba","2024-01-31",0,0,0,0,0,0,0,0
"Cuba","2024-02-01",0,0,0,0,0,0,0,0
"Cuba","2024-02-02",0,0,0,0,0,0,0,0
"Cuba","2024-02-03",0,0,0,0,0,0,0,0
"Cuba","2024-02-04",0,0,0,0,0,0,0,0
"Cuba","2024-02-05",0,0,0,0,0,0,0,0
"Cuba","2024-02-06",0,0,0,0,0,0,0,0
"Cuba","2024-02-07",0,0,0,0,0,0,0,0
"Cuba","2024-02-08",0,0,0,0,0,0,0,0
"Cuba","2024-02-09",0,0,0,0,0,0,0,0
"Cuba","2024-02-10",0,0,0,0,0,0,0,0
"Cuba","2024-02-11",0,0,0,0,0,0,0,0
"Cuba","2024-02-12",0,0,0,0,0,0,0,0
"Cuba","2024-02-13",0,0,0,0,0,0,0,0
"Cuba","2024-02-14",0,0,0,0,0,0,0,0
"Cuba","2024-02-15",0,0,0,0,0,0,0,0
"Cuba","2024-02-16",0,0,0,0,0,0,0,0
"Cuba","2024-02-17",0,0,0,0,0,0,0,0
"Cuba","2024-02-18",0,0,0,0,0,0,0,0
"Cuba","2024-02-19",0,0,0,0,0,0,0,0
"Cuba","2024-02-20",0,0,0,0,0,0,0,0
"Cuba","2024-02-21",0,0,0,0,0,0,0,0
"Cuba","2024-02-22",0,0,0,0,0,0,0,0
"Cuba","2024-02-23",0,0,0,0,0,0,0,0
"Cuba","2024-02-24",0,0,0,0,0,0,0,0
"Cuba","2024-02-25",0,0,0,0,0,0,0,0
"Cuba","2024-02-26",0,0,0,0,0,0,0,0
"Cuba","2024-02-27",0,0,0,0,0,0,0,0
"Cuba","2024-02-28",0,0,0,0,0,0,0,0
"Cuba","2024-02-29",0,0,0,0,0,0,0,0
"Cuba","2024-03-01",0,0,0,0,0,0,0,0
"Cuba","2024-03-02",0,0,0,0,0,0,0,0
"Cuba","2024-03-03",0,0,0,0,0,0,0,0
"Cuba","2024-03-04",0,0,0,0,0,0,0,0
"Cuba","2024-03-05",0,0,0,0,0,0,0,0
"Cuba","2024-03-06",0,0,0,0,0,0,0,0
"Cuba","2024-03-07",0,0,0,0,0,0,0,0
"Cuba","2024-03-08",0,0,0,0,0,0,0,0
"Cuba","2024-03-09",0,0,0,0,0,0,0,0
"Cuba","2024-03-10",0,0,0,0,0,0,0,0
"Cuba","2024-03-11",0,0,0,0,0,0,0,0
"Cuba","2024-03-12",0,0,0,0,0,0,0,0
"Cuba","2024-03-13",0,0,0,0,0,0,0,0
"Cuba","2024-03-14",0,0,0,0,0,0,0,0
"Cuba","2024-03-15",0,0,0,0,0,0,0,0
"Cuba","2024-03-16",0,0,0,0,0,0,0,0
"Cuba","2024-03-17",0,0,0,0,0,0,0,0
"Cuba","2024-03-18",0,0,0,0,0,0,0,0
"Cuba","2024-03-19",0,0,0,0,0,0,0,0
"Cuba","2024-03-20",0,0,0,0,0,0,0,0
"Cuba","2024-03-21",0,0,0,0,0,0,0,0
"Cuba","2024-03-22",0,0,0,0,0,0,0,0
"Cuba","2024-03-23",0,0,0,0,0,0,0,0
"Cuba","2024-03-24",0,0,0,0,0,0,0,0
"Cuba","2024-03-25",0,0,0,0,0,0,0,0
"Cuba","2024-03-26",0,0,0,0,0,0,0,0
"Cuba","2024-03-27",0,0,0,0,0,0,0,0
"Cuba","2024-03-28",0,0,0,0,0,0,0,0
"Cuba","2024-03-29",0,0,0,0,0,0,0,0
"Cuba","2024-03-30",0,0,0,0,0,0,0,0
"Cuba","2024-03-31",0,0,0,0,0,0,0,0
"Cuba","2024-04-01",0,0,0,0,0,0,0,0
"Cuba","2024-04-02",0,0,0,0,0,0,0,0
"Cuba","2024-04-03",0,0,0,0,0,0,0,0
"Cuba","2024-04-04",0,0,0,0,0,0,0,0
"Cuba","2024-04-05",0,0,0,0,0,0,0,0
"Cuba","2024-04-06",0,0,0,0,0,0,0,0
"Cuba","2024-04-07",0,0,0,0,0,0,0,0
"Cuba","2024-04-08",0,0,0,0,0,0,0,0
"Cuba","2024-04-09",0,0,0,0,0,0,0,0
"Cuba","2024-04-10",0,0,0,0,0,0,0,0
"Cuba","2024-04-11",0,0,0,0,0,0,0,0
"Cuba","2024-04-12",0,0,0,0,0,0,0,0
"Cuba","2024-04-13",0,0,0,0,0,0,0,0
"Cuba","2024-04-14",0,0,0,0,0,0,0,0
"Cuba","2024-04-15",0,0,0,0,0,0,0,0
"Cuba","2024-04-16",0,0,0,0,0,0,0,0
"Cuba","2024-04-17",0,0,0,0,0,0,0,0
"Cuba","2024-04-18",0,0,0,0,0,0,0,0
"Cuba","2024-04-19",0,0,0,0,0,0,0,0
"Cuba","2024-04-20",0,0,0,0,0,0,0,0
"Cuba","2024-04-21",0,0,0,0,0,0,0,0
"Cuba","2024-04-22",0,0,0,0,0,0,0,0
"Cuba","2024-04-23",0,0,0,0,0,0,0,0
"Cuba","2024-04-24",0,0,0,0,0,0,0,0
"Cuba","2024-04-25",0,0,0,0,0,0,0,0
"Cuba","2024-04-26",0,0,0,0,0,0,0,0
"Cuba","2024-04-27",0,0,0,0,0,0,0,0
"Cuba","2024-04-28",0,0,0,0,0,0,0,0
"Cuba","2024-04-29",0,0,0,0,0,0,0,0
"Cuba","2024-04-30",0,0,0,0,0,0,0,0
"Cuba","2024-05-01",0,0,0,0,0,0,0,0
"Cuba","2024-05-02",0,0,0,0,0,0,0,0
"Cuba","2024-05-03",0,0,0,0,0,0,0,0
"Cuba","2024-05-04",0,0,0,0,0,0,0,0
"Cuba","2024-05-05",0,0,0,0,0,0,0,0
"Cuba","2024-05-06",0,0,0,0,0,0,0,0
"Cuba","2024-05-07",0,0,0,0,0,0,0,0
"Cuba","2024-05-08",0,0,0,0,0,0,0,0
"Cuba","2024-05-09",0,0,0,0,0,0,0,0
"Cuba","2024-05-10",0,0,0,0,0,0,0,0
"Cuba","2024-05-11",0,0,0,0,0,0,0,0
"Cuba","2024-05-12",0,0,0,0,0,0,0,0
"Cuba","2024-05-13",0,0,0,0,0,0,0,0
"Cuba","2024-05-14",0,0,0,0,0,0,0,0
"Cuba","2024-05-15",0,0,0,0,0,0,0,0
"Cuba","2024-05-16",0,0,0,0,0,0,0,0
"Cuba","2024-05-17",0,0,0,0,0,0,0,0
"Cuba","2024-05-18",0,0,0,0,0,0,0,0
"Cuba","2024-05-19",0,0,0,0,0,0,0,0
"Cuba","2024-05-20",0,0,0,0,0,0,0,0
"Cuba","2024-05-21",0,0,0,0,0,0,0,0
"Cuba","2024-05-22",0,0,0,0,0,0,0,0
"Cuba","2024-05-23",0,0,0,0,0,0,0,0
"Cuba","2024-05-24",0,0,0,0,0,0,0,0
"Cuba","2024-05-25",0,0,0,0,0,0,0,0
"Cuba","2024-05-26",0,0,0,0,0,0,0,0
"Cuba","2024-05-27",0,0,0,0,0,0,0,0
"Cuba","2024-05-28",0,0,0,0,0,0,0,0
"Cuba","2024-05-29",0,0,0,0,0,0,0,0
"Cuba","2024-05-30",0,0,0,0,0,0,0,0
"Cuba","2024-05-31",0,0,0,0,0,0,0,0
"Cuba","2024-06-01",0,0,0,0,0,0,0,0
"Cuba","2024-06-02",0,0,0,0,0,0,0,0
"Cuba","2024-06-03",0,0,0,0,0,0,0,0
"Cuba","2024-06-04",0,0,0,0,0,0,0,0
"Cuba","2024-06-05",0,0,0,0,0,0,0,0
"Cuba","2024-06-06",0,0,0,0,0,0,0,0
"Cuba","2024-06-07",0,0,0,0,0,0,0,0
"Cuba","2024-06-08",0,0,0,0,0,0,0,0
"Cuba","2024-06-09",0,0,0,0,0,0,0,0
"Cuba","2024-06-10",0,0,0,0,0,0,0,0
"Cuba","2024-06-11",0,0,0,0,0,0,0,0
"Cuba","2024-06-12",0,0,0,0,0,0,0,0
"Cuba","2024-06-13",0,0,0,0,0,0,0,0
"Cuba","2024-06-14",0,0,0,0,0,0,0,0
"Cuba","2024-06-15",0,0,0,0,0,0,0,0
"Cuba","2024-06-16",0,0,0,0,0,0,0,0
"Cuba","2024-06-17",0,0,0,0,0,0,0,0
"Cuba","2024-06-18",0,0,0,0,0,0,0,0
"Cuba","2024-06-19",0,0,0,0,0,0,0,0
"Cuba","2024-06-20",0,0,0,0,0,0,0,0
"Cuba","2024-06-21",0,0,0,0,0,0,0,0
"Cuba","2024-06-22",0,0,0,0,0,0,0,0
"Cuba","2024-06-23",0,0,0,0,0,0,0,0
"Cuba","2024-06-24",0,0,0,0,0,0,0,0
"Cuba","2024-06-25",0,0,0,0,0,0,0,0
"Cuba","2024-06-26",0,0,0,0,0,0,0,0
"Cuba","2024-06-27",0,0,0,0,0,0,0,0
"Cuba","2024-06-28",0,0,0,0,0,0,0,0
"Cuba","2024-06-29",0,0,0,0,0,0,0,0
"Cuba","2024-06-30",0,0,0,0,0,0,0,0
"Cuba","2024-07-01",0,0,0,0,0,0,0,0
"Cuba","2024-07-02",0,0,0,0,0,0,0,0
"Cuba","2024-07-03",0,0,0,0,0,0,0,0
"Cuba","2024-07-04",0,0,0,0,0,0,0,0
"Cuba","2024-07-05",0,0,0,0,0,0,0,0
"Cuba","2024-07-06",0,0,0,0,0,0,0,0
"Cuba","2024-07-07",0,0,0,0,0,0,0,0
"Cuba","2024-07-08",0,0,0,0,0,0,0,0
"Cuba","2024-07-09",0,0,0,0,0,0,0,0
"Cuba","2024-07-10",0,0,0,0,0,0,0,0
"Cuba","2024-07-11",0,0,0,0,0,0,0,0
"Cuba","2024-07-12",0,0,0,0,0,0,0,0
"Cuba","2024-07-13",0,0,0,0,0,0,0,0
"Cuba","2024-07-14",0,0,0,0,0,0,0,0
"Cuba","2024-07-15",0,0,0,0,0,0,0,0
"Cuba","2024-07-16",0,0,0,0,0,0,0,0
"Cuba","2024-07-17",0,0,0,0,0,0,0,0
"Cuba","2024-07-18",0,0,0,0,0,0,0,0
"Cuba","2024-07-19",0,0,0,0,0,0,0,0
"Cuba","2024-07-20",0,0,0,0,0,0,0,0
"Cuba","2024-07-21",0,0,0,0,0,0,0,0
"Cuba","2024-07-22",0,0,0,0,0,0,0,0
"Cuba","2024-07-23",0,0,0,0,0,0,0,0
"Cuba","2024-07-24",0,0,0,0,0,0,0,0
"Cuba","2024-07-25",0,0,0,0,0,0,0,0
"Cuba","2024-07-26",0,0,0,0,0,0,0,0
"Cuba","2024-07-27",0,0,0,0,0,0,0,0
"Cuba","2024-07-28",0,0,0,0,0,0,0,0
"Cuba","2024-07-29",0,0,0,0,0,0,0,0
"Cuba","2024-07-30",0,0,0,0,0,0,0,0
"Cuba","2024-07-31",0,0,0,0,0,0,0,0
"Cuba","2024-08-01",0,0,0,0,0,0,0,0
"Cuba","2024-08-02",0,0,0,0,0,0,0,0
"Cuba","2024-08-03",0,0,0,0,0,0,0,0
"Cuba","2024-08-04",0,0,0,0,0,0,0,0
"Cuba","2024-08-05",0,0,0,0,0,0,0,0
"Cuba","2024-08-06",0,0,0,0,0,0,0,0
"Cuba","2024-08-07",0,0,0,0,0,0,0,0
"Cuba","2024-08-08",0,0,0,0,0,0,0,0
"Cuba","2024-08-09",0,0,0,0,0,0,0,0
"Cuba","2024-08-10",0,0,0,0,0,0,0,0
"Cuba","2024-08-11",0,0,0,0,0,0,0,0
"Cuba","2024-08-12",0,0,0,0,0,0,0,0
"Cuba","2024-08-13",0,0,0,0,0,0,0,0
"Cuba","2024-08-14",0,0,0,0,0,0,0,0
"Cuba","2024-08-15",0,0,0,0,0,0,0,0
"Cuba","2024-08-16",0,0,0,0,0,0,0,0
"Cuba","2024-08-17",0,0,0,0,0,0,0,0
"Cuba","2024-08-18",0,0,0,0,0,0,0,0
"Cuba","2024-08-19",0,0,0,0,0,0,0,0
"Cuba","2024-08-20",0,0,0,0,0,0,0,0
"Cuba","2024-08-21",0,0,0,0,0,0,0,0
"Cuba","2024-08-22",0,0,0,0,0,0,0,0
"Cuba","2024-08-23",0,0,0,0,0,0,0,0
"Cuba","2024-08-24",0,0,0,0,0,0,0,0
"Cuba","2024-08-25",0,0,0,0,0,0,0,0
"Cuba","2024-08-26",0,0,0,0,0,0,0,0
"Cuba","2024-08-27",0,0,0,0,0,0,0,0
"Cuba","2024-08-28",0,0,0,0,0,0,0,0
"Cuba","2024-08-29",0,0,0,0,0,0,0,0
"Cuba","2024-08-30",0,0,0,0,0,0,0,0
"Cuba","2024-08-31",0,0,0,0,0,0,0,0
"Cuba","2024-09-01",0,0,0,0,0,0,0,0
"Cuba","2024-09-02",0,0,0,0,0,0,0,0
"Cuba","2024-09-03",0,0,0,0,0,0,0,0
"Cuba","2024-09-04",0,0,0,0,0,0,0,0
"Cuba","2024-09-05",0,0,0,0,0,0,0,0
"Cuba","2024-09-06",0,0,0,0,0,0,0,0
"Cuba","2024-09-07",0,0,0,0,0,0,0,0
"Cuba","2024-09-08",0,0,0,0,0,0,0,0
"Cuba","2024-09-09",0,0,0,0,0,0,0,0
"Cuba","2024-09-10",0,0,0,0,0,0,0,0
"Cuba","2024-09-11",0,0,0,0,0,0,0,0
"Cuba","2024-09-12",0,0,0,0,0,0,0,0
"Cuba","2024-09-13",0,0,0,0,0,0,0,0
"Cuba","2024-09-14",0,0,0,0,0,0,0,0
"Cuba","2024-09-15",0,0,0,0,0,0,0,0
"Cuba","2024-09-16",0,0,0,0,0,0,0,0
"Cuba","2024-09-17",0,0,0,0,0,0,0,0
"Cuba","2024-09-18",0,0,0,0,0,0,0,0
"Cuba","2024-09-19",0,0,0,0,0,0,0,0
"Cuba","2024-09-20",0,0,0,0,0,0,0,0
"Cuba","2024-09-21",0,0,0,0,0,0,0,0
"Cuba","2024-09-22",0,0,0,0,0,0,0,0
"Cuba","2024-09-23",0,0,0,0,0,0,0,0
"Cuba","2024-09-24",0,0,0,0,0,0,0,0
"Cuba","2024-09-25",0,0,0,0,0,0,0,0
"Cuba","2024-09-26",0,0,0,0,0,0,0,0
"Cuba","2024-09-27",0,0,0,0,0,0,0,0
"Cuba","2024-09-28",0,0,0,0,0,0,0,0
"Cuba","2024-09-29",0,0,0,0,0,0,0,0
"Cuba","2024-09-30",0,0,0,0,0,0,0,0
"Cuba","2024-10-01",0,0,0,0,0,0,0,0
"Cuba","2024-10-02",0,0,0,0,0,0,0,0
"Cuba","2024-10-03",0,0,0,0,0,0,0,0
"Cuba","2024-10-04",0,0,0,0,0,0,0,0
"Cuba","2024-10-05",0,0,0,0,0,0,0,0
"Cuba","2024-10-06",0,0,0,0,0,0,0,0
"Cuba","2024-10-07",0,0,0,0,0,0,0,0
"Cuba","2024-10-08",0,0,0,0,0,0,0,0
"Cuba","2024-10-09",0,0,0,0,0,0,0,0
"Cuba","2024-10-10",0,0,0,0,0,0,0,0
"Cuba","2024-10-11",0,0,0,0,0,0,0,0
"Cuba","2024-10-12",0,0,0,0,0,0,0,0
"Cuba","2024-10-13",0,0,0,0,0,0,0,0
"Cuba","2024-10-14",0,0,0,0,0,0,0,0
"Cuba","2024-10-15",0,0,0,0,0,0,0,0
"Cuba","2024-10-16",0,0,0,0,0,0,0,0
"Cuba","2024-10-17",0,0,0,0,0,0,0,0
"Cuba","2024-10-18",0,0,0,0,0,0,0,0
"Cuba","2024-10-19",0,0,0,0,0,0,0,0
"Cuba","2024-10-20",0,0,0,0,0,0,0,0
"Cuba","2024-10-21",0,0,0,0,0,0,0,0
"Cuba","2024-10-22",0,0,0,0,0,0,0,0
"Cuba","2024-10-23",0,0,0,0,0,0,0,0
"Cuba","2024-10-24",0,0,0,0,0,0,0,0
"Cuba","2024-10-25",0,0,0,0,0,0,0,0
"Cuba","2024-10-26",0,0,0,0,0,0,0,0
"Cuba","2024-10-27",0,0,0,0,0,0,0,0
"Cuba","2024-10-28",0,0,0,0,0,0,0,0
"Cuba","2024-10-29",0,0,0,0,0,0,0,0
"Cuba","2024-10-30",0,0,0,0,0,0,0,0
"Cuba","2024-10-31",0,0,0,0,0,0,0,0
"Cuba","2024-11-01",0,0,0,0,0,0,0,0
"Cuba","2024-11-02",0,0,0,0,0,0,0,0
"Cuba","2024-11-03",0,0,0,0,0,0,0,0
"Cuba","2024-11-04",0,0,0,0,0,0,0,0
"Cuba","2024-11-05",0,0,0,0,0,0,0,0
"Cuba","2024-11-06",0,0,0,0,0,0,0,0
"Cuba","2024-11-07",0,0,0,0,0,0,0,0
"Cuba","2024-11-08",0,0,0,0,0,0,0,0
"Cuba","2024-11-09",0,0,0,0,0,0,0,0
"Cuba","2024-11-10",0,0,0,0,0,0,0,0
"Cuba","2024-11-11",0,0,0,0,0,0,0,0
"Cuba","2024-11-12",0,0,0,0,0,0,0,0
"Cuba","2024-11-13",0,0,0,0,0,0,0,0
"Cuba","2024-11-14",0,0,0,0,0,0,0,0
"Cuba","2024-11-15",0,0,0,0,0,0,0,0
"Cuba","2024-11-16",0,0,0,0,0,0,0,0
"Cuba","2024-11-17",0,0,0,0,0,0,0,0
"Cuba","2024-11-18",0,0,0,0,0,0,0,0
"Cuba","2024-11-19",0,0,0,0,0,0,0,0
"Cuba","2024-11-20",0,0,0,0,0,0,0,0
"Cuba","2024-11-21",0,0,0,0,0,0,0,0
"Cuba","2024-11-22",0,0,0,0,0,0,0,0
"Cuba","2024-11-23",0,0,0,0,0,0,0,0
"Cuba","2024-11-24",0,0,0,0,0,0,0,0
"Cuba","2024-11-25",0,0,0,0,0,0,0,0
"Cuba","2024-11-26",0,0,0,0,0,0,0,0
"Cuba","2024-11-27",0,0,0,0,0,0,0,0
"Cuba","2024-11-28",0,0,0,0,0,0,0,0
"Cuba","2024-11-29",0,0,0,0,0,0,0,0
"Cuba","2024-11-30",0,0,0,0,0,0,0,0
"Cuba","2024-12-01",0,0,0,0,0,0,0,0
"Cuba","2024-12-02",0,0,0,0,0,0,0,0
"Cuba","2024-12-03",0,0,0,0,0,0,0,0
"Cuba","2024-12-04",0,0,0,0,0,0,0,0
"Cuba","2024-12-05",0,0,0,0,0,0,0,0
"Cuba","2024-12-06",0,0,0,0,0,0,0,0
"Cuba","2024-12-07",0,0,0,0,0,0,0,0
"Cuba","2024-12-08",0,0,0,0,0,0,0,0
"Cuba","2024-12-09",0,0,0,0,0,0,0,0
"Cuba","2024-12-10",0,0,0,0,0,0,0,0
"Cuba","2024-12-11",0,0,0,0,0,0,0,0
"Cuba","2024-12-12",0,0,0,0,0,0,0,0
"Cuba","2024-12-13",0,0,0,0,0,0,0,0
"Cuba","2024-12-14",0,0,0,0,0,0,0,0
"Cuba","2024-12-15",0,0,0,0,0,0,0,0
"Cuba","2024-12-16",0,0,0,0,0,0,0,0
"Cuba","2024-12-17",0,0,0,0,0,0,0,0
"Cuba","2024-12-18",0,0,0,0,0,0,0,0
"Cuba","2024-12-19",0,0,0,0,0,0,0,0
"Cuba","2024-12-20",0,0,0,0,0,0,0,0
"Cuba","2024-12-21",0,0,0,0,0,0,0,0
"Cuba","2024-12-22",0,0,0,0,0,0,0,0
"Cuba","2024-12-23",0,0,0,0,0,0,0,0
"Cuba","2024-12-24",0,0,0,0,0,0,0,0
"Cuba","2024-12-25",0,0,0,0,0,0,0,0
"Cuba","2024-12-26",0,0,0,0,0,0,0,0
"Cuba","2024-12-27",0,0,0,0,0,0,0,0
"Cuba","2024-12-28",0,0,0,0,0,0,0,0
"Cuba","2024-12-29",0,0,0,0,0,0,0,0
"Cuba","2024-12-30",0,0,0,0,0,0,0,0
"Cuba","2024-12-31",0,0,0,0,0,0,0,0
"Cuba","2025-01-01",0,0,0,0,0,0,0,0
"Cuba","2025-01-02",0,0,0,0,0,0,0,0
"Cuba","2025-01-03",0,0,0,0,0,0,0,0
"Cuba","2025-01-04",0,0,0,0,0,0,0,0
"Cuba","2025-01-05",0,0,0,0,0,0,0,0
"Cuba","2025-01-06",0,0,0,0,0,0,0,0
"Cuba","2025-01-07",0,0,0,0,0,0,0,0
"Cuba","2025-01-08",0,0,0,0,0,0,0,0
"Cuba","2025-01-09",0,0,0,0,0,0,0,0
"Cuba","2025-01-10",0,0,0,0,0,0,0,0
"Cuba","2025-01-11",0,0,0,0,0,0,0,0
"Cuba","2025-01-12",0,0,0,0,0,0,0,0
"Cuba","2025-01-13",0,0,0,0,0,0,0,0
"Curaçao","2024-01-01",0,0,0,0,0,0,0,0
"Curaçao","2024-01-02",0,0,0,0,0,0,0,0
"Curaçao","2024-01-03",0,0,0,0,0,0,0,0
"Curaçao","2024-01-04",0,0,0,0,0,0,0,0
"Curaçao","2024-01-05",0,0,0,0,0,0,0,0
"Curaçao","2024-01-06",0,0,0,0,0,0,0,0
"Curaçao","2024-01-07",0,0,0,0,0,0,0,0
"Curaçao","2024-01-08",0,0,0,0,0,0,0,0
"Curaçao","2024-01-09",0,0,0,0,0,0,0,0
"Curaçao","2024-01-10",0,0,0,0,0,0,0,0
"Curaçao","2024-01-11",0,0,0,0,0,0,0,0
"Curaçao","2024-01-12",0,0,0,0,0,0,0,0
"Curaçao","2024-01-13",0,0,0,0,0,0,0,0
"Curaçao","2024-01-14",0,0,0,0,0,0,0,0
"Curaçao","2024-01-15",0,0,0,0,0,0,0,0
"Curaçao","2024-01-16",0,0,0,0,0,0,0,0
"Curaçao","2024-01-17",0,0,0,0,0,0,0,0
"Curaçao","2024-01-18",0,0,0,0,0,0,0,0
"Curaçao","2024-01-19",0,0,0,0,0,0,0,0
"Curaçao","2024-01-20",0,0,0,0,0,0,0,0
"Curaçao","2024-01-21",0,0,0,0,0,0,0,0
"Curaçao","2024-01-22",0,0,0,0,0,0,0,0
"Curaçao","2024-01-23",0,0,0,0,0,0,0,0
"Curaçao","2024-01-24",0,0,0,0,0,0,0,0
"Curaçao","2024-01-25",0,0,0,0,0,0,0,0
"Curaçao","2024-01-26",0,0,0,0,0,0,0,0
"Curaçao","2024-01-27",0,0,0,0,0,0,0,0
"Curaçao","2024-01-28",0,0,0,0,0,0,0,0
"Curaçao","2024-01-29",0,0,0,0,0,0,0,0
"Curaçao","2024-01-30",0,0,0,0,0,0,0,0
"Curaçao","2024-01-31",0,0,0,0,0,0,0,0
"Curaçao","2024-02-01",0,0,0,0,0,0,0,0
"Curaçao","2024-02-02",0,0,0,0,0,0,0,0
"Curaçao","2024-02-03",0,0,0,0,0,0,0,0
"Curaçao","2024-02-04",0,0,0,0,0,0,0,0
"Curaçao","2024-02-05",0,0,0,0,0,0,0,0
"Curaçao","2024-02-06",0,0,0,0,0,0,0,0
"Curaçao","2024-02-07",0,0,0,0,0,0,0,0
"Curaçao","2024-02-08",0,0,0,0,0,0,0,0
"Curaçao","2024-02-09",0,0,0,0,0,0,0,0
"Curaçao","2024-02-10",0,0,0,0,0,0,0,0
"Curaçao","2024-02-11",0,0,0,0,0,0,0,0
"Curaçao","2024-02-12",0,0,0,0,0,0,0,0
"Curaçao","2024-02-13",0,0,0,0,0,0,0,0
"Curaçao","2024-02-14",0,0,0,0,0,0,0,0
"Curaçao","2024-02-15",0,0,0,0,0,0,0,0
"Curaçao","2024-02-16",0,0,0,0,0,0,0,0
"Curaçao","2024-02-17",0,0,0,0,0,0,0,0
"Curaçao","2024-02-18",0,0,0,0,0,0,0,0
"Curaçao","2024-02-19",0,0,0,0,0,0,0,0
"Curaçao","2024-02-20",0,0,0,0,0,0,0,0
"Curaçao","2024-02-21",0,0,0,0,0,0,0,0
"Curaçao","2024-02-22",0,0,0,0,0,0,0,0
"Curaçao","2024-02-23",0,0,0,0,0,0,0,0
"Curaçao","2024-02-24",0,0,0,0,0,0,0,0
"Curaçao","2024-02-25",0,0,0,0,0,0,0,0
"Curaçao","2024-02-26",0,0,0,0,0,0,0,0
"Curaçao","2024-02-27",0,0,0,0,0,0,0,0
"Curaçao","2024-02-28",0,0,0,0,0,0,0,0
"Curaçao","2024-02-29",0,0,0,0,0,0,0,0
"Curaçao","2024-03-01",0,0,0,0,0,0,0,0
"Curaçao","2024-03-02",0,0,0,0,0,0,0,0
"Curaçao","2024-03-03",0,0,0,0,0,0,0,0
"Curaçao","2024-03-04",0,0,0,0,0,0,0,0
"Curaçao","2024-03-05",0,0,0,0,0,0,0,0
"Curaçao","2024-03-06",0,0,0,0,0,0,0,0
"Curaçao","2024-03-07",0,0,0,0,0,0,0,0
"Curaçao","2024-03-08",0,0,0,0,0,0,0,0
"Curaçao","2024-03-09",0,0,0,0,0,0,0,0
"Curaçao","2024-03-10",0,0,0,0,0,0,0,0
"Curaçao","2024-03-11",0,0,0,0,0,0,0,0
"Curaçao","2024-03-12",0,0,0,0,0,0,0,0
"Curaçao","2024-03-13",0,0,0,0,0,0,0,0
"Curaçao","2024-03-14",0,0,0,0,0,0,0,0
"Curaçao","2024-03-15",0,0,0,0,0,0,0,0
"Curaçao","2024-03-16",0,0,0,0,0,0,0,0
"Curaçao","2024-03-17",0,0,0,0,0,0,0,0
"Curaçao","2024-03-18",0,0,0,0,0,0,0,0
"Curaçao","2024-03-19",0,0,0,0,0,0,0,0
"Curaçao","2024-03-20",0,0,0,0,0,0,0,0
"Curaçao","2024-03-21",0,0,0,0,0,0,0,0
"Curaçao","2024-03-22",0,0,0,0,0,0,0,0
"Curaçao","2024-03-23",0,0,0,0,0,0,0,0
"Curaçao","2024-03-24",0,0,0,0,0,0,0,0
"Curaçao","2024-03-25",0,0,0,0,0,0,0,0
"Curaçao","2024-03-26",0,0,0,0,0,0,0,0
"Curaçao","2024-03-27",0,0,0,0,0,0,0,0
"Curaçao","2024-03-28",0,0,0,0,0,0,0,0
"Curaçao","2024-03-29",0,0,0,0,0,0,0,0
"Curaçao","2024-03-30",0,0,0,0,0,0,0,0
"Curaçao","2024-03-31",0,0,0,0,0,0,0,0
"Curaçao","2024-04-01",0,0,0,0,0,0,0,0
"Curaçao","2024-04-02",0,0,0,0,0,0,0,0
"Curaçao","2024-04-03",0,0,0,0,0,0,0,0
"Curaçao","2024-04-04",0,0,0,0,0,0,0,0
"Curaçao","2024-04-05",0,0,0,0,0,0,0,0
"Curaçao","2024-04-06",0,0,0,0,0,0,0,0
"Curaçao","2024-04-07",0,0,0,0,0,0,0,0
"Curaçao","2024-04-08",0,0,0,0,0,0,0,0
"Curaçao","2024-04-09",0,0,0,0,0,0,0,0
"Curaçao","2024-04-10",0,0,0,0,0,0,0,0
"Curaçao","2024-04-11",0,0,0,0,0,0,0,0
"Curaçao","2024-04-12",0,0,0,0,0,0,0,0
"Curaçao","2024-04-13",0,0,0,0,0,0,0,0
"Curaçao","2024-04-14",0,0,0,0,0,0,0,0
"Curaçao","2024-04-15",0,0,0,0,0,0,0,0
"Curaçao","2024-04-16",0,0,0,0,0,0,0,0
"Curaçao","2024-04-17",0,0,0,0,0,0,0,0
"Curaçao","2024-04-18",0,0,0,0,0,0,0,0
"Curaçao","2024-04-19",0,0,0,0,0,0,0,0
"Curaçao","2024-04-20",0,0,0,0,0,0,0,0
"Curaçao","2024-04-21",0,0,0,0,0,0,0,0
"Curaçao","2024-04-22",0,0,0,0,0,0,0,0
"Curaçao","2024-04-23",0,0,0,0,0,0,0,0
"Curaçao","2024-04-24",0,0,0,0,0,0,0,0
"Curaçao","2024-04-25",0,0,0,0,0,0,0,0
"Curaçao","2024-04-26",0,0,0,0,0,0,0,0
"Curaçao","2024-04-27",0,0,0,0,0,0,0,0
"Curaçao","2024-04-28",0,0,0,0,0,0,0,0
"Curaçao","2024-04-29",0,0,0,0,0,0,0,0
"Curaçao","2024-04-30",0,0,0,0,0,0,0,0
"Curaçao","2024-05-01",0,0,0,0,0,0,0,0
"Curaçao","2024-05-02",0,0,0,0,0,0,0,0
"Curaçao","2024-05-03",0,0,0,0,0,0,0,0
"Curaçao","2024-05-04",0,0,0,0,0,0,0,0
"Curaçao","2024-05-05",0,0,0,0,0,0,0,0
"Curaçao","2024-05-06",0,0,0,0,0,0,0,0
"Curaçao","2024-05-07",0,0,0,0,0,0,0,0
"Curaçao","2024-05-08",0,0,0,0,0,0,0,0
"Curaçao","2024-05-09",0,0,0,0,0,0,0,0
"Curaçao","2024-05-10",0,0,0,0,0,0,0,0
"Curaçao","2024-05-11",0,0,0,0,0,0,0,0
"Curaçao","2024-05-12",0,0,0,0,0,0,0,0
"Curaçao","2024-05-13",0,0,0,0,0,0,0,0
"Curaçao","2024-05-14",0,0,0,0,0,0,0,0
"Curaçao","2024-05-15",0,0,0,0,0,0,0,0
"Curaçao","2024-05-16",0,0,0,0,0,0,0,0
"Curaçao","2024-05-17",0,0,0,0,0,0,0,0
"Curaçao","2024-05-18",0,0,0,0,0,0,0,0
"Curaçao","2024-05-19",0,0,0,0,0,0,0,0
"Curaçao","2024-05-20",0,0,0,0,0,0,0,0
"Curaçao","2024-05-21",0,0,0,0,0,0,0,0
"Curaçao","2024-05-22",0,0,0,0,0,0,0,0
"Curaçao","2024-05-23",0,0,0,0,0,0,0,0
"Curaçao","2024-05-24",0,0,0,0,0,0,0,0
"Curaçao","2024-05-25",0,0,0,0,0,0,0,0
"Curaçao","2024-05-26",0,0,0,0,0,0,0,0
"Curaçao","2024-05-27",0,0,0,0,0,0,0,0
"Curaçao","2024-05-28",0,0,0,0,0,0,0,0
"Curaçao","2024-05-29",0,0,0,0,0,0,0,0
"Curaçao","2024-05-30",0,0,0,0,0,0,0,0
"Curaçao","2024-05-31",0,0,0,0,0,0,0,0
"Curaçao","2024-06-01",0,0,0,0,0,0,0,0
"Curaçao","2024-06-02",0,0,0,0,0,0,0,0
"Curaçao","2024-06-03",0,0,0,0,0,0,0,0
"Curaçao","2024-06-04",0,0,0,0,0,0,0,0
"Curaçao","2024-06-05",0,0,0,0,0,0,0,0
"Curaçao","2024-06-06",0,0,0,0,0,0,0,0
"Curaçao","2024-06-07",0,0,0,0,0,0,0,0
"Curaçao","2024-06-08",0,0,0,0,0,0,0,0
"Curaçao","2024-06-09",0,0,0,0,0,0,0,0
"Curaçao","2024-06-10",0,0,0,0,0,0,0,0
"Curaçao","2024-06-11",0,0,0,0,0,0,0,0
"Curaçao","2024-06-12",0,0,0,0,0,0,0,0
"Curaçao","2024-06-13",0,0,0,0,0,0,0,0
"Curaçao","2024-06-14",0,0,0,0,0,0,0,0
"Curaçao","2024-06-15",0,0,0,0,0,0,0,0
"Curaçao","2024-06-16",0,0,0,0,0,0,0,0
"Curaçao","2024-06-17",0,0,0,0,0,0,0,0
"Curaçao","2024-06-18",0,0,0,0,0,0,0,0
"Curaçao","2024-06-19",0,0,0,0,0,0,0,0
"Curaçao","2024-06-20",0,0,0,0,0,0,0,0
"Curaçao","2024-06-21",0,0,0,0,0,0,0,0
"Curaçao","2024-06-22",0,0,0,0,0,0,0,0
"Curaçao","2024-06-23",0,0,0,0,0,0,0,0
"Curaçao","2024-06-24",0,0,0,0,0,0,0,0
"Curaçao","2024-06-25",0,0,0,0,0,0,0,0
"Curaçao","2024-06-26",0,0,0,0,0,0,0,0
"Curaçao","2024-06-27",0,0,0,0,0,0,0,0
"Curaçao","2024-06-28",0,0,0,0,0,0,0,0
"Curaçao","2024-06-29",0,0,0,0,0,0,0,0
"Curaçao","2024-06-30",0,0,0,0,0,0,0,0
"Curaçao","2024-07-01",0,0,0,0,0,0,0,0
"Curaçao","2024-07-02",0,0,0,0,0,0,0,0
"Curaçao","2024-07-03",0,0,0,0,0,0,0,0
"Curaçao","2024-07-04",0,0,0,0,0,0,0,0
"Curaçao","2024-07-05",0,0,0,0,0,0,0,0
"Curaçao","2024-07-06",0,0,0,0,0,0,0,0
"Curaçao","2024-07-07",0,0,0,0,0,0,0,0
"Curaçao","2024-07-08",0,0,0,0,0,0,0,0
"Curaçao","2024-07-09",0,0,0,0,0,0,0,0
"Curaçao","2024-07-10",0,0,0,0,0,0,0,0
"Curaçao","2024-07-11",0,0,0,0,0,0,0,0
"Curaçao","2024-07-12",0,0,0,0,0,0,0,0
"Curaçao","2024-07-13",0,0,0,0,0,0,0,0
"Curaçao","2024-07-14",0,0,0,0,0,0,0,0
"Curaçao","2024-07-15",0,0,0,0,0,0,0,0
"Curaçao","2024-07-16",0,0,0,0,0,0,0,0
"Curaçao","2024-07-17",0,0,0,0,0,0,0,0
"Curaçao","2024-07-18",0,0,0,0,0,0,0,0
"Curaçao","2024-07-19",0,0,0,0,0,0,0,0
"Curaçao","2024-07-20",0,0,0,0,0,0,0,0
"Curaçao","2024-07-21",0,0,0,0,0,0,0,0
"Curaçao","2024-07-22",0,0,0,0,0,0,0,0
"Curaçao","2024-07-23",0,0,0,0,0,0,0,0
"Curaçao","2024-07-24",0,0,0,0,0,0,0,0
"Curaçao","2024-07-25",0,0,0,0,0,0,0,0
"Curaçao","2024-07-26",0,0,0,0,0,0,0,0
"Curaçao","2024-07-27",0,0,0,0,0,0,0,0
"Curaçao","2024-07-28",0,0,0,0,0,0,0,0
"Curaçao","2024-07-29",0,0,0,0,0,0,0,0
"Curaçao","2024-07-30",0,0,0,0,0,0,0,0
"Curaçao","2024-07-31",0,0,0,0,0,0,0,0
"Curaçao","2024-08-01",0,0,0,0,0,0,0,0
"Curaçao","2024-08-02",0,0,0,0,0,0,0,0
"Curaçao","2024-08-03",0,0,0,0,0,0,0,0
"Curaçao","2024-08-04",0,0,0,0,0,0,0,0
"Curaçao","2024-08-05",0,0,0,0,0,0,0,0
"Curaçao","2024-08-06",0,0,0,0,0,0,0,0
"Curaçao","2024-08-07",0,0,0,0,0,0,0,0
"Curaçao","2024-08-08",0,0,0,0,0,0,0,0
"Curaçao","2024-08-09",0,0,0,0,0,0,0,0
"Curaçao","2024-08-10",0,0,0,0,0,0,0,0
"Curaçao","2024-08-11",0,0,0,0,0,0,0,0
"Curaçao","2024-08-12",0,0,0,0,0,0,0,0
"Curaçao","2024-08-13",0,0,0,0,0,0,0,0
"Curaçao","2024-08-14",0,0,0,0,0,0,0,0
"Curaçao","2024-08-15",0,0,0,0,0,0,0,0
"Curaçao","2024-08-16",0,0,0,0,0,0,0,0
"Curaçao","2024-08-17",0,0,0,0,0,0,0,0
"Curaçao","2024-08-18",0,0,0,0,0,0,0,0
"Curaçao","2024-08-19",0,0,0,0,0,0,0,0
"Curaçao","2024-08-20",0,0,0,0,0,0,0,0
"Curaçao","2024-08-21",0,0,0,0,0,0,0,0
"Curaçao","2024-08-22",0,0,0,0,0,0,0,0
"Curaçao","2024-08-23",0,0,0,0,0,0,0,0
"Curaçao","2024-08-24",0,0,0,0,0,0,0,0
"Curaçao","2024-08-25",0,0,0,0,0,0,0,0
"Curaçao","2024-08-26",0,0,0,0,0,0,0,0
"Curaçao","2024-08-27",0,0,0,0,0,0,0,0
"Curaçao","2024-08-28",0,0,0,0,0,0,0,0
"Curaçao","2024-08-29",0,0,0,0,0,0,0,0
"Curaçao","2024-08-30",0,0,0,0,0,0,0,0
"Curaçao","2024-08-31",0,0,0,0,0,0,0,0
"Curaçao","2024-09-01",0,0,0,0,0,0,0,0
"Curaçao","2024-09-02",0,0,0,0,0,0,0,0
"Curaçao","2024-09-03",0,0,0,0,0,0,0,0
"Curaçao","2024-09-04",0,0,0,0,0,0,0,0
"Curaçao","2024-09-05",0,0,0,0,0,0,0,0
"Curaçao","2024-09-06",0,0,0,0,0,0,0,0
"Curaçao","2024-09-07",0,0,0,0,0,0,0,0
"Curaçao","2024-09-08",0,0,0,0,0,0,0,0
"Curaçao","2024-09-09",0,0,0,0,0,0,0,0
"Curaçao","2024-09-10",0,0,0,0,0,0,0,0
"Curaçao","2024-09-11",0,0,0,0,0,0,0,0
"Curaçao","2024-09-12",0,0,0,0,0,0,0,0
"Curaçao","2024-09-13",0,0,0,0,0,0,0,0
"Curaçao","2024-09-14",0,0,0,0,0,0,0,0
"Curaçao","2024-09-15",0,0,0,0,0,0,0,0
"Curaçao","2024-09-16",0,0,0,0,0,0,0,0
"Curaçao","2024-09-17",0,0,0,0,0,0,0,0
"Curaçao","2024-09-18",0,0,0,0,0,0,0,0
"Curaçao","2024-09-19",0,0,0,0,0,0,0,0
"Curaçao","2024-09-20",0,0,0,0,0,0,0,0
"Curaçao","2024-09-21",0,0,0,0,0,0,0,0
"Curaçao","2024-09-22",0,0,0,0,0,0,0,0
"Curaçao","2024-09-23",0,0,0,0,0,0,0,0
"Curaçao","2024-09-24",0,0,0,0,0,0,0,0
"Curaçao","2024-09-25",0,0,0,0,0,0,0,0
"Curaçao","2024-09-26",0,0,0,0,0,0,0,0
"Curaçao","2024-09-27",0,0,0,0,0,0,0,0
"Curaçao","2024-09-28",0,0,0,0,0,0,0,0
"Curaçao","2024-09-29",0,0,0,0,0,0,0,0
"Curaçao","2024-09-30",0,0,0,0,0,0,0,0
"Curaçao","2024-10-01",0,0,0,0,0,0,0,0
"Curaçao","2024-10-02",0,0,0,0,0,0,0,0
"Curaçao","2024-10-03",0,0,0,0,0,0,0,0
"Curaçao","2024-10-04",0,0,0,0,0,0,0,0
"Curaçao","2024-10-05",0,0,0,0,0,0,0,0
"Curaçao","2024-10-06",0,0,0,0,0,0,0,0
"Curaçao","2024-10-07",0,0,0,0,0,0,0,0
"Curaçao","2024-10-08",0,0,0,0,0,0,0,0
"Curaçao","2024-10-09",0,0,0,0,0,0,0,0
"Curaçao","2024-10-10",0,0,0,0,0,0,0,0
"Curaçao","2024-10-11",0,0,0,0,0,0,0,0
"Curaçao","2024-10-12",0,0,0,0,0,0,0,0
"Curaçao","2024-10-13",0,0,0,0,0,0,0,0
"Curaçao","2024-10-14",0,0,0,0,0,0,0,0
"Curaçao","2024-10-15",0,0,0,0,0,0,0,0
"Curaçao","2024-10-16",0,0,0,0,0,0,0,0
"Curaçao","2024-10-17",0,0,0,0,0,0,0,0
"Curaçao","2024-10-18",0,0,0,0,0,0,0,0
"Curaçao","2024-10-19",0,0,0,0,0,0,0,0
"Curaçao","2024-10-20",0,0,0,0,0,0,0,0
"Curaçao","2024-10-21",0,0,0,0,0,0,0,0
"Curaçao","2024-10-22",0,0,0,0,0,0,0,0
"Curaçao","2024-10-23",0,0,0,0,0,0,0,0
"Curaçao","2024-10-24",0,0,0,0,0,0,0,0
"Curaçao","2024-10-25",0,0,0,0,0,0,0,0
"Curaçao","2024-10-26",0,0,0,0,0,0,0,0
"Curaçao","2024-10-27",0,0,0,0,0,0,0,0
"Curaçao","2024-10-28",0,0,0,0,0,0,0,0
"Curaçao","2024-10-29",0,0,0,0,0,0,0,0
"Curaçao","2024-10-30",0,0,0,0,0,0,0,0
"Curaçao","2024-10-31",0,0,0,0,0,0,0,0
"Curaçao","2024-11-01",0,0,0,0,0,0,0,0
"Curaçao","2024-11-02",0,0,0,0,0,0,0,0
"Curaçao","2024-11-03",0,0,0,0,0,0,0,0
"Curaçao","2024-11-04",0,0,0,0,0,0,0,0
"Curaçao","2024-11-05",0,0,0,0,0,0,0,0
"Curaçao","2024-11-06",0,0,0,0,0,0,0,0
"Curaçao","2024-11-07",0,0,0,0,0,0,0,0
"Curaçao","2024-11-08",0,0,0,0,0,0,0,0
"Curaçao","2024-11-09",0,0,0,0,0,0,0,0
"Curaçao","2024-11-10",0,0,0,0,0,0,0,0
"Curaçao","2024-11-11",0,0,0,0,0,0,0,0
"Curaçao","2024-11-12",0,0,0,0,0,0,0,0
"Curaçao","2024-11-13",0,0,0,0,0,0,0,0
"Curaçao","2024-11-14",0,0,0,0,0,0,0,0
"Curaçao","2024-11-15",0,0,0,0,0,0,0,0
"Curaçao","2024-11-16",0,0,0,0,0,0,0,0
"Curaçao","2024-11-17",0,0,0,0,0,0,0,0
"Curaçao","2024-11-18",0,0,0,0,0,0,0,0
"Curaçao","2024-11-19",0,0,0,0,0,0,0,0
"Curaçao","2024-11-20",0,0,0,0,0,0,0,0
"Curaçao","2024-11-21",0,0,0,0,0,0,0,0
"Curaçao","2024-11-22",0,0,0,0,0,0,0,0
"Curaçao","2024-11-23",0,0,0,0,0,0,0,0
"Curaçao","2024-11-24",0,0,0,0,0,0,0,0
"Curaçao","2024-11-25",0,0,0,0,0,0,0,0
"Curaçao","2024-11-26",0,0,0,0,0,0,0,0
"Curaçao","2024-11-27",0,0,0,0,0,0,0,0
"Curaçao","2024-11-28",0,0,0,0,0,0,0,0
"Curaçao","2024-11-29",0,0,0,0,0,0,0,0
"Curaçao","2024-11-30",0,0,0,0,0,0,0,0
"Curaçao","2024-12-01",0,0,0,0,0,0,0,0
"Curaçao","2024-12-02",0,0,0,0,0,0,0,0
"Curaçao","2024-12-03",0,0,0,0,0,0,0,0
"Curaçao","2024-12-04",0,0,0,0,0,0,0,0
"Curaçao","2024-12-05",0,0,0,0,0,0,0,0
"Curaçao","2024-12-06",0,0,0,0,0,0,0,0
"Curaçao","2024-12-07",0,0,0,0,0,0,0,0
"Curaçao","2024-12-08",0,0,0,0,0,0,0,0
"Curaçao","2024-12-09",0,0,0,0,0,0,0,0
"Curaçao","2024-12-10",0,0,0,0,0,0,0,0
"Curaçao","2024-12-11",0,0,0,0,0,0,0,0
"Curaçao","2024-12-12",0,0,0,0,0,0,0,0
"Curaçao","2024-12-13",0,0,0,0,0,0,0,0
"Curaçao","2024-12-14",0,0,0,0,0,0,0,0
"Curaçao","2024-12-15",0,0,0,0,0,0,0,0
"Curaçao","2024-12-16",0,0,0,0,0,0,0,0
"Curaçao","2024-12-17",0,0,0,0,0,0,0,0
"Curaçao","2024-12-18",0,0,0,0,0,0,0,0
"Curaçao","2024-12-19",0,0,0,0,0,0,0,0
"Curaçao","2024-12-20",0,0,0,0,0,0,0,0
"Curaçao","2024-12-21",0,0,0,0,0,0,0,0
"Curaçao","2024-12-22",0,0,0,0,0,0,0,0
"Curaçao","2024-12-23",0,0,0,0,0,0,0,0
"Curaçao","2024-12-24",0,0,0,0,0,0,0,0
"Curaçao","2024-12-25",0,0,0,0,0,0,0,0
"Curaçao","2024-12-26",0,0,0,0,0,0,0,0
"Curaçao","2024-12-27",0,0,0,0,0,0,0,0
"Curaçao","2024-12-28",0,0,0,0,0,0,0,0
"Curaçao","2024-12-29",0,0,0,0,0,0,0,0
"Curaçao","2024-12-30",0,0,0,0,0,0,0,0
"Curaçao","2024-12-31",0,0,0,0,0,0,0,0
"Curaçao","2025-01-01",0,0,0,0,0,0,0,0
"Curaçao","2025-01-02",0,0,0,0,0,0,0,0
"Curaçao","2025-01-03",0,0,0,0,0,0,0,0
"Curaçao","2025-01-04",0,0,0,0,0,0,0,0
"Curaçao","2025-01-05",0,0,0,0,0,0,0,0
"Curaçao","2025-01-06",0,0,0,0,0,0,0,0
"Curaçao","2025-01-07",0,0,0,0,0,0,0,0
"Curaçao","2025-01-08",0,0,0,0,0,0,0,0
"Curaçao","2025-01-09",0,0,0,0,0,0,0,0
"Curaçao","2025-01-10",0,0,0,0,0,0,0,0
"Curaçao","2025-01-11",0,0,0,0,0,0,0,0
"Curaçao","2025-01-12",0,0,0,0,0,0,0,0
"Curaçao","2025-01-13",0,0,0,0,0,0,0,0
"Cyprus","2024-01-01",0,0,0,0,0,0,0,0
"Cyprus","2024-01-02",0,0,0,0,0,0,0,0
"Cyprus","2024-01-03",0,0,0,0,0,0,0,0
"Cyprus","2024-01-04",0,0,0,0,0,0,0,0
"Cyprus","2024-01-05",0,0,0,0,0,0,0,0
"Cyprus","2024-01-06",0,0,0,0,0,0,0,0
"Cyprus","2024-01-07",0,0,0,0,0,0,0,0
"Cyprus","2024-01-08",0,0,0,0,0,0,0,0
"Cyprus","2024-01-09",0,0,0,0,0,0,0,0
"Cyprus","2024-01-10",0,0,0,0,0,0,0,0
"Cyprus","2024-01-11",0,0,0,0,0,0,0,0
"Cyprus","2024-01-12",0,0,0,0,0,0,0,0
"Cyprus","2024-01-13",0,0,0,0,0,0,0,0
"Cyprus","2024-01-14",0,0,0,0,0,0,0,0
"Cyprus","2024-01-15",0,0,0,0,0,0,0,0
"Cyprus","2024-01-16",0,0,0,0,0,0,0,0
"Cyprus","2024-01-17",0,0,0,0,0,0,0,0
"Cyprus","2024-01-18",0,0,0,0,0,0,0,0
"Cyprus","2024-01-19",0,0,0,0,0,0,0,0
"Cyprus","2024-01-20",0,0,0,0,0,0,0,0
"Cyprus","2024-01-21",0,0,0,0,0,0,0,0
"Cyprus","2024-01-22",0,0,0,0,0,0,0,0
"Cyprus","2024-01-23",0,0,0,0,0,0,0,0
"Cyprus","2024-01-24",0,0,0,0,0,0,0,0
"Cyprus","2024-01-25",0,0,0,0,0,0,0,0
"Cyprus","2024-01-26",0,0,0,0,0,0,0,0
"Cyprus","2024-01-27",0,0,0,0,0,0,0,0
"Cyprus","2024-01-28",0,0,0,0,0,0,0,0
"Cyprus","2024-01-29",0,0,0,0,0,0,0,0
"Cyprus","2024-01-30",0,0,0,0,0,0,0,0
"Cyprus","2024-01-31",0,0,0,0,0,0,0,0
"Cyprus","2024-02-01",0,0,0,0,0,0,0,0
"Cyprus","2024-02-02",0,0,0,0,0,0,0,0
"Cyprus","2024-02-03",0,0,0,0,0,0,0,0
"Cyprus","2024-02-04",0,0,0,0,0,0,0,0
"Cyprus","2024-02-05",0,0,0,0,0,0,0,0
"Cyprus","2024-02-06",0,0,0,0,0,0,0,0
"Cyprus","2024-02-07",0,0,0,0,0,0,0,0
"Cyprus","2024-02-08",0,0,0,0,0,0,0,0
"Cyprus","2024-02-09",0,0,0,0,0,0,0,0
"Cyprus","2024-02-10",0,0,0,0,0,0,0,0
"Cyprus","2024-02-11",0,0,0,0,0,0,0,0
"Cyprus","2024-02-12",0,0,0,0,0,0,0,0
"Cyprus","2024-02-13",0,0,0,0,0,0,0,0
"Cyprus","2024-02-14",0,0,0,0,0,0,0,0
"Cyprus","2024-02-15",0,0,0,0,0,0,0,0
"Cyprus","2024-02-16",0,0,0,0,0,0,0,0
"Cyprus","2024-02-17",0,0,0,0,0,0,0,0
"Cyprus","2024-02-18",0,0,0,0,0,0,0,0
"Cyprus","2024-02-19",0,0,0,0,0,0,0,0
"Cyprus","2024-02-20",0,0,0,0,0,0,0,0
"Cyprus","2024-02-21",0,0,0,0,0,0,0,0
"Cyprus","2024-02-22",0,0,0,0,0,0,0,0
"Cyprus","2024-02-23",0,0,0,0,0,0,0,0
"Cyprus","2024-02-24",0,0,0,0,0,0,0,0
"Cyprus","2024-02-25",0,0,0,0,0,0,0,0
"Cyprus","2024-02-26",0,0,0,0,0,0,0,0
"Cyprus","2024-02-27",0,0,0,0,0,0,0,0
"Cyprus","2024-02-28",0,0,0,0,0,0,0,0
"Cyprus","2024-02-29",0,0,0,0,0,0,0,0
"Cyprus","2024-03-01",0,0,0,0,0,0,0,0
"Cyprus","2024-03-02",0,0,0,0,0,0,0,0
"Cyprus","2024-03-03",0,0,0,0,0,0,0,0
"Cyprus","2024-03-04",0,0,0,0,0,0,0,0
"Cyprus","2024-03-05",0,0,0,0,0,0,0,0
"Cyprus","2024-03-06",0,0,0,0,0,0,0,0
"Cyprus","2024-03-07",0,0,0,0,0,0,0,0
"Cyprus","2024-03-08",0,0,0,0,0,0,0,0
"Cyprus","2024-03-09",0,0,0,0,0,0,0,0
"Cyprus","2024-03-10",0,0,0,0,0,0,0,0
"Cyprus","2024-03-11",0,0,0,0,0,0,0,0
"Cyprus","2024-03-12",0,0,0,0,0,0,0,0
"Cyprus","2024-03-13",0,0,0,0,0,0,0,0
"Cyprus","2024-03-14",0,0,0,0,0,0,0,0
"Cyprus","2024-03-15",0,0,0,0,0,0,0,0
"Cyprus","2024-03-16",0,0,0,0,0,0,0,0
"Cyprus","2024-03-17",0,0,0,0,0,0,0,0
"Cyprus","2024-03-18",0,0,0,0,0,0,0,0
"Cyprus","2024-03-19",0,0,0,0,0,0,0,0
"Cyprus","2024-03-20",0,0,0,0,0,0,0,0
"Cyprus","2024-03-21",0,0,0,0,0,0,0,0
"Cyprus","2024-03-22",0,0,0,0,0,0,0,0
"Cyprus","2024-03-23",0,0,0,0,0,0,0,0
"Cyprus","2024-03-24",0,0,0,0,0,0,0,0
"Cyprus","2024-03-25",0,0,0,0,0,0,0,0
"Cyprus","2024-03-26",0,0,0,0,0,0,0,0
"Cyprus","2024-03-27",0,0,0,0,0,0,0,0
"Cyprus","2024-03-28",0,0,0,0,0,0,0,0
"Cyprus","2024-03-29",0,0,0,0,0,0,0,0
"Cyprus","2024-03-30",0,0,0,0,0,0,0,0
"Cyprus","2024-03-31",0,0,0,0,0,0,0,0
"Cyprus","2024-04-01",0,0,0,0,0,0,0,0
"Cyprus","2024-04-02",0,0,0,0,0,0,0,0
"Cyprus","2024-04-03",0,0,0,0,0,0,0,0
"Cyprus","2024-04-04",0,0,0,0,0,0,0,0
"Cyprus","2024-04-05",0,0,0,0,0,0,0,0
"Cyprus","2024-04-06",0,0,0,0,0,0,0,0
"Cyprus","2024-04-07",0,0,0,0,0,0,0,0
"Cyprus","2024-04-08",0,0,0,0,0,0,0,0
"Cyprus","2024-04-09",0,0,0,0,0,0,0,0
"Cyprus","2024-04-10",0,0,0,0,0,0,0,0
"Cyprus","2024-04-11",0,0,0,0,0,0,0,0
"Cyprus","2024-04-12",0,0,0,0,0,0,0,0
"Cyprus","2024-04-13",0,0,0,0,0,0,0,0
"Cyprus","2024-04-14",0,0,0,0,0,0,0,0
"Cyprus","2024-04-15",0,0,0,0,0,0,0,0
"Cyprus","2024-04-16",0,0,0,0,0,0,0,0
"Cyprus","2024-04-17",0,0,0,0,0,0,0,0
"Cyprus","2024-04-18",0,0,0,0,0,0,0,0
"Cyprus","2024-04-19",0,0,0,0,0,0,0,0
"Cyprus","2024-04-20",0,0,0,0,0,0,0,0
"Cyprus","2024-04-21",0,0,0,0,0,0,0,0
"Cyprus","2024-04-22",0,0,0,0,0,0,0,0
"Cyprus","2024-04-23",0,0,0,0,0,0,0,0
"Cyprus","2024-04-24",0,0,0,0,0,0,0,0
"Cyprus","2024-04-25",0,0,0,0,0,0,0,0
"Cyprus","2024-04-26",0,0,0,0,0,0,0,0
"Cyprus","2024-04-27",0,0,0,0,0,0,0,0
"Cyprus","2024-04-28",0,0,0,0,0,0,0,0
"Cyprus","2024-04-29",0,0,0,0,0,0,0,0
"Cyprus","2024-04-30",0,0,0,0,0,0,0,0
"Cyprus","2024-05-01",0,0,0,0,0,0,0,0
"Cyprus","2024-05-02",0,0,0,0,0,0,0,0
"Cyprus","2024-05-03",0,0,0,0,0,0,0,0
"Cyprus","2024-05-04",0,0,0,0,0,0,0,0
"Cyprus","2024-05-05",0,0,0,0,0,0,0,0
"Cyprus","2024-05-06",0,0,0,0,0,0,0,0
"Cyprus","2024-05-07",0,0,0,0,0,0,0,0
"Cyprus","2024-05-08",0,0,0,0,0,0,0,0
"Cyprus","2024-05-09",0,0,0,0,0,0,0,0
"Cyprus","2024-05-10",0,0,0,0,0,0,0,0
"Cyprus","2024-05-11",0,0,0,0,0,0,0,0
"Cyprus","2024-05-12",0,0,0,0,0,0,0,0
"Cyprus","2024-05-13",0,0,0,0,0,0,0,0
"Cyprus","2024-05-14",0,0,0,0,0,0,0,0
"Cyprus","2024-05-15",0,0,0,0,0,0,0,0
"Cyprus","2024-05-16",0,0,0,0,0,0,0,0
"Cyprus","2024-05-17",0,0,0,0,0,0,0,0
"Cyprus","2024-05-18",0,0,0,0,0,0,0,0
"Cyprus","2024-05-19",0,0,0,0,0,0,0,0
"Cyprus","2024-05-20",0,0,0,0,0,0,0,0
"Cyprus","2024-05-21",0,0,0,0,0,0,0,0
"Cyprus","2024-05-22",0,0,0,0,0,0,0,0
"Cyprus","2024-05-23",0,0,0,0,0,0,0,0
"Cyprus","2024-05-24",0,0,0,0,0,0,0,0
"Cyprus","2024-05-25",0,0,0,0,0,0,0,0
"Cyprus","2024-05-26",0,0,0,0,0,0,0,0
"Cyprus","2024-05-27",0,0,0,0,0,0,0,0
"Cyprus","2024-05-28",0,0,0,0,0,0,0,0
"Cyprus","2024-05-29",0,0,0,0,0,0,0,0
"Cyprus","2024-05-30",0,0,0,0,0,0,0,0
"Cyprus","2024-05-31",0,0,0,0,0,0,0,0
"Cyprus","2024-06-01",0,0,0,0,0,0,0,0
"Cyprus","2024-06-02",0,0,0,0,0,0,0,0
"Cyprus","2024-06-03",0,0,0,0,0,0,0,0
"Cyprus","2024-06-04",0,0,0,0,0,0,0,0
"Cyprus","2024-06-05",0,0,0,0,0,0,0,0
"Cyprus","2024-06-06",0,0,0,0,0,0,0,0
"Cyprus","2024-06-07",0,0,0,0,0,0,0,0
"Cyprus","2024-06-08",0,0,0,0,0,0,0,0
"Cyprus","2024-06-09",0,0,0,0,0,0,0,0
"Cyprus","2024-06-10",0,0,0,0,0,0,0,0
"Cyprus","2024-06-11",0,0,0,0,0,0,0,0
"Cyprus","2024-06-12",0,0,0,0,0,0,0,0
"Cyprus","2024-06-13",0,0,0,0,0,0,0,0
"Cyprus","2024-06-14",0,0,0,0,0,0,0,0
"Cyprus","2024-06-15",0,0,0,0,0,0,0,0
"Cyprus","2024-06-16",0,0,0,0,0,0,0,0
"Cyprus","2024-06-17",0,0,0,0,0,0,0,0
"Cyprus","2024-06-18",0,0,0,0,0,0,0,0
"Cyprus","2024-06-19",0,0,0,0,0,0,0,0
"Cyprus","2024-06-20",0,0,0,0,0,0,0,0
"Cyprus","2024-06-21",0,0,0,0,0,0,0,0
"Cyprus","2024-06-22",0,0,0,0,0,0,0,0
"Cyprus","2024-06-23",0,0,0,0,0,0,0,0
"Cyprus","2024-06-24",0,0,0,0,0,0,0,0
"Cyprus","2024-06-25",0,0,0,0,0,0,0,0
"Cyprus","2024-06-26",0,0,0,0,0,0,0,0
"Cyprus","2024-06-27",0,0,0,0,0,0,0,0
"Cyprus","2024-06-28",0,0,0,0,0,0,0,0
"Cyprus","2024-06-29",0,0,0,0,0,0,0,0
"Cyprus","2024-06-30",0,0,0,0,0,0,0,0
"Cyprus","2024-07-01",0,0,0,0,0,0,0,0
"Cyprus","2024-07-02",0,0,0,0,0,0,0,0
"Cyprus","2024-07-03",0,0,0,0,0,0,0,0
"Cyprus","2024-07-04",0,0,0,0,0,0,0,0
"Cyprus","2024-07-05",0,0,0,0,0,0,0,0
"Cyprus","2024-07-06",0,0,0,0,0,0,0,0
"Cyprus","2024-07-07",0,0,0,0,0,0,0,0
"Cyprus","2024-07-08",0,0,0,0,0,0,0,0
"Cyprus","2024-07-09",0,0,0,0,0,0,0,0
"Cyprus","2024-07-10",0,0,0,0,0,0,0,0
"Cyprus","2024-07-11",0,0,0,0,0,0,0,0
"Cyprus","2024-07-12",0,0,0,0,0,0,0,0
"Cyprus","2024-07-13",0,0,0,0,0,0,0,0
"Cyprus","2024-07-14",0,0,0,0,0,0,0,0
"Cyprus","2024-07-15",0,0,0,0,0,0,0,0
"Cyprus","2024-07-16",0,0,0,0,0,0,0,0
"Cyprus","2024-07-17",0,0,0,0,0,0,0,0
"Cyprus","2024-07-18",0,0,0,0,0,0,0,0
"Cyprus","2024-07-19",0,0,0,0,0,0,0,0
"Cyprus","2024-07-20",0,0,0,0,0,0,0,0
"Cyprus","2024-07-21",0,0,0,0,0,0,0,0
"Cyprus","2024-07-22",0,0,0,0,0,0,0,0
"Cyprus","2024-07-23",0,0,0,0,0,0,0,0
"Cyprus","2024-07-24",0,0,0,0,0,0,0,0
"Cyprus","2024-07-25",0,0,0,0,0,0,0,0
"Cyprus","2024-07-26",0,0,0,0,0,0,0,0
"Cyprus","2024-07-27",0,0,0,0,0,0,0,0
"Cyprus","2024-07-28",0,0,0,0,0,0,0,0
"Cyprus","2024-07-29",0,0,0,0,0,0,0,0
"Cyprus","2024-07-30",0,0,0,0,0,0,0,0
"Cyprus","2024-07-31",0,0,0,0,0,0,0,0
"Cyprus","2024-08-01",0,0,0,0,0,0,0,0
"Cyprus","2024-08-02",0,0,0,0,0,0,0,0
"Cyprus","2024-08-03",0,0,0,0,0,0,0,0
"Cyprus","2024-08-04",0,0,0,0,0,0,0,0
"Cyprus","2024-08-05",0,0,0,0,0,0,0,0
"Cyprus","2024-08-06",0,0,0,0,0,0,0,0
"Cyprus","2024-08-07",0,0,0,0,0,0,0,0
"Cyprus","2024-08-08",0,0,0,0,0,0,0,0
"Cyprus","2024-08-09",0,0,0,0,0,0,0,0
"Cyprus","2024-08-10",0,0,0,0,0,0,0,0
"Cyprus","2024-08-11",0,0,0,0,0,0,0,0
"Cyprus","2024-08-12",0,0,0,0,0,0,0,0
"Cyprus","2024-08-13",0,0,0,0,0,0,0,0
"Cyprus","2024-08-14",0,0,0,0,0,0,0,0
"Cyprus","2024-08-15",0,0,0,0,0,0,0,0
"Cyprus","2024-08-16",0,0,0,0,0,0,0,0
"Cyprus","2024-08-17",0,0,0,0,0,0,0,0
"Cyprus","2024-08-18",0,0,0,0,0,0,0,0
"Cyprus","2024-08-19",0,0,0,0,0,0,0,0
"Cyprus","2024-08-20",0,0,0,0,0,0,0,0
"Cyprus","2024-08-21",0,0,0,0,0,0,0,0
"Cyprus","2024-08-22",0,0,0,0,0,0,0,0
"Cyprus","2024-08-23",0,0,0,0,0,0,0,0
"Cyprus","2024-08-24",0,0,0,0,0,0,0,0
"Cyprus","2024-08-25",0,0,0,0,0,0,0,0
"Cyprus","2024-08-26",0,0,0,0,0,0,0,0
"Cyprus","2024-08-27",0,0,0,0,0,0,0,0
"Cyprus","2024-08-28",0,0,0,0,0,0,0,0
"Cyprus","2024-08-29",0,0,0,0,0,0,0,0
"Cyprus","2024-08-30",0,0,0,0,0,0,0,0
"Cyprus","2024-08-31",0,0,0,0,0,0,0,0
"Cyprus","2024-09-01",0,0,0,0,0,0,0,0
"Cyprus","2024-09-02",0,0,0,0,0,0,0,0
"Cyprus","2024-09-03",0,0,0,0,0,0,0,0
"Cyprus","2024-09-04",0,0,0,0,0,0,0,0
"Cyprus","2024-09-05",0,0,0,0,0,0,0,0
"Cyprus","2024-09-06",0,0,0,0,0,0,0,0
"Cyprus","2024-09-07",0,0,0,0,0,0,0,0
"Cyprus","2024-09-08",0,0,0,0,0,0,0,0
"Cyprus","2024-09-09",0,0,0,0,0,0,0,0
"Cyprus","2024-09-10",0,0,0,0,0,0,0,0
"Cyprus","2024-09-11",0,0,0,0,0,0,0,0
"Cyprus","2024-09-12",0,0,0,0,0,0,0,0
"Cyprus","2024-09-13",0,0,0,0,0,0,0,0
"Cyprus","2024-09-14",0,0,0,0,0,0,0,0
"Cyprus","2024-09-15",0,0,0,0,0,0,0,0
"Cyprus","2024-09-16",0,0,0,0,0,0,0,0
"Cyprus","2024-09-17",0,0,0,0,0,0,0,0
"Cyprus","2024-09-18",0,0,0,0,0,0,0,0
"Cyprus","2024-09-19",0,0,0,0,0,0,0,0
"Cyprus","2024-09-20",0,0,0,0,0,0,0,0
"Cyprus","2024-09-21",0,0,0,0,0,0,0,0
"Cyprus","2024-09-22",0,0,0,0,0,0,0,0
"Cyprus","2024-09-23",0,0,0,0,0,0,0,0
"Cyprus","2024-09-24",0,0,0,0,0,0,0,0
"Cyprus","2024-09-25",0,0,0,0,0,0,0,0
"Cyprus","2024-09-26",0,0,0,0,0,0,0,0
"Cyprus","2024-09-27",0,0,0,0,0,0,0,0
"Cyprus","2024-09-28",0,0,0,0,0,0,0,0
"Cyprus","2024-09-29",0,0,0,0,0,0,0,0
"Cyprus","2024-09-30",0,0,0,0,0,0,0,0
"Cyprus","2024-10-01",0,0,0,0,0,0,0,0
"Cyprus","2024-10-02",0,0,0,0,0,0,0,0
"Cyprus","2024-10-03",0,0,0,0,0,0,0,0
"Cyprus","2024-10-04",0,0,0,0,0,0,0,0
"Cyprus","2024-10-05",0,0,0,0,0,0,0,0
"Cyprus","2024-10-06",0,0,0,0,0,0,0,0
"Cyprus","2024-10-07",0,0,0,0,0,0,0,0
"Cyprus","2024-10-08",0,0,0,0,0,0,0,0
"Cyprus","2024-10-09",0,0,0,0,0,0,0,0
"Cyprus","2024-10-10",0,0,0,0,0,0,0,0
"Cyprus","2024-10-11",0,0,0,0,0,0,0,0
"Cyprus","2024-10-12",0,0,0,0,0,0,0,0
"Cyprus","2024-10-13",0,0,0,0,0,0,0,0
"Cyprus","2024-10-14",0,0,0,0,0,0,0,0
"Cyprus","2024-10-15",0,0,0,0,0,0,0,0
"Cyprus","2024-10-16",0,0,0,0,0,0,0,0
"Cyprus","2024-10-17",0,0,0,0,0,0,0,0
"Cyprus","2024-10-18",0,0,0,0,0,0,0,0
"Cyprus","2024-10-19",0,0,0,0,0,0,0,0
"Cyprus","2024-10-20",0,0,0,0,0,0,0,0
"Cyprus","2024-10-21",0,0,0,0,0,0,0,0
"Cyprus","2024-10-22",0,0,0,0,0,0,0,0
"Cyprus","2024-10-23",0,0,0,0,0,0,0,0
"Cyprus","2024-10-24",0,0,0,0,0,0,0,0
"Cyprus","2024-10-25",0,0,0,0,0,0,0,0
"Cyprus","2024-10-26",0,0,0,0,0,0,0,0
"Cyprus","2024-10-27",0,0,0,0,0,0,0,0
"Cyprus","2024-10-28",0,0,0,0,0,0,0,0
"Cyprus","2024-10-29",0,0,0,0,0,0,0,0
"Cyprus","2024-10-30",0,0,0,0,0,0,0,0
"Cyprus","2024-10-31",0,0,0,0,0,0,0,0
"Cyprus","2024-11-01",0,0,0,0,0,0,0,0
"Cyprus","2024-11-02",0,0,0,0,0,0,0,0
"Cyprus","2024-11-03",0,0,0,0,0,0,0,0
"Cyprus","2024-11-04",0,0,0,0,0,0,0,0
"Cyprus","2024-11-05",0,0,0,0,0,0,0,0
"Cyprus","2024-11-06",0,0,0,0,0,0,0,0
"Cyprus","2024-11-07",0,0,0,0,0,0,0,0
"Cyprus","2024-11-08",0,0,0,0,0,0,0,0
"Cyprus","2024-11-09",0,0,0,0,0,0,0,0
"Cyprus","2024-11-10",0,0,0,0,0,0,0,0
"Cyprus","2024-11-11",0,0,0,0,0,0,0,0
"Cyprus","2024-11-12",0,0,0,0,0,0,0,0
"Cyprus","2024-11-13",0,0,0,0,0,0,0,0
"Cyprus","2024-11-14",0,0,0,0,0,0,0,0
"Cyprus","2024-11-15",0,0,0,0,0,0,0,0
"Cyprus","2024-11-16",0,0,0,0,0,0,0,0
"Cyprus","2024-11-17",0,0,0,0,0,0,0,0
"Cyprus","2024-11-18",0,0,0,0,0,0,0,0
"Cyprus","2024-11-19",0,0,0,0,0,0,0,0
"Cyprus","2024-11-20",0,0,0,0,0,0,0,0
"Cyprus","2024-11-21",0,0,0,0,0,0,0,0
"Cyprus","2024-11-22",0,0,0,0,0,0,0,0
"Cyprus","2024-11-23",0,0,0,0,0,0,0,0
"Cyprus","2024-11-24",0,0,0,0,0,0,0,0
"Cyprus","2024-11-25",0,0,0,0,0,0,0,0
"Cyprus","2024-11-26",0,0,0,0,0,0,0,0
"Cyprus","2024-11-27",0,0,0,0,0,0,0,0
"Cyprus","2024-11-28",0,0,0,0,0,0,0,0
"Cyprus","2024-11-29",0,0,0,0,0,0,0,0
"Cyprus","2024-11-30",0,0,0,0,0,0,0,0
"Cyprus","2024-12-01",0,0,0,0,0,0,0,0
"Cyprus","2024-12-02",0,0,0,0,0,0,0,0
"Cyprus","2024-12-03",0,0,0,0,0,0,0,0
"Cyprus","2024-12-04",0,0,0,0,0,0,0,0
"Cyprus","2024-12-05",0,0,0,0,0,0,0,0
"Cyprus","2024-12-06",0,0,0,0,0,0,0,0
"Cyprus","2024-12-07",0,0,0,0,0,0,0,0
"Cyprus","2024-12-08",0,0,0,0,0,0,0,0
"Cyprus","2024-12-09",0,0,0,0,0,0,0,0
"Cyprus","2024-12-10",0,0,0,0,0,0,0,0
"Cyprus","2024-12-11",0,0,0,0,0,0,0,0
"Cyprus","2024-12-12",0,0,0,0,0,0,0,0
"Cyprus","2024-12-13",0,0,0,0,0,0,0,0
"Cyprus","2024-12-14",0,0,0,0,0,0,0,0
"Cyprus","2024-12-15",0,0,0,0,0,0,0,0
"Cyprus","2024-12-16",0,0,0,0,0,0,0,0
"Cyprus","2024-12-17",0,0,0,0,0,0,0,0
"Cyprus","2024-12-18",0,0,0,0,0,0,0,0
"Cyprus","2024-12-19",0,0,0,0,0,0,0,0
"Cyprus","2024-12-20",0,0,0,0,0,0,0,0
"Cyprus","2024-12-21",0,0,0,0,0,0,0,0
"Cyprus","2024-12-22",0,0,0,0,0,0,0,0
"Cyprus","2024-12-23",0,0,0,0,0,0,0,0
"Cyprus","2024-12-24",0,0,0,0,0,0,0,0
"Cyprus","2024-12-25",0,0,0,0,0,0,0,0
"Cyprus","2024-12-26",0,0,0,0,0,0,0,0
"Cyprus","2024-12-27",0,0,0,0,0,0,0,0
"Cyprus","2024-12-28",0,0,0,0,0,0,0,0
"Cyprus","2024-12-29",0,0,0,0,0,0,0,0
"Cyprus","2024-12-30",0,0,0,0,0,0,0,0
"Cyprus","2024-12-31",0,0,0,0,0,0,0,0
"Cyprus","2025-01-01",0,0,0,0,0,0,0,0
"Cyprus","2025-01-02",0,0,0,0,0,0,0,0
"Cyprus","2025-01-03",0,0,0,0,0,0,0,0
"Cyprus","2025-01-04",0,0,0,0,0,0,0,0
"Cyprus","2025-01-05",0,0,0,0,0,0,0,0
"Cyprus","2025-01-06",0,0,0,0,0,0,0,0
"Cyprus","2025-01-07",0,0,0,0,0,0,0,0
"Cyprus","2025-01-08",0,0,0,0,0,0,0,0
"Cyprus","2025-01-09",0,0,0,0,0,0,0,0
"Cyprus","2025-01-10",0,0,0,0,0,0,0,0
"Cyprus","2025-01-11",0,0,0,0,0,0,0,0
"Cyprus","2025-01-12",0,0,0,0,0,0,0,0
"Cyprus","2025-01-13",0,0,0,0,0,0,0,0
"Czechia","2024-01-01",0,0,0,0,0,0,0,0
"Czechia","2024-01-02",0,0,0,0,0,0,0,0
"Czechia","2024-01-03",0,0,0,0,0,0,0,0
"Czechia","2024-01-04",0,0,0,0,0,0,0,0
"Czechia","2024-01-05",0,0,0,0,0,0,0,0
"Czechia","2024-01-06",0,0,0,0,0,0,0,0
"Czechia","2024-01-07",0,0,0,0,0,0,0,0
"Czechia","2024-01-08",0,0,0,0,0,0,0,0
"Czechia","2024-01-09",0,0,0,0,0,0,0,0
"Czechia","2024-01-10",0,0,0,0,0,0,0,0
"Czechia","2024-01-11",0,0,0,0,0,0,0,0
"Czechia","2024-01-12",0,0,0,0,0,0,0,0
"Czechia","2024-01-13",0,0,0,0,0,0,0,0
"Czechia","2024-01-14",0,0,0,0,0,0,0,0
"Czechia","2024-01-15",0,0,0,0,0,0,0,0
"Czechia","2024-01-16",0,0,0,0,0,0,0,0
"Czechia","2024-01-17",0,0,0,0,0,0,0,0
"Czechia","2024-01-18",0,0,0,0,0,0,0,0
"Czechia","2024-01-19",0,0,0,0,0,0,0,0
"Czechia","2024-01-20",0,0,0,0,0,0,0,0
"Czechia","2024-01-21",0,0,0,0,0,0,0,0
"Czechia","2024-01-22",0,0,0,0,0,0,0,0
"Czechia","2024-01-23",0,0,0,0,0,0,0,0
"Czechia","2024-01-24",0,0,0,0,0,0,0,0
"Czechia","2024-01-25",0,0,0,0,0,0,0,0
"Czechia","2024-01-26",0,0,0,0,0,0,0,0
"Czechia","2024-01-27",0,0,0,0,0,0,0,0
"Czechia","2024-01-28",0,0,0,0,0,0,0,0
"Czechia","2024-01-29",0,0,0,0,0,0,0,0
"Czechia","2024-01-30",0,0,0,0,0,0,0,0
"Czechia","2024-01-31",0,1,1,0,1,1,0,0
"Czechia","2024-02-01",0,0,1,0,0,1,0,0
"Czechia","2024-02-02",0,0,1,0,0,1,0,0
"Czechia","2024-02-03",0,0,1,0,1,2,0,0
"Czechia","2024-02-04",0,0,1,0,0,2,0,0
"Czechia","2024-02-05",0,0,1,0,0,2,0,0
"Czechia","2024-02-06",0,0,1,0,0,2,0,0
"Czechia","2024-02-07",0,0,1,0,0,2,0,0
"Czechia","2024-02-08",0,0,1,0,1,3,0,0
"Czechia","2024-02-09",0,0,1,0,0,3,0,0
"Czechia","2024-02-10",0,0,1,0,0,3,0,0
"Czechia","2024-02-11",0,0,1,0,0,3,0,0
"Czechia","2024-02-12",0,0,1,0,0,3,0,0
"Czechia","2024-02-13",0,0,1,0,1,4,0,0
"Czechia","2024-02-14",0,0,1,0,0,4,0,0
"Czechia","2024-02-15",0,0,1,0,0,4,0,0
"Czechia","2024-02-16",0,0,1,0,0,4,0,0
"Czechia","2024-02-17",0,0,1,0,1,5,0,0
"Czechia","2024-02-18",0,0,1,0,0,5,0,0
"Czechia","2024-02-19",0,0,1,0,0,5,0,0
"Czechia","2024-02-20",0,0,1,0,0,5,0,0
"Czechia","2024-02-21",0,0,1,0,0,5,0,0
"Czechia","2024-02-22",0,0,1,0,1,6,0,0
"Czechia","2024-02-23",0,0,1,0,0,6,0,0
"Czechia","2024-02-24",0,0,1,0,0,6,0,0
"Czechia","2024-02-25",0,0,1,0,0,6,0,0
"Czechia","2024-02-26",0,0,1,0,0,6,0,0
"Czechia","2024-02-27",0,0,1,0,1,7,0,0
"Czechia","2024-02-28",0,0,1,0,0,7,0,0
"Czechia","2024-02-29",0,6,7,0,0,7,0,0
"Czechia","2024-03-01",0,0,7,0,0,7,0,0
"Czechia","2024-03-02",0,0,7,0,0,7,0,0
"Czechia","2024-03-03",0,0,7,0,0,7,0,0
"Czechia","2024-03-04",0,0,7,0,0,7,0,0
"Czechia","2024-03-05",0,0,7,0,0,7,0,0
"Czechia","2024-03-06",0,0,7,0,0,7,0,0
"Czechia","2024-03-07",0,0,7,0,0,7,0,0
"Czechia","2024-03-08",0,0,7,0,0,7,0,0
"Czechia","2024-03-09",0,0,7,0,0,7,0,0
"Czechia","2024-03-10",0,0,7,0,0,7,0,0
"Czechia","2024-03-11",0,0,7,0,1,8,0,0
"Czechia","2024-03-12",0,0,7,0,0,8,0,0
"Czechia","2024-03-13",0,0,7,0,0,8,0,0
"Czechia","2024-03-14",0,0,7,0,0,8,0,0
"Czechia","2024-03-15",0,0,7,0,0,8,0,0
"Czechia","2024-03-16",0,0,7,0,0,8,0,0
"Czechia","2024-03-17",0,0,7,0,0,8,0,0
"Czechia","2024-03-18",0,0,7,0,0,8,0,0
"Czechia","2024-03-19",0,0,7,0,0,8,0,0
"Czechia","2024-03-20",0,0,7,0,0,8,0,0
"Czechia","2024-03-21",0,0,7,0,0,8,0,0
"Czechia","2024-03-22",0,0,7,0,0,8,0,0
"Czechia","2024-03-23",0,0,7,0,0,8,0,0
"Czechia","2024-03-24",0,0,7,0,0,8,0,0
"Czechia","2024-03-25",0,0,7,0,0,8,0,0
"Czechia","2024-03-26",0,0,7,0,0,8,0,0
"Czechia","2024-03-27",0,0,7,0,0,8,0,0
"Czechia","2024-03-28",0,0,7,0,0,8,0,0
"Czechia","2024-03-29",0,0,7,0,0,8,0,0
"Czechia","2024-03-30",0,0,7,0,0,8,0,0
"Czechia","2024-03-31",0,0,7,0,1,9,0,0
"Czechia","2024-04-01",0,0,7,0,0,9,0,0
"Czechia","2024-04-02",0,0,7,0,0,9,0,0
"Czechia","2024-04-03",0,0,7,0,0,9,0,0
"Czechia","2024-04-04",0,0,7,0,0,9,0,0
"Czechia","2024-04-05",0,0,7,0,0,9,0,0
"Czechia","2024-04-06",0,0,7,0,0,9,0,0
"Czechia","2024-04-07",0,0,7,0,0,9,0,0
"Czechia","2024-04-08",0,0,7,0,0,9,0,0
"Czechia","2024-04-09",0,0,7,0,0,9,0,0
"Czechia","2024-04-10",0,0,7,0,0,9,0,0
"Czechia","2024-04-11",0,0,7,0,0,9,0,0
"Czechia","2024-04-12",0,0,7,0,0,9,0,0
"Czechia","2024-04-13",0,0,7,0,0,9,0,0
"Czechia","2024-04-14",0,0,7,0,0,9,0,0
"Czechia","2024-04-15",0,0,7,0,0,9,0,0
"Czechia","2024-04-16",0,0,7,0,0,9,0,0
"Czechia","2024-04-17",0,0,7,0,0,9,0,0
"Czechia","2024-04-18",0,0,7,0,0,9,0,0
"Czechia","2024-04-19",0,0,7,0,0,9,0,0
"Czechia","2024-04-20",0,0,7,0,1,10,0,0
"Czechia","2024-04-21",0,0,7,0,0,10,0,0
"Czechia","2024-04-22",0,0,7,0,0,10,0,0
"Czechia","2024-04-23",0,0,7,0,0,10,0,0
"Czechia","2024-04-24",0,0,7,0,0,10,0,0
"Czechia","2024-04-25",0,0,7,0,0,10,0,0
"Czechia","2024-04-26",0,0,7,0,0,10,0,0
"Czechia","2024-04-27",0,0,7,0,0,10,0,0
"Czechia","2024-04-28",0,0,7,0,0,10,0,0
"Czechia","2024-04-29",0,0,7,0,0,10,0,0
"Czechia","2024-04-30",0,3,10,0,0,10,0,0
"Czechia","2024-05-01",0,0,10,0,0,10,0,0
"Czechia","2024-05-02",0,0,10,0,0,10,0,0
"Czechia","2024-05-03",0,0,10,0,0,10,0,0
"Czechia","2024-05-04",0,0,10,0,0,10,0,0
"Czechia","2024-05-05",0,0,10,0,0,10,0,0
"Czechia","2024-05-06",0,0,10,0,0,10,0,0
"Czechia","2024-05-07",0,0,10,0,0,10,0,0
"Czechia","2024-05-08",0,0,10,0,0,10,0,0
"Czechia","2024-05-09",0,0,10,0,0,10,0,0
"Czechia","2024-05-10",0,0,10,0,0,10,0,0
"Czechia","2024-05-11",0,0,10,0,0,10,0,0
"Czechia","2024-05-12",0,0,10,0,0,10,0,0
"Czechia","2024-05-13",0,0,10,0,0,10,0,0
"Czechia","2024-05-14",0,0,10,0,0,10,0,0
"Czechia","2024-05-15",0,0,10,0,0,10,0,0
"Czechia","2024-05-16",0,0,10,0,1,11,0,0
"Czechia","2024-05-17",0,0,10,0,0,11,0,0
"Czechia","2024-05-18",0,0,10,0,0,11,0,0
"Czechia","2024-05-19",0,0,10,0,0,11,0,0
"Czechia","2024-05-20",0,0,10,0,0,11,0,0
"Czechia","2024-05-21",0,0,10,0,0,11,0,0
"Czechia","2024-05-22",0,0,10,0,0,11,0,0
"Czechia","2024-05-23",0,0,10,0,0,11,0,0
"Czechia","2024-05-24",0,0,10,0,0,11,0,0
"Czechia","2024-05-25",0,0,10,0,0,11,0,0
"Czechia","2024-05-26",0,0,10,0,0,11,0,0
"Czechia","2024-05-27",0,0,10,0,0,11,0,0
"Czechia","2024-05-28",0,0,10,0,0,11,0,0
"Czechia","2024-05-29",0,0,10,0,0,11,0,0
"Czechia","2024-05-30",0,0,10,0,0,11,0,0
"Czechia","2024-05-31",0,1,11,0,0,11,0,0
"Czechia","2024-06-01",0,0,11,0,0,11,0,0
"Czechia","2024-06-02",0,0,11,0,0,11,0,0
"Czechia","2024-06-03",0,0,11,0,0,11,0,0
"Czechia","2024-06-04",0,0,11,0,0,11,0,0
"Czechia","2024-06-05",0,0,11,0,0,11,0,0
"Czechia","2024-06-06",0,0,11,0,0,11,0,0
"Czechia","2024-06-07",0,0,11,0,0,11,0,0
"Czechia","2024-06-08",0,0,11,0,0,11,0,0
"Czechia","2024-06-09",0,0,11,0,0,11,0,0
"Czechia","2024-06-10",0,0,11,0,0,11,0,0
"Czechia","2024-06-11",0,0,11,0,0,11,0,0
"Czechia","2024-06-12",0,0,11,0,0,11,0,0
"Czechia","2024-06-13",0,0,11,0,0,11,0,0
"Czechia","2024-06-14",0,0,11,0,0,11,0,0
"Czechia","2024-06-15",0,0,11,0,0,11,0,0
"Czechia","2024-06-16",0,0,11,0,1,12,0,0
"Czechia","2024-06-17",0,0,11,0,0,12,0,0
"Czechia","2024-06-18",0,0,11,0,0,12,0,0
"Czechia","2024-06-19",0,0,11,0,0,12,0,0
"Czechia","2024-06-20",0,0,11,0,0,12,0,0
"Czechia","2024-06-21",0,0,11,0,0,12,0,0
"Czechia","2024-06-22",0,0,11,0,0,12,0,0
"Czechia","2024-06-23",0,0,11,0,0,12,0,0
"Czechia","2024-06-24",0,0,11,0,0,12,0,0
"Czechia","2024-06-25",0,0,11,0,0,12,0,0
"Czechia","2024-06-26",0,0,11,0,0,12,0,0
"Czechia","2024-06-27",0,0,11,0,0,12,0,0
"Czechia","2024-06-28",0,0,11,0,0,12,0,0
"Czechia","2024-06-29",0,0,11,0,0,12,0,0
"Czechia","2024-06-30",0,0,11,0,0,12,0,0
"Czechia","2024-07-01",0,0,11,0,0,12,0,0
"Czechia","2024-07-02",0,0,11,0,0,12,0,0
"Czechia","2024-07-03",0,0,11,0,0,12,0,0
"Czechia","2024-07-04",0,0,11,0,0,12,0,0
"Czechia","2024-07-05",0,0,11,0,0,12,0,0
"Czechia","2024-07-06",0,0,11,0,0,12,0,0
"Czechia","2024-07-07",0,0,11,0,0,12,0,0
"Czechia","2024-07-08",0,0,11,0,0,12,0,0
"Czechia","2024-07-09",0,0,11,0,0,12,0,0
"Czechia","2024-07-10",0,0,11,0,0,12,0,0
"Czechia","2024-07-11",0,0,11,0,0,12,0,0
"Czechia","2024-07-12",0,0,11,0,0,12,0,0
"Czechia","2024-07-13",0,0,11,0,0,12,0,0
"Czechia","2024-07-14",0,0,11,0,0,12,0,0
"Czechia","2024-07-15",0,0,11,0,0,12,0,0
"Czechia","2024-07-16",0,0,11,0,1,13,0,0
"Czechia","2024-07-17",0,0,11,0,0,13,0,0
"Czechia","2024-07-18",0,0,11,0,0,13,0,0
"Czechia","2024-07-19",0,0,11,0,0,13,0,0
"Czechia","2024-07-20",0,0,11,0,0,13,0,0
"Czechia","2024-07-21",0,0,11,0,0,13,0,0
"Czechia","2024-07-22",0,0,11,0,0,13,0,0
"Czechia","2024-07-23",0,0,11,0,0,13,0,0
"Czechia","2024-07-24",0,0,11,0,0,13,0,0
"Czechia","2024-07-25",0,0,11,0,0,13,0,0
"Czechia","2024-07-26",0,0,11,0,0,13,0,0
"Czechia","2024-07-27",0,0,11,0,0,13,0,0
"Czechia","2024-07-28",0,0,11,0,0,13,0,0
"Czechia","2024-07-29",0,0,11,0,0,13,0,0
"Czechia","2024-07-30",0,0,11,0,0,13,0,0
"Czechia","2024-07-31",0,0,11,0,0,13,0,0
"Czechia","2024-08-01",0,0,11,0,0,13,0,0
"Czechia","2024-08-02",0,0,11,0,0,13,0,0
"Czechia","2024-08-03",0,0,11,0,0,13,0,0
"Czechia","2024-08-04",0,0,11,0,0,13,0,0
"Czechia","2024-08-05",0,0,11,0,0,13,0,0
"Czechia","2024-08-06",0,0,11,0,0,13,0,0
"Czechia","2024-08-07",0,0,11,0,0,13,0,0
"Czechia","2024-08-08",0,0,11,0,0,13,0,0
"Czechia","2024-08-09",0,0,11,0,0,13,0,0
"Czechia","2024-08-10",0,0,11,0,0,13,0,0
"Czechia","2024-08-11",0,0,11,0,0,13,0,0
"Czechia","2024-08-12",0,0,11,0,0,13,0,0
"Czechia","2024-08-13",0,0,11,0,0,13,0,0
"Czechia","2024-08-14",0,0,11,0,0,13,0,0
"Czechia","2024-08-15",0,0,11,0,0,13,0,0
"Czechia","2024-08-16",0,0,11,0,1,14,0,0
"Czechia","2024-08-17",0,0,11,0,0,14,0,0
"Czechia","2024-08-18",0,0,11,0,0,14,0,0
"Czechia","2024-08-19",0,0,11,0,0,14,0,0
"Czechia","2024-08-20",0,0,11,0,0,14,0,0
"Czechia","2024-08-21",0,0,11,0,0,14,0,0
"Czechia","2024-08-22",0,0,11,0,0,14,0,0
"Czechia","2024-08-23",0,0,11,0,0,14,0,0
"Czechia","2024-08-24",0,0,11,0,0,14,0,0
"Czechia","2024-08-25",0,0,11,0,0,14,0,0
"Czechia","2024-08-26",0,0,11,0,0,14,0,0
"Czechia","2024-08-27",0,0,11,0,0,14,0,0
"Czechia","2024-08-28",0,0,11,0,0,14,0,0
"Czechia","2024-08-29",0,0,11,0,0,14,0,0
"Czechia","2024-08-30",0,0,11,0,0,14,0,0
"Czechia","2024-08-31",0,3,14,0,0,14,0,0
"Czechia","2024-09-01",0,0,14,0,0,14,0,0
"Czechia","2024-09-02",0,0,14,0,0,14,0,0
"Czechia","2024-09-03",0,0,14,0,0,14,0,0
"Czechia","2024-09-04",0,0,14,0,0,14,0,0
"Czechia","2024-09-05",0,0,14,0,0,14,0,0
"Czechia","2024-09-06",0,0,14,0,0,14,0,0
"Czechia","2024-09-07",0,0,14,0,0,14,0,0
"Czechia","2024-09-08",0,0,14,0,1,15,0,0
"Czechia","2024-09-09",0,0,14,0,0,15,0,0
"Czechia","2024-09-10",0,0,14,0,0,15,0,0
"Czechia","2024-09-11",0,0,14,0,0,15,0,0
"Czechia","2024-09-12",0,0,14,0,0,15,0,0
"Czechia","2024-09-13",0,0,14,0,0,15,0,0
"Czechia","2024-09-14",0,0,14,0,0,15,0,0
"Czechia","2024-09-15",0,0,14,0,0,15,0,0
"Czechia","2024-09-16",0,0,14,0,0,15,0,0
"Czechia","2024-09-17",0,0,14,0,0,15,0,0
"Czechia","2024-09-18",0,0,14,0,0,15,0,0
"Czechia","2024-09-19",0,0,14,0,0,15,0,0
"Czechia","2024-09-20",0,0,14,0,0,15,0,0
"Czechia","2024-09-21",0,0,14,0,0,15,0,0
"Czechia","2024-09-22",0,0,14,0,0,15,0,0
"Czechia","2024-09-23",0,0,14,0,1,16,0,0
"Czechia","2024-09-24",0,0,14,0,0,16,0,0
"Czechia","2024-09-25",0,0,14,0,0,16,0,0
"Czechia","2024-09-26",0,0,14,0,0,16,0,0
"Czechia","2024-09-27",0,0,14,0,0,16,0,0
"Czechia","2024-09-28",0,0,14,0,0,16,0,0
"Czechia","2024-09-29",0,0,14,0,0,16,0,0
"Czechia","2024-09-30",0,2,16,0,0,16,0,0
"Czechia","2024-10-01",0,0,16,0,0,16,0,0
"Czechia","2024-10-02",0,0,16,0,0,16,0,0
"Czechia","2024-10-03",0,0,16,0,0,16,0,0
"Czechia","2024-10-04",0,0,16,0,0,16,0,0
"Czechia","2024-10-05",0,0,16,0,0,16,0,0
"Czechia","2024-10-06",0,0,16,0,1,17,0,0
"Czechia","2024-10-07",0,0,16,0,0,17,0,0
"Czechia","2024-10-08",0,0,16,0,0,17,0,0
"Czechia","2024-10-09",0,0,16,0,0,17,0,0
"Czechia","2024-10-10",0,0,16,0,0,17,0,0
"Czechia","2024-10-11",0,0,16,0,0,17,0,0
"Czechia","2024-10-12",0,0,16,0,0,17,0,0
"Czechia","2024-10-13",0,0,16,0,0,17,0,0
"Czechia","2024-10-14",0,0,16,0,0,17,0,0
"Czechia","2024-10-15",0,0,16,0,0,17,0,0
"Czechia","2024-10-16",0,0,16,0,1,18,0,0
"Czechia","2024-10-17",0,0,16,0,0,18,0,0
"Czechia","2024-10-18",0,0,16,0,0,18,0,0
"Czechia","2024-10-19",0,0,16,0,0,18,0,0
"Czechia","2024-10-20",0,0,16,0,0,18,0,0
"Czechia","2024-10-21",0,0,16,0,0,18,0,0
"Czechia","2024-10-22",0,0,16,0,0,18,0,0
"Czechia","2024-10-23",0,0,16,0,0,18,0,0
"Czechia","2024-10-24",0,0,16,0,0,18,0,0
"Czechia","2024-10-25",0,0,16,0,0,18,0,0
"Czechia","2024-10-26",0,0,16,0,1,19,0,0
"Czechia","2024-10-27",0,0,16,0,0,19,0,0
"Czechia","2024-10-28",0,0,16,0,0,19,0,0
"Czechia","2024-10-29",0,0,16,0,0,19,0,0
"Czechia","2024-10-30",0,0,16,0,0,19,0,0
"Czechia","2024-10-31",0,3,19,0,0,19,0,0
"Czechia","2024-11-01",0,0,19,0,0,19,0,0
"Czechia","2024-11-02",0,0,19,0,0,19,0,0
"Czechia","2024-11-03",0,0,19,0,0,19,0,0
"Czechia","2024-11-04",0,0,19,0,0,19,0,0
"Czechia","2024-11-05",0,0,19,0,0,19,0,0
"Czechia","2024-11-06",0,0,19,0,0,19,0,0
"Czechia","2024-11-07",0,0,19,0,0,19,0,0
"Czechia","2024-11-08",0,0,19,0,1,20,0,0
"Czechia","2024-11-09",0,0,19,0,0,20,0,0
"Czechia","2024-11-10",0,0,19,0,0,20,0,0
"Czechia","2024-11-11",0,0,19,0,0,20,0,0
"Czechia","2024-11-12",0,0,19,0,0,20,0,0
"Czechia","2024-11-13",0,0,19,0,0,20,0,0
"Czechia","2024-11-14",0,0,19,0,0,20,0,0
"Czechia","2024-11-15",0,0,19,0,0,20,0,0
"Czechia","2024-11-16",0,0,19,0,0,20,0,0
"Czechia","2024-11-17",0,0,19,0,0,20,0,0
"Czechia","2024-11-18",0,0,19,0,0,20,0,0
"Czechia","2024-11-19",0,0,19,0,0,20,0,0
"Czechia","2024-11-20",0,0,19,0,0,20,0,0
"Czechia","2024-11-21",0,0,19,0,0,20,0,0
"Czechia","2024-11-22",0,0,19,0,0,20,0,0
"Czechia","2024-11-23",0,0,19,0,1,21,0,0
"Czechia","2024-11-24",0,0,19,0,0,21,0,0
"Czechia","2024-11-25",0,0,19,0,0,21,0,0
"Czechia","2024-11-26",0,0,19,0,0,21,0,0
"Czechia","2024-11-27",0,0,19,0,0,21,0,0
"Czechia","2024-11-28",0,0,19,0,0,21,0,0
"Czechia","2024-11-29",0,0,19,0,0,21,0,0
"Czechia","2024-11-30",0,2,21,0,0,21,0,0
"Czechia","2024-12-01",0,0,21,0,0,21,0,0
"Czechia","2024-12-02",0,0,21,0,0,21,0,0
"Czechia","2024-12-03",0,0,21,0,0,21,0,0
"Czechia","2024-12-04",0,0,21,0,0,21,0,0
"Czechia","2024-12-05",0,0,21,0,0,21,0,0
"Czechia","2024-12-06",0,0,21,0,0,21,0,0
"Czechia","2024-12-07",0,0,21,0,0,21,0,0
"Czechia","2024-12-08",0,0,21,0,0,21,0,0
"Czechia","2024-12-09",0,0,21,0,0,21,0,0
"Czechia","2024-12-10",0,0,21,0,0,21,0,0
"Czechia","2024-12-11",0,0,21,0,0,21,0,0
"Czechia","2024-12-12",0,0,21,0,0,21,0,0
"Czechia","2024-12-13",0,0,21,0,0,21,0,0
"Czechia","2024-12-14",0,0,21,0,0,21,0,0
"Czechia","2024-12-15",0,0,21,0,0,21,0,0
"Czechia","2024-12-16",0,0,21,0,0,21,0,0
"Czechia","2024-12-17",0,0,21,0,0,21,0,0
"Czechia","2024-12-18",0,0,21,0,0,21,0,0
"Czechia","2024-12-19",0,0,21,0,0,21,0,0
"Czechia","2024-12-20",0,0,21,0,0,21,0,0
"Czechia","2024-12-21",0,0,21,0,0,21,0,0
"Czechia","2024-12-22",0,0,21,0,0,21,0,0
"Czechia","2024-12-23",0,0,21,0,0,21,0,0
"Czechia","2024-12-24",0,0,21,0,0,21,0,0
"Czechia","2024-12-25",0,0,21,0,0,21,0,0
"Czechia","2024-12-26",0,0,21,0,0,21,0,0
"Czechia","2024-12-27",0,0,21,0,0,21,0,0
"Czechia","2024-12-28",0,0,21,0,0,21,0,0
"Czechia","2024-12-29",0,0,21,0,0,21,0,0
"Czechia","2024-12-30",0,0,21,0,0,21,0,0
"Czechia","2024-12-31",0,0,21,0,0,21,0,0
"Czechia","2025-01-01",0,0,21,0,0,21,0,0
"Czechia","2025-01-02",0,0,21,0,0,21,0,0
"Czechia","2025-01-03",0,0,21,0,0,21,0,0
"Czechia","2025-01-04",0,0,21,0,0,21,0,0
"Czechia","2025-01-05",0,0,21,0,0,21,0,0
"Czechia","2025-01-06",0,0,21,0,0,21,0,0
"Czechia","2025-01-07",0,0,21,0,0,21,0,0
"Czechia","2025-01-08",0,0,21,0,0,21,0,0
"Czechia","2025-01-09",0,0,21,0,0,21,0,0
"Czechia","2025-01-10",0,0,21,0,0,21,0,0
"Czechia","2025-01-11",0,0,21,0,0,21,0,0
"Czechia","2025-01-12",0,0,21,0,0,21,0,0
"Czechia","2025-01-13",0,0,21,0,0,21,0,0
"Democratic Republic of the Congo","2024-01-01",0,0,0,0,0,0,0,0
"Democratic Republic of the Congo","2024-01-02",0,0,0,0,0,0,0,0
"Democratic Republic of the Congo","2024-01-03",0,0,0,0,0,0,0,0
"Democratic Republic of the Congo","2024-01-04",0,0,0,0,0,0,0,0
"Democratic Republic of the Congo","2024-01-05",0,0,0,0,0,0,0,0
"Democratic Republic of the Congo","2024-01-06",0,0,0,0,0,0,0,0
"Democratic Republic of the Congo","2024-01-07",0,57,57,0,57,57,0,0
"Democratic Republic of the Congo","2024-01-08",0,0,57,0,10,67,0,0
"Democratic Republic of the Congo","2024-01-09",0,0,57,0,10,77,0,0
"Democratic Republic of the Congo","2024-01-10",0,0,57,0,10,87,0,0
"Democratic Republic of the Congo","2024-01-11",0,0,57,0,10,97,0,0
"Democratic Republic of the Congo","2024-01-12",0,0,57,0,10,107,0,0
"Democratic Republic of the Congo","2024-01-13",0,0,57,0,10,117,0,0
"Democratic Republic of the Congo","2024-01-14",0,70,127,0,10,127,0,0
"Democratic Republic of the Congo","2024-01-15",0,0,127,0,13,140,0,0
"Democratic Republic of the Congo","2024-01-16",0,0,127,0,12,152,0,0
"Democratic Republic of the Congo","2024-01-17",0,0,127,0,13,165,0,0
"Democratic Republic of the Congo","2024-01-18",0,0,127,0,13,178,0,0
"Democratic Republic of the Congo","2024-01-19",0,0,127,0,13,191,0,0
"Democratic Republic of the Congo","2024-01-20",0,0,127,0,12,203,0,0
"Democratic Republic of the Congo","2024-01-21",0,89,216,0,13,216,0,0
"Democratic Republic of the Congo","2024-01-22",0,0,216,0,11,227,0,0
"Democratic Republic of the Congo","2024-01-23",0,0,216,0,10,237,0,0
"Democratic Republic of the Congo","2024-01-24",0,0,216,0,11,248,0,0
"Democratic Republic of the Congo","2024-01-25",0,0,216,0,10,258,0,0
"Democratic Republic of the Congo","2024-01-26",0,0,216,0,11,269,0,0
"Democratic Republic of the Congo","2024-01-27",0,0,216,0,10,279,0,0
"Democratic Republic of the Congo","2024-01-28",0,74,290,0,11,290,0,0
"Democratic Republic of the Congo","2024-01-29",0,0,290,0,9,299,0,0
"Democratic Republic of the Congo","2024-01-30",0,0,290,0,9,308,0,0
"Democratic Republic of the Congo","2024-01-31",0,0,290,0,9,317,0,0
"Democratic Republic of the Congo","2024-02-01",0,0,290,0,8,325,0,0
"Democratic Republic of the Congo","2024-02-02",0,0,290,0,9,334,0,0
"Democratic Republic of the Congo","2024-02-03",0,0,290,0,9,343,0,0
"Democratic Republic of the Congo","2024-02-04",0,62,352,0,9,352,0,0
"Democratic Republic of the Congo","2024-02-05",0,0,352,0,9,361,0,0
"Democratic Republic of the Congo","2024-02-06",0,0,352,0,8,369,0,0
"Democratic Republic of the Congo","2024-02-07",0,0,352,0,9,378,0,0
"Democratic Republic of the Congo","2024-02-08",0,0,352,0,8,386,0,0
"Democratic Republic of the Congo","2024-02-09",0,0,352,0,9,395,0,0
"Democratic Republic of the Congo","2024-02-10",1351,0,352,1351,8,403,1351,1351
"Democratic Republic of the Congo","2024-02-11",0,60,412,1351,9,412,44,1395
"Democratic Republic of the Congo","2024-02-12",0,0,412,1351,9,421,44,1439
"Democratic Republic of the Congo","2024-02-13",0,0,412,1351,9,430,45,1484
"Democratic Republic of the Congo","2024-02-14",0,0,412,1351,9,439,44,1528
"Democratic Republic of the Congo","2024-02-15",0,0,412,1351,10,449,44,1572
"Democratic Republic of the Congo","2024-02-16",0,0,412,1351,9,458,44,1616
"Democratic Republic of the Congo","2024-02-17",0,0,412,1351,9,467,45,1661
"Democratic Republic of the Congo","2024-02-18",0,64,476,1351,9,476,44,1705
"Democratic Republic of the Congo","2024-02-19",0,0,476,1351,6,482,44,1749
"Democratic Republic of the Congo","2024-02-20",0,0,476,1351,7,489,44,1793
"Democratic Republic of the Congo","2024-02-21",0,0,476,1351,6,495,44,1837
"Democratic Republic of the Congo","2024-02-22",0,0,476,1351,6,501,45,1882
"Democratic Republic of the Congo","2024-02-23",0,0,476,1351,6,507,44,1926
"Democratic Republic of the Congo","2024-02-24",0,0,476,1351,7,514,44,1970
"Democratic Republic of the Congo","2024-02-25",0,44,520,1351,6,520,44,2014
"Democratic Republic of the Congo","2024-02-26",0,0,520,1351,12,532,45,2059
"Democratic Republic of the Congo","2024-02-27",0,0,520,1351,11,543,44,2103
"Democratic Republic of the Congo","2024-02-28",0,0,520,1351,12,555,44,2147
"Democratic Republic of the Congo","2024-02-29",0,0,520,1351,11,566,44,2191
"Democratic Republic of the Congo","2024-03-01",0,0,520,1351,12,578,44,2235
"Democratic Republic of the Congo","2024-03-02",0,0,520,1351,11,589,45,2280
"Democratic Republic of the Congo","2024-03-03",0,81,601,1351,12,601,44,2324
"Democratic Republic of the Congo","2024-03-04",0,0,601,1351,8,609,44,2368
"Democratic Republic of the Congo","2024-03-05",0,0,601,1351,8,617,44,2412
"Democratic Republic of the Congo","2024-03-06",0,0,601,1351,8,625,45,2457
"Democratic Republic of the Congo","2024-03-07",0,0,601,1351,8,633,44,2501
"Democratic Republic of the Congo","2024-03-08",0,0,601,1351,8,641,44,2545
"Democratic Republic of the Congo","2024-03-09",0,0,601,1351,8,649,44,2589
"Democratic Republic of the Congo","2024-03-10",0,56,657,1351,8,657,44,2633
"Democratic Republic of the Congo","2024-03-11",0,0,657,1351,10,667,45,2678
"Democratic Republic of the Congo","2024-03-12",0,0,657,1351,9,676,44,2722
"Democratic Republic of the Congo","2024-03-13",0,0,657,1351,10,686,44,2766
"Democratic Republic of the Congo","2024-03-14",0,0,657,1351,10,696,44,2810
"Democratic Republic of the Congo","2024-03-15",0,0,657,1351,10,706,45,2855
"Democratic Republic of the Congo","2024-03-16",0,0,657,1351,9,715,44,2899
"Democratic Republic of the Congo","2024-03-17",1592,68,725,2943,10,725,44,2943
"Democratic Republic of the Congo","2024-03-18",0,0,725,2943,10,735,90,3033
"Democratic Republic of the Congo","2024-03-19",0,0,725,2943,9,744,91,3124
"Democratic Republic of the Congo","2024-03-20",0,0,725,2943,10,754,90,3214
"Democratic Republic of the Congo","2024-03-21",0,0,725,2943,9,763,91,3305
"Democratic Republic of the Congo","2024-03-22",0,0,725,2943,10,773,90,3395
"Democratic Republic of the Congo","2024-03-23",0,0,725,2943,9,782,91,3486
"Democratic Republic of the Congo","2024-03-24",633,67,792,3576,10,792,90,3576
"Democratic Republic of the Congo","2024-03-25",0,0,792,3576,9,801,119,3695
"Democratic Republic of the Congo","2024-03-26",0,0,792,3576,8,809,118,3813
"Democratic Republic of the Congo","2024-03-27",0,0,792,3576,9,818,119,3932
"Democratic Republic of the Congo","2024-03-28",0,0,792,3576,9,827,118,4050
"Democratic Republic of the Congo","2024-03-29",593,0,792,4169,9,836,119,4169
"Democratic Republic of the Congo","2024-03-30",0,0,792,4169,8,844,6,4175
"Democratic Republic of the Congo","2024-03-31",0,61,853,4169,9,853,6,4181
"Democratic Republic of the Congo","2024-04-01",0,0,853,4169,12,865,7,4188
"Democratic Republic of the Congo","2024-04-02",0,0,853,4169,13,878,6,4194
"Democratic Republic of the Congo","2024-04-03",0,0,853,4169,12,890,6,4200
"Democratic Republic of the Congo","2024-04-04",0,0,853,4169,12,902,7,4207
"Democratic Republic of the Congo","2024-04-05",0,0,853,4169,12,914,6,4213
"Democratic Republic of the Congo","2024-04-06",50,0,853,4219,13,927,6,4219
"Democratic Republic of the Congo","2024-04-07",0,86,939,4219,12,939,48,4267
"Democratic Republic of the Congo","2024-04-08",0,0,939,4219,19,958,47,4314
"Democratic Republic of the Congo","2024-04-09",0,0,939,4219,19,977,48,4362
"Democratic Republic of the Congo","2024-04-10",0,0,939,4219,19,996,47,4409
"Democratic Republic of the Congo","2024-04-11",0,0,939,4219,20,1016,48,4457
"Democratic Republic of the Congo","2024-04-12",0,0,939,4219,19,1035,48,4505
"Democratic Republic of the Congo","2024-04-13",0,0,939,4219,19,1054,47,4552
"Democratic Republic of the Congo","2024-04-14",381,134,1073,4600,19,1073,48,4600
"Democratic Republic of the Congo","2024-04-15",0,0,1073,4600,21,1094,28,4628
"Democratic Republic of the Congo","2024-04-16",0,0,1073,4600,21,1115,28,4656
"Democratic Republic of the Congo","2024-04-17",0,0,1073,4600,21,1136,28,4684
"Democratic Republic of the Congo","2024-04-18",0,0,1073,4600,22,1158,27,4711
"Democratic Republic of the Congo","2024-04-19",0,0,1073,4600,21,1179,28,4739
"Democratic Republic of the Congo","2024-04-20",167,0,1073,4767,21,1200,28,4767
"Democratic Republic of the Congo","2024-04-21",0,148,1221,4767,21,1221,25,4792
"Democratic Republic of the Congo","2024-04-22",0,0,1221,4767,24,1245,25,4817
"Democratic Republic of the Congo","2024-04-23",0,0,1221,4767,24,1269,24,4841
"Democratic Republic of the Congo","2024-04-24",0,0,1221,4767,24,1293,25,4866
"Democratic Republic of the Congo","2024-04-25",0,0,1221,4767,24,1317,25,4891
"Democratic Republic of the Congo","2024-04-26",0,0,1221,4767,24,1341,24,4915
"Democratic Republic of the Congo","2024-04-27",0,0,1221,4767,24,1365,25,4940
"Democratic Republic of the Congo","2024-04-28",198,168,1389,4965,24,1389,25,4965
"Democratic Republic of the Congo","2024-04-29",0,0,1389,4965,35,1424,69,5034
"Democratic Republic of the Congo","2024-04-30",0,0,1389,4965,36,1460,68,5102
"Democratic Republic of the Congo","2024-05-01",0,0,1389,4965,35,1495,69,5171
"Democratic Republic of the Congo","2024-05-02",0,0,1389,4965,35,1530,68,5239
"Democratic Republic of the Congo","2024-05-03",0,0,1389,4965,35,1565,69,5308
"Democratic Republic of the Congo","2024-05-04",0,0,1389,4965,36,1601,68,5376
"Democratic Republic of the Congo","2024-05-05",480,247,1636,5445,35,1636,69,5445
"Democratic Republic of the Congo","2024-05-06",0,0,1636,5445,25,1661,19,5464
"Democratic Republic of the Congo","2024-05-07",0,0,1636,5445,25,1686,20,5484
"Democratic Republic of the Congo","2024-05-08",0,0,1636,5445,25,1711,19,5503
"Democratic Republic of the Congo","2024-05-09",0,0,1636,5445,26,1737,20,5523
"Democratic Republic of the Congo","2024-05-10",0,0,1636,5445,25,1762,19,5542
"Democratic Republic of the Congo","2024-05-11",0,0,1636,5445,25,1787,20,5562
"Democratic Republic of the Congo","2024-05-12",136,176,1812,5581,25,1812,19,5581
"Democratic Republic of the Congo","2024-05-13",0,0,1812,5581,29,1841,78,5659
"Democratic Republic of the Congo","2024-05-14",0,0,1812,5581,29,1870,78,5737
"Democratic Republic of the Congo","2024-05-15",0,0,1812,5581,29,1899,78,5815
"Democratic Republic of the Congo","2024-05-16",0,0,1812,5581,28,1927,78,5893
"Democratic Republic of the Congo","2024-05-17",0,0,1812,5581,29,1956,78,5971
"Democratic Republic of the Congo","2024-05-18",468,0,1812,6049,29,1985,78,6049
"Democratic Republic of the Congo","2024-05-19",0,202,2014,6049,29,2014,50,6099
"Democratic Republic of the Congo","2024-05-20",0,0,2014,6049,30,2044,49,6148
"Democratic Republic of the Congo","2024-05-21",0,0,2014,6049,30,2074,50,6198
"Democratic Republic of the Congo","2024-05-22",0,0,2014,6049,30,2104,50,6248
"Democratic Republic of the Congo","2024-05-23",0,0,2014,6049,31,2135,50,6298
"Democratic Republic of the Congo","2024-05-24",0,0,2014,6049,30,2165,49,6347
"Democratic Republic of the Congo","2024-05-25",348,0,2014,6397,30,2195,50,6397
"Democratic Republic of the Congo","2024-05-26",0,211,2225,6397,30,2225,22,6419
"Democratic Republic of the Congo","2024-05-27",0,0,2225,6397,36,2261,22,6441
"Democratic Republic of the Congo","2024-05-28",0,0,2225,6397,37,2298,22,6463
"Democratic Republic of the Congo","2024-05-29",0,0,2225,6397,36,2334,23,6486
"Democratic Republic of the Congo","2024-05-30",0,0,2225,6397,37,2371,22,6508
"Democratic Republic of the Congo","2024-05-31",0,0,2225,6397,36,2407,22,6530
"Democratic Republic of the Congo","2024-06-01",0,0,2225,6397,37,2444,22,6552
"Democratic Republic of the Congo","2024-06-02",0,255,2480,6397,36,2480,22,6574
"Democratic Republic of the Congo","2024-06-03",0,0,2480,6397,32,2512,22,6596
"Democratic Republic of the Congo","2024-06-04",0,0,2480,6397,32,2544,22,6618
"Democratic Republic of the Congo","2024-06-05",0,0,2480,6397,32,2576,22,6640
"Democratic Republic of the Congo","2024-06-06",0,0,2480,6397,33,2609,23,6663
"Democratic Republic of the Congo","2024-06-07",0,0,2480,6397,32,2641,22,6685
"Democratic Republic of the Congo","2024-06-08",0,0,2480,6397,32,2673,22,6707
"Democratic Republic of the Congo","2024-06-09",332,225,2705,6729,32,2705,22,6729
"Democratic Republic of the Congo","2024-06-10",0,0,2705,6729,53,2758,39,6768
"Democratic Republic of the Congo","2024-06-11",0,0,2705,6729,54,2812,39,6807
"Democratic Republic of the Congo","2024-06-12",0,0,2705,6729,53,2865,39,6846
"Democratic Republic of the Congo","2024-06-13",0,0,2705,6729,54,2919,39,6885
"Democratic Republic of the Congo","2024-06-14",0,0,2705,6729,53,2972,39,6924
"Democratic Republic of the Congo","2024-06-15",0,0,2705,6729,54,3026,39,6963
"Democratic Republic of the Congo","2024-06-16",273,374,3079,7002,53,3079,39,7002
"Democratic Republic of the Congo","2024-06-17",0,0,3079,7002,48,3127,100,7102
"Democratic Republic of the Congo","2024-06-18",0,0,3079,7002,48,3175,99,7201
"Democratic Republic of the Congo","2024-06-19",0,0,3079,7002,48,3223,99,7300
"Democratic Republic of the Congo","2024-06-20",0,0,3079,7002,48,3271,100,7400
"Democratic Republic of the Congo","2024-06-21",0,0,3079,7002,48,3319,100,7500
"Democratic Republic of the Congo","2024-06-22",597,0,3079,7599,48,3367,99,7599
"Democratic Republic of the Congo","2024-06-23",0,336,3415,7599,48,3415,57,7656
"Democratic Republic of the Congo","2024-06-24",0,0,3415,7599,65,3480,57,7713
"Democratic Republic of the Congo","2024-06-25",0,0,3415,7599,66,3546,58,7771
"Democratic Republic of the Congo","2024-06-26",0,0,3415,7599,65,3611,57,7828
"Democratic Republic of the Congo","2024-06-27",0,0,3415,7599,65,3676,57,7885
"Democratic Republic of the Congo","2024-06-28",0,0,3415,7599,65,3741,58,7943
"Democratic Republic of the Congo","2024-06-29",0,0,3415,7599,66,3807,57,8000
"Democratic Republic of the Congo","2024-06-30",458,457,3872,8057,65,3872,57,8057
"Democratic Republic of the Congo","2024-07-01",0,0,3872,8057,59,3931,87,8144
"Democratic Republic of the Congo","2024-07-02",0,0,3872,8057,59,3990,88,8232
"Democratic Republic of the Congo","2024-07-03",0,0,3872,8057,59,4049,87,8319
"Democratic Republic of the Congo","2024-07-04",0,0,3872,8057,60,4109,87,8406
"Democratic Republic of the Congo","2024-07-05",0,0,3872,8057,59,4168,88,8494
"Democratic Republic of the Congo","2024-07-06",524,0,3872,8581,59,4227,87,8581
"Democratic Republic of the Congo","2024-07-07",0,414,4286,8581,59,4286,75,8656
"Democratic Republic of the Congo","2024-07-08",0,0,4286,8581,47,4333,76,8732
"Democratic Republic of the Congo","2024-07-09",0,0,4286,8581,48,4381,75,8807
"Democratic Republic of the Congo","2024-07-10",0,0,4286,8581,47,4428,75,8882
"Democratic Republic of the Congo","2024-07-11",0,0,4286,8581,48,4476,76,8958
"Democratic Republic of the Congo","2024-07-12",452,0,4286,9033,47,4523,75,9033
"Democratic Republic of the Congo","2024-07-13",0,0,4286,9033,48,4571,133,9166
"Democratic Republic of the Congo","2024-07-14",0,332,4618,9033,47,4618,133,9299
"Democratic Republic of the Congo","2024-07-15",0,0,4618,9033,74,4692,133,9432
"Democratic Republic of the Congo","2024-07-16",0,0,4618,9033,74,4766,133,9565
"Democratic Republic of the Congo","2024-07-17",0,0,4618,9033,74,4840,134,9699
"Democratic Republic of the Congo","2024-07-18",0,0,4618,9033,73,4913,133,9832
"Democratic Republic of the Congo","2024-07-19",0,0,4618,9033,74,4987,133,9965
"Democratic Republic of the Congo","2024-07-20",0,0,4618,9033,74,5061,133,10098
"Democratic Republic of the Congo","2024-07-21",0,517,5135,9033,74,5135,133,10231
"Democratic Republic of the Congo","2024-07-22",0,0,5135,9033,54,5189,133,10364
"Democratic Republic of the Congo","2024-07-23",0,0,5135,9033,54,5243,133,10497
"Democratic Republic of the Congo","2024-07-24",0,0,5135,9033,54,5297,134,10631
"Democratic Republic of the Congo","2024-07-25",0,0,5135,9033,53,5350,133,10764
"Democratic Republic of the Congo","2024-07-26",0,0,5135,9033,54,5404,133,10897
"Democratic Republic of the Congo","2024-07-27",0,0,5135,9033,54,5458,133,11030
"Democratic Republic of the Congo","2024-07-28",2130,377,5512,11163,54,5512,133,11163
"Democratic Republic of the Congo","2024-07-29",0,0,5512,11163,33,5545,100,11263
"Democratic Republic of the Congo","2024-07-30",0,0,5512,11163,32,5577,100,11363
"Democratic Republic of the Congo","2024-07-31",0,0,5512,11163,33,5610,100,11463
"Democratic Republic of the Congo","2024-08-01",0,0,5512,11163,32,5642,101,11564
"Democratic Republic of the Congo","2024-08-02",0,0,5512,11163,33,5675,100,11664
"Democratic Republic of the Congo","2024-08-03",601,0,5512,11764,32,5707,100,11764
"Democratic Republic of the Congo","2024-08-04",0,228,5740,11764,33,5740,398,12162
"Democratic Republic of the Congo","2024-08-05",0,0,5740,11764,34,5774,398,12560
"Democratic Republic of the Congo","2024-08-06",0,0,5740,11764,34,5808,398,12958
"Democratic Republic of the Congo","2024-08-07",0,0,5740,11764,34,5842,397,13355
"Democratic Republic of the Congo","2024-08-08",0,0,5740,11764,35,5877,398,13753
"Democratic Republic of the Congo","2024-08-09",2387,0,5740,14151,34,5911,398,14151
"Democratic Republic of the Congo","2024-08-10",0,0,5740,14151,34,5945,112,14263
"Democratic Republic of the Congo","2024-08-11",0,239,5979,14151,34,5979,112,14375
"Democratic Republic of the Congo","2024-08-12",0,0,5979,14151,29,6008,112,14487
"Democratic Republic of the Congo","2024-08-13",0,0,5979,14151,30,6038,111,14598
"Democratic Republic of the Congo","2024-08-14",0,0,5979,14151,29,6067,112,14710
"Democratic Republic of the Congo","2024-08-15",0,0,5979,14151,30,6097,112,14822
"Democratic Republic of the Congo","2024-08-16",783,0,5979,14934,29,6126,112,14934
"Democratic Republic of the Congo","2024-08-17",0,0,5979,14934,30,6156,197,15131
"Democratic Republic of the Congo","2024-08-18",0,206,6185,14934,29,6185,197,15328
"Democratic Republic of the Congo","2024-08-19",0,0,6185,14934,29,6214,197,15525
"Democratic Republic of the Congo","2024-08-20",0,0,6185,14934,29,6243,197,15722
"Democratic Republic of the Congo","2024-08-21",0,0,6185,14934,29,6272,196,15918
"Democratic Republic of the Congo","2024-08-22",0,0,6185,14934,30,6302,197,16115
"Democratic Republic of the Congo","2024-08-23",0,0,6185,14934,29,6331,197,16312
"Democratic Republic of the Congo","2024-08-24",0,0,6185,14934,29,6360,197,16509
"Democratic Republic of the Congo","2024-08-25",1772,204,6389,16706,29,6389,197,16706
"Democratic Republic of the Congo","2024-08-26",0,0,6389,16706,45,6434,182,16888
"Democratic Republic of the Congo","2024-08-27",0,0,6389,16706,46,6480,183,17071
"Democratic Republic of the Congo","2024-08-28",0,0,6389,16706,45,6525,183,17254
"Democratic Republic of the Congo","2024-08-29",0,0,6389,16706,45,6570,182,17436
"Democratic Republic of the Congo","2024-08-30",0,0,6389,16706,45,6615,182,17618
"Democratic Republic of the Congo","2024-08-31",1095,0,6389,17801,46,6661,183,17801
"Democratic Republic of the Congo","2024-09-01",0,317,6706,17801,45,6706,333,18134
"Democratic Republic of the Congo","2024-09-02",0,0,6706,17801,46,6752,333,18467
"Democratic Republic of the Congo","2024-09-03",0,0,6706,17801,46,6798,332,18799
"Democratic Republic of the Congo","2024-09-04",0,0,6706,17801,46,6844,333,19132
"Democratic Republic of the Congo","2024-09-05",0,0,6706,17801,47,6891,333,19465
"Democratic Republic of the Congo","2024-09-06",0,0,6706,17801,46,6937,332,19797
"Democratic Republic of the Congo","2024-09-07",0,0,6706,17801,46,6983,333,20130
"Democratic Republic of the Congo","2024-09-08",2662,323,7029,20463,46,7029,333,20463
"Democratic Republic of the Congo","2024-09-09",0,0,7029,20463,42,7071,14,20477
"Democratic Republic of the Congo","2024-09-10",0,0,7029,20463,42,7113,13,20490
"Democratic Republic of the Congo","2024-09-11",0,0,7029,20463,42,7155,14,20504
"Democratic Republic of the Congo","2024-09-12",0,0,7029,20463,42,7197,14,20518
"Democratic Republic of the Congo","2024-09-13",0,0,7029,20463,42,7239,13,20531
"Democratic Republic of the Congo","2024-09-14",0,0,7029,20463,42,7281,14,20545
"Democratic Republic of the Congo","2024-09-15",0,294,7323,20463,42,7323,14,20559
"Democratic Republic of the Congo","2024-09-16",0,0,7323,20463,43,7366,13,20572
"Democratic Republic of the Congo","2024-09-17",0,0,7323,20463,44,7410,14,20586
"Democratic Republic of the Congo","2024-09-18",0,0,7323,20463,43,7453,14,20600
"Democratic Republic of the Congo","2024-09-19",0,0,7323,20463,43,7496,13,20613
"Democratic Republic of the Congo","2024-09-20",0,0,7323,20463,43,7539,14,20627
"Democratic Republic of the Congo","2024-09-21",0,0,7323,20463,44,7583,14,20641
"Democratic Republic of the Congo","2024-09-22",0,303,7626,20463,43,7626,13,20654
"Democratic Republic of the Congo","2024-09-23",205,0,7626,20668,26,7652,14,20668
"Democratic Republic of the Congo","2024-09-24",0,0,7626,20668,27,7679,144,20812
"Democratic Republic of the Congo","2024-09-25",0,0,7626,20668,26,7705,144,20956
"Democratic Republic of the Congo","2024-09-26",0,0,7626,20668,26,7731,144,21100
"Democratic Republic of the Congo","2024-09-27",0,0,7626,20668,26,7757,143,21243
"Democratic Republic of the Congo","2024-09-28",0,0,7626,20668,27,7784,144,21387
"Democratic Republic of the Congo","2024-09-29",0,184,7810,20668,26,7810,144,21531
"Democratic Republic of the Congo","2024-09-30",1007,0,7810,21675,24,7834,144,21675
"Democratic Republic of the Congo","2024-10-01",0,0,7810,21675,24,7858,415,22090
"Democratic Republic of the Congo","2024-10-02",0,0,7810,21675,24,7882,415,22505
"Democratic Republic of the Congo","2024-10-03",0,0,7810,21675,24,7906,415,22920
"Democratic Republic of the Congo","2024-10-04",0,0,7810,21675,24,7930,414,23334
"Democratic Republic of the Congo","2024-10-05",0,0,7810,21675,24,7954,415,23749
"Democratic Republic of the Congo","2024-10-06",0,168,7978,21675,24,7978,415,24164
"Democratic Republic of the Congo","2024-10-07",0,0,7978,21675,36,8014,415,24579
"Democratic Republic of the Congo","2024-10-08",0,0,7978,21675,36,8050,415,24994
"Democratic Republic of the Congo","2024-10-09",0,0,7978,21675,36,8086,415,25409
"Democratic Republic of the Congo","2024-10-10",0,0,7978,21675,35,8121,414,25823
"Democratic Republic of the Congo","2024-10-11",0,0,7978,21675,36,8157,415,26238
"Democratic Republic of the Congo","2024-10-12",0,0,7978,21675,36,8193,415,26653
"Democratic Republic of the Congo","2024-10-13",5393,251,8229,27068,36,8229,415,27068
"Democratic Republic of the Congo","2024-10-14",0,0,8229,27068,44,8273,189,27257
"Democratic Republic of the Congo","2024-10-15",0,0,8229,27068,44,8317,189,27446
"Democratic Republic of the Congo","2024-10-16",0,0,8229,27068,44,8361,189,27635
"Democratic Republic of the Congo","2024-10-17",0,0,8229,27068,44,8405,189,27824
"Democratic Republic of the Congo","2024-10-18",0,0,8229,27068,44,8449,189,28013
"Democratic Republic of the Congo","2024-10-19",0,0,8229,27068,44,8493,189,28202
"Democratic Republic of the Congo","2024-10-20",1323,308,8537,28391,44,8537,189,28391
"Democratic Republic of the Congo","2024-10-21",0,0,8537,28391,30,8567,95,28486
"Democratic Republic of the Congo","2024-10-22",0,0,8537,28391,31,8598,96,28582
"Democratic Republic of the Congo","2024-10-23",0,0,8537,28391,30,8628,95,28677
"Democratic Republic of the Congo","2024-10-24",0,0,8537,28391,31,8659,95,28772
"Democratic Republic of the Congo","2024-10-25",0,0,8537,28391,30,8689,95,28867
"Democratic Republic of the Congo","2024-10-26",0,0,8537,28391,31,8720,96,28963
"Democratic Republic of the Congo","2024-10-27",667,213,8750,29058,30,8750,95,29058
"Democratic Republic of the Congo","2024-10-28",0,0,8750,29058,22,8772,68,29126
"Democratic Republic of the Congo","2024-10-29",0,0,8750,29058,23,8795,68,29194
"Democratic Republic of the Congo","2024-10-30",0,0,8750,29058,22,8817,68,29262
"Democratic Republic of the Congo","2024-10-31",0,0,8750,29058,22,8839,67,29329
"Democratic Republic of the Congo","2024-11-01",0,0,8750,29058,22,8861,68,29397
"Democratic Republic of the Congo","2024-11-02",0,0,8750,29058,23,8884,68,29465
"Democratic Republic of the Congo","2024-11-03",475,156,8906,29533,22,8906,68,29533
"Democratic Republic of the Congo","2024-11-04",0,0,8906,29533,41,8947,268,29801
"Democratic Republic of the Congo","2024-11-05",0,0,8906,29533,40,8987,267,30068
"Democratic Republic of the Congo","2024-11-06",0,0,8906,29533,41,9028,268,30336
"Democratic Republic of the Congo","2024-11-07",0,0,8906,29533,41,9069,267,30603
"Democratic Republic of the Congo","2024-11-08",0,0,8906,29533,41,9110,268,30871
"Democratic Republic of the Congo","2024-11-09",0,0,8906,29533,40,9150,267,31138
"Democratic Republic of the Congo","2024-11-10",0,285,9191,29533,41,9191,268,31406
"Democratic Republic of the Congo","2024-11-11",0,0,9191,29533,8,9199,267,31673
"Democratic Republic of the Congo","2024-11-12",0,0,9191,29533,8,9207,268,31941
"Democratic Republic of the Congo","2024-11-13",0,0,9191,29533,8,9215,268,32209
"Democratic Republic of the Congo","2024-11-14",0,0,9191,29533,8,9223,267,32476
"Democratic Republic of the Congo","2024-11-15",0,0,9191,29533,8,9231,268,32744
"Democratic Republic of the Congo","2024-11-16",0,0,9191,29533,8,9239,267,33011
"Democratic Republic of the Congo","2024-11-17",0,56,9247,29533,8,9247,268,33279
"Democratic Republic of the Congo","2024-11-18",0,0,9247,29533,0,9247,267,33546
"Democratic Republic of the Congo","2024-11-19",0,0,9247,29533,0,9247,268,33814
"Democratic Republic of the Congo","2024-11-20",0,0,9247,29533,0,9247,267,34081
"Democratic Republic of the Congo","2024-11-21",4816,0,9247,34349,0,9247,268,34349
"Democratic Republic of the Congo","2024-11-22",0,0,9247,34349,0,9247,0,34349
"Democratic Republic of the Congo","2024-11-23",0,0,9247,34349,0,9247,0,34349
"Democratic Republic of the Congo","2024-11-24",0,0,9247,34349,0,9247,0,34349
"Democratic Republic of the Congo","2024-11-25",0,0,9247,34349,0,9247,0,34349
"Democratic Republic of the Congo","2024-11-26",0,0,9247,34349,0,9247,0,34349
"Democratic Republic of the Congo","2024-11-27",0,0,9247,34349,0,9247,0,34349
"Democratic Republic of the Congo","2024-11-28",0,0,9247,34349,0,9247,0,34349
"Democratic Republic of the Congo","2024-11-29",0,0,9247,34349,0,9247,0,34349
"Democratic Republic of the Congo","2024-11-30",0,0,9247,34349,0,9247,0,34349
"Democratic Republic of the Congo","2024-12-01",0,0,9247,34349,0,9247,0,34349
"Democratic Republic of the Congo","2024-12-02",0,0,9247,34349,0,9247,0,34349
"Democratic Republic of the Congo","2024-12-03",0,0,9247,34349,0,9247,0,34349
"Democratic Republic of the Congo","2024-12-04",0,0,9247,34349,0,9247,0,34349
"Democratic Republic of the Congo","2024-12-05",0,0,9247,34349,0,9247,0,34349
"Democratic Republic of the Congo","2024-12-06",0,0,9247,34349,0,9247,0,34349
"Democratic Republic of the Congo","2024-12-07",0,0,9247,34349,0,9247,0,34349
"Democratic Republic of the Congo","2024-12-08",0,0,9247,34349,0,9247,0,34349
"Democratic Republic of the Congo","2024-12-09",0,0,9247,34349,0,9247,0,34349
"Democratic Republic of the Congo","2024-12-10",0,0,9247,34349,0,9247,0,34349
"Democratic Republic of the Congo","2024-12-11",0,0,9247,34349,0,9247,0,34349
"Democratic Republic of the Congo","2024-12-12",0,0,9247,34349,0,9247,0,34349
"Democratic Republic of the Congo","2024-12-13",0,0,9247,34349,0,9247,0,34349
"Democratic Republic of the Congo","2024-12-14",0,0,9247,34349,0,9247,0,34349
"Democratic Republic of the Congo","2024-12-15",0,0,9247,34349,0,9247,0,34349
"Democratic Republic of the Congo","2024-12-16",0,0,9247,34349,0,9247,0,34349
"Democratic Republic of the Congo","2024-12-17",0,0,9247,34349,0,9247,0,34349
"Democratic Republic of the Congo","2024-12-18",0,0,9247,34349,0,9247,0,34349
"Democratic Republic of the Congo","2024-12-19",0,0,9247,34349,0,9247,0,34349
"Democratic Republic of the Congo","2024-12-20",0,0,9247,34349,0,9247,0,34349
"Democratic Republic of the Congo","2024-12-21",0,0,9247,34349,0,9247,0,34349
"Democratic Republic of the Congo","2024-12-22",0,0,9247,34349,0,9247,0,34349
"Democratic Republic of the Congo","2024-12-23",0,0,9247,34349,0,9247,0,34349
"Democratic Republic of the Congo","2024-12-24",0,0,9247,34349,0,9247,0,34349
"Democratic Republic of the Congo","2024-12-25",0,0,9247,34349,0,9247,0,34349
"Democratic Republic of the Congo","2024-12-26",0,0,9247,34349,0,9247,0,34349
"Democratic Republic of the Congo","2024-12-27",0,0,9247,34349,0,9247,0,34349
"Democratic Republic of the Congo","2024-12-28",0,0,9247,34349,0,9247,0,34349
"Democratic Republic of the Congo","2024-12-29",0,0,9247,34349,0,9247,0,34349
"Democratic Republic of the Congo","2024-12-30",0,0,9247,34349,0,9247,0,34349
"Democratic Republic of the Congo","2024-12-31",0,0,9247,34349,0,9247,0,34349
"Democratic Republic of the Congo","2025-01-01",0,0,9247,34349,0,9247,0,34349
"Democratic Republic of the Congo","2025-01-02",0,0,9247,34349,0,9247,0,34349
"Democratic Republic of the Congo","2025-01-03",0,0,9247,34349,0,9247,0,34349
"Democratic Republic of the Congo","2025-01-04",0,0,9247,34349,0,9247,0,34349
"Democratic Republic of the Congo","2025-01-05",0,0,9247,34349,0,9247,0,34349
"Democratic Republic of the Congo","2025-01-06",0,0,9247,34349,0,9247,0,34349
"Democratic Republic of the Congo","2025-01-07",0,0,9247,34349,0,9247,0,34349
"Democratic Republic of the Congo","2025-01-08",0,0,9247,34349,0,9247,0,34349
"Democratic Republic of the Congo","2025-01-09",0,0,9247,34349,0,9247,0,34349
"Democratic Republic of the Congo","2025-01-10",0,0,9247,34349,0,9247,0,34349
"Democratic Republic of the Congo","2025-01-11",0,0,9247,34349,0,9247,0,34349
"Democratic Republic of the Congo","2025-01-12",0,0,9247,34349,0,9247,0,34349
"Democratic Republic of the Congo","2025-01-13",0,0,9247,34349,0,9247,0,34349
"Denmark","2024-01-01",0,0,0,0,0,0,0,0
"Denmark","2024-01-02",0,0,0,0,0,0,0,0
"Denmark","2024-01-03",0,0,0,0,0,0,0,0
"Denmark","2024-01-04",0,0,0,0,0,0,0,0
"Denmark","2024-01-05",0,0,0,0,0,0,0,0
"Denmark","2024-01-06",0,0,0,0,0,0,0,0
"Denmark","2024-01-07",0,0,0,0,0,0,0,0
"Denmark","2024-01-08",0,0,0,0,0,0,0,0
"Denmark","2024-01-09",0,0,0,0,0,0,0,0
"Denmark","2024-01-10",0,0,0,0,0,0,0,0
"Denmark","2024-01-11",0,0,0,0,0,0,0,0
"Denmark","2024-01-12",0,0,0,0,0,0,0,0
"Denmark","2024-01-13",0,0,0,0,0,0,0,0
"Denmark","2024-01-14",0,0,0,0,0,0,0,0
"Denmark","2024-01-15",0,0,0,0,0,0,0,0
"Denmark","2024-01-16",0,0,0,0,0,0,0,0
"Denmark","2024-01-17",0,0,0,0,0,0,0,0
"Denmark","2024-01-18",0,0,0,0,0,0,0,0
"Denmark","2024-01-19",0,0,0,0,0,0,0,0
"Denmark","2024-01-20",0,0,0,0,0,0,0,0
"Denmark","2024-01-21",0,0,0,0,0,0,0,0
"Denmark","2024-01-22",0,0,0,0,0,0,0,0
"Denmark","2024-01-23",0,0,0,0,0,0,0,0
"Denmark","2024-01-24",0,0,0,0,0,0,0,0
"Denmark","2024-01-25",0,0,0,0,0,0,0,0
"Denmark","2024-01-26",0,0,0,0,0,0,0,0
"Denmark","2024-01-27",0,0,0,0,0,0,0,0
"Denmark","2024-01-28",0,0,0,0,0,0,0,0
"Denmark","2024-01-29",0,0,0,0,0,0,0,0
"Denmark","2024-01-30",0,0,0,0,0,0,0,0
"Denmark","2024-01-31",0,0,0,0,0,0,0,0
"Denmark","2024-02-01",0,0,0,0,0,0,0,0
"Denmark","2024-02-02",0,0,0,0,0,0,0,0
"Denmark","2024-02-03",0,0,0,0,0,0,0,0
"Denmark","2024-02-04",0,0,0,0,0,0,0,0
"Denmark","2024-02-05",0,0,0,0,0,0,0,0
"Denmark","2024-02-06",0,0,0,0,0,0,0,0
"Denmark","2024-02-07",0,0,0,0,0,0,0,0
"Denmark","2024-02-08",0,0,0,0,0,0,0,0
"Denmark","2024-02-09",0,0,0,0,0,0,0,0
"Denmark","2024-02-10",0,0,0,0,0,0,0,0
"Denmark","2024-02-11",0,0,0,0,0,0,0,0
"Denmark","2024-02-12",0,0,0,0,0,0,0,0
"Denmark","2024-02-13",0,0,0,0,0,0,0,0
"Denmark","2024-02-14",0,0,0,0,0,0,0,0
"Denmark","2024-02-15",0,0,0,0,0,0,0,0
"Denmark","2024-02-16",0,0,0,0,0,0,0,0
"Denmark","2024-02-17",0,0,0,0,0,0,0,0
"Denmark","2024-02-18",0,0,0,0,0,0,0,0
"Denmark","2024-02-19",0,0,0,0,0,0,0,0
"Denmark","2024-02-20",0,0,0,0,0,0,0,0
"Denmark","2024-02-21",0,0,0,0,0,0,0,0
"Denmark","2024-02-22",0,0,0,0,0,0,0,0
"Denmark","2024-02-23",0,0,0,0,0,0,0,0
"Denmark","2024-02-24",0,0,0,0,0,0,0,0
"Denmark","2024-02-25",0,0,0,0,0,0,0,0
"Denmark","2024-02-26",0,0,0,0,0,0,0,0
"Denmark","2024-02-27",0,0,0,0,0,0,0,0
"Denmark","2024-02-28",0,0,0,0,0,0,0,0
"Denmark","2024-02-29",0,0,0,0,0,0,0,0
"Denmark","2024-03-01",0,0,0,0,0,0,0,0
"Denmark","2024-03-02",0,0,0,0,0,0,0,0
"Denmark","2024-03-03",0,0,0,0,0,0,0,0
"Denmark","2024-03-04",0,0,0,0,0,0,0,0
"Denmark","2024-03-05",0,0,0,0,0,0,0,0
"Denmark","2024-03-06",0,0,0,0,0,0,0,0
"Denmark","2024-03-07",0,0,0,0,0,0,0,0
"Denmark","2024-03-08",0,0,0,0,0,0,0,0
"Denmark","2024-03-09",0,0,0,0,0,0,0,0
"Denmark","2024-03-10",0,0,0,0,0,0,0,0
"Denmark","2024-03-11",0,0,0,0,0,0,0,0
"Denmark","2024-03-12",0,0,0,0,0,0,0,0
"Denmark","2024-03-13",0,0,0,0,0,0,0,0
"Denmark","2024-03-14",0,0,0,0,0,0,0,0
"Denmark","2024-03-15",0,0,0,0,0,0,0,0
"Denmark","2024-03-16",0,0,0,0,0,0,0,0
"Denmark","2024-03-17",0,0,0,0,0,0,0,0
"Denmark","2024-03-18",0,0,0,0,0,0,0,0
"Denmark","2024-03-19",0,0,0,0,0,0,0,0
"Denmark","2024-03-20",0,0,0,0,0,0,0,0
"Denmark","2024-03-21",0,0,0,0,0,0,0,0
"Denmark","2024-03-22",0,0,0,0,0,0,0,0
"Denmark","2024-03-23",0,0,0,0,0,0,0,0
"Denmark","2024-03-24",0,0,0,0,0,0,0,0
"Denmark","2024-03-25",0,0,0,0,0,0,0,0
"Denmark","2024-03-26",0,0,0,0,0,0,0,0
"Denmark","2024-03-27",0,0,0,0,0,0,0,0
"Denmark","2024-03-28",0,0,0,0,0,0,0,0
"Denmark","2024-03-29",0,0,0,0,0,0,0,0
"Denmark","2024-03-30",0,0,0,0,0,0,0,0
"Denmark","2024-03-31",0,0,0,0,0,0,0,0
"Denmark","2024-04-01",0,0,0,0,0,0,0,0
"Denmark","2024-04-02",0,0,0,0,0,0,0,0
"Denmark","2024-04-03",0,0,0,0,0,0,0,0
"Denmark","2024-04-04",0,0,0,0,0,0,0,0
"Denmark","2024-04-05",0,0,0,0,0,0,0,0
"Denmark","2024-04-06",0,0,0,0,0,0,0,0
"Denmark","2024-04-07",0,0,0,0,0,0,0,0
"Denmark","2024-04-08",0,0,0,0,0,0,0,0
"Denmark","2024-04-09",0,0,0,0,0,0,0,0
"Denmark","2024-04-10",0,0,0,0,0,0,0,0
"Denmark","2024-04-11",0,0,0,0,0,0,0,0
"Denmark","2024-04-12",0,0,0,0,0,0,0,0
"Denmark","2024-04-13",0,0,0,0,0,0,0,0
"Denmark","2024-04-14",0,0,0,0,0,0,0,0
"Denmark","2024-04-15",0,0,0,0,0,0,0,0
"Denmark","2024-04-16",0,0,0,0,0,0,0,0
"Denmark","2024-04-17",0,0,0,0,0,0,0,0
"Denmark","2024-04-18",0,0,0,0,0,0,0,0
"Denmark","2024-04-19",0,0,0,0,0,0,0,0
"Denmark","2024-04-20",0,0,0,0,0,0,0,0
"Denmark","2024-04-21",0,0,0,0,0,0,0,0
"Denmark","2024-04-22",0,0,0,0,0,0,0,0
"Denmark","2024-04-23",0,0,0,0,0,0,0,0
"Denmark","2024-04-24",0,0,0,0,0,0,0,0
"Denmark","2024-04-25",0,0,0,0,0,0,0,0
"Denmark","2024-04-26",0,0,0,0,0,0,0,0
"Denmark","2024-04-27",0,0,0,0,0,0,0,0
"Denmark","2024-04-28",0,0,0,0,0,0,0,0
"Denmark","2024-04-29",0,0,0,0,0,0,0,0
"Denmark","2024-04-30",0,0,0,0,0,0,0,0
"Denmark","2024-05-01",0,0,0,0,0,0,0,0
"Denmark","2024-05-02",0,0,0,0,0,0,0,0
"Denmark","2024-05-03",0,0,0,0,0,0,0,0
"Denmark","2024-05-04",0,0,0,0,0,0,0,0
"Denmark","2024-05-05",0,0,0,0,0,0,0,0
"Denmark","2024-05-06",0,0,0,0,0,0,0,0
"Denmark","2024-05-07",0,0,0,0,0,0,0,0
"Denmark","2024-05-08",0,0,0,0,0,0,0,0
"Denmark","2024-05-09",0,0,0,0,0,0,0,0
"Denmark","2024-05-10",0,0,0,0,0,0,0,0
"Denmark","2024-05-11",0,0,0,0,0,0,0,0
"Denmark","2024-05-12",0,0,0,0,0,0,0,0
"Denmark","2024-05-13",0,0,0,0,0,0,0,0
"Denmark","2024-05-14",0,0,0,0,0,0,0,0
"Denmark","2024-05-15",0,0,0,0,0,0,0,0
"Denmark","2024-05-16",0,0,0,0,0,0,0,0
"Denmark","2024-05-17",0,0,0,0,0,0,0,0
"Denmark","2024-05-18",0,0,0,0,0,0,0,0
"Denmark","2024-05-19",0,0,0,0,0,0,0,0
"Denmark","2024-05-20",0,0,0,0,0,0,0,0
"Denmark","2024-05-21",0,0,0,0,0,0,0,0
"Denmark","2024-05-22",0,0,0,0,0,0,0,0
"Denmark","2024-05-23",0,0,0,0,0,0,0,0
"Denmark","2024-05-24",0,0,0,0,0,0,0,0
"Denmark","2024-05-25",0,0,0,0,0,0,0,0
"Denmark","2024-05-26",0,0,0,0,0,0,0,0
"Denmark","2024-05-27",0,0,0,0,0,0,0,0
"Denmark","2024-05-28",0,0,0,0,0,0,0,0
"Denmark","2024-05-29",0,0,0,0,0,0,0,0
"Denmark","2024-05-30",0,0,0,0,0,0,0,0
"Denmark","2024-05-31",0,0,0,0,0,0,0,0
"Denmark","2024-06-01",0,0,0,0,0,0,0,0
"Denmark","2024-06-02",0,0,0,0,0,0,0,0
"Denmark","2024-06-03",0,0,0,0,0,0,0,0
"Denmark","2024-06-04",0,0,0,0,0,0,0,0
"Denmark","2024-06-05",0,0,0,0,0,0,0,0
"Denmark","2024-06-06",0,0,0,0,0,0,0,0
"Denmark","2024-06-07",0,0,0,0,0,0,0,0
"Denmark","2024-06-08",0,0,0,0,0,0,0,0
"Denmark","2024-06-09",0,0,0,0,0,0,0,0
"Denmark","2024-06-10",0,0,0,0,0,0,0,0
"Denmark","2024-06-11",0,0,0,0,0,0,0,0
"Denmark","2024-06-12",0,0,0,0,0,0,0,0
"Denmark","2024-06-13",0,0,0,0,0,0,0,0
"Denmark","2024-06-14",0,0,0,0,0,0,0,0
"Denmark","2024-06-15",0,0,0,0,0,0,0,0
"Denmark","2024-06-16",0,0,0,0,0,0,0,0
"Denmark","2024-06-17",0,0,0,0,0,0,0,0
"Denmark","2024-06-18",0,0,0,0,0,0,0,0
"Denmark","2024-06-19",0,0,0,0,0,0,0,0
"Denmark","2024-06-20",0,0,0,0,0,0,0,0
"Denmark","2024-06-21",0,0,0,0,0,0,0,0
"Denmark","2024-06-22",0,0,0,0,0,0,0,0
"Denmark","2024-06-23",0,0,0,0,0,0,0,0
"Denmark","2024-06-24",0,0,0,0,0,0,0,0
"Denmark","2024-06-25",0,0,0,0,0,0,0,0
"Denmark","2024-06-26",0,0,0,0,0,0,0,0
"Denmark","2024-06-27",0,0,0,0,0,0,0,0
"Denmark","2024-06-28",0,0,0,0,0,0,0,0
"Denmark","2024-06-29",0,0,0,0,0,0,0,0
"Denmark","2024-06-30",0,0,0,0,0,0,0,0
"Denmark","2024-07-01",0,0,0,0,0,0,0,0
"Denmark","2024-07-02",0,0,0,0,0,0,0,0
"Denmark","2024-07-03",0,0,0,0,0,0,0,0
"Denmark","2024-07-04",0,0,0,0,0,0,0,0
"Denmark","2024-07-05",0,0,0,0,0,0,0,0
"Denmark","2024-07-06",0,0,0,0,0,0,0,0
"Denmark","2024-07-07",0,0,0,0,0,0,0,0
"Denmark","2024-07-08",0,0,0,0,0,0,0,0
"Denmark","2024-07-09",0,0,0,0,0,0,0,0
"Denmark","2024-07-10",0,0,0,0,0,0,0,0
"Denmark","2024-07-11",0,0,0,0,0,0,0,0
"Denmark","2024-07-12",0,0,0,0,0,0,0,0
"Denmark","2024-07-13",0,0,0,0,0,0,0,0
"Denmark","2024-07-14",0,0,0,0,0,0,0,0
"Denmark","2024-07-15",0,0,0,0,0,0,0,0
"Denmark","2024-07-16",0,0,0,0,0,0,0,0
"Denmark","2024-07-17",0,0,0,0,0,0,0,0
"Denmark","2024-07-18",0,0,0,0,0,0,0,0
"Denmark","2024-07-19",0,0,0,0,0,0,0,0
"Denmark","2024-07-20",0,0,0,0,0,0,0,0
"Denmark","2024-07-21",0,0,0,0,0,0,0,0
"Denmark","2024-07-22",0,0,0,0,0,0,0,0
"Denmark","2024-07-23",0,0,0,0,0,0,0,0
"Denmark","2024-07-24",0,0,0,0,0,0,0,0
"Denmark","2024-07-25",0,0,0,0,0,0,0,0
"Denmark","2024-07-26",0,0,0,0,0,0,0,0
"Denmark","2024-07-27",0,0,0,0,0,0,0,0
"Denmark","2024-07-28",0,0,0,0,0,0,0,0
"Denmark","2024-07-29",0,0,0,0,0,0,0,0
"Denmark","2024-07-30",0,0,0,0,0,0,0,0
"Denmark","2024-07-31",0,5,5,0,5,5,0,0
"Denmark","2024-08-01",0,0,5,0,0,5,0,0
"Denmark","2024-08-02",0,0,5,0,0,5,0,0
"Denmark","2024-08-03",0,0,5,0,0,5,0,0
"Denmark","2024-08-04",0,0,5,0,0,5,0,0
"Denmark","2024-08-05",0,0,5,0,0,5,0,0
"Denmark","2024-08-06",0,0,5,0,0,5,0,0
"Denmark","2024-08-07",0,0,5,0,0,5,0,0
"Denmark","2024-08-08",0,0,5,0,0,5,0,0
"Denmark","2024-08-09",0,0,5,0,0,5,0,0
"Denmark","2024-08-10",0,0,5,0,0,5,0,0
"Denmark","2024-08-11",0,0,5,0,0,5,0,0
"Denmark","2024-08-12",0,0,5,0,0,5,0,0
"Denmark","2024-08-13",0,0,5,0,0,5,0,0
"Denmark","2024-08-14",0,0,5,0,0,5,0,0
"Denmark","2024-08-15",0,0,5,0,0,5,0,0
"Denmark","2024-08-16",0,0,5,0,1,6,0,0
"Denmark","2024-08-17",0,0,5,0,0,6,0,0
"Denmark","2024-08-18",0,0,5,0,0,6,0,0
"Denmark","2024-08-19",0,0,5,0,0,6,0,0
"Denmark","2024-08-20",0,0,5,0,0,6,0,0
"Denmark","2024-08-21",0,0,5,0,0,6,0,0
"Denmark","2024-08-22",0,0,5,0,0,6,0,0
"Denmark","2024-08-23",0,0,5,0,0,6,0,0
"Denmark","2024-08-24",0,0,5,0,0,6,0,0
"Denmark","2024-08-25",0,0,5,0,0,6,0,0
"Denmark","2024-08-26",0,0,5,0,0,6,0,0
"Denmark","2024-08-27",0,0,5,0,0,6,0,0
"Denmark","2024-08-28",0,0,5,0,0,6,0,0
"Denmark","2024-08-29",0,0,5,0,0,6,0,0
"Denmark","2024-08-30",0,0,5,0,0,6,0,0
"Denmark","2024-08-31",0,1,6,0,0,6,0,0
"Denmark","2024-09-01",0,0,6,0,0,6,0,0
"Denmark","2024-09-02",0,0,6,0,0,6,0,0
"Denmark","2024-09-03",0,0,6,0,0,6,0,0
"Denmark","2024-09-04",0,0,6,0,1,7,0,0
"Denmark","2024-09-05",0,0,6,0,0,7,0,0
"Denmark","2024-09-06",0,0,6,0,0,7,0,0
"Denmark","2024-09-07",0,0,6,0,0,7,0,0
"Denmark","2024-09-08",0,0,6,0,0,7,0,0
"Denmark","2024-09-09",0,0,6,0,1,8,0,0
"Denmark","2024-09-10",0,0,6,0,0,8,0,0
"Denmark","2024-09-11",0,0,6,0,0,8,0,0
"Denmark","2024-09-12",0,0,6,0,0,8,0,0
"Denmark","2024-09-13",0,0,6,0,0,8,0,0
"Denmark","2024-09-14",0,0,6,0,0,8,0,0
"Denmark","2024-09-15",0,0,6,0,0,8,0,0
"Denmark","2024-09-16",0,0,6,0,1,9,0,0
"Denmark","2024-09-17",0,0,6,0,0,9,0,0
"Denmark","2024-09-18",0,0,6,0,0,9,0,0
"Denmark","2024-09-19",0,0,6,0,0,9,0,0
"Denmark","2024-09-20",0,0,6,0,0,9,0,0
"Denmark","2024-09-21",0,0,6,0,1,10,0,0
"Denmark","2024-09-22",0,0,6,0,0,10,0,0
"Denmark","2024-09-23",0,0,6,0,0,10,0,0
"Denmark","2024-09-24",0,0,6,0,0,10,0,0
"Denmark","2024-09-25",0,0,6,0,0,10,0,0
"Denmark","2024-09-26",0,0,6,0,0,10,0,0
"Denmark","2024-09-27",0,0,6,0,0,10,0,0
"Denmark","2024-09-28",0,0,6,0,1,11,0,0
"Denmark","2024-09-29",0,0,6,0,0,11,0,0
"Denmark","2024-09-30",0,5,11,0,0,11,0,0
"Denmark","2024-10-01",0,0,11,0,0,11,0,0
"Denmark","2024-10-02",0,0,11,0,0,11,0,0
"Denmark","2024-10-03",0,0,11,0,0,11,0,0
"Denmark","2024-10-04",0,0,11,0,0,11,0,0
"Denmark","2024-10-05",0,0,11,0,0,11,0,0
"Denmark","2024-10-06",0,0,11,0,0,11,0,0
"Denmark","2024-10-07",0,0,11,0,0,11,0,0
"Denmark","2024-10-08",0,0,11,0,0,11,0,0
"Denmark","2024-10-09",0,0,11,0,0,11,0,0
"Denmark","2024-10-10",0,0,11,0,0,11,0,0
"Denmark","2024-10-11",0,0,11,0,0,11,0,0
"Denmark","2024-10-12",0,0,11,0,0,11,0,0
"Denmark","2024-10-13",0,0,11,0,0,11,0,0
"Denmark","2024-10-14",0,0,11,0,0,11,0,0
"Denmark","2024-10-15",0,0,11,0,0,11,0,0
"Denmark","2024-10-16",0,0,11,0,0,11,0,0
"Denmark","2024-10-17",0,0,11,0,0,11,0,0
"Denmark","2024-10-18",0,0,11,0,0,11,0,0
"Denmark","2024-10-19",0,0,11,0,0,11,0,0
"Denmark","2024-10-20",0,0,11,0,0,11,0,0
"Denmark","2024-10-21",0,0,11,0,0,11,0,0
"Denmark","2024-10-22",0,0,11,0,0,11,0,0
"Denmark","2024-10-23",0,0,11,0,0,11,0,0
"Denmark","2024-10-24",0,0,11,0,0,11,0,0
"Denmark","2024-10-25",0,0,11,0,0,11,0,0
"Denmark","2024-10-26",0,0,11,0,0,11,0,0
"Denmark","2024-10-27",0,0,11,0,0,11,0,0
"Denmark","2024-10-28",0,0,11,0,0,11,0,0
"Denmark","2024-10-29",0,0,11,0,0,11,0,0
"Denmark","2024-10-30",0,0,11,0,0,11,0,0
"Denmark","2024-10-31",0,0,11,0,0,11,0,0
"Denmark","2024-11-01",0,0,11,0,0,11,0,0
"Denmark","2024-11-02",0,0,11,0,0,11,0,0
"Denmark","2024-11-03",0,0,11,0,0,11,0,0
"Denmark","2024-11-04",0,0,11,0,0,11,0,0
"Denmark","2024-11-05",0,0,11,0,0,11,0,0
"Denmark","2024-11-06",0,0,11,0,0,11,0,0
"Denmark","2024-11-07",0,0,11,0,0,11,0,0
"Denmark","2024-11-08",0,0,11,0,0,11,0,0
"Denmark","2024-11-09",0,0,11,0,0,11,0,0
"Denmark","2024-11-10",0,0,11,0,0,11,0,0
"Denmark","2024-11-11",0,0,11,0,0,11,0,0
"Denmark","2024-11-12",0,0,11,0,0,11,0,0
"Denmark","2024-11-13",0,0,11,0,0,11,0,0
"Denmark","2024-11-14",0,0,11,0,0,11,0,0
"Denmark","2024-11-15",0,0,11,0,0,11,0,0
"Denmark","2024-11-16",0,0,11,0,0,11,0,0
"Denmark","2024-11-17",0,0,11,0,0,11,0,0
"Denmark","2024-11-18",0,0,11,0,0,11,0,0
"Denmark","2024-11-19",0,0,11,0,0,11,0,0
"Denmark","2024-11-20",0,0,11,0,0,11,0,0
"Denmark","2024-11-21",0,0,11,0,0,11,0,0
"Denmark","2024-11-22",0,0,11,0,0,11,0,0
"Denmark","2024-11-23",0,0,11,0,0,11,0,0
"Denmark","2024-11-24",0,0,11,0,0,11,0,0
"Denmark","2024-11-25",0,0,11,0,0,11,0,0
"Denmark","2024-11-26",0,0,11,0,0,11,0,0
"Denmark","2024-11-27",0,0,11,0,0,11,0,0
"Denmark","2024-11-28",0,0,11,0,0,11,0,0
"Denmark","2024-11-29",0,0,11,0,0,11,0,0
"Denmark","2024-11-30",0,0,11,0,0,11,0,0
"Denmark","2024-12-01",0,0,11,0,0,11,0,0
"Denmark","2024-12-02",0,0,11,0,0,11,0,0
"Denmark","2024-12-03",0,0,11,0,0,11,0,0
"Denmark","2024-12-04",0,0,11,0,0,11,0,0
"Denmark","2024-12-05",0,0,11,0,0,11,0,0
"Denmark","2024-12-06",0,0,11,0,0,11,0,0
"Denmark","2024-12-07",0,0,11,0,0,11,0,0
"Denmark","2024-12-08",0,0,11,0,0,11,0,0
"Denmark","2024-12-09",0,0,11,0,0,11,0,0
"Denmark","2024-12-10",0,0,11,0,0,11,0,0
"Denmark","2024-12-11",0,0,11,0,0,11,0,0
"Denmark","2024-12-12",0,0,11,0,0,11,0,0
"Denmark","2024-12-13",0,0,11,0,0,11,0,0
"Denmark","2024-12-14",0,0,11,0,0,11,0,0
"Denmark","2024-12-15",0,0,11,0,0,11,0,0
"Denmark","2024-12-16",0,0,11,0,0,11,0,0
"Denmark","2024-12-17",0,0,11,0,0,11,0,0
"Denmark","2024-12-18",0,0,11,0,0,11,0,0
"Denmark","2024-12-19",0,0,11,0,0,11,0,0
"Denmark","2024-12-20",0,0,11,0,0,11,0,0
"Denmark","2024-12-21",0,0,11,0,0,11,0,0
"Denmark","2024-12-22",0,0,11,0,0,11,0,0
"Denmark","2024-12-23",0,0,11,0,0,11,0,0
"Denmark","2024-12-24",0,0,11,0,0,11,0,0
"Denmark","2024-12-25",0,0,11,0,0,11,0,0
"Denmark","2024-12-26",0,0,11,0,0,11,0,0
"Denmark","2024-12-27",0,0,11,0,0,11,0,0
"Denmark","2024-12-28",0,0,11,0,0,11,0,0
"Denmark","2024-12-29",0,0,11,0,0,11,0,0
"Denmark","2024-12-30",0,0,11,0,0,11,0,0
"Denmark","2024-12-31",0,0,11,0,0,11,0,0
"Denmark","2025-01-01",0,0,11,0,0,11,0,0
"Denmark","2025-01-02",0,0,11,0,0,11,0,0
"Denmark","2025-01-03",0,0,11,0,0,11,0,0
"Denmark","2025-01-04",0,0,11,0,0,11,0,0
"Denmark","2025-01-05",0,0,11,0,0,11,0,0
"Denmark","2025-01-06",0,0,11,0,0,11,0,0
"Denmark","2025-01-07",0,0,11,0,0,11,0,0
"Denmark","2025-01-08",0,0,11,0,0,11,0,0
"Denmark","2025-01-09",0,0,11,0,0,11,0,0
"Denmark","2025-01-10",0,0,11,0,0,11,0,0
"Denmark","2025-01-11",0,0,11,0,0,11,0,0
"Denmark","2025-01-12",0,0,11,0,0,11,0,0
"Denmark","2025-01-13",0,0,11,0,0,11,0,0
"Dominican Republic","2024-01-01",0,0,0,0,0,0,0,0
"Dominican Republic","2024-01-02",0,0,0,0,0,0,0,0
"Dominican Republic","2024-01-03",0,0,0,0,0,0,0,0
"Dominican Republic","2024-01-04",0,0,0,0,0,0,0,0
"Dominican Republic","2024-01-05",0,0,0,0,0,0,0,0
"Dominican Republic","2024-01-06",0,0,0,0,0,0,0,0
"Dominican Republic","2024-01-07",0,0,0,0,0,0,0,0
"Dominican Republic","2024-01-08",0,0,0,0,0,0,0,0
"Dominican Republic","2024-01-09",0,0,0,0,0,0,0,0
"Dominican Republic","2024-01-10",0,0,0,0,0,0,0,0
"Dominican Republic","2024-01-11",0,0,0,0,0,0,0,0
"Dominican Republic","2024-01-12",0,0,0,0,0,0,0,0
"Dominican Republic","2024-01-13",0,0,0,0,0,0,0,0
"Dominican Republic","2024-01-14",0,0,0,0,0,0,0,0
"Dominican Republic","2024-01-15",0,0,0,0,0,0,0,0
"Dominican Republic","2024-01-16",0,0,0,0,0,0,0,0
"Dominican Republic","2024-01-17",0,0,0,0,0,0,0,0
"Dominican Republic","2024-01-18",0,0,0,0,0,0,0,0
"Dominican Republic","2024-01-19",0,0,0,0,0,0,0,0
"Dominican Republic","2024-01-20",0,0,0,0,0,0,0,0
"Dominican Republic","2024-01-21",0,0,0,0,0,0,0,0
"Dominican Republic","2024-01-22",0,0,0,0,0,0,0,0
"Dominican Republic","2024-01-23",0,0,0,0,0,0,0,0
"Dominican Republic","2024-01-24",0,0,0,0,0,0,0,0
"Dominican Republic","2024-01-25",0,0,0,0,0,0,0,0
"Dominican Republic","2024-01-26",0,0,0,0,0,0,0,0
"Dominican Republic","2024-01-27",0,0,0,0,0,0,0,0
"Dominican Republic","2024-01-28",0,0,0,0,0,0,0,0
"Dominican Republic","2024-01-29",0,0,0,0,0,0,0,0
"Dominican Republic","2024-01-30",0,0,0,0,0,0,0,0
"Dominican Republic","2024-01-31",0,0,0,0,0,0,0,0
"Dominican Republic","2024-02-01",0,0,0,0,0,0,0,0
"Dominican Republic","2024-02-02",0,0,0,0,0,0,0,0
"Dominican Republic","2024-02-03",0,0,0,0,0,0,0,0
"Dominican Republic","2024-02-04",0,0,0,0,0,0,0,0
"Dominican Republic","2024-02-05",0,0,0,0,0,0,0,0
"Dominican Republic","2024-02-06",0,0,0,0,0,0,0,0
"Dominican Republic","2024-02-07",0,0,0,0,0,0,0,0
"Dominican Republic","2024-02-08",0,0,0,0,0,0,0,0
"Dominican Republic","2024-02-09",0,0,0,0,0,0,0,0
"Dominican Republic","2024-02-10",0,0,0,0,0,0,0,0
"Dominican Republic","2024-02-11",0,0,0,0,0,0,0,0
"Dominican Republic","2024-02-12",0,0,0,0,0,0,0,0
"Dominican Republic","2024-02-13",0,0,0,0,0,0,0,0
"Dominican Republic","2024-02-14",0,0,0,0,0,0,0,0
"Dominican Republic","2024-02-15",0,0,0,0,0,0,0,0
"Dominican Republic","2024-02-16",0,0,0,0,0,0,0,0
"Dominican Republic","2024-02-17",0,0,0,0,0,0,0,0
"Dominican Republic","2024-02-18",0,0,0,0,0,0,0,0
"Dominican Republic","2024-02-19",0,0,0,0,0,0,0,0
"Dominican Republic","2024-02-20",0,2,2,0,2,2,0,0
"Dominican Republic","2024-02-21",0,0,2,0,0,2,0,0
"Dominican Republic","2024-02-22",0,0,2,0,1,3,0,0
"Dominican Republic","2024-02-23",0,0,2,0,0,3,0,0
"Dominican Republic","2024-02-24",0,0,2,0,0,3,0,0
"Dominican Republic","2024-02-25",0,0,2,0,0,3,0,0
"Dominican Republic","2024-02-26",0,0,2,0,1,4,0,0
"Dominican Republic","2024-02-27",0,2,4,0,0,4,0,0
"Dominican Republic","2024-02-28",0,0,4,0,0,4,0,0
"Dominican Republic","2024-02-29",0,0,4,0,0,4,0,0
"Dominican Republic","2024-03-01",0,0,4,0,0,4,0,0
"Dominican Republic","2024-03-02",0,0,4,0,0,4,0,0
"Dominican Republic","2024-03-03",0,0,4,0,0,4,0,0
"Dominican Republic","2024-03-04",0,0,4,0,0,4,0,0
"Dominican Republic","2024-03-05",0,0,4,0,0,4,0,0
"Dominican Republic","2024-03-06",0,0,4,0,1,5,0,0
"Dominican Republic","2024-03-07",0,0,4,0,0,5,0,0
"Dominican Republic","2024-03-08",0,0,4,0,0,5,0,0
"Dominican Republic","2024-03-09",0,0,4,0,0,5,0,0
"Dominican Republic","2024-03-10",0,0,4,0,0,5,0,0
"Dominican Republic","2024-03-11",0,0,4,0,0,5,0,0
"Dominican Republic","2024-03-12",0,1,5,0,0,5,0,0
"Dominican Republic","2024-03-13",0,0,5,0,0,5,0,0
"Dominican Republic","2024-03-14",0,0,5,0,0,5,0,0
"Dominican Republic","2024-03-15",0,0,5,0,0,5,0,0
"Dominican Republic","2024-03-16",0,0,5,0,1,6,0,0
"Dominican Republic","2024-03-17",0,0,5,0,0,6,0,0
"Dominican Republic","2024-03-18",0,0,5,0,0,6,0,0
"Dominican Republic","2024-03-19",0,1,6,0,0,6,0,0
"Dominican Republic","2024-03-20",0,0,6,0,0,6,0,0
"Dominican Republic","2024-03-21",0,0,6,0,0,6,0,0
"Dominican Republic","2024-03-22",0,0,6,0,0,6,0,0
"Dominican Republic","2024-03-23",0,0,6,0,0,6,0,0
"Dominican Republic","2024-03-24",0,0,6,0,0,6,0,0
"Dominican Republic","2024-03-25",0,0,6,0,0,6,0,0
"Dominican Republic","2024-03-26",0,0,6,0,0,6,0,0
"Dominican Republic","2024-03-27",0,0,6,0,0,6,0,0
"Dominican Republic","2024-03-28",0,0,6,0,0,6,0,0
"Dominican Republic","2024-03-29",0,0,6,0,0,6,0,0
"Dominican Republic","2024-03-30",0,0,6,0,0,6,0,0
"Dominican Republic","2024-03-31",0,0,6,0,0,6,0,0
"Dominican Republic","2024-04-01",0,0,6,0,0,6,0,0
"Dominican Republic","2024-04-02",0,0,6,0,0,6,0,0
"Dominican Republic","2024-04-03",0,0,6,0,1,7,0,0
"Dominican Republic","2024-04-04",0,0,6,0,0,7,0,0
"Dominican Republic","2024-04-05",0,0,6,0,0,7,0,0
"Dominican Republic","2024-04-06",0,0,6,0,0,7,0,0
"Dominican Republic","2024-04-07",0,0,6,0,0,7,0,0
"Dominican Republic","2024-04-08",0,0,6,0,0,7,0,0
"Dominican Republic","2024-04-09",0,0,6,0,0,7,0,0
"Dominican Republic","2024-04-10",0,0,6,0,0,7,0,0
"Dominican Republic","2024-04-11",0,0,6,0,0,7,0,0
"Dominican Republic","2024-04-12",0,0,6,0,0,7,0,0
"Dominican Republic","2024-04-13",0,0,6,0,0,7,0,0
"Dominican Republic","2024-04-14",0,0,6,0,0,7,0,0
"Dominican Republic","2024-04-15",0,0,6,0,0,7,0,0
"Dominican Republic","2024-04-16",0,1,7,0,0,7,0,0
"Dominican Republic","2024-04-17",0,0,7,0,0,7,0,0
"Dominican Republic","2024-04-18",0,0,7,0,0,7,0,0
"Dominican Republic","2024-04-19",0,0,7,0,0,7,0,0
"Dominican Republic","2024-04-20",0,0,7,0,1,8,0,0
"Dominican Republic","2024-04-21",0,0,7,0,0,8,0,0
"Dominican Republic","2024-04-22",0,0,7,0,0,8,0,0
"Dominican Republic","2024-04-23",0,1,8,0,0,8,0,0
"Dominican Republic","2024-04-24",0,0,8,0,0,8,0,0
"Dominican Republic","2024-04-25",0,0,8,0,0,8,0,0
"Dominican Republic","2024-04-26",0,0,8,0,0,8,0,0
"Dominican Republic","2024-04-27",0,0,8,0,0,8,0,0
"Dominican Republic","2024-04-28",0,0,8,0,0,8,0,0
"Dominican Republic","2024-04-29",0,0,8,0,0,8,0,0
"Dominican Republic","2024-04-30",0,0,8,0,0,8,0,0
"Dominican Republic","2024-05-01",0,0,8,0,0,8,0,0
"Dominican Republic","2024-05-02",0,0,8,0,0,8,0,0
"Dominican Republic","2024-05-03",0,0,8,0,0,8,0,0
"Dominican Republic","2024-05-04",0,0,8,0,0,8,0,0
"Dominican Republic","2024-05-05",0,0,8,0,0,8,0,0
"Dominican Republic","2024-05-06",0,0,8,0,0,8,0,0
"Dominican Republic","2024-05-07",0,0,8,0,0,8,0,0
"Dominican Republic","2024-05-08",0,0,8,0,0,8,0,0
"Dominican Republic","2024-05-09",0,0,8,0,0,8,0,0
"Dominican Republic","2024-05-10",0,0,8,0,0,8,0,0
"Dominican Republic","2024-05-11",0,0,8,0,0,8,0,0
"Dominican Republic","2024-05-12",0,0,8,0,0,8,0,0
"Dominican Republic","2024-05-13",0,0,8,0,0,8,0,0
"Dominican Republic","2024-05-14",0,0,8,0,0,8,0,0
"Dominican Republic","2024-05-15",0,0,8,0,0,8,0,0
"Dominican Republic","2024-05-16",0,0,8,0,0,8,0,0
"Dominican Republic","2024-05-17",0,0,8,0,0,8,0,0
"Dominican Republic","2024-05-18",0,0,8,0,0,8,0,0
"Dominican Republic","2024-05-19",0,0,8,0,0,8,0,0
"Dominican Republic","2024-05-20",0,0,8,0,0,8,0,0
"Dominican Republic","2024-05-21",0,0,8,0,0,8,0,0
"Dominican Republic","2024-05-22",0,0,8,0,0,8,0,0
"Dominican Republic","2024-05-23",0,0,8,0,0,8,0,0
"Dominican Republic","2024-05-24",0,0,8,0,0,8,0,0
"Dominican Republic","2024-05-25",0,0,8,0,0,8,0,0
"Dominican Republic","2024-05-26",0,0,8,0,0,8,0,0
"Dominican Republic","2024-05-27",0,0,8,0,0,8,0,0
"Dominican Republic","2024-05-28",0,0,8,0,0,8,0,0
"Dominican Republic","2024-05-29",0,0,8,0,0,8,0,0
"Dominican Republic","2024-05-30",0,0,8,0,0,8,0,0
"Dominican Republic","2024-05-31",0,0,8,0,0,8,0,0
"Dominican Republic","2024-06-01",0,0,8,0,0,8,0,0
"Dominican Republic","2024-06-02",0,0,8,0,0,8,0,0
"Dominican Republic","2024-06-03",0,0,8,0,0,8,0,0
"Dominican Republic","2024-06-04",0,0,8,0,0,8,0,0
"Dominican Republic","2024-06-05",0,0,8,0,0,8,0,0
"Dominican Republic","2024-06-06",0,0,8,0,0,8,0,0
"Dominican Republic","2024-06-07",0,0,8,0,0,8,0,0
"Dominican Republic","2024-06-08",0,0,8,0,0,8,0,0
"Dominican Republic","2024-06-09",0,0,8,0,0,8,0,0
"Dominican Republic","2024-06-10",0,0,8,0,0,8,0,0
"Dominican Republic","2024-06-11",0,0,8,0,0,8,0,0
"Dominican Republic","2024-06-12",0,0,8,0,0,8,0,0
"Dominican Republic","2024-06-13",0,0,8,0,0,8,0,0
"Dominican Republic","2024-06-14",0,0,8,0,0,8,0,0
"Dominican Republic","2024-06-15",0,0,8,0,0,8,0,0
"Dominican Republic","2024-06-16",0,0,8,0,0,8,0,0
"Dominican Republic","2024-06-17",0,0,8,0,0,8,0,0
"Dominican Republic","2024-06-18",0,0,8,0,0,8,0,0
"Dominican Republic","2024-06-19",0,0,8,0,0,8,0,0
"Dominican Republic","2024-06-20",0,0,8,0,0,8,0,0
"Dominican Republic","2024-06-21",0,0,8,0,0,8,0,0
"Dominican Republic","2024-06-22",0,0,8,0,0,8,0,0
"Dominican Republic","2024-06-23",0,0,8,0,0,8,0,0
"Dominican Republic","2024-06-24",0,0,8,0,0,8,0,0
"Dominican Republic","2024-06-25",0,0,8,0,0,8,0,0
"Dominican Republic","2024-06-26",0,0,8,0,0,8,0,0
"Dominican Republic","2024-06-27",0,0,8,0,0,8,0,0
"Dominican Republic","2024-06-28",0,0,8,0,0,8,0,0
"Dominican Republic","2024-06-29",0,0,8,0,0,8,0,0
"Dominican Republic","2024-06-30",0,0,8,0,0,8,0,0
"Dominican Republic","2024-07-01",0,0,8,0,0,8,0,0
"Dominican Republic","2024-07-02",0,0,8,0,0,8,0,0
"Dominican Republic","2024-07-03",0,0,8,0,0,8,0,0
"Dominican Republic","2024-07-04",0,0,8,0,0,8,0,0
"Dominican Republic","2024-07-05",0,0,8,0,0,8,0,0
"Dominican Republic","2024-07-06",0,0,8,0,0,8,0,0
"Dominican Republic","2024-07-07",0,0,8,0,0,8,0,0
"Dominican Republic","2024-07-08",0,0,8,0,0,8,0,0
"Dominican Republic","2024-07-09",0,0,8,0,0,8,0,0
"Dominican Republic","2024-07-10",0,0,8,0,0,8,0,0
"Dominican Republic","2024-07-11",0,0,8,0,0,8,0,0
"Dominican Republic","2024-07-12",0,0,8,0,0,8,0,0
"Dominican Republic","2024-07-13",0,0,8,0,0,8,0,0
"Dominican Republic","2024-07-14",0,0,8,0,0,8,0,0
"Dominican Republic","2024-07-15",0,0,8,0,0,8,0,0
"Dominican Republic","2024-07-16",0,0,8,0,0,8,0,0
"Dominican Republic","2024-07-17",0,0,8,0,0,8,0,0
"Dominican Republic","2024-07-18",0,0,8,0,0,8,0,0
"Dominican Republic","2024-07-19",0,0,8,0,0,8,0,0
"Dominican Republic","2024-07-20",0,0,8,0,0,8,0,0
"Dominican Republic","2024-07-21",0,0,8,0,0,8,0,0
"Dominican Republic","2024-07-22",0,0,8,0,0,8,0,0
"Dominican Republic","2024-07-23",0,0,8,0,0,8,0,0
"Dominican Republic","2024-07-24",0,0,8,0,0,8,0,0
"Dominican Republic","2024-07-25",0,0,8,0,0,8,0,0
"Dominican Republic","2024-07-26",0,0,8,0,0,8,0,0
"Dominican Republic","2024-07-27",0,0,8,0,0,8,0,0
"Dominican Republic","2024-07-28",0,0,8,0,0,8,0,0
"Dominican Republic","2024-07-29",0,0,8,0,0,8,0,0
"Dominican Republic","2024-07-30",0,0,8,0,0,8,0,0
"Dominican Republic","2024-07-31",0,0,8,0,0,8,0,0
"Dominican Republic","2024-08-01",0,0,8,0,0,8,0,0
"Dominican Republic","2024-08-02",0,0,8,0,0,8,0,0
"Dominican Republic","2024-08-03",0,0,8,0,0,8,0,0
"Dominican Republic","2024-08-04",0,0,8,0,0,8,0,0
"Dominican Republic","2024-08-05",0,0,8,0,0,8,0,0
"Dominican Republic","2024-08-06",0,0,8,0,0,8,0,0
"Dominican Republic","2024-08-07",0,0,8,0,0,8,0,0
"Dominican Republic","2024-08-08",0,0,8,0,0,8,0,0
"Dominican Republic","2024-08-09",0,0,8,0,0,8,0,0
"Dominican Republic","2024-08-10",0,0,8,0,0,8,0,0
"Dominican Republic","2024-08-11",0,0,8,0,0,8,0,0
"Dominican Republic","2024-08-12",0,0,8,0,0,8,0,0
"Dominican Republic","2024-08-13",0,0,8,0,0,8,0,0
"Dominican Republic","2024-08-14",0,0,8,0,0,8,0,0
"Dominican Republic","2024-08-15",0,0,8,0,0,8,0,0
"Dominican Republic","2024-08-16",0,0,8,0,0,8,0,0
"Dominican Republic","2024-08-17",0,0,8,0,0,8,0,0
"Dominican Republic","2024-08-18",0,0,8,0,0,8,0,0
"Dominican Republic","2024-08-19",0,0,8,0,0,8,0,0
"Dominican Republic","2024-08-20",0,0,8,0,0,8,0,0
"Dominican Republic","2024-08-21",0,0,8,0,0,8,0,0
"Dominican Republic","2024-08-22",0,0,8,0,0,8,0,0
"Dominican Republic","2024-08-23",0,0,8,0,0,8,0,0
"Dominican Republic","2024-08-24",0,0,8,0,0,8,0,0
"Dominican Republic","2024-08-25",0,0,8,0,0,8,0,0
"Dominican Republic","2024-08-26",0,0,8,0,0,8,0,0
"Dominican Republic","2024-08-27",0,0,8,0,0,8,0,0
"Dominican Republic","2024-08-28",0,0,8,0,0,8,0,0
"Dominican Republic","2024-08-29",0,0,8,0,0,8,0,0
"Dominican Republic","2024-08-30",0,0,8,0,0,8,0,0
"Dominican Republic","2024-08-31",0,0,8,0,0,8,0,0
"Dominican Republic","2024-09-01",0,0,8,0,0,8,0,0
"Dominican Republic","2024-09-02",0,0,8,0,0,8,0,0
"Dominican Republic","2024-09-03",0,0,8,0,0,8,0,0
"Dominican Republic","2024-09-04",0,0,8,0,0,8,0,0
"Dominican Republic","2024-09-05",0,0,8,0,0,8,0,0
"Dominican Republic","2024-09-06",0,0,8,0,0,8,0,0
"Dominican Republic","2024-09-07",0,0,8,0,0,8,0,0
"Dominican Republic","2024-09-08",0,0,8,0,0,8,0,0
"Dominican Republic","2024-09-09",0,0,8,0,0,8,0,0
"Dominican Republic","2024-09-10",0,0,8,0,0,8,0,0
"Dominican Republic","2024-09-11",0,0,8,0,0,8,0,0
"Dominican Republic","2024-09-12",0,0,8,0,0,8,0,0
"Dominican Republic","2024-09-13",0,0,8,0,0,8,0,0
"Dominican Republic","2024-09-14",0,0,8,0,0,8,0,0
"Dominican Republic","2024-09-15",0,0,8,0,0,8,0,0
"Dominican Republic","2024-09-16",0,0,8,0,0,8,0,0
"Dominican Republic","2024-09-17",0,0,8,0,0,8,0,0
"Dominican Republic","2024-09-18",0,0,8,0,0,8,0,0
"Dominican Republic","2024-09-19",0,0,8,0,0,8,0,0
"Dominican Republic","2024-09-20",0,0,8,0,0,8,0,0
"Dominican Republic","2024-09-21",0,0,8,0,0,8,0,0
"Dominican Republic","2024-09-22",0,0,8,0,0,8,0,0
"Dominican Republic","2024-09-23",0,0,8,0,0,8,0,0
"Dominican Republic","2024-09-24",0,0,8,0,0,8,0,0
"Dominican Republic","2024-09-25",0,0,8,0,0,8,0,0
"Dominican Republic","2024-09-26",0,0,8,0,0,8,0,0
"Dominican Republic","2024-09-27",0,0,8,0,0,8,0,0
"Dominican Republic","2024-09-28",0,0,8,0,0,8,0,0
"Dominican Republic","2024-09-29",0,0,8,0,0,8,0,0
"Dominican Republic","2024-09-30",0,0,8,0,0,8,0,0
"Dominican Republic","2024-10-01",0,0,8,0,0,8,0,0
"Dominican Republic","2024-10-02",0,0,8,0,0,8,0,0
"Dominican Republic","2024-10-03",0,0,8,0,0,8,0,0
"Dominican Republic","2024-10-04",0,0,8,0,0,8,0,0
"Dominican Republic","2024-10-05",0,0,8,0,0,8,0,0
"Dominican Republic","2024-10-06",0,0,8,0,0,8,0,0
"Dominican Republic","2024-10-07",0,0,8,0,0,8,0,0
"Dominican Republic","2024-10-08",0,0,8,0,0,8,0,0
"Dominican Republic","2024-10-09",0,0,8,0,0,8,0,0
"Dominican Republic","2024-10-10",0,0,8,0,0,8,0,0
"Dominican Republic","2024-10-11",0,0,8,0,0,8,0,0
"Dominican Republic","2024-10-12",0,0,8,0,0,8,0,0
"Dominican Republic","2024-10-13",0,0,8,0,0,8,0,0
"Dominican Republic","2024-10-14",0,0,8,0,0,8,0,0
"Dominican Republic","2024-10-15",0,0,8,0,0,8,0,0
"Dominican Republic","2024-10-16",0,0,8,0,0,8,0,0
"Dominican Republic","2024-10-17",0,0,8,0,0,8,0,0
"Dominican Republic","2024-10-18",0,0,8,0,0,8,0,0
"Dominican Republic","2024-10-19",0,0,8,0,0,8,0,0
"Dominican Republic","2024-10-20",0,0,8,0,0,8,0,0
"Dominican Republic","2024-10-21",0,0,8,0,0,8,0,0
"Dominican Republic","2024-10-22",0,0,8,0,0,8,0,0
"Dominican Republic","2024-10-23",0,0,8,0,0,8,0,0
"Dominican Republic","2024-10-24",0,0,8,0,0,8,0,0
"Dominican Republic","2024-10-25",0,0,8,0,0,8,0,0
"Dominican Republic","2024-10-26",0,0,8,0,0,8,0,0
"Dominican Republic","2024-10-27",0,0,8,0,0,8,0,0
"Dominican Republic","2024-10-28",0,0,8,0,0,8,0,0
"Dominican Republic","2024-10-29",0,0,8,0,0,8,0,0
"Dominican Republic","2024-10-30",0,0,8,0,0,8,0,0
"Dominican Republic","2024-10-31",0,0,8,0,0,8,0,0
"Dominican Republic","2024-11-01",0,0,8,0,0,8,0,0
"Dominican Republic","2024-11-02",0,0,8,0,0,8,0,0
"Dominican Republic","2024-11-03",0,0,8,0,0,8,0,0
"Dominican Republic","2024-11-04",0,0,8,0,0,8,0,0
"Dominican Republic","2024-11-05",0,0,8,0,0,8,0,0
"Dominican Republic","2024-11-06",0,0,8,0,0,8,0,0
"Dominican Republic","2024-11-07",0,0,8,0,0,8,0,0
"Dominican Republic","2024-11-08",0,0,8,0,0,8,0,0
"Dominican Republic","2024-11-09",0,0,8,0,0,8,0,0
"Dominican Republic","2024-11-10",0,0,8,0,0,8,0,0
"Dominican Republic","2024-11-11",0,0,8,0,0,8,0,0
"Dominican Republic","2024-11-12",0,0,8,0,0,8,0,0
"Dominican Republic","2024-11-13",0,0,8,0,0,8,0,0
"Dominican Republic","2024-11-14",0,0,8,0,0,8,0,0
"Dominican Republic","2024-11-15",0,0,8,0,0,8,0,0
"Dominican Republic","2024-11-16",0,0,8,0,0,8,0,0
"Dominican Republic","2024-11-17",0,0,8,0,0,8,0,0
"Dominican Republic","2024-11-18",0,0,8,0,0,8,0,0
"Dominican Republic","2024-11-19",0,0,8,0,0,8,0,0
"Dominican Republic","2024-11-20",0,0,8,0,0,8,0,0
"Dominican Republic","2024-11-21",0,0,8,0,0,8,0,0
"Dominican Republic","2024-11-22",0,0,8,0,0,8,0,0
"Dominican Republic","2024-11-23",0,0,8,0,0,8,0,0
"Dominican Republic","2024-11-24",0,0,8,0,0,8,0,0
"Dominican Republic","2024-11-25",0,0,8,0,0,8,0,0
"Dominican Republic","2024-11-26",0,0,8,0,0,8,0,0
"Dominican Republic","2024-11-27",0,0,8,0,0,8,0,0
"Dominican Republic","2024-11-28",0,0,8,0,0,8,0,0
"Dominican Republic","2024-11-29",0,0,8,0,0,8,0,0
"Dominican Republic","2024-11-30",0,0,8,0,0,8,0,0
"Dominican Republic","2024-12-01",0,0,8,0,0,8,0,0
"Dominican Republic","2024-12-02",0,0,8,0,0,8,0,0
"Dominican Republic","2024-12-03",0,0,8,0,0,8,0,0
"Dominican Republic","2024-12-04",0,0,8,0,0,8,0,0
"Dominican Republic","2024-12-05",0,0,8,0,0,8,0,0
"Dominican Republic","2024-12-06",0,0,8,0,0,8,0,0
"Dominican Republic","2024-12-07",0,0,8,0,0,8,0,0
"Dominican Republic","2024-12-08",0,0,8,0,0,8,0,0
"Dominican Republic","2024-12-09",0,0,8,0,0,8,0,0
"Dominican Republic","2024-12-10",0,0,8,0,0,8,0,0
"Dominican Republic","2024-12-11",0,0,8,0,0,8,0,0
"Dominican Republic","2024-12-12",0,0,8,0,0,8,0,0
"Dominican Republic","2024-12-13",0,0,8,0,0,8,0,0
"Dominican Republic","2024-12-14",0,0,8,0,0,8,0,0
"Dominican Republic","2024-12-15",0,0,8,0,0,8,0,0
"Dominican Republic","2024-12-16",0,0,8,0,0,8,0,0
"Dominican Republic","2024-12-17",0,0,8,0,0,8,0,0
"Dominican Republic","2024-12-18",0,0,8,0,0,8,0,0
"Dominican Republic","2024-12-19",0,0,8,0,0,8,0,0
"Dominican Republic","2024-12-20",0,0,8,0,0,8,0,0
"Dominican Republic","2024-12-21",0,0,8,0,0,8,0,0
"Dominican Republic","2024-12-22",0,0,8,0,0,8,0,0
"Dominican Republic","2024-12-23",0,0,8,0,0,8,0,0
"Dominican Republic","2024-12-24",0,0,8,0,0,8,0,0
"Dominican Republic","2024-12-25",0,0,8,0,0,8,0,0
"Dominican Republic","2024-12-26",0,0,8,0,0,8,0,0
"Dominican Republic","2024-12-27",0,0,8,0,0,8,0,0
"Dominican Republic","2024-12-28",0,0,8,0,0,8,0,0
"Dominican Republic","2024-12-29",0,0,8,0,0,8,0,0
"Dominican Republic","2024-12-30",0,0,8,0,0,8,0,0
"Dominican Republic","2024-12-31",0,0,8,0,0,8,0,0
"Dominican Republic","2025-01-01",0,0,8,0,0,8,0,0
"Dominican Republic","2025-01-02",0,0,8,0,0,8,0,0
"Dominican Republic","2025-01-03",0,0,8,0,0,8,0,0
"Dominican Republic","2025-01-04",0,0,8,0,0,8,0,0
"Dominican Republic","2025-01-05",0,0,8,0,0,8,0,0
"Dominican Republic","2025-01-06",0,0,8,0,0,8,0,0
"Dominican Republic","2025-01-07",0,0,8,0,0,8,0,0
"Dominican Republic","2025-01-08",0,0,8,0,0,8,0,0
"Dominican Republic","2025-01-09",0,0,8,0,0,8,0,0
"Dominican Republic","2025-01-10",0,0,8,0,0,8,0,0
"Dominican Republic","2025-01-11",0,0,8,0,0,8,0,0
"Dominican Republic","2025-01-12",0,0,8,0,0,8,0,0
"Dominican Republic","2025-01-13",0,0,8,0,0,8,0,0
"Ecuador","2024-01-01",0,0,0,0,0,0,0,0
"Ecuador","2024-01-02",0,1,1,0,1,1,0,0
"Ecuador","2024-01-03",0,0,1,0,0,1,0,0
"Ecuador","2024-01-04",0,0,1,0,0,1,0,0
"Ecuador","2024-01-05",0,0,1,0,0,1,0,0
"Ecuador","2024-01-06",0,0,1,0,0,1,0,0
"Ecuador","2024-01-07",0,0,1,0,0,1,0,0
"Ecuador","2024-01-08",0,0,1,0,0,1,0,0
"Ecuador","2024-01-09",0,0,1,0,0,1,0,0
"Ecuador","2024-01-10",0,0,1,0,0,1,0,0
"Ecuador","2024-01-11",0,0,1,0,0,1,0,0
"Ecuador","2024-01-12",0,0,1,0,0,1,0,0
"Ecuador","2024-01-13",0,0,1,0,0,1,0,0
"Ecuador","2024-01-14",0,0,1,0,0,1,0,0
"Ecuador","2024-01-15",0,0,1,0,0,1,0,0
"Ecuador","2024-01-16",0,0,1,0,0,1,0,0
"Ecuador","2024-01-17",0,0,1,0,0,1,0,0
"Ecuador","2024-01-18",0,0,1,0,0,1,0,0
"Ecuador","2024-01-19",0,0,1,0,0,1,0,0
"Ecuador","2024-01-20",0,0,1,0,0,1,0,0
"Ecuador","2024-01-21",0,0,1,0,0,1,0,0
"Ecuador","2024-01-22",0,0,1,0,0,1,0,0
"Ecuador","2024-01-23",0,0,1,0,0,1,0,0
"Ecuador","2024-01-24",0,0,1,0,0,1,0,0
"Ecuador","2024-01-25",0,0,1,0,0,1,0,0
"Ecuador","2024-01-26",0,0,1,0,0,1,0,0
"Ecuador","2024-01-27",0,0,1,0,0,1,0,0
"Ecuador","2024-01-28",0,0,1,0,0,1,0,0
"Ecuador","2024-01-29",0,0,1,0,0,1,0,0
"Ecuador","2024-01-30",0,0,1,0,0,1,0,0
"Ecuador","2024-01-31",0,0,1,0,0,1,0,0
"Ecuador","2024-02-01",0,0,1,0,0,1,0,0
"Ecuador","2024-02-02",0,0,1,0,0,1,0,0
"Ecuador","2024-02-03",0,0,1,0,0,1,0,0
"Ecuador","2024-02-04",0,0,1,0,0,1,0,0
"Ecuador","2024-02-05",0,0,1,0,0,1,0,0
"Ecuador","2024-02-06",0,0,1,0,0,1,0,0
"Ecuador","2024-02-07",0,0,1,0,1,2,0,0
"Ecuador","2024-02-08",0,0,1,0,0,2,0,0
"Ecuador","2024-02-09",0,0,1,0,0,2,0,0
"Ecuador","2024-02-10",0,0,1,0,0,2,0,0
"Ecuador","2024-02-11",0,0,1,0,0,2,0,0
"Ecuador","2024-02-12",0,0,1,0,0,2,0,0
"Ecuador","2024-02-13",0,0,1,0,0,2,0,0
"Ecuador","2024-02-14",0,0,1,0,0,2,0,0
"Ecuador","2024-02-15",0,0,1,0,0,2,0,0
"Ecuador","2024-02-16",0,0,1,0,0,2,0,0
"Ecuador","2024-02-17",0,0,1,0,0,2,0,0
"Ecuador","2024-02-18",0,0,1,0,0,2,0,0
"Ecuador","2024-02-19",0,0,1,0,0,2,0,0
"Ecuador","2024-02-20",0,0,1,0,0,2,0,0
"Ecuador","2024-02-21",0,0,1,0,0,2,0,0
"Ecuador","2024-02-22",0,0,1,0,0,2,0,0
"Ecuador","2024-02-23",0,0,1,0,0,2,0,0
"Ecuador","2024-02-24",0,0,1,0,0,2,0,0
"Ecuador","2024-02-25",0,0,1,0,0,2,0,0
"Ecuador","2024-02-26",0,0,1,0,0,2,0,0
"Ecuador","2024-02-27",0,0,1,0,0,2,0,0
"Ecuador","2024-02-28",0,0,1,0,0,2,0,0
"Ecuador","2024-02-29",0,0,1,0,0,2,0,0
"Ecuador","2024-03-01",0,0,1,0,0,2,0,0
"Ecuador","2024-03-02",0,0,1,0,0,2,0,0
"Ecuador","2024-03-03",0,0,1,0,0,2,0,0
"Ecuador","2024-03-04",0,0,1,0,0,2,0,0
"Ecuador","2024-03-05",0,0,1,0,0,2,0,0
"Ecuador","2024-03-06",0,0,1,0,0,2,0,0
"Ecuador","2024-03-07",0,0,1,0,0,2,0,0
"Ecuador","2024-03-08",0,0,1,0,0,2,0,0
"Ecuador","2024-03-09",0,0,1,0,0,2,0,0
"Ecuador","2024-03-10",0,0,1,0,0,2,0,0
"Ecuador","2024-03-11",0,0,1,0,0,2,0,0
"Ecuador","2024-03-12",0,1,2,0,0,2,0,0
"Ecuador","2024-03-13",0,0,2,0,0,2,0,0
"Ecuador","2024-03-14",0,0,2,0,0,2,0,0
"Ecuador","2024-03-15",0,0,2,0,0,2,0,0
"Ecuador","2024-03-16",0,0,2,0,0,2,0,0
"Ecuador","2024-03-17",0,0,2,0,0,2,0,0
"Ecuador","2024-03-18",0,0,2,0,0,2,0,0
"Ecuador","2024-03-19",0,0,2,0,0,2,0,0
"Ecuador","2024-03-20",0,0,2,0,0,2,0,0
"Ecuador","2024-03-21",0,0,2,0,0,2,0,0
"Ecuador","2024-03-22",0,0,2,0,0,2,0,0
"Ecuador","2024-03-23",0,0,2,0,0,2,0,0
"Ecuador","2024-03-24",0,0,2,0,0,2,0,0
"Ecuador","2024-03-25",0,0,2,0,0,2,0,0
"Ecuador","2024-03-26",0,0,2,0,0,2,0,0
"Ecuador","2024-03-27",0,0,2,0,0,2,0,0
"Ecuador","2024-03-28",0,0,2,0,0,2,0,0
"Ecuador","2024-03-29",0,0,2,0,0,2,0,0
"Ecuador","2024-03-30",0,0,2,0,0,2,0,0
"Ecuador","2024-03-31",0,0,2,0,0,2,0,0
"Ecuador","2024-04-01",0,0,2,0,0,2,0,0
"Ecuador","2024-04-02",0,0,2,0,0,2,0,0
"Ecuador","2024-04-03",0,0,2,0,1,3,0,0
"Ecuador","2024-04-04",0,0,2,0,0,3,0,0
"Ecuador","2024-04-05",0,0,2,0,0,3,0,0
"Ecuador","2024-04-06",0,0,2,0,0,3,0,0
"Ecuador","2024-04-07",0,0,2,0,0,3,0,0
"Ecuador","2024-04-08",0,0,2,0,0,3,0,0
"Ecuador","2024-04-09",0,0,2,0,0,3,0,0
"Ecuador","2024-04-10",0,0,2,0,0,3,0,0
"Ecuador","2024-04-11",0,0,2,0,0,3,0,0
"Ecuador","2024-04-12",0,0,2,0,0,3,0,0
"Ecuador","2024-04-13",0,0,2,0,0,3,0,0
"Ecuador","2024-04-14",0,0,2,0,0,3,0,0
"Ecuador","2024-04-15",0,0,2,0,0,3,0,0
"Ecuador","2024-04-16",0,0,2,0,0,3,0,0
"Ecuador","2024-04-17",0,0,2,0,0,3,0,0
"Ecuador","2024-04-18",0,0,2,0,0,3,0,0
"Ecuador","2024-04-19",0,0,2,0,0,3,0,0
"Ecuador","2024-04-20",0,0,2,0,0,3,0,0
"Ecuador","2024-04-21",0,0,2,0,0,3,0,0
"Ecuador","2024-04-22",0,0,2,0,0,3,0,0
"Ecuador","2024-04-23",0,1,3,0,0,3,0,0
"Ecuador","2024-04-24",0,0,3,0,0,3,0,0
"Ecuador","2024-04-25",0,0,3,0,0,3,0,0
"Ecuador","2024-04-26",0,0,3,0,0,3,0,0
"Ecuador","2024-04-27",0,0,3,0,0,3,0,0
"Ecuador","2024-04-28",0,0,3,0,0,3,0,0
"Ecuador","2024-04-29",0,0,3,0,0,3,0,0
"Ecuador","2024-04-30",0,0,3,0,0,3,0,0
"Ecuador","2024-05-01",0,0,3,0,1,4,0,0
"Ecuador","2024-05-02",0,0,3,0,0,4,0,0
"Ecuador","2024-05-03",0,0,3,0,0,4,0,0
"Ecuador","2024-05-04",0,0,3,0,0,4,0,0
"Ecuador","2024-05-05",0,0,3,0,0,4,0,0
"Ecuador","2024-05-06",0,0,3,0,0,4,0,0
"Ecuador","2024-05-07",0,1,4,0,0,4,0,0
"Ecuador","2024-05-08",0,0,4,0,0,4,0,0
"Ecuador","2024-05-09",0,0,4,0,0,4,0,0
"Ecuador","2024-05-10",0,0,4,0,0,4,0,0
"Ecuador","2024-05-11",0,0,4,0,0,4,0,0
"Ecuador","2024-05-12",0,0,4,0,0,4,0,0
"Ecuador","2024-05-13",0,0,4,0,0,4,0,0
"Ecuador","2024-05-14",0,0,4,0,0,4,0,0
"Ecuador","2024-05-15",0,0,4,0,0,4,0,0
"Ecuador","2024-05-16",0,0,4,0,0,4,0,0
"Ecuador","2024-05-17",0,0,4,0,0,4,0,0
"Ecuador","2024-05-18",0,0,4,0,0,4,0,0
"Ecuador","2024-05-19",0,0,4,0,0,4,0,0
"Ecuador","2024-05-20",0,0,4,0,0,4,0,0
"Ecuador","2024-05-21",0,0,4,0,0,4,0,0
"Ecuador","2024-05-22",0,0,4,0,0,4,0,0
"Ecuador","2024-05-23",0,0,4,0,0,4,0,0
"Ecuador","2024-05-24",0,0,4,0,0,4,0,0
"Ecuador","2024-05-25",0,0,4,0,0,4,0,0
"Ecuador","2024-05-26",0,0,4,0,0,4,0,0
"Ecuador","2024-05-27",0,0,4,0,0,4,0,0
"Ecuador","2024-05-28",0,0,4,0,0,4,0,0
"Ecuador","2024-05-29",0,0,4,0,0,4,0,0
"Ecuador","2024-05-30",0,0,4,0,0,4,0,0
"Ecuador","2024-05-31",0,0,4,0,0,4,0,0
"Ecuador","2024-06-01",0,0,4,0,0,4,0,0
"Ecuador","2024-06-02",0,0,4,0,0,4,0,0
"Ecuador","2024-06-03",0,0,4,0,0,4,0,0
"Ecuador","2024-06-04",0,0,4,0,0,4,0,0
"Ecuador","2024-06-05",0,0,4,0,0,4,0,0
"Ecuador","2024-06-06",0,0,4,0,0,4,0,0
"Ecuador","2024-06-07",0,0,4,0,0,4,0,0
"Ecuador","2024-06-08",0,0,4,0,0,4,0,0
"Ecuador","2024-06-09",0,0,4,0,0,4,0,0
"Ecuador","2024-06-10",0,0,4,0,0,4,0,0
"Ecuador","2024-06-11",0,0,4,0,0,4,0,0
"Ecuador","2024-06-12",0,0,4,0,0,4,0,0
"Ecuador","2024-06-13",0,0,4,0,0,4,0,0
"Ecuador","2024-06-14",0,0,4,0,0,4,0,0
"Ecuador","2024-06-15",0,0,4,0,0,4,0,0
"Ecuador","2024-06-16",0,0,4,0,0,4,0,0
"Ecuador","2024-06-17",0,0,4,0,0,4,0,0
"Ecuador","2024-06-18",0,0,4,0,0,4,0,0
"Ecuador","2024-06-19",0,0,4,0,1,5,0,0
"Ecuador","2024-06-20",0,0,4,0,0,5,0,0
"Ecuador","2024-06-21",0,0,4,0,0,5,0,0
"Ecuador","2024-06-22",0,0,4,0,0,5,0,0
"Ecuador","2024-06-23",0,0,4,0,0,5,0,0
"Ecuador","2024-06-24",0,0,4,0,0,5,0,0
"Ecuador","2024-06-25",0,0,4,0,0,5,0,0
"Ecuador","2024-06-26",0,0,4,0,0,5,0,0
"Ecuador","2024-06-27",0,0,4,0,0,5,0,0
"Ecuador","2024-06-28",0,0,4,0,0,5,0,0
"Ecuador","2024-06-29",0,0,4,0,0,5,0,0
"Ecuador","2024-06-30",0,0,4,0,0,5,0,0
"Ecuador","2024-07-01",0,0,4,0,0,5,0,0
"Ecuador","2024-07-02",0,0,4,0,0,5,0,0
"Ecuador","2024-07-03",0,0,4,0,0,5,0,0
"Ecuador","2024-07-04",0,0,4,0,0,5,0,0
"Ecuador","2024-07-05",0,0,4,0,0,5,0,0
"Ecuador","2024-07-06",0,0,4,0,0,5,0,0
"Ecuador","2024-07-07",0,0,4,0,0,5,0,0
"Ecuador","2024-07-08",0,0,4,0,0,5,0,0
"Ecuador","2024-07-09",0,0,4,0,0,5,0,0
"Ecuador","2024-07-10",0,0,4,0,0,5,0,0
"Ecuador","2024-07-11",0,0,4,0,0,5,0,0
"Ecuador","2024-07-12",0,0,4,0,0,5,0,0
"Ecuador","2024-07-13",0,0,4,0,0,5,0,0
"Ecuador","2024-07-14",0,0,4,0,0,5,0,0
"Ecuador","2024-07-15",0,0,4,0,0,5,0,0
"Ecuador","2024-07-16",0,0,4,0,0,5,0,0
"Ecuador","2024-07-17",0,0,4,0,0,5,0,0
"Ecuador","2024-07-18",0,0,4,0,0,5,0,0
"Ecuador","2024-07-19",0,0,4,0,0,5,0,0
"Ecuador","2024-07-20",0,0,4,0,0,5,0,0
"Ecuador","2024-07-21",0,0,4,0,0,5,0,0
"Ecuador","2024-07-22",0,0,4,0,0,5,0,0
"Ecuador","2024-07-23",0,0,4,0,0,5,0,0
"Ecuador","2024-07-24",0,0,4,0,0,5,0,0
"Ecuador","2024-07-25",0,0,4,0,0,5,0,0
"Ecuador","2024-07-26",0,0,4,0,0,5,0,0
"Ecuador","2024-07-27",0,0,4,0,0,5,0,0
"Ecuador","2024-07-28",0,0,4,0,0,5,0,0
"Ecuador","2024-07-29",0,0,4,0,0,5,0,0
"Ecuador","2024-07-30",0,1,5,0,0,5,0,0
"Ecuador","2024-07-31",0,0,5,0,0,5,0,0
"Ecuador","2024-08-01",0,0,5,0,0,5,0,0
"Ecuador","2024-08-02",0,0,5,0,0,5,0,0
"Ecuador","2024-08-03",0,0,5,0,1,6,0,0
"Ecuador","2024-08-04",0,0,5,0,0,6,0,0
"Ecuador","2024-08-05",0,0,5,0,0,6,0,0
"Ecuador","2024-08-06",0,1,6,0,0,6,0,0
"Ecuador","2024-08-07",0,0,6,0,0,6,0,0
"Ecuador","2024-08-08",0,0,6,0,0,6,0,0
"Ecuador","2024-08-09",0,0,6,0,0,6,0,0
"Ecuador","2024-08-10",0,0,6,0,1,7,0,0
"Ecuador","2024-08-11",0,0,6,0,0,7,0,0
"Ecuador","2024-08-12",0,0,6,0,0,7,0,0
"Ecuador","2024-08-13",0,1,7,0,0,7,0,0
"Ecuador","2024-08-14",0,0,7,0,0,7,0,0
"Ecuador","2024-08-15",0,0,7,0,0,7,0,0
"Ecuador","2024-08-16",0,0,7,0,0,7,0,0
"Ecuador","2024-08-17",0,0,7,0,1,8,0,0
"Ecuador","2024-08-18",0,0,7,0,0,8,0,0
"Ecuador","2024-08-19",0,0,7,0,0,8,0,0
"Ecuador","2024-08-20",0,1,8,0,0,8,0,0
"Ecuador","2024-08-21",0,0,8,0,1,9,0,0
"Ecuador","2024-08-22",0,0,8,0,0,9,0,0
"Ecuador","2024-08-23",0,0,8,0,1,10,0,0
"Ecuador","2024-08-24",0,0,8,0,1,11,0,0
"Ecuador","2024-08-25",0,0,8,0,1,12,0,0
"Ecuador","2024-08-26",0,0,8,0,0,12,0,0
"Ecuador","2024-08-27",0,5,13,0,1,13,0,0
"Ecuador","2024-08-28",0,0,13,0,0,13,0,0
"Ecuador","2024-08-29",0,0,13,0,0,13,0,0
"Ecuador","2024-08-30",0,0,13,0,1,14,0,0
"Ecuador","2024-08-31",0,0,13,0,0,14,0,0
"Ecuador","2024-09-01",0,0,13,0,0,14,0,0
"Ecuador","2024-09-02",0,0,13,0,0,14,0,0
"Ecuador","2024-09-03",0,0,13,0,1,15,0,0
"Ecuador","2024-09-04",0,0,13,0,0,15,0,0
"Ecuador","2024-09-05",0,0,13,0,0,15,0,0
"Ecuador","2024-09-06",0,0,13,0,0,15,0,0
"Ecuador","2024-09-07",0,0,13,0,0,15,0,0
"Ecuador","2024-09-08",0,0,13,0,1,16,0,0
"Ecuador","2024-09-09",0,0,13,0,0,16,0,0
"Ecuador","2024-09-10",0,3,16,0,0,16,0,0
"Ecuador","2024-09-11",0,0,16,0,1,17,0,0
"Ecuador","2024-09-12",0,0,16,0,0,17,0,0
"Ecuador","2024-09-13",0,0,16,0,1,18,0,0
"Ecuador","2024-09-14",0,0,16,0,0,18,0,0
"Ecuador","2024-09-15",0,0,16,0,1,19,0,0
"Ecuador","2024-09-16",0,0,16,0,0,19,0,0
"Ecuador","2024-09-17",0,4,20,0,1,20,0,0
"Ecuador","2024-09-18",0,0,20,0,0,20,0,0
"Ecuador","2024-09-19",0,0,20,0,1,21,0,0
"Ecuador","2024-09-20",0,0,20,0,0,21,0,0
"Ecuador","2024-09-21",0,0,20,0,1,22,0,0
"Ecuador","2024-09-22",0,0,20,0,0,22,0,0
"Ecuador","2024-09-23",0,0,20,0,1,23,0,0
"Ecuador","2024-09-24",0,3,23,0,0,23,0,0
"Ecuador","2024-09-25",0,0,23,0,0,23,0,0
"Ecuador","2024-09-26",0,0,23,0,0,23,0,0
"Ecuador","2024-09-27",0,0,23,0,0,23,0,0
"Ecuador","2024-09-28",0,0,23,0,1,24,0,0
"Ecuador","2024-09-29",0,0,23,0,0,24,0,0
"Ecuador","2024-09-30",0,0,23,0,0,24,0,0
"Ecuador","2024-10-01",0,1,24,0,0,24,0,0
"Ecuador","2024-10-02",0,0,24,0,0,24,0,0
"Ecuador","2024-10-03",0,0,24,0,0,24,0,0
"Ecuador","2024-10-04",0,0,24,0,0,24,0,0
"Ecuador","2024-10-05",0,0,24,0,0,24,0,0
"Ecuador","2024-10-06",0,0,24,0,0,24,0,0
"Ecuador","2024-10-07",0,0,24,0,0,24,0,0
"Ecuador","2024-10-08",0,0,24,0,0,24,0,0
"Ecuador","2024-10-09",0,0,24,0,0,24,0,0
"Ecuador","2024-10-10",0,0,24,0,0,24,0,0
"Ecuador","2024-10-11",0,0,24,0,0,24,0,0
"Ecuador","2024-10-12",0,0,24,0,0,24,0,0
"Ecuador","2024-10-13",0,0,24,0,0,24,0,0
"Ecuador","2024-10-14",0,0,24,0,0,24,0,0
"Ecuador","2024-10-15",0,0,24,0,0,24,0,0
"Ecuador","2024-10-16",0,0,24,0,0,24,0,0
"Ecuador","2024-10-17",0,0,24,0,0,24,0,0
"Ecuador","2024-10-18",0,0,24,0,0,24,0,0
"Ecuador","2024-10-19",0,0,24,0,0,24,0,0
"Ecuador","2024-10-20",0,0,24,0,0,24,0,0
"Ecuador","2024-10-21",0,0,24,0,0,24,0,0
"Ecuador","2024-10-22",0,0,24,0,0,24,0,0
"Ecuador","2024-10-23",0,0,24,0,0,24,0,0
"Ecuador","2024-10-24",0,0,24,0,0,24,0,0
"Ecuador","2024-10-25",0,0,24,0,0,24,0,0
"Ecuador","2024-10-26",0,0,24,0,0,24,0,0
"Ecuador","2024-10-27",0,0,24,0,0,24,0,0
"Ecuador","2024-10-28",0,0,24,0,0,24,0,0
"Ecuador","2024-10-29",0,0,24,0,0,24,0,0
"Ecuador","2024-10-30",0,0,24,0,0,24,0,0
"Ecuador","2024-10-31",0,0,24,0,0,24,0,0
"Ecuador","2024-11-01",0,0,24,0,0,24,0,0
"Ecuador","2024-11-02",0,0,24,0,0,24,0,0
"Ecuador","2024-11-03",0,0,24,0,0,24,0,0
"Ecuador","2024-11-04",0,0,24,0,0,24,0,0
"Ecuador","2024-11-05",0,0,24,0,0,24,0,0
"Ecuador","2024-11-06",0,0,24,0,0,24,0,0
"Ecuador","2024-11-07",0,0,24,0,0,24,0,0
"Ecuador","2024-11-08",0,0,24,0,0,24,0,0
"Ecuador","2024-11-09",0,0,24,0,0,24,0,0
"Ecuador","2024-11-10",0,0,24,0,0,24,0,0
"Ecuador","2024-11-11",0,0,24,0,0,24,0,0
"Ecuador","2024-11-12",0,0,24,0,0,24,0,0
"Ecuador","2024-11-13",0,0,24,0,0,24,0,0
"Ecuador","2024-11-14",0,0,24,0,0,24,0,0
"Ecuador","2024-11-15",0,0,24,0,0,24,0,0
"Ecuador","2024-11-16",0,0,24,0,0,24,0,0
"Ecuador","2024-11-17",0,0,24,0,0,24,0,0
"Ecuador","2024-11-18",0,0,24,0,0,24,0,0
"Ecuador","2024-11-19",0,0,24,0,0,24,0,0
"Ecuador","2024-11-20",0,0,24,0,0,24,0,0
"Ecuador","2024-11-21",0,0,24,0,0,24,0,0
"Ecuador","2024-11-22",0,0,24,0,0,24,0,0
"Ecuador","2024-11-23",0,0,24,0,0,24,0,0
"Ecuador","2024-11-24",0,0,24,0,0,24,0,0
"Ecuador","2024-11-25",0,0,24,0,0,24,0,0
"Ecuador","2024-11-26",0,0,24,0,0,24,0,0
"Ecuador","2024-11-27",0,0,24,0,0,24,0,0
"Ecuador","2024-11-28",0,0,24,0,0,24,0,0
"Ecuador","2024-11-29",0,0,24,0,0,24,0,0
"Ecuador","2024-11-30",0,0,24,0,0,24,0,0
"Ecuador","2024-12-01",0,0,24,0,0,24,0,0
"Ecuador","2024-12-02",0,0,24,0,0,24,0,0
"Ecuador","2024-12-03",0,0,24,0,0,24,0,0
"Ecuador","2024-12-04",0,0,24,0,0,24,0,0
"Ecuador","2024-12-05",0,0,24,0,0,24,0,0
"Ecuador","2024-12-06",0,0,24,0,0,24,0,0
"Ecuador","2024-12-07",0,0,24,0,0,24,0,0
"Ecuador","2024-12-08",0,0,24,0,0,24,0,0
"Ecuador","2024-12-09",0,0,24,0,0,24,0,0
"Ecuador","2024-12-10",0,0,24,0,0,24,0,0
"Ecuador","2024-12-11",0,0,24,0,0,24,0,0
"Ecuador","2024-12-12",0,0,24,0,0,24,0,0
"Ecuador","2024-12-13",0,0,24,0,0,24,0,0
"Ecuador","2024-12-14",0,0,24,0,0,24,0,0
"Ecuador","2024-12-15",0,0,24,0,0,24,0,0
"Ecuador","2024-12-16",0,0,24,0,0,24,0,0
"Ecuador","2024-12-17",0,0,24,0,0,24,0,0
"Ecuador","2024-12-18",0,0,24,0,0,24,0,0
"Ecuador","2024-12-19",0,0,24,0,0,24,0,0
"Ecuador","2024-12-20",0,0,24,0,0,24,0,0
"Ecuador","2024-12-21",0,0,24,0,0,24,0,0
"Ecuador","2024-12-22",0,0,24,0,0,24,0,0
"Ecuador","2024-12-23",0,0,24,0,0,24,0,0
"Ecuador","2024-12-24",0,0,24,0,0,24,0,0
"Ecuador","2024-12-25",0,0,24,0,0,24,0,0
"Ecuador","2024-12-26",0,0,24,0,0,24,0,0
"Ecuador","2024-12-27",0,0,24,0,0,24,0,0
"Ecuador","2024-12-28",0,0,24,0,0,24,0,0
"Ecuador","2024-12-29",0,0,24,0,0,24,0,0
"Ecuador","2024-12-30",0,0,24,0,0,24,0,0
"Ecuador","2024-12-31",0,0,24,0,0,24,0,0
"Ecuador","2025-01-01",0,0,24,0,0,24,0,0
"Ecuador","2025-01-02",0,0,24,0,0,24,0,0
"Ecuador","2025-01-03",0,0,24,0,0,24,0,0
"Ecuador","2025-01-04",0,0,24,0,0,24,0,0
"Ecuador","2025-01-05",0,0,24,0,0,24,0,0
"Ecuador","2025-01-06",0,0,24,0,0,24,0,0
"Ecuador","2025-01-07",0,0,24,0,0,24,0,0
"Ecuador","2025-01-08",0,0,24,0,0,24,0,0
"Ecuador","2025-01-09",0,0,24,0,0,24,0,0
"Ecuador","2025-01-10",0,0,24,0,0,24,0,0
"Ecuador","2025-01-11",0,0,24,0,0,24,0,0
"Ecuador","2025-01-12",0,0,24,0,0,24,0,0
"Ecuador","2025-01-13",0,0,24,0,0,24,0,0
"El Salvador","2024-01-01",0,0,0,0,0,0,0,0
"El Salvador","2024-01-02",0,0,0,0,0,0,0,0
"El Salvador","2024-01-03",0,0,0,0,0,0,0,0
"El Salvador","2024-01-04",0,0,0,0,0,0,0,0
"El Salvador","2024-01-05",0,0,0,0,0,0,0,0
"El Salvador","2024-01-06",0,0,0,0,0,0,0,0
"El Salvador","2024-01-07",0,0,0,0,0,0,0,0
"El Salvador","2024-01-08",0,0,0,0,0,0,0,0
"El Salvador","2024-01-09",0,0,0,0,0,0,0,0
"El Salvador","2024-01-10",0,0,0,0,0,0,0,0
"El Salvador","2024-01-11",0,0,0,0,0,0,0,0
"El Salvador","2024-01-12",0,0,0,0,0,0,0,0
"El Salvador","2024-01-13",0,0,0,0,0,0,0,0
"El Salvador","2024-01-14",0,0,0,0,0,0,0,0
"El Salvador","2024-01-15",0,0,0,0,0,0,0,0
"El Salvador","2024-01-16",0,0,0,0,0,0,0,0
"El Salvador","2024-01-17",0,0,0,0,0,0,0,0
"El Salvador","2024-01-18",0,0,0,0,0,0,0,0
"El Salvador","2024-01-19",0,0,0,0,0,0,0,0
"El Salvador","2024-01-20",0,0,0,0,0,0,0,0
"El Salvador","2024-01-21",0,0,0,0,0,0,0,0
"El Salvador","2024-01-22",0,0,0,0,0,0,0,0
"El Salvador","2024-01-23",0,0,0,0,0,0,0,0
"El Salvador","2024-01-24",0,0,0,0,0,0,0,0
"El Salvador","2024-01-25",0,0,0,0,0,0,0,0
"El Salvador","2024-01-26",0,0,0,0,0,0,0,0
"El Salvador","2024-01-27",0,0,0,0,0,0,0,0
"El Salvador","2024-01-28",0,0,0,0,0,0,0,0
"El Salvador","2024-01-29",0,0,0,0,0,0,0,0
"El Salvador","2024-01-30",0,0,0,0,0,0,0,0
"El Salvador","2024-01-31",0,0,0,0,0,0,0,0
"El Salvador","2024-02-01",0,0,0,0,0,0,0,0
"El Salvador","2024-02-02",0,0,0,0,0,0,0,0
"El Salvador","2024-02-03",0,0,0,0,0,0,0,0
"El Salvador","2024-02-04",0,0,0,0,0,0,0,0
"El Salvador","2024-02-05",0,0,0,0,0,0,0,0
"El Salvador","2024-02-06",0,0,0,0,0,0,0,0
"El Salvador","2024-02-07",0,0,0,0,0,0,0,0
"El Salvador","2024-02-08",0,0,0,0,0,0,0,0
"El Salvador","2024-02-09",0,0,0,0,0,0,0,0
"El Salvador","2024-02-10",0,0,0,0,0,0,0,0
"El Salvador","2024-02-11",0,0,0,0,0,0,0,0
"El Salvador","2024-02-12",0,0,0,0,0,0,0,0
"El Salvador","2024-02-13",0,0,0,0,0,0,0,0
"El Salvador","2024-02-14",0,0,0,0,0,0,0,0
"El Salvador","2024-02-15",0,0,0,0,0,0,0,0
"El Salvador","2024-02-16",0,0,0,0,0,0,0,0
"El Salvador","2024-02-17",0,0,0,0,0,0,0,0
"El Salvador","2024-02-18",0,0,0,0,0,0,0,0
"El Salvador","2024-02-19",0,0,0,0,0,0,0,0
"El Salvador","2024-02-20",0,0,0,0,0,0,0,0
"El Salvador","2024-02-21",0,0,0,0,0,0,0,0
"El Salvador","2024-02-22",0,0,0,0,0,0,0,0
"El Salvador","2024-02-23",0,0,0,0,0,0,0,0
"El Salvador","2024-02-24",0,0,0,0,0,0,0,0
"El Salvador","2024-02-25",0,0,0,0,0,0,0,0
"El Salvador","2024-02-26",0,0,0,0,0,0,0,0
"El Salvador","2024-02-27",0,0,0,0,0,0,0,0
"El Salvador","2024-02-28",0,0,0,0,0,0,0,0
"El Salvador","2024-02-29",0,0,0,0,0,0,0,0
"El Salvador","2024-03-01",0,0,0,0,0,0,0,0
"El Salvador","2024-03-02",0,0,0,0,0,0,0,0
"El Salvador","2024-03-03",0,0,0,0,0,0,0,0
"El Salvador","2024-03-04",0,0,0,0,0,0,0,0
"El Salvador","2024-03-05",0,0,0,0,0,0,0,0
"El Salvador","2024-03-06",0,0,0,0,0,0,0,0
"El Salvador","2024-03-07",0,0,0,0,0,0,0,0
"El Salvador","2024-03-08",0,0,0,0,0,0,0,0
"El Salvador","2024-03-09",0,0,0,0,0,0,0,0
"El Salvador","2024-03-10",0,0,0,0,0,0,0,0
"El Salvador","2024-03-11",0,0,0,0,0,0,0,0
"El Salvador","2024-03-12",0,0,0,0,0,0,0,0
"El Salvador","2024-03-13",0,0,0,0,0,0,0,0
"El Salvador","2024-03-14",0,0,0,0,0,0,0,0
"El Salvador","2024-03-15",0,0,0,0,0,0,0,0
"El Salvador","2024-03-16",0,0,0,0,0,0,0,0
"El Salvador","2024-03-17",0,0,0,0,0,0,0,0
"El Salvador","2024-03-18",0,0,0,0,0,0,0,0
"El Salvador","2024-03-19",0,0,0,0,0,0,0,0
"El Salvador","2024-03-20",0,0,0,0,0,0,0,0
"El Salvador","2024-03-21",0,0,0,0,0,0,0,0
"El Salvador","2024-03-22",0,0,0,0,0,0,0,0
"El Salvador","2024-03-23",0,0,0,0,0,0,0,0
"El Salvador","2024-03-24",0,0,0,0,0,0,0,0
"El Salvador","2024-03-25",0,0,0,0,0,0,0,0
"El Salvador","2024-03-26",0,0,0,0,0,0,0,0
"El Salvador","2024-03-27",0,0,0,0,0,0,0,0
"El Salvador","2024-03-28",0,0,0,0,0,0,0,0
"El Salvador","2024-03-29",0,0,0,0,0,0,0,0
"El Salvador","2024-03-30",0,0,0,0,0,0,0,0
"El Salvador","2024-03-31",0,0,0,0,0,0,0,0
"El Salvador","2024-04-01",0,0,0,0,0,0,0,0
"El Salvador","2024-04-02",0,0,0,0,0,0,0,0
"El Salvador","2024-04-03",0,0,0,0,0,0,0,0
"El Salvador","2024-04-04",0,0,0,0,0,0,0,0
"El Salvador","2024-04-05",0,0,0,0,0,0,0,0
"El Salvador","2024-04-06",0,0,0,0,0,0,0,0
"El Salvador","2024-04-07",0,0,0,0,0,0,0,0
"El Salvador","2024-04-08",0,0,0,0,0,0,0,0
"El Salvador","2024-04-09",0,0,0,0,0,0,0,0
"El Salvador","2024-04-10",0,0,0,0,0,0,0,0
"El Salvador","2024-04-11",0,0,0,0,0,0,0,0
"El Salvador","2024-04-12",0,0,0,0,0,0,0,0
"El Salvador","2024-04-13",0,0,0,0,0,0,0,0
"El Salvador","2024-04-14",0,0,0,0,0,0,0,0
"El Salvador","2024-04-15",0,0,0,0,0,0,0,0
"El Salvador","2024-04-16",0,0,0,0,0,0,0,0
"El Salvador","2024-04-17",0,0,0,0,0,0,0,0
"El Salvador","2024-04-18",0,0,0,0,0,0,0,0
"El Salvador","2024-04-19",0,0,0,0,0,0,0,0
"El Salvador","2024-04-20",0,0,0,0,0,0,0,0
"El Salvador","2024-04-21",0,0,0,0,0,0,0,0
"El Salvador","2024-04-22",0,0,0,0,0,0,0,0
"El Salvador","2024-04-23",0,0,0,0,0,0,0,0
"El Salvador","2024-04-24",0,0,0,0,0,0,0,0
"El Salvador","2024-04-25",0,0,0,0,0,0,0,0
"El Salvador","2024-04-26",0,0,0,0,0,0,0,0
"El Salvador","2024-04-27",0,0,0,0,0,0,0,0
"El Salvador","2024-04-28",0,0,0,0,0,0,0,0
"El Salvador","2024-04-29",0,0,0,0,0,0,0,0
"El Salvador","2024-04-30",0,0,0,0,0,0,0,0
"El Salvador","2024-05-01",0,0,0,0,0,0,0,0
"El Salvador","2024-05-02",0,0,0,0,0,0,0,0
"El Salvador","2024-05-03",0,0,0,0,0,0,0,0
"El Salvador","2024-05-04",0,0,0,0,0,0,0,0
"El Salvador","2024-05-05",0,0,0,0,0,0,0,0
"El Salvador","2024-05-06",0,0,0,0,0,0,0,0
"El Salvador","2024-05-07",0,0,0,0,0,0,0,0
"El Salvador","2024-05-08",0,0,0,0,0,0,0,0
"El Salvador","2024-05-09",0,0,0,0,0,0,0,0
"El Salvador","2024-05-10",0,0,0,0,0,0,0,0
"El Salvador","2024-05-11",0,0,0,0,0,0,0,0
"El Salvador","2024-05-12",0,0,0,0,0,0,0,0
"El Salvador","2024-05-13",0,0,0,0,0,0,0,0
"El Salvador","2024-05-14",0,0,0,0,0,0,0,0
"El Salvador","2024-05-15",0,0,0,0,0,0,0,0
"El Salvador","2024-05-16",0,0,0,0,0,0,0,0
"El Salvador","2024-05-17",0,0,0,0,0,0,0,0
"El Salvador","2024-05-18",0,0,0,0,0,0,0,0
"El Salvador","2024-05-19",0,0,0,0,0,0,0,0
"El Salvador","2024-05-20",0,0,0,0,0,0,0,0
"El Salvador","2024-05-21",0,0,0,0,0,0,0,0
"El Salvador","2024-05-22",0,0,0,0,0,0,0,0
"El Salvador","2024-05-23",0,0,0,0,0,0,0,0
"El Salvador","2024-05-24",0,0,0,0,0,0,0,0
"El Salvador","2024-05-25",0,0,0,0,0,0,0,0
"El Salvador","2024-05-26",0,0,0,0,0,0,0,0
"El Salvador","2024-05-27",0,0,0,0,0,0,0,0
"El Salvador","2024-05-28",0,0,0,0,0,0,0,0
"El Salvador","2024-05-29",0,0,0,0,0,0,0,0
"El Salvador","2024-05-30",0,0,0,0,0,0,0,0
"El Salvador","2024-05-31",0,0,0,0,0,0,0,0
"El Salvador","2024-06-01",0,0,0,0,0,0,0,0
"El Salvador","2024-06-02",0,0,0,0,0,0,0,0
"El Salvador","2024-06-03",0,0,0,0,0,0,0,0
"El Salvador","2024-06-04",0,0,0,0,0,0,0,0
"El Salvador","2024-06-05",0,0,0,0,0,0,0,0
"El Salvador","2024-06-06",0,0,0,0,0,0,0,0
"El Salvador","2024-06-07",0,0,0,0,0,0,0,0
"El Salvador","2024-06-08",0,0,0,0,0,0,0,0
"El Salvador","2024-06-09",0,0,0,0,0,0,0,0
"El Salvador","2024-06-10",0,0,0,0,0,0,0,0
"El Salvador","2024-06-11",0,0,0,0,0,0,0,0
"El Salvador","2024-06-12",0,0,0,0,0,0,0,0
"El Salvador","2024-06-13",0,0,0,0,0,0,0,0
"El Salvador","2024-06-14",0,0,0,0,0,0,0,0
"El Salvador","2024-06-15",0,0,0,0,0,0,0,0
"El Salvador","2024-06-16",0,0,0,0,0,0,0,0
"El Salvador","2024-06-17",0,0,0,0,0,0,0,0
"El Salvador","2024-06-18",0,0,0,0,0,0,0,0
"El Salvador","2024-06-19",0,0,0,0,0,0,0,0
"El Salvador","2024-06-20",0,0,0,0,0,0,0,0
"El Salvador","2024-06-21",0,0,0,0,0,0,0,0
"El Salvador","2024-06-22",0,0,0,0,0,0,0,0
"El Salvador","2024-06-23",0,0,0,0,0,0,0,0
"El Salvador","2024-06-24",0,0,0,0,0,0,0,0
"El Salvador","2024-06-25",0,0,0,0,0,0,0,0
"El Salvador","2024-06-26",0,0,0,0,0,0,0,0
"El Salvador","2024-06-27",0,0,0,0,0,0,0,0
"El Salvador","2024-06-28",0,0,0,0,0,0,0,0
"El Salvador","2024-06-29",0,0,0,0,0,0,0,0
"El Salvador","2024-06-30",0,0,0,0,0,0,0,0
"El Salvador","2024-07-01",0,0,0,0,0,0,0,0
"El Salvador","2024-07-02",0,0,0,0,0,0,0,0
"El Salvador","2024-07-03",0,0,0,0,0,0,0,0
"El Salvador","2024-07-04",0,0,0,0,0,0,0,0
"El Salvador","2024-07-05",0,0,0,0,0,0,0,0
"El Salvador","2024-07-06",0,0,0,0,0,0,0,0
"El Salvador","2024-07-07",0,0,0,0,0,0,0,0
"El Salvador","2024-07-08",0,0,0,0,0,0,0,0
"El Salvador","2024-07-09",0,0,0,0,0,0,0,0
"El Salvador","2024-07-10",0,0,0,0,0,0,0,0
"El Salvador","2024-07-11",0,0,0,0,0,0,0,0
"El Salvador","2024-07-12",0,0,0,0,0,0,0,0
"El Salvador","2024-07-13",0,0,0,0,0,0,0,0
"El Salvador","2024-07-14",0,0,0,0,0,0,0,0
"El Salvador","2024-07-15",0,0,0,0,0,0,0,0
"El Salvador","2024-07-16",0,0,0,0,0,0,0,0
"El Salvador","2024-07-17",0,0,0,0,0,0,0,0
"El Salvador","2024-07-18",0,0,0,0,0,0,0,0
"El Salvador","2024-07-19",0,0,0,0,0,0,0,0
"El Salvador","2024-07-20",0,0,0,0,0,0,0,0
"El Salvador","2024-07-21",0,0,0,0,0,0,0,0
"El Salvador","2024-07-22",0,0,0,0,0,0,0,0
"El Salvador","2024-07-23",0,0,0,0,0,0,0,0
"El Salvador","2024-07-24",0,0,0,0,0,0,0,0
"El Salvador","2024-07-25",0,0,0,0,0,0,0,0
"El Salvador","2024-07-26",0,0,0,0,0,0,0,0
"El Salvador","2024-07-27",0,0,0,0,0,0,0,0
"El Salvador","2024-07-28",0,0,0,0,0,0,0,0
"El Salvador","2024-07-29",0,0,0,0,0,0,0,0
"El Salvador","2024-07-30",0,0,0,0,0,0,0,0
"El Salvador","2024-07-31",0,0,0,0,0,0,0,0
"El Salvador","2024-08-01",0,0,0,0,0,0,0,0
"El Salvador","2024-08-02",0,0,0,0,0,0,0,0
"El Salvador","2024-08-03",0,0,0,0,0,0,0,0
"El Salvador","2024-08-04",0,0,0,0,0,0,0,0
"El Salvador","2024-08-05",0,0,0,0,0,0,0,0
"El Salvador","2024-08-06",0,0,0,0,0,0,0,0
"El Salvador","2024-08-07",0,0,0,0,0,0,0,0
"El Salvador","2024-08-08",0,0,0,0,0,0,0,0
"El Salvador","2024-08-09",0,0,0,0,0,0,0,0
"El Salvador","2024-08-10",0,0,0,0,0,0,0,0
"El Salvador","2024-08-11",0,0,0,0,0,0,0,0
"El Salvador","2024-08-12",0,0,0,0,0,0,0,0
"El Salvador","2024-08-13",0,0,0,0,0,0,0,0
"El Salvador","2024-08-14",0,0,0,0,0,0,0,0
"El Salvador","2024-08-15",0,0,0,0,0,0,0,0
"El Salvador","2024-08-16",0,0,0,0,0,0,0,0
"El Salvador","2024-08-17",0,0,0,0,0,0,0,0
"El Salvador","2024-08-18",0,0,0,0,0,0,0,0
"El Salvador","2024-08-19",0,0,0,0,0,0,0,0
"El Salvador","2024-08-20",0,0,0,0,0,0,0,0
"El Salvador","2024-08-21",0,0,0,0,0,0,0,0
"El Salvador","2024-08-22",0,0,0,0,0,0,0,0
"El Salvador","2024-08-23",0,0,0,0,0,0,0,0
"El Salvador","2024-08-24",0,0,0,0,0,0,0,0
"El Salvador","2024-08-25",0,0,0,0,0,0,0,0
"El Salvador","2024-08-26",0,0,0,0,0,0,0,0
"El Salvador","2024-08-27",0,0,0,0,0,0,0,0
"El Salvador","2024-08-28",0,0,0,0,0,0,0,0
"El Salvador","2024-08-29",0,0,0,0,0,0,0,0
"El Salvador","2024-08-30",0,0,0,0,0,0,0,0
"El Salvador","2024-08-31",0,0,0,0,0,0,0,0
"El Salvador","2024-09-01",0,0,0,0,0,0,0,0
"El Salvador","2024-09-02",0,0,0,0,0,0,0,0
"El Salvador","2024-09-03",0,0,0,0,0,0,0,0
"El Salvador","2024-09-04",0,0,0,0,0,0,0,0
"El Salvador","2024-09-05",0,0,0,0,0,0,0,0
"El Salvador","2024-09-06",0,0,0,0,0,0,0,0
"El Salvador","2024-09-07",0,0,0,0,0,0,0,0
"El Salvador","2024-09-08",0,0,0,0,0,0,0,0
"El Salvador","2024-09-09",0,0,0,0,0,0,0,0
"El Salvador","2024-09-10",0,0,0,0,0,0,0,0
"El Salvador","2024-09-11",0,0,0,0,0,0,0,0
"El Salvador","2024-09-12",0,0,0,0,0,0,0,0
"El Salvador","2024-09-13",0,0,0,0,0,0,0,0
"El Salvador","2024-09-14",0,0,0,0,0,0,0,0
"El Salvador","2024-09-15",0,0,0,0,0,0,0,0
"El Salvador","2024-09-16",0,0,0,0,0,0,0,0
"El Salvador","2024-09-17",0,0,0,0,0,0,0,0
"El Salvador","2024-09-18",0,0,0,0,0,0,0,0
"El Salvador","2024-09-19",0,0,0,0,0,0,0,0
"El Salvador","2024-09-20",0,0,0,0,0,0,0,0
"El Salvador","2024-09-21",0,0,0,0,0,0,0,0
"El Salvador","2024-09-22",0,0,0,0,0,0,0,0
"El Salvador","2024-09-23",0,0,0,0,0,0,0,0
"El Salvador","2024-09-24",0,0,0,0,0,0,0,0
"El Salvador","2024-09-25",0,0,0,0,0,0,0,0
"El Salvador","2024-09-26",0,0,0,0,0,0,0,0
"El Salvador","2024-09-27",0,0,0,0,0,0,0,0
"El Salvador","2024-09-28",0,0,0,0,0,0,0,0
"El Salvador","2024-09-29",0,0,0,0,0,0,0,0
"El Salvador","2024-09-30",0,0,0,0,0,0,0,0
"El Salvador","2024-10-01",0,0,0,0,0,0,0,0
"El Salvador","2024-10-02",0,0,0,0,0,0,0,0
"El Salvador","2024-10-03",0,0,0,0,0,0,0,0
"El Salvador","2024-10-04",0,0,0,0,0,0,0,0
"El Salvador","2024-10-05",0,0,0,0,0,0,0,0
"El Salvador","2024-10-06",0,0,0,0,0,0,0,0
"El Salvador","2024-10-07",0,0,0,0,0,0,0,0
"El Salvador","2024-10-08",0,0,0,0,0,0,0,0
"El Salvador","2024-10-09",0,0,0,0,0,0,0,0
"El Salvador","2024-10-10",0,0,0,0,0,0,0,0
"El Salvador","2024-10-11",0,0,0,0,0,0,0,0
"El Salvador","2024-10-12",0,0,0,0,0,0,0,0
"El Salvador","2024-10-13",0,0,0,0,0,0,0,0
"El Salvador","2024-10-14",0,0,0,0,0,0,0,0
"El Salvador","2024-10-15",0,0,0,0,0,0,0,0
"El Salvador","2024-10-16",0,0,0,0,0,0,0,0
"El Salvador","2024-10-17",0,0,0,0,0,0,0,0
"El Salvador","2024-10-18",0,0,0,0,0,0,0,0
"El Salvador","2024-10-19",0,0,0,0,0,0,0,0
"El Salvador","2024-10-20",0,0,0,0,0,0,0,0
"El Salvador","2024-10-21",0,0,0,0,0,0,0,0
"El Salvador","2024-10-22",0,0,0,0,0,0,0,0
"El Salvador","2024-10-23",0,0,0,0,0,0,0,0
"El Salvador","2024-10-24",0,0,0,0,0,0,0,0
"El Salvador","2024-10-25",0,0,0,0,0,0,0,0
"El Salvador","2024-10-26",0,0,0,0,0,0,0,0
"El Salvador","2024-10-27",0,0,0,0,0,0,0,0
"El Salvador","2024-10-28",0,0,0,0,0,0,0,0
"El Salvador","2024-10-29",0,0,0,0,0,0,0,0
"El Salvador","2024-10-30",0,0,0,0,0,0,0,0
"El Salvador","2024-10-31",0,0,0,0,0,0,0,0
"El Salvador","2024-11-01",0,0,0,0,0,0,0,0
"El Salvador","2024-11-02",0,0,0,0,0,0,0,0
"El Salvador","2024-11-03",0,0,0,0,0,0,0,0
"El Salvador","2024-11-04",0,0,0,0,0,0,0,0
"El Salvador","2024-11-05",0,0,0,0,0,0,0,0
"El Salvador","2024-11-06",0,0,0,0,0,0,0,0
"El Salvador","2024-11-07",0,0,0,0,0,0,0,0
"El Salvador","2024-11-08",0,0,0,0,0,0,0,0
"El Salvador","2024-11-09",0,0,0,0,0,0,0,0
"El Salvador","2024-11-10",0,0,0,0,0,0,0,0
"El Salvador","2024-11-11",0,0,0,0,0,0,0,0
"El Salvador","2024-11-12",0,0,0,0,0,0,0,0
"El Salvador","2024-11-13",0,0,0,0,0,0,0,0
"El Salvador","2024-11-14",0,0,0,0,0,0,0,0
"El Salvador","2024-11-15",0,0,0,0,0,0,0,0
"El Salvador","2024-11-16",0,0,0,0,0,0,0,0
"El Salvador","2024-11-17",0,0,0,0,0,0,0,0
"El Salvador","2024-11-18",0,0,0,0,0,0,0,0
"El Salvador","2024-11-19",0,0,0,0,0,0,0,0
"El Salvador","2024-11-20",0,0,0,0,0,0,0,0
"El Salvador","2024-11-21",0,0,0,0,0,0,0,0
"El Salvador","2024-11-22",0,0,0,0,0,0,0,0
"El Salvador","2024-11-23",0,0,0,0,0,0,0,0
"El Salvador","2024-11-24",0,0,0,0,0,0,0,0
"El Salvador","2024-11-25",0,0,0,0,0,0,0,0
"El Salvador","2024-11-26",0,0,0,0,0,0,0,0
"El Salvador","2024-11-27",0,0,0,0,0,0,0,0
"El Salvador","2024-11-28",0,0,0,0,0,0,0,0
"El Salvador","2024-11-29",0,0,0,0,0,0,0,0
"El Salvador","2024-11-30",0,0,0,0,0,0,0,0
"El Salvador","2024-12-01",0,0,0,0,0,0,0,0
"El Salvador","2024-12-02",0,0,0,0,0,0,0,0
"El Salvador","2024-12-03",0,0,0,0,0,0,0,0
"El Salvador","2024-12-04",0,0,0,0,0,0,0,0
"El Salvador","2024-12-05",0,0,0,0,0,0,0,0
"El Salvador","2024-12-06",0,0,0,0,0,0,0,0
"El Salvador","2024-12-07",0,0,0,0,0,0,0,0
"El Salvador","2024-12-08",0,0,0,0,0,0,0,0
"El Salvador","2024-12-09",0,0,0,0,0,0,0,0
"El Salvador","2024-12-10",0,0,0,0,0,0,0,0
"El Salvador","2024-12-11",0,0,0,0,0,0,0,0
"El Salvador","2024-12-12",0,0,0,0,0,0,0,0
"El Salvador","2024-12-13",0,0,0,0,0,0,0,0
"El Salvador","2024-12-14",0,0,0,0,0,0,0,0
"El Salvador","2024-12-15",0,0,0,0,0,0,0,0
"El Salvador","2024-12-16",0,0,0,0,0,0,0,0
"El Salvador","2024-12-17",0,0,0,0,0,0,0,0
"El Salvador","2024-12-18",0,0,0,0,0,0,0,0
"El Salvador","2024-12-19",0,0,0,0,0,0,0,0
"El Salvador","2024-12-20",0,0,0,0,0,0,0,0
"El Salvador","2024-12-21",0,0,0,0,0,0,0,0
"El Salvador","2024-12-22",0,0,0,0,0,0,0,0
"El Salvador","2024-12-23",0,0,0,0,0,0,0,0
"El Salvador","2024-12-24",0,0,0,0,0,0,0,0
"El Salvador","2024-12-25",0,0,0,0,0,0,0,0
"El Salvador","2024-12-26",0,0,0,0,0,0,0,0
"El Salvador","2024-12-27",0,0,0,0,0,0,0,0
"El Salvador","2024-12-28",0,0,0,0,0,0,0,0
"El Salvador","2024-12-29",0,0,0,0,0,0,0,0
"El Salvador","2024-12-30",0,0,0,0,0,0,0,0
"El Salvador","2024-12-31",0,0,0,0,0,0,0,0
"El Salvador","2025-01-01",0,0,0,0,0,0,0,0
"El Salvador","2025-01-02",0,0,0,0,0,0,0,0
"El Salvador","2025-01-03",0,0,0,0,0,0,0,0
"El Salvador","2025-01-04",0,0,0,0,0,0,0,0
"El Salvador","2025-01-05",0,0,0,0,0,0,0,0
"El Salvador","2025-01-06",0,0,0,0,0,0,0,0
"El Salvador","2025-01-07",0,0,0,0,0,0,0,0
"El Salvador","2025-01-08",0,0,0,0,0,0,0,0
"El Salvador","2025-01-09",0,0,0,0,0,0,0,0
"El Salvador","2025-01-10",0,0,0,0,0,0,0,0
"El Salvador","2025-01-11",0,0,0,0,0,0,0,0
"El Salvador","2025-01-12",0,0,0,0,0,0,0,0
"El Salvador","2025-01-13",0,0,0,0,0,0,0,0
"Estonia","2024-01-01",0,0,0,0,0,0,0,0
"Estonia","2024-01-02",0,0,0,0,0,0,0,0
"Estonia","2024-01-03",0,0,0,0,0,0,0,0
"Estonia","2024-01-04",0,0,0,0,0,0,0,0
"Estonia","2024-01-05",0,0,0,0,0,0,0,0
"Estonia","2024-01-06",0,0,0,0,0,0,0,0
"Estonia","2024-01-07",0,0,0,0,0,0,0,0
"Estonia","2024-01-08",0,0,0,0,0,0,0,0
"Estonia","2024-01-09",0,0,0,0,0,0,0,0
"Estonia","2024-01-10",0,0,0,0,0,0,0,0
"Estonia","2024-01-11",0,0,0,0,0,0,0,0
"Estonia","2024-01-12",0,0,0,0,0,0,0,0
"Estonia","2024-01-13",0,0,0,0,0,0,0,0
"Estonia","2024-01-14",0,0,0,0,0,0,0,0
"Estonia","2024-01-15",0,0,0,0,0,0,0,0
"Estonia","2024-01-16",0,0,0,0,0,0,0,0
"Estonia","2024-01-17",0,0,0,0,0,0,0,0
"Estonia","2024-01-18",0,0,0,0,0,0,0,0
"Estonia","2024-01-19",0,0,0,0,0,0,0,0
"Estonia","2024-01-20",0,0,0,0,0,0,0,0
"Estonia","2024-01-21",0,0,0,0,0,0,0,0
"Estonia","2024-01-22",0,0,0,0,0,0,0,0
"Estonia","2024-01-23",0,0,0,0,0,0,0,0
"Estonia","2024-01-24",0,0,0,0,0,0,0,0
"Estonia","2024-01-25",0,0,0,0,0,0,0,0
"Estonia","2024-01-26",0,0,0,0,0,0,0,0
"Estonia","2024-01-27",0,0,0,0,0,0,0,0
"Estonia","2024-01-28",0,0,0,0,0,0,0,0
"Estonia","2024-01-29",0,0,0,0,0,0,0,0
"Estonia","2024-01-30",0,0,0,0,0,0,0,0
"Estonia","2024-01-31",0,0,0,0,0,0,0,0
"Estonia","2024-02-01",0,0,0,0,0,0,0,0
"Estonia","2024-02-02",0,0,0,0,0,0,0,0
"Estonia","2024-02-03",0,0,0,0,0,0,0,0
"Estonia","2024-02-04",0,0,0,0,0,0,0,0
"Estonia","2024-02-05",0,0,0,0,0,0,0,0
"Estonia","2024-02-06",0,0,0,0,0,0,0,0
"Estonia","2024-02-07",0,0,0,0,0,0,0,0
"Estonia","2024-02-08",0,0,0,0,0,0,0,0
"Estonia","2024-02-09",0,0,0,0,0,0,0,0
"Estonia","2024-02-10",0,0,0,0,0,0,0,0
"Estonia","2024-02-11",0,0,0,0,0,0,0,0
"Estonia","2024-02-12",0,0,0,0,0,0,0,0
"Estonia","2024-02-13",0,0,0,0,0,0,0,0
"Estonia","2024-02-14",0,0,0,0,0,0,0,0
"Estonia","2024-02-15",0,0,0,0,0,0,0,0
"Estonia","2024-02-16",0,0,0,0,0,0,0,0
"Estonia","2024-02-17",0,0,0,0,0,0,0,0
"Estonia","2024-02-18",0,0,0,0,0,0,0,0
"Estonia","2024-02-19",0,0,0,0,0,0,0,0
"Estonia","2024-02-20",0,0,0,0,0,0,0,0
"Estonia","2024-02-21",0,0,0,0,0,0,0,0
"Estonia","2024-02-22",0,0,0,0,0,0,0,0
"Estonia","2024-02-23",0,0,0,0,0,0,0,0
"Estonia","2024-02-24",0,0,0,0,0,0,0,0
"Estonia","2024-02-25",0,0,0,0,0,0,0,0
"Estonia","2024-02-26",0,0,0,0,0,0,0,0
"Estonia","2024-02-27",0,0,0,0,0,0,0,0
"Estonia","2024-02-28",0,0,0,0,0,0,0,0
"Estonia","2024-02-29",0,0,0,0,0,0,0,0
"Estonia","2024-03-01",0,0,0,0,0,0,0,0
"Estonia","2024-03-02",0,0,0,0,0,0,0,0
"Estonia","2024-03-03",0,0,0,0,0,0,0,0
"Estonia","2024-03-04",0,0,0,0,0,0,0,0
"Estonia","2024-03-05",0,0,0,0,0,0,0,0
"Estonia","2024-03-06",0,0,0,0,0,0,0,0
"Estonia","2024-03-07",0,0,0,0,0,0,0,0
"Estonia","2024-03-08",0,0,0,0,0,0,0,0
"Estonia","2024-03-09",0,0,0,0,0,0,0,0
"Estonia","2024-03-10",0,0,0,0,0,0,0,0
"Estonia","2024-03-11",0,0,0,0,0,0,0,0
"Estonia","2024-03-12",0,0,0,0,0,0,0,0
"Estonia","2024-03-13",0,0,0,0,0,0,0,0
"Estonia","2024-03-14",0,0,0,0,0,0,0,0
"Estonia","2024-03-15",0,0,0,0,0,0,0,0
"Estonia","2024-03-16",0,0,0,0,0,0,0,0
"Estonia","2024-03-17",0,0,0,0,0,0,0,0
"Estonia","2024-03-18",0,0,0,0,0,0,0,0
"Estonia","2024-03-19",0,0,0,0,0,0,0,0
"Estonia","2024-03-20",0,0,0,0,0,0,0,0
"Estonia","2024-03-21",0,0,0,0,0,0,0,0
"Estonia","2024-03-22",0,0,0,0,0,0,0,0
"Estonia","2024-03-23",0,0,0,0,0,0,0,0
"Estonia","2024-03-24",0,0,0,0,0,0,0,0
"Estonia","2024-03-25",0,0,0,0,0,0,0,0
"Estonia","2024-03-26",0,0,0,0,0,0,0,0
"Estonia","2024-03-27",0,0,0,0,0,0,0,0
"Estonia","2024-03-28",0,0,0,0,0,0,0,0
"Estonia","2024-03-29",0,0,0,0,0,0,0,0
"Estonia","2024-03-30",0,0,0,0,0,0,0,0
"Estonia","2024-03-31",0,0,0,0,0,0,0,0
"Estonia","2024-04-01",0,0,0,0,0,0,0,0
"Estonia","2024-04-02",0,0,0,0,0,0,0,0
"Estonia","2024-04-03",0,0,0,0,0,0,0,0
"Estonia","2024-04-04",0,0,0,0,0,0,0,0
"Estonia","2024-04-05",0,0,0,0,0,0,0,0
"Estonia","2024-04-06",0,0,0,0,0,0,0,0
"Estonia","2024-04-07",0,0,0,0,0,0,0,0
"Estonia","2024-04-08",0,0,0,0,0,0,0,0
"Estonia","2024-04-09",0,0,0,0,0,0,0,0
"Estonia","2024-04-10",0,0,0,0,0,0,0,0
"Estonia","2024-04-11",0,0,0,0,0,0,0,0
"Estonia","2024-04-12",0,0,0,0,0,0,0,0
"Estonia","2024-04-13",0,0,0,0,0,0,0,0
"Estonia","2024-04-14",0,0,0,0,0,0,0,0
"Estonia","2024-04-15",0,0,0,0,0,0,0,0
"Estonia","2024-04-16",0,0,0,0,0,0,0,0
"Estonia","2024-04-17",0,0,0,0,0,0,0,0
"Estonia","2024-04-18",0,0,0,0,0,0,0,0
"Estonia","2024-04-19",0,0,0,0,0,0,0,0
"Estonia","2024-04-20",0,0,0,0,0,0,0,0
"Estonia","2024-04-21",0,0,0,0,0,0,0,0
"Estonia","2024-04-22",0,0,0,0,0,0,0,0
"Estonia","2024-04-23",0,0,0,0,0,0,0,0
"Estonia","2024-04-24",0,0,0,0,0,0,0,0
"Estonia","2024-04-25",0,0,0,0,0,0,0,0
"Estonia","2024-04-26",0,0,0,0,0,0,0,0
"Estonia","2024-04-27",0,0,0,0,0,0,0,0
"Estonia","2024-04-28",0,0,0,0,0,0,0,0
"Estonia","2024-04-29",0,0,0,0,0,0,0,0
"Estonia","2024-04-30",0,0,0,0,0,0,0,0
"Estonia","2024-05-01",0,0,0,0,0,0,0,0
"Estonia","2024-05-02",0,0,0,0,0,0,0,0
"Estonia","2024-05-03",0,0,0,0,0,0,0,0
"Estonia","2024-05-04",0,0,0,0,0,0,0,0
"Estonia","2024-05-05",0,0,0,0,0,0,0,0
"Estonia","2024-05-06",0,0,0,0,0,0,0,0
"Estonia","2024-05-07",0,0,0,0,0,0,0,0
"Estonia","2024-05-08",0,0,0,0,0,0,0,0
"Estonia","2024-05-09",0,0,0,0,0,0,0,0
"Estonia","2024-05-10",0,0,0,0,0,0,0,0
"Estonia","2024-05-11",0,0,0,0,0,0,0,0
"Estonia","2024-05-12",0,0,0,0,0,0,0,0
"Estonia","2024-05-13",0,0,0,0,0,0,0,0
"Estonia","2024-05-14",0,0,0,0,0,0,0,0
"Estonia","2024-05-15",0,0,0,0,0,0,0,0
"Estonia","2024-05-16",0,0,0,0,0,0,0,0
"Estonia","2024-05-17",0,0,0,0,0,0,0,0
"Estonia","2024-05-18",0,0,0,0,0,0,0,0
"Estonia","2024-05-19",0,0,0,0,0,0,0,0
"Estonia","2024-05-20",0,0,0,0,0,0,0,0
"Estonia","2024-05-21",0,0,0,0,0,0,0,0
"Estonia","2024-05-22",0,0,0,0,0,0,0,0
"Estonia","2024-05-23",0,0,0,0,0,0,0,0
"Estonia","2024-05-24",0,0,0,0,0,0,0,0
"Estonia","2024-05-25",0,0,0,0,0,0,0,0
"Estonia","2024-05-26",0,0,0,0,0,0,0,0
"Estonia","2024-05-27",0,0,0,0,0,0,0,0
"Estonia","2024-05-28",0,0,0,0,0,0,0,0
"Estonia","2024-05-29",0,0,0,0,0,0,0,0
"Estonia","2024-05-30",0,0,0,0,0,0,0,0
"Estonia","2024-05-31",0,0,0,0,0,0,0,0
"Estonia","2024-06-01",0,0,0,0,0,0,0,0
"Estonia","2024-06-02",0,0,0,0,0,0,0,0
"Estonia","2024-06-03",0,0,0,0,0,0,0,0
"Estonia","2024-06-04",0,0,0,0,0,0,0,0
"Estonia","2024-06-05",0,0,0,0,0,0,0,0
"Estonia","2024-06-06",0,0,0,0,0,0,0,0
"Estonia","2024-06-07",0,0,0,0,0,0,0,0
"Estonia","2024-06-08",0,0,0,0,0,0,0,0
"Estonia","2024-06-09",0,0,0,0,0,0,0,0
"Estonia","2024-06-10",0,0,0,0,0,0,0,0
"Estonia","2024-06-11",0,0,0,0,0,0,0,0
"Estonia","2024-06-12",0,0,0,0,0,0,0,0
"Estonia","2024-06-13",0,0,0,0,0,0,0,0
"Estonia","2024-06-14",0,0,0,0,0,0,0,0
"Estonia","2024-06-15",0,0,0,0,0,0,0,0
"Estonia","2024-06-16",0,0,0,0,0,0,0,0
"Estonia","2024-06-17",0,0,0,0,0,0,0,0
"Estonia","2024-06-18",0,0,0,0,0,0,0,0
"Estonia","2024-06-19",0,0,0,0,0,0,0,0
"Estonia","2024-06-20",0,0,0,0,0,0,0,0
"Estonia","2024-06-21",0,0,0,0,0,0,0,0
"Estonia","2024-06-22",0,0,0,0,0,0,0,0
"Estonia","2024-06-23",0,0,0,0,0,0,0,0
"Estonia","2024-06-24",0,0,0,0,0,0,0,0
"Estonia","2024-06-25",0,0,0,0,0,0,0,0
"Estonia","2024-06-26",0,0,0,0,0,0,0,0
"Estonia","2024-06-27",0,0,0,0,0,0,0,0
"Estonia","2024-06-28",0,0,0,0,0,0,0,0
"Estonia","2024-06-29",0,0,0,0,0,0,0,0
"Estonia","2024-06-30",0,0,0,0,0,0,0,0
"Estonia","2024-07-01",0,0,0,0,0,0,0,0
"Estonia","2024-07-02",0,0,0,0,0,0,0,0
"Estonia","2024-07-03",0,0,0,0,0,0,0,0
"Estonia","2024-07-04",0,0,0,0,0,0,0,0
"Estonia","2024-07-05",0,0,0,0,0,0,0,0
"Estonia","2024-07-06",0,0,0,0,0,0,0,0
"Estonia","2024-07-07",0,0,0,0,0,0,0,0
"Estonia","2024-07-08",0,0,0,0,0,0,0,0
"Estonia","2024-07-09",0,0,0,0,0,0,0,0
"Estonia","2024-07-10",0,0,0,0,0,0,0,0
"Estonia","2024-07-11",0,0,0,0,0,0,0,0
"Estonia","2024-07-12",0,0,0,0,0,0,0,0
"Estonia","2024-07-13",0,0,0,0,0,0,0,0
"Estonia","2024-07-14",0,0,0,0,0,0,0,0
"Estonia","2024-07-15",0,0,0,0,0,0,0,0
"Estonia","2024-07-16",0,0,0,0,0,0,0,0
"Estonia","2024-07-17",0,0,0,0,0,0,0,0
"Estonia","2024-07-18",0,0,0,0,0,0,0,0
"Estonia","2024-07-19",0,0,0,0,0,0,0,0
"Estonia","2024-07-20",0,0,0,0,0,0,0,0
"Estonia","2024-07-21",0,0,0,0,0,0,0,0
"Estonia","2024-07-22",0,0,0,0,0,0,0,0
"Estonia","2024-07-23",0,0,0,0,0,0,0,0
"Estonia","2024-07-24",0,0,0,0,0,0,0,0
"Estonia","2024-07-25",0,0,0,0,0,0,0,0
"Estonia","2024-07-26",0,0,0,0,0,0,0,0
"Estonia","2024-07-27",0,0,0,0,0,0,0,0
"Estonia","2024-07-28",0,0,0,0,0,0,0,0
"Estonia","2024-07-29",0,0,0,0,0,0,0,0
"Estonia","2024-07-30",0,0,0,0,0,0,0,0
"Estonia","2024-07-31",0,0,0,0,0,0,0,0
"Estonia","2024-08-01",0,0,0,0,0,0,0,0
"Estonia","2024-08-02",0,0,0,0,0,0,0,0
"Estonia","2024-08-03",0,0,0,0,0,0,0,0
"Estonia","2024-08-04",0,0,0,0,0,0,0,0
"Estonia","2024-08-05",0,0,0,0,0,0,0,0
"Estonia","2024-08-06",0,0,0,0,0,0,0,0
"Estonia","2024-08-07",0,0,0,0,0,0,0,0
"Estonia","2024-08-08",0,0,0,0,0,0,0,0
"Estonia","2024-08-09",0,0,0,0,0,0,0,0
"Estonia","2024-08-10",0,0,0,0,0,0,0,0
"Estonia","2024-08-11",0,0,0,0,0,0,0,0
"Estonia","2024-08-12",0,0,0,0,0,0,0,0
"Estonia","2024-08-13",0,0,0,0,0,0,0,0
"Estonia","2024-08-14",0,0,0,0,0,0,0,0
"Estonia","2024-08-15",0,0,0,0,0,0,0,0
"Estonia","2024-08-16",0,0,0,0,0,0,0,0
"Estonia","2024-08-17",0,0,0,0,0,0,0,0
"Estonia","2024-08-18",0,0,0,0,0,0,0,0
"Estonia","2024-08-19",0,0,0,0,0,0,0,0
"Estonia","2024-08-20",0,0,0,0,0,0,0,0
"Estonia","2024-08-21",0,0,0,0,0,0,0,0
"Estonia","2024-08-22",0,0,0,0,0,0,0,0
"Estonia","2024-08-23",0,0,0,0,0,0,0,0
"Estonia","2024-08-24",0,0,0,0,0,0,0,0
"Estonia","2024-08-25",0,0,0,0,0,0,0,0
"Estonia","2024-08-26",0,0,0,0,0,0,0,0
"Estonia","2024-08-27",0,0,0,0,0,0,0,0
"Estonia","2024-08-28",0,0,0,0,0,0,0,0
"Estonia","2024-08-29",0,0,0,0,0,0,0,0
"Estonia","2024-08-30",0,0,0,0,0,0,0,0
"Estonia","2024-08-31",0,0,0,0,0,0,0,0
"Estonia","2024-09-01",0,0,0,0,0,0,0,0
"Estonia","2024-09-02",0,0,0,0,0,0,0,0
"Estonia","2024-09-03",0,0,0,0,0,0,0,0
"Estonia","2024-09-04",0,0,0,0,0,0,0,0
"Estonia","2024-09-05",0,0,0,0,0,0,0,0
"Estonia","2024-09-06",0,0,0,0,0,0,0,0
"Estonia","2024-09-07",0,0,0,0,0,0,0,0
"Estonia","2024-09-08",0,0,0,0,0,0,0,0
"Estonia","2024-09-09",0,0,0,0,0,0,0,0
"Estonia","2024-09-10",0,0,0,0,0,0,0,0
"Estonia","2024-09-11",0,0,0,0,0,0,0,0
"Estonia","2024-09-12",0,0,0,0,0,0,0,0
"Estonia","2024-09-13",0,0,0,0,0,0,0,0
"Estonia","2024-09-14",0,0,0,0,0,0,0,0
"Estonia","2024-09-15",0,0,0,0,0,0,0,0
"Estonia","2024-09-16",0,0,0,0,0,0,0,0
"Estonia","2024-09-17",0,0,0,0,0,0,0,0
"Estonia","2024-09-18",0,0,0,0,0,0,0,0
"Estonia","2024-09-19",0,0,0,0,0,0,0,0
"Estonia","2024-09-20",0,0,0,0,0,0,0,0
"Estonia","2024-09-21",0,0,0,0,0,0,0,0
"Estonia","2024-09-22",0,0,0,0,0,0,0,0
"Estonia","2024-09-23",0,0,0,0,0,0,0,0
"Estonia","2024-09-24",0,0,0,0,0,0,0,0
"Estonia","2024-09-25",0,0,0,0,0,0,0,0
"Estonia","2024-09-26",0,0,0,0,0,0,0,0
"Estonia","2024-09-27",0,0,0,0,0,0,0,0
"Estonia","2024-09-28",0,0,0,0,0,0,0,0
"Estonia","2024-09-29",0,0,0,0,0,0,0,0
"Estonia","2024-09-30",0,0,0,0,0,0,0,0
"Estonia","2024-10-01",0,0,0,0,0,0,0,0
"Estonia","2024-10-02",0,0,0,0,0,0,0,0
"Estonia","2024-10-03",0,0,0,0,0,0,0,0
"Estonia","2024-10-04",0,0,0,0,0,0,0,0
"Estonia","2024-10-05",0,0,0,0,0,0,0,0
"Estonia","2024-10-06",0,0,0,0,0,0,0,0
"Estonia","2024-10-07",0,0,0,0,0,0,0,0
"Estonia","2024-10-08",0,0,0,0,0,0,0,0
"Estonia","2024-10-09",0,0,0,0,0,0,0,0
"Estonia","2024-10-10",0,0,0,0,0,0,0,0
"Estonia","2024-10-11",0,0,0,0,0,0,0,0
"Estonia","2024-10-12",0,0,0,0,0,0,0,0
"Estonia","2024-10-13",0,0,0,0,0,0,0,0
"Estonia","2024-10-14",0,0,0,0,0,0,0,0
"Estonia","2024-10-15",0,0,0,0,0,0,0,0
"Estonia","2024-10-16",0,0,0,0,0,0,0,0
"Estonia","2024-10-17",0,0,0,0,0,0,0,0
"Estonia","2024-10-18",0,0,0,0,0,0,0,0
"Estonia","2024-10-19",0,0,0,0,0,0,0,0
"Estonia","2024-10-20",0,0,0,0,0,0,0,0
"Estonia","2024-10-21",0,0,0,0,0,0,0,0
"Estonia","2024-10-22",0,0,0,0,0,0,0,0
"Estonia","2024-10-23",0,0,0,0,0,0,0,0
"Estonia","2024-10-24",0,0,0,0,0,0,0,0
"Estonia","2024-10-25",0,0,0,0,0,0,0,0
"Estonia","2024-10-26",0,0,0,0,0,0,0,0
"Estonia","2024-10-27",0,0,0,0,0,0,0,0
"Estonia","2024-10-28",0,0,0,0,0,0,0,0
"Estonia","2024-10-29",0,0,0,0,0,0,0,0
"Estonia","2024-10-30",0,0,0,0,0,0,0,0
"Estonia","2024-10-31",0,0,0,0,0,0,0,0
"Estonia","2024-11-01",0,0,0,0,0,0,0,0
"Estonia","2024-11-02",0,0,0,0,0,0,0,0
"Estonia","2024-11-03",0,0,0,0,0,0,0,0
"Estonia","2024-11-04",0,0,0,0,0,0,0,0
"Estonia","2024-11-05",0,0,0,0,0,0,0,0
"Estonia","2024-11-06",0,0,0,0,0,0,0,0
"Estonia","2024-11-07",0,0,0,0,0,0,0,0
"Estonia","2024-11-08",0,0,0,0,0,0,0,0
"Estonia","2024-11-09",0,0,0,0,0,0,0,0
"Estonia","2024-11-10",0,0,0,0,0,0,0,0
"Estonia","2024-11-11",0,0,0,0,0,0,0,0
"Estonia","2024-11-12",0,0,0,0,0,0,0,0
"Estonia","2024-11-13",0,0,0,0,0,0,0,0
"Estonia","2024-11-14",0,0,0,0,0,0,0,0
"Estonia","2024-11-15",0,0,0,0,0,0,0,0
"Estonia","2024-11-16",0,0,0,0,0,0,0,0
"Estonia","2024-11-17",0,0,0,0,0,0,0,0
"Estonia","2024-11-18",0,0,0,0,0,0,0,0
"Estonia","2024-11-19",0,0,0,0,0,0,0,0
"Estonia","2024-11-20",0,0,0,0,0,0,0,0
"Estonia","2024-11-21",0,0,0,0,0,0,0,0
"Estonia","2024-11-22",0,0,0,0,0,0,0,0
"Estonia","2024-11-23",0,0,0,0,0,0,0,0
"Estonia","2024-11-24",0,0,0,0,0,0,0,0
"Estonia","2024-11-25",0,0,0,0,0,0,0,0
"Estonia","2024-11-26",0,0,0,0,0,0,0,0
"Estonia","2024-11-27",0,0,0,0,0,0,0,0
"Estonia","2024-11-28",0,0,0,0,0,0,0,0
"Estonia","2024-11-29",0,0,0,0,0,0,0,0
"Estonia","2024-11-30",0,0,0,0,0,0,0,0
"Estonia","2024-12-01",0,0,0,0,0,0,0,0
"Estonia","2024-12-02",0,0,0,0,0,0,0,0
"Estonia","2024-12-03",0,0,0,0,0,0,0,0
"Estonia","2024-12-04",0,0,0,0,0,0,0,0
"Estonia","2024-12-05",0,0,0,0,0,0,0,0
"Estonia","2024-12-06",0,0,0,0,0,0,0,0
"Estonia","2024-12-07",0,0,0,0,0,0,0,0
"Estonia","2024-12-08",0,0,0,0,0,0,0,0
"Estonia","2024-12-09",0,0,0,0,0,0,0,0
"Estonia","2024-12-10",0,0,0,0,0,0,0,0
"Estonia","2024-12-11",0,0,0,0,0,0,0,0
"Estonia","2024-12-12",0,0,0,0,0,0,0,0
"Estonia","2024-12-13",0,0,0,0,0,0,0,0
"Estonia","2024-12-14",0,0,0,0,0,0,0,0
"Estonia","2024-12-15",0,0,0,0,0,0,0,0
"Estonia","2024-12-16",0,0,0,0,0,0,0,0
"Estonia","2024-12-17",0,0,0,0,0,0,0,0
"Estonia","2024-12-18",0,0,0,0,0,0,0,0
"Estonia","2024-12-19",0,0,0,0,0,0,0,0
"Estonia","2024-12-20",0,0,0,0,0,0,0,0
"Estonia","2024-12-21",0,0,0,0,0,0,0,0
"Estonia","2024-12-22",0,0,0,0,0,0,0,0
"Estonia","2024-12-23",0,0,0,0,0,0,0,0
"Estonia","2024-12-24",0,0,0,0,0,0,0,0
"Estonia","2024-12-25",0,0,0,0,0,0,0,0
"Estonia","2024-12-26",0,0,0,0,0,0,0,0
"Estonia","2024-12-27",0,0,0,0,0,0,0,0
"Estonia","2024-12-28",0,0,0,0,0,0,0,0
"Estonia","2024-12-29",0,0,0,0,0,0,0,0
"Estonia","2024-12-30",0,0,0,0,0,0,0,0
"Estonia","2024-12-31",0,0,0,0,0,0,0,0
"Estonia","2025-01-01",0,0,0,0,0,0,0,0
"Estonia","2025-01-02",0,0,0,0,0,0,0,0
"Estonia","2025-01-03",0,0,0,0,0,0,0,0
"Estonia","2025-01-04",0,0,0,0,0,0,0,0
"Estonia","2025-01-05",0,0,0,0,0,0,0,0
"Estonia","2025-01-06",0,0,0,0,0,0,0,0
"Estonia","2025-01-07",0,0,0,0,0,0,0,0
"Estonia","2025-01-08",0,0,0,0,0,0,0,0
"Estonia","2025-01-09",0,0,0,0,0,0,0,0
"Estonia","2025-01-10",0,0,0,0,0,0,0,0
"Estonia","2025-01-11",0,0,0,0,0,0,0,0
"Estonia","2025-01-12",0,0,0,0,0,0,0,0
"Estonia","2025-01-13",0,0,0,0,0,0,0,0
"Europe","2024-01-01",0,0,0,0,0,0,0,0
"Europe","2024-01-02",0,0,0,0,0,0,0,0
"Europe","2024-01-03",0,0,0,0,0,0,0,0
"Europe","2024-01-04",0,0,0,0,0,0,0,0
"Europe","2024-01-05",0,0,0,0,0,0,0,0
"Europe","2024-01-06",0,0,0,0,0,0,0,0
"Europe","2024-01-07",0,0,0,0,0,0,0,0
"Europe","2024-01-08",0,0,0,0,0,0,0,0
"Europe","2024-01-09",0,0,0,0,0,0,0,0
"Europe","2024-01-10",0,0,0,0,0,0,0,0
"Europe","2024-01-11",0,0,0,0,0,0,0,0
"Europe","2024-01-12",0,0,0,0,0,0,0,0
"Europe","2024-01-13",0,0,0,0,0,0,0,0
"Europe","2024-01-14",0,0,0,0,0,0,0,0
"Europe","2024-01-15",0,0,0,0,0,0,0,0
"Europe","2024-01-16",0,0,0,0,0,0,0,0
"Europe","2024-01-17",0,0,0,0,0,0,0,0
"Europe","2024-01-18",0,0,0,0,0,0,0,0
"Europe","2024-01-19",0,0,0,0,0,0,0,0
"Europe","2024-01-20",0,0,0,0,0,0,0,0
"Europe","2024-01-21",0,0,0,0,0,0,0,0
"Europe","2024-01-22",0,0,0,0,0,0,0,0
"Europe","2024-01-23",0,0,0,0,0,0,0,0
"Europe","2024-01-24",0,0,0,0,0,0,0,0
"Europe","2024-01-25",0,0,0,0,0,0,0,0
"Europe","2024-01-26",0,0,0,0,0,0,0,0
"Europe","2024-01-27",0,0,0,0,0,0,0,0
"Europe","2024-01-28",0,0,0,0,0,0,0,0
"Europe","2024-01-29",0,0,0,0,0,0,0,0
"Europe","2024-01-30",0,0,0,0,0,0,0,0
"Europe","2024-01-31",0,141,141,0,141,141,0,0
"Europe","2024-02-01",0,0,141,0,7,148,0,0
"Europe","2024-02-02",0,0,141,0,6,154,0,0
"Europe","2024-02-03",0,0,141,0,7,161,0,0
"Europe","2024-02-04",0,0,141,0,7,168,0,0
"Europe","2024-02-05",0,0,141,0,7,175,0,0
"Europe","2024-02-06",0,0,141,0,6,181,0,0
"Europe","2024-02-07",0,0,141,0,7,188,0,0
"Europe","2024-02-08",0,0,141,0,7,195,0,0
"Europe","2024-02-09",0,0,141,0,7,202,0,0
"Europe","2024-02-10",0,0,141,0,6,208,0,0
"Europe","2024-02-11",0,0,141,0,7,215,0,0
"Europe","2024-02-12",0,0,141,0,7,222,0,0
"Europe","2024-02-13",0,0,141,0,6,228,0,0
"Europe","2024-02-14",0,0,141,0,7,235,0,0
"Europe","2024-02-15",0,0,141,0,7,242,0,0
"Europe","2024-02-16",0,0,141,0,7,249,0,0
"Europe","2024-02-17",0,0,141,0,6,255,0,0
"Europe","2024-02-18",0,0,141,0,7,262,0,0
"Europe","2024-02-19",0,0,141,0,7,269,0,0
"Europe","2024-02-20",0,0,141,0,6,275,0,0
"Europe","2024-02-21",0,0,141,0,7,282,0,0
"Europe","2024-02-22",0,0,141,0,7,289,0,0
"Europe","2024-02-23",0,0,141,0,7,296,0,0
"Europe","2024-02-24",0,0,141,0,6,302,0,0
"Europe","2024-02-25",0,0,141,0,7,309,0,0
"Europe","2024-02-26",0,0,141,0,7,316,0,0
"Europe","2024-02-27",0,0,141,0,7,323,0,0
"Europe","2024-02-28",0,0,141,0,6,329,0,0
"Europe","2024-02-29",0,195,336,0,7,336,0,0
"Europe","2024-03-01",0,0,336,0,4,340,0,0
"Europe","2024-03-02",0,0,336,0,4,344,0,0
"Europe","2024-03-03",0,0,336,0,4,348,0,0
"Europe","2024-03-04",0,0,336,0,4,352,0,0
"Europe","2024-03-05",0,0,336,0,4,356,0,0
"Europe","2024-03-06",0,0,336,0,4,360,0,0
"Europe","2024-03-07",0,0,336,0,4,364,0,0
"Europe","2024-03-08",0,0,336,0,4,368,0,0
"Europe","2024-03-09",0,0,336,0,4,372,0,0
"Europe","2024-03-10",0,0,336,0,4,376,0,0
"Europe","2024-03-11",0,0,336,0,4,380,0,0
"Europe","2024-03-12",0,0,336,0,4,384,0,0
"Europe","2024-03-13",0,0,336,0,4,388,0,0
"Europe","2024-03-14",0,0,336,0,4,392,0,0
"Europe","2024-03-15",0,0,336,0,4,396,0,0
"Europe","2024-03-16",0,0,336,0,3,399,0,0
"Europe","2024-03-17",0,0,336,0,4,403,0,0
"Europe","2024-03-18",0,0,336,0,4,407,0,0
"Europe","2024-03-19",0,0,336,0,4,411,0,0
"Europe","2024-03-20",0,0,336,0,4,415,0,0
"Europe","2024-03-21",0,0,336,0,4,419,0,0
"Europe","2024-03-22",0,0,336,0,4,423,0,0
"Europe","2024-03-23",0,0,336,0,4,427,0,0
"Europe","2024-03-24",0,0,336,0,4,431,0,0
"Europe","2024-03-25",0,0,336,0,4,435,0,0
"Europe","2024-03-26",0,0,336,0,4,439,0,0
"Europe","2024-03-27",0,0,336,0,4,443,0,0
"Europe","2024-03-28",0,0,336,0,4,447,0,0
"Europe","2024-03-29",0,0,336,0,4,451,0,0
"Europe","2024-03-30",0,0,336,0,4,455,0,0
"Europe","2024-03-31",0,123,459,0,4,459,0,0
"Europe","2024-04-01",0,0,459,0,4,463,0,0
"Europe","2024-04-02",0,0,459,0,3,466,0,0
"Europe","2024-04-03",0,0,459,0,4,470,0,0
"Europe","2024-04-04",0,0,459,0,3,473,0,0
"Europe","2024-04-05",0,0,459,0,4,477,0,0
"Europe","2024-04-06",0,0,459,0,4,481,0,0
"Europe","2024-04-07",0,0,459,0,3,484,0,0
"Europe","2024-04-08",0,0,459,0,4,488,0,0
"Europe","2024-04-09",0,0,459,0,3,491,0,0
"Europe","2024-04-10",0,0,459,0,4,495,0,0
"Europe","2024-04-11",0,0,459,0,4,499,0,0
"Europe","2024-04-12",0,0,459,0,3,502,0,0
"Europe","2024-04-13",0,0,459,0,4,506,0,0
"Europe","2024-04-14",0,0,459,0,3,509,0,0
"Europe","2024-04-15",0,0,459,0,4,513,0,0
"Europe","2024-04-16",0,0,459,0,4,517,0,0
"Europe","2024-04-17",0,0,459,0,3,520,0,0
"Europe","2024-04-18",0,0,459,0,4,524,0,0
"Europe","2024-04-19",0,0,459,0,3,527,0,0
"Europe","2024-04-20",0,0,459,0,4,531,0,0
"Europe","2024-04-21",0,0,459,0,4,535,0,0
"Europe","2024-04-22",0,0,459,0,3,538,0,0
"Europe","2024-04-23",0,0,459,0,4,542,0,0
"Europe","2024-04-24",0,0,459,0,3,545,0,0
"Europe","2024-04-25",0,0,459,0,4,549,0,0
"Europe","2024-04-26",0,0,459,0,4,553,0,0
"Europe","2024-04-27",0,0,459,0,3,556,0,0
"Europe","2024-04-28",0,0,459,0,4,560,0,0
"Europe","2024-04-29",0,0,459,0,3,563,0,0
"Europe","2024-04-30",0,108,567,0,4,567,0,0
"Europe","2024-05-01",0,0,567,0,4,571,0,0
"Europe","2024-05-02",0,0,567,0,4,575,0,0
"Europe","2024-05-03",0,0,567,0,4,579,0,0
"Europe","2024-05-04",0,0,567,0,4,583,0,0
"Europe","2024-05-05",0,0,567,0,4,587,0,0
"Europe","2024-05-06",0,0,567,0,4,591,0,0
"Europe","2024-05-07",0,0,567,0,4,595,0,0
"Europe","2024-05-08",0,0,567,0,4,599,0,0
"Europe","2024-05-09",0,0,567,0,4,603,0,0
"Europe","2024-05-10",0,0,567,0,4,607,0,0
"Europe","2024-05-11",0,0,567,0,4,611,0,0
"Europe","2024-05-12",0,0,567,0,4,615,0,0
"Europe","2024-05-13",0,0,567,0,4,619,0,0
"Europe","2024-05-14",0,0,567,0,4,623,0,0
"Europe","2024-05-15",0,0,567,0,4,627,0,0
"Europe","2024-05-16",0,0,567,0,3,630,0,0
"Europe","2024-05-17",0,0,567,0,4,634,0,0
"Europe","2024-05-18",0,0,567,0,4,638,0,0
"Europe","2024-05-19",0,0,567,0,4,642,0,0
"Europe","2024-05-20",0,0,567,0,4,646,0,0
"Europe","2024-05-21",0,0,567,0,4,650,0,0
"Europe","2024-05-22",0,0,567,0,4,654,0,0
"Europe","2024-05-23",0,0,567,0,4,658,0,0
"Europe","2024-05-24",0,0,567,0,4,662,0,0
"Europe","2024-05-25",0,0,567,0,4,666,0,0
"Europe","2024-05-26",0,0,567,0,4,670,0,0
"Europe","2024-05-27",0,0,567,0,4,674,0,0
"Europe","2024-05-28",0,0,567,0,4,678,0,0
"Europe","2024-05-29",0,0,567,0,4,682,0,0
"Europe","2024-05-30",0,0,567,0,4,686,0,0
"Europe","2024-05-31",0,123,690,0,4,690,0,0
"Europe","2024-06-01",0,0,690,0,3,693,0,0
"Europe","2024-06-02",0,0,690,0,4,697,0,0
"Europe","2024-06-03",0,0,690,0,3,700,0,0
"Europe","2024-06-04",0,0,690,0,3,703,0,0
"Europe","2024-06-05",0,0,690,0,3,706,0,0
"Europe","2024-06-06",0,0,690,0,4,710,0,0
"Europe","2024-06-07",0,0,690,0,3,713,0,0
"Europe","2024-06-08",0,0,690,0,3,716,0,0
"Europe","2024-06-09",0,0,690,0,3,719,0,0
"Europe","2024-06-10",0,0,690,0,4,723,0,0
"Europe","2024-06-11",0,0,690,0,3,726,0,0
"Europe","2024-06-12",0,0,690,0,3,729,0,0
"Europe","2024-06-13",0,0,690,0,3,732,0,0
"Europe","2024-06-14",0,0,690,0,4,736,0,0
"Europe","2024-06-15",0,0,690,0,3,739,0,0
"Europe","2024-06-16",0,0,690,0,3,742,0,0
"Europe","2024-06-17",0,0,690,0,4,746,0,0
"Europe","2024-06-18",0,0,690,0,3,749,0,0
"Europe","2024-06-19",0,0,690,0,3,752,0,0
"Europe","2024-06-20",0,0,690,0,3,755,0,0
"Europe","2024-06-21",0,0,690,0,4,759,0,0
"Europe","2024-06-22",0,0,690,0,3,762,0,0
"Europe","2024-06-23",0,0,690,0,3,765,0,0
"Europe","2024-06-24",0,0,690,0,3,768,0,0
"Europe","2024-06-25",0,0,690,0,4,772,0,0
"Europe","2024-06-26",0,0,690,0,3,775,0,0
"Europe","2024-06-27",0,0,690,0,3,778,0,0
"Europe","2024-06-28",0,0,690,0,3,781,0,0
"Europe","2024-06-29",0,0,690,0,4,785,0,0
"Europe","2024-06-30",0,98,788,0,3,788,0,0
"Europe","2024-07-01",0,0,788,0,5,793,0,0
"Europe","2024-07-02",0,0,788,0,5,798,0,0
"Europe","2024-07-03",0,0,788,0,4,802,0,0
"Europe","2024-07-04",0,0,788,0,5,807,0,0
"Europe","2024-07-05",0,0,788,0,5,812,0,0
"Europe","2024-07-06",0,0,788,0,5,817,0,0
"Europe","2024-07-07",0,0,788,0,4,821,0,0
"Europe","2024-07-08",0,0,788,0,5,826,0,0
"Europe","2024-07-09",0,0,788,0,5,831,0,0
"Europe","2024-07-10",0,0,788,0,5,836,0,0
"Europe","2024-07-11",0,0,788,0,5,841,0,0
"Europe","2024-07-12",0,0,788,0,4,845,0,0
"Europe","2024-07-13",0,0,788,0,5,850,0,0
"Europe","2024-07-14",0,0,788,0,5,855,0,0
"Europe","2024-07-15",0,0,788,0,5,860,0,0
"Europe","2024-07-16",0,0,788,0,4,864,0,0
"Europe","2024-07-17",0,0,788,0,5,869,0,0
"Europe","2024-07-18",0,0,788,0,5,874,0,0
"Europe","2024-07-19",0,0,788,0,5,879,0,0
"Europe","2024-07-20",0,0,788,0,4,883,0,0
"Europe","2024-07-21",0,0,788,0,5,888,0,0
"Europe","2024-07-22",0,0,788,0,5,893,0,0
"Europe","2024-07-23",0,0,788,0,5,898,0,0
"Europe","2024-07-24",0,0,788,0,5,903,0,0
"Europe","2024-07-25",0,0,788,0,4,907,0,0
"Europe","2024-07-26",0,0,788,0,5,912,0,0
"Europe","2024-07-27",0,0,788,0,5,917,0,0
"Europe","2024-07-28",0,0,788,0,5,922,0,0
"Europe","2024-07-29",0,0,788,0,4,926,0,0
"Europe","2024-07-30",0,0,788,0,5,931,0,0
"Europe","2024-07-31",0,148,936,0,5,936,0,0
"Europe","2024-08-01",0,0,936,0,9,945,0,0
"Europe","2024-08-02",0,0,936,0,9,954,0,0
"Europe","2024-08-03",0,0,936,0,9,963,0,0
"Europe","2024-08-04",0,0,936,0,9,972,0,0
"Europe","2024-08-05",0,0,936,0,9,981,0,0
"Europe","2024-08-06",0,0,936,0,9,990,0,0
"Europe","2024-08-07",0,0,936,0,9,999,0,0
"Europe","2024-08-08",0,0,936,0,10,1009,0,0
"Europe","2024-08-09",0,0,936,0,9,1018,0,0
"Europe","2024-08-10",0,0,936,0,9,1027,0,0
"Europe","2024-08-11",0,0,936,0,9,1036,0,0
"Europe","2024-08-12",0,0,936,0,9,1045,0,0
"Europe","2024-08-13",0,0,936,0,9,1054,0,0
"Europe","2024-08-14",0,0,936,0,9,1063,0,0
"Europe","2024-08-15",0,0,936,0,9,1072,0,0
"Europe","2024-08-16",0,0,936,0,9,1081,0,0
"Europe","2024-08-17",0,0,936,0,9,1090,0,0
"Europe","2024-08-18",0,0,936,0,9,1099,0,0
"Europe","2024-08-19",0,0,936,0,9,1108,0,0
"Europe","2024-08-20",0,0,936,0,9,1117,0,0
"Europe","2024-08-21",0,0,936,0,9,1126,0,0
"Europe","2024-08-22",0,0,936,0,9,1135,0,0
"Europe","2024-08-23",0,0,936,0,9,1144,0,0
"Europe","2024-08-24",0,0,936,0,10,1154,0,0
"Europe","2024-08-25",0,0,936,0,9,1163,0,0
"Europe","2024-08-26",0,0,936,0,9,1172,0,0
"Europe","2024-08-27",0,0,936,0,9,1181,0,0
"Europe","2024-08-28",0,0,936,0,9,1190,0,0
"Europe","2024-08-29",0,0,936,0,9,1199,0,0
"Europe","2024-08-30",0,0,936,0,9,1208,0,0
"Europe","2024-08-31",0,281,1217,0,9,1217,0,0
"Europe","2024-09-01",0,0,1217,0,7,1224,0,0
"Europe","2024-09-02",0,0,1217,0,7,1231,0,0
"Europe","2024-09-03",0,0,1217,0,7,1238,0,0
"Europe","2024-09-04",0,0,1217,0,7,1245,0,0
"Europe","2024-09-05",0,0,1217,0,6,1251,0,0
"Europe","2024-09-06",0,0,1217,0,7,1258,0,0
"Europe","2024-09-07",0,0,1217,0,7,1265,0,0
"Europe","2024-09-08",0,0,1217,0,7,1272,0,0
"Europe","2024-09-09",0,0,1217,0,7,1279,0,0
"Europe","2024-09-10",0,0,1217,0,7,1286,0,0
"Europe","2024-09-11",0,0,1217,0,7,1293,0,0
"Europe","2024-09-12",0,0,1217,0,7,1300,0,0
"Europe","2024-09-13",0,0,1217,0,7,1307,0,0
"Europe","2024-09-14",0,0,1217,0,7,1314,0,0
"Europe","2024-09-15",0,0,1217,0,7,1321,0,0
"Europe","2024-09-16",0,0,1217,0,6,1327,0,0
"Europe","2024-09-17",0,0,1217,0,7,1334,0,0
"Europe","2024-09-18",0,0,1217,0,7,1341,0,0
"Europe","2024-09-19",0,0,1217,0,7,1348,0,0
"Europe","2024-09-20",0,0,1217,0,7,1355,0,0
"Europe","2024-09-21",0,0,1217,0,7,1362,0,0
"Europe","2024-09-22",0,0,1217,0,7,1369,0,0
"Europe","2024-09-23",0,0,1217,0,7,1376,0,0
"Europe","2024-09-24",0,0,1217,0,7,1383,0,0
"Europe","2024-09-25",0,0,1217,0,6,1389,0,0
"Europe","2024-09-26",0,0,1217,0,7,1396,0,0
"Europe","2024-09-27",0,0,1217,0,7,1403,0,0
"Europe","2024-09-28",0,0,1217,0,7,1410,0,0
"Europe","2024-09-29",0,0,1217,0,7,1417,0,0
"Europe","2024-09-30",0,207,1424,0,7,1424,0,0
"Europe","2024-10-01",0,0,1424,0,7,1431,0,0
"Europe","2024-10-02",0,0,1424,0,8,1439,0,0
"Europe","2024-10-03",0,0,1424,0,7,1446,0,0
"Europe","2024-10-04",0,0,1424,0,8,1454,0,0
"Europe","2024-10-05",0,0,1424,0,7,1461,0,0
"Europe","2024-10-06",0,0,1424,0,7,1468,0,0
"Europe","2024-10-07",0,0,1424,0,8,1476,0,0
"Europe","2024-10-08",0,0,1424,0,7,1483,0,0
"Europe","2024-10-09",0,0,1424,0,7,1490,0,0
"Europe","2024-10-10",0,0,1424,0,8,1498,0,0
"Europe","2024-10-11",0,0,1424,0,7,1505,0,0
"Europe","2024-10-12",0,0,1424,0,8,1513,0,0
"Europe","2024-10-13",0,0,1424,0,7,1520,0,0
"Europe","2024-10-14",0,0,1424,0,7,1527,0,0
"Europe","2024-10-15",0,0,1424,0,8,1535,0,0
"Europe","2024-10-16",0,0,1424,0,7,1542,0,0
"Europe","2024-10-17",0,0,1424,0,8,1550,0,0
"Europe","2024-10-18",0,0,1424,0,7,1557,0,0
"Europe","2024-10-19",0,0,1424,0,7,1564,0,0
"Europe","2024-10-20",0,0,1424,0,8,1572,0,0
"Europe","2024-10-21",0,0,1424,0,7,1579,0,0
"Europe","2024-10-22",0,0,1424,0,8,1587,0,0
"Europe","2024-10-23",0,0,1424,0,7,1594,0,0
"Europe","2024-10-24",0,0,1424,0,7,1601,0,0
"Europe","2024-10-25",0,0,1424,0,8,1609,0,0
"Europe","2024-10-26",0,0,1424,0,7,1616,0,0
"Europe","2024-10-27",0,0,1424,0,7,1623,0,0
"Europe","2024-10-28",0,0,1424,0,8,1631,0,0
"Europe","2024-10-29",0,0,1424,0,7,1638,0,0
"Europe","2024-10-30",0,0,1424,0,8,1646,0,0
"Europe","2024-10-31",0,229,1653,0,7,1653,0,0
"Europe","2024-11-01",0,0,1653,0,9,1662,0,0
"Europe","2024-11-02",0,0,1653,0,9,1671,0,0
"Europe","2024-11-03",0,0,1653,0,10,1681,0,0
"Europe","2024-11-04",0,0,1653,0,9,1690,0,0
"Europe","2024-11-05",0,0,1653,0,9,1699,0,0
"Europe","2024-11-06",0,0,1653,0,9,1708,0,0
"Europe","2024-11-07",0,0,1653,0,10,1718,0,0
"Europe","2024-11-08",0,0,1653,0,9,1727,0,0
"Europe","2024-11-09",0,0,1653,0,9,1736,0,0
"Europe","2024-11-10",0,0,1653,0,9,1745,0,0
"Europe","2024-11-11",0,0,1653,0,10,1755,0,0
"Europe","2024-11-12",0,0,1653,0,9,1764,0,0
"Europe","2024-11-13",0,0,1653,0,9,1773,0,0
"Europe","2024-11-14",0,0,1653,0,9,1782,0,0
"Europe","2024-11-15",0,0,1653,0,9,1791,0,0
"Europe","2024-11-16",0,0,1653,0,10,1801,0,0
"Europe","2024-11-17",0,0,1653,0,9,1810,0,0
"Europe","2024-11-18",0,0,1653,0,9,1819,0,0
"Europe","2024-11-19",0,0,1653,0,9,1828,0,0
"Europe","2024-11-20",0,0,1653,0,10,1838,0,0
"Europe","2024-11-21",0,0,1653,0,9,1847,0,0
"Europe","2024-11-22",0,0,1653,0,9,1856,0,0
"Europe","2024-11-23",0,0,1653,0,9,1865,0,0
"Europe","2024-11-24",0,0,1653,0,10,1875,0,0
"Europe","2024-11-25",0,0,1653,0,9,1884,0,0
"Europe","2024-11-26",0,0,1653,0,9,1893,0,0
"Europe","2024-11-27",0,0,1653,0,9,1902,0,0
"Europe","2024-11-28",0,0,1653,0,10,1912,0,0
"Europe","2024-11-29",0,0,1653,0,9,1921,0,0
"Europe","2024-11-30",0,277,1930,0,9,1930,0,0
"Europe","2024-12-01",0,0,1930,0,0,1930,0,0
"Europe","2024-12-02",0,0,1930,0,0,1930,0,0
"Europe","2024-12-03",0,0,1930,0,0,1930,0,0
"Europe","2024-12-04",0,0,1930,0,0,1930,0,0
"Europe","2024-12-05",0,0,1930,0,0,1930,0,0
"Europe","2024-12-06",0,0,1930,0,0,1930,0,0
"Europe","2024-12-07",0,0,1930,0,0,1930,0,0
"Europe","2024-12-08",0,0,1930,0,0,1930,0,0
"Europe","2024-12-09",0,0,1930,0,0,1930,0,0
"Europe","2024-12-10",0,0,1930,0,0,1930,0,0
"Europe","2024-12-11",0,0,1930,0,0,1930,0,0
"Europe","2024-12-12",0,0,1930,0,0,1930,0,0
"Europe","2024-12-13",0,0,1930,0,0,1930,0,0
"Europe","2024-12-14",0,0,1930,0,0,1930,0,0
"Europe","2024-12-15",0,0,1930,0,0,1930,0,0
"Europe","2024-12-16",0,0,1930,0,0,1930,0,0
"Europe","2024-12-17",0,0,1930,0,0,1930,0,0
"Europe","2024-12-18",0,0,1930,0,0,1930,0,0
"Europe","2024-12-19",0,0,1930,0,0,1930,0,0
"Europe","2024-12-20",0,0,1930,0,0,1930,0,0
"Europe","2024-12-21",0,0,1930,0,0,1930,0,0
"Europe","2024-12-22",0,0,1930,0,0,1930,0,0
"Europe","2024-12-23",0,0,1930,0,0,1930,0,0
"Europe","2024-12-24",0,0,1930,0,0,1930,0,0
"Europe","2024-12-25",0,0,1930,0,0,1930,0,0
"Europe","2024-12-26",0,0,1930,0,0,1930,0,0
"Europe","2024-12-27",0,0,1930,0,0,1930,0,0
"Europe","2024-12-28",0,0,1930,0,0,1930,0,0
"Europe","2024-12-29",0,0,1930,0,0,1930,0,0
"Europe","2024-12-30",0,0,1930,0,0,1930,0,0
"Europe","2024-12-31",0,0,1930,0,0,1930,0,0
"Europe","2025-01-01",0,0,1930,0,0,1930,0,0
"Europe","2025-01-02",0,0,1930,0,0,1930,0,0
"Europe","2025-01-03",0,0,1930,0,0,1930,0,0
"Europe","2025-01-04",0,0,1930,0,0,1930,0,0
"Europe","2025-01-05",0,0,1930,0,0,1930,0,0
"Europe","2025-01-06",0,0,1930,0,0,1930,0,0
"Europe","2025-01-07",0,0,1930,0,0,1930,0,0
"Europe","2025-01-08",0,0,1930,0,0,1930,0,0
"Europe","2025-01-09",0,0,1930,0,0,1930,0,0
"Europe","2025-01-10",0,0,1930,0,0,1930,0,0
"Europe","2025-01-11",0,0,1930,0,0,1930,0,0
"Europe","2025-01-12",0,0,1930,0,0,1930,0,0
"Europe","2025-01-13",0,0,1930,0,0,1930,0,0
"Finland","2024-01-01",0,0,0,0,0,0,0,0
"Finland","2024-01-02",0,0,0,0,0,0,0,0
"Finland","2024-01-03",0,0,0,0,0,0,0,0
"Finland","2024-01-04",0,0,0,0,0,0,0,0
"Finland","2024-01-05",0,0,0,0,0,0,0,0
"Finland","2024-01-06",0,0,0,0,0,0,0,0
"Finland","2024-01-07",0,0,0,0,0,0,0,0
"Finland","2024-01-08",0,0,0,0,0,0,0,0
"Finland","2024-01-09",0,0,0,0,0,0,0,0
"Finland","2024-01-10",0,0,0,0,0,0,0,0
"Finland","2024-01-11",0,0,0,0,0,0,0,0
"Finland","2024-01-12",0,0,0,0,0,0,0,0
"Finland","2024-01-13",0,0,0,0,0,0,0,0
"Finland","2024-01-14",0,0,0,0,0,0,0,0
"Finland","2024-01-15",0,0,0,0,0,0,0,0
"Finland","2024-01-16",0,0,0,0,0,0,0,0
"Finland","2024-01-17",0,0,0,0,0,0,0,0
"Finland","2024-01-18",0,0,0,0,0,0,0,0
"Finland","2024-01-19",0,0,0,0,0,0,0,0
"Finland","2024-01-20",0,0,0,0,0,0,0,0
"Finland","2024-01-21",0,0,0,0,0,0,0,0
"Finland","2024-01-22",0,0,0,0,0,0,0,0
"Finland","2024-01-23",0,0,0,0,0,0,0,0
"Finland","2024-01-24",0,0,0,0,0,0,0,0
"Finland","2024-01-25",0,0,0,0,0,0,0,0
"Finland","2024-01-26",0,0,0,0,0,0,0,0
"Finland","2024-01-27",0,0,0,0,0,0,0,0
"Finland","2024-01-28",0,0,0,0,0,0,0,0
"Finland","2024-01-29",0,0,0,0,0,0,0,0
"Finland","2024-01-30",0,0,0,0,0,0,0,0
"Finland","2024-01-31",0,0,0,0,0,0,0,0
"Finland","2024-02-01",0,0,0,0,0,0,0,0
"Finland","2024-02-02",0,0,0,0,0,0,0,0
"Finland","2024-02-03",0,0,0,0,0,0,0,0
"Finland","2024-02-04",0,0,0,0,0,0,0,0
"Finland","2024-02-05",0,0,0,0,0,0,0,0
"Finland","2024-02-06",0,0,0,0,0,0,0,0
"Finland","2024-02-07",0,0,0,0,0,0,0,0
"Finland","2024-02-08",0,0,0,0,0,0,0,0
"Finland","2024-02-09",0,0,0,0,0,0,0,0
"Finland","2024-02-10",0,0,0,0,0,0,0,0
"Finland","2024-02-11",0,0,0,0,0,0,0,0
"Finland","2024-02-12",0,0,0,0,0,0,0,0
"Finland","2024-02-13",0,0,0,0,0,0,0,0
"Finland","2024-02-14",0,0,0,0,0,0,0,0
"Finland","2024-02-15",0,0,0,0,0,0,0,0
"Finland","2024-02-16",0,0,0,0,0,0,0,0
"Finland","2024-02-17",0,0,0,0,0,0,0,0
"Finland","2024-02-18",0,0,0,0,0,0,0,0
"Finland","2024-02-19",0,0,0,0,0,0,0,0
"Finland","2024-02-20",0,0,0,0,0,0,0,0
"Finland","2024-02-21",0,0,0,0,0,0,0,0
"Finland","2024-02-22",0,0,0,0,0,0,0,0
"Finland","2024-02-23",0,0,0,0,0,0,0,0
"Finland","2024-02-24",0,0,0,0,0,0,0,0
"Finland","2024-02-25",0,0,0,0,0,0,0,0
"Finland","2024-02-26",0,0,0,0,0,0,0,0
"Finland","2024-02-27",0,0,0,0,0,0,0,0
"Finland","2024-02-28",0,0,0,0,0,0,0,0
"Finland","2024-02-29",0,1,1,0,1,1,0,0
"Finland","2024-03-01",0,0,1,0,0,1,0,0
"Finland","2024-03-02",0,0,1,0,0,1,0,0
"Finland","2024-03-03",0,0,1,0,0,1,0,0
"Finland","2024-03-04",0,0,1,0,0,1,0,0
"Finland","2024-03-05",0,0,1,0,0,1,0,0
"Finland","2024-03-06",0,0,1,0,0,1,0,0
"Finland","2024-03-07",0,0,1,0,0,1,0,0
"Finland","2024-03-08",0,0,1,0,0,1,0,0
"Finland","2024-03-09",0,0,1,0,0,1,0,0
"Finland","2024-03-10",0,0,1,0,0,1,0,0
"Finland","2024-03-11",0,0,1,0,0,1,0,0
"Finland","2024-03-12",0,0,1,0,0,1,0,0
"Finland","2024-03-13",0,0,1,0,0,1,0,0
"Finland","2024-03-14",0,0,1,0,0,1,0,0
"Finland","2024-03-15",0,0,1,0,0,1,0,0
"Finland","2024-03-16",0,0,1,0,0,1,0,0
"Finland","2024-03-17",0,0,1,0,0,1,0,0
"Finland","2024-03-18",0,0,1,0,0,1,0,0
"Finland","2024-03-19",0,0,1,0,0,1,0,0
"Finland","2024-03-20",0,0,1,0,0,1,0,0
"Finland","2024-03-21",0,0,1,0,0,1,0,0
"Finland","2024-03-22",0,0,1,0,0,1,0,0
"Finland","2024-03-23",0,0,1,0,0,1,0,0
"Finland","2024-03-24",0,0,1,0,0,1,0,0
"Finland","2024-03-25",0,0,1,0,0,1,0,0
"Finland","2024-03-26",0,0,1,0,0,1,0,0
"Finland","2024-03-27",0,0,1,0,0,1,0,0
"Finland","2024-03-28",0,0,1,0,0,1,0,0
"Finland","2024-03-29",0,0,1,0,0,1,0,0
"Finland","2024-03-30",0,0,1,0,0,1,0,0
"Finland","2024-03-31",0,0,1,0,0,1,0,0
"Finland","2024-04-01",0,0,1,0,0,1,0,0
"Finland","2024-04-02",0,0,1,0,0,1,0,0
"Finland","2024-04-03",0,0,1,0,0,1,0,0
"Finland","2024-04-04",0,0,1,0,0,1,0,0
"Finland","2024-04-05",0,0,1,0,0,1,0,0
"Finland","2024-04-06",0,0,1,0,0,1,0,0
"Finland","2024-04-07",0,0,1,0,0,1,0,0
"Finland","2024-04-08",0,0,1,0,0,1,0,0
"Finland","2024-04-09",0,0,1,0,0,1,0,0
"Finland","2024-04-10",0,0,1,0,0,1,0,0
"Finland","2024-04-11",0,0,1,0,0,1,0,0
"Finland","2024-04-12",0,0,1,0,0,1,0,0
"Finland","2024-04-13",0,0,1,0,0,1,0,0
"Finland","2024-04-14",0,0,1,0,0,1,0,0
"Finland","2024-04-15",0,0,1,0,0,1,0,0
"Finland","2024-04-16",0,0,1,0,0,1,0,0
"Finland","2024-04-17",0,0,1,0,0,1,0,0
"Finland","2024-04-18",0,0,1,0,0,1,0,0
"Finland","2024-04-19",0,0,1,0,0,1,0,0
"Finland","2024-04-20",0,0,1,0,0,1,0,0
"Finland","2024-04-21",0,0,1,0,0,1,0,0
"Finland","2024-04-22",0,0,1,0,0,1,0,0
"Finland","2024-04-23",0,0,1,0,0,1,0,0
"Finland","2024-04-24",0,0,1,0,0,1,0,0
"Finland","2024-04-25",0,0,1,0,0,1,0,0
"Finland","2024-04-26",0,0,1,0,0,1,0,0
"Finland","2024-04-27",0,0,1,0,0,1,0,0
"Finland","2024-04-28",0,0,1,0,0,1,0,0
"Finland","2024-04-29",0,0,1,0,0,1,0,0
"Finland","2024-04-30",0,0,1,0,0,1,0,0
"Finland","2024-05-01",0,0,1,0,0,1,0,0
"Finland","2024-05-02",0,0,1,0,0,1,0,0
"Finland","2024-05-03",0,0,1,0,0,1,0,0
"Finland","2024-05-04",0,0,1,0,0,1,0,0
"Finland","2024-05-05",0,0,1,0,0,1,0,0
"Finland","2024-05-06",0,0,1,0,0,1,0,0
"Finland","2024-05-07",0,0,1,0,0,1,0,0
"Finland","2024-05-08",0,0,1,0,0,1,0,0
"Finland","2024-05-09",0,0,1,0,0,1,0,0
"Finland","2024-05-10",0,0,1,0,0,1,0,0
"Finland","2024-05-11",0,0,1,0,0,1,0,0
"Finland","2024-05-12",0,0,1,0,0,1,0,0
"Finland","2024-05-13",0,0,1,0,0,1,0,0
"Finland","2024-05-14",0,0,1,0,0,1,0,0
"Finland","2024-05-15",0,0,1,0,0,1,0,0
"Finland","2024-05-16",0,0,1,0,0,1,0,0
"Finland","2024-05-17",0,0,1,0,0,1,0,0
"Finland","2024-05-18",0,0,1,0,0,1,0,0
"Finland","2024-05-19",0,0,1,0,0,1,0,0
"Finland","2024-05-20",0,0,1,0,0,1,0,0
"Finland","2024-05-21",0,0,1,0,0,1,0,0
"Finland","2024-05-22",0,0,1,0,0,1,0,0
"Finland","2024-05-23",0,0,1,0,0,1,0,0
"Finland","2024-05-24",0,0,1,0,0,1,0,0
"Finland","2024-05-25",0,0,1,0,0,1,0,0
"Finland","2024-05-26",0,0,1,0,0,1,0,0
"Finland","2024-05-27",0,0,1,0,0,1,0,0
"Finland","2024-05-28",0,0,1,0,0,1,0,0
"Finland","2024-05-29",0,0,1,0,0,1,0,0
"Finland","2024-05-30",0,0,1,0,0,1,0,0
"Finland","2024-05-31",0,0,1,0,0,1,0,0
"Finland","2024-06-01",0,0,1,0,0,1,0,0
"Finland","2024-06-02",0,0,1,0,0,1,0,0
"Finland","2024-06-03",0,0,1,0,0,1,0,0
"Finland","2024-06-04",0,0,1,0,0,1,0,0
"Finland","2024-06-05",0,0,1,0,0,1,0,0
"Finland","2024-06-06",0,0,1,0,0,1,0,0
"Finland","2024-06-07",0,0,1,0,0,1,0,0
"Finland","2024-06-08",0,0,1,0,0,1,0,0
"Finland","2024-06-09",0,0,1,0,0,1,0,0
"Finland","2024-06-10",0,0,1,0,0,1,0,0
"Finland","2024-06-11",0,0,1,0,0,1,0,0
"Finland","2024-06-12",0,0,1,0,0,1,0,0
"Finland","2024-06-13",0,0,1,0,0,1,0,0
"Finland","2024-06-14",0,0,1,0,0,1,0,0
"Finland","2024-06-15",0,0,1,0,0,1,0,0
"Finland","2024-06-16",0,0,1,0,0,1,0,0
"Finland","2024-06-17",0,0,1,0,0,1,0,0
"Finland","2024-06-18",0,0,1,0,0,1,0,0
"Finland","2024-06-19",0,0,1,0,0,1,0,0
"Finland","2024-06-20",0,0,1,0,0,1,0,0
"Finland","2024-06-21",0,0,1,0,0,1,0,0
"Finland","2024-06-22",0,0,1,0,0,1,0,0
"Finland","2024-06-23",0,0,1,0,0,1,0,0
"Finland","2024-06-24",0,0,1,0,0,1,0,0
"Finland","2024-06-25",0,0,1,0,0,1,0,0
"Finland","2024-06-26",0,0,1,0,0,1,0,0
"Finland","2024-06-27",0,0,1,0,0,1,0,0
"Finland","2024-06-28",0,0,1,0,0,1,0,0
"Finland","2024-06-29",0,0,1,0,0,1,0,0
"Finland","2024-06-30",0,0,1,0,0,1,0,0
"Finland","2024-07-01",0,0,1,0,0,1,0,0
"Finland","2024-07-02",0,0,1,0,0,1,0,0
"Finland","2024-07-03",0,0,1,0,0,1,0,0
"Finland","2024-07-04",0,0,1,0,0,1,0,0
"Finland","2024-07-05",0,0,1,0,0,1,0,0
"Finland","2024-07-06",0,0,1,0,0,1,0,0
"Finland","2024-07-07",0,0,1,0,0,1,0,0
"Finland","2024-07-08",0,0,1,0,0,1,0,0
"Finland","2024-07-09",0,0,1,0,0,1,0,0
"Finland","2024-07-10",0,0,1,0,0,1,0,0
"Finland","2024-07-11",0,0,1,0,0,1,0,0
"Finland","2024-07-12",0,0,1,0,0,1,0,0
"Finland","2024-07-13",0,0,1,0,0,1,0,0
"Finland","2024-07-14",0,0,1,0,0,1,0,0
"Finland","2024-07-15",0,0,1,0,0,1,0,0
"Finland","2024-07-16",0,0,1,0,0,1,0,0
"Finland","2024-07-17",0,0,1,0,0,1,0,0
"Finland","2024-07-18",0,0,1,0,0,1,0,0
"Finland","2024-07-19",0,0,1,0,0,1,0,0
"Finland","2024-07-20",0,0,1,0,0,1,0,0
"Finland","2024-07-21",0,0,1,0,0,1,0,0
"Finland","2024-07-22",0,0,1,0,0,1,0,0
"Finland","2024-07-23",0,0,1,0,0,1,0,0
"Finland","2024-07-24",0,0,1,0,0,1,0,0
"Finland","2024-07-25",0,0,1,0,0,1,0,0
"Finland","2024-07-26",0,0,1,0,0,1,0,0
"Finland","2024-07-27",0,0,1,0,0,1,0,0
"Finland","2024-07-28",0,0,1,0,0,1,0,0
"Finland","2024-07-29",0,0,1,0,0,1,0,0
"Finland","2024-07-30",0,0,1,0,0,1,0,0
"Finland","2024-07-31",0,0,1,0,0,1,0,0
"Finland","2024-08-01",0,0,1,0,0,1,0,0
"Finland","2024-08-02",0,0,1,0,0,1,0,0
"Finland","2024-08-03",0,0,1,0,0,1,0,0
"Finland","2024-08-04",0,0,1,0,0,1,0,0
"Finland","2024-08-05",0,0,1,0,0,1,0,0
"Finland","2024-08-06",0,0,1,0,0,1,0,0
"Finland","2024-08-07",0,0,1,0,0,1,0,0
"Finland","2024-08-08",0,0,1,0,0,1,0,0
"Finland","2024-08-09",0,0,1,0,0,1,0,0
"Finland","2024-08-10",0,0,1,0,0,1,0,0
"Finland","2024-08-11",0,0,1,0,0,1,0,0
"Finland","2024-08-12",0,0,1,0,0,1,0,0
"Finland","2024-08-13",0,0,1,0,0,1,0,0
"Finland","2024-08-14",0,0,1,0,0,1,0,0
"Finland","2024-08-15",0,0,1,0,0,1,0,0
"Finland","2024-08-16",0,0,1,0,0,1,0,0
"Finland","2024-08-17",0,0,1,0,0,1,0,0
"Finland","2024-08-18",0,0,1,0,0,1,0,0
"Finland","2024-08-19",0,0,1,0,0,1,0,0
"Finland","2024-08-20",0,0,1,0,0,1,0,0
"Finland","2024-08-21",0,0,1,0,0,1,0,0
"Finland","2024-08-22",0,0,1,0,0,1,0,0
"Finland","2024-08-23",0,0,1,0,0,1,0,0
"Finland","2024-08-24",0,0,1,0,0,1,0,0
"Finland","2024-08-25",0,0,1,0,0,1,0,0
"Finland","2024-08-26",0,0,1,0,0,1,0,0
"Finland","2024-08-27",0,0,1,0,0,1,0,0
"Finland","2024-08-28",0,0,1,0,0,1,0,0
"Finland","2024-08-29",0,0,1,0,0,1,0,0
"Finland","2024-08-30",0,0,1,0,0,1,0,0
"Finland","2024-08-31",0,0,1,0,0,1,0,0
"Finland","2024-09-01",0,0,1,0,0,1,0,0
"Finland","2024-09-02",0,0,1,0,0,1,0,0
"Finland","2024-09-03",0,0,1,0,0,1,0,0
"Finland","2024-09-04",0,0,1,0,0,1,0,0
"Finland","2024-09-05",0,0,1,0,0,1,0,0
"Finland","2024-09-06",0,0,1,0,0,1,0,0
"Finland","2024-09-07",0,0,1,0,0,1,0,0
"Finland","2024-09-08",0,0,1,0,0,1,0,0
"Finland","2024-09-09",0,0,1,0,0,1,0,0
"Finland","2024-09-10",0,0,1,0,0,1,0,0
"Finland","2024-09-11",0,0,1,0,0,1,0,0
"Finland","2024-09-12",0,0,1,0,0,1,0,0
"Finland","2024-09-13",0,0,1,0,0,1,0,0
"Finland","2024-09-14",0,0,1,0,0,1,0,0
"Finland","2024-09-15",0,0,1,0,0,1,0,0
"Finland","2024-09-16",0,0,1,0,0,1,0,0
"Finland","2024-09-17",0,0,1,0,0,1,0,0
"Finland","2024-09-18",0,0,1,0,0,1,0,0
"Finland","2024-09-19",0,0,1,0,0,1,0,0
"Finland","2024-09-20",0,0,1,0,0,1,0,0
"Finland","2024-09-21",0,0,1,0,0,1,0,0
"Finland","2024-09-22",0,0,1,0,0,1,0,0
"Finland","2024-09-23",0,0,1,0,0,1,0,0
"Finland","2024-09-24",0,0,1,0,0,1,0,0
"Finland","2024-09-25",0,0,1,0,0,1,0,0
"Finland","2024-09-26",0,0,1,0,0,1,0,0
"Finland","2024-09-27",0,0,1,0,0,1,0,0
"Finland","2024-09-28",0,0,1,0,0,1,0,0
"Finland","2024-09-29",0,0,1,0,0,1,0,0
"Finland","2024-09-30",0,0,1,0,0,1,0,0
"Finland","2024-10-01",0,0,1,0,0,1,0,0
"Finland","2024-10-02",0,0,1,0,0,1,0,0
"Finland","2024-10-03",0,0,1,0,0,1,0,0
"Finland","2024-10-04",0,0,1,0,0,1,0,0
"Finland","2024-10-05",0,0,1,0,0,1,0,0
"Finland","2024-10-06",0,0,1,0,0,1,0,0
"Finland","2024-10-07",0,0,1,0,0,1,0,0
"Finland","2024-10-08",0,0,1,0,0,1,0,0
"Finland","2024-10-09",0,0,1,0,0,1,0,0
"Finland","2024-10-10",0,0,1,0,0,1,0,0
"Finland","2024-10-11",0,0,1,0,0,1,0,0
"Finland","2024-10-12",0,0,1,0,0,1,0,0
"Finland","2024-10-13",0,0,1,0,0,1,0,0
"Finland","2024-10-14",0,0,1,0,0,1,0,0
"Finland","2024-10-15",0,0,1,0,0,1,0,0
"Finland","2024-10-16",0,0,1,0,0,1,0,0
"Finland","2024-10-17",0,0,1,0,0,1,0,0
"Finland","2024-10-18",0,0,1,0,0,1,0,0
"Finland","2024-10-19",0,0,1,0,0,1,0,0
"Finland","2024-10-20",0,0,1,0,0,1,0,0
"Finland","2024-10-21",0,0,1,0,0,1,0,0
"Finland","2024-10-22",0,0,1,0,0,1,0,0
"Finland","2024-10-23",0,0,1,0,0,1,0,0
"Finland","2024-10-24",0,0,1,0,0,1,0,0
"Finland","2024-10-25",0,0,1,0,0,1,0,0
"Finland","2024-10-26",0,0,1,0,0,1,0,0
"Finland","2024-10-27",0,0,1,0,0,1,0,0
"Finland","2024-10-28",0,0,1,0,0,1,0,0
"Finland","2024-10-29",0,0,1,0,0,1,0,0
"Finland","2024-10-30",0,0,1,0,0,1,0,0
"Finland","2024-10-31",0,0,1,0,0,1,0,0
"Finland","2024-11-01",0,0,1,0,0,1,0,0
"Finland","2024-11-02",0,0,1,0,0,1,0,0
"Finland","2024-11-03",0,0,1,0,0,1,0,0
"Finland","2024-11-04",0,0,1,0,0,1,0,0
"Finland","2024-11-05",0,0,1,0,0,1,0,0
"Finland","2024-11-06",0,0,1,0,0,1,0,0
"Finland","2024-11-07",0,0,1,0,0,1,0,0
"Finland","2024-11-08",0,0,1,0,0,1,0,0
"Finland","2024-11-09",0,0,1,0,0,1,0,0
"Finland","2024-11-10",0,0,1,0,0,1,0,0
"Finland","2024-11-11",0,0,1,0,0,1,0,0
"Finland","2024-11-12",0,0,1,0,0,1,0,0
"Finland","2024-11-13",0,0,1,0,0,1,0,0
"Finland","2024-11-14",0,0,1,0,0,1,0,0
"Finland","2024-11-15",0,0,1,0,0,1,0,0
"Finland","2024-11-16",0,0,1,0,0,1,0,0
"Finland","2024-11-17",0,0,1,0,0,1,0,0
"Finland","2024-11-18",0,0,1,0,0,1,0,0
"Finland","2024-11-19",0,0,1,0,0,1,0,0
"Finland","2024-11-20",0,0,1,0,0,1,0,0
"Finland","2024-11-21",0,0,1,0,0,1,0,0
"Finland","2024-11-22",0,0,1,0,0,1,0,0
"Finland","2024-11-23",0,0,1,0,0,1,0,0
"Finland","2024-11-24",0,0,1,0,0,1,0,0
"Finland","2024-11-25",0,0,1,0,0,1,0,0
"Finland","2024-11-26",0,0,1,0,0,1,0,0
"Finland","2024-11-27",0,0,1,0,0,1,0,0
"Finland","2024-11-28",0,0,1,0,0,1,0,0
"Finland","2024-11-29",0,0,1,0,0,1,0,0
"Finland","2024-11-30",0,0,1,0,0,1,0,0
"Finland","2024-12-01",0,0,1,0,0,1,0,0
"Finland","2024-12-02",0,0,1,0,0,1,0,0
"Finland","2024-12-03",0,0,1,0,0,1,0,0
"Finland","2024-12-04",0,0,1,0,0,1,0,0
"Finland","2024-12-05",0,0,1,0,0,1,0,0
"Finland","2024-12-06",0,0,1,0,0,1,0,0
"Finland","2024-12-07",0,0,1,0,0,1,0,0
"Finland","2024-12-08",0,0,1,0,0,1,0,0
"Finland","2024-12-09",0,0,1,0,0,1,0,0
"Finland","2024-12-10",0,0,1,0,0,1,0,0
"Finland","2024-12-11",0,0,1,0,0,1,0,0
"Finland","2024-12-12",0,0,1,0,0,1,0,0
"Finland","2024-12-13",0,0,1,0,0,1,0,0
"Finland","2024-12-14",0,0,1,0,0,1,0,0
"Finland","2024-12-15",0,0,1,0,0,1,0,0
"Finland","2024-12-16",0,0,1,0,0,1,0,0
"Finland","2024-12-17",0,0,1,0,0,1,0,0
"Finland","2024-12-18",0,0,1,0,0,1,0,0
"Finland","2024-12-19",0,0,1,0,0,1,0,0
"Finland","2024-12-20",0,0,1,0,0,1,0,0
"Finland","2024-12-21",0,0,1,0,0,1,0,0
"Finland","2024-12-22",0,0,1,0,0,1,0,0
"Finland","2024-12-23",0,0,1,0,0,1,0,0
"Finland","2024-12-24",0,0,1,0,0,1,0,0
"Finland","2024-12-25",0,0,1,0,0,1,0,0
"Finland","2024-12-26",0,0,1,0,0,1,0,0
"Finland","2024-12-27",0,0,1,0,0,1,0,0
"Finland","2024-12-28",0,0,1,0,0,1,0,0
"Finland","2024-12-29",0,0,1,0,0,1,0,0
"Finland","2024-12-30",0,0,1,0,0,1,0,0
"Finland","2024-12-31",0,0,1,0,0,1,0,0
"Finland","2025-01-01",0,0,1,0,0,1,0,0
"Finland","2025-01-02",0,0,1,0,0,1,0,0
"Finland","2025-01-03",0,0,1,0,0,1,0,0
"Finland","2025-01-04",0,0,1,0,0,1,0,0
"Finland","2025-01-05",0,0,1,0,0,1,0,0
"Finland","2025-01-06",0,0,1,0,0,1,0,0
"Finland","2025-01-07",0,0,1,0,0,1,0,0
"Finland","2025-01-08",0,0,1,0,0,1,0,0
"Finland","2025-01-09",0,0,1,0,0,1,0,0
"Finland","2025-01-10",0,0,1,0,0,1,0,0
"Finland","2025-01-11",0,0,1,0,0,1,0,0
"Finland","2025-01-12",0,0,1,0,0,1,0,0
"Finland","2025-01-13",0,0,1,0,0,1,0,0
"France","2024-01-01",0,0,0,0,0,0,0,0
"France","2024-01-02",0,0,0,0,0,0,0,0
"France","2024-01-03",0,0,0,0,0,0,0,0
"France","2024-01-04",0,0,0,0,0,0,0,0
"France","2024-01-05",0,0,0,0,0,0,0,0
"France","2024-01-06",0,0,0,0,0,0,0,0
"France","2024-01-07",0,0,0,0,0,0,0,0
"France","2024-01-08",0,0,0,0,0,0,0,0
"France","2024-01-09",0,0,0,0,0,0,0,0
"France","2024-01-10",0,0,0,0,0,0,0,0
"France","2024-01-11",0,0,0,0,0,0,0,0
"France","2024-01-12",0,0,0,0,0,0,0,0
"France","2024-01-13",0,0,0,0,0,0,0,0
"France","2024-01-14",0,0,0,0,0,0,0,0
"France","2024-01-15",0,0,0,0,0,0,0,0
"France","2024-01-16",0,0,0,0,0,0,0,0
"France","2024-01-17",0,0,0,0,0,0,0,0
"France","2024-01-18",0,0,0,0,0,0,0,0
"France","2024-01-19",0,0,0,0,0,0,0,0
"France","2024-01-20",0,0,0,0,0,0,0,0
"France","2024-01-21",0,0,0,0,0,0,0,0
"France","2024-01-22",0,0,0,0,0,0,0,0
"France","2024-01-23",0,0,0,0,0,0,0,0
"France","2024-01-24",0,0,0,0,0,0,0,0
"France","2024-01-25",0,0,0,0,0,0,0,0
"France","2024-01-26",0,0,0,0,0,0,0,0
"France","2024-01-27",0,0,0,0,0,0,0,0
"France","2024-01-28",0,0,0,0,0,0,0,0
"France","2024-01-29",0,0,0,0,0,0,0,0
"France","2024-01-30",0,0,0,0,0,0,0,0
"France","2024-01-31",0,8,8,0,8,8,0,0
"France","2024-02-01",0,0,8,0,1,9,0,0
"France","2024-02-02",0,0,8,0,0,9,0,0
"France","2024-02-03",0,0,8,0,1,10,0,0
"France","2024-02-04",0,0,8,0,0,10,0,0
"France","2024-02-05",0,0,8,0,1,11,0,0
"France","2024-02-06",0,0,8,0,0,11,0,0
"France","2024-02-07",0,0,8,0,1,12,0,0
"France","2024-02-08",0,0,8,0,0,12,0,0
"France","2024-02-09",0,0,8,0,1,13,0,0
"France","2024-02-10",0,0,8,0,1,14,0,0
"France","2024-02-11",0,0,8,0,0,14,0,0
"France","2024-02-12",0,0,8,0,1,15,0,0
"France","2024-02-13",0,0,8,0,0,15,0,0
"France","2024-02-14",0,0,8,0,1,16,0,0
"France","2024-02-15",0,0,8,0,0,16,0,0
"France","2024-02-16",0,0,8,0,1,17,0,0
"France","2024-02-17",0,0,8,0,0,17,0,0
"France","2024-02-18",0,0,8,0,1,18,0,0
"France","2024-02-19",0,0,8,0,0,18,0,0
"France","2024-02-20",0,0,8,0,1,19,0,0
"France","2024-02-21",0,0,8,0,1,20,0,0
"France","2024-02-22",0,0,8,0,0,20,0,0
"France","2024-02-23",0,0,8,0,1,21,0,0
"France","2024-02-24",0,0,8,0,0,21,0,0
"France","2024-02-25",0,0,8,0,1,22,0,0
"France","2024-02-26",0,0,8,0,0,22,0,0
"France","2024-02-27",0,0,8,0,1,23,0,0
"France","2024-02-28",0,0,8,0,0,23,0,0
"France","2024-02-29",0,16,24,0,1,24,0,0
"France","2024-03-01",0,0,24,0,0,24,0,0
"France","2024-03-02",0,0,24,0,1,25,0,0
"France","2024-03-03",0,0,24,0,0,25,0,0
"France","2024-03-04",0,0,24,0,0,25,0,0
"France","2024-03-05",0,0,24,0,1,26,0,0
"France","2024-03-06",0,0,24,0,0,26,0,0
"France","2024-03-07",0,0,24,0,0,26,0,0
"France","2024-03-08",0,0,24,0,1,27,0,0
"France","2024-03-09",0,0,24,0,0,27,0,0
"France","2024-03-10",0,0,24,0,1,28,0,0
"France","2024-03-11",0,0,24,0,0,28,0,0
"France","2024-03-12",0,0,24,0,0,28,0,0
"France","2024-03-13",0,0,24,0,1,29,0,0
"France","2024-03-14",0,0,24,0,0,29,0,0
"France","2024-03-15",0,0,24,0,0,29,0,0
"France","2024-03-16",0,0,24,0,1,30,0,0
"France","2024-03-17",0,0,24,0,0,30,0,0
"France","2024-03-18",0,0,24,0,0,30,0,0
"France","2024-03-19",0,0,24,0,1,31,0,0
"France","2024-03-20",0,0,24,0,0,31,0,0
"France","2024-03-21",0,0,24,0,0,31,0,0
"France","2024-03-22",0,0,24,0,1,32,0,0
"France","2024-03-23",0,0,24,0,0,32,0,0
"France","2024-03-24",0,0,24,0,1,33,0,0
"France","2024-03-25",0,0,24,0,0,33,0,0
"France","2024-03-26",0,0,24,0,0,33,0,0
"France","2024-03-27",0,0,24,0,1,34,0,0
"France","2024-03-28",0,0,24,0,0,34,0,0
"France","2024-03-29",0,0,24,0,0,34,0,0
"France","2024-03-30",0,0,24,0,1,35,0,0
"France","2024-03-31",0,11,35,0,0,35,0,0
"France","2024-04-01",0,0,35,0,0,35,0,0
"France","2024-04-02",0,0,35,0,1,36,0,0
"France","2024-04-03",0,0,35,0,0,36,0,0
"France","2024-04-04",0,0,35,0,1,37,0,0
"France","2024-04-05",0,0,35,0,0,37,0,0
"France","2024-04-06",0,0,35,0,0,37,0,0
"France","2024-04-07",0,0,35,0,1,38,0,0
"France","2024-04-08",0,0,35,0,0,38,0,0
"France","2024-04-09",0,0,35,0,1,39,0,0
"France","2024-04-10",0,0,35,0,0,39,0,0
"France","2024-04-11",0,0,35,0,0,39,0,0
"France","2024-04-12",0,0,35,0,1,40,0,0
"France","2024-04-13",0,0,35,0,0,40,0,0
"France","2024-04-14",0,0,35,0,1,41,0,0
"France","2024-04-15",0,0,35,0,0,41,0,0
"France","2024-04-16",0,0,35,0,0,41,0,0
"France","2024-04-17",0,0,35,0,1,42,0,0
"France","2024-04-18",0,0,35,0,0,42,0,0
"France","2024-04-19",0,0,35,0,1,43,0,0
"France","2024-04-20",0,0,35,0,0,43,0,0
"France","2024-04-21",0,0,35,0,0,43,0,0
"France","2024-04-22",0,0,35,0,1,44,0,0
"France","2024-04-23",0,0,35,0,0,44,0,0
"France","2024-04-24",0,0,35,0,1,45,0,0
"France","2024-04-25",0,0,35,0,0,45,0,0
"France","2024-04-26",0,0,35,0,0,45,0,0
"France","2024-04-27",0,0,35,0,1,46,0,0
"France","2024-04-28",0,0,35,0,0,46,0,0
"France","2024-04-29",0,0,35,0,1,47,0,0
"France","2024-04-30",0,12,47,0,0,47,0,0
"France","2024-05-01",0,0,47,0,1,48,0,0
"France","2024-05-02",0,0,47,0,1,49,0,0
"France","2024-05-03",0,0,47,0,1,50,0,0
"France","2024-05-04",0,0,47,0,1,51,0,0
"France","2024-05-05",0,0,47,0,1,52,0,0
"France","2024-05-06",0,0,47,0,1,53,0,0
"France","2024-05-07",0,0,47,0,1,54,0,0
"France","2024-05-08",0,0,47,0,1,55,0,0
"France","2024-05-09",0,0,47,0,1,56,0,0
"France","2024-05-10",0,0,47,0,1,57,0,0
"France","2024-05-11",0,0,47,0,1,58,0,0
"France","2024-05-12",0,0,47,0,1,59,0,0
"France","2024-05-13",0,0,47,0,1,60,0,0
"France","2024-05-14",0,0,47,0,1,61,0,0
"France","2024-05-15",0,0,47,0,1,62,0,0
"France","2024-05-16",0,0,47,0,1,63,0,0
"France","2024-05-17",0,0,47,0,1,64,0,0
"France","2024-05-18",0,0,47,0,1,65,0,0
"France","2024-05-19",0,0,47,0,1,66,0,0
"France","2024-05-20",0,0,47,0,1,67,0,0
"France","2024-05-21",0,0,47,0,1,68,0,0
"France","2024-05-22",0,0,47,0,1,69,0,0
"France","2024-05-23",0,0,47,0,1,70,0,0
"France","2024-05-24",0,0,47,0,1,71,0,0
"France","2024-05-25",0,0,47,0,1,72,0,0
"France","2024-05-26",0,0,47,0,1,73,0,0
"France","2024-05-27",0,0,47,0,1,74,0,0
"France","2024-05-28",0,0,47,0,1,75,0,0
"France","2024-05-29",0,0,47,0,1,76,0,0
"France","2024-05-30",0,0,47,0,1,77,0,0
"France","2024-05-31",0,31,78,0,1,78,0,0
"France","2024-06-01",0,0,78,0,1,79,0,0
"France","2024-06-02",0,0,78,0,1,80,0,0
"France","2024-06-03",0,0,78,0,0,80,0,0
"France","2024-06-04",0,0,78,0,1,81,0,0
"France","2024-06-05",0,0,78,0,1,82,0,0
"France","2024-06-06",0,0,78,0,1,83,0,0
"France","2024-06-07",0,0,78,0,0,83,0,0
"France","2024-06-08",0,0,78,0,1,84,0,0
"France","2024-06-09",0,0,78,0,1,85,0,0
"France","2024-06-10",0,0,78,0,1,86,0,0
"France","2024-06-11",0,0,78,0,0,86,0,0
"France","2024-06-12",0,0,78,0,1,87,0,0
"France","2024-06-13",0,0,78,0,1,88,0,0
"France","2024-06-14",0,0,78,0,1,89,0,0
"France","2024-06-15",0,0,78,0,1,90,0,0
"France","2024-06-16",0,0,78,0,0,90,0,0
"France","2024-06-17",0,0,78,0,1,91,0,0
"France","2024-06-18",0,0,78,0,1,92,0,0
"France","2024-06-19",0,0,78,0,1,93,0,0
"France","2024-06-20",0,0,78,0,0,93,0,0
"France","2024-06-21",0,0,78,0,1,94,0,0
"France","2024-06-22",0,0,78,0,1,95,0,0
"France","2024-06-23",0,0,78,0,1,96,0,0
"France","2024-06-24",0,0,78,0,0,96,0,0
"France","2024-06-25",0,0,78,0,1,97,0,0
"France","2024-06-26",0,0,78,0,1,98,0,0
"France","2024-06-27",0,0,78,0,1,99,0,0
"France","2024-06-28",0,0,78,0,0,99,0,0
"France","2024-06-29",0,0,78,0,1,100,0,0
"France","2024-06-30",0,23,101,0,1,101,0,0
"France","2024-07-01",0,0,101,0,0,101,0,0
"France","2024-07-02",0,0,101,0,1,102,0,0
"France","2024-07-03",0,0,101,0,0,102,0,0
"France","2024-07-04",0,0,101,0,0,102,0,0
"France","2024-07-05",0,0,101,0,1,103,0,0
"France","2024-07-06",0,0,101,0,0,103,0,0
"France","2024-07-07",0,0,101,0,0,103,0,0
"France","2024-07-08",0,0,101,0,1,104,0,0
"France","2024-07-09",0,0,101,0,0,104,0,0
"France","2024-07-10",0,0,101,0,1,105,0,0
"France","2024-07-11",0,0,101,0,0,105,0,0
"France","2024-07-12",0,0,101,0,0,105,0,0
"France","2024-07-13",0,0,101,0,1,106,0,0
"France","2024-07-14",0,0,101,0,0,106,0,0
"France","2024-07-15",0,0,101,0,0,106,0,0
"France","2024-07-16",0,0,101,0,1,107,0,0
"France","2024-07-17",0,0,101,0,0,107,0,0
"France","2024-07-18",0,0,101,0,0,107,0,0
"France","2024-07-19",0,0,101,0,1,108,0,0
"France","2024-07-20",0,0,101,0,0,108,0,0
"France","2024-07-21",0,0,101,0,0,108,0,0
"France","2024-07-22",0,0,101,0,1,109,0,0
"France","2024-07-23",0,0,101,0,0,109,0,0
"France","2024-07-24",0,0,101,0,1,110,0,0
"France","2024-07-25",0,0,101,0,0,110,0,0
"France","2024-07-26",0,0,101,0,0,110,0,0
"France","2024-07-27",0,0,101,0,1,111,0,0
"France","2024-07-28",0,0,101,0,0,111,0,0
"France","2024-07-29",0,0,101,0,0,111,0,0
"France","2024-07-30",0,0,101,0,1,112,0,0
"France","2024-07-31",0,11,112,0,0,112,0,0
"France","2024-08-01",0,0,112,0,1,113,0,0
"France","2024-08-02",0,0,112,0,1,114,0,0
"France","2024-08-03",0,0,112,0,0,114,0,0
"France","2024-08-04",0,0,112,0,1,115,0,0
"France","2024-08-05",0,0,112,0,1,116,0,0
"France","2024-08-06",0,0,112,0,1,117,0,0
"France","2024-08-07",0,0,112,0,0,117,0,0
"France","2024-08-08",0,0,112,0,1,118,0,0
"France","2024-08-09",0,0,112,0,1,119,0,0
"France","2024-08-10",0,0,112,0,1,120,0,0
"France","2024-08-11",0,0,112,0,1,121,0,0
"France","2024-08-12",0,0,112,0,0,121,0,0
"France","2024-08-13",0,0,112,0,1,122,0,0
"France","2024-08-14",0,0,112,0,1,123,0,0
"France","2024-08-15",0,0,112,0,1,124,0,0
"France","2024-08-16",0,0,112,0,0,124,0,0
"France","2024-08-17",0,0,112,0,1,125,0,0
"France","2024-08-18",0,0,112,0,1,126,0,0
"France","2024-08-19",0,0,112,0,1,127,0,0
"France","2024-08-20",0,0,112,0,0,127,0,0
"France","2024-08-21",0,0,112,0,1,128,0,0
"France","2024-08-22",0,0,112,0,1,129,0,0
"France","2024-08-23",0,0,112,0,1,130,0,0
"France","2024-08-24",0,0,112,0,1,131,0,0
"France","2024-08-25",0,0,112,0,0,131,0,0
"France","2024-08-26",0,0,112,0,1,132,0,0
"France","2024-08-27",0,0,112,0,1,133,0,0
"France","2024-08-28",0,0,112,0,1,134,0,0
"France","2024-08-29",0,0,112,0,0,134,0,0
"France","2024-08-30",0,0,112,0,1,135,0,0
"France","2024-08-31",0,24,136,0,1,136,0,0
"France","2024-09-01",0,0,136,0,1,137,0,0
"France","2024-09-02",0,0,136,0,1,138,0,0
"France","2024-09-03",0,0,136,0,1,139,0,0
"France","2024-09-04",0,0,136,0,1,140,0,0
"France","2024-09-05",0,0,136,0,0,140,0,0
"France","2024-09-06",0,0,136,0,1,141,0,0
"France","2024-09-07",0,0,136,0,1,142,0,0
"France","2024-09-08",0,0,136,0,1,143,0,0
"France","2024-09-09",0,0,136,0,1,144,0,0
"France","2024-09-10",0,0,136,0,1,145,0,0
"France","2024-09-11",0,0,136,0,1,146,0,0
"France","2024-09-12",0,0,136,0,1,147,0,0
"France","2024-09-13",0,0,136,0,1,148,0,0
"France","2024-09-14",0,0,136,0,1,149,0,0
"France","2024-09-15",0,0,136,0,1,150,0,0
"France","2024-09-16",0,0,136,0,0,150,0,0
"France","2024-09-17",0,0,136,0,1,151,0,0
"France","2024-09-18",0,0,136,0,1,152,0,0
"France","2024-09-19",0,0,136,0,1,153,0,0
"France","2024-09-20",0,0,136,0,1,154,0,0
"France","2024-09-21",0,0,136,0,1,155,0,0
"France","2024-09-22",0,0,136,0,1,156,0,0
"France","2024-09-23",0,0,136,0,1,157,0,0
"France","2024-09-24",0,0,136,0,1,158,0,0
"France","2024-09-25",0,0,136,0,0,158,0,0
"France","2024-09-26",0,0,136,0,1,159,0,0
"France","2024-09-27",0,0,136,0,1,160,0,0
"France","2024-09-28",0,0,136,0,1,161,0,0
"France","2024-09-29",0,0,136,0,1,162,0,0
"France","2024-09-30",0,27,163,0,1,163,0,0
"France","2024-10-01",0,0,163,0,1,164,0,0
"France","2024-10-02",0,0,163,0,1,165,0,0
"France","2024-10-03",0,0,163,0,1,166,0,0
"France","2024-10-04",0,0,163,0,1,167,0,0
"France","2024-10-05",0,0,163,0,1,168,0,0
"France","2024-10-06",0,0,163,0,1,169,0,0
"France","2024-10-07",0,0,163,0,1,170,0,0
"France","2024-10-08",0,0,163,0,0,170,0,0
"France","2024-10-09",0,0,163,0,1,171,0,0
"France","2024-10-10",0,0,163,0,1,172,0,0
"France","2024-10-11",0,0,163,0,1,173,0,0
"France","2024-10-12",0,0,163,0,1,174,0,0
"France","2024-10-13",0,0,163,0,1,175,0,0
"France","2024-10-14",0,0,163,0,1,176,0,0
"France","2024-10-15",0,0,163,0,1,177,0,0
"France","2024-10-16",0,0,163,0,1,178,0,0
"France","2024-10-17",0,0,163,0,1,179,0,0
"France","2024-10-18",0,0,163,0,1,180,0,0
"France","2024-10-19",0,0,163,0,1,181,0,0
"France","2024-10-20",0,0,163,0,1,182,0,0
"France","2024-10-21",0,0,163,0,1,183,0,0
"France","2024-10-22",0,0,163,0,1,184,0,0
"France","2024-10-23",0,0,163,0,1,185,0,0
"France","2024-10-24",0,0,163,0,0,185,0,0
"France","2024-10-25",0,0,163,0,1,186,0,0
"France","2024-10-26",0,0,163,0,1,187,0,0
"France","2024-10-27",0,0,163,0,1,188,0,0
"France","2024-10-28",0,0,163,0,1,189,0,0
"France","2024-10-29",0,0,163,0,1,190,0,0
"France","2024-10-30",0,0,163,0,1,191,0,0
"France","2024-10-31",0,29,192,0,1,192,0,0
"France","2024-11-01",0,0,192,0,0,192,0,0
"France","2024-11-02",0,0,192,0,1,193,0,0
"France","2024-11-03",0,0,192,0,0,193,0,0
"France","2024-11-04",0,0,192,0,0,193,0,0
"France","2024-11-05",0,0,192,0,0,193,0,0
"France","2024-11-06",0,0,192,0,1,194,0,0
"France","2024-11-07",0,0,192,0,0,194,0,0
"France","2024-11-08",0,0,192,0,0,194,0,0
"France","2024-11-09",0,0,192,0,0,194,0,0
"France","2024-11-10",0,0,192,0,1,195,0,0
"France","2024-11-11",0,0,192,0,0,195,0,0
"France","2024-11-12",0,0,192,0,0,195,0,0
"France","2024-11-13",0,0,192,0,0,195,0,0
"France","2024-11-14",0,0,192,0,1,196,0,0
"France","2024-11-15",0,0,192,0,0,196,0,0
"France","2024-11-16",0,0,192,0,0,196,0,0
"France","2024-11-17",0,0,192,0,1,197,0,0
"France","2024-11-18",0,0,192,0,0,197,0,0
"France","2024-11-19",0,0,192,0,0,197,0,0
"France","2024-11-20",0,0,192,0,0,197,0,0
"France","2024-11-21",0,0,192,0,1,198,0,0
"France","2024-11-22",0,0,192,0,0,198,0,0
"France","2024-11-23",0,0,192,0,0,198,0,0
"France","2024-11-24",0,0,192,0,0,198,0,0
"France","2024-11-25",0,0,192,0,1,199,0,0
"France","2024-11-26",0,0,192,0,0,199,0,0
"France","2024-11-27",0,0,192,0,0,199,0,0
"France","2024-11-28",0,0,192,0,0,199,0,0
"France","2024-11-29",0,0,192,0,1,200,0,0
"France","2024-11-30",0,8,200,0,0,200,0,0
"France","2024-12-01",0,0,200,0,0,200,0,0
"France","2024-12-02",0,0,200,0,0,200,0,0
"France","2024-12-03",0,0,200,0,0,200,0,0
"France","2024-12-04",0,0,200,0,0,200,0,0
"France","2024-12-05",0,0,200,0,0,200,0,0
"France","2024-12-06",0,0,200,0,0,200,0,0
"France","2024-12-07",0,0,200,0,0,200,0,0
"France","2024-12-08",0,0,200,0,0,200,0,0
"France","2024-12-09",0,0,200,0,0,200,0,0
"France","2024-12-10",0,0,200,0,0,200,0,0
"France","2024-12-11",0,0,200,0,0,200,0,0
"France","2024-12-12",0,0,200,0,0,200,0,0
"France","2024-12-13",0,0,200,0,0,200,0,0
"France","2024-12-14",0,0,200,0,0,200,0,0
"France","2024-12-15",0,0,200,0,0,200,0,0
"France","2024-12-16",0,0,200,0,0,200,0,0
"France","2024-12-17",0,0,200,0,0,200,0,0
"France","2024-12-18",0,0,200,0,0,200,0,0
"France","2024-12-19",0,0,200,0,0,200,0,0
"France","2024-12-20",0,0,200,0,0,200,0,0
"France","2024-12-21",0,0,200,0,0,200,0,0
"France","2024-12-22",0,0,200,0,0,200,0,0
"France","2024-12-23",0,0,200,0,0,200,0,0
"France","2024-12-24",0,0,200,0,0,200,0,0
"France","2024-12-25",0,0,200,0,0,200,0,0
"France","2024-12-26",0,0,200,0,0,200,0,0
"France","2024-12-27",0,0,200,0,0,200,0,0
"France","2024-12-28",0,0,200,0,0,200,0,0
"France","2024-12-29",0,0,200,0,0,200,0,0
"France","2024-12-30",0,0,200,0,0,200,0,0
"France","2024-12-31",0,0,200,0,0,200,0,0
"France","2025-01-01",0,0,200,0,0,200,0,0
"France","2025-01-02",0,0,200,0,0,200,0,0
"France","2025-01-03",0,0,200,0,0,200,0,0
"France","2025-01-04",0,0,200,0,0,200,0,0
"France","2025-01-05",0,0,200,0,0,200,0,0
"France","2025-01-06",0,0,200,0,0,200,0,0
"France","2025-01-07",0,0,200,0,0,200,0,0
"France","2025-01-08",0,0,200,0,0,200,0,0
"France","2025-01-09",0,0,200,0,0,200,0,0
"France","2025-01-10",0,0,200,0,0,200,0,0
"France","2025-01-11",0,0,200,0,0,200,0,0
"France","2025-01-12",0,0,200,0,0,200,0,0
"France","2025-01-13",0,0,200,0,0,200,0,0
"Gabon","2024-01-01",0,0,0,0,0,0,0,0
"Gabon","2024-01-02",0,0,0,0,0,0,0,0
"Gabon","2024-01-03",0,0,0,0,0,0,0,0
"Gabon","2024-01-04",0,0,0,0,0,0,0,0
"Gabon","2024-01-05",0,0,0,0,0,0,0,0
"Gabon","2024-01-06",0,0,0,0,0,0,0,0
"Gabon","2024-01-07",0,0,0,0,0,0,0,0
"Gabon","2024-01-08",0,0,0,0,0,0,0,0
"Gabon","2024-01-09",0,0,0,0,0,0,0,0
"Gabon","2024-01-10",0,0,0,0,0,0,0,0
"Gabon","2024-01-11",0,0,0,0,0,0,0,0
"Gabon","2024-01-12",0,0,0,0,0,0,0,0
"Gabon","2024-01-13",0,0,0,0,0,0,0,0
"Gabon","2024-01-14",0,0,0,0,0,0,0,0
"Gabon","2024-01-15",0,0,0,0,0,0,0,0
"Gabon","2024-01-16",0,0,0,0,0,0,0,0
"Gabon","2024-01-17",0,0,0,0,0,0,0,0
"Gabon","2024-01-18",0,0,0,0,0,0,0,0
"Gabon","2024-01-19",0,0,0,0,0,0,0,0
"Gabon","2024-01-20",0,0,0,0,0,0,0,0
"Gabon","2024-01-21",0,0,0,0,0,0,0,0
"Gabon","2024-01-22",0,0,0,0,0,0,0,0
"Gabon","2024-01-23",0,0,0,0,0,0,0,0
"Gabon","2024-01-24",0,0,0,0,0,0,0,0
"Gabon","2024-01-25",0,0,0,0,0,0,0,0
"Gabon","2024-01-26",0,0,0,0,0,0,0,0
"Gabon","2024-01-27",0,0,0,0,0,0,0,0
"Gabon","2024-01-28",0,0,0,0,0,0,0,0
"Gabon","2024-01-29",0,0,0,0,0,0,0,0
"Gabon","2024-01-30",0,0,0,0,0,0,0,0
"Gabon","2024-01-31",0,0,0,0,0,0,0,0
"Gabon","2024-02-01",0,0,0,0,0,0,0,0
"Gabon","2024-02-02",0,0,0,0,0,0,0,0
"Gabon","2024-02-03",0,0,0,0,0,0,0,0
"Gabon","2024-02-04",0,0,0,0,0,0,0,0
"Gabon","2024-02-05",0,0,0,0,0,0,0,0
"Gabon","2024-02-06",0,0,0,0,0,0,0,0
"Gabon","2024-02-07",0,0,0,0,0,0,0,0
"Gabon","2024-02-08",0,0,0,0,0,0,0,0
"Gabon","2024-02-09",0,0,0,0,0,0,0,0
"Gabon","2024-02-10",0,0,0,0,0,0,0,0
"Gabon","2024-02-11",0,0,0,0,0,0,0,0
"Gabon","2024-02-12",0,0,0,0,0,0,0,0
"Gabon","2024-02-13",0,0,0,0,0,0,0,0
"Gabon","2024-02-14",0,0,0,0,0,0,0,0
"Gabon","2024-02-15",0,0,0,0,0,0,0,0
"Gabon","2024-02-16",0,0,0,0,0,0,0,0
"Gabon","2024-02-17",0,0,0,0,0,0,0,0
"Gabon","2024-02-18",0,0,0,0,0,0,0,0
"Gabon","2024-02-19",0,0,0,0,0,0,0,0
"Gabon","2024-02-20",0,0,0,0,0,0,0,0
"Gabon","2024-02-21",0,0,0,0,0,0,0,0
"Gabon","2024-02-22",0,0,0,0,0,0,0,0
"Gabon","2024-02-23",0,0,0,0,0,0,0,0
"Gabon","2024-02-24",0,0,0,0,0,0,0,0
"Gabon","2024-02-25",0,0,0,0,0,0,0,0
"Gabon","2024-02-26",0,0,0,0,0,0,0,0
"Gabon","2024-02-27",0,0,0,0,0,0,0,0
"Gabon","2024-02-28",0,0,0,0,0,0,0,0
"Gabon","2024-02-29",0,0,0,0,0,0,0,0
"Gabon","2024-03-01",0,0,0,0,0,0,0,0
"Gabon","2024-03-02",0,0,0,0,0,0,0,0
"Gabon","2024-03-03",0,0,0,0,0,0,0,0
"Gabon","2024-03-04",0,0,0,0,0,0,0,0
"Gabon","2024-03-05",0,0,0,0,0,0,0,0
"Gabon","2024-03-06",0,0,0,0,0,0,0,0
"Gabon","2024-03-07",0,0,0,0,0,0,0,0
"Gabon","2024-03-08",0,0,0,0,0,0,0,0
"Gabon","2024-03-09",0,0,0,0,0,0,0,0
"Gabon","2024-03-10",0,0,0,0,0,0,0,0
"Gabon","2024-03-11",0,0,0,0,0,0,0,0
"Gabon","2024-03-12",0,0,0,0,0,0,0,0
"Gabon","2024-03-13",0,0,0,0,0,0,0,0
"Gabon","2024-03-14",0,0,0,0,0,0,0,0
"Gabon","2024-03-15",0,0,0,0,0,0,0,0
"Gabon","2024-03-16",0,0,0,0,0,0,0,0
"Gabon","2024-03-17",0,0,0,0,0,0,0,0
"Gabon","2024-03-18",0,0,0,0,0,0,0,0
"Gabon","2024-03-19",0,0,0,0,0,0,0,0
"Gabon","2024-03-20",0,0,0,0,0,0,0,0
"Gabon","2024-03-21",0,0,0,0,0,0,0,0
"Gabon","2024-03-22",0,0,0,0,0,0,0,0
"Gabon","2024-03-23",0,0,0,0,0,0,0,0
"Gabon","2024-03-24",0,0,0,0,0,0,0,0
"Gabon","2024-03-25",0,0,0,0,0,0,0,0
"Gabon","2024-03-26",0,0,0,0,0,0,0,0
"Gabon","2024-03-27",0,0,0,0,0,0,0,0
"Gabon","2024-03-28",0,0,0,0,0,0,0,0
"Gabon","2024-03-29",0,0,0,0,0,0,0,0
"Gabon","2024-03-30",0,0,0,0,0,0,0,0
"Gabon","2024-03-31",0,0,0,0,0,0,0,0
"Gabon","2024-04-01",0,0,0,0,0,0,0,0
"Gabon","2024-04-02",0,0,0,0,0,0,0,0
"Gabon","2024-04-03",0,0,0,0,0,0,0,0
"Gabon","2024-04-04",0,0,0,0,0,0,0,0
"Gabon","2024-04-05",0,0,0,0,0,0,0,0
"Gabon","2024-04-06",0,0,0,0,0,0,0,0
"Gabon","2024-04-07",0,0,0,0,0,0,0,0
"Gabon","2024-04-08",0,0,0,0,0,0,0,0
"Gabon","2024-04-09",0,0,0,0,0,0,0,0
"Gabon","2024-04-10",0,0,0,0,0,0,0,0
"Gabon","2024-04-11",0,0,0,0,0,0,0,0
"Gabon","2024-04-12",0,0,0,0,0,0,0,0
"Gabon","2024-04-13",0,0,0,0,0,0,0,0
"Gabon","2024-04-14",0,0,0,0,0,0,0,0
"Gabon","2024-04-15",0,0,0,0,0,0,0,0
"Gabon","2024-04-16",0,0,0,0,0,0,0,0
"Gabon","2024-04-17",0,0,0,0,0,0,0,0
"Gabon","2024-04-18",0,0,0,0,0,0,0,0
"Gabon","2024-04-19",0,0,0,0,0,0,0,0
"Gabon","2024-04-20",0,0,0,0,0,0,0,0
"Gabon","2024-04-21",0,0,0,0,0,0,0,0
"Gabon","2024-04-22",0,0,0,0,0,0,0,0
"Gabon","2024-04-23",0,0,0,0,0,0,0,0
"Gabon","2024-04-24",0,0,0,0,0,0,0,0
"Gabon","2024-04-25",0,0,0,0,0,0,0,0
"Gabon","2024-04-26",0,0,0,0,0,0,0,0
"Gabon","2024-04-27",0,0,0,0,0,0,0,0
"Gabon","2024-04-28",0,0,0,0,0,0,0,0
"Gabon","2024-04-29",0,0,0,0,0,0,0,0
"Gabon","2024-04-30",0,0,0,0,0,0,0,0
"Gabon","2024-05-01",0,0,0,0,0,0,0,0
"Gabon","2024-05-02",0,0,0,0,0,0,0,0
"Gabon","2024-05-03",0,0,0,0,0,0,0,0
"Gabon","2024-05-04",0,0,0,0,0,0,0,0
"Gabon","2024-05-05",0,0,0,0,0,0,0,0
"Gabon","2024-05-06",0,0,0,0,0,0,0,0
"Gabon","2024-05-07",0,0,0,0,0,0,0,0
"Gabon","2024-05-08",0,0,0,0,0,0,0,0
"Gabon","2024-05-09",0,0,0,0,0,0,0,0
"Gabon","2024-05-10",0,0,0,0,0,0,0,0
"Gabon","2024-05-11",0,0,0,0,0,0,0,0
"Gabon","2024-05-12",0,0,0,0,0,0,0,0
"Gabon","2024-05-13",0,0,0,0,0,0,0,0
"Gabon","2024-05-14",0,0,0,0,0,0,0,0
"Gabon","2024-05-15",0,0,0,0,0,0,0,0
"Gabon","2024-05-16",0,0,0,0,0,0,0,0
"Gabon","2024-05-17",0,0,0,0,0,0,0,0
"Gabon","2024-05-18",0,0,0,0,0,0,0,0
"Gabon","2024-05-19",0,0,0,0,0,0,0,0
"Gabon","2024-05-20",0,0,0,0,0,0,0,0
"Gabon","2024-05-21",0,0,0,0,0,0,0,0
"Gabon","2024-05-22",0,0,0,0,0,0,0,0
"Gabon","2024-05-23",0,0,0,0,0,0,0,0
"Gabon","2024-05-24",0,0,0,0,0,0,0,0
"Gabon","2024-05-25",0,0,0,0,0,0,0,0
"Gabon","2024-05-26",0,0,0,0,0,0,0,0
"Gabon","2024-05-27",0,0,0,0,0,0,0,0
"Gabon","2024-05-28",0,0,0,0,0,0,0,0
"Gabon","2024-05-29",0,0,0,0,0,0,0,0
"Gabon","2024-05-30",0,0,0,0,0,0,0,0
"Gabon","2024-05-31",0,0,0,0,0,0,0,0
"Gabon","2024-06-01",0,0,0,0,0,0,0,0
"Gabon","2024-06-02",0,0,0,0,0,0,0,0
"Gabon","2024-06-03",0,0,0,0,0,0,0,0
"Gabon","2024-06-04",0,0,0,0,0,0,0,0
"Gabon","2024-06-05",0,0,0,0,0,0,0,0
"Gabon","2024-06-06",0,0,0,0,0,0,0,0
"Gabon","2024-06-07",0,0,0,0,0,0,0,0
"Gabon","2024-06-08",0,0,0,0,0,0,0,0
"Gabon","2024-06-09",0,0,0,0,0,0,0,0
"Gabon","2024-06-10",0,0,0,0,0,0,0,0
"Gabon","2024-06-11",0,0,0,0,0,0,0,0
"Gabon","2024-06-12",0,0,0,0,0,0,0,0
"Gabon","2024-06-13",0,0,0,0,0,0,0,0
"Gabon","2024-06-14",0,0,0,0,0,0,0,0
"Gabon","2024-06-15",0,0,0,0,0,0,0,0
"Gabon","2024-06-16",0,0,0,0,0,0,0,0
"Gabon","2024-06-17",0,0,0,0,0,0,0,0
"Gabon","2024-06-18",0,0,0,0,0,0,0,0
"Gabon","2024-06-19",0,0,0,0,0,0,0,0
"Gabon","2024-06-20",0,0,0,0,0,0,0,0
"Gabon","2024-06-21",0,0,0,0,0,0,0,0
"Gabon","2024-06-22",0,0,0,0,0,0,0,0
"Gabon","2024-06-23",0,0,0,0,0,0,0,0
"Gabon","2024-06-24",0,0,0,0,0,0,0,0
"Gabon","2024-06-25",0,0,0,0,0,0,0,0
"Gabon","2024-06-26",0,0,0,0,0,0,0,0
"Gabon","2024-06-27",0,0,0,0,0,0,0,0
"Gabon","2024-06-28",0,0,0,0,0,0,0,0
"Gabon","2024-06-29",0,0,0,0,0,0,0,0
"Gabon","2024-06-30",0,0,0,0,0,0,0,0
"Gabon","2024-07-01",0,0,0,0,0,0,0,0
"Gabon","2024-07-02",0,0,0,0,0,0,0,0
"Gabon","2024-07-03",0,0,0,0,0,0,0,0
"Gabon","2024-07-04",0,0,0,0,0,0,0,0
"Gabon","2024-07-05",0,0,0,0,0,0,0,0
"Gabon","2024-07-06",0,0,0,0,0,0,0,0
"Gabon","2024-07-07",0,0,0,0,0,0,0,0
"Gabon","2024-07-08",0,0,0,0,0,0,0,0
"Gabon","2024-07-09",0,0,0,0,0,0,0,0
"Gabon","2024-07-10",0,0,0,0,0,0,0,0
"Gabon","2024-07-11",0,0,0,0,0,0,0,0
"Gabon","2024-07-12",0,0,0,0,0,0,0,0
"Gabon","2024-07-13",0,0,0,0,0,0,0,0
"Gabon","2024-07-14",0,0,0,0,0,0,0,0
"Gabon","2024-07-15",0,0,0,0,0,0,0,0
"Gabon","2024-07-16",0,0,0,0,0,0,0,0
"Gabon","2024-07-17",0,0,0,0,0,0,0,0
"Gabon","2024-07-18",0,0,0,0,0,0,0,0
"Gabon","2024-07-19",0,0,0,0,0,0,0,0
"Gabon","2024-07-20",0,0,0,0,0,0,0,0
"Gabon","2024-07-21",0,0,0,0,0,0,0,0
"Gabon","2024-07-22",0,0,0,0,0,0,0,0
"Gabon","2024-07-23",0,0,0,0,0,0,0,0
"Gabon","2024-07-24",0,0,0,0,0,0,0,0
"Gabon","2024-07-25",0,0,0,0,0,0,0,0
"Gabon","2024-07-26",0,0,0,0,0,0,0,0
"Gabon","2024-07-27",0,0,0,0,0,0,0,0
"Gabon","2024-07-28",0,0,0,0,0,0,0,0
"Gabon","2024-07-29",0,0,0,0,0,0,0,0
"Gabon","2024-07-30",0,0,0,0,0,0,0,0
"Gabon","2024-07-31",0,0,0,0,0,0,0,0
"Gabon","2024-08-01",0,0,0,0,0,0,0,0
"Gabon","2024-08-02",0,0,0,0,0,0,0,0
"Gabon","2024-08-03",0,0,0,0,0,0,0,0
"Gabon","2024-08-04",0,0,0,0,0,0,0,0
"Gabon","2024-08-05",0,0,0,0,0,0,0,0
"Gabon","2024-08-06",0,0,0,0,0,0,0,0
"Gabon","2024-08-07",0,0,0,0,0,0,0,0
"Gabon","2024-08-08",0,0,0,0,0,0,0,0
"Gabon","2024-08-09",0,0,0,0,0,0,0,0
"Gabon","2024-08-10",0,0,0,0,0,0,0,0
"Gabon","2024-08-11",0,0,0,0,0,0,0,0
"Gabon","2024-08-12",0,0,0,0,0,0,0,0
"Gabon","2024-08-13",0,0,0,0,0,0,0,0
"Gabon","2024-08-14",0,0,0,0,0,0,0,0
"Gabon","2024-08-15",0,0,0,0,0,0,0,0
"Gabon","2024-08-16",0,0,0,0,0,0,0,0
"Gabon","2024-08-17",0,0,0,0,0,0,0,0
"Gabon","2024-08-18",0,0,0,0,0,0,0,0
"Gabon","2024-08-19",0,0,0,0,0,0,0,0
"Gabon","2024-08-20",0,0,0,0,0,0,0,0
"Gabon","2024-08-21",0,0,0,0,0,0,0,0
"Gabon","2024-08-22",0,0,0,0,0,0,0,0
"Gabon","2024-08-23",0,0,0,0,0,0,0,0
"Gabon","2024-08-24",0,0,0,0,0,0,0,0
"Gabon","2024-08-25",0,1,1,0,1,1,0,0
"Gabon","2024-08-26",0,0,1,0,0,1,0,0
"Gabon","2024-08-27",0,0,1,0,0,1,0,0
"Gabon","2024-08-28",0,0,1,0,0,1,0,0
"Gabon","2024-08-29",0,0,1,0,1,2,0,0
"Gabon","2024-08-30",0,0,1,0,0,2,0,0
"Gabon","2024-08-31",0,0,1,0,0,2,0,0
"Gabon","2024-09-01",0,1,2,0,0,2,0,0
"Gabon","2024-09-02",0,0,2,0,0,2,0,0
"Gabon","2024-09-03",0,0,2,0,0,2,0,0
"Gabon","2024-09-04",0,0,2,0,0,2,0,0
"Gabon","2024-09-05",0,0,2,0,0,2,0,0
"Gabon","2024-09-06",0,0,2,0,0,2,0,0
"Gabon","2024-09-07",0,0,2,0,0,2,0,0
"Gabon","2024-09-08",4,0,2,4,0,2,4,4
"Gabon","2024-09-09",0,0,2,4,0,2,0,4
"Gabon","2024-09-10",0,0,2,4,0,2,0,4
"Gabon","2024-09-11",0,0,2,4,0,2,0,4
"Gabon","2024-09-12",0,0,2,4,0,2,1,5
"Gabon","2024-09-13",0,0,2,4,0,2,0,5
"Gabon","2024-09-14",0,0,2,4,0,2,0,5
"Gabon","2024-09-15",0,0,2,4,0,2,0,5
"Gabon","2024-09-16",0,0,2,4,0,2,0,5
"Gabon","2024-09-17",0,0,2,4,0,2,0,5
"Gabon","2024-09-18",0,0,2,4,0,2,0,5
"Gabon","2024-09-19",0,0,2,4,0,2,1,6
"Gabon","2024-09-20",0,0,2,4,0,2,0,6
"Gabon","2024-09-21",0,0,2,4,0,2,0,6
"Gabon","2024-09-22",0,0,2,4,0,2,0,6
"Gabon","2024-09-23",0,0,2,4,0,2,0,6
"Gabon","2024-09-24",0,0,2,4,0,2,0,6
"Gabon","2024-09-25",0,0,2,4,0,2,0,6
"Gabon","2024-09-26",0,0,2,4,0,2,0,6
"Gabon","2024-09-27",0,0,2,4,0,2,1,7
"Gabon","2024-09-28",0,0,2,4,0,2,0,7
"Gabon","2024-09-29",0,0,2,4,0,2,0,7
"Gabon","2024-09-30",3,0,2,7,0,2,0,7
"Gabon","2024-10-01",0,0,2,7,0,2,0,7
"Gabon","2024-10-02",0,0,2,7,0,2,1,8
"Gabon","2024-10-03",0,0,2,7,0,2,0,8
"Gabon","2024-10-04",0,0,2,7,0,2,0,8
"Gabon","2024-10-05",0,0,2,7,0,2,1,9
"Gabon","2024-10-06",2,0,2,9,0,2,0,9
"Gabon","2024-10-07",0,0,2,9,0,2,0,9
"Gabon","2024-10-08",0,0,2,9,0,2,0,9
"Gabon","2024-10-09",0,0,2,9,0,2,0,9
"Gabon","2024-10-10",0,0,2,9,0,2,0,9
"Gabon","2024-10-11",0,0,2,9,0,2,0,9
"Gabon","2024-10-12",0,0,2,9,0,2,0,9
"Gabon","2024-10-13",0,0,2,9,0,2,0,9
"Gabon","2024-10-14",0,0,2,9,0,2,1,10
"Gabon","2024-10-15",0,0,2,9,0,2,0,10
"Gabon","2024-10-16",0,0,2,9,0,2,0,10
"Gabon","2024-10-17",0,0,2,9,0,2,0,10
"Gabon","2024-10-18",0,0,2,9,0,2,0,10
"Gabon","2024-10-19",0,0,2,9,0,2,0,10
"Gabon","2024-10-20",1,0,2,10,0,2,0,10
"Gabon","2024-10-21",3,0,2,13,0,2,3,13
"Gabon","2024-10-22",0,0,2,13,0,2,0,13
"Gabon","2024-10-23",0,0,2,13,0,2,0,13
"Gabon","2024-10-24",0,0,2,13,0,2,0,13
"Gabon","2024-10-25",0,0,2,13,0,2,0,13
"Gabon","2024-10-26",0,0,2,13,0,2,0,13
"Gabon","2024-10-27",0,0,2,13,0,2,0,13
"Gabon","2024-10-28",0,0,2,13,0,2,0,13
"Gabon","2024-10-29",0,0,2,13,0,2,0,13
"Gabon","2024-10-30",0,0,2,13,0,2,0,13
"Gabon","2024-10-31",0,0,2,13,0,2,0,13
"Gabon","2024-11-01",0,0,2,13,0,2,0,13
"Gabon","2024-11-02",0,0,2,13,0,2,0,13
"Gabon","2024-11-03",0,0,2,13,0,2,0,13
"Gabon","2024-11-04",0,0,2,13,0,2,0,13
"Gabon","2024-11-05",0,0,2,13,0,2,0,13
"Gabon","2024-11-06",0,0,2,13,0,2,0,13
"Gabon","2024-11-07",0,0,2,13,0,2,0,13
"Gabon","2024-11-08",0,0,2,13,0,2,0,13
"Gabon","2024-11-09",0,0,2,13,0,2,0,13
"Gabon","2024-11-10",0,0,2,13,0,2,0,13
"Gabon","2024-11-11",0,0,2,13,0,2,0,13
"Gabon","2024-11-12",0,0,2,13,0,2,0,13
"Gabon","2024-11-13",0,0,2,13,0,2,0,13
"Gabon","2024-11-14",0,0,2,13,0,2,0,13
"Gabon","2024-11-15",0,0,2,13,0,2,0,13
"Gabon","2024-11-16",0,0,2,13,0,2,0,13
"Gabon","2024-11-17",0,0,2,13,0,2,0,13
"Gabon","2024-11-18",0,0,2,13,0,2,0,13
"Gabon","2024-11-19",0,0,2,13,0,2,0,13
"Gabon","2024-11-20",0,0,2,13,0,2,0,13
"Gabon","2024-11-21",0,0,2,13,0,2,0,13
"Gabon","2024-11-22",0,0,2,13,0,2,0,13
"Gabon","2024-11-23",0,0,2,13,0,2,0,13
"Gabon","2024-11-24",0,0,2,13,0,2,0,13
"Gabon","2024-11-25",0,0,2,13,0,2,0,13
"Gabon","2024-11-26",0,0,2,13,0,2,0,13
"Gabon","2024-11-27",0,0,2,13,0,2,0,13
"Gabon","2024-11-28",0,0,2,13,0,2,0,13
"Gabon","2024-11-29",0,0,2,13,0,2,0,13
"Gabon","2024-11-30",0,0,2,13,0,2,0,13
"Gabon","2024-12-01",0,0,2,13,0,2,0,13
"Gabon","2024-12-02",0,0,2,13,0,2,0,13
"Gabon","2024-12-03",0,0,2,13,0,2,0,13
"Gabon","2024-12-04",0,0,2,13,0,2,0,13
"Gabon","2024-12-05",0,0,2,13,0,2,0,13
"Gabon","2024-12-06",0,0,2,13,0,2,0,13
"Gabon","2024-12-07",0,0,2,13,0,2,0,13
"Gabon","2024-12-08",0,0,2,13,0,2,0,13
"Gabon","2024-12-09",0,0,2,13,0,2,0,13
"Gabon","2024-12-10",0,0,2,13,0,2,0,13
"Gabon","2024-12-11",0,0,2,13,0,2,0,13
"Gabon","2024-12-12",0,0,2,13,0,2,0,13
"Gabon","2024-12-13",0,0,2,13,0,2,0,13
"Gabon","2024-12-14",0,0,2,13,0,2,0,13
"Gabon","2024-12-15",0,0,2,13,0,2,0,13
"Gabon","2024-12-16",0,0,2,13,0,2,0,13
"Gabon","2024-12-17",0,0,2,13,0,2,0,13
"Gabon","2024-12-18",0,0,2,13,0,2,0,13
"Gabon","2024-12-19",0,0,2,13,0,2,0,13
"Gabon","2024-12-20",0,0,2,13,0,2,0,13
"Gabon","2024-12-21",0,0,2,13,0,2,0,13
"Gabon","2024-12-22",0,0,2,13,0,2,0,13
"Gabon","2024-12-23",0,0,2,13,0,2,0,13
"Gabon","2024-12-24",0,0,2,13,0,2,0,13
"Gabon","2024-12-25",0,0,2,13,0,2,0,13
"Gabon","2024-12-26",0,0,2,13,0,2,0,13
"Gabon","2024-12-27",0,0,2,13,0,2,0,13
"Gabon","2024-12-28",0,0,2,13,0,2,0,13
"Gabon","2024-12-29",0,0,2,13,0,2,0,13
"Gabon","2024-12-30",0,0,2,13,0,2,0,13
"Gabon","2024-12-31",0,0,2,13,0,2,0,13
"Gabon","2025-01-01",0,0,2,13,0,2,0,13
"Gabon","2025-01-02",0,0,2,13,0,2,0,13
"Gabon","2025-01-03",0,0,2,13,0,2,0,13
"Gabon","2025-01-04",0,0,2,13,0,2,0,13
"Gabon","2025-01-05",0,0,2,13,0,2,0,13
"Gabon","2025-01-06",0,0,2,13,0,2,0,13
"Gabon","2025-01-07",0,0,2,13,0,2,0,13
"Gabon","2025-01-08",0,0,2,13,0,2,0,13
"Gabon","2025-01-09",0,0,2,13,0,2,0,13
"Gabon","2025-01-10",0,0,2,13,0,2,0,13
"Gabon","2025-01-11",0,0,2,13,0,2,0,13
"Gabon","2025-01-12",0,0,2,13,0,2,0,13
"Gabon","2025-01-13",0,0,2,13,0,2,0,13
"Georgia","2024-01-01",0,0,0,0,0,0,0,0
"Georgia","2024-01-02",0,0,0,0,0,0,0,0
"Georgia","2024-01-03",0,0,0,0,0,0,0,0
"Georgia","2024-01-04",0,0,0,0,0,0,0,0
"Georgia","2024-01-05",0,0,0,0,0,0,0,0
"Georgia","2024-01-06",0,0,0,0,0,0,0,0
"Georgia","2024-01-07",0,0,0,0,0,0,0,0
"Georgia","2024-01-08",0,0,0,0,0,0,0,0
"Georgia","2024-01-09",0,0,0,0,0,0,0,0
"Georgia","2024-01-10",0,0,0,0,0,0,0,0
"Georgia","2024-01-11",0,0,0,0,0,0,0,0
"Georgia","2024-01-12",0,0,0,0,0,0,0,0
"Georgia","2024-01-13",0,0,0,0,0,0,0,0
"Georgia","2024-01-14",0,0,0,0,0,0,0,0
"Georgia","2024-01-15",0,0,0,0,0,0,0,0
"Georgia","2024-01-16",0,0,0,0,0,0,0,0
"Georgia","2024-01-17",0,0,0,0,0,0,0,0
"Georgia","2024-01-18",0,0,0,0,0,0,0,0
"Georgia","2024-01-19",0,0,0,0,0,0,0,0
"Georgia","2024-01-20",0,0,0,0,0,0,0,0
"Georgia","2024-01-21",0,0,0,0,0,0,0,0
"Georgia","2024-01-22",0,0,0,0,0,0,0,0
"Georgia","2024-01-23",0,0,0,0,0,0,0,0
"Georgia","2024-01-24",0,0,0,0,0,0,0,0
"Georgia","2024-01-25",0,0,0,0,0,0,0,0
"Georgia","2024-01-26",0,0,0,0,0,0,0,0
"Georgia","2024-01-27",0,0,0,0,0,0,0,0
"Georgia","2024-01-28",0,0,0,0,0,0,0,0
"Georgia","2024-01-29",0,0,0,0,0,0,0,0
"Georgia","2024-01-30",0,0,0,0,0,0,0,0
"Georgia","2024-01-31",0,0,0,0,0,0,0,0
"Georgia","2024-02-01",0,0,0,0,0,0,0,0
"Georgia","2024-02-02",0,0,0,0,0,0,0,0
"Georgia","2024-02-03",0,0,0,0,0,0,0,0
"Georgia","2024-02-04",0,0,0,0,0,0,0,0
"Georgia","2024-02-05",0,0,0,0,0,0,0,0
"Georgia","2024-02-06",0,0,0,0,0,0,0,0
"Georgia","2024-02-07",0,0,0,0,0,0,0,0
"Georgia","2024-02-08",0,0,0,0,0,0,0,0
"Georgia","2024-02-09",0,0,0,0,0,0,0,0
"Georgia","2024-02-10",0,0,0,0,0,0,0,0
"Georgia","2024-02-11",0,0,0,0,0,0,0,0
"Georgia","2024-02-12",0,0,0,0,0,0,0,0
"Georgia","2024-02-13",0,0,0,0,0,0,0,0
"Georgia","2024-02-14",0,0,0,0,0,0,0,0
"Georgia","2024-02-15",0,0,0,0,0,0,0,0
"Georgia","2024-02-16",0,0,0,0,0,0,0,0
"Georgia","2024-02-17",0,0,0,0,0,0,0,0
"Georgia","2024-02-18",0,0,0,0,0,0,0,0
"Georgia","2024-02-19",0,0,0,0,0,0,0,0
"Georgia","2024-02-20",0,0,0,0,0,0,0,0
"Georgia","2024-02-21",0,0,0,0,0,0,0,0
"Georgia","2024-02-22",0,0,0,0,0,0,0,0
"Georgia","2024-02-23",0,0,0,0,0,0,0,0
"Georgia","2024-02-24",0,0,0,0,0,0,0,0
"Georgia","2024-02-25",0,0,0,0,0,0,0,0
"Georgia","2024-02-26",0,0,0,0,0,0,0,0
"Georgia","2024-02-27",0,0,0,0,0,0,0,0
"Georgia","2024-02-28",0,0,0,0,0,0,0,0
"Georgia","2024-02-29",0,0,0,0,0,0,0,0
"Georgia","2024-03-01",0,0,0,0,0,0,0,0
"Georgia","2024-03-02",0,0,0,0,0,0,0,0
"Georgia","2024-03-03",0,0,0,0,0,0,0,0
"Georgia","2024-03-04",0,0,0,0,0,0,0,0
"Georgia","2024-03-05",0,0,0,0,0,0,0,0
"Georgia","2024-03-06",0,0,0,0,0,0,0,0
"Georgia","2024-03-07",0,0,0,0,0,0,0,0
"Georgia","2024-03-08",0,0,0,0,0,0,0,0
"Georgia","2024-03-09",0,0,0,0,0,0,0,0
"Georgia","2024-03-10",0,0,0,0,0,0,0,0
"Georgia","2024-03-11",0,0,0,0,0,0,0,0
"Georgia","2024-03-12",0,0,0,0,0,0,0,0
"Georgia","2024-03-13",0,0,0,0,0,0,0,0
"Georgia","2024-03-14",0,0,0,0,0,0,0,0
"Georgia","2024-03-15",0,0,0,0,0,0,0,0
"Georgia","2024-03-16",0,0,0,0,0,0,0,0
"Georgia","2024-03-17",0,0,0,0,0,0,0,0
"Georgia","2024-03-18",0,0,0,0,0,0,0,0
"Georgia","2024-03-19",0,0,0,0,0,0,0,0
"Georgia","2024-03-20",0,0,0,0,0,0,0,0
"Georgia","2024-03-21",0,0,0,0,0,0,0,0
"Georgia","2024-03-22",0,0,0,0,0,0,0,0
"Georgia","2024-03-23",0,0,0,0,0,0,0,0
"Georgia","2024-03-24",0,0,0,0,0,0,0,0
"Georgia","2024-03-25",0,0,0,0,0,0,0,0
"Georgia","2024-03-26",0,0,0,0,0,0,0,0
"Georgia","2024-03-27",0,0,0,0,0,0,0,0
"Georgia","2024-03-28",0,0,0,0,0,0,0,0
"Georgia","2024-03-29",0,0,0,0,0,0,0,0
"Georgia","2024-03-30",0,0,0,0,0,0,0,0
"Georgia","2024-03-31",0,0,0,0,0,0,0,0
"Georgia","2024-04-01",0,0,0,0,0,0,0,0
"Georgia","2024-04-02",0,0,0,0,0,0,0,0
"Georgia","2024-04-03",0,0,0,0,0,0,0,0
"Georgia","2024-04-04",0,0,0,0,0,0,0,0
"Georgia","2024-04-05",0,0,0,0,0,0,0,0
"Georgia","2024-04-06",0,0,0,0,0,0,0,0
"Georgia","2024-04-07",0,0,0,0,0,0,0,0
"Georgia","2024-04-08",0,0,0,0,0,0,0,0
"Georgia","2024-04-09",0,0,0,0,0,0,0,0
"Georgia","2024-04-10",0,0,0,0,0,0,0,0
"Georgia","2024-04-11",0,0,0,0,0,0,0,0
"Georgia","2024-04-12",0,0,0,0,0,0,0,0
"Georgia","2024-04-13",0,0,0,0,0,0,0,0
"Georgia","2024-04-14",0,0,0,0,0,0,0,0
"Georgia","2024-04-15",0,0,0,0,0,0,0,0
"Georgia","2024-04-16",0,0,0,0,0,0,0,0
"Georgia","2024-04-17",0,0,0,0,0,0,0,0
"Georgia","2024-04-18",0,0,0,0,0,0,0,0
"Georgia","2024-04-19",0,0,0,0,0,0,0,0
"Georgia","2024-04-20",0,0,0,0,0,0,0,0
"Georgia","2024-04-21",0,0,0,0,0,0,0,0
"Georgia","2024-04-22",0,0,0,0,0,0,0,0
"Georgia","2024-04-23",0,0,0,0,0,0,0,0
"Georgia","2024-04-24",0,0,0,0,0,0,0,0
"Georgia","2024-04-25",0,0,0,0,0,0,0,0
"Georgia","2024-04-26",0,0,0,0,0,0,0,0
"Georgia","2024-04-27",0,0,0,0,0,0,0,0
"Georgia","2024-04-28",0,0,0,0,0,0,0,0
"Georgia","2024-04-29",0,0,0,0,0,0,0,0
"Georgia","2024-04-30",0,0,0,0,0,0,0,0
"Georgia","2024-05-01",0,0,0,0,0,0,0,0
"Georgia","2024-05-02",0,0,0,0,0,0,0,0
"Georgia","2024-05-03",0,0,0,0,0,0,0,0
"Georgia","2024-05-04",0,0,0,0,0,0,0,0
"Georgia","2024-05-05",0,0,0,0,0,0,0,0
"Georgia","2024-05-06",0,0,0,0,0,0,0,0
"Georgia","2024-05-07",0,0,0,0,0,0,0,0
"Georgia","2024-05-08",0,0,0,0,0,0,0,0
"Georgia","2024-05-09",0,0,0,0,0,0,0,0
"Georgia","2024-05-10",0,0,0,0,0,0,0,0
"Georgia","2024-05-11",0,0,0,0,0,0,0,0
"Georgia","2024-05-12",0,0,0,0,0,0,0,0
"Georgia","2024-05-13",0,0,0,0,0,0,0,0
"Georgia","2024-05-14",0,0,0,0,0,0,0,0
"Georgia","2024-05-15",0,0,0,0,0,0,0,0
"Georgia","2024-05-16",0,0,0,0,0,0,0,0
"Georgia","2024-05-17",0,0,0,0,0,0,0,0
"Georgia","2024-05-18",0,0,0,0,0,0,0,0
"Georgia","2024-05-19",0,0,0,0,0,0,0,0
"Georgia","2024-05-20",0,0,0,0,0,0,0,0
"Georgia","2024-05-21",0,0,0,0,0,0,0,0
"Georgia","2024-05-22",0,0,0,0,0,0,0,0
"Georgia","2024-05-23",0,0,0,0,0,0,0,0
"Georgia","2024-05-24",0,0,0,0,0,0,0,0
"Georgia","2024-05-25",0,0,0,0,0,0,0,0
"Georgia","2024-05-26",0,0,0,0,0,0,0,0
"Georgia","2024-05-27",0,0,0,0,0,0,0,0
"Georgia","2024-05-28",0,0,0,0,0,0,0,0
"Georgia","2024-05-29",0,0,0,0,0,0,0,0
"Georgia","2024-05-30",0,0,0,0,0,0,0,0
"Georgia","2024-05-31",0,0,0,0,0,0,0,0
"Georgia","2024-06-01",0,0,0,0,0,0,0,0
"Georgia","2024-06-02",0,0,0,0,0,0,0,0
"Georgia","2024-06-03",0,0,0,0,0,0,0,0
"Georgia","2024-06-04",0,0,0,0,0,0,0,0
"Georgia","2024-06-05",0,0,0,0,0,0,0,0
"Georgia","2024-06-06",0,0,0,0,0,0,0,0
"Georgia","2024-06-07",0,0,0,0,0,0,0,0
"Georgia","2024-06-08",0,0,0,0,0,0,0,0
"Georgia","2024-06-09",0,0,0,0,0,0,0,0
"Georgia","2024-06-10",0,0,0,0,0,0,0,0
"Georgia","2024-06-11",0,0,0,0,0,0,0,0
"Georgia","2024-06-12",0,0,0,0,0,0,0,0
"Georgia","2024-06-13",0,0,0,0,0,0,0,0
"Georgia","2024-06-14",0,0,0,0,0,0,0,0
"Georgia","2024-06-15",0,0,0,0,0,0,0,0
"Georgia","2024-06-16",0,0,0,0,0,0,0,0
"Georgia","2024-06-17",0,0,0,0,0,0,0,0
"Georgia","2024-06-18",0,0,0,0,0,0,0,0
"Georgia","2024-06-19",0,0,0,0,0,0,0,0
"Georgia","2024-06-20",0,0,0,0,0,0,0,0
"Georgia","2024-06-21",0,0,0,0,0,0,0,0
"Georgia","2024-06-22",0,0,0,0,0,0,0,0
"Georgia","2024-06-23",0,0,0,0,0,0,0,0
"Georgia","2024-06-24",0,0,0,0,0,0,0,0
"Georgia","2024-06-25",0,0,0,0,0,0,0,0
"Georgia","2024-06-26",0,0,0,0,0,0,0,0
"Georgia","2024-06-27",0,0,0,0,0,0,0,0
"Georgia","2024-06-28",0,0,0,0,0,0,0,0
"Georgia","2024-06-29",0,0,0,0,0,0,0,0
"Georgia","2024-06-30",0,0,0,0,0,0,0,0
"Georgia","2024-07-01",0,0,0,0,0,0,0,0
"Georgia","2024-07-02",0,0,0,0,0,0,0,0
"Georgia","2024-07-03",0,0,0,0,0,0,0,0
"Georgia","2024-07-04",0,0,0,0,0,0,0,0
"Georgia","2024-07-05",0,0,0,0,0,0,0,0
"Georgia","2024-07-06",0,0,0,0,0,0,0,0
"Georgia","2024-07-07",0,0,0,0,0,0,0,0
"Georgia","2024-07-08",0,0,0,0,0,0,0,0
"Georgia","2024-07-09",0,0,0,0,0,0,0,0
"Georgia","2024-07-10",0,0,0,0,0,0,0,0
"Georgia","2024-07-11",0,0,0,0,0,0,0,0
"Georgia","2024-07-12",0,0,0,0,0,0,0,0
"Georgia","2024-07-13",0,0,0,0,0,0,0,0
"Georgia","2024-07-14",0,0,0,0,0,0,0,0
"Georgia","2024-07-15",0,0,0,0,0,0,0,0
"Georgia","2024-07-16",0,0,0,0,0,0,0,0
"Georgia","2024-07-17",0,0,0,0,0,0,0,0
"Georgia","2024-07-18",0,0,0,0,0,0,0,0
"Georgia","2024-07-19",0,0,0,0,0,0,0,0
"Georgia","2024-07-20",0,0,0,0,0,0,0,0
"Georgia","2024-07-21",0,0,0,0,0,0,0,0
"Georgia","2024-07-22",0,0,0,0,0,0,0,0
"Georgia","2024-07-23",0,0,0,0,0,0,0,0
"Georgia","2024-07-24",0,0,0,0,0,0,0,0
"Georgia","2024-07-25",0,0,0,0,0,0,0,0
"Georgia","2024-07-26",0,0,0,0,0,0,0,0
"Georgia","2024-07-27",0,0,0,0,0,0,0,0
"Georgia","2024-07-28",0,0,0,0,0,0,0,0
"Georgia","2024-07-29",0,0,0,0,0,0,0,0
"Georgia","2024-07-30",0,0,0,0,0,0,0,0
"Georgia","2024-07-31",0,0,0,0,0,0,0,0
"Georgia","2024-08-01",0,0,0,0,0,0,0,0
"Georgia","2024-08-02",0,0,0,0,0,0,0,0
"Georgia","2024-08-03",0,0,0,0,0,0,0,0
"Georgia","2024-08-04",0,0,0,0,0,0,0,0
"Georgia","2024-08-05",0,0,0,0,0,0,0,0
"Georgia","2024-08-06",0,0,0,0,0,0,0,0
"Georgia","2024-08-07",0,0,0,0,0,0,0,0
"Georgia","2024-08-08",0,0,0,0,0,0,0,0
"Georgia","2024-08-09",0,0,0,0,0,0,0,0
"Georgia","2024-08-10",0,0,0,0,0,0,0,0
"Georgia","2024-08-11",0,0,0,0,0,0,0,0
"Georgia","2024-08-12",0,0,0,0,0,0,0,0
"Georgia","2024-08-13",0,0,0,0,0,0,0,0
"Georgia","2024-08-14",0,0,0,0,0,0,0,0
"Georgia","2024-08-15",0,0,0,0,0,0,0,0
"Georgia","2024-08-16",0,0,0,0,0,0,0,0
"Georgia","2024-08-17",0,0,0,0,0,0,0,0
"Georgia","2024-08-18",0,0,0,0,0,0,0,0
"Georgia","2024-08-19",0,0,0,0,0,0,0,0
"Georgia","2024-08-20",0,0,0,0,0,0,0,0
"Georgia","2024-08-21",0,0,0,0,0,0,0,0
"Georgia","2024-08-22",0,0,0,0,0,0,0,0
"Georgia","2024-08-23",0,0,0,0,0,0,0,0
"Georgia","2024-08-24",0,0,0,0,0,0,0,0
"Georgia","2024-08-25",0,0,0,0,0,0,0,0
"Georgia","2024-08-26",0,0,0,0,0,0,0,0
"Georgia","2024-08-27",0,0,0,0,0,0,0,0
"Georgia","2024-08-28",0,0,0,0,0,0,0,0
"Georgia","2024-08-29",0,0,0,0,0,0,0,0
"Georgia","2024-08-30",0,0,0,0,0,0,0,0
"Georgia","2024-08-31",0,0,0,0,0,0,0,0
"Georgia","2024-09-01",0,0,0,0,0,0,0,0
"Georgia","2024-09-02",0,0,0,0,0,0,0,0
"Georgia","2024-09-03",0,0,0,0,0,0,0,0
"Georgia","2024-09-04",0,0,0,0,0,0,0,0
"Georgia","2024-09-05",0,0,0,0,0,0,0,0
"Georgia","2024-09-06",0,0,0,0,0,0,0,0
"Georgia","2024-09-07",0,0,0,0,0,0,0,0
"Georgia","2024-09-08",0,0,0,0,0,0,0,0
"Georgia","2024-09-09",0,0,0,0,0,0,0,0
"Georgia","2024-09-10",0,0,0,0,0,0,0,0
"Georgia","2024-09-11",0,0,0,0,0,0,0,0
"Georgia","2024-09-12",0,0,0,0,0,0,0,0
"Georgia","2024-09-13",0,0,0,0,0,0,0,0
"Georgia","2024-09-14",0,0,0,0,0,0,0,0
"Georgia","2024-09-15",0,0,0,0,0,0,0,0
"Georgia","2024-09-16",0,0,0,0,0,0,0,0
"Georgia","2024-09-17",0,0,0,0,0,0,0,0
"Georgia","2024-09-18",0,0,0,0,0,0,0,0
"Georgia","2024-09-19",0,0,0,0,0,0,0,0
"Georgia","2024-09-20",0,0,0,0,0,0,0,0
"Georgia","2024-09-21",0,0,0,0,0,0,0,0
"Georgia","2024-09-22",0,0,0,0,0,0,0,0
"Georgia","2024-09-23",0,0,0,0,0,0,0,0
"Georgia","2024-09-24",0,0,0,0,0,0,0,0
"Georgia","2024-09-25",0,0,0,0,0,0,0,0
"Georgia","2024-09-26",0,0,0,0,0,0,0,0
"Georgia","2024-09-27",0,0,0,0,0,0,0,0
"Georgia","2024-09-28",0,0,0,0,0,0,0,0
"Georgia","2024-09-29",0,0,0,0,0,0,0,0
"Georgia","2024-09-30",0,0,0,0,0,0,0,0
"Georgia","2024-10-01",0,0,0,0,0,0,0,0
"Georgia","2024-10-02",0,0,0,0,0,0,0,0
"Georgia","2024-10-03",0,0,0,0,0,0,0,0
"Georgia","2024-10-04",0,0,0,0,0,0,0,0
"Georgia","2024-10-05",0,0,0,0,0,0,0,0
"Georgia","2024-10-06",0,0,0,0,0,0,0,0
"Georgia","2024-10-07",0,0,0,0,0,0,0,0
"Georgia","2024-10-08",0,0,0,0,0,0,0,0
"Georgia","2024-10-09",0,0,0,0,0,0,0,0
"Georgia","2024-10-10",0,0,0,0,0,0,0,0
"Georgia","2024-10-11",0,0,0,0,0,0,0,0
"Georgia","2024-10-12",0,0,0,0,0,0,0,0
"Georgia","2024-10-13",0,0,0,0,0,0,0,0
"Georgia","2024-10-14",0,0,0,0,0,0,0,0
"Georgia","2024-10-15",0,0,0,0,0,0,0,0
"Georgia","2024-10-16",0,0,0,0,0,0,0,0
"Georgia","2024-10-17",0,0,0,0,0,0,0,0
"Georgia","2024-10-18",0,0,0,0,0,0,0,0
"Georgia","2024-10-19",0,0,0,0,0,0,0,0
"Georgia","2024-10-20",0,0,0,0,0,0,0,0
"Georgia","2024-10-21",0,0,0,0,0,0,0,0
"Georgia","2024-10-22",0,0,0,0,0,0,0,0
"Georgia","2024-10-23",0,0,0,0,0,0,0,0
"Georgia","2024-10-24",0,0,0,0,0,0,0,0
"Georgia","2024-10-25",0,0,0,0,0,0,0,0
"Georgia","2024-10-26",0,0,0,0,0,0,0,0
"Georgia","2024-10-27",0,0,0,0,0,0,0,0
"Georgia","2024-10-28",0,0,0,0,0,0,0,0
"Georgia","2024-10-29",0,0,0,0,0,0,0,0
"Georgia","2024-10-30",0,0,0,0,0,0,0,0
"Georgia","2024-10-31",0,0,0,0,0,0,0,0
"Georgia","2024-11-01",0,0,0,0,0,0,0,0
"Georgia","2024-11-02",0,0,0,0,0,0,0,0
"Georgia","2024-11-03",0,0,0,0,0,0,0,0
"Georgia","2024-11-04",0,0,0,0,0,0,0,0
"Georgia","2024-11-05",0,0,0,0,0,0,0,0
"Georgia","2024-11-06",0,0,0,0,0,0,0,0
"Georgia","2024-11-07",0,0,0,0,0,0,0,0
"Georgia","2024-11-08",0,0,0,0,0,0,0,0
"Georgia","2024-11-09",0,0,0,0,0,0,0,0
"Georgia","2024-11-10",0,0,0,0,0,0,0,0
"Georgia","2024-11-11",0,0,0,0,0,0,0,0
"Georgia","2024-11-12",0,0,0,0,0,0,0,0
"Georgia","2024-11-13",0,0,0,0,0,0,0,0
"Georgia","2024-11-14",0,0,0,0,0,0,0,0
"Georgia","2024-11-15",0,0,0,0,0,0,0,0
"Georgia","2024-11-16",0,0,0,0,0,0,0,0
"Georgia","2024-11-17",0,0,0,0,0,0,0,0
"Georgia","2024-11-18",0,0,0,0,0,0,0,0
"Georgia","2024-11-19",0,0,0,0,0,0,0,0
"Georgia","2024-11-20",0,0,0,0,0,0,0,0
"Georgia","2024-11-21",0,0,0,0,0,0,0,0
"Georgia","2024-11-22",0,0,0,0,0,0,0,0
"Georgia","2024-11-23",0,0,0,0,0,0,0,0
"Georgia","2024-11-24",0,0,0,0,0,0,0,0
"Georgia","2024-11-25",0,0,0,0,0,0,0,0
"Georgia","2024-11-26",0,0,0,0,0,0,0,0
"Georgia","2024-11-27",0,0,0,0,0,0,0,0
"Georgia","2024-11-28",0,0,0,0,0,0,0,0
"Georgia","2024-11-29",0,0,0,0,0,0,0,0
"Georgia","2024-11-30",0,0,0,0,0,0,0,0
"Georgia","2024-12-01",0,0,0,0,0,0,0,0
"Georgia","2024-12-02",0,0,0,0,0,0,0,0
"Georgia","2024-12-03",0,0,0,0,0,0,0,0
"Georgia","2024-12-04",0,0,0,0,0,0,0,0
"Georgia","2024-12-05",0,0,0,0,0,0,0,0
"Georgia","2024-12-06",0,0,0,0,0,0,0,0
"Georgia","2024-12-07",0,0,0,0,0,0,0,0
"Georgia","2024-12-08",0,0,0,0,0,0,0,0
"Georgia","2024-12-09",0,0,0,0,0,0,0,0
"Georgia","2024-12-10",0,0,0,0,0,0,0,0
"Georgia","2024-12-11",0,0,0,0,0,0,0,0
"Georgia","2024-12-12",0,0,0,0,0,0,0,0
"Georgia","2024-12-13",0,0,0,0,0,0,0,0
"Georgia","2024-12-14",0,0,0,0,0,0,0,0
"Georgia","2024-12-15",0,0,0,0,0,0,0,0
"Georgia","2024-12-16",0,0,0,0,0,0,0,0
"Georgia","2024-12-17",0,0,0,0,0,0,0,0
"Georgia","2024-12-18",0,0,0,0,0,0,0,0
"Georgia","2024-12-19",0,0,0,0,0,0,0,0
"Georgia","2024-12-20",0,0,0,0,0,0,0,0
"Georgia","2024-12-21",0,0,0,0,0,0,0,0
"Georgia","2024-12-22",0,0,0,0,0,0,0,0
"Georgia","2024-12-23",0,0,0,0,0,0,0,0
"Georgia","2024-12-24",0,0,0,0,0,0,0,0
"Georgia","2024-12-25",0,0,0,0,0,0,0,0
"Georgia","2024-12-26",0,0,0,0,0,0,0,0
"Georgia","2024-12-27",0,0,0,0,0,0,0,0
"Georgia","2024-12-28",0,0,0,0,0,0,0,0
"Georgia","2024-12-29",0,0,0,0,0,0,0,0
"Georgia","2024-12-30",0,0,0,0,0,0,0,0
"Georgia","2024-12-31",0,0,0,0,0,0,0,0
"Georgia","2025-01-01",0,0,0,0,0,0,0,0
"Georgia","2025-01-02",0,0,0,0,0,0,0,0
"Georgia","2025-01-03",0,0,0,0,0,0,0,0
"Georgia","2025-01-04",0,0,0,0,0,0,0,0
"Georgia","2025-01-05",0,0,0,0,0,0,0,0
"Georgia","2025-01-06",0,0,0,0,0,0,0,0
"Georgia","2025-01-07",0,0,0,0,0,0,0,0
"Georgia","2025-01-08",0,0,0,0,0,0,0,0
"Georgia","2025-01-09",0,0,0,0,0,0,0,0
"Georgia","2025-01-10",0,0,0,0,0,0,0,0
"Georgia","2025-01-11",0,0,0,0,0,0,0,0
"Georgia","2025-01-12",0,0,0,0,0,0,0,0
"Georgia","2025-01-13",0,0,0,0,0,0,0,0
"Germany","2024-01-01",0,0,0,0,0,0,0,0
"Germany","2024-01-02",0,0,0,0,0,0,0,0
"Germany","2024-01-03",0,0,0,0,0,0,0,0
"Germany","2024-01-04",0,0,0,0,0,0,0,0
"Germany","2024-01-05",0,0,0,0,0,0,0,0
"Germany","2024-01-06",0,0,0,0,0,0,0,0
"Germany","2024-01-07",0,0,0,0,0,0,0,0
"Germany","2024-01-08",0,0,0,0,0,0,0,0
"Germany","2024-01-09",0,0,0,0,0,0,0,0
"Germany","2024-01-10",0,0,0,0,0,0,0,0
"Germany","2024-01-11",0,0,0,0,0,0,0,0
"Germany","2024-01-12",0,0,0,0,0,0,0,0
"Germany","2024-01-13",0,0,0,0,0,0,0,0
"Germany","2024-01-14",0,0,0,0,0,0,0,0
"Germany","2024-01-15",0,0,0,0,0,0,0,0
"Germany","2024-01-16",0,0,0,0,0,0,0,0
"Germany","2024-01-17",0,0,0,0,0,0,0,0
"Germany","2024-01-18",0,0,0,0,0,0,0,0
"Germany","2024-01-19",0,0,0,0,0,0,0,0
"Germany","2024-01-20",0,0,0,0,0,0,0,0
"Germany","2024-01-21",0,0,0,0,0,0,0,0
"Germany","2024-01-22",0,0,0,0,0,0,0,0
"Germany","2024-01-23",0,0,0,0,0,0,0,0
"Germany","2024-01-24",0,0,0,0,0,0,0,0
"Germany","2024-01-25",0,0,0,0,0,0,0,0
"Germany","2024-01-26",0,0,0,0,0,0,0,0
"Germany","2024-01-27",0,0,0,0,0,0,0,0
"Germany","2024-01-28",0,0,0,0,0,0,0,0
"Germany","2024-01-29",0,0,0,0,0,0,0,0
"Germany","2024-01-30",0,0,0,0,0,0,0,0
"Germany","2024-01-31",0,7,7,0,7,7,0,0
"Germany","2024-02-01",0,0,7,0,0,7,0,0
"Germany","2024-02-02",0,0,7,0,1,8,0,0
"Germany","2024-02-03",0,0,7,0,0,8,0,0
"Germany","2024-02-04",0,0,7,0,0,8,0,0
"Germany","2024-02-05",0,0,7,0,1,9,0,0
"Germany","2024-02-06",0,0,7,0,0,9,0,0
"Germany","2024-02-07",0,0,7,0,0,9,0,0
"Germany","2024-02-08",0,0,7,0,0,9,0,0
"Germany","2024-02-09",0,0,7,0,1,10,0,0
"Germany","2024-02-10",0,0,7,0,0,10,0,0
"Germany","2024-02-11",0,0,7,0,0,10,0,0
"Germany","2024-02-12",0,0,7,0,1,11,0,0
"Germany","2024-02-13",0,0,7,0,0,11,0,0
"Germany","2024-02-14",0,0,7,0,0,11,0,0
"Germany","2024-02-15",0,0,7,0,1,12,0,0
"Germany","2024-02-16",0,0,7,0,0,12,0,0
"Germany","2024-02-17",0,0,7,0,0,12,0,0
"Germany","2024-02-18",0,0,7,0,1,13,0,0
"Germany","2024-02-19",0,0,7,0,0,13,0,0
"Germany","2024-02-20",0,0,7,0,0,13,0,0
"Germany","2024-02-21",0,0,7,0,1,14,0,0
"Germany","2024-02-22",0,0,7,0,0,14,0,0
"Germany","2024-02-23",0,0,7,0,0,14,0,0
"Germany","2024-02-24",0,0,7,0,0,14,0,0
"Germany","2024-02-25",0,0,7,0,1,15,0,0
"Germany","2024-02-26",0,0,7,0,0,15,0,0
"Germany","2024-02-27",0,0,7,0,0,15,0,0
"Germany","2024-02-28",0,0,7,0,1,16,0,0
"Germany","2024-02-29",0,9,16,0,0,16,0,0
"Germany","2024-03-01",0,0,16,0,0,16,0,0
"Germany","2024-03-02",0,0,16,0,1,17,0,0
"Germany","2024-03-03",0,0,16,0,0,17,0,0
"Germany","2024-03-04",0,0,16,0,1,18,0,0
"Germany","2024-03-05",0,0,16,0,0,18,0,0
"Germany","2024-03-06",0,0,16,0,1,19,0,0
"Germany","2024-03-07",0,0,16,0,0,19,0,0
"Germany","2024-03-08",0,0,16,0,1,20,0,0
"Germany","2024-03-09",0,0,16,0,0,20,0,0
"Germany","2024-03-10",0,0,16,0,1,21,0,0
"Germany","2024-03-11",0,0,16,0,0,21,0,0
"Germany","2024-03-12",0,0,16,0,0,21,0,0
"Germany","2024-03-13",0,0,16,0,1,22,0,0
"Germany","2024-03-14",0,0,16,0,0,22,0,0
"Germany","2024-03-15",0,0,16,0,1,23,0,0
"Germany","2024-03-16",0,0,16,0,0,23,0,0
"Germany","2024-03-17",0,0,16,0,1,24,0,0
"Germany","2024-03-18",0,0,16,0,0,24,0,0
"Germany","2024-03-19",0,0,16,0,1,25,0,0
"Germany","2024-03-20",0,0,16,0,0,25,0,0
"Germany","2024-03-21",0,0,16,0,0,25,0,0
"Germany","2024-03-22",0,0,16,0,1,26,0,0
"Germany","2024-03-23",0,0,16,0,0,26,0,0
"Germany","2024-03-24",0,0,16,0,1,27,0,0
"Germany","2024-03-25",0,0,16,0,0,27,0,0
"Germany","2024-03-26",0,0,16,0,1,28,0,0
"Germany","2024-03-27",0,0,16,0,0,28,0,0
"Germany","2024-03-28",0,0,16,0,1,29,0,0
"Germany","2024-03-29",0,0,16,0,0,29,0,0
"Germany","2024-03-30",0,0,16,0,1,30,0,0
"Germany","2024-03-31",0,14,30,0,0,30,0,0
"Germany","2024-04-01",0,0,30,0,0,30,0,0
"Germany","2024-04-02",0,0,30,0,1,31,0,0
"Germany","2024-04-03",0,0,30,0,0,31,0,0
"Germany","2024-04-04",0,0,30,0,0,31,0,0
"Germany","2024-04-05",0,0,30,0,1,32,0,0
"Germany","2024-04-06",0,0,30,0,0,32,0,0
"Germany","2024-04-07",0,0,30,0,1,33,0,0
"Germany","2024-04-08",0,0,30,0,0,33,0,0
"Germany","2024-04-09",0,0,30,0,0,33,0,0
"Germany","2024-04-10",0,0,30,0,1,34,0,0
"Germany","2024-04-11",0,0,30,0,0,34,0,0
"Germany","2024-04-12",0,0,30,0,0,34,0,0
"Germany","2024-04-13",0,0,30,0,1,35,0,0
"Germany","2024-04-14",0,0,30,0,0,35,0,0
"Germany","2024-04-15",0,0,30,0,1,36,0,0
"Germany","2024-04-16",0,0,30,0,0,36,0,0
"Germany","2024-04-17",0,0,30,0,0,36,0,0
"Germany","2024-04-18",0,0,30,0,1,37,0,0
"Germany","2024-04-19",0,0,30,0,0,37,0,0
"Germany","2024-04-20",0,0,30,0,0,37,0,0
"Germany","2024-04-21",0,0,30,0,1,38,0,0
"Germany","2024-04-22",0,0,30,0,0,38,0,0
"Germany","2024-04-23",0,0,30,0,0,38,0,0
"Germany","2024-04-24",0,0,30,0,1,39,0,0
"Germany","2024-04-25",0,0,30,0,0,39,0,0
"Germany","2024-04-26",0,0,30,0,1,40,0,0
"Germany","2024-04-27",0,0,30,0,0,40,0,0
"Germany","2024-04-28",0,0,30,0,0,40,0,0
"Germany","2024-04-29",0,0,30,0,1,41,0,0
"Germany","2024-04-30",0,11,41,0,0,41,0,0
"Germany","2024-05-01",0,0,41,0,0,41,0,0
"Germany","2024-05-02",0,0,41,0,0,41,0,0
"Germany","2024-05-03",0,0,41,0,1,42,0,0
"Germany","2024-05-04",0,0,41,0,0,42,0,0
"Germany","2024-05-05",0,0,41,0,0,42,0,0
"Germany","2024-05-06",0,0,41,0,0,42,0,0
"Germany","2024-05-07",0,0,41,0,0,42,0,0
"Germany","2024-05-08",0,0,41,0,1,43,0,0
"Germany","2024-05-09",0,0,41,0,0,43,0,0
"Germany","2024-05-10",0,0,41,0,0,43,0,0
"Germany","2024-05-11",0,0,41,0,0,43,0,0
"Germany","2024-05-12",0,0,41,0,0,43,0,0
"Germany","2024-05-13",0,0,41,0,1,44,0,0
"Germany","2024-05-14",0,0,41,0,0,44,0,0
"Germany","2024-05-15",0,0,41,0,0,44,0,0
"Germany","2024-05-16",0,0,41,0,0,44,0,0
"Germany","2024-05-17",0,0,41,0,0,44,0,0
"Germany","2024-05-18",0,0,41,0,0,44,0,0
"Germany","2024-05-19",0,0,41,0,1,45,0,0
"Germany","2024-05-20",0,0,41,0,0,45,0,0
"Germany","2024-05-21",0,0,41,0,0,45,0,0
"Germany","2024-05-22",0,0,41,0,0,45,0,0
"Germany","2024-05-23",0,0,41,0,0,45,0,0
"Germany","2024-05-24",0,0,41,0,1,46,0,0
"Germany","2024-05-25",0,0,41,0,0,46,0,0
"Germany","2024-05-26",0,0,41,0,0,46,0,0
"Germany","2024-05-27",0,0,41,0,0,46,0,0
"Germany","2024-05-28",0,0,41,0,0,46,0,0
"Germany","2024-05-29",0,0,41,0,1,47,0,0
"Germany","2024-05-30",0,0,41,0,0,47,0,0
"Germany","2024-05-31",0,6,47,0,0,47,0,0
"Germany","2024-06-01",0,0,47,0,0,47,0,0
"Germany","2024-06-02",0,0,47,0,1,48,0,0
"Germany","2024-06-03",0,0,47,0,0,48,0,0
"Germany","2024-06-04",0,0,47,0,0,48,0,0
"Germany","2024-06-05",0,0,47,0,1,49,0,0
"Germany","2024-06-06",0,0,47,0,0,49,0,0
"Germany","2024-06-07",0,0,47,0,0,49,0,0
"Germany","2024-06-08",0,0,47,0,1,50,0,0
"Germany","2024-06-09",0,0,47,0,0,50,0,0
"Germany","2024-06-10",0,0,47,0,0,50,0,0
"Germany","2024-06-11",0,0,47,0,1,51,0,0
"Germany","2024-06-12",0,0,47,0,0,51,0,0
"Germany","2024-06-13",0,0,47,0,0,51,0,0
"Germany","2024-06-14",0,0,47,0,1,52,0,0
"Germany","2024-06-15",0,0,47,0,0,52,0,0
"Germany","2024-06-16",0,0,47,0,0,52,0,0
"Germany","2024-06-17",0,0,47,0,1,53,0,0
"Germany","2024-06-18",0,0,47,0,0,53,0,0
"Germany","2024-06-19",0,0,47,0,0,53,0,0
"Germany","2024-06-20",0,0,47,0,1,54,0,0
"Germany","2024-06-21",0,0,47,0,0,54,0,0
"Germany","2024-06-22",0,0,47,0,0,54,0,0
"Germany","2024-06-23",0,0,47,0,1,55,0,0
"Germany","2024-06-24",0,0,47,0,0,55,0,0
"Germany","2024-06-25",0,0,47,0,0,55,0,0
"Germany","2024-06-26",0,0,47,0,1,56,0,0
"Germany","2024-06-27",0,0,47,0,0,56,0,0
"Germany","2024-06-28",0,0,47,0,0,56,0,0
"Germany","2024-06-29",0,0,47,0,1,57,0,0
"Germany","2024-06-30",0,10,57,0,0,57,0,0
"Germany","2024-07-01",0,0,57,0,1,58,0,0
"Germany","2024-07-02",0,0,57,0,1,59,0,0
"Germany","2024-07-03",0,0,57,0,1,60,0,0
"Germany","2024-07-04",0,0,57,0,1,61,0,0
"Germany","2024-07-05",0,0,57,0,1,62,0,0
"Germany","2024-07-06",0,0,57,0,1,63,0,0
"Germany","2024-07-07",0,0,57,0,1,64,0,0
"Germany","2024-07-08",0,0,57,0,0,64,0,0
"Germany","2024-07-09",0,0,57,0,1,65,0,0
"Germany","2024-07-10",0,0,57,0,1,66,0,0
"Germany","2024-07-11",0,0,57,0,1,67,0,0
"Germany","2024-07-12",0,0,57,0,1,68,0,0
"Germany","2024-07-13",0,0,57,0,1,69,0,0
"Germany","2024-07-14",0,0,57,0,1,70,0,0
"Germany","2024-07-15",0,0,57,0,1,71,0,0
"Germany","2024-07-16",0,0,57,0,1,72,0,0
"Germany","2024-07-17",0,0,57,0,1,73,0,0
"Germany","2024-07-18",0,0,57,0,1,74,0,0
"Germany","2024-07-19",0,0,57,0,1,75,0,0
"Germany","2024-07-20",0,0,57,0,1,76,0,0
"Germany","2024-07-21",0,0,57,0,1,77,0,0
"Germany","2024-07-22",0,0,57,0,1,78,0,0
"Germany","2024-07-23",0,0,57,0,1,79,0,0
"Germany","2024-07-24",0,0,57,0,0,79,0,0
"Germany","2024-07-25",0,0,57,0,1,80,0,0
"Germany","2024-07-26",0,0,57,0,1,81,0,0
"Germany","2024-07-27",0,0,57,0,1,82,0,0
"Germany","2024-07-28",0,0,57,0,1,83,0,0
"Germany","2024-07-29",0,0,57,0,1,84,0,0
"Germany","2024-07-30",0,0,57,0,1,85,0,0
"Germany","2024-07-31",0,29,86,0,1,86,0,0
"Germany","2024-08-01",0,0,86,0,1,87,0,0
"Germany","2024-08-02",0,0,86,0,0,87,0,0
"Germany","2024-08-03",0,0,86,0,1,88,0,0
"Germany","2024-08-04",0,0,86,0,1,89,0,0
"Germany","2024-08-05",0,0,86,0,1,90,0,0
"Germany","2024-08-06",0,0,86,0,0,90,0,0
"Germany","2024-08-07",0,0,86,0,1,91,0,0
"Germany","2024-08-08",0,0,86,0,1,92,0,0
"Germany","2024-08-09",0,0,86,0,1,93,0,0
"Germany","2024-08-10",0,0,86,0,0,93,0,0
"Germany","2024-08-11",0,0,86,0,1,94,0,0
"Germany","2024-08-12",0,0,86,0,1,95,0,0
"Germany","2024-08-13",0,0,86,0,1,96,0,0
"Germany","2024-08-14",0,0,86,0,0,96,0,0
"Germany","2024-08-15",0,0,86,0,1,97,0,0
"Germany","2024-08-16",0,0,86,0,1,98,0,0
"Germany","2024-08-17",0,0,86,0,1,99,0,0
"Germany","2024-08-18",0,0,86,0,0,99,0,0
"Germany","2024-08-19",0,0,86,0,1,100,0,0
"Germany","2024-08-20",0,0,86,0,1,101,0,0
"Germany","2024-08-21",0,0,86,0,1,102,0,0
"Germany","2024-08-22",0,0,86,0,0,102,0,0
"Germany","2024-08-23",0,0,86,0,1,103,0,0
"Germany","2024-08-24",0,0,86,0,1,104,0,0
"Germany","2024-08-25",0,0,86,0,1,105,0,0
"Germany","2024-08-26",0,0,86,0,0,105,0,0
"Germany","2024-08-27",0,0,86,0,1,106,0,0
"Germany","2024-08-28",0,0,86,0,1,107,0,0
"Germany","2024-08-29",0,0,86,0,1,108,0,0
"Germany","2024-08-30",0,0,86,0,0,108,0,0
"Germany","2024-08-31",0,23,109,0,1,109,0,0
"Germany","2024-09-01",0,0,109,0,1,110,0,0
"Germany","2024-09-02",0,0,109,0,1,111,0,0
"Germany","2024-09-03",0,0,109,0,0,111,0,0
"Germany","2024-09-04",0,0,109,0,1,112,0,0
"Germany","2024-09-05",0,0,109,0,1,113,0,0
"Germany","2024-09-06",0,0,109,0,1,114,0,0
"Germany","2024-09-07",0,0,109,0,0,114,0,0
"Germany","2024-09-08",0,0,109,0,1,115,0,0
"Germany","2024-09-09",0,0,109,0,1,116,0,0
"Germany","2024-09-10",0,0,109,0,1,117,0,0
"Germany","2024-09-11",0,0,109,0,0,117,0,0
"Germany","2024-09-12",0,0,109,0,1,118,0,0
"Germany","2024-09-13",0,0,109,0,1,119,0,0
"Germany","2024-09-14",0,0,109,0,1,120,0,0
"Germany","2024-09-15",0,0,109,0,1,121,0,0
"Germany","2024-09-16",0,0,109,0,0,121,0,0
"Germany","2024-09-17",0,0,109,0,1,122,0,0
"Germany","2024-09-18",0,0,109,0,1,123,0,0
"Germany","2024-09-19",0,0,109,0,1,124,0,0
"Germany","2024-09-20",0,0,109,0,0,124,0,0
"Germany","2024-09-21",0,0,109,0,1,125,0,0
"Germany","2024-09-22",0,0,109,0,1,126,0,0
"Germany","2024-09-23",0,0,109,0,1,127,0,0
"Germany","2024-09-24",0,0,109,0,0,127,0,0
"Germany","2024-09-25",0,0,109,0,1,128,0,0
"Germany","2024-09-26",0,0,109,0,1,129,0,0
"Germany","2024-09-27",0,0,109,0,1,130,0,0
"Germany","2024-09-28",0,0,109,0,0,130,0,0
"Germany","2024-09-29",0,0,109,0,1,131,0,0
"Germany","2024-09-30",0,23,132,0,1,132,0,0
"Germany","2024-10-01",0,0,132,0,2,134,0,0
"Germany","2024-10-02",0,0,132,0,1,135,0,0
"Germany","2024-10-03",0,0,132,0,2,137,0,0
"Germany","2024-10-04",0,0,132,0,1,138,0,0
"Germany","2024-10-05",0,0,132,0,2,140,0,0
"Germany","2024-10-06",0,0,132,0,1,141,0,0
"Germany","2024-10-07",0,0,132,0,2,143,0,0
"Germany","2024-10-08",0,0,132,0,1,144,0,0
"Germany","2024-10-09",0,0,132,0,2,146,0,0
"Germany","2024-10-10",0,0,132,0,1,147,0,0
"Germany","2024-10-11",0,0,132,0,2,149,0,0
"Germany","2024-10-12",0,0,132,0,2,151,0,0
"Germany","2024-10-13",0,0,132,0,1,152,0,0
"Germany","2024-10-14",0,0,132,0,2,154,0,0
"Germany","2024-10-15",0,0,132,0,1,155,0,0
"Germany","2024-10-16",0,0,132,0,2,157,0,0
"Germany","2024-10-17",0,0,132,0,1,158,0,0
"Germany","2024-10-18",0,0,132,0,2,160,0,0
"Germany","2024-10-19",0,0,132,0,1,161,0,0
"Germany","2024-10-20",0,0,132,0,2,163,0,0
"Germany","2024-10-21",0,0,132,0,2,165,0,0
"Germany","2024-10-22",0,0,132,0,1,166,0,0
"Germany","2024-10-23",0,0,132,0,2,168,0,0
"Germany","2024-10-24",0,0,132,0,1,169,0,0
"Germany","2024-10-25",0,0,132,0,2,171,0,0
"Germany","2024-10-26",0,0,132,0,1,172,0,0
"Germany","2024-10-27",0,0,132,0,2,174,0,0
"Germany","2024-10-28",0,0,132,0,1,175,0,0
"Germany","2024-10-29",0,0,132,0,2,177,0,0
"Germany","2024-10-30",0,0,132,0,1,178,0,0
"Germany","2024-10-31",0,48,180,0,2,180,0,0
"Germany","2024-11-01",0,0,180,0,2,182,0,0
"Germany","2024-11-02",0,0,180,0,2,184,0,0
"Germany","2024-11-03",0,0,180,0,2,186,0,0
"Germany","2024-11-04",0,0,180,0,2,188,0,0
"Germany","2024-11-05",0,0,180,0,2,190,0,0
"Germany","2024-11-06",0,0,180,0,2,192,0,0
"Germany","2024-11-07",0,0,180,0,2,194,0,0
"Germany","2024-11-08",0,0,180,0,2,196,0,0
"Germany","2024-11-09",0,0,180,0,2,198,0,0
"Germany","2024-11-10",0,0,180,0,2,200,0,0
"Germany","2024-11-11",0,0,180,0,2,202,0,0
"Germany","2024-11-12",0,0,180,0,2,204,0,0
"Germany","2024-11-13",0,0,180,0,2,206,0,0
"Germany","2024-11-14",0,0,180,0,2,208,0,0
"Germany","2024-11-15",0,0,180,0,2,210,0,0
"Germany","2024-11-16",0,0,180,0,2,212,0,0
"Germany","2024-11-17",0,0,180,0,2,214,0,0
"Germany","2024-11-18",0,0,180,0,2,216,0,0
"Germany","2024-11-19",0,0,180,0,2,218,0,0
"Germany","2024-11-20",0,0,180,0,2,220,0,0
"Germany","2024-11-21",0,0,180,0,2,222,0,0
"Germany","2024-11-22",0,0,180,0,2,224,0,0
"Germany","2024-11-23",0,0,180,0,2,226,0,0
"Germany","2024-11-24",0,0,180,0,2,228,0,0
"Germany","2024-11-25",0,0,180,0,2,230,0,0
"Germany","2024-11-26",0,0,180,0,2,232,0,0
"Germany","2024-11-27",0,0,180,0,2,234,0,0
"Germany","2024-11-28",0,0,180,0,2,236,0,0
"Germany","2024-11-29",0,0,180,0,2,238,0,0
"Germany","2024-11-30",0,60,240,0,2,240,0,0
"Germany","2024-12-01",0,0,240,0,0,240,0,0
"Germany","2024-12-02",0,0,240,0,0,240,0,0
"Germany","2024-12-03",0,0,240,0,0,240,0,0
"Germany","2024-12-04",0,0,240,0,0,240,0,0
"Germany","2024-12-05",0,0,240,0,0,240,0,0
"Germany","2024-12-06",0,0,240,0,0,240,0,0
"Germany","2024-12-07",0,0,240,0,0,240,0,0
"Germany","2024-12-08",0,0,240,0,0,240,0,0
"Germany","2024-12-09",0,0,240,0,0,240,0,0
"Germany","2024-12-10",0,0,240,0,0,240,0,0
"Germany","2024-12-11",0,0,240,0,0,240,0,0
"Germany","2024-12-12",0,0,240,0,0,240,0,0
"Germany","2024-12-13",0,0,240,0,0,240,0,0
"Germany","2024-12-14",0,0,240,0,0,240,0,0
"Germany","2024-12-15",0,0,240,0,0,240,0,0
"Germany","2024-12-16",0,0,240,0,0,240,0,0
"Germany","2024-12-17",0,0,240,0,0,240,0,0
"Germany","2024-12-18",0,0,240,0,0,240,0,0
"Germany","2024-12-19",0,0,240,0,0,240,0,0
"Germany","2024-12-20",0,0,240,0,0,240,0,0
"Germany","2024-12-21",0,0,240,0,0,240,0,0
"Germany","2024-12-22",0,0,240,0,0,240,0,0
"Germany","2024-12-23",0,0,240,0,0,240,0,0
"Germany","2024-12-24",0,0,240,0,0,240,0,0
"Germany","2024-12-25",0,0,240,0,0,240,0,0
"Germany","2024-12-26",0,0,240,0,0,240,0,0
"Germany","2024-12-27",0,0,240,0,0,240,0,0
"Germany","2024-12-28",0,0,240,0,0,240,0,0
"Germany","2024-12-29",0,0,240,0,0,240,0,0
"Germany","2024-12-30",0,0,240,0,0,240,0,0
"Germany","2024-12-31",0,0,240,0,0,240,0,0
"Germany","2025-01-01",0,0,240,0,0,240,0,0
"Germany","2025-01-02",0,0,240,0,0,240,0,0
"Germany","2025-01-03",0,0,240,0,0,240,0,0
"Germany","2025-01-04",0,0,240,0,0,240,0,0
"Germany","2025-01-05",0,0,240,0,0,240,0,0
"Germany","2025-01-06",0,0,240,0,0,240,0,0
"Germany","2025-01-07",0,0,240,0,0,240,0,0
"Germany","2025-01-08",0,0,240,0,0,240,0,0
"Germany","2025-01-09",0,0,240,0,0,240,0,0
"Germany","2025-01-10",0,0,240,0,0,240,0,0
"Germany","2025-01-11",0,0,240,0,0,240,0,0
"Germany","2025-01-12",0,0,240,0,0,240,0,0
"Germany","2025-01-13",0,0,240,0,0,240,0,0
"Ghana","2024-01-01",0,0,0,0,0,0,0,0
"Ghana","2024-01-02",0,0,0,0,0,0,0,0
"Ghana","2024-01-03",0,0,0,0,0,0,0,0
"Ghana","2024-01-04",0,0,0,0,0,0,0,0
"Ghana","2024-01-05",0,0,0,0,0,0,0,0
"Ghana","2024-01-06",0,0,0,0,0,0,0,0
"Ghana","2024-01-07",0,0,0,0,0,0,0,0
"Ghana","2024-01-08",0,0,0,0,0,0,0,0
"Ghana","2024-01-09",0,0,0,0,0,0,0,0
"Ghana","2024-01-10",0,0,0,0,0,0,0,0
"Ghana","2024-01-11",0,0,0,0,0,0,0,0
"Ghana","2024-01-12",0,0,0,0,0,0,0,0
"Ghana","2024-01-13",0,0,0,0,0,0,0,0
"Ghana","2024-01-14",0,0,0,0,0,0,0,0
"Ghana","2024-01-15",0,0,0,0,0,0,0,0
"Ghana","2024-01-16",0,0,0,0,0,0,0,0
"Ghana","2024-01-17",0,0,0,0,0,0,0,0
"Ghana","2024-01-18",0,0,0,0,0,0,0,0
"Ghana","2024-01-19",0,0,0,0,0,0,0,0
"Ghana","2024-01-20",0,0,0,0,0,0,0,0
"Ghana","2024-01-21",0,0,0,0,0,0,0,0
"Ghana","2024-01-22",0,0,0,0,0,0,0,0
"Ghana","2024-01-23",0,0,0,0,0,0,0,0
"Ghana","2024-01-24",0,0,0,0,0,0,0,0
"Ghana","2024-01-25",0,0,0,0,0,0,0,0
"Ghana","2024-01-26",0,0,0,0,0,0,0,0
"Ghana","2024-01-27",0,0,0,0,0,0,0,0
"Ghana","2024-01-28",0,0,0,0,0,0,0,0
"Ghana","2024-01-29",0,0,0,0,0,0,0,0
"Ghana","2024-01-30",0,0,0,0,0,0,0,0
"Ghana","2024-01-31",0,0,0,0,0,0,0,0
"Ghana","2024-02-01",0,0,0,0,0,0,0,0
"Ghana","2024-02-02",0,0,0,0,0,0,0,0
"Ghana","2024-02-03",0,0,0,0,0,0,0,0
"Ghana","2024-02-04",0,0,0,0,0,0,0,0
"Ghana","2024-02-05",0,0,0,0,0,0,0,0
"Ghana","2024-02-06",0,0,0,0,0,0,0,0
"Ghana","2024-02-07",0,0,0,0,0,0,0,0
"Ghana","2024-02-08",0,0,0,0,0,0,0,0
"Ghana","2024-02-09",0,0,0,0,0,0,0,0
"Ghana","2024-02-10",0,0,0,0,0,0,0,0
"Ghana","2024-02-11",0,0,0,0,0,0,0,0
"Ghana","2024-02-12",0,0,0,0,0,0,0,0
"Ghana","2024-02-13",0,0,0,0,0,0,0,0
"Ghana","2024-02-14",0,0,0,0,0,0,0,0
"Ghana","2024-02-15",0,0,0,0,0,0,0,0
"Ghana","2024-02-16",0,0,0,0,0,0,0,0
"Ghana","2024-02-17",0,0,0,0,0,0,0,0
"Ghana","2024-02-18",0,0,0,0,0,0,0,0
"Ghana","2024-02-19",0,0,0,0,0,0,0,0
"Ghana","2024-02-20",0,0,0,0,0,0,0,0
"Ghana","2024-02-21",0,0,0,0,0,0,0,0
"Ghana","2024-02-22",0,0,0,0,0,0,0,0
"Ghana","2024-02-23",0,0,0,0,0,0,0,0
"Ghana","2024-02-24",0,0,0,0,0,0,0,0
"Ghana","2024-02-25",0,0,0,0,0,0,0,0
"Ghana","2024-02-26",0,0,0,0,0,0,0,0
"Ghana","2024-02-27",0,0,0,0,0,0,0,0
"Ghana","2024-02-28",0,0,0,0,0,0,0,0
"Ghana","2024-02-29",0,0,0,0,0,0,0,0
"Ghana","2024-03-01",0,0,0,0,0,0,0,0
"Ghana","2024-03-02",0,0,0,0,0,0,0,0
"Ghana","2024-03-03",0,0,0,0,0,0,0,0
"Ghana","2024-03-04",0,0,0,0,0,0,0,0
"Ghana","2024-03-05",0,0,0,0,0,0,0,0
"Ghana","2024-03-06",0,0,0,0,0,0,0,0
"Ghana","2024-03-07",0,0,0,0,0,0,0,0
"Ghana","2024-03-08",0,0,0,0,0,0,0,0
"Ghana","2024-03-09",0,0,0,0,0,0,0,0
"Ghana","2024-03-10",0,0,0,0,0,0,0,0
"Ghana","2024-03-11",0,0,0,0,0,0,0,0
"Ghana","2024-03-12",0,0,0,0,0,0,0,0
"Ghana","2024-03-13",0,0,0,0,0,0,0,0
"Ghana","2024-03-14",0,0,0,0,0,0,0,0
"Ghana","2024-03-15",0,0,0,0,0,0,0,0
"Ghana","2024-03-16",0,0,0,0,0,0,0,0
"Ghana","2024-03-17",0,0,0,0,0,0,0,0
"Ghana","2024-03-18",0,0,0,0,0,0,0,0
"Ghana","2024-03-19",0,0,0,0,0,0,0,0
"Ghana","2024-03-20",0,0,0,0,0,0,0,0
"Ghana","2024-03-21",0,0,0,0,0,0,0,0
"Ghana","2024-03-22",0,0,0,0,0,0,0,0
"Ghana","2024-03-23",0,0,0,0,0,0,0,0
"Ghana","2024-03-24",0,0,0,0,0,0,0,0
"Ghana","2024-03-25",0,0,0,0,0,0,0,0
"Ghana","2024-03-26",0,0,0,0,0,0,0,0
"Ghana","2024-03-27",0,0,0,0,0,0,0,0
"Ghana","2024-03-28",0,0,0,0,0,0,0,0
"Ghana","2024-03-29",0,0,0,0,0,0,0,0
"Ghana","2024-03-30",0,0,0,0,0,0,0,0
"Ghana","2024-03-31",0,0,0,0,0,0,0,0
"Ghana","2024-04-01",0,0,0,0,0,0,0,0
"Ghana","2024-04-02",0,0,0,0,0,0,0,0
"Ghana","2024-04-03",0,0,0,0,0,0,0,0
"Ghana","2024-04-04",0,0,0,0,0,0,0,0
"Ghana","2024-04-05",0,0,0,0,0,0,0,0
"Ghana","2024-04-06",0,0,0,0,0,0,0,0
"Ghana","2024-04-07",0,0,0,0,0,0,0,0
"Ghana","2024-04-08",0,0,0,0,0,0,0,0
"Ghana","2024-04-09",0,0,0,0,0,0,0,0
"Ghana","2024-04-10",0,0,0,0,0,0,0,0
"Ghana","2024-04-11",0,0,0,0,0,0,0,0
"Ghana","2024-04-12",0,0,0,0,0,0,0,0
"Ghana","2024-04-13",0,0,0,0,0,0,0,0
"Ghana","2024-04-14",0,0,0,0,0,0,0,0
"Ghana","2024-04-15",0,0,0,0,0,0,0,0
"Ghana","2024-04-16",0,0,0,0,0,0,0,0
"Ghana","2024-04-17",0,0,0,0,0,0,0,0
"Ghana","2024-04-18",0,0,0,0,0,0,0,0
"Ghana","2024-04-19",0,0,0,0,0,0,0,0
"Ghana","2024-04-20",0,0,0,0,0,0,0,0
"Ghana","2024-04-21",0,0,0,0,0,0,0,0
"Ghana","2024-04-22",0,0,0,0,0,0,0,0
"Ghana","2024-04-23",0,0,0,0,0,0,0,0
"Ghana","2024-04-24",0,0,0,0,0,0,0,0
"Ghana","2024-04-25",0,0,0,0,0,0,0,0
"Ghana","2024-04-26",0,0,0,0,0,0,0,0
"Ghana","2024-04-27",0,0,0,0,0,0,0,0
"Ghana","2024-04-28",0,0,0,0,0,0,0,0
"Ghana","2024-04-29",0,0,0,0,0,0,0,0
"Ghana","2024-04-30",0,0,0,0,0,0,0,0
"Ghana","2024-05-01",0,0,0,0,0,0,0,0
"Ghana","2024-05-02",0,0,0,0,0,0,0,0
"Ghana","2024-05-03",0,0,0,0,0,0,0,0
"Ghana","2024-05-04",0,0,0,0,0,0,0,0
"Ghana","2024-05-05",0,0,0,0,0,0,0,0
"Ghana","2024-05-06",0,0,0,0,0,0,0,0
"Ghana","2024-05-07",0,0,0,0,0,0,0,0
"Ghana","2024-05-08",0,0,0,0,0,0,0,0
"Ghana","2024-05-09",0,0,0,0,0,0,0,0
"Ghana","2024-05-10",0,0,0,0,0,0,0,0
"Ghana","2024-05-11",0,0,0,0,0,0,0,0
"Ghana","2024-05-12",0,0,0,0,0,0,0,0
"Ghana","2024-05-13",0,0,0,0,0,0,0,0
"Ghana","2024-05-14",0,0,0,0,0,0,0,0
"Ghana","2024-05-15",0,0,0,0,0,0,0,0
"Ghana","2024-05-16",0,0,0,0,0,0,0,0
"Ghana","2024-05-17",0,0,0,0,0,0,0,0
"Ghana","2024-05-18",0,0,0,0,0,0,0,0
"Ghana","2024-05-19",0,0,0,0,0,0,0,0
"Ghana","2024-05-20",0,0,0,0,0,0,0,0
"Ghana","2024-05-21",0,0,0,0,0,0,0,0
"Ghana","2024-05-22",0,0,0,0,0,0,0,0
"Ghana","2024-05-23",0,0,0,0,0,0,0,0
"Ghana","2024-05-24",0,0,0,0,0,0,0,0
"Ghana","2024-05-25",0,0,0,0,0,0,0,0
"Ghana","2024-05-26",0,0,0,0,0,0,0,0
"Ghana","2024-05-27",0,0,0,0,0,0,0,0
"Ghana","2024-05-28",0,0,0,0,0,0,0,0
"Ghana","2024-05-29",0,0,0,0,0,0,0,0
"Ghana","2024-05-30",0,0,0,0,0,0,0,0
"Ghana","2024-05-31",0,0,0,0,0,0,0,0
"Ghana","2024-06-01",0,0,0,0,0,0,0,0
"Ghana","2024-06-02",0,0,0,0,0,0,0,0
"Ghana","2024-06-03",0,0,0,0,0,0,0,0
"Ghana","2024-06-04",0,0,0,0,0,0,0,0
"Ghana","2024-06-05",0,0,0,0,0,0,0,0
"Ghana","2024-06-06",0,0,0,0,0,0,0,0
"Ghana","2024-06-07",0,0,0,0,0,0,0,0
"Ghana","2024-06-08",0,0,0,0,0,0,0,0
"Ghana","2024-06-09",0,0,0,0,0,0,0,0
"Ghana","2024-06-10",0,0,0,0,0,0,0,0
"Ghana","2024-06-11",0,0,0,0,0,0,0,0
"Ghana","2024-06-12",0,0,0,0,0,0,0,0
"Ghana","2024-06-13",0,0,0,0,0,0,0,0
"Ghana","2024-06-14",0,0,0,0,0,0,0,0
"Ghana","2024-06-15",0,0,0,0,0,0,0,0
"Ghana","2024-06-16",0,0,0,0,0,0,0,0
"Ghana","2024-06-17",0,0,0,0,0,0,0,0
"Ghana","2024-06-18",0,0,0,0,0,0,0,0
"Ghana","2024-06-19",0,0,0,0,0,0,0,0
"Ghana","2024-06-20",0,0,0,0,0,0,0,0
"Ghana","2024-06-21",0,0,0,0,0,0,0,0
"Ghana","2024-06-22",0,0,0,0,0,0,0,0
"Ghana","2024-06-23",0,0,0,0,0,0,0,0
"Ghana","2024-06-24",0,0,0,0,0,0,0,0
"Ghana","2024-06-25",0,0,0,0,0,0,0,0
"Ghana","2024-06-26",0,0,0,0,0,0,0,0
"Ghana","2024-06-27",0,0,0,0,0,0,0,0
"Ghana","2024-06-28",0,0,0,0,0,0,0,0
"Ghana","2024-06-29",0,0,0,0,0,0,0,0
"Ghana","2024-06-30",0,0,0,0,0,0,0,0
"Ghana","2024-07-01",0,0,0,0,0,0,0,0
"Ghana","2024-07-02",0,0,0,0,0,0,0,0
"Ghana","2024-07-03",0,0,0,0,0,0,0,0
"Ghana","2024-07-04",0,0,0,0,0,0,0,0
"Ghana","2024-07-05",0,0,0,0,0,0,0,0
"Ghana","2024-07-06",0,0,0,0,0,0,0,0
"Ghana","2024-07-07",0,0,0,0,0,0,0,0
"Ghana","2024-07-08",0,0,0,0,0,0,0,0
"Ghana","2024-07-09",0,0,0,0,0,0,0,0
"Ghana","2024-07-10",0,0,0,0,0,0,0,0
"Ghana","2024-07-11",0,0,0,0,0,0,0,0
"Ghana","2024-07-12",0,0,0,0,0,0,0,0
"Ghana","2024-07-13",0,0,0,0,0,0,0,0
"Ghana","2024-07-14",0,0,0,0,0,0,0,0
"Ghana","2024-07-15",0,0,0,0,0,0,0,0
"Ghana","2024-07-16",0,0,0,0,0,0,0,0
"Ghana","2024-07-17",0,0,0,0,0,0,0,0
"Ghana","2024-07-18",0,0,0,0,0,0,0,0
"Ghana","2024-07-19",0,0,0,0,0,0,0,0
"Ghana","2024-07-20",0,0,0,0,0,0,0,0
"Ghana","2024-07-21",0,0,0,0,0,0,0,0
"Ghana","2024-07-22",0,0,0,0,0,0,0,0
"Ghana","2024-07-23",0,0,0,0,0,0,0,0
"Ghana","2024-07-24",0,0,0,0,0,0,0,0
"Ghana","2024-07-25",0,0,0,0,0,0,0,0
"Ghana","2024-07-26",0,0,0,0,0,0,0,0
"Ghana","2024-07-27",0,0,0,0,0,0,0,0
"Ghana","2024-07-28",0,0,0,0,0,0,0,0
"Ghana","2024-07-29",0,0,0,0,0,0,0,0
"Ghana","2024-07-30",0,0,0,0,0,0,0,0
"Ghana","2024-07-31",0,0,0,0,0,0,0,0
"Ghana","2024-08-01",0,0,0,0,0,0,0,0
"Ghana","2024-08-02",0,0,0,0,0,0,0,0
"Ghana","2024-08-03",0,0,0,0,0,0,0,0
"Ghana","2024-08-04",0,0,0,0,0,0,0,0
"Ghana","2024-08-05",0,0,0,0,0,0,0,0
"Ghana","2024-08-06",0,0,0,0,0,0,0,0
"Ghana","2024-08-07",0,0,0,0,0,0,0,0
"Ghana","2024-08-08",0,0,0,0,0,0,0,0
"Ghana","2024-08-09",0,0,0,0,0,0,0,0
"Ghana","2024-08-10",0,0,0,0,0,0,0,0
"Ghana","2024-08-11",0,0,0,0,0,0,0,0
"Ghana","2024-08-12",0,0,0,0,0,0,0,0
"Ghana","2024-08-13",0,0,0,0,0,0,0,0
"Ghana","2024-08-14",0,0,0,0,0,0,0,0
"Ghana","2024-08-15",0,0,0,0,0,0,0,0
"Ghana","2024-08-16",0,0,0,0,0,0,0,0
"Ghana","2024-08-17",0,0,0,0,0,0,0,0
"Ghana","2024-08-18",0,0,0,0,0,0,0,0
"Ghana","2024-08-19",0,0,0,0,0,0,0,0
"Ghana","2024-08-20",0,0,0,0,0,0,0,0
"Ghana","2024-08-21",0,0,0,0,0,0,0,0
"Ghana","2024-08-22",0,0,0,0,0,0,0,0
"Ghana","2024-08-23",0,0,0,0,0,0,0,0
"Ghana","2024-08-24",0,0,0,0,0,0,0,0
"Ghana","2024-08-25",0,0,0,0,0,0,0,0
"Ghana","2024-08-26",0,0,0,0,0,0,0,0
"Ghana","2024-08-27",0,0,0,0,0,0,0,0
"Ghana","2024-08-28",0,0,0,0,0,0,0,0
"Ghana","2024-08-29",0,0,0,0,0,0,0,0
"Ghana","2024-08-30",0,0,0,0,0,0,0,0
"Ghana","2024-08-31",0,0,0,0,0,0,0,0
"Ghana","2024-09-01",0,0,0,0,0,0,0,0
"Ghana","2024-09-02",0,0,0,0,0,0,0,0
"Ghana","2024-09-03",0,0,0,0,0,0,0,0
"Ghana","2024-09-04",0,0,0,0,0,0,0,0
"Ghana","2024-09-05",0,0,0,0,0,0,0,0
"Ghana","2024-09-06",0,0,0,0,0,0,0,0
"Ghana","2024-09-07",0,0,0,0,0,0,0,0
"Ghana","2024-09-08",0,0,0,0,0,0,0,0
"Ghana","2024-09-09",0,0,0,0,0,0,0,0
"Ghana","2024-09-10",0,0,0,0,0,0,0,0
"Ghana","2024-09-11",0,0,0,0,0,0,0,0
"Ghana","2024-09-12",0,0,0,0,0,0,0,0
"Ghana","2024-09-13",0,0,0,0,0,0,0,0
"Ghana","2024-09-14",0,0,0,0,0,0,0,0
"Ghana","2024-09-15",0,0,0,0,0,0,0,0
"Ghana","2024-09-16",0,0,0,0,0,0,0,0
"Ghana","2024-09-17",0,0,0,0,0,0,0,0
"Ghana","2024-09-18",0,0,0,0,0,0,0,0
"Ghana","2024-09-19",0,0,0,0,0,0,0,0
"Ghana","2024-09-20",0,0,0,0,0,0,0,0
"Ghana","2024-09-21",0,0,0,0,0,0,0,0
"Ghana","2024-09-22",0,1,1,0,1,1,0,0
"Ghana","2024-09-23",0,0,1,0,0,1,0,0
"Ghana","2024-09-24",0,0,1,0,0,1,0,0
"Ghana","2024-09-25",0,0,1,0,0,1,0,0
"Ghana","2024-09-26",0,0,1,0,1,2,0,0
"Ghana","2024-09-27",0,0,1,0,0,2,0,0
"Ghana","2024-09-28",0,0,1,0,0,2,0,0
"Ghana","2024-09-29",0,1,2,0,0,2,0,0
"Ghana","2024-09-30",0,0,2,0,0,2,0,0
"Ghana","2024-10-01",0,0,2,0,0,2,0,0
"Ghana","2024-10-02",0,0,2,0,0,2,0,0
"Ghana","2024-10-03",0,0,2,0,0,2,0,0
"Ghana","2024-10-04",0,0,2,0,0,2,0,0
"Ghana","2024-10-05",0,0,2,0,0,2,0,0
"Ghana","2024-10-06",0,0,2,0,0,2,0,0
"Ghana","2024-10-07",0,0,2,0,0,2,0,0
"Ghana","2024-10-08",0,0,2,0,0,2,0,0
"Ghana","2024-10-09",0,0,2,0,0,2,0,0
"Ghana","2024-10-10",0,0,2,0,0,2,0,0
"Ghana","2024-10-11",0,0,2,0,0,2,0,0
"Ghana","2024-10-12",0,0,2,0,0,2,0,0
"Ghana","2024-10-13",0,0,2,0,0,2,0,0
"Ghana","2024-10-14",0,0,2,0,1,3,0,0
"Ghana","2024-10-15",0,0,2,0,0,3,0,0
"Ghana","2024-10-16",0,0,2,0,0,3,0,0
"Ghana","2024-10-17",0,0,2,0,0,3,0,0
"Ghana","2024-10-18",0,0,2,0,0,3,0,0
"Ghana","2024-10-19",0,0,2,0,0,3,0,0
"Ghana","2024-10-20",0,0,2,0,0,3,0,0
"Ghana","2024-10-21",0,0,2,0,0,3,0,0
"Ghana","2024-10-22",0,0,2,0,0,3,0,0
"Ghana","2024-10-23",0,0,2,0,0,3,0,0
"Ghana","2024-10-24",0,0,2,0,0,3,0,0
"Ghana","2024-10-25",0,0,2,0,0,3,0,0
"Ghana","2024-10-26",0,0,2,0,0,3,0,0
"Ghana","2024-10-27",0,1,3,0,0,3,0,0
"Ghana","2024-10-28",0,0,3,0,0,3,0,0
"Ghana","2024-10-29",0,0,3,0,0,3,0,0
"Ghana","2024-10-30",0,0,3,0,0,3,0,0
"Ghana","2024-10-31",0,0,3,0,0,3,0,0
"Ghana","2024-11-01",0,0,3,0,0,3,0,0
"Ghana","2024-11-02",0,0,3,0,0,3,0,0
"Ghana","2024-11-03",0,0,3,0,0,3,0,0
"Ghana","2024-11-04",0,0,3,0,0,3,0,0
"Ghana","2024-11-05",0,0,3,0,0,3,0,0
"Ghana","2024-11-06",0,0,3,0,0,3,0,0
"Ghana","2024-11-07",0,0,3,0,1,4,0,0
"Ghana","2024-11-08",0,0,3,0,0,4,0,0
"Ghana","2024-11-09",0,0,3,0,0,4,0,0
"Ghana","2024-11-10",0,0,3,0,0,4,0,0
"Ghana","2024-11-11",0,0,3,0,0,4,0,0
"Ghana","2024-11-12",0,0,3,0,0,4,0,0
"Ghana","2024-11-13",0,0,3,0,0,4,0,0
"Ghana","2024-11-14",0,0,3,0,0,4,0,0
"Ghana","2024-11-15",0,0,3,0,0,4,0,0
"Ghana","2024-11-16",0,0,3,0,0,4,0,0
"Ghana","2024-11-17",0,1,4,0,0,4,0,0
"Ghana","2024-11-18",0,0,4,0,0,4,0,0
"Ghana","2024-11-19",0,0,4,0,0,4,0,0
"Ghana","2024-11-20",0,0,4,0,0,4,0,0
"Ghana","2024-11-21",0,0,4,0,1,5,0,0
"Ghana","2024-11-22",0,0,4,0,0,5,0,0
"Ghana","2024-11-23",0,0,4,0,0,5,0,0
"Ghana","2024-11-24",0,1,5,0,0,5,0,0
"Ghana","2024-11-25",0,0,5,0,0,5,0,0
"Ghana","2024-11-26",0,0,5,0,0,5,0,0
"Ghana","2024-11-27",0,0,5,0,0,5,0,0
"Ghana","2024-11-28",0,0,5,0,0,5,0,0
"Ghana","2024-11-29",0,0,5,0,0,5,0,0
"Ghana","2024-11-30",0,0,5,0,0,5,0,0
"Ghana","2024-12-01",0,0,5,0,0,5,0,0
"Ghana","2024-12-02",0,0,5,0,0,5,0,0
"Ghana","2024-12-03",0,0,5,0,0,5,0,0
"Ghana","2024-12-04",0,0,5,0,0,5,0,0
"Ghana","2024-12-05",0,0,5,0,0,5,0,0
"Ghana","2024-12-06",0,0,5,0,0,5,0,0
"Ghana","2024-12-07",0,0,5,0,0,5,0,0
"Ghana","2024-12-08",0,0,5,0,0,5,0,0
"Ghana","2024-12-09",0,0,5,0,0,5,0,0
"Ghana","2024-12-10",0,0,5,0,0,5,0,0
"Ghana","2024-12-11",0,0,5,0,0,5,0,0
"Ghana","2024-12-12",0,0,5,0,0,5,0,0
"Ghana","2024-12-13",0,0,5,0,0,5,0,0
"Ghana","2024-12-14",0,0,5,0,0,5,0,0
"Ghana","2024-12-15",0,0,5,0,0,5,0,0
"Ghana","2024-12-16",0,0,5,0,0,5,0,0
"Ghana","2024-12-17",0,0,5,0,0,5,0,0
"Ghana","2024-12-18",0,0,5,0,0,5,0,0
"Ghana","2024-12-19",0,0,5,0,0,5,0,0
"Ghana","2024-12-20",0,0,5,0,0,5,0,0
"Ghana","2024-12-21",0,0,5,0,0,5,0,0
"Ghana","2024-12-22",0,0,5,0,0,5,0,0
"Ghana","2024-12-23",0,0,5,0,0,5,0,0
"Ghana","2024-12-24",0,0,5,0,0,5,0,0
"Ghana","2024-12-25",0,0,5,0,0,5,0,0
"Ghana","2024-12-26",0,0,5,0,0,5,0,0
"Ghana","2024-12-27",0,0,5,0,0,5,0,0
"Ghana","2024-12-28",0,0,5,0,0,5,0,0
"Ghana","2024-12-29",0,0,5,0,0,5,0,0
"Ghana","2024-12-30",0,0,5,0,0,5,0,0
"Ghana","2024-12-31",0,0,5,0,0,5,0,0
"Ghana","2025-01-01",0,0,5,0,0,5,0,0
"Ghana","2025-01-02",0,0,5,0,0,5,0,0
"Ghana","2025-01-03",0,0,5,0,0,5,0,0
"Ghana","2025-01-04",0,0,5,0,0,5,0,0
"Ghana","2025-01-05",0,0,5,0,0,5,0,0
"Ghana","2025-01-06",0,0,5,0,0,5,0,0
"Ghana","2025-01-07",0,0,5,0,0,5,0,0
"Ghana","2025-01-08",0,0,5,0,0,5,0,0
"Ghana","2025-01-09",0,0,5,0,0,5,0,0
"Ghana","2025-01-10",0,0,5,0,0,5,0,0
"Ghana","2025-01-11",0,0,5,0,0,5,0,0
"Ghana","2025-01-12",0,0,5,0,0,5,0,0
"Ghana","2025-01-13",0,0,5,0,0,5,0,0
"Gibraltar","2024-01-01",0,0,0,0,0,0,0,0
"Gibraltar","2024-01-02",0,0,0,0,0,0,0,0
"Gibraltar","2024-01-03",0,0,0,0,0,0,0,0
"Gibraltar","2024-01-04",0,0,0,0,0,0,0,0
"Gibraltar","2024-01-05",0,0,0,0,0,0,0,0
"Gibraltar","2024-01-06",0,0,0,0,0,0,0,0
"Gibraltar","2024-01-07",0,0,0,0,0,0,0,0
"Gibraltar","2024-01-08",0,0,0,0,0,0,0,0
"Gibraltar","2024-01-09",0,0,0,0,0,0,0,0
"Gibraltar","2024-01-10",0,0,0,0,0,0,0,0
"Gibraltar","2024-01-11",0,0,0,0,0,0,0,0
"Gibraltar","2024-01-12",0,0,0,0,0,0,0,0
"Gibraltar","2024-01-13",0,0,0,0,0,0,0,0
"Gibraltar","2024-01-14",0,0,0,0,0,0,0,0
"Gibraltar","2024-01-15",0,0,0,0,0,0,0,0
"Gibraltar","2024-01-16",0,0,0,0,0,0,0,0
"Gibraltar","2024-01-17",0,0,0,0,0,0,0,0
"Gibraltar","2024-01-18",0,0,0,0,0,0,0,0
"Gibraltar","2024-01-19",0,0,0,0,0,0,0,0
"Gibraltar","2024-01-20",0,0,0,0,0,0,0,0
"Gibraltar","2024-01-21",0,0,0,0,0,0,0,0
"Gibraltar","2024-01-22",0,0,0,0,0,0,0,0
"Gibraltar","2024-01-23",0,0,0,0,0,0,0,0
"Gibraltar","2024-01-24",0,0,0,0,0,0,0,0
"Gibraltar","2024-01-25",0,0,0,0,0,0,0,0
"Gibraltar","2024-01-26",0,0,0,0,0,0,0,0
"Gibraltar","2024-01-27",0,0,0,0,0,0,0,0
"Gibraltar","2024-01-28",0,0,0,0,0,0,0,0
"Gibraltar","2024-01-29",0,0,0,0,0,0,0,0
"Gibraltar","2024-01-30",0,0,0,0,0,0,0,0
"Gibraltar","2024-01-31",0,0,0,0,0,0,0,0
"Gibraltar","2024-02-01",0,0,0,0,0,0,0,0
"Gibraltar","2024-02-02",0,0,0,0,0,0,0,0
"Gibraltar","2024-02-03",0,0,0,0,0,0,0,0
"Gibraltar","2024-02-04",0,0,0,0,0,0,0,0
"Gibraltar","2024-02-05",0,0,0,0,0,0,0,0
"Gibraltar","2024-02-06",0,0,0,0,0,0,0,0
"Gibraltar","2024-02-07",0,0,0,0,0,0,0,0
"Gibraltar","2024-02-08",0,0,0,0,0,0,0,0
"Gibraltar","2024-02-09",0,0,0,0,0,0,0,0
"Gibraltar","2024-02-10",0,0,0,0,0,0,0,0
"Gibraltar","2024-02-11",0,0,0,0,0,0,0,0
"Gibraltar","2024-02-12",0,0,0,0,0,0,0,0
"Gibraltar","2024-02-13",0,0,0,0,0,0,0,0
"Gibraltar","2024-02-14",0,0,0,0,0,0,0,0
"Gibraltar","2024-02-15",0,0,0,0,0,0,0,0
"Gibraltar","2024-02-16",0,0,0,0,0,0,0,0
"Gibraltar","2024-02-17",0,0,0,0,0,0,0,0
"Gibraltar","2024-02-18",0,0,0,0,0,0,0,0
"Gibraltar","2024-02-19",0,0,0,0,0,0,0,0
"Gibraltar","2024-02-20",0,0,0,0,0,0,0,0
"Gibraltar","2024-02-21",0,0,0,0,0,0,0,0
"Gibraltar","2024-02-22",0,0,0,0,0,0,0,0
"Gibraltar","2024-02-23",0,0,0,0,0,0,0,0
"Gibraltar","2024-02-24",0,0,0,0,0,0,0,0
"Gibraltar","2024-02-25",0,0,0,0,0,0,0,0
"Gibraltar","2024-02-26",0,0,0,0,0,0,0,0
"Gibraltar","2024-02-27",0,0,0,0,0,0,0,0
"Gibraltar","2024-02-28",0,0,0,0,0,0,0,0
"Gibraltar","2024-02-29",0,0,0,0,0,0,0,0
"Gibraltar","2024-03-01",0,0,0,0,0,0,0,0
"Gibraltar","2024-03-02",0,0,0,0,0,0,0,0
"Gibraltar","2024-03-03",0,0,0,0,0,0,0,0
"Gibraltar","2024-03-04",0,0,0,0,0,0,0,0
"Gibraltar","2024-03-05",0,0,0,0,0,0,0,0
"Gibraltar","2024-03-06",0,0,0,0,0,0,0,0
"Gibraltar","2024-03-07",0,0,0,0,0,0,0,0
"Gibraltar","2024-03-08",0,0,0,0,0,0,0,0
"Gibraltar","2024-03-09",0,0,0,0,0,0,0,0
"Gibraltar","2024-03-10",0,0,0,0,0,0,0,0
"Gibraltar","2024-03-11",0,0,0,0,0,0,0,0
"Gibraltar","2024-03-12",0,0,0,0,0,0,0,0
"Gibraltar","2024-03-13",0,0,0,0,0,0,0,0
"Gibraltar","2024-03-14",0,0,0,0,0,0,0,0
"Gibraltar","2024-03-15",0,0,0,0,0,0,0,0
"Gibraltar","2024-03-16",0,0,0,0,0,0,0,0
"Gibraltar","2024-03-17",0,0,0,0,0,0,0,0
"Gibraltar","2024-03-18",0,0,0,0,0,0,0,0
"Gibraltar","2024-03-19",0,0,0,0,0,0,0,0
"Gibraltar","2024-03-20",0,0,0,0,0,0,0,0
"Gibraltar","2024-03-21",0,0,0,0,0,0,0,0
"Gibraltar","2024-03-22",0,0,0,0,0,0,0,0
"Gibraltar","2024-03-23",0,0,0,0,0,0,0,0
"Gibraltar","2024-03-24",0,0,0,0,0,0,0,0
"Gibraltar","2024-03-25",0,0,0,0,0,0,0,0
"Gibraltar","2024-03-26",0,0,0,0,0,0,0,0
"Gibraltar","2024-03-27",0,0,0,0,0,0,0,0
"Gibraltar","2024-03-28",0,0,0,0,0,0,0,0
"Gibraltar","2024-03-29",0,0,0,0,0,0,0,0
"Gibraltar","2024-03-30",0,0,0,0,0,0,0,0
"Gibraltar","2024-03-31",0,0,0,0,0,0,0,0
"Gibraltar","2024-04-01",0,0,0,0,0,0,0,0
"Gibraltar","2024-04-02",0,0,0,0,0,0,0,0
"Gibraltar","2024-04-03",0,0,0,0,0,0,0,0
"Gibraltar","2024-04-04",0,0,0,0,0,0,0,0
"Gibraltar","2024-04-05",0,0,0,0,0,0,0,0
"Gibraltar","2024-04-06",0,0,0,0,0,0,0,0
"Gibraltar","2024-04-07",0,0,0,0,0,0,0,0
"Gibraltar","2024-04-08",0,0,0,0,0,0,0,0
"Gibraltar","2024-04-09",0,0,0,0,0,0,0,0
"Gibraltar","2024-04-10",0,0,0,0,0,0,0,0
"Gibraltar","2024-04-11",0,0,0,0,0,0,0,0
"Gibraltar","2024-04-12",0,0,0,0,0,0,0,0
"Gibraltar","2024-04-13",0,0,0,0,0,0,0,0
"Gibraltar","2024-04-14",0,0,0,0,0,0,0,0
"Gibraltar","2024-04-15",0,0,0,0,0,0,0,0
"Gibraltar","2024-04-16",0,0,0,0,0,0,0,0
"Gibraltar","2024-04-17",0,0,0,0,0,0,0,0
"Gibraltar","2024-04-18",0,0,0,0,0,0,0,0
"Gibraltar","2024-04-19",0,0,0,0,0,0,0,0
"Gibraltar","2024-04-20",0,0,0,0,0,0,0,0
"Gibraltar","2024-04-21",0,0,0,0,0,0,0,0
"Gibraltar","2024-04-22",0,0,0,0,0,0,0,0
"Gibraltar","2024-04-23",0,0,0,0,0,0,0,0
"Gibraltar","2024-04-24",0,0,0,0,0,0,0,0
"Gibraltar","2024-04-25",0,0,0,0,0,0,0,0
"Gibraltar","2024-04-26",0,0,0,0,0,0,0,0
"Gibraltar","2024-04-27",0,0,0,0,0,0,0,0
"Gibraltar","2024-04-28",0,0,0,0,0,0,0,0
"Gibraltar","2024-04-29",0,0,0,0,0,0,0,0
"Gibraltar","2024-04-30",0,0,0,0,0,0,0,0
"Gibraltar","2024-05-01",0,0,0,0,0,0,0,0
"Gibraltar","2024-05-02",0,0,0,0,0,0,0,0
"Gibraltar","2024-05-03",0,0,0,0,0,0,0,0
"Gibraltar","2024-05-04",0,0,0,0,0,0,0,0
"Gibraltar","2024-05-05",0,0,0,0,0,0,0,0
"Gibraltar","2024-05-06",0,0,0,0,0,0,0,0
"Gibraltar","2024-05-07",0,0,0,0,0,0,0,0
"Gibraltar","2024-05-08",0,0,0,0,0,0,0,0
"Gibraltar","2024-05-09",0,0,0,0,0,0,0,0
"Gibraltar","2024-05-10",0,0,0,0,0,0,0,0
"Gibraltar","2024-05-11",0,0,0,0,0,0,0,0
"Gibraltar","2024-05-12",0,0,0,0,0,0,0,0
"Gibraltar","2024-05-13",0,0,0,0,0,0,0,0
"Gibraltar","2024-05-14",0,0,0,0,0,0,0,0
"Gibraltar","2024-05-15",0,0,0,0,0,0,0,0
"Gibraltar","2024-05-16",0,0,0,0,0,0,0,0
"Gibraltar","2024-05-17",0,0,0,0,0,0,0,0
"Gibraltar","2024-05-18",0,0,0,0,0,0,0,0
"Gibraltar","2024-05-19",0,0,0,0,0,0,0,0
"Gibraltar","2024-05-20",0,0,0,0,0,0,0,0
"Gibraltar","2024-05-21",0,0,0,0,0,0,0,0
"Gibraltar","2024-05-22",0,0,0,0,0,0,0,0
"Gibraltar","2024-05-23",0,0,0,0,0,0,0,0
"Gibraltar","2024-05-24",0,0,0,0,0,0,0,0
"Gibraltar","2024-05-25",0,0,0,0,0,0,0,0
"Gibraltar","2024-05-26",0,0,0,0,0,0,0,0
"Gibraltar","2024-05-27",0,0,0,0,0,0,0,0
"Gibraltar","2024-05-28",0,0,0,0,0,0,0,0
"Gibraltar","2024-05-29",0,0,0,0,0,0,0,0
"Gibraltar","2024-05-30",0,0,0,0,0,0,0,0
"Gibraltar","2024-05-31",0,0,0,0,0,0,0,0
"Gibraltar","2024-06-01",0,0,0,0,0,0,0,0
"Gibraltar","2024-06-02",0,0,0,0,0,0,0,0
"Gibraltar","2024-06-03",0,0,0,0,0,0,0,0
"Gibraltar","2024-06-04",0,0,0,0,0,0,0,0
"Gibraltar","2024-06-05",0,0,0,0,0,0,0,0
"Gibraltar","2024-06-06",0,0,0,0,0,0,0,0
"Gibraltar","2024-06-07",0,0,0,0,0,0,0,0
"Gibraltar","2024-06-08",0,0,0,0,0,0,0,0
"Gibraltar","2024-06-09",0,0,0,0,0,0,0,0
"Gibraltar","2024-06-10",0,0,0,0,0,0,0,0
"Gibraltar","2024-06-11",0,0,0,0,0,0,0,0
"Gibraltar","2024-06-12",0,0,0,0,0,0,0,0
"Gibraltar","2024-06-13",0,0,0,0,0,0,0,0
"Gibraltar","2024-06-14",0,0,0,0,0,0,0,0
"Gibraltar","2024-06-15",0,0,0,0,0,0,0,0
"Gibraltar","2024-06-16",0,0,0,0,0,0,0,0
"Gibraltar","2024-06-17",0,0,0,0,0,0,0,0
"Gibraltar","2024-06-18",0,0,0,0,0,0,0,0
"Gibraltar","2024-06-19",0,0,0,0,0,0,0,0
"Gibraltar","2024-06-20",0,0,0,0,0,0,0,0
"Gibraltar","2024-06-21",0,0,0,0,0,0,0,0
"Gibraltar","2024-06-22",0,0,0,0,0,0,0,0
"Gibraltar","2024-06-23",0,0,0,0,0,0,0,0
"Gibraltar","2024-06-24",0,0,0,0,0,0,0,0
"Gibraltar","2024-06-25",0,0,0,0,0,0,0,0
"Gibraltar","2024-06-26",0,0,0,0,0,0,0,0
"Gibraltar","2024-06-27",0,0,0,0,0,0,0,0
"Gibraltar","2024-06-28",0,0,0,0,0,0,0,0
"Gibraltar","2024-06-29",0,0,0,0,0,0,0,0
"Gibraltar","2024-06-30",0,0,0,0,0,0,0,0
"Gibraltar","2024-07-01",0,0,0,0,0,0,0,0
"Gibraltar","2024-07-02",0,0,0,0,0,0,0,0
"Gibraltar","2024-07-03",0,0,0,0,0,0,0,0
"Gibraltar","2024-07-04",0,0,0,0,0,0,0,0
"Gibraltar","2024-07-05",0,0,0,0,0,0,0,0
"Gibraltar","2024-07-06",0,0,0,0,0,0,0,0
"Gibraltar","2024-07-07",0,0,0,0,0,0,0,0
"Gibraltar","2024-07-08",0,0,0,0,0,0,0,0
"Gibraltar","2024-07-09",0,0,0,0,0,0,0,0
"Gibraltar","2024-07-10",0,0,0,0,0,0,0,0
"Gibraltar","2024-07-11",0,0,0,0,0,0,0,0
"Gibraltar","2024-07-12",0,0,0,0,0,0,0,0
"Gibraltar","2024-07-13",0,0,0,0,0,0,0,0
"Gibraltar","2024-07-14",0,0,0,0,0,0,0,0
"Gibraltar","2024-07-15",0,0,0,0,0,0,0,0
"Gibraltar","2024-07-16",0,0,0,0,0,0,0,0
"Gibraltar","2024-07-17",0,0,0,0,0,0,0,0
"Gibraltar","2024-07-18",0,0,0,0,0,0,0,0
"Gibraltar","2024-07-19",0,0,0,0,0,0,0,0
"Gibraltar","2024-07-20",0,0,0,0,0,0,0,0
"Gibraltar","2024-07-21",0,0,0,0,0,0,0,0
"Gibraltar","2024-07-22",0,0,0,0,0,0,0,0
"Gibraltar","2024-07-23",0,0,0,0,0,0,0,0
"Gibraltar","2024-07-24",0,0,0,0,0,0,0,0
"Gibraltar","2024-07-25",0,0,0,0,0,0,0,0
"Gibraltar","2024-07-26",0,0,0,0,0,0,0,0
"Gibraltar","2024-07-27",0,0,0,0,0,0,0,0
"Gibraltar","2024-07-28",0,0,0,0,0,0,0,0
"Gibraltar","2024-07-29",0,0,0,0,0,0,0,0
"Gibraltar","2024-07-30",0,0,0,0,0,0,0,0
"Gibraltar","2024-07-31",0,0,0,0,0,0,0,0
"Gibraltar","2024-08-01",0,0,0,0,0,0,0,0
"Gibraltar","2024-08-02",0,0,0,0,0,0,0,0
"Gibraltar","2024-08-03",0,0,0,0,0,0,0,0
"Gibraltar","2024-08-04",0,0,0,0,0,0,0,0
"Gibraltar","2024-08-05",0,0,0,0,0,0,0,0
"Gibraltar","2024-08-06",0,0,0,0,0,0,0,0
"Gibraltar","2024-08-07",0,0,0,0,0,0,0,0
"Gibraltar","2024-08-08",0,0,0,0,0,0,0,0
"Gibraltar","2024-08-09",0,0,0,0,0,0,0,0
"Gibraltar","2024-08-10",0,0,0,0,0,0,0,0
"Gibraltar","2024-08-11",0,0,0,0,0,0,0,0
"Gibraltar","2024-08-12",0,0,0,0,0,0,0,0
"Gibraltar","2024-08-13",0,0,0,0,0,0,0,0
"Gibraltar","2024-08-14",0,0,0,0,0,0,0,0
"Gibraltar","2024-08-15",0,0,0,0,0,0,0,0
"Gibraltar","2024-08-16",0,0,0,0,0,0,0,0
"Gibraltar","2024-08-17",0,0,0,0,0,0,0,0
"Gibraltar","2024-08-18",0,0,0,0,0,0,0,0
"Gibraltar","2024-08-19",0,0,0,0,0,0,0,0
"Gibraltar","2024-08-20",0,0,0,0,0,0,0,0
"Gibraltar","2024-08-21",0,0,0,0,0,0,0,0
"Gibraltar","2024-08-22",0,0,0,0,0,0,0,0
"Gibraltar","2024-08-23",0,0,0,0,0,0,0,0
"Gibraltar","2024-08-24",0,0,0,0,0,0,0,0
"Gibraltar","2024-08-25",0,0,0,0,0,0,0,0
"Gibraltar","2024-08-26",0,0,0,0,0,0,0,0
"Gibraltar","2024-08-27",0,0,0,0,0,0,0,0
"Gibraltar","2024-08-28",0,0,0,0,0,0,0,0
"Gibraltar","2024-08-29",0,0,0,0,0,0,0,0
"Gibraltar","2024-08-30",0,0,0,0,0,0,0,0
"Gibraltar","2024-08-31",0,0,0,0,0,0,0,0
"Gibraltar","2024-09-01",0,0,0,0,0,0,0,0
"Gibraltar","2024-09-02",0,0,0,0,0,0,0,0
"Gibraltar","2024-09-03",0,0,0,0,0,0,0,0
"Gibraltar","2024-09-04",0,0,0,0,0,0,0,0
"Gibraltar","2024-09-05",0,0,0,0,0,0,0,0
"Gibraltar","2024-09-06",0,0,0,0,0,0,0,0
"Gibraltar","2024-09-07",0,0,0,0,0,0,0,0
"Gibraltar","2024-09-08",0,0,0,0,0,0,0,0
"Gibraltar","2024-09-09",0,0,0,0,0,0,0,0
"Gibraltar","2024-09-10",0,0,0,0,0,0,0,0
"Gibraltar","2024-09-11",0,0,0,0,0,0,0,0
"Gibraltar","2024-09-12",0,0,0,0,0,0,0,0
"Gibraltar","2024-09-13",0,0,0,0,0,0,0,0
"Gibraltar","2024-09-14",0,0,0,0,0,0,0,0
"Gibraltar","2024-09-15",0,0,0,0,0,0,0,0
"Gibraltar","2024-09-16",0,0,0,0,0,0,0,0
"Gibraltar","2024-09-17",0,0,0,0,0,0,0,0
"Gibraltar","2024-09-18",0,0,0,0,0,0,0,0
"Gibraltar","2024-09-19",0,0,0,0,0,0,0,0
"Gibraltar","2024-09-20",0,0,0,0,0,0,0,0
"Gibraltar","2024-09-21",0,0,0,0,0,0,0,0
"Gibraltar","2024-09-22",0,0,0,0,0,0,0,0
"Gibraltar","2024-09-23",0,0,0,0,0,0,0,0
"Gibraltar","2024-09-24",0,0,0,0,0,0,0,0
"Gibraltar","2024-09-25",0,0,0,0,0,0,0,0
"Gibraltar","2024-09-26",0,0,0,0,0,0,0,0
"Gibraltar","2024-09-27",0,0,0,0,0,0,0,0
"Gibraltar","2024-09-28",0,0,0,0,0,0,0,0
"Gibraltar","2024-09-29",0,0,0,0,0,0,0,0
"Gibraltar","2024-09-30",0,0,0,0,0,0,0,0
"Gibraltar","2024-10-01",0,0,0,0,0,0,0,0
"Gibraltar","2024-10-02",0,0,0,0,0,0,0,0
"Gibraltar","2024-10-03",0,0,0,0,0,0,0,0
"Gibraltar","2024-10-04",0,0,0,0,0,0,0,0
"Gibraltar","2024-10-05",0,0,0,0,0,0,0,0
"Gibraltar","2024-10-06",0,0,0,0,0,0,0,0
"Gibraltar","2024-10-07",0,0,0,0,0,0,0,0
"Gibraltar","2024-10-08",0,0,0,0,0,0,0,0
"Gibraltar","2024-10-09",0,0,0,0,0,0,0,0
"Gibraltar","2024-10-10",0,0,0,0,0,0,0,0
"Gibraltar","2024-10-11",0,0,0,0,0,0,0,0
"Gibraltar","2024-10-12",0,0,0,0,0,0,0,0
"Gibraltar","2024-10-13",0,0,0,0,0,0,0,0
"Gibraltar","2024-10-14",0,0,0,0,0,0,0,0
"Gibraltar","2024-10-15",0,0,0,0,0,0,0,0
"Gibraltar","2024-10-16",0,0,0,0,0,0,0,0
"Gibraltar","2024-10-17",0,0,0,0,0,0,0,0
"Gibraltar","2024-10-18",0,0,0,0,0,0,0,0
"Gibraltar","2024-10-19",0,0,0,0,0,0,0,0
"Gibraltar","2024-10-20",0,0,0,0,0,0,0,0
"Gibraltar","2024-10-21",0,0,0,0,0,0,0,0
"Gibraltar","2024-10-22",0,0,0,0,0,0,0,0
"Gibraltar","2024-10-23",0,0,0,0,0,0,0,0
"Gibraltar","2024-10-24",0,0,0,0,0,0,0,0
"Gibraltar","2024-10-25",0,0,0,0,0,0,0,0
"Gibraltar","2024-10-26",0,0,0,0,0,0,0,0
"Gibraltar","2024-10-27",0,0,0,0,0,0,0,0
"Gibraltar","2024-10-28",0,0,0,0,0,0,0,0
"Gibraltar","2024-10-29",0,0,0,0,0,0,0,0
"Gibraltar","2024-10-30",0,0,0,0,0,0,0,0
"Gibraltar","2024-10-31",0,0,0,0,0,0,0,0
"Gibraltar","2024-11-01",0,0,0,0,0,0,0,0
"Gibraltar","2024-11-02",0,0,0,0,0,0,0,0
"Gibraltar","2024-11-03",0,0,0,0,0,0,0,0
"Gibraltar","2024-11-04",0,0,0,0,0,0,0,0
"Gibraltar","2024-11-05",0,0,0,0,0,0,0,0
"Gibraltar","2024-11-06",0,0,0,0,0,0,0,0
"Gibraltar","2024-11-07",0,0,0,0,0,0,0,0
"Gibraltar","2024-11-08",0,0,0,0,0,0,0,0
"Gibraltar","2024-11-09",0,0,0,0,0,0,0,0
"Gibraltar","2024-11-10",0,0,0,0,0,0,0,0
"Gibraltar","2024-11-11",0,0,0,0,0,0,0,0
"Gibraltar","2024-11-12",0,0,0,0,0,0,0,0
"Gibraltar","2024-11-13",0,0,0,0,0,0,0,0
"Gibraltar","2024-11-14",0,0,0,0,0,0,0,0
"Gibraltar","2024-11-15",0,0,0,0,0,0,0,0
"Gibraltar","2024-11-16",0,0,0,0,0,0,0,0
"Gibraltar","2024-11-17",0,0,0,0,0,0,0,0
"Gibraltar","2024-11-18",0,0,0,0,0,0,0,0
"Gibraltar","2024-11-19",0,0,0,0,0,0,0,0
"Gibraltar","2024-11-20",0,0,0,0,0,0,0,0
"Gibraltar","2024-11-21",0,0,0,0,0,0,0,0
"Gibraltar","2024-11-22",0,0,0,0,0,0,0,0
"Gibraltar","2024-11-23",0,0,0,0,0,0,0,0
"Gibraltar","2024-11-24",0,0,0,0,0,0,0,0
"Gibraltar","2024-11-25",0,0,0,0,0,0,0,0
"Gibraltar","2024-11-26",0,0,0,0,0,0,0,0
"Gibraltar","2024-11-27",0,0,0,0,0,0,0,0
"Gibraltar","2024-11-28",0,0,0,0,0,0,0,0
"Gibraltar","2024-11-29",0,0,0,0,0,0,0,0
"Gibraltar","2024-11-30",0,0,0,0,0,0,0,0
"Gibraltar","2024-12-01",0,0,0,0,0,0,0,0
"Gibraltar","2024-12-02",0,0,0,0,0,0,0,0
"Gibraltar","2024-12-03",0,0,0,0,0,0,0,0
"Gibraltar","2024-12-04",0,0,0,0,0,0,0,0
"Gibraltar","2024-12-05",0,0,0,0,0,0,0,0
"Gibraltar","2024-12-06",0,0,0,0,0,0,0,0
"Gibraltar","2024-12-07",0,0,0,0,0,0,0,0
"Gibraltar","2024-12-08",0,0,0,0,0,0,0,0
"Gibraltar","2024-12-09",0,0,0,0,0,0,0,0
"Gibraltar","2024-12-10",0,0,0,0,0,0,0,0
"Gibraltar","2024-12-11",0,0,0,0,0,0,0,0
"Gibraltar","2024-12-12",0,0,0,0,0,0,0,0
"Gibraltar","2024-12-13",0,0,0,0,0,0,0,0
"Gibraltar","2024-12-14",0,0,0,0,0,0,0,0
"Gibraltar","2024-12-15",0,0,0,0,0,0,0,0
"Gibraltar","2024-12-16",0,0,0,0,0,0,0,0
"Gibraltar","2024-12-17",0,0,0,0,0,0,0,0
"Gibraltar","2024-12-18",0,0,0,0,0,0,0,0
"Gibraltar","2024-12-19",0,0,0,0,0,0,0,0
"Gibraltar","2024-12-20",0,0,0,0,0,0,0,0
"Gibraltar","2024-12-21",0,0,0,0,0,0,0,0
"Gibraltar","2024-12-22",0,0,0,0,0,0,0,0
"Gibraltar","2024-12-23",0,0,0,0,0,0,0,0
"Gibraltar","2024-12-24",0,0,0,0,0,0,0,0
"Gibraltar","2024-12-25",0,0,0,0,0,0,0,0
"Gibraltar","2024-12-26",0,0,0,0,0,0,0,0
"Gibraltar","2024-12-27",0,0,0,0,0,0,0,0
"Gibraltar","2024-12-28",0,0,0,0,0,0,0,0
"Gibraltar","2024-12-29",0,0,0,0,0,0,0,0
"Gibraltar","2024-12-30",0,0,0,0,0,0,0,0
"Gibraltar","2024-12-31",0,0,0,0,0,0,0,0
"Gibraltar","2025-01-01",0,0,0,0,0,0,0,0
"Gibraltar","2025-01-02",0,0,0,0,0,0,0,0
"Gibraltar","2025-01-03",0,0,0,0,0,0,0,0
"Gibraltar","2025-01-04",0,0,0,0,0,0,0,0
"Gibraltar","2025-01-05",0,0,0,0,0,0,0,0
"Gibraltar","2025-01-06",0,0,0,0,0,0,0,0
"Gibraltar","2025-01-07",0,0,0,0,0,0,0,0
"Gibraltar","2025-01-08",0,0,0,0,0,0,0,0
"Gibraltar","2025-01-09",0,0,0,0,0,0,0,0
"Gibraltar","2025-01-10",0,0,0,0,0,0,0,0
"Gibraltar","2025-01-11",0,0,0,0,0,0,0,0
"Gibraltar","2025-01-12",0,0,0,0,0,0,0,0
"Gibraltar","2025-01-13",0,0,0,0,0,0,0,0
"Greece","2024-01-01",0,0,0,0,0,0,0,0
"Greece","2024-01-02",0,0,0,0,0,0,0,0
"Greece","2024-01-03",0,0,0,0,0,0,0,0
"Greece","2024-01-04",0,0,0,0,0,0,0,0
"Greece","2024-01-05",0,0,0,0,0,0,0,0
"Greece","2024-01-06",0,0,0,0,0,0,0,0
"Greece","2024-01-07",0,0,0,0,0,0,0,0
"Greece","2024-01-08",0,0,0,0,0,0,0,0
"Greece","2024-01-09",0,0,0,0,0,0,0,0
"Greece","2024-01-10",0,0,0,0,0,0,0,0
"Greece","2024-01-11",0,0,0,0,0,0,0,0
"Greece","2024-01-12",0,0,0,0,0,0,0,0
"Greece","2024-01-13",0,0,0,0,0,0,0,0
"Greece","2024-01-14",0,0,0,0,0,0,0,0
"Greece","2024-01-15",0,0,0,0,0,0,0,0
"Greece","2024-01-16",0,0,0,0,0,0,0,0
"Greece","2024-01-17",0,0,0,0,0,0,0,0
"Greece","2024-01-18",0,0,0,0,0,0,0,0
"Greece","2024-01-19",0,0,0,0,0,0,0,0
"Greece","2024-01-20",0,0,0,0,0,0,0,0
"Greece","2024-01-21",0,0,0,0,0,0,0,0
"Greece","2024-01-22",0,0,0,0,0,0,0,0
"Greece","2024-01-23",0,0,0,0,0,0,0,0
"Greece","2024-01-24",0,0,0,0,0,0,0,0
"Greece","2024-01-25",0,0,0,0,0,0,0,0
"Greece","2024-01-26",0,0,0,0,0,0,0,0
"Greece","2024-01-27",0,0,0,0,0,0,0,0
"Greece","2024-01-28",0,0,0,0,0,0,0,0
"Greece","2024-01-29",0,0,0,0,0,0,0,0
"Greece","2024-01-30",0,0,0,0,0,0,0,0
"Greece","2024-01-31",0,2,2,0,2,2,0,0
"Greece","2024-02-01",0,0,2,0,0,2,0,0
"Greece","2024-02-02",0,0,2,0,0,2,0,0
"Greece","2024-02-03",0,0,2,0,0,2,0,0
"Greece","2024-02-04",0,0,2,0,0,2,0,0
"Greece","2024-02-05",0,0,2,0,0,2,0,0
"Greece","2024-02-06",0,0,2,0,0,2,0,0
"Greece","2024-02-07",0,0,2,0,0,2,0,0
"Greece","2024-02-08",0,0,2,0,0,2,0,0
"Greece","2024-02-09",0,0,2,0,0,2,0,0
"Greece","2024-02-10",0,0,2,0,0,2,0,0
"Greece","2024-02-11",0,0,2,0,0,2,0,0
"Greece","2024-02-12",0,0,2,0,0,2,0,0
"Greece","2024-02-13",0,0,2,0,0,2,0,0
"Greece","2024-02-14",0,0,2,0,0,2,0,0
"Greece","2024-02-15",0,0,2,0,0,2,0,0
"Greece","2024-02-16",0,0,2,0,0,2,0,0
"Greece","2024-02-17",0,0,2,0,0,2,0,0
"Greece","2024-02-18",0,0,2,0,0,2,0,0
"Greece","2024-02-19",0,0,2,0,0,2,0,0
"Greece","2024-02-20",0,0,2,0,0,2,0,0
"Greece","2024-02-21",0,0,2,0,0,2,0,0
"Greece","2024-02-22",0,0,2,0,0,2,0,0
"Greece","2024-02-23",0,0,2,0,0,2,0,0
"Greece","2024-02-24",0,0,2,0,0,2,0,0
"Greece","2024-02-25",0,0,2,0,0,2,0,0
"Greece","2024-02-26",0,0,2,0,0,2,0,0
"Greece","2024-02-27",0,0,2,0,0,2,0,0
"Greece","2024-02-28",0,0,2,0,0,2,0,0
"Greece","2024-02-29",0,0,2,0,0,2,0,0
"Greece","2024-03-01",0,0,2,0,0,2,0,0
"Greece","2024-03-02",0,0,2,0,1,3,0,0
"Greece","2024-03-03",0,0,2,0,0,3,0,0
"Greece","2024-03-04",0,0,2,0,0,3,0,0
"Greece","2024-03-05",0,0,2,0,0,3,0,0
"Greece","2024-03-06",0,0,2,0,0,3,0,0
"Greece","2024-03-07",0,0,2,0,0,3,0,0
"Greece","2024-03-08",0,0,2,0,0,3,0,0
"Greece","2024-03-09",0,0,2,0,0,3,0,0
"Greece","2024-03-10",0,0,2,0,0,3,0,0
"Greece","2024-03-11",0,0,2,0,0,3,0,0
"Greece","2024-03-12",0,0,2,0,0,3,0,0
"Greece","2024-03-13",0,0,2,0,0,3,0,0
"Greece","2024-03-14",0,0,2,0,0,3,0,0
"Greece","2024-03-15",0,0,2,0,0,3,0,0
"Greece","2024-03-16",0,0,2,0,0,3,0,0
"Greece","2024-03-17",0,0,2,0,0,3,0,0
"Greece","2024-03-18",0,0,2,0,0,3,0,0
"Greece","2024-03-19",0,0,2,0,0,3,0,0
"Greece","2024-03-20",0,0,2,0,0,3,0,0
"Greece","2024-03-21",0,0,2,0,0,3,0,0
"Greece","2024-03-22",0,0,2,0,0,3,0,0
"Greece","2024-03-23",0,0,2,0,0,3,0,0
"Greece","2024-03-24",0,0,2,0,0,3,0,0
"Greece","2024-03-25",0,0,2,0,0,3,0,0
"Greece","2024-03-26",0,0,2,0,0,3,0,0
"Greece","2024-03-27",0,0,2,0,0,3,0,0
"Greece","2024-03-28",0,0,2,0,0,3,0,0
"Greece","2024-03-29",0,0,2,0,0,3,0,0
"Greece","2024-03-30",0,0,2,0,0,3,0,0
"Greece","2024-03-31",0,1,3,0,0,3,0,0
"Greece","2024-04-01",0,0,3,0,0,3,0,0
"Greece","2024-04-02",0,0,3,0,0,3,0,0
"Greece","2024-04-03",0,0,3,0,1,4,0,0
"Greece","2024-04-04",0,0,3,0,0,4,0,0
"Greece","2024-04-05",0,0,3,0,0,4,0,0
"Greece","2024-04-06",0,0,3,0,0,4,0,0
"Greece","2024-04-07",0,0,3,0,0,4,0,0
"Greece","2024-04-08",0,0,3,0,1,5,0,0
"Greece","2024-04-09",0,0,3,0,0,5,0,0
"Greece","2024-04-10",0,0,3,0,0,5,0,0
"Greece","2024-04-11",0,0,3,0,0,5,0,0
"Greece","2024-04-12",0,0,3,0,0,5,0,0
"Greece","2024-04-13",0,0,3,0,1,6,0,0
"Greece","2024-04-14",0,0,3,0,0,6,0,0
"Greece","2024-04-15",0,0,3,0,0,6,0,0
"Greece","2024-04-16",0,0,3,0,0,6,0,0
"Greece","2024-04-17",0,0,3,0,0,6,0,0
"Greece","2024-04-18",0,0,3,0,1,7,0,0
"Greece","2024-04-19",0,0,3,0,0,7,0,0
"Greece","2024-04-20",0,0,3,0,0,7,0,0
"Greece","2024-04-21",0,0,3,0,0,7,0,0
"Greece","2024-04-22",0,0,3,0,0,7,0,0
"Greece","2024-04-23",0,0,3,0,1,8,0,0
"Greece","2024-04-24",0,0,3,0,0,8,0,0
"Greece","2024-04-25",0,0,3,0,0,8,0,0
"Greece","2024-04-26",0,0,3,0,0,8,0,0
"Greece","2024-04-27",0,0,3,0,0,8,0,0
"Greece","2024-04-28",0,0,3,0,1,9,0,0
"Greece","2024-04-29",0,0,3,0,0,9,0,0
"Greece","2024-04-30",0,6,9,0,0,9,0,0
"Greece","2024-05-01",0,0,9,0,0,9,0,0
"Greece","2024-05-02",0,0,9,0,0,9,0,0
"Greece","2024-05-03",0,0,9,0,0,9,0,0
"Greece","2024-05-04",0,0,9,0,0,9,0,0
"Greece","2024-05-05",0,0,9,0,0,9,0,0
"Greece","2024-05-06",0,0,9,0,0,9,0,0
"Greece","2024-05-07",0,0,9,0,0,9,0,0
"Greece","2024-05-08",0,0,9,0,0,9,0,0
"Greece","2024-05-09",0,0,9,0,0,9,0,0
"Greece","2024-05-10",0,0,9,0,0,9,0,0
"Greece","2024-05-11",0,0,9,0,0,9,0,0
"Greece","2024-05-12",0,0,9,0,0,9,0,0
"Greece","2024-05-13",0,0,9,0,0,9,0,0
"Greece","2024-05-14",0,0,9,0,0,9,0,0
"Greece","2024-05-15",0,0,9,0,0,9,0,0
"Greece","2024-05-16",0,0,9,0,1,10,0,0
"Greece","2024-05-17",0,0,9,0,0,10,0,0
"Greece","2024-05-18",0,0,9,0,0,10,0,0
"Greece","2024-05-19",0,0,9,0,0,10,0,0
"Greece","2024-05-20",0,0,9,0,0,10,0,0
"Greece","2024-05-21",0,0,9,0,0,10,0,0
"Greece","2024-05-22",0,0,9,0,0,10,0,0
"Greece","2024-05-23",0,0,9,0,0,10,0,0
"Greece","2024-05-24",0,0,9,0,0,10,0,0
"Greece","2024-05-25",0,0,9,0,0,10,0,0
"Greece","2024-05-26",0,0,9,0,0,10,0,0
"Greece","2024-05-27",0,0,9,0,0,10,0,0
"Greece","2024-05-28",0,0,9,0,0,10,0,0
"Greece","2024-05-29",0,0,9,0,0,10,0,0
"Greece","2024-05-30",0,0,9,0,0,10,0,0
"Greece","2024-05-31",0,1,10,0,0,10,0,0
"Greece","2024-06-01",0,0,10,0,0,10,0,0
"Greece","2024-06-02",0,0,10,0,0,10,0,0
"Greece","2024-06-03",0,0,10,0,0,10,0,0
"Greece","2024-06-04",0,0,10,0,0,10,0,0
"Greece","2024-06-05",0,0,10,0,0,10,0,0
"Greece","2024-06-06",0,0,10,0,0,10,0,0
"Greece","2024-06-07",0,0,10,0,0,10,0,0
"Greece","2024-06-08",0,0,10,0,0,10,0,0
"Greece","2024-06-09",0,0,10,0,0,10,0,0
"Greece","2024-06-10",0,0,10,0,0,10,0,0
"Greece","2024-06-11",0,0,10,0,0,10,0,0
"Greece","2024-06-12",0,0,10,0,0,10,0,0
"Greece","2024-06-13",0,0,10,0,0,10,0,0
"Greece","2024-06-14",0,0,10,0,0,10,0,0
"Greece","2024-06-15",0,0,10,0,0,10,0,0
"Greece","2024-06-16",0,0,10,0,0,10,0,0
"Greece","2024-06-17",0,0,10,0,0,10,0,0
"Greece","2024-06-18",0,0,10,0,0,10,0,0
"Greece","2024-06-19",0,0,10,0,0,10,0,0
"Greece","2024-06-20",0,0,10,0,0,10,0,0
"Greece","2024-06-21",0,0,10,0,1,11,0,0
"Greece","2024-06-22",0,0,10,0,0,11,0,0
"Greece","2024-06-23",0,0,10,0,0,11,0,0
"Greece","2024-06-24",0,0,10,0,0,11,0,0
"Greece","2024-06-25",0,0,10,0,0,11,0,0
"Greece","2024-06-26",0,0,10,0,0,11,0,0
"Greece","2024-06-27",0,0,10,0,0,11,0,0
"Greece","2024-06-28",0,0,10,0,0,11,0,0
"Greece","2024-06-29",0,0,10,0,0,11,0,0
"Greece","2024-06-30",0,0,10,0,0,11,0,0
"Greece","2024-07-01",0,0,10,0,0,11,0,0
"Greece","2024-07-02",0,0,10,0,0,11,0,0
"Greece","2024-07-03",0,0,10,0,0,11,0,0
"Greece","2024-07-04",0,0,10,0,0,11,0,0
"Greece","2024-07-05",0,0,10,0,0,11,0,0
"Greece","2024-07-06",0,0,10,0,0,11,0,0
"Greece","2024-07-07",0,0,10,0,0,11,0,0
"Greece","2024-07-08",0,0,10,0,0,11,0,0
"Greece","2024-07-09",0,0,10,0,0,11,0,0
"Greece","2024-07-10",0,0,10,0,0,11,0,0
"Greece","2024-07-11",0,0,10,0,0,11,0,0
"Greece","2024-07-12",0,0,10,0,0,11,0,0
"Greece","2024-07-13",0,0,10,0,0,11,0,0
"Greece","2024-07-14",0,0,10,0,0,11,0,0
"Greece","2024-07-15",0,0,10,0,0,11,0,0
"Greece","2024-07-16",0,0,10,0,0,11,0,0
"Greece","2024-07-17",0,0,10,0,0,11,0,0
"Greece","2024-07-18",0,0,10,0,0,11,0,0
"Greece","2024-07-19",0,0,10,0,0,11,0,0
"Greece","2024-07-20",0,0,10,0,0,11,0,0
"Greece","2024-07-21",0,0,10,0,0,11,0,0
"Greece","2024-07-22",0,0,10,0,0,11,0,0
"Greece","2024-07-23",0,0,10,0,0,11,0,0
"Greece","2024-07-24",0,0,10,0,0,11,0,0
"Greece","2024-07-25",0,0,10,0,0,11,0,0
"Greece","2024-07-26",0,0,10,0,0,11,0,0
"Greece","2024-07-27",0,0,10,0,0,11,0,0
"Greece","2024-07-28",0,0,10,0,0,11,0,0
"Greece","2024-07-29",0,0,10,0,0,11,0,0
"Greece","2024-07-30",0,0,10,0,0,11,0,0
"Greece","2024-07-31",0,0,10,0,1,12,0,0
"Greece","2024-08-01",0,0,10,0,0,12,0,0
"Greece","2024-08-02",0,0,10,0,0,12,0,0
"Greece","2024-08-03",0,0,10,0,0,12,0,0
"Greece","2024-08-04",0,0,10,0,0,12,0,0
"Greece","2024-08-05",0,0,10,0,0,12,0,0
"Greece","2024-08-06",0,0,10,0,0,12,0,0
"Greece","2024-08-07",0,0,10,0,0,12,0,0
"Greece","2024-08-08",0,0,10,0,0,12,0,0
"Greece","2024-08-09",0,0,10,0,0,12,0,0
"Greece","2024-08-10",0,0,10,0,0,12,0,0
"Greece","2024-08-11",0,0,10,0,0,12,0,0
"Greece","2024-08-12",0,0,10,0,0,12,0,0
"Greece","2024-08-13",0,0,10,0,0,12,0,0
"Greece","2024-08-14",0,0,10,0,0,12,0,0
"Greece","2024-08-15",0,0,10,0,0,12,0,0
"Greece","2024-08-16",0,0,10,0,0,12,0,0
"Greece","2024-08-17",0,0,10,0,0,12,0,0
"Greece","2024-08-18",0,0,10,0,0,12,0,0
"Greece","2024-08-19",0,0,10,0,0,12,0,0
"Greece","2024-08-20",0,0,10,0,0,12,0,0
"Greece","2024-08-21",0,0,10,0,0,12,0,0
"Greece","2024-08-22",0,0,10,0,0,12,0,0
"Greece","2024-08-23",0,0,10,0,0,12,0,0
"Greece","2024-08-24",0,0,10,0,0,12,0,0
"Greece","2024-08-25",0,0,10,0,0,12,0,0
"Greece","2024-08-26",0,0,10,0,0,12,0,0
"Greece","2024-08-27",0,0,10,0,0,12,0,0
"Greece","2024-08-28",0,0,10,0,0,12,0,0
"Greece","2024-08-29",0,0,10,0,0,12,0,0
"Greece","2024-08-30",0,0,10,0,0,12,0,0
"Greece","2024-08-31",0,0,10,0,0,12,0,0
"Greece","2024-09-01",0,0,10,0,0,12,0,0
"Greece","2024-09-02",0,0,10,0,0,12,0,0
"Greece","2024-09-03",0,0,10,0,0,12,0,0
"Greece","2024-09-04",0,0,10,0,0,12,0,0
"Greece","2024-09-05",0,0,10,0,0,12,0,0
"Greece","2024-09-06",0,0,10,0,0,12,0,0
"Greece","2024-09-07",0,0,10,0,0,12,0,0
"Greece","2024-09-08",0,0,10,0,0,12,0,0
"Greece","2024-09-09",0,0,10,0,0,12,0,0
"Greece","2024-09-10",0,0,10,0,1,13,0,0
"Greece","2024-09-11",0,0,10,0,0,13,0,0
"Greece","2024-09-12",0,0,10,0,0,13,0,0
"Greece","2024-09-13",0,0,10,0,0,13,0,0
"Greece","2024-09-14",0,0,10,0,0,13,0,0
"Greece","2024-09-15",0,0,10,0,0,13,0,0
"Greece","2024-09-16",0,0,10,0,0,13,0,0
"Greece","2024-09-17",0,0,10,0,0,13,0,0
"Greece","2024-09-18",0,0,10,0,0,13,0,0
"Greece","2024-09-19",0,0,10,0,0,13,0,0
"Greece","2024-09-20",0,0,10,0,0,13,0,0
"Greece","2024-09-21",0,0,10,0,0,13,0,0
"Greece","2024-09-22",0,0,10,0,0,13,0,0
"Greece","2024-09-23",0,0,10,0,0,13,0,0
"Greece","2024-09-24",0,0,10,0,0,13,0,0
"Greece","2024-09-25",0,0,10,0,0,13,0,0
"Greece","2024-09-26",0,0,10,0,0,13,0,0
"Greece","2024-09-27",0,0,10,0,0,13,0,0
"Greece","2024-09-28",0,0,10,0,0,13,0,0
"Greece","2024-09-29",0,0,10,0,0,13,0,0
"Greece","2024-09-30",0,3,13,0,0,13,0,0
"Greece","2024-10-01",0,0,13,0,0,13,0,0
"Greece","2024-10-02",0,0,13,0,0,13,0,0
"Greece","2024-10-03",0,0,13,0,0,13,0,0
"Greece","2024-10-04",0,0,13,0,0,13,0,0
"Greece","2024-10-05",0,0,13,0,0,13,0,0
"Greece","2024-10-06",0,0,13,0,0,13,0,0
"Greece","2024-10-07",0,0,13,0,1,14,0,0
"Greece","2024-10-08",0,0,13,0,0,14,0,0
"Greece","2024-10-09",0,0,13,0,0,14,0,0
"Greece","2024-10-10",0,0,13,0,0,14,0,0
"Greece","2024-10-11",0,0,13,0,0,14,0,0
"Greece","2024-10-12",0,0,13,0,0,14,0,0
"Greece","2024-10-13",0,0,13,0,0,14,0,0
"Greece","2024-10-14",0,0,13,0,0,14,0,0
"Greece","2024-10-15",0,0,13,0,0,14,0,0
"Greece","2024-10-16",0,0,13,0,0,14,0,0
"Greece","2024-10-17",0,0,13,0,0,14,0,0
"Greece","2024-10-18",0,0,13,0,0,14,0,0
"Greece","2024-10-19",0,0,13,0,1,15,0,0
"Greece","2024-10-20",0,0,13,0,0,15,0,0
"Greece","2024-10-21",0,0,13,0,0,15,0,0
"Greece","2024-10-22",0,0,13,0,0,15,0,0
"Greece","2024-10-23",0,0,13,0,0,15,0,0
"Greece","2024-10-24",0,0,13,0,0,15,0,0
"Greece","2024-10-25",0,0,13,0,0,15,0,0
"Greece","2024-10-26",0,0,13,0,0,15,0,0
"Greece","2024-10-27",0,0,13,0,0,15,0,0
"Greece","2024-10-28",0,0,13,0,0,15,0,0
"Greece","2024-10-29",0,0,13,0,0,15,0,0
"Greece","2024-10-30",0,0,13,0,0,15,0,0
"Greece","2024-10-31",0,0,13,0,1,16,0,0
"Greece","2024-11-01",0,0,13,0,0,16,0,0
"Greece","2024-11-02",0,0,13,0,0,16,0,0
"Greece","2024-11-03",0,0,13,0,0,16,0,0
"Greece","2024-11-04",0,0,13,0,0,16,0,0
"Greece","2024-11-05",0,0,13,0,0,16,0,0
"Greece","2024-11-06",0,0,13,0,0,16,0,0
"Greece","2024-11-07",0,0,13,0,0,16,0,0
"Greece","2024-11-08",0,0,13,0,0,16,0,0
"Greece","2024-11-09",0,0,13,0,0,16,0,0
"Greece","2024-11-10",0,0,13,0,0,16,0,0
"Greece","2024-11-11",0,0,13,0,0,16,0,0
"Greece","2024-11-12",0,0,13,0,1,17,0,0
"Greece","2024-11-13",0,0,13,0,0,17,0,0
"Greece","2024-11-14",0,0,13,0,0,17,0,0
"Greece","2024-11-15",0,0,13,0,0,17,0,0
"Greece","2024-11-16",0,0,13,0,0,17,0,0
"Greece","2024-11-17",0,0,13,0,0,17,0,0
"Greece","2024-11-18",0,0,13,0,0,17,0,0
"Greece","2024-11-19",0,0,13,0,0,17,0,0
"Greece","2024-11-20",0,0,13,0,0,17,0,0
"Greece","2024-11-21",0,0,13,0,0,17,0,0
"Greece","2024-11-22",0,0,13,0,0,17,0,0
"Greece","2024-11-23",0,0,13,0,0,17,0,0
"Greece","2024-11-24",0,0,13,0,1,18,0,0
"Greece","2024-11-25",0,0,13,0,0,18,0,0
"Greece","2024-11-26",0,0,13,0,0,18,0,0
"Greece","2024-11-27",0,0,13,0,0,18,0,0
"Greece","2024-11-28",0,0,13,0,0,18,0,0
"Greece","2024-11-29",0,0,13,0,0,18,0,0
"Greece","2024-11-30",0,5,18,0,0,18,0,0
"Greece","2024-12-01",0,0,18,0,0,18,0,0
"Greece","2024-12-02",0,0,18,0,0,18,0,0
"Greece","2024-12-03",0,0,18,0,0,18,0,0
"Greece","2024-12-04",0,0,18,0,0,18,0,0
"Greece","2024-12-05",0,0,18,0,0,18,0,0
"Greece","2024-12-06",0,0,18,0,0,18,0,0
"Greece","2024-12-07",0,0,18,0,0,18,0,0
"Greece","2024-12-08",0,0,18,0,0,18,0,0
"Greece","2024-12-09",0,0,18,0,0,18,0,0
"Greece","2024-12-10",0,0,18,0,0,18,0,0
"Greece","2024-12-11",0,0,18,0,0,18,0,0
"Greece","2024-12-12",0,0,18,0,0,18,0,0
"Greece","2024-12-13",0,0,18,0,0,18,0,0
"Greece","2024-12-14",0,0,18,0,0,18,0,0
"Greece","2024-12-15",0,0,18,0,0,18,0,0
"Greece","2024-12-16",0,0,18,0,0,18,0,0
"Greece","2024-12-17",0,0,18,0,0,18,0,0
"Greece","2024-12-18",0,0,18,0,0,18,0,0
"Greece","2024-12-19",0,0,18,0,0,18,0,0
"Greece","2024-12-20",0,0,18,0,0,18,0,0
"Greece","2024-12-21",0,0,18,0,0,18,0,0
"Greece","2024-12-22",0,0,18,0,0,18,0,0
"Greece","2024-12-23",0,0,18,0,0,18,0,0
"Greece","2024-12-24",0,0,18,0,0,18,0,0
"Greece","2024-12-25",0,0,18,0,0,18,0,0
"Greece","2024-12-26",0,0,18,0,0,18,0,0
"Greece","2024-12-27",0,0,18,0,0,18,0,0
"Greece","2024-12-28",0,0,18,0,0,18,0,0
"Greece","2024-12-29",0,0,18,0,0,18,0,0
"Greece","2024-12-30",0,0,18,0,0,18,0,0
"Greece","2024-12-31",0,0,18,0,0,18,0,0
"Greece","2025-01-01",0,0,18,0,0,18,0,0
"Greece","2025-01-02",0,0,18,0,0,18,0,0
"Greece","2025-01-03",0,0,18,0,0,18,0,0
"Greece","2025-01-04",0,0,18,0,0,18,0,0
"Greece","2025-01-05",0,0,18,0,0,18,0,0
"Greece","2025-01-06",0,0,18,0,0,18,0,0
"Greece","2025-01-07",0,0,18,0,0,18,0,0
"Greece","2025-01-08",0,0,18,0,0,18,0,0
"Greece","2025-01-09",0,0,18,0,0,18,0,0
"Greece","2025-01-10",0,0,18,0,0,18,0,0
"Greece","2025-01-11",0,0,18,0,0,18,0,0
"Greece","2025-01-12",0,0,18,0,0,18,0,0
"Greece","2025-01-13",0,0,18,0,0,18,0,0
"Greenland","2024-01-01",0,0,0,0,0,0,0,0
"Greenland","2024-01-02",0,0,0,0,0,0,0,0
"Greenland","2024-01-03",0,0,0,0,0,0,0,0
"Greenland","2024-01-04",0,0,0,0,0,0,0,0
"Greenland","2024-01-05",0,0,0,0,0,0,0,0
"Greenland","2024-01-06",0,0,0,0,0,0,0,0
"Greenland","2024-01-07",0,0,0,0,0,0,0,0
"Greenland","2024-01-08",0,0,0,0,0,0,0,0
"Greenland","2024-01-09",0,0,0,0,0,0,0,0
"Greenland","2024-01-10",0,0,0,0,0,0,0,0
"Greenland","2024-01-11",0,0,0,0,0,0,0,0
"Greenland","2024-01-12",0,0,0,0,0,0,0,0
"Greenland","2024-01-13",0,0,0,0,0,0,0,0
"Greenland","2024-01-14",0,0,0,0,0,0,0,0
"Greenland","2024-01-15",0,0,0,0,0,0,0,0
"Greenland","2024-01-16",0,0,0,0,0,0,0,0
"Greenland","2024-01-17",0,0,0,0,0,0,0,0
"Greenland","2024-01-18",0,0,0,0,0,0,0,0
"Greenland","2024-01-19",0,0,0,0,0,0,0,0
"Greenland","2024-01-20",0,0,0,0,0,0,0,0
"Greenland","2024-01-21",0,0,0,0,0,0,0,0
"Greenland","2024-01-22",0,0,0,0,0,0,0,0
"Greenland","2024-01-23",0,0,0,0,0,0,0,0
"Greenland","2024-01-24",0,0,0,0,0,0,0,0
"Greenland","2024-01-25",0,0,0,0,0,0,0,0
"Greenland","2024-01-26",0,0,0,0,0,0,0,0
"Greenland","2024-01-27",0,0,0,0,0,0,0,0
"Greenland","2024-01-28",0,0,0,0,0,0,0,0
"Greenland","2024-01-29",0,0,0,0,0,0,0,0
"Greenland","2024-01-30",0,0,0,0,0,0,0,0
"Greenland","2024-01-31",0,0,0,0,0,0,0,0
"Greenland","2024-02-01",0,0,0,0,0,0,0,0
"Greenland","2024-02-02",0,0,0,0,0,0,0,0
"Greenland","2024-02-03",0,0,0,0,0,0,0,0
"Greenland","2024-02-04",0,0,0,0,0,0,0,0
"Greenland","2024-02-05",0,0,0,0,0,0,0,0
"Greenland","2024-02-06",0,0,0,0,0,0,0,0
"Greenland","2024-02-07",0,0,0,0,0,0,0,0
"Greenland","2024-02-08",0,0,0,0,0,0,0,0
"Greenland","2024-02-09",0,0,0,0,0,0,0,0
"Greenland","2024-02-10",0,0,0,0,0,0,0,0
"Greenland","2024-02-11",0,0,0,0,0,0,0,0
"Greenland","2024-02-12",0,0,0,0,0,0,0,0
"Greenland","2024-02-13",0,0,0,0,0,0,0,0
"Greenland","2024-02-14",0,0,0,0,0,0,0,0
"Greenland","2024-02-15",0,0,0,0,0,0,0,0
"Greenland","2024-02-16",0,0,0,0,0,0,0,0
"Greenland","2024-02-17",0,0,0,0,0,0,0,0
"Greenland","2024-02-18",0,0,0,0,0,0,0,0
"Greenland","2024-02-19",0,0,0,0,0,0,0,0
"Greenland","2024-02-20",0,0,0,0,0,0,0,0
"Greenland","2024-02-21",0,0,0,0,0,0,0,0
"Greenland","2024-02-22",0,0,0,0,0,0,0,0
"Greenland","2024-02-23",0,0,0,0,0,0,0,0
"Greenland","2024-02-24",0,0,0,0,0,0,0,0
"Greenland","2024-02-25",0,0,0,0,0,0,0,0
"Greenland","2024-02-26",0,0,0,0,0,0,0,0
"Greenland","2024-02-27",0,0,0,0,0,0,0,0
"Greenland","2024-02-28",0,0,0,0,0,0,0,0
"Greenland","2024-02-29",0,0,0,0,0,0,0,0
"Greenland","2024-03-01",0,0,0,0,0,0,0,0
"Greenland","2024-03-02",0,0,0,0,0,0,0,0
"Greenland","2024-03-03",0,0,0,0,0,0,0,0
"Greenland","2024-03-04",0,0,0,0,0,0,0,0
"Greenland","2024-03-05",0,0,0,0,0,0,0,0
"Greenland","2024-03-06",0,0,0,0,0,0,0,0
"Greenland","2024-03-07",0,0,0,0,0,0,0,0
"Greenland","2024-03-08",0,0,0,0,0,0,0,0
"Greenland","2024-03-09",0,0,0,0,0,0,0,0
"Greenland","2024-03-10",0,0,0,0,0,0,0,0
"Greenland","2024-03-11",0,0,0,0,0,0,0,0
"Greenland","2024-03-12",0,0,0,0,0,0,0,0
"Greenland","2024-03-13",0,0,0,0,0,0,0,0
"Greenland","2024-03-14",0,0,0,0,0,0,0,0
"Greenland","2024-03-15",0,0,0,0,0,0,0,0
"Greenland","2024-03-16",0,0,0,0,0,0,0,0
"Greenland","2024-03-17",0,0,0,0,0,0,0,0
"Greenland","2024-03-18",0,0,0,0,0,0,0,0
"Greenland","2024-03-19",0,0,0,0,0,0,0,0
"Greenland","2024-03-20",0,0,0,0,0,0,0,0
"Greenland","2024-03-21",0,0,0,0,0,0,0,0
"Greenland","2024-03-22",0,0,0,0,0,0,0,0
"Greenland","2024-03-23",0,0,0,0,0,0,0,0
"Greenland","2024-03-24",0,0,0,0,0,0,0,0
"Greenland","2024-03-25",0,0,0,0,0,0,0,0
"Greenland","2024-03-26",0,0,0,0,0,0,0,0
"Greenland","2024-03-27",0,0,0,0,0,0,0,0
"Greenland","2024-03-28",0,0,0,0,0,0,0,0
"Greenland","2024-03-29",0,0,0,0,0,0,0,0
"Greenland","2024-03-30",0,0,0,0,0,0,0,0
"Greenland","2024-03-31",0,0,0,0,0,0,0,0
"Greenland","2024-04-01",0,0,0,0,0,0,0,0
"Greenland","2024-04-02",0,0,0,0,0,0,0,0
"Greenland","2024-04-03",0,0,0,0,0,0,0,0
"Greenland","2024-04-04",0,0,0,0,0,0,0,0
"Greenland","2024-04-05",0,0,0,0,0,0,0,0
"Greenland","2024-04-06",0,0,0,0,0,0,0,0
"Greenland","2024-04-07",0,0,0,0,0,0,0,0
"Greenland","2024-04-08",0,0,0,0,0,0,0,0
"Greenland","2024-04-09",0,0,0,0,0,0,0,0
"Greenland","2024-04-10",0,0,0,0,0,0,0,0
"Greenland","2024-04-11",0,0,0,0,0,0,0,0
"Greenland","2024-04-12",0,0,0,0,0,0,0,0
"Greenland","2024-04-13",0,0,0,0,0,0,0,0
"Greenland","2024-04-14",0,0,0,0,0,0,0,0
"Greenland","2024-04-15",0,0,0,0,0,0,0,0
"Greenland","2024-04-16",0,0,0,0,0,0,0,0
"Greenland","2024-04-17",0,0,0,0,0,0,0,0
"Greenland","2024-04-18",0,0,0,0,0,0,0,0
"Greenland","2024-04-19",0,0,0,0,0,0,0,0
"Greenland","2024-04-20",0,0,0,0,0,0,0,0
"Greenland","2024-04-21",0,0,0,0,0,0,0,0
"Greenland","2024-04-22",0,0,0,0,0,0,0,0
"Greenland","2024-04-23",0,0,0,0,0,0,0,0
"Greenland","2024-04-24",0,0,0,0,0,0,0,0
"Greenland","2024-04-25",0,0,0,0,0,0,0,0
"Greenland","2024-04-26",0,0,0,0,0,0,0,0
"Greenland","2024-04-27",0,0,0,0,0,0,0,0
"Greenland","2024-04-28",0,0,0,0,0,0,0,0
"Greenland","2024-04-29",0,0,0,0,0,0,0,0
"Greenland","2024-04-30",0,0,0,0,0,0,0,0
"Greenland","2024-05-01",0,0,0,0,0,0,0,0
"Greenland","2024-05-02",0,0,0,0,0,0,0,0
"Greenland","2024-05-03",0,0,0,0,0,0,0,0
"Greenland","2024-05-04",0,0,0,0,0,0,0,0
"Greenland","2024-05-05",0,0,0,0,0,0,0,0
"Greenland","2024-05-06",0,0,0,0,0,0,0,0
"Greenland","2024-05-07",0,0,0,0,0,0,0,0
"Greenland","2024-05-08",0,0,0,0,0,0,0,0
"Greenland","2024-05-09",0,0,0,0,0,0,0,0
"Greenland","2024-05-10",0,0,0,0,0,0,0,0
"Greenland","2024-05-11",0,0,0,0,0,0,0,0
"Greenland","2024-05-12",0,0,0,0,0,0,0,0
"Greenland","2024-05-13",0,0,0,0,0,0,0,0
"Greenland","2024-05-14",0,0,0,0,0,0,0,0
"Greenland","2024-05-15",0,0,0,0,0,0,0,0
"Greenland","2024-05-16",0,0,0,0,0,0,0,0
"Greenland","2024-05-17",0,0,0,0,0,0,0,0
"Greenland","2024-05-18",0,0,0,0,0,0,0,0
"Greenland","2024-05-19",0,0,0,0,0,0,0,0
"Greenland","2024-05-20",0,0,0,0,0,0,0,0
"Greenland","2024-05-21",0,0,0,0,0,0,0,0
"Greenland","2024-05-22",0,0,0,0,0,0,0,0
"Greenland","2024-05-23",0,0,0,0,0,0,0,0
"Greenland","2024-05-24",0,0,0,0,0,0,0,0
"Greenland","2024-05-25",0,0,0,0,0,0,0,0
"Greenland","2024-05-26",0,0,0,0,0,0,0,0
"Greenland","2024-05-27",0,0,0,0,0,0,0,0
"Greenland","2024-05-28",0,0,0,0,0,0,0,0
"Greenland","2024-05-29",0,0,0,0,0,0,0,0
"Greenland","2024-05-30",0,0,0,0,0,0,0,0
"Greenland","2024-05-31",0,0,0,0,0,0,0,0
"Greenland","2024-06-01",0,0,0,0,0,0,0,0
"Greenland","2024-06-02",0,0,0,0,0,0,0,0
"Greenland","2024-06-03",0,0,0,0,0,0,0,0
"Greenland","2024-06-04",0,0,0,0,0,0,0,0
"Greenland","2024-06-05",0,0,0,0,0,0,0,0
"Greenland","2024-06-06",0,0,0,0,0,0,0,0
"Greenland","2024-06-07",0,0,0,0,0,0,0,0
"Greenland","2024-06-08",0,0,0,0,0,0,0,0
"Greenland","2024-06-09",0,0,0,0,0,0,0,0
"Greenland","2024-06-10",0,0,0,0,0,0,0,0
"Greenland","2024-06-11",0,0,0,0,0,0,0,0
"Greenland","2024-06-12",0,0,0,0,0,0,0,0
"Greenland","2024-06-13",0,0,0,0,0,0,0,0
"Greenland","2024-06-14",0,0,0,0,0,0,0,0
"Greenland","2024-06-15",0,0,0,0,0,0,0,0
"Greenland","2024-06-16",0,0,0,0,0,0,0,0
"Greenland","2024-06-17",0,0,0,0,0,0,0,0
"Greenland","2024-06-18",0,0,0,0,0,0,0,0
"Greenland","2024-06-19",0,0,0,0,0,0,0,0
"Greenland","2024-06-20",0,0,0,0,0,0,0,0
"Greenland","2024-06-21",0,0,0,0,0,0,0,0
"Greenland","2024-06-22",0,0,0,0,0,0,0,0
"Greenland","2024-06-23",0,0,0,0,0,0,0,0
"Greenland","2024-06-24",0,0,0,0,0,0,0,0
"Greenland","2024-06-25",0,0,0,0,0,0,0,0
"Greenland","2024-06-26",0,0,0,0,0,0,0,0
"Greenland","2024-06-27",0,0,0,0,0,0,0,0
"Greenland","2024-06-28",0,0,0,0,0,0,0,0
"Greenland","2024-06-29",0,0,0,0,0,0,0,0
"Greenland","2024-06-30",0,0,0,0,0,0,0,0
"Greenland","2024-07-01",0,0,0,0,0,0,0,0
"Greenland","2024-07-02",0,0,0,0,0,0,0,0
"Greenland","2024-07-03",0,0,0,0,0,0,0,0
"Greenland","2024-07-04",0,0,0,0,0,0,0,0
"Greenland","2024-07-05",0,0,0,0,0,0,0,0
"Greenland","2024-07-06",0,0,0,0,0,0,0,0
"Greenland","2024-07-07",0,0,0,0,0,0,0,0
"Greenland","2024-07-08",0,0,0,0,0,0,0,0
"Greenland","2024-07-09",0,0,0,0,0,0,0,0
"Greenland","2024-07-10",0,0,0,0,0,0,0,0
"Greenland","2024-07-11",0,0,0,0,0,0,0,0
"Greenland","2024-07-12",0,0,0,0,0,0,0,0
"Greenland","2024-07-13",0,0,0,0,0,0,0,0
"Greenland","2024-07-14",0,0,0,0,0,0,0,0
"Greenland","2024-07-15",0,0,0,0,0,0,0,0
"Greenland","2024-07-16",0,0,0,0,0,0,0,0
"Greenland","2024-07-17",0,0,0,0,0,0,0,0
"Greenland","2024-07-18",0,0,0,0,0,0,0,0
"Greenland","2024-07-19",0,0,0,0,0,0,0,0
"Greenland","2024-07-20",0,0,0,0,0,0,0,0
"Greenland","2024-07-21",0,0,0,0,0,0,0,0
"Greenland","2024-07-22",0,0,0,0,0,0,0,0
"Greenland","2024-07-23",0,0,0,0,0,0,0,0
"Greenland","2024-07-24",0,0,0,0,0,0,0,0
"Greenland","2024-07-25",0,0,0,0,0,0,0,0
"Greenland","2024-07-26",0,0,0,0,0,0,0,0
"Greenland","2024-07-27",0,0,0,0,0,0,0,0
"Greenland","2024-07-28",0,0,0,0,0,0,0,0
"Greenland","2024-07-29",0,0,0,0,0,0,0,0
"Greenland","2024-07-30",0,0,0,0,0,0,0,0
"Greenland","2024-07-31",0,0,0,0,0,0,0,0
"Greenland","2024-08-01",0,0,0,0,0,0,0,0
"Greenland","2024-08-02",0,0,0,0,0,0,0,0
"Greenland","2024-08-03",0,0,0,0,0,0,0,0
"Greenland","2024-08-04",0,0,0,0,0,0,0,0
"Greenland","2024-08-05",0,0,0,0,0,0,0,0
"Greenland","2024-08-06",0,0,0,0,0,0,0,0
"Greenland","2024-08-07",0,0,0,0,0,0,0,0
"Greenland","2024-08-08",0,0,0,0,0,0,0,0
"Greenland","2024-08-09",0,0,0,0,0,0,0,0
"Greenland","2024-08-10",0,0,0,0,0,0,0,0
"Greenland","2024-08-11",0,0,0,0,0,0,0,0
"Greenland","2024-08-12",0,0,0,0,0,0,0,0
"Greenland","2024-08-13",0,0,0,0,0,0,0,0
"Greenland","2024-08-14",0,0,0,0,0,0,0,0
"Greenland","2024-08-15",0,0,0,0,0,0,0,0
"Greenland","2024-08-16",0,0,0,0,0,0,0,0
"Greenland","2024-08-17",0,0,0,0,0,0,0,0
"Greenland","2024-08-18",0,0,0,0,0,0,0,0
"Greenland","2024-08-19",0,0,0,0,0,0,0,0
"Greenland","2024-08-20",0,0,0,0,0,0,0,0
"Greenland","2024-08-21",0,0,0,0,0,0,0,0
"Greenland","2024-08-22",0,0,0,0,0,0,0,0
"Greenland","2024-08-23",0,0,0,0,0,0,0,0
"Greenland","2024-08-24",0,0,0,0,0,0,0,0
"Greenland","2024-08-25",0,0,0,0,0,0,0,0
"Greenland","2024-08-26",0,0,0,0,0,0,0,0
"Greenland","2024-08-27",0,0,0,0,0,0,0,0
"Greenland","2024-08-28",0,0,0,0,0,0,0,0
"Greenland","2024-08-29",0,0,0,0,0,0,0,0
"Greenland","2024-08-30",0,0,0,0,0,0,0,0
"Greenland","2024-08-31",0,0,0,0,0,0,0,0
"Greenland","2024-09-01",0,0,0,0,0,0,0,0
"Greenland","2024-09-02",0,0,0,0,0,0,0,0
"Greenland","2024-09-03",0,0,0,0,0,0,0,0
"Greenland","2024-09-04",0,0,0,0,0,0,0,0
"Greenland","2024-09-05",0,0,0,0,0,0,0,0
"Greenland","2024-09-06",0,0,0,0,0,0,0,0
"Greenland","2024-09-07",0,0,0,0,0,0,0,0
"Greenland","2024-09-08",0,0,0,0,0,0,0,0
"Greenland","2024-09-09",0,0,0,0,0,0,0,0
"Greenland","2024-09-10",0,0,0,0,0,0,0,0
"Greenland","2024-09-11",0,0,0,0,0,0,0,0
"Greenland","2024-09-12",0,0,0,0,0,0,0,0
"Greenland","2024-09-13",0,0,0,0,0,0,0,0
"Greenland","2024-09-14",0,0,0,0,0,0,0,0
"Greenland","2024-09-15",0,0,0,0,0,0,0,0
"Greenland","2024-09-16",0,0,0,0,0,0,0,0
"Greenland","2024-09-17",0,0,0,0,0,0,0,0
"Greenland","2024-09-18",0,0,0,0,0,0,0,0
"Greenland","2024-09-19",0,0,0,0,0,0,0,0
"Greenland","2024-09-20",0,0,0,0,0,0,0,0
"Greenland","2024-09-21",0,0,0,0,0,0,0,0
"Greenland","2024-09-22",0,0,0,0,0,0,0,0
"Greenland","2024-09-23",0,0,0,0,0,0,0,0
"Greenland","2024-09-24",0,0,0,0,0,0,0,0
"Greenland","2024-09-25",0,0,0,0,0,0,0,0
"Greenland","2024-09-26",0,0,0,0,0,0,0,0
"Greenland","2024-09-27",0,0,0,0,0,0,0,0
"Greenland","2024-09-28",0,0,0,0,0,0,0,0
"Greenland","2024-09-29",0,0,0,0,0,0,0,0
"Greenland","2024-09-30",0,0,0,0,0,0,0,0
"Greenland","2024-10-01",0,0,0,0,0,0,0,0
"Greenland","2024-10-02",0,0,0,0,0,0,0,0
"Greenland","2024-10-03",0,0,0,0,0,0,0,0
"Greenland","2024-10-04",0,0,0,0,0,0,0,0
"Greenland","2024-10-05",0,0,0,0,0,0,0,0
"Greenland","2024-10-06",0,0,0,0,0,0,0,0
"Greenland","2024-10-07",0,0,0,0,0,0,0,0
"Greenland","2024-10-08",0,0,0,0,0,0,0,0
"Greenland","2024-10-09",0,0,0,0,0,0,0,0
"Greenland","2024-10-10",0,0,0,0,0,0,0,0
"Greenland","2024-10-11",0,0,0,0,0,0,0,0
"Greenland","2024-10-12",0,0,0,0,0,0,0,0
"Greenland","2024-10-13",0,0,0,0,0,0,0,0
"Greenland","2024-10-14",0,0,0,0,0,0,0,0
"Greenland","2024-10-15",0,0,0,0,0,0,0,0
"Greenland","2024-10-16",0,0,0,0,0,0,0,0
"Greenland","2024-10-17",0,0,0,0,0,0,0,0
"Greenland","2024-10-18",0,0,0,0,0,0,0,0
"Greenland","2024-10-19",0,0,0,0,0,0,0,0
"Greenland","2024-10-20",0,0,0,0,0,0,0,0
"Greenland","2024-10-21",0,0,0,0,0,0,0,0
"Greenland","2024-10-22",0,0,0,0,0,0,0,0
"Greenland","2024-10-23",0,0,0,0,0,0,0,0
"Greenland","2024-10-24",0,0,0,0,0,0,0,0
"Greenland","2024-10-25",0,0,0,0,0,0,0,0
"Greenland","2024-10-26",0,0,0,0,0,0,0,0
"Greenland","2024-10-27",0,0,0,0,0,0,0,0
"Greenland","2024-10-28",0,0,0,0,0,0,0,0
"Greenland","2024-10-29",0,0,0,0,0,0,0,0
"Greenland","2024-10-30",0,0,0,0,0,0,0,0
"Greenland","2024-10-31",0,0,0,0,0,0,0,0
"Greenland","2024-11-01",0,0,0,0,0,0,0,0
"Greenland","2024-11-02",0,0,0,0,0,0,0,0
"Greenland","2024-11-03",0,0,0,0,0,0,0,0
"Greenland","2024-11-04",0,0,0,0,0,0,0,0
"Greenland","2024-11-05",0,0,0,0,0,0,0,0
"Greenland","2024-11-06",0,0,0,0,0,0,0,0
"Greenland","2024-11-07",0,0,0,0,0,0,0,0
"Greenland","2024-11-08",0,0,0,0,0,0,0,0
"Greenland","2024-11-09",0,0,0,0,0,0,0,0
"Greenland","2024-11-10",0,0,0,0,0,0,0,0
"Greenland","2024-11-11",0,0,0,0,0,0,0,0
"Greenland","2024-11-12",0,0,0,0,0,0,0,0
"Greenland","2024-11-13",0,0,0,0,0,0,0,0
"Greenland","2024-11-14",0,0,0,0,0,0,0,0
"Greenland","2024-11-15",0,0,0,0,0,0,0,0
"Greenland","2024-11-16",0,0,0,0,0,0,0,0
"Greenland","2024-11-17",0,0,0,0,0,0,0,0
"Greenland","2024-11-18",0,0,0,0,0,0,0,0
"Greenland","2024-11-19",0,0,0,0,0,0,0,0
"Greenland","2024-11-20",0,0,0,0,0,0,0,0
"Greenland","2024-11-21",0,0,0,0,0,0,0,0
"Greenland","2024-11-22",0,0,0,0,0,0,0,0
"Greenland","2024-11-23",0,0,0,0,0,0,0,0
"Greenland","2024-11-24",0,0,0,0,0,0,0,0
"Greenland","2024-11-25",0,0,0,0,0,0,0,0
"Greenland","2024-11-26",0,0,0,0,0,0,0,0
"Greenland","2024-11-27",0,0,0,0,0,0,0,0
"Greenland","2024-11-28",0,0,0,0,0,0,0,0
"Greenland","2024-11-29",0,0,0,0,0,0,0,0
"Greenland","2024-11-30",0,0,0,0,0,0,0,0
"Greenland","2024-12-01",0,0,0,0,0,0,0,0
"Greenland","2024-12-02",0,0,0,0,0,0,0,0
"Greenland","2024-12-03",0,0,0,0,0,0,0,0
"Greenland","2024-12-04",0,0,0,0,0,0,0,0
"Greenland","2024-12-05",0,0,0,0,0,0,0,0
"Greenland","2024-12-06",0,0,0,0,0,0,0,0
"Greenland","2024-12-07",0,0,0,0,0,0,0,0
"Greenland","2024-12-08",0,0,0,0,0,0,0,0
"Greenland","2024-12-09",0,0,0,0,0,0,0,0
"Greenland","2024-12-10",0,0,0,0,0,0,0,0
"Greenland","2024-12-11",0,0,0,0,0,0,0,0
"Greenland","2024-12-12",0,0,0,0,0,0,0,0
"Greenland","2024-12-13",0,0,0,0,0,0,0,0
"Greenland","2024-12-14",0,0,0,0,0,0,0,0
"Greenland","2024-12-15",0,0,0,0,0,0,0,0
"Greenland","2024-12-16",0,0,0,0,0,0,0,0
"Greenland","2024-12-17",0,0,0,0,0,0,0,0
"Greenland","2024-12-18",0,0,0,0,0,0,0,0
"Greenland","2024-12-19",0,0,0,0,0,0,0,0
"Greenland","2024-12-20",0,0,0,0,0,0,0,0
"Greenland","2024-12-21",0,0,0,0,0,0,0,0
"Greenland","2024-12-22",0,0,0,0,0,0,0,0
"Greenland","2024-12-23",0,0,0,0,0,0,0,0
"Greenland","2024-12-24",0,0,0,0,0,0,0,0
"Greenland","2024-12-25",0,0,0,0,0,0,0,0
"Greenland","2024-12-26",0,0,0,0,0,0,0,0
"Greenland","2024-12-27",0,0,0,0,0,0,0,0
"Greenland","2024-12-28",0,0,0,0,0,0,0,0
"Greenland","2024-12-29",0,0,0,0,0,0,0,0
"Greenland","2024-12-30",0,0,0,0,0,0,0,0
"Greenland","2024-12-31",0,0,0,0,0,0,0,0
"Greenland","2025-01-01",0,0,0,0,0,0,0,0
"Greenland","2025-01-02",0,0,0,0,0,0,0,0
"Greenland","2025-01-03",0,0,0,0,0,0,0,0
"Greenland","2025-01-04",0,0,0,0,0,0,0,0
"Greenland","2025-01-05",0,0,0,0,0,0,0,0
"Greenland","2025-01-06",0,0,0,0,0,0,0,0
"Greenland","2025-01-07",0,0,0,0,0,0,0,0
"Greenland","2025-01-08",0,0,0,0,0,0,0,0
"Greenland","2025-01-09",0,0,0,0,0,0,0,0
"Greenland","2025-01-10",0,0,0,0,0,0,0,0
"Greenland","2025-01-11",0,0,0,0,0,0,0,0
"Greenland","2025-01-12",0,0,0,0,0,0,0,0
"Greenland","2025-01-13",0,0,0,0,0,0,0,0
"Guadeloupe","2024-01-01",0,0,0,0,0,0,0,0
"Guadeloupe","2024-01-02",0,0,0,0,0,0,0,0
"Guadeloupe","2024-01-03",0,0,0,0,0,0,0,0
"Guadeloupe","2024-01-04",0,0,0,0,0,0,0,0
"Guadeloupe","2024-01-05",0,0,0,0,0,0,0,0
"Guadeloupe","2024-01-06",0,0,0,0,0,0,0,0
"Guadeloupe","2024-01-07",0,0,0,0,0,0,0,0
"Guadeloupe","2024-01-08",0,0,0,0,0,0,0,0
"Guadeloupe","2024-01-09",0,0,0,0,0,0,0,0
"Guadeloupe","2024-01-10",0,0,0,0,0,0,0,0
"Guadeloupe","2024-01-11",0,0,0,0,0,0,0,0
"Guadeloupe","2024-01-12",0,0,0,0,0,0,0,0
"Guadeloupe","2024-01-13",0,0,0,0,0,0,0,0
"Guadeloupe","2024-01-14",0,0,0,0,0,0,0,0
"Guadeloupe","2024-01-15",0,0,0,0,0,0,0,0
"Guadeloupe","2024-01-16",0,0,0,0,0,0,0,0
"Guadeloupe","2024-01-17",0,0,0,0,0,0,0,0
"Guadeloupe","2024-01-18",0,0,0,0,0,0,0,0
"Guadeloupe","2024-01-19",0,0,0,0,0,0,0,0
"Guadeloupe","2024-01-20",0,0,0,0,0,0,0,0
"Guadeloupe","2024-01-21",0,0,0,0,0,0,0,0
"Guadeloupe","2024-01-22",0,0,0,0,0,0,0,0
"Guadeloupe","2024-01-23",0,0,0,0,0,0,0,0
"Guadeloupe","2024-01-24",0,0,0,0,0,0,0,0
"Guadeloupe","2024-01-25",0,0,0,0,0,0,0,0
"Guadeloupe","2024-01-26",0,0,0,0,0,0,0,0
"Guadeloupe","2024-01-27",0,0,0,0,0,0,0,0
"Guadeloupe","2024-01-28",0,0,0,0,0,0,0,0
"Guadeloupe","2024-01-29",0,0,0,0,0,0,0,0
"Guadeloupe","2024-01-30",0,0,0,0,0,0,0,0
"Guadeloupe","2024-01-31",0,0,0,0,0,0,0,0
"Guadeloupe","2024-02-01",0,0,0,0,0,0,0,0
"Guadeloupe","2024-02-02",0,0,0,0,0,0,0,0
"Guadeloupe","2024-02-03",0,0,0,0,0,0,0,0
"Guadeloupe","2024-02-04",0,0,0,0,0,0,0,0
"Guadeloupe","2024-02-05",0,0,0,0,0,0,0,0
"Guadeloupe","2024-02-06",0,0,0,0,0,0,0,0
"Guadeloupe","2024-02-07",0,0,0,0,0,0,0,0
"Guadeloupe","2024-02-08",0,0,0,0,0,0,0,0
"Guadeloupe","2024-02-09",0,0,0,0,0,0,0,0
"Guadeloupe","2024-02-10",0,0,0,0,0,0,0,0
"Guadeloupe","2024-02-11",0,0,0,0,0,0,0,0
"Guadeloupe","2024-02-12",0,0,0,0,0,0,0,0
"Guadeloupe","2024-02-13",0,0,0,0,0,0,0,0
"Guadeloupe","2024-02-14",0,0,0,0,0,0,0,0
"Guadeloupe","2024-02-15",0,0,0,0,0,0,0,0
"Guadeloupe","2024-02-16",0,0,0,0,0,0,0,0
"Guadeloupe","2024-02-17",0,0,0,0,0,0,0,0
"Guadeloupe","2024-02-18",0,0,0,0,0,0,0,0
"Guadeloupe","2024-02-19",0,0,0,0,0,0,0,0
"Guadeloupe","2024-02-20",0,0,0,0,0,0,0,0
"Guadeloupe","2024-02-21",0,0,0,0,0,0,0,0
"Guadeloupe","2024-02-22",0,0,0,0,0,0,0,0
"Guadeloupe","2024-02-23",0,0,0,0,0,0,0,0
"Guadeloupe","2024-02-24",0,0,0,0,0,0,0,0
"Guadeloupe","2024-02-25",0,0,0,0,0,0,0,0
"Guadeloupe","2024-02-26",0,0,0,0,0,0,0,0
"Guadeloupe","2024-02-27",0,0,0,0,0,0,0,0
"Guadeloupe","2024-02-28",0,0,0,0,0,0,0,0
"Guadeloupe","2024-02-29",0,0,0,0,0,0,0,0
"Guadeloupe","2024-03-01",0,0,0,0,0,0,0,0
"Guadeloupe","2024-03-02",0,0,0,0,0,0,0,0
"Guadeloupe","2024-03-03",0,0,0,0,0,0,0,0
"Guadeloupe","2024-03-04",0,0,0,0,0,0,0,0
"Guadeloupe","2024-03-05",0,0,0,0,0,0,0,0
"Guadeloupe","2024-03-06",0,0,0,0,0,0,0,0
"Guadeloupe","2024-03-07",0,0,0,0,0,0,0,0
"Guadeloupe","2024-03-08",0,0,0,0,0,0,0,0
"Guadeloupe","2024-03-09",0,0,0,0,0,0,0,0
"Guadeloupe","2024-03-10",0,0,0,0,0,0,0,0
"Guadeloupe","2024-03-11",0,0,0,0,0,0,0,0
"Guadeloupe","2024-03-12",0,0,0,0,0,0,0,0
"Guadeloupe","2024-03-13",0,0,0,0,0,0,0,0
"Guadeloupe","2024-03-14",0,0,0,0,0,0,0,0
"Guadeloupe","2024-03-15",0,0,0,0,0,0,0,0
"Guadeloupe","2024-03-16",0,0,0,0,0,0,0,0
"Guadeloupe","2024-03-17",0,0,0,0,0,0,0,0
"Guadeloupe","2024-03-18",0,0,0,0,0,0,0,0
"Guadeloupe","2024-03-19",0,0,0,0,0,0,0,0
"Guadeloupe","2024-03-20",0,0,0,0,0,0,0,0
"Guadeloupe","2024-03-21",0,0,0,0,0,0,0,0
"Guadeloupe","2024-03-22",0,0,0,0,0,0,0,0
"Guadeloupe","2024-03-23",0,0,0,0,0,0,0,0
"Guadeloupe","2024-03-24",0,0,0,0,0,0,0,0
"Guadeloupe","2024-03-25",0,0,0,0,0,0,0,0
"Guadeloupe","2024-03-26",0,0,0,0,0,0,0,0
"Guadeloupe","2024-03-27",0,0,0,0,0,0,0,0
"Guadeloupe","2024-03-28",0,0,0,0,0,0,0,0
"Guadeloupe","2024-03-29",0,0,0,0,0,0,0,0
"Guadeloupe","2024-03-30",0,0,0,0,0,0,0,0
"Guadeloupe","2024-03-31",0,0,0,0,0,0,0,0
"Guadeloupe","2024-04-01",0,0,0,0,0,0,0,0
"Guadeloupe","2024-04-02",0,0,0,0,0,0,0,0
"Guadeloupe","2024-04-03",0,0,0,0,0,0,0,0
"Guadeloupe","2024-04-04",0,0,0,0,0,0,0,0
"Guadeloupe","2024-04-05",0,0,0,0,0,0,0,0
"Guadeloupe","2024-04-06",0,0,0,0,0,0,0,0
"Guadeloupe","2024-04-07",0,0,0,0,0,0,0,0
"Guadeloupe","2024-04-08",0,0,0,0,0,0,0,0
"Guadeloupe","2024-04-09",0,0,0,0,0,0,0,0
"Guadeloupe","2024-04-10",0,0,0,0,0,0,0,0
"Guadeloupe","2024-04-11",0,0,0,0,0,0,0,0
"Guadeloupe","2024-04-12",0,0,0,0,0,0,0,0
"Guadeloupe","2024-04-13",0,0,0,0,0,0,0,0
"Guadeloupe","2024-04-14",0,0,0,0,0,0,0,0
"Guadeloupe","2024-04-15",0,0,0,0,0,0,0,0
"Guadeloupe","2024-04-16",0,0,0,0,0,0,0,0
"Guadeloupe","2024-04-17",0,0,0,0,0,0,0,0
"Guadeloupe","2024-04-18",0,0,0,0,0,0,0,0
"Guadeloupe","2024-04-19",0,0,0,0,0,0,0,0
"Guadeloupe","2024-04-20",0,0,0,0,0,0,0,0
"Guadeloupe","2024-04-21",0,0,0,0,0,0,0,0
"Guadeloupe","2024-04-22",0,0,0,0,0,0,0,0
"Guadeloupe","2024-04-23",0,0,0,0,0,0,0,0
"Guadeloupe","2024-04-24",0,0,0,0,0,0,0,0
"Guadeloupe","2024-04-25",0,0,0,0,0,0,0,0
"Guadeloupe","2024-04-26",0,0,0,0,0,0,0,0
"Guadeloupe","2024-04-27",0,0,0,0,0,0,0,0
"Guadeloupe","2024-04-28",0,0,0,0,0,0,0,0
"Guadeloupe","2024-04-29",0,0,0,0,0,0,0,0
"Guadeloupe","2024-04-30",0,0,0,0,0,0,0,0
"Guadeloupe","2024-05-01",0,0,0,0,0,0,0,0
"Guadeloupe","2024-05-02",0,0,0,0,0,0,0,0
"Guadeloupe","2024-05-03",0,0,0,0,0,0,0,0
"Guadeloupe","2024-05-04",0,0,0,0,0,0,0,0
"Guadeloupe","2024-05-05",0,0,0,0,0,0,0,0
"Guadeloupe","2024-05-06",0,0,0,0,0,0,0,0
"Guadeloupe","2024-05-07",0,0,0,0,0,0,0,0
"Guadeloupe","2024-05-08",0,0,0,0,0,0,0,0
"Guadeloupe","2024-05-09",0,0,0,0,0,0,0,0
"Guadeloupe","2024-05-10",0,0,0,0,0,0,0,0
"Guadeloupe","2024-05-11",0,0,0,0,0,0,0,0
"Guadeloupe","2024-05-12",0,0,0,0,0,0,0,0
"Guadeloupe","2024-05-13",0,0,0,0,0,0,0,0
"Guadeloupe","2024-05-14",0,0,0,0,0,0,0,0
"Guadeloupe","2024-05-15",0,0,0,0,0,0,0,0
"Guadeloupe","2024-05-16",0,0,0,0,0,0,0,0
"Guadeloupe","2024-05-17",0,0,0,0,0,0,0,0
"Guadeloupe","2024-05-18",0,0,0,0,0,0,0,0
"Guadeloupe","2024-05-19",0,0,0,0,0,0,0,0
"Guadeloupe","2024-05-20",0,0,0,0,0,0,0,0
"Guadeloupe","2024-05-21",0,0,0,0,0,0,0,0
"Guadeloupe","2024-05-22",0,0,0,0,0,0,0,0
"Guadeloupe","2024-05-23",0,0,0,0,0,0,0,0
"Guadeloupe","2024-05-24",0,0,0,0,0,0,0,0
"Guadeloupe","2024-05-25",0,0,0,0,0,0,0,0
"Guadeloupe","2024-05-26",0,0,0,0,0,0,0,0
"Guadeloupe","2024-05-27",0,0,0,0,0,0,0,0
"Guadeloupe","2024-05-28",0,0,0,0,0,0,0,0
"Guadeloupe","2024-05-29",0,0,0,0,0,0,0,0
"Guadeloupe","2024-05-30",0,0,0,0,0,0,0,0
"Guadeloupe","2024-05-31",0,0,0,0,0,0,0,0
"Guadeloupe","2024-06-01",0,0,0,0,0,0,0,0
"Guadeloupe","2024-06-02",0,0,0,0,0,0,0,0
"Guadeloupe","2024-06-03",0,0,0,0,0,0,0,0
"Guadeloupe","2024-06-04",0,0,0,0,0,0,0,0
"Guadeloupe","2024-06-05",0,0,0,0,0,0,0,0
"Guadeloupe","2024-06-06",0,0,0,0,0,0,0,0
"Guadeloupe","2024-06-07",0,0,0,0,0,0,0,0
"Guadeloupe","2024-06-08",0,0,0,0,0,0,0,0
"Guadeloupe","2024-06-09",0,0,0,0,0,0,0,0
"Guadeloupe","2024-06-10",0,0,0,0,0,0,0,0
"Guadeloupe","2024-06-11",0,0,0,0,0,0,0,0
"Guadeloupe","2024-06-12",0,0,0,0,0,0,0,0
"Guadeloupe","2024-06-13",0,0,0,0,0,0,0,0
"Guadeloupe","2024-06-14",0,0,0,0,0,0,0,0
"Guadeloupe","2024-06-15",0,0,0,0,0,0,0,0
"Guadeloupe","2024-06-16",0,0,0,0,0,0,0,0
"Guadeloupe","2024-06-17",0,0,0,0,0,0,0,0
"Guadeloupe","2024-06-18",0,0,0,0,0,0,0,0
"Guadeloupe","2024-06-19",0,0,0,0,0,0,0,0
"Guadeloupe","2024-06-20",0,0,0,0,0,0,0,0
"Guadeloupe","2024-06-21",0,0,0,0,0,0,0,0
"Guadeloupe","2024-06-22",0,0,0,0,0,0,0,0
"Guadeloupe","2024-06-23",0,0,0,0,0,0,0,0
"Guadeloupe","2024-06-24",0,0,0,0,0,0,0,0
"Guadeloupe","2024-06-25",0,0,0,0,0,0,0,0
"Guadeloupe","2024-06-26",0,0,0,0,0,0,0,0
"Guadeloupe","2024-06-27",0,0,0,0,0,0,0,0
"Guadeloupe","2024-06-28",0,0,0,0,0,0,0,0
"Guadeloupe","2024-06-29",0,0,0,0,0,0,0,0
"Guadeloupe","2024-06-30",0,0,0,0,0,0,0,0
"Guadeloupe","2024-07-01",0,0,0,0,0,0,0,0
"Guadeloupe","2024-07-02",0,0,0,0,0,0,0,0
"Guadeloupe","2024-07-03",0,0,0,0,0,0,0,0
"Guadeloupe","2024-07-04",0,0,0,0,0,0,0,0
"Guadeloupe","2024-07-05",0,0,0,0,0,0,0,0
"Guadeloupe","2024-07-06",0,0,0,0,0,0,0,0
"Guadeloupe","2024-07-07",0,0,0,0,0,0,0,0
"Guadeloupe","2024-07-08",0,0,0,0,0,0,0,0
"Guadeloupe","2024-07-09",0,0,0,0,0,0,0,0
"Guadeloupe","2024-07-10",0,0,0,0,0,0,0,0
"Guadeloupe","2024-07-11",0,0,0,0,0,0,0,0
"Guadeloupe","2024-07-12",0,0,0,0,0,0,0,0
"Guadeloupe","2024-07-13",0,0,0,0,0,0,0,0
"Guadeloupe","2024-07-14",0,0,0,0,0,0,0,0
"Guadeloupe","2024-07-15",0,0,0,0,0,0,0,0
"Guadeloupe","2024-07-16",0,0,0,0,0,0,0,0
"Guadeloupe","2024-07-17",0,0,0,0,0,0,0,0
"Guadeloupe","2024-07-18",0,0,0,0,0,0,0,0
"Guadeloupe","2024-07-19",0,0,0,0,0,0,0,0
"Guadeloupe","2024-07-20",0,0,0,0,0,0,0,0
"Guadeloupe","2024-07-21",0,0,0,0,0,0,0,0
"Guadeloupe","2024-07-22",0,0,0,0,0,0,0,0
"Guadeloupe","2024-07-23",0,0,0,0,0,0,0,0
"Guadeloupe","2024-07-24",0,0,0,0,0,0,0,0
"Guadeloupe","2024-07-25",0,0,0,0,0,0,0,0
"Guadeloupe","2024-07-26",0,0,0,0,0,0,0,0
"Guadeloupe","2024-07-27",0,0,0,0,0,0,0,0
"Guadeloupe","2024-07-28",0,0,0,0,0,0,0,0
"Guadeloupe","2024-07-29",0,0,0,0,0,0,0,0
"Guadeloupe","2024-07-30",0,0,0,0,0,0,0,0
"Guadeloupe","2024-07-31",0,0,0,0,0,0,0,0
"Guadeloupe","2024-08-01",0,0,0,0,0,0,0,0
"Guadeloupe","2024-08-02",0,0,0,0,0,0,0,0
"Guadeloupe","2024-08-03",0,0,0,0,0,0,0,0
"Guadeloupe","2024-08-04",0,0,0,0,0,0,0,0
"Guadeloupe","2024-08-05",0,0,0,0,0,0,0,0
"Guadeloupe","2024-08-06",0,0,0,0,0,0,0,0
"Guadeloupe","2024-08-07",0,0,0,0,0,0,0,0
"Guadeloupe","2024-08-08",0,0,0,0,0,0,0,0
"Guadeloupe","2024-08-09",0,0,0,0,0,0,0,0
"Guadeloupe","2024-08-10",0,0,0,0,0,0,0,0
"Guadeloupe","2024-08-11",0,0,0,0,0,0,0,0
"Guadeloupe","2024-08-12",0,0,0,0,0,0,0,0
"Guadeloupe","2024-08-13",0,0,0,0,0,0,0,0
"Guadeloupe","2024-08-14",0,0,0,0,0,0,0,0
"Guadeloupe","2024-08-15",0,0,0,0,0,0,0,0
"Guadeloupe","2024-08-16",0,0,0,0,0,0,0,0
"Guadeloupe","2024-08-17",0,0,0,0,0,0,0,0
"Guadeloupe","2024-08-18",0,0,0,0,0,0,0,0
"Guadeloupe","2024-08-19",0,0,0,0,0,0,0,0
"Guadeloupe","2024-08-20",0,0,0,0,0,0,0,0
"Guadeloupe","2024-08-21",0,0,0,0,0,0,0,0
"Guadeloupe","2024-08-22",0,0,0,0,0,0,0,0
"Guadeloupe","2024-08-23",0,0,0,0,0,0,0,0
"Guadeloupe","2024-08-24",0,0,0,0,0,0,0,0
"Guadeloupe","2024-08-25",0,0,0,0,0,0,0,0
"Guadeloupe","2024-08-26",0,0,0,0,0,0,0,0
"Guadeloupe","2024-08-27",0,0,0,0,0,0,0,0
"Guadeloupe","2024-08-28",0,0,0,0,0,0,0,0
"Guadeloupe","2024-08-29",0,0,0,0,0,0,0,0
"Guadeloupe","2024-08-30",0,0,0,0,0,0,0,0
"Guadeloupe","2024-08-31",0,0,0,0,0,0,0,0
"Guadeloupe","2024-09-01",0,0,0,0,0,0,0,0
"Guadeloupe","2024-09-02",0,0,0,0,0,0,0,0
"Guadeloupe","2024-09-03",0,0,0,0,0,0,0,0
"Guadeloupe","2024-09-04",0,0,0,0,0,0,0,0
"Guadeloupe","2024-09-05",0,0,0,0,0,0,0,0
"Guadeloupe","2024-09-06",0,0,0,0,0,0,0,0
"Guadeloupe","2024-09-07",0,0,0,0,0,0,0,0
"Guadeloupe","2024-09-08",0,0,0,0,0,0,0,0
"Guadeloupe","2024-09-09",0,0,0,0,0,0,0,0
"Guadeloupe","2024-09-10",0,0,0,0,0,0,0,0
"Guadeloupe","2024-09-11",0,0,0,0,0,0,0,0
"Guadeloupe","2024-09-12",0,0,0,0,0,0,0,0
"Guadeloupe","2024-09-13",0,0,0,0,0,0,0,0
"Guadeloupe","2024-09-14",0,0,0,0,0,0,0,0
"Guadeloupe","2024-09-15",0,0,0,0,0,0,0,0
"Guadeloupe","2024-09-16",0,0,0,0,0,0,0,0
"Guadeloupe","2024-09-17",0,0,0,0,0,0,0,0
"Guadeloupe","2024-09-18",0,0,0,0,0,0,0,0
"Guadeloupe","2024-09-19",0,0,0,0,0,0,0,0
"Guadeloupe","2024-09-20",0,0,0,0,0,0,0,0
"Guadeloupe","2024-09-21",0,0,0,0,0,0,0,0
"Guadeloupe","2024-09-22",0,0,0,0,0,0,0,0
"Guadeloupe","2024-09-23",0,0,0,0,0,0,0,0
"Guadeloupe","2024-09-24",0,0,0,0,0,0,0,0
"Guadeloupe","2024-09-25",0,0,0,0,0,0,0,0
"Guadeloupe","2024-09-26",0,0,0,0,0,0,0,0
"Guadeloupe","2024-09-27",0,0,0,0,0,0,0,0
"Guadeloupe","2024-09-28",0,0,0,0,0,0,0,0
"Guadeloupe","2024-09-29",0,0,0,0,0,0,0,0
"Guadeloupe","2024-09-30",0,0,0,0,0,0,0,0
"Guadeloupe","2024-10-01",0,0,0,0,0,0,0,0
"Guadeloupe","2024-10-02",0,0,0,0,0,0,0,0
"Guadeloupe","2024-10-03",0,0,0,0,0,0,0,0
"Guadeloupe","2024-10-04",0,0,0,0,0,0,0,0
"Guadeloupe","2024-10-05",0,0,0,0,0,0,0,0
"Guadeloupe","2024-10-06",0,0,0,0,0,0,0,0
"Guadeloupe","2024-10-07",0,0,0,0,0,0,0,0
"Guadeloupe","2024-10-08",0,0,0,0,0,0,0,0
"Guadeloupe","2024-10-09",0,0,0,0,0,0,0,0
"Guadeloupe","2024-10-10",0,0,0,0,0,0,0,0
"Guadeloupe","2024-10-11",0,0,0,0,0,0,0,0
"Guadeloupe","2024-10-12",0,0,0,0,0,0,0,0
"Guadeloupe","2024-10-13",0,0,0,0,0,0,0,0
"Guadeloupe","2024-10-14",0,0,0,0,0,0,0,0
"Guadeloupe","2024-10-15",0,0,0,0,0,0,0,0
"Guadeloupe","2024-10-16",0,0,0,0,0,0,0,0
"Guadeloupe","2024-10-17",0,0,0,0,0,0,0,0
"Guadeloupe","2024-10-18",0,0,0,0,0,0,0,0
"Guadeloupe","2024-10-19",0,0,0,0,0,0,0,0
"Guadeloupe","2024-10-20",0,0,0,0,0,0,0,0
"Guadeloupe","2024-10-21",0,0,0,0,0,0,0,0
"Guadeloupe","2024-10-22",0,0,0,0,0,0,0,0
"Guadeloupe","2024-10-23",0,0,0,0,0,0,0,0
"Guadeloupe","2024-10-24",0,0,0,0,0,0,0,0
"Guadeloupe","2024-10-25",0,0,0,0,0,0,0,0
"Guadeloupe","2024-10-26",0,0,0,0,0,0,0,0
"Guadeloupe","2024-10-27",0,0,0,0,0,0,0,0
"Guadeloupe","2024-10-28",0,0,0,0,0,0,0,0
"Guadeloupe","2024-10-29",0,0,0,0,0,0,0,0
"Guadeloupe","2024-10-30",0,0,0,0,0,0,0,0
"Guadeloupe","2024-10-31",0,0,0,0,0,0,0,0
"Guadeloupe","2024-11-01",0,0,0,0,0,0,0,0
"Guadeloupe","2024-11-02",0,0,0,0,0,0,0,0
"Guadeloupe","2024-11-03",0,0,0,0,0,0,0,0
"Guadeloupe","2024-11-04",0,0,0,0,0,0,0,0
"Guadeloupe","2024-11-05",0,0,0,0,0,0,0,0
"Guadeloupe","2024-11-06",0,0,0,0,0,0,0,0
"Guadeloupe","2024-11-07",0,0,0,0,0,0,0,0
"Guadeloupe","2024-11-08",0,0,0,0,0,0,0,0
"Guadeloupe","2024-11-09",0,0,0,0,0,0,0,0
"Guadeloupe","2024-11-10",0,0,0,0,0,0,0,0
"Guadeloupe","2024-11-11",0,0,0,0,0,0,0,0
"Guadeloupe","2024-11-12",0,0,0,0,0,0,0,0
"Guadeloupe","2024-11-13",0,0,0,0,0,0,0,0
"Guadeloupe","2024-11-14",0,0,0,0,0,0,0,0
"Guadeloupe","2024-11-15",0,0,0,0,0,0,0,0
"Guadeloupe","2024-11-16",0,0,0,0,0,0,0,0
"Guadeloupe","2024-11-17",0,0,0,0,0,0,0,0
"Guadeloupe","2024-11-18",0,0,0,0,0,0,0,0
"Guadeloupe","2024-11-19",0,0,0,0,0,0,0,0
"Guadeloupe","2024-11-20",0,0,0,0,0,0,0,0
"Guadeloupe","2024-11-21",0,0,0,0,0,0,0,0
"Guadeloupe","2024-11-22",0,0,0,0,0,0,0,0
"Guadeloupe","2024-11-23",0,0,0,0,0,0,0,0
"Guadeloupe","2024-11-24",0,0,0,0,0,0,0,0
"Guadeloupe","2024-11-25",0,0,0,0,0,0,0,0
"Guadeloupe","2024-11-26",0,0,0,0,0,0,0,0
"Guadeloupe","2024-11-27",0,0,0,0,0,0,0,0
"Guadeloupe","2024-11-28",0,0,0,0,0,0,0,0
"Guadeloupe","2024-11-29",0,0,0,0,0,0,0,0
"Guadeloupe","2024-11-30",0,0,0,0,0,0,0,0
"Guadeloupe","2024-12-01",0,0,0,0,0,0,0,0
"Guadeloupe","2024-12-02",0,0,0,0,0,0,0,0
"Guadeloupe","2024-12-03",0,0,0,0,0,0,0,0
"Guadeloupe","2024-12-04",0,0,0,0,0,0,0,0
"Guadeloupe","2024-12-05",0,0,0,0,0,0,0,0
"Guadeloupe","2024-12-06",0,0,0,0,0,0,0,0
"Guadeloupe","2024-12-07",0,0,0,0,0,0,0,0
"Guadeloupe","2024-12-08",0,0,0,0,0,0,0,0
"Guadeloupe","2024-12-09",0,0,0,0,0,0,0,0
"Guadeloupe","2024-12-10",0,0,0,0,0,0,0,0
"Guadeloupe","2024-12-11",0,0,0,0,0,0,0,0
"Guadeloupe","2024-12-12",0,0,0,0,0,0,0,0
"Guadeloupe","2024-12-13",0,0,0,0,0,0,0,0
"Guadeloupe","2024-12-14",0,0,0,0,0,0,0,0
"Guadeloupe","2024-12-15",0,0,0,0,0,0,0,0
"Guadeloupe","2024-12-16",0,0,0,0,0,0,0,0
"Guadeloupe","2024-12-17",0,0,0,0,0,0,0,0
"Guadeloupe","2024-12-18",0,0,0,0,0,0,0,0
"Guadeloupe","2024-12-19",0,0,0,0,0,0,0,0
"Guadeloupe","2024-12-20",0,0,0,0,0,0,0,0
"Guadeloupe","2024-12-21",0,0,0,0,0,0,0,0
"Guadeloupe","2024-12-22",0,0,0,0,0,0,0,0
"Guadeloupe","2024-12-23",0,0,0,0,0,0,0,0
"Guadeloupe","2024-12-24",0,0,0,0,0,0,0,0
"Guadeloupe","2024-12-25",0,0,0,0,0,0,0,0
"Guadeloupe","2024-12-26",0,0,0,0,0,0,0,0
"Guadeloupe","2024-12-27",0,0,0,0,0,0,0,0
"Guadeloupe","2024-12-28",0,0,0,0,0,0,0,0
"Guadeloupe","2024-12-29",0,0,0,0,0,0,0,0
"Guadeloupe","2024-12-30",0,0,0,0,0,0,0,0
"Guadeloupe","2024-12-31",0,0,0,0,0,0,0,0
"Guadeloupe","2025-01-01",0,0,0,0,0,0,0,0
"Guadeloupe","2025-01-02",0,0,0,0,0,0,0,0
"Guadeloupe","2025-01-03",0,0,0,0,0,0,0,0
"Guadeloupe","2025-01-04",0,0,0,0,0,0,0,0
"Guadeloupe","2025-01-05",0,0,0,0,0,0,0,0
"Guadeloupe","2025-01-06",0,0,0,0,0,0,0,0
"Guadeloupe","2025-01-07",0,0,0,0,0,0,0,0
"Guadeloupe","2025-01-08",0,0,0,0,0,0,0,0
"Guadeloupe","2025-01-09",0,0,0,0,0,0,0,0
"Guadeloupe","2025-01-10",0,0,0,0,0,0,0,0
"Guadeloupe","2025-01-11",0,0,0,0,0,0,0,0
"Guadeloupe","2025-01-12",0,0,0,0,0,0,0,0
"Guadeloupe","2025-01-13",0,0,0,0,0,0,0,0
"Guatemala","2024-01-01",0,0,0,0,0,0,0,0
"Guatemala","2024-01-02",0,0,0,0,0,0,0,0
"Guatemala","2024-01-03",0,0,0,0,0,0,0,0
"Guatemala","2024-01-04",0,0,0,0,0,0,0,0
"Guatemala","2024-01-05",0,0,0,0,0,0,0,0
"Guatemala","2024-01-06",0,0,0,0,0,0,0,0
"Guatemala","2024-01-07",0,0,0,0,0,0,0,0
"Guatemala","2024-01-08",0,0,0,0,0,0,0,0
"Guatemala","2024-01-09",0,0,0,0,0,0,0,0
"Guatemala","2024-01-10",0,0,0,0,0,0,0,0
"Guatemala","2024-01-11",0,0,0,0,0,0,0,0
"Guatemala","2024-01-12",0,0,0,0,0,0,0,0
"Guatemala","2024-01-13",0,0,0,0,0,0,0,0
"Guatemala","2024-01-14",0,0,0,0,0,0,0,0
"Guatemala","2024-01-15",0,0,0,0,0,0,0,0
"Guatemala","2024-01-16",0,1,1,0,1,1,0,0
"Guatemala","2024-01-17",0,0,1,0,0,1,0,0
"Guatemala","2024-01-18",0,0,1,0,0,1,0,0
"Guatemala","2024-01-19",0,0,1,0,0,1,0,0
"Guatemala","2024-01-20",0,0,1,0,0,1,0,0
"Guatemala","2024-01-21",0,0,1,0,0,1,0,0
"Guatemala","2024-01-22",0,0,1,0,0,1,0,0
"Guatemala","2024-01-23",0,0,1,0,0,1,0,0
"Guatemala","2024-01-24",0,0,1,0,0,1,0,0
"Guatemala","2024-01-25",0,0,1,0,0,1,0,0
"Guatemala","2024-01-26",0,0,1,0,0,1,0,0
"Guatemala","2024-01-27",0,0,1,0,0,1,0,0
"Guatemala","2024-01-28",0,0,1,0,0,1,0,0
"Guatemala","2024-01-29",0,0,1,0,0,1,0,0
"Guatemala","2024-01-30",0,0,1,0,0,1,0,0
"Guatemala","2024-01-31",0,0,1,0,0,1,0,0
"Guatemala","2024-02-01",0,0,1,0,0,1,0,0
"Guatemala","2024-02-02",0,0,1,0,0,1,0,0
"Guatemala","2024-02-03",0,0,1,0,0,1,0,0
"Guatemala","2024-02-04",0,0,1,0,0,1,0,0
"Guatemala","2024-02-05",0,0,1,0,0,1,0,0
"Guatemala","2024-02-06",0,0,1,0,0,1,0,0
"Guatemala","2024-02-07",0,0,1,0,0,1,0,0
"Guatemala","2024-02-08",0,0,1,0,0,1,0,0
"Guatemala","2024-02-09",0,0,1,0,0,1,0,0
"Guatemala","2024-02-10",0,0,1,0,0,1,0,0
"Guatemala","2024-02-11",0,0,1,0,0,1,0,0
"Guatemala","2024-02-12",0,0,1,0,0,1,0,0
"Guatemala","2024-02-13",0,0,1,0,0,1,0,0
"Guatemala","2024-02-14",0,0,1,0,0,1,0,0
"Guatemala","2024-02-15",0,0,1,0,0,1,0,0
"Guatemala","2024-02-16",0,0,1,0,0,1,0,0
"Guatemala","2024-02-17",0,0,1,0,0,1,0,0
"Guatemala","2024-02-18",0,0,1,0,0,1,0,0
"Guatemala","2024-02-19",0,0,1,0,0,1,0,0
"Guatemala","2024-02-20",0,0,1,0,0,1,0,0
"Guatemala","2024-02-21",0,0,1,0,0,1,0,0
"Guatemala","2024-02-22",0,0,1,0,0,1,0,0
"Guatemala","2024-02-23",0,0,1,0,0,1,0,0
"Guatemala","2024-02-24",0,0,1,0,0,1,0,0
"Guatemala","2024-02-25",0,0,1,0,0,1,0,0
"Guatemala","2024-02-26",0,0,1,0,0,1,0,0
"Guatemala","2024-02-27",0,0,1,0,0,1,0,0
"Guatemala","2024-02-28",0,0,1,0,0,1,0,0
"Guatemala","2024-02-29",0,0,1,0,0,1,0,0
"Guatemala","2024-03-01",0,0,1,0,0,1,0,0
"Guatemala","2024-03-02",0,0,1,0,1,2,0,0
"Guatemala","2024-03-03",0,0,1,0,0,2,0,0
"Guatemala","2024-03-04",0,0,1,0,0,2,0,0
"Guatemala","2024-03-05",0,0,1,0,0,2,0,0
"Guatemala","2024-03-06",0,0,1,0,0,2,0,0
"Guatemala","2024-03-07",0,0,1,0,0,2,0,0
"Guatemala","2024-03-08",0,0,1,0,0,2,0,0
"Guatemala","2024-03-09",0,0,1,0,0,2,0,0
"Guatemala","2024-03-10",0,0,1,0,0,2,0,0
"Guatemala","2024-03-11",0,0,1,0,0,2,0,0
"Guatemala","2024-03-12",0,0,1,0,0,2,0,0
"Guatemala","2024-03-13",0,0,1,0,0,2,0,0
"Guatemala","2024-03-14",0,0,1,0,0,2,0,0
"Guatemala","2024-03-15",0,0,1,0,0,2,0,0
"Guatemala","2024-03-16",0,0,1,0,0,2,0,0
"Guatemala","2024-03-17",0,0,1,0,0,2,0,0
"Guatemala","2024-03-18",0,0,1,0,0,2,0,0
"Guatemala","2024-03-19",0,0,1,0,0,2,0,0
"Guatemala","2024-03-20",0,0,1,0,0,2,0,0
"Guatemala","2024-03-21",0,0,1,0,0,2,0,0
"Guatemala","2024-03-22",0,0,1,0,0,2,0,0
"Guatemala","2024-03-23",0,0,1,0,0,2,0,0
"Guatemala","2024-03-24",0,0,1,0,0,2,0,0
"Guatemala","2024-03-25",0,0,1,0,0,2,0,0
"Guatemala","2024-03-26",0,0,1,0,0,2,0,0
"Guatemala","2024-03-27",0,0,1,0,0,2,0,0
"Guatemala","2024-03-28",0,0,1,0,0,2,0,0
"Guatemala","2024-03-29",0,0,1,0,0,2,0,0
"Guatemala","2024-03-30",0,0,1,0,0,2,0,0
"Guatemala","2024-03-31",0,0,1,0,0,2,0,0
"Guatemala","2024-04-01",0,0,1,0,0,2,0,0
"Guatemala","2024-04-02",0,0,1,0,0,2,0,0
"Guatemala","2024-04-03",0,0,1,0,0,2,0,0
"Guatemala","2024-04-04",0,0,1,0,0,2,0,0
"Guatemala","2024-04-05",0,0,1,0,0,2,0,0
"Guatemala","2024-04-06",0,0,1,0,0,2,0,0
"Guatemala","2024-04-07",0,0,1,0,0,2,0,0
"Guatemala","2024-04-08",0,0,1,0,0,2,0,0
"Guatemala","2024-04-09",0,0,1,0,0,2,0,0
"Guatemala","2024-04-10",0,0,1,0,0,2,0,0
"Guatemala","2024-04-11",0,0,1,0,0,2,0,0
"Guatemala","2024-04-12",0,0,1,0,0,2,0,0
"Guatemala","2024-04-13",0,0,1,0,0,2,0,0
"Guatemala","2024-04-14",0,0,1,0,0,2,0,0
"Guatemala","2024-04-15",0,0,1,0,0,2,0,0
"Guatemala","2024-04-16",0,1,2,0,0,2,0,0
"Guatemala","2024-04-17",0,0,2,0,0,2,0,0
"Guatemala","2024-04-18",0,0,2,0,0,2,0,0
"Guatemala","2024-04-19",0,0,2,0,0,2,0,0
"Guatemala","2024-04-20",0,0,2,0,0,2,0,0
"Guatemala","2024-04-21",0,0,2,0,0,2,0,0
"Guatemala","2024-04-22",0,0,2,0,0,2,0,0
"Guatemala","2024-04-23",0,0,2,0,0,2,0,0
"Guatemala","2024-04-24",0,0,2,0,0,2,0,0
"Guatemala","2024-04-25",0,0,2,0,0,2,0,0
"Guatemala","2024-04-26",0,0,2,0,0,2,0,0
"Guatemala","2024-04-27",0,0,2,0,0,2,0,0
"Guatemala","2024-04-28",0,0,2,0,0,2,0,0
"Guatemala","2024-04-29",0,0,2,0,0,2,0,0
"Guatemala","2024-04-30",0,0,2,0,0,2,0,0
"Guatemala","2024-05-01",0,0,2,0,0,2,0,0
"Guatemala","2024-05-02",0,0,2,0,0,2,0,0
"Guatemala","2024-05-03",0,0,2,0,0,2,0,0
"Guatemala","2024-05-04",0,0,2,0,0,2,0,0
"Guatemala","2024-05-05",0,0,2,0,0,2,0,0
"Guatemala","2024-05-06",0,0,2,0,0,2,0,0
"Guatemala","2024-05-07",0,0,2,0,0,2,0,0
"Guatemala","2024-05-08",0,0,2,0,0,2,0,0
"Guatemala","2024-05-09",0,0,2,0,0,2,0,0
"Guatemala","2024-05-10",0,0,2,0,0,2,0,0
"Guatemala","2024-05-11",0,0,2,0,0,2,0,0
"Guatemala","2024-05-12",0,0,2,0,0,2,0,0
"Guatemala","2024-05-13",0,0,2,0,0,2,0,0
"Guatemala","2024-05-14",0,0,2,0,0,2,0,0
"Guatemala","2024-05-15",0,0,2,0,0,2,0,0
"Guatemala","2024-05-16",0,0,2,0,0,2,0,0
"Guatemala","2024-05-17",0,0,2,0,0,2,0,0
"Guatemala","2024-05-18",0,0,2,0,0,2,0,0
"Guatemala","2024-05-19",0,0,2,0,0,2,0,0
"Guatemala","2024-05-20",0,0,2,0,0,2,0,0
"Guatemala","2024-05-21",0,0,2,0,0,2,0,0
"Guatemala","2024-05-22",0,0,2,0,0,2,0,0
"Guatemala","2024-05-23",0,0,2,0,0,2,0,0
"Guatemala","2024-05-24",0,0,2,0,0,2,0,0
"Guatemala","2024-05-25",0,0,2,0,0,2,0,0
"Guatemala","2024-05-26",0,0,2,0,0,2,0,0
"Guatemala","2024-05-27",0,0,2,0,0,2,0,0
"Guatemala","2024-05-28",0,0,2,0,0,2,0,0
"Guatemala","2024-05-29",0,0,2,0,0,2,0,0
"Guatemala","2024-05-30",0,0,2,0,0,2,0,0
"Guatemala","2024-05-31",0,0,2,0,0,2,0,0
"Guatemala","2024-06-01",0,0,2,0,0,2,0,0
"Guatemala","2024-06-02",0,0,2,0,0,2,0,0
"Guatemala","2024-06-03",0,0,2,0,0,2,0,0
"Guatemala","2024-06-04",0,0,2,0,0,2,0,0
"Guatemala","2024-06-05",0,0,2,0,0,2,0,0
"Guatemala","2024-06-06",0,0,2,0,0,2,0,0
"Guatemala","2024-06-07",0,0,2,0,0,2,0,0
"Guatemala","2024-06-08",0,0,2,0,0,2,0,0
"Guatemala","2024-06-09",0,0,2,0,0,2,0,0
"Guatemala","2024-06-10",0,0,2,0,0,2,0,0
"Guatemala","2024-06-11",0,0,2,0,0,2,0,0
"Guatemala","2024-06-12",0,0,2,0,0,2,0,0
"Guatemala","2024-06-13",0,0,2,0,0,2,0,0
"Guatemala","2024-06-14",0,0,2,0,0,2,0,0
"Guatemala","2024-06-15",0,0,2,0,0,2,0,0
"Guatemala","2024-06-16",0,0,2,0,0,2,0,0
"Guatemala","2024-06-17",0,0,2,0,0,2,0,0
"Guatemala","2024-06-18",0,0,2,0,0,2,0,0
"Guatemala","2024-06-19",0,0,2,0,0,2,0,0
"Guatemala","2024-06-20",0,0,2,0,0,2,0,0
"Guatemala","2024-06-21",0,0,2,0,0,2,0,0
"Guatemala","2024-06-22",0,0,2,0,0,2,0,0
"Guatemala","2024-06-23",0,0,2,0,0,2,0,0
"Guatemala","2024-06-24",0,0,2,0,0,2,0,0
"Guatemala","2024-06-25",0,0,2,0,0,2,0,0
"Guatemala","2024-06-26",0,0,2,0,0,2,0,0
"Guatemala","2024-06-27",0,0,2,0,0,2,0,0
"Guatemala","2024-06-28",0,0,2,0,0,2,0,0
"Guatemala","2024-06-29",0,0,2,0,0,2,0,0
"Guatemala","2024-06-30",0,0,2,0,0,2,0,0
"Guatemala","2024-07-01",0,0,2,0,0,2,0,0
"Guatemala","2024-07-02",0,0,2,0,0,2,0,0
"Guatemala","2024-07-03",0,0,2,0,0,2,0,0
"Guatemala","2024-07-04",0,0,2,0,0,2,0,0
"Guatemala","2024-07-05",0,0,2,0,0,2,0,0
"Guatemala","2024-07-06",0,0,2,0,0,2,0,0
"Guatemala","2024-07-07",0,0,2,0,0,2,0,0
"Guatemala","2024-07-08",0,0,2,0,0,2,0,0
"Guatemala","2024-07-09",0,0,2,0,0,2,0,0
"Guatemala","2024-07-10",0,0,2,0,0,2,0,0
"Guatemala","2024-07-11",0,0,2,0,0,2,0,0
"Guatemala","2024-07-12",0,0,2,0,0,2,0,0
"Guatemala","2024-07-13",0,0,2,0,0,2,0,0
"Guatemala","2024-07-14",0,0,2,0,0,2,0,0
"Guatemala","2024-07-15",0,0,2,0,0,2,0,0
"Guatemala","2024-07-16",0,0,2,0,0,2,0,0
"Guatemala","2024-07-17",0,0,2,0,0,2,0,0
"Guatemala","2024-07-18",0,0,2,0,0,2,0,0
"Guatemala","2024-07-19",0,0,2,0,0,2,0,0
"Guatemala","2024-07-20",0,0,2,0,1,3,0,0
"Guatemala","2024-07-21",0,0,2,0,0,3,0,0
"Guatemala","2024-07-22",0,0,2,0,0,3,0,0
"Guatemala","2024-07-23",0,0,2,0,0,3,0,0
"Guatemala","2024-07-24",0,0,2,0,0,3,0,0
"Guatemala","2024-07-25",0,0,2,0,0,3,0,0
"Guatemala","2024-07-26",0,0,2,0,0,3,0,0
"Guatemala","2024-07-27",0,0,2,0,0,3,0,0
"Guatemala","2024-07-28",0,0,2,0,0,3,0,0
"Guatemala","2024-07-29",0,0,2,0,0,3,0,0
"Guatemala","2024-07-30",0,0,2,0,0,3,0,0
"Guatemala","2024-07-31",0,0,2,0,0,3,0,0
"Guatemala","2024-08-01",0,0,2,0,0,3,0,0
"Guatemala","2024-08-02",0,0,2,0,0,3,0,0
"Guatemala","2024-08-03",0,0,2,0,0,3,0,0
"Guatemala","2024-08-04",0,0,2,0,0,3,0,0
"Guatemala","2024-08-05",0,0,2,0,0,3,0,0
"Guatemala","2024-08-06",0,0,2,0,0,3,0,0
"Guatemala","2024-08-07",0,0,2,0,0,3,0,0
"Guatemala","2024-08-08",0,0,2,0,0,3,0,0
"Guatemala","2024-08-09",0,0,2,0,0,3,0,0
"Guatemala","2024-08-10",0,0,2,0,0,3,0,0
"Guatemala","2024-08-11",0,0,2,0,0,3,0,0
"Guatemala","2024-08-12",0,0,2,0,0,3,0,0
"Guatemala","2024-08-13",0,0,2,0,0,3,0,0
"Guatemala","2024-08-14",0,0,2,0,0,3,0,0
"Guatemala","2024-08-15",0,0,2,0,0,3,0,0
"Guatemala","2024-08-16",0,0,2,0,0,3,0,0
"Guatemala","2024-08-17",0,0,2,0,0,3,0,0
"Guatemala","2024-08-18",0,0,2,0,0,3,0,0
"Guatemala","2024-08-19",0,0,2,0,0,3,0,0
"Guatemala","2024-08-20",0,0,2,0,0,3,0,0
"Guatemala","2024-08-21",0,0,2,0,0,3,0,0
"Guatemala","2024-08-22",0,0,2,0,0,3,0,0
"Guatemala","2024-08-23",0,0,2,0,0,3,0,0
"Guatemala","2024-08-24",0,0,2,0,0,3,0,0
"Guatemala","2024-08-25",0,0,2,0,0,3,0,0
"Guatemala","2024-08-26",0,0,2,0,0,3,0,0
"Guatemala","2024-08-27",0,0,2,0,0,3,0,0
"Guatemala","2024-08-28",0,0,2,0,0,3,0,0
"Guatemala","2024-08-29",0,0,2,0,0,3,0,0
"Guatemala","2024-08-30",0,0,2,0,0,3,0,0
"Guatemala","2024-08-31",0,0,2,0,0,3,0,0
"Guatemala","2024-09-01",0,0,2,0,0,3,0,0
"Guatemala","2024-09-02",0,0,2,0,0,3,0,0
"Guatemala","2024-09-03",0,0,2,0,0,3,0,0
"Guatemala","2024-09-04",0,0,2,0,0,3,0,0
"Guatemala","2024-09-05",0,0,2,0,0,3,0,0
"Guatemala","2024-09-06",0,0,2,0,0,3,0,0
"Guatemala","2024-09-07",0,0,2,0,0,3,0,0
"Guatemala","2024-09-08",0,0,2,0,0,3,0,0
"Guatemala","2024-09-09",0,0,2,0,0,3,0,0
"Guatemala","2024-09-10",0,0,2,0,0,3,0,0
"Guatemala","2024-09-11",0,0,2,0,0,3,0,0
"Guatemala","2024-09-12",0,0,2,0,0,3,0,0
"Guatemala","2024-09-13",0,0,2,0,0,3,0,0
"Guatemala","2024-09-14",0,0,2,0,0,3,0,0
"Guatemala","2024-09-15",0,0,2,0,0,3,0,0
"Guatemala","2024-09-16",0,0,2,0,0,3,0,0
"Guatemala","2024-09-17",0,0,2,0,0,3,0,0
"Guatemala","2024-09-18",0,0,2,0,0,3,0,0
"Guatemala","2024-09-19",0,0,2,0,0,3,0,0
"Guatemala","2024-09-20",0,0,2,0,0,3,0,0
"Guatemala","2024-09-21",0,0,2,0,0,3,0,0
"Guatemala","2024-09-22",0,0,2,0,0,3,0,0
"Guatemala","2024-09-23",0,0,2,0,0,3,0,0
"Guatemala","2024-09-24",0,0,2,0,0,3,0,0
"Guatemala","2024-09-25",0,0,2,0,0,3,0,0
"Guatemala","2024-09-26",0,0,2,0,0,3,0,0
"Guatemala","2024-09-27",0,0,2,0,0,3,0,0
"Guatemala","2024-09-28",0,0,2,0,0,3,0,0
"Guatemala","2024-09-29",0,0,2,0,0,3,0,0
"Guatemala","2024-09-30",0,0,2,0,0,3,0,0
"Guatemala","2024-10-01",0,0,2,0,0,3,0,0
"Guatemala","2024-10-02",0,0,2,0,0,3,0,0
"Guatemala","2024-10-03",0,0,2,0,0,3,0,0
"Guatemala","2024-10-04",0,0,2,0,0,3,0,0
"Guatemala","2024-10-05",0,0,2,0,0,3,0,0
"Guatemala","2024-10-06",0,0,2,0,0,3,0,0
"Guatemala","2024-10-07",0,0,2,0,0,3,0,0
"Guatemala","2024-10-08",0,0,2,0,0,3,0,0
"Guatemala","2024-10-09",0,0,2,0,0,3,0,0
"Guatemala","2024-10-10",0,0,2,0,0,3,0,0
"Guatemala","2024-10-11",0,0,2,0,0,3,0,0
"Guatemala","2024-10-12",0,0,2,0,0,3,0,0
"Guatemala","2024-10-13",0,0,2,0,0,3,0,0
"Guatemala","2024-10-14",0,0,2,0,0,3,0,0
"Guatemala","2024-10-15",0,0,2,0,0,3,0,0
"Guatemala","2024-10-16",0,0,2,0,0,3,0,0
"Guatemala","2024-10-17",0,0,2,0,0,3,0,0
"Guatemala","2024-10-18",0,0,2,0,0,3,0,0
"Guatemala","2024-10-19",0,0,2,0,0,3,0,0
"Guatemala","2024-10-20",0,0,2,0,0,3,0,0
"Guatemala","2024-10-21",0,0,2,0,0,3,0,0
"Guatemala","2024-10-22",0,1,3,0,0,3,0,0
"Guatemala","2024-10-23",0,0,3,0,0,3,0,0
"Guatemala","2024-10-24",0,0,3,0,0,3,0,0
"Guatemala","2024-10-25",0,0,3,0,0,3,0,0
"Guatemala","2024-10-26",0,0,3,0,0,3,0,0
"Guatemala","2024-10-27",0,0,3,0,0,3,0,0
"Guatemala","2024-10-28",0,0,3,0,0,3,0,0
"Guatemala","2024-10-29",0,0,3,0,0,3,0,0
"Guatemala","2024-10-30",0,0,3,0,0,3,0,0
"Guatemala","2024-10-31",0,0,3,0,0,3,0,0
"Guatemala","2024-11-01",0,0,3,0,0,3,0,0
"Guatemala","2024-11-02",0,0,3,0,0,3,0,0
"Guatemala","2024-11-03",0,0,3,0,0,3,0,0
"Guatemala","2024-11-04",0,0,3,0,0,3,0,0
"Guatemala","2024-11-05",0,0,3,0,0,3,0,0
"Guatemala","2024-11-06",0,0,3,0,0,3,0,0
"Guatemala","2024-11-07",0,0,3,0,0,3,0,0
"Guatemala","2024-11-08",0,0,3,0,0,3,0,0
"Guatemala","2024-11-09",0,0,3,0,0,3,0,0
"Guatemala","2024-11-10",0,0,3,0,0,3,0,0
"Guatemala","2024-11-11",0,0,3,0,0,3,0,0
"Guatemala","2024-11-12",0,0,3,0,0,3,0,0
"Guatemala","2024-11-13",0,0,3,0,0,3,0,0
"Guatemala","2024-11-14",0,0,3,0,0,3,0,0
"Guatemala","2024-11-15",0,0,3,0,0,3,0,0
"Guatemala","2024-11-16",0,0,3,0,0,3,0,0
"Guatemala","2024-11-17",0,0,3,0,0,3,0,0
"Guatemala","2024-11-18",0,0,3,0,0,3,0,0
"Guatemala","2024-11-19",0,0,3,0,0,3,0,0
"Guatemala","2024-11-20",0,0,3,0,0,3,0,0
"Guatemala","2024-11-21",0,0,3,0,0,3,0,0
"Guatemala","2024-11-22",0,0,3,0,0,3,0,0
"Guatemala","2024-11-23",0,0,3,0,0,3,0,0
"Guatemala","2024-11-24",0,0,3,0,0,3,0,0
"Guatemala","2024-11-25",0,0,3,0,0,3,0,0
"Guatemala","2024-11-26",0,0,3,0,0,3,0,0
"Guatemala","2024-11-27",0,0,3,0,0,3,0,0
"Guatemala","2024-11-28",0,0,3,0,0,3,0,0
"Guatemala","2024-11-29",0,0,3,0,0,3,0,0
"Guatemala","2024-11-30",0,0,3,0,0,3,0,0
"Guatemala","2024-12-01",0,0,3,0,0,3,0,0
"Guatemala","2024-12-02",0,0,3,0,0,3,0,0
"Guatemala","2024-12-03",0,0,3,0,0,3,0,0
"Guatemala","2024-12-04",0,0,3,0,0,3,0,0
"Guatemala","2024-12-05",0,0,3,0,0,3,0,0
"Guatemala","2024-12-06",0,0,3,0,0,3,0,0
"Guatemala","2024-12-07",0,0,3,0,0,3,0,0
"Guatemala","2024-12-08",0,0,3,0,0,3,0,0
"Guatemala","2024-12-09",0,0,3,0,0,3,0,0
"Guatemala","2024-12-10",0,0,3,0,0,3,0,0
"Guatemala","2024-12-11",0,0,3,0,0,3,0,0
"Guatemala","2024-12-12",0,0,3,0,0,3,0,0
"Guatemala","2024-12-13",0,0,3,0,0,3,0,0
"Guatemala","2024-12-14",0,0,3,0,0,3,0,0
"Guatemala","2024-12-15",0,0,3,0,0,3,0,0
"Guatemala","2024-12-16",0,0,3,0,0,3,0,0
"Guatemala","2024-12-17",0,0,3,0,0,3,0,0
"Guatemala","2024-12-18",0,0,3,0,0,3,0,0
"Guatemala","2024-12-19",0,0,3,0,0,3,0,0
"Guatemala","2024-12-20",0,0,3,0,0,3,0,0
"Guatemala","2024-12-21",0,0,3,0,0,3,0,0
"Guatemala","2024-12-22",0,0,3,0,0,3,0,0
"Guatemala","2024-12-23",0,0,3,0,0,3,0,0
"Guatemala","2024-12-24",0,0,3,0,0,3,0,0
"Guatemala","2024-12-25",0,0,3,0,0,3,0,0
"Guatemala","2024-12-26",0,0,3,0,0,3,0,0
"Guatemala","2024-12-27",0,0,3,0,0,3,0,0
"Guatemala","2024-12-28",0,0,3,0,0,3,0,0
"Guatemala","2024-12-29",0,0,3,0,0,3,0,0
"Guatemala","2024-12-30",0,0,3,0,0,3,0,0
"Guatemala","2024-12-31",0,0,3,0,0,3,0,0
"Guatemala","2025-01-01",0,0,3,0,0,3,0,0
"Guatemala","2025-01-02",0,0,3,0,0,3,0,0
"Guatemala","2025-01-03",0,0,3,0,0,3,0,0
"Guatemala","2025-01-04",0,0,3,0,0,3,0,0
"Guatemala","2025-01-05",0,0,3,0,0,3,0,0
"Guatemala","2025-01-06",0,0,3,0,0,3,0,0
"Guatemala","2025-01-07",0,0,3,0,0,3,0,0
"Guatemala","2025-01-08",0,0,3,0,0,3,0,0
"Guatemala","2025-01-09",0,0,3,0,0,3,0,0
"Guatemala","2025-01-10",0,0,3,0,0,3,0,0
"Guatemala","2025-01-11",0,0,3,0,0,3,0,0
"Guatemala","2025-01-12",0,0,3,0,0,3,0,0
"Guatemala","2025-01-13",0,0,3,0,0,3,0,0
"Guinea","2024-01-01",0,0,0,0,0,0,0,0
"Guinea","2024-01-02",0,0,0,0,0,0,0,0
"Guinea","2024-01-03",0,0,0,0,0,0,0,0
"Guinea","2024-01-04",0,0,0,0,0,0,0,0
"Guinea","2024-01-05",0,0,0,0,0,0,0,0
"Guinea","2024-01-06",0,0,0,0,0,0,0,0
"Guinea","2024-01-07",0,0,0,0,0,0,0,0
"Guinea","2024-01-08",0,0,0,0,0,0,0,0
"Guinea","2024-01-09",0,0,0,0,0,0,0,0
"Guinea","2024-01-10",0,0,0,0,0,0,0,0
"Guinea","2024-01-11",0,0,0,0,0,0,0,0
"Guinea","2024-01-12",0,0,0,0,0,0,0,0
"Guinea","2024-01-13",0,0,0,0,0,0,0,0
"Guinea","2024-01-14",0,0,0,0,0,0,0,0
"Guinea","2024-01-15",0,0,0,0,0,0,0,0
"Guinea","2024-01-16",0,0,0,0,0,0,0,0
"Guinea","2024-01-17",0,0,0,0,0,0,0,0
"Guinea","2024-01-18",0,0,0,0,0,0,0,0
"Guinea","2024-01-19",0,0,0,0,0,0,0,0
"Guinea","2024-01-20",0,0,0,0,0,0,0,0
"Guinea","2024-01-21",0,0,0,0,0,0,0,0
"Guinea","2024-01-22",0,0,0,0,0,0,0,0
"Guinea","2024-01-23",0,0,0,0,0,0,0,0
"Guinea","2024-01-24",0,0,0,0,0,0,0,0
"Guinea","2024-01-25",0,0,0,0,0,0,0,0
"Guinea","2024-01-26",0,0,0,0,0,0,0,0
"Guinea","2024-01-27",0,0,0,0,0,0,0,0
"Guinea","2024-01-28",0,0,0,0,0,0,0,0
"Guinea","2024-01-29",0,0,0,0,0,0,0,0
"Guinea","2024-01-30",0,0,0,0,0,0,0,0
"Guinea","2024-01-31",0,0,0,0,0,0,0,0
"Guinea","2024-02-01",0,0,0,0,0,0,0,0
"Guinea","2024-02-02",0,0,0,0,0,0,0,0
"Guinea","2024-02-03",0,0,0,0,0,0,0,0
"Guinea","2024-02-04",0,0,0,0,0,0,0,0
"Guinea","2024-02-05",0,0,0,0,0,0,0,0
"Guinea","2024-02-06",0,0,0,0,0,0,0,0
"Guinea","2024-02-07",0,0,0,0,0,0,0,0
"Guinea","2024-02-08",0,0,0,0,0,0,0,0
"Guinea","2024-02-09",0,0,0,0,0,0,0,0
"Guinea","2024-02-10",0,0,0,0,0,0,0,0
"Guinea","2024-02-11",0,0,0,0,0,0,0,0
"Guinea","2024-02-12",0,0,0,0,0,0,0,0
"Guinea","2024-02-13",0,0,0,0,0,0,0,0
"Guinea","2024-02-14",0,0,0,0,0,0,0,0
"Guinea","2024-02-15",0,0,0,0,0,0,0,0
"Guinea","2024-02-16",0,0,0,0,0,0,0,0
"Guinea","2024-02-17",0,0,0,0,0,0,0,0
"Guinea","2024-02-18",0,0,0,0,0,0,0,0
"Guinea","2024-02-19",0,0,0,0,0,0,0,0
"Guinea","2024-02-20",0,0,0,0,0,0,0,0
"Guinea","2024-02-21",0,0,0,0,0,0,0,0
"Guinea","2024-02-22",0,0,0,0,0,0,0,0
"Guinea","2024-02-23",0,0,0,0,0,0,0,0
"Guinea","2024-02-24",0,0,0,0,0,0,0,0
"Guinea","2024-02-25",0,0,0,0,0,0,0,0
"Guinea","2024-02-26",0,0,0,0,0,0,0,0
"Guinea","2024-02-27",0,0,0,0,0,0,0,0
"Guinea","2024-02-28",0,0,0,0,0,0,0,0
"Guinea","2024-02-29",0,0,0,0,0,0,0,0
"Guinea","2024-03-01",0,0,0,0,0,0,0,0
"Guinea","2024-03-02",0,0,0,0,0,0,0,0
"Guinea","2024-03-03",0,0,0,0,0,0,0,0
"Guinea","2024-03-04",0,0,0,0,0,0,0,0
"Guinea","2024-03-05",0,0,0,0,0,0,0,0
"Guinea","2024-03-06",0,0,0,0,0,0,0,0
"Guinea","2024-03-07",0,0,0,0,0,0,0,0
"Guinea","2024-03-08",0,0,0,0,0,0,0,0
"Guinea","2024-03-09",0,0,0,0,0,0,0,0
"Guinea","2024-03-10",0,0,0,0,0,0,0,0
"Guinea","2024-03-11",0,0,0,0,0,0,0,0
"Guinea","2024-03-12",0,0,0,0,0,0,0,0
"Guinea","2024-03-13",0,0,0,0,0,0,0,0
"Guinea","2024-03-14",0,0,0,0,0,0,0,0
"Guinea","2024-03-15",0,0,0,0,0,0,0,0
"Guinea","2024-03-16",0,0,0,0,0,0,0,0
"Guinea","2024-03-17",0,0,0,0,0,0,0,0
"Guinea","2024-03-18",0,0,0,0,0,0,0,0
"Guinea","2024-03-19",0,0,0,0,0,0,0,0
"Guinea","2024-03-20",0,0,0,0,0,0,0,0
"Guinea","2024-03-21",0,0,0,0,0,0,0,0
"Guinea","2024-03-22",0,0,0,0,0,0,0,0
"Guinea","2024-03-23",0,0,0,0,0,0,0,0
"Guinea","2024-03-24",0,0,0,0,0,0,0,0
"Guinea","2024-03-25",0,0,0,0,0,0,0,0
"Guinea","2024-03-26",0,0,0,0,0,0,0,0
"Guinea","2024-03-27",0,0,0,0,0,0,0,0
"Guinea","2024-03-28",0,0,0,0,0,0,0,0
"Guinea","2024-03-29",0,0,0,0,0,0,0,0
"Guinea","2024-03-30",0,0,0,0,0,0,0,0
"Guinea","2024-03-31",0,0,0,0,0,0,0,0
"Guinea","2024-04-01",0,0,0,0,0,0,0,0
"Guinea","2024-04-02",0,0,0,0,0,0,0,0
"Guinea","2024-04-03",0,0,0,0,0,0,0,0
"Guinea","2024-04-04",0,0,0,0,0,0,0,0
"Guinea","2024-04-05",0,0,0,0,0,0,0,0
"Guinea","2024-04-06",0,0,0,0,0,0,0,0
"Guinea","2024-04-07",0,0,0,0,0,0,0,0
"Guinea","2024-04-08",0,0,0,0,0,0,0,0
"Guinea","2024-04-09",0,0,0,0,0,0,0,0
"Guinea","2024-04-10",0,0,0,0,0,0,0,0
"Guinea","2024-04-11",0,0,0,0,0,0,0,0
"Guinea","2024-04-12",0,0,0,0,0,0,0,0
"Guinea","2024-04-13",0,0,0,0,0,0,0,0
"Guinea","2024-04-14",0,0,0,0,0,0,0,0
"Guinea","2024-04-15",0,0,0,0,0,0,0,0
"Guinea","2024-04-16",0,0,0,0,0,0,0,0
"Guinea","2024-04-17",0,0,0,0,0,0,0,0
"Guinea","2024-04-18",0,0,0,0,0,0,0,0
"Guinea","2024-04-19",0,0,0,0,0,0,0,0
"Guinea","2024-04-20",0,0,0,0,0,0,0,0
"Guinea","2024-04-21",0,0,0,0,0,0,0,0
"Guinea","2024-04-22",0,0,0,0,0,0,0,0
"Guinea","2024-04-23",0,0,0,0,0,0,0,0
"Guinea","2024-04-24",0,0,0,0,0,0,0,0
"Guinea","2024-04-25",0,0,0,0,0,0,0,0
"Guinea","2024-04-26",0,0,0,0,0,0,0,0
"Guinea","2024-04-27",0,0,0,0,0,0,0,0
"Guinea","2024-04-28",0,0,0,0,0,0,0,0
"Guinea","2024-04-29",0,0,0,0,0,0,0,0
"Guinea","2024-04-30",0,0,0,0,0,0,0,0
"Guinea","2024-05-01",0,0,0,0,0,0,0,0
"Guinea","2024-05-02",0,0,0,0,0,0,0,0
"Guinea","2024-05-03",0,0,0,0,0,0,0,0
"Guinea","2024-05-04",0,0,0,0,0,0,0,0
"Guinea","2024-05-05",0,0,0,0,0,0,0,0
"Guinea","2024-05-06",0,0,0,0,0,0,0,0
"Guinea","2024-05-07",0,0,0,0,0,0,0,0
"Guinea","2024-05-08",0,0,0,0,0,0,0,0
"Guinea","2024-05-09",0,0,0,0,0,0,0,0
"Guinea","2024-05-10",0,0,0,0,0,0,0,0
"Guinea","2024-05-11",0,0,0,0,0,0,0,0
"Guinea","2024-05-12",0,0,0,0,0,0,0,0
"Guinea","2024-05-13",0,0,0,0,0,0,0,0
"Guinea","2024-05-14",0,0,0,0,0,0,0,0
"Guinea","2024-05-15",0,0,0,0,0,0,0,0
"Guinea","2024-05-16",0,0,0,0,0,0,0,0
"Guinea","2024-05-17",0,0,0,0,0,0,0,0
"Guinea","2024-05-18",0,0,0,0,0,0,0,0
"Guinea","2024-05-19",0,0,0,0,0,0,0,0
"Guinea","2024-05-20",0,0,0,0,0,0,0,0
"Guinea","2024-05-21",0,0,0,0,0,0,0,0
"Guinea","2024-05-22",0,0,0,0,0,0,0,0
"Guinea","2024-05-23",0,0,0,0,0,0,0,0
"Guinea","2024-05-24",0,0,0,0,0,0,0,0
"Guinea","2024-05-25",0,0,0,0,0,0,0,0
"Guinea","2024-05-26",0,0,0,0,0,0,0,0
"Guinea","2024-05-27",0,0,0,0,0,0,0,0
"Guinea","2024-05-28",0,0,0,0,0,0,0,0
"Guinea","2024-05-29",0,0,0,0,0,0,0,0
"Guinea","2024-05-30",0,0,0,0,0,0,0,0
"Guinea","2024-05-31",0,0,0,0,0,0,0,0
"Guinea","2024-06-01",0,0,0,0,0,0,0,0
"Guinea","2024-06-02",0,0,0,0,0,0,0,0
"Guinea","2024-06-03",0,0,0,0,0,0,0,0
"Guinea","2024-06-04",0,0,0,0,0,0,0,0
"Guinea","2024-06-05",0,0,0,0,0,0,0,0
"Guinea","2024-06-06",0,0,0,0,0,0,0,0
"Guinea","2024-06-07",0,0,0,0,0,0,0,0
"Guinea","2024-06-08",0,0,0,0,0,0,0,0
"Guinea","2024-06-09",0,0,0,0,0,0,0,0
"Guinea","2024-06-10",0,0,0,0,0,0,0,0
"Guinea","2024-06-11",0,0,0,0,0,0,0,0
"Guinea","2024-06-12",0,0,0,0,0,0,0,0
"Guinea","2024-06-13",0,0,0,0,0,0,0,0
"Guinea","2024-06-14",0,0,0,0,0,0,0,0
"Guinea","2024-06-15",0,0,0,0,0,0,0,0
"Guinea","2024-06-16",0,0,0,0,0,0,0,0
"Guinea","2024-06-17",0,0,0,0,0,0,0,0
"Guinea","2024-06-18",0,0,0,0,0,0,0,0
"Guinea","2024-06-19",0,0,0,0,0,0,0,0
"Guinea","2024-06-20",0,0,0,0,0,0,0,0
"Guinea","2024-06-21",0,0,0,0,0,0,0,0
"Guinea","2024-06-22",0,0,0,0,0,0,0,0
"Guinea","2024-06-23",0,0,0,0,0,0,0,0
"Guinea","2024-06-24",0,0,0,0,0,0,0,0
"Guinea","2024-06-25",0,0,0,0,0,0,0,0
"Guinea","2024-06-26",0,0,0,0,0,0,0,0
"Guinea","2024-06-27",0,0,0,0,0,0,0,0
"Guinea","2024-06-28",0,0,0,0,0,0,0,0
"Guinea","2024-06-29",0,0,0,0,0,0,0,0
"Guinea","2024-06-30",0,0,0,0,0,0,0,0
"Guinea","2024-07-01",0,0,0,0,0,0,0,0
"Guinea","2024-07-02",0,0,0,0,0,0,0,0
"Guinea","2024-07-03",0,0,0,0,0,0,0,0
"Guinea","2024-07-04",0,0,0,0,0,0,0,0
"Guinea","2024-07-05",0,0,0,0,0,0,0,0
"Guinea","2024-07-06",0,0,0,0,0,0,0,0
"Guinea","2024-07-07",0,0,0,0,0,0,0,0
"Guinea","2024-07-08",0,0,0,0,0,0,0,0
"Guinea","2024-07-09",0,0,0,0,0,0,0,0
"Guinea","2024-07-10",0,0,0,0,0,0,0,0
"Guinea","2024-07-11",0,0,0,0,0,0,0,0
"Guinea","2024-07-12",0,0,0,0,0,0,0,0
"Guinea","2024-07-13",0,0,0,0,0,0,0,0
"Guinea","2024-07-14",0,0,0,0,0,0,0,0
"Guinea","2024-07-15",0,0,0,0,0,0,0,0
"Guinea","2024-07-16",0,0,0,0,0,0,0,0
"Guinea","2024-07-17",0,0,0,0,0,0,0,0
"Guinea","2024-07-18",0,0,0,0,0,0,0,0
"Guinea","2024-07-19",0,0,0,0,0,0,0,0
"Guinea","2024-07-20",0,0,0,0,0,0,0,0
"Guinea","2024-07-21",0,0,0,0,0,0,0,0
"Guinea","2024-07-22",0,0,0,0,0,0,0,0
"Guinea","2024-07-23",0,0,0,0,0,0,0,0
"Guinea","2024-07-24",0,0,0,0,0,0,0,0
"Guinea","2024-07-25",0,0,0,0,0,0,0,0
"Guinea","2024-07-26",0,0,0,0,0,0,0,0
"Guinea","2024-07-27",0,0,0,0,0,0,0,0
"Guinea","2024-07-28",0,0,0,0,0,0,0,0
"Guinea","2024-07-29",0,0,0,0,0,0,0,0
"Guinea","2024-07-30",0,0,0,0,0,0,0,0
"Guinea","2024-07-31",0,0,0,0,0,0,0,0
"Guinea","2024-08-01",0,0,0,0,0,0,0,0
"Guinea","2024-08-02",0,0,0,0,0,0,0,0
"Guinea","2024-08-03",0,0,0,0,0,0,0,0
"Guinea","2024-08-04",0,0,0,0,0,0,0,0
"Guinea","2024-08-05",0,0,0,0,0,0,0,0
"Guinea","2024-08-06",0,0,0,0,0,0,0,0
"Guinea","2024-08-07",0,0,0,0,0,0,0,0
"Guinea","2024-08-08",0,0,0,0,0,0,0,0
"Guinea","2024-08-09",0,0,0,0,0,0,0,0
"Guinea","2024-08-10",0,0,0,0,0,0,0,0
"Guinea","2024-08-11",0,0,0,0,0,0,0,0
"Guinea","2024-08-12",0,0,0,0,0,0,0,0
"Guinea","2024-08-13",0,0,0,0,0,0,0,0
"Guinea","2024-08-14",0,0,0,0,0,0,0,0
"Guinea","2024-08-15",0,0,0,0,0,0,0,0
"Guinea","2024-08-16",0,0,0,0,0,0,0,0
"Guinea","2024-08-17",0,0,0,0,0,0,0,0
"Guinea","2024-08-18",0,0,0,0,0,0,0,0
"Guinea","2024-08-19",0,0,0,0,0,0,0,0
"Guinea","2024-08-20",0,0,0,0,0,0,0,0
"Guinea","2024-08-21",0,0,0,0,0,0,0,0
"Guinea","2024-08-22",0,0,0,0,0,0,0,0
"Guinea","2024-08-23",0,0,0,0,0,0,0,0
"Guinea","2024-08-24",0,0,0,0,0,0,0,0
"Guinea","2024-08-25",0,0,0,0,0,0,0,0
"Guinea","2024-08-26",0,0,0,0,0,0,0,0
"Guinea","2024-08-27",0,0,0,0,0,0,0,0
"Guinea","2024-08-28",0,0,0,0,0,0,0,0
"Guinea","2024-08-29",0,0,0,0,0,0,0,0
"Guinea","2024-08-30",0,0,0,0,0,0,0,0
"Guinea","2024-08-31",0,0,0,0,0,0,0,0
"Guinea","2024-09-01",0,1,1,0,1,1,0,0
"Guinea","2024-09-02",0,0,1,0,0,1,0,0
"Guinea","2024-09-03",0,0,1,0,0,1,0,0
"Guinea","2024-09-04",0,0,1,0,0,1,0,0
"Guinea","2024-09-05",0,0,1,0,0,1,0,0
"Guinea","2024-09-06",0,0,1,0,0,1,0,0
"Guinea","2024-09-07",0,0,1,0,0,1,0,0
"Guinea","2024-09-08",0,0,1,0,0,1,0,0
"Guinea","2024-09-09",0,0,1,0,0,1,0,0
"Guinea","2024-09-10",0,0,1,0,0,1,0,0
"Guinea","2024-09-11",0,0,1,0,0,1,0,0
"Guinea","2024-09-12",0,0,1,0,0,1,0,0
"Guinea","2024-09-13",0,0,1,0,0,1,0,0
"Guinea","2024-09-14",0,0,1,0,0,1,0,0
"Guinea","2024-09-15",0,0,1,0,0,1,0,0
"Guinea","2024-09-16",0,0,1,0,0,1,0,0
"Guinea","2024-09-17",0,0,1,0,0,1,0,0
"Guinea","2024-09-18",0,0,1,0,0,1,0,0
"Guinea","2024-09-19",0,0,1,0,0,1,0,0
"Guinea","2024-09-20",0,0,1,0,0,1,0,0
"Guinea","2024-09-21",0,0,1,0,0,1,0,0
"Guinea","2024-09-22",0,0,1,0,0,1,0,0
"Guinea","2024-09-23",0,0,1,0,0,1,0,0
"Guinea","2024-09-24",0,0,1,0,0,1,0,0
"Guinea","2024-09-25",0,0,1,0,0,1,0,0
"Guinea","2024-09-26",0,0,1,0,0,1,0,0
"Guinea","2024-09-27",0,0,1,0,0,1,0,0
"Guinea","2024-09-28",0,0,1,0,0,1,0,0
"Guinea","2024-09-29",0,0,1,0,0,1,0,0
"Guinea","2024-09-30",0,0,1,0,0,1,0,0
"Guinea","2024-10-01",0,0,1,0,0,1,0,0
"Guinea","2024-10-02",0,0,1,0,0,1,0,0
"Guinea","2024-10-03",0,0,1,0,0,1,0,0
"Guinea","2024-10-04",0,0,1,0,0,1,0,0
"Guinea","2024-10-05",0,0,1,0,0,1,0,0
"Guinea","2024-10-06",0,0,1,0,0,1,0,0
"Guinea","2024-10-07",0,0,1,0,0,1,0,0
"Guinea","2024-10-08",0,0,1,0,0,1,0,0
"Guinea","2024-10-09",0,0,1,0,0,1,0,0
"Guinea","2024-10-10",0,0,1,0,0,1,0,0
"Guinea","2024-10-11",0,0,1,0,0,1,0,0
"Guinea","2024-10-12",0,0,1,0,0,1,0,0
"Guinea","2024-10-13",0,0,1,0,0,1,0,0
"Guinea","2024-10-14",0,0,1,0,0,1,0,0
"Guinea","2024-10-15",0,0,1,0,0,1,0,0
"Guinea","2024-10-16",0,0,1,0,0,1,0,0
"Guinea","2024-10-17",0,0,1,0,0,1,0,0
"Guinea","2024-10-18",0,0,1,0,0,1,0,0
"Guinea","2024-10-19",0,0,1,0,0,1,0,0
"Guinea","2024-10-20",0,0,1,0,0,1,0,0
"Guinea","2024-10-21",0,0,1,0,1,2,0,0
"Guinea","2024-10-22",0,0,1,0,0,2,0,0
"Guinea","2024-10-23",0,0,1,0,0,2,0,0
"Guinea","2024-10-24",0,0,1,0,0,2,0,0
"Guinea","2024-10-25",0,0,1,0,0,2,0,0
"Guinea","2024-10-26",0,0,1,0,0,2,0,0
"Guinea","2024-10-27",0,0,1,0,0,2,0,0
"Guinea","2024-10-28",0,0,1,0,0,2,0,0
"Guinea","2024-10-29",0,0,1,0,0,2,0,0
"Guinea","2024-10-30",0,0,1,0,0,2,0,0
"Guinea","2024-10-31",0,0,1,0,0,2,0,0
"Guinea","2024-11-01",0,0,1,0,0,2,0,0
"Guinea","2024-11-02",0,0,1,0,0,2,0,0
"Guinea","2024-11-03",0,0,1,0,0,2,0,0
"Guinea","2024-11-04",0,0,1,0,0,2,0,0
"Guinea","2024-11-05",0,0,1,0,0,2,0,0
"Guinea","2024-11-06",0,0,1,0,0,2,0,0
"Guinea","2024-11-07",0,0,1,0,0,2,0,0
"Guinea","2024-11-08",0,0,1,0,0,2,0,0
"Guinea","2024-11-09",0,0,1,0,0,2,0,0
"Guinea","2024-11-10",0,0,1,0,0,2,0,0
"Guinea","2024-11-11",0,0,1,0,0,2,0,0
"Guinea","2024-11-12",0,0,1,0,0,2,0,0
"Guinea","2024-11-13",0,0,1,0,0,2,0,0
"Guinea","2024-11-14",0,0,1,0,0,2,0,0
"Guinea","2024-11-15",0,0,1,0,0,2,0,0
"Guinea","2024-11-16",0,0,1,0,0,2,0,0
"Guinea","2024-11-17",0,0,1,0,0,2,0,0
"Guinea","2024-11-18",0,0,1,0,0,2,0,0
"Guinea","2024-11-19",0,0,1,0,0,2,0,0
"Guinea","2024-11-20",0,0,1,0,0,2,0,0
"Guinea","2024-11-21",0,0,1,0,0,2,0,0
"Guinea","2024-11-22",0,0,1,0,0,2,0,0
"Guinea","2024-11-23",0,0,1,0,0,2,0,0
"Guinea","2024-11-24",0,0,1,0,0,2,0,0
"Guinea","2024-11-25",0,0,1,0,0,2,0,0
"Guinea","2024-11-26",0,0,1,0,0,2,0,0
"Guinea","2024-11-27",0,0,1,0,0,2,0,0
"Guinea","2024-11-28",0,0,1,0,0,2,0,0
"Guinea","2024-11-29",0,0,1,0,0,2,0,0
"Guinea","2024-11-30",0,0,1,0,0,2,0,0
"Guinea","2024-12-01",0,0,1,0,0,2,0,0
"Guinea","2024-12-02",0,0,1,0,0,2,0,0
"Guinea","2024-12-03",0,0,1,0,0,2,0,0
"Guinea","2024-12-04",0,0,1,0,0,2,0,0
"Guinea","2024-12-05",0,0,1,0,0,2,0,0
"Guinea","2024-12-06",0,0,1,0,0,2,0,0
"Guinea","2024-12-07",0,0,1,0,0,2,0,0
"Guinea","2024-12-08",0,1,2,0,0,2,0,0
"Guinea","2024-12-09",0,0,2,0,0,2,0,0
"Guinea","2024-12-10",0,0,2,0,0,2,0,0
"Guinea","2024-12-11",0,0,2,0,0,2,0,0
"Guinea","2024-12-12",0,0,2,0,0,2,0,0
"Guinea","2024-12-13",0,0,2,0,0,2,0,0
"Guinea","2024-12-14",0,0,2,0,0,2,0,0
"Guinea","2024-12-15",0,0,2,0,0,2,0,0
"Guinea","2024-12-16",0,0,2,0,0,2,0,0
"Guinea","2024-12-17",0,0,2,0,0,2,0,0
"Guinea","2024-12-18",0,0,2,0,0,2,0,0
"Guinea","2024-12-19",0,0,2,0,0,2,0,0
"Guinea","2024-12-20",0,0,2,0,0,2,0,0
"Guinea","2024-12-21",0,0,2,0,0,2,0,0
"Guinea","2024-12-22",0,0,2,0,0,2,0,0
"Guinea","2024-12-23",0,0,2,0,0,2,0,0
"Guinea","2024-12-24",0,0,2,0,0,2,0,0
"Guinea","2024-12-25",0,0,2,0,0,2,0,0
"Guinea","2024-12-26",0,0,2,0,0,2,0,0
"Guinea","2024-12-27",0,0,2,0,0,2,0,0
"Guinea","2024-12-28",0,0,2,0,0,2,0,0
"Guinea","2024-12-29",0,0,2,0,0,2,0,0
"Guinea","2024-12-30",0,0,2,0,0,2,0,0
"Guinea","2024-12-31",0,0,2,0,0,2,0,0
"Guinea","2025-01-01",0,0,2,0,0,2,0,0
"Guinea","2025-01-02",0,0,2,0,0,2,0,0
"Guinea","2025-01-03",0,0,2,0,0,2,0,0
"Guinea","2025-01-04",0,0,2,0,0,2,0,0
"Guinea","2025-01-05",0,0,2,0,0,2,0,0
"Guinea","2025-01-06",0,0,2,0,0,2,0,0
"Guinea","2025-01-07",0,0,2,0,0,2,0,0
"Guinea","2025-01-08",0,0,2,0,0,2,0,0
"Guinea","2025-01-09",0,0,2,0,0,2,0,0
"Guinea","2025-01-10",0,0,2,0,0,2,0,0
"Guinea","2025-01-11",0,0,2,0,0,2,0,0
"Guinea","2025-01-12",0,0,2,0,0,2,0,0
"Guinea","2025-01-13",0,0,2,0,0,2,0,0
"Guyana","2024-01-01",0,0,0,0,0,0,0,0
"Guyana","2024-01-02",0,0,0,0,0,0,0,0
"Guyana","2024-01-03",0,0,0,0,0,0,0,0
"Guyana","2024-01-04",0,0,0,0,0,0,0,0
"Guyana","2024-01-05",0,0,0,0,0,0,0,0
"Guyana","2024-01-06",0,0,0,0,0,0,0,0
"Guyana","2024-01-07",0,0,0,0,0,0,0,0
"Guyana","2024-01-08",0,0,0,0,0,0,0,0
"Guyana","2024-01-09",0,0,0,0,0,0,0,0
"Guyana","2024-01-10",0,0,0,0,0,0,0,0
"Guyana","2024-01-11",0,0,0,0,0,0,0,0
"Guyana","2024-01-12",0,0,0,0,0,0,0,0
"Guyana","2024-01-13",0,0,0,0,0,0,0,0
"Guyana","2024-01-14",0,0,0,0,0,0,0,0
"Guyana","2024-01-15",0,0,0,0,0,0,0,0
"Guyana","2024-01-16",0,0,0,0,0,0,0,0
"Guyana","2024-01-17",0,0,0,0,0,0,0,0
"Guyana","2024-01-18",0,0,0,0,0,0,0,0
"Guyana","2024-01-19",0,0,0,0,0,0,0,0
"Guyana","2024-01-20",0,0,0,0,0,0,0,0
"Guyana","2024-01-21",0,0,0,0,0,0,0,0
"Guyana","2024-01-22",0,0,0,0,0,0,0,0
"Guyana","2024-01-23",0,0,0,0,0,0,0,0
"Guyana","2024-01-24",0,0,0,0,0,0,0,0
"Guyana","2024-01-25",0,0,0,0,0,0,0,0
"Guyana","2024-01-26",0,0,0,0,0,0,0,0
"Guyana","2024-01-27",0,0,0,0,0,0,0,0
"Guyana","2024-01-28",0,0,0,0,0,0,0,0
"Guyana","2024-01-29",0,0,0,0,0,0,0,0
"Guyana","2024-01-30",0,0,0,0,0,0,0,0
"Guyana","2024-01-31",0,0,0,0,0,0,0,0
"Guyana","2024-02-01",0,0,0,0,0,0,0,0
"Guyana","2024-02-02",0,0,0,0,0,0,0,0
"Guyana","2024-02-03",0,0,0,0,0,0,0,0
"Guyana","2024-02-04",0,0,0,0,0,0,0,0
"Guyana","2024-02-05",0,0,0,0,0,0,0,0
"Guyana","2024-02-06",0,0,0,0,0,0,0,0
"Guyana","2024-02-07",0,0,0,0,0,0,0,0
"Guyana","2024-02-08",0,0,0,0,0,0,0,0
"Guyana","2024-02-09",0,0,0,0,0,0,0,0
"Guyana","2024-02-10",0,0,0,0,0,0,0,0
"Guyana","2024-02-11",0,0,0,0,0,0,0,0
"Guyana","2024-02-12",0,0,0,0,0,0,0,0
"Guyana","2024-02-13",0,0,0,0,0,0,0,0
"Guyana","2024-02-14",0,0,0,0,0,0,0,0
"Guyana","2024-02-15",0,0,0,0,0,0,0,0
"Guyana","2024-02-16",0,0,0,0,0,0,0,0
"Guyana","2024-02-17",0,0,0,0,0,0,0,0
"Guyana","2024-02-18",0,0,0,0,0,0,0,0
"Guyana","2024-02-19",0,0,0,0,0,0,0,0
"Guyana","2024-02-20",0,0,0,0,0,0,0,0
"Guyana","2024-02-21",0,0,0,0,0,0,0,0
"Guyana","2024-02-22",0,0,0,0,0,0,0,0
"Guyana","2024-02-23",0,0,0,0,0,0,0,0
"Guyana","2024-02-24",0,0,0,0,0,0,0,0
"Guyana","2024-02-25",0,0,0,0,0,0,0,0
"Guyana","2024-02-26",0,0,0,0,0,0,0,0
"Guyana","2024-02-27",0,0,0,0,0,0,0,0
"Guyana","2024-02-28",0,0,0,0,0,0,0,0
"Guyana","2024-02-29",0,0,0,0,0,0,0,0
"Guyana","2024-03-01",0,0,0,0,0,0,0,0
"Guyana","2024-03-02",0,0,0,0,0,0,0,0
"Guyana","2024-03-03",0,0,0,0,0,0,0,0
"Guyana","2024-03-04",0,0,0,0,0,0,0,0
"Guyana","2024-03-05",0,0,0,0,0,0,0,0
"Guyana","2024-03-06",0,0,0,0,0,0,0,0
"Guyana","2024-03-07",0,0,0,0,0,0,0,0
"Guyana","2024-03-08",0,0,0,0,0,0,0,0
"Guyana","2024-03-09",0,0,0,0,0,0,0,0
"Guyana","2024-03-10",0,0,0,0,0,0,0,0
"Guyana","2024-03-11",0,0,0,0,0,0,0,0
"Guyana","2024-03-12",0,0,0,0,0,0,0,0
"Guyana","2024-03-13",0,0,0,0,0,0,0,0
"Guyana","2024-03-14",0,0,0,0,0,0,0,0
"Guyana","2024-03-15",0,0,0,0,0,0,0,0
"Guyana","2024-03-16",0,0,0,0,0,0,0,0
"Guyana","2024-03-17",0,0,0,0,0,0,0,0
"Guyana","2024-03-18",0,0,0,0,0,0,0,0
"Guyana","2024-03-19",0,0,0,0,0,0,0,0
"Guyana","2024-03-20",0,0,0,0,0,0,0,0
"Guyana","2024-03-21",0,0,0,0,0,0,0,0
"Guyana","2024-03-22",0,0,0,0,0,0,0,0
"Guyana","2024-03-23",0,0,0,0,0,0,0,0
"Guyana","2024-03-24",0,0,0,0,0,0,0,0
"Guyana","2024-03-25",0,0,0,0,0,0,0,0
"Guyana","2024-03-26",0,0,0,0,0,0,0,0
"Guyana","2024-03-27",0,0,0,0,0,0,0,0
"Guyana","2024-03-28",0,0,0,0,0,0,0,0
"Guyana","2024-03-29",0,0,0,0,0,0,0,0
"Guyana","2024-03-30",0,0,0,0,0,0,0,0
"Guyana","2024-03-31",0,0,0,0,0,0,0,0
"Guyana","2024-04-01",0,0,0,0,0,0,0,0
"Guyana","2024-04-02",0,0,0,0,0,0,0,0
"Guyana","2024-04-03",0,0,0,0,0,0,0,0
"Guyana","2024-04-04",0,0,0,0,0,0,0,0
"Guyana","2024-04-05",0,0,0,0,0,0,0,0
"Guyana","2024-04-06",0,0,0,0,0,0,0,0
"Guyana","2024-04-07",0,0,0,0,0,0,0,0
"Guyana","2024-04-08",0,0,0,0,0,0,0,0
"Guyana","2024-04-09",0,0,0,0,0,0,0,0
"Guyana","2024-04-10",0,0,0,0,0,0,0,0
"Guyana","2024-04-11",0,0,0,0,0,0,0,0
"Guyana","2024-04-12",0,0,0,0,0,0,0,0
"Guyana","2024-04-13",0,0,0,0,0,0,0,0
"Guyana","2024-04-14",0,0,0,0,0,0,0,0
"Guyana","2024-04-15",0,0,0,0,0,0,0,0
"Guyana","2024-04-16",0,0,0,0,0,0,0,0
"Guyana","2024-04-17",0,0,0,0,0,0,0,0
"Guyana","2024-04-18",0,0,0,0,0,0,0,0
"Guyana","2024-04-19",0,0,0,0,0,0,0,0
"Guyana","2024-04-20",0,0,0,0,0,0,0,0
"Guyana","2024-04-21",0,0,0,0,0,0,0,0
"Guyana","2024-04-22",0,0,0,0,0,0,0,0
"Guyana","2024-04-23",0,0,0,0,0,0,0,0
"Guyana","2024-04-24",0,0,0,0,0,0,0,0
"Guyana","2024-04-25",0,0,0,0,0,0,0,0
"Guyana","2024-04-26",0,0,0,0,0,0,0,0
"Guyana","2024-04-27",0,0,0,0,0,0,0,0
"Guyana","2024-04-28",0,0,0,0,0,0,0,0
"Guyana","2024-04-29",0,0,0,0,0,0,0,0
"Guyana","2024-04-30",0,0,0,0,0,0,0,0
"Guyana","2024-05-01",0,0,0,0,0,0,0,0
"Guyana","2024-05-02",0,0,0,0,0,0,0,0
"Guyana","2024-05-03",0,0,0,0,0,0,0,0
"Guyana","2024-05-04",0,0,0,0,0,0,0,0
"Guyana","2024-05-05",0,0,0,0,0,0,0,0
"Guyana","2024-05-06",0,0,0,0,0,0,0,0
"Guyana","2024-05-07",0,0,0,0,0,0,0,0
"Guyana","2024-05-08",0,0,0,0,0,0,0,0
"Guyana","2024-05-09",0,0,0,0,0,0,0,0
"Guyana","2024-05-10",0,0,0,0,0,0,0,0
"Guyana","2024-05-11",0,0,0,0,0,0,0,0
"Guyana","2024-05-12",0,0,0,0,0,0,0,0
"Guyana","2024-05-13",0,0,0,0,0,0,0,0
"Guyana","2024-05-14",0,0,0,0,0,0,0,0
"Guyana","2024-05-15",0,0,0,0,0,0,0,0
"Guyana","2024-05-16",0,0,0,0,0,0,0,0
"Guyana","2024-05-17",0,0,0,0,0,0,0,0
"Guyana","2024-05-18",0,0,0,0,0,0,0,0
"Guyana","2024-05-19",0,0,0,0,0,0,0,0
"Guyana","2024-05-20",0,0,0,0,0,0,0,0
"Guyana","2024-05-21",0,0,0,0,0,0,0,0
"Guyana","2024-05-22",0,0,0,0,0,0,0,0
"Guyana","2024-05-23",0,0,0,0,0,0,0,0
"Guyana","2024-05-24",0,0,0,0,0,0,0,0
"Guyana","2024-05-25",0,0,0,0,0,0,0,0
"Guyana","2024-05-26",0,0,0,0,0,0,0,0
"Guyana","2024-05-27",0,0,0,0,0,0,0,0
"Guyana","2024-05-28",0,0,0,0,0,0,0,0
"Guyana","2024-05-29",0,0,0,0,0,0,0,0
"Guyana","2024-05-30",0,0,0,0,0,0,0,0
"Guyana","2024-05-31",0,0,0,0,0,0,0,0
"Guyana","2024-06-01",0,0,0,0,0,0,0,0
"Guyana","2024-06-02",0,0,0,0,0,0,0,0
"Guyana","2024-06-03",0,0,0,0,0,0,0,0
"Guyana","2024-06-04",0,0,0,0,0,0,0,0
"Guyana","2024-06-05",0,0,0,0,0,0,0,0
"Guyana","2024-06-06",0,0,0,0,0,0,0,0
"Guyana","2024-06-07",0,0,0,0,0,0,0,0
"Guyana","2024-06-08",0,0,0,0,0,0,0,0
"Guyana","2024-06-09",0,0,0,0,0,0,0,0
"Guyana","2024-06-10",0,0,0,0,0,0,0,0
"Guyana","2024-06-11",0,0,0,0,0,0,0,0
"Guyana","2024-06-12",0,0,0,0,0,0,0,0
"Guyana","2024-06-13",0,0,0,0,0,0,0,0
"Guyana","2024-06-14",0,0,0,0,0,0,0,0
"Guyana","2024-06-15",0,0,0,0,0,0,0,0
"Guyana","2024-06-16",0,0,0,0,0,0,0,0
"Guyana","2024-06-17",0,0,0,0,0,0,0,0
"Guyana","2024-06-18",0,0,0,0,0,0,0,0
"Guyana","2024-06-19",0,0,0,0,0,0,0,0
"Guyana","2024-06-20",0,0,0,0,0,0,0,0
"Guyana","2024-06-21",0,0,0,0,0,0,0,0
"Guyana","2024-06-22",0,0,0,0,0,0,0,0
"Guyana","2024-06-23",0,0,0,0,0,0,0,0
"Guyana","2024-06-24",0,0,0,0,0,0,0,0
"Guyana","2024-06-25",0,0,0,0,0,0,0,0
"Guyana","2024-06-26",0,0,0,0,0,0,0,0
"Guyana","2024-06-27",0,0,0,0,0,0,0,0
"Guyana","2024-06-28",0,0,0,0,0,0,0,0
"Guyana","2024-06-29",0,0,0,0,0,0,0,0
"Guyana","2024-06-30",0,0,0,0,0,0,0,0
"Guyana","2024-07-01",0,0,0,0,0,0,0,0
"Guyana","2024-07-02",0,0,0,0,0,0,0,0
"Guyana","2024-07-03",0,0,0,0,0,0,0,0
"Guyana","2024-07-04",0,0,0,0,0,0,0,0
"Guyana","2024-07-05",0,0,0,0,0,0,0,0
"Guyana","2024-07-06",0,0,0,0,0,0,0,0
"Guyana","2024-07-07",0,0,0,0,0,0,0,0
"Guyana","2024-07-08",0,0,0,0,0,0,0,0
"Guyana","2024-07-09",0,0,0,0,0,0,0,0
"Guyana","2024-07-10",0,0,0,0,0,0,0,0
"Guyana","2024-07-11",0,0,0,0,0,0,0,0
"Guyana","2024-07-12",0,0,0,0,0,0,0,0
"Guyana","2024-07-13",0,0,0,0,0,0,0,0
"Guyana","2024-07-14",0,0,0,0,0,0,0,0
"Guyana","2024-07-15",0,0,0,0,0,0,0,0
"Guyana","2024-07-16",0,0,0,0,0,0,0,0
"Guyana","2024-07-17",0,0,0,0,0,0,0,0
"Guyana","2024-07-18",0,0,0,0,0,0,0,0
"Guyana","2024-07-19",0,0,0,0,0,0,0,0
"Guyana","2024-07-20",0,0,0,0,0,0,0,0
"Guyana","2024-07-21",0,0,0,0,0,0,0,0
"Guyana","2024-07-22",0,0,0,0,0,0,0,0
"Guyana","2024-07-23",0,0,0,0,0,0,0,0
"Guyana","2024-07-24",0,0,0,0,0,0,0,0
"Guyana","2024-07-25",0,0,0,0,0,0,0,0
"Guyana","2024-07-26",0,0,0,0,0,0,0,0
"Guyana","2024-07-27",0,0,0,0,0,0,0,0
"Guyana","2024-07-28",0,0,0,0,0,0,0,0
"Guyana","2024-07-29",0,0,0,0,0,0,0,0
"Guyana","2024-07-30",0,0,0,0,0,0,0,0
"Guyana","2024-07-31",0,0,0,0,0,0,0,0
"Guyana","2024-08-01",0,0,0,0,0,0,0,0
"Guyana","2024-08-02",0,0,0,0,0,0,0,0
"Guyana","2024-08-03",0,0,0,0,0,0,0,0
"Guyana","2024-08-04",0,0,0,0,0,0,0,0
"Guyana","2024-08-05",0,0,0,0,0,0,0,0
"Guyana","2024-08-06",0,0,0,0,0,0,0,0
"Guyana","2024-08-07",0,0,0,0,0,0,0,0
"Guyana","2024-08-08",0,0,0,0,0,0,0,0
"Guyana","2024-08-09",0,0,0,0,0,0,0,0
"Guyana","2024-08-10",0,0,0,0,0,0,0,0
"Guyana","2024-08-11",0,0,0,0,0,0,0,0
"Guyana","2024-08-12",0,0,0,0,0,0,0,0
"Guyana","2024-08-13",0,0,0,0,0,0,0,0
"Guyana","2024-08-14",0,0,0,0,0,0,0,0
"Guyana","2024-08-15",0,0,0,0,0,0,0,0
"Guyana","2024-08-16",0,0,0,0,0,0,0,0
"Guyana","2024-08-17",0,0,0,0,0,0,0,0
"Guyana","2024-08-18",0,0,0,0,0,0,0,0
"Guyana","2024-08-19",0,0,0,0,0,0,0,0
"Guyana","2024-08-20",0,0,0,0,0,0,0,0
"Guyana","2024-08-21",0,0,0,0,0,0,0,0
"Guyana","2024-08-22",0,0,0,0,0,0,0,0
"Guyana","2024-08-23",0,0,0,0,0,0,0,0
"Guyana","2024-08-24",0,0,0,0,0,0,0,0
"Guyana","2024-08-25",0,0,0,0,0,0,0,0
"Guyana","2024-08-26",0,0,0,0,0,0,0,0
"Guyana","2024-08-27",0,0,0,0,0,0,0,0
"Guyana","2024-08-28",0,0,0,0,0,0,0,0
"Guyana","2024-08-29",0,0,0,0,0,0,0,0
"Guyana","2024-08-30",0,0,0,0,0,0,0,0
"Guyana","2024-08-31",0,0,0,0,0,0,0,0
"Guyana","2024-09-01",0,0,0,0,0,0,0,0
"Guyana","2024-09-02",0,0,0,0,0,0,0,0
"Guyana","2024-09-03",0,0,0,0,0,0,0,0
"Guyana","2024-09-04",0,0,0,0,0,0,0,0
"Guyana","2024-09-05",0,0,0,0,0,0,0,0
"Guyana","2024-09-06",0,0,0,0,0,0,0,0
"Guyana","2024-09-07",0,0,0,0,0,0,0,0
"Guyana","2024-09-08",0,0,0,0,0,0,0,0
"Guyana","2024-09-09",0,0,0,0,0,0,0,0
"Guyana","2024-09-10",0,0,0,0,0,0,0,0
"Guyana","2024-09-11",0,0,0,0,0,0,0,0
"Guyana","2024-09-12",0,0,0,0,0,0,0,0
"Guyana","2024-09-13",0,0,0,0,0,0,0,0
"Guyana","2024-09-14",0,0,0,0,0,0,0,0
"Guyana","2024-09-15",0,0,0,0,0,0,0,0
"Guyana","2024-09-16",0,0,0,0,0,0,0,0
"Guyana","2024-09-17",0,0,0,0,0,0,0,0
"Guyana","2024-09-18",0,0,0,0,0,0,0,0
"Guyana","2024-09-19",0,0,0,0,0,0,0,0
"Guyana","2024-09-20",0,0,0,0,0,0,0,0
"Guyana","2024-09-21",0,0,0,0,0,0,0,0
"Guyana","2024-09-22",0,0,0,0,0,0,0,0
"Guyana","2024-09-23",0,0,0,0,0,0,0,0
"Guyana","2024-09-24",0,0,0,0,0,0,0,0
"Guyana","2024-09-25",0,0,0,0,0,0,0,0
"Guyana","2024-09-26",0,0,0,0,0,0,0,0
"Guyana","2024-09-27",0,0,0,0,0,0,0,0
"Guyana","2024-09-28",0,0,0,0,0,0,0,0
"Guyana","2024-09-29",0,0,0,0,0,0,0,0
"Guyana","2024-09-30",0,0,0,0,0,0,0,0
"Guyana","2024-10-01",0,0,0,0,0,0,0,0
"Guyana","2024-10-02",0,0,0,0,0,0,0,0
"Guyana","2024-10-03",0,0,0,0,0,0,0,0
"Guyana","2024-10-04",0,0,0,0,0,0,0,0
"Guyana","2024-10-05",0,0,0,0,0,0,0,0
"Guyana","2024-10-06",0,0,0,0,0,0,0,0
"Guyana","2024-10-07",0,0,0,0,0,0,0,0
"Guyana","2024-10-08",0,0,0,0,0,0,0,0
"Guyana","2024-10-09",0,0,0,0,0,0,0,0
"Guyana","2024-10-10",0,0,0,0,0,0,0,0
"Guyana","2024-10-11",0,0,0,0,0,0,0,0
"Guyana","2024-10-12",0,0,0,0,0,0,0,0
"Guyana","2024-10-13",0,0,0,0,0,0,0,0
"Guyana","2024-10-14",0,0,0,0,0,0,0,0
"Guyana","2024-10-15",0,0,0,0,0,0,0,0
"Guyana","2024-10-16",0,0,0,0,0,0,0,0
"Guyana","2024-10-17",0,0,0,0,0,0,0,0
"Guyana","2024-10-18",0,0,0,0,0,0,0,0
"Guyana","2024-10-19",0,0,0,0,0,0,0,0
"Guyana","2024-10-20",0,0,0,0,0,0,0,0
"Guyana","2024-10-21",0,0,0,0,0,0,0,0
"Guyana","2024-10-22",0,0,0,0,0,0,0,0
"Guyana","2024-10-23",0,0,0,0,0,0,0,0
"Guyana","2024-10-24",0,0,0,0,0,0,0,0
"Guyana","2024-10-25",0,0,0,0,0,0,0,0
"Guyana","2024-10-26",0,0,0,0,0,0,0,0
"Guyana","2024-10-27",0,0,0,0,0,0,0,0
"Guyana","2024-10-28",0,0,0,0,0,0,0,0
"Guyana","2024-10-29",0,0,0,0,0,0,0,0
"Guyana","2024-10-30",0,0,0,0,0,0,0,0
"Guyana","2024-10-31",0,0,0,0,0,0,0,0
"Guyana","2024-11-01",0,0,0,0,0,0,0,0
"Guyana","2024-11-02",0,0,0,0,0,0,0,0
"Guyana","2024-11-03",0,0,0,0,0,0,0,0
"Guyana","2024-11-04",0,0,0,0,0,0,0,0
"Guyana","2024-11-05",0,0,0,0,0,0,0,0
"Guyana","2024-11-06",0,0,0,0,0,0,0,0
"Guyana","2024-11-07",0,0,0,0,0,0,0,0
"Guyana","2024-11-08",0,0,0,0,0,0,0,0
"Guyana","2024-11-09",0,0,0,0,0,0,0,0
"Guyana","2024-11-10",0,0,0,0,0,0,0,0
"Guyana","2024-11-11",0,0,0,0,0,0,0,0
"Guyana","2024-11-12",0,0,0,0,0,0,0,0
"Guyana","2024-11-13",0,0,0,0,0,0,0,0
"Guyana","2024-11-14",0,0,0,0,0,0,0,0
"Guyana","2024-11-15",0,0,0,0,0,0,0,0
"Guyana","2024-11-16",0,0,0,0,0,0,0,0
"Guyana","2024-11-17",0,0,0,0,0,0,0,0
"Guyana","2024-11-18",0,0,0,0,0,0,0,0
"Guyana","2024-11-19",0,0,0,0,0,0,0,0
"Guyana","2024-11-20",0,0,0,0,0,0,0,0
"Guyana","2024-11-21",0,0,0,0,0,0,0,0
"Guyana","2024-11-22",0,0,0,0,0,0,0,0
"Guyana","2024-11-23",0,0,0,0,0,0,0,0
"Guyana","2024-11-24",0,0,0,0,0,0,0,0
"Guyana","2024-11-25",0,0,0,0,0,0,0,0
"Guyana","2024-11-26",0,0,0,0,0,0,0,0
"Guyana","2024-11-27",0,0,0,0,0,0,0,0
"Guyana","2024-11-28",0,0,0,0,0,0,0,0
"Guyana","2024-11-29",0,0,0,0,0,0,0,0
"Guyana","2024-11-30",0,0,0,0,0,0,0,0
"Guyana","2024-12-01",0,0,0,0,0,0,0,0
"Guyana","2024-12-02",0,0,0,0,0,0,0,0
"Guyana","2024-12-03",0,0,0,0,0,0,0,0
"Guyana","2024-12-04",0,0,0,0,0,0,0,0
"Guyana","2024-12-05",0,0,0,0,0,0,0,0
"Guyana","2024-12-06",0,0,0,0,0,0,0,0
"Guyana","2024-12-07",0,0,0,0,0,0,0,0
"Guyana","2024-12-08",0,0,0,0,0,0,0,0
"Guyana","2024-12-09",0,0,0,0,0,0,0,0
"Guyana","2024-12-10",0,0,0,0,0,0,0,0
"Guyana","2024-12-11",0,0,0,0,0,0,0,0
"Guyana","2024-12-12",0,0,0,0,0,0,0,0
"Guyana","2024-12-13",0,0,0,0,0,0,0,0
"Guyana","2024-12-14",0,0,0,0,0,0,0,0
"Guyana","2024-12-15",0,0,0,0,0,0,0,0
"Guyana","2024-12-16",0,0,0,0,0,0,0,0
"Guyana","2024-12-17",0,0,0,0,0,0,0,0
"Guyana","2024-12-18",0,0,0,0,0,0,0,0
"Guyana","2024-12-19",0,0,0,0,0,0,0,0
"Guyana","2024-12-20",0,0,0,0,0,0,0,0
"Guyana","2024-12-21",0,0,0,0,0,0,0,0
"Guyana","2024-12-22",0,0,0,0,0,0,0,0
"Guyana","2024-12-23",0,0,0,0,0,0,0,0
"Guyana","2024-12-24",0,0,0,0,0,0,0,0
"Guyana","2024-12-25",0,0,0,0,0,0,0,0
"Guyana","2024-12-26",0,0,0,0,0,0,0,0
"Guyana","2024-12-27",0,0,0,0,0,0,0,0
"Guyana","2024-12-28",0,0,0,0,0,0,0,0
"Guyana","2024-12-29",0,0,0,0,0,0,0,0
"Guyana","2024-12-30",0,0,0,0,0,0,0,0
"Guyana","2024-12-31",0,0,0,0,0,0,0,0
"Guyana","2025-01-01",0,0,0,0,0,0,0,0
"Guyana","2025-01-02",0,0,0,0,0,0,0,0
"Guyana","2025-01-03",0,0,0,0,0,0,0,0
"Guyana","2025-01-04",0,0,0,0,0,0,0,0
"Guyana","2025-01-05",0,0,0,0,0,0,0,0
"Guyana","2025-01-06",0,0,0,0,0,0,0,0
"Guyana","2025-01-07",0,0,0,0,0,0,0,0
"Guyana","2025-01-08",0,0,0,0,0,0,0,0
"Guyana","2025-01-09",0,0,0,0,0,0,0,0
"Guyana","2025-01-10",0,0,0,0,0,0,0,0
"Guyana","2025-01-11",0,0,0,0,0,0,0,0
"Guyana","2025-01-12",0,0,0,0,0,0,0,0
"Guyana","2025-01-13",0,0,0,0,0,0,0,0
"Honduras","2024-01-01",0,0,0,0,0,0,0,0
"Honduras","2024-01-02",0,0,0,0,0,0,0,0
"Honduras","2024-01-03",0,0,0,0,0,0,0,0
"Honduras","2024-01-04",0,0,0,0,0,0,0,0
"Honduras","2024-01-05",0,0,0,0,0,0,0,0
"Honduras","2024-01-06",0,0,0,0,0,0,0,0
"Honduras","2024-01-07",0,0,0,0,0,0,0,0
"Honduras","2024-01-08",0,0,0,0,0,0,0,0
"Honduras","2024-01-09",0,0,0,0,0,0,0,0
"Honduras","2024-01-10",0,0,0,0,0,0,0,0
"Honduras","2024-01-11",0,0,0,0,0,0,0,0
"Honduras","2024-01-12",0,0,0,0,0,0,0,0
"Honduras","2024-01-13",0,0,0,0,0,0,0,0
"Honduras","2024-01-14",0,0,0,0,0,0,0,0
"Honduras","2024-01-15",0,0,0,0,0,0,0,0
"Honduras","2024-01-16",0,0,0,0,0,0,0,0
"Honduras","2024-01-17",0,0,0,0,0,0,0,0
"Honduras","2024-01-18",0,0,0,0,0,0,0,0
"Honduras","2024-01-19",0,0,0,0,0,0,0,0
"Honduras","2024-01-20",0,0,0,0,0,0,0,0
"Honduras","2024-01-21",0,0,0,0,0,0,0,0
"Honduras","2024-01-22",0,0,0,0,0,0,0,0
"Honduras","2024-01-23",0,0,0,0,0,0,0,0
"Honduras","2024-01-24",0,0,0,0,0,0,0,0
"Honduras","2024-01-25",0,0,0,0,0,0,0,0
"Honduras","2024-01-26",0,0,0,0,0,0,0,0
"Honduras","2024-01-27",0,0,0,0,0,0,0,0
"Honduras","2024-01-28",0,0,0,0,0,0,0,0
"Honduras","2024-01-29",0,0,0,0,0,0,0,0
"Honduras","2024-01-30",0,0,0,0,0,0,0,0
"Honduras","2024-01-31",0,0,0,0,0,0,0,0
"Honduras","2024-02-01",0,0,0,0,0,0,0,0
"Honduras","2024-02-02",0,0,0,0,0,0,0,0
"Honduras","2024-02-03",0,0,0,0,0,0,0,0
"Honduras","2024-02-04",0,0,0,0,0,0,0,0
"Honduras","2024-02-05",0,0,0,0,0,0,0,0
"Honduras","2024-02-06",0,0,0,0,0,0,0,0
"Honduras","2024-02-07",0,0,0,0,0,0,0,0
"Honduras","2024-02-08",0,0,0,0,0,0,0,0
"Honduras","2024-02-09",0,0,0,0,0,0,0,0
"Honduras","2024-02-10",0,0,0,0,0,0,0,0
"Honduras","2024-02-11",0,0,0,0,0,0,0,0
"Honduras","2024-02-12",0,0,0,0,0,0,0,0
"Honduras","2024-02-13",0,0,0,0,0,0,0,0
"Honduras","2024-02-14",0,0,0,0,0,0,0,0
"Honduras","2024-02-15",0,0,0,0,0,0,0,0
"Honduras","2024-02-16",0,0,0,0,0,0,0,0
"Honduras","2024-02-17",0,0,0,0,0,0,0,0
"Honduras","2024-02-18",0,0,0,0,0,0,0,0
"Honduras","2024-02-19",0,0,0,0,0,0,0,0
"Honduras","2024-02-20",0,0,0,0,0,0,0,0
"Honduras","2024-02-21",0,0,0,0,0,0,0,0
"Honduras","2024-02-22",0,0,0,0,0,0,0,0
"Honduras","2024-02-23",0,0,0,0,0,0,0,0
"Honduras","2024-02-24",0,0,0,0,0,0,0,0
"Honduras","2024-02-25",0,0,0,0,0,0,0,0
"Honduras","2024-02-26",0,0,0,0,0,0,0,0
"Honduras","2024-02-27",0,0,0,0,0,0,0,0
"Honduras","2024-02-28",0,0,0,0,0,0,0,0
"Honduras","2024-02-29",0,0,0,0,0,0,0,0
"Honduras","2024-03-01",0,0,0,0,0,0,0,0
"Honduras","2024-03-02",0,0,0,0,0,0,0,0
"Honduras","2024-03-03",0,0,0,0,0,0,0,0
"Honduras","2024-03-04",0,0,0,0,0,0,0,0
"Honduras","2024-03-05",0,0,0,0,0,0,0,0
"Honduras","2024-03-06",0,0,0,0,0,0,0,0
"Honduras","2024-03-07",0,0,0,0,0,0,0,0
"Honduras","2024-03-08",0,0,0,0,0,0,0,0
"Honduras","2024-03-09",0,0,0,0,0,0,0,0
"Honduras","2024-03-10",0,0,0,0,0,0,0,0
"Honduras","2024-03-11",0,0,0,0,0,0,0,0
"Honduras","2024-03-12",0,0,0,0,0,0,0,0
"Honduras","2024-03-13",0,0,0,0,0,0,0,0
"Honduras","2024-03-14",0,0,0,0,0,0,0,0
"Honduras","2024-03-15",0,0,0,0,0,0,0,0
"Honduras","2024-03-16",0,0,0,0,0,0,0,0
"Honduras","2024-03-17",0,0,0,0,0,0,0,0
"Honduras","2024-03-18",0,0,0,0,0,0,0,0
"Honduras","2024-03-19",0,0,0,0,0,0,0,0
"Honduras","2024-03-20",0,0,0,0,0,0,0,0
"Honduras","2024-03-21",0,0,0,0,0,0,0,0
"Honduras","2024-03-22",0,0,0,0,0,0,0,0
"Honduras","2024-03-23",0,0,0,0,0,0,0,0
"Honduras","2024-03-24",0,0,0,0,0,0,0,0
"Honduras","2024-03-25",0,0,0,0,0,0,0,0
"Honduras","2024-03-26",0,0,0,0,0,0,0,0
"Honduras","2024-03-27",0,0,0,0,0,0,0,0
"Honduras","2024-03-28",0,0,0,0,0,0,0,0
"Honduras","2024-03-29",0,0,0,0,0,0,0,0
"Honduras","2024-03-30",0,0,0,0,0,0,0,0
"Honduras","2024-03-31",0,0,0,0,0,0,0,0
"Honduras","2024-04-01",0,0,0,0,0,0,0,0
"Honduras","2024-04-02",0,0,0,0,0,0,0,0
"Honduras","2024-04-03",0,0,0,0,0,0,0,0
"Honduras","2024-04-04",0,0,0,0,0,0,0,0
"Honduras","2024-04-05",0,0,0,0,0,0,0,0
"Honduras","2024-04-06",0,0,0,0,0,0,0,0
"Honduras","2024-04-07",0,0,0,0,0,0,0,0
"Honduras","2024-04-08",0,0,0,0,0,0,0,0
"Honduras","2024-04-09",0,0,0,0,0,0,0,0
"Honduras","2024-04-10",0,0,0,0,0,0,0,0
"Honduras","2024-04-11",0,0,0,0,0,0,0,0
"Honduras","2024-04-12",0,0,0,0,0,0,0,0
"Honduras","2024-04-13",0,0,0,0,0,0,0,0
"Honduras","2024-04-14",0,0,0,0,0,0,0,0
"Honduras","2024-04-15",0,0,0,0,0,0,0,0
"Honduras","2024-04-16",0,0,0,0,0,0,0,0
"Honduras","2024-04-17",0,0,0,0,0,0,0,0
"Honduras","2024-04-18",0,0,0,0,0,0,0,0
"Honduras","2024-04-19",0,0,0,0,0,0,0,0
"Honduras","2024-04-20",0,0,0,0,0,0,0,0
"Honduras","2024-04-21",0,0,0,0,0,0,0,0
"Honduras","2024-04-22",0,0,0,0,0,0,0,0
"Honduras","2024-04-23",0,0,0,0,0,0,0,0
"Honduras","2024-04-24",0,0,0,0,0,0,0,0
"Honduras","2024-04-25",0,0,0,0,0,0,0,0
"Honduras","2024-04-26",0,0,0,0,0,0,0,0
"Honduras","2024-04-27",0,0,0,0,0,0,0,0
"Honduras","2024-04-28",0,0,0,0,0,0,0,0
"Honduras","2024-04-29",0,0,0,0,0,0,0,0
"Honduras","2024-04-30",0,0,0,0,0,0,0,0
"Honduras","2024-05-01",0,0,0,0,0,0,0,0
"Honduras","2024-05-02",0,0,0,0,0,0,0,0
"Honduras","2024-05-03",0,0,0,0,0,0,0,0
"Honduras","2024-05-04",0,0,0,0,0,0,0,0
"Honduras","2024-05-05",0,0,0,0,0,0,0,0
"Honduras","2024-05-06",0,0,0,0,0,0,0,0
"Honduras","2024-05-07",0,0,0,0,0,0,0,0
"Honduras","2024-05-08",0,0,0,0,0,0,0,0
"Honduras","2024-05-09",0,0,0,0,0,0,0,0
"Honduras","2024-05-10",0,0,0,0,0,0,0,0
"Honduras","2024-05-11",0,0,0,0,0,0,0,0
"Honduras","2024-05-12",0,0,0,0,0,0,0,0
"Honduras","2024-05-13",0,0,0,0,0,0,0,0
"Honduras","2024-05-14",0,0,0,0,0,0,0,0
"Honduras","2024-05-15",0,0,0,0,0,0,0,0
"Honduras","2024-05-16",0,0,0,0,0,0,0,0
"Honduras","2024-05-17",0,0,0,0,0,0,0,0
"Honduras","2024-05-18",0,0,0,0,0,0,0,0
"Honduras","2024-05-19",0,0,0,0,0,0,0,0
"Honduras","2024-05-20",0,0,0,0,0,0,0,0
"Honduras","2024-05-21",0,0,0,0,0,0,0,0
"Honduras","2024-05-22",0,0,0,0,0,0,0,0
"Honduras","2024-05-23",0,0,0,0,0,0,0,0
"Honduras","2024-05-24",0,0,0,0,0,0,0,0
"Honduras","2024-05-25",0,0,0,0,0,0,0,0
"Honduras","2024-05-26",0,0,0,0,0,0,0,0
"Honduras","2024-05-27",0,0,0,0,0,0,0,0
"Honduras","2024-05-28",0,0,0,0,0,0,0,0
"Honduras","2024-05-29",0,0,0,0,0,0,0,0
"Honduras","2024-05-30",0,0,0,0,0,0,0,0
"Honduras","2024-05-31",0,0,0,0,0,0,0,0
"Honduras","2024-06-01",0,0,0,0,0,0,0,0
"Honduras","2024-06-02",0,0,0,0,0,0,0,0
"Honduras","2024-06-03",0,0,0,0,0,0,0,0
"Honduras","2024-06-04",0,0,0,0,0,0,0,0
"Honduras","2024-06-05",0,0,0,0,0,0,0,0
"Honduras","2024-06-06",0,0,0,0,0,0,0,0
"Honduras","2024-06-07",0,0,0,0,0,0,0,0
"Honduras","2024-06-08",0,0,0,0,0,0,0,0
"Honduras","2024-06-09",0,0,0,0,0,0,0,0
"Honduras","2024-06-10",0,0,0,0,0,0,0,0
"Honduras","2024-06-11",0,0,0,0,0,0,0,0
"Honduras","2024-06-12",0,0,0,0,0,0,0,0
"Honduras","2024-06-13",0,0,0,0,0,0,0,0
"Honduras","2024-06-14",0,0,0,0,0,0,0,0
"Honduras","2024-06-15",0,0,0,0,0,0,0,0
"Honduras","2024-06-16",0,0,0,0,0,0,0,0
"Honduras","2024-06-17",0,0,0,0,0,0,0,0
"Honduras","2024-06-18",0,0,0,0,0,0,0,0
"Honduras","2024-06-19",0,0,0,0,0,0,0,0
"Honduras","2024-06-20",0,0,0,0,0,0,0,0
"Honduras","2024-06-21",0,0,0,0,0,0,0,0
"Honduras","2024-06-22",0,0,0,0,0,0,0,0
"Honduras","2024-06-23",0,0,0,0,0,0,0,0
"Honduras","2024-06-24",0,0,0,0,0,0,0,0
"Honduras","2024-06-25",0,0,0,0,0,0,0,0
"Honduras","2024-06-26",0,0,0,0,0,0,0,0
"Honduras","2024-06-27",0,0,0,0,0,0,0,0
"Honduras","2024-06-28",0,0,0,0,0,0,0,0
"Honduras","2024-06-29",0,0,0,0,0,0,0,0
"Honduras","2024-06-30",0,0,0,0,0,0,0,0
"Honduras","2024-07-01",0,0,0,0,0,0,0,0
"Honduras","2024-07-02",0,0,0,0,0,0,0,0
"Honduras","2024-07-03",0,0,0,0,0,0,0,0
"Honduras","2024-07-04",0,0,0,0,0,0,0,0
"Honduras","2024-07-05",0,0,0,0,0,0,0,0
"Honduras","2024-07-06",0,0,0,0,0,0,0,0
"Honduras","2024-07-07",0,0,0,0,0,0,0,0
"Honduras","2024-07-08",0,0,0,0,0,0,0,0
"Honduras","2024-07-09",0,0,0,0,0,0,0,0
"Honduras","2024-07-10",0,0,0,0,0,0,0,0
"Honduras","2024-07-11",0,0,0,0,0,0,0,0
"Honduras","2024-07-12",0,0,0,0,0,0,0,0
"Honduras","2024-07-13",0,0,0,0,0,0,0,0
"Honduras","2024-07-14",0,0,0,0,0,0,0,0
"Honduras","2024-07-15",0,0,0,0,0,0,0,0
"Honduras","2024-07-16",0,0,0,0,0,0,0,0
"Honduras","2024-07-17",0,0,0,0,0,0,0,0
"Honduras","2024-07-18",0,0,0,0,0,0,0,0
"Honduras","2024-07-19",0,0,0,0,0,0,0,0
"Honduras","2024-07-20",0,0,0,0,0,0,0,0
"Honduras","2024-07-21",0,0,0,0,0,0,0,0
"Honduras","2024-07-22",0,0,0,0,0,0,0,0
"Honduras","2024-07-23",0,0,0,0,0,0,0,0
"Honduras","2024-07-24",0,0,0,0,0,0,0,0
"Honduras","2024-07-25",0,0,0,0,0,0,0,0
"Honduras","2024-07-26",0,0,0,0,0,0,0,0
"Honduras","2024-07-27",0,0,0,0,0,0,0,0
"Honduras","2024-07-28",0,0,0,0,0,0,0,0
"Honduras","2024-07-29",0,0,0,0,0,0,0,0
"Honduras","2024-07-30",0,0,0,0,0,0,0,0
"Honduras","2024-07-31",0,0,0,0,0,0,0,0
"Honduras","2024-08-01",0,0,0,0,0,0,0,0
"Honduras","2024-08-02",0,0,0,0,0,0,0,0
"Honduras","2024-08-03",0,0,0,0,0,0,0,0
"Honduras","2024-08-04",0,0,0,0,0,0,0,0
"Honduras","2024-08-05",0,0,0,0,0,0,0,0
"Honduras","2024-08-06",0,0,0,0,0,0,0,0
"Honduras","2024-08-07",0,0,0,0,0,0,0,0
"Honduras","2024-08-08",0,0,0,0,0,0,0,0
"Honduras","2024-08-09",0,0,0,0,0,0,0,0
"Honduras","2024-08-10",0,0,0,0,0,0,0,0
"Honduras","2024-08-11",0,0,0,0,0,0,0,0
"Honduras","2024-08-12",0,0,0,0,0,0,0,0
"Honduras","2024-08-13",0,0,0,0,0,0,0,0
"Honduras","2024-08-14",0,0,0,0,0,0,0,0
"Honduras","2024-08-15",0,0,0,0,0,0,0,0
"Honduras","2024-08-16",0,0,0,0,0,0,0,0
"Honduras","2024-08-17",0,0,0,0,0,0,0,0
"Honduras","2024-08-18",0,0,0,0,0,0,0,0
"Honduras","2024-08-19",0,0,0,0,0,0,0,0
"Honduras","2024-08-20",0,0,0,0,0,0,0,0
"Honduras","2024-08-21",0,0,0,0,0,0,0,0
"Honduras","2024-08-22",0,0,0,0,0,0,0,0
"Honduras","2024-08-23",0,0,0,0,0,0,0,0
"Honduras","2024-08-24",0,0,0,0,0,0,0,0
"Honduras","2024-08-25",0,0,0,0,0,0,0,0
"Honduras","2024-08-26",0,0,0,0,0,0,0,0
"Honduras","2024-08-27",0,0,0,0,0,0,0,0
"Honduras","2024-08-28",0,0,0,0,0,0,0,0
"Honduras","2024-08-29",0,0,0,0,0,0,0,0
"Honduras","2024-08-30",0,0,0,0,0,0,0,0
"Honduras","2024-08-31",0,0,0,0,0,0,0,0
"Honduras","2024-09-01",0,0,0,0,0,0,0,0
"Honduras","2024-09-02",0,0,0,0,0,0,0,0
"Honduras","2024-09-03",0,0,0,0,0,0,0,0
"Honduras","2024-09-04",0,0,0,0,0,0,0,0
"Honduras","2024-09-05",0,0,0,0,0,0,0,0
"Honduras","2024-09-06",0,0,0,0,0,0,0,0
"Honduras","2024-09-07",0,0,0,0,0,0,0,0
"Honduras","2024-09-08",0,0,0,0,0,0,0,0
"Honduras","2024-09-09",0,0,0,0,0,0,0,0
"Honduras","2024-09-10",0,0,0,0,0,0,0,0
"Honduras","2024-09-11",0,0,0,0,0,0,0,0
"Honduras","2024-09-12",0,0,0,0,0,0,0,0
"Honduras","2024-09-13",0,0,0,0,0,0,0,0
"Honduras","2024-09-14",0,0,0,0,0,0,0,0
"Honduras","2024-09-15",0,0,0,0,0,0,0,0
"Honduras","2024-09-16",0,0,0,0,0,0,0,0
"Honduras","2024-09-17",0,0,0,0,0,0,0,0
"Honduras","2024-09-18",0,0,0,0,0,0,0,0
"Honduras","2024-09-19",0,0,0,0,0,0,0,0
"Honduras","2024-09-20",0,0,0,0,0,0,0,0
"Honduras","2024-09-21",0,0,0,0,0,0,0,0
"Honduras","2024-09-22",0,0,0,0,0,0,0,0
"Honduras","2024-09-23",0,0,0,0,0,0,0,0
"Honduras","2024-09-24",0,0,0,0,0,0,0,0
"Honduras","2024-09-25",0,0,0,0,0,0,0,0
"Honduras","2024-09-26",0,0,0,0,0,0,0,0
"Honduras","2024-09-27",0,0,0,0,0,0,0,0
"Honduras","2024-09-28",0,0,0,0,0,0,0,0
"Honduras","2024-09-29",0,0,0,0,0,0,0,0
"Honduras","2024-09-30",0,0,0,0,0,0,0,0
"Honduras","2024-10-01",0,0,0,0,0,0,0,0
"Honduras","2024-10-02",0,0,0,0,0,0,0,0
"Honduras","2024-10-03",0,0,0,0,0,0,0,0
"Honduras","2024-10-04",0,0,0,0,0,0,0,0
"Honduras","2024-10-05",0,0,0,0,0,0,0,0
"Honduras","2024-10-06",0,0,0,0,0,0,0,0
"Honduras","2024-10-07",0,0,0,0,0,0,0,0
"Honduras","2024-10-08",0,0,0,0,0,0,0,0
"Honduras","2024-10-09",0,0,0,0,0,0,0,0
"Honduras","2024-10-10",0,0,0,0,0,0,0,0
"Honduras","2024-10-11",0,0,0,0,0,0,0,0
"Honduras","2024-10-12",0,0,0,0,0,0,0,0
"Honduras","2024-10-13",0,0,0,0,0,0,0,0
"Honduras","2024-10-14",0,0,0,0,0,0,0,0
"Honduras","2024-10-15",0,0,0,0,0,0,0,0
"Honduras","2024-10-16",0,0,0,0,0,0,0,0
"Honduras","2024-10-17",0,0,0,0,0,0,0,0
"Honduras","2024-10-18",0,0,0,0,0,0,0,0
"Honduras","2024-10-19",0,0,0,0,0,0,0,0
"Honduras","2024-10-20",0,0,0,0,0,0,0,0
"Honduras","2024-10-21",0,0,0,0,0,0,0,0
"Honduras","2024-10-22",0,0,0,0,0,0,0,0
"Honduras","2024-10-23",0,0,0,0,0,0,0,0
"Honduras","2024-10-24",0,0,0,0,0,0,0,0
"Honduras","2024-10-25",0,0,0,0,0,0,0,0
"Honduras","2024-10-26",0,0,0,0,0,0,0,0
"Honduras","2024-10-27",0,0,0,0,0,0,0,0
"Honduras","2024-10-28",0,0,0,0,0,0,0,0
"Honduras","2024-10-29",0,0,0,0,0,0,0,0
"Honduras","2024-10-30",0,0,0,0,0,0,0,0
"Honduras","2024-10-31",0,0,0,0,0,0,0,0
"Honduras","2024-11-01",0,0,0,0,0,0,0,0
"Honduras","2024-11-02",0,0,0,0,0,0,0,0
"Honduras","2024-11-03",0,0,0,0,0,0,0,0
"Honduras","2024-11-04",0,0,0,0,0,0,0,0
"Honduras","2024-11-05",0,0,0,0,0,0,0,0
"Honduras","2024-11-06",0,0,0,0,0,0,0,0
"Honduras","2024-11-07",0,0,0,0,0,0,0,0
"Honduras","2024-11-08",0,0,0,0,0,0,0,0
"Honduras","2024-11-09",0,0,0,0,0,0,0,0
"Honduras","2024-11-10",0,0,0,0,0,0,0,0
"Honduras","2024-11-11",0,0,0,0,0,0,0,0
"Honduras","2024-11-12",0,0,0,0,0,0,0,0
"Honduras","2024-11-13",0,0,0,0,0,0,0,0
"Honduras","2024-11-14",0,0,0,0,0,0,0,0
"Honduras","2024-11-15",0,0,0,0,0,0,0,0
"Honduras","2024-11-16",0,0,0,0,0,0,0,0
"Honduras","2024-11-17",0,0,0,0,0,0,0,0
"Honduras","2024-11-18",0,0,0,0,0,0,0,0
"Honduras","2024-11-19",0,0,0,0,0,0,0,0
"Honduras","2024-11-20",0,0,0,0,0,0,0,0
"Honduras","2024-11-21",0,0,0,0,0,0,0,0
"Honduras","2024-11-22",0,0,0,0,0,0,0,0
"Honduras","2024-11-23",0,0,0,0,0,0,0,0
"Honduras","2024-11-24",0,0,0,0,0,0,0,0
"Honduras","2024-11-25",0,0,0,0,0,0,0,0
"Honduras","2024-11-26",0,0,0,0,0,0,0,0
"Honduras","2024-11-27",0,0,0,0,0,0,0,0
"Honduras","2024-11-28",0,0,0,0,0,0,0,0
"Honduras","2024-11-29",0,0,0,0,0,0,0,0
"Honduras","2024-11-30",0,0,0,0,0,0,0,0
"Honduras","2024-12-01",0,0,0,0,0,0,0,0
"Honduras","2024-12-02",0,0,0,0,0,0,0,0
"Honduras","2024-12-03",0,0,0,0,0,0,0,0
"Honduras","2024-12-04",0,0,0,0,0,0,0,0
"Honduras","2024-12-05",0,0,0,0,0,0,0,0
"Honduras","2024-12-06",0,0,0,0,0,0,0,0
"Honduras","2024-12-07",0,0,0,0,0,0,0,0
"Honduras","2024-12-08",0,0,0,0,0,0,0,0
"Honduras","2024-12-09",0,0,0,0,0,0,0,0
"Honduras","2024-12-10",0,0,0,0,0,0,0,0
"Honduras","2024-12-11",0,0,0,0,0,0,0,0
"Honduras","2024-12-12",0,0,0,0,0,0,0,0
"Honduras","2024-12-13",0,0,0,0,0,0,0,0
"Honduras","2024-12-14",0,0,0,0,0,0,0,0
"Honduras","2024-12-15",0,0,0,0,0,0,0,0
"Honduras","2024-12-16",0,0,0,0,0,0,0,0
"Honduras","2024-12-17",0,0,0,0,0,0,0,0
"Honduras","2024-12-18",0,0,0,0,0,0,0,0
"Honduras","2024-12-19",0,0,0,0,0,0,0,0
"Honduras","2024-12-20",0,0,0,0,0,0,0,0
"Honduras","2024-12-21",0,0,0,0,0,0,0,0
"Honduras","2024-12-22",0,0,0,0,0,0,0,0
"Honduras","2024-12-23",0,0,0,0,0,0,0,0
"Honduras","2024-12-24",0,0,0,0,0,0,0,0
"Honduras","2024-12-25",0,0,0,0,0,0,0,0
"Honduras","2024-12-26",0,0,0,0,0,0,0,0
"Honduras","2024-12-27",0,0,0,0,0,0,0,0
"Honduras","2024-12-28",0,0,0,0,0,0,0,0
"Honduras","2024-12-29",0,0,0,0,0,0,0,0
"Honduras","2024-12-30",0,0,0,0,0,0,0,0
"Honduras","2024-12-31",0,0,0,0,0,0,0,0
"Honduras","2025-01-01",0,0,0,0,0,0,0,0
"Honduras","2025-01-02",0,0,0,0,0,0,0,0
"Honduras","2025-01-03",0,0,0,0,0,0,0,0
"Honduras","2025-01-04",0,0,0,0,0,0,0,0
"Honduras","2025-01-05",0,0,0,0,0,0,0,0
"Honduras","2025-01-06",0,0,0,0,0,0,0,0
"Honduras","2025-01-07",0,0,0,0,0,0,0,0
"Honduras","2025-01-08",0,0,0,0,0,0,0,0
"Honduras","2025-01-09",0,0,0,0,0,0,0,0
"Honduras","2025-01-10",0,0,0,0,0,0,0,0
"Honduras","2025-01-11",0,0,0,0,0,0,0,0
"Honduras","2025-01-12",0,0,0,0,0,0,0,0
"Honduras","2025-01-13",0,0,0,0,0,0,0,0
"Hungary","2024-01-01",0,0,0,0,0,0,0,0
"Hungary","2024-01-02",0,0,0,0,0,0,0,0
"Hungary","2024-01-03",0,0,0,0,0,0,0,0
"Hungary","2024-01-04",0,0,0,0,0,0,0,0
"Hungary","2024-01-05",0,0,0,0,0,0,0,0
"Hungary","2024-01-06",0,0,0,0,0,0,0,0
"Hungary","2024-01-07",0,0,0,0,0,0,0,0
"Hungary","2024-01-08",0,0,0,0,0,0,0,0
"Hungary","2024-01-09",0,0,0,0,0,0,0,0
"Hungary","2024-01-10",0,0,0,0,0,0,0,0
"Hungary","2024-01-11",0,0,0,0,0,0,0,0
"Hungary","2024-01-12",0,0,0,0,0,0,0,0
"Hungary","2024-01-13",0,0,0,0,0,0,0,0
"Hungary","2024-01-14",0,0,0,0,0,0,0,0
"Hungary","2024-01-15",0,0,0,0,0,0,0,0
"Hungary","2024-01-16",0,0,0,0,0,0,0,0
"Hungary","2024-01-17",0,0,0,0,0,0,0,0
"Hungary","2024-01-18",0,0,0,0,0,0,0,0
"Hungary","2024-01-19",0,0,0,0,0,0,0,0
"Hungary","2024-01-20",0,0,0,0,0,0,0,0
"Hungary","2024-01-21",0,0,0,0,0,0,0,0
"Hungary","2024-01-22",0,0,0,0,0,0,0,0
"Hungary","2024-01-23",0,0,0,0,0,0,0,0
"Hungary","2024-01-24",0,0,0,0,0,0,0,0
"Hungary","2024-01-25",0,0,0,0,0,0,0,0
"Hungary","2024-01-26",0,0,0,0,0,0,0,0
"Hungary","2024-01-27",0,0,0,0,0,0,0,0
"Hungary","2024-01-28",0,0,0,0,0,0,0,0
"Hungary","2024-01-29",0,0,0,0,0,0,0,0
"Hungary","2024-01-30",0,0,0,0,0,0,0,0
"Hungary","2024-01-31",0,1,1,0,1,1,0,0
"Hungary","2024-02-01",0,0,1,0,0,1,0,0
"Hungary","2024-02-02",0,0,1,0,0,1,0,0
"Hungary","2024-02-03",0,0,1,0,0,1,0,0
"Hungary","2024-02-04",0,0,1,0,0,1,0,0
"Hungary","2024-02-05",0,0,1,0,0,1,0,0
"Hungary","2024-02-06",0,0,1,0,0,1,0,0
"Hungary","2024-02-07",0,0,1,0,0,1,0,0
"Hungary","2024-02-08",0,0,1,0,0,1,0,0
"Hungary","2024-02-09",0,0,1,0,0,1,0,0
"Hungary","2024-02-10",0,0,1,0,0,1,0,0
"Hungary","2024-02-11",0,0,1,0,0,1,0,0
"Hungary","2024-02-12",0,0,1,0,0,1,0,0
"Hungary","2024-02-13",0,0,1,0,0,1,0,0
"Hungary","2024-02-14",0,0,1,0,0,1,0,0
"Hungary","2024-02-15",0,0,1,0,0,1,0,0
"Hungary","2024-02-16",0,0,1,0,0,1,0,0
"Hungary","2024-02-17",0,0,1,0,0,1,0,0
"Hungary","2024-02-18",0,0,1,0,0,1,0,0
"Hungary","2024-02-19",0,0,1,0,0,1,0,0
"Hungary","2024-02-20",0,0,1,0,0,1,0,0
"Hungary","2024-02-21",0,0,1,0,0,1,0,0
"Hungary","2024-02-22",0,0,1,0,0,1,0,0
"Hungary","2024-02-23",0,0,1,0,0,1,0,0
"Hungary","2024-02-24",0,0,1,0,0,1,0,0
"Hungary","2024-02-25",0,0,1,0,0,1,0,0
"Hungary","2024-02-26",0,0,1,0,0,1,0,0
"Hungary","2024-02-27",0,0,1,0,0,1,0,0
"Hungary","2024-02-28",0,0,1,0,0,1,0,0
"Hungary","2024-02-29",0,0,1,0,0,1,0,0
"Hungary","2024-03-01",0,0,1,0,0,1,0,0
"Hungary","2024-03-02",0,0,1,0,0,1,0,0
"Hungary","2024-03-03",0,0,1,0,0,1,0,0
"Hungary","2024-03-04",0,0,1,0,0,1,0,0
"Hungary","2024-03-05",0,0,1,0,0,1,0,0
"Hungary","2024-03-06",0,0,1,0,0,1,0,0
"Hungary","2024-03-07",0,0,1,0,0,1,0,0
"Hungary","2024-03-08",0,0,1,0,0,1,0,0
"Hungary","2024-03-09",0,0,1,0,1,2,0,0
"Hungary","2024-03-10",0,0,1,0,0,2,0,0
"Hungary","2024-03-11",0,0,1,0,0,2,0,0
"Hungary","2024-03-12",0,0,1,0,0,2,0,0
"Hungary","2024-03-13",0,0,1,0,0,2,0,0
"Hungary","2024-03-14",0,0,1,0,0,2,0,0
"Hungary","2024-03-15",0,0,1,0,0,2,0,0
"Hungary","2024-03-16",0,0,1,0,0,2,0,0
"Hungary","2024-03-17",0,0,1,0,0,2,0,0
"Hungary","2024-03-18",0,0,1,0,0,2,0,0
"Hungary","2024-03-19",0,0,1,0,0,2,0,0
"Hungary","2024-03-20",0,0,1,0,0,2,0,0
"Hungary","2024-03-21",0,0,1,0,0,2,0,0
"Hungary","2024-03-22",0,0,1,0,0,2,0,0
"Hungary","2024-03-23",0,0,1,0,0,2,0,0
"Hungary","2024-03-24",0,0,1,0,0,2,0,0
"Hungary","2024-03-25",0,0,1,0,0,2,0,0
"Hungary","2024-03-26",0,0,1,0,0,2,0,0
"Hungary","2024-03-27",0,0,1,0,0,2,0,0
"Hungary","2024-03-28",0,0,1,0,0,2,0,0
"Hungary","2024-03-29",0,0,1,0,0,2,0,0
"Hungary","2024-03-30",0,0,1,0,0,2,0,0
"Hungary","2024-03-31",0,0,1,0,0,2,0,0
"Hungary","2024-04-01",0,0,1,0,0,2,0,0
"Hungary","2024-04-02",0,0,1,0,0,2,0,0
"Hungary","2024-04-03",0,0,1,0,0,2,0,0
"Hungary","2024-04-04",0,0,1,0,0,2,0,0
"Hungary","2024-04-05",0,0,1,0,0,2,0,0
"Hungary","2024-04-06",0,0,1,0,0,2,0,0
"Hungary","2024-04-07",0,0,1,0,0,2,0,0
"Hungary","2024-04-08",0,0,1,0,0,2,0,0
"Hungary","2024-04-09",0,0,1,0,0,2,0,0
"Hungary","2024-04-10",0,0,1,0,0,2,0,0
"Hungary","2024-04-11",0,0,1,0,0,2,0,0
"Hungary","2024-04-12",0,0,1,0,0,2,0,0
"Hungary","2024-04-13",0,0,1,0,0,2,0,0
"Hungary","2024-04-14",0,0,1,0,0,2,0,0
"Hungary","2024-04-15",0,0,1,0,0,2,0,0
"Hungary","2024-04-16",0,0,1,0,0,2,0,0
"Hungary","2024-04-17",0,0,1,0,0,2,0,0
"Hungary","2024-04-18",0,0,1,0,0,2,0,0
"Hungary","2024-04-19",0,0,1,0,0,2,0,0
"Hungary","2024-04-20",0,0,1,0,0,2,0,0
"Hungary","2024-04-21",0,0,1,0,0,2,0,0
"Hungary","2024-04-22",0,0,1,0,0,2,0,0
"Hungary","2024-04-23",0,0,1,0,0,2,0,0
"Hungary","2024-04-24",0,0,1,0,0,2,0,0
"Hungary","2024-04-25",0,0,1,0,0,2,0,0
"Hungary","2024-04-26",0,0,1,0,0,2,0,0
"Hungary","2024-04-27",0,0,1,0,0,2,0,0
"Hungary","2024-04-28",0,0,1,0,0,2,0,0
"Hungary","2024-04-29",0,0,1,0,0,2,0,0
"Hungary","2024-04-30",0,0,1,0,0,2,0,0
"Hungary","2024-05-01",0,0,1,0,0,2,0,0
"Hungary","2024-05-02",0,0,1,0,0,2,0,0
"Hungary","2024-05-03",0,0,1,0,0,2,0,0
"Hungary","2024-05-04",0,0,1,0,0,2,0,0
"Hungary","2024-05-05",0,0,1,0,0,2,0,0
"Hungary","2024-05-06",0,0,1,0,0,2,0,0
"Hungary","2024-05-07",0,0,1,0,0,2,0,0
"Hungary","2024-05-08",0,0,1,0,0,2,0,0
"Hungary","2024-05-09",0,0,1,0,0,2,0,0
"Hungary","2024-05-10",0,0,1,0,0,2,0,0
"Hungary","2024-05-11",0,0,1,0,0,2,0,0
"Hungary","2024-05-12",0,0,1,0,0,2,0,0
"Hungary","2024-05-13",0,0,1,0,0,2,0,0
"Hungary","2024-05-14",0,0,1,0,0,2,0,0
"Hungary","2024-05-15",0,0,1,0,0,2,0,0
"Hungary","2024-05-16",0,0,1,0,0,2,0,0
"Hungary","2024-05-17",0,0,1,0,0,2,0,0
"Hungary","2024-05-18",0,0,1,0,0,2,0,0
"Hungary","2024-05-19",0,0,1,0,0,2,0,0
"Hungary","2024-05-20",0,0,1,0,0,2,0,0
"Hungary","2024-05-21",0,0,1,0,0,2,0,0
"Hungary","2024-05-22",0,0,1,0,0,2,0,0
"Hungary","2024-05-23",0,0,1,0,0,2,0,0
"Hungary","2024-05-24",0,0,1,0,1,3,0,0
"Hungary","2024-05-25",0,0,1,0,0,3,0,0
"Hungary","2024-05-26",0,0,1,0,0,3,0,0
"Hungary","2024-05-27",0,0,1,0,0,3,0,0
"Hungary","2024-05-28",0,0,1,0,0,3,0,0
"Hungary","2024-05-29",0,0,1,0,0,3,0,0
"Hungary","2024-05-30",0,0,1,0,0,3,0,0
"Hungary","2024-05-31",0,0,1,0,0,3,0,0
"Hungary","2024-06-01",0,0,1,0,0,3,0,0
"Hungary","2024-06-02",0,0,1,0,0,3,0,0
"Hungary","2024-06-03",0,0,1,0,0,3,0,0
"Hungary","2024-06-04",0,0,1,0,0,3,0,0
"Hungary","2024-06-05",0,0,1,0,0,3,0,0
"Hungary","2024-06-06",0,0,1,0,0,3,0,0
"Hungary","2024-06-07",0,0,1,0,0,3,0,0
"Hungary","2024-06-08",0,0,1,0,0,3,0,0
"Hungary","2024-06-09",0,0,1,0,0,3,0,0
"Hungary","2024-06-10",0,0,1,0,0,3,0,0
"Hungary","2024-06-11",0,0,1,0,0,3,0,0
"Hungary","2024-06-12",0,0,1,0,0,3,0,0
"Hungary","2024-06-13",0,0,1,0,0,3,0,0
"Hungary","2024-06-14",0,0,1,0,0,3,0,0
"Hungary","2024-06-15",0,0,1,0,0,3,0,0
"Hungary","2024-06-16",0,0,1,0,0,3,0,0
"Hungary","2024-06-17",0,0,1,0,0,3,0,0
"Hungary","2024-06-18",0,0,1,0,0,3,0,0
"Hungary","2024-06-19",0,0,1,0,0,3,0,0
"Hungary","2024-06-20",0,0,1,0,0,3,0,0
"Hungary","2024-06-21",0,0,1,0,0,3,0,0
"Hungary","2024-06-22",0,0,1,0,0,3,0,0
"Hungary","2024-06-23",0,0,1,0,0,3,0,0
"Hungary","2024-06-24",0,0,1,0,0,3,0,0
"Hungary","2024-06-25",0,0,1,0,0,3,0,0
"Hungary","2024-06-26",0,0,1,0,0,3,0,0
"Hungary","2024-06-27",0,0,1,0,0,3,0,0
"Hungary","2024-06-28",0,0,1,0,0,3,0,0
"Hungary","2024-06-29",0,0,1,0,0,3,0,0
"Hungary","2024-06-30",0,2,3,0,0,3,0,0
"Hungary","2024-07-01",0,0,3,0,0,3,0,0
"Hungary","2024-07-02",0,0,3,0,0,3,0,0
"Hungary","2024-07-03",0,0,3,0,0,3,0,0
"Hungary","2024-07-04",0,0,3,0,0,3,0,0
"Hungary","2024-07-05",0,0,3,0,0,3,0,0
"Hungary","2024-07-06",0,0,3,0,0,3,0,0
"Hungary","2024-07-07",0,0,3,0,0,3,0,0
"Hungary","2024-07-08",0,0,3,0,0,3,0,0
"Hungary","2024-07-09",0,0,3,0,0,3,0,0
"Hungary","2024-07-10",0,0,3,0,0,3,0,0
"Hungary","2024-07-11",0,0,3,0,0,3,0,0
"Hungary","2024-07-12",0,0,3,0,0,3,0,0
"Hungary","2024-07-13",0,0,3,0,0,3,0,0
"Hungary","2024-07-14",0,0,3,0,0,3,0,0
"Hungary","2024-07-15",0,0,3,0,0,3,0,0
"Hungary","2024-07-16",0,0,3,0,0,3,0,0
"Hungary","2024-07-17",0,0,3,0,0,3,0,0
"Hungary","2024-07-18",0,0,3,0,0,3,0,0
"Hungary","2024-07-19",0,0,3,0,0,3,0,0
"Hungary","2024-07-20",0,0,3,0,0,3,0,0
"Hungary","2024-07-21",0,0,3,0,0,3,0,0
"Hungary","2024-07-22",0,0,3,0,0,3,0,0
"Hungary","2024-07-23",0,0,3,0,0,3,0,0
"Hungary","2024-07-24",0,0,3,0,0,3,0,0
"Hungary","2024-07-25",0,0,3,0,0,3,0,0
"Hungary","2024-07-26",0,0,3,0,0,3,0,0
"Hungary","2024-07-27",0,0,3,0,0,3,0,0
"Hungary","2024-07-28",0,0,3,0,0,3,0,0
"Hungary","2024-07-29",0,0,3,0,0,3,0,0
"Hungary","2024-07-30",0,0,3,0,0,3,0,0
"Hungary","2024-07-31",0,0,3,0,0,3,0,0
"Hungary","2024-08-01",0,0,3,0,0,3,0,0
"Hungary","2024-08-02",0,0,3,0,0,3,0,0
"Hungary","2024-08-03",0,0,3,0,0,3,0,0
"Hungary","2024-08-04",0,0,3,0,0,3,0,0
"Hungary","2024-08-05",0,0,3,0,0,3,0,0
"Hungary","2024-08-06",0,0,3,0,0,3,0,0
"Hungary","2024-08-07",0,0,3,0,0,3,0,0
"Hungary","2024-08-08",0,0,3,0,0,3,0,0
"Hungary","2024-08-09",0,0,3,0,0,3,0,0
"Hungary","2024-08-10",0,0,3,0,0,3,0,0
"Hungary","2024-08-11",0,0,3,0,0,3,0,0
"Hungary","2024-08-12",0,0,3,0,0,3,0,0
"Hungary","2024-08-13",0,0,3,0,0,3,0,0
"Hungary","2024-08-14",0,0,3,0,0,3,0,0
"Hungary","2024-08-15",0,0,3,0,0,3,0,0
"Hungary","2024-08-16",0,0,3,0,0,3,0,0
"Hungary","2024-08-17",0,0,3,0,0,3,0,0
"Hungary","2024-08-18",0,0,3,0,0,3,0,0
"Hungary","2024-08-19",0,0,3,0,0,3,0,0
"Hungary","2024-08-20",0,0,3,0,0,3,0,0
"Hungary","2024-08-21",0,0,3,0,0,3,0,0
"Hungary","2024-08-22",0,0,3,0,0,3,0,0
"Hungary","2024-08-23",0,0,3,0,0,3,0,0
"Hungary","2024-08-24",0,0,3,0,0,3,0,0
"Hungary","2024-08-25",0,0,3,0,0,3,0,0
"Hungary","2024-08-26",0,0,3,0,0,3,0,0
"Hungary","2024-08-27",0,0,3,0,0,3,0,0
"Hungary","2024-08-28",0,0,3,0,0,3,0,0
"Hungary","2024-08-29",0,0,3,0,0,3,0,0
"Hungary","2024-08-30",0,0,3,0,0,3,0,0
"Hungary","2024-08-31",0,0,3,0,0,3,0,0
"Hungary","2024-09-01",0,0,3,0,0,3,0,0
"Hungary","2024-09-02",0,0,3,0,0,3,0,0
"Hungary","2024-09-03",0,0,3,0,0,3,0,0
"Hungary","2024-09-04",0,0,3,0,0,3,0,0
"Hungary","2024-09-05",0,0,3,0,0,3,0,0
"Hungary","2024-09-06",0,0,3,0,0,3,0,0
"Hungary","2024-09-07",0,0,3,0,0,3,0,0
"Hungary","2024-09-08",0,0,3,0,0,3,0,0
"Hungary","2024-09-09",0,0,3,0,0,3,0,0
"Hungary","2024-09-10",0,0,3,0,0,3,0,0
"Hungary","2024-09-11",0,0,3,0,0,3,0,0
"Hungary","2024-09-12",0,0,3,0,0,3,0,0
"Hungary","2024-09-13",0,0,3,0,0,3,0,0
"Hungary","2024-09-14",0,0,3,0,0,3,0,0
"Hungary","2024-09-15",0,0,3,0,0,3,0,0
"Hungary","2024-09-16",0,0,3,0,0,3,0,0
"Hungary","2024-09-17",0,0,3,0,0,3,0,0
"Hungary","2024-09-18",0,0,3,0,0,3,0,0
"Hungary","2024-09-19",0,0,3,0,0,3,0,0
"Hungary","2024-09-20",0,0,3,0,0,3,0,0
"Hungary","2024-09-21",0,0,3,0,0,3,0,0
"Hungary","2024-09-22",0,0,3,0,0,3,0,0
"Hungary","2024-09-23",0,0,3,0,0,3,0,0
"Hungary","2024-09-24",0,0,3,0,0,3,0,0
"Hungary","2024-09-25",0,0,3,0,0,3,0,0
"Hungary","2024-09-26",0,0,3,0,0,3,0,0
"Hungary","2024-09-27",0,0,3,0,0,3,0,0
"Hungary","2024-09-28",0,0,3,0,0,3,0,0
"Hungary","2024-09-29",0,0,3,0,0,3,0,0
"Hungary","2024-09-30",0,0,3,0,0,3,0,0
"Hungary","2024-10-01",0,0,3,0,0,3,0,0
"Hungary","2024-10-02",0,0,3,0,0,3,0,0
"Hungary","2024-10-03",0,0,3,0,0,3,0,0
"Hungary","2024-10-04",0,0,3,0,0,3,0,0
"Hungary","2024-10-05",0,0,3,0,0,3,0,0
"Hungary","2024-10-06",0,0,3,0,0,3,0,0
"Hungary","2024-10-07",0,0,3,0,0,3,0,0
"Hungary","2024-10-08",0,0,3,0,0,3,0,0
"Hungary","2024-10-09",0,0,3,0,0,3,0,0
"Hungary","2024-10-10",0,0,3,0,0,3,0,0
"Hungary","2024-10-11",0,0,3,0,0,3,0,0
"Hungary","2024-10-12",0,0,3,0,0,3,0,0
"Hungary","2024-10-13",0,0,3,0,0,3,0,0
"Hungary","2024-10-14",0,0,3,0,0,3,0,0
"Hungary","2024-10-15",0,0,3,0,0,3,0,0
"Hungary","2024-10-16",0,0,3,0,0,3,0,0
"Hungary","2024-10-17",0,0,3,0,0,3,0,0
"Hungary","2024-10-18",0,0,3,0,0,3,0,0
"Hungary","2024-10-19",0,0,3,0,0,3,0,0
"Hungary","2024-10-20",0,0,3,0,0,3,0,0
"Hungary","2024-10-21",0,0,3,0,0,3,0,0
"Hungary","2024-10-22",0,0,3,0,0,3,0,0
"Hungary","2024-10-23",0,0,3,0,0,3,0,0
"Hungary","2024-10-24",0,0,3,0,0,3,0,0
"Hungary","2024-10-25",0,0,3,0,0,3,0,0
"Hungary","2024-10-26",0,0,3,0,0,3,0,0
"Hungary","2024-10-27",0,0,3,0,0,3,0,0
"Hungary","2024-10-28",0,0,3,0,0,3,0,0
"Hungary","2024-10-29",0,0,3,0,0,3,0,0
"Hungary","2024-10-30",0,0,3,0,0,3,0,0
"Hungary","2024-10-31",0,0,3,0,0,3,0,0
"Hungary","2024-11-01",0,0,3,0,0,3,0,0
"Hungary","2024-11-02",0,0,3,0,0,3,0,0
"Hungary","2024-11-03",0,0,3,0,0,3,0,0
"Hungary","2024-11-04",0,0,3,0,0,3,0,0
"Hungary","2024-11-05",0,0,3,0,0,3,0,0
"Hungary","2024-11-06",0,0,3,0,0,3,0,0
"Hungary","2024-11-07",0,0,3,0,0,3,0,0
"Hungary","2024-11-08",0,0,3,0,0,3,0,0
"Hungary","2024-11-09",0,0,3,0,0,3,0,0
"Hungary","2024-11-10",0,0,3,0,0,3,0,0
"Hungary","2024-11-11",0,0,3,0,0,3,0,0
"Hungary","2024-11-12",0,0,3,0,0,3,0,0
"Hungary","2024-11-13",0,0,3,0,0,3,0,0
"Hungary","2024-11-14",0,0,3,0,0,3,0,0
"Hungary","2024-11-15",0,0,3,0,0,3,0,0
"Hungary","2024-11-16",0,0,3,0,0,3,0,0
"Hungary","2024-11-17",0,0,3,0,0,3,0,0
"Hungary","2024-11-18",0,0,3,0,0,3,0,0
"Hungary","2024-11-19",0,0,3,0,0,3,0,0
"Hungary","2024-11-20",0,0,3,0,0,3,0,0
"Hungary","2024-11-21",0,0,3,0,0,3,0,0
"Hungary","2024-11-22",0,0,3,0,0,3,0,0
"Hungary","2024-11-23",0,0,3,0,0,3,0,0
"Hungary","2024-11-24",0,0,3,0,0,3,0,0
"Hungary","2024-11-25",0,0,3,0,0,3,0,0
"Hungary","2024-11-26",0,0,3,0,0,3,0,0
"Hungary","2024-11-27",0,0,3,0,0,3,0,0
"Hungary","2024-11-28",0,0,3,0,0,3,0,0
"Hungary","2024-11-29",0,0,3,0,0,3,0,0
"Hungary","2024-11-30",0,0,3,0,0,3,0,0
"Hungary","2024-12-01",0,0,3,0,0,3,0,0
"Hungary","2024-12-02",0,0,3,0,0,3,0,0
"Hungary","2024-12-03",0,0,3,0,0,3,0,0
"Hungary","2024-12-04",0,0,3,0,0,3,0,0
"Hungary","2024-12-05",0,0,3,0,0,3,0,0
"Hungary","2024-12-06",0,0,3,0,0,3,0,0
"Hungary","2024-12-07",0,0,3,0,0,3,0,0
"Hungary","2024-12-08",0,0,3,0,0,3,0,0
"Hungary","2024-12-09",0,0,3,0,0,3,0,0
"Hungary","2024-12-10",0,0,3,0,0,3,0,0
"Hungary","2024-12-11",0,0,3,0,0,3,0,0
"Hungary","2024-12-12",0,0,3,0,0,3,0,0
"Hungary","2024-12-13",0,0,3,0,0,3,0,0
"Hungary","2024-12-14",0,0,3,0,0,3,0,0
"Hungary","2024-12-15",0,0,3,0,0,3,0,0
"Hungary","2024-12-16",0,0,3,0,0,3,0,0
"Hungary","2024-12-17",0,0,3,0,0,3,0,0
"Hungary","2024-12-18",0,0,3,0,0,3,0,0
"Hungary","2024-12-19",0,0,3,0,0,3,0,0
"Hungary","2024-12-20",0,0,3,0,0,3,0,0
"Hungary","2024-12-21",0,0,3,0,0,3,0,0
"Hungary","2024-12-22",0,0,3,0,0,3,0,0
"Hungary","2024-12-23",0,0,3,0,0,3,0,0
"Hungary","2024-12-24",0,0,3,0,0,3,0,0
"Hungary","2024-12-25",0,0,3,0,0,3,0,0
"Hungary","2024-12-26",0,0,3,0,0,3,0,0
"Hungary","2024-12-27",0,0,3,0,0,3,0,0
"Hungary","2024-12-28",0,0,3,0,0,3,0,0
"Hungary","2024-12-29",0,0,3,0,0,3,0,0
"Hungary","2024-12-30",0,0,3,0,0,3,0,0
"Hungary","2024-12-31",0,0,3,0,0,3,0,0
"Hungary","2025-01-01",0,0,3,0,0,3,0,0
"Hungary","2025-01-02",0,0,3,0,0,3,0,0
"Hungary","2025-01-03",0,0,3,0,0,3,0,0
"Hungary","2025-01-04",0,0,3,0,0,3,0,0
"Hungary","2025-01-05",0,0,3,0,0,3,0,0
"Hungary","2025-01-06",0,0,3,0,0,3,0,0
"Hungary","2025-01-07",0,0,3,0,0,3,0,0
"Hungary","2025-01-08",0,0,3,0,0,3,0,0
"Hungary","2025-01-09",0,0,3,0,0,3,0,0
"Hungary","2025-01-10",0,0,3,0,0,3,0,0
"Hungary","2025-01-11",0,0,3,0,0,3,0,0
"Hungary","2025-01-12",0,0,3,0,0,3,0,0
"Hungary","2025-01-13",0,0,3,0,0,3,0,0
"Iceland","2024-01-01",0,0,0,0,0,0,0,0
"Iceland","2024-01-02",0,0,0,0,0,0,0,0
"Iceland","2024-01-03",0,0,0,0,0,0,0,0
"Iceland","2024-01-04",0,0,0,0,0,0,0,0
"Iceland","2024-01-05",0,0,0,0,0,0,0,0
"Iceland","2024-01-06",0,0,0,0,0,0,0,0
"Iceland","2024-01-07",0,0,0,0,0,0,0,0
"Iceland","2024-01-08",0,0,0,0,0,0,0,0
"Iceland","2024-01-09",0,0,0,0,0,0,0,0
"Iceland","2024-01-10",0,0,0,0,0,0,0,0
"Iceland","2024-01-11",0,0,0,0,0,0,0,0
"Iceland","2024-01-12",0,0,0,0,0,0,0,0
"Iceland","2024-01-13",0,0,0,0,0,0,0,0
"Iceland","2024-01-14",0,0,0,0,0,0,0,0
"Iceland","2024-01-15",0,0,0,0,0,0,0,0
"Iceland","2024-01-16",0,0,0,0,0,0,0,0
"Iceland","2024-01-17",0,0,0,0,0,0,0,0
"Iceland","2024-01-18",0,0,0,0,0,0,0,0
"Iceland","2024-01-19",0,0,0,0,0,0,0,0
"Iceland","2024-01-20",0,0,0,0,0,0,0,0
"Iceland","2024-01-21",0,0,0,0,0,0,0,0
"Iceland","2024-01-22",0,0,0,0,0,0,0,0
"Iceland","2024-01-23",0,0,0,0,0,0,0,0
"Iceland","2024-01-24",0,0,0,0,0,0,0,0
"Iceland","2024-01-25",0,0,0,0,0,0,0,0
"Iceland","2024-01-26",0,0,0,0,0,0,0,0
"Iceland","2024-01-27",0,0,0,0,0,0,0,0
"Iceland","2024-01-28",0,0,0,0,0,0,0,0
"Iceland","2024-01-29",0,0,0,0,0,0,0,0
"Iceland","2024-01-30",0,0,0,0,0,0,0,0
"Iceland","2024-01-31",0,0,0,0,0,0,0,0
"Iceland","2024-02-01",0,0,0,0,0,0,0,0
"Iceland","2024-02-02",0,0,0,0,0,0,0,0
"Iceland","2024-02-03",0,0,0,0,0,0,0,0
"Iceland","2024-02-04",0,0,0,0,0,0,0,0
"Iceland","2024-02-05",0,0,0,0,0,0,0,0
"Iceland","2024-02-06",0,0,0,0,0,0,0,0
"Iceland","2024-02-07",0,0,0,0,0,0,0,0
"Iceland","2024-02-08",0,0,0,0,0,0,0,0
"Iceland","2024-02-09",0,0,0,0,0,0,0,0
"Iceland","2024-02-10",0,0,0,0,0,0,0,0
"Iceland","2024-02-11",0,0,0,0,0,0,0,0
"Iceland","2024-02-12",0,0,0,0,0,0,0,0
"Iceland","2024-02-13",0,0,0,0,0,0,0,0
"Iceland","2024-02-14",0,0,0,0,0,0,0,0
"Iceland","2024-02-15",0,0,0,0,0,0,0,0
"Iceland","2024-02-16",0,0,0,0,0,0,0,0
"Iceland","2024-02-17",0,0,0,0,0,0,0,0
"Iceland","2024-02-18",0,0,0,0,0,0,0,0
"Iceland","2024-02-19",0,0,0,0,0,0,0,0
"Iceland","2024-02-20",0,0,0,0,0,0,0,0
"Iceland","2024-02-21",0,0,0,0,0,0,0,0
"Iceland","2024-02-22",0,0,0,0,0,0,0,0
"Iceland","2024-02-23",0,0,0,0,0,0,0,0
"Iceland","2024-02-24",0,0,0,0,0,0,0,0
"Iceland","2024-02-25",0,0,0,0,0,0,0,0
"Iceland","2024-02-26",0,0,0,0,0,0,0,0
"Iceland","2024-02-27",0,0,0,0,0,0,0,0
"Iceland","2024-02-28",0,0,0,0,0,0,0,0
"Iceland","2024-02-29",0,0,0,0,0,0,0,0
"Iceland","2024-03-01",0,0,0,0,0,0,0,0
"Iceland","2024-03-02",0,0,0,0,0,0,0,0
"Iceland","2024-03-03",0,0,0,0,0,0,0,0
"Iceland","2024-03-04",0,0,0,0,0,0,0,0
"Iceland","2024-03-05",0,0,0,0,0,0,0,0
"Iceland","2024-03-06",0,0,0,0,0,0,0,0
"Iceland","2024-03-07",0,0,0,0,0,0,0,0
"Iceland","2024-03-08",0,0,0,0,0,0,0,0
"Iceland","2024-03-09",0,0,0,0,0,0,0,0
"Iceland","2024-03-10",0,0,0,0,0,0,0,0
"Iceland","2024-03-11",0,0,0,0,0,0,0,0
"Iceland","2024-03-12",0,0,0,0,0,0,0,0
"Iceland","2024-03-13",0,0,0,0,0,0,0,0
"Iceland","2024-03-14",0,0,0,0,0,0,0,0
"Iceland","2024-03-15",0,0,0,0,0,0,0,0
"Iceland","2024-03-16",0,0,0,0,0,0,0,0
"Iceland","2024-03-17",0,0,0,0,0,0,0,0
"Iceland","2024-03-18",0,0,0,0,0,0,0,0
"Iceland","2024-03-19",0,0,0,0,0,0,0,0
"Iceland","2024-03-20",0,0,0,0,0,0,0,0
"Iceland","2024-03-21",0,0,0,0,0,0,0,0
"Iceland","2024-03-22",0,0,0,0,0,0,0,0
"Iceland","2024-03-23",0,0,0,0,0,0,0,0
"Iceland","2024-03-24",0,0,0,0,0,0,0,0
"Iceland","2024-03-25",0,0,0,0,0,0,0,0
"Iceland","2024-03-26",0,0,0,0,0,0,0,0
"Iceland","2024-03-27",0,0,0,0,0,0,0,0
"Iceland","2024-03-28",0,0,0,0,0,0,0,0
"Iceland","2024-03-29",0,0,0,0,0,0,0,0
"Iceland","2024-03-30",0,0,0,0,0,0,0,0
"Iceland","2024-03-31",0,0,0,0,0,0,0,0
"Iceland","2024-04-01",0,0,0,0,0,0,0,0
"Iceland","2024-04-02",0,0,0,0,0,0,0,0
"Iceland","2024-04-03",0,0,0,0,0,0,0,0
"Iceland","2024-04-04",0,0,0,0,0,0,0,0
"Iceland","2024-04-05",0,0,0,0,0,0,0,0
"Iceland","2024-04-06",0,0,0,0,0,0,0,0
"Iceland","2024-04-07",0,0,0,0,0,0,0,0
"Iceland","2024-04-08",0,0,0,0,0,0,0,0
"Iceland","2024-04-09",0,0,0,0,0,0,0,0
"Iceland","2024-04-10",0,0,0,0,0,0,0,0
"Iceland","2024-04-11",0,0,0,0,0,0,0,0
"Iceland","2024-04-12",0,0,0,0,0,0,0,0
"Iceland","2024-04-13",0,0,0,0,0,0,0,0
"Iceland","2024-04-14",0,0,0,0,0,0,0,0
"Iceland","2024-04-15",0,0,0,0,0,0,0,0
"Iceland","2024-04-16",0,0,0,0,0,0,0,0
"Iceland","2024-04-17",0,0,0,0,0,0,0,0
"Iceland","2024-04-18",0,0,0,0,0,0,0,0
"Iceland","2024-04-19",0,0,0,0,0,0,0,0
"Iceland","2024-04-20",0,0,0,0,0,0,0,0
"Iceland","2024-04-21",0,0,0,0,0,0,0,0
"Iceland","2024-04-22",0,0,0,0,0,0,0,0
"Iceland","2024-04-23",0,0,0,0,0,0,0,0
"Iceland","2024-04-24",0,0,0,0,0,0,0,0
"Iceland","2024-04-25",0,0,0,0,0,0,0,0
"Iceland","2024-04-26",0,0,0,0,0,0,0,0
"Iceland","2024-04-27",0,0,0,0,0,0,0,0
"Iceland","2024-04-28",0,0,0,0,0,0,0,0
"Iceland","2024-04-29",0,0,0,0,0,0,0,0
"Iceland","2024-04-30",0,0,0,0,0,0,0,0
"Iceland","2024-05-01",0,0,0,0,0,0,0,0
"Iceland","2024-05-02",0,0,0,0,0,0,0,0
"Iceland","2024-05-03",0,0,0,0,0,0,0,0
"Iceland","2024-05-04",0,0,0,0,0,0,0,0
"Iceland","2024-05-05",0,0,0,0,0,0,0,0
"Iceland","2024-05-06",0,0,0,0,0,0,0,0
"Iceland","2024-05-07",0,0,0,0,0,0,0,0
"Iceland","2024-05-08",0,0,0,0,0,0,0,0
"Iceland","2024-05-09",0,0,0,0,0,0,0,0
"Iceland","2024-05-10",0,0,0,0,0,0,0,0
"Iceland","2024-05-11",0,0,0,0,0,0,0,0
"Iceland","2024-05-12",0,0,0,0,0,0,0,0
"Iceland","2024-05-13",0,0,0,0,0,0,0,0
"Iceland","2024-05-14",0,0,0,0,0,0,0,0
"Iceland","2024-05-15",0,0,0,0,0,0,0,0
"Iceland","2024-05-16",0,0,0,0,0,0,0,0
"Iceland","2024-05-17",0,0,0,0,0,0,0,0
"Iceland","2024-05-18",0,0,0,0,0,0,0,0
"Iceland","2024-05-19",0,0,0,0,0,0,0,0
"Iceland","2024-05-20",0,0,0,0,0,0,0,0
"Iceland","2024-05-21",0,0,0,0,0,0,0,0
"Iceland","2024-05-22",0,0,0,0,0,0,0,0
"Iceland","2024-05-23",0,0,0,0,0,0,0,0
"Iceland","2024-05-24",0,0,0,0,0,0,0,0
"Iceland","2024-05-25",0,0,0,0,0,0,0,0
"Iceland","2024-05-26",0,0,0,0,0,0,0,0
"Iceland","2024-05-27",0,0,0,0,0,0,0,0
"Iceland","2024-05-28",0,0,0,0,0,0,0,0
"Iceland","2024-05-29",0,0,0,0,0,0,0,0
"Iceland","2024-05-30",0,0,0,0,0,0,0,0
"Iceland","2024-05-31",0,0,0,0,0,0,0,0
"Iceland","2024-06-01",0,0,0,0,0,0,0,0
"Iceland","2024-06-02",0,0,0,0,0,0,0,0
"Iceland","2024-06-03",0,0,0,0,0,0,0,0
"Iceland","2024-06-04",0,0,0,0,0,0,0,0
"Iceland","2024-06-05",0,0,0,0,0,0,0,0
"Iceland","2024-06-06",0,0,0,0,0,0,0,0
"Iceland","2024-06-07",0,0,0,0,0,0,0,0
"Iceland","2024-06-08",0,0,0,0,0,0,0,0
"Iceland","2024-06-09",0,0,0,0,0,0,0,0
"Iceland","2024-06-10",0,0,0,0,0,0,0,0
"Iceland","2024-06-11",0,0,0,0,0,0,0,0
"Iceland","2024-06-12",0,0,0,0,0,0,0,0
"Iceland","2024-06-13",0,0,0,0,0,0,0,0
"Iceland","2024-06-14",0,0,0,0,0,0,0,0
"Iceland","2024-06-15",0,0,0,0,0,0,0,0
"Iceland","2024-06-16",0,0,0,0,0,0,0,0
"Iceland","2024-06-17",0,0,0,0,0,0,0,0
"Iceland","2024-06-18",0,0,0,0,0,0,0,0
"Iceland","2024-06-19",0,0,0,0,0,0,0,0
"Iceland","2024-06-20",0,0,0,0,0,0,0,0
"Iceland","2024-06-21",0,0,0,0,0,0,0,0
"Iceland","2024-06-22",0,0,0,0,0,0,0,0
"Iceland","2024-06-23",0,0,0,0,0,0,0,0
"Iceland","2024-06-24",0,0,0,0,0,0,0,0
"Iceland","2024-06-25",0,0,0,0,0,0,0,0
"Iceland","2024-06-26",0,0,0,0,0,0,0,0
"Iceland","2024-06-27",0,0,0,0,0,0,0,0
"Iceland","2024-06-28",0,0,0,0,0,0,0,0
"Iceland","2024-06-29",0,0,0,0,0,0,0,0
"Iceland","2024-06-30",0,0,0,0,0,0,0,0
"Iceland","2024-07-01",0,0,0,0,0,0,0,0
"Iceland","2024-07-02",0,0,0,0,0,0,0,0
"Iceland","2024-07-03",0,0,0,0,0,0,0,0
"Iceland","2024-07-04",0,0,0,0,0,0,0,0
"Iceland","2024-07-05",0,0,0,0,0,0,0,0
"Iceland","2024-07-06",0,0,0,0,0,0,0,0
"Iceland","2024-07-07",0,0,0,0,0,0,0,0
"Iceland","2024-07-08",0,0,0,0,0,0,0,0
"Iceland","2024-07-09",0,0,0,0,0,0,0,0
"Iceland","2024-07-10",0,0,0,0,0,0,0,0
"Iceland","2024-07-11",0,0,0,0,0,0,0,0
"Iceland","2024-07-12",0,0,0,0,0,0,0,0
"Iceland","2024-07-13",0,0,0,0,0,0,0,0
"Iceland","2024-07-14",0,0,0,0,0,0,0,0
"Iceland","2024-07-15",0,0,0,0,0,0,0,0
"Iceland","2024-07-16",0,0,0,0,0,0,0,0
"Iceland","2024-07-17",0,0,0,0,0,0,0,0
"Iceland","2024-07-18",0,0,0,0,0,0,0,0
"Iceland","2024-07-19",0,0,0,0,0,0,0,0
"Iceland","2024-07-20",0,0,0,0,0,0,0,0
"Iceland","2024-07-21",0,0,0,0,0,0,0,0
"Iceland","2024-07-22",0,0,0,0,0,0,0,0
"Iceland","2024-07-23",0,0,0,0,0,0,0,0
"Iceland","2024-07-24",0,0,0,0,0,0,0,0
"Iceland","2024-07-25",0,0,0,0,0,0,0,0
"Iceland","2024-07-26",0,0,0,0,0,0,0,0
"Iceland","2024-07-27",0,0,0,0,0,0,0,0
"Iceland","2024-07-28",0,0,0,0,0,0,0,0
"Iceland","2024-07-29",0,0,0,0,0,0,0,0
"Iceland","2024-07-30",0,0,0,0,0,0,0,0
"Iceland","2024-07-31",0,0,0,0,0,0,0,0
"Iceland","2024-08-01",0,0,0,0,0,0,0,0
"Iceland","2024-08-02",0,0,0,0,0,0,0,0
"Iceland","2024-08-03",0,0,0,0,0,0,0,0
"Iceland","2024-08-04",0,0,0,0,0,0,0,0
"Iceland","2024-08-05",0,0,0,0,0,0,0,0
"Iceland","2024-08-06",0,0,0,0,0,0,0,0
"Iceland","2024-08-07",0,0,0,0,0,0,0,0
"Iceland","2024-08-08",0,0,0,0,0,0,0,0
"Iceland","2024-08-09",0,0,0,0,0,0,0,0
"Iceland","2024-08-10",0,0,0,0,0,0,0,0
"Iceland","2024-08-11",0,0,0,0,0,0,0,0
"Iceland","2024-08-12",0,0,0,0,0,0,0,0
"Iceland","2024-08-13",0,0,0,0,0,0,0,0
"Iceland","2024-08-14",0,0,0,0,0,0,0,0
"Iceland","2024-08-15",0,0,0,0,0,0,0,0
"Iceland","2024-08-16",0,0,0,0,0,0,0,0
"Iceland","2024-08-17",0,0,0,0,0,0,0,0
"Iceland","2024-08-18",0,0,0,0,0,0,0,0
"Iceland","2024-08-19",0,0,0,0,0,0,0,0
"Iceland","2024-08-20",0,0,0,0,0,0,0,0
"Iceland","2024-08-21",0,0,0,0,0,0,0,0
"Iceland","2024-08-22",0,0,0,0,0,0,0,0
"Iceland","2024-08-23",0,0,0,0,0,0,0,0
"Iceland","2024-08-24",0,0,0,0,0,0,0,0
"Iceland","2024-08-25",0,0,0,0,0,0,0,0
"Iceland","2024-08-26",0,0,0,0,0,0,0,0
"Iceland","2024-08-27",0,0,0,0,0,0,0,0
"Iceland","2024-08-28",0,0,0,0,0,0,0,0
"Iceland","2024-08-29",0,0,0,0,0,0,0,0
"Iceland","2024-08-30",0,0,0,0,0,0,0,0
"Iceland","2024-08-31",0,0,0,0,0,0,0,0
"Iceland","2024-09-01",0,0,0,0,0,0,0,0
"Iceland","2024-09-02",0,0,0,0,0,0,0,0
"Iceland","2024-09-03",0,0,0,0,0,0,0,0
"Iceland","2024-09-04",0,0,0,0,0,0,0,0
"Iceland","2024-09-05",0,0,0,0,0,0,0,0
"Iceland","2024-09-06",0,0,0,0,0,0,0,0
"Iceland","2024-09-07",0,0,0,0,0,0,0,0
"Iceland","2024-09-08",0,0,0,0,0,0,0,0
"Iceland","2024-09-09",0,0,0,0,0,0,0,0
"Iceland","2024-09-10",0,0,0,0,0,0,0,0
"Iceland","2024-09-11",0,0,0,0,0,0,0,0
"Iceland","2024-09-12",0,0,0,0,0,0,0,0
"Iceland","2024-09-13",0,0,0,0,0,0,0,0
"Iceland","2024-09-14",0,0,0,0,0,0,0,0
"Iceland","2024-09-15",0,0,0,0,0,0,0,0
"Iceland","2024-09-16",0,0,0,0,0,0,0,0
"Iceland","2024-09-17",0,0,0,0,0,0,0,0
"Iceland","2024-09-18",0,0,0,0,0,0,0,0
"Iceland","2024-09-19",0,0,0,0,0,0,0,0
"Iceland","2024-09-20",0,0,0,0,0,0,0,0
"Iceland","2024-09-21",0,0,0,0,0,0,0,0
"Iceland","2024-09-22",0,0,0,0,0,0,0,0
"Iceland","2024-09-23",0,0,0,0,0,0,0,0
"Iceland","2024-09-24",0,0,0,0,0,0,0,0
"Iceland","2024-09-25",0,0,0,0,0,0,0,0
"Iceland","2024-09-26",0,0,0,0,0,0,0,0
"Iceland","2024-09-27",0,0,0,0,0,0,0,0
"Iceland","2024-09-28",0,0,0,0,0,0,0,0
"Iceland","2024-09-29",0,0,0,0,0,0,0,0
"Iceland","2024-09-30",0,0,0,0,0,0,0,0
"Iceland","2024-10-01",0,0,0,0,0,0,0,0
"Iceland","2024-10-02",0,0,0,0,0,0,0,0
"Iceland","2024-10-03",0,0,0,0,0,0,0,0
"Iceland","2024-10-04",0,0,0,0,0,0,0,0
"Iceland","2024-10-05",0,0,0,0,0,0,0,0
"Iceland","2024-10-06",0,0,0,0,0,0,0,0
"Iceland","2024-10-07",0,0,0,0,0,0,0,0
"Iceland","2024-10-08",0,0,0,0,0,0,0,0
"Iceland","2024-10-09",0,0,0,0,0,0,0,0
"Iceland","2024-10-10",0,0,0,0,0,0,0,0
"Iceland","2024-10-11",0,0,0,0,0,0,0,0
"Iceland","2024-10-12",0,0,0,0,0,0,0,0
"Iceland","2024-10-13",0,0,0,0,0,0,0,0
"Iceland","2024-10-14",0,0,0,0,0,0,0,0
"Iceland","2024-10-15",0,0,0,0,0,0,0,0
"Iceland","2024-10-16",0,0,0,0,0,0,0,0
"Iceland","2024-10-17",0,0,0,0,0,0,0,0
"Iceland","2024-10-18",0,0,0,0,0,0,0,0
"Iceland","2024-10-19",0,0,0,0,0,0,0,0
"Iceland","2024-10-20",0,0,0,0,0,0,0,0
"Iceland","2024-10-21",0,0,0,0,0,0,0,0
"Iceland","2024-10-22",0,0,0,0,0,0,0,0
"Iceland","2024-10-23",0,0,0,0,0,0,0,0
"Iceland","2024-10-24",0,0,0,0,0,0,0,0
"Iceland","2024-10-25",0,0,0,0,0,0,0,0
"Iceland","2024-10-26",0,0,0,0,0,0,0,0
"Iceland","2024-10-27",0,0,0,0,0,0,0,0
"Iceland","2024-10-28",0,0,0,0,0,0,0,0
"Iceland","2024-10-29",0,0,0,0,0,0,0,0
"Iceland","2024-10-30",0,0,0,0,0,0,0,0
"Iceland","2024-10-31",0,0,0,0,0,0,0,0
"Iceland","2024-11-01",0,0,0,0,0,0,0,0
"Iceland","2024-11-02",0,0,0,0,0,0,0,0
"Iceland","2024-11-03",0,0,0,0,0,0,0,0
"Iceland","2024-11-04",0,0,0,0,0,0,0,0
"Iceland","2024-11-05",0,0,0,0,0,0,0,0
"Iceland","2024-11-06",0,0,0,0,0,0,0,0
"Iceland","2024-11-07",0,0,0,0,0,0,0,0
"Iceland","2024-11-08",0,0,0,0,0,0,0,0
"Iceland","2024-11-09",0,0,0,0,0,0,0,0
"Iceland","2024-11-10",0,0,0,0,0,0,0,0
"Iceland","2024-11-11",0,0,0,0,0,0,0,0
"Iceland","2024-11-12",0,0,0,0,0,0,0,0
"Iceland","2024-11-13",0,0,0,0,0,0,0,0
"Iceland","2024-11-14",0,0,0,0,0,0,0,0
"Iceland","2024-11-15",0,0,0,0,0,0,0,0
"Iceland","2024-11-16",0,0,0,0,0,0,0,0
"Iceland","2024-11-17",0,0,0,0,0,0,0,0
"Iceland","2024-11-18",0,0,0,0,0,0,0,0
"Iceland","2024-11-19",0,0,0,0,0,0,0,0
"Iceland","2024-11-20",0,0,0,0,0,0,0,0
"Iceland","2024-11-21",0,0,0,0,0,0,0,0
"Iceland","2024-11-22",0,0,0,0,0,0,0,0
"Iceland","2024-11-23",0,0,0,0,0,0,0,0
"Iceland","2024-11-24",0,0,0,0,0,0,0,0
"Iceland","2024-11-25",0,0,0,0,0,0,0,0
"Iceland","2024-11-26",0,0,0,0,0,0,0,0
"Iceland","2024-11-27",0,0,0,0,0,0,0,0
"Iceland","2024-11-28",0,0,0,0,0,0,0,0
"Iceland","2024-11-29",0,0,0,0,0,0,0,0
"Iceland","2024-11-30",0,0,0,0,0,0,0,0
"Iceland","2024-12-01",0,0,0,0,0,0,0,0
"Iceland","2024-12-02",0,0,0,0,0,0,0,0
"Iceland","2024-12-03",0,0,0,0,0,0,0,0
"Iceland","2024-12-04",0,0,0,0,0,0,0,0
"Iceland","2024-12-05",0,0,0,0,0,0,0,0
"Iceland","2024-12-06",0,0,0,0,0,0,0,0
"Iceland","2024-12-07",0,0,0,0,0,0,0,0
"Iceland","2024-12-08",0,0,0,0,0,0,0,0
"Iceland","2024-12-09",0,0,0,0,0,0,0,0
"Iceland","2024-12-10",0,0,0,0,0,0,0,0
"Iceland","2024-12-11",0,0,0,0,0,0,0,0
"Iceland","2024-12-12",0,0,0,0,0,0,0,0
"Iceland","2024-12-13",0,0,0,0,0,0,0,0
"Iceland","2024-12-14",0,0,0,0,0,0,0,0
"Iceland","2024-12-15",0,0,0,0,0,0,0,0
"Iceland","2024-12-16",0,0,0,0,0,0,0,0
"Iceland","2024-12-17",0,0,0,0,0,0,0,0
"Iceland","2024-12-18",0,0,0,0,0,0,0,0
"Iceland","2024-12-19",0,0,0,0,0,0,0,0
"Iceland","2024-12-20",0,0,0,0,0,0,0,0
"Iceland","2024-12-21",0,0,0,0,0,0,0,0
"Iceland","2024-12-22",0,0,0,0,0,0,0,0
"Iceland","2024-12-23",0,0,0,0,0,0,0,0
"Iceland","2024-12-24",0,0,0,0,0,0,0,0
"Iceland","2024-12-25",0,0,0,0,0,0,0,0
"Iceland","2024-12-26",0,0,0,0,0,0,0,0
"Iceland","2024-12-27",0,0,0,0,0,0,0,0
"Iceland","2024-12-28",0,0,0,0,0,0,0,0
"Iceland","2024-12-29",0,0,0,0,0,0,0,0
"Iceland","2024-12-30",0,0,0,0,0,0,0,0
"Iceland","2024-12-31",0,0,0,0,0,0,0,0
"Iceland","2025-01-01",0,0,0,0,0,0,0,0
"Iceland","2025-01-02",0,0,0,0,0,0,0,0
"Iceland","2025-01-03",0,0,0,0,0,0,0,0
"Iceland","2025-01-04",0,0,0,0,0,0,0,0
"Iceland","2025-01-05",0,0,0,0,0,0,0,0
"Iceland","2025-01-06",0,0,0,0,0,0,0,0
"Iceland","2025-01-07",0,0,0,0,0,0,0,0
"Iceland","2025-01-08",0,0,0,0,0,0,0,0
"Iceland","2025-01-09",0,0,0,0,0,0,0,0
"Iceland","2025-01-10",0,0,0,0,0,0,0,0
"Iceland","2025-01-11",0,0,0,0,0,0,0,0
"Iceland","2025-01-12",0,0,0,0,0,0,0,0
"Iceland","2025-01-13",0,0,0,0,0,0,0,0
"India","2024-01-01",0,0,0,0,0,0,0,0
"India","2024-01-02",0,0,0,0,0,0,0,0
"India","2024-01-03",0,0,0,0,0,0,0,0
"India","2024-01-04",0,0,0,0,0,0,0,0
"India","2024-01-05",0,0,0,0,0,0,0,0
"India","2024-01-06",0,0,0,0,0,0,0,0
"India","2024-01-07",0,0,0,0,0,0,0,0
"India","2024-01-08",0,0,0,0,0,0,0,0
"India","2024-01-09",0,0,0,0,0,0,0,0
"India","2024-01-10",0,0,0,0,0,0,0,0
"India","2024-01-11",0,0,0,0,0,0,0,0
"India","2024-01-12",0,0,0,0,0,0,0,0
"India","2024-01-13",0,0,0,0,0,0,0,0
"India","2024-01-14",0,0,0,0,0,0,0,0
"India","2024-01-15",0,0,0,0,0,0,0,0
"India","2024-01-16",0,0,0,0,0,0,0,0
"India","2024-01-17",0,0,0,0,0,0,0,0
"India","2024-01-18",0,0,0,0,0,0,0,0
"India","2024-01-19",0,0,0,0,0,0,0,0
"India","2024-01-20",0,0,0,0,0,0,0,0
"India","2024-01-21",0,0,0,0,0,0,0,0
"India","2024-01-22",0,0,0,0,0,0,0,0
"India","2024-01-23",0,0,0,0,0,0,0,0
"India","2024-01-24",0,0,0,0,0,0,0,0
"India","2024-01-25",0,0,0,0,0,0,0,0
"India","2024-01-26",0,0,0,0,0,0,0,0
"India","2024-01-27",0,0,0,0,0,0,0,0
"India","2024-01-28",0,0,0,0,0,0,0,0
"India","2024-01-29",0,0,0,0,0,0,0,0
"India","2024-01-30",0,0,0,0,0,0,0,0
"India","2024-01-31",0,0,0,0,0,0,0,0
"India","2024-02-01",0,0,0,0,0,0,0,0
"India","2024-02-02",0,0,0,0,0,0,0,0
"India","2024-02-03",0,0,0,0,0,0,0,0
"India","2024-02-04",0,0,0,0,0,0,0,0
"India","2024-02-05",0,0,0,0,0,0,0,0
"India","2024-02-06",0,0,0,0,0,0,0,0
"India","2024-02-07",0,0,0,0,0,0,0,0
"India","2024-02-08",0,0,0,0,0,0,0,0
"India","2024-02-09",0,0,0,0,0,0,0,0
"India","2024-02-10",0,0,0,0,0,0,0,0
"India","2024-02-11",0,0,0,0,0,0,0,0
"India","2024-02-12",0,0,0,0,0,0,0,0
"India","2024-02-13",0,0,0,0,0,0,0,0
"India","2024-02-14",0,0,0,0,0,0,0,0
"India","2024-02-15",0,0,0,0,0,0,0,0
"India","2024-02-16",0,0,0,0,0,0,0,0
"India","2024-02-17",0,0,0,0,0,0,0,0
"India","2024-02-18",0,0,0,0,0,0,0,0
"India","2024-02-19",0,0,0,0,0,0,0,0
"India","2024-02-20",0,0,0,0,0,0,0,0
"India","2024-02-21",0,0,0,0,0,0,0,0
"India","2024-02-22",0,0,0,0,0,0,0,0
"India","2024-02-23",0,0,0,0,0,0,0,0
"India","2024-02-24",0,0,0,0,0,0,0,0
"India","2024-02-25",0,0,0,0,0,0,0,0
"India","2024-02-26",0,0,0,0,0,0,0,0
"India","2024-02-27",0,0,0,0,0,0,0,0
"India","2024-02-28",0,0,0,0,0,0,0,0
"India","2024-02-29",0,0,0,0,0,0,0,0
"India","2024-03-01",0,0,0,0,0,0,0,0
"India","2024-03-02",0,0,0,0,0,0,0,0
"India","2024-03-03",0,0,0,0,0,0,0,0
"India","2024-03-04",0,0,0,0,0,0,0,0
"India","2024-03-05",0,0,0,0,0,0,0,0
"India","2024-03-06",0,0,0,0,0,0,0,0
"India","2024-03-07",0,0,0,0,0,0,0,0
"India","2024-03-08",0,0,0,0,0,0,0,0
"India","2024-03-09",0,0,0,0,0,0,0,0
"India","2024-03-10",0,0,0,0,0,0,0,0
"India","2024-03-11",0,0,0,0,0,0,0,0
"India","2024-03-12",0,0,0,0,0,0,0,0
"India","2024-03-13",0,0,0,0,0,0,0,0
"India","2024-03-14",0,0,0,0,0,0,0,0
"India","2024-03-15",0,0,0,0,0,0,0,0
"India","2024-03-16",0,0,0,0,0,0,0,0
"India","2024-03-17",0,0,0,0,0,0,0,0
"India","2024-03-18",0,0,0,0,0,0,0,0
"India","2024-03-19",0,0,0,0,0,0,0,0
"India","2024-03-20",0,0,0,0,0,0,0,0
"India","2024-03-21",0,0,0,0,0,0,0,0
"India","2024-03-22",0,0,0,0,0,0,0,0
"India","2024-03-23",0,0,0,0,0,0,0,0
"India","2024-03-24",0,0,0,0,0,0,0,0
"India","2024-03-25",0,0,0,0,0,0,0,0
"India","2024-03-26",0,0,0,0,0,0,0,0
"India","2024-03-27",0,0,0,0,0,0,0,0
"India","2024-03-28",0,0,0,0,0,0,0,0
"India","2024-03-29",0,0,0,0,0,0,0,0
"India","2024-03-30",0,0,0,0,0,0,0,0
"India","2024-03-31",0,0,0,0,0,0,0,0
"India","2024-04-01",0,0,0,0,0,0,0,0
"India","2024-04-02",0,0,0,0,0,0,0,0
"India","2024-04-03",0,0,0,0,0,0,0,0
"India","2024-04-04",0,0,0,0,0,0,0,0
"India","2024-04-05",0,0,0,0,0,0,0,0
"India","2024-04-06",0,0,0,0,0,0,0,0
"India","2024-04-07",0,0,0,0,0,0,0,0
"India","2024-04-08",0,0,0,0,0,0,0,0
"India","2024-04-09",0,0,0,0,0,0,0,0
"India","2024-04-10",0,0,0,0,0,0,0,0
"India","2024-04-11",0,0,0,0,0,0,0,0
"India","2024-04-12",0,0,0,0,0,0,0,0
"India","2024-04-13",0,0,0,0,0,0,0,0
"India","2024-04-14",0,0,0,0,0,0,0,0
"India","2024-04-15",0,0,0,0,0,0,0,0
"India","2024-04-16",0,0,0,0,0,0,0,0
"India","2024-04-17",0,0,0,0,0,0,0,0
"India","2024-04-18",0,0,0,0,0,0,0,0
"India","2024-04-19",0,0,0,0,0,0,0,0
"India","2024-04-20",0,0,0,0,0,0,0,0
"India","2024-04-21",0,0,0,0,0,0,0,0
"India","2024-04-22",0,0,0,0,0,0,0,0
"India","2024-04-23",0,0,0,0,0,0,0,0
"India","2024-04-24",0,0,0,0,0,0,0,0
"India","2024-04-25",0,0,0,0,0,0,0,0
"India","2024-04-26",0,0,0,0,0,0,0,0
"India","2024-04-27",0,0,0,0,0,0,0,0
"India","2024-04-28",0,0,0,0,0,0,0,0
"India","2024-04-29",0,0,0,0,0,0,0,0
"India","2024-04-30",0,0,0,0,0,0,0,0
"India","2024-05-01",0,0,0,0,0,0,0,0
"India","2024-05-02",0,0,0,0,0,0,0,0
"India","2024-05-03",0,0,0,0,0,0,0,0
"India","2024-05-04",0,0,0,0,0,0,0,0
"India","2024-05-05",0,0,0,0,0,0,0,0
"India","2024-05-06",0,0,0,0,0,0,0,0
"India","2024-05-07",0,0,0,0,0,0,0,0
"India","2024-05-08",0,0,0,0,0,0,0,0
"India","2024-05-09",0,0,0,0,0,0,0,0
"India","2024-05-10",0,0,0,0,0,0,0,0
"India","2024-05-11",0,0,0,0,0,0,0,0
"India","2024-05-12",0,0,0,0,0,0,0,0
"India","2024-05-13",0,0,0,0,0,0,0,0
"India","2024-05-14",0,0,0,0,0,0,0,0
"India","2024-05-15",0,0,0,0,0,0,0,0
"India","2024-05-16",0,0,0,0,0,0,0,0
"India","2024-05-17",0,0,0,0,0,0,0,0
"India","2024-05-18",0,0,0,0,0,0,0,0
"India","2024-05-19",0,0,0,0,0,0,0,0
"India","2024-05-20",0,0,0,0,0,0,0,0
"India","2024-05-21",0,0,0,0,0,0,0,0
"India","2024-05-22",0,0,0,0,0,0,0,0
"India","2024-05-23",0,0,0,0,0,0,0,0
"India","2024-05-24",0,0,0,0,0,0,0,0
"India","2024-05-25",0,0,0,0,0,0,0,0
"India","2024-05-26",0,0,0,0,0,0,0,0
"India","2024-05-27",0,0,0,0,0,0,0,0
"India","2024-05-28",0,0,0,0,0,0,0,0
"India","2024-05-29",0,0,0,0,0,0,0,0
"India","2024-05-30",0,0,0,0,0,0,0,0
"India","2024-05-31",0,0,0,0,0,0,0,0
"India","2024-06-01",0,0,0,0,0,0,0,0
"India","2024-06-02",0,0,0,0,0,0,0,0
"India","2024-06-03",0,0,0,0,0,0,0,0
"India","2024-06-04",0,0,0,0,0,0,0,0
"India","2024-06-05",0,0,0,0,0,0,0,0
"India","2024-06-06",0,0,0,0,0,0,0,0
"India","2024-06-07",0,0,0,0,0,0,0,0
"India","2024-06-08",0,0,0,0,0,0,0,0
"India","2024-06-09",0,0,0,0,0,0,0,0
"India","2024-06-10",0,0,0,0,0,0,0,0
"India","2024-06-11",0,0,0,0,0,0,0,0
"India","2024-06-12",0,0,0,0,0,0,0,0
"India","2024-06-13",0,0,0,0,0,0,0,0
"India","2024-06-14",0,0,0,0,0,0,0,0
"India","2024-06-15",0,0,0,0,0,0,0,0
"India","2024-06-16",0,0,0,0,0,0,0,0
"India","2024-06-17",0,0,0,0,0,0,0,0
"India","2024-06-18",0,0,0,0,0,0,0,0
"India","2024-06-19",0,0,0,0,0,0,0,0
"India","2024-06-20",0,0,0,0,0,0,0,0
"India","2024-06-21",0,0,0,0,0,0,0,0
"India","2024-06-22",0,0,0,0,0,0,0,0
"India","2024-06-23",0,0,0,0,0,0,0,0
"India","2024-06-24",0,0,0,0,0,0,0,0
"India","2024-06-25",0,0,0,0,0,0,0,0
"India","2024-06-26",0,0,0,0,0,0,0,0
"India","2024-06-27",0,0,0,0,0,0,0,0
"India","2024-06-28",0,0,0,0,0,0,0,0
"India","2024-06-29",0,0,0,0,0,0,0,0
"India","2024-06-30",0,0,0,0,0,0,0,0
"India","2024-07-01",0,0,0,0,0,0,0,0
"India","2024-07-02",0,0,0,0,0,0,0,0
"India","2024-07-03",0,0,0,0,0,0,0,0
"India","2024-07-04",0,0,0,0,0,0,0,0
"India","2024-07-05",0,0,0,0,0,0,0,0
"India","2024-07-06",0,0,0,0,0,0,0,0
"India","2024-07-07",0,0,0,0,0,0,0,0
"India","2024-07-08",0,0,0,0,0,0,0,0
"India","2024-07-09",0,0,0,0,0,0,0,0
"India","2024-07-10",0,0,0,0,0,0,0,0
"India","2024-07-11",0,0,0,0,0,0,0,0
"India","2024-07-12",0,0,0,0,0,0,0,0
"India","2024-07-13",0,0,0,0,0,0,0,0
"India","2024-07-14",0,0,0,0,0,0,0,0
"India","2024-07-15",0,0,0,0,0,0,0,0
"India","2024-07-16",0,0,0,0,0,0,0,0
"India","2024-07-17",0,0,0,0,0,0,0,0
"India","2024-07-18",0,0,0,0,0,0,0,0
"India","2024-07-19",0,0,0,0,0,0,0,0
"India","2024-07-20",0,0,0,0,0,0,0,0
"India","2024-07-21",0,0,0,0,0,0,0,0
"India","2024-07-22",0,0,0,0,0,0,0,0
"India","2024-07-23",0,0,0,0,0,0,0,0
"India","2024-07-24",0,0,0,0,0,0,0,0
"India","2024-07-25",0,0,0,0,0,0,0,0
"India","2024-07-26",0,0,0,0,0,0,0,0
"India","2024-07-27",0,0,0,0,0,0,0,0
"India","2024-07-28",0,0,0,0,0,0,0,0
"India","2024-07-29",0,0,0,0,0,0,0,0
"India","2024-07-30",0,0,0,0,0,0,0,0
"India","2024-07-31",0,0,0,0,0,0,0,0
"India","2024-08-01",0,0,0,0,0,0,0,0
"India","2024-08-02",0,0,0,0,0,0,0,0
"India","2024-08-03",0,0,0,0,0,0,0,0
"India","2024-08-04",0,0,0,0,0,0,0,0
"India","2024-08-05",0,0,0,0,0,0,0,0
"India","2024-08-06",0,0,0,0,0,0,0,0
"India","2024-08-07",0,0,0,0,0,0,0,0
"India","2024-08-08",0,0,0,0,0,0,0,0
"India","2024-08-09",0,0,0,0,0,0,0,0
"India","2024-08-10",0,0,0,0,0,0,0,0
"India","2024-08-11",0,0,0,0,0,0,0,0
"India","2024-08-12",0,0,0,0,0,0,0,0
"India","2024-08-13",0,0,0,0,0,0,0,0
"India","2024-08-14",0,0,0,0,0,0,0,0
"India","2024-08-15",0,0,0,0,0,0,0,0
"India","2024-08-16",0,0,0,0,0,0,0,0
"India","2024-08-17",0,0,0,0,0,0,0,0
"India","2024-08-18",0,0,0,0,0,0,0,0
"India","2024-08-19",0,0,0,0,0,0,0,0
"India","2024-08-20",0,0,0,0,0,0,0,0
"India","2024-08-21",0,0,0,0,0,0,0,0
"India","2024-08-22",0,0,0,0,0,0,0,0
"India","2024-08-23",0,0,0,0,0,0,0,0
"India","2024-08-24",0,0,0,0,0,0,0,0
"India","2024-08-25",0,0,0,0,0,0,0,0
"India","2024-08-26",0,0,0,0,0,0,0,0
"India","2024-08-27",0,0,0,0,0,0,0,0
"India","2024-08-28",0,0,0,0,0,0,0,0
"India","2024-08-29",0,0,0,0,0,0,0,0
"India","2024-08-30",0,0,0,0,0,0,0,0
"India","2024-08-31",0,3,3,0,3,3,0,0
"India","2024-09-01",0,0,3,0,0,3,0,0
"India","2024-09-02",0,0,3,0,0,3,0,0
"India","2024-09-03",0,0,3,0,0,3,0,0
"India","2024-09-04",0,0,3,0,0,3,0,0
"India","2024-09-05",0,0,3,0,0,3,0,0
"India","2024-09-06",0,0,3,0,1,4,0,0
"India","2024-09-07",0,0,3,0,0,4,0,0
"India","2024-09-08",0,0,3,0,0,4,0,0
"India","2024-09-09",0,0,3,0,0,4,0,0
"India","2024-09-10",0,0,3,0,0,4,0,0
"India","2024-09-11",0,0,3,0,0,4,0,0
"India","2024-09-12",0,0,3,0,0,4,0,0
"India","2024-09-13",0,0,3,0,0,4,0,0
"India","2024-09-14",0,0,3,0,0,4,0,0
"India","2024-09-15",0,0,3,0,1,5,0,0
"India","2024-09-16",0,0,3,0,0,5,0,0
"India","2024-09-17",0,0,3,0,0,5,0,0
"India","2024-09-18",0,0,3,0,0,5,0,0
"India","2024-09-19",0,0,3,0,0,5,0,0
"India","2024-09-20",0,0,3,0,0,5,0,0
"India","2024-09-21",0,0,3,0,0,5,0,0
"India","2024-09-22",0,0,3,0,0,5,0,0
"India","2024-09-23",0,0,3,0,0,5,0,0
"India","2024-09-24",0,0,3,0,0,5,0,0
"India","2024-09-25",0,0,3,0,0,5,0,0
"India","2024-09-26",0,0,3,0,1,6,0,0
"India","2024-09-27",0,0,3,0,0,6,0,0
"India","2024-09-28",0,0,3,0,0,6,0,0
"India","2024-09-29",0,0,3,0,0,6,0,0
"India","2024-09-30",0,3,6,0,0,6,0,0
"India","2024-10-01",0,0,6,0,0,6,0,0
"India","2024-10-02",0,0,6,0,0,6,0,0
"India","2024-10-03",0,0,6,0,0,6,0,0
"India","2024-10-04",0,0,6,0,0,6,0,0
"India","2024-10-05",0,0,6,0,0,6,0,0
"India","2024-10-06",0,0,6,0,0,6,0,0
"India","2024-10-07",0,0,6,0,0,6,0,0
"India","2024-10-08",0,0,6,0,0,6,0,0
"India","2024-10-09",0,0,6,0,0,6,0,0
"India","2024-10-10",0,0,6,0,0,6,0,0
"India","2024-10-11",0,0,6,0,0,6,0,0
"India","2024-10-12",0,0,6,0,0,6,0,0
"India","2024-10-13",0,0,6,0,0,6,0,0
"India","2024-10-14",0,0,6,0,0,6,0,0
"India","2024-10-15",0,0,6,0,0,6,0,0
"India","2024-10-16",0,0,6,0,0,6,0,0
"India","2024-10-17",0,0,6,0,0,6,0,0
"India","2024-10-18",0,0,6,0,0,6,0,0
"India","2024-10-19",0,0,6,0,0,6,0,0
"India","2024-10-20",0,0,6,0,0,6,0,0
"India","2024-10-21",0,0,6,0,0,6,0,0
"India","2024-10-22",0,0,6,0,0,6,0,0
"India","2024-10-23",0,0,6,0,0,6,0,0
"India","2024-10-24",0,0,6,0,0,6,0,0
"India","2024-10-25",0,0,6,0,0,6,0,0
"India","2024-10-26",0,0,6,0,0,6,0,0
"India","2024-10-27",0,0,6,0,0,6,0,0
"India","2024-10-28",0,0,6,0,0,6,0,0
"India","2024-10-29",0,0,6,0,0,6,0,0
"India","2024-10-30",0,0,6,0,0,6,0,0
"India","2024-10-31",0,0,6,0,0,6,0,0
"India","2024-11-01",0,0,6,0,0,6,0,0
"India","2024-11-02",0,0,6,0,0,6,0,0
"India","2024-11-03",0,0,6,0,0,6,0,0
"India","2024-11-04",0,0,6,0,0,6,0,0
"India","2024-11-05",0,0,6,0,0,6,0,0
"India","2024-11-06",0,0,6,0,0,6,0,0
"India","2024-11-07",0,0,6,0,0,6,0,0
"India","2024-11-08",0,0,6,0,0,6,0,0
"India","2024-11-09",0,0,6,0,0,6,0,0
"India","2024-11-10",0,0,6,0,0,6,0,0
"India","2024-11-11",0,0,6,0,0,6,0,0
"India","2024-11-12",0,0,6,0,0,6,0,0
"India","2024-11-13",0,0,6,0,0,6,0,0
"India","2024-11-14",0,0,6,0,0,6,0,0
"India","2024-11-15",0,0,6,0,0,6,0,0
"India","2024-11-16",0,0,6,0,0,6,0,0
"India","2024-11-17",0,0,6,0,0,6,0,0
"India","2024-11-18",0,0,6,0,0,6,0,0
"India","2024-11-19",0,0,6,0,0,6,0,0
"India","2024-11-20",0,0,6,0,0,6,0,0
"India","2024-11-21",0,0,6,0,0,6,0,0
"India","2024-11-22",0,0,6,0,0,6,0,0
"India","2024-11-23",0,0,6,0,0,6,0,0
"India","2024-11-24",0,0,6,0,0,6,0,0
"India","2024-11-25",0,0,6,0,0,6,0,0
"India","2024-11-26",0,0,6,0,0,6,0,0
"India","2024-11-27",0,0,6,0,0,6,0,0
"India","2024-11-28",0,0,6,0,0,6,0,0
"India","2024-11-29",0,0,6,0,0,6,0,0
"India","2024-11-30",0,0,6,0,0,6,0,0
"India","2024-12-01",0,0,6,0,0,6,0,0
"India","2024-12-02",0,0,6,0,0,6,0,0
"India","2024-12-03",0,0,6,0,0,6,0,0
"India","2024-12-04",0,0,6,0,0,6,0,0
"India","2024-12-05",0,0,6,0,0,6,0,0
"India","2024-12-06",0,0,6,0,0,6,0,0
"India","2024-12-07",0,0,6,0,0,6,0,0
"India","2024-12-08",0,0,6,0,0,6,0,0
"India","2024-12-09",0,0,6,0,0,6,0,0
"India","2024-12-10",0,0,6,0,0,6,0,0
"India","2024-12-11",0,0,6,0,0,6,0,0
"India","2024-12-12",0,0,6,0,0,6,0,0
"India","2024-12-13",0,0,6,0,0,6,0,0
"India","2024-12-14",0,0,6,0,0,6,0,0
"India","2024-12-15",0,0,6,0,0,6,0,0
"India","2024-12-16",0,0,6,0,0,6,0,0
"India","2024-12-17",0,0,6,0,0,6,0,0
"India","2024-12-18",0,0,6,0,0,6,0,0
"India","2024-12-19",0,0,6,0,0,6,0,0
"India","2024-12-20",0,0,6,0,0,6,0,0
"India","2024-12-21",0,0,6,0,0,6,0,0
"India","2024-12-22",0,0,6,0,0,6,0,0
"India","2024-12-23",0,0,6,0,0,6,0,0
"India","2024-12-24",0,0,6,0,0,6,0,0
"India","2024-12-25",0,0,6,0,0,6,0,0
"India","2024-12-26",0,0,6,0,0,6,0,0
"India","2024-12-27",0,0,6,0,0,6,0,0
"India","2024-12-28",0,0,6,0,0,6,0,0
"India","2024-12-29",0,0,6,0,0,6,0,0
"India","2024-12-30",0,0,6,0,0,6,0,0
"India","2024-12-31",0,0,6,0,0,6,0,0
"India","2025-01-01",0,0,6,0,0,6,0,0
"India","2025-01-02",0,0,6,0,0,6,0,0
"India","2025-01-03",0,0,6,0,0,6,0,0
"India","2025-01-04",0,0,6,0,0,6,0,0
"India","2025-01-05",0,0,6,0,0,6,0,0
"India","2025-01-06",0,0,6,0,0,6,0,0
"India","2025-01-07",0,0,6,0,0,6,0,0
"India","2025-01-08",0,0,6,0,0,6,0,0
"India","2025-01-09",0,0,6,0,0,6,0,0
"India","2025-01-10",0,0,6,0,0,6,0,0
"India","2025-01-11",0,0,6,0,0,6,0,0
"India","2025-01-12",0,0,6,0,0,6,0,0
"India","2025-01-13",0,0,6,0,0,6,0,0
"Indonesia","2024-01-01",0,0,0,0,0,0,0,0
"Indonesia","2024-01-02",0,0,0,0,0,0,0,0
"Indonesia","2024-01-03",0,0,0,0,0,0,0,0
"Indonesia","2024-01-04",0,0,0,0,0,0,0,0
"Indonesia","2024-01-05",0,0,0,0,0,0,0,0
"Indonesia","2024-01-06",0,0,0,0,0,0,0,0
"Indonesia","2024-01-07",0,0,0,0,0,0,0,0
"Indonesia","2024-01-08",0,0,0,0,0,0,0,0
"Indonesia","2024-01-09",0,0,0,0,0,0,0,0
"Indonesia","2024-01-10",0,0,0,0,0,0,0,0
"Indonesia","2024-01-11",0,0,0,0,0,0,0,0
"Indonesia","2024-01-12",0,0,0,0,0,0,0,0
"Indonesia","2024-01-13",0,0,0,0,0,0,0,0
"Indonesia","2024-01-14",0,0,0,0,0,0,0,0
"Indonesia","2024-01-15",0,0,0,0,0,0,0,0
"Indonesia","2024-01-16",0,0,0,0,0,0,0,0
"Indonesia","2024-01-17",0,0,0,0,0,0,0,0
"Indonesia","2024-01-18",0,0,0,0,0,0,0,0
"Indonesia","2024-01-19",0,0,0,0,0,0,0,0
"Indonesia","2024-01-20",0,0,0,0,0,0,0,0
"Indonesia","2024-01-21",0,0,0,0,0,0,0,0
"Indonesia","2024-01-22",0,0,0,0,0,0,0,0
"Indonesia","2024-01-23",0,0,0,0,0,0,0,0
"Indonesia","2024-01-24",0,0,0,0,0,0,0,0
"Indonesia","2024-01-25",0,0,0,0,0,0,0,0
"Indonesia","2024-01-26",0,0,0,0,0,0,0,0
"Indonesia","2024-01-27",0,0,0,0,0,0,0,0
"Indonesia","2024-01-28",0,0,0,0,0,0,0,0
"Indonesia","2024-01-29",0,0,0,0,0,0,0,0
"Indonesia","2024-01-30",0,0,0,0,0,0,0,0
"Indonesia","2024-01-31",0,7,7,0,7,7,0,0
"Indonesia","2024-02-01",0,0,7,0,0,7,0,0
"Indonesia","2024-02-02",0,0,7,0,0,7,0,0
"Indonesia","2024-02-03",0,0,7,0,0,7,0,0
"Indonesia","2024-02-04",0,0,7,0,1,8,0,0
"Indonesia","2024-02-05",0,0,7,0,0,8,0,0
"Indonesia","2024-02-06",0,0,7,0,0,8,0,0
"Indonesia","2024-02-07",0,0,7,0,0,8,0,0
"Indonesia","2024-02-08",0,0,7,0,0,8,0,0
"Indonesia","2024-02-09",0,0,7,0,0,8,0,0
"Indonesia","2024-02-10",0,0,7,0,0,8,0,0
"Indonesia","2024-02-11",0,0,7,0,1,9,0,0
"Indonesia","2024-02-12",0,0,7,0,0,9,0,0
"Indonesia","2024-02-13",0,0,7,0,0,9,0,0
"Indonesia","2024-02-14",0,0,7,0,0,9,0,0
"Indonesia","2024-02-15",0,0,7,0,0,9,0,0
"Indonesia","2024-02-16",0,0,7,0,0,9,0,0
"Indonesia","2024-02-17",0,0,7,0,0,9,0,0
"Indonesia","2024-02-18",0,0,7,0,0,9,0,0
"Indonesia","2024-02-19",0,0,7,0,1,10,0,0
"Indonesia","2024-02-20",0,0,7,0,0,10,0,0
"Indonesia","2024-02-21",0,0,7,0,0,10,0,0
"Indonesia","2024-02-22",0,0,7,0,0,10,0,0
"Indonesia","2024-02-23",0,0,7,0,0,10,0,0
"Indonesia","2024-02-24",0,0,7,0,0,10,0,0
"Indonesia","2024-02-25",0,0,7,0,0,10,0,0
"Indonesia","2024-02-26",0,0,7,0,1,11,0,0
"Indonesia","2024-02-27",0,0,7,0,0,11,0,0
"Indonesia","2024-02-28",0,0,7,0,0,11,0,0
"Indonesia","2024-02-29",0,4,11,0,0,11,0,0
"Indonesia","2024-03-01",0,0,11,0,0,11,0,0
"Indonesia","2024-03-02",0,0,11,0,0,11,0,0
"Indonesia","2024-03-03",0,0,11,0,0,11,0,0
"Indonesia","2024-03-04",0,0,11,0,0,11,0,0
"Indonesia","2024-03-05",0,0,11,0,0,11,0,0
"Indonesia","2024-03-06",0,0,11,0,0,11,0,0
"Indonesia","2024-03-07",0,0,11,0,0,11,0,0
"Indonesia","2024-03-08",0,0,11,0,0,11,0,0
"Indonesia","2024-03-09",0,0,11,0,0,11,0,0
"Indonesia","2024-03-10",0,0,11,0,0,11,0,0
"Indonesia","2024-03-11",0,0,11,0,0,11,0,0
"Indonesia","2024-03-12",0,0,11,0,0,11,0,0
"Indonesia","2024-03-13",0,0,11,0,0,11,0,0
"Indonesia","2024-03-14",0,0,11,0,0,11,0,0
"Indonesia","2024-03-15",0,0,11,0,0,11,0,0
"Indonesia","2024-03-16",0,0,11,0,0,11,0,0
"Indonesia","2024-03-17",0,0,11,0,1,12,0,0
"Indonesia","2024-03-18",0,0,11,0,0,12,0,0
"Indonesia","2024-03-19",0,0,11,0,0,12,0,0
"Indonesia","2024-03-20",0,0,11,0,0,12,0,0
"Indonesia","2024-03-21",0,0,11,0,0,12,0,0
"Indonesia","2024-03-22",0,0,11,0,0,12,0,0
"Indonesia","2024-03-23",0,0,11,0,0,12,0,0
"Indonesia","2024-03-24",0,0,11,0,0,12,0,0
"Indonesia","2024-03-25",0,0,11,0,0,12,0,0
"Indonesia","2024-03-26",0,0,11,0,0,12,0,0
"Indonesia","2024-03-27",0,0,11,0,0,12,0,0
"Indonesia","2024-03-28",0,0,11,0,0,12,0,0
"Indonesia","2024-03-29",0,0,11,0,0,12,0,0
"Indonesia","2024-03-30",0,0,11,0,0,12,0,0
"Indonesia","2024-03-31",0,0,11,0,0,12,0,0
"Indonesia","2024-04-01",0,0,11,0,0,12,0,0
"Indonesia","2024-04-02",0,1,12,0,0,12,0,0
"Indonesia","2024-04-03",0,0,12,0,0,12,0,0
"Indonesia","2024-04-04",0,0,12,0,0,12,0,0
"Indonesia","2024-04-05",0,0,12,0,0,12,0,0
"Indonesia","2024-04-06",0,0,12,0,0,12,0,0
"Indonesia","2024-04-07",0,0,12,0,0,12,0,0
"Indonesia","2024-04-08",0,0,12,0,0,12,0,0
"Indonesia","2024-04-09",0,0,12,0,0,12,0,0
"Indonesia","2024-04-10",0,0,12,0,0,12,0,0
"Indonesia","2024-04-11",0,0,12,0,0,12,0,0
"Indonesia","2024-04-12",0,0,12,0,0,12,0,0
"Indonesia","2024-04-13",0,0,12,0,0,12,0,0
"Indonesia","2024-04-14",0,0,12,0,0,12,0,0
"Indonesia","2024-04-15",0,0,12,0,0,12,0,0
"Indonesia","2024-04-16",0,0,12,0,0,12,0,0
"Indonesia","2024-04-17",0,0,12,0,1,13,0,0
"Indonesia","2024-04-18",0,0,12,0,0,13,0,0
"Indonesia","2024-04-19",0,0,12,0,0,13,0,0
"Indonesia","2024-04-20",0,0,12,0,0,13,0,0
"Indonesia","2024-04-21",0,0,12,0,0,13,0,0
"Indonesia","2024-04-22",0,0,12,0,0,13,0,0
"Indonesia","2024-04-23",0,0,12,0,0,13,0,0
"Indonesia","2024-04-24",0,0,12,0,0,13,0,0
"Indonesia","2024-04-25",0,0,12,0,0,13,0,0
"Indonesia","2024-04-26",0,0,12,0,0,13,0,0
"Indonesia","2024-04-27",0,0,12,0,0,13,0,0
"Indonesia","2024-04-28",0,0,12,0,0,13,0,0
"Indonesia","2024-04-29",0,0,12,0,0,13,0,0
"Indonesia","2024-04-30",0,1,13,0,0,13,0,0
"Indonesia","2024-05-01",0,0,13,0,0,13,0,0
"Indonesia","2024-05-02",0,0,13,0,0,13,0,0
"Indonesia","2024-05-03",0,0,13,0,0,13,0,0
"Indonesia","2024-05-04",0,0,13,0,0,13,0,0
"Indonesia","2024-05-05",0,0,13,0,0,13,0,0
"Indonesia","2024-05-06",0,0,13,0,0,13,0,0
"Indonesia","2024-05-07",0,0,13,0,0,13,0,0
"Indonesia","2024-05-08",0,0,13,0,0,13,0,0
"Indonesia","2024-05-09",0,0,13,0,0,13,0,0
"Indonesia","2024-05-10",0,0,13,0,0,13,0,0
"Indonesia","2024-05-11",0,0,13,0,0,13,0,0
"Indonesia","2024-05-12",0,0,13,0,0,13,0,0
"Indonesia","2024-05-13",0,0,13,0,0,13,0,0
"Indonesia","2024-05-14",0,0,13,0,0,13,0,0
"Indonesia","2024-05-15",0,0,13,0,0,13,0,0
"Indonesia","2024-05-16",0,0,13,0,1,14,0,0
"Indonesia","2024-05-17",0,0,13,0,0,14,0,0
"Indonesia","2024-05-18",0,0,13,0,0,14,0,0
"Indonesia","2024-05-19",0,0,13,0,0,14,0,0
"Indonesia","2024-05-20",0,0,13,0,0,14,0,0
"Indonesia","2024-05-21",0,0,13,0,0,14,0,0
"Indonesia","2024-05-22",0,0,13,0,0,14,0,0
"Indonesia","2024-05-23",0,0,13,0,0,14,0,0
"Indonesia","2024-05-24",0,0,13,0,0,14,0,0
"Indonesia","2024-05-25",0,0,13,0,0,14,0,0
"Indonesia","2024-05-26",0,0,13,0,0,14,0,0
"Indonesia","2024-05-27",0,0,13,0,0,14,0,0
"Indonesia","2024-05-28",0,0,13,0,0,14,0,0
"Indonesia","2024-05-29",0,0,13,0,0,14,0,0
"Indonesia","2024-05-30",0,0,13,0,0,14,0,0
"Indonesia","2024-05-31",0,1,14,0,0,14,0,0
"Indonesia","2024-06-01",0,0,14,0,0,14,0,0
"Indonesia","2024-06-02",0,0,14,0,0,14,0,0
"Indonesia","2024-06-03",0,0,14,0,0,14,0,0
"Indonesia","2024-06-04",0,0,14,0,0,14,0,0
"Indonesia","2024-06-05",0,0,14,0,0,14,0,0
"Indonesia","2024-06-06",0,0,14,0,0,14,0,0
"Indonesia","2024-06-07",0,0,14,0,0,14,0,0
"Indonesia","2024-06-08",0,0,14,0,0,14,0,0
"Indonesia","2024-06-09",0,0,14,0,0,14,0,0
"Indonesia","2024-06-10",0,0,14,0,0,14,0,0
"Indonesia","2024-06-11",0,0,14,0,0,14,0,0
"Indonesia","2024-06-12",0,0,14,0,0,14,0,0
"Indonesia","2024-06-13",0,0,14,0,0,14,0,0
"Indonesia","2024-06-14",0,0,14,0,0,14,0,0
"Indonesia","2024-06-15",0,0,14,0,0,14,0,0
"Indonesia","2024-06-16",0,0,14,0,1,15,0,0
"Indonesia","2024-06-17",0,0,14,0,0,15,0,0
"Indonesia","2024-06-18",0,0,14,0,0,15,0,0
"Indonesia","2024-06-19",0,0,14,0,0,15,0,0
"Indonesia","2024-06-20",0,0,14,0,0,15,0,0
"Indonesia","2024-06-21",0,0,14,0,0,15,0,0
"Indonesia","2024-06-22",0,0,14,0,0,15,0,0
"Indonesia","2024-06-23",0,0,14,0,0,15,0,0
"Indonesia","2024-06-24",0,0,14,0,0,15,0,0
"Indonesia","2024-06-25",0,0,14,0,0,15,0,0
"Indonesia","2024-06-26",0,0,14,0,0,15,0,0
"Indonesia","2024-06-27",0,0,14,0,0,15,0,0
"Indonesia","2024-06-28",0,0,14,0,0,15,0,0
"Indonesia","2024-06-29",0,0,14,0,0,15,0,0
"Indonesia","2024-06-30",0,1,15,0,0,15,0,0
"Indonesia","2024-07-01",0,0,15,0,0,15,0,0
"Indonesia","2024-07-02",0,0,15,0,0,15,0,0
"Indonesia","2024-07-03",0,0,15,0,0,15,0,0
"Indonesia","2024-07-04",0,0,15,0,0,15,0,0
"Indonesia","2024-07-05",0,0,15,0,0,15,0,0
"Indonesia","2024-07-06",0,0,15,0,0,15,0,0
"Indonesia","2024-07-07",0,0,15,0,0,15,0,0
"Indonesia","2024-07-08",0,0,15,0,0,15,0,0
"Indonesia","2024-07-09",0,0,15,0,0,15,0,0
"Indonesia","2024-07-10",0,0,15,0,0,15,0,0
"Indonesia","2024-07-11",0,0,15,0,0,15,0,0
"Indonesia","2024-07-12",0,0,15,0,0,15,0,0
"Indonesia","2024-07-13",0,0,15,0,0,15,0,0
"Indonesia","2024-07-14",0,0,15,0,0,15,0,0
"Indonesia","2024-07-15",0,0,15,0,0,15,0,0
"Indonesia","2024-07-16",0,0,15,0,0,15,0,0
"Indonesia","2024-07-17",0,0,15,0,0,15,0,0
"Indonesia","2024-07-18",0,0,15,0,0,15,0,0
"Indonesia","2024-07-19",0,0,15,0,0,15,0,0
"Indonesia","2024-07-20",0,0,15,0,0,15,0,0
"Indonesia","2024-07-21",0,0,15,0,0,15,0,0
"Indonesia","2024-07-22",0,0,15,0,0,15,0,0
"Indonesia","2024-07-23",0,0,15,0,0,15,0,0
"Indonesia","2024-07-24",0,0,15,0,0,15,0,0
"Indonesia","2024-07-25",0,0,15,0,0,15,0,0
"Indonesia","2024-07-26",0,0,15,0,0,15,0,0
"Indonesia","2024-07-27",0,0,15,0,0,15,0,0
"Indonesia","2024-07-28",0,0,15,0,0,15,0,0
"Indonesia","2024-07-29",0,0,15,0,0,15,0,0
"Indonesia","2024-07-30",0,0,15,0,0,15,0,0
"Indonesia","2024-07-31",0,0,15,0,0,15,0,0
"Indonesia","2024-08-01",0,0,15,0,0,15,0,0
"Indonesia","2024-08-02",0,0,15,0,0,15,0,0
"Indonesia","2024-08-03",0,0,15,0,0,15,0,0
"Indonesia","2024-08-04",0,0,15,0,0,15,0,0
"Indonesia","2024-08-05",0,0,15,0,0,15,0,0
"Indonesia","2024-08-06",0,0,15,0,0,15,0,0
"Indonesia","2024-08-07",0,0,15,0,0,15,0,0
"Indonesia","2024-08-08",0,0,15,0,0,15,0,0
"Indonesia","2024-08-09",0,0,15,0,0,15,0,0
"Indonesia","2024-08-10",0,0,15,0,0,15,0,0
"Indonesia","2024-08-11",0,0,15,0,0,15,0,0
"Indonesia","2024-08-12",0,0,15,0,0,15,0,0
"Indonesia","2024-08-13",0,0,15,0,0,15,0,0
"Indonesia","2024-08-14",0,0,15,0,0,15,0,0
"Indonesia","2024-08-15",0,0,15,0,0,15,0,0
"Indonesia","2024-08-16",0,0,15,0,0,15,0,0
"Indonesia","2024-08-17",0,0,15,0,0,15,0,0
"Indonesia","2024-08-18",0,0,15,0,0,15,0,0
"Indonesia","2024-08-19",0,0,15,0,0,15,0,0
"Indonesia","2024-08-20",0,0,15,0,0,15,0,0
"Indonesia","2024-08-21",0,0,15,0,0,15,0,0
"Indonesia","2024-08-22",0,0,15,0,0,15,0,0
"Indonesia","2024-08-23",0,0,15,0,0,15,0,0
"Indonesia","2024-08-24",0,0,15,0,0,15,0,0
"Indonesia","2024-08-25",0,0,15,0,0,15,0,0
"Indonesia","2024-08-26",0,0,15,0,0,15,0,0
"Indonesia","2024-08-27",0,0,15,0,0,15,0,0
"Indonesia","2024-08-28",0,0,15,0,0,15,0,0
"Indonesia","2024-08-29",0,0,15,0,0,15,0,0
"Indonesia","2024-08-30",0,0,15,0,0,15,0,0
"Indonesia","2024-08-31",0,0,15,0,0,15,0,0
"Indonesia","2024-09-01",0,0,15,0,0,15,0,0
"Indonesia","2024-09-02",0,0,15,0,0,15,0,0
"Indonesia","2024-09-03",0,0,15,0,0,15,0,0
"Indonesia","2024-09-04",0,0,15,0,0,15,0,0
"Indonesia","2024-09-05",0,0,15,0,0,15,0,0
"Indonesia","2024-09-06",0,0,15,0,0,15,0,0
"Indonesia","2024-09-07",0,0,15,0,0,15,0,0
"Indonesia","2024-09-08",0,0,15,0,0,15,0,0
"Indonesia","2024-09-09",0,0,15,0,0,15,0,0
"Indonesia","2024-09-10",0,0,15,0,0,15,0,0
"Indonesia","2024-09-11",0,0,15,0,0,15,0,0
"Indonesia","2024-09-12",0,0,15,0,0,15,0,0
"Indonesia","2024-09-13",0,0,15,0,0,15,0,0
"Indonesia","2024-09-14",0,0,15,0,0,15,0,0
"Indonesia","2024-09-15",0,0,15,0,0,15,0,0
"Indonesia","2024-09-16",0,0,15,0,0,15,0,0
"Indonesia","2024-09-17",0,0,15,0,0,15,0,0
"Indonesia","2024-09-18",0,0,15,0,0,15,0,0
"Indonesia","2024-09-19",0,0,15,0,0,15,0,0
"Indonesia","2024-09-20",0,0,15,0,0,15,0,0
"Indonesia","2024-09-21",0,0,15,0,0,15,0,0
"Indonesia","2024-09-22",0,0,15,0,0,15,0,0
"Indonesia","2024-09-23",0,0,15,0,0,15,0,0
"Indonesia","2024-09-24",0,0,15,0,0,15,0,0
"Indonesia","2024-09-25",0,0,15,0,0,15,0,0
"Indonesia","2024-09-26",0,0,15,0,0,15,0,0
"Indonesia","2024-09-27",0,0,15,0,0,15,0,0
"Indonesia","2024-09-28",0,0,15,0,0,15,0,0
"Indonesia","2024-09-29",0,0,15,0,0,15,0,0
"Indonesia","2024-09-30",0,0,15,0,0,15,0,0
"Indonesia","2024-10-01",0,0,15,0,0,15,0,0
"Indonesia","2024-10-02",0,0,15,0,0,15,0,0
"Indonesia","2024-10-03",0,0,15,0,0,15,0,0
"Indonesia","2024-10-04",0,0,15,0,0,15,0,0
"Indonesia","2024-10-05",0,0,15,0,0,15,0,0
"Indonesia","2024-10-06",0,0,15,0,0,15,0,0
"Indonesia","2024-10-07",0,0,15,0,0,15,0,0
"Indonesia","2024-10-08",0,0,15,0,0,15,0,0
"Indonesia","2024-10-09",0,0,15,0,0,15,0,0
"Indonesia","2024-10-10",0,0,15,0,0,15,0,0
"Indonesia","2024-10-11",0,0,15,0,0,15,0,0
"Indonesia","2024-10-12",0,0,15,0,0,15,0,0
"Indonesia","2024-10-13",0,0,15,0,0,15,0,0
"Indonesia","2024-10-14",0,0,15,0,0,15,0,0
"Indonesia","2024-10-15",0,0,15,0,0,15,0,0
"Indonesia","2024-10-16",0,0,15,0,0,15,0,0
"Indonesia","2024-10-17",0,0,15,0,0,15,0,0
"Indonesia","2024-10-18",0,0,15,0,0,15,0,0
"Indonesia","2024-10-19",0,0,15,0,0,15,0,0
"Indonesia","2024-10-20",0,0,15,0,0,15,0,0
"Indonesia","2024-10-21",0,0,15,0,0,15,0,0
"Indonesia","2024-10-22",0,0,15,0,0,15,0,0
"Indonesia","2024-10-23",0,0,15,0,0,15,0,0
"Indonesia","2024-10-24",0,0,15,0,0,15,0,0
"Indonesia","2024-10-25",0,0,15,0,0,15,0,0
"Indonesia","2024-10-26",0,0,15,0,0,15,0,0
"Indonesia","2024-10-27",0,0,15,0,0,15,0,0
"Indonesia","2024-10-28",0,0,15,0,0,15,0,0
"Indonesia","2024-10-29",0,0,15,0,0,15,0,0
"Indonesia","2024-10-30",0,0,15,0,0,15,0,0
"Indonesia","2024-10-31",0,0,15,0,0,15,0,0
"Indonesia","2024-11-01",0,0,15,0,0,15,0,0
"Indonesia","2024-11-02",0,0,15,0,0,15,0,0
"Indonesia","2024-11-03",0,0,15,0,0,15,0,0
"Indonesia","2024-11-04",0,0,15,0,0,15,0,0
"Indonesia","2024-11-05",0,0,15,0,0,15,0,0
"Indonesia","2024-11-06",0,0,15,0,0,15,0,0
"Indonesia","2024-11-07",0,0,15,0,0,15,0,0
"Indonesia","2024-11-08",0,0,15,0,0,15,0,0
"Indonesia","2024-11-09",0,0,15,0,0,15,0,0
"Indonesia","2024-11-10",0,0,15,0,0,15,0,0
"Indonesia","2024-11-11",0,0,15,0,0,15,0,0
"Indonesia","2024-11-12",0,0,15,0,0,15,0,0
"Indonesia","2024-11-13",0,0,15,0,0,15,0,0
"Indonesia","2024-11-14",0,0,15,0,0,15,0,0
"Indonesia","2024-11-15",0,0,15,0,0,15,0,0
"Indonesia","2024-11-16",0,0,15,0,0,15,0,0
"Indonesia","2024-11-17",0,0,15,0,0,15,0,0
"Indonesia","2024-11-18",0,0,15,0,0,15,0,0
"Indonesia","2024-11-19",0,0,15,0,0,15,0,0
"Indonesia","2024-11-20",0,0,15,0,0,15,0,0
"Indonesia","2024-11-21",0,0,15,0,0,15,0,0
"Indonesia","2024-11-22",0,0,15,0,0,15,0,0
"Indonesia","2024-11-23",0,0,15,0,0,15,0,0
"Indonesia","2024-11-24",0,0,15,0,0,15,0,0
"Indonesia","2024-11-25",0,0,15,0,0,15,0,0
"Indonesia","2024-11-26",0,0,15,0,0,15,0,0
"Indonesia","2024-11-27",0,0,15,0,0,15,0,0
"Indonesia","2024-11-28",0,0,15,0,0,15,0,0
"Indonesia","2024-11-29",0,0,15,0,0,15,0,0
"Indonesia","2024-11-30",0,0,15,0,0,15,0,0
"Indonesia","2024-12-01",0,0,15,0,0,15,0,0
"Indonesia","2024-12-02",0,0,15,0,0,15,0,0
"Indonesia","2024-12-03",0,0,15,0,0,15,0,0
"Indonesia","2024-12-04",0,0,15,0,0,15,0,0
"Indonesia","2024-12-05",0,0,15,0,0,15,0,0
"Indonesia","2024-12-06",0,0,15,0,0,15,0,0
"Indonesia","2024-12-07",0,0,15,0,0,15,0,0
"Indonesia","2024-12-08",0,0,15,0,0,15,0,0
"Indonesia","2024-12-09",0,0,15,0,0,15,0,0
"Indonesia","2024-12-10",0,0,15,0,0,15,0,0
"Indonesia","2024-12-11",0,0,15,0,0,15,0,0
"Indonesia","2024-12-12",0,0,15,0,0,15,0,0
"Indonesia","2024-12-13",0,0,15,0,0,15,0,0
"Indonesia","2024-12-14",0,0,15,0,0,15,0,0
"Indonesia","2024-12-15",0,0,15,0,0,15,0,0
"Indonesia","2024-12-16",0,0,15,0,0,15,0,0
"Indonesia","2024-12-17",0,0,15,0,0,15,0,0
"Indonesia","2024-12-18",0,0,15,0,0,15,0,0
"Indonesia","2024-12-19",0,0,15,0,0,15,0,0
"Indonesia","2024-12-20",0,0,15,0,0,15,0,0
"Indonesia","2024-12-21",0,0,15,0,0,15,0,0
"Indonesia","2024-12-22",0,0,15,0,0,15,0,0
"Indonesia","2024-12-23",0,0,15,0,0,15,0,0
"Indonesia","2024-12-24",0,0,15,0,0,15,0,0
"Indonesia","2024-12-25",0,0,15,0,0,15,0,0
"Indonesia","2024-12-26",0,0,15,0,0,15,0,0
"Indonesia","2024-12-27",0,0,15,0,0,15,0,0
"Indonesia","2024-12-28",0,0,15,0,0,15,0,0
"Indonesia","2024-12-29",0,0,15,0,0,15,0,0
"Indonesia","2024-12-30",0,0,15,0,0,15,0,0
"Indonesia","2024-12-31",0,0,15,0,0,15,0,0
"Indonesia","2025-01-01",0,0,15,0,0,15,0,0
"Indonesia","2025-01-02",0,0,15,0,0,15,0,0
"Indonesia","2025-01-03",0,0,15,0,0,15,0,0
"Indonesia","2025-01-04",0,0,15,0,0,15,0,0
"Indonesia","2025-01-05",0,0,15,0,0,15,0,0
"Indonesia","2025-01-06",0,0,15,0,0,15,0,0
"Indonesia","2025-01-07",0,0,15,0,0,15,0,0
"Indonesia","2025-01-08",0,0,15,0,0,15,0,0
"Indonesia","2025-01-09",0,0,15,0,0,15,0,0
"Indonesia","2025-01-10",0,0,15,0,0,15,0,0
"Indonesia","2025-01-11",0,0,15,0,0,15,0,0
"Indonesia","2025-01-12",0,0,15,0,0,15,0,0
"Indonesia","2025-01-13",0,0,15,0,0,15,0,0
"Ireland","2024-01-01",0,0,0,0,0,0,0,0
"Ireland","2024-01-02",0,0,0,0,0,0,0,0
"Ireland","2024-01-03",0,0,0,0,0,0,0,0
"Ireland","2024-01-04",0,0,0,0,0,0,0,0
"Ireland","2024-01-05",0,0,0,0,0,0,0,0
"Ireland","2024-01-06",0,0,0,0,0,0,0,0
"Ireland","2024-01-07",0,0,0,0,0,0,0,0
"Ireland","2024-01-08",0,0,0,0,0,0,0,0
"Ireland","2024-01-09",0,0,0,0,0,0,0,0
"Ireland","2024-01-10",0,0,0,0,0,0,0,0
"Ireland","2024-01-11",0,0,0,0,0,0,0,0
"Ireland","2024-01-12",0,0,0,0,0,0,0,0
"Ireland","2024-01-13",0,0,0,0,0,0,0,0
"Ireland","2024-01-14",0,0,0,0,0,0,0,0
"Ireland","2024-01-15",0,0,0,0,0,0,0,0
"Ireland","2024-01-16",0,0,0,0,0,0,0,0
"Ireland","2024-01-17",0,0,0,0,0,0,0,0
"Ireland","2024-01-18",0,0,0,0,0,0,0,0
"Ireland","2024-01-19",0,0,0,0,0,0,0,0
"Ireland","2024-01-20",0,0,0,0,0,0,0,0
"Ireland","2024-01-21",0,0,0,0,0,0,0,0
"Ireland","2024-01-22",0,0,0,0,0,0,0,0
"Ireland","2024-01-23",0,0,0,0,0,0,0,0
"Ireland","2024-01-24",0,0,0,0,0,0,0,0
"Ireland","2024-01-25",0,0,0,0,0,0,0,0
"Ireland","2024-01-26",0,0,0,0,0,0,0,0
"Ireland","2024-01-27",0,0,0,0,0,0,0,0
"Ireland","2024-01-28",0,0,0,0,0,0,0,0
"Ireland","2024-01-29",0,0,0,0,0,0,0,0
"Ireland","2024-01-30",0,0,0,0,0,0,0,0
"Ireland","2024-01-31",0,0,0,0,0,0,0,0
"Ireland","2024-02-01",0,0,0,0,0,0,0,0
"Ireland","2024-02-02",0,0,0,0,0,0,0,0
"Ireland","2024-02-03",0,0,0,0,0,0,0,0
"Ireland","2024-02-04",0,0,0,0,0,0,0,0
"Ireland","2024-02-05",0,0,0,0,0,0,0,0
"Ireland","2024-02-06",0,0,0,0,0,0,0,0
"Ireland","2024-02-07",0,0,0,0,0,0,0,0
"Ireland","2024-02-08",0,0,0,0,0,0,0,0
"Ireland","2024-02-09",0,0,0,0,0,0,0,0
"Ireland","2024-02-10",0,0,0,0,0,0,0,0
"Ireland","2024-02-11",0,0,0,0,0,0,0,0
"Ireland","2024-02-12",0,0,0,0,0,0,0,0
"Ireland","2024-02-13",0,0,0,0,0,0,0,0
"Ireland","2024-02-14",0,0,0,0,0,0,0,0
"Ireland","2024-02-15",0,0,0,0,0,0,0,0
"Ireland","2024-02-16",0,0,0,0,0,0,0,0
"Ireland","2024-02-17",0,0,0,0,0,0,0,0
"Ireland","2024-02-18",0,0,0,0,0,0,0,0
"Ireland","2024-02-19",0,0,0,0,0,0,0,0
"Ireland","2024-02-20",0,0,0,0,0,0,0,0
"Ireland","2024-02-21",0,0,0,0,0,0,0,0
"Ireland","2024-02-22",0,0,0,0,0,0,0,0
"Ireland","2024-02-23",0,0,0,0,0,0,0,0
"Ireland","2024-02-24",0,0,0,0,0,0,0,0
"Ireland","2024-02-25",0,0,0,0,0,0,0,0
"Ireland","2024-02-26",0,0,0,0,0,0,0,0
"Ireland","2024-02-27",0,0,0,0,0,0,0,0
"Ireland","2024-02-28",0,0,0,0,0,0,0,0
"Ireland","2024-02-29",0,1,1,0,1,1,0,0
"Ireland","2024-03-01",0,0,1,0,0,1,0,0
"Ireland","2024-03-02",0,0,1,0,0,1,0,0
"Ireland","2024-03-03",0,0,1,0,0,1,0,0
"Ireland","2024-03-04",0,0,1,0,0,1,0,0
"Ireland","2024-03-05",0,0,1,0,0,1,0,0
"Ireland","2024-03-06",0,0,1,0,0,1,0,0
"Ireland","2024-03-07",0,0,1,0,0,1,0,0
"Ireland","2024-03-08",0,0,1,0,0,1,0,0
"Ireland","2024-03-09",0,0,1,0,0,1,0,0
"Ireland","2024-03-10",0,0,1,0,0,1,0,0
"Ireland","2024-03-11",0,0,1,0,0,1,0,0
"Ireland","2024-03-12",0,0,1,0,0,1,0,0
"Ireland","2024-03-13",0,0,1,0,0,1,0,0
"Ireland","2024-03-14",0,0,1,0,0,1,0,0
"Ireland","2024-03-15",0,0,1,0,0,1,0,0
"Ireland","2024-03-16",0,0,1,0,0,1,0,0
"Ireland","2024-03-17",0,0,1,0,0,1,0,0
"Ireland","2024-03-18",0,0,1,0,0,1,0,0
"Ireland","2024-03-19",0,0,1,0,0,1,0,0
"Ireland","2024-03-20",0,0,1,0,0,1,0,0
"Ireland","2024-03-21",0,0,1,0,0,1,0,0
"Ireland","2024-03-22",0,0,1,0,0,1,0,0
"Ireland","2024-03-23",0,0,1,0,0,1,0,0
"Ireland","2024-03-24",0,0,1,0,0,1,0,0
"Ireland","2024-03-25",0,0,1,0,0,1,0,0
"Ireland","2024-03-26",0,0,1,0,0,1,0,0
"Ireland","2024-03-27",0,0,1,0,0,1,0,0
"Ireland","2024-03-28",0,0,1,0,0,1,0,0
"Ireland","2024-03-29",0,0,1,0,0,1,0,0
"Ireland","2024-03-30",0,0,1,0,0,1,0,0
"Ireland","2024-03-31",0,0,1,0,1,2,0,0
"Ireland","2024-04-01",0,0,1,0,0,2,0,0
"Ireland","2024-04-02",0,0,1,0,0,2,0,0
"Ireland","2024-04-03",0,0,1,0,0,2,0,0
"Ireland","2024-04-04",0,0,1,0,0,2,0,0
"Ireland","2024-04-05",0,0,1,0,0,2,0,0
"Ireland","2024-04-06",0,0,1,0,0,2,0,0
"Ireland","2024-04-07",0,0,1,0,0,2,0,0
"Ireland","2024-04-08",0,0,1,0,0,2,0,0
"Ireland","2024-04-09",0,0,1,0,0,2,0,0
"Ireland","2024-04-10",0,0,1,0,0,2,0,0
"Ireland","2024-04-11",0,0,1,0,0,2,0,0
"Ireland","2024-04-12",0,0,1,0,0,2,0,0
"Ireland","2024-04-13",0,0,1,0,0,2,0,0
"Ireland","2024-04-14",0,0,1,0,0,2,0,0
"Ireland","2024-04-15",0,0,1,0,0,2,0,0
"Ireland","2024-04-16",0,0,1,0,0,2,0,0
"Ireland","2024-04-17",0,0,1,0,0,2,0,0
"Ireland","2024-04-18",0,0,1,0,0,2,0,0
"Ireland","2024-04-19",0,0,1,0,0,2,0,0
"Ireland","2024-04-20",0,0,1,0,0,2,0,0
"Ireland","2024-04-21",0,0,1,0,0,2,0,0
"Ireland","2024-04-22",0,0,1,0,0,2,0,0
"Ireland","2024-04-23",0,0,1,0,0,2,0,0
"Ireland","2024-04-24",0,0,1,0,0,2,0,0
"Ireland","2024-04-25",0,0,1,0,0,2,0,0
"Ireland","2024-04-26",0,0,1,0,0,2,0,0
"Ireland","2024-04-27",0,0,1,0,0,2,0,0
"Ireland","2024-04-28",0,0,1,0,0,2,0,0
"Ireland","2024-04-29",0,0,1,0,0,2,0,0
"Ireland","2024-04-30",0,1,2,0,0,2,0,0
"Ireland","2024-05-01",0,0,2,0,0,2,0,0
"Ireland","2024-05-02",0,0,2,0,0,2,0,0
"Ireland","2024-05-03",0,0,2,0,0,2,0,0
"Ireland","2024-05-04",0,0,2,0,0,2,0,0
"Ireland","2024-05-05",0,0,2,0,0,2,0,0
"Ireland","2024-05-06",0,0,2,0,0,2,0,0
"Ireland","2024-05-07",0,0,2,0,0,2,0,0
"Ireland","2024-05-08",0,0,2,0,0,2,0,0
"Ireland","2024-05-09",0,0,2,0,0,2,0,0
"Ireland","2024-05-10",0,0,2,0,0,2,0,0
"Ireland","2024-05-11",0,0,2,0,0,2,0,0
"Ireland","2024-05-12",0,0,2,0,0,2,0,0
"Ireland","2024-05-13",0,0,2,0,0,2,0,0
"Ireland","2024-05-14",0,0,2,0,0,2,0,0
"Ireland","2024-05-15",0,0,2,0,0,2,0,0
"Ireland","2024-05-16",0,0,2,0,1,3,0,0
"Ireland","2024-05-17",0,0,2,0,0,3,0,0
"Ireland","2024-05-18",0,0,2,0,0,3,0,0
"Ireland","2024-05-19",0,0,2,0,0,3,0,0
"Ireland","2024-05-20",0,0,2,0,0,3,0,0
"Ireland","2024-05-21",0,0,2,0,0,3,0,0
"Ireland","2024-05-22",0,0,2,0,0,3,0,0
"Ireland","2024-05-23",0,0,2,0,0,3,0,0
"Ireland","2024-05-24",0,0,2,0,0,3,0,0
"Ireland","2024-05-25",0,0,2,0,0,3,0,0
"Ireland","2024-05-26",0,0,2,0,0,3,0,0
"Ireland","2024-05-27",0,0,2,0,0,3,0,0
"Ireland","2024-05-28",0,0,2,0,0,3,0,0
"Ireland","2024-05-29",0,0,2,0,0,3,0,0
"Ireland","2024-05-30",0,0,2,0,0,3,0,0
"Ireland","2024-05-31",0,1,3,0,0,3,0,0
"Ireland","2024-06-01",0,0,3,0,0,3,0,0
"Ireland","2024-06-02",0,0,3,0,0,3,0,0
"Ireland","2024-06-03",0,0,3,0,0,3,0,0
"Ireland","2024-06-04",0,0,3,0,0,3,0,0
"Ireland","2024-06-05",0,0,3,0,0,3,0,0
"Ireland","2024-06-06",0,0,3,0,0,3,0,0
"Ireland","2024-06-07",0,0,3,0,0,3,0,0
"Ireland","2024-06-08",0,0,3,0,1,4,0,0
"Ireland","2024-06-09",0,0,3,0,0,4,0,0
"Ireland","2024-06-10",0,0,3,0,0,4,0,0
"Ireland","2024-06-11",0,0,3,0,0,4,0,0
"Ireland","2024-06-12",0,0,3,0,0,4,0,0
"Ireland","2024-06-13",0,0,3,0,0,4,0,0
"Ireland","2024-06-14",0,0,3,0,0,4,0,0
"Ireland","2024-06-15",0,0,3,0,0,4,0,0
"Ireland","2024-06-16",0,0,3,0,0,4,0,0
"Ireland","2024-06-17",0,0,3,0,0,4,0,0
"Ireland","2024-06-18",0,0,3,0,0,4,0,0
"Ireland","2024-06-19",0,0,3,0,0,4,0,0
"Ireland","2024-06-20",0,0,3,0,0,4,0,0
"Ireland","2024-06-21",0,0,3,0,0,4,0,0
"Ireland","2024-06-22",0,0,3,0,0,4,0,0
"Ireland","2024-06-23",0,0,3,0,1,5,0,0
"Ireland","2024-06-24",0,0,3,0,0,5,0,0
"Ireland","2024-06-25",0,0,3,0,0,5,0,0
"Ireland","2024-06-26",0,0,3,0,0,5,0,0
"Ireland","2024-06-27",0,0,3,0,0,5,0,0
"Ireland","2024-06-28",0,0,3,0,0,5,0,0
"Ireland","2024-06-29",0,0,3,0,0,5,0,0
"Ireland","2024-06-30",0,2,5,0,0,5,0,0
"Ireland","2024-07-01",0,0,5,0,0,5,0,0
"Ireland","2024-07-02",0,0,5,0,0,5,0,0
"Ireland","2024-07-03",0,0,5,0,0,5,0,0
"Ireland","2024-07-04",0,0,5,0,0,5,0,0
"Ireland","2024-07-05",0,0,5,0,0,5,0,0
"Ireland","2024-07-06",0,0,5,0,0,5,0,0
"Ireland","2024-07-07",0,0,5,0,0,5,0,0
"Ireland","2024-07-08",0,0,5,0,0,5,0,0
"Ireland","2024-07-09",0,0,5,0,0,5,0,0
"Ireland","2024-07-10",0,0,5,0,0,5,0,0
"Ireland","2024-07-11",0,0,5,0,0,5,0,0
"Ireland","2024-07-12",0,0,5,0,0,5,0,0
"Ireland","2024-07-13",0,0,5,0,0,5,0,0
"Ireland","2024-07-14",0,0,5,0,0,5,0,0
"Ireland","2024-07-15",0,0,5,0,0,5,0,0
"Ireland","2024-07-16",0,0,5,0,0,5,0,0
"Ireland","2024-07-17",0,0,5,0,0,5,0,0
"Ireland","2024-07-18",0,0,5,0,0,5,0,0
"Ireland","2024-07-19",0,0,5,0,0,5,0,0
"Ireland","2024-07-20",0,0,5,0,0,5,0,0
"Ireland","2024-07-21",0,0,5,0,0,5,0,0
"Ireland","2024-07-22",0,0,5,0,0,5,0,0
"Ireland","2024-07-23",0,0,5,0,0,5,0,0
"Ireland","2024-07-24",0,0,5,0,0,5,0,0
"Ireland","2024-07-25",0,0,5,0,0,5,0,0
"Ireland","2024-07-26",0,0,5,0,0,5,0,0
"Ireland","2024-07-27",0,0,5,0,0,5,0,0
"Ireland","2024-07-28",0,0,5,0,0,5,0,0
"Ireland","2024-07-29",0,0,5,0,0,5,0,0
"Ireland","2024-07-30",0,0,5,0,0,5,0,0
"Ireland","2024-07-31",0,0,5,0,0,5,0,0
"Ireland","2024-08-01",0,0,5,0,1,6,0,0
"Ireland","2024-08-02",0,0,5,0,0,6,0,0
"Ireland","2024-08-03",0,0,5,0,0,6,0,0
"Ireland","2024-08-04",0,0,5,0,0,6,0,0
"Ireland","2024-08-05",0,0,5,0,0,6,0,0
"Ireland","2024-08-06",0,0,5,0,0,6,0,0
"Ireland","2024-08-07",0,0,5,0,0,6,0,0
"Ireland","2024-08-08",0,0,5,0,0,6,0,0
"Ireland","2024-08-09",0,0,5,0,0,6,0,0
"Ireland","2024-08-10",0,0,5,0,0,6,0,0
"Ireland","2024-08-11",0,0,5,0,0,6,0,0
"Ireland","2024-08-12",0,0,5,0,0,6,0,0
"Ireland","2024-08-13",0,0,5,0,0,6,0,0
"Ireland","2024-08-14",0,0,5,0,0,6,0,0
"Ireland","2024-08-15",0,0,5,0,0,6,0,0
"Ireland","2024-08-16",0,0,5,0,0,6,0,0
"Ireland","2024-08-17",0,0,5,0,0,6,0,0
"Ireland","2024-08-18",0,0,5,0,0,6,0,0
"Ireland","2024-08-19",0,0,5,0,0,6,0,0
"Ireland","2024-08-20",0,0,5,0,0,6,0,0
"Ireland","2024-08-21",0,0,5,0,0,6,0,0
"Ireland","2024-08-22",0,0,5,0,0,6,0,0
"Ireland","2024-08-23",0,0,5,0,0,6,0,0
"Ireland","2024-08-24",0,0,5,0,0,6,0,0
"Ireland","2024-08-25",0,0,5,0,0,6,0,0
"Ireland","2024-08-26",0,0,5,0,0,6,0,0
"Ireland","2024-08-27",0,0,5,0,0,6,0,0
"Ireland","2024-08-28",0,0,5,0,0,6,0,0
"Ireland","2024-08-29",0,0,5,0,0,6,0,0
"Ireland","2024-08-30",0,0,5,0,0,6,0,0
"Ireland","2024-08-31",0,1,6,0,0,6,0,0
"Ireland","2024-09-01",0,0,6,0,0,6,0,0
"Ireland","2024-09-02",0,0,6,0,0,6,0,0
"Ireland","2024-09-03",0,0,6,0,0,6,0,0
"Ireland","2024-09-04",0,0,6,0,0,6,0,0
"Ireland","2024-09-05",0,0,6,0,0,6,0,0
"Ireland","2024-09-06",0,0,6,0,1,7,0,0
"Ireland","2024-09-07",0,0,6,0,0,7,0,0
"Ireland","2024-09-08",0,0,6,0,0,7,0,0
"Ireland","2024-09-09",0,0,6,0,0,7,0,0
"Ireland","2024-09-10",0,0,6,0,0,7,0,0
"Ireland","2024-09-11",0,0,6,0,0,7,0,0
"Ireland","2024-09-12",0,0,6,0,0,7,0,0
"Ireland","2024-09-13",0,0,6,0,0,7,0,0
"Ireland","2024-09-14",0,0,6,0,0,7,0,0
"Ireland","2024-09-15",0,0,6,0,1,8,0,0
"Ireland","2024-09-16",0,0,6,0,0,8,0,0
"Ireland","2024-09-17",0,0,6,0,0,8,0,0
"Ireland","2024-09-18",0,0,6,0,0,8,0,0
"Ireland","2024-09-19",0,0,6,0,0,8,0,0
"Ireland","2024-09-20",0,0,6,0,0,8,0,0
"Ireland","2024-09-21",0,0,6,0,0,8,0,0
"Ireland","2024-09-22",0,0,6,0,0,8,0,0
"Ireland","2024-09-23",0,0,6,0,0,8,0,0
"Ireland","2024-09-24",0,0,6,0,0,8,0,0
"Ireland","2024-09-25",0,0,6,0,0,8,0,0
"Ireland","2024-09-26",0,0,6,0,1,9,0,0
"Ireland","2024-09-27",0,0,6,0,0,9,0,0
"Ireland","2024-09-28",0,0,6,0,0,9,0,0
"Ireland","2024-09-29",0,0,6,0,0,9,0,0
"Ireland","2024-09-30",0,3,9,0,0,9,0,0
"Ireland","2024-10-01",0,0,9,0,0,9,0,0
"Ireland","2024-10-02",0,0,9,0,1,10,0,0
"Ireland","2024-10-03",0,0,9,0,0,10,0,0
"Ireland","2024-10-04",0,0,9,0,0,10,0,0
"Ireland","2024-10-05",0,0,9,0,0,10,0,0
"Ireland","2024-10-06",0,0,9,0,1,11,0,0
"Ireland","2024-10-07",0,0,9,0,0,11,0,0
"Ireland","2024-10-08",0,0,9,0,0,11,0,0
"Ireland","2024-10-09",0,0,9,0,0,11,0,0
"Ireland","2024-10-10",0,0,9,0,1,12,0,0
"Ireland","2024-10-11",0,0,9,0,0,12,0,0
"Ireland","2024-10-12",0,0,9,0,0,12,0,0
"Ireland","2024-10-13",0,0,9,0,0,12,0,0
"Ireland","2024-10-14",0,0,9,0,1,13,0,0
"Ireland","2024-10-15",0,0,9,0,0,13,0,0
"Ireland","2024-10-16",0,0,9,0,0,13,0,0
"Ireland","2024-10-17",0,0,9,0,0,13,0,0
"Ireland","2024-10-18",0,0,9,0,1,14,0,0
"Ireland","2024-10-19",0,0,9,0,0,14,0,0
"Ireland","2024-10-20",0,0,9,0,0,14,0,0
"Ireland","2024-10-21",0,0,9,0,0,14,0,0
"Ireland","2024-10-22",0,0,9,0,1,15,0,0
"Ireland","2024-10-23",0,0,9,0,0,15,0,0
"Ireland","2024-10-24",0,0,9,0,0,15,0,0
"Ireland","2024-10-25",0,0,9,0,0,15,0,0
"Ireland","2024-10-26",0,0,9,0,1,16,0,0
"Ireland","2024-10-27",0,0,9,0,0,16,0,0
"Ireland","2024-10-28",0,0,9,0,0,16,0,0
"Ireland","2024-10-29",0,0,9,0,0,16,0,0
"Ireland","2024-10-30",0,0,9,0,1,17,0,0
"Ireland","2024-10-31",0,8,17,0,0,17,0,0
"Ireland","2024-11-01",0,0,17,0,0,17,0,0
"Ireland","2024-11-02",0,0,17,0,0,17,0,0
"Ireland","2024-11-03",0,0,17,0,0,17,0,0
"Ireland","2024-11-04",0,0,17,0,1,18,0,0
"Ireland","2024-11-05",0,0,17,0,0,18,0,0
"Ireland","2024-11-06",0,0,17,0,0,18,0,0
"Ireland","2024-11-07",0,0,17,0,0,18,0,0
"Ireland","2024-11-08",0,0,17,0,0,18,0,0
"Ireland","2024-11-09",0,0,17,0,0,18,0,0
"Ireland","2024-11-10",0,0,17,0,0,18,0,0
"Ireland","2024-11-11",0,0,17,0,0,18,0,0
"Ireland","2024-11-12",0,0,17,0,1,19,0,0
"Ireland","2024-11-13",0,0,17,0,0,19,0,0
"Ireland","2024-11-14",0,0,17,0,0,19,0,0
"Ireland","2024-11-15",0,0,17,0,0,19,0,0
"Ireland","2024-11-16",0,0,17,0,0,19,0,0
"Ireland","2024-11-17",0,0,17,0,0,19,0,0
"Ireland","2024-11-18",0,0,17,0,0,19,0,0
"Ireland","2024-11-19",0,0,17,0,1,20,0,0
"Ireland","2024-11-20",0,0,17,0,0,20,0,0
"Ireland","2024-11-21",0,0,17,0,0,20,0,0
"Ireland","2024-11-22",0,0,17,0,0,20,0,0
"Ireland","2024-11-23",0,0,17,0,0,20,0,0
"Ireland","2024-11-24",0,0,17,0,0,20,0,0
"Ireland","2024-11-25",0,0,17,0,0,20,0,0
"Ireland","2024-11-26",0,0,17,0,0,20,0,0
"Ireland","2024-11-27",0,0,17,0,1,21,0,0
"Ireland","2024-11-28",0,0,17,0,0,21,0,0
"Ireland","2024-11-29",0,0,17,0,0,21,0,0
"Ireland","2024-11-30",0,4,21,0,0,21,0,0
"Ireland","2024-12-01",0,0,21,0,0,21,0,0
"Ireland","2024-12-02",0,0,21,0,0,21,0,0
"Ireland","2024-12-03",0,0,21,0,0,21,0,0
"Ireland","2024-12-04",0,0,21,0,0,21,0,0
"Ireland","2024-12-05",0,0,21,0,0,21,0,0
"Ireland","2024-12-06",0,0,21,0,0,21,0,0
"Ireland","2024-12-07",0,0,21,0,0,21,0,0
"Ireland","2024-12-08",0,0,21,0,0,21,0,0
"Ireland","2024-12-09",0,0,21,0,0,21,0,0
"Ireland","2024-12-10",0,0,21,0,0,21,0,0
"Ireland","2024-12-11",0,0,21,0,0,21,0,0
"Ireland","2024-12-12",0,0,21,0,0,21,0,0
"Ireland","2024-12-13",0,0,21,0,0,21,0,0
"Ireland","2024-12-14",0,0,21,0,0,21,0,0
"Ireland","2024-12-15",0,0,21,0,0,21,0,0
"Ireland","2024-12-16",0,0,21,0,0,21,0,0
"Ireland","2024-12-17",0,0,21,0,0,21,0,0
"Ireland","2024-12-18",0,0,21,0,0,21,0,0
"Ireland","2024-12-19",0,0,21,0,0,21,0,0
"Ireland","2024-12-20",0,0,21,0,0,21,0,0
"Ireland","2024-12-21",0,0,21,0,0,21,0,0
"Ireland","2024-12-22",0,0,21,0,0,21,0,0
"Ireland","2024-12-23",0,0,21,0,0,21,0,0
"Ireland","2024-12-24",0,0,21,0,0,21,0,0
"Ireland","2024-12-25",0,0,21,0,0,21,0,0
"Ireland","2024-12-26",0,0,21,0,0,21,0,0
"Ireland","2024-12-27",0,0,21,0,0,21,0,0
"Ireland","2024-12-28",0,0,21,0,0,21,0,0
"Ireland","2024-12-29",0,0,21,0,0,21,0,0
"Ireland","2024-12-30",0,0,21,0,0,21,0,0
"Ireland","2024-12-31",0,0,21,0,0,21,0,0
"Ireland","2025-01-01",0,0,21,0,0,21,0,0
"Ireland","2025-01-02",0,0,21,0,0,21,0,0
"Ireland","2025-01-03",0,0,21,0,0,21,0,0
"Ireland","2025-01-04",0,0,21,0,0,21,0,0
"Ireland","2025-01-05",0,0,21,0,0,21,0,0
"Ireland","2025-01-06",0,0,21,0,0,21,0,0
"Ireland","2025-01-07",0,0,21,0,0,21,0,0
"Ireland","2025-01-08",0,0,21,0,0,21,0,0
"Ireland","2025-01-09",0,0,21,0,0,21,0,0
"Ireland","2025-01-10",0,0,21,0,0,21,0,0
"Ireland","2025-01-11",0,0,21,0,0,21,0,0
"Ireland","2025-01-12",0,0,21,0,0,21,0,0
"Ireland","2025-01-13",0,0,21,0,0,21,0,0
"Israel","2024-01-01",0,0,0,0,0,0,0,0
"Israel","2024-01-02",0,0,0,0,0,0,0,0
"Israel","2024-01-03",0,0,0,0,0,0,0,0
"Israel","2024-01-04",0,0,0,0,0,0,0,0
"Israel","2024-01-05",0,0,0,0,0,0,0,0
"Israel","2024-01-06",0,0,0,0,0,0,0,0
"Israel","2024-01-07",0,0,0,0,0,0,0,0
"Israel","2024-01-08",0,0,0,0,0,0,0,0
"Israel","2024-01-09",0,0,0,0,0,0,0,0
"Israel","2024-01-10",0,0,0,0,0,0,0,0
"Israel","2024-01-11",0,0,0,0,0,0,0,0
"Israel","2024-01-12",0,0,0,0,0,0,0,0
"Israel","2024-01-13",0,0,0,0,0,0,0,0
"Israel","2024-01-14",0,0,0,0,0,0,0,0
"Israel","2024-01-15",0,0,0,0,0,0,0,0
"Israel","2024-01-16",0,0,0,0,0,0,0,0
"Israel","2024-01-17",0,0,0,0,0,0,0,0
"Israel","2024-01-18",0,0,0,0,0,0,0,0
"Israel","2024-01-19",0,0,0,0,0,0,0,0
"Israel","2024-01-20",0,0,0,0,0,0,0,0
"Israel","2024-01-21",0,0,0,0,0,0,0,0
"Israel","2024-01-22",0,0,0,0,0,0,0,0
"Israel","2024-01-23",0,0,0,0,0,0,0,0
"Israel","2024-01-24",0,0,0,0,0,0,0,0
"Israel","2024-01-25",0,0,0,0,0,0,0,0
"Israel","2024-01-26",0,0,0,0,0,0,0,0
"Israel","2024-01-27",0,0,0,0,0,0,0,0
"Israel","2024-01-28",0,0,0,0,0,0,0,0
"Israel","2024-01-29",0,0,0,0,0,0,0,0
"Israel","2024-01-30",0,0,0,0,0,0,0,0
"Israel","2024-01-31",0,0,0,0,0,0,0,0
"Israel","2024-02-01",0,0,0,0,0,0,0,0
"Israel","2024-02-02",0,0,0,0,0,0,0,0
"Israel","2024-02-03",0,0,0,0,0,0,0,0
"Israel","2024-02-04",0,0,0,0,0,0,0,0
"Israel","2024-02-05",0,0,0,0,0,0,0,0
"Israel","2024-02-06",0,0,0,0,0,0,0,0
"Israel","2024-02-07",0,0,0,0,0,0,0,0
"Israel","2024-02-08",0,0,0,0,0,0,0,0
"Israel","2024-02-09",0,0,0,0,0,0,0,0
"Israel","2024-02-10",0,0,0,0,0,0,0,0
"Israel","2024-02-11",0,0,0,0,0,0,0,0
"Israel","2024-02-12",0,0,0,0,0,0,0,0
"Israel","2024-02-13",0,0,0,0,0,0,0,0
"Israel","2024-02-14",0,0,0,0,0,0,0,0
"Israel","2024-02-15",0,0,0,0,0,0,0,0
"Israel","2024-02-16",0,0,0,0,0,0,0,0
"Israel","2024-02-17",0,0,0,0,0,0,0,0
"Israel","2024-02-18",0,0,0,0,0,0,0,0
"Israel","2024-02-19",0,0,0,0,0,0,0,0
"Israel","2024-02-20",0,0,0,0,0,0,0,0
"Israel","2024-02-21",0,0,0,0,0,0,0,0
"Israel","2024-02-22",0,0,0,0,0,0,0,0
"Israel","2024-02-23",0,0,0,0,0,0,0,0
"Israel","2024-02-24",0,0,0,0,0,0,0,0
"Israel","2024-02-25",0,0,0,0,0,0,0,0
"Israel","2024-02-26",0,0,0,0,0,0,0,0
"Israel","2024-02-27",0,0,0,0,0,0,0,0
"Israel","2024-02-28",0,0,0,0,0,0,0,0
"Israel","2024-02-29",0,18,18,0,18,18,0,0
"Israel","2024-03-01",0,0,18,0,0,18,0,0
"Israel","2024-03-02",0,0,18,0,0,18,0,0
"Israel","2024-03-03",0,0,18,0,0,18,0,0
"Israel","2024-03-04",0,0,18,0,0,18,0,0
"Israel","2024-03-05",0,0,18,0,0,18,0,0
"Israel","2024-03-06",0,0,18,0,0,18,0,0
"Israel","2024-03-07",0,0,18,0,0,18,0,0
"Israel","2024-03-08",0,0,18,0,0,18,0,0
"Israel","2024-03-09",0,0,18,0,0,18,0,0
"Israel","2024-03-10",0,0,18,0,0,18,0,0
"Israel","2024-03-11",0,0,18,0,0,18,0,0
"Israel","2024-03-12",0,0,18,0,0,18,0,0
"Israel","2024-03-13",0,0,18,0,0,18,0,0
"Israel","2024-03-14",0,0,18,0,0,18,0,0
"Israel","2024-03-15",0,0,18,0,0,18,0,0
"Israel","2024-03-16",0,0,18,0,0,18,0,0
"Israel","2024-03-17",0,0,18,0,0,18,0,0
"Israel","2024-03-18",0,0,18,0,0,18,0,0
"Israel","2024-03-19",0,0,18,0,0,18,0,0
"Israel","2024-03-20",0,0,18,0,0,18,0,0
"Israel","2024-03-21",0,0,18,0,1,19,0,0
"Israel","2024-03-22",0,0,18,0,0,19,0,0
"Israel","2024-03-23",0,0,18,0,0,19,0,0
"Israel","2024-03-24",0,0,18,0,0,19,0,0
"Israel","2024-03-25",0,0,18,0,0,19,0,0
"Israel","2024-03-26",0,0,18,0,0,19,0,0
"Israel","2024-03-27",0,0,18,0,0,19,0,0
"Israel","2024-03-28",0,0,18,0,0,19,0,0
"Israel","2024-03-29",0,0,18,0,0,19,0,0
"Israel","2024-03-30",0,0,18,0,0,19,0,0
"Israel","2024-03-31",0,0,18,0,0,19,0,0
"Israel","2024-04-01",0,0,18,0,0,19,0,0
"Israel","2024-04-02",0,0,18,0,0,19,0,0
"Israel","2024-04-03",0,0,18,0,0,19,0,0
"Israel","2024-04-04",0,0,18,0,0,19,0,0
"Israel","2024-04-05",0,0,18,0,0,19,0,0
"Israel","2024-04-06",0,0,18,0,0,19,0,0
"Israel","2024-04-07",0,0,18,0,0,19,0,0
"Israel","2024-04-08",0,0,18,0,0,19,0,0
"Israel","2024-04-09",0,1,19,0,0,19,0,0
"Israel","2024-04-10",0,0,19,0,0,19,0,0
"Israel","2024-04-11",0,0,19,0,1,20,0,0
"Israel","2024-04-12",0,0,19,0,0,20,0,0
"Israel","2024-04-13",0,0,19,0,0,20,0,0
"Israel","2024-04-14",0,0,19,0,1,21,0,0
"Israel","2024-04-15",0,0,19,0,0,21,0,0
"Israel","2024-04-16",0,0,19,0,0,21,0,0
"Israel","2024-04-17",0,0,19,0,1,22,0,0
"Israel","2024-04-18",0,0,19,0,0,22,0,0
"Israel","2024-04-19",0,0,19,0,0,22,0,0
"Israel","2024-04-20",0,0,19,0,1,23,0,0
"Israel","2024-04-21",0,0,19,0,0,23,0,0
"Israel","2024-04-22",0,0,19,0,0,23,0,0
"Israel","2024-04-23",0,0,19,0,1,24,0,0
"Israel","2024-04-24",0,0,19,0,0,24,0,0
"Israel","2024-04-25",0,0,19,0,1,25,0,0
"Israel","2024-04-26",0,0,19,0,0,25,0,0
"Israel","2024-04-27",0,0,19,0,0,25,0,0
"Israel","2024-04-28",0,0,19,0,1,26,0,0
"Israel","2024-04-29",0,0,19,0,0,26,0,0
"Israel","2024-04-30",0,0,19,0,0,26,0,0
"Israel","2024-05-01",0,0,19,0,1,27,0,0
"Israel","2024-05-02",0,0,19,0,0,27,0,0
"Israel","2024-05-03",0,0,19,0,0,27,0,0
"Israel","2024-05-04",0,0,19,0,1,28,0,0
"Israel","2024-05-05",0,0,19,0,0,28,0,0
"Israel","2024-05-06",0,0,19,0,0,28,0,0
"Israel","2024-05-07",0,0,19,0,1,29,0,0
"Israel","2024-05-08",0,0,19,0,0,29,0,0
"Israel","2024-05-09",0,0,19,0,0,29,0,0
"Israel","2024-05-10",0,0,19,0,1,30,0,0
"Israel","2024-05-11",0,0,19,0,0,30,0,0
"Israel","2024-05-12",0,0,19,0,0,30,0,0
"Israel","2024-05-13",0,0,19,0,1,31,0,0
"Israel","2024-05-14",0,0,19,0,0,31,0,0
"Israel","2024-05-15",0,0,19,0,0,31,0,0
"Israel","2024-05-16",0,0,19,0,1,32,0,0
"Israel","2024-05-17",0,0,19,0,0,32,0,0
"Israel","2024-05-18",0,0,19,0,1,33,0,0
"Israel","2024-05-19",0,0,19,0,0,33,0,0
"Israel","2024-05-20",0,0,19,0,0,33,0,0
"Israel","2024-05-21",0,0,19,0,1,34,0,0
"Israel","2024-05-22",0,0,19,0,0,34,0,0
"Israel","2024-05-23",0,0,19,0,0,34,0,0
"Israel","2024-05-24",0,0,19,0,1,35,0,0
"Israel","2024-05-25",0,0,19,0,0,35,0,0
"Israel","2024-05-26",0,0,19,0,0,35,0,0
"Israel","2024-05-27",0,0,19,0,1,36,0,0
"Israel","2024-05-28",0,0,19,0,0,36,0,0
"Israel","2024-05-29",0,0,19,0,0,36,0,0
"Israel","2024-05-30",0,0,19,0,1,37,0,0
"Israel","2024-05-31",0,18,37,0,0,37,0,0
"Israel","2024-06-01",0,0,37,0,0,37,0,0
"Israel","2024-06-02",0,0,37,0,0,37,0,0
"Israel","2024-06-03",0,0,37,0,0,37,0,0
"Israel","2024-06-04",0,0,37,0,0,37,0,0
"Israel","2024-06-05",0,0,37,0,0,37,0,0
"Israel","2024-06-06",0,0,37,0,0,37,0,0
"Israel","2024-06-07",0,0,37,0,0,37,0,0
"Israel","2024-06-08",0,0,37,0,1,38,0,0
"Israel","2024-06-09",0,0,37,0,0,38,0,0
"Israel","2024-06-10",0,0,37,0,0,38,0,0
"Israel","2024-06-11",0,0,37,0,0,38,0,0
"Israel","2024-06-12",0,0,37,0,0,38,0,0
"Israel","2024-06-13",0,0,37,0,0,38,0,0
"Israel","2024-06-14",0,0,37,0,0,38,0,0
"Israel","2024-06-15",0,0,37,0,0,38,0,0
"Israel","2024-06-16",0,0,37,0,0,38,0,0
"Israel","2024-06-17",0,0,37,0,0,38,0,0
"Israel","2024-06-18",0,0,37,0,0,38,0,0
"Israel","2024-06-19",0,0,37,0,0,38,0,0
"Israel","2024-06-20",0,0,37,0,0,38,0,0
"Israel","2024-06-21",0,0,37,0,0,38,0,0
"Israel","2024-06-22",0,0,37,0,0,38,0,0
"Israel","2024-06-23",0,0,37,0,1,39,0,0
"Israel","2024-06-24",0,0,37,0,0,39,0,0
"Israel","2024-06-25",0,0,37,0,0,39,0,0
"Israel","2024-06-26",0,0,37,0,0,39,0,0
"Israel","2024-06-27",0,0,37,0,0,39,0,0
"Israel","2024-06-28",0,0,37,0,0,39,0,0
"Israel","2024-06-29",0,0,37,0,0,39,0,0
"Israel","2024-06-30",0,2,39,0,0,39,0,0
"Israel","2024-07-01",0,0,39,0,0,39,0,0
"Israel","2024-07-02",0,0,39,0,0,39,0,0
"Israel","2024-07-03",0,0,39,0,0,39,0,0
"Israel","2024-07-04",0,0,39,0,0,39,0,0
"Israel","2024-07-05",0,0,39,0,0,39,0,0
"Israel","2024-07-06",0,0,39,0,1,40,0,0
"Israel","2024-07-07",0,0,39,0,0,40,0,0
"Israel","2024-07-08",0,0,39,0,0,40,0,0
"Israel","2024-07-09",0,0,39,0,0,40,0,0
"Israel","2024-07-10",0,0,39,0,0,40,0,0
"Israel","2024-07-11",0,0,39,0,0,40,0,0
"Israel","2024-07-12",0,0,39,0,0,40,0,0
"Israel","2024-07-13",0,0,39,0,0,40,0,0
"Israel","2024-07-14",0,0,39,0,0,40,0,0
"Israel","2024-07-15",0,0,39,0,0,40,0,0
"Israel","2024-07-16",0,0,39,0,1,41,0,0
"Israel","2024-07-17",0,0,39,0,0,41,0,0
"Israel","2024-07-18",0,0,39,0,0,41,0,0
"Israel","2024-07-19",0,0,39,0,0,41,0,0
"Israel","2024-07-20",0,0,39,0,0,41,0,0
"Israel","2024-07-21",0,0,39,0,0,41,0,0
"Israel","2024-07-22",0,0,39,0,0,41,0,0
"Israel","2024-07-23",0,0,39,0,0,41,0,0
"Israel","2024-07-24",0,0,39,0,0,41,0,0
"Israel","2024-07-25",0,0,39,0,0,41,0,0
"Israel","2024-07-26",0,0,39,0,1,42,0,0
"Israel","2024-07-27",0,0,39,0,0,42,0,0
"Israel","2024-07-28",0,0,39,0,0,42,0,0
"Israel","2024-07-29",0,0,39,0,0,42,0,0
"Israel","2024-07-30",0,0,39,0,0,42,0,0
"Israel","2024-07-31",0,3,42,0,0,42,0,0
"Israel","2024-08-01",0,0,42,0,0,42,0,0
"Israel","2024-08-02",0,0,42,0,0,42,0,0
"Israel","2024-08-03",0,0,42,0,0,42,0,0
"Israel","2024-08-04",0,0,42,0,1,43,0,0
"Israel","2024-08-05",0,0,42,0,0,43,0,0
"Israel","2024-08-06",0,0,42,0,0,43,0,0
"Israel","2024-08-07",0,0,42,0,0,43,0,0
"Israel","2024-08-08",0,0,42,0,0,43,0,0
"Israel","2024-08-09",0,0,42,0,0,43,0,0
"Israel","2024-08-10",0,0,42,0,0,43,0,0
"Israel","2024-08-11",0,0,42,0,0,43,0,0
"Israel","2024-08-12",0,0,42,0,1,44,0,0
"Israel","2024-08-13",0,0,42,0,0,44,0,0
"Israel","2024-08-14",0,0,42,0,0,44,0,0
"Israel","2024-08-15",0,0,42,0,0,44,0,0
"Israel","2024-08-16",0,0,42,0,0,44,0,0
"Israel","2024-08-17",0,0,42,0,0,44,0,0
"Israel","2024-08-18",0,0,42,0,0,44,0,0
"Israel","2024-08-19",0,0,42,0,0,44,0,0
"Israel","2024-08-20",0,0,42,0,1,45,0,0
"Israel","2024-08-21",0,0,42,0,0,45,0,0
"Israel","2024-08-22",0,0,42,0,0,45,0,0
"Israel","2024-08-23",0,0,42,0,0,45,0,0
"Israel","2024-08-24",0,0,42,0,0,45,0,0
"Israel","2024-08-25",0,0,42,0,0,45,0,0
"Israel","2024-08-26",0,0,42,0,0,45,0,0
"Israel","2024-08-27",0,0,42,0,0,45,0,0
"Israel","2024-08-28",0,0,42,0,1,46,0,0
"Israel","2024-08-29",0,0,42,0,0,46,0,0
"Israel","2024-08-30",0,0,42,0,0,46,0,0
"Israel","2024-08-31",0,4,46,0,0,46,0,0
"Israel","2024-09-01",0,0,46,0,0,46,0,0
"Israel","2024-09-02",0,0,46,0,0,46,0,0
"Israel","2024-09-03",0,0,46,0,0,46,0,0
"Israel","2024-09-04",0,0,46,0,1,47,0,0
"Israel","2024-09-05",0,0,46,0,0,47,0,0
"Israel","2024-09-06",0,0,46,0,0,47,0,0
"Israel","2024-09-07",0,0,46,0,0,47,0,0
"Israel","2024-09-08",0,0,46,0,0,47,0,0
"Israel","2024-09-09",0,0,46,0,0,47,0,0
"Israel","2024-09-10",0,0,46,0,0,47,0,0
"Israel","2024-09-11",0,0,46,0,0,47,0,0
"Israel","2024-09-12",0,0,46,0,1,48,0,0
"Israel","2024-09-13",0,0,46,0,0,48,0,0
"Israel","2024-09-14",0,0,46,0,0,48,0,0
"Israel","2024-09-15",0,0,46,0,0,48,0,0
"Israel","2024-09-16",0,0,46,0,0,48,0,0
"Israel","2024-09-17",0,0,46,0,0,48,0,0
"Israel","2024-09-18",0,0,46,0,0,48,0,0
"Israel","2024-09-19",0,0,46,0,1,49,0,0
"Israel","2024-09-20",0,0,46,0,0,49,0,0
"Israel","2024-09-21",0,0,46,0,0,49,0,0
"Israel","2024-09-22",0,0,46,0,0,49,0,0
"Israel","2024-09-23",0,0,46,0,0,49,0,0
"Israel","2024-09-24",0,0,46,0,0,49,0,0
"Israel","2024-09-25",0,0,46,0,0,49,0,0
"Israel","2024-09-26",0,0,46,0,0,49,0,0
"Israel","2024-09-27",0,0,46,0,1,50,0,0
"Israel","2024-09-28",0,0,46,0,0,50,0,0
"Israel","2024-09-29",0,0,46,0,0,50,0,0
"Israel","2024-09-30",0,4,50,0,0,50,0,0
"Israel","2024-10-01",0,0,50,0,0,50,0,0
"Israel","2024-10-02",0,0,50,0,0,50,0,0
"Israel","2024-10-03",0,0,50,0,0,50,0,0
"Israel","2024-10-04",0,0,50,0,0,50,0,0
"Israel","2024-10-05",0,0,50,0,0,50,0,0
"Israel","2024-10-06",0,0,50,0,0,50,0,0
"Israel","2024-10-07",0,0,50,0,0,50,0,0
"Israel","2024-10-08",0,0,50,0,0,50,0,0
"Israel","2024-10-09",0,0,50,0,0,50,0,0
"Israel","2024-10-10",0,0,50,0,0,50,0,0
"Israel","2024-10-11",0,0,50,0,0,50,0,0
"Israel","2024-10-12",0,0,50,0,0,50,0,0
"Israel","2024-10-13",0,0,50,0,0,50,0,0
"Israel","2024-10-14",0,0,50,0,0,50,0,0
"Israel","2024-10-15",0,0,50,0,0,50,0,0
"Israel","2024-10-16",0,0,50,0,0,50,0,0
"Israel","2024-10-17",0,0,50,0,0,50,0,0
"Israel","2024-10-18",0,0,50,0,0,50,0,0
"Israel","2024-10-19",0,0,50,0,0,50,0,0
"Israel","2024-10-20",0,0,50,0,0,50,0,0
"Israel","2024-10-21",0,0,50,0,0,50,0,0
"Israel","2024-10-22",0,0,50,0,0,50,0,0
"Israel","2024-10-23",0,0,50,0,0,50,0,0
"Israel","2024-10-24",0,0,50,0,0,50,0,0
"Israel","2024-10-25",0,0,50,0,0,50,0,0
"Israel","2024-10-26",0,0,50,0,0,50,0,0
"Israel","2024-10-27",0,0,50,0,0,50,0,0
"Israel","2024-10-28",0,0,50,0,0,50,0,0
"Israel","2024-10-29",0,0,50,0,0,50,0,0
"Israel","2024-10-30",0,0,50,0,0,50,0,0
"Israel","2024-10-31",0,0,50,0,0,50,0,0
"Israel","2024-11-01",0,0,50,0,0,50,0,0
"Israel","2024-11-02",0,0,50,0,0,50,0,0
"Israel","2024-11-03",0,0,50,0,0,50,0,0
"Israel","2024-11-04",0,0,50,0,0,50,0,0
"Israel","2024-11-05",0,0,50,0,0,50,0,0
"Israel","2024-11-06",0,0,50,0,0,50,0,0
"Israel","2024-11-07",0,0,50,0,0,50,0,0
"Israel","2024-11-08",0,0,50,0,0,50,0,0
"Israel","2024-11-09",0,0,50,0,0,50,0,0
"Israel","2024-11-10",0,0,50,0,0,50,0,0
"Israel","2024-11-11",0,0,50,0,0,50,0,0
"Israel","2024-11-12",0,0,50,0,0,50,0,0
"Israel","2024-11-13",0,0,50,0,0,50,0,0
"Israel","2024-11-14",0,0,50,0,0,50,0,0
"Israel","2024-11-15",0,0,50,0,0,50,0,0
"Israel","2024-11-16",0,0,50,0,0,50,0,0
"Israel","2024-11-17",0,0,50,0,0,50,0,0
"Israel","2024-11-18",0,0,50,0,0,50,0,0
"Israel","2024-11-19",0,0,50,0,0,50,0,0
"Israel","2024-11-20",0,0,50,0,0,50,0,0
"Israel","2024-11-21",0,0,50,0,0,50,0,0
"Israel","2024-11-22",0,0,50,0,0,50,0,0
"Israel","2024-11-23",0,0,50,0,0,50,0,0
"Israel","2024-11-24",0,0,50,0,0,50,0,0
"Israel","2024-11-25",0,0,50,0,0,50,0,0
"Israel","2024-11-26",0,0,50,0,0,50,0,0
"Israel","2024-11-27",0,0,50,0,0,50,0,0
"Israel","2024-11-28",0,0,50,0,0,50,0,0
"Israel","2024-11-29",0,0,50,0,0,50,0,0
"Israel","2024-11-30",0,0,50,0,0,50,0,0
"Israel","2024-12-01",0,0,50,0,0,50,0,0
"Israel","2024-12-02",0,0,50,0,0,50,0,0
"Israel","2024-12-03",0,0,50,0,0,50,0,0
"Israel","2024-12-04",0,0,50,0,0,50,0,0
"Israel","2024-12-05",0,0,50,0,0,50,0,0
"Israel","2024-12-06",0,0,50,0,0,50,0,0
"Israel","2024-12-07",0,0,50,0,0,50,0,0
"Israel","2024-12-08",0,0,50,0,0,50,0,0
"Israel","2024-12-09",0,0,50,0,0,50,0,0
"Israel","2024-12-10",0,0,50,0,0,50,0,0
"Israel","2024-12-11",0,0,50,0,0,50,0,0
"Israel","2024-12-12",0,0,50,0,0,50,0,0
"Israel","2024-12-13",0,0,50,0,0,50,0,0
"Israel","2024-12-14",0,0,50,0,0,50,0,0
"Israel","2024-12-15",0,0,50,0,0,50,0,0
"Israel","2024-12-16",0,0,50,0,0,50,0,0
"Israel","2024-12-17",0,0,50,0,0,50,0,0
"Israel","2024-12-18",0,0,50,0,0,50,0,0
"Israel","2024-12-19",0,0,50,0,0,50,0,0
"Israel","2024-12-20",0,0,50,0,0,50,0,0
"Israel","2024-12-21",0,0,50,0,0,50,0,0
"Israel","2024-12-22",0,0,50,0,0,50,0,0
"Israel","2024-12-23",0,0,50,0,0,50,0,0
"Israel","2024-12-24",0,0,50,0,0,50,0,0
"Israel","2024-12-25",0,0,50,0,0,50,0,0
"Israel","2024-12-26",0,0,50,0,0,50,0,0
"Israel","2024-12-27",0,0,50,0,0,50,0,0
"Israel","2024-12-28",0,0,50,0,0,50,0,0
"Israel","2024-12-29",0,0,50,0,0,50,0,0
"Israel","2024-12-30",0,0,50,0,0,50,0,0
"Israel","2024-12-31",0,0,50,0,0,50,0,0
"Israel","2025-01-01",0,0,50,0,0,50,0,0
"Israel","2025-01-02",0,0,50,0,0,50,0,0
"Israel","2025-01-03",0,0,50,0,0,50,0,0
"Israel","2025-01-04",0,0,50,0,0,50,0,0
"Israel","2025-01-05",0,0,50,0,0,50,0,0
"Israel","2025-01-06",0,0,50,0,0,50,0,0
"Israel","2025-01-07",0,0,50,0,0,50,0,0
"Israel","2025-01-08",0,0,50,0,0,50,0,0
"Israel","2025-01-09",0,0,50,0,0,50,0,0
"Israel","2025-01-10",0,0,50,0,0,50,0,0
"Israel","2025-01-11",0,0,50,0,0,50,0,0
"Israel","2025-01-12",0,0,50,0,0,50,0,0
"Israel","2025-01-13",0,0,50,0,0,50,0,0
"Italy","2024-01-01",0,0,0,0,0,0,0,0
"Italy","2024-01-02",0,0,0,0,0,0,0,0
"Italy","2024-01-03",0,0,0,0,0,0,0,0
"Italy","2024-01-04",0,0,0,0,0,0,0,0
"Italy","2024-01-05",0,0,0,0,0,0,0,0
"Italy","2024-01-06",0,0,0,0,0,0,0,0
"Italy","2024-01-07",0,0,0,0,0,0,0,0
"Italy","2024-01-08",0,0,0,0,0,0,0,0
"Italy","2024-01-09",0,0,0,0,0,0,0,0
"Italy","2024-01-10",0,0,0,0,0,0,0,0
"Italy","2024-01-11",0,0,0,0,0,0,0,0
"Italy","2024-01-12",0,0,0,0,0,0,0,0
"Italy","2024-01-13",0,0,0,0,0,0,0,0
"Italy","2024-01-14",0,0,0,0,0,0,0,0
"Italy","2024-01-15",0,0,0,0,0,0,0,0
"Italy","2024-01-16",0,0,0,0,0,0,0,0
"Italy","2024-01-17",0,0,0,0,0,0,0,0
"Italy","2024-01-18",0,0,0,0,0,0,0,0
"Italy","2024-01-19",0,0,0,0,0,0,0,0
"Italy","2024-01-20",0,0,0,0,0,0,0,0
"Italy","2024-01-21",0,0,0,0,0,0,0,0
"Italy","2024-01-22",0,0,0,0,0,0,0,0
"Italy","2024-01-23",0,0,0,0,0,0,0,0
"Italy","2024-01-24",0,0,0,0,0,0,0,0
"Italy","2024-01-25",0,0,0,0,0,0,0,0
"Italy","2024-01-26",0,0,0,0,0,0,0,0
"Italy","2024-01-27",0,0,0,0,0,0,0,0
"Italy","2024-01-28",0,0,0,0,0,0,0,0
"Italy","2024-01-29",0,0,0,0,0,0,0,0
"Italy","2024-01-30",0,0,0,0,0,0,0,0
"Italy","2024-01-31",0,26,26,0,26,26,0,0
"Italy","2024-02-01",0,0,26,0,0,26,0,0
"Italy","2024-02-02",0,0,26,0,1,27,0,0
"Italy","2024-02-03",0,0,26,0,0,27,0,0
"Italy","2024-02-04",0,0,26,0,1,28,0,0
"Italy","2024-02-05",0,0,26,0,0,28,0,0
"Italy","2024-02-06",0,0,26,0,1,29,0,0
"Italy","2024-02-07",0,0,26,0,0,29,0,0
"Italy","2024-02-08",0,0,26,0,1,30,0,0
"Italy","2024-02-09",0,0,26,0,0,30,0,0
"Italy","2024-02-10",0,0,26,0,0,30,0,0
"Italy","2024-02-11",0,0,26,0,1,31,0,0
"Italy","2024-02-12",0,0,26,0,0,31,0,0
"Italy","2024-02-13",0,0,26,0,1,32,0,0
"Italy","2024-02-14",0,0,26,0,0,32,0,0
"Italy","2024-02-15",0,0,26,0,1,33,0,0
"Italy","2024-02-16",0,0,26,0,0,33,0,0
"Italy","2024-02-17",0,0,26,0,1,34,0,0
"Italy","2024-02-18",0,0,26,0,0,34,0,0
"Italy","2024-02-19",0,0,26,0,1,35,0,0
"Italy","2024-02-20",0,0,26,0,0,35,0,0
"Italy","2024-02-21",0,0,26,0,0,35,0,0
"Italy","2024-02-22",0,0,26,0,1,36,0,0
"Italy","2024-02-23",0,0,26,0,0,36,0,0
"Italy","2024-02-24",0,0,26,0,1,37,0,0
"Italy","2024-02-25",0,0,26,0,0,37,0,0
"Italy","2024-02-26",0,0,26,0,1,38,0,0
"Italy","2024-02-27",0,0,26,0,0,38,0,0
"Italy","2024-02-28",0,0,26,0,1,39,0,0
"Italy","2024-02-29",0,13,39,0,0,39,0,0
"Italy","2024-03-01",0,0,39,0,0,39,0,0
"Italy","2024-03-02",0,0,39,0,1,40,0,0
"Italy","2024-03-03",0,0,39,0,0,40,0,0
"Italy","2024-03-04",0,0,39,0,1,41,0,0
"Italy","2024-03-05",0,0,39,0,0,41,0,0
"Italy","2024-03-06",0,0,39,0,1,42,0,0
"Italy","2024-03-07",0,0,39,0,0,42,0,0
"Italy","2024-03-08",0,0,39,0,1,43,0,0
"Italy","2024-03-09",0,0,39,0,0,43,0,0
"Italy","2024-03-10",0,0,39,0,1,44,0,0
"Italy","2024-03-11",0,0,39,0,0,44,0,0
"Italy","2024-03-12",0,0,39,0,0,44,0,0
"Italy","2024-03-13",0,0,39,0,1,45,0,0
"Italy","2024-03-14",0,0,39,0,0,45,0,0
"Italy","2024-03-15",0,0,39,0,1,46,0,0
"Italy","2024-03-16",0,0,39,0,0,46,0,0
"Italy","2024-03-17",0,0,39,0,1,47,0,0
"Italy","2024-03-18",0,0,39,0,0,47,0,0
"Italy","2024-03-19",0,0,39,0,1,48,0,0
"Italy","2024-03-20",0,0,39,0,0,48,0,0
"Italy","2024-03-21",0,0,39,0,0,48,0,0
"Italy","2024-03-22",0,0,39,0,1,49,0,0
"Italy","2024-03-23",0,0,39,0,0,49,0,0
"Italy","2024-03-24",0,0,39,0,1,50,0,0
"Italy","2024-03-25",0,0,39,0,0,50,0,0
"Italy","2024-03-26",0,0,39,0,1,51,0,0
"Italy","2024-03-27",0,0,39,0,0,51,0,0
"Italy","2024-03-28",0,0,39,0,1,52,0,0
"Italy","2024-03-29",0,0,39,0,0,52,0,0
"Italy","2024-03-30",0,0,39,0,1,53,0,0
"Italy","2024-03-31",0,14,53,0,0,53,0,0
"Italy","2024-04-01",0,0,53,0,0,53,0,0
"Italy","2024-04-02",0,0,53,0,0,53,0,0
"Italy","2024-04-03",0,0,53,0,0,53,0,0
"Italy","2024-04-04",0,0,53,0,0,53,0,0
"Italy","2024-04-05",0,0,53,0,0,53,0,0
"Italy","2024-04-06",0,0,53,0,0,53,0,0
"Italy","2024-04-07",0,0,53,0,0,53,0,0
"Italy","2024-04-08",0,0,53,0,0,53,0,0
"Italy","2024-04-09",0,0,53,0,0,53,0,0
"Italy","2024-04-10",0,0,53,0,0,53,0,0
"Italy","2024-04-11",0,0,53,0,0,53,0,0
"Italy","2024-04-12",0,0,53,0,0,53,0,0
"Italy","2024-04-13",0,0,53,0,0,53,0,0
"Italy","2024-04-14",0,0,53,0,0,53,0,0
"Italy","2024-04-15",0,0,53,0,0,53,0,0
"Italy","2024-04-16",0,0,53,0,1,54,0,0
"Italy","2024-04-17",0,0,53,0,0,54,0,0
"Italy","2024-04-18",0,0,53,0,0,54,0,0
"Italy","2024-04-19",0,0,53,0,0,54,0,0
"Italy","2024-04-20",0,0,53,0,0,54,0,0
"Italy","2024-04-21",0,0,53,0,0,54,0,0
"Italy","2024-04-22",0,0,53,0,0,54,0,0
"Italy","2024-04-23",0,0,53,0,0,54,0,0
"Italy","2024-04-24",0,0,53,0,0,54,0,0
"Italy","2024-04-25",0,0,53,0,0,54,0,0
"Italy","2024-04-26",0,0,53,0,0,54,0,0
"Italy","2024-04-27",0,0,53,0,0,54,0,0
"Italy","2024-04-28",0,0,53,0,0,54,0,0
"Italy","2024-04-29",0,0,53,0,0,54,0,0
"Italy","2024-04-30",0,1,54,0,0,54,0,0
"Italy","2024-05-01",0,0,54,0,0,54,0,0
"Italy","2024-05-02",0,0,54,0,0,54,0,0
"Italy","2024-05-03",0,0,54,0,0,54,0,0
"Italy","2024-05-04",0,0,54,0,1,55,0,0
"Italy","2024-05-05",0,0,54,0,0,55,0,0
"Italy","2024-05-06",0,0,54,0,0,55,0,0
"Italy","2024-05-07",0,0,54,0,0,55,0,0
"Italy","2024-05-08",0,0,54,0,0,55,0,0
"Italy","2024-05-09",0,0,54,0,0,55,0,0
"Italy","2024-05-10",0,0,54,0,0,55,0,0
"Italy","2024-05-11",0,0,54,0,0,55,0,0
"Italy","2024-05-12",0,0,54,0,1,56,0,0
"Italy","2024-05-13",0,0,54,0,0,56,0,0
"Italy","2024-05-14",0,0,54,0,0,56,0,0
"Italy","2024-05-15",0,0,54,0,0,56,0,0
"Italy","2024-05-16",0,0,54,0,0,56,0,0
"Italy","2024-05-17",0,0,54,0,0,56,0,0
"Italy","2024-05-18",0,0,54,0,0,56,0,0
"Italy","2024-05-19",0,0,54,0,0,56,0,0
"Italy","2024-05-20",0,0,54,0,1,57,0,0
"Italy","2024-05-21",0,0,54,0,0,57,0,0
"Italy","2024-05-22",0,0,54,0,0,57,0,0
"Italy","2024-05-23",0,0,54,0,0,57,0,0
"Italy","2024-05-24",0,0,54,0,0,57,0,0
"Italy","2024-05-25",0,0,54,0,0,57,0,0
"Italy","2024-05-26",0,0,54,0,0,57,0,0
"Italy","2024-05-27",0,0,54,0,0,57,0,0
"Italy","2024-05-28",0,0,54,0,1,58,0,0
"Italy","2024-05-29",0,0,54,0,0,58,0,0
"Italy","2024-05-30",0,0,54,0,0,58,0,0
"Italy","2024-05-31",0,4,58,0,0,58,0,0
"Italy","2024-06-01",0,0,58,0,0,58,0,0
"Italy","2024-06-02",0,0,58,0,0,58,0,0
"Italy","2024-06-03",0,0,58,0,0,58,0,0
"Italy","2024-06-04",0,0,58,0,0,58,0,0
"Italy","2024-06-05",0,0,58,0,0,58,0,0
"Italy","2024-06-06",0,0,58,0,0,58,0,0
"Italy","2024-06-07",0,0,58,0,0,58,0,0
"Italy","2024-06-08",0,0,58,0,1,59,0,0
"Italy","2024-06-09",0,0,58,0,0,59,0,0
"Italy","2024-06-10",0,0,58,0,0,59,0,0
"Italy","2024-06-11",0,0,58,0,0,59,0,0
"Italy","2024-06-12",0,0,58,0,0,59,0,0
"Italy","2024-06-13",0,0,58,0,0,59,0,0
"Italy","2024-06-14",0,0,58,0,0,59,0,0
"Italy","2024-06-15",0,0,58,0,0,59,0,0
"Italy","2024-06-16",0,0,58,0,0,59,0,0
"Italy","2024-06-17",0,0,58,0,0,59,0,0
"Italy","2024-06-18",0,0,58,0,0,59,0,0
"Italy","2024-06-19",0,0,58,0,0,59,0,0
"Italy","2024-06-20",0,0,58,0,0,59,0,0
"Italy","2024-06-21",0,0,58,0,0,59,0,0
"Italy","2024-06-22",0,0,58,0,0,59,0,0
"Italy","2024-06-23",0,0,58,0,1,60,0,0
"Italy","2024-06-24",0,0,58,0,0,60,0,0
"Italy","2024-06-25",0,0,58,0,0,60,0,0
"Italy","2024-06-26",0,0,58,0,0,60,0,0
"Italy","2024-06-27",0,0,58,0,0,60,0,0
"Italy","2024-06-28",0,0,58,0,0,60,0,0
"Italy","2024-06-29",0,0,58,0,0,60,0,0
"Italy","2024-06-30",0,2,60,0,0,60,0,0
"Italy","2024-07-01",0,0,60,0,0,60,0,0
"Italy","2024-07-02",0,0,60,0,0,60,0,0
"Italy","2024-07-03",0,0,60,0,1,61,0,0
"Italy","2024-07-04",0,0,60,0,0,61,0,0
"Italy","2024-07-05",0,0,60,0,0,61,0,0
"Italy","2024-07-06",0,0,60,0,0,61,0,0
"Italy","2024-07-07",0,0,60,0,1,62,0,0
"Italy","2024-07-08",0,0,60,0,0,62,0,0
"Italy","2024-07-09",0,0,60,0,0,62,0,0
"Italy","2024-07-10",0,0,60,0,0,62,0,0
"Italy","2024-07-11",0,0,60,0,0,62,0,0
"Italy","2024-07-12",0,0,60,0,1,63,0,0
"Italy","2024-07-13",0,0,60,0,0,63,0,0
"Italy","2024-07-14",0,0,60,0,0,63,0,0
"Italy","2024-07-15",0,0,60,0,0,63,0,0
"Italy","2024-07-16",0,0,60,0,1,64,0,0
"Italy","2024-07-17",0,0,60,0,0,64,0,0
"Italy","2024-07-18",0,0,60,0,0,64,0,0
"Italy","2024-07-19",0,0,60,0,0,64,0,0
"Italy","2024-07-20",0,0,60,0,1,65,0,0
"Italy","2024-07-21",0,0,60,0,0,65,0,0
"Italy","2024-07-22",0,0,60,0,0,65,0,0
"Italy","2024-07-23",0,0,60,0,0,65,0,0
"Italy","2024-07-24",0,0,60,0,0,65,0,0
"Italy","2024-07-25",0,0,60,0,1,66,0,0
"Italy","2024-07-26",0,0,60,0,0,66,0,0
"Italy","2024-07-27",0,0,60,0,0,66,0,0
"Italy","2024-07-28",0,0,60,0,0,66,0,0
"Italy","2024-07-29",0,0,60,0,1,67,0,0
"Italy","2024-07-30",0,0,60,0,0,67,0,0
"Italy","2024-07-31",0,7,67,0,0,67,0,0
"Italy","2024-08-01",0,0,67,0,0,67,0,0
"Italy","2024-08-02",0,0,67,0,0,67,0,0
"Italy","2024-08-03",0,0,67,0,0,67,0,0
"Italy","2024-08-04",0,0,67,0,0,67,0,0
"Italy","2024-08-05",0,0,67,0,0,67,0,0
"Italy","2024-08-06",0,0,67,0,0,67,0,0
"Italy","2024-08-07",0,0,67,0,0,67,0,0
"Italy","2024-08-08",0,0,67,0,0,67,0,0
"Italy","2024-08-09",0,0,67,0,0,67,0,0
"Italy","2024-08-10",0,0,67,0,0,67,0,0
"Italy","2024-08-11",0,0,67,0,0,67,0,0
"Italy","2024-08-12",0,0,67,0,0,67,0,0
"Italy","2024-08-13",0,0,67,0,0,67,0,0
"Italy","2024-08-14",0,0,67,0,0,67,0,0
"Italy","2024-08-15",0,0,67,0,0,67,0,0
"Italy","2024-08-16",0,0,67,0,1,68,0,0
"Italy","2024-08-17",0,0,67,0,0,68,0,0
"Italy","2024-08-18",0,0,67,0,0,68,0,0
"Italy","2024-08-19",0,0,67,0,0,68,0,0
"Italy","2024-08-20",0,0,67,0,0,68,0,0
"Italy","2024-08-21",0,0,67,0,0,68,0,0
"Italy","2024-08-22",0,0,67,0,0,68,0,0
"Italy","2024-08-23",0,0,67,0,0,68,0,0
"Italy","2024-08-24",0,0,67,0,0,68,0,0
"Italy","2024-08-25",0,0,67,0,0,68,0,0
"Italy","2024-08-26",0,0,67,0,0,68,0,0
"Italy","2024-08-27",0,0,67,0,0,68,0,0
"Italy","2024-08-28",0,0,67,0,0,68,0,0
"Italy","2024-08-29",0,0,67,0,0,68,0,0
"Italy","2024-08-30",0,0,67,0,0,68,0,0
"Italy","2024-08-31",0,1,68,0,0,68,0,0
"Italy","2024-09-01",0,0,68,0,0,68,0,0
"Italy","2024-09-02",0,0,68,0,0,68,0,0
"Italy","2024-09-03",0,0,68,0,0,68,0,0
"Italy","2024-09-04",0,0,68,0,1,69,0,0
"Italy","2024-09-05",0,0,68,0,0,69,0,0
"Italy","2024-09-06",0,0,68,0,0,69,0,0
"Italy","2024-09-07",0,0,68,0,0,69,0,0
"Italy","2024-09-08",0,0,68,0,0,69,0,0
"Italy","2024-09-09",0,0,68,0,1,70,0,0
"Italy","2024-09-10",0,0,68,0,0,70,0,0
"Italy","2024-09-11",0,0,68,0,0,70,0,0
"Italy","2024-09-12",0,0,68,0,0,70,0,0
"Italy","2024-09-13",0,0,68,0,0,70,0,0
"Italy","2024-09-14",0,0,68,0,0,70,0,0
"Italy","2024-09-15",0,0,68,0,0,70,0,0
"Italy","2024-09-16",0,0,68,0,1,71,0,0
"Italy","2024-09-17",0,0,68,0,0,71,0,0
"Italy","2024-09-18",0,0,68,0,0,71,0,0
"Italy","2024-09-19",0,0,68,0,0,71,0,0
"Italy","2024-09-20",0,0,68,0,0,71,0,0
"Italy","2024-09-21",0,0,68,0,1,72,0,0
"Italy","2024-09-22",0,0,68,0,0,72,0,0
"Italy","2024-09-23",0,0,68,0,0,72,0,0
"Italy","2024-09-24",0,0,68,0,0,72,0,0
"Italy","2024-09-25",0,0,68,0,0,72,0,0
"Italy","2024-09-26",0,0,68,0,0,72,0,0
"Italy","2024-09-27",0,0,68,0,0,72,0,0
"Italy","2024-09-28",0,0,68,0,1,73,0,0
"Italy","2024-09-29",0,0,68,0,0,73,0,0
"Italy","2024-09-30",0,5,73,0,0,73,0,0
"Italy","2024-10-01",0,0,73,0,0,73,0,0
"Italy","2024-10-02",0,0,73,0,1,74,0,0
"Italy","2024-10-03",0,0,73,0,0,74,0,0
"Italy","2024-10-04",0,0,73,0,0,74,0,0
"Italy","2024-10-05",0,0,73,0,1,75,0,0
"Italy","2024-10-06",0,0,73,0,0,75,0,0
"Italy","2024-10-07",0,0,73,0,0,75,0,0
"Italy","2024-10-08",0,0,73,0,1,76,0,0
"Italy","2024-10-09",0,0,73,0,0,76,0,0
"Italy","2024-10-10",0,0,73,0,0,76,0,0
"Italy","2024-10-11",0,0,73,0,1,77,0,0
"Italy","2024-10-12",0,0,73,0,0,77,0,0
"Italy","2024-10-13",0,0,73,0,0,77,0,0
"Italy","2024-10-14",0,0,73,0,1,78,0,0
"Italy","2024-10-15",0,0,73,0,0,78,0,0
"Italy","2024-10-16",0,0,73,0,0,78,0,0
"Italy","2024-10-17",0,0,73,0,0,78,0,0
"Italy","2024-10-18",0,0,73,0,1,79,0,0
"Italy","2024-10-19",0,0,73,0,0,79,0,0
"Italy","2024-10-20",0,0,73,0,0,79,0,0
"Italy","2024-10-21",0,0,73,0,1,80,0,0
"Italy","2024-10-22",0,0,73,0,0,80,0,0
"Italy","2024-10-23",0,0,73,0,0,80,0,0
"Italy","2024-10-24",0,0,73,0,1,81,0,0
"Italy","2024-10-25",0,0,73,0,0,81,0,0
"Italy","2024-10-26",0,0,73,0,0,81,0,0
"Italy","2024-10-27",0,0,73,0,1,82,0,0
"Italy","2024-10-28",0,0,73,0,0,82,0,0
"Italy","2024-10-29",0,0,73,0,0,82,0,0
"Italy","2024-10-30",0,0,73,0,1,83,0,0
"Italy","2024-10-31",0,10,83,0,0,83,0,0
"Italy","2024-11-01",0,0,83,0,0,83,0,0
"Italy","2024-11-02",0,0,83,0,0,83,0,0
"Italy","2024-11-03",0,0,83,0,1,84,0,0
"Italy","2024-11-04",0,0,83,0,0,84,0,0
"Italy","2024-11-05",0,0,83,0,0,84,0,0
"Italy","2024-11-06",0,0,83,0,0,84,0,0
"Italy","2024-11-07",0,0,83,0,1,85,0,0
"Italy","2024-11-08",0,0,83,0,0,85,0,0
"Italy","2024-11-09",0,0,83,0,0,85,0,0
"Italy","2024-11-10",0,0,83,0,0,85,0,0
"Italy","2024-11-11",0,0,83,0,1,86,0,0
"Italy","2024-11-12",0,0,83,0,0,86,0,0
"Italy","2024-11-13",0,0,83,0,0,86,0,0
"Italy","2024-11-14",0,0,83,0,0,86,0,0
"Italy","2024-11-15",0,0,83,0,1,87,0,0
"Italy","2024-11-16",0,0,83,0,0,87,0,0
"Italy","2024-11-17",0,0,83,0,0,87,0,0
"Italy","2024-11-18",0,0,83,0,0,87,0,0
"Italy","2024-11-19",0,0,83,0,0,87,0,0
"Italy","2024-11-20",0,0,83,0,1,88,0,0
"Italy","2024-11-21",0,0,83,0,0,88,0,0
"Italy","2024-11-22",0,0,83,0,0,88,0,0
"Italy","2024-11-23",0,0,83,0,0,88,0,0
"Italy","2024-11-24",0,0,83,0,1,89,0,0
"Italy","2024-11-25",0,0,83,0,0,89,0,0
"Italy","2024-11-26",0,0,83,0,0,89,0,0
"Italy","2024-11-27",0,0,83,0,0,89,0,0
"Italy","2024-11-28",0,0,83,0,1,90,0,0
"Italy","2024-11-29",0,0,83,0,0,90,0,0
"Italy","2024-11-30",0,7,90,0,0,90,0,0
"Italy","2024-12-01",0,0,90,0,0,90,0,0
"Italy","2024-12-02",0,0,90,0,0,90,0,0
"Italy","2024-12-03",0,0,90,0,0,90,0,0
"Italy","2024-12-04",0,0,90,0,0,90,0,0
"Italy","2024-12-05",0,0,90,0,0,90,0,0
"Italy","2024-12-06",0,0,90,0,0,90,0,0
"Italy","2024-12-07",0,0,90,0,0,90,0,0
"Italy","2024-12-08",0,0,90,0,0,90,0,0
"Italy","2024-12-09",0,0,90,0,0,90,0,0
"Italy","2024-12-10",0,0,90,0,0,90,0,0
"Italy","2024-12-11",0,0,90,0,0,90,0,0
"Italy","2024-12-12",0,0,90,0,0,90,0,0
"Italy","2024-12-13",0,0,90,0,0,90,0,0
"Italy","2024-12-14",0,0,90,0,0,90,0,0
"Italy","2024-12-15",0,0,90,0,0,90,0,0
"Italy","2024-12-16",0,0,90,0,0,90,0,0
"Italy","2024-12-17",0,0,90,0,0,90,0,0
"Italy","2024-12-18",0,0,90,0,0,90,0,0
"Italy","2024-12-19",0,0,90,0,0,90,0,0
"Italy","2024-12-20",0,0,90,0,0,90,0,0
"Italy","2024-12-21",0,0,90,0,0,90,0,0
"Italy","2024-12-22",0,0,90,0,0,90,0,0
"Italy","2024-12-23",0,0,90,0,0,90,0,0
"Italy","2024-12-24",0,0,90,0,0,90,0,0
"Italy","2024-12-25",0,0,90,0,0,90,0,0
"Italy","2024-12-26",0,0,90,0,0,90,0,0
"Italy","2024-12-27",0,0,90,0,0,90,0,0
"Italy","2024-12-28",0,0,90,0,0,90,0,0
"Italy","2024-12-29",0,0,90,0,0,90,0,0
"Italy","2024-12-30",0,0,90,0,0,90,0,0
"Italy","2024-12-31",0,0,90,0,0,90,0,0
"Italy","2025-01-01",0,0,90,0,0,90,0,0
"Italy","2025-01-02",0,0,90,0,0,90,0,0
"Italy","2025-01-03",0,0,90,0,0,90,0,0
"Italy","2025-01-04",0,0,90,0,0,90,0,0
"Italy","2025-01-05",0,0,90,0,0,90,0,0
"Italy","2025-01-06",0,0,90,0,0,90,0,0
"Italy","2025-01-07",0,0,90,0,0,90,0,0
"Italy","2025-01-08",0,0,90,0,0,90,0,0
"Italy","2025-01-09",0,0,90,0,0,90,0,0
"Italy","2025-01-10",0,0,90,0,0,90,0,0
"Italy","2025-01-11",0,0,90,0,0,90,0,0
"Italy","2025-01-12",0,0,90,0,0,90,0,0
"Italy","2025-01-13",0,0,90,0,0,90,0,0
"Jamaica","2024-01-01",0,0,0,0,0,0,0,0
"Jamaica","2024-01-02",0,0,0,0,0,0,0,0
"Jamaica","2024-01-03",0,0,0,0,0,0,0,0
"Jamaica","2024-01-04",0,0,0,0,0,0,0,0
"Jamaica","2024-01-05",0,0,0,0,0,0,0,0
"Jamaica","2024-01-06",0,0,0,0,0,0,0,0
"Jamaica","2024-01-07",0,0,0,0,0,0,0,0
"Jamaica","2024-01-08",0,0,0,0,0,0,0,0
"Jamaica","2024-01-09",0,0,0,0,0,0,0,0
"Jamaica","2024-01-10",0,0,0,0,0,0,0,0
"Jamaica","2024-01-11",0,0,0,0,0,0,0,0
"Jamaica","2024-01-12",0,0,0,0,0,0,0,0
"Jamaica","2024-01-13",0,0,0,0,0,0,0,0
"Jamaica","2024-01-14",0,0,0,0,0,0,0,0
"Jamaica","2024-01-15",0,0,0,0,0,0,0,0
"Jamaica","2024-01-16",0,0,0,0,0,0,0,0
"Jamaica","2024-01-17",0,0,0,0,0,0,0,0
"Jamaica","2024-01-18",0,0,0,0,0,0,0,0
"Jamaica","2024-01-19",0,0,0,0,0,0,0,0
"Jamaica","2024-01-20",0,0,0,0,0,0,0,0
"Jamaica","2024-01-21",0,0,0,0,0,0,0,0
"Jamaica","2024-01-22",0,0,0,0,0,0,0,0
"Jamaica","2024-01-23",0,0,0,0,0,0,0,0
"Jamaica","2024-01-24",0,0,0,0,0,0,0,0
"Jamaica","2024-01-25",0,0,0,0,0,0,0,0
"Jamaica","2024-01-26",0,0,0,0,0,0,0,0
"Jamaica","2024-01-27",0,0,0,0,0,0,0,0
"Jamaica","2024-01-28",0,0,0,0,0,0,0,0
"Jamaica","2024-01-29",0,0,0,0,0,0,0,0
"Jamaica","2024-01-30",0,0,0,0,0,0,0,0
"Jamaica","2024-01-31",0,0,0,0,0,0,0,0
"Jamaica","2024-02-01",0,0,0,0,0,0,0,0
"Jamaica","2024-02-02",0,0,0,0,0,0,0,0
"Jamaica","2024-02-03",0,0,0,0,0,0,0,0
"Jamaica","2024-02-04",0,0,0,0,0,0,0,0
"Jamaica","2024-02-05",0,0,0,0,0,0,0,0
"Jamaica","2024-02-06",0,0,0,0,0,0,0,0
"Jamaica","2024-02-07",0,0,0,0,0,0,0,0
"Jamaica","2024-02-08",0,0,0,0,0,0,0,0
"Jamaica","2024-02-09",0,0,0,0,0,0,0,0
"Jamaica","2024-02-10",0,0,0,0,0,0,0,0
"Jamaica","2024-02-11",0,0,0,0,0,0,0,0
"Jamaica","2024-02-12",0,0,0,0,0,0,0,0
"Jamaica","2024-02-13",0,0,0,0,0,0,0,0
"Jamaica","2024-02-14",0,0,0,0,0,0,0,0
"Jamaica","2024-02-15",0,0,0,0,0,0,0,0
"Jamaica","2024-02-16",0,0,0,0,0,0,0,0
"Jamaica","2024-02-17",0,0,0,0,0,0,0,0
"Jamaica","2024-02-18",0,0,0,0,0,0,0,0
"Jamaica","2024-02-19",0,0,0,0,0,0,0,0
"Jamaica","2024-02-20",0,0,0,0,0,0,0,0
"Jamaica","2024-02-21",0,0,0,0,0,0,0,0
"Jamaica","2024-02-22",0,0,0,0,0,0,0,0
"Jamaica","2024-02-23",0,0,0,0,0,0,0,0
"Jamaica","2024-02-24",0,0,0,0,0,0,0,0
"Jamaica","2024-02-25",0,0,0,0,0,0,0,0
"Jamaica","2024-02-26",0,0,0,0,0,0,0,0
"Jamaica","2024-02-27",0,0,0,0,0,0,0,0
"Jamaica","2024-02-28",0,0,0,0,0,0,0,0
"Jamaica","2024-02-29",0,0,0,0,0,0,0,0
"Jamaica","2024-03-01",0,0,0,0,0,0,0,0
"Jamaica","2024-03-02",0,0,0,0,0,0,0,0
"Jamaica","2024-03-03",0,0,0,0,0,0,0,0
"Jamaica","2024-03-04",0,0,0,0,0,0,0,0
"Jamaica","2024-03-05",0,0,0,0,0,0,0,0
"Jamaica","2024-03-06",0,0,0,0,0,0,0,0
"Jamaica","2024-03-07",0,0,0,0,0,0,0,0
"Jamaica","2024-03-08",0,0,0,0,0,0,0,0
"Jamaica","2024-03-09",0,0,0,0,0,0,0,0
"Jamaica","2024-03-10",0,0,0,0,0,0,0,0
"Jamaica","2024-03-11",0,0,0,0,0,0,0,0
"Jamaica","2024-03-12",0,0,0,0,0,0,0,0
"Jamaica","2024-03-13",0,0,0,0,0,0,0,0
"Jamaica","2024-03-14",0,0,0,0,0,0,0,0
"Jamaica","2024-03-15",0,0,0,0,0,0,0,0
"Jamaica","2024-03-16",0,0,0,0,0,0,0,0
"Jamaica","2024-03-17",0,0,0,0,0,0,0,0
"Jamaica","2024-03-18",0,0,0,0,0,0,0,0
"Jamaica","2024-03-19",0,0,0,0,0,0,0,0
"Jamaica","2024-03-20",0,0,0,0,0,0,0,0
"Jamaica","2024-03-21",0,0,0,0,0,0,0,0
"Jamaica","2024-03-22",0,0,0,0,0,0,0,0
"Jamaica","2024-03-23",0,0,0,0,0,0,0,0
"Jamaica","2024-03-24",0,0,0,0,0,0,0,0
"Jamaica","2024-03-25",0,0,0,0,0,0,0,0
"Jamaica","2024-03-26",0,0,0,0,0,0,0,0
"Jamaica","2024-03-27",0,0,0,0,0,0,0,0
"Jamaica","2024-03-28",0,0,0,0,0,0,0,0
"Jamaica","2024-03-29",0,0,0,0,0,0,0,0
"Jamaica","2024-03-30",0,0,0,0,0,0,0,0
"Jamaica","2024-03-31",0,0,0,0,0,0,0,0
"Jamaica","2024-04-01",0,0,0,0,0,0,0,0
"Jamaica","2024-04-02",0,0,0,0,0,0,0,0
"Jamaica","2024-04-03",0,0,0,0,0,0,0,0
"Jamaica","2024-04-04",0,0,0,0,0,0,0,0
"Jamaica","2024-04-05",0,0,0,0,0,0,0,0
"Jamaica","2024-04-06",0,0,0,0,0,0,0,0
"Jamaica","2024-04-07",0,0,0,0,0,0,0,0
"Jamaica","2024-04-08",0,0,0,0,0,0,0,0
"Jamaica","2024-04-09",0,0,0,0,0,0,0,0
"Jamaica","2024-04-10",0,0,0,0,0,0,0,0
"Jamaica","2024-04-11",0,0,0,0,0,0,0,0
"Jamaica","2024-04-12",0,0,0,0,0,0,0,0
"Jamaica","2024-04-13",0,0,0,0,0,0,0,0
"Jamaica","2024-04-14",0,0,0,0,0,0,0,0
"Jamaica","2024-04-15",0,0,0,0,0,0,0,0
"Jamaica","2024-04-16",0,0,0,0,0,0,0,0
"Jamaica","2024-04-17",0,0,0,0,0,0,0,0
"Jamaica","2024-04-18",0,0,0,0,0,0,0,0
"Jamaica","2024-04-19",0,0,0,0,0,0,0,0
"Jamaica","2024-04-20",0,0,0,0,0,0,0,0
"Jamaica","2024-04-21",0,0,0,0,0,0,0,0
"Jamaica","2024-04-22",0,0,0,0,0,0,0,0
"Jamaica","2024-04-23",0,0,0,0,0,0,0,0
"Jamaica","2024-04-24",0,0,0,0,0,0,0,0
"Jamaica","2024-04-25",0,0,0,0,0,0,0,0
"Jamaica","2024-04-26",0,0,0,0,0,0,0,0
"Jamaica","2024-04-27",0,0,0,0,0,0,0,0
"Jamaica","2024-04-28",0,0,0,0,0,0,0,0
"Jamaica","2024-04-29",0,0,0,0,0,0,0,0
"Jamaica","2024-04-30",0,0,0,0,0,0,0,0
"Jamaica","2024-05-01",0,0,0,0,0,0,0,0
"Jamaica","2024-05-02",0,0,0,0,0,0,0,0
"Jamaica","2024-05-03",0,0,0,0,0,0,0,0
"Jamaica","2024-05-04",0,0,0,0,0,0,0,0
"Jamaica","2024-05-05",0,0,0,0,0,0,0,0
"Jamaica","2024-05-06",0,0,0,0,0,0,0,0
"Jamaica","2024-05-07",0,0,0,0,0,0,0,0
"Jamaica","2024-05-08",0,0,0,0,0,0,0,0
"Jamaica","2024-05-09",0,0,0,0,0,0,0,0
"Jamaica","2024-05-10",0,0,0,0,0,0,0,0
"Jamaica","2024-05-11",0,0,0,0,0,0,0,0
"Jamaica","2024-05-12",0,0,0,0,0,0,0,0
"Jamaica","2024-05-13",0,0,0,0,0,0,0,0
"Jamaica","2024-05-14",0,0,0,0,0,0,0,0
"Jamaica","2024-05-15",0,0,0,0,0,0,0,0
"Jamaica","2024-05-16",0,0,0,0,0,0,0,0
"Jamaica","2024-05-17",0,0,0,0,0,0,0,0
"Jamaica","2024-05-18",0,0,0,0,0,0,0,0
"Jamaica","2024-05-19",0,0,0,0,0,0,0,0
"Jamaica","2024-05-20",0,0,0,0,0,0,0,0
"Jamaica","2024-05-21",0,0,0,0,0,0,0,0
"Jamaica","2024-05-22",0,0,0,0,0,0,0,0
"Jamaica","2024-05-23",0,0,0,0,0,0,0,0
"Jamaica","2024-05-24",0,0,0,0,0,0,0,0
"Jamaica","2024-05-25",0,0,0,0,0,0,0,0
"Jamaica","2024-05-26",0,0,0,0,0,0,0,0
"Jamaica","2024-05-27",0,0,0,0,0,0,0,0
"Jamaica","2024-05-28",0,0,0,0,0,0,0,0
"Jamaica","2024-05-29",0,0,0,0,0,0,0,0
"Jamaica","2024-05-30",0,0,0,0,0,0,0,0
"Jamaica","2024-05-31",0,0,0,0,0,0,0,0
"Jamaica","2024-06-01",0,0,0,0,0,0,0,0
"Jamaica","2024-06-02",0,0,0,0,0,0,0,0
"Jamaica","2024-06-03",0,0,0,0,0,0,0,0
"Jamaica","2024-06-04",0,0,0,0,0,0,0,0
"Jamaica","2024-06-05",0,0,0,0,0,0,0,0
"Jamaica","2024-06-06",0,0,0,0,0,0,0,0
"Jamaica","2024-06-07",0,0,0,0,0,0,0,0
"Jamaica","2024-06-08",0,0,0,0,0,0,0,0
"Jamaica","2024-06-09",0,0,0,0,0,0,0,0
"Jamaica","2024-06-10",0,0,0,0,0,0,0,0
"Jamaica","2024-06-11",0,0,0,0,0,0,0,0
"Jamaica","2024-06-12",0,0,0,0,0,0,0,0
"Jamaica","2024-06-13",0,0,0,0,0,0,0,0
"Jamaica","2024-06-14",0,0,0,0,0,0,0,0
"Jamaica","2024-06-15",0,0,0,0,0,0,0,0
"Jamaica","2024-06-16",0,0,0,0,0,0,0,0
"Jamaica","2024-06-17",0,0,0,0,0,0,0,0
"Jamaica","2024-06-18",0,0,0,0,0,0,0,0
"Jamaica","2024-06-19",0,0,0,0,0,0,0,0
"Jamaica","2024-06-20",0,0,0,0,0,0,0,0
"Jamaica","2024-06-21",0,0,0,0,0,0,0,0
"Jamaica","2024-06-22",0,0,0,0,0,0,0,0
"Jamaica","2024-06-23",0,0,0,0,0,0,0,0
"Jamaica","2024-06-24",0,0,0,0,0,0,0,0
"Jamaica","2024-06-25",0,0,0,0,0,0,0,0
"Jamaica","2024-06-26",0,0,0,0,0,0,0,0
"Jamaica","2024-06-27",0,0,0,0,0,0,0,0
"Jamaica","2024-06-28",0,0,0,0,0,0,0,0
"Jamaica","2024-06-29",0,0,0,0,0,0,0,0
"Jamaica","2024-06-30",0,0,0,0,0,0,0,0
"Jamaica","2024-07-01",0,0,0,0,0,0,0,0
"Jamaica","2024-07-02",0,0,0,0,0,0,0,0
"Jamaica","2024-07-03",0,0,0,0,0,0,0,0
"Jamaica","2024-07-04",0,0,0,0,0,0,0,0
"Jamaica","2024-07-05",0,0,0,0,0,0,0,0
"Jamaica","2024-07-06",0,0,0,0,0,0,0,0
"Jamaica","2024-07-07",0,0,0,0,0,0,0,0
"Jamaica","2024-07-08",0,0,0,0,0,0,0,0
"Jamaica","2024-07-09",0,0,0,0,0,0,0,0
"Jamaica","2024-07-10",0,0,0,0,0,0,0,0
"Jamaica","2024-07-11",0,0,0,0,0,0,0,0
"Jamaica","2024-07-12",0,0,0,0,0,0,0,0
"Jamaica","2024-07-13",0,0,0,0,0,0,0,0
"Jamaica","2024-07-14",0,0,0,0,0,0,0,0
"Jamaica","2024-07-15",0,0,0,0,0,0,0,0
"Jamaica","2024-07-16",0,0,0,0,0,0,0,0
"Jamaica","2024-07-17",0,0,0,0,0,0,0,0
"Jamaica","2024-07-18",0,0,0,0,0,0,0,0
"Jamaica","2024-07-19",0,0,0,0,0,0,0,0
"Jamaica","2024-07-20",0,0,0,0,0,0,0,0
"Jamaica","2024-07-21",0,0,0,0,0,0,0,0
"Jamaica","2024-07-22",0,0,0,0,0,0,0,0
"Jamaica","2024-07-23",0,0,0,0,0,0,0,0
"Jamaica","2024-07-24",0,0,0,0,0,0,0,0
"Jamaica","2024-07-25",0,0,0,0,0,0,0,0
"Jamaica","2024-07-26",0,0,0,0,0,0,0,0
"Jamaica","2024-07-27",0,0,0,0,0,0,0,0
"Jamaica","2024-07-28",0,0,0,0,0,0,0,0
"Jamaica","2024-07-29",0,0,0,0,0,0,0,0
"Jamaica","2024-07-30",0,0,0,0,0,0,0,0
"Jamaica","2024-07-31",0,0,0,0,0,0,0,0
"Jamaica","2024-08-01",0,0,0,0,0,0,0,0
"Jamaica","2024-08-02",0,0,0,0,0,0,0,0
"Jamaica","2024-08-03",0,0,0,0,0,0,0,0
"Jamaica","2024-08-04",0,0,0,0,0,0,0,0
"Jamaica","2024-08-05",0,0,0,0,0,0,0,0
"Jamaica","2024-08-06",0,0,0,0,0,0,0,0
"Jamaica","2024-08-07",0,0,0,0,0,0,0,0
"Jamaica","2024-08-08",0,0,0,0,0,0,0,0
"Jamaica","2024-08-09",0,0,0,0,0,0,0,0
"Jamaica","2024-08-10",0,0,0,0,0,0,0,0
"Jamaica","2024-08-11",0,0,0,0,0,0,0,0
"Jamaica","2024-08-12",0,0,0,0,0,0,0,0
"Jamaica","2024-08-13",0,0,0,0,0,0,0,0
"Jamaica","2024-08-14",0,0,0,0,0,0,0,0
"Jamaica","2024-08-15",0,0,0,0,0,0,0,0
"Jamaica","2024-08-16",0,0,0,0,0,0,0,0
"Jamaica","2024-08-17",0,0,0,0,0,0,0,0
"Jamaica","2024-08-18",0,0,0,0,0,0,0,0
"Jamaica","2024-08-19",0,0,0,0,0,0,0,0
"Jamaica","2024-08-20",0,0,0,0,0,0,0,0
"Jamaica","2024-08-21",0,0,0,0,0,0,0,0
"Jamaica","2024-08-22",0,0,0,0,0,0,0,0
"Jamaica","2024-08-23",0,0,0,0,0,0,0,0
"Jamaica","2024-08-24",0,0,0,0,0,0,0,0
"Jamaica","2024-08-25",0,0,0,0,0,0,0,0
"Jamaica","2024-08-26",0,0,0,0,0,0,0,0
"Jamaica","2024-08-27",0,0,0,0,0,0,0,0
"Jamaica","2024-08-28",0,0,0,0,0,0,0,0
"Jamaica","2024-08-29",0,0,0,0,0,0,0,0
"Jamaica","2024-08-30",0,0,0,0,0,0,0,0
"Jamaica","2024-08-31",0,0,0,0,0,0,0,0
"Jamaica","2024-09-01",0,0,0,0,0,0,0,0
"Jamaica","2024-09-02",0,0,0,0,0,0,0,0
"Jamaica","2024-09-03",0,0,0,0,0,0,0,0
"Jamaica","2024-09-04",0,0,0,0,0,0,0,0
"Jamaica","2024-09-05",0,0,0,0,0,0,0,0
"Jamaica","2024-09-06",0,0,0,0,0,0,0,0
"Jamaica","2024-09-07",0,0,0,0,0,0,0,0
"Jamaica","2024-09-08",0,0,0,0,0,0,0,0
"Jamaica","2024-09-09",0,0,0,0,0,0,0,0
"Jamaica","2024-09-10",0,0,0,0,0,0,0,0
"Jamaica","2024-09-11",0,0,0,0,0,0,0,0
"Jamaica","2024-09-12",0,0,0,0,0,0,0,0
"Jamaica","2024-09-13",0,0,0,0,0,0,0,0
"Jamaica","2024-09-14",0,0,0,0,0,0,0,0
"Jamaica","2024-09-15",0,0,0,0,0,0,0,0
"Jamaica","2024-09-16",0,0,0,0,0,0,0,0
"Jamaica","2024-09-17",0,0,0,0,0,0,0,0
"Jamaica","2024-09-18",0,0,0,0,0,0,0,0
"Jamaica","2024-09-19",0,0,0,0,0,0,0,0
"Jamaica","2024-09-20",0,0,0,0,0,0,0,0
"Jamaica","2024-09-21",0,0,0,0,0,0,0,0
"Jamaica","2024-09-22",0,0,0,0,0,0,0,0
"Jamaica","2024-09-23",0,0,0,0,0,0,0,0
"Jamaica","2024-09-24",0,0,0,0,0,0,0,0
"Jamaica","2024-09-25",0,0,0,0,0,0,0,0
"Jamaica","2024-09-26",0,0,0,0,0,0,0,0
"Jamaica","2024-09-27",0,0,0,0,0,0,0,0
"Jamaica","2024-09-28",0,0,0,0,0,0,0,0
"Jamaica","2024-09-29",0,0,0,0,0,0,0,0
"Jamaica","2024-09-30",0,0,0,0,0,0,0,0
"Jamaica","2024-10-01",0,0,0,0,0,0,0,0
"Jamaica","2024-10-02",0,0,0,0,0,0,0,0
"Jamaica","2024-10-03",0,0,0,0,0,0,0,0
"Jamaica","2024-10-04",0,0,0,0,0,0,0,0
"Jamaica","2024-10-05",0,0,0,0,0,0,0,0
"Jamaica","2024-10-06",0,0,0,0,0,0,0,0
"Jamaica","2024-10-07",0,0,0,0,0,0,0,0
"Jamaica","2024-10-08",0,0,0,0,0,0,0,0
"Jamaica","2024-10-09",0,0,0,0,0,0,0,0
"Jamaica","2024-10-10",0,0,0,0,0,0,0,0
"Jamaica","2024-10-11",0,0,0,0,0,0,0,0
"Jamaica","2024-10-12",0,0,0,0,0,0,0,0
"Jamaica","2024-10-13",0,0,0,0,0,0,0,0
"Jamaica","2024-10-14",0,0,0,0,0,0,0,0
"Jamaica","2024-10-15",0,0,0,0,0,0,0,0
"Jamaica","2024-10-16",0,0,0,0,0,0,0,0
"Jamaica","2024-10-17",0,0,0,0,0,0,0,0
"Jamaica","2024-10-18",0,0,0,0,0,0,0,0
"Jamaica","2024-10-19",0,0,0,0,0,0,0,0
"Jamaica","2024-10-20",0,0,0,0,0,0,0,0
"Jamaica","2024-10-21",0,0,0,0,0,0,0,0
"Jamaica","2024-10-22",0,0,0,0,0,0,0,0
"Jamaica","2024-10-23",0,0,0,0,0,0,0,0
"Jamaica","2024-10-24",0,0,0,0,0,0,0,0
"Jamaica","2024-10-25",0,0,0,0,0,0,0,0
"Jamaica","2024-10-26",0,0,0,0,0,0,0,0
"Jamaica","2024-10-27",0,0,0,0,0,0,0,0
"Jamaica","2024-10-28",0,0,0,0,0,0,0,0
"Jamaica","2024-10-29",0,0,0,0,0,0,0,0
"Jamaica","2024-10-30",0,0,0,0,0,0,0,0
"Jamaica","2024-10-31",0,0,0,0,0,0,0,0
"Jamaica","2024-11-01",0,0,0,0,0,0,0,0
"Jamaica","2024-11-02",0,0,0,0,0,0,0,0
"Jamaica","2024-11-03",0,0,0,0,0,0,0,0
"Jamaica","2024-11-04",0,0,0,0,0,0,0,0
"Jamaica","2024-11-05",0,0,0,0,0,0,0,0
"Jamaica","2024-11-06",0,0,0,0,0,0,0,0
"Jamaica","2024-11-07",0,0,0,0,0,0,0,0
"Jamaica","2024-11-08",0,0,0,0,0,0,0,0
"Jamaica","2024-11-09",0,0,0,0,0,0,0,0
"Jamaica","2024-11-10",0,0,0,0,0,0,0,0
"Jamaica","2024-11-11",0,0,0,0,0,0,0,0
"Jamaica","2024-11-12",0,0,0,0,0,0,0,0
"Jamaica","2024-11-13",0,0,0,0,0,0,0,0
"Jamaica","2024-11-14",0,0,0,0,0,0,0,0
"Jamaica","2024-11-15",0,0,0,0,0,0,0,0
"Jamaica","2024-11-16",0,0,0,0,0,0,0,0
"Jamaica","2024-11-17",0,0,0,0,0,0,0,0
"Jamaica","2024-11-18",0,0,0,0,0,0,0,0
"Jamaica","2024-11-19",0,0,0,0,0,0,0,0
"Jamaica","2024-11-20",0,0,0,0,0,0,0,0
"Jamaica","2024-11-21",0,0,0,0,0,0,0,0
"Jamaica","2024-11-22",0,0,0,0,0,0,0,0
"Jamaica","2024-11-23",0,0,0,0,0,0,0,0
"Jamaica","2024-11-24",0,0,0,0,0,0,0,0
"Jamaica","2024-11-25",0,0,0,0,0,0,0,0
"Jamaica","2024-11-26",0,0,0,0,0,0,0,0
"Jamaica","2024-11-27",0,0,0,0,0,0,0,0
"Jamaica","2024-11-28",0,0,0,0,0,0,0,0
"Jamaica","2024-11-29",0,0,0,0,0,0,0,0
"Jamaica","2024-11-30",0,0,0,0,0,0,0,0
"Jamaica","2024-12-01",0,0,0,0,0,0,0,0
"Jamaica","2024-12-02",0,0,0,0,0,0,0,0
"Jamaica","2024-12-03",0,0,0,0,0,0,0,0
"Jamaica","2024-12-04",0,0,0,0,0,0,0,0
"Jamaica","2024-12-05",0,0,0,0,0,0,0,0
"Jamaica","2024-12-06",0,0,0,0,0,0,0,0
"Jamaica","2024-12-07",0,0,0,0,0,0,0,0
"Jamaica","2024-12-08",0,0,0,0,0,0,0,0
"Jamaica","2024-12-09",0,0,0,0,0,0,0,0
"Jamaica","2024-12-10",0,0,0,0,0,0,0,0
"Jamaica","2024-12-11",0,0,0,0,0,0,0,0
"Jamaica","2024-12-12",0,0,0,0,0,0,0,0
"Jamaica","2024-12-13",0,0,0,0,0,0,0,0
"Jamaica","2024-12-14",0,0,0,0,0,0,0,0
"Jamaica","2024-12-15",0,0,0,0,0,0,0,0
"Jamaica","2024-12-16",0,0,0,0,0,0,0,0
"Jamaica","2024-12-17",0,0,0,0,0,0,0,0
"Jamaica","2024-12-18",0,0,0,0,0,0,0,0
"Jamaica","2024-12-19",0,0,0,0,0,0,0,0
"Jamaica","2024-12-20",0,0,0,0,0,0,0,0
"Jamaica","2024-12-21",0,0,0,0,0,0,0,0
"Jamaica","2024-12-22",0,0,0,0,0,0,0,0
"Jamaica","2024-12-23",0,0,0,0,0,0,0,0
"Jamaica","2024-12-24",0,0,0,0,0,0,0,0
"Jamaica","2024-12-25",0,0,0,0,0,0,0,0
"Jamaica","2024-12-26",0,0,0,0,0,0,0,0
"Jamaica","2024-12-27",0,0,0,0,0,0,0,0
"Jamaica","2024-12-28",0,0,0,0,0,0,0,0
"Jamaica","2024-12-29",0,0,0,0,0,0,0,0
"Jamaica","2024-12-30",0,0,0,0,0,0,0,0
"Jamaica","2024-12-31",0,0,0,0,0,0,0,0
"Jamaica","2025-01-01",0,0,0,0,0,0,0,0
"Jamaica","2025-01-02",0,0,0,0,0,0,0,0
"Jamaica","2025-01-03",0,0,0,0,0,0,0,0
"Jamaica","2025-01-04",0,0,0,0,0,0,0,0
"Jamaica","2025-01-05",0,0,0,0,0,0,0,0
"Jamaica","2025-01-06",0,0,0,0,0,0,0,0
"Jamaica","2025-01-07",0,0,0,0,0,0,0,0
"Jamaica","2025-01-08",0,0,0,0,0,0,0,0
"Jamaica","2025-01-09",0,0,0,0,0,0,0,0
"Jamaica","2025-01-10",0,0,0,0,0,0,0,0
"Jamaica","2025-01-11",0,0,0,0,0,0,0,0
"Jamaica","2025-01-12",0,0,0,0,0,0,0,0
"Jamaica","2025-01-13",0,0,0,0,0,0,0,0
"Japan","2024-01-01",0,0,0,0,0,0,0,0
"Japan","2024-01-02",0,0,0,0,0,0,0,0
"Japan","2024-01-03",0,0,0,0,0,0,0,0
"Japan","2024-01-04",0,0,0,0,0,0,0,0
"Japan","2024-01-05",0,0,0,0,0,0,0,0
"Japan","2024-01-06",0,0,0,0,0,0,0,0
"Japan","2024-01-07",0,0,0,0,0,0,0,0
"Japan","2024-01-08",0,0,0,0,0,0,0,0
"Japan","2024-01-09",0,1,1,0,1,1,0,0
"Japan","2024-01-10",0,0,1,0,0,1,0,0
"Japan","2024-01-11",0,0,1,0,0,1,0,0
"Japan","2024-01-12",0,0,1,0,0,1,0,0
"Japan","2024-01-13",0,0,1,0,0,1,0,0
"Japan","2024-01-14",0,0,1,0,0,1,0,0
"Japan","2024-01-15",0,0,1,0,1,2,0,0
"Japan","2024-01-16",0,0,1,0,0,2,0,0
"Japan","2024-01-17",0,0,1,0,0,2,0,0
"Japan","2024-01-18",0,0,1,0,0,2,0,0
"Japan","2024-01-19",0,1,2,0,0,2,0,0
"Japan","2024-01-20",0,0,2,0,0,2,0,0
"Japan","2024-01-21",0,0,2,0,0,2,0,0
"Japan","2024-01-22",0,0,2,0,1,3,0,0
"Japan","2024-01-23",0,0,2,0,0,3,0,0
"Japan","2024-01-24",0,0,2,0,0,3,0,0
"Japan","2024-01-25",0,0,2,0,0,3,0,0
"Japan","2024-01-26",0,0,2,0,1,4,0,0
"Japan","2024-01-27",0,0,2,0,0,4,0,0
"Japan","2024-01-28",0,0,2,0,0,4,0,0
"Japan","2024-01-29",0,0,2,0,0,4,0,0
"Japan","2024-01-30",0,0,2,0,0,4,0,0
"Japan","2024-01-31",0,0,2,0,1,5,0,0
"Japan","2024-02-01",0,0,2,0,0,5,0,0
"Japan","2024-02-02",0,3,5,0,0,5,0,0
"Japan","2024-02-03",0,0,5,0,1,6,0,0
"Japan","2024-02-04",0,0,5,0,1,7,0,0
"Japan","2024-02-05",0,3,8,0,1,8,0,0
"Japan","2024-02-06",0,0,8,0,0,8,0,0
"Japan","2024-02-07",0,0,8,0,0,8,0,0
"Japan","2024-02-08",0,0,8,0,0,8,0,0
"Japan","2024-02-09",0,0,8,0,0,8,0,0
"Japan","2024-02-10",0,0,8,0,0,8,0,0
"Japan","2024-02-11",0,0,8,0,0,8,0,0
"Japan","2024-02-12",0,0,8,0,0,8,0,0
"Japan","2024-02-13",0,0,8,0,0,8,0,0
"Japan","2024-02-14",0,0,8,0,0,8,0,0
"Japan","2024-02-15",0,0,8,0,0,8,0,0
"Japan","2024-02-16",0,0,8,0,0,8,0,0
"Japan","2024-02-17",0,0,8,0,0,8,0,0
"Japan","2024-02-18",0,0,8,0,1,9,0,0
"Japan","2024-02-19",0,0,8,0,0,9,0,0
"Japan","2024-02-20",0,0,8,0,0,9,0,0
"Japan","2024-02-21",0,0,8,0,0,9,0,0
"Japan","2024-02-22",0,0,8,0,0,9,0,0
"Japan","2024-02-23",0,0,8,0,0,9,0,0
"Japan","2024-02-24",0,0,8,0,0,9,0,0
"Japan","2024-02-25",0,0,8,0,0,9,0,0
"Japan","2024-02-26",0,0,8,0,0,9,0,0
"Japan","2024-02-27",0,0,8,0,0,9,0,0
"Japan","2024-02-28",0,0,8,0,0,9,0,0
"Japan","2024-02-29",0,0,8,0,0,9,0,0
"Japan","2024-03-01",0,1,9,0,0,9,0,0
"Japan","2024-03-02",0,0,9,0,0,9,0,0
"Japan","2024-03-03",0,0,9,0,0,9,0,0
"Japan","2024-03-04",0,0,9,0,0,9,0,0
"Japan","2024-03-05",0,0,9,0,1,10,0,0
"Japan","2024-03-06",0,0,9,0,0,10,0,0
"Japan","2024-03-07",0,0,9,0,0,10,0,0
"Japan","2024-03-08",0,1,10,0,0,10,0,0
"Japan","2024-03-09",0,0,10,0,0,10,0,0
"Japan","2024-03-10",0,0,10,0,0,10,0,0
"Japan","2024-03-11",0,0,10,0,0,10,0,0
"Japan","2024-03-12",0,0,10,0,0,10,0,0
"Japan","2024-03-13",0,0,10,0,0,10,0,0
"Japan","2024-03-14",0,0,10,0,0,10,0,0
"Japan","2024-03-15",0,0,10,0,0,10,0,0
"Japan","2024-03-16",0,0,10,0,0,10,0,0
"Japan","2024-03-17",0,0,10,0,0,10,0,0
"Japan","2024-03-18",0,0,10,0,0,10,0,0
"Japan","2024-03-19",0,0,10,0,0,10,0,0
"Japan","2024-03-20",0,0,10,0,0,10,0,0
"Japan","2024-03-21",0,0,10,0,0,10,0,0
"Japan","2024-03-22",0,0,10,0,0,10,0,0
"Japan","2024-03-23",0,0,10,0,1,11,0,0
"Japan","2024-03-24",0,0,10,0,0,11,0,0
"Japan","2024-03-25",0,0,10,0,0,11,0,0
"Japan","2024-03-26",0,0,10,0,0,11,0,0
"Japan","2024-03-27",0,0,10,0,0,11,0,0
"Japan","2024-03-28",0,0,10,0,0,11,0,0
"Japan","2024-03-29",0,0,10,0,0,11,0,0
"Japan","2024-03-30",0,0,10,0,0,11,0,0
"Japan","2024-03-31",0,0,10,0,0,11,0,0
"Japan","2024-04-01",0,0,10,0,0,11,0,0
"Japan","2024-04-02",0,0,10,0,0,11,0,0
"Japan","2024-04-03",0,0,10,0,0,11,0,0
"Japan","2024-04-04",0,0,10,0,0,11,0,0
"Japan","2024-04-05",0,1,11,0,0,11,0,0
"Japan","2024-04-06",0,0,11,0,0,11,0,0
"Japan","2024-04-07",0,0,11,0,0,11,0,0
"Japan","2024-04-08",0,0,11,0,0,11,0,0
"Japan","2024-04-09",0,0,11,0,1,12,0,0
"Japan","2024-04-10",0,0,11,0,0,12,0,0
"Japan","2024-04-11",0,0,11,0,0,12,0,0
"Japan","2024-04-12",0,1,12,0,0,12,0,0
"Japan","2024-04-13",0,0,12,0,0,12,0,0
"Japan","2024-04-14",0,0,12,0,0,12,0,0
"Japan","2024-04-15",0,0,12,0,0,12,0,0
"Japan","2024-04-16",0,0,12,0,1,13,0,0
"Japan","2024-04-17",0,0,12,0,0,13,0,0
"Japan","2024-04-18",0,0,12,0,0,13,0,0
"Japan","2024-04-19",0,1,13,0,0,13,0,0
"Japan","2024-04-20",0,0,13,0,0,13,0,0
"Japan","2024-04-21",0,0,13,0,0,13,0,0
"Japan","2024-04-22",0,0,13,0,0,13,0,0
"Japan","2024-04-23",0,0,13,0,0,13,0,0
"Japan","2024-04-24",0,0,13,0,0,13,0,0
"Japan","2024-04-25",0,0,13,0,0,13,0,0
"Japan","2024-04-26",0,0,13,0,0,13,0,0
"Japan","2024-04-27",0,0,13,0,0,13,0,0
"Japan","2024-04-28",0,0,13,0,0,13,0,0
"Japan","2024-04-29",0,0,13,0,0,13,0,0
"Japan","2024-04-30",0,0,13,0,1,14,0,0
"Japan","2024-05-01",0,0,13,0,0,14,0,0
"Japan","2024-05-02",0,0,13,0,0,14,0,0
"Japan","2024-05-03",0,0,13,0,0,14,0,0
"Japan","2024-05-04",0,0,13,0,0,14,0,0
"Japan","2024-05-05",0,0,13,0,0,14,0,0
"Japan","2024-05-06",0,0,13,0,0,14,0,0
"Japan","2024-05-07",0,0,13,0,0,14,0,0
"Japan","2024-05-08",0,0,13,0,0,14,0,0
"Japan","2024-05-09",0,0,13,0,0,14,0,0
"Japan","2024-05-10",0,1,14,0,0,14,0,0
"Japan","2024-05-11",0,0,14,0,0,14,0,0
"Japan","2024-05-12",0,0,14,0,0,14,0,0
"Japan","2024-05-13",0,0,14,0,0,14,0,0
"Japan","2024-05-14",0,0,14,0,0,14,0,0
"Japan","2024-05-15",0,0,14,0,0,14,0,0
"Japan","2024-05-16",0,0,14,0,0,14,0,0
"Japan","2024-05-17",0,0,14,0,0,14,0,0
"Japan","2024-05-18",0,0,14,0,1,15,0,0
"Japan","2024-05-19",0,0,14,0,0,15,0,0
"Japan","2024-05-20",0,0,14,0,0,15,0,0
"Japan","2024-05-21",0,0,14,0,0,15,0,0
"Japan","2024-05-22",0,0,14,0,0,15,0,0
"Japan","2024-05-23",0,0,14,0,0,15,0,0
"Japan","2024-05-24",0,1,15,0,0,15,0,0
"Japan","2024-05-25",0,0,15,0,0,15,0,0
"Japan","2024-05-26",0,0,15,0,0,15,0,0
"Japan","2024-05-27",0,0,15,0,0,15,0,0
"Japan","2024-05-28",0,0,15,0,0,15,0,0
"Japan","2024-05-29",0,0,15,0,0,15,0,0
"Japan","2024-05-30",0,0,15,0,0,15,0,0
"Japan","2024-05-31",0,0,15,0,0,15,0,0
"Japan","2024-06-01",0,0,15,0,0,15,0,0
"Japan","2024-06-02",0,0,15,0,0,15,0,0
"Japan","2024-06-03",0,0,15,0,0,15,0,0
"Japan","2024-06-04",0,0,15,0,0,15,0,0
"Japan","2024-06-05",0,0,15,0,0,15,0,0
"Japan","2024-06-06",0,0,15,0,0,15,0,0
"Japan","2024-06-07",0,0,15,0,0,15,0,0
"Japan","2024-06-08",0,0,15,0,0,15,0,0
"Japan","2024-06-09",0,0,15,0,0,15,0,0
"Japan","2024-06-10",0,0,15,0,0,15,0,0
"Japan","2024-06-11",0,0,15,0,0,15,0,0
"Japan","2024-06-12",0,0,15,0,0,15,0,0
"Japan","2024-06-13",0,0,15,0,0,15,0,0
"Japan","2024-06-14",0,0,15,0,0,15,0,0
"Japan","2024-06-15",0,0,15,0,0,15,0,0
"Japan","2024-06-16",0,0,15,0,0,15,0,0
"Japan","2024-06-17",0,0,15,0,0,15,0,0
"Japan","2024-06-18",0,0,15,0,0,15,0,0
"Japan","2024-06-19",0,0,15,0,0,15,0,0
"Japan","2024-06-20",0,0,15,0,0,15,0,0
"Japan","2024-06-21",0,0,15,0,0,15,0,0
"Japan","2024-06-22",0,0,15,0,0,15,0,0
"Japan","2024-06-23",0,0,15,0,0,15,0,0
"Japan","2024-06-24",0,0,15,0,0,15,0,0
"Japan","2024-06-25",0,0,15,0,0,15,0,0
"Japan","2024-06-26",0,0,15,0,0,15,0,0
"Japan","2024-06-27",0,0,15,0,0,15,0,0
"Japan","2024-06-28",0,0,15,0,0,15,0,0
"Japan","2024-06-29",0,0,15,0,0,15,0,0
"Japan","2024-06-30",0,0,15,0,1,16,0,0
"Japan","2024-07-01",0,0,15,0,0,16,0,0
"Japan","2024-07-02",0,0,15,0,0,16,0,0
"Japan","2024-07-03",0,0,15,0,0,16,0,0
"Japan","2024-07-04",0,0,15,0,0,16,0,0
"Japan","2024-07-05",0,0,15,0,0,16,0,0
"Japan","2024-07-06",0,0,15,0,0,16,0,0
"Japan","2024-07-07",0,0,15,0,0,16,0,0
"Japan","2024-07-08",0,0,15,0,0,16,0,0
"Japan","2024-07-09",0,0,15,0,0,16,0,0
"Japan","2024-07-10",0,0,15,0,0,16,0,0
"Japan","2024-07-11",0,0,15,0,0,16,0,0
"Japan","2024-07-12",0,0,15,0,0,16,0,0
"Japan","2024-07-13",0,0,15,0,0,16,0,0
"Japan","2024-07-14",0,0,15,0,0,16,0,0
"Japan","2024-07-15",0,0,15,0,0,16,0,0
"Japan","2024-07-16",0,0,15,0,0,16,0,0
"Japan","2024-07-17",0,0,15,0,0,16,0,0
"Japan","2024-07-18",0,0,15,0,0,16,0,0
"Japan","2024-07-19",0,0,15,0,0,16,0,0
"Japan","2024-07-20",0,0,15,0,0,16,0,0
"Japan","2024-07-21",0,0,15,0,0,16,0,0
"Japan","2024-07-22",0,0,15,0,0,16,0,0
"Japan","2024-07-23",0,0,15,0,0,16,0,0
"Japan","2024-07-24",0,0,15,0,0,16,0,0
"Japan","2024-07-25",0,0,15,0,0,16,0,0
"Japan","2024-07-26",0,0,15,0,0,16,0,0
"Japan","2024-07-27",0,0,15,0,0,16,0,0
"Japan","2024-07-28",0,0,15,0,0,16,0,0
"Japan","2024-07-29",0,0,15,0,0,16,0,0
"Japan","2024-07-30",0,0,15,0,0,16,0,0
"Japan","2024-07-31",0,0,15,0,0,16,0,0
"Japan","2024-08-01",0,0,15,0,0,16,0,0
"Japan","2024-08-02",0,0,15,0,0,16,0,0
"Japan","2024-08-03",0,0,15,0,0,16,0,0
"Japan","2024-08-04",0,0,15,0,0,16,0,0
"Japan","2024-08-05",0,1,16,0,0,16,0,0
"Japan","2024-08-06",0,0,16,0,0,16,0,0
"Japan","2024-08-07",0,0,16,0,0,16,0,0
"Japan","2024-08-08",0,0,16,0,0,16,0,0
"Japan","2024-08-09",0,0,16,0,0,16,0,0
"Japan","2024-08-10",0,0,16,0,0,16,0,0
"Japan","2024-08-11",0,0,16,0,0,16,0,0
"Japan","2024-08-12",0,0,16,0,0,16,0,0
"Japan","2024-08-13",0,0,16,0,0,16,0,0
"Japan","2024-08-14",0,0,16,0,0,16,0,0
"Japan","2024-08-15",0,0,16,0,0,16,0,0
"Japan","2024-08-16",0,0,16,0,0,16,0,0
"Japan","2024-08-17",0,0,16,0,0,16,0,0
"Japan","2024-08-18",0,0,16,0,0,16,0,0
"Japan","2024-08-19",0,0,16,0,0,16,0,0
"Japan","2024-08-20",0,0,16,0,0,16,0,0
"Japan","2024-08-21",0,0,16,0,0,16,0,0
"Japan","2024-08-22",0,0,16,0,0,16,0,0
"Japan","2024-08-23",0,0,16,0,0,16,0,0
"Japan","2024-08-24",0,0,16,0,0,16,0,0
"Japan","2024-08-25",0,0,16,0,0,16,0,0
"Japan","2024-08-26",0,0,16,0,0,16,0,0
"Japan","2024-08-27",0,0,16,0,0,16,0,0
"Japan","2024-08-28",0,0,16,0,0,16,0,0
"Japan","2024-08-29",0,0,16,0,0,16,0,0
"Japan","2024-08-30",0,0,16,0,0,16,0,0
"Japan","2024-08-31",0,0,16,0,0,16,0,0
"Japan","2024-09-01",0,0,16,0,0,16,0,0
"Japan","2024-09-02",0,0,16,0,0,16,0,0
"Japan","2024-09-03",0,0,16,0,0,16,0,0
"Japan","2024-09-04",0,0,16,0,0,16,0,0
"Japan","2024-09-05",0,0,16,0,1,17,0,0
"Japan","2024-09-06",0,0,16,0,0,17,0,0
"Japan","2024-09-07",0,0,16,0,0,17,0,0
"Japan","2024-09-08",0,0,16,0,0,17,0,0
"Japan","2024-09-09",0,0,16,0,0,17,0,0
"Japan","2024-09-10",0,0,16,0,0,17,0,0
"Japan","2024-09-11",0,0,16,0,0,17,0,0
"Japan","2024-09-12",0,0,16,0,0,17,0,0
"Japan","2024-09-13",0,0,16,0,0,17,0,0
"Japan","2024-09-14",0,0,16,0,0,17,0,0
"Japan","2024-09-15",0,0,16,0,0,17,0,0
"Japan","2024-09-16",0,0,16,0,0,17,0,0
"Japan","2024-09-17",0,0,16,0,0,17,0,0
"Japan","2024-09-18",0,0,16,0,0,17,0,0
"Japan","2024-09-19",0,0,16,0,0,17,0,0
"Japan","2024-09-20",0,0,16,0,0,17,0,0
"Japan","2024-09-21",0,0,16,0,0,17,0,0
"Japan","2024-09-22",0,0,16,0,0,17,0,0
"Japan","2024-09-23",0,0,16,0,0,17,0,0
"Japan","2024-09-24",0,0,16,0,0,17,0,0
"Japan","2024-09-25",0,0,16,0,0,17,0,0
"Japan","2024-09-26",0,0,16,0,0,17,0,0
"Japan","2024-09-27",0,0,16,0,0,17,0,0
"Japan","2024-09-28",0,0,16,0,0,17,0,0
"Japan","2024-09-29",0,0,16,0,0,17,0,0
"Japan","2024-09-30",0,0,16,0,0,17,0,0
"Japan","2024-10-01",0,0,16,0,0,17,0,0
"Japan","2024-10-02",0,0,16,0,0,17,0,0
"Japan","2024-10-03",0,0,16,0,0,17,0,0
"Japan","2024-10-04",0,1,17,0,0,17,0,0
"Japan","2024-10-05",0,0,17,0,0,17,0,0
"Japan","2024-10-06",0,0,17,0,0,17,0,0
"Japan","2024-10-07",0,0,17,0,0,17,0,0
"Japan","2024-10-08",0,0,17,0,1,18,0,0
"Japan","2024-10-09",0,0,17,0,0,18,0,0
"Japan","2024-10-10",0,0,17,0,0,18,0,0
"Japan","2024-10-11",0,0,17,0,0,18,0,0
"Japan","2024-10-12",0,0,17,0,0,18,0,0
"Japan","2024-10-13",0,0,17,0,0,18,0,0
"Japan","2024-10-14",0,0,17,0,0,18,0,0
"Japan","2024-10-15",0,0,17,0,1,19,0,0
"Japan","2024-10-16",0,0,17,0,0,19,0,0
"Japan","2024-10-17",0,0,17,0,0,19,0,0
"Japan","2024-10-18",0,2,19,0,0,19,0,0
"Japan","2024-10-19",0,0,19,0,0,19,0,0
"Japan","2024-10-20",0,0,19,0,0,19,0,0
"Japan","2024-10-21",0,0,19,0,0,19,0,0
"Japan","2024-10-22",0,0,19,0,0,19,0,0
"Japan","2024-10-23",0,0,19,0,0,19,0,0
"Japan","2024-10-24",0,0,19,0,0,19,0,0
"Japan","2024-10-25",0,0,19,0,0,19,0,0
"Japan","2024-10-26",0,0,19,0,0,19,0,0
"Japan","2024-10-27",0,0,19,0,0,19,0,0
"Japan","2024-10-28",0,0,19,0,0,19,0,0
"Japan","2024-10-29",0,0,19,0,0,19,0,0
"Japan","2024-10-30",0,0,19,0,0,19,0,0
"Japan","2024-10-31",0,0,19,0,0,19,0,0
"Japan","2024-11-01",0,0,19,0,0,19,0,0
"Japan","2024-11-02",0,0,19,0,1,20,0,0
"Japan","2024-11-03",0,0,19,0,0,20,0,0
"Japan","2024-11-04",0,0,19,0,0,20,0,0
"Japan","2024-11-05",0,0,19,0,0,20,0,0
"Japan","2024-11-06",0,0,19,0,0,20,0,0
"Japan","2024-11-07",0,0,19,0,0,20,0,0
"Japan","2024-11-08",0,0,19,0,0,20,0,0
"Japan","2024-11-09",0,0,19,0,0,20,0,0
"Japan","2024-11-10",0,0,19,0,0,20,0,0
"Japan","2024-11-11",0,0,19,0,0,20,0,0
"Japan","2024-11-12",0,0,19,0,0,20,0,0
"Japan","2024-11-13",0,0,19,0,0,20,0,0
"Japan","2024-11-14",0,0,19,0,0,20,0,0
"Japan","2024-11-15",0,1,20,0,0,20,0,0
"Japan","2024-11-16",0,0,20,0,0,20,0,0
"Japan","2024-11-17",0,0,20,0,0,20,0,0
"Japan","2024-11-18",0,0,20,0,0,20,0,0
"Japan","2024-11-19",0,0,20,0,0,20,0,0
"Japan","2024-11-20",0,0,20,0,0,20,0,0
"Japan","2024-11-21",0,0,20,0,0,20,0,0
"Japan","2024-11-22",0,0,20,0,0,20,0,0
"Japan","2024-11-23",0,0,20,0,0,20,0,0
"Japan","2024-11-24",0,0,20,0,0,20,0,0
"Japan","2024-11-25",0,0,20,0,0,20,0,0
"Japan","2024-11-26",0,0,20,0,0,20,0,0
"Japan","2024-11-27",0,0,20,0,0,20,0,0
"Japan","2024-11-28",0,0,20,0,0,20,0,0
"Japan","2024-11-29",0,0,20,0,0,20,0,0
"Japan","2024-11-30",0,0,20,0,0,20,0,0
"Japan","2024-12-01",0,0,20,0,0,20,0,0
"Japan","2024-12-02",0,0,20,0,0,20,0,0
"Japan","2024-12-03",0,0,20,0,0,20,0,0
"Japan","2024-12-04",0,0,20,0,0,20,0,0
"Japan","2024-12-05",0,0,20,0,0,20,0,0
"Japan","2024-12-06",0,0,20,0,0,20,0,0
"Japan","2024-12-07",0,0,20,0,0,20,0,0
"Japan","2024-12-08",0,0,20,0,0,20,0,0
"Japan","2024-12-09",0,0,20,0,0,20,0,0
"Japan","2024-12-10",0,0,20,0,0,20,0,0
"Japan","2024-12-11",0,0,20,0,0,20,0,0
"Japan","2024-12-12",0,0,20,0,0,20,0,0
"Japan","2024-12-13",0,0,20,0,0,20,0,0
"Japan","2024-12-14",0,0,20,0,0,20,0,0
"Japan","2024-12-15",0,0,20,0,0,20,0,0
"Japan","2024-12-16",0,0,20,0,0,20,0,0
"Japan","2024-12-17",0,0,20,0,0,20,0,0
"Japan","2024-12-18",0,0,20,0,0,20,0,0
"Japan","2024-12-19",0,0,20,0,0,20,0,0
"Japan","2024-12-20",0,0,20,0,0,20,0,0
"Japan","2024-12-21",0,0,20,0,0,20,0,0
"Japan","2024-12-22",0,0,20,0,0,20,0,0
"Japan","2024-12-23",0,0,20,0,0,20,0,0
"Japan","2024-12-24",0,0,20,0,0,20,0,0
"Japan","2024-12-25",0,0,20,0,0,20,0,0
"Japan","2024-12-26",0,0,20,0,0,20,0,0
"Japan","2024-12-27",0,0,20,0,0,20,0,0
"Japan","2024-12-28",0,0,20,0,0,20,0,0
"Japan","2024-12-29",0,0,20,0,0,20,0,0
"Japan","2024-12-30",0,0,20,0,0,20,0,0
"Japan","2024-12-31",0,0,20,0,0,20,0,0
"Japan","2025-01-01",0,0,20,0,0,20,0,0
"Japan","2025-01-02",0,0,20,0,0,20,0,0
"Japan","2025-01-03",0,0,20,0,0,20,0,0
"Japan","2025-01-04",0,0,20,0,0,20,0,0
"Japan","2025-01-05",0,0,20,0,0,20,0,0
"Japan","2025-01-06",0,0,20,0,0,20,0,0
"Japan","2025-01-07",0,0,20,0,0,20,0,0
"Japan","2025-01-08",0,0,20,0,0,20,0,0
"Japan","2025-01-09",0,0,20,0,0,20,0,0
"Japan","2025-01-10",0,0,20,0,0,20,0,0
"Japan","2025-01-11",0,0,20,0,0,20,0,0
"Japan","2025-01-12",0,0,20,0,0,20,0,0
"Japan","2025-01-13",0,0,20,0,0,20,0,0
"Jordan","2024-01-01",0,0,0,0,0,0,0,0
"Jordan","2024-01-02",0,0,0,0,0,0,0,0
"Jordan","2024-01-03",0,0,0,0,0,0,0,0
"Jordan","2024-01-04",0,0,0,0,0,0,0,0
"Jordan","2024-01-05",0,0,0,0,0,0,0,0
"Jordan","2024-01-06",0,0,0,0,0,0,0,0
"Jordan","2024-01-07",0,0,0,0,0,0,0,0
"Jordan","2024-01-08",0,0,0,0,0,0,0,0
"Jordan","2024-01-09",0,0,0,0,0,0,0,0
"Jordan","2024-01-10",0,0,0,0,0,0,0,0
"Jordan","2024-01-11",0,0,0,0,0,0,0,0
"Jordan","2024-01-12",0,0,0,0,0,0,0,0
"Jordan","2024-01-13",0,0,0,0,0,0,0,0
"Jordan","2024-01-14",0,0,0,0,0,0,0,0
"Jordan","2024-01-15",0,0,0,0,0,0,0,0
"Jordan","2024-01-16",0,0,0,0,0,0,0,0
"Jordan","2024-01-17",0,0,0,0,0,0,0,0
"Jordan","2024-01-18",0,0,0,0,0,0,0,0
"Jordan","2024-01-19",0,0,0,0,0,0,0,0
"Jordan","2024-01-20",0,0,0,0,0,0,0,0
"Jordan","2024-01-21",0,0,0,0,0,0,0,0
"Jordan","2024-01-22",0,0,0,0,0,0,0,0
"Jordan","2024-01-23",0,0,0,0,0,0,0,0
"Jordan","2024-01-24",0,0,0,0,0,0,0,0
"Jordan","2024-01-25",0,0,0,0,0,0,0,0
"Jordan","2024-01-26",0,0,0,0,0,0,0,0
"Jordan","2024-01-27",0,0,0,0,0,0,0,0
"Jordan","2024-01-28",0,0,0,0,0,0,0,0
"Jordan","2024-01-29",0,0,0,0,0,0,0,0
"Jordan","2024-01-30",0,0,0,0,0,0,0,0
"Jordan","2024-01-31",0,0,0,0,0,0,0,0
"Jordan","2024-02-01",0,0,0,0,0,0,0,0
"Jordan","2024-02-02",0,0,0,0,0,0,0,0
"Jordan","2024-02-03",0,0,0,0,0,0,0,0
"Jordan","2024-02-04",0,0,0,0,0,0,0,0
"Jordan","2024-02-05",0,0,0,0,0,0,0,0
"Jordan","2024-02-06",0,0,0,0,0,0,0,0
"Jordan","2024-02-07",0,0,0,0,0,0,0,0
"Jordan","2024-02-08",0,0,0,0,0,0,0,0
"Jordan","2024-02-09",0,0,0,0,0,0,0,0
"Jordan","2024-02-10",0,0,0,0,0,0,0,0
"Jordan","2024-02-11",0,0,0,0,0,0,0,0
"Jordan","2024-02-12",0,0,0,0,0,0,0,0
"Jordan","2024-02-13",0,0,0,0,0,0,0,0
"Jordan","2024-02-14",0,0,0,0,0,0,0,0
"Jordan","2024-02-15",0,0,0,0,0,0,0,0
"Jordan","2024-02-16",0,0,0,0,0,0,0,0
"Jordan","2024-02-17",0,0,0,0,0,0,0,0
"Jordan","2024-02-18",0,0,0,0,0,0,0,0
"Jordan","2024-02-19",0,0,0,0,0,0,0,0
"Jordan","2024-02-20",0,0,0,0,0,0,0,0
"Jordan","2024-02-21",0,0,0,0,0,0,0,0
"Jordan","2024-02-22",0,0,0,0,0,0,0,0
"Jordan","2024-02-23",0,0,0,0,0,0,0,0
"Jordan","2024-02-24",0,0,0,0,0,0,0,0
"Jordan","2024-02-25",0,0,0,0,0,0,0,0
"Jordan","2024-02-26",0,0,0,0,0,0,0,0
"Jordan","2024-02-27",0,0,0,0,0,0,0,0
"Jordan","2024-02-28",0,0,0,0,0,0,0,0
"Jordan","2024-02-29",0,0,0,0,0,0,0,0
"Jordan","2024-03-01",0,0,0,0,0,0,0,0
"Jordan","2024-03-02",0,0,0,0,0,0,0,0
"Jordan","2024-03-03",0,0,0,0,0,0,0,0
"Jordan","2024-03-04",0,0,0,0,0,0,0,0
"Jordan","2024-03-05",0,0,0,0,0,0,0,0
"Jordan","2024-03-06",0,0,0,0,0,0,0,0
"Jordan","2024-03-07",0,0,0,0,0,0,0,0
"Jordan","2024-03-08",0,0,0,0,0,0,0,0
"Jordan","2024-03-09",0,0,0,0,0,0,0,0
"Jordan","2024-03-10",0,0,0,0,0,0,0,0
"Jordan","2024-03-11",0,0,0,0,0,0,0,0
"Jordan","2024-03-12",0,0,0,0,0,0,0,0
"Jordan","2024-03-13",0,0,0,0,0,0,0,0
"Jordan","2024-03-14",0,0,0,0,0,0,0,0
"Jordan","2024-03-15",0,0,0,0,0,0,0,0
"Jordan","2024-03-16",0,0,0,0,0,0,0,0
"Jordan","2024-03-17",0,0,0,0,0,0,0,0
"Jordan","2024-03-18",0,0,0,0,0,0,0,0
"Jordan","2024-03-19",0,0,0,0,0,0,0,0
"Jordan","2024-03-20",0,0,0,0,0,0,0,0
"Jordan","2024-03-21",0,0,0,0,0,0,0,0
"Jordan","2024-03-22",0,0,0,0,0,0,0,0
"Jordan","2024-03-23",0,0,0,0,0,0,0,0
"Jordan","2024-03-24",0,0,0,0,0,0,0,0
"Jordan","2024-03-25",0,0,0,0,0,0,0,0
"Jordan","2024-03-26",0,0,0,0,0,0,0,0
"Jordan","2024-03-27",0,0,0,0,0,0,0,0
"Jordan","2024-03-28",0,0,0,0,0,0,0,0
"Jordan","2024-03-29",0,0,0,0,0,0,0,0
"Jordan","2024-03-30",0,0,0,0,0,0,0,0
"Jordan","2024-03-31",0,0,0,0,0,0,0,0
"Jordan","2024-04-01",0,0,0,0,0,0,0,0
"Jordan","2024-04-02",0,0,0,0,0,0,0,0
"Jordan","2024-04-03",0,0,0,0,0,0,0,0
"Jordan","2024-04-04",0,0,0,0,0,0,0,0
"Jordan","2024-04-05",0,0,0,0,0,0,0,0
"Jordan","2024-04-06",0,0,0,0,0,0,0,0
"Jordan","2024-04-07",0,0,0,0,0,0,0,0
"Jordan","2024-04-08",0,0,0,0,0,0,0,0
"Jordan","2024-04-09",0,0,0,0,0,0,0,0
"Jordan","2024-04-10",0,0,0,0,0,0,0,0
"Jordan","2024-04-11",0,0,0,0,0,0,0,0
"Jordan","2024-04-12",0,0,0,0,0,0,0,0
"Jordan","2024-04-13",0,0,0,0,0,0,0,0
"Jordan","2024-04-14",0,0,0,0,0,0,0,0
"Jordan","2024-04-15",0,0,0,0,0,0,0,0
"Jordan","2024-04-16",0,0,0,0,0,0,0,0
"Jordan","2024-04-17",0,0,0,0,0,0,0,0
"Jordan","2024-04-18",0,0,0,0,0,0,0,0
"Jordan","2024-04-19",0,0,0,0,0,0,0,0
"Jordan","2024-04-20",0,0,0,0,0,0,0,0
"Jordan","2024-04-21",0,0,0,0,0,0,0,0
"Jordan","2024-04-22",0,0,0,0,0,0,0,0
"Jordan","2024-04-23",0,0,0,0,0,0,0,0
"Jordan","2024-04-24",0,0,0,0,0,0,0,0
"Jordan","2024-04-25",0,0,0,0,0,0,0,0
"Jordan","2024-04-26",0,0,0,0,0,0,0,0
"Jordan","2024-04-27",0,0,0,0,0,0,0,0
"Jordan","2024-04-28",0,0,0,0,0,0,0,0
"Jordan","2024-04-29",0,0,0,0,0,0,0,0
"Jordan","2024-04-30",0,0,0,0,0,0,0,0
"Jordan","2024-05-01",0,0,0,0,0,0,0,0
"Jordan","2024-05-02",0,0,0,0,0,0,0,0
"Jordan","2024-05-03",0,0,0,0,0,0,0,0
"Jordan","2024-05-04",0,0,0,0,0,0,0,0
"Jordan","2024-05-05",0,0,0,0,0,0,0,0
"Jordan","2024-05-06",0,0,0,0,0,0,0,0
"Jordan","2024-05-07",0,0,0,0,0,0,0,0
"Jordan","2024-05-08",0,0,0,0,0,0,0,0
"Jordan","2024-05-09",0,0,0,0,0,0,0,0
"Jordan","2024-05-10",0,0,0,0,0,0,0,0
"Jordan","2024-05-11",0,0,0,0,0,0,0,0
"Jordan","2024-05-12",0,0,0,0,0,0,0,0
"Jordan","2024-05-13",0,0,0,0,0,0,0,0
"Jordan","2024-05-14",0,0,0,0,0,0,0,0
"Jordan","2024-05-15",0,0,0,0,0,0,0,0
"Jordan","2024-05-16",0,0,0,0,0,0,0,0
"Jordan","2024-05-17",0,0,0,0,0,0,0,0
"Jordan","2024-05-18",0,0,0,0,0,0,0,0
"Jordan","2024-05-19",0,0,0,0,0,0,0,0
"Jordan","2024-05-20",0,0,0,0,0,0,0,0
"Jordan","2024-05-21",0,0,0,0,0,0,0,0
"Jordan","2024-05-22",0,0,0,0,0,0,0,0
"Jordan","2024-05-23",0,0,0,0,0,0,0,0
"Jordan","2024-05-24",0,0,0,0,0,0,0,0
"Jordan","2024-05-25",0,0,0,0,0,0,0,0
"Jordan","2024-05-26",0,0,0,0,0,0,0,0
"Jordan","2024-05-27",0,0,0,0,0,0,0,0
"Jordan","2024-05-28",0,0,0,0,0,0,0,0
"Jordan","2024-05-29",0,0,0,0,0,0,0,0
"Jordan","2024-05-30",0,0,0,0,0,0,0,0
"Jordan","2024-05-31",0,0,0,0,0,0,0,0
"Jordan","2024-06-01",0,0,0,0,0,0,0,0
"Jordan","2024-06-02",0,0,0,0,0,0,0,0
"Jordan","2024-06-03",0,0,0,0,0,0,0,0
"Jordan","2024-06-04",0,0,0,0,0,0,0,0
"Jordan","2024-06-05",0,0,0,0,0,0,0,0
"Jordan","2024-06-06",0,0,0,0,0,0,0,0
"Jordan","2024-06-07",0,0,0,0,0,0,0,0
"Jordan","2024-06-08",0,0,0,0,0,0,0,0
"Jordan","2024-06-09",0,0,0,0,0,0,0,0
"Jordan","2024-06-10",0,0,0,0,0,0,0,0
"Jordan","2024-06-11",0,0,0,0,0,0,0,0
"Jordan","2024-06-12",0,0,0,0,0,0,0,0
"Jordan","2024-06-13",0,0,0,0,0,0,0,0
"Jordan","2024-06-14",0,0,0,0,0,0,0,0
"Jordan","2024-06-15",0,0,0,0,0,0,0,0
"Jordan","2024-06-16",0,0,0,0,0,0,0,0
"Jordan","2024-06-17",0,0,0,0,0,0,0,0
"Jordan","2024-06-18",0,0,0,0,0,0,0,0
"Jordan","2024-06-19",0,0,0,0,0,0,0,0
"Jordan","2024-06-20",0,0,0,0,0,0,0,0
"Jordan","2024-06-21",0,0,0,0,0,0,0,0
"Jordan","2024-06-22",0,0,0,0,0,0,0,0
"Jordan","2024-06-23",0,0,0,0,0,0,0,0
"Jordan","2024-06-24",0,0,0,0,0,0,0,0
"Jordan","2024-06-25",0,0,0,0,0,0,0,0
"Jordan","2024-06-26",0,0,0,0,0,0,0,0
"Jordan","2024-06-27",0,0,0,0,0,0,0,0
"Jordan","2024-06-28",0,0,0,0,0,0,0,0
"Jordan","2024-06-29",0,0,0,0,0,0,0,0
"Jordan","2024-06-30",0,0,0,0,0,0,0,0
"Jordan","2024-07-01",0,0,0,0,0,0,0,0
"Jordan","2024-07-02",0,0,0,0,0,0,0,0
"Jordan","2024-07-03",0,0,0,0,0,0,0,0
"Jordan","2024-07-04",0,0,0,0,0,0,0,0
"Jordan","2024-07-05",0,0,0,0,0,0,0,0
"Jordan","2024-07-06",0,0,0,0,0,0,0,0
"Jordan","2024-07-07",0,0,0,0,0,0,0,0
"Jordan","2024-07-08",0,0,0,0,0,0,0,0
"Jordan","2024-07-09",0,0,0,0,0,0,0,0
"Jordan","2024-07-10",0,0,0,0,0,0,0,0
"Jordan","2024-07-11",0,0,0,0,0,0,0,0
"Jordan","2024-07-12",0,0,0,0,0,0,0,0
"Jordan","2024-07-13",0,0,0,0,0,0,0,0
"Jordan","2024-07-14",0,0,0,0,0,0,0,0
"Jordan","2024-07-15",0,0,0,0,0,0,0,0
"Jordan","2024-07-16",0,0,0,0,0,0,0,0
"Jordan","2024-07-17",0,0,0,0,0,0,0,0
"Jordan","2024-07-18",0,0,0,0,0,0,0,0
"Jordan","2024-07-19",0,0,0,0,0,0,0,0
"Jordan","2024-07-20",0,0,0,0,0,0,0,0
"Jordan","2024-07-21",0,0,0,0,0,0,0,0
"Jordan","2024-07-22",0,0,0,0,0,0,0,0
"Jordan","2024-07-23",0,0,0,0,0,0,0,0
"Jordan","2024-07-24",0,0,0,0,0,0,0,0
"Jordan","2024-07-25",0,0,0,0,0,0,0,0
"Jordan","2024-07-26",0,0,0,0,0,0,0,0
"Jordan","2024-07-27",0,0,0,0,0,0,0,0
"Jordan","2024-07-28",0,0,0,0,0,0,0,0
"Jordan","2024-07-29",0,0,0,0,0,0,0,0
"Jordan","2024-07-30",0,0,0,0,0,0,0,0
"Jordan","2024-07-31",0,0,0,0,0,0,0,0
"Jordan","2024-08-01",0,0,0,0,0,0,0,0
"Jordan","2024-08-02",0,0,0,0,0,0,0,0
"Jordan","2024-08-03",0,0,0,0,0,0,0,0
"Jordan","2024-08-04",0,0,0,0,0,0,0,0
"Jordan","2024-08-05",0,0,0,0,0,0,0,0
"Jordan","2024-08-06",0,0,0,0,0,0,0,0
"Jordan","2024-08-07",0,0,0,0,0,0,0,0
"Jordan","2024-08-08",0,0,0,0,0,0,0,0
"Jordan","2024-08-09",0,0,0,0,0,0,0,0
"Jordan","2024-08-10",0,0,0,0,0,0,0,0
"Jordan","2024-08-11",0,0,0,0,0,0,0,0
"Jordan","2024-08-12",0,0,0,0,0,0,0,0
"Jordan","2024-08-13",0,0,0,0,0,0,0,0
"Jordan","2024-08-14",0,0,0,0,0,0,0,0
"Jordan","2024-08-15",0,0,0,0,0,0,0,0
"Jordan","2024-08-16",0,0,0,0,0,0,0,0
"Jordan","2024-08-17",0,0,0,0,0,0,0,0
"Jordan","2024-08-18",0,0,0,0,0,0,0,0
"Jordan","2024-08-19",0,0,0,0,0,0,0,0
"Jordan","2024-08-20",0,0,0,0,0,0,0,0
"Jordan","2024-08-21",0,0,0,0,0,0,0,0
"Jordan","2024-08-22",0,0,0,0,0,0,0,0
"Jordan","2024-08-23",0,0,0,0,0,0,0,0
"Jordan","2024-08-24",0,0,0,0,0,0,0,0
"Jordan","2024-08-25",0,0,0,0,0,0,0,0
"Jordan","2024-08-26",0,0,0,0,0,0,0,0
"Jordan","2024-08-27",0,0,0,0,0,0,0,0
"Jordan","2024-08-28",0,0,0,0,0,0,0,0
"Jordan","2024-08-29",0,0,0,0,0,0,0,0
"Jordan","2024-08-30",0,0,0,0,0,0,0,0
"Jordan","2024-08-31",0,0,0,0,0,0,0,0
"Jordan","2024-09-01",0,0,0,0,0,0,0,0
"Jordan","2024-09-02",0,1,1,0,1,1,0,0
"Jordan","2024-09-03",0,0,1,0,0,1,0,0
"Jordan","2024-09-04",0,0,1,0,0,1,0,0
"Jordan","2024-09-05",0,0,1,0,0,1,0,0
"Jordan","2024-09-06",0,0,1,0,0,1,0,0
"Jordan","2024-09-07",0,0,1,0,0,1,0,0
"Jordan","2024-09-08",0,0,1,0,0,1,0,0
"Jordan","2024-09-09",0,0,1,0,0,1,0,0
"Jordan","2024-09-10",0,0,1,0,0,1,0,0
"Jordan","2024-09-11",0,0,1,0,0,1,0,0
"Jordan","2024-09-12",0,0,1,0,0,1,0,0
"Jordan","2024-09-13",0,0,1,0,0,1,0,0
"Jordan","2024-09-14",0,0,1,0,0,1,0,0
"Jordan","2024-09-15",0,0,1,0,0,1,0,0
"Jordan","2024-09-16",0,0,1,0,0,1,0,0
"Jordan","2024-09-17",0,0,1,0,0,1,0,0
"Jordan","2024-09-18",0,0,1,0,0,1,0,0
"Jordan","2024-09-19",0,0,1,0,0,1,0,0
"Jordan","2024-09-20",0,0,1,0,0,1,0,0
"Jordan","2024-09-21",0,0,1,0,0,1,0,0
"Jordan","2024-09-22",0,0,1,0,0,1,0,0
"Jordan","2024-09-23",0,0,1,0,0,1,0,0
"Jordan","2024-09-24",0,0,1,0,0,1,0,0
"Jordan","2024-09-25",0,0,1,0,0,1,0,0
"Jordan","2024-09-26",0,0,1,0,0,1,0,0
"Jordan","2024-09-27",0,0,1,0,0,1,0,0
"Jordan","2024-09-28",0,0,1,0,0,1,0,0
"Jordan","2024-09-29",0,0,1,0,0,1,0,0
"Jordan","2024-09-30",0,0,1,0,0,1,0,0
"Jordan","2024-10-01",0,0,1,0,0,1,0,0
"Jordan","2024-10-02",0,0,1,0,0,1,0,0
"Jordan","2024-10-03",0,0,1,0,0,1,0,0
"Jordan","2024-10-04",0,0,1,0,0,1,0,0
"Jordan","2024-10-05",0,0,1,0,0,1,0,0
"Jordan","2024-10-06",0,0,1,0,0,1,0,0
"Jordan","2024-10-07",0,0,1,0,0,1,0,0
"Jordan","2024-10-08",0,0,1,0,0,1,0,0
"Jordan","2024-10-09",0,0,1,0,0,1,0,0
"Jordan","2024-10-10",0,0,1,0,0,1,0,0
"Jordan","2024-10-11",0,0,1,0,0,1,0,0
"Jordan","2024-10-12",0,0,1,0,0,1,0,0
"Jordan","2024-10-13",0,0,1,0,0,1,0,0
"Jordan","2024-10-14",0,0,1,0,0,1,0,0
"Jordan","2024-10-15",0,0,1,0,0,1,0,0
"Jordan","2024-10-16",0,0,1,0,0,1,0,0
"Jordan","2024-10-17",0,0,1,0,0,1,0,0
"Jordan","2024-10-18",0,0,1,0,0,1,0,0
"Jordan","2024-10-19",0,0,1,0,0,1,0,0
"Jordan","2024-10-20",0,0,1,0,0,1,0,0
"Jordan","2024-10-21",0,0,1,0,0,1,0,0
"Jordan","2024-10-22",0,0,1,0,0,1,0,0
"Jordan","2024-10-23",0,0,1,0,0,1,0,0
"Jordan","2024-10-24",0,0,1,0,0,1,0,0
"Jordan","2024-10-25",0,0,1,0,0,1,0,0
"Jordan","2024-10-26",0,0,1,0,0,1,0,0
"Jordan","2024-10-27",0,0,1,0,0,1,0,0
"Jordan","2024-10-28",0,0,1,0,0,1,0,0
"Jordan","2024-10-29",0,0,1,0,0,1,0,0
"Jordan","2024-10-30",0,0,1,0,0,1,0,0
"Jordan","2024-10-31",0,0,1,0,0,1,0,0
"Jordan","2024-11-01",0,0,1,0,0,1,0,0
"Jordan","2024-11-02",0,0,1,0,0,1,0,0
"Jordan","2024-11-03",0,0,1,0,0,1,0,0
"Jordan","2024-11-04",0,0,1,0,0,1,0,0
"Jordan","2024-11-05",0,0,1,0,0,1,0,0
"Jordan","2024-11-06",0,0,1,0,0,1,0,0
"Jordan","2024-11-07",0,0,1,0,0,1,0,0
"Jordan","2024-11-08",0,0,1,0,0,1,0,0
"Jordan","2024-11-09",0,0,1,0,0,1,0,0
"Jordan","2024-11-10",0,0,1,0,0,1,0,0
"Jordan","2024-11-11",0,0,1,0,0,1,0,0
"Jordan","2024-11-12",0,0,1,0,0,1,0,0
"Jordan","2024-11-13",0,0,1,0,0,1,0,0
"Jordan","2024-11-14",0,0,1,0,0,1,0,0
"Jordan","2024-11-15",0,0,1,0,0,1,0,0
"Jordan","2024-11-16",0,0,1,0,0,1,0,0
"Jordan","2024-11-17",0,0,1,0,0,1,0,0
"Jordan","2024-11-18",0,0,1,0,0,1,0,0
"Jordan","2024-11-19",0,0,1,0,0,1,0,0
"Jordan","2024-11-20",0,0,1,0,0,1,0,0
"Jordan","2024-11-21",0,0,1,0,0,1,0,0
"Jordan","2024-11-22",0,0,1,0,0,1,0,0
"Jordan","2024-11-23",0,0,1,0,0,1,0,0
"Jordan","2024-11-24",0,0,1,0,0,1,0,0
"Jordan","2024-11-25",0,0,1,0,0,1,0,0
"Jordan","2024-11-26",0,0,1,0,0,1,0,0
"Jordan","2024-11-27",0,0,1,0,0,1,0,0
"Jordan","2024-11-28",0,0,1,0,0,1,0,0
"Jordan","2024-11-29",0,0,1,0,0,1,0,0
"Jordan","2024-11-30",0,0,1,0,0,1,0,0
"Jordan","2024-12-01",0,0,1,0,0,1,0,0
"Jordan","2024-12-02",0,0,1,0,0,1,0,0
"Jordan","2024-12-03",0,0,1,0,0,1,0,0
"Jordan","2024-12-04",0,0,1,0,0,1,0,0
"Jordan","2024-12-05",0,0,1,0,0,1,0,0
"Jordan","2024-12-06",0,0,1,0,0,1,0,0
"Jordan","2024-12-07",0,0,1,0,0,1,0,0
"Jordan","2024-12-08",0,0,1,0,0,1,0,0
"Jordan","2024-12-09",0,0,1,0,0,1,0,0
"Jordan","2024-12-10",0,0,1,0,0,1,0,0
"Jordan","2024-12-11",0,0,1,0,0,1,0,0
"Jordan","2024-12-12",0,0,1,0,0,1,0,0
"Jordan","2024-12-13",0,0,1,0,0,1,0,0
"Jordan","2024-12-14",0,0,1,0,0,1,0,0
"Jordan","2024-12-15",0,0,1,0,0,1,0,0
"Jordan","2024-12-16",0,0,1,0,0,1,0,0
"Jordan","2024-12-17",0,0,1,0,0,1,0,0
"Jordan","2024-12-18",0,0,1,0,0,1,0,0
"Jordan","2024-12-19",0,0,1,0,0,1,0,0
"Jordan","2024-12-20",0,0,1,0,0,1,0,0
"Jordan","2024-12-21",0,0,1,0,0,1,0,0
"Jordan","2024-12-22",0,0,1,0,0,1,0,0
"Jordan","2024-12-23",0,0,1,0,0,1,0,0
"Jordan","2024-12-24",0,0,1,0,0,1,0,0
"Jordan","2024-12-25",0,0,1,0,0,1,0,0
"Jordan","2024-12-26",0,0,1,0,0,1,0,0
"Jordan","2024-12-27",0,0,1,0,0,1,0,0
"Jordan","2024-12-28",0,0,1,0,0,1,0,0
"Jordan","2024-12-29",0,0,1,0,0,1,0,0
"Jordan","2024-12-30",0,0,1,0,0,1,0,0
"Jordan","2024-12-31",0,0,1,0,0,1,0,0
"Jordan","2025-01-01",0,0,1,0,0,1,0,0
"Jordan","2025-01-02",0,0,1,0,0,1,0,0
"Jordan","2025-01-03",0,0,1,0,0,1,0,0
"Jordan","2025-01-04",0,0,1,0,0,1,0,0
"Jordan","2025-01-05",0,0,1,0,0,1,0,0
"Jordan","2025-01-06",0,0,1,0,0,1,0,0
"Jordan","2025-01-07",0,0,1,0,0,1,0,0
"Jordan","2025-01-08",0,0,1,0,0,1,0,0
"Jordan","2025-01-09",0,0,1,0,0,1,0,0
"Jordan","2025-01-10",0,0,1,0,0,1,0,0
"Jordan","2025-01-11",0,0,1,0,0,1,0,0
"Jordan","2025-01-12",0,0,1,0,0,1,0,0
"Jordan","2025-01-13",0,0,1,0,0,1,0,0
"Kenya","2024-01-01",0,0,0,0,0,0,0,0
"Kenya","2024-01-02",0,0,0,0,0,0,0,0
"Kenya","2024-01-03",0,0,0,0,0,0,0,0
"Kenya","2024-01-04",0,0,0,0,0,0,0,0
"Kenya","2024-01-05",0,0,0,0,0,0,0,0
"Kenya","2024-01-06",0,0,0,0,0,0,0,0
"Kenya","2024-01-07",0,0,0,0,0,0,0,0
"Kenya","2024-01-08",0,0,0,0,0,0,0,0
"Kenya","2024-01-09",0,0,0,0,0,0,0,0
"Kenya","2024-01-10",0,0,0,0,0,0,0,0
"Kenya","2024-01-11",0,0,0,0,0,0,0,0
"Kenya","2024-01-12",0,0,0,0,0,0,0,0
"Kenya","2024-01-13",0,0,0,0,0,0,0,0
"Kenya","2024-01-14",0,0,0,0,0,0,0,0
"Kenya","2024-01-15",0,0,0,0,0,0,0,0
"Kenya","2024-01-16",0,0,0,0,0,0,0,0
"Kenya","2024-01-17",0,0,0,0,0,0,0,0
"Kenya","2024-01-18",0,0,0,0,0,0,0,0
"Kenya","2024-01-19",0,0,0,0,0,0,0,0
"Kenya","2024-01-20",0,0,0,0,0,0,0,0
"Kenya","2024-01-21",0,0,0,0,0,0,0,0
"Kenya","2024-01-22",0,0,0,0,0,0,0,0
"Kenya","2024-01-23",0,0,0,0,0,0,0,0
"Kenya","2024-01-24",0,0,0,0,0,0,0,0
"Kenya","2024-01-25",0,0,0,0,0,0,0,0
"Kenya","2024-01-26",0,0,0,0,0,0,0,0
"Kenya","2024-01-27",0,0,0,0,0,0,0,0
"Kenya","2024-01-28",0,0,0,0,0,0,0,0
"Kenya","2024-01-29",0,0,0,0,0,0,0,0
"Kenya","2024-01-30",0,0,0,0,0,0,0,0
"Kenya","2024-01-31",0,0,0,0,0,0,0,0
"Kenya","2024-02-01",0,0,0,0,0,0,0,0
"Kenya","2024-02-02",0,0,0,0,0,0,0,0
"Kenya","2024-02-03",0,0,0,0,0,0,0,0
"Kenya","2024-02-04",0,0,0,0,0,0,0,0
"Kenya","2024-02-05",0,0,0,0,0,0,0,0
"Kenya","2024-02-06",0,0,0,0,0,0,0,0
"Kenya","2024-02-07",0,0,0,0,0,0,0,0
"Kenya","2024-02-08",0,0,0,0,0,0,0,0
"Kenya","2024-02-09",0,0,0,0,0,0,0,0
"Kenya","2024-02-10",0,0,0,0,0,0,0,0
"Kenya","2024-02-11",0,0,0,0,0,0,0,0
"Kenya","2024-02-12",0,0,0,0,0,0,0,0
"Kenya","2024-02-13",0,0,0,0,0,0,0,0
"Kenya","2024-02-14",0,0,0,0,0,0,0,0
"Kenya","2024-02-15",0,0,0,0,0,0,0,0
"Kenya","2024-02-16",0,0,0,0,0,0,0,0
"Kenya","2024-02-17",0,0,0,0,0,0,0,0
"Kenya","2024-02-18",0,0,0,0,0,0,0,0
"Kenya","2024-02-19",0,0,0,0,0,0,0,0
"Kenya","2024-02-20",0,0,0,0,0,0,0,0
"Kenya","2024-02-21",0,0,0,0,0,0,0,0
"Kenya","2024-02-22",0,0,0,0,0,0,0,0
"Kenya","2024-02-23",0,0,0,0,0,0,0,0
"Kenya","2024-02-24",0,0,0,0,0,0,0,0
"Kenya","2024-02-25",0,0,0,0,0,0,0,0
"Kenya","2024-02-26",0,0,0,0,0,0,0,0
"Kenya","2024-02-27",0,0,0,0,0,0,0,0
"Kenya","2024-02-28",0,0,0,0,0,0,0,0
"Kenya","2024-02-29",0,0,0,0,0,0,0,0
"Kenya","2024-03-01",0,0,0,0,0,0,0,0
"Kenya","2024-03-02",0,0,0,0,0,0,0,0
"Kenya","2024-03-03",0,0,0,0,0,0,0,0
"Kenya","2024-03-04",0,0,0,0,0,0,0,0
"Kenya","2024-03-05",0,0,0,0,0,0,0,0
"Kenya","2024-03-06",0,0,0,0,0,0,0,0
"Kenya","2024-03-07",0,0,0,0,0,0,0,0
"Kenya","2024-03-08",0,0,0,0,0,0,0,0
"Kenya","2024-03-09",0,0,0,0,0,0,0,0
"Kenya","2024-03-10",0,0,0,0,0,0,0,0
"Kenya","2024-03-11",0,0,0,0,0,0,0,0
"Kenya","2024-03-12",0,0,0,0,0,0,0,0
"Kenya","2024-03-13",0,0,0,0,0,0,0,0
"Kenya","2024-03-14",0,0,0,0,0,0,0,0
"Kenya","2024-03-15",0,0,0,0,0,0,0,0
"Kenya","2024-03-16",0,0,0,0,0,0,0,0
"Kenya","2024-03-17",0,0,0,0,0,0,0,0
"Kenya","2024-03-18",0,0,0,0,0,0,0,0
"Kenya","2024-03-19",0,0,0,0,0,0,0,0
"Kenya","2024-03-20",0,0,0,0,0,0,0,0
"Kenya","2024-03-21",0,0,0,0,0,0,0,0
"Kenya","2024-03-22",0,0,0,0,0,0,0,0
"Kenya","2024-03-23",0,0,0,0,0,0,0,0
"Kenya","2024-03-24",0,0,0,0,0,0,0,0
"Kenya","2024-03-25",0,0,0,0,0,0,0,0
"Kenya","2024-03-26",0,0,0,0,0,0,0,0
"Kenya","2024-03-27",0,0,0,0,0,0,0,0
"Kenya","2024-03-28",0,0,0,0,0,0,0,0
"Kenya","2024-03-29",0,0,0,0,0,0,0,0
"Kenya","2024-03-30",0,0,0,0,0,0,0,0
"Kenya","2024-03-31",0,0,0,0,0,0,0,0
"Kenya","2024-04-01",0,0,0,0,0,0,0,0
"Kenya","2024-04-02",0,0,0,0,0,0,0,0
"Kenya","2024-04-03",0,0,0,0,0,0,0,0
"Kenya","2024-04-04",0,0,0,0,0,0,0,0
"Kenya","2024-04-05",0,0,0,0,0,0,0,0
"Kenya","2024-04-06",0,0,0,0,0,0,0,0
"Kenya","2024-04-07",0,0,0,0,0,0,0,0
"Kenya","2024-04-08",0,0,0,0,0,0,0,0
"Kenya","2024-04-09",0,0,0,0,0,0,0,0
"Kenya","2024-04-10",0,0,0,0,0,0,0,0
"Kenya","2024-04-11",0,0,0,0,0,0,0,0
"Kenya","2024-04-12",0,0,0,0,0,0,0,0
"Kenya","2024-04-13",0,0,0,0,0,0,0,0
"Kenya","2024-04-14",0,0,0,0,0,0,0,0
"Kenya","2024-04-15",0,0,0,0,0,0,0,0
"Kenya","2024-04-16",0,0,0,0,0,0,0,0
"Kenya","2024-04-17",0,0,0,0,0,0,0,0
"Kenya","2024-04-18",0,0,0,0,0,0,0,0
"Kenya","2024-04-19",0,0,0,0,0,0,0,0
"Kenya","2024-04-20",0,0,0,0,0,0,0,0
"Kenya","2024-04-21",0,0,0,0,0,0,0,0
"Kenya","2024-04-22",0,0,0,0,0,0,0,0
"Kenya","2024-04-23",0,0,0,0,0,0,0,0
"Kenya","2024-04-24",0,0,0,0,0,0,0,0
"Kenya","2024-04-25",0,0,0,0,0,0,0,0
"Kenya","2024-04-26",0,0,0,0,0,0,0,0
"Kenya","2024-04-27",0,0,0,0,0,0,0,0
"Kenya","2024-04-28",0,0,0,0,0,0,0,0
"Kenya","2024-04-29",0,0,0,0,0,0,0,0
"Kenya","2024-04-30",0,0,0,0,0,0,0,0
"Kenya","2024-05-01",0,0,0,0,0,0,0,0
"Kenya","2024-05-02",0,0,0,0,0,0,0,0
"Kenya","2024-05-03",0,0,0,0,0,0,0,0
"Kenya","2024-05-04",0,0,0,0,0,0,0,0
"Kenya","2024-05-05",0,0,0,0,0,0,0,0
"Kenya","2024-05-06",0,0,0,0,0,0,0,0
"Kenya","2024-05-07",0,0,0,0,0,0,0,0
"Kenya","2024-05-08",0,0,0,0,0,0,0,0
"Kenya","2024-05-09",0,0,0,0,0,0,0,0
"Kenya","2024-05-10",0,0,0,0,0,0,0,0
"Kenya","2024-05-11",0,0,0,0,0,0,0,0
"Kenya","2024-05-12",0,0,0,0,0,0,0,0
"Kenya","2024-05-13",0,0,0,0,0,0,0,0
"Kenya","2024-05-14",0,0,0,0,0,0,0,0
"Kenya","2024-05-15",0,0,0,0,0,0,0,0
"Kenya","2024-05-16",0,0,0,0,0,0,0,0
"Kenya","2024-05-17",0,0,0,0,0,0,0,0
"Kenya","2024-05-18",0,0,0,0,0,0,0,0
"Kenya","2024-05-19",0,0,0,0,0,0,0,0
"Kenya","2024-05-20",0,0,0,0,0,0,0,0
"Kenya","2024-05-21",0,0,0,0,0,0,0,0
"Kenya","2024-05-22",0,0,0,0,0,0,0,0
"Kenya","2024-05-23",0,0,0,0,0,0,0,0
"Kenya","2024-05-24",0,0,0,0,0,0,0,0
"Kenya","2024-05-25",0,0,0,0,0,0,0,0
"Kenya","2024-05-26",0,0,0,0,0,0,0,0
"Kenya","2024-05-27",0,0,0,0,0,0,0,0
"Kenya","2024-05-28",0,0,0,0,0,0,0,0
"Kenya","2024-05-29",0,0,0,0,0,0,0,0
"Kenya","2024-05-30",0,0,0,0,0,0,0,0
"Kenya","2024-05-31",0,0,0,0,0,0,0,0
"Kenya","2024-06-01",0,0,0,0,0,0,0,0
"Kenya","2024-06-02",0,0,0,0,0,0,0,0
"Kenya","2024-06-03",0,0,0,0,0,0,0,0
"Kenya","2024-06-04",0,0,0,0,0,0,0,0
"Kenya","2024-06-05",0,0,0,0,0,0,0,0
"Kenya","2024-06-06",0,0,0,0,0,0,0,0
"Kenya","2024-06-07",0,0,0,0,0,0,0,0
"Kenya","2024-06-08",0,0,0,0,0,0,0,0
"Kenya","2024-06-09",0,0,0,0,0,0,0,0
"Kenya","2024-06-10",0,0,0,0,0,0,0,0
"Kenya","2024-06-11",0,0,0,0,0,0,0,0
"Kenya","2024-06-12",0,0,0,0,0,0,0,0
"Kenya","2024-06-13",0,0,0,0,0,0,0,0
"Kenya","2024-06-14",0,0,0,0,0,0,0,0
"Kenya","2024-06-15",0,0,0,0,0,0,0,0
"Kenya","2024-06-16",0,0,0,0,0,0,0,0
"Kenya","2024-06-17",0,0,0,0,0,0,0,0
"Kenya","2024-06-18",0,0,0,0,0,0,0,0
"Kenya","2024-06-19",0,0,0,0,0,0,0,0
"Kenya","2024-06-20",0,0,0,0,0,0,0,0
"Kenya","2024-06-21",0,0,0,0,0,0,0,0
"Kenya","2024-06-22",0,0,0,0,0,0,0,0
"Kenya","2024-06-23",0,0,0,0,0,0,0,0
"Kenya","2024-06-24",0,0,0,0,0,0,0,0
"Kenya","2024-06-25",0,0,0,0,0,0,0,0
"Kenya","2024-06-26",0,0,0,0,0,0,0,0
"Kenya","2024-06-27",0,0,0,0,0,0,0,0
"Kenya","2024-06-28",0,0,0,0,0,0,0,0
"Kenya","2024-06-29",0,0,0,0,0,0,0,0
"Kenya","2024-06-30",0,0,0,0,0,0,0,0
"Kenya","2024-07-01",0,0,0,0,0,0,0,0
"Kenya","2024-07-02",0,0,0,0,0,0,0,0
"Kenya","2024-07-03",0,0,0,0,0,0,0,0
"Kenya","2024-07-04",0,0,0,0,0,0,0,0
"Kenya","2024-07-05",0,0,0,0,0,0,0,0
"Kenya","2024-07-06",0,0,0,0,0,0,0,0
"Kenya","2024-07-07",0,0,0,0,0,0,0,0
"Kenya","2024-07-08",0,0,0,0,0,0,0,0
"Kenya","2024-07-09",0,0,0,0,0,0,0,0
"Kenya","2024-07-10",0,0,0,0,0,0,0,0
"Kenya","2024-07-11",0,0,0,0,0,0,0,0
"Kenya","2024-07-12",0,0,0,0,0,0,0,0
"Kenya","2024-07-13",0,0,0,0,0,0,0,0
"Kenya","2024-07-14",0,0,0,0,0,0,0,0
"Kenya","2024-07-15",0,0,0,0,0,0,0,0
"Kenya","2024-07-16",0,0,0,0,0,0,0,0
"Kenya","2024-07-17",0,0,0,0,0,0,0,0
"Kenya","2024-07-18",0,0,0,0,0,0,0,0
"Kenya","2024-07-19",0,0,0,0,0,0,0,0
"Kenya","2024-07-20",0,0,0,0,0,0,0,0
"Kenya","2024-07-21",0,0,0,0,0,0,0,0
"Kenya","2024-07-22",0,0,0,0,0,0,0,0
"Kenya","2024-07-23",0,0,0,0,0,0,0,0
"Kenya","2024-07-24",0,0,0,0,0,0,0,0
"Kenya","2024-07-25",0,0,0,0,0,0,0,0
"Kenya","2024-07-26",0,0,0,0,0,0,0,0
"Kenya","2024-07-27",0,0,0,0,0,0,0,0
"Kenya","2024-07-28",0,1,1,0,1,1,0,0
"Kenya","2024-07-29",0,0,1,0,0,1,0,0
"Kenya","2024-07-30",0,0,1,0,0,1,0,0
"Kenya","2024-07-31",0,0,1,0,0,1,0,0
"Kenya","2024-08-01",0,0,1,0,0,1,0,0
"Kenya","2024-08-02",0,0,1,0,0,1,0,0
"Kenya","2024-08-03",0,0,1,0,0,1,0,0
"Kenya","2024-08-04",0,0,1,0,0,1,0,0
"Kenya","2024-08-05",0,0,1,0,0,1,0,0
"Kenya","2024-08-06",0,0,1,0,0,1,0,0
"Kenya","2024-08-07",0,0,1,0,0,1,0,0
"Kenya","2024-08-08",0,0,1,0,0,1,0,0
"Kenya","2024-08-09",0,0,1,0,0,1,0,0
"Kenya","2024-08-10",0,0,1,0,0,1,0,0
"Kenya","2024-08-11",0,0,1,0,0,1,0,0
"Kenya","2024-08-12",0,0,1,0,1,2,0,0
"Kenya","2024-08-13",0,0,1,0,0,2,0,0
"Kenya","2024-08-14",0,0,1,0,0,2,0,0
"Kenya","2024-08-15",0,0,1,0,0,2,0,0
"Kenya","2024-08-16",0,0,1,0,0,2,0,0
"Kenya","2024-08-17",0,0,1,0,0,2,0,0
"Kenya","2024-08-18",0,0,1,0,0,2,0,0
"Kenya","2024-08-19",0,0,1,0,0,2,0,0
"Kenya","2024-08-20",0,0,1,0,0,2,0,0
"Kenya","2024-08-21",0,0,1,0,0,2,0,0
"Kenya","2024-08-22",0,0,1,0,0,2,0,0
"Kenya","2024-08-23",0,0,1,0,0,2,0,0
"Kenya","2024-08-24",0,0,1,0,0,2,0,0
"Kenya","2024-08-25",0,1,2,0,0,2,0,0
"Kenya","2024-08-26",0,0,2,0,0,2,0,0
"Kenya","2024-08-27",0,0,2,0,1,3,0,0
"Kenya","2024-08-28",0,0,2,0,0,3,0,0
"Kenya","2024-08-29",0,0,2,0,0,3,0,0
"Kenya","2024-08-30",0,0,2,0,0,3,0,0
"Kenya","2024-08-31",0,0,2,0,1,4,0,0
"Kenya","2024-09-01",0,2,4,0,0,4,0,0
"Kenya","2024-09-02",0,0,4,0,0,4,0,0
"Kenya","2024-09-03",0,0,4,0,0,4,0,0
"Kenya","2024-09-04",0,0,4,0,0,4,0,0
"Kenya","2024-09-05",0,0,4,0,1,5,0,0
"Kenya","2024-09-06",0,0,4,0,0,5,0,0
"Kenya","2024-09-07",0,0,4,0,0,5,0,0
"Kenya","2024-09-08",110,1,5,110,0,5,110,110
"Kenya","2024-09-09",0,0,5,110,0,5,4,114
"Kenya","2024-09-10",0,0,5,110,0,5,4,118
"Kenya","2024-09-11",0,0,5,110,0,5,4,122
"Kenya","2024-09-12",0,0,5,110,1,6,4,126
"Kenya","2024-09-13",0,0,5,110,0,6,5,131
"Kenya","2024-09-14",0,0,5,110,0,6,4,135
"Kenya","2024-09-15",0,0,5,110,0,6,4,139
"Kenya","2024-09-16",0,0,5,110,0,6,4,143
"Kenya","2024-09-17",0,0,5,110,0,6,4,147
"Kenya","2024-09-18",0,0,5,110,1,7,4,151
"Kenya","2024-09-19",0,0,5,110,0,7,4,155
"Kenya","2024-09-20",0,0,5,110,0,7,4,159
"Kenya","2024-09-21",0,0,5,110,0,7,5,164
"Kenya","2024-09-22",0,0,5,110,0,7,4,168
"Kenya","2024-09-23",0,0,5,110,0,7,4,172
"Kenya","2024-09-24",0,0,5,110,0,7,4,176
"Kenya","2024-09-25",0,0,5,110,1,8,4,180
"Kenya","2024-09-26",0,0,5,110,0,8,4,184
"Kenya","2024-09-27",0,0,5,110,0,8,4,188
"Kenya","2024-09-28",0,3,8,110,0,8,4,192
"Kenya","2024-09-29",0,0,8,110,0,8,4,196
"Kenya","2024-09-30",0,0,8,110,1,9,5,201
"Kenya","2024-10-01",0,0,8,110,1,10,4,205
"Kenya","2024-10-02",0,0,8,110,0,10,4,209
"Kenya","2024-10-03",0,0,8,110,0,10,4,213
"Kenya","2024-10-04",107,0,8,217,1,11,4,217
"Kenya","2024-10-05",0,0,8,217,1,12,1,218
"Kenya","2024-10-06",0,4,12,217,0,12,1,219
"Kenya","2024-10-07",0,0,12,217,0,12,0,219
"Kenya","2024-10-08",0,0,12,217,0,12,1,220
"Kenya","2024-10-09",0,0,12,217,0,12,1,221
"Kenya","2024-10-10",0,0,12,217,1,13,1,222
"Kenya","2024-10-11",0,0,12,217,0,13,1,223
"Kenya","2024-10-12",0,0,12,217,0,13,0,223
"Kenya","2024-10-13",0,1,13,217,0,13,1,224
"Kenya","2024-10-14",8,0,13,225,0,13,1,225
"Kenya","2024-10-15",0,0,13,225,0,13,1,226
"Kenya","2024-10-16",0,0,13,225,0,13,1,227
"Kenya","2024-10-17",0,0,13,225,1,14,0,227
"Kenya","2024-10-18",0,0,13,225,0,14,1,228
"Kenya","2024-10-19",0,0,13,225,0,14,1,229
"Kenya","2024-10-20",5,1,14,230,0,14,1,230
"Kenya","2024-10-21",0,0,14,230,0,14,0,230
"Kenya","2024-10-22",0,0,14,230,0,14,0,230
"Kenya","2024-10-23",0,0,14,230,0,14,0,230
"Kenya","2024-10-24",0,0,14,230,1,15,0,230
"Kenya","2024-10-25",0,0,14,230,0,15,0,230
"Kenya","2024-10-26",0,0,14,230,0,15,0,230
"Kenya","2024-10-27",0,0,14,230,0,15,0,230
"Kenya","2024-10-28",0,0,14,230,0,15,0,230
"Kenya","2024-10-29",0,0,14,230,0,15,0,230
"Kenya","2024-10-30",0,0,14,230,0,15,0,230
"Kenya","2024-10-31",0,0,14,230,1,16,0,230
"Kenya","2024-11-01",0,0,14,230,0,16,0,230
"Kenya","2024-11-02",0,0,14,230,0,16,0,230
"Kenya","2024-11-03",0,0,14,230,0,16,0,230
"Kenya","2024-11-04",0,0,14,230,0,16,0,230
"Kenya","2024-11-05",0,0,14,230,0,16,0,230
"Kenya","2024-11-06",0,0,14,230,0,16,0,230
"Kenya","2024-11-07",0,0,14,230,1,17,0,230
"Kenya","2024-11-08",0,0,14,230,0,17,0,230
"Kenya","2024-11-09",0,0,14,230,0,17,0,230
"Kenya","2024-11-10",0,3,17,230,0,17,0,230
"Kenya","2024-11-11",0,0,17,230,0,17,0,230
"Kenya","2024-11-12",0,0,17,230,0,17,0,230
"Kenya","2024-11-13",0,0,17,230,0,17,0,230
"Kenya","2024-11-14",0,0,17,230,1,18,0,230
"Kenya","2024-11-15",0,0,17,230,0,18,0,230
"Kenya","2024-11-16",0,0,17,230,0,18,0,230
"Kenya","2024-11-17",0,0,17,230,0,18,0,230
"Kenya","2024-11-18",0,0,17,230,0,18,0,230
"Kenya","2024-11-19",0,0,17,230,0,18,0,230
"Kenya","2024-11-20",0,0,17,230,0,18,0,230
"Kenya","2024-11-21",0,0,17,230,1,19,0,230
"Kenya","2024-11-22",0,0,17,230,0,19,0,230
"Kenya","2024-11-23",0,0,17,230,0,19,0,230
"Kenya","2024-11-24",0,2,19,230,0,19,0,230
"Kenya","2024-11-25",0,0,19,230,1,20,0,230
"Kenya","2024-11-26",0,0,19,230,0,20,0,230
"Kenya","2024-11-27",0,0,19,230,1,21,0,230
"Kenya","2024-11-28",0,0,19,230,0,21,0,230
"Kenya","2024-11-29",0,0,19,230,1,22,0,230
"Kenya","2024-11-30",0,0,19,230,0,22,0,230
"Kenya","2024-12-01",0,4,23,230,1,23,0,230
"Kenya","2024-12-02",0,0,23,230,1,24,0,230
"Kenya","2024-12-03",0,0,23,230,0,24,0,230
"Kenya","2024-12-04",0,0,23,230,1,25,0,230
"Kenya","2024-12-05",0,0,23,230,1,26,0,230
"Kenya","2024-12-06",0,0,23,230,1,27,0,230
"Kenya","2024-12-07",0,0,23,230,0,27,0,230
"Kenya","2024-12-08",0,5,28,230,1,28,0,230
"Kenya","2024-12-09",0,0,28,230,0,28,0,230
"Kenya","2024-12-10",0,0,28,230,0,28,0,230
"Kenya","2024-12-11",0,0,28,230,0,28,0,230
"Kenya","2024-12-12",0,0,28,230,1,29,0,230
"Kenya","2024-12-13",0,0,28,230,0,29,0,230
"Kenya","2024-12-14",0,0,28,230,0,29,0,230
"Kenya","2024-12-15",0,1,29,230,0,29,0,230
"Kenya","2024-12-16",0,0,29,230,0,29,0,230
"Kenya","2024-12-17",0,0,29,230,0,29,0,230
"Kenya","2024-12-18",0,0,29,230,0,29,0,230
"Kenya","2024-12-19",0,0,29,230,0,29,0,230
"Kenya","2024-12-20",0,0,29,230,0,29,0,230
"Kenya","2024-12-21",0,0,29,230,0,29,0,230
"Kenya","2024-12-22",0,0,29,230,0,29,0,230
"Kenya","2024-12-23",0,0,29,230,0,29,0,230
"Kenya","2024-12-24",0,0,29,230,0,29,0,230
"Kenya","2024-12-25",0,0,29,230,0,29,0,230
"Kenya","2024-12-26",0,0,29,230,0,29,0,230
"Kenya","2024-12-27",0,0,29,230,0,29,0,230
"Kenya","2024-12-28",0,0,29,230,0,29,0,230
"Kenya","2024-12-29",0,0,29,230,0,29,0,230
"Kenya","2024-12-30",0,0,29,230,0,29,0,230
"Kenya","2024-12-31",0,0,29,230,0,29,0,230
"Kenya","2025-01-01",0,0,29,230,0,29,0,230
"Kenya","2025-01-02",0,0,29,230,0,29,0,230
"Kenya","2025-01-03",0,0,29,230,0,29,0,230
"Kenya","2025-01-04",0,0,29,230,0,29,0,230
"Kenya","2025-01-05",0,0,29,230,0,29,0,230
"Kenya","2025-01-06",0,0,29,230,0,29,0,230
"Kenya","2025-01-07",0,0,29,230,0,29,0,230
"Kenya","2025-01-08",0,0,29,230,0,29,0,230
"Kenya","2025-01-09",0,0,29,230,0,29,0,230
"Kenya","2025-01-10",0,0,29,230,0,29,0,230
"Kenya","2025-01-11",0,0,29,230,0,29,0,230
"Kenya","2025-01-12",0,0,29,230,0,29,0,230
"Kenya","2025-01-13",0,0,29,230,0,29,0,230
"Latvia","2024-01-01",0,0,0,0,0,0,0,0
"Latvia","2024-01-02",0,0,0,0,0,0,0,0
"Latvia","2024-01-03",0,0,0,0,0,0,0,0
"Latvia","2024-01-04",0,0,0,0,0,0,0,0
"Latvia","2024-01-05",0,0,0,0,0,0,0,0
"Latvia","2024-01-06",0,0,0,0,0,0,0,0
"Latvia","2024-01-07",0,0,0,0,0,0,0,0
"Latvia","2024-01-08",0,0,0,0,0,0,0,0
"Latvia","2024-01-09",0,0,0,0,0,0,0,0
"Latvia","2024-01-10",0,0,0,0,0,0,0,0
"Latvia","2024-01-11",0,0,0,0,0,0,0,0
"Latvia","2024-01-12",0,0,0,0,0,0,0,0
"Latvia","2024-01-13",0,0,0,0,0,0,0,0
"Latvia","2024-01-14",0,0,0,0,0,0,0,0
"Latvia","2024-01-15",0,0,0,0,0,0,0,0
"Latvia","2024-01-16",0,0,0,0,0,0,0,0
"Latvia","2024-01-17",0,0,0,0,0,0,0,0
"Latvia","2024-01-18",0,0,0,0,0,0,0,0
"Latvia","2024-01-19",0,0,0,0,0,0,0,0
"Latvia","2024-01-20",0,0,0,0,0,0,0,0
"Latvia","2024-01-21",0,0,0,0,0,0,0,0
"Latvia","2024-01-22",0,0,0,0,0,0,0,0
"Latvia","2024-01-23",0,0,0,0,0,0,0,0
"Latvia","2024-01-24",0,0,0,0,0,0,0,0
"Latvia","2024-01-25",0,0,0,0,0,0,0,0
"Latvia","2024-01-26",0,0,0,0,0,0,0,0
"Latvia","2024-01-27",0,0,0,0,0,0,0,0
"Latvia","2024-01-28",0,0,0,0,0,0,0,0
"Latvia","2024-01-29",0,0,0,0,0,0,0,0
"Latvia","2024-01-30",0,0,0,0,0,0,0,0
"Latvia","2024-01-31",0,0,0,0,0,0,0,0
"Latvia","2024-02-01",0,0,0,0,0,0,0,0
"Latvia","2024-02-02",0,0,0,0,0,0,0,0
"Latvia","2024-02-03",0,0,0,0,0,0,0,0
"Latvia","2024-02-04",0,0,0,0,0,0,0,0
"Latvia","2024-02-05",0,0,0,0,0,0,0,0
"Latvia","2024-02-06",0,0,0,0,0,0,0,0
"Latvia","2024-02-07",0,0,0,0,0,0,0,0
"Latvia","2024-02-08",0,0,0,0,0,0,0,0
"Latvia","2024-02-09",0,0,0,0,0,0,0,0
"Latvia","2024-02-10",0,0,0,0,0,0,0,0
"Latvia","2024-02-11",0,0,0,0,0,0,0,0
"Latvia","2024-02-12",0,0,0,0,0,0,0,0
"Latvia","2024-02-13",0,0,0,0,0,0,0,0
"Latvia","2024-02-14",0,0,0,0,0,0,0,0
"Latvia","2024-02-15",0,0,0,0,0,0,0,0
"Latvia","2024-02-16",0,0,0,0,0,0,0,0
"Latvia","2024-02-17",0,0,0,0,0,0,0,0
"Latvia","2024-02-18",0,0,0,0,0,0,0,0
"Latvia","2024-02-19",0,0,0,0,0,0,0,0
"Latvia","2024-02-20",0,0,0,0,0,0,0,0
"Latvia","2024-02-21",0,0,0,0,0,0,0,0
"Latvia","2024-02-22",0,0,0,0,0,0,0,0
"Latvia","2024-02-23",0,0,0,0,0,0,0,0
"Latvia","2024-02-24",0,0,0,0,0,0,0,0
"Latvia","2024-02-25",0,0,0,0,0,0,0,0
"Latvia","2024-02-26",0,0,0,0,0,0,0,0
"Latvia","2024-02-27",0,0,0,0,0,0,0,0
"Latvia","2024-02-28",0,0,0,0,0,0,0,0
"Latvia","2024-02-29",0,0,0,0,0,0,0,0
"Latvia","2024-03-01",0,0,0,0,0,0,0,0
"Latvia","2024-03-02",0,0,0,0,0,0,0,0
"Latvia","2024-03-03",0,0,0,0,0,0,0,0
"Latvia","2024-03-04",0,0,0,0,0,0,0,0
"Latvia","2024-03-05",0,0,0,0,0,0,0,0
"Latvia","2024-03-06",0,0,0,0,0,0,0,0
"Latvia","2024-03-07",0,0,0,0,0,0,0,0
"Latvia","2024-03-08",0,0,0,0,0,0,0,0
"Latvia","2024-03-09",0,0,0,0,0,0,0,0
"Latvia","2024-03-10",0,0,0,0,0,0,0,0
"Latvia","2024-03-11",0,0,0,0,0,0,0,0
"Latvia","2024-03-12",0,0,0,0,0,0,0,0
"Latvia","2024-03-13",0,0,0,0,0,0,0,0
"Latvia","2024-03-14",0,0,0,0,0,0,0,0
"Latvia","2024-03-15",0,0,0,0,0,0,0,0
"Latvia","2024-03-16",0,0,0,0,0,0,0,0
"Latvia","2024-03-17",0,0,0,0,0,0,0,0
"Latvia","2024-03-18",0,0,0,0,0,0,0,0
"Latvia","2024-03-19",0,0,0,0,0,0,0,0
"Latvia","2024-03-20",0,0,0,0,0,0,0,0
"Latvia","2024-03-21",0,0,0,0,0,0,0,0
"Latvia","2024-03-22",0,0,0,0,0,0,0,0
"Latvia","2024-03-23",0,0,0,0,0,0,0,0
"Latvia","2024-03-24",0,0,0,0,0,0,0,0
"Latvia","2024-03-25",0,0,0,0,0,0,0,0
"Latvia","2024-03-26",0,0,0,0,0,0,0,0
"Latvia","2024-03-27",0,0,0,0,0,0,0,0
"Latvia","2024-03-28",0,0,0,0,0,0,0,0
"Latvia","2024-03-29",0,0,0,0,0,0,0,0
"Latvia","2024-03-30",0,0,0,0,0,0,0,0
"Latvia","2024-03-31",0,0,0,0,0,0,0,0
"Latvia","2024-04-01",0,0,0,0,0,0,0,0
"Latvia","2024-04-02",0,0,0,0,0,0,0,0
"Latvia","2024-04-03",0,0,0,0,0,0,0,0
"Latvia","2024-04-04",0,0,0,0,0,0,0,0
"Latvia","2024-04-05",0,0,0,0,0,0,0,0
"Latvia","2024-04-06",0,0,0,0,0,0,0,0
"Latvia","2024-04-07",0,0,0,0,0,0,0,0
"Latvia","2024-04-08",0,0,0,0,0,0,0,0
"Latvia","2024-04-09",0,0,0,0,0,0,0,0
"Latvia","2024-04-10",0,0,0,0,0,0,0,0
"Latvia","2024-04-11",0,0,0,0,0,0,0,0
"Latvia","2024-04-12",0,0,0,0,0,0,0,0
"Latvia","2024-04-13",0,0,0,0,0,0,0,0
"Latvia","2024-04-14",0,0,0,0,0,0,0,0
"Latvia","2024-04-15",0,0,0,0,0,0,0,0
"Latvia","2024-04-16",0,0,0,0,0,0,0,0
"Latvia","2024-04-17",0,0,0,0,0,0,0,0
"Latvia","2024-04-18",0,0,0,0,0,0,0,0
"Latvia","2024-04-19",0,0,0,0,0,0,0,0
"Latvia","2024-04-20",0,0,0,0,0,0,0,0
"Latvia","2024-04-21",0,0,0,0,0,0,0,0
"Latvia","2024-04-22",0,0,0,0,0,0,0,0
"Latvia","2024-04-23",0,0,0,0,0,0,0,0
"Latvia","2024-04-24",0,0,0,0,0,0,0,0
"Latvia","2024-04-25",0,0,0,0,0,0,0,0
"Latvia","2024-04-26",0,0,0,0,0,0,0,0
"Latvia","2024-04-27",0,0,0,0,0,0,0,0
"Latvia","2024-04-28",0,0,0,0,0,0,0,0
"Latvia","2024-04-29",0,0,0,0,0,0,0,0
"Latvia","2024-04-30",0,0,0,0,0,0,0,0
"Latvia","2024-05-01",0,0,0,0,0,0,0,0
"Latvia","2024-05-02",0,0,0,0,0,0,0,0
"Latvia","2024-05-03",0,0,0,0,0,0,0,0
"Latvia","2024-05-04",0,0,0,0,0,0,0,0
"Latvia","2024-05-05",0,0,0,0,0,0,0,0
"Latvia","2024-05-06",0,0,0,0,0,0,0,0
"Latvia","2024-05-07",0,0,0,0,0,0,0,0
"Latvia","2024-05-08",0,0,0,0,0,0,0,0
"Latvia","2024-05-09",0,0,0,0,0,0,0,0
"Latvia","2024-05-10",0,0,0,0,0,0,0,0
"Latvia","2024-05-11",0,0,0,0,0,0,0,0
"Latvia","2024-05-12",0,0,0,0,0,0,0,0
"Latvia","2024-05-13",0,0,0,0,0,0,0,0
"Latvia","2024-05-14",0,0,0,0,0,0,0,0
"Latvia","2024-05-15",0,0,0,0,0,0,0,0
"Latvia","2024-05-16",0,0,0,0,0,0,0,0
"Latvia","2024-05-17",0,0,0,0,0,0,0,0
"Latvia","2024-05-18",0,0,0,0,0,0,0,0
"Latvia","2024-05-19",0,0,0,0,0,0,0,0
"Latvia","2024-05-20",0,0,0,0,0,0,0,0
"Latvia","2024-05-21",0,0,0,0,0,0,0,0
"Latvia","2024-05-22",0,0,0,0,0,0,0,0
"Latvia","2024-05-23",0,0,0,0,0,0,0,0
"Latvia","2024-05-24",0,0,0,0,0,0,0,0
"Latvia","2024-05-25",0,0,0,0,0,0,0,0
"Latvia","2024-05-26",0,0,0,0,0,0,0,0
"Latvia","2024-05-27",0,0,0,0,0,0,0,0
"Latvia","2024-05-28",0,0,0,0,0,0,0,0
"Latvia","2024-05-29",0,0,0,0,0,0,0,0
"Latvia","2024-05-30",0,0,0,0,0,0,0,0
"Latvia","2024-05-31",0,0,0,0,0,0,0,0
"Latvia","2024-06-01",0,0,0,0,0,0,0,0
"Latvia","2024-06-02",0,0,0,0,0,0,0,0
"Latvia","2024-06-03",0,0,0,0,0,0,0,0
"Latvia","2024-06-04",0,0,0,0,0,0,0,0
"Latvia","2024-06-05",0,0,0,0,0,0,0,0
"Latvia","2024-06-06",0,0,0,0,0,0,0,0
"Latvia","2024-06-07",0,0,0,0,0,0,0,0
"Latvia","2024-06-08",0,0,0,0,0,0,0,0
"Latvia","2024-06-09",0,0,0,0,0,0,0,0
"Latvia","2024-06-10",0,0,0,0,0,0,0,0
"Latvia","2024-06-11",0,0,0,0,0,0,0,0
"Latvia","2024-06-12",0,0,0,0,0,0,0,0
"Latvia","2024-06-13",0,0,0,0,0,0,0,0
"Latvia","2024-06-14",0,0,0,0,0,0,0,0
"Latvia","2024-06-15",0,0,0,0,0,0,0,0
"Latvia","2024-06-16",0,0,0,0,0,0,0,0
"Latvia","2024-06-17",0,0,0,0,0,0,0,0
"Latvia","2024-06-18",0,0,0,0,0,0,0,0
"Latvia","2024-06-19",0,0,0,0,0,0,0,0
"Latvia","2024-06-20",0,0,0,0,0,0,0,0
"Latvia","2024-06-21",0,0,0,0,0,0,0,0
"Latvia","2024-06-22",0,0,0,0,0,0,0,0
"Latvia","2024-06-23",0,0,0,0,0,0,0,0
"Latvia","2024-06-24",0,0,0,0,0,0,0,0
"Latvia","2024-06-25",0,0,0,0,0,0,0,0
"Latvia","2024-06-26",0,0,0,0,0,0,0,0
"Latvia","2024-06-27",0,0,0,0,0,0,0,0
"Latvia","2024-06-28",0,0,0,0,0,0,0,0
"Latvia","2024-06-29",0,0,0,0,0,0,0,0
"Latvia","2024-06-30",0,0,0,0,0,0,0,0
"Latvia","2024-07-01",0,0,0,0,0,0,0,0
"Latvia","2024-07-02",0,0,0,0,0,0,0,0
"Latvia","2024-07-03",0,0,0,0,0,0,0,0
"Latvia","2024-07-04",0,0,0,0,0,0,0,0
"Latvia","2024-07-05",0,0,0,0,0,0,0,0
"Latvia","2024-07-06",0,0,0,0,0,0,0,0
"Latvia","2024-07-07",0,0,0,0,0,0,0,0
"Latvia","2024-07-08",0,0,0,0,0,0,0,0
"Latvia","2024-07-09",0,0,0,0,0,0,0,0
"Latvia","2024-07-10",0,0,0,0,0,0,0,0
"Latvia","2024-07-11",0,0,0,0,0,0,0,0
"Latvia","2024-07-12",0,0,0,0,0,0,0,0
"Latvia","2024-07-13",0,0,0,0,0,0,0,0
"Latvia","2024-07-14",0,0,0,0,0,0,0,0
"Latvia","2024-07-15",0,0,0,0,0,0,0,0
"Latvia","2024-07-16",0,0,0,0,0,0,0,0
"Latvia","2024-07-17",0,0,0,0,0,0,0,0
"Latvia","2024-07-18",0,0,0,0,0,0,0,0
"Latvia","2024-07-19",0,0,0,0,0,0,0,0
"Latvia","2024-07-20",0,0,0,0,0,0,0,0
"Latvia","2024-07-21",0,0,0,0,0,0,0,0
"Latvia","2024-07-22",0,0,0,0,0,0,0,0
"Latvia","2024-07-23",0,0,0,0,0,0,0,0
"Latvia","2024-07-24",0,0,0,0,0,0,0,0
"Latvia","2024-07-25",0,0,0,0,0,0,0,0
"Latvia","2024-07-26",0,0,0,0,0,0,0,0
"Latvia","2024-07-27",0,0,0,0,0,0,0,0
"Latvia","2024-07-28",0,0,0,0,0,0,0,0
"Latvia","2024-07-29",0,0,0,0,0,0,0,0
"Latvia","2024-07-30",0,0,0,0,0,0,0,0
"Latvia","2024-07-31",0,0,0,0,0,0,0,0
"Latvia","2024-08-01",0,0,0,0,0,0,0,0
"Latvia","2024-08-02",0,0,0,0,0,0,0,0
"Latvia","2024-08-03",0,0,0,0,0,0,0,0
"Latvia","2024-08-04",0,0,0,0,0,0,0,0
"Latvia","2024-08-05",0,0,0,0,0,0,0,0
"Latvia","2024-08-06",0,0,0,0,0,0,0,0
"Latvia","2024-08-07",0,0,0,0,0,0,0,0
"Latvia","2024-08-08",0,0,0,0,0,0,0,0
"Latvia","2024-08-09",0,0,0,0,0,0,0,0
"Latvia","2024-08-10",0,0,0,0,0,0,0,0
"Latvia","2024-08-11",0,0,0,0,0,0,0,0
"Latvia","2024-08-12",0,0,0,0,0,0,0,0
"Latvia","2024-08-13",0,0,0,0,0,0,0,0
"Latvia","2024-08-14",0,0,0,0,0,0,0,0
"Latvia","2024-08-15",0,0,0,0,0,0,0,0
"Latvia","2024-08-16",0,0,0,0,0,0,0,0
"Latvia","2024-08-17",0,0,0,0,0,0,0,0
"Latvia","2024-08-18",0,0,0,0,0,0,0,0
"Latvia","2024-08-19",0,0,0,0,0,0,0,0
"Latvia","2024-08-20",0,0,0,0,0,0,0,0
"Latvia","2024-08-21",0,0,0,0,0,0,0,0
"Latvia","2024-08-22",0,0,0,0,0,0,0,0
"Latvia","2024-08-23",0,0,0,0,0,0,0,0
"Latvia","2024-08-24",0,0,0,0,0,0,0,0
"Latvia","2024-08-25",0,0,0,0,0,0,0,0
"Latvia","2024-08-26",0,0,0,0,0,0,0,0
"Latvia","2024-08-27",0,0,0,0,0,0,0,0
"Latvia","2024-08-28",0,0,0,0,0,0,0,0
"Latvia","2024-08-29",0,0,0,0,0,0,0,0
"Latvia","2024-08-30",0,0,0,0,0,0,0,0
"Latvia","2024-08-31",0,0,0,0,0,0,0,0
"Latvia","2024-09-01",0,0,0,0,0,0,0,0
"Latvia","2024-09-02",0,0,0,0,0,0,0,0
"Latvia","2024-09-03",0,0,0,0,0,0,0,0
"Latvia","2024-09-04",0,0,0,0,0,0,0,0
"Latvia","2024-09-05",0,0,0,0,0,0,0,0
"Latvia","2024-09-06",0,0,0,0,0,0,0,0
"Latvia","2024-09-07",0,0,0,0,0,0,0,0
"Latvia","2024-09-08",0,0,0,0,0,0,0,0
"Latvia","2024-09-09",0,0,0,0,0,0,0,0
"Latvia","2024-09-10",0,0,0,0,0,0,0,0
"Latvia","2024-09-11",0,0,0,0,0,0,0,0
"Latvia","2024-09-12",0,0,0,0,0,0,0,0
"Latvia","2024-09-13",0,0,0,0,0,0,0,0
"Latvia","2024-09-14",0,0,0,0,0,0,0,0
"Latvia","2024-09-15",0,0,0,0,0,0,0,0
"Latvia","2024-09-16",0,0,0,0,0,0,0,0
"Latvia","2024-09-17",0,0,0,0,0,0,0,0
"Latvia","2024-09-18",0,0,0,0,0,0,0,0
"Latvia","2024-09-19",0,0,0,0,0,0,0,0
"Latvia","2024-09-20",0,0,0,0,0,0,0,0
"Latvia","2024-09-21",0,0,0,0,0,0,0,0
"Latvia","2024-09-22",0,0,0,0,0,0,0,0
"Latvia","2024-09-23",0,0,0,0,0,0,0,0
"Latvia","2024-09-24",0,0,0,0,0,0,0,0
"Latvia","2024-09-25",0,0,0,0,0,0,0,0
"Latvia","2024-09-26",0,0,0,0,0,0,0,0
"Latvia","2024-09-27",0,0,0,0,0,0,0,0
"Latvia","2024-09-28",0,0,0,0,0,0,0,0
"Latvia","2024-09-29",0,0,0,0,0,0,0,0
"Latvia","2024-09-30",0,0,0,0,0,0,0,0
"Latvia","2024-10-01",0,0,0,0,0,0,0,0
"Latvia","2024-10-02",0,0,0,0,0,0,0,0
"Latvia","2024-10-03",0,0,0,0,0,0,0,0
"Latvia","2024-10-04",0,0,0,0,0,0,0,0
"Latvia","2024-10-05",0,0,0,0,0,0,0,0
"Latvia","2024-10-06",0,0,0,0,0,0,0,0
"Latvia","2024-10-07",0,0,0,0,0,0,0,0
"Latvia","2024-10-08",0,0,0,0,0,0,0,0
"Latvia","2024-10-09",0,0,0,0,0,0,0,0
"Latvia","2024-10-10",0,0,0,0,0,0,0,0
"Latvia","2024-10-11",0,0,0,0,0,0,0,0
"Latvia","2024-10-12",0,0,0,0,0,0,0,0
"Latvia","2024-10-13",0,0,0,0,0,0,0,0
"Latvia","2024-10-14",0,0,0,0,0,0,0,0
"Latvia","2024-10-15",0,0,0,0,0,0,0,0
"Latvia","2024-10-16",0,0,0,0,0,0,0,0
"Latvia","2024-10-17",0,0,0,0,0,0,0,0
"Latvia","2024-10-18",0,0,0,0,0,0,0,0
"Latvia","2024-10-19",0,0,0,0,0,0,0,0
"Latvia","2024-10-20",0,0,0,0,0,0,0,0
"Latvia","2024-10-21",0,0,0,0,0,0,0,0
"Latvia","2024-10-22",0,0,0,0,0,0,0,0
"Latvia","2024-10-23",0,0,0,0,0,0,0,0
"Latvia","2024-10-24",0,0,0,0,0,0,0,0
"Latvia","2024-10-25",0,0,0,0,0,0,0,0
"Latvia","2024-10-26",0,0,0,0,0,0,0,0
"Latvia","2024-10-27",0,0,0,0,0,0,0,0
"Latvia","2024-10-28",0,0,0,0,0,0,0,0
"Latvia","2024-10-29",0,0,0,0,0,0,0,0
"Latvia","2024-10-30",0,0,0,0,0,0,0,0
"Latvia","2024-10-31",0,0,0,0,0,0,0,0
"Latvia","2024-11-01",0,0,0,0,0,0,0,0
"Latvia","2024-11-02",0,0,0,0,0,0,0,0
"Latvia","2024-11-03",0,0,0,0,0,0,0,0
"Latvia","2024-11-04",0,0,0,0,0,0,0,0
"Latvia","2024-11-05",0,0,0,0,0,0,0,0
"Latvia","2024-11-06",0,0,0,0,0,0,0,0
"Latvia","2024-11-07",0,0,0,0,0,0,0,0
"Latvia","2024-11-08",0,0,0,0,0,0,0,0
"Latvia","2024-11-09",0,0,0,0,0,0,0,0
"Latvia","2024-11-10",0,0,0,0,0,0,0,0
"Latvia","2024-11-11",0,0,0,0,0,0,0,0
"Latvia","2024-11-12",0,0,0,0,0,0,0,0
"Latvia","2024-11-13",0,0,0,0,0,0,0,0
"Latvia","2024-11-14",0,0,0,0,0,0,0,0
"Latvia","2024-11-15",0,0,0,0,0,0,0,0
"Latvia","2024-11-16",0,0,0,0,0,0,0,0
"Latvia","2024-11-17",0,0,0,0,0,0,0,0
"Latvia","2024-11-18",0,0,0,0,0,0,0,0
"Latvia","2024-11-19",0,0,0,0,0,0,0,0
"Latvia","2024-11-20",0,0,0,0,0,0,0,0
"Latvia","2024-11-21",0,0,0,0,0,0,0,0
"Latvia","2024-11-22",0,0,0,0,0,0,0,0
"Latvia","2024-11-23",0,0,0,0,0,0,0,0
"Latvia","2024-11-24",0,0,0,0,0,0,0,0
"Latvia","2024-11-25",0,0,0,0,0,0,0,0
"Latvia","2024-11-26",0,0,0,0,0,0,0,0
"Latvia","2024-11-27",0,0,0,0,0,0,0,0
"Latvia","2024-11-28",0,0,0,0,0,0,0,0
"Latvia","2024-11-29",0,0,0,0,0,0,0,0
"Latvia","2024-11-30",0,0,0,0,0,0,0,0
"Latvia","2024-12-01",0,0,0,0,0,0,0,0
"Latvia","2024-12-02",0,0,0,0,0,0,0,0
"Latvia","2024-12-03",0,0,0,0,0,0,0,0
"Latvia","2024-12-04",0,0,0,0,0,0,0,0
"Latvia","2024-12-05",0,0,0,0,0,0,0,0
"Latvia","2024-12-06",0,0,0,0,0,0,0,0
"Latvia","2024-12-07",0,0,0,0,0,0,0,0
"Latvia","2024-12-08",0,0,0,0,0,0,0,0
"Latvia","2024-12-09",0,0,0,0,0,0,0,0
"Latvia","2024-12-10",0,0,0,0,0,0,0,0
"Latvia","2024-12-11",0,0,0,0,0,0,0,0
"Latvia","2024-12-12",0,0,0,0,0,0,0,0
"Latvia","2024-12-13",0,0,0,0,0,0,0,0
"Latvia","2024-12-14",0,0,0,0,0,0,0,0
"Latvia","2024-12-15",0,0,0,0,0,0,0,0
"Latvia","2024-12-16",0,0,0,0,0,0,0,0
"Latvia","2024-12-17",0,0,0,0,0,0,0,0
"Latvia","2024-12-18",0,0,0,0,0,0,0,0
"Latvia","2024-12-19",0,0,0,0,0,0,0,0
"Latvia","2024-12-20",0,0,0,0,0,0,0,0
"Latvia","2024-12-21",0,0,0,0,0,0,0,0
"Latvia","2024-12-22",0,0,0,0,0,0,0,0
"Latvia","2024-12-23",0,0,0,0,0,0,0,0
"Latvia","2024-12-24",0,0,0,0,0,0,0,0
"Latvia","2024-12-25",0,0,0,0,0,0,0,0
"Latvia","2024-12-26",0,0,0,0,0,0,0,0
"Latvia","2024-12-27",0,0,0,0,0,0,0,0
"Latvia","2024-12-28",0,0,0,0,0,0,0,0
"Latvia","2024-12-29",0,0,0,0,0,0,0,0
"Latvia","2024-12-30",0,0,0,0,0,0,0,0
"Latvia","2024-12-31",0,0,0,0,0,0,0,0
"Latvia","2025-01-01",0,0,0,0,0,0,0,0
"Latvia","2025-01-02",0,0,0,0,0,0,0,0
"Latvia","2025-01-03",0,0,0,0,0,0,0,0
"Latvia","2025-01-04",0,0,0,0,0,0,0,0
"Latvia","2025-01-05",0,0,0,0,0,0,0,0
"Latvia","2025-01-06",0,0,0,0,0,0,0,0
"Latvia","2025-01-07",0,0,0,0,0,0,0,0
"Latvia","2025-01-08",0,0,0,0,0,0,0,0
"Latvia","2025-01-09",0,0,0,0,0,0,0,0
"Latvia","2025-01-10",0,0,0,0,0,0,0,0
"Latvia","2025-01-11",0,0,0,0,0,0,0,0
"Latvia","2025-01-12",0,0,0,0,0,0,0,0
"Latvia","2025-01-13",0,0,0,0,0,0,0,0
"Lebanon","2024-01-01",0,0,0,0,0,0,0,0
"Lebanon","2024-01-02",0,0,0,0,0,0,0,0
"Lebanon","2024-01-03",0,0,0,0,0,0,0,0
"Lebanon","2024-01-04",0,0,0,0,0,0,0,0
"Lebanon","2024-01-05",0,0,0,0,0,0,0,0
"Lebanon","2024-01-06",0,0,0,0,0,0,0,0
"Lebanon","2024-01-07",0,0,0,0,0,0,0,0
"Lebanon","2024-01-08",0,0,0,0,0,0,0,0
"Lebanon","2024-01-09",0,0,0,0,0,0,0,0
"Lebanon","2024-01-10",0,0,0,0,0,0,0,0
"Lebanon","2024-01-11",0,0,0,0,0,0,0,0
"Lebanon","2024-01-12",0,0,0,0,0,0,0,0
"Lebanon","2024-01-13",0,0,0,0,0,0,0,0
"Lebanon","2024-01-14",0,0,0,0,0,0,0,0
"Lebanon","2024-01-15",0,0,0,0,0,0,0,0
"Lebanon","2024-01-16",0,0,0,0,0,0,0,0
"Lebanon","2024-01-17",0,0,0,0,0,0,0,0
"Lebanon","2024-01-18",0,0,0,0,0,0,0,0
"Lebanon","2024-01-19",0,0,0,0,0,0,0,0
"Lebanon","2024-01-20",0,0,0,0,0,0,0,0
"Lebanon","2024-01-21",0,0,0,0,0,0,0,0
"Lebanon","2024-01-22",0,0,0,0,0,0,0,0
"Lebanon","2024-01-23",0,0,0,0,0,0,0,0
"Lebanon","2024-01-24",0,0,0,0,0,0,0,0
"Lebanon","2024-01-25",0,0,0,0,0,0,0,0
"Lebanon","2024-01-26",0,0,0,0,0,0,0,0
"Lebanon","2024-01-27",0,0,0,0,0,0,0,0
"Lebanon","2024-01-28",0,0,0,0,0,0,0,0
"Lebanon","2024-01-29",0,0,0,0,0,0,0,0
"Lebanon","2024-01-30",0,0,0,0,0,0,0,0
"Lebanon","2024-01-31",0,0,0,0,0,0,0,0
"Lebanon","2024-02-01",0,0,0,0,0,0,0,0
"Lebanon","2024-02-02",0,0,0,0,0,0,0,0
"Lebanon","2024-02-03",0,0,0,0,0,0,0,0
"Lebanon","2024-02-04",0,0,0,0,0,0,0,0
"Lebanon","2024-02-05",0,0,0,0,0,0,0,0
"Lebanon","2024-02-06",0,0,0,0,0,0,0,0
"Lebanon","2024-02-07",0,0,0,0,0,0,0,0
"Lebanon","2024-02-08",0,0,0,0,0,0,0,0
"Lebanon","2024-02-09",0,0,0,0,0,0,0,0
"Lebanon","2024-02-10",0,0,0,0,0,0,0,0
"Lebanon","2024-02-11",0,0,0,0,0,0,0,0
"Lebanon","2024-02-12",0,0,0,0,0,0,0,0
"Lebanon","2024-02-13",0,0,0,0,0,0,0,0
"Lebanon","2024-02-14",0,0,0,0,0,0,0,0
"Lebanon","2024-02-15",0,0,0,0,0,0,0,0
"Lebanon","2024-02-16",0,0,0,0,0,0,0,0
"Lebanon","2024-02-17",0,0,0,0,0,0,0,0
"Lebanon","2024-02-18",0,0,0,0,0,0,0,0
"Lebanon","2024-02-19",0,0,0,0,0,0,0,0
"Lebanon","2024-02-20",0,0,0,0,0,0,0,0
"Lebanon","2024-02-21",0,0,0,0,0,0,0,0
"Lebanon","2024-02-22",0,0,0,0,0,0,0,0
"Lebanon","2024-02-23",0,0,0,0,0,0,0,0
"Lebanon","2024-02-24",0,0,0,0,0,0,0,0
"Lebanon","2024-02-25",0,0,0,0,0,0,0,0
"Lebanon","2024-02-26",0,0,0,0,0,0,0,0
"Lebanon","2024-02-27",0,0,0,0,0,0,0,0
"Lebanon","2024-02-28",0,0,0,0,0,0,0,0
"Lebanon","2024-02-29",0,0,0,0,0,0,0,0
"Lebanon","2024-03-01",0,0,0,0,0,0,0,0
"Lebanon","2024-03-02",0,0,0,0,0,0,0,0
"Lebanon","2024-03-03",0,0,0,0,0,0,0,0
"Lebanon","2024-03-04",0,0,0,0,0,0,0,0
"Lebanon","2024-03-05",0,0,0,0,0,0,0,0
"Lebanon","2024-03-06",0,0,0,0,0,0,0,0
"Lebanon","2024-03-07",0,0,0,0,0,0,0,0
"Lebanon","2024-03-08",0,0,0,0,0,0,0,0
"Lebanon","2024-03-09",0,0,0,0,0,0,0,0
"Lebanon","2024-03-10",0,0,0,0,0,0,0,0
"Lebanon","2024-03-11",0,0,0,0,0,0,0,0
"Lebanon","2024-03-12",0,0,0,0,0,0,0,0
"Lebanon","2024-03-13",0,0,0,0,0,0,0,0
"Lebanon","2024-03-14",0,1,1,0,1,1,0,0
"Lebanon","2024-03-15",0,0,1,0,0,1,0,0
"Lebanon","2024-03-16",0,0,1,0,0,1,0,0
"Lebanon","2024-03-17",0,0,1,0,0,1,0,0
"Lebanon","2024-03-18",0,0,1,0,0,1,0,0
"Lebanon","2024-03-19",0,0,1,0,0,1,0,0
"Lebanon","2024-03-20",0,0,1,0,0,1,0,0
"Lebanon","2024-03-21",0,0,1,0,0,1,0,0
"Lebanon","2024-03-22",0,0,1,0,0,1,0,0
"Lebanon","2024-03-23",0,0,1,0,0,1,0,0
"Lebanon","2024-03-24",0,0,1,0,0,1,0,0
"Lebanon","2024-03-25",0,0,1,0,0,1,0,0
"Lebanon","2024-03-26",0,0,1,0,0,1,0,0
"Lebanon","2024-03-27",0,0,1,0,0,1,0,0
"Lebanon","2024-03-28",0,0,1,0,0,1,0,0
"Lebanon","2024-03-29",0,0,1,0,0,1,0,0
"Lebanon","2024-03-30",0,0,1,0,0,1,0,0
"Lebanon","2024-03-31",0,0,1,0,0,1,0,0
"Lebanon","2024-04-01",0,0,1,0,0,1,0,0
"Lebanon","2024-04-02",0,0,1,0,0,1,0,0
"Lebanon","2024-04-03",0,0,1,0,0,1,0,0
"Lebanon","2024-04-04",0,0,1,0,0,1,0,0
"Lebanon","2024-04-05",0,0,1,0,0,1,0,0
"Lebanon","2024-04-06",0,0,1,0,0,1,0,0
"Lebanon","2024-04-07",0,0,1,0,0,1,0,0
"Lebanon","2024-04-08",0,0,1,0,0,1,0,0
"Lebanon","2024-04-09",0,0,1,0,0,1,0,0
"Lebanon","2024-04-10",0,0,1,0,0,1,0,0
"Lebanon","2024-04-11",0,0,1,0,0,1,0,0
"Lebanon","2024-04-12",0,0,1,0,0,1,0,0
"Lebanon","2024-04-13",0,0,1,0,0,1,0,0
"Lebanon","2024-04-14",0,0,1,0,0,1,0,0
"Lebanon","2024-04-15",0,0,1,0,0,1,0,0
"Lebanon","2024-04-16",0,0,1,0,0,1,0,0
"Lebanon","2024-04-17",0,0,1,0,0,1,0,0
"Lebanon","2024-04-18",0,0,1,0,0,1,0,0
"Lebanon","2024-04-19",0,0,1,0,0,1,0,0
"Lebanon","2024-04-20",0,0,1,0,0,1,0,0
"Lebanon","2024-04-21",0,0,1,0,0,1,0,0
"Lebanon","2024-04-22",0,0,1,0,0,1,0,0
"Lebanon","2024-04-23",0,0,1,0,0,1,0,0
"Lebanon","2024-04-24",0,0,1,0,0,1,0,0
"Lebanon","2024-04-25",0,0,1,0,0,1,0,0
"Lebanon","2024-04-26",0,0,1,0,0,1,0,0
"Lebanon","2024-04-27",0,0,1,0,0,1,0,0
"Lebanon","2024-04-28",0,0,1,0,0,1,0,0
"Lebanon","2024-04-29",0,0,1,0,0,1,0,0
"Lebanon","2024-04-30",0,0,1,0,0,1,0,0
"Lebanon","2024-05-01",0,0,1,0,0,1,0,0
"Lebanon","2024-05-02",0,0,1,0,0,1,0,0
"Lebanon","2024-05-03",0,0,1,0,0,1,0,0
"Lebanon","2024-05-04",0,0,1,0,0,1,0,0
"Lebanon","2024-05-05",0,0,1,0,0,1,0,0
"Lebanon","2024-05-06",0,0,1,0,0,1,0,0
"Lebanon","2024-05-07",0,0,1,0,0,1,0,0
"Lebanon","2024-05-08",0,0,1,0,0,1,0,0
"Lebanon","2024-05-09",0,0,1,0,0,1,0,0
"Lebanon","2024-05-10",0,0,1,0,0,1,0,0
"Lebanon","2024-05-11",0,0,1,0,0,1,0,0
"Lebanon","2024-05-12",0,0,1,0,0,1,0,0
"Lebanon","2024-05-13",0,0,1,0,0,1,0,0
"Lebanon","2024-05-14",0,0,1,0,0,1,0,0
"Lebanon","2024-05-15",0,0,1,0,0,1,0,0
"Lebanon","2024-05-16",0,0,1,0,0,1,0,0
"Lebanon","2024-05-17",0,0,1,0,0,1,0,0
"Lebanon","2024-05-18",0,0,1,0,0,1,0,0
"Lebanon","2024-05-19",0,0,1,0,0,1,0,0
"Lebanon","2024-05-20",0,0,1,0,0,1,0,0
"Lebanon","2024-05-21",0,0,1,0,0,1,0,0
"Lebanon","2024-05-22",0,0,1,0,0,1,0,0
"Lebanon","2024-05-23",0,0,1,0,0,1,0,0
"Lebanon","2024-05-24",0,0,1,0,0,1,0,0
"Lebanon","2024-05-25",0,0,1,0,0,1,0,0
"Lebanon","2024-05-26",0,0,1,0,0,1,0,0
"Lebanon","2024-05-27",0,0,1,0,0,1,0,0
"Lebanon","2024-05-28",0,0,1,0,0,1,0,0
"Lebanon","2024-05-29",0,0,1,0,0,1,0,0
"Lebanon","2024-05-30",0,0,1,0,0,1,0,0
"Lebanon","2024-05-31",0,0,1,0,0,1,0,0
"Lebanon","2024-06-01",0,0,1,0,0,1,0,0
"Lebanon","2024-06-02",0,0,1,0,0,1,0,0
"Lebanon","2024-06-03",0,0,1,0,0,1,0,0
"Lebanon","2024-06-04",0,0,1,0,0,1,0,0
"Lebanon","2024-06-05",0,0,1,0,0,1,0,0
"Lebanon","2024-06-06",0,0,1,0,0,1,0,0
"Lebanon","2024-06-07",0,0,1,0,0,1,0,0
"Lebanon","2024-06-08",0,0,1,0,0,1,0,0
"Lebanon","2024-06-09",0,0,1,0,0,1,0,0
"Lebanon","2024-06-10",0,0,1,0,0,1,0,0
"Lebanon","2024-06-11",0,0,1,0,0,1,0,0
"Lebanon","2024-06-12",0,0,1,0,0,1,0,0
"Lebanon","2024-06-13",0,0,1,0,0,1,0,0
"Lebanon","2024-06-14",0,0,1,0,0,1,0,0
"Lebanon","2024-06-15",0,0,1,0,0,1,0,0
"Lebanon","2024-06-16",0,0,1,0,0,1,0,0
"Lebanon","2024-06-17",0,0,1,0,0,1,0,0
"Lebanon","2024-06-18",0,0,1,0,0,1,0,0
"Lebanon","2024-06-19",0,0,1,0,0,1,0,0
"Lebanon","2024-06-20",0,0,1,0,0,1,0,0
"Lebanon","2024-06-21",0,0,1,0,0,1,0,0
"Lebanon","2024-06-22",0,0,1,0,0,1,0,0
"Lebanon","2024-06-23",0,0,1,0,0,1,0,0
"Lebanon","2024-06-24",0,0,1,0,0,1,0,0
"Lebanon","2024-06-25",0,0,1,0,0,1,0,0
"Lebanon","2024-06-26",0,0,1,0,0,1,0,0
"Lebanon","2024-06-27",0,0,1,0,0,1,0,0
"Lebanon","2024-06-28",0,0,1,0,0,1,0,0
"Lebanon","2024-06-29",0,0,1,0,0,1,0,0
"Lebanon","2024-06-30",0,0,1,0,0,1,0,0
"Lebanon","2024-07-01",0,0,1,0,0,1,0,0
"Lebanon","2024-07-02",0,0,1,0,0,1,0,0
"Lebanon","2024-07-03",0,0,1,0,0,1,0,0
"Lebanon","2024-07-04",0,0,1,0,0,1,0,0
"Lebanon","2024-07-05",0,0,1,0,0,1,0,0
"Lebanon","2024-07-06",0,0,1,0,0,1,0,0
"Lebanon","2024-07-07",0,0,1,0,0,1,0,0
"Lebanon","2024-07-08",0,0,1,0,0,1,0,0
"Lebanon","2024-07-09",0,0,1,0,0,1,0,0
"Lebanon","2024-07-10",0,0,1,0,0,1,0,0
"Lebanon","2024-07-11",0,0,1,0,0,1,0,0
"Lebanon","2024-07-12",0,0,1,0,0,1,0,0
"Lebanon","2024-07-13",0,0,1,0,0,1,0,0
"Lebanon","2024-07-14",0,0,1,0,0,1,0,0
"Lebanon","2024-07-15",0,0,1,0,0,1,0,0
"Lebanon","2024-07-16",0,0,1,0,0,1,0,0
"Lebanon","2024-07-17",0,0,1,0,0,1,0,0
"Lebanon","2024-07-18",0,0,1,0,0,1,0,0
"Lebanon","2024-07-19",0,0,1,0,0,1,0,0
"Lebanon","2024-07-20",0,0,1,0,0,1,0,0
"Lebanon","2024-07-21",0,0,1,0,0,1,0,0
"Lebanon","2024-07-22",0,0,1,0,0,1,0,0
"Lebanon","2024-07-23",0,0,1,0,0,1,0,0
"Lebanon","2024-07-24",0,0,1,0,0,1,0,0
"Lebanon","2024-07-25",0,0,1,0,0,1,0,0
"Lebanon","2024-07-26",0,0,1,0,0,1,0,0
"Lebanon","2024-07-27",0,0,1,0,0,1,0,0
"Lebanon","2024-07-28",0,0,1,0,0,1,0,0
"Lebanon","2024-07-29",0,0,1,0,0,1,0,0
"Lebanon","2024-07-30",0,0,1,0,0,1,0,0
"Lebanon","2024-07-31",0,0,1,0,0,1,0,0
"Lebanon","2024-08-01",0,0,1,0,0,1,0,0
"Lebanon","2024-08-02",0,0,1,0,0,1,0,0
"Lebanon","2024-08-03",0,0,1,0,0,1,0,0
"Lebanon","2024-08-04",0,0,1,0,0,1,0,0
"Lebanon","2024-08-05",0,0,1,0,0,1,0,0
"Lebanon","2024-08-06",0,0,1,0,0,1,0,0
"Lebanon","2024-08-07",0,0,1,0,0,1,0,0
"Lebanon","2024-08-08",0,0,1,0,0,1,0,0
"Lebanon","2024-08-09",0,0,1,0,0,1,0,0
"Lebanon","2024-08-10",0,0,1,0,0,1,0,0
"Lebanon","2024-08-11",0,0,1,0,0,1,0,0
"Lebanon","2024-08-12",0,0,1,0,0,1,0,0
"Lebanon","2024-08-13",0,0,1,0,0,1,0,0
"Lebanon","2024-08-14",0,0,1,0,0,1,0,0
"Lebanon","2024-08-15",0,0,1,0,0,1,0,0
"Lebanon","2024-08-16",0,0,1,0,0,1,0,0
"Lebanon","2024-08-17",0,0,1,0,0,1,0,0
"Lebanon","2024-08-18",0,0,1,0,0,1,0,0
"Lebanon","2024-08-19",0,0,1,0,0,1,0,0
"Lebanon","2024-08-20",0,0,1,0,0,1,0,0
"Lebanon","2024-08-21",0,0,1,0,0,1,0,0
"Lebanon","2024-08-22",0,0,1,0,0,1,0,0
"Lebanon","2024-08-23",0,0,1,0,0,1,0,0
"Lebanon","2024-08-24",0,0,1,0,0,1,0,0
"Lebanon","2024-08-25",0,0,1,0,0,1,0,0
"Lebanon","2024-08-26",0,0,1,0,0,1,0,0
"Lebanon","2024-08-27",0,0,1,0,0,1,0,0
"Lebanon","2024-08-28",0,0,1,0,0,1,0,0
"Lebanon","2024-08-29",0,0,1,0,0,1,0,0
"Lebanon","2024-08-30",0,0,1,0,0,1,0,0
"Lebanon","2024-08-31",0,0,1,0,0,1,0,0
"Lebanon","2024-09-01",0,0,1,0,0,1,0,0
"Lebanon","2024-09-02",0,0,1,0,0,1,0,0
"Lebanon","2024-09-03",0,0,1,0,0,1,0,0
"Lebanon","2024-09-04",0,0,1,0,0,1,0,0
"Lebanon","2024-09-05",0,0,1,0,0,1,0,0
"Lebanon","2024-09-06",0,0,1,0,0,1,0,0
"Lebanon","2024-09-07",0,0,1,0,0,1,0,0
"Lebanon","2024-09-08",0,0,1,0,0,1,0,0
"Lebanon","2024-09-09",0,0,1,0,0,1,0,0
"Lebanon","2024-09-10",0,0,1,0,0,1,0,0
"Lebanon","2024-09-11",0,0,1,0,0,1,0,0
"Lebanon","2024-09-12",0,0,1,0,0,1,0,0
"Lebanon","2024-09-13",0,0,1,0,0,1,0,0
"Lebanon","2024-09-14",0,0,1,0,0,1,0,0
"Lebanon","2024-09-15",0,0,1,0,0,1,0,0
"Lebanon","2024-09-16",0,0,1,0,0,1,0,0
"Lebanon","2024-09-17",0,0,1,0,0,1,0,0
"Lebanon","2024-09-18",0,0,1,0,0,1,0,0
"Lebanon","2024-09-19",0,0,1,0,0,1,0,0
"Lebanon","2024-09-20",0,0,1,0,0,1,0,0
"Lebanon","2024-09-21",0,0,1,0,0,1,0,0
"Lebanon","2024-09-22",0,0,1,0,0,1,0,0
"Lebanon","2024-09-23",0,0,1,0,0,1,0,0
"Lebanon","2024-09-24",0,0,1,0,0,1,0,0
"Lebanon","2024-09-25",0,0,1,0,0,1,0,0
"Lebanon","2024-09-26",0,0,1,0,0,1,0,0
"Lebanon","2024-09-27",0,0,1,0,0,1,0,0
"Lebanon","2024-09-28",0,0,1,0,0,1,0,0
"Lebanon","2024-09-29",0,0,1,0,0,1,0,0
"Lebanon","2024-09-30",0,0,1,0,0,1,0,0
"Lebanon","2024-10-01",0,0,1,0,0,1,0,0
"Lebanon","2024-10-02",0,0,1,0,0,1,0,0
"Lebanon","2024-10-03",0,0,1,0,0,1,0,0
"Lebanon","2024-10-04",0,0,1,0,0,1,0,0
"Lebanon","2024-10-05",0,0,1,0,0,1,0,0
"Lebanon","2024-10-06",0,0,1,0,0,1,0,0
"Lebanon","2024-10-07",0,0,1,0,0,1,0,0
"Lebanon","2024-10-08",0,0,1,0,0,1,0,0
"Lebanon","2024-10-09",0,0,1,0,0,1,0,0
"Lebanon","2024-10-10",0,0,1,0,0,1,0,0
"Lebanon","2024-10-11",0,0,1,0,0,1,0,0
"Lebanon","2024-10-12",0,0,1,0,0,1,0,0
"Lebanon","2024-10-13",0,0,1,0,0,1,0,0
"Lebanon","2024-10-14",0,0,1,0,0,1,0,0
"Lebanon","2024-10-15",0,0,1,0,0,1,0,0
"Lebanon","2024-10-16",0,0,1,0,0,1,0,0
"Lebanon","2024-10-17",0,0,1,0,0,1,0,0
"Lebanon","2024-10-18",0,0,1,0,0,1,0,0
"Lebanon","2024-10-19",0,0,1,0,0,1,0,0
"Lebanon","2024-10-20",0,0,1,0,0,1,0,0
"Lebanon","2024-10-21",0,0,1,0,0,1,0,0
"Lebanon","2024-10-22",0,0,1,0,0,1,0,0
"Lebanon","2024-10-23",0,0,1,0,0,1,0,0
"Lebanon","2024-10-24",0,0,1,0,0,1,0,0
"Lebanon","2024-10-25",0,0,1,0,0,1,0,0
"Lebanon","2024-10-26",0,0,1,0,0,1,0,0
"Lebanon","2024-10-27",0,0,1,0,0,1,0,0
"Lebanon","2024-10-28",0,0,1,0,0,1,0,0
"Lebanon","2024-10-29",0,0,1,0,0,1,0,0
"Lebanon","2024-10-30",0,0,1,0,0,1,0,0
"Lebanon","2024-10-31",0,0,1,0,0,1,0,0
"Lebanon","2024-11-01",0,0,1,0,0,1,0,0
"Lebanon","2024-11-02",0,0,1,0,0,1,0,0
"Lebanon","2024-11-03",0,0,1,0,0,1,0,0
"Lebanon","2024-11-04",0,0,1,0,0,1,0,0
"Lebanon","2024-11-05",0,0,1,0,0,1,0,0
"Lebanon","2024-11-06",0,0,1,0,0,1,0,0
"Lebanon","2024-11-07",0,0,1,0,0,1,0,0
"Lebanon","2024-11-08",0,0,1,0,0,1,0,0
"Lebanon","2024-11-09",0,0,1,0,0,1,0,0
"Lebanon","2024-11-10",0,0,1,0,0,1,0,0
"Lebanon","2024-11-11",0,0,1,0,0,1,0,0
"Lebanon","2024-11-12",0,0,1,0,0,1,0,0
"Lebanon","2024-11-13",0,0,1,0,0,1,0,0
"Lebanon","2024-11-14",0,0,1,0,0,1,0,0
"Lebanon","2024-11-15",0,0,1,0,0,1,0,0
"Lebanon","2024-11-16",0,0,1,0,0,1,0,0
"Lebanon","2024-11-17",0,0,1,0,0,1,0,0
"Lebanon","2024-11-18",0,0,1,0,0,1,0,0
"Lebanon","2024-11-19",0,0,1,0,0,1,0,0
"Lebanon","2024-11-20",0,0,1,0,0,1,0,0
"Lebanon","2024-11-21",0,0,1,0,0,1,0,0
"Lebanon","2024-11-22",0,0,1,0,0,1,0,0
"Lebanon","2024-11-23",0,0,1,0,0,1,0,0
"Lebanon","2024-11-24",0,0,1,0,0,1,0,0
"Lebanon","2024-11-25",0,0,1,0,0,1,0,0
"Lebanon","2024-11-26",0,0,1,0,0,1,0,0
"Lebanon","2024-11-27",0,0,1,0,0,1,0,0
"Lebanon","2024-11-28",0,0,1,0,0,1,0,0
"Lebanon","2024-11-29",0,0,1,0,0,1,0,0
"Lebanon","2024-11-30",0,0,1,0,0,1,0,0
"Lebanon","2024-12-01",0,0,1,0,0,1,0,0
"Lebanon","2024-12-02",0,0,1,0,0,1,0,0
"Lebanon","2024-12-03",0,0,1,0,0,1,0,0
"Lebanon","2024-12-04",0,0,1,0,0,1,0,0
"Lebanon","2024-12-05",0,0,1,0,0,1,0,0
"Lebanon","2024-12-06",0,0,1,0,0,1,0,0
"Lebanon","2024-12-07",0,0,1,0,0,1,0,0
"Lebanon","2024-12-08",0,0,1,0,0,1,0,0
"Lebanon","2024-12-09",0,0,1,0,0,1,0,0
"Lebanon","2024-12-10",0,0,1,0,0,1,0,0
"Lebanon","2024-12-11",0,0,1,0,0,1,0,0
"Lebanon","2024-12-12",0,0,1,0,0,1,0,0
"Lebanon","2024-12-13",0,0,1,0,0,1,0,0
"Lebanon","2024-12-14",0,0,1,0,0,1,0,0
"Lebanon","2024-12-15",0,0,1,0,0,1,0,0
"Lebanon","2024-12-16",0,0,1,0,0,1,0,0
"Lebanon","2024-12-17",0,0,1,0,0,1,0,0
"Lebanon","2024-12-18",0,0,1,0,0,1,0,0
"Lebanon","2024-12-19",0,0,1,0,0,1,0,0
"Lebanon","2024-12-20",0,0,1,0,0,1,0,0
"Lebanon","2024-12-21",0,0,1,0,0,1,0,0
"Lebanon","2024-12-22",0,0,1,0,0,1,0,0
"Lebanon","2024-12-23",0,0,1,0,0,1,0,0
"Lebanon","2024-12-24",0,0,1,0,0,1,0,0
"Lebanon","2024-12-25",0,0,1,0,0,1,0,0
"Lebanon","2024-12-26",0,0,1,0,0,1,0,0
"Lebanon","2024-12-27",0,0,1,0,0,1,0,0
"Lebanon","2024-12-28",0,0,1,0,0,1,0,0
"Lebanon","2024-12-29",0,0,1,0,0,1,0,0
"Lebanon","2024-12-30",0,0,1,0,0,1,0,0
"Lebanon","2024-12-31",0,0,1,0,0,1,0,0
"Lebanon","2025-01-01",0,0,1,0,0,1,0,0
"Lebanon","2025-01-02",0,0,1,0,0,1,0,0
"Lebanon","2025-01-03",0,0,1,0,0,1,0,0
"Lebanon","2025-01-04",0,0,1,0,0,1,0,0
"Lebanon","2025-01-05",0,0,1,0,0,1,0,0
"Lebanon","2025-01-06",0,0,1,0,0,1,0,0
"Lebanon","2025-01-07",0,0,1,0,0,1,0,0
"Lebanon","2025-01-08",0,0,1,0,0,1,0,0
"Lebanon","2025-01-09",0,0,1,0,0,1,0,0
"Lebanon","2025-01-10",0,0,1,0,0,1,0,0
"Lebanon","2025-01-11",0,0,1,0,0,1,0,0
"Lebanon","2025-01-12",0,0,1,0,0,1,0,0
"Lebanon","2025-01-13",0,0,1,0,0,1,0,0
"Liberia","2024-01-01",0,0,0,0,0,0,0,0
"Liberia","2024-01-02",0,0,0,0,0,0,0,0
"Liberia","2024-01-03",0,0,0,0,0,0,0,0
"Liberia","2024-01-04",0,0,0,0,0,0,0,0
"Liberia","2024-01-05",0,0,0,0,0,0,0,0
"Liberia","2024-01-06",0,0,0,0,0,0,0,0
"Liberia","2024-01-07",0,0,0,0,0,0,0,0
"Liberia","2024-01-08",0,0,0,0,0,0,0,0
"Liberia","2024-01-09",0,0,0,0,0,0,0,0
"Liberia","2024-01-10",0,0,0,0,0,0,0,0
"Liberia","2024-01-11",0,0,0,0,0,0,0,0
"Liberia","2024-01-12",0,0,0,0,0,0,0,0
"Liberia","2024-01-13",0,0,0,0,0,0,0,0
"Liberia","2024-01-14",0,1,1,0,1,1,0,0
"Liberia","2024-01-15",0,0,1,0,0,1,0,0
"Liberia","2024-01-16",0,0,1,0,0,1,0,0
"Liberia","2024-01-17",0,0,1,0,0,1,0,0
"Liberia","2024-01-18",0,0,1,0,0,1,0,0
"Liberia","2024-01-19",0,0,1,0,0,1,0,0
"Liberia","2024-01-20",0,0,1,0,0,1,0,0
"Liberia","2024-01-21",0,0,1,0,0,1,0,0
"Liberia","2024-01-22",0,0,1,0,0,1,0,0
"Liberia","2024-01-23",0,0,1,0,0,1,0,0
"Liberia","2024-01-24",0,0,1,0,0,1,0,0
"Liberia","2024-01-25",0,0,1,0,1,2,0,0
"Liberia","2024-01-26",0,0,1,0,0,2,0,0
"Liberia","2024-01-27",0,0,1,0,0,2,0,0
"Liberia","2024-01-28",0,0,1,0,0,2,0,0
"Liberia","2024-01-29",0,0,1,0,0,2,0,0
"Liberia","2024-01-30",0,0,1,0,0,2,0,0
"Liberia","2024-01-31",0,0,1,0,0,2,0,0
"Liberia","2024-02-01",0,0,1,0,0,2,0,0
"Liberia","2024-02-02",0,0,1,0,0,2,0,0
"Liberia","2024-02-03",0,0,1,0,0,2,0,0
"Liberia","2024-02-04",0,1,2,0,0,2,0,0
"Liberia","2024-02-05",0,0,2,0,0,2,0,0
"Liberia","2024-02-06",0,0,2,0,0,2,0,0
"Liberia","2024-02-07",0,0,2,0,0,2,0,0
"Liberia","2024-02-08",0,0,2,0,0,2,0,0
"Liberia","2024-02-09",0,0,2,0,0,2,0,0
"Liberia","2024-02-10",0,0,2,0,0,2,0,0
"Liberia","2024-02-11",0,0,2,0,0,2,0,0
"Liberia","2024-02-12",0,0,2,0,1,3,0,0
"Liberia","2024-02-13",0,0,2,0,0,3,0,0
"Liberia","2024-02-14",0,0,2,0,0,3,0,0
"Liberia","2024-02-15",0,0,2,0,0,3,0,0
"Liberia","2024-02-16",0,0,2,0,0,3,0,0
"Liberia","2024-02-17",0,0,2,0,0,3,0,0
"Liberia","2024-02-18",0,1,3,0,0,3,0,0
"Liberia","2024-02-19",0,0,3,0,0,3,0,0
"Liberia","2024-02-20",0,0,3,0,0,3,0,0
"Liberia","2024-02-21",0,0,3,0,0,3,0,0
"Liberia","2024-02-22",0,0,3,0,0,3,0,0
"Liberia","2024-02-23",0,0,3,0,0,3,0,0
"Liberia","2024-02-24",0,0,3,0,0,3,0,0
"Liberia","2024-02-25",0,0,3,0,0,3,0,0
"Liberia","2024-02-26",0,0,3,0,0,3,0,0
"Liberia","2024-02-27",0,0,3,0,0,3,0,0
"Liberia","2024-02-28",0,0,3,0,0,3,0,0
"Liberia","2024-02-29",0,0,3,0,1,4,0,0
"Liberia","2024-03-01",0,0,3,0,0,4,0,0
"Liberia","2024-03-02",0,0,3,0,0,4,0,0
"Liberia","2024-03-03",0,0,3,0,0,4,0,0
"Liberia","2024-03-04",0,0,3,0,0,4,0,0
"Liberia","2024-03-05",0,0,3,0,0,4,0,0
"Liberia","2024-03-06",0,0,3,0,0,4,0,0
"Liberia","2024-03-07",0,0,3,0,0,4,0,0
"Liberia","2024-03-08",0,0,3,0,0,4,0,0
"Liberia","2024-03-09",0,0,3,0,0,4,0,0
"Liberia","2024-03-10",0,1,4,0,0,4,0,0
"Liberia","2024-03-11",0,0,4,0,0,4,0,0
"Liberia","2024-03-12",0,0,4,0,0,4,0,0
"Liberia","2024-03-13",0,0,4,0,0,4,0,0
"Liberia","2024-03-14",0,0,4,0,0,4,0,0
"Liberia","2024-03-15",0,0,4,0,0,4,0,0
"Liberia","2024-03-16",0,0,4,0,0,4,0,0
"Liberia","2024-03-17",0,0,4,0,0,4,0,0
"Liberia","2024-03-18",0,0,4,0,0,4,0,0
"Liberia","2024-03-19",0,0,4,0,0,4,0,0
"Liberia","2024-03-20",0,0,4,0,0,4,0,0
"Liberia","2024-03-21",0,0,4,0,1,5,0,0
"Liberia","2024-03-22",0,0,4,0,0,5,0,0
"Liberia","2024-03-23",0,0,4,0,0,5,0,0
"Liberia","2024-03-24",0,0,4,0,0,5,0,0
"Liberia","2024-03-25",0,0,4,0,0,5,0,0
"Liberia","2024-03-26",0,0,4,0,0,5,0,0
"Liberia","2024-03-27",0,0,4,0,0,5,0,0
"Liberia","2024-03-28",0,0,4,0,0,5,0,0
"Liberia","2024-03-29",0,0,4,0,0,5,0,0
"Liberia","2024-03-30",0,0,4,0,0,5,0,0
"Liberia","2024-03-31",0,1,5,0,0,5,0,0
"Liberia","2024-04-01",0,0,5,0,0,5,0,0
"Liberia","2024-04-02",0,0,5,0,0,5,0,0
"Liberia","2024-04-03",0,0,5,0,0,5,0,0
"Liberia","2024-04-04",0,0,5,0,0,5,0,0
"Liberia","2024-04-05",0,0,5,0,0,5,0,0
"Liberia","2024-04-06",0,0,5,0,0,5,0,0
"Liberia","2024-04-07",0,0,5,0,0,5,0,0
"Liberia","2024-04-08",0,0,5,0,0,5,0,0
"Liberia","2024-04-09",0,0,5,0,0,5,0,0
"Liberia","2024-04-10",0,0,5,0,0,5,0,0
"Liberia","2024-04-11",0,0,5,0,0,5,0,0
"Liberia","2024-04-12",0,0,5,0,0,5,0,0
"Liberia","2024-04-13",0,0,5,0,0,5,0,0
"Liberia","2024-04-14",0,0,5,0,0,5,0,0
"Liberia","2024-04-15",0,0,5,0,0,5,0,0
"Liberia","2024-04-16",0,0,5,0,0,5,0,0
"Liberia","2024-04-17",0,0,5,0,0,5,0,0
"Liberia","2024-04-18",0,0,5,0,0,5,0,0
"Liberia","2024-04-19",0,0,5,0,0,5,0,0
"Liberia","2024-04-20",0,0,5,0,0,5,0,0
"Liberia","2024-04-21",0,0,5,0,0,5,0,0
"Liberia","2024-04-22",0,0,5,0,0,5,0,0
"Liberia","2024-04-23",0,0,5,0,0,5,0,0
"Liberia","2024-04-24",0,0,5,0,0,5,0,0
"Liberia","2024-04-25",0,0,5,0,0,5,0,0
"Liberia","2024-04-26",0,0,5,0,0,5,0,0
"Liberia","2024-04-27",0,0,5,0,0,5,0,0
"Liberia","2024-04-28",0,0,5,0,0,5,0,0
"Liberia","2024-04-29",0,0,5,0,0,5,0,0
"Liberia","2024-04-30",0,0,5,0,0,5,0,0
"Liberia","2024-05-01",0,0,5,0,0,5,0,0
"Liberia","2024-05-02",0,0,5,0,0,5,0,0
"Liberia","2024-05-03",0,0,5,0,0,5,0,0
"Liberia","2024-05-04",0,0,5,0,0,5,0,0
"Liberia","2024-05-05",0,0,5,0,0,5,0,0
"Liberia","2024-05-06",0,0,5,0,0,5,0,0
"Liberia","2024-05-07",0,0,5,0,0,5,0,0
"Liberia","2024-05-08",0,0,5,0,0,5,0,0
"Liberia","2024-05-09",0,0,5,0,0,5,0,0
"Liberia","2024-05-10",0,0,5,0,0,5,0,0
"Liberia","2024-05-11",0,0,5,0,0,5,0,0
"Liberia","2024-05-12",0,0,5,0,0,5,0,0
"Liberia","2024-05-13",0,0,5,0,0,5,0,0
"Liberia","2024-05-14",0,0,5,0,0,5,0,0
"Liberia","2024-05-15",0,0,5,0,0,5,0,0
"Liberia","2024-05-16",0,0,5,0,0,5,0,0
"Liberia","2024-05-17",0,0,5,0,0,5,0,0
"Liberia","2024-05-18",0,0,5,0,0,5,0,0
"Liberia","2024-05-19",0,0,5,0,0,5,0,0
"Liberia","2024-05-20",0,0,5,0,0,5,0,0
"Liberia","2024-05-21",0,0,5,0,0,5,0,0
"Liberia","2024-05-22",0,0,5,0,0,5,0,0
"Liberia","2024-05-23",0,0,5,0,0,5,0,0
"Liberia","2024-05-24",0,0,5,0,0,5,0,0
"Liberia","2024-05-25",0,0,5,0,0,5,0,0
"Liberia","2024-05-26",0,0,5,0,0,5,0,0
"Liberia","2024-05-27",0,0,5,0,0,5,0,0
"Liberia","2024-05-28",0,0,5,0,0,5,0,0
"Liberia","2024-05-29",0,0,5,0,0,5,0,0
"Liberia","2024-05-30",0,0,5,0,0,5,0,0
"Liberia","2024-05-31",0,0,5,0,0,5,0,0
"Liberia","2024-06-01",0,0,5,0,0,5,0,0
"Liberia","2024-06-02",0,0,5,0,0,5,0,0
"Liberia","2024-06-03",0,0,5,0,0,5,0,0
"Liberia","2024-06-04",0,0,5,0,0,5,0,0
"Liberia","2024-06-05",0,0,5,0,0,5,0,0
"Liberia","2024-06-06",0,0,5,0,1,6,0,0
"Liberia","2024-06-07",0,0,5,0,0,6,0,0
"Liberia","2024-06-08",0,0,5,0,0,6,0,0
"Liberia","2024-06-09",0,0,5,0,0,6,0,0
"Liberia","2024-06-10",0,0,5,0,0,6,0,0
"Liberia","2024-06-11",0,0,5,0,0,6,0,0
"Liberia","2024-06-12",0,0,5,0,0,6,0,0
"Liberia","2024-06-13",0,0,5,0,0,6,0,0
"Liberia","2024-06-14",0,0,5,0,0,6,0,0
"Liberia","2024-06-15",0,0,5,0,0,6,0,0
"Liberia","2024-06-16",0,0,5,0,0,6,0,0
"Liberia","2024-06-17",0,0,5,0,0,6,0,0
"Liberia","2024-06-18",0,0,5,0,0,6,0,0
"Liberia","2024-06-19",0,0,5,0,0,6,0,0
"Liberia","2024-06-20",0,0,5,0,0,6,0,0
"Liberia","2024-06-21",0,0,5,0,0,6,0,0
"Liberia","2024-06-22",0,0,5,0,0,6,0,0
"Liberia","2024-06-23",0,0,5,0,0,6,0,0
"Liberia","2024-06-24",0,0,5,0,0,6,0,0
"Liberia","2024-06-25",0,0,5,0,0,6,0,0
"Liberia","2024-06-26",0,0,5,0,0,6,0,0
"Liberia","2024-06-27",0,0,5,0,0,6,0,0
"Liberia","2024-06-28",0,0,5,0,0,6,0,0
"Liberia","2024-06-29",0,0,5,0,0,6,0,0
"Liberia","2024-06-30",0,0,5,0,0,6,0,0
"Liberia","2024-07-01",0,0,5,0,0,6,0,0
"Liberia","2024-07-02",0,0,5,0,0,6,0,0
"Liberia","2024-07-03",0,0,5,0,0,6,0,0
"Liberia","2024-07-04",0,0,5,0,0,6,0,0
"Liberia","2024-07-05",0,0,5,0,0,6,0,0
"Liberia","2024-07-06",0,0,5,0,0,6,0,0
"Liberia","2024-07-07",0,0,5,0,0,6,0,0
"Liberia","2024-07-08",0,0,5,0,0,6,0,0
"Liberia","2024-07-09",0,0,5,0,0,6,0,0
"Liberia","2024-07-10",0,0,5,0,0,6,0,0
"Liberia","2024-07-11",0,0,5,0,0,6,0,0
"Liberia","2024-07-12",0,0,5,0,0,6,0,0
"Liberia","2024-07-13",0,0,5,0,0,6,0,0
"Liberia","2024-07-14",0,0,5,0,0,6,0,0
"Liberia","2024-07-15",0,0,5,0,0,6,0,0
"Liberia","2024-07-16",0,0,5,0,0,6,0,0
"Liberia","2024-07-17",0,0,5,0,0,6,0,0
"Liberia","2024-07-18",0,0,5,0,0,6,0,0
"Liberia","2024-07-19",0,0,5,0,0,6,0,0
"Liberia","2024-07-20",0,0,5,0,0,6,0,0
"Liberia","2024-07-21",0,0,5,0,0,6,0,0
"Liberia","2024-07-22",0,0,5,0,0,6,0,0
"Liberia","2024-07-23",0,0,5,0,0,6,0,0
"Liberia","2024-07-24",0,0,5,0,0,6,0,0
"Liberia","2024-07-25",0,0,5,0,0,6,0,0
"Liberia","2024-07-26",0,0,5,0,0,6,0,0
"Liberia","2024-07-27",0,0,5,0,0,6,0,0
"Liberia","2024-07-28",0,0,5,0,0,6,0,0
"Liberia","2024-07-29",0,0,5,0,0,6,0,0
"Liberia","2024-07-30",0,0,5,0,0,6,0,0
"Liberia","2024-07-31",0,0,5,0,0,6,0,0
"Liberia","2024-08-01",0,0,5,0,0,6,0,0
"Liberia","2024-08-02",0,0,5,0,0,6,0,0
"Liberia","2024-08-03",0,0,5,0,0,6,0,0
"Liberia","2024-08-04",0,0,5,0,0,6,0,0
"Liberia","2024-08-05",0,0,5,0,0,6,0,0
"Liberia","2024-08-06",0,0,5,0,0,6,0,0
"Liberia","2024-08-07",0,0,5,0,0,6,0,0
"Liberia","2024-08-08",0,0,5,0,0,6,0,0
"Liberia","2024-08-09",0,0,5,0,0,6,0,0
"Liberia","2024-08-10",0,0,5,0,0,6,0,0
"Liberia","2024-08-11",0,1,6,0,0,6,0,0
"Liberia","2024-08-12",0,0,6,0,0,6,0,0
"Liberia","2024-08-13",0,0,6,0,0,6,0,0
"Liberia","2024-08-14",0,0,6,0,0,6,0,0
"Liberia","2024-08-15",0,0,6,0,0,6,0,0
"Liberia","2024-08-16",0,0,6,0,0,6,0,0
"Liberia","2024-08-17",0,0,6,0,0,6,0,0
"Liberia","2024-08-18",0,0,6,0,0,6,0,0
"Liberia","2024-08-19",0,0,6,0,0,6,0,0
"Liberia","2024-08-20",0,0,6,0,0,6,0,0
"Liberia","2024-08-21",0,0,6,0,0,6,0,0
"Liberia","2024-08-22",0,0,6,0,1,7,0,0
"Liberia","2024-08-23",0,0,6,0,0,7,0,0
"Liberia","2024-08-24",0,0,6,0,0,7,0,0
"Liberia","2024-08-25",0,0,6,0,0,7,0,0
"Liberia","2024-08-26",0,0,6,0,0,7,0,0
"Liberia","2024-08-27",0,0,6,0,0,7,0,0
"Liberia","2024-08-28",0,0,6,0,0,7,0,0
"Liberia","2024-08-29",0,0,6,0,0,7,0,0
"Liberia","2024-08-30",0,0,6,0,0,7,0,0
"Liberia","2024-08-31",0,0,6,0,0,7,0,0
"Liberia","2024-09-01",0,1,7,0,0,7,0,0
"Liberia","2024-09-02",0,0,7,0,0,7,0,0
"Liberia","2024-09-03",0,0,7,0,1,8,0,0
"Liberia","2024-09-04",0,0,7,0,0,8,0,0
"Liberia","2024-09-05",0,0,7,0,0,8,0,0
"Liberia","2024-09-06",0,0,7,0,0,8,0,0
"Liberia","2024-09-07",0,0,7,0,1,9,0,0
"Liberia","2024-09-08",85,2,9,85,0,9,85,85
"Liberia","2024-09-09",0,0,9,85,0,9,6,91
"Liberia","2024-09-10",0,0,9,85,1,10,5,96
"Liberia","2024-09-11",0,0,9,85,0,10,6,102
"Liberia","2024-09-12",0,0,9,85,1,11,6,108
"Liberia","2024-09-13",0,0,9,85,0,11,5,113
"Liberia","2024-09-14",0,0,9,85,1,12,6,119
"Liberia","2024-09-15",0,3,12,85,0,12,6,125
"Liberia","2024-09-16",0,0,12,85,0,12,5,130
"Liberia","2024-09-17",0,0,12,85,0,12,6,136
"Liberia","2024-09-18",0,0,12,85,0,12,5,141
"Liberia","2024-09-19",0,0,12,85,1,13,6,147
"Liberia","2024-09-20",0,0,12,85,0,13,6,153
"Liberia","2024-09-21",0,0,12,85,0,13,5,158
"Liberia","2024-09-22",79,0,12,164,0,13,6,164
"Liberia","2024-09-23",0,0,12,164,0,13,1,165
"Liberia","2024-09-24",0,0,12,164,0,13,1,166
"Liberia","2024-09-25",0,0,12,164,0,13,0,166
"Liberia","2024-09-26",0,0,12,164,1,14,1,167
"Liberia","2024-09-27",0,0,12,164,0,14,1,168
"Liberia","2024-09-28",0,0,12,164,0,14,1,169
"Liberia","2024-09-29",0,2,14,164,0,14,1,170
"Liberia","2024-09-30",0,0,14,164,0,14,1,171
"Liberia","2024-10-01",0,0,14,164,1,15,0,171
"Liberia","2024-10-02",0,0,14,164,0,15,1,172
"Liberia","2024-10-03",0,0,14,164,0,15,1,173
"Liberia","2024-10-04",0,0,14,164,0,15,1,174
"Liberia","2024-10-05",0,0,14,164,1,16,1,175
"Liberia","2024-10-06",0,0,14,164,0,16,1,176
"Liberia","2024-10-07",0,0,14,164,0,16,0,176
"Liberia","2024-10-08",0,0,14,164,1,17,1,177
"Liberia","2024-10-09",0,0,14,164,0,17,1,178
"Liberia","2024-10-10",0,0,14,164,0,17,1,179
"Liberia","2024-10-11",0,0,14,164,0,17,1,180
"Liberia","2024-10-12",0,0,14,164,1,18,0,180
"Liberia","2024-10-13",0,4,18,164,0,18,1,181
"Liberia","2024-10-14",0,0,18,164,0,18,1,182
"Liberia","2024-10-15",0,0,18,164,0,18,1,183
"Liberia","2024-10-16",0,0,18,164,0,18,1,184
"Liberia","2024-10-17",0,0,18,164,1,19,1,185
"Liberia","2024-10-18",0,0,18,164,0,19,0,185
"Liberia","2024-10-19",0,0,18,164,0,19,1,186
"Liberia","2024-10-20",23,1,19,187,0,19,1,187
"Liberia","2024-10-21",47,0,19,234,0,19,47,234
"Liberia","2024-10-22",0,0,19,234,0,19,1,235
"Liberia","2024-10-23",0,0,19,234,0,19,2,237
"Liberia","2024-10-24",0,0,19,234,1,20,1,238
"Liberia","2024-10-25",0,0,19,234,0,20,1,239
"Liberia","2024-10-26",0,0,19,234,0,20,2,241
"Liberia","2024-10-27",0,1,20,234,0,20,1,242
"Liberia","2024-10-28",0,0,20,234,0,20,1,243
"Liberia","2024-10-29",0,0,20,234,1,21,1,244
"Liberia","2024-10-30",0,0,20,234,0,21,2,246
"Liberia","2024-10-31",0,0,20,234,1,22,1,247
"Liberia","2024-11-01",0,0,20,234,0,22,1,248
"Liberia","2024-11-02",0,0,20,234,1,23,2,250
"Liberia","2024-11-03",17,3,23,251,0,23,1,251
"Liberia","2024-11-04",0,0,23,251,3,26,2,253
"Liberia","2024-11-05",0,0,23,251,2,28,3,256
"Liberia","2024-11-06",0,0,23,251,3,31,2,258
"Liberia","2024-11-07",0,0,23,251,2,33,2,260
"Liberia","2024-11-08",0,0,23,251,3,36,3,263
"Liberia","2024-11-09",0,0,23,251,2,38,2,265
"Liberia","2024-11-10",0,18,41,251,3,41,2,267
"Liberia","2024-11-11",0,0,41,251,0,41,2,269
"Liberia","2024-11-12",0,0,41,251,0,41,3,272
"Liberia","2024-11-13",23,0,41,274,0,41,2,274
"Liberia","2024-11-14",0,0,41,274,1,42,0,274
"Liberia","2024-11-15",0,0,41,274,0,42,0,274
"Liberia","2024-11-16",0,0,41,274,0,42,0,274
"Liberia","2024-11-17",0,1,42,274,0,42,0,274
"Liberia","2024-11-18",0,0,42,274,1,43,0,274
"Liberia","2024-11-19",0,0,42,274,2,45,0,274
"Liberia","2024-11-20",0,0,42,274,1,46,0,274
"Liberia","2024-11-21",0,0,42,274,1,47,0,274
"Liberia","2024-11-22",0,0,42,274,1,48,0,274
"Liberia","2024-11-23",0,0,42,274,2,50,0,274
"Liberia","2024-11-24",0,9,51,274,1,51,0,274
"Liberia","2024-11-25",0,0,51,274,2,53,0,274
"Liberia","2024-11-26",0,0,51,274,1,54,0,274
"Liberia","2024-11-27",0,0,51,274,2,56,0,274
"Liberia","2024-11-28",0,0,51,274,1,57,0,274
"Liberia","2024-11-29",0,0,51,274,2,59,0,274
"Liberia","2024-11-30",0,0,51,274,1,60,0,274
"Liberia","2024-12-01",0,11,62,274,2,62,0,274
"Liberia","2024-12-02",0,0,62,274,0,62,0,274
"Liberia","2024-12-03",0,0,62,274,0,62,0,274
"Liberia","2024-12-04",0,0,62,274,0,62,0,274
"Liberia","2024-12-05",0,0,62,274,1,63,0,274
"Liberia","2024-12-06",0,0,62,274,0,63,0,274
"Liberia","2024-12-07",0,0,62,274,0,63,0,274
"Liberia","2024-12-08",0,1,63,274,0,63,0,274
"Liberia","2024-12-09",0,0,63,274,0,63,0,274
"Liberia","2024-12-10",0,0,63,274,0,63,0,274
"Liberia","2024-12-11",0,0,63,274,0,63,0,274
"Liberia","2024-12-12",0,0,63,274,0,63,0,274
"Liberia","2024-12-13",0,0,63,274,0,63,0,274
"Liberia","2024-12-14",0,0,63,274,0,63,0,274
"Liberia","2024-12-15",0,0,63,274,0,63,0,274
"Liberia","2024-12-16",0,0,63,274,0,63,0,274
"Liberia","2024-12-17",0,0,63,274,0,63,0,274
"Liberia","2024-12-18",0,0,63,274,0,63,0,274
"Liberia","2024-12-19",0,0,63,274,0,63,0,274
"Liberia","2024-12-20",0,0,63,274,0,63,0,274
"Liberia","2024-12-21",0,0,63,274,0,63,0,274
"Liberia","2024-12-22",0,0,63,274,0,63,0,274
"Liberia","2024-12-23",0,0,63,274,0,63,0,274
"Liberia","2024-12-24",0,0,63,274,0,63,0,274
"Liberia","2024-12-25",0,0,63,274,0,63,0,274
"Liberia","2024-12-26",0,0,63,274,0,63,0,274
"Liberia","2024-12-27",0,0,63,274,0,63,0,274
"Liberia","2024-12-28",0,0,63,274,0,63,0,274
"Liberia","2024-12-29",0,0,63,274,0,63,0,274
"Liberia","2024-12-30",0,0,63,274,0,63,0,274
"Liberia","2024-12-31",0,0,63,274,0,63,0,274
"Liberia","2025-01-01",0,0,63,274,0,63,0,274
"Liberia","2025-01-02",0,0,63,274,0,63,0,274
"Liberia","2025-01-03",0,0,63,274,0,63,0,274
"Liberia","2025-01-04",0,0,63,274,0,63,0,274
"Liberia","2025-01-05",0,0,63,274,0,63,0,274
"Liberia","2025-01-06",0,0,63,274,0,63,0,274
"Liberia","2025-01-07",0,0,63,274,0,63,0,274
"Liberia","2025-01-08",0,0,63,274,0,63,0,274
"Liberia","2025-01-09",0,0,63,274,0,63,0,274
"Liberia","2025-01-10",0,0,63,274,0,63,0,274
"Liberia","2025-01-11",0,0,63,274,0,63,0,274
"Liberia","2025-01-12",0,0,63,274,0,63,0,274
"Liberia","2025-01-13",0,0,63,274,0,63,0,274
"Lithuania","2024-01-01",0,0,0,0,0,0,0,0
"Lithuania","2024-01-02",0,0,0,0,0,0,0,0
"Lithuania","2024-01-03",0,0,0,0,0,0,0,0
"Lithuania","2024-01-04",0,0,0,0,0,0,0,0
"Lithuania","2024-01-05",0,0,0,0,0,0,0,0
"Lithuania","2024-01-06",0,0,0,0,0,0,0,0
"Lithuania","2024-01-07",0,0,0,0,0,0,0,0
"Lithuania","2024-01-08",0,0,0,0,0,0,0,0
"Lithuania","2024-01-09",0,0,0,0,0,0,0,0
"Lithuania","2024-01-10",0,0,0,0,0,0,0,0
"Lithuania","2024-01-11",0,0,0,0,0,0,0,0
"Lithuania","2024-01-12",0,0,0,0,0,0,0,0
"Lithuania","2024-01-13",0,0,0,0,0,0,0,0
"Lithuania","2024-01-14",0,0,0,0,0,0,0,0
"Lithuania","2024-01-15",0,0,0,0,0,0,0,0
"Lithuania","2024-01-16",0,0,0,0,0,0,0,0
"Lithuania","2024-01-17",0,0,0,0,0,0,0,0
"Lithuania","2024-01-18",0,0,0,0,0,0,0,0
"Lithuania","2024-01-19",0,0,0,0,0,0,0,0
"Lithuania","2024-01-20",0,0,0,0,0,0,0,0
"Lithuania","2024-01-21",0,0,0,0,0,0,0,0
"Lithuania","2024-01-22",0,0,0,0,0,0,0,0
"Lithuania","2024-01-23",0,0,0,0,0,0,0,0
"Lithuania","2024-01-24",0,0,0,0,0,0,0,0
"Lithuania","2024-01-25",0,0,0,0,0,0,0,0
"Lithuania","2024-01-26",0,0,0,0,0,0,0,0
"Lithuania","2024-01-27",0,0,0,0,0,0,0,0
"Lithuania","2024-01-28",0,0,0,0,0,0,0,0
"Lithuania","2024-01-29",0,0,0,0,0,0,0,0
"Lithuania","2024-01-30",0,0,0,0,0,0,0,0
"Lithuania","2024-01-31",0,0,0,0,0,0,0,0
"Lithuania","2024-02-01",0,0,0,0,0,0,0,0
"Lithuania","2024-02-02",0,0,0,0,0,0,0,0
"Lithuania","2024-02-03",0,0,0,0,0,0,0,0
"Lithuania","2024-02-04",0,0,0,0,0,0,0,0
"Lithuania","2024-02-05",0,0,0,0,0,0,0,0
"Lithuania","2024-02-06",0,0,0,0,0,0,0,0
"Lithuania","2024-02-07",0,0,0,0,0,0,0,0
"Lithuania","2024-02-08",0,0,0,0,0,0,0,0
"Lithuania","2024-02-09",0,0,0,0,0,0,0,0
"Lithuania","2024-02-10",0,0,0,0,0,0,0,0
"Lithuania","2024-02-11",0,0,0,0,0,0,0,0
"Lithuania","2024-02-12",0,0,0,0,0,0,0,0
"Lithuania","2024-02-13",0,0,0,0,0,0,0,0
"Lithuania","2024-02-14",0,0,0,0,0,0,0,0
"Lithuania","2024-02-15",0,0,0,0,0,0,0,0
"Lithuania","2024-02-16",0,0,0,0,0,0,0,0
"Lithuania","2024-02-17",0,0,0,0,0,0,0,0
"Lithuania","2024-02-18",0,0,0,0,0,0,0,0
"Lithuania","2024-02-19",0,0,0,0,0,0,0,0
"Lithuania","2024-02-20",0,0,0,0,0,0,0,0
"Lithuania","2024-02-21",0,0,0,0,0,0,0,0
"Lithuania","2024-02-22",0,0,0,0,0,0,0,0
"Lithuania","2024-02-23",0,0,0,0,0,0,0,0
"Lithuania","2024-02-24",0,0,0,0,0,0,0,0
"Lithuania","2024-02-25",0,0,0,0,0,0,0,0
"Lithuania","2024-02-26",0,0,0,0,0,0,0,0
"Lithuania","2024-02-27",0,0,0,0,0,0,0,0
"Lithuania","2024-02-28",0,0,0,0,0,0,0,0
"Lithuania","2024-02-29",0,0,0,0,0,0,0,0
"Lithuania","2024-03-01",0,0,0,0,0,0,0,0
"Lithuania","2024-03-02",0,0,0,0,0,0,0,0
"Lithuania","2024-03-03",0,0,0,0,0,0,0,0
"Lithuania","2024-03-04",0,0,0,0,0,0,0,0
"Lithuania","2024-03-05",0,0,0,0,0,0,0,0
"Lithuania","2024-03-06",0,0,0,0,0,0,0,0
"Lithuania","2024-03-07",0,0,0,0,0,0,0,0
"Lithuania","2024-03-08",0,0,0,0,0,0,0,0
"Lithuania","2024-03-09",0,0,0,0,0,0,0,0
"Lithuania","2024-03-10",0,0,0,0,0,0,0,0
"Lithuania","2024-03-11",0,0,0,0,0,0,0,0
"Lithuania","2024-03-12",0,0,0,0,0,0,0,0
"Lithuania","2024-03-13",0,0,0,0,0,0,0,0
"Lithuania","2024-03-14",0,0,0,0,0,0,0,0
"Lithuania","2024-03-15",0,0,0,0,0,0,0,0
"Lithuania","2024-03-16",0,0,0,0,0,0,0,0
"Lithuania","2024-03-17",0,0,0,0,0,0,0,0
"Lithuania","2024-03-18",0,0,0,0,0,0,0,0
"Lithuania","2024-03-19",0,0,0,0,0,0,0,0
"Lithuania","2024-03-20",0,0,0,0,0,0,0,0
"Lithuania","2024-03-21",0,0,0,0,0,0,0,0
"Lithuania","2024-03-22",0,0,0,0,0,0,0,0
"Lithuania","2024-03-23",0,0,0,0,0,0,0,0
"Lithuania","2024-03-24",0,0,0,0,0,0,0,0
"Lithuania","2024-03-25",0,0,0,0,0,0,0,0
"Lithuania","2024-03-26",0,0,0,0,0,0,0,0
"Lithuania","2024-03-27",0,0,0,0,0,0,0,0
"Lithuania","2024-03-28",0,0,0,0,0,0,0,0
"Lithuania","2024-03-29",0,0,0,0,0,0,0,0
"Lithuania","2024-03-30",0,0,0,0,0,0,0,0
"Lithuania","2024-03-31",0,0,0,0,0,0,0,0
"Lithuania","2024-04-01",0,0,0,0,0,0,0,0
"Lithuania","2024-04-02",0,0,0,0,0,0,0,0
"Lithuania","2024-04-03",0,0,0,0,0,0,0,0
"Lithuania","2024-04-04",0,0,0,0,0,0,0,0
"Lithuania","2024-04-05",0,0,0,0,0,0,0,0
"Lithuania","2024-04-06",0,0,0,0,0,0,0,0
"Lithuania","2024-04-07",0,0,0,0,0,0,0,0
"Lithuania","2024-04-08",0,0,0,0,0,0,0,0
"Lithuania","2024-04-09",0,0,0,0,0,0,0,0
"Lithuania","2024-04-10",0,0,0,0,0,0,0,0
"Lithuania","2024-04-11",0,0,0,0,0,0,0,0
"Lithuania","2024-04-12",0,0,0,0,0,0,0,0
"Lithuania","2024-04-13",0,0,0,0,0,0,0,0
"Lithuania","2024-04-14",0,0,0,0,0,0,0,0
"Lithuania","2024-04-15",0,0,0,0,0,0,0,0
"Lithuania","2024-04-16",0,0,0,0,0,0,0,0
"Lithuania","2024-04-17",0,0,0,0,0,0,0,0
"Lithuania","2024-04-18",0,0,0,0,0,0,0,0
"Lithuania","2024-04-19",0,0,0,0,0,0,0,0
"Lithuania","2024-04-20",0,0,0,0,0,0,0,0
"Lithuania","2024-04-21",0,0,0,0,0,0,0,0
"Lithuania","2024-04-22",0,0,0,0,0,0,0,0
"Lithuania","2024-04-23",0,0,0,0,0,0,0,0
"Lithuania","2024-04-24",0,0,0,0,0,0,0,0
"Lithuania","2024-04-25",0,0,0,0,0,0,0,0
"Lithuania","2024-04-26",0,0,0,0,0,0,0,0
"Lithuania","2024-04-27",0,0,0,0,0,0,0,0
"Lithuania","2024-04-28",0,0,0,0,0,0,0,0
"Lithuania","2024-04-29",0,0,0,0,0,0,0,0
"Lithuania","2024-04-30",0,0,0,0,0,0,0,0
"Lithuania","2024-05-01",0,0,0,0,0,0,0,0
"Lithuania","2024-05-02",0,0,0,0,0,0,0,0
"Lithuania","2024-05-03",0,0,0,0,0,0,0,0
"Lithuania","2024-05-04",0,0,0,0,0,0,0,0
"Lithuania","2024-05-05",0,0,0,0,0,0,0,0
"Lithuania","2024-05-06",0,0,0,0,0,0,0,0
"Lithuania","2024-05-07",0,0,0,0,0,0,0,0
"Lithuania","2024-05-08",0,0,0,0,0,0,0,0
"Lithuania","2024-05-09",0,0,0,0,0,0,0,0
"Lithuania","2024-05-10",0,0,0,0,0,0,0,0
"Lithuania","2024-05-11",0,0,0,0,0,0,0,0
"Lithuania","2024-05-12",0,0,0,0,0,0,0,0
"Lithuania","2024-05-13",0,0,0,0,0,0,0,0
"Lithuania","2024-05-14",0,0,0,0,0,0,0,0
"Lithuania","2024-05-15",0,0,0,0,0,0,0,0
"Lithuania","2024-05-16",0,0,0,0,0,0,0,0
"Lithuania","2024-05-17",0,0,0,0,0,0,0,0
"Lithuania","2024-05-18",0,0,0,0,0,0,0,0
"Lithuania","2024-05-19",0,0,0,0,0,0,0,0
"Lithuania","2024-05-20",0,0,0,0,0,0,0,0
"Lithuania","2024-05-21",0,0,0,0,0,0,0,0
"Lithuania","2024-05-22",0,0,0,0,0,0,0,0
"Lithuania","2024-05-23",0,0,0,0,0,0,0,0
"Lithuania","2024-05-24",0,0,0,0,0,0,0,0
"Lithuania","2024-05-25",0,0,0,0,0,0,0,0
"Lithuania","2024-05-26",0,0,0,0,0,0,0,0
"Lithuania","2024-05-27",0,0,0,0,0,0,0,0
"Lithuania","2024-05-28",0,0,0,0,0,0,0,0
"Lithuania","2024-05-29",0,0,0,0,0,0,0,0
"Lithuania","2024-05-30",0,0,0,0,0,0,0,0
"Lithuania","2024-05-31",0,0,0,0,0,0,0,0
"Lithuania","2024-06-01",0,0,0,0,0,0,0,0
"Lithuania","2024-06-02",0,0,0,0,0,0,0,0
"Lithuania","2024-06-03",0,0,0,0,0,0,0,0
"Lithuania","2024-06-04",0,0,0,0,0,0,0,0
"Lithuania","2024-06-05",0,0,0,0,0,0,0,0
"Lithuania","2024-06-06",0,0,0,0,0,0,0,0
"Lithuania","2024-06-07",0,0,0,0,0,0,0,0
"Lithuania","2024-06-08",0,0,0,0,0,0,0,0
"Lithuania","2024-06-09",0,0,0,0,0,0,0,0
"Lithuania","2024-06-10",0,0,0,0,0,0,0,0
"Lithuania","2024-06-11",0,0,0,0,0,0,0,0
"Lithuania","2024-06-12",0,0,0,0,0,0,0,0
"Lithuania","2024-06-13",0,0,0,0,0,0,0,0
"Lithuania","2024-06-14",0,0,0,0,0,0,0,0
"Lithuania","2024-06-15",0,0,0,0,0,0,0,0
"Lithuania","2024-06-16",0,0,0,0,0,0,0,0
"Lithuania","2024-06-17",0,0,0,0,0,0,0,0
"Lithuania","2024-06-18",0,0,0,0,0,0,0,0
"Lithuania","2024-06-19",0,0,0,0,0,0,0,0
"Lithuania","2024-06-20",0,0,0,0,0,0,0,0
"Lithuania","2024-06-21",0,0,0,0,0,0,0,0
"Lithuania","2024-06-22",0,0,0,0,0,0,0,0
"Lithuania","2024-06-23",0,0,0,0,0,0,0,0
"Lithuania","2024-06-24",0,0,0,0,0,0,0,0
"Lithuania","2024-06-25",0,0,0,0,0,0,0,0
"Lithuania","2024-06-26",0,0,0,0,0,0,0,0
"Lithuania","2024-06-27",0,0,0,0,0,0,0,0
"Lithuania","2024-06-28",0,0,0,0,0,0,0,0
"Lithuania","2024-06-29",0,0,0,0,0,0,0,0
"Lithuania","2024-06-30",0,0,0,0,0,0,0,0
"Lithuania","2024-07-01",0,0,0,0,0,0,0,0
"Lithuania","2024-07-02",0,0,0,0,0,0,0,0
"Lithuania","2024-07-03",0,0,0,0,0,0,0,0
"Lithuania","2024-07-04",0,0,0,0,0,0,0,0
"Lithuania","2024-07-05",0,0,0,0,0,0,0,0
"Lithuania","2024-07-06",0,0,0,0,0,0,0,0
"Lithuania","2024-07-07",0,0,0,0,0,0,0,0
"Lithuania","2024-07-08",0,0,0,0,0,0,0,0
"Lithuania","2024-07-09",0,0,0,0,0,0,0,0
"Lithuania","2024-07-10",0,0,0,0,0,0,0,0
"Lithuania","2024-07-11",0,0,0,0,0,0,0,0
"Lithuania","2024-07-12",0,0,0,0,0,0,0,0
"Lithuania","2024-07-13",0,0,0,0,0,0,0,0
"Lithuania","2024-07-14",0,0,0,0,0,0,0,0
"Lithuania","2024-07-15",0,0,0,0,0,0,0,0
"Lithuania","2024-07-16",0,0,0,0,0,0,0,0
"Lithuania","2024-07-17",0,0,0,0,0,0,0,0
"Lithuania","2024-07-18",0,0,0,0,0,0,0,0
"Lithuania","2024-07-19",0,0,0,0,0,0,0,0
"Lithuania","2024-07-20",0,0,0,0,0,0,0,0
"Lithuania","2024-07-21",0,0,0,0,0,0,0,0
"Lithuania","2024-07-22",0,0,0,0,0,0,0,0
"Lithuania","2024-07-23",0,0,0,0,0,0,0,0
"Lithuania","2024-07-24",0,0,0,0,0,0,0,0
"Lithuania","2024-07-25",0,0,0,0,0,0,0,0
"Lithuania","2024-07-26",0,0,0,0,0,0,0,0
"Lithuania","2024-07-27",0,0,0,0,0,0,0,0
"Lithuania","2024-07-28",0,0,0,0,0,0,0,0
"Lithuania","2024-07-29",0,0,0,0,0,0,0,0
"Lithuania","2024-07-30",0,0,0,0,0,0,0,0
"Lithuania","2024-07-31",0,0,0,0,0,0,0,0
"Lithuania","2024-08-01",0,0,0,0,0,0,0,0
"Lithuania","2024-08-02",0,0,0,0,0,0,0,0
"Lithuania","2024-08-03",0,0,0,0,0,0,0,0
"Lithuania","2024-08-04",0,0,0,0,0,0,0,0
"Lithuania","2024-08-05",0,0,0,0,0,0,0,0
"Lithuania","2024-08-06",0,0,0,0,0,0,0,0
"Lithuania","2024-08-07",0,0,0,0,0,0,0,0
"Lithuania","2024-08-08",0,0,0,0,0,0,0,0
"Lithuania","2024-08-09",0,0,0,0,0,0,0,0
"Lithuania","2024-08-10",0,0,0,0,0,0,0,0
"Lithuania","2024-08-11",0,0,0,0,0,0,0,0
"Lithuania","2024-08-12",0,0,0,0,0,0,0,0
"Lithuania","2024-08-13",0,0,0,0,0,0,0,0
"Lithuania","2024-08-14",0,0,0,0,0,0,0,0
"Lithuania","2024-08-15",0,0,0,0,0,0,0,0
"Lithuania","2024-08-16",0,0,0,0,0,0,0,0
"Lithuania","2024-08-17",0,0,0,0,0,0,0,0
"Lithuania","2024-08-18",0,0,0,0,0,0,0,0
"Lithuania","2024-08-19",0,0,0,0,0,0,0,0
"Lithuania","2024-08-20",0,0,0,0,0,0,0,0
"Lithuania","2024-08-21",0,0,0,0,0,0,0,0
"Lithuania","2024-08-22",0,0,0,0,0,0,0,0
"Lithuania","2024-08-23",0,0,0,0,0,0,0,0
"Lithuania","2024-08-24",0,0,0,0,0,0,0,0
"Lithuania","2024-08-25",0,0,0,0,0,0,0,0
"Lithuania","2024-08-26",0,0,0,0,0,0,0,0
"Lithuania","2024-08-27",0,0,0,0,0,0,0,0
"Lithuania","2024-08-28",0,0,0,0,0,0,0,0
"Lithuania","2024-08-29",0,0,0,0,0,0,0,0
"Lithuania","2024-08-30",0,0,0,0,0,0,0,0
"Lithuania","2024-08-31",0,0,0,0,0,0,0,0
"Lithuania","2024-09-01",0,0,0,0,0,0,0,0
"Lithuania","2024-09-02",0,0,0,0,0,0,0,0
"Lithuania","2024-09-03",0,0,0,0,0,0,0,0
"Lithuania","2024-09-04",0,0,0,0,0,0,0,0
"Lithuania","2024-09-05",0,0,0,0,0,0,0,0
"Lithuania","2024-09-06",0,0,0,0,0,0,0,0
"Lithuania","2024-09-07",0,0,0,0,0,0,0,0
"Lithuania","2024-09-08",0,0,0,0,0,0,0,0
"Lithuania","2024-09-09",0,0,0,0,0,0,0,0
"Lithuania","2024-09-10",0,0,0,0,0,0,0,0
"Lithuania","2024-09-11",0,0,0,0,0,0,0,0
"Lithuania","2024-09-12",0,0,0,0,0,0,0,0
"Lithuania","2024-09-13",0,0,0,0,0,0,0,0
"Lithuania","2024-09-14",0,0,0,0,0,0,0,0
"Lithuania","2024-09-15",0,0,0,0,0,0,0,0
"Lithuania","2024-09-16",0,0,0,0,0,0,0,0
"Lithuania","2024-09-17",0,0,0,0,0,0,0,0
"Lithuania","2024-09-18",0,0,0,0,0,0,0,0
"Lithuania","2024-09-19",0,0,0,0,0,0,0,0
"Lithuania","2024-09-20",0,0,0,0,0,0,0,0
"Lithuania","2024-09-21",0,0,0,0,0,0,0,0
"Lithuania","2024-09-22",0,0,0,0,0,0,0,0
"Lithuania","2024-09-23",0,0,0,0,0,0,0,0
"Lithuania","2024-09-24",0,0,0,0,0,0,0,0
"Lithuania","2024-09-25",0,0,0,0,0,0,0,0
"Lithuania","2024-09-26",0,0,0,0,0,0,0,0
"Lithuania","2024-09-27",0,0,0,0,0,0,0,0
"Lithuania","2024-09-28",0,0,0,0,0,0,0,0
"Lithuania","2024-09-29",0,0,0,0,0,0,0,0
"Lithuania","2024-09-30",0,1,1,0,1,1,0,0
"Lithuania","2024-10-01",0,0,1,0,0,1,0,0
"Lithuania","2024-10-02",0,0,1,0,0,1,0,0
"Lithuania","2024-10-03",0,0,1,0,0,1,0,0
"Lithuania","2024-10-04",0,0,1,0,0,1,0,0
"Lithuania","2024-10-05",0,0,1,0,0,1,0,0
"Lithuania","2024-10-06",0,0,1,0,0,1,0,0
"Lithuania","2024-10-07",0,0,1,0,0,1,0,0
"Lithuania","2024-10-08",0,0,1,0,0,1,0,0
"Lithuania","2024-10-09",0,0,1,0,0,1,0,0
"Lithuania","2024-10-10",0,0,1,0,0,1,0,0
"Lithuania","2024-10-11",0,0,1,0,0,1,0,0
"Lithuania","2024-10-12",0,0,1,0,0,1,0,0
"Lithuania","2024-10-13",0,0,1,0,0,1,0,0
"Lithuania","2024-10-14",0,0,1,0,0,1,0,0
"Lithuania","2024-10-15",0,0,1,0,0,1,0,0
"Lithuania","2024-10-16",0,0,1,0,0,1,0,0
"Lithuania","2024-10-17",0,0,1,0,0,1,0,0
"Lithuania","2024-10-18",0,0,1,0,0,1,0,0
"Lithuania","2024-10-19",0,0,1,0,0,1,0,0
"Lithuania","2024-10-20",0,0,1,0,0,1,0,0
"Lithuania","2024-10-21",0,0,1,0,0,1,0,0
"Lithuania","2024-10-22",0,0,1,0,0,1,0,0
"Lithuania","2024-10-23",0,0,1,0,0,1,0,0
"Lithuania","2024-10-24",0,0,1,0,0,1,0,0
"Lithuania","2024-10-25",0,0,1,0,0,1,0,0
"Lithuania","2024-10-26",0,0,1,0,0,1,0,0
"Lithuania","2024-10-27",0,0,1,0,0,1,0,0
"Lithuania","2024-10-28",0,0,1,0,0,1,0,0
"Lithuania","2024-10-29",0,0,1,0,0,1,0,0
"Lithuania","2024-10-30",0,0,1,0,0,1,0,0
"Lithuania","2024-10-31",0,0,1,0,0,1,0,0
"Lithuania","2024-11-01",0,0,1,0,0,1,0,0
"Lithuania","2024-11-02",0,0,1,0,0,1,0,0
"Lithuania","2024-11-03",0,0,1,0,0,1,0,0
"Lithuania","2024-11-04",0,0,1,0,0,1,0,0
"Lithuania","2024-11-05",0,0,1,0,0,1,0,0
"Lithuania","2024-11-06",0,0,1,0,0,1,0,0
"Lithuania","2024-11-07",0,0,1,0,0,1,0,0
"Lithuania","2024-11-08",0,0,1,0,0,1,0,0
"Lithuania","2024-11-09",0,0,1,0,0,1,0,0
"Lithuania","2024-11-10",0,0,1,0,0,1,0,0
"Lithuania","2024-11-11",0,0,1,0,0,1,0,0
"Lithuania","2024-11-12",0,0,1,0,0,1,0,0
"Lithuania","2024-11-13",0,0,1,0,0,1,0,0
"Lithuania","2024-11-14",0,0,1,0,0,1,0,0
"Lithuania","2024-11-15",0,0,1,0,0,1,0,0
"Lithuania","2024-11-16",0,0,1,0,0,1,0,0
"Lithuania","2024-11-17",0,0,1,0,0,1,0,0
"Lithuania","2024-11-18",0,0,1,0,0,1,0,0
"Lithuania","2024-11-19",0,0,1,0,0,1,0,0
"Lithuania","2024-11-20",0,0,1,0,0,1,0,0
"Lithuania","2024-11-21",0,0,1,0,0,1,0,0
"Lithuania","2024-11-22",0,0,1,0,0,1,0,0
"Lithuania","2024-11-23",0,0,1,0,0,1,0,0
"Lithuania","2024-11-24",0,0,1,0,0,1,0,0
"Lithuania","2024-11-25",0,0,1,0,0,1,0,0
"Lithuania","2024-11-26",0,0,1,0,0,1,0,0
"Lithuania","2024-11-27",0,0,1,0,0,1,0,0
"Lithuania","2024-11-28",0,0,1,0,0,1,0,0
"Lithuania","2024-11-29",0,0,1,0,0,1,0,0
"Lithuania","2024-11-30",0,0,1,0,0,1,0,0
"Lithuania","2024-12-01",0,0,1,0,0,1,0,0
"Lithuania","2024-12-02",0,0,1,0,0,1,0,0
"Lithuania","2024-12-03",0,0,1,0,0,1,0,0
"Lithuania","2024-12-04",0,0,1,0,0,1,0,0
"Lithuania","2024-12-05",0,0,1,0,0,1,0,0
"Lithuania","2024-12-06",0,0,1,0,0,1,0,0
"Lithuania","2024-12-07",0,0,1,0,0,1,0,0
"Lithuania","2024-12-08",0,0,1,0,0,1,0,0
"Lithuania","2024-12-09",0,0,1,0,0,1,0,0
"Lithuania","2024-12-10",0,0,1,0,0,1,0,0
"Lithuania","2024-12-11",0,0,1,0,0,1,0,0
"Lithuania","2024-12-12",0,0,1,0,0,1,0,0
"Lithuania","2024-12-13",0,0,1,0,0,1,0,0
"Lithuania","2024-12-14",0,0,1,0,0,1,0,0
"Lithuania","2024-12-15",0,0,1,0,0,1,0,0
"Lithuania","2024-12-16",0,0,1,0,0,1,0,0
"Lithuania","2024-12-17",0,0,1,0,0,1,0,0
"Lithuania","2024-12-18",0,0,1,0,0,1,0,0
"Lithuania","2024-12-19",0,0,1,0,0,1,0,0
"Lithuania","2024-12-20",0,0,1,0,0,1,0,0
"Lithuania","2024-12-21",0,0,1,0,0,1,0,0
"Lithuania","2024-12-22",0,0,1,0,0,1,0,0
"Lithuania","2024-12-23",0,0,1,0,0,1,0,0
"Lithuania","2024-12-24",0,0,1,0,0,1,0,0
"Lithuania","2024-12-25",0,0,1,0,0,1,0,0
"Lithuania","2024-12-26",0,0,1,0,0,1,0,0
"Lithuania","2024-12-27",0,0,1,0,0,1,0,0
"Lithuania","2024-12-28",0,0,1,0,0,1,0,0
"Lithuania","2024-12-29",0,0,1,0,0,1,0,0
"Lithuania","2024-12-30",0,0,1,0,0,1,0,0
"Lithuania","2024-12-31",0,0,1,0,0,1,0,0
"Lithuania","2025-01-01",0,0,1,0,0,1,0,0
"Lithuania","2025-01-02",0,0,1,0,0,1,0,0
"Lithuania","2025-01-03",0,0,1,0,0,1,0,0
"Lithuania","2025-01-04",0,0,1,0,0,1,0,0
"Lithuania","2025-01-05",0,0,1,0,0,1,0,0
"Lithuania","2025-01-06",0,0,1,0,0,1,0,0
"Lithuania","2025-01-07",0,0,1,0,0,1,0,0
"Lithuania","2025-01-08",0,0,1,0,0,1,0,0
"Lithuania","2025-01-09",0,0,1,0,0,1,0,0
"Lithuania","2025-01-10",0,0,1,0,0,1,0,0
"Lithuania","2025-01-11",0,0,1,0,0,1,0,0
"Lithuania","2025-01-12",0,0,1,0,0,1,0,0
"Lithuania","2025-01-13",0,0,1,0,0,1,0,0
"Luxembourg","2024-01-01",0,0,0,0,0,0,0,0
"Luxembourg","2024-01-02",0,0,0,0,0,0,0,0
"Luxembourg","2024-01-03",0,0,0,0,0,0,0,0
"Luxembourg","2024-01-04",0,0,0,0,0,0,0,0
"Luxembourg","2024-01-05",0,0,0,0,0,0,0,0
"Luxembourg","2024-01-06",0,0,0,0,0,0,0,0
"Luxembourg","2024-01-07",0,0,0,0,0,0,0,0
"Luxembourg","2024-01-08",0,0,0,0,0,0,0,0
"Luxembourg","2024-01-09",0,0,0,0,0,0,0,0
"Luxembourg","2024-01-10",0,0,0,0,0,0,0,0
"Luxembourg","2024-01-11",0,0,0,0,0,0,0,0
"Luxembourg","2024-01-12",0,0,0,0,0,0,0,0
"Luxembourg","2024-01-13",0,0,0,0,0,0,0,0
"Luxembourg","2024-01-14",0,0,0,0,0,0,0,0
"Luxembourg","2024-01-15",0,0,0,0,0,0,0,0
"Luxembourg","2024-01-16",0,0,0,0,0,0,0,0
"Luxembourg","2024-01-17",0,0,0,0,0,0,0,0
"Luxembourg","2024-01-18",0,0,0,0,0,0,0,0
"Luxembourg","2024-01-19",0,0,0,0,0,0,0,0
"Luxembourg","2024-01-20",0,0,0,0,0,0,0,0
"Luxembourg","2024-01-21",0,0,0,0,0,0,0,0
"Luxembourg","2024-01-22",0,0,0,0,0,0,0,0
"Luxembourg","2024-01-23",0,0,0,0,0,0,0,0
"Luxembourg","2024-01-24",0,0,0,0,0,0,0,0
"Luxembourg","2024-01-25",0,0,0,0,0,0,0,0
"Luxembourg","2024-01-26",0,0,0,0,0,0,0,0
"Luxembourg","2024-01-27",0,0,0,0,0,0,0,0
"Luxembourg","2024-01-28",0,0,0,0,0,0,0,0
"Luxembourg","2024-01-29",0,0,0,0,0,0,0,0
"Luxembourg","2024-01-30",0,0,0,0,0,0,0,0
"Luxembourg","2024-01-31",0,0,0,0,0,0,0,0
"Luxembourg","2024-02-01",0,0,0,0,0,0,0,0
"Luxembourg","2024-02-02",0,0,0,0,0,0,0,0
"Luxembourg","2024-02-03",0,0,0,0,0,0,0,0
"Luxembourg","2024-02-04",0,0,0,0,0,0,0,0
"Luxembourg","2024-02-05",0,0,0,0,0,0,0,0
"Luxembourg","2024-02-06",0,0,0,0,0,0,0,0
"Luxembourg","2024-02-07",0,0,0,0,0,0,0,0
"Luxembourg","2024-02-08",0,0,0,0,0,0,0,0
"Luxembourg","2024-02-09",0,0,0,0,0,0,0,0
"Luxembourg","2024-02-10",0,0,0,0,0,0,0,0
"Luxembourg","2024-02-11",0,0,0,0,0,0,0,0
"Luxembourg","2024-02-12",0,0,0,0,0,0,0,0
"Luxembourg","2024-02-13",0,0,0,0,0,0,0,0
"Luxembourg","2024-02-14",0,0,0,0,0,0,0,0
"Luxembourg","2024-02-15",0,0,0,0,0,0,0,0
"Luxembourg","2024-02-16",0,0,0,0,0,0,0,0
"Luxembourg","2024-02-17",0,0,0,0,0,0,0,0
"Luxembourg","2024-02-18",0,0,0,0,0,0,0,0
"Luxembourg","2024-02-19",0,0,0,0,0,0,0,0
"Luxembourg","2024-02-20",0,0,0,0,0,0,0,0
"Luxembourg","2024-02-21",0,0,0,0,0,0,0,0
"Luxembourg","2024-02-22",0,0,0,0,0,0,0,0
"Luxembourg","2024-02-23",0,0,0,0,0,0,0,0
"Luxembourg","2024-02-24",0,0,0,0,0,0,0,0
"Luxembourg","2024-02-25",0,0,0,0,0,0,0,0
"Luxembourg","2024-02-26",0,0,0,0,0,0,0,0
"Luxembourg","2024-02-27",0,0,0,0,0,0,0,0
"Luxembourg","2024-02-28",0,0,0,0,0,0,0,0
"Luxembourg","2024-02-29",0,1,1,0,1,1,0,0
"Luxembourg","2024-03-01",0,0,1,0,0,1,0,0
"Luxembourg","2024-03-02",0,0,1,0,0,1,0,0
"Luxembourg","2024-03-03",0,0,1,0,0,1,0,0
"Luxembourg","2024-03-04",0,0,1,0,0,1,0,0
"Luxembourg","2024-03-05",0,0,1,0,0,1,0,0
"Luxembourg","2024-03-06",0,0,1,0,0,1,0,0
"Luxembourg","2024-03-07",0,0,1,0,0,1,0,0
"Luxembourg","2024-03-08",0,0,1,0,0,1,0,0
"Luxembourg","2024-03-09",0,0,1,0,0,1,0,0
"Luxembourg","2024-03-10",0,0,1,0,0,1,0,0
"Luxembourg","2024-03-11",0,0,1,0,0,1,0,0
"Luxembourg","2024-03-12",0,0,1,0,0,1,0,0
"Luxembourg","2024-03-13",0,0,1,0,0,1,0,0
"Luxembourg","2024-03-14",0,0,1,0,0,1,0,0
"Luxembourg","2024-03-15",0,0,1,0,0,1,0,0
"Luxembourg","2024-03-16",0,0,1,0,0,1,0,0
"Luxembourg","2024-03-17",0,0,1,0,0,1,0,0
"Luxembourg","2024-03-18",0,0,1,0,0,1,0,0
"Luxembourg","2024-03-19",0,0,1,0,0,1,0,0
"Luxembourg","2024-03-20",0,0,1,0,0,1,0,0
"Luxembourg","2024-03-21",0,0,1,0,0,1,0,0
"Luxembourg","2024-03-22",0,0,1,0,0,1,0,0
"Luxembourg","2024-03-23",0,0,1,0,0,1,0,0
"Luxembourg","2024-03-24",0,0,1,0,0,1,0,0
"Luxembourg","2024-03-25",0,0,1,0,0,1,0,0
"Luxembourg","2024-03-26",0,0,1,0,0,1,0,0
"Luxembourg","2024-03-27",0,0,1,0,0,1,0,0
"Luxembourg","2024-03-28",0,0,1,0,0,1,0,0
"Luxembourg","2024-03-29",0,0,1,0,0,1,0,0
"Luxembourg","2024-03-30",0,0,1,0,0,1,0,0
"Luxembourg","2024-03-31",0,0,1,0,0,1,0,0
"Luxembourg","2024-04-01",0,0,1,0,0,1,0,0
"Luxembourg","2024-04-02",0,0,1,0,0,1,0,0
"Luxembourg","2024-04-03",0,0,1,0,0,1,0,0
"Luxembourg","2024-04-04",0,0,1,0,0,1,0,0
"Luxembourg","2024-04-05",0,0,1,0,0,1,0,0
"Luxembourg","2024-04-06",0,0,1,0,0,1,0,0
"Luxembourg","2024-04-07",0,0,1,0,0,1,0,0
"Luxembourg","2024-04-08",0,0,1,0,0,1,0,0
"Luxembourg","2024-04-09",0,0,1,0,0,1,0,0
"Luxembourg","2024-04-10",0,0,1,0,0,1,0,0
"Luxembourg","2024-04-11",0,0,1,0,0,1,0,0
"Luxembourg","2024-04-12",0,0,1,0,0,1,0,0
"Luxembourg","2024-04-13",0,0,1,0,0,1,0,0
"Luxembourg","2024-04-14",0,0,1,0,0,1,0,0
"Luxembourg","2024-04-15",0,0,1,0,0,1,0,0
"Luxembourg","2024-04-16",0,0,1,0,0,1,0,0
"Luxembourg","2024-04-17",0,0,1,0,0,1,0,0
"Luxembourg","2024-04-18",0,0,1,0,0,1,0,0
"Luxembourg","2024-04-19",0,0,1,0,0,1,0,0
"Luxembourg","2024-04-20",0,0,1,0,0,1,0,0
"Luxembourg","2024-04-21",0,0,1,0,0,1,0,0
"Luxembourg","2024-04-22",0,0,1,0,0,1,0,0
"Luxembourg","2024-04-23",0,0,1,0,0,1,0,0
"Luxembourg","2024-04-24",0,0,1,0,0,1,0,0
"Luxembourg","2024-04-25",0,0,1,0,0,1,0,0
"Luxembourg","2024-04-26",0,0,1,0,0,1,0,0
"Luxembourg","2024-04-27",0,0,1,0,0,1,0,0
"Luxembourg","2024-04-28",0,0,1,0,0,1,0,0
"Luxembourg","2024-04-29",0,0,1,0,0,1,0,0
"Luxembourg","2024-04-30",0,0,1,0,0,1,0,0
"Luxembourg","2024-05-01",0,0,1,0,0,1,0,0
"Luxembourg","2024-05-02",0,0,1,0,0,1,0,0
"Luxembourg","2024-05-03",0,0,1,0,0,1,0,0
"Luxembourg","2024-05-04",0,0,1,0,0,1,0,0
"Luxembourg","2024-05-05",0,0,1,0,0,1,0,0
"Luxembourg","2024-05-06",0,0,1,0,0,1,0,0
"Luxembourg","2024-05-07",0,0,1,0,0,1,0,0
"Luxembourg","2024-05-08",0,0,1,0,0,1,0,0
"Luxembourg","2024-05-09",0,0,1,0,0,1,0,0
"Luxembourg","2024-05-10",0,0,1,0,0,1,0,0
"Luxembourg","2024-05-11",0,0,1,0,0,1,0,0
"Luxembourg","2024-05-12",0,0,1,0,0,1,0,0
"Luxembourg","2024-05-13",0,0,1,0,0,1,0,0
"Luxembourg","2024-05-14",0,0,1,0,0,1,0,0
"Luxembourg","2024-05-15",0,0,1,0,0,1,0,0
"Luxembourg","2024-05-16",0,0,1,0,0,1,0,0
"Luxembourg","2024-05-17",0,0,1,0,0,1,0,0
"Luxembourg","2024-05-18",0,0,1,0,0,1,0,0
"Luxembourg","2024-05-19",0,0,1,0,0,1,0,0
"Luxembourg","2024-05-20",0,0,1,0,0,1,0,0
"Luxembourg","2024-05-21",0,0,1,0,0,1,0,0
"Luxembourg","2024-05-22",0,0,1,0,0,1,0,0
"Luxembourg","2024-05-23",0,0,1,0,0,1,0,0
"Luxembourg","2024-05-24",0,0,1,0,0,1,0,0
"Luxembourg","2024-05-25",0,0,1,0,0,1,0,0
"Luxembourg","2024-05-26",0,0,1,0,0,1,0,0
"Luxembourg","2024-05-27",0,0,1,0,0,1,0,0
"Luxembourg","2024-05-28",0,0,1,0,0,1,0,0
"Luxembourg","2024-05-29",0,0,1,0,0,1,0,0
"Luxembourg","2024-05-30",0,0,1,0,0,1,0,0
"Luxembourg","2024-05-31",0,0,1,0,0,1,0,0
"Luxembourg","2024-06-01",0,0,1,0,0,1,0,0
"Luxembourg","2024-06-02",0,0,1,0,0,1,0,0
"Luxembourg","2024-06-03",0,0,1,0,0,1,0,0
"Luxembourg","2024-06-04",0,0,1,0,0,1,0,0
"Luxembourg","2024-06-05",0,0,1,0,0,1,0,0
"Luxembourg","2024-06-06",0,0,1,0,0,1,0,0
"Luxembourg","2024-06-07",0,0,1,0,0,1,0,0
"Luxembourg","2024-06-08",0,0,1,0,0,1,0,0
"Luxembourg","2024-06-09",0,0,1,0,0,1,0,0
"Luxembourg","2024-06-10",0,0,1,0,0,1,0,0
"Luxembourg","2024-06-11",0,0,1,0,0,1,0,0
"Luxembourg","2024-06-12",0,0,1,0,0,1,0,0
"Luxembourg","2024-06-13",0,0,1,0,0,1,0,0
"Luxembourg","2024-06-14",0,0,1,0,0,1,0,0
"Luxembourg","2024-06-15",0,0,1,0,0,1,0,0
"Luxembourg","2024-06-16",0,0,1,0,0,1,0,0
"Luxembourg","2024-06-17",0,0,1,0,0,1,0,0
"Luxembourg","2024-06-18",0,0,1,0,0,1,0,0
"Luxembourg","2024-06-19",0,0,1,0,0,1,0,0
"Luxembourg","2024-06-20",0,0,1,0,0,1,0,0
"Luxembourg","2024-06-21",0,0,1,0,0,1,0,0
"Luxembourg","2024-06-22",0,0,1,0,0,1,0,0
"Luxembourg","2024-06-23",0,0,1,0,0,1,0,0
"Luxembourg","2024-06-24",0,0,1,0,0,1,0,0
"Luxembourg","2024-06-25",0,0,1,0,0,1,0,0
"Luxembourg","2024-06-26",0,0,1,0,0,1,0,0
"Luxembourg","2024-06-27",0,0,1,0,0,1,0,0
"Luxembourg","2024-06-28",0,0,1,0,0,1,0,0
"Luxembourg","2024-06-29",0,0,1,0,0,1,0,0
"Luxembourg","2024-06-30",0,0,1,0,0,1,0,0
"Luxembourg","2024-07-01",0,0,1,0,1,2,0,0
"Luxembourg","2024-07-02",0,0,1,0,0,2,0,0
"Luxembourg","2024-07-03",0,0,1,0,0,2,0,0
"Luxembourg","2024-07-04",0,0,1,0,0,2,0,0
"Luxembourg","2024-07-05",0,0,1,0,0,2,0,0
"Luxembourg","2024-07-06",0,0,1,0,0,2,0,0
"Luxembourg","2024-07-07",0,0,1,0,0,2,0,0
"Luxembourg","2024-07-08",0,0,1,0,0,2,0,0
"Luxembourg","2024-07-09",0,0,1,0,0,2,0,0
"Luxembourg","2024-07-10",0,0,1,0,0,2,0,0
"Luxembourg","2024-07-11",0,0,1,0,0,2,0,0
"Luxembourg","2024-07-12",0,0,1,0,0,2,0,0
"Luxembourg","2024-07-13",0,0,1,0,0,2,0,0
"Luxembourg","2024-07-14",0,0,1,0,0,2,0,0
"Luxembourg","2024-07-15",0,0,1,0,0,2,0,0
"Luxembourg","2024-07-16",0,0,1,0,0,2,0,0
"Luxembourg","2024-07-17",0,0,1,0,0,2,0,0
"Luxembourg","2024-07-18",0,0,1,0,0,2,0,0
"Luxembourg","2024-07-19",0,0,1,0,0,2,0,0
"Luxembourg","2024-07-20",0,0,1,0,0,2,0,0
"Luxembourg","2024-07-21",0,0,1,0,0,2,0,0
"Luxembourg","2024-07-22",0,0,1,0,0,2,0,0
"Luxembourg","2024-07-23",0,0,1,0,0,2,0,0
"Luxembourg","2024-07-24",0,0,1,0,0,2,0,0
"Luxembourg","2024-07-25",0,0,1,0,0,2,0,0
"Luxembourg","2024-07-26",0,0,1,0,0,2,0,0
"Luxembourg","2024-07-27",0,0,1,0,0,2,0,0
"Luxembourg","2024-07-28",0,0,1,0,0,2,0,0
"Luxembourg","2024-07-29",0,0,1,0,0,2,0,0
"Luxembourg","2024-07-30",0,0,1,0,0,2,0,0
"Luxembourg","2024-07-31",0,0,1,0,0,2,0,0
"Luxembourg","2024-08-01",0,0,1,0,0,2,0,0
"Luxembourg","2024-08-02",0,0,1,0,0,2,0,0
"Luxembourg","2024-08-03",0,0,1,0,0,2,0,0
"Luxembourg","2024-08-04",0,0,1,0,0,2,0,0
"Luxembourg","2024-08-05",0,0,1,0,0,2,0,0
"Luxembourg","2024-08-06",0,0,1,0,0,2,0,0
"Luxembourg","2024-08-07",0,0,1,0,0,2,0,0
"Luxembourg","2024-08-08",0,0,1,0,0,2,0,0
"Luxembourg","2024-08-09",0,0,1,0,0,2,0,0
"Luxembourg","2024-08-10",0,0,1,0,0,2,0,0
"Luxembourg","2024-08-11",0,0,1,0,0,2,0,0
"Luxembourg","2024-08-12",0,0,1,0,0,2,0,0
"Luxembourg","2024-08-13",0,0,1,0,0,2,0,0
"Luxembourg","2024-08-14",0,0,1,0,0,2,0,0
"Luxembourg","2024-08-15",0,0,1,0,0,2,0,0
"Luxembourg","2024-08-16",0,0,1,0,0,2,0,0
"Luxembourg","2024-08-17",0,0,1,0,0,2,0,0
"Luxembourg","2024-08-18",0,0,1,0,0,2,0,0
"Luxembourg","2024-08-19",0,0,1,0,0,2,0,0
"Luxembourg","2024-08-20",0,0,1,0,0,2,0,0
"Luxembourg","2024-08-21",0,0,1,0,0,2,0,0
"Luxembourg","2024-08-22",0,0,1,0,0,2,0,0
"Luxembourg","2024-08-23",0,0,1,0,0,2,0,0
"Luxembourg","2024-08-24",0,0,1,0,0,2,0,0
"Luxembourg","2024-08-25",0,0,1,0,0,2,0,0
"Luxembourg","2024-08-26",0,0,1,0,0,2,0,0
"Luxembourg","2024-08-27",0,0,1,0,0,2,0,0
"Luxembourg","2024-08-28",0,0,1,0,0,2,0,0
"Luxembourg","2024-08-29",0,0,1,0,0,2,0,0
"Luxembourg","2024-08-30",0,0,1,0,0,2,0,0
"Luxembourg","2024-08-31",0,0,1,0,0,2,0,0
"Luxembourg","2024-09-01",0,0,1,0,0,2,0,0
"Luxembourg","2024-09-02",0,0,1,0,0,2,0,0
"Luxembourg","2024-09-03",0,0,1,0,0,2,0,0
"Luxembourg","2024-09-04",0,0,1,0,0,2,0,0
"Luxembourg","2024-09-05",0,0,1,0,0,2,0,0
"Luxembourg","2024-09-06",0,0,1,0,0,2,0,0
"Luxembourg","2024-09-07",0,0,1,0,0,2,0,0
"Luxembourg","2024-09-08",0,0,1,0,0,2,0,0
"Luxembourg","2024-09-09",0,0,1,0,0,2,0,0
"Luxembourg","2024-09-10",0,0,1,0,0,2,0,0
"Luxembourg","2024-09-11",0,0,1,0,0,2,0,0
"Luxembourg","2024-09-12",0,0,1,0,0,2,0,0
"Luxembourg","2024-09-13",0,0,1,0,0,2,0,0
"Luxembourg","2024-09-14",0,0,1,0,0,2,0,0
"Luxembourg","2024-09-15",0,0,1,0,0,2,0,0
"Luxembourg","2024-09-16",0,0,1,0,0,2,0,0
"Luxembourg","2024-09-17",0,0,1,0,0,2,0,0
"Luxembourg","2024-09-18",0,0,1,0,0,2,0,0
"Luxembourg","2024-09-19",0,0,1,0,0,2,0,0
"Luxembourg","2024-09-20",0,0,1,0,0,2,0,0
"Luxembourg","2024-09-21",0,0,1,0,0,2,0,0
"Luxembourg","2024-09-22",0,0,1,0,0,2,0,0
"Luxembourg","2024-09-23",0,0,1,0,0,2,0,0
"Luxembourg","2024-09-24",0,0,1,0,0,2,0,0
"Luxembourg","2024-09-25",0,0,1,0,0,2,0,0
"Luxembourg","2024-09-26",0,0,1,0,0,2,0,0
"Luxembourg","2024-09-27",0,0,1,0,0,2,0,0
"Luxembourg","2024-09-28",0,0,1,0,0,2,0,0
"Luxembourg","2024-09-29",0,0,1,0,0,2,0,0
"Luxembourg","2024-09-30",0,0,1,0,0,2,0,0
"Luxembourg","2024-10-01",0,0,1,0,0,2,0,0
"Luxembourg","2024-10-02",0,0,1,0,0,2,0,0
"Luxembourg","2024-10-03",0,0,1,0,0,2,0,0
"Luxembourg","2024-10-04",0,0,1,0,0,2,0,0
"Luxembourg","2024-10-05",0,0,1,0,0,2,0,0
"Luxembourg","2024-10-06",0,0,1,0,0,2,0,0
"Luxembourg","2024-10-07",0,0,1,0,0,2,0,0
"Luxembourg","2024-10-08",0,0,1,0,0,2,0,0
"Luxembourg","2024-10-09",0,0,1,0,0,2,0,0
"Luxembourg","2024-10-10",0,0,1,0,0,2,0,0
"Luxembourg","2024-10-11",0,0,1,0,0,2,0,0
"Luxembourg","2024-10-12",0,0,1,0,0,2,0,0
"Luxembourg","2024-10-13",0,0,1,0,0,2,0,0
"Luxembourg","2024-10-14",0,0,1,0,0,2,0,0
"Luxembourg","2024-10-15",0,0,1,0,0,2,0,0
"Luxembourg","2024-10-16",0,0,1,0,0,2,0,0
"Luxembourg","2024-10-17",0,0,1,0,0,2,0,0
"Luxembourg","2024-10-18",0,0,1,0,0,2,0,0
"Luxembourg","2024-10-19",0,0,1,0,0,2,0,0
"Luxembourg","2024-10-20",0,0,1,0,0,2,0,0
"Luxembourg","2024-10-21",0,0,1,0,0,2,0,0
"Luxembourg","2024-10-22",0,0,1,0,0,2,0,0
"Luxembourg","2024-10-23",0,0,1,0,0,2,0,0
"Luxembourg","2024-10-24",0,0,1,0,0,2,0,0
"Luxembourg","2024-10-25",0,0,1,0,0,2,0,0
"Luxembourg","2024-10-26",0,0,1,0,0,2,0,0
"Luxembourg","2024-10-27",0,0,1,0,0,2,0,0
"Luxembourg","2024-10-28",0,0,1,0,0,2,0,0
"Luxembourg","2024-10-29",0,0,1,0,0,2,0,0
"Luxembourg","2024-10-30",0,0,1,0,0,2,0,0
"Luxembourg","2024-10-31",0,1,2,0,0,2,0,0
"Luxembourg","2024-11-01",0,0,2,0,0,2,0,0
"Luxembourg","2024-11-02",0,0,2,0,0,2,0,0
"Luxembourg","2024-11-03",0,0,2,0,0,2,0,0
"Luxembourg","2024-11-04",0,0,2,0,0,2,0,0
"Luxembourg","2024-11-05",0,0,2,0,0,2,0,0
"Luxembourg","2024-11-06",0,0,2,0,0,2,0,0
"Luxembourg","2024-11-07",0,0,2,0,0,2,0,0
"Luxembourg","2024-11-08",0,0,2,0,0,2,0,0
"Luxembourg","2024-11-09",0,0,2,0,0,2,0,0
"Luxembourg","2024-11-10",0,0,2,0,0,2,0,0
"Luxembourg","2024-11-11",0,0,2,0,0,2,0,0
"Luxembourg","2024-11-12",0,0,2,0,0,2,0,0
"Luxembourg","2024-11-13",0,0,2,0,0,2,0,0
"Luxembourg","2024-11-14",0,0,2,0,0,2,0,0
"Luxembourg","2024-11-15",0,0,2,0,0,2,0,0
"Luxembourg","2024-11-16",0,0,2,0,0,2,0,0
"Luxembourg","2024-11-17",0,0,2,0,0,2,0,0
"Luxembourg","2024-11-18",0,0,2,0,0,2,0,0
"Luxembourg","2024-11-19",0,0,2,0,0,2,0,0
"Luxembourg","2024-11-20",0,0,2,0,0,2,0,0
"Luxembourg","2024-11-21",0,0,2,0,0,2,0,0
"Luxembourg","2024-11-22",0,0,2,0,0,2,0,0
"Luxembourg","2024-11-23",0,0,2,0,0,2,0,0
"Luxembourg","2024-11-24",0,0,2,0,0,2,0,0
"Luxembourg","2024-11-25",0,0,2,0,0,2,0,0
"Luxembourg","2024-11-26",0,0,2,0,0,2,0,0
"Luxembourg","2024-11-27",0,0,2,0,0,2,0,0
"Luxembourg","2024-11-28",0,0,2,0,0,2,0,0
"Luxembourg","2024-11-29",0,0,2,0,0,2,0,0
"Luxembourg","2024-11-30",0,0,2,0,0,2,0,0
"Luxembourg","2024-12-01",0,0,2,0,0,2,0,0
"Luxembourg","2024-12-02",0,0,2,0,0,2,0,0
"Luxembourg","2024-12-03",0,0,2,0,0,2,0,0
"Luxembourg","2024-12-04",0,0,2,0,0,2,0,0
"Luxembourg","2024-12-05",0,0,2,0,0,2,0,0
"Luxembourg","2024-12-06",0,0,2,0,0,2,0,0
"Luxembourg","2024-12-07",0,0,2,0,0,2,0,0
"Luxembourg","2024-12-08",0,0,2,0,0,2,0,0
"Luxembourg","2024-12-09",0,0,2,0,0,2,0,0
"Luxembourg","2024-12-10",0,0,2,0,0,2,0,0
"Luxembourg","2024-12-11",0,0,2,0,0,2,0,0
"Luxembourg","2024-12-12",0,0,2,0,0,2,0,0
"Luxembourg","2024-12-13",0,0,2,0,0,2,0,0
"Luxembourg","2024-12-14",0,0,2,0,0,2,0,0
"Luxembourg","2024-12-15",0,0,2,0,0,2,0,0
"Luxembourg","2024-12-16",0,0,2,0,0,2,0,0
"Luxembourg","2024-12-17",0,0,2,0,0,2,0,0
"Luxembourg","2024-12-18",0,0,2,0,0,2,0,0
"Luxembourg","2024-12-19",0,0,2,0,0,2,0,0
"Luxembourg","2024-12-20",0,0,2,0,0,2,0,0
"Luxembourg","2024-12-21",0,0,2,0,0,2,0,0
"Luxembourg","2024-12-22",0,0,2,0,0,2,0,0
"Luxembourg","2024-12-23",0,0,2,0,0,2,0,0
"Luxembourg","2024-12-24",0,0,2,0,0,2,0,0
"Luxembourg","2024-12-25",0,0,2,0,0,2,0,0
"Luxembourg","2024-12-26",0,0,2,0,0,2,0,0
"Luxembourg","2024-12-27",0,0,2,0,0,2,0,0
"Luxembourg","2024-12-28",0,0,2,0,0,2,0,0
"Luxembourg","2024-12-29",0,0,2,0,0,2,0,0
"Luxembourg","2024-12-30",0,0,2,0,0,2,0,0
"Luxembourg","2024-12-31",0,0,2,0,0,2,0,0
"Luxembourg","2025-01-01",0,0,2,0,0,2,0,0
"Luxembourg","2025-01-02",0,0,2,0,0,2,0,0
"Luxembourg","2025-01-03",0,0,2,0,0,2,0,0
"Luxembourg","2025-01-04",0,0,2,0,0,2,0,0
"Luxembourg","2025-01-05",0,0,2,0,0,2,0,0
"Luxembourg","2025-01-06",0,0,2,0,0,2,0,0
"Luxembourg","2025-01-07",0,0,2,0,0,2,0,0
"Luxembourg","2025-01-08",0,0,2,0,0,2,0,0
"Luxembourg","2025-01-09",0,0,2,0,0,2,0,0
"Luxembourg","2025-01-10",0,0,2,0,0,2,0,0
"Luxembourg","2025-01-11",0,0,2,0,0,2,0,0
"Luxembourg","2025-01-12",0,0,2,0,0,2,0,0
"Luxembourg","2025-01-13",0,0,2,0,0,2,0,0
"Malaysia","2024-01-01",0,0,0,0,0,0,0,0
"Malaysia","2024-01-02",0,0,0,0,0,0,0,0
"Malaysia","2024-01-03",0,0,0,0,0,0,0,0
"Malaysia","2024-01-04",0,0,0,0,0,0,0,0
"Malaysia","2024-01-05",0,0,0,0,0,0,0,0
"Malaysia","2024-01-06",0,0,0,0,0,0,0,0
"Malaysia","2024-01-07",0,0,0,0,0,0,0,0
"Malaysia","2024-01-08",0,0,0,0,0,0,0,0
"Malaysia","2024-01-09",0,0,0,0,0,0,0,0
"Malaysia","2024-01-10",0,0,0,0,0,0,0,0
"Malaysia","2024-01-11",0,0,0,0,0,0,0,0
"Malaysia","2024-01-12",0,0,0,0,0,0,0,0
"Malaysia","2024-01-13",0,0,0,0,0,0,0,0
"Malaysia","2024-01-14",0,0,0,0,0,0,0,0
"Malaysia","2024-01-15",0,0,0,0,0,0,0,0
"Malaysia","2024-01-16",0,0,0,0,0,0,0,0
"Malaysia","2024-01-17",0,0,0,0,0,0,0,0
"Malaysia","2024-01-18",0,0,0,0,0,0,0,0
"Malaysia","2024-01-19",0,0,0,0,0,0,0,0
"Malaysia","2024-01-20",0,0,0,0,0,0,0,0
"Malaysia","2024-01-21",0,0,0,0,0,0,0,0
"Malaysia","2024-01-22",0,0,0,0,0,0,0,0
"Malaysia","2024-01-23",0,0,0,0,0,0,0,0
"Malaysia","2024-01-24",0,0,0,0,0,0,0,0
"Malaysia","2024-01-25",0,0,0,0,0,0,0,0
"Malaysia","2024-01-26",0,0,0,0,0,0,0,0
"Malaysia","2024-01-27",0,0,0,0,0,0,0,0
"Malaysia","2024-01-28",0,0,0,0,0,0,0,0
"Malaysia","2024-01-29",0,0,0,0,0,0,0,0
"Malaysia","2024-01-30",0,0,0,0,0,0,0,0
"Malaysia","2024-01-31",0,0,0,0,0,0,0,0
"Malaysia","2024-02-01",0,0,0,0,0,0,0,0
"Malaysia","2024-02-02",0,0,0,0,0,0,0,0
"Malaysia","2024-02-03",0,0,0,0,0,0,0,0
"Malaysia","2024-02-04",0,0,0,0,0,0,0,0
"Malaysia","2024-02-05",0,0,0,0,0,0,0,0
"Malaysia","2024-02-06",0,0,0,0,0,0,0,0
"Malaysia","2024-02-07",0,0,0,0,0,0,0,0
"Malaysia","2024-02-08",0,0,0,0,0,0,0,0
"Malaysia","2024-02-09",0,0,0,0,0,0,0,0
"Malaysia","2024-02-10",0,0,0,0,0,0,0,0
"Malaysia","2024-02-11",0,0,0,0,0,0,0,0
"Malaysia","2024-02-12",0,0,0,0,0,0,0,0
"Malaysia","2024-02-13",0,0,0,0,0,0,0,0
"Malaysia","2024-02-14",0,0,0,0,0,0,0,0
"Malaysia","2024-02-15",0,0,0,0,0,0,0,0
"Malaysia","2024-02-16",0,0,0,0,0,0,0,0
"Malaysia","2024-02-17",0,0,0,0,0,0,0,0
"Malaysia","2024-02-18",0,0,0,0,0,0,0,0
"Malaysia","2024-02-19",0,0,0,0,0,0,0,0
"Malaysia","2024-02-20",0,0,0,0,0,0,0,0
"Malaysia","2024-02-21",0,0,0,0,0,0,0,0
"Malaysia","2024-02-22",0,0,0,0,0,0,0,0
"Malaysia","2024-02-23",0,0,0,0,0,0,0,0
"Malaysia","2024-02-24",0,0,0,0,0,0,0,0
"Malaysia","2024-02-25",0,0,0,0,0,0,0,0
"Malaysia","2024-02-26",0,0,0,0,0,0,0,0
"Malaysia","2024-02-27",0,0,0,0,0,0,0,0
"Malaysia","2024-02-28",0,0,0,0,0,0,0,0
"Malaysia","2024-02-29",0,0,0,0,0,0,0,0
"Malaysia","2024-03-01",0,0,0,0,0,0,0,0
"Malaysia","2024-03-02",0,0,0,0,0,0,0,0
"Malaysia","2024-03-03",0,0,0,0,0,0,0,0
"Malaysia","2024-03-04",0,0,0,0,0,0,0,0
"Malaysia","2024-03-05",0,0,0,0,0,0,0,0
"Malaysia","2024-03-06",0,0,0,0,0,0,0,0
"Malaysia","2024-03-07",0,0,0,0,0,0,0,0
"Malaysia","2024-03-08",0,0,0,0,0,0,0,0
"Malaysia","2024-03-09",0,0,0,0,0,0,0,0
"Malaysia","2024-03-10",0,0,0,0,0,0,0,0
"Malaysia","2024-03-11",0,0,0,0,0,0,0,0
"Malaysia","2024-03-12",0,0,0,0,0,0,0,0
"Malaysia","2024-03-13",0,0,0,0,0,0,0,0
"Malaysia","2024-03-14",0,0,0,0,0,0,0,0
"Malaysia","2024-03-15",0,0,0,0,0,0,0,0
"Malaysia","2024-03-16",0,0,0,0,0,0,0,0
"Malaysia","2024-03-17",0,0,0,0,0,0,0,0
"Malaysia","2024-03-18",0,0,0,0,0,0,0,0
"Malaysia","2024-03-19",0,0,0,0,0,0,0,0
"Malaysia","2024-03-20",0,0,0,0,0,0,0,0
"Malaysia","2024-03-21",0,0,0,0,0,0,0,0
"Malaysia","2024-03-22",0,0,0,0,0,0,0,0
"Malaysia","2024-03-23",0,0,0,0,0,0,0,0
"Malaysia","2024-03-24",0,0,0,0,0,0,0,0
"Malaysia","2024-03-25",0,0,0,0,0,0,0,0
"Malaysia","2024-03-26",0,0,0,0,0,0,0,0
"Malaysia","2024-03-27",0,0,0,0,0,0,0,0
"Malaysia","2024-03-28",0,0,0,0,0,0,0,0
"Malaysia","2024-03-29",0,0,0,0,0,0,0,0
"Malaysia","2024-03-30",0,0,0,0,0,0,0,0
"Malaysia","2024-03-31",0,0,0,0,0,0,0,0
"Malaysia","2024-04-01",0,0,0,0,0,0,0,0
"Malaysia","2024-04-02",0,0,0,0,0,0,0,0
"Malaysia","2024-04-03",0,0,0,0,0,0,0,0
"Malaysia","2024-04-04",0,0,0,0,0,0,0,0
"Malaysia","2024-04-05",0,0,0,0,0,0,0,0
"Malaysia","2024-04-06",0,0,0,0,0,0,0,0
"Malaysia","2024-04-07",0,0,0,0,0,0,0,0
"Malaysia","2024-04-08",0,0,0,0,0,0,0,0
"Malaysia","2024-04-09",0,0,0,0,0,0,0,0
"Malaysia","2024-04-10",0,0,0,0,0,0,0,0
"Malaysia","2024-04-11",0,0,0,0,0,0,0,0
"Malaysia","2024-04-12",0,0,0,0,0,0,0,0
"Malaysia","2024-04-13",0,0,0,0,0,0,0,0
"Malaysia","2024-04-14",0,0,0,0,0,0,0,0
"Malaysia","2024-04-15",0,0,0,0,0,0,0,0
"Malaysia","2024-04-16",0,0,0,0,0,0,0,0
"Malaysia","2024-04-17",0,0,0,0,0,0,0,0
"Malaysia","2024-04-18",0,0,0,0,0,0,0,0
"Malaysia","2024-04-19",0,0,0,0,0,0,0,0
"Malaysia","2024-04-20",0,0,0,0,0,0,0,0
"Malaysia","2024-04-21",0,0,0,0,0,0,0,0
"Malaysia","2024-04-22",0,0,0,0,0,0,0,0
"Malaysia","2024-04-23",0,0,0,0,0,0,0,0
"Malaysia","2024-04-24",0,0,0,0,0,0,0,0
"Malaysia","2024-04-25",0,0,0,0,0,0,0,0
"Malaysia","2024-04-26",0,0,0,0,0,0,0,0
"Malaysia","2024-04-27",0,0,0,0,0,0,0,0
"Malaysia","2024-04-28",0,0,0,0,0,0,0,0
"Malaysia","2024-04-29",0,0,0,0,0,0,0,0
"Malaysia","2024-04-30",0,0,0,0,0,0,0,0
"Malaysia","2024-05-01",0,0,0,0,0,0,0,0
"Malaysia","2024-05-02",0,0,0,0,0,0,0,0
"Malaysia","2024-05-03",0,0,0,0,0,0,0,0
"Malaysia","2024-05-04",0,0,0,0,0,0,0,0
"Malaysia","2024-05-05",0,0,0,0,0,0,0,0
"Malaysia","2024-05-06",0,0,0,0,0,0,0,0
"Malaysia","2024-05-07",0,0,0,0,0,0,0,0
"Malaysia","2024-05-08",0,0,0,0,0,0,0,0
"Malaysia","2024-05-09",0,0,0,0,0,0,0,0
"Malaysia","2024-05-10",0,0,0,0,0,0,0,0
"Malaysia","2024-05-11",0,0,0,0,0,0,0,0
"Malaysia","2024-05-12",0,0,0,0,0,0,0,0
"Malaysia","2024-05-13",0,0,0,0,0,0,0,0
"Malaysia","2024-05-14",0,0,0,0,0,0,0,0
"Malaysia","2024-05-15",0,0,0,0,0,0,0,0
"Malaysia","2024-05-16",0,0,0,0,0,0,0,0
"Malaysia","2024-05-17",0,0,0,0,0,0,0,0
"Malaysia","2024-05-18",0,0,0,0,0,0,0,0
"Malaysia","2024-05-19",0,0,0,0,0,0,0,0
"Malaysia","2024-05-20",0,0,0,0,0,0,0,0
"Malaysia","2024-05-21",0,0,0,0,0,0,0,0
"Malaysia","2024-05-22",0,0,0,0,0,0,0,0
"Malaysia","2024-05-23",0,0,0,0,0,0,0,0
"Malaysia","2024-05-24",0,0,0,0,0,0,0,0
"Malaysia","2024-05-25",0,0,0,0,0,0,0,0
"Malaysia","2024-05-26",0,0,0,0,0,0,0,0
"Malaysia","2024-05-27",0,0,0,0,0,0,0,0
"Malaysia","2024-05-28",0,0,0,0,0,0,0,0
"Malaysia","2024-05-29",0,0,0,0,0,0,0,0
"Malaysia","2024-05-30",0,0,0,0,0,0,0,0
"Malaysia","2024-05-31",0,0,0,0,0,0,0,0
"Malaysia","2024-06-01",0,0,0,0,0,0,0,0
"Malaysia","2024-06-02",0,0,0,0,0,0,0,0
"Malaysia","2024-06-03",0,0,0,0,0,0,0,0
"Malaysia","2024-06-04",0,0,0,0,0,0,0,0
"Malaysia","2024-06-05",0,0,0,0,0,0,0,0
"Malaysia","2024-06-06",0,0,0,0,0,0,0,0
"Malaysia","2024-06-07",0,0,0,0,0,0,0,0
"Malaysia","2024-06-08",0,0,0,0,0,0,0,0
"Malaysia","2024-06-09",0,0,0,0,0,0,0,0
"Malaysia","2024-06-10",0,0,0,0,0,0,0,0
"Malaysia","2024-06-11",0,0,0,0,0,0,0,0
"Malaysia","2024-06-12",0,0,0,0,0,0,0,0
"Malaysia","2024-06-13",0,0,0,0,0,0,0,0
"Malaysia","2024-06-14",0,0,0,0,0,0,0,0
"Malaysia","2024-06-15",0,0,0,0,0,0,0,0
"Malaysia","2024-06-16",0,0,0,0,0,0,0,0
"Malaysia","2024-06-17",0,0,0,0,0,0,0,0
"Malaysia","2024-06-18",0,0,0,0,0,0,0,0
"Malaysia","2024-06-19",0,0,0,0,0,0,0,0
"Malaysia","2024-06-20",0,0,0,0,0,0,0,0
"Malaysia","2024-06-21",0,0,0,0,0,0,0,0
"Malaysia","2024-06-22",0,0,0,0,0,0,0,0
"Malaysia","2024-06-23",0,0,0,0,0,0,0,0
"Malaysia","2024-06-24",0,0,0,0,0,0,0,0
"Malaysia","2024-06-25",0,0,0,0,0,0,0,0
"Malaysia","2024-06-26",0,0,0,0,0,0,0,0
"Malaysia","2024-06-27",0,0,0,0,0,0,0,0
"Malaysia","2024-06-28",0,0,0,0,0,0,0,0
"Malaysia","2024-06-29",0,0,0,0,0,0,0,0
"Malaysia","2024-06-30",0,0,0,0,0,0,0,0
"Malaysia","2024-07-01",0,0,0,0,0,0,0,0
"Malaysia","2024-07-02",0,0,0,0,0,0,0,0
"Malaysia","2024-07-03",0,0,0,0,0,0,0,0
"Malaysia","2024-07-04",0,0,0,0,0,0,0,0
"Malaysia","2024-07-05",0,0,0,0,0,0,0,0
"Malaysia","2024-07-06",0,0,0,0,0,0,0,0
"Malaysia","2024-07-07",0,0,0,0,0,0,0,0
"Malaysia","2024-07-08",0,0,0,0,0,0,0,0
"Malaysia","2024-07-09",0,0,0,0,0,0,0,0
"Malaysia","2024-07-10",0,0,0,0,0,0,0,0
"Malaysia","2024-07-11",0,0,0,0,0,0,0,0
"Malaysia","2024-07-12",0,0,0,0,0,0,0,0
"Malaysia","2024-07-13",0,0,0,0,0,0,0,0
"Malaysia","2024-07-14",0,0,0,0,0,0,0,0
"Malaysia","2024-07-15",0,0,0,0,0,0,0,0
"Malaysia","2024-07-16",0,0,0,0,0,0,0,0
"Malaysia","2024-07-17",0,0,0,0,0,0,0,0
"Malaysia","2024-07-18",0,0,0,0,0,0,0,0
"Malaysia","2024-07-19",0,0,0,0,0,0,0,0
"Malaysia","2024-07-20",0,0,0,0,0,0,0,0
"Malaysia","2024-07-21",0,0,0,0,0,0,0,0
"Malaysia","2024-07-22",0,0,0,0,0,0,0,0
"Malaysia","2024-07-23",0,0,0,0,0,0,0,0
"Malaysia","2024-07-24",0,0,0,0,0,0,0,0
"Malaysia","2024-07-25",0,0,0,0,0,0,0,0
"Malaysia","2024-07-26",0,0,0,0,0,0,0,0
"Malaysia","2024-07-27",0,0,0,0,0,0,0,0
"Malaysia","2024-07-28",0,0,0,0,0,0,0,0
"Malaysia","2024-07-29",0,0,0,0,0,0,0,0
"Malaysia","2024-07-30",0,0,0,0,0,0,0,0
"Malaysia","2024-07-31",0,0,0,0,0,0,0,0
"Malaysia","2024-08-01",0,0,0,0,0,0,0,0
"Malaysia","2024-08-02",0,0,0,0,0,0,0,0
"Malaysia","2024-08-03",0,0,0,0,0,0,0,0
"Malaysia","2024-08-04",0,0,0,0,0,0,0,0
"Malaysia","2024-08-05",0,0,0,0,0,0,0,0
"Malaysia","2024-08-06",0,0,0,0,0,0,0,0
"Malaysia","2024-08-07",0,0,0,0,0,0,0,0
"Malaysia","2024-08-08",0,0,0,0,0,0,0,0
"Malaysia","2024-08-09",0,0,0,0,0,0,0,0
"Malaysia","2024-08-10",0,0,0,0,0,0,0,0
"Malaysia","2024-08-11",0,0,0,0,0,0,0,0
"Malaysia","2024-08-12",0,0,0,0,0,0,0,0
"Malaysia","2024-08-13",0,0,0,0,0,0,0,0
"Malaysia","2024-08-14",0,0,0,0,0,0,0,0
"Malaysia","2024-08-15",0,0,0,0,0,0,0,0
"Malaysia","2024-08-16",0,0,0,0,0,0,0,0
"Malaysia","2024-08-17",0,0,0,0,0,0,0,0
"Malaysia","2024-08-18",0,0,0,0,0,0,0,0
"Malaysia","2024-08-19",0,0,0,0,0,0,0,0
"Malaysia","2024-08-20",0,0,0,0,0,0,0,0
"Malaysia","2024-08-21",0,0,0,0,0,0,0,0
"Malaysia","2024-08-22",0,0,0,0,0,0,0,0
"Malaysia","2024-08-23",0,0,0,0,0,0,0,0
"Malaysia","2024-08-24",0,0,0,0,0,0,0,0
"Malaysia","2024-08-25",0,0,0,0,0,0,0,0
"Malaysia","2024-08-26",0,0,0,0,0,0,0,0
"Malaysia","2024-08-27",0,0,0,0,0,0,0,0
"Malaysia","2024-08-28",0,0,0,0,0,0,0,0
"Malaysia","2024-08-29",0,0,0,0,0,0,0,0
"Malaysia","2024-08-30",0,0,0,0,0,0,0,0
"Malaysia","2024-08-31",0,0,0,0,0,0,0,0
"Malaysia","2024-09-01",0,0,0,0,0,0,0,0
"Malaysia","2024-09-02",0,0,0,0,0,0,0,0
"Malaysia","2024-09-03",0,0,0,0,0,0,0,0
"Malaysia","2024-09-04",0,0,0,0,0,0,0,0
"Malaysia","2024-09-05",0,0,0,0,0,0,0,0
"Malaysia","2024-09-06",0,0,0,0,0,0,0,0
"Malaysia","2024-09-07",0,0,0,0,0,0,0,0
"Malaysia","2024-09-08",0,0,0,0,0,0,0,0
"Malaysia","2024-09-09",0,0,0,0,0,0,0,0
"Malaysia","2024-09-10",0,0,0,0,0,0,0,0
"Malaysia","2024-09-11",0,0,0,0,0,0,0,0
"Malaysia","2024-09-12",0,0,0,0,0,0,0,0
"Malaysia","2024-09-13",0,0,0,0,0,0,0,0
"Malaysia","2024-09-14",0,0,0,0,0,0,0,0
"Malaysia","2024-09-15",0,0,0,0,0,0,0,0
"Malaysia","2024-09-16",0,0,0,0,0,0,0,0
"Malaysia","2024-09-17",0,0,0,0,0,0,0,0
"Malaysia","2024-09-18",0,1,1,0,1,1,0,0
"Malaysia","2024-09-19",0,0,1,0,0,1,0,0
"Malaysia","2024-09-20",0,0,1,0,0,1,0,0
"Malaysia","2024-09-21",0,0,1,0,0,1,0,0
"Malaysia","2024-09-22",0,0,1,0,0,1,0,0
"Malaysia","2024-09-23",0,0,1,0,0,1,0,0
"Malaysia","2024-09-24",0,0,1,0,0,1,0,0
"Malaysia","2024-09-25",0,0,1,0,0,1,0,0
"Malaysia","2024-09-26",0,0,1,0,0,1,0,0
"Malaysia","2024-09-27",0,0,1,0,0,1,0,0
"Malaysia","2024-09-28",0,0,1,0,0,1,0,0
"Malaysia","2024-09-29",0,0,1,0,0,1,0,0
"Malaysia","2024-09-30",0,0,1,0,0,1,0,0
"Malaysia","2024-10-01",0,0,1,0,0,1,0,0
"Malaysia","2024-10-02",0,0,1,0,0,1,0,0
"Malaysia","2024-10-03",0,0,1,0,0,1,0,0
"Malaysia","2024-10-04",0,0,1,0,0,1,0,0
"Malaysia","2024-10-05",0,0,1,0,0,1,0,0
"Malaysia","2024-10-06",0,0,1,0,0,1,0,0
"Malaysia","2024-10-07",0,0,1,0,0,1,0,0
"Malaysia","2024-10-08",0,0,1,0,0,1,0,0
"Malaysia","2024-10-09",0,0,1,0,0,1,0,0
"Malaysia","2024-10-10",0,0,1,0,0,1,0,0
"Malaysia","2024-10-11",0,0,1,0,0,1,0,0
"Malaysia","2024-10-12",0,0,1,0,0,1,0,0
"Malaysia","2024-10-13",0,0,1,0,0,1,0,0
"Malaysia","2024-10-14",0,0,1,0,0,1,0,0
"Malaysia","2024-10-15",0,0,1,0,0,1,0,0
"Malaysia","2024-10-16",0,0,1,0,0,1,0,0
"Malaysia","2024-10-17",0,0,1,0,0,1,0,0
"Malaysia","2024-10-18",0,0,1,0,0,1,0,0
"Malaysia","2024-10-19",0,0,1,0,0,1,0,0
"Malaysia","2024-10-20",0,0,1,0,0,1,0,0
"Malaysia","2024-10-21",0,0,1,0,0,1,0,0
"Malaysia","2024-10-22",0,0,1,0,0,1,0,0
"Malaysia","2024-10-23",0,0,1,0,0,1,0,0
"Malaysia","2024-10-24",0,0,1,0,0,1,0,0
"Malaysia","2024-10-25",0,0,1,0,0,1,0,0
"Malaysia","2024-10-26",0,0,1,0,0,1,0,0
"Malaysia","2024-10-27",0,0,1,0,0,1,0,0
"Malaysia","2024-10-28",0,0,1,0,0,1,0,0
"Malaysia","2024-10-29",0,0,1,0,0,1,0,0
"Malaysia","2024-10-30",0,0,1,0,0,1,0,0
"Malaysia","2024-10-31",0,0,1,0,0,1,0,0
"Malaysia","2024-11-01",0,0,1,0,0,1,0,0
"Malaysia","2024-11-02",0,0,1,0,0,1,0,0
"Malaysia","2024-11-03",0,0,1,0,0,1,0,0
"Malaysia","2024-11-04",0,0,1,0,0,1,0,0
"Malaysia","2024-11-05",0,0,1,0,0,1,0,0
"Malaysia","2024-11-06",0,0,1,0,0,1,0,0
"Malaysia","2024-11-07",0,0,1,0,0,1,0,0
"Malaysia","2024-11-08",0,0,1,0,0,1,0,0
"Malaysia","2024-11-09",0,0,1,0,0,1,0,0
"Malaysia","2024-11-10",0,0,1,0,0,1,0,0
"Malaysia","2024-11-11",0,0,1,0,0,1,0,0
"Malaysia","2024-11-12",0,0,1,0,0,1,0,0
"Malaysia","2024-11-13",0,0,1,0,0,1,0,0
"Malaysia","2024-11-14",0,0,1,0,0,1,0,0
"Malaysia","2024-11-15",0,0,1,0,0,1,0,0
"Malaysia","2024-11-16",0,0,1,0,0,1,0,0
"Malaysia","2024-11-17",0,0,1,0,0,1,0,0
"Malaysia","2024-11-18",0,0,1,0,0,1,0,0
"Malaysia","2024-11-19",0,0,1,0,0,1,0,0
"Malaysia","2024-11-20",0,0,1,0,0,1,0,0
"Malaysia","2024-11-21",0,0,1,0,0,1,0,0
"Malaysia","2024-11-22",0,0,1,0,0,1,0,0
"Malaysia","2024-11-23",0,0,1,0,0,1,0,0
"Malaysia","2024-11-24",0,0,1,0,0,1,0,0
"Malaysia","2024-11-25",0,0,1,0,0,1,0,0
"Malaysia","2024-11-26",0,0,1,0,0,1,0,0
"Malaysia","2024-11-27",0,0,1,0,0,1,0,0
"Malaysia","2024-11-28",0,0,1,0,0,1,0,0
"Malaysia","2024-11-29",0,0,1,0,0,1,0,0
"Malaysia","2024-11-30",0,0,1,0,0,1,0,0
"Malaysia","2024-12-01",0,0,1,0,0,1,0,0
"Malaysia","2024-12-02",0,0,1,0,0,1,0,0
"Malaysia","2024-12-03",0,0,1,0,0,1,0,0
"Malaysia","2024-12-04",0,0,1,0,0,1,0,0
"Malaysia","2024-12-05",0,0,1,0,0,1,0,0
"Malaysia","2024-12-06",0,0,1,0,0,1,0,0
"Malaysia","2024-12-07",0,0,1,0,0,1,0,0
"Malaysia","2024-12-08",0,0,1,0,0,1,0,0
"Malaysia","2024-12-09",0,0,1,0,0,1,0,0
"Malaysia","2024-12-10",0,0,1,0,0,1,0,0
"Malaysia","2024-12-11",0,0,1,0,0,1,0,0
"Malaysia","2024-12-12",0,0,1,0,0,1,0,0
"Malaysia","2024-12-13",0,0,1,0,0,1,0,0
"Malaysia","2024-12-14",0,0,1,0,0,1,0,0
"Malaysia","2024-12-15",0,0,1,0,0,1,0,0
"Malaysia","2024-12-16",0,0,1,0,0,1,0,0
"Malaysia","2024-12-17",0,0,1,0,0,1,0,0
"Malaysia","2024-12-18",0,0,1,0,0,1,0,0
"Malaysia","2024-12-19",0,0,1,0,0,1,0,0
"Malaysia","2024-12-20",0,0,1,0,0,1,0,0
"Malaysia","2024-12-21",0,0,1,0,0,1,0,0
"Malaysia","2024-12-22",0,0,1,0,0,1,0,0
"Malaysia","2024-12-23",0,0,1,0,0,1,0,0
"Malaysia","2024-12-24",0,0,1,0,0,1,0,0
"Malaysia","2024-12-25",0,0,1,0,0,1,0,0
"Malaysia","2024-12-26",0,0,1,0,0,1,0,0
"Malaysia","2024-12-27",0,0,1,0,0,1,0,0
"Malaysia","2024-12-28",0,0,1,0,0,1,0,0
"Malaysia","2024-12-29",0,0,1,0,0,1,0,0
"Malaysia","2024-12-30",0,0,1,0,0,1,0,0
"Malaysia","2024-12-31",0,0,1,0,0,1,0,0
"Malaysia","2025-01-01",0,0,1,0,0,1,0,0
"Malaysia","2025-01-02",0,0,1,0,0,1,0,0
"Malaysia","2025-01-03",0,0,1,0,0,1,0,0
"Malaysia","2025-01-04",0,0,1,0,0,1,0,0
"Malaysia","2025-01-05",0,0,1,0,0,1,0,0
"Malaysia","2025-01-06",0,0,1,0,0,1,0,0
"Malaysia","2025-01-07",0,0,1,0,0,1,0,0
"Malaysia","2025-01-08",0,0,1,0,0,1,0,0
"Malaysia","2025-01-09",0,0,1,0,0,1,0,0
"Malaysia","2025-01-10",0,0,1,0,0,1,0,0
"Malaysia","2025-01-11",0,0,1,0,0,1,0,0
"Malaysia","2025-01-12",0,0,1,0,0,1,0,0
"Malaysia","2025-01-13",0,0,1,0,0,1,0,0
"Malta","2024-01-01",0,0,0,0,0,0,0,0
"Malta","2024-01-02",0,0,0,0,0,0,0,0
"Malta","2024-01-03",0,0,0,0,0,0,0,0
"Malta","2024-01-04",0,0,0,0,0,0,0,0
"Malta","2024-01-05",0,0,0,0,0,0,0,0
"Malta","2024-01-06",0,0,0,0,0,0,0,0
"Malta","2024-01-07",0,0,0,0,0,0,0,0
"Malta","2024-01-08",0,0,0,0,0,0,0,0
"Malta","2024-01-09",0,0,0,0,0,0,0,0
"Malta","2024-01-10",0,0,0,0,0,0,0,0
"Malta","2024-01-11",0,0,0,0,0,0,0,0
"Malta","2024-01-12",0,0,0,0,0,0,0,0
"Malta","2024-01-13",0,0,0,0,0,0,0,0
"Malta","2024-01-14",0,0,0,0,0,0,0,0
"Malta","2024-01-15",0,0,0,0,0,0,0,0
"Malta","2024-01-16",0,0,0,0,0,0,0,0
"Malta","2024-01-17",0,0,0,0,0,0,0,0
"Malta","2024-01-18",0,0,0,0,0,0,0,0
"Malta","2024-01-19",0,0,0,0,0,0,0,0
"Malta","2024-01-20",0,0,0,0,0,0,0,0
"Malta","2024-01-21",0,0,0,0,0,0,0,0
"Malta","2024-01-22",0,0,0,0,0,0,0,0
"Malta","2024-01-23",0,0,0,0,0,0,0,0
"Malta","2024-01-24",0,0,0,0,0,0,0,0
"Malta","2024-01-25",0,0,0,0,0,0,0,0
"Malta","2024-01-26",0,0,0,0,0,0,0,0
"Malta","2024-01-27",0,0,0,0,0,0,0,0
"Malta","2024-01-28",0,0,0,0,0,0,0,0
"Malta","2024-01-29",0,0,0,0,0,0,0,0
"Malta","2024-01-30",0,0,0,0,0,0,0,0
"Malta","2024-01-31",0,0,0,0,0,0,0,0
"Malta","2024-02-01",0,0,0,0,0,0,0,0
"Malta","2024-02-02",0,0,0,0,0,0,0,0
"Malta","2024-02-03",0,0,0,0,0,0,0,0
"Malta","2024-02-04",0,0,0,0,0,0,0,0
"Malta","2024-02-05",0,0,0,0,0,0,0,0
"Malta","2024-02-06",0,0,0,0,0,0,0,0
"Malta","2024-02-07",0,0,0,0,0,0,0,0
"Malta","2024-02-08",0,0,0,0,0,0,0,0
"Malta","2024-02-09",0,0,0,0,0,0,0,0
"Malta","2024-02-10",0,0,0,0,0,0,0,0
"Malta","2024-02-11",0,0,0,0,0,0,0,0
"Malta","2024-02-12",0,0,0,0,0,0,0,0
"Malta","2024-02-13",0,0,0,0,0,0,0,0
"Malta","2024-02-14",0,0,0,0,0,0,0,0
"Malta","2024-02-15",0,0,0,0,0,0,0,0
"Malta","2024-02-16",0,0,0,0,0,0,0,0
"Malta","2024-02-17",0,0,0,0,0,0,0,0
"Malta","2024-02-18",0,0,0,0,0,0,0,0
"Malta","2024-02-19",0,0,0,0,0,0,0,0
"Malta","2024-02-20",0,0,0,0,0,0,0,0
"Malta","2024-02-21",0,0,0,0,0,0,0,0
"Malta","2024-02-22",0,0,0,0,0,0,0,0
"Malta","2024-02-23",0,0,0,0,0,0,0,0
"Malta","2024-02-24",0,0,0,0,0,0,0,0
"Malta","2024-02-25",0,0,0,0,0,0,0,0
"Malta","2024-02-26",0,0,0,0,0,0,0,0
"Malta","2024-02-27",0,0,0,0,0,0,0,0
"Malta","2024-02-28",0,0,0,0,0,0,0,0
"Malta","2024-02-29",0,0,0,0,0,0,0,0
"Malta","2024-03-01",0,0,0,0,0,0,0,0
"Malta","2024-03-02",0,0,0,0,0,0,0,0
"Malta","2024-03-03",0,0,0,0,0,0,0,0
"Malta","2024-03-04",0,0,0,0,0,0,0,0
"Malta","2024-03-05",0,0,0,0,0,0,0,0
"Malta","2024-03-06",0,0,0,0,0,0,0,0
"Malta","2024-03-07",0,0,0,0,0,0,0,0
"Malta","2024-03-08",0,0,0,0,0,0,0,0
"Malta","2024-03-09",0,0,0,0,0,0,0,0
"Malta","2024-03-10",0,0,0,0,0,0,0,0
"Malta","2024-03-11",0,0,0,0,0,0,0,0
"Malta","2024-03-12",0,0,0,0,0,0,0,0
"Malta","2024-03-13",0,0,0,0,0,0,0,0
"Malta","2024-03-14",0,0,0,0,0,0,0,0
"Malta","2024-03-15",0,0,0,0,0,0,0,0
"Malta","2024-03-16",0,0,0,0,0,0,0,0
"Malta","2024-03-17",0,0,0,0,0,0,0,0
"Malta","2024-03-18",0,0,0,0,0,0,0,0
"Malta","2024-03-19",0,0,0,0,0,0,0,0
"Malta","2024-03-20",0,0,0,0,0,0,0,0
"Malta","2024-03-21",0,0,0,0,0,0,0,0
"Malta","2024-03-22",0,0,0,0,0,0,0,0
"Malta","2024-03-23",0,0,0,0,0,0,0,0
"Malta","2024-03-24",0,0,0,0,0,0,0,0
"Malta","2024-03-25",0,0,0,0,0,0,0,0
"Malta","2024-03-26",0,0,0,0,0,0,0,0
"Malta","2024-03-27",0,0,0,0,0,0,0,0
"Malta","2024-03-28",0,0,0,0,0,0,0,0
"Malta","2024-03-29",0,0,0,0,0,0,0,0
"Malta","2024-03-30",0,0,0,0,0,0,0,0
"Malta","2024-03-31",0,0,0,0,0,0,0,0
"Malta","2024-04-01",0,0,0,0,0,0,0,0
"Malta","2024-04-02",0,0,0,0,0,0,0,0
"Malta","2024-04-03",0,0,0,0,0,0,0,0
"Malta","2024-04-04",0,0,0,0,0,0,0,0
"Malta","2024-04-05",0,0,0,0,0,0,0,0
"Malta","2024-04-06",0,0,0,0,0,0,0,0
"Malta","2024-04-07",0,0,0,0,0,0,0,0
"Malta","2024-04-08",0,0,0,0,0,0,0,0
"Malta","2024-04-09",0,0,0,0,0,0,0,0
"Malta","2024-04-10",0,0,0,0,0,0,0,0
"Malta","2024-04-11",0,0,0,0,0,0,0,0
"Malta","2024-04-12",0,0,0,0,0,0,0,0
"Malta","2024-04-13",0,0,0,0,0,0,0,0
"Malta","2024-04-14",0,0,0,0,0,0,0,0
"Malta","2024-04-15",0,0,0,0,0,0,0,0
"Malta","2024-04-16",0,0,0,0,0,0,0,0
"Malta","2024-04-17",0,0,0,0,0,0,0,0
"Malta","2024-04-18",0,0,0,0,0,0,0,0
"Malta","2024-04-19",0,0,0,0,0,0,0,0
"Malta","2024-04-20",0,0,0,0,0,0,0,0
"Malta","2024-04-21",0,0,0,0,0,0,0,0
"Malta","2024-04-22",0,0,0,0,0,0,0,0
"Malta","2024-04-23",0,0,0,0,0,0,0,0
"Malta","2024-04-24",0,0,0,0,0,0,0,0
"Malta","2024-04-25",0,0,0,0,0,0,0,0
"Malta","2024-04-26",0,0,0,0,0,0,0,0
"Malta","2024-04-27",0,0,0,0,0,0,0,0
"Malta","2024-04-28",0,0,0,0,0,0,0,0
"Malta","2024-04-29",0,0,0,0,0,0,0,0
"Malta","2024-04-30",0,0,0,0,0,0,0,0
"Malta","2024-05-01",0,0,0,0,0,0,0,0
"Malta","2024-05-02",0,0,0,0,0,0,0,0
"Malta","2024-05-03",0,0,0,0,0,0,0,0
"Malta","2024-05-04",0,0,0,0,0,0,0,0
"Malta","2024-05-05",0,0,0,0,0,0,0,0
"Malta","2024-05-06",0,0,0,0,0,0,0,0
"Malta","2024-05-07",0,0,0,0,0,0,0,0
"Malta","2024-05-08",0,0,0,0,0,0,0,0
"Malta","2024-05-09",0,0,0,0,0,0,0,0
"Malta","2024-05-10",0,0,0,0,0,0,0,0
"Malta","2024-05-11",0,0,0,0,0,0,0,0
"Malta","2024-05-12",0,0,0,0,0,0,0,0
"Malta","2024-05-13",0,0,0,0,0,0,0,0
"Malta","2024-05-14",0,0,0,0,0,0,0,0
"Malta","2024-05-15",0,0,0,0,0,0,0,0
"Malta","2024-05-16",0,0,0,0,0,0,0,0
"Malta","2024-05-17",0,0,0,0,0,0,0,0
"Malta","2024-05-18",0,0,0,0,0,0,0,0
"Malta","2024-05-19",0,0,0,0,0,0,0,0
"Malta","2024-05-20",0,0,0,0,0,0,0,0
"Malta","2024-05-21",0,0,0,0,0,0,0,0
"Malta","2024-05-22",0,0,0,0,0,0,0,0
"Malta","2024-05-23",0,0,0,0,0,0,0,0
"Malta","2024-05-24",0,0,0,0,0,0,0,0
"Malta","2024-05-25",0,0,0,0,0,0,0,0
"Malta","2024-05-26",0,0,0,0,0,0,0,0
"Malta","2024-05-27",0,0,0,0,0,0,0,0
"Malta","2024-05-28",0,0,0,0,0,0,0,0
"Malta","2024-05-29",0,0,0,0,0,0,0,0
"Malta","2024-05-30",0,0,0,0,0,0,0,0
"Malta","2024-05-31",0,0,0,0,0,0,0,0
"Malta","2024-06-01",0,0,0,0,0,0,0,0
"Malta","2024-06-02",0,0,0,0,0,0,0,0
"Malta","2024-06-03",0,0,0,0,0,0,0,0
"Malta","2024-06-04",0,0,0,0,0,0,0,0
"Malta","2024-06-05",0,0,0,0,0,0,0,0
"Malta","2024-06-06",0,0,0,0,0,0,0,0
"Malta","2024-06-07",0,0,0,0,0,0,0,0
"Malta","2024-06-08",0,0,0,0,0,0,0,0
"Malta","2024-06-09",0,0,0,0,0,0,0,0
"Malta","2024-06-10",0,0,0,0,0,0,0,0
"Malta","2024-06-11",0,0,0,0,0,0,0,0
"Malta","2024-06-12",0,0,0,0,0,0,0,0
"Malta","2024-06-13",0,0,0,0,0,0,0,0
"Malta","2024-06-14",0,0,0,0,0,0,0,0
"Malta","2024-06-15",0,0,0,0,0,0,0,0
"Malta","2024-06-16",0,0,0,0,0,0,0,0
"Malta","2024-06-17",0,0,0,0,0,0,0,0
"Malta","2024-06-18",0,0,0,0,0,0,0,0
"Malta","2024-06-19",0,0,0,0,0,0,0,0
"Malta","2024-06-20",0,0,0,0,0,0,0,0
"Malta","2024-06-21",0,0,0,0,0,0,0,0
"Malta","2024-06-22",0,0,0,0,0,0,0,0
"Malta","2024-06-23",0,0,0,0,0,0,0,0
"Malta","2024-06-24",0,0,0,0,0,0,0,0
"Malta","2024-06-25",0,0,0,0,0,0,0,0
"Malta","2024-06-26",0,0,0,0,0,0,0,0
"Malta","2024-06-27",0,0,0,0,0,0,0,0
"Malta","2024-06-28",0,0,0,0,0,0,0,0
"Malta","2024-06-29",0,0,0,0,0,0,0,0
"Malta","2024-06-30",0,0,0,0,0,0,0,0
"Malta","2024-07-01",0,0,0,0,0,0,0,0
"Malta","2024-07-02",0,0,0,0,0,0,0,0
"Malta","2024-07-03",0,0,0,0,0,0,0,0
"Malta","2024-07-04",0,0,0,0,0,0,0,0
"Malta","2024-07-05",0,0,0,0,0,0,0,0
"Malta","2024-07-06",0,0,0,0,0,0,0,0
"Malta","2024-07-07",0,0,0,0,0,0,0,0
"Malta","2024-07-08",0,0,0,0,0,0,0,0
"Malta","2024-07-09",0,0,0,0,0,0,0,0
"Malta","2024-07-10",0,0,0,0,0,0,0,0
"Malta","2024-07-11",0,0,0,0,0,0,0,0
"Malta","2024-07-12",0,0,0,0,0,0,0,0
"Malta","2024-07-13",0,0,0,0,0,0,0,0
"Malta","2024-07-14",0,0,0,0,0,0,0,0
"Malta","2024-07-15",0,0,0,0,0,0,0,0
"Malta","2024-07-16",0,0,0,0,0,0,0,0
"Malta","2024-07-17",0,0,0,0,0,0,0,0
"Malta","2024-07-18",0,0,0,0,0,0,0,0
"Malta","2024-07-19",0,0,0,0,0,0,0,0
"Malta","2024-07-20",0,0,0,0,0,0,0,0
"Malta","2024-07-21",0,0,0,0,0,0,0,0
"Malta","2024-07-22",0,0,0,0,0,0,0,0
"Malta","2024-07-23",0,0,0,0,0,0,0,0
"Malta","2024-07-24",0,0,0,0,0,0,0,0
"Malta","2024-07-25",0,0,0,0,0,0,0,0
"Malta","2024-07-26",0,0,0,0,0,0,0,0
"Malta","2024-07-27",0,0,0,0,0,0,0,0
"Malta","2024-07-28",0,0,0,0,0,0,0,0
"Malta","2024-07-29",0,0,0,0,0,0,0,0
"Malta","2024-07-30",0,0,0,0,0,0,0,0
"Malta","2024-07-31",0,0,0,0,0,0,0,0
"Malta","2024-08-01",0,0,0,0,0,0,0,0
"Malta","2024-08-02",0,0,0,0,0,0,0,0
"Malta","2024-08-03",0,0,0,0,0,0,0,0
"Malta","2024-08-04",0,0,0,0,0,0,0,0
"Malta","2024-08-05",0,0,0,0,0,0,0,0
"Malta","2024-08-06",0,0,0,0,0,0,0,0
"Malta","2024-08-07",0,0,0,0,0,0,0,0
"Malta","2024-08-08",0,0,0,0,0,0,0,0
"Malta","2024-08-09",0,0,0,0,0,0,0,0
"Malta","2024-08-10",0,0,0,0,0,0,0,0
"Malta","2024-08-11",0,0,0,0,0,0,0,0
"Malta","2024-08-12",0,0,0,0,0,0,0,0
"Malta","2024-08-13",0,0,0,0,0,0,0,0
"Malta","2024-08-14",0,0,0,0,0,0,0,0
"Malta","2024-08-15",0,0,0,0,0,0,0,0
"Malta","2024-08-16",0,0,0,0,0,0,0,0
"Malta","2024-08-17",0,0,0,0,0,0,0,0
"Malta","2024-08-18",0,0,0,0,0,0,0,0
"Malta","2024-08-19",0,0,0,0,0,0,0,0
"Malta","2024-08-20",0,0,0,0,0,0,0,0
"Malta","2024-08-21",0,0,0,0,0,0,0,0
"Malta","2024-08-22",0,0,0,0,0,0,0,0
"Malta","2024-08-23",0,0,0,0,0,0,0,0
"Malta","2024-08-24",0,0,0,0,0,0,0,0
"Malta","2024-08-25",0,0,0,0,0,0,0,0
"Malta","2024-08-26",0,0,0,0,0,0,0,0
"Malta","2024-08-27",0,0,0,0,0,0,0,0
"Malta","2024-08-28",0,0,0,0,0,0,0,0
"Malta","2024-08-29",0,0,0,0,0,0,0,0
"Malta","2024-08-30",0,0,0,0,0,0,0,0
"Malta","2024-08-31",0,2,2,0,2,2,0,0
"Malta","2024-09-01",0,0,2,0,0,2,0,0
"Malta","2024-09-02",0,0,2,0,0,2,0,0
"Malta","2024-09-03",0,0,2,0,0,2,0,0
"Malta","2024-09-04",0,0,2,0,0,2,0,0
"Malta","2024-09-05",0,0,2,0,0,2,0,0
"Malta","2024-09-06",0,0,2,0,0,2,0,0
"Malta","2024-09-07",0,0,2,0,0,2,0,0
"Malta","2024-09-08",0,0,2,0,0,2,0,0
"Malta","2024-09-09",0,0,2,0,0,2,0,0
"Malta","2024-09-10",0,0,2,0,0,2,0,0
"Malta","2024-09-11",0,0,2,0,0,2,0,0
"Malta","2024-09-12",0,0,2,0,0,2,0,0
"Malta","2024-09-13",0,0,2,0,0,2,0,0
"Malta","2024-09-14",0,0,2,0,0,2,0,0
"Malta","2024-09-15",0,0,2,0,0,2,0,0
"Malta","2024-09-16",0,0,2,0,0,2,0,0
"Malta","2024-09-17",0,0,2,0,0,2,0,0
"Malta","2024-09-18",0,0,2,0,0,2,0,0
"Malta","2024-09-19",0,0,2,0,0,2,0,0
"Malta","2024-09-20",0,0,2,0,0,2,0,0
"Malta","2024-09-21",0,0,2,0,0,2,0,0
"Malta","2024-09-22",0,0,2,0,0,2,0,0
"Malta","2024-09-23",0,0,2,0,0,2,0,0
"Malta","2024-09-24",0,0,2,0,0,2,0,0
"Malta","2024-09-25",0,0,2,0,0,2,0,0
"Malta","2024-09-26",0,0,2,0,0,2,0,0
"Malta","2024-09-27",0,0,2,0,0,2,0,0
"Malta","2024-09-28",0,0,2,0,0,2,0,0
"Malta","2024-09-29",0,0,2,0,0,2,0,0
"Malta","2024-09-30",0,0,2,0,0,2,0,0
"Malta","2024-10-01",0,0,2,0,1,3,0,0
"Malta","2024-10-02",0,0,2,0,0,3,0,0
"Malta","2024-10-03",0,0,2,0,0,3,0,0
"Malta","2024-10-04",0,0,2,0,0,3,0,0
"Malta","2024-10-05",0,0,2,0,0,3,0,0
"Malta","2024-10-06",0,0,2,0,0,3,0,0
"Malta","2024-10-07",0,0,2,0,0,3,0,0
"Malta","2024-10-08",0,0,2,0,0,3,0,0
"Malta","2024-10-09",0,0,2,0,0,3,0,0
"Malta","2024-10-10",0,0,2,0,0,3,0,0
"Malta","2024-10-11",0,0,2,0,0,3,0,0
"Malta","2024-10-12",0,0,2,0,0,3,0,0
"Malta","2024-10-13",0,0,2,0,0,3,0,0
"Malta","2024-10-14",0,0,2,0,0,3,0,0
"Malta","2024-10-15",0,0,2,0,0,3,0,0
"Malta","2024-10-16",0,0,2,0,0,3,0,0
"Malta","2024-10-17",0,0,2,0,0,3,0,0
"Malta","2024-10-18",0,0,2,0,0,3,0,0
"Malta","2024-10-19",0,0,2,0,0,3,0,0
"Malta","2024-10-20",0,0,2,0,0,3,0,0
"Malta","2024-10-21",0,0,2,0,0,3,0,0
"Malta","2024-10-22",0,0,2,0,0,3,0,0
"Malta","2024-10-23",0,0,2,0,0,3,0,0
"Malta","2024-10-24",0,0,2,0,0,3,0,0
"Malta","2024-10-25",0,0,2,0,0,3,0,0
"Malta","2024-10-26",0,0,2,0,0,3,0,0
"Malta","2024-10-27",0,0,2,0,0,3,0,0
"Malta","2024-10-28",0,0,2,0,0,3,0,0
"Malta","2024-10-29",0,0,2,0,0,3,0,0
"Malta","2024-10-30",0,0,2,0,0,3,0,0
"Malta","2024-10-31",0,1,3,0,0,3,0,0
"Malta","2024-11-01",0,0,3,0,0,3,0,0
"Malta","2024-11-02",0,0,3,0,0,3,0,0
"Malta","2024-11-03",0,0,3,0,0,3,0,0
"Malta","2024-11-04",0,0,3,0,0,3,0,0
"Malta","2024-11-05",0,0,3,0,0,3,0,0
"Malta","2024-11-06",0,0,3,0,0,3,0,0
"Malta","2024-11-07",0,0,3,0,0,3,0,0
"Malta","2024-11-08",0,0,3,0,0,3,0,0
"Malta","2024-11-09",0,0,3,0,0,3,0,0
"Malta","2024-11-10",0,0,3,0,0,3,0,0
"Malta","2024-11-11",0,0,3,0,0,3,0,0
"Malta","2024-11-12",0,0,3,0,0,3,0,0
"Malta","2024-11-13",0,0,3,0,0,3,0,0
"Malta","2024-11-14",0,0,3,0,0,3,0,0
"Malta","2024-11-15",0,0,3,0,0,3,0,0
"Malta","2024-11-16",0,0,3,0,0,3,0,0
"Malta","2024-11-17",0,0,3,0,0,3,0,0
"Malta","2024-11-18",0,0,3,0,0,3,0,0
"Malta","2024-11-19",0,0,3,0,0,3,0,0
"Malta","2024-11-20",0,0,3,0,0,3,0,0
"Malta","2024-11-21",0,0,3,0,0,3,0,0
"Malta","2024-11-22",0,0,3,0,0,3,0,0
"Malta","2024-11-23",0,0,3,0,0,3,0,0
"Malta","2024-11-24",0,0,3,0,0,3,0,0
"Malta","2024-11-25",0,0,3,0,0,3,0,0
"Malta","2024-11-26",0,0,3,0,0,3,0,0
"Malta","2024-11-27",0,0,3,0,0,3,0,0
"Malta","2024-11-28",0,0,3,0,0,3,0,0
"Malta","2024-11-29",0,0,3,0,0,3,0,0
"Malta","2024-11-30",0,0,3,0,0,3,0,0
"Malta","2024-12-01",0,0,3,0,0,3,0,0
"Malta","2024-12-02",0,0,3,0,0,3,0,0
"Malta","2024-12-03",0,0,3,0,0,3,0,0
"Malta","2024-12-04",0,0,3,0,0,3,0,0
"Malta","2024-12-05",0,0,3,0,0,3,0,0
"Malta","2024-12-06",0,0,3,0,0,3,0,0
"Malta","2024-12-07",0,0,3,0,0,3,0,0
"Malta","2024-12-08",0,0,3,0,0,3,0,0
"Malta","2024-12-09",0,0,3,0,0,3,0,0
"Malta","2024-12-10",0,0,3,0,0,3,0,0
"Malta","2024-12-11",0,0,3,0,0,3,0,0
"Malta","2024-12-12",0,0,3,0,0,3,0,0
"Malta","2024-12-13",0,0,3,0,0,3,0,0
"Malta","2024-12-14",0,0,3,0,0,3,0,0
"Malta","2024-12-15",0,0,3,0,0,3,0,0
"Malta","2024-12-16",0,0,3,0,0,3,0,0
"Malta","2024-12-17",0,0,3,0,0,3,0,0
"Malta","2024-12-18",0,0,3,0,0,3,0,0
"Malta","2024-12-19",0,0,3,0,0,3,0,0
"Malta","2024-12-20",0,0,3,0,0,3,0,0
"Malta","2024-12-21",0,0,3,0,0,3,0,0
"Malta","2024-12-22",0,0,3,0,0,3,0,0
"Malta","2024-12-23",0,0,3,0,0,3,0,0
"Malta","2024-12-24",0,0,3,0,0,3,0,0
"Malta","2024-12-25",0,0,3,0,0,3,0,0
"Malta","2024-12-26",0,0,3,0,0,3,0,0
"Malta","2024-12-27",0,0,3,0,0,3,0,0
"Malta","2024-12-28",0,0,3,0,0,3,0,0
"Malta","2024-12-29",0,0,3,0,0,3,0,0
"Malta","2024-12-30",0,0,3,0,0,3,0,0
"Malta","2024-12-31",0,0,3,0,0,3,0,0
"Malta","2025-01-01",0,0,3,0,0,3,0,0
"Malta","2025-01-02",0,0,3,0,0,3,0,0
"Malta","2025-01-03",0,0,3,0,0,3,0,0
"Malta","2025-01-04",0,0,3,0,0,3,0,0
"Malta","2025-01-05",0,0,3,0,0,3,0,0
"Malta","2025-01-06",0,0,3,0,0,3,0,0
"Malta","2025-01-07",0,0,3,0,0,3,0,0
"Malta","2025-01-08",0,0,3,0,0,3,0,0
"Malta","2025-01-09",0,0,3,0,0,3,0,0
"Malta","2025-01-10",0,0,3,0,0,3,0,0
"Malta","2025-01-11",0,0,3,0,0,3,0,0
"Malta","2025-01-12",0,0,3,0,0,3,0,0
"Malta","2025-01-13",0,0,3,0,0,3,0,0
"Martinique","2024-01-01",0,0,0,0,0,0,0,0
"Martinique","2024-01-02",0,0,0,0,0,0,0,0
"Martinique","2024-01-03",0,0,0,0,0,0,0,0
"Martinique","2024-01-04",0,0,0,0,0,0,0,0
"Martinique","2024-01-05",0,0,0,0,0,0,0,0
"Martinique","2024-01-06",0,0,0,0,0,0,0,0
"Martinique","2024-01-07",0,0,0,0,0,0,0,0
"Martinique","2024-01-08",0,0,0,0,0,0,0,0
"Martinique","2024-01-09",0,0,0,0,0,0,0,0
"Martinique","2024-01-10",0,0,0,0,0,0,0,0
"Martinique","2024-01-11",0,0,0,0,0,0,0,0
"Martinique","2024-01-12",0,0,0,0,0,0,0,0
"Martinique","2024-01-13",0,0,0,0,0,0,0,0
"Martinique","2024-01-14",0,0,0,0,0,0,0,0
"Martinique","2024-01-15",0,0,0,0,0,0,0,0
"Martinique","2024-01-16",0,0,0,0,0,0,0,0
"Martinique","2024-01-17",0,0,0,0,0,0,0,0
"Martinique","2024-01-18",0,0,0,0,0,0,0,0
"Martinique","2024-01-19",0,0,0,0,0,0,0,0
"Martinique","2024-01-20",0,0,0,0,0,0,0,0
"Martinique","2024-01-21",0,0,0,0,0,0,0,0
"Martinique","2024-01-22",0,0,0,0,0,0,0,0
"Martinique","2024-01-23",0,0,0,0,0,0,0,0
"Martinique","2024-01-24",0,0,0,0,0,0,0,0
"Martinique","2024-01-25",0,0,0,0,0,0,0,0
"Martinique","2024-01-26",0,0,0,0,0,0,0,0
"Martinique","2024-01-27",0,0,0,0,0,0,0,0
"Martinique","2024-01-28",0,0,0,0,0,0,0,0
"Martinique","2024-01-29",0,0,0,0,0,0,0,0
"Martinique","2024-01-30",0,0,0,0,0,0,0,0
"Martinique","2024-01-31",0,0,0,0,0,0,0,0
"Martinique","2024-02-01",0,0,0,0,0,0,0,0
"Martinique","2024-02-02",0,0,0,0,0,0,0,0
"Martinique","2024-02-03",0,0,0,0,0,0,0,0
"Martinique","2024-02-04",0,0,0,0,0,0,0,0
"Martinique","2024-02-05",0,0,0,0,0,0,0,0
"Martinique","2024-02-06",0,0,0,0,0,0,0,0
"Martinique","2024-02-07",0,0,0,0,0,0,0,0
"Martinique","2024-02-08",0,0,0,0,0,0,0,0
"Martinique","2024-02-09",0,0,0,0,0,0,0,0
"Martinique","2024-02-10",0,0,0,0,0,0,0,0
"Martinique","2024-02-11",0,0,0,0,0,0,0,0
"Martinique","2024-02-12",0,0,0,0,0,0,0,0
"Martinique","2024-02-13",0,0,0,0,0,0,0,0
"Martinique","2024-02-14",0,0,0,0,0,0,0,0
"Martinique","2024-02-15",0,0,0,0,0,0,0,0
"Martinique","2024-02-16",0,0,0,0,0,0,0,0
"Martinique","2024-02-17",0,0,0,0,0,0,0,0
"Martinique","2024-02-18",0,0,0,0,0,0,0,0
"Martinique","2024-02-19",0,0,0,0,0,0,0,0
"Martinique","2024-02-20",0,0,0,0,0,0,0,0
"Martinique","2024-02-21",0,0,0,0,0,0,0,0
"Martinique","2024-02-22",0,0,0,0,0,0,0,0
"Martinique","2024-02-23",0,0,0,0,0,0,0,0
"Martinique","2024-02-24",0,0,0,0,0,0,0,0
"Martinique","2024-02-25",0,0,0,0,0,0,0,0
"Martinique","2024-02-26",0,0,0,0,0,0,0,0
"Martinique","2024-02-27",0,0,0,0,0,0,0,0
"Martinique","2024-02-28",0,0,0,0,0,0,0,0
"Martinique","2024-02-29",0,0,0,0,0,0,0,0
"Martinique","2024-03-01",0,0,0,0,0,0,0,0
"Martinique","2024-03-02",0,0,0,0,0,0,0,0
"Martinique","2024-03-03",0,0,0,0,0,0,0,0
"Martinique","2024-03-04",0,0,0,0,0,0,0,0
"Martinique","2024-03-05",0,0,0,0,0,0,0,0
"Martinique","2024-03-06",0,0,0,0,0,0,0,0
"Martinique","2024-03-07",0,0,0,0,0,0,0,0
"Martinique","2024-03-08",0,0,0,0,0,0,0,0
"Martinique","2024-03-09",0,0,0,0,0,0,0,0
"Martinique","2024-03-10",0,0,0,0,0,0,0,0
"Martinique","2024-03-11",0,0,0,0,0,0,0,0
"Martinique","2024-03-12",0,0,0,0,0,0,0,0
"Martinique","2024-03-13",0,0,0,0,0,0,0,0
"Martinique","2024-03-14",0,0,0,0,0,0,0,0
"Martinique","2024-03-15",0,0,0,0,0,0,0,0
"Martinique","2024-03-16",0,0,0,0,0,0,0,0
"Martinique","2024-03-17",0,0,0,0,0,0,0,0
"Martinique","2024-03-18",0,0,0,0,0,0,0,0
"Martinique","2024-03-19",0,0,0,0,0,0,0,0
"Martinique","2024-03-20",0,0,0,0,0,0,0,0
"Martinique","2024-03-21",0,0,0,0,0,0,0,0
"Martinique","2024-03-22",0,0,0,0,0,0,0,0
"Martinique","2024-03-23",0,0,0,0,0,0,0,0
"Martinique","2024-03-24",0,0,0,0,0,0,0,0
"Martinique","2024-03-25",0,0,0,0,0,0,0,0
"Martinique","2024-03-26",0,0,0,0,0,0,0,0
"Martinique","2024-03-27",0,0,0,0,0,0,0,0
"Martinique","2024-03-28",0,0,0,0,0,0,0,0
"Martinique","2024-03-29",0,0,0,0,0,0,0,0
"Martinique","2024-03-30",0,0,0,0,0,0,0,0
"Martinique","2024-03-31",0,0,0,0,0,0,0,0
"Martinique","2024-04-01",0,0,0,0,0,0,0,0
"Martinique","2024-04-02",0,0,0,0,0,0,0,0
"Martinique","2024-04-03",0,0,0,0,0,0,0,0
"Martinique","2024-04-04",0,0,0,0,0,0,0,0
"Martinique","2024-04-05",0,0,0,0,0,0,0,0
"Martinique","2024-04-06",0,0,0,0,0,0,0,0
"Martinique","2024-04-07",0,0,0,0,0,0,0,0
"Martinique","2024-04-08",0,0,0,0,0,0,0,0
"Martinique","2024-04-09",0,0,0,0,0,0,0,0
"Martinique","2024-04-10",0,0,0,0,0,0,0,0
"Martinique","2024-04-11",0,0,0,0,0,0,0,0
"Martinique","2024-04-12",0,0,0,0,0,0,0,0
"Martinique","2024-04-13",0,0,0,0,0,0,0,0
"Martinique","2024-04-14",0,0,0,0,0,0,0,0
"Martinique","2024-04-15",0,0,0,0,0,0,0,0
"Martinique","2024-04-16",0,0,0,0,0,0,0,0
"Martinique","2024-04-17",0,0,0,0,0,0,0,0
"Martinique","2024-04-18",0,0,0,0,0,0,0,0
"Martinique","2024-04-19",0,0,0,0,0,0,0,0
"Martinique","2024-04-20",0,0,0,0,0,0,0,0
"Martinique","2024-04-21",0,0,0,0,0,0,0,0
"Martinique","2024-04-22",0,0,0,0,0,0,0,0
"Martinique","2024-04-23",0,0,0,0,0,0,0,0
"Martinique","2024-04-24",0,0,0,0,0,0,0,0
"Martinique","2024-04-25",0,0,0,0,0,0,0,0
"Martinique","2024-04-26",0,0,0,0,0,0,0,0
"Martinique","2024-04-27",0,0,0,0,0,0,0,0
"Martinique","2024-04-28",0,0,0,0,0,0,0,0
"Martinique","2024-04-29",0,0,0,0,0,0,0,0
"Martinique","2024-04-30",0,0,0,0,0,0,0,0
"Martinique","2024-05-01",0,0,0,0,0,0,0,0
"Martinique","2024-05-02",0,0,0,0,0,0,0,0
"Martinique","2024-05-03",0,0,0,0,0,0,0,0
"Martinique","2024-05-04",0,0,0,0,0,0,0,0
"Martinique","2024-05-05",0,0,0,0,0,0,0,0
"Martinique","2024-05-06",0,0,0,0,0,0,0,0
"Martinique","2024-05-07",0,0,0,0,0,0,0,0
"Martinique","2024-05-08",0,0,0,0,0,0,0,0
"Martinique","2024-05-09",0,0,0,0,0,0,0,0
"Martinique","2024-05-10",0,0,0,0,0,0,0,0
"Martinique","2024-05-11",0,0,0,0,0,0,0,0
"Martinique","2024-05-12",0,0,0,0,0,0,0,0
"Martinique","2024-05-13",0,0,0,0,0,0,0,0
"Martinique","2024-05-14",0,0,0,0,0,0,0,0
"Martinique","2024-05-15",0,0,0,0,0,0,0,0
"Martinique","2024-05-16",0,0,0,0,0,0,0,0
"Martinique","2024-05-17",0,0,0,0,0,0,0,0
"Martinique","2024-05-18",0,0,0,0,0,0,0,0
"Martinique","2024-05-19",0,0,0,0,0,0,0,0
"Martinique","2024-05-20",0,0,0,0,0,0,0,0
"Martinique","2024-05-21",0,0,0,0,0,0,0,0
"Martinique","2024-05-22",0,0,0,0,0,0,0,0
"Martinique","2024-05-23",0,0,0,0,0,0,0,0
"Martinique","2024-05-24",0,0,0,0,0,0,0,0
"Martinique","2024-05-25",0,0,0,0,0,0,0,0
"Martinique","2024-05-26",0,0,0,0,0,0,0,0
"Martinique","2024-05-27",0,0,0,0,0,0,0,0
"Martinique","2024-05-28",0,0,0,0,0,0,0,0
"Martinique","2024-05-29",0,0,0,0,0,0,0,0
"Martinique","2024-05-30",0,0,0,0,0,0,0,0
"Martinique","2024-05-31",0,0,0,0,0,0,0,0
"Martinique","2024-06-01",0,0,0,0,0,0,0,0
"Martinique","2024-06-02",0,0,0,0,0,0,0,0
"Martinique","2024-06-03",0,0,0,0,0,0,0,0
"Martinique","2024-06-04",0,0,0,0,0,0,0,0
"Martinique","2024-06-05",0,0,0,0,0,0,0,0
"Martinique","2024-06-06",0,0,0,0,0,0,0,0
"Martinique","2024-06-07",0,0,0,0,0,0,0,0
"Martinique","2024-06-08",0,0,0,0,0,0,0,0
"Martinique","2024-06-09",0,0,0,0,0,0,0,0
"Martinique","2024-06-10",0,0,0,0,0,0,0,0
"Martinique","2024-06-11",0,0,0,0,0,0,0,0
"Martinique","2024-06-12",0,0,0,0,0,0,0,0
"Martinique","2024-06-13",0,0,0,0,0,0,0,0
"Martinique","2024-06-14",0,0,0,0,0,0,0,0
"Martinique","2024-06-15",0,0,0,0,0,0,0,0
"Martinique","2024-06-16",0,0,0,0,0,0,0,0
"Martinique","2024-06-17",0,0,0,0,0,0,0,0
"Martinique","2024-06-18",0,0,0,0,0,0,0,0
"Martinique","2024-06-19",0,0,0,0,0,0,0,0
"Martinique","2024-06-20",0,0,0,0,0,0,0,0
"Martinique","2024-06-21",0,0,0,0,0,0,0,0
"Martinique","2024-06-22",0,0,0,0,0,0,0,0
"Martinique","2024-06-23",0,0,0,0,0,0,0,0
"Martinique","2024-06-24",0,0,0,0,0,0,0,0
"Martinique","2024-06-25",0,0,0,0,0,0,0,0
"Martinique","2024-06-26",0,0,0,0,0,0,0,0
"Martinique","2024-06-27",0,0,0,0,0,0,0,0
"Martinique","2024-06-28",0,0,0,0,0,0,0,0
"Martinique","2024-06-29",0,0,0,0,0,0,0,0
"Martinique","2024-06-30",0,0,0,0,0,0,0,0
"Martinique","2024-07-01",0,0,0,0,0,0,0,0
"Martinique","2024-07-02",0,0,0,0,0,0,0,0
"Martinique","2024-07-03",0,0,0,0,0,0,0,0
"Martinique","2024-07-04",0,0,0,0,0,0,0,0
"Martinique","2024-07-05",0,0,0,0,0,0,0,0
"Martinique","2024-07-06",0,0,0,0,0,0,0,0
"Martinique","2024-07-07",0,0,0,0,0,0,0,0
"Martinique","2024-07-08",0,0,0,0,0,0,0,0
"Martinique","2024-07-09",0,0,0,0,0,0,0,0
"Martinique","2024-07-10",0,0,0,0,0,0,0,0
"Martinique","2024-07-11",0,0,0,0,0,0,0,0
"Martinique","2024-07-12",0,0,0,0,0,0,0,0
"Martinique","2024-07-13",0,0,0,0,0,0,0,0
"Martinique","2024-07-14",0,0,0,0,0,0,0,0
"Martinique","2024-07-15",0,0,0,0,0,0,0,0
"Martinique","2024-07-16",0,0,0,0,0,0,0,0
"Martinique","2024-07-17",0,0,0,0,0,0,0,0
"Martinique","2024-07-18",0,0,0,0,0,0,0,0
"Martinique","2024-07-19",0,0,0,0,0,0,0,0
"Martinique","2024-07-20",0,0,0,0,0,0,0,0
"Martinique","2024-07-21",0,0,0,0,0,0,0,0
"Martinique","2024-07-22",0,0,0,0,0,0,0,0
"Martinique","2024-07-23",0,0,0,0,0,0,0,0
"Martinique","2024-07-24",0,0,0,0,0,0,0,0
"Martinique","2024-07-25",0,0,0,0,0,0,0,0
"Martinique","2024-07-26",0,0,0,0,0,0,0,0
"Martinique","2024-07-27",0,0,0,0,0,0,0,0
"Martinique","2024-07-28",0,0,0,0,0,0,0,0
"Martinique","2024-07-29",0,0,0,0,0,0,0,0
"Martinique","2024-07-30",0,0,0,0,0,0,0,0
"Martinique","2024-07-31",0,0,0,0,0,0,0,0
"Martinique","2024-08-01",0,0,0,0,0,0,0,0
"Martinique","2024-08-02",0,0,0,0,0,0,0,0
"Martinique","2024-08-03",0,0,0,0,0,0,0,0
"Martinique","2024-08-04",0,0,0,0,0,0,0,0
"Martinique","2024-08-05",0,0,0,0,0,0,0,0
"Martinique","2024-08-06",0,0,0,0,0,0,0,0
"Martinique","2024-08-07",0,0,0,0,0,0,0,0
"Martinique","2024-08-08",0,0,0,0,0,0,0,0
"Martinique","2024-08-09",0,0,0,0,0,0,0,0
"Martinique","2024-08-10",0,0,0,0,0,0,0,0
"Martinique","2024-08-11",0,0,0,0,0,0,0,0
"Martinique","2024-08-12",0,0,0,0,0,0,0,0
"Martinique","2024-08-13",0,0,0,0,0,0,0,0
"Martinique","2024-08-14",0,0,0,0,0,0,0,0
"Martinique","2024-08-15",0,0,0,0,0,0,0,0
"Martinique","2024-08-16",0,0,0,0,0,0,0,0
"Martinique","2024-08-17",0,0,0,0,0,0,0,0
"Martinique","2024-08-18",0,0,0,0,0,0,0,0
"Martinique","2024-08-19",0,0,0,0,0,0,0,0
"Martinique","2024-08-20",0,0,0,0,0,0,0,0
"Martinique","2024-08-21",0,0,0,0,0,0,0,0
"Martinique","2024-08-22",0,0,0,0,0,0,0,0
"Martinique","2024-08-23",0,0,0,0,0,0,0,0
"Martinique","2024-08-24",0,0,0,0,0,0,0,0
"Martinique","2024-08-25",0,0,0,0,0,0,0,0
"Martinique","2024-08-26",0,0,0,0,0,0,0,0
"Martinique","2024-08-27",0,0,0,0,0,0,0,0
"Martinique","2024-08-28",0,0,0,0,0,0,0,0
"Martinique","2024-08-29",0,0,0,0,0,0,0,0
"Martinique","2024-08-30",0,0,0,0,0,0,0,0
"Martinique","2024-08-31",0,0,0,0,0,0,0,0
"Martinique","2024-09-01",0,0,0,0,0,0,0,0
"Martinique","2024-09-02",0,0,0,0,0,0,0,0
"Martinique","2024-09-03",0,0,0,0,0,0,0,0
"Martinique","2024-09-04",0,0,0,0,0,0,0,0
"Martinique","2024-09-05",0,0,0,0,0,0,0,0
"Martinique","2024-09-06",0,0,0,0,0,0,0,0
"Martinique","2024-09-07",0,0,0,0,0,0,0,0
"Martinique","2024-09-08",0,0,0,0,0,0,0,0
"Martinique","2024-09-09",0,0,0,0,0,0,0,0
"Martinique","2024-09-10",0,0,0,0,0,0,0,0
"Martinique","2024-09-11",0,0,0,0,0,0,0,0
"Martinique","2024-09-12",0,0,0,0,0,0,0,0
"Martinique","2024-09-13",0,0,0,0,0,0,0,0
"Martinique","2024-09-14",0,0,0,0,0,0,0,0
"Martinique","2024-09-15",0,0,0,0,0,0,0,0
"Martinique","2024-09-16",0,0,0,0,0,0,0,0
"Martinique","2024-09-17",0,0,0,0,0,0,0,0
"Martinique","2024-09-18",0,0,0,0,0,0,0,0
"Martinique","2024-09-19",0,0,0,0,0,0,0,0
"Martinique","2024-09-20",0,0,0,0,0,0,0,0
"Martinique","2024-09-21",0,0,0,0,0,0,0,0
"Martinique","2024-09-22",0,0,0,0,0,0,0,0
"Martinique","2024-09-23",0,0,0,0,0,0,0,0
"Martinique","2024-09-24",0,0,0,0,0,0,0,0
"Martinique","2024-09-25",0,0,0,0,0,0,0,0
"Martinique","2024-09-26",0,0,0,0,0,0,0,0
"Martinique","2024-09-27",0,0,0,0,0,0,0,0
"Martinique","2024-09-28",0,0,0,0,0,0,0,0
"Martinique","2024-09-29",0,0,0,0,0,0,0,0
"Martinique","2024-09-30",0,0,0,0,0,0,0,0
"Martinique","2024-10-01",0,0,0,0,0,0,0,0
"Martinique","2024-10-02",0,0,0,0,0,0,0,0
"Martinique","2024-10-03",0,0,0,0,0,0,0,0
"Martinique","2024-10-04",0,0,0,0,0,0,0,0
"Martinique","2024-10-05",0,0,0,0,0,0,0,0
"Martinique","2024-10-06",0,0,0,0,0,0,0,0
"Martinique","2024-10-07",0,0,0,0,0,0,0,0
"Martinique","2024-10-08",0,0,0,0,0,0,0,0
"Martinique","2024-10-09",0,0,0,0,0,0,0,0
"Martinique","2024-10-10",0,0,0,0,0,0,0,0
"Martinique","2024-10-11",0,0,0,0,0,0,0,0
"Martinique","2024-10-12",0,0,0,0,0,0,0,0
"Martinique","2024-10-13",0,0,0,0,0,0,0,0
"Martinique","2024-10-14",0,0,0,0,0,0,0,0
"Martinique","2024-10-15",0,0,0,0,0,0,0,0
"Martinique","2024-10-16",0,0,0,0,0,0,0,0
"Martinique","2024-10-17",0,0,0,0,0,0,0,0
"Martinique","2024-10-18",0,0,0,0,0,0,0,0
"Martinique","2024-10-19",0,0,0,0,0,0,0,0
"Martinique","2024-10-20",0,0,0,0,0,0,0,0
"Martinique","2024-10-21",0,0,0,0,0,0,0,0
"Martinique","2024-10-22",0,0,0,0,0,0,0,0
"Martinique","2024-10-23",0,0,0,0,0,0,0,0
"Martinique","2024-10-24",0,0,0,0,0,0,0,0
"Martinique","2024-10-25",0,0,0,0,0,0,0,0
"Martinique","2024-10-26",0,0,0,0,0,0,0,0
"Martinique","2024-10-27",0,0,0,0,0,0,0,0
"Martinique","2024-10-28",0,0,0,0,0,0,0,0
"Martinique","2024-10-29",0,0,0,0,0,0,0,0
"Martinique","2024-10-30",0,0,0,0,0,0,0,0
"Martinique","2024-10-31",0,0,0,0,0,0,0,0
"Martinique","2024-11-01",0,0,0,0,0,0,0,0
"Martinique","2024-11-02",0,0,0,0,0,0,0,0
"Martinique","2024-11-03",0,0,0,0,0,0,0,0
"Martinique","2024-11-04",0,0,0,0,0,0,0,0
"Martinique","2024-11-05",0,0,0,0,0,0,0,0
"Martinique","2024-11-06",0,0,0,0,0,0,0,0
"Martinique","2024-11-07",0,0,0,0,0,0,0,0
"Martinique","2024-11-08",0,0,0,0,0,0,0,0
"Martinique","2024-11-09",0,0,0,0,0,0,0,0
"Martinique","2024-11-10",0,0,0,0,0,0,0,0
"Martinique","2024-11-11",0,0,0,0,0,0,0,0
"Martinique","2024-11-12",0,0,0,0,0,0,0,0
"Martinique","2024-11-13",0,0,0,0,0,0,0,0
"Martinique","2024-11-14",0,0,0,0,0,0,0,0
"Martinique","2024-11-15",0,0,0,0,0,0,0,0
"Martinique","2024-11-16",0,0,0,0,0,0,0,0
"Martinique","2024-11-17",0,0,0,0,0,0,0,0
"Martinique","2024-11-18",0,0,0,0,0,0,0,0
"Martinique","2024-11-19",0,0,0,0,0,0,0,0
"Martinique","2024-11-20",0,0,0,0,0,0,0,0
"Martinique","2024-11-21",0,0,0,0,0,0,0,0
"Martinique","2024-11-22",0,0,0,0,0,0,0,0
"Martinique","2024-11-23",0,0,0,0,0,0,0,0
"Martinique","2024-11-24",0,0,0,0,0,0,0,0
"Martinique","2024-11-25",0,0,0,0,0,0,0,0
"Martinique","2024-11-26",0,0,0,0,0,0,0,0
"Martinique","2024-11-27",0,0,0,0,0,0,0,0
"Martinique","2024-11-28",0,0,0,0,0,0,0,0
"Martinique","2024-11-29",0,0,0,0,0,0,0,0
"Martinique","2024-11-30",0,0,0,0,0,0,0,0
"Martinique","2024-12-01",0,0,0,0,0,0,0,0
"Martinique","2024-12-02",0,0,0,0,0,0,0,0
"Martinique","2024-12-03",0,0,0,0,0,0,0,0
"Martinique","2024-12-04",0,0,0,0,0,0,0,0
"Martinique","2024-12-05",0,0,0,0,0,0,0,0
"Martinique","2024-12-06",0,0,0,0,0,0,0,0
"Martinique","2024-12-07",0,0,0,0,0,0,0,0
"Martinique","2024-12-08",0,0,0,0,0,0,0,0
"Martinique","2024-12-09",0,0,0,0,0,0,0,0
"Martinique","2024-12-10",0,0,0,0,0,0,0,0
"Martinique","2024-12-11",0,0,0,0,0,0,0,0
"Martinique","2024-12-12",0,0,0,0,0,0,0,0
"Martinique","2024-12-13",0,0,0,0,0,0,0,0
"Martinique","2024-12-14",0,0,0,0,0,0,0,0
"Martinique","2024-12-15",0,0,0,0,0,0,0,0
"Martinique","2024-12-16",0,0,0,0,0,0,0,0
"Martinique","2024-12-17",0,0,0,0,0,0,0,0
"Martinique","2024-12-18",0,0,0,0,0,0,0,0
"Martinique","2024-12-19",0,0,0,0,0,0,0,0
"Martinique","2024-12-20",0,0,0,0,0,0,0,0
"Martinique","2024-12-21",0,0,0,0,0,0,0,0
"Martinique","2024-12-22",0,0,0,0,0,0,0,0
"Martinique","2024-12-23",0,0,0,0,0,0,0,0
"Martinique","2024-12-24",0,0,0,0,0,0,0,0
"Martinique","2024-12-25",0,0,0,0,0,0,0,0
"Martinique","2024-12-26",0,0,0,0,0,0,0,0
"Martinique","2024-12-27",0,0,0,0,0,0,0,0
"Martinique","2024-12-28",0,0,0,0,0,0,0,0
"Martinique","2024-12-29",0,0,0,0,0,0,0,0
"Martinique","2024-12-30",0,0,0,0,0,0,0,0
"Martinique","2024-12-31",0,0,0,0,0,0,0,0
"Martinique","2025-01-01",0,0,0,0,0,0,0,0
"Martinique","2025-01-02",0,0,0,0,0,0,0,0
"Martinique","2025-01-03",0,0,0,0,0,0,0,0
"Martinique","2025-01-04",0,0,0,0,0,0,0,0
"Martinique","2025-01-05",0,0,0,0,0,0,0,0
"Martinique","2025-01-06",0,0,0,0,0,0,0,0
"Martinique","2025-01-07",0,0,0,0,0,0,0,0
"Martinique","2025-01-08",0,0,0,0,0,0,0,0
"Martinique","2025-01-09",0,0,0,0,0,0,0,0
"Martinique","2025-01-10",0,0,0,0,0,0,0,0
"Martinique","2025-01-11",0,0,0,0,0,0,0,0
"Martinique","2025-01-12",0,0,0,0,0,0,0,0
"Martinique","2025-01-13",0,0,0,0,0,0,0,0
"Mauritius","2024-01-01",0,0,0,0,0,0,0,0
"Mauritius","2024-01-02",0,0,0,0,0,0,0,0
"Mauritius","2024-01-03",0,0,0,0,0,0,0,0
"Mauritius","2024-01-04",0,0,0,0,0,0,0,0
"Mauritius","2024-01-05",0,0,0,0,0,0,0,0
"Mauritius","2024-01-06",0,0,0,0,0,0,0,0
"Mauritius","2024-01-07",0,0,0,0,0,0,0,0
"Mauritius","2024-01-08",0,0,0,0,0,0,0,0
"Mauritius","2024-01-09",0,0,0,0,0,0,0,0
"Mauritius","2024-01-10",0,0,0,0,0,0,0,0
"Mauritius","2024-01-11",0,0,0,0,0,0,0,0
"Mauritius","2024-01-12",0,0,0,0,0,0,0,0
"Mauritius","2024-01-13",0,0,0,0,0,0,0,0
"Mauritius","2024-01-14",0,0,0,0,0,0,0,0
"Mauritius","2024-01-15",0,0,0,0,0,0,0,0
"Mauritius","2024-01-16",0,0,0,0,0,0,0,0
"Mauritius","2024-01-17",0,0,0,0,0,0,0,0
"Mauritius","2024-01-18",0,0,0,0,0,0,0,0
"Mauritius","2024-01-19",0,0,0,0,0,0,0,0
"Mauritius","2024-01-20",0,0,0,0,0,0,0,0
"Mauritius","2024-01-21",0,0,0,0,0,0,0,0
"Mauritius","2024-01-22",0,0,0,0,0,0,0,0
"Mauritius","2024-01-23",0,0,0,0,0,0,0,0
"Mauritius","2024-01-24",0,0,0,0,0,0,0,0
"Mauritius","2024-01-25",0,0,0,0,0,0,0,0
"Mauritius","2024-01-26",0,0,0,0,0,0,0,0
"Mauritius","2024-01-27",0,0,0,0,0,0,0,0
"Mauritius","2024-01-28",0,0,0,0,0,0,0,0
"Mauritius","2024-01-29",0,0,0,0,0,0,0,0
"Mauritius","2024-01-30",0,0,0,0,0,0,0,0
"Mauritius","2024-01-31",0,0,0,0,0,0,0,0
"Mauritius","2024-02-01",0,0,0,0,0,0,0,0
"Mauritius","2024-02-02",0,0,0,0,0,0,0,0
"Mauritius","2024-02-03",0,0,0,0,0,0,0,0
"Mauritius","2024-02-04",0,0,0,0,0,0,0,0
"Mauritius","2024-02-05",0,0,0,0,0,0,0,0
"Mauritius","2024-02-06",0,0,0,0,0,0,0,0
"Mauritius","2024-02-07",0,0,0,0,0,0,0,0
"Mauritius","2024-02-08",0,0,0,0,0,0,0,0
"Mauritius","2024-02-09",0,0,0,0,0,0,0,0
"Mauritius","2024-02-10",0,0,0,0,0,0,0,0
"Mauritius","2024-02-11",0,0,0,0,0,0,0,0
"Mauritius","2024-02-12",0,0,0,0,0,0,0,0
"Mauritius","2024-02-13",0,0,0,0,0,0,0,0
"Mauritius","2024-02-14",0,0,0,0,0,0,0,0
"Mauritius","2024-02-15",0,0,0,0,0,0,0,0
"Mauritius","2024-02-16",0,0,0,0,0,0,0,0
"Mauritius","2024-02-17",0,0,0,0,0,0,0,0
"Mauritius","2024-02-18",0,0,0,0,0,0,0,0
"Mauritius","2024-02-19",0,0,0,0,0,0,0,0
"Mauritius","2024-02-20",0,0,0,0,0,0,0,0
"Mauritius","2024-02-21",0,0,0,0,0,0,0,0
"Mauritius","2024-02-22",0,0,0,0,0,0,0,0
"Mauritius","2024-02-23",0,0,0,0,0,0,0,0
"Mauritius","2024-02-24",0,0,0,0,0,0,0,0
"Mauritius","2024-02-25",0,0,0,0,0,0,0,0
"Mauritius","2024-02-26",0,0,0,0,0,0,0,0
"Mauritius","2024-02-27",0,0,0,0,0,0,0,0
"Mauritius","2024-02-28",0,0,0,0,0,0,0,0
"Mauritius","2024-02-29",0,0,0,0,0,0,0,0
"Mauritius","2024-03-01",0,0,0,0,0,0,0,0
"Mauritius","2024-03-02",0,0,0,0,0,0,0,0
"Mauritius","2024-03-03",0,0,0,0,0,0,0,0
"Mauritius","2024-03-04",0,0,0,0,0,0,0,0
"Mauritius","2024-03-05",0,0,0,0,0,0,0,0
"Mauritius","2024-03-06",0,0,0,0,0,0,0,0
"Mauritius","2024-03-07",0,0,0,0,0,0,0,0
"Mauritius","2024-03-08",0,0,0,0,0,0,0,0
"Mauritius","2024-03-09",0,0,0,0,0,0,0,0
"Mauritius","2024-03-10",0,0,0,0,0,0,0,0
"Mauritius","2024-03-11",0,0,0,0,0,0,0,0
"Mauritius","2024-03-12",0,0,0,0,0,0,0,0
"Mauritius","2024-03-13",0,0,0,0,0,0,0,0
"Mauritius","2024-03-14",0,0,0,0,0,0,0,0
"Mauritius","2024-03-15",0,0,0,0,0,0,0,0
"Mauritius","2024-03-16",0,0,0,0,0,0,0,0
"Mauritius","2024-03-17",0,0,0,0,0,0,0,0
"Mauritius","2024-03-18",0,0,0,0,0,0,0,0
"Mauritius","2024-03-19",0,0,0,0,0,0,0,0
"Mauritius","2024-03-20",0,0,0,0,0,0,0,0
"Mauritius","2024-03-21",0,0,0,0,0,0,0,0
"Mauritius","2024-03-22",0,0,0,0,0,0,0,0
"Mauritius","2024-03-23",0,0,0,0,0,0,0,0
"Mauritius","2024-03-24",0,0,0,0,0,0,0,0
"Mauritius","2024-03-25",0,0,0,0,0,0,0,0
"Mauritius","2024-03-26",0,0,0,0,0,0,0,0
"Mauritius","2024-03-27",0,0,0,0,0,0,0,0
"Mauritius","2024-03-28",0,0,0,0,0,0,0,0
"Mauritius","2024-03-29",0,0,0,0,0,0,0,0
"Mauritius","2024-03-30",0,0,0,0,0,0,0,0
"Mauritius","2024-03-31",0,0,0,0,0,0,0,0
"Mauritius","2024-04-01",0,0,0,0,0,0,0,0
"Mauritius","2024-04-02",0,0,0,0,0,0,0,0
"Mauritius","2024-04-03",0,0,0,0,0,0,0,0
"Mauritius","2024-04-04",0,0,0,0,0,0,0,0
"Mauritius","2024-04-05",0,0,0,0,0,0,0,0
"Mauritius","2024-04-06",0,0,0,0,0,0,0,0
"Mauritius","2024-04-07",0,0,0,0,0,0,0,0
"Mauritius","2024-04-08",0,0,0,0,0,0,0,0
"Mauritius","2024-04-09",0,0,0,0,0,0,0,0
"Mauritius","2024-04-10",0,0,0,0,0,0,0,0
"Mauritius","2024-04-11",0,0,0,0,0,0,0,0
"Mauritius","2024-04-12",0,0,0,0,0,0,0,0
"Mauritius","2024-04-13",0,0,0,0,0,0,0,0
"Mauritius","2024-04-14",0,0,0,0,0,0,0,0
"Mauritius","2024-04-15",0,0,0,0,0,0,0,0
"Mauritius","2024-04-16",0,0,0,0,0,0,0,0
"Mauritius","2024-04-17",0,0,0,0,0,0,0,0
"Mauritius","2024-04-18",0,0,0,0,0,0,0,0
"Mauritius","2024-04-19",0,0,0,0,0,0,0,0
"Mauritius","2024-04-20",0,0,0,0,0,0,0,0
"Mauritius","2024-04-21",0,0,0,0,0,0,0,0
"Mauritius","2024-04-22",0,0,0,0,0,0,0,0
"Mauritius","2024-04-23",0,0,0,0,0,0,0,0
"Mauritius","2024-04-24",0,0,0,0,0,0,0,0
"Mauritius","2024-04-25",0,0,0,0,0,0,0,0
"Mauritius","2024-04-26",0,0,0,0,0,0,0,0
"Mauritius","2024-04-27",0,0,0,0,0,0,0,0
"Mauritius","2024-04-28",0,0,0,0,0,0,0,0
"Mauritius","2024-04-29",0,0,0,0,0,0,0,0
"Mauritius","2024-04-30",0,0,0,0,0,0,0,0
"Mauritius","2024-05-01",0,0,0,0,0,0,0,0
"Mauritius","2024-05-02",0,0,0,0,0,0,0,0
"Mauritius","2024-05-03",0,0,0,0,0,0,0,0
"Mauritius","2024-05-04",0,0,0,0,0,0,0,0
"Mauritius","2024-05-05",0,0,0,0,0,0,0,0
"Mauritius","2024-05-06",0,0,0,0,0,0,0,0
"Mauritius","2024-05-07",0,0,0,0,0,0,0,0
"Mauritius","2024-05-08",0,0,0,0,0,0,0,0
"Mauritius","2024-05-09",0,0,0,0,0,0,0,0
"Mauritius","2024-05-10",0,0,0,0,0,0,0,0
"Mauritius","2024-05-11",0,0,0,0,0,0,0,0
"Mauritius","2024-05-12",0,0,0,0,0,0,0,0
"Mauritius","2024-05-13",0,0,0,0,0,0,0,0
"Mauritius","2024-05-14",0,0,0,0,0,0,0,0
"Mauritius","2024-05-15",0,0,0,0,0,0,0,0
"Mauritius","2024-05-16",0,0,0,0,0,0,0,0
"Mauritius","2024-05-17",0,0,0,0,0,0,0,0
"Mauritius","2024-05-18",0,0,0,0,0,0,0,0
"Mauritius","2024-05-19",0,0,0,0,0,0,0,0
"Mauritius","2024-05-20",0,0,0,0,0,0,0,0
"Mauritius","2024-05-21",0,0,0,0,0,0,0,0
"Mauritius","2024-05-22",0,0,0,0,0,0,0,0
"Mauritius","2024-05-23",0,0,0,0,0,0,0,0
"Mauritius","2024-05-24",0,0,0,0,0,0,0,0
"Mauritius","2024-05-25",0,0,0,0,0,0,0,0
"Mauritius","2024-05-26",0,0,0,0,0,0,0,0
"Mauritius","2024-05-27",0,0,0,0,0,0,0,0
"Mauritius","2024-05-28",0,0,0,0,0,0,0,0
"Mauritius","2024-05-29",0,0,0,0,0,0,0,0
"Mauritius","2024-05-30",0,0,0,0,0,0,0,0
"Mauritius","2024-05-31",0,0,0,0,0,0,0,0
"Mauritius","2024-06-01",0,0,0,0,0,0,0,0
"Mauritius","2024-06-02",0,0,0,0,0,0,0,0
"Mauritius","2024-06-03",0,0,0,0,0,0,0,0
"Mauritius","2024-06-04",0,0,0,0,0,0,0,0
"Mauritius","2024-06-05",0,0,0,0,0,0,0,0
"Mauritius","2024-06-06",0,0,0,0,0,0,0,0
"Mauritius","2024-06-07",0,0,0,0,0,0,0,0
"Mauritius","2024-06-08",0,0,0,0,0,0,0,0
"Mauritius","2024-06-09",0,0,0,0,0,0,0,0
"Mauritius","2024-06-10",0,0,0,0,0,0,0,0
"Mauritius","2024-06-11",0,0,0,0,0,0,0,0
"Mauritius","2024-06-12",0,0,0,0,0,0,0,0
"Mauritius","2024-06-13",0,0,0,0,0,0,0,0
"Mauritius","2024-06-14",0,0,0,0,0,0,0,0
"Mauritius","2024-06-15",0,0,0,0,0,0,0,0
"Mauritius","2024-06-16",0,0,0,0,0,0,0,0
"Mauritius","2024-06-17",0,0,0,0,0,0,0,0
"Mauritius","2024-06-18",0,0,0,0,0,0,0,0
"Mauritius","2024-06-19",0,0,0,0,0,0,0,0
"Mauritius","2024-06-20",0,0,0,0,0,0,0,0
"Mauritius","2024-06-21",0,0,0,0,0,0,0,0
"Mauritius","2024-06-22",0,0,0,0,0,0,0,0
"Mauritius","2024-06-23",0,0,0,0,0,0,0,0
"Mauritius","2024-06-24",0,0,0,0,0,0,0,0
"Mauritius","2024-06-25",0,0,0,0,0,0,0,0
"Mauritius","2024-06-26",0,0,0,0,0,0,0,0
"Mauritius","2024-06-27",0,0,0,0,0,0,0,0
"Mauritius","2024-06-28",0,0,0,0,0,0,0,0
"Mauritius","2024-06-29",0,0,0,0,0,0,0,0
"Mauritius","2024-06-30",0,0,0,0,0,0,0,0
"Mauritius","2024-07-01",0,0,0,0,0,0,0,0
"Mauritius","2024-07-02",0,0,0,0,0,0,0,0
"Mauritius","2024-07-03",0,0,0,0,0,0,0,0
"Mauritius","2024-07-04",0,0,0,0,0,0,0,0
"Mauritius","2024-07-05",0,0,0,0,0,0,0,0
"Mauritius","2024-07-06",0,0,0,0,0,0,0,0
"Mauritius","2024-07-07",0,0,0,0,0,0,0,0
"Mauritius","2024-07-08",0,0,0,0,0,0,0,0
"Mauritius","2024-07-09",0,0,0,0,0,0,0,0
"Mauritius","2024-07-10",0,0,0,0,0,0,0,0
"Mauritius","2024-07-11",0,0,0,0,0,0,0,0
"Mauritius","2024-07-12",0,0,0,0,0,0,0,0
"Mauritius","2024-07-13",0,0,0,0,0,0,0,0
"Mauritius","2024-07-14",0,0,0,0,0,0,0,0
"Mauritius","2024-07-15",0,0,0,0,0,0,0,0
"Mauritius","2024-07-16",0,0,0,0,0,0,0,0
"Mauritius","2024-07-17",0,0,0,0,0,0,0,0
"Mauritius","2024-07-18",0,0,0,0,0,0,0,0
"Mauritius","2024-07-19",0,0,0,0,0,0,0,0
"Mauritius","2024-07-20",0,0,0,0,0,0,0,0
"Mauritius","2024-07-21",0,0,0,0,0,0,0,0
"Mauritius","2024-07-22",0,0,0,0,0,0,0,0
"Mauritius","2024-07-23",0,0,0,0,0,0,0,0
"Mauritius","2024-07-24",0,0,0,0,0,0,0,0
"Mauritius","2024-07-25",0,0,0,0,0,0,0,0
"Mauritius","2024-07-26",0,0,0,0,0,0,0,0
"Mauritius","2024-07-27",0,0,0,0,0,0,0,0
"Mauritius","2024-07-28",0,0,0,0,0,0,0,0
"Mauritius","2024-07-29",0,0,0,0,0,0,0,0
"Mauritius","2024-07-30",0,0,0,0,0,0,0,0
"Mauritius","2024-07-31",0,0,0,0,0,0,0,0
"Mauritius","2024-08-01",0,0,0,0,0,0,0,0
"Mauritius","2024-08-02",0,0,0,0,0,0,0,0
"Mauritius","2024-08-03",0,0,0,0,0,0,0,0
"Mauritius","2024-08-04",0,0,0,0,0,0,0,0
"Mauritius","2024-08-05",0,0,0,0,0,0,0,0
"Mauritius","2024-08-06",0,0,0,0,0,0,0,0
"Mauritius","2024-08-07",0,0,0,0,0,0,0,0
"Mauritius","2024-08-08",0,0,0,0,0,0,0,0
"Mauritius","2024-08-09",0,0,0,0,0,0,0,0
"Mauritius","2024-08-10",0,0,0,0,0,0,0,0
"Mauritius","2024-08-11",0,0,0,0,0,0,0,0
"Mauritius","2024-08-12",0,0,0,0,0,0,0,0
"Mauritius","2024-08-13",0,0,0,0,0,0,0,0
"Mauritius","2024-08-14",0,0,0,0,0,0,0,0
"Mauritius","2024-08-15",0,0,0,0,0,0,0,0
"Mauritius","2024-08-16",0,0,0,0,0,0,0,0
"Mauritius","2024-08-17",0,0,0,0,0,0,0,0
"Mauritius","2024-08-18",0,0,0,0,0,0,0,0
"Mauritius","2024-08-19",0,0,0,0,0,0,0,0
"Mauritius","2024-08-20",0,0,0,0,0,0,0,0
"Mauritius","2024-08-21",0,0,0,0,0,0,0,0
"Mauritius","2024-08-22",0,0,0,0,0,0,0,0
"Mauritius","2024-08-23",0,0,0,0,0,0,0,0
"Mauritius","2024-08-24",0,0,0,0,0,0,0,0
"Mauritius","2024-08-25",0,0,0,0,0,0,0,0
"Mauritius","2024-08-26",0,0,0,0,0,0,0,0
"Mauritius","2024-08-27",0,0,0,0,0,0,0,0
"Mauritius","2024-08-28",0,0,0,0,0,0,0,0
"Mauritius","2024-08-29",0,0,0,0,0,0,0,0
"Mauritius","2024-08-30",0,0,0,0,0,0,0,0
"Mauritius","2024-08-31",0,0,0,0,0,0,0,0
"Mauritius","2024-09-01",0,0,0,0,0,0,0,0
"Mauritius","2024-09-02",0,0,0,0,0,0,0,0
"Mauritius","2024-09-03",0,0,0,0,0,0,0,0
"Mauritius","2024-09-04",0,0,0,0,0,0,0,0
"Mauritius","2024-09-05",0,0,0,0,0,0,0,0
"Mauritius","2024-09-06",0,0,0,0,0,0,0,0
"Mauritius","2024-09-07",0,0,0,0,0,0,0,0
"Mauritius","2024-09-08",0,0,0,0,0,0,0,0
"Mauritius","2024-09-09",0,0,0,0,0,0,0,0
"Mauritius","2024-09-10",0,0,0,0,0,0,0,0
"Mauritius","2024-09-11",0,0,0,0,0,0,0,0
"Mauritius","2024-09-12",0,0,0,0,0,0,0,0
"Mauritius","2024-09-13",0,0,0,0,0,0,0,0
"Mauritius","2024-09-14",0,0,0,0,0,0,0,0
"Mauritius","2024-09-15",0,0,0,0,0,0,0,0
"Mauritius","2024-09-16",0,0,0,0,0,0,0,0
"Mauritius","2024-09-17",0,0,0,0,0,0,0,0
"Mauritius","2024-09-18",0,0,0,0,0,0,0,0
"Mauritius","2024-09-19",0,0,0,0,0,0,0,0
"Mauritius","2024-09-20",0,0,0,0,0,0,0,0
"Mauritius","2024-09-21",0,0,0,0,0,0,0,0
"Mauritius","2024-09-22",0,0,0,0,0,0,0,0
"Mauritius","2024-09-23",0,0,0,0,0,0,0,0
"Mauritius","2024-09-24",0,0,0,0,0,0,0,0
"Mauritius","2024-09-25",0,0,0,0,0,0,0,0
"Mauritius","2024-09-26",0,0,0,0,0,0,0,0
"Mauritius","2024-09-27",0,0,0,0,0,0,0,0
"Mauritius","2024-09-28",0,0,0,0,0,0,0,0
"Mauritius","2024-09-29",0,0,0,0,0,0,0,0
"Mauritius","2024-09-30",0,0,0,0,0,0,0,0
"Mauritius","2024-10-01",0,0,0,0,0,0,0,0
"Mauritius","2024-10-02",0,0,0,0,0,0,0,0
"Mauritius","2024-10-03",0,0,0,0,0,0,0,0
"Mauritius","2024-10-04",0,0,0,0,0,0,0,0
"Mauritius","2024-10-05",0,0,0,0,0,0,0,0
"Mauritius","2024-10-06",0,0,0,0,0,0,0,0
"Mauritius","2024-10-07",0,0,0,0,0,0,0,0
"Mauritius","2024-10-08",0,0,0,0,0,0,0,0
"Mauritius","2024-10-09",0,0,0,0,0,0,0,0
"Mauritius","2024-10-10",0,0,0,0,0,0,0,0
"Mauritius","2024-10-11",0,0,0,0,0,0,0,0
"Mauritius","2024-10-12",0,0,0,0,0,0,0,0
"Mauritius","2024-10-13",0,0,0,0,0,0,0,0
"Mauritius","2024-10-14",0,0,0,0,0,0,0,0
"Mauritius","2024-10-15",0,0,0,0,0,0,0,0
"Mauritius","2024-10-16",0,0,0,0,0,0,0,0
"Mauritius","2024-10-17",0,0,0,0,0,0,0,0
"Mauritius","2024-10-18",0,0,0,0,0,0,0,0
"Mauritius","2024-10-19",0,0,0,0,0,0,0,0
"Mauritius","2024-10-20",0,0,0,0,0,0,0,0
"Mauritius","2024-10-21",0,0,0,0,0,0,0,0
"Mauritius","2024-10-22",0,0,0,0,0,0,0,0
"Mauritius","2024-10-23",0,0,0,0,0,0,0,0
"Mauritius","2024-10-24",0,0,0,0,0,0,0,0
"Mauritius","2024-10-25",0,0,0,0,0,0,0,0
"Mauritius","2024-10-26",0,0,0,0,0,0,0,0
"Mauritius","2024-10-27",0,1,1,0,1,1,0,0
"Mauritius","2024-10-28",0,0,1,0,0,1,0,0
"Mauritius","2024-10-29",0,0,1,0,0,1,0,0
"Mauritius","2024-10-30",0,0,1,0,0,1,0,0
"Mauritius","2024-10-31",0,0,1,0,0,1,0,0
"Mauritius","2024-11-01",0,0,1,0,0,1,0,0
"Mauritius","2024-11-02",0,0,1,0,0,1,0,0
"Mauritius","2024-11-03",0,0,1,0,0,1,0,0
"Mauritius","2024-11-04",0,0,1,0,0,1,0,0
"Mauritius","2024-11-05",0,0,1,0,0,1,0,0
"Mauritius","2024-11-06",0,0,1,0,0,1,0,0
"Mauritius","2024-11-07",0,0,1,0,0,1,0,0
"Mauritius","2024-11-08",0,0,1,0,0,1,0,0
"Mauritius","2024-11-09",0,0,1,0,0,1,0,0
"Mauritius","2024-11-10",0,0,1,0,0,1,0,0
"Mauritius","2024-11-11",0,0,1,0,0,1,0,0
"Mauritius","2024-11-12",0,0,1,0,0,1,0,0
"Mauritius","2024-11-13",0,0,1,0,0,1,0,0
"Mauritius","2024-11-14",0,0,1,0,0,1,0,0
"Mauritius","2024-11-15",0,0,1,0,0,1,0,0
"Mauritius","2024-11-16",0,0,1,0,0,1,0,0
"Mauritius","2024-11-17",0,0,1,0,0,1,0,0
"Mauritius","2024-11-18",0,0,1,0,0,1,0,0
"Mauritius","2024-11-19",0,0,1,0,0,1,0,0
"Mauritius","2024-11-20",0,0,1,0,0,1,0,0
"Mauritius","2024-11-21",0,0,1,0,0,1,0,0
"Mauritius","2024-11-22",0,0,1,0,0,1,0,0
"Mauritius","2024-11-23",0,0,1,0,0,1,0,0
"Mauritius","2024-11-24",0,0,1,0,0,1,0,0
"Mauritius","2024-11-25",0,0,1,0,0,1,0,0
"Mauritius","2024-11-26",0,0,1,0,0,1,0,0
"Mauritius","2024-11-27",0,0,1,0,0,1,0,0
"Mauritius","2024-11-28",0,0,1,0,0,1,0,0
"Mauritius","2024-11-29",0,0,1,0,0,1,0,0
"Mauritius","2024-11-30",0,0,1,0,0,1,0,0
"Mauritius","2024-12-01",0,0,1,0,0,1,0,0
"Mauritius","2024-12-02",0,0,1,0,0,1,0,0
"Mauritius","2024-12-03",0,0,1,0,0,1,0,0
"Mauritius","2024-12-04",0,0,1,0,0,1,0,0
"Mauritius","2024-12-05",0,0,1,0,0,1,0,0
"Mauritius","2024-12-06",0,0,1,0,0,1,0,0
"Mauritius","2024-12-07",0,0,1,0,0,1,0,0
"Mauritius","2024-12-08",0,0,1,0,0,1,0,0
"Mauritius","2024-12-09",0,0,1,0,0,1,0,0
"Mauritius","2024-12-10",0,0,1,0,0,1,0,0
"Mauritius","2024-12-11",0,0,1,0,0,1,0,0
"Mauritius","2024-12-12",0,0,1,0,0,1,0,0
"Mauritius","2024-12-13",0,0,1,0,0,1,0,0
"Mauritius","2024-12-14",0,0,1,0,0,1,0,0
"Mauritius","2024-12-15",0,0,1,0,0,1,0,0
"Mauritius","2024-12-16",0,0,1,0,0,1,0,0
"Mauritius","2024-12-17",0,0,1,0,0,1,0,0
"Mauritius","2024-12-18",0,0,1,0,0,1,0,0
"Mauritius","2024-12-19",0,0,1,0,0,1,0,0
"Mauritius","2024-12-20",0,0,1,0,0,1,0,0
"Mauritius","2024-12-21",0,0,1,0,0,1,0,0
"Mauritius","2024-12-22",0,0,1,0,0,1,0,0
"Mauritius","2024-12-23",0,0,1,0,0,1,0,0
"Mauritius","2024-12-24",0,0,1,0,0,1,0,0
"Mauritius","2024-12-25",0,0,1,0,0,1,0,0
"Mauritius","2024-12-26",0,0,1,0,0,1,0,0
"Mauritius","2024-12-27",0,0,1,0,0,1,0,0
"Mauritius","2024-12-28",0,0,1,0,0,1,0,0
"Mauritius","2024-12-29",0,0,1,0,0,1,0,0
"Mauritius","2024-12-30",0,0,1,0,0,1,0,0
"Mauritius","2024-12-31",0,0,1,0,0,1,0,0
"Mauritius","2025-01-01",0,0,1,0,0,1,0,0
"Mauritius","2025-01-02",0,0,1,0,0,1,0,0
"Mauritius","2025-01-03",0,0,1,0,0,1,0,0
"Mauritius","2025-01-04",0,0,1,0,0,1,0,0
"Mauritius","2025-01-05",0,0,1,0,0,1,0,0
"Mauritius","2025-01-06",0,0,1,0,0,1,0,0
"Mauritius","2025-01-07",0,0,1,0,0,1,0,0
"Mauritius","2025-01-08",0,0,1,0,0,1,0,0
"Mauritius","2025-01-09",0,0,1,0,0,1,0,0
"Mauritius","2025-01-10",0,0,1,0,0,1,0,0
"Mauritius","2025-01-11",0,0,1,0,0,1,0,0
"Mauritius","2025-01-12",0,0,1,0,0,1,0,0
"Mauritius","2025-01-13",0,0,1,0,0,1,0,0
"Mexico","2024-01-01",0,0,0,0,0,0,0,0
"Mexico","2024-01-02",0,0,0,0,0,0,0,0
"Mexico","2024-01-03",0,0,0,0,0,0,0,0
"Mexico","2024-01-04",0,0,0,0,0,0,0,0
"Mexico","2024-01-05",0,0,0,0,0,0,0,0
"Mexico","2024-01-06",0,0,0,0,0,0,0,0
"Mexico","2024-01-07",0,0,0,0,0,0,0,0
"Mexico","2024-01-08",0,0,0,0,0,0,0,0
"Mexico","2024-01-09",0,1,1,0,1,1,0,0
"Mexico","2024-01-10",0,0,1,0,0,1,0,0
"Mexico","2024-01-11",0,0,1,0,0,1,0,0
"Mexico","2024-01-12",0,0,1,0,0,1,0,0
"Mexico","2024-01-13",0,0,1,0,1,2,0,0
"Mexico","2024-01-14",0,0,1,0,0,2,0,0
"Mexico","2024-01-15",0,0,1,0,0,2,0,0
"Mexico","2024-01-16",0,1,2,0,0,2,0,0
"Mexico","2024-01-17",0,0,2,0,0,2,0,0
"Mexico","2024-01-18",0,0,2,0,0,2,0,0
"Mexico","2024-01-19",0,0,2,0,0,2,0,0
"Mexico","2024-01-20",0,0,2,0,1,3,0,0
"Mexico","2024-01-21",0,0,2,0,0,3,0,0
"Mexico","2024-01-22",0,0,2,0,0,3,0,0
"Mexico","2024-01-23",0,0,2,0,0,3,0,0
"Mexico","2024-01-24",0,0,2,0,0,3,0,0
"Mexico","2024-01-25",0,0,2,0,0,3,0,0
"Mexico","2024-01-26",0,0,2,0,0,3,0,0
"Mexico","2024-01-27",0,0,2,0,1,4,0,0
"Mexico","2024-01-28",0,0,2,0,0,4,0,0
"Mexico","2024-01-29",0,0,2,0,0,4,0,0
"Mexico","2024-01-30",0,2,4,0,0,4,0,0
"Mexico","2024-01-31",0,0,4,0,0,4,0,0
"Mexico","2024-02-01",0,0,4,0,0,4,0,0
"Mexico","2024-02-02",0,0,4,0,0,4,0,0
"Mexico","2024-02-03",0,0,4,0,0,4,0,0
"Mexico","2024-02-04",0,0,4,0,0,4,0,0
"Mexico","2024-02-05",0,0,4,0,0,4,0,0
"Mexico","2024-02-06",0,0,4,0,0,4,0,0
"Mexico","2024-02-07",0,0,4,0,1,5,0,0
"Mexico","2024-02-08",0,0,4,0,0,5,0,0
"Mexico","2024-02-09",0,0,4,0,0,5,0,0
"Mexico","2024-02-10",0,0,4,0,0,5,0,0
"Mexico","2024-02-11",0,0,4,0,0,5,0,0
"Mexico","2024-02-12",0,0,4,0,0,5,0,0
"Mexico","2024-02-13",0,1,5,0,0,5,0,0
"Mexico","2024-02-14",0,0,5,0,0,5,0,0
"Mexico","2024-02-15",0,0,5,0,0,5,0,0
"Mexico","2024-02-16",0,0,5,0,0,5,0,0
"Mexico","2024-02-17",0,0,5,0,0,5,0,0
"Mexico","2024-02-18",0,0,5,0,0,5,0,0
"Mexico","2024-02-19",0,0,5,0,0,5,0,0
"Mexico","2024-02-20",0,0,5,0,0,5,0,0
"Mexico","2024-02-21",0,0,5,0,1,6,0,0
"Mexico","2024-02-22",0,0,5,0,0,6,0,0
"Mexico","2024-02-23",0,0,5,0,0,6,0,0
"Mexico","2024-02-24",0,0,5,0,0,6,0,0
"Mexico","2024-02-25",0,0,5,0,0,6,0,0
"Mexico","2024-02-26",0,0,5,0,0,6,0,0
"Mexico","2024-02-27",0,0,5,0,0,6,0,0
"Mexico","2024-02-28",0,0,5,0,0,6,0,0
"Mexico","2024-02-29",0,0,5,0,0,6,0,0
"Mexico","2024-03-01",0,0,5,0,0,6,0,0
"Mexico","2024-03-02",0,0,5,0,0,6,0,0
"Mexico","2024-03-03",0,0,5,0,0,6,0,0
"Mexico","2024-03-04",0,0,5,0,0,6,0,0
"Mexico","2024-03-05",0,0,5,0,1,7,0,0
"Mexico","2024-03-06",0,0,5,0,0,7,0,0
"Mexico","2024-03-07",0,0,5,0,0,7,0,0
"Mexico","2024-03-08",0,0,5,0,0,7,0,0
"Mexico","2024-03-09",0,0,5,0,0,7,0,0
"Mexico","2024-03-10",0,0,5,0,0,7,0,0
"Mexico","2024-03-11",0,0,5,0,0,7,0,0
"Mexico","2024-03-12",0,2,7,0,0,7,0,0
"Mexico","2024-03-13",0,0,7,0,0,7,0,0
"Mexico","2024-03-14",0,0,7,0,0,7,0,0
"Mexico","2024-03-15",0,0,7,0,0,7,0,0
"Mexico","2024-03-16",0,0,7,0,1,8,0,0
"Mexico","2024-03-17",0,0,7,0,0,8,0,0
"Mexico","2024-03-18",0,0,7,0,0,8,0,0
"Mexico","2024-03-19",0,0,7,0,0,8,0,0
"Mexico","2024-03-20",0,0,7,0,0,8,0,0
"Mexico","2024-03-21",0,0,7,0,0,8,0,0
"Mexico","2024-03-22",0,0,7,0,0,8,0,0
"Mexico","2024-03-23",0,0,7,0,1,9,0,0
"Mexico","2024-03-24",0,0,7,0,0,9,0,0
"Mexico","2024-03-25",0,0,7,0,0,9,0,0
"Mexico","2024-03-26",0,2,9,0,0,9,0,0
"Mexico","2024-03-27",0,0,9,0,0,9,0,0
"Mexico","2024-03-28",0,0,9,0,0,9,0,0
"Mexico","2024-03-29",0,0,9,0,0,9,0,0
"Mexico","2024-03-30",0,0,9,0,1,10,0,0
"Mexico","2024-03-31",0,0,9,0,0,10,0,0
"Mexico","2024-04-01",0,0,9,0,0,10,0,0
"Mexico","2024-04-02",0,1,10,0,0,10,0,0
"Mexico","2024-04-03",0,0,10,0,0,10,0,0
"Mexico","2024-04-04",0,0,10,0,0,10,0,0
"Mexico","2024-04-05",0,0,10,0,0,10,0,0
"Mexico","2024-04-06",0,0,10,0,1,11,0,0
"Mexico","2024-04-07",0,0,10,0,0,11,0,0
"Mexico","2024-04-08",0,0,10,0,0,11,0,0
"Mexico","2024-04-09",0,0,10,0,0,11,0,0
"Mexico","2024-04-10",0,0,10,0,0,11,0,0
"Mexico","2024-04-11",0,0,10,0,0,11,0,0
"Mexico","2024-04-12",0,0,10,0,0,11,0,0
"Mexico","2024-04-13",0,0,10,0,1,12,0,0
"Mexico","2024-04-14",0,0,10,0,0,12,0,0
"Mexico","2024-04-15",0,0,10,0,0,12,0,0
"Mexico","2024-04-16",0,2,12,0,0,12,0,0
"Mexico","2024-04-17",0,0,12,0,1,13,0,0
"Mexico","2024-04-18",0,0,12,0,0,13,0,0
"Mexico","2024-04-19",0,0,12,0,1,14,0,0
"Mexico","2024-04-20",0,0,12,0,1,15,0,0
"Mexico","2024-04-21",0,0,12,0,1,16,0,0
"Mexico","2024-04-22",0,0,12,0,0,16,0,0
"Mexico","2024-04-23",0,5,17,0,1,17,0,0
"Mexico","2024-04-24",0,0,17,0,0,17,0,0
"Mexico","2024-04-25",0,0,17,0,0,17,0,0
"Mexico","2024-04-26",0,0,17,0,0,17,0,0
"Mexico","2024-04-27",0,0,17,0,1,18,0,0
"Mexico","2024-04-28",0,0,17,0,0,18,0,0
"Mexico","2024-04-29",0,0,17,0,0,18,0,0
"Mexico","2024-04-30",0,1,18,0,0,18,0,0
"Mexico","2024-05-01",0,0,18,0,0,18,0,0
"Mexico","2024-05-02",0,0,18,0,1,19,0,0
"Mexico","2024-05-03",0,0,18,0,0,19,0,0
"Mexico","2024-05-04",0,0,18,0,1,20,0,0
"Mexico","2024-05-05",0,0,18,0,0,20,0,0
"Mexico","2024-05-06",0,0,18,0,1,21,0,0
"Mexico","2024-05-07",0,0,18,0,0,21,0,0
"Mexico","2024-05-08",0,0,18,0,0,21,0,0
"Mexico","2024-05-09",0,0,18,0,1,22,0,0
"Mexico","2024-05-10",0,0,18,0,0,22,0,0
"Mexico","2024-05-11",0,0,18,0,1,23,0,0
"Mexico","2024-05-12",0,0,18,0,0,23,0,0
"Mexico","2024-05-13",0,0,18,0,1,24,0,0
"Mexico","2024-05-14",0,6,24,0,0,24,0,0
"Mexico","2024-05-15",0,0,24,0,0,24,0,0
"Mexico","2024-05-16",0,0,24,0,1,25,0,0
"Mexico","2024-05-17",0,0,24,0,0,25,0,0
"Mexico","2024-05-18",0,0,24,0,1,26,0,0
"Mexico","2024-05-19",0,0,24,0,0,26,0,0
"Mexico","2024-05-20",0,0,24,0,1,27,0,0
"Mexico","2024-05-21",0,3,27,0,0,27,0,0
"Mexico","2024-05-22",0,0,27,0,1,28,0,0
"Mexico","2024-05-23",0,0,27,0,1,29,0,0
"Mexico","2024-05-24",0,0,27,0,1,30,0,0
"Mexico","2024-05-25",0,0,27,0,2,32,0,0
"Mexico","2024-05-26",0,0,27,0,1,33,0,0
"Mexico","2024-05-27",0,0,27,0,1,34,0,0
"Mexico","2024-05-28",0,8,35,0,1,35,0,0
"Mexico","2024-05-29",0,0,35,0,0,35,0,0
"Mexico","2024-05-30",0,0,35,0,1,36,0,0
"Mexico","2024-05-31",0,0,35,0,0,36,0,0
"Mexico","2024-06-01",0,0,35,0,1,37,0,0
"Mexico","2024-06-02",0,0,35,0,0,37,0,0
"Mexico","2024-06-03",0,0,35,0,1,38,0,0
"Mexico","2024-06-04",0,3,38,0,0,38,0,0
"Mexico","2024-06-05",0,0,38,0,0,38,0,0
"Mexico","2024-06-06",0,0,38,0,1,39,0,0
"Mexico","2024-06-07",0,0,38,0,0,39,0,0
"Mexico","2024-06-08",0,0,38,0,0,39,0,0
"Mexico","2024-06-09",0,0,38,0,0,39,0,0
"Mexico","2024-06-10",0,0,38,0,1,40,0,0
"Mexico","2024-06-11",0,2,40,0,0,40,0,0
"Mexico","2024-06-12",0,0,40,0,1,41,0,0
"Mexico","2024-06-13",0,0,40,0,0,41,0,0
"Mexico","2024-06-14",0,0,40,0,1,42,0,0
"Mexico","2024-06-15",0,0,40,0,0,42,0,0
"Mexico","2024-06-16",0,0,40,0,1,43,0,0
"Mexico","2024-06-17",0,0,40,0,0,43,0,0
"Mexico","2024-06-18",0,4,44,0,1,44,0,0
"Mexico","2024-06-19",0,0,44,0,0,44,0,0
"Mexico","2024-06-20",0,0,44,0,1,45,0,0
"Mexico","2024-06-21",0,0,44,0,0,45,0,0
"Mexico","2024-06-22",0,0,44,0,0,45,0,0
"Mexico","2024-06-23",0,0,44,0,0,45,0,0
"Mexico","2024-06-24",0,0,44,0,1,46,0,0
"Mexico","2024-06-25",0,2,46,0,0,46,0,0
"Mexico","2024-06-26",0,0,46,0,0,46,0,0
"Mexico","2024-06-27",0,0,46,0,0,46,0,0
"Mexico","2024-06-28",0,0,46,0,0,46,0,0
"Mexico","2024-06-29",0,0,46,0,1,47,0,0
"Mexico","2024-06-30",0,0,46,0,0,47,0,0
"Mexico","2024-07-01",0,0,46,0,0,47,0,0
"Mexico","2024-07-02",0,1,47,0,0,47,0,0
"Mexico","2024-07-03",0,0,47,0,0,47,0,0
"Mexico","2024-07-04",0,0,47,0,1,48,0,0
"Mexico","2024-07-05",0,0,47,0,0,48,0,0
"Mexico","2024-07-06",0,0,47,0,0,48,0,0
"Mexico","2024-07-07",0,0,47,0,0,48,0,0
"Mexico","2024-07-08",0,0,47,0,1,49,0,0
"Mexico","2024-07-09",0,2,49,0,0,49,0,0
"Mexico","2024-07-10",0,0,49,0,0,49,0,0
"Mexico","2024-07-11",0,0,49,0,0,49,0,0
"Mexico","2024-07-12",0,0,49,0,1,50,0,0
"Mexico","2024-07-13",0,0,49,0,0,50,0,0
"Mexico","2024-07-14",0,0,49,0,0,50,0,0
"Mexico","2024-07-15",0,0,49,0,0,50,0,0
"Mexico","2024-07-16",0,0,49,0,1,51,0,0
"Mexico","2024-07-17",0,0,49,0,0,51,0,0
"Mexico","2024-07-18",0,0,49,0,0,51,0,0
"Mexico","2024-07-19",0,0,49,0,0,51,0,0
"Mexico","2024-07-20",0,0,49,0,0,51,0,0
"Mexico","2024-07-21",0,0,49,0,1,52,0,0
"Mexico","2024-07-22",0,0,49,0,0,52,0,0
"Mexico","2024-07-23",0,3,52,0,0,52,0,0
"Mexico","2024-07-24",0,0,52,0,0,52,0,0
"Mexico","2024-07-25",0,0,52,0,1,53,0,0
"Mexico","2024-07-26",0,0,52,0,0,53,0,0
"Mexico","2024-07-27",0,0,52,0,0,53,0,0
"Mexico","2024-07-28",0,0,52,0,0,53,0,0
"Mexico","2024-07-29",0,0,52,0,1,54,0,0
"Mexico","2024-07-30",0,2,54,0,0,54,0,0
"Mexico","2024-07-31",0,0,54,0,1,55,0,0
"Mexico","2024-08-01",0,0,54,0,1,56,0,0
"Mexico","2024-08-02",0,0,54,0,1,57,0,0
"Mexico","2024-08-03",0,0,54,0,0,57,0,0
"Mexico","2024-08-04",0,0,54,0,1,58,0,0
"Mexico","2024-08-05",0,0,54,0,1,59,0,0
"Mexico","2024-08-06",0,6,60,0,1,60,0,0
"Mexico","2024-08-07",0,0,60,0,2,62,0,0
"Mexico","2024-08-08",0,0,60,0,1,63,0,0
"Mexico","2024-08-09",0,0,60,0,2,65,0,0
"Mexico","2024-08-10",0,0,60,0,1,66,0,0
"Mexico","2024-08-11",0,0,60,0,2,68,0,0
"Mexico","2024-08-12",0,0,60,0,1,69,0,0
"Mexico","2024-08-13",0,11,71,0,2,71,0,0
"Mexico","2024-08-14",0,0,71,0,1,72,0,0
"Mexico","2024-08-15",0,0,71,0,0,72,0,0
"Mexico","2024-08-16",0,0,71,0,1,73,0,0
"Mexico","2024-08-17",0,0,71,0,1,74,0,0
"Mexico","2024-08-18",0,0,71,0,1,75,0,0
"Mexico","2024-08-19",0,0,71,0,0,75,0,0
"Mexico","2024-08-20",0,5,76,0,1,76,0,0
"Mexico","2024-08-21",0,0,76,0,1,77,0,0
"Mexico","2024-08-22",0,0,76,0,2,79,0,0
"Mexico","2024-08-23",0,0,76,0,1,80,0,0
"Mexico","2024-08-24",0,0,76,0,2,82,0,0
"Mexico","2024-08-25",0,0,76,0,1,83,0,0
"Mexico","2024-08-26",0,0,76,0,2,85,0,0
"Mexico","2024-08-27",0,10,86,0,1,86,0,0
"Mexico","2024-08-28",0,0,86,0,1,87,0,0
"Mexico","2024-08-29",0,0,86,0,0,87,0,0
"Mexico","2024-08-30",0,0,86,0,1,88,0,0
"Mexico","2024-08-31",0,0,86,0,0,88,0,0
"Mexico","2024-09-01",0,0,86,0,1,89,0,0
"Mexico","2024-09-02",0,0,86,0,0,89,0,0
"Mexico","2024-09-03",0,4,90,0,1,90,0,0
"Mexico","2024-09-04",0,0,90,0,0,90,0,0
"Mexico","2024-09-05",0,0,90,0,1,91,0,0
"Mexico","2024-09-06",0,0,90,0,0,91,0,0
"Mexico","2024-09-07",0,0,90,0,1,92,0,0
"Mexico","2024-09-08",0,0,90,0,0,92,0,0
"Mexico","2024-09-09",0,0,90,0,1,93,0,0
"Mexico","2024-09-10",0,3,93,0,0,93,0,0
"Mexico","2024-09-11",0,0,93,0,1,94,0,0
"Mexico","2024-09-12",0,0,93,0,1,95,0,0
"Mexico","2024-09-13",0,0,93,0,1,96,0,0
"Mexico","2024-09-14",0,0,93,0,0,96,0,0
"Mexico","2024-09-15",0,0,93,0,1,97,0,0
"Mexico","2024-09-16",0,0,93,0,1,98,0,0
"Mexico","2024-09-17",0,6,99,0,1,99,0,0
"Mexico","2024-09-18",0,0,99,0,1,100,0,0
"Mexico","2024-09-19",0,0,99,0,0,100,0,0
"Mexico","2024-09-20",0,0,99,0,1,101,0,0
"Mexico","2024-09-21",0,0,99,0,0,101,0,0
"Mexico","2024-09-22",0,0,99,0,1,102,0,0
"Mexico","2024-09-23",0,0,99,0,0,102,0,0
"Mexico","2024-09-24",0,4,103,0,1,103,0,0
"Mexico","2024-09-25",0,0,103,0,0,103,0,0
"Mexico","2024-09-26",0,0,103,0,1,104,0,0
"Mexico","2024-09-27",0,0,103,0,0,104,0,0
"Mexico","2024-09-28",0,0,103,0,0,104,0,0
"Mexico","2024-09-29",0,0,103,0,0,104,0,0
"Mexico","2024-09-30",0,0,103,0,1,105,0,0
"Mexico","2024-10-01",0,2,105,0,0,105,0,0
"Mexico","2024-10-02",0,0,105,0,0,105,0,0
"Mexico","2024-10-03",0,0,105,0,1,106,0,0
"Mexico","2024-10-04",0,0,105,0,0,106,0,0
"Mexico","2024-10-05",0,0,105,0,0,106,0,0
"Mexico","2024-10-06",0,0,105,0,0,106,0,0
"Mexico","2024-10-07",0,0,105,0,1,107,0,0
"Mexico","2024-10-08",0,2,107,0,0,107,0,0
"Mexico","2024-10-09",0,0,107,0,1,108,0,0
"Mexico","2024-10-10",0,0,107,0,0,108,0,0
"Mexico","2024-10-11",0,0,107,0,1,109,0,0
"Mexico","2024-10-12",0,0,107,0,0,109,0,0
"Mexico","2024-10-13",0,0,107,0,1,110,0,0
"Mexico","2024-10-14",0,0,107,0,0,110,0,0
"Mexico","2024-10-15",0,4,111,0,1,111,0,0
"Mexico","2024-10-16",0,0,111,0,0,111,0,0
"Mexico","2024-10-17",0,0,111,0,0,111,0,0
"Mexico","2024-10-18",0,0,111,0,0,111,0,0
"Mexico","2024-10-19",0,0,111,0,1,112,0,0
"Mexico","2024-10-20",0,0,111,0,0,112,0,0
"Mexico","2024-10-21",0,0,111,0,0,112,0,0
"Mexico","2024-10-22",0,1,112,0,0,112,0,0
"Mexico","2024-10-23",0,0,112,0,0,112,0,0
"Mexico","2024-10-24",0,0,112,0,0,112,0,0
"Mexico","2024-10-25",0,0,112,0,0,112,0,0
"Mexico","2024-10-26",0,0,112,0,1,113,0,0
"Mexico","2024-10-27",0,0,112,0,0,113,0,0
"Mexico","2024-10-28",0,0,112,0,0,113,0,0
"Mexico","2024-10-29",0,1,113,0,0,113,0,0
"Mexico","2024-10-30",0,0,113,0,0,113,0,0
"Mexico","2024-10-31",0,0,113,0,0,113,0,0
"Mexico","2024-11-01",0,0,113,0,0,113,0,0
"Mexico","2024-11-02",0,0,113,0,0,113,0,0
"Mexico","2024-11-03",0,0,113,0,0,113,0,0
"Mexico","2024-11-04",0,0,113,0,0,113,0,0
"Mexico","2024-11-05",0,0,113,0,0,113,0,0
"Mexico","2024-11-06",0,0,113,0,0,113,0,0
"Mexico","2024-11-07",0,0,113,0,0,113,0,0
"Mexico","2024-11-08",0,0,113,0,0,113,0,0
"Mexico","2024-11-09",0,0,113,0,0,113,0,0
"Mexico","2024-11-10",0,0,113,0,0,113,0,0
"Mexico","2024-11-11",0,0,113,0,0,113,0,0
"Mexico","2024-11-12",0,0,113,0,0,113,0,0
"Mexico","2024-11-13",0,0,113,0,0,113,0,0
"Mexico","2024-11-14",0,0,113,0,0,113,0,0
"Mexico","2024-11-15",0,0,113,0,0,113,0,0
"Mexico","2024-11-16",0,0,113,0,0,113,0,0
"Mexico","2024-11-17",0,0,113,0,0,113,0,0
"Mexico","2024-11-18",0,0,113,0,0,113,0,0
"Mexico","2024-11-19",0,0,113,0,0,113,0,0
"Mexico","2024-11-20",0,0,113,0,0,113,0,0
"Mexico","2024-11-21",0,0,113,0,0,113,0,0
"Mexico","2024-11-22",0,0,113,0,0,113,0,0
"Mexico","2024-11-23",0,0,113,0,0,113,0,0
"Mexico","2024-11-24",0,0,113,0,0,113,0,0
"Mexico","2024-11-25",0,0,113,0,0,113,0,0
"Mexico","2024-11-26",0,0,113,0,0,113,0,0
"Mexico","2024-11-27",0,0,113,0,0,113,0,0
"Mexico","2024-11-28",0,0,113,0,0,113,0,0
"Mexico","2024-11-29",0,0,113,0,0,113,0,0
"Mexico","2024-11-30",0,0,113,0,0,113,0,0
"Mexico","2024-12-01",0,0,113,0,0,113,0,0
"Mexico","2024-12-02",0,0,113,0,0,113,0,0
"Mexico","2024-12-03",0,0,113,0,0,113,0,0
"Mexico","2024-12-04",0,0,113,0,0,113,0,0
"Mexico","2024-12-05",0,0,113,0,0,113,0,0
"Mexico","2024-12-06",0,0,113,0,0,113,0,0
"Mexico","2024-12-07",0,0,113,0,0,113,0,0
"Mexico","2024-12-08",0,0,113,0,0,113,0,0
"Mexico","2024-12-09",0,0,113,0,0,113,0,0
"Mexico","2024-12-10",0,0,113,0,0,113,0,0
"Mexico","2024-12-11",0,0,113,0,0,113,0,0
"Mexico","2024-12-12",0,0,113,0,0,113,0,0
"Mexico","2024-12-13",0,0,113,0,0,113,0,0
"Mexico","2024-12-14",0,0,113,0,0,113,0,0
"Mexico","2024-12-15",0,0,113,0,0,113,0,0
"Mexico","2024-12-16",0,0,113,0,0,113,0,0
"Mexico","2024-12-17",0,0,113,0,0,113,0,0
"Mexico","2024-12-18",0,0,113,0,0,113,0,0
"Mexico","2024-12-19",0,0,113,0,0,113,0,0
"Mexico","2024-12-20",0,0,113,0,0,113,0,0
"Mexico","2024-12-21",0,0,113,0,0,113,0,0
"Mexico","2024-12-22",0,0,113,0,0,113,0,0
"Mexico","2024-12-23",0,0,113,0,0,113,0,0
"Mexico","2024-12-24",0,0,113,0,0,113,0,0
"Mexico","2024-12-25",0,0,113,0,0,113,0,0
"Mexico","2024-12-26",0,0,113,0,0,113,0,0
"Mexico","2024-12-27",0,0,113,0,0,113,0,0
"Mexico","2024-12-28",0,0,113,0,0,113,0,0
"Mexico","2024-12-29",0,0,113,0,0,113,0,0
"Mexico","2024-12-30",0,0,113,0,0,113,0,0
"Mexico","2024-12-31",0,0,113,0,0,113,0,0
"Mexico","2025-01-01",0,0,113,0,0,113,0,0
"Mexico","2025-01-02",0,0,113,0,0,113,0,0
"Mexico","2025-01-03",0,0,113,0,0,113,0,0
"Mexico","2025-01-04",0,0,113,0,0,113,0,0
"Mexico","2025-01-05",0,0,113,0,0,113,0,0
"Mexico","2025-01-06",0,0,113,0,0,113,0,0
"Mexico","2025-01-07",0,0,113,0,0,113,0,0
"Mexico","2025-01-08",0,0,113,0,0,113,0,0
"Mexico","2025-01-09",0,0,113,0,0,113,0,0
"Mexico","2025-01-10",0,0,113,0,0,113,0,0
"Mexico","2025-01-11",0,0,113,0,0,113,0,0
"Mexico","2025-01-12",0,0,113,0,0,113,0,0
"Mexico","2025-01-13",0,0,113,0,0,113,0,0
"Republic of Moldova","2024-01-01",0,0,0,0,0,0,0,0
"Republic of Moldova","2024-01-02",0,0,0,0,0,0,0,0
"Republic of Moldova","2024-01-03",0,0,0,0,0,0,0,0
"Republic of Moldova","2024-01-04",0,0,0,0,0,0,0,0
"Republic of Moldova","2024-01-05",0,0,0,0,0,0,0,0
"Republic of Moldova","2024-01-06",0,0,0,0,0,0,0,0
"Republic of Moldova","2024-01-07",0,0,0,0,0,0,0,0
"Republic of Moldova","2024-01-08",0,0,0,0,0,0,0,0
"Republic of Moldova","2024-01-09",0,0,0,0,0,0,0,0
"Republic of Moldova","2024-01-10",0,0,0,0,0,0,0,0
"Republic of Moldova","2024-01-11",0,0,0,0,0,0,0,0
"Republic of Moldova","2024-01-12",0,0,0,0,0,0,0,0
"Republic of Moldova","2024-01-13",0,0,0,0,0,0,0,0
"Republic of Moldova","2024-01-14",0,0,0,0,0,0,0,0
"Republic of Moldova","2024-01-15",0,0,0,0,0,0,0,0
"Republic of Moldova","2024-01-16",0,0,0,0,0,0,0,0
"Republic of Moldova","2024-01-17",0,0,0,0,0,0,0,0
"Republic of Moldova","2024-01-18",0,0,0,0,0,0,0,0
"Republic of Moldova","2024-01-19",0,0,0,0,0,0,0,0
"Republic of Moldova","2024-01-20",0,0,0,0,0,0,0,0
"Republic of Moldova","2024-01-21",0,0,0,0,0,0,0,0
"Republic of Moldova","2024-01-22",0,0,0,0,0,0,0,0
"Republic of Moldova","2024-01-23",0,0,0,0,0,0,0,0
"Republic of Moldova","2024-01-24",0,0,0,0,0,0,0,0
"Republic of Moldova","2024-01-25",0,0,0,0,0,0,0,0
"Republic of Moldova","2024-01-26",0,0,0,0,0,0,0,0
"Republic of Moldova","2024-01-27",0,0,0,0,0,0,0,0
"Republic of Moldova","2024-01-28",0,0,0,0,0,0,0,0
"Republic of Moldova","2024-01-29",0,0,0,0,0,0,0,0
"Republic of Moldova","2024-01-30",0,0,0,0,0,0,0,0
"Republic of Moldova","2024-01-31",0,0,0,0,0,0,0,0
"Republic of Moldova","2024-02-01",0,0,0,0,0,0,0,0
"Republic of Moldova","2024-02-02",0,0,0,0,0,0,0,0
"Republic of Moldova","2024-02-03",0,0,0,0,0,0,0,0
"Republic of Moldova","2024-02-04",0,0,0,0,0,0,0,0
"Republic of Moldova","2024-02-05",0,0,0,0,0,0,0,0
"Republic of Moldova","2024-02-06",0,0,0,0,0,0,0,0
"Republic of Moldova","2024-02-07",0,0,0,0,0,0,0,0
"Republic of Moldova","2024-02-08",0,0,0,0,0,0,0,0
"Republic of Moldova","2024-02-09",0,0,0,0,0,0,0,0
"Republic of Moldova","2024-02-10",0,0,0,0,0,0,0,0
"Republic of Moldova","2024-02-11",0,0,0,0,0,0,0,0
"Republic of Moldova","2024-02-12",0,0,0,0,0,0,0,0
"Republic of Moldova","2024-02-13",0,0,0,0,0,0,0,0
"Republic of Moldova","2024-02-14",0,0,0,0,0,0,0,0
"Republic of Moldova","2024-02-15",0,0,0,0,0,0,0,0
"Republic of Moldova","2024-02-16",0,0,0,0,0,0,0,0
"Republic of Moldova","2024-02-17",0,0,0,0,0,0,0,0
"Republic of Moldova","2024-02-18",0,0,0,0,0,0,0,0
"Republic of Moldova","2024-02-19",0,0,0,0,0,0,0,0
"Republic of Moldova","2024-02-20",0,0,0,0,0,0,0,0
"Republic of Moldova","2024-02-21",0,0,0,0,0,0,0,0
"Republic of Moldova","2024-02-22",0,0,0,0,0,0,0,0
"Republic of Moldova","2024-02-23",0,0,0,0,0,0,0,0
"Republic of Moldova","2024-02-24",0,0,0,0,0,0,0,0
"Republic of Moldova","2024-02-25",0,0,0,0,0,0,0,0
"Republic of Moldova","2024-02-26",0,0,0,0,0,0,0,0
"Republic of Moldova","2024-02-27",0,0,0,0,0,0,0,0
"Republic of Moldova","2024-02-28",0,0,0,0,0,0,0,0
"Republic of Moldova","2024-02-29",0,0,0,0,0,0,0,0
"Republic of Moldova","2024-03-01",0,0,0,0,0,0,0,0
"Republic of Moldova","2024-03-02",0,0,0,0,0,0,0,0
"Republic of Moldova","2024-03-03",0,0,0,0,0,0,0,0
"Republic of Moldova","2024-03-04",0,0,0,0,0,0,0,0
"Republic of Moldova","2024-03-05",0,0,0,0,0,0,0,0
"Republic of Moldova","2024-03-06",0,0,0,0,0,0,0,0
"Republic of Moldova","2024-03-07",0,0,0,0,0,0,0,0
"Republic of Moldova","2024-03-08",0,0,0,0,0,0,0,0
"Republic of Moldova","2024-03-09",0,0,0,0,0,0,0,0
"Republic of Moldova","2024-03-10",0,0,0,0,0,0,0,0
"Republic of Moldova","2024-03-11",0,0,0,0,0,0,0,0
"Republic of Moldova","2024-03-12",0,0,0,0,0,0,0,0
"Republic of Moldova","2024-03-13",0,0,0,0,0,0,0,0
"Republic of Moldova","2024-03-14",0,0,0,0,0,0,0,0
"Republic of Moldova","2024-03-15",0,0,0,0,0,0,0,0
"Republic of Moldova","2024-03-16",0,0,0,0,0,0,0,0
"Republic of Moldova","2024-03-17",0,0,0,0,0,0,0,0
"Republic of Moldova","2024-03-18",0,0,0,0,0,0,0,0
"Republic of Moldova","2024-03-19",0,0,0,0,0,0,0,0
"Republic of Moldova","2024-03-20",0,0,0,0,0,0,0,0
"Republic of Moldova","2024-03-21",0,0,0,0,0,0,0,0
"Republic of Moldova","2024-03-22",0,0,0,0,0,0,0,0
"Republic of Moldova","2024-03-23",0,0,0,0,0,0,0,0
"Republic of Moldova","2024-03-24",0,0,0,0,0,0,0,0
"Republic of Moldova","2024-03-25",0,0,0,0,0,0,0,0
"Republic of Moldova","2024-03-26",0,0,0,0,0,0,0,0
"Republic of Moldova","2024-03-27",0,0,0,0,0,0,0,0
"Republic of Moldova","2024-03-28",0,0,0,0,0,0,0,0
"Republic of Moldova","2024-03-29",0,0,0,0,0,0,0,0
"Republic of Moldova","2024-03-30",0,0,0,0,0,0,0,0
"Republic of Moldova","2024-03-31",0,0,0,0,0,0,0,0
"Republic of Moldova","2024-04-01",0,0,0,0,0,0,0,0
"Republic of Moldova","2024-04-02",0,0,0,0,0,0,0,0
"Republic of Moldova","2024-04-03",0,0,0,0,0,0,0,0
"Republic of Moldova","2024-04-04",0,0,0,0,0,0,0,0
"Republic of Moldova","2024-04-05",0,0,0,0,0,0,0,0
"Republic of Moldova","2024-04-06",0,0,0,0,0,0,0,0
"Republic of Moldova","2024-04-07",0,0,0,0,0,0,0,0
"Republic of Moldova","2024-04-08",0,0,0,0,0,0,0,0
"Republic of Moldova","2024-04-09",0,0,0,0,0,0,0,0
"Republic of Moldova","2024-04-10",0,0,0,0,0,0,0,0
"Republic of Moldova","2024-04-11",0,0,0,0,0,0,0,0
"Republic of Moldova","2024-04-12",0,0,0,0,0,0,0,0
"Republic of Moldova","2024-04-13",0,0,0,0,0,0,0,0
"Republic of Moldova","2024-04-14",0,0,0,0,0,0,0,0
"Republic of Moldova","2024-04-15",0,0,0,0,0,0,0,0
"Republic of Moldova","2024-04-16",0,0,0,0,0,0,0,0
"Republic of Moldova","2024-04-17",0,0,0,0,0,0,0,0
"Republic of Moldova","2024-04-18",0,0,0,0,0,0,0,0
"Republic of Moldova","2024-04-19",0,0,0,0,0,0,0,0
"Republic of Moldova","2024-04-20",0,0,0,0,0,0,0,0
"Republic of Moldova","2024-04-21",0,0,0,0,0,0,0,0
"Republic of Moldova","2024-04-22",0,0,0,0,0,0,0,0
"Republic of Moldova","2024-04-23",0,0,0,0,0,0,0,0
"Republic of Moldova","2024-04-24",0,0,0,0,0,0,0,0
"Republic of Moldova","2024-04-25",0,0,0,0,0,0,0,0
"Republic of Moldova","2024-04-26",0,0,0,0,0,0,0,0
"Republic of Moldova","2024-04-27",0,0,0,0,0,0,0,0
"Republic of Moldova","2024-04-28",0,0,0,0,0,0,0,0
"Republic of Moldova","2024-04-29",0,0,0,0,0,0,0,0
"Republic of Moldova","2024-04-30",0,0,0,0,0,0,0,0
"Republic of Moldova","2024-05-01",0,0,0,0,0,0,0,0
"Republic of Moldova","2024-05-02",0,0,0,0,0,0,0,0
"Republic of Moldova","2024-05-03",0,0,0,0,0,0,0,0
"Republic of Moldova","2024-05-04",0,0,0,0,0,0,0,0
"Republic of Moldova","2024-05-05",0,0,0,0,0,0,0,0
"Republic of Moldova","2024-05-06",0,0,0,0,0,0,0,0
"Republic of Moldova","2024-05-07",0,0,0,0,0,0,0,0
"Republic of Moldova","2024-05-08",0,0,0,0,0,0,0,0
"Republic of Moldova","2024-05-09",0,0,0,0,0,0,0,0
"Republic of Moldova","2024-05-10",0,0,0,0,0,0,0,0
"Republic of Moldova","2024-05-11",0,0,0,0,0,0,0,0
"Republic of Moldova","2024-05-12",0,0,0,0,0,0,0,0
"Republic of Moldova","2024-05-13",0,0,0,0,0,0,0,0
"Republic of Moldova","2024-05-14",0,0,0,0,0,0,0,0
"Republic of Moldova","2024-05-15",0,0,0,0,0,0,0,0
"Republic of Moldova","2024-05-16",0,0,0,0,0,0,0,0
"Republic of Moldova","2024-05-17",0,0,0,0,0,0,0,0
"Republic of Moldova","2024-05-18",0,0,0,0,0,0,0,0
"Republic of Moldova","2024-05-19",0,0,0,0,0,0,0,0
"Republic of Moldova","2024-05-20",0,0,0,0,0,0,0,0
"Republic of Moldova","2024-05-21",0,0,0,0,0,0,0,0
"Republic of Moldova","2024-05-22",0,0,0,0,0,0,0,0
"Republic of Moldova","2024-05-23",0,0,0,0,0,0,0,0
"Republic of Moldova","2024-05-24",0,0,0,0,0,0,0,0
"Republic of Moldova","2024-05-25",0,0,0,0,0,0,0,0
"Republic of Moldova","2024-05-26",0,0,0,0,0,0,0,0
"Republic of Moldova","2024-05-27",0,0,0,0,0,0,0,0
"Republic of Moldova","2024-05-28",0,0,0,0,0,0,0,0
"Republic of Moldova","2024-05-29",0,0,0,0,0,0,0,0
"Republic of Moldova","2024-05-30",0,0,0,0,0,0,0,0
"Republic of Moldova","2024-05-31",0,0,0,0,0,0,0,0
"Republic of Moldova","2024-06-01",0,0,0,0,0,0,0,0
"Republic of Moldova","2024-06-02",0,0,0,0,0,0,0,0
"Republic of Moldova","2024-06-03",0,0,0,0,0,0,0,0
"Republic of Moldova","2024-06-04",0,0,0,0,0,0,0,0
"Republic of Moldova","2024-06-05",0,0,0,0,0,0,0,0
"Republic of Moldova","2024-06-06",0,0,0,0,0,0,0,0
"Republic of Moldova","2024-06-07",0,0,0,0,0,0,0,0
"Republic of Moldova","2024-06-08",0,0,0,0,0,0,0,0
"Republic of Moldova","2024-06-09",0,0,0,0,0,0,0,0
"Republic of Moldova","2024-06-10",0,0,0,0,0,0,0,0
"Republic of Moldova","2024-06-11",0,0,0,0,0,0,0,0
"Republic of Moldova","2024-06-12",0,0,0,0,0,0,0,0
"Republic of Moldova","2024-06-13",0,0,0,0,0,0,0,0
"Republic of Moldova","2024-06-14",0,0,0,0,0,0,0,0
"Republic of Moldova","2024-06-15",0,0,0,0,0,0,0,0
"Republic of Moldova","2024-06-16",0,0,0,0,0,0,0,0
"Republic of Moldova","2024-06-17",0,0,0,0,0,0,0,0
"Republic of Moldova","2024-06-18",0,0,0,0,0,0,0,0
"Republic of Moldova","2024-06-19",0,0,0,0,0,0,0,0
"Republic of Moldova","2024-06-20",0,0,0,0,0,0,0,0
"Republic of Moldova","2024-06-21",0,0,0,0,0,0,0,0
"Republic of Moldova","2024-06-22",0,0,0,0,0,0,0,0
"Republic of Moldova","2024-06-23",0,0,0,0,0,0,0,0
"Republic of Moldova","2024-06-24",0,0,0,0,0,0,0,0
"Republic of Moldova","2024-06-25",0,0,0,0,0,0,0,0
"Republic of Moldova","2024-06-26",0,0,0,0,0,0,0,0
"Republic of Moldova","2024-06-27",0,0,0,0,0,0,0,0
"Republic of Moldova","2024-06-28",0,0,0,0,0,0,0,0
"Republic of Moldova","2024-06-29",0,0,0,0,0,0,0,0
"Republic of Moldova","2024-06-30",0,0,0,0,0,0,0,0
"Republic of Moldova","2024-07-01",0,0,0,0,0,0,0,0
"Republic of Moldova","2024-07-02",0,0,0,0,0,0,0,0
"Republic of Moldova","2024-07-03",0,0,0,0,0,0,0,0
"Republic of Moldova","2024-07-04",0,0,0,0,0,0,0,0
"Republic of Moldova","2024-07-05",0,0,0,0,0,0,0,0
"Republic of Moldova","2024-07-06",0,0,0,0,0,0,0,0
"Republic of Moldova","2024-07-07",0,0,0,0,0,0,0,0
"Republic of Moldova","2024-07-08",0,0,0,0,0,0,0,0
"Republic of Moldova","2024-07-09",0,0,0,0,0,0,0,0
"Republic of Moldova","2024-07-10",0,0,0,0,0,0,0,0
"Republic of Moldova","2024-07-11",0,0,0,0,0,0,0,0
"Republic of Moldova","2024-07-12",0,0,0,0,0,0,0,0
"Republic of Moldova","2024-07-13",0,0,0,0,0,0,0,0
"Republic of Moldova","2024-07-14",0,0,0,0,0,0,0,0
"Republic of Moldova","2024-07-15",0,0,0,0,0,0,0,0
"Republic of Moldova","2024-07-16",0,0,0,0,0,0,0,0
"Republic of Moldova","2024-07-17",0,0,0,0,0,0,0,0
"Republic of Moldova","2024-07-18",0,0,0,0,0,0,0,0
"Republic of Moldova","2024-07-19",0,0,0,0,0,0,0,0
"Republic of Moldova","2024-07-20",0,0,0,0,0,0,0,0
"Republic of Moldova","2024-07-21",0,0,0,0,0,0,0,0
"Republic of Moldova","2024-07-22",0,0,0,0,0,0,0,0
"Republic of Moldova","2024-07-23",0,0,0,0,0,0,0,0
"Republic of Moldova","2024-07-24",0,0,0,0,0,0,0,0
"Republic of Moldova","2024-07-25",0,0,0,0,0,0,0,0
"Republic of Moldova","2024-07-26",0,0,0,0,0,0,0,0
"Republic of Moldova","2024-07-27",0,0,0,0,0,0,0,0
"Republic of Moldova","2024-07-28",0,0,0,0,0,0,0,0
"Republic of Moldova","2024-07-29",0,0,0,0,0,0,0,0
"Republic of Moldova","2024-07-30",0,0,0,0,0,0,0,0
"Republic of Moldova","2024-07-31",0,0,0,0,0,0,0,0
"Republic of Moldova","2024-08-01",0,0,0,0,0,0,0,0
"Republic of Moldova","2024-08-02",0,0,0,0,0,0,0,0
"Republic of Moldova","2024-08-03",0,0,0,0,0,0,0,0
"Republic of Moldova","2024-08-04",0,0,0,0,0,0,0,0
"Republic of Moldova","2024-08-05",0,0,0,0,0,0,0,0
"Republic of Moldova","2024-08-06",0,0,0,0,0,0,0,0
"Republic of Moldova","2024-08-07",0,0,0,0,0,0,0,0
"Republic of Moldova","2024-08-08",0,0,0,0,0,0,0,0
"Republic of Moldova","2024-08-09",0,0,0,0,0,0,0,0
"Republic of Moldova","2024-08-10",0,0,0,0,0,0,0,0
"Republic of Moldova","2024-08-11",0,0,0,0,0,0,0,0
"Republic of Moldova","2024-08-12",0,0,0,0,0,0,0,0
"Republic of Moldova","2024-08-13",0,0,0,0,0,0,0,0
"Republic of Moldova","2024-08-14",0,0,0,0,0,0,0,0
"Republic of Moldova","2024-08-15",0,0,0,0,0,0,0,0
"Republic of Moldova","2024-08-16",0,0,0,0,0,0,0,0
"Republic of Moldova","2024-08-17",0,0,0,0,0,0,0,0
"Republic of Moldova","2024-08-18",0,0,0,0,0,0,0,0
"Republic of Moldova","2024-08-19",0,0,0,0,0,0,0,0
"Republic of Moldova","2024-08-20",0,0,0,0,0,0,0,0
"Republic of Moldova","2024-08-21",0,0,0,0,0,0,0,0
"Republic of Moldova","2024-08-22",0,0,0,0,0,0,0,0
"Republic of Moldova","2024-08-23",0,0,0,0,0,0,0,0
"Republic of Moldova","2024-08-24",0,0,0,0,0,0,0,0
"Republic of Moldova","2024-08-25",0,0,0,0,0,0,0,0
"Republic of Moldova","2024-08-26",0,0,0,0,0,0,0,0
"Republic of Moldova","2024-08-27",0,0,0,0,0,0,0,0
"Republic of Moldova","2024-08-28",0,0,0,0,0,0,0,0
"Republic of Moldova","2024-08-29",0,0,0,0,0,0,0,0
"Republic of Moldova","2024-08-30",0,0,0,0,0,0,0,0
"Republic of Moldova","2024-08-31",0,0,0,0,0,0,0,0
"Republic of Moldova","2024-09-01",0,0,0,0,0,0,0,0
"Republic of Moldova","2024-09-02",0,0,0,0,0,0,0,0
"Republic of Moldova","2024-09-03",0,0,0,0,0,0,0,0
"Republic of Moldova","2024-09-04",0,0,0,0,0,0,0,0
"Republic of Moldova","2024-09-05",0,0,0,0,0,0,0,0
"Republic of Moldova","2024-09-06",0,0,0,0,0,0,0,0
"Republic of Moldova","2024-09-07",0,0,0,0,0,0,0,0
"Republic of Moldova","2024-09-08",0,0,0,0,0,0,0,0
"Republic of Moldova","2024-09-09",0,0,0,0,0,0,0,0
"Republic of Moldova","2024-09-10",0,0,0,0,0,0,0,0
"Republic of Moldova","2024-09-11",0,0,0,0,0,0,0,0
"Republic of Moldova","2024-09-12",0,0,0,0,0,0,0,0
"Republic of Moldova","2024-09-13",0,0,0,0,0,0,0,0
"Republic of Moldova","2024-09-14",0,0,0,0,0,0,0,0
"Republic of Moldova","2024-09-15",0,0,0,0,0,0,0,0
"Republic of Moldova","2024-09-16",0,0,0,0,0,0,0,0
"Republic of Moldova","2024-09-17",0,0,0,0,0,0,0,0
"Republic of Moldova","2024-09-18",0,0,0,0,0,0,0,0
"Republic of Moldova","2024-09-19",0,0,0,0,0,0,0,0
"Republic of Moldova","2024-09-20",0,0,0,0,0,0,0,0
"Republic of Moldova","2024-09-21",0,0,0,0,0,0,0,0
"Republic of Moldova","2024-09-22",0,0,0,0,0,0,0,0
"Republic of Moldova","2024-09-23",0,0,0,0,0,0,0,0
"Republic of Moldova","2024-09-24",0,0,0,0,0,0,0,0
"Republic of Moldova","2024-09-25",0,0,0,0,0,0,0,0
"Republic of Moldova","2024-09-26",0,0,0,0,0,0,0,0
"Republic of Moldova","2024-09-27",0,0,0,0,0,0,0,0
"Republic of Moldova","2024-09-28",0,0,0,0,0,0,0,0
"Republic of Moldova","2024-09-29",0,0,0,0,0,0,0,0
"Republic of Moldova","2024-09-30",0,0,0,0,0,0,0,0
"Republic of Moldova","2024-10-01",0,0,0,0,0,0,0,0
"Republic of Moldova","2024-10-02",0,0,0,0,0,0,0,0
"Republic of Moldova","2024-10-03",0,0,0,0,0,0,0,0
"Republic of Moldova","2024-10-04",0,0,0,0,0,0,0,0
"Republic of Moldova","2024-10-05",0,0,0,0,0,0,0,0
"Republic of Moldova","2024-10-06",0,0,0,0,0,0,0,0
"Republic of Moldova","2024-10-07",0,0,0,0,0,0,0,0
"Republic of Moldova","2024-10-08",0,0,0,0,0,0,0,0
"Republic of Moldova","2024-10-09",0,0,0,0,0,0,0,0
"Republic of Moldova","2024-10-10",0,0,0,0,0,0,0,0
"Republic of Moldova","2024-10-11",0,0,0,0,0,0,0,0
"Republic of Moldova","2024-10-12",0,0,0,0,0,0,0,0
"Republic of Moldova","2024-10-13",0,0,0,0,0,0,0,0
"Republic of Moldova","2024-10-14",0,0,0,0,0,0,0,0
"Republic of Moldova","2024-10-15",0,0,0,0,0,0,0,0
"Republic of Moldova","2024-10-16",0,0,0,0,0,0,0,0
"Republic of Moldova","2024-10-17",0,0,0,0,0,0,0,0
"Republic of Moldova","2024-10-18",0,0,0,0,0,0,0,0
"Republic of Moldova","2024-10-19",0,0,0,0,0,0,0,0
"Republic of Moldova","2024-10-20",0,0,0,0,0,0,0,0
"Republic of Moldova","2024-10-21",0,0,0,0,0,0,0,0
"Republic of Moldova","2024-10-22",0,0,0,0,0,0,0,0
"Republic of Moldova","2024-10-23",0,0,0,0,0,0,0,0
"Republic of Moldova","2024-10-24",0,0,0,0,0,0,0,0
"Republic of Moldova","2024-10-25",0,0,0,0,0,0,0,0
"Republic of Moldova","2024-10-26",0,0,0,0,0,0,0,0
"Republic of Moldova","2024-10-27",0,0,0,0,0,0,0,0
"Republic of Moldova","2024-10-28",0,0,0,0,0,0,0,0
"Republic of Moldova","2024-10-29",0,0,0,0,0,0,0,0
"Republic of Moldova","2024-10-30",0,0,0,0,0,0,0,0
"Republic of Moldova","2024-10-31",0,0,0,0,0,0,0,0
"Republic of Moldova","2024-11-01",0,0,0,0,0,0,0,0
"Republic of Moldova","2024-11-02",0,0,0,0,0,0,0,0
"Republic of Moldova","2024-11-03",0,0,0,0,0,0,0,0
"Republic of Moldova","2024-11-04",0,0,0,0,0,0,0,0
"Republic of Moldova","2024-11-05",0,0,0,0,0,0,0,0
"Republic of Moldova","2024-11-06",0,0,0,0,0,0,0,0
"Republic of Moldova","2024-11-07",0,0,0,0,0,0,0,0
"Republic of Moldova","2024-11-08",0,0,0,0,0,0,0,0
"Republic of Moldova","2024-11-09",0,0,0,0,0,0,0,0
"Republic of Moldova","2024-11-10",0,0,0,0,0,0,0,0
"Republic of Moldova","2024-11-11",0,0,0,0,0,0,0,0
"Republic of Moldova","2024-11-12",0,0,0,0,0,0,0,0
"Republic of Moldova","2024-11-13",0,0,0,0,0,0,0,0
"Republic of Moldova","2024-11-14",0,0,0,0,0,0,0,0
"Republic of Moldova","2024-11-15",0,0,0,0,0,0,0,0
"Republic of Moldova","2024-11-16",0,0,0,0,0,0,0,0
"Republic of Moldova","2024-11-17",0,0,0,0,0,0,0,0
"Republic of Moldova","2024-11-18",0,0,0,0,0,0,0,0
"Republic of Moldova","2024-11-19",0,0,0,0,0,0,0,0
"Republic of Moldova","2024-11-20",0,0,0,0,0,0,0,0
"Republic of Moldova","2024-11-21",0,0,0,0,0,0,0,0
"Republic of Moldova","2024-11-22",0,0,0,0,0,0,0,0
"Republic of Moldova","2024-11-23",0,0,0,0,0,0,0,0
"Republic of Moldova","2024-11-24",0,0,0,0,0,0,0,0
"Republic of Moldova","2024-11-25",0,0,0,0,0,0,0,0
"Republic of Moldova","2024-11-26",0,0,0,0,0,0,0,0
"Republic of Moldova","2024-11-27",0,0,0,0,0,0,0,0
"Republic of Moldova","2024-11-28",0,0,0,0,0,0,0,0
"Republic of Moldova","2024-11-29",0,0,0,0,0,0,0,0
"Republic of Moldova","2024-11-30",0,0,0,0,0,0,0,0
"Republic of Moldova","2024-12-01",0,0,0,0,0,0,0,0
"Republic of Moldova","2024-12-02",0,0,0,0,0,0,0,0
"Republic of Moldova","2024-12-03",0,0,0,0,0,0,0,0
"Republic of Moldova","2024-12-04",0,0,0,0,0,0,0,0
"Republic of Moldova","2024-12-05",0,0,0,0,0,0,0,0
"Republic of Moldova","2024-12-06",0,0,0,0,0,0,0,0
"Republic of Moldova","2024-12-07",0,0,0,0,0,0,0,0
"Republic of Moldova","2024-12-08",0,0,0,0,0,0,0,0
"Republic of Moldova","2024-12-09",0,0,0,0,0,0,0,0
"Republic of Moldova","2024-12-10",0,0,0,0,0,0,0,0
"Republic of Moldova","2024-12-11",0,0,0,0,0,0,0,0
"Republic of Moldova","2024-12-12",0,0,0,0,0,0,0,0
"Republic of Moldova","2024-12-13",0,0,0,0,0,0,0,0
"Republic of Moldova","2024-12-14",0,0,0,0,0,0,0,0
"Republic of Moldova","2024-12-15",0,0,0,0,0,0,0,0
"Republic of Moldova","2024-12-16",0,0,0,0,0,0,0,0
"Republic of Moldova","2024-12-17",0,0,0,0,0,0,0,0
"Republic of Moldova","2024-12-18",0,0,0,0,0,0,0,0
"Republic of Moldova","2024-12-19",0,0,0,0,0,0,0,0
"Republic of Moldova","2024-12-20",0,0,0,0,0,0,0,0
"Republic of Moldova","2024-12-21",0,0,0,0,0,0,0,0
"Republic of Moldova","2024-12-22",0,0,0,0,0,0,0,0
"Republic of Moldova","2024-12-23",0,0,0,0,0,0,0,0
"Republic of Moldova","2024-12-24",0,0,0,0,0,0,0,0
"Republic of Moldova","2024-12-25",0,0,0,0,0,0,0,0
"Republic of Moldova","2024-12-26",0,0,0,0,0,0,0,0
"Republic of Moldova","2024-12-27",0,0,0,0,0,0,0,0
"Republic of Moldova","2024-12-28",0,0,0,0,0,0,0,0
"Republic of Moldova","2024-12-29",0,0,0,0,0,0,0,0
"Republic of Moldova","2024-12-30",0,0,0,0,0,0,0,0
"Republic of Moldova","2024-12-31",0,0,0,0,0,0,0,0
"Republic of Moldova","2025-01-01",0,0,0,0,0,0,0,0
"Republic of Moldova","2025-01-02",0,0,0,0,0,0,0,0
"Republic of Moldova","2025-01-03",0,0,0,0,0,0,0,0
"Republic of Moldova","2025-01-04",0,0,0,0,0,0,0,0
"Republic of Moldova","2025-01-05",0,0,0,0,0,0,0,0
"Republic of Moldova","2025-01-06",0,0,0,0,0,0,0,0
"Republic of Moldova","2025-01-07",0,0,0,0,0,0,0,0
"Republic of Moldova","2025-01-08",0,0,0,0,0,0,0,0
"Republic of Moldova","2025-01-09",0,0,0,0,0,0,0,0
"Republic of Moldova","2025-01-10",0,0,0,0,0,0,0,0
"Republic of Moldova","2025-01-11",0,0,0,0,0,0,0,0
"Republic of Moldova","2025-01-12",0,0,0,0,0,0,0,0
"Republic of Moldova","2025-01-13",0,0,0,0,0,0,0,0
"Monaco","2024-01-01",0,0,0,0,0,0,0,0
"Monaco","2024-01-02",0,0,0,0,0,0,0,0
"Monaco","2024-01-03",0,0,0,0,0,0,0,0
"Monaco","2024-01-04",0,0,0,0,0,0,0,0
"Monaco","2024-01-05",0,0,0,0,0,0,0,0
"Monaco","2024-01-06",0,0,0,0,0,0,0,0
"Monaco","2024-01-07",0,0,0,0,0,0,0,0
"Monaco","2024-01-08",0,0,0,0,0,0,0,0
"Monaco","2024-01-09",0,0,0,0,0,0,0,0
"Monaco","2024-01-10",0,0,0,0,0,0,0,0
"Monaco","2024-01-11",0,0,0,0,0,0,0,0
"Monaco","2024-01-12",0,0,0,0,0,0,0,0
"Monaco","2024-01-13",0,0,0,0,0,0,0,0
"Monaco","2024-01-14",0,0,0,0,0,0,0,0
"Monaco","2024-01-15",0,0,0,0,0,0,0,0
"Monaco","2024-01-16",0,0,0,0,0,0,0,0
"Monaco","2024-01-17",0,0,0,0,0,0,0,0
"Monaco","2024-01-18",0,0,0,0,0,0,0,0
"Monaco","2024-01-19",0,0,0,0,0,0,0,0
"Monaco","2024-01-20",0,0,0,0,0,0,0,0
"Monaco","2024-01-21",0,0,0,0,0,0,0,0
"Monaco","2024-01-22",0,0,0,0,0,0,0,0
"Monaco","2024-01-23",0,0,0,0,0,0,0,0
"Monaco","2024-01-24",0,0,0,0,0,0,0,0
"Monaco","2024-01-25",0,0,0,0,0,0,0,0
"Monaco","2024-01-26",0,0,0,0,0,0,0,0
"Monaco","2024-01-27",0,0,0,0,0,0,0,0
"Monaco","2024-01-28",0,0,0,0,0,0,0,0
"Monaco","2024-01-29",0,0,0,0,0,0,0,0
"Monaco","2024-01-30",0,0,0,0,0,0,0,0
"Monaco","2024-01-31",0,0,0,0,0,0,0,0
"Monaco","2024-02-01",0,0,0,0,0,0,0,0
"Monaco","2024-02-02",0,0,0,0,0,0,0,0
"Monaco","2024-02-03",0,0,0,0,0,0,0,0
"Monaco","2024-02-04",0,0,0,0,0,0,0,0
"Monaco","2024-02-05",0,0,0,0,0,0,0,0
"Monaco","2024-02-06",0,0,0,0,0,0,0,0
"Monaco","2024-02-07",0,0,0,0,0,0,0,0
"Monaco","2024-02-08",0,0,0,0,0,0,0,0
"Monaco","2024-02-09",0,0,0,0,0,0,0,0
"Monaco","2024-02-10",0,0,0,0,0,0,0,0
"Monaco","2024-02-11",0,0,0,0,0,0,0,0
"Monaco","2024-02-12",0,0,0,0,0,0,0,0
"Monaco","2024-02-13",0,0,0,0,0,0,0,0
"Monaco","2024-02-14",0,0,0,0,0,0,0,0
"Monaco","2024-02-15",0,0,0,0,0,0,0,0
"Monaco","2024-02-16",0,0,0,0,0,0,0,0
"Monaco","2024-02-17",0,0,0,0,0,0,0,0
"Monaco","2024-02-18",0,0,0,0,0,0,0,0
"Monaco","2024-02-19",0,0,0,0,0,0,0,0
"Monaco","2024-02-20",0,0,0,0,0,0,0,0
"Monaco","2024-02-21",0,0,0,0,0,0,0,0
"Monaco","2024-02-22",0,0,0,0,0,0,0,0
"Monaco","2024-02-23",0,0,0,0,0,0,0,0
"Monaco","2024-02-24",0,0,0,0,0,0,0,0
"Monaco","2024-02-25",0,0,0,0,0,0,0,0
"Monaco","2024-02-26",0,0,0,0,0,0,0,0
"Monaco","2024-02-27",0,0,0,0,0,0,0,0
"Monaco","2024-02-28",0,0,0,0,0,0,0,0
"Monaco","2024-02-29",0,0,0,0,0,0,0,0
"Monaco","2024-03-01",0,0,0,0,0,0,0,0
"Monaco","2024-03-02",0,0,0,0,0,0,0,0
"Monaco","2024-03-03",0,0,0,0,0,0,0,0
"Monaco","2024-03-04",0,0,0,0,0,0,0,0
"Monaco","2024-03-05",0,0,0,0,0,0,0,0
"Monaco","2024-03-06",0,0,0,0,0,0,0,0
"Monaco","2024-03-07",0,0,0,0,0,0,0,0
"Monaco","2024-03-08",0,0,0,0,0,0,0,0
"Monaco","2024-03-09",0,0,0,0,0,0,0,0
"Monaco","2024-03-10",0,0,0,0,0,0,0,0
"Monaco","2024-03-11",0,0,0,0,0,0,0,0
"Monaco","2024-03-12",0,0,0,0,0,0,0,0
"Monaco","2024-03-13",0,0,0,0,0,0,0,0
"Monaco","2024-03-14",0,0,0,0,0,0,0,0
"Monaco","2024-03-15",0,0,0,0,0,0,0,0
"Monaco","2024-03-16",0,0,0,0,0,0,0,0
"Monaco","2024-03-17",0,0,0,0,0,0,0,0
"Monaco","2024-03-18",0,0,0,0,0,0,0,0
"Monaco","2024-03-19",0,0,0,0,0,0,0,0
"Monaco","2024-03-20",0,0,0,0,0,0,0,0
"Monaco","2024-03-21",0,0,0,0,0,0,0,0
"Monaco","2024-03-22",0,0,0,0,0,0,0,0
"Monaco","2024-03-23",0,0,0,0,0,0,0,0
"Monaco","2024-03-24",0,0,0,0,0,0,0,0
"Monaco","2024-03-25",0,0,0,0,0,0,0,0
"Monaco","2024-03-26",0,0,0,0,0,0,0,0
"Monaco","2024-03-27",0,0,0,0,0,0,0,0
"Monaco","2024-03-28",0,0,0,0,0,0,0,0
"Monaco","2024-03-29",0,0,0,0,0,0,0,0
"Monaco","2024-03-30",0,0,0,0,0,0,0,0
"Monaco","2024-03-31",0,0,0,0,0,0,0,0
"Monaco","2024-04-01",0,0,0,0,0,0,0,0
"Monaco","2024-04-02",0,0,0,0,0,0,0,0
"Monaco","2024-04-03",0,0,0,0,0,0,0,0
"Monaco","2024-04-04",0,0,0,0,0,0,0,0
"Monaco","2024-04-05",0,0,0,0,0,0,0,0
"Monaco","2024-04-06",0,0,0,0,0,0,0,0
"Monaco","2024-04-07",0,0,0,0,0,0,0,0
"Monaco","2024-04-08",0,0,0,0,0,0,0,0
"Monaco","2024-04-09",0,0,0,0,0,0,0,0
"Monaco","2024-04-10",0,0,0,0,0,0,0,0
"Monaco","2024-04-11",0,0,0,0,0,0,0,0
"Monaco","2024-04-12",0,0,0,0,0,0,0,0
"Monaco","2024-04-13",0,0,0,0,0,0,0,0
"Monaco","2024-04-14",0,0,0,0,0,0,0,0
"Monaco","2024-04-15",0,0,0,0,0,0,0,0
"Monaco","2024-04-16",0,0,0,0,0,0,0,0
"Monaco","2024-04-17",0,0,0,0,0,0,0,0
"Monaco","2024-04-18",0,0,0,0,0,0,0,0
"Monaco","2024-04-19",0,0,0,0,0,0,0,0
"Monaco","2024-04-20",0,0,0,0,0,0,0,0
"Monaco","2024-04-21",0,0,0,0,0,0,0,0
"Monaco","2024-04-22",0,0,0,0,0,0,0,0
"Monaco","2024-04-23",0,0,0,0,0,0,0,0
"Monaco","2024-04-24",0,0,0,0,0,0,0,0
"Monaco","2024-04-25",0,0,0,0,0,0,0,0
"Monaco","2024-04-26",0,0,0,0,0,0,0,0
"Monaco","2024-04-27",0,0,0,0,0,0,0,0
"Monaco","2024-04-28",0,0,0,0,0,0,0,0
"Monaco","2024-04-29",0,0,0,0,0,0,0,0
"Monaco","2024-04-30",0,0,0,0,0,0,0,0
"Monaco","2024-05-01",0,0,0,0,0,0,0,0
"Monaco","2024-05-02",0,0,0,0,0,0,0,0
"Monaco","2024-05-03",0,0,0,0,0,0,0,0
"Monaco","2024-05-04",0,0,0,0,0,0,0,0
"Monaco","2024-05-05",0,0,0,0,0,0,0,0
"Monaco","2024-05-06",0,0,0,0,0,0,0,0
"Monaco","2024-05-07",0,0,0,0,0,0,0,0
"Monaco","2024-05-08",0,0,0,0,0,0,0,0
"Monaco","2024-05-09",0,0,0,0,0,0,0,0
"Monaco","2024-05-10",0,0,0,0,0,0,0,0
"Monaco","2024-05-11",0,0,0,0,0,0,0,0
"Monaco","2024-05-12",0,0,0,0,0,0,0,0
"Monaco","2024-05-13",0,0,0,0,0,0,0,0
"Monaco","2024-05-14",0,0,0,0,0,0,0,0
"Monaco","2024-05-15",0,0,0,0,0,0,0,0
"Monaco","2024-05-16",0,0,0,0,0,0,0,0
"Monaco","2024-05-17",0,0,0,0,0,0,0,0
"Monaco","2024-05-18",0,0,0,0,0,0,0,0
"Monaco","2024-05-19",0,0,0,0,0,0,0,0
"Monaco","2024-05-20",0,0,0,0,0,0,0,0
"Monaco","2024-05-21",0,0,0,0,0,0,0,0
"Monaco","2024-05-22",0,0,0,0,0,0,0,0
"Monaco","2024-05-23",0,0,0,0,0,0,0,0
"Monaco","2024-05-24",0,0,0,0,0,0,0,0
"Monaco","2024-05-25",0,0,0,0,0,0,0,0
"Monaco","2024-05-26",0,0,0,0,0,0,0,0
"Monaco","2024-05-27",0,0,0,0,0,0,0,0
"Monaco","2024-05-28",0,0,0,0,0,0,0,0
"Monaco","2024-05-29",0,0,0,0,0,0,0,0
"Monaco","2024-05-30",0,0,0,0,0,0,0,0
"Monaco","2024-05-31",0,0,0,0,0,0,0,0
"Monaco","2024-06-01",0,0,0,0,0,0,0,0
"Monaco","2024-06-02",0,0,0,0,0,0,0,0
"Monaco","2024-06-03",0,0,0,0,0,0,0,0
"Monaco","2024-06-04",0,0,0,0,0,0,0,0
"Monaco","2024-06-05",0,0,0,0,0,0,0,0
"Monaco","2024-06-06",0,0,0,0,0,0,0,0
"Monaco","2024-06-07",0,0,0,0,0,0,0,0
"Monaco","2024-06-08",0,0,0,0,0,0,0,0
"Monaco","2024-06-09",0,0,0,0,0,0,0,0
"Monaco","2024-06-10",0,0,0,0,0,0,0,0
"Monaco","2024-06-11",0,0,0,0,0,0,0,0
"Monaco","2024-06-12",0,0,0,0,0,0,0,0
"Monaco","2024-06-13",0,0,0,0,0,0,0,0
"Monaco","2024-06-14",0,0,0,0,0,0,0,0
"Monaco","2024-06-15",0,0,0,0,0,0,0,0
"Monaco","2024-06-16",0,0,0,0,0,0,0,0
"Monaco","2024-06-17",0,0,0,0,0,0,0,0
"Monaco","2024-06-18",0,0,0,0,0,0,0,0
"Monaco","2024-06-19",0,0,0,0,0,0,0,0
"Monaco","2024-06-20",0,0,0,0,0,0,0,0
"Monaco","2024-06-21",0,0,0,0,0,0,0,0
"Monaco","2024-06-22",0,0,0,0,0,0,0,0
"Monaco","2024-06-23",0,0,0,0,0,0,0,0
"Monaco","2024-06-24",0,0,0,0,0,0,0,0
"Monaco","2024-06-25",0,0,0,0,0,0,0,0
"Monaco","2024-06-26",0,0,0,0,0,0,0,0
"Monaco","2024-06-27",0,0,0,0,0,0,0,0
"Monaco","2024-06-28",0,0,0,0,0,0,0,0
"Monaco","2024-06-29",0,0,0,0,0,0,0,0
"Monaco","2024-06-30",0,0,0,0,0,0,0,0
"Monaco","2024-07-01",0,0,0,0,0,0,0,0
"Monaco","2024-07-02",0,0,0,0,0,0,0,0
"Monaco","2024-07-03",0,0,0,0,0,0,0,0
"Monaco","2024-07-04",0,0,0,0,0,0,0,0
"Monaco","2024-07-05",0,0,0,0,0,0,0,0
"Monaco","2024-07-06",0,0,0,0,0,0,0,0
"Monaco","2024-07-07",0,0,0,0,0,0,0,0
"Monaco","2024-07-08",0,0,0,0,0,0,0,0
"Monaco","2024-07-09",0,0,0,0,0,0,0,0
"Monaco","2024-07-10",0,0,0,0,0,0,0,0
"Monaco","2024-07-11",0,0,0,0,0,0,0,0
"Monaco","2024-07-12",0,0,0,0,0,0,0,0
"Monaco","2024-07-13",0,0,0,0,0,0,0,0
"Monaco","2024-07-14",0,0,0,0,0,0,0,0
"Monaco","2024-07-15",0,0,0,0,0,0,0,0
"Monaco","2024-07-16",0,0,0,0,0,0,0,0
"Monaco","2024-07-17",0,0,0,0,0,0,0,0
"Monaco","2024-07-18",0,0,0,0,0,0,0,0
"Monaco","2024-07-19",0,0,0,0,0,0,0,0
"Monaco","2024-07-20",0,0,0,0,0,0,0,0
"Monaco","2024-07-21",0,0,0,0,0,0,0,0
"Monaco","2024-07-22",0,0,0,0,0,0,0,0
"Monaco","2024-07-23",0,0,0,0,0,0,0,0
"Monaco","2024-07-24",0,0,0,0,0,0,0,0
"Monaco","2024-07-25",0,0,0,0,0,0,0,0
"Monaco","2024-07-26",0,0,0,0,0,0,0,0
"Monaco","2024-07-27",0,0,0,0,0,0,0,0
"Monaco","2024-07-28",0,0,0,0,0,0,0,0
"Monaco","2024-07-29",0,0,0,0,0,0,0,0
"Monaco","2024-07-30",0,0,0,0,0,0,0,0
"Monaco","2024-07-31",0,0,0,0,0,0,0,0
"Monaco","2024-08-01",0,0,0,0,0,0,0,0
"Monaco","2024-08-02",0,0,0,0,0,0,0,0
"Monaco","2024-08-03",0,0,0,0,0,0,0,0
"Monaco","2024-08-04",0,0,0,0,0,0,0,0
"Monaco","2024-08-05",0,0,0,0,0,0,0,0
"Monaco","2024-08-06",0,0,0,0,0,0,0,0
"Monaco","2024-08-07",0,0,0,0,0,0,0,0
"Monaco","2024-08-08",0,0,0,0,0,0,0,0
"Monaco","2024-08-09",0,0,0,0,0,0,0,0
"Monaco","2024-08-10",0,0,0,0,0,0,0,0
"Monaco","2024-08-11",0,0,0,0,0,0,0,0
"Monaco","2024-08-12",0,0,0,0,0,0,0,0
"Monaco","2024-08-13",0,0,0,0,0,0,0,0
"Monaco","2024-08-14",0,0,0,0,0,0,0,0
"Monaco","2024-08-15",0,0,0,0,0,0,0,0
"Monaco","2024-08-16",0,0,0,0,0,0,0,0
"Monaco","2024-08-17",0,0,0,0,0,0,0,0
"Monaco","2024-08-18",0,0,0,0,0,0,0,0
"Monaco","2024-08-19",0,0,0,0,0,0,0,0
"Monaco","2024-08-20",0,0,0,0,0,0,0,0
"Monaco","2024-08-21",0,0,0,0,0,0,0,0
"Monaco","2024-08-22",0,0,0,0,0,0,0,0
"Monaco","2024-08-23",0,0,0,0,0,0,0,0
"Monaco","2024-08-24",0,0,0,0,0,0,0,0
"Monaco","2024-08-25",0,0,0,0,0,0,0,0
"Monaco","2024-08-26",0,0,0,0,0,0,0,0
"Monaco","2024-08-27",0,0,0,0,0,0,0,0
"Monaco","2024-08-28",0,0,0,0,0,0,0,0
"Monaco","2024-08-29",0,0,0,0,0,0,0,0
"Monaco","2024-08-30",0,0,0,0,0,0,0,0
"Monaco","2024-08-31",0,0,0,0,0,0,0,0
"Monaco","2024-09-01",0,0,0,0,0,0,0,0
"Monaco","2024-09-02",0,0,0,0,0,0,0,0
"Monaco","2024-09-03",0,0,0,0,0,0,0,0
"Monaco","2024-09-04",0,0,0,0,0,0,0,0
"Monaco","2024-09-05",0,0,0,0,0,0,0,0
"Monaco","2024-09-06",0,0,0,0,0,0,0,0
"Monaco","2024-09-07",0,0,0,0,0,0,0,0
"Monaco","2024-09-08",0,0,0,0,0,0,0,0
"Monaco","2024-09-09",0,0,0,0,0,0,0,0
"Monaco","2024-09-10",0,0,0,0,0,0,0,0
"Monaco","2024-09-11",0,0,0,0,0,0,0,0
"Monaco","2024-09-12",0,0,0,0,0,0,0,0
"Monaco","2024-09-13",0,0,0,0,0,0,0,0
"Monaco","2024-09-14",0,0,0,0,0,0,0,0
"Monaco","2024-09-15",0,0,0,0,0,0,0,0
"Monaco","2024-09-16",0,0,0,0,0,0,0,0
"Monaco","2024-09-17",0,0,0,0,0,0,0,0
"Monaco","2024-09-18",0,0,0,0,0,0,0,0
"Monaco","2024-09-19",0,0,0,0,0,0,0,0
"Monaco","2024-09-20",0,0,0,0,0,0,0,0
"Monaco","2024-09-21",0,0,0,0,0,0,0,0
"Monaco","2024-09-22",0,0,0,0,0,0,0,0
"Monaco","2024-09-23",0,0,0,0,0,0,0,0
"Monaco","2024-09-24",0,0,0,0,0,0,0,0
"Monaco","2024-09-25",0,0,0,0,0,0,0,0
"Monaco","2024-09-26",0,0,0,0,0,0,0,0
"Monaco","2024-09-27",0,0,0,0,0,0,0,0
"Monaco","2024-09-28",0,0,0,0,0,0,0,0
"Monaco","2024-09-29",0,0,0,0,0,0,0,0
"Monaco","2024-09-30",0,0,0,0,0,0,0,0
"Monaco","2024-10-01",0,0,0,0,0,0,0,0
"Monaco","2024-10-02",0,0,0,0,0,0,0,0
"Monaco","2024-10-03",0,0,0,0,0,0,0,0
"Monaco","2024-10-04",0,0,0,0,0,0,0,0
"Monaco","2024-10-05",0,0,0,0,0,0,0,0
"Monaco","2024-10-06",0,0,0,0,0,0,0,0
"Monaco","2024-10-07",0,0,0,0,0,0,0,0
"Monaco","2024-10-08",0,0,0,0,0,0,0,0
"Monaco","2024-10-09",0,0,0,0,0,0,0,0
"Monaco","2024-10-10",0,0,0,0,0,0,0,0
"Monaco","2024-10-11",0,0,0,0,0,0,0,0
"Monaco","2024-10-12",0,0,0,0,0,0,0,0
"Monaco","2024-10-13",0,0,0,0,0,0,0,0
"Monaco","2024-10-14",0,0,0,0,0,0,0,0
"Monaco","2024-10-15",0,0,0,0,0,0,0,0
"Monaco","2024-10-16",0,0,0,0,0,0,0,0
"Monaco","2024-10-17",0,0,0,0,0,0,0,0
"Monaco","2024-10-18",0,0,0,0,0,0,0,0
"Monaco","2024-10-19",0,0,0,0,0,0,0,0
"Monaco","2024-10-20",0,0,0,0,0,0,0,0
"Monaco","2024-10-21",0,0,0,0,0,0,0,0
"Monaco","2024-10-22",0,0,0,0,0,0,0,0
"Monaco","2024-10-23",0,0,0,0,0,0,0,0
"Monaco","2024-10-24",0,0,0,0,0,0,0,0
"Monaco","2024-10-25",0,0,0,0,0,0,0,0
"Monaco","2024-10-26",0,0,0,0,0,0,0,0
"Monaco","2024-10-27",0,0,0,0,0,0,0,0
"Monaco","2024-10-28",0,0,0,0,0,0,0,0
"Monaco","2024-10-29",0,0,0,0,0,0,0,0
"Monaco","2024-10-30",0,0,0,0,0,0,0,0
"Monaco","2024-10-31",0,0,0,0,0,0,0,0
"Monaco","2024-11-01",0,0,0,0,0,0,0,0
"Monaco","2024-11-02",0,0,0,0,0,0,0,0
"Monaco","2024-11-03",0,0,0,0,0,0,0,0
"Monaco","2024-11-04",0,0,0,0,0,0,0,0
"Monaco","2024-11-05",0,0,0,0,0,0,0,0
"Monaco","2024-11-06",0,0,0,0,0,0,0,0
"Monaco","2024-11-07",0,0,0,0,0,0,0,0
"Monaco","2024-11-08",0,0,0,0,0,0,0,0
"Monaco","2024-11-09",0,0,0,0,0,0,0,0
"Monaco","2024-11-10",0,0,0,0,0,0,0,0
"Monaco","2024-11-11",0,0,0,0,0,0,0,0
"Monaco","2024-11-12",0,0,0,0,0,0,0,0
"Monaco","2024-11-13",0,0,0,0,0,0,0,0
"Monaco","2024-11-14",0,0,0,0,0,0,0,0
"Monaco","2024-11-15",0,0,0,0,0,0,0,0
"Monaco","2024-11-16",0,0,0,0,0,0,0,0
"Monaco","2024-11-17",0,0,0,0,0,0,0,0
"Monaco","2024-11-18",0,0,0,0,0,0,0,0
"Monaco","2024-11-19",0,0,0,0,0,0,0,0
"Monaco","2024-11-20",0,0,0,0,0,0,0,0
"Monaco","2024-11-21",0,0,0,0,0,0,0,0
"Monaco","2024-11-22",0,0,0,0,0,0,0,0
"Monaco","2024-11-23",0,0,0,0,0,0,0,0
"Monaco","2024-11-24",0,0,0,0,0,0,0,0
"Monaco","2024-11-25",0,0,0,0,0,0,0,0
"Monaco","2024-11-26",0,0,0,0,0,0,0,0
"Monaco","2024-11-27",0,0,0,0,0,0,0,0
"Monaco","2024-11-28",0,0,0,0,0,0,0,0
"Monaco","2024-11-29",0,0,0,0,0,0,0,0
"Monaco","2024-11-30",0,0,0,0,0,0,0,0
"Monaco","2024-12-01",0,0,0,0,0,0,0,0
"Monaco","2024-12-02",0,0,0,0,0,0,0,0
"Monaco","2024-12-03",0,0,0,0,0,0,0,0
"Monaco","2024-12-04",0,0,0,0,0,0,0,0
"Monaco","2024-12-05",0,0,0,0,0,0,0,0
"Monaco","2024-12-06",0,0,0,0,0,0,0,0
"Monaco","2024-12-07",0,0,0,0,0,0,0,0
"Monaco","2024-12-08",0,0,0,0,0,0,0,0
"Monaco","2024-12-09",0,0,0,0,0,0,0,0
"Monaco","2024-12-10",0,0,0,0,0,0,0,0
"Monaco","2024-12-11",0,0,0,0,0,0,0,0
"Monaco","2024-12-12",0,0,0,0,0,0,0,0
"Monaco","2024-12-13",0,0,0,0,0,0,0,0
"Monaco","2024-12-14",0,0,0,0,0,0,0,0
"Monaco","2024-12-15",0,0,0,0,0,0,0,0
"Monaco","2024-12-16",0,0,0,0,0,0,0,0
"Monaco","2024-12-17",0,0,0,0,0,0,0,0
"Monaco","2024-12-18",0,0,0,0,0,0,0,0
"Monaco","2024-12-19",0,0,0,0,0,0,0,0
"Monaco","2024-12-20",0,0,0,0,0,0,0,0
"Monaco","2024-12-21",0,0,0,0,0,0,0,0
"Monaco","2024-12-22",0,0,0,0,0,0,0,0
"Monaco","2024-12-23",0,0,0,0,0,0,0,0
"Monaco","2024-12-24",0,0,0,0,0,0,0,0
"Monaco","2024-12-25",0,0,0,0,0,0,0,0
"Monaco","2024-12-26",0,0,0,0,0,0,0,0
"Monaco","2024-12-27",0,0,0,0,0,0,0,0
"Monaco","2024-12-28",0,0,0,0,0,0,0,0
"Monaco","2024-12-29",0,0,0,0,0,0,0,0
"Monaco","2024-12-30",0,0,0,0,0,0,0,0
"Monaco","2024-12-31",0,0,0,0,0,0,0,0
"Monaco","2025-01-01",0,0,0,0,0,0,0,0
"Monaco","2025-01-02",0,0,0,0,0,0,0,0
"Monaco","2025-01-03",0,0,0,0,0,0,0,0
"Monaco","2025-01-04",0,0,0,0,0,0,0,0
"Monaco","2025-01-05",0,0,0,0,0,0,0,0
"Monaco","2025-01-06",0,0,0,0,0,0,0,0
"Monaco","2025-01-07",0,0,0,0,0,0,0,0
"Monaco","2025-01-08",0,0,0,0,0,0,0,0
"Monaco","2025-01-09",0,0,0,0,0,0,0,0
"Monaco","2025-01-10",0,0,0,0,0,0,0,0
"Monaco","2025-01-11",0,0,0,0,0,0,0,0
"Monaco","2025-01-12",0,0,0,0,0,0,0,0
"Monaco","2025-01-13",0,0,0,0,0,0,0,0
"Montenegro","2024-01-01",0,0,0,0,0,0,0,0
"Montenegro","2024-01-02",0,0,0,0,0,0,0,0
"Montenegro","2024-01-03",0,0,0,0,0,0,0,0
"Montenegro","2024-01-04",0,0,0,0,0,0,0,0
"Montenegro","2024-01-05",0,0,0,0,0,0,0,0
"Montenegro","2024-01-06",0,0,0,0,0,0,0,0
"Montenegro","2024-01-07",0,0,0,0,0,0,0,0
"Montenegro","2024-01-08",0,0,0,0,0,0,0,0
"Montenegro","2024-01-09",0,0,0,0,0,0,0,0
"Montenegro","2024-01-10",0,0,0,0,0,0,0,0
"Montenegro","2024-01-11",0,0,0,0,0,0,0,0
"Montenegro","2024-01-12",0,0,0,0,0,0,0,0
"Montenegro","2024-01-13",0,0,0,0,0,0,0,0
"Montenegro","2024-01-14",0,0,0,0,0,0,0,0
"Montenegro","2024-01-15",0,0,0,0,0,0,0,0
"Montenegro","2024-01-16",0,0,0,0,0,0,0,0
"Montenegro","2024-01-17",0,0,0,0,0,0,0,0
"Montenegro","2024-01-18",0,0,0,0,0,0,0,0
"Montenegro","2024-01-19",0,0,0,0,0,0,0,0
"Montenegro","2024-01-20",0,0,0,0,0,0,0,0
"Montenegro","2024-01-21",0,0,0,0,0,0,0,0
"Montenegro","2024-01-22",0,0,0,0,0,0,0,0
"Montenegro","2024-01-23",0,0,0,0,0,0,0,0
"Montenegro","2024-01-24",0,0,0,0,0,0,0,0
"Montenegro","2024-01-25",0,0,0,0,0,0,0,0
"Montenegro","2024-01-26",0,0,0,0,0,0,0,0
"Montenegro","2024-01-27",0,0,0,0,0,0,0,0
"Montenegro","2024-01-28",0,0,0,0,0,0,0,0
"Montenegro","2024-01-29",0,0,0,0,0,0,0,0
"Montenegro","2024-01-30",0,0,0,0,0,0,0,0
"Montenegro","2024-01-31",0,0,0,0,0,0,0,0
"Montenegro","2024-02-01",0,0,0,0,0,0,0,0
"Montenegro","2024-02-02",0,0,0,0,0,0,0,0
"Montenegro","2024-02-03",0,0,0,0,0,0,0,0
"Montenegro","2024-02-04",0,0,0,0,0,0,0,0
"Montenegro","2024-02-05",0,0,0,0,0,0,0,0
"Montenegro","2024-02-06",0,0,0,0,0,0,0,0
"Montenegro","2024-02-07",0,0,0,0,0,0,0,0
"Montenegro","2024-02-08",0,0,0,0,0,0,0,0
"Montenegro","2024-02-09",0,0,0,0,0,0,0,0
"Montenegro","2024-02-10",0,0,0,0,0,0,0,0
"Montenegro","2024-02-11",0,0,0,0,0,0,0,0
"Montenegro","2024-02-12",0,0,0,0,0,0,0,0
"Montenegro","2024-02-13",0,0,0,0,0,0,0,0
"Montenegro","2024-02-14",0,0,0,0,0,0,0,0
"Montenegro","2024-02-15",0,0,0,0,0,0,0,0
"Montenegro","2024-02-16",0,0,0,0,0,0,0,0
"Montenegro","2024-02-17",0,0,0,0,0,0,0,0
"Montenegro","2024-02-18",0,0,0,0,0,0,0,0
"Montenegro","2024-02-19",0,0,0,0,0,0,0,0
"Montenegro","2024-02-20",0,0,0,0,0,0,0,0
"Montenegro","2024-02-21",0,0,0,0,0,0,0,0
"Montenegro","2024-02-22",0,0,0,0,0,0,0,0
"Montenegro","2024-02-23",0,0,0,0,0,0,0,0
"Montenegro","2024-02-24",0,0,0,0,0,0,0,0
"Montenegro","2024-02-25",0,0,0,0,0,0,0,0
"Montenegro","2024-02-26",0,0,0,0,0,0,0,0
"Montenegro","2024-02-27",0,0,0,0,0,0,0,0
"Montenegro","2024-02-28",0,0,0,0,0,0,0,0
"Montenegro","2024-02-29",0,0,0,0,0,0,0,0
"Montenegro","2024-03-01",0,0,0,0,0,0,0,0
"Montenegro","2024-03-02",0,0,0,0,0,0,0,0
"Montenegro","2024-03-03",0,0,0,0,0,0,0,0
"Montenegro","2024-03-04",0,0,0,0,0,0,0,0
"Montenegro","2024-03-05",0,0,0,0,0,0,0,0
"Montenegro","2024-03-06",0,0,0,0,0,0,0,0
"Montenegro","2024-03-07",0,0,0,0,0,0,0,0
"Montenegro","2024-03-08",0,0,0,0,0,0,0,0
"Montenegro","2024-03-09",0,0,0,0,0,0,0,0
"Montenegro","2024-03-10",0,0,0,0,0,0,0,0
"Montenegro","2024-03-11",0,0,0,0,0,0,0,0
"Montenegro","2024-03-12",0,0,0,0,0,0,0,0
"Montenegro","2024-03-13",0,0,0,0,0,0,0,0
"Montenegro","2024-03-14",0,0,0,0,0,0,0,0
"Montenegro","2024-03-15",0,0,0,0,0,0,0,0
"Montenegro","2024-03-16",0,0,0,0,0,0,0,0
"Montenegro","2024-03-17",0,0,0,0,0,0,0,0
"Montenegro","2024-03-18",0,0,0,0,0,0,0,0
"Montenegro","2024-03-19",0,0,0,0,0,0,0,0
"Montenegro","2024-03-20",0,0,0,0,0,0,0,0
"Montenegro","2024-03-21",0,0,0,0,0,0,0,0
"Montenegro","2024-03-22",0,0,0,0,0,0,0,0
"Montenegro","2024-03-23",0,0,0,0,0,0,0,0
"Montenegro","2024-03-24",0,0,0,0,0,0,0,0
"Montenegro","2024-03-25",0,0,0,0,0,0,0,0
"Montenegro","2024-03-26",0,0,0,0,0,0,0,0
"Montenegro","2024-03-27",0,0,0,0,0,0,0,0
"Montenegro","2024-03-28",0,0,0,0,0,0,0,0
"Montenegro","2024-03-29",0,0,0,0,0,0,0,0
"Montenegro","2024-03-30",0,0,0,0,0,0,0,0
"Montenegro","2024-03-31",0,0,0,0,0,0,0,0
"Montenegro","2024-04-01",0,0,0,0,0,0,0,0
"Montenegro","2024-04-02",0,0,0,0,0,0,0,0
"Montenegro","2024-04-03",0,0,0,0,0,0,0,0
"Montenegro","2024-04-04",0,0,0,0,0,0,0,0
"Montenegro","2024-04-05",0,0,0,0,0,0,0,0
"Montenegro","2024-04-06",0,0,0,0,0,0,0,0
"Montenegro","2024-04-07",0,0,0,0,0,0,0,0
"Montenegro","2024-04-08",0,0,0,0,0,0,0,0
"Montenegro","2024-04-09",0,0,0,0,0,0,0,0
"Montenegro","2024-04-10",0,0,0,0,0,0,0,0
"Montenegro","2024-04-11",0,0,0,0,0,0,0,0
"Montenegro","2024-04-12",0,0,0,0,0,0,0,0
"Montenegro","2024-04-13",0,0,0,0,0,0,0,0
"Montenegro","2024-04-14",0,0,0,0,0,0,0,0
"Montenegro","2024-04-15",0,0,0,0,0,0,0,0
"Montenegro","2024-04-16",0,0,0,0,0,0,0,0
"Montenegro","2024-04-17",0,0,0,0,0,0,0,0
"Montenegro","2024-04-18",0,0,0,0,0,0,0,0
"Montenegro","2024-04-19",0,0,0,0,0,0,0,0
"Montenegro","2024-04-20",0,0,0,0,0,0,0,0
"Montenegro","2024-04-21",0,0,0,0,0,0,0,0
"Montenegro","2024-04-22",0,0,0,0,0,0,0,0
"Montenegro","2024-04-23",0,0,0,0,0,0,0,0
"Montenegro","2024-04-24",0,0,0,0,0,0,0,0
"Montenegro","2024-04-25",0,0,0,0,0,0,0,0
"Montenegro","2024-04-26",0,0,0,0,0,0,0,0
"Montenegro","2024-04-27",0,0,0,0,0,0,0,0
"Montenegro","2024-04-28",0,0,0,0,0,0,0,0
"Montenegro","2024-04-29",0,0,0,0,0,0,0,0
"Montenegro","2024-04-30",0,0,0,0,0,0,0,0
"Montenegro","2024-05-01",0,0,0,0,0,0,0,0
"Montenegro","2024-05-02",0,0,0,0,0,0,0,0
"Montenegro","2024-05-03",0,0,0,0,0,0,0,0
"Montenegro","2024-05-04",0,0,0,0,0,0,0,0
"Montenegro","2024-05-05",0,0,0,0,0,0,0,0
"Montenegro","2024-05-06",0,0,0,0,0,0,0,0
"Montenegro","2024-05-07",0,0,0,0,0,0,0,0
"Montenegro","2024-05-08",0,0,0,0,0,0,0,0
"Montenegro","2024-05-09",0,0,0,0,0,0,0,0
"Montenegro","2024-05-10",0,0,0,0,0,0,0,0
"Montenegro","2024-05-11",0,0,0,0,0,0,0,0
"Montenegro","2024-05-12",0,0,0,0,0,0,0,0
"Montenegro","2024-05-13",0,0,0,0,0,0,0,0
"Montenegro","2024-05-14",0,0,0,0,0,0,0,0
"Montenegro","2024-05-15",0,0,0,0,0,0,0,0
"Montenegro","2024-05-16",0,0,0,0,0,0,0,0
"Montenegro","2024-05-17",0,0,0,0,0,0,0,0
"Montenegro","2024-05-18",0,0,0,0,0,0,0,0
"Montenegro","2024-05-19",0,0,0,0,0,0,0,0
"Montenegro","2024-05-20",0,0,0,0,0,0,0,0
"Montenegro","2024-05-21",0,0,0,0,0,0,0,0
"Montenegro","2024-05-22",0,0,0,0,0,0,0,0
"Montenegro","2024-05-23",0,0,0,0,0,0,0,0
"Montenegro","2024-05-24",0,0,0,0,0,0,0,0
"Montenegro","2024-05-25",0,0,0,0,0,0,0,0
"Montenegro","2024-05-26",0,0,0,0,0,0,0,0
"Montenegro","2024-05-27",0,0,0,0,0,0,0,0
"Montenegro","2024-05-28",0,0,0,0,0,0,0,0
"Montenegro","2024-05-29",0,0,0,0,0,0,0,0
"Montenegro","2024-05-30",0,0,0,0,0,0,0,0
"Montenegro","2024-05-31",0,0,0,0,0,0,0,0
"Montenegro","2024-06-01",0,0,0,0,0,0,0,0
"Montenegro","2024-06-02",0,0,0,0,0,0,0,0
"Montenegro","2024-06-03",0,0,0,0,0,0,0,0
"Montenegro","2024-06-04",0,0,0,0,0,0,0,0
"Montenegro","2024-06-05",0,0,0,0,0,0,0,0
"Montenegro","2024-06-06",0,0,0,0,0,0,0,0
"Montenegro","2024-06-07",0,0,0,0,0,0,0,0
"Montenegro","2024-06-08",0,0,0,0,0,0,0,0
"Montenegro","2024-06-09",0,0,0,0,0,0,0,0
"Montenegro","2024-06-10",0,0,0,0,0,0,0,0
"Montenegro","2024-06-11",0,0,0,0,0,0,0,0
"Montenegro","2024-06-12",0,0,0,0,0,0,0,0
"Montenegro","2024-06-13",0,0,0,0,0,0,0,0
"Montenegro","2024-06-14",0,0,0,0,0,0,0,0
"Montenegro","2024-06-15",0,0,0,0,0,0,0,0
"Montenegro","2024-06-16",0,0,0,0,0,0,0,0
"Montenegro","2024-06-17",0,0,0,0,0,0,0,0
"Montenegro","2024-06-18",0,0,0,0,0,0,0,0
"Montenegro","2024-06-19",0,0,0,0,0,0,0,0
"Montenegro","2024-06-20",0,0,0,0,0,0,0,0
"Montenegro","2024-06-21",0,0,0,0,0,0,0,0
"Montenegro","2024-06-22",0,0,0,0,0,0,0,0
"Montenegro","2024-06-23",0,0,0,0,0,0,0,0
"Montenegro","2024-06-24",0,0,0,0,0,0,0,0
"Montenegro","2024-06-25",0,0,0,0,0,0,0,0
"Montenegro","2024-06-26",0,0,0,0,0,0,0,0
"Montenegro","2024-06-27",0,0,0,0,0,0,0,0
"Montenegro","2024-06-28",0,0,0,0,0,0,0,0
"Montenegro","2024-06-29",0,0,0,0,0,0,0,0
"Montenegro","2024-06-30",0,0,0,0,0,0,0,0
"Montenegro","2024-07-01",0,0,0,0,0,0,0,0
"Montenegro","2024-07-02",0,0,0,0,0,0,0,0
"Montenegro","2024-07-03",0,0,0,0,0,0,0,0
"Montenegro","2024-07-04",0,0,0,0,0,0,0,0
"Montenegro","2024-07-05",0,0,0,0,0,0,0,0
"Montenegro","2024-07-06",0,0,0,0,0,0,0,0
"Montenegro","2024-07-07",0,0,0,0,0,0,0,0
"Montenegro","2024-07-08",0,0,0,0,0,0,0,0
"Montenegro","2024-07-09",0,0,0,0,0,0,0,0
"Montenegro","2024-07-10",0,0,0,0,0,0,0,0
"Montenegro","2024-07-11",0,0,0,0,0,0,0,0
"Montenegro","2024-07-12",0,0,0,0,0,0,0,0
"Montenegro","2024-07-13",0,0,0,0,0,0,0,0
"Montenegro","2024-07-14",0,0,0,0,0,0,0,0
"Montenegro","2024-07-15",0,0,0,0,0,0,0,0
"Montenegro","2024-07-16",0,0,0,0,0,0,0,0
"Montenegro","2024-07-17",0,0,0,0,0,0,0,0
"Montenegro","2024-07-18",0,0,0,0,0,0,0,0
"Montenegro","2024-07-19",0,0,0,0,0,0,0,0
"Montenegro","2024-07-20",0,0,0,0,0,0,0,0
"Montenegro","2024-07-21",0,0,0,0,0,0,0,0
"Montenegro","2024-07-22",0,0,0,0,0,0,0,0
"Montenegro","2024-07-23",0,0,0,0,0,0,0,0
"Montenegro","2024-07-24",0,0,0,0,0,0,0,0
"Montenegro","2024-07-25",0,0,0,0,0,0,0,0
"Montenegro","2024-07-26",0,0,0,0,0,0,0,0
"Montenegro","2024-07-27",0,0,0,0,0,0,0,0
"Montenegro","2024-07-28",0,0,0,0,0,0,0,0
"Montenegro","2024-07-29",0,0,0,0,0,0,0,0
"Montenegro","2024-07-30",0,0,0,0,0,0,0,0
"Montenegro","2024-07-31",0,0,0,0,0,0,0,0
"Montenegro","2024-08-01",0,0,0,0,0,0,0,0
"Montenegro","2024-08-02",0,0,0,0,0,0,0,0
"Montenegro","2024-08-03",0,0,0,0,0,0,0,0
"Montenegro","2024-08-04",0,0,0,0,0,0,0,0
"Montenegro","2024-08-05",0,0,0,0,0,0,0,0
"Montenegro","2024-08-06",0,0,0,0,0,0,0,0
"Montenegro","2024-08-07",0,0,0,0,0,0,0,0
"Montenegro","2024-08-08",0,0,0,0,0,0,0,0
"Montenegro","2024-08-09",0,0,0,0,0,0,0,0
"Montenegro","2024-08-10",0,0,0,0,0,0,0,0
"Montenegro","2024-08-11",0,0,0,0,0,0,0,0
"Montenegro","2024-08-12",0,0,0,0,0,0,0,0
"Montenegro","2024-08-13",0,0,0,0,0,0,0,0
"Montenegro","2024-08-14",0,0,0,0,0,0,0,0
"Montenegro","2024-08-15",0,0,0,0,0,0,0,0
"Montenegro","2024-08-16",0,0,0,0,0,0,0,0
"Montenegro","2024-08-17",0,0,0,0,0,0,0,0
"Montenegro","2024-08-18",0,0,0,0,0,0,0,0
"Montenegro","2024-08-19",0,0,0,0,0,0,0,0
"Montenegro","2024-08-20",0,0,0,0,0,0,0,0
"Montenegro","2024-08-21",0,0,0,0,0,0,0,0
"Montenegro","2024-08-22",0,0,0,0,0,0,0,0
"Montenegro","2024-08-23",0,0,0,0,0,0,0,0
"Montenegro","2024-08-24",0,0,0,0,0,0,0,0
"Montenegro","2024-08-25",0,0,0,0,0,0,0,0
"Montenegro","2024-08-26",0,0,0,0,0,0,0,0
"Montenegro","2024-08-27",0,0,0,0,0,0,0,0
"Montenegro","2024-08-28",0,0,0,0,0,0,0,0
"Montenegro","2024-08-29",0,0,0,0,0,0,0,0
"Montenegro","2024-08-30",0,0,0,0,0,0,0,0
"Montenegro","2024-08-31",0,0,0,0,0,0,0,0
"Montenegro","2024-09-01",0,0,0,0,0,0,0,0
"Montenegro","2024-09-02",0,0,0,0,0,0,0,0
"Montenegro","2024-09-03",0,0,0,0,0,0,0,0
"Montenegro","2024-09-04",0,0,0,0,0,0,0,0
"Montenegro","2024-09-05",0,0,0,0,0,0,0,0
"Montenegro","2024-09-06",0,0,0,0,0,0,0,0
"Montenegro","2024-09-07",0,0,0,0,0,0,0,0
"Montenegro","2024-09-08",0,0,0,0,0,0,0,0
"Montenegro","2024-09-09",0,0,0,0,0,0,0,0
"Montenegro","2024-09-10",0,0,0,0,0,0,0,0
"Montenegro","2024-09-11",0,0,0,0,0,0,0,0
"Montenegro","2024-09-12",0,0,0,0,0,0,0,0
"Montenegro","2024-09-13",0,0,0,0,0,0,0,0
"Montenegro","2024-09-14",0,0,0,0,0,0,0,0
"Montenegro","2024-09-15",0,0,0,0,0,0,0,0
"Montenegro","2024-09-16",0,0,0,0,0,0,0,0
"Montenegro","2024-09-17",0,0,0,0,0,0,0,0
"Montenegro","2024-09-18",0,0,0,0,0,0,0,0
"Montenegro","2024-09-19",0,0,0,0,0,0,0,0
"Montenegro","2024-09-20",0,0,0,0,0,0,0,0
"Montenegro","2024-09-21",0,0,0,0,0,0,0,0
"Montenegro","2024-09-22",0,0,0,0,0,0,0,0
"Montenegro","2024-09-23",0,0,0,0,0,0,0,0
"Montenegro","2024-09-24",0,0,0,0,0,0,0,0
"Montenegro","2024-09-25",0,0,0,0,0,0,0,0
"Montenegro","2024-09-26",0,0,0,0,0,0,0,0
"Montenegro","2024-09-27",0,0,0,0,0,0,0,0
"Montenegro","2024-09-28",0,0,0,0,0,0,0,0
"Montenegro","2024-09-29",0,0,0,0,0,0,0,0
"Montenegro","2024-09-30",0,0,0,0,0,0,0,0
"Montenegro","2024-10-01",0,0,0,0,0,0,0,0
"Montenegro","2024-10-02",0,0,0,0,0,0,0,0
"Montenegro","2024-10-03",0,0,0,0,0,0,0,0
"Montenegro","2024-10-04",0,0,0,0,0,0,0,0
"Montenegro","2024-10-05",0,0,0,0,0,0,0,0
"Montenegro","2024-10-06",0,0,0,0,0,0,0,0
"Montenegro","2024-10-07",0,0,0,0,0,0,0,0
"Montenegro","2024-10-08",0,0,0,0,0,0,0,0
"Montenegro","2024-10-09",0,0,0,0,0,0,0,0
"Montenegro","2024-10-10",0,0,0,0,0,0,0,0
"Montenegro","2024-10-11",0,0,0,0,0,0,0,0
"Montenegro","2024-10-12",0,0,0,0,0,0,0,0
"Montenegro","2024-10-13",0,0,0,0,0,0,0,0
"Montenegro","2024-10-14",0,0,0,0,0,0,0,0
"Montenegro","2024-10-15",0,0,0,0,0,0,0,0
"Montenegro","2024-10-16",0,0,0,0,0,0,0,0
"Montenegro","2024-10-17",0,0,0,0,0,0,0,0
"Montenegro","2024-10-18",0,0,0,0,0,0,0,0
"Montenegro","2024-10-19",0,0,0,0,0,0,0,0
"Montenegro","2024-10-20",0,0,0,0,0,0,0,0
"Montenegro","2024-10-21",0,0,0,0,0,0,0,0
"Montenegro","2024-10-22",0,0,0,0,0,0,0,0
"Montenegro","2024-10-23",0,0,0,0,0,0,0,0
"Montenegro","2024-10-24",0,0,0,0,0,0,0,0
"Montenegro","2024-10-25",0,0,0,0,0,0,0,0
"Montenegro","2024-10-26",0,0,0,0,0,0,0,0
"Montenegro","2024-10-27",0,0,0,0,0,0,0,0
"Montenegro","2024-10-28",0,0,0,0,0,0,0,0
"Montenegro","2024-10-29",0,0,0,0,0,0,0,0
"Montenegro","2024-10-30",0,0,0,0,0,0,0,0
"Montenegro","2024-10-31",0,0,0,0,0,0,0,0
"Montenegro","2024-11-01",0,0,0,0,0,0,0,0
"Montenegro","2024-11-02",0,0,0,0,0,0,0,0
"Montenegro","2024-11-03",0,0,0,0,0,0,0,0
"Montenegro","2024-11-04",0,0,0,0,0,0,0,0
"Montenegro","2024-11-05",0,0,0,0,0,0,0,0
"Montenegro","2024-11-06",0,0,0,0,0,0,0,0
"Montenegro","2024-11-07",0,0,0,0,0,0,0,0
"Montenegro","2024-11-08",0,0,0,0,0,0,0,0
"Montenegro","2024-11-09",0,0,0,0,0,0,0,0
"Montenegro","2024-11-10",0,0,0,0,0,0,0,0
"Montenegro","2024-11-11",0,0,0,0,0,0,0,0
"Montenegro","2024-11-12",0,0,0,0,0,0,0,0
"Montenegro","2024-11-13",0,0,0,0,0,0,0,0
"Montenegro","2024-11-14",0,0,0,0,0,0,0,0
"Montenegro","2024-11-15",0,0,0,0,0,0,0,0
"Montenegro","2024-11-16",0,0,0,0,0,0,0,0
"Montenegro","2024-11-17",0,0,0,0,0,0,0,0
"Montenegro","2024-11-18",0,0,0,0,0,0,0,0
"Montenegro","2024-11-19",0,0,0,0,0,0,0,0
"Montenegro","2024-11-20",0,0,0,0,0,0,0,0
"Montenegro","2024-11-21",0,0,0,0,0,0,0,0
"Montenegro","2024-11-22",0,0,0,0,0,0,0,0
"Montenegro","2024-11-23",0,0,0,0,0,0,0,0
"Montenegro","2024-11-24",0,0,0,0,0,0,0,0
"Montenegro","2024-11-25",0,0,0,0,0,0,0,0
"Montenegro","2024-11-26",0,0,0,0,0,0,0,0
"Montenegro","2024-11-27",0,0,0,0,0,0,0,0
"Montenegro","2024-11-28",0,0,0,0,0,0,0,0
"Montenegro","2024-11-29",0,0,0,0,0,0,0,0
"Montenegro","2024-11-30",0,0,0,0,0,0,0,0
"Montenegro","2024-12-01",0,0,0,0,0,0,0,0
"Montenegro","2024-12-02",0,0,0,0,0,0,0,0
"Montenegro","2024-12-03",0,0,0,0,0,0,0,0
"Montenegro","2024-12-04",0,0,0,0,0,0,0,0
"Montenegro","2024-12-05",0,0,0,0,0,0,0,0
"Montenegro","2024-12-06",0,0,0,0,0,0,0,0
"Montenegro","2024-12-07",0,0,0,0,0,0,0,0
"Montenegro","2024-12-08",0,0,0,0,0,0,0,0
"Montenegro","2024-12-09",0,0,0,0,0,0,0,0
"Montenegro","2024-12-10",0,0,0,0,0,0,0,0
"Montenegro","2024-12-11",0,0,0,0,0,0,0,0
"Montenegro","2024-12-12",0,0,0,0,0,0,0,0
"Montenegro","2024-12-13",0,0,0,0,0,0,0,0
"Montenegro","2024-12-14",0,0,0,0,0,0,0,0
"Montenegro","2024-12-15",0,0,0,0,0,0,0,0
"Montenegro","2024-12-16",0,0,0,0,0,0,0,0
"Montenegro","2024-12-17",0,0,0,0,0,0,0,0
"Montenegro","2024-12-18",0,0,0,0,0,0,0,0
"Montenegro","2024-12-19",0,0,0,0,0,0,0,0
"Montenegro","2024-12-20",0,0,0,0,0,0,0,0
"Montenegro","2024-12-21",0,0,0,0,0,0,0,0
"Montenegro","2024-12-22",0,0,0,0,0,0,0,0
"Montenegro","2024-12-23",0,0,0,0,0,0,0,0
"Montenegro","2024-12-24",0,0,0,0,0,0,0,0
"Montenegro","2024-12-25",0,0,0,0,0,0,0,0
"Montenegro","2024-12-26",0,0,0,0,0,0,0,0
"Montenegro","2024-12-27",0,0,0,0,0,0,0,0
"Montenegro","2024-12-28",0,0,0,0,0,0,0,0
"Montenegro","2024-12-29",0,0,0,0,0,0,0,0
"Montenegro","2024-12-30",0,0,0,0,0,0,0,0
"Montenegro","2024-12-31",0,0,0,0,0,0,0,0
"Montenegro","2025-01-01",0,0,0,0,0,0,0,0
"Montenegro","2025-01-02",0,0,0,0,0,0,0,0
"Montenegro","2025-01-03",0,0,0,0,0,0,0,0
"Montenegro","2025-01-04",0,0,0,0,0,0,0,0
"Montenegro","2025-01-05",0,0,0,0,0,0,0,0
"Montenegro","2025-01-06",0,0,0,0,0,0,0,0
"Montenegro","2025-01-07",0,0,0,0,0,0,0,0
"Montenegro","2025-01-08",0,0,0,0,0,0,0,0
"Montenegro","2025-01-09",0,0,0,0,0,0,0,0
"Montenegro","2025-01-10",0,0,0,0,0,0,0,0
"Montenegro","2025-01-11",0,0,0,0,0,0,0,0
"Montenegro","2025-01-12",0,0,0,0,0,0,0,0
"Montenegro","2025-01-13",0,0,0,0,0,0,0,0
"Morocco","2024-01-01",0,0,0,0,0,0,0,0
"Morocco","2024-01-02",0,0,0,0,0,0,0,0
"Morocco","2024-01-03",0,0,0,0,0,0,0,0
"Morocco","2024-01-04",0,0,0,0,0,0,0,0
"Morocco","2024-01-05",0,0,0,0,0,0,0,0
"Morocco","2024-01-06",0,0,0,0,0,0,0,0
"Morocco","2024-01-07",0,0,0,0,0,0,0,0
"Morocco","2024-01-08",0,0,0,0,0,0,0,0
"Morocco","2024-01-09",0,0,0,0,0,0,0,0
"Morocco","2024-01-10",0,0,0,0,0,0,0,0
"Morocco","2024-01-11",0,0,0,0,0,0,0,0
"Morocco","2024-01-12",0,0,0,0,0,0,0,0
"Morocco","2024-01-13",0,0,0,0,0,0,0,0
"Morocco","2024-01-14",0,0,0,0,0,0,0,0
"Morocco","2024-01-15",0,0,0,0,0,0,0,0
"Morocco","2024-01-16",0,0,0,0,0,0,0,0
"Morocco","2024-01-17",0,0,0,0,0,0,0,0
"Morocco","2024-01-18",0,0,0,0,0,0,0,0
"Morocco","2024-01-19",0,0,0,0,0,0,0,0
"Morocco","2024-01-20",0,0,0,0,0,0,0,0
"Morocco","2024-01-21",0,0,0,0,0,0,0,0
"Morocco","2024-01-22",0,0,0,0,0,0,0,0
"Morocco","2024-01-23",0,0,0,0,0,0,0,0
"Morocco","2024-01-24",0,0,0,0,0,0,0,0
"Morocco","2024-01-25",0,0,0,0,0,0,0,0
"Morocco","2024-01-26",0,0,0,0,0,0,0,0
"Morocco","2024-01-27",0,0,0,0,0,0,0,0
"Morocco","2024-01-28",0,0,0,0,0,0,0,0
"Morocco","2024-01-29",0,0,0,0,0,0,0,0
"Morocco","2024-01-30",0,0,0,0,0,0,0,0
"Morocco","2024-01-31",0,0,0,0,0,0,0,0
"Morocco","2024-02-01",0,0,0,0,0,0,0,0
"Morocco","2024-02-02",0,0,0,0,0,0,0,0
"Morocco","2024-02-03",0,0,0,0,0,0,0,0
"Morocco","2024-02-04",0,0,0,0,0,0,0,0
"Morocco","2024-02-05",0,0,0,0,0,0,0,0
"Morocco","2024-02-06",0,0,0,0,0,0,0,0
"Morocco","2024-02-07",0,0,0,0,0,0,0,0
"Morocco","2024-02-08",0,0,0,0,0,0,0,0
"Morocco","2024-02-09",0,0,0,0,0,0,0,0
"Morocco","2024-02-10",0,0,0,0,0,0,0,0
"Morocco","2024-02-11",0,0,0,0,0,0,0,0
"Morocco","2024-02-12",0,0,0,0,0,0,0,0
"Morocco","2024-02-13",0,0,0,0,0,0,0,0
"Morocco","2024-02-14",0,0,0,0,0,0,0,0
"Morocco","2024-02-15",0,0,0,0,0,0,0,0
"Morocco","2024-02-16",0,0,0,0,0,0,0,0
"Morocco","2024-02-17",0,0,0,0,0,0,0,0
"Morocco","2024-02-18",0,0,0,0,0,0,0,0
"Morocco","2024-02-19",0,0,0,0,0,0,0,0
"Morocco","2024-02-20",0,0,0,0,0,0,0,0
"Morocco","2024-02-21",0,0,0,0,0,0,0,0
"Morocco","2024-02-22",0,0,0,0,0,0,0,0
"Morocco","2024-02-23",0,0,0,0,0,0,0,0
"Morocco","2024-02-24",0,0,0,0,0,0,0,0
"Morocco","2024-02-25",0,0,0,0,0,0,0,0
"Morocco","2024-02-26",0,0,0,0,0,0,0,0
"Morocco","2024-02-27",0,0,0,0,0,0,0,0
"Morocco","2024-02-28",0,0,0,0,0,0,0,0
"Morocco","2024-02-29",0,0,0,0,0,0,0,0
"Morocco","2024-03-01",0,0,0,0,0,0,0,0
"Morocco","2024-03-02",0,0,0,0,0,0,0,0
"Morocco","2024-03-03",0,0,0,0,0,0,0,0
"Morocco","2024-03-04",0,0,0,0,0,0,0,0
"Morocco","2024-03-05",0,0,0,0,0,0,0,0
"Morocco","2024-03-06",0,0,0,0,0,0,0,0
"Morocco","2024-03-07",0,0,0,0,0,0,0,0
"Morocco","2024-03-08",0,0,0,0,0,0,0,0
"Morocco","2024-03-09",0,0,0,0,0,0,0,0
"Morocco","2024-03-10",0,0,0,0,0,0,0,0
"Morocco","2024-03-11",0,0,0,0,0,0,0,0
"Morocco","2024-03-12",0,0,0,0,0,0,0,0
"Morocco","2024-03-13",0,0,0,0,0,0,0,0
"Morocco","2024-03-14",0,0,0,0,0,0,0,0
"Morocco","2024-03-15",0,1,1,0,1,1,0,0
"Morocco","2024-03-16",0,0,1,0,0,1,0,0
"Morocco","2024-03-17",0,0,1,0,0,1,0,0
"Morocco","2024-03-18",0,0,1,0,0,1,0,0
"Morocco","2024-03-19",0,0,1,0,0,1,0,0
"Morocco","2024-03-20",0,0,1,0,0,1,0,0
"Morocco","2024-03-21",0,0,1,0,0,1,0,0
"Morocco","2024-03-22",0,0,1,0,0,1,0,0
"Morocco","2024-03-23",0,0,1,0,0,1,0,0
"Morocco","2024-03-24",0,0,1,0,0,1,0,0
"Morocco","2024-03-25",0,0,1,0,0,1,0,0
"Morocco","2024-03-26",0,0,1,0,0,1,0,0
"Morocco","2024-03-27",0,0,1,0,0,1,0,0
"Morocco","2024-03-28",0,0,1,0,0,1,0,0
"Morocco","2024-03-29",0,0,1,0,0,1,0,0
"Morocco","2024-03-30",0,0,1,0,0,1,0,0
"Morocco","2024-03-31",0,0,1,0,0,1,0,0
"Morocco","2024-04-01",0,0,1,0,0,1,0,0
"Morocco","2024-04-02",0,0,1,0,0,1,0,0
"Morocco","2024-04-03",0,0,1,0,0,1,0,0
"Morocco","2024-04-04",0,0,1,0,0,1,0,0
"Morocco","2024-04-05",0,0,1,0,0,1,0,0
"Morocco","2024-04-06",0,0,1,0,0,1,0,0
"Morocco","2024-04-07",0,0,1,0,0,1,0,0
"Morocco","2024-04-08",0,0,1,0,0,1,0,0
"Morocco","2024-04-09",0,0,1,0,0,1,0,0
"Morocco","2024-04-10",0,0,1,0,0,1,0,0
"Morocco","2024-04-11",0,0,1,0,0,1,0,0
"Morocco","2024-04-12",0,0,1,0,0,1,0,0
"Morocco","2024-04-13",0,0,1,0,0,1,0,0
"Morocco","2024-04-14",0,0,1,0,0,1,0,0
"Morocco","2024-04-15",0,0,1,0,0,1,0,0
"Morocco","2024-04-16",0,0,1,0,0,1,0,0
"Morocco","2024-04-17",0,0,1,0,0,1,0,0
"Morocco","2024-04-18",0,0,1,0,0,1,0,0
"Morocco","2024-04-19",0,0,1,0,0,1,0,0
"Morocco","2024-04-20",0,0,1,0,0,1,0,0
"Morocco","2024-04-21",0,0,1,0,0,1,0,0
"Morocco","2024-04-22",0,0,1,0,0,1,0,0
"Morocco","2024-04-23",0,0,1,0,0,1,0,0
"Morocco","2024-04-24",0,0,1,0,0,1,0,0
"Morocco","2024-04-25",0,0,1,0,0,1,0,0
"Morocco","2024-04-26",0,0,1,0,0,1,0,0
"Morocco","2024-04-27",0,0,1,0,0,1,0,0
"Morocco","2024-04-28",0,0,1,0,0,1,0,0
"Morocco","2024-04-29",0,0,1,0,0,1,0,0
"Morocco","2024-04-30",0,0,1,0,0,1,0,0
"Morocco","2024-05-01",0,0,1,0,0,1,0,0
"Morocco","2024-05-02",0,0,1,0,0,1,0,0
"Morocco","2024-05-03",0,0,1,0,0,1,0,0
"Morocco","2024-05-04",0,0,1,0,0,1,0,0
"Morocco","2024-05-05",0,0,1,0,0,1,0,0
"Morocco","2024-05-06",0,0,1,0,0,1,0,0
"Morocco","2024-05-07",0,0,1,0,0,1,0,0
"Morocco","2024-05-08",0,0,1,0,0,1,0,0
"Morocco","2024-05-09",0,0,1,0,0,1,0,0
"Morocco","2024-05-10",0,0,1,0,0,1,0,0
"Morocco","2024-05-11",0,0,1,0,0,1,0,0
"Morocco","2024-05-12",0,0,1,0,0,1,0,0
"Morocco","2024-05-13",0,0,1,0,0,1,0,0
"Morocco","2024-05-14",0,0,1,0,0,1,0,0
"Morocco","2024-05-15",0,0,1,0,0,1,0,0
"Morocco","2024-05-16",0,0,1,0,0,1,0,0
"Morocco","2024-05-17",0,0,1,0,0,1,0,0
"Morocco","2024-05-18",0,0,1,0,0,1,0,0
"Morocco","2024-05-19",0,0,1,0,0,1,0,0
"Morocco","2024-05-20",0,0,1,0,0,1,0,0
"Morocco","2024-05-21",0,0,1,0,0,1,0,0
"Morocco","2024-05-22",0,0,1,0,0,1,0,0
"Morocco","2024-05-23",0,0,1,0,0,1,0,0
"Morocco","2024-05-24",0,0,1,0,0,1,0,0
"Morocco","2024-05-25",0,0,1,0,0,1,0,0
"Morocco","2024-05-26",0,0,1,0,0,1,0,0
"Morocco","2024-05-27",0,0,1,0,0,1,0,0
"Morocco","2024-05-28",0,0,1,0,0,1,0,0
"Morocco","2024-05-29",0,0,1,0,0,1,0,0
"Morocco","2024-05-30",0,0,1,0,0,1,0,0
"Morocco","2024-05-31",0,0,1,0,0,1,0,0
"Morocco","2024-06-01",0,0,1,0,0,1,0,0
"Morocco","2024-06-02",0,0,1,0,0,1,0,0
"Morocco","2024-06-03",0,0,1,0,0,1,0,0
"Morocco","2024-06-04",0,0,1,0,0,1,0,0
"Morocco","2024-06-05",0,0,1,0,0,1,0,0
"Morocco","2024-06-06",0,0,1,0,0,1,0,0
"Morocco","2024-06-07",0,0,1,0,0,1,0,0
"Morocco","2024-06-08",0,0,1,0,0,1,0,0
"Morocco","2024-06-09",0,0,1,0,0,1,0,0
"Morocco","2024-06-10",0,0,1,0,0,1,0,0
"Morocco","2024-06-11",0,0,1,0,0,1,0,0
"Morocco","2024-06-12",0,0,1,0,0,1,0,0
"Morocco","2024-06-13",0,0,1,0,0,1,0,0
"Morocco","2024-06-14",0,0,1,0,1,2,0,0
"Morocco","2024-06-15",0,0,1,0,0,2,0,0
"Morocco","2024-06-16",0,0,1,0,0,2,0,0
"Morocco","2024-06-17",0,0,1,0,0,2,0,0
"Morocco","2024-06-18",0,0,1,0,0,2,0,0
"Morocco","2024-06-19",0,0,1,0,0,2,0,0
"Morocco","2024-06-20",0,0,1,0,0,2,0,0
"Morocco","2024-06-21",0,0,1,0,0,2,0,0
"Morocco","2024-06-22",0,0,1,0,0,2,0,0
"Morocco","2024-06-23",0,0,1,0,0,2,0,0
"Morocco","2024-06-24",0,0,1,0,0,2,0,0
"Morocco","2024-06-25",0,0,1,0,0,2,0,0
"Morocco","2024-06-26",0,0,1,0,0,2,0,0
"Morocco","2024-06-27",0,0,1,0,0,2,0,0
"Morocco","2024-06-28",0,0,1,0,0,2,0,0
"Morocco","2024-06-29",0,0,1,0,0,2,0,0
"Morocco","2024-06-30",0,0,1,0,0,2,0,0
"Morocco","2024-07-01",0,0,1,0,0,2,0,0
"Morocco","2024-07-02",0,0,1,0,0,2,0,0
"Morocco","2024-07-03",0,0,1,0,0,2,0,0
"Morocco","2024-07-04",0,0,1,0,0,2,0,0
"Morocco","2024-07-05",0,0,1,0,0,2,0,0
"Morocco","2024-07-06",0,0,1,0,0,2,0,0
"Morocco","2024-07-07",0,0,1,0,0,2,0,0
"Morocco","2024-07-08",0,0,1,0,0,2,0,0
"Morocco","2024-07-09",0,0,1,0,0,2,0,0
"Morocco","2024-07-10",0,0,1,0,0,2,0,0
"Morocco","2024-07-11",0,0,1,0,0,2,0,0
"Morocco","2024-07-12",0,0,1,0,0,2,0,0
"Morocco","2024-07-13",0,0,1,0,0,2,0,0
"Morocco","2024-07-14",0,0,1,0,0,2,0,0
"Morocco","2024-07-15",0,0,1,0,0,2,0,0
"Morocco","2024-07-16",0,0,1,0,0,2,0,0
"Morocco","2024-07-17",0,0,1,0,0,2,0,0
"Morocco","2024-07-18",0,0,1,0,0,2,0,0
"Morocco","2024-07-19",0,0,1,0,0,2,0,0
"Morocco","2024-07-20",0,0,1,0,0,2,0,0
"Morocco","2024-07-21",0,0,1,0,0,2,0,0
"Morocco","2024-07-22",0,0,1,0,0,2,0,0
"Morocco","2024-07-23",0,0,1,0,0,2,0,0
"Morocco","2024-07-24",0,0,1,0,0,2,0,0
"Morocco","2024-07-25",0,0,1,0,0,2,0,0
"Morocco","2024-07-26",0,0,1,0,0,2,0,0
"Morocco","2024-07-27",0,0,1,0,0,2,0,0
"Morocco","2024-07-28",0,0,1,0,0,2,0,0
"Morocco","2024-07-29",0,0,1,0,0,2,0,0
"Morocco","2024-07-30",0,0,1,0,0,2,0,0
"Morocco","2024-07-31",0,0,1,0,0,2,0,0
"Morocco","2024-08-01",0,0,1,0,0,2,0,0
"Morocco","2024-08-02",0,0,1,0,0,2,0,0
"Morocco","2024-08-03",0,0,1,0,0,2,0,0
"Morocco","2024-08-04",0,0,1,0,0,2,0,0
"Morocco","2024-08-05",0,0,1,0,0,2,0,0
"Morocco","2024-08-06",0,0,1,0,0,2,0,0
"Morocco","2024-08-07",0,0,1,0,0,2,0,0
"Morocco","2024-08-08",0,0,1,0,0,2,0,0
"Morocco","2024-08-09",0,0,1,0,0,2,0,0
"Morocco","2024-08-10",0,0,1,0,0,2,0,0
"Morocco","2024-08-11",0,0,1,0,0,2,0,0
"Morocco","2024-08-12",0,0,1,0,0,2,0,0
"Morocco","2024-08-13",0,0,1,0,0,2,0,0
"Morocco","2024-08-14",0,0,1,0,0,2,0,0
"Morocco","2024-08-15",0,0,1,0,0,2,0,0
"Morocco","2024-08-16",0,0,1,0,0,2,0,0
"Morocco","2024-08-17",0,0,1,0,0,2,0,0
"Morocco","2024-08-18",0,0,1,0,0,2,0,0
"Morocco","2024-08-19",0,0,1,0,0,2,0,0
"Morocco","2024-08-20",0,0,1,0,0,2,0,0
"Morocco","2024-08-21",0,0,1,0,0,2,0,0
"Morocco","2024-08-22",0,0,1,0,0,2,0,0
"Morocco","2024-08-23",0,0,1,0,0,2,0,0
"Morocco","2024-08-24",0,0,1,0,0,2,0,0
"Morocco","2024-08-25",0,0,1,0,0,2,0,0
"Morocco","2024-08-26",0,0,1,0,0,2,0,0
"Morocco","2024-08-27",0,0,1,0,0,2,0,0
"Morocco","2024-08-28",0,0,1,0,0,2,0,0
"Morocco","2024-08-29",0,0,1,0,0,2,0,0
"Morocco","2024-08-30",0,0,1,0,0,2,0,0
"Morocco","2024-08-31",0,0,1,0,0,2,0,0
"Morocco","2024-09-01",0,0,1,0,0,2,0,0
"Morocco","2024-09-02",0,0,1,0,0,2,0,0
"Morocco","2024-09-03",0,0,1,0,0,2,0,0
"Morocco","2024-09-04",0,0,1,0,0,2,0,0
"Morocco","2024-09-05",0,0,1,0,0,2,0,0
"Morocco","2024-09-06",0,0,1,0,0,2,0,0
"Morocco","2024-09-07",0,0,1,0,0,2,0,0
"Morocco","2024-09-08",0,0,1,0,0,2,0,0
"Morocco","2024-09-09",0,0,1,0,0,2,0,0
"Morocco","2024-09-10",0,0,1,0,0,2,0,0
"Morocco","2024-09-11",0,0,1,0,0,2,0,0
"Morocco","2024-09-12",0,1,2,0,0,2,0,0
"Morocco","2024-09-13",0,0,2,0,0,2,0,0
"Morocco","2024-09-14",0,0,2,0,0,2,0,0
"Morocco","2024-09-15",0,0,2,0,0,2,0,0
"Morocco","2024-09-16",0,0,2,0,0,2,0,0
"Morocco","2024-09-17",0,0,2,0,0,2,0,0
"Morocco","2024-09-18",0,0,2,0,0,2,0,0
"Morocco","2024-09-19",0,0,2,0,0,2,0,0
"Morocco","2024-09-20",0,0,2,0,0,2,0,0
"Morocco","2024-09-21",0,0,2,0,0,2,0,0
"Morocco","2024-09-22",0,0,2,0,0,2,0,0
"Morocco","2024-09-23",0,0,2,0,1,3,0,0
"Morocco","2024-09-24",0,0,2,0,0,3,0,0
"Morocco","2024-09-25",0,0,2,0,0,3,0,0
"Morocco","2024-09-26",0,0,2,0,0,3,0,0
"Morocco","2024-09-27",0,0,2,0,0,3,0,0
"Morocco","2024-09-28",0,0,2,0,0,3,0,0
"Morocco","2024-09-29",0,0,2,0,0,3,0,0
"Morocco","2024-09-30",0,0,2,0,0,3,0,0
"Morocco","2024-10-01",0,0,2,0,0,3,0,0
"Morocco","2024-10-02",0,0,2,0,0,3,0,0
"Morocco","2024-10-03",0,1,3,0,0,3,0,0
"Morocco","2024-10-04",0,0,3,0,0,3,0,0
"Morocco","2024-10-05",0,0,3,0,0,3,0,0
"Morocco","2024-10-06",0,0,3,0,0,3,0,0
"Morocco","2024-10-07",0,0,3,0,0,3,0,0
"Morocco","2024-10-08",0,0,3,0,0,3,0,0
"Morocco","2024-10-09",0,0,3,0,0,3,0,0
"Morocco","2024-10-10",0,0,3,0,0,3,0,0
"Morocco","2024-10-11",0,0,3,0,0,3,0,0
"Morocco","2024-10-12",0,0,3,0,0,3,0,0
"Morocco","2024-10-13",0,0,3,0,0,3,0,0
"Morocco","2024-10-14",0,0,3,0,0,3,0,0
"Morocco","2024-10-15",0,0,3,0,0,3,0,0
"Morocco","2024-10-16",0,0,3,0,0,3,0,0
"Morocco","2024-10-17",0,0,3,0,0,3,0,0
"Morocco","2024-10-18",0,0,3,0,0,3,0,0
"Morocco","2024-10-19",0,0,3,0,0,3,0,0
"Morocco","2024-10-20",0,0,3,0,0,3,0,0
"Morocco","2024-10-21",0,0,3,0,0,3,0,0
"Morocco","2024-10-22",0,0,3,0,0,3,0,0
"Morocco","2024-10-23",0,0,3,0,0,3,0,0
"Morocco","2024-10-24",0,0,3,0,0,3,0,0
"Morocco","2024-10-25",0,0,3,0,0,3,0,0
"Morocco","2024-10-26",0,0,3,0,0,3,0,0
"Morocco","2024-10-27",0,0,3,0,0,3,0,0
"Morocco","2024-10-28",0,0,3,0,0,3,0,0
"Morocco","2024-10-29",0,0,3,0,0,3,0,0
"Morocco","2024-10-30",0,0,3,0,0,3,0,0
"Morocco","2024-10-31",0,0,3,0,0,3,0,0
"Morocco","2024-11-01",0,0,3,0,0,3,0,0
"Morocco","2024-11-02",0,0,3,0,0,3,0,0
"Morocco","2024-11-03",0,0,3,0,0,3,0,0
"Morocco","2024-11-04",0,0,3,0,0,3,0,0
"Morocco","2024-11-05",0,0,3,0,0,3,0,0
"Morocco","2024-11-06",0,0,3,0,0,3,0,0
"Morocco","2024-11-07",0,0,3,0,0,3,0,0
"Morocco","2024-11-08",0,0,3,0,0,3,0,0
"Morocco","2024-11-09",0,0,3,0,0,3,0,0
"Morocco","2024-11-10",0,0,3,0,0,3,0,0
"Morocco","2024-11-11",0,0,3,0,0,3,0,0
"Morocco","2024-11-12",0,0,3,0,0,3,0,0
"Morocco","2024-11-13",0,0,3,0,0,3,0,0
"Morocco","2024-11-14",0,0,3,0,0,3,0,0
"Morocco","2024-11-15",0,0,3,0,0,3,0,0
"Morocco","2024-11-16",0,0,3,0,0,3,0,0
"Morocco","2024-11-17",0,0,3,0,0,3,0,0
"Morocco","2024-11-18",0,0,3,0,0,3,0,0
"Morocco","2024-11-19",0,0,3,0,0,3,0,0
"Morocco","2024-11-20",0,0,3,0,0,3,0,0
"Morocco","2024-11-21",0,0,3,0,0,3,0,0
"Morocco","2024-11-22",0,0,3,0,0,3,0,0
"Morocco","2024-11-23",0,0,3,0,0,3,0,0
"Morocco","2024-11-24",0,0,3,0,0,3,0,0
"Morocco","2024-11-25",0,0,3,0,0,3,0,0
"Morocco","2024-11-26",0,0,3,0,0,3,0,0
"Morocco","2024-11-27",0,0,3,0,0,3,0,0
"Morocco","2024-11-28",0,0,3,0,0,3,0,0
"Morocco","2024-11-29",0,0,3,0,0,3,0,0
"Morocco","2024-11-30",0,0,3,0,0,3,0,0
"Morocco","2024-12-01",0,0,3,0,0,3,0,0
"Morocco","2024-12-02",0,0,3,0,0,3,0,0
"Morocco","2024-12-03",0,0,3,0,0,3,0,0
"Morocco","2024-12-04",0,0,3,0,0,3,0,0
"Morocco","2024-12-05",0,0,3,0,0,3,0,0
"Morocco","2024-12-06",0,0,3,0,0,3,0,0
"Morocco","2024-12-07",0,0,3,0,0,3,0,0
"Morocco","2024-12-08",0,0,3,0,0,3,0,0
"Morocco","2024-12-09",0,0,3,0,0,3,0,0
"Morocco","2024-12-10",0,0,3,0,0,3,0,0
"Morocco","2024-12-11",0,0,3,0,0,3,0,0
"Morocco","2024-12-12",0,0,3,0,0,3,0,0
"Morocco","2024-12-13",0,0,3,0,0,3,0,0
"Morocco","2024-12-14",0,0,3,0,0,3,0,0
"Morocco","2024-12-15",0,0,3,0,0,3,0,0
"Morocco","2024-12-16",0,0,3,0,0,3,0,0
"Morocco","2024-12-17",0,0,3,0,0,3,0,0
"Morocco","2024-12-18",0,0,3,0,0,3,0,0
"Morocco","2024-12-19",0,0,3,0,0,3,0,0
"Morocco","2024-12-20",0,0,3,0,0,3,0,0
"Morocco","2024-12-21",0,0,3,0,0,3,0,0
"Morocco","2024-12-22",0,0,3,0,0,3,0,0
"Morocco","2024-12-23",0,0,3,0,0,3,0,0
"Morocco","2024-12-24",0,0,3,0,0,3,0,0
"Morocco","2024-12-25",0,0,3,0,0,3,0,0
"Morocco","2024-12-26",0,0,3,0,0,3,0,0
"Morocco","2024-12-27",0,0,3,0,0,3,0,0
"Morocco","2024-12-28",0,0,3,0,0,3,0,0
"Morocco","2024-12-29",0,0,3,0,0,3,0,0
"Morocco","2024-12-30",0,0,3,0,0,3,0,0
"Morocco","2024-12-31",0,0,3,0,0,3,0,0
"Morocco","2025-01-01",0,0,3,0,0,3,0,0
"Morocco","2025-01-02",0,0,3,0,0,3,0,0
"Morocco","2025-01-03",0,0,3,0,0,3,0,0
"Morocco","2025-01-04",0,0,3,0,0,3,0,0
"Morocco","2025-01-05",0,0,3,0,0,3,0,0
"Morocco","2025-01-06",0,0,3,0,0,3,0,0
"Morocco","2025-01-07",0,0,3,0,0,3,0,0
"Morocco","2025-01-08",0,0,3,0,0,3,0,0
"Morocco","2025-01-09",0,0,3,0,0,3,0,0
"Morocco","2025-01-10",0,0,3,0,0,3,0,0
"Morocco","2025-01-11",0,0,3,0,0,3,0,0
"Morocco","2025-01-12",0,0,3,0,0,3,0,0
"Morocco","2025-01-13",0,0,3,0,0,3,0,0
"Mozambique","2024-01-01",0,0,0,0,0,0,0,0
"Mozambique","2024-01-02",0,0,0,0,0,0,0,0
"Mozambique","2024-01-03",0,0,0,0,0,0,0,0
"Mozambique","2024-01-04",0,0,0,0,0,0,0,0
"Mozambique","2024-01-05",0,0,0,0,0,0,0,0
"Mozambique","2024-01-06",0,0,0,0,0,0,0,0
"Mozambique","2024-01-07",0,0,0,0,0,0,0,0
"Mozambique","2024-01-08",0,0,0,0,0,0,0,0
"Mozambique","2024-01-09",0,0,0,0,0,0,0,0
"Mozambique","2024-01-10",0,0,0,0,0,0,0,0
"Mozambique","2024-01-11",0,0,0,0,0,0,0,0
"Mozambique","2024-01-12",0,0,0,0,0,0,0,0
"Mozambique","2024-01-13",0,0,0,0,0,0,0,0
"Mozambique","2024-01-14",0,0,0,0,0,0,0,0
"Mozambique","2024-01-15",0,0,0,0,0,0,0,0
"Mozambique","2024-01-16",0,0,0,0,0,0,0,0
"Mozambique","2024-01-17",0,0,0,0,0,0,0,0
"Mozambique","2024-01-18",0,0,0,0,0,0,0,0
"Mozambique","2024-01-19",0,0,0,0,0,0,0,0
"Mozambique","2024-01-20",0,0,0,0,0,0,0,0
"Mozambique","2024-01-21",0,0,0,0,0,0,0,0
"Mozambique","2024-01-22",0,0,0,0,0,0,0,0
"Mozambique","2024-01-23",0,0,0,0,0,0,0,0
"Mozambique","2024-01-24",0,0,0,0,0,0,0,0
"Mozambique","2024-01-25",0,0,0,0,0,0,0,0
"Mozambique","2024-01-26",0,0,0,0,0,0,0,0
"Mozambique","2024-01-27",0,0,0,0,0,0,0,0
"Mozambique","2024-01-28",0,0,0,0,0,0,0,0
"Mozambique","2024-01-29",0,0,0,0,0,0,0,0
"Mozambique","2024-01-30",0,0,0,0,0,0,0,0
"Mozambique","2024-01-31",0,0,0,0,0,0,0,0
"Mozambique","2024-02-01",0,0,0,0,0,0,0,0
"Mozambique","2024-02-02",0,0,0,0,0,0,0,0
"Mozambique","2024-02-03",0,0,0,0,0,0,0,0
"Mozambique","2024-02-04",0,0,0,0,0,0,0,0
"Mozambique","2024-02-05",0,0,0,0,0,0,0,0
"Mozambique","2024-02-06",0,0,0,0,0,0,0,0
"Mozambique","2024-02-07",0,0,0,0,0,0,0,0
"Mozambique","2024-02-08",0,0,0,0,0,0,0,0
"Mozambique","2024-02-09",0,0,0,0,0,0,0,0
"Mozambique","2024-02-10",0,0,0,0,0,0,0,0
"Mozambique","2024-02-11",0,0,0,0,0,0,0,0
"Mozambique","2024-02-12",0,0,0,0,0,0,0,0
"Mozambique","2024-02-13",0,0,0,0,0,0,0,0
"Mozambique","2024-02-14",0,0,0,0,0,0,0,0
"Mozambique","2024-02-15",0,0,0,0,0,0,0,0
"Mozambique","2024-02-16",0,0,0,0,0,0,0,0
"Mozambique","2024-02-17",0,0,0,0,0,0,0,0
"Mozambique","2024-02-18",0,0,0,0,0,0,0,0
"Mozambique","2024-02-19",0,0,0,0,0,0,0,0
"Mozambique","2024-02-20",0,0,0,0,0,0,0,0
"Mozambique","2024-02-21",0,0,0,0,0,0,0,0
"Mozambique","2024-02-22",0,0,0,0,0,0,0,0
"Mozambique","2024-02-23",0,0,0,0,0,0,0,0
"Mozambique","2024-02-24",0,0,0,0,0,0,0,0
"Mozambique","2024-02-25",0,0,0,0,0,0,0,0
"Mozambique","2024-02-26",0,0,0,0,0,0,0,0
"Mozambique","2024-02-27",0,0,0,0,0,0,0,0
"Mozambique","2024-02-28",0,0,0,0,0,0,0,0
"Mozambique","2024-02-29",0,0,0,0,0,0,0,0
"Mozambique","2024-03-01",0,0,0,0,0,0,0,0
"Mozambique","2024-03-02",0,0,0,0,0,0,0,0
"Mozambique","2024-03-03",0,0,0,0,0,0,0,0
"Mozambique","2024-03-04",0,0,0,0,0,0,0,0
"Mozambique","2024-03-05",0,0,0,0,0,0,0,0
"Mozambique","2024-03-06",0,0,0,0,0,0,0,0
"Mozambique","2024-03-07",0,0,0,0,0,0,0,0
"Mozambique","2024-03-08",0,0,0,0,0,0,0,0
"Mozambique","2024-03-09",0,0,0,0,0,0,0,0
"Mozambique","2024-03-10",0,0,0,0,0,0,0,0
"Mozambique","2024-03-11",0,0,0,0,0,0,0,0
"Mozambique","2024-03-12",0,0,0,0,0,0,0,0
"Mozambique","2024-03-13",0,0,0,0,0,0,0,0
"Mozambique","2024-03-14",0,0,0,0,0,0,0,0
"Mozambique","2024-03-15",0,0,0,0,0,0,0,0
"Mozambique","2024-03-16",0,0,0,0,0,0,0,0
"Mozambique","2024-03-17",0,0,0,0,0,0,0,0
"Mozambique","2024-03-18",0,0,0,0,0,0,0,0
"Mozambique","2024-03-19",0,0,0,0,0,0,0,0
"Mozambique","2024-03-20",0,0,0,0,0,0,0,0
"Mozambique","2024-03-21",0,0,0,0,0,0,0,0
"Mozambique","2024-03-22",0,0,0,0,0,0,0,0
"Mozambique","2024-03-23",0,0,0,0,0,0,0,0
"Mozambique","2024-03-24",0,0,0,0,0,0,0,0
"Mozambique","2024-03-25",0,0,0,0,0,0,0,0
"Mozambique","2024-03-26",0,0,0,0,0,0,0,0
"Mozambique","2024-03-27",0,0,0,0,0,0,0,0
"Mozambique","2024-03-28",0,0,0,0,0,0,0,0
"Mozambique","2024-03-29",0,0,0,0,0,0,0,0
"Mozambique","2024-03-30",0,0,0,0,0,0,0,0
"Mozambique","2024-03-31",0,0,0,0,0,0,0,0
"Mozambique","2024-04-01",0,0,0,0,0,0,0,0
"Mozambique","2024-04-02",0,0,0,0,0,0,0,0
"Mozambique","2024-04-03",0,0,0,0,0,0,0,0
"Mozambique","2024-04-04",0,0,0,0,0,0,0,0
"Mozambique","2024-04-05",0,0,0,0,0,0,0,0
"Mozambique","2024-04-06",0,0,0,0,0,0,0,0
"Mozambique","2024-04-07",0,0,0,0,0,0,0,0
"Mozambique","2024-04-08",0,0,0,0,0,0,0,0
"Mozambique","2024-04-09",0,0,0,0,0,0,0,0
"Mozambique","2024-04-10",0,0,0,0,0,0,0,0
"Mozambique","2024-04-11",0,0,0,0,0,0,0,0
"Mozambique","2024-04-12",0,0,0,0,0,0,0,0
"Mozambique","2024-04-13",0,0,0,0,0,0,0,0
"Mozambique","2024-04-14",0,0,0,0,0,0,0,0
"Mozambique","2024-04-15",0,0,0,0,0,0,0,0
"Mozambique","2024-04-16",0,0,0,0,0,0,0,0
"Mozambique","2024-04-17",0,0,0,0,0,0,0,0
"Mozambique","2024-04-18",0,0,0,0,0,0,0,0
"Mozambique","2024-04-19",0,0,0,0,0,0,0,0
"Mozambique","2024-04-20",0,0,0,0,0,0,0,0
"Mozambique","2024-04-21",0,0,0,0,0,0,0,0
"Mozambique","2024-04-22",0,0,0,0,0,0,0,0
"Mozambique","2024-04-23",0,0,0,0,0,0,0,0
"Mozambique","2024-04-24",0,0,0,0,0,0,0,0
"Mozambique","2024-04-25",0,0,0,0,0,0,0,0
"Mozambique","2024-04-26",0,0,0,0,0,0,0,0
"Mozambique","2024-04-27",0,0,0,0,0,0,0,0
"Mozambique","2024-04-28",0,0,0,0,0,0,0,0
"Mozambique","2024-04-29",0,0,0,0,0,0,0,0
"Mozambique","2024-04-30",0,0,0,0,0,0,0,0
"Mozambique","2024-05-01",0,0,0,0,0,0,0,0
"Mozambique","2024-05-02",0,0,0,0,0,0,0,0
"Mozambique","2024-05-03",0,0,0,0,0,0,0,0
"Mozambique","2024-05-04",0,0,0,0,0,0,0,0
"Mozambique","2024-05-05",0,0,0,0,0,0,0,0
"Mozambique","2024-05-06",0,0,0,0,0,0,0,0
"Mozambique","2024-05-07",0,0,0,0,0,0,0,0
"Mozambique","2024-05-08",0,0,0,0,0,0,0,0
"Mozambique","2024-05-09",0,0,0,0,0,0,0,0
"Mozambique","2024-05-10",0,0,0,0,0,0,0,0
"Mozambique","2024-05-11",0,0,0,0,0,0,0,0
"Mozambique","2024-05-12",0,0,0,0,0,0,0,0
"Mozambique","2024-05-13",0,0,0,0,0,0,0,0
"Mozambique","2024-05-14",0,0,0,0,0,0,0,0
"Mozambique","2024-05-15",0,0,0,0,0,0,0,0
"Mozambique","2024-05-16",0,0,0,0,0,0,0,0
"Mozambique","2024-05-17",0,0,0,0,0,0,0,0
"Mozambique","2024-05-18",0,0,0,0,0,0,0,0
"Mozambique","2024-05-19",0,0,0,0,0,0,0,0
"Mozambique","2024-05-20",0,0,0,0,0,0,0,0
"Mozambique","2024-05-21",0,0,0,0,0,0,0,0
"Mozambique","2024-05-22",0,0,0,0,0,0,0,0
"Mozambique","2024-05-23",0,0,0,0,0,0,0,0
"Mozambique","2024-05-24",0,0,0,0,0,0,0,0
"Mozambique","2024-05-25",0,0,0,0,0,0,0,0
"Mozambique","2024-05-26",0,0,0,0,0,0,0,0
"Mozambique","2024-05-27",0,0,0,0,0,0,0,0
"Mozambique","2024-05-28",0,0,0,0,0,0,0,0
"Mozambique","2024-05-29",0,0,0,0,0,0,0,0
"Mozambique","2024-05-30",0,0,0,0,0,0,0,0
"Mozambique","2024-05-31",0,0,0,0,0,0,0,0
"Mozambique","2024-06-01",0,0,0,0,0,0,0,0
"Mozambique","2024-06-02",0,0,0,0,0,0,0,0
"Mozambique","2024-06-03",0,0,0,0,0,0,0,0
"Mozambique","2024-06-04",0,0,0,0,0,0,0,0
"Mozambique","2024-06-05",0,0,0,0,0,0,0,0
"Mozambique","2024-06-06",0,0,0,0,0,0,0,0
"Mozambique","2024-06-07",0,0,0,0,0,0,0,0
"Mozambique","2024-06-08",0,0,0,0,0,0,0,0
"Mozambique","2024-06-09",0,0,0,0,0,0,0,0
"Mozambique","2024-06-10",0,0,0,0,0,0,0,0
"Mozambique","2024-06-11",0,0,0,0,0,0,0,0
"Mozambique","2024-06-12",0,0,0,0,0,0,0,0
"Mozambique","2024-06-13",0,0,0,0,0,0,0,0
"Mozambique","2024-06-14",0,0,0,0,0,0,0,0
"Mozambique","2024-06-15",0,0,0,0,0,0,0,0
"Mozambique","2024-06-16",0,0,0,0,0,0,0,0
"Mozambique","2024-06-17",0,0,0,0,0,0,0,0
"Mozambique","2024-06-18",0,0,0,0,0,0,0,0
"Mozambique","2024-06-19",0,0,0,0,0,0,0,0
"Mozambique","2024-06-20",0,0,0,0,0,0,0,0
"Mozambique","2024-06-21",0,0,0,0,0,0,0,0
"Mozambique","2024-06-22",0,0,0,0,0,0,0,0
"Mozambique","2024-06-23",0,0,0,0,0,0,0,0
"Mozambique","2024-06-24",0,0,0,0,0,0,0,0
"Mozambique","2024-06-25",0,0,0,0,0,0,0,0
"Mozambique","2024-06-26",0,0,0,0,0,0,0,0
"Mozambique","2024-06-27",0,0,0,0,0,0,0,0
"Mozambique","2024-06-28",0,0,0,0,0,0,0,0
"Mozambique","2024-06-29",0,0,0,0,0,0,0,0
"Mozambique","2024-06-30",0,0,0,0,0,0,0,0
"Mozambique","2024-07-01",0,0,0,0,0,0,0,0
"Mozambique","2024-07-02",0,0,0,0,0,0,0,0
"Mozambique","2024-07-03",0,0,0,0,0,0,0,0
"Mozambique","2024-07-04",0,0,0,0,0,0,0,0
"Mozambique","2024-07-05",0,0,0,0,0,0,0,0
"Mozambique","2024-07-06",0,0,0,0,0,0,0,0
"Mozambique","2024-07-07",0,0,0,0,0,0,0,0
"Mozambique","2024-07-08",0,0,0,0,0,0,0,0
"Mozambique","2024-07-09",0,0,0,0,0,0,0,0
"Mozambique","2024-07-10",0,0,0,0,0,0,0,0
"Mozambique","2024-07-11",0,0,0,0,0,0,0,0
"Mozambique","2024-07-12",0,0,0,0,0,0,0,0
"Mozambique","2024-07-13",0,0,0,0,0,0,0,0
"Mozambique","2024-07-14",0,0,0,0,0,0,0,0
"Mozambique","2024-07-15",0,0,0,0,0,0,0,0
"Mozambique","2024-07-16",0,0,0,0,0,0,0,0
"Mozambique","2024-07-17",0,0,0,0,0,0,0,0
"Mozambique","2024-07-18",0,0,0,0,0,0,0,0
"Mozambique","2024-07-19",0,0,0,0,0,0,0,0
"Mozambique","2024-07-20",0,0,0,0,0,0,0,0
"Mozambique","2024-07-21",0,0,0,0,0,0,0,0
"Mozambique","2024-07-22",0,0,0,0,0,0,0,0
"Mozambique","2024-07-23",0,0,0,0,0,0,0,0
"Mozambique","2024-07-24",0,0,0,0,0,0,0,0
"Mozambique","2024-07-25",0,0,0,0,0,0,0,0
"Mozambique","2024-07-26",0,0,0,0,0,0,0,0
"Mozambique","2024-07-27",0,0,0,0,0,0,0,0
"Mozambique","2024-07-28",0,0,0,0,0,0,0,0
"Mozambique","2024-07-29",0,0,0,0,0,0,0,0
"Mozambique","2024-07-30",0,0,0,0,0,0,0,0
"Mozambique","2024-07-31",0,0,0,0,0,0,0,0
"Mozambique","2024-08-01",0,0,0,0,0,0,0,0
"Mozambique","2024-08-02",0,0,0,0,0,0,0,0
"Mozambique","2024-08-03",0,0,0,0,0,0,0,0
"Mozambique","2024-08-04",0,0,0,0,0,0,0,0
"Mozambique","2024-08-05",0,0,0,0,0,0,0,0
"Mozambique","2024-08-06",0,0,0,0,0,0,0,0
"Mozambique","2024-08-07",0,0,0,0,0,0,0,0
"Mozambique","2024-08-08",0,0,0,0,0,0,0,0
"Mozambique","2024-08-09",0,0,0,0,0,0,0,0
"Mozambique","2024-08-10",0,0,0,0,0,0,0,0
"Mozambique","2024-08-11",0,0,0,0,0,0,0,0
"Mozambique","2024-08-12",0,0,0,0,0,0,0,0
"Mozambique","2024-08-13",0,0,0,0,0,0,0,0
"Mozambique","2024-08-14",0,0,0,0,0,0,0,0
"Mozambique","2024-08-15",0,0,0,0,0,0,0,0
"Mozambique","2024-08-16",0,0,0,0,0,0,0,0
"Mozambique","2024-08-17",0,0,0,0,0,0,0,0
"Mozambique","2024-08-18",0,0,0,0,0,0,0,0
"Mozambique","2024-08-19",0,0,0,0,0,0,0,0
"Mozambique","2024-08-20",0,0,0,0,0,0,0,0
"Mozambique","2024-08-21",0,0,0,0,0,0,0,0
"Mozambique","2024-08-22",0,0,0,0,0,0,0,0
"Mozambique","2024-08-23",0,0,0,0,0,0,0,0
"Mozambique","2024-08-24",0,0,0,0,0,0,0,0
"Mozambique","2024-08-25",0,0,0,0,0,0,0,0
"Mozambique","2024-08-26",0,0,0,0,0,0,0,0
"Mozambique","2024-08-27",0,0,0,0,0,0,0,0
"Mozambique","2024-08-28",0,0,0,0,0,0,0,0
"Mozambique","2024-08-29",0,0,0,0,0,0,0,0
"Mozambique","2024-08-30",0,0,0,0,0,0,0,0
"Mozambique","2024-08-31",0,0,0,0,0,0,0,0
"Mozambique","2024-09-01",0,0,0,0,0,0,0,0
"Mozambique","2024-09-02",0,0,0,0,0,0,0,0
"Mozambique","2024-09-03",0,0,0,0,0,0,0,0
"Mozambique","2024-09-04",0,0,0,0,0,0,0,0
"Mozambique","2024-09-05",0,0,0,0,0,0,0,0
"Mozambique","2024-09-06",0,0,0,0,0,0,0,0
"Mozambique","2024-09-07",0,0,0,0,0,0,0,0
"Mozambique","2024-09-08",0,0,0,0,0,0,0,0
"Mozambique","2024-09-09",0,0,0,0,0,0,0,0
"Mozambique","2024-09-10",0,0,0,0,0,0,0,0
"Mozambique","2024-09-11",0,0,0,0,0,0,0,0
"Mozambique","2024-09-12",0,0,0,0,0,0,0,0
"Mozambique","2024-09-13",0,0,0,0,0,0,0,0
"Mozambique","2024-09-14",0,0,0,0,0,0,0,0
"Mozambique","2024-09-15",0,0,0,0,0,0,0,0
"Mozambique","2024-09-16",0,0,0,0,0,0,0,0
"Mozambique","2024-09-17",0,0,0,0,0,0,0,0
"Mozambique","2024-09-18",0,0,0,0,0,0,0,0
"Mozambique","2024-09-19",0,0,0,0,0,0,0,0
"Mozambique","2024-09-20",0,0,0,0,0,0,0,0
"Mozambique","2024-09-21",0,0,0,0,0,0,0,0
"Mozambique","2024-09-22",0,0,0,0,0,0,0,0
"Mozambique","2024-09-23",0,0,0,0,0,0,0,0
"Mozambique","2024-09-24",0,0,0,0,0,0,0,0
"Mozambique","2024-09-25",0,0,0,0,0,0,0,0
"Mozambique","2024-09-26",0,0,0,0,0,0,0,0
"Mozambique","2024-09-27",0,0,0,0,0,0,0,0
"Mozambique","2024-09-28",0,0,0,0,0,0,0,0
"Mozambique","2024-09-29",0,0,0,0,0,0,0,0
"Mozambique","2024-09-30",0,0,0,0,0,0,0,0
"Mozambique","2024-10-01",0,0,0,0,0,0,0,0
"Mozambique","2024-10-02",0,0,0,0,0,0,0,0
"Mozambique","2024-10-03",0,0,0,0,0,0,0,0
"Mozambique","2024-10-04",0,0,0,0,0,0,0,0
"Mozambique","2024-10-05",0,0,0,0,0,0,0,0
"Mozambique","2024-10-06",0,0,0,0,0,0,0,0
"Mozambique","2024-10-07",0,0,0,0,0,0,0,0
"Mozambique","2024-10-08",0,0,0,0,0,0,0,0
"Mozambique","2024-10-09",0,0,0,0,0,0,0,0
"Mozambique","2024-10-10",0,0,0,0,0,0,0,0
"Mozambique","2024-10-11",0,0,0,0,0,0,0,0
"Mozambique","2024-10-12",0,0,0,0,0,0,0,0
"Mozambique","2024-10-13",0,0,0,0,0,0,0,0
"Mozambique","2024-10-14",0,0,0,0,0,0,0,0
"Mozambique","2024-10-15",0,0,0,0,0,0,0,0
"Mozambique","2024-10-16",0,0,0,0,0,0,0,0
"Mozambique","2024-10-17",0,0,0,0,0,0,0,0
"Mozambique","2024-10-18",0,0,0,0,0,0,0,0
"Mozambique","2024-10-19",0,0,0,0,0,0,0,0
"Mozambique","2024-10-20",0,0,0,0,0,0,0,0
"Mozambique","2024-10-21",0,0,0,0,0,0,0,0
"Mozambique","2024-10-22",0,0,0,0,0,0,0,0
"Mozambique","2024-10-23",0,0,0,0,0,0,0,0
"Mozambique","2024-10-24",0,0,0,0,0,0,0,0
"Mozambique","2024-10-25",0,0,0,0,0,0,0,0
"Mozambique","2024-10-26",0,0,0,0,0,0,0,0
"Mozambique","2024-10-27",0,0,0,0,0,0,0,0
"Mozambique","2024-10-28",0,0,0,0,0,0,0,0
"Mozambique","2024-10-29",0,0,0,0,0,0,0,0
"Mozambique","2024-10-30",0,0,0,0,0,0,0,0
"Mozambique","2024-10-31",0,0,0,0,0,0,0,0
"Mozambique","2024-11-01",0,0,0,0,0,0,0,0
"Mozambique","2024-11-02",0,0,0,0,0,0,0,0
"Mozambique","2024-11-03",0,0,0,0,0,0,0,0
"Mozambique","2024-11-04",0,0,0,0,0,0,0,0
"Mozambique","2024-11-05",0,0,0,0,0,0,0,0
"Mozambique","2024-11-06",0,0,0,0,0,0,0,0
"Mozambique","2024-11-07",0,0,0,0,0,0,0,0
"Mozambique","2024-11-08",0,0,0,0,0,0,0,0
"Mozambique","2024-11-09",0,0,0,0,0,0,0,0
"Mozambique","2024-11-10",0,0,0,0,0,0,0,0
"Mozambique","2024-11-11",0,0,0,0,0,0,0,0
"Mozambique","2024-11-12",0,0,0,0,0,0,0,0
"Mozambique","2024-11-13",0,0,0,0,0,0,0,0
"Mozambique","2024-11-14",0,0,0,0,0,0,0,0
"Mozambique","2024-11-15",0,0,0,0,0,0,0,0
"Mozambique","2024-11-16",0,0,0,0,0,0,0,0
"Mozambique","2024-11-17",0,0,0,0,0,0,0,0
"Mozambique","2024-11-18",0,0,0,0,0,0,0,0
"Mozambique","2024-11-19",0,0,0,0,0,0,0,0
"Mozambique","2024-11-20",0,0,0,0,0,0,0,0
"Mozambique","2024-11-21",0,0,0,0,0,0,0,0
"Mozambique","2024-11-22",0,0,0,0,0,0,0,0
"Mozambique","2024-11-23",0,0,0,0,0,0,0,0
"Mozambique","2024-11-24",0,0,0,0,0,0,0,0
"Mozambique","2024-11-25",0,0,0,0,0,0,0,0
"Mozambique","2024-11-26",0,0,0,0,0,0,0,0
"Mozambique","2024-11-27",0,0,0,0,0,0,0,0
"Mozambique","2024-11-28",0,0,0,0,0,0,0,0
"Mozambique","2024-11-29",0,0,0,0,0,0,0,0
"Mozambique","2024-11-30",0,0,0,0,0,0,0,0
"Mozambique","2024-12-01",0,0,0,0,0,0,0,0
"Mozambique","2024-12-02",0,0,0,0,0,0,0,0
"Mozambique","2024-12-03",0,0,0,0,0,0,0,0
"Mozambique","2024-12-04",0,0,0,0,0,0,0,0
"Mozambique","2024-12-05",0,0,0,0,0,0,0,0
"Mozambique","2024-12-06",0,0,0,0,0,0,0,0
"Mozambique","2024-12-07",0,0,0,0,0,0,0,0
"Mozambique","2024-12-08",0,0,0,0,0,0,0,0
"Mozambique","2024-12-09",0,0,0,0,0,0,0,0
"Mozambique","2024-12-10",0,0,0,0,0,0,0,0
"Mozambique","2024-12-11",0,0,0,0,0,0,0,0
"Mozambique","2024-12-12",0,0,0,0,0,0,0,0
"Mozambique","2024-12-13",0,0,0,0,0,0,0,0
"Mozambique","2024-12-14",0,0,0,0,0,0,0,0
"Mozambique","2024-12-15",0,0,0,0,0,0,0,0
"Mozambique","2024-12-16",0,0,0,0,0,0,0,0
"Mozambique","2024-12-17",0,0,0,0,0,0,0,0
"Mozambique","2024-12-18",0,0,0,0,0,0,0,0
"Mozambique","2024-12-19",0,0,0,0,0,0,0,0
"Mozambique","2024-12-20",0,0,0,0,0,0,0,0
"Mozambique","2024-12-21",0,0,0,0,0,0,0,0
"Mozambique","2024-12-22",0,0,0,0,0,0,0,0
"Mozambique","2024-12-23",0,0,0,0,0,0,0,0
"Mozambique","2024-12-24",0,0,0,0,0,0,0,0
"Mozambique","2024-12-25",0,0,0,0,0,0,0,0
"Mozambique","2024-12-26",0,0,0,0,0,0,0,0
"Mozambique","2024-12-27",0,0,0,0,0,0,0,0
"Mozambique","2024-12-28",0,0,0,0,0,0,0,0
"Mozambique","2024-12-29",0,0,0,0,0,0,0,0
"Mozambique","2024-12-30",0,0,0,0,0,0,0,0
"Mozambique","2024-12-31",0,0,0,0,0,0,0,0
"Mozambique","2025-01-01",0,0,0,0,0,0,0,0
"Mozambique","2025-01-02",0,0,0,0,0,0,0,0
"Mozambique","2025-01-03",0,0,0,0,0,0,0,0
"Mozambique","2025-01-04",0,0,0,0,0,0,0,0
"Mozambique","2025-01-05",0,0,0,0,0,0,0,0
"Mozambique","2025-01-06",0,0,0,0,0,0,0,0
"Mozambique","2025-01-07",0,0,0,0,0,0,0,0
"Mozambique","2025-01-08",0,0,0,0,0,0,0,0
"Mozambique","2025-01-09",0,0,0,0,0,0,0,0
"Mozambique","2025-01-10",0,0,0,0,0,0,0,0
"Mozambique","2025-01-11",0,0,0,0,0,0,0,0
"Mozambique","2025-01-12",0,0,0,0,0,0,0,0
"Mozambique","2025-01-13",0,0,0,0,0,0,0,0
"Nepal","2024-01-01",0,0,0,0,0,0,0,0
"Nepal","2024-01-02",0,0,0,0,0,0,0,0
"Nepal","2024-01-03",0,0,0,0,0,0,0,0
"Nepal","2024-01-04",0,0,0,0,0,0,0,0
"Nepal","2024-01-05",0,0,0,0,0,0,0,0
"Nepal","2024-01-06",0,0,0,0,0,0,0,0
"Nepal","2024-01-07",0,0,0,0,0,0,0,0
"Nepal","2024-01-08",0,0,0,0,0,0,0,0
"Nepal","2024-01-09",0,0,0,0,0,0,0,0
"Nepal","2024-01-10",0,0,0,0,0,0,0,0
"Nepal","2024-01-11",0,0,0,0,0,0,0,0
"Nepal","2024-01-12",0,0,0,0,0,0,0,0
"Nepal","2024-01-13",0,0,0,0,0,0,0,0
"Nepal","2024-01-14",0,0,0,0,0,0,0,0
"Nepal","2024-01-15",0,0,0,0,0,0,0,0
"Nepal","2024-01-16",0,0,0,0,0,0,0,0
"Nepal","2024-01-17",0,0,0,0,0,0,0,0
"Nepal","2024-01-18",0,0,0,0,0,0,0,0
"Nepal","2024-01-19",0,0,0,0,0,0,0,0
"Nepal","2024-01-20",0,0,0,0,0,0,0,0
"Nepal","2024-01-21",0,0,0,0,0,0,0,0
"Nepal","2024-01-22",0,0,0,0,0,0,0,0
"Nepal","2024-01-23",0,0,0,0,0,0,0,0
"Nepal","2024-01-24",0,0,0,0,0,0,0,0
"Nepal","2024-01-25",0,0,0,0,0,0,0,0
"Nepal","2024-01-26",0,0,0,0,0,0,0,0
"Nepal","2024-01-27",0,0,0,0,0,0,0,0
"Nepal","2024-01-28",0,0,0,0,0,0,0,0
"Nepal","2024-01-29",0,0,0,0,0,0,0,0
"Nepal","2024-01-30",0,0,0,0,0,0,0,0
"Nepal","2024-01-31",0,0,0,0,0,0,0,0
"Nepal","2024-02-01",0,0,0,0,0,0,0,0
"Nepal","2024-02-02",0,0,0,0,0,0,0,0
"Nepal","2024-02-03",0,0,0,0,0,0,0,0
"Nepal","2024-02-04",0,0,0,0,0,0,0,0
"Nepal","2024-02-05",0,0,0,0,0,0,0,0
"Nepal","2024-02-06",0,0,0,0,0,0,0,0
"Nepal","2024-02-07",0,0,0,0,0,0,0,0
"Nepal","2024-02-08",0,0,0,0,0,0,0,0
"Nepal","2024-02-09",0,0,0,0,0,0,0,0
"Nepal","2024-02-10",0,0,0,0,0,0,0,0
"Nepal","2024-02-11",0,0,0,0,0,0,0,0
"Nepal","2024-02-12",0,0,0,0,0,0,0,0
"Nepal","2024-02-13",0,0,0,0,0,0,0,0
"Nepal","2024-02-14",0,0,0,0,0,0,0,0
"Nepal","2024-02-15",0,0,0,0,0,0,0,0
"Nepal","2024-02-16",0,0,0,0,0,0,0,0
"Nepal","2024-02-17",0,0,0,0,0,0,0,0
"Nepal","2024-02-18",0,0,0,0,0,0,0,0
"Nepal","2024-02-19",0,0,0,0,0,0,0,0
"Nepal","2024-02-20",0,0,0,0,0,0,0,0
"Nepal","2024-02-21",0,0,0,0,0,0,0,0
"Nepal","2024-02-22",0,0,0,0,0,0,0,0
"Nepal","2024-02-23",0,0,0,0,0,0,0,0
"Nepal","2024-02-24",0,0,0,0,0,0,0,0
"Nepal","2024-02-25",0,0,0,0,0,0,0,0
"Nepal","2024-02-26",0,0,0,0,0,0,0,0
"Nepal","2024-02-27",0,0,0,0,0,0,0,0
"Nepal","2024-02-28",0,0,0,0,0,0,0,0
"Nepal","2024-02-29",0,0,0,0,0,0,0,0
"Nepal","2024-03-01",0,0,0,0,0,0,0,0
"Nepal","2024-03-02",0,0,0,0,0,0,0,0
"Nepal","2024-03-03",0,0,0,0,0,0,0,0
"Nepal","2024-03-04",0,0,0,0,0,0,0,0
"Nepal","2024-03-05",0,0,0,0,0,0,0,0
"Nepal","2024-03-06",0,0,0,0,0,0,0,0
"Nepal","2024-03-07",0,0,0,0,0,0,0,0
"Nepal","2024-03-08",0,0,0,0,0,0,0,0
"Nepal","2024-03-09",0,0,0,0,0,0,0,0
"Nepal","2024-03-10",0,0,0,0,0,0,0,0
"Nepal","2024-03-11",0,0,0,0,0,0,0,0
"Nepal","2024-03-12",0,0,0,0,0,0,0,0
"Nepal","2024-03-13",0,0,0,0,0,0,0,0
"Nepal","2024-03-14",0,0,0,0,0,0,0,0
"Nepal","2024-03-15",0,0,0,0,0,0,0,0
"Nepal","2024-03-16",0,0,0,0,0,0,0,0
"Nepal","2024-03-17",0,0,0,0,0,0,0,0
"Nepal","2024-03-18",0,0,0,0,0,0,0,0
"Nepal","2024-03-19",0,0,0,0,0,0,0,0
"Nepal","2024-03-20",0,0,0,0,0,0,0,0
"Nepal","2024-03-21",0,0,0,0,0,0,0,0
"Nepal","2024-03-22",0,0,0,0,0,0,0,0
"Nepal","2024-03-23",0,0,0,0,0,0,0,0
"Nepal","2024-03-24",0,0,0,0,0,0,0,0
"Nepal","2024-03-25",0,0,0,0,0,0,0,0
"Nepal","2024-03-26",0,0,0,0,0,0,0,0
"Nepal","2024-03-27",0,0,0,0,0,0,0,0
"Nepal","2024-03-28",0,0,0,0,0,0,0,0
"Nepal","2024-03-29",0,0,0,0,0,0,0,0
"Nepal","2024-03-30",0,0,0,0,0,0,0,0
"Nepal","2024-03-31",0,0,0,0,0,0,0,0
"Nepal","2024-04-01",0,0,0,0,0,0,0,0
"Nepal","2024-04-02",0,0,0,0,0,0,0,0
"Nepal","2024-04-03",0,0,0,0,0,0,0,0
"Nepal","2024-04-04",0,0,0,0,0,0,0,0
"Nepal","2024-04-05",0,0,0,0,0,0,0,0
"Nepal","2024-04-06",0,0,0,0,0,0,0,0
"Nepal","2024-04-07",0,0,0,0,0,0,0,0
"Nepal","2024-04-08",0,0,0,0,0,0,0,0
"Nepal","2024-04-09",0,0,0,0,0,0,0,0
"Nepal","2024-04-10",0,0,0,0,0,0,0,0
"Nepal","2024-04-11",0,0,0,0,0,0,0,0
"Nepal","2024-04-12",0,0,0,0,0,0,0,0
"Nepal","2024-04-13",0,0,0,0,0,0,0,0
"Nepal","2024-04-14",0,0,0,0,0,0,0,0
"Nepal","2024-04-15",0,0,0,0,0,0,0,0
"Nepal","2024-04-16",0,0,0,0,0,0,0,0
"Nepal","2024-04-17",0,0,0,0,0,0,0,0
"Nepal","2024-04-18",0,0,0,0,0,0,0,0
"Nepal","2024-04-19",0,0,0,0,0,0,0,0
"Nepal","2024-04-20",0,0,0,0,0,0,0,0
"Nepal","2024-04-21",0,0,0,0,0,0,0,0
"Nepal","2024-04-22",0,0,0,0,0,0,0,0
"Nepal","2024-04-23",0,0,0,0,0,0,0,0
"Nepal","2024-04-24",0,0,0,0,0,0,0,0
"Nepal","2024-04-25",0,0,0,0,0,0,0,0
"Nepal","2024-04-26",0,0,0,0,0,0,0,0
"Nepal","2024-04-27",0,0,0,0,0,0,0,0
"Nepal","2024-04-28",0,0,0,0,0,0,0,0
"Nepal","2024-04-29",0,0,0,0,0,0,0,0
"Nepal","2024-04-30",0,0,0,0,0,0,0,0
"Nepal","2024-05-01",0,0,0,0,0,0,0,0
"Nepal","2024-05-02",0,0,0,0,0,0,0,0
"Nepal","2024-05-03",0,0,0,0,0,0,0,0
"Nepal","2024-05-04",0,0,0,0,0,0,0,0
"Nepal","2024-05-05",0,0,0,0,0,0,0,0
"Nepal","2024-05-06",0,0,0,0,0,0,0,0
"Nepal","2024-05-07",0,0,0,0,0,0,0,0
"Nepal","2024-05-08",0,0,0,0,0,0,0,0
"Nepal","2024-05-09",0,0,0,0,0,0,0,0
"Nepal","2024-05-10",0,0,0,0,0,0,0,0
"Nepal","2024-05-11",0,0,0,0,0,0,0,0
"Nepal","2024-05-12",0,0,0,0,0,0,0,0
"Nepal","2024-05-13",0,0,0,0,0,0,0,0
"Nepal","2024-05-14",0,0,0,0,0,0,0,0
"Nepal","2024-05-15",0,0,0,0,0,0,0,0
"Nepal","2024-05-16",0,0,0,0,0,0,0,0
"Nepal","2024-05-17",0,0,0,0,0,0,0,0
"Nepal","2024-05-18",0,0,0,0,0,0,0,0
"Nepal","2024-05-19",0,0,0,0,0,0,0,0
"Nepal","2024-05-20",0,0,0,0,0,0,0,0
"Nepal","2024-05-21",0,0,0,0,0,0,0,0
"Nepal","2024-05-22",0,0,0,0,0,0,0,0
"Nepal","2024-05-23",0,0,0,0,0,0,0,0
"Nepal","2024-05-24",0,0,0,0,0,0,0,0
"Nepal","2024-05-25",0,0,0,0,0,0,0,0
"Nepal","2024-05-26",0,0,0,0,0,0,0,0
"Nepal","2024-05-27",0,0,0,0,0,0,0,0
"Nepal","2024-05-28",0,0,0,0,0,0,0,0
"Nepal","2024-05-29",0,0,0,0,0,0,0,0
"Nepal","2024-05-30",0,0,0,0,0,0,0,0
"Nepal","2024-05-31",0,0,0,0,0,0,0,0
"Nepal","2024-06-01",0,0,0,0,0,0,0,0
"Nepal","2024-06-02",0,0,0,0,0,0,0,0
"Nepal","2024-06-03",0,0,0,0,0,0,0,0
"Nepal","2024-06-04",0,0,0,0,0,0,0,0
"Nepal","2024-06-05",0,0,0,0,0,0,0,0
"Nepal","2024-06-06",0,0,0,0,0,0,0,0
"Nepal","2024-06-07",0,0,0,0,0,0,0,0
"Nepal","2024-06-08",0,0,0,0,0,0,0,0
"Nepal","2024-06-09",0,0,0,0,0,0,0,0
"Nepal","2024-06-10",0,0,0,0,0,0,0,0
"Nepal","2024-06-11",0,0,0,0,0,0,0,0
"Nepal","2024-06-12",0,0,0,0,0,0,0,0
"Nepal","2024-06-13",0,0,0,0,0,0,0,0
"Nepal","2024-06-14",0,0,0,0,0,0,0,0
"Nepal","2024-06-15",0,0,0,0,0,0,0,0
"Nepal","2024-06-16",0,0,0,0,0,0,0,0
"Nepal","2024-06-17",0,0,0,0,0,0,0,0
"Nepal","2024-06-18",0,0,0,0,0,0,0,0
"Nepal","2024-06-19",0,0,0,0,0,0,0,0
"Nepal","2024-06-20",0,0,0,0,0,0,0,0
"Nepal","2024-06-21",0,0,0,0,0,0,0,0
"Nepal","2024-06-22",0,0,0,0,0,0,0,0
"Nepal","2024-06-23",0,0,0,0,0,0,0,0
"Nepal","2024-06-24",0,0,0,0,0,0,0,0
"Nepal","2024-06-25",0,0,0,0,0,0,0,0
"Nepal","2024-06-26",0,0,0,0,0,0,0,0
"Nepal","2024-06-27",0,0,0,0,0,0,0,0
"Nepal","2024-06-28",0,0,0,0,0,0,0,0
"Nepal","2024-06-29",0,0,0,0,0,0,0,0
"Nepal","2024-06-30",0,0,0,0,0,0,0,0
"Nepal","2024-07-01",0,0,0,0,0,0,0,0
"Nepal","2024-07-02",0,0,0,0,0,0,0,0
"Nepal","2024-07-03",0,0,0,0,0,0,0,0
"Nepal","2024-07-04",0,0,0,0,0,0,0,0
"Nepal","2024-07-05",0,0,0,0,0,0,0,0
"Nepal","2024-07-06",0,0,0,0,0,0,0,0
"Nepal","2024-07-07",0,0,0,0,0,0,0,0
"Nepal","2024-07-08",0,0,0,0,0,0,0,0
"Nepal","2024-07-09",0,0,0,0,0,0,0,0
"Nepal","2024-07-10",0,0,0,0,0,0,0,0
"Nepal","2024-07-11",0,0,0,0,0,0,0,0
"Nepal","2024-07-12",0,0,0,0,0,0,0,0
"Nepal","2024-07-13",0,0,0,0,0,0,0,0
"Nepal","2024-07-14",0,0,0,0,0,0,0,0
"Nepal","2024-07-15",0,0,0,0,0,0,0,0
"Nepal","2024-07-16",0,0,0,0,0,0,0,0
"Nepal","2024-07-17",0,0,0,0,0,0,0,0
"Nepal","2024-07-18",0,0,0,0,0,0,0,0
"Nepal","2024-07-19",0,0,0,0,0,0,0,0
"Nepal","2024-07-20",0,0,0,0,0,0,0,0
"Nepal","2024-07-21",0,0,0,0,0,0,0,0
"Nepal","2024-07-22",0,0,0,0,0,0,0,0
"Nepal","2024-07-23",0,0,0,0,0,0,0,0
"Nepal","2024-07-24",0,0,0,0,0,0,0,0
"Nepal","2024-07-25",0,0,0,0,0,0,0,0
"Nepal","2024-07-26",0,0,0,0,0,0,0,0
"Nepal","2024-07-27",0,0,0,0,0,0,0,0
"Nepal","2024-07-28",0,0,0,0,0,0,0,0
"Nepal","2024-07-29",0,0,0,0,0,0,0,0
"Nepal","2024-07-30",0,0,0,0,0,0,0,0
"Nepal","2024-07-31",0,0,0,0,0,0,0,0
"Nepal","2024-08-01",0,0,0,0,0,0,0,0
"Nepal","2024-08-02",0,0,0,0,0,0,0,0
"Nepal","2024-08-03",0,0,0,0,0,0,0,0
"Nepal","2024-08-04",0,0,0,0,0,0,0,0
"Nepal","2024-08-05",0,0,0,0,0,0,0,0
"Nepal","2024-08-06",0,0,0,0,0,0,0,0
"Nepal","2024-08-07",0,0,0,0,0,0,0,0
"Nepal","2024-08-08",0,0,0,0,0,0,0,0
"Nepal","2024-08-09",0,0,0,0,0,0,0,0
"Nepal","2024-08-10",0,0,0,0,0,0,0,0
"Nepal","2024-08-11",0,0,0,0,0,0,0,0
"Nepal","2024-08-12",0,0,0,0,0,0,0,0
"Nepal","2024-08-13",0,0,0,0,0,0,0,0
"Nepal","2024-08-14",0,0,0,0,0,0,0,0
"Nepal","2024-08-15",0,0,0,0,0,0,0,0
"Nepal","2024-08-16",0,0,0,0,0,0,0,0
"Nepal","2024-08-17",0,0,0,0,0,0,0,0
"Nepal","2024-08-18",0,0,0,0,0,0,0,0
"Nepal","2024-08-19",0,0,0,0,0,0,0,0
"Nepal","2024-08-20",0,0,0,0,0,0,0,0
"Nepal","2024-08-21",0,0,0,0,0,0,0,0
"Nepal","2024-08-22",0,0,0,0,0,0,0,0
"Nepal","2024-08-23",0,0,0,0,0,0,0,0
"Nepal","2024-08-24",0,0,0,0,0,0,0,0
"Nepal","2024-08-25",0,0,0,0,0,0,0,0
"Nepal","2024-08-26",0,0,0,0,0,0,0,0
"Nepal","2024-08-27",0,0,0,0,0,0,0,0
"Nepal","2024-08-28",0,0,0,0,0,0,0,0
"Nepal","2024-08-29",0,0,0,0,0,0,0,0
"Nepal","2024-08-30",0,0,0,0,0,0,0,0
"Nepal","2024-08-31",0,0,0,0,0,0,0,0
"Nepal","2024-09-01",0,0,0,0,0,0,0,0
"Nepal","2024-09-02",0,0,0,0,0,0,0,0
"Nepal","2024-09-03",0,0,0,0,0,0,0,0
"Nepal","2024-09-04",0,0,0,0,0,0,0,0
"Nepal","2024-09-05",0,0,0,0,0,0,0,0
"Nepal","2024-09-06",0,0,0,0,0,0,0,0
"Nepal","2024-09-07",0,0,0,0,0,0,0,0
"Nepal","2024-09-08",0,0,0,0,0,0,0,0
"Nepal","2024-09-09",0,0,0,0,0,0,0,0
"Nepal","2024-09-10",0,0,0,0,0,0,0,0
"Nepal","2024-09-11",0,0,0,0,0,0,0,0
"Nepal","2024-09-12",0,0,0,0,0,0,0,0
"Nepal","2024-09-13",0,0,0,0,0,0,0,0
"Nepal","2024-09-14",0,0,0,0,0,0,0,0
"Nepal","2024-09-15",0,0,0,0,0,0,0,0
"Nepal","2024-09-16",0,0,0,0,0,0,0,0
"Nepal","2024-09-17",0,0,0,0,0,0,0,0
"Nepal","2024-09-18",0,0,0,0,0,0,0,0
"Nepal","2024-09-19",0,0,0,0,0,0,0,0
"Nepal","2024-09-20",0,0,0,0,0,0,0,0
"Nepal","2024-09-21",0,0,0,0,0,0,0,0
"Nepal","2024-09-22",0,0,0,0,0,0,0,0
"Nepal","2024-09-23",0,0,0,0,0,0,0,0
"Nepal","2024-09-24",0,0,0,0,0,0,0,0
"Nepal","2024-09-25",0,0,0,0,0,0,0,0
"Nepal","2024-09-26",0,0,0,0,0,0,0,0
"Nepal","2024-09-27",0,0,0,0,0,0,0,0
"Nepal","2024-09-28",0,0,0,0,0,0,0,0
"Nepal","2024-09-29",0,0,0,0,0,0,0,0
"Nepal","2024-09-30",0,0,0,0,0,0,0,0
"Nepal","2024-10-01",0,0,0,0,0,0,0,0
"Nepal","2024-10-02",0,0,0,0,0,0,0,0
"Nepal","2024-10-03",0,0,0,0,0,0,0,0
"Nepal","2024-10-04",0,0,0,0,0,0,0,0
"Nepal","2024-10-05",0,0,0,0,0,0,0,0
"Nepal","2024-10-06",0,0,0,0,0,0,0,0
"Nepal","2024-10-07",0,0,0,0,0,0,0,0
"Nepal","2024-10-08",0,0,0,0,0,0,0,0
"Nepal","2024-10-09",0,0,0,0,0,0,0,0
"Nepal","2024-10-10",0,0,0,0,0,0,0,0
"Nepal","2024-10-11",0,0,0,0,0,0,0,0
"Nepal","2024-10-12",0,0,0,0,0,0,0,0
"Nepal","2024-10-13",0,0,0,0,0,0,0,0
"Nepal","2024-10-14",0,0,0,0,0,0,0,0
"Nepal","2024-10-15",0,0,0,0,0,0,0,0
"Nepal","2024-10-16",0,0,0,0,0,0,0,0
"Nepal","2024-10-17",0,0,0,0,0,0,0,0
"Nepal","2024-10-18",0,0,0,0,0,0,0,0
"Nepal","2024-10-19",0,0,0,0,0,0,0,0
"Nepal","2024-10-20",0,0,0,0,0,0,0,0
"Nepal","2024-10-21",0,0,0,0,0,0,0,0
"Nepal","2024-10-22",0,0,0,0,0,0,0,0
"Nepal","2024-10-23",0,0,0,0,0,0,0,0
"Nepal","2024-10-24",0,0,0,0,0,0,0,0
"Nepal","2024-10-25",0,0,0,0,0,0,0,0
"Nepal","2024-10-26",0,0,0,0,0,0,0,0
"Nepal","2024-10-27",0,0,0,0,0,0,0,0
"Nepal","2024-10-28",0,0,0,0,0,0,0,0
"Nepal","2024-10-29",0,0,0,0,0,0,0,0
"Nepal","2024-10-30",0,0,0,0,0,0,0,0
"Nepal","2024-10-31",0,0,0,0,0,0,0,0
"Nepal","2024-11-01",0,0,0,0,0,0,0,0
"Nepal","2024-11-02",0,0,0,0,0,0,0,0
"Nepal","2024-11-03",0,0,0,0,0,0,0,0
"Nepal","2024-11-04",0,0,0,0,0,0,0,0
"Nepal","2024-11-05",0,0,0,0,0,0,0,0
"Nepal","2024-11-06",0,0,0,0,0,0,0,0
"Nepal","2024-11-07",0,0,0,0,0,0,0,0
"Nepal","2024-11-08",0,0,0,0,0,0,0,0
"Nepal","2024-11-09",0,0,0,0,0,0,0,0
"Nepal","2024-11-10",0,0,0,0,0,0,0,0
"Nepal","2024-11-11",0,0,0,0,0,0,0,0
"Nepal","2024-11-12",0,0,0,0,0,0,0,0
"Nepal","2024-11-13",0,0,0,0,0,0,0,0
"Nepal","2024-11-14",0,0,0,0,0,0,0,0
"Nepal","2024-11-15",0,0,0,0,0,0,0,0
"Nepal","2024-11-16",0,0,0,0,0,0,0,0
"Nepal","2024-11-17",0,0,0,0,0,0,0,0
"Nepal","2024-11-18",0,0,0,0,0,0,0,0
"Nepal","2024-11-19",0,0,0,0,0,0,0,0
"Nepal","2024-11-20",0,0,0,0,0,0,0,0
"Nepal","2024-11-21",0,0,0,0,0,0,0,0
"Nepal","2024-11-22",0,0,0,0,0,0,0,0
"Nepal","2024-11-23",0,0,0,0,0,0,0,0
"Nepal","2024-11-24",0,0,0,0,0,0,0,0
"Nepal","2024-11-25",0,0,0,0,0,0,0,0
"Nepal","2024-11-26",0,0,0,0,0,0,0,0
"Nepal","2024-11-27",0,0,0,0,0,0,0,0
"Nepal","2024-11-28",0,0,0,0,0,0,0,0
"Nepal","2024-11-29",0,0,0,0,0,0,0,0
"Nepal","2024-11-30",0,0,0,0,0,0,0,0
"Nepal","2024-12-01",0,0,0,0,0,0,0,0
"Nepal","2024-12-02",0,0,0,0,0,0,0,0
"Nepal","2024-12-03",0,0,0,0,0,0,0,0
"Nepal","2024-12-04",0,0,0,0,0,0,0,0
"Nepal","2024-12-05",0,0,0,0,0,0,0,0
"Nepal","2024-12-06",0,0,0,0,0,0,0,0
"Nepal","2024-12-07",0,0,0,0,0,0,0,0
"Nepal","2024-12-08",0,0,0,0,0,0,0,0
"Nepal","2024-12-09",0,0,0,0,0,0,0,0
"Nepal","2024-12-10",0,0,0,0,0,0,0,0
"Nepal","2024-12-11",0,0,0,0,0,0,0,0
"Nepal","2024-12-12",0,0,0,0,0,0,0,0
"Nepal","2024-12-13",0,0,0,0,0,0,0,0
"Nepal","2024-12-14",0,0,0,0,0,0,0,0
"Nepal","2024-12-15",0,0,0,0,0,0,0,0
"Nepal","2024-12-16",0,0,0,0,0,0,0,0
"Nepal","2024-12-17",0,0,0,0,0,0,0,0
"Nepal","2024-12-18",0,0,0,0,0,0,0,0
"Nepal","2024-12-19",0,0,0,0,0,0,0,0
"Nepal","2024-12-20",0,0,0,0,0,0,0,0
"Nepal","2024-12-21",0,0,0,0,0,0,0,0
"Nepal","2024-12-22",0,0,0,0,0,0,0,0
"Nepal","2024-12-23",0,0,0,0,0,0,0,0
"Nepal","2024-12-24",0,0,0,0,0,0,0,0
"Nepal","2024-12-25",0,0,0,0,0,0,0,0
"Nepal","2024-12-26",0,0,0,0,0,0,0,0
"Nepal","2024-12-27",0,0,0,0,0,0,0,0
"Nepal","2024-12-28",0,0,0,0,0,0,0,0
"Nepal","2024-12-29",0,0,0,0,0,0,0,0
"Nepal","2024-12-30",0,0,0,0,0,0,0,0
"Nepal","2024-12-31",0,0,0,0,0,0,0,0
"Nepal","2025-01-01",0,0,0,0,0,0,0,0
"Nepal","2025-01-02",0,0,0,0,0,0,0,0
"Nepal","2025-01-03",0,0,0,0,0,0,0,0
"Nepal","2025-01-04",0,0,0,0,0,0,0,0
"Nepal","2025-01-05",0,0,0,0,0,0,0,0
"Nepal","2025-01-06",0,0,0,0,0,0,0,0
"Nepal","2025-01-07",0,0,0,0,0,0,0,0
"Nepal","2025-01-08",0,0,0,0,0,0,0,0
"Nepal","2025-01-09",0,0,0,0,0,0,0,0
"Nepal","2025-01-10",0,0,0,0,0,0,0,0
"Nepal","2025-01-11",0,0,0,0,0,0,0,0
"Nepal","2025-01-12",0,0,0,0,0,0,0,0
"Nepal","2025-01-13",0,0,0,0,0,0,0,0
"Netherlands (Kingdom of the)","2024-01-01",0,0,0,0,0,0,0,0
"Netherlands (Kingdom of the)","2024-01-02",0,0,0,0,0,0,0,0
"Netherlands (Kingdom of the)","2024-01-03",0,0,0,0,0,0,0,0
"Netherlands (Kingdom of the)","2024-01-04",0,0,0,0,0,0,0,0
"Netherlands (Kingdom of the)","2024-01-05",0,0,0,0,0,0,0,0
"Netherlands (Kingdom of the)","2024-01-06",0,0,0,0,0,0,0,0
"Netherlands (Kingdom of the)","2024-01-07",0,0,0,0,0,0,0,0
"Netherlands (Kingdom of the)","2024-01-08",0,0,0,0,0,0,0,0
"Netherlands (Kingdom of the)","2024-01-09",0,0,0,0,0,0,0,0
"Netherlands (Kingdom of the)","2024-01-10",0,0,0,0,0,0,0,0
"Netherlands (Kingdom of the)","2024-01-11",0,0,0,0,0,0,0,0
"Netherlands (Kingdom of the)","2024-01-12",0,0,0,0,0,0,0,0
"Netherlands (Kingdom of the)","2024-01-13",0,0,0,0,0,0,0,0
"Netherlands (Kingdom of the)","2024-01-14",0,0,0,0,0,0,0,0
"Netherlands (Kingdom of the)","2024-01-15",0,0,0,0,0,0,0,0
"Netherlands (Kingdom of the)","2024-01-16",0,0,0,0,0,0,0,0
"Netherlands (Kingdom of the)","2024-01-17",0,0,0,0,0,0,0,0
"Netherlands (Kingdom of the)","2024-01-18",0,0,0,0,0,0,0,0
"Netherlands (Kingdom of the)","2024-01-19",0,0,0,0,0,0,0,0
"Netherlands (Kingdom of the)","2024-01-20",0,0,0,0,0,0,0,0
"Netherlands (Kingdom of the)","2024-01-21",0,0,0,0,0,0,0,0
"Netherlands (Kingdom of the)","2024-01-22",0,0,0,0,0,0,0,0
"Netherlands (Kingdom of the)","2024-01-23",0,0,0,0,0,0,0,0
"Netherlands (Kingdom of the)","2024-01-24",0,0,0,0,0,0,0,0
"Netherlands (Kingdom of the)","2024-01-25",0,0,0,0,0,0,0,0
"Netherlands (Kingdom of the)","2024-01-26",0,0,0,0,0,0,0,0
"Netherlands (Kingdom of the)","2024-01-27",0,0,0,0,0,0,0,0
"Netherlands (Kingdom of the)","2024-01-28",0,0,0,0,0,0,0,0
"Netherlands (Kingdom of the)","2024-01-29",0,0,0,0,0,0,0,0
"Netherlands (Kingdom of the)","2024-01-30",0,0,0,0,0,0,0,0
"Netherlands (Kingdom of the)","2024-01-31",0,5,5,0,5,5,0,0
"Netherlands (Kingdom of the)","2024-02-01",0,0,5,0,0,5,0,0
"Netherlands (Kingdom of the)","2024-02-02",0,0,5,0,0,5,0,0
"Netherlands (Kingdom of the)","2024-02-03",0,0,5,0,1,6,0,0
"Netherlands (Kingdom of the)","2024-02-04",0,0,5,0,0,6,0,0
"Netherlands (Kingdom of the)","2024-02-05",0,0,5,0,0,6,0,0
"Netherlands (Kingdom of the)","2024-02-06",0,0,5,0,0,6,0,0
"Netherlands (Kingdom of the)","2024-02-07",0,0,5,0,1,7,0,0
"Netherlands (Kingdom of the)","2024-02-08",0,0,5,0,0,7,0,0
"Netherlands (Kingdom of the)","2024-02-09",0,0,5,0,0,7,0,0
"Netherlands (Kingdom of the)","2024-02-10",0,0,5,0,0,7,0,0
"Netherlands (Kingdom of the)","2024-02-11",0,0,5,0,1,8,0,0
"Netherlands (Kingdom of the)","2024-02-12",0,0,5,0,0,8,0,0
"Netherlands (Kingdom of the)","2024-02-13",0,0,5,0,0,8,0,0
"Netherlands (Kingdom of the)","2024-02-14",0,0,5,0,0,8,0,0
"Netherlands (Kingdom of the)","2024-02-15",0,0,5,0,1,9,0,0
"Netherlands (Kingdom of the)","2024-02-16",0,0,5,0,0,9,0,0
"Netherlands (Kingdom of the)","2024-02-17",0,0,5,0,0,9,0,0
"Netherlands (Kingdom of the)","2024-02-18",0,0,5,0,0,9,0,0
"Netherlands (Kingdom of the)","2024-02-19",0,0,5,0,1,10,0,0
"Netherlands (Kingdom of the)","2024-02-20",0,0,5,0,0,10,0,0
"Netherlands (Kingdom of the)","2024-02-21",0,0,5,0,0,10,0,0
"Netherlands (Kingdom of the)","2024-02-22",0,0,5,0,0,10,0,0
"Netherlands (Kingdom of the)","2024-02-23",0,0,5,0,1,11,0,0
"Netherlands (Kingdom of the)","2024-02-24",0,0,5,0,0,11,0,0
"Netherlands (Kingdom of the)","2024-02-25",0,0,5,0,0,11,0,0
"Netherlands (Kingdom of the)","2024-02-26",0,0,5,0,0,11,0,0
"Netherlands (Kingdom of the)","2024-02-27",0,0,5,0,1,12,0,0
"Netherlands (Kingdom of the)","2024-02-28",0,0,5,0,0,12,0,0
"Netherlands (Kingdom of the)","2024-02-29",0,7,12,0,0,12,0,0
"Netherlands (Kingdom of the)","2024-03-01",0,0,12,0,0,12,0,0
"Netherlands (Kingdom of the)","2024-03-02",0,0,12,0,0,12,0,0
"Netherlands (Kingdom of the)","2024-03-03",0,0,12,0,0,12,0,0
"Netherlands (Kingdom of the)","2024-03-04",0,0,12,0,0,12,0,0
"Netherlands (Kingdom of the)","2024-03-05",0,0,12,0,0,12,0,0
"Netherlands (Kingdom of the)","2024-03-06",0,0,12,0,0,12,0,0
"Netherlands (Kingdom of the)","2024-03-07",0,0,12,0,0,12,0,0
"Netherlands (Kingdom of the)","2024-03-08",0,0,12,0,0,12,0,0
"Netherlands (Kingdom of the)","2024-03-09",0,0,12,0,0,12,0,0
"Netherlands (Kingdom of the)","2024-03-10",0,0,12,0,0,12,0,0
"Netherlands (Kingdom of the)","2024-03-11",0,0,12,0,0,12,0,0
"Netherlands (Kingdom of the)","2024-03-12",0,0,12,0,0,12,0,0
"Netherlands (Kingdom of the)","2024-03-13",0,0,12,0,0,12,0,0
"Netherlands (Kingdom of the)","2024-03-14",0,0,12,0,0,12,0,0
"Netherlands (Kingdom of the)","2024-03-15",0,0,12,0,0,12,0,0
"Netherlands (Kingdom of the)","2024-03-16",0,0,12,0,1,13,0,0
"Netherlands (Kingdom of the)","2024-03-17",0,0,12,0,0,13,0,0
"Netherlands (Kingdom of the)","2024-03-18",0,0,12,0,0,13,0,0
"Netherlands (Kingdom of the)","2024-03-19",0,0,12,0,0,13,0,0
"Netherlands (Kingdom of the)","2024-03-20",0,0,12,0,0,13,0,0
"Netherlands (Kingdom of the)","2024-03-21",0,0,12,0,0,13,0,0
"Netherlands (Kingdom of the)","2024-03-22",0,0,12,0,0,13,0,0
"Netherlands (Kingdom of the)","2024-03-23",0,0,12,0,0,13,0,0
"Netherlands (Kingdom of the)","2024-03-24",0,0,12,0,0,13,0,0
"Netherlands (Kingdom of the)","2024-03-25",0,0,12,0,0,13,0,0
"Netherlands (Kingdom of the)","2024-03-26",0,0,12,0,0,13,0,0
"Netherlands (Kingdom of the)","2024-03-27",0,0,12,0,0,13,0,0
"Netherlands (Kingdom of the)","2024-03-28",0,0,12,0,0,13,0,0
"Netherlands (Kingdom of the)","2024-03-29",0,0,12,0,0,13,0,0
"Netherlands (Kingdom of the)","2024-03-30",0,0,12,0,0,13,0,0
"Netherlands (Kingdom of the)","2024-03-31",0,0,12,0,0,13,0,0
"Netherlands (Kingdom of the)","2024-04-01",0,0,12,0,0,13,0,0
"Netherlands (Kingdom of the)","2024-04-02",0,0,12,0,0,13,0,0
"Netherlands (Kingdom of the)","2024-04-03",0,0,12,0,0,13,0,0
"Netherlands (Kingdom of the)","2024-04-04",0,0,12,0,0,13,0,0
"Netherlands (Kingdom of the)","2024-04-05",0,0,12,0,0,13,0,0
"Netherlands (Kingdom of the)","2024-04-06",0,0,12,0,0,13,0,0
"Netherlands (Kingdom of the)","2024-04-07",0,0,12,0,0,13,0,0
"Netherlands (Kingdom of the)","2024-04-08",0,0,12,0,0,13,0,0
"Netherlands (Kingdom of the)","2024-04-09",0,0,12,0,0,13,0,0
"Netherlands (Kingdom of the)","2024-04-10",0,0,12,0,0,13,0,0
"Netherlands (Kingdom of the)","2024-04-11",0,0,12,0,0,13,0,0
"Netherlands (Kingdom of the)","2024-04-12",0,0,12,0,0,13,0,0
"Netherlands (Kingdom of the)","2024-04-13",0,0,12,0,0,13,0,0
"Netherlands (Kingdom of the)","2024-04-14",0,0,12,0,0,13,0,0
"Netherlands (Kingdom of the)","2024-04-15",0,0,12,0,1,14,0,0
"Netherlands (Kingdom of the)","2024-04-16",0,0,12,0,0,14,0,0
"Netherlands (Kingdom of the)","2024-04-17",0,0,12,0,0,14,0,0
"Netherlands (Kingdom of the)","2024-04-18",0,0,12,0,0,14,0,0
"Netherlands (Kingdom of the)","2024-04-19",0,0,12,0,0,14,0,0
"Netherlands (Kingdom of the)","2024-04-20",0,0,12,0,0,14,0,0
"Netherlands (Kingdom of the)","2024-04-21",0,0,12,0,0,14,0,0
"Netherlands (Kingdom of the)","2024-04-22",0,0,12,0,0,14,0,0
"Netherlands (Kingdom of the)","2024-04-23",0,0,12,0,0,14,0,0
"Netherlands (Kingdom of the)","2024-04-24",0,0,12,0,0,14,0,0
"Netherlands (Kingdom of the)","2024-04-25",0,0,12,0,0,14,0,0
"Netherlands (Kingdom of the)","2024-04-26",0,0,12,0,0,14,0,0
"Netherlands (Kingdom of the)","2024-04-27",0,0,12,0,0,14,0,0
"Netherlands (Kingdom of the)","2024-04-28",0,0,12,0,0,14,0,0
"Netherlands (Kingdom of the)","2024-04-29",0,0,12,0,0,14,0,0
"Netherlands (Kingdom of the)","2024-04-30",0,2,14,0,0,14,0,0
"Netherlands (Kingdom of the)","2024-05-01",0,0,14,0,0,14,0,0
"Netherlands (Kingdom of the)","2024-05-02",0,0,14,0,0,14,0,0
"Netherlands (Kingdom of the)","2024-05-03",0,0,14,0,0,14,0,0
"Netherlands (Kingdom of the)","2024-05-04",0,0,14,0,0,14,0,0
"Netherlands (Kingdom of the)","2024-05-05",0,0,14,0,0,14,0,0
"Netherlands (Kingdom of the)","2024-05-06",0,0,14,0,0,14,0,0
"Netherlands (Kingdom of the)","2024-05-07",0,0,14,0,0,14,0,0
"Netherlands (Kingdom of the)","2024-05-08",0,0,14,0,0,14,0,0
"Netherlands (Kingdom of the)","2024-05-09",0,0,14,0,0,14,0,0
"Netherlands (Kingdom of the)","2024-05-10",0,0,14,0,0,14,0,0
"Netherlands (Kingdom of the)","2024-05-11",0,0,14,0,0,14,0,0
"Netherlands (Kingdom of the)","2024-05-12",0,0,14,0,0,14,0,0
"Netherlands (Kingdom of the)","2024-05-13",0,0,14,0,0,14,0,0
"Netherlands (Kingdom of the)","2024-05-14",0,0,14,0,0,14,0,0
"Netherlands (Kingdom of the)","2024-05-15",0,0,14,0,0,14,0,0
"Netherlands (Kingdom of the)","2024-05-16",0,0,14,0,1,15,0,0
"Netherlands (Kingdom of the)","2024-05-17",0,0,14,0,0,15,0,0
"Netherlands (Kingdom of the)","2024-05-18",0,0,14,0,0,15,0,0
"Netherlands (Kingdom of the)","2024-05-19",0,0,14,0,0,15,0,0
"Netherlands (Kingdom of the)","2024-05-20",0,0,14,0,0,15,0,0
"Netherlands (Kingdom of the)","2024-05-21",0,0,14,0,0,15,0,0
"Netherlands (Kingdom of the)","2024-05-22",0,0,14,0,0,15,0,0
"Netherlands (Kingdom of the)","2024-05-23",0,0,14,0,0,15,0,0
"Netherlands (Kingdom of the)","2024-05-24",0,0,14,0,0,15,0,0
"Netherlands (Kingdom of the)","2024-05-25",0,0,14,0,0,15,0,0
"Netherlands (Kingdom of the)","2024-05-26",0,0,14,0,0,15,0,0
"Netherlands (Kingdom of the)","2024-05-27",0,0,14,0,0,15,0,0
"Netherlands (Kingdom of the)","2024-05-28",0,0,14,0,0,15,0,0
"Netherlands (Kingdom of the)","2024-05-29",0,0,14,0,0,15,0,0
"Netherlands (Kingdom of the)","2024-05-30",0,0,14,0,0,15,0,0
"Netherlands (Kingdom of the)","2024-05-31",0,1,15,0,0,15,0,0
"Netherlands (Kingdom of the)","2024-06-01",0,0,15,0,0,15,0,0
"Netherlands (Kingdom of the)","2024-06-02",0,0,15,0,0,15,0,0
"Netherlands (Kingdom of the)","2024-06-03",0,0,15,0,0,15,0,0
"Netherlands (Kingdom of the)","2024-06-04",0,0,15,0,0,15,0,0
"Netherlands (Kingdom of the)","2024-06-05",0,0,15,0,0,15,0,0
"Netherlands (Kingdom of the)","2024-06-06",0,0,15,0,0,15,0,0
"Netherlands (Kingdom of the)","2024-06-07",0,0,15,0,0,15,0,0
"Netherlands (Kingdom of the)","2024-06-08",0,0,15,0,1,16,0,0
"Netherlands (Kingdom of the)","2024-06-09",0,0,15,0,0,16,0,0
"Netherlands (Kingdom of the)","2024-06-10",0,0,15,0,0,16,0,0
"Netherlands (Kingdom of the)","2024-06-11",0,0,15,0,0,16,0,0
"Netherlands (Kingdom of the)","2024-06-12",0,0,15,0,0,16,0,0
"Netherlands (Kingdom of the)","2024-06-13",0,0,15,0,0,16,0,0
"Netherlands (Kingdom of the)","2024-06-14",0,0,15,0,0,16,0,0
"Netherlands (Kingdom of the)","2024-06-15",0,0,15,0,0,16,0,0
"Netherlands (Kingdom of the)","2024-06-16",0,0,15,0,0,16,0,0
"Netherlands (Kingdom of the)","2024-06-17",0,0,15,0,0,16,0,0
"Netherlands (Kingdom of the)","2024-06-18",0,0,15,0,0,16,0,0
"Netherlands (Kingdom of the)","2024-06-19",0,0,15,0,0,16,0,0
"Netherlands (Kingdom of the)","2024-06-20",0,0,15,0,0,16,0,0
"Netherlands (Kingdom of the)","2024-06-21",0,0,15,0,0,16,0,0
"Netherlands (Kingdom of the)","2024-06-22",0,0,15,0,0,16,0,0
"Netherlands (Kingdom of the)","2024-06-23",0,0,15,0,1,17,0,0
"Netherlands (Kingdom of the)","2024-06-24",0,0,15,0,0,17,0,0
"Netherlands (Kingdom of the)","2024-06-25",0,0,15,0,0,17,0,0
"Netherlands (Kingdom of the)","2024-06-26",0,0,15,0,0,17,0,0
"Netherlands (Kingdom of the)","2024-06-27",0,0,15,0,0,17,0,0
"Netherlands (Kingdom of the)","2024-06-28",0,0,15,0,0,17,0,0
"Netherlands (Kingdom of the)","2024-06-29",0,0,15,0,0,17,0,0
"Netherlands (Kingdom of the)","2024-06-30",0,2,17,0,0,17,0,0
"Netherlands (Kingdom of the)","2024-07-01",0,0,17,0,0,17,0,0
"Netherlands (Kingdom of the)","2024-07-02",0,0,17,0,0,17,0,0
"Netherlands (Kingdom of the)","2024-07-03",0,0,17,0,0,17,0,0
"Netherlands (Kingdom of the)","2024-07-04",0,0,17,0,1,18,0,0
"Netherlands (Kingdom of the)","2024-07-05",0,0,17,0,0,18,0,0
"Netherlands (Kingdom of the)","2024-07-06",0,0,17,0,0,18,0,0
"Netherlands (Kingdom of the)","2024-07-07",0,0,17,0,0,18,0,0
"Netherlands (Kingdom of the)","2024-07-08",0,0,17,0,0,18,0,0
"Netherlands (Kingdom of the)","2024-07-09",0,0,17,0,0,18,0,0
"Netherlands (Kingdom of the)","2024-07-10",0,0,17,0,0,18,0,0
"Netherlands (Kingdom of the)","2024-07-11",0,0,17,0,0,18,0,0
"Netherlands (Kingdom of the)","2024-07-12",0,0,17,0,1,19,0,0
"Netherlands (Kingdom of the)","2024-07-13",0,0,17,0,0,19,0,0
"Netherlands (Kingdom of the)","2024-07-14",0,0,17,0,0,19,0,0
"Netherlands (Kingdom of the)","2024-07-15",0,0,17,0,0,19,0,0
"Netherlands (Kingdom of the)","2024-07-16",0,0,17,0,0,19,0,0
"Netherlands (Kingdom of the)","2024-07-17",0,0,17,0,0,19,0,0
"Netherlands (Kingdom of the)","2024-07-18",0,0,17,0,0,19,0,0
"Netherlands (Kingdom of the)","2024-07-19",0,0,17,0,0,19,0,0
"Netherlands (Kingdom of the)","2024-07-20",0,0,17,0,1,20,0,0
"Netherlands (Kingdom of the)","2024-07-21",0,0,17,0,0,20,0,0
"Netherlands (Kingdom of the)","2024-07-22",0,0,17,0,0,20,0,0
"Netherlands (Kingdom of the)","2024-07-23",0,0,17,0,0,20,0,0
"Netherlands (Kingdom of the)","2024-07-24",0,0,17,0,0,20,0,0
"Netherlands (Kingdom of the)","2024-07-25",0,0,17,0,0,20,0,0
"Netherlands (Kingdom of the)","2024-07-26",0,0,17,0,0,20,0,0
"Netherlands (Kingdom of the)","2024-07-27",0,0,17,0,0,20,0,0
"Netherlands (Kingdom of the)","2024-07-28",0,0,17,0,1,21,0,0
"Netherlands (Kingdom of the)","2024-07-29",0,0,17,0,0,21,0,0
"Netherlands (Kingdom of the)","2024-07-30",0,0,17,0,0,21,0,0
"Netherlands (Kingdom of the)","2024-07-31",0,4,21,0,0,21,0,0
"Netherlands (Kingdom of the)","2024-08-01",0,0,21,0,1,22,0,0
"Netherlands (Kingdom of the)","2024-08-02",0,0,21,0,0,22,0,0
"Netherlands (Kingdom of the)","2024-08-03",0,0,21,0,1,23,0,0
"Netherlands (Kingdom of the)","2024-08-04",0,0,21,0,0,23,0,0
"Netherlands (Kingdom of the)","2024-08-05",0,0,21,0,1,24,0,0
"Netherlands (Kingdom of the)","2024-08-06",0,0,21,0,1,25,0,0
"Netherlands (Kingdom of the)","2024-08-07",0,0,21,0,0,25,0,0
"Netherlands (Kingdom of the)","2024-08-08",0,0,21,0,1,26,0,0
"Netherlands (Kingdom of the)","2024-08-09",0,0,21,0,1,27,0,0
"Netherlands (Kingdom of the)","2024-08-10",0,0,21,0,0,27,0,0
"Netherlands (Kingdom of the)","2024-08-11",0,0,21,0,1,28,0,0
"Netherlands (Kingdom of the)","2024-08-12",0,0,21,0,0,28,0,0
"Netherlands (Kingdom of the)","2024-08-13",0,0,21,0,1,29,0,0
"Netherlands (Kingdom of the)","2024-08-14",0,0,21,0,1,30,0,0
"Netherlands (Kingdom of the)","2024-08-15",0,0,21,0,0,30,0,0
"Netherlands (Kingdom of the)","2024-08-16",0,0,21,0,1,31,0,0
"Netherlands (Kingdom of the)","2024-08-17",0,0,21,0,0,31,0,0
"Netherlands (Kingdom of the)","2024-08-18",0,0,21,0,1,32,0,0
"Netherlands (Kingdom of the)","2024-08-19",0,0,21,0,1,33,0,0
"Netherlands (Kingdom of the)","2024-08-20",0,0,21,0,0,33,0,0
"Netherlands (Kingdom of the)","2024-08-21",0,0,21,0,1,34,0,0
"Netherlands (Kingdom of the)","2024-08-22",0,0,21,0,0,34,0,0
"Netherlands (Kingdom of the)","2024-08-23",0,0,21,0,1,35,0,0
"Netherlands (Kingdom of the)","2024-08-24",0,0,21,0,1,36,0,0
"Netherlands (Kingdom of the)","2024-08-25",0,0,21,0,0,36,0,0
"Netherlands (Kingdom of the)","2024-08-26",0,0,21,0,1,37,0,0
"Netherlands (Kingdom of the)","2024-08-27",0,0,21,0,1,38,0,0
"Netherlands (Kingdom of the)","2024-08-28",0,0,21,0,0,38,0,0
"Netherlands (Kingdom of the)","2024-08-29",0,0,21,0,1,39,0,0
"Netherlands (Kingdom of the)","2024-08-30",0,0,21,0,0,39,0,0
"Netherlands (Kingdom of the)","2024-08-31",0,19,40,0,1,40,0,0
"Netherlands (Kingdom of the)","2024-09-01",0,0,40,0,1,41,0,0
"Netherlands (Kingdom of the)","2024-09-02",0,0,40,0,0,41,0,0
"Netherlands (Kingdom of the)","2024-09-03",0,0,40,0,1,42,0,0
"Netherlands (Kingdom of the)","2024-09-04",0,0,40,0,1,43,0,0
"Netherlands (Kingdom of the)","2024-09-05",0,0,40,0,1,44,0,0
"Netherlands (Kingdom of the)","2024-09-06",0,0,40,0,0,44,0,0
"Netherlands (Kingdom of the)","2024-09-07",0,0,40,0,1,45,0,0
"Netherlands (Kingdom of the)","2024-09-08",0,0,40,0,1,46,0,0
"Netherlands (Kingdom of the)","2024-09-09",0,0,40,0,1,47,0,0
"Netherlands (Kingdom of the)","2024-09-10",0,0,40,0,0,47,0,0
"Netherlands (Kingdom of the)","2024-09-11",0,0,40,0,1,48,0,0
"Netherlands (Kingdom of the)","2024-09-12",0,0,40,0,1,49,0,0
"Netherlands (Kingdom of the)","2024-09-13",0,0,40,0,1,50,0,0
"Netherlands (Kingdom of the)","2024-09-14",0,0,40,0,0,50,0,0
"Netherlands (Kingdom of the)","2024-09-15",0,0,40,0,1,51,0,0
"Netherlands (Kingdom of the)","2024-09-16",0,0,40,0,1,52,0,0
"Netherlands (Kingdom of the)","2024-09-17",0,0,40,0,0,52,0,0
"Netherlands (Kingdom of the)","2024-09-18",0,0,40,0,1,53,0,0
"Netherlands (Kingdom of the)","2024-09-19",0,0,40,0,1,54,0,0
"Netherlands (Kingdom of the)","2024-09-20",0,0,40,0,1,55,0,0
"Netherlands (Kingdom of the)","2024-09-21",0,0,40,0,0,55,0,0
"Netherlands (Kingdom of the)","2024-09-22",0,0,40,0,1,56,0,0
"Netherlands (Kingdom of the)","2024-09-23",0,0,40,0,1,57,0,0
"Netherlands (Kingdom of the)","2024-09-24",0,0,40,0,1,58,0,0
"Netherlands (Kingdom of the)","2024-09-25",0,0,40,0,0,58,0,0
"Netherlands (Kingdom of the)","2024-09-26",0,0,40,0,1,59,0,0
"Netherlands (Kingdom of the)","2024-09-27",0,0,40,0,1,60,0,0
"Netherlands (Kingdom of the)","2024-09-28",0,0,40,0,1,61,0,0
"Netherlands (Kingdom of the)","2024-09-29",0,0,40,0,0,61,0,0
"Netherlands (Kingdom of the)","2024-09-30",0,22,62,0,1,62,0,0
"Netherlands (Kingdom of the)","2024-10-01",0,0,62,0,1,63,0,0
"Netherlands (Kingdom of the)","2024-10-02",0,0,62,0,1,64,0,0
"Netherlands (Kingdom of the)","2024-10-03",0,0,62,0,0,64,0,0
"Netherlands (Kingdom of the)","2024-10-04",0,0,62,0,1,65,0,0
"Netherlands (Kingdom of the)","2024-10-05",0,0,62,0,1,66,0,0
"Netherlands (Kingdom of the)","2024-10-06",0,0,62,0,1,67,0,0
"Netherlands (Kingdom of the)","2024-10-07",0,0,62,0,1,68,0,0
"Netherlands (Kingdom of the)","2024-10-08",0,0,62,0,0,68,0,0
"Netherlands (Kingdom of the)","2024-10-09",0,0,62,0,1,69,0,0
"Netherlands (Kingdom of the)","2024-10-10",0,0,62,0,1,70,0,0
"Netherlands (Kingdom of the)","2024-10-11",0,0,62,0,1,71,0,0
"Netherlands (Kingdom of the)","2024-10-12",0,0,62,0,1,72,0,0
"Netherlands (Kingdom of the)","2024-10-13",0,0,62,0,0,72,0,0
"Netherlands (Kingdom of the)","2024-10-14",0,0,62,0,1,73,0,0
"Netherlands (Kingdom of the)","2024-10-15",0,0,62,0,1,74,0,0
"Netherlands (Kingdom of the)","2024-10-16",0,0,62,0,1,75,0,0
"Netherlands (Kingdom of the)","2024-10-17",0,0,62,0,1,76,0,0
"Netherlands (Kingdom of the)","2024-10-18",0,0,62,0,1,77,0,0
"Netherlands (Kingdom of the)","2024-10-19",0,0,62,0,0,77,0,0
"Netherlands (Kingdom of the)","2024-10-20",0,0,62,0,1,78,0,0
"Netherlands (Kingdom of the)","2024-10-21",0,0,62,0,1,79,0,0
"Netherlands (Kingdom of the)","2024-10-22",0,0,62,0,1,80,0,0
"Netherlands (Kingdom of the)","2024-10-23",0,0,62,0,1,81,0,0
"Netherlands (Kingdom of the)","2024-10-24",0,0,62,0,0,81,0,0
"Netherlands (Kingdom of the)","2024-10-25",0,0,62,0,1,82,0,0
"Netherlands (Kingdom of the)","2024-10-26",0,0,62,0,1,83,0,0
"Netherlands (Kingdom of the)","2024-10-27",0,0,62,0,1,84,0,0
"Netherlands (Kingdom of the)","2024-10-28",0,0,62,0,1,85,0,0
"Netherlands (Kingdom of the)","2024-10-29",0,0,62,0,0,85,0,0
"Netherlands (Kingdom of the)","2024-10-30",0,0,62,0,1,86,0,0
"Netherlands (Kingdom of the)","2024-10-31",0,25,87,0,1,87,0,0
"Netherlands (Kingdom of the)","2024-11-01",0,0,87,0,1,88,0,0
"Netherlands (Kingdom of the)","2024-11-02",0,0,87,0,2,90,0,0
"Netherlands (Kingdom of the)","2024-11-03",0,0,87,0,1,91,0,0
"Netherlands (Kingdom of the)","2024-11-04",0,0,87,0,1,92,0,0
"Netherlands (Kingdom of the)","2024-11-05",0,0,87,0,1,93,0,0
"Netherlands (Kingdom of the)","2024-11-06",0,0,87,0,2,95,0,0
"Netherlands (Kingdom of the)","2024-11-07",0,0,87,0,1,96,0,0
"Netherlands (Kingdom of the)","2024-11-08",0,0,87,0,1,97,0,0
"Netherlands (Kingdom of the)","2024-11-09",0,0,87,0,1,98,0,0
"Netherlands (Kingdom of the)","2024-11-10",0,0,87,0,2,100,0,0
"Netherlands (Kingdom of the)","2024-11-11",0,0,87,0,1,101,0,0
"Netherlands (Kingdom of the)","2024-11-12",0,0,87,0,1,102,0,0
"Netherlands (Kingdom of the)","2024-11-13",0,0,87,0,1,103,0,0
"Netherlands (Kingdom of the)","2024-11-14",0,0,87,0,2,105,0,0
"Netherlands (Kingdom of the)","2024-11-15",0,0,87,0,1,106,0,0
"Netherlands (Kingdom of the)","2024-11-16",0,0,87,0,1,107,0,0
"Netherlands (Kingdom of the)","2024-11-17",0,0,87,0,2,109,0,0
"Netherlands (Kingdom of the)","2024-11-18",0,0,87,0,1,110,0,0
"Netherlands (Kingdom of the)","2024-11-19",0,0,87,0,1,111,0,0
"Netherlands (Kingdom of the)","2024-11-20",0,0,87,0,1,112,0,0
"Netherlands (Kingdom of the)","2024-11-21",0,0,87,0,2,114,0,0
"Netherlands (Kingdom of the)","2024-11-22",0,0,87,0,1,115,0,0
"Netherlands (Kingdom of the)","2024-11-23",0,0,87,0,1,116,0,0
"Netherlands (Kingdom of the)","2024-11-24",0,0,87,0,1,117,0,0
"Netherlands (Kingdom of the)","2024-11-25",0,0,87,0,2,119,0,0
"Netherlands (Kingdom of the)","2024-11-26",0,0,87,0,1,120,0,0
"Netherlands (Kingdom of the)","2024-11-27",0,0,87,0,1,121,0,0
"Netherlands (Kingdom of the)","2024-11-28",0,0,87,0,1,122,0,0
"Netherlands (Kingdom of the)","2024-11-29",0,0,87,0,2,124,0,0
"Netherlands (Kingdom of the)","2024-11-30",0,38,125,0,1,125,0,0
"Netherlands (Kingdom of the)","2024-12-01",0,0,125,0,0,125,0,0
"Netherlands (Kingdom of the)","2024-12-02",0,0,125,0,0,125,0,0
"Netherlands (Kingdom of the)","2024-12-03",0,0,125,0,0,125,0,0
"Netherlands (Kingdom of the)","2024-12-04",0,0,125,0,0,125,0,0
"Netherlands (Kingdom of the)","2024-12-05",0,0,125,0,0,125,0,0
"Netherlands (Kingdom of the)","2024-12-06",0,0,125,0,0,125,0,0
"Netherlands (Kingdom of the)","2024-12-07",0,0,125,0,0,125,0,0
"Netherlands (Kingdom of the)","2024-12-08",0,0,125,0,0,125,0,0
"Netherlands (Kingdom of the)","2024-12-09",0,0,125,0,0,125,0,0
"Netherlands (Kingdom of the)","2024-12-10",0,0,125,0,0,125,0,0
"Netherlands (Kingdom of the)","2024-12-11",0,0,125,0,0,125,0,0
"Netherlands (Kingdom of the)","2024-12-12",0,0,125,0,0,125,0,0
"Netherlands (Kingdom of the)","2024-12-13",0,0,125,0,0,125,0,0
"Netherlands (Kingdom of the)","2024-12-14",0,0,125,0,0,125,0,0
"Netherlands (Kingdom of the)","2024-12-15",0,0,125,0,0,125,0,0
"Netherlands (Kingdom of the)","2024-12-16",0,0,125,0,0,125,0,0
"Netherlands (Kingdom of the)","2024-12-17",0,0,125,0,0,125,0,0
"Netherlands (Kingdom of the)","2024-12-18",0,0,125,0,0,125,0,0
"Netherlands (Kingdom of the)","2024-12-19",0,0,125,0,0,125,0,0
"Netherlands (Kingdom of the)","2024-12-20",0,0,125,0,0,125,0,0
"Netherlands (Kingdom of the)","2024-12-21",0,0,125,0,0,125,0,0
"Netherlands (Kingdom of the)","2024-12-22",0,0,125,0,0,125,0,0
"Netherlands (Kingdom of the)","2024-12-23",0,0,125,0,0,125,0,0
"Netherlands (Kingdom of the)","2024-12-24",0,0,125,0,0,125,0,0
"Netherlands (Kingdom of the)","2024-12-25",0,0,125,0,0,125,0,0
"Netherlands (Kingdom of the)","2024-12-26",0,0,125,0,0,125,0,0
"Netherlands (Kingdom of the)","2024-12-27",0,0,125,0,0,125,0,0
"Netherlands (Kingdom of the)","2024-12-28",0,0,125,0,0,125,0,0
"Netherlands (Kingdom of the)","2024-12-29",0,0,125,0,0,125,0,0
"Netherlands (Kingdom of the)","2024-12-30",0,0,125,0,0,125,0,0
"Netherlands (Kingdom of the)","2024-12-31",0,0,125,0,0,125,0,0
"Netherlands (Kingdom of the)","2025-01-01",0,0,125,0,0,125,0,0
"Netherlands (Kingdom of the)","2025-01-02",0,0,125,0,0,125,0,0
"Netherlands (Kingdom of the)","2025-01-03",0,0,125,0,0,125,0,0
"Netherlands (Kingdom of the)","2025-01-04",0,0,125,0,0,125,0,0
"Netherlands (Kingdom of the)","2025-01-05",0,0,125,0,0,125,0,0
"Netherlands (Kingdom of the)","2025-01-06",0,0,125,0,0,125,0,0
"Netherlands (Kingdom of the)","2025-01-07",0,0,125,0,0,125,0,0
"Netherlands (Kingdom of the)","2025-01-08",0,0,125,0,0,125,0,0
"Netherlands (Kingdom of the)","2025-01-09",0,0,125,0,0,125,0,0
"Netherlands (Kingdom of the)","2025-01-10",0,0,125,0,0,125,0,0
"Netherlands (Kingdom of the)","2025-01-11",0,0,125,0,0,125,0,0
"Netherlands (Kingdom of the)","2025-01-12",0,0,125,0,0,125,0,0
"Netherlands (Kingdom of the)","2025-01-13",0,0,125,0,0,125,0,0
"New Zealand","2024-01-01",0,0,0,0,0,0,0,0
"New Zealand","2024-01-02",0,0,0,0,0,0,0,0
"New Zealand","2024-01-03",0,0,0,0,0,0,0,0
"New Zealand","2024-01-04",0,0,0,0,0,0,0,0
"New Zealand","2024-01-05",0,0,0,0,0,0,0,0
"New Zealand","2024-01-06",0,0,0,0,0,0,0,0
"New Zealand","2024-01-07",0,0,0,0,0,0,0,0
"New Zealand","2024-01-08",0,0,0,0,0,0,0,0
"New Zealand","2024-01-09",0,0,0,0,0,0,0,0
"New Zealand","2024-01-10",0,0,0,0,0,0,0,0
"New Zealand","2024-01-11",0,0,0,0,0,0,0,0
"New Zealand","2024-01-12",0,0,0,0,0,0,0,0
"New Zealand","2024-01-13",0,0,0,0,0,0,0,0
"New Zealand","2024-01-14",0,0,0,0,0,0,0,0
"New Zealand","2024-01-15",0,0,0,0,0,0,0,0
"New Zealand","2024-01-16",0,8,8,0,8,8,0,0
"New Zealand","2024-01-17",0,0,8,0,0,8,0,0
"New Zealand","2024-01-18",0,0,8,0,0,8,0,0
"New Zealand","2024-01-19",0,0,8,0,0,8,0,0
"New Zealand","2024-01-20",0,0,8,0,0,8,0,0
"New Zealand","2024-01-21",0,0,8,0,0,8,0,0
"New Zealand","2024-01-22",0,0,8,0,0,8,0,0
"New Zealand","2024-01-23",0,0,8,0,0,8,0,0
"New Zealand","2024-01-24",0,0,8,0,0,8,0,0
"New Zealand","2024-01-25",0,0,8,0,0,8,0,0
"New Zealand","2024-01-26",0,0,8,0,0,8,0,0
"New Zealand","2024-01-27",0,0,8,0,0,8,0,0
"New Zealand","2024-01-28",0,0,8,0,0,8,0,0
"New Zealand","2024-01-29",0,0,8,0,0,8,0,0
"New Zealand","2024-01-30",0,0,8,0,0,8,0,0
"New Zealand","2024-01-31",0,0,8,0,0,8,0,0
"New Zealand","2024-02-01",0,0,8,0,0,8,0,0
"New Zealand","2024-02-02",0,0,8,0,0,8,0,0
"New Zealand","2024-02-03",0,0,8,0,0,8,0,0
"New Zealand","2024-02-04",0,0,8,0,0,8,0,0
"New Zealand","2024-02-05",0,0,8,0,0,8,0,0
"New Zealand","2024-02-06",0,0,8,0,0,8,0,0
"New Zealand","2024-02-07",0,0,8,0,0,8,0,0
"New Zealand","2024-02-08",0,0,8,0,0,8,0,0
"New Zealand","2024-02-09",0,0,8,0,0,8,0,0
"New Zealand","2024-02-10",0,0,8,0,0,8,0,0
"New Zealand","2024-02-11",0,0,8,0,0,8,0,0
"New Zealand","2024-02-12",0,0,8,0,0,8,0,0
"New Zealand","2024-02-13",0,0,8,0,0,8,0,0
"New Zealand","2024-02-14",0,0,8,0,0,8,0,0
"New Zealand","2024-02-15",0,0,8,0,0,8,0,0
"New Zealand","2024-02-16",0,0,8,0,0,8,0,0
"New Zealand","2024-02-17",0,0,8,0,0,8,0,0
"New Zealand","2024-02-18",0,0,8,0,0,8,0,0
"New Zealand","2024-02-19",0,0,8,0,0,8,0,0
"New Zealand","2024-02-20",0,0,8,0,0,8,0,0
"New Zealand","2024-02-21",0,0,8,0,0,8,0,0
"New Zealand","2024-02-22",0,0,8,0,0,8,0,0
"New Zealand","2024-02-23",0,0,8,0,0,8,0,0
"New Zealand","2024-02-24",0,0,8,0,0,8,0,0
"New Zealand","2024-02-25",0,0,8,0,0,8,0,0
"New Zealand","2024-02-26",0,0,8,0,0,8,0,0
"New Zealand","2024-02-27",0,0,8,0,0,8,0,0
"New Zealand","2024-02-28",0,0,8,0,0,8,0,0
"New Zealand","2024-02-29",0,0,8,0,0,8,0,0
"New Zealand","2024-03-01",0,0,8,0,0,8,0,0
"New Zealand","2024-03-02",0,0,8,0,0,8,0,0
"New Zealand","2024-03-03",0,0,8,0,0,8,0,0
"New Zealand","2024-03-04",0,0,8,0,0,8,0,0
"New Zealand","2024-03-05",0,0,8,0,0,8,0,0
"New Zealand","2024-03-06",0,0,8,0,0,8,0,0
"New Zealand","2024-03-07",0,0,8,0,0,8,0,0
"New Zealand","2024-03-08",0,0,8,0,0,8,0,0
"New Zealand","2024-03-09",0,0,8,0,0,8,0,0
"New Zealand","2024-03-10",0,0,8,0,0,8,0,0
"New Zealand","2024-03-11",0,0,8,0,0,8,0,0
"New Zealand","2024-03-12",0,0,8,0,0,8,0,0
"New Zealand","2024-03-13",0,0,8,0,0,8,0,0
"New Zealand","2024-03-14",0,0,8,0,1,9,0,0
"New Zealand","2024-03-15",0,0,8,0,0,9,0,0
"New Zealand","2024-03-16",0,0,8,0,0,9,0,0
"New Zealand","2024-03-17",0,0,8,0,0,9,0,0
"New Zealand","2024-03-18",0,0,8,0,0,9,0,0
"New Zealand","2024-03-19",0,0,8,0,0,9,0,0
"New Zealand","2024-03-20",0,0,8,0,0,9,0,0
"New Zealand","2024-03-21",0,0,8,0,0,9,0,0
"New Zealand","2024-03-22",0,0,8,0,0,9,0,0
"New Zealand","2024-03-23",0,0,8,0,0,9,0,0
"New Zealand","2024-03-24",0,0,8,0,0,9,0,0
"New Zealand","2024-03-25",0,0,8,0,0,9,0,0
"New Zealand","2024-03-26",0,0,8,0,0,9,0,0
"New Zealand","2024-03-27",0,0,8,0,0,9,0,0
"New Zealand","2024-03-28",0,0,8,0,0,9,0,0
"New Zealand","2024-03-29",0,0,8,0,0,9,0,0
"New Zealand","2024-03-30",0,0,8,0,0,9,0,0
"New Zealand","2024-03-31",0,0,8,0,0,9,0,0
"New Zealand","2024-04-01",0,0,8,0,0,9,0,0
"New Zealand","2024-04-02",0,0,8,0,0,9,0,0
"New Zealand","2024-04-03",0,0,8,0,0,9,0,0
"New Zealand","2024-04-04",0,0,8,0,0,9,0,0
"New Zealand","2024-04-05",0,0,8,0,0,9,0,0
"New Zealand","2024-04-06",0,0,8,0,0,9,0,0
"New Zealand","2024-04-07",0,0,8,0,0,9,0,0
"New Zealand","2024-04-08",0,0,8,0,0,9,0,0
"New Zealand","2024-04-09",0,0,8,0,0,9,0,0
"New Zealand","2024-04-10",0,0,8,0,0,9,0,0
"New Zealand","2024-04-11",0,0,8,0,0,9,0,0
"New Zealand","2024-04-12",0,0,8,0,0,9,0,0
"New Zealand","2024-04-13",0,0,8,0,0,9,0,0
"New Zealand","2024-04-14",0,0,8,0,0,9,0,0
"New Zealand","2024-04-15",0,0,8,0,0,9,0,0
"New Zealand","2024-04-16",0,0,8,0,0,9,0,0
"New Zealand","2024-04-17",0,0,8,0,0,9,0,0
"New Zealand","2024-04-18",0,0,8,0,0,9,0,0
"New Zealand","2024-04-19",0,0,8,0,0,9,0,0
"New Zealand","2024-04-20",0,0,8,0,0,9,0,0
"New Zealand","2024-04-21",0,0,8,0,0,9,0,0
"New Zealand","2024-04-22",0,0,8,0,0,9,0,0
"New Zealand","2024-04-23",0,0,8,0,0,9,0,0
"New Zealand","2024-04-24",0,0,8,0,0,9,0,0
"New Zealand","2024-04-25",0,0,8,0,0,9,0,0
"New Zealand","2024-04-26",0,0,8,0,0,9,0,0
"New Zealand","2024-04-27",0,0,8,0,0,9,0,0
"New Zealand","2024-04-28",0,0,8,0,0,9,0,0
"New Zealand","2024-04-29",0,0,8,0,0,9,0,0
"New Zealand","2024-04-30",0,0,8,0,0,9,0,0
"New Zealand","2024-05-01",0,0,8,0,0,9,0,0
"New Zealand","2024-05-02",0,0,8,0,0,9,0,0
"New Zealand","2024-05-03",0,0,8,0,0,9,0,0
"New Zealand","2024-05-04",0,0,8,0,0,9,0,0
"New Zealand","2024-05-05",0,0,8,0,0,9,0,0
"New Zealand","2024-05-06",0,0,8,0,0,9,0,0
"New Zealand","2024-05-07",0,0,8,0,0,9,0,0
"New Zealand","2024-05-08",0,0,8,0,0,9,0,0
"New Zealand","2024-05-09",0,1,9,0,0,9,0,0
"New Zealand","2024-05-10",0,0,9,0,0,9,0,0
"New Zealand","2024-05-11",0,0,9,0,0,9,0,0
"New Zealand","2024-05-12",0,0,9,0,0,9,0,0
"New Zealand","2024-05-13",0,0,9,0,0,9,0,0
"New Zealand","2024-05-14",0,0,9,0,0,9,0,0
"New Zealand","2024-05-15",0,0,9,0,0,9,0,0
"New Zealand","2024-05-16",0,0,9,0,0,9,0,0
"New Zealand","2024-05-17",0,0,9,0,0,9,0,0
"New Zealand","2024-05-18",0,0,9,0,0,9,0,0
"New Zealand","2024-05-19",0,0,9,0,0,9,0,0
"New Zealand","2024-05-20",0,0,9,0,0,9,0,0
"New Zealand","2024-05-21",0,0,9,0,0,9,0,0
"New Zealand","2024-05-22",0,0,9,0,0,9,0,0
"New Zealand","2024-05-23",0,0,9,0,1,10,0,0
"New Zealand","2024-05-24",0,0,9,0,0,10,0,0
"New Zealand","2024-05-25",0,0,9,0,0,10,0,0
"New Zealand","2024-05-26",0,0,9,0,0,10,0,0
"New Zealand","2024-05-27",0,0,9,0,0,10,0,0
"New Zealand","2024-05-28",0,0,9,0,0,10,0,0
"New Zealand","2024-05-29",0,0,9,0,0,10,0,0
"New Zealand","2024-05-30",0,0,9,0,0,10,0,0
"New Zealand","2024-05-31",0,0,9,0,0,10,0,0
"New Zealand","2024-06-01",0,0,9,0,0,10,0,0
"New Zealand","2024-06-02",0,0,9,0,0,10,0,0
"New Zealand","2024-06-03",0,0,9,0,0,10,0,0
"New Zealand","2024-06-04",0,0,9,0,0,10,0,0
"New Zealand","2024-06-05",0,0,9,0,0,10,0,0
"New Zealand","2024-06-06",0,0,9,0,0,10,0,0
"New Zealand","2024-06-07",0,0,9,0,0,10,0,0
"New Zealand","2024-06-08",0,0,9,0,0,10,0,0
"New Zealand","2024-06-09",0,0,9,0,0,10,0,0
"New Zealand","2024-06-10",0,0,9,0,0,10,0,0
"New Zealand","2024-06-11",0,0,9,0,0,10,0,0
"New Zealand","2024-06-12",0,0,9,0,0,10,0,0
"New Zealand","2024-06-13",0,0,9,0,0,10,0,0
"New Zealand","2024-06-14",0,0,9,0,0,10,0,0
"New Zealand","2024-06-15",0,0,9,0,0,10,0,0
"New Zealand","2024-06-16",0,0,9,0,0,10,0,0
"New Zealand","2024-06-17",0,0,9,0,0,10,0,0
"New Zealand","2024-06-18",0,0,9,0,1,11,0,0
"New Zealand","2024-06-19",0,0,9,0,0,11,0,0
"New Zealand","2024-06-20",0,0,9,0,0,11,0,0
"New Zealand","2024-06-21",0,0,9,0,0,11,0,0
"New Zealand","2024-06-22",0,0,9,0,0,11,0,0
"New Zealand","2024-06-23",0,0,9,0,0,11,0,0
"New Zealand","2024-06-24",0,0,9,0,0,11,0,0
"New Zealand","2024-06-25",0,0,9,0,0,11,0,0
"New Zealand","2024-06-26",0,0,9,0,0,11,0,0
"New Zealand","2024-06-27",0,0,9,0,0,11,0,0
"New Zealand","2024-06-28",0,0,9,0,0,11,0,0
"New Zealand","2024-06-29",0,0,9,0,0,11,0,0
"New Zealand","2024-06-30",0,0,9,0,0,11,0,0
"New Zealand","2024-07-01",0,2,11,0,0,11,0,0
"New Zealand","2024-07-02",0,0,11,0,0,11,0,0
"New Zealand","2024-07-03",0,0,11,0,0,11,0,0
"New Zealand","2024-07-04",0,0,11,0,0,11,0,0
"New Zealand","2024-07-05",0,0,11,0,0,11,0,0
"New Zealand","2024-07-06",0,0,11,0,1,12,0,0
"New Zealand","2024-07-07",0,0,11,0,0,12,0,0
"New Zealand","2024-07-08",0,0,11,0,0,12,0,0
"New Zealand","2024-07-09",0,0,11,0,0,12,0,0
"New Zealand","2024-07-10",0,0,11,0,0,12,0,0
"New Zealand","2024-07-11",0,0,11,0,0,12,0,0
"New Zealand","2024-07-12",0,0,11,0,0,12,0,0
"New Zealand","2024-07-13",0,0,11,0,0,12,0,0
"New Zealand","2024-07-14",0,0,11,0,0,12,0,0
"New Zealand","2024-07-15",0,0,11,0,1,13,0,0
"New Zealand","2024-07-16",0,0,11,0,0,13,0,0
"New Zealand","2024-07-17",0,0,11,0,0,13,0,0
"New Zealand","2024-07-18",0,0,11,0,0,13,0,0
"New Zealand","2024-07-19",0,0,11,0,0,13,0,0
"New Zealand","2024-07-20",0,0,11,0,0,13,0,0
"New Zealand","2024-07-21",0,0,11,0,0,13,0,0
"New Zealand","2024-07-22",0,0,11,0,0,13,0,0
"New Zealand","2024-07-23",0,0,11,0,0,13,0,0
"New Zealand","2024-07-24",0,0,11,0,1,14,0,0
"New Zealand","2024-07-25",0,0,11,0,0,14,0,0
"New Zealand","2024-07-26",0,0,11,0,0,14,0,0
"New Zealand","2024-07-27",0,0,11,0,0,14,0,0
"New Zealand","2024-07-28",0,0,11,0,0,14,0,0
"New Zealand","2024-07-29",0,0,11,0,0,14,0,0
"New Zealand","2024-07-30",0,0,11,0,0,14,0,0
"New Zealand","2024-07-31",0,0,11,0,0,14,0,0
"New Zealand","2024-08-01",0,0,11,0,1,15,0,0
"New Zealand","2024-08-02",0,0,11,0,0,15,0,0
"New Zealand","2024-08-03",0,0,11,0,0,15,0,0
"New Zealand","2024-08-04",0,0,11,0,0,15,0,0
"New Zealand","2024-08-05",0,0,11,0,0,15,0,0
"New Zealand","2024-08-06",0,0,11,0,0,15,0,0
"New Zealand","2024-08-07",0,0,11,0,0,15,0,0
"New Zealand","2024-08-08",0,0,11,0,0,15,0,0
"New Zealand","2024-08-09",0,0,11,0,0,15,0,0
"New Zealand","2024-08-10",0,0,11,0,1,16,0,0
"New Zealand","2024-08-11",0,0,11,0,0,16,0,0
"New Zealand","2024-08-12",0,0,11,0,0,16,0,0
"New Zealand","2024-08-13",0,0,11,0,0,16,0,0
"New Zealand","2024-08-14",0,0,11,0,0,16,0,0
"New Zealand","2024-08-15",0,0,11,0,0,16,0,0
"New Zealand","2024-08-16",0,0,11,0,0,16,0,0
"New Zealand","2024-08-17",0,0,11,0,0,16,0,0
"New Zealand","2024-08-18",0,0,11,0,0,16,0,0
"New Zealand","2024-08-19",0,0,11,0,1,17,0,0
"New Zealand","2024-08-20",0,0,11,0,0,17,0,0
"New Zealand","2024-08-21",0,0,11,0,0,17,0,0
"New Zealand","2024-08-22",0,0,11,0,0,17,0,0
"New Zealand","2024-08-23",0,0,11,0,0,17,0,0
"New Zealand","2024-08-24",0,0,11,0,0,17,0,0
"New Zealand","2024-08-25",0,0,11,0,0,17,0,0
"New Zealand","2024-08-26",0,0,11,0,0,17,0,0
"New Zealand","2024-08-27",0,0,11,0,0,17,0,0
"New Zealand","2024-08-28",0,0,11,0,1,18,0,0
"New Zealand","2024-08-29",0,0,11,0,0,18,0,0
"New Zealand","2024-08-30",0,0,11,0,0,18,0,0
"New Zealand","2024-08-31",0,0,11,0,0,18,0,0
"New Zealand","2024-09-01",0,0,11,0,0,18,0,0
"New Zealand","2024-09-02",0,0,11,0,0,18,0,0
"New Zealand","2024-09-03",0,0,11,0,0,18,0,0
"New Zealand","2024-09-04",0,0,11,0,0,18,0,0
"New Zealand","2024-09-05",0,0,11,0,0,18,0,0
"New Zealand","2024-09-06",0,0,11,0,1,19,0,0
"New Zealand","2024-09-07",0,0,11,0,0,19,0,0
"New Zealand","2024-09-08",0,0,11,0,0,19,0,0
"New Zealand","2024-09-09",0,0,11,0,0,19,0,0
"New Zealand","2024-09-10",0,0,11,0,0,19,0,0
"New Zealand","2024-09-11",0,0,11,0,0,19,0,0
"New Zealand","2024-09-12",0,0,11,0,0,19,0,0
"New Zealand","2024-09-13",0,0,11,0,0,19,0,0
"New Zealand","2024-09-14",0,0,11,0,0,19,0,0
"New Zealand","2024-09-15",0,0,11,0,1,20,0,0
"New Zealand","2024-09-16",0,0,11,0,0,20,0,0
"New Zealand","2024-09-17",0,0,11,0,0,20,0,0
"New Zealand","2024-09-18",0,0,11,0,0,20,0,0
"New Zealand","2024-09-19",0,0,11,0,0,20,0,0
"New Zealand","2024-09-20",0,0,11,0,0,20,0,0
"New Zealand","2024-09-21",0,0,11,0,0,20,0,0
"New Zealand","2024-09-22",0,0,11,0,0,20,0,0
"New Zealand","2024-09-23",0,0,11,0,1,21,0,0
"New Zealand","2024-09-24",0,0,11,0,0,21,0,0
"New Zealand","2024-09-25",0,0,11,0,0,21,0,0
"New Zealand","2024-09-26",0,0,11,0,0,21,0,0
"New Zealand","2024-09-27",0,0,11,0,0,21,0,0
"New Zealand","2024-09-28",0,0,11,0,0,21,0,0
"New Zealand","2024-09-29",0,0,11,0,0,21,0,0
"New Zealand","2024-09-30",0,0,11,0,0,21,0,0
"New Zealand","2024-10-01",0,0,11,0,0,21,0,0
"New Zealand","2024-10-02",0,0,11,0,1,22,0,0
"New Zealand","2024-10-03",0,0,11,0,0,22,0,0
"New Zealand","2024-10-04",0,0,11,0,0,22,0,0
"New Zealand","2024-10-05",0,0,11,0,0,22,0,0
"New Zealand","2024-10-06",0,0,11,0,0,22,0,0
"New Zealand","2024-10-07",0,0,11,0,0,22,0,0
"New Zealand","2024-10-08",0,0,11,0,0,22,0,0
"New Zealand","2024-10-09",0,0,11,0,0,22,0,0
"New Zealand","2024-10-10",0,0,11,0,0,22,0,0
"New Zealand","2024-10-11",0,0,11,0,1,23,0,0
"New Zealand","2024-10-12",0,0,11,0,0,23,0,0
"New Zealand","2024-10-13",0,0,11,0,0,23,0,0
"New Zealand","2024-10-14",0,0,11,0,0,23,0,0
"New Zealand","2024-10-15",0,12,23,0,0,23,0,0
"New Zealand","2024-10-16",0,0,23,0,0,23,0,0
"New Zealand","2024-10-17",0,0,23,0,0,23,0,0
"New Zealand","2024-10-18",0,0,23,0,0,23,0,0
"New Zealand","2024-10-19",0,0,23,0,0,23,0,0
"New Zealand","2024-10-20",0,0,23,0,0,23,0,0
"New Zealand","2024-10-21",0,0,23,0,0,23,0,0
"New Zealand","2024-10-22",0,0,23,0,0,23,0,0
"New Zealand","2024-10-23",0,0,23,0,0,23,0,0
"New Zealand","2024-10-24",0,0,23,0,0,23,0,0
"New Zealand","2024-10-25",0,0,23,0,0,23,0,0
"New Zealand","2024-10-26",0,0,23,0,1,24,0,0
"New Zealand","2024-10-27",0,0,23,0,0,24,0,0
"New Zealand","2024-10-28",0,0,23,0,0,24,0,0
"New Zealand","2024-10-29",0,0,23,0,0,24,0,0
"New Zealand","2024-10-30",0,0,23,0,0,24,0,0
"New Zealand","2024-10-31",0,0,23,0,0,24,0,0
"New Zealand","2024-11-01",0,0,23,0,0,24,0,0
"New Zealand","2024-11-02",0,0,23,0,0,24,0,0
"New Zealand","2024-11-03",0,0,23,0,0,24,0,0
"New Zealand","2024-11-04",0,1,24,0,0,24,0,0
"New Zealand","2024-11-05",0,0,24,0,0,24,0,0
"New Zealand","2024-11-06",0,0,24,0,0,24,0,0
"New Zealand","2024-11-07",0,0,24,0,0,24,0,0
"New Zealand","2024-11-08",0,0,24,0,0,24,0,0
"New Zealand","2024-11-09",0,0,24,0,0,24,0,0
"New Zealand","2024-11-10",0,0,24,0,1,25,0,0
"New Zealand","2024-11-11",0,0,24,0,0,25,0,0
"New Zealand","2024-11-12",0,0,24,0,0,25,0,0
"New Zealand","2024-11-13",0,0,24,0,0,25,0,0
"New Zealand","2024-11-14",0,0,24,0,0,25,0,0
"New Zealand","2024-11-15",0,0,24,0,0,25,0,0
"New Zealand","2024-11-16",0,0,24,0,0,25,0,0
"New Zealand","2024-11-17",0,0,24,0,0,25,0,0
"New Zealand","2024-11-18",0,0,24,0,0,25,0,0
"New Zealand","2024-11-19",0,0,24,0,0,25,0,0
"New Zealand","2024-11-20",0,0,24,0,1,26,0,0
"New Zealand","2024-11-21",0,0,24,0,0,26,0,0
"New Zealand","2024-11-22",0,0,24,0,0,26,0,0
"New Zealand","2024-11-23",0,0,24,0,0,26,0,0
"New Zealand","2024-11-24",0,0,24,0,0,26,0,0
"New Zealand","2024-11-25",0,0,24,0,0,26,0,0
"New Zealand","2024-11-26",0,0,24,0,0,26,0,0
"New Zealand","2024-11-27",0,0,24,0,0,26,0,0
"New Zealand","2024-11-28",0,0,24,0,0,26,0,0
"New Zealand","2024-11-29",0,0,24,0,0,26,0,0
"New Zealand","2024-11-30",0,0,24,0,1,27,0,0
"New Zealand","2024-12-01",0,0,24,0,0,27,0,0
"New Zealand","2024-12-02",0,0,24,0,0,27,0,0
"New Zealand","2024-12-03",0,0,24,0,0,27,0,0
"New Zealand","2024-12-04",0,0,24,0,0,27,0,0
"New Zealand","2024-12-05",0,3,27,0,0,27,0,0
"New Zealand","2024-12-06",0,0,27,0,0,27,0,0
"New Zealand","2024-12-07",0,0,27,0,0,27,0,0
"New Zealand","2024-12-08",0,0,27,0,0,27,0,0
"New Zealand","2024-12-09",0,0,27,0,0,27,0,0
"New Zealand","2024-12-10",0,0,27,0,0,27,0,0
"New Zealand","2024-12-11",0,0,27,0,0,27,0,0
"New Zealand","2024-12-12",0,0,27,0,0,27,0,0
"New Zealand","2024-12-13",0,0,27,0,0,27,0,0
"New Zealand","2024-12-14",0,0,27,0,0,27,0,0
"New Zealand","2024-12-15",0,0,27,0,0,27,0,0
"New Zealand","2024-12-16",0,0,27,0,0,27,0,0
"New Zealand","2024-12-17",0,0,27,0,0,27,0,0
"New Zealand","2024-12-18",0,0,27,0,0,27,0,0
"New Zealand","2024-12-19",0,0,27,0,0,27,0,0
"New Zealand","2024-12-20",0,0,27,0,0,27,0,0
"New Zealand","2024-12-21",0,0,27,0,0,27,0,0
"New Zealand","2024-12-22",0,0,27,0,0,27,0,0
"New Zealand","2024-12-23",0,0,27,0,0,27,0,0
"New Zealand","2024-12-24",0,0,27,0,0,27,0,0
"New Zealand","2024-12-25",0,0,27,0,0,27,0,0
"New Zealand","2024-12-26",0,0,27,0,0,27,0,0
"New Zealand","2024-12-27",0,0,27,0,0,27,0,0
"New Zealand","2024-12-28",0,0,27,0,0,27,0,0
"New Zealand","2024-12-29",0,0,27,0,0,27,0,0
"New Zealand","2024-12-30",0,0,27,0,0,27,0,0
"New Zealand","2024-12-31",0,0,27,0,0,27,0,0
"New Zealand","2025-01-01",0,0,27,0,0,27,0,0
"New Zealand","2025-01-02",0,0,27,0,0,27,0,0
"New Zealand","2025-01-03",0,0,27,0,0,27,0,0
"New Zealand","2025-01-04",0,0,27,0,0,27,0,0
"New Zealand","2025-01-05",0,0,27,0,0,27,0,0
"New Zealand","2025-01-06",0,0,27,0,0,27,0,0
"New Zealand","2025-01-07",0,0,27,0,0,27,0,0
"New Zealand","2025-01-08",0,0,27,0,0,27,0,0
"New Zealand","2025-01-09",0,0,27,0,0,27,0,0
"New Zealand","2025-01-10",0,0,27,0,0,27,0,0
"New Zealand","2025-01-11",0,0,27,0,0,27,0,0
"New Zealand","2025-01-12",0,0,27,0,0,27,0,0
"New Zealand","2025-01-13",0,0,27,0,0,27,0,0
"Nigeria","2024-01-01",0,0,0,0,0,0,0,0
"Nigeria","2024-01-02",0,0,0,0,0,0,0,0
"Nigeria","2024-01-03",0,0,0,0,0,0,0,0
"Nigeria","2024-01-04",0,0,0,0,0,0,0,0
"Nigeria","2024-01-05",0,0,0,0,0,0,0,0
"Nigeria","2024-01-06",0,0,0,0,0,0,0,0
"Nigeria","2024-01-07",0,0,0,0,0,0,0,0
"Nigeria","2024-01-08",0,0,0,0,0,0,0,0
"Nigeria","2024-01-09",0,0,0,0,0,0,0,0
"Nigeria","2024-01-10",0,0,0,0,0,0,0,0
"Nigeria","2024-01-11",0,0,0,0,0,0,0,0
"Nigeria","2024-01-12",0,0,0,0,0,0,0,0
"Nigeria","2024-01-13",0,0,0,0,0,0,0,0
"Nigeria","2024-01-14",0,0,0,0,0,0,0,0
"Nigeria","2024-01-15",0,0,0,0,0,0,0,0
"Nigeria","2024-01-16",0,0,0,0,0,0,0,0
"Nigeria","2024-01-17",0,0,0,0,0,0,0,0
"Nigeria","2024-01-18",0,0,0,0,0,0,0,0
"Nigeria","2024-01-19",0,0,0,0,0,0,0,0
"Nigeria","2024-01-20",0,0,0,0,0,0,0,0
"Nigeria","2024-01-21",0,0,0,0,0,0,0,0
"Nigeria","2024-01-22",0,0,0,0,0,0,0,0
"Nigeria","2024-01-23",0,0,0,0,0,0,0,0
"Nigeria","2024-01-24",0,0,0,0,0,0,0,0
"Nigeria","2024-01-25",0,0,0,0,0,0,0,0
"Nigeria","2024-01-26",0,0,0,0,0,0,0,0
"Nigeria","2024-01-27",0,0,0,0,0,0,0,0
"Nigeria","2024-01-28",0,2,2,0,2,2,0,0
"Nigeria","2024-01-29",0,0,2,0,0,2,0,0
"Nigeria","2024-01-30",0,0,2,0,0,2,0,0
"Nigeria","2024-01-31",0,0,2,0,0,2,0,0
"Nigeria","2024-02-01",0,0,2,0,1,3,0,0
"Nigeria","2024-02-02",0,0,2,0,0,3,0,0
"Nigeria","2024-02-03",0,0,2,0,0,3,0,0
"Nigeria","2024-02-04",0,0,2,0,0,3,0,0
"Nigeria","2024-02-05",0,0,2,0,0,3,0,0
"Nigeria","2024-02-06",0,0,2,0,0,3,0,0
"Nigeria","2024-02-07",0,0,2,0,0,3,0,0
"Nigeria","2024-02-08",0,0,2,0,1,4,0,0
"Nigeria","2024-02-09",0,0,2,0,0,4,0,0
"Nigeria","2024-02-10",0,0,2,0,0,4,0,0
"Nigeria","2024-02-11",0,2,4,0,0,4,0,0
"Nigeria","2024-02-12",0,0,4,0,0,4,0,0
"Nigeria","2024-02-13",0,0,4,0,1,5,0,0
"Nigeria","2024-02-14",0,0,4,0,0,5,0,0
"Nigeria","2024-02-15",0,0,4,0,0,5,0,0
"Nigeria","2024-02-16",0,0,4,0,0,5,0,0
"Nigeria","2024-02-17",0,0,4,0,1,6,0,0
"Nigeria","2024-02-18",0,2,6,0,0,6,0,0
"Nigeria","2024-02-19",0,0,6,0,0,6,0,0
"Nigeria","2024-02-20",0,0,6,0,0,6,0,0
"Nigeria","2024-02-21",0,0,6,0,1,7,0,0
"Nigeria","2024-02-22",0,0,6,0,0,7,0,0
"Nigeria","2024-02-23",0,0,6,0,0,7,0,0
"Nigeria","2024-02-24",0,0,6,0,0,7,0,0
"Nigeria","2024-02-25",0,0,6,0,0,7,0,0
"Nigeria","2024-02-26",0,0,6,0,1,8,0,0
"Nigeria","2024-02-27",0,0,6,0,0,8,0,0
"Nigeria","2024-02-28",0,0,6,0,0,8,0,0
"Nigeria","2024-02-29",0,0,6,0,0,8,0,0
"Nigeria","2024-03-01",0,0,6,0,0,8,0,0
"Nigeria","2024-03-02",0,0,6,0,0,8,0,0
"Nigeria","2024-03-03",0,0,6,0,1,9,0,0
"Nigeria","2024-03-04",0,0,6,0,0,9,0,0
"Nigeria","2024-03-05",0,0,6,0,0,9,0,0
"Nigeria","2024-03-06",0,0,6,0,0,9,0,0
"Nigeria","2024-03-07",0,0,6,0,0,9,0,0
"Nigeria","2024-03-08",0,0,6,0,1,10,0,0
"Nigeria","2024-03-09",0,0,6,0,0,10,0,0
"Nigeria","2024-03-10",0,4,10,0,0,10,0,0
"Nigeria","2024-03-11",0,0,10,0,0,10,0,0
"Nigeria","2024-03-12",0,0,10,0,1,11,0,0
"Nigeria","2024-03-13",0,0,10,0,0,11,0,0
"Nigeria","2024-03-14",0,0,10,0,0,11,0,0
"Nigeria","2024-03-15",0,0,10,0,0,11,0,0
"Nigeria","2024-03-16",0,0,10,0,1,12,0,0
"Nigeria","2024-03-17",0,2,12,0,0,12,0,0
"Nigeria","2024-03-18",0,0,12,0,0,12,0,0
"Nigeria","2024-03-19",0,0,12,0,1,13,0,0
"Nigeria","2024-03-20",0,0,12,0,0,13,0,0
"Nigeria","2024-03-21",0,0,12,0,1,14,0,0
"Nigeria","2024-03-22",0,0,12,0,0,14,0,0
"Nigeria","2024-03-23",0,0,12,0,1,15,0,0
"Nigeria","2024-03-24",0,0,12,0,0,15,0,0
"Nigeria","2024-03-25",0,0,12,0,0,15,0,0
"Nigeria","2024-03-26",0,0,12,0,1,16,0,0
"Nigeria","2024-03-27",0,0,12,0,0,16,0,0
"Nigeria","2024-03-28",0,0,12,0,1,17,0,0
"Nigeria","2024-03-29",0,0,12,0,0,17,0,0
"Nigeria","2024-03-30",0,0,12,0,1,18,0,0
"Nigeria","2024-03-31",0,6,18,0,0,18,0,0
"Nigeria","2024-04-01",0,0,18,0,0,18,0,0
"Nigeria","2024-04-02",0,0,18,0,0,18,0,0
"Nigeria","2024-04-03",0,0,18,0,0,18,0,0
"Nigeria","2024-04-04",0,0,18,0,1,19,0,0
"Nigeria","2024-04-05",0,0,18,0,0,19,0,0
"Nigeria","2024-04-06",0,0,18,0,0,19,0,0
"Nigeria","2024-04-07",0,1,19,0,0,19,0,0
"Nigeria","2024-04-08",0,0,19,0,0,19,0,0
"Nigeria","2024-04-09",0,0,19,0,0,19,0,0
"Nigeria","2024-04-10",0,0,19,0,0,19,0,0
"Nigeria","2024-04-11",0,0,19,0,1,20,0,0
"Nigeria","2024-04-12",0,0,19,0,0,20,0,0
"Nigeria","2024-04-13",0,0,19,0,0,20,0,0
"Nigeria","2024-04-14",0,1,20,0,0,20,0,0
"Nigeria","2024-04-15",0,0,20,0,0,20,0,0
"Nigeria","2024-04-16",0,0,20,0,0,20,0,0
"Nigeria","2024-04-17",0,0,20,0,0,20,0,0
"Nigeria","2024-04-18",0,0,20,0,1,21,0,0
"Nigeria","2024-04-19",0,0,20,0,0,21,0,0
"Nigeria","2024-04-20",0,0,20,0,0,21,0,0
"Nigeria","2024-04-21",0,0,20,0,0,21,0,0
"Nigeria","2024-04-22",0,0,20,0,0,21,0,0
"Nigeria","2024-04-23",0,0,20,0,0,21,0,0
"Nigeria","2024-04-24",0,0,20,0,0,21,0,0
"Nigeria","2024-04-25",0,0,20,0,1,22,0,0
"Nigeria","2024-04-26",0,0,20,0,0,22,0,0
"Nigeria","2024-04-27",0,0,20,0,0,22,0,0
"Nigeria","2024-04-28",0,2,22,0,0,22,0,0
"Nigeria","2024-04-29",0,0,22,0,0,22,0,0
"Nigeria","2024-04-30",0,0,22,0,1,23,0,0
"Nigeria","2024-05-01",0,0,22,0,0,23,0,0
"Nigeria","2024-05-02",0,0,22,0,0,23,0,0
"Nigeria","2024-05-03",0,0,22,0,0,23,0,0
"Nigeria","2024-05-04",0,0,22,0,1,24,0,0
"Nigeria","2024-05-05",0,2,24,0,0,24,0,0
"Nigeria","2024-05-06",0,0,24,0,0,24,0,0
"Nigeria","2024-05-07",0,0,24,0,0,24,0,0
"Nigeria","2024-05-08",0,0,24,0,0,24,0,0
"Nigeria","2024-05-09",0,0,24,0,0,24,0,0
"Nigeria","2024-05-10",0,0,24,0,0,24,0,0
"Nigeria","2024-05-11",0,0,24,0,1,25,0,0
"Nigeria","2024-05-12",0,0,24,0,0,25,0,0
"Nigeria","2024-05-13",0,0,24,0,0,25,0,0
"Nigeria","2024-05-14",0,0,24,0,0,25,0,0
"Nigeria","2024-05-15",0,0,24,0,0,25,0,0
"Nigeria","2024-05-16",0,0,24,0,0,25,0,0
"Nigeria","2024-05-17",0,0,24,0,0,25,0,0
"Nigeria","2024-05-18",0,0,24,0,0,25,0,0
"Nigeria","2024-05-19",0,0,24,0,0,25,0,0
"Nigeria","2024-05-20",0,0,24,0,0,25,0,0
"Nigeria","2024-05-21",0,0,24,0,1,26,0,0
"Nigeria","2024-05-22",0,0,24,0,0,26,0,0
"Nigeria","2024-05-23",0,0,24,0,0,26,0,0
"Nigeria","2024-05-24",0,0,24,0,0,26,0,0
"Nigeria","2024-05-25",0,0,24,0,0,26,0,0
"Nigeria","2024-05-26",0,2,26,0,0,26,0,0
"Nigeria","2024-05-27",0,0,26,0,0,26,0,0
"Nigeria","2024-05-28",0,0,26,0,0,26,0,0
"Nigeria","2024-05-29",0,0,26,0,0,26,0,0
"Nigeria","2024-05-30",0,0,26,0,1,27,0,0
"Nigeria","2024-05-31",0,0,26,0,0,27,0,0
"Nigeria","2024-06-01",0,0,26,0,0,27,0,0
"Nigeria","2024-06-02",0,1,27,0,0,27,0,0
"Nigeria","2024-06-03",0,0,27,0,0,27,0,0
"Nigeria","2024-06-04",0,0,27,0,0,27,0,0
"Nigeria","2024-06-05",0,0,27,0,0,27,0,0
"Nigeria","2024-06-06",0,0,27,0,1,28,0,0
"Nigeria","2024-06-07",0,0,27,0,0,28,0,0
"Nigeria","2024-06-08",0,0,27,0,0,28,0,0
"Nigeria","2024-06-09",0,1,28,0,0,28,0,0
"Nigeria","2024-06-10",0,0,28,0,0,28,0,0
"Nigeria","2024-06-11",0,0,28,0,1,29,0,0
"Nigeria","2024-06-12",0,0,28,0,0,29,0,0
"Nigeria","2024-06-13",0,0,28,0,0,29,0,0
"Nigeria","2024-06-14",0,0,28,0,0,29,0,0
"Nigeria","2024-06-15",0,0,28,0,1,30,0,0
"Nigeria","2024-06-16",0,2,30,0,0,30,0,0
"Nigeria","2024-06-17",0,0,30,0,0,30,0,0
"Nigeria","2024-06-18",0,0,30,0,0,30,0,0
"Nigeria","2024-06-19",0,0,30,0,0,30,0,0
"Nigeria","2024-06-20",0,0,30,0,1,31,0,0
"Nigeria","2024-06-21",0,0,30,0,0,31,0,0
"Nigeria","2024-06-22",0,0,30,0,0,31,0,0
"Nigeria","2024-06-23",0,1,31,0,0,31,0,0
"Nigeria","2024-06-24",0,0,31,0,0,31,0,0
"Nigeria","2024-06-25",0,0,31,0,1,32,0,0
"Nigeria","2024-06-26",0,0,31,0,0,32,0,0
"Nigeria","2024-06-27",0,0,31,0,1,33,0,0
"Nigeria","2024-06-28",0,0,31,0,0,33,0,0
"Nigeria","2024-06-29",0,0,31,0,1,34,0,0
"Nigeria","2024-06-30",0,3,34,0,0,34,0,0
"Nigeria","2024-07-01",0,0,34,0,0,34,0,0
"Nigeria","2024-07-02",0,0,34,0,1,35,0,0
"Nigeria","2024-07-03",0,0,34,0,0,35,0,0
"Nigeria","2024-07-04",0,0,34,0,1,36,0,0
"Nigeria","2024-07-05",0,0,34,0,0,36,0,0
"Nigeria","2024-07-06",0,0,34,0,1,37,0,0
"Nigeria","2024-07-07",0,3,37,0,0,37,0,0
"Nigeria","2024-07-08",0,0,37,0,0,37,0,0
"Nigeria","2024-07-09",0,0,37,0,0,37,0,0
"Nigeria","2024-07-10",0,0,37,0,0,37,0,0
"Nigeria","2024-07-11",0,0,37,0,0,37,0,0
"Nigeria","2024-07-12",0,0,37,0,0,37,0,0
"Nigeria","2024-07-13",0,0,37,0,0,37,0,0
"Nigeria","2024-07-14",0,0,37,0,0,37,0,0
"Nigeria","2024-07-15",0,0,37,0,1,38,0,0
"Nigeria","2024-07-16",0,0,37,0,0,38,0,0
"Nigeria","2024-07-17",0,0,37,0,0,38,0,0
"Nigeria","2024-07-18",0,0,37,0,0,38,0,0
"Nigeria","2024-07-19",0,0,37,0,0,38,0,0
"Nigeria","2024-07-20",0,0,37,0,0,38,0,0
"Nigeria","2024-07-21",0,1,38,0,0,38,0,0
"Nigeria","2024-07-22",0,0,38,0,0,38,0,0
"Nigeria","2024-07-23",0,0,38,0,0,38,0,0
"Nigeria","2024-07-24",0,0,38,0,0,38,0,0
"Nigeria","2024-07-25",0,0,38,0,0,38,0,0
"Nigeria","2024-07-26",0,0,38,0,0,38,0,0
"Nigeria","2024-07-27",0,0,38,0,0,38,0,0
"Nigeria","2024-07-28",0,0,38,0,0,38,0,0
"Nigeria","2024-07-29",0,0,38,0,0,38,0,0
"Nigeria","2024-07-30",0,0,38,0,0,38,0,0
"Nigeria","2024-07-31",0,0,38,0,0,38,0,0
"Nigeria","2024-08-01",0,0,38,0,1,39,0,0
"Nigeria","2024-08-02",0,0,38,0,0,39,0,0
"Nigeria","2024-08-03",0,0,38,0,0,39,0,0
"Nigeria","2024-08-04",0,0,38,0,0,39,0,0
"Nigeria","2024-08-05",0,0,38,0,0,39,0,0
"Nigeria","2024-08-06",0,0,38,0,0,39,0,0
"Nigeria","2024-08-07",0,0,38,0,0,39,0,0
"Nigeria","2024-08-08",0,0,38,0,0,39,0,0
"Nigeria","2024-08-09",0,0,38,0,0,39,0,0
"Nigeria","2024-08-10",0,0,38,0,0,39,0,0
"Nigeria","2024-08-11",0,1,39,0,0,39,0,0
"Nigeria","2024-08-12",0,0,39,0,0,39,0,0
"Nigeria","2024-08-13",0,0,39,0,0,39,0,0
"Nigeria","2024-08-14",0,0,39,0,0,39,0,0
"Nigeria","2024-08-15",0,0,39,0,1,40,0,0
"Nigeria","2024-08-16",0,0,39,0,0,40,0,0
"Nigeria","2024-08-17",0,0,39,0,0,40,0,0
"Nigeria","2024-08-18",802,1,40,802,0,40,802,802
"Nigeria","2024-08-19",0,0,40,802,1,41,9,811
"Nigeria","2024-08-20",0,0,40,802,2,43,10,821
"Nigeria","2024-08-21",0,0,40,802,1,44,9,830
"Nigeria","2024-08-22",0,0,40,802,2,46,9,839
"Nigeria","2024-08-23",0,0,40,802,1,47,9,848
"Nigeria","2024-08-24",0,0,40,802,2,49,10,858
"Nigeria","2024-08-25",65,10,50,867,1,50,9,867
"Nigeria","2024-08-26",0,0,50,867,1,51,8,875
"Nigeria","2024-08-27",0,0,50,867,1,52,7,882
"Nigeria","2024-08-28",0,0,50,867,1,53,8,890
"Nigeria","2024-08-29",0,0,50,867,2,55,7,897
"Nigeria","2024-08-30",0,0,50,867,1,56,8,905
"Nigeria","2024-08-31",0,0,50,867,1,57,7,912
"Nigeria","2024-09-01",53,8,58,920,1,58,8,920
"Nigeria","2024-09-02",0,0,58,920,1,59,10,930
"Nigeria","2024-09-03",0,0,58,920,2,61,11,941
"Nigeria","2024-09-04",0,0,58,920,1,62,10,951
"Nigeria","2024-09-05",0,0,58,920,1,63,10,961
"Nigeria","2024-09-06",0,0,58,920,1,64,10,971
"Nigeria","2024-09-07",0,0,58,920,2,66,11,982
"Nigeria","2024-09-08",72,9,67,992,1,67,10,992
"Nigeria","2024-09-09",0,0,67,992,1,68,9,1001
"Nigeria","2024-09-10",0,0,67,992,1,69,9,1010
"Nigeria","2024-09-11",0,0,67,992,1,70,9,1019
"Nigeria","2024-09-12",0,0,67,992,0,70,9,1028
"Nigeria","2024-09-13",0,0,67,992,1,71,9,1037
"Nigeria","2024-09-14",0,0,67,992,1,72,9,1046
"Nigeria","2024-09-15",63,6,73,1055,1,73,9,1055
"Nigeria","2024-09-16",0,0,73,1055,1,74,10,1065
"Nigeria","2024-09-17",0,0,73,1055,0,74,11,1076
"Nigeria","2024-09-18",0,0,73,1055,1,75,10,1086
"Nigeria","2024-09-19",0,0,73,1055,1,76,10,1096
"Nigeria","2024-09-20",0,0,73,1055,1,77,10,1106
"Nigeria","2024-09-21",0,0,73,1055,0,77,11,1117
"Nigeria","2024-09-22",72,5,78,1127,1,78,10,1127
"Nigeria","2024-09-23",0,0,78,1127,1,79,8,1135
"Nigeria","2024-09-24",0,0,78,1127,2,81,7,1142
"Nigeria","2024-09-25",0,0,78,1127,1,82,8,1150
"Nigeria","2024-09-26",0,0,78,1127,2,84,8,1158
"Nigeria","2024-09-27",0,0,78,1127,1,85,8,1166
"Nigeria","2024-09-28",0,0,78,1127,2,87,7,1173
"Nigeria","2024-09-29",54,10,88,1181,1,88,8,1181
"Nigeria","2024-09-30",0,0,88,1181,1,89,8,1189
"Nigeria","2024-10-01",0,0,88,1181,1,90,8,1197
"Nigeria","2024-10-02",0,0,88,1181,1,91,8,1205
"Nigeria","2024-10-03",0,0,88,1181,0,91,8,1213
"Nigeria","2024-10-04",0,0,88,1181,1,92,8,1221
"Nigeria","2024-10-05",0,0,88,1181,1,93,8,1229
"Nigeria","2024-10-06",56,6,94,1237,1,94,8,1237
"Nigeria","2024-10-07",0,0,94,1237,1,95,2,1239
"Nigeria","2024-10-08",0,0,94,1237,1,96,3,1242
"Nigeria","2024-10-09",0,0,94,1237,1,97,2,1244
"Nigeria","2024-10-10",0,0,94,1237,2,99,3,1247
"Nigeria","2024-10-11",0,0,94,1237,1,100,2,1249
"Nigeria","2024-10-12",0,0,94,1237,1,101,2,1251
"Nigeria","2024-10-13",0,8,102,1237,1,102,3,1254
"Nigeria","2024-10-14",0,0,102,1237,1,103,2,1256
"Nigeria","2024-10-15",0,0,102,1237,1,104,2,1258
"Nigeria","2024-10-16",0,0,102,1237,1,105,3,1261
"Nigeria","2024-10-17",0,0,102,1237,0,105,2,1263
"Nigeria","2024-10-18",0,0,102,1237,1,106,3,1266
"Nigeria","2024-10-19",0,0,102,1237,1,107,2,1268
"Nigeria","2024-10-20",0,6,108,1237,1,108,2,1270
"Nigeria","2024-10-21",0,0,108,1237,1,109,3,1273
"Nigeria","2024-10-22",0,0,108,1237,2,111,2,1275
"Nigeria","2024-10-23",0,0,108,1237,1,112,2,1277
"Nigeria","2024-10-24",0,0,108,1237,2,114,3,1280
"Nigeria","2024-10-25",0,0,108,1237,1,115,2,1282
"Nigeria","2024-10-26",0,0,108,1237,2,117,3,1285
"Nigeria","2024-10-27",50,10,118,1287,1,118,2,1287
"Nigeria","2024-10-28",0,0,118,1287,1,119,5,1292
"Nigeria","2024-10-29",0,0,118,1287,1,120,6,1298
"Nigeria","2024-10-30",0,0,118,1287,1,121,5,1303
"Nigeria","2024-10-31",0,0,118,1287,0,121,5,1308
"Nigeria","2024-11-01",0,0,118,1287,1,122,5,1313
"Nigeria","2024-11-02",0,0,118,1287,1,123,6,1319
"Nigeria","2024-11-03",37,6,124,1324,1,124,5,1324
"Nigeria","2024-11-04",0,0,124,1324,2,126,0,1324
"Nigeria","2024-11-05",0,0,124,1324,2,128,0,1324
"Nigeria","2024-11-06",0,0,124,1324,2,130,0,1324
"Nigeria","2024-11-07",0,0,124,1324,1,131,0,1324
"Nigeria","2024-11-08",0,0,124,1324,2,133,0,1324
"Nigeria","2024-11-09",0,0,124,1324,2,135,0,1324
"Nigeria","2024-11-10",0,13,137,1324,2,137,0,1324
"Nigeria","2024-11-11",0,0,137,1324,1,138,0,1324
"Nigeria","2024-11-12",0,0,137,1324,1,139,0,1324
"Nigeria","2024-11-13",0,0,137,1324,1,140,0,1324
"Nigeria","2024-11-14",0,0,137,1324,0,140,0,1324
"Nigeria","2024-11-15",0,0,137,1324,1,141,0,1324
"Nigeria","2024-11-16",0,0,137,1324,1,142,0,1324
"Nigeria","2024-11-17",0,6,143,1324,1,143,0,1324
"Nigeria","2024-11-18",0,0,143,1324,0,143,0,1324
"Nigeria","2024-11-19",0,0,143,1324,1,144,0,1324
"Nigeria","2024-11-20",0,0,143,1324,0,144,0,1324
"Nigeria","2024-11-21",0,0,143,1324,0,144,0,1324
"Nigeria","2024-11-22",0,0,143,1324,0,144,0,1324
"Nigeria","2024-11-23",0,0,143,1324,1,145,0,1324
"Nigeria","2024-11-24",0,2,145,1324,0,145,0,1324
"Nigeria","2024-11-25",0,0,145,1324,1,146,0,1324
"Nigeria","2024-11-26",0,0,145,1324,1,147,0,1324
"Nigeria","2024-11-27",0,0,145,1324,1,148,0,1324
"Nigeria","2024-11-28",0,0,145,1324,1,149,0,1324
"Nigeria","2024-11-29",0,0,145,1324,1,150,0,1324
"Nigeria","2024-11-30",0,0,145,1324,1,151,0,1324
"Nigeria","2024-12-01",0,7,152,1324,1,152,0,1324
"Nigeria","2024-12-02",0,0,152,1324,2,154,0,1324
"Nigeria","2024-12-03",0,0,152,1324,2,156,0,1324
"Nigeria","2024-12-04",0,0,152,1324,2,158,0,1324
"Nigeria","2024-12-05",0,0,152,1324,3,161,0,1324
"Nigeria","2024-12-06",0,0,152,1324,2,163,0,1324
"Nigeria","2024-12-07",0,0,152,1324,2,165,0,1324
"Nigeria","2024-12-08",0,15,167,1324,2,167,0,1324
"Nigeria","2024-12-09",0,0,167,1324,0,167,0,1324
"Nigeria","2024-12-10",0,0,167,1324,0,167,0,1324
"Nigeria","2024-12-11",0,0,167,1324,0,167,0,1324
"Nigeria","2024-12-12",0,0,167,1324,0,167,0,1324
"Nigeria","2024-12-13",0,0,167,1324,0,167,0,1324
"Nigeria","2024-12-14",0,0,167,1324,0,167,0,1324
"Nigeria","2024-12-15",0,0,167,1324,0,167,0,1324
"Nigeria","2024-12-16",0,0,167,1324,0,167,0,1324
"Nigeria","2024-12-17",0,0,167,1324,0,167,0,1324
"Nigeria","2024-12-18",0,0,167,1324,0,167,0,1324
"Nigeria","2024-12-19",0,0,167,1324,0,167,0,1324
"Nigeria","2024-12-20",0,0,167,1324,0,167,0,1324
"Nigeria","2024-12-21",0,0,167,1324,0,167,0,1324
"Nigeria","2024-12-22",0,0,167,1324,0,167,0,1324
"Nigeria","2024-12-23",0,0,167,1324,0,167,0,1324
"Nigeria","2024-12-24",0,0,167,1324,0,167,0,1324
"Nigeria","2024-12-25",0,0,167,1324,0,167,0,1324
"Nigeria","2024-12-26",0,0,167,1324,0,167,0,1324
"Nigeria","2024-12-27",0,0,167,1324,0,167,0,1324
"Nigeria","2024-12-28",0,0,167,1324,0,167,0,1324
"Nigeria","2024-12-29",0,0,167,1324,0,167,0,1324
"Nigeria","2024-12-30",0,0,167,1324,0,167,0,1324
"Nigeria","2024-12-31",0,0,167,1324,0,167,0,1324
"Nigeria","2025-01-01",0,0,167,1324,0,167,0,1324
"Nigeria","2025-01-02",0,0,167,1324,0,167,0,1324
"Nigeria","2025-01-03",0,0,167,1324,0,167,0,1324
"Nigeria","2025-01-04",0,0,167,1324,0,167,0,1324
"Nigeria","2025-01-05",0,0,167,1324,0,167,0,1324
"Nigeria","2025-01-06",0,0,167,1324,0,167,0,1324
"Nigeria","2025-01-07",0,0,167,1324,0,167,0,1324
"Nigeria","2025-01-08",0,0,167,1324,0,167,0,1324
"Nigeria","2025-01-09",0,0,167,1324,0,167,0,1324
"Nigeria","2025-01-10",0,0,167,1324,0,167,0,1324
"Nigeria","2025-01-11",0,0,167,1324,0,167,0,1324
"Nigeria","2025-01-12",0,0,167,1324,0,167,0,1324
"Nigeria","2025-01-13",0,0,167,1324,0,167,0,1324
"North America","2024-01-01",0,0,0,0,0,0,0,0
"North America","2024-01-02",0,50,50,0,50,50,0,0
"North America","2024-01-03",0,0,50,0,8,58,0,0
"North America","2024-01-04",0,0,50,0,9,67,0,0
"North America","2024-01-05",0,0,50,0,8,75,0,0
"North America","2024-01-06",0,0,50,0,8,83,0,0
"North America","2024-01-07",0,0,50,0,8,91,0,0
"North America","2024-01-08",0,0,50,0,9,100,0,0
"North America","2024-01-09",0,58,108,0,8,108,0,0
"North America","2024-01-10",0,0,108,0,11,119,0,0
"North America","2024-01-11",0,0,108,0,10,129,0,0
"North America","2024-01-12",0,0,108,0,11,140,0,0
"North America","2024-01-13",0,0,108,0,10,150,0,0
"North America","2024-01-14",0,0,108,0,11,161,0,0
"North America","2024-01-15",0,0,108,0,10,171,0,0
"North America","2024-01-16",0,74,182,0,11,182,0,0
"North America","2024-01-17",0,0,182,0,7,189,0,0
"North America","2024-01-18",0,0,182,0,8,197,0,0
"North America","2024-01-19",0,0,182,0,7,204,0,0
"North America","2024-01-20",0,0,182,0,8,212,0,0
"North America","2024-01-21",0,0,182,0,7,219,0,0
"North America","2024-01-22",0,0,182,0,8,227,0,0
"North America","2024-01-23",0,52,234,0,7,234,0,0
"North America","2024-01-24",0,0,234,0,13,247,0,0
"North America","2024-01-25",0,0,234,0,12,259,0,0
"North America","2024-01-26",0,0,234,0,13,272,0,0
"North America","2024-01-27",0,0,234,0,13,285,0,0
"North America","2024-01-28",0,0,234,0,13,298,0,0
"North America","2024-01-29",0,0,234,0,12,310,0,0
"North America","2024-01-30",0,89,323,0,13,323,0,0
"North America","2024-01-31",0,0,323,0,10,333,0,0
"North America","2024-02-01",0,0,323,0,9,342,0,0
"North America","2024-02-02",0,0,323,0,10,352,0,0
"North America","2024-02-03",0,0,323,0,9,361,0,0
"North America","2024-02-04",0,0,323,0,10,371,0,0
"North America","2024-02-05",0,0,323,0,9,380,0,0
"North America","2024-02-06",0,67,390,0,10,390,0,0
"North America","2024-02-07",0,0,390,0,10,400,0,0
"North America","2024-02-08",0,0,390,0,9,409,0,0
"North America","2024-02-09",0,0,390,0,10,419,0,0
"North America","2024-02-10",0,0,390,0,9,428,0,0
"North America","2024-02-11",0,0,390,0,10,438,0,0
"North America","2024-02-12",0,0,390,0,9,447,0,0
"North America","2024-02-13",0,67,457,0,10,457,0,0
"North America","2024-02-14",0,0,457,0,10,467,0,0
"North America","2024-02-15",0,0,457,0,9,476,0,0
"North America","2024-02-16",0,0,457,0,10,486,0,0
"North America","2024-02-17",0,0,457,0,10,496,0,0
"North America","2024-02-18",0,0,457,0,10,506,0,0
"North America","2024-02-19",0,0,457,0,9,515,0,0
"North America","2024-02-20",0,68,525,0,10,525,0,0
"North America","2024-02-21",0,0,525,0,11,536,0,0
"North America","2024-02-22",0,0,525,0,11,547,0,0
"North America","2024-02-23",0,0,525,0,11,558,0,0
"North America","2024-02-24",0,0,525,0,11,569,0,0
"North America","2024-02-25",0,0,525,0,11,580,0,0
"North America","2024-02-26",0,0,525,0,11,591,0,0
"North America","2024-02-27",0,77,602,0,11,602,0,0
"North America","2024-02-28",0,0,602,0,11,613,0,0
"North America","2024-02-29",0,0,602,0,11,624,0,0
"North America","2024-03-01",0,0,602,0,11,635,0,0
"North America","2024-03-02",0,0,602,0,10,645,0,0
"North America","2024-03-03",0,0,602,0,11,656,0,0
"North America","2024-03-04",0,0,602,0,11,667,0,0
"North America","2024-03-05",0,76,678,0,11,678,0,0
"North America","2024-03-06",0,0,678,0,12,690,0,0
"North America","2024-03-07",0,0,678,0,11,701,0,0
"North America","2024-03-08",0,0,678,0,12,713,0,0
"North America","2024-03-09",0,0,678,0,12,725,0,0
"North America","2024-03-10",0,0,678,0,12,737,0,0
"North America","2024-03-11",0,0,678,0,11,748,0,0
"North America","2024-03-12",0,82,760,0,12,760,0,0
"North America","2024-03-13",0,0,760,0,8,768,0,0
"North America","2024-03-14",0,0,760,0,9,777,0,0
"North America","2024-03-15",0,0,760,0,8,785,0,0
"North America","2024-03-16",0,0,760,0,8,793,0,0
"North America","2024-03-17",0,0,760,0,8,801,0,0
"North America","2024-03-18",0,0,760,0,9,810,0,0
"North America","2024-03-19",0,58,818,0,8,818,0,0
"North America","2024-03-20",0,0,818,0,10,828,0,0
"North America","2024-03-21",0,0,818,0,10,838,0,0
"North America","2024-03-22",0,0,818,0,10,848,0,0
"North America","2024-03-23",0,0,818,0,9,857,0,0
"North America","2024-03-24",0,0,818,0,10,867,0,0
"North America","2024-03-25",0,0,818,0,10,877,0,0
"North America","2024-03-26",0,69,887,0,10,887,0,0
"North America","2024-03-27",0,0,887,0,7,894,0,0
"North America","2024-03-28",0,0,887,0,8,902,0,0
"North America","2024-03-29",0,0,887,0,7,909,0,0
"North America","2024-03-30",0,0,887,0,8,917,0,0
"North America","2024-03-31",0,0,887,0,7,924,0,0
"North America","2024-04-01",0,0,887,0,8,932,0,0
"North America","2024-04-02",0,52,939,0,7,939,0,0
"North America","2024-04-03",0,0,939,0,10,949,0,0
"North America","2024-04-04",0,0,939,0,11,960,0,0
"North America","2024-04-05",0,0,939,0,10,970,0,0
"North America","2024-04-06",0,0,939,0,10,980,0,0
"North America","2024-04-07",0,0,939,0,10,990,0,0
"North America","2024-04-08",0,0,939,0,11,1001,0,0
"North America","2024-04-09",0,72,1011,0,10,1011,0,0
"North America","2024-04-10",0,0,1011,0,12,1023,0,0
"North America","2024-04-11",0,0,1011,0,12,1035,0,0
"North America","2024-04-12",0,0,1011,0,12,1047,0,0
"North America","2024-04-13",0,0,1011,0,12,1059,0,0
"North America","2024-04-14",0,0,1011,0,12,1071,0,0
"North America","2024-04-15",0,0,1011,0,12,1083,0,0
"North America","2024-04-16",0,84,1095,0,12,1095,0,0
"North America","2024-04-17",0,0,1095,0,12,1107,0,0
"North America","2024-04-18",0,0,1095,0,13,1120,0,0
"North America","2024-04-19",0,0,1095,0,12,1132,0,0
"North America","2024-04-20",0,0,1095,0,12,1144,0,0
"North America","2024-04-21",0,0,1095,0,12,1156,0,0
"North America","2024-04-22",0,0,1095,0,13,1169,0,0
"North America","2024-04-23",0,86,1181,0,12,1181,0,0
"North America","2024-04-24",0,0,1181,0,8,1189,0,0
"North America","2024-04-25",0,0,1181,0,8,1197,0,0
"North America","2024-04-26",0,0,1181,0,8,1205,0,0
"North America","2024-04-27",0,0,1181,0,7,1212,0,0
"North America","2024-04-28",0,0,1181,0,8,1220,0,0
"North America","2024-04-29",0,0,1181,0,8,1228,0,0
"North America","2024-04-30",0,55,1236,0,8,1236,0,0
"North America","2024-05-01",0,0,1236,0,8,1244,0,0
"North America","2024-05-02",0,0,1236,0,9,1253,0,0
"North America","2024-05-03",0,0,1236,0,8,1261,0,0
"North America","2024-05-04",0,0,1236,0,8,1269,0,0
"North America","2024-05-05",0,0,1236,0,8,1277,0,0
"North America","2024-05-06",0,0,1236,0,9,1286,0,0
"North America","2024-05-07",0,58,1294,0,8,1294,0,0
"North America","2024-05-08",0,0,1294,0,9,1303,0,0
"North America","2024-05-09",0,0,1294,0,9,1312,0,0
"North America","2024-05-10",0,0,1294,0,9,1321,0,0
"North America","2024-05-11",0,0,1294,0,9,1330,0,0
"North America","2024-05-12",0,0,1294,0,9,1339,0,0
"North America","2024-05-13",0,0,1294,0,9,1348,0,0
"North America","2024-05-14",0,63,1357,0,9,1357,0,0
"North America","2024-05-15",0,0,1357,0,9,1366,0,0
"North America","2024-05-16",0,0,1357,0,9,1375,0,0
"North America","2024-05-17",0,0,1357,0,9,1384,0,0
"North America","2024-05-18",0,0,1357,0,10,1394,0,0
"North America","2024-05-19",0,0,1357,0,9,1403,0,0
"North America","2024-05-20",0,0,1357,0,9,1412,0,0
"North America","2024-05-21",0,64,1421,0,9,1421,0,0
"North America","2024-05-22",0,0,1421,0,10,1431,0,0
"North America","2024-05-23",0,0,1421,0,11,1442,0,0
"North America","2024-05-24",0,0,1421,0,10,1452,0,0
"North America","2024-05-25",0,0,1421,0,10,1462,0,0
"North America","2024-05-26",0,0,1421,0,10,1472,0,0
"North America","2024-05-27",0,0,1421,0,11,1483,0,0
"North America","2024-05-28",0,72,1493,0,10,1493,0,0
"North America","2024-05-29",0,0,1493,0,10,1503,0,0
"North America","2024-05-30",0,0,1493,0,9,1512,0,0
"North America","2024-05-31",0,0,1493,0,10,1522,0,0
"North America","2024-06-01",0,0,1493,0,10,1532,0,0
"North America","2024-06-02",0,0,1493,0,10,1542,0,0
"North America","2024-06-03",0,0,1493,0,9,1551,0,0
"North America","2024-06-04",0,68,1561,0,10,1561,0,0
"North America","2024-06-05",0,0,1561,0,12,1573,0,0
"North America","2024-06-06",0,0,1561,0,11,1584,0,0
"North America","2024-06-07",0,0,1561,0,12,1596,0,0
"North America","2024-06-08",0,0,1561,0,11,1607,0,0
"North America","2024-06-09",0,0,1561,0,12,1619,0,0
"North America","2024-06-10",0,0,1561,0,11,1630,0,0
"North America","2024-06-11",0,81,1642,0,12,1642,0,0
"North America","2024-06-12",0,0,1642,0,8,1650,0,0
"North America","2024-06-13",0,0,1642,0,8,1658,0,0
"North America","2024-06-14",0,0,1642,0,8,1666,0,0
"North America","2024-06-15",0,0,1642,0,7,1673,0,0
"North America","2024-06-16",0,0,1642,0,8,1681,0,0
"North America","2024-06-17",0,0,1642,0,8,1689,0,0
"North America","2024-06-18",0,55,1697,0,8,1697,0,0
"North America","2024-06-19",0,0,1697,0,8,1705,0,0
"North America","2024-06-20",0,0,1697,0,9,1714,0,0
"North America","2024-06-21",0,0,1697,0,8,1722,0,0
"North America","2024-06-22",0,0,1697,0,8,1730,0,0
"North America","2024-06-23",0,0,1697,0,8,1738,0,0
"North America","2024-06-24",0,0,1697,0,9,1747,0,0
"North America","2024-06-25",0,58,1755,0,8,1755,0,0
"North America","2024-06-26",0,0,1755,0,9,1764,0,0
"North America","2024-06-27",0,0,1755,0,9,1773,0,0
"North America","2024-06-28",0,0,1755,0,9,1782,0,0
"North America","2024-06-29",0,0,1755,0,10,1792,0,0
"North America","2024-06-30",0,0,1755,0,9,1801,0,0
"North America","2024-07-01",0,0,1755,0,9,1810,0,0
"North America","2024-07-02",0,64,1819,0,9,1819,0,0
"North America","2024-07-03",0,0,1819,0,9,1828,0,0
"North America","2024-07-04",0,0,1819,0,10,1838,0,0
"North America","2024-07-05",0,0,1819,0,9,1847,0,0
"North America","2024-07-06",0,0,1819,0,9,1856,0,0
"North America","2024-07-07",0,0,1819,0,9,1865,0,0
"North America","2024-07-08",0,0,1819,0,10,1875,0,0
"North America","2024-07-09",0,65,1884,0,9,1884,0,0
"North America","2024-07-10",0,0,1884,0,11,1895,0,0
"North America","2024-07-11",0,0,1884,0,11,1906,0,0
"North America","2024-07-12",0,0,1884,0,11,1917,0,0
"North America","2024-07-13",0,0,1884,0,12,1929,0,0
"North America","2024-07-14",0,0,1884,0,11,1940,0,0
"North America","2024-07-15",0,0,1884,0,11,1951,0,0
"North America","2024-07-16",0,78,1962,0,11,1962,0,0
"North America","2024-07-17",0,0,1962,0,9,1971,0,0
"North America","2024-07-18",0,0,1962,0,9,1980,0,0
"North America","2024-07-19",0,0,1962,0,9,1989,0,0
"North America","2024-07-20",0,0,1962,0,8,1997,0,0
"North America","2024-07-21",0,0,1962,0,9,2006,0,0
"North America","2024-07-22",0,0,1962,0,9,2015,0,0
"North America","2024-07-23",0,62,2024,0,9,2024,0,0
"North America","2024-07-24",0,0,2024,0,10,2034,0,0
"North America","2024-07-25",0,0,2024,0,9,2043,0,0
"North America","2024-07-26",0,0,2024,0,10,2053,0,0
"North America","2024-07-27",0,0,2024,0,10,2063,0,0
"North America","2024-07-28",0,0,2024,0,10,2073,0,0
"North America","2024-07-29",0,0,2024,0,9,2082,0,0
"North America","2024-07-30",0,68,2092,0,10,2092,0,0
"North America","2024-07-31",0,0,2092,0,11,2103,0,0
"North America","2024-08-01",0,0,2092,0,12,2115,0,0
"North America","2024-08-02",0,0,2092,0,11,2126,0,0
"North America","2024-08-03",0,0,2092,0,12,2138,0,0
"North America","2024-08-04",0,0,2092,0,11,2149,0,0
"North America","2024-08-05",0,0,2092,0,12,2161,0,0
"North America","2024-08-06",0,80,2172,0,11,2172,0,0
"North America","2024-08-07",0,0,2172,0,13,2185,0,0
"North America","2024-08-08",0,0,2172,0,13,2198,0,0
"North America","2024-08-09",0,0,2172,0,13,2211,0,0
"North America","2024-08-10",0,0,2172,0,12,2223,0,0
"North America","2024-08-11",0,0,2172,0,13,2236,0,0
"North America","2024-08-12",0,0,2172,0,13,2249,0,0
"North America","2024-08-13",0,90,2262,0,13,2262,0,0
"North America","2024-08-14",0,0,2262,0,11,2273,0,0
"North America","2024-08-15",0,0,2262,0,10,2283,0,0
"North America","2024-08-16",0,0,2262,0,11,2294,0,0
"North America","2024-08-17",0,0,2262,0,10,2304,0,0
"North America","2024-08-18",0,0,2262,0,11,2315,0,0
"North America","2024-08-19",0,0,2262,0,10,2325,0,0
"North America","2024-08-20",0,74,2336,0,11,2336,0,0
"North America","2024-08-21",0,0,2336,0,12,2348,0,0
"North America","2024-08-22",0,0,2336,0,12,2360,0,0
"North America","2024-08-23",0,0,2336,0,12,2372,0,0
"North America","2024-08-24",0,0,2336,0,13,2385,0,0
"North America","2024-08-25",0,0,2336,0,12,2397,0,0
"North America","2024-08-26",0,0,2336,0,12,2409,0,0
"North America","2024-08-27",0,85,2421,0,12,2421,0,0
"North America","2024-08-28",0,0,2421,0,12,2433,0,0
"North America","2024-08-29",0,0,2421,0,12,2445,0,0
"North America","2024-08-30",0,0,2421,0,12,2457,0,0
"North America","2024-08-31",0,0,2421,0,13,2470,0,0
"North America","2024-09-01",0,0,2421,0,12,2482,0,0
"North America","2024-09-02",0,0,2421,0,12,2494,0,0
"North America","2024-09-03",0,85,2506,0,12,2506,0,0
"North America","2024-09-04",0,0,2506,0,12,2518,0,0
"North America","2024-09-05",0,0,2506,0,13,2531,0,0
"North America","2024-09-06",0,0,2506,0,12,2543,0,0
"North America","2024-09-07",0,0,2506,0,13,2556,0,0
"North America","2024-09-08",0,0,2506,0,12,2568,0,0
"North America","2024-09-09",0,0,2506,0,13,2581,0,0
"North America","2024-09-10",0,87,2593,0,12,2593,0,0
"North America","2024-09-11",0,0,2593,0,10,2603,0,0
"North America","2024-09-12",0,0,2593,0,9,2612,0,0
"North America","2024-09-13",0,0,2593,0,10,2622,0,0
"North America","2024-09-14",0,0,2593,0,9,2631,0,0
"North America","2024-09-15",0,0,2593,0,10,2641,0,0
"North America","2024-09-16",0,0,2593,0,9,2650,0,0
"North America","2024-09-17",0,67,2660,0,10,2660,0,0
"North America","2024-09-18",0,0,2660,0,11,2671,0,0
"North America","2024-09-19",0,0,2660,0,11,2682,0,0
"North America","2024-09-20",0,0,2660,0,11,2693,0,0
"North America","2024-09-21",0,0,2660,0,11,2704,0,0
"North America","2024-09-22",0,0,2660,0,11,2715,0,0
"North America","2024-09-23",0,0,2660,0,11,2726,0,0
"North America","2024-09-24",0,77,2737,0,11,2737,0,0
"North America","2024-09-25",0,0,2737,0,9,2746,0,0
"North America","2024-09-26",0,0,2737,0,8,2754,0,0
"North America","2024-09-27",0,0,2737,0,9,2763,0,0
"North America","2024-09-28",0,0,2737,0,8,2771,0,0
"North America","2024-09-29",0,0,2737,0,9,2780,0,0
"North America","2024-09-30",0,0,2737,0,8,2788,0,0
"North America","2024-10-01",0,60,2797,0,9,2797,0,0
"North America","2024-10-02",0,0,2797,0,7,2804,0,0
"North America","2024-10-03",0,0,2797,0,7,2811,0,0
"North America","2024-10-04",0,0,2797,0,7,2818,0,0
"North America","2024-10-05",0,0,2797,0,8,2826,0,0
"North America","2024-10-06",0,0,2797,0,7,2833,0,0
"North America","2024-10-07",0,0,2797,0,7,2840,0,0
"North America","2024-10-08",0,50,2847,0,7,2847,0,0
"North America","2024-10-09",0,0,2847,0,5,2852,0,0
"North America","2024-10-10",0,0,2847,0,5,2857,0,0
"North America","2024-10-11",0,0,2847,0,5,2862,0,0
"North America","2024-10-12",0,0,2847,0,5,2867,0,0
"North America","2024-10-13",0,0,2847,0,5,2872,0,0
"North America","2024-10-14",0,0,2847,0,5,2877,0,0
"North America","2024-10-15",0,35,2882,0,5,2882,0,0
"North America","2024-10-16",0,0,2882,0,7,2889,0,0
"North America","2024-10-17",0,0,2882,0,6,2895,0,0
"North America","2024-10-18",0,0,2882,0,7,2902,0,0
"North America","2024-10-19",0,0,2882,0,7,2909,0,0
"North America","2024-10-20",0,0,2882,0,7,2916,0,0
"North America","2024-10-21",0,0,2882,0,6,2922,0,0
"North America","2024-10-22",0,47,2929,0,7,2929,0,0
"North America","2024-10-23",0,0,2929,0,4,2933,0,0
"North America","2024-10-24",0,0,2929,0,5,2938,0,0
"North America","2024-10-25",0,0,2929,0,4,2942,0,0
"North America","2024-10-26",0,0,2929,0,5,2947,0,0
"North America","2024-10-27",0,0,2929,0,4,2951,0,0
"North America","2024-10-28",0,0,2929,0,5,2956,0,0
"North America","2024-10-29",0,31,2960,0,4,2960,0,0
"North America","2024-10-30",0,0,2960,0,4,2964,0,0
"North America","2024-10-31",0,0,2960,0,3,2967,0,0
"North America","2024-11-01",0,0,2960,0,4,2971,0,0
"North America","2024-11-02",0,0,2960,0,4,2975,0,0
"North America","2024-11-03",0,0,2960,0,4,2979,0,0
"North America","2024-11-04",0,0,2960,0,3,2982,0,0
"North America","2024-11-05",0,26,2986,0,4,2986,0,0
"North America","2024-11-06",0,0,2986,0,3,2989,0,0
"North America","2024-11-07",0,0,2986,0,3,2992,0,0
"North America","2024-11-08",0,0,2986,0,3,2995,0,0
"North America","2024-11-09",0,0,2986,0,3,2998,0,0
"North America","2024-11-10",0,0,2986,0,3,3001,0,0
"North America","2024-11-11",0,0,2986,0,3,3004,0,0
"North America","2024-11-12",0,21,3007,0,3,3007,0,0
"North America","2024-11-13",0,0,3007,0,2,3009,0,0
"North America","2024-11-14",0,0,3007,0,2,3011,0,0
"North America","2024-11-15",0,0,3007,0,2,3013,0,0
"North America","2024-11-16",0,0,3007,0,2,3015,0,0
"North America","2024-11-17",0,0,3007,0,2,3017,0,0
"North America","2024-11-18",0,0,3007,0,2,3019,0,0
"North America","2024-11-19",0,14,3021,0,2,3021,0,0
"North America","2024-11-20",0,0,3021,0,1,3022,0,0
"North America","2024-11-21",0,0,3021,0,1,3023,0,0
"North America","2024-11-22",0,0,3021,0,1,3024,0,0
"North America","2024-11-23",0,0,3021,0,0,3024,0,0
"North America","2024-11-24",0,0,3021,0,1,3025,0,0
"North America","2024-11-25",0,0,3021,0,1,3026,0,0
"North America","2024-11-26",0,6,3027,0,1,3027,0,0
"North America","2024-11-27",0,0,3027,0,0,3027,0,0
"North America","2024-11-28",0,0,3027,0,0,3027,0,0
"North America","2024-11-29",0,0,3027,0,0,3027,0,0
"North America","2024-11-30",0,0,3027,0,0,3027,0,0
"North America","2024-12-01",0,0,3027,0,0,3027,0,0
"North America","2024-12-02",0,0,3027,0,0,3027,0,0
"North America","2024-12-03",0,0,3027,0,0,3027,0,0
"North America","2024-12-04",0,0,3027,0,0,3027,0,0
"North America","2024-12-05",0,0,3027,0,0,3027,0,0
"North America","2024-12-06",0,0,3027,0,0,3027,0,0
"North America","2024-12-07",0,0,3027,0,0,3027,0,0
"North America","2024-12-08",0,0,3027,0,0,3027,0,0
"North America","2024-12-09",0,0,3027,0,0,3027,0,0
"North America","2024-12-10",0,0,3027,0,0,3027,0,0
"North America","2024-12-11",0,0,3027,0,0,3027,0,0
"North America","2024-12-12",0,0,3027,0,0,3027,0,0
"North America","2024-12-13",0,0,3027,0,0,3027,0,0
"North America","2024-12-14",0,0,3027,0,0,3027,0,0
"North America","2024-12-15",0,0,3027,0,0,3027,0,0
"North America","2024-12-16",0,0,3027,0,0,3027,0,0
"North America","2024-12-17",0,0,3027,0,0,3027,0,0
"North America","2024-12-18",0,0,3027,0,0,3027,0,0
"North America","2024-12-19",0,0,3027,0,0,3027,0,0
"North America","2024-12-20",0,0,3027,0,0,3027,0,0
"North America","2024-12-21",0,0,3027,0,0,3027,0,0
"North America","2024-12-22",0,0,3027,0,0,3027,0,0
"North America","2024-12-23",0,0,3027,0,0,3027,0,0
"North America","2024-12-24",0,0,3027,0,0,3027,0,0
"North America","2024-12-25",0,0,3027,0,0,3027,0,0
"North America","2024-12-26",0,0,3027,0,0,3027,0,0
"North America","2024-12-27",0,0,3027,0,0,3027,0,0
"North America","2024-12-28",0,0,3027,0,0,3027,0,0
"North America","2024-12-29",0,0,3027,0,0,3027,0,0
"North America","2024-12-30",0,0,3027,0,0,3027,0,0
"North America","2024-12-31",0,0,3027,0,0,3027,0,0
"North America","2025-01-01",0,0,3027,0,0,3027,0,0
"North America","2025-01-02",0,0,3027,0,0,3027,0,0
"North America","2025-01-03",0,0,3027,0,0,3027,0,0
"North America","2025-01-04",0,0,3027,0,0,3027,0,0
"North America","2025-01-05",0,0,3027,0,0,3027,0,0
"North America","2025-01-06",0,0,3027,0,0,3027,0,0
"North America","2025-01-07",0,0,3027,0,0,3027,0,0
"North America","2025-01-08",0,0,3027,0,0,3027,0,0
"North America","2025-01-09",0,0,3027,0,0,3027,0,0
"North America","2025-01-10",0,0,3027,0,0,3027,0,0
"North America","2025-01-11",0,0,3027,0,0,3027,0,0
"North America","2025-01-12",0,0,3027,0,0,3027,0,0
"North America","2025-01-13",0,0,3027,0,0,3027,0,0
"Norway","2024-01-01",0,0,0,0,0,0,0,0
"Norway","2024-01-02",0,0,0,0,0,0,0,0
"Norway","2024-01-03",0,0,0,0,0,0,0,0
"Norway","2024-01-04",0,0,0,0,0,0,0,0
"Norway","2024-01-05",0,0,0,0,0,0,0,0
"Norway","2024-01-06",0,0,0,0,0,0,0,0
"Norway","2024-01-07",0,0,0,0,0,0,0,0
"Norway","2024-01-08",0,0,0,0,0,0,0,0
"Norway","2024-01-09",0,0,0,0,0,0,0,0
"Norway","2024-01-10",0,0,0,0,0,0,0,0
"Norway","2024-01-11",0,0,0,0,0,0,0,0
"Norway","2024-01-12",0,0,0,0,0,0,0,0
"Norway","2024-01-13",0,0,0,0,0,0,0,0
"Norway","2024-01-14",0,0,0,0,0,0,0,0
"Norway","2024-01-15",0,0,0,0,0,0,0,0
"Norway","2024-01-16",0,0,0,0,0,0,0,0
"Norway","2024-01-17",0,0,0,0,0,0,0,0
"Norway","2024-01-18",0,0,0,0,0,0,0,0
"Norway","2024-01-19",0,0,0,0,0,0,0,0
"Norway","2024-01-20",0,0,0,0,0,0,0,0
"Norway","2024-01-21",0,0,0,0,0,0,0,0
"Norway","2024-01-22",0,0,0,0,0,0,0,0
"Norway","2024-01-23",0,0,0,0,0,0,0,0
"Norway","2024-01-24",0,0,0,0,0,0,0,0
"Norway","2024-01-25",0,0,0,0,0,0,0,0
"Norway","2024-01-26",0,0,0,0,0,0,0,0
"Norway","2024-01-27",0,0,0,0,0,0,0,0
"Norway","2024-01-28",0,0,0,0,0,0,0,0
"Norway","2024-01-29",0,0,0,0,0,0,0,0
"Norway","2024-01-30",0,0,0,0,0,0,0,0
"Norway","2024-01-31",0,1,1,0,1,1,0,0
"Norway","2024-02-01",0,0,1,0,0,1,0,0
"Norway","2024-02-02",0,0,1,0,0,1,0,0
"Norway","2024-02-03",0,0,1,0,0,1,0,0
"Norway","2024-02-04",0,0,1,0,0,1,0,0
"Norway","2024-02-05",0,0,1,0,0,1,0,0
"Norway","2024-02-06",0,0,1,0,0,1,0,0
"Norway","2024-02-07",0,0,1,0,0,1,0,0
"Norway","2024-02-08",0,0,1,0,0,1,0,0
"Norway","2024-02-09",0,0,1,0,0,1,0,0
"Norway","2024-02-10",0,0,1,0,0,1,0,0
"Norway","2024-02-11",0,0,1,0,0,1,0,0
"Norway","2024-02-12",0,0,1,0,0,1,0,0
"Norway","2024-02-13",0,0,1,0,0,1,0,0
"Norway","2024-02-14",0,0,1,0,0,1,0,0
"Norway","2024-02-15",0,0,1,0,0,1,0,0
"Norway","2024-02-16",0,0,1,0,0,1,0,0
"Norway","2024-02-17",0,0,1,0,0,1,0,0
"Norway","2024-02-18",0,0,1,0,0,1,0,0
"Norway","2024-02-19",0,0,1,0,0,1,0,0
"Norway","2024-02-20",0,0,1,0,0,1,0,0
"Norway","2024-02-21",0,0,1,0,0,1,0,0
"Norway","2024-02-22",0,0,1,0,0,1,0,0
"Norway","2024-02-23",0,0,1,0,0,1,0,0
"Norway","2024-02-24",0,0,1,0,0,1,0,0
"Norway","2024-02-25",0,0,1,0,0,1,0,0
"Norway","2024-02-26",0,0,1,0,0,1,0,0
"Norway","2024-02-27",0,0,1,0,0,1,0,0
"Norway","2024-02-28",0,0,1,0,0,1,0,0
"Norway","2024-02-29",0,0,1,0,0,1,0,0
"Norway","2024-03-01",0,0,1,0,0,1,0,0
"Norway","2024-03-02",0,0,1,0,0,1,0,0
"Norway","2024-03-03",0,0,1,0,0,1,0,0
"Norway","2024-03-04",0,0,1,0,0,1,0,0
"Norway","2024-03-05",0,0,1,0,0,1,0,0
"Norway","2024-03-06",0,0,1,0,0,1,0,0
"Norway","2024-03-07",0,0,1,0,0,1,0,0
"Norway","2024-03-08",0,0,1,0,0,1,0,0
"Norway","2024-03-09",0,0,1,0,0,1,0,0
"Norway","2024-03-10",0,0,1,0,0,1,0,0
"Norway","2024-03-11",0,0,1,0,0,1,0,0
"Norway","2024-03-12",0,0,1,0,0,1,0,0
"Norway","2024-03-13",0,0,1,0,0,1,0,0
"Norway","2024-03-14",0,0,1,0,0,1,0,0
"Norway","2024-03-15",0,0,1,0,0,1,0,0
"Norway","2024-03-16",0,0,1,0,0,1,0,0
"Norway","2024-03-17",0,0,1,0,1,2,0,0
"Norway","2024-03-18",0,0,1,0,0,2,0,0
"Norway","2024-03-19",0,0,1,0,0,2,0,0
"Norway","2024-03-20",0,0,1,0,0,2,0,0
"Norway","2024-03-21",0,0,1,0,0,2,0,0
"Norway","2024-03-22",0,0,1,0,0,2,0,0
"Norway","2024-03-23",0,0,1,0,0,2,0,0
"Norway","2024-03-24",0,0,1,0,0,2,0,0
"Norway","2024-03-25",0,0,1,0,0,2,0,0
"Norway","2024-03-26",0,0,1,0,0,2,0,0
"Norway","2024-03-27",0,0,1,0,0,2,0,0
"Norway","2024-03-28",0,0,1,0,0,2,0,0
"Norway","2024-03-29",0,0,1,0,0,2,0,0
"Norway","2024-03-30",0,0,1,0,0,2,0,0
"Norway","2024-03-31",0,0,1,0,0,2,0,0
"Norway","2024-04-01",0,0,1,0,0,2,0,0
"Norway","2024-04-02",0,0,1,0,0,2,0,0
"Norway","2024-04-03",0,0,1,0,0,2,0,0
"Norway","2024-04-04",0,0,1,0,0,2,0,0
"Norway","2024-04-05",0,0,1,0,0,2,0,0
"Norway","2024-04-06",0,0,1,0,0,2,0,0
"Norway","2024-04-07",0,0,1,0,0,2,0,0
"Norway","2024-04-08",0,0,1,0,0,2,0,0
"Norway","2024-04-09",0,0,1,0,0,2,0,0
"Norway","2024-04-10",0,0,1,0,0,2,0,0
"Norway","2024-04-11",0,0,1,0,0,2,0,0
"Norway","2024-04-12",0,0,1,0,0,2,0,0
"Norway","2024-04-13",0,0,1,0,0,2,0,0
"Norway","2024-04-14",0,0,1,0,0,2,0,0
"Norway","2024-04-15",0,0,1,0,0,2,0,0
"Norway","2024-04-16",0,0,1,0,0,2,0,0
"Norway","2024-04-17",0,0,1,0,0,2,0,0
"Norway","2024-04-18",0,0,1,0,0,2,0,0
"Norway","2024-04-19",0,0,1,0,0,2,0,0
"Norway","2024-04-20",0,0,1,0,0,2,0,0
"Norway","2024-04-21",0,0,1,0,0,2,0,0
"Norway","2024-04-22",0,0,1,0,0,2,0,0
"Norway","2024-04-23",0,0,1,0,0,2,0,0
"Norway","2024-04-24",0,0,1,0,0,2,0,0
"Norway","2024-04-25",0,0,1,0,0,2,0,0
"Norway","2024-04-26",0,0,1,0,0,2,0,0
"Norway","2024-04-27",0,0,1,0,0,2,0,0
"Norway","2024-04-28",0,0,1,0,0,2,0,0
"Norway","2024-04-29",0,0,1,0,0,2,0,0
"Norway","2024-04-30",0,1,2,0,0,2,0,0
"Norway","2024-05-01",0,0,2,0,0,2,0,0
"Norway","2024-05-02",0,0,2,0,0,2,0,0
"Norway","2024-05-03",0,0,2,0,0,2,0,0
"Norway","2024-05-04",0,0,2,0,0,2,0,0
"Norway","2024-05-05",0,0,2,0,0,2,0,0
"Norway","2024-05-06",0,0,2,0,0,2,0,0
"Norway","2024-05-07",0,0,2,0,0,2,0,0
"Norway","2024-05-08",0,0,2,0,0,2,0,0
"Norway","2024-05-09",0,0,2,0,0,2,0,0
"Norway","2024-05-10",0,0,2,0,0,2,0,0
"Norway","2024-05-11",0,0,2,0,0,2,0,0
"Norway","2024-05-12",0,0,2,0,0,2,0,0
"Norway","2024-05-13",0,0,2,0,0,2,0,0
"Norway","2024-05-14",0,0,2,0,0,2,0,0
"Norway","2024-05-15",0,0,2,0,0,2,0,0
"Norway","2024-05-16",0,0,2,0,0,2,0,0
"Norway","2024-05-17",0,0,2,0,0,2,0,0
"Norway","2024-05-18",0,0,2,0,0,2,0,0
"Norway","2024-05-19",0,0,2,0,0,2,0,0
"Norway","2024-05-20",0,0,2,0,0,2,0,0
"Norway","2024-05-21",0,0,2,0,0,2,0,0
"Norway","2024-05-22",0,0,2,0,0,2,0,0
"Norway","2024-05-23",0,0,2,0,0,2,0,0
"Norway","2024-05-24",0,0,2,0,0,2,0,0
"Norway","2024-05-25",0,0,2,0,0,2,0,0
"Norway","2024-05-26",0,0,2,0,0,2,0,0
"Norway","2024-05-27",0,0,2,0,0,2,0,0
"Norway","2024-05-28",0,0,2,0,0,2,0,0
"Norway","2024-05-29",0,0,2,0,0,2,0,0
"Norway","2024-05-30",0,0,2,0,0,2,0,0
"Norway","2024-05-31",0,0,2,0,0,2,0,0
"Norway","2024-06-01",0,0,2,0,0,2,0,0
"Norway","2024-06-02",0,0,2,0,0,2,0,0
"Norway","2024-06-03",0,0,2,0,0,2,0,0
"Norway","2024-06-04",0,0,2,0,0,2,0,0
"Norway","2024-06-05",0,0,2,0,0,2,0,0
"Norway","2024-06-06",0,0,2,0,0,2,0,0
"Norway","2024-06-07",0,0,2,0,0,2,0,0
"Norway","2024-06-08",0,0,2,0,0,2,0,0
"Norway","2024-06-09",0,0,2,0,0,2,0,0
"Norway","2024-06-10",0,0,2,0,0,2,0,0
"Norway","2024-06-11",0,0,2,0,0,2,0,0
"Norway","2024-06-12",0,0,2,0,0,2,0,0
"Norway","2024-06-13",0,0,2,0,0,2,0,0
"Norway","2024-06-14",0,0,2,0,0,2,0,0
"Norway","2024-06-15",0,0,2,0,0,2,0,0
"Norway","2024-06-16",0,0,2,0,1,3,0,0
"Norway","2024-06-17",0,0,2,0,0,3,0,0
"Norway","2024-06-18",0,0,2,0,0,3,0,0
"Norway","2024-06-19",0,0,2,0,0,3,0,0
"Norway","2024-06-20",0,0,2,0,0,3,0,0
"Norway","2024-06-21",0,0,2,0,0,3,0,0
"Norway","2024-06-22",0,0,2,0,0,3,0,0
"Norway","2024-06-23",0,0,2,0,0,3,0,0
"Norway","2024-06-24",0,0,2,0,0,3,0,0
"Norway","2024-06-25",0,0,2,0,0,3,0,0
"Norway","2024-06-26",0,0,2,0,0,3,0,0
"Norway","2024-06-27",0,0,2,0,0,3,0,0
"Norway","2024-06-28",0,0,2,0,0,3,0,0
"Norway","2024-06-29",0,0,2,0,0,3,0,0
"Norway","2024-06-30",0,0,2,0,0,3,0,0
"Norway","2024-07-01",0,0,2,0,0,3,0,0
"Norway","2024-07-02",0,0,2,0,0,3,0,0
"Norway","2024-07-03",0,0,2,0,0,3,0,0
"Norway","2024-07-04",0,0,2,0,0,3,0,0
"Norway","2024-07-05",0,0,2,0,0,3,0,0
"Norway","2024-07-06",0,0,2,0,0,3,0,0
"Norway","2024-07-07",0,0,2,0,0,3,0,0
"Norway","2024-07-08",0,0,2,0,0,3,0,0
"Norway","2024-07-09",0,0,2,0,0,3,0,0
"Norway","2024-07-10",0,0,2,0,0,3,0,0
"Norway","2024-07-11",0,0,2,0,0,3,0,0
"Norway","2024-07-12",0,0,2,0,0,3,0,0
"Norway","2024-07-13",0,0,2,0,0,3,0,0
"Norway","2024-07-14",0,0,2,0,0,3,0,0
"Norway","2024-07-15",0,0,2,0,0,3,0,0
"Norway","2024-07-16",0,0,2,0,0,3,0,0
"Norway","2024-07-17",0,0,2,0,0,3,0,0
"Norway","2024-07-18",0,0,2,0,0,3,0,0
"Norway","2024-07-19",0,0,2,0,0,3,0,0
"Norway","2024-07-20",0,0,2,0,0,3,0,0
"Norway","2024-07-21",0,0,2,0,0,3,0,0
"Norway","2024-07-22",0,0,2,0,0,3,0,0
"Norway","2024-07-23",0,0,2,0,0,3,0,0
"Norway","2024-07-24",0,0,2,0,0,3,0,0
"Norway","2024-07-25",0,0,2,0,0,3,0,0
"Norway","2024-07-26",0,0,2,0,0,3,0,0
"Norway","2024-07-27",0,0,2,0,0,3,0,0
"Norway","2024-07-28",0,0,2,0,0,3,0,0
"Norway","2024-07-29",0,0,2,0,0,3,0,0
"Norway","2024-07-30",0,0,2,0,0,3,0,0
"Norway","2024-07-31",0,1,3,0,0,3,0,0
"Norway","2024-08-01",0,0,3,0,0,3,0,0
"Norway","2024-08-02",0,0,3,0,0,3,0,0
"Norway","2024-08-03",0,0,3,0,0,3,0,0
"Norway","2024-08-04",0,0,3,0,0,3,0,0
"Norway","2024-08-05",0,0,3,0,0,3,0,0
"Norway","2024-08-06",0,0,3,0,0,3,0,0
"Norway","2024-08-07",0,0,3,0,0,3,0,0
"Norway","2024-08-08",0,0,3,0,1,4,0,0
"Norway","2024-08-09",0,0,3,0,0,4,0,0
"Norway","2024-08-10",0,0,3,0,0,4,0,0
"Norway","2024-08-11",0,0,3,0,0,4,0,0
"Norway","2024-08-12",0,0,3,0,0,4,0,0
"Norway","2024-08-13",0,0,3,0,0,4,0,0
"Norway","2024-08-14",0,0,3,0,0,4,0,0
"Norway","2024-08-15",0,0,3,0,0,4,0,0
"Norway","2024-08-16",0,0,3,0,0,4,0,0
"Norway","2024-08-17",0,0,3,0,0,4,0,0
"Norway","2024-08-18",0,0,3,0,0,4,0,0
"Norway","2024-08-19",0,0,3,0,0,4,0,0
"Norway","2024-08-20",0,0,3,0,0,4,0,0
"Norway","2024-08-21",0,0,3,0,0,4,0,0
"Norway","2024-08-22",0,0,3,0,0,4,0,0
"Norway","2024-08-23",0,0,3,0,0,4,0,0
"Norway","2024-08-24",0,0,3,0,1,5,0,0
"Norway","2024-08-25",0,0,3,0,0,5,0,0
"Norway","2024-08-26",0,0,3,0,0,5,0,0
"Norway","2024-08-27",0,0,3,0,0,5,0,0
"Norway","2024-08-28",0,0,3,0,0,5,0,0
"Norway","2024-08-29",0,0,3,0,0,5,0,0
"Norway","2024-08-30",0,0,3,0,0,5,0,0
"Norway","2024-08-31",0,2,5,0,0,5,0,0
"Norway","2024-09-01",0,0,5,0,0,5,0,0
"Norway","2024-09-02",0,0,5,0,0,5,0,0
"Norway","2024-09-03",0,0,5,0,0,5,0,0
"Norway","2024-09-04",0,0,5,0,0,5,0,0
"Norway","2024-09-05",0,0,5,0,1,6,0,0
"Norway","2024-09-06",0,0,5,0,0,6,0,0
"Norway","2024-09-07",0,0,5,0,0,6,0,0
"Norway","2024-09-08",0,0,5,0,0,6,0,0
"Norway","2024-09-09",0,0,5,0,0,6,0,0
"Norway","2024-09-10",0,0,5,0,0,6,0,0
"Norway","2024-09-11",0,0,5,0,0,6,0,0
"Norway","2024-09-12",0,0,5,0,0,6,0,0
"Norway","2024-09-13",0,0,5,0,0,6,0,0
"Norway","2024-09-14",0,0,5,0,1,7,0,0
"Norway","2024-09-15",0,0,5,0,0,7,0,0
"Norway","2024-09-16",0,0,5,0,0,7,0,0
"Norway","2024-09-17",0,0,5,0,0,7,0,0
"Norway","2024-09-18",0,0,5,0,0,7,0,0
"Norway","2024-09-19",0,0,5,0,0,7,0,0
"Norway","2024-09-20",0,0,5,0,0,7,0,0
"Norway","2024-09-21",0,0,5,0,0,7,0,0
"Norway","2024-09-22",0,0,5,0,1,8,0,0
"Norway","2024-09-23",0,0,5,0,0,8,0,0
"Norway","2024-09-24",0,0,5,0,0,8,0,0
"Norway","2024-09-25",0,0,5,0,0,8,0,0
"Norway","2024-09-26",0,0,5,0,0,8,0,0
"Norway","2024-09-27",0,0,5,0,0,8,0,0
"Norway","2024-09-28",0,0,5,0,0,8,0,0
"Norway","2024-09-29",0,0,5,0,0,8,0,0
"Norway","2024-09-30",0,0,5,0,0,8,0,0
"Norway","2024-10-01",0,0,5,0,1,9,0,0
"Norway","2024-10-02",0,0,5,0,0,9,0,0
"Norway","2024-10-03",0,0,5,0,0,9,0,0
"Norway","2024-10-04",0,0,5,0,0,9,0,0
"Norway","2024-10-05",0,0,5,0,0,9,0,0
"Norway","2024-10-06",0,0,5,0,0,9,0,0
"Norway","2024-10-07",0,0,5,0,0,9,0,0
"Norway","2024-10-08",0,0,5,0,0,9,0,0
"Norway","2024-10-09",0,0,5,0,0,9,0,0
"Norway","2024-10-10",0,0,5,0,1,10,0,0
"Norway","2024-10-11",0,0,5,0,0,10,0,0
"Norway","2024-10-12",0,0,5,0,0,10,0,0
"Norway","2024-10-13",0,0,5,0,0,10,0,0
"Norway","2024-10-14",0,0,5,0,0,10,0,0
"Norway","2024-10-15",0,0,5,0,0,10,0,0
"Norway","2024-10-16",0,0,5,0,0,10,0,0
"Norway","2024-10-17",0,0,5,0,0,10,0,0
"Norway","2024-10-18",0,0,5,0,1,11,0,0
"Norway","2024-10-19",0,0,5,0,0,11,0,0
"Norway","2024-10-20",0,0,5,0,0,11,0,0
"Norway","2024-10-21",0,0,5,0,0,11,0,0
"Norway","2024-10-22",0,0,5,0,0,11,0,0
"Norway","2024-10-23",0,0,5,0,0,11,0,0
"Norway","2024-10-24",0,0,5,0,0,11,0,0
"Norway","2024-10-25",0,0,5,0,0,11,0,0
"Norway","2024-10-26",0,0,5,0,0,11,0,0
"Norway","2024-10-27",0,0,5,0,1,12,0,0
"Norway","2024-10-28",0,0,5,0,0,12,0,0
"Norway","2024-10-29",0,0,5,0,0,12,0,0
"Norway","2024-10-30",0,0,5,0,0,12,0,0
"Norway","2024-10-31",0,7,12,0,0,12,0,0
"Norway","2024-11-01",0,0,12,0,0,12,0,0
"Norway","2024-11-02",0,0,12,0,0,12,0,0
"Norway","2024-11-03",0,0,12,0,0,12,0,0
"Norway","2024-11-04",0,0,12,0,0,12,0,0
"Norway","2024-11-05",0,0,12,0,0,12,0,0
"Norway","2024-11-06",0,0,12,0,1,13,0,0
"Norway","2024-11-07",0,0,12,0,0,13,0,0
"Norway","2024-11-08",0,0,12,0,0,13,0,0
"Norway","2024-11-09",0,0,12,0,0,13,0,0
"Norway","2024-11-10",0,0,12,0,0,13,0,0
"Norway","2024-11-11",0,0,12,0,0,13,0,0
"Norway","2024-11-12",0,0,12,0,0,13,0,0
"Norway","2024-11-13",0,0,12,0,0,13,0,0
"Norway","2024-11-14",0,0,12,0,0,13,0,0
"Norway","2024-11-15",0,0,12,0,1,14,0,0
"Norway","2024-11-16",0,0,12,0,0,14,0,0
"Norway","2024-11-17",0,0,12,0,0,14,0,0
"Norway","2024-11-18",0,0,12,0,0,14,0,0
"Norway","2024-11-19",0,0,12,0,0,14,0,0
"Norway","2024-11-20",0,0,12,0,0,14,0,0
"Norway","2024-11-21",0,0,12,0,0,14,0,0
"Norway","2024-11-22",0,0,12,0,0,14,0,0
"Norway","2024-11-23",0,0,12,0,0,14,0,0
"Norway","2024-11-24",0,0,12,0,0,14,0,0
"Norway","2024-11-25",0,0,12,0,0,14,0,0
"Norway","2024-11-26",0,0,12,0,1,15,0,0
"Norway","2024-11-27",0,0,12,0,0,15,0,0
"Norway","2024-11-28",0,0,12,0,0,15,0,0
"Norway","2024-11-29",0,0,12,0,0,15,0,0
"Norway","2024-11-30",0,3,15,0,0,15,0,0
"Norway","2024-12-01",0,0,15,0,0,15,0,0
"Norway","2024-12-02",0,0,15,0,0,15,0,0
"Norway","2024-12-03",0,0,15,0,0,15,0,0
"Norway","2024-12-04",0,0,15,0,0,15,0,0
"Norway","2024-12-05",0,0,15,0,0,15,0,0
"Norway","2024-12-06",0,0,15,0,0,15,0,0
"Norway","2024-12-07",0,0,15,0,0,15,0,0
"Norway","2024-12-08",0,0,15,0,0,15,0,0
"Norway","2024-12-09",0,0,15,0,0,15,0,0
"Norway","2024-12-10",0,0,15,0,0,15,0,0
"Norway","2024-12-11",0,0,15,0,0,15,0,0
"Norway","2024-12-12",0,0,15,0,0,15,0,0
"Norway","2024-12-13",0,0,15,0,0,15,0,0
"Norway","2024-12-14",0,0,15,0,0,15,0,0
"Norway","2024-12-15",0,0,15,0,0,15,0,0
"Norway","2024-12-16",0,0,15,0,0,15,0,0
"Norway","2024-12-17",0,0,15,0,0,15,0,0
"Norway","2024-12-18",0,0,15,0,0,15,0,0
"Norway","2024-12-19",0,0,15,0,0,15,0,0
"Norway","2024-12-20",0,0,15,0,0,15,0,0
"Norway","2024-12-21",0,0,15,0,0,15,0,0
"Norway","2024-12-22",0,0,15,0,0,15,0,0
"Norway","2024-12-23",0,0,15,0,0,15,0,0
"Norway","2024-12-24",0,0,15,0,0,15,0,0
"Norway","2024-12-25",0,0,15,0,0,15,0,0
"Norway","2024-12-26",0,0,15,0,0,15,0,0
"Norway","2024-12-27",0,0,15,0,0,15,0,0
"Norway","2024-12-28",0,0,15,0,0,15,0,0
"Norway","2024-12-29",0,0,15,0,0,15,0,0
"Norway","2024-12-30",0,0,15,0,0,15,0,0
"Norway","2024-12-31",0,0,15,0,0,15,0,0
"Norway","2025-01-01",0,0,15,0,0,15,0,0
"Norway","2025-01-02",0,0,15,0,0,15,0,0
"Norway","2025-01-03",0,0,15,0,0,15,0,0
"Norway","2025-01-04",0,0,15,0,0,15,0,0
"Norway","2025-01-05",0,0,15,0,0,15,0,0
"Norway","2025-01-06",0,0,15,0,0,15,0,0
"Norway","2025-01-07",0,0,15,0,0,15,0,0
"Norway","2025-01-08",0,0,15,0,0,15,0,0
"Norway","2025-01-09",0,0,15,0,0,15,0,0
"Norway","2025-01-10",0,0,15,0,0,15,0,0
"Norway","2025-01-11",0,0,15,0,0,15,0,0
"Norway","2025-01-12",0,0,15,0,0,15,0,0
"Norway","2025-01-13",0,0,15,0,0,15,0,0
"Oceania","2024-01-01",0,0,0,0,0,0,0,0
"Oceania","2024-01-02",0,0,0,0,0,0,0,0
"Oceania","2024-01-03",0,0,0,0,0,0,0,0
"Oceania","2024-01-04",0,0,0,0,0,0,0,0
"Oceania","2024-01-05",0,0,0,0,0,0,0,0
"Oceania","2024-01-06",0,0,0,0,0,0,0,0
"Oceania","2024-01-07",0,0,0,0,0,0,0,0
"Oceania","2024-01-08",0,0,0,0,0,0,0,0
"Oceania","2024-01-09",0,0,0,0,0,0,0,0
"Oceania","2024-01-10",0,0,0,0,0,0,0,0
"Oceania","2024-01-11",0,0,0,0,0,0,0,0
"Oceania","2024-01-12",0,0,0,0,0,0,0,0
"Oceania","2024-01-13",0,0,0,0,0,0,0,0
"Oceania","2024-01-14",0,0,0,0,0,0,0,0
"Oceania","2024-01-15",0,0,0,0,0,0,0,0
"Oceania","2024-01-16",0,8,8,0,8,8,0,0
"Oceania","2024-01-17",0,0,8,0,0,8,0,0
"Oceania","2024-01-18",0,0,8,0,1,9,0,0
"Oceania","2024-01-19",0,0,8,0,0,9,0,0
"Oceania","2024-01-20",0,0,8,0,1,10,0,0
"Oceania","2024-01-21",0,0,8,0,0,10,0,0
"Oceania","2024-01-22",0,0,8,0,0,10,0,0
"Oceania","2024-01-23",0,0,8,0,1,11,0,0
"Oceania","2024-01-24",0,0,8,0,0,11,0,0
"Oceania","2024-01-25",0,0,8,0,1,12,0,0
"Oceania","2024-01-26",0,0,8,0,0,12,0,0
"Oceania","2024-01-27",0,0,8,0,0,12,0,0
"Oceania","2024-01-28",0,0,8,0,1,13,0,0
"Oceania","2024-01-29",0,0,8,0,0,13,0,0
"Oceania","2024-01-30",0,0,8,0,1,14,0,0
"Oceania","2024-01-31",0,6,14,0,0,14,0,0
"Oceania","2024-02-01",0,0,14,0,0,14,0,0
"Oceania","2024-02-02",0,0,14,0,0,14,0,0
"Oceania","2024-02-03",0,0,14,0,0,14,0,0
"Oceania","2024-02-04",0,0,14,0,0,14,0,0
"Oceania","2024-02-05",0,0,14,0,0,14,0,0
"Oceania","2024-02-06",0,0,14,0,0,14,0,0
"Oceania","2024-02-07",0,0,14,0,0,14,0,0
"Oceania","2024-02-08",0,0,14,0,0,14,0,0
"Oceania","2024-02-09",0,0,14,0,0,14,0,0
"Oceania","2024-02-10",0,0,14,0,1,15,0,0
"Oceania","2024-02-11",0,0,14,0,0,15,0,0
"Oceania","2024-02-12",0,0,14,0,0,15,0,0
"Oceania","2024-02-13",0,0,14,0,0,15,0,0
"Oceania","2024-02-14",0,0,14,0,0,15,0,0
"Oceania","2024-02-15",0,0,14,0,0,15,0,0
"Oceania","2024-02-16",0,0,14,0,0,15,0,0
"Oceania","2024-02-17",0,0,14,0,0,15,0,0
"Oceania","2024-02-18",0,0,14,0,0,15,0,0
"Oceania","2024-02-19",0,0,14,0,0,15,0,0
"Oceania","2024-02-20",0,0,14,0,0,15,0,0
"Oceania","2024-02-21",0,0,14,0,0,15,0,0
"Oceania","2024-02-22",0,0,14,0,0,15,0,0
"Oceania","2024-02-23",0,0,14,0,0,15,0,0
"Oceania","2024-02-24",0,0,14,0,0,15,0,0
"Oceania","2024-02-25",0,0,14,0,0,15,0,0
"Oceania","2024-02-26",0,0,14,0,0,15,0,0
"Oceania","2024-02-27",0,0,14,0,1,16,0,0
"Oceania","2024-02-28",0,0,14,0,0,16,0,0
"Oceania","2024-02-29",0,0,14,0,0,16,0,0
"Oceania","2024-03-01",0,0,14,0,0,16,0,0
"Oceania","2024-03-02",0,0,14,0,0,16,0,0
"Oceania","2024-03-03",0,0,14,0,0,16,0,0
"Oceania","2024-03-04",0,0,14,0,0,16,0,0
"Oceania","2024-03-05",0,0,14,0,0,16,0,0
"Oceania","2024-03-06",0,0,14,0,0,16,0,0
"Oceania","2024-03-07",0,0,14,0,0,16,0,0
"Oceania","2024-03-08",0,0,14,0,0,16,0,0
"Oceania","2024-03-09",0,0,14,0,0,16,0,0
"Oceania","2024-03-10",0,0,14,0,0,16,0,0
"Oceania","2024-03-11",0,0,14,0,0,16,0,0
"Oceania","2024-03-12",0,0,14,0,0,16,0,0
"Oceania","2024-03-13",0,0,14,0,0,16,0,0
"Oceania","2024-03-14",0,0,14,0,0,16,0,0
"Oceania","2024-03-15",0,0,14,0,0,16,0,0
"Oceania","2024-03-16",0,0,14,0,0,16,0,0
"Oceania","2024-03-17",0,0,14,0,1,17,0,0
"Oceania","2024-03-18",0,0,14,0,0,17,0,0
"Oceania","2024-03-19",0,0,14,0,0,17,0,0
"Oceania","2024-03-20",0,0,14,0,0,17,0,0
"Oceania","2024-03-21",0,0,14,0,0,17,0,0
"Oceania","2024-03-22",0,0,14,0,0,17,0,0
"Oceania","2024-03-23",0,0,14,0,0,17,0,0
"Oceania","2024-03-24",0,0,14,0,0,17,0,0
"Oceania","2024-03-25",0,0,14,0,0,17,0,0
"Oceania","2024-03-26",0,0,14,0,0,17,0,0
"Oceania","2024-03-27",0,0,14,0,0,17,0,0
"Oceania","2024-03-28",0,0,14,0,0,17,0,0
"Oceania","2024-03-29",0,0,14,0,0,17,0,0
"Oceania","2024-03-30",0,0,14,0,0,17,0,0
"Oceania","2024-03-31",0,0,14,0,0,17,0,0
"Oceania","2024-04-01",0,0,14,0,0,17,0,0
"Oceania","2024-04-02",0,0,14,0,0,17,0,0
"Oceania","2024-04-03",0,0,14,0,1,18,0,0
"Oceania","2024-04-04",0,0,14,0,0,18,0,0
"Oceania","2024-04-05",0,0,14,0,0,18,0,0
"Oceania","2024-04-06",0,0,14,0,0,18,0,0
"Oceania","2024-04-07",0,0,14,0,0,18,0,0
"Oceania","2024-04-08",0,0,14,0,0,18,0,0
"Oceania","2024-04-09",0,0,14,0,0,18,0,0
"Oceania","2024-04-10",0,0,14,0,0,18,0,0
"Oceania","2024-04-11",0,0,14,0,0,18,0,0
"Oceania","2024-04-12",0,0,14,0,0,18,0,0
"Oceania","2024-04-13",0,0,14,0,0,18,0,0
"Oceania","2024-04-14",0,0,14,0,0,18,0,0
"Oceania","2024-04-15",0,0,14,0,0,18,0,0
"Oceania","2024-04-16",0,0,14,0,0,18,0,0
"Oceania","2024-04-17",0,0,14,0,0,18,0,0
"Oceania","2024-04-18",0,0,14,0,0,18,0,0
"Oceania","2024-04-19",0,0,14,0,0,18,0,0
"Oceania","2024-04-20",0,0,14,0,0,18,0,0
"Oceania","2024-04-21",0,0,14,0,0,18,0,0
"Oceania","2024-04-22",0,0,14,0,1,19,0,0
"Oceania","2024-04-23",0,0,14,0,0,19,0,0
"Oceania","2024-04-24",0,0,14,0,0,19,0,0
"Oceania","2024-04-25",0,0,14,0,0,19,0,0
"Oceania","2024-04-26",0,0,14,0,0,19,0,0
"Oceania","2024-04-27",0,0,14,0,0,19,0,0
"Oceania","2024-04-28",0,0,14,0,0,19,0,0
"Oceania","2024-04-29",0,0,14,0,0,19,0,0
"Oceania","2024-04-30",0,5,19,0,0,19,0,0
"Oceania","2024-05-01",0,0,19,0,0,19,0,0
"Oceania","2024-05-02",0,0,19,0,0,19,0,0
"Oceania","2024-05-03",0,0,19,0,0,19,0,0
"Oceania","2024-05-04",0,0,19,0,0,19,0,0
"Oceania","2024-05-05",0,0,19,0,1,20,0,0
"Oceania","2024-05-06",0,0,19,0,0,20,0,0
"Oceania","2024-05-07",0,0,19,0,0,20,0,0
"Oceania","2024-05-08",0,0,19,0,0,20,0,0
"Oceania","2024-05-09",0,1,20,0,0,20,0,0
"Oceania","2024-05-10",0,0,20,0,2,22,0,0
"Oceania","2024-05-11",0,0,20,0,1,23,0,0
"Oceania","2024-05-12",0,0,20,0,1,24,0,0
"Oceania","2024-05-13",0,0,20,0,2,26,0,0
"Oceania","2024-05-14",0,0,20,0,2,28,0,0
"Oceania","2024-05-15",0,0,20,0,1,29,0,0
"Oceania","2024-05-16",0,0,20,0,1,30,0,0
"Oceania","2024-05-17",0,0,20,0,2,32,0,0
"Oceania","2024-05-18",0,0,20,0,2,34,0,0
"Oceania","2024-05-19",0,0,20,0,1,35,0,0
"Oceania","2024-05-20",0,0,20,0,1,36,0,0
"Oceania","2024-05-21",0,0,20,0,2,38,0,0
"Oceania","2024-05-22",0,0,20,0,2,40,0,0
"Oceania","2024-05-23",0,0,20,0,1,41,0,0
"Oceania","2024-05-24",0,0,20,0,1,42,0,0
"Oceania","2024-05-25",0,0,20,0,2,44,0,0
"Oceania","2024-05-26",0,0,20,0,2,46,0,0
"Oceania","2024-05-27",0,0,20,0,1,47,0,0
"Oceania","2024-05-28",0,0,20,0,1,48,0,0
"Oceania","2024-05-29",0,0,20,0,2,50,0,0
"Oceania","2024-05-30",0,0,20,0,2,52,0,0
"Oceania","2024-05-31",0,33,53,0,1,53,0,0
"Oceania","2024-06-01",0,0,53,0,2,55,0,0
"Oceania","2024-06-02",0,0,53,0,2,57,0,0
"Oceania","2024-06-03",0,0,53,0,2,59,0,0
"Oceania","2024-06-04",0,0,53,0,3,62,0,0
"Oceania","2024-06-05",0,0,53,0,2,64,0,0
"Oceania","2024-06-06",0,0,53,0,2,66,0,0
"Oceania","2024-06-07",0,0,53,0,2,68,0,0
"Oceania","2024-06-08",0,0,53,0,2,70,0,0
"Oceania","2024-06-09",0,0,53,0,2,72,0,0
"Oceania","2024-06-10",0,0,53,0,2,74,0,0
"Oceania","2024-06-11",0,0,53,0,2,76,0,0
"Oceania","2024-06-12",0,0,53,0,3,79,0,0
"Oceania","2024-06-13",0,0,53,0,2,81,0,0
"Oceania","2024-06-14",0,0,53,0,2,83,0,0
"Oceania","2024-06-15",0,0,53,0,2,85,0,0
"Oceania","2024-06-16",0,0,53,0,2,87,0,0
"Oceania","2024-06-17",0,0,53,0,2,89,0,0
"Oceania","2024-06-18",0,0,53,0,2,91,0,0
"Oceania","2024-06-19",0,0,53,0,3,94,0,0
"Oceania","2024-06-20",0,0,53,0,2,96,0,0
"Oceania","2024-06-21",0,0,53,0,2,98,0,0
"Oceania","2024-06-22",0,0,53,0,2,100,0,0
"Oceania","2024-06-23",0,0,53,0,2,102,0,0
"Oceania","2024-06-24",0,0,53,0,2,104,0,0
"Oceania","2024-06-25",0,0,53,0,2,106,0,0
"Oceania","2024-06-26",0,0,53,0,2,108,0,0
"Oceania","2024-06-27",0,0,53,0,3,111,0,0
"Oceania","2024-06-28",0,0,53,0,2,113,0,0
"Oceania","2024-06-29",0,0,53,0,2,115,0,0
"Oceania","2024-06-30",0,64,117,0,2,117,0,0
"Oceania","2024-07-01",0,2,119,0,2,119,0,0
"Oceania","2024-07-02",0,0,119,0,1,120,0,0
"Oceania","2024-07-03",0,0,119,0,1,121,0,0
"Oceania","2024-07-04",0,0,119,0,1,122,0,0
"Oceania","2024-07-05",0,0,119,0,1,123,0,0
"Oceania","2024-07-06",0,0,119,0,1,124,0,0
"Oceania","2024-07-07",0,0,119,0,1,125,0,0
"Oceania","2024-07-08",0,0,119,0,1,126,0,0
"Oceania","2024-07-09",0,0,119,0,1,127,0,0
"Oceania","2024-07-10",0,0,119,0,1,128,0,0
"Oceania","2024-07-11",0,0,119,0,1,129,0,0
"Oceania","2024-07-12",0,0,119,0,1,130,0,0
"Oceania","2024-07-13",0,0,119,0,1,131,0,0
"Oceania","2024-07-14",0,0,119,0,1,132,0,0
"Oceania","2024-07-15",0,14,133,0,1,133,0,0
"Oceania","2024-07-16",0,0,133,0,3,136,0,0
"Oceania","2024-07-17",0,0,133,0,3,139,0,0
"Oceania","2024-07-18",0,0,133,0,3,142,0,0
"Oceania","2024-07-19",0,0,133,0,3,145,0,0
"Oceania","2024-07-20",0,0,133,0,3,148,0,0
"Oceania","2024-07-21",0,0,133,0,3,151,0,0
"Oceania","2024-07-22",0,21,154,0,3,154,0,0
"Oceania","2024-07-23",0,0,154,0,4,158,0,0
"Oceania","2024-07-24",0,0,154,0,4,162,0,0
"Oceania","2024-07-25",0,0,154,0,5,167,0,0
"Oceania","2024-07-26",0,0,154,0,4,171,0,0
"Oceania","2024-07-27",0,21,175,0,4,175,0,0
"Oceania","2024-07-28",0,0,175,0,11,186,0,0
"Oceania","2024-07-29",0,0,175,0,10,196,0,0
"Oceania","2024-07-30",0,32,207,0,11,207,0,0
"Oceania","2024-07-31",0,13,220,0,13,220,0,0
"Oceania","2024-08-01",0,0,220,0,4,224,0,0
"Oceania","2024-08-02",0,0,220,0,3,227,0,0
"Oceania","2024-08-03",0,0,220,0,4,231,0,0
"Oceania","2024-08-04",0,0,220,0,3,234,0,0
"Oceania","2024-08-05",0,0,220,0,4,238,0,0
"Oceania","2024-08-06",0,0,220,0,3,241,0,0
"Oceania","2024-08-07",0,0,220,0,4,245,0,0
"Oceania","2024-08-08",0,0,220,0,3,248,0,0
"Oceania","2024-08-09",0,0,220,0,4,252,0,0
"Oceania","2024-08-10",0,0,220,0,3,255,0,0
"Oceania","2024-08-11",0,0,220,0,4,259,0,0
"Oceania","2024-08-12",0,0,220,0,3,262,0,0
"Oceania","2024-08-13",0,0,220,0,4,266,0,0
"Oceania","2024-08-14",0,0,220,0,3,269,0,0
"Oceania","2024-08-15",0,0,220,0,4,273,0,0
"Oceania","2024-08-16",0,0,220,0,3,276,0,0
"Oceania","2024-08-17",0,0,220,0,4,280,0,0
"Oceania","2024-08-18",0,0,220,0,3,283,0,0
"Oceania","2024-08-19",0,0,220,0,4,287,0,0
"Oceania","2024-08-20",0,0,220,0,3,290,0,0
"Oceania","2024-08-21",0,74,294,0,4,294,0,0
"Oceania","2024-08-22",0,0,294,0,9,303,0,0
"Oceania","2024-08-23",0,0,294,0,9,312,0,0
"Oceania","2024-08-24",0,0,294,0,8,320,0,0
"Oceania","2024-08-25",0,0,294,0,9,329,0,0
"Oceania","2024-08-26",0,0,294,0,9,338,0,0
"Oceania","2024-08-27",0,0,294,0,8,346,0,0
"Oceania","2024-08-28",0,0,294,0,9,355,0,0
"Oceania","2024-08-29",0,70,364,0,9,364,0,0
"Oceania","2024-08-30",0,0,364,0,50,414,0,0
"Oceania","2024-08-31",0,101,465,0,51,465,0,0
"Oceania","2024-09-01",0,0,465,0,4,469,0,0
"Oceania","2024-09-02",0,0,465,0,5,474,0,0
"Oceania","2024-09-03",0,0,465,0,4,478,0,0
"Oceania","2024-09-04",0,0,465,0,5,483,0,0
"Oceania","2024-09-05",0,0,465,0,4,487,0,0
"Oceania","2024-09-06",0,0,465,0,4,491,0,0
"Oceania","2024-09-07",0,0,465,0,5,496,0,0
"Oceania","2024-09-08",0,35,500,0,4,500,0,0
"Oceania","2024-09-09",0,0,500,0,12,512,0,0
"Oceania","2024-09-10",0,0,500,0,12,524,0,0
"Oceania","2024-09-11",0,0,500,0,12,536,0,0
"Oceania","2024-09-12",0,0,500,0,12,548,0,0
"Oceania","2024-09-13",0,0,500,0,12,560,0,0
"Oceania","2024-09-14",0,0,500,0,12,572,0,0
"Oceania","2024-09-15",0,84,584,0,12,584,0,0
"Oceania","2024-09-16",0,0,584,0,13,597,0,0
"Oceania","2024-09-17",0,0,584,0,13,610,0,0
"Oceania","2024-09-18",0,0,584,0,13,623,0,0
"Oceania","2024-09-19",0,0,584,0,14,637,0,0
"Oceania","2024-09-20",0,0,584,0,13,650,0,0
"Oceania","2024-09-21",0,0,584,0,13,663,0,0
"Oceania","2024-09-22",0,92,676,0,13,676,0,0
"Oceania","2024-09-23",0,0,676,0,13,689,0,0
"Oceania","2024-09-24",0,0,676,0,13,702,0,0
"Oceania","2024-09-25",0,0,676,0,13,715,0,0
"Oceania","2024-09-26",0,0,676,0,13,728,0,0
"Oceania","2024-09-27",0,0,676,0,13,741,0,0
"Oceania","2024-09-28",0,0,676,0,13,754,0,0
"Oceania","2024-09-29",0,91,767,0,13,767,0,0
"Oceania","2024-09-30",0,0,767,0,10,777,0,0
"Oceania","2024-10-01",0,0,767,0,11,788,0,0
"Oceania","2024-10-02",0,0,767,0,10,798,0,0
"Oceania","2024-10-03",0,0,767,0,10,808,0,0
"Oceania","2024-10-04",0,0,767,0,10,818,0,0
"Oceania","2024-10-05",0,0,767,0,11,829,0,0
"Oceania","2024-10-06",0,72,839,0,10,839,0,0
"Oceania","2024-10-07",0,23,862,0,23,862,0,0
"Oceania","2024-10-08",0,0,862,0,9,871,0,0
"Oceania","2024-10-09",0,0,862,0,9,880,0,0
"Oceania","2024-10-10",0,0,862,0,9,889,0,0
"Oceania","2024-10-11",0,0,862,0,9,898,0,0
"Oceania","2024-10-12",0,0,862,0,9,907,0,0
"Oceania","2024-10-13",0,54,916,0,9,916,0,0
"Oceania","2024-10-14",0,0,916,0,6,922,0,0
"Oceania","2024-10-15",0,12,928,0,6,928,0,0
"Oceania","2024-10-16",0,0,928,0,16,944,0,0
"Oceania","2024-10-17",0,0,928,0,16,960,0,0
"Oceania","2024-10-18",0,0,928,0,15,975,0,0
"Oceania","2024-10-19",0,0,928,0,16,991,0,0
"Oceania","2024-10-20",0,79,1007,0,16,1007,0,0
"Oceania","2024-10-21",0,0,1007,0,10,1017,0,0
"Oceania","2024-10-22",0,0,1007,0,9,1026,0,0
"Oceania","2024-10-23",0,0,1007,0,10,1036,0,0
"Oceania","2024-10-24",0,0,1007,0,10,1046,0,0
"Oceania","2024-10-25",0,0,1007,0,10,1056,0,0
"Oceania","2024-10-26",0,0,1007,0,9,1065,0,0
"Oceania","2024-10-27",0,68,1075,0,10,1075,0,0
"Oceania","2024-10-28",0,0,1075,0,11,1086,0,0
"Oceania","2024-10-29",0,0,1075,0,12,1098,0,0
"Oceania","2024-10-30",0,0,1075,0,11,1109,0,0
"Oceania","2024-10-31",0,0,1075,0,11,1120,0,0
"Oceania","2024-11-01",0,0,1075,0,11,1131,0,0
"Oceania","2024-11-02",0,0,1075,0,12,1143,0,0
"Oceania","2024-11-03",0,79,1154,0,11,1154,0,0
"Oceania","2024-11-04",0,1,1155,0,1,1155,0,0
"Oceania","2024-11-05",0,0,1155,0,10,1165,0,0
"Oceania","2024-11-06",0,0,1155,0,9,1174,0,0
"Oceania","2024-11-07",0,0,1155,0,9,1183,0,0
"Oceania","2024-11-08",0,0,1155,0,10,1193,0,0
"Oceania","2024-11-09",0,0,1155,0,10,1203,0,0
"Oceania","2024-11-10",0,57,1212,0,9,1212,0,0
"Oceania","2024-11-11",0,0,1212,0,7,1219,0,0
"Oceania","2024-11-12",0,0,1212,0,7,1226,0,0
"Oceania","2024-11-13",0,0,1212,0,7,1233,0,0
"Oceania","2024-11-14",0,0,1212,0,7,1240,0,0
"Oceania","2024-11-15",0,0,1212,0,7,1247,0,0
"Oceania","2024-11-16",0,0,1212,0,7,1254,0,0
"Oceania","2024-11-17",0,49,1261,0,7,1261,0,0
"Oceania","2024-11-18",0,0,1261,0,4,1265,0,0
"Oceania","2024-11-19",0,0,1261,0,4,1269,0,0
"Oceania","2024-11-20",0,0,1261,0,4,1273,0,0
"Oceania","2024-11-21",0,0,1261,0,5,1278,0,0
"Oceania","2024-11-22",0,0,1261,0,4,1282,0,0
"Oceania","2024-11-23",0,0,1261,0,4,1286,0,0
"Oceania","2024-11-24",0,29,1290,0,4,1290,0,0
"Oceania","2024-11-25",0,0,1290,0,5,1295,0,0
"Oceania","2024-11-26",0,0,1290,0,5,1300,0,0
"Oceania","2024-11-27",0,0,1290,0,5,1305,0,0
"Oceania","2024-11-28",0,0,1290,0,4,1309,0,0
"Oceania","2024-11-29",0,0,1290,0,5,1314,0,0
"Oceania","2024-11-30",0,0,1290,0,5,1319,0,0
"Oceania","2024-12-01",0,34,1324,0,5,1324,0,0
"Oceania","2024-12-02",0,0,1324,0,1,1325,0,0
"Oceania","2024-12-03",0,0,1324,0,1,1326,0,0
"Oceania","2024-12-04",0,0,1324,0,0,1326,0,0
"Oceania","2024-12-05",0,3,1327,0,1,1327,0,0
"Oceania","2024-12-06",0,0,1327,0,6,1333,0,0
"Oceania","2024-12-07",0,0,1327,0,7,1340,0,0
"Oceania","2024-12-08",0,0,1327,0,7,1347,0,0
"Oceania","2024-12-09",0,26,1353,0,6,1353,0,0
"Oceania","2024-12-10",0,0,1353,0,4,1357,0,0
"Oceania","2024-12-11",0,0,1353,0,5,1362,0,0
"Oceania","2024-12-12",0,0,1353,0,4,1366,0,0
"Oceania","2024-12-13",0,0,1353,0,4,1370,0,0
"Oceania","2024-12-14",0,0,1353,0,5,1375,0,0
"Oceania","2024-12-15",0,26,1379,0,4,1379,0,0
"Oceania","2024-12-16",0,0,1379,0,0,1379,0,0
"Oceania","2024-12-17",0,0,1379,0,0,1379,0,0
"Oceania","2024-12-18",0,0,1379,0,0,1379,0,0
"Oceania","2024-12-19",0,0,1379,0,0,1379,0,0
"Oceania","2024-12-20",0,0,1379,0,0,1379,0,0
"Oceania","2024-12-21",0,0,1379,0,0,1379,0,0
"Oceania","2024-12-22",0,0,1379,0,0,1379,0,0
"Oceania","2024-12-23",0,0,1379,0,0,1379,0,0
"Oceania","2024-12-24",0,0,1379,0,0,1379,0,0
"Oceania","2024-12-25",0,0,1379,0,0,1379,0,0
"Oceania","2024-12-26",0,0,1379,0,0,1379,0,0
"Oceania","2024-12-27",0,0,1379,0,0,1379,0,0
"Oceania","2024-12-28",0,0,1379,0,0,1379,0,0
"Oceania","2024-12-29",0,0,1379,0,0,1379,0,0
"Oceania","2024-12-30",0,0,1379,0,0,1379,0,0
"Oceania","2024-12-31",0,0,1379,0,0,1379,0,0
"Oceania","2025-01-01",0,0,1379,0,0,1379,0,0
"Oceania","2025-01-02",0,0,1379,0,0,1379,0,0
"Oceania","2025-01-03",0,0,1379,0,0,1379,0,0
"Oceania","2025-01-04",0,0,1379,0,0,1379,0,0
"Oceania","2025-01-05",0,0,1379,0,0,1379,0,0
"Oceania","2025-01-06",0,0,1379,0,0,1379,0,0
"Oceania","2025-01-07",0,0,1379,0,0,1379,0,0
"Oceania","2025-01-08",0,0,1379,0,0,1379,0,0
"Oceania","2025-01-09",0,0,1379,0,0,1379,0,0
"Oceania","2025-01-10",0,0,1379,0,0,1379,0,0
"Oceania","2025-01-11",0,0,1379,0,0,1379,0,0
"Oceania","2025-01-12",0,0,1379,0,0,1379,0,0
"Oceania","2025-01-13",0,0,1379,0,0,1379,0,0
"Oman","2024-01-01",0,0,0,0,0,0,0,0
"Oman","2024-01-02",0,0,0,0,0,0,0,0
"Oman","2024-01-03",0,0,0,0,0,0,0,0
"Oman","2024-01-04",0,0,0,0,0,0,0,0
"Oman","2024-01-05",0,0,0,0,0,0,0,0
"Oman","2024-01-06",0,0,0,0,0,0,0,0
"Oman","2024-01-07",0,0,0,0,0,0,0,0
"Oman","2024-01-08",0,0,0,0,0,0,0,0
"Oman","2024-01-09",0,0,0,0,0,0,0,0
"Oman","2024-01-10",0,0,0,0,0,0,0,0
"Oman","2024-01-11",0,0,0,0,0,0,0,0
"Oman","2024-01-12",0,0,0,0,0,0,0,0
"Oman","2024-01-13",0,0,0,0,0,0,0,0
"Oman","2024-01-14",0,0,0,0,0,0,0,0
"Oman","2024-01-15",0,0,0,0,0,0,0,0
"Oman","2024-01-16",0,0,0,0,0,0,0,0
"Oman","2024-01-17",0,0,0,0,0,0,0,0
"Oman","2024-01-18",0,0,0,0,0,0,0,0
"Oman","2024-01-19",0,0,0,0,0,0,0,0
"Oman","2024-01-20",0,0,0,0,0,0,0,0
"Oman","2024-01-21",0,0,0,0,0,0,0,0
"Oman","2024-01-22",0,0,0,0,0,0,0,0
"Oman","2024-01-23",0,0,0,0,0,0,0,0
"Oman","2024-01-24",0,0,0,0,0,0,0,0
"Oman","2024-01-25",0,0,0,0,0,0,0,0
"Oman","2024-01-26",0,0,0,0,0,0,0,0
"Oman","2024-01-27",0,0,0,0,0,0,0,0
"Oman","2024-01-28",0,0,0,0,0,0,0,0
"Oman","2024-01-29",0,0,0,0,0,0,0,0
"Oman","2024-01-30",0,0,0,0,0,0,0,0
"Oman","2024-01-31",0,0,0,0,0,0,0,0
"Oman","2024-02-01",0,0,0,0,0,0,0,0
"Oman","2024-02-02",0,0,0,0,0,0,0,0
"Oman","2024-02-03",0,0,0,0,0,0,0,0
"Oman","2024-02-04",0,0,0,0,0,0,0,0
"Oman","2024-02-05",0,0,0,0,0,0,0,0
"Oman","2024-02-06",0,0,0,0,0,0,0,0
"Oman","2024-02-07",0,0,0,0,0,0,0,0
"Oman","2024-02-08",0,0,0,0,0,0,0,0
"Oman","2024-02-09",0,0,0,0,0,0,0,0
"Oman","2024-02-10",0,0,0,0,0,0,0,0
"Oman","2024-02-11",0,0,0,0,0,0,0,0
"Oman","2024-02-12",0,0,0,0,0,0,0,0
"Oman","2024-02-13",0,0,0,0,0,0,0,0
"Oman","2024-02-14",0,0,0,0,0,0,0,0
"Oman","2024-02-15",0,0,0,0,0,0,0,0
"Oman","2024-02-16",0,0,0,0,0,0,0,0
"Oman","2024-02-17",0,0,0,0,0,0,0,0
"Oman","2024-02-18",0,0,0,0,0,0,0,0
"Oman","2024-02-19",0,0,0,0,0,0,0,0
"Oman","2024-02-20",0,0,0,0,0,0,0,0
"Oman","2024-02-21",0,0,0,0,0,0,0,0
"Oman","2024-02-22",0,0,0,0,0,0,0,0
"Oman","2024-02-23",0,0,0,0,0,0,0,0
"Oman","2024-02-24",0,0,0,0,0,0,0,0
"Oman","2024-02-25",0,0,0,0,0,0,0,0
"Oman","2024-02-26",0,0,0,0,0,0,0,0
"Oman","2024-02-27",0,0,0,0,0,0,0,0
"Oman","2024-02-28",0,0,0,0,0,0,0,0
"Oman","2024-02-29",0,0,0,0,0,0,0,0
"Oman","2024-03-01",0,0,0,0,0,0,0,0
"Oman","2024-03-02",0,0,0,0,0,0,0,0
"Oman","2024-03-03",0,0,0,0,0,0,0,0
"Oman","2024-03-04",0,0,0,0,0,0,0,0
"Oman","2024-03-05",0,0,0,0,0,0,0,0
"Oman","2024-03-06",0,0,0,0,0,0,0,0
"Oman","2024-03-07",0,0,0,0,0,0,0,0
"Oman","2024-03-08",0,0,0,0,0,0,0,0
"Oman","2024-03-09",0,0,0,0,0,0,0,0
"Oman","2024-03-10",0,0,0,0,0,0,0,0
"Oman","2024-03-11",0,0,0,0,0,0,0,0
"Oman","2024-03-12",0,0,0,0,0,0,0,0
"Oman","2024-03-13",0,0,0,0,0,0,0,0
"Oman","2024-03-14",0,0,0,0,0,0,0,0
"Oman","2024-03-15",0,0,0,0,0,0,0,0
"Oman","2024-03-16",0,0,0,0,0,0,0,0
"Oman","2024-03-17",0,0,0,0,0,0,0,0
"Oman","2024-03-18",0,0,0,0,0,0,0,0
"Oman","2024-03-19",0,0,0,0,0,0,0,0
"Oman","2024-03-20",0,0,0,0,0,0,0,0
"Oman","2024-03-21",0,0,0,0,0,0,0,0
"Oman","2024-03-22",0,0,0,0,0,0,0,0
"Oman","2024-03-23",0,0,0,0,0,0,0,0
"Oman","2024-03-24",0,0,0,0,0,0,0,0
"Oman","2024-03-25",0,0,0,0,0,0,0,0
"Oman","2024-03-26",0,0,0,0,0,0,0,0
"Oman","2024-03-27",0,0,0,0,0,0,0,0
"Oman","2024-03-28",0,0,0,0,0,0,0,0
"Oman","2024-03-29",0,0,0,0,0,0,0,0
"Oman","2024-03-30",0,0,0,0,0,0,0,0
"Oman","2024-03-31",0,0,0,0,0,0,0,0
"Oman","2024-04-01",0,0,0,0,0,0,0,0
"Oman","2024-04-02",0,0,0,0,0,0,0,0
"Oman","2024-04-03",0,0,0,0,0,0,0,0
"Oman","2024-04-04",0,0,0,0,0,0,0,0
"Oman","2024-04-05",0,0,0,0,0,0,0,0
"Oman","2024-04-06",0,0,0,0,0,0,0,0
"Oman","2024-04-07",0,0,0,0,0,0,0,0
"Oman","2024-04-08",0,0,0,0,0,0,0,0
"Oman","2024-04-09",0,0,0,0,0,0,0,0
"Oman","2024-04-10",0,0,0,0,0,0,0,0
"Oman","2024-04-11",0,0,0,0,0,0,0,0
"Oman","2024-04-12",0,0,0,0,0,0,0,0
"Oman","2024-04-13",0,0,0,0,0,0,0,0
"Oman","2024-04-14",0,0,0,0,0,0,0,0
"Oman","2024-04-15",0,0,0,0,0,0,0,0
"Oman","2024-04-16",0,0,0,0,0,0,0,0
"Oman","2024-04-17",0,0,0,0,0,0,0,0
"Oman","2024-04-18",0,0,0,0,0,0,0,0
"Oman","2024-04-19",0,0,0,0,0,0,0,0
"Oman","2024-04-20",0,0,0,0,0,0,0,0
"Oman","2024-04-21",0,0,0,0,0,0,0,0
"Oman","2024-04-22",0,0,0,0,0,0,0,0
"Oman","2024-04-23",0,0,0,0,0,0,0,0
"Oman","2024-04-24",0,0,0,0,0,0,0,0
"Oman","2024-04-25",0,0,0,0,0,0,0,0
"Oman","2024-04-26",0,0,0,0,0,0,0,0
"Oman","2024-04-27",0,0,0,0,0,0,0,0
"Oman","2024-04-28",0,0,0,0,0,0,0,0
"Oman","2024-04-29",0,0,0,0,0,0,0,0
"Oman","2024-04-30",0,0,0,0,0,0,0,0
"Oman","2024-05-01",0,0,0,0,0,0,0,0
"Oman","2024-05-02",0,0,0,0,0,0,0,0
"Oman","2024-05-03",0,0,0,0,0,0,0,0
"Oman","2024-05-04",0,0,0,0,0,0,0,0
"Oman","2024-05-05",0,0,0,0,0,0,0,0
"Oman","2024-05-06",0,0,0,0,0,0,0,0
"Oman","2024-05-07",0,0,0,0,0,0,0,0
"Oman","2024-05-08",0,0,0,0,0,0,0,0
"Oman","2024-05-09",0,0,0,0,0,0,0,0
"Oman","2024-05-10",0,0,0,0,0,0,0,0
"Oman","2024-05-11",0,0,0,0,0,0,0,0
"Oman","2024-05-12",0,0,0,0,0,0,0,0
"Oman","2024-05-13",0,0,0,0,0,0,0,0
"Oman","2024-05-14",0,0,0,0,0,0,0,0
"Oman","2024-05-15",0,0,0,0,0,0,0,0
"Oman","2024-05-16",0,0,0,0,0,0,0,0
"Oman","2024-05-17",0,0,0,0,0,0,0,0
"Oman","2024-05-18",0,0,0,0,0,0,0,0
"Oman","2024-05-19",0,0,0,0,0,0,0,0
"Oman","2024-05-20",0,0,0,0,0,0,0,0
"Oman","2024-05-21",0,0,0,0,0,0,0,0
"Oman","2024-05-22",0,0,0,0,0,0,0,0
"Oman","2024-05-23",0,0,0,0,0,0,0,0
"Oman","2024-05-24",0,0,0,0,0,0,0,0
"Oman","2024-05-25",0,0,0,0,0,0,0,0
"Oman","2024-05-26",0,0,0,0,0,0,0,0
"Oman","2024-05-27",0,0,0,0,0,0,0,0
"Oman","2024-05-28",0,0,0,0,0,0,0,0
"Oman","2024-05-29",0,0,0,0,0,0,0,0
"Oman","2024-05-30",0,0,0,0,0,0,0,0
"Oman","2024-05-31",0,0,0,0,0,0,0,0
"Oman","2024-06-01",0,0,0,0,0,0,0,0
"Oman","2024-06-02",0,0,0,0,0,0,0,0
"Oman","2024-06-03",0,0,0,0,0,0,0,0
"Oman","2024-06-04",0,0,0,0,0,0,0,0
"Oman","2024-06-05",0,0,0,0,0,0,0,0
"Oman","2024-06-06",0,0,0,0,0,0,0,0
"Oman","2024-06-07",0,0,0,0,0,0,0,0
"Oman","2024-06-08",0,0,0,0,0,0,0,0
"Oman","2024-06-09",0,0,0,0,0,0,0,0
"Oman","2024-06-10",0,0,0,0,0,0,0,0
"Oman","2024-06-11",0,0,0,0,0,0,0,0
"Oman","2024-06-12",0,0,0,0,0,0,0,0
"Oman","2024-06-13",0,0,0,0,0,0,0,0
"Oman","2024-06-14",0,0,0,0,0,0,0,0
"Oman","2024-06-15",0,0,0,0,0,0,0,0
"Oman","2024-06-16",0,0,0,0,0,0,0,0
"Oman","2024-06-17",0,0,0,0,0,0,0,0
"Oman","2024-06-18",0,0,0,0,0,0,0,0
"Oman","2024-06-19",0,0,0,0,0,0,0,0
"Oman","2024-06-20",0,0,0,0,0,0,0,0
"Oman","2024-06-21",0,0,0,0,0,0,0,0
"Oman","2024-06-22",0,0,0,0,0,0,0,0
"Oman","2024-06-23",0,0,0,0,0,0,0,0
"Oman","2024-06-24",0,0,0,0,0,0,0,0
"Oman","2024-06-25",0,0,0,0,0,0,0,0
"Oman","2024-06-26",0,0,0,0,0,0,0,0
"Oman","2024-06-27",0,0,0,0,0,0,0,0
"Oman","2024-06-28",0,0,0,0,0,0,0,0
"Oman","2024-06-29",0,0,0,0,0,0,0,0
"Oman","2024-06-30",0,0,0,0,0,0,0,0
"Oman","2024-07-01",0,0,0,0,0,0,0,0
"Oman","2024-07-02",0,0,0,0,0,0,0,0
"Oman","2024-07-03",0,0,0,0,0,0,0,0
"Oman","2024-07-04",0,0,0,0,0,0,0,0
"Oman","2024-07-05",0,0,0,0,0,0,0,0
"Oman","2024-07-06",0,0,0,0,0,0,0,0
"Oman","2024-07-07",0,0,0,0,0,0,0,0
"Oman","2024-07-08",0,0,0,0,0,0,0,0
"Oman","2024-07-09",0,0,0,0,0,0,0,0
"Oman","2024-07-10",0,0,0,0,0,0,0,0
"Oman","2024-07-11",0,0,0,0,0,0,0,0
"Oman","2024-07-12",0,0,0,0,0,0,0,0
"Oman","2024-07-13",0,0,0,0,0,0,0,0
"Oman","2024-07-14",0,0,0,0,0,0,0,0
"Oman","2024-07-15",0,0,0,0,0,0,0,0
"Oman","2024-07-16",0,0,0,0,0,0,0,0
"Oman","2024-07-17",0,0,0,0,0,0,0,0
"Oman","2024-07-18",0,0,0,0,0,0,0,0
"Oman","2024-07-19",0,0,0,0,0,0,0,0
"Oman","2024-07-20",0,0,0,0,0,0,0,0
"Oman","2024-07-21",0,0,0,0,0,0,0,0
"Oman","2024-07-22",0,0,0,0,0,0,0,0
"Oman","2024-07-23",0,0,0,0,0,0,0,0
"Oman","2024-07-24",0,0,0,0,0,0,0,0
"Oman","2024-07-25",0,0,0,0,0,0,0,0
"Oman","2024-07-26",0,0,0,0,0,0,0,0
"Oman","2024-07-27",0,0,0,0,0,0,0,0
"Oman","2024-07-28",0,0,0,0,0,0,0,0
"Oman","2024-07-29",0,0,0,0,0,0,0,0
"Oman","2024-07-30",0,0,0,0,0,0,0,0
"Oman","2024-07-31",0,0,0,0,0,0,0,0
"Oman","2024-08-01",0,0,0,0,0,0,0,0
"Oman","2024-08-02",0,0,0,0,0,0,0,0
"Oman","2024-08-03",0,0,0,0,0,0,0,0
"Oman","2024-08-04",0,0,0,0,0,0,0,0
"Oman","2024-08-05",0,0,0,0,0,0,0,0
"Oman","2024-08-06",0,0,0,0,0,0,0,0
"Oman","2024-08-07",0,0,0,0,0,0,0,0
"Oman","2024-08-08",0,0,0,0,0,0,0,0
"Oman","2024-08-09",0,0,0,0,0,0,0,0
"Oman","2024-08-10",0,0,0,0,0,0,0,0
"Oman","2024-08-11",0,0,0,0,0,0,0,0
"Oman","2024-08-12",0,0,0,0,0,0,0,0
"Oman","2024-08-13",0,0,0,0,0,0,0,0
"Oman","2024-08-14",0,0,0,0,0,0,0,0
"Oman","2024-08-15",0,0,0,0,0,0,0,0
"Oman","2024-08-16",0,0,0,0,0,0,0,0
"Oman","2024-08-17",0,0,0,0,0,0,0,0
"Oman","2024-08-18",0,0,0,0,0,0,0,0
"Oman","2024-08-19",0,0,0,0,0,0,0,0
"Oman","2024-08-20",0,0,0,0,0,0,0,0
"Oman","2024-08-21",0,0,0,0,0,0,0,0
"Oman","2024-08-22",0,0,0,0,0,0,0,0
"Oman","2024-08-23",0,0,0,0,0,0,0,0
"Oman","2024-08-24",0,0,0,0,0,0,0,0
"Oman","2024-08-25",0,0,0,0,0,0,0,0
"Oman","2024-08-26",0,0,0,0,0,0,0,0
"Oman","2024-08-27",0,0,0,0,0,0,0,0
"Oman","2024-08-28",0,0,0,0,0,0,0,0
"Oman","2024-08-29",0,0,0,0,0,0,0,0
"Oman","2024-08-30",0,0,0,0,0,0,0,0
"Oman","2024-08-31",0,0,0,0,0,0,0,0
"Oman","2024-09-01",0,0,0,0,0,0,0,0
"Oman","2024-09-02",0,0,0,0,0,0,0,0
"Oman","2024-09-03",0,0,0,0,0,0,0,0
"Oman","2024-09-04",0,0,0,0,0,0,0,0
"Oman","2024-09-05",0,0,0,0,0,0,0,0
"Oman","2024-09-06",0,0,0,0,0,0,0,0
"Oman","2024-09-07",0,0,0,0,0,0,0,0
"Oman","2024-09-08",0,0,0,0,0,0,0,0
"Oman","2024-09-09",0,0,0,0,0,0,0,0
"Oman","2024-09-10",0,0,0,0,0,0,0,0
"Oman","2024-09-11",0,0,0,0,0,0,0,0
"Oman","2024-09-12",0,0,0,0,0,0,0,0
"Oman","2024-09-13",0,0,0,0,0,0,0,0
"Oman","2024-09-14",0,0,0,0,0,0,0,0
"Oman","2024-09-15",0,0,0,0,0,0,0,0
"Oman","2024-09-16",0,0,0,0,0,0,0,0
"Oman","2024-09-17",0,0,0,0,0,0,0,0
"Oman","2024-09-18",0,0,0,0,0,0,0,0
"Oman","2024-09-19",0,0,0,0,0,0,0,0
"Oman","2024-09-20",0,0,0,0,0,0,0,0
"Oman","2024-09-21",0,0,0,0,0,0,0,0
"Oman","2024-09-22",0,0,0,0,0,0,0,0
"Oman","2024-09-23",0,0,0,0,0,0,0,0
"Oman","2024-09-24",0,0,0,0,0,0,0,0
"Oman","2024-09-25",0,0,0,0,0,0,0,0
"Oman","2024-09-26",0,0,0,0,0,0,0,0
"Oman","2024-09-27",0,0,0,0,0,0,0,0
"Oman","2024-09-28",0,0,0,0,0,0,0,0
"Oman","2024-09-29",0,0,0,0,0,0,0,0
"Oman","2024-09-30",0,0,0,0,0,0,0,0
"Oman","2024-10-01",0,0,0,0,0,0,0,0
"Oman","2024-10-02",0,1,1,0,1,1,0,0
"Oman","2024-10-03",0,0,1,0,0,1,0,0
"Oman","2024-10-04",0,0,1,0,0,1,0,0
"Oman","2024-10-05",0,0,1,0,0,1,0,0
"Oman","2024-10-06",0,0,1,0,0,1,0,0
"Oman","2024-10-07",0,0,1,0,0,1,0,0
"Oman","2024-10-08",0,0,1,0,0,1,0,0
"Oman","2024-10-09",0,0,1,0,0,1,0,0
"Oman","2024-10-10",0,0,1,0,0,1,0,0
"Oman","2024-10-11",0,0,1,0,0,1,0,0
"Oman","2024-10-12",0,0,1,0,0,1,0,0
"Oman","2024-10-13",0,0,1,0,0,1,0,0
"Oman","2024-10-14",0,0,1,0,0,1,0,0
"Oman","2024-10-15",0,0,1,0,0,1,0,0
"Oman","2024-10-16",0,0,1,0,0,1,0,0
"Oman","2024-10-17",0,0,1,0,0,1,0,0
"Oman","2024-10-18",0,0,1,0,0,1,0,0
"Oman","2024-10-19",0,0,1,0,0,1,0,0
"Oman","2024-10-20",0,0,1,0,0,1,0,0
"Oman","2024-10-21",0,0,1,0,0,1,0,0
"Oman","2024-10-22",0,0,1,0,0,1,0,0
"Oman","2024-10-23",0,0,1,0,0,1,0,0
"Oman","2024-10-24",0,0,1,0,0,1,0,0
"Oman","2024-10-25",0,0,1,0,0,1,0,0
"Oman","2024-10-26",0,0,1,0,0,1,0,0
"Oman","2024-10-27",0,0,1,0,0,1,0,0
"Oman","2024-10-28",0,0,1,0,0,1,0,0
"Oman","2024-10-29",0,0,1,0,0,1,0,0
"Oman","2024-10-30",0,0,1,0,0,1,0,0
"Oman","2024-10-31",0,0,1,0,0,1,0,0
"Oman","2024-11-01",0,0,1,0,0,1,0,0
"Oman","2024-11-02",0,0,1,0,0,1,0,0
"Oman","2024-11-03",0,0,1,0,0,1,0,0
"Oman","2024-11-04",0,0,1,0,0,1,0,0
"Oman","2024-11-05",0,0,1,0,0,1,0,0
"Oman","2024-11-06",0,0,1,0,1,2,0,0
"Oman","2024-11-07",0,0,1,0,0,2,0,0
"Oman","2024-11-08",0,0,1,0,0,2,0,0
"Oman","2024-11-09",0,0,1,0,0,2,0,0
"Oman","2024-11-10",0,0,1,0,0,2,0,0
"Oman","2024-11-11",0,0,1,0,0,2,0,0
"Oman","2024-11-12",0,0,1,0,0,2,0,0
"Oman","2024-11-13",0,0,1,0,0,2,0,0
"Oman","2024-11-14",0,0,1,0,0,2,0,0
"Oman","2024-11-15",0,0,1,0,0,2,0,0
"Oman","2024-11-16",0,0,1,0,0,2,0,0
"Oman","2024-11-17",0,0,1,0,0,2,0,0
"Oman","2024-11-18",0,0,1,0,0,2,0,0
"Oman","2024-11-19",0,0,1,0,0,2,0,0
"Oman","2024-11-20",0,0,1,0,0,2,0,0
"Oman","2024-11-21",0,0,1,0,0,2,0,0
"Oman","2024-11-22",0,0,1,0,0,2,0,0
"Oman","2024-11-23",0,0,1,0,0,2,0,0
"Oman","2024-11-24",0,0,1,0,0,2,0,0
"Oman","2024-11-25",0,0,1,0,0,2,0,0
"Oman","2024-11-26",0,0,1,0,0,2,0,0
"Oman","2024-11-27",0,0,1,0,0,2,0,0
"Oman","2024-11-28",0,0,1,0,0,2,0,0
"Oman","2024-11-29",0,0,1,0,0,2,0,0
"Oman","2024-11-30",0,0,1,0,0,2,0,0
"Oman","2024-12-01",0,0,1,0,0,2,0,0
"Oman","2024-12-02",0,0,1,0,0,2,0,0
"Oman","2024-12-03",0,0,1,0,0,2,0,0
"Oman","2024-12-04",0,0,1,0,0,2,0,0
"Oman","2024-12-05",0,0,1,0,0,2,0,0
"Oman","2024-12-06",0,0,1,0,0,2,0,0
"Oman","2024-12-07",0,0,1,0,0,2,0,0
"Oman","2024-12-08",0,0,1,0,0,2,0,0
"Oman","2024-12-09",0,1,2,0,0,2,0,0
"Oman","2024-12-10",0,0,2,0,0,2,0,0
"Oman","2024-12-11",0,0,2,0,0,2,0,0
"Oman","2024-12-12",0,0,2,0,0,2,0,0
"Oman","2024-12-13",0,0,2,0,0,2,0,0
"Oman","2024-12-14",0,0,2,0,0,2,0,0
"Oman","2024-12-15",0,0,2,0,0,2,0,0
"Oman","2024-12-16",0,0,2,0,0,2,0,0
"Oman","2024-12-17",0,0,2,0,0,2,0,0
"Oman","2024-12-18",0,0,2,0,0,2,0,0
"Oman","2024-12-19",0,0,2,0,0,2,0,0
"Oman","2024-12-20",0,0,2,0,0,2,0,0
"Oman","2024-12-21",0,0,2,0,0,2,0,0
"Oman","2024-12-22",0,0,2,0,0,2,0,0
"Oman","2024-12-23",0,0,2,0,0,2,0,0
"Oman","2024-12-24",0,0,2,0,0,2,0,0
"Oman","2024-12-25",0,0,2,0,0,2,0,0
"Oman","2024-12-26",0,0,2,0,0,2,0,0
"Oman","2024-12-27",0,0,2,0,0,2,0,0
"Oman","2024-12-28",0,0,2,0,0,2,0,0
"Oman","2024-12-29",0,0,2,0,0,2,0,0
"Oman","2024-12-30",0,0,2,0,0,2,0,0
"Oman","2024-12-31",0,0,2,0,0,2,0,0
"Oman","2025-01-01",0,0,2,0,0,2,0,0
"Oman","2025-01-02",0,0,2,0,0,2,0,0
"Oman","2025-01-03",0,0,2,0,0,2,0,0
"Oman","2025-01-04",0,0,2,0,0,2,0,0
"Oman","2025-01-05",0,0,2,0,0,2,0,0
"Oman","2025-01-06",0,0,2,0,0,2,0,0
"Oman","2025-01-07",0,0,2,0,0,2,0,0
"Oman","2025-01-08",0,0,2,0,0,2,0,0
"Oman","2025-01-09",0,0,2,0,0,2,0,0
"Oman","2025-01-10",0,0,2,0,0,2,0,0
"Oman","2025-01-11",0,0,2,0,0,2,0,0
"Oman","2025-01-12",0,0,2,0,0,2,0,0
"Oman","2025-01-13",0,0,2,0,0,2,0,0
"Pakistan","2024-01-01",0,0,0,0,0,0,0,0
"Pakistan","2024-01-02",0,0,0,0,0,0,0,0
"Pakistan","2024-01-03",0,0,0,0,0,0,0,0
"Pakistan","2024-01-04",0,0,0,0,0,0,0,0
"Pakistan","2024-01-05",0,0,0,0,0,0,0,0
"Pakistan","2024-01-06",0,0,0,0,0,0,0,0
"Pakistan","2024-01-07",0,0,0,0,0,0,0,0
"Pakistan","2024-01-08",0,0,0,0,0,0,0,0
"Pakistan","2024-01-09",0,0,0,0,0,0,0,0
"Pakistan","2024-01-10",0,0,0,0,0,0,0,0
"Pakistan","2024-01-11",0,0,0,0,0,0,0,0
"Pakistan","2024-01-12",0,0,0,0,0,0,0,0
"Pakistan","2024-01-13",0,0,0,0,0,0,0,0
"Pakistan","2024-01-14",0,0,0,0,0,0,0,0
"Pakistan","2024-01-15",0,0,0,0,0,0,0,0
"Pakistan","2024-01-16",0,0,0,0,0,0,0,0
"Pakistan","2024-01-17",0,0,0,0,0,0,0,0
"Pakistan","2024-01-18",0,0,0,0,0,0,0,0
"Pakistan","2024-01-19",0,1,1,0,1,1,0,0
"Pakistan","2024-01-20",0,0,1,0,0,1,0,0
"Pakistan","2024-01-21",0,0,1,0,0,1,0,0
"Pakistan","2024-01-22",0,0,1,0,0,1,0,0
"Pakistan","2024-01-23",0,0,1,0,0,1,0,0
"Pakistan","2024-01-24",0,0,1,0,0,1,0,0
"Pakistan","2024-01-25",0,0,1,0,0,1,0,0
"Pakistan","2024-01-26",0,0,1,0,0,1,0,0
"Pakistan","2024-01-27",0,0,1,0,0,1,0,0
"Pakistan","2024-01-28",0,0,1,0,0,1,0,0
"Pakistan","2024-01-29",0,0,1,0,0,1,0,0
"Pakistan","2024-01-30",0,0,1,0,0,1,0,0
"Pakistan","2024-01-31",0,0,1,0,0,1,0,0
"Pakistan","2024-02-01",0,0,1,0,0,1,0,0
"Pakistan","2024-02-02",0,0,1,0,0,1,0,0
"Pakistan","2024-02-03",0,0,1,0,0,1,0,0
"Pakistan","2024-02-04",0,0,1,0,0,1,0,0
"Pakistan","2024-02-05",0,0,1,0,0,1,0,0
"Pakistan","2024-02-06",0,0,1,0,0,1,0,0
"Pakistan","2024-02-07",0,0,1,0,0,1,0,0
"Pakistan","2024-02-08",0,0,1,0,0,1,0,0
"Pakistan","2024-02-09",0,0,1,0,0,1,0,0
"Pakistan","2024-02-10",0,0,1,0,0,1,0,0
"Pakistan","2024-02-11",0,0,1,0,0,1,0,0
"Pakistan","2024-02-12",0,0,1,0,0,1,0,0
"Pakistan","2024-02-13",0,0,1,0,0,1,0,0
"Pakistan","2024-02-14",0,0,1,0,0,1,0,0
"Pakistan","2024-02-15",0,0,1,0,0,1,0,0
"Pakistan","2024-02-16",0,0,1,0,0,1,0,0
"Pakistan","2024-02-17",0,0,1,0,0,1,0,0
"Pakistan","2024-02-18",0,0,1,0,0,1,0,0
"Pakistan","2024-02-19",0,0,1,0,0,1,0,0
"Pakistan","2024-02-20",0,0,1,0,0,1,0,0
"Pakistan","2024-02-21",0,0,1,0,0,1,0,0
"Pakistan","2024-02-22",0,0,1,0,0,1,0,0
"Pakistan","2024-02-23",0,0,1,0,0,1,0,0
"Pakistan","2024-02-24",0,0,1,0,0,1,0,0
"Pakistan","2024-02-25",0,0,1,0,0,1,0,0
"Pakistan","2024-02-26",0,0,1,0,0,1,0,0
"Pakistan","2024-02-27",0,0,1,0,0,1,0,0
"Pakistan","2024-02-28",0,0,1,0,0,1,0,0
"Pakistan","2024-02-29",0,0,1,0,0,1,0,0
"Pakistan","2024-03-01",0,0,1,0,0,1,0,0
"Pakistan","2024-03-02",0,0,1,0,0,1,0,0
"Pakistan","2024-03-03",0,0,1,0,0,1,0,0
"Pakistan","2024-03-04",0,0,1,0,0,1,0,0
"Pakistan","2024-03-05",0,0,1,0,0,1,0,0
"Pakistan","2024-03-06",0,0,1,0,0,1,0,0
"Pakistan","2024-03-07",0,0,1,0,0,1,0,0
"Pakistan","2024-03-08",0,0,1,0,0,1,0,0
"Pakistan","2024-03-09",0,0,1,0,0,1,0,0
"Pakistan","2024-03-10",0,0,1,0,0,1,0,0
"Pakistan","2024-03-11",0,0,1,0,0,1,0,0
"Pakistan","2024-03-12",0,0,1,0,0,1,0,0
"Pakistan","2024-03-13",0,0,1,0,0,1,0,0
"Pakistan","2024-03-14",0,0,1,0,0,1,0,0
"Pakistan","2024-03-15",0,0,1,0,0,1,0,0
"Pakistan","2024-03-16",0,0,1,0,0,1,0,0
"Pakistan","2024-03-17",0,0,1,0,0,1,0,0
"Pakistan","2024-03-18",0,0,1,0,0,1,0,0
"Pakistan","2024-03-19",0,0,1,0,0,1,0,0
"Pakistan","2024-03-20",0,0,1,0,0,1,0,0
"Pakistan","2024-03-21",0,0,1,0,0,1,0,0
"Pakistan","2024-03-22",0,0,1,0,0,1,0,0
"Pakistan","2024-03-23",0,0,1,0,0,1,0,0
"Pakistan","2024-03-24",0,0,1,0,0,1,0,0
"Pakistan","2024-03-25",0,0,1,0,0,1,0,0
"Pakistan","2024-03-26",0,0,1,0,0,1,0,0
"Pakistan","2024-03-27",0,0,1,0,0,1,0,0
"Pakistan","2024-03-28",0,0,1,0,0,1,0,0
"Pakistan","2024-03-29",0,0,1,0,0,1,0,0
"Pakistan","2024-03-30",0,0,1,0,0,1,0,0
"Pakistan","2024-03-31",0,0,1,0,0,1,0,0
"Pakistan","2024-04-01",0,0,1,0,0,1,0,0
"Pakistan","2024-04-02",0,0,1,0,0,1,0,0
"Pakistan","2024-04-03",0,0,1,0,0,1,0,0
"Pakistan","2024-04-04",0,0,1,0,0,1,0,0
"Pakistan","2024-04-05",0,0,1,0,0,1,0,0
"Pakistan","2024-04-06",0,0,1,0,0,1,0,0
"Pakistan","2024-04-07",0,0,1,0,0,1,0,0
"Pakistan","2024-04-08",0,0,1,0,0,1,0,0
"Pakistan","2024-04-09",0,0,1,0,0,1,0,0
"Pakistan","2024-04-10",0,0,1,0,0,1,0,0
"Pakistan","2024-04-11",0,0,1,0,0,1,0,0
"Pakistan","2024-04-12",0,0,1,0,0,1,0,0
"Pakistan","2024-04-13",0,0,1,0,0,1,0,0
"Pakistan","2024-04-14",0,0,1,0,0,1,0,0
"Pakistan","2024-04-15",0,0,1,0,0,1,0,0
"Pakistan","2024-04-16",0,0,1,0,0,1,0,0
"Pakistan","2024-04-17",0,0,1,0,0,1,0,0
"Pakistan","2024-04-18",0,0,1,0,0,1,0,0
"Pakistan","2024-04-19",0,0,1,0,0,1,0,0
"Pakistan","2024-04-20",0,0,1,0,0,1,0,0
"Pakistan","2024-04-21",0,0,1,0,0,1,0,0
"Pakistan","2024-04-22",0,0,1,0,0,1,0,0
"Pakistan","2024-04-23",0,0,1,0,0,1,0,0
"Pakistan","2024-04-24",0,0,1,0,0,1,0,0
"Pakistan","2024-04-25",0,0,1,0,0,1,0,0
"Pakistan","2024-04-26",0,0,1,0,0,1,0,0
"Pakistan","2024-04-27",0,0,1,0,0,1,0,0
"Pakistan","2024-04-28",0,0,1,0,0,1,0,0
"Pakistan","2024-04-29",0,0,1,0,0,1,0,0
"Pakistan","2024-04-30",0,0,1,0,0,1,0,0
"Pakistan","2024-05-01",0,0,1,0,0,1,0,0
"Pakistan","2024-05-02",0,0,1,0,0,1,0,0
"Pakistan","2024-05-03",0,0,1,0,1,2,0,0
"Pakistan","2024-05-04",0,0,1,0,0,2,0,0
"Pakistan","2024-05-05",0,0,1,0,0,2,0,0
"Pakistan","2024-05-06",0,0,1,0,0,2,0,0
"Pakistan","2024-05-07",0,0,1,0,0,2,0,0
"Pakistan","2024-05-08",0,0,1,0,0,2,0,0
"Pakistan","2024-05-09",0,0,1,0,0,2,0,0
"Pakistan","2024-05-10",0,0,1,0,0,2,0,0
"Pakistan","2024-05-11",0,0,1,0,0,2,0,0
"Pakistan","2024-05-12",0,0,1,0,0,2,0,0
"Pakistan","2024-05-13",0,0,1,0,0,2,0,0
"Pakistan","2024-05-14",0,0,1,0,0,2,0,0
"Pakistan","2024-05-15",0,0,1,0,0,2,0,0
"Pakistan","2024-05-16",0,0,1,0,0,2,0,0
"Pakistan","2024-05-17",0,0,1,0,0,2,0,0
"Pakistan","2024-05-18",0,0,1,0,0,2,0,0
"Pakistan","2024-05-19",0,0,1,0,0,2,0,0
"Pakistan","2024-05-20",0,0,1,0,0,2,0,0
"Pakistan","2024-05-21",0,0,1,0,0,2,0,0
"Pakistan","2024-05-22",0,0,1,0,0,2,0,0
"Pakistan","2024-05-23",0,0,1,0,0,2,0,0
"Pakistan","2024-05-24",0,0,1,0,0,2,0,0
"Pakistan","2024-05-25",0,0,1,0,0,2,0,0
"Pakistan","2024-05-26",0,0,1,0,0,2,0,0
"Pakistan","2024-05-27",0,0,1,0,0,2,0,0
"Pakistan","2024-05-28",0,0,1,0,0,2,0,0
"Pakistan","2024-05-29",0,0,1,0,0,2,0,0
"Pakistan","2024-05-30",0,0,1,0,0,2,0,0
"Pakistan","2024-05-31",0,0,1,0,0,2,0,0
"Pakistan","2024-06-01",0,0,1,0,0,2,0,0
"Pakistan","2024-06-02",0,0,1,0,0,2,0,0
"Pakistan","2024-06-03",0,0,1,0,0,2,0,0
"Pakistan","2024-06-04",0,0,1,0,0,2,0,0
"Pakistan","2024-06-05",0,0,1,0,0,2,0,0
"Pakistan","2024-06-06",0,0,1,0,0,2,0,0
"Pakistan","2024-06-07",0,0,1,0,0,2,0,0
"Pakistan","2024-06-08",0,0,1,0,0,2,0,0
"Pakistan","2024-06-09",0,0,1,0,0,2,0,0
"Pakistan","2024-06-10",0,0,1,0,0,2,0,0
"Pakistan","2024-06-11",0,0,1,0,0,2,0,0
"Pakistan","2024-06-12",0,0,1,0,0,2,0,0
"Pakistan","2024-06-13",0,0,1,0,0,2,0,0
"Pakistan","2024-06-14",0,0,1,0,0,2,0,0
"Pakistan","2024-06-15",0,0,1,0,0,2,0,0
"Pakistan","2024-06-16",0,0,1,0,0,2,0,0
"Pakistan","2024-06-17",0,0,1,0,0,2,0,0
"Pakistan","2024-06-18",0,0,1,0,0,2,0,0
"Pakistan","2024-06-19",0,0,1,0,0,2,0,0
"Pakistan","2024-06-20",0,0,1,0,0,2,0,0
"Pakistan","2024-06-21",0,0,1,0,0,2,0,0
"Pakistan","2024-06-22",0,0,1,0,0,2,0,0
"Pakistan","2024-06-23",0,0,1,0,0,2,0,0
"Pakistan","2024-06-24",0,0,1,0,0,2,0,0
"Pakistan","2024-06-25",0,0,1,0,0,2,0,0
"Pakistan","2024-06-26",0,0,1,0,0,2,0,0
"Pakistan","2024-06-27",0,0,1,0,0,2,0,0
"Pakistan","2024-06-28",0,0,1,0,0,2,0,0
"Pakistan","2024-06-29",0,0,1,0,0,2,0,0
"Pakistan","2024-06-30",0,0,1,0,0,2,0,0
"Pakistan","2024-07-01",0,0,1,0,0,2,0,0
"Pakistan","2024-07-02",0,0,1,0,0,2,0,0
"Pakistan","2024-07-03",0,0,1,0,0,2,0,0
"Pakistan","2024-07-04",0,0,1,0,0,2,0,0
"Pakistan","2024-07-05",0,0,1,0,0,2,0,0
"Pakistan","2024-07-06",0,0,1,0,0,2,0,0
"Pakistan","2024-07-07",0,0,1,0,0,2,0,0
"Pakistan","2024-07-08",0,0,1,0,0,2,0,0
"Pakistan","2024-07-09",0,0,1,0,0,2,0,0
"Pakistan","2024-07-10",0,0,1,0,0,2,0,0
"Pakistan","2024-07-11",0,0,1,0,0,2,0,0
"Pakistan","2024-07-12",0,0,1,0,0,2,0,0
"Pakistan","2024-07-13",0,0,1,0,0,2,0,0
"Pakistan","2024-07-14",0,0,1,0,0,2,0,0
"Pakistan","2024-07-15",0,0,1,0,0,2,0,0
"Pakistan","2024-07-16",0,0,1,0,0,2,0,0
"Pakistan","2024-07-17",0,0,1,0,0,2,0,0
"Pakistan","2024-07-18",0,0,1,0,0,2,0,0
"Pakistan","2024-07-19",0,0,1,0,0,2,0,0
"Pakistan","2024-07-20",0,0,1,0,0,2,0,0
"Pakistan","2024-07-21",0,0,1,0,0,2,0,0
"Pakistan","2024-07-22",0,0,1,0,0,2,0,0
"Pakistan","2024-07-23",0,0,1,0,0,2,0,0
"Pakistan","2024-07-24",0,0,1,0,0,2,0,0
"Pakistan","2024-07-25",0,0,1,0,0,2,0,0
"Pakistan","2024-07-26",0,0,1,0,0,2,0,0
"Pakistan","2024-07-27",0,0,1,0,0,2,0,0
"Pakistan","2024-07-28",0,0,1,0,0,2,0,0
"Pakistan","2024-07-29",0,0,1,0,0,2,0,0
"Pakistan","2024-07-30",0,0,1,0,0,2,0,0
"Pakistan","2024-07-31",0,0,1,0,0,2,0,0
"Pakistan","2024-08-01",0,0,1,0,0,2,0,0
"Pakistan","2024-08-02",0,0,1,0,0,2,0,0
"Pakistan","2024-08-03",0,0,1,0,0,2,0,0
"Pakistan","2024-08-04",0,0,1,0,0,2,0,0
"Pakistan","2024-08-05",0,0,1,0,0,2,0,0
"Pakistan","2024-08-06",0,0,1,0,0,2,0,0
"Pakistan","2024-08-07",0,0,1,0,0,2,0,0
"Pakistan","2024-08-08",0,0,1,0,0,2,0,0
"Pakistan","2024-08-09",0,0,1,0,0,2,0,0
"Pakistan","2024-08-10",0,0,1,0,0,2,0,0
"Pakistan","2024-08-11",0,0,1,0,0,2,0,0
"Pakistan","2024-08-12",0,0,1,0,0,2,0,0
"Pakistan","2024-08-13",0,0,1,0,0,2,0,0
"Pakistan","2024-08-14",0,1,2,0,0,2,0,0
"Pakistan","2024-08-15",0,0,2,0,0,2,0,0
"Pakistan","2024-08-16",0,0,2,0,0,2,0,0
"Pakistan","2024-08-17",0,0,2,0,0,2,0,0
"Pakistan","2024-08-18",0,0,2,0,0,2,0,0
"Pakistan","2024-08-19",0,0,2,0,1,3,0,0
"Pakistan","2024-08-20",0,0,2,0,0,3,0,0
"Pakistan","2024-08-21",0,0,2,0,0,3,0,0
"Pakistan","2024-08-22",0,1,3,0,0,3,0,0
"Pakistan","2024-08-23",0,0,3,0,0,3,0,0
"Pakistan","2024-08-24",0,0,3,0,0,3,0,0
"Pakistan","2024-08-25",0,0,3,0,0,3,0,0
"Pakistan","2024-08-26",0,0,3,0,0,3,0,0
"Pakistan","2024-08-27",0,0,3,0,0,3,0,0
"Pakistan","2024-08-28",0,0,3,0,0,3,0,0
"Pakistan","2024-08-29",0,0,3,0,0,3,0,0
"Pakistan","2024-08-30",0,0,3,0,0,3,0,0
"Pakistan","2024-08-31",0,0,3,0,0,3,0,0
"Pakistan","2024-09-01",0,0,3,0,0,3,0,0
"Pakistan","2024-09-02",0,0,3,0,0,3,0,0
"Pakistan","2024-09-03",0,0,3,0,0,3,0,0
"Pakistan","2024-09-04",0,0,3,0,0,3,0,0
"Pakistan","2024-09-05",0,0,3,0,0,3,0,0
"Pakistan","2024-09-06",0,0,3,0,0,3,0,0
"Pakistan","2024-09-07",0,0,3,0,0,3,0,0
"Pakistan","2024-09-08",0,0,3,0,0,3,0,0
"Pakistan","2024-09-09",0,0,3,0,0,3,0,0
"Pakistan","2024-09-10",0,0,3,0,0,3,0,0
"Pakistan","2024-09-11",0,0,3,0,0,3,0,0
"Pakistan","2024-09-12",0,0,3,0,0,3,0,0
"Pakistan","2024-09-13",0,0,3,0,0,3,0,0
"Pakistan","2024-09-14",0,0,3,0,0,3,0,0
"Pakistan","2024-09-15",0,0,3,0,0,3,0,0
"Pakistan","2024-09-16",0,0,3,0,0,3,0,0
"Pakistan","2024-09-17",0,0,3,0,0,3,0,0
"Pakistan","2024-09-18",0,0,3,0,0,3,0,0
"Pakistan","2024-09-19",0,0,3,0,0,3,0,0
"Pakistan","2024-09-20",0,0,3,0,0,3,0,0
"Pakistan","2024-09-21",0,0,3,0,0,3,0,0
"Pakistan","2024-09-22",0,0,3,0,0,3,0,0
"Pakistan","2024-09-23",0,0,3,0,0,3,0,0
"Pakistan","2024-09-24",0,0,3,0,0,3,0,0
"Pakistan","2024-09-25",0,0,3,0,0,3,0,0
"Pakistan","2024-09-26",0,0,3,0,0,3,0,0
"Pakistan","2024-09-27",0,0,3,0,0,3,0,0
"Pakistan","2024-09-28",0,0,3,0,0,3,0,0
"Pakistan","2024-09-29",0,0,3,0,0,3,0,0
"Pakistan","2024-09-30",0,0,3,0,0,3,0,0
"Pakistan","2024-10-01",0,0,3,0,0,3,0,0
"Pakistan","2024-10-02",0,0,3,0,0,3,0,0
"Pakistan","2024-10-03",0,0,3,0,0,3,0,0
"Pakistan","2024-10-04",0,0,3,0,0,3,0,0
"Pakistan","2024-10-05",0,0,3,0,0,3,0,0
"Pakistan","2024-10-06",0,0,3,0,0,3,0,0
"Pakistan","2024-10-07",0,0,3,0,0,3,0,0
"Pakistan","2024-10-08",0,0,3,0,0,3,0,0
"Pakistan","2024-10-09",0,0,3,0,0,3,0,0
"Pakistan","2024-10-10",0,0,3,0,0,3,0,0
"Pakistan","2024-10-11",0,0,3,0,1,4,0,0
"Pakistan","2024-10-12",0,0,3,0,0,4,0,0
"Pakistan","2024-10-13",0,0,3,0,0,4,0,0
"Pakistan","2024-10-14",0,0,3,0,0,4,0,0
"Pakistan","2024-10-15",0,0,3,0,0,4,0,0
"Pakistan","2024-10-16",0,0,3,0,0,4,0,0
"Pakistan","2024-10-17",0,0,3,0,0,4,0,0
"Pakistan","2024-10-18",0,0,3,0,0,4,0,0
"Pakistan","2024-10-19",0,0,3,0,0,4,0,0
"Pakistan","2024-10-20",0,0,3,0,0,4,0,0
"Pakistan","2024-10-21",0,0,3,0,0,4,0,0
"Pakistan","2024-10-22",0,0,3,0,0,4,0,0
"Pakistan","2024-10-23",0,0,3,0,0,4,0,0
"Pakistan","2024-10-24",0,0,3,0,0,4,0,0
"Pakistan","2024-10-25",0,0,3,0,0,4,0,0
"Pakistan","2024-10-26",0,0,3,0,0,4,0,0
"Pakistan","2024-10-27",0,0,3,0,0,4,0,0
"Pakistan","2024-10-28",0,0,3,0,0,4,0,0
"Pakistan","2024-10-29",0,0,3,0,0,4,0,0
"Pakistan","2024-10-30",0,0,3,0,0,4,0,0
"Pakistan","2024-10-31",0,0,3,0,0,4,0,0
"Pakistan","2024-11-01",0,0,3,0,0,4,0,0
"Pakistan","2024-11-02",0,0,3,0,0,4,0,0
"Pakistan","2024-11-03",0,0,3,0,0,4,0,0
"Pakistan","2024-11-04",0,0,3,0,0,4,0,0
"Pakistan","2024-11-05",0,0,3,0,0,4,0,0
"Pakistan","2024-11-06",0,0,3,0,0,4,0,0
"Pakistan","2024-11-07",0,0,3,0,0,4,0,0
"Pakistan","2024-11-08",0,0,3,0,0,4,0,0
"Pakistan","2024-11-09",0,0,3,0,0,4,0,0
"Pakistan","2024-11-10",0,0,3,0,0,4,0,0
"Pakistan","2024-11-11",0,0,3,0,0,4,0,0
"Pakistan","2024-11-12",0,0,3,0,0,4,0,0
"Pakistan","2024-11-13",0,0,3,0,0,4,0,0
"Pakistan","2024-11-14",0,0,3,0,0,4,0,0
"Pakistan","2024-11-15",0,0,3,0,0,4,0,0
"Pakistan","2024-11-16",0,0,3,0,0,4,0,0
"Pakistan","2024-11-17",0,0,3,0,0,4,0,0
"Pakistan","2024-11-18",0,0,3,0,0,4,0,0
"Pakistan","2024-11-19",0,0,3,0,0,4,0,0
"Pakistan","2024-11-20",0,0,3,0,0,4,0,0
"Pakistan","2024-11-21",0,0,3,0,0,4,0,0
"Pakistan","2024-11-22",0,0,3,0,0,4,0,0
"Pakistan","2024-11-23",0,0,3,0,0,4,0,0
"Pakistan","2024-11-24",0,0,3,0,0,4,0,0
"Pakistan","2024-11-25",0,0,3,0,0,4,0,0
"Pakistan","2024-11-26",0,0,3,0,0,4,0,0
"Pakistan","2024-11-27",0,0,3,0,0,4,0,0
"Pakistan","2024-11-28",0,0,3,0,0,4,0,0
"Pakistan","2024-11-29",0,1,4,0,0,4,0,0
"Pakistan","2024-11-30",0,0,4,0,0,4,0,0
"Pakistan","2024-12-01",0,0,4,0,0,4,0,0
"Pakistan","2024-12-02",0,0,4,0,0,4,0,0
"Pakistan","2024-12-03",0,0,4,0,0,4,0,0
"Pakistan","2024-12-04",0,0,4,0,0,4,0,0
"Pakistan","2024-12-05",0,0,4,0,0,4,0,0
"Pakistan","2024-12-06",0,0,4,0,0,4,0,0
"Pakistan","2024-12-07",0,0,4,0,0,4,0,0
"Pakistan","2024-12-08",0,0,4,0,0,4,0,0
"Pakistan","2024-12-09",0,0,4,0,0,4,0,0
"Pakistan","2024-12-10",0,0,4,0,0,4,0,0
"Pakistan","2024-12-11",0,0,4,0,0,4,0,0
"Pakistan","2024-12-12",0,0,4,0,0,4,0,0
"Pakistan","2024-12-13",0,0,4,0,0,4,0,0
"Pakistan","2024-12-14",0,0,4,0,0,4,0,0
"Pakistan","2024-12-15",0,0,4,0,0,4,0,0
"Pakistan","2024-12-16",0,0,4,0,0,4,0,0
"Pakistan","2024-12-17",0,0,4,0,0,4,0,0
"Pakistan","2024-12-18",0,0,4,0,0,4,0,0
"Pakistan","2024-12-19",0,0,4,0,0,4,0,0
"Pakistan","2024-12-20",0,0,4,0,0,4,0,0
"Pakistan","2024-12-21",0,0,4,0,0,4,0,0
"Pakistan","2024-12-22",0,0,4,0,0,4,0,0
"Pakistan","2024-12-23",0,0,4,0,0,4,0,0
"Pakistan","2024-12-24",0,0,4,0,0,4,0,0
"Pakistan","2024-12-25",0,0,4,0,0,4,0,0
"Pakistan","2024-12-26",0,0,4,0,0,4,0,0
"Pakistan","2024-12-27",0,0,4,0,0,4,0,0
"Pakistan","2024-12-28",0,0,4,0,0,4,0,0
"Pakistan","2024-12-29",0,0,4,0,0,4,0,0
"Pakistan","2024-12-30",0,0,4,0,0,4,0,0
"Pakistan","2024-12-31",0,0,4,0,0,4,0,0
"Pakistan","2025-01-01",0,0,4,0,0,4,0,0
"Pakistan","2025-01-02",0,0,4,0,0,4,0,0
"Pakistan","2025-01-03",0,0,4,0,0,4,0,0
"Pakistan","2025-01-04",0,0,4,0,0,4,0,0
"Pakistan","2025-01-05",0,0,4,0,0,4,0,0
"Pakistan","2025-01-06",0,0,4,0,0,4,0,0
"Pakistan","2025-01-07",0,0,4,0,0,4,0,0
"Pakistan","2025-01-08",0,0,4,0,0,4,0,0
"Pakistan","2025-01-09",0,0,4,0,0,4,0,0
"Pakistan","2025-01-10",0,0,4,0,0,4,0,0
"Pakistan","2025-01-11",0,0,4,0,0,4,0,0
"Pakistan","2025-01-12",0,0,4,0,0,4,0,0
"Pakistan","2025-01-13",0,0,4,0,0,4,0,0
"Panama","2024-01-01",0,0,0,0,0,0,0,0
"Panama","2024-01-02",0,0,0,0,0,0,0,0
"Panama","2024-01-03",0,0,0,0,0,0,0,0
"Panama","2024-01-04",0,0,0,0,0,0,0,0
"Panama","2024-01-05",0,0,0,0,0,0,0,0
"Panama","2024-01-06",0,0,0,0,0,0,0,0
"Panama","2024-01-07",0,0,0,0,0,0,0,0
"Panama","2024-01-08",0,0,0,0,0,0,0,0
"Panama","2024-01-09",0,0,0,0,0,0,0,0
"Panama","2024-01-10",0,0,0,0,0,0,0,0
"Panama","2024-01-11",0,0,0,0,0,0,0,0
"Panama","2024-01-12",0,0,0,0,0,0,0,0
"Panama","2024-01-13",0,0,0,0,0,0,0,0
"Panama","2024-01-14",0,0,0,0,0,0,0,0
"Panama","2024-01-15",0,0,0,0,0,0,0,0
"Panama","2024-01-16",0,1,1,0,1,1,0,0
"Panama","2024-01-17",0,0,1,0,0,1,0,0
"Panama","2024-01-18",0,0,1,0,0,1,0,0
"Panama","2024-01-19",0,0,1,0,0,1,0,0
"Panama","2024-01-20",0,0,1,0,0,1,0,0
"Panama","2024-01-21",0,0,1,0,0,1,0,0
"Panama","2024-01-22",0,0,1,0,0,1,0,0
"Panama","2024-01-23",0,0,1,0,0,1,0,0
"Panama","2024-01-24",0,0,1,0,0,1,0,0
"Panama","2024-01-25",0,0,1,0,0,1,0,0
"Panama","2024-01-26",0,0,1,0,0,1,0,0
"Panama","2024-01-27",0,0,1,0,1,2,0,0
"Panama","2024-01-28",0,0,1,0,0,2,0,0
"Panama","2024-01-29",0,0,1,0,0,2,0,0
"Panama","2024-01-30",0,0,1,0,0,2,0,0
"Panama","2024-01-31",0,0,1,0,0,2,0,0
"Panama","2024-02-01",0,0,1,0,0,2,0,0
"Panama","2024-02-02",0,0,1,0,0,2,0,0
"Panama","2024-02-03",0,0,1,0,0,2,0,0
"Panama","2024-02-04",0,0,1,0,0,2,0,0
"Panama","2024-02-05",0,0,1,0,0,2,0,0
"Panama","2024-02-06",0,1,2,0,0,2,0,0
"Panama","2024-02-07",0,0,2,0,0,2,0,0
"Panama","2024-02-08",0,0,2,0,0,2,0,0
"Panama","2024-02-09",0,0,2,0,0,2,0,0
"Panama","2024-02-10",0,0,2,0,0,2,0,0
"Panama","2024-02-11",0,0,2,0,0,2,0,0
"Panama","2024-02-12",0,0,2,0,0,2,0,0
"Panama","2024-02-13",0,0,2,0,0,2,0,0
"Panama","2024-02-14",0,0,2,0,0,2,0,0
"Panama","2024-02-15",0,0,2,0,0,2,0,0
"Panama","2024-02-16",0,0,2,0,0,2,0,0
"Panama","2024-02-17",0,0,2,0,0,2,0,0
"Panama","2024-02-18",0,0,2,0,0,2,0,0
"Panama","2024-02-19",0,0,2,0,0,2,0,0
"Panama","2024-02-20",0,0,2,0,0,2,0,0
"Panama","2024-02-21",0,0,2,0,0,2,0,0
"Panama","2024-02-22",0,0,2,0,0,2,0,0
"Panama","2024-02-23",0,0,2,0,0,2,0,0
"Panama","2024-02-24",0,0,2,0,0,2,0,0
"Panama","2024-02-25",0,0,2,0,0,2,0,0
"Panama","2024-02-26",0,0,2,0,0,2,0,0
"Panama","2024-02-27",0,0,2,0,0,2,0,0
"Panama","2024-02-28",0,0,2,0,0,2,0,0
"Panama","2024-02-29",0,0,2,0,0,2,0,0
"Panama","2024-03-01",0,0,2,0,0,2,0,0
"Panama","2024-03-02",0,0,2,0,0,2,0,0
"Panama","2024-03-03",0,0,2,0,0,2,0,0
"Panama","2024-03-04",0,0,2,0,0,2,0,0
"Panama","2024-03-05",0,0,2,0,0,2,0,0
"Panama","2024-03-06",0,0,2,0,0,2,0,0
"Panama","2024-03-07",0,0,2,0,0,2,0,0
"Panama","2024-03-08",0,0,2,0,0,2,0,0
"Panama","2024-03-09",0,0,2,0,0,2,0,0
"Panama","2024-03-10",0,0,2,0,0,2,0,0
"Panama","2024-03-11",0,0,2,0,0,2,0,0
"Panama","2024-03-12",0,0,2,0,0,2,0,0
"Panama","2024-03-13",0,0,2,0,0,2,0,0
"Panama","2024-03-14",0,0,2,0,0,2,0,0
"Panama","2024-03-15",0,0,2,0,0,2,0,0
"Panama","2024-03-16",0,0,2,0,0,2,0,0
"Panama","2024-03-17",0,0,2,0,0,2,0,0
"Panama","2024-03-18",0,0,2,0,0,2,0,0
"Panama","2024-03-19",0,0,2,0,0,2,0,0
"Panama","2024-03-20",0,0,2,0,0,2,0,0
"Panama","2024-03-21",0,0,2,0,0,2,0,0
"Panama","2024-03-22",0,0,2,0,0,2,0,0
"Panama","2024-03-23",0,0,2,0,0,2,0,0
"Panama","2024-03-24",0,0,2,0,0,2,0,0
"Panama","2024-03-25",0,0,2,0,0,2,0,0
"Panama","2024-03-26",0,0,2,0,0,2,0,0
"Panama","2024-03-27",0,0,2,0,0,2,0,0
"Panama","2024-03-28",0,0,2,0,0,2,0,0
"Panama","2024-03-29",0,0,2,0,0,2,0,0
"Panama","2024-03-30",0,0,2,0,0,2,0,0
"Panama","2024-03-31",0,0,2,0,0,2,0,0
"Panama","2024-04-01",0,0,2,0,0,2,0,0
"Panama","2024-04-02",0,0,2,0,0,2,0,0
"Panama","2024-04-03",0,0,2,0,0,2,0,0
"Panama","2024-04-04",0,0,2,0,0,2,0,0
"Panama","2024-04-05",0,0,2,0,0,2,0,0
"Panama","2024-04-06",0,0,2,0,0,2,0,0
"Panama","2024-04-07",0,0,2,0,0,2,0,0
"Panama","2024-04-08",0,0,2,0,0,2,0,0
"Panama","2024-04-09",0,0,2,0,0,2,0,0
"Panama","2024-04-10",0,0,2,0,0,2,0,0
"Panama","2024-04-11",0,0,2,0,0,2,0,0
"Panama","2024-04-12",0,0,2,0,0,2,0,0
"Panama","2024-04-13",0,0,2,0,0,2,0,0
"Panama","2024-04-14",0,0,2,0,0,2,0,0
"Panama","2024-04-15",0,0,2,0,0,2,0,0
"Panama","2024-04-16",0,0,2,0,0,2,0,0
"Panama","2024-04-17",0,0,2,0,1,3,0,0
"Panama","2024-04-18",0,0,2,0,0,3,0,0
"Panama","2024-04-19",0,0,2,0,0,3,0,0
"Panama","2024-04-20",0,0,2,0,0,3,0,0
"Panama","2024-04-21",0,0,2,0,0,3,0,0
"Panama","2024-04-22",0,0,2,0,0,3,0,0
"Panama","2024-04-23",0,0,2,0,0,3,0,0
"Panama","2024-04-24",0,0,2,0,0,3,0,0
"Panama","2024-04-25",0,0,2,0,0,3,0,0
"Panama","2024-04-26",0,0,2,0,0,3,0,0
"Panama","2024-04-27",0,0,2,0,0,3,0,0
"Panama","2024-04-28",0,0,2,0,0,3,0,0
"Panama","2024-04-29",0,0,2,0,0,3,0,0
"Panama","2024-04-30",0,0,2,0,0,3,0,0
"Panama","2024-05-01",0,0,2,0,0,3,0,0
"Panama","2024-05-02",0,0,2,0,0,3,0,0
"Panama","2024-05-03",0,0,2,0,0,3,0,0
"Panama","2024-05-04",0,0,2,0,0,3,0,0
"Panama","2024-05-05",0,0,2,0,0,3,0,0
"Panama","2024-05-06",0,0,2,0,0,3,0,0
"Panama","2024-05-07",0,0,2,0,0,3,0,0
"Panama","2024-05-08",0,0,2,0,0,3,0,0
"Panama","2024-05-09",0,0,2,0,0,3,0,0
"Panama","2024-05-10",0,0,2,0,0,3,0,0
"Panama","2024-05-11",0,0,2,0,0,3,0,0
"Panama","2024-05-12",0,0,2,0,0,3,0,0
"Panama","2024-05-13",0,0,2,0,0,3,0,0
"Panama","2024-05-14",0,0,2,0,0,3,0,0
"Panama","2024-05-15",0,0,2,0,0,3,0,0
"Panama","2024-05-16",0,0,2,0,0,3,0,0
"Panama","2024-05-17",0,0,2,0,0,3,0,0
"Panama","2024-05-18",0,0,2,0,0,3,0,0
"Panama","2024-05-19",0,0,2,0,0,3,0,0
"Panama","2024-05-20",0,0,2,0,0,3,0,0
"Panama","2024-05-21",0,0,2,0,0,3,0,0
"Panama","2024-05-22",0,0,2,0,0,3,0,0
"Panama","2024-05-23",0,0,2,0,0,3,0,0
"Panama","2024-05-24",0,0,2,0,0,3,0,0
"Panama","2024-05-25",0,0,2,0,0,3,0,0
"Panama","2024-05-26",0,0,2,0,0,3,0,0
"Panama","2024-05-27",0,0,2,0,0,3,0,0
"Panama","2024-05-28",0,0,2,0,0,3,0,0
"Panama","2024-05-29",0,0,2,0,0,3,0,0
"Panama","2024-05-30",0,0,2,0,0,3,0,0
"Panama","2024-05-31",0,0,2,0,0,3,0,0
"Panama","2024-06-01",0,0,2,0,0,3,0,0
"Panama","2024-06-02",0,0,2,0,0,3,0,0
"Panama","2024-06-03",0,0,2,0,0,3,0,0
"Panama","2024-06-04",0,0,2,0,0,3,0,0
"Panama","2024-06-05",0,0,2,0,0,3,0,0
"Panama","2024-06-06",0,0,2,0,0,3,0,0
"Panama","2024-06-07",0,0,2,0,0,3,0,0
"Panama","2024-06-08",0,0,2,0,0,3,0,0
"Panama","2024-06-09",0,0,2,0,0,3,0,0
"Panama","2024-06-10",0,0,2,0,0,3,0,0
"Panama","2024-06-11",0,0,2,0,0,3,0,0
"Panama","2024-06-12",0,0,2,0,0,3,0,0
"Panama","2024-06-13",0,0,2,0,0,3,0,0
"Panama","2024-06-14",0,0,2,0,0,3,0,0
"Panama","2024-06-15",0,0,2,0,0,3,0,0
"Panama","2024-06-16",0,0,2,0,0,3,0,0
"Panama","2024-06-17",0,0,2,0,0,3,0,0
"Panama","2024-06-18",0,0,2,0,0,3,0,0
"Panama","2024-06-19",0,0,2,0,0,3,0,0
"Panama","2024-06-20",0,0,2,0,0,3,0,0
"Panama","2024-06-21",0,0,2,0,0,3,0,0
"Panama","2024-06-22",0,0,2,0,0,3,0,0
"Panama","2024-06-23",0,0,2,0,0,3,0,0
"Panama","2024-06-24",0,0,2,0,0,3,0,0
"Panama","2024-06-25",0,1,3,0,0,3,0,0
"Panama","2024-06-26",0,0,3,0,0,3,0,0
"Panama","2024-06-27",0,0,3,0,0,3,0,0
"Panama","2024-06-28",0,0,3,0,0,3,0,0
"Panama","2024-06-29",0,0,3,0,0,3,0,0
"Panama","2024-06-30",0,0,3,0,0,3,0,0
"Panama","2024-07-01",0,0,3,0,0,3,0,0
"Panama","2024-07-02",0,0,3,0,0,3,0,0
"Panama","2024-07-03",0,0,3,0,0,3,0,0
"Panama","2024-07-04",0,0,3,0,0,3,0,0
"Panama","2024-07-05",0,0,3,0,0,3,0,0
"Panama","2024-07-06",0,0,3,0,0,3,0,0
"Panama","2024-07-07",0,0,3,0,0,3,0,0
"Panama","2024-07-08",0,0,3,0,0,3,0,0
"Panama","2024-07-09",0,0,3,0,0,3,0,0
"Panama","2024-07-10",0,0,3,0,0,3,0,0
"Panama","2024-07-11",0,0,3,0,0,3,0,0
"Panama","2024-07-12",0,0,3,0,0,3,0,0
"Panama","2024-07-13",0,0,3,0,1,4,0,0
"Panama","2024-07-14",0,0,3,0,0,4,0,0
"Panama","2024-07-15",0,0,3,0,0,4,0,0
"Panama","2024-07-16",0,0,3,0,0,4,0,0
"Panama","2024-07-17",0,0,3,0,0,4,0,0
"Panama","2024-07-18",0,0,3,0,0,4,0,0
"Panama","2024-07-19",0,0,3,0,0,4,0,0
"Panama","2024-07-20",0,0,3,0,0,4,0,0
"Panama","2024-07-21",0,0,3,0,0,4,0,0
"Panama","2024-07-22",0,0,3,0,0,4,0,0
"Panama","2024-07-23",0,0,3,0,0,4,0,0
"Panama","2024-07-24",0,0,3,0,0,4,0,0
"Panama","2024-07-25",0,0,3,0,0,4,0,0
"Panama","2024-07-26",0,0,3,0,0,4,0,0
"Panama","2024-07-27",0,0,3,0,0,4,0,0
"Panama","2024-07-28",0,0,3,0,0,4,0,0
"Panama","2024-07-29",0,0,3,0,0,4,0,0
"Panama","2024-07-30",0,1,4,0,0,4,0,0
"Panama","2024-07-31",0,0,4,0,0,4,0,0
"Panama","2024-08-01",0,0,4,0,0,4,0,0
"Panama","2024-08-02",0,0,4,0,0,4,0,0
"Panama","2024-08-03",0,0,4,0,0,4,0,0
"Panama","2024-08-04",0,0,4,0,0,4,0,0
"Panama","2024-08-05",0,0,4,0,0,4,0,0
"Panama","2024-08-06",0,0,4,0,0,4,0,0
"Panama","2024-08-07",0,0,4,0,0,4,0,0
"Panama","2024-08-08",0,0,4,0,0,4,0,0
"Panama","2024-08-09",0,0,4,0,0,4,0,0
"Panama","2024-08-10",0,0,4,0,0,4,0,0
"Panama","2024-08-11",0,0,4,0,0,4,0,0
"Panama","2024-08-12",0,0,4,0,0,4,0,0
"Panama","2024-08-13",0,0,4,0,0,4,0,0
"Panama","2024-08-14",0,0,4,0,0,4,0,0
"Panama","2024-08-15",0,0,4,0,0,4,0,0
"Panama","2024-08-16",0,0,4,0,0,4,0,0
"Panama","2024-08-17",0,0,4,0,0,4,0,0
"Panama","2024-08-18",0,0,4,0,0,4,0,0
"Panama","2024-08-19",0,0,4,0,0,4,0,0
"Panama","2024-08-20",0,0,4,0,0,4,0,0
"Panama","2024-08-21",0,0,4,0,0,4,0,0
"Panama","2024-08-22",0,0,4,0,0,4,0,0
"Panama","2024-08-23",0,0,4,0,0,4,0,0
"Panama","2024-08-24",0,0,4,0,1,5,0,0
"Panama","2024-08-25",0,0,4,0,0,5,0,0
"Panama","2024-08-26",0,0,4,0,0,5,0,0
"Panama","2024-08-27",0,0,4,0,0,5,0,0
"Panama","2024-08-28",0,0,4,0,0,5,0,0
"Panama","2024-08-29",0,0,4,0,0,5,0,0
"Panama","2024-08-30",0,0,4,0,0,5,0,0
"Panama","2024-08-31",0,0,4,0,0,5,0,0
"Panama","2024-09-01",0,0,4,0,0,5,0,0
"Panama","2024-09-02",0,0,4,0,0,5,0,0
"Panama","2024-09-03",0,0,4,0,0,5,0,0
"Panama","2024-09-04",0,0,4,0,0,5,0,0
"Panama","2024-09-05",0,0,4,0,0,5,0,0
"Panama","2024-09-06",0,0,4,0,0,5,0,0
"Panama","2024-09-07",0,0,4,0,0,5,0,0
"Panama","2024-09-08",0,0,4,0,0,5,0,0
"Panama","2024-09-09",0,0,4,0,0,5,0,0
"Panama","2024-09-10",0,0,4,0,0,5,0,0
"Panama","2024-09-11",0,0,4,0,0,5,0,0
"Panama","2024-09-12",0,0,4,0,0,5,0,0
"Panama","2024-09-13",0,0,4,0,0,5,0,0
"Panama","2024-09-14",0,0,4,0,0,5,0,0
"Panama","2024-09-15",0,0,4,0,0,5,0,0
"Panama","2024-09-16",0,0,4,0,0,5,0,0
"Panama","2024-09-17",0,1,5,0,0,5,0,0
"Panama","2024-09-18",0,0,5,0,0,5,0,0
"Panama","2024-09-19",0,0,5,0,0,5,0,0
"Panama","2024-09-20",0,0,5,0,0,5,0,0
"Panama","2024-09-21",0,0,5,0,0,5,0,0
"Panama","2024-09-22",0,0,5,0,0,5,0,0
"Panama","2024-09-23",0,0,5,0,0,5,0,0
"Panama","2024-09-24",0,0,5,0,0,5,0,0
"Panama","2024-09-25",0,0,5,0,0,5,0,0
"Panama","2024-09-26",0,0,5,0,0,5,0,0
"Panama","2024-09-27",0,0,5,0,0,5,0,0
"Panama","2024-09-28",0,0,5,0,0,5,0,0
"Panama","2024-09-29",0,0,5,0,0,5,0,0
"Panama","2024-09-30",0,0,5,0,0,5,0,0
"Panama","2024-10-01",0,0,5,0,0,5,0,0
"Panama","2024-10-02",0,0,5,0,0,5,0,0
"Panama","2024-10-03",0,0,5,0,0,5,0,0
"Panama","2024-10-04",0,0,5,0,0,5,0,0
"Panama","2024-10-05",0,0,5,0,0,5,0,0
"Panama","2024-10-06",0,0,5,0,0,5,0,0
"Panama","2024-10-07",0,0,5,0,0,5,0,0
"Panama","2024-10-08",0,0,5,0,0,5,0,0
"Panama","2024-10-09",0,0,5,0,0,5,0,0
"Panama","2024-10-10",0,0,5,0,0,5,0,0
"Panama","2024-10-11",0,0,5,0,0,5,0,0
"Panama","2024-10-12",0,0,5,0,0,5,0,0
"Panama","2024-10-13",0,0,5,0,0,5,0,0
"Panama","2024-10-14",0,0,5,0,0,5,0,0
"Panama","2024-10-15",0,0,5,0,0,5,0,0
"Panama","2024-10-16",0,0,5,0,0,5,0,0
"Panama","2024-10-17",0,0,5,0,0,5,0,0
"Panama","2024-10-18",0,0,5,0,0,5,0,0
"Panama","2024-10-19",0,0,5,0,0,5,0,0
"Panama","2024-10-20",0,0,5,0,0,5,0,0
"Panama","2024-10-21",0,0,5,0,0,5,0,0
"Panama","2024-10-22",0,0,5,0,0,5,0,0
"Panama","2024-10-23",0,0,5,0,0,5,0,0
"Panama","2024-10-24",0,0,5,0,0,5,0,0
"Panama","2024-10-25",0,0,5,0,0,5,0,0
"Panama","2024-10-26",0,0,5,0,0,5,0,0
"Panama","2024-10-27",0,0,5,0,0,5,0,0
"Panama","2024-10-28",0,0,5,0,0,5,0,0
"Panama","2024-10-29",0,0,5,0,0,5,0,0
"Panama","2024-10-30",0,0,5,0,0,5,0,0
"Panama","2024-10-31",0,0,5,0,0,5,0,0
"Panama","2024-11-01",0,0,5,0,0,5,0,0
"Panama","2024-11-02",0,0,5,0,0,5,0,0
"Panama","2024-11-03",0,0,5,0,0,5,0,0
"Panama","2024-11-04",0,0,5,0,0,5,0,0
"Panama","2024-11-05",0,0,5,0,0,5,0,0
"Panama","2024-11-06",0,0,5,0,0,5,0,0
"Panama","2024-11-07",0,0,5,0,0,5,0,0
"Panama","2024-11-08",0,0,5,0,0,5,0,0
"Panama","2024-11-09",0,0,5,0,0,5,0,0
"Panama","2024-11-10",0,0,5,0,0,5,0,0
"Panama","2024-11-11",0,0,5,0,0,5,0,0
"Panama","2024-11-12",0,0,5,0,0,5,0,0
"Panama","2024-11-13",0,0,5,0,0,5,0,0
"Panama","2024-11-14",0,0,5,0,0,5,0,0
"Panama","2024-11-15",0,0,5,0,0,5,0,0
"Panama","2024-11-16",0,0,5,0,0,5,0,0
"Panama","2024-11-17",0,0,5,0,0,5,0,0
"Panama","2024-11-18",0,0,5,0,0,5,0,0
"Panama","2024-11-19",0,0,5,0,0,5,0,0
"Panama","2024-11-20",0,0,5,0,0,5,0,0
"Panama","2024-11-21",0,0,5,0,0,5,0,0
"Panama","2024-11-22",0,0,5,0,0,5,0,0
"Panama","2024-11-23",0,0,5,0,0,5,0,0
"Panama","2024-11-24",0,0,5,0,0,5,0,0
"Panama","2024-11-25",0,0,5,0,0,5,0,0
"Panama","2024-11-26",0,0,5,0,0,5,0,0
"Panama","2024-11-27",0,0,5,0,0,5,0,0
"Panama","2024-11-28",0,0,5,0,0,5,0,0
"Panama","2024-11-29",0,0,5,0,0,5,0,0
"Panama","2024-11-30",0,0,5,0,0,5,0,0
"Panama","2024-12-01",0,0,5,0,0,5,0,0
"Panama","2024-12-02",0,0,5,0,0,5,0,0
"Panama","2024-12-03",0,0,5,0,0,5,0,0
"Panama","2024-12-04",0,0,5,0,0,5,0,0
"Panama","2024-12-05",0,0,5,0,0,5,0,0
"Panama","2024-12-06",0,0,5,0,0,5,0,0
"Panama","2024-12-07",0,0,5,0,0,5,0,0
"Panama","2024-12-08",0,0,5,0,0,5,0,0
"Panama","2024-12-09",0,0,5,0,0,5,0,0
"Panama","2024-12-10",0,0,5,0,0,5,0,0
"Panama","2024-12-11",0,0,5,0,0,5,0,0
"Panama","2024-12-12",0,0,5,0,0,5,0,0
"Panama","2024-12-13",0,0,5,0,0,5,0,0
"Panama","2024-12-14",0,0,5,0,0,5,0,0
"Panama","2024-12-15",0,0,5,0,0,5,0,0
"Panama","2024-12-16",0,0,5,0,0,5,0,0
"Panama","2024-12-17",0,0,5,0,0,5,0,0
"Panama","2024-12-18",0,0,5,0,0,5,0,0
"Panama","2024-12-19",0,0,5,0,0,5,0,0
"Panama","2024-12-20",0,0,5,0,0,5,0,0
"Panama","2024-12-21",0,0,5,0,0,5,0,0
"Panama","2024-12-22",0,0,5,0,0,5,0,0
"Panama","2024-12-23",0,0,5,0,0,5,0,0
"Panama","2024-12-24",0,0,5,0,0,5,0,0
"Panama","2024-12-25",0,0,5,0,0,5,0,0
"Panama","2024-12-26",0,0,5,0,0,5,0,0
"Panama","2024-12-27",0,0,5,0,0,5,0,0
"Panama","2024-12-28",0,0,5,0,0,5,0,0
"Panama","2024-12-29",0,0,5,0,0,5,0,0
"Panama","2024-12-30",0,0,5,0,0,5,0,0
"Panama","2024-12-31",0,0,5,0,0,5,0,0
"Panama","2025-01-01",0,0,5,0,0,5,0,0
"Panama","2025-01-02",0,0,5,0,0,5,0,0
"Panama","2025-01-03",0,0,5,0,0,5,0,0
"Panama","2025-01-04",0,0,5,0,0,5,0,0
"Panama","2025-01-05",0,0,5,0,0,5,0,0
"Panama","2025-01-06",0,0,5,0,0,5,0,0
"Panama","2025-01-07",0,0,5,0,0,5,0,0
"Panama","2025-01-08",0,0,5,0,0,5,0,0
"Panama","2025-01-09",0,0,5,0,0,5,0,0
"Panama","2025-01-10",0,0,5,0,0,5,0,0
"Panama","2025-01-11",0,0,5,0,0,5,0,0
"Panama","2025-01-12",0,0,5,0,0,5,0,0
"Panama","2025-01-13",0,0,5,0,0,5,0,0
"Paraguay","2024-01-01",0,0,0,0,0,0,0,0
"Paraguay","2024-01-02",0,0,0,0,0,0,0,0
"Paraguay","2024-01-03",0,0,0,0,0,0,0,0
"Paraguay","2024-01-04",0,0,0,0,0,0,0,0
"Paraguay","2024-01-05",0,0,0,0,0,0,0,0
"Paraguay","2024-01-06",0,0,0,0,0,0,0,0
"Paraguay","2024-01-07",0,0,0,0,0,0,0,0
"Paraguay","2024-01-08",0,0,0,0,0,0,0,0
"Paraguay","2024-01-09",0,0,0,0,0,0,0,0
"Paraguay","2024-01-10",0,0,0,0,0,0,0,0
"Paraguay","2024-01-11",0,0,0,0,0,0,0,0
"Paraguay","2024-01-12",0,0,0,0,0,0,0,0
"Paraguay","2024-01-13",0,0,0,0,0,0,0,0
"Paraguay","2024-01-14",0,0,0,0,0,0,0,0
"Paraguay","2024-01-15",0,0,0,0,0,0,0,0
"Paraguay","2024-01-16",0,0,0,0,0,0,0,0
"Paraguay","2024-01-17",0,0,0,0,0,0,0,0
"Paraguay","2024-01-18",0,0,0,0,0,0,0,0
"Paraguay","2024-01-19",0,0,0,0,0,0,0,0
"Paraguay","2024-01-20",0,0,0,0,0,0,0,0
"Paraguay","2024-01-21",0,0,0,0,0,0,0,0
"Paraguay","2024-01-22",0,0,0,0,0,0,0,0
"Paraguay","2024-01-23",0,0,0,0,0,0,0,0
"Paraguay","2024-01-24",0,0,0,0,0,0,0,0
"Paraguay","2024-01-25",0,0,0,0,0,0,0,0
"Paraguay","2024-01-26",0,0,0,0,0,0,0,0
"Paraguay","2024-01-27",0,0,0,0,0,0,0,0
"Paraguay","2024-01-28",0,0,0,0,0,0,0,0
"Paraguay","2024-01-29",0,0,0,0,0,0,0,0
"Paraguay","2024-01-30",0,0,0,0,0,0,0,0
"Paraguay","2024-01-31",0,0,0,0,0,0,0,0
"Paraguay","2024-02-01",0,0,0,0,0,0,0,0
"Paraguay","2024-02-02",0,0,0,0,0,0,0,0
"Paraguay","2024-02-03",0,0,0,0,0,0,0,0
"Paraguay","2024-02-04",0,0,0,0,0,0,0,0
"Paraguay","2024-02-05",0,0,0,0,0,0,0,0
"Paraguay","2024-02-06",0,0,0,0,0,0,0,0
"Paraguay","2024-02-07",0,0,0,0,0,0,0,0
"Paraguay","2024-02-08",0,0,0,0,0,0,0,0
"Paraguay","2024-02-09",0,0,0,0,0,0,0,0
"Paraguay","2024-02-10",0,0,0,0,0,0,0,0
"Paraguay","2024-02-11",0,0,0,0,0,0,0,0
"Paraguay","2024-02-12",0,0,0,0,0,0,0,0
"Paraguay","2024-02-13",0,0,0,0,0,0,0,0
"Paraguay","2024-02-14",0,0,0,0,0,0,0,0
"Paraguay","2024-02-15",0,0,0,0,0,0,0,0
"Paraguay","2024-02-16",0,0,0,0,0,0,0,0
"Paraguay","2024-02-17",0,0,0,0,0,0,0,0
"Paraguay","2024-02-18",0,0,0,0,0,0,0,0
"Paraguay","2024-02-19",0,0,0,0,0,0,0,0
"Paraguay","2024-02-20",0,0,0,0,0,0,0,0
"Paraguay","2024-02-21",0,0,0,0,0,0,0,0
"Paraguay","2024-02-22",0,0,0,0,0,0,0,0
"Paraguay","2024-02-23",0,0,0,0,0,0,0,0
"Paraguay","2024-02-24",0,0,0,0,0,0,0,0
"Paraguay","2024-02-25",0,0,0,0,0,0,0,0
"Paraguay","2024-02-26",0,0,0,0,0,0,0,0
"Paraguay","2024-02-27",0,0,0,0,0,0,0,0
"Paraguay","2024-02-28",0,0,0,0,0,0,0,0
"Paraguay","2024-02-29",0,0,0,0,0,0,0,0
"Paraguay","2024-03-01",0,0,0,0,0,0,0,0
"Paraguay","2024-03-02",0,0,0,0,0,0,0,0
"Paraguay","2024-03-03",0,0,0,0,0,0,0,0
"Paraguay","2024-03-04",0,0,0,0,0,0,0,0
"Paraguay","2024-03-05",0,0,0,0,0,0,0,0
"Paraguay","2024-03-06",0,0,0,0,0,0,0,0
"Paraguay","2024-03-07",0,0,0,0,0,0,0,0
"Paraguay","2024-03-08",0,0,0,0,0,0,0,0
"Paraguay","2024-03-09",0,0,0,0,0,0,0,0
"Paraguay","2024-03-10",0,0,0,0,0,0,0,0
"Paraguay","2024-03-11",0,0,0,0,0,0,0,0
"Paraguay","2024-03-12",0,0,0,0,0,0,0,0
"Paraguay","2024-03-13",0,0,0,0,0,0,0,0
"Paraguay","2024-03-14",0,0,0,0,0,0,0,0
"Paraguay","2024-03-15",0,0,0,0,0,0,0,0
"Paraguay","2024-03-16",0,0,0,0,0,0,0,0
"Paraguay","2024-03-17",0,0,0,0,0,0,0,0
"Paraguay","2024-03-18",0,0,0,0,0,0,0,0
"Paraguay","2024-03-19",0,0,0,0,0,0,0,0
"Paraguay","2024-03-20",0,0,0,0,0,0,0,0
"Paraguay","2024-03-21",0,0,0,0,0,0,0,0
"Paraguay","2024-03-22",0,0,0,0,0,0,0,0
"Paraguay","2024-03-23",0,0,0,0,0,0,0,0
"Paraguay","2024-03-24",0,0,0,0,0,0,0,0
"Paraguay","2024-03-25",0,0,0,0,0,0,0,0
"Paraguay","2024-03-26",0,0,0,0,0,0,0,0
"Paraguay","2024-03-27",0,0,0,0,0,0,0,0
"Paraguay","2024-03-28",0,0,0,0,0,0,0,0
"Paraguay","2024-03-29",0,0,0,0,0,0,0,0
"Paraguay","2024-03-30",0,0,0,0,0,0,0,0
"Paraguay","2024-03-31",0,0,0,0,0,0,0,0
"Paraguay","2024-04-01",0,0,0,0,0,0,0,0
"Paraguay","2024-04-02",0,0,0,0,0,0,0,0
"Paraguay","2024-04-03",0,0,0,0,0,0,0,0
"Paraguay","2024-04-04",0,0,0,0,0,0,0,0
"Paraguay","2024-04-05",0,0,0,0,0,0,0,0
"Paraguay","2024-04-06",0,0,0,0,0,0,0,0
"Paraguay","2024-04-07",0,0,0,0,0,0,0,0
"Paraguay","2024-04-08",0,0,0,0,0,0,0,0
"Paraguay","2024-04-09",0,0,0,0,0,0,0,0
"Paraguay","2024-04-10",0,0,0,0,0,0,0,0
"Paraguay","2024-04-11",0,0,0,0,0,0,0,0
"Paraguay","2024-04-12",0,0,0,0,0,0,0,0
"Paraguay","2024-04-13",0,0,0,0,0,0,0,0
"Paraguay","2024-04-14",0,0,0,0,0,0,0,0
"Paraguay","2024-04-15",0,0,0,0,0,0,0,0
"Paraguay","2024-04-16",0,0,0,0,0,0,0,0
"Paraguay","2024-04-17",0,0,0,0,0,0,0,0
"Paraguay","2024-04-18",0,0,0,0,0,0,0,0
"Paraguay","2024-04-19",0,0,0,0,0,0,0,0
"Paraguay","2024-04-20",0,0,0,0,0,0,0,0
"Paraguay","2024-04-21",0,0,0,0,0,0,0,0
"Paraguay","2024-04-22",0,0,0,0,0,0,0,0
"Paraguay","2024-04-23",0,0,0,0,0,0,0,0
"Paraguay","2024-04-24",0,0,0,0,0,0,0,0
"Paraguay","2024-04-25",0,0,0,0,0,0,0,0
"Paraguay","2024-04-26",0,0,0,0,0,0,0,0
"Paraguay","2024-04-27",0,0,0,0,0,0,0,0
"Paraguay","2024-04-28",0,0,0,0,0,0,0,0
"Paraguay","2024-04-29",0,0,0,0,0,0,0,0
"Paraguay","2024-04-30",0,0,0,0,0,0,0,0
"Paraguay","2024-05-01",0,0,0,0,0,0,0,0
"Paraguay","2024-05-02",0,0,0,0,0,0,0,0
"Paraguay","2024-05-03",0,0,0,0,0,0,0,0
"Paraguay","2024-05-04",0,0,0,0,0,0,0,0
"Paraguay","2024-05-05",0,0,0,0,0,0,0,0
"Paraguay","2024-05-06",0,0,0,0,0,0,0,0
"Paraguay","2024-05-07",0,0,0,0,0,0,0,0
"Paraguay","2024-05-08",0,0,0,0,0,0,0,0
"Paraguay","2024-05-09",0,0,0,0,0,0,0,0
"Paraguay","2024-05-10",0,0,0,0,0,0,0,0
"Paraguay","2024-05-11",0,0,0,0,0,0,0,0
"Paraguay","2024-05-12",0,0,0,0,0,0,0,0
"Paraguay","2024-05-13",0,0,0,0,0,0,0,0
"Paraguay","2024-05-14",0,0,0,0,0,0,0,0
"Paraguay","2024-05-15",0,0,0,0,0,0,0,0
"Paraguay","2024-05-16",0,0,0,0,0,0,0,0
"Paraguay","2024-05-17",0,0,0,0,0,0,0,0
"Paraguay","2024-05-18",0,0,0,0,0,0,0,0
"Paraguay","2024-05-19",0,0,0,0,0,0,0,0
"Paraguay","2024-05-20",0,0,0,0,0,0,0,0
"Paraguay","2024-05-21",0,0,0,0,0,0,0,0
"Paraguay","2024-05-22",0,0,0,0,0,0,0,0
"Paraguay","2024-05-23",0,0,0,0,0,0,0,0
"Paraguay","2024-05-24",0,0,0,0,0,0,0,0
"Paraguay","2024-05-25",0,0,0,0,0,0,0,0
"Paraguay","2024-05-26",0,0,0,0,0,0,0,0
"Paraguay","2024-05-27",0,0,0,0,0,0,0,0
"Paraguay","2024-05-28",0,0,0,0,0,0,0,0
"Paraguay","2024-05-29",0,0,0,0,0,0,0,0
"Paraguay","2024-05-30",0,0,0,0,0,0,0,0
"Paraguay","2024-05-31",0,0,0,0,0,0,0,0
"Paraguay","2024-06-01",0,0,0,0,0,0,0,0
"Paraguay","2024-06-02",0,0,0,0,0,0,0,0
"Paraguay","2024-06-03",0,0,0,0,0,0,0,0
"Paraguay","2024-06-04",0,0,0,0,0,0,0,0
"Paraguay","2024-06-05",0,0,0,0,0,0,0,0
"Paraguay","2024-06-06",0,0,0,0,0,0,0,0
"Paraguay","2024-06-07",0,0,0,0,0,0,0,0
"Paraguay","2024-06-08",0,0,0,0,0,0,0,0
"Paraguay","2024-06-09",0,0,0,0,0,0,0,0
"Paraguay","2024-06-10",0,0,0,0,0,0,0,0
"Paraguay","2024-06-11",0,0,0,0,0,0,0,0
"Paraguay","2024-06-12",0,0,0,0,0,0,0,0
"Paraguay","2024-06-13",0,0,0,0,0,0,0,0
"Paraguay","2024-06-14",0,0,0,0,0,0,0,0
"Paraguay","2024-06-15",0,0,0,0,0,0,0,0
"Paraguay","2024-06-16",0,0,0,0,0,0,0,0
"Paraguay","2024-06-17",0,0,0,0,0,0,0,0
"Paraguay","2024-06-18",0,0,0,0,0,0,0,0
"Paraguay","2024-06-19",0,0,0,0,0,0,0,0
"Paraguay","2024-06-20",0,0,0,0,0,0,0,0
"Paraguay","2024-06-21",0,0,0,0,0,0,0,0
"Paraguay","2024-06-22",0,0,0,0,0,0,0,0
"Paraguay","2024-06-23",0,0,0,0,0,0,0,0
"Paraguay","2024-06-24",0,0,0,0,0,0,0,0
"Paraguay","2024-06-25",0,0,0,0,0,0,0,0
"Paraguay","2024-06-26",0,0,0,0,0,0,0,0
"Paraguay","2024-06-27",0,0,0,0,0,0,0,0
"Paraguay","2024-06-28",0,0,0,0,0,0,0,0
"Paraguay","2024-06-29",0,0,0,0,0,0,0,0
"Paraguay","2024-06-30",0,0,0,0,0,0,0,0
"Paraguay","2024-07-01",0,0,0,0,0,0,0,0
"Paraguay","2024-07-02",0,0,0,0,0,0,0,0
"Paraguay","2024-07-03",0,0,0,0,0,0,0,0
"Paraguay","2024-07-04",0,0,0,0,0,0,0,0
"Paraguay","2024-07-05",0,0,0,0,0,0,0,0
"Paraguay","2024-07-06",0,0,0,0,0,0,0,0
"Paraguay","2024-07-07",0,0,0,0,0,0,0,0
"Paraguay","2024-07-08",0,0,0,0,0,0,0,0
"Paraguay","2024-07-09",0,0,0,0,0,0,0,0
"Paraguay","2024-07-10",0,0,0,0,0,0,0,0
"Paraguay","2024-07-11",0,0,0,0,0,0,0,0
"Paraguay","2024-07-12",0,0,0,0,0,0,0,0
"Paraguay","2024-07-13",0,0,0,0,0,0,0,0
"Paraguay","2024-07-14",0,0,0,0,0,0,0,0
"Paraguay","2024-07-15",0,0,0,0,0,0,0,0
"Paraguay","2024-07-16",0,0,0,0,0,0,0,0
"Paraguay","2024-07-17",0,0,0,0,0,0,0,0
"Paraguay","2024-07-18",0,0,0,0,0,0,0,0
"Paraguay","2024-07-19",0,0,0,0,0,0,0,0
"Paraguay","2024-07-20",0,0,0,0,0,0,0,0
"Paraguay","2024-07-21",0,0,0,0,0,0,0,0
"Paraguay","2024-07-22",0,0,0,0,0,0,0,0
"Paraguay","2024-07-23",0,0,0,0,0,0,0,0
"Paraguay","2024-07-24",0,0,0,0,0,0,0,0
"Paraguay","2024-07-25",0,0,0,0,0,0,0,0
"Paraguay","2024-07-26",0,0,0,0,0,0,0,0
"Paraguay","2024-07-27",0,0,0,0,0,0,0,0
"Paraguay","2024-07-28",0,0,0,0,0,0,0,0
"Paraguay","2024-07-29",0,0,0,0,0,0,0,0
"Paraguay","2024-07-30",0,0,0,0,0,0,0,0
"Paraguay","2024-07-31",0,0,0,0,0,0,0,0
"Paraguay","2024-08-01",0,0,0,0,0,0,0,0
"Paraguay","2024-08-02",0,0,0,0,0,0,0,0
"Paraguay","2024-08-03",0,0,0,0,0,0,0,0
"Paraguay","2024-08-04",0,0,0,0,0,0,0,0
"Paraguay","2024-08-05",0,0,0,0,0,0,0,0
"Paraguay","2024-08-06",0,0,0,0,0,0,0,0
"Paraguay","2024-08-07",0,0,0,0,0,0,0,0
"Paraguay","2024-08-08",0,0,0,0,0,0,0,0
"Paraguay","2024-08-09",0,0,0,0,0,0,0,0
"Paraguay","2024-08-10",0,0,0,0,0,0,0,0
"Paraguay","2024-08-11",0,0,0,0,0,0,0,0
"Paraguay","2024-08-12",0,0,0,0,0,0,0,0
"Paraguay","2024-08-13",0,0,0,0,0,0,0,0
"Paraguay","2024-08-14",0,0,0,0,0,0,0,0
"Paraguay","2024-08-15",0,0,0,0,0,0,0,0
"Paraguay","2024-08-16",0,0,0,0,0,0,0,0
"Paraguay","2024-08-17",0,0,0,0,0,0,0,0
"Paraguay","2024-08-18",0,0,0,0,0,0,0,0
"Paraguay","2024-08-19",0,0,0,0,0,0,0,0
"Paraguay","2024-08-20",0,0,0,0,0,0,0,0
"Paraguay","2024-08-21",0,0,0,0,0,0,0,0
"Paraguay","2024-08-22",0,0,0,0,0,0,0,0
"Paraguay","2024-08-23",0,0,0,0,0,0,0,0
"Paraguay","2024-08-24",0,0,0,0,0,0,0,0
"Paraguay","2024-08-25",0,0,0,0,0,0,0,0
"Paraguay","2024-08-26",0,0,0,0,0,0,0,0
"Paraguay","2024-08-27",0,0,0,0,0,0,0,0
"Paraguay","2024-08-28",0,0,0,0,0,0,0,0
"Paraguay","2024-08-29",0,0,0,0,0,0,0,0
"Paraguay","2024-08-30",0,0,0,0,0,0,0,0
"Paraguay","2024-08-31",0,0,0,0,0,0,0,0
"Paraguay","2024-09-01",0,0,0,0,0,0,0,0
"Paraguay","2024-09-02",0,0,0,0,0,0,0,0
"Paraguay","2024-09-03",0,0,0,0,0,0,0,0
"Paraguay","2024-09-04",0,0,0,0,0,0,0,0
"Paraguay","2024-09-05",0,0,0,0,0,0,0,0
"Paraguay","2024-09-06",0,0,0,0,0,0,0,0
"Paraguay","2024-09-07",0,0,0,0,0,0,0,0
"Paraguay","2024-09-08",0,0,0,0,0,0,0,0
"Paraguay","2024-09-09",0,0,0,0,0,0,0,0
"Paraguay","2024-09-10",0,0,0,0,0,0,0,0
"Paraguay","2024-09-11",0,0,0,0,0,0,0,0
"Paraguay","2024-09-12",0,0,0,0,0,0,0,0
"Paraguay","2024-09-13",0,0,0,0,0,0,0,0
"Paraguay","2024-09-14",0,0,0,0,0,0,0,0
"Paraguay","2024-09-15",0,0,0,0,0,0,0,0
"Paraguay","2024-09-16",0,0,0,0,0,0,0,0
"Paraguay","2024-09-17",0,0,0,0,0,0,0,0
"Paraguay","2024-09-18",0,0,0,0,0,0,0,0
"Paraguay","2024-09-19",0,0,0,0,0,0,0,0
"Paraguay","2024-09-20",0,0,0,0,0,0,0,0
"Paraguay","2024-09-21",0,0,0,0,0,0,0,0
"Paraguay","2024-09-22",0,0,0,0,0,0,0,0
"Paraguay","2024-09-23",0,0,0,0,0,0,0,0
"Paraguay","2024-09-24",0,0,0,0,0,0,0,0
"Paraguay","2024-09-25",0,0,0,0,0,0,0,0
"Paraguay","2024-09-26",0,0,0,0,0,0,0,0
"Paraguay","2024-09-27",0,0,0,0,0,0,0,0
"Paraguay","2024-09-28",0,0,0,0,0,0,0,0
"Paraguay","2024-09-29",0,0,0,0,0,0,0,0
"Paraguay","2024-09-30",0,0,0,0,0,0,0,0
"Paraguay","2024-10-01",0,0,0,0,0,0,0,0
"Paraguay","2024-10-02",0,0,0,0,0,0,0,0
"Paraguay","2024-10-03",0,0,0,0,0,0,0,0
"Paraguay","2024-10-04",0,0,0,0,0,0,0,0
"Paraguay","2024-10-05",0,0,0,0,0,0,0,0
"Paraguay","2024-10-06",0,0,0,0,0,0,0,0
"Paraguay","2024-10-07",0,0,0,0,0,0,0,0
"Paraguay","2024-10-08",0,0,0,0,0,0,0,0
"Paraguay","2024-10-09",0,0,0,0,0,0,0,0
"Paraguay","2024-10-10",0,0,0,0,0,0,0,0
"Paraguay","2024-10-11",0,0,0,0,0,0,0,0
"Paraguay","2024-10-12",0,0,0,0,0,0,0,0
"Paraguay","2024-10-13",0,0,0,0,0,0,0,0
"Paraguay","2024-10-14",0,0,0,0,0,0,0,0
"Paraguay","2024-10-15",0,0,0,0,0,0,0,0
"Paraguay","2024-10-16",0,0,0,0,0,0,0,0
"Paraguay","2024-10-17",0,0,0,0,0,0,0,0
"Paraguay","2024-10-18",0,0,0,0,0,0,0,0
"Paraguay","2024-10-19",0,0,0,0,0,0,0,0
"Paraguay","2024-10-20",0,0,0,0,0,0,0,0
"Paraguay","2024-10-21",0,0,0,0,0,0,0,0
"Paraguay","2024-10-22",0,0,0,0,0,0,0,0
"Paraguay","2024-10-23",0,0,0,0,0,0,0,0
"Paraguay","2024-10-24",0,0,0,0,0,0,0,0
"Paraguay","2024-10-25",0,0,0,0,0,0,0,0
"Paraguay","2024-10-26",0,0,0,0,0,0,0,0
"Paraguay","2024-10-27",0,0,0,0,0,0,0,0
"Paraguay","2024-10-28",0,0,0,0,0,0,0,0
"Paraguay","2024-10-29",0,0,0,0,0,0,0,0
"Paraguay","2024-10-30",0,0,0,0,0,0,0,0
"Paraguay","2024-10-31",0,0,0,0,0,0,0,0
"Paraguay","2024-11-01",0,0,0,0,0,0,0,0
"Paraguay","2024-11-02",0,0,0,0,0,0,0,0
"Paraguay","2024-11-03",0,0,0,0,0,0,0,0
"Paraguay","2024-11-04",0,0,0,0,0,0,0,0
"Paraguay","2024-11-05",0,0,0,0,0,0,0,0
"Paraguay","2024-11-06",0,0,0,0,0,0,0,0
"Paraguay","2024-11-07",0,0,0,0,0,0,0,0
"Paraguay","2024-11-08",0,0,0,0,0,0,0,0
"Paraguay","2024-11-09",0,0,0,0,0,0,0,0
"Paraguay","2024-11-10",0,0,0,0,0,0,0,0
"Paraguay","2024-11-11",0,0,0,0,0,0,0,0
"Paraguay","2024-11-12",0,0,0,0,0,0,0,0
"Paraguay","2024-11-13",0,0,0,0,0,0,0,0
"Paraguay","2024-11-14",0,0,0,0,0,0,0,0
"Paraguay","2024-11-15",0,0,0,0,0,0,0,0
"Paraguay","2024-11-16",0,0,0,0,0,0,0,0
"Paraguay","2024-11-17",0,0,0,0,0,0,0,0
"Paraguay","2024-11-18",0,0,0,0,0,0,0,0
"Paraguay","2024-11-19",0,0,0,0,0,0,0,0
"Paraguay","2024-11-20",0,0,0,0,0,0,0,0
"Paraguay","2024-11-21",0,0,0,0,0,0,0,0
"Paraguay","2024-11-22",0,0,0,0,0,0,0,0
"Paraguay","2024-11-23",0,0,0,0,0,0,0,0
"Paraguay","2024-11-24",0,0,0,0,0,0,0,0
"Paraguay","2024-11-25",0,0,0,0,0,0,0,0
"Paraguay","2024-11-26",0,0,0,0,0,0,0,0
"Paraguay","2024-11-27",0,0,0,0,0,0,0,0
"Paraguay","2024-11-28",0,0,0,0,0,0,0,0
"Paraguay","2024-11-29",0,0,0,0,0,0,0,0
"Paraguay","2024-11-30",0,0,0,0,0,0,0,0
"Paraguay","2024-12-01",0,0,0,0,0,0,0,0
"Paraguay","2024-12-02",0,0,0,0,0,0,0,0
"Paraguay","2024-12-03",0,0,0,0,0,0,0,0
"Paraguay","2024-12-04",0,0,0,0,0,0,0,0
"Paraguay","2024-12-05",0,0,0,0,0,0,0,0
"Paraguay","2024-12-06",0,0,0,0,0,0,0,0
"Paraguay","2024-12-07",0,0,0,0,0,0,0,0
"Paraguay","2024-12-08",0,0,0,0,0,0,0,0
"Paraguay","2024-12-09",0,0,0,0,0,0,0,0
"Paraguay","2024-12-10",0,0,0,0,0,0,0,0
"Paraguay","2024-12-11",0,0,0,0,0,0,0,0
"Paraguay","2024-12-12",0,0,0,0,0,0,0,0
"Paraguay","2024-12-13",0,0,0,0,0,0,0,0
"Paraguay","2024-12-14",0,0,0,0,0,0,0,0
"Paraguay","2024-12-15",0,0,0,0,0,0,0,0
"Paraguay","2024-12-16",0,0,0,0,0,0,0,0
"Paraguay","2024-12-17",0,0,0,0,0,0,0,0
"Paraguay","2024-12-18",0,0,0,0,0,0,0,0
"Paraguay","2024-12-19",0,0,0,0,0,0,0,0
"Paraguay","2024-12-20",0,0,0,0,0,0,0,0
"Paraguay","2024-12-21",0,0,0,0,0,0,0,0
"Paraguay","2024-12-22",0,0,0,0,0,0,0,0
"Paraguay","2024-12-23",0,0,0,0,0,0,0,0
"Paraguay","2024-12-24",0,0,0,0,0,0,0,0
"Paraguay","2024-12-25",0,0,0,0,0,0,0,0
"Paraguay","2024-12-26",0,0,0,0,0,0,0,0
"Paraguay","2024-12-27",0,0,0,0,0,0,0,0
"Paraguay","2024-12-28",0,0,0,0,0,0,0,0
"Paraguay","2024-12-29",0,0,0,0,0,0,0,0
"Paraguay","2024-12-30",0,0,0,0,0,0,0,0
"Paraguay","2024-12-31",0,0,0,0,0,0,0,0
"Paraguay","2025-01-01",0,0,0,0,0,0,0,0
"Paraguay","2025-01-02",0,0,0,0,0,0,0,0
"Paraguay","2025-01-03",0,0,0,0,0,0,0,0
"Paraguay","2025-01-04",0,0,0,0,0,0,0,0
"Paraguay","2025-01-05",0,0,0,0,0,0,0,0
"Paraguay","2025-01-06",0,0,0,0,0,0,0,0
"Paraguay","2025-01-07",0,0,0,0,0,0,0,0
"Paraguay","2025-01-08",0,0,0,0,0,0,0,0
"Paraguay","2025-01-09",0,0,0,0,0,0,0,0
"Paraguay","2025-01-10",0,0,0,0,0,0,0,0
"Paraguay","2025-01-11",0,0,0,0,0,0,0,0
"Paraguay","2025-01-12",0,0,0,0,0,0,0,0
"Paraguay","2025-01-13",0,0,0,0,0,0,0,0
"Peru","2024-01-01",0,0,0,0,0,0,0,0
"Peru","2024-01-02",0,2,2,0,2,2,0,0
"Peru","2024-01-03",0,0,2,0,0,2,0,0
"Peru","2024-01-04",0,0,2,0,0,2,0,0
"Peru","2024-01-05",0,0,2,0,0,2,0,0
"Peru","2024-01-06",0,0,2,0,1,3,0,0
"Peru","2024-01-07",0,0,2,0,0,3,0,0
"Peru","2024-01-08",0,0,2,0,0,3,0,0
"Peru","2024-01-09",0,1,3,0,0,3,0,0
"Peru","2024-01-10",0,0,3,0,0,3,0,0
"Peru","2024-01-11",0,0,3,0,1,4,0,0
"Peru","2024-01-12",0,0,3,0,0,4,0,0
"Peru","2024-01-13",0,0,3,0,0,4,0,0
"Peru","2024-01-14",0,0,3,0,0,4,0,0
"Peru","2024-01-15",0,0,3,0,1,5,0,0
"Peru","2024-01-16",0,2,5,0,0,5,0,0
"Peru","2024-01-17",0,0,5,0,0,5,0,0
"Peru","2024-01-18",0,0,5,0,0,5,0,0
"Peru","2024-01-19",0,0,5,0,1,6,0,0
"Peru","2024-01-20",0,0,5,0,0,6,0,0
"Peru","2024-01-21",0,0,5,0,0,6,0,0
"Peru","2024-01-22",0,0,5,0,0,6,0,0
"Peru","2024-01-23",0,0,5,0,1,7,0,0
"Peru","2024-01-24",0,0,5,0,0,7,0,0
"Peru","2024-01-25",0,0,5,0,0,7,0,0
"Peru","2024-01-26",0,0,5,0,0,7,0,0
"Peru","2024-01-27",0,0,5,0,0,7,0,0
"Peru","2024-01-28",0,0,5,0,1,8,0,0
"Peru","2024-01-29",0,0,5,0,0,8,0,0
"Peru","2024-01-30",0,3,8,0,0,8,0,0
"Peru","2024-01-31",0,0,8,0,0,8,0,0
"Peru","2024-02-01",0,0,8,0,0,8,0,0
"Peru","2024-02-02",0,0,8,0,0,8,0,0
"Peru","2024-02-03",0,0,8,0,1,9,0,0
"Peru","2024-02-04",0,0,8,0,0,9,0,0
"Peru","2024-02-05",0,0,8,0,0,9,0,0
"Peru","2024-02-06",0,1,9,0,0,9,0,0
"Peru","2024-02-07",0,0,9,0,0,9,0,0
"Peru","2024-02-08",0,0,9,0,1,10,0,0
"Peru","2024-02-09",0,0,9,0,0,10,0,0
"Peru","2024-02-10",0,0,9,0,0,10,0,0
"Peru","2024-02-11",0,0,9,0,0,10,0,0
"Peru","2024-02-12",0,0,9,0,1,11,0,0
"Peru","2024-02-13",0,2,11,0,0,11,0,0
"Peru","2024-02-14",0,0,11,0,0,11,0,0
"Peru","2024-02-15",0,0,11,0,1,12,0,0
"Peru","2024-02-16",0,0,11,0,0,12,0,0
"Peru","2024-02-17",0,0,11,0,0,12,0,0
"Peru","2024-02-18",0,0,11,0,0,12,0,0
"Peru","2024-02-19",0,0,11,0,1,13,0,0
"Peru","2024-02-20",0,2,13,0,0,13,0,0
"Peru","2024-02-21",0,0,13,0,1,14,0,0
"Peru","2024-02-22",0,0,13,0,0,14,0,0
"Peru","2024-02-23",0,0,13,0,1,15,0,0
"Peru","2024-02-24",0,0,13,0,1,16,0,0
"Peru","2024-02-25",0,0,13,0,1,17,0,0
"Peru","2024-02-26",0,0,13,0,0,17,0,0
"Peru","2024-02-27",0,5,18,0,1,18,0,0
"Peru","2024-02-28",0,0,18,0,0,18,0,0
"Peru","2024-02-29",0,0,18,0,1,19,0,0
"Peru","2024-03-01",0,0,18,0,0,19,0,0
"Peru","2024-03-02",0,0,18,0,0,19,0,0
"Peru","2024-03-03",0,0,18,0,0,19,0,0
"Peru","2024-03-04",0,0,18,0,1,20,0,0
"Peru","2024-03-05",0,2,20,0,0,20,0,0
"Peru","2024-03-06",0,0,20,0,0,20,0,0
"Peru","2024-03-07",0,0,20,0,1,21,0,0
"Peru","2024-03-08",0,0,20,0,0,21,0,0
"Peru","2024-03-09",0,0,20,0,0,21,0,0
"Peru","2024-03-10",0,0,20,0,0,21,0,0
"Peru","2024-03-11",0,0,20,0,1,22,0,0
"Peru","2024-03-12",0,2,22,0,0,22,0,0
"Peru","2024-03-13",0,0,22,0,1,23,0,0
"Peru","2024-03-14",0,0,22,0,0,23,0,0
"Peru","2024-03-15",0,0,22,0,1,24,0,0
"Peru","2024-03-16",0,0,22,0,1,25,0,0
"Peru","2024-03-17",0,0,22,0,1,26,0,0
"Peru","2024-03-18",0,0,22,0,0,26,0,0
"Peru","2024-03-19",0,5,27,0,1,27,0,0
"Peru","2024-03-20",0,0,27,0,1,28,0,0
"Peru","2024-03-21",0,0,27,0,0,28,0,0
"Peru","2024-03-22",0,0,27,0,1,29,0,0
"Peru","2024-03-23",0,0,27,0,1,30,0,0
"Peru","2024-03-24",0,0,27,0,1,31,0,0
"Peru","2024-03-25",0,0,27,0,0,31,0,0
"Peru","2024-03-26",0,5,32,0,1,32,0,0
"Peru","2024-03-27",0,0,32,0,0,32,0,0
"Peru","2024-03-28",0,0,32,0,0,32,0,0
"Peru","2024-03-29",0,0,32,0,0,32,0,0
"Peru","2024-03-30",0,0,32,0,0,32,0,0
"Peru","2024-03-31",0,0,32,0,0,32,0,0
"Peru","2024-04-01",0,0,32,0,0,32,0,0
"Peru","2024-04-02",0,0,32,0,0,32,0,0
"Peru","2024-04-03",0,0,32,0,1,33,0,0
"Peru","2024-04-04",0,0,32,0,0,33,0,0
"Peru","2024-04-05",0,0,32,0,0,33,0,0
"Peru","2024-04-06",0,0,32,0,0,33,0,0
"Peru","2024-04-07",0,0,32,0,0,33,0,0
"Peru","2024-04-08",0,0,32,0,0,33,0,0
"Peru","2024-04-09",0,1,33,0,0,33,0,0
"Peru","2024-04-10",0,0,33,0,1,34,0,0
"Peru","2024-04-11",0,0,33,0,1,35,0,0
"Peru","2024-04-12",0,0,33,0,1,36,0,0
"Peru","2024-04-13",0,0,33,0,0,36,0,0
"Peru","2024-04-14",0,0,33,0,1,37,0,0
"Peru","2024-04-15",0,0,33,0,1,38,0,0
"Peru","2024-04-16",0,6,39,0,1,39,0,0
"Peru","2024-04-17",0,0,39,0,0,39,0,0
"Peru","2024-04-18",0,0,39,0,1,40,0,0
"Peru","2024-04-19",0,0,39,0,0,40,0,0
"Peru","2024-04-20",0,0,39,0,1,41,0,0
"Peru","2024-04-21",0,0,39,0,0,41,0,0
"Peru","2024-04-22",0,0,39,0,1,42,0,0
"Peru","2024-04-23",0,3,42,0,0,42,0,0
"Peru","2024-04-24",0,0,42,0,1,43,0,0
"Peru","2024-04-25",0,0,42,0,0,43,0,0
"Peru","2024-04-26",0,0,42,0,1,44,0,0
"Peru","2024-04-27",0,0,42,0,0,44,0,0
"Peru","2024-04-28",0,0,42,0,1,45,0,0
"Peru","2024-04-29",0,0,42,0,0,45,0,0
"Peru","2024-04-30",0,4,46,0,1,46,0,0
"Peru","2024-05-01",0,0,46,0,0,46,0,0
"Peru","2024-05-02",0,0,46,0,1,47,0,0
"Peru","2024-05-03",0,0,46,0,0,47,0,0
"Peru","2024-05-04",0,0,46,0,1,48,0,0
"Peru","2024-05-05",0,0,46,0,0,48,0,0
"Peru","2024-05-06",0,0,46,0,1,49,0,0
"Peru","2024-05-07",0,3,49,0,0,49,0,0
"Peru","2024-05-08",0,0,49,0,0,49,0,0
"Peru","2024-05-09",0,0,49,0,1,50,0,0
"Peru","2024-05-10",0,0,49,0,0,50,0,0
"Peru","2024-05-11",0,0,49,0,0,50,0,0
"Peru","2024-05-12",0,0,49,0,0,50,0,0
"Peru","2024-05-13",0,0,49,0,1,51,0,0
"Peru","2024-05-14",0,2,51,0,0,51,0,0
"Peru","2024-05-15",0,0,51,0,0,51,0,0
"Peru","2024-05-16",0,0,51,0,0,51,0,0
"Peru","2024-05-17",0,0,51,0,0,51,0,0
"Peru","2024-05-18",0,0,51,0,1,52,0,0
"Peru","2024-05-19",0,0,51,0,0,52,0,0
"Peru","2024-05-20",0,0,51,0,0,52,0,0
"Peru","2024-05-21",0,1,52,0,0,52,0,0
"Peru","2024-05-22",0,0,52,0,1,53,0,0
"Peru","2024-05-23",0,0,52,0,0,53,0,0
"Peru","2024-05-24",0,0,52,0,1,54,0,0
"Peru","2024-05-25",0,0,52,0,1,55,0,0
"Peru","2024-05-26",0,0,52,0,1,56,0,0
"Peru","2024-05-27",0,0,52,0,0,56,0,0
"Peru","2024-05-28",0,5,57,0,1,57,0,0
"Peru","2024-05-29",0,0,57,0,0,57,0,0
"Peru","2024-05-30",0,0,57,0,1,58,0,0
"Peru","2024-05-31",0,0,57,0,0,58,0,0
"Peru","2024-06-01",0,0,57,0,0,58,0,0
"Peru","2024-06-02",0,0,57,0,0,58,0,0
"Peru","2024-06-03",0,0,57,0,1,59,0,0
"Peru","2024-06-04",0,2,59,0,0,59,0,0
"Peru","2024-06-05",0,0,59,0,1,60,0,0
"Peru","2024-06-06",0,0,59,0,0,60,0,0
"Peru","2024-06-07",0,0,59,0,1,61,0,0
"Peru","2024-06-08",0,0,59,0,0,61,0,0
"Peru","2024-06-09",0,0,59,0,1,62,0,0
"Peru","2024-06-10",0,0,59,0,0,62,0,0
"Peru","2024-06-11",0,4,63,0,1,63,0,0
"Peru","2024-06-12",0,0,63,0,0,63,0,0
"Peru","2024-06-13",0,0,63,0,1,64,0,0
"Peru","2024-06-14",0,0,63,0,0,64,0,0
"Peru","2024-06-15",0,0,63,0,0,64,0,0
"Peru","2024-06-16",0,0,63,0,0,64,0,0
"Peru","2024-06-17",0,0,63,0,1,65,0,0
"Peru","2024-06-18",0,2,65,0,0,65,0,0
"Peru","2024-06-19",0,0,65,0,0,65,0,0
"Peru","2024-06-20",0,0,65,0,0,65,0,0
"Peru","2024-06-21",0,0,65,0,0,65,0,0
"Peru","2024-06-22",0,0,65,0,1,66,0,0
"Peru","2024-06-23",0,0,65,0,0,66,0,0
"Peru","2024-06-24",0,0,65,0,0,66,0,0
"Peru","2024-06-25",0,1,66,0,0,66,0,0
"Peru","2024-06-26",0,0,66,0,1,67,0,0
"Peru","2024-06-27",0,0,66,0,1,68,0,0
"Peru","2024-06-28",0,0,66,0,1,69,0,0
"Peru","2024-06-29",0,0,66,0,0,69,0,0
"Peru","2024-06-30",0,0,66,0,1,70,0,0
"Peru","2024-07-01",0,0,66,0,1,71,0,0
"Peru","2024-07-02",0,6,72,0,1,72,0,0
"Peru","2024-07-03",0,0,72,0,1,73,0,0
"Peru","2024-07-04",0,0,72,0,0,73,0,0
"Peru","2024-07-05",0,0,72,0,1,74,0,0
"Peru","2024-07-06",0,0,72,0,0,74,0,0
"Peru","2024-07-07",0,0,72,0,1,75,0,0
"Peru","2024-07-08",0,0,72,0,0,75,0,0
"Peru","2024-07-09",0,4,76,0,1,76,0,0
"Peru","2024-07-10",0,0,76,0,0,76,0,0
"Peru","2024-07-11",0,0,76,0,1,77,0,0
"Peru","2024-07-12",0,0,76,0,0,77,0,0
"Peru","2024-07-13",0,0,76,0,1,78,0,0
"Peru","2024-07-14",0,0,76,0,0,78,0,0
"Peru","2024-07-15",0,0,76,0,1,79,0,0
"Peru","2024-07-16",0,3,79,0,0,79,0,0
"Peru","2024-07-17",0,0,79,0,0,79,0,0
"Peru","2024-07-18",0,0,79,0,1,80,0,0
"Peru","2024-07-19",0,0,79,0,0,80,0,0
"Peru","2024-07-20",0,0,79,0,0,80,0,0
"Peru","2024-07-21",0,0,79,0,0,80,0,0
"Peru","2024-07-22",0,0,79,0,1,81,0,0
"Peru","2024-07-23",0,2,81,0,0,81,0,0
"Peru","2024-07-24",0,0,81,0,0,81,0,0
"Peru","2024-07-25",0,0,81,0,1,82,0,0
"Peru","2024-07-26",0,0,81,0,0,82,0,0
"Peru","2024-07-27",0,0,81,0,0,82,0,0
"Peru","2024-07-28",0,0,81,0,0,82,0,0
"Peru","2024-07-29",0,0,81,0,1,83,0,0
"Peru","2024-07-30",0,2,83,0,0,83,0,0
"Peru","2024-07-31",0,0,83,0,0,83,0,0
"Peru","2024-08-01",0,0,83,0,0,83,0,0
"Peru","2024-08-02",0,0,83,0,0,83,0,0
"Peru","2024-08-03",0,0,83,0,0,83,0,0
"Peru","2024-08-04",0,0,83,0,0,83,0,0
"Peru","2024-08-05",0,0,83,0,0,83,0,0
"Peru","2024-08-06",0,0,83,0,0,83,0,0
"Peru","2024-08-07",0,0,83,0,1,84,0,0
"Peru","2024-08-08",0,0,83,0,0,84,0,0
"Peru","2024-08-09",0,0,83,0,0,84,0,0
"Peru","2024-08-10",0,0,83,0,0,84,0,0
"Peru","2024-08-11",0,0,83,0,0,84,0,0
"Peru","2024-08-12",0,0,83,0,0,84,0,0
"Peru","2024-08-13",0,1,84,0,0,84,0,0
"Peru","2024-08-14",0,0,84,0,0,84,0,0
"Peru","2024-08-15",0,0,84,0,0,84,0,0
"Peru","2024-08-16",0,0,84,0,0,84,0,0
"Peru","2024-08-17",0,0,84,0,1,85,0,0
"Peru","2024-08-18",0,0,84,0,0,85,0,0
"Peru","2024-08-19",0,0,84,0,0,85,0,0
"Peru","2024-08-20",0,1,85,0,0,85,0,0
"Peru","2024-08-21",0,0,85,0,0,85,0,0
"Peru","2024-08-22",0,0,85,0,0,85,0,0
"Peru","2024-08-23",0,0,85,0,0,85,0,0
"Peru","2024-08-24",0,0,85,0,1,86,0,0
"Peru","2024-08-25",0,0,85,0,0,86,0,0
"Peru","2024-08-26",0,0,85,0,0,86,0,0
"Peru","2024-08-27",0,1,86,0,0,86,0,0
"Peru","2024-08-28",0,0,86,0,0,86,0,0
"Peru","2024-08-29",0,0,86,0,0,86,0,0
"Peru","2024-08-30",0,0,86,0,0,86,0,0
"Peru","2024-08-31",0,0,86,0,0,86,0,0
"Peru","2024-09-01",0,0,86,0,0,86,0,0
"Peru","2024-09-02",0,0,86,0,0,86,0,0
"Peru","2024-09-03",0,0,86,0,0,86,0,0
"Peru","2024-09-04",0,0,86,0,1,87,0,0
"Peru","2024-09-05",0,0,86,0,0,87,0,0
"Peru","2024-09-06",0,0,86,0,0,87,0,0
"Peru","2024-09-07",0,0,86,0,0,87,0,0
"Peru","2024-09-08",0,0,86,0,0,87,0,0
"Peru","2024-09-09",0,0,86,0,0,87,0,0
"Peru","2024-09-10",0,1,87,0,0,87,0,0
"Peru","2024-09-11",0,0,87,0,0,87,0,0
"Peru","2024-09-12",0,0,87,0,1,88,0,0
"Peru","2024-09-13",0,0,87,0,0,88,0,0
"Peru","2024-09-14",0,0,87,0,0,88,0,0
"Peru","2024-09-15",0,0,87,0,0,88,0,0
"Peru","2024-09-16",0,0,87,0,1,89,0,0
"Peru","2024-09-17",0,2,89,0,0,89,0,0
"Peru","2024-09-18",0,0,89,0,0,89,0,0
"Peru","2024-09-19",0,0,89,0,0,89,0,0
"Peru","2024-09-20",0,0,89,0,0,89,0,0
"Peru","2024-09-21",0,0,89,0,0,89,0,0
"Peru","2024-09-22",0,0,89,0,0,89,0,0
"Peru","2024-09-23",0,0,89,0,0,89,0,0
"Peru","2024-09-24",0,0,89,0,0,89,0,0
"Peru","2024-09-25",0,0,89,0,1,90,0,0
"Peru","2024-09-26",0,0,89,0,0,90,0,0
"Peru","2024-09-27",0,0,89,0,0,90,0,0
"Peru","2024-09-28",0,0,89,0,0,90,0,0
"Peru","2024-09-29",0,0,89,0,0,90,0,0
"Peru","2024-09-30",0,0,89,0,0,90,0,0
"Peru","2024-10-01",0,1,90,0,0,90,0,0
"Peru","2024-10-02",0,0,90,0,0,90,0,0
"Peru","2024-10-03",0,0,90,0,0,90,0,0
"Peru","2024-10-04",0,0,90,0,0,90,0,0
"Peru","2024-10-05",0,0,90,0,0,90,0,0
"Peru","2024-10-06",0,0,90,0,0,90,0,0
"Peru","2024-10-07",0,0,90,0,0,90,0,0
"Peru","2024-10-08",0,0,90,0,0,90,0,0
"Peru","2024-10-09",0,0,90,0,0,90,0,0
"Peru","2024-10-10",0,0,90,0,0,90,0,0
"Peru","2024-10-11",0,0,90,0,0,90,0,0
"Peru","2024-10-12",0,0,90,0,0,90,0,0
"Peru","2024-10-13",0,0,90,0,0,90,0,0
"Peru","2024-10-14",0,0,90,0,0,90,0,0
"Peru","2024-10-15",0,0,90,0,0,90,0,0
"Peru","2024-10-16",0,0,90,0,0,90,0,0
"Peru","2024-10-17",0,0,90,0,0,90,0,0
"Peru","2024-10-18",0,0,90,0,0,90,0,0
"Peru","2024-10-19",0,0,90,0,0,90,0,0
"Peru","2024-10-20",0,0,90,0,0,90,0,0
"Peru","2024-10-21",0,0,90,0,0,90,0,0
"Peru","2024-10-22",0,0,90,0,0,90,0,0
"Peru","2024-10-23",0,0,90,0,0,90,0,0
"Peru","2024-10-24",0,0,90,0,0,90,0,0
"Peru","2024-10-25",0,0,90,0,0,90,0,0
"Peru","2024-10-26",0,0,90,0,0,90,0,0
"Peru","2024-10-27",0,0,90,0,0,90,0,0
"Peru","2024-10-28",0,0,90,0,0,90,0,0
"Peru","2024-10-29",0,0,90,0,0,90,0,0
"Peru","2024-10-30",0,0,90,0,0,90,0,0
"Peru","2024-10-31",0,0,90,0,0,90,0,0
"Peru","2024-11-01",0,0,90,0,0,90,0,0
"Peru","2024-11-02",0,0,90,0,0,90,0,0
"Peru","2024-11-03",0,0,90,0,0,90,0,0
"Peru","2024-11-04",0,0,90,0,0,90,0,0
"Peru","2024-11-05",0,0,90,0,0,90,0,0
"Peru","2024-11-06",0,0,90,0,0,90,0,0
"Peru","2024-11-07",0,0,90,0,0,90,0,0
"Peru","2024-11-08",0,0,90,0,0,90,0,0
"Peru","2024-11-09",0,0,90,0,0,90,0,0
"Peru","2024-11-10",0,0,90,0,0,90,0,0
"Peru","2024-11-11",0,0,90,0,0,90,0,0
"Peru","2024-11-12",0,0,90,0,0,90,0,0
"Peru","2024-11-13",0,0,90,0,0,90,0,0
"Peru","2024-11-14",0,0,90,0,0,90,0,0
"Peru","2024-11-15",0,0,90,0,0,90,0,0
"Peru","2024-11-16",0,0,90,0,0,90,0,0
"Peru","2024-11-17",0,0,90,0,0,90,0,0
"Peru","2024-11-18",0,0,90,0,0,90,0,0
"Peru","2024-11-19",0,0,90,0,0,90,0,0
"Peru","2024-11-20",0,0,90,0,0,90,0,0
"Peru","2024-11-21",0,0,90,0,0,90,0,0
"Peru","2024-11-22",0,0,90,0,0,90,0,0
"Peru","2024-11-23",0,0,90,0,0,90,0,0
"Peru","2024-11-24",0,0,90,0,0,90,0,0
"Peru","2024-11-25",0,0,90,0,0,90,0,0
"Peru","2024-11-26",0,0,90,0,0,90,0,0
"Peru","2024-11-27",0,0,90,0,0,90,0,0
"Peru","2024-11-28",0,0,90,0,0,90,0,0
"Peru","2024-11-29",0,0,90,0,0,90,0,0
"Peru","2024-11-30",0,0,90,0,0,90,0,0
"Peru","2024-12-01",0,0,90,0,0,90,0,0
"Peru","2024-12-02",0,0,90,0,0,90,0,0
"Peru","2024-12-03",0,0,90,0,0,90,0,0
"Peru","2024-12-04",0,0,90,0,0,90,0,0
"Peru","2024-12-05",0,0,90,0,0,90,0,0
"Peru","2024-12-06",0,0,90,0,0,90,0,0
"Peru","2024-12-07",0,0,90,0,0,90,0,0
"Peru","2024-12-08",0,0,90,0,0,90,0,0
"Peru","2024-12-09",0,0,90,0,0,90,0,0
"Peru","2024-12-10",0,0,90,0,0,90,0,0
"Peru","2024-12-11",0,0,90,0,0,90,0,0
"Peru","2024-12-12",0,0,90,0,0,90,0,0
"Peru","2024-12-13",0,0,90,0,0,90,0,0
"Peru","2024-12-14",0,0,90,0,0,90,0,0
"Peru","2024-12-15",0,0,90,0,0,90,0,0
"Peru","2024-12-16",0,0,90,0,0,90,0,0
"Peru","2024-12-17",0,0,90,0,0,90,0,0
"Peru","2024-12-18",0,0,90,0,0,90,0,0
"Peru","2024-12-19",0,0,90,0,0,90,0,0
"Peru","2024-12-20",0,0,90,0,0,90,0,0
"Peru","2024-12-21",0,0,90,0,0,90,0,0
"Peru","2024-12-22",0,0,90,0,0,90,0,0
"Peru","2024-12-23",0,0,90,0,0,90,0,0
"Peru","2024-12-24",0,0,90,0,0,90,0,0
"Peru","2024-12-25",0,0,90,0,0,90,0,0
"Peru","2024-12-26",0,0,90,0,0,90,0,0
"Peru","2024-12-27",0,0,90,0,0,90,0,0
"Peru","2024-12-28",0,0,90,0,0,90,0,0
"Peru","2024-12-29",0,0,90,0,0,90,0,0
"Peru","2024-12-30",0,0,90,0,0,90,0,0
"Peru","2024-12-31",0,0,90,0,0,90,0,0
"Peru","2025-01-01",0,0,90,0,0,90,0,0
"Peru","2025-01-02",0,0,90,0,0,90,0,0
"Peru","2025-01-03",0,0,90,0,0,90,0,0
"Peru","2025-01-04",0,0,90,0,0,90,0,0
"Peru","2025-01-05",0,0,90,0,0,90,0,0
"Peru","2025-01-06",0,0,90,0,0,90,0,0
"Peru","2025-01-07",0,0,90,0,0,90,0,0
"Peru","2025-01-08",0,0,90,0,0,90,0,0
"Peru","2025-01-09",0,0,90,0,0,90,0,0
"Peru","2025-01-10",0,0,90,0,0,90,0,0
"Peru","2025-01-11",0,0,90,0,0,90,0,0
"Peru","2025-01-12",0,0,90,0,0,90,0,0
"Peru","2025-01-13",0,0,90,0,0,90,0,0
"Philippines","2024-01-01",0,0,0,0,0,0,0,0
"Philippines","2024-01-02",0,0,0,0,0,0,0,0
"Philippines","2024-01-03",0,0,0,0,0,0,0,0
"Philippines","2024-01-04",0,0,0,0,0,0,0,0
"Philippines","2024-01-05",0,0,0,0,0,0,0,0
"Philippines","2024-01-06",0,0,0,0,0,0,0,0
"Philippines","2024-01-07",0,0,0,0,0,0,0,0
"Philippines","2024-01-08",0,0,0,0,0,0,0,0
"Philippines","2024-01-09",0,0,0,0,0,0,0,0
"Philippines","2024-01-10",0,0,0,0,0,0,0,0
"Philippines","2024-01-11",0,0,0,0,0,0,0,0
"Philippines","2024-01-12",0,0,0,0,0,0,0,0
"Philippines","2024-01-13",0,0,0,0,0,0,0,0
"Philippines","2024-01-14",0,0,0,0,0,0,0,0
"Philippines","2024-01-15",0,0,0,0,0,0,0,0
"Philippines","2024-01-16",0,0,0,0,0,0,0,0
"Philippines","2024-01-17",0,0,0,0,0,0,0,0
"Philippines","2024-01-18",0,0,0,0,0,0,0,0
"Philippines","2024-01-19",0,0,0,0,0,0,0,0
"Philippines","2024-01-20",0,0,0,0,0,0,0,0
"Philippines","2024-01-21",0,0,0,0,0,0,0,0
"Philippines","2024-01-22",0,0,0,0,0,0,0,0
"Philippines","2024-01-23",0,0,0,0,0,0,0,0
"Philippines","2024-01-24",0,0,0,0,0,0,0,0
"Philippines","2024-01-25",0,0,0,0,0,0,0,0
"Philippines","2024-01-26",0,0,0,0,0,0,0,0
"Philippines","2024-01-27",0,0,0,0,0,0,0,0
"Philippines","2024-01-28",0,0,0,0,0,0,0,0
"Philippines","2024-01-29",0,0,0,0,0,0,0,0
"Philippines","2024-01-30",0,0,0,0,0,0,0,0
"Philippines","2024-01-31",0,0,0,0,0,0,0,0
"Philippines","2024-02-01",0,0,0,0,0,0,0,0
"Philippines","2024-02-02",0,0,0,0,0,0,0,0
"Philippines","2024-02-03",0,0,0,0,0,0,0,0
"Philippines","2024-02-04",0,0,0,0,0,0,0,0
"Philippines","2024-02-05",0,0,0,0,0,0,0,0
"Philippines","2024-02-06",0,0,0,0,0,0,0,0
"Philippines","2024-02-07",0,0,0,0,0,0,0,0
"Philippines","2024-02-08",0,0,0,0,0,0,0,0
"Philippines","2024-02-09",0,0,0,0,0,0,0,0
"Philippines","2024-02-10",0,0,0,0,0,0,0,0
"Philippines","2024-02-11",0,0,0,0,0,0,0,0
"Philippines","2024-02-12",0,0,0,0,0,0,0,0
"Philippines","2024-02-13",0,0,0,0,0,0,0,0
"Philippines","2024-02-14",0,0,0,0,0,0,0,0
"Philippines","2024-02-15",0,0,0,0,0,0,0,0
"Philippines","2024-02-16",0,0,0,0,0,0,0,0
"Philippines","2024-02-17",0,0,0,0,0,0,0,0
"Philippines","2024-02-18",0,0,0,0,0,0,0,0
"Philippines","2024-02-19",0,0,0,0,0,0,0,0
"Philippines","2024-02-20",0,0,0,0,0,0,0,0
"Philippines","2024-02-21",0,0,0,0,0,0,0,0
"Philippines","2024-02-22",0,0,0,0,0,0,0,0
"Philippines","2024-02-23",0,0,0,0,0,0,0,0
"Philippines","2024-02-24",0,0,0,0,0,0,0,0
"Philippines","2024-02-25",0,0,0,0,0,0,0,0
"Philippines","2024-02-26",0,0,0,0,0,0,0,0
"Philippines","2024-02-27",0,0,0,0,0,0,0,0
"Philippines","2024-02-28",0,0,0,0,0,0,0,0
"Philippines","2024-02-29",0,0,0,0,0,0,0,0
"Philippines","2024-03-01",0,0,0,0,0,0,0,0
"Philippines","2024-03-02",0,0,0,0,0,0,0,0
"Philippines","2024-03-03",0,0,0,0,0,0,0,0
"Philippines","2024-03-04",0,0,0,0,0,0,0,0
"Philippines","2024-03-05",0,0,0,0,0,0,0,0
"Philippines","2024-03-06",0,0,0,0,0,0,0,0
"Philippines","2024-03-07",0,0,0,0,0,0,0,0
"Philippines","2024-03-08",0,0,0,0,0,0,0,0
"Philippines","2024-03-09",0,0,0,0,0,0,0,0
"Philippines","2024-03-10",0,0,0,0,0,0,0,0
"Philippines","2024-03-11",0,0,0,0,0,0,0,0
"Philippines","2024-03-12",0,0,0,0,0,0,0,0
"Philippines","2024-03-13",0,0,0,0,0,0,0,0
"Philippines","2024-03-14",0,0,0,0,0,0,0,0
"Philippines","2024-03-15",0,0,0,0,0,0,0,0
"Philippines","2024-03-16",0,0,0,0,0,0,0,0
"Philippines","2024-03-17",0,0,0,0,0,0,0,0
"Philippines","2024-03-18",0,0,0,0,0,0,0,0
"Philippines","2024-03-19",0,0,0,0,0,0,0,0
"Philippines","2024-03-20",0,0,0,0,0,0,0,0
"Philippines","2024-03-21",0,0,0,0,0,0,0,0
"Philippines","2024-03-22",0,0,0,0,0,0,0,0
"Philippines","2024-03-23",0,0,0,0,0,0,0,0
"Philippines","2024-03-24",0,0,0,0,0,0,0,0
"Philippines","2024-03-25",0,0,0,0,0,0,0,0
"Philippines","2024-03-26",0,0,0,0,0,0,0,0
"Philippines","2024-03-27",0,0,0,0,0,0,0,0
"Philippines","2024-03-28",0,0,0,0,0,0,0,0
"Philippines","2024-03-29",0,0,0,0,0,0,0,0
"Philippines","2024-03-30",0,0,0,0,0,0,0,0
"Philippines","2024-03-31",0,0,0,0,0,0,0,0
"Philippines","2024-04-01",0,0,0,0,0,0,0,0
"Philippines","2024-04-02",0,0,0,0,0,0,0,0
"Philippines","2024-04-03",0,0,0,0,0,0,0,0
"Philippines","2024-04-04",0,0,0,0,0,0,0,0
"Philippines","2024-04-05",0,0,0,0,0,0,0,0
"Philippines","2024-04-06",0,0,0,0,0,0,0,0
"Philippines","2024-04-07",0,0,0,0,0,0,0,0
"Philippines","2024-04-08",0,0,0,0,0,0,0,0
"Philippines","2024-04-09",0,0,0,0,0,0,0,0
"Philippines","2024-04-10",0,0,0,0,0,0,0,0
"Philippines","2024-04-11",0,0,0,0,0,0,0,0
"Philippines","2024-04-12",0,0,0,0,0,0,0,0
"Philippines","2024-04-13",0,0,0,0,0,0,0,0
"Philippines","2024-04-14",0,0,0,0,0,0,0,0
"Philippines","2024-04-15",0,0,0,0,0,0,0,0
"Philippines","2024-04-16",0,0,0,0,0,0,0,0
"Philippines","2024-04-17",0,0,0,0,0,0,0,0
"Philippines","2024-04-18",0,0,0,0,0,0,0,0
"Philippines","2024-04-19",0,0,0,0,0,0,0,0
"Philippines","2024-04-20",0,0,0,0,0,0,0,0
"Philippines","2024-04-21",0,0,0,0,0,0,0,0
"Philippines","2024-04-22",0,0,0,0,0,0,0,0
"Philippines","2024-04-23",0,0,0,0,0,0,0,0
"Philippines","2024-04-24",0,0,0,0,0,0,0,0
"Philippines","2024-04-25",0,0,0,0,0,0,0,0
"Philippines","2024-04-26",0,0,0,0,0,0,0,0
"Philippines","2024-04-27",0,0,0,0,0,0,0,0
"Philippines","2024-04-28",0,0,0,0,0,0,0,0
"Philippines","2024-04-29",0,0,0,0,0,0,0,0
"Philippines","2024-04-30",0,0,0,0,0,0,0,0
"Philippines","2024-05-01",0,0,0,0,0,0,0,0
"Philippines","2024-05-02",0,0,0,0,0,0,0,0
"Philippines","2024-05-03",0,0,0,0,0,0,0,0
"Philippines","2024-05-04",0,0,0,0,0,0,0,0
"Philippines","2024-05-05",0,0,0,0,0,0,0,0
"Philippines","2024-05-06",0,0,0,0,0,0,0,0
"Philippines","2024-05-07",0,0,0,0,0,0,0,0
"Philippines","2024-05-08",0,0,0,0,0,0,0,0
"Philippines","2024-05-09",0,0,0,0,0,0,0,0
"Philippines","2024-05-10",0,0,0,0,0,0,0,0
"Philippines","2024-05-11",0,0,0,0,0,0,0,0
"Philippines","2024-05-12",0,0,0,0,0,0,0,0
"Philippines","2024-05-13",0,0,0,0,0,0,0,0
"Philippines","2024-05-14",0,0,0,0,0,0,0,0
"Philippines","2024-05-15",0,0,0,0,0,0,0,0
"Philippines","2024-05-16",0,0,0,0,0,0,0,0
"Philippines","2024-05-17",0,0,0,0,0,0,0,0
"Philippines","2024-05-18",0,0,0,0,0,0,0,0
"Philippines","2024-05-19",0,0,0,0,0,0,0,0
"Philippines","2024-05-20",0,0,0,0,0,0,0,0
"Philippines","2024-05-21",0,0,0,0,0,0,0,0
"Philippines","2024-05-22",0,0,0,0,0,0,0,0
"Philippines","2024-05-23",0,0,0,0,0,0,0,0
"Philippines","2024-05-24",0,0,0,0,0,0,0,0
"Philippines","2024-05-25",0,0,0,0,0,0,0,0
"Philippines","2024-05-26",0,0,0,0,0,0,0,0
"Philippines","2024-05-27",0,0,0,0,0,0,0,0
"Philippines","2024-05-28",0,0,0,0,0,0,0,0
"Philippines","2024-05-29",0,0,0,0,0,0,0,0
"Philippines","2024-05-30",0,0,0,0,0,0,0,0
"Philippines","2024-05-31",0,0,0,0,0,0,0,0
"Philippines","2024-06-01",0,0,0,0,0,0,0,0
"Philippines","2024-06-02",0,0,0,0,0,0,0,0
"Philippines","2024-06-03",0,0,0,0,0,0,0,0
"Philippines","2024-06-04",0,0,0,0,0,0,0,0
"Philippines","2024-06-05",0,0,0,0,0,0,0,0
"Philippines","2024-06-06",0,0,0,0,0,0,0,0
"Philippines","2024-06-07",0,0,0,0,0,0,0,0
"Philippines","2024-06-08",0,0,0,0,0,0,0,0
"Philippines","2024-06-09",0,0,0,0,0,0,0,0
"Philippines","2024-06-10",0,0,0,0,0,0,0,0
"Philippines","2024-06-11",0,0,0,0,0,0,0,0
"Philippines","2024-06-12",0,0,0,0,0,0,0,0
"Philippines","2024-06-13",0,0,0,0,0,0,0,0
"Philippines","2024-06-14",0,0,0,0,0,0,0,0
"Philippines","2024-06-15",0,0,0,0,0,0,0,0
"Philippines","2024-06-16",0,0,0,0,0,0,0,0
"Philippines","2024-06-17",0,0,0,0,0,0,0,0
"Philippines","2024-06-18",0,0,0,0,0,0,0,0
"Philippines","2024-06-19",0,0,0,0,0,0,0,0
"Philippines","2024-06-20",0,0,0,0,0,0,0,0
"Philippines","2024-06-21",0,0,0,0,0,0,0,0
"Philippines","2024-06-22",0,0,0,0,0,0,0,0
"Philippines","2024-06-23",0,0,0,0,0,0,0,0
"Philippines","2024-06-24",0,0,0,0,0,0,0,0
"Philippines","2024-06-25",0,0,0,0,0,0,0,0
"Philippines","2024-06-26",0,0,0,0,0,0,0,0
"Philippines","2024-06-27",0,0,0,0,0,0,0,0
"Philippines","2024-06-28",0,0,0,0,0,0,0,0
"Philippines","2024-06-29",0,0,0,0,0,0,0,0
"Philippines","2024-06-30",0,0,0,0,0,0,0,0
"Philippines","2024-07-01",0,0,0,0,0,0,0,0
"Philippines","2024-07-02",0,0,0,0,0,0,0,0
"Philippines","2024-07-03",0,0,0,0,0,0,0,0
"Philippines","2024-07-04",0,0,0,0,0,0,0,0
"Philippines","2024-07-05",0,0,0,0,0,0,0,0
"Philippines","2024-07-06",0,0,0,0,0,0,0,0
"Philippines","2024-07-07",0,0,0,0,0,0,0,0
"Philippines","2024-07-08",0,0,0,0,0,0,0,0
"Philippines","2024-07-09",0,0,0,0,0,0,0,0
"Philippines","2024-07-10",0,0,0,0,0,0,0,0
"Philippines","2024-07-11",0,0,0,0,0,0,0,0
"Philippines","2024-07-12",0,0,0,0,0,0,0,0
"Philippines","2024-07-13",0,0,0,0,0,0,0,0
"Philippines","2024-07-14",0,0,0,0,0,0,0,0
"Philippines","2024-07-15",0,0,0,0,0,0,0,0
"Philippines","2024-07-16",0,0,0,0,0,0,0,0
"Philippines","2024-07-17",0,0,0,0,0,0,0,0
"Philippines","2024-07-18",0,0,0,0,0,0,0,0
"Philippines","2024-07-19",0,0,0,0,0,0,0,0
"Philippines","2024-07-20",0,0,0,0,0,0,0,0
"Philippines","2024-07-21",0,0,0,0,0,0,0,0
"Philippines","2024-07-22",0,0,0,0,0,0,0,0
"Philippines","2024-07-23",0,0,0,0,0,0,0,0
"Philippines","2024-07-24",0,0,0,0,0,0,0,0
"Philippines","2024-07-25",0,0,0,0,0,0,0,0
"Philippines","2024-07-26",0,0,0,0,0,0,0,0
"Philippines","2024-07-27",0,0,0,0,0,0,0,0
"Philippines","2024-07-28",0,0,0,0,0,0,0,0
"Philippines","2024-07-29",0,0,0,0,0,0,0,0
"Philippines","2024-07-30",0,0,0,0,0,0,0,0
"Philippines","2024-07-31",0,0,0,0,0,0,0,0
"Philippines","2024-08-01",0,0,0,0,0,0,0,0
"Philippines","2024-08-02",0,0,0,0,0,0,0,0
"Philippines","2024-08-03",0,0,0,0,0,0,0,0
"Philippines","2024-08-04",0,0,0,0,0,0,0,0
"Philippines","2024-08-05",0,0,0,0,0,0,0,0
"Philippines","2024-08-06",0,0,0,0,0,0,0,0
"Philippines","2024-08-07",0,0,0,0,0,0,0,0
"Philippines","2024-08-08",0,0,0,0,0,0,0,0
"Philippines","2024-08-09",0,0,0,0,0,0,0,0
"Philippines","2024-08-10",0,0,0,0,0,0,0,0
"Philippines","2024-08-11",0,0,0,0,0,0,0,0
"Philippines","2024-08-12",0,0,0,0,0,0,0,0
"Philippines","2024-08-13",0,0,0,0,0,0,0,0
"Philippines","2024-08-14",0,0,0,0,0,0,0,0
"Philippines","2024-08-15",0,0,0,0,0,0,0,0
"Philippines","2024-08-16",0,0,0,0,0,0,0,0
"Philippines","2024-08-17",0,0,0,0,0,0,0,0
"Philippines","2024-08-18",0,0,0,0,0,0,0,0
"Philippines","2024-08-19",0,1,1,0,1,1,0,0
"Philippines","2024-08-20",0,0,1,0,0,1,0,0
"Philippines","2024-08-21",0,0,1,0,1,2,0,0
"Philippines","2024-08-22",0,0,1,0,0,2,0,0
"Philippines","2024-08-23",0,0,1,0,1,3,0,0
"Philippines","2024-08-24",0,0,1,0,0,3,0,0
"Philippines","2024-08-25",0,0,1,0,1,4,0,0
"Philippines","2024-08-26",0,0,1,0,0,4,0,0
"Philippines","2024-08-27",0,0,1,0,1,5,0,0
"Philippines","2024-08-28",0,4,5,0,0,5,0,0
"Philippines","2024-08-29",0,0,5,0,1,6,0,0
"Philippines","2024-08-30",0,0,5,0,1,7,0,0
"Philippines","2024-08-31",0,0,5,0,0,7,0,0
"Philippines","2024-09-01",0,3,8,0,1,8,0,0
"Philippines","2024-09-02",0,0,8,0,1,9,0,0
"Philippines","2024-09-03",0,0,8,0,0,9,0,0
"Philippines","2024-09-04",0,0,8,0,1,10,0,0
"Philippines","2024-09-05",0,0,8,0,0,10,0,0
"Philippines","2024-09-06",0,0,8,0,1,11,0,0
"Philippines","2024-09-07",0,0,8,0,1,12,0,0
"Philippines","2024-09-08",0,0,8,0,0,12,0,0
"Philippines","2024-09-09",0,0,8,0,1,13,0,0
"Philippines","2024-09-10",0,0,8,0,0,13,0,0
"Philippines","2024-09-11",0,0,8,0,1,14,0,0
"Philippines","2024-09-12",0,0,8,0,1,15,0,0
"Philippines","2024-09-13",0,0,8,0,0,15,0,0
"Philippines","2024-09-14",0,0,8,0,1,16,0,0
"Philippines","2024-09-15",0,0,8,0,0,16,0,0
"Philippines","2024-09-16",0,0,8,0,1,17,0,0
"Philippines","2024-09-17",0,0,8,0,1,18,0,0
"Philippines","2024-09-18",0,0,8,0,0,18,0,0
"Philippines","2024-09-19",0,0,8,0,1,19,0,0
"Philippines","2024-09-20",0,0,8,0,0,19,0,0
"Philippines","2024-09-21",0,0,8,0,1,20,0,0
"Philippines","2024-09-22",0,0,8,0,1,21,0,0
"Philippines","2024-09-23",0,0,8,0,0,21,0,0
"Philippines","2024-09-24",0,0,8,0,1,22,0,0
"Philippines","2024-09-25",0,0,8,0,0,22,0,0
"Philippines","2024-09-26",0,15,23,0,1,23,0,0
"Philippines","2024-09-27",0,0,23,0,0,23,0,0
"Philippines","2024-09-28",0,0,23,0,1,24,0,0
"Philippines","2024-09-29",0,0,23,0,0,24,0,0
"Philippines","2024-09-30",0,0,23,0,1,25,0,0
"Philippines","2024-10-01",0,0,23,0,0,25,0,0
"Philippines","2024-10-02",0,0,23,0,0,25,0,0
"Philippines","2024-10-03",0,0,23,0,1,26,0,0
"Philippines","2024-10-04",0,0,23,0,0,26,0,0
"Philippines","2024-10-05",0,0,23,0,0,26,0,0
"Philippines","2024-10-06",0,0,23,0,1,27,0,0
"Philippines","2024-10-07",0,0,23,0,0,27,0,0
"Philippines","2024-10-08",0,0,23,0,1,28,0,0
"Philippines","2024-10-09",0,0,23,0,0,28,0,0
"Philippines","2024-10-10",0,0,23,0,0,28,0,0
"Philippines","2024-10-11",0,0,23,0,1,29,0,0
"Philippines","2024-10-12",0,0,23,0,0,29,0,0
"Philippines","2024-10-13",0,0,23,0,1,30,0,0
"Philippines","2024-10-14",0,0,23,0,0,30,0,0
"Philippines","2024-10-15",0,0,23,0,0,30,0,0
"Philippines","2024-10-16",0,0,23,0,1,31,0,0
"Philippines","2024-10-17",0,0,23,0,0,31,0,0
"Philippines","2024-10-18",0,0,23,0,1,32,0,0
"Philippines","2024-10-19",0,0,23,0,0,32,0,0
"Philippines","2024-10-20",0,0,23,0,0,32,0,0
"Philippines","2024-10-21",0,0,23,0,1,33,0,0
"Philippines","2024-10-22",0,0,23,0,0,33,0,0
"Philippines","2024-10-23",0,0,23,0,0,33,0,0
"Philippines","2024-10-24",0,0,23,0,1,34,0,0
"Philippines","2024-10-25",0,0,23,0,0,34,0,0
"Philippines","2024-10-26",0,0,23,0,1,35,0,0
"Philippines","2024-10-27",0,0,23,0,0,35,0,0
"Philippines","2024-10-28",0,0,23,0,0,35,0,0
"Philippines","2024-10-29",0,0,23,0,1,36,0,0
"Philippines","2024-10-30",0,0,23,0,0,36,0,0
"Philippines","2024-10-31",0,0,23,0,1,37,0,0
"Philippines","2024-11-01",0,0,23,0,0,37,0,0
"Philippines","2024-11-02",0,0,23,0,0,37,0,0
"Philippines","2024-11-03",0,0,23,0,1,38,0,0
"Philippines","2024-11-04",0,0,23,0,0,38,0,0
"Philippines","2024-11-05",0,0,23,0,0,38,0,0
"Philippines","2024-11-06",0,0,23,0,1,39,0,0
"Philippines","2024-11-07",0,0,23,0,0,39,0,0
"Philippines","2024-11-08",0,0,23,0,1,40,0,0
"Philippines","2024-11-09",0,0,23,0,0,40,0,0
"Philippines","2024-11-10",0,0,23,0,0,40,0,0
"Philippines","2024-11-11",0,0,23,0,1,41,0,0
"Philippines","2024-11-12",0,0,23,0,0,41,0,0
"Philippines","2024-11-13",0,0,23,0,1,42,0,0
"Philippines","2024-11-14",0,0,23,0,0,42,0,0
"Philippines","2024-11-15",0,0,23,0,0,42,0,0
"Philippines","2024-11-16",0,0,23,0,1,43,0,0
"Philippines","2024-11-17",0,0,23,0,0,43,0,0
"Philippines","2024-11-18",0,0,23,0,1,44,0,0
"Philippines","2024-11-19",0,0,23,0,0,44,0,0
"Philippines","2024-11-20",0,0,23,0,0,44,0,0
"Philippines","2024-11-21",0,0,23,0,1,45,0,0
"Philippines","2024-11-22",0,0,23,0,0,45,0,0
"Philippines","2024-11-23",0,0,23,0,0,45,0,0
"Philippines","2024-11-24",0,0,23,0,1,46,0,0
"Philippines","2024-11-25",0,0,23,0,0,46,0,0
"Philippines","2024-11-26",0,0,23,0,1,47,0,0
"Philippines","2024-11-27",0,24,47,0,0,47,0,0
"Philippines","2024-11-28",0,0,47,0,0,47,0,0
"Philippines","2024-11-29",0,0,47,0,0,47,0,0
"Philippines","2024-11-30",0,0,47,0,0,47,0,0
"Philippines","2024-12-01",0,0,47,0,0,47,0,0
"Philippines","2024-12-02",0,0,47,0,0,47,0,0
"Philippines","2024-12-03",0,0,47,0,0,47,0,0
"Philippines","2024-12-04",0,0,47,0,0,47,0,0
"Philippines","2024-12-05",0,0,47,0,0,47,0,0
"Philippines","2024-12-06",0,0,47,0,0,47,0,0
"Philippines","2024-12-07",0,0,47,0,0,47,0,0
"Philippines","2024-12-08",0,0,47,0,0,47,0,0
"Philippines","2024-12-09",0,0,47,0,0,47,0,0
"Philippines","2024-12-10",0,0,47,0,0,47,0,0
"Philippines","2024-12-11",0,0,47,0,0,47,0,0
"Philippines","2024-12-12",0,0,47,0,0,47,0,0
"Philippines","2024-12-13",0,0,47,0,0,47,0,0
"Philippines","2024-12-14",0,0,47,0,0,47,0,0
"Philippines","2024-12-15",0,0,47,0,0,47,0,0
"Philippines","2024-12-16",0,0,47,0,0,47,0,0
"Philippines","2024-12-17",0,0,47,0,0,47,0,0
"Philippines","2024-12-18",0,0,47,0,0,47,0,0
"Philippines","2024-12-19",0,0,47,0,0,47,0,0
"Philippines","2024-12-20",0,0,47,0,0,47,0,0
"Philippines","2024-12-21",0,0,47,0,0,47,0,0
"Philippines","2024-12-22",0,0,47,0,0,47,0,0
"Philippines","2024-12-23",0,0,47,0,0,47,0,0
"Philippines","2024-12-24",0,0,47,0,0,47,0,0
"Philippines","2024-12-25",0,0,47,0,0,47,0,0
"Philippines","2024-12-26",0,0,47,0,0,47,0,0
"Philippines","2024-12-27",0,0,47,0,0,47,0,0
"Philippines","2024-12-28",0,0,47,0,0,47,0,0
"Philippines","2024-12-29",0,0,47,0,0,47,0,0
"Philippines","2024-12-30",0,0,47,0,0,47,0,0
"Philippines","2024-12-31",0,0,47,0,0,47,0,0
"Philippines","2025-01-01",0,0,47,0,0,47,0,0
"Philippines","2025-01-02",0,0,47,0,0,47,0,0
"Philippines","2025-01-03",0,0,47,0,0,47,0,0
"Philippines","2025-01-04",0,0,47,0,0,47,0,0
"Philippines","2025-01-05",0,0,47,0,0,47,0,0
"Philippines","2025-01-06",0,0,47,0,0,47,0,0
"Philippines","2025-01-07",0,0,47,0,0,47,0,0
"Philippines","2025-01-08",0,0,47,0,0,47,0,0
"Philippines","2025-01-09",0,0,47,0,0,47,0,0
"Philippines","2025-01-10",0,0,47,0,0,47,0,0
"Philippines","2025-01-11",0,0,47,0,0,47,0,0
"Philippines","2025-01-12",0,0,47,0,0,47,0,0
"Philippines","2025-01-13",0,0,47,0,0,47,0,0
"Poland","2024-01-01",0,0,0,0,0,0,0,0
"Poland","2024-01-02",0,0,0,0,0,0,0,0
"Poland","2024-01-03",0,0,0,0,0,0,0,0
"Poland","2024-01-04",0,0,0,0,0,0,0,0
"Poland","2024-01-05",0,0,0,0,0,0,0,0
"Poland","2024-01-06",0,0,0,0,0,0,0,0
"Poland","2024-01-07",0,0,0,0,0,0,0,0
"Poland","2024-01-08",0,0,0,0,0,0,0,0
"Poland","2024-01-09",0,0,0,0,0,0,0,0
"Poland","2024-01-10",0,0,0,0,0,0,0,0
"Poland","2024-01-11",0,0,0,0,0,0,0,0
"Poland","2024-01-12",0,0,0,0,0,0,0,0
"Poland","2024-01-13",0,0,0,0,0,0,0,0
"Poland","2024-01-14",0,0,0,0,0,0,0,0
"Poland","2024-01-15",0,0,0,0,0,0,0,0
"Poland","2024-01-16",0,0,0,0,0,0,0,0
"Poland","2024-01-17",0,0,0,0,0,0,0,0
"Poland","2024-01-18",0,0,0,0,0,0,0,0
"Poland","2024-01-19",0,0,0,0,0,0,0,0
"Poland","2024-01-20",0,0,0,0,0,0,0,0
"Poland","2024-01-21",0,0,0,0,0,0,0,0
"Poland","2024-01-22",0,0,0,0,0,0,0,0
"Poland","2024-01-23",0,0,0,0,0,0,0,0
"Poland","2024-01-24",0,0,0,0,0,0,0,0
"Poland","2024-01-25",0,0,0,0,0,0,0,0
"Poland","2024-01-26",0,0,0,0,0,0,0,0
"Poland","2024-01-27",0,0,0,0,0,0,0,0
"Poland","2024-01-28",0,0,0,0,0,0,0,0
"Poland","2024-01-29",0,0,0,0,0,0,0,0
"Poland","2024-01-30",0,0,0,0,0,0,0,0
"Poland","2024-01-31",0,3,3,0,3,3,0,0
"Poland","2024-02-01",0,0,3,0,0,3,0,0
"Poland","2024-02-02",0,0,3,0,0,3,0,0
"Poland","2024-02-03",0,0,3,0,0,3,0,0
"Poland","2024-02-04",0,0,3,0,0,3,0,0
"Poland","2024-02-05",0,0,3,0,0,3,0,0
"Poland","2024-02-06",0,0,3,0,0,3,0,0
"Poland","2024-02-07",0,0,3,0,0,3,0,0
"Poland","2024-02-08",0,0,3,0,0,3,0,0
"Poland","2024-02-09",0,0,3,0,0,3,0,0
"Poland","2024-02-10",0,0,3,0,0,3,0,0
"Poland","2024-02-11",0,0,3,0,0,3,0,0
"Poland","2024-02-12",0,0,3,0,0,3,0,0
"Poland","2024-02-13",0,0,3,0,0,3,0,0
"Poland","2024-02-14",0,0,3,0,0,3,0,0
"Poland","2024-02-15",0,0,3,0,0,3,0,0
"Poland","2024-02-16",0,0,3,0,0,3,0,0
"Poland","2024-02-17",0,0,3,0,0,3,0,0
"Poland","2024-02-18",0,0,3,0,0,3,0,0
"Poland","2024-02-19",0,0,3,0,0,3,0,0
"Poland","2024-02-20",0,0,3,0,0,3,0,0
"Poland","2024-02-21",0,0,3,0,0,3,0,0
"Poland","2024-02-22",0,0,3,0,0,3,0,0
"Poland","2024-02-23",0,0,3,0,0,3,0,0
"Poland","2024-02-24",0,0,3,0,0,3,0,0
"Poland","2024-02-25",0,0,3,0,0,3,0,0
"Poland","2024-02-26",0,0,3,0,0,3,0,0
"Poland","2024-02-27",0,0,3,0,0,3,0,0
"Poland","2024-02-28",0,0,3,0,0,3,0,0
"Poland","2024-02-29",0,0,3,0,0,3,0,0
"Poland","2024-03-01",0,0,3,0,0,3,0,0
"Poland","2024-03-02",0,0,3,0,1,4,0,0
"Poland","2024-03-03",0,0,3,0,0,4,0,0
"Poland","2024-03-04",0,0,3,0,0,4,0,0
"Poland","2024-03-05",0,0,3,0,0,4,0,0
"Poland","2024-03-06",0,0,3,0,0,4,0,0
"Poland","2024-03-07",0,0,3,0,0,4,0,0
"Poland","2024-03-08",0,0,3,0,0,4,0,0
"Poland","2024-03-09",0,0,3,0,0,4,0,0
"Poland","2024-03-10",0,0,3,0,0,4,0,0
"Poland","2024-03-11",0,0,3,0,0,4,0,0
"Poland","2024-03-12",0,0,3,0,0,4,0,0
"Poland","2024-03-13",0,0,3,0,0,4,0,0
"Poland","2024-03-14",0,0,3,0,0,4,0,0
"Poland","2024-03-15",0,0,3,0,0,4,0,0
"Poland","2024-03-16",0,0,3,0,0,4,0,0
"Poland","2024-03-17",0,0,3,0,0,4,0,0
"Poland","2024-03-18",0,0,3,0,0,4,0,0
"Poland","2024-03-19",0,0,3,0,0,4,0,0
"Poland","2024-03-20",0,0,3,0,0,4,0,0
"Poland","2024-03-21",0,0,3,0,0,4,0,0
"Poland","2024-03-22",0,0,3,0,0,4,0,0
"Poland","2024-03-23",0,0,3,0,0,4,0,0
"Poland","2024-03-24",0,0,3,0,0,4,0,0
"Poland","2024-03-25",0,0,3,0,0,4,0,0
"Poland","2024-03-26",0,0,3,0,0,4,0,0
"Poland","2024-03-27",0,0,3,0,0,4,0,0
"Poland","2024-03-28",0,0,3,0,0,4,0,0
"Poland","2024-03-29",0,0,3,0,0,4,0,0
"Poland","2024-03-30",0,0,3,0,0,4,0,0
"Poland","2024-03-31",0,1,4,0,0,4,0,0
"Poland","2024-04-01",0,0,4,0,0,4,0,0
"Poland","2024-04-02",0,0,4,0,0,4,0,0
"Poland","2024-04-03",0,0,4,0,0,4,0,0
"Poland","2024-04-04",0,0,4,0,0,4,0,0
"Poland","2024-04-05",0,0,4,0,0,4,0,0
"Poland","2024-04-06",0,0,4,0,0,4,0,0
"Poland","2024-04-07",0,0,4,0,0,4,0,0
"Poland","2024-04-08",0,0,4,0,0,4,0,0
"Poland","2024-04-09",0,0,4,0,0,4,0,0
"Poland","2024-04-10",0,0,4,0,0,4,0,0
"Poland","2024-04-11",0,0,4,0,0,4,0,0
"Poland","2024-04-12",0,0,4,0,0,4,0,0
"Poland","2024-04-13",0,0,4,0,0,4,0,0
"Poland","2024-04-14",0,0,4,0,0,4,0,0
"Poland","2024-04-15",0,0,4,0,0,4,0,0
"Poland","2024-04-16",0,0,4,0,1,5,0,0
"Poland","2024-04-17",0,0,4,0,0,5,0,0
"Poland","2024-04-18",0,0,4,0,0,5,0,0
"Poland","2024-04-19",0,0,4,0,0,5,0,0
"Poland","2024-04-20",0,0,4,0,0,5,0,0
"Poland","2024-04-21",0,0,4,0,0,5,0,0
"Poland","2024-04-22",0,0,4,0,0,5,0,0
"Poland","2024-04-23",0,0,4,0,0,5,0,0
"Poland","2024-04-24",0,0,4,0,0,5,0,0
"Poland","2024-04-25",0,0,4,0,0,5,0,0
"Poland","2024-04-26",0,0,4,0,0,5,0,0
"Poland","2024-04-27",0,0,4,0,0,5,0,0
"Poland","2024-04-28",0,0,4,0,0,5,0,0
"Poland","2024-04-29",0,0,4,0,0,5,0,0
"Poland","2024-04-30",0,0,4,0,0,5,0,0
"Poland","2024-05-01",0,0,4,0,0,5,0,0
"Poland","2024-05-02",0,0,4,0,0,5,0,0
"Poland","2024-05-03",0,0,4,0,0,5,0,0
"Poland","2024-05-04",0,0,4,0,0,5,0,0
"Poland","2024-05-05",0,0,4,0,0,5,0,0
"Poland","2024-05-06",0,0,4,0,0,5,0,0
"Poland","2024-05-07",0,0,4,0,0,5,0,0
"Poland","2024-05-08",0,0,4,0,0,5,0,0
"Poland","2024-05-09",0,0,4,0,0,5,0,0
"Poland","2024-05-10",0,0,4,0,0,5,0,0
"Poland","2024-05-11",0,0,4,0,0,5,0,0
"Poland","2024-05-12",0,0,4,0,0,5,0,0
"Poland","2024-05-13",0,0,4,0,0,5,0,0
"Poland","2024-05-14",0,0,4,0,0,5,0,0
"Poland","2024-05-15",0,0,4,0,0,5,0,0
"Poland","2024-05-16",0,0,4,0,1,6,0,0
"Poland","2024-05-17",0,0,4,0,0,6,0,0
"Poland","2024-05-18",0,0,4,0,0,6,0,0
"Poland","2024-05-19",0,0,4,0,0,6,0,0
"Poland","2024-05-20",0,0,4,0,0,6,0,0
"Poland","2024-05-21",0,0,4,0,0,6,0,0
"Poland","2024-05-22",0,0,4,0,0,6,0,0
"Poland","2024-05-23",0,0,4,0,0,6,0,0
"Poland","2024-05-24",0,0,4,0,0,6,0,0
"Poland","2024-05-25",0,0,4,0,0,6,0,0
"Poland","2024-05-26",0,0,4,0,0,6,0,0
"Poland","2024-05-27",0,0,4,0,0,6,0,0
"Poland","2024-05-28",0,0,4,0,0,6,0,0
"Poland","2024-05-29",0,0,4,0,0,6,0,0
"Poland","2024-05-30",0,0,4,0,0,6,0,0
"Poland","2024-05-31",0,2,6,0,0,6,0,0
"Poland","2024-06-01",0,0,6,0,0,6,0,0
"Poland","2024-06-02",0,0,6,0,0,6,0,0
"Poland","2024-06-03",0,0,6,0,0,6,0,0
"Poland","2024-06-04",0,0,6,0,0,6,0,0
"Poland","2024-06-05",0,0,6,0,0,6,0,0
"Poland","2024-06-06",0,0,6,0,0,6,0,0
"Poland","2024-06-07",0,0,6,0,0,6,0,0
"Poland","2024-06-08",0,0,6,0,0,6,0,0
"Poland","2024-06-09",0,0,6,0,0,6,0,0
"Poland","2024-06-10",0,0,6,0,0,6,0,0
"Poland","2024-06-11",0,0,6,0,0,6,0,0
"Poland","2024-06-12",0,0,6,0,0,6,0,0
"Poland","2024-06-13",0,0,6,0,0,6,0,0
"Poland","2024-06-14",0,0,6,0,0,6,0,0
"Poland","2024-06-15",0,0,6,0,0,6,0,0
"Poland","2024-06-16",0,0,6,0,0,6,0,0
"Poland","2024-06-17",0,0,6,0,0,6,0,0
"Poland","2024-06-18",0,0,6,0,0,6,0,0
"Poland","2024-06-19",0,0,6,0,0,6,0,0
"Poland","2024-06-20",0,0,6,0,0,6,0,0
"Poland","2024-06-21",0,0,6,0,0,6,0,0
"Poland","2024-06-22",0,0,6,0,0,6,0,0
"Poland","2024-06-23",0,0,6,0,0,6,0,0
"Poland","2024-06-24",0,0,6,0,1,7,0,0
"Poland","2024-06-25",0,0,6,0,0,7,0,0
"Poland","2024-06-26",0,0,6,0,0,7,0,0
"Poland","2024-06-27",0,0,6,0,0,7,0,0
"Poland","2024-06-28",0,0,6,0,0,7,0,0
"Poland","2024-06-29",0,0,6,0,0,7,0,0
"Poland","2024-06-30",0,0,6,0,0,7,0,0
"Poland","2024-07-01",0,0,6,0,0,7,0,0
"Poland","2024-07-02",0,0,6,0,0,7,0,0
"Poland","2024-07-03",0,0,6,0,0,7,0,0
"Poland","2024-07-04",0,0,6,0,0,7,0,0
"Poland","2024-07-05",0,0,6,0,0,7,0,0
"Poland","2024-07-06",0,0,6,0,0,7,0,0
"Poland","2024-07-07",0,0,6,0,0,7,0,0
"Poland","2024-07-08",0,0,6,0,0,7,0,0
"Poland","2024-07-09",0,0,6,0,0,7,0,0
"Poland","2024-07-10",0,0,6,0,0,7,0,0
"Poland","2024-07-11",0,0,6,0,0,7,0,0
"Poland","2024-07-12",0,0,6,0,0,7,0,0
"Poland","2024-07-13",0,0,6,0,0,7,0,0
"Poland","2024-07-14",0,0,6,0,0,7,0,0
"Poland","2024-07-15",0,0,6,0,0,7,0,0
"Poland","2024-07-16",0,0,6,0,0,7,0,0
"Poland","2024-07-17",0,0,6,0,0,7,0,0
"Poland","2024-07-18",0,0,6,0,0,7,0,0
"Poland","2024-07-19",0,0,6,0,0,7,0,0
"Poland","2024-07-20",0,0,6,0,0,7,0,0
"Poland","2024-07-21",0,0,6,0,0,7,0,0
"Poland","2024-07-22",0,0,6,0,0,7,0,0
"Poland","2024-07-23",0,0,6,0,0,7,0,0
"Poland","2024-07-24",0,0,6,0,0,7,0,0
"Poland","2024-07-25",0,0,6,0,0,7,0,0
"Poland","2024-07-26",0,0,6,0,0,7,0,0
"Poland","2024-07-27",0,0,6,0,0,7,0,0
"Poland","2024-07-28",0,0,6,0,0,7,0,0
"Poland","2024-07-29",0,0,6,0,0,7,0,0
"Poland","2024-07-30",0,0,6,0,0,7,0,0
"Poland","2024-07-31",0,0,6,0,0,7,0,0
"Poland","2024-08-01",0,0,6,0,0,7,0,0
"Poland","2024-08-02",0,0,6,0,0,7,0,0
"Poland","2024-08-03",0,0,6,0,0,7,0,0
"Poland","2024-08-04",0,0,6,0,0,7,0,0
"Poland","2024-08-05",0,0,6,0,0,7,0,0
"Poland","2024-08-06",0,0,6,0,0,7,0,0
"Poland","2024-08-07",0,0,6,0,0,7,0,0
"Poland","2024-08-08",0,0,6,0,1,8,0,0
"Poland","2024-08-09",0,0,6,0,0,8,0,0
"Poland","2024-08-10",0,0,6,0,0,8,0,0
"Poland","2024-08-11",0,0,6,0,0,8,0,0
"Poland","2024-08-12",0,0,6,0,0,8,0,0
"Poland","2024-08-13",0,0,6,0,0,8,0,0
"Poland","2024-08-14",0,0,6,0,0,8,0,0
"Poland","2024-08-15",0,0,6,0,0,8,0,0
"Poland","2024-08-16",0,0,6,0,0,8,0,0
"Poland","2024-08-17",0,0,6,0,0,8,0,0
"Poland","2024-08-18",0,0,6,0,0,8,0,0
"Poland","2024-08-19",0,0,6,0,0,8,0,0
"Poland","2024-08-20",0,0,6,0,0,8,0,0
"Poland","2024-08-21",0,0,6,0,0,8,0,0
"Poland","2024-08-22",0,0,6,0,0,8,0,0
"Poland","2024-08-23",0,0,6,0,0,8,0,0
"Poland","2024-08-24",0,0,6,0,0,8,0,0
"Poland","2024-08-25",0,0,6,0,0,8,0,0
"Poland","2024-08-26",0,0,6,0,0,8,0,0
"Poland","2024-08-27",0,0,6,0,0,8,0,0
"Poland","2024-08-28",0,0,6,0,0,8,0,0
"Poland","2024-08-29",0,0,6,0,0,8,0,0
"Poland","2024-08-30",0,0,6,0,0,8,0,0
"Poland","2024-08-31",0,2,8,0,0,8,0,0
"Poland","2024-09-01",0,0,8,0,0,8,0,0
"Poland","2024-09-02",0,0,8,0,0,8,0,0
"Poland","2024-09-03",0,0,8,0,0,8,0,0
"Poland","2024-09-04",0,0,8,0,0,8,0,0
"Poland","2024-09-05",0,0,8,0,0,8,0,0
"Poland","2024-09-06",0,0,8,0,0,8,0,0
"Poland","2024-09-07",0,0,8,0,0,8,0,0
"Poland","2024-09-08",0,0,8,0,0,8,0,0
"Poland","2024-09-09",0,0,8,0,0,8,0,0
"Poland","2024-09-10",0,0,8,0,0,8,0,0
"Poland","2024-09-11",0,0,8,0,0,8,0,0
"Poland","2024-09-12",0,0,8,0,0,8,0,0
"Poland","2024-09-13",0,0,8,0,0,8,0,0
"Poland","2024-09-14",0,0,8,0,0,8,0,0
"Poland","2024-09-15",0,0,8,0,0,8,0,0
"Poland","2024-09-16",0,0,8,0,0,8,0,0
"Poland","2024-09-17",0,0,8,0,0,8,0,0
"Poland","2024-09-18",0,0,8,0,0,8,0,0
"Poland","2024-09-19",0,0,8,0,0,8,0,0
"Poland","2024-09-20",0,0,8,0,0,8,0,0
"Poland","2024-09-21",0,0,8,0,0,8,0,0
"Poland","2024-09-22",0,0,8,0,0,8,0,0
"Poland","2024-09-23",0,0,8,0,0,8,0,0
"Poland","2024-09-24",0,0,8,0,0,8,0,0
"Poland","2024-09-25",0,0,8,0,0,8,0,0
"Poland","2024-09-26",0,0,8,0,0,8,0,0
"Poland","2024-09-27",0,0,8,0,0,8,0,0
"Poland","2024-09-28",0,0,8,0,0,8,0,0
"Poland","2024-09-29",0,0,8,0,0,8,0,0
"Poland","2024-09-30",0,0,8,0,0,8,0,0
"Poland","2024-10-01",0,0,8,0,0,8,0,0
"Poland","2024-10-02",0,0,8,0,0,8,0,0
"Poland","2024-10-03",0,0,8,0,0,8,0,0
"Poland","2024-10-04",0,0,8,0,0,8,0,0
"Poland","2024-10-05",0,0,8,0,0,8,0,0
"Poland","2024-10-06",0,0,8,0,0,8,0,0
"Poland","2024-10-07",0,0,8,0,0,8,0,0
"Poland","2024-10-08",0,0,8,0,0,8,0,0
"Poland","2024-10-09",0,0,8,0,0,8,0,0
"Poland","2024-10-10",0,0,8,0,0,8,0,0
"Poland","2024-10-11",0,0,8,0,0,8,0,0
"Poland","2024-10-12",0,0,8,0,0,8,0,0
"Poland","2024-10-13",0,0,8,0,0,8,0,0
"Poland","2024-10-14",0,0,8,0,0,8,0,0
"Poland","2024-10-15",0,0,8,0,0,8,0,0
"Poland","2024-10-16",0,0,8,0,0,8,0,0
"Poland","2024-10-17",0,0,8,0,0,8,0,0
"Poland","2024-10-18",0,0,8,0,0,8,0,0
"Poland","2024-10-19",0,0,8,0,0,8,0,0
"Poland","2024-10-20",0,0,8,0,0,8,0,0
"Poland","2024-10-21",0,0,8,0,0,8,0,0
"Poland","2024-10-22",0,0,8,0,0,8,0,0
"Poland","2024-10-23",0,0,8,0,0,8,0,0
"Poland","2024-10-24",0,0,8,0,0,8,0,0
"Poland","2024-10-25",0,0,8,0,0,8,0,0
"Poland","2024-10-26",0,0,8,0,0,8,0,0
"Poland","2024-10-27",0,0,8,0,0,8,0,0
"Poland","2024-10-28",0,0,8,0,0,8,0,0
"Poland","2024-10-29",0,0,8,0,0,8,0,0
"Poland","2024-10-30",0,0,8,0,0,8,0,0
"Poland","2024-10-31",0,0,8,0,0,8,0,0
"Poland","2024-11-01",0,0,8,0,0,8,0,0
"Poland","2024-11-02",0,0,8,0,0,8,0,0
"Poland","2024-11-03",0,0,8,0,0,8,0,0
"Poland","2024-11-04",0,0,8,0,0,8,0,0
"Poland","2024-11-05",0,0,8,0,0,8,0,0
"Poland","2024-11-06",0,0,8,0,0,8,0,0
"Poland","2024-11-07",0,0,8,0,0,8,0,0
"Poland","2024-11-08",0,0,8,0,0,8,0,0
"Poland","2024-11-09",0,0,8,0,0,8,0,0
"Poland","2024-11-10",0,0,8,0,0,8,0,0
"Poland","2024-11-11",0,0,8,0,0,8,0,0
"Poland","2024-11-12",0,0,8,0,0,8,0,0
"Poland","2024-11-13",0,0,8,0,0,8,0,0
"Poland","2024-11-14",0,0,8,0,0,8,0,0
"Poland","2024-11-15",0,0,8,0,0,8,0,0
"Poland","2024-11-16",0,0,8,0,0,8,0,0
"Poland","2024-11-17",0,0,8,0,0,8,0,0
"Poland","2024-11-18",0,0,8,0,0,8,0,0
"Poland","2024-11-19",0,0,8,0,0,8,0,0
"Poland","2024-11-20",0,0,8,0,0,8,0,0
"Poland","2024-11-21",0,0,8,0,0,8,0,0
"Poland","2024-11-22",0,0,8,0,0,8,0,0
"Poland","2024-11-23",0,0,8,0,0,8,0,0
"Poland","2024-11-24",0,0,8,0,0,8,0,0
"Poland","2024-11-25",0,0,8,0,0,8,0,0
"Poland","2024-11-26",0,0,8,0,0,8,0,0
"Poland","2024-11-27",0,0,8,0,0,8,0,0
"Poland","2024-11-28",0,0,8,0,0,8,0,0
"Poland","2024-11-29",0,0,8,0,0,8,0,0
"Poland","2024-11-30",0,0,8,0,0,8,0,0
"Poland","2024-12-01",0,0,8,0,0,8,0,0
"Poland","2024-12-02",0,0,8,0,0,8,0,0
"Poland","2024-12-03",0,0,8,0,0,8,0,0
"Poland","2024-12-04",0,0,8,0,0,8,0,0
"Poland","2024-12-05",0,0,8,0,0,8,0,0
"Poland","2024-12-06",0,0,8,0,0,8,0,0
"Poland","2024-12-07",0,0,8,0,0,8,0,0
"Poland","2024-12-08",0,0,8,0,0,8,0,0
"Poland","2024-12-09",0,0,8,0,0,8,0,0
"Poland","2024-12-10",0,0,8,0,0,8,0,0
"Poland","2024-12-11",0,0,8,0,0,8,0,0
"Poland","2024-12-12",0,0,8,0,0,8,0,0
"Poland","2024-12-13",0,0,8,0,0,8,0,0
"Poland","2024-12-14",0,0,8,0,0,8,0,0
"Poland","2024-12-15",0,0,8,0,0,8,0,0
"Poland","2024-12-16",0,0,8,0,0,8,0,0
"Poland","2024-12-17",0,0,8,0,0,8,0,0
"Poland","2024-12-18",0,0,8,0,0,8,0,0
"Poland","2024-12-19",0,0,8,0,0,8,0,0
"Poland","2024-12-20",0,0,8,0,0,8,0,0
"Poland","2024-12-21",0,0,8,0,0,8,0,0
"Poland","2024-12-22",0,0,8,0,0,8,0,0
"Poland","2024-12-23",0,0,8,0,0,8,0,0
"Poland","2024-12-24",0,0,8,0,0,8,0,0
"Poland","2024-12-25",0,0,8,0,0,8,0,0
"Poland","2024-12-26",0,0,8,0,0,8,0,0
"Poland","2024-12-27",0,0,8,0,0,8,0,0
"Poland","2024-12-28",0,0,8,0,0,8,0,0
"Poland","2024-12-29",0,0,8,0,0,8,0,0
"Poland","2024-12-30",0,0,8,0,0,8,0,0
"Poland","2024-12-31",0,0,8,0,0,8,0,0
"Poland","2025-01-01",0,0,8,0,0,8,0,0
"Poland","2025-01-02",0,0,8,0,0,8,0,0
"Poland","2025-01-03",0,0,8,0,0,8,0,0
"Poland","2025-01-04",0,0,8,0,0,8,0,0
"Poland","2025-01-05",0,0,8,0,0,8,0,0
"Poland","2025-01-06",0,0,8,0,0,8,0,0
"Poland","2025-01-07",0,0,8,0,0,8,0,0
"Poland","2025-01-08",0,0,8,0,0,8,0,0
"Poland","2025-01-09",0,0,8,0,0,8,0,0
"Poland","2025-01-10",0,0,8,0,0,8,0,0
"Poland","2025-01-11",0,0,8,0,0,8,0,0
"Poland","2025-01-12",0,0,8,0,0,8,0,0
"Poland","2025-01-13",0,0,8,0,0,8,0,0
"Portugal","2024-01-01",0,0,0,0,0,0,0,0
"Portugal","2024-01-02",0,0,0,0,0,0,0,0
"Portugal","2024-01-03",0,0,0,0,0,0,0,0
"Portugal","2024-01-04",0,0,0,0,0,0,0,0
"Portugal","2024-01-05",0,0,0,0,0,0,0,0
"Portugal","2024-01-06",0,0,0,0,0,0,0,0
"Portugal","2024-01-07",0,0,0,0,0,0,0,0
"Portugal","2024-01-08",0,0,0,0,0,0,0,0
"Portugal","2024-01-09",0,0,0,0,0,0,0,0
"Portugal","2024-01-10",0,0,0,0,0,0,0,0
"Portugal","2024-01-11",0,0,0,0,0,0,0,0
"Portugal","2024-01-12",0,0,0,0,0,0,0,0
"Portugal","2024-01-13",0,0,0,0,0,0,0,0
"Portugal","2024-01-14",0,0,0,0,0,0,0,0
"Portugal","2024-01-15",0,0,0,0,0,0,0,0
"Portugal","2024-01-16",0,0,0,0,0,0,0,0
"Portugal","2024-01-17",0,0,0,0,0,0,0,0
"Portugal","2024-01-18",0,0,0,0,0,0,0,0
"Portugal","2024-01-19",0,0,0,0,0,0,0,0
"Portugal","2024-01-20",0,0,0,0,0,0,0,0
"Portugal","2024-01-21",0,0,0,0,0,0,0,0
"Portugal","2024-01-22",0,0,0,0,0,0,0,0
"Portugal","2024-01-23",0,0,0,0,0,0,0,0
"Portugal","2024-01-24",0,0,0,0,0,0,0,0
"Portugal","2024-01-25",0,0,0,0,0,0,0,0
"Portugal","2024-01-26",0,0,0,0,0,0,0,0
"Portugal","2024-01-27",0,0,0,0,0,0,0,0
"Portugal","2024-01-28",0,0,0,0,0,0,0,0
"Portugal","2024-01-29",0,0,0,0,0,0,0,0
"Portugal","2024-01-30",0,0,0,0,0,0,0,0
"Portugal","2024-01-31",0,24,24,0,24,24,0,0
"Portugal","2024-02-01",0,0,24,0,0,24,0,0
"Portugal","2024-02-02",0,0,24,0,0,24,0,0
"Portugal","2024-02-03",0,0,24,0,0,24,0,0
"Portugal","2024-02-04",0,0,24,0,1,25,0,0
"Portugal","2024-02-05",0,0,24,0,0,25,0,0
"Portugal","2024-02-06",0,0,24,0,0,25,0,0
"Portugal","2024-02-07",0,0,24,0,0,25,0,0
"Portugal","2024-02-08",0,0,24,0,0,25,0,0
"Portugal","2024-02-09",0,0,24,0,0,25,0,0
"Portugal","2024-02-10",0,0,24,0,0,25,0,0
"Portugal","2024-02-11",0,0,24,0,1,26,0,0
"Portugal","2024-02-12",0,0,24,0,0,26,0,0
"Portugal","2024-02-13",0,0,24,0,0,26,0,0
"Portugal","2024-02-14",0,0,24,0,0,26,0,0
"Portugal","2024-02-15",0,0,24,0,0,26,0,0
"Portugal","2024-02-16",0,0,24,0,0,26,0,0
"Portugal","2024-02-17",0,0,24,0,0,26,0,0
"Portugal","2024-02-18",0,0,24,0,0,26,0,0
"Portugal","2024-02-19",0,0,24,0,1,27,0,0
"Portugal","2024-02-20",0,0,24,0,0,27,0,0
"Portugal","2024-02-21",0,0,24,0,0,27,0,0
"Portugal","2024-02-22",0,0,24,0,0,27,0,0
"Portugal","2024-02-23",0,0,24,0,0,27,0,0
"Portugal","2024-02-24",0,0,24,0,0,27,0,0
"Portugal","2024-02-25",0,0,24,0,0,27,0,0
"Portugal","2024-02-26",0,0,24,0,1,28,0,0
"Portugal","2024-02-27",0,0,24,0,0,28,0,0
"Portugal","2024-02-28",0,0,24,0,0,28,0,0
"Portugal","2024-02-29",0,4,28,0,0,28,0,0
"Portugal","2024-03-01",0,0,28,0,0,28,0,0
"Portugal","2024-03-02",0,0,28,0,0,28,0,0
"Portugal","2024-03-03",0,0,28,0,0,28,0,0
"Portugal","2024-03-04",0,0,28,0,0,28,0,0
"Portugal","2024-03-05",0,0,28,0,0,28,0,0
"Portugal","2024-03-06",0,0,28,0,1,29,0,0
"Portugal","2024-03-07",0,0,28,0,0,29,0,0
"Portugal","2024-03-08",0,0,28,0,0,29,0,0
"Portugal","2024-03-09",0,0,28,0,0,29,0,0
"Portugal","2024-03-10",0,0,28,0,0,29,0,0
"Portugal","2024-03-11",0,0,28,0,0,29,0,0
"Portugal","2024-03-12",0,0,28,0,0,29,0,0
"Portugal","2024-03-13",0,0,28,0,0,29,0,0
"Portugal","2024-03-14",0,0,28,0,0,29,0,0
"Portugal","2024-03-15",0,0,28,0,0,29,0,0
"Portugal","2024-03-16",0,0,28,0,1,30,0,0
"Portugal","2024-03-17",0,0,28,0,0,30,0,0
"Portugal","2024-03-18",0,0,28,0,0,30,0,0
"Portugal","2024-03-19",0,0,28,0,0,30,0,0
"Portugal","2024-03-20",0,0,28,0,0,30,0,0
"Portugal","2024-03-21",0,0,28,0,0,30,0,0
"Portugal","2024-03-22",0,0,28,0,0,30,0,0
"Portugal","2024-03-23",0,0,28,0,0,30,0,0
"Portugal","2024-03-24",0,0,28,0,0,30,0,0
"Portugal","2024-03-25",0,0,28,0,0,30,0,0
"Portugal","2024-03-26",0,0,28,0,1,31,0,0
"Portugal","2024-03-27",0,0,28,0,0,31,0,0
"Portugal","2024-03-28",0,0,28,0,0,31,0,0
"Portugal","2024-03-29",0,0,28,0,0,31,0,0
"Portugal","2024-03-30",0,0,28,0,0,31,0,0
"Portugal","2024-03-31",0,3,31,0,0,31,0,0
"Portugal","2024-04-01",0,0,31,0,0,31,0,0
"Portugal","2024-04-02",0,0,31,0,0,31,0,0
"Portugal","2024-04-03",0,0,31,0,0,31,0,0
"Portugal","2024-04-04",0,0,31,0,0,31,0,0
"Portugal","2024-04-05",0,0,31,0,0,31,0,0
"Portugal","2024-04-06",0,0,31,0,0,31,0,0
"Portugal","2024-04-07",0,0,31,0,0,31,0,0
"Portugal","2024-04-08",0,0,31,0,0,31,0,0
"Portugal","2024-04-09",0,0,31,0,0,31,0,0
"Portugal","2024-04-10",0,0,31,0,0,31,0,0
"Portugal","2024-04-11",0,0,31,0,0,31,0,0
"Portugal","2024-04-12",0,0,31,0,0,31,0,0
"Portugal","2024-04-13",0,0,31,0,0,31,0,0
"Portugal","2024-04-14",0,0,31,0,0,31,0,0
"Portugal","2024-04-15",0,0,31,0,0,31,0,0
"Portugal","2024-04-16",0,0,31,0,0,31,0,0
"Portugal","2024-04-17",0,0,31,0,0,31,0,0
"Portugal","2024-04-18",0,0,31,0,0,31,0,0
"Portugal","2024-04-19",0,0,31,0,0,31,0,0
"Portugal","2024-04-20",0,0,31,0,0,31,0,0
"Portugal","2024-04-21",0,0,31,0,1,32,0,0
"Portugal","2024-04-22",0,0,31,0,0,32,0,0
"Portugal","2024-04-23",0,0,31,0,0,32,0,0
"Portugal","2024-04-24",0,0,31,0,0,32,0,0
"Portugal","2024-04-25",0,0,31,0,0,32,0,0
"Portugal","2024-04-26",0,0,31,0,0,32,0,0
"Portugal","2024-04-27",0,0,31,0,0,32,0,0
"Portugal","2024-04-28",0,0,31,0,0,32,0,0
"Portugal","2024-04-29",0,0,31,0,0,32,0,0
"Portugal","2024-04-30",0,0,31,0,0,32,0,0
"Portugal","2024-05-01",0,0,31,0,0,32,0,0
"Portugal","2024-05-02",0,0,31,0,0,32,0,0
"Portugal","2024-05-03",0,0,31,0,0,32,0,0
"Portugal","2024-05-04",0,0,31,0,0,32,0,0
"Portugal","2024-05-05",0,0,31,0,0,32,0,0
"Portugal","2024-05-06",0,0,31,0,0,32,0,0
"Portugal","2024-05-07",0,0,31,0,0,32,0,0
"Portugal","2024-05-08",0,0,31,0,0,32,0,0
"Portugal","2024-05-09",0,0,31,0,0,32,0,0
"Portugal","2024-05-10",0,0,31,0,0,32,0,0
"Portugal","2024-05-11",0,0,31,0,0,32,0,0
"Portugal","2024-05-12",0,0,31,0,0,32,0,0
"Portugal","2024-05-13",0,0,31,0,0,32,0,0
"Portugal","2024-05-14",0,0,31,0,0,32,0,0
"Portugal","2024-05-15",0,0,31,0,0,32,0,0
"Portugal","2024-05-16",0,0,31,0,0,32,0,0
"Portugal","2024-05-17",0,0,31,0,0,32,0,0
"Portugal","2024-05-18",0,0,31,0,0,32,0,0
"Portugal","2024-05-19",0,0,31,0,0,32,0,0
"Portugal","2024-05-20",0,0,31,0,0,32,0,0
"Portugal","2024-05-21",0,0,31,0,0,32,0,0
"Portugal","2024-05-22",0,0,31,0,0,32,0,0
"Portugal","2024-05-23",0,0,31,0,0,32,0,0
"Portugal","2024-05-24",0,0,31,0,0,32,0,0
"Portugal","2024-05-25",0,0,31,0,0,32,0,0
"Portugal","2024-05-26",0,0,31,0,0,32,0,0
"Portugal","2024-05-27",0,0,31,0,0,32,0,0
"Portugal","2024-05-28",0,0,31,0,0,32,0,0
"Portugal","2024-05-29",0,0,31,0,0,32,0,0
"Portugal","2024-05-30",0,0,31,0,0,32,0,0
"Portugal","2024-05-31",0,0,31,0,1,33,0,0
"Portugal","2024-06-01",0,0,31,0,0,33,0,0
"Portugal","2024-06-02",0,0,31,0,0,33,0,0
"Portugal","2024-06-03",0,0,31,0,0,33,0,0
"Portugal","2024-06-04",0,0,31,0,0,33,0,0
"Portugal","2024-06-05",0,0,31,0,0,33,0,0
"Portugal","2024-06-06",0,0,31,0,0,33,0,0
"Portugal","2024-06-07",0,0,31,0,0,33,0,0
"Portugal","2024-06-08",0,0,31,0,0,33,0,0
"Portugal","2024-06-09",0,0,31,0,0,33,0,0
"Portugal","2024-06-10",0,0,31,0,0,33,0,0
"Portugal","2024-06-11",0,0,31,0,0,33,0,0
"Portugal","2024-06-12",0,0,31,0,0,33,0,0
"Portugal","2024-06-13",0,0,31,0,0,33,0,0
"Portugal","2024-06-14",0,0,31,0,0,33,0,0
"Portugal","2024-06-15",0,0,31,0,0,33,0,0
"Portugal","2024-06-16",0,0,31,0,0,33,0,0
"Portugal","2024-06-17",0,0,31,0,0,33,0,0
"Portugal","2024-06-18",0,0,31,0,0,33,0,0
"Portugal","2024-06-19",0,0,31,0,0,33,0,0
"Portugal","2024-06-20",0,0,31,0,0,33,0,0
"Portugal","2024-06-21",0,0,31,0,0,33,0,0
"Portugal","2024-06-22",0,0,31,0,0,33,0,0
"Portugal","2024-06-23",0,0,31,0,0,33,0,0
"Portugal","2024-06-24",0,0,31,0,0,33,0,0
"Portugal","2024-06-25",0,0,31,0,0,33,0,0
"Portugal","2024-06-26",0,0,31,0,0,33,0,0
"Portugal","2024-06-27",0,0,31,0,0,33,0,0
"Portugal","2024-06-28",0,0,31,0,0,33,0,0
"Portugal","2024-06-29",0,0,31,0,0,33,0,0
"Portugal","2024-06-30",0,0,31,0,0,33,0,0
"Portugal","2024-07-01",0,0,31,0,0,33,0,0
"Portugal","2024-07-02",0,0,31,0,0,33,0,0
"Portugal","2024-07-03",0,0,31,0,0,33,0,0
"Portugal","2024-07-04",0,0,31,0,0,33,0,0
"Portugal","2024-07-05",0,0,31,0,0,33,0,0
"Portugal","2024-07-06",0,0,31,0,0,33,0,0
"Portugal","2024-07-07",0,0,31,0,0,33,0,0
"Portugal","2024-07-08",0,0,31,0,0,33,0,0
"Portugal","2024-07-09",0,0,31,0,0,33,0,0
"Portugal","2024-07-10",0,0,31,0,0,33,0,0
"Portugal","2024-07-11",0,0,31,0,1,34,0,0
"Portugal","2024-07-12",0,0,31,0,0,34,0,0
"Portugal","2024-07-13",0,0,31,0,0,34,0,0
"Portugal","2024-07-14",0,0,31,0,0,34,0,0
"Portugal","2024-07-15",0,0,31,0,0,34,0,0
"Portugal","2024-07-16",0,0,31,0,0,34,0,0
"Portugal","2024-07-17",0,0,31,0,0,34,0,0
"Portugal","2024-07-18",0,0,31,0,0,34,0,0
"Portugal","2024-07-19",0,0,31,0,0,34,0,0
"Portugal","2024-07-20",0,0,31,0,0,34,0,0
"Portugal","2024-07-21",0,0,31,0,0,34,0,0
"Portugal","2024-07-22",0,0,31,0,0,34,0,0
"Portugal","2024-07-23",0,0,31,0,0,34,0,0
"Portugal","2024-07-24",0,0,31,0,0,34,0,0
"Portugal","2024-07-25",0,0,31,0,0,34,0,0
"Portugal","2024-07-26",0,0,31,0,0,34,0,0
"Portugal","2024-07-27",0,0,31,0,0,34,0,0
"Portugal","2024-07-28",0,0,31,0,0,34,0,0
"Portugal","2024-07-29",0,0,31,0,0,34,0,0
"Portugal","2024-07-30",0,0,31,0,0,34,0,0
"Portugal","2024-07-31",0,3,34,0,0,34,0,0
"Portugal","2024-08-01",0,0,34,0,0,34,0,0
"Portugal","2024-08-02",0,0,34,0,1,35,0,0
"Portugal","2024-08-03",0,0,34,0,0,35,0,0
"Portugal","2024-08-04",0,0,34,0,0,35,0,0
"Portugal","2024-08-05",0,0,34,0,1,36,0,0
"Portugal","2024-08-06",0,0,34,0,0,36,0,0
"Portugal","2024-08-07",0,0,34,0,0,36,0,0
"Portugal","2024-08-08",0,0,34,0,1,37,0,0
"Portugal","2024-08-09",0,0,34,0,0,37,0,0
"Portugal","2024-08-10",0,0,34,0,0,37,0,0
"Portugal","2024-08-11",0,0,34,0,1,38,0,0
"Portugal","2024-08-12",0,0,34,0,0,38,0,0
"Portugal","2024-08-13",0,0,34,0,0,38,0,0
"Portugal","2024-08-14",0,0,34,0,1,39,0,0
"Portugal","2024-08-15",0,0,34,0,0,39,0,0
"Portugal","2024-08-16",0,0,34,0,0,39,0,0
"Portugal","2024-08-17",0,0,34,0,0,39,0,0
"Portugal","2024-08-18",0,0,34,0,1,40,0,0
"Portugal","2024-08-19",0,0,34,0,0,40,0,0
"Portugal","2024-08-20",0,0,34,0,0,40,0,0
"Portugal","2024-08-21",0,0,34,0,1,41,0,0
"Portugal","2024-08-22",0,0,34,0,0,41,0,0
"Portugal","2024-08-23",0,0,34,0,0,41,0,0
"Portugal","2024-08-24",0,0,34,0,1,42,0,0
"Portugal","2024-08-25",0,0,34,0,0,42,0,0
"Portugal","2024-08-26",0,0,34,0,0,42,0,0
"Portugal","2024-08-27",0,0,34,0,1,43,0,0
"Portugal","2024-08-28",0,0,34,0,0,43,0,0
"Portugal","2024-08-29",0,0,34,0,0,43,0,0
"Portugal","2024-08-30",0,0,34,0,1,44,0,0
"Portugal","2024-08-31",0,10,44,0,0,44,0,0
"Portugal","2024-09-01",0,0,44,0,1,45,0,0
"Portugal","2024-09-02",0,0,44,0,0,45,0,0
"Portugal","2024-09-03",0,0,44,0,1,46,0,0
"Portugal","2024-09-04",0,0,44,0,1,47,0,0
"Portugal","2024-09-05",0,0,44,0,1,48,0,0
"Portugal","2024-09-06",0,0,44,0,0,48,0,0
"Portugal","2024-09-07",0,0,44,0,1,49,0,0
"Portugal","2024-09-08",0,0,44,0,1,50,0,0
"Portugal","2024-09-09",0,0,44,0,0,50,0,0
"Portugal","2024-09-10",0,0,44,0,1,51,0,0
"Portugal","2024-09-11",0,0,44,0,1,52,0,0
"Portugal","2024-09-12",0,0,44,0,0,52,0,0
"Portugal","2024-09-13",0,0,44,0,1,53,0,0
"Portugal","2024-09-14",0,0,44,0,1,54,0,0
"Portugal","2024-09-15",0,0,44,0,0,54,0,0
"Portugal","2024-09-16",0,0,44,0,1,55,0,0
"Portugal","2024-09-17",0,0,44,0,1,56,0,0
"Portugal","2024-09-18",0,0,44,0,1,57,0,0
"Portugal","2024-09-19",0,0,44,0,0,57,0,0
"Portugal","2024-09-20",0,0,44,0,1,58,0,0
"Portugal","2024-09-21",0,0,44,0,1,59,0,0
"Portugal","2024-09-22",0,0,44,0,0,59,0,0
"Portugal","2024-09-23",0,0,44,0,1,60,0,0
"Portugal","2024-09-24",0,0,44,0,1,61,0,0
"Portugal","2024-09-25",0,0,44,0,1,62,0,0
"Portugal","2024-09-26",0,0,44,0,0,62,0,0
"Portugal","2024-09-27",0,0,44,0,1,63,0,0
"Portugal","2024-09-28",0,0,44,0,1,64,0,0
"Portugal","2024-09-29",0,0,44,0,0,64,0,0
"Portugal","2024-09-30",0,21,65,0,1,65,0,0
"Portugal","2024-10-01",0,0,65,0,0,65,0,0
"Portugal","2024-10-02",0,0,65,0,0,65,0,0
"Portugal","2024-10-03",0,0,65,0,0,65,0,0
"Portugal","2024-10-04",0,0,65,0,0,65,0,0
"Portugal","2024-10-05",0,0,65,0,0,65,0,0
"Portugal","2024-10-06",0,0,65,0,0,65,0,0
"Portugal","2024-10-07",0,0,65,0,0,65,0,0
"Portugal","2024-10-08",0,0,65,0,0,65,0,0
"Portugal","2024-10-09",0,0,65,0,0,65,0,0
"Portugal","2024-10-10",0,0,65,0,0,65,0,0
"Portugal","2024-10-11",0,0,65,0,0,65,0,0
"Portugal","2024-10-12",0,0,65,0,0,65,0,0
"Portugal","2024-10-13",0,0,65,0,0,65,0,0
"Portugal","2024-10-14",0,0,65,0,0,65,0,0
"Portugal","2024-10-15",0,0,65,0,0,65,0,0
"Portugal","2024-10-16",0,0,65,0,0,65,0,0
"Portugal","2024-10-17",0,0,65,0,0,65,0,0
"Portugal","2024-10-18",0,0,65,0,0,65,0,0
"Portugal","2024-10-19",0,0,65,0,0,65,0,0
"Portugal","2024-10-20",0,0,65,0,0,65,0,0
"Portugal","2024-10-21",0,0,65,0,0,65,0,0
"Portugal","2024-10-22",0,0,65,0,0,65,0,0
"Portugal","2024-10-23",0,0,65,0,0,65,0,0
"Portugal","2024-10-24",0,0,65,0,0,65,0,0
"Portugal","2024-10-25",0,0,65,0,0,65,0,0
"Portugal","2024-10-26",0,0,65,0,0,65,0,0
"Portugal","2024-10-27",0,0,65,0,0,65,0,0
"Portugal","2024-10-28",0,0,65,0,0,65,0,0
"Portugal","2024-10-29",0,0,65,0,0,65,0,0
"Portugal","2024-10-30",0,0,65,0,0,65,0,0
"Portugal","2024-10-31",0,0,65,0,0,65,0,0
"Portugal","2024-11-01",0,0,65,0,0,65,0,0
"Portugal","2024-11-02",0,0,65,0,0,65,0,0
"Portugal","2024-11-03",0,0,65,0,0,65,0,0
"Portugal","2024-11-04",0,0,65,0,0,65,0,0
"Portugal","2024-11-05",0,0,65,0,0,65,0,0
"Portugal","2024-11-06",0,0,65,0,0,65,0,0
"Portugal","2024-11-07",0,0,65,0,0,65,0,0
"Portugal","2024-11-08",0,0,65,0,0,65,0,0
"Portugal","2024-11-09",0,0,65,0,0,65,0,0
"Portugal","2024-11-10",0,0,65,0,0,65,0,0
"Portugal","2024-11-11",0,0,65,0,0,65,0,0
"Portugal","2024-11-12",0,0,65,0,0,65,0,0
"Portugal","2024-11-13",0,0,65,0,0,65,0,0
"Portugal","2024-11-14",0,0,65,0,0,65,0,0
"Portugal","2024-11-15",0,0,65,0,0,65,0,0
"Portugal","2024-11-16",0,0,65,0,0,65,0,0
"Portugal","2024-11-17",0,0,65,0,0,65,0,0
"Portugal","2024-11-18",0,0,65,0,0,65,0,0
"Portugal","2024-11-19",0,0,65,0,0,65,0,0
"Portugal","2024-11-20",0,0,65,0,0,65,0,0
"Portugal","2024-11-21",0,0,65,0,0,65,0,0
"Portugal","2024-11-22",0,0,65,0,0,65,0,0
"Portugal","2024-11-23",0,0,65,0,0,65,0,0
"Portugal","2024-11-24",0,0,65,0,0,65,0,0
"Portugal","2024-11-25",0,0,65,0,0,65,0,0
"Portugal","2024-11-26",0,0,65,0,0,65,0,0
"Portugal","2024-11-27",0,0,65,0,0,65,0,0
"Portugal","2024-11-28",0,0,65,0,0,65,0,0
"Portugal","2024-11-29",0,0,65,0,0,65,0,0
"Portugal","2024-11-30",0,0,65,0,0,65,0,0
"Portugal","2024-12-01",0,0,65,0,0,65,0,0
"Portugal","2024-12-02",0,0,65,0,0,65,0,0
"Portugal","2024-12-03",0,0,65,0,0,65,0,0
"Portugal","2024-12-04",0,0,65,0,0,65,0,0
"Portugal","2024-12-05",0,0,65,0,0,65,0,0
"Portugal","2024-12-06",0,0,65,0,0,65,0,0
"Portugal","2024-12-07",0,0,65,0,0,65,0,0
"Portugal","2024-12-08",0,0,65,0,0,65,0,0
"Portugal","2024-12-09",0,0,65,0,0,65,0,0
"Portugal","2024-12-10",0,0,65,0,0,65,0,0
"Portugal","2024-12-11",0,0,65,0,0,65,0,0
"Portugal","2024-12-12",0,0,65,0,0,65,0,0
"Portugal","2024-12-13",0,0,65,0,0,65,0,0
"Portugal","2024-12-14",0,0,65,0,0,65,0,0
"Portugal","2024-12-15",0,0,65,0,0,65,0,0
"Portugal","2024-12-16",0,0,65,0,0,65,0,0
"Portugal","2024-12-17",0,0,65,0,0,65,0,0
"Portugal","2024-12-18",0,0,65,0,0,65,0,0
"Portugal","2024-12-19",0,0,65,0,0,65,0,0
"Portugal","2024-12-20",0,0,65,0,0,65,0,0
"Portugal","2024-12-21",0,0,65,0,0,65,0,0
"Portugal","2024-12-22",0,0,65,0,0,65,0,0
"Portugal","2024-12-23",0,0,65,0,0,65,0,0
"Portugal","2024-12-24",0,0,65,0,0,65,0,0
"Portugal","2024-12-25",0,0,65,0,0,65,0,0
"Portugal","2024-12-26",0,0,65,0,0,65,0,0
"Portugal","2024-12-27",0,0,65,0,0,65,0,0
"Portugal","2024-12-28",0,0,65,0,0,65,0,0
"Portugal","2024-12-29",0,0,65,0,0,65,0,0
"Portugal","2024-12-30",0,0,65,0,0,65,0,0
"Portugal","2024-12-31",0,0,65,0,0,65,0,0
"Portugal","2025-01-01",0,0,65,0,0,65,0,0
"Portugal","2025-01-02",0,0,65,0,0,65,0,0
"Portugal","2025-01-03",0,0,65,0,0,65,0,0
"Portugal","2025-01-04",0,0,65,0,0,65,0,0
"Portugal","2025-01-05",0,0,65,0,0,65,0,0
"Portugal","2025-01-06",0,0,65,0,0,65,0,0
"Portugal","2025-01-07",0,0,65,0,0,65,0,0
"Portugal","2025-01-08",0,0,65,0,0,65,0,0
"Portugal","2025-01-09",0,0,65,0,0,65,0,0
"Portugal","2025-01-10",0,0,65,0,0,65,0,0
"Portugal","2025-01-11",0,0,65,0,0,65,0,0
"Portugal","2025-01-12",0,0,65,0,0,65,0,0
"Portugal","2025-01-13",0,0,65,0,0,65,0,0
"Romania","2024-01-01",0,0,0,0,0,0,0,0
"Romania","2024-01-02",0,0,0,0,0,0,0,0
"Romania","2024-01-03",0,0,0,0,0,0,0,0
"Romania","2024-01-04",0,0,0,0,0,0,0,0
"Romania","2024-01-05",0,0,0,0,0,0,0,0
"Romania","2024-01-06",0,0,0,0,0,0,0,0
"Romania","2024-01-07",0,0,0,0,0,0,0,0
"Romania","2024-01-08",0,0,0,0,0,0,0,0
"Romania","2024-01-09",0,0,0,0,0,0,0,0
"Romania","2024-01-10",0,0,0,0,0,0,0,0
"Romania","2024-01-11",0,0,0,0,0,0,0,0
"Romania","2024-01-12",0,0,0,0,0,0,0,0
"Romania","2024-01-13",0,0,0,0,0,0,0,0
"Romania","2024-01-14",0,0,0,0,0,0,0,0
"Romania","2024-01-15",0,0,0,0,0,0,0,0
"Romania","2024-01-16",0,0,0,0,0,0,0,0
"Romania","2024-01-17",0,0,0,0,0,0,0,0
"Romania","2024-01-18",0,0,0,0,0,0,0,0
"Romania","2024-01-19",0,0,0,0,0,0,0,0
"Romania","2024-01-20",0,0,0,0,0,0,0,0
"Romania","2024-01-21",0,0,0,0,0,0,0,0
"Romania","2024-01-22",0,0,0,0,0,0,0,0
"Romania","2024-01-23",0,0,0,0,0,0,0,0
"Romania","2024-01-24",0,0,0,0,0,0,0,0
"Romania","2024-01-25",0,0,0,0,0,0,0,0
"Romania","2024-01-26",0,0,0,0,0,0,0,0
"Romania","2024-01-27",0,0,0,0,0,0,0,0
"Romania","2024-01-28",0,0,0,0,0,0,0,0
"Romania","2024-01-29",0,0,0,0,0,0,0,0
"Romania","2024-01-30",0,0,0,0,0,0,0,0
"Romania","2024-01-31",0,0,0,0,0,0,0,0
"Romania","2024-02-01",0,0,0,0,0,0,0,0
"Romania","2024-02-02",0,0,0,0,0,0,0,0
"Romania","2024-02-03",0,0,0,0,0,0,0,0
"Romania","2024-02-04",0,0,0,0,0,0,0,0
"Romania","2024-02-05",0,0,0,0,0,0,0,0
"Romania","2024-02-06",0,0,0,0,0,0,0,0
"Romania","2024-02-07",0,0,0,0,0,0,0,0
"Romania","2024-02-08",0,0,0,0,0,0,0,0
"Romania","2024-02-09",0,0,0,0,0,0,0,0
"Romania","2024-02-10",0,0,0,0,0,0,0,0
"Romania","2024-02-11",0,0,0,0,0,0,0,0
"Romania","2024-02-12",0,0,0,0,0,0,0,0
"Romania","2024-02-13",0,0,0,0,0,0,0,0
"Romania","2024-02-14",0,0,0,0,0,0,0,0
"Romania","2024-02-15",0,0,0,0,0,0,0,0
"Romania","2024-02-16",0,0,0,0,0,0,0,0
"Romania","2024-02-17",0,0,0,0,0,0,0,0
"Romania","2024-02-18",0,0,0,0,0,0,0,0
"Romania","2024-02-19",0,0,0,0,0,0,0,0
"Romania","2024-02-20",0,0,0,0,0,0,0,0
"Romania","2024-02-21",0,0,0,0,0,0,0,0
"Romania","2024-02-22",0,0,0,0,0,0,0,0
"Romania","2024-02-23",0,0,0,0,0,0,0,0
"Romania","2024-02-24",0,0,0,0,0,0,0,0
"Romania","2024-02-25",0,0,0,0,0,0,0,0
"Romania","2024-02-26",0,0,0,0,0,0,0,0
"Romania","2024-02-27",0,0,0,0,0,0,0,0
"Romania","2024-02-28",0,0,0,0,0,0,0,0
"Romania","2024-02-29",0,0,0,0,0,0,0,0
"Romania","2024-03-01",0,0,0,0,0,0,0,0
"Romania","2024-03-02",0,0,0,0,0,0,0,0
"Romania","2024-03-03",0,0,0,0,0,0,0,0
"Romania","2024-03-04",0,0,0,0,0,0,0,0
"Romania","2024-03-05",0,0,0,0,0,0,0,0
"Romania","2024-03-06",0,0,0,0,0,0,0,0
"Romania","2024-03-07",0,0,0,0,0,0,0,0
"Romania","2024-03-08",0,0,0,0,0,0,0,0
"Romania","2024-03-09",0,0,0,0,0,0,0,0
"Romania","2024-03-10",0,0,0,0,0,0,0,0
"Romania","2024-03-11",0,0,0,0,0,0,0,0
"Romania","2024-03-12",0,0,0,0,0,0,0,0
"Romania","2024-03-13",0,0,0,0,0,0,0,0
"Romania","2024-03-14",0,0,0,0,0,0,0,0
"Romania","2024-03-15",0,0,0,0,0,0,0,0
"Romania","2024-03-16",0,0,0,0,0,0,0,0
"Romania","2024-03-17",0,0,0,0,0,0,0,0
"Romania","2024-03-18",0,0,0,0,0,0,0,0
"Romania","2024-03-19",0,0,0,0,0,0,0,0
"Romania","2024-03-20",0,0,0,0,0,0,0,0
"Romania","2024-03-21",0,0,0,0,0,0,0,0
"Romania","2024-03-22",0,0,0,0,0,0,0,0
"Romania","2024-03-23",0,0,0,0,0,0,0,0
"Romania","2024-03-24",0,0,0,0,0,0,0,0
"Romania","2024-03-25",0,0,0,0,0,0,0,0
"Romania","2024-03-26",0,0,0,0,0,0,0,0
"Romania","2024-03-27",0,0,0,0,0,0,0,0
"Romania","2024-03-28",0,0,0,0,0,0,0,0
"Romania","2024-03-29",0,0,0,0,0,0,0,0
"Romania","2024-03-30",0,0,0,0,0,0,0,0
"Romania","2024-03-31",0,0,0,0,0,0,0,0
"Romania","2024-04-01",0,0,0,0,0,0,0,0
"Romania","2024-04-02",0,0,0,0,0,0,0,0
"Romania","2024-04-03",0,0,0,0,0,0,0,0
"Romania","2024-04-04",0,0,0,0,0,0,0,0
"Romania","2024-04-05",0,0,0,0,0,0,0,0
"Romania","2024-04-06",0,0,0,0,0,0,0,0
"Romania","2024-04-07",0,0,0,0,0,0,0,0
"Romania","2024-04-08",0,0,0,0,0,0,0,0
"Romania","2024-04-09",0,0,0,0,0,0,0,0
"Romania","2024-04-10",0,0,0,0,0,0,0,0
"Romania","2024-04-11",0,0,0,0,0,0,0,0
"Romania","2024-04-12",0,0,0,0,0,0,0,0
"Romania","2024-04-13",0,0,0,0,0,0,0,0
"Romania","2024-04-14",0,0,0,0,0,0,0,0
"Romania","2024-04-15",0,0,0,0,0,0,0,0
"Romania","2024-04-16",0,0,0,0,0,0,0,0
"Romania","2024-04-17",0,0,0,0,0,0,0,0
"Romania","2024-04-18",0,0,0,0,0,0,0,0
"Romania","2024-04-19",0,0,0,0,0,0,0,0
"Romania","2024-04-20",0,0,0,0,0,0,0,0
"Romania","2024-04-21",0,0,0,0,0,0,0,0
"Romania","2024-04-22",0,0,0,0,0,0,0,0
"Romania","2024-04-23",0,0,0,0,0,0,0,0
"Romania","2024-04-24",0,0,0,0,0,0,0,0
"Romania","2024-04-25",0,0,0,0,0,0,0,0
"Romania","2024-04-26",0,0,0,0,0,0,0,0
"Romania","2024-04-27",0,0,0,0,0,0,0,0
"Romania","2024-04-28",0,0,0,0,0,0,0,0
"Romania","2024-04-29",0,0,0,0,0,0,0,0
"Romania","2024-04-30",0,0,0,0,0,0,0,0
"Romania","2024-05-01",0,0,0,0,0,0,0,0
"Romania","2024-05-02",0,0,0,0,0,0,0,0
"Romania","2024-05-03",0,0,0,0,0,0,0,0
"Romania","2024-05-04",0,0,0,0,0,0,0,0
"Romania","2024-05-05",0,0,0,0,0,0,0,0
"Romania","2024-05-06",0,0,0,0,0,0,0,0
"Romania","2024-05-07",0,0,0,0,0,0,0,0
"Romania","2024-05-08",0,0,0,0,0,0,0,0
"Romania","2024-05-09",0,0,0,0,0,0,0,0
"Romania","2024-05-10",0,0,0,0,0,0,0,0
"Romania","2024-05-11",0,0,0,0,0,0,0,0
"Romania","2024-05-12",0,0,0,0,0,0,0,0
"Romania","2024-05-13",0,0,0,0,0,0,0,0
"Romania","2024-05-14",0,0,0,0,0,0,0,0
"Romania","2024-05-15",0,0,0,0,0,0,0,0
"Romania","2024-05-16",0,0,0,0,0,0,0,0
"Romania","2024-05-17",0,0,0,0,0,0,0,0
"Romania","2024-05-18",0,0,0,0,0,0,0,0
"Romania","2024-05-19",0,0,0,0,0,0,0,0
"Romania","2024-05-20",0,0,0,0,0,0,0,0
"Romania","2024-05-21",0,0,0,0,0,0,0,0
"Romania","2024-05-22",0,0,0,0,0,0,0,0
"Romania","2024-05-23",0,0,0,0,0,0,0,0
"Romania","2024-05-24",0,0,0,0,0,0,0,0
"Romania","2024-05-25",0,0,0,0,0,0,0,0
"Romania","2024-05-26",0,0,0,0,0,0,0,0
"Romania","2024-05-27",0,0,0,0,0,0,0,0
"Romania","2024-05-28",0,0,0,0,0,0,0,0
"Romania","2024-05-29",0,0,0,0,0,0,0,0
"Romania","2024-05-30",0,0,0,0,0,0,0,0
"Romania","2024-05-31",0,0,0,0,0,0,0,0
"Romania","2024-06-01",0,0,0,0,0,0,0,0
"Romania","2024-06-02",0,0,0,0,0,0,0,0
"Romania","2024-06-03",0,0,0,0,0,0,0,0
"Romania","2024-06-04",0,0,0,0,0,0,0,0
"Romania","2024-06-05",0,0,0,0,0,0,0,0
"Romania","2024-06-06",0,0,0,0,0,0,0,0
"Romania","2024-06-07",0,0,0,0,0,0,0,0
"Romania","2024-06-08",0,0,0,0,0,0,0,0
"Romania","2024-06-09",0,0,0,0,0,0,0,0
"Romania","2024-06-10",0,0,0,0,0,0,0,0
"Romania","2024-06-11",0,0,0,0,0,0,0,0
"Romania","2024-06-12",0,0,0,0,0,0,0,0
"Romania","2024-06-13",0,0,0,0,0,0,0,0
"Romania","2024-06-14",0,0,0,0,0,0,0,0
"Romania","2024-06-15",0,0,0,0,0,0,0,0
"Romania","2024-06-16",0,0,0,0,0,0,0,0
"Romania","2024-06-17",0,0,0,0,0,0,0,0
"Romania","2024-06-18",0,0,0,0,0,0,0,0
"Romania","2024-06-19",0,0,0,0,0,0,0,0
"Romania","2024-06-20",0,0,0,0,0,0,0,0
"Romania","2024-06-21",0,0,0,0,0,0,0,0
"Romania","2024-06-22",0,0,0,0,0,0,0,0
"Romania","2024-06-23",0,0,0,0,0,0,0,0
"Romania","2024-06-24",0,0,0,0,0,0,0,0
"Romania","2024-06-25",0,0,0,0,0,0,0,0
"Romania","2024-06-26",0,0,0,0,0,0,0,0
"Romania","2024-06-27",0,0,0,0,0,0,0,0
"Romania","2024-06-28",0,0,0,0,0,0,0,0
"Romania","2024-06-29",0,0,0,0,0,0,0,0
"Romania","2024-06-30",0,0,0,0,0,0,0,0
"Romania","2024-07-01",0,0,0,0,0,0,0,0
"Romania","2024-07-02",0,0,0,0,0,0,0,0
"Romania","2024-07-03",0,0,0,0,0,0,0,0
"Romania","2024-07-04",0,0,0,0,0,0,0,0
"Romania","2024-07-05",0,0,0,0,0,0,0,0
"Romania","2024-07-06",0,0,0,0,0,0,0,0
"Romania","2024-07-07",0,0,0,0,0,0,0,0
"Romania","2024-07-08",0,0,0,0,0,0,0,0
"Romania","2024-07-09",0,0,0,0,0,0,0,0
"Romania","2024-07-10",0,0,0,0,0,0,0,0
"Romania","2024-07-11",0,0,0,0,0,0,0,0
"Romania","2024-07-12",0,0,0,0,0,0,0,0
"Romania","2024-07-13",0,0,0,0,0,0,0,0
"Romania","2024-07-14",0,0,0,0,0,0,0,0
"Romania","2024-07-15",0,0,0,0,0,0,0,0
"Romania","2024-07-16",0,0,0,0,0,0,0,0
"Romania","2024-07-17",0,0,0,0,0,0,0,0
"Romania","2024-07-18",0,0,0,0,0,0,0,0
"Romania","2024-07-19",0,0,0,0,0,0,0,0
"Romania","2024-07-20",0,0,0,0,0,0,0,0
"Romania","2024-07-21",0,0,0,0,0,0,0,0
"Romania","2024-07-22",0,0,0,0,0,0,0,0
"Romania","2024-07-23",0,0,0,0,0,0,0,0
"Romania","2024-07-24",0,0,0,0,0,0,0,0
"Romania","2024-07-25",0,0,0,0,0,0,0,0
"Romania","2024-07-26",0,0,0,0,0,0,0,0
"Romania","2024-07-27",0,0,0,0,0,0,0,0
"Romania","2024-07-28",0,0,0,0,0,0,0,0
"Romania","2024-07-29",0,0,0,0,0,0,0,0
"Romania","2024-07-30",0,0,0,0,0,0,0,0
"Romania","2024-07-31",0,0,0,0,0,0,0,0
"Romania","2024-08-01",0,0,0,0,0,0,0,0
"Romania","2024-08-02",0,0,0,0,0,0,0,0
"Romania","2024-08-03",0,0,0,0,0,0,0,0
"Romania","2024-08-04",0,0,0,0,0,0,0,0
"Romania","2024-08-05",0,0,0,0,0,0,0,0
"Romania","2024-08-06",0,0,0,0,0,0,0,0
"Romania","2024-08-07",0,0,0,0,0,0,0,0
"Romania","2024-08-08",0,0,0,0,0,0,0,0
"Romania","2024-08-09",0,0,0,0,0,0,0,0
"Romania","2024-08-10",0,0,0,0,0,0,0,0
"Romania","2024-08-11",0,0,0,0,0,0,0,0
"Romania","2024-08-12",0,0,0,0,0,0,0,0
"Romania","2024-08-13",0,0,0,0,0,0,0,0
"Romania","2024-08-14",0,0,0,0,0,0,0,0
"Romania","2024-08-15",0,0,0,0,0,0,0,0
"Romania","2024-08-16",0,0,0,0,0,0,0,0
"Romania","2024-08-17",0,0,0,0,0,0,0,0
"Romania","2024-08-18",0,0,0,0,0,0,0,0
"Romania","2024-08-19",0,0,0,0,0,0,0,0
"Romania","2024-08-20",0,0,0,0,0,0,0,0
"Romania","2024-08-21",0,0,0,0,0,0,0,0
"Romania","2024-08-22",0,0,0,0,0,0,0,0
"Romania","2024-08-23",0,0,0,0,0,0,0,0
"Romania","2024-08-24",0,0,0,0,0,0,0,0
"Romania","2024-08-25",0,0,0,0,0,0,0,0
"Romania","2024-08-26",0,0,0,0,0,0,0,0
"Romania","2024-08-27",0,0,0,0,0,0,0,0
"Romania","2024-08-28",0,0,0,0,0,0,0,0
"Romania","2024-08-29",0,0,0,0,0,0,0,0
"Romania","2024-08-30",0,0,0,0,0,0,0,0
"Romania","2024-08-31",0,1,1,0,1,1,0,0
"Romania","2024-09-01",0,0,1,0,0,1,0,0
"Romania","2024-09-02",0,0,1,0,0,1,0,0
"Romania","2024-09-03",0,0,1,0,0,1,0,0
"Romania","2024-09-04",0,0,1,0,0,1,0,0
"Romania","2024-09-05",0,0,1,0,0,1,0,0
"Romania","2024-09-06",0,0,1,0,0,1,0,0
"Romania","2024-09-07",0,0,1,0,0,1,0,0
"Romania","2024-09-08",0,0,1,0,0,1,0,0
"Romania","2024-09-09",0,0,1,0,0,1,0,0
"Romania","2024-09-10",0,0,1,0,0,1,0,0
"Romania","2024-09-11",0,0,1,0,0,1,0,0
"Romania","2024-09-12",0,0,1,0,0,1,0,0
"Romania","2024-09-13",0,0,1,0,0,1,0,0
"Romania","2024-09-14",0,0,1,0,0,1,0,0
"Romania","2024-09-15",0,0,1,0,0,1,0,0
"Romania","2024-09-16",0,0,1,0,0,1,0,0
"Romania","2024-09-17",0,0,1,0,0,1,0,0
"Romania","2024-09-18",0,0,1,0,0,1,0,0
"Romania","2024-09-19",0,0,1,0,0,1,0,0
"Romania","2024-09-20",0,0,1,0,0,1,0,0
"Romania","2024-09-21",0,0,1,0,0,1,0,0
"Romania","2024-09-22",0,0,1,0,0,1,0,0
"Romania","2024-09-23",0,0,1,0,0,1,0,0
"Romania","2024-09-24",0,0,1,0,0,1,0,0
"Romania","2024-09-25",0,0,1,0,0,1,0,0
"Romania","2024-09-26",0,0,1,0,0,1,0,0
"Romania","2024-09-27",0,0,1,0,0,1,0,0
"Romania","2024-09-28",0,0,1,0,0,1,0,0
"Romania","2024-09-29",0,0,1,0,0,1,0,0
"Romania","2024-09-30",0,0,1,0,0,1,0,0
"Romania","2024-10-01",0,0,1,0,0,1,0,0
"Romania","2024-10-02",0,0,1,0,0,1,0,0
"Romania","2024-10-03",0,0,1,0,0,1,0,0
"Romania","2024-10-04",0,0,1,0,0,1,0,0
"Romania","2024-10-05",0,0,1,0,0,1,0,0
"Romania","2024-10-06",0,0,1,0,0,1,0,0
"Romania","2024-10-07",0,0,1,0,0,1,0,0
"Romania","2024-10-08",0,0,1,0,0,1,0,0
"Romania","2024-10-09",0,0,1,0,0,1,0,0
"Romania","2024-10-10",0,0,1,0,0,1,0,0
"Romania","2024-10-11",0,0,1,0,0,1,0,0
"Romania","2024-10-12",0,0,1,0,0,1,0,0
"Romania","2024-10-13",0,0,1,0,0,1,0,0
"Romania","2024-10-14",0,0,1,0,0,1,0,0
"Romania","2024-10-15",0,0,1,0,0,1,0,0
"Romania","2024-10-16",0,0,1,0,0,1,0,0
"Romania","2024-10-17",0,0,1,0,0,1,0,0
"Romania","2024-10-18",0,0,1,0,0,1,0,0
"Romania","2024-10-19",0,0,1,0,0,1,0,0
"Romania","2024-10-20",0,0,1,0,0,1,0,0
"Romania","2024-10-21",0,0,1,0,0,1,0,0
"Romania","2024-10-22",0,0,1,0,0,1,0,0
"Romania","2024-10-23",0,0,1,0,0,1,0,0
"Romania","2024-10-24",0,0,1,0,0,1,0,0
"Romania","2024-10-25",0,0,1,0,0,1,0,0
"Romania","2024-10-26",0,0,1,0,0,1,0,0
"Romania","2024-10-27",0,0,1,0,0,1,0,0
"Romania","2024-10-28",0,0,1,0,0,1,0,0
"Romania","2024-10-29",0,0,1,0,0,1,0,0
"Romania","2024-10-30",0,0,1,0,0,1,0,0
"Romania","2024-10-31",0,0,1,0,0,1,0,0
"Romania","2024-11-01",0,0,1,0,0,1,0,0
"Romania","2024-11-02",0,0,1,0,0,1,0,0
"Romania","2024-11-03",0,0,1,0,0,1,0,0
"Romania","2024-11-04",0,0,1,0,0,1,0,0
"Romania","2024-11-05",0,0,1,0,0,1,0,0
"Romania","2024-11-06",0,0,1,0,0,1,0,0
"Romania","2024-11-07",0,0,1,0,0,1,0,0
"Romania","2024-11-08",0,0,1,0,0,1,0,0
"Romania","2024-11-09",0,0,1,0,0,1,0,0
"Romania","2024-11-10",0,0,1,0,0,1,0,0
"Romania","2024-11-11",0,0,1,0,0,1,0,0
"Romania","2024-11-12",0,0,1,0,0,1,0,0
"Romania","2024-11-13",0,0,1,0,0,1,0,0
"Romania","2024-11-14",0,0,1,0,0,1,0,0
"Romania","2024-11-15",0,0,1,0,0,1,0,0
"Romania","2024-11-16",0,0,1,0,0,1,0,0
"Romania","2024-11-17",0,0,1,0,0,1,0,0
"Romania","2024-11-18",0,0,1,0,0,1,0,0
"Romania","2024-11-19",0,0,1,0,0,1,0,0
"Romania","2024-11-20",0,0,1,0,0,1,0,0
"Romania","2024-11-21",0,0,1,0,0,1,0,0
"Romania","2024-11-22",0,0,1,0,0,1,0,0
"Romania","2024-11-23",0,0,1,0,0,1,0,0
"Romania","2024-11-24",0,0,1,0,0,1,0,0
"Romania","2024-11-25",0,0,1,0,0,1,0,0
"Romania","2024-11-26",0,0,1,0,0,1,0,0
"Romania","2024-11-27",0,0,1,0,0,1,0,0
"Romania","2024-11-28",0,0,1,0,0,1,0,0
"Romania","2024-11-29",0,0,1,0,0,1,0,0
"Romania","2024-11-30",0,0,1,0,0,1,0,0
"Romania","2024-12-01",0,0,1,0,0,1,0,0
"Romania","2024-12-02",0,0,1,0,0,1,0,0
"Romania","2024-12-03",0,0,1,0,0,1,0,0
"Romania","2024-12-04",0,0,1,0,0,1,0,0
"Romania","2024-12-05",0,0,1,0,0,1,0,0
"Romania","2024-12-06",0,0,1,0,0,1,0,0
"Romania","2024-12-07",0,0,1,0,0,1,0,0
"Romania","2024-12-08",0,0,1,0,0,1,0,0
"Romania","2024-12-09",0,0,1,0,0,1,0,0
"Romania","2024-12-10",0,0,1,0,0,1,0,0
"Romania","2024-12-11",0,0,1,0,0,1,0,0
"Romania","2024-12-12",0,0,1,0,0,1,0,0
"Romania","2024-12-13",0,0,1,0,0,1,0,0
"Romania","2024-12-14",0,0,1,0,0,1,0,0
"Romania","2024-12-15",0,0,1,0,0,1,0,0
"Romania","2024-12-16",0,0,1,0,0,1,0,0
"Romania","2024-12-17",0,0,1,0,0,1,0,0
"Romania","2024-12-18",0,0,1,0,0,1,0,0
"Romania","2024-12-19",0,0,1,0,0,1,0,0
"Romania","2024-12-20",0,0,1,0,0,1,0,0
"Romania","2024-12-21",0,0,1,0,0,1,0,0
"Romania","2024-12-22",0,0,1,0,0,1,0,0
"Romania","2024-12-23",0,0,1,0,0,1,0,0
"Romania","2024-12-24",0,0,1,0,0,1,0,0
"Romania","2024-12-25",0,0,1,0,0,1,0,0
"Romania","2024-12-26",0,0,1,0,0,1,0,0
"Romania","2024-12-27",0,0,1,0,0,1,0,0
"Romania","2024-12-28",0,0,1,0,0,1,0,0
"Romania","2024-12-29",0,0,1,0,0,1,0,0
"Romania","2024-12-30",0,0,1,0,0,1,0,0
"Romania","2024-12-31",0,0,1,0,0,1,0,0
"Romania","2025-01-01",0,0,1,0,0,1,0,0
"Romania","2025-01-02",0,0,1,0,0,1,0,0
"Romania","2025-01-03",0,0,1,0,0,1,0,0
"Romania","2025-01-04",0,0,1,0,0,1,0,0
"Romania","2025-01-05",0,0,1,0,0,1,0,0
"Romania","2025-01-06",0,0,1,0,0,1,0,0
"Romania","2025-01-07",0,0,1,0,0,1,0,0
"Romania","2025-01-08",0,0,1,0,0,1,0,0
"Romania","2025-01-09",0,0,1,0,0,1,0,0
"Romania","2025-01-10",0,0,1,0,0,1,0,0
"Romania","2025-01-11",0,0,1,0,0,1,0,0
"Romania","2025-01-12",0,0,1,0,0,1,0,0
"Romania","2025-01-13",0,0,1,0,0,1,0,0
"Russian Federation","2024-01-01",0,0,0,0,0,0,0,0
"Russian Federation","2024-01-02",0,0,0,0,0,0,0,0
"Russian Federation","2024-01-03",0,0,0,0,0,0,0,0
"Russian Federation","2024-01-04",0,0,0,0,0,0,0,0
"Russian Federation","2024-01-05",0,0,0,0,0,0,0,0
"Russian Federation","2024-01-06",0,0,0,0,0,0,0,0
"Russian Federation","2024-01-07",0,0,0,0,0,0,0,0
"Russian Federation","2024-01-08",0,0,0,0,0,0,0,0
"Russian Federation","2024-01-09",0,0,0,0,0,0,0,0
"Russian Federation","2024-01-10",0,0,0,0,0,0,0,0
"Russian Federation","2024-01-11",0,0,0,0,0,0,0,0
"Russian Federation","2024-01-12",0,0,0,0,0,0,0,0
"Russian Federation","2024-01-13",0,0,0,0,0,0,0,0
"Russian Federation","2024-01-14",0,0,0,0,0,0,0,0
"Russian Federation","2024-01-15",0,0,0,0,0,0,0,0
"Russian Federation","2024-01-16",0,0,0,0,0,0,0,0
"Russian Federation","2024-01-17",0,0,0,0,0,0,0,0
"Russian Federation","2024-01-18",0,0,0,0,0,0,0,0
"Russian Federation","2024-01-19",0,0,0,0,0,0,0,0
"Russian Federation","2024-01-20",0,0,0,0,0,0,0,0
"Russian Federation","2024-01-21",0,0,0,0,0,0,0,0
"Russian Federation","2024-01-22",0,0,0,0,0,0,0,0
"Russian Federation","2024-01-23",0,0,0,0,0,0,0,0
"Russian Federation","2024-01-24",0,0,0,0,0,0,0,0
"Russian Federation","2024-01-25",0,0,0,0,0,0,0,0
"Russian Federation","2024-01-26",0,0,0,0,0,0,0,0
"Russian Federation","2024-01-27",0,0,0,0,0,0,0,0
"Russian Federation","2024-01-28",0,0,0,0,0,0,0,0
"Russian Federation","2024-01-29",0,0,0,0,0,0,0,0
"Russian Federation","2024-01-30",0,0,0,0,0,0,0,0
"Russian Federation","2024-01-31",0,2,2,0,2,2,0,0
"Russian Federation","2024-02-01",0,0,2,0,0,2,0,0
"Russian Federation","2024-02-02",0,0,2,0,0,2,0,0
"Russian Federation","2024-02-03",0,0,2,0,0,2,0,0
"Russian Federation","2024-02-04",0,0,2,0,0,2,0,0
"Russian Federation","2024-02-05",0,0,2,0,0,2,0,0
"Russian Federation","2024-02-06",0,0,2,0,0,2,0,0
"Russian Federation","2024-02-07",0,0,2,0,0,2,0,0
"Russian Federation","2024-02-08",0,0,2,0,0,2,0,0
"Russian Federation","2024-02-09",0,0,2,0,0,2,0,0
"Russian Federation","2024-02-10",0,0,2,0,0,2,0,0
"Russian Federation","2024-02-11",0,0,2,0,0,2,0,0
"Russian Federation","2024-02-12",0,0,2,0,0,2,0,0
"Russian Federation","2024-02-13",0,0,2,0,0,2,0,0
"Russian Federation","2024-02-14",0,0,2,0,0,2,0,0
"Russian Federation","2024-02-15",0,0,2,0,0,2,0,0
"Russian Federation","2024-02-16",0,0,2,0,0,2,0,0
"Russian Federation","2024-02-17",0,0,2,0,0,2,0,0
"Russian Federation","2024-02-18",0,0,2,0,0,2,0,0
"Russian Federation","2024-02-19",0,0,2,0,0,2,0,0
"Russian Federation","2024-02-20",0,0,2,0,0,2,0,0
"Russian Federation","2024-02-21",0,0,2,0,0,2,0,0
"Russian Federation","2024-02-22",0,0,2,0,0,2,0,0
"Russian Federation","2024-02-23",0,0,2,0,0,2,0,0
"Russian Federation","2024-02-24",0,0,2,0,0,2,0,0
"Russian Federation","2024-02-25",0,0,2,0,0,2,0,0
"Russian Federation","2024-02-26",0,0,2,0,0,2,0,0
"Russian Federation","2024-02-27",0,0,2,0,0,2,0,0
"Russian Federation","2024-02-28",0,0,2,0,0,2,0,0
"Russian Federation","2024-02-29",0,0,2,0,0,2,0,0
"Russian Federation","2024-03-01",0,0,2,0,0,2,0,0
"Russian Federation","2024-03-02",0,0,2,0,0,2,0,0
"Russian Federation","2024-03-03",0,0,2,0,0,2,0,0
"Russian Federation","2024-03-04",0,0,2,0,0,2,0,0
"Russian Federation","2024-03-05",0,0,2,0,0,2,0,0
"Russian Federation","2024-03-06",0,0,2,0,0,2,0,0
"Russian Federation","2024-03-07",0,0,2,0,0,2,0,0
"Russian Federation","2024-03-08",0,0,2,0,0,2,0,0
"Russian Federation","2024-03-09",0,0,2,0,0,2,0,0
"Russian Federation","2024-03-10",0,0,2,0,0,2,0,0
"Russian Federation","2024-03-11",0,0,2,0,0,2,0,0
"Russian Federation","2024-03-12",0,0,2,0,0,2,0,0
"Russian Federation","2024-03-13",0,0,2,0,0,2,0,0
"Russian Federation","2024-03-14",0,0,2,0,0,2,0,0
"Russian Federation","2024-03-15",0,0,2,0,0,2,0,0
"Russian Federation","2024-03-16",0,0,2,0,0,2,0,0
"Russian Federation","2024-03-17",0,0,2,0,0,2,0,0
"Russian Federation","2024-03-18",0,0,2,0,0,2,0,0
"Russian Federation","2024-03-19",0,0,2,0,0,2,0,0
"Russian Federation","2024-03-20",0,0,2,0,0,2,0,0
"Russian Federation","2024-03-21",0,0,2,0,0,2,0,0
"Russian Federation","2024-03-22",0,0,2,0,0,2,0,0
"Russian Federation","2024-03-23",0,0,2,0,0,2,0,0
"Russian Federation","2024-03-24",0,0,2,0,0,2,0,0
"Russian Federation","2024-03-25",0,0,2,0,0,2,0,0
"Russian Federation","2024-03-26",0,0,2,0,0,2,0,0
"Russian Federation","2024-03-27",0,0,2,0,0,2,0,0
"Russian Federation","2024-03-28",0,0,2,0,0,2,0,0
"Russian Federation","2024-03-29",0,0,2,0,0,2,0,0
"Russian Federation","2024-03-30",0,0,2,0,0,2,0,0
"Russian Federation","2024-03-31",0,0,2,0,0,2,0,0
"Russian Federation","2024-04-01",0,0,2,0,0,2,0,0
"Russian Federation","2024-04-02",0,0,2,0,0,2,0,0
"Russian Federation","2024-04-03",0,0,2,0,0,2,0,0
"Russian Federation","2024-04-04",0,0,2,0,0,2,0,0
"Russian Federation","2024-04-05",0,0,2,0,0,2,0,0
"Russian Federation","2024-04-06",0,0,2,0,0,2,0,0
"Russian Federation","2024-04-07",0,0,2,0,0,2,0,0
"Russian Federation","2024-04-08",0,0,2,0,0,2,0,0
"Russian Federation","2024-04-09",0,0,2,0,0,2,0,0
"Russian Federation","2024-04-10",0,0,2,0,0,2,0,0
"Russian Federation","2024-04-11",0,0,2,0,0,2,0,0
"Russian Federation","2024-04-12",0,0,2,0,0,2,0,0
"Russian Federation","2024-04-13",0,0,2,0,0,2,0,0
"Russian Federation","2024-04-14",0,0,2,0,0,2,0,0
"Russian Federation","2024-04-15",0,0,2,0,0,2,0,0
"Russian Federation","2024-04-16",0,0,2,0,0,2,0,0
"Russian Federation","2024-04-17",0,0,2,0,0,2,0,0
"Russian Federation","2024-04-18",0,0,2,0,0,2,0,0
"Russian Federation","2024-04-19",0,0,2,0,0,2,0,0
"Russian Federation","2024-04-20",0,0,2,0,0,2,0,0
"Russian Federation","2024-04-21",0,0,2,0,0,2,0,0
"Russian Federation","2024-04-22",0,0,2,0,0,2,0,0
"Russian Federation","2024-04-23",0,0,2,0,0,2,0,0
"Russian Federation","2024-04-24",0,0,2,0,0,2,0,0
"Russian Federation","2024-04-25",0,0,2,0,0,2,0,0
"Russian Federation","2024-04-26",0,0,2,0,0,2,0,0
"Russian Federation","2024-04-27",0,0,2,0,0,2,0,0
"Russian Federation","2024-04-28",0,0,2,0,0,2,0,0
"Russian Federation","2024-04-29",0,0,2,0,0,2,0,0
"Russian Federation","2024-04-30",0,0,2,0,0,2,0,0
"Russian Federation","2024-05-01",0,0,2,0,0,2,0,0
"Russian Federation","2024-05-02",0,0,2,0,0,2,0,0
"Russian Federation","2024-05-03",0,0,2,0,0,2,0,0
"Russian Federation","2024-05-04",0,0,2,0,0,2,0,0
"Russian Federation","2024-05-05",0,0,2,0,0,2,0,0
"Russian Federation","2024-05-06",0,0,2,0,0,2,0,0
"Russian Federation","2024-05-07",0,0,2,0,0,2,0,0
"Russian Federation","2024-05-08",0,0,2,0,0,2,0,0
"Russian Federation","2024-05-09",0,0,2,0,0,2,0,0
"Russian Federation","2024-05-10",0,0,2,0,0,2,0,0
"Russian Federation","2024-05-11",0,0,2,0,0,2,0,0
"Russian Federation","2024-05-12",0,0,2,0,0,2,0,0
"Russian Federation","2024-05-13",0,0,2,0,0,2,0,0
"Russian Federation","2024-05-14",0,0,2,0,0,2,0,0
"Russian Federation","2024-05-15",0,0,2,0,0,2,0,0
"Russian Federation","2024-05-16",0,0,2,0,0,2,0,0
"Russian Federation","2024-05-17",0,0,2,0,0,2,0,0
"Russian Federation","2024-05-18",0,0,2,0,0,2,0,0
"Russian Federation","2024-05-19",0,0,2,0,0,2,0,0
"Russian Federation","2024-05-20",0,0,2,0,0,2,0,0
"Russian Federation","2024-05-21",0,0,2,0,0,2,0,0
"Russian Federation","2024-05-22",0,0,2,0,0,2,0,0
"Russian Federation","2024-05-23",0,0,2,0,0,2,0,0
"Russian Federation","2024-05-24",0,0,2,0,0,2,0,0
"Russian Federation","2024-05-25",0,0,2,0,0,2,0,0
"Russian Federation","2024-05-26",0,0,2,0,0,2,0,0
"Russian Federation","2024-05-27",0,0,2,0,0,2,0,0
"Russian Federation","2024-05-28",0,0,2,0,0,2,0,0
"Russian Federation","2024-05-29",0,0,2,0,0,2,0,0
"Russian Federation","2024-05-30",0,0,2,0,0,2,0,0
"Russian Federation","2024-05-31",0,0,2,0,0,2,0,0
"Russian Federation","2024-06-01",0,0,2,0,0,2,0,0
"Russian Federation","2024-06-02",0,0,2,0,0,2,0,0
"Russian Federation","2024-06-03",0,0,2,0,0,2,0,0
"Russian Federation","2024-06-04",0,0,2,0,0,2,0,0
"Russian Federation","2024-06-05",0,0,2,0,0,2,0,0
"Russian Federation","2024-06-06",0,0,2,0,0,2,0,0
"Russian Federation","2024-06-07",0,0,2,0,0,2,0,0
"Russian Federation","2024-06-08",0,0,2,0,0,2,0,0
"Russian Federation","2024-06-09",0,0,2,0,0,2,0,0
"Russian Federation","2024-06-10",0,0,2,0,0,2,0,0
"Russian Federation","2024-06-11",0,0,2,0,0,2,0,0
"Russian Federation","2024-06-12",0,0,2,0,0,2,0,0
"Russian Federation","2024-06-13",0,0,2,0,0,2,0,0
"Russian Federation","2024-06-14",0,0,2,0,0,2,0,0
"Russian Federation","2024-06-15",0,0,2,0,0,2,0,0
"Russian Federation","2024-06-16",0,0,2,0,0,2,0,0
"Russian Federation","2024-06-17",0,0,2,0,0,2,0,0
"Russian Federation","2024-06-18",0,0,2,0,0,2,0,0
"Russian Federation","2024-06-19",0,0,2,0,0,2,0,0
"Russian Federation","2024-06-20",0,0,2,0,0,2,0,0
"Russian Federation","2024-06-21",0,0,2,0,0,2,0,0
"Russian Federation","2024-06-22",0,0,2,0,0,2,0,0
"Russian Federation","2024-06-23",0,0,2,0,0,2,0,0
"Russian Federation","2024-06-24",0,0,2,0,0,2,0,0
"Russian Federation","2024-06-25",0,0,2,0,0,2,0,0
"Russian Federation","2024-06-26",0,0,2,0,0,2,0,0
"Russian Federation","2024-06-27",0,0,2,0,0,2,0,0
"Russian Federation","2024-06-28",0,0,2,0,0,2,0,0
"Russian Federation","2024-06-29",0,0,2,0,0,2,0,0
"Russian Federation","2024-06-30",0,0,2,0,0,2,0,0
"Russian Federation","2024-07-01",0,0,2,0,0,2,0,0
"Russian Federation","2024-07-02",0,0,2,0,0,2,0,0
"Russian Federation","2024-07-03",0,0,2,0,0,2,0,0
"Russian Federation","2024-07-04",0,0,2,0,0,2,0,0
"Russian Federation","2024-07-05",0,0,2,0,0,2,0,0
"Russian Federation","2024-07-06",0,0,2,0,0,2,0,0
"Russian Federation","2024-07-07",0,0,2,0,0,2,0,0
"Russian Federation","2024-07-08",0,0,2,0,0,2,0,0
"Russian Federation","2024-07-09",0,0,2,0,0,2,0,0
"Russian Federation","2024-07-10",0,0,2,0,0,2,0,0
"Russian Federation","2024-07-11",0,0,2,0,0,2,0,0
"Russian Federation","2024-07-12",0,0,2,0,0,2,0,0
"Russian Federation","2024-07-13",0,0,2,0,0,2,0,0
"Russian Federation","2024-07-14",0,0,2,0,0,2,0,0
"Russian Federation","2024-07-15",0,0,2,0,0,2,0,0
"Russian Federation","2024-07-16",0,0,2,0,0,2,0,0
"Russian Federation","2024-07-17",0,0,2,0,0,2,0,0
"Russian Federation","2024-07-18",0,0,2,0,0,2,0,0
"Russian Federation","2024-07-19",0,0,2,0,0,2,0,0
"Russian Federation","2024-07-20",0,0,2,0,0,2,0,0
"Russian Federation","2024-07-21",0,0,2,0,0,2,0,0
"Russian Federation","2024-07-22",0,0,2,0,0,2,0,0
"Russian Federation","2024-07-23",0,0,2,0,0,2,0,0
"Russian Federation","2024-07-24",0,0,2,0,0,2,0,0
"Russian Federation","2024-07-25",0,0,2,0,0,2,0,0
"Russian Federation","2024-07-26",0,0,2,0,0,2,0,0
"Russian Federation","2024-07-27",0,0,2,0,0,2,0,0
"Russian Federation","2024-07-28",0,0,2,0,0,2,0,0
"Russian Federation","2024-07-29",0,0,2,0,0,2,0,0
"Russian Federation","2024-07-30",0,0,2,0,0,2,0,0
"Russian Federation","2024-07-31",0,0,2,0,0,2,0,0
"Russian Federation","2024-08-01",0,0,2,0,0,2,0,0
"Russian Federation","2024-08-02",0,0,2,0,0,2,0,0
"Russian Federation","2024-08-03",0,0,2,0,0,2,0,0
"Russian Federation","2024-08-04",0,0,2,0,0,2,0,0
"Russian Federation","2024-08-05",0,0,2,0,0,2,0,0
"Russian Federation","2024-08-06",0,0,2,0,0,2,0,0
"Russian Federation","2024-08-07",0,0,2,0,0,2,0,0
"Russian Federation","2024-08-08",0,0,2,0,0,2,0,0
"Russian Federation","2024-08-09",0,0,2,0,0,2,0,0
"Russian Federation","2024-08-10",0,0,2,0,0,2,0,0
"Russian Federation","2024-08-11",0,0,2,0,0,2,0,0
"Russian Federation","2024-08-12",0,0,2,0,0,2,0,0
"Russian Federation","2024-08-13",0,0,2,0,0,2,0,0
"Russian Federation","2024-08-14",0,0,2,0,0,2,0,0
"Russian Federation","2024-08-15",0,0,2,0,0,2,0,0
"Russian Federation","2024-08-16",0,0,2,0,0,2,0,0
"Russian Federation","2024-08-17",0,0,2,0,0,2,0,0
"Russian Federation","2024-08-18",0,0,2,0,0,2,0,0
"Russian Federation","2024-08-19",0,0,2,0,0,2,0,0
"Russian Federation","2024-08-20",0,0,2,0,0,2,0,0
"Russian Federation","2024-08-21",0,0,2,0,0,2,0,0
"Russian Federation","2024-08-22",0,0,2,0,0,2,0,0
"Russian Federation","2024-08-23",0,0,2,0,0,2,0,0
"Russian Federation","2024-08-24",0,0,2,0,0,2,0,0
"Russian Federation","2024-08-25",0,0,2,0,0,2,0,0
"Russian Federation","2024-08-26",0,0,2,0,0,2,0,0
"Russian Federation","2024-08-27",0,0,2,0,0,2,0,0
"Russian Federation","2024-08-28",0,0,2,0,0,2,0,0
"Russian Federation","2024-08-29",0,0,2,0,0,2,0,0
"Russian Federation","2024-08-30",0,0,2,0,0,2,0,0
"Russian Federation","2024-08-31",0,0,2,0,0,2,0,0
"Russian Federation","2024-09-01",0,0,2,0,0,2,0,0
"Russian Federation","2024-09-02",0,0,2,0,0,2,0,0
"Russian Federation","2024-09-03",0,0,2,0,0,2,0,0
"Russian Federation","2024-09-04",0,0,2,0,0,2,0,0
"Russian Federation","2024-09-05",0,0,2,0,0,2,0,0
"Russian Federation","2024-09-06",0,0,2,0,0,2,0,0
"Russian Federation","2024-09-07",0,0,2,0,0,2,0,0
"Russian Federation","2024-09-08",0,0,2,0,0,2,0,0
"Russian Federation","2024-09-09",0,0,2,0,0,2,0,0
"Russian Federation","2024-09-10",0,0,2,0,0,2,0,0
"Russian Federation","2024-09-11",0,0,2,0,0,2,0,0
"Russian Federation","2024-09-12",0,0,2,0,0,2,0,0
"Russian Federation","2024-09-13",0,0,2,0,0,2,0,0
"Russian Federation","2024-09-14",0,0,2,0,0,2,0,0
"Russian Federation","2024-09-15",0,0,2,0,0,2,0,0
"Russian Federation","2024-09-16",0,0,2,0,0,2,0,0
"Russian Federation","2024-09-17",0,0,2,0,0,2,0,0
"Russian Federation","2024-09-18",0,0,2,0,0,2,0,0
"Russian Federation","2024-09-19",0,0,2,0,0,2,0,0
"Russian Federation","2024-09-20",0,0,2,0,0,2,0,0
"Russian Federation","2024-09-21",0,0,2,0,0,2,0,0
"Russian Federation","2024-09-22",0,0,2,0,0,2,0,0
"Russian Federation","2024-09-23",0,0,2,0,0,2,0,0
"Russian Federation","2024-09-24",0,0,2,0,0,2,0,0
"Russian Federation","2024-09-25",0,0,2,0,0,2,0,0
"Russian Federation","2024-09-26",0,0,2,0,0,2,0,0
"Russian Federation","2024-09-27",0,0,2,0,0,2,0,0
"Russian Federation","2024-09-28",0,0,2,0,0,2,0,0
"Russian Federation","2024-09-29",0,0,2,0,0,2,0,0
"Russian Federation","2024-09-30",0,0,2,0,0,2,0,0
"Russian Federation","2024-10-01",0,0,2,0,0,2,0,0
"Russian Federation","2024-10-02",0,0,2,0,0,2,0,0
"Russian Federation","2024-10-03",0,0,2,0,0,2,0,0
"Russian Federation","2024-10-04",0,0,2,0,0,2,0,0
"Russian Federation","2024-10-05",0,0,2,0,0,2,0,0
"Russian Federation","2024-10-06",0,0,2,0,0,2,0,0
"Russian Federation","2024-10-07",0,0,2,0,0,2,0,0
"Russian Federation","2024-10-08",0,0,2,0,0,2,0,0
"Russian Federation","2024-10-09",0,0,2,0,0,2,0,0
"Russian Federation","2024-10-10",0,0,2,0,0,2,0,0
"Russian Federation","2024-10-11",0,0,2,0,0,2,0,0
"Russian Federation","2024-10-12",0,0,2,0,0,2,0,0
"Russian Federation","2024-10-13",0,0,2,0,0,2,0,0
"Russian Federation","2024-10-14",0,0,2,0,0,2,0,0
"Russian Federation","2024-10-15",0,0,2,0,0,2,0,0
"Russian Federation","2024-10-16",0,0,2,0,0,2,0,0
"Russian Federation","2024-10-17",0,0,2,0,0,2,0,0
"Russian Federation","2024-10-18",0,0,2,0,0,2,0,0
"Russian Federation","2024-10-19",0,0,2,0,0,2,0,0
"Russian Federation","2024-10-20",0,0,2,0,0,2,0,0
"Russian Federation","2024-10-21",0,0,2,0,0,2,0,0
"Russian Federation","2024-10-22",0,0,2,0,0,2,0,0
"Russian Federation","2024-10-23",0,0,2,0,0,2,0,0
"Russian Federation","2024-10-24",0,0,2,0,0,2,0,0
"Russian Federation","2024-10-25",0,0,2,0,0,2,0,0
"Russian Federation","2024-10-26",0,0,2,0,0,2,0,0
"Russian Federation","2024-10-27",0,0,2,0,0,2,0,0
"Russian Federation","2024-10-28",0,0,2,0,0,2,0,0
"Russian Federation","2024-10-29",0,0,2,0,0,2,0,0
"Russian Federation","2024-10-30",0,0,2,0,0,2,0,0
"Russian Federation","2024-10-31",0,0,2,0,0,2,0,0
"Russian Federation","2024-11-01",0,0,2,0,0,2,0,0
"Russian Federation","2024-11-02",0,0,2,0,0,2,0,0
"Russian Federation","2024-11-03",0,0,2,0,0,2,0,0
"Russian Federation","2024-11-04",0,0,2,0,0,2,0,0
"Russian Federation","2024-11-05",0,0,2,0,0,2,0,0
"Russian Federation","2024-11-06",0,0,2,0,0,2,0,0
"Russian Federation","2024-11-07",0,0,2,0,0,2,0,0
"Russian Federation","2024-11-08",0,0,2,0,0,2,0,0
"Russian Federation","2024-11-09",0,0,2,0,0,2,0,0
"Russian Federation","2024-11-10",0,0,2,0,0,2,0,0
"Russian Federation","2024-11-11",0,0,2,0,0,2,0,0
"Russian Federation","2024-11-12",0,0,2,0,0,2,0,0
"Russian Federation","2024-11-13",0,0,2,0,0,2,0,0
"Russian Federation","2024-11-14",0,0,2,0,0,2,0,0
"Russian Federation","2024-11-15",0,0,2,0,0,2,0,0
"Russian Federation","2024-11-16",0,0,2,0,0,2,0,0
"Russian Federation","2024-11-17",0,0,2,0,0,2,0,0
"Russian Federation","2024-11-18",0,0,2,0,0,2,0,0
"Russian Federation","2024-11-19",0,0,2,0,0,2,0,0
"Russian Federation","2024-11-20",0,0,2,0,0,2,0,0
"Russian Federation","2024-11-21",0,0,2,0,0,2,0,0
"Russian Federation","2024-11-22",0,0,2,0,0,2,0,0
"Russian Federation","2024-11-23",0,0,2,0,0,2,0,0
"Russian Federation","2024-11-24",0,0,2,0,0,2,0,0
"Russian Federation","2024-11-25",0,0,2,0,0,2,0,0
"Russian Federation","2024-11-26",0,0,2,0,0,2,0,0
"Russian Federation","2024-11-27",0,0,2,0,0,2,0,0
"Russian Federation","2024-11-28",0,0,2,0,0,2,0,0
"Russian Federation","2024-11-29",0,0,2,0,0,2,0,0
"Russian Federation","2024-11-30",0,0,2,0,0,2,0,0
"Russian Federation","2024-12-01",0,0,2,0,0,2,0,0
"Russian Federation","2024-12-02",0,0,2,0,0,2,0,0
"Russian Federation","2024-12-03",0,0,2,0,0,2,0,0
"Russian Federation","2024-12-04",0,0,2,0,0,2,0,0
"Russian Federation","2024-12-05",0,0,2,0,0,2,0,0
"Russian Federation","2024-12-06",0,0,2,0,0,2,0,0
"Russian Federation","2024-12-07",0,0,2,0,0,2,0,0
"Russian Federation","2024-12-08",0,0,2,0,0,2,0,0
"Russian Federation","2024-12-09",0,0,2,0,0,2,0,0
"Russian Federation","2024-12-10",0,0,2,0,0,2,0,0
"Russian Federation","2024-12-11",0,0,2,0,0,2,0,0
"Russian Federation","2024-12-12",0,0,2,0,0,2,0,0
"Russian Federation","2024-12-13",0,0,2,0,0,2,0,0
"Russian Federation","2024-12-14",0,0,2,0,0,2,0,0
"Russian Federation","2024-12-15",0,0,2,0,0,2,0,0
"Russian Federation","2024-12-16",0,0,2,0,0,2,0,0
"Russian Federation","2024-12-17",0,0,2,0,0,2,0,0
"Russian Federation","2024-12-18",0,0,2,0,0,2,0,0
"Russian Federation","2024-12-19",0,0,2,0,0,2,0,0
"Russian Federation","2024-12-20",0,0,2,0,0,2,0,0
"Russian Federation","2024-12-21",0,0,2,0,0,2,0,0
"Russian Federation","2024-12-22",0,0,2,0,0,2,0,0
"Russian Federation","2024-12-23",0,0,2,0,0,2,0,0
"Russian Federation","2024-12-24",0,0,2,0,0,2,0,0
"Russian Federation","2024-12-25",0,0,2,0,0,2,0,0
"Russian Federation","2024-12-26",0,0,2,0,0,2,0,0
"Russian Federation","2024-12-27",0,0,2,0,0,2,0,0
"Russian Federation","2024-12-28",0,0,2,0,0,2,0,0
"Russian Federation","2024-12-29",0,0,2,0,0,2,0,0
"Russian Federation","2024-12-30",0,0,2,0,0,2,0,0
"Russian Federation","2024-12-31",0,0,2,0,0,2,0,0
"Russian Federation","2025-01-01",0,0,2,0,0,2,0,0
"Russian Federation","2025-01-02",0,0,2,0,0,2,0,0
"Russian Federation","2025-01-03",0,0,2,0,0,2,0,0
"Russian Federation","2025-01-04",0,0,2,0,0,2,0,0
"Russian Federation","2025-01-05",0,0,2,0,0,2,0,0
"Russian Federation","2025-01-06",0,0,2,0,0,2,0,0
"Russian Federation","2025-01-07",0,0,2,0,0,2,0,0
"Russian Federation","2025-01-08",0,0,2,0,0,2,0,0
"Russian Federation","2025-01-09",0,0,2,0,0,2,0,0
"Russian Federation","2025-01-10",0,0,2,0,0,2,0,0
"Russian Federation","2025-01-11",0,0,2,0,0,2,0,0
"Russian Federation","2025-01-12",0,0,2,0,0,2,0,0
"Russian Federation","2025-01-13",0,0,2,0,0,2,0,0
"Rwanda","2024-01-01",0,0,0,0,0,0,0,0
"Rwanda","2024-01-02",0,0,0,0,0,0,0,0
"Rwanda","2024-01-03",0,0,0,0,0,0,0,0
"Rwanda","2024-01-04",0,0,0,0,0,0,0,0
"Rwanda","2024-01-05",0,0,0,0,0,0,0,0
"Rwanda","2024-01-06",0,0,0,0,0,0,0,0
"Rwanda","2024-01-07",0,0,0,0,0,0,0,0
"Rwanda","2024-01-08",0,0,0,0,0,0,0,0
"Rwanda","2024-01-09",0,0,0,0,0,0,0,0
"Rwanda","2024-01-10",0,0,0,0,0,0,0,0
"Rwanda","2024-01-11",0,0,0,0,0,0,0,0
"Rwanda","2024-01-12",0,0,0,0,0,0,0,0
"Rwanda","2024-01-13",0,0,0,0,0,0,0,0
"Rwanda","2024-01-14",0,0,0,0,0,0,0,0
"Rwanda","2024-01-15",0,0,0,0,0,0,0,0
"Rwanda","2024-01-16",0,0,0,0,0,0,0,0
"Rwanda","2024-01-17",0,0,0,0,0,0,0,0
"Rwanda","2024-01-18",0,0,0,0,0,0,0,0
"Rwanda","2024-01-19",0,0,0,0,0,0,0,0
"Rwanda","2024-01-20",0,0,0,0,0,0,0,0
"Rwanda","2024-01-21",0,0,0,0,0,0,0,0
"Rwanda","2024-01-22",0,0,0,0,0,0,0,0
"Rwanda","2024-01-23",0,0,0,0,0,0,0,0
"Rwanda","2024-01-24",0,0,0,0,0,0,0,0
"Rwanda","2024-01-25",0,0,0,0,0,0,0,0
"Rwanda","2024-01-26",0,0,0,0,0,0,0,0
"Rwanda","2024-01-27",0,0,0,0,0,0,0,0
"Rwanda","2024-01-28",0,0,0,0,0,0,0,0
"Rwanda","2024-01-29",0,0,0,0,0,0,0,0
"Rwanda","2024-01-30",0,0,0,0,0,0,0,0
"Rwanda","2024-01-31",0,0,0,0,0,0,0,0
"Rwanda","2024-02-01",0,0,0,0,0,0,0,0
"Rwanda","2024-02-02",0,0,0,0,0,0,0,0
"Rwanda","2024-02-03",0,0,0,0,0,0,0,0
"Rwanda","2024-02-04",0,0,0,0,0,0,0,0
"Rwanda","2024-02-05",0,0,0,0,0,0,0,0
"Rwanda","2024-02-06",0,0,0,0,0,0,0,0
"Rwanda","2024-02-07",0,0,0,0,0,0,0,0
"Rwanda","2024-02-08",0,0,0,0,0,0,0,0
"Rwanda","2024-02-09",0,0,0,0,0,0,0,0
"Rwanda","2024-02-10",0,0,0,0,0,0,0,0
"Rwanda","2024-02-11",0,0,0,0,0,0,0,0
"Rwanda","2024-02-12",0,0,0,0,0,0,0,0
"Rwanda","2024-02-13",0,0,0,0,0,0,0,0
"Rwanda","2024-02-14",0,0,0,0,0,0,0,0
"Rwanda","2024-02-15",0,0,0,0,0,0,0,0
"Rwanda","2024-02-16",0,0,0,0,0,0,0,0
"Rwanda","2024-02-17",0,0,0,0,0,0,0,0
"Rwanda","2024-02-18",0,0,0,0,0,0,0,0
"Rwanda","2024-02-19",0,0,0,0,0,0,0,0
"Rwanda","2024-02-20",0,0,0,0,0,0,0,0
"Rwanda","2024-02-21",0,0,0,0,0,0,0,0
"Rwanda","2024-02-22",0,0,0,0,0,0,0,0
"Rwanda","2024-02-23",0,0,0,0,0,0,0,0
"Rwanda","2024-02-24",0,0,0,0,0,0,0,0
"Rwanda","2024-02-25",0,0,0,0,0,0,0,0
"Rwanda","2024-02-26",0,0,0,0,0,0,0,0
"Rwanda","2024-02-27",0,0,0,0,0,0,0,0
"Rwanda","2024-02-28",0,0,0,0,0,0,0,0
"Rwanda","2024-02-29",0,0,0,0,0,0,0,0
"Rwanda","2024-03-01",0,0,0,0,0,0,0,0
"Rwanda","2024-03-02",0,0,0,0,0,0,0,0
"Rwanda","2024-03-03",0,0,0,0,0,0,0,0
"Rwanda","2024-03-04",0,0,0,0,0,0,0,0
"Rwanda","2024-03-05",0,0,0,0,0,0,0,0
"Rwanda","2024-03-06",0,0,0,0,0,0,0,0
"Rwanda","2024-03-07",0,0,0,0,0,0,0,0
"Rwanda","2024-03-08",0,0,0,0,0,0,0,0
"Rwanda","2024-03-09",0,0,0,0,0,0,0,0
"Rwanda","2024-03-10",0,0,0,0,0,0,0,0
"Rwanda","2024-03-11",0,0,0,0,0,0,0,0
"Rwanda","2024-03-12",0,0,0,0,0,0,0,0
"Rwanda","2024-03-13",0,0,0,0,0,0,0,0
"Rwanda","2024-03-14",0,0,0,0,0,0,0,0
"Rwanda","2024-03-15",0,0,0,0,0,0,0,0
"Rwanda","2024-03-16",0,0,0,0,0,0,0,0
"Rwanda","2024-03-17",0,0,0,0,0,0,0,0
"Rwanda","2024-03-18",0,0,0,0,0,0,0,0
"Rwanda","2024-03-19",0,0,0,0,0,0,0,0
"Rwanda","2024-03-20",0,0,0,0,0,0,0,0
"Rwanda","2024-03-21",0,0,0,0,0,0,0,0
"Rwanda","2024-03-22",0,0,0,0,0,0,0,0
"Rwanda","2024-03-23",0,0,0,0,0,0,0,0
"Rwanda","2024-03-24",0,0,0,0,0,0,0,0
"Rwanda","2024-03-25",0,0,0,0,0,0,0,0
"Rwanda","2024-03-26",0,0,0,0,0,0,0,0
"Rwanda","2024-03-27",0,0,0,0,0,0,0,0
"Rwanda","2024-03-28",0,0,0,0,0,0,0,0
"Rwanda","2024-03-29",0,0,0,0,0,0,0,0
"Rwanda","2024-03-30",0,0,0,0,0,0,0,0
"Rwanda","2024-03-31",0,0,0,0,0,0,0,0
"Rwanda","2024-04-01",0,0,0,0,0,0,0,0
"Rwanda","2024-04-02",0,0,0,0,0,0,0,0
"Rwanda","2024-04-03",0,0,0,0,0,0,0,0
"Rwanda","2024-04-04",0,0,0,0,0,0,0,0
"Rwanda","2024-04-05",0,0,0,0,0,0,0,0
"Rwanda","2024-04-06",0,0,0,0,0,0,0,0
"Rwanda","2024-04-07",0,0,0,0,0,0,0,0
"Rwanda","2024-04-08",0,0,0,0,0,0,0,0
"Rwanda","2024-04-09",0,0,0,0,0,0,0,0
"Rwanda","2024-04-10",0,0,0,0,0,0,0,0
"Rwanda","2024-04-11",0,0,0,0,0,0,0,0
"Rwanda","2024-04-12",0,0,0,0,0,0,0,0
"Rwanda","2024-04-13",0,0,0,0,0,0,0,0
"Rwanda","2024-04-14",0,0,0,0,0,0,0,0
"Rwanda","2024-04-15",0,0,0,0,0,0,0,0
"Rwanda","2024-04-16",0,0,0,0,0,0,0,0
"Rwanda","2024-04-17",0,0,0,0,0,0,0,0
"Rwanda","2024-04-18",0,0,0,0,0,0,0,0
"Rwanda","2024-04-19",0,0,0,0,0,0,0,0
"Rwanda","2024-04-20",0,0,0,0,0,0,0,0
"Rwanda","2024-04-21",0,0,0,0,0,0,0,0
"Rwanda","2024-04-22",0,0,0,0,0,0,0,0
"Rwanda","2024-04-23",0,0,0,0,0,0,0,0
"Rwanda","2024-04-24",0,0,0,0,0,0,0,0
"Rwanda","2024-04-25",0,0,0,0,0,0,0,0
"Rwanda","2024-04-26",0,0,0,0,0,0,0,0
"Rwanda","2024-04-27",0,0,0,0,0,0,0,0
"Rwanda","2024-04-28",0,0,0,0,0,0,0,0
"Rwanda","2024-04-29",0,0,0,0,0,0,0,0
"Rwanda","2024-04-30",0,0,0,0,0,0,0,0
"Rwanda","2024-05-01",0,0,0,0,0,0,0,0
"Rwanda","2024-05-02",0,0,0,0,0,0,0,0
"Rwanda","2024-05-03",0,0,0,0,0,0,0,0
"Rwanda","2024-05-04",0,0,0,0,0,0,0,0
"Rwanda","2024-05-05",0,0,0,0,0,0,0,0
"Rwanda","2024-05-06",0,0,0,0,0,0,0,0
"Rwanda","2024-05-07",0,0,0,0,0,0,0,0
"Rwanda","2024-05-08",0,0,0,0,0,0,0,0
"Rwanda","2024-05-09",0,0,0,0,0,0,0,0
"Rwanda","2024-05-10",0,0,0,0,0,0,0,0
"Rwanda","2024-05-11",0,0,0,0,0,0,0,0
"Rwanda","2024-05-12",0,0,0,0,0,0,0,0
"Rwanda","2024-05-13",0,0,0,0,0,0,0,0
"Rwanda","2024-05-14",0,0,0,0,0,0,0,0
"Rwanda","2024-05-15",0,0,0,0,0,0,0,0
"Rwanda","2024-05-16",0,0,0,0,0,0,0,0
"Rwanda","2024-05-17",0,0,0,0,0,0,0,0
"Rwanda","2024-05-18",0,0,0,0,0,0,0,0
"Rwanda","2024-05-19",0,0,0,0,0,0,0,0
"Rwanda","2024-05-20",0,0,0,0,0,0,0,0
"Rwanda","2024-05-21",0,0,0,0,0,0,0,0
"Rwanda","2024-05-22",0,0,0,0,0,0,0,0
"Rwanda","2024-05-23",0,0,0,0,0,0,0,0
"Rwanda","2024-05-24",0,0,0,0,0,0,0,0
"Rwanda","2024-05-25",0,0,0,0,0,0,0,0
"Rwanda","2024-05-26",0,0,0,0,0,0,0,0
"Rwanda","2024-05-27",0,0,0,0,0,0,0,0
"Rwanda","2024-05-28",0,0,0,0,0,0,0,0
"Rwanda","2024-05-29",0,0,0,0,0,0,0,0
"Rwanda","2024-05-30",0,0,0,0,0,0,0,0
"Rwanda","2024-05-31",0,0,0,0,0,0,0,0
"Rwanda","2024-06-01",0,0,0,0,0,0,0,0
"Rwanda","2024-06-02",0,0,0,0,0,0,0,0
"Rwanda","2024-06-03",0,0,0,0,0,0,0,0
"Rwanda","2024-06-04",0,0,0,0,0,0,0,0
"Rwanda","2024-06-05",0,0,0,0,0,0,0,0
"Rwanda","2024-06-06",0,0,0,0,0,0,0,0
"Rwanda","2024-06-07",0,0,0,0,0,0,0,0
"Rwanda","2024-06-08",0,0,0,0,0,0,0,0
"Rwanda","2024-06-09",0,0,0,0,0,0,0,0
"Rwanda","2024-06-10",0,0,0,0,0,0,0,0
"Rwanda","2024-06-11",0,0,0,0,0,0,0,0
"Rwanda","2024-06-12",0,0,0,0,0,0,0,0
"Rwanda","2024-06-13",0,0,0,0,0,0,0,0
"Rwanda","2024-06-14",0,0,0,0,0,0,0,0
"Rwanda","2024-06-15",0,0,0,0,0,0,0,0
"Rwanda","2024-06-16",0,0,0,0,0,0,0,0
"Rwanda","2024-06-17",0,0,0,0,0,0,0,0
"Rwanda","2024-06-18",0,0,0,0,0,0,0,0
"Rwanda","2024-06-19",0,0,0,0,0,0,0,0
"Rwanda","2024-06-20",0,0,0,0,0,0,0,0
"Rwanda","2024-06-21",0,0,0,0,0,0,0,0
"Rwanda","2024-06-22",0,0,0,0,0,0,0,0
"Rwanda","2024-06-23",0,0,0,0,0,0,0,0
"Rwanda","2024-06-24",0,0,0,0,0,0,0,0
"Rwanda","2024-06-25",0,0,0,0,0,0,0,0
"Rwanda","2024-06-26",0,0,0,0,0,0,0,0
"Rwanda","2024-06-27",0,0,0,0,0,0,0,0
"Rwanda","2024-06-28",0,0,0,0,0,0,0,0
"Rwanda","2024-06-29",0,0,0,0,0,0,0,0
"Rwanda","2024-06-30",0,0,0,0,0,0,0,0
"Rwanda","2024-07-01",0,0,0,0,0,0,0,0
"Rwanda","2024-07-02",0,0,0,0,0,0,0,0
"Rwanda","2024-07-03",0,0,0,0,0,0,0,0
"Rwanda","2024-07-04",0,0,0,0,0,0,0,0
"Rwanda","2024-07-05",0,0,0,0,0,0,0,0
"Rwanda","2024-07-06",0,0,0,0,0,0,0,0
"Rwanda","2024-07-07",0,0,0,0,0,0,0,0
"Rwanda","2024-07-08",0,0,0,0,0,0,0,0
"Rwanda","2024-07-09",0,0,0,0,0,0,0,0
"Rwanda","2024-07-10",0,0,0,0,0,0,0,0
"Rwanda","2024-07-11",0,0,0,0,0,0,0,0
"Rwanda","2024-07-12",0,0,0,0,0,0,0,0
"Rwanda","2024-07-13",0,0,0,0,0,0,0,0
"Rwanda","2024-07-14",8,0,0,8,0,0,8,8
"Rwanda","2024-07-15",0,0,0,8,0,0,1,9
"Rwanda","2024-07-16",0,0,0,8,0,0,1,10
"Rwanda","2024-07-17",0,0,0,8,0,0,1,11
"Rwanda","2024-07-18",0,0,0,8,0,0,1,12
"Rwanda","2024-07-19",0,0,0,8,0,0,1,13
"Rwanda","2024-07-20",0,0,0,8,0,0,1,14
"Rwanda","2024-07-21",0,0,0,8,0,0,2,16
"Rwanda","2024-07-22",0,0,0,8,0,0,1,17
"Rwanda","2024-07-23",0,0,0,8,0,0,1,18
"Rwanda","2024-07-24",0,0,0,8,0,0,1,19
"Rwanda","2024-07-25",0,0,0,8,0,0,1,20
"Rwanda","2024-07-26",0,0,0,8,0,0,1,21
"Rwanda","2024-07-27",0,0,0,8,0,0,1,22
"Rwanda","2024-07-28",15,4,4,23,4,4,1,23
"Rwanda","2024-07-29",0,0,4,23,0,4,30,53
"Rwanda","2024-07-30",0,0,4,23,0,4,29,82
"Rwanda","2024-07-31",0,0,4,23,0,4,30,112
"Rwanda","2024-08-01",0,0,4,23,0,4,30,142
"Rwanda","2024-08-02",0,0,4,23,0,4,30,172
"Rwanda","2024-08-03",0,0,4,23,0,4,29,201
"Rwanda","2024-08-04",208,0,4,231,0,4,30,231
"Rwanda","2024-08-05",0,0,4,231,0,4,24,255
"Rwanda","2024-08-06",0,0,4,231,0,4,25,280
"Rwanda","2024-08-07",0,0,4,231,0,4,24,304
"Rwanda","2024-08-08",0,0,4,231,0,4,24,328
"Rwanda","2024-08-09",0,0,4,231,0,4,24,352
"Rwanda","2024-08-10",0,0,4,231,1,5,25,377
"Rwanda","2024-08-11",170,0,4,401,0,5,24,401
"Rwanda","2024-08-12",0,0,4,401,0,5,20,421
"Rwanda","2024-08-13",0,0,4,401,0,5,19,440
"Rwanda","2024-08-14",0,0,4,401,0,5,20,460
"Rwanda","2024-08-15",0,0,4,401,0,5,20,480
"Rwanda","2024-08-16",0,0,4,401,0,5,20,500
"Rwanda","2024-08-17",0,0,4,401,0,5,19,519
"Rwanda","2024-08-18",138,0,4,539,0,5,20,539
"Rwanda","2024-08-19",0,0,4,539,0,5,30,569
"Rwanda","2024-08-20",0,0,4,539,0,5,30,599
"Rwanda","2024-08-21",0,0,4,539,0,5,30,629
"Rwanda","2024-08-22",0,0,4,539,0,5,29,658
"Rwanda","2024-08-23",0,0,4,539,0,5,30,688
"Rwanda","2024-08-24",0,0,4,539,0,5,30,718
"Rwanda","2024-08-25",209,0,4,748,0,5,30,748
"Rwanda","2024-08-26",0,0,4,748,0,5,53,801
"Rwanda","2024-08-27",0,0,4,748,0,5,52,853
"Rwanda","2024-08-28",0,0,4,748,0,5,53,906
"Rwanda","2024-08-29",0,0,4,748,0,5,52,958
"Rwanda","2024-08-30",0,0,4,748,0,5,53,1011
"Rwanda","2024-08-31",0,0,4,748,0,5,52,1063
"Rwanda","2024-09-01",368,0,4,1116,0,5,53,1116
"Rwanda","2024-09-02",0,0,4,1116,0,5,38,1154
"Rwanda","2024-09-03",0,0,4,1116,1,6,37,1191
"Rwanda","2024-09-04",0,0,4,1116,0,6,38,1229
"Rwanda","2024-09-05",0,0,4,1116,0,6,37,1266
"Rwanda","2024-09-06",0,0,4,1116,0,6,38,1304
"Rwanda","2024-09-07",0,0,4,1116,0,6,37,1341
"Rwanda","2024-09-08",263,0,4,1379,0,6,38,1379
"Rwanda","2024-09-09",0,0,4,1379,0,6,51,1430
"Rwanda","2024-09-10",0,0,4,1379,0,6,52,1482
"Rwanda","2024-09-11",0,0,4,1379,0,6,51,1533
"Rwanda","2024-09-12",0,0,4,1379,0,6,52,1585
"Rwanda","2024-09-13",0,0,4,1379,0,6,51,1636
"Rwanda","2024-09-14",0,0,4,1379,0,6,52,1688
"Rwanda","2024-09-15",360,2,6,1739,0,6,51,1739
"Rwanda","2024-09-16",0,0,6,1739,0,6,72,1811
"Rwanda","2024-09-17",0,0,6,1739,0,6,73,1884
"Rwanda","2024-09-18",0,0,6,1739,1,7,72,1956
"Rwanda","2024-09-19",0,0,6,1739,0,7,72,2028
"Rwanda","2024-09-20",0,0,6,1739,0,7,72,2100
"Rwanda","2024-09-21",0,0,6,1739,0,7,73,2173
"Rwanda","2024-09-22",506,0,6,2245,0,7,72,2245
"Rwanda","2024-09-23",0,0,6,2245,1,8,78,2323
"Rwanda","2024-09-24",0,0,6,2245,0,8,77,2400
"Rwanda","2024-09-25",0,0,6,2245,0,8,78,2478
"Rwanda","2024-09-26",0,0,6,2245,0,8,78,2556
"Rwanda","2024-09-27",0,0,6,2245,0,8,78,2634
"Rwanda","2024-09-28",0,0,6,2245,0,8,77,2711
"Rwanda","2024-09-29",544,0,6,2789,1,9,78,2789
"Rwanda","2024-09-30",0,0,6,2789,0,9,1,2790
"Rwanda","2024-10-01",0,0,6,2789,0,9,2,2792
"Rwanda","2024-10-02",0,0,6,2789,0,9,1,2793
"Rwanda","2024-10-03",0,0,6,2789,0,9,1,2794
"Rwanda","2024-10-04",0,0,6,2789,1,10,1,2795
"Rwanda","2024-10-05",0,0,6,2789,0,10,2,2797
"Rwanda","2024-10-06",9,4,10,2798,0,10,1,2798
"Rwanda","2024-10-07",0,0,10,2798,1,11,76,2874
"Rwanda","2024-10-08",0,0,10,2798,0,11,76,2950
"Rwanda","2024-10-09",0,0,10,2798,1,12,76,3026
"Rwanda","2024-10-10",0,0,10,2798,0,12,75,3101
"Rwanda","2024-10-11",0,0,10,2798,1,13,76,3177
"Rwanda","2024-10-12",0,0,10,2798,0,13,76,3253
"Rwanda","2024-10-13",531,4,14,3329,1,14,76,3329
"Rwanda","2024-10-14",0,0,14,3329,1,15,25,3354
"Rwanda","2024-10-15",0,0,14,3329,1,16,26,3380
"Rwanda","2024-10-16",0,0,14,3329,1,17,25,3405
"Rwanda","2024-10-17",0,0,14,3329,2,19,26,3431
"Rwanda","2024-10-18",0,0,14,3329,1,20,25,3456
"Rwanda","2024-10-19",0,0,14,3329,1,21,26,3482
"Rwanda","2024-10-20",178,8,22,3507,1,22,25,3507
"Rwanda","2024-10-21",0,0,22,3507,1,23,27,3534
"Rwanda","2024-10-22",0,0,22,3507,0,23,27,3561
"Rwanda","2024-10-23",0,0,22,3507,1,24,27,3588
"Rwanda","2024-10-24",0,0,22,3507,0,24,28,3616
"Rwanda","2024-10-25",0,0,22,3507,1,25,27,3643
"Rwanda","2024-10-26",0,0,22,3507,0,25,27,3670
"Rwanda","2024-10-27",190,4,26,3697,1,26,27,3697
"Rwanda","2024-10-28",0,0,26,3697,1,27,33,3730
"Rwanda","2024-10-29",0,0,26,3697,1,28,32,3762
"Rwanda","2024-10-30",0,0,26,3697,0,28,33,3795
"Rwanda","2024-10-31",0,0,26,3697,1,29,32,3827
"Rwanda","2024-11-01",0,0,26,3697,1,30,33,3860
"Rwanda","2024-11-02",0,0,26,3697,1,31,32,3892
"Rwanda","2024-11-03",228,0,26,3925,1,32,33,3925
"Rwanda","2024-11-04",0,0,26,3925,0,32,22,3947
"Rwanda","2024-11-05",0,0,26,3925,1,33,22,3969
"Rwanda","2024-11-06",0,0,26,3925,1,34,22,3991
"Rwanda","2024-11-07",0,0,26,3925,1,35,21,4012
"Rwanda","2024-11-08",0,0,26,3925,0,35,22,4034
"Rwanda","2024-11-09",0,0,26,3925,1,36,22,4056
"Rwanda","2024-11-10",153,11,37,4078,1,37,22,4078
"Rwanda","2024-11-11",0,0,37,4078,1,38,0,4078
"Rwanda","2024-11-12",0,0,37,4078,1,39,0,4078
"Rwanda","2024-11-13",0,0,37,4078,1,40,0,4078
"Rwanda","2024-11-14",0,0,37,4078,1,41,0,4078
"Rwanda","2024-11-15",0,0,37,4078,1,42,0,4078
"Rwanda","2024-11-16",0,0,37,4078,1,43,0,4078
"Rwanda","2024-11-17",0,0,37,4078,2,45,0,4078
"Rwanda","2024-11-18",0,0,37,4078,1,46,0,4078
"Rwanda","2024-11-19",0,0,37,4078,1,47,0,4078
"Rwanda","2024-11-20",0,0,37,4078,1,48,0,4078
"Rwanda","2024-11-21",0,0,37,4078,1,49,0,4078
"Rwanda","2024-11-22",0,0,37,4078,1,50,0,4078
"Rwanda","2024-11-23",0,0,37,4078,1,51,0,4078
"Rwanda","2024-11-24",0,15,52,4078,1,52,0,4078
"Rwanda","2024-11-25",0,0,52,4078,1,53,0,4078
"Rwanda","2024-11-26",0,0,52,4078,1,54,0,4078
"Rwanda","2024-11-27",0,0,52,4078,2,56,0,4078
"Rwanda","2024-11-28",0,0,52,4078,1,57,0,4078
"Rwanda","2024-11-29",0,0,52,4078,1,58,0,4078
"Rwanda","2024-11-30",0,7,59,4078,1,59,0,4078
"Rwanda","2024-12-01",0,0,59,4078,0,59,0,4078
"Rwanda","2024-12-02",0,0,59,4078,0,59,0,4078
"Rwanda","2024-12-03",0,0,59,4078,0,59,0,4078
"Rwanda","2024-12-04",0,0,59,4078,0,59,0,4078
"Rwanda","2024-12-05",0,0,59,4078,0,59,0,4078
"Rwanda","2024-12-06",0,0,59,4078,0,59,0,4078
"Rwanda","2024-12-07",0,0,59,4078,0,59,0,4078
"Rwanda","2024-12-08",0,0,59,4078,0,59,0,4078
"Rwanda","2024-12-09",0,0,59,4078,0,59,0,4078
"Rwanda","2024-12-10",0,0,59,4078,0,59,0,4078
"Rwanda","2024-12-11",0,0,59,4078,0,59,0,4078
"Rwanda","2024-12-12",0,0,59,4078,0,59,0,4078
"Rwanda","2024-12-13",0,0,59,4078,0,59,0,4078
"Rwanda","2024-12-14",0,0,59,4078,0,59,0,4078
"Rwanda","2024-12-15",0,0,59,4078,0,59,0,4078
"Rwanda","2024-12-16",0,0,59,4078,0,59,0,4078
"Rwanda","2024-12-17",0,0,59,4078,0,59,0,4078
"Rwanda","2024-12-18",0,0,59,4078,0,59,0,4078
"Rwanda","2024-12-19",0,0,59,4078,0,59,0,4078
"Rwanda","2024-12-20",0,0,59,4078,0,59,0,4078
"Rwanda","2024-12-21",0,0,59,4078,0,59,0,4078
"Rwanda","2024-12-22",0,0,59,4078,0,59,0,4078
"Rwanda","2024-12-23",0,0,59,4078,0,59,0,4078
"Rwanda","2024-12-24",0,0,59,4078,0,59,0,4078
"Rwanda","2024-12-25",0,0,59,4078,0,59,0,4078
"Rwanda","2024-12-26",0,0,59,4078,0,59,0,4078
"Rwanda","2024-12-27",0,0,59,4078,0,59,0,4078
"Rwanda","2024-12-28",0,0,59,4078,0,59,0,4078
"Rwanda","2024-12-29",0,0,59,4078,0,59,0,4078
"Rwanda","2024-12-30",0,0,59,4078,0,59,0,4078
"Rwanda","2024-12-31",0,0,59,4078,0,59,0,4078
"Rwanda","2025-01-01",0,0,59,4078,0,59,0,4078
"Rwanda","2025-01-02",0,0,59,4078,0,59,0,4078
"Rwanda","2025-01-03",0,0,59,4078,0,59,0,4078
"Rwanda","2025-01-04",0,0,59,4078,0,59,0,4078
"Rwanda","2025-01-05",0,0,59,4078,0,59,0,4078
"Rwanda","2025-01-06",0,0,59,4078,0,59,0,4078
"Rwanda","2025-01-07",0,0,59,4078,0,59,0,4078
"Rwanda","2025-01-08",0,0,59,4078,0,59,0,4078
"Rwanda","2025-01-09",0,0,59,4078,0,59,0,4078
"Rwanda","2025-01-10",0,0,59,4078,0,59,0,4078
"Rwanda","2025-01-11",0,0,59,4078,0,59,0,4078
"Rwanda","2025-01-12",0,0,59,4078,0,59,0,4078
"Rwanda","2025-01-13",0,0,59,4078,0,59,0,4078
"Saint Martin (French Part)","2024-01-01",0,0,0,0,0,0,0,0
"Saint Martin (French Part)","2024-01-02",0,0,0,0,0,0,0,0
"Saint Martin (French Part)","2024-01-03",0,0,0,0,0,0,0,0
"Saint Martin (French Part)","2024-01-04",0,0,0,0,0,0,0,0
"Saint Martin (French Part)","2024-01-05",0,0,0,0,0,0,0,0
"Saint Martin (French Part)","2024-01-06",0,0,0,0,0,0,0,0
"Saint Martin (French Part)","2024-01-07",0,0,0,0,0,0,0,0
"Saint Martin (French Part)","2024-01-08",0,0,0,0,0,0,0,0
"Saint Martin (French Part)","2024-01-09",0,0,0,0,0,0,0,0
"Saint Martin (French Part)","2024-01-10",0,0,0,0,0,0,0,0
"Saint Martin (French Part)","2024-01-11",0,0,0,0,0,0,0,0
"Saint Martin (French Part)","2024-01-12",0,0,0,0,0,0,0,0
"Saint Martin (French Part)","2024-01-13",0,0,0,0,0,0,0,0
"Saint Martin (French Part)","2024-01-14",0,0,0,0,0,0,0,0
"Saint Martin (French Part)","2024-01-15",0,0,0,0,0,0,0,0
"Saint Martin (French Part)","2024-01-16",0,0,0,0,0,0,0,0
"Saint Martin (French Part)","2024-01-17",0,0,0,0,0,0,0,0
"Saint Martin (French Part)","2024-01-18",0,0,0,0,0,0,0,0
"Saint Martin (French Part)","2024-01-19",0,0,0,0,0,0,0,0
"Saint Martin (French Part)","2024-01-20",0,0,0,0,0,0,0,0
"Saint Martin (French Part)","2024-01-21",0,0,0,0,0,0,0,0
"Saint Martin (French Part)","2024-01-22",0,0,0,0,0,0,0,0
"Saint Martin (French Part)","2024-01-23",0,0,0,0,0,0,0,0
"Saint Martin (French Part)","2024-01-24",0,0,0,0,0,0,0,0
"Saint Martin (French Part)","2024-01-25",0,0,0,0,0,0,0,0
"Saint Martin (French Part)","2024-01-26",0,0,0,0,0,0,0,0
"Saint Martin (French Part)","2024-01-27",0,0,0,0,0,0,0,0
"Saint Martin (French Part)","2024-01-28",0,0,0,0,0,0,0,0
"Saint Martin (French Part)","2024-01-29",0,0,0,0,0,0,0,0
"Saint Martin (French Part)","2024-01-30",0,0,0,0,0,0,0,0
"Saint Martin (French Part)","2024-01-31",0,0,0,0,0,0,0,0
"Saint Martin (French Part)","2024-02-01",0,0,0,0,0,0,0,0
"Saint Martin (French Part)","2024-02-02",0,0,0,0,0,0,0,0
"Saint Martin (French Part)","2024-02-03",0,0,0,0,0,0,0,0
"Saint Martin (French Part)","2024-02-04",0,0,0,0,0,0,0,0
"Saint Martin (French Part)","2024-02-05",0,0,0,0,0,0,0,0
"Saint Martin (French Part)","2024-02-06",0,0,0,0,0,0,0,0
"Saint Martin (French Part)","2024-02-07",0,0,0,0,0,0,0,0
"Saint Martin (French Part)","2024-02-08",0,0,0,0,0,0,0,0
"Saint Martin (French Part)","2024-02-09",0,0,0,0,0,0,0,0
"Saint Martin (French Part)","2024-02-10",0,0,0,0,0,0,0,0
"Saint Martin (French Part)","2024-02-11",0,0,0,0,0,0,0,0
"Saint Martin (French Part)","2024-02-12",0,0,0,0,0,0,0,0
"Saint Martin (French Part)","2024-02-13",0,0,0,0,0,0,0,0
"Saint Martin (French Part)","2024-02-14",0,0,0,0,0,0,0,0
"Saint Martin (French Part)","2024-02-15",0,0,0,0,0,0,0,0
"Saint Martin (French Part)","2024-02-16",0,0,0,0,0,0,0,0
"Saint Martin (French Part)","2024-02-17",0,0,0,0,0,0,0,0
"Saint Martin (French Part)","2024-02-18",0,0,0,0,0,0,0,0
"Saint Martin (French Part)","2024-02-19",0,0,0,0,0,0,0,0
"Saint Martin (French Part)","2024-02-20",0,0,0,0,0,0,0,0
"Saint Martin (French Part)","2024-02-21",0,0,0,0,0,0,0,0
"Saint Martin (French Part)","2024-02-22",0,0,0,0,0,0,0,0
"Saint Martin (French Part)","2024-02-23",0,0,0,0,0,0,0,0
"Saint Martin (French Part)","2024-02-24",0,0,0,0,0,0,0,0
"Saint Martin (French Part)","2024-02-25",0,0,0,0,0,0,0,0
"Saint Martin (French Part)","2024-02-26",0,0,0,0,0,0,0,0
"Saint Martin (French Part)","2024-02-27",0,0,0,0,0,0,0,0
"Saint Martin (French Part)","2024-02-28",0,0,0,0,0,0,0,0
"Saint Martin (French Part)","2024-02-29",0,0,0,0,0,0,0,0
"Saint Martin (French Part)","2024-03-01",0,0,0,0,0,0,0,0
"Saint Martin (French Part)","2024-03-02",0,0,0,0,0,0,0,0
"Saint Martin (French Part)","2024-03-03",0,0,0,0,0,0,0,0
"Saint Martin (French Part)","2024-03-04",0,0,0,0,0,0,0,0
"Saint Martin (French Part)","2024-03-05",0,0,0,0,0,0,0,0
"Saint Martin (French Part)","2024-03-06",0,0,0,0,0,0,0,0
"Saint Martin (French Part)","2024-03-07",0,0,0,0,0,0,0,0
"Saint Martin (French Part)","2024-03-08",0,0,0,0,0,0,0,0
"Saint Martin (French Part)","2024-03-09",0,0,0,0,0,0,0,0
"Saint Martin (French Part)","2024-03-10",0,0,0,0,0,0,0,0
"Saint Martin (French Part)","2024-03-11",0,0,0,0,0,0,0,0
"Saint Martin (French Part)","2024-03-12",0,0,0,0,0,0,0,0
"Saint Martin (French Part)","2024-03-13",0,0,0,0,0,0,0,0
"Saint Martin (French Part)","2024-03-14",0,0,0,0,0,0,0,0
"Saint Martin (French Part)","2024-03-15",0,0,0,0,0,0,0,0
"Saint Martin (French Part)","2024-03-16",0,0,0,0,0,0,0,0
"Saint Martin (French Part)","2024-03-17",0,0,0,0,0,0,0,0
"Saint Martin (French Part)","2024-03-18",0,0,0,0,0,0,0,0
"Saint Martin (French Part)","2024-03-19",0,0,0,0,0,0,0,0
"Saint Martin (French Part)","2024-03-20",0,0,0,0,0,0,0,0
"Saint Martin (French Part)","2024-03-21",0,0,0,0,0,0,0,0
"Saint Martin (French Part)","2024-03-22",0,0,0,0,0,0,0,0
"Saint Martin (French Part)","2024-03-23",0,0,0,0,0,0,0,0
"Saint Martin (French Part)","2024-03-24",0,0,0,0,0,0,0,0
"Saint Martin (French Part)","2024-03-25",0,0,0,0,0,0,0,0
"Saint Martin (French Part)","2024-03-26",0,0,0,0,0,0,0,0
"Saint Martin (French Part)","2024-03-27",0,0,0,0,0,0,0,0
"Saint Martin (French Part)","2024-03-28",0,0,0,0,0,0,0,0
"Saint Martin (French Part)","2024-03-29",0,0,0,0,0,0,0,0
"Saint Martin (French Part)","2024-03-30",0,0,0,0,0,0,0,0
"Saint Martin (French Part)","2024-03-31",0,0,0,0,0,0,0,0
"Saint Martin (French Part)","2024-04-01",0,0,0,0,0,0,0,0
"Saint Martin (French Part)","2024-04-02",0,0,0,0,0,0,0,0
"Saint Martin (French Part)","2024-04-03",0,0,0,0,0,0,0,0
"Saint Martin (French Part)","2024-04-04",0,0,0,0,0,0,0,0
"Saint Martin (French Part)","2024-04-05",0,0,0,0,0,0,0,0
"Saint Martin (French Part)","2024-04-06",0,0,0,0,0,0,0,0
"Saint Martin (French Part)","2024-04-07",0,0,0,0,0,0,0,0
"Saint Martin (French Part)","2024-04-08",0,0,0,0,0,0,0,0
"Saint Martin (French Part)","2024-04-09",0,0,0,0,0,0,0,0
"Saint Martin (French Part)","2024-04-10",0,0,0,0,0,0,0,0
"Saint Martin (French Part)","2024-04-11",0,0,0,0,0,0,0,0
"Saint Martin (French Part)","2024-04-12",0,0,0,0,0,0,0,0
"Saint Martin (French Part)","2024-04-13",0,0,0,0,0,0,0,0
"Saint Martin (French Part)","2024-04-14",0,0,0,0,0,0,0,0
"Saint Martin (French Part)","2024-04-15",0,0,0,0,0,0,0,0
"Saint Martin (French Part)","2024-04-16",0,0,0,0,0,0,0,0
"Saint Martin (French Part)","2024-04-17",0,0,0,0,0,0,0,0
"Saint Martin (French Part)","2024-04-18",0,0,0,0,0,0,0,0
"Saint Martin (French Part)","2024-04-19",0,0,0,0,0,0,0,0
"Saint Martin (French Part)","2024-04-20",0,0,0,0,0,0,0,0
"Saint Martin (French Part)","2024-04-21",0,0,0,0,0,0,0,0
"Saint Martin (French Part)","2024-04-22",0,0,0,0,0,0,0,0
"Saint Martin (French Part)","2024-04-23",0,0,0,0,0,0,0,0
"Saint Martin (French Part)","2024-04-24",0,0,0,0,0,0,0,0
"Saint Martin (French Part)","2024-04-25",0,0,0,0,0,0,0,0
"Saint Martin (French Part)","2024-04-26",0,0,0,0,0,0,0,0
"Saint Martin (French Part)","2024-04-27",0,0,0,0,0,0,0,0
"Saint Martin (French Part)","2024-04-28",0,0,0,0,0,0,0,0
"Saint Martin (French Part)","2024-04-29",0,0,0,0,0,0,0,0
"Saint Martin (French Part)","2024-04-30",0,0,0,0,0,0,0,0
"Saint Martin (French Part)","2024-05-01",0,0,0,0,0,0,0,0
"Saint Martin (French Part)","2024-05-02",0,0,0,0,0,0,0,0
"Saint Martin (French Part)","2024-05-03",0,0,0,0,0,0,0,0
"Saint Martin (French Part)","2024-05-04",0,0,0,0,0,0,0,0
"Saint Martin (French Part)","2024-05-05",0,0,0,0,0,0,0,0
"Saint Martin (French Part)","2024-05-06",0,0,0,0,0,0,0,0
"Saint Martin (French Part)","2024-05-07",0,0,0,0,0,0,0,0
"Saint Martin (French Part)","2024-05-08",0,0,0,0,0,0,0,0
"Saint Martin (French Part)","2024-05-09",0,0,0,0,0,0,0,0
"Saint Martin (French Part)","2024-05-10",0,0,0,0,0,0,0,0
"Saint Martin (French Part)","2024-05-11",0,0,0,0,0,0,0,0
"Saint Martin (French Part)","2024-05-12",0,0,0,0,0,0,0,0
"Saint Martin (French Part)","2024-05-13",0,0,0,0,0,0,0,0
"Saint Martin (French Part)","2024-05-14",0,0,0,0,0,0,0,0
"Saint Martin (French Part)","2024-05-15",0,0,0,0,0,0,0,0
"Saint Martin (French Part)","2024-05-16",0,0,0,0,0,0,0,0
"Saint Martin (French Part)","2024-05-17",0,0,0,0,0,0,0,0
"Saint Martin (French Part)","2024-05-18",0,0,0,0,0,0,0,0
"Saint Martin (French Part)","2024-05-19",0,0,0,0,0,0,0,0
"Saint Martin (French Part)","2024-05-20",0,0,0,0,0,0,0,0
"Saint Martin (French Part)","2024-05-21",0,0,0,0,0,0,0,0
"Saint Martin (French Part)","2024-05-22",0,0,0,0,0,0,0,0
"Saint Martin (French Part)","2024-05-23",0,0,0,0,0,0,0,0
"Saint Martin (French Part)","2024-05-24",0,0,0,0,0,0,0,0
"Saint Martin (French Part)","2024-05-25",0,0,0,0,0,0,0,0
"Saint Martin (French Part)","2024-05-26",0,0,0,0,0,0,0,0
"Saint Martin (French Part)","2024-05-27",0,0,0,0,0,0,0,0
"Saint Martin (French Part)","2024-05-28",0,0,0,0,0,0,0,0
"Saint Martin (French Part)","2024-05-29",0,0,0,0,0,0,0,0
"Saint Martin (French Part)","2024-05-30",0,0,0,0,0,0,0,0
"Saint Martin (French Part)","2024-05-31",0,0,0,0,0,0,0,0
"Saint Martin (French Part)","2024-06-01",0,0,0,0,0,0,0,0
"Saint Martin (French Part)","2024-06-02",0,0,0,0,0,0,0,0
"Saint Martin (French Part)","2024-06-03",0,0,0,0,0,0,0,0
"Saint Martin (French Part)","2024-06-04",0,0,0,0,0,0,0,0
"Saint Martin (French Part)","2024-06-05",0,0,0,0,0,0,0,0
"Saint Martin (French Part)","2024-06-06",0,0,0,0,0,0,0,0
"Saint Martin (French Part)","2024-06-07",0,0,0,0,0,0,0,0
"Saint Martin (French Part)","2024-06-08",0,0,0,0,0,0,0,0
"Saint Martin (French Part)","2024-06-09",0,0,0,0,0,0,0,0
"Saint Martin (French Part)","2024-06-10",0,0,0,0,0,0,0,0
"Saint Martin (French Part)","2024-06-11",0,0,0,0,0,0,0,0
"Saint Martin (French Part)","2024-06-12",0,0,0,0,0,0,0,0
"Saint Martin (French Part)","2024-06-13",0,0,0,0,0,0,0,0
"Saint Martin (French Part)","2024-06-14",0,0,0,0,0,0,0,0
"Saint Martin (French Part)","2024-06-15",0,0,0,0,0,0,0,0
"Saint Martin (French Part)","2024-06-16",0,0,0,0,0,0,0,0
"Saint Martin (French Part)","2024-06-17",0,0,0,0,0,0,0,0
"Saint Martin (French Part)","2024-06-18",0,0,0,0,0,0,0,0
"Saint Martin (French Part)","2024-06-19",0,0,0,0,0,0,0,0
"Saint Martin (French Part)","2024-06-20",0,0,0,0,0,0,0,0
"Saint Martin (French Part)","2024-06-21",0,0,0,0,0,0,0,0
"Saint Martin (French Part)","2024-06-22",0,0,0,0,0,0,0,0
"Saint Martin (French Part)","2024-06-23",0,0,0,0,0,0,0,0
"Saint Martin (French Part)","2024-06-24",0,0,0,0,0,0,0,0
"Saint Martin (French Part)","2024-06-25",0,0,0,0,0,0,0,0
"Saint Martin (French Part)","2024-06-26",0,0,0,0,0,0,0,0
"Saint Martin (French Part)","2024-06-27",0,0,0,0,0,0,0,0
"Saint Martin (French Part)","2024-06-28",0,0,0,0,0,0,0,0
"Saint Martin (French Part)","2024-06-29",0,0,0,0,0,0,0,0
"Saint Martin (French Part)","2024-06-30",0,0,0,0,0,0,0,0
"Saint Martin (French Part)","2024-07-01",0,0,0,0,0,0,0,0
"Saint Martin (French Part)","2024-07-02",0,0,0,0,0,0,0,0
"Saint Martin (French Part)","2024-07-03",0,0,0,0,0,0,0,0
"Saint Martin (French Part)","2024-07-04",0,0,0,0,0,0,0,0
"Saint Martin (French Part)","2024-07-05",0,0,0,0,0,0,0,0
"Saint Martin (French Part)","2024-07-06",0,0,0,0,0,0,0,0
"Saint Martin (French Part)","2024-07-07",0,0,0,0,0,0,0,0
"Saint Martin (French Part)","2024-07-08",0,0,0,0,0,0,0,0
"Saint Martin (French Part)","2024-07-09",0,0,0,0,0,0,0,0
"Saint Martin (French Part)","2024-07-10",0,0,0,0,0,0,0,0
"Saint Martin (French Part)","2024-07-11",0,0,0,0,0,0,0,0
"Saint Martin (French Part)","2024-07-12",0,0,0,0,0,0,0,0
"Saint Martin (French Part)","2024-07-13",0,0,0,0,0,0,0,0
"Saint Martin (French Part)","2024-07-14",0,0,0,0,0,0,0,0
"Saint Martin (French Part)","2024-07-15",0,0,0,0,0,0,0,0
"Saint Martin (French Part)","2024-07-16",0,0,0,0,0,0,0,0
"Saint Martin (French Part)","2024-07-17",0,0,0,0,0,0,0,0
"Saint Martin (French Part)","2024-07-18",0,0,0,0,0,0,0,0
"Saint Martin (French Part)","2024-07-19",0,0,0,0,0,0,0,0
"Saint Martin (French Part)","2024-07-20",0,0,0,0,0,0,0,0
"Saint Martin (French Part)","2024-07-21",0,0,0,0,0,0,0,0
"Saint Martin (French Part)","2024-07-22",0,0,0,0,0,0,0,0
"Saint Martin (French Part)","2024-07-23",0,0,0,0,0,0,0,0
"Saint Martin (French Part)","2024-07-24",0,0,0,0,0,0,0,0
"Saint Martin (French Part)","2024-07-25",0,0,0,0,0,0,0,0
"Saint Martin (French Part)","2024-07-26",0,0,0,0,0,0,0,0
"Saint Martin (French Part)","2024-07-27",0,0,0,0,0,0,0,0
"Saint Martin (French Part)","2024-07-28",0,0,0,0,0,0,0,0
"Saint Martin (French Part)","2024-07-29",0,0,0,0,0,0,0,0
"Saint Martin (French Part)","2024-07-30",0,0,0,0,0,0,0,0
"Saint Martin (French Part)","2024-07-31",0,0,0,0,0,0,0,0
"Saint Martin (French Part)","2024-08-01",0,0,0,0,0,0,0,0
"Saint Martin (French Part)","2024-08-02",0,0,0,0,0,0,0,0
"Saint Martin (French Part)","2024-08-03",0,0,0,0,0,0,0,0
"Saint Martin (French Part)","2024-08-04",0,0,0,0,0,0,0,0
"Saint Martin (French Part)","2024-08-05",0,0,0,0,0,0,0,0
"Saint Martin (French Part)","2024-08-06",0,0,0,0,0,0,0,0
"Saint Martin (French Part)","2024-08-07",0,0,0,0,0,0,0,0
"Saint Martin (French Part)","2024-08-08",0,0,0,0,0,0,0,0
"Saint Martin (French Part)","2024-08-09",0,0,0,0,0,0,0,0
"Saint Martin (French Part)","2024-08-10",0,0,0,0,0,0,0,0
"Saint Martin (French Part)","2024-08-11",0,0,0,0,0,0,0,0
"Saint Martin (French Part)","2024-08-12",0,0,0,0,0,0,0,0
"Saint Martin (French Part)","2024-08-13",0,0,0,0,0,0,0,0
"Saint Martin (French Part)","2024-08-14",0,0,0,0,0,0,0,0
"Saint Martin (French Part)","2024-08-15",0,0,0,0,0,0,0,0
"Saint Martin (French Part)","2024-08-16",0,0,0,0,0,0,0,0
"Saint Martin (French Part)","2024-08-17",0,0,0,0,0,0,0,0
"Saint Martin (French Part)","2024-08-18",0,0,0,0,0,0,0,0
"Saint Martin (French Part)","2024-08-19",0,0,0,0,0,0,0,0
"Saint Martin (French Part)","2024-08-20",0,0,0,0,0,0,0,0
"Saint Martin (French Part)","2024-08-21",0,0,0,0,0,0,0,0
"Saint Martin (French Part)","2024-08-22",0,0,0,0,0,0,0,0
"Saint Martin (French Part)","2024-08-23",0,0,0,0,0,0,0,0
"Saint Martin (French Part)","2024-08-24",0,0,0,0,0,0,0,0
"Saint Martin (French Part)","2024-08-25",0,0,0,0,0,0,0,0
"Saint Martin (French Part)","2024-08-26",0,0,0,0,0,0,0,0
"Saint Martin (French Part)","2024-08-27",0,0,0,0,0,0,0,0
"Saint Martin (French Part)","2024-08-28",0,0,0,0,0,0,0,0
"Saint Martin (French Part)","2024-08-29",0,0,0,0,0,0,0,0
"Saint Martin (French Part)","2024-08-30",0,0,0,0,0,0,0,0
"Saint Martin (French Part)","2024-08-31",0,0,0,0,0,0,0,0
"Saint Martin (French Part)","2024-09-01",0,0,0,0,0,0,0,0
"Saint Martin (French Part)","2024-09-02",0,0,0,0,0,0,0,0
"Saint Martin (French Part)","2024-09-03",0,0,0,0,0,0,0,0
"Saint Martin (French Part)","2024-09-04",0,0,0,0,0,0,0,0
"Saint Martin (French Part)","2024-09-05",0,0,0,0,0,0,0,0
"Saint Martin (French Part)","2024-09-06",0,0,0,0,0,0,0,0
"Saint Martin (French Part)","2024-09-07",0,0,0,0,0,0,0,0
"Saint Martin (French Part)","2024-09-08",0,0,0,0,0,0,0,0
"Saint Martin (French Part)","2024-09-09",0,0,0,0,0,0,0,0
"Saint Martin (French Part)","2024-09-10",0,0,0,0,0,0,0,0
"Saint Martin (French Part)","2024-09-11",0,0,0,0,0,0,0,0
"Saint Martin (French Part)","2024-09-12",0,0,0,0,0,0,0,0
"Saint Martin (French Part)","2024-09-13",0,0,0,0,0,0,0,0
"Saint Martin (French Part)","2024-09-14",0,0,0,0,0,0,0,0
"Saint Martin (French Part)","2024-09-15",0,0,0,0,0,0,0,0
"Saint Martin (French Part)","2024-09-16",0,0,0,0,0,0,0,0
"Saint Martin (French Part)","2024-09-17",0,0,0,0,0,0,0,0
"Saint Martin (French Part)","2024-09-18",0,0,0,0,0,0,0,0
"Saint Martin (French Part)","2024-09-19",0,0,0,0,0,0,0,0
"Saint Martin (French Part)","2024-09-20",0,0,0,0,0,0,0,0
"Saint Martin (French Part)","2024-09-21",0,0,0,0,0,0,0,0
"Saint Martin (French Part)","2024-09-22",0,0,0,0,0,0,0,0
"Saint Martin (French Part)","2024-09-23",0,0,0,0,0,0,0,0
"Saint Martin (French Part)","2024-09-24",0,0,0,0,0,0,0,0
"Saint Martin (French Part)","2024-09-25",0,0,0,0,0,0,0,0
"Saint Martin (French Part)","2024-09-26",0,0,0,0,0,0,0,0
"Saint Martin (French Part)","2024-09-27",0,0,0,0,0,0,0,0
"Saint Martin (French Part)","2024-09-28",0,0,0,0,0,0,0,0
"Saint Martin (French Part)","2024-09-29",0,0,0,0,0,0,0,0
"Saint Martin (French Part)","2024-09-30",0,0,0,0,0,0,0,0
"Saint Martin (French Part)","2024-10-01",0,0,0,0,0,0,0,0
"Saint Martin (French Part)","2024-10-02",0,0,0,0,0,0,0,0
"Saint Martin (French Part)","2024-10-03",0,0,0,0,0,0,0,0
"Saint Martin (French Part)","2024-10-04",0,0,0,0,0,0,0,0
"Saint Martin (French Part)","2024-10-05",0,0,0,0,0,0,0,0
"Saint Martin (French Part)","2024-10-06",0,0,0,0,0,0,0,0
"Saint Martin (French Part)","2024-10-07",0,0,0,0,0,0,0,0
"Saint Martin (French Part)","2024-10-08",0,0,0,0,0,0,0,0
"Saint Martin (French Part)","2024-10-09",0,0,0,0,0,0,0,0
"Saint Martin (French Part)","2024-10-10",0,0,0,0,0,0,0,0
"Saint Martin (French Part)","2024-10-11",0,0,0,0,0,0,0,0
"Saint Martin (French Part)","2024-10-12",0,0,0,0,0,0,0,0
"Saint Martin (French Part)","2024-10-13",0,0,0,0,0,0,0,0
"Saint Martin (French Part)","2024-10-14",0,0,0,0,0,0,0,0
"Saint Martin (French Part)","2024-10-15",0,0,0,0,0,0,0,0
"Saint Martin (French Part)","2024-10-16",0,0,0,0,0,0,0,0
"Saint Martin (French Part)","2024-10-17",0,0,0,0,0,0,0,0
"Saint Martin (French Part)","2024-10-18",0,0,0,0,0,0,0,0
"Saint Martin (French Part)","2024-10-19",0,0,0,0,0,0,0,0
"Saint Martin (French Part)","2024-10-20",0,0,0,0,0,0,0,0
"Saint Martin (French Part)","2024-10-21",0,0,0,0,0,0,0,0
"Saint Martin (French Part)","2024-10-22",0,0,0,0,0,0,0,0
"Saint Martin (French Part)","2024-10-23",0,0,0,0,0,0,0,0
"Saint Martin (French Part)","2024-10-24",0,0,0,0,0,0,0,0
"Saint Martin (French Part)","2024-10-25",0,0,0,0,0,0,0,0
"Saint Martin (French Part)","2024-10-26",0,0,0,0,0,0,0,0
"Saint Martin (French Part)","2024-10-27",0,0,0,0,0,0,0,0
"Saint Martin (French Part)","2024-10-28",0,0,0,0,0,0,0,0
"Saint Martin (French Part)","2024-10-29",0,0,0,0,0,0,0,0
"Saint Martin (French Part)","2024-10-30",0,0,0,0,0,0,0,0
"Saint Martin (French Part)","2024-10-31",0,0,0,0,0,0,0,0
"Saint Martin (French Part)","2024-11-01",0,0,0,0,0,0,0,0
"Saint Martin (French Part)","2024-11-02",0,0,0,0,0,0,0,0
"Saint Martin (French Part)","2024-11-03",0,0,0,0,0,0,0,0
"Saint Martin (French Part)","2024-11-04",0,0,0,0,0,0,0,0
"Saint Martin (French Part)","2024-11-05",0,0,0,0,0,0,0,0
"Saint Martin (French Part)","2024-11-06",0,0,0,0,0,0,0,0
"Saint Martin (French Part)","2024-11-07",0,0,0,0,0,0,0,0
"Saint Martin (French Part)","2024-11-08",0,0,0,0,0,0,0,0
"Saint Martin (French Part)","2024-11-09",0,0,0,0,0,0,0,0
"Saint Martin (French Part)","2024-11-10",0,0,0,0,0,0,0,0
"Saint Martin (French Part)","2024-11-11",0,0,0,0,0,0,0,0
"Saint Martin (French Part)","2024-11-12",0,0,0,0,0,0,0,0
"Saint Martin (French Part)","2024-11-13",0,0,0,0,0,0,0,0
"Saint Martin (French Part)","2024-11-14",0,0,0,0,0,0,0,0
"Saint Martin (French Part)","2024-11-15",0,0,0,0,0,0,0,0
"Saint Martin (French Part)","2024-11-16",0,0,0,0,0,0,0,0
"Saint Martin (French Part)","2024-11-17",0,0,0,0,0,0,0,0
"Saint Martin (French Part)","2024-11-18",0,0,0,0,0,0,0,0
"Saint Martin (French Part)","2024-11-19",0,0,0,0,0,0,0,0
"Saint Martin (French Part)","2024-11-20",0,0,0,0,0,0,0,0
"Saint Martin (French Part)","2024-11-21",0,0,0,0,0,0,0,0
"Saint Martin (French Part)","2024-11-22",0,0,0,0,0,0,0,0
"Saint Martin (French Part)","2024-11-23",0,0,0,0,0,0,0,0
"Saint Martin (French Part)","2024-11-24",0,0,0,0,0,0,0,0
"Saint Martin (French Part)","2024-11-25",0,0,0,0,0,0,0,0
"Saint Martin (French Part)","2024-11-26",0,0,0,0,0,0,0,0
"Saint Martin (French Part)","2024-11-27",0,0,0,0,0,0,0,0
"Saint Martin (French Part)","2024-11-28",0,0,0,0,0,0,0,0
"Saint Martin (French Part)","2024-11-29",0,0,0,0,0,0,0,0
"Saint Martin (French Part)","2024-11-30",0,0,0,0,0,0,0,0
"Saint Martin (French Part)","2024-12-01",0,0,0,0,0,0,0,0
"Saint Martin (French Part)","2024-12-02",0,0,0,0,0,0,0,0
"Saint Martin (French Part)","2024-12-03",0,0,0,0,0,0,0,0
"Saint Martin (French Part)","2024-12-04",0,0,0,0,0,0,0,0
"Saint Martin (French Part)","2024-12-05",0,0,0,0,0,0,0,0
"Saint Martin (French Part)","2024-12-06",0,0,0,0,0,0,0,0
"Saint Martin (French Part)","2024-12-07",0,0,0,0,0,0,0,0
"Saint Martin (French Part)","2024-12-08",0,0,0,0,0,0,0,0
"Saint Martin (French Part)","2024-12-09",0,0,0,0,0,0,0,0
"Saint Martin (French Part)","2024-12-10",0,0,0,0,0,0,0,0
"Saint Martin (French Part)","2024-12-11",0,0,0,0,0,0,0,0
"Saint Martin (French Part)","2024-12-12",0,0,0,0,0,0,0,0
"Saint Martin (French Part)","2024-12-13",0,0,0,0,0,0,0,0
"Saint Martin (French Part)","2024-12-14",0,0,0,0,0,0,0,0
"Saint Martin (French Part)","2024-12-15",0,0,0,0,0,0,0,0
"Saint Martin (French Part)","2024-12-16",0,0,0,0,0,0,0,0
"Saint Martin (French Part)","2024-12-17",0,0,0,0,0,0,0,0
"Saint Martin (French Part)","2024-12-18",0,0,0,0,0,0,0,0
"Saint Martin (French Part)","2024-12-19",0,0,0,0,0,0,0,0
"Saint Martin (French Part)","2024-12-20",0,0,0,0,0,0,0,0
"Saint Martin (French Part)","2024-12-21",0,0,0,0,0,0,0,0
"Saint Martin (French Part)","2024-12-22",0,0,0,0,0,0,0,0
"Saint Martin (French Part)","2024-12-23",0,0,0,0,0,0,0,0
"Saint Martin (French Part)","2024-12-24",0,0,0,0,0,0,0,0
"Saint Martin (French Part)","2024-12-25",0,0,0,0,0,0,0,0
"Saint Martin (French Part)","2024-12-26",0,0,0,0,0,0,0,0
"Saint Martin (French Part)","2024-12-27",0,0,0,0,0,0,0,0
"Saint Martin (French Part)","2024-12-28",0,0,0,0,0,0,0,0
"Saint Martin (French Part)","2024-12-29",0,0,0,0,0,0,0,0
"Saint Martin (French Part)","2024-12-30",0,0,0,0,0,0,0,0
"Saint Martin (French Part)","2024-12-31",0,0,0,0,0,0,0,0
"Saint Martin (French Part)","2025-01-01",0,0,0,0,0,0,0,0
"Saint Martin (French Part)","2025-01-02",0,0,0,0,0,0,0,0
"Saint Martin (French Part)","2025-01-03",0,0,0,0,0,0,0,0
"Saint Martin (French Part)","2025-01-04",0,0,0,0,0,0,0,0
"Saint Martin (French Part)","2025-01-05",0,0,0,0,0,0,0,0
"Saint Martin (French Part)","2025-01-06",0,0,0,0,0,0,0,0
"Saint Martin (French Part)","2025-01-07",0,0,0,0,0,0,0,0
"Saint Martin (French Part)","2025-01-08",0,0,0,0,0,0,0,0
"Saint Martin (French Part)","2025-01-09",0,0,0,0,0,0,0,0
"Saint Martin (French Part)","2025-01-10",0,0,0,0,0,0,0,0
"Saint Martin (French Part)","2025-01-11",0,0,0,0,0,0,0,0
"Saint Martin (French Part)","2025-01-12",0,0,0,0,0,0,0,0
"Saint Martin (French Part)","2025-01-13",0,0,0,0,0,0,0,0
"San Marino","2024-01-01",0,0,0,0,0,0,0,0
"San Marino","2024-01-02",0,0,0,0,0,0,0,0
"San Marino","2024-01-03",0,0,0,0,0,0,0,0
"San Marino","2024-01-04",0,0,0,0,0,0,0,0
"San Marino","2024-01-05",0,0,0,0,0,0,0,0
"San Marino","2024-01-06",0,0,0,0,0,0,0,0
"San Marino","2024-01-07",0,0,0,0,0,0,0,0
"San Marino","2024-01-08",0,0,0,0,0,0,0,0
"San Marino","2024-01-09",0,0,0,0,0,0,0,0
"San Marino","2024-01-10",0,0,0,0,0,0,0,0
"San Marino","2024-01-11",0,0,0,0,0,0,0,0
"San Marino","2024-01-12",0,0,0,0,0,0,0,0
"San Marino","2024-01-13",0,0,0,0,0,0,0,0
"San Marino","2024-01-14",0,0,0,0,0,0,0,0
"San Marino","2024-01-15",0,0,0,0,0,0,0,0
"San Marino","2024-01-16",0,0,0,0,0,0,0,0
"San Marino","2024-01-17",0,0,0,0,0,0,0,0
"San Marino","2024-01-18",0,0,0,0,0,0,0,0
"San Marino","2024-01-19",0,0,0,0,0,0,0,0
"San Marino","2024-01-20",0,0,0,0,0,0,0,0
"San Marino","2024-01-21",0,0,0,0,0,0,0,0
"San Marino","2024-01-22",0,0,0,0,0,0,0,0
"San Marino","2024-01-23",0,0,0,0,0,0,0,0
"San Marino","2024-01-24",0,0,0,0,0,0,0,0
"San Marino","2024-01-25",0,0,0,0,0,0,0,0
"San Marino","2024-01-26",0,0,0,0,0,0,0,0
"San Marino","2024-01-27",0,0,0,0,0,0,0,0
"San Marino","2024-01-28",0,0,0,0,0,0,0,0
"San Marino","2024-01-29",0,0,0,0,0,0,0,0
"San Marino","2024-01-30",0,0,0,0,0,0,0,0
"San Marino","2024-01-31",0,0,0,0,0,0,0,0
"San Marino","2024-02-01",0,0,0,0,0,0,0,0
"San Marino","2024-02-02",0,0,0,0,0,0,0,0
"San Marino","2024-02-03",0,0,0,0,0,0,0,0
"San Marino","2024-02-04",0,0,0,0,0,0,0,0
"San Marino","2024-02-05",0,0,0,0,0,0,0,0
"San Marino","2024-02-06",0,0,0,0,0,0,0,0
"San Marino","2024-02-07",0,0,0,0,0,0,0,0
"San Marino","2024-02-08",0,0,0,0,0,0,0,0
"San Marino","2024-02-09",0,0,0,0,0,0,0,0
"San Marino","2024-02-10",0,0,0,0,0,0,0,0
"San Marino","2024-02-11",0,0,0,0,0,0,0,0
"San Marino","2024-02-12",0,0,0,0,0,0,0,0
"San Marino","2024-02-13",0,0,0,0,0,0,0,0
"San Marino","2024-02-14",0,0,0,0,0,0,0,0
"San Marino","2024-02-15",0,0,0,0,0,0,0,0
"San Marino","2024-02-16",0,0,0,0,0,0,0,0
"San Marino","2024-02-17",0,0,0,0,0,0,0,0
"San Marino","2024-02-18",0,0,0,0,0,0,0,0
"San Marino","2024-02-19",0,0,0,0,0,0,0,0
"San Marino","2024-02-20",0,0,0,0,0,0,0,0
"San Marino","2024-02-21",0,0,0,0,0,0,0,0
"San Marino","2024-02-22",0,0,0,0,0,0,0,0
"San Marino","2024-02-23",0,0,0,0,0,0,0,0
"San Marino","2024-02-24",0,0,0,0,0,0,0,0
"San Marino","2024-02-25",0,0,0,0,0,0,0,0
"San Marino","2024-02-26",0,0,0,0,0,0,0,0
"San Marino","2024-02-27",0,0,0,0,0,0,0,0
"San Marino","2024-02-28",0,0,0,0,0,0,0,0
"San Marino","2024-02-29",0,0,0,0,0,0,0,0
"San Marino","2024-03-01",0,0,0,0,0,0,0,0
"San Marino","2024-03-02",0,0,0,0,0,0,0,0
"San Marino","2024-03-03",0,0,0,0,0,0,0,0
"San Marino","2024-03-04",0,0,0,0,0,0,0,0
"San Marino","2024-03-05",0,0,0,0,0,0,0,0
"San Marino","2024-03-06",0,0,0,0,0,0,0,0
"San Marino","2024-03-07",0,0,0,0,0,0,0,0
"San Marino","2024-03-08",0,0,0,0,0,0,0,0
"San Marino","2024-03-09",0,0,0,0,0,0,0,0
"San Marino","2024-03-10",0,0,0,0,0,0,0,0
"San Marino","2024-03-11",0,0,0,0,0,0,0,0
"San Marino","2024-03-12",0,0,0,0,0,0,0,0
"San Marino","2024-03-13",0,0,0,0,0,0,0,0
"San Marino","2024-03-14",0,0,0,0,0,0,0,0
"San Marino","2024-03-15",0,0,0,0,0,0,0,0
"San Marino","2024-03-16",0,0,0,0,0,0,0,0
"San Marino","2024-03-17",0,0,0,0,0,0,0,0
"San Marino","2024-03-18",0,0,0,0,0,0,0,0
"San Marino","2024-03-19",0,0,0,0,0,0,0,0
"San Marino","2024-03-20",0,0,0,0,0,0,0,0
"San Marino","2024-03-21",0,0,0,0,0,0,0,0
"San Marino","2024-03-22",0,0,0,0,0,0,0,0
"San Marino","2024-03-23",0,0,0,0,0,0,0,0
"San Marino","2024-03-24",0,0,0,0,0,0,0,0
"San Marino","2024-03-25",0,0,0,0,0,0,0,0
"San Marino","2024-03-26",0,0,0,0,0,0,0,0
"San Marino","2024-03-27",0,0,0,0,0,0,0,0
"San Marino","2024-03-28",0,0,0,0,0,0,0,0
"San Marino","2024-03-29",0,0,0,0,0,0,0,0
"San Marino","2024-03-30",0,0,0,0,0,0,0,0
"San Marino","2024-03-31",0,0,0,0,0,0,0,0
"San Marino","2024-04-01",0,0,0,0,0,0,0,0
"San Marino","2024-04-02",0,0,0,0,0,0,0,0
"San Marino","2024-04-03",0,0,0,0,0,0,0,0
"San Marino","2024-04-04",0,0,0,0,0,0,0,0
"San Marino","2024-04-05",0,0,0,0,0,0,0,0
"San Marino","2024-04-06",0,0,0,0,0,0,0,0
"San Marino","2024-04-07",0,0,0,0,0,0,0,0
"San Marino","2024-04-08",0,0,0,0,0,0,0,0
"San Marino","2024-04-09",0,0,0,0,0,0,0,0
"San Marino","2024-04-10",0,0,0,0,0,0,0,0
"San Marino","2024-04-11",0,0,0,0,0,0,0,0
"San Marino","2024-04-12",0,0,0,0,0,0,0,0
"San Marino","2024-04-13",0,0,0,0,0,0,0,0
"San Marino","2024-04-14",0,0,0,0,0,0,0,0
"San Marino","2024-04-15",0,0,0,0,0,0,0,0
"San Marino","2024-04-16",0,0,0,0,0,0,0,0
"San Marino","2024-04-17",0,0,0,0,0,0,0,0
"San Marino","2024-04-18",0,0,0,0,0,0,0,0
"San Marino","2024-04-19",0,0,0,0,0,0,0,0
"San Marino","2024-04-20",0,0,0,0,0,0,0,0
"San Marino","2024-04-21",0,0,0,0,0,0,0,0
"San Marino","2024-04-22",0,0,0,0,0,0,0,0
"San Marino","2024-04-23",0,0,0,0,0,0,0,0
"San Marino","2024-04-24",0,0,0,0,0,0,0,0
"San Marino","2024-04-25",0,0,0,0,0,0,0,0
"San Marino","2024-04-26",0,0,0,0,0,0,0,0
"San Marino","2024-04-27",0,0,0,0,0,0,0,0
"San Marino","2024-04-28",0,0,0,0,0,0,0,0
"San Marino","2024-04-29",0,0,0,0,0,0,0,0
"San Marino","2024-04-30",0,0,0,0,0,0,0,0
"San Marino","2024-05-01",0,0,0,0,0,0,0,0
"San Marino","2024-05-02",0,0,0,0,0,0,0,0
"San Marino","2024-05-03",0,0,0,0,0,0,0,0
"San Marino","2024-05-04",0,0,0,0,0,0,0,0
"San Marino","2024-05-05",0,0,0,0,0,0,0,0
"San Marino","2024-05-06",0,0,0,0,0,0,0,0
"San Marino","2024-05-07",0,0,0,0,0,0,0,0
"San Marino","2024-05-08",0,0,0,0,0,0,0,0
"San Marino","2024-05-09",0,0,0,0,0,0,0,0
"San Marino","2024-05-10",0,0,0,0,0,0,0,0
"San Marino","2024-05-11",0,0,0,0,0,0,0,0
"San Marino","2024-05-12",0,0,0,0,0,0,0,0
"San Marino","2024-05-13",0,0,0,0,0,0,0,0
"San Marino","2024-05-14",0,0,0,0,0,0,0,0
"San Marino","2024-05-15",0,0,0,0,0,0,0,0
"San Marino","2024-05-16",0,0,0,0,0,0,0,0
"San Marino","2024-05-17",0,0,0,0,0,0,0,0
"San Marino","2024-05-18",0,0,0,0,0,0,0,0
"San Marino","2024-05-19",0,0,0,0,0,0,0,0
"San Marino","2024-05-20",0,0,0,0,0,0,0,0
"San Marino","2024-05-21",0,0,0,0,0,0,0,0
"San Marino","2024-05-22",0,0,0,0,0,0,0,0
"San Marino","2024-05-23",0,0,0,0,0,0,0,0
"San Marino","2024-05-24",0,0,0,0,0,0,0,0
"San Marino","2024-05-25",0,0,0,0,0,0,0,0
"San Marino","2024-05-26",0,0,0,0,0,0,0,0
"San Marino","2024-05-27",0,0,0,0,0,0,0,0
"San Marino","2024-05-28",0,0,0,0,0,0,0,0
"San Marino","2024-05-29",0,0,0,0,0,0,0,0
"San Marino","2024-05-30",0,0,0,0,0,0,0,0
"San Marino","2024-05-31",0,0,0,0,0,0,0,0
"San Marino","2024-06-01",0,0,0,0,0,0,0,0
"San Marino","2024-06-02",0,0,0,0,0,0,0,0
"San Marino","2024-06-03",0,0,0,0,0,0,0,0
"San Marino","2024-06-04",0,0,0,0,0,0,0,0
"San Marino","2024-06-05",0,0,0,0,0,0,0,0
"San Marino","2024-06-06",0,0,0,0,0,0,0,0
"San Marino","2024-06-07",0,0,0,0,0,0,0,0
"San Marino","2024-06-08",0,0,0,0,0,0,0,0
"San Marino","2024-06-09",0,0,0,0,0,0,0,0
"San Marino","2024-06-10",0,0,0,0,0,0,0,0
"San Marino","2024-06-11",0,0,0,0,0,0,0,0
"San Marino","2024-06-12",0,0,0,0,0,0,0,0
"San Marino","2024-06-13",0,0,0,0,0,0,0,0
"San Marino","2024-06-14",0,0,0,0,0,0,0,0
"San Marino","2024-06-15",0,0,0,0,0,0,0,0
"San Marino","2024-06-16",0,0,0,0,0,0,0,0
"San Marino","2024-06-17",0,0,0,0,0,0,0,0
"San Marino","2024-06-18",0,0,0,0,0,0,0,0
"San Marino","2024-06-19",0,0,0,0,0,0,0,0
"San Marino","2024-06-20",0,0,0,0,0,0,0,0
"San Marino","2024-06-21",0,0,0,0,0,0,0,0
"San Marino","2024-06-22",0,0,0,0,0,0,0,0
"San Marino","2024-06-23",0,0,0,0,0,0,0,0
"San Marino","2024-06-24",0,0,0,0,0,0,0,0
"San Marino","2024-06-25",0,0,0,0,0,0,0,0
"San Marino","2024-06-26",0,0,0,0,0,0,0,0
"San Marino","2024-06-27",0,0,0,0,0,0,0,0
"San Marino","2024-06-28",0,0,0,0,0,0,0,0
"San Marino","2024-06-29",0,0,0,0,0,0,0,0
"San Marino","2024-06-30",0,0,0,0,0,0,0,0
"San Marino","2024-07-01",0,0,0,0,0,0,0,0
"San Marino","2024-07-02",0,0,0,0,0,0,0,0
"San Marino","2024-07-03",0,0,0,0,0,0,0,0
"San Marino","2024-07-04",0,0,0,0,0,0,0,0
"San Marino","2024-07-05",0,0,0,0,0,0,0,0
"San Marino","2024-07-06",0,0,0,0,0,0,0,0
"San Marino","2024-07-07",0,0,0,0,0,0,0,0
"San Marino","2024-07-08",0,0,0,0,0,0,0,0
"San Marino","2024-07-09",0,0,0,0,0,0,0,0
"San Marino","2024-07-10",0,0,0,0,0,0,0,0
"San Marino","2024-07-11",0,0,0,0,0,0,0,0
"San Marino","2024-07-12",0,0,0,0,0,0,0,0
"San Marino","2024-07-13",0,0,0,0,0,0,0,0
"San Marino","2024-07-14",0,0,0,0,0,0,0,0
"San Marino","2024-07-15",0,0,0,0,0,0,0,0
"San Marino","2024-07-16",0,0,0,0,0,0,0,0
"San Marino","2024-07-17",0,0,0,0,0,0,0,0
"San Marino","2024-07-18",0,0,0,0,0,0,0,0
"San Marino","2024-07-19",0,0,0,0,0,0,0,0
"San Marino","2024-07-20",0,0,0,0,0,0,0,0
"San Marino","2024-07-21",0,0,0,0,0,0,0,0
"San Marino","2024-07-22",0,0,0,0,0,0,0,0
"San Marino","2024-07-23",0,0,0,0,0,0,0,0
"San Marino","2024-07-24",0,0,0,0,0,0,0,0
"San Marino","2024-07-25",0,0,0,0,0,0,0,0
"San Marino","2024-07-26",0,0,0,0,0,0,0,0
"San Marino","2024-07-27",0,0,0,0,0,0,0,0
"San Marino","2024-07-28",0,0,0,0,0,0,0,0
"San Marino","2024-07-29",0,0,0,0,0,0,0,0
"San Marino","2024-07-30",0,0,0,0,0,0,0,0
"San Marino","2024-07-31",0,0,0,0,0,0,0,0
"San Marino","2024-08-01",0,0,0,0,0,0,0,0
"San Marino","2024-08-02",0,0,0,0,0,0,0,0
"San Marino","2024-08-03",0,0,0,0,0,0,0,0
"San Marino","2024-08-04",0,0,0,0,0,0,0,0
"San Marino","2024-08-05",0,0,0,0,0,0,0,0
"San Marino","2024-08-06",0,0,0,0,0,0,0,0
"San Marino","2024-08-07",0,0,0,0,0,0,0,0
"San Marino","2024-08-08",0,0,0,0,0,0,0,0
"San Marino","2024-08-09",0,0,0,0,0,0,0,0
"San Marino","2024-08-10",0,0,0,0,0,0,0,0
"San Marino","2024-08-11",0,0,0,0,0,0,0,0
"San Marino","2024-08-12",0,0,0,0,0,0,0,0
"San Marino","2024-08-13",0,0,0,0,0,0,0,0
"San Marino","2024-08-14",0,0,0,0,0,0,0,0
"San Marino","2024-08-15",0,0,0,0,0,0,0,0
"San Marino","2024-08-16",0,0,0,0,0,0,0,0
"San Marino","2024-08-17",0,0,0,0,0,0,0,0
"San Marino","2024-08-18",0,0,0,0,0,0,0,0
"San Marino","2024-08-19",0,0,0,0,0,0,0,0
"San Marino","2024-08-20",0,0,0,0,0,0,0,0
"San Marino","2024-08-21",0,0,0,0,0,0,0,0
"San Marino","2024-08-22",0,0,0,0,0,0,0,0
"San Marino","2024-08-23",0,0,0,0,0,0,0,0
"San Marino","2024-08-24",0,0,0,0,0,0,0,0
"San Marino","2024-08-25",0,0,0,0,0,0,0,0
"San Marino","2024-08-26",0,0,0,0,0,0,0,0
"San Marino","2024-08-27",0,0,0,0,0,0,0,0
"San Marino","2024-08-28",0,0,0,0,0,0,0,0
"San Marino","2024-08-29",0,0,0,0,0,0,0,0
"San Marino","2024-08-30",0,0,0,0,0,0,0,0
"San Marino","2024-08-31",0,0,0,0,0,0,0,0
"San Marino","2024-09-01",0,0,0,0,0,0,0,0
"San Marino","2024-09-02",0,0,0,0,0,0,0,0
"San Marino","2024-09-03",0,0,0,0,0,0,0,0
"San Marino","2024-09-04",0,0,0,0,0,0,0,0
"San Marino","2024-09-05",0,0,0,0,0,0,0,0
"San Marino","2024-09-06",0,0,0,0,0,0,0,0
"San Marino","2024-09-07",0,0,0,0,0,0,0,0
"San Marino","2024-09-08",0,0,0,0,0,0,0,0
"San Marino","2024-09-09",0,0,0,0,0,0,0,0
"San Marino","2024-09-10",0,0,0,0,0,0,0,0
"San Marino","2024-09-11",0,0,0,0,0,0,0,0
"San Marino","2024-09-12",0,0,0,0,0,0,0,0
"San Marino","2024-09-13",0,0,0,0,0,0,0,0
"San Marino","2024-09-14",0,0,0,0,0,0,0,0
"San Marino","2024-09-15",0,0,0,0,0,0,0,0
"San Marino","2024-09-16",0,0,0,0,0,0,0,0
"San Marino","2024-09-17",0,0,0,0,0,0,0,0
"San Marino","2024-09-18",0,0,0,0,0,0,0,0
"San Marino","2024-09-19",0,0,0,0,0,0,0,0
"San Marino","2024-09-20",0,0,0,0,0,0,0,0
"San Marino","2024-09-21",0,0,0,0,0,0,0,0
"San Marino","2024-09-22",0,0,0,0,0,0,0,0
"San Marino","2024-09-23",0,0,0,0,0,0,0,0
"San Marino","2024-09-24",0,0,0,0,0,0,0,0
"San Marino","2024-09-25",0,0,0,0,0,0,0,0
"San Marino","2024-09-26",0,0,0,0,0,0,0,0
"San Marino","2024-09-27",0,0,0,0,0,0,0,0
"San Marino","2024-09-28",0,0,0,0,0,0,0,0
"San Marino","2024-09-29",0,0,0,0,0,0,0,0
"San Marino","2024-09-30",0,0,0,0,0,0,0,0
"San Marino","2024-10-01",0,0,0,0,0,0,0,0
"San Marino","2024-10-02",0,0,0,0,0,0,0,0
"San Marino","2024-10-03",0,0,0,0,0,0,0,0
"San Marino","2024-10-04",0,0,0,0,0,0,0,0
"San Marino","2024-10-05",0,0,0,0,0,0,0,0
"San Marino","2024-10-06",0,0,0,0,0,0,0,0
"San Marino","2024-10-07",0,0,0,0,0,0,0,0
"San Marino","2024-10-08",0,0,0,0,0,0,0,0
"San Marino","2024-10-09",0,0,0,0,0,0,0,0
"San Marino","2024-10-10",0,0,0,0,0,0,0,0
"San Marino","2024-10-11",0,0,0,0,0,0,0,0
"San Marino","2024-10-12",0,0,0,0,0,0,0,0
"San Marino","2024-10-13",0,0,0,0,0,0,0,0
"San Marino","2024-10-14",0,0,0,0,0,0,0,0
"San Marino","2024-10-15",0,0,0,0,0,0,0,0
"San Marino","2024-10-16",0,0,0,0,0,0,0,0
"San Marino","2024-10-17",0,0,0,0,0,0,0,0
"San Marino","2024-10-18",0,0,0,0,0,0,0,0
"San Marino","2024-10-19",0,0,0,0,0,0,0,0
"San Marino","2024-10-20",0,0,0,0,0,0,0,0
"San Marino","2024-10-21",0,0,0,0,0,0,0,0
"San Marino","2024-10-22",0,0,0,0,0,0,0,0
"San Marino","2024-10-23",0,0,0,0,0,0,0,0
"San Marino","2024-10-24",0,0,0,0,0,0,0,0
"San Marino","2024-10-25",0,0,0,0,0,0,0,0
"San Marino","2024-10-26",0,0,0,0,0,0,0,0
"San Marino","2024-10-27",0,0,0,0,0,0,0,0
"San Marino","2024-10-28",0,0,0,0,0,0,0,0
"San Marino","2024-10-29",0,0,0,0,0,0,0,0
"San Marino","2024-10-30",0,0,0,0,0,0,0,0
"San Marino","2024-10-31",0,0,0,0,0,0,0,0
"San Marino","2024-11-01",0,0,0,0,0,0,0,0
"San Marino","2024-11-02",0,0,0,0,0,0,0,0
"San Marino","2024-11-03",0,0,0,0,0,0,0,0
"San Marino","2024-11-04",0,0,0,0,0,0,0,0
"San Marino","2024-11-05",0,0,0,0,0,0,0,0
"San Marino","2024-11-06",0,0,0,0,0,0,0,0
"San Marino","2024-11-07",0,0,0,0,0,0,0,0
"San Marino","2024-11-08",0,0,0,0,0,0,0,0
"San Marino","2024-11-09",0,0,0,0,0,0,0,0
"San Marino","2024-11-10",0,0,0,0,0,0,0,0
"San Marino","2024-11-11",0,0,0,0,0,0,0,0
"San Marino","2024-11-12",0,0,0,0,0,0,0,0
"San Marino","2024-11-13",0,0,0,0,0,0,0,0
"San Marino","2024-11-14",0,0,0,0,0,0,0,0
"San Marino","2024-11-15",0,0,0,0,0,0,0,0
"San Marino","2024-11-16",0,0,0,0,0,0,0,0
"San Marino","2024-11-17",0,0,0,0,0,0,0,0
"San Marino","2024-11-18",0,0,0,0,0,0,0,0
"San Marino","2024-11-19",0,0,0,0,0,0,0,0
"San Marino","2024-11-20",0,0,0,0,0,0,0,0
"San Marino","2024-11-21",0,0,0,0,0,0,0,0
"San Marino","2024-11-22",0,0,0,0,0,0,0,0
"San Marino","2024-11-23",0,0,0,0,0,0,0,0
"San Marino","2024-11-24",0,0,0,0,0,0,0,0
"San Marino","2024-11-25",0,0,0,0,0,0,0,0
"San Marino","2024-11-26",0,0,0,0,0,0,0,0
"San Marino","2024-11-27",0,0,0,0,0,0,0,0
"San Marino","2024-11-28",0,0,0,0,0,0,0,0
"San Marino","2024-11-29",0,0,0,0,0,0,0,0
"San Marino","2024-11-30",0,0,0,0,0,0,0,0
"San Marino","2024-12-01",0,0,0,0,0,0,0,0
"San Marino","2024-12-02",0,0,0,0,0,0,0,0
"San Marino","2024-12-03",0,0,0,0,0,0,0,0
"San Marino","2024-12-04",0,0,0,0,0,0,0,0
"San Marino","2024-12-05",0,0,0,0,0,0,0,0
"San Marino","2024-12-06",0,0,0,0,0,0,0,0
"San Marino","2024-12-07",0,0,0,0,0,0,0,0
"San Marino","2024-12-08",0,0,0,0,0,0,0,0
"San Marino","2024-12-09",0,0,0,0,0,0,0,0
"San Marino","2024-12-10",0,0,0,0,0,0,0,0
"San Marino","2024-12-11",0,0,0,0,0,0,0,0
"San Marino","2024-12-12",0,0,0,0,0,0,0,0
"San Marino","2024-12-13",0,0,0,0,0,0,0,0
"San Marino","2024-12-14",0,0,0,0,0,0,0,0
"San Marino","2024-12-15",0,0,0,0,0,0,0,0
"San Marino","2024-12-16",0,0,0,0,0,0,0,0
"San Marino","2024-12-17",0,0,0,0,0,0,0,0
"San Marino","2024-12-18",0,0,0,0,0,0,0,0
"San Marino","2024-12-19",0,0,0,0,0,0,0,0
"San Marino","2024-12-20",0,0,0,0,0,0,0,0
"San Marino","2024-12-21",0,0,0,0,0,0,0,0
"San Marino","2024-12-22",0,0,0,0,0,0,0,0
"San Marino","2024-12-23",0,0,0,0,0,0,0,0
"San Marino","2024-12-24",0,0,0,0,0,0,0,0
"San Marino","2024-12-25",0,0,0,0,0,0,0,0
"San Marino","2024-12-26",0,0,0,0,0,0,0,0
"San Marino","2024-12-27",0,0,0,0,0,0,0,0
"San Marino","2024-12-28",0,0,0,0,0,0,0,0
"San Marino","2024-12-29",0,0,0,0,0,0,0,0
"San Marino","2024-12-30",0,0,0,0,0,0,0,0
"San Marino","2024-12-31",0,0,0,0,0,0,0,0
"San Marino","2025-01-01",0,0,0,0,0,0,0,0
"San Marino","2025-01-02",0,0,0,0,0,0,0,0
"San Marino","2025-01-03",0,0,0,0,0,0,0,0
"San Marino","2025-01-04",0,0,0,0,0,0,0,0
"San Marino","2025-01-05",0,0,0,0,0,0,0,0
"San Marino","2025-01-06",0,0,0,0,0,0,0,0
"San Marino","2025-01-07",0,0,0,0,0,0,0,0
"San Marino","2025-01-08",0,0,0,0,0,0,0,0
"San Marino","2025-01-09",0,0,0,0,0,0,0,0
"San Marino","2025-01-10",0,0,0,0,0,0,0,0
"San Marino","2025-01-11",0,0,0,0,0,0,0,0
"San Marino","2025-01-12",0,0,0,0,0,0,0,0
"San Marino","2025-01-13",0,0,0,0,0,0,0,0
"Saudi Arabia","2024-01-01",0,0,0,0,0,0,0,0
"Saudi Arabia","2024-01-02",0,0,0,0,0,0,0,0
"Saudi Arabia","2024-01-03",0,0,0,0,0,0,0,0
"Saudi Arabia","2024-01-04",0,0,0,0,0,0,0,0
"Saudi Arabia","2024-01-05",0,0,0,0,0,0,0,0
"Saudi Arabia","2024-01-06",0,0,0,0,0,0,0,0
"Saudi Arabia","2024-01-07",0,0,0,0,0,0,0,0
"Saudi Arabia","2024-01-08",0,0,0,0,0,0,0,0
"Saudi Arabia","2024-01-09",0,0,0,0,0,0,0,0
"Saudi Arabia","2024-01-10",0,0,0,0,0,0,0,0
"Saudi Arabia","2024-01-11",0,0,0,0,0,0,0,0
"Saudi Arabia","2024-01-12",0,0,0,0,0,0,0,0
"Saudi Arabia","2024-01-13",0,0,0,0,0,0,0,0
"Saudi Arabia","2024-01-14",0,0,0,0,0,0,0,0
"Saudi Arabia","2024-01-15",0,0,0,0,0,0,0,0
"Saudi Arabia","2024-01-16",0,0,0,0,0,0,0,0
"Saudi Arabia","2024-01-17",0,0,0,0,0,0,0,0
"Saudi Arabia","2024-01-18",0,0,0,0,0,0,0,0
"Saudi Arabia","2024-01-19",0,0,0,0,0,0,0,0
"Saudi Arabia","2024-01-20",0,0,0,0,0,0,0,0
"Saudi Arabia","2024-01-21",0,0,0,0,0,0,0,0
"Saudi Arabia","2024-01-22",0,0,0,0,0,0,0,0
"Saudi Arabia","2024-01-23",0,0,0,0,0,0,0,0
"Saudi Arabia","2024-01-24",0,0,0,0,0,0,0,0
"Saudi Arabia","2024-01-25",0,0,0,0,0,0,0,0
"Saudi Arabia","2024-01-26",0,0,0,0,0,0,0,0
"Saudi Arabia","2024-01-27",0,0,0,0,0,0,0,0
"Saudi Arabia","2024-01-28",0,0,0,0,0,0,0,0
"Saudi Arabia","2024-01-29",0,0,0,0,0,0,0,0
"Saudi Arabia","2024-01-30",0,0,0,0,0,0,0,0
"Saudi Arabia","2024-01-31",0,16,16,0,16,16,0,0
"Saudi Arabia","2024-02-01",0,0,16,0,1,17,0,0
"Saudi Arabia","2024-02-02",0,0,16,0,0,17,0,0
"Saudi Arabia","2024-02-03",0,0,16,0,1,18,0,0
"Saudi Arabia","2024-02-04",0,0,16,0,0,18,0,0
"Saudi Arabia","2024-02-05",0,0,16,0,1,19,0,0
"Saudi Arabia","2024-02-06",0,0,16,0,0,19,0,0
"Saudi Arabia","2024-02-07",0,0,16,0,1,20,0,0
"Saudi Arabia","2024-02-08",0,0,16,0,0,20,0,0
"Saudi Arabia","2024-02-09",0,0,16,0,1,21,0,0
"Saudi Arabia","2024-02-10",0,0,16,0,0,21,0,0
"Saudi Arabia","2024-02-11",0,0,16,0,1,22,0,0
"Saudi Arabia","2024-02-12",0,0,16,0,0,22,0,0
"Saudi Arabia","2024-02-13",0,0,16,0,1,23,0,0
"Saudi Arabia","2024-02-14",0,0,16,0,1,24,0,0
"Saudi Arabia","2024-02-15",0,0,16,0,0,24,0,0
"Saudi Arabia","2024-02-16",0,0,16,0,1,25,0,0
"Saudi Arabia","2024-02-17",0,0,16,0,0,25,0,0
"Saudi Arabia","2024-02-18",0,0,16,0,1,26,0,0
"Saudi Arabia","2024-02-19",0,0,16,0,0,26,0,0
"Saudi Arabia","2024-02-20",0,0,16,0,1,27,0,0
"Saudi Arabia","2024-02-21",0,0,16,0,0,27,0,0
"Saudi Arabia","2024-02-22",0,0,16,0,1,28,0,0
"Saudi Arabia","2024-02-23",0,0,16,0,0,28,0,0
"Saudi Arabia","2024-02-24",0,0,16,0,1,29,0,0
"Saudi Arabia","2024-02-25",0,0,16,0,0,29,0,0
"Saudi Arabia","2024-02-26",0,0,16,0,1,30,0,0
"Saudi Arabia","2024-02-27",0,0,16,0,0,30,0,0
"Saudi Arabia","2024-02-28",0,15,31,0,1,31,0,0
"Saudi Arabia","2024-02-29",0,0,31,0,1,32,0,0
"Saudi Arabia","2024-03-01",0,0,31,0,0,32,0,0
"Saudi Arabia","2024-03-02",0,0,31,0,1,33,0,0
"Saudi Arabia","2024-03-03",0,0,31,0,0,33,0,0
"Saudi Arabia","2024-03-04",0,0,31,0,1,34,0,0
"Saudi Arabia","2024-03-05",0,0,31,0,1,35,0,0
"Saudi Arabia","2024-03-06",0,0,31,0,0,35,0,0
"Saudi Arabia","2024-03-07",0,0,31,0,1,36,0,0
"Saudi Arabia","2024-03-08",0,0,31,0,1,37,0,0
"Saudi Arabia","2024-03-09",0,0,31,0,0,37,0,0
"Saudi Arabia","2024-03-10",0,0,31,0,1,38,0,0
"Saudi Arabia","2024-03-11",0,0,31,0,1,39,0,0
"Saudi Arabia","2024-03-12",0,0,31,0,0,39,0,0
"Saudi Arabia","2024-03-13",0,0,31,0,1,40,0,0
"Saudi Arabia","2024-03-14",0,0,31,0,0,40,0,0
"Saudi Arabia","2024-03-15",0,0,31,0,1,41,0,0
"Saudi Arabia","2024-03-16",0,0,31,0,1,42,0,0
"Saudi Arabia","2024-03-17",0,0,31,0,0,42,0,0
"Saudi Arabia","2024-03-18",0,0,31,0,1,43,0,0
"Saudi Arabia","2024-03-19",0,0,31,0,0,43,0,0
"Saudi Arabia","2024-03-20",0,0,31,0,1,44,0,0
"Saudi Arabia","2024-03-21",0,0,31,0,1,45,0,0
"Saudi Arabia","2024-03-22",0,0,31,0,0,45,0,0
"Saudi Arabia","2024-03-23",0,0,31,0,1,46,0,0
"Saudi Arabia","2024-03-24",0,0,31,0,1,47,0,0
"Saudi Arabia","2024-03-25",0,0,31,0,0,47,0,0
"Saudi Arabia","2024-03-26",0,0,31,0,1,48,0,0
"Saudi Arabia","2024-03-27",0,0,31,0,1,49,0,0
"Saudi Arabia","2024-03-28",0,0,31,0,0,49,0,0
"Saudi Arabia","2024-03-29",0,0,31,0,1,50,0,0
"Saudi Arabia","2024-03-30",0,0,31,0,0,50,0,0
"Saudi Arabia","2024-03-31",0,20,51,0,1,51,0,0
"Saudi Arabia","2024-04-01",0,0,51,0,0,51,0,0
"Saudi Arabia","2024-04-02",0,0,51,0,1,52,0,0
"Saudi Arabia","2024-04-03",0,0,51,0,0,52,0,0
"Saudi Arabia","2024-04-04",0,0,51,0,1,53,0,0
"Saudi Arabia","2024-04-05",0,0,51,0,0,53,0,0
"Saudi Arabia","2024-04-06",0,0,51,0,1,54,0,0
"Saudi Arabia","2024-04-07",0,0,51,0,0,54,0,0
"Saudi Arabia","2024-04-08",0,0,51,0,0,54,0,0
"Saudi Arabia","2024-04-09",0,0,51,0,1,55,0,0
"Saudi Arabia","2024-04-10",0,0,51,0,0,55,0,0
"Saudi Arabia","2024-04-11",0,0,51,0,1,56,0,0
"Saudi Arabia","2024-04-12",0,0,51,0,0,56,0,0
"Saudi Arabia","2024-04-13",0,0,51,0,1,57,0,0
"Saudi Arabia","2024-04-14",0,0,51,0,0,57,0,0
"Saudi Arabia","2024-04-15",0,0,51,0,0,57,0,0
"Saudi Arabia","2024-04-16",0,0,51,0,1,58,0,0
"Saudi Arabia","2024-04-17",0,0,51,0,0,58,0,0
"Saudi Arabia","2024-04-18",0,0,51,0,1,59,0,0
"Saudi Arabia","2024-04-19",0,0,51,0,0,59,0,0
"Saudi Arabia","2024-04-20",0,0,51,0,1,60,0,0
"Saudi Arabia","2024-04-21",0,0,51,0,0,60,0,0
"Saudi Arabia","2024-04-22",0,0,51,0,1,61,0,0
"Saudi Arabia","2024-04-23",0,0,51,0,0,61,0,0
"Saudi Arabia","2024-04-24",0,0,51,0,0,61,0,0
"Saudi Arabia","2024-04-25",0,0,51,0,1,62,0,0
"Saudi Arabia","2024-04-26",0,0,51,0,0,62,0,0
"Saudi Arabia","2024-04-27",0,0,51,0,1,63,0,0
"Saudi Arabia","2024-04-28",0,0,51,0,0,63,0,0
"Saudi Arabia","2024-04-29",0,0,51,0,1,64,0,0
"Saudi Arabia","2024-04-30",0,13,64,0,0,64,0,0
"Saudi Arabia","2024-05-01",0,0,64,0,0,64,0,0
"Saudi Arabia","2024-05-02",0,0,64,0,1,65,0,0
"Saudi Arabia","2024-05-03",0,0,64,0,0,65,0,0
"Saudi Arabia","2024-05-04",0,0,64,0,1,66,0,0
"Saudi Arabia","2024-05-05",0,0,64,0,0,66,0,0
"Saudi Arabia","2024-05-06",0,0,64,0,1,67,0,0
"Saudi Arabia","2024-05-07",0,0,64,0,0,67,0,0
"Saudi Arabia","2024-05-08",0,0,64,0,1,68,0,0
"Saudi Arabia","2024-05-09",0,0,64,0,0,68,0,0
"Saudi Arabia","2024-05-10",0,0,64,0,1,69,0,0
"Saudi Arabia","2024-05-11",0,0,64,0,0,69,0,0
"Saudi Arabia","2024-05-12",0,0,64,0,1,70,0,0
"Saudi Arabia","2024-05-13",0,0,64,0,0,70,0,0
"Saudi Arabia","2024-05-14",0,0,64,0,1,71,0,0
"Saudi Arabia","2024-05-15",0,0,64,0,0,71,0,0
"Saudi Arabia","2024-05-16",0,0,64,0,1,72,0,0
"Saudi Arabia","2024-05-17",0,0,64,0,0,72,0,0
"Saudi Arabia","2024-05-18",0,0,64,0,1,73,0,0
"Saudi Arabia","2024-05-19",0,0,64,0,0,73,0,0
"Saudi Arabia","2024-05-20",0,0,64,0,1,74,0,0
"Saudi Arabia","2024-05-21",0,0,64,0,0,74,0,0
"Saudi Arabia","2024-05-22",0,0,64,0,1,75,0,0
"Saudi Arabia","2024-05-23",0,0,64,0,0,75,0,0
"Saudi Arabia","2024-05-24",0,0,64,0,1,76,0,0
"Saudi Arabia","2024-05-25",0,0,64,0,0,76,0,0
"Saudi Arabia","2024-05-26",0,0,64,0,1,77,0,0
"Saudi Arabia","2024-05-27",0,0,64,0,0,77,0,0
"Saudi Arabia","2024-05-28",0,0,64,0,1,78,0,0
"Saudi Arabia","2024-05-29",0,0,64,0,0,78,0,0
"Saudi Arabia","2024-05-30",0,0,64,0,1,79,0,0
"Saudi Arabia","2024-05-31",0,15,79,0,0,79,0,0
"Saudi Arabia","2024-06-01",0,0,79,0,0,79,0,0
"Saudi Arabia","2024-06-02",0,0,79,0,0,79,0,0
"Saudi Arabia","2024-06-03",0,0,79,0,1,80,0,0
"Saudi Arabia","2024-06-04",0,0,79,0,0,80,0,0
"Saudi Arabia","2024-06-05",0,0,79,0,0,80,0,0
"Saudi Arabia","2024-06-06",0,0,79,0,0,80,0,0
"Saudi Arabia","2024-06-07",0,0,79,0,0,80,0,0
"Saudi Arabia","2024-06-08",0,0,79,0,1,81,0,0
"Saudi Arabia","2024-06-09",0,0,79,0,0,81,0,0
"Saudi Arabia","2024-06-10",0,0,79,0,0,81,0,0
"Saudi Arabia","2024-06-11",0,0,79,0,0,81,0,0
"Saudi Arabia","2024-06-12",0,0,79,0,0,81,0,0
"Saudi Arabia","2024-06-13",0,0,79,0,1,82,0,0
"Saudi Arabia","2024-06-14",0,0,79,0,0,82,0,0
"Saudi Arabia","2024-06-15",0,0,79,0,0,82,0,0
"Saudi Arabia","2024-06-16",0,0,79,0,0,82,0,0
"Saudi Arabia","2024-06-17",0,0,79,0,0,82,0,0
"Saudi Arabia","2024-06-18",0,0,79,0,1,83,0,0
"Saudi Arabia","2024-06-19",0,0,79,0,0,83,0,0
"Saudi Arabia","2024-06-20",0,0,79,0,0,83,0,0
"Saudi Arabia","2024-06-21",0,0,79,0,0,83,0,0
"Saudi Arabia","2024-06-22",0,0,79,0,0,83,0,0
"Saudi Arabia","2024-06-23",0,0,79,0,1,84,0,0
"Saudi Arabia","2024-06-24",0,0,79,0,0,84,0,0
"Saudi Arabia","2024-06-25",0,0,79,0,0,84,0,0
"Saudi Arabia","2024-06-26",0,0,79,0,0,84,0,0
"Saudi Arabia","2024-06-27",0,0,79,0,0,84,0,0
"Saudi Arabia","2024-06-28",0,0,79,0,1,85,0,0
"Saudi Arabia","2024-06-29",0,0,79,0,0,85,0,0
"Saudi Arabia","2024-06-30",0,6,85,0,0,85,0,0
"Saudi Arabia","2024-07-01",0,0,85,0,0,85,0,0
"Saudi Arabia","2024-07-02",0,0,85,0,1,86,0,0
"Saudi Arabia","2024-07-03",0,0,85,0,0,86,0,0
"Saudi Arabia","2024-07-04",0,0,85,0,0,86,0,0
"Saudi Arabia","2024-07-05",0,0,85,0,0,86,0,0
"Saudi Arabia","2024-07-06",0,0,85,0,1,87,0,0
"Saudi Arabia","2024-07-07",0,0,85,0,0,87,0,0
"Saudi Arabia","2024-07-08",0,0,85,0,0,87,0,0
"Saudi Arabia","2024-07-09",0,0,85,0,1,88,0,0
"Saudi Arabia","2024-07-10",0,0,85,0,0,88,0,0
"Saudi Arabia","2024-07-11",0,0,85,0,0,88,0,0
"Saudi Arabia","2024-07-12",0,0,85,0,0,88,0,0
"Saudi Arabia","2024-07-13",0,0,85,0,1,89,0,0
"Saudi Arabia","2024-07-14",0,0,85,0,0,89,0,0
"Saudi Arabia","2024-07-15",0,0,85,0,0,89,0,0
"Saudi Arabia","2024-07-16",0,0,85,0,1,90,0,0
"Saudi Arabia","2024-07-17",0,0,85,0,0,90,0,0
"Saudi Arabia","2024-07-18",0,0,85,0,0,90,0,0
"Saudi Arabia","2024-07-19",0,0,85,0,1,91,0,0
"Saudi Arabia","2024-07-20",0,0,85,0,0,91,0,0
"Saudi Arabia","2024-07-21",0,0,85,0,0,91,0,0
"Saudi Arabia","2024-07-22",0,0,85,0,0,91,0,0
"Saudi Arabia","2024-07-23",0,0,85,0,1,92,0,0
"Saudi Arabia","2024-07-24",0,0,85,0,0,92,0,0
"Saudi Arabia","2024-07-25",0,0,85,0,0,92,0,0
"Saudi Arabia","2024-07-26",0,0,85,0,1,93,0,0
"Saudi Arabia","2024-07-27",0,0,85,0,0,93,0,0
"Saudi Arabia","2024-07-28",0,0,85,0,0,93,0,0
"Saudi Arabia","2024-07-29",0,0,85,0,0,93,0,0
"Saudi Arabia","2024-07-30",0,0,85,0,1,94,0,0
"Saudi Arabia","2024-07-31",0,9,94,0,0,94,0,0
"Saudi Arabia","2024-08-01",0,0,94,0,0,94,0,0
"Saudi Arabia","2024-08-02",0,0,94,0,0,94,0,0
"Saudi Arabia","2024-08-03",0,0,94,0,0,94,0,0
"Saudi Arabia","2024-08-04",0,0,94,0,0,94,0,0
"Saudi Arabia","2024-08-05",0,0,94,0,0,94,0,0
"Saudi Arabia","2024-08-06",0,0,94,0,0,94,0,0
"Saudi Arabia","2024-08-07",0,0,94,0,0,94,0,0
"Saudi Arabia","2024-08-08",0,0,94,0,0,94,0,0
"Saudi Arabia","2024-08-09",0,0,94,0,0,94,0,0
"Saudi Arabia","2024-08-10",0,0,94,0,0,94,0,0
"Saudi Arabia","2024-08-11",0,0,94,0,1,95,0,0
"Saudi Arabia","2024-08-12",0,0,94,0,0,95,0,0
"Saudi Arabia","2024-08-13",0,0,94,0,0,95,0,0
"Saudi Arabia","2024-08-14",0,0,94,0,0,95,0,0
"Saudi Arabia","2024-08-15",0,0,94,0,0,95,0,0
"Saudi Arabia","2024-08-16",0,0,94,0,0,95,0,0
"Saudi Arabia","2024-08-17",0,0,94,0,0,95,0,0
"Saudi Arabia","2024-08-18",0,0,94,0,0,95,0,0
"Saudi Arabia","2024-08-19",0,0,94,0,0,95,0,0
"Saudi Arabia","2024-08-20",0,0,94,0,0,95,0,0
"Saudi Arabia","2024-08-21",0,1,95,0,0,95,0,0
"Saudi Arabia","2024-08-22",0,0,95,0,0,95,0,0
"Saudi Arabia","2024-08-23",0,0,95,0,0,95,0,0
"Saudi Arabia","2024-08-24",0,0,95,0,0,95,0,0
"Saudi Arabia","2024-08-25",0,0,95,0,0,95,0,0
"Saudi Arabia","2024-08-26",0,0,95,0,0,95,0,0
"Saudi Arabia","2024-08-27",0,0,95,0,0,95,0,0
"Saudi Arabia","2024-08-28",0,0,95,0,0,95,0,0
"Saudi Arabia","2024-08-29",0,0,95,0,0,95,0,0
"Saudi Arabia","2024-08-30",0,0,95,0,0,95,0,0
"Saudi Arabia","2024-08-31",0,0,95,0,0,95,0,0
"Saudi Arabia","2024-09-01",0,0,95,0,0,95,0,0
"Saudi Arabia","2024-09-02",0,0,95,0,0,95,0,0
"Saudi Arabia","2024-09-03",0,0,95,0,0,95,0,0
"Saudi Arabia","2024-09-04",0,0,95,0,0,95,0,0
"Saudi Arabia","2024-09-05",0,0,95,0,0,95,0,0
"Saudi Arabia","2024-09-06",0,0,95,0,0,95,0,0
"Saudi Arabia","2024-09-07",0,0,95,0,0,95,0,0
"Saudi Arabia","2024-09-08",0,0,95,0,0,95,0,0
"Saudi Arabia","2024-09-09",0,0,95,0,0,95,0,0
"Saudi Arabia","2024-09-10",0,0,95,0,0,95,0,0
"Saudi Arabia","2024-09-11",0,0,95,0,0,95,0,0
"Saudi Arabia","2024-09-12",0,0,95,0,0,95,0,0
"Saudi Arabia","2024-09-13",0,0,95,0,0,95,0,0
"Saudi Arabia","2024-09-14",0,0,95,0,0,95,0,0
"Saudi Arabia","2024-09-15",0,0,95,0,0,95,0,0
"Saudi Arabia","2024-09-16",0,0,95,0,0,95,0,0
"Saudi Arabia","2024-09-17",0,0,95,0,0,95,0,0
"Saudi Arabia","2024-09-18",0,0,95,0,0,95,0,0
"Saudi Arabia","2024-09-19",0,0,95,0,0,95,0,0
"Saudi Arabia","2024-09-20",0,0,95,0,0,95,0,0
"Saudi Arabia","2024-09-21",0,0,95,0,0,95,0,0
"Saudi Arabia","2024-09-22",0,0,95,0,0,95,0,0
"Saudi Arabia","2024-09-23",0,0,95,0,0,95,0,0
"Saudi Arabia","2024-09-24",0,0,95,0,0,95,0,0
"Saudi Arabia","2024-09-25",0,0,95,0,0,95,0,0
"Saudi Arabia","2024-09-26",0,0,95,0,0,95,0,0
"Saudi Arabia","2024-09-27",0,0,95,0,0,95,0,0
"Saudi Arabia","2024-09-28",0,0,95,0,0,95,0,0
"Saudi Arabia","2024-09-29",0,0,95,0,0,95,0,0
"Saudi Arabia","2024-09-30",0,0,95,0,0,95,0,0
"Saudi Arabia","2024-10-01",0,0,95,0,0,95,0,0
"Saudi Arabia","2024-10-02",0,0,95,0,0,95,0,0
"Saudi Arabia","2024-10-03",0,0,95,0,0,95,0,0
"Saudi Arabia","2024-10-04",0,0,95,0,0,95,0,0
"Saudi Arabia","2024-10-05",0,0,95,0,0,95,0,0
"Saudi Arabia","2024-10-06",0,0,95,0,0,95,0,0
"Saudi Arabia","2024-10-07",0,0,95,0,0,95,0,0
"Saudi Arabia","2024-10-08",0,0,95,0,0,95,0,0
"Saudi Arabia","2024-10-09",0,0,95,0,0,95,0,0
"Saudi Arabia","2024-10-10",0,0,95,0,0,95,0,0
"Saudi Arabia","2024-10-11",0,0,95,0,0,95,0,0
"Saudi Arabia","2024-10-12",0,0,95,0,0,95,0,0
"Saudi Arabia","2024-10-13",0,0,95,0,0,95,0,0
"Saudi Arabia","2024-10-14",0,0,95,0,0,95,0,0
"Saudi Arabia","2024-10-15",0,0,95,0,0,95,0,0
"Saudi Arabia","2024-10-16",0,0,95,0,0,95,0,0
"Saudi Arabia","2024-10-17",0,0,95,0,0,95,0,0
"Saudi Arabia","2024-10-18",0,0,95,0,0,95,0,0
"Saudi Arabia","2024-10-19",0,0,95,0,0,95,0,0
"Saudi Arabia","2024-10-20",0,0,95,0,0,95,0,0
"Saudi Arabia","2024-10-21",0,0,95,0,0,95,0,0
"Saudi Arabia","2024-10-22",0,0,95,0,0,95,0,0
"Saudi Arabia","2024-10-23",0,0,95,0,0,95,0,0
"Saudi Arabia","2024-10-24",0,0,95,0,0,95,0,0
"Saudi Arabia","2024-10-25",0,0,95,0,0,95,0,0
"Saudi Arabia","2024-10-26",0,0,95,0,0,95,0,0
"Saudi Arabia","2024-10-27",0,0,95,0,0,95,0,0
"Saudi Arabia","2024-10-28",0,0,95,0,0,95,0,0
"Saudi Arabia","2024-10-29",0,0,95,0,0,95,0,0
"Saudi Arabia","2024-10-30",0,0,95,0,0,95,0,0
"Saudi Arabia","2024-10-31",0,0,95,0,0,95,0,0
"Saudi Arabia","2024-11-01",0,0,95,0,0,95,0,0
"Saudi Arabia","2024-11-02",0,0,95,0,0,95,0,0
"Saudi Arabia","2024-11-03",0,0,95,0,0,95,0,0
"Saudi Arabia","2024-11-04",0,0,95,0,0,95,0,0
"Saudi Arabia","2024-11-05",0,0,95,0,0,95,0,0
"Saudi Arabia","2024-11-06",0,0,95,0,0,95,0,0
"Saudi Arabia","2024-11-07",0,0,95,0,0,95,0,0
"Saudi Arabia","2024-11-08",0,0,95,0,0,95,0,0
"Saudi Arabia","2024-11-09",0,0,95,0,0,95,0,0
"Saudi Arabia","2024-11-10",0,0,95,0,0,95,0,0
"Saudi Arabia","2024-11-11",0,0,95,0,0,95,0,0
"Saudi Arabia","2024-11-12",0,0,95,0,0,95,0,0
"Saudi Arabia","2024-11-13",0,0,95,0,0,95,0,0
"Saudi Arabia","2024-11-14",0,0,95,0,0,95,0,0
"Saudi Arabia","2024-11-15",0,0,95,0,0,95,0,0
"Saudi Arabia","2024-11-16",0,0,95,0,0,95,0,0
"Saudi Arabia","2024-11-17",0,0,95,0,0,95,0,0
"Saudi Arabia","2024-11-18",0,0,95,0,0,95,0,0
"Saudi Arabia","2024-11-19",0,0,95,0,0,95,0,0
"Saudi Arabia","2024-11-20",0,0,95,0,0,95,0,0
"Saudi Arabia","2024-11-21",0,0,95,0,0,95,0,0
"Saudi Arabia","2024-11-22",0,0,95,0,0,95,0,0
"Saudi Arabia","2024-11-23",0,0,95,0,0,95,0,0
"Saudi Arabia","2024-11-24",0,0,95,0,0,95,0,0
"Saudi Arabia","2024-11-25",0,0,95,0,0,95,0,0
"Saudi Arabia","2024-11-26",0,0,95,0,0,95,0,0
"Saudi Arabia","2024-11-27",0,0,95,0,0,95,0,0
"Saudi Arabia","2024-11-28",0,0,95,0,0,95,0,0
"Saudi Arabia","2024-11-29",0,0,95,0,0,95,0,0
"Saudi Arabia","2024-11-30",0,0,95,0,0,95,0,0
"Saudi Arabia","2024-12-01",0,0,95,0,0,95,0,0
"Saudi Arabia","2024-12-02",0,0,95,0,0,95,0,0
"Saudi Arabia","2024-12-03",0,0,95,0,0,95,0,0
"Saudi Arabia","2024-12-04",0,0,95,0,0,95,0,0
"Saudi Arabia","2024-12-05",0,0,95,0,0,95,0,0
"Saudi Arabia","2024-12-06",0,0,95,0,0,95,0,0
"Saudi Arabia","2024-12-07",0,0,95,0,0,95,0,0
"Saudi Arabia","2024-12-08",0,0,95,0,0,95,0,0
"Saudi Arabia","2024-12-09",0,0,95,0,0,95,0,0
"Saudi Arabia","2024-12-10",0,0,95,0,0,95,0,0
"Saudi Arabia","2024-12-11",0,0,95,0,0,95,0,0
"Saudi Arabia","2024-12-12",0,0,95,0,0,95,0,0
"Saudi Arabia","2024-12-13",0,0,95,0,0,95,0,0
"Saudi Arabia","2024-12-14",0,0,95,0,0,95,0,0
"Saudi Arabia","2024-12-15",0,0,95,0,0,95,0,0
"Saudi Arabia","2024-12-16",0,0,95,0,0,95,0,0
"Saudi Arabia","2024-12-17",0,0,95,0,0,95,0,0
"Saudi Arabia","2024-12-18",0,0,95,0,0,95,0,0
"Saudi Arabia","2024-12-19",0,0,95,0,0,95,0,0
"Saudi Arabia","2024-12-20",0,0,95,0,0,95,0,0
"Saudi Arabia","2024-12-21",0,0,95,0,0,95,0,0
"Saudi Arabia","2024-12-22",0,0,95,0,0,95,0,0
"Saudi Arabia","2024-12-23",0,0,95,0,0,95,0,0
"Saudi Arabia","2024-12-24",0,0,95,0,0,95,0,0
"Saudi Arabia","2024-12-25",0,0,95,0,0,95,0,0
"Saudi Arabia","2024-12-26",0,0,95,0,0,95,0,0
"Saudi Arabia","2024-12-27",0,0,95,0,0,95,0,0
"Saudi Arabia","2024-12-28",0,0,95,0,0,95,0,0
"Saudi Arabia","2024-12-29",0,0,95,0,0,95,0,0
"Saudi Arabia","2024-12-30",0,0,95,0,0,95,0,0
"Saudi Arabia","2024-12-31",0,0,95,0,0,95,0,0
"Saudi Arabia","2025-01-01",0,0,95,0,0,95,0,0
"Saudi Arabia","2025-01-02",0,0,95,0,0,95,0,0
"Saudi Arabia","2025-01-03",0,0,95,0,0,95,0,0
"Saudi Arabia","2025-01-04",0,0,95,0,0,95,0,0
"Saudi Arabia","2025-01-05",0,0,95,0,0,95,0,0
"Saudi Arabia","2025-01-06",0,0,95,0,0,95,0,0
"Saudi Arabia","2025-01-07",0,0,95,0,0,95,0,0
"Saudi Arabia","2025-01-08",0,0,95,0,0,95,0,0
"Saudi Arabia","2025-01-09",0,0,95,0,0,95,0,0
"Saudi Arabia","2025-01-10",0,0,95,0,0,95,0,0
"Saudi Arabia","2025-01-11",0,0,95,0,0,95,0,0
"Saudi Arabia","2025-01-12",0,0,95,0,0,95,0,0
"Saudi Arabia","2025-01-13",0,0,95,0,0,95,0,0
"Serbia","2024-01-01",0,0,0,0,0,0,0,0
"Serbia","2024-01-02",0,0,0,0,0,0,0,0
"Serbia","2024-01-03",0,0,0,0,0,0,0,0
"Serbia","2024-01-04",0,0,0,0,0,0,0,0
"Serbia","2024-01-05",0,0,0,0,0,0,0,0
"Serbia","2024-01-06",0,0,0,0,0,0,0,0
"Serbia","2024-01-07",0,0,0,0,0,0,0,0
"Serbia","2024-01-08",0,0,0,0,0,0,0,0
"Serbia","2024-01-09",0,0,0,0,0,0,0,0
"Serbia","2024-01-10",0,0,0,0,0,0,0,0
"Serbia","2024-01-11",0,0,0,0,0,0,0,0
"Serbia","2024-01-12",0,0,0,0,0,0,0,0
"Serbia","2024-01-13",0,0,0,0,0,0,0,0
"Serbia","2024-01-14",0,0,0,0,0,0,0,0
"Serbia","2024-01-15",0,0,0,0,0,0,0,0
"Serbia","2024-01-16",0,0,0,0,0,0,0,0
"Serbia","2024-01-17",0,0,0,0,0,0,0,0
"Serbia","2024-01-18",0,0,0,0,0,0,0,0
"Serbia","2024-01-19",0,0,0,0,0,0,0,0
"Serbia","2024-01-20",0,0,0,0,0,0,0,0
"Serbia","2024-01-21",0,0,0,0,0,0,0,0
"Serbia","2024-01-22",0,0,0,0,0,0,0,0
"Serbia","2024-01-23",0,0,0,0,0,0,0,0
"Serbia","2024-01-24",0,0,0,0,0,0,0,0
"Serbia","2024-01-25",0,0,0,0,0,0,0,0
"Serbia","2024-01-26",0,0,0,0,0,0,0,0
"Serbia","2024-01-27",0,0,0,0,0,0,0,0
"Serbia","2024-01-28",0,0,0,0,0,0,0,0
"Serbia","2024-01-29",0,0,0,0,0,0,0,0
"Serbia","2024-01-30",0,0,0,0,0,0,0,0
"Serbia","2024-01-31",0,0,0,0,0,0,0,0
"Serbia","2024-02-01",0,0,0,0,0,0,0,0
"Serbia","2024-02-02",0,0,0,0,0,0,0,0
"Serbia","2024-02-03",0,0,0,0,0,0,0,0
"Serbia","2024-02-04",0,0,0,0,0,0,0,0
"Serbia","2024-02-05",0,0,0,0,0,0,0,0
"Serbia","2024-02-06",0,0,0,0,0,0,0,0
"Serbia","2024-02-07",0,0,0,0,0,0,0,0
"Serbia","2024-02-08",0,0,0,0,0,0,0,0
"Serbia","2024-02-09",0,0,0,0,0,0,0,0
"Serbia","2024-02-10",0,0,0,0,0,0,0,0
"Serbia","2024-02-11",0,0,0,0,0,0,0,0
"Serbia","2024-02-12",0,0,0,0,0,0,0,0
"Serbia","2024-02-13",0,0,0,0,0,0,0,0
"Serbia","2024-02-14",0,0,0,0,0,0,0,0
"Serbia","2024-02-15",0,0,0,0,0,0,0,0
"Serbia","2024-02-16",0,0,0,0,0,0,0,0
"Serbia","2024-02-17",0,0,0,0,0,0,0,0
"Serbia","2024-02-18",0,0,0,0,0,0,0,0
"Serbia","2024-02-19",0,0,0,0,0,0,0,0
"Serbia","2024-02-20",0,0,0,0,0,0,0,0
"Serbia","2024-02-21",0,0,0,0,0,0,0,0
"Serbia","2024-02-22",0,0,0,0,0,0,0,0
"Serbia","2024-02-23",0,0,0,0,0,0,0,0
"Serbia","2024-02-24",0,0,0,0,0,0,0,0
"Serbia","2024-02-25",0,0,0,0,0,0,0,0
"Serbia","2024-02-26",0,0,0,0,0,0,0,0
"Serbia","2024-02-27",0,0,0,0,0,0,0,0
"Serbia","2024-02-28",0,0,0,0,0,0,0,0
"Serbia","2024-02-29",0,0,0,0,0,0,0,0
"Serbia","2024-03-01",0,0,0,0,0,0,0,0
"Serbia","2024-03-02",0,0,0,0,0,0,0,0
"Serbia","2024-03-03",0,0,0,0,0,0,0,0
"Serbia","2024-03-04",0,0,0,0,0,0,0,0
"Serbia","2024-03-05",0,0,0,0,0,0,0,0
"Serbia","2024-03-06",0,0,0,0,0,0,0,0
"Serbia","2024-03-07",0,0,0,0,0,0,0,0
"Serbia","2024-03-08",0,0,0,0,0,0,0,0
"Serbia","2024-03-09",0,0,0,0,0,0,0,0
"Serbia","2024-03-10",0,0,0,0,0,0,0,0
"Serbia","2024-03-11",0,0,0,0,0,0,0,0
"Serbia","2024-03-12",0,0,0,0,0,0,0,0
"Serbia","2024-03-13",0,0,0,0,0,0,0,0
"Serbia","2024-03-14",0,0,0,0,0,0,0,0
"Serbia","2024-03-15",0,0,0,0,0,0,0,0
"Serbia","2024-03-16",0,0,0,0,0,0,0,0
"Serbia","2024-03-17",0,0,0,0,0,0,0,0
"Serbia","2024-03-18",0,0,0,0,0,0,0,0
"Serbia","2024-03-19",0,0,0,0,0,0,0,0
"Serbia","2024-03-20",0,0,0,0,0,0,0,0
"Serbia","2024-03-21",0,0,0,0,0,0,0,0
"Serbia","2024-03-22",0,0,0,0,0,0,0,0
"Serbia","2024-03-23",0,0,0,0,0,0,0,0
"Serbia","2024-03-24",0,0,0,0,0,0,0,0
"Serbia","2024-03-25",0,0,0,0,0,0,0,0
"Serbia","2024-03-26",0,0,0,0,0,0,0,0
"Serbia","2024-03-27",0,0,0,0,0,0,0,0
"Serbia","2024-03-28",0,0,0,0,0,0,0,0
"Serbia","2024-03-29",0,0,0,0,0,0,0,0
"Serbia","2024-03-30",0,0,0,0,0,0,0,0
"Serbia","2024-03-31",0,0,0,0,0,0,0,0
"Serbia","2024-04-01",0,0,0,0,0,0,0,0
"Serbia","2024-04-02",0,0,0,0,0,0,0,0
"Serbia","2024-04-03",0,0,0,0,0,0,0,0
"Serbia","2024-04-04",0,0,0,0,0,0,0,0
"Serbia","2024-04-05",0,0,0,0,0,0,0,0
"Serbia","2024-04-06",0,0,0,0,0,0,0,0
"Serbia","2024-04-07",0,0,0,0,0,0,0,0
"Serbia","2024-04-08",0,0,0,0,0,0,0,0
"Serbia","2024-04-09",0,0,0,0,0,0,0,0
"Serbia","2024-04-10",0,0,0,0,0,0,0,0
"Serbia","2024-04-11",0,0,0,0,0,0,0,0
"Serbia","2024-04-12",0,0,0,0,0,0,0,0
"Serbia","2024-04-13",0,0,0,0,0,0,0,0
"Serbia","2024-04-14",0,0,0,0,0,0,0,0
"Serbia","2024-04-15",0,0,0,0,0,0,0,0
"Serbia","2024-04-16",0,0,0,0,0,0,0,0
"Serbia","2024-04-17",0,0,0,0,0,0,0,0
"Serbia","2024-04-18",0,0,0,0,0,0,0,0
"Serbia","2024-04-19",0,0,0,0,0,0,0,0
"Serbia","2024-04-20",0,0,0,0,0,0,0,0
"Serbia","2024-04-21",0,0,0,0,0,0,0,0
"Serbia","2024-04-22",0,0,0,0,0,0,0,0
"Serbia","2024-04-23",0,0,0,0,0,0,0,0
"Serbia","2024-04-24",0,0,0,0,0,0,0,0
"Serbia","2024-04-25",0,0,0,0,0,0,0,0
"Serbia","2024-04-26",0,0,0,0,0,0,0,0
"Serbia","2024-04-27",0,0,0,0,0,0,0,0
"Serbia","2024-04-28",0,0,0,0,0,0,0,0
"Serbia","2024-04-29",0,0,0,0,0,0,0,0
"Serbia","2024-04-30",0,0,0,0,0,0,0,0
"Serbia","2024-05-01",0,0,0,0,0,0,0,0
"Serbia","2024-05-02",0,0,0,0,0,0,0,0
"Serbia","2024-05-03",0,0,0,0,0,0,0,0
"Serbia","2024-05-04",0,0,0,0,0,0,0,0
"Serbia","2024-05-05",0,0,0,0,0,0,0,0
"Serbia","2024-05-06",0,0,0,0,0,0,0,0
"Serbia","2024-05-07",0,0,0,0,0,0,0,0
"Serbia","2024-05-08",0,0,0,0,0,0,0,0
"Serbia","2024-05-09",0,0,0,0,0,0,0,0
"Serbia","2024-05-10",0,0,0,0,0,0,0,0
"Serbia","2024-05-11",0,0,0,0,0,0,0,0
"Serbia","2024-05-12",0,0,0,0,0,0,0,0
"Serbia","2024-05-13",0,0,0,0,0,0,0,0
"Serbia","2024-05-14",0,0,0,0,0,0,0,0
"Serbia","2024-05-15",0,0,0,0,0,0,0,0
"Serbia","2024-05-16",0,0,0,0,0,0,0,0
"Serbia","2024-05-17",0,0,0,0,0,0,0,0
"Serbia","2024-05-18",0,0,0,0,0,0,0,0
"Serbia","2024-05-19",0,0,0,0,0,0,0,0
"Serbia","2024-05-20",0,0,0,0,0,0,0,0
"Serbia","2024-05-21",0,0,0,0,0,0,0,0
"Serbia","2024-05-22",0,0,0,0,0,0,0,0
"Serbia","2024-05-23",0,0,0,0,0,0,0,0
"Serbia","2024-05-24",0,0,0,0,0,0,0,0
"Serbia","2024-05-25",0,0,0,0,0,0,0,0
"Serbia","2024-05-26",0,0,0,0,0,0,0,0
"Serbia","2024-05-27",0,0,0,0,0,0,0,0
"Serbia","2024-05-28",0,0,0,0,0,0,0,0
"Serbia","2024-05-29",0,0,0,0,0,0,0,0
"Serbia","2024-05-30",0,0,0,0,0,0,0,0
"Serbia","2024-05-31",0,0,0,0,0,0,0,0
"Serbia","2024-06-01",0,0,0,0,0,0,0,0
"Serbia","2024-06-02",0,0,0,0,0,0,0,0
"Serbia","2024-06-03",0,0,0,0,0,0,0,0
"Serbia","2024-06-04",0,0,0,0,0,0,0,0
"Serbia","2024-06-05",0,0,0,0,0,0,0,0
"Serbia","2024-06-06",0,0,0,0,0,0,0,0
"Serbia","2024-06-07",0,0,0,0,0,0,0,0
"Serbia","2024-06-08",0,0,0,0,0,0,0,0
"Serbia","2024-06-09",0,0,0,0,0,0,0,0
"Serbia","2024-06-10",0,0,0,0,0,0,0,0
"Serbia","2024-06-11",0,0,0,0,0,0,0,0
"Serbia","2024-06-12",0,0,0,0,0,0,0,0
"Serbia","2024-06-13",0,0,0,0,0,0,0,0
"Serbia","2024-06-14",0,0,0,0,0,0,0,0
"Serbia","2024-06-15",0,0,0,0,0,0,0,0
"Serbia","2024-06-16",0,0,0,0,0,0,0,0
"Serbia","2024-06-17",0,0,0,0,0,0,0,0
"Serbia","2024-06-18",0,0,0,0,0,0,0,0
"Serbia","2024-06-19",0,0,0,0,0,0,0,0
"Serbia","2024-06-20",0,0,0,0,0,0,0,0
"Serbia","2024-06-21",0,0,0,0,0,0,0,0
"Serbia","2024-06-22",0,0,0,0,0,0,0,0
"Serbia","2024-06-23",0,0,0,0,0,0,0,0
"Serbia","2024-06-24",0,0,0,0,0,0,0,0
"Serbia","2024-06-25",0,0,0,0,0,0,0,0
"Serbia","2024-06-26",0,0,0,0,0,0,0,0
"Serbia","2024-06-27",0,0,0,0,0,0,0,0
"Serbia","2024-06-28",0,0,0,0,0,0,0,0
"Serbia","2024-06-29",0,0,0,0,0,0,0,0
"Serbia","2024-06-30",0,0,0,0,0,0,0,0
"Serbia","2024-07-01",0,0,0,0,0,0,0,0
"Serbia","2024-07-02",0,0,0,0,0,0,0,0
"Serbia","2024-07-03",0,0,0,0,0,0,0,0
"Serbia","2024-07-04",0,0,0,0,0,0,0,0
"Serbia","2024-07-05",0,0,0,0,0,0,0,0
"Serbia","2024-07-06",0,0,0,0,0,0,0,0
"Serbia","2024-07-07",0,0,0,0,0,0,0,0
"Serbia","2024-07-08",0,0,0,0,0,0,0,0
"Serbia","2024-07-09",0,0,0,0,0,0,0,0
"Serbia","2024-07-10",0,0,0,0,0,0,0,0
"Serbia","2024-07-11",0,0,0,0,0,0,0,0
"Serbia","2024-07-12",0,0,0,0,0,0,0,0
"Serbia","2024-07-13",0,0,0,0,0,0,0,0
"Serbia","2024-07-14",0,0,0,0,0,0,0,0
"Serbia","2024-07-15",0,0,0,0,0,0,0,0
"Serbia","2024-07-16",0,0,0,0,0,0,0,0
"Serbia","2024-07-17",0,0,0,0,0,0,0,0
"Serbia","2024-07-18",0,0,0,0,0,0,0,0
"Serbia","2024-07-19",0,0,0,0,0,0,0,0
"Serbia","2024-07-20",0,0,0,0,0,0,0,0
"Serbia","2024-07-21",0,0,0,0,0,0,0,0
"Serbia","2024-07-22",0,0,0,0,0,0,0,0
"Serbia","2024-07-23",0,0,0,0,0,0,0,0
"Serbia","2024-07-24",0,0,0,0,0,0,0,0
"Serbia","2024-07-25",0,0,0,0,0,0,0,0
"Serbia","2024-07-26",0,0,0,0,0,0,0,0
"Serbia","2024-07-27",0,0,0,0,0,0,0,0
"Serbia","2024-07-28",0,0,0,0,0,0,0,0
"Serbia","2024-07-29",0,0,0,0,0,0,0,0
"Serbia","2024-07-30",0,0,0,0,0,0,0,0
"Serbia","2024-07-31",0,0,0,0,0,0,0,0
"Serbia","2024-08-01",0,0,0,0,0,0,0,0
"Serbia","2024-08-02",0,0,0,0,0,0,0,0
"Serbia","2024-08-03",0,0,0,0,0,0,0,0
"Serbia","2024-08-04",0,0,0,0,0,0,0,0
"Serbia","2024-08-05",0,0,0,0,0,0,0,0
"Serbia","2024-08-06",0,0,0,0,0,0,0,0
"Serbia","2024-08-07",0,0,0,0,0,0,0,0
"Serbia","2024-08-08",0,0,0,0,0,0,0,0
"Serbia","2024-08-09",0,0,0,0,0,0,0,0
"Serbia","2024-08-10",0,0,0,0,0,0,0,0
"Serbia","2024-08-11",0,0,0,0,0,0,0,0
"Serbia","2024-08-12",0,0,0,0,0,0,0,0
"Serbia","2024-08-13",0,0,0,0,0,0,0,0
"Serbia","2024-08-14",0,0,0,0,0,0,0,0
"Serbia","2024-08-15",0,0,0,0,0,0,0,0
"Serbia","2024-08-16",0,0,0,0,0,0,0,0
"Serbia","2024-08-17",0,0,0,0,0,0,0,0
"Serbia","2024-08-18",0,0,0,0,0,0,0,0
"Serbia","2024-08-19",0,0,0,0,0,0,0,0
"Serbia","2024-08-20",0,0,0,0,0,0,0,0
"Serbia","2024-08-21",0,0,0,0,0,0,0,0
"Serbia","2024-08-22",0,0,0,0,0,0,0,0
"Serbia","2024-08-23",0,0,0,0,0,0,0,0
"Serbia","2024-08-24",0,0,0,0,0,0,0,0
"Serbia","2024-08-25",0,0,0,0,0,0,0,0
"Serbia","2024-08-26",0,0,0,0,0,0,0,0
"Serbia","2024-08-27",0,0,0,0,0,0,0,0
"Serbia","2024-08-28",0,0,0,0,0,0,0,0
"Serbia","2024-08-29",0,0,0,0,0,0,0,0
"Serbia","2024-08-30",0,0,0,0,0,0,0,0
"Serbia","2024-08-31",0,0,0,0,0,0,0,0
"Serbia","2024-09-01",0,0,0,0,0,0,0,0
"Serbia","2024-09-02",0,0,0,0,0,0,0,0
"Serbia","2024-09-03",0,0,0,0,0,0,0,0
"Serbia","2024-09-04",0,0,0,0,0,0,0,0
"Serbia","2024-09-05",0,0,0,0,0,0,0,0
"Serbia","2024-09-06",0,0,0,0,0,0,0,0
"Serbia","2024-09-07",0,0,0,0,0,0,0,0
"Serbia","2024-09-08",0,0,0,0,0,0,0,0
"Serbia","2024-09-09",0,0,0,0,0,0,0,0
"Serbia","2024-09-10",0,0,0,0,0,0,0,0
"Serbia","2024-09-11",0,0,0,0,0,0,0,0
"Serbia","2024-09-12",0,0,0,0,0,0,0,0
"Serbia","2024-09-13",0,0,0,0,0,0,0,0
"Serbia","2024-09-14",0,0,0,0,0,0,0,0
"Serbia","2024-09-15",0,0,0,0,0,0,0,0
"Serbia","2024-09-16",0,0,0,0,0,0,0,0
"Serbia","2024-09-17",0,0,0,0,0,0,0,0
"Serbia","2024-09-18",0,0,0,0,0,0,0,0
"Serbia","2024-09-19",0,0,0,0,0,0,0,0
"Serbia","2024-09-20",0,0,0,0,0,0,0,0
"Serbia","2024-09-21",0,0,0,0,0,0,0,0
"Serbia","2024-09-22",0,0,0,0,0,0,0,0
"Serbia","2024-09-23",0,0,0,0,0,0,0,0
"Serbia","2024-09-24",0,0,0,0,0,0,0,0
"Serbia","2024-09-25",0,0,0,0,0,0,0,0
"Serbia","2024-09-26",0,0,0,0,0,0,0,0
"Serbia","2024-09-27",0,0,0,0,0,0,0,0
"Serbia","2024-09-28",0,0,0,0,0,0,0,0
"Serbia","2024-09-29",0,0,0,0,0,0,0,0
"Serbia","2024-09-30",0,0,0,0,0,0,0,0
"Serbia","2024-10-01",0,0,0,0,0,0,0,0
"Serbia","2024-10-02",0,0,0,0,0,0,0,0
"Serbia","2024-10-03",0,0,0,0,0,0,0,0
"Serbia","2024-10-04",0,0,0,0,0,0,0,0
"Serbia","2024-10-05",0,0,0,0,0,0,0,0
"Serbia","2024-10-06",0,0,0,0,0,0,0,0
"Serbia","2024-10-07",0,0,0,0,0,0,0,0
"Serbia","2024-10-08",0,0,0,0,0,0,0,0
"Serbia","2024-10-09",0,0,0,0,0,0,0,0
"Serbia","2024-10-10",0,0,0,0,0,0,0,0
"Serbia","2024-10-11",0,0,0,0,0,0,0,0
"Serbia","2024-10-12",0,0,0,0,0,0,0,0
"Serbia","2024-10-13",0,0,0,0,0,0,0,0
"Serbia","2024-10-14",0,0,0,0,0,0,0,0
"Serbia","2024-10-15",0,0,0,0,0,0,0,0
"Serbia","2024-10-16",0,0,0,0,0,0,0,0
"Serbia","2024-10-17",0,0,0,0,0,0,0,0
"Serbia","2024-10-18",0,0,0,0,0,0,0,0
"Serbia","2024-10-19",0,0,0,0,0,0,0,0
"Serbia","2024-10-20",0,0,0,0,0,0,0,0
"Serbia","2024-10-21",0,0,0,0,0,0,0,0
"Serbia","2024-10-22",0,0,0,0,0,0,0,0
"Serbia","2024-10-23",0,0,0,0,0,0,0,0
"Serbia","2024-10-24",0,0,0,0,0,0,0,0
"Serbia","2024-10-25",0,0,0,0,0,0,0,0
"Serbia","2024-10-26",0,0,0,0,0,0,0,0
"Serbia","2024-10-27",0,0,0,0,0,0,0,0
"Serbia","2024-10-28",0,0,0,0,0,0,0,0
"Serbia","2024-10-29",0,0,0,0,0,0,0,0
"Serbia","2024-10-30",0,0,0,0,0,0,0,0
"Serbia","2024-10-31",0,0,0,0,0,0,0,0
"Serbia","2024-11-01",0,0,0,0,0,0,0,0
"Serbia","2024-11-02",0,0,0,0,0,0,0,0
"Serbia","2024-11-03",0,0,0,0,0,0,0,0
"Serbia","2024-11-04",0,0,0,0,0,0,0,0
"Serbia","2024-11-05",0,0,0,0,0,0,0,0
"Serbia","2024-11-06",0,0,0,0,0,0,0,0
"Serbia","2024-11-07",0,0,0,0,0,0,0,0
"Serbia","2024-11-08",0,0,0,0,0,0,0,0
"Serbia","2024-11-09",0,0,0,0,0,0,0,0
"Serbia","2024-11-10",0,0,0,0,0,0,0,0
"Serbia","2024-11-11",0,0,0,0,0,0,0,0
"Serbia","2024-11-12",0,0,0,0,0,0,0,0
"Serbia","2024-11-13",0,0,0,0,0,0,0,0
"Serbia","2024-11-14",0,0,0,0,0,0,0,0
"Serbia","2024-11-15",0,0,0,0,0,0,0,0
"Serbia","2024-11-16",0,0,0,0,0,0,0,0
"Serbia","2024-11-17",0,0,0,0,0,0,0,0
"Serbia","2024-11-18",0,0,0,0,0,0,0,0
"Serbia","2024-11-19",0,0,0,0,0,0,0,0
"Serbia","2024-11-20",0,0,0,0,0,0,0,0
"Serbia","2024-11-21",0,0,0,0,0,0,0,0
"Serbia","2024-11-22",0,0,0,0,0,0,0,0
"Serbia","2024-11-23",0,0,0,0,0,0,0,0
"Serbia","2024-11-24",0,0,0,0,0,0,0,0
"Serbia","2024-11-25",0,0,0,0,0,0,0,0
"Serbia","2024-11-26",0,0,0,0,0,0,0,0
"Serbia","2024-11-27",0,0,0,0,0,0,0,0
"Serbia","2024-11-28",0,0,0,0,0,0,0,0
"Serbia","2024-11-29",0,0,0,0,0,0,0,0
"Serbia","2024-11-30",0,0,0,0,0,0,0,0
"Serbia","2024-12-01",0,0,0,0,0,0,0,0
"Serbia","2024-12-02",0,0,0,0,0,0,0,0
"Serbia","2024-12-03",0,0,0,0,0,0,0,0
"Serbia","2024-12-04",0,0,0,0,0,0,0,0
"Serbia","2024-12-05",0,0,0,0,0,0,0,0
"Serbia","2024-12-06",0,0,0,0,0,0,0,0
"Serbia","2024-12-07",0,0,0,0,0,0,0,0
"Serbia","2024-12-08",0,0,0,0,0,0,0,0
"Serbia","2024-12-09",0,0,0,0,0,0,0,0
"Serbia","2024-12-10",0,0,0,0,0,0,0,0
"Serbia","2024-12-11",0,0,0,0,0,0,0,0
"Serbia","2024-12-12",0,0,0,0,0,0,0,0
"Serbia","2024-12-13",0,0,0,0,0,0,0,0
"Serbia","2024-12-14",0,0,0,0,0,0,0,0
"Serbia","2024-12-15",0,0,0,0,0,0,0,0
"Serbia","2024-12-16",0,0,0,0,0,0,0,0
"Serbia","2024-12-17",0,0,0,0,0,0,0,0
"Serbia","2024-12-18",0,0,0,0,0,0,0,0
"Serbia","2024-12-19",0,0,0,0,0,0,0,0
"Serbia","2024-12-20",0,0,0,0,0,0,0,0
"Serbia","2024-12-21",0,0,0,0,0,0,0,0
"Serbia","2024-12-22",0,0,0,0,0,0,0,0
"Serbia","2024-12-23",0,0,0,0,0,0,0,0
"Serbia","2024-12-24",0,0,0,0,0,0,0,0
"Serbia","2024-12-25",0,0,0,0,0,0,0,0
"Serbia","2024-12-26",0,0,0,0,0,0,0,0
"Serbia","2024-12-27",0,0,0,0,0,0,0,0
"Serbia","2024-12-28",0,0,0,0,0,0,0,0
"Serbia","2024-12-29",0,0,0,0,0,0,0,0
"Serbia","2024-12-30",0,0,0,0,0,0,0,0
"Serbia","2024-12-31",0,0,0,0,0,0,0,0
"Serbia","2025-01-01",0,0,0,0,0,0,0,0
"Serbia","2025-01-02",0,0,0,0,0,0,0,0
"Serbia","2025-01-03",0,0,0,0,0,0,0,0
"Serbia","2025-01-04",0,0,0,0,0,0,0,0
"Serbia","2025-01-05",0,0,0,0,0,0,0,0
"Serbia","2025-01-06",0,0,0,0,0,0,0,0
"Serbia","2025-01-07",0,0,0,0,0,0,0,0
"Serbia","2025-01-08",0,0,0,0,0,0,0,0
"Serbia","2025-01-09",0,0,0,0,0,0,0,0
"Serbia","2025-01-10",0,0,0,0,0,0,0,0
"Serbia","2025-01-11",0,0,0,0,0,0,0,0
"Serbia","2025-01-12",0,0,0,0,0,0,0,0
"Serbia","2025-01-13",0,0,0,0,0,0,0,0
"Singapore","2024-01-01",0,0,0,0,0,0,0,0
"Singapore","2024-01-02",0,0,0,0,0,0,0,0
"Singapore","2024-01-03",0,0,0,0,0,0,0,0
"Singapore","2024-01-04",0,0,0,0,0,0,0,0
"Singapore","2024-01-05",0,1,1,0,1,1,0,0
"Singapore","2024-01-06",0,0,1,0,0,1,0,0
"Singapore","2024-01-07",0,0,1,0,0,1,0,0
"Singapore","2024-01-08",0,0,1,0,0,1,0,0
"Singapore","2024-01-09",0,0,1,0,0,1,0,0
"Singapore","2024-01-10",0,0,1,0,0,1,0,0
"Singapore","2024-01-11",0,0,1,0,0,1,0,0
"Singapore","2024-01-12",0,0,1,0,0,1,0,0
"Singapore","2024-01-13",0,0,1,0,0,1,0,0
"Singapore","2024-01-14",0,0,1,0,0,1,0,0
"Singapore","2024-01-15",0,0,1,0,0,1,0,0
"Singapore","2024-01-16",0,0,1,0,0,1,0,0
"Singapore","2024-01-17",0,0,1,0,0,1,0,0
"Singapore","2024-01-18",0,0,1,0,0,1,0,0
"Singapore","2024-01-19",0,0,1,0,0,1,0,0
"Singapore","2024-01-20",0,0,1,0,0,1,0,0
"Singapore","2024-01-21",0,0,1,0,0,1,0,0
"Singapore","2024-01-22",0,0,1,0,0,1,0,0
"Singapore","2024-01-23",0,0,1,0,0,1,0,0
"Singapore","2024-01-24",0,0,1,0,0,1,0,0
"Singapore","2024-01-25",0,0,1,0,0,1,0,0
"Singapore","2024-01-26",0,0,1,0,0,1,0,0
"Singapore","2024-01-27",0,0,1,0,1,2,0,0
"Singapore","2024-01-28",0,0,1,0,0,2,0,0
"Singapore","2024-01-29",0,0,1,0,0,2,0,0
"Singapore","2024-01-30",0,0,1,0,0,2,0,0
"Singapore","2024-01-31",0,0,1,0,0,2,0,0
"Singapore","2024-02-01",0,0,1,0,0,2,0,0
"Singapore","2024-02-02",0,0,1,0,0,2,0,0
"Singapore","2024-02-03",0,0,1,0,0,2,0,0
"Singapore","2024-02-04",0,0,1,0,0,2,0,0
"Singapore","2024-02-05",0,0,1,0,0,2,0,0
"Singapore","2024-02-06",0,0,1,0,0,2,0,0
"Singapore","2024-02-07",0,0,1,0,0,2,0,0
"Singapore","2024-02-08",0,0,1,0,0,2,0,0
"Singapore","2024-02-09",0,0,1,0,0,2,0,0
"Singapore","2024-02-10",0,0,1,0,0,2,0,0
"Singapore","2024-02-11",0,0,1,0,0,2,0,0
"Singapore","2024-02-12",0,0,1,0,0,2,0,0
"Singapore","2024-02-13",0,0,1,0,0,2,0,0
"Singapore","2024-02-14",0,0,1,0,0,2,0,0
"Singapore","2024-02-15",0,0,1,0,0,2,0,0
"Singapore","2024-02-16",0,1,2,0,0,2,0,0
"Singapore","2024-02-17",0,0,2,0,0,2,0,0
"Singapore","2024-02-18",0,0,2,0,0,2,0,0
"Singapore","2024-02-19",0,0,2,0,0,2,0,0
"Singapore","2024-02-20",0,0,2,0,0,2,0,0
"Singapore","2024-02-21",0,0,2,0,0,2,0,0
"Singapore","2024-02-22",0,0,2,0,1,3,0,0
"Singapore","2024-02-23",0,0,2,0,0,3,0,0
"Singapore","2024-02-24",0,0,2,0,0,3,0,0
"Singapore","2024-02-25",0,0,2,0,0,3,0,0
"Singapore","2024-02-26",0,0,2,0,0,3,0,0
"Singapore","2024-02-27",0,0,2,0,0,3,0,0
"Singapore","2024-02-28",0,0,2,0,0,3,0,0
"Singapore","2024-02-29",0,0,2,0,0,3,0,0
"Singapore","2024-03-01",0,0,2,0,0,3,0,0
"Singapore","2024-03-02",0,0,2,0,0,3,0,0
"Singapore","2024-03-03",0,0,2,0,1,4,0,0
"Singapore","2024-03-04",0,0,2,0,0,4,0,0
"Singapore","2024-03-05",0,0,2,0,0,4,0,0
"Singapore","2024-03-06",0,0,2,0,0,4,0,0
"Singapore","2024-03-07",0,0,2,0,0,4,0,0
"Singapore","2024-03-08",0,2,4,0,0,4,0,0
"Singapore","2024-03-09",0,0,4,0,0,4,0,0
"Singapore","2024-03-10",0,0,4,0,1,5,0,0
"Singapore","2024-03-11",0,0,4,0,0,5,0,0
"Singapore","2024-03-12",0,0,4,0,0,5,0,0
"Singapore","2024-03-13",0,0,4,0,0,5,0,0
"Singapore","2024-03-14",0,0,4,0,1,6,0,0
"Singapore","2024-03-15",0,2,6,0,0,6,0,0
"Singapore","2024-03-16",0,0,6,0,0,6,0,0
"Singapore","2024-03-17",0,0,6,0,0,6,0,0
"Singapore","2024-03-18",0,0,6,0,0,6,0,0
"Singapore","2024-03-19",0,0,6,0,1,7,0,0
"Singapore","2024-03-20",0,0,6,0,0,7,0,0
"Singapore","2024-03-21",0,0,6,0,0,7,0,0
"Singapore","2024-03-22",0,1,7,0,0,7,0,0
"Singapore","2024-03-23",0,0,7,0,0,7,0,0
"Singapore","2024-03-24",0,0,7,0,0,7,0,0
"Singapore","2024-03-25",0,0,7,0,0,7,0,0
"Singapore","2024-03-26",0,0,7,0,0,7,0,0
"Singapore","2024-03-27",0,0,7,0,0,7,0,0
"Singapore","2024-03-28",0,0,7,0,0,7,0,0
"Singapore","2024-03-29",0,0,7,0,0,7,0,0
"Singapore","2024-03-30",0,0,7,0,1,8,0,0
"Singapore","2024-03-31",0,0,7,0,0,8,0,0
"Singapore","2024-04-01",0,0,7,0,0,8,0,0
"Singapore","2024-04-02",0,0,7,0,0,8,0,0
"Singapore","2024-04-03",0,0,7,0,0,8,0,0
"Singapore","2024-04-04",0,0,7,0,0,8,0,0
"Singapore","2024-04-05",0,1,8,0,0,8,0,0
"Singapore","2024-04-06",0,0,8,0,0,8,0,0
"Singapore","2024-04-07",0,0,8,0,0,8,0,0
"Singapore","2024-04-08",0,0,8,0,0,8,0,0
"Singapore","2024-04-09",0,0,8,0,0,8,0,0
"Singapore","2024-04-10",0,0,8,0,0,8,0,0
"Singapore","2024-04-11",0,0,8,0,0,8,0,0
"Singapore","2024-04-12",0,0,8,0,0,8,0,0
"Singapore","2024-04-13",0,0,8,0,0,8,0,0
"Singapore","2024-04-14",0,0,8,0,0,8,0,0
"Singapore","2024-04-15",0,0,8,0,0,8,0,0
"Singapore","2024-04-16",0,0,8,0,1,9,0,0
"Singapore","2024-04-17",0,0,8,0,0,9,0,0
"Singapore","2024-04-18",0,0,8,0,0,9,0,0
"Singapore","2024-04-19",0,0,8,0,0,9,0,0
"Singapore","2024-04-20",0,0,8,0,0,9,0,0
"Singapore","2024-04-21",0,0,8,0,0,9,0,0
"Singapore","2024-04-22",0,0,8,0,0,9,0,0
"Singapore","2024-04-23",0,0,8,0,0,9,0,0
"Singapore","2024-04-24",0,0,8,0,0,9,0,0
"Singapore","2024-04-25",0,0,8,0,0,9,0,0
"Singapore","2024-04-26",0,1,9,0,0,9,0,0
"Singapore","2024-04-27",0,0,9,0,0,9,0,0
"Singapore","2024-04-28",0,0,9,0,0,9,0,0
"Singapore","2024-04-29",0,0,9,0,0,9,0,0
"Singapore","2024-04-30",0,0,9,0,0,9,0,0
"Singapore","2024-05-01",0,0,9,0,0,9,0,0
"Singapore","2024-05-02",0,0,9,0,0,9,0,0
"Singapore","2024-05-03",0,0,9,0,0,9,0,0
"Singapore","2024-05-04",0,0,9,0,0,9,0,0
"Singapore","2024-05-05",0,0,9,0,0,9,0,0
"Singapore","2024-05-06",0,0,9,0,0,9,0,0
"Singapore","2024-05-07",0,0,9,0,0,9,0,0
"Singapore","2024-05-08",0,0,9,0,0,9,0,0
"Singapore","2024-05-09",0,0,9,0,0,9,0,0
"Singapore","2024-05-10",0,0,9,0,0,9,0,0
"Singapore","2024-05-11",0,0,9,0,0,9,0,0
"Singapore","2024-05-12",0,0,9,0,0,9,0,0
"Singapore","2024-05-13",0,0,9,0,0,9,0,0
"Singapore","2024-05-14",0,0,9,0,0,9,0,0
"Singapore","2024-05-15",0,0,9,0,0,9,0,0
"Singapore","2024-05-16",0,0,9,0,0,9,0,0
"Singapore","2024-05-17",0,0,9,0,0,9,0,0
"Singapore","2024-05-18",0,0,9,0,0,9,0,0
"Singapore","2024-05-19",0,0,9,0,0,9,0,0
"Singapore","2024-05-20",0,0,9,0,0,9,0,0
"Singapore","2024-05-21",0,0,9,0,0,9,0,0
"Singapore","2024-05-22",0,0,9,0,0,9,0,0
"Singapore","2024-05-23",0,0,9,0,0,9,0,0
"Singapore","2024-05-24",0,0,9,0,0,9,0,0
"Singapore","2024-05-25",0,0,9,0,0,9,0,0
"Singapore","2024-05-26",0,0,9,0,0,9,0,0
"Singapore","2024-05-27",0,0,9,0,1,10,0,0
"Singapore","2024-05-28",0,0,9,0,0,10,0,0
"Singapore","2024-05-29",0,0,9,0,0,10,0,0
"Singapore","2024-05-30",0,0,9,0,0,10,0,0
"Singapore","2024-05-31",0,0,9,0,0,10,0,0
"Singapore","2024-06-01",0,0,9,0,0,10,0,0
"Singapore","2024-06-02",0,0,9,0,0,10,0,0
"Singapore","2024-06-03",0,0,9,0,0,10,0,0
"Singapore","2024-06-04",0,0,9,0,0,10,0,0
"Singapore","2024-06-05",0,0,9,0,0,10,0,0
"Singapore","2024-06-06",0,0,9,0,0,10,0,0
"Singapore","2024-06-07",0,0,9,0,0,10,0,0
"Singapore","2024-06-08",0,0,9,0,0,10,0,0
"Singapore","2024-06-09",0,0,9,0,0,10,0,0
"Singapore","2024-06-10",0,0,9,0,0,10,0,0
"Singapore","2024-06-11",0,0,9,0,0,10,0,0
"Singapore","2024-06-12",0,0,9,0,0,10,0,0
"Singapore","2024-06-13",0,0,9,0,0,10,0,0
"Singapore","2024-06-14",0,0,9,0,0,10,0,0
"Singapore","2024-06-15",0,0,9,0,0,10,0,0
"Singapore","2024-06-16",0,0,9,0,0,10,0,0
"Singapore","2024-06-17",0,0,9,0,0,10,0,0
"Singapore","2024-06-18",0,0,9,0,0,10,0,0
"Singapore","2024-06-19",0,0,9,0,0,10,0,0
"Singapore","2024-06-20",0,0,9,0,0,10,0,0
"Singapore","2024-06-21",0,0,9,0,0,10,0,0
"Singapore","2024-06-22",0,0,9,0,0,10,0,0
"Singapore","2024-06-23",0,0,9,0,0,10,0,0
"Singapore","2024-06-24",0,0,9,0,0,10,0,0
"Singapore","2024-06-25",0,1,10,0,0,10,0,0
"Singapore","2024-06-26",0,0,10,0,0,10,0,0
"Singapore","2024-06-27",0,0,10,0,0,10,0,0
"Singapore","2024-06-28",0,0,10,0,0,10,0,0
"Singapore","2024-06-29",0,0,10,0,0,10,0,0
"Singapore","2024-06-30",0,0,10,0,0,10,0,0
"Singapore","2024-07-01",0,0,10,0,0,10,0,0
"Singapore","2024-07-02",0,0,10,0,0,10,0,0
"Singapore","2024-07-03",0,0,10,0,0,10,0,0
"Singapore","2024-07-04",0,0,10,0,0,10,0,0
"Singapore","2024-07-05",0,0,10,0,1,11,0,0
"Singapore","2024-07-06",0,0,10,0,0,11,0,0
"Singapore","2024-07-07",0,0,10,0,0,11,0,0
"Singapore","2024-07-08",0,0,10,0,0,11,0,0
"Singapore","2024-07-09",0,0,10,0,0,11,0,0
"Singapore","2024-07-10",0,0,10,0,0,11,0,0
"Singapore","2024-07-11",0,0,10,0,0,11,0,0
"Singapore","2024-07-12",0,0,10,0,0,11,0,0
"Singapore","2024-07-13",0,1,11,0,0,11,0,0
"Singapore","2024-07-14",0,0,11,0,0,11,0,0
"Singapore","2024-07-15",0,0,11,0,0,11,0,0
"Singapore","2024-07-16",0,0,11,0,0,11,0,0
"Singapore","2024-07-17",0,0,11,0,0,11,0,0
"Singapore","2024-07-18",0,0,11,0,0,11,0,0
"Singapore","2024-07-19",0,0,11,0,0,11,0,0
"Singapore","2024-07-20",0,0,11,0,0,11,0,0
"Singapore","2024-07-21",0,0,11,0,0,11,0,0
"Singapore","2024-07-22",0,0,11,0,1,12,0,0
"Singapore","2024-07-23",0,0,11,0,0,12,0,0
"Singapore","2024-07-24",0,0,11,0,0,12,0,0
"Singapore","2024-07-25",0,0,11,0,0,12,0,0
"Singapore","2024-07-26",0,0,11,0,0,12,0,0
"Singapore","2024-07-27",0,0,11,0,0,12,0,0
"Singapore","2024-07-28",0,0,11,0,0,12,0,0
"Singapore","2024-07-29",0,0,11,0,0,12,0,0
"Singapore","2024-07-30",0,0,11,0,0,12,0,0
"Singapore","2024-07-31",0,0,11,0,0,12,0,0
"Singapore","2024-08-01",0,0,11,0,0,12,0,0
"Singapore","2024-08-02",0,0,11,0,0,12,0,0
"Singapore","2024-08-03",0,0,11,0,0,12,0,0
"Singapore","2024-08-04",0,0,11,0,0,12,0,0
"Singapore","2024-08-05",0,0,11,0,0,12,0,0
"Singapore","2024-08-06",0,0,11,0,0,12,0,0
"Singapore","2024-08-07",0,0,11,0,1,13,0,0
"Singapore","2024-08-08",0,0,11,0,0,13,0,0
"Singapore","2024-08-09",0,0,11,0,0,13,0,0
"Singapore","2024-08-10",0,0,11,0,0,13,0,0
"Singapore","2024-08-11",0,0,11,0,0,13,0,0
"Singapore","2024-08-12",0,0,11,0,0,13,0,0
"Singapore","2024-08-13",0,0,11,0,0,13,0,0
"Singapore","2024-08-14",0,0,11,0,0,13,0,0
"Singapore","2024-08-15",0,2,13,0,0,13,0,0
"Singapore","2024-08-16",0,0,13,0,0,13,0,0
"Singapore","2024-08-17",0,0,13,0,0,13,0,0
"Singapore","2024-08-18",0,0,13,0,0,13,0,0
"Singapore","2024-08-19",0,0,13,0,0,13,0,0
"Singapore","2024-08-20",0,0,13,0,1,14,0,0
"Singapore","2024-08-21",0,0,13,0,0,14,0,0
"Singapore","2024-08-22",0,0,13,0,0,14,0,0
"Singapore","2024-08-23",0,1,14,0,0,14,0,0
"Singapore","2024-08-24",0,0,14,0,0,14,0,0
"Singapore","2024-08-25",0,0,14,0,0,14,0,0
"Singapore","2024-08-26",0,0,14,0,0,14,0,0
"Singapore","2024-08-27",0,0,14,0,0,14,0,0
"Singapore","2024-08-28",0,0,14,0,0,14,0,0
"Singapore","2024-08-29",0,0,14,0,0,14,0,0
"Singapore","2024-08-30",0,0,14,0,0,14,0,0
"Singapore","2024-08-31",0,0,14,0,0,14,0,0
"Singapore","2024-09-01",0,0,14,0,1,15,0,0
"Singapore","2024-09-02",0,0,14,0,0,15,0,0
"Singapore","2024-09-03",0,0,14,0,0,15,0,0
"Singapore","2024-09-04",0,0,14,0,0,15,0,0
"Singapore","2024-09-05",0,0,14,0,0,15,0,0
"Singapore","2024-09-06",0,0,14,0,0,15,0,0
"Singapore","2024-09-07",0,0,14,0,0,15,0,0
"Singapore","2024-09-08",0,1,15,0,0,15,0,0
"Singapore","2024-09-09",0,0,15,0,0,15,0,0
"Singapore","2024-09-10",0,0,15,0,0,15,0,0
"Singapore","2024-09-11",0,0,15,0,0,15,0,0
"Singapore","2024-09-12",0,0,15,0,0,15,0,0
"Singapore","2024-09-13",0,0,15,0,0,15,0,0
"Singapore","2024-09-14",0,0,15,0,0,15,0,0
"Singapore","2024-09-15",0,0,15,0,0,15,0,0
"Singapore","2024-09-16",0,0,15,0,0,15,0,0
"Singapore","2024-09-17",0,0,15,0,1,16,0,0
"Singapore","2024-09-18",0,0,15,0,0,16,0,0
"Singapore","2024-09-19",0,0,15,0,0,16,0,0
"Singapore","2024-09-20",0,0,15,0,0,16,0,0
"Singapore","2024-09-21",0,0,15,0,0,16,0,0
"Singapore","2024-09-22",0,0,15,0,0,16,0,0
"Singapore","2024-09-23",0,0,15,0,0,16,0,0
"Singapore","2024-09-24",0,0,15,0,0,16,0,0
"Singapore","2024-09-25",0,0,15,0,0,16,0,0
"Singapore","2024-09-26",0,0,15,0,0,16,0,0
"Singapore","2024-09-27",0,0,15,0,0,16,0,0
"Singapore","2024-09-28",0,0,15,0,0,16,0,0
"Singapore","2024-09-29",0,0,15,0,0,16,0,0
"Singapore","2024-09-30",0,0,15,0,0,16,0,0
"Singapore","2024-10-01",0,0,15,0,0,16,0,0
"Singapore","2024-10-02",0,0,15,0,0,16,0,0
"Singapore","2024-10-03",0,0,15,0,1,17,0,0
"Singapore","2024-10-04",0,0,15,0,0,17,0,0
"Singapore","2024-10-05",0,0,15,0,0,17,0,0
"Singapore","2024-10-06",0,0,15,0,0,17,0,0
"Singapore","2024-10-07",0,0,15,0,0,17,0,0
"Singapore","2024-10-08",0,0,15,0,0,17,0,0
"Singapore","2024-10-09",0,0,15,0,0,17,0,0
"Singapore","2024-10-10",0,0,15,0,0,17,0,0
"Singapore","2024-10-11",0,2,17,0,0,17,0,0
"Singapore","2024-10-12",0,0,17,0,0,17,0,0
"Singapore","2024-10-13",0,0,17,0,0,17,0,0
"Singapore","2024-10-14",0,0,17,0,0,17,0,0
"Singapore","2024-10-15",0,0,17,0,0,17,0,0
"Singapore","2024-10-16",0,0,17,0,0,17,0,0
"Singapore","2024-10-17",0,0,17,0,0,17,0,0
"Singapore","2024-10-18",0,0,17,0,0,17,0,0
"Singapore","2024-10-19",0,0,17,0,0,17,0,0
"Singapore","2024-10-20",0,0,17,0,0,17,0,0
"Singapore","2024-10-21",0,0,17,0,0,17,0,0
"Singapore","2024-10-22",0,0,17,0,0,17,0,0
"Singapore","2024-10-23",0,0,17,0,0,17,0,0
"Singapore","2024-10-24",0,0,17,0,0,17,0,0
"Singapore","2024-10-25",0,0,17,0,0,17,0,0
"Singapore","2024-10-26",0,0,17,0,0,17,0,0
"Singapore","2024-10-27",0,0,17,0,0,17,0,0
"Singapore","2024-10-28",0,0,17,0,0,17,0,0
"Singapore","2024-10-29",0,0,17,0,0,17,0,0
"Singapore","2024-10-30",0,0,17,0,0,17,0,0
"Singapore","2024-10-31",0,0,17,0,0,17,0,0
"Singapore","2024-11-01",0,0,17,0,0,17,0,0
"Singapore","2024-11-02",0,0,17,0,0,17,0,0
"Singapore","2024-11-03",0,0,17,0,0,17,0,0
"Singapore","2024-11-04",0,0,17,0,0,17,0,0
"Singapore","2024-11-05",0,0,17,0,0,17,0,0
"Singapore","2024-11-06",0,0,17,0,0,17,0,0
"Singapore","2024-11-07",0,0,17,0,0,17,0,0
"Singapore","2024-11-08",0,0,17,0,0,17,0,0
"Singapore","2024-11-09",0,0,17,0,0,17,0,0
"Singapore","2024-11-10",0,0,17,0,0,17,0,0
"Singapore","2024-11-11",0,0,17,0,0,17,0,0
"Singapore","2024-11-12",0,0,17,0,0,17,0,0
"Singapore","2024-11-13",0,0,17,0,0,17,0,0
"Singapore","2024-11-14",0,0,17,0,0,17,0,0
"Singapore","2024-11-15",0,0,17,0,0,17,0,0
"Singapore","2024-11-16",0,0,17,0,0,17,0,0
"Singapore","2024-11-17",0,0,17,0,0,17,0,0
"Singapore","2024-11-18",0,0,17,0,0,17,0,0
"Singapore","2024-11-19",0,0,17,0,0,17,0,0
"Singapore","2024-11-20",0,0,17,0,0,17,0,0
"Singapore","2024-11-21",0,0,17,0,0,17,0,0
"Singapore","2024-11-22",0,0,17,0,0,17,0,0
"Singapore","2024-11-23",0,0,17,0,0,17,0,0
"Singapore","2024-11-24",0,0,17,0,0,17,0,0
"Singapore","2024-11-25",0,0,17,0,0,17,0,0
"Singapore","2024-11-26",0,0,17,0,0,17,0,0
"Singapore","2024-11-27",0,0,17,0,0,17,0,0
"Singapore","2024-11-28",0,0,17,0,0,17,0,0
"Singapore","2024-11-29",0,0,17,0,0,17,0,0
"Singapore","2024-11-30",0,0,17,0,0,17,0,0
"Singapore","2024-12-01",0,0,17,0,0,17,0,0
"Singapore","2024-12-02",0,0,17,0,0,17,0,0
"Singapore","2024-12-03",0,0,17,0,0,17,0,0
"Singapore","2024-12-04",0,0,17,0,0,17,0,0
"Singapore","2024-12-05",0,0,17,0,0,17,0,0
"Singapore","2024-12-06",0,0,17,0,0,17,0,0
"Singapore","2024-12-07",0,0,17,0,0,17,0,0
"Singapore","2024-12-08",0,0,17,0,0,17,0,0
"Singapore","2024-12-09",0,0,17,0,0,17,0,0
"Singapore","2024-12-10",0,0,17,0,0,17,0,0
"Singapore","2024-12-11",0,0,17,0,0,17,0,0
"Singapore","2024-12-12",0,0,17,0,0,17,0,0
"Singapore","2024-12-13",0,0,17,0,0,17,0,0
"Singapore","2024-12-14",0,0,17,0,0,17,0,0
"Singapore","2024-12-15",0,0,17,0,0,17,0,0
"Singapore","2024-12-16",0,0,17,0,0,17,0,0
"Singapore","2024-12-17",0,0,17,0,0,17,0,0
"Singapore","2024-12-18",0,0,17,0,0,17,0,0
"Singapore","2024-12-19",0,0,17,0,0,17,0,0
"Singapore","2024-12-20",0,0,17,0,0,17,0,0
"Singapore","2024-12-21",0,0,17,0,0,17,0,0
"Singapore","2024-12-22",0,0,17,0,0,17,0,0
"Singapore","2024-12-23",0,0,17,0,0,17,0,0
"Singapore","2024-12-24",0,0,17,0,0,17,0,0
"Singapore","2024-12-25",0,0,17,0,0,17,0,0
"Singapore","2024-12-26",0,0,17,0,0,17,0,0
"Singapore","2024-12-27",0,0,17,0,0,17,0,0
"Singapore","2024-12-28",0,0,17,0,0,17,0,0
"Singapore","2024-12-29",0,0,17,0,0,17,0,0
"Singapore","2024-12-30",0,0,17,0,0,17,0,0
"Singapore","2024-12-31",0,0,17,0,0,17,0,0
"Singapore","2025-01-01",0,0,17,0,0,17,0,0
"Singapore","2025-01-02",0,0,17,0,0,17,0,0
"Singapore","2025-01-03",0,0,17,0,0,17,0,0
"Singapore","2025-01-04",0,0,17,0,0,17,0,0
"Singapore","2025-01-05",0,0,17,0,0,17,0,0
"Singapore","2025-01-06",0,0,17,0,0,17,0,0
"Singapore","2025-01-07",0,0,17,0,0,17,0,0
"Singapore","2025-01-08",0,0,17,0,0,17,0,0
"Singapore","2025-01-09",0,0,17,0,0,17,0,0
"Singapore","2025-01-10",0,0,17,0,0,17,0,0
"Singapore","2025-01-11",0,0,17,0,0,17,0,0
"Singapore","2025-01-12",0,0,17,0,0,17,0,0
"Singapore","2025-01-13",0,0,17,0,0,17,0,0
"Slovakia","2024-01-01",0,0,0,0,0,0,0,0
"Slovakia","2024-01-02",0,0,0,0,0,0,0,0
"Slovakia","2024-01-03",0,0,0,0,0,0,0,0
"Slovakia","2024-01-04",0,0,0,0,0,0,0,0
"Slovakia","2024-01-05",0,0,0,0,0,0,0,0
"Slovakia","2024-01-06",0,0,0,0,0,0,0,0
"Slovakia","2024-01-07",0,0,0,0,0,0,0,0
"Slovakia","2024-01-08",0,0,0,0,0,0,0,0
"Slovakia","2024-01-09",0,0,0,0,0,0,0,0
"Slovakia","2024-01-10",0,0,0,0,0,0,0,0
"Slovakia","2024-01-11",0,0,0,0,0,0,0,0
"Slovakia","2024-01-12",0,0,0,0,0,0,0,0
"Slovakia","2024-01-13",0,0,0,0,0,0,0,0
"Slovakia","2024-01-14",0,0,0,0,0,0,0,0
"Slovakia","2024-01-15",0,0,0,0,0,0,0,0
"Slovakia","2024-01-16",0,0,0,0,0,0,0,0
"Slovakia","2024-01-17",0,0,0,0,0,0,0,0
"Slovakia","2024-01-18",0,0,0,0,0,0,0,0
"Slovakia","2024-01-19",0,0,0,0,0,0,0,0
"Slovakia","2024-01-20",0,0,0,0,0,0,0,0
"Slovakia","2024-01-21",0,0,0,0,0,0,0,0
"Slovakia","2024-01-22",0,0,0,0,0,0,0,0
"Slovakia","2024-01-23",0,0,0,0,0,0,0,0
"Slovakia","2024-01-24",0,0,0,0,0,0,0,0
"Slovakia","2024-01-25",0,0,0,0,0,0,0,0
"Slovakia","2024-01-26",0,0,0,0,0,0,0,0
"Slovakia","2024-01-27",0,0,0,0,0,0,0,0
"Slovakia","2024-01-28",0,0,0,0,0,0,0,0
"Slovakia","2024-01-29",0,0,0,0,0,0,0,0
"Slovakia","2024-01-30",0,0,0,0,0,0,0,0
"Slovakia","2024-01-31",0,2,2,0,2,2,0,0
"Slovakia","2024-02-01",0,0,2,0,0,2,0,0
"Slovakia","2024-02-02",0,0,2,0,0,2,0,0
"Slovakia","2024-02-03",0,0,2,0,0,2,0,0
"Slovakia","2024-02-04",0,0,2,0,0,2,0,0
"Slovakia","2024-02-05",0,0,2,0,0,2,0,0
"Slovakia","2024-02-06",0,0,2,0,0,2,0,0
"Slovakia","2024-02-07",0,0,2,0,0,2,0,0
"Slovakia","2024-02-08",0,0,2,0,0,2,0,0
"Slovakia","2024-02-09",0,0,2,0,0,2,0,0
"Slovakia","2024-02-10",0,0,2,0,0,2,0,0
"Slovakia","2024-02-11",0,0,2,0,0,2,0,0
"Slovakia","2024-02-12",0,0,2,0,0,2,0,0
"Slovakia","2024-02-13",0,0,2,0,0,2,0,0
"Slovakia","2024-02-14",0,0,2,0,0,2,0,0
"Slovakia","2024-02-15",0,0,2,0,0,2,0,0
"Slovakia","2024-02-16",0,0,2,0,0,2,0,0
"Slovakia","2024-02-17",0,0,2,0,0,2,0,0
"Slovakia","2024-02-18",0,0,2,0,0,2,0,0
"Slovakia","2024-02-19",0,0,2,0,0,2,0,0
"Slovakia","2024-02-20",0,0,2,0,0,2,0,0
"Slovakia","2024-02-21",0,0,2,0,0,2,0,0
"Slovakia","2024-02-22",0,0,2,0,0,2,0,0
"Slovakia","2024-02-23",0,0,2,0,0,2,0,0
"Slovakia","2024-02-24",0,0,2,0,0,2,0,0
"Slovakia","2024-02-25",0,0,2,0,0,2,0,0
"Slovakia","2024-02-26",0,0,2,0,0,2,0,0
"Slovakia","2024-02-27",0,0,2,0,0,2,0,0
"Slovakia","2024-02-28",0,0,2,0,0,2,0,0
"Slovakia","2024-02-29",0,0,2,0,0,2,0,0
"Slovakia","2024-03-01",0,0,2,0,0,2,0,0
"Slovakia","2024-03-02",0,0,2,0,0,2,0,0
"Slovakia","2024-03-03",0,0,2,0,0,2,0,0
"Slovakia","2024-03-04",0,0,2,0,0,2,0,0
"Slovakia","2024-03-05",0,0,2,0,0,2,0,0
"Slovakia","2024-03-06",0,0,2,0,0,2,0,0
"Slovakia","2024-03-07",0,0,2,0,0,2,0,0
"Slovakia","2024-03-08",0,0,2,0,0,2,0,0
"Slovakia","2024-03-09",0,0,2,0,0,2,0,0
"Slovakia","2024-03-10",0,0,2,0,0,2,0,0
"Slovakia","2024-03-11",0,0,2,0,0,2,0,0
"Slovakia","2024-03-12",0,0,2,0,0,2,0,0
"Slovakia","2024-03-13",0,0,2,0,0,2,0,0
"Slovakia","2024-03-14",0,0,2,0,0,2,0,0
"Slovakia","2024-03-15",0,0,2,0,0,2,0,0
"Slovakia","2024-03-16",0,0,2,0,0,2,0,0
"Slovakia","2024-03-17",0,0,2,0,0,2,0,0
"Slovakia","2024-03-18",0,0,2,0,0,2,0,0
"Slovakia","2024-03-19",0,0,2,0,0,2,0,0
"Slovakia","2024-03-20",0,0,2,0,0,2,0,0
"Slovakia","2024-03-21",0,0,2,0,0,2,0,0
"Slovakia","2024-03-22",0,0,2,0,0,2,0,0
"Slovakia","2024-03-23",0,0,2,0,0,2,0,0
"Slovakia","2024-03-24",0,0,2,0,0,2,0,0
"Slovakia","2024-03-25",0,0,2,0,0,2,0,0
"Slovakia","2024-03-26",0,0,2,0,0,2,0,0
"Slovakia","2024-03-27",0,0,2,0,0,2,0,0
"Slovakia","2024-03-28",0,0,2,0,0,2,0,0
"Slovakia","2024-03-29",0,0,2,0,0,2,0,0
"Slovakia","2024-03-30",0,0,2,0,0,2,0,0
"Slovakia","2024-03-31",0,0,2,0,0,2,0,0
"Slovakia","2024-04-01",0,0,2,0,0,2,0,0
"Slovakia","2024-04-02",0,0,2,0,0,2,0,0
"Slovakia","2024-04-03",0,0,2,0,0,2,0,0
"Slovakia","2024-04-04",0,0,2,0,0,2,0,0
"Slovakia","2024-04-05",0,0,2,0,0,2,0,0
"Slovakia","2024-04-06",0,0,2,0,0,2,0,0
"Slovakia","2024-04-07",0,0,2,0,0,2,0,0
"Slovakia","2024-04-08",0,0,2,0,0,2,0,0
"Slovakia","2024-04-09",0,0,2,0,0,2,0,0
"Slovakia","2024-04-10",0,0,2,0,0,2,0,0
"Slovakia","2024-04-11",0,0,2,0,0,2,0,0
"Slovakia","2024-04-12",0,0,2,0,0,2,0,0
"Slovakia","2024-04-13",0,0,2,0,0,2,0,0
"Slovakia","2024-04-14",0,0,2,0,0,2,0,0
"Slovakia","2024-04-15",0,0,2,0,0,2,0,0
"Slovakia","2024-04-16",0,0,2,0,0,2,0,0
"Slovakia","2024-04-17",0,0,2,0,1,3,0,0
"Slovakia","2024-04-18",0,0,2,0,0,3,0,0
"Slovakia","2024-04-19",0,0,2,0,0,3,0,0
"Slovakia","2024-04-20",0,0,2,0,0,3,0,0
"Slovakia","2024-04-21",0,0,2,0,0,3,0,0
"Slovakia","2024-04-22",0,0,2,0,0,3,0,0
"Slovakia","2024-04-23",0,0,2,0,0,3,0,0
"Slovakia","2024-04-24",0,0,2,0,0,3,0,0
"Slovakia","2024-04-25",0,0,2,0,0,3,0,0
"Slovakia","2024-04-26",0,0,2,0,0,3,0,0
"Slovakia","2024-04-27",0,0,2,0,0,3,0,0
"Slovakia","2024-04-28",0,0,2,0,0,3,0,0
"Slovakia","2024-04-29",0,0,2,0,0,3,0,0
"Slovakia","2024-04-30",0,0,2,0,0,3,0,0
"Slovakia","2024-05-01",0,0,2,0,0,3,0,0
"Slovakia","2024-05-02",0,0,2,0,0,3,0,0
"Slovakia","2024-05-03",0,0,2,0,0,3,0,0
"Slovakia","2024-05-04",0,0,2,0,0,3,0,0
"Slovakia","2024-05-05",0,0,2,0,0,3,0,0
"Slovakia","2024-05-06",0,0,2,0,0,3,0,0
"Slovakia","2024-05-07",0,0,2,0,0,3,0,0
"Slovakia","2024-05-08",0,0,2,0,0,3,0,0
"Slovakia","2024-05-09",0,0,2,0,0,3,0,0
"Slovakia","2024-05-10",0,0,2,0,0,3,0,0
"Slovakia","2024-05-11",0,0,2,0,0,3,0,0
"Slovakia","2024-05-12",0,0,2,0,0,3,0,0
"Slovakia","2024-05-13",0,0,2,0,0,3,0,0
"Slovakia","2024-05-14",0,0,2,0,0,3,0,0
"Slovakia","2024-05-15",0,0,2,0,0,3,0,0
"Slovakia","2024-05-16",0,0,2,0,0,3,0,0
"Slovakia","2024-05-17",0,0,2,0,0,3,0,0
"Slovakia","2024-05-18",0,0,2,0,0,3,0,0
"Slovakia","2024-05-19",0,0,2,0,0,3,0,0
"Slovakia","2024-05-20",0,0,2,0,0,3,0,0
"Slovakia","2024-05-21",0,0,2,0,0,3,0,0
"Slovakia","2024-05-22",0,0,2,0,0,3,0,0
"Slovakia","2024-05-23",0,0,2,0,0,3,0,0
"Slovakia","2024-05-24",0,0,2,0,0,3,0,0
"Slovakia","2024-05-25",0,0,2,0,0,3,0,0
"Slovakia","2024-05-26",0,0,2,0,0,3,0,0
"Slovakia","2024-05-27",0,0,2,0,0,3,0,0
"Slovakia","2024-05-28",0,0,2,0,0,3,0,0
"Slovakia","2024-05-29",0,0,2,0,0,3,0,0
"Slovakia","2024-05-30",0,0,2,0,0,3,0,0
"Slovakia","2024-05-31",0,0,2,0,0,3,0,0
"Slovakia","2024-06-01",0,0,2,0,0,3,0,0
"Slovakia","2024-06-02",0,0,2,0,0,3,0,0
"Slovakia","2024-06-03",0,0,2,0,0,3,0,0
"Slovakia","2024-06-04",0,0,2,0,0,3,0,0
"Slovakia","2024-06-05",0,0,2,0,0,3,0,0
"Slovakia","2024-06-06",0,0,2,0,0,3,0,0
"Slovakia","2024-06-07",0,0,2,0,0,3,0,0
"Slovakia","2024-06-08",0,0,2,0,0,3,0,0
"Slovakia","2024-06-09",0,0,2,0,0,3,0,0
"Slovakia","2024-06-10",0,0,2,0,0,3,0,0
"Slovakia","2024-06-11",0,0,2,0,0,3,0,0
"Slovakia","2024-06-12",0,0,2,0,0,3,0,0
"Slovakia","2024-06-13",0,0,2,0,0,3,0,0
"Slovakia","2024-06-14",0,0,2,0,0,3,0,0
"Slovakia","2024-06-15",0,0,2,0,0,3,0,0
"Slovakia","2024-06-16",0,0,2,0,0,3,0,0
"Slovakia","2024-06-17",0,0,2,0,0,3,0,0
"Slovakia","2024-06-18",0,0,2,0,0,3,0,0
"Slovakia","2024-06-19",0,0,2,0,0,3,0,0
"Slovakia","2024-06-20",0,0,2,0,0,3,0,0
"Slovakia","2024-06-21",0,0,2,0,0,3,0,0
"Slovakia","2024-06-22",0,0,2,0,0,3,0,0
"Slovakia","2024-06-23",0,0,2,0,0,3,0,0
"Slovakia","2024-06-24",0,0,2,0,0,3,0,0
"Slovakia","2024-06-25",0,0,2,0,0,3,0,0
"Slovakia","2024-06-26",0,0,2,0,0,3,0,0
"Slovakia","2024-06-27",0,0,2,0,0,3,0,0
"Slovakia","2024-06-28",0,0,2,0,0,3,0,0
"Slovakia","2024-06-29",0,0,2,0,0,3,0,0
"Slovakia","2024-06-30",0,0,2,0,0,3,0,0
"Slovakia","2024-07-01",0,0,2,0,0,3,0,0
"Slovakia","2024-07-02",0,0,2,0,0,3,0,0
"Slovakia","2024-07-03",0,0,2,0,0,3,0,0
"Slovakia","2024-07-04",0,0,2,0,0,3,0,0
"Slovakia","2024-07-05",0,0,2,0,0,3,0,0
"Slovakia","2024-07-06",0,0,2,0,0,3,0,0
"Slovakia","2024-07-07",0,0,2,0,0,3,0,0
"Slovakia","2024-07-08",0,0,2,0,0,3,0,0
"Slovakia","2024-07-09",0,0,2,0,0,3,0,0
"Slovakia","2024-07-10",0,0,2,0,0,3,0,0
"Slovakia","2024-07-11",0,0,2,0,0,3,0,0
"Slovakia","2024-07-12",0,0,2,0,0,3,0,0
"Slovakia","2024-07-13",0,0,2,0,0,3,0,0
"Slovakia","2024-07-14",0,0,2,0,0,3,0,0
"Slovakia","2024-07-15",0,0,2,0,0,3,0,0
"Slovakia","2024-07-16",0,0,2,0,0,3,0,0
"Slovakia","2024-07-17",0,0,2,0,0,3,0,0
"Slovakia","2024-07-18",0,0,2,0,0,3,0,0
"Slovakia","2024-07-19",0,0,2,0,0,3,0,0
"Slovakia","2024-07-20",0,0,2,0,0,3,0,0
"Slovakia","2024-07-21",0,0,2,0,0,3,0,0
"Slovakia","2024-07-22",0,0,2,0,0,3,0,0
"Slovakia","2024-07-23",0,0,2,0,0,3,0,0
"Slovakia","2024-07-24",0,0,2,0,0,3,0,0
"Slovakia","2024-07-25",0,0,2,0,0,3,0,0
"Slovakia","2024-07-26",0,0,2,0,0,3,0,0
"Slovakia","2024-07-27",0,0,2,0,0,3,0,0
"Slovakia","2024-07-28",0,0,2,0,0,3,0,0
"Slovakia","2024-07-29",0,0,2,0,0,3,0,0
"Slovakia","2024-07-30",0,0,2,0,0,3,0,0
"Slovakia","2024-07-31",0,0,2,0,0,3,0,0
"Slovakia","2024-08-01",0,0,2,0,0,3,0,0
"Slovakia","2024-08-02",0,0,2,0,0,3,0,0
"Slovakia","2024-08-03",0,0,2,0,0,3,0,0
"Slovakia","2024-08-04",0,0,2,0,0,3,0,0
"Slovakia","2024-08-05",0,0,2,0,0,3,0,0
"Slovakia","2024-08-06",0,0,2,0,0,3,0,0
"Slovakia","2024-08-07",0,0,2,0,0,3,0,0
"Slovakia","2024-08-08",0,0,2,0,0,3,0,0
"Slovakia","2024-08-09",0,0,2,0,0,3,0,0
"Slovakia","2024-08-10",0,0,2,0,0,3,0,0
"Slovakia","2024-08-11",0,0,2,0,0,3,0,0
"Slovakia","2024-08-12",0,0,2,0,0,3,0,0
"Slovakia","2024-08-13",0,0,2,0,0,3,0,0
"Slovakia","2024-08-14",0,0,2,0,0,3,0,0
"Slovakia","2024-08-15",0,0,2,0,0,3,0,0
"Slovakia","2024-08-16",0,0,2,0,0,3,0,0
"Slovakia","2024-08-17",0,0,2,0,0,3,0,0
"Slovakia","2024-08-18",0,0,2,0,0,3,0,0
"Slovakia","2024-08-19",0,0,2,0,0,3,0,0
"Slovakia","2024-08-20",0,0,2,0,0,3,0,0
"Slovakia","2024-08-21",0,0,2,0,0,3,0,0
"Slovakia","2024-08-22",0,0,2,0,0,3,0,0
"Slovakia","2024-08-23",0,0,2,0,0,3,0,0
"Slovakia","2024-08-24",0,0,2,0,0,3,0,0
"Slovakia","2024-08-25",0,0,2,0,0,3,0,0
"Slovakia","2024-08-26",0,0,2,0,0,3,0,0
"Slovakia","2024-08-27",0,0,2,0,0,3,0,0
"Slovakia","2024-08-28",0,0,2,0,0,3,0,0
"Slovakia","2024-08-29",0,0,2,0,0,3,0,0
"Slovakia","2024-08-30",0,0,2,0,0,3,0,0
"Slovakia","2024-08-31",0,0,2,0,0,3,0,0
"Slovakia","2024-09-01",0,0,2,0,0,3,0,0
"Slovakia","2024-09-02",0,0,2,0,0,3,0,0
"Slovakia","2024-09-03",0,0,2,0,0,3,0,0
"Slovakia","2024-09-04",0,0,2,0,0,3,0,0
"Slovakia","2024-09-05",0,0,2,0,0,3,0,0
"Slovakia","2024-09-06",0,0,2,0,0,3,0,0
"Slovakia","2024-09-07",0,0,2,0,0,3,0,0
"Slovakia","2024-09-08",0,0,2,0,0,3,0,0
"Slovakia","2024-09-09",0,0,2,0,0,3,0,0
"Slovakia","2024-09-10",0,0,2,0,0,3,0,0
"Slovakia","2024-09-11",0,0,2,0,0,3,0,0
"Slovakia","2024-09-12",0,0,2,0,0,3,0,0
"Slovakia","2024-09-13",0,0,2,0,0,3,0,0
"Slovakia","2024-09-14",0,0,2,0,0,3,0,0
"Slovakia","2024-09-15",0,0,2,0,1,4,0,0
"Slovakia","2024-09-16",0,0,2,0,0,4,0,0
"Slovakia","2024-09-17",0,0,2,0,0,4,0,0
"Slovakia","2024-09-18",0,0,2,0,0,4,0,0
"Slovakia","2024-09-19",0,0,2,0,0,4,0,0
"Slovakia","2024-09-20",0,0,2,0,0,4,0,0
"Slovakia","2024-09-21",0,0,2,0,0,4,0,0
"Slovakia","2024-09-22",0,0,2,0,0,4,0,0
"Slovakia","2024-09-23",0,0,2,0,0,4,0,0
"Slovakia","2024-09-24",0,0,2,0,0,4,0,0
"Slovakia","2024-09-25",0,0,2,0,0,4,0,0
"Slovakia","2024-09-26",0,0,2,0,0,4,0,0
"Slovakia","2024-09-27",0,0,2,0,0,4,0,0
"Slovakia","2024-09-28",0,0,2,0,0,4,0,0
"Slovakia","2024-09-29",0,0,2,0,0,4,0,0
"Slovakia","2024-09-30",0,0,2,0,0,4,0,0
"Slovakia","2024-10-01",0,0,2,0,0,4,0,0
"Slovakia","2024-10-02",0,0,2,0,0,4,0,0
"Slovakia","2024-10-03",0,0,2,0,0,4,0,0
"Slovakia","2024-10-04",0,0,2,0,0,4,0,0
"Slovakia","2024-10-05",0,0,2,0,0,4,0,0
"Slovakia","2024-10-06",0,0,2,0,0,4,0,0
"Slovakia","2024-10-07",0,0,2,0,0,4,0,0
"Slovakia","2024-10-08",0,0,2,0,0,4,0,0
"Slovakia","2024-10-09",0,0,2,0,0,4,0,0
"Slovakia","2024-10-10",0,0,2,0,0,4,0,0
"Slovakia","2024-10-11",0,0,2,0,0,4,0,0
"Slovakia","2024-10-12",0,0,2,0,0,4,0,0
"Slovakia","2024-10-13",0,0,2,0,0,4,0,0
"Slovakia","2024-10-14",0,0,2,0,0,4,0,0
"Slovakia","2024-10-15",0,0,2,0,0,4,0,0
"Slovakia","2024-10-16",0,0,2,0,0,4,0,0
"Slovakia","2024-10-17",0,0,2,0,0,4,0,0
"Slovakia","2024-10-18",0,0,2,0,0,4,0,0
"Slovakia","2024-10-19",0,0,2,0,0,4,0,0
"Slovakia","2024-10-20",0,0,2,0,0,4,0,0
"Slovakia","2024-10-21",0,0,2,0,0,4,0,0
"Slovakia","2024-10-22",0,0,2,0,0,4,0,0
"Slovakia","2024-10-23",0,0,2,0,0,4,0,0
"Slovakia","2024-10-24",0,0,2,0,0,4,0,0
"Slovakia","2024-10-25",0,0,2,0,0,4,0,0
"Slovakia","2024-10-26",0,0,2,0,0,4,0,0
"Slovakia","2024-10-27",0,0,2,0,0,4,0,0
"Slovakia","2024-10-28",0,0,2,0,0,4,0,0
"Slovakia","2024-10-29",0,0,2,0,0,4,0,0
"Slovakia","2024-10-30",0,0,2,0,0,4,0,0
"Slovakia","2024-10-31",0,0,2,0,0,4,0,0
"Slovakia","2024-11-01",0,0,2,0,0,4,0,0
"Slovakia","2024-11-02",0,0,2,0,0,4,0,0
"Slovakia","2024-11-03",0,0,2,0,0,4,0,0
"Slovakia","2024-11-04",0,0,2,0,0,4,0,0
"Slovakia","2024-11-05",0,0,2,0,0,4,0,0
"Slovakia","2024-11-06",0,0,2,0,0,4,0,0
"Slovakia","2024-11-07",0,0,2,0,0,4,0,0
"Slovakia","2024-11-08",0,0,2,0,0,4,0,0
"Slovakia","2024-11-09",0,0,2,0,0,4,0,0
"Slovakia","2024-11-10",0,0,2,0,0,4,0,0
"Slovakia","2024-11-11",0,0,2,0,0,4,0,0
"Slovakia","2024-11-12",0,0,2,0,0,4,0,0
"Slovakia","2024-11-13",0,0,2,0,0,4,0,0
"Slovakia","2024-11-14",0,0,2,0,0,4,0,0
"Slovakia","2024-11-15",0,0,2,0,0,4,0,0
"Slovakia","2024-11-16",0,0,2,0,0,4,0,0
"Slovakia","2024-11-17",0,0,2,0,0,4,0,0
"Slovakia","2024-11-18",0,0,2,0,0,4,0,0
"Slovakia","2024-11-19",0,0,2,0,0,4,0,0
"Slovakia","2024-11-20",0,0,2,0,0,4,0,0
"Slovakia","2024-11-21",0,0,2,0,0,4,0,0
"Slovakia","2024-11-22",0,0,2,0,0,4,0,0
"Slovakia","2024-11-23",0,0,2,0,0,4,0,0
"Slovakia","2024-11-24",0,0,2,0,0,4,0,0
"Slovakia","2024-11-25",0,0,2,0,0,4,0,0
"Slovakia","2024-11-26",0,0,2,0,0,4,0,0
"Slovakia","2024-11-27",0,0,2,0,0,4,0,0
"Slovakia","2024-11-28",0,0,2,0,0,4,0,0
"Slovakia","2024-11-29",0,0,2,0,0,4,0,0
"Slovakia","2024-11-30",0,2,4,0,0,4,0,0
"Slovakia","2024-12-01",0,0,4,0,0,4,0,0
"Slovakia","2024-12-02",0,0,4,0,0,4,0,0
"Slovakia","2024-12-03",0,0,4,0,0,4,0,0
"Slovakia","2024-12-04",0,0,4,0,0,4,0,0
"Slovakia","2024-12-05",0,0,4,0,0,4,0,0
"Slovakia","2024-12-06",0,0,4,0,0,4,0,0
"Slovakia","2024-12-07",0,0,4,0,0,4,0,0
"Slovakia","2024-12-08",0,0,4,0,0,4,0,0
"Slovakia","2024-12-09",0,0,4,0,0,4,0,0
"Slovakia","2024-12-10",0,0,4,0,0,4,0,0
"Slovakia","2024-12-11",0,0,4,0,0,4,0,0
"Slovakia","2024-12-12",0,0,4,0,0,4,0,0
"Slovakia","2024-12-13",0,0,4,0,0,4,0,0
"Slovakia","2024-12-14",0,0,4,0,0,4,0,0
"Slovakia","2024-12-15",0,0,4,0,0,4,0,0
"Slovakia","2024-12-16",0,0,4,0,0,4,0,0
"Slovakia","2024-12-17",0,0,4,0,0,4,0,0
"Slovakia","2024-12-18",0,0,4,0,0,4,0,0
"Slovakia","2024-12-19",0,0,4,0,0,4,0,0
"Slovakia","2024-12-20",0,0,4,0,0,4,0,0
"Slovakia","2024-12-21",0,0,4,0,0,4,0,0
"Slovakia","2024-12-22",0,0,4,0,0,4,0,0
"Slovakia","2024-12-23",0,0,4,0,0,4,0,0
"Slovakia","2024-12-24",0,0,4,0,0,4,0,0
"Slovakia","2024-12-25",0,0,4,0,0,4,0,0
"Slovakia","2024-12-26",0,0,4,0,0,4,0,0
"Slovakia","2024-12-27",0,0,4,0,0,4,0,0
"Slovakia","2024-12-28",0,0,4,0,0,4,0,0
"Slovakia","2024-12-29",0,0,4,0,0,4,0,0
"Slovakia","2024-12-30",0,0,4,0,0,4,0,0
"Slovakia","2024-12-31",0,0,4,0,0,4,0,0
"Slovakia","2025-01-01",0,0,4,0,0,4,0,0
"Slovakia","2025-01-02",0,0,4,0,0,4,0,0
"Slovakia","2025-01-03",0,0,4,0,0,4,0,0
"Slovakia","2025-01-04",0,0,4,0,0,4,0,0
"Slovakia","2025-01-05",0,0,4,0,0,4,0,0
"Slovakia","2025-01-06",0,0,4,0,0,4,0,0
"Slovakia","2025-01-07",0,0,4,0,0,4,0,0
"Slovakia","2025-01-08",0,0,4,0,0,4,0,0
"Slovakia","2025-01-09",0,0,4,0,0,4,0,0
"Slovakia","2025-01-10",0,0,4,0,0,4,0,0
"Slovakia","2025-01-11",0,0,4,0,0,4,0,0
"Slovakia","2025-01-12",0,0,4,0,0,4,0,0
"Slovakia","2025-01-13",0,0,4,0,0,4,0,0
"Slovenia","2024-01-01",0,0,0,0,0,0,0,0
"Slovenia","2024-01-02",0,0,0,0,0,0,0,0
"Slovenia","2024-01-03",0,0,0,0,0,0,0,0
"Slovenia","2024-01-04",0,0,0,0,0,0,0,0
"Slovenia","2024-01-05",0,0,0,0,0,0,0,0
"Slovenia","2024-01-06",0,0,0,0,0,0,0,0
"Slovenia","2024-01-07",0,0,0,0,0,0,0,0
"Slovenia","2024-01-08",0,0,0,0,0,0,0,0
"Slovenia","2024-01-09",0,0,0,0,0,0,0,0
"Slovenia","2024-01-10",0,0,0,0,0,0,0,0
"Slovenia","2024-01-11",0,0,0,0,0,0,0,0
"Slovenia","2024-01-12",0,0,0,0,0,0,0,0
"Slovenia","2024-01-13",0,0,0,0,0,0,0,0
"Slovenia","2024-01-14",0,0,0,0,0,0,0,0
"Slovenia","2024-01-15",0,0,0,0,0,0,0,0
"Slovenia","2024-01-16",0,0,0,0,0,0,0,0
"Slovenia","2024-01-17",0,0,0,0,0,0,0,0
"Slovenia","2024-01-18",0,0,0,0,0,0,0,0
"Slovenia","2024-01-19",0,0,0,0,0,0,0,0
"Slovenia","2024-01-20",0,0,0,0,0,0,0,0
"Slovenia","2024-01-21",0,0,0,0,0,0,0,0
"Slovenia","2024-01-22",0,0,0,0,0,0,0,0
"Slovenia","2024-01-23",0,0,0,0,0,0,0,0
"Slovenia","2024-01-24",0,0,0,0,0,0,0,0
"Slovenia","2024-01-25",0,0,0,0,0,0,0,0
"Slovenia","2024-01-26",0,0,0,0,0,0,0,0
"Slovenia","2024-01-27",0,0,0,0,0,0,0,0
"Slovenia","2024-01-28",0,0,0,0,0,0,0,0
"Slovenia","2024-01-29",0,0,0,0,0,0,0,0
"Slovenia","2024-01-30",0,0,0,0,0,0,0,0
"Slovenia","2024-01-31",0,0,0,0,0,0,0,0
"Slovenia","2024-02-01",0,0,0,0,0,0,0,0
"Slovenia","2024-02-02",0,0,0,0,0,0,0,0
"Slovenia","2024-02-03",0,0,0,0,0,0,0,0
"Slovenia","2024-02-04",0,0,0,0,0,0,0,0
"Slovenia","2024-02-05",0,0,0,0,0,0,0,0
"Slovenia","2024-02-06",0,0,0,0,0,0,0,0
"Slovenia","2024-02-07",0,0,0,0,0,0,0,0
"Slovenia","2024-02-08",0,0,0,0,0,0,0,0
"Slovenia","2024-02-09",0,0,0,0,0,0,0,0
"Slovenia","2024-02-10",0,0,0,0,0,0,0,0
"Slovenia","2024-02-11",0,0,0,0,0,0,0,0
"Slovenia","2024-02-12",0,0,0,0,0,0,0,0
"Slovenia","2024-02-13",0,0,0,0,0,0,0,0
"Slovenia","2024-02-14",0,0,0,0,0,0,0,0
"Slovenia","2024-02-15",0,0,0,0,0,0,0,0
"Slovenia","2024-02-16",0,0,0,0,0,0,0,0
"Slovenia","2024-02-17",0,0,0,0,0,0,0,0
"Slovenia","2024-02-18",0,0,0,0,0,0,0,0
"Slovenia","2024-02-19",0,0,0,0,0,0,0,0
"Slovenia","2024-02-20",0,0,0,0,0,0,0,0
"Slovenia","2024-02-21",0,0,0,0,0,0,0,0
"Slovenia","2024-02-22",0,0,0,0,0,0,0,0
"Slovenia","2024-02-23",0,0,0,0,0,0,0,0
"Slovenia","2024-02-24",0,0,0,0,0,0,0,0
"Slovenia","2024-02-25",0,0,0,0,0,0,0,0
"Slovenia","2024-02-26",0,0,0,0,0,0,0,0
"Slovenia","2024-02-27",0,0,0,0,0,0,0,0
"Slovenia","2024-02-28",0,0,0,0,0,0,0,0
"Slovenia","2024-02-29",0,0,0,0,0,0,0,0
"Slovenia","2024-03-01",0,0,0,0,0,0,0,0
"Slovenia","2024-03-02",0,0,0,0,0,0,0,0
"Slovenia","2024-03-03",0,0,0,0,0,0,0,0
"Slovenia","2024-03-04",0,0,0,0,0,0,0,0
"Slovenia","2024-03-05",0,0,0,0,0,0,0,0
"Slovenia","2024-03-06",0,0,0,0,0,0,0,0
"Slovenia","2024-03-07",0,0,0,0,0,0,0,0
"Slovenia","2024-03-08",0,0,0,0,0,0,0,0
"Slovenia","2024-03-09",0,0,0,0,0,0,0,0
"Slovenia","2024-03-10",0,0,0,0,0,0,0,0
"Slovenia","2024-03-11",0,0,0,0,0,0,0,0
"Slovenia","2024-03-12",0,0,0,0,0,0,0,0
"Slovenia","2024-03-13",0,0,0,0,0,0,0,0
"Slovenia","2024-03-14",0,0,0,0,0,0,0,0
"Slovenia","2024-03-15",0,0,0,0,0,0,0,0
"Slovenia","2024-03-16",0,0,0,0,0,0,0,0
"Slovenia","2024-03-17",0,0,0,0,0,0,0,0
"Slovenia","2024-03-18",0,0,0,0,0,0,0,0
"Slovenia","2024-03-19",0,0,0,0,0,0,0,0
"Slovenia","2024-03-20",0,0,0,0,0,0,0,0
"Slovenia","2024-03-21",0,0,0,0,0,0,0,0
"Slovenia","2024-03-22",0,0,0,0,0,0,0,0
"Slovenia","2024-03-23",0,0,0,0,0,0,0,0
"Slovenia","2024-03-24",0,0,0,0,0,0,0,0
"Slovenia","2024-03-25",0,0,0,0,0,0,0,0
"Slovenia","2024-03-26",0,0,0,0,0,0,0,0
"Slovenia","2024-03-27",0,0,0,0,0,0,0,0
"Slovenia","2024-03-28",0,0,0,0,0,0,0,0
"Slovenia","2024-03-29",0,0,0,0,0,0,0,0
"Slovenia","2024-03-30",0,0,0,0,0,0,0,0
"Slovenia","2024-03-31",0,0,0,0,0,0,0,0
"Slovenia","2024-04-01",0,0,0,0,0,0,0,0
"Slovenia","2024-04-02",0,0,0,0,0,0,0,0
"Slovenia","2024-04-03",0,0,0,0,0,0,0,0
"Slovenia","2024-04-04",0,0,0,0,0,0,0,0
"Slovenia","2024-04-05",0,0,0,0,0,0,0,0
"Slovenia","2024-04-06",0,0,0,0,0,0,0,0
"Slovenia","2024-04-07",0,0,0,0,0,0,0,0
"Slovenia","2024-04-08",0,0,0,0,0,0,0,0
"Slovenia","2024-04-09",0,0,0,0,0,0,0,0
"Slovenia","2024-04-10",0,0,0,0,0,0,0,0
"Slovenia","2024-04-11",0,0,0,0,0,0,0,0
"Slovenia","2024-04-12",0,0,0,0,0,0,0,0
"Slovenia","2024-04-13",0,0,0,0,0,0,0,0
"Slovenia","2024-04-14",0,0,0,0,0,0,0,0
"Slovenia","2024-04-15",0,0,0,0,0,0,0,0
"Slovenia","2024-04-16",0,0,0,0,0,0,0,0
"Slovenia","2024-04-17",0,0,0,0,0,0,0,0
"Slovenia","2024-04-18",0,0,0,0,0,0,0,0
"Slovenia","2024-04-19",0,0,0,0,0,0,0,0
"Slovenia","2024-04-20",0,0,0,0,0,0,0,0
"Slovenia","2024-04-21",0,0,0,0,0,0,0,0
"Slovenia","2024-04-22",0,0,0,0,0,0,0,0
"Slovenia","2024-04-23",0,0,0,0,0,0,0,0
"Slovenia","2024-04-24",0,0,0,0,0,0,0,0
"Slovenia","2024-04-25",0,0,0,0,0,0,0,0
"Slovenia","2024-04-26",0,0,0,0,0,0,0,0
"Slovenia","2024-04-27",0,0,0,0,0,0,0,0
"Slovenia","2024-04-28",0,0,0,0,0,0,0,0
"Slovenia","2024-04-29",0,0,0,0,0,0,0,0
"Slovenia","2024-04-30",0,0,0,0,0,0,0,0
"Slovenia","2024-05-01",0,0,0,0,0,0,0,0
"Slovenia","2024-05-02",0,0,0,0,0,0,0,0
"Slovenia","2024-05-03",0,0,0,0,0,0,0,0
"Slovenia","2024-05-04",0,0,0,0,0,0,0,0
"Slovenia","2024-05-05",0,0,0,0,0,0,0,0
"Slovenia","2024-05-06",0,0,0,0,0,0,0,0
"Slovenia","2024-05-07",0,0,0,0,0,0,0,0
"Slovenia","2024-05-08",0,0,0,0,0,0,0,0
"Slovenia","2024-05-09",0,0,0,0,0,0,0,0
"Slovenia","2024-05-10",0,0,0,0,0,0,0,0
"Slovenia","2024-05-11",0,0,0,0,0,0,0,0
"Slovenia","2024-05-12",0,0,0,0,0,0,0,0
"Slovenia","2024-05-13",0,0,0,0,0,0,0,0
"Slovenia","2024-05-14",0,0,0,0,0,0,0,0
"Slovenia","2024-05-15",0,0,0,0,0,0,0,0
"Slovenia","2024-05-16",0,0,0,0,0,0,0,0
"Slovenia","2024-05-17",0,0,0,0,0,0,0,0
"Slovenia","2024-05-18",0,0,0,0,0,0,0,0
"Slovenia","2024-05-19",0,0,0,0,0,0,0,0
"Slovenia","2024-05-20",0,0,0,0,0,0,0,0
"Slovenia","2024-05-21",0,0,0,0,0,0,0,0
"Slovenia","2024-05-22",0,0,0,0,0,0,0,0
"Slovenia","2024-05-23",0,0,0,0,0,0,0,0
"Slovenia","2024-05-24",0,0,0,0,0,0,0,0
"Slovenia","2024-05-25",0,0,0,0,0,0,0,0
"Slovenia","2024-05-26",0,0,0,0,0,0,0,0
"Slovenia","2024-05-27",0,0,0,0,0,0,0,0
"Slovenia","2024-05-28",0,0,0,0,0,0,0,0
"Slovenia","2024-05-29",0,0,0,0,0,0,0,0
"Slovenia","2024-05-30",0,0,0,0,0,0,0,0
"Slovenia","2024-05-31",0,0,0,0,0,0,0,0
"Slovenia","2024-06-01",0,0,0,0,0,0,0,0
"Slovenia","2024-06-02",0,0,0,0,0,0,0,0
"Slovenia","2024-06-03",0,0,0,0,0,0,0,0
"Slovenia","2024-06-04",0,0,0,0,0,0,0,0
"Slovenia","2024-06-05",0,0,0,0,0,0,0,0
"Slovenia","2024-06-06",0,0,0,0,0,0,0,0
"Slovenia","2024-06-07",0,0,0,0,0,0,0,0
"Slovenia","2024-06-08",0,0,0,0,0,0,0,0
"Slovenia","2024-06-09",0,0,0,0,0,0,0,0
"Slovenia","2024-06-10",0,0,0,0,0,0,0,0
"Slovenia","2024-06-11",0,0,0,0,0,0,0,0
"Slovenia","2024-06-12",0,0,0,0,0,0,0,0
"Slovenia","2024-06-13",0,0,0,0,0,0,0,0
"Slovenia","2024-06-14",0,0,0,0,0,0,0,0
"Slovenia","2024-06-15",0,0,0,0,0,0,0,0
"Slovenia","2024-06-16",0,0,0,0,0,0,0,0
"Slovenia","2024-06-17",0,0,0,0,0,0,0,0
"Slovenia","2024-06-18",0,0,0,0,0,0,0,0
"Slovenia","2024-06-19",0,0,0,0,0,0,0,0
"Slovenia","2024-06-20",0,0,0,0,0,0,0,0
"Slovenia","2024-06-21",0,0,0,0,0,0,0,0
"Slovenia","2024-06-22",0,0,0,0,0,0,0,0
"Slovenia","2024-06-23",0,0,0,0,0,0,0,0
"Slovenia","2024-06-24",0,0,0,0,0,0,0,0
"Slovenia","2024-06-25",0,0,0,0,0,0,0,0
"Slovenia","2024-06-26",0,0,0,0,0,0,0,0
"Slovenia","2024-06-27",0,0,0,0,0,0,0,0
"Slovenia","2024-06-28",0,0,0,0,0,0,0,0
"Slovenia","2024-06-29",0,0,0,0,0,0,0,0
"Slovenia","2024-06-30",0,0,0,0,0,0,0,0
"Slovenia","2024-07-01",0,0,0,0,0,0,0,0
"Slovenia","2024-07-02",0,0,0,0,0,0,0,0
"Slovenia","2024-07-03",0,0,0,0,0,0,0,0
"Slovenia","2024-07-04",0,0,0,0,0,0,0,0
"Slovenia","2024-07-05",0,0,0,0,0,0,0,0
"Slovenia","2024-07-06",0,0,0,0,0,0,0,0
"Slovenia","2024-07-07",0,0,0,0,0,0,0,0
"Slovenia","2024-07-08",0,0,0,0,0,0,0,0
"Slovenia","2024-07-09",0,0,0,0,0,0,0,0
"Slovenia","2024-07-10",0,0,0,0,0,0,0,0
"Slovenia","2024-07-11",0,0,0,0,0,0,0,0
"Slovenia","2024-07-12",0,0,0,0,0,0,0,0
"Slovenia","2024-07-13",0,0,0,0,0,0,0,0
"Slovenia","2024-07-14",0,0,0,0,0,0,0,0
"Slovenia","2024-07-15",0,0,0,0,0,0,0,0
"Slovenia","2024-07-16",0,0,0,0,0,0,0,0
"Slovenia","2024-07-17",0,0,0,0,0,0,0,0
"Slovenia","2024-07-18",0,0,0,0,0,0,0,0
"Slovenia","2024-07-19",0,0,0,0,0,0,0,0
"Slovenia","2024-07-20",0,0,0,0,0,0,0,0
"Slovenia","2024-07-21",0,0,0,0,0,0,0,0
"Slovenia","2024-07-22",0,0,0,0,0,0,0,0
"Slovenia","2024-07-23",0,0,0,0,0,0,0,0
"Slovenia","2024-07-24",0,0,0,0,0,0,0,0
"Slovenia","2024-07-25",0,0,0,0,0,0,0,0
"Slovenia","2024-07-26",0,0,0,0,0,0,0,0
"Slovenia","2024-07-27",0,0,0,0,0,0,0,0
"Slovenia","2024-07-28",0,0,0,0,0,0,0,0
"Slovenia","2024-07-29",0,0,0,0,0,0,0,0
"Slovenia","2024-07-30",0,0,0,0,0,0,0,0
"Slovenia","2024-07-31",0,0,0,0,0,0,0,0
"Slovenia","2024-08-01",0,0,0,0,0,0,0,0
"Slovenia","2024-08-02",0,0,0,0,0,0,0,0
"Slovenia","2024-08-03",0,0,0,0,0,0,0,0
"Slovenia","2024-08-04",0,0,0,0,0,0,0,0
"Slovenia","2024-08-05",0,0,0,0,0,0,0,0
"Slovenia","2024-08-06",0,0,0,0,0,0,0,0
"Slovenia","2024-08-07",0,0,0,0,0,0,0,0
"Slovenia","2024-08-08",0,0,0,0,0,0,0,0
"Slovenia","2024-08-09",0,0,0,0,0,0,0,0
"Slovenia","2024-08-10",0,0,0,0,0,0,0,0
"Slovenia","2024-08-11",0,0,0,0,0,0,0,0
"Slovenia","2024-08-12",0,0,0,0,0,0,0,0
"Slovenia","2024-08-13",0,0,0,0,0,0,0,0
"Slovenia","2024-08-14",0,0,0,0,0,0,0,0
"Slovenia","2024-08-15",0,0,0,0,0,0,0,0
"Slovenia","2024-08-16",0,0,0,0,0,0,0,0
"Slovenia","2024-08-17",0,0,0,0,0,0,0,0
"Slovenia","2024-08-18",0,0,0,0,0,0,0,0
"Slovenia","2024-08-19",0,0,0,0,0,0,0,0
"Slovenia","2024-08-20",0,0,0,0,0,0,0,0
"Slovenia","2024-08-21",0,0,0,0,0,0,0,0
"Slovenia","2024-08-22",0,0,0,0,0,0,0,0
"Slovenia","2024-08-23",0,0,0,0,0,0,0,0
"Slovenia","2024-08-24",0,0,0,0,0,0,0,0
"Slovenia","2024-08-25",0,0,0,0,0,0,0,0
"Slovenia","2024-08-26",0,0,0,0,0,0,0,0
"Slovenia","2024-08-27",0,0,0,0,0,0,0,0
"Slovenia","2024-08-28",0,0,0,0,0,0,0,0
"Slovenia","2024-08-29",0,0,0,0,0,0,0,0
"Slovenia","2024-08-30",0,0,0,0,0,0,0,0
"Slovenia","2024-08-31",0,0,0,0,0,0,0,0
"Slovenia","2024-09-01",0,0,0,0,0,0,0,0
"Slovenia","2024-09-02",0,0,0,0,0,0,0,0
"Slovenia","2024-09-03",0,0,0,0,0,0,0,0
"Slovenia","2024-09-04",0,0,0,0,0,0,0,0
"Slovenia","2024-09-05",0,0,0,0,0,0,0,0
"Slovenia","2024-09-06",0,0,0,0,0,0,0,0
"Slovenia","2024-09-07",0,0,0,0,0,0,0,0
"Slovenia","2024-09-08",0,0,0,0,0,0,0,0
"Slovenia","2024-09-09",0,0,0,0,0,0,0,0
"Slovenia","2024-09-10",0,0,0,0,0,0,0,0
"Slovenia","2024-09-11",0,0,0,0,0,0,0,0
"Slovenia","2024-09-12",0,0,0,0,0,0,0,0
"Slovenia","2024-09-13",0,0,0,0,0,0,0,0
"Slovenia","2024-09-14",0,0,0,0,0,0,0,0
"Slovenia","2024-09-15",0,0,0,0,0,0,0,0
"Slovenia","2024-09-16",0,0,0,0,0,0,0,0
"Slovenia","2024-09-17",0,0,0,0,0,0,0,0
"Slovenia","2024-09-18",0,0,0,0,0,0,0,0
"Slovenia","2024-09-19",0,0,0,0,0,0,0,0
"Slovenia","2024-09-20",0,0,0,0,0,0,0,0
"Slovenia","2024-09-21",0,0,0,0,0,0,0,0
"Slovenia","2024-09-22",0,0,0,0,0,0,0,0
"Slovenia","2024-09-23",0,0,0,0,0,0,0,0
"Slovenia","2024-09-24",0,0,0,0,0,0,0,0
"Slovenia","2024-09-25",0,0,0,0,0,0,0,0
"Slovenia","2024-09-26",0,0,0,0,0,0,0,0
"Slovenia","2024-09-27",0,0,0,0,0,0,0,0
"Slovenia","2024-09-28",0,0,0,0,0,0,0,0
"Slovenia","2024-09-29",0,0,0,0,0,0,0,0
"Slovenia","2024-09-30",0,0,0,0,0,0,0,0
"Slovenia","2024-10-01",0,0,0,0,0,0,0,0
"Slovenia","2024-10-02",0,0,0,0,0,0,0,0
"Slovenia","2024-10-03",0,0,0,0,0,0,0,0
"Slovenia","2024-10-04",0,0,0,0,0,0,0,0
"Slovenia","2024-10-05",0,0,0,0,0,0,0,0
"Slovenia","2024-10-06",0,0,0,0,0,0,0,0
"Slovenia","2024-10-07",0,0,0,0,0,0,0,0
"Slovenia","2024-10-08",0,0,0,0,0,0,0,0
"Slovenia","2024-10-09",0,0,0,0,0,0,0,0
"Slovenia","2024-10-10",0,0,0,0,0,0,0,0
"Slovenia","2024-10-11",0,0,0,0,0,0,0,0
"Slovenia","2024-10-12",0,0,0,0,0,0,0,0
"Slovenia","2024-10-13",0,0,0,0,0,0,0,0
"Slovenia","2024-10-14",0,0,0,0,0,0,0,0
"Slovenia","2024-10-15",0,0,0,0,0,0,0,0
"Slovenia","2024-10-16",0,0,0,0,0,0,0,0
"Slovenia","2024-10-17",0,0,0,0,0,0,0,0
"Slovenia","2024-10-18",0,0,0,0,0,0,0,0
"Slovenia","2024-10-19",0,0,0,0,0,0,0,0
"Slovenia","2024-10-20",0,0,0,0,0,0,0,0
"Slovenia","2024-10-21",0,0,0,0,0,0,0,0
"Slovenia","2024-10-22",0,0,0,0,0,0,0,0
"Slovenia","2024-10-23",0,0,0,0,0,0,0,0
"Slovenia","2024-10-24",0,0,0,0,0,0,0,0
"Slovenia","2024-10-25",0,0,0,0,0,0,0,0
"Slovenia","2024-10-26",0,0,0,0,0,0,0,0
"Slovenia","2024-10-27",0,0,0,0,0,0,0,0
"Slovenia","2024-10-28",0,0,0,0,0,0,0,0
"Slovenia","2024-10-29",0,0,0,0,0,0,0,0
"Slovenia","2024-10-30",0,0,0,0,0,0,0,0
"Slovenia","2024-10-31",0,0,0,0,0,0,0,0
"Slovenia","2024-11-01",0,0,0,0,0,0,0,0
"Slovenia","2024-11-02",0,0,0,0,0,0,0,0
"Slovenia","2024-11-03",0,0,0,0,0,0,0,0
"Slovenia","2024-11-04",0,0,0,0,0,0,0,0
"Slovenia","2024-11-05",0,0,0,0,0,0,0,0
"Slovenia","2024-11-06",0,0,0,0,0,0,0,0
"Slovenia","2024-11-07",0,0,0,0,0,0,0,0
"Slovenia","2024-11-08",0,0,0,0,0,0,0,0
"Slovenia","2024-11-09",0,0,0,0,0,0,0,0
"Slovenia","2024-11-10",0,0,0,0,0,0,0,0
"Slovenia","2024-11-11",0,0,0,0,0,0,0,0
"Slovenia","2024-11-12",0,0,0,0,0,0,0,0
"Slovenia","2024-11-13",0,0,0,0,0,0,0,0
"Slovenia","2024-11-14",0,0,0,0,0,0,0,0
"Slovenia","2024-11-15",0,0,0,0,0,0,0,0
"Slovenia","2024-11-16",0,0,0,0,0,0,0,0
"Slovenia","2024-11-17",0,0,0,0,0,0,0,0
"Slovenia","2024-11-18",0,0,0,0,0,0,0,0
"Slovenia","2024-11-19",0,0,0,0,0,0,0,0
"Slovenia","2024-11-20",0,0,0,0,0,0,0,0
"Slovenia","2024-11-21",0,0,0,0,0,0,0,0
"Slovenia","2024-11-22",0,0,0,0,0,0,0,0
"Slovenia","2024-11-23",0,0,0,0,0,0,0,0
"Slovenia","2024-11-24",0,0,0,0,0,0,0,0
"Slovenia","2024-11-25",0,0,0,0,0,0,0,0
"Slovenia","2024-11-26",0,0,0,0,0,0,0,0
"Slovenia","2024-11-27",0,0,0,0,0,0,0,0
"Slovenia","2024-11-28",0,0,0,0,0,0,0,0
"Slovenia","2024-11-29",0,0,0,0,0,0,0,0
"Slovenia","2024-11-30",0,0,0,0,0,0,0,0
"Slovenia","2024-12-01",0,0,0,0,0,0,0,0
"Slovenia","2024-12-02",0,0,0,0,0,0,0,0
"Slovenia","2024-12-03",0,0,0,0,0,0,0,0
"Slovenia","2024-12-04",0,0,0,0,0,0,0,0
"Slovenia","2024-12-05",0,0,0,0,0,0,0,0
"Slovenia","2024-12-06",0,0,0,0,0,0,0,0
"Slovenia","2024-12-07",0,0,0,0,0,0,0,0
"Slovenia","2024-12-08",0,0,0,0,0,0,0,0
"Slovenia","2024-12-09",0,0,0,0,0,0,0,0
"Slovenia","2024-12-10",0,0,0,0,0,0,0,0
"Slovenia","2024-12-11",0,0,0,0,0,0,0,0
"Slovenia","2024-12-12",0,0,0,0,0,0,0,0
"Slovenia","2024-12-13",0,0,0,0,0,0,0,0
"Slovenia","2024-12-14",0,0,0,0,0,0,0,0
"Slovenia","2024-12-15",0,0,0,0,0,0,0,0
"Slovenia","2024-12-16",0,0,0,0,0,0,0,0
"Slovenia","2024-12-17",0,0,0,0,0,0,0,0
"Slovenia","2024-12-18",0,0,0,0,0,0,0,0
"Slovenia","2024-12-19",0,0,0,0,0,0,0,0
"Slovenia","2024-12-20",0,0,0,0,0,0,0,0
"Slovenia","2024-12-21",0,0,0,0,0,0,0,0
"Slovenia","2024-12-22",0,0,0,0,0,0,0,0
"Slovenia","2024-12-23",0,0,0,0,0,0,0,0
"Slovenia","2024-12-24",0,0,0,0,0,0,0,0
"Slovenia","2024-12-25",0,0,0,0,0,0,0,0
"Slovenia","2024-12-26",0,0,0,0,0,0,0,0
"Slovenia","2024-12-27",0,0,0,0,0,0,0,0
"Slovenia","2024-12-28",0,0,0,0,0,0,0,0
"Slovenia","2024-12-29",0,0,0,0,0,0,0,0
"Slovenia","2024-12-30",0,0,0,0,0,0,0,0
"Slovenia","2024-12-31",0,0,0,0,0,0,0,0
"Slovenia","2025-01-01",0,0,0,0,0,0,0,0
"Slovenia","2025-01-02",0,0,0,0,0,0,0,0
"Slovenia","2025-01-03",0,0,0,0,0,0,0,0
"Slovenia","2025-01-04",0,0,0,0,0,0,0,0
"Slovenia","2025-01-05",0,0,0,0,0,0,0,0
"Slovenia","2025-01-06",0,0,0,0,0,0,0,0
"Slovenia","2025-01-07",0,0,0,0,0,0,0,0
"Slovenia","2025-01-08",0,0,0,0,0,0,0,0
"Slovenia","2025-01-09",0,0,0,0,0,0,0,0
"Slovenia","2025-01-10",0,0,0,0,0,0,0,0
"Slovenia","2025-01-11",0,0,0,0,0,0,0,0
"Slovenia","2025-01-12",0,0,0,0,0,0,0,0
"Slovenia","2025-01-13",0,0,0,0,0,0,0,0
"South Africa","2024-01-01",0,0,0,0,0,0,0,0
"South Africa","2024-01-02",0,0,0,0,0,0,0,0
"South Africa","2024-01-03",0,0,0,0,0,0,0,0
"South Africa","2024-01-04",0,0,0,0,0,0,0,0
"South Africa","2024-01-05",0,0,0,0,0,0,0,0
"South Africa","2024-01-06",0,0,0,0,0,0,0,0
"South Africa","2024-01-07",0,0,0,0,0,0,0,0
"South Africa","2024-01-08",0,0,0,0,0,0,0,0
"South Africa","2024-01-09",0,0,0,0,0,0,0,0
"South Africa","2024-01-10",0,0,0,0,0,0,0,0
"South Africa","2024-01-11",0,0,0,0,0,0,0,0
"South Africa","2024-01-12",0,0,0,0,0,0,0,0
"South Africa","2024-01-13",0,0,0,0,0,0,0,0
"South Africa","2024-01-14",0,0,0,0,0,0,0,0
"South Africa","2024-01-15",0,0,0,0,0,0,0,0
"South Africa","2024-01-16",0,0,0,0,0,0,0,0
"South Africa","2024-01-17",0,0,0,0,0,0,0,0
"South Africa","2024-01-18",0,0,0,0,0,0,0,0
"South Africa","2024-01-19",0,0,0,0,0,0,0,0
"South Africa","2024-01-20",0,0,0,0,0,0,0,0
"South Africa","2024-01-21",0,0,0,0,0,0,0,0
"South Africa","2024-01-22",0,0,0,0,0,0,0,0
"South Africa","2024-01-23",0,0,0,0,0,0,0,0
"South Africa","2024-01-24",0,0,0,0,0,0,0,0
"South Africa","2024-01-25",0,0,0,0,0,0,0,0
"South Africa","2024-01-26",0,0,0,0,0,0,0,0
"South Africa","2024-01-27",0,0,0,0,0,0,0,0
"South Africa","2024-01-28",0,0,0,0,0,0,0,0
"South Africa","2024-01-29",0,0,0,0,0,0,0,0
"South Africa","2024-01-30",0,0,0,0,0,0,0,0
"South Africa","2024-01-31",0,0,0,0,0,0,0,0
"South Africa","2024-02-01",0,0,0,0,0,0,0,0
"South Africa","2024-02-02",0,0,0,0,0,0,0,0
"South Africa","2024-02-03",0,0,0,0,0,0,0,0
"South Africa","2024-02-04",0,0,0,0,0,0,0,0
"South Africa","2024-02-05",0,0,0,0,0,0,0,0
"South Africa","2024-02-06",0,0,0,0,0,0,0,0
"South Africa","2024-02-07",0,0,0,0,0,0,0,0
"South Africa","2024-02-08",0,0,0,0,0,0,0,0
"South Africa","2024-02-09",0,0,0,0,0,0,0,0
"South Africa","2024-02-10",0,0,0,0,0,0,0,0
"South Africa","2024-02-11",0,0,0,0,0,0,0,0
"South Africa","2024-02-12",0,0,0,0,0,0,0,0
"South Africa","2024-02-13",0,0,0,0,0,0,0,0
"South Africa","2024-02-14",0,0,0,0,0,0,0,0
"South Africa","2024-02-15",0,0,0,0,0,0,0,0
"South Africa","2024-02-16",0,0,0,0,0,0,0,0
"South Africa","2024-02-17",0,0,0,0,0,0,0,0
"South Africa","2024-02-18",0,0,0,0,0,0,0,0
"South Africa","2024-02-19",0,0,0,0,0,0,0,0
"South Africa","2024-02-20",0,0,0,0,0,0,0,0
"South Africa","2024-02-21",0,0,0,0,0,0,0,0
"South Africa","2024-02-22",0,0,0,0,0,0,0,0
"South Africa","2024-02-23",0,0,0,0,0,0,0,0
"South Africa","2024-02-24",0,0,0,0,0,0,0,0
"South Africa","2024-02-25",0,0,0,0,0,0,0,0
"South Africa","2024-02-26",0,0,0,0,0,0,0,0
"South Africa","2024-02-27",0,0,0,0,0,0,0,0
"South Africa","2024-02-28",0,0,0,0,0,0,0,0
"South Africa","2024-02-29",0,0,0,0,0,0,0,0
"South Africa","2024-03-01",0,0,0,0,0,0,0,0
"South Africa","2024-03-02",0,0,0,0,0,0,0,0
"South Africa","2024-03-03",0,0,0,0,0,0,0,0
"South Africa","2024-03-04",0,0,0,0,0,0,0,0
"South Africa","2024-03-05",0,0,0,0,0,0,0,0
"South Africa","2024-03-06",0,0,0,0,0,0,0,0
"South Africa","2024-03-07",0,0,0,0,0,0,0,0
"South Africa","2024-03-08",0,0,0,0,0,0,0,0
"South Africa","2024-03-09",0,0,0,0,0,0,0,0
"South Africa","2024-03-10",0,0,0,0,0,0,0,0
"South Africa","2024-03-11",0,0,0,0,0,0,0,0
"South Africa","2024-03-12",0,0,0,0,0,0,0,0
"South Africa","2024-03-13",0,0,0,0,0,0,0,0
"South Africa","2024-03-14",0,0,0,0,0,0,0,0
"South Africa","2024-03-15",0,0,0,0,0,0,0,0
"South Africa","2024-03-16",0,0,0,0,0,0,0,0
"South Africa","2024-03-17",0,0,0,0,0,0,0,0
"South Africa","2024-03-18",0,0,0,0,0,0,0,0
"South Africa","2024-03-19",0,0,0,0,0,0,0,0
"South Africa","2024-03-20",0,0,0,0,0,0,0,0
"South Africa","2024-03-21",0,0,0,0,0,0,0,0
"South Africa","2024-03-22",0,0,0,0,0,0,0,0
"South Africa","2024-03-23",0,0,0,0,0,0,0,0
"South Africa","2024-03-24",0,0,0,0,0,0,0,0
"South Africa","2024-03-25",0,0,0,0,0,0,0,0
"South Africa","2024-03-26",0,0,0,0,0,0,0,0
"South Africa","2024-03-27",0,0,0,0,0,0,0,0
"South Africa","2024-03-28",0,0,0,0,0,0,0,0
"South Africa","2024-03-29",0,0,0,0,0,0,0,0
"South Africa","2024-03-30",0,0,0,0,0,0,0,0
"South Africa","2024-03-31",0,0,0,0,0,0,0,0
"South Africa","2024-04-01",0,0,0,0,0,0,0,0
"South Africa","2024-04-02",0,0,0,0,0,0,0,0
"South Africa","2024-04-03",0,0,0,0,0,0,0,0
"South Africa","2024-04-04",0,0,0,0,0,0,0,0
"South Africa","2024-04-05",0,0,0,0,0,0,0,0
"South Africa","2024-04-06",0,0,0,0,0,0,0,0
"South Africa","2024-04-07",0,0,0,0,0,0,0,0
"South Africa","2024-04-08",0,0,0,0,0,0,0,0
"South Africa","2024-04-09",0,0,0,0,0,0,0,0
"South Africa","2024-04-10",0,0,0,0,0,0,0,0
"South Africa","2024-04-11",0,0,0,0,0,0,0,0
"South Africa","2024-04-12",0,0,0,0,0,0,0,0
"South Africa","2024-04-13",0,0,0,0,0,0,0,0
"South Africa","2024-04-14",0,0,0,0,0,0,0,0
"South Africa","2024-04-15",0,0,0,0,0,0,0,0
"South Africa","2024-04-16",0,0,0,0,0,0,0,0
"South Africa","2024-04-17",0,0,0,0,0,0,0,0
"South Africa","2024-04-18",0,0,0,0,0,0,0,0
"South Africa","2024-04-19",0,0,0,0,0,0,0,0
"South Africa","2024-04-20",0,0,0,0,0,0,0,0
"South Africa","2024-04-21",0,0,0,0,0,0,0,0
"South Africa","2024-04-22",0,0,0,0,0,0,0,0
"South Africa","2024-04-23",0,0,0,0,0,0,0,0
"South Africa","2024-04-24",0,0,0,0,0,0,0,0
"South Africa","2024-04-25",0,0,0,0,0,0,0,0
"South Africa","2024-04-26",0,0,0,0,0,0,0,0
"South Africa","2024-04-27",0,0,0,0,0,0,0,0
"South Africa","2024-04-28",0,0,0,0,0,0,0,0
"South Africa","2024-04-29",0,0,0,0,0,0,0,0
"South Africa","2024-04-30",0,0,0,0,0,0,0,0
"South Africa","2024-05-01",0,0,0,0,0,0,0,0
"South Africa","2024-05-02",0,0,0,0,0,0,0,0
"South Africa","2024-05-03",0,0,0,0,0,0,0,0
"South Africa","2024-05-04",0,0,0,0,0,0,0,0
"South Africa","2024-05-05",0,0,0,0,0,0,0,0
"South Africa","2024-05-06",0,0,0,0,0,0,0,0
"South Africa","2024-05-07",0,0,0,0,0,0,0,0
"South Africa","2024-05-08",0,0,0,0,0,0,0,0
"South Africa","2024-05-09",0,0,0,0,0,0,0,0
"South Africa","2024-05-10",0,0,0,0,0,0,0,0
"South Africa","2024-05-11",0,0,0,0,0,0,0,0
"South Africa","2024-05-12",0,1,1,0,1,1,0,0
"South Africa","2024-05-13",0,0,1,0,0,1,0,0
"South Africa","2024-05-14",0,0,1,0,0,1,0,0
"South Africa","2024-05-15",0,0,1,0,0,1,0,0
"South Africa","2024-05-16",0,0,1,0,0,1,0,0
"South Africa","2024-05-17",0,0,1,0,0,1,0,0
"South Africa","2024-05-18",0,0,1,0,0,1,0,0
"South Africa","2024-05-19",0,0,1,0,0,1,0,0
"South Africa","2024-05-20",0,0,1,0,1,2,0,0
"South Africa","2024-05-21",0,0,1,0,0,2,0,0
"South Africa","2024-05-22",0,0,1,0,0,2,0,0
"South Africa","2024-05-23",0,0,1,0,0,2,0,0
"South Africa","2024-05-24",0,0,1,0,0,2,0,0
"South Africa","2024-05-25",0,0,1,0,0,2,0,0
"South Africa","2024-05-26",0,1,2,0,0,2,0,0
"South Africa","2024-05-27",0,0,2,0,0,2,0,0
"South Africa","2024-05-28",0,0,2,0,0,2,0,0
"South Africa","2024-05-29",0,0,2,0,0,2,0,0
"South Africa","2024-05-30",0,0,2,0,1,3,0,0
"South Africa","2024-05-31",0,0,2,0,0,3,0,0
"South Africa","2024-06-01",0,0,2,0,0,3,0,0
"South Africa","2024-06-02",0,1,3,0,0,3,0,0
"South Africa","2024-06-03",0,0,3,0,0,3,0,0
"South Africa","2024-06-04",0,0,3,0,1,4,0,0
"South Africa","2024-06-05",0,0,3,0,0,4,0,0
"South Africa","2024-06-06",0,0,3,0,0,4,0,0
"South Africa","2024-06-07",0,0,3,0,0,4,0,0
"South Africa","2024-06-08",0,0,3,0,1,5,0,0
"South Africa","2024-06-09",0,2,5,0,0,5,0,0
"South Africa","2024-06-10",0,0,5,0,1,6,0,0
"South Africa","2024-06-11",0,0,5,0,1,7,0,0
"South Africa","2024-06-12",0,0,5,0,1,8,0,0
"South Africa","2024-06-13",0,0,5,0,1,9,0,0
"South Africa","2024-06-14",0,0,5,0,1,10,0,0
"South Africa","2024-06-15",0,0,5,0,1,11,0,0
"South Africa","2024-06-16",0,7,12,0,1,12,0,0
"South Africa","2024-06-17",0,0,12,0,1,13,0,0
"South Africa","2024-06-18",0,0,12,0,0,13,0,0
"South Africa","2024-06-19",0,0,12,0,1,14,0,0
"South Africa","2024-06-20",0,0,12,0,0,14,0,0
"South Africa","2024-06-21",0,0,12,0,1,15,0,0
"South Africa","2024-06-22",0,0,12,0,0,15,0,0
"South Africa","2024-06-23",0,4,16,0,1,16,0,0
"South Africa","2024-06-24",0,0,16,0,0,16,0,0
"South Africa","2024-06-25",0,0,16,0,1,17,0,0
"South Africa","2024-06-26",0,0,16,0,0,17,0,0
"South Africa","2024-06-27",0,0,16,0,0,17,0,0
"South Africa","2024-06-28",0,0,16,0,0,17,0,0
"South Africa","2024-06-29",0,0,16,0,1,18,0,0
"South Africa","2024-06-30",0,0,16,0,0,18,0,0
"South Africa","2024-07-01",0,0,16,0,0,18,0,0
"South Africa","2024-07-02",0,0,16,0,1,19,0,0
"South Africa","2024-07-03",0,0,16,0,0,19,0,0
"South Africa","2024-07-04",0,0,16,0,0,19,0,0
"South Africa","2024-07-05",0,0,16,0,0,19,0,0
"South Africa","2024-07-06",0,0,16,0,1,20,0,0
"South Africa","2024-07-07",0,4,20,0,0,20,0,0
"South Africa","2024-07-08",0,0,20,0,0,20,0,0
"South Africa","2024-07-09",0,0,20,0,1,21,0,0
"South Africa","2024-07-10",0,0,20,0,0,21,0,0
"South Africa","2024-07-11",0,0,20,0,0,21,0,0
"South Africa","2024-07-12",0,0,20,0,0,21,0,0
"South Africa","2024-07-13",0,0,20,0,1,22,0,0
"South Africa","2024-07-14",0,2,22,0,0,22,0,0
"South Africa","2024-07-15",0,0,22,0,0,22,0,0
"South Africa","2024-07-16",0,0,22,0,0,22,0,0
"South Africa","2024-07-17",0,0,22,0,0,22,0,0
"South Africa","2024-07-18",0,0,22,0,0,22,0,0
"South Africa","2024-07-19",0,0,22,0,0,22,0,0
"South Africa","2024-07-20",0,0,22,0,1,23,0,0
"South Africa","2024-07-21",0,0,22,0,0,23,0,0
"South Africa","2024-07-22",0,0,22,0,0,23,0,0
"South Africa","2024-07-23",0,0,22,0,0,23,0,0
"South Africa","2024-07-24",0,0,22,0,0,23,0,0
"South Africa","2024-07-25",0,0,22,0,0,23,0,0
"South Africa","2024-07-26",0,0,22,0,0,23,0,0
"South Africa","2024-07-27",0,0,22,0,0,23,0,0
"South Africa","2024-07-28",0,0,22,0,0,23,0,0
"South Africa","2024-07-29",0,0,22,0,0,23,0,0
"South Africa","2024-07-30",0,0,22,0,1,24,0,0
"South Africa","2024-07-31",0,0,22,0,0,24,0,0
"South Africa","2024-08-01",0,0,22,0,0,24,0,0
"South Africa","2024-08-02",0,0,22,0,0,24,0,0
"South Africa","2024-08-03",0,0,22,0,0,24,0,0
"South Africa","2024-08-04",0,2,24,0,0,24,0,0
"South Africa","2024-08-05",0,0,24,0,0,24,0,0
"South Africa","2024-08-06",0,0,24,0,0,24,0,0
"South Africa","2024-08-07",0,0,24,0,0,24,0,0
"South Africa","2024-08-08",0,0,24,0,0,24,0,0
"South Africa","2024-08-09",0,0,24,0,0,24,0,0
"South Africa","2024-08-10",0,0,24,0,0,24,0,0
"South Africa","2024-08-11",0,0,24,0,0,24,0,0
"South Africa","2024-08-12",0,0,24,0,0,24,0,0
"South Africa","2024-08-13",0,0,24,0,0,24,0,0
"South Africa","2024-08-14",0,0,24,0,0,24,0,0
"South Africa","2024-08-15",0,0,24,0,0,24,0,0
"South Africa","2024-08-16",0,0,24,0,0,24,0,0
"South Africa","2024-08-17",0,0,24,0,0,24,0,0
"South Africa","2024-08-18",0,0,24,0,0,24,0,0
"South Africa","2024-08-19",0,0,24,0,0,24,0,0
"South Africa","2024-08-20",0,0,24,0,0,24,0,0
"South Africa","2024-08-21",0,0,24,0,0,24,0,0
"South Africa","2024-08-22",0,0,24,0,1,25,0,0
"South Africa","2024-08-23",0,0,24,0,0,25,0,0
"South Africa","2024-08-24",0,0,24,0,0,25,0,0
"South Africa","2024-08-25",0,0,24,0,0,25,0,0
"South Africa","2024-08-26",0,0,24,0,0,25,0,0
"South Africa","2024-08-27",0,0,24,0,0,25,0,0
"South Africa","2024-08-28",0,0,24,0,0,25,0,0
"South Africa","2024-08-29",0,0,24,0,0,25,0,0
"South Africa","2024-08-30",0,0,24,0,0,25,0,0
"South Africa","2024-08-31",0,0,24,0,0,25,0,0
"South Africa","2024-09-01",0,0,24,0,0,25,0,0
"South Africa","2024-09-02",0,0,24,0,0,25,0,0
"South Africa","2024-09-03",0,0,24,0,0,25,0,0
"South Africa","2024-09-04",0,0,24,0,0,25,0,0
"South Africa","2024-09-05",0,0,24,0,0,25,0,0
"South Africa","2024-09-06",0,0,24,0,0,25,0,0
"South Africa","2024-09-07",0,0,24,0,0,25,0,0
"South Africa","2024-09-08",0,1,25,0,0,25,0,0
"South Africa","2024-09-09",0,0,25,0,0,25,0,0
"South Africa","2024-09-10",0,0,25,0,0,25,0,0
"South Africa","2024-09-11",0,0,25,0,0,25,0,0
"South Africa","2024-09-12",0,0,25,0,0,25,0,0
"South Africa","2024-09-13",0,0,25,0,0,25,0,0
"South Africa","2024-09-14",0,0,25,0,0,25,0,0
"South Africa","2024-09-15",0,0,25,0,0,25,0,0
"South Africa","2024-09-16",0,0,25,0,0,25,0,0
"South Africa","2024-09-17",0,0,25,0,0,25,0,0
"South Africa","2024-09-18",0,0,25,0,0,25,0,0
"South Africa","2024-09-19",0,0,25,0,0,25,0,0
"South Africa","2024-09-20",0,0,25,0,0,25,0,0
"South Africa","2024-09-21",0,0,25,0,0,25,0,0
"South Africa","2024-09-22",0,0,25,0,0,25,0,0
"South Africa","2024-09-23",0,0,25,0,0,25,0,0
"South Africa","2024-09-24",0,0,25,0,0,25,0,0
"South Africa","2024-09-25",0,0,25,0,0,25,0,0
"South Africa","2024-09-26",0,0,25,0,0,25,0,0
"South Africa","2024-09-27",0,0,25,0,0,25,0,0
"South Africa","2024-09-28",0,0,25,0,0,25,0,0
"South Africa","2024-09-29",0,0,25,0,0,25,0,0
"South Africa","2024-09-30",0,0,25,0,0,25,0,0
"South Africa","2024-10-01",0,0,25,0,0,25,0,0
"South Africa","2024-10-02",0,0,25,0,0,25,0,0
"South Africa","2024-10-03",0,0,25,0,0,25,0,0
"South Africa","2024-10-04",0,0,25,0,0,25,0,0
"South Africa","2024-10-05",0,0,25,0,0,25,0,0
"South Africa","2024-10-06",0,0,25,0,0,25,0,0
"South Africa","2024-10-07",0,0,25,0,0,25,0,0
"South Africa","2024-10-08",0,0,25,0,0,25,0,0
"South Africa","2024-10-09",0,0,25,0,0,25,0,0
"South Africa","2024-10-10",0,0,25,0,0,25,0,0
"South Africa","2024-10-11",0,0,25,0,0,25,0,0
"South Africa","2024-10-12",0,0,25,0,0,25,0,0
"South Africa","2024-10-13",0,0,25,0,0,25,0,0
"South Africa","2024-10-14",0,0,25,0,0,25,0,0
"South Africa","2024-10-15",0,0,25,0,0,25,0,0
"South Africa","2024-10-16",0,0,25,0,0,25,0,0
"South Africa","2024-10-17",0,0,25,0,0,25,0,0
"South Africa","2024-10-18",0,0,25,0,0,25,0,0
"South Africa","2024-10-19",0,0,25,0,0,25,0,0
"South Africa","2024-10-20",0,0,25,0,0,25,0,0
"South Africa","2024-10-21",0,0,25,0,0,25,0,0
"South Africa","2024-10-22",0,0,25,0,0,25,0,0
"South Africa","2024-10-23",0,0,25,0,0,25,0,0
"South Africa","2024-10-24",0,0,25,0,0,25,0,0
"South Africa","2024-10-25",0,0,25,0,0,25,0,0
"South Africa","2024-10-26",0,0,25,0,0,25,0,0
"South Africa","2024-10-27",0,0,25,0,0,25,0,0
"South Africa","2024-10-28",0,0,25,0,0,25,0,0
"South Africa","2024-10-29",0,0,25,0,0,25,0,0
"South Africa","2024-10-30",0,0,25,0,0,25,0,0
"South Africa","2024-10-31",0,0,25,0,0,25,0,0
"South Africa","2024-11-01",0,0,25,0,0,25,0,0
"South Africa","2024-11-02",0,0,25,0,0,25,0,0
"South Africa","2024-11-03",0,0,25,0,0,25,0,0
"South Africa","2024-11-04",0,0,25,0,0,25,0,0
"South Africa","2024-11-05",0,0,25,0,0,25,0,0
"South Africa","2024-11-06",0,0,25,0,0,25,0,0
"South Africa","2024-11-07",0,0,25,0,0,25,0,0
"South Africa","2024-11-08",0,0,25,0,0,25,0,0
"South Africa","2024-11-09",0,0,25,0,0,25,0,0
"South Africa","2024-11-10",0,0,25,0,0,25,0,0
"South Africa","2024-11-11",0,0,25,0,0,25,0,0
"South Africa","2024-11-12",0,0,25,0,0,25,0,0
"South Africa","2024-11-13",0,0,25,0,0,25,0,0
"South Africa","2024-11-14",0,0,25,0,0,25,0,0
"South Africa","2024-11-15",0,0,25,0,0,25,0,0
"South Africa","2024-11-16",0,0,25,0,0,25,0,0
"South Africa","2024-11-17",0,0,25,0,0,25,0,0
"South Africa","2024-11-18",0,0,25,0,0,25,0,0
"South Africa","2024-11-19",0,0,25,0,0,25,0,0
"South Africa","2024-11-20",0,0,25,0,0,25,0,0
"South Africa","2024-11-21",0,0,25,0,0,25,0,0
"South Africa","2024-11-22",0,0,25,0,0,25,0,0
"South Africa","2024-11-23",0,0,25,0,0,25,0,0
"South Africa","2024-11-24",0,0,25,0,0,25,0,0
"South Africa","2024-11-25",0,0,25,0,0,25,0,0
"South Africa","2024-11-26",0,0,25,0,0,25,0,0
"South Africa","2024-11-27",0,0,25,0,0,25,0,0
"South Africa","2024-11-28",0,0,25,0,0,25,0,0
"South Africa","2024-11-29",0,0,25,0,0,25,0,0
"South Africa","2024-11-30",0,0,25,0,0,25,0,0
"South Africa","2024-12-01",0,0,25,0,0,25,0,0
"South Africa","2024-12-02",0,0,25,0,0,25,0,0
"South Africa","2024-12-03",0,0,25,0,0,25,0,0
"South Africa","2024-12-04",0,0,25,0,0,25,0,0
"South Africa","2024-12-05",0,0,25,0,0,25,0,0
"South Africa","2024-12-06",0,0,25,0,0,25,0,0
"South Africa","2024-12-07",0,0,25,0,0,25,0,0
"South Africa","2024-12-08",0,0,25,0,0,25,0,0
"South Africa","2024-12-09",0,0,25,0,0,25,0,0
"South Africa","2024-12-10",0,0,25,0,0,25,0,0
"South Africa","2024-12-11",0,0,25,0,0,25,0,0
"South Africa","2024-12-12",0,0,25,0,0,25,0,0
"South Africa","2024-12-13",0,0,25,0,0,25,0,0
"South Africa","2024-12-14",0,0,25,0,0,25,0,0
"South Africa","2024-12-15",0,0,25,0,0,25,0,0
"South Africa","2024-12-16",0,0,25,0,0,25,0,0
"South Africa","2024-12-17",0,0,25,0,0,25,0,0
"South Africa","2024-12-18",0,0,25,0,0,25,0,0
"South Africa","2024-12-19",0,0,25,0,0,25,0,0
"South Africa","2024-12-20",0,0,25,0,0,25,0,0
"South Africa","2024-12-21",0,0,25,0,0,25,0,0
"South Africa","2024-12-22",0,0,25,0,0,25,0,0
"South Africa","2024-12-23",0,0,25,0,0,25,0,0
"South Africa","2024-12-24",0,0,25,0,0,25,0,0
"South Africa","2024-12-25",0,0,25,0,0,25,0,0
"South Africa","2024-12-26",0,0,25,0,0,25,0,0
"South Africa","2024-12-27",0,0,25,0,0,25,0,0
"South Africa","2024-12-28",0,0,25,0,0,25,0,0
"South Africa","2024-12-29",0,0,25,0,0,25,0,0
"South Africa","2024-12-30",0,0,25,0,0,25,0,0
"South Africa","2024-12-31",0,0,25,0,0,25,0,0
"South Africa","2025-01-01",0,0,25,0,0,25,0,0
"South Africa","2025-01-02",0,0,25,0,0,25,0,0
"South Africa","2025-01-03",0,0,25,0,0,25,0,0
"South Africa","2025-01-04",0,0,25,0,0,25,0,0
"South Africa","2025-01-05",0,0,25,0,0,25,0,0
"South Africa","2025-01-06",0,0,25,0,0,25,0,0
"South Africa","2025-01-07",0,0,25,0,0,25,0,0
"South Africa","2025-01-08",0,0,25,0,0,25,0,0
"South Africa","2025-01-09",0,0,25,0,0,25,0,0
"South Africa","2025-01-10",0,0,25,0,0,25,0,0
"South Africa","2025-01-11",0,0,25,0,0,25,0,0
"South Africa","2025-01-12",0,0,25,0,0,25,0,0
"South Africa","2025-01-13",0,0,25,0,0,25,0,0
"South America","2024-01-01",0,0,0,0,0,0,0,0
"South America","2024-01-02",0,61,61,0,61,61,0,0
"South America","2024-01-03",0,0,61,0,7,68,0,0
"South America","2024-01-04",0,0,61,0,7,75,0,0
"South America","2024-01-05",0,0,61,0,7,82,0,0
"South America","2024-01-06",0,0,61,0,8,90,0,0
"South America","2024-01-07",0,0,61,0,7,97,0,0
"South America","2024-01-08",0,0,61,0,7,104,0,0
"South America","2024-01-09",0,50,111,0,7,111,0,0
"South America","2024-01-10",0,0,111,0,7,118,0,0
"South America","2024-01-11",0,0,111,0,8,126,0,0
"South America","2024-01-12",0,0,111,0,7,133,0,0
"South America","2024-01-13",0,0,111,0,7,140,0,0
"South America","2024-01-14",0,0,111,0,7,147,0,0
"South America","2024-01-15",0,0,111,0,8,155,0,0
"South America","2024-01-16",0,51,162,0,7,162,0,0
"South America","2024-01-17",0,0,162,0,6,168,0,0
"South America","2024-01-18",0,0,162,0,5,173,0,0
"South America","2024-01-19",0,0,162,0,6,179,0,0
"South America","2024-01-20",0,0,162,0,6,185,0,0
"South America","2024-01-21",0,0,162,0,6,191,0,0
"South America","2024-01-22",0,0,162,0,5,196,0,0
"South America","2024-01-23",0,40,202,0,6,202,0,0
"South America","2024-01-24",0,0,202,0,6,208,0,0
"South America","2024-01-25",0,0,202,0,7,215,0,0
"South America","2024-01-26",0,0,202,0,6,221,0,0
"South America","2024-01-27",0,0,202,0,7,228,0,0
"South America","2024-01-28",0,0,202,0,6,234,0,0
"South America","2024-01-29",0,0,202,0,7,241,0,0
"South America","2024-01-30",0,45,247,0,6,247,0,0
"South America","2024-01-31",0,0,247,0,5,252,0,0
"South America","2024-02-01",0,0,247,0,5,257,0,0
"South America","2024-02-02",0,0,247,0,5,262,0,0
"South America","2024-02-03",0,0,247,0,6,268,0,0
"South America","2024-02-04",0,0,247,0,5,273,0,0
"South America","2024-02-05",0,0,247,0,5,278,0,0
"South America","2024-02-06",0,36,283,0,5,283,0,0
"South America","2024-02-07",0,0,283,0,5,288,0,0
"South America","2024-02-08",0,0,283,0,5,293,0,0
"South America","2024-02-09",0,0,283,0,5,298,0,0
"South America","2024-02-10",0,0,283,0,6,304,0,0
"South America","2024-02-11",0,0,283,0,5,309,0,0
"South America","2024-02-12",0,0,283,0,5,314,0,0
"South America","2024-02-13",0,36,319,0,5,319,0,0
"South America","2024-02-14",0,0,319,0,6,325,0,0
"South America","2024-02-15",0,0,319,0,6,331,0,0
"South America","2024-02-16",0,0,319,0,6,337,0,0
"South America","2024-02-17",0,0,319,0,7,344,0,0
"South America","2024-02-18",0,0,319,0,6,350,0,0
"South America","2024-02-19",0,0,319,0,6,356,0,0
"South America","2024-02-20",0,43,362,0,6,362,0,0
"South America","2024-02-21",0,0,362,0,6,368,0,0
"South America","2024-02-22",0,0,362,0,6,374,0,0
"South America","2024-02-23",0,0,362,0,6,380,0,0
"South America","2024-02-24",0,0,362,0,5,385,0,0
"South America","2024-02-25",0,0,362,0,6,391,0,0
"South America","2024-02-26",0,0,362,0,6,397,0,0
"South America","2024-02-27",0,41,403,0,6,403,0,0
"South America","2024-02-28",0,0,403,0,4,407,0,0
"South America","2024-02-29",0,0,403,0,4,411,0,0
"South America","2024-03-01",0,0,403,0,4,415,0,0
"South America","2024-03-02",0,0,403,0,4,419,0,0
"South America","2024-03-03",0,0,403,0,4,423,0,0
"South America","2024-03-04",0,0,403,0,4,427,0,0
"South America","2024-03-05",0,28,431,0,4,431,0,0
"South America","2024-03-06",0,0,431,0,4,435,0,0
"South America","2024-03-07",0,0,431,0,4,439,0,0
"South America","2024-03-08",0,0,431,0,4,443,0,0
"South America","2024-03-09",0,0,431,0,5,448,0,0
"South America","2024-03-10",0,0,431,0,4,452,0,0
"South America","2024-03-11",0,0,431,0,4,456,0,0
"South America","2024-03-12",0,29,460,0,4,460,0,0
"South America","2024-03-13",0,0,460,0,4,464,0,0
"South America","2024-03-14",0,0,460,0,5,469,0,0
"South America","2024-03-15",0,0,460,0,4,473,0,0
"South America","2024-03-16",0,0,460,0,5,478,0,0
"South America","2024-03-17",0,0,460,0,4,482,0,0
"South America","2024-03-18",0,0,460,0,5,487,0,0
"South America","2024-03-19",0,31,491,0,4,491,0,0
"South America","2024-03-20",0,0,491,0,4,495,0,0
"South America","2024-03-21",0,0,491,0,4,499,0,0
"South America","2024-03-22",0,0,491,0,4,503,0,0
"South America","2024-03-23",0,0,491,0,4,507,0,0
"South America","2024-03-24",0,0,491,0,4,511,0,0
"South America","2024-03-25",0,0,491,0,4,515,0,0
"South America","2024-03-26",0,28,519,0,4,519,0,0
"South America","2024-03-27",0,0,519,0,4,523,0,0
"South America","2024-03-28",0,0,519,0,5,528,0,0
"South America","2024-03-29",0,0,519,0,4,532,0,0
"South America","2024-03-30",0,0,519,0,4,536,0,0
"South America","2024-03-31",0,0,519,0,4,540,0,0
"South America","2024-04-01",0,0,519,0,5,545,0,0
"South America","2024-04-02",0,30,549,0,4,549,0,0
"South America","2024-04-03",0,0,549,0,3,552,0,0
"South America","2024-04-04",0,0,549,0,4,556,0,0
"South America","2024-04-05",0,0,549,0,3,559,0,0
"South America","2024-04-06",0,0,549,0,4,563,0,0
"South America","2024-04-07",0,0,549,0,3,566,0,0
"South America","2024-04-08",0,0,549,0,4,570,0,0
"South America","2024-04-09",0,24,573,0,3,573,0,0
"South America","2024-04-10",0,0,573,0,3,576,0,0
"South America","2024-04-11",0,0,573,0,3,579,0,0
"South America","2024-04-12",0,0,573,0,3,582,0,0
"South America","2024-04-13",0,0,573,0,2,584,0,0
"South America","2024-04-14",0,0,573,0,3,587,0,0
"South America","2024-04-15",0,0,573,0,3,590,0,0
"South America","2024-04-16",0,20,593,0,3,593,0,0
"South America","2024-04-17",0,0,593,0,5,598,0,0
"South America","2024-04-18",0,0,593,0,4,602,0,0
"South America","2024-04-19",0,0,593,0,5,607,0,0
"South America","2024-04-20",0,0,593,0,5,612,0,0
"South America","2024-04-21",0,0,593,0,5,617,0,0
"South America","2024-04-22",0,0,593,0,4,621,0,0
"South America","2024-04-23",0,33,626,0,5,626,0,0
"South America","2024-04-24",0,0,626,0,4,630,0,0
"South America","2024-04-25",0,0,626,0,3,633,0,0
"South America","2024-04-26",0,0,626,0,4,637,0,0
"South America","2024-04-27",0,0,626,0,3,640,0,0
"South America","2024-04-28",0,0,626,0,4,644,0,0
"South America","2024-04-29",0,0,626,0,3,647,0,0
"South America","2024-04-30",0,25,651,0,4,651,0,0
"South America","2024-05-01",0,0,651,0,3,654,0,0
"South America","2024-05-02",0,0,651,0,3,657,0,0
"South America","2024-05-03",0,0,651,0,3,660,0,0
"South America","2024-05-04",0,0,651,0,3,663,0,0
"South America","2024-05-05",0,0,651,0,3,666,0,0
"South America","2024-05-06",0,0,651,0,3,669,0,0
"South America","2024-05-07",0,21,672,0,3,672,0,0
"South America","2024-05-08",0,0,672,0,3,675,0,0
"South America","2024-05-09",0,0,672,0,3,678,0,0
"South America","2024-05-10",0,0,672,0,3,681,0,0
"South America","2024-05-11",0,0,672,0,4,685,0,0
"South America","2024-05-12",0,0,672,0,3,688,0,0
"South America","2024-05-13",0,0,672,0,3,691,0,0
"South America","2024-05-14",0,22,694,0,3,694,0,0
"South America","2024-05-15",0,0,694,0,1,695,0,0
"South America","2024-05-16",0,0,694,0,2,697,0,0
"South America","2024-05-17",0,0,694,0,1,698,0,0
"South America","2024-05-18",0,0,694,0,2,700,0,0
"South America","2024-05-19",0,0,694,0,1,701,0,0
"South America","2024-05-20",0,0,694,0,2,703,0,0
"South America","2024-05-21",0,10,704,0,1,704,0,0
"South America","2024-05-22",0,0,704,0,3,707,0,0
"South America","2024-05-23",0,0,704,0,3,710,0,0
"South America","2024-05-24",0,0,704,0,3,713,0,0
"South America","2024-05-25",0,0,704,0,2,715,0,0
"South America","2024-05-26",0,0,704,0,3,718,0,0
"South America","2024-05-27",0,0,704,0,3,721,0,0
"South America","2024-05-28",0,20,724,0,3,724,0,0
"South America","2024-05-29",0,0,724,0,2,726,0,0
"South America","2024-05-30",0,0,724,0,3,729,0,0
"South America","2024-05-31",0,0,724,0,2,731,0,0
"South America","2024-06-01",0,0,724,0,3,734,0,0
"South America","2024-06-02",0,0,724,0,2,736,0,0
"South America","2024-06-03",0,0,724,0,3,739,0,0
"South America","2024-06-04",0,17,741,0,2,741,0,0
"South America","2024-06-05",0,0,741,0,2,743,0,0
"South America","2024-06-06",0,0,741,0,3,746,0,0
"South America","2024-06-07",0,0,741,0,2,748,0,0
"South America","2024-06-08",0,0,741,0,2,750,0,0
"South America","2024-06-09",0,0,741,0,2,752,0,0
"South America","2024-06-10",0,0,741,0,3,755,0,0
"South America","2024-06-11",0,16,757,0,2,757,0,0
"South America","2024-06-12",0,0,757,0,2,759,0,0
"South America","2024-06-13",0,0,757,0,1,760,0,0
"South America","2024-06-14",0,0,757,0,2,762,0,0
"South America","2024-06-15",0,0,757,0,1,763,0,0
"South America","2024-06-16",0,0,757,0,2,765,0,0
"South America","2024-06-17",0,0,757,0,1,766,0,0
"South America","2024-06-18",0,11,768,0,2,768,0,0
"South America","2024-06-19",0,0,768,0,2,770,0,0
"South America","2024-06-20",0,0,768,0,3,773,0,0
"South America","2024-06-21",0,0,768,0,2,775,0,0
"South America","2024-06-22",0,0,768,0,2,777,0,0
"South America","2024-06-23",0,0,768,0,2,779,0,0
"South America","2024-06-24",0,0,768,0,3,782,0,0
"South America","2024-06-25",0,16,784,0,2,784,0,0
"South America","2024-06-26",0,0,784,0,4,788,0,0
"South America","2024-06-27",0,0,784,0,4,792,0,0
"South America","2024-06-28",0,0,784,0,4,796,0,0
"South America","2024-06-29",0,0,784,0,3,799,0,0
"South America","2024-06-30",0,0,784,0,4,803,0,0
"South America","2024-07-01",0,0,784,0,4,807,0,0
"South America","2024-07-02",0,27,811,0,4,811,0,0
"South America","2024-07-03",0,0,811,0,4,815,0,0
"South America","2024-07-04",0,0,811,0,4,819,0,0
"South America","2024-07-05",0,0,811,0,4,823,0,0
"South America","2024-07-06",0,0,811,0,4,827,0,0
"South America","2024-07-07",0,0,811,0,4,831,0,0
"South America","2024-07-08",0,0,811,0,4,835,0,0
"South America","2024-07-09",0,28,839,0,4,839,0,0
"South America","2024-07-10",0,0,839,0,4,843,0,0
"South America","2024-07-11",0,0,839,0,5,848,0,0
"South America","2024-07-12",0,0,839,0,4,852,0,0
"South America","2024-07-13",0,0,839,0,5,857,0,0
"South America","2024-07-14",0,0,839,0,4,861,0,0
"South America","2024-07-15",0,0,839,0,5,866,0,0
"South America","2024-07-16",0,31,870,0,4,870,0,0
"South America","2024-07-17",0,0,870,0,5,875,0,0
"South America","2024-07-18",0,0,870,0,5,880,0,0
"South America","2024-07-19",0,0,870,0,5,885,0,0
"South America","2024-07-20",0,0,870,0,6,891,0,0
"South America","2024-07-21",0,0,870,0,5,896,0,0
"South America","2024-07-22",0,0,870,0,5,901,0,0
"South America","2024-07-23",0,36,906,0,5,906,0,0
"South America","2024-07-24",0,0,906,0,6,912,0,0
"South America","2024-07-25",0,0,906,0,6,918,0,0
"South America","2024-07-26",0,0,906,0,6,924,0,0
"South America","2024-07-27",0,0,906,0,5,929,0,0
"South America","2024-07-28",0,0,906,0,6,935,0,0
"South America","2024-07-29",0,0,906,0,6,941,0,0
"South America","2024-07-30",0,41,947,0,6,947,0,0
"South America","2024-07-31",0,0,947,0,9,956,0,0
"South America","2024-08-01",0,0,947,0,9,965,0,0
"South America","2024-08-02",0,0,947,0,9,974,0,0
"South America","2024-08-03",0,0,947,0,10,984,0,0
"South America","2024-08-04",0,0,947,0,9,993,0,0
"South America","2024-08-05",0,0,947,0,9,1002,0,0
"South America","2024-08-06",0,64,1011,0,9,1011,0,0
"South America","2024-08-07",0,0,1011,0,10,1021,0,0
"South America","2024-08-08",0,0,1011,0,10,1031,0,0
"South America","2024-08-09",0,0,1011,0,10,1041,0,0
"South America","2024-08-10",0,0,1011,0,11,1052,0,0
"South America","2024-08-11",0,0,1011,0,10,1062,0,0
"South America","2024-08-12",0,0,1011,0,10,1072,0,0
"South America","2024-08-13",0,71,1082,0,10,1082,0,0
"South America","2024-08-14",0,0,1082,0,15,1097,0,0
"South America","2024-08-15",0,0,1082,0,14,1111,0,0
"South America","2024-08-16",0,0,1082,0,15,1126,0,0
"South America","2024-08-17",0,0,1082,0,14,1140,0,0
"South America","2024-08-18",0,0,1082,0,15,1155,0,0
"South America","2024-08-19",0,0,1082,0,14,1169,0,0
"South America","2024-08-20",0,102,1184,0,15,1184,0,0
"South America","2024-08-21",0,0,1184,0,14,1198,0,0
"South America","2024-08-22",0,0,1184,0,14,1212,0,0
"South America","2024-08-23",0,0,1184,0,14,1226,0,0
"South America","2024-08-24",0,0,1184,0,15,1241,0,0
"South America","2024-08-25",0,0,1184,0,14,1255,0,0
"South America","2024-08-26",0,0,1184,0,14,1269,0,0
"South America","2024-08-27",0,99,1283,0,14,1283,0,0
"South America","2024-08-28",0,0,1283,0,15,1298,0,0
"South America","2024-08-29",0,0,1283,0,14,1312,0,0
"South America","2024-08-30",0,0,1283,0,15,1327,0,0
"South America","2024-08-31",0,0,1283,0,14,1341,0,0
"South America","2024-09-01",0,0,1283,0,15,1356,0,0
"South America","2024-09-02",0,0,1283,0,14,1370,0,0
"South America","2024-09-03",0,102,1385,0,15,1385,0,0
"South America","2024-09-04",0,0,1385,0,11,1396,0,0
"South America","2024-09-05",0,0,1385,0,10,1406,0,0
"South America","2024-09-06",0,0,1385,0,11,1417,0,0
"South America","2024-09-07",0,0,1385,0,10,1427,0,0
"South America","2024-09-08",0,0,1385,0,11,1438,0,0
"South America","2024-09-09",0,0,1385,0,10,1448,0,0
"South America","2024-09-10",0,74,1459,0,11,1459,0,0
"South America","2024-09-11",0,0,1459,0,12,1471,0,0
"South America","2024-09-12",0,0,1459,0,11,1482,0,0
"South America","2024-09-13",0,0,1459,0,12,1494,0,0
"South America","2024-09-14",0,0,1459,0,12,1506,0,0
"South America","2024-09-15",0,0,1459,0,12,1518,0,0
"South America","2024-09-16",0,0,1459,0,11,1529,0,0
"South America","2024-09-17",0,82,1541,0,12,1541,0,0
"South America","2024-09-18",0,0,1541,0,10,1551,0,0
"South America","2024-09-19",0,0,1541,0,11,1562,0,0
"South America","2024-09-20",0,0,1541,0,10,1572,0,0
"South America","2024-09-21",0,0,1541,0,10,1582,0,0
"South America","2024-09-22",0,0,1541,0,10,1592,0,0
"South America","2024-09-23",0,0,1541,0,11,1603,0,0
"South America","2024-09-24",0,72,1613,0,10,1613,0,0
"South America","2024-09-25",0,0,1613,0,13,1626,0,0
"South America","2024-09-26",0,0,1613,0,12,1638,0,0
"South America","2024-09-27",0,0,1613,0,13,1651,0,0
"South America","2024-09-28",0,0,1613,0,12,1663,0,0
"South America","2024-09-29",0,0,1613,0,13,1676,0,0
"South America","2024-09-30",0,0,1613,0,12,1688,0,0
"South America","2024-10-01",0,88,1701,0,13,1701,0,0
"South America","2024-10-02",0,0,1701,0,12,1713,0,0
"South America","2024-10-03",0,0,1701,0,11,1724,0,0
"South America","2024-10-04",0,0,1701,0,12,1736,0,0
"South America","2024-10-05",0,0,1701,0,12,1748,0,0
"South America","2024-10-06",0,0,1701,0,12,1760,0,0
"South America","2024-10-07",0,0,1701,0,11,1771,0,0
"South America","2024-10-08",0,82,1783,0,12,1783,0,0
"South America","2024-10-09",0,0,1783,0,9,1792,0,0
"South America","2024-10-10",0,0,1783,0,8,1800,0,0
"South America","2024-10-11",0,0,1783,0,9,1809,0,0
"South America","2024-10-12",0,0,1783,0,8,1817,0,0
"South America","2024-10-13",0,0,1783,0,9,1826,0,0
"South America","2024-10-14",0,0,1783,0,8,1834,0,0
"South America","2024-10-15",0,60,1843,0,9,1843,0,0
"South America","2024-10-16",0,0,1843,0,11,1854,0,0
"South America","2024-10-17",0,0,1843,0,10,1864,0,0
"South America","2024-10-18",0,0,1843,0,11,1875,0,0
"South America","2024-10-19",0,0,1843,0,11,1886,0,0
"South America","2024-10-20",0,0,1843,0,11,1897,0,0
"South America","2024-10-21",0,0,1843,0,10,1907,0,0
"South America","2024-10-22",0,75,1918,0,11,1918,0,0
"South America","2024-10-23",0,0,1918,0,8,1926,0,0
"South America","2024-10-24",0,0,1918,0,9,1935,0,0
"South America","2024-10-25",0,0,1918,0,8,1943,0,0
"South America","2024-10-26",0,0,1918,0,8,1951,0,0
"South America","2024-10-27",0,0,1918,0,8,1959,0,0
"South America","2024-10-28",0,0,1918,0,9,1968,0,0
"South America","2024-10-29",0,58,1976,0,8,1976,0,0
"South America","2024-10-30",0,0,1976,0,9,1985,0,0
"South America","2024-10-31",0,0,1976,0,9,1994,0,0
"South America","2024-11-01",0,0,1976,0,9,2003,0,0
"South America","2024-11-02",0,0,1976,0,10,2013,0,0
"South America","2024-11-03",0,0,1976,0,9,2022,0,0
"South America","2024-11-04",0,0,1976,0,9,2031,0,0
"South America","2024-11-05",0,64,2040,0,9,2040,0,0
"South America","2024-11-06",0,0,2040,0,7,2047,0,0
"South America","2024-11-07",0,0,2040,0,6,2053,0,0
"South America","2024-11-08",0,0,2040,0,7,2060,0,0
"South America","2024-11-09",0,0,2040,0,6,2066,0,0
"South America","2024-11-10",0,0,2040,0,7,2073,0,0
"South America","2024-11-11",0,0,2040,0,6,2079,0,0
"South America","2024-11-12",0,46,2086,0,7,2086,0,0
"South America","2024-11-13",0,0,2086,0,4,2090,0,0
"South America","2024-11-14",0,0,2086,0,3,2093,0,0
"South America","2024-11-15",0,0,2086,0,4,2097,0,0
"South America","2024-11-16",0,0,2086,0,4,2101,0,0
"South America","2024-11-17",0,0,2086,0,4,2105,0,0
"South America","2024-11-18",0,0,2086,0,3,2108,0,0
"South America","2024-11-19",0,26,2112,0,4,2112,0,0
"South America","2024-11-20",0,0,2112,0,0,2112,0,0
"South America","2024-11-21",0,0,2112,0,1,2113,0,0
"South America","2024-11-22",0,0,2112,0,0,2113,0,0
"South America","2024-11-23",0,0,2112,0,1,2114,0,0
"South America","2024-11-24",0,0,2112,0,0,2114,0,0
"South America","2024-11-25",0,0,2112,0,1,2115,0,0
"South America","2024-11-26",0,3,2115,0,0,2115,0,0
"South America","2024-11-27",0,0,2115,0,0,2115,0,0
"South America","2024-11-28",0,0,2115,0,0,2115,0,0
"South America","2024-11-29",0,0,2115,0,0,2115,0,0
"South America","2024-11-30",0,0,2115,0,0,2115,0,0
"South America","2024-12-01",0,0,2115,0,0,2115,0,0
"South America","2024-12-02",0,0,2115,0,0,2115,0,0
"South America","2024-12-03",0,0,2115,0,0,2115,0,0
"South America","2024-12-04",0,0,2115,0,0,2115,0,0
"South America","2024-12-05",0,0,2115,0,0,2115,0,0
"South America","2024-12-06",0,0,2115,0,0,2115,0,0
"South America","2024-12-07",0,0,2115,0,0,2115,0,0
"South America","2024-12-08",0,0,2115,0,0,2115,0,0
"South America","2024-12-09",0,0,2115,0,0,2115,0,0
"South America","2024-12-10",0,0,2115,0,0,2115,0,0
"South America","2024-12-11",0,0,2115,0,0,2115,0,0
"South America","2024-12-12",0,0,2115,0,0,2115,0,0
"South America","2024-12-13",0,0,2115,0,0,2115,0,0
"South America","2024-12-14",0,0,2115,0,0,2115,0,0
"South America","2024-12-15",0,0,2115,0,0,2115,0,0
"South America","2024-12-16",0,0,2115,0,0,2115,0,0
"South America","2024-12-17",0,0,2115,0,0,2115,0,0
"South America","2024-12-18",0,0,2115,0,0,2115,0,0
"South America","2024-12-19",0,0,2115,0,0,2115,0,0
"South America","2024-12-20",0,0,2115,0,0,2115,0,0
"South America","2024-12-21",0,0,2115,0,0,2115,0,0
"South America","2024-12-22",0,0,2115,0,0,2115,0,0
"South America","2024-12-23",0,0,2115,0,0,2115,0,0
"South America","2024-12-24",0,0,2115,0,0,2115,0,0
"South America","2024-12-25",0,0,2115,0,0,2115,0,0
"South America","2024-12-26",0,0,2115,0,0,2115,0,0
"South America","2024-12-27",0,0,2115,0,0,2115,0,0
"South America","2024-12-28",0,0,2115,0,0,2115,0,0
"South America","2024-12-29",0,0,2115,0,0,2115,0,0
"South America","2024-12-30",0,0,2115,0,0,2115,0,0
"South America","2024-12-31",0,0,2115,0,0,2115,0,0
"South America","2025-01-01",0,0,2115,0,0,2115,0,0
"South America","2025-01-02",0,0,2115,0,0,2115,0,0
"South America","2025-01-03",0,0,2115,0,0,2115,0,0
"South America","2025-01-04",0,0,2115,0,0,2115,0,0
"South America","2025-01-05",0,0,2115,0,0,2115,0,0
"South America","2025-01-06",0,0,2115,0,0,2115,0,0
"South America","2025-01-07",0,0,2115,0,0,2115,0,0
"South America","2025-01-08",0,0,2115,0,0,2115,0,0
"South America","2025-01-09",0,0,2115,0,0,2115,0,0
"South America","2025-01-10",0,0,2115,0,0,2115,0,0
"South America","2025-01-11",0,0,2115,0,0,2115,0,0
"South America","2025-01-12",0,0,2115,0,0,2115,0,0
"South America","2025-01-13",0,0,2115,0,0,2115,0,0
"Republic of Korea","2024-01-01",0,0,0,0,0,0,0,0
"Republic of Korea","2024-01-02",0,0,0,0,0,0,0,0
"Republic of Korea","2024-01-03",0,0,0,0,0,0,0,0
"Republic of Korea","2024-01-04",0,0,0,0,0,0,0,0
"Republic of Korea","2024-01-05",0,0,0,0,0,0,0,0
"Republic of Korea","2024-01-06",0,0,0,0,0,0,0,0
"Republic of Korea","2024-01-07",0,0,0,0,0,0,0,0
"Republic of Korea","2024-01-08",0,0,0,0,0,0,0,0
"Republic of Korea","2024-01-09",0,0,0,0,0,0,0,0
"Republic of Korea","2024-01-10",0,0,0,0,0,0,0,0
"Republic of Korea","2024-01-11",0,0,0,0,0,0,0,0
"Republic of Korea","2024-01-12",0,0,0,0,0,0,0,0
"Republic of Korea","2024-01-13",0,0,0,0,0,0,0,0
"Republic of Korea","2024-01-14",0,0,0,0,0,0,0,0
"Republic of Korea","2024-01-15",0,0,0,0,0,0,0,0
"Republic of Korea","2024-01-16",0,0,0,0,0,0,0,0
"Republic of Korea","2024-01-17",0,0,0,0,0,0,0,0
"Republic of Korea","2024-01-18",0,0,0,0,0,0,0,0
"Republic of Korea","2024-01-19",0,0,0,0,0,0,0,0
"Republic of Korea","2024-01-20",0,0,0,0,0,0,0,0
"Republic of Korea","2024-01-21",0,0,0,0,0,0,0,0
"Republic of Korea","2024-01-22",0,0,0,0,0,0,0,0
"Republic of Korea","2024-01-23",0,0,0,0,0,0,0,0
"Republic of Korea","2024-01-24",0,0,0,0,0,0,0,0
"Republic of Korea","2024-01-25",0,0,0,0,0,0,0,0
"Republic of Korea","2024-01-26",0,0,0,0,0,0,0,0
"Republic of Korea","2024-01-27",0,0,0,0,0,0,0,0
"Republic of Korea","2024-01-28",0,0,0,0,0,0,0,0
"Republic of Korea","2024-01-29",0,0,0,0,0,0,0,0
"Republic of Korea","2024-01-30",0,0,0,0,0,0,0,0
"Republic of Korea","2024-01-31",0,0,0,0,0,0,0,0
"Republic of Korea","2024-02-01",0,0,0,0,0,0,0,0
"Republic of Korea","2024-02-02",0,0,0,0,0,0,0,0
"Republic of Korea","2024-02-03",0,0,0,0,0,0,0,0
"Republic of Korea","2024-02-04",0,0,0,0,0,0,0,0
"Republic of Korea","2024-02-05",0,0,0,0,0,0,0,0
"Republic of Korea","2024-02-06",0,0,0,0,0,0,0,0
"Republic of Korea","2024-02-07",0,0,0,0,0,0,0,0
"Republic of Korea","2024-02-08",0,0,0,0,0,0,0,0
"Republic of Korea","2024-02-09",0,0,0,0,0,0,0,0
"Republic of Korea","2024-02-10",0,0,0,0,0,0,0,0
"Republic of Korea","2024-02-11",0,0,0,0,0,0,0,0
"Republic of Korea","2024-02-12",0,0,0,0,0,0,0,0
"Republic of Korea","2024-02-13",0,0,0,0,0,0,0,0
"Republic of Korea","2024-02-14",0,0,0,0,0,0,0,0
"Republic of Korea","2024-02-15",0,0,0,0,0,0,0,0
"Republic of Korea","2024-02-16",0,0,0,0,0,0,0,0
"Republic of Korea","2024-02-17",0,0,0,0,0,0,0,0
"Republic of Korea","2024-02-18",0,0,0,0,0,0,0,0
"Republic of Korea","2024-02-19",0,0,0,0,0,0,0,0
"Republic of Korea","2024-02-20",0,0,0,0,0,0,0,0
"Republic of Korea","2024-02-21",0,0,0,0,0,0,0,0
"Republic of Korea","2024-02-22",0,0,0,0,0,0,0,0
"Republic of Korea","2024-02-23",0,0,0,0,0,0,0,0
"Republic of Korea","2024-02-24",0,0,0,0,0,0,0,0
"Republic of Korea","2024-02-25",0,0,0,0,0,0,0,0
"Republic of Korea","2024-02-26",0,0,0,0,0,0,0,0
"Republic of Korea","2024-02-27",0,0,0,0,0,0,0,0
"Republic of Korea","2024-02-28",0,0,0,0,0,0,0,0
"Republic of Korea","2024-02-29",0,0,0,0,0,0,0,0
"Republic of Korea","2024-03-01",0,0,0,0,0,0,0,0
"Republic of Korea","2024-03-02",0,0,0,0,0,0,0,0
"Republic of Korea","2024-03-03",0,0,0,0,0,0,0,0
"Republic of Korea","2024-03-04",0,0,0,0,0,0,0,0
"Republic of Korea","2024-03-05",0,0,0,0,0,0,0,0
"Republic of Korea","2024-03-06",0,0,0,0,0,0,0,0
"Republic of Korea","2024-03-07",0,0,0,0,0,0,0,0
"Republic of Korea","2024-03-08",0,0,0,0,0,0,0,0
"Republic of Korea","2024-03-09",0,0,0,0,0,0,0,0
"Republic of Korea","2024-03-10",0,0,0,0,0,0,0,0
"Republic of Korea","2024-03-11",0,0,0,0,0,0,0,0
"Republic of Korea","2024-03-12",0,0,0,0,0,0,0,0
"Republic of Korea","2024-03-13",0,0,0,0,0,0,0,0
"Republic of Korea","2024-03-14",0,0,0,0,0,0,0,0
"Republic of Korea","2024-03-15",0,0,0,0,0,0,0,0
"Republic of Korea","2024-03-16",0,0,0,0,0,0,0,0
"Republic of Korea","2024-03-17",0,0,0,0,0,0,0,0
"Republic of Korea","2024-03-18",0,0,0,0,0,0,0,0
"Republic of Korea","2024-03-19",0,0,0,0,0,0,0,0
"Republic of Korea","2024-03-20",0,0,0,0,0,0,0,0
"Republic of Korea","2024-03-21",0,0,0,0,0,0,0,0
"Republic of Korea","2024-03-22",0,0,0,0,0,0,0,0
"Republic of Korea","2024-03-23",0,0,0,0,0,0,0,0
"Republic of Korea","2024-03-24",0,0,0,0,0,0,0,0
"Republic of Korea","2024-03-25",0,0,0,0,0,0,0,0
"Republic of Korea","2024-03-26",0,0,0,0,0,0,0,0
"Republic of Korea","2024-03-27",0,0,0,0,0,0,0,0
"Republic of Korea","2024-03-28",0,0,0,0,0,0,0,0
"Republic of Korea","2024-03-29",0,0,0,0,0,0,0,0
"Republic of Korea","2024-03-30",0,0,0,0,0,0,0,0
"Republic of Korea","2024-03-31",0,0,0,0,0,0,0,0
"Republic of Korea","2024-04-01",0,0,0,0,0,0,0,0
"Republic of Korea","2024-04-02",0,0,0,0,0,0,0,0
"Republic of Korea","2024-04-03",0,0,0,0,0,0,0,0
"Republic of Korea","2024-04-04",0,0,0,0,0,0,0,0
"Republic of Korea","2024-04-05",0,0,0,0,0,0,0,0
"Republic of Korea","2024-04-06",0,0,0,0,0,0,0,0
"Republic of Korea","2024-04-07",0,0,0,0,0,0,0,0
"Republic of Korea","2024-04-08",0,0,0,0,0,0,0,0
"Republic of Korea","2024-04-09",0,0,0,0,0,0,0,0
"Republic of Korea","2024-04-10",0,0,0,0,0,0,0,0
"Republic of Korea","2024-04-11",0,0,0,0,0,0,0,0
"Republic of Korea","2024-04-12",0,0,0,0,0,0,0,0
"Republic of Korea","2024-04-13",0,0,0,0,0,0,0,0
"Republic of Korea","2024-04-14",0,0,0,0,0,0,0,0
"Republic of Korea","2024-04-15",0,0,0,0,0,0,0,0
"Republic of Korea","2024-04-16",0,0,0,0,0,0,0,0
"Republic of Korea","2024-04-17",0,0,0,0,0,0,0,0
"Republic of Korea","2024-04-18",0,0,0,0,0,0,0,0
"Republic of Korea","2024-04-19",0,0,0,0,0,0,0,0
"Republic of Korea","2024-04-20",0,0,0,0,0,0,0,0
"Republic of Korea","2024-04-21",0,0,0,0,0,0,0,0
"Republic of Korea","2024-04-22",0,0,0,0,0,0,0,0
"Republic of Korea","2024-04-23",0,0,0,0,0,0,0,0
"Republic of Korea","2024-04-24",0,0,0,0,0,0,0,0
"Republic of Korea","2024-04-25",0,0,0,0,0,0,0,0
"Republic of Korea","2024-04-26",0,0,0,0,0,0,0,0
"Republic of Korea","2024-04-27",0,1,1,0,1,1,0,0
"Republic of Korea","2024-04-28",0,0,1,0,0,1,0,0
"Republic of Korea","2024-04-29",0,0,1,0,0,1,0,0
"Republic of Korea","2024-04-30",0,0,1,0,0,1,0,0
"Republic of Korea","2024-05-01",0,0,1,0,0,1,0,0
"Republic of Korea","2024-05-02",0,0,1,0,0,1,0,0
"Republic of Korea","2024-05-03",0,0,1,0,0,1,0,0
"Republic of Korea","2024-05-04",0,0,1,0,0,1,0,0
"Republic of Korea","2024-05-05",0,0,1,0,0,1,0,0
"Republic of Korea","2024-05-06",0,0,1,0,0,1,0,0
"Republic of Korea","2024-05-07",0,0,1,0,0,1,0,0
"Republic of Korea","2024-05-08",0,0,1,0,0,1,0,0
"Republic of Korea","2024-05-09",0,0,1,0,0,1,0,0
"Republic of Korea","2024-05-10",0,0,1,0,0,1,0,0
"Republic of Korea","2024-05-11",0,0,1,0,0,1,0,0
"Republic of Korea","2024-05-12",0,0,1,0,1,2,0,0
"Republic of Korea","2024-05-13",0,0,1,0,0,2,0,0
"Republic of Korea","2024-05-14",0,0,1,0,0,2,0,0
"Republic of Korea","2024-05-15",0,0,1,0,0,2,0,0
"Republic of Korea","2024-05-16",0,0,1,0,0,2,0,0
"Republic of Korea","2024-05-17",0,0,1,0,0,2,0,0
"Republic of Korea","2024-05-18",0,0,1,0,0,2,0,0
"Republic of Korea","2024-05-19",0,0,1,0,0,2,0,0
"Republic of Korea","2024-05-20",0,0,1,0,0,2,0,0
"Republic of Korea","2024-05-21",0,0,1,0,0,2,0,0
"Republic of Korea","2024-05-22",0,0,1,0,0,2,0,0
"Republic of Korea","2024-05-23",0,0,1,0,0,2,0,0
"Republic of Korea","2024-05-24",0,0,1,0,0,2,0,0
"Republic of Korea","2024-05-25",0,0,1,0,0,2,0,0
"Republic of Korea","2024-05-26",0,0,1,0,0,2,0,0
"Republic of Korea","2024-05-27",0,0,1,0,0,2,0,0
"Republic of Korea","2024-05-28",0,0,1,0,0,2,0,0
"Republic of Korea","2024-05-29",0,0,1,0,0,2,0,0
"Republic of Korea","2024-05-30",0,0,1,0,0,2,0,0
"Republic of Korea","2024-05-31",0,0,1,0,0,2,0,0
"Republic of Korea","2024-06-01",0,0,1,0,0,2,0,0
"Republic of Korea","2024-06-02",0,0,1,0,0,2,0,0
"Republic of Korea","2024-06-03",0,0,1,0,0,2,0,0
"Republic of Korea","2024-06-04",0,0,1,0,0,2,0,0
"Republic of Korea","2024-06-05",0,0,1,0,0,2,0,0
"Republic of Korea","2024-06-06",0,0,1,0,0,2,0,0
"Republic of Korea","2024-06-07",0,0,1,0,0,2,0,0
"Republic of Korea","2024-06-08",0,0,1,0,0,2,0,0
"Republic of Korea","2024-06-09",0,0,1,0,0,2,0,0
"Republic of Korea","2024-06-10",0,0,1,0,0,2,0,0
"Republic of Korea","2024-06-11",0,0,1,0,1,3,0,0
"Republic of Korea","2024-06-12",0,0,1,0,0,3,0,0
"Republic of Korea","2024-06-13",0,0,1,0,0,3,0,0
"Republic of Korea","2024-06-14",0,0,1,0,0,3,0,0
"Republic of Korea","2024-06-15",0,0,1,0,0,3,0,0
"Republic of Korea","2024-06-16",0,0,1,0,0,3,0,0
"Republic of Korea","2024-06-17",0,0,1,0,0,3,0,0
"Republic of Korea","2024-06-18",0,0,1,0,0,3,0,0
"Republic of Korea","2024-06-19",0,0,1,0,0,3,0,0
"Republic of Korea","2024-06-20",0,0,1,0,0,3,0,0
"Republic of Korea","2024-06-21",0,0,1,0,0,3,0,0
"Republic of Korea","2024-06-22",0,0,1,0,0,3,0,0
"Republic of Korea","2024-06-23",0,0,1,0,0,3,0,0
"Republic of Korea","2024-06-24",0,0,1,0,0,3,0,0
"Republic of Korea","2024-06-25",0,2,3,0,0,3,0,0
"Republic of Korea","2024-06-26",0,0,3,0,0,3,0,0
"Republic of Korea","2024-06-27",0,0,3,0,1,4,0,0
"Republic of Korea","2024-06-28",0,1,4,0,0,4,0,0
"Republic of Korea","2024-06-29",0,0,4,0,0,4,0,0
"Republic of Korea","2024-06-30",0,0,4,0,0,4,0,0
"Republic of Korea","2024-07-01",0,0,4,0,0,4,0,0
"Republic of Korea","2024-07-02",0,0,4,0,1,5,0,0
"Republic of Korea","2024-07-03",0,0,4,0,0,5,0,0
"Republic of Korea","2024-07-04",0,0,4,0,0,5,0,0
"Republic of Korea","2024-07-05",0,0,4,0,0,5,0,0
"Republic of Korea","2024-07-06",0,0,4,0,0,5,0,0
"Republic of Korea","2024-07-07",0,0,4,0,0,5,0,0
"Republic of Korea","2024-07-08",0,0,4,0,0,5,0,0
"Republic of Korea","2024-07-09",0,0,4,0,1,6,0,0
"Republic of Korea","2024-07-10",0,0,4,0,0,6,0,0
"Republic of Korea","2024-07-11",0,0,4,0,0,6,0,0
"Republic of Korea","2024-07-12",0,2,6,0,0,6,0,0
"Republic of Korea","2024-07-13",0,0,6,0,0,6,0,0
"Republic of Korea","2024-07-14",0,0,6,0,0,6,0,0
"Republic of Korea","2024-07-15",0,0,6,0,1,7,0,0
"Republic of Korea","2024-07-16",0,0,6,0,0,7,0,0
"Republic of Korea","2024-07-17",0,0,6,0,0,7,0,0
"Republic of Korea","2024-07-18",0,0,6,0,0,7,0,0
"Republic of Korea","2024-07-19",0,0,6,0,0,7,0,0
"Republic of Korea","2024-07-20",0,0,6,0,1,8,0,0
"Republic of Korea","2024-07-21",0,0,6,0,0,8,0,0
"Republic of Korea","2024-07-22",0,0,6,0,0,8,0,0
"Republic of Korea","2024-07-23",0,0,6,0,0,8,0,0
"Republic of Korea","2024-07-24",0,0,6,0,0,8,0,0
"Republic of Korea","2024-07-25",0,0,6,0,0,8,0,0
"Republic of Korea","2024-07-26",0,0,6,0,1,9,0,0
"Republic of Korea","2024-07-27",0,0,6,0,0,9,0,0
"Republic of Korea","2024-07-28",0,0,6,0,0,9,0,0
"Republic of Korea","2024-07-29",0,0,6,0,0,9,0,0
"Republic of Korea","2024-07-30",0,0,6,0,0,9,0,0
"Republic of Korea","2024-07-31",0,0,6,0,1,10,0,0
"Republic of Korea","2024-08-01",0,0,6,0,0,10,0,0
"Republic of Korea","2024-08-02",0,4,10,0,0,10,0,0
"Republic of Korea","2024-08-03",0,0,10,0,0,10,0,0
"Republic of Korea","2024-08-04",0,0,10,0,0,10,0,0
"Republic of Korea","2024-08-05",0,0,10,0,0,10,0,0
"Republic of Korea","2024-08-06",0,0,10,0,0,10,0,0
"Republic of Korea","2024-08-07",0,0,10,0,0,10,0,0
"Republic of Korea","2024-08-08",0,0,10,0,0,10,0,0
"Republic of Korea","2024-08-09",0,0,10,0,0,10,0,0
"Republic of Korea","2024-08-10",0,0,10,0,0,10,0,0
"Republic of Korea","2024-08-11",0,0,10,0,0,10,0,0
"Republic of Korea","2024-08-12",0,0,10,0,0,10,0,0
"Republic of Korea","2024-08-13",0,0,10,0,1,11,0,0
"Republic of Korea","2024-08-14",0,0,10,0,0,11,0,0
"Republic of Korea","2024-08-15",0,0,10,0,0,11,0,0
"Republic of Korea","2024-08-16",0,0,10,0,0,11,0,0
"Republic of Korea","2024-08-17",0,0,10,0,0,11,0,0
"Republic of Korea","2024-08-18",0,0,10,0,0,11,0,0
"Republic of Korea","2024-08-19",0,0,10,0,0,11,0,0
"Republic of Korea","2024-08-20",0,0,10,0,0,11,0,0
"Republic of Korea","2024-08-21",0,0,10,0,0,11,0,0
"Republic of Korea","2024-08-22",0,1,11,0,0,11,0,0
"Republic of Korea","2024-08-23",0,0,11,0,0,11,0,0
"Republic of Korea","2024-08-24",0,0,11,0,0,11,0,0
"Republic of Korea","2024-08-25",0,0,11,0,0,11,0,0
"Republic of Korea","2024-08-26",0,0,11,0,0,11,0,0
"Republic of Korea","2024-08-27",0,0,11,0,0,11,0,0
"Republic of Korea","2024-08-28",0,0,11,0,0,11,0,0
"Republic of Korea","2024-08-29",0,0,11,0,1,12,0,0
"Republic of Korea","2024-08-30",0,0,11,0,0,12,0,0
"Republic of Korea","2024-08-31",0,0,11,0,0,12,0,0
"Republic of Korea","2024-09-01",0,0,11,0,0,12,0,0
"Republic of Korea","2024-09-02",0,0,11,0,0,12,0,0
"Republic of Korea","2024-09-03",0,0,11,0,0,12,0,0
"Republic of Korea","2024-09-04",0,0,11,0,0,12,0,0
"Republic of Korea","2024-09-05",0,0,11,0,0,12,0,0
"Republic of Korea","2024-09-06",0,0,11,0,0,12,0,0
"Republic of Korea","2024-09-07",0,0,11,0,0,12,0,0
"Republic of Korea","2024-09-08",0,0,11,0,0,12,0,0
"Republic of Korea","2024-09-09",0,0,11,0,1,13,0,0
"Republic of Korea","2024-09-10",0,0,11,0,0,13,0,0
"Republic of Korea","2024-09-11",0,0,11,0,0,13,0,0
"Republic of Korea","2024-09-12",0,0,11,0,0,13,0,0
"Republic of Korea","2024-09-13",0,0,11,0,0,13,0,0
"Republic of Korea","2024-09-14",0,0,11,0,0,13,0,0
"Republic of Korea","2024-09-15",0,2,13,0,0,13,0,0
"Republic of Korea","2024-09-16",0,0,13,0,0,13,0,0
"Republic of Korea","2024-09-17",0,0,13,0,0,13,0,0
"Republic of Korea","2024-09-18",0,0,13,0,0,13,0,0
"Republic of Korea","2024-09-19",0,0,13,0,0,13,0,0
"Republic of Korea","2024-09-20",0,0,13,0,0,13,0,0
"Republic of Korea","2024-09-21",0,0,13,0,0,13,0,0
"Republic of Korea","2024-09-22",0,0,13,0,0,13,0,0
"Republic of Korea","2024-09-23",0,0,13,0,0,13,0,0
"Republic of Korea","2024-09-24",0,0,13,0,0,13,0,0
"Republic of Korea","2024-09-25",0,0,13,0,0,13,0,0
"Republic of Korea","2024-09-26",0,0,13,0,0,13,0,0
"Republic of Korea","2024-09-27",0,0,13,0,0,13,0,0
"Republic of Korea","2024-09-28",0,0,13,0,0,13,0,0
"Republic of Korea","2024-09-29",0,0,13,0,0,13,0,0
"Republic of Korea","2024-09-30",0,0,13,0,0,13,0,0
"Republic of Korea","2024-10-01",0,0,13,0,0,13,0,0
"Republic of Korea","2024-10-02",0,0,13,0,0,13,0,0
"Republic of Korea","2024-10-03",0,0,13,0,0,13,0,0
"Republic of Korea","2024-10-04",0,0,13,0,0,13,0,0
"Republic of Korea","2024-10-05",0,0,13,0,0,13,0,0
"Republic of Korea","2024-10-06",0,0,13,0,0,13,0,0
"Republic of Korea","2024-10-07",0,0,13,0,0,13,0,0
"Republic of Korea","2024-10-08",0,0,13,0,0,13,0,0
"Republic of Korea","2024-10-09",0,0,13,0,1,14,0,0
"Republic of Korea","2024-10-10",0,0,13,0,0,14,0,0
"Republic of Korea","2024-10-11",0,0,13,0,0,14,0,0
"Republic of Korea","2024-10-12",0,0,13,0,0,14,0,0
"Republic of Korea","2024-10-13",0,0,13,0,0,14,0,0
"Republic of Korea","2024-10-14",0,0,13,0,0,14,0,0
"Republic of Korea","2024-10-15",0,0,13,0,0,14,0,0
"Republic of Korea","2024-10-16",0,0,13,0,0,14,0,0
"Republic of Korea","2024-10-17",0,0,13,0,0,14,0,0
"Republic of Korea","2024-10-18",0,0,13,0,0,14,0,0
"Republic of Korea","2024-10-19",0,0,13,0,0,14,0,0
"Republic of Korea","2024-10-20",0,0,13,0,0,14,0,0
"Republic of Korea","2024-10-21",0,0,13,0,0,14,0,0
"Republic of Korea","2024-10-22",0,0,13,0,0,14,0,0
"Republic of Korea","2024-10-23",0,0,13,0,0,14,0,0
"Republic of Korea","2024-10-24",0,0,13,0,0,14,0,0
"Republic of Korea","2024-10-25",0,0,13,0,0,14,0,0
"Republic of Korea","2024-10-26",0,0,13,0,0,14,0,0
"Republic of Korea","2024-10-27",0,0,13,0,0,14,0,0
"Republic of Korea","2024-10-28",0,0,13,0,0,14,0,0
"Republic of Korea","2024-10-29",0,0,13,0,0,14,0,0
"Republic of Korea","2024-10-30",0,0,13,0,0,14,0,0
"Republic of Korea","2024-10-31",0,1,14,0,0,14,0,0
"Republic of Korea","2024-11-01",0,0,14,0,0,14,0,0
"Republic of Korea","2024-11-02",0,0,14,0,0,14,0,0
"Republic of Korea","2024-11-03",0,0,14,0,1,15,0,0
"Republic of Korea","2024-11-04",0,0,14,0,0,15,0,0
"Republic of Korea","2024-11-05",0,0,14,0,0,15,0,0
"Republic of Korea","2024-11-06",0,0,14,0,0,15,0,0
"Republic of Korea","2024-11-07",0,0,14,0,0,15,0,0
"Republic of Korea","2024-11-08",0,0,14,0,1,16,0,0
"Republic of Korea","2024-11-09",0,0,14,0,0,16,0,0
"Republic of Korea","2024-11-10",0,0,14,0,0,16,0,0
"Republic of Korea","2024-11-11",0,0,14,0,0,16,0,0
"Republic of Korea","2024-11-12",0,0,14,0,0,16,0,0
"Republic of Korea","2024-11-13",0,0,14,0,1,17,0,0
"Republic of Korea","2024-11-14",0,0,14,0,0,17,0,0
"Republic of Korea","2024-11-15",0,3,17,0,0,17,0,0
"Republic of Korea","2024-11-16",0,0,17,0,0,17,0,0
"Republic of Korea","2024-11-17",0,0,17,0,0,17,0,0
"Republic of Korea","2024-11-18",0,0,17,0,0,17,0,0
"Republic of Korea","2024-11-19",0,0,17,0,0,17,0,0
"Republic of Korea","2024-11-20",0,0,17,0,0,17,0,0
"Republic of Korea","2024-11-21",0,0,17,0,0,17,0,0
"Republic of Korea","2024-11-22",0,0,17,0,0,17,0,0
"Republic of Korea","2024-11-23",0,0,17,0,0,17,0,0
"Republic of Korea","2024-11-24",0,0,17,0,0,17,0,0
"Republic of Korea","2024-11-25",0,0,17,0,0,17,0,0
"Republic of Korea","2024-11-26",0,0,17,0,0,17,0,0
"Republic of Korea","2024-11-27",0,0,17,0,0,17,0,0
"Republic of Korea","2024-11-28",0,0,17,0,0,17,0,0
"Republic of Korea","2024-11-29",0,0,17,0,0,17,0,0
"Republic of Korea","2024-11-30",0,0,17,0,0,17,0,0
"Republic of Korea","2024-12-01",0,0,17,0,0,17,0,0
"Republic of Korea","2024-12-02",0,0,17,0,0,17,0,0
"Republic of Korea","2024-12-03",0,0,17,0,0,17,0,0
"Republic of Korea","2024-12-04",0,0,17,0,0,17,0,0
"Republic of Korea","2024-12-05",0,0,17,0,0,17,0,0
"Republic of Korea","2024-12-06",0,0,17,0,0,17,0,0
"Republic of Korea","2024-12-07",0,0,17,0,0,17,0,0
"Republic of Korea","2024-12-08",0,0,17,0,0,17,0,0
"Republic of Korea","2024-12-09",0,0,17,0,0,17,0,0
"Republic of Korea","2024-12-10",0,0,17,0,0,17,0,0
"Republic of Korea","2024-12-11",0,0,17,0,0,17,0,0
"Republic of Korea","2024-12-12",0,0,17,0,0,17,0,0
"Republic of Korea","2024-12-13",0,0,17,0,0,17,0,0
"Republic of Korea","2024-12-14",0,0,17,0,0,17,0,0
"Republic of Korea","2024-12-15",0,0,17,0,0,17,0,0
"Republic of Korea","2024-12-16",0,0,17,0,0,17,0,0
"Republic of Korea","2024-12-17",0,0,17,0,0,17,0,0
"Republic of Korea","2024-12-18",0,0,17,0,0,17,0,0
"Republic of Korea","2024-12-19",0,0,17,0,0,17,0,0
"Republic of Korea","2024-12-20",0,0,17,0,0,17,0,0
"Republic of Korea","2024-12-21",0,0,17,0,0,17,0,0
"Republic of Korea","2024-12-22",0,0,17,0,0,17,0,0
"Republic of Korea","2024-12-23",0,0,17,0,0,17,0,0
"Republic of Korea","2024-12-24",0,0,17,0,0,17,0,0
"Republic of Korea","2024-12-25",0,0,17,0,0,17,0,0
"Republic of Korea","2024-12-26",0,0,17,0,0,17,0,0
"Republic of Korea","2024-12-27",0,0,17,0,0,17,0,0
"Republic of Korea","2024-12-28",0,0,17,0,0,17,0,0
"Republic of Korea","2024-12-29",0,0,17,0,0,17,0,0
"Republic of Korea","2024-12-30",0,0,17,0,0,17,0,0
"Republic of Korea","2024-12-31",0,0,17,0,0,17,0,0
"Republic of Korea","2025-01-01",0,0,17,0,0,17,0,0
"Republic of Korea","2025-01-02",0,0,17,0,0,17,0,0
"Republic of Korea","2025-01-03",0,0,17,0,0,17,0,0
"Republic of Korea","2025-01-04",0,0,17,0,0,17,0,0
"Republic of Korea","2025-01-05",0,0,17,0,0,17,0,0
"Republic of Korea","2025-01-06",0,0,17,0,0,17,0,0
"Republic of Korea","2025-01-07",0,0,17,0,0,17,0,0
"Republic of Korea","2025-01-08",0,0,17,0,0,17,0,0
"Republic of Korea","2025-01-09",0,0,17,0,0,17,0,0
"Republic of Korea","2025-01-10",0,0,17,0,0,17,0,0
"Republic of Korea","2025-01-11",0,0,17,0,0,17,0,0
"Republic of Korea","2025-01-12",0,0,17,0,0,17,0,0
"Republic of Korea","2025-01-13",0,0,17,0,0,17,0,0
"Spain","2024-01-01",0,0,0,0,0,0,0,0
"Spain","2024-01-02",0,0,0,0,0,0,0,0
"Spain","2024-01-03",0,0,0,0,0,0,0,0
"Spain","2024-01-04",0,0,0,0,0,0,0,0
"Spain","2024-01-05",0,0,0,0,0,0,0,0
"Spain","2024-01-06",0,0,0,0,0,0,0,0
"Spain","2024-01-07",0,0,0,0,0,0,0,0
"Spain","2024-01-08",0,0,0,0,0,0,0,0
"Spain","2024-01-09",0,0,0,0,0,0,0,0
"Spain","2024-01-10",0,0,0,0,0,0,0,0
"Spain","2024-01-11",0,0,0,0,0,0,0,0
"Spain","2024-01-12",0,0,0,0,0,0,0,0
"Spain","2024-01-13",0,0,0,0,0,0,0,0
"Spain","2024-01-14",0,0,0,0,0,0,0,0
"Spain","2024-01-15",0,0,0,0,0,0,0,0
"Spain","2024-01-16",0,0,0,0,0,0,0,0
"Spain","2024-01-17",0,0,0,0,0,0,0,0
"Spain","2024-01-18",0,0,0,0,0,0,0,0
"Spain","2024-01-19",0,0,0,0,0,0,0,0
"Spain","2024-01-20",0,0,0,0,0,0,0,0
"Spain","2024-01-21",0,0,0,0,0,0,0,0
"Spain","2024-01-22",0,0,0,0,0,0,0,0
"Spain","2024-01-23",0,0,0,0,0,0,0,0
"Spain","2024-01-24",0,0,0,0,0,0,0,0
"Spain","2024-01-25",0,0,0,0,0,0,0,0
"Spain","2024-01-26",0,0,0,0,0,0,0,0
"Spain","2024-01-27",0,0,0,0,0,0,0,0
"Spain","2024-01-28",0,0,0,0,0,0,0,0
"Spain","2024-01-29",0,0,0,0,0,0,0,0
"Spain","2024-01-30",0,0,0,0,0,0,0,0
"Spain","2024-01-31",0,34,34,0,34,34,0,0
"Spain","2024-02-01",0,0,34,0,4,38,0,0
"Spain","2024-02-02",0,0,34,0,4,42,0,0
"Spain","2024-02-03",0,0,34,0,4,46,0,0
"Spain","2024-02-04",0,0,34,0,3,49,0,0
"Spain","2024-02-05",0,0,34,0,4,53,0,0
"Spain","2024-02-06",0,0,34,0,4,57,0,0
"Spain","2024-02-07",0,0,34,0,4,61,0,0
"Spain","2024-02-08",0,0,34,0,4,65,0,0
"Spain","2024-02-09",0,0,34,0,4,69,0,0
"Spain","2024-02-10",0,0,34,0,4,73,0,0
"Spain","2024-02-11",0,0,34,0,3,76,0,0
"Spain","2024-02-12",0,0,34,0,4,80,0,0
"Spain","2024-02-13",0,0,34,0,4,84,0,0
"Spain","2024-02-14",0,0,34,0,4,88,0,0
"Spain","2024-02-15",0,0,34,0,4,92,0,0
"Spain","2024-02-16",0,0,34,0,4,96,0,0
"Spain","2024-02-17",0,0,34,0,4,100,0,0
"Spain","2024-02-18",0,0,34,0,4,104,0,0
"Spain","2024-02-19",0,0,34,0,3,107,0,0
"Spain","2024-02-20",0,0,34,0,4,111,0,0
"Spain","2024-02-21",0,0,34,0,4,115,0,0
"Spain","2024-02-22",0,0,34,0,4,119,0,0
"Spain","2024-02-23",0,0,34,0,4,123,0,0
"Spain","2024-02-24",0,0,34,0,4,127,0,0
"Spain","2024-02-25",0,0,34,0,4,131,0,0
"Spain","2024-02-26",0,0,34,0,3,134,0,0
"Spain","2024-02-27",0,0,34,0,4,138,0,0
"Spain","2024-02-28",0,0,34,0,4,142,0,0
"Spain","2024-02-29",0,112,146,0,4,146,0,0
"Spain","2024-03-01",0,0,146,0,2,148,0,0
"Spain","2024-03-02",0,0,146,0,2,150,0,0
"Spain","2024-03-03",0,0,146,0,2,152,0,0
"Spain","2024-03-04",0,0,146,0,2,154,0,0
"Spain","2024-03-05",0,0,146,0,2,156,0,0
"Spain","2024-03-06",0,0,146,0,2,158,0,0
"Spain","2024-03-07",0,0,146,0,2,160,0,0
"Spain","2024-03-08",0,0,146,0,2,162,0,0
"Spain","2024-03-09",0,0,146,0,2,164,0,0
"Spain","2024-03-10",0,0,146,0,2,166,0,0
"Spain","2024-03-11",0,0,146,0,2,168,0,0
"Spain","2024-03-12",0,0,146,0,2,170,0,0
"Spain","2024-03-13",0,0,146,0,2,172,0,0
"Spain","2024-03-14",0,0,146,0,2,174,0,0
"Spain","2024-03-15",0,0,146,0,2,176,0,0
"Spain","2024-03-16",0,0,146,0,2,178,0,0
"Spain","2024-03-17",0,0,146,0,2,180,0,0
"Spain","2024-03-18",0,0,146,0,2,182,0,0
"Spain","2024-03-19",0,0,146,0,2,184,0,0
"Spain","2024-03-20",0,0,146,0,2,186,0,0
"Spain","2024-03-21",0,0,146,0,2,188,0,0
"Spain","2024-03-22",0,0,146,0,2,190,0,0
"Spain","2024-03-23",0,0,146,0,2,192,0,0
"Spain","2024-03-24",0,0,146,0,2,194,0,0
"Spain","2024-03-25",0,0,146,0,2,196,0,0
"Spain","2024-03-26",0,0,146,0,2,198,0,0
"Spain","2024-03-27",0,0,146,0,2,200,0,0
"Spain","2024-03-28",0,0,146,0,2,202,0,0
"Spain","2024-03-29",0,0,146,0,2,204,0,0
"Spain","2024-03-30",0,0,146,0,2,206,0,0
"Spain","2024-03-31",0,62,208,0,2,208,0,0
"Spain","2024-04-01",0,0,208,0,1,209,0,0
"Spain","2024-04-02",0,0,208,0,1,210,0,0
"Spain","2024-04-03",0,0,208,0,1,211,0,0
"Spain","2024-04-04",0,0,208,0,1,212,0,0
"Spain","2024-04-05",0,0,208,0,1,213,0,0
"Spain","2024-04-06",0,0,208,0,1,214,0,0
"Spain","2024-04-07",0,0,208,0,1,215,0,0
"Spain","2024-04-08",0,0,208,0,2,217,0,0
"Spain","2024-04-09",0,0,208,0,1,218,0,0
"Spain","2024-04-10",0,0,208,0,1,219,0,0
"Spain","2024-04-11",0,0,208,0,1,220,0,0
"Spain","2024-04-12",0,0,208,0,1,221,0,0
"Spain","2024-04-13",0,0,208,0,1,222,0,0
"Spain","2024-04-14",0,0,208,0,1,223,0,0
"Spain","2024-04-15",0,0,208,0,1,224,0,0
"Spain","2024-04-16",0,0,208,0,1,225,0,0
"Spain","2024-04-17",0,0,208,0,1,226,0,0
"Spain","2024-04-18",0,0,208,0,1,227,0,0
"Spain","2024-04-19",0,0,208,0,1,228,0,0
"Spain","2024-04-20",0,0,208,0,1,229,0,0
"Spain","2024-04-21",0,0,208,0,1,230,0,0
"Spain","2024-04-22",0,0,208,0,1,231,0,0
"Spain","2024-04-23",0,0,208,0,2,233,0,0
"Spain","2024-04-24",0,0,208,0,1,234,0,0
"Spain","2024-04-25",0,0,208,0,1,235,0,0
"Spain","2024-04-26",0,0,208,0,1,236,0,0
"Spain","2024-04-27",0,0,208,0,1,237,0,0
"Spain","2024-04-28",0,0,208,0,1,238,0,0
"Spain","2024-04-29",0,0,208,0,1,239,0,0
"Spain","2024-04-30",0,32,240,0,1,240,0,0
"Spain","2024-05-01",0,0,240,0,1,241,0,0
"Spain","2024-05-02",0,0,240,0,1,242,0,0
"Spain","2024-05-03",0,0,240,0,2,244,0,0
"Spain","2024-05-04",0,0,240,0,1,245,0,0
"Spain","2024-05-05",0,0,240,0,1,246,0,0
"Spain","2024-05-06",0,0,240,0,1,247,0,0
"Spain","2024-05-07",0,0,240,0,2,249,0,0
"Spain","2024-05-08",0,0,240,0,1,250,0,0
"Spain","2024-05-09",0,0,240,0,1,251,0,0
"Spain","2024-05-10",0,0,240,0,1,252,0,0
"Spain","2024-05-11",0,0,240,0,1,253,0,0
"Spain","2024-05-12",0,0,240,0,2,255,0,0
"Spain","2024-05-13",0,0,240,0,1,256,0,0
"Spain","2024-05-14",0,0,240,0,1,257,0,0
"Spain","2024-05-15",0,0,240,0,1,258,0,0
"Spain","2024-05-16",0,0,240,0,2,260,0,0
"Spain","2024-05-17",0,0,240,0,1,261,0,0
"Spain","2024-05-18",0,0,240,0,1,262,0,0
"Spain","2024-05-19",0,0,240,0,1,263,0,0
"Spain","2024-05-20",0,0,240,0,2,265,0,0
"Spain","2024-05-21",0,0,240,0,1,266,0,0
"Spain","2024-05-22",0,0,240,0,1,267,0,0
"Spain","2024-05-23",0,0,240,0,1,268,0,0
"Spain","2024-05-24",0,0,240,0,1,269,0,0
"Spain","2024-05-25",0,0,240,0,2,271,0,0
"Spain","2024-05-26",0,0,240,0,1,272,0,0
"Spain","2024-05-27",0,0,240,0,1,273,0,0
"Spain","2024-05-28",0,0,240,0,1,274,0,0
"Spain","2024-05-29",0,0,240,0,2,276,0,0
"Spain","2024-05-30",0,0,240,0,1,277,0,0
"Spain","2024-05-31",0,38,278,0,1,278,0,0
"Spain","2024-06-01",0,0,278,0,2,280,0,0
"Spain","2024-06-02",0,0,278,0,2,282,0,0
"Spain","2024-06-03",0,0,278,0,1,283,0,0
"Spain","2024-06-04",0,0,278,0,2,285,0,0
"Spain","2024-06-05",0,0,278,0,2,287,0,0
"Spain","2024-06-06",0,0,278,0,2,289,0,0
"Spain","2024-06-07",0,0,278,0,2,291,0,0
"Spain","2024-06-08",0,0,278,0,1,292,0,0
"Spain","2024-06-09",0,0,278,0,2,294,0,0
"Spain","2024-06-10",0,0,278,0,2,296,0,0
"Spain","2024-06-11",0,0,278,0,2,298,0,0
"Spain","2024-06-12",0,0,278,0,2,300,0,0
"Spain","2024-06-13",0,0,278,0,1,301,0,0
"Spain","2024-06-14",0,0,278,0,2,303,0,0
"Spain","2024-06-15",0,0,278,0,2,305,0,0
"Spain","2024-06-16",0,0,278,0,2,307,0,0
"Spain","2024-06-17",0,0,278,0,2,309,0,0
"Spain","2024-06-18",0,0,278,0,1,310,0,0
"Spain","2024-06-19",0,0,278,0,2,312,0,0
"Spain","2024-06-20",0,0,278,0,2,314,0,0
"Spain","2024-06-21",0,0,278,0,2,316,0,0
"Spain","2024-06-22",0,0,278,0,2,318,0,0
"Spain","2024-06-23",0,0,278,0,1,319,0,0
"Spain","2024-06-24",0,0,278,0,2,321,0,0
"Spain","2024-06-25",0,0,278,0,2,323,0,0
"Spain","2024-06-26",0,0,278,0,2,325,0,0
"Spain","2024-06-27",0,0,278,0,2,327,0,0
"Spain","2024-06-28",0,0,278,0,1,328,0,0
"Spain","2024-06-29",0,0,278,0,2,330,0,0
"Spain","2024-06-30",0,54,332,0,2,332,0,0
"Spain","2024-07-01",0,0,332,0,1,333,0,0
"Spain","2024-07-02",0,0,332,0,0,333,0,0
"Spain","2024-07-03",0,0,332,0,1,334,0,0
"Spain","2024-07-04",0,0,332,0,1,335,0,0
"Spain","2024-07-05",0,0,332,0,0,335,0,0
"Spain","2024-07-06",0,0,332,0,1,336,0,0
"Spain","2024-07-07",0,0,332,0,1,337,0,0
"Spain","2024-07-08",0,0,332,0,0,337,0,0
"Spain","2024-07-09",0,0,332,0,1,338,0,0
"Spain","2024-07-10",0,0,332,0,0,338,0,0
"Spain","2024-07-11",0,0,332,0,1,339,0,0
"Spain","2024-07-12",0,0,332,0,1,340,0,0
"Spain","2024-07-13",0,0,332,0,0,340,0,0
"Spain","2024-07-14",0,0,332,0,1,341,0,0
"Spain","2024-07-15",0,0,332,0,1,342,0,0
"Spain","2024-07-16",0,0,332,0,0,342,0,0
"Spain","2024-07-17",0,0,332,0,1,343,0,0
"Spain","2024-07-18",0,0,332,0,1,344,0,0
"Spain","2024-07-19",0,0,332,0,0,344,0,0
"Spain","2024-07-20",0,0,332,0,1,345,0,0
"Spain","2024-07-21",0,0,332,0,1,346,0,0
"Spain","2024-07-22",0,0,332,0,0,346,0,0
"Spain","2024-07-23",0,0,332,0,1,347,0,0
"Spain","2024-07-24",0,0,332,0,0,347,0,0
"Spain","2024-07-25",0,0,332,0,1,348,0,0
"Spain","2024-07-26",0,0,332,0,1,349,0,0
"Spain","2024-07-27",0,0,332,0,0,349,0,0
"Spain","2024-07-28",0,0,332,0,1,350,0,0
"Spain","2024-07-29",0,0,332,0,1,351,0,0
"Spain","2024-07-30",0,0,332,0,0,351,0,0
"Spain","2024-07-31",0,20,352,0,1,352,0,0
"Spain","2024-08-01",0,0,352,0,4,356,0,0
"Spain","2024-08-02",0,0,352,0,5,361,0,0
"Spain","2024-08-03",0,0,352,0,4,365,0,0
"Spain","2024-08-04",0,0,352,0,5,370,0,0
"Spain","2024-08-05",0,0,352,0,4,374,0,0
"Spain","2024-08-06",0,0,352,0,4,378,0,0
"Spain","2024-08-07",0,0,352,0,5,383,0,0
"Spain","2024-08-08",0,0,352,0,4,387,0,0
"Spain","2024-08-09",0,0,352,0,4,391,0,0
"Spain","2024-08-10",0,0,352,0,5,396,0,0
"Spain","2024-08-11",0,0,352,0,4,400,0,0
"Spain","2024-08-12",0,0,352,0,5,405,0,0
"Spain","2024-08-13",0,0,352,0,4,409,0,0
"Spain","2024-08-14",0,0,352,0,4,413,0,0
"Spain","2024-08-15",0,0,352,0,5,418,0,0
"Spain","2024-08-16",0,0,352,0,4,422,0,0
"Spain","2024-08-17",0,0,352,0,5,427,0,0
"Spain","2024-08-18",0,0,352,0,4,431,0,0
"Spain","2024-08-19",0,0,352,0,4,435,0,0
"Spain","2024-08-20",0,0,352,0,5,440,0,0
"Spain","2024-08-21",0,0,352,0,4,444,0,0
"Spain","2024-08-22",0,0,352,0,5,449,0,0
"Spain","2024-08-23",0,0,352,0,4,453,0,0
"Spain","2024-08-24",0,0,352,0,4,457,0,0
"Spain","2024-08-25",0,0,352,0,5,462,0,0
"Spain","2024-08-26",0,0,352,0,4,466,0,0
"Spain","2024-08-27",0,0,352,0,4,470,0,0
"Spain","2024-08-28",0,0,352,0,5,475,0,0
"Spain","2024-08-29",0,0,352,0,4,479,0,0
"Spain","2024-08-30",0,0,352,0,5,484,0,0
"Spain","2024-08-31",0,136,488,0,4,488,0,0
"Spain","2024-09-01",0,0,488,0,1,489,0,0
"Spain","2024-09-02",0,0,488,0,2,491,0,0
"Spain","2024-09-03",0,0,488,0,1,492,0,0
"Spain","2024-09-04",0,0,488,0,2,494,0,0
"Spain","2024-09-05",0,0,488,0,1,495,0,0
"Spain","2024-09-06",0,0,488,0,1,496,0,0
"Spain","2024-09-07",0,0,488,0,2,498,0,0
"Spain","2024-09-08",0,0,488,0,1,499,0,0
"Spain","2024-09-09",0,0,488,0,2,501,0,0
"Spain","2024-09-10",0,0,488,0,1,502,0,0
"Spain","2024-09-11",0,0,488,0,1,503,0,0
"Spain","2024-09-12",0,0,488,0,2,505,0,0
"Spain","2024-09-13",0,0,488,0,1,506,0,0
"Spain","2024-09-14",0,0,488,0,2,508,0,0
"Spain","2024-09-15",0,0,488,0,1,509,0,0
"Spain","2024-09-16",0,0,488,0,1,510,0,0
"Spain","2024-09-17",0,0,488,0,2,512,0,0
"Spain","2024-09-18",0,0,488,0,1,513,0,0
"Spain","2024-09-19",0,0,488,0,2,515,0,0
"Spain","2024-09-20",0,0,488,0,1,516,0,0
"Spain","2024-09-21",0,0,488,0,1,517,0,0
"Spain","2024-09-22",0,0,488,0,2,519,0,0
"Spain","2024-09-23",0,0,488,0,1,520,0,0
"Spain","2024-09-24",0,0,488,0,2,522,0,0
"Spain","2024-09-25",0,0,488,0,1,523,0,0
"Spain","2024-09-26",0,0,488,0,1,524,0,0
"Spain","2024-09-27",0,0,488,0,2,526,0,0
"Spain","2024-09-28",0,0,488,0,1,527,0,0
"Spain","2024-09-29",0,0,488,0,2,529,0,0
"Spain","2024-09-30",0,42,530,0,1,530,0,0
"Spain","2024-10-01",0,0,530,0,2,532,0,0
"Spain","2024-10-02",0,0,530,0,2,534,0,0
"Spain","2024-10-03",0,0,530,0,2,536,0,0
"Spain","2024-10-04",0,0,530,0,2,538,0,0
"Spain","2024-10-05",0,0,530,0,2,540,0,0
"Spain","2024-10-06",0,0,530,0,2,542,0,0
"Spain","2024-10-07",0,0,530,0,2,544,0,0
"Spain","2024-10-08",0,0,530,0,3,547,0,0
"Spain","2024-10-09",0,0,530,0,2,549,0,0
"Spain","2024-10-10",0,0,530,0,2,551,0,0
"Spain","2024-10-11",0,0,530,0,2,553,0,0
"Spain","2024-10-12",0,0,530,0,2,555,0,0
"Spain","2024-10-13",0,0,530,0,2,557,0,0
"Spain","2024-10-14",0,0,530,0,2,559,0,0
"Spain","2024-10-15",0,0,530,0,2,561,0,0
"Spain","2024-10-16",0,0,530,0,2,563,0,0
"Spain","2024-10-17",0,0,530,0,2,565,0,0
"Spain","2024-10-18",0,0,530,0,2,567,0,0
"Spain","2024-10-19",0,0,530,0,2,569,0,0
"Spain","2024-10-20",0,0,530,0,2,571,0,0
"Spain","2024-10-21",0,0,530,0,2,573,0,0
"Spain","2024-10-22",0,0,530,0,2,575,0,0
"Spain","2024-10-23",0,0,530,0,2,577,0,0
"Spain","2024-10-24",0,0,530,0,3,580,0,0
"Spain","2024-10-25",0,0,530,0,2,582,0,0
"Spain","2024-10-26",0,0,530,0,2,584,0,0
"Spain","2024-10-27",0,0,530,0,2,586,0,0
"Spain","2024-10-28",0,0,530,0,2,588,0,0
"Spain","2024-10-29",0,0,530,0,2,590,0,0
"Spain","2024-10-30",0,0,530,0,2,592,0,0
"Spain","2024-10-31",0,64,594,0,2,594,0,0
"Spain","2024-11-01",0,0,594,0,3,597,0,0
"Spain","2024-11-02",0,0,594,0,3,600,0,0
"Spain","2024-11-03",0,0,594,0,4,604,0,0
"Spain","2024-11-04",0,0,594,0,3,607,0,0
"Spain","2024-11-05",0,0,594,0,3,610,0,0
"Spain","2024-11-06",0,0,594,0,3,613,0,0
"Spain","2024-11-07",0,0,594,0,4,617,0,0
"Spain","2024-11-08",0,0,594,0,3,620,0,0
"Spain","2024-11-09",0,0,594,0,3,623,0,0
"Spain","2024-11-10",0,0,594,0,3,626,0,0
"Spain","2024-11-11",0,0,594,0,4,630,0,0
"Spain","2024-11-12",0,0,594,0,3,633,0,0
"Spain","2024-11-13",0,0,594,0,3,636,0,0
"Spain","2024-11-14",0,0,594,0,3,639,0,0
"Spain","2024-11-15",0,0,594,0,3,642,0,0
"Spain","2024-11-16",0,0,594,0,4,646,0,0
"Spain","2024-11-17",0,0,594,0,3,649,0,0
"Spain","2024-11-18",0,0,594,0,3,652,0,0
"Spain","2024-11-19",0,0,594,0,3,655,0,0
"Spain","2024-11-20",0,0,594,0,4,659,0,0
"Spain","2024-11-21",0,0,594,0,3,662,0,0
"Spain","2024-11-22",0,0,594,0,3,665,0,0
"Spain","2024-11-23",0,0,594,0,3,668,0,0
"Spain","2024-11-24",0,0,594,0,4,672,0,0
"Spain","2024-11-25",0,0,594,0,3,675,0,0
"Spain","2024-11-26",0,0,594,0,3,678,0,0
"Spain","2024-11-27",0,0,594,0,3,681,0,0
"Spain","2024-11-28",0,0,594,0,4,685,0,0
"Spain","2024-11-29",0,0,594,0,3,688,0,0
"Spain","2024-11-30",0,97,691,0,3,691,0,0
"Spain","2024-12-01",0,0,691,0,0,691,0,0
"Spain","2024-12-02",0,0,691,0,0,691,0,0
"Spain","2024-12-03",0,0,691,0,0,691,0,0
"Spain","2024-12-04",0,0,691,0,0,691,0,0
"Spain","2024-12-05",0,0,691,0,0,691,0,0
"Spain","2024-12-06",0,0,691,0,0,691,0,0
"Spain","2024-12-07",0,0,691,0,0,691,0,0
"Spain","2024-12-08",0,0,691,0,0,691,0,0
"Spain","2024-12-09",0,0,691,0,0,691,0,0
"Spain","2024-12-10",0,0,691,0,0,691,0,0
"Spain","2024-12-11",0,0,691,0,0,691,0,0
"Spain","2024-12-12",0,0,691,0,0,691,0,0
"Spain","2024-12-13",0,0,691,0,0,691,0,0
"Spain","2024-12-14",0,0,691,0,0,691,0,0
"Spain","2024-12-15",0,0,691,0,0,691,0,0
"Spain","2024-12-16",0,0,691,0,0,691,0,0
"Spain","2024-12-17",0,0,691,0,0,691,0,0
"Spain","2024-12-18",0,0,691,0,0,691,0,0
"Spain","2024-12-19",0,0,691,0,0,691,0,0
"Spain","2024-12-20",0,0,691,0,0,691,0,0
"Spain","2024-12-21",0,0,691,0,0,691,0,0
"Spain","2024-12-22",0,0,691,0,0,691,0,0
"Spain","2024-12-23",0,0,691,0,0,691,0,0
"Spain","2024-12-24",0,0,691,0,0,691,0,0
"Spain","2024-12-25",0,0,691,0,0,691,0,0
"Spain","2024-12-26",0,0,691,0,0,691,0,0
"Spain","2024-12-27",0,0,691,0,0,691,0,0
"Spain","2024-12-28",0,0,691,0,0,691,0,0
"Spain","2024-12-29",0,0,691,0,0,691,0,0
"Spain","2024-12-30",0,0,691,0,0,691,0,0
"Spain","2024-12-31",0,0,691,0,0,691,0,0
"Spain","2025-01-01",0,0,691,0,0,691,0,0
"Spain","2025-01-02",0,0,691,0,0,691,0,0
"Spain","2025-01-03",0,0,691,0,0,691,0,0
"Spain","2025-01-04",0,0,691,0,0,691,0,0
"Spain","2025-01-05",0,0,691,0,0,691,0,0
"Spain","2025-01-06",0,0,691,0,0,691,0,0
"Spain","2025-01-07",0,0,691,0,0,691,0,0
"Spain","2025-01-08",0,0,691,0,0,691,0,0
"Spain","2025-01-09",0,0,691,0,0,691,0,0
"Spain","2025-01-10",0,0,691,0,0,691,0,0
"Spain","2025-01-11",0,0,691,0,0,691,0,0
"Spain","2025-01-12",0,0,691,0,0,691,0,0
"Spain","2025-01-13",0,0,691,0,0,691,0,0
"Sri Lanka","2024-01-01",0,0,0,0,0,0,0,0
"Sri Lanka","2024-01-02",0,0,0,0,0,0,0,0
"Sri Lanka","2024-01-03",0,0,0,0,0,0,0,0
"Sri Lanka","2024-01-04",0,0,0,0,0,0,0,0
"Sri Lanka","2024-01-05",0,0,0,0,0,0,0,0
"Sri Lanka","2024-01-06",0,0,0,0,0,0,0,0
"Sri Lanka","2024-01-07",0,0,0,0,0,0,0,0
"Sri Lanka","2024-01-08",0,0,0,0,0,0,0,0
"Sri Lanka","2024-01-09",0,0,0,0,0,0,0,0
"Sri Lanka","2024-01-10",0,0,0,0,0,0,0,0
"Sri Lanka","2024-01-11",0,0,0,0,0,0,0,0
"Sri Lanka","2024-01-12",0,0,0,0,0,0,0,0
"Sri Lanka","2024-01-13",0,0,0,0,0,0,0,0
"Sri Lanka","2024-01-14",0,0,0,0,0,0,0,0
"Sri Lanka","2024-01-15",0,0,0,0,0,0,0,0
"Sri Lanka","2024-01-16",0,0,0,0,0,0,0,0
"Sri Lanka","2024-01-17",0,0,0,0,0,0,0,0
"Sri Lanka","2024-01-18",0,0,0,0,0,0,0,0
"Sri Lanka","2024-01-19",0,0,0,0,0,0,0,0
"Sri Lanka","2024-01-20",0,0,0,0,0,0,0,0
"Sri Lanka","2024-01-21",0,0,0,0,0,0,0,0
"Sri Lanka","2024-01-22",0,0,0,0,0,0,0,0
"Sri Lanka","2024-01-23",0,0,0,0,0,0,0,0
"Sri Lanka","2024-01-24",0,0,0,0,0,0,0,0
"Sri Lanka","2024-01-25",0,0,0,0,0,0,0,0
"Sri Lanka","2024-01-26",0,0,0,0,0,0,0,0
"Sri Lanka","2024-01-27",0,0,0,0,0,0,0,0
"Sri Lanka","2024-01-28",0,0,0,0,0,0,0,0
"Sri Lanka","2024-01-29",0,0,0,0,0,0,0,0
"Sri Lanka","2024-01-30",0,0,0,0,0,0,0,0
"Sri Lanka","2024-01-31",0,0,0,0,0,0,0,0
"Sri Lanka","2024-02-01",0,0,0,0,0,0,0,0
"Sri Lanka","2024-02-02",0,0,0,0,0,0,0,0
"Sri Lanka","2024-02-03",0,0,0,0,0,0,0,0
"Sri Lanka","2024-02-04",0,0,0,0,0,0,0,0
"Sri Lanka","2024-02-05",0,0,0,0,0,0,0,0
"Sri Lanka","2024-02-06",0,0,0,0,0,0,0,0
"Sri Lanka","2024-02-07",0,0,0,0,0,0,0,0
"Sri Lanka","2024-02-08",0,0,0,0,0,0,0,0
"Sri Lanka","2024-02-09",0,0,0,0,0,0,0,0
"Sri Lanka","2024-02-10",0,0,0,0,0,0,0,0
"Sri Lanka","2024-02-11",0,0,0,0,0,0,0,0
"Sri Lanka","2024-02-12",0,0,0,0,0,0,0,0
"Sri Lanka","2024-02-13",0,0,0,0,0,0,0,0
"Sri Lanka","2024-02-14",0,0,0,0,0,0,0,0
"Sri Lanka","2024-02-15",0,0,0,0,0,0,0,0
"Sri Lanka","2024-02-16",0,0,0,0,0,0,0,0
"Sri Lanka","2024-02-17",0,0,0,0,0,0,0,0
"Sri Lanka","2024-02-18",0,0,0,0,0,0,0,0
"Sri Lanka","2024-02-19",0,0,0,0,0,0,0,0
"Sri Lanka","2024-02-20",0,0,0,0,0,0,0,0
"Sri Lanka","2024-02-21",0,0,0,0,0,0,0,0
"Sri Lanka","2024-02-22",0,0,0,0,0,0,0,0
"Sri Lanka","2024-02-23",0,0,0,0,0,0,0,0
"Sri Lanka","2024-02-24",0,0,0,0,0,0,0,0
"Sri Lanka","2024-02-25",0,0,0,0,0,0,0,0
"Sri Lanka","2024-02-26",0,0,0,0,0,0,0,0
"Sri Lanka","2024-02-27",0,0,0,0,0,0,0,0
"Sri Lanka","2024-02-28",0,0,0,0,0,0,0,0
"Sri Lanka","2024-02-29",0,0,0,0,0,0,0,0
"Sri Lanka","2024-03-01",0,0,0,0,0,0,0,0
"Sri Lanka","2024-03-02",0,0,0,0,0,0,0,0
"Sri Lanka","2024-03-03",0,0,0,0,0,0,0,0
"Sri Lanka","2024-03-04",0,0,0,0,0,0,0,0
"Sri Lanka","2024-03-05",0,0,0,0,0,0,0,0
"Sri Lanka","2024-03-06",0,0,0,0,0,0,0,0
"Sri Lanka","2024-03-07",0,0,0,0,0,0,0,0
"Sri Lanka","2024-03-08",0,0,0,0,0,0,0,0
"Sri Lanka","2024-03-09",0,0,0,0,0,0,0,0
"Sri Lanka","2024-03-10",0,0,0,0,0,0,0,0
"Sri Lanka","2024-03-11",0,0,0,0,0,0,0,0
"Sri Lanka","2024-03-12",0,0,0,0,0,0,0,0
"Sri Lanka","2024-03-13",0,0,0,0,0,0,0,0
"Sri Lanka","2024-03-14",0,0,0,0,0,0,0,0
"Sri Lanka","2024-03-15",0,0,0,0,0,0,0,0
"Sri Lanka","2024-03-16",0,0,0,0,0,0,0,0
"Sri Lanka","2024-03-17",0,0,0,0,0,0,0,0
"Sri Lanka","2024-03-18",0,0,0,0,0,0,0,0
"Sri Lanka","2024-03-19",0,0,0,0,0,0,0,0
"Sri Lanka","2024-03-20",0,0,0,0,0,0,0,0
"Sri Lanka","2024-03-21",0,0,0,0,0,0,0,0
"Sri Lanka","2024-03-22",0,0,0,0,0,0,0,0
"Sri Lanka","2024-03-23",0,0,0,0,0,0,0,0
"Sri Lanka","2024-03-24",0,0,0,0,0,0,0,0
"Sri Lanka","2024-03-25",0,0,0,0,0,0,0,0
"Sri Lanka","2024-03-26",0,0,0,0,0,0,0,0
"Sri Lanka","2024-03-27",0,0,0,0,0,0,0,0
"Sri Lanka","2024-03-28",0,0,0,0,0,0,0,0
"Sri Lanka","2024-03-29",0,0,0,0,0,0,0,0
"Sri Lanka","2024-03-30",0,0,0,0,0,0,0,0
"Sri Lanka","2024-03-31",0,0,0,0,0,0,0,0
"Sri Lanka","2024-04-01",0,0,0,0,0,0,0,0
"Sri Lanka","2024-04-02",0,0,0,0,0,0,0,0
"Sri Lanka","2024-04-03",0,0,0,0,0,0,0,0
"Sri Lanka","2024-04-04",0,0,0,0,0,0,0,0
"Sri Lanka","2024-04-05",0,0,0,0,0,0,0,0
"Sri Lanka","2024-04-06",0,0,0,0,0,0,0,0
"Sri Lanka","2024-04-07",0,0,0,0,0,0,0,0
"Sri Lanka","2024-04-08",0,0,0,0,0,0,0,0
"Sri Lanka","2024-04-09",0,0,0,0,0,0,0,0
"Sri Lanka","2024-04-10",0,0,0,0,0,0,0,0
"Sri Lanka","2024-04-11",0,0,0,0,0,0,0,0
"Sri Lanka","2024-04-12",0,0,0,0,0,0,0,0
"Sri Lanka","2024-04-13",0,0,0,0,0,0,0,0
"Sri Lanka","2024-04-14",0,0,0,0,0,0,0,0
"Sri Lanka","2024-04-15",0,0,0,0,0,0,0,0
"Sri Lanka","2024-04-16",0,0,0,0,0,0,0,0
"Sri Lanka","2024-04-17",0,0,0,0,0,0,0,0
"Sri Lanka","2024-04-18",0,0,0,0,0,0,0,0
"Sri Lanka","2024-04-19",0,0,0,0,0,0,0,0
"Sri Lanka","2024-04-20",0,0,0,0,0,0,0,0
"Sri Lanka","2024-04-21",0,0,0,0,0,0,0,0
"Sri Lanka","2024-04-22",0,0,0,0,0,0,0,0
"Sri Lanka","2024-04-23",0,0,0,0,0,0,0,0
"Sri Lanka","2024-04-24",0,0,0,0,0,0,0,0
"Sri Lanka","2024-04-25",0,0,0,0,0,0,0,0
"Sri Lanka","2024-04-26",0,0,0,0,0,0,0,0
"Sri Lanka","2024-04-27",0,0,0,0,0,0,0,0
"Sri Lanka","2024-04-28",0,0,0,0,0,0,0,0
"Sri Lanka","2024-04-29",0,0,0,0,0,0,0,0
"Sri Lanka","2024-04-30",0,0,0,0,0,0,0,0
"Sri Lanka","2024-05-01",0,0,0,0,0,0,0,0
"Sri Lanka","2024-05-02",0,0,0,0,0,0,0,0
"Sri Lanka","2024-05-03",0,0,0,0,0,0,0,0
"Sri Lanka","2024-05-04",0,0,0,0,0,0,0,0
"Sri Lanka","2024-05-05",0,0,0,0,0,0,0,0
"Sri Lanka","2024-05-06",0,0,0,0,0,0,0,0
"Sri Lanka","2024-05-07",0,0,0,0,0,0,0,0
"Sri Lanka","2024-05-08",0,0,0,0,0,0,0,0
"Sri Lanka","2024-05-09",0,0,0,0,0,0,0,0
"Sri Lanka","2024-05-10",0,0,0,0,0,0,0,0
"Sri Lanka","2024-05-11",0,0,0,0,0,0,0,0
"Sri Lanka","2024-05-12",0,0,0,0,0,0,0,0
"Sri Lanka","2024-05-13",0,0,0,0,0,0,0,0
"Sri Lanka","2024-05-14",0,0,0,0,0,0,0,0
"Sri Lanka","2024-05-15",0,0,0,0,0,0,0,0
"Sri Lanka","2024-05-16",0,0,0,0,0,0,0,0
"Sri Lanka","2024-05-17",0,0,0,0,0,0,0,0
"Sri Lanka","2024-05-18",0,0,0,0,0,0,0,0
"Sri Lanka","2024-05-19",0,0,0,0,0,0,0,0
"Sri Lanka","2024-05-20",0,0,0,0,0,0,0,0
"Sri Lanka","2024-05-21",0,0,0,0,0,0,0,0
"Sri Lanka","2024-05-22",0,0,0,0,0,0,0,0
"Sri Lanka","2024-05-23",0,0,0,0,0,0,0,0
"Sri Lanka","2024-05-24",0,0,0,0,0,0,0,0
"Sri Lanka","2024-05-25",0,0,0,0,0,0,0,0
"Sri Lanka","2024-05-26",0,0,0,0,0,0,0,0
"Sri Lanka","2024-05-27",0,0,0,0,0,0,0,0
"Sri Lanka","2024-05-28",0,0,0,0,0,0,0,0
"Sri Lanka","2024-05-29",0,0,0,0,0,0,0,0
"Sri Lanka","2024-05-30",0,0,0,0,0,0,0,0
"Sri Lanka","2024-05-31",0,0,0,0,0,0,0,0
"Sri Lanka","2024-06-01",0,0,0,0,0,0,0,0
"Sri Lanka","2024-06-02",0,0,0,0,0,0,0,0
"Sri Lanka","2024-06-03",0,0,0,0,0,0,0,0
"Sri Lanka","2024-06-04",0,0,0,0,0,0,0,0
"Sri Lanka","2024-06-05",0,0,0,0,0,0,0,0
"Sri Lanka","2024-06-06",0,0,0,0,0,0,0,0
"Sri Lanka","2024-06-07",0,0,0,0,0,0,0,0
"Sri Lanka","2024-06-08",0,0,0,0,0,0,0,0
"Sri Lanka","2024-06-09",0,0,0,0,0,0,0,0
"Sri Lanka","2024-06-10",0,0,0,0,0,0,0,0
"Sri Lanka","2024-06-11",0,0,0,0,0,0,0,0
"Sri Lanka","2024-06-12",0,0,0,0,0,0,0,0
"Sri Lanka","2024-06-13",0,0,0,0,0,0,0,0
"Sri Lanka","2024-06-14",0,0,0,0,0,0,0,0
"Sri Lanka","2024-06-15",0,0,0,0,0,0,0,0
"Sri Lanka","2024-06-16",0,0,0,0,0,0,0,0
"Sri Lanka","2024-06-17",0,0,0,0,0,0,0,0
"Sri Lanka","2024-06-18",0,0,0,0,0,0,0,0
"Sri Lanka","2024-06-19",0,0,0,0,0,0,0,0
"Sri Lanka","2024-06-20",0,0,0,0,0,0,0,0
"Sri Lanka","2024-06-21",0,0,0,0,0,0,0,0
"Sri Lanka","2024-06-22",0,0,0,0,0,0,0,0
"Sri Lanka","2024-06-23",0,0,0,0,0,0,0,0
"Sri Lanka","2024-06-24",0,0,0,0,0,0,0,0
"Sri Lanka","2024-06-25",0,0,0,0,0,0,0,0
"Sri Lanka","2024-06-26",0,0,0,0,0,0,0,0
"Sri Lanka","2024-06-27",0,0,0,0,0,0,0,0
"Sri Lanka","2024-06-28",0,0,0,0,0,0,0,0
"Sri Lanka","2024-06-29",0,0,0,0,0,0,0,0
"Sri Lanka","2024-06-30",0,0,0,0,0,0,0,0
"Sri Lanka","2024-07-01",0,0,0,0,0,0,0,0
"Sri Lanka","2024-07-02",0,0,0,0,0,0,0,0
"Sri Lanka","2024-07-03",0,0,0,0,0,0,0,0
"Sri Lanka","2024-07-04",0,0,0,0,0,0,0,0
"Sri Lanka","2024-07-05",0,0,0,0,0,0,0,0
"Sri Lanka","2024-07-06",0,0,0,0,0,0,0,0
"Sri Lanka","2024-07-07",0,0,0,0,0,0,0,0
"Sri Lanka","2024-07-08",0,0,0,0,0,0,0,0
"Sri Lanka","2024-07-09",0,0,0,0,0,0,0,0
"Sri Lanka","2024-07-10",0,0,0,0,0,0,0,0
"Sri Lanka","2024-07-11",0,0,0,0,0,0,0,0
"Sri Lanka","2024-07-12",0,0,0,0,0,0,0,0
"Sri Lanka","2024-07-13",0,0,0,0,0,0,0,0
"Sri Lanka","2024-07-14",0,0,0,0,0,0,0,0
"Sri Lanka","2024-07-15",0,0,0,0,0,0,0,0
"Sri Lanka","2024-07-16",0,0,0,0,0,0,0,0
"Sri Lanka","2024-07-17",0,0,0,0,0,0,0,0
"Sri Lanka","2024-07-18",0,0,0,0,0,0,0,0
"Sri Lanka","2024-07-19",0,0,0,0,0,0,0,0
"Sri Lanka","2024-07-20",0,0,0,0,0,0,0,0
"Sri Lanka","2024-07-21",0,0,0,0,0,0,0,0
"Sri Lanka","2024-07-22",0,0,0,0,0,0,0,0
"Sri Lanka","2024-07-23",0,0,0,0,0,0,0,0
"Sri Lanka","2024-07-24",0,0,0,0,0,0,0,0
"Sri Lanka","2024-07-25",0,0,0,0,0,0,0,0
"Sri Lanka","2024-07-26",0,0,0,0,0,0,0,0
"Sri Lanka","2024-07-27",0,0,0,0,0,0,0,0
"Sri Lanka","2024-07-28",0,0,0,0,0,0,0,0
"Sri Lanka","2024-07-29",0,0,0,0,0,0,0,0
"Sri Lanka","2024-07-30",0,0,0,0,0,0,0,0
"Sri Lanka","2024-07-31",0,0,0,0,0,0,0,0
"Sri Lanka","2024-08-01",0,0,0,0,0,0,0,0
"Sri Lanka","2024-08-02",0,0,0,0,0,0,0,0
"Sri Lanka","2024-08-03",0,0,0,0,0,0,0,0
"Sri Lanka","2024-08-04",0,0,0,0,0,0,0,0
"Sri Lanka","2024-08-05",0,0,0,0,0,0,0,0
"Sri Lanka","2024-08-06",0,0,0,0,0,0,0,0
"Sri Lanka","2024-08-07",0,0,0,0,0,0,0,0
"Sri Lanka","2024-08-08",0,0,0,0,0,0,0,0
"Sri Lanka","2024-08-09",0,0,0,0,0,0,0,0
"Sri Lanka","2024-08-10",0,0,0,0,0,0,0,0
"Sri Lanka","2024-08-11",0,0,0,0,0,0,0,0
"Sri Lanka","2024-08-12",0,0,0,0,0,0,0,0
"Sri Lanka","2024-08-13",0,0,0,0,0,0,0,0
"Sri Lanka","2024-08-14",0,0,0,0,0,0,0,0
"Sri Lanka","2024-08-15",0,0,0,0,0,0,0,0
"Sri Lanka","2024-08-16",0,0,0,0,0,0,0,0
"Sri Lanka","2024-08-17",0,0,0,0,0,0,0,0
"Sri Lanka","2024-08-18",0,0,0,0,0,0,0,0
"Sri Lanka","2024-08-19",0,0,0,0,0,0,0,0
"Sri Lanka","2024-08-20",0,0,0,0,0,0,0,0
"Sri Lanka","2024-08-21",0,0,0,0,0,0,0,0
"Sri Lanka","2024-08-22",0,0,0,0,0,0,0,0
"Sri Lanka","2024-08-23",0,0,0,0,0,0,0,0
"Sri Lanka","2024-08-24",0,0,0,0,0,0,0,0
"Sri Lanka","2024-08-25",0,0,0,0,0,0,0,0
"Sri Lanka","2024-08-26",0,0,0,0,0,0,0,0
"Sri Lanka","2024-08-27",0,0,0,0,0,0,0,0
"Sri Lanka","2024-08-28",0,0,0,0,0,0,0,0
"Sri Lanka","2024-08-29",0,0,0,0,0,0,0,0
"Sri Lanka","2024-08-30",0,0,0,0,0,0,0,0
"Sri Lanka","2024-08-31",0,0,0,0,0,0,0,0
"Sri Lanka","2024-09-01",0,0,0,0,0,0,0,0
"Sri Lanka","2024-09-02",0,0,0,0,0,0,0,0
"Sri Lanka","2024-09-03",0,0,0,0,0,0,0,0
"Sri Lanka","2024-09-04",0,0,0,0,0,0,0,0
"Sri Lanka","2024-09-05",0,0,0,0,0,0,0,0
"Sri Lanka","2024-09-06",0,0,0,0,0,0,0,0
"Sri Lanka","2024-09-07",0,0,0,0,0,0,0,0
"Sri Lanka","2024-09-08",0,0,0,0,0,0,0,0
"Sri Lanka","2024-09-09",0,0,0,0,0,0,0,0
"Sri Lanka","2024-09-10",0,0,0,0,0,0,0,0
"Sri Lanka","2024-09-11",0,0,0,0,0,0,0,0
"Sri Lanka","2024-09-12",0,0,0,0,0,0,0,0
"Sri Lanka","2024-09-13",0,0,0,0,0,0,0,0
"Sri Lanka","2024-09-14",0,0,0,0,0,0,0,0
"Sri Lanka","2024-09-15",0,0,0,0,0,0,0,0
"Sri Lanka","2024-09-16",0,0,0,0,0,0,0,0
"Sri Lanka","2024-09-17",0,0,0,0,0,0,0,0
"Sri Lanka","2024-09-18",0,0,0,0,0,0,0,0
"Sri Lanka","2024-09-19",0,0,0,0,0,0,0,0
"Sri Lanka","2024-09-20",0,0,0,0,0,0,0,0
"Sri Lanka","2024-09-21",0,0,0,0,0,0,0,0
"Sri Lanka","2024-09-22",0,0,0,0,0,0,0,0
"Sri Lanka","2024-09-23",0,0,0,0,0,0,0,0
"Sri Lanka","2024-09-24",0,0,0,0,0,0,0,0
"Sri Lanka","2024-09-25",0,0,0,0,0,0,0,0
"Sri Lanka","2024-09-26",0,0,0,0,0,0,0,0
"Sri Lanka","2024-09-27",0,0,0,0,0,0,0,0
"Sri Lanka","2024-09-28",0,0,0,0,0,0,0,0
"Sri Lanka","2024-09-29",0,0,0,0,0,0,0,0
"Sri Lanka","2024-09-30",0,0,0,0,0,0,0,0
"Sri Lanka","2024-10-01",0,0,0,0,0,0,0,0
"Sri Lanka","2024-10-02",0,0,0,0,0,0,0,0
"Sri Lanka","2024-10-03",0,0,0,0,0,0,0,0
"Sri Lanka","2024-10-04",0,0,0,0,0,0,0,0
"Sri Lanka","2024-10-05",0,0,0,0,0,0,0,0
"Sri Lanka","2024-10-06",0,0,0,0,0,0,0,0
"Sri Lanka","2024-10-07",0,0,0,0,0,0,0,0
"Sri Lanka","2024-10-08",0,0,0,0,0,0,0,0
"Sri Lanka","2024-10-09",0,0,0,0,0,0,0,0
"Sri Lanka","2024-10-10",0,0,0,0,0,0,0,0
"Sri Lanka","2024-10-11",0,0,0,0,0,0,0,0
"Sri Lanka","2024-10-12",0,0,0,0,0,0,0,0
"Sri Lanka","2024-10-13",0,0,0,0,0,0,0,0
"Sri Lanka","2024-10-14",0,0,0,0,0,0,0,0
"Sri Lanka","2024-10-15",0,0,0,0,0,0,0,0
"Sri Lanka","2024-10-16",0,0,0,0,0,0,0,0
"Sri Lanka","2024-10-17",0,0,0,0,0,0,0,0
"Sri Lanka","2024-10-18",0,0,0,0,0,0,0,0
"Sri Lanka","2024-10-19",0,0,0,0,0,0,0,0
"Sri Lanka","2024-10-20",0,0,0,0,0,0,0,0
"Sri Lanka","2024-10-21",0,0,0,0,0,0,0,0
"Sri Lanka","2024-10-22",0,0,0,0,0,0,0,0
"Sri Lanka","2024-10-23",0,0,0,0,0,0,0,0
"Sri Lanka","2024-10-24",0,0,0,0,0,0,0,0
"Sri Lanka","2024-10-25",0,0,0,0,0,0,0,0
"Sri Lanka","2024-10-26",0,0,0,0,0,0,0,0
"Sri Lanka","2024-10-27",0,0,0,0,0,0,0,0
"Sri Lanka","2024-10-28",0,0,0,0,0,0,0,0
"Sri Lanka","2024-10-29",0,0,0,0,0,0,0,0
"Sri Lanka","2024-10-30",0,0,0,0,0,0,0,0
"Sri Lanka","2024-10-31",0,0,0,0,0,0,0,0
"Sri Lanka","2024-11-01",0,0,0,0,0,0,0,0
"Sri Lanka","2024-11-02",0,0,0,0,0,0,0,0
"Sri Lanka","2024-11-03",0,0,0,0,0,0,0,0
"Sri Lanka","2024-11-04",0,0,0,0,0,0,0,0
"Sri Lanka","2024-11-05",0,0,0,0,0,0,0,0
"Sri Lanka","2024-11-06",0,0,0,0,0,0,0,0
"Sri Lanka","2024-11-07",0,0,0,0,0,0,0,0
"Sri Lanka","2024-11-08",0,0,0,0,0,0,0,0
"Sri Lanka","2024-11-09",0,0,0,0,0,0,0,0
"Sri Lanka","2024-11-10",0,0,0,0,0,0,0,0
"Sri Lanka","2024-11-11",0,0,0,0,0,0,0,0
"Sri Lanka","2024-11-12",0,0,0,0,0,0,0,0
"Sri Lanka","2024-11-13",0,0,0,0,0,0,0,0
"Sri Lanka","2024-11-14",0,0,0,0,0,0,0,0
"Sri Lanka","2024-11-15",0,0,0,0,0,0,0,0
"Sri Lanka","2024-11-16",0,0,0,0,0,0,0,0
"Sri Lanka","2024-11-17",0,0,0,0,0,0,0,0
"Sri Lanka","2024-11-18",0,0,0,0,0,0,0,0
"Sri Lanka","2024-11-19",0,0,0,0,0,0,0,0
"Sri Lanka","2024-11-20",0,0,0,0,0,0,0,0
"Sri Lanka","2024-11-21",0,0,0,0,0,0,0,0
"Sri Lanka","2024-11-22",0,0,0,0,0,0,0,0
"Sri Lanka","2024-11-23",0,0,0,0,0,0,0,0
"Sri Lanka","2024-11-24",0,0,0,0,0,0,0,0
"Sri Lanka","2024-11-25",0,0,0,0,0,0,0,0
"Sri Lanka","2024-11-26",0,0,0,0,0,0,0,0
"Sri Lanka","2024-11-27",0,0,0,0,0,0,0,0
"Sri Lanka","2024-11-28",0,0,0,0,0,0,0,0
"Sri Lanka","2024-11-29",0,0,0,0,0,0,0,0
"Sri Lanka","2024-11-30",0,0,0,0,0,0,0,0
"Sri Lanka","2024-12-01",0,0,0,0,0,0,0,0
"Sri Lanka","2024-12-02",0,0,0,0,0,0,0,0
"Sri Lanka","2024-12-03",0,0,0,0,0,0,0,0
"Sri Lanka","2024-12-04",0,0,0,0,0,0,0,0
"Sri Lanka","2024-12-05",0,0,0,0,0,0,0,0
"Sri Lanka","2024-12-06",0,0,0,0,0,0,0,0
"Sri Lanka","2024-12-07",0,0,0,0,0,0,0,0
"Sri Lanka","2024-12-08",0,0,0,0,0,0,0,0
"Sri Lanka","2024-12-09",0,0,0,0,0,0,0,0
"Sri Lanka","2024-12-10",0,0,0,0,0,0,0,0
"Sri Lanka","2024-12-11",0,0,0,0,0,0,0,0
"Sri Lanka","2024-12-12",0,0,0,0,0,0,0,0
"Sri Lanka","2024-12-13",0,0,0,0,0,0,0,0
"Sri Lanka","2024-12-14",0,0,0,0,0,0,0,0
"Sri Lanka","2024-12-15",0,0,0,0,0,0,0,0
"Sri Lanka","2024-12-16",0,0,0,0,0,0,0,0
"Sri Lanka","2024-12-17",0,0,0,0,0,0,0,0
"Sri Lanka","2024-12-18",0,0,0,0,0,0,0,0
"Sri Lanka","2024-12-19",0,0,0,0,0,0,0,0
"Sri Lanka","2024-12-20",0,0,0,0,0,0,0,0
"Sri Lanka","2024-12-21",0,0,0,0,0,0,0,0
"Sri Lanka","2024-12-22",0,0,0,0,0,0,0,0
"Sri Lanka","2024-12-23",0,0,0,0,0,0,0,0
"Sri Lanka","2024-12-24",0,0,0,0,0,0,0,0
"Sri Lanka","2024-12-25",0,0,0,0,0,0,0,0
"Sri Lanka","2024-12-26",0,0,0,0,0,0,0,0
"Sri Lanka","2024-12-27",0,0,0,0,0,0,0,0
"Sri Lanka","2024-12-28",0,0,0,0,0,0,0,0
"Sri Lanka","2024-12-29",0,0,0,0,0,0,0,0
"Sri Lanka","2024-12-30",0,0,0,0,0,0,0,0
"Sri Lanka","2024-12-31",0,0,0,0,0,0,0,0
"Sri Lanka","2025-01-01",0,0,0,0,0,0,0,0
"Sri Lanka","2025-01-02",0,0,0,0,0,0,0,0
"Sri Lanka","2025-01-03",0,0,0,0,0,0,0,0
"Sri Lanka","2025-01-04",0,0,0,0,0,0,0,0
"Sri Lanka","2025-01-05",0,0,0,0,0,0,0,0
"Sri Lanka","2025-01-06",0,0,0,0,0,0,0,0
"Sri Lanka","2025-01-07",0,0,0,0,0,0,0,0
"Sri Lanka","2025-01-08",0,0,0,0,0,0,0,0
"Sri Lanka","2025-01-09",0,0,0,0,0,0,0,0
"Sri Lanka","2025-01-10",0,0,0,0,0,0,0,0
"Sri Lanka","2025-01-11",0,0,0,0,0,0,0,0
"Sri Lanka","2025-01-12",0,0,0,0,0,0,0,0
"Sri Lanka","2025-01-13",0,0,0,0,0,0,0,0
"Sweden","2024-01-01",0,0,0,0,0,0,0,0
"Sweden","2024-01-02",0,0,0,0,0,0,0,0
"Sweden","2024-01-03",0,0,0,0,0,0,0,0
"Sweden","2024-01-04",0,0,0,0,0,0,0,0
"Sweden","2024-01-05",0,0,0,0,0,0,0,0
"Sweden","2024-01-06",0,0,0,0,0,0,0,0
"Sweden","2024-01-07",0,0,0,0,0,0,0,0
"Sweden","2024-01-08",0,0,0,0,0,0,0,0
"Sweden","2024-01-09",0,0,0,0,0,0,0,0
"Sweden","2024-01-10",0,0,0,0,0,0,0,0
"Sweden","2024-01-11",0,0,0,0,0,0,0,0
"Sweden","2024-01-12",0,0,0,0,0,0,0,0
"Sweden","2024-01-13",0,0,0,0,0,0,0,0
"Sweden","2024-01-14",0,0,0,0,0,0,0,0
"Sweden","2024-01-15",0,0,0,0,0,0,0,0
"Sweden","2024-01-16",0,0,0,0,0,0,0,0
"Sweden","2024-01-17",0,0,0,0,0,0,0,0
"Sweden","2024-01-18",0,0,0,0,0,0,0,0
"Sweden","2024-01-19",0,0,0,0,0,0,0,0
"Sweden","2024-01-20",0,0,0,0,0,0,0,0
"Sweden","2024-01-21",0,0,0,0,0,0,0,0
"Sweden","2024-01-22",0,0,0,0,0,0,0,0
"Sweden","2024-01-23",0,0,0,0,0,0,0,0
"Sweden","2024-01-24",0,0,0,0,0,0,0,0
"Sweden","2024-01-25",0,0,0,0,0,0,0,0
"Sweden","2024-01-26",0,0,0,0,0,0,0,0
"Sweden","2024-01-27",0,0,0,0,0,0,0,0
"Sweden","2024-01-28",0,0,0,0,0,0,0,0
"Sweden","2024-01-29",0,0,0,0,0,0,0,0
"Sweden","2024-01-30",0,0,0,0,0,0,0,0
"Sweden","2024-01-31",0,3,3,0,3,3,0,0
"Sweden","2024-02-01",0,0,3,0,0,3,0,0
"Sweden","2024-02-02",0,0,3,0,0,3,0,0
"Sweden","2024-02-03",0,0,3,0,0,3,0,0
"Sweden","2024-02-04",0,0,3,0,0,3,0,0
"Sweden","2024-02-05",0,0,3,0,0,3,0,0
"Sweden","2024-02-06",0,0,3,0,0,3,0,0
"Sweden","2024-02-07",0,0,3,0,0,3,0,0
"Sweden","2024-02-08",0,0,3,0,1,4,0,0
"Sweden","2024-02-09",0,0,3,0,0,4,0,0
"Sweden","2024-02-10",0,0,3,0,0,4,0,0
"Sweden","2024-02-11",0,0,3,0,0,4,0,0
"Sweden","2024-02-12",0,0,3,0,0,4,0,0
"Sweden","2024-02-13",0,0,3,0,0,4,0,0
"Sweden","2024-02-14",0,0,3,0,0,4,0,0
"Sweden","2024-02-15",0,0,3,0,0,4,0,0
"Sweden","2024-02-16",0,0,3,0,0,4,0,0
"Sweden","2024-02-17",0,0,3,0,0,4,0,0
"Sweden","2024-02-18",0,0,3,0,0,4,0,0
"Sweden","2024-02-19",0,0,3,0,0,4,0,0
"Sweden","2024-02-20",0,0,3,0,0,4,0,0
"Sweden","2024-02-21",0,0,3,0,0,4,0,0
"Sweden","2024-02-22",0,0,3,0,1,5,0,0
"Sweden","2024-02-23",0,0,3,0,0,5,0,0
"Sweden","2024-02-24",0,0,3,0,0,5,0,0
"Sweden","2024-02-25",0,0,3,0,0,5,0,0
"Sweden","2024-02-26",0,0,3,0,0,5,0,0
"Sweden","2024-02-27",0,0,3,0,0,5,0,0
"Sweden","2024-02-28",0,0,3,0,0,5,0,0
"Sweden","2024-02-29",0,2,5,0,0,5,0,0
"Sweden","2024-03-01",0,0,5,0,0,5,0,0
"Sweden","2024-03-02",0,0,5,0,0,5,0,0
"Sweden","2024-03-03",0,0,5,0,1,6,0,0
"Sweden","2024-03-04",0,0,5,0,0,6,0,0
"Sweden","2024-03-05",0,0,5,0,0,6,0,0
"Sweden","2024-03-06",0,0,5,0,0,6,0,0
"Sweden","2024-03-07",0,0,5,0,1,7,0,0
"Sweden","2024-03-08",0,0,5,0,0,7,0,0
"Sweden","2024-03-09",0,0,5,0,0,7,0,0
"Sweden","2024-03-10",0,0,5,0,0,7,0,0
"Sweden","2024-03-11",0,0,5,0,1,8,0,0
"Sweden","2024-03-12",0,0,5,0,0,8,0,0
"Sweden","2024-03-13",0,0,5,0,0,8,0,0
"Sweden","2024-03-14",0,0,5,0,0,8,0,0
"Sweden","2024-03-15",0,0,5,0,0,8,0,0
"Sweden","2024-03-16",0,0,5,0,1,9,0,0
"Sweden","2024-03-17",0,0,5,0,0,9,0,0
"Sweden","2024-03-18",0,0,5,0,0,9,0,0
"Sweden","2024-03-19",0,0,5,0,0,9,0,0
"Sweden","2024-03-20",0,0,5,0,1,10,0,0
"Sweden","2024-03-21",0,0,5,0,0,10,0,0
"Sweden","2024-03-22",0,0,5,0,0,10,0,0
"Sweden","2024-03-23",0,0,5,0,0,10,0,0
"Sweden","2024-03-24",0,0,5,0,1,11,0,0
"Sweden","2024-03-25",0,0,5,0,0,11,0,0
"Sweden","2024-03-26",0,0,5,0,0,11,0,0
"Sweden","2024-03-27",0,0,5,0,0,11,0,0
"Sweden","2024-03-28",0,0,5,0,0,11,0,0
"Sweden","2024-03-29",0,0,5,0,1,12,0,0
"Sweden","2024-03-30",0,0,5,0,0,12,0,0
"Sweden","2024-03-31",0,0,5,0,0,12,0,0
"Sweden","2024-04-01",0,0,5,0,0,12,0,0
"Sweden","2024-04-02",0,0,5,0,1,13,0,0
"Sweden","2024-04-03",0,0,5,0,0,13,0,0
"Sweden","2024-04-04",0,0,5,0,0,13,0,0
"Sweden","2024-04-05",0,0,5,0,0,13,0,0
"Sweden","2024-04-06",0,0,5,0,0,13,0,0
"Sweden","2024-04-07",0,0,5,0,1,14,0,0
"Sweden","2024-04-08",0,0,5,0,0,14,0,0
"Sweden","2024-04-09",0,0,5,0,0,14,0,0
"Sweden","2024-04-10",0,0,5,0,0,14,0,0
"Sweden","2024-04-11",0,0,5,0,1,15,0,0
"Sweden","2024-04-12",0,0,5,0,0,15,0,0
"Sweden","2024-04-13",0,0,5,0,0,15,0,0
"Sweden","2024-04-14",0,0,5,0,0,15,0,0
"Sweden","2024-04-15",0,0,5,0,1,16,0,0
"Sweden","2024-04-16",0,0,5,0,0,16,0,0
"Sweden","2024-04-17",0,0,5,0,0,16,0,0
"Sweden","2024-04-18",0,0,5,0,0,16,0,0
"Sweden","2024-04-19",0,0,5,0,0,16,0,0
"Sweden","2024-04-20",0,0,5,0,1,17,0,0
"Sweden","2024-04-21",0,0,5,0,0,17,0,0
"Sweden","2024-04-22",0,0,5,0,0,17,0,0
"Sweden","2024-04-23",0,0,5,0,0,17,0,0
"Sweden","2024-04-24",0,0,5,0,1,18,0,0
"Sweden","2024-04-25",0,0,5,0,0,18,0,0
"Sweden","2024-04-26",0,0,5,0,0,18,0,0
"Sweden","2024-04-27",0,0,5,0,0,18,0,0
"Sweden","2024-04-28",0,0,5,0,1,19,0,0
"Sweden","2024-04-29",0,0,5,0,0,19,0,0
"Sweden","2024-04-30",0,14,19,0,0,19,0,0
"Sweden","2024-05-01",0,0,19,0,0,19,0,0
"Sweden","2024-05-02",0,0,19,0,1,20,0,0
"Sweden","2024-05-03",0,0,19,0,0,20,0,0
"Sweden","2024-05-04",0,0,19,0,0,20,0,0
"Sweden","2024-05-05",0,0,19,0,1,21,0,0
"Sweden","2024-05-06",0,0,19,0,0,21,0,0
"Sweden","2024-05-07",0,0,19,0,0,21,0,0
"Sweden","2024-05-08",0,0,19,0,1,22,0,0
"Sweden","2024-05-09",0,0,19,0,0,22,0,0
"Sweden","2024-05-10",0,0,19,0,1,23,0,0
"Sweden","2024-05-11",0,0,19,0,0,23,0,0
"Sweden","2024-05-12",0,0,19,0,0,23,0,0
"Sweden","2024-05-13",0,0,19,0,1,24,0,0
"Sweden","2024-05-14",0,0,19,0,0,24,0,0
"Sweden","2024-05-15",0,0,19,0,0,24,0,0
"Sweden","2024-05-16",0,0,19,0,1,25,0,0
"Sweden","2024-05-17",0,0,19,0,0,25,0,0
"Sweden","2024-05-18",0,0,19,0,0,25,0,0
"Sweden","2024-05-19",0,0,19,0,1,26,0,0
"Sweden","2024-05-20",0,0,19,0,0,26,0,0
"Sweden","2024-05-21",0,0,19,0,0,26,0,0
"Sweden","2024-05-22",0,0,19,0,1,27,0,0
"Sweden","2024-05-23",0,0,19,0,0,27,0,0
"Sweden","2024-05-24",0,0,19,0,1,28,0,0
"Sweden","2024-05-25",0,0,19,0,0,28,0,0
"Sweden","2024-05-26",0,0,19,0,0,28,0,0
"Sweden","2024-05-27",0,0,19,0,1,29,0,0
"Sweden","2024-05-28",0,0,19,0,0,29,0,0
"Sweden","2024-05-29",0,0,19,0,0,29,0,0
"Sweden","2024-05-30",0,0,19,0,1,30,0,0
"Sweden","2024-05-31",0,11,30,0,0,30,0,0
"Sweden","2024-06-01",0,0,30,0,0,30,0,0
"Sweden","2024-06-02",0,0,30,0,0,30,0,0
"Sweden","2024-06-03",0,0,30,0,0,30,0,0
"Sweden","2024-06-04",0,0,30,0,0,30,0,0
"Sweden","2024-06-05",0,0,30,0,0,30,0,0
"Sweden","2024-06-06",0,0,30,0,0,30,0,0
"Sweden","2024-06-07",0,0,30,0,0,30,0,0
"Sweden","2024-06-08",0,0,30,0,1,31,0,0
"Sweden","2024-06-09",0,0,30,0,0,31,0,0
"Sweden","2024-06-10",0,0,30,0,0,31,0,0
"Sweden","2024-06-11",0,0,30,0,0,31,0,0
"Sweden","2024-06-12",0,0,30,0,0,31,0,0
"Sweden","2024-06-13",0,0,30,0,0,31,0,0
"Sweden","2024-06-14",0,0,30,0,0,31,0,0
"Sweden","2024-06-15",0,0,30,0,0,31,0,0
"Sweden","2024-06-16",0,0,30,0,0,31,0,0
"Sweden","2024-06-17",0,0,30,0,0,31,0,0
"Sweden","2024-06-18",0,0,30,0,0,31,0,0
"Sweden","2024-06-19",0,0,30,0,0,31,0,0
"Sweden","2024-06-20",0,0,30,0,0,31,0,0
"Sweden","2024-06-21",0,0,30,0,0,31,0,0
"Sweden","2024-06-22",0,0,30,0,0,31,0,0
"Sweden","2024-06-23",0,0,30,0,1,32,0,0
"Sweden","2024-06-24",0,0,30,0,0,32,0,0
"Sweden","2024-06-25",0,0,30,0,0,32,0,0
"Sweden","2024-06-26",0,0,30,0,0,32,0,0
"Sweden","2024-06-27",0,0,30,0,0,32,0,0
"Sweden","2024-06-28",0,0,30,0,0,32,0,0
"Sweden","2024-06-29",0,0,30,0,0,32,0,0
"Sweden","2024-06-30",0,2,32,0,0,32,0,0
"Sweden","2024-07-01",0,0,32,0,0,32,0,0
"Sweden","2024-07-02",0,0,32,0,0,32,0,0
"Sweden","2024-07-03",0,0,32,0,0,32,0,0
"Sweden","2024-07-04",0,0,32,0,0,32,0,0
"Sweden","2024-07-05",0,0,32,0,0,32,0,0
"Sweden","2024-07-06",0,0,32,0,0,32,0,0
"Sweden","2024-07-07",0,0,32,0,0,32,0,0
"Sweden","2024-07-08",0,0,32,0,0,32,0,0
"Sweden","2024-07-09",0,0,32,0,0,32,0,0
"Sweden","2024-07-10",0,0,32,0,0,32,0,0
"Sweden","2024-07-11",0,0,32,0,0,32,0,0
"Sweden","2024-07-12",0,0,32,0,0,32,0,0
"Sweden","2024-07-13",0,0,32,0,0,32,0,0
"Sweden","2024-07-14",0,0,32,0,0,32,0,0
"Sweden","2024-07-15",0,0,32,0,0,32,0,0
"Sweden","2024-07-16",0,0,32,0,1,33,0,0
"Sweden","2024-07-17",0,0,32,0,0,33,0,0
"Sweden","2024-07-18",0,0,32,0,0,33,0,0
"Sweden","2024-07-19",0,0,32,0,0,33,0,0
"Sweden","2024-07-20",0,0,32,0,0,33,0,0
"Sweden","2024-07-21",0,0,32,0,0,33,0,0
"Sweden","2024-07-22",0,0,32,0,0,33,0,0
"Sweden","2024-07-23",0,0,32,0,0,33,0,0
"Sweden","2024-07-24",0,0,32,0,0,33,0,0
"Sweden","2024-07-25",0,0,32,0,0,33,0,0
"Sweden","2024-07-26",0,0,32,0,0,33,0,0
"Sweden","2024-07-27",0,0,32,0,0,33,0,0
"Sweden","2024-07-28",0,0,32,0,0,33,0,0
"Sweden","2024-07-29",0,0,32,0,0,33,0,0
"Sweden","2024-07-30",0,0,32,0,0,33,0,0
"Sweden","2024-07-31",0,1,33,0,0,33,0,0
"Sweden","2024-08-01",0,0,33,0,0,33,0,0
"Sweden","2024-08-02",0,0,33,0,0,33,0,0
"Sweden","2024-08-03",0,0,33,0,0,33,0,0
"Sweden","2024-08-04",0,0,33,0,0,33,0,0
"Sweden","2024-08-05",0,0,33,0,0,33,0,0
"Sweden","2024-08-06",0,0,33,0,0,33,0,0
"Sweden","2024-08-07",0,0,33,0,0,33,0,0
"Sweden","2024-08-08",0,0,33,0,1,34,0,0
"Sweden","2024-08-09",0,0,33,0,0,34,0,0
"Sweden","2024-08-10",0,0,33,0,0,34,0,0
"Sweden","2024-08-11",0,0,33,0,0,34,0,0
"Sweden","2024-08-12",0,0,33,0,0,34,0,0
"Sweden","2024-08-13",0,0,33,0,0,34,0,0
"Sweden","2024-08-14",0,0,33,0,0,34,0,0
"Sweden","2024-08-15",0,0,33,0,0,34,0,0
"Sweden","2024-08-16",0,0,33,0,0,34,0,0
"Sweden","2024-08-17",0,0,33,0,0,34,0,0
"Sweden","2024-08-18",0,0,33,0,0,34,0,0
"Sweden","2024-08-19",0,0,33,0,0,34,0,0
"Sweden","2024-08-20",0,0,33,0,0,34,0,0
"Sweden","2024-08-21",0,0,33,0,0,34,0,0
"Sweden","2024-08-22",0,0,33,0,0,34,0,0
"Sweden","2024-08-23",0,0,33,0,0,34,0,0
"Sweden","2024-08-24",0,0,33,0,1,35,0,0
"Sweden","2024-08-25",0,0,33,0,0,35,0,0
"Sweden","2024-08-26",0,0,33,0,0,35,0,0
"Sweden","2024-08-27",0,0,33,0,0,35,0,0
"Sweden","2024-08-28",0,0,33,0,0,35,0,0
"Sweden","2024-08-29",0,0,33,0,0,35,0,0
"Sweden","2024-08-30",0,0,33,0,0,35,0,0
"Sweden","2024-08-31",0,2,35,0,0,35,0,0
"Sweden","2024-09-01",0,0,35,0,0,35,0,0
"Sweden","2024-09-02",0,0,35,0,0,35,0,0
"Sweden","2024-09-03",0,0,35,0,0,35,0,0
"Sweden","2024-09-04",0,0,35,0,0,35,0,0
"Sweden","2024-09-05",0,0,35,0,0,35,0,0
"Sweden","2024-09-06",0,0,35,0,0,35,0,0
"Sweden","2024-09-07",0,0,35,0,0,35,0,0
"Sweden","2024-09-08",0,0,35,0,0,35,0,0
"Sweden","2024-09-09",0,0,35,0,0,35,0,0
"Sweden","2024-09-10",0,0,35,0,0,35,0,0
"Sweden","2024-09-11",0,0,35,0,1,36,0,0
"Sweden","2024-09-12",0,0,35,0,0,36,0,0
"Sweden","2024-09-13",0,0,35,0,0,36,0,0
"Sweden","2024-09-14",0,0,35,0,0,36,0,0
"Sweden","2024-09-15",0,0,35,0,0,36,0,0
"Sweden","2024-09-16",0,0,35,0,0,36,0,0
"Sweden","2024-09-17",0,0,35,0,0,36,0,0
"Sweden","2024-09-18",0,0,35,0,0,36,0,0
"Sweden","2024-09-19",0,0,35,0,0,36,0,0
"Sweden","2024-09-20",0,0,35,0,0,36,0,0
"Sweden","2024-09-21",0,0,35,0,0,36,0,0
"Sweden","2024-09-22",0,0,35,0,0,36,0,0
"Sweden","2024-09-23",0,0,35,0,0,36,0,0
"Sweden","2024-09-24",0,0,35,0,0,36,0,0
"Sweden","2024-09-25",0,0,35,0,0,36,0,0
"Sweden","2024-09-26",0,0,35,0,0,36,0,0
"Sweden","2024-09-27",0,0,35,0,0,36,0,0
"Sweden","2024-09-28",0,0,35,0,0,36,0,0
"Sweden","2024-09-29",0,0,35,0,0,36,0,0
"Sweden","2024-09-30",0,0,35,0,0,36,0,0
"Sweden","2024-10-01",0,0,35,0,1,37,0,0
"Sweden","2024-10-02",0,0,35,0,0,37,0,0
"Sweden","2024-10-03",0,0,35,0,0,37,0,0
"Sweden","2024-10-04",0,0,35,0,0,37,0,0
"Sweden","2024-10-05",0,0,35,0,0,37,0,0
"Sweden","2024-10-06",0,0,35,0,0,37,0,0
"Sweden","2024-10-07",0,0,35,0,0,37,0,0
"Sweden","2024-10-08",0,0,35,0,0,37,0,0
"Sweden","2024-10-09",0,0,35,0,0,37,0,0
"Sweden","2024-10-10",0,0,35,0,0,37,0,0
"Sweden","2024-10-11",0,0,35,0,0,37,0,0
"Sweden","2024-10-12",0,0,35,0,0,37,0,0
"Sweden","2024-10-13",0,0,35,0,0,37,0,0
"Sweden","2024-10-14",0,0,35,0,0,37,0,0
"Sweden","2024-10-15",0,0,35,0,0,37,0,0
"Sweden","2024-10-16",0,0,35,0,0,37,0,0
"Sweden","2024-10-17",0,0,35,0,0,37,0,0
"Sweden","2024-10-18",0,0,35,0,0,37,0,0
"Sweden","2024-10-19",0,0,35,0,0,37,0,0
"Sweden","2024-10-20",0,0,35,0,0,37,0,0
"Sweden","2024-10-21",0,0,35,0,1,38,0,0
"Sweden","2024-10-22",0,0,35,0,0,38,0,0
"Sweden","2024-10-23",0,0,35,0,0,38,0,0
"Sweden","2024-10-24",0,0,35,0,0,38,0,0
"Sweden","2024-10-25",0,0,35,0,0,38,0,0
"Sweden","2024-10-26",0,0,35,0,0,38,0,0
"Sweden","2024-10-27",0,0,35,0,0,38,0,0
"Sweden","2024-10-28",0,0,35,0,0,38,0,0
"Sweden","2024-10-29",0,0,35,0,0,38,0,0
"Sweden","2024-10-30",0,0,35,0,0,38,0,0
"Sweden","2024-10-31",0,3,38,0,0,38,0,0
"Sweden","2024-11-01",0,0,38,0,0,38,0,0
"Sweden","2024-11-02",0,0,38,0,0,38,0,0
"Sweden","2024-11-03",0,0,38,0,0,38,0,0
"Sweden","2024-11-04",0,0,38,0,0,38,0,0
"Sweden","2024-11-05",0,0,38,0,0,38,0,0
"Sweden","2024-11-06",0,0,38,0,0,38,0,0
"Sweden","2024-11-07",0,0,38,0,0,38,0,0
"Sweden","2024-11-08",0,0,38,0,0,38,0,0
"Sweden","2024-11-09",0,0,38,0,0,38,0,0
"Sweden","2024-11-10",0,0,38,0,0,38,0,0
"Sweden","2024-11-11",0,0,38,0,0,38,0,0
"Sweden","2024-11-12",0,0,38,0,0,38,0,0
"Sweden","2024-11-13",0,0,38,0,0,38,0,0
"Sweden","2024-11-14",0,0,38,0,0,38,0,0
"Sweden","2024-11-15",0,0,38,0,0,38,0,0
"Sweden","2024-11-16",0,0,38,0,0,38,0,0
"Sweden","2024-11-17",0,0,38,0,0,38,0,0
"Sweden","2024-11-18",0,0,38,0,0,38,0,0
"Sweden","2024-11-19",0,0,38,0,0,38,0,0
"Sweden","2024-11-20",0,0,38,0,0,38,0,0
"Sweden","2024-11-21",0,0,38,0,0,38,0,0
"Sweden","2024-11-22",0,0,38,0,0,38,0,0
"Sweden","2024-11-23",0,0,38,0,0,38,0,0
"Sweden","2024-11-24",0,0,38,0,0,38,0,0
"Sweden","2024-11-25",0,0,38,0,0,38,0,0
"Sweden","2024-11-26",0,0,38,0,0,38,0,0
"Sweden","2024-11-27",0,0,38,0,0,38,0,0
"Sweden","2024-11-28",0,0,38,0,0,38,0,0
"Sweden","2024-11-29",0,0,38,0,0,38,0,0
"Sweden","2024-11-30",0,0,38,0,0,38,0,0
"Sweden","2024-12-01",0,0,38,0,0,38,0,0
"Sweden","2024-12-02",0,0,38,0,0,38,0,0
"Sweden","2024-12-03",0,0,38,0,0,38,0,0
"Sweden","2024-12-04",0,0,38,0,0,38,0,0
"Sweden","2024-12-05",0,0,38,0,0,38,0,0
"Sweden","2024-12-06",0,0,38,0,0,38,0,0
"Sweden","2024-12-07",0,0,38,0,0,38,0,0
"Sweden","2024-12-08",0,0,38,0,0,38,0,0
"Sweden","2024-12-09",0,0,38,0,0,38,0,0
"Sweden","2024-12-10",0,0,38,0,0,38,0,0
"Sweden","2024-12-11",0,0,38,0,0,38,0,0
"Sweden","2024-12-12",0,0,38,0,0,38,0,0
"Sweden","2024-12-13",0,0,38,0,0,38,0,0
"Sweden","2024-12-14",0,0,38,0,0,38,0,0
"Sweden","2024-12-15",0,0,38,0,0,38,0,0
"Sweden","2024-12-16",0,0,38,0,0,38,0,0
"Sweden","2024-12-17",0,0,38,0,0,38,0,0
"Sweden","2024-12-18",0,0,38,0,0,38,0,0
"Sweden","2024-12-19",0,0,38,0,0,38,0,0
"Sweden","2024-12-20",0,0,38,0,0,38,0,0
"Sweden","2024-12-21",0,0,38,0,0,38,0,0
"Sweden","2024-12-22",0,0,38,0,0,38,0,0
"Sweden","2024-12-23",0,0,38,0,0,38,0,0
"Sweden","2024-12-24",0,0,38,0,0,38,0,0
"Sweden","2024-12-25",0,0,38,0,0,38,0,0
"Sweden","2024-12-26",0,0,38,0,0,38,0,0
"Sweden","2024-12-27",0,0,38,0,0,38,0,0
"Sweden","2024-12-28",0,0,38,0,0,38,0,0
"Sweden","2024-12-29",0,0,38,0,0,38,0,0
"Sweden","2024-12-30",0,0,38,0,0,38,0,0
"Sweden","2024-12-31",0,0,38,0,0,38,0,0
"Sweden","2025-01-01",0,0,38,0,0,38,0,0
"Sweden","2025-01-02",0,0,38,0,0,38,0,0
"Sweden","2025-01-03",0,0,38,0,0,38,0,0
"Sweden","2025-01-04",0,0,38,0,0,38,0,0
"Sweden","2025-01-05",0,0,38,0,0,38,0,0
"Sweden","2025-01-06",0,0,38,0,0,38,0,0
"Sweden","2025-01-07",0,0,38,0,0,38,0,0
"Sweden","2025-01-08",0,0,38,0,0,38,0,0
"Sweden","2025-01-09",0,0,38,0,0,38,0,0
"Sweden","2025-01-10",0,0,38,0,0,38,0,0
"Sweden","2025-01-11",0,0,38,0,0,38,0,0
"Sweden","2025-01-12",0,0,38,0,0,38,0,0
"Sweden","2025-01-13",0,0,38,0,0,38,0,0
"Switzerland","2024-01-01",0,0,0,0,0,0,0,0
"Switzerland","2024-01-02",0,0,0,0,0,0,0,0
"Switzerland","2024-01-03",0,0,0,0,0,0,0,0
"Switzerland","2024-01-04",0,0,0,0,0,0,0,0
"Switzerland","2024-01-05",0,0,0,0,0,0,0,0
"Switzerland","2024-01-06",0,0,0,0,0,0,0,0
"Switzerland","2024-01-07",0,0,0,0,0,0,0,0
"Switzerland","2024-01-08",0,0,0,0,0,0,0,0
"Switzerland","2024-01-09",0,0,0,0,0,0,0,0
"Switzerland","2024-01-10",0,0,0,0,0,0,0,0
"Switzerland","2024-01-11",0,0,0,0,0,0,0,0
"Switzerland","2024-01-12",0,0,0,0,0,0,0,0
"Switzerland","2024-01-13",0,0,0,0,0,0,0,0
"Switzerland","2024-01-14",0,0,0,0,0,0,0,0
"Switzerland","2024-01-15",0,0,0,0,0,0,0,0
"Switzerland","2024-01-16",0,0,0,0,0,0,0,0
"Switzerland","2024-01-17",0,0,0,0,0,0,0,0
"Switzerland","2024-01-18",0,0,0,0,0,0,0,0
"Switzerland","2024-01-19",0,0,0,0,0,0,0,0
"Switzerland","2024-01-20",0,0,0,0,0,0,0,0
"Switzerland","2024-01-21",0,0,0,0,0,0,0,0
"Switzerland","2024-01-22",0,0,0,0,0,0,0,0
"Switzerland","2024-01-23",0,0,0,0,0,0,0,0
"Switzerland","2024-01-24",0,0,0,0,0,0,0,0
"Switzerland","2024-01-25",0,0,0,0,0,0,0,0
"Switzerland","2024-01-26",0,0,0,0,0,0,0,0
"Switzerland","2024-01-27",0,0,0,0,0,0,0,0
"Switzerland","2024-01-28",0,0,0,0,0,0,0,0
"Switzerland","2024-01-29",0,0,0,0,0,0,0,0
"Switzerland","2024-01-30",0,0,0,0,0,0,0,0
"Switzerland","2024-01-31",0,9,9,0,9,9,0,0
"Switzerland","2024-02-01",0,0,9,0,0,9,0,0
"Switzerland","2024-02-02",0,0,9,0,0,9,0,0
"Switzerland","2024-02-03",0,0,9,0,1,10,0,0
"Switzerland","2024-02-04",0,0,9,0,0,10,0,0
"Switzerland","2024-02-05",0,0,9,0,0,10,0,0
"Switzerland","2024-02-06",0,0,9,0,0,10,0,0
"Switzerland","2024-02-07",0,0,9,0,1,11,0,0
"Switzerland","2024-02-08",0,0,9,0,0,11,0,0
"Switzerland","2024-02-09",0,0,9,0,0,11,0,0
"Switzerland","2024-02-10",0,0,9,0,0,11,0,0
"Switzerland","2024-02-11",0,0,9,0,1,12,0,0
"Switzerland","2024-02-12",0,0,9,0,0,12,0,0
"Switzerland","2024-02-13",0,0,9,0,0,12,0,0
"Switzerland","2024-02-14",0,0,9,0,0,12,0,0
"Switzerland","2024-02-15",0,0,9,0,1,13,0,0
"Switzerland","2024-02-16",0,0,9,0,0,13,0,0
"Switzerland","2024-02-17",0,0,9,0,0,13,0,0
"Switzerland","2024-02-18",0,0,9,0,0,13,0,0
"Switzerland","2024-02-19",0,0,9,0,1,14,0,0
"Switzerland","2024-02-20",0,0,9,0,0,14,0,0
"Switzerland","2024-02-21",0,0,9,0,0,14,0,0
"Switzerland","2024-02-22",0,0,9,0,0,14,0,0
"Switzerland","2024-02-23",0,0,9,0,1,15,0,0
"Switzerland","2024-02-24",0,0,9,0,0,15,0,0
"Switzerland","2024-02-25",0,0,9,0,0,15,0,0
"Switzerland","2024-02-26",0,0,9,0,0,15,0,0
"Switzerland","2024-02-27",0,0,9,0,1,16,0,0
"Switzerland","2024-02-28",0,0,9,0,0,16,0,0
"Switzerland","2024-02-29",0,7,16,0,0,16,0,0
"Switzerland","2024-03-01",0,0,16,0,0,16,0,0
"Switzerland","2024-03-02",0,0,16,0,0,16,0,0
"Switzerland","2024-03-03",0,0,16,0,0,16,0,0
"Switzerland","2024-03-04",0,0,16,0,0,16,0,0
"Switzerland","2024-03-05",0,0,16,0,0,16,0,0
"Switzerland","2024-03-06",0,0,16,0,0,16,0,0
"Switzerland","2024-03-07",0,0,16,0,0,16,0,0
"Switzerland","2024-03-08",0,0,16,0,0,16,0,0
"Switzerland","2024-03-09",0,0,16,0,0,16,0,0
"Switzerland","2024-03-10",0,0,16,0,0,16,0,0
"Switzerland","2024-03-11",0,0,16,0,1,17,0,0
"Switzerland","2024-03-12",0,0,16,0,0,17,0,0
"Switzerland","2024-03-13",0,0,16,0,0,17,0,0
"Switzerland","2024-03-14",0,0,16,0,0,17,0,0
"Switzerland","2024-03-15",0,0,16,0,0,17,0,0
"Switzerland","2024-03-16",0,0,16,0,0,17,0,0
"Switzerland","2024-03-17",0,0,16,0,0,17,0,0
"Switzerland","2024-03-18",0,0,16,0,0,17,0,0
"Switzerland","2024-03-19",0,0,16,0,0,17,0,0
"Switzerland","2024-03-20",0,0,16,0,0,17,0,0
"Switzerland","2024-03-21",0,0,16,0,0,17,0,0
"Switzerland","2024-03-22",0,0,16,0,0,17,0,0
"Switzerland","2024-03-23",0,0,16,0,0,17,0,0
"Switzerland","2024-03-24",0,0,16,0,0,17,0,0
"Switzerland","2024-03-25",0,0,16,0,0,17,0,0
"Switzerland","2024-03-26",0,0,16,0,0,17,0,0
"Switzerland","2024-03-27",0,0,16,0,0,17,0,0
"Switzerland","2024-03-28",0,0,16,0,0,17,0,0
"Switzerland","2024-03-29",0,0,16,0,0,17,0,0
"Switzerland","2024-03-30",0,0,16,0,0,17,0,0
"Switzerland","2024-03-31",0,0,16,0,1,18,0,0
"Switzerland","2024-04-01",0,0,16,0,0,18,0,0
"Switzerland","2024-04-02",0,0,16,0,0,18,0,0
"Switzerland","2024-04-03",0,0,16,0,0,18,0,0
"Switzerland","2024-04-04",0,0,16,0,0,18,0,0
"Switzerland","2024-04-05",0,0,16,0,0,18,0,0
"Switzerland","2024-04-06",0,0,16,0,0,18,0,0
"Switzerland","2024-04-07",0,0,16,0,0,18,0,0
"Switzerland","2024-04-08",0,0,16,0,0,18,0,0
"Switzerland","2024-04-09",0,0,16,0,0,18,0,0
"Switzerland","2024-04-10",0,0,16,0,0,18,0,0
"Switzerland","2024-04-11",0,0,16,0,0,18,0,0
"Switzerland","2024-04-12",0,0,16,0,0,18,0,0
"Switzerland","2024-04-13",0,0,16,0,0,18,0,0
"Switzerland","2024-04-14",0,0,16,0,0,18,0,0
"Switzerland","2024-04-15",0,0,16,0,0,18,0,0
"Switzerland","2024-04-16",0,0,16,0,0,18,0,0
"Switzerland","2024-04-17",0,0,16,0,0,18,0,0
"Switzerland","2024-04-18",0,0,16,0,0,18,0,0
"Switzerland","2024-04-19",0,0,16,0,0,18,0,0
"Switzerland","2024-04-20",0,0,16,0,0,18,0,0
"Switzerland","2024-04-21",0,0,16,0,1,19,0,0
"Switzerland","2024-04-22",0,0,16,0,0,19,0,0
"Switzerland","2024-04-23",0,0,16,0,0,19,0,0
"Switzerland","2024-04-24",0,0,16,0,0,19,0,0
"Switzerland","2024-04-25",0,0,16,0,0,19,0,0
"Switzerland","2024-04-26",0,0,16,0,0,19,0,0
"Switzerland","2024-04-27",0,0,16,0,0,19,0,0
"Switzerland","2024-04-28",0,0,16,0,0,19,0,0
"Switzerland","2024-04-29",0,0,16,0,0,19,0,0
"Switzerland","2024-04-30",0,0,16,0,0,19,0,0
"Switzerland","2024-05-01",0,0,16,0,0,19,0,0
"Switzerland","2024-05-02",0,0,16,0,0,19,0,0
"Switzerland","2024-05-03",0,0,16,0,0,19,0,0
"Switzerland","2024-05-04",0,0,16,0,0,19,0,0
"Switzerland","2024-05-05",0,0,16,0,0,19,0,0
"Switzerland","2024-05-06",0,0,16,0,0,19,0,0
"Switzerland","2024-05-07",0,0,16,0,0,19,0,0
"Switzerland","2024-05-08",0,0,16,0,0,19,0,0
"Switzerland","2024-05-09",0,0,16,0,0,19,0,0
"Switzerland","2024-05-10",0,0,16,0,0,19,0,0
"Switzerland","2024-05-11",0,0,16,0,1,20,0,0
"Switzerland","2024-05-12",0,0,16,0,0,20,0,0
"Switzerland","2024-05-13",0,0,16,0,0,20,0,0
"Switzerland","2024-05-14",0,0,16,0,0,20,0,0
"Switzerland","2024-05-15",0,0,16,0,0,20,0,0
"Switzerland","2024-05-16",0,0,16,0,0,20,0,0
"Switzerland","2024-05-17",0,0,16,0,0,20,0,0
"Switzerland","2024-05-18",0,0,16,0,0,20,0,0
"Switzerland","2024-05-19",0,0,16,0,0,20,0,0
"Switzerland","2024-05-20",0,0,16,0,0,20,0,0
"Switzerland","2024-05-21",0,0,16,0,0,20,0,0
"Switzerland","2024-05-22",0,0,16,0,0,20,0,0
"Switzerland","2024-05-23",0,0,16,0,0,20,0,0
"Switzerland","2024-05-24",0,0,16,0,0,20,0,0
"Switzerland","2024-05-25",0,0,16,0,0,20,0,0
"Switzerland","2024-05-26",0,0,16,0,0,20,0,0
"Switzerland","2024-05-27",0,0,16,0,0,20,0,0
"Switzerland","2024-05-28",0,0,16,0,0,20,0,0
"Switzerland","2024-05-29",0,0,16,0,0,20,0,0
"Switzerland","2024-05-30",0,0,16,0,0,20,0,0
"Switzerland","2024-05-31",0,0,16,0,0,20,0,0
"Switzerland","2024-06-01",0,0,16,0,1,21,0,0
"Switzerland","2024-06-02",0,0,16,0,0,21,0,0
"Switzerland","2024-06-03",0,0,16,0,0,21,0,0
"Switzerland","2024-06-04",0,0,16,0,0,21,0,0
"Switzerland","2024-06-05",0,0,16,0,0,21,0,0
"Switzerland","2024-06-06",0,0,16,0,0,21,0,0
"Switzerland","2024-06-07",0,0,16,0,0,21,0,0
"Switzerland","2024-06-08",0,0,16,0,0,21,0,0
"Switzerland","2024-06-09",0,0,16,0,0,21,0,0
"Switzerland","2024-06-10",0,0,16,0,0,21,0,0
"Switzerland","2024-06-11",0,0,16,0,0,21,0,0
"Switzerland","2024-06-12",0,0,16,0,0,21,0,0
"Switzerland","2024-06-13",0,0,16,0,0,21,0,0
"Switzerland","2024-06-14",0,0,16,0,0,21,0,0
"Switzerland","2024-06-15",0,0,16,0,0,21,0,0
"Switzerland","2024-06-16",0,0,16,0,0,21,0,0
"Switzerland","2024-06-17",0,0,16,0,0,21,0,0
"Switzerland","2024-06-18",0,0,16,0,0,21,0,0
"Switzerland","2024-06-19",0,0,16,0,0,21,0,0
"Switzerland","2024-06-20",0,0,16,0,0,21,0,0
"Switzerland","2024-06-21",0,0,16,0,1,22,0,0
"Switzerland","2024-06-22",0,0,16,0,0,22,0,0
"Switzerland","2024-06-23",0,0,16,0,0,22,0,0
"Switzerland","2024-06-24",0,0,16,0,0,22,0,0
"Switzerland","2024-06-25",0,0,16,0,0,22,0,0
"Switzerland","2024-06-26",0,0,16,0,0,22,0,0
"Switzerland","2024-06-27",0,0,16,0,0,22,0,0
"Switzerland","2024-06-28",0,0,16,0,0,22,0,0
"Switzerland","2024-06-29",0,0,16,0,0,22,0,0
"Switzerland","2024-06-30",0,0,16,0,0,22,0,0
"Switzerland","2024-07-01",0,0,16,0,0,22,0,0
"Switzerland","2024-07-02",0,0,16,0,0,22,0,0
"Switzerland","2024-07-03",0,0,16,0,0,22,0,0
"Switzerland","2024-07-04",0,0,16,0,0,22,0,0
"Switzerland","2024-07-05",0,0,16,0,0,22,0,0
"Switzerland","2024-07-06",0,0,16,0,0,22,0,0
"Switzerland","2024-07-07",0,0,16,0,0,22,0,0
"Switzerland","2024-07-08",0,0,16,0,0,22,0,0
"Switzerland","2024-07-09",0,0,16,0,0,22,0,0
"Switzerland","2024-07-10",0,0,16,0,0,22,0,0
"Switzerland","2024-07-11",0,0,16,0,1,23,0,0
"Switzerland","2024-07-12",0,0,16,0,0,23,0,0
"Switzerland","2024-07-13",0,0,16,0,0,23,0,0
"Switzerland","2024-07-14",0,0,16,0,0,23,0,0
"Switzerland","2024-07-15",0,0,16,0,0,23,0,0
"Switzerland","2024-07-16",0,0,16,0,0,23,0,0
"Switzerland","2024-07-17",0,0,16,0,0,23,0,0
"Switzerland","2024-07-18",0,0,16,0,0,23,0,0
"Switzerland","2024-07-19",0,0,16,0,0,23,0,0
"Switzerland","2024-07-20",0,0,16,0,0,23,0,0
"Switzerland","2024-07-21",0,0,16,0,0,23,0,0
"Switzerland","2024-07-22",0,0,16,0,0,23,0,0
"Switzerland","2024-07-23",0,0,16,0,0,23,0,0
"Switzerland","2024-07-24",0,0,16,0,0,23,0,0
"Switzerland","2024-07-25",0,0,16,0,0,23,0,0
"Switzerland","2024-07-26",0,0,16,0,0,23,0,0
"Switzerland","2024-07-27",0,0,16,0,0,23,0,0
"Switzerland","2024-07-28",0,0,16,0,0,23,0,0
"Switzerland","2024-07-29",0,0,16,0,0,23,0,0
"Switzerland","2024-07-30",0,0,16,0,0,23,0,0
"Switzerland","2024-07-31",0,0,16,0,0,23,0,0
"Switzerland","2024-08-01",0,0,16,0,1,24,0,0
"Switzerland","2024-08-02",0,0,16,0,0,24,0,0
"Switzerland","2024-08-03",0,0,16,0,0,24,0,0
"Switzerland","2024-08-04",0,0,16,0,0,24,0,0
"Switzerland","2024-08-05",0,0,16,0,0,24,0,0
"Switzerland","2024-08-06",0,0,16,0,0,24,0,0
"Switzerland","2024-08-07",0,0,16,0,0,24,0,0
"Switzerland","2024-08-08",0,0,16,0,0,24,0,0
"Switzerland","2024-08-09",0,0,16,0,0,24,0,0
"Switzerland","2024-08-10",0,0,16,0,0,24,0,0
"Switzerland","2024-08-11",0,0,16,0,0,24,0,0
"Switzerland","2024-08-12",0,0,16,0,0,24,0,0
"Switzerland","2024-08-13",0,0,16,0,0,24,0,0
"Switzerland","2024-08-14",0,0,16,0,0,24,0,0
"Switzerland","2024-08-15",0,0,16,0,0,24,0,0
"Switzerland","2024-08-16",0,0,16,0,0,24,0,0
"Switzerland","2024-08-17",0,0,16,0,0,24,0,0
"Switzerland","2024-08-18",0,0,16,0,0,24,0,0
"Switzerland","2024-08-19",0,0,16,0,0,24,0,0
"Switzerland","2024-08-20",0,0,16,0,0,24,0,0
"Switzerland","2024-08-21",0,0,16,0,1,25,0,0
"Switzerland","2024-08-22",0,0,16,0,0,25,0,0
"Switzerland","2024-08-23",0,0,16,0,0,25,0,0
"Switzerland","2024-08-24",0,0,16,0,0,25,0,0
"Switzerland","2024-08-25",0,0,16,0,0,25,0,0
"Switzerland","2024-08-26",0,0,16,0,0,25,0,0
"Switzerland","2024-08-27",0,0,16,0,0,25,0,0
"Switzerland","2024-08-28",0,0,16,0,0,25,0,0
"Switzerland","2024-08-29",0,0,16,0,0,25,0,0
"Switzerland","2024-08-30",0,0,16,0,0,25,0,0
"Switzerland","2024-08-31",0,9,25,0,0,25,0,0
"Switzerland","2024-09-01",0,0,25,0,0,25,0,0
"Switzerland","2024-09-02",0,0,25,0,0,25,0,0
"Switzerland","2024-09-03",0,0,25,0,0,25,0,0
"Switzerland","2024-09-04",0,0,25,0,0,25,0,0
"Switzerland","2024-09-05",0,0,25,0,0,25,0,0
"Switzerland","2024-09-06",0,0,25,0,0,25,0,0
"Switzerland","2024-09-07",0,0,25,0,0,25,0,0
"Switzerland","2024-09-08",0,0,25,0,0,25,0,0
"Switzerland","2024-09-09",0,0,25,0,0,25,0,0
"Switzerland","2024-09-10",0,0,25,0,0,25,0,0
"Switzerland","2024-09-11",0,0,25,0,0,25,0,0
"Switzerland","2024-09-12",0,0,25,0,0,25,0,0
"Switzerland","2024-09-13",0,0,25,0,0,25,0,0
"Switzerland","2024-09-14",0,0,25,0,0,25,0,0
"Switzerland","2024-09-15",0,0,25,0,0,25,0,0
"Switzerland","2024-09-16",0,0,25,0,0,25,0,0
"Switzerland","2024-09-17",0,0,25,0,0,25,0,0
"Switzerland","2024-09-18",0,0,25,0,0,25,0,0
"Switzerland","2024-09-19",0,0,25,0,0,25,0,0
"Switzerland","2024-09-20",0,0,25,0,0,25,0,0
"Switzerland","2024-09-21",0,0,25,0,0,25,0,0
"Switzerland","2024-09-22",0,0,25,0,0,25,0,0
"Switzerland","2024-09-23",0,0,25,0,0,25,0,0
"Switzerland","2024-09-24",0,0,25,0,0,25,0,0
"Switzerland","2024-09-25",0,0,25,0,0,25,0,0
"Switzerland","2024-09-26",0,0,25,0,0,25,0,0
"Switzerland","2024-09-27",0,0,25,0,0,25,0,0
"Switzerland","2024-09-28",0,0,25,0,0,25,0,0
"Switzerland","2024-09-29",0,0,25,0,0,25,0,0
"Switzerland","2024-09-30",0,0,25,0,0,25,0,0
"Switzerland","2024-10-01",0,0,25,0,0,25,0,0
"Switzerland","2024-10-02",0,0,25,0,0,25,0,0
"Switzerland","2024-10-03",0,0,25,0,0,25,0,0
"Switzerland","2024-10-04",0,0,25,0,0,25,0,0
"Switzerland","2024-10-05",0,0,25,0,0,25,0,0
"Switzerland","2024-10-06",0,0,25,0,0,25,0,0
"Switzerland","2024-10-07",0,0,25,0,0,25,0,0
"Switzerland","2024-10-08",0,0,25,0,0,25,0,0
"Switzerland","2024-10-09",0,0,25,0,0,25,0,0
"Switzerland","2024-10-10",0,0,25,0,0,25,0,0
"Switzerland","2024-10-11",0,0,25,0,0,25,0,0
"Switzerland","2024-10-12",0,0,25,0,0,25,0,0
"Switzerland","2024-10-13",0,0,25,0,0,25,0,0
"Switzerland","2024-10-14",0,0,25,0,0,25,0,0
"Switzerland","2024-10-15",0,0,25,0,0,25,0,0
"Switzerland","2024-10-16",0,0,25,0,0,25,0,0
"Switzerland","2024-10-17",0,0,25,0,0,25,0,0
"Switzerland","2024-10-18",0,0,25,0,0,25,0,0
"Switzerland","2024-10-19",0,0,25,0,0,25,0,0
"Switzerland","2024-10-20",0,0,25,0,0,25,0,0
"Switzerland","2024-10-21",0,0,25,0,0,25,0,0
"Switzerland","2024-10-22",0,0,25,0,0,25,0,0
"Switzerland","2024-10-23",0,0,25,0,0,25,0,0
"Switzerland","2024-10-24",0,0,25,0,0,25,0,0
"Switzerland","2024-10-25",0,0,25,0,0,25,0,0
"Switzerland","2024-10-26",0,0,25,0,0,25,0,0
"Switzerland","2024-10-27",0,0,25,0,0,25,0,0
"Switzerland","2024-10-28",0,0,25,0,0,25,0,0
"Switzerland","2024-10-29",0,0,25,0,0,25,0,0
"Switzerland","2024-10-30",0,0,25,0,0,25,0,0
"Switzerland","2024-10-31",0,0,25,0,0,25,0,0
"Switzerland","2024-11-01",0,0,25,0,0,25,0,0
"Switzerland","2024-11-02",0,0,25,0,0,25,0,0
"Switzerland","2024-11-03",0,0,25,0,0,25,0,0
"Switzerland","2024-11-04",0,0,25,0,0,25,0,0
"Switzerland","2024-11-05",0,0,25,0,0,25,0,0
"Switzerland","2024-11-06",0,0,25,0,0,25,0,0
"Switzerland","2024-11-07",0,0,25,0,0,25,0,0
"Switzerland","2024-11-08",0,0,25,0,0,25,0,0
"Switzerland","2024-11-09",0,0,25,0,0,25,0,0
"Switzerland","2024-11-10",0,0,25,0,0,25,0,0
"Switzerland","2024-11-11",0,0,25,0,0,25,0,0
"Switzerland","2024-11-12",0,0,25,0,0,25,0,0
"Switzerland","2024-11-13",0,0,25,0,0,25,0,0
"Switzerland","2024-11-14",0,0,25,0,0,25,0,0
"Switzerland","2024-11-15",0,0,25,0,0,25,0,0
"Switzerland","2024-11-16",0,0,25,0,0,25,0,0
"Switzerland","2024-11-17",0,0,25,0,0,25,0,0
"Switzerland","2024-11-18",0,0,25,0,0,25,0,0
"Switzerland","2024-11-19",0,0,25,0,0,25,0,0
"Switzerland","2024-11-20",0,0,25,0,0,25,0,0
"Switzerland","2024-11-21",0,0,25,0,0,25,0,0
"Switzerland","2024-11-22",0,0,25,0,0,25,0,0
"Switzerland","2024-11-23",0,0,25,0,0,25,0,0
"Switzerland","2024-11-24",0,0,25,0,0,25,0,0
"Switzerland","2024-11-25",0,0,25,0,0,25,0,0
"Switzerland","2024-11-26",0,0,25,0,0,25,0,0
"Switzerland","2024-11-27",0,0,25,0,0,25,0,0
"Switzerland","2024-11-28",0,0,25,0,0,25,0,0
"Switzerland","2024-11-29",0,0,25,0,0,25,0,0
"Switzerland","2024-11-30",0,0,25,0,0,25,0,0
"Switzerland","2024-12-01",0,0,25,0,0,25,0,0
"Switzerland","2024-12-02",0,0,25,0,0,25,0,0
"Switzerland","2024-12-03",0,0,25,0,0,25,0,0
"Switzerland","2024-12-04",0,0,25,0,0,25,0,0
"Switzerland","2024-12-05",0,0,25,0,0,25,0,0
"Switzerland","2024-12-06",0,0,25,0,0,25,0,0
"Switzerland","2024-12-07",0,0,25,0,0,25,0,0
"Switzerland","2024-12-08",0,0,25,0,0,25,0,0
"Switzerland","2024-12-09",0,0,25,0,0,25,0,0
"Switzerland","2024-12-10",0,0,25,0,0,25,0,0
"Switzerland","2024-12-11",0,0,25,0,0,25,0,0
"Switzerland","2024-12-12",0,0,25,0,0,25,0,0
"Switzerland","2024-12-13",0,0,25,0,0,25,0,0
"Switzerland","2024-12-14",0,0,25,0,0,25,0,0
"Switzerland","2024-12-15",0,0,25,0,0,25,0,0
"Switzerland","2024-12-16",0,0,25,0,0,25,0,0
"Switzerland","2024-12-17",0,0,25,0,0,25,0,0
"Switzerland","2024-12-18",0,0,25,0,0,25,0,0
"Switzerland","2024-12-19",0,0,25,0,0,25,0,0
"Switzerland","2024-12-20",0,0,25,0,0,25,0,0
"Switzerland","2024-12-21",0,0,25,0,0,25,0,0
"Switzerland","2024-12-22",0,0,25,0,0,25,0,0
"Switzerland","2024-12-23",0,0,25,0,0,25,0,0
"Switzerland","2024-12-24",0,0,25,0,0,25,0,0
"Switzerland","2024-12-25",0,0,25,0,0,25,0,0
"Switzerland","2024-12-26",0,0,25,0,0,25,0,0
"Switzerland","2024-12-27",0,0,25,0,0,25,0,0
"Switzerland","2024-12-28",0,0,25,0,0,25,0,0
"Switzerland","2024-12-29",0,0,25,0,0,25,0,0
"Switzerland","2024-12-30",0,0,25,0,0,25,0,0
"Switzerland","2024-12-31",0,0,25,0,0,25,0,0
"Switzerland","2025-01-01",0,0,25,0,0,25,0,0
"Switzerland","2025-01-02",0,0,25,0,0,25,0,0
"Switzerland","2025-01-03",0,0,25,0,0,25,0,0
"Switzerland","2025-01-04",0,0,25,0,0,25,0,0
"Switzerland","2025-01-05",0,0,25,0,0,25,0,0
"Switzerland","2025-01-06",0,0,25,0,0,25,0,0
"Switzerland","2025-01-07",0,0,25,0,0,25,0,0
"Switzerland","2025-01-08",0,0,25,0,0,25,0,0
"Switzerland","2025-01-09",0,0,25,0,0,25,0,0
"Switzerland","2025-01-10",0,0,25,0,0,25,0,0
"Switzerland","2025-01-11",0,0,25,0,0,25,0,0
"Switzerland","2025-01-12",0,0,25,0,0,25,0,0
"Switzerland","2025-01-13",0,0,25,0,0,25,0,0
"Thailand","2024-01-01",0,0,0,0,0,0,0,0
"Thailand","2024-01-02",0,0,0,0,0,0,0,0
"Thailand","2024-01-03",0,0,0,0,0,0,0,0
"Thailand","2024-01-04",0,0,0,0,0,0,0,0
"Thailand","2024-01-05",0,0,0,0,0,0,0,0
"Thailand","2024-01-06",0,0,0,0,0,0,0,0
"Thailand","2024-01-07",0,0,0,0,0,0,0,0
"Thailand","2024-01-08",0,0,0,0,0,0,0,0
"Thailand","2024-01-09",0,0,0,0,0,0,0,0
"Thailand","2024-01-10",0,0,0,0,0,0,0,0
"Thailand","2024-01-11",0,0,0,0,0,0,0,0
"Thailand","2024-01-12",0,0,0,0,0,0,0,0
"Thailand","2024-01-13",0,0,0,0,0,0,0,0
"Thailand","2024-01-14",0,0,0,0,0,0,0,0
"Thailand","2024-01-15",0,0,0,0,0,0,0,0
"Thailand","2024-01-16",0,0,0,0,0,0,0,0
"Thailand","2024-01-17",0,0,0,0,0,0,0,0
"Thailand","2024-01-18",0,0,0,0,0,0,0,0
"Thailand","2024-01-19",0,0,0,0,0,0,0,0
"Thailand","2024-01-20",0,0,0,0,0,0,0,0
"Thailand","2024-01-21",0,0,0,0,0,0,0,0
"Thailand","2024-01-22",0,0,0,0,0,0,0,0
"Thailand","2024-01-23",0,0,0,0,0,0,0,0
"Thailand","2024-01-24",0,0,0,0,0,0,0,0
"Thailand","2024-01-25",0,0,0,0,0,0,0,0
"Thailand","2024-01-26",0,0,0,0,0,0,0,0
"Thailand","2024-01-27",0,0,0,0,0,0,0,0
"Thailand","2024-01-28",0,0,0,0,0,0,0,0
"Thailand","2024-01-29",0,0,0,0,0,0,0,0
"Thailand","2024-01-30",0,0,0,0,0,0,0,0
"Thailand","2024-01-31",0,36,36,0,36,36,0,0
"Thailand","2024-02-01",0,0,36,0,1,37,0,0
"Thailand","2024-02-02",0,0,36,0,1,38,0,0
"Thailand","2024-02-03",0,0,36,0,0,38,0,0
"Thailand","2024-02-04",0,0,36,0,1,39,0,0
"Thailand","2024-02-05",0,0,36,0,1,40,0,0
"Thailand","2024-02-06",0,0,36,0,1,41,0,0
"Thailand","2024-02-07",0,0,36,0,0,41,0,0
"Thailand","2024-02-08",0,0,36,0,1,42,0,0
"Thailand","2024-02-09",0,0,36,0,1,43,0,0
"Thailand","2024-02-10",0,0,36,0,1,44,0,0
"Thailand","2024-02-11",0,0,36,0,0,44,0,0
"Thailand","2024-02-12",0,0,36,0,1,45,0,0
"Thailand","2024-02-13",0,0,36,0,1,46,0,0
"Thailand","2024-02-14",0,0,36,0,1,47,0,0
"Thailand","2024-02-15",0,0,36,0,0,47,0,0
"Thailand","2024-02-16",0,0,36,0,1,48,0,0
"Thailand","2024-02-17",0,0,36,0,1,49,0,0
"Thailand","2024-02-18",0,0,36,0,1,50,0,0
"Thailand","2024-02-19",0,0,36,0,0,50,0,0
"Thailand","2024-02-20",0,0,36,0,1,51,0,0
"Thailand","2024-02-21",0,0,36,0,1,52,0,0
"Thailand","2024-02-22",0,0,36,0,1,53,0,0
"Thailand","2024-02-23",0,0,36,0,0,53,0,0
"Thailand","2024-02-24",0,0,36,0,1,54,0,0
"Thailand","2024-02-25",0,0,36,0,1,55,0,0
"Thailand","2024-02-26",0,0,36,0,1,56,0,0
"Thailand","2024-02-27",0,0,36,0,0,56,0,0
"Thailand","2024-02-28",0,0,36,0,1,57,0,0
"Thailand","2024-02-29",0,22,58,0,1,58,0,0
"Thailand","2024-03-01",0,0,58,0,0,58,0,0
"Thailand","2024-03-02",0,0,58,0,1,59,0,0
"Thailand","2024-03-03",0,0,58,0,0,59,0,0
"Thailand","2024-03-04",0,0,58,0,1,60,0,0
"Thailand","2024-03-05",0,0,58,0,0,60,0,0
"Thailand","2024-03-06",0,0,58,0,0,60,0,0
"Thailand","2024-03-07",0,0,58,0,1,61,0,0
"Thailand","2024-03-08",0,0,58,0,0,61,0,0
"Thailand","2024-03-09",0,0,58,0,0,61,0,0
"Thailand","2024-03-10",0,0,58,0,1,62,0,0
"Thailand","2024-03-11",0,0,58,0,0,62,0,0
"Thailand","2024-03-12",0,0,58,0,1,63,0,0
"Thailand","2024-03-13",0,0,58,0,0,63,0,0
"Thailand","2024-03-14",0,0,58,0,0,63,0,0
"Thailand","2024-03-15",0,0,58,0,1,64,0,0
"Thailand","2024-03-16",0,0,58,0,0,64,0,0
"Thailand","2024-03-17",0,0,58,0,1,65,0,0
"Thailand","2024-03-18",0,0,58,0,0,65,0,0
"Thailand","2024-03-19",0,0,58,0,0,65,0,0
"Thailand","2024-03-20",0,0,58,0,1,66,0,0
"Thailand","2024-03-21",0,0,58,0,0,66,0,0
"Thailand","2024-03-22",0,0,58,0,1,67,0,0
"Thailand","2024-03-23",0,0,58,0,0,67,0,0
"Thailand","2024-03-24",0,0,58,0,0,67,0,0
"Thailand","2024-03-25",0,0,58,0,1,68,0,0
"Thailand","2024-03-26",0,0,58,0,0,68,0,0
"Thailand","2024-03-27",0,0,58,0,0,68,0,0
"Thailand","2024-03-28",0,0,58,0,1,69,0,0
"Thailand","2024-03-29",0,0,58,0,0,69,0,0
"Thailand","2024-03-30",0,0,58,0,1,70,0,0
"Thailand","2024-03-31",0,12,70,0,0,70,0,0
"Thailand","2024-04-01",0,6,76,0,6,76,0,0
"Thailand","2024-04-02",0,0,76,0,0,76,0,0
"Thailand","2024-04-03",0,0,76,0,1,77,0,0
"Thailand","2024-04-04",0,0,76,0,0,77,0,0
"Thailand","2024-04-05",0,0,76,0,1,78,0,0
"Thailand","2024-04-06",0,0,76,0,0,78,0,0
"Thailand","2024-04-07",0,0,76,0,1,79,0,0
"Thailand","2024-04-08",0,0,76,0,0,79,0,0
"Thailand","2024-04-09",0,0,76,0,1,80,0,0
"Thailand","2024-04-10",0,0,76,0,0,80,0,0
"Thailand","2024-04-11",0,0,76,0,0,80,0,0
"Thailand","2024-04-12",0,0,76,0,1,81,0,0
"Thailand","2024-04-13",0,0,76,0,0,81,0,0
"Thailand","2024-04-14",0,0,76,0,1,82,0,0
"Thailand","2024-04-15",0,0,76,0,0,82,0,0
"Thailand","2024-04-16",0,0,76,0,1,83,0,0
"Thailand","2024-04-17",0,0,76,0,0,83,0,0
"Thailand","2024-04-18",0,0,76,0,1,84,0,0
"Thailand","2024-04-19",0,0,76,0,0,84,0,0
"Thailand","2024-04-20",0,0,76,0,1,85,0,0
"Thailand","2024-04-21",0,0,76,0,0,85,0,0
"Thailand","2024-04-22",0,0,76,0,0,85,0,0
"Thailand","2024-04-23",0,0,76,0,1,86,0,0
"Thailand","2024-04-24",0,0,76,0,0,86,0,0
"Thailand","2024-04-25",0,0,76,0,1,87,0,0
"Thailand","2024-04-26",0,0,76,0,0,87,0,0
"Thailand","2024-04-27",0,0,76,0,1,88,0,0
"Thailand","2024-04-28",0,0,76,0,0,88,0,0
"Thailand","2024-04-29",0,0,76,0,1,89,0,0
"Thailand","2024-04-30",0,13,89,0,0,89,0,0
"Thailand","2024-05-01",0,0,89,0,1,90,0,0
"Thailand","2024-05-02",0,0,89,0,0,90,0,0
"Thailand","2024-05-03",0,0,89,0,1,91,0,0
"Thailand","2024-05-04",0,0,89,0,1,92,0,0
"Thailand","2024-05-05",0,0,89,0,0,92,0,0
"Thailand","2024-05-06",0,0,89,0,1,93,0,0
"Thailand","2024-05-07",0,0,89,0,1,94,0,0
"Thailand","2024-05-08",0,0,89,0,0,94,0,0
"Thailand","2024-05-09",0,0,89,0,1,95,0,0
"Thailand","2024-05-10",0,0,89,0,1,96,0,0
"Thailand","2024-05-11",0,0,89,0,0,96,0,0
"Thailand","2024-05-12",0,0,89,0,1,97,0,0
"Thailand","2024-05-13",0,0,89,0,1,98,0,0
"Thailand","2024-05-14",0,0,89,0,0,98,0,0
"Thailand","2024-05-15",0,0,89,0,1,99,0,0
"Thailand","2024-05-16",0,0,89,0,1,100,0,0
"Thailand","2024-05-17",0,0,89,0,1,101,0,0
"Thailand","2024-05-18",0,0,89,0,0,101,0,0
"Thailand","2024-05-19",0,0,89,0,1,102,0,0
"Thailand","2024-05-20",0,0,89,0,1,103,0,0
"Thailand","2024-05-21",0,0,89,0,0,103,0,0
"Thailand","2024-05-22",0,0,89,0,1,104,0,0
"Thailand","2024-05-23",0,0,89,0,1,105,0,0
"Thailand","2024-05-24",0,0,89,0,0,105,0,0
"Thailand","2024-05-25",0,0,89,0,1,106,0,0
"Thailand","2024-05-26",0,0,89,0,1,107,0,0
"Thailand","2024-05-27",0,0,89,0,0,107,0,0
"Thailand","2024-05-28",0,0,89,0,1,108,0,0
"Thailand","2024-05-29",0,0,89,0,1,109,0,0
"Thailand","2024-05-30",0,0,89,0,0,109,0,0
"Thailand","2024-05-31",0,21,110,0,1,110,0,0
"Thailand","2024-06-01",0,0,110,0,0,110,0,0
"Thailand","2024-06-02",0,0,110,0,1,111,0,0
"Thailand","2024-06-03",0,0,110,0,0,111,0,0
"Thailand","2024-06-04",0,0,110,0,0,111,0,0
"Thailand","2024-06-05",0,0,110,0,1,112,0,0
"Thailand","2024-06-06",0,0,110,0,0,112,0,0
"Thailand","2024-06-07",0,0,110,0,0,112,0,0
"Thailand","2024-06-08",0,0,110,0,1,113,0,0
"Thailand","2024-06-09",0,0,110,0,0,113,0,0
"Thailand","2024-06-10",0,0,110,0,0,113,0,0
"Thailand","2024-06-11",0,0,110,0,1,114,0,0
"Thailand","2024-06-12",0,0,110,0,0,114,0,0
"Thailand","2024-06-13",0,0,110,0,0,114,0,0
"Thailand","2024-06-14",0,0,110,0,1,115,0,0
"Thailand","2024-06-15",0,0,110,0,0,115,0,0
"Thailand","2024-06-16",0,0,110,0,0,115,0,0
"Thailand","2024-06-17",0,0,110,0,1,116,0,0
"Thailand","2024-06-18",0,0,110,0,0,116,0,0
"Thailand","2024-06-19",0,0,110,0,0,116,0,0
"Thailand","2024-06-20",0,0,110,0,1,117,0,0
"Thailand","2024-06-21",0,0,110,0,0,117,0,0
"Thailand","2024-06-22",0,0,110,0,0,117,0,0
"Thailand","2024-06-23",0,0,110,0,1,118,0,0
"Thailand","2024-06-24",0,0,110,0,0,118,0,0
"Thailand","2024-06-25",0,0,110,0,0,118,0,0
"Thailand","2024-06-26",0,0,110,0,1,119,0,0
"Thailand","2024-06-27",0,0,110,0,0,119,0,0
"Thailand","2024-06-28",0,0,110,0,0,119,0,0
"Thailand","2024-06-29",0,0,110,0,1,120,0,0
"Thailand","2024-06-30",0,10,120,0,0,120,0,0
"Thailand","2024-07-01",0,0,120,0,0,120,0,0
"Thailand","2024-07-02",0,0,120,0,1,121,0,0
"Thailand","2024-07-03",0,0,120,0,0,121,0,0
"Thailand","2024-07-04",0,0,120,0,1,122,0,0
"Thailand","2024-07-05",0,0,120,0,0,122,0,0
"Thailand","2024-07-06",0,0,120,0,1,123,0,0
"Thailand","2024-07-07",0,0,120,0,0,123,0,0
"Thailand","2024-07-08",0,0,120,0,1,124,0,0
"Thailand","2024-07-09",0,0,120,0,0,124,0,0
"Thailand","2024-07-10",0,0,120,0,1,125,0,0
"Thailand","2024-07-11",0,0,120,0,0,125,0,0
"Thailand","2024-07-12",0,0,120,0,1,126,0,0
"Thailand","2024-07-13",0,0,120,0,0,126,0,0
"Thailand","2024-07-14",0,0,120,0,1,127,0,0
"Thailand","2024-07-15",0,0,120,0,0,127,0,0
"Thailand","2024-07-16",0,0,120,0,1,128,0,0
"Thailand","2024-07-17",0,0,120,0,0,128,0,0
"Thailand","2024-07-18",0,0,120,0,1,129,0,0
"Thailand","2024-07-19",0,0,120,0,0,129,0,0
"Thailand","2024-07-20",0,0,120,0,1,130,0,0
"Thailand","2024-07-21",0,0,120,0,0,130,0,0
"Thailand","2024-07-22",0,0,120,0,1,131,0,0
"Thailand","2024-07-23",0,0,120,0,0,131,0,0
"Thailand","2024-07-24",0,0,120,0,1,132,0,0
"Thailand","2024-07-25",0,0,120,0,0,132,0,0
"Thailand","2024-07-26",0,0,120,0,1,133,0,0
"Thailand","2024-07-27",0,0,120,0,0,133,0,0
"Thailand","2024-07-28",0,0,120,0,1,134,0,0
"Thailand","2024-07-29",0,0,120,0,0,134,0,0
"Thailand","2024-07-30",0,0,120,0,1,135,0,0
"Thailand","2024-07-31",0,15,135,0,0,135,0,0
"Thailand","2024-08-01",0,0,135,0,0,135,0,0
"Thailand","2024-08-02",0,0,135,0,1,136,0,0
"Thailand","2024-08-03",0,0,135,0,0,136,0,0
"Thailand","2024-08-04",0,0,135,0,1,137,0,0
"Thailand","2024-08-05",0,0,135,0,0,137,0,0
"Thailand","2024-08-06",0,0,135,0,1,138,0,0
"Thailand","2024-08-07",0,0,135,0,0,138,0,0
"Thailand","2024-08-08",0,0,135,0,0,138,0,0
"Thailand","2024-08-09",0,0,135,0,1,139,0,0
"Thailand","2024-08-10",0,0,135,0,0,139,0,0
"Thailand","2024-08-11",0,0,135,0,1,140,0,0
"Thailand","2024-08-12",0,0,135,0,0,140,0,0
"Thailand","2024-08-13",0,0,135,0,0,140,0,0
"Thailand","2024-08-14",0,0,135,0,1,141,0,0
"Thailand","2024-08-15",0,0,135,0,0,141,0,0
"Thailand","2024-08-16",0,0,135,0,1,142,0,0
"Thailand","2024-08-17",0,0,135,0,0,142,0,0
"Thailand","2024-08-18",0,0,135,0,1,143,0,0
"Thailand","2024-08-19",0,0,135,0,0,143,0,0
"Thailand","2024-08-20",0,0,135,0,0,143,0,0
"Thailand","2024-08-21",0,0,135,0,1,144,0,0
"Thailand","2024-08-22",0,0,135,0,0,144,0,0
"Thailand","2024-08-23",0,0,135,0,1,145,0,0
"Thailand","2024-08-24",0,0,135,0,0,145,0,0
"Thailand","2024-08-25",0,0,135,0,0,145,0,0
"Thailand","2024-08-26",0,0,135,0,1,146,0,0
"Thailand","2024-08-27",0,0,135,0,0,146,0,0
"Thailand","2024-08-28",0,0,135,0,1,147,0,0
"Thailand","2024-08-29",0,0,135,0,0,147,0,0
"Thailand","2024-08-30",0,0,135,0,1,148,0,0
"Thailand","2024-08-31",0,13,148,0,0,148,0,0
"Thailand","2024-09-01",0,0,148,0,0,148,0,0
"Thailand","2024-09-02",0,0,148,0,1,149,0,0
"Thailand","2024-09-03",0,0,148,0,0,149,0,0
"Thailand","2024-09-04",0,0,148,0,1,150,0,0
"Thailand","2024-09-05",0,0,148,0,0,150,0,0
"Thailand","2024-09-06",0,0,148,0,0,150,0,0
"Thailand","2024-09-07",0,0,148,0,1,151,0,0
"Thailand","2024-09-08",0,0,148,0,0,151,0,0
"Thailand","2024-09-09",0,0,148,0,1,152,0,0
"Thailand","2024-09-10",0,0,148,0,0,152,0,0
"Thailand","2024-09-11",0,0,148,0,0,152,0,0
"Thailand","2024-09-12",0,0,148,0,1,153,0,0
"Thailand","2024-09-13",0,0,148,0,0,153,0,0
"Thailand","2024-09-14",0,0,148,0,1,154,0,0
"Thailand","2024-09-15",0,0,148,0,0,154,0,0
"Thailand","2024-09-16",0,0,148,0,0,154,0,0
"Thailand","2024-09-17",0,0,148,0,1,155,0,0
"Thailand","2024-09-18",0,0,148,0,0,155,0,0
"Thailand","2024-09-19",0,0,148,0,1,156,0,0
"Thailand","2024-09-20",0,0,148,0,0,156,0,0
"Thailand","2024-09-21",0,0,148,0,0,156,0,0
"Thailand","2024-09-22",0,0,148,0,1,157,0,0
"Thailand","2024-09-23",0,0,148,0,0,157,0,0
"Thailand","2024-09-24",0,0,148,0,1,158,0,0
"Thailand","2024-09-25",0,0,148,0,0,158,0,0
"Thailand","2024-09-26",0,0,148,0,0,158,0,0
"Thailand","2024-09-27",0,0,148,0,1,159,0,0
"Thailand","2024-09-28",0,0,148,0,0,159,0,0
"Thailand","2024-09-29",0,0,148,0,1,160,0,0
"Thailand","2024-09-30",0,12,160,0,0,160,0,0
"Thailand","2024-10-01",0,0,160,0,0,160,0,0
"Thailand","2024-10-02",0,0,160,0,1,161,0,0
"Thailand","2024-10-03",0,0,160,0,0,161,0,0
"Thailand","2024-10-04",0,0,160,0,1,162,0,0
"Thailand","2024-10-05",0,0,160,0,0,162,0,0
"Thailand","2024-10-06",0,0,160,0,1,163,0,0
"Thailand","2024-10-07",0,0,160,0,0,163,0,0
"Thailand","2024-10-08",0,0,160,0,0,163,0,0
"Thailand","2024-10-09",0,0,160,0,1,164,0,0
"Thailand","2024-10-10",0,0,160,0,0,164,0,0
"Thailand","2024-10-11",0,0,160,0,1,165,0,0
"Thailand","2024-10-12",0,0,160,0,0,165,0,0
"Thailand","2024-10-13",0,0,160,0,0,165,0,0
"Thailand","2024-10-14",0,0,160,0,1,166,0,0
"Thailand","2024-10-15",0,0,160,0,0,166,0,0
"Thailand","2024-10-16",0,0,160,0,1,167,0,0
"Thailand","2024-10-17",0,0,160,0,0,167,0,0
"Thailand","2024-10-18",0,0,160,0,1,168,0,0
"Thailand","2024-10-19",0,0,160,0,0,168,0,0
"Thailand","2024-10-20",0,0,160,0,0,168,0,0
"Thailand","2024-10-21",0,0,160,0,1,169,0,0
"Thailand","2024-10-22",0,0,160,0,0,169,0,0
"Thailand","2024-10-23",0,0,160,0,1,170,0,0
"Thailand","2024-10-24",0,0,160,0,0,170,0,0
"Thailand","2024-10-25",0,0,160,0,0,170,0,0
"Thailand","2024-10-26",0,0,160,0,1,171,0,0
"Thailand","2024-10-27",0,0,160,0,0,171,0,0
"Thailand","2024-10-28",0,0,160,0,1,172,0,0
"Thailand","2024-10-29",0,0,160,0,0,172,0,0
"Thailand","2024-10-30",0,0,160,0,1,173,0,0
"Thailand","2024-10-31",0,13,173,0,0,173,0,0
"Thailand","2024-11-01",0,0,173,0,0,173,0,0
"Thailand","2024-11-02",0,0,173,0,0,173,0,0
"Thailand","2024-11-03",0,0,173,0,1,174,0,0
"Thailand","2024-11-04",0,0,173,0,0,174,0,0
"Thailand","2024-11-05",0,0,173,0,0,174,0,0
"Thailand","2024-11-06",0,0,173,0,0,174,0,0
"Thailand","2024-11-07",0,0,173,0,1,175,0,0
"Thailand","2024-11-08",0,0,173,0,0,175,0,0
"Thailand","2024-11-09",0,0,173,0,0,175,0,0
"Thailand","2024-11-10",0,0,173,0,0,175,0,0
"Thailand","2024-11-11",0,0,173,0,1,176,0,0
"Thailand","2024-11-12",0,0,173,0,0,176,0,0
"Thailand","2024-11-13",0,0,173,0,0,176,0,0
"Thailand","2024-11-14",0,0,173,0,0,176,0,0
"Thailand","2024-11-15",0,0,173,0,1,177,0,0
"Thailand","2024-11-16",0,0,173,0,0,177,0,0
"Thailand","2024-11-17",0,0,173,0,0,177,0,0
"Thailand","2024-11-18",0,0,173,0,0,177,0,0
"Thailand","2024-11-19",0,0,173,0,0,177,0,0
"Thailand","2024-11-20",0,0,173,0,1,178,0,0
"Thailand","2024-11-21",0,0,173,0,0,178,0,0
"Thailand","2024-11-22",0,0,173,0,0,178,0,0
"Thailand","2024-11-23",0,0,173,0,0,178,0,0
"Thailand","2024-11-24",0,0,173,0,1,179,0,0
"Thailand","2024-11-25",0,0,173,0,0,179,0,0
"Thailand","2024-11-26",0,0,173,0,0,179,0,0
"Thailand","2024-11-27",0,0,173,0,0,179,0,0
"Thailand","2024-11-28",0,0,173,0,1,180,0,0
"Thailand","2024-11-29",0,0,173,0,0,180,0,0
"Thailand","2024-11-30",0,7,180,0,0,180,0,0
"Thailand","2024-12-01",0,0,180,0,0,180,0,0
"Thailand","2024-12-02",0,0,180,0,0,180,0,0
"Thailand","2024-12-03",0,0,180,0,0,180,0,0
"Thailand","2024-12-04",0,0,180,0,0,180,0,0
"Thailand","2024-12-05",0,0,180,0,0,180,0,0
"Thailand","2024-12-06",0,0,180,0,0,180,0,0
"Thailand","2024-12-07",0,0,180,0,0,180,0,0
"Thailand","2024-12-08",0,0,180,0,0,180,0,0
"Thailand","2024-12-09",0,0,180,0,0,180,0,0
"Thailand","2024-12-10",0,0,180,0,0,180,0,0
"Thailand","2024-12-11",0,0,180,0,0,180,0,0
"Thailand","2024-12-12",0,0,180,0,0,180,0,0
"Thailand","2024-12-13",0,0,180,0,0,180,0,0
"Thailand","2024-12-14",0,0,180,0,0,180,0,0
"Thailand","2024-12-15",0,0,180,0,0,180,0,0
"Thailand","2024-12-16",0,0,180,0,0,180,0,0
"Thailand","2024-12-17",0,0,180,0,0,180,0,0
"Thailand","2024-12-18",0,0,180,0,0,180,0,0
"Thailand","2024-12-19",0,0,180,0,0,180,0,0
"Thailand","2024-12-20",0,0,180,0,0,180,0,0
"Thailand","2024-12-21",0,0,180,0,0,180,0,0
"Thailand","2024-12-22",0,0,180,0,0,180,0,0
"Thailand","2024-12-23",0,0,180,0,0,180,0,0
"Thailand","2024-12-24",0,0,180,0,0,180,0,0
"Thailand","2024-12-25",0,0,180,0,0,180,0,0
"Thailand","2024-12-26",0,0,180,0,0,180,0,0
"Thailand","2024-12-27",0,0,180,0,0,180,0,0
"Thailand","2024-12-28",0,0,180,0,0,180,0,0
"Thailand","2024-12-29",0,0,180,0,0,180,0,0
"Thailand","2024-12-30",0,0,180,0,0,180,0,0
"Thailand","2024-12-31",0,0,180,0,0,180,0,0
"Thailand","2025-01-01",0,0,180,0,0,180,0,0
"Thailand","2025-01-02",0,0,180,0,0,180,0,0
"Thailand","2025-01-03",0,0,180,0,0,180,0,0
"Thailand","2025-01-04",0,0,180,0,0,180,0,0
"Thailand","2025-01-05",0,0,180,0,0,180,0,0
"Thailand","2025-01-06",0,0,180,0,0,180,0,0
"Thailand","2025-01-07",0,0,180,0,0,180,0,0
"Thailand","2025-01-08",0,0,180,0,0,180,0,0
"Thailand","2025-01-09",0,0,180,0,0,180,0,0
"Thailand","2025-01-10",0,0,180,0,0,180,0,0
"Thailand","2025-01-11",0,0,180,0,0,180,0,0
"Thailand","2025-01-12",0,0,180,0,0,180,0,0
"Thailand","2025-01-13",0,0,180,0,0,180,0,0
"Trinidad and Tobago","2024-01-01",0,0,0,0,0,0,0,0
"Trinidad and Tobago","2024-01-02",0,0,0,0,0,0,0,0
"Trinidad and Tobago","2024-01-03",0,0,0,0,0,0,0,0
"Trinidad and Tobago","2024-01-04",0,0,0,0,0,0,0,0
"Trinidad and Tobago","2024-01-05",0,0,0,0,0,0,0,0
"Trinidad and Tobago","2024-01-06",0,0,0,0,0,0,0,0
"Trinidad and Tobago","2024-01-07",0,0,0,0,0,0,0,0
"Trinidad and Tobago","2024-01-08",0,0,0,0,0,0,0,0
"Trinidad and Tobago","2024-01-09",0,0,0,0,0,0,0,0
"Trinidad and Tobago","2024-01-10",0,0,0,0,0,0,0,0
"Trinidad and Tobago","2024-01-11",0,0,0,0,0,0,0,0
"Trinidad and Tobago","2024-01-12",0,0,0,0,0,0,0,0
"Trinidad and Tobago","2024-01-13",0,0,0,0,0,0,0,0
"Trinidad and Tobago","2024-01-14",0,0,0,0,0,0,0,0
"Trinidad and Tobago","2024-01-15",0,0,0,0,0,0,0,0
"Trinidad and Tobago","2024-01-16",0,0,0,0,0,0,0,0
"Trinidad and Tobago","2024-01-17",0,0,0,0,0,0,0,0
"Trinidad and Tobago","2024-01-18",0,0,0,0,0,0,0,0
"Trinidad and Tobago","2024-01-19",0,0,0,0,0,0,0,0
"Trinidad and Tobago","2024-01-20",0,0,0,0,0,0,0,0
"Trinidad and Tobago","2024-01-21",0,0,0,0,0,0,0,0
"Trinidad and Tobago","2024-01-22",0,0,0,0,0,0,0,0
"Trinidad and Tobago","2024-01-23",0,0,0,0,0,0,0,0
"Trinidad and Tobago","2024-01-24",0,0,0,0,0,0,0,0
"Trinidad and Tobago","2024-01-25",0,0,0,0,0,0,0,0
"Trinidad and Tobago","2024-01-26",0,0,0,0,0,0,0,0
"Trinidad and Tobago","2024-01-27",0,0,0,0,0,0,0,0
"Trinidad and Tobago","2024-01-28",0,0,0,0,0,0,0,0
"Trinidad and Tobago","2024-01-29",0,0,0,0,0,0,0,0
"Trinidad and Tobago","2024-01-30",0,0,0,0,0,0,0,0
"Trinidad and Tobago","2024-01-31",0,0,0,0,0,0,0,0
"Trinidad and Tobago","2024-02-01",0,0,0,0,0,0,0,0
"Trinidad and Tobago","2024-02-02",0,0,0,0,0,0,0,0
"Trinidad and Tobago","2024-02-03",0,0,0,0,0,0,0,0
"Trinidad and Tobago","2024-02-04",0,0,0,0,0,0,0,0
"Trinidad and Tobago","2024-02-05",0,0,0,0,0,0,0,0
"Trinidad and Tobago","2024-02-06",0,0,0,0,0,0,0,0
"Trinidad and Tobago","2024-02-07",0,0,0,0,0,0,0,0
"Trinidad and Tobago","2024-02-08",0,0,0,0,0,0,0,0
"Trinidad and Tobago","2024-02-09",0,0,0,0,0,0,0,0
"Trinidad and Tobago","2024-02-10",0,0,0,0,0,0,0,0
"Trinidad and Tobago","2024-02-11",0,0,0,0,0,0,0,0
"Trinidad and Tobago","2024-02-12",0,0,0,0,0,0,0,0
"Trinidad and Tobago","2024-02-13",0,0,0,0,0,0,0,0
"Trinidad and Tobago","2024-02-14",0,0,0,0,0,0,0,0
"Trinidad and Tobago","2024-02-15",0,0,0,0,0,0,0,0
"Trinidad and Tobago","2024-02-16",0,0,0,0,0,0,0,0
"Trinidad and Tobago","2024-02-17",0,0,0,0,0,0,0,0
"Trinidad and Tobago","2024-02-18",0,0,0,0,0,0,0,0
"Trinidad and Tobago","2024-02-19",0,0,0,0,0,0,0,0
"Trinidad and Tobago","2024-02-20",0,0,0,0,0,0,0,0
"Trinidad and Tobago","2024-02-21",0,0,0,0,0,0,0,0
"Trinidad and Tobago","2024-02-22",0,0,0,0,0,0,0,0
"Trinidad and Tobago","2024-02-23",0,0,0,0,0,0,0,0
"Trinidad and Tobago","2024-02-24",0,0,0,0,0,0,0,0
"Trinidad and Tobago","2024-02-25",0,0,0,0,0,0,0,0
"Trinidad and Tobago","2024-02-26",0,0,0,0,0,0,0,0
"Trinidad and Tobago","2024-02-27",0,0,0,0,0,0,0,0
"Trinidad and Tobago","2024-02-28",0,0,0,0,0,0,0,0
"Trinidad and Tobago","2024-02-29",0,0,0,0,0,0,0,0
"Trinidad and Tobago","2024-03-01",0,0,0,0,0,0,0,0
"Trinidad and Tobago","2024-03-02",0,0,0,0,0,0,0,0
"Trinidad and Tobago","2024-03-03",0,0,0,0,0,0,0,0
"Trinidad and Tobago","2024-03-04",0,0,0,0,0,0,0,0
"Trinidad and Tobago","2024-03-05",0,0,0,0,0,0,0,0
"Trinidad and Tobago","2024-03-06",0,0,0,0,0,0,0,0
"Trinidad and Tobago","2024-03-07",0,0,0,0,0,0,0,0
"Trinidad and Tobago","2024-03-08",0,0,0,0,0,0,0,0
"Trinidad and Tobago","2024-03-09",0,0,0,0,0,0,0,0
"Trinidad and Tobago","2024-03-10",0,0,0,0,0,0,0,0
"Trinidad and Tobago","2024-03-11",0,0,0,0,0,0,0,0
"Trinidad and Tobago","2024-03-12",0,0,0,0,0,0,0,0
"Trinidad and Tobago","2024-03-13",0,0,0,0,0,0,0,0
"Trinidad and Tobago","2024-03-14",0,0,0,0,0,0,0,0
"Trinidad and Tobago","2024-03-15",0,0,0,0,0,0,0,0
"Trinidad and Tobago","2024-03-16",0,0,0,0,0,0,0,0
"Trinidad and Tobago","2024-03-17",0,0,0,0,0,0,0,0
"Trinidad and Tobago","2024-03-18",0,0,0,0,0,0,0,0
"Trinidad and Tobago","2024-03-19",0,0,0,0,0,0,0,0
"Trinidad and Tobago","2024-03-20",0,0,0,0,0,0,0,0
"Trinidad and Tobago","2024-03-21",0,0,0,0,0,0,0,0
"Trinidad and Tobago","2024-03-22",0,0,0,0,0,0,0,0
"Trinidad and Tobago","2024-03-23",0,0,0,0,0,0,0,0
"Trinidad and Tobago","2024-03-24",0,0,0,0,0,0,0,0
"Trinidad and Tobago","2024-03-25",0,0,0,0,0,0,0,0
"Trinidad and Tobago","2024-03-26",0,0,0,0,0,0,0,0
"Trinidad and Tobago","2024-03-27",0,0,0,0,0,0,0,0
"Trinidad and Tobago","2024-03-28",0,0,0,0,0,0,0,0
"Trinidad and Tobago","2024-03-29",0,0,0,0,0,0,0,0
"Trinidad and Tobago","2024-03-30",0,0,0,0,0,0,0,0
"Trinidad and Tobago","2024-03-31",0,0,0,0,0,0,0,0
"Trinidad and Tobago","2024-04-01",0,0,0,0,0,0,0,0
"Trinidad and Tobago","2024-04-02",0,0,0,0,0,0,0,0
"Trinidad and Tobago","2024-04-03",0,0,0,0,0,0,0,0
"Trinidad and Tobago","2024-04-04",0,0,0,0,0,0,0,0
"Trinidad and Tobago","2024-04-05",0,0,0,0,0,0,0,0
"Trinidad and Tobago","2024-04-06",0,0,0,0,0,0,0,0
"Trinidad and Tobago","2024-04-07",0,0,0,0,0,0,0,0
"Trinidad and Tobago","2024-04-08",0,0,0,0,0,0,0,0
"Trinidad and Tobago","2024-04-09",0,0,0,0,0,0,0,0
"Trinidad and Tobago","2024-04-10",0,0,0,0,0,0,0,0
"Trinidad and Tobago","2024-04-11",0,0,0,0,0,0,0,0
"Trinidad and Tobago","2024-04-12",0,0,0,0,0,0,0,0
"Trinidad and Tobago","2024-04-13",0,0,0,0,0,0,0,0
"Trinidad and Tobago","2024-04-14",0,0,0,0,0,0,0,0
"Trinidad and Tobago","2024-04-15",0,0,0,0,0,0,0,0
"Trinidad and Tobago","2024-04-16",0,0,0,0,0,0,0,0
"Trinidad and Tobago","2024-04-17",0,0,0,0,0,0,0,0
"Trinidad and Tobago","2024-04-18",0,0,0,0,0,0,0,0
"Trinidad and Tobago","2024-04-19",0,0,0,0,0,0,0,0
"Trinidad and Tobago","2024-04-20",0,0,0,0,0,0,0,0
"Trinidad and Tobago","2024-04-21",0,0,0,0,0,0,0,0
"Trinidad and Tobago","2024-04-22",0,0,0,0,0,0,0,0
"Trinidad and Tobago","2024-04-23",0,0,0,0,0,0,0,0
"Trinidad and Tobago","2024-04-24",0,0,0,0,0,0,0,0
"Trinidad and Tobago","2024-04-25",0,0,0,0,0,0,0,0
"Trinidad and Tobago","2024-04-26",0,0,0,0,0,0,0,0
"Trinidad and Tobago","2024-04-27",0,0,0,0,0,0,0,0
"Trinidad and Tobago","2024-04-28",0,0,0,0,0,0,0,0
"Trinidad and Tobago","2024-04-29",0,0,0,0,0,0,0,0
"Trinidad and Tobago","2024-04-30",0,0,0,0,0,0,0,0
"Trinidad and Tobago","2024-05-01",0,0,0,0,0,0,0,0
"Trinidad and Tobago","2024-05-02",0,0,0,0,0,0,0,0
"Trinidad and Tobago","2024-05-03",0,0,0,0,0,0,0,0
"Trinidad and Tobago","2024-05-04",0,0,0,0,0,0,0,0
"Trinidad and Tobago","2024-05-05",0,0,0,0,0,0,0,0
"Trinidad and Tobago","2024-05-06",0,0,0,0,0,0,0,0
"Trinidad and Tobago","2024-05-07",0,0,0,0,0,0,0,0
"Trinidad and Tobago","2024-05-08",0,0,0,0,0,0,0,0
"Trinidad and Tobago","2024-05-09",0,0,0,0,0,0,0,0
"Trinidad and Tobago","2024-05-10",0,0,0,0,0,0,0,0
"Trinidad and Tobago","2024-05-11",0,0,0,0,0,0,0,0
"Trinidad and Tobago","2024-05-12",0,0,0,0,0,0,0,0
"Trinidad and Tobago","2024-05-13",0,0,0,0,0,0,0,0
"Trinidad and Tobago","2024-05-14",0,0,0,0,0,0,0,0
"Trinidad and Tobago","2024-05-15",0,0,0,0,0,0,0,0
"Trinidad and Tobago","2024-05-16",0,0,0,0,0,0,0,0
"Trinidad and Tobago","2024-05-17",0,0,0,0,0,0,0,0
"Trinidad and Tobago","2024-05-18",0,0,0,0,0,0,0,0
"Trinidad and Tobago","2024-05-19",0,0,0,0,0,0,0,0
"Trinidad and Tobago","2024-05-20",0,0,0,0,0,0,0,0
"Trinidad and Tobago","2024-05-21",0,0,0,0,0,0,0,0
"Trinidad and Tobago","2024-05-22",0,0,0,0,0,0,0,0
"Trinidad and Tobago","2024-05-23",0,0,0,0,0,0,0,0
"Trinidad and Tobago","2024-05-24",0,0,0,0,0,0,0,0
"Trinidad and Tobago","2024-05-25",0,0,0,0,0,0,0,0
"Trinidad and Tobago","2024-05-26",0,0,0,0,0,0,0,0
"Trinidad and Tobago","2024-05-27",0,0,0,0,0,0,0,0
"Trinidad and Tobago","2024-05-28",0,0,0,0,0,0,0,0
"Trinidad and Tobago","2024-05-29",0,0,0,0,0,0,0,0
"Trinidad and Tobago","2024-05-30",0,0,0,0,0,0,0,0
"Trinidad and Tobago","2024-05-31",0,0,0,0,0,0,0,0
"Trinidad and Tobago","2024-06-01",0,0,0,0,0,0,0,0
"Trinidad and Tobago","2024-06-02",0,0,0,0,0,0,0,0
"Trinidad and Tobago","2024-06-03",0,0,0,0,0,0,0,0
"Trinidad and Tobago","2024-06-04",0,0,0,0,0,0,0,0
"Trinidad and Tobago","2024-06-05",0,0,0,0,0,0,0,0
"Trinidad and Tobago","2024-06-06",0,0,0,0,0,0,0,0
"Trinidad and Tobago","2024-06-07",0,0,0,0,0,0,0,0
"Trinidad and Tobago","2024-06-08",0,0,0,0,0,0,0,0
"Trinidad and Tobago","2024-06-09",0,0,0,0,0,0,0,0
"Trinidad and Tobago","2024-06-10",0,0,0,0,0,0,0,0
"Trinidad and Tobago","2024-06-11",0,0,0,0,0,0,0,0
"Trinidad and Tobago","2024-06-12",0,0,0,0,0,0,0,0
"Trinidad and Tobago","2024-06-13",0,0,0,0,0,0,0,0
"Trinidad and Tobago","2024-06-14",0,0,0,0,0,0,0,0
"Trinidad and Tobago","2024-06-15",0,0,0,0,0,0,0,0
"Trinidad and Tobago","2024-06-16",0,0,0,0,0,0,0,0
"Trinidad and Tobago","2024-06-17",0,0,0,0,0,0,0,0
"Trinidad and Tobago","2024-06-18",0,0,0,0,0,0,0,0
"Trinidad and Tobago","2024-06-19",0,0,0,0,0,0,0,0
"Trinidad and Tobago","2024-06-20",0,0,0,0,0,0,0,0
"Trinidad and Tobago","2024-06-21",0,0,0,0,0,0,0,0
"Trinidad and Tobago","2024-06-22",0,0,0,0,0,0,0,0
"Trinidad and Tobago","2024-06-23",0,0,0,0,0,0,0,0
"Trinidad and Tobago","2024-06-24",0,0,0,0,0,0,0,0
"Trinidad and Tobago","2024-06-25",0,0,0,0,0,0,0,0
"Trinidad and Tobago","2024-06-26",0,0,0,0,0,0,0,0
"Trinidad and Tobago","2024-06-27",0,0,0,0,0,0,0,0
"Trinidad and Tobago","2024-06-28",0,0,0,0,0,0,0,0
"Trinidad and Tobago","2024-06-29",0,0,0,0,0,0,0,0
"Trinidad and Tobago","2024-06-30",0,0,0,0,0,0,0,0
"Trinidad and Tobago","2024-07-01",0,0,0,0,0,0,0,0
"Trinidad and Tobago","2024-07-02",0,0,0,0,0,0,0,0
"Trinidad and Tobago","2024-07-03",0,0,0,0,0,0,0,0
"Trinidad and Tobago","2024-07-04",0,0,0,0,0,0,0,0
"Trinidad and Tobago","2024-07-05",0,0,0,0,0,0,0,0
"Trinidad and Tobago","2024-07-06",0,0,0,0,0,0,0,0
"Trinidad and Tobago","2024-07-07",0,0,0,0,0,0,0,0
"Trinidad and Tobago","2024-07-08",0,0,0,0,0,0,0,0
"Trinidad and Tobago","2024-07-09",0,0,0,0,0,0,0,0
"Trinidad and Tobago","2024-07-10",0,0,0,0,0,0,0,0
"Trinidad and Tobago","2024-07-11",0,0,0,0,0,0,0,0
"Trinidad and Tobago","2024-07-12",0,0,0,0,0,0,0,0
"Trinidad and Tobago","2024-07-13",0,0,0,0,0,0,0,0
"Trinidad and Tobago","2024-07-14",0,0,0,0,0,0,0,0
"Trinidad and Tobago","2024-07-15",0,0,0,0,0,0,0,0
"Trinidad and Tobago","2024-07-16",0,0,0,0,0,0,0,0
"Trinidad and Tobago","2024-07-17",0,0,0,0,0,0,0,0
"Trinidad and Tobago","2024-07-18",0,0,0,0,0,0,0,0
"Trinidad and Tobago","2024-07-19",0,0,0,0,0,0,0,0
"Trinidad and Tobago","2024-07-20",0,0,0,0,0,0,0,0
"Trinidad and Tobago","2024-07-21",0,0,0,0,0,0,0,0
"Trinidad and Tobago","2024-07-22",0,0,0,0,0,0,0,0
"Trinidad and Tobago","2024-07-23",0,0,0,0,0,0,0,0
"Trinidad and Tobago","2024-07-24",0,0,0,0,0,0,0,0
"Trinidad and Tobago","2024-07-25",0,0,0,0,0,0,0,0
"Trinidad and Tobago","2024-07-26",0,0,0,0,0,0,0,0
"Trinidad and Tobago","2024-07-27",0,0,0,0,0,0,0,0
"Trinidad and Tobago","2024-07-28",0,0,0,0,0,0,0,0
"Trinidad and Tobago","2024-07-29",0,0,0,0,0,0,0,0
"Trinidad and Tobago","2024-07-30",0,0,0,0,0,0,0,0
"Trinidad and Tobago","2024-07-31",0,0,0,0,0,0,0,0
"Trinidad and Tobago","2024-08-01",0,0,0,0,0,0,0,0
"Trinidad and Tobago","2024-08-02",0,0,0,0,0,0,0,0
"Trinidad and Tobago","2024-08-03",0,0,0,0,0,0,0,0
"Trinidad and Tobago","2024-08-04",0,0,0,0,0,0,0,0
"Trinidad and Tobago","2024-08-05",0,0,0,0,0,0,0,0
"Trinidad and Tobago","2024-08-06",0,0,0,0,0,0,0,0
"Trinidad and Tobago","2024-08-07",0,0,0,0,0,0,0,0
"Trinidad and Tobago","2024-08-08",0,0,0,0,0,0,0,0
"Trinidad and Tobago","2024-08-09",0,0,0,0,0,0,0,0
"Trinidad and Tobago","2024-08-10",0,0,0,0,0,0,0,0
"Trinidad and Tobago","2024-08-11",0,0,0,0,0,0,0,0
"Trinidad and Tobago","2024-08-12",0,0,0,0,0,0,0,0
"Trinidad and Tobago","2024-08-13",0,0,0,0,0,0,0,0
"Trinidad and Tobago","2024-08-14",0,0,0,0,0,0,0,0
"Trinidad and Tobago","2024-08-15",0,0,0,0,0,0,0,0
"Trinidad and Tobago","2024-08-16",0,0,0,0,0,0,0,0
"Trinidad and Tobago","2024-08-17",0,0,0,0,0,0,0,0
"Trinidad and Tobago","2024-08-18",0,0,0,0,0,0,0,0
"Trinidad and Tobago","2024-08-19",0,0,0,0,0,0,0,0
"Trinidad and Tobago","2024-08-20",0,0,0,0,0,0,0,0
"Trinidad and Tobago","2024-08-21",0,0,0,0,0,0,0,0
"Trinidad and Tobago","2024-08-22",0,0,0,0,0,0,0,0
"Trinidad and Tobago","2024-08-23",0,0,0,0,0,0,0,0
"Trinidad and Tobago","2024-08-24",0,0,0,0,0,0,0,0
"Trinidad and Tobago","2024-08-25",0,0,0,0,0,0,0,0
"Trinidad and Tobago","2024-08-26",0,0,0,0,0,0,0,0
"Trinidad and Tobago","2024-08-27",0,0,0,0,0,0,0,0
"Trinidad and Tobago","2024-08-28",0,0,0,0,0,0,0,0
"Trinidad and Tobago","2024-08-29",0,0,0,0,0,0,0,0
"Trinidad and Tobago","2024-08-30",0,0,0,0,0,0,0,0
"Trinidad and Tobago","2024-08-31",0,0,0,0,0,0,0,0
"Trinidad and Tobago","2024-09-01",0,0,0,0,0,0,0,0
"Trinidad and Tobago","2024-09-02",0,0,0,0,0,0,0,0
"Trinidad and Tobago","2024-09-03",0,0,0,0,0,0,0,0
"Trinidad and Tobago","2024-09-04",0,0,0,0,0,0,0,0
"Trinidad and Tobago","2024-09-05",0,0,0,0,0,0,0,0
"Trinidad and Tobago","2024-09-06",0,0,0,0,0,0,0,0
"Trinidad and Tobago","2024-09-07",0,0,0,0,0,0,0,0
"Trinidad and Tobago","2024-09-08",0,0,0,0,0,0,0,0
"Trinidad and Tobago","2024-09-09",0,0,0,0,0,0,0,0
"Trinidad and Tobago","2024-09-10",0,0,0,0,0,0,0,0
"Trinidad and Tobago","2024-09-11",0,0,0,0,0,0,0,0
"Trinidad and Tobago","2024-09-12",0,0,0,0,0,0,0,0
"Trinidad and Tobago","2024-09-13",0,0,0,0,0,0,0,0
"Trinidad and Tobago","2024-09-14",0,0,0,0,0,0,0,0
"Trinidad and Tobago","2024-09-15",0,0,0,0,0,0,0,0
"Trinidad and Tobago","2024-09-16",0,0,0,0,0,0,0,0
"Trinidad and Tobago","2024-09-17",0,0,0,0,0,0,0,0
"Trinidad and Tobago","2024-09-18",0,0,0,0,0,0,0,0
"Trinidad and Tobago","2024-09-19",0,0,0,0,0,0,0,0
"Trinidad and Tobago","2024-09-20",0,0,0,0,0,0,0,0
"Trinidad and Tobago","2024-09-21",0,0,0,0,0,0,0,0
"Trinidad and Tobago","2024-09-22",0,0,0,0,0,0,0,0
"Trinidad and Tobago","2024-09-23",0,0,0,0,0,0,0,0
"Trinidad and Tobago","2024-09-24",0,0,0,0,0,0,0,0
"Trinidad and Tobago","2024-09-25",0,0,0,0,0,0,0,0
"Trinidad and Tobago","2024-09-26",0,0,0,0,0,0,0,0
"Trinidad and Tobago","2024-09-27",0,0,0,0,0,0,0,0
"Trinidad and Tobago","2024-09-28",0,0,0,0,0,0,0,0
"Trinidad and Tobago","2024-09-29",0,0,0,0,0,0,0,0
"Trinidad and Tobago","2024-09-30",0,0,0,0,0,0,0,0
"Trinidad and Tobago","2024-10-01",0,0,0,0,0,0,0,0
"Trinidad and Tobago","2024-10-02",0,0,0,0,0,0,0,0
"Trinidad and Tobago","2024-10-03",0,0,0,0,0,0,0,0
"Trinidad and Tobago","2024-10-04",0,0,0,0,0,0,0,0
"Trinidad and Tobago","2024-10-05",0,0,0,0,0,0,0,0
"Trinidad and Tobago","2024-10-06",0,0,0,0,0,0,0,0
"Trinidad and Tobago","2024-10-07",0,0,0,0,0,0,0,0
"Trinidad and Tobago","2024-10-08",0,0,0,0,0,0,0,0
"Trinidad and Tobago","2024-10-09",0,0,0,0,0,0,0,0
"Trinidad and Tobago","2024-10-10",0,0,0,0,0,0,0,0
"Trinidad and Tobago","2024-10-11",0,0,0,0,0,0,0,0
"Trinidad and Tobago","2024-10-12",0,0,0,0,0,0,0,0
"Trinidad and Tobago","2024-10-13",0,0,0,0,0,0,0,0
"Trinidad and Tobago","2024-10-14",0,0,0,0,0,0,0,0
"Trinidad and Tobago","2024-10-15",0,0,0,0,0,0,0,0
"Trinidad and Tobago","2024-10-16",0,0,0,0,0,0,0,0
"Trinidad and Tobago","2024-10-17",0,0,0,0,0,0,0,0
"Trinidad and Tobago","2024-10-18",0,0,0,0,0,0,0,0
"Trinidad and Tobago","2024-10-19",0,0,0,0,0,0,0,0
"Trinidad and Tobago","2024-10-20",0,0,0,0,0,0,0,0
"Trinidad and Tobago","2024-10-21",0,0,0,0,0,0,0,0
"Trinidad and Tobago","2024-10-22",0,0,0,0,0,0,0,0
"Trinidad and Tobago","2024-10-23",0,0,0,0,0,0,0,0
"Trinidad and Tobago","2024-10-24",0,0,0,0,0,0,0,0
"Trinidad and Tobago","2024-10-25",0,0,0,0,0,0,0,0
"Trinidad and Tobago","2024-10-26",0,0,0,0,0,0,0,0
"Trinidad and Tobago","2024-10-27",0,0,0,0,0,0,0,0
"Trinidad and Tobago","2024-10-28",0,0,0,0,0,0,0,0
"Trinidad and Tobago","2024-10-29",0,0,0,0,0,0,0,0
"Trinidad and Tobago","2024-10-30",0,0,0,0,0,0,0,0
"Trinidad and Tobago","2024-10-31",0,0,0,0,0,0,0,0
"Trinidad and Tobago","2024-11-01",0,0,0,0,0,0,0,0
"Trinidad and Tobago","2024-11-02",0,0,0,0,0,0,0,0
"Trinidad and Tobago","2024-11-03",0,0,0,0,0,0,0,0
"Trinidad and Tobago","2024-11-04",0,0,0,0,0,0,0,0
"Trinidad and Tobago","2024-11-05",0,0,0,0,0,0,0,0
"Trinidad and Tobago","2024-11-06",0,0,0,0,0,0,0,0
"Trinidad and Tobago","2024-11-07",0,0,0,0,0,0,0,0
"Trinidad and Tobago","2024-11-08",0,0,0,0,0,0,0,0
"Trinidad and Tobago","2024-11-09",0,0,0,0,0,0,0,0
"Trinidad and Tobago","2024-11-10",0,0,0,0,0,0,0,0
"Trinidad and Tobago","2024-11-11",0,0,0,0,0,0,0,0
"Trinidad and Tobago","2024-11-12",0,0,0,0,0,0,0,0
"Trinidad and Tobago","2024-11-13",0,0,0,0,0,0,0,0
"Trinidad and Tobago","2024-11-14",0,0,0,0,0,0,0,0
"Trinidad and Tobago","2024-11-15",0,0,0,0,0,0,0,0
"Trinidad and Tobago","2024-11-16",0,0,0,0,0,0,0,0
"Trinidad and Tobago","2024-11-17",0,0,0,0,0,0,0,0
"Trinidad and Tobago","2024-11-18",0,0,0,0,0,0,0,0
"Trinidad and Tobago","2024-11-19",0,0,0,0,0,0,0,0
"Trinidad and Tobago","2024-11-20",0,0,0,0,0,0,0,0
"Trinidad and Tobago","2024-11-21",0,0,0,0,0,0,0,0
"Trinidad and Tobago","2024-11-22",0,0,0,0,0,0,0,0
"Trinidad and Tobago","2024-11-23",0,0,0,0,0,0,0,0
"Trinidad and Tobago","2024-11-24",0,0,0,0,0,0,0,0
"Trinidad and Tobago","2024-11-25",0,0,0,0,0,0,0,0
"Trinidad and Tobago","2024-11-26",0,0,0,0,0,0,0,0
"Trinidad and Tobago","2024-11-27",0,0,0,0,0,0,0,0
"Trinidad and Tobago","2024-11-28",0,0,0,0,0,0,0,0
"Trinidad and Tobago","2024-11-29",0,0,0,0,0,0,0,0
"Trinidad and Tobago","2024-11-30",0,0,0,0,0,0,0,0
"Trinidad and Tobago","2024-12-01",0,0,0,0,0,0,0,0
"Trinidad and Tobago","2024-12-02",0,0,0,0,0,0,0,0
"Trinidad and Tobago","2024-12-03",0,0,0,0,0,0,0,0
"Trinidad and Tobago","2024-12-04",0,0,0,0,0,0,0,0
"Trinidad and Tobago","2024-12-05",0,0,0,0,0,0,0,0
"Trinidad and Tobago","2024-12-06",0,0,0,0,0,0,0,0
"Trinidad and Tobago","2024-12-07",0,0,0,0,0,0,0,0
"Trinidad and Tobago","2024-12-08",0,0,0,0,0,0,0,0
"Trinidad and Tobago","2024-12-09",0,0,0,0,0,0,0,0
"Trinidad and Tobago","2024-12-10",0,0,0,0,0,0,0,0
"Trinidad and Tobago","2024-12-11",0,0,0,0,0,0,0,0
"Trinidad and Tobago","2024-12-12",0,0,0,0,0,0,0,0
"Trinidad and Tobago","2024-12-13",0,0,0,0,0,0,0,0
"Trinidad and Tobago","2024-12-14",0,0,0,0,0,0,0,0
"Trinidad and Tobago","2024-12-15",0,0,0,0,0,0,0,0
"Trinidad and Tobago","2024-12-16",0,0,0,0,0,0,0,0
"Trinidad and Tobago","2024-12-17",0,0,0,0,0,0,0,0
"Trinidad and Tobago","2024-12-18",0,0,0,0,0,0,0,0
"Trinidad and Tobago","2024-12-19",0,0,0,0,0,0,0,0
"Trinidad and Tobago","2024-12-20",0,0,0,0,0,0,0,0
"Trinidad and Tobago","2024-12-21",0,0,0,0,0,0,0,0
"Trinidad and Tobago","2024-12-22",0,0,0,0,0,0,0,0
"Trinidad and Tobago","2024-12-23",0,0,0,0,0,0,0,0
"Trinidad and Tobago","2024-12-24",0,0,0,0,0,0,0,0
"Trinidad and Tobago","2024-12-25",0,0,0,0,0,0,0,0
"Trinidad and Tobago","2024-12-26",0,0,0,0,0,0,0,0
"Trinidad and Tobago","2024-12-27",0,0,0,0,0,0,0,0
"Trinidad and Tobago","2024-12-28",0,0,0,0,0,0,0,0
"Trinidad and Tobago","2024-12-29",0,0,0,0,0,0,0,0
"Trinidad and Tobago","2024-12-30",0,0,0,0,0,0,0,0
"Trinidad and Tobago","2024-12-31",0,0,0,0,0,0,0,0
"Trinidad and Tobago","2025-01-01",0,0,0,0,0,0,0,0
"Trinidad and Tobago","2025-01-02",0,0,0,0,0,0,0,0
"Trinidad and Tobago","2025-01-03",0,0,0,0,0,0,0,0
"Trinidad and Tobago","2025-01-04",0,0,0,0,0,0,0,0
"Trinidad and Tobago","2025-01-05",0,0,0,0,0,0,0,0
"Trinidad and Tobago","2025-01-06",0,0,0,0,0,0,0,0
"Trinidad and Tobago","2025-01-07",0,0,0,0,0,0,0,0
"Trinidad and Tobago","2025-01-08",0,0,0,0,0,0,0,0
"Trinidad and Tobago","2025-01-09",0,0,0,0,0,0,0,0
"Trinidad and Tobago","2025-01-10",0,0,0,0,0,0,0,0
"Trinidad and Tobago","2025-01-11",0,0,0,0,0,0,0,0
"Trinidad and Tobago","2025-01-12",0,0,0,0,0,0,0,0
"Trinidad and Tobago","2025-01-13",0,0,0,0,0,0,0,0
"Türkiye","2024-01-01",0,0,0,0,0,0,0,0
"Türkiye","2024-01-02",0,0,0,0,0,0,0,0
"Türkiye","2024-01-03",0,0,0,0,0,0,0,0
"Türkiye","2024-01-04",0,0,0,0,0,0,0,0
"Türkiye","2024-01-05",0,0,0,0,0,0,0,0
"Türkiye","2024-01-06",0,0,0,0,0,0,0,0
"Türkiye","2024-01-07",0,0,0,0,0,0,0,0
"Türkiye","2024-01-08",0,0,0,0,0,0,0,0
"Türkiye","2024-01-09",0,0,0,0,0,0,0,0
"Türkiye","2024-01-10",0,0,0,0,0,0,0,0
"Türkiye","2024-01-11",0,0,0,0,0,0,0,0
"Türkiye","2024-01-12",0,0,0,0,0,0,0,0
"Türkiye","2024-01-13",0,0,0,0,0,0,0,0
"Türkiye","2024-01-14",0,0,0,0,0,0,0,0
"Türkiye","2024-01-15",0,0,0,0,0,0,0,0
"Türkiye","2024-01-16",0,0,0,0,0,0,0,0
"Türkiye","2024-01-17",0,0,0,0,0,0,0,0
"Türkiye","2024-01-18",0,0,0,0,0,0,0,0
"Türkiye","2024-01-19",0,0,0,0,0,0,0,0
"Türkiye","2024-01-20",0,0,0,0,0,0,0,0
"Türkiye","2024-01-21",0,0,0,0,0,0,0,0
"Türkiye","2024-01-22",0,0,0,0,0,0,0,0
"Türkiye","2024-01-23",0,0,0,0,0,0,0,0
"Türkiye","2024-01-24",0,0,0,0,0,0,0,0
"Türkiye","2024-01-25",0,0,0,0,0,0,0,0
"Türkiye","2024-01-26",0,0,0,0,0,0,0,0
"Türkiye","2024-01-27",0,0,0,0,0,0,0,0
"Türkiye","2024-01-28",0,0,0,0,0,0,0,0
"Türkiye","2024-01-29",0,0,0,0,0,0,0,0
"Türkiye","2024-01-30",0,0,0,0,0,0,0,0
"Türkiye","2024-01-31",0,0,0,0,0,0,0,0
"Türkiye","2024-02-01",0,0,0,0,0,0,0,0
"Türkiye","2024-02-02",0,0,0,0,0,0,0,0
"Türkiye","2024-02-03",0,0,0,0,0,0,0,0
"Türkiye","2024-02-04",0,0,0,0,0,0,0,0
"Türkiye","2024-02-05",0,0,0,0,0,0,0,0
"Türkiye","2024-02-06",0,0,0,0,0,0,0,0
"Türkiye","2024-02-07",0,0,0,0,0,0,0,0
"Türkiye","2024-02-08",0,0,0,0,0,0,0,0
"Türkiye","2024-02-09",0,0,0,0,0,0,0,0
"Türkiye","2024-02-10",0,0,0,0,0,0,0,0
"Türkiye","2024-02-11",0,0,0,0,0,0,0,0
"Türkiye","2024-02-12",0,0,0,0,0,0,0,0
"Türkiye","2024-02-13",0,0,0,0,0,0,0,0
"Türkiye","2024-02-14",0,0,0,0,0,0,0,0
"Türkiye","2024-02-15",0,0,0,0,0,0,0,0
"Türkiye","2024-02-16",0,0,0,0,0,0,0,0
"Türkiye","2024-02-17",0,0,0,0,0,0,0,0
"Türkiye","2024-02-18",0,0,0,0,0,0,0,0
"Türkiye","2024-02-19",0,0,0,0,0,0,0,0
"Türkiye","2024-02-20",0,0,0,0,0,0,0,0
"Türkiye","2024-02-21",0,0,0,0,0,0,0,0
"Türkiye","2024-02-22",0,0,0,0,0,0,0,0
"Türkiye","2024-02-23",0,0,0,0,0,0,0,0
"Türkiye","2024-02-24",0,0,0,0,0,0,0,0
"Türkiye","2024-02-25",0,0,0,0,0,0,0,0
"Türkiye","2024-02-26",0,0,0,0,0,0,0,0
"Türkiye","2024-02-27",0,0,0,0,0,0,0,0
"Türkiye","2024-02-28",0,0,0,0,0,0,0,0
"Türkiye","2024-02-29",0,0,0,0,0,0,0,0
"Türkiye","2024-03-01",0,0,0,0,0,0,0,0
"Türkiye","2024-03-02",0,0,0,0,0,0,0,0
"Türkiye","2024-03-03",0,0,0,0,0,0,0,0
"Türkiye","2024-03-04",0,0,0,0,0,0,0,0
"Türkiye","2024-03-05",0,0,0,0,0,0,0,0
"Türkiye","2024-03-06",0,0,0,0,0,0,0,0
"Türkiye","2024-03-07",0,0,0,0,0,0,0,0
"Türkiye","2024-03-08",0,0,0,0,0,0,0,0
"Türkiye","2024-03-09",0,0,0,0,0,0,0,0
"Türkiye","2024-03-10",0,0,0,0,0,0,0,0
"Türkiye","2024-03-11",0,0,0,0,0,0,0,0
"Türkiye","2024-03-12",0,0,0,0,0,0,0,0
"Türkiye","2024-03-13",0,0,0,0,0,0,0,0
"Türkiye","2024-03-14",0,0,0,0,0,0,0,0
"Türkiye","2024-03-15",0,0,0,0,0,0,0,0
"Türkiye","2024-03-16",0,0,0,0,0,0,0,0
"Türkiye","2024-03-17",0,0,0,0,0,0,0,0
"Türkiye","2024-03-18",0,0,0,0,0,0,0,0
"Türkiye","2024-03-19",0,0,0,0,0,0,0,0
"Türkiye","2024-03-20",0,0,0,0,0,0,0,0
"Türkiye","2024-03-21",0,0,0,0,0,0,0,0
"Türkiye","2024-03-22",0,0,0,0,0,0,0,0
"Türkiye","2024-03-23",0,0,0,0,0,0,0,0
"Türkiye","2024-03-24",0,0,0,0,0,0,0,0
"Türkiye","2024-03-25",0,0,0,0,0,0,0,0
"Türkiye","2024-03-26",0,0,0,0,0,0,0,0
"Türkiye","2024-03-27",0,0,0,0,0,0,0,0
"Türkiye","2024-03-28",0,0,0,0,0,0,0,0
"Türkiye","2024-03-29",0,0,0,0,0,0,0,0
"Türkiye","2024-03-30",0,0,0,0,0,0,0,0
"Türkiye","2024-03-31",0,0,0,0,0,0,0,0
"Türkiye","2024-04-01",0,0,0,0,0,0,0,0
"Türkiye","2024-04-02",0,0,0,0,0,0,0,0
"Türkiye","2024-04-03",0,0,0,0,0,0,0,0
"Türkiye","2024-04-04",0,0,0,0,0,0,0,0
"Türkiye","2024-04-05",0,0,0,0,0,0,0,0
"Türkiye","2024-04-06",0,0,0,0,0,0,0,0
"Türkiye","2024-04-07",0,0,0,0,0,0,0,0
"Türkiye","2024-04-08",0,0,0,0,0,0,0,0
"Türkiye","2024-04-09",0,0,0,0,0,0,0,0
"Türkiye","2024-04-10",0,0,0,0,0,0,0,0
"Türkiye","2024-04-11",0,0,0,0,0,0,0,0
"Türkiye","2024-04-12",0,0,0,0,0,0,0,0
"Türkiye","2024-04-13",0,0,0,0,0,0,0,0
"Türkiye","2024-04-14",0,0,0,0,0,0,0,0
"Türkiye","2024-04-15",0,0,0,0,0,0,0,0
"Türkiye","2024-04-16",0,0,0,0,0,0,0,0
"Türkiye","2024-04-17",0,0,0,0,0,0,0,0
"Türkiye","2024-04-18",0,0,0,0,0,0,0,0
"Türkiye","2024-04-19",0,0,0,0,0,0,0,0
"Türkiye","2024-04-20",0,0,0,0,0,0,0,0
"Türkiye","2024-04-21",0,0,0,0,0,0,0,0
"Türkiye","2024-04-22",0,0,0,0,0,0,0,0
"Türkiye","2024-04-23",0,0,0,0,0,0,0,0
"Türkiye","2024-04-24",0,0,0,0,0,0,0,0
"Türkiye","2024-04-25",0,0,0,0,0,0,0,0
"Türkiye","2024-04-26",0,0,0,0,0,0,0,0
"Türkiye","2024-04-27",0,0,0,0,0,0,0,0
"Türkiye","2024-04-28",0,0,0,0,0,0,0,0
"Türkiye","2024-04-29",0,0,0,0,0,0,0,0
"Türkiye","2024-04-30",0,0,0,0,0,0,0,0
"Türkiye","2024-05-01",0,0,0,0,0,0,0,0
"Türkiye","2024-05-02",0,0,0,0,0,0,0,0
"Türkiye","2024-05-03",0,0,0,0,0,0,0,0
"Türkiye","2024-05-04",0,0,0,0,0,0,0,0
"Türkiye","2024-05-05",0,0,0,0,0,0,0,0
"Türkiye","2024-05-06",0,0,0,0,0,0,0,0
"Türkiye","2024-05-07",0,0,0,0,0,0,0,0
"Türkiye","2024-05-08",0,0,0,0,0,0,0,0
"Türkiye","2024-05-09",0,0,0,0,0,0,0,0
"Türkiye","2024-05-10",0,0,0,0,0,0,0,0
"Türkiye","2024-05-11",0,0,0,0,0,0,0,0
"Türkiye","2024-05-12",0,0,0,0,0,0,0,0
"Türkiye","2024-05-13",0,0,0,0,0,0,0,0
"Türkiye","2024-05-14",0,0,0,0,0,0,0,0
"Türkiye","2024-05-15",0,0,0,0,0,0,0,0
"Türkiye","2024-05-16",0,0,0,0,0,0,0,0
"Türkiye","2024-05-17",0,0,0,0,0,0,0,0
"Türkiye","2024-05-18",0,0,0,0,0,0,0,0
"Türkiye","2024-05-19",0,0,0,0,0,0,0,0
"Türkiye","2024-05-20",0,0,0,0,0,0,0,0
"Türkiye","2024-05-21",0,0,0,0,0,0,0,0
"Türkiye","2024-05-22",0,0,0,0,0,0,0,0
"Türkiye","2024-05-23",0,0,0,0,0,0,0,0
"Türkiye","2024-05-24",0,0,0,0,0,0,0,0
"Türkiye","2024-05-25",0,0,0,0,0,0,0,0
"Türkiye","2024-05-26",0,0,0,0,0,0,0,0
"Türkiye","2024-05-27",0,0,0,0,0,0,0,0
"Türkiye","2024-05-28",0,0,0,0,0,0,0,0
"Türkiye","2024-05-29",0,0,0,0,0,0,0,0
"Türkiye","2024-05-30",0,0,0,0,0,0,0,0
"Türkiye","2024-05-31",0,0,0,0,0,0,0,0
"Türkiye","2024-06-01",0,0,0,0,0,0,0,0
"Türkiye","2024-06-02",0,0,0,0,0,0,0,0
"Türkiye","2024-06-03",0,0,0,0,0,0,0,0
"Türkiye","2024-06-04",0,0,0,0,0,0,0,0
"Türkiye","2024-06-05",0,0,0,0,0,0,0,0
"Türkiye","2024-06-06",0,0,0,0,0,0,0,0
"Türkiye","2024-06-07",0,0,0,0,0,0,0,0
"Türkiye","2024-06-08",0,0,0,0,0,0,0,0
"Türkiye","2024-06-09",0,0,0,0,0,0,0,0
"Türkiye","2024-06-10",0,0,0,0,0,0,0,0
"Türkiye","2024-06-11",0,0,0,0,0,0,0,0
"Türkiye","2024-06-12",0,0,0,0,0,0,0,0
"Türkiye","2024-06-13",0,0,0,0,0,0,0,0
"Türkiye","2024-06-14",0,0,0,0,0,0,0,0
"Türkiye","2024-06-15",0,0,0,0,0,0,0,0
"Türkiye","2024-06-16",0,0,0,0,0,0,0,0
"Türkiye","2024-06-17",0,0,0,0,0,0,0,0
"Türkiye","2024-06-18",0,0,0,0,0,0,0,0
"Türkiye","2024-06-19",0,0,0,0,0,0,0,0
"Türkiye","2024-06-20",0,0,0,0,0,0,0,0
"Türkiye","2024-06-21",0,0,0,0,0,0,0,0
"Türkiye","2024-06-22",0,0,0,0,0,0,0,0
"Türkiye","2024-06-23",0,0,0,0,0,0,0,0
"Türkiye","2024-06-24",0,0,0,0,0,0,0,0
"Türkiye","2024-06-25",0,0,0,0,0,0,0,0
"Türkiye","2024-06-26",0,0,0,0,0,0,0,0
"Türkiye","2024-06-27",0,0,0,0,0,0,0,0
"Türkiye","2024-06-28",0,0,0,0,0,0,0,0
"Türkiye","2024-06-29",0,0,0,0,0,0,0,0
"Türkiye","2024-06-30",0,0,0,0,0,0,0,0
"Türkiye","2024-07-01",0,0,0,0,0,0,0,0
"Türkiye","2024-07-02",0,0,0,0,0,0,0,0
"Türkiye","2024-07-03",0,0,0,0,0,0,0,0
"Türkiye","2024-07-04",0,0,0,0,0,0,0,0
"Türkiye","2024-07-05",0,0,0,0,0,0,0,0
"Türkiye","2024-07-06",0,0,0,0,0,0,0,0
"Türkiye","2024-07-07",0,0,0,0,0,0,0,0
"Türkiye","2024-07-08",0,0,0,0,0,0,0,0
"Türkiye","2024-07-09",0,0,0,0,0,0,0,0
"Türkiye","2024-07-10",0,0,0,0,0,0,0,0
"Türkiye","2024-07-11",0,0,0,0,0,0,0,0
"Türkiye","2024-07-12",0,0,0,0,0,0,0,0
"Türkiye","2024-07-13",0,0,0,0,0,0,0,0
"Türkiye","2024-07-14",0,0,0,0,0,0,0,0
"Türkiye","2024-07-15",0,0,0,0,0,0,0,0
"Türkiye","2024-07-16",0,0,0,0,0,0,0,0
"Türkiye","2024-07-17",0,0,0,0,0,0,0,0
"Türkiye","2024-07-18",0,0,0,0,0,0,0,0
"Türkiye","2024-07-19",0,0,0,0,0,0,0,0
"Türkiye","2024-07-20",0,0,0,0,0,0,0,0
"Türkiye","2024-07-21",0,0,0,0,0,0,0,0
"Türkiye","2024-07-22",0,0,0,0,0,0,0,0
"Türkiye","2024-07-23",0,0,0,0,0,0,0,0
"Türkiye","2024-07-24",0,0,0,0,0,0,0,0
"Türkiye","2024-07-25",0,0,0,0,0,0,0,0
"Türkiye","2024-07-26",0,0,0,0,0,0,0,0
"Türkiye","2024-07-27",0,0,0,0,0,0,0,0
"Türkiye","2024-07-28",0,0,0,0,0,0,0,0
"Türkiye","2024-07-29",0,0,0,0,0,0,0,0
"Türkiye","2024-07-30",0,0,0,0,0,0,0,0
"Türkiye","2024-07-31",0,0,0,0,0,0,0,0
"Türkiye","2024-08-01",0,0,0,0,0,0,0,0
"Türkiye","2024-08-02",0,0,0,0,0,0,0,0
"Türkiye","2024-08-03",0,0,0,0,0,0,0,0
"Türkiye","2024-08-04",0,0,0,0,0,0,0,0
"Türkiye","2024-08-05",0,0,0,0,0,0,0,0
"Türkiye","2024-08-06",0,0,0,0,0,0,0,0
"Türkiye","2024-08-07",0,0,0,0,0,0,0,0
"Türkiye","2024-08-08",0,0,0,0,0,0,0,0
"Türkiye","2024-08-09",0,0,0,0,0,0,0,0
"Türkiye","2024-08-10",0,0,0,0,0,0,0,0
"Türkiye","2024-08-11",0,0,0,0,0,0,0,0
"Türkiye","2024-08-12",0,0,0,0,0,0,0,0
"Türkiye","2024-08-13",0,0,0,0,0,0,0,0
"Türkiye","2024-08-14",0,0,0,0,0,0,0,0
"Türkiye","2024-08-15",0,0,0,0,0,0,0,0
"Türkiye","2024-08-16",0,0,0,0,0,0,0,0
"Türkiye","2024-08-17",0,0,0,0,0,0,0,0
"Türkiye","2024-08-18",0,0,0,0,0,0,0,0
"Türkiye","2024-08-19",0,0,0,0,0,0,0,0
"Türkiye","2024-08-20",0,0,0,0,0,0,0,0
"Türkiye","2024-08-21",0,0,0,0,0,0,0,0
"Türkiye","2024-08-22",0,0,0,0,0,0,0,0
"Türkiye","2024-08-23",0,0,0,0,0,0,0,0
"Türkiye","2024-08-24",0,0,0,0,0,0,0,0
"Türkiye","2024-08-25",0,0,0,0,0,0,0,0
"Türkiye","2024-08-26",0,0,0,0,0,0,0,0
"Türkiye","2024-08-27",0,0,0,0,0,0,0,0
"Türkiye","2024-08-28",0,0,0,0,0,0,0,0
"Türkiye","2024-08-29",0,0,0,0,0,0,0,0
"Türkiye","2024-08-30",0,0,0,0,0,0,0,0
"Türkiye","2024-08-31",0,0,0,0,0,0,0,0
"Türkiye","2024-09-01",0,0,0,0,0,0,0,0
"Türkiye","2024-09-02",0,0,0,0,0,0,0,0
"Türkiye","2024-09-03",0,0,0,0,0,0,0,0
"Türkiye","2024-09-04",0,0,0,0,0,0,0,0
"Türkiye","2024-09-05",0,0,0,0,0,0,0,0
"Türkiye","2024-09-06",0,0,0,0,0,0,0,0
"Türkiye","2024-09-07",0,0,0,0,0,0,0,0
"Türkiye","2024-09-08",0,0,0,0,0,0,0,0
"Türkiye","2024-09-09",0,0,0,0,0,0,0,0
"Türkiye","2024-09-10",0,0,0,0,0,0,0,0
"Türkiye","2024-09-11",0,0,0,0,0,0,0,0
"Türkiye","2024-09-12",0,0,0,0,0,0,0,0
"Türkiye","2024-09-13",0,0,0,0,0,0,0,0
"Türkiye","2024-09-14",0,0,0,0,0,0,0,0
"Türkiye","2024-09-15",0,0,0,0,0,0,0,0
"Türkiye","2024-09-16",0,0,0,0,0,0,0,0
"Türkiye","2024-09-17",0,0,0,0,0,0,0,0
"Türkiye","2024-09-18",0,0,0,0,0,0,0,0
"Türkiye","2024-09-19",0,0,0,0,0,0,0,0
"Türkiye","2024-09-20",0,0,0,0,0,0,0,0
"Türkiye","2024-09-21",0,0,0,0,0,0,0,0
"Türkiye","2024-09-22",0,0,0,0,0,0,0,0
"Türkiye","2024-09-23",0,0,0,0,0,0,0,0
"Türkiye","2024-09-24",0,0,0,0,0,0,0,0
"Türkiye","2024-09-25",0,0,0,0,0,0,0,0
"Türkiye","2024-09-26",0,0,0,0,0,0,0,0
"Türkiye","2024-09-27",0,0,0,0,0,0,0,0
"Türkiye","2024-09-28",0,0,0,0,0,0,0,0
"Türkiye","2024-09-29",0,0,0,0,0,0,0,0
"Türkiye","2024-09-30",0,0,0,0,0,0,0,0
"Türkiye","2024-10-01",0,0,0,0,0,0,0,0
"Türkiye","2024-10-02",0,0,0,0,0,0,0,0
"Türkiye","2024-10-03",0,0,0,0,0,0,0,0
"Türkiye","2024-10-04",0,0,0,0,0,0,0,0
"Türkiye","2024-10-05",0,0,0,0,0,0,0,0
"Türkiye","2024-10-06",0,0,0,0,0,0,0,0
"Türkiye","2024-10-07",0,0,0,0,0,0,0,0
"Türkiye","2024-10-08",0,0,0,0,0,0,0,0
"Türkiye","2024-10-09",0,0,0,0,0,0,0,0
"Türkiye","2024-10-10",0,0,0,0,0,0,0,0
"Türkiye","2024-10-11",0,0,0,0,0,0,0,0
"Türkiye","2024-10-12",0,0,0,0,0,0,0,0
"Türkiye","2024-10-13",0,0,0,0,0,0,0,0
"Türkiye","2024-10-14",0,0,0,0,0,0,0,0
"Türkiye","2024-10-15",0,0,0,0,0,0,0,0
"Türkiye","2024-10-16",0,0,0,0,0,0,0,0
"Türkiye","2024-10-17",0,0,0,0,0,0,0,0
"Türkiye","2024-10-18",0,0,0,0,0,0,0,0
"Türkiye","2024-10-19",0,0,0,0,0,0,0,0
"Türkiye","2024-10-20",0,0,0,0,0,0,0,0
"Türkiye","2024-10-21",0,0,0,0,0,0,0,0
"Türkiye","2024-10-22",0,0,0,0,0,0,0,0
"Türkiye","2024-10-23",0,0,0,0,0,0,0,0
"Türkiye","2024-10-24",0,0,0,0,0,0,0,0
"Türkiye","2024-10-25",0,0,0,0,0,0,0,0
"Türkiye","2024-10-26",0,0,0,0,0,0,0,0
"Türkiye","2024-10-27",0,0,0,0,0,0,0,0
"Türkiye","2024-10-28",0,0,0,0,0,0,0,0
"Türkiye","2024-10-29",0,0,0,0,0,0,0,0
"Türkiye","2024-10-30",0,0,0,0,0,0,0,0
"Türkiye","2024-10-31",0,0,0,0,0,0,0,0
"Türkiye","2024-11-01",0,0,0,0,0,0,0,0
"Türkiye","2024-11-02",0,0,0,0,0,0,0,0
"Türkiye","2024-11-03",0,0,0,0,0,0,0,0
"Türkiye","2024-11-04",0,0,0,0,0,0,0,0
"Türkiye","2024-11-05",0,0,0,0,0,0,0,0
"Türkiye","2024-11-06",0,0,0,0,0,0,0,0
"Türkiye","2024-11-07",0,0,0,0,0,0,0,0
"Türkiye","2024-11-08",0,0,0,0,0,0,0,0
"Türkiye","2024-11-09",0,0,0,0,0,0,0,0
"Türkiye","2024-11-10",0,0,0,0,0,0,0,0
"Türkiye","2024-11-11",0,0,0,0,0,0,0,0
"Türkiye","2024-11-12",0,0,0,0,0,0,0,0
"Türkiye","2024-11-13",0,0,0,0,0,0,0,0
"Türkiye","2024-11-14",0,0,0,0,0,0,0,0
"Türkiye","2024-11-15",0,0,0,0,0,0,0,0
"Türkiye","2024-11-16",0,0,0,0,0,0,0,0
"Türkiye","2024-11-17",0,0,0,0,0,0,0,0
"Türkiye","2024-11-18",0,0,0,0,0,0,0,0
"Türkiye","2024-11-19",0,0,0,0,0,0,0,0
"Türkiye","2024-11-20",0,0,0,0,0,0,0,0
"Türkiye","2024-11-21",0,0,0,0,0,0,0,0
"Türkiye","2024-11-22",0,0,0,0,0,0,0,0
"Türkiye","2024-11-23",0,0,0,0,0,0,0,0
"Türkiye","2024-11-24",0,0,0,0,0,0,0,0
"Türkiye","2024-11-25",0,0,0,0,0,0,0,0
"Türkiye","2024-11-26",0,0,0,0,0,0,0,0
"Türkiye","2024-11-27",0,0,0,0,0,0,0,0
"Türkiye","2024-11-28",0,0,0,0,0,0,0,0
"Türkiye","2024-11-29",0,0,0,0,0,0,0,0
"Türkiye","2024-11-30",0,0,0,0,0,0,0,0
"Türkiye","2024-12-01",0,0,0,0,0,0,0,0
"Türkiye","2024-12-02",0,0,0,0,0,0,0,0
"Türkiye","2024-12-03",0,0,0,0,0,0,0,0
"Türkiye","2024-12-04",0,0,0,0,0,0,0,0
"Türkiye","2024-12-05",0,0,0,0,0,0,0,0
"Türkiye","2024-12-06",0,0,0,0,0,0,0,0
"Türkiye","2024-12-07",0,0,0,0,0,0,0,0
"Türkiye","2024-12-08",0,0,0,0,0,0,0,0
"Türkiye","2024-12-09",0,0,0,0,0,0,0,0
"Türkiye","2024-12-10",0,0,0,0,0,0,0,0
"Türkiye","2024-12-11",0,0,0,0,0,0,0,0
"Türkiye","2024-12-12",0,0,0,0,0,0,0,0
"Türkiye","2024-12-13",0,0,0,0,0,0,0,0
"Türkiye","2024-12-14",0,0,0,0,0,0,0,0
"Türkiye","2024-12-15",0,0,0,0,0,0,0,0
"Türkiye","2024-12-16",0,0,0,0,0,0,0,0
"Türkiye","2024-12-17",0,0,0,0,0,0,0,0
"Türkiye","2024-12-18",0,0,0,0,0,0,0,0
"Türkiye","2024-12-19",0,0,0,0,0,0,0,0
"Türkiye","2024-12-20",0,0,0,0,0,0,0,0
"Türkiye","2024-12-21",0,0,0,0,0,0,0,0
"Türkiye","2024-12-22",0,0,0,0,0,0,0,0
"Türkiye","2024-12-23",0,0,0,0,0,0,0,0
"Türkiye","2024-12-24",0,0,0,0,0,0,0,0
"Türkiye","2024-12-25",0,0,0,0,0,0,0,0
"Türkiye","2024-12-26",0,0,0,0,0,0,0,0
"Türkiye","2024-12-27",0,0,0,0,0,0,0,0
"Türkiye","2024-12-28",0,0,0,0,0,0,0,0
"Türkiye","2024-12-29",0,0,0,0,0,0,0,0
"Türkiye","2024-12-30",0,0,0,0,0,0,0,0
"Türkiye","2024-12-31",0,0,0,0,0,0,0,0
"Türkiye","2025-01-01",0,0,0,0,0,0,0,0
"Türkiye","2025-01-02",0,0,0,0,0,0,0,0
"Türkiye","2025-01-03",0,0,0,0,0,0,0,0
"Türkiye","2025-01-04",0,0,0,0,0,0,0,0
"Türkiye","2025-01-05",0,0,0,0,0,0,0,0
"Türkiye","2025-01-06",0,0,0,0,0,0,0,0
"Türkiye","2025-01-07",0,0,0,0,0,0,0,0
"Türkiye","2025-01-08",0,0,0,0,0,0,0,0
"Türkiye","2025-01-09",0,0,0,0,0,0,0,0
"Türkiye","2025-01-10",0,0,0,0,0,0,0,0
"Türkiye","2025-01-11",0,0,0,0,0,0,0,0
"Türkiye","2025-01-12",0,0,0,0,0,0,0,0
"Türkiye","2025-01-13",0,0,0,0,0,0,0,0
"Uganda","2024-01-01",0,0,0,0,0,0,0,0
"Uganda","2024-01-02",0,0,0,0,0,0,0,0
"Uganda","2024-01-03",0,0,0,0,0,0,0,0
"Uganda","2024-01-04",0,0,0,0,0,0,0,0
"Uganda","2024-01-05",0,0,0,0,0,0,0,0
"Uganda","2024-01-06",0,0,0,0,0,0,0,0
"Uganda","2024-01-07",0,0,0,0,0,0,0,0
"Uganda","2024-01-08",0,0,0,0,0,0,0,0
"Uganda","2024-01-09",0,0,0,0,0,0,0,0
"Uganda","2024-01-10",0,0,0,0,0,0,0,0
"Uganda","2024-01-11",0,0,0,0,0,0,0,0
"Uganda","2024-01-12",0,0,0,0,0,0,0,0
"Uganda","2024-01-13",0,0,0,0,0,0,0,0
"Uganda","2024-01-14",0,0,0,0,0,0,0,0
"Uganda","2024-01-15",0,0,0,0,0,0,0,0
"Uganda","2024-01-16",0,0,0,0,0,0,0,0
"Uganda","2024-01-17",0,0,0,0,0,0,0,0
"Uganda","2024-01-18",0,0,0,0,0,0,0,0
"Uganda","2024-01-19",0,0,0,0,0,0,0,0
"Uganda","2024-01-20",0,0,0,0,0,0,0,0
"Uganda","2024-01-21",0,0,0,0,0,0,0,0
"Uganda","2024-01-22",0,0,0,0,0,0,0,0
"Uganda","2024-01-23",0,0,0,0,0,0,0,0
"Uganda","2024-01-24",0,0,0,0,0,0,0,0
"Uganda","2024-01-25",0,0,0,0,0,0,0,0
"Uganda","2024-01-26",0,0,0,0,0,0,0,0
"Uganda","2024-01-27",0,0,0,0,0,0,0,0
"Uganda","2024-01-28",0,0,0,0,0,0,0,0
"Uganda","2024-01-29",0,0,0,0,0,0,0,0
"Uganda","2024-01-30",0,0,0,0,0,0,0,0
"Uganda","2024-01-31",0,0,0,0,0,0,0,0
"Uganda","2024-02-01",0,0,0,0,0,0,0,0
"Uganda","2024-02-02",0,0,0,0,0,0,0,0
"Uganda","2024-02-03",0,0,0,0,0,0,0,0
"Uganda","2024-02-04",0,0,0,0,0,0,0,0
"Uganda","2024-02-05",0,0,0,0,0,0,0,0
"Uganda","2024-02-06",0,0,0,0,0,0,0,0
"Uganda","2024-02-07",0,0,0,0,0,0,0,0
"Uganda","2024-02-08",0,0,0,0,0,0,0,0
"Uganda","2024-02-09",0,0,0,0,0,0,0,0
"Uganda","2024-02-10",0,0,0,0,0,0,0,0
"Uganda","2024-02-11",0,0,0,0,0,0,0,0
"Uganda","2024-02-12",0,0,0,0,0,0,0,0
"Uganda","2024-02-13",0,0,0,0,0,0,0,0
"Uganda","2024-02-14",0,0,0,0,0,0,0,0
"Uganda","2024-02-15",0,0,0,0,0,0,0,0
"Uganda","2024-02-16",0,0,0,0,0,0,0,0
"Uganda","2024-02-17",0,0,0,0,0,0,0,0
"Uganda","2024-02-18",0,0,0,0,0,0,0,0
"Uganda","2024-02-19",0,0,0,0,0,0,0,0
"Uganda","2024-02-20",0,0,0,0,0,0,0,0
"Uganda","2024-02-21",0,0,0,0,0,0,0,0
"Uganda","2024-02-22",0,0,0,0,0,0,0,0
"Uganda","2024-02-23",0,0,0,0,0,0,0,0
"Uganda","2024-02-24",0,0,0,0,0,0,0,0
"Uganda","2024-02-25",0,0,0,0,0,0,0,0
"Uganda","2024-02-26",0,0,0,0,0,0,0,0
"Uganda","2024-02-27",0,0,0,0,0,0,0,0
"Uganda","2024-02-28",0,0,0,0,0,0,0,0
"Uganda","2024-02-29",0,0,0,0,0,0,0,0
"Uganda","2024-03-01",0,0,0,0,0,0,0,0
"Uganda","2024-03-02",0,0,0,0,0,0,0,0
"Uganda","2024-03-03",0,0,0,0,0,0,0,0
"Uganda","2024-03-04",0,0,0,0,0,0,0,0
"Uganda","2024-03-05",0,0,0,0,0,0,0,0
"Uganda","2024-03-06",0,0,0,0,0,0,0,0
"Uganda","2024-03-07",0,0,0,0,0,0,0,0
"Uganda","2024-03-08",0,0,0,0,0,0,0,0
"Uganda","2024-03-09",0,0,0,0,0,0,0,0
"Uganda","2024-03-10",0,0,0,0,0,0,0,0
"Uganda","2024-03-11",0,0,0,0,0,0,0,0
"Uganda","2024-03-12",0,0,0,0,0,0,0,0
"Uganda","2024-03-13",0,0,0,0,0,0,0,0
"Uganda","2024-03-14",0,0,0,0,0,0,0,0
"Uganda","2024-03-15",0,0,0,0,0,0,0,0
"Uganda","2024-03-16",0,0,0,0,0,0,0,0
"Uganda","2024-03-17",0,0,0,0,0,0,0,0
"Uganda","2024-03-18",0,0,0,0,0,0,0,0
"Uganda","2024-03-19",0,0,0,0,0,0,0,0
"Uganda","2024-03-20",0,0,0,0,0,0,0,0
"Uganda","2024-03-21",0,0,0,0,0,0,0,0
"Uganda","2024-03-22",0,0,0,0,0,0,0,0
"Uganda","2024-03-23",0,0,0,0,0,0,0,0
"Uganda","2024-03-24",0,0,0,0,0,0,0,0
"Uganda","2024-03-25",0,0,0,0,0,0,0,0
"Uganda","2024-03-26",0,0,0,0,0,0,0,0
"Uganda","2024-03-27",0,0,0,0,0,0,0,0
"Uganda","2024-03-28",0,0,0,0,0,0,0,0
"Uganda","2024-03-29",0,0,0,0,0,0,0,0
"Uganda","2024-03-30",0,0,0,0,0,0,0,0
"Uganda","2024-03-31",0,0,0,0,0,0,0,0
"Uganda","2024-04-01",0,0,0,0,0,0,0,0
"Uganda","2024-04-02",0,0,0,0,0,0,0,0
"Uganda","2024-04-03",0,0,0,0,0,0,0,0
"Uganda","2024-04-04",0,0,0,0,0,0,0,0
"Uganda","2024-04-05",0,0,0,0,0,0,0,0
"Uganda","2024-04-06",0,0,0,0,0,0,0,0
"Uganda","2024-04-07",0,0,0,0,0,0,0,0
"Uganda","2024-04-08",0,0,0,0,0,0,0,0
"Uganda","2024-04-09",0,0,0,0,0,0,0,0
"Uganda","2024-04-10",0,0,0,0,0,0,0,0
"Uganda","2024-04-11",0,0,0,0,0,0,0,0
"Uganda","2024-04-12",0,0,0,0,0,0,0,0
"Uganda","2024-04-13",0,0,0,0,0,0,0,0
"Uganda","2024-04-14",0,0,0,0,0,0,0,0
"Uganda","2024-04-15",0,0,0,0,0,0,0,0
"Uganda","2024-04-16",0,0,0,0,0,0,0,0
"Uganda","2024-04-17",0,0,0,0,0,0,0,0
"Uganda","2024-04-18",0,0,0,0,0,0,0,0
"Uganda","2024-04-19",0,0,0,0,0,0,0,0
"Uganda","2024-04-20",0,0,0,0,0,0,0,0
"Uganda","2024-04-21",0,0,0,0,0,0,0,0
"Uganda","2024-04-22",0,0,0,0,0,0,0,0
"Uganda","2024-04-23",0,0,0,0,0,0,0,0
"Uganda","2024-04-24",0,0,0,0,0,0,0,0
"Uganda","2024-04-25",0,0,0,0,0,0,0,0
"Uganda","2024-04-26",0,0,0,0,0,0,0,0
"Uganda","2024-04-27",0,0,0,0,0,0,0,0
"Uganda","2024-04-28",0,0,0,0,0,0,0,0
"Uganda","2024-04-29",0,0,0,0,0,0,0,0
"Uganda","2024-04-30",0,0,0,0,0,0,0,0
"Uganda","2024-05-01",0,0,0,0,0,0,0,0
"Uganda","2024-05-02",0,0,0,0,0,0,0,0
"Uganda","2024-05-03",0,0,0,0,0,0,0,0
"Uganda","2024-05-04",0,0,0,0,0,0,0,0
"Uganda","2024-05-05",0,0,0,0,0,0,0,0
"Uganda","2024-05-06",0,0,0,0,0,0,0,0
"Uganda","2024-05-07",0,0,0,0,0,0,0,0
"Uganda","2024-05-08",0,0,0,0,0,0,0,0
"Uganda","2024-05-09",0,0,0,0,0,0,0,0
"Uganda","2024-05-10",0,0,0,0,0,0,0,0
"Uganda","2024-05-11",0,0,0,0,0,0,0,0
"Uganda","2024-05-12",0,0,0,0,0,0,0,0
"Uganda","2024-05-13",0,0,0,0,0,0,0,0
"Uganda","2024-05-14",0,0,0,0,0,0,0,0
"Uganda","2024-05-15",0,0,0,0,0,0,0,0
"Uganda","2024-05-16",0,0,0,0,0,0,0,0
"Uganda","2024-05-17",0,0,0,0,0,0,0,0
"Uganda","2024-05-18",0,0,0,0,0,0,0,0
"Uganda","2024-05-19",0,0,0,0,0,0,0,0
"Uganda","2024-05-20",0,0,0,0,0,0,0,0
"Uganda","2024-05-21",0,0,0,0,0,0,0,0
"Uganda","2024-05-22",0,0,0,0,0,0,0,0
"Uganda","2024-05-23",0,0,0,0,0,0,0,0
"Uganda","2024-05-24",0,0,0,0,0,0,0,0
"Uganda","2024-05-25",0,0,0,0,0,0,0,0
"Uganda","2024-05-26",0,0,0,0,0,0,0,0
"Uganda","2024-05-27",0,0,0,0,0,0,0,0
"Uganda","2024-05-28",0,0,0,0,0,0,0,0
"Uganda","2024-05-29",0,0,0,0,0,0,0,0
"Uganda","2024-05-30",0,0,0,0,0,0,0,0
"Uganda","2024-05-31",0,0,0,0,0,0,0,0
"Uganda","2024-06-01",0,0,0,0,0,0,0,0
"Uganda","2024-06-02",0,0,0,0,0,0,0,0
"Uganda","2024-06-03",0,0,0,0,0,0,0,0
"Uganda","2024-06-04",0,0,0,0,0,0,0,0
"Uganda","2024-06-05",0,0,0,0,0,0,0,0
"Uganda","2024-06-06",0,0,0,0,0,0,0,0
"Uganda","2024-06-07",0,0,0,0,0,0,0,0
"Uganda","2024-06-08",0,0,0,0,0,0,0,0
"Uganda","2024-06-09",0,0,0,0,0,0,0,0
"Uganda","2024-06-10",0,0,0,0,0,0,0,0
"Uganda","2024-06-11",0,0,0,0,0,0,0,0
"Uganda","2024-06-12",0,0,0,0,0,0,0,0
"Uganda","2024-06-13",0,0,0,0,0,0,0,0
"Uganda","2024-06-14",0,0,0,0,0,0,0,0
"Uganda","2024-06-15",0,0,0,0,0,0,0,0
"Uganda","2024-06-16",0,0,0,0,0,0,0,0
"Uganda","2024-06-17",0,0,0,0,0,0,0,0
"Uganda","2024-06-18",0,0,0,0,0,0,0,0
"Uganda","2024-06-19",0,0,0,0,0,0,0,0
"Uganda","2024-06-20",0,0,0,0,0,0,0,0
"Uganda","2024-06-21",0,0,0,0,0,0,0,0
"Uganda","2024-06-22",0,0,0,0,0,0,0,0
"Uganda","2024-06-23",0,0,0,0,0,0,0,0
"Uganda","2024-06-24",0,0,0,0,0,0,0,0
"Uganda","2024-06-25",0,0,0,0,0,0,0,0
"Uganda","2024-06-26",0,0,0,0,0,0,0,0
"Uganda","2024-06-27",0,0,0,0,0,0,0,0
"Uganda","2024-06-28",0,0,0,0,0,0,0,0
"Uganda","2024-06-29",0,0,0,0,0,0,0,0
"Uganda","2024-06-30",0,0,0,0,0,0,0,0
"Uganda","2024-07-01",0,0,0,0,0,0,0,0
"Uganda","2024-07-02",0,0,0,0,0,0,0,0
"Uganda","2024-07-03",0,0,0,0,0,0,0,0
"Uganda","2024-07-04",0,0,0,0,0,0,0,0
"Uganda","2024-07-05",0,0,0,0,0,0,0,0
"Uganda","2024-07-06",0,0,0,0,0,0,0,0
"Uganda","2024-07-07",0,1,1,0,1,1,0,0
"Uganda","2024-07-08",0,0,1,0,0,1,0,0
"Uganda","2024-07-09",0,0,1,0,0,1,0,0
"Uganda","2024-07-10",0,0,1,0,0,1,0,0
"Uganda","2024-07-11",0,0,1,0,1,2,0,0
"Uganda","2024-07-12",0,0,1,0,0,2,0,0
"Uganda","2024-07-13",0,0,1,0,0,2,0,0
"Uganda","2024-07-14",0,1,2,0,0,2,0,0
"Uganda","2024-07-15",0,0,2,0,0,2,0,0
"Uganda","2024-07-16",0,0,2,0,0,2,0,0
"Uganda","2024-07-17",0,0,2,0,0,2,0,0
"Uganda","2024-07-18",0,0,2,0,0,2,0,0
"Uganda","2024-07-19",0,0,2,0,0,2,0,0
"Uganda","2024-07-20",0,0,2,0,0,2,0,0
"Uganda","2024-07-21",0,0,2,0,0,2,0,0
"Uganda","2024-07-22",0,0,2,0,0,2,0,0
"Uganda","2024-07-23",0,0,2,0,0,2,0,0
"Uganda","2024-07-24",0,0,2,0,0,2,0,0
"Uganda","2024-07-25",0,0,2,0,0,2,0,0
"Uganda","2024-07-26",0,0,2,0,0,2,0,0
"Uganda","2024-07-27",0,0,2,0,0,2,0,0
"Uganda","2024-07-28",0,0,2,0,0,2,0,0
"Uganda","2024-07-29",0,0,2,0,1,3,0,0
"Uganda","2024-07-30",0,0,2,0,0,3,0,0
"Uganda","2024-07-31",0,0,2,0,0,3,0,0
"Uganda","2024-08-01",0,0,2,0,0,3,0,0
"Uganda","2024-08-02",0,0,2,0,0,3,0,0
"Uganda","2024-08-03",0,0,2,0,0,3,0,0
"Uganda","2024-08-04",0,0,2,0,0,3,0,0
"Uganda","2024-08-05",0,0,2,0,0,3,0,0
"Uganda","2024-08-06",0,0,2,0,0,3,0,0
"Uganda","2024-08-07",0,0,2,0,0,3,0,0
"Uganda","2024-08-08",0,0,2,0,0,3,0,0
"Uganda","2024-08-09",0,0,2,0,0,3,0,0
"Uganda","2024-08-10",0,0,2,0,0,3,0,0
"Uganda","2024-08-11",0,1,3,0,0,3,0,0
"Uganda","2024-08-12",0,0,3,0,0,3,0,0
"Uganda","2024-08-13",0,0,3,0,1,4,0,0
"Uganda","2024-08-14",0,0,3,0,0,4,0,0
"Uganda","2024-08-15",0,0,3,0,0,4,0,0
"Uganda","2024-08-16",0,0,3,0,0,4,0,0
"Uganda","2024-08-17",0,0,3,0,1,5,0,0
"Uganda","2024-08-18",0,2,5,0,0,5,0,0
"Uganda","2024-08-19",0,0,5,0,1,6,0,0
"Uganda","2024-08-20",0,0,5,0,1,7,0,0
"Uganda","2024-08-21",0,0,5,0,1,8,0,0
"Uganda","2024-08-22",0,0,5,0,0,8,0,0
"Uganda","2024-08-23",0,0,5,0,1,9,0,0
"Uganda","2024-08-24",0,0,5,0,1,10,0,0
"Uganda","2024-08-25",0,6,11,0,1,11,0,0
"Uganda","2024-08-26",0,0,11,0,1,12,0,0
"Uganda","2024-08-27",0,0,11,0,0,12,0,0
"Uganda","2024-08-28",0,0,11,0,1,13,0,0
"Uganda","2024-08-29",0,0,11,0,0,13,0,0
"Uganda","2024-08-30",0,0,11,0,1,14,0,0
"Uganda","2024-08-31",0,0,11,0,0,14,0,0
"Uganda","2024-09-01",0,4,15,0,1,15,0,0
"Uganda","2024-09-02",0,0,15,0,1,16,0,0
"Uganda","2024-09-03",0,0,15,0,1,17,0,0
"Uganda","2024-09-04",0,0,15,0,1,18,0,0
"Uganda","2024-09-05",0,0,15,0,2,20,0,0
"Uganda","2024-09-06",0,0,15,0,1,21,0,0
"Uganda","2024-09-07",0,0,15,0,1,22,0,0
"Uganda","2024-09-08",0,8,23,0,1,23,0,0
"Uganda","2024-09-09",0,0,23,0,1,24,0,0
"Uganda","2024-09-10",0,0,23,0,1,25,0,0
"Uganda","2024-09-11",0,0,23,0,1,26,0,0
"Uganda","2024-09-12",0,0,23,0,0,26,0,0
"Uganda","2024-09-13",0,0,23,0,1,27,0,0
"Uganda","2024-09-14",0,0,23,0,1,28,0,0
"Uganda","2024-09-15",0,6,29,0,1,29,0,0
"Uganda","2024-09-16",0,0,29,0,1,30,0,0
"Uganda","2024-09-17",0,0,29,0,1,31,0,0
"Uganda","2024-09-18",0,0,29,0,1,32,0,0
"Uganda","2024-09-19",0,0,29,0,0,32,0,0
"Uganda","2024-09-20",0,0,29,0,1,33,0,0
"Uganda","2024-09-21",0,0,29,0,1,34,0,0
"Uganda","2024-09-22",0,6,35,0,1,35,0,0
"Uganda","2024-09-23",0,0,35,0,2,37,0,0
"Uganda","2024-09-24",0,0,35,0,2,39,0,0
"Uganda","2024-09-25",0,0,35,0,2,41,0,0
"Uganda","2024-09-26",0,0,35,0,2,43,0,0
"Uganda","2024-09-27",0,0,35,0,2,45,0,0
"Uganda","2024-09-28",0,0,35,0,2,47,0,0
"Uganda","2024-09-29",0,14,49,0,2,49,0,0
"Uganda","2024-09-30",0,0,49,0,3,52,0,0
"Uganda","2024-10-01",0,0,49,0,3,55,0,0
"Uganda","2024-10-02",0,0,49,0,3,58,0,0
"Uganda","2024-10-03",0,0,49,0,2,60,0,0
"Uganda","2024-10-04",0,0,49,0,3,63,0,0
"Uganda","2024-10-05",0,0,49,0,3,66,0,0
"Uganda","2024-10-06",0,20,69,0,3,69,0,0
"Uganda","2024-10-07",0,0,69,0,5,74,0,0
"Uganda","2024-10-08",0,0,69,0,6,80,0,0
"Uganda","2024-10-09",0,0,69,0,5,85,0,0
"Uganda","2024-10-10",0,0,69,0,5,90,0,0
"Uganda","2024-10-11",0,0,69,0,5,95,0,0
"Uganda","2024-10-12",0,0,69,0,6,101,0,0
"Uganda","2024-10-13",0,37,106,0,5,106,0,0
"Uganda","2024-10-14",0,0,106,0,7,113,0,0
"Uganda","2024-10-15",0,0,106,0,6,119,0,0
"Uganda","2024-10-16",0,0,106,0,7,126,0,0
"Uganda","2024-10-17",0,0,106,0,7,133,0,0
"Uganda","2024-10-18",0,0,106,0,7,140,0,0
"Uganda","2024-10-19",0,0,106,0,6,146,0,0
"Uganda","2024-10-20",0,47,153,0,7,153,0,0
"Uganda","2024-10-21",0,0,153,0,20,173,0,0
"Uganda","2024-10-22",0,0,153,0,19,192,0,0
"Uganda","2024-10-23",0,0,153,0,20,212,0,0
"Uganda","2024-10-24",0,0,153,0,19,231,0,0
"Uganda","2024-10-25",0,0,153,0,20,251,0,0
"Uganda","2024-10-26",0,0,153,0,19,270,0,0
"Uganda","2024-10-27",0,137,290,0,20,290,0,0
"Uganda","2024-10-28",0,0,290,0,8,298,0,0
"Uganda","2024-10-29",0,0,290,0,8,306,0,0
"Uganda","2024-10-30",0,0,290,0,8,314,0,0
"Uganda","2024-10-31",0,0,290,0,8,322,0,0
"Uganda","2024-11-01",0,0,290,0,8,330,0,0
"Uganda","2024-11-02",0,0,290,0,8,338,0,0
"Uganda","2024-11-03",0,56,346,0,8,346,0,0
"Uganda","2024-11-04",0,0,346,0,14,360,0,0
"Uganda","2024-11-05",0,0,346,0,14,374,0,0
"Uganda","2024-11-06",0,0,346,0,14,388,0,0
"Uganda","2024-11-07",0,0,346,0,13,401,0,0
"Uganda","2024-11-08",0,0,346,0,14,415,0,0
"Uganda","2024-11-09",0,0,346,0,14,429,0,0
"Uganda","2024-11-10",0,97,443,0,14,443,0,0
"Uganda","2024-11-11",0,0,443,0,15,458,0,0
"Uganda","2024-11-12",0,0,443,0,15,473,0,0
"Uganda","2024-11-13",0,0,443,0,15,488,0,0
"Uganda","2024-11-14",0,0,443,0,14,502,0,0
"Uganda","2024-11-15",0,0,443,0,15,517,0,0
"Uganda","2024-11-16",0,0,443,0,15,532,0,0
"Uganda","2024-11-17",0,104,547,0,15,547,0,0
"Uganda","2024-11-18",0,0,547,0,19,566,0,0
"Uganda","2024-11-19",0,0,547,0,18,584,0,0
"Uganda","2024-11-20",0,0,547,0,19,603,0,0
"Uganda","2024-11-21",0,0,547,0,19,622,0,0
"Uganda","2024-11-22",0,0,547,0,19,641,0,0
"Uganda","2024-11-23",0,0,547,0,18,659,0,0
"Uganda","2024-11-24",0,131,678,0,19,678,0,0
"Uganda","2024-11-25",0,0,678,0,18,696,0,0
"Uganda","2024-11-26",0,0,678,0,17,713,0,0
"Uganda","2024-11-27",0,0,678,0,18,731,0,0
"Uganda","2024-11-28",0,0,678,0,18,749,0,0
"Uganda","2024-11-29",0,0,678,0,17,766,0,0
"Uganda","2024-11-30",0,106,784,0,18,784,0,0
"Uganda","2024-12-01",0,33,817,0,33,817,0,0
"Uganda","2024-12-02",0,0,817,0,15,832,0,0
"Uganda","2024-12-03",0,0,817,0,16,848,0,0
"Uganda","2024-12-04",0,0,817,0,15,863,0,0
"Uganda","2024-12-05",0,0,817,0,16,879,0,0
"Uganda","2024-12-06",0,0,817,0,15,894,0,0
"Uganda","2024-12-07",0,0,817,0,16,910,0,0
"Uganda","2024-12-08",0,108,925,0,15,925,0,0
"Uganda","2024-12-09",0,0,925,0,20,945,0,0
"Uganda","2024-12-10",0,0,925,0,21,966,0,0
"Uganda","2024-12-11",0,0,925,0,20,986,0,0
"Uganda","2024-12-12",0,0,925,0,21,1007,0,0
"Uganda","2024-12-13",0,102,1027,0,20,1027,0,0
"Uganda","2024-12-14",0,0,1027,0,0,1027,0,0
"Uganda","2024-12-15",0,0,1027,0,0,1027,0,0
"Uganda","2024-12-16",0,0,1027,0,0,1027,0,0
"Uganda","2024-12-17",0,0,1027,0,0,1027,0,0
"Uganda","2024-12-18",0,0,1027,0,0,1027,0,0
"Uganda","2024-12-19",0,0,1027,0,0,1027,0,0
"Uganda","2024-12-20",0,0,1027,0,0,1027,0,0
"Uganda","2024-12-21",0,0,1027,0,0,1027,0,0
"Uganda","2024-12-22",0,0,1027,0,0,1027,0,0
"Uganda","2024-12-23",0,0,1027,0,0,1027,0,0
"Uganda","2024-12-24",0,0,1027,0,0,1027,0,0
"Uganda","2024-12-25",0,0,1027,0,0,1027,0,0
"Uganda","2024-12-26",0,0,1027,0,0,1027,0,0
"Uganda","2024-12-27",0,0,1027,0,0,1027,0,0
"Uganda","2024-12-28",0,0,1027,0,0,1027,0,0
"Uganda","2024-12-29",0,0,1027,0,0,1027,0,0
"Uganda","2024-12-30",0,0,1027,0,0,1027,0,0
"Uganda","2024-12-31",0,0,1027,0,0,1027,0,0
"Uganda","2025-01-01",0,0,1027,0,0,1027,0,0
"Uganda","2025-01-02",0,0,1027,0,0,1027,0,0
"Uganda","2025-01-03",0,0,1027,0,0,1027,0,0
"Uganda","2025-01-04",0,0,1027,0,0,1027,0,0
"Uganda","2025-01-05",0,0,1027,0,0,1027,0,0
"Uganda","2025-01-06",0,0,1027,0,0,1027,0,0
"Uganda","2025-01-07",0,0,1027,0,0,1027,0,0
"Uganda","2025-01-08",0,0,1027,0,0,1027,0,0
"Uganda","2025-01-09",0,0,1027,0,0,1027,0,0
"Uganda","2025-01-10",0,0,1027,0,0,1027,0,0
"Uganda","2025-01-11",0,0,1027,0,0,1027,0,0
"Uganda","2025-01-12",0,0,1027,0,0,1027,0,0
"Uganda","2025-01-13",0,0,1027,0,0,1027,0,0
"Ukraine","2024-01-01",0,0,0,0,0,0,0,0
"Ukraine","2024-01-02",0,0,0,0,0,0,0,0
"Ukraine","2024-01-03",0,0,0,0,0,0,0,0
"Ukraine","2024-01-04",0,0,0,0,0,0,0,0
"Ukraine","2024-01-05",0,0,0,0,0,0,0,0
"Ukraine","2024-01-06",0,0,0,0,0,0,0,0
"Ukraine","2024-01-07",0,0,0,0,0,0,0,0
"Ukraine","2024-01-08",0,0,0,0,0,0,0,0
"Ukraine","2024-01-09",0,0,0,0,0,0,0,0
"Ukraine","2024-01-10",0,0,0,0,0,0,0,0
"Ukraine","2024-01-11",0,0,0,0,0,0,0,0
"Ukraine","2024-01-12",0,0,0,0,0,0,0,0
"Ukraine","2024-01-13",0,0,0,0,0,0,0,0
"Ukraine","2024-01-14",0,0,0,0,0,0,0,0
"Ukraine","2024-01-15",0,0,0,0,0,0,0,0
"Ukraine","2024-01-16",0,0,0,0,0,0,0,0
"Ukraine","2024-01-17",0,0,0,0,0,0,0,0
"Ukraine","2024-01-18",0,0,0,0,0,0,0,0
"Ukraine","2024-01-19",0,0,0,0,0,0,0,0
"Ukraine","2024-01-20",0,0,0,0,0,0,0,0
"Ukraine","2024-01-21",0,0,0,0,0,0,0,0
"Ukraine","2024-01-22",0,0,0,0,0,0,0,0
"Ukraine","2024-01-23",0,0,0,0,0,0,0,0
"Ukraine","2024-01-24",0,0,0,0,0,0,0,0
"Ukraine","2024-01-25",0,0,0,0,0,0,0,0
"Ukraine","2024-01-26",0,0,0,0,0,0,0,0
"Ukraine","2024-01-27",0,0,0,0,0,0,0,0
"Ukraine","2024-01-28",0,0,0,0,0,0,0,0
"Ukraine","2024-01-29",0,0,0,0,0,0,0,0
"Ukraine","2024-01-30",0,0,0,0,0,0,0,0
"Ukraine","2024-01-31",0,0,0,0,0,0,0,0
"Ukraine","2024-02-01",0,0,0,0,0,0,0,0
"Ukraine","2024-02-02",0,0,0,0,0,0,0,0
"Ukraine","2024-02-03",0,0,0,0,0,0,0,0
"Ukraine","2024-02-04",0,0,0,0,0,0,0,0
"Ukraine","2024-02-05",0,0,0,0,0,0,0,0
"Ukraine","2024-02-06",0,0,0,0,0,0,0,0
"Ukraine","2024-02-07",0,0,0,0,0,0,0,0
"Ukraine","2024-02-08",0,0,0,0,0,0,0,0
"Ukraine","2024-02-09",0,0,0,0,0,0,0,0
"Ukraine","2024-02-10",0,0,0,0,0,0,0,0
"Ukraine","2024-02-11",0,0,0,0,0,0,0,0
"Ukraine","2024-02-12",0,0,0,0,0,0,0,0
"Ukraine","2024-02-13",0,0,0,0,0,0,0,0
"Ukraine","2024-02-14",0,0,0,0,0,0,0,0
"Ukraine","2024-02-15",0,0,0,0,0,0,0,0
"Ukraine","2024-02-16",0,0,0,0,0,0,0,0
"Ukraine","2024-02-17",0,0,0,0,0,0,0,0
"Ukraine","2024-02-18",0,0,0,0,0,0,0,0
"Ukraine","2024-02-19",0,0,0,0,0,0,0,0
"Ukraine","2024-02-20",0,0,0,0,0,0,0,0
"Ukraine","2024-02-21",0,0,0,0,0,0,0,0
"Ukraine","2024-02-22",0,0,0,0,0,0,0,0
"Ukraine","2024-02-23",0,0,0,0,0,0,0,0
"Ukraine","2024-02-24",0,0,0,0,0,0,0,0
"Ukraine","2024-02-25",0,0,0,0,0,0,0,0
"Ukraine","2024-02-26",0,0,0,0,0,0,0,0
"Ukraine","2024-02-27",0,0,0,0,0,0,0,0
"Ukraine","2024-02-28",0,0,0,0,0,0,0,0
"Ukraine","2024-02-29",0,0,0,0,0,0,0,0
"Ukraine","2024-03-01",0,0,0,0,0,0,0,0
"Ukraine","2024-03-02",0,0,0,0,0,0,0,0
"Ukraine","2024-03-03",0,0,0,0,0,0,0,0
"Ukraine","2024-03-04",0,0,0,0,0,0,0,0
"Ukraine","2024-03-05",0,0,0,0,0,0,0,0
"Ukraine","2024-03-06",0,0,0,0,0,0,0,0
"Ukraine","2024-03-07",0,0,0,0,0,0,0,0
"Ukraine","2024-03-08",0,0,0,0,0,0,0,0
"Ukraine","2024-03-09",0,0,0,0,0,0,0,0
"Ukraine","2024-03-10",0,0,0,0,0,0,0,0
"Ukraine","2024-03-11",0,0,0,0,0,0,0,0
"Ukraine","2024-03-12",0,0,0,0,0,0,0,0
"Ukraine","2024-03-13",0,0,0,0,0,0,0,0
"Ukraine","2024-03-14",0,0,0,0,0,0,0,0
"Ukraine","2024-03-15",0,0,0,0,0,0,0,0
"Ukraine","2024-03-16",0,0,0,0,0,0,0,0
"Ukraine","2024-03-17",0,0,0,0,0,0,0,0
"Ukraine","2024-03-18",0,0,0,0,0,0,0,0
"Ukraine","2024-03-19",0,0,0,0,0,0,0,0
"Ukraine","2024-03-20",0,0,0,0,0,0,0,0
"Ukraine","2024-03-21",0,0,0,0,0,0,0,0
"Ukraine","2024-03-22",0,0,0,0,0,0,0,0
"Ukraine","2024-03-23",0,0,0,0,0,0,0,0
"Ukraine","2024-03-24",0,0,0,0,0,0,0,0
"Ukraine","2024-03-25",0,0,0,0,0,0,0,0
"Ukraine","2024-03-26",0,0,0,0,0,0,0,0
"Ukraine","2024-03-27",0,0,0,0,0,0,0,0
"Ukraine","2024-03-28",0,0,0,0,0,0,0,0
"Ukraine","2024-03-29",0,0,0,0,0,0,0,0
"Ukraine","2024-03-30",0,0,0,0,0,0,0,0
"Ukraine","2024-03-31",0,0,0,0,0,0,0,0
"Ukraine","2024-04-01",0,0,0,0,0,0,0,0
"Ukraine","2024-04-02",0,0,0,0,0,0,0,0
"Ukraine","2024-04-03",0,0,0,0,0,0,0,0
"Ukraine","2024-04-04",0,0,0,0,0,0,0,0
"Ukraine","2024-04-05",0,0,0,0,0,0,0,0
"Ukraine","2024-04-06",0,0,0,0,0,0,0,0
"Ukraine","2024-04-07",0,0,0,0,0,0,0,0
"Ukraine","2024-04-08",0,0,0,0,0,0,0,0
"Ukraine","2024-04-09",0,0,0,0,0,0,0,0
"Ukraine","2024-04-10",0,0,0,0,0,0,0,0
"Ukraine","2024-04-11",0,0,0,0,0,0,0,0
"Ukraine","2024-04-12",0,0,0,0,0,0,0,0
"Ukraine","2024-04-13",0,0,0,0,0,0,0,0
"Ukraine","2024-04-14",0,0,0,0,0,0,0,0
"Ukraine","2024-04-15",0,0,0,0,0,0,0,0
"Ukraine","2024-04-16",0,0,0,0,0,0,0,0
"Ukraine","2024-04-17",0,0,0,0,0,0,0,0
"Ukraine","2024-04-18",0,0,0,0,0,0,0,0
"Ukraine","2024-04-19",0,0,0,0,0,0,0,0
"Ukraine","2024-04-20",0,0,0,0,0,0,0,0
"Ukraine","2024-04-21",0,0,0,0,0,0,0,0
"Ukraine","2024-04-22",0,0,0,0,0,0,0,0
"Ukraine","2024-04-23",0,0,0,0,0,0,0,0
"Ukraine","2024-04-24",0,0,0,0,0,0,0,0
"Ukraine","2024-04-25",0,0,0,0,0,0,0,0
"Ukraine","2024-04-26",0,0,0,0,0,0,0,0
"Ukraine","2024-04-27",0,0,0,0,0,0,0,0
"Ukraine","2024-04-28",0,0,0,0,0,0,0,0
"Ukraine","2024-04-29",0,0,0,0,0,0,0,0
"Ukraine","2024-04-30",0,0,0,0,0,0,0,0
"Ukraine","2024-05-01",0,0,0,0,0,0,0,0
"Ukraine","2024-05-02",0,0,0,0,0,0,0,0
"Ukraine","2024-05-03",0,0,0,0,0,0,0,0
"Ukraine","2024-05-04",0,0,0,0,0,0,0,0
"Ukraine","2024-05-05",0,0,0,0,0,0,0,0
"Ukraine","2024-05-06",0,0,0,0,0,0,0,0
"Ukraine","2024-05-07",0,0,0,0,0,0,0,0
"Ukraine","2024-05-08",0,0,0,0,0,0,0,0
"Ukraine","2024-05-09",0,0,0,0,0,0,0,0
"Ukraine","2024-05-10",0,0,0,0,0,0,0,0
"Ukraine","2024-05-11",0,0,0,0,0,0,0,0
"Ukraine","2024-05-12",0,0,0,0,0,0,0,0
"Ukraine","2024-05-13",0,0,0,0,0,0,0,0
"Ukraine","2024-05-14",0,0,0,0,0,0,0,0
"Ukraine","2024-05-15",0,0,0,0,0,0,0,0
"Ukraine","2024-05-16",0,0,0,0,0,0,0,0
"Ukraine","2024-05-17",0,0,0,0,0,0,0,0
"Ukraine","2024-05-18",0,0,0,0,0,0,0,0
"Ukraine","2024-05-19",0,0,0,0,0,0,0,0
"Ukraine","2024-05-20",0,0,0,0,0,0,0,0
"Ukraine","2024-05-21",0,0,0,0,0,0,0,0
"Ukraine","2024-05-22",0,0,0,0,0,0,0,0
"Ukraine","2024-05-23",0,0,0,0,0,0,0,0
"Ukraine","2024-05-24",0,0,0,0,0,0,0,0
"Ukraine","2024-05-25",0,0,0,0,0,0,0,0
"Ukraine","2024-05-26",0,0,0,0,0,0,0,0
"Ukraine","2024-05-27",0,0,0,0,0,0,0,0
"Ukraine","2024-05-28",0,0,0,0,0,0,0,0
"Ukraine","2024-05-29",0,0,0,0,0,0,0,0
"Ukraine","2024-05-30",0,0,0,0,0,0,0,0
"Ukraine","2024-05-31",0,0,0,0,0,0,0,0
"Ukraine","2024-06-01",0,0,0,0,0,0,0,0
"Ukraine","2024-06-02",0,0,0,0,0,0,0,0
"Ukraine","2024-06-03",0,0,0,0,0,0,0,0
"Ukraine","2024-06-04",0,0,0,0,0,0,0,0
"Ukraine","2024-06-05",0,0,0,0,0,0,0,0
"Ukraine","2024-06-06",0,0,0,0,0,0,0,0
"Ukraine","2024-06-07",0,0,0,0,0,0,0,0
"Ukraine","2024-06-08",0,0,0,0,0,0,0,0
"Ukraine","2024-06-09",0,0,0,0,0,0,0,0
"Ukraine","2024-06-10",0,0,0,0,0,0,0,0
"Ukraine","2024-06-11",0,0,0,0,0,0,0,0
"Ukraine","2024-06-12",0,0,0,0,0,0,0,0
"Ukraine","2024-06-13",0,0,0,0,0,0,0,0
"Ukraine","2024-06-14",0,0,0,0,0,0,0,0
"Ukraine","2024-06-15",0,0,0,0,0,0,0,0
"Ukraine","2024-06-16",0,0,0,0,0,0,0,0
"Ukraine","2024-06-17",0,0,0,0,0,0,0,0
"Ukraine","2024-06-18",0,0,0,0,0,0,0,0
"Ukraine","2024-06-19",0,0,0,0,0,0,0,0
"Ukraine","2024-06-20",0,0,0,0,0,0,0,0
"Ukraine","2024-06-21",0,0,0,0,0,0,0,0
"Ukraine","2024-06-22",0,0,0,0,0,0,0,0
"Ukraine","2024-06-23",0,0,0,0,0,0,0,0
"Ukraine","2024-06-24",0,0,0,0,0,0,0,0
"Ukraine","2024-06-25",0,0,0,0,0,0,0,0
"Ukraine","2024-06-26",0,0,0,0,0,0,0,0
"Ukraine","2024-06-27",0,0,0,0,0,0,0,0
"Ukraine","2024-06-28",0,0,0,0,0,0,0,0
"Ukraine","2024-06-29",0,0,0,0,0,0,0,0
"Ukraine","2024-06-30",0,0,0,0,0,0,0,0
"Ukraine","2024-07-01",0,0,0,0,0,0,0,0
"Ukraine","2024-07-02",0,0,0,0,0,0,0,0
"Ukraine","2024-07-03",0,0,0,0,0,0,0,0
"Ukraine","2024-07-04",0,0,0,0,0,0,0,0
"Ukraine","2024-07-05",0,0,0,0,0,0,0,0
"Ukraine","2024-07-06",0,0,0,0,0,0,0,0
"Ukraine","2024-07-07",0,0,0,0,0,0,0,0
"Ukraine","2024-07-08",0,0,0,0,0,0,0,0
"Ukraine","2024-07-09",0,0,0,0,0,0,0,0
"Ukraine","2024-07-10",0,0,0,0,0,0,0,0
"Ukraine","2024-07-11",0,0,0,0,0,0,0,0
"Ukraine","2024-07-12",0,0,0,0,0,0,0,0
"Ukraine","2024-07-13",0,0,0,0,0,0,0,0
"Ukraine","2024-07-14",0,0,0,0,0,0,0,0
"Ukraine","2024-07-15",0,0,0,0,0,0,0,0
"Ukraine","2024-07-16",0,0,0,0,0,0,0,0
"Ukraine","2024-07-17",0,0,0,0,0,0,0,0
"Ukraine","2024-07-18",0,0,0,0,0,0,0,0
"Ukraine","2024-07-19",0,0,0,0,0,0,0,0
"Ukraine","2024-07-20",0,0,0,0,0,0,0,0
"Ukraine","2024-07-21",0,0,0,0,0,0,0,0
"Ukraine","2024-07-22",0,0,0,0,0,0,0,0
"Ukraine","2024-07-23",0,0,0,0,0,0,0,0
"Ukraine","2024-07-24",0,0,0,0,0,0,0,0
"Ukraine","2024-07-25",0,0,0,0,0,0,0,0
"Ukraine","2024-07-26",0,0,0,0,0,0,0,0
"Ukraine","2024-07-27",0,0,0,0,0,0,0,0
"Ukraine","2024-07-28",0,0,0,0,0,0,0,0
"Ukraine","2024-07-29",0,0,0,0,0,0,0,0
"Ukraine","2024-07-30",0,0,0,0,0,0,0,0
"Ukraine","2024-07-31",0,0,0,0,0,0,0,0
"Ukraine","2024-08-01",0,0,0,0,0,0,0,0
"Ukraine","2024-08-02",0,0,0,0,0,0,0,0
"Ukraine","2024-08-03",0,0,0,0,0,0,0,0
"Ukraine","2024-08-04",0,0,0,0,0,0,0,0
"Ukraine","2024-08-05",0,0,0,0,0,0,0,0
"Ukraine","2024-08-06",0,0,0,0,0,0,0,0
"Ukraine","2024-08-07",0,0,0,0,0,0,0,0
"Ukraine","2024-08-08",0,0,0,0,0,0,0,0
"Ukraine","2024-08-09",0,0,0,0,0,0,0,0
"Ukraine","2024-08-10",0,0,0,0,0,0,0,0
"Ukraine","2024-08-11",0,0,0,0,0,0,0,0
"Ukraine","2024-08-12",0,0,0,0,0,0,0,0
"Ukraine","2024-08-13",0,0,0,0,0,0,0,0
"Ukraine","2024-08-14",0,0,0,0,0,0,0,0
"Ukraine","2024-08-15",0,0,0,0,0,0,0,0
"Ukraine","2024-08-16",0,0,0,0,0,0,0,0
"Ukraine","2024-08-17",0,0,0,0,0,0,0,0
"Ukraine","2024-08-18",0,0,0,0,0,0,0,0
"Ukraine","2024-08-19",0,0,0,0,0,0,0,0
"Ukraine","2024-08-20",0,0,0,0,0,0,0,0
"Ukraine","2024-08-21",0,0,0,0,0,0,0,0
"Ukraine","2024-08-22",0,0,0,0,0,0,0,0
"Ukraine","2024-08-23",0,0,0,0,0,0,0,0
"Ukraine","2024-08-24",0,0,0,0,0,0,0,0
"Ukraine","2024-08-25",0,0,0,0,0,0,0,0
"Ukraine","2024-08-26",0,0,0,0,0,0,0,0
"Ukraine","2024-08-27",0,0,0,0,0,0,0,0
"Ukraine","2024-08-28",0,0,0,0,0,0,0,0
"Ukraine","2024-08-29",0,0,0,0,0,0,0,0
"Ukraine","2024-08-30",0,0,0,0,0,0,0,0
"Ukraine","2024-08-31",0,0,0,0,0,0,0,0
"Ukraine","2024-09-01",0,0,0,0,0,0,0,0
"Ukraine","2024-09-02",0,0,0,0,0,0,0,0
"Ukraine","2024-09-03",0,0,0,0,0,0,0,0
"Ukraine","2024-09-04",0,0,0,0,0,0,0,0
"Ukraine","2024-09-05",0,0,0,0,0,0,0,0
"Ukraine","2024-09-06",0,0,0,0,0,0,0,0
"Ukraine","2024-09-07",0,0,0,0,0,0,0,0
"Ukraine","2024-09-08",0,0,0,0,0,0,0,0
"Ukraine","2024-09-09",0,0,0,0,0,0,0,0
"Ukraine","2024-09-10",0,0,0,0,0,0,0,0
"Ukraine","2024-09-11",0,0,0,0,0,0,0,0
"Ukraine","2024-09-12",0,0,0,0,0,0,0,0
"Ukraine","2024-09-13",0,0,0,0,0,0,0,0
"Ukraine","2024-09-14",0,0,0,0,0,0,0,0
"Ukraine","2024-09-15",0,0,0,0,0,0,0,0
"Ukraine","2024-09-16",0,0,0,0,0,0,0,0
"Ukraine","2024-09-17",0,0,0,0,0,0,0,0
"Ukraine","2024-09-18",0,0,0,0,0,0,0,0
"Ukraine","2024-09-19",0,0,0,0,0,0,0,0
"Ukraine","2024-09-20",0,0,0,0,0,0,0,0
"Ukraine","2024-09-21",0,0,0,0,0,0,0,0
"Ukraine","2024-09-22",0,0,0,0,0,0,0,0
"Ukraine","2024-09-23",0,0,0,0,0,0,0,0
"Ukraine","2024-09-24",0,0,0,0,0,0,0,0
"Ukraine","2024-09-25",0,0,0,0,0,0,0,0
"Ukraine","2024-09-26",0,0,0,0,0,0,0,0
"Ukraine","2024-09-27",0,0,0,0,0,0,0,0
"Ukraine","2024-09-28",0,0,0,0,0,0,0,0
"Ukraine","2024-09-29",0,0,0,0,0,0,0,0
"Ukraine","2024-09-30",0,0,0,0,0,0,0,0
"Ukraine","2024-10-01",0,0,0,0,0,0,0,0
"Ukraine","2024-10-02",0,0,0,0,0,0,0,0
"Ukraine","2024-10-03",0,0,0,0,0,0,0,0
"Ukraine","2024-10-04",0,0,0,0,0,0,0,0
"Ukraine","2024-10-05",0,0,0,0,0,0,0,0
"Ukraine","2024-10-06",0,0,0,0,0,0,0,0
"Ukraine","2024-10-07",0,0,0,0,0,0,0,0
"Ukraine","2024-10-08",0,0,0,0,0,0,0,0
"Ukraine","2024-10-09",0,0,0,0,0,0,0,0
"Ukraine","2024-10-10",0,0,0,0,0,0,0,0
"Ukraine","2024-10-11",0,0,0,0,0,0,0,0
"Ukraine","2024-10-12",0,0,0,0,0,0,0,0
"Ukraine","2024-10-13",0,0,0,0,0,0,0,0
"Ukraine","2024-10-14",0,0,0,0,0,0,0,0
"Ukraine","2024-10-15",0,0,0,0,0,0,0,0
"Ukraine","2024-10-16",0,0,0,0,0,0,0,0
"Ukraine","2024-10-17",0,0,0,0,0,0,0,0
"Ukraine","2024-10-18",0,0,0,0,0,0,0,0
"Ukraine","2024-10-19",0,0,0,0,0,0,0,0
"Ukraine","2024-10-20",0,0,0,0,0,0,0,0
"Ukraine","2024-10-21",0,0,0,0,0,0,0,0
"Ukraine","2024-10-22",0,0,0,0,0,0,0,0
"Ukraine","2024-10-23",0,0,0,0,0,0,0,0
"Ukraine","2024-10-24",0,0,0,0,0,0,0,0
"Ukraine","2024-10-25",0,0,0,0,0,0,0,0
"Ukraine","2024-10-26",0,0,0,0,0,0,0,0
"Ukraine","2024-10-27",0,0,0,0,0,0,0,0
"Ukraine","2024-10-28",0,0,0,0,0,0,0,0
"Ukraine","2024-10-29",0,0,0,0,0,0,0,0
"Ukraine","2024-10-30",0,0,0,0,0,0,0,0
"Ukraine","2024-10-31",0,0,0,0,0,0,0,0
"Ukraine","2024-11-01",0,0,0,0,0,0,0,0
"Ukraine","2024-11-02",0,0,0,0,0,0,0,0
"Ukraine","2024-11-03",0,0,0,0,0,0,0,0
"Ukraine","2024-11-04",0,0,0,0,0,0,0,0
"Ukraine","2024-11-05",0,0,0,0,0,0,0,0
"Ukraine","2024-11-06",0,0,0,0,0,0,0,0
"Ukraine","2024-11-07",0,0,0,0,0,0,0,0
"Ukraine","2024-11-08",0,0,0,0,0,0,0,0
"Ukraine","2024-11-09",0,0,0,0,0,0,0,0
"Ukraine","2024-11-10",0,0,0,0,0,0,0,0
"Ukraine","2024-11-11",0,0,0,0,0,0,0,0
"Ukraine","2024-11-12",0,0,0,0,0,0,0,0
"Ukraine","2024-11-13",0,0,0,0,0,0,0,0
"Ukraine","2024-11-14",0,0,0,0,0,0,0,0
"Ukraine","2024-11-15",0,0,0,0,0,0,0,0
"Ukraine","2024-11-16",0,0,0,0,0,0,0,0
"Ukraine","2024-11-17",0,0,0,0,0,0,0,0
"Ukraine","2024-11-18",0,0,0,0,0,0,0,0
"Ukraine","2024-11-19",0,0,0,0,0,0,0,0
"Ukraine","2024-11-20",0,0,0,0,0,0,0,0
"Ukraine","2024-11-21",0,0,0,0,0,0,0,0
"Ukraine","2024-11-22",0,0,0,0,0,0,0,0
"Ukraine","2024-11-23",0,0,0,0,0,0,0,0
"Ukraine","2024-11-24",0,0,0,0,0,0,0,0
"Ukraine","2024-11-25",0,0,0,0,0,0,0,0
"Ukraine","2024-11-26",0,0,0,0,0,0,0,0
"Ukraine","2024-11-27",0,0,0,0,0,0,0,0
"Ukraine","2024-11-28",0,0,0,0,0,0,0,0
"Ukraine","2024-11-29",0,0,0,0,0,0,0,0
"Ukraine","2024-11-30",0,0,0,0,0,0,0,0
"Ukraine","2024-12-01",0,0,0,0,0,0,0,0
"Ukraine","2024-12-02",0,0,0,0,0,0,0,0
"Ukraine","2024-12-03",0,0,0,0,0,0,0,0
"Ukraine","2024-12-04",0,0,0,0,0,0,0,0
"Ukraine","2024-12-05",0,0,0,0,0,0,0,0
"Ukraine","2024-12-06",0,0,0,0,0,0,0,0
"Ukraine","2024-12-07",0,0,0,0,0,0,0,0
"Ukraine","2024-12-08",0,0,0,0,0,0,0,0
"Ukraine","2024-12-09",0,0,0,0,0,0,0,0
"Ukraine","2024-12-10",0,0,0,0,0,0,0,0
"Ukraine","2024-12-11",0,0,0,0,0,0,0,0
"Ukraine","2024-12-12",0,0,0,0,0,0,0,0
"Ukraine","2024-12-13",0,0,0,0,0,0,0,0
"Ukraine","2024-12-14",0,0,0,0,0,0,0,0
"Ukraine","2024-12-15",0,0,0,0,0,0,0,0
"Ukraine","2024-12-16",0,0,0,0,0,0,0,0
"Ukraine","2024-12-17",0,0,0,0,0,0,0,0
"Ukraine","2024-12-18",0,0,0,0,0,0,0,0
"Ukraine","2024-12-19",0,0,0,0,0,0,0,0
"Ukraine","2024-12-20",0,0,0,0,0,0,0,0
"Ukraine","2024-12-21",0,0,0,0,0,0,0,0
"Ukraine","2024-12-22",0,0,0,0,0,0,0,0
"Ukraine","2024-12-23",0,0,0,0,0,0,0,0
"Ukraine","2024-12-24",0,0,0,0,0,0,0,0
"Ukraine","2024-12-25",0,0,0,0,0,0,0,0
"Ukraine","2024-12-26",0,0,0,0,0,0,0,0
"Ukraine","2024-12-27",0,0,0,0,0,0,0,0
"Ukraine","2024-12-28",0,0,0,0,0,0,0,0
"Ukraine","2024-12-29",0,0,0,0,0,0,0,0
"Ukraine","2024-12-30",0,0,0,0,0,0,0,0
"Ukraine","2024-12-31",0,0,0,0,0,0,0,0
"Ukraine","2025-01-01",0,0,0,0,0,0,0,0
"Ukraine","2025-01-02",0,0,0,0,0,0,0,0
"Ukraine","2025-01-03",0,0,0,0,0,0,0,0
"Ukraine","2025-01-04",0,0,0,0,0,0,0,0
"Ukraine","2025-01-05",0,0,0,0,0,0,0,0
"Ukraine","2025-01-06",0,0,0,0,0,0,0,0
"Ukraine","2025-01-07",0,0,0,0,0,0,0,0
"Ukraine","2025-01-08",0,0,0,0,0,0,0,0
"Ukraine","2025-01-09",0,0,0,0,0,0,0,0
"Ukraine","2025-01-10",0,0,0,0,0,0,0,0
"Ukraine","2025-01-11",0,0,0,0,0,0,0,0
"Ukraine","2025-01-12",0,0,0,0,0,0,0,0
"Ukraine","2025-01-13",0,0,0,0,0,0,0,0
"United Arab Emirates","2024-01-01",0,0,0,0,0,0,0,0
"United Arab Emirates","2024-01-02",0,0,0,0,0,0,0,0
"United Arab Emirates","2024-01-03",0,0,0,0,0,0,0,0
"United Arab Emirates","2024-01-04",0,0,0,0,0,0,0,0
"United Arab Emirates","2024-01-05",0,0,0,0,0,0,0,0
"United Arab Emirates","2024-01-06",0,0,0,0,0,0,0,0
"United Arab Emirates","2024-01-07",0,0,0,0,0,0,0,0
"United Arab Emirates","2024-01-08",0,0,0,0,0,0,0,0
"United Arab Emirates","2024-01-09",0,0,0,0,0,0,0,0
"United Arab Emirates","2024-01-10",0,0,0,0,0,0,0,0
"United Arab Emirates","2024-01-11",0,1,1,0,1,1,0,0
"United Arab Emirates","2024-01-12",0,0,1,0,0,1,0,0
"United Arab Emirates","2024-01-13",0,0,1,0,0,1,0,0
"United Arab Emirates","2024-01-14",0,0,1,0,0,1,0,0
"United Arab Emirates","2024-01-15",0,0,1,0,0,1,0,0
"United Arab Emirates","2024-01-16",0,0,1,0,0,1,0,0
"United Arab Emirates","2024-01-17",0,0,1,0,0,1,0,0
"United Arab Emirates","2024-01-18",0,0,1,0,0,1,0,0
"United Arab Emirates","2024-01-19",0,0,1,0,0,1,0,0
"United Arab Emirates","2024-01-20",0,0,1,0,0,1,0,0
"United Arab Emirates","2024-01-21",0,0,1,0,0,1,0,0
"United Arab Emirates","2024-01-22",0,0,1,0,0,1,0,0
"United Arab Emirates","2024-01-23",0,0,1,0,0,1,0,0
"United Arab Emirates","2024-01-24",0,0,1,0,0,1,0,0
"United Arab Emirates","2024-01-25",0,0,1,0,0,1,0,0
"United Arab Emirates","2024-01-26",0,0,1,0,0,1,0,0
"United Arab Emirates","2024-01-27",0,0,1,0,0,1,0,0
"United Arab Emirates","2024-01-28",0,0,1,0,0,1,0,0
"United Arab Emirates","2024-01-29",0,0,1,0,0,1,0,0
"United Arab Emirates","2024-01-30",0,0,1,0,0,1,0,0
"United Arab Emirates","2024-01-31",0,0,1,0,0,1,0,0
"United Arab Emirates","2024-02-01",0,0,1,0,0,1,0,0
"United Arab Emirates","2024-02-02",0,0,1,0,0,1,0,0
"United Arab Emirates","2024-02-03",0,0,1,0,0,1,0,0
"United Arab Emirates","2024-02-04",0,0,1,0,0,1,0,0
"United Arab Emirates","2024-02-05",0,0,1,0,0,1,0,0
"United Arab Emirates","2024-02-06",0,0,1,0,1,2,0,0
"United Arab Emirates","2024-02-07",0,0,1,0,0,2,0,0
"United Arab Emirates","2024-02-08",0,0,1,0,0,2,0,0
"United Arab Emirates","2024-02-09",0,0,1,0,0,2,0,0
"United Arab Emirates","2024-02-10",0,0,1,0,0,2,0,0
"United Arab Emirates","2024-02-11",0,0,1,0,0,2,0,0
"United Arab Emirates","2024-02-12",0,0,1,0,0,2,0,0
"United Arab Emirates","2024-02-13",0,0,1,0,0,2,0,0
"United Arab Emirates","2024-02-14",0,0,1,0,0,2,0,0
"United Arab Emirates","2024-02-15",0,0,1,0,0,2,0,0
"United Arab Emirates","2024-02-16",0,0,1,0,0,2,0,0
"United Arab Emirates","2024-02-17",0,0,1,0,0,2,0,0
"United Arab Emirates","2024-02-18",0,0,1,0,0,2,0,0
"United Arab Emirates","2024-02-19",0,0,1,0,0,2,0,0
"United Arab Emirates","2024-02-20",0,0,1,0,0,2,0,0
"United Arab Emirates","2024-02-21",0,0,1,0,0,2,0,0
"United Arab Emirates","2024-02-22",0,0,1,0,0,2,0,0
"United Arab Emirates","2024-02-23",0,0,1,0,0,2,0,0
"United Arab Emirates","2024-02-24",0,0,1,0,0,2,0,0
"United Arab Emirates","2024-02-25",0,0,1,0,0,2,0,0
"United Arab Emirates","2024-02-26",0,0,1,0,0,2,0,0
"United Arab Emirates","2024-02-27",0,0,1,0,0,2,0,0
"United Arab Emirates","2024-02-28",0,0,1,0,0,2,0,0
"United Arab Emirates","2024-02-29",0,0,1,0,0,2,0,0
"United Arab Emirates","2024-03-01",0,0,1,0,0,2,0,0
"United Arab Emirates","2024-03-02",0,1,2,0,0,2,0,0
"United Arab Emirates","2024-03-03",0,0,2,0,0,2,0,0
"United Arab Emirates","2024-03-04",0,0,2,0,0,2,0,0
"United Arab Emirates","2024-03-05",0,0,2,0,0,2,0,0
"United Arab Emirates","2024-03-06",0,0,2,0,0,2,0,0
"United Arab Emirates","2024-03-07",0,0,2,0,0,2,0,0
"United Arab Emirates","2024-03-08",0,0,2,0,0,2,0,0
"United Arab Emirates","2024-03-09",0,0,2,0,0,2,0,0
"United Arab Emirates","2024-03-10",0,0,2,0,0,2,0,0
"United Arab Emirates","2024-03-11",0,0,2,0,0,2,0,0
"United Arab Emirates","2024-03-12",0,0,2,0,0,2,0,0
"United Arab Emirates","2024-03-13",0,0,2,0,0,2,0,0
"United Arab Emirates","2024-03-14",0,0,2,0,0,2,0,0
"United Arab Emirates","2024-03-15",0,0,2,0,0,2,0,0
"United Arab Emirates","2024-03-16",0,0,2,0,0,2,0,0
"United Arab Emirates","2024-03-17",0,0,2,0,0,2,0,0
"United Arab Emirates","2024-03-18",0,0,2,0,0,2,0,0
"United Arab Emirates","2024-03-19",0,0,2,0,0,2,0,0
"United Arab Emirates","2024-03-20",0,0,2,0,0,2,0,0
"United Arab Emirates","2024-03-21",0,0,2,0,0,2,0,0
"United Arab Emirates","2024-03-22",0,0,2,0,0,2,0,0
"United Arab Emirates","2024-03-23",0,0,2,0,0,2,0,0
"United Arab Emirates","2024-03-24",0,0,2,0,0,2,0,0
"United Arab Emirates","2024-03-25",0,0,2,0,0,2,0,0
"United Arab Emirates","2024-03-26",0,0,2,0,0,2,0,0
"United Arab Emirates","2024-03-27",0,0,2,0,1,3,0,0
"United Arab Emirates","2024-03-28",0,0,2,0,0,3,0,0
"United Arab Emirates","2024-03-29",0,0,2,0,0,3,0,0
"United Arab Emirates","2024-03-30",0,0,2,0,0,3,0,0
"United Arab Emirates","2024-03-31",0,0,2,0,0,3,0,0
"United Arab Emirates","2024-04-01",0,0,2,0,0,3,0,0
"United Arab Emirates","2024-04-02",0,0,2,0,0,3,0,0
"United Arab Emirates","2024-04-03",0,0,2,0,0,3,0,0
"United Arab Emirates","2024-04-04",0,0,2,0,0,3,0,0
"United Arab Emirates","2024-04-05",0,0,2,0,0,3,0,0
"United Arab Emirates","2024-04-06",0,0,2,0,0,3,0,0
"United Arab Emirates","2024-04-07",0,0,2,0,0,3,0,0
"United Arab Emirates","2024-04-08",0,0,2,0,0,3,0,0
"United Arab Emirates","2024-04-09",0,0,2,0,0,3,0,0
"United Arab Emirates","2024-04-10",0,0,2,0,0,3,0,0
"United Arab Emirates","2024-04-11",0,0,2,0,0,3,0,0
"United Arab Emirates","2024-04-12",0,0,2,0,0,3,0,0
"United Arab Emirates","2024-04-13",0,0,2,0,0,3,0,0
"United Arab Emirates","2024-04-14",0,0,2,0,0,3,0,0
"United Arab Emirates","2024-04-15",0,0,2,0,0,3,0,0
"United Arab Emirates","2024-04-16",0,0,2,0,0,3,0,0
"United Arab Emirates","2024-04-17",0,0,2,0,0,3,0,0
"United Arab Emirates","2024-04-18",0,0,2,0,0,3,0,0
"United Arab Emirates","2024-04-19",0,0,2,0,0,3,0,0
"United Arab Emirates","2024-04-20",0,1,3,0,0,3,0,0
"United Arab Emirates","2024-04-21",0,0,3,0,0,3,0,0
"United Arab Emirates","2024-04-22",0,0,3,0,0,3,0,0
"United Arab Emirates","2024-04-23",0,0,3,0,0,3,0,0
"United Arab Emirates","2024-04-24",0,0,3,0,0,3,0,0
"United Arab Emirates","2024-04-25",0,0,3,0,0,3,0,0
"United Arab Emirates","2024-04-26",0,0,3,0,0,3,0,0
"United Arab Emirates","2024-04-27",0,0,3,0,0,3,0,0
"United Arab Emirates","2024-04-28",0,0,3,0,0,3,0,0
"United Arab Emirates","2024-04-29",0,0,3,0,0,3,0,0
"United Arab Emirates","2024-04-30",0,0,3,0,0,3,0,0
"United Arab Emirates","2024-05-01",0,0,3,0,0,3,0,0
"United Arab Emirates","2024-05-02",0,0,3,0,0,3,0,0
"United Arab Emirates","2024-05-03",0,0,3,0,0,3,0,0
"United Arab Emirates","2024-05-04",0,0,3,0,0,3,0,0
"United Arab Emirates","2024-05-05",0,0,3,0,0,3,0,0
"United Arab Emirates","2024-05-06",0,0,3,0,0,3,0,0
"United Arab Emirates","2024-05-07",0,0,3,0,0,3,0,0
"United Arab Emirates","2024-05-08",0,0,3,0,0,3,0,0
"United Arab Emirates","2024-05-09",0,0,3,0,0,3,0,0
"United Arab Emirates","2024-05-10",0,0,3,0,0,3,0,0
"United Arab Emirates","2024-05-11",0,0,3,0,0,3,0,0
"United Arab Emirates","2024-05-12",0,0,3,0,0,3,0,0
"United Arab Emirates","2024-05-13",0,0,3,0,0,3,0,0
"United Arab Emirates","2024-05-14",0,0,3,0,0,3,0,0
"United Arab Emirates","2024-05-15",0,0,3,0,0,3,0,0
"United Arab Emirates","2024-05-16",0,0,3,0,0,3,0,0
"United Arab Emirates","2024-05-17",0,0,3,0,0,3,0,0
"United Arab Emirates","2024-05-18",0,0,3,0,0,3,0,0
"United Arab Emirates","2024-05-19",0,0,3,0,0,3,0,0
"United Arab Emirates","2024-05-20",0,0,3,0,0,3,0,0
"United Arab Emirates","2024-05-21",0,0,3,0,0,3,0,0
"United Arab Emirates","2024-05-22",0,0,3,0,0,3,0,0
"United Arab Emirates","2024-05-23",0,0,3,0,0,3,0,0
"United Arab Emirates","2024-05-24",0,0,3,0,0,3,0,0
"United Arab Emirates","2024-05-25",0,0,3,0,0,3,0,0
"United Arab Emirates","2024-05-26",0,0,3,0,0,3,0,0
"United Arab Emirates","2024-05-27",0,0,3,0,0,3,0,0
"United Arab Emirates","2024-05-28",0,0,3,0,0,3,0,0
"United Arab Emirates","2024-05-29",0,0,3,0,0,3,0,0
"United Arab Emirates","2024-05-30",0,0,3,0,0,3,0,0
"United Arab Emirates","2024-05-31",0,0,3,0,0,3,0,0
"United Arab Emirates","2024-06-01",0,0,3,0,0,3,0,0
"United Arab Emirates","2024-06-02",0,0,3,0,0,3,0,0
"United Arab Emirates","2024-06-03",0,0,3,0,0,3,0,0
"United Arab Emirates","2024-06-04",0,0,3,0,0,3,0,0
"United Arab Emirates","2024-06-05",0,0,3,0,0,3,0,0
"United Arab Emirates","2024-06-06",0,0,3,0,0,3,0,0
"United Arab Emirates","2024-06-07",0,0,3,0,0,3,0,0
"United Arab Emirates","2024-06-08",0,0,3,0,0,3,0,0
"United Arab Emirates","2024-06-09",0,0,3,0,0,3,0,0
"United Arab Emirates","2024-06-10",0,0,3,0,0,3,0,0
"United Arab Emirates","2024-06-11",0,0,3,0,0,3,0,0
"United Arab Emirates","2024-06-12",0,0,3,0,0,3,0,0
"United Arab Emirates","2024-06-13",0,0,3,0,0,3,0,0
"United Arab Emirates","2024-06-14",0,0,3,0,0,3,0,0
"United Arab Emirates","2024-06-15",0,0,3,0,0,3,0,0
"United Arab Emirates","2024-06-16",0,0,3,0,0,3,0,0
"United Arab Emirates","2024-06-17",0,0,3,0,0,3,0,0
"United Arab Emirates","2024-06-18",0,0,3,0,0,3,0,0
"United Arab Emirates","2024-06-19",0,0,3,0,0,3,0,0
"United Arab Emirates","2024-06-20",0,0,3,0,0,3,0,0
"United Arab Emirates","2024-06-21",0,0,3,0,0,3,0,0
"United Arab Emirates","2024-06-22",0,0,3,0,0,3,0,0
"United Arab Emirates","2024-06-23",0,0,3,0,0,3,0,0
"United Arab Emirates","2024-06-24",0,0,3,0,0,3,0,0
"United Arab Emirates","2024-06-25",0,0,3,0,0,3,0,0
"United Arab Emirates","2024-06-26",0,0,3,0,0,3,0,0
"United Arab Emirates","2024-06-27",0,0,3,0,0,3,0,0
"United Arab Emirates","2024-06-28",0,0,3,0,0,3,0,0
"United Arab Emirates","2024-06-29",0,0,3,0,0,3,0,0
"United Arab Emirates","2024-06-30",0,0,3,0,0,3,0,0
"United Arab Emirates","2024-07-01",0,0,3,0,0,3,0,0
"United Arab Emirates","2024-07-02",0,0,3,0,0,3,0,0
"United Arab Emirates","2024-07-03",0,0,3,0,0,3,0,0
"United Arab Emirates","2024-07-04",0,0,3,0,0,3,0,0
"United Arab Emirates","2024-07-05",0,0,3,0,0,3,0,0
"United Arab Emirates","2024-07-06",0,0,3,0,0,3,0,0
"United Arab Emirates","2024-07-07",0,0,3,0,0,3,0,0
"United Arab Emirates","2024-07-08",0,0,3,0,0,3,0,0
"United Arab Emirates","2024-07-09",0,0,3,0,0,3,0,0
"United Arab Emirates","2024-07-10",0,0,3,0,0,3,0,0
"United Arab Emirates","2024-07-11",0,0,3,0,1,4,0,0
"United Arab Emirates","2024-07-12",0,0,3,0,0,4,0,0
"United Arab Emirates","2024-07-13",0,0,3,0,0,4,0,0
"United Arab Emirates","2024-07-14",0,0,3,0,0,4,0,0
"United Arab Emirates","2024-07-15",0,0,3,0,0,4,0,0
"United Arab Emirates","2024-07-16",0,0,3,0,0,4,0,0
"United Arab Emirates","2024-07-17",0,0,3,0,0,4,0,0
"United Arab Emirates","2024-07-18",0,0,3,0,0,4,0,0
"United Arab Emirates","2024-07-19",0,0,3,0,0,4,0,0
"United Arab Emirates","2024-07-20",0,0,3,0,0,4,0,0
"United Arab Emirates","2024-07-21",0,0,3,0,0,4,0,0
"United Arab Emirates","2024-07-22",0,0,3,0,0,4,0,0
"United Arab Emirates","2024-07-23",0,0,3,0,0,4,0,0
"United Arab Emirates","2024-07-24",0,0,3,0,0,4,0,0
"United Arab Emirates","2024-07-25",0,0,3,0,0,4,0,0
"United Arab Emirates","2024-07-26",0,0,3,0,0,4,0,0
"United Arab Emirates","2024-07-27",0,0,3,0,0,4,0,0
"United Arab Emirates","2024-07-28",0,0,3,0,0,4,0,0
"United Arab Emirates","2024-07-29",0,0,3,0,0,4,0,0
"United Arab Emirates","2024-07-30",0,0,3,0,0,4,0,0
"United Arab Emirates","2024-07-31",0,0,3,0,0,4,0,0
"United Arab Emirates","2024-08-01",0,0,3,0,0,4,0,0
"United Arab Emirates","2024-08-02",0,0,3,0,0,4,0,0
"United Arab Emirates","2024-08-03",0,0,3,0,0,4,0,0
"United Arab Emirates","2024-08-04",0,0,3,0,0,4,0,0
"United Arab Emirates","2024-08-05",0,0,3,0,0,4,0,0
"United Arab Emirates","2024-08-06",0,0,3,0,0,4,0,0
"United Arab Emirates","2024-08-07",0,0,3,0,0,4,0,0
"United Arab Emirates","2024-08-08",0,0,3,0,0,4,0,0
"United Arab Emirates","2024-08-09",0,0,3,0,0,4,0,0
"United Arab Emirates","2024-08-10",0,0,3,0,0,4,0,0
"United Arab Emirates","2024-08-11",0,0,3,0,0,4,0,0
"United Arab Emirates","2024-08-12",0,0,3,0,0,4,0,0
"United Arab Emirates","2024-08-13",0,0,3,0,0,4,0,0
"United Arab Emirates","2024-08-14",0,0,3,0,0,4,0,0
"United Arab Emirates","2024-08-15",0,0,3,0,0,4,0,0
"United Arab Emirates","2024-08-16",0,0,3,0,0,4,0,0
"United Arab Emirates","2024-08-17",0,0,3,0,0,4,0,0
"United Arab Emirates","2024-08-18",0,0,3,0,0,4,0,0
"United Arab Emirates","2024-08-19",0,0,3,0,0,4,0,0
"United Arab Emirates","2024-08-20",0,0,3,0,0,4,0,0
"United Arab Emirates","2024-08-21",0,0,3,0,0,4,0,0
"United Arab Emirates","2024-08-22",0,0,3,0,0,4,0,0
"United Arab Emirates","2024-08-23",0,0,3,0,0,4,0,0
"United Arab Emirates","2024-08-24",0,0,3,0,0,4,0,0
"United Arab Emirates","2024-08-25",0,0,3,0,0,4,0,0
"United Arab Emirates","2024-08-26",0,0,3,0,0,4,0,0
"United Arab Emirates","2024-08-27",0,0,3,0,0,4,0,0
"United Arab Emirates","2024-08-28",0,0,3,0,0,4,0,0
"United Arab Emirates","2024-08-29",0,0,3,0,0,4,0,0
"United Arab Emirates","2024-08-30",0,0,3,0,0,4,0,0
"United Arab Emirates","2024-08-31",0,0,3,0,0,4,0,0
"United Arab Emirates","2024-09-01",0,0,3,0,0,4,0,0
"United Arab Emirates","2024-09-02",0,0,3,0,0,4,0,0
"United Arab Emirates","2024-09-03",0,0,3,0,0,4,0,0
"United Arab Emirates","2024-09-04",0,0,3,0,0,4,0,0
"United Arab Emirates","2024-09-05",0,0,3,0,0,4,0,0
"United Arab Emirates","2024-09-06",0,0,3,0,0,4,0,0
"United Arab Emirates","2024-09-07",0,0,3,0,0,4,0,0
"United Arab Emirates","2024-09-08",0,0,3,0,0,4,0,0
"United Arab Emirates","2024-09-09",0,0,3,0,0,4,0,0
"United Arab Emirates","2024-09-10",0,0,3,0,0,4,0,0
"United Arab Emirates","2024-09-11",0,0,3,0,0,4,0,0
"United Arab Emirates","2024-09-12",0,0,3,0,0,4,0,0
"United Arab Emirates","2024-09-13",0,0,3,0,0,4,0,0
"United Arab Emirates","2024-09-14",0,0,3,0,0,4,0,0
"United Arab Emirates","2024-09-15",0,0,3,0,0,4,0,0
"United Arab Emirates","2024-09-16",0,0,3,0,0,4,0,0
"United Arab Emirates","2024-09-17",0,0,3,0,0,4,0,0
"United Arab Emirates","2024-09-18",0,0,3,0,0,4,0,0
"United Arab Emirates","2024-09-19",0,0,3,0,0,4,0,0
"United Arab Emirates","2024-09-20",0,0,3,0,0,4,0,0
"United Arab Emirates","2024-09-21",0,0,3,0,0,4,0,0
"United Arab Emirates","2024-09-22",0,0,3,0,0,4,0,0
"United Arab Emirates","2024-09-23",0,0,3,0,0,4,0,0
"United Arab Emirates","2024-09-24",0,0,3,0,0,4,0,0
"United Arab Emirates","2024-09-25",0,0,3,0,0,4,0,0
"United Arab Emirates","2024-09-26",0,0,3,0,0,4,0,0
"United Arab Emirates","2024-09-27",0,0,3,0,0,4,0,0
"United Arab Emirates","2024-09-28",0,0,3,0,0,4,0,0
"United Arab Emirates","2024-09-29",0,0,3,0,0,4,0,0
"United Arab Emirates","2024-09-30",0,1,4,0,0,4,0,0
"United Arab Emirates","2024-10-01",0,0,4,0,0,4,0,0
"United Arab Emirates","2024-10-02",0,0,4,0,0,4,0,0
"United Arab Emirates","2024-10-03",0,0,4,0,0,4,0,0
"United Arab Emirates","2024-10-04",0,0,4,0,0,4,0,0
"United Arab Emirates","2024-10-05",0,0,4,0,0,4,0,0
"United Arab Emirates","2024-10-06",0,0,4,0,0,4,0,0
"United Arab Emirates","2024-10-07",0,0,4,0,0,4,0,0
"United Arab Emirates","2024-10-08",0,0,4,0,0,4,0,0
"United Arab Emirates","2024-10-09",0,0,4,0,0,4,0,0
"United Arab Emirates","2024-10-10",0,0,4,0,0,4,0,0
"United Arab Emirates","2024-10-11",0,0,4,0,0,4,0,0
"United Arab Emirates","2024-10-12",0,0,4,0,0,4,0,0
"United Arab Emirates","2024-10-13",0,0,4,0,0,4,0,0
"United Arab Emirates","2024-10-14",0,0,4,0,0,4,0,0
"United Arab Emirates","2024-10-15",0,0,4,0,0,4,0,0
"United Arab Emirates","2024-10-16",0,0,4,0,1,5,0,0
"United Arab Emirates","2024-10-17",0,0,4,0,0,5,0,0
"United Arab Emirates","2024-10-18",0,0,4,0,0,5,0,0
"United Arab Emirates","2024-10-19",0,0,4,0,0,5,0,0
"United Arab Emirates","2024-10-20",0,0,4,0,0,5,0,0
"United Arab Emirates","2024-10-21",0,0,4,0,0,5,0,0
"United Arab Emirates","2024-10-22",0,0,4,0,0,5,0,0
"United Arab Emirates","2024-10-23",0,0,4,0,0,5,0,0
"United Arab Emirates","2024-10-24",0,0,4,0,0,5,0,0
"United Arab Emirates","2024-10-25",0,0,4,0,0,5,0,0
"United Arab Emirates","2024-10-26",0,0,4,0,0,5,0,0
"United Arab Emirates","2024-10-27",0,0,4,0,0,5,0,0
"United Arab Emirates","2024-10-28",0,0,4,0,0,5,0,0
"United Arab Emirates","2024-10-29",0,0,4,0,0,5,0,0
"United Arab Emirates","2024-10-30",0,1,5,0,0,5,0,0
"United Arab Emirates","2024-10-31",0,0,5,0,0,5,0,0
"United Arab Emirates","2024-11-01",0,0,5,0,0,5,0,0
"United Arab Emirates","2024-11-02",0,0,5,0,0,5,0,0
"United Arab Emirates","2024-11-03",0,0,5,0,0,5,0,0
"United Arab Emirates","2024-11-04",0,0,5,0,0,5,0,0
"United Arab Emirates","2024-11-05",0,0,5,0,0,5,0,0
"United Arab Emirates","2024-11-06",0,0,5,0,0,5,0,0
"United Arab Emirates","2024-11-07",0,0,5,0,0,5,0,0
"United Arab Emirates","2024-11-08",0,0,5,0,0,5,0,0
"United Arab Emirates","2024-11-09",0,0,5,0,0,5,0,0
"United Arab Emirates","2024-11-10",0,0,5,0,0,5,0,0
"United Arab Emirates","2024-11-11",0,0,5,0,0,5,0,0
"United Arab Emirates","2024-11-12",0,0,5,0,0,5,0,0
"United Arab Emirates","2024-11-13",0,0,5,0,0,5,0,0
"United Arab Emirates","2024-11-14",0,0,5,0,0,5,0,0
"United Arab Emirates","2024-11-15",0,0,5,0,0,5,0,0
"United Arab Emirates","2024-11-16",0,0,5,0,0,5,0,0
"United Arab Emirates","2024-11-17",0,0,5,0,0,5,0,0
"United Arab Emirates","2024-11-18",0,0,5,0,0,5,0,0
"United Arab Emirates","2024-11-19",0,0,5,0,0,5,0,0
"United Arab Emirates","2024-11-20",0,0,5,0,0,5,0,0
"United Arab Emirates","2024-11-21",0,0,5,0,0,5,0,0
"United Arab Emirates","2024-11-22",0,0,5,0,0,5,0,0
"United Arab Emirates","2024-11-23",0,0,5,0,0,5,0,0
"United Arab Emirates","2024-11-24",0,0,5,0,0,5,0,0
"United Arab Emirates","2024-11-25",0,0,5,0,0,5,0,0
"United Arab Emirates","2024-11-26",0,0,5,0,0,5,0,0
"United Arab Emirates","2024-11-27",0,0,5,0,0,5,0,0
"United Arab Emirates","2024-11-28",0,0,5,0,0,5,0,0
"United Arab Emirates","2024-11-29",0,0,5,0,0,5,0,0
"United Arab Emirates","2024-11-30",0,0,5,0,0,5,0,0
"United Arab Emirates","2024-12-01",0,0,5,0,0,5,0,0
"United Arab Emirates","2024-12-02",0,0,5,0,0,5,0,0
"United Arab Emirates","2024-12-03",0,0,5,0,0,5,0,0
"United Arab Emirates","2024-12-04",0,0,5,0,0,5,0,0
"United Arab Emirates","2024-12-05",0,0,5,0,0,5,0,0
"United Arab Emirates","2024-12-06",0,0,5,0,0,5,0,0
"United Arab Emirates","2024-12-07",0,0,5,0,0,5,0,0
"United Arab Emirates","2024-12-08",0,0,5,0,0,5,0,0
"United Arab Emirates","2024-12-09",0,0,5,0,0,5,0,0
"United Arab Emirates","2024-12-10",0,0,5,0,0,5,0,0
"United Arab Emirates","2024-12-11",0,0,5,0,0,5,0,0
"United Arab Emirates","2024-12-12",0,0,5,0,0,5,0,0
"United Arab Emirates","2024-12-13",0,0,5,0,0,5,0,0
"United Arab Emirates","2024-12-14",0,0,5,0,0,5,0,0
"United Arab Emirates","2024-12-15",0,0,5,0,0,5,0,0
"United Arab Emirates","2024-12-16",0,0,5,0,0,5,0,0
"United Arab Emirates","2024-12-17",0,0,5,0,0,5,0,0
"United Arab Emirates","2024-12-18",0,0,5,0,0,5,0,0
"United Arab Emirates","2024-12-19",0,0,5,0,0,5,0,0
"United Arab Emirates","2024-12-20",0,0,5,0,0,5,0,0
"United Arab Emirates","2024-12-21",0,0,5,0,0,5,0,0
"United Arab Emirates","2024-12-22",0,0,5,0,0,5,0,0
"United Arab Emirates","2024-12-23",0,0,5,0,0,5,0,0
"United Arab Emirates","2024-12-24",0,0,5,0,0,5,0,0
"United Arab Emirates","2024-12-25",0,0,5,0,0,5,0,0
"United Arab Emirates","2024-12-26",0,0,5,0,0,5,0,0
"United Arab Emirates","2024-12-27",0,0,5,0,0,5,0,0
"United Arab Emirates","2024-12-28",0,0,5,0,0,5,0,0
"United Arab Emirates","2024-12-29",0,0,5,0,0,5,0,0
"United Arab Emirates","2024-12-30",0,0,5,0,0,5,0,0
"United Arab Emirates","2024-12-31",0,0,5,0,0,5,0,0
"United Arab Emirates","2025-01-01",0,0,5,0,0,5,0,0
"United Arab Emirates","2025-01-02",0,0,5,0,0,5,0,0
"United Arab Emirates","2025-01-03",0,0,5,0,0,5,0,0
"United Arab Emirates","2025-01-04",0,0,5,0,0,5,0,0
"United Arab Emirates","2025-01-05",0,0,5,0,0,5,0,0
"United Arab Emirates","2025-01-06",0,0,5,0,0,5,0,0
"United Arab Emirates","2025-01-07",0,0,5,0,0,5,0,0
"United Arab Emirates","2025-01-08",0,0,5,0,0,5,0,0
"United Arab Emirates","2025-01-09",0,0,5,0,0,5,0,0
"United Arab Emirates","2025-01-10",0,0,5,0,0,5,0,0
"United Arab Emirates","2025-01-11",0,0,5,0,0,5,0,0
"United Arab Emirates","2025-01-12",0,0,5,0,0,5,0,0
"United Arab Emirates","2025-01-13",0,0,5,0,0,5,0,0
"United Kingdom of Great Britain and Northern Ireland","2024-01-01",0,0,0,0,0,0,0,0
"United Kingdom of Great Britain and Northern Ireland","2024-01-02",0,0,0,0,0,0,0,0
"United Kingdom of Great Britain and Northern Ireland","2024-01-03",0,0,0,0,0,0,0,0
"United Kingdom of Great Britain and Northern Ireland","2024-01-04",0,0,0,0,0,0,0,0
"United Kingdom of Great Britain and Northern Ireland","2024-01-05",0,0,0,0,0,0,0,0
"United Kingdom of Great Britain and Northern Ireland","2024-01-06",0,0,0,0,0,0,0,0
"United Kingdom of Great Britain and Northern Ireland","2024-01-07",0,0,0,0,0,0,0,0
"United Kingdom of Great Britain and Northern Ireland","2024-01-08",0,0,0,0,0,0,0,0
"United Kingdom of Great Britain and Northern Ireland","2024-01-09",0,0,0,0,0,0,0,0
"United Kingdom of Great Britain and Northern Ireland","2024-01-10",0,0,0,0,0,0,0,0
"United Kingdom of Great Britain and Northern Ireland","2024-01-11",0,0,0,0,0,0,0,0
"United Kingdom of Great Britain and Northern Ireland","2024-01-12",0,0,0,0,0,0,0,0
"United Kingdom of Great Britain and Northern Ireland","2024-01-13",0,0,0,0,0,0,0,0
"United Kingdom of Great Britain and Northern Ireland","2024-01-14",0,0,0,0,0,0,0,0
"United Kingdom of Great Britain and Northern Ireland","2024-01-15",0,0,0,0,0,0,0,0
"United Kingdom of Great Britain and Northern Ireland","2024-01-16",0,0,0,0,0,0,0,0
"United Kingdom of Great Britain and Northern Ireland","2024-01-17",0,0,0,0,0,0,0,0
"United Kingdom of Great Britain and Northern Ireland","2024-01-18",0,0,0,0,0,0,0,0
"United Kingdom of Great Britain and Northern Ireland","2024-01-19",0,0,0,0,0,0,0,0
"United Kingdom of Great Britain and Northern Ireland","2024-01-20",0,0,0,0,0,0,0,0
"United Kingdom of Great Britain and Northern Ireland","2024-01-21",0,0,0,0,0,0,0,0
"United Kingdom of Great Britain and Northern Ireland","2024-01-22",0,0,0,0,0,0,0,0
"United Kingdom of Great Britain and Northern Ireland","2024-01-23",0,0,0,0,0,0,0,0
"United Kingdom of Great Britain and Northern Ireland","2024-01-24",0,0,0,0,0,0,0,0
"United Kingdom of Great Britain and Northern Ireland","2024-01-25",0,0,0,0,0,0,0,0
"United Kingdom of Great Britain and Northern Ireland","2024-01-26",0,0,0,0,0,0,0,0
"United Kingdom of Great Britain and Northern Ireland","2024-01-27",0,0,0,0,0,0,0,0
"United Kingdom of Great Britain and Northern Ireland","2024-01-28",0,0,0,0,0,0,0,0
"United Kingdom of Great Britain and Northern Ireland","2024-01-29",0,0,0,0,0,0,0,0
"United Kingdom of Great Britain and Northern Ireland","2024-01-30",0,0,0,0,0,0,0,0
"United Kingdom of Great Britain and Northern Ireland","2024-01-31",0,7,7,0,7,7,0,0
"United Kingdom of Great Britain and Northern Ireland","2024-02-01",0,0,7,0,0,7,0,0
"United Kingdom of Great Britain and Northern Ireland","2024-02-02",0,0,7,0,1,8,0,0
"United Kingdom of Great Britain and Northern Ireland","2024-02-03",0,0,7,0,0,8,0,0
"United Kingdom of Great Britain and Northern Ireland","2024-02-04",0,0,7,0,0,8,0,0
"United Kingdom of Great Britain and Northern Ireland","2024-02-05",0,0,7,0,1,9,0,0
"United Kingdom of Great Britain and Northern Ireland","2024-02-06",0,0,7,0,0,9,0,0
"United Kingdom of Great Britain and Northern Ireland","2024-02-07",0,0,7,0,0,9,0,0
"United Kingdom of Great Britain and Northern Ireland","2024-02-08",0,0,7,0,1,10,0,0
"United Kingdom of Great Britain and Northern Ireland","2024-02-09",0,0,7,0,0,10,0,0
"United Kingdom of Great Britain and Northern Ireland","2024-02-10",0,0,7,0,0,10,0,0
"United Kingdom of Great Britain and Northern Ireland","2024-02-11",0,0,7,0,1,11,0,0
"United Kingdom of Great Britain and Northern Ireland","2024-02-12",0,0,7,0,0,11,0,0
"United Kingdom of Great Britain and Northern Ireland","2024-02-13",0,0,7,0,0,11,0,0
"United Kingdom of Great Britain and Northern Ireland","2024-02-14",0,0,7,0,1,12,0,0
"United Kingdom of Great Britain and Northern Ireland","2024-02-15",0,0,7,0,0,12,0,0
"United Kingdom of Great Britain and Northern Ireland","2024-02-16",0,0,7,0,1,13,0,0
"United Kingdom of Great Britain and Northern Ireland","2024-02-17",0,0,7,0,0,13,0,0
"United Kingdom of Great Britain and Northern Ireland","2024-02-18",0,0,7,0,0,13,0,0
"United Kingdom of Great Britain and Northern Ireland","2024-02-19",0,0,7,0,1,14,0,0
"United Kingdom of Great Britain and Northern Ireland","2024-02-20",0,0,7,0,0,14,0,0
"United Kingdom of Great Britain and Northern Ireland","2024-02-21",0,0,7,0,0,14,0,0
"United Kingdom of Great Britain and Northern Ireland","2024-02-22",0,0,7,0,1,15,0,0
"United Kingdom of Great Britain and Northern Ireland","2024-02-23",0,0,7,0,0,15,0,0
"United Kingdom of Great Britain and Northern Ireland","2024-02-24",0,0,7,0,0,15,0,0
"United Kingdom of Great Britain and Northern Ireland","2024-02-25",0,0,7,0,1,16,0,0
"United Kingdom of Great Britain and Northern Ireland","2024-02-26",0,0,7,0,0,16,0,0
"United Kingdom of Great Britain and Northern Ireland","2024-02-27",0,0,7,0,0,16,0,0
"United Kingdom of Great Britain and Northern Ireland","2024-02-28",0,0,7,0,1,17,0,0
"United Kingdom of Great Britain and Northern Ireland","2024-02-29",0,10,17,0,0,17,0,0
"United Kingdom of Great Britain and Northern Ireland","2024-03-01",0,0,17,0,1,18,0,0
"United Kingdom of Great Britain and Northern Ireland","2024-03-02",0,0,17,0,0,18,0,0
"United Kingdom of Great Britain and Northern Ireland","2024-03-03",0,0,17,0,1,19,0,0
"United Kingdom of Great Britain and Northern Ireland","2024-03-04",0,0,17,0,0,19,0,0
"United Kingdom of Great Britain and Northern Ireland","2024-03-05",0,0,17,0,1,20,0,0
"United Kingdom of Great Britain and Northern Ireland","2024-03-06",0,0,17,0,0,20,0,0
"United Kingdom of Great Britain and Northern Ireland","2024-03-07",0,0,17,0,1,21,0,0
"United Kingdom of Great Britain and Northern Ireland","2024-03-08",0,0,17,0,0,21,0,0
"United Kingdom of Great Britain and Northern Ireland","2024-03-09",0,0,17,0,1,22,0,0
"United Kingdom of Great Britain and Northern Ireland","2024-03-10",0,0,17,0,0,22,0,0
"United Kingdom of Great Britain and Northern Ireland","2024-03-11",0,0,17,0,1,23,0,0
"United Kingdom of Great Britain and Northern Ireland","2024-03-12",0,0,17,0,0,23,0,0
"United Kingdom of Great Britain and Northern Ireland","2024-03-13",0,0,17,0,1,24,0,0
"United Kingdom of Great Britain and Northern Ireland","2024-03-14",0,0,17,0,0,24,0,0
"United Kingdom of Great Britain and Northern Ireland","2024-03-15",0,0,17,0,1,25,0,0
"United Kingdom of Great Britain and Northern Ireland","2024-03-16",0,0,17,0,0,25,0,0
"United Kingdom of Great Britain and Northern Ireland","2024-03-17",0,0,17,0,1,26,0,0
"United Kingdom of Great Britain and Northern Ireland","2024-03-18",0,0,17,0,0,26,0,0
"United Kingdom of Great Britain and Northern Ireland","2024-03-19",0,0,17,0,1,27,0,0
"United Kingdom of Great Britain and Northern Ireland","2024-03-20",0,0,17,0,0,27,0,0
"United Kingdom of Great Britain and Northern Ireland","2024-03-21",0,0,17,0,1,28,0,0
"United Kingdom of Great Britain and Northern Ireland","2024-03-22",0,0,17,0,0,28,0,0
"United Kingdom of Great Britain and Northern Ireland","2024-03-23",0,0,17,0,1,29,0,0
"United Kingdom of Great Britain and Northern Ireland","2024-03-24",0,0,17,0,0,29,0,0
"United Kingdom of Great Britain and Northern Ireland","2024-03-25",0,0,17,0,1,30,0,0
"United Kingdom of Great Britain and Northern Ireland","2024-03-26",0,0,17,0,0,30,0,0
"United Kingdom of Great Britain and Northern Ireland","2024-03-27",0,0,17,0,1,31,0,0
"United Kingdom of Great Britain and Northern Ireland","2024-03-28",0,0,17,0,0,31,0,0
"United Kingdom of Great Britain and Northern Ireland","2024-03-29",0,0,17,0,1,32,0,0
"United Kingdom of Great Britain and Northern Ireland","2024-03-30",0,0,17,0,0,32,0,0
"United Kingdom of Great Britain and Northern Ireland","2024-03-31",0,16,33,0,1,33,0,0
"United Kingdom of Great Britain and Northern Ireland","2024-04-01",0,0,33,0,1,34,0,0
"United Kingdom of Great Britain and Northern Ireland","2024-04-02",0,0,33,0,0,34,0,0
"United Kingdom of Great Britain and Northern Ireland","2024-04-03",0,0,33,0,1,35,0,0
"United Kingdom of Great Britain and Northern Ireland","2024-04-04",0,0,33,0,1,36,0,0
"United Kingdom of Great Britain and Northern Ireland","2024-04-05",0,0,33,0,0,36,0,0
"United Kingdom of Great Britain and Northern Ireland","2024-04-06",0,0,33,0,1,37,0,0
"United Kingdom of Great Britain and Northern Ireland","2024-04-07",0,0,33,0,1,38,0,0
"United Kingdom of Great Britain and Northern Ireland","2024-04-08",0,0,33,0,0,38,0,0
"United Kingdom of Great Britain and Northern Ireland","2024-04-09",0,0,33,0,1,39,0,0
"United Kingdom of Great Britain and Northern Ireland","2024-04-10",0,0,33,0,1,40,0,0
"United Kingdom of Great Britain and Northern Ireland","2024-04-11",0,0,33,0,0,40,0,0
"United Kingdom of Great Britain and Northern Ireland","2024-04-12",0,0,33,0,1,41,0,0
"United Kingdom of Great Britain and Northern Ireland","2024-04-13",0,0,33,0,1,42,0,0
"United Kingdom of Great Britain and Northern Ireland","2024-04-14",0,0,33,0,0,42,0,0
"United Kingdom of Great Britain and Northern Ireland","2024-04-15",0,0,33,0,1,43,0,0
"United Kingdom of Great Britain and Northern Ireland","2024-04-16",0,0,33,0,1,44,0,0
"United Kingdom of Great Britain and Northern Ireland","2024-04-17",0,0,33,0,0,44,0,0
"United Kingdom of Great Britain and Northern Ireland","2024-04-18",0,0,33,0,1,45,0,0
"United Kingdom of Great Britain and Northern Ireland","2024-04-19",0,0,33,0,1,46,0,0
"United Kingdom of Great Britain and Northern Ireland","2024-04-20",0,0,33,0,0,46,0,0
"United Kingdom of Great Britain and Northern Ireland","2024-04-21",0,0,33,0,1,47,0,0
"United Kingdom of Great Britain and Northern Ireland","2024-04-22",0,0,33,0,1,48,0,0
"United Kingdom of Great Britain and Northern Ireland","2024-04-23",0,0,33,0,0,48,0,0
"United Kingdom of Great Britain and Northern Ireland","2024-04-24",0,0,33,0,1,49,0,0
"United Kingdom of Great Britain and Northern Ireland","2024-04-25",0,0,33,0,1,50,0,0
"United Kingdom of Great Britain and Northern Ireland","2024-04-26",0,0,33,0,0,50,0,0
"United Kingdom of Great Britain and Northern Ireland","2024-04-27",0,0,33,0,1,51,0,0
"United Kingdom of Great Britain and Northern Ireland","2024-04-28",0,0,33,0,1,52,0,0
"United Kingdom of Great Britain and Northern Ireland","2024-04-29",0,0,33,0,0,52,0,0
"United Kingdom of Great Britain and Northern Ireland","2024-04-30",0,20,53,0,1,53,0,0
"United Kingdom of Great Britain and Northern Ireland","2024-05-01",0,0,53,0,1,54,0,0
"United Kingdom of Great Britain and Northern Ireland","2024-05-02",0,0,53,0,1,55,0,0
"United Kingdom of Great Britain and Northern Ireland","2024-05-03",0,0,53,0,0,55,0,0
"United Kingdom of Great Britain and Northern Ireland","2024-05-04",0,0,53,0,1,56,0,0
"United Kingdom of Great Britain and Northern Ireland","2024-05-05",0,0,53,0,1,57,0,0
"United Kingdom of Great Britain and Northern Ireland","2024-05-06",0,0,53,0,1,58,0,0
"United Kingdom of Great Britain and Northern Ireland","2024-05-07",0,0,53,0,0,58,0,0
"United Kingdom of Great Britain and Northern Ireland","2024-05-08",0,0,53,0,1,59,0,0
"United Kingdom of Great Britain and Northern Ireland","2024-05-09",0,0,53,0,1,60,0,0
"United Kingdom of Great Britain and Northern Ireland","2024-05-10",0,0,53,0,1,61,0,0
"United Kingdom of Great Britain and Northern Ireland","2024-05-11",0,0,53,0,1,62,0,0
"United Kingdom of Great Britain and Northern Ireland","2024-05-12",0,0,53,0,0,62,0,0
"United Kingdom of Great Britain and Northern Ireland","2024-05-13",0,0,53,0,1,63,0,0
"United Kingdom of Great Britain and Northern Ireland","2024-05-14",0,0,53,0,1,64,0,0
"United Kingdom of Great Britain and Northern Ireland","2024-05-15",0,0,53,0,1,65,0,0
"United Kingdom of Great Britain and Northern Ireland","2024-05-16",0,0,53,0,0,65,0,0
"United Kingdom of Great Britain and Northern Ireland","2024-05-17",0,0,53,0,1,66,0,0
"United Kingdom of Great Britain and Northern Ireland","2024-05-18",0,0,53,0,1,67,0,0
"United Kingdom of Great Britain and Northern Ireland","2024-05-19",0,0,53,0,1,68,0,0
"United Kingdom of Great Britain and Northern Ireland","2024-05-20",0,0,53,0,0,68,0,0
"United Kingdom of Great Britain and Northern Ireland","2024-05-21",0,0,53,0,1,69,0,0
"United Kingdom of Great Britain and Northern Ireland","2024-05-22",0,0,53,0,1,70,0,0
"United Kingdom of Great Britain and Northern Ireland","2024-05-23",0,0,53,0,1,71,0,0
"United Kingdom of Great Britain and Northern Ireland","2024-05-24",0,0,53,0,1,72,0,0
"United Kingdom of Great Britain and Northern Ireland","2024-05-25",0,0,53,0,0,72,0,0
"United Kingdom of Great Britain and Northern Ireland","2024-05-26",0,0,53,0,1,73,0,0
"United Kingdom of Great Britain and Northern Ireland","2024-05-27",0,0,53,0,1,74,0,0
"United Kingdom of Great Britain and Northern Ireland","2024-05-28",0,0,53,0,1,75,0,0
"United Kingdom of Great Britain and Northern Ireland","2024-05-29",0,0,53,0,0,75,0,0
"United Kingdom of Great Britain and Northern Ireland","2024-05-30",0,0,53,0,1,76,0,0
"United Kingdom of Great Britain and Northern Ireland","2024-05-31",0,24,77,0,1,77,0,0
"United Kingdom of Great Britain and Northern Ireland","2024-06-01",0,0,77,0,1,78,0,0
"United Kingdom of Great Britain and Northern Ireland","2024-06-02",0,0,77,0,1,79,0,0
"United Kingdom of Great Britain and Northern Ireland","2024-06-03",0,0,77,0,1,80,0,0
"United Kingdom of Great Britain and Northern Ireland","2024-06-04",0,0,77,0,1,81,0,0
"United Kingdom of Great Britain and Northern Ireland","2024-06-05",0,0,77,0,1,82,0,0
"United Kingdom of Great Britain and Northern Ireland","2024-06-06",0,0,77,0,1,83,0,0
"United Kingdom of Great Britain and Northern Ireland","2024-06-07",0,0,77,0,2,85,0,0
"United Kingdom of Great Britain and Northern Ireland","2024-06-08",0,0,77,0,1,86,0,0
"United Kingdom of Great Britain and Northern Ireland","2024-06-09",0,0,77,0,1,87,0,0
"United Kingdom of Great Britain and Northern Ireland","2024-06-10",0,0,77,0,1,88,0,0
"United Kingdom of Great Britain and Northern Ireland","2024-06-11",0,0,77,0,1,89,0,0
"United Kingdom of Great Britain and Northern Ireland","2024-06-12",0,0,77,0,1,90,0,0
"United Kingdom of Great Britain and Northern Ireland","2024-06-13",0,0,77,0,1,91,0,0
"United Kingdom of Great Britain and Northern Ireland","2024-06-14",0,0,77,0,1,92,0,0
"United Kingdom of Great Britain and Northern Ireland","2024-06-15",0,0,77,0,1,93,0,0
"United Kingdom of Great Britain and Northern Ireland","2024-06-16",0,0,77,0,1,94,0,0
"United Kingdom of Great Britain and Northern Ireland","2024-06-17",0,0,77,0,1,95,0,0
"United Kingdom of Great Britain and Northern Ireland","2024-06-18",0,0,77,0,1,96,0,0
"United Kingdom of Great Britain and Northern Ireland","2024-06-19",0,0,77,0,2,98,0,0
"United Kingdom of Great Britain and Northern Ireland","2024-06-20",0,0,77,0,1,99,0,0
"United Kingdom of Great Britain and Northern Ireland","2024-06-21",0,0,77,0,1,100,0,0
"United Kingdom of Great Britain and Northern Ireland","2024-06-22",0,0,77,0,1,101,0,0
"United Kingdom of Great Britain and Northern Ireland","2024-06-23",0,0,77,0,1,102,0,0
"United Kingdom of Great Britain and Northern Ireland","2024-06-24",0,0,77,0,1,103,0,0
"United Kingdom of Great Britain and Northern Ireland","2024-06-25",0,0,77,0,1,104,0,0
"United Kingdom of Great Britain and Northern Ireland","2024-06-26",0,0,77,0,1,105,0,0
"United Kingdom of Great Britain and Northern Ireland","2024-06-27",0,0,77,0,1,106,0,0
"United Kingdom of Great Britain and Northern Ireland","2024-06-28",0,0,77,0,1,107,0,0
"United Kingdom of Great Britain and Northern Ireland","2024-06-29",0,0,77,0,1,108,0,0
"United Kingdom of Great Britain and Northern Ireland","2024-06-30",0,0,77,0,1,109,0,0
"United Kingdom of Great Britain and Northern Ireland","2024-07-01",0,0,77,0,2,111,0,0
"United Kingdom of Great Britain and Northern Ireland","2024-07-02",0,0,77,0,1,112,0,0
"United Kingdom of Great Britain and Northern Ireland","2024-07-03",0,0,77,0,1,113,0,0
"United Kingdom of Great Britain and Northern Ireland","2024-07-04",0,0,77,0,1,114,0,0
"United Kingdom of Great Britain and Northern Ireland","2024-07-05",0,0,77,0,1,115,0,0
"United Kingdom of Great Britain and Northern Ireland","2024-07-06",0,0,77,0,1,116,0,0
"United Kingdom of Great Britain and Northern Ireland","2024-07-07",0,0,77,0,1,117,0,0
"United Kingdom of Great Britain and Northern Ireland","2024-07-08",0,0,77,0,1,118,0,0
"United Kingdom of Great Britain and Northern Ireland","2024-07-09",0,0,77,0,1,119,0,0
"United Kingdom of Great Britain and Northern Ireland","2024-07-10",0,0,77,0,1,120,0,0
"United Kingdom of Great Britain and Northern Ireland","2024-07-11",0,0,77,0,1,121,0,0
"United Kingdom of Great Britain and Northern Ireland","2024-07-12",0,0,77,0,1,122,0,0
"United Kingdom of Great Britain and Northern Ireland","2024-07-13",0,0,77,0,2,124,0,0
"United Kingdom of Great Britain and Northern Ireland","2024-07-14",0,0,77,0,1,125,0,0
"United Kingdom of Great Britain and Northern Ireland","2024-07-15",0,0,77,0,1,126,0,0
"United Kingdom of Great Britain and Northern Ireland","2024-07-16",0,0,77,0,1,127,0,0
"United Kingdom of Great Britain and Northern Ireland","2024-07-17",0,0,77,0,1,128,0,0
"United Kingdom of Great Britain and Northern Ireland","2024-07-18",0,0,77,0,1,129,0,0
"United Kingdom of Great Britain and Northern Ireland","2024-07-19",0,0,77,0,1,130,0,0
"United Kingdom of Great Britain and Northern Ireland","2024-07-20",0,0,77,0,1,131,0,0
"United Kingdom of Great Britain and Northern Ireland","2024-07-21",0,0,77,0,1,132,0,0
"United Kingdom of Great Britain and Northern Ireland","2024-07-22",0,0,77,0,1,133,0,0
"United Kingdom of Great Britain and Northern Ireland","2024-07-23",0,0,77,0,1,134,0,0
"United Kingdom of Great Britain and Northern Ireland","2024-07-24",0,0,77,0,1,135,0,0
"United Kingdom of Great Britain and Northern Ireland","2024-07-25",0,0,77,0,2,137,0,0
"United Kingdom of Great Britain and Northern Ireland","2024-07-26",0,0,77,0,1,138,0,0
"United Kingdom of Great Britain and Northern Ireland","2024-07-27",0,0,77,0,1,139,0,0
"United Kingdom of Great Britain and Northern Ireland","2024-07-28",0,0,77,0,1,140,0,0
"United Kingdom of Great Britain and Northern Ireland","2024-07-29",0,0,77,0,1,141,0,0
"United Kingdom of Great Britain and Northern Ireland","2024-07-30",0,0,77,0,1,142,0,0
"United Kingdom of Great Britain and Northern Ireland","2024-07-31",0,66,143,0,1,143,0,0
"United Kingdom of Great Britain and Northern Ireland","2024-08-01",0,0,143,0,1,144,0,0
"United Kingdom of Great Britain and Northern Ireland","2024-08-02",0,0,143,0,2,146,0,0
"United Kingdom of Great Britain and Northern Ireland","2024-08-03",0,0,143,0,1,147,0,0
"United Kingdom of Great Britain and Northern Ireland","2024-08-04",0,0,143,0,1,148,0,0
"United Kingdom of Great Britain and Northern Ireland","2024-08-05",0,0,143,0,1,149,0,0
"United Kingdom of Great Britain and Northern Ireland","2024-08-06",0,0,143,0,2,151,0,0
"United Kingdom of Great Britain and Northern Ireland","2024-08-07",0,0,143,0,1,152,0,0
"United Kingdom of Great Britain and Northern Ireland","2024-08-08",0,0,143,0,1,153,0,0
"United Kingdom of Great Britain and Northern Ireland","2024-08-09",0,0,143,0,2,155,0,0
"United Kingdom of Great Britain and Northern Ireland","2024-08-10",0,0,143,0,1,156,0,0
"United Kingdom of Great Britain and Northern Ireland","2024-08-11",0,0,143,0,1,157,0,0
"United Kingdom of Great Britain and Northern Ireland","2024-08-12",0,0,143,0,1,158,0,0
"United Kingdom of Great Britain and Northern Ireland","2024-08-13",0,0,143,0,2,160,0,0
"United Kingdom of Great Britain and Northern Ireland","2024-08-14",0,0,143,0,1,161,0,0
"United Kingdom of Great Britain and Northern Ireland","2024-08-15",0,0,143,0,1,162,0,0
"United Kingdom of Great Britain and Northern Ireland","2024-08-16",0,0,143,0,2,164,0,0
"United Kingdom of Great Britain and Northern Ireland","2024-08-17",0,0,143,0,1,165,0,0
"United Kingdom of Great Britain and Northern Ireland","2024-08-18",0,0,143,0,1,166,0,0
"United Kingdom of Great Britain and Northern Ireland","2024-08-19",0,0,143,0,2,168,0,0
"United Kingdom of Great Britain and Northern Ireland","2024-08-20",0,0,143,0,1,169,0,0
"United Kingdom of Great Britain and Northern Ireland","2024-08-21",0,0,143,0,1,170,0,0
"United Kingdom of Great Britain and Northern Ireland","2024-08-22",0,0,143,0,1,171,0,0
"United Kingdom of Great Britain and Northern Ireland","2024-08-23",0,0,143,0,2,173,0,0
"United Kingdom of Great Britain and Northern Ireland","2024-08-24",0,0,143,0,1,174,0,0
"United Kingdom of Great Britain and Northern Ireland","2024-08-25",0,0,143,0,1,175,0,0
"United Kingdom of Great Britain and Northern Ireland","2024-08-26",0,0,143,0,2,177,0,0
"United Kingdom of Great Britain and Northern Ireland","2024-08-27",0,0,143,0,1,178,0,0
"United Kingdom of Great Britain and Northern Ireland","2024-08-28",0,0,143,0,1,179,0,0
"United Kingdom of Great Britain and Northern Ireland","2024-08-29",0,0,143,0,1,180,0,0
"United Kingdom of Great Britain and Northern Ireland","2024-08-30",0,0,143,0,2,182,0,0
"United Kingdom of Great Britain and Northern Ireland","2024-08-31",0,40,183,0,1,183,0,0
"United Kingdom of Great Britain and Northern Ireland","2024-09-01",0,0,183,0,1,184,0,0
"United Kingdom of Great Britain and Northern Ireland","2024-09-02",0,0,183,0,2,186,0,0
"United Kingdom of Great Britain and Northern Ireland","2024-09-03",0,0,183,0,1,187,0,0
"United Kingdom of Great Britain and Northern Ireland","2024-09-04",0,0,183,0,2,189,0,0
"United Kingdom of Great Britain and Northern Ireland","2024-09-05",0,0,183,0,1,190,0,0
"United Kingdom of Great Britain and Northern Ireland","2024-09-06",0,0,183,0,1,191,0,0
"United Kingdom of Great Britain and Northern Ireland","2024-09-07",0,0,183,0,2,193,0,0
"United Kingdom of Great Britain and Northern Ireland","2024-09-08",0,0,183,0,1,194,0,0
"United Kingdom of Great Britain and Northern Ireland","2024-09-09",0,0,183,0,2,196,0,0
"United Kingdom of Great Britain and Northern Ireland","2024-09-10",0,0,183,0,1,197,0,0
"United Kingdom of Great Britain and Northern Ireland","2024-09-11",0,0,183,0,1,198,0,0
"United Kingdom of Great Britain and Northern Ireland","2024-09-12",0,0,183,0,2,200,0,0
"United Kingdom of Great Britain and Northern Ireland","2024-09-13",0,0,183,0,1,201,0,0
"United Kingdom of Great Britain and Northern Ireland","2024-09-14",0,0,183,0,2,203,0,0
"United Kingdom of Great Britain and Northern Ireland","2024-09-15",0,0,183,0,1,204,0,0
"United Kingdom of Great Britain and Northern Ireland","2024-09-16",0,0,183,0,1,205,0,0
"United Kingdom of Great Britain and Northern Ireland","2024-09-17",0,0,183,0,2,207,0,0
"United Kingdom of Great Britain and Northern Ireland","2024-09-18",0,0,183,0,1,208,0,0
"United Kingdom of Great Britain and Northern Ireland","2024-09-19",0,0,183,0,2,210,0,0
"United Kingdom of Great Britain and Northern Ireland","2024-09-20",0,0,183,0,1,211,0,0
"United Kingdom of Great Britain and Northern Ireland","2024-09-21",0,0,183,0,1,212,0,0
"United Kingdom of Great Britain and Northern Ireland","2024-09-22",0,0,183,0,2,214,0,0
"United Kingdom of Great Britain and Northern Ireland","2024-09-23",0,0,183,0,1,215,0,0
"United Kingdom of Great Britain and Northern Ireland","2024-09-24",0,0,183,0,2,217,0,0
"United Kingdom of Great Britain and Northern Ireland","2024-09-25",0,0,183,0,1,218,0,0
"United Kingdom of Great Britain and Northern Ireland","2024-09-26",0,0,183,0,1,219,0,0
"United Kingdom of Great Britain and Northern Ireland","2024-09-27",0,0,183,0,2,221,0,0
"United Kingdom of Great Britain and Northern Ireland","2024-09-28",0,0,183,0,1,222,0,0
"United Kingdom of Great Britain and Northern Ireland","2024-09-29",0,0,183,0,2,224,0,0
"United Kingdom of Great Britain and Northern Ireland","2024-09-30",0,42,225,0,1,225,0,0
"United Kingdom of Great Britain and Northern Ireland","2024-10-01",0,0,225,0,0,225,0,0
"United Kingdom of Great Britain and Northern Ireland","2024-10-02",0,0,225,0,1,226,0,0
"United Kingdom of Great Britain and Northern Ireland","2024-10-03",0,0,225,0,0,226,0,0
"United Kingdom of Great Britain and Northern Ireland","2024-10-04",0,0,225,0,0,226,0,0
"United Kingdom of Great Britain and Northern Ireland","2024-10-05",0,0,225,0,1,227,0,0
"United Kingdom of Great Britain and Northern Ireland","2024-10-06",0,0,225,0,0,227,0,0
"United Kingdom of Great Britain and Northern Ireland","2024-10-07",0,0,225,0,0,227,0,0
"United Kingdom of Great Britain and Northern Ireland","2024-10-08",0,0,225,0,1,228,0,0
"United Kingdom of Great Britain and Northern Ireland","2024-10-09",0,0,225,0,0,228,0,0
"United Kingdom of Great Britain and Northern Ireland","2024-10-10",0,0,225,0,0,228,0,0
"United Kingdom of Great Britain and Northern Ireland","2024-10-11",0,0,225,0,1,229,0,0
"United Kingdom of Great Britain and Northern Ireland","2024-10-12",0,0,225,0,0,229,0,0
"United Kingdom of Great Britain and Northern Ireland","2024-10-13",0,0,225,0,0,229,0,0
"United Kingdom of Great Britain and Northern Ireland","2024-10-14",0,0,225,0,1,230,0,0
"United Kingdom of Great Britain and Northern Ireland","2024-10-15",0,0,225,0,0,230,0,0
"United Kingdom of Great Britain and Northern Ireland","2024-10-16",0,0,225,0,0,230,0,0
"United Kingdom of Great Britain and Northern Ireland","2024-10-17",0,0,225,0,0,230,0,0
"United Kingdom of Great Britain and Northern Ireland","2024-10-18",0,0,225,0,1,231,0,0
"United Kingdom of Great Britain and Northern Ireland","2024-10-19",0,0,225,0,0,231,0,0
"United Kingdom of Great Britain and Northern Ireland","2024-10-20",0,0,225,0,0,231,0,0
"United Kingdom of Great Britain and Northern Ireland","2024-10-21",0,0,225,0,1,232,0,0
"United Kingdom of Great Britain and Northern Ireland","2024-10-22",0,0,225,0,0,232,0,0
"United Kingdom of Great Britain and Northern Ireland","2024-10-23",0,0,225,0,0,232,0,0
"United Kingdom of Great Britain and Northern Ireland","2024-10-24",0,0,225,0,1,233,0,0
"United Kingdom of Great Britain and Northern Ireland","2024-10-25",0,0,225,0,0,233,0,0
"United Kingdom of Great Britain and Northern Ireland","2024-10-26",0,0,225,0,0,233,0,0
"United Kingdom of Great Britain and Northern Ireland","2024-10-27",0,0,225,0,1,234,0,0
"United Kingdom of Great Britain and Northern Ireland","2024-10-28",0,0,225,0,0,234,0,0
"United Kingdom of Great Britain and Northern Ireland","2024-10-29",0,0,225,0,0,234,0,0
"United Kingdom of Great Britain and Northern Ireland","2024-10-30",0,0,225,0,1,235,0,0
"United Kingdom of Great Britain and Northern Ireland","2024-10-31",0,10,235,0,0,235,0,0
"United Kingdom of Great Britain and Northern Ireland","2024-11-01",0,0,235,0,1,236,0,0
"United Kingdom of Great Britain and Northern Ireland","2024-11-02",0,0,235,0,1,237,0,0
"United Kingdom of Great Britain and Northern Ireland","2024-11-03",0,0,235,0,2,239,0,0
"United Kingdom of Great Britain and Northern Ireland","2024-11-04",0,0,235,0,1,240,0,0
"United Kingdom of Great Britain and Northern Ireland","2024-11-05",0,0,235,0,1,241,0,0
"United Kingdom of Great Britain and Northern Ireland","2024-11-06",0,0,235,0,1,242,0,0
"United Kingdom of Great Britain and Northern Ireland","2024-11-07",0,0,235,0,1,243,0,0
"United Kingdom of Great Britain and Northern Ireland","2024-11-08",0,0,235,0,2,245,0,0
"United Kingdom of Great Britain and Northern Ireland","2024-11-09",0,0,235,0,1,246,0,0
"United Kingdom of Great Britain and Northern Ireland","2024-11-10",0,0,235,0,1,247,0,0
"United Kingdom of Great Britain and Northern Ireland","2024-11-11",0,0,235,0,1,248,0,0
"United Kingdom of Great Britain and Northern Ireland","2024-11-12",0,0,235,0,1,249,0,0
"United Kingdom of Great Britain and Northern Ireland","2024-11-13",0,0,235,0,2,251,0,0
"United Kingdom of Great Britain and Northern Ireland","2024-11-14",0,0,235,0,1,252,0,0
"United Kingdom of Great Britain and Northern Ireland","2024-11-15",0,0,235,0,1,253,0,0
"United Kingdom of Great Britain and Northern Ireland","2024-11-16",0,0,235,0,1,254,0,0
"United Kingdom of Great Britain and Northern Ireland","2024-11-17",0,0,235,0,1,255,0,0
"United Kingdom of Great Britain and Northern Ireland","2024-11-18",0,0,235,0,2,257,0,0
"United Kingdom of Great Britain and Northern Ireland","2024-11-19",0,0,235,0,1,258,0,0
"United Kingdom of Great Britain and Northern Ireland","2024-11-20",0,0,235,0,1,259,0,0
"United Kingdom of Great Britain and Northern Ireland","2024-11-21",0,0,235,0,1,260,0,0
"United Kingdom of Great Britain and Northern Ireland","2024-11-22",0,0,235,0,1,261,0,0
"United Kingdom of Great Britain and Northern Ireland","2024-11-23",0,0,235,0,2,263,0,0
"United Kingdom of Great Britain and Northern Ireland","2024-11-24",0,0,235,0,1,264,0,0
"United Kingdom of Great Britain and Northern Ireland","2024-11-25",0,0,235,0,1,265,0,0
"United Kingdom of Great Britain and Northern Ireland","2024-11-26",0,0,235,0,1,266,0,0
"United Kingdom of Great Britain and Northern Ireland","2024-11-27",0,0,235,0,1,267,0,0
"United Kingdom of Great Britain and Northern Ireland","2024-11-28",0,0,235,0,2,269,0,0
"United Kingdom of Great Britain and Northern Ireland","2024-11-29",0,0,235,0,1,270,0,0
"United Kingdom of Great Britain and Northern Ireland","2024-11-30",0,36,271,0,1,271,0,0
"United Kingdom of Great Britain and Northern Ireland","2024-12-01",0,0,271,0,0,271,0,0
"United Kingdom of Great Britain and Northern Ireland","2024-12-02",0,0,271,0,0,271,0,0
"United Kingdom of Great Britain and Northern Ireland","2024-12-03",0,0,271,0,0,271,0,0
"United Kingdom of Great Britain and Northern Ireland","2024-12-04",0,0,271,0,0,271,0,0
"United Kingdom of Great Britain and Northern Ireland","2024-12-05",0,0,271,0,0,271,0,0
"United Kingdom of Great Britain and Northern Ireland","2024-12-06",0,0,271,0,0,271,0,0
"United Kingdom of Great Britain and Northern Ireland","2024-12-07",0,0,271,0,0,271,0,0
"United Kingdom of Great Britain and Northern Ireland","2024-12-08",0,0,271,0,0,271,0,0
"United Kingdom of Great Britain and Northern Ireland","2024-12-09",0,0,271,0,0,271,0,0
"United Kingdom of Great Britain and Northern Ireland","2024-12-10",0,0,271,0,0,271,0,0
"United Kingdom of Great Britain and Northern Ireland","2024-12-11",0,0,271,0,0,271,0,0
"United Kingdom of Great Britain and Northern Ireland","2024-12-12",0,0,271,0,0,271,0,0
"United Kingdom of Great Britain and Northern Ireland","2024-12-13",0,0,271,0,0,271,0,0
"United Kingdom of Great Britain and Northern Ireland","2024-12-14",0,0,271,0,0,271,0,0
"United Kingdom of Great Britain and Northern Ireland","2024-12-15",0,0,271,0,0,271,0,0
"United Kingdom of Great Britain and Northern Ireland","2024-12-16",0,0,271,0,0,271,0,0
"United Kingdom of Great Britain and Northern Ireland","2024-12-17",0,0,271,0,0,271,0,0
"United Kingdom of Great Britain and Northern Ireland","2024-12-18",0,0,271,0,0,271,0,0
"United Kingdom of Great Britain and Northern Ireland","2024-12-19",0,0,271,0,0,271,0,0
"United Kingdom of Great Britain and Northern Ireland","2024-12-20",0,0,271,0,0,271,0,0
"United Kingdom of Great Britain and Northern Ireland","2024-12-21",0,0,271,0,0,271,0,0
"United Kingdom of Great Britain and Northern Ireland","2024-12-22",0,0,271,0,0,271,0,0
"United Kingdom of Great Britain and Northern Ireland","2024-12-23",0,0,271,0,0,271,0,0
"United Kingdom of Great Britain and Northern Ireland","2024-12-24",0,0,271,0,0,271,0,0
"United Kingdom of Great Britain and Northern Ireland","2024-12-25",0,0,271,0,0,271,0,0
"United Kingdom of Great Britain and Northern Ireland","2024-12-26",0,0,271,0,0,271,0,0
"United Kingdom of Great Britain and Northern Ireland","2024-12-27",0,0,271,0,0,271,0,0
"United Kingdom of Great Britain and Northern Ireland","2024-12-28",0,0,271,0,0,271,0,0
"United Kingdom of Great Britain and Northern Ireland","2024-12-29",0,0,271,0,0,271,0,0
"United Kingdom of Great Britain and Northern Ireland","2024-12-30",0,0,271,0,0,271,0,0
"United Kingdom of Great Britain and Northern Ireland","2024-12-31",0,0,271,0,0,271,0,0
"United Kingdom of Great Britain and Northern Ireland","2025-01-01",0,0,271,0,0,271,0,0
"United Kingdom of Great Britain and Northern Ireland","2025-01-02",0,0,271,0,0,271,0,0
"United Kingdom of Great Britain and Northern Ireland","2025-01-03",0,0,271,0,0,271,0,0
"United Kingdom of Great Britain and Northern Ireland","2025-01-04",0,0,271,0,0,271,0,0
"United Kingdom of Great Britain and Northern Ireland","2025-01-05",0,0,271,0,0,271,0,0
"United Kingdom of Great Britain and Northern Ireland","2025-01-06",0,0,271,0,0,271,0,0
"United Kingdom of Great Britain and Northern Ireland","2025-01-07",0,0,271,0,0,271,0,0
"United Kingdom of Great Britain and Northern Ireland","2025-01-08",0,0,271,0,0,271,0,0
"United Kingdom of Great Britain and Northern Ireland","2025-01-09",0,0,271,0,0,271,0,0
"United Kingdom of Great Britain and Northern Ireland","2025-01-10",0,0,271,0,0,271,0,0
"United Kingdom of Great Britain and Northern Ireland","2025-01-11",0,0,271,0,0,271,0,0
"United Kingdom of Great Britain and Northern Ireland","2025-01-12",0,0,271,0,0,271,0,0
"United Kingdom of Great Britain and Northern Ireland","2025-01-13",0,0,271,0,0,271,0,0
"United States of America","2024-01-01",0,0,0,0,0,0,0,0
"United States of America","2024-01-02",0,50,50,0,50,50,0,0
"United States of America","2024-01-03",0,0,50,0,8,58,0,0
"United States of America","2024-01-04",0,0,50,0,8,66,0,0
"United States of America","2024-01-05",0,0,50,0,8,74,0,0
"United States of America","2024-01-06",0,0,50,0,8,82,0,0
"United States of America","2024-01-07",0,0,50,0,8,90,0,0
"United States of America","2024-01-08",0,0,50,0,8,98,0,0
"United States of America","2024-01-09",0,56,106,0,8,106,0,0
"United States of America","2024-01-10",0,0,106,0,10,116,0,0
"United States of America","2024-01-11",0,0,106,0,10,126,0,0
"United States of America","2024-01-12",0,0,106,0,10,136,0,0
"United States of America","2024-01-13",0,0,106,0,11,147,0,0
"United States of America","2024-01-14",0,0,106,0,10,157,0,0
"United States of America","2024-01-15",0,0,106,0,10,167,0,0
"United States of America","2024-01-16",0,71,177,0,10,177,0,0
"United States of America","2024-01-17",0,0,177,0,7,184,0,0
"United States of America","2024-01-18",0,0,177,0,7,191,0,0
"United States of America","2024-01-19",0,0,177,0,7,198,0,0
"United States of America","2024-01-20",0,0,177,0,7,205,0,0
"United States of America","2024-01-21",0,0,177,0,7,212,0,0
"United States of America","2024-01-22",0,0,177,0,7,219,0,0
"United States of America","2024-01-23",0,49,226,0,7,226,0,0
"United States of America","2024-01-24",0,0,226,0,12,238,0,0
"United States of America","2024-01-25",0,0,226,0,12,250,0,0
"United States of America","2024-01-26",0,0,226,0,12,262,0,0
"United States of America","2024-01-27",0,0,226,0,11,273,0,0
"United States of America","2024-01-28",0,0,226,0,12,285,0,0
"United States of America","2024-01-29",0,0,226,0,12,297,0,0
"United States of America","2024-01-30",0,83,309,0,12,309,0,0
"United States of America","2024-01-31",0,0,309,0,8,317,0,0
"United States of America","2024-02-01",0,0,309,0,9,326,0,0
"United States of America","2024-02-02",0,0,309,0,8,334,0,0
"United States of America","2024-02-03",0,0,309,0,9,343,0,0
"United States of America","2024-02-04",0,0,309,0,8,351,0,0
"United States of America","2024-02-05",0,0,309,0,9,360,0,0
"United States of America","2024-02-06",0,59,368,0,8,368,0,0
"United States of America","2024-02-07",0,0,368,0,8,376,0,0
"United States of America","2024-02-08",0,0,368,0,9,385,0,0
"United States of America","2024-02-09",0,0,368,0,8,393,0,0
"United States of America","2024-02-10",0,0,368,0,8,401,0,0
"United States of America","2024-02-11",0,0,368,0,8,409,0,0
"United States of America","2024-02-12",0,0,368,0,9,418,0,0
"United States of America","2024-02-13",0,58,426,0,8,426,0,0
"United States of America","2024-02-14",0,0,426,0,8,434,0,0
"United States of America","2024-02-15",0,0,426,0,9,443,0,0
"United States of America","2024-02-16",0,0,426,0,8,451,0,0
"United States of America","2024-02-17",0,0,426,0,8,459,0,0
"United States of America","2024-02-18",0,0,426,0,8,467,0,0
"United States of America","2024-02-19",0,0,426,0,9,476,0,0
"United States of America","2024-02-20",0,58,484,0,8,484,0,0
"United States of America","2024-02-21",0,0,484,0,11,495,0,0
"United States of America","2024-02-22",0,0,484,0,10,505,0,0
"United States of America","2024-02-23",0,0,484,0,11,516,0,0
"United States of America","2024-02-24",0,0,484,0,10,526,0,0
"United States of America","2024-02-25",0,0,484,0,11,537,0,0
"United States of America","2024-02-26",0,0,484,0,10,547,0,0
"United States of America","2024-02-27",0,74,558,0,11,558,0,0
"United States of America","2024-02-28",0,0,558,0,10,568,0,0
"United States of America","2024-02-29",0,0,558,0,10,578,0,0
"United States of America","2024-03-01",0,0,558,0,10,588,0,0
"United States of America","2024-03-02",0,0,558,0,9,597,0,0
"United States of America","2024-03-03",0,0,558,0,10,607,0,0
"United States of America","2024-03-04",0,0,558,0,10,617,0,0
"United States of America","2024-03-05",0,69,627,0,10,627,0,0
"United States of America","2024-03-06",0,0,627,0,11,638,0,0
"United States of America","2024-03-07",0,0,627,0,12,650,0,0
"United States of America","2024-03-08",0,0,627,0,11,661,0,0
"United States of America","2024-03-09",0,0,627,0,11,672,0,0
"United States of America","2024-03-10",0,0,627,0,11,683,0,0
"United States of America","2024-03-11",0,0,627,0,12,695,0,0
"United States of America","2024-03-12",0,79,706,0,11,706,0,0
"United States of America","2024-03-13",0,0,706,0,8,714,0,0
"United States of America","2024-03-14",0,0,706,0,8,722,0,0
"United States of America","2024-03-15",0,0,706,0,8,730,0,0
"United States of America","2024-03-16",0,0,706,0,7,737,0,0
"United States of America","2024-03-17",0,0,706,0,8,745,0,0
"United States of America","2024-03-18",0,0,706,0,8,753,0,0
"United States of America","2024-03-19",0,55,761,0,8,761,0,0
"United States of America","2024-03-20",0,0,761,0,9,770,0,0
"United States of America","2024-03-21",0,0,761,0,9,779,0,0
"United States of America","2024-03-22",0,0,761,0,9,788,0,0
"United States of America","2024-03-23",0,0,761,0,9,797,0,0
"United States of America","2024-03-24",0,0,761,0,9,806,0,0
"United States of America","2024-03-25",0,0,761,0,9,815,0,0
"United States of America","2024-03-26",0,63,824,0,9,824,0,0
"United States of America","2024-03-27",0,0,824,0,7,831,0,0
"United States of America","2024-03-28",0,0,824,0,6,837,0,0
"United States of America","2024-03-29",0,0,824,0,7,844,0,0
"United States of America","2024-03-30",0,0,824,0,7,851,0,0
"United States of America","2024-03-31",0,0,824,0,7,858,0,0
"United States of America","2024-04-01",0,0,824,0,6,864,0,0
"United States of America","2024-04-02",0,47,871,0,7,871,0,0
"United States of America","2024-04-03",0,0,871,0,10,881,0,0
"United States of America","2024-04-04",0,0,871,0,9,890,0,0
"United States of America","2024-04-05",0,0,871,0,10,900,0,0
"United States of America","2024-04-06",0,0,871,0,10,910,0,0
"United States of America","2024-04-07",0,0,871,0,10,920,0,0
"United States of America","2024-04-08",0,0,871,0,9,929,0,0
"United States of America","2024-04-09",0,68,939,0,10,939,0,0
"United States of America","2024-04-10",0,0,939,0,11,950,0,0
"United States of America","2024-04-11",0,0,939,0,11,961,0,0
"United States of America","2024-04-12",0,0,939,0,11,972,0,0
"United States of America","2024-04-13",0,0,939,0,11,983,0,0
"United States of America","2024-04-14",0,0,939,0,11,994,0,0
"United States of America","2024-04-15",0,0,939,0,11,1005,0,0
"United States of America","2024-04-16",0,77,1016,0,11,1016,0,0
"United States of America","2024-04-17",0,0,1016,0,11,1027,0,0
"United States of America","2024-04-18",0,0,1016,0,12,1039,0,0
"United States of America","2024-04-19",0,0,1016,0,11,1050,0,0
"United States of America","2024-04-20",0,0,1016,0,11,1061,0,0
"United States of America","2024-04-21",0,0,1016,0,11,1072,0,0
"United States of America","2024-04-22",0,0,1016,0,12,1084,0,0
"United States of America","2024-04-23",0,79,1095,0,11,1095,0,0
"United States of America","2024-04-24",0,0,1095,0,7,1102,0,0
"United States of America","2024-04-25",0,0,1095,0,8,1110,0,0
"United States of America","2024-04-26",0,0,1095,0,7,1117,0,0
"United States of America","2024-04-27",0,0,1095,0,8,1125,0,0
"United States of America","2024-04-28",0,0,1095,0,7,1132,0,0
"United States of America","2024-04-29",0,0,1095,0,8,1140,0,0
"United States of America","2024-04-30",0,52,1147,0,7,1147,0,0
"United States of America","2024-05-01",0,0,1147,0,8,1155,0,0
"United States of America","2024-05-02",0,0,1147,0,7,1162,0,0
"United States of America","2024-05-03",0,0,1147,0,8,1170,0,0
"United States of America","2024-05-04",0,0,1147,0,8,1178,0,0
"United States of America","2024-05-05",0,0,1147,0,8,1186,0,0
"United States of America","2024-05-06",0,0,1147,0,7,1193,0,0
"United States of America","2024-05-07",0,54,1201,0,8,1201,0,0
"United States of America","2024-05-08",0,0,1201,0,7,1208,0,0
"United States of America","2024-05-09",0,0,1201,0,7,1215,0,0
"United States of America","2024-05-10",0,0,1201,0,7,1222,0,0
"United States of America","2024-05-11",0,0,1201,0,7,1229,0,0
"United States of America","2024-05-12",0,0,1201,0,7,1236,0,0
"United States of America","2024-05-13",0,0,1201,0,7,1243,0,0
"United States of America","2024-05-14",0,49,1250,0,7,1250,0,0
"United States of America","2024-05-15",0,0,1250,0,8,1258,0,0
"United States of America","2024-05-16",0,0,1250,0,9,1267,0,0
"United States of America","2024-05-17",0,0,1250,0,8,1275,0,0
"United States of America","2024-05-18",0,0,1250,0,8,1283,0,0
"United States of America","2024-05-19",0,0,1250,0,8,1291,0,0
"United States of America","2024-05-20",0,0,1250,0,9,1300,0,0
"United States of America","2024-05-21",0,58,1308,0,8,1308,0,0
"United States of America","2024-05-22",0,0,1308,0,8,1316,0,0
"United States of America","2024-05-23",0,0,1308,0,9,1325,0,0
"United States of America","2024-05-24",0,0,1308,0,8,1333,0,0
"United States of America","2024-05-25",0,0,1308,0,8,1341,0,0
"United States of America","2024-05-26",0,0,1308,0,8,1349,0,0
"United States of America","2024-05-27",0,0,1308,0,9,1358,0,0
"United States of America","2024-05-28",0,58,1366,0,8,1366,0,0
"United States of America","2024-05-29",0,0,1366,0,8,1374,0,0
"United States of America","2024-05-30",0,0,1366,0,8,1382,0,0
"United States of America","2024-05-31",0,0,1366,0,8,1390,0,0
"United States of America","2024-06-01",0,0,1366,0,9,1399,0,0
"United States of America","2024-06-02",0,0,1366,0,8,1407,0,0
"United States of America","2024-06-03",0,0,1366,0,8,1415,0,0
"United States of America","2024-06-04",0,57,1423,0,8,1423,0,0
"United States of America","2024-06-05",0,0,1423,0,10,1433,0,0
"United States of America","2024-06-06",0,0,1423,0,10,1443,0,0
"United States of America","2024-06-07",0,0,1423,0,10,1453,0,0
"United States of America","2024-06-08",0,0,1423,0,11,1464,0,0
"United States of America","2024-06-09",0,0,1423,0,10,1474,0,0
"United States of America","2024-06-10",0,0,1423,0,10,1484,0,0
"United States of America","2024-06-11",0,71,1494,0,10,1494,0,0
"United States of America","2024-06-12",0,0,1494,0,7,1501,0,0
"United States of America","2024-06-13",0,0,1494,0,7,1508,0,0
"United States of America","2024-06-14",0,0,1494,0,7,1515,0,0
"United States of America","2024-06-15",0,0,1494,0,7,1522,0,0
"United States of America","2024-06-16",0,0,1494,0,7,1529,0,0
"United States of America","2024-06-17",0,0,1494,0,7,1536,0,0
"United States of America","2024-06-18",0,49,1543,0,7,1543,0,0
"United States of America","2024-06-19",0,0,1543,0,6,1549,0,0
"United States of America","2024-06-20",0,0,1543,0,7,1556,0,0
"United States of America","2024-06-21",0,0,1543,0,6,1562,0,0
"United States of America","2024-06-22",0,0,1543,0,6,1568,0,0
"United States of America","2024-06-23",0,0,1543,0,6,1574,0,0
"United States of America","2024-06-24",0,0,1543,0,7,1581,0,0
"United States of America","2024-06-25",0,44,1587,0,6,1587,0,0
"United States of America","2024-06-26",0,0,1587,0,7,1594,0,0
"United States of America","2024-06-27",0,0,1587,0,8,1602,0,0
"United States of America","2024-06-28",0,0,1587,0,7,1609,0,0
"United States of America","2024-06-29",0,0,1587,0,7,1616,0,0
"United States of America","2024-06-30",0,0,1587,0,7,1623,0,0
"United States of America","2024-07-01",0,0,1587,0,8,1631,0,0
"United States of America","2024-07-02",0,51,1638,0,7,1638,0,0
"United States of America","2024-07-03",0,0,1638,0,7,1645,0,0
"United States of America","2024-07-04",0,0,1638,0,8,1653,0,0
"United States of America","2024-07-05",0,0,1638,0,7,1660,0,0
"United States of America","2024-07-06",0,0,1638,0,8,1668,0,0
"United States of America","2024-07-07",0,0,1638,0,7,1675,0,0
"United States of America","2024-07-08",0,0,1638,0,8,1683,0,0
"United States of America","2024-07-09",0,52,1690,0,7,1690,0,0
"United States of America","2024-07-10",0,0,1690,0,9,1699,0,0
"United States of America","2024-07-11",0,0,1690,0,9,1708,0,0
"United States of America","2024-07-12",0,0,1690,0,9,1717,0,0
"United States of America","2024-07-13",0,0,1690,0,10,1727,0,0
"United States of America","2024-07-14",0,0,1690,0,9,1736,0,0
"United States of America","2024-07-15",0,0,1690,0,9,1745,0,0
"United States of America","2024-07-16",0,64,1754,0,9,1754,0,0
"United States of America","2024-07-17",0,0,1754,0,6,1760,0,0
"United States of America","2024-07-18",0,0,1754,0,6,1766,0,0
"United States of America","2024-07-19",0,0,1754,0,6,1772,0,0
"United States of America","2024-07-20",0,0,1754,0,5,1777,0,0
"United States of America","2024-07-21",0,0,1754,0,6,1783,0,0
"United States of America","2024-07-22",0,0,1754,0,6,1789,0,0
"United States of America","2024-07-23",0,41,1795,0,6,1795,0,0
"United States of America","2024-07-24",0,0,1795,0,7,1802,0,0
"United States of America","2024-07-25",0,0,1795,0,8,1810,0,0
"United States of America","2024-07-26",0,0,1795,0,7,1817,0,0
"United States of America","2024-07-27",0,0,1795,0,7,1824,0,0
"United States of America","2024-07-28",0,0,1795,0,7,1831,0,0
"United States of America","2024-07-29",0,0,1795,0,8,1839,0,0
"United States of America","2024-07-30",0,51,1846,0,7,1846,0,0
"United States of America","2024-07-31",0,0,1846,0,8,1854,0,0
"United States of America","2024-08-01",0,0,1846,0,7,1861,0,0
"United States of America","2024-08-02",0,0,1846,0,8,1869,0,0
"United States of America","2024-08-03",0,0,1846,0,7,1876,0,0
"United States of America","2024-08-04",0,0,1846,0,8,1884,0,0
"United States of America","2024-08-05",0,0,1846,0,7,1891,0,0
"United States of America","2024-08-06",0,53,1899,0,8,1899,0,0
"United States of America","2024-08-07",0,0,1899,0,9,1908,0,0
"United States of America","2024-08-08",0,0,1899,0,9,1917,0,0
"United States of America","2024-08-09",0,0,1899,0,9,1926,0,0
"United States of America","2024-08-10",0,0,1899,0,8,1934,0,0
"United States of America","2024-08-11",0,0,1899,0,9,1943,0,0
"United States of America","2024-08-12",0,0,1899,0,9,1952,0,0
"United States of America","2024-08-13",0,62,1961,0,9,1961,0,0
"United States of America","2024-08-14",0,0,1961,0,9,1970,0,0
"United States of America","2024-08-15",0,0,1961,0,9,1979,0,0
"United States of America","2024-08-16",0,0,1961,0,9,1988,0,0
"United States of America","2024-08-17",0,0,1961,0,8,1996,0,0
"United States of America","2024-08-18",0,0,1961,0,9,2005,0,0
"United States of America","2024-08-19",0,0,1961,0,9,2014,0,0
"United States of America","2024-08-20",0,62,2023,0,9,2023,0,0
"United States of America","2024-08-21",0,0,2023,0,8,2031,0,0
"United States of America","2024-08-22",0,0,2023,0,8,2039,0,0
"United States of America","2024-08-23",0,0,2023,0,8,2047,0,0
"United States of America","2024-08-24",0,0,2023,0,9,2056,0,0
"United States of America","2024-08-25",0,0,2023,0,8,2064,0,0
"United States of America","2024-08-26",0,0,2023,0,8,2072,0,0
"United States of America","2024-08-27",0,57,2080,0,8,2080,0,0
"United States of America","2024-08-28",0,0,2080,0,9,2089,0,0
"United States of America","2024-08-29",0,0,2080,0,10,2099,0,0
"United States of America","2024-08-30",0,0,2080,0,9,2108,0,0
"United States of America","2024-08-31",0,0,2080,0,10,2118,0,0
"United States of America","2024-09-01",0,0,2080,0,9,2127,0,0
"United States of America","2024-09-02",0,0,2080,0,10,2137,0,0
"United States of America","2024-09-03",0,66,2146,0,9,2146,0,0
"United States of America","2024-09-04",0,0,2146,0,10,2156,0,0
"United States of America","2024-09-05",0,0,2146,0,9,2165,0,0
"United States of America","2024-09-06",0,0,2146,0,10,2175,0,0
"United States of America","2024-09-07",0,0,2146,0,9,2184,0,0
"United States of America","2024-09-08",0,0,2146,0,10,2194,0,0
"United States of America","2024-09-09",0,0,2146,0,9,2203,0,0
"United States of America","2024-09-10",0,67,2213,0,10,2213,0,0
"United States of America","2024-09-11",0,0,2213,0,6,2219,0,0
"United States of America","2024-09-12",0,0,2213,0,7,2226,0,0
"United States of America","2024-09-13",0,0,2213,0,6,2232,0,0
"United States of America","2024-09-14",0,0,2213,0,6,2238,0,0
"United States of America","2024-09-15",0,0,2213,0,6,2244,0,0
"United States of America","2024-09-16",0,0,2213,0,7,2251,0,0
"United States of America","2024-09-17",0,44,2257,0,6,2257,0,0
"United States of America","2024-09-18",0,0,2257,0,8,2265,0,0
"United States of America","2024-09-19",0,0,2257,0,8,2273,0,0
"United States of America","2024-09-20",0,0,2257,0,8,2281,0,0
"United States of America","2024-09-21",0,0,2257,0,9,2290,0,0
"United States of America","2024-09-22",0,0,2257,0,8,2298,0,0
"United States of America","2024-09-23",0,0,2257,0,8,2306,0,0
"United States of America","2024-09-24",0,57,2314,0,8,2314,0,0
"United States of America","2024-09-25",0,0,2314,0,6,2320,0,0
"United States of America","2024-09-26",0,0,2314,0,6,2326,0,0
"United States of America","2024-09-27",0,0,2314,0,6,2332,0,0
"United States of America","2024-09-28",0,0,2314,0,7,2339,0,0
"United States of America","2024-09-29",0,0,2314,0,6,2345,0,0
"United States of America","2024-09-30",0,0,2314,0,6,2351,0,0
"United States of America","2024-10-01",0,43,2357,0,6,2357,0,0
"United States of America","2024-10-02",0,0,2357,0,5,2362,0,0
"United States of America","2024-10-03",0,0,2357,0,6,2368,0,0
"United States of America","2024-10-04",0,0,2357,0,5,2373,0,0
"United States of America","2024-10-05",0,0,2357,0,5,2378,0,0
"United States of America","2024-10-06",0,0,2357,0,5,2383,0,0
"United States of America","2024-10-07",0,0,2357,0,6,2389,0,0
"United States of America","2024-10-08",0,37,2394,0,5,2394,0,0
"United States of America","2024-10-09",0,0,2394,0,3,2397,0,0
"United States of America","2024-10-10",0,0,2394,0,3,2400,0,0
"United States of America","2024-10-11",0,0,2394,0,3,2403,0,0
"United States of America","2024-10-12",0,0,2394,0,3,2406,0,0
"United States of America","2024-10-13",0,0,2394,0,3,2409,0,0
"United States of America","2024-10-14",0,0,2394,0,3,2412,0,0
"United States of America","2024-10-15",0,21,2415,0,3,2415,0,0
"United States of America","2024-10-16",0,0,2415,0,5,2420,0,0
"United States of America","2024-10-17",0,0,2415,0,5,2425,0,0
"United States of America","2024-10-18",0,0,2415,0,5,2430,0,0
"United States of America","2024-10-19",0,0,2415,0,4,2434,0,0
"United States of America","2024-10-20",0,0,2415,0,5,2439,0,0
"United States of America","2024-10-21",0,0,2415,0,5,2444,0,0
"United States of America","2024-10-22",0,34,2449,0,5,2449,0,0
"United States of America","2024-10-23",0,0,2449,0,3,2452,0,0
"United States of America","2024-10-24",0,0,2449,0,3,2455,0,0
"United States of America","2024-10-25",0,0,2449,0,3,2458,0,0
"United States of America","2024-10-26",0,0,2449,0,4,2462,0,0
"United States of America","2024-10-27",0,0,2449,0,3,2465,0,0
"United States of America","2024-10-28",0,0,2449,0,3,2468,0,0
"United States of America","2024-10-29",0,22,2471,0,3,2471,0,0
"United States of America","2024-10-30",0,0,2471,0,3,2474,0,0
"United States of America","2024-10-31",0,0,2471,0,4,2478,0,0
"United States of America","2024-11-01",0,0,2471,0,3,2481,0,0
"United States of America","2024-11-02",0,0,2471,0,3,2484,0,0
"United States of America","2024-11-03",0,0,2471,0,3,2487,0,0
"United States of America","2024-11-04",0,0,2471,0,4,2491,0,0
"United States of America","2024-11-05",0,23,2494,0,3,2494,0,0
"United States of America","2024-11-06",0,0,2494,0,3,2497,0,0
"United States of America","2024-11-07",0,0,2494,0,2,2499,0,0
"United States of America","2024-11-08",0,0,2494,0,3,2502,0,0
"United States of America","2024-11-09",0,0,2494,0,2,2504,0,0
"United States of America","2024-11-10",0,0,2494,0,3,2507,0,0
"United States of America","2024-11-11",0,0,2494,0,2,2509,0,0
"United States of America","2024-11-12",0,18,2512,0,3,2512,0,0
"United States of America","2024-11-13",0,0,2512,0,2,2514,0,0
"United States of America","2024-11-14",0,0,2512,0,2,2516,0,0
"United States of America","2024-11-15",0,0,2512,0,2,2518,0,0
"United States of America","2024-11-16",0,0,2512,0,2,2520,0,0
"United States of America","2024-11-17",0,0,2512,0,2,2522,0,0
"United States of America","2024-11-18",0,0,2512,0,2,2524,0,0
"United States of America","2024-11-19",0,14,2526,0,2,2526,0,0
"United States of America","2024-11-20",0,0,2526,0,1,2527,0,0
"United States of America","2024-11-21",0,0,2526,0,1,2528,0,0
"United States of America","2024-11-22",0,0,2526,0,1,2529,0,0
"United States of America","2024-11-23",0,0,2526,0,0,2529,0,0
"United States of America","2024-11-24",0,0,2526,0,1,2530,0,0
"United States of America","2024-11-25",0,0,2526,0,1,2531,0,0
"United States of America","2024-11-26",0,6,2532,0,1,2532,0,0
"United States of America","2024-11-27",0,0,2532,0,0,2532,0,0
"United States of America","2024-11-28",0,0,2532,0,0,2532,0,0
"United States of America","2024-11-29",0,0,2532,0,0,2532,0,0
"United States of America","2024-11-30",0,0,2532,0,0,2532,0,0
"United States of America","2024-12-01",0,0,2532,0,0,2532,0,0
"United States of America","2024-12-02",0,0,2532,0,0,2532,0,0
"United States of America","2024-12-03",0,0,2532,0,0,2532,0,0
"United States of America","2024-12-04",0,0,2532,0,0,2532,0,0
"United States of America","2024-12-05",0,0,2532,0,0,2532,0,0
"United States of America","2024-12-06",0,0,2532,0,0,2532,0,0
"United States of America","2024-12-07",0,0,2532,0,0,2532,0,0
"United States of America","2024-12-08",0,0,2532,0,0,2532,0,0
"United States of America","2024-12-09",0,0,2532,0,0,2532,0,0
"United States of America","2024-12-10",0,0,2532,0,0,2532,0,0
"United States of America","2024-12-11",0,0,2532,0,0,2532,0,0
"United States of America","2024-12-12",0,0,2532,0,0,2532,0,0
"United States of America","2024-12-13",0,0,2532,0,0,2532,0,0
"United States of America","2024-12-14",0,0,2532,0,0,2532,0,0
"United States of America","2024-12-15",0,0,2532,0,0,2532,0,0
"United States of America","2024-12-16",0,0,2532,0,0,2532,0,0
"United States of America","2024-12-17",0,0,2532,0,0,2532,0,0
"United States of America","2024-12-18",0,0,2532,0,0,2532,0,0
"United States of America","2024-12-19",0,0,2532,0,0,2532,0,0
"United States of America","2024-12-20",0,0,2532,0,0,2532,0,0
"United States of America","2024-12-21",0,0,2532,0,0,2532,0,0
"United States of America","2024-12-22",0,0,2532,0,0,2532,0,0
"United States of America","2024-12-23",0,0,2532,0,0,2532,0,0
"United States of America","2024-12-24",0,0,2532,0,0,2532,0,0
"United States of America","2024-12-25",0,0,2532,0,0,2532,0,0
"United States of America","2024-12-26",0,0,2532,0,0,2532,0,0
"United States of America","2024-12-27",0,0,2532,0,0,2532,0,0
"United States of America","2024-12-28",0,0,2532,0,0,2532,0,0
"United States of America","2024-12-29",0,0,2532,0,0,2532,0,0
"United States of America","2024-12-30",0,0,2532,0,0,2532,0,0
"United States of America","2024-12-31",0,0,2532,0,0,2532,0,0
"United States of America","2025-01-01",0,0,2532,0,0,2532,0,0
"United States of America","2025-01-02",0,0,2532,0,0,2532,0,0
"United States of America","2025-01-03",0,0,2532,0,0,2532,0,0
"United States of America","2025-01-04",0,0,2532,0,0,2532,0,0
"United States of America","2025-01-05",0,0,2532,0,0,2532,0,0
"United States of America","2025-01-06",0,0,2532,0,0,2532,0,0
"United States of America","2025-01-07",0,0,2532,0,0,2532,0,0
"United States of America","2025-01-08",0,0,2532,0,0,2532,0,0
"United States of America","2025-01-09",0,0,2532,0,0,2532,0,0
"United States of America","2025-01-10",0,0,2532,0,0,2532,0,0
"United States of America","2025-01-11",0,0,2532,0,0,2532,0,0
"United States of America","2025-01-12",0,0,2532,0,0,2532,0,0
"United States of America","2025-01-13",0,0,2532,0,0,2532,0,0
"Uruguay","2024-01-01",0,0,0,0,0,0,0,0
"Uruguay","2024-01-02",0,0,0,0,0,0,0,0
"Uruguay","2024-01-03",0,0,0,0,0,0,0,0
"Uruguay","2024-01-04",0,0,0,0,0,0,0,0
"Uruguay","2024-01-05",0,0,0,0,0,0,0,0
"Uruguay","2024-01-06",0,0,0,0,0,0,0,0
"Uruguay","2024-01-07",0,0,0,0,0,0,0,0
"Uruguay","2024-01-08",0,0,0,0,0,0,0,0
"Uruguay","2024-01-09",0,0,0,0,0,0,0,0
"Uruguay","2024-01-10",0,0,0,0,0,0,0,0
"Uruguay","2024-01-11",0,0,0,0,0,0,0,0
"Uruguay","2024-01-12",0,0,0,0,0,0,0,0
"Uruguay","2024-01-13",0,0,0,0,0,0,0,0
"Uruguay","2024-01-14",0,0,0,0,0,0,0,0
"Uruguay","2024-01-15",0,0,0,0,0,0,0,0
"Uruguay","2024-01-16",0,0,0,0,0,0,0,0
"Uruguay","2024-01-17",0,0,0,0,0,0,0,0
"Uruguay","2024-01-18",0,0,0,0,0,0,0,0
"Uruguay","2024-01-19",0,0,0,0,0,0,0,0
"Uruguay","2024-01-20",0,0,0,0,0,0,0,0
"Uruguay","2024-01-21",0,0,0,0,0,0,0,0
"Uruguay","2024-01-22",0,0,0,0,0,0,0,0
"Uruguay","2024-01-23",0,0,0,0,0,0,0,0
"Uruguay","2024-01-24",0,0,0,0,0,0,0,0
"Uruguay","2024-01-25",0,0,0,0,0,0,0,0
"Uruguay","2024-01-26",0,0,0,0,0,0,0,0
"Uruguay","2024-01-27",0,0,0,0,0,0,0,0
"Uruguay","2024-01-28",0,0,0,0,0,0,0,0
"Uruguay","2024-01-29",0,0,0,0,0,0,0,0
"Uruguay","2024-01-30",0,0,0,0,0,0,0,0
"Uruguay","2024-01-31",0,0,0,0,0,0,0,0
"Uruguay","2024-02-01",0,0,0,0,0,0,0,0
"Uruguay","2024-02-02",0,0,0,0,0,0,0,0
"Uruguay","2024-02-03",0,0,0,0,0,0,0,0
"Uruguay","2024-02-04",0,0,0,0,0,0,0,0
"Uruguay","2024-02-05",0,0,0,0,0,0,0,0
"Uruguay","2024-02-06",0,0,0,0,0,0,0,0
"Uruguay","2024-02-07",0,0,0,0,0,0,0,0
"Uruguay","2024-02-08",0,0,0,0,0,0,0,0
"Uruguay","2024-02-09",0,0,0,0,0,0,0,0
"Uruguay","2024-02-10",0,0,0,0,0,0,0,0
"Uruguay","2024-02-11",0,0,0,0,0,0,0,0
"Uruguay","2024-02-12",0,0,0,0,0,0,0,0
"Uruguay","2024-02-13",0,0,0,0,0,0,0,0
"Uruguay","2024-02-14",0,0,0,0,0,0,0,0
"Uruguay","2024-02-15",0,0,0,0,0,0,0,0
"Uruguay","2024-02-16",0,0,0,0,0,0,0,0
"Uruguay","2024-02-17",0,0,0,0,0,0,0,0
"Uruguay","2024-02-18",0,0,0,0,0,0,0,0
"Uruguay","2024-02-19",0,0,0,0,0,0,0,0
"Uruguay","2024-02-20",0,0,0,0,0,0,0,0
"Uruguay","2024-02-21",0,0,0,0,0,0,0,0
"Uruguay","2024-02-22",0,0,0,0,0,0,0,0
"Uruguay","2024-02-23",0,0,0,0,0,0,0,0
"Uruguay","2024-02-24",0,0,0,0,0,0,0,0
"Uruguay","2024-02-25",0,0,0,0,0,0,0,0
"Uruguay","2024-02-26",0,0,0,0,0,0,0,0
"Uruguay","2024-02-27",0,0,0,0,0,0,0,0
"Uruguay","2024-02-28",0,0,0,0,0,0,0,0
"Uruguay","2024-02-29",0,0,0,0,0,0,0,0
"Uruguay","2024-03-01",0,0,0,0,0,0,0,0
"Uruguay","2024-03-02",0,0,0,0,0,0,0,0
"Uruguay","2024-03-03",0,0,0,0,0,0,0,0
"Uruguay","2024-03-04",0,0,0,0,0,0,0,0
"Uruguay","2024-03-05",0,0,0,0,0,0,0,0
"Uruguay","2024-03-06",0,0,0,0,0,0,0,0
"Uruguay","2024-03-07",0,0,0,0,0,0,0,0
"Uruguay","2024-03-08",0,0,0,0,0,0,0,0
"Uruguay","2024-03-09",0,0,0,0,0,0,0,0
"Uruguay","2024-03-10",0,0,0,0,0,0,0,0
"Uruguay","2024-03-11",0,0,0,0,0,0,0,0
"Uruguay","2024-03-12",0,0,0,0,0,0,0,0
"Uruguay","2024-03-13",0,0,0,0,0,0,0,0
"Uruguay","2024-03-14",0,0,0,0,0,0,0,0
"Uruguay","2024-03-15",0,0,0,0,0,0,0,0
"Uruguay","2024-03-16",0,0,0,0,0,0,0,0
"Uruguay","2024-03-17",0,0,0,0,0,0,0,0
"Uruguay","2024-03-18",0,0,0,0,0,0,0,0
"Uruguay","2024-03-19",0,0,0,0,0,0,0,0
"Uruguay","2024-03-20",0,0,0,0,0,0,0,0
"Uruguay","2024-03-21",0,0,0,0,0,0,0,0
"Uruguay","2024-03-22",0,0,0,0,0,0,0,0
"Uruguay","2024-03-23",0,0,0,0,0,0,0,0
"Uruguay","2024-03-24",0,0,0,0,0,0,0,0
"Uruguay","2024-03-25",0,0,0,0,0,0,0,0
"Uruguay","2024-03-26",0,0,0,0,0,0,0,0
"Uruguay","2024-03-27",0,0,0,0,0,0,0,0
"Uruguay","2024-03-28",0,0,0,0,0,0,0,0
"Uruguay","2024-03-29",0,0,0,0,0,0,0,0
"Uruguay","2024-03-30",0,0,0,0,0,0,0,0
"Uruguay","2024-03-31",0,0,0,0,0,0,0,0
"Uruguay","2024-04-01",0,0,0,0,0,0,0,0
"Uruguay","2024-04-02",0,0,0,0,0,0,0,0
"Uruguay","2024-04-03",0,0,0,0,0,0,0,0
"Uruguay","2024-04-04",0,0,0,0,0,0,0,0
"Uruguay","2024-04-05",0,0,0,0,0,0,0,0
"Uruguay","2024-04-06",0,0,0,0,0,0,0,0
"Uruguay","2024-04-07",0,0,0,0,0,0,0,0
"Uruguay","2024-04-08",0,0,0,0,0,0,0,0
"Uruguay","2024-04-09",0,0,0,0,0,0,0,0
"Uruguay","2024-04-10",0,0,0,0,0,0,0,0
"Uruguay","2024-04-11",0,0,0,0,0,0,0,0
"Uruguay","2024-04-12",0,0,0,0,0,0,0,0
"Uruguay","2024-04-13",0,0,0,0,0,0,0,0
"Uruguay","2024-04-14",0,0,0,0,0,0,0,0
"Uruguay","2024-04-15",0,0,0,0,0,0,0,0
"Uruguay","2024-04-16",0,0,0,0,0,0,0,0
"Uruguay","2024-04-17",0,0,0,0,0,0,0,0
"Uruguay","2024-04-18",0,0,0,0,0,0,0,0
"Uruguay","2024-04-19",0,0,0,0,0,0,0,0
"Uruguay","2024-04-20",0,0,0,0,0,0,0,0
"Uruguay","2024-04-21",0,0,0,0,0,0,0,0
"Uruguay","2024-04-22",0,0,0,0,0,0,0,0
"Uruguay","2024-04-23",0,0,0,0,0,0,0,0
"Uruguay","2024-04-24",0,0,0,0,0,0,0,0
"Uruguay","2024-04-25",0,0,0,0,0,0,0,0
"Uruguay","2024-04-26",0,0,0,0,0,0,0,0
"Uruguay","2024-04-27",0,0,0,0,0,0,0,0
"Uruguay","2024-04-28",0,0,0,0,0,0,0,0
"Uruguay","2024-04-29",0,0,0,0,0,0,0,0
"Uruguay","2024-04-30",0,0,0,0,0,0,0,0
"Uruguay","2024-05-01",0,0,0,0,0,0,0,0
"Uruguay","2024-05-02",0,0,0,0,0,0,0,0
"Uruguay","2024-05-03",0,0,0,0,0,0,0,0
"Uruguay","2024-05-04",0,0,0,0,0,0,0,0
"Uruguay","2024-05-05",0,0,0,0,0,0,0,0
"Uruguay","2024-05-06",0,0,0,0,0,0,0,0
"Uruguay","2024-05-07",0,0,0,0,0,0,0,0
"Uruguay","2024-05-08",0,0,0,0,0,0,0,0
"Uruguay","2024-05-09",0,0,0,0,0,0,0,0
"Uruguay","2024-05-10",0,0,0,0,0,0,0,0
"Uruguay","2024-05-11",0,0,0,0,0,0,0,0
"Uruguay","2024-05-12",0,0,0,0,0,0,0,0
"Uruguay","2024-05-13",0,0,0,0,0,0,0,0
"Uruguay","2024-05-14",0,0,0,0,0,0,0,0
"Uruguay","2024-05-15",0,0,0,0,0,0,0,0
"Uruguay","2024-05-16",0,0,0,0,0,0,0,0
"Uruguay","2024-05-17",0,0,0,0,0,0,0,0
"Uruguay","2024-05-18",0,0,0,0,0,0,0,0
"Uruguay","2024-05-19",0,0,0,0,0,0,0,0
"Uruguay","2024-05-20",0,0,0,0,0,0,0,0
"Uruguay","2024-05-21",0,0,0,0,0,0,0,0
"Uruguay","2024-05-22",0,0,0,0,0,0,0,0
"Uruguay","2024-05-23",0,0,0,0,0,0,0,0
"Uruguay","2024-05-24",0,0,0,0,0,0,0,0
"Uruguay","2024-05-25",0,0,0,0,0,0,0,0
"Uruguay","2024-05-26",0,0,0,0,0,0,0,0
"Uruguay","2024-05-27",0,0,0,0,0,0,0,0
"Uruguay","2024-05-28",0,0,0,0,0,0,0,0
"Uruguay","2024-05-29",0,0,0,0,0,0,0,0
"Uruguay","2024-05-30",0,0,0,0,0,0,0,0
"Uruguay","2024-05-31",0,0,0,0,0,0,0,0
"Uruguay","2024-06-01",0,0,0,0,0,0,0,0
"Uruguay","2024-06-02",0,0,0,0,0,0,0,0
"Uruguay","2024-06-03",0,0,0,0,0,0,0,0
"Uruguay","2024-06-04",0,0,0,0,0,0,0,0
"Uruguay","2024-06-05",0,0,0,0,0,0,0,0
"Uruguay","2024-06-06",0,0,0,0,0,0,0,0
"Uruguay","2024-06-07",0,0,0,0,0,0,0,0
"Uruguay","2024-06-08",0,0,0,0,0,0,0,0
"Uruguay","2024-06-09",0,0,0,0,0,0,0,0
"Uruguay","2024-06-10",0,0,0,0,0,0,0,0
"Uruguay","2024-06-11",0,0,0,0,0,0,0,0
"Uruguay","2024-06-12",0,0,0,0,0,0,0,0
"Uruguay","2024-06-13",0,0,0,0,0,0,0,0
"Uruguay","2024-06-14",0,0,0,0,0,0,0,0
"Uruguay","2024-06-15",0,0,0,0,0,0,0,0
"Uruguay","2024-06-16",0,0,0,0,0,0,0,0
"Uruguay","2024-06-17",0,0,0,0,0,0,0,0
"Uruguay","2024-06-18",0,0,0,0,0,0,0,0
"Uruguay","2024-06-19",0,0,0,0,0,0,0,0
"Uruguay","2024-06-20",0,0,0,0,0,0,0,0
"Uruguay","2024-06-21",0,0,0,0,0,0,0,0
"Uruguay","2024-06-22",0,0,0,0,0,0,0,0
"Uruguay","2024-06-23",0,0,0,0,0,0,0,0
"Uruguay","2024-06-24",0,0,0,0,0,0,0,0
"Uruguay","2024-06-25",0,0,0,0,0,0,0,0
"Uruguay","2024-06-26",0,0,0,0,0,0,0,0
"Uruguay","2024-06-27",0,0,0,0,0,0,0,0
"Uruguay","2024-06-28",0,0,0,0,0,0,0,0
"Uruguay","2024-06-29",0,0,0,0,0,0,0,0
"Uruguay","2024-06-30",0,0,0,0,0,0,0,0
"Uruguay","2024-07-01",0,0,0,0,0,0,0,0
"Uruguay","2024-07-02",0,0,0,0,0,0,0,0
"Uruguay","2024-07-03",0,0,0,0,0,0,0,0
"Uruguay","2024-07-04",0,0,0,0,0,0,0,0
"Uruguay","2024-07-05",0,0,0,0,0,0,0,0
"Uruguay","2024-07-06",0,0,0,0,0,0,0,0
"Uruguay","2024-07-07",0,0,0,0,0,0,0,0
"Uruguay","2024-07-08",0,0,0,0,0,0,0,0
"Uruguay","2024-07-09",0,0,0,0,0,0,0,0
"Uruguay","2024-07-10",0,0,0,0,0,0,0,0
"Uruguay","2024-07-11",0,0,0,0,0,0,0,0
"Uruguay","2024-07-12",0,0,0,0,0,0,0,0
"Uruguay","2024-07-13",0,0,0,0,0,0,0,0
"Uruguay","2024-07-14",0,0,0,0,0,0,0,0
"Uruguay","2024-07-15",0,0,0,0,0,0,0,0
"Uruguay","2024-07-16",0,0,0,0,0,0,0,0
"Uruguay","2024-07-17",0,0,0,0,0,0,0,0
"Uruguay","2024-07-18",0,0,0,0,0,0,0,0
"Uruguay","2024-07-19",0,0,0,0,0,0,0,0
"Uruguay","2024-07-20",0,0,0,0,0,0,0,0
"Uruguay","2024-07-21",0,0,0,0,0,0,0,0
"Uruguay","2024-07-22",0,0,0,0,0,0,0,0
"Uruguay","2024-07-23",0,0,0,0,0,0,0,0
"Uruguay","2024-07-24",0,0,0,0,0,0,0,0
"Uruguay","2024-07-25",0,0,0,0,0,0,0,0
"Uruguay","2024-07-26",0,0,0,0,0,0,0,0
"Uruguay","2024-07-27",0,0,0,0,0,0,0,0
"Uruguay","2024-07-28",0,0,0,0,0,0,0,0
"Uruguay","2024-07-29",0,0,0,0,0,0,0,0
"Uruguay","2024-07-30",0,0,0,0,0,0,0,0
"Uruguay","2024-07-31",0,0,0,0,0,0,0,0
"Uruguay","2024-08-01",0,0,0,0,0,0,0,0
"Uruguay","2024-08-02",0,0,0,0,0,0,0,0
"Uruguay","2024-08-03",0,0,0,0,0,0,0,0
"Uruguay","2024-08-04",0,0,0,0,0,0,0,0
"Uruguay","2024-08-05",0,0,0,0,0,0,0,0
"Uruguay","2024-08-06",0,0,0,0,0,0,0,0
"Uruguay","2024-08-07",0,0,0,0,0,0,0,0
"Uruguay","2024-08-08",0,0,0,0,0,0,0,0
"Uruguay","2024-08-09",0,0,0,0,0,0,0,0
"Uruguay","2024-08-10",0,0,0,0,0,0,0,0
"Uruguay","2024-08-11",0,0,0,0,0,0,0,0
"Uruguay","2024-08-12",0,0,0,0,0,0,0,0
"Uruguay","2024-08-13",0,0,0,0,0,0,0,0
"Uruguay","2024-08-14",0,0,0,0,0,0,0,0
"Uruguay","2024-08-15",0,0,0,0,0,0,0,0
"Uruguay","2024-08-16",0,0,0,0,0,0,0,0
"Uruguay","2024-08-17",0,0,0,0,0,0,0,0
"Uruguay","2024-08-18",0,0,0,0,0,0,0,0
"Uruguay","2024-08-19",0,0,0,0,0,0,0,0
"Uruguay","2024-08-20",0,0,0,0,0,0,0,0
"Uruguay","2024-08-21",0,0,0,0,0,0,0,0
"Uruguay","2024-08-22",0,0,0,0,0,0,0,0
"Uruguay","2024-08-23",0,0,0,0,0,0,0,0
"Uruguay","2024-08-24",0,0,0,0,0,0,0,0
"Uruguay","2024-08-25",0,0,0,0,0,0,0,0
"Uruguay","2024-08-26",0,0,0,0,0,0,0,0
"Uruguay","2024-08-27",0,0,0,0,0,0,0,0
"Uruguay","2024-08-28",0,0,0,0,0,0,0,0
"Uruguay","2024-08-29",0,0,0,0,0,0,0,0
"Uruguay","2024-08-30",0,0,0,0,0,0,0,0
"Uruguay","2024-08-31",0,0,0,0,0,0,0,0
"Uruguay","2024-09-01",0,0,0,0,0,0,0,0
"Uruguay","2024-09-02",0,0,0,0,0,0,0,0
"Uruguay","2024-09-03",0,0,0,0,0,0,0,0
"Uruguay","2024-09-04",0,0,0,0,0,0,0,0
"Uruguay","2024-09-05",0,0,0,0,0,0,0,0
"Uruguay","2024-09-06",0,0,0,0,0,0,0,0
"Uruguay","2024-09-07",0,0,0,0,0,0,0,0
"Uruguay","2024-09-08",0,0,0,0,0,0,0,0
"Uruguay","2024-09-09",0,0,0,0,0,0,0,0
"Uruguay","2024-09-10",0,0,0,0,0,0,0,0
"Uruguay","2024-09-11",0,0,0,0,0,0,0,0
"Uruguay","2024-09-12",0,0,0,0,0,0,0,0
"Uruguay","2024-09-13",0,0,0,0,0,0,0,0
"Uruguay","2024-09-14",0,0,0,0,0,0,0,0
"Uruguay","2024-09-15",0,0,0,0,0,0,0,0
"Uruguay","2024-09-16",0,0,0,0,0,0,0,0
"Uruguay","2024-09-17",0,0,0,0,0,0,0,0
"Uruguay","2024-09-18",0,0,0,0,0,0,0,0
"Uruguay","2024-09-19",0,0,0,0,0,0,0,0
"Uruguay","2024-09-20",0,0,0,0,0,0,0,0
"Uruguay","2024-09-21",0,0,0,0,0,0,0,0
"Uruguay","2024-09-22",0,0,0,0,0,0,0,0
"Uruguay","2024-09-23",0,0,0,0,0,0,0,0
"Uruguay","2024-09-24",0,1,1,0,1,1,0,0
"Uruguay","2024-09-25",0,0,1,0,0,1,0,0
"Uruguay","2024-09-26",0,0,1,0,0,1,0,0
"Uruguay","2024-09-27",0,0,1,0,0,1,0,0
"Uruguay","2024-09-28",0,0,1,0,0,1,0,0
"Uruguay","2024-09-29",0,0,1,0,0,1,0,0
"Uruguay","2024-09-30",0,0,1,0,0,1,0,0
"Uruguay","2024-10-01",0,0,1,0,0,1,0,0
"Uruguay","2024-10-02",0,0,1,0,0,1,0,0
"Uruguay","2024-10-03",0,0,1,0,0,1,0,0
"Uruguay","2024-10-04",0,0,1,0,0,1,0,0
"Uruguay","2024-10-05",0,0,1,0,0,1,0,0
"Uruguay","2024-10-06",0,0,1,0,0,1,0,0
"Uruguay","2024-10-07",0,0,1,0,0,1,0,0
"Uruguay","2024-10-08",0,0,1,0,0,1,0,0
"Uruguay","2024-10-09",0,0,1,0,0,1,0,0
"Uruguay","2024-10-10",0,0,1,0,0,1,0,0
"Uruguay","2024-10-11",0,0,1,0,0,1,0,0
"Uruguay","2024-10-12",0,0,1,0,0,1,0,0
"Uruguay","2024-10-13",0,0,1,0,0,1,0,0
"Uruguay","2024-10-14",0,0,1,0,0,1,0,0
"Uruguay","2024-10-15",0,0,1,0,0,1,0,0
"Uruguay","2024-10-16",0,0,1,0,0,1,0,0
"Uruguay","2024-10-17",0,0,1,0,0,1,0,0
"Uruguay","2024-10-18",0,0,1,0,0,1,0,0
"Uruguay","2024-10-19",0,0,1,0,0,1,0,0
"Uruguay","2024-10-20",0,0,1,0,0,1,0,0
"Uruguay","2024-10-21",0,0,1,0,0,1,0,0
"Uruguay","2024-10-22",0,0,1,0,0,1,0,0
"Uruguay","2024-10-23",0,0,1,0,0,1,0,0
"Uruguay","2024-10-24",0,0,1,0,0,1,0,0
"Uruguay","2024-10-25",0,0,1,0,0,1,0,0
"Uruguay","2024-10-26",0,0,1,0,0,1,0,0
"Uruguay","2024-10-27",0,0,1,0,0,1,0,0
"Uruguay","2024-10-28",0,0,1,0,0,1,0,0
"Uruguay","2024-10-29",0,0,1,0,0,1,0,0
"Uruguay","2024-10-30",0,0,1,0,0,1,0,0
"Uruguay","2024-10-31",0,0,1,0,0,1,0,0
"Uruguay","2024-11-01",0,0,1,0,0,1,0,0
"Uruguay","2024-11-02",0,0,1,0,0,1,0,0
"Uruguay","2024-11-03",0,0,1,0,0,1,0,0
"Uruguay","2024-11-04",0,0,1,0,0,1,0,0
"Uruguay","2024-11-05",0,0,1,0,0,1,0,0
"Uruguay","2024-11-06",0,0,1,0,0,1,0,0
"Uruguay","2024-11-07",0,0,1,0,0,1,0,0
"Uruguay","2024-11-08",0,0,1,0,0,1,0,0
"Uruguay","2024-11-09",0,0,1,0,0,1,0,0
"Uruguay","2024-11-10",0,0,1,0,0,1,0,0
"Uruguay","2024-11-11",0,0,1,0,0,1,0,0
"Uruguay","2024-11-12",0,0,1,0,0,1,0,0
"Uruguay","2024-11-13",0,0,1,0,0,1,0,0
"Uruguay","2024-11-14",0,0,1,0,0,1,0,0
"Uruguay","2024-11-15",0,0,1,0,0,1,0,0
"Uruguay","2024-11-16",0,0,1,0,0,1,0,0
"Uruguay","2024-11-17",0,0,1,0,0,1,0,0
"Uruguay","2024-11-18",0,0,1,0,0,1,0,0
"Uruguay","2024-11-19",0,0,1,0,0,1,0,0
"Uruguay","2024-11-20",0,0,1,0,0,1,0,0
"Uruguay","2024-11-21",0,0,1,0,0,1,0,0
"Uruguay","2024-11-22",0,0,1,0,0,1,0,0
"Uruguay","2024-11-23",0,0,1,0,0,1,0,0
"Uruguay","2024-11-24",0,0,1,0,0,1,0,0
"Uruguay","2024-11-25",0,0,1,0,0,1,0,0
"Uruguay","2024-11-26",0,0,1,0,0,1,0,0
"Uruguay","2024-11-27",0,0,1,0,0,1,0,0
"Uruguay","2024-11-28",0,0,1,0,0,1,0,0
"Uruguay","2024-11-29",0,0,1,0,0,1,0,0
"Uruguay","2024-11-30",0,0,1,0,0,1,0,0
"Uruguay","2024-12-01",0,0,1,0,0,1,0,0
"Uruguay","2024-12-02",0,0,1,0,0,1,0,0
"Uruguay","2024-12-03",0,0,1,0,0,1,0,0
"Uruguay","2024-12-04",0,0,1,0,0,1,0,0
"Uruguay","2024-12-05",0,0,1,0,0,1,0,0
"Uruguay","2024-12-06",0,0,1,0,0,1,0,0
"Uruguay","2024-12-07",0,0,1,0,0,1,0,0
"Uruguay","2024-12-08",0,0,1,0,0,1,0,0
"Uruguay","2024-12-09",0,0,1,0,0,1,0,0
"Uruguay","2024-12-10",0,0,1,0,0,1,0,0
"Uruguay","2024-12-11",0,0,1,0,0,1,0,0
"Uruguay","2024-12-12",0,0,1,0,0,1,0,0
"Uruguay","2024-12-13",0,0,1,0,0,1,0,0
"Uruguay","2024-12-14",0,0,1,0,0,1,0,0
"Uruguay","2024-12-15",0,0,1,0,0,1,0,0
"Uruguay","2024-12-16",0,0,1,0,0,1,0,0
"Uruguay","2024-12-17",0,0,1,0,0,1,0,0
"Uruguay","2024-12-18",0,0,1,0,0,1,0,0
"Uruguay","2024-12-19",0,0,1,0,0,1,0,0
"Uruguay","2024-12-20",0,0,1,0,0,1,0,0
"Uruguay","2024-12-21",0,0,1,0,0,1,0,0
"Uruguay","2024-12-22",0,0,1,0,0,1,0,0
"Uruguay","2024-12-23",0,0,1,0,0,1,0,0
"Uruguay","2024-12-24",0,0,1,0,0,1,0,0
"Uruguay","2024-12-25",0,0,1,0,0,1,0,0
"Uruguay","2024-12-26",0,0,1,0,0,1,0,0
"Uruguay","2024-12-27",0,0,1,0,0,1,0,0
"Uruguay","2024-12-28",0,0,1,0,0,1,0,0
"Uruguay","2024-12-29",0,0,1,0,0,1,0,0
"Uruguay","2024-12-30",0,0,1,0,0,1,0,0
"Uruguay","2024-12-31",0,0,1,0,0,1,0,0
"Uruguay","2025-01-01",0,0,1,0,0,1,0,0
"Uruguay","2025-01-02",0,0,1,0,0,1,0,0
"Uruguay","2025-01-03",0,0,1,0,0,1,0,0
"Uruguay","2025-01-04",0,0,1,0,0,1,0,0
"Uruguay","2025-01-05",0,0,1,0,0,1,0,0
"Uruguay","2025-01-06",0,0,1,0,0,1,0,0
"Uruguay","2025-01-07",0,0,1,0,0,1,0,0
"Uruguay","2025-01-08",0,0,1,0,0,1,0,0
"Uruguay","2025-01-09",0,0,1,0,0,1,0,0
"Uruguay","2025-01-10",0,0,1,0,0,1,0,0
"Uruguay","2025-01-11",0,0,1,0,0,1,0,0
"Uruguay","2025-01-12",0,0,1,0,0,1,0,0
"Uruguay","2025-01-13",0,0,1,0,0,1,0,0
"Venezuela (Bolivarian Republic of)","2024-01-01",0,0,0,0,0,0,0,0
"Venezuela (Bolivarian Republic of)","2024-01-02",0,0,0,0,0,0,0,0
"Venezuela (Bolivarian Republic of)","2024-01-03",0,0,0,0,0,0,0,0
"Venezuela (Bolivarian Republic of)","2024-01-04",0,0,0,0,0,0,0,0
"Venezuela (Bolivarian Republic of)","2024-01-05",0,0,0,0,0,0,0,0
"Venezuela (Bolivarian Republic of)","2024-01-06",0,0,0,0,0,0,0,0
"Venezuela (Bolivarian Republic of)","2024-01-07",0,0,0,0,0,0,0,0
"Venezuela (Bolivarian Republic of)","2024-01-08",0,0,0,0,0,0,0,0
"Venezuela (Bolivarian Republic of)","2024-01-09",0,0,0,0,0,0,0,0
"Venezuela (Bolivarian Republic of)","2024-01-10",0,0,0,0,0,0,0,0
"Venezuela (Bolivarian Republic of)","2024-01-11",0,0,0,0,0,0,0,0
"Venezuela (Bolivarian Republic of)","2024-01-12",0,0,0,0,0,0,0,0
"Venezuela (Bolivarian Republic of)","2024-01-13",0,0,0,0,0,0,0,0
"Venezuela (Bolivarian Republic of)","2024-01-14",0,0,0,0,0,0,0,0
"Venezuela (Bolivarian Republic of)","2024-01-15",0,0,0,0,0,0,0,0
"Venezuela (Bolivarian Republic of)","2024-01-16",0,0,0,0,0,0,0,0
"Venezuela (Bolivarian Republic of)","2024-01-17",0,0,0,0,0,0,0,0
"Venezuela (Bolivarian Republic of)","2024-01-18",0,0,0,0,0,0,0,0
"Venezuela (Bolivarian Republic of)","2024-01-19",0,0,0,0,0,0,0,0
"Venezuela (Bolivarian Republic of)","2024-01-20",0,0,0,0,0,0,0,0
"Venezuela (Bolivarian Republic of)","2024-01-21",0,0,0,0,0,0,0,0
"Venezuela (Bolivarian Republic of)","2024-01-22",0,0,0,0,0,0,0,0
"Venezuela (Bolivarian Republic of)","2024-01-23",0,0,0,0,0,0,0,0
"Venezuela (Bolivarian Republic of)","2024-01-24",0,0,0,0,0,0,0,0
"Venezuela (Bolivarian Republic of)","2024-01-25",0,0,0,0,0,0,0,0
"Venezuela (Bolivarian Republic of)","2024-01-26",0,0,0,0,0,0,0,0
"Venezuela (Bolivarian Republic of)","2024-01-27",0,0,0,0,0,0,0,0
"Venezuela (Bolivarian Republic of)","2024-01-28",0,0,0,0,0,0,0,0
"Venezuela (Bolivarian Republic of)","2024-01-29",0,0,0,0,0,0,0,0
"Venezuela (Bolivarian Republic of)","2024-01-30",0,0,0,0,0,0,0,0
"Venezuela (Bolivarian Republic of)","2024-01-31",0,0,0,0,0,0,0,0
"Venezuela (Bolivarian Republic of)","2024-02-01",0,0,0,0,0,0,0,0
"Venezuela (Bolivarian Republic of)","2024-02-02",0,0,0,0,0,0,0,0
"Venezuela (Bolivarian Republic of)","2024-02-03",0,0,0,0,0,0,0,0
"Venezuela (Bolivarian Republic of)","2024-02-04",0,0,0,0,0,0,0,0
"Venezuela (Bolivarian Republic of)","2024-02-05",0,0,0,0,0,0,0,0
"Venezuela (Bolivarian Republic of)","2024-02-06",0,0,0,0,0,0,0,0
"Venezuela (Bolivarian Republic of)","2024-02-07",0,0,0,0,0,0,0,0
"Venezuela (Bolivarian Republic of)","2024-02-08",0,0,0,0,0,0,0,0
"Venezuela (Bolivarian Republic of)","2024-02-09",0,0,0,0,0,0,0,0
"Venezuela (Bolivarian Republic of)","2024-02-10",0,0,0,0,0,0,0,0
"Venezuela (Bolivarian Republic of)","2024-02-11",0,0,0,0,0,0,0,0
"Venezuela (Bolivarian Republic of)","2024-02-12",0,0,0,0,0,0,0,0
"Venezuela (Bolivarian Republic of)","2024-02-13",0,0,0,0,0,0,0,0
"Venezuela (Bolivarian Republic of)","2024-02-14",0,0,0,0,0,0,0,0
"Venezuela (Bolivarian Republic of)","2024-02-15",0,0,0,0,0,0,0,0
"Venezuela (Bolivarian Republic of)","2024-02-16",0,0,0,0,0,0,0,0
"Venezuela (Bolivarian Republic of)","2024-02-17",0,0,0,0,0,0,0,0
"Venezuela (Bolivarian Republic of)","2024-02-18",0,0,0,0,0,0,0,0
"Venezuela (Bolivarian Republic of)","2024-02-19",0,0,0,0,0,0,0,0
"Venezuela (Bolivarian Republic of)","2024-02-20",0,0,0,0,0,0,0,0
"Venezuela (Bolivarian Republic of)","2024-02-21",0,0,0,0,0,0,0,0
"Venezuela (Bolivarian Republic of)","2024-02-22",0,0,0,0,0,0,0,0
"Venezuela (Bolivarian Republic of)","2024-02-23",0,0,0,0,0,0,0,0
"Venezuela (Bolivarian Republic of)","2024-02-24",0,0,0,0,0,0,0,0
"Venezuela (Bolivarian Republic of)","2024-02-25",0,0,0,0,0,0,0,0
"Venezuela (Bolivarian Republic of)","2024-02-26",0,0,0,0,0,0,0,0
"Venezuela (Bolivarian Republic of)","2024-02-27",0,0,0,0,0,0,0,0
"Venezuela (Bolivarian Republic of)","2024-02-28",0,0,0,0,0,0,0,0
"Venezuela (Bolivarian Republic of)","2024-02-29",0,0,0,0,0,0,0,0
"Venezuela (Bolivarian Republic of)","2024-03-01",0,0,0,0,0,0,0,0
"Venezuela (Bolivarian Republic of)","2024-03-02",0,0,0,0,0,0,0,0
"Venezuela (Bolivarian Republic of)","2024-03-03",0,0,0,0,0,0,0,0
"Venezuela (Bolivarian Republic of)","2024-03-04",0,0,0,0,0,0,0,0
"Venezuela (Bolivarian Republic of)","2024-03-05",0,0,0,0,0,0,0,0
"Venezuela (Bolivarian Republic of)","2024-03-06",0,0,0,0,0,0,0,0
"Venezuela (Bolivarian Republic of)","2024-03-07",0,0,0,0,0,0,0,0
"Venezuela (Bolivarian Republic of)","2024-03-08",0,0,0,0,0,0,0,0
"Venezuela (Bolivarian Republic of)","2024-03-09",0,0,0,0,0,0,0,0
"Venezuela (Bolivarian Republic of)","2024-03-10",0,0,0,0,0,0,0,0
"Venezuela (Bolivarian Republic of)","2024-03-11",0,0,0,0,0,0,0,0
"Venezuela (Bolivarian Republic of)","2024-03-12",0,0,0,0,0,0,0,0
"Venezuela (Bolivarian Republic of)","2024-03-13",0,0,0,0,0,0,0,0
"Venezuela (Bolivarian Republic of)","2024-03-14",0,0,0,0,0,0,0,0
"Venezuela (Bolivarian Republic of)","2024-03-15",0,0,0,0,0,0,0,0
"Venezuela (Bolivarian Republic of)","2024-03-16",0,0,0,0,0,0,0,0
"Venezuela (Bolivarian Republic of)","2024-03-17",0,0,0,0,0,0,0,0
"Venezuela (Bolivarian Republic of)","2024-03-18",0,0,0,0,0,0,0,0
"Venezuela (Bolivarian Republic of)","2024-03-19",0,0,0,0,0,0,0,0
"Venezuela (Bolivarian Republic of)","2024-03-20",0,0,0,0,0,0,0,0
"Venezuela (Bolivarian Republic of)","2024-03-21",0,0,0,0,0,0,0,0
"Venezuela (Bolivarian Republic of)","2024-03-22",0,0,0,0,0,0,0,0
"Venezuela (Bolivarian Republic of)","2024-03-23",0,0,0,0,0,0,0,0
"Venezuela (Bolivarian Republic of)","2024-03-24",0,0,0,0,0,0,0,0
"Venezuela (Bolivarian Republic of)","2024-03-25",0,0,0,0,0,0,0,0
"Venezuela (Bolivarian Republic of)","2024-03-26",0,0,0,0,0,0,0,0
"Venezuela (Bolivarian Republic of)","2024-03-27",0,0,0,0,0,0,0,0
"Venezuela (Bolivarian Republic of)","2024-03-28",0,0,0,0,0,0,0,0
"Venezuela (Bolivarian Republic of)","2024-03-29",0,0,0,0,0,0,0,0
"Venezuela (Bolivarian Republic of)","2024-03-30",0,0,0,0,0,0,0,0
"Venezuela (Bolivarian Republic of)","2024-03-31",0,0,0,0,0,0,0,0
"Venezuela (Bolivarian Republic of)","2024-04-01",0,0,0,0,0,0,0,0
"Venezuela (Bolivarian Republic of)","2024-04-02",0,0,0,0,0,0,0,0
"Venezuela (Bolivarian Republic of)","2024-04-03",0,0,0,0,0,0,0,0
"Venezuela (Bolivarian Republic of)","2024-04-04",0,0,0,0,0,0,0,0
"Venezuela (Bolivarian Republic of)","2024-04-05",0,0,0,0,0,0,0,0
"Venezuela (Bolivarian Republic of)","2024-04-06",0,0,0,0,0,0,0,0
"Venezuela (Bolivarian Republic of)","2024-04-07",0,0,0,0,0,0,0,0
"Venezuela (Bolivarian Republic of)","2024-04-08",0,0,0,0,0,0,0,0
"Venezuela (Bolivarian Republic of)","2024-04-09",0,0,0,0,0,0,0,0
"Venezuela (Bolivarian Republic of)","2024-04-10",0,0,0,0,0,0,0,0
"Venezuela (Bolivarian Republic of)","2024-04-11",0,0,0,0,0,0,0,0
"Venezuela (Bolivarian Republic of)","2024-04-12",0,0,0,0,0,0,0,0
"Venezuela (Bolivarian Republic of)","2024-04-13",0,0,0,0,0,0,0,0
"Venezuela (Bolivarian Republic of)","2024-04-14",0,0,0,0,0,0,0,0
"Venezuela (Bolivarian Republic of)","2024-04-15",0,0,0,0,0,0,0,0
"Venezuela (Bolivarian Republic of)","2024-04-16",0,0,0,0,0,0,0,0
"Venezuela (Bolivarian Republic of)","2024-04-17",0,0,0,0,0,0,0,0
"Venezuela (Bolivarian Republic of)","2024-04-18",0,0,0,0,0,0,0,0
"Venezuela (Bolivarian Republic of)","2024-04-19",0,0,0,0,0,0,0,0
"Venezuela (Bolivarian Republic of)","2024-04-20",0,0,0,0,0,0,0,0
"Venezuela (Bolivarian Republic of)","2024-04-21",0,0,0,0,0,0,0,0
"Venezuela (Bolivarian Republic of)","2024-04-22",0,0,0,0,0,0,0,0
"Venezuela (Bolivarian Republic of)","2024-04-23",0,0,0,0,0,0,0,0
"Venezuela (Bolivarian Republic of)","2024-04-24",0,0,0,0,0,0,0,0
"Venezuela (Bolivarian Republic of)","2024-04-25",0,0,0,0,0,0,0,0
"Venezuela (Bolivarian Republic of)","2024-04-26",0,0,0,0,0,0,0,0
"Venezuela (Bolivarian Republic of)","2024-04-27",0,0,0,0,0,0,0,0
"Venezuela (Bolivarian Republic of)","2024-04-28",0,0,0,0,0,0,0,0
"Venezuela (Bolivarian Republic of)","2024-04-29",0,0,0,0,0,0,0,0
"Venezuela (Bolivarian Republic of)","2024-04-30",0,0,0,0,0,0,0,0
"Venezuela (Bolivarian Republic of)","2024-05-01",0,0,0,0,0,0,0,0
"Venezuela (Bolivarian Republic of)","2024-05-02",0,0,0,0,0,0,0,0
"Venezuela (Bolivarian Republic of)","2024-05-03",0,0,0,0,0,0,0,0
"Venezuela (Bolivarian Republic of)","2024-05-04",0,0,0,0,0,0,0,0
"Venezuela (Bolivarian Republic of)","2024-05-05",0,0,0,0,0,0,0,0
"Venezuela (Bolivarian Republic of)","2024-05-06",0,0,0,0,0,0,0,0
"Venezuela (Bolivarian Republic of)","2024-05-07",0,0,0,0,0,0,0,0
"Venezuela (Bolivarian Republic of)","2024-05-08",0,0,0,0,0,0,0,0
"Venezuela (Bolivarian Republic of)","2024-05-09",0,0,0,0,0,0,0,0
"Venezuela (Bolivarian Republic of)","2024-05-10",0,0,0,0,0,0,0,0
"Venezuela (Bolivarian Republic of)","2024-05-11",0,0,0,0,0,0,0,0
"Venezuela (Bolivarian Republic of)","2024-05-12",0,0,0,0,0,0,0,0
"Venezuela (Bolivarian Republic of)","2024-05-13",0,0,0,0,0,0,0,0
"Venezuela (Bolivarian Republic of)","2024-05-14",0,0,0,0,0,0,0,0
"Venezuela (Bolivarian Republic of)","2024-05-15",0,0,0,0,0,0,0,0
"Venezuela (Bolivarian Republic of)","2024-05-16",0,0,0,0,0,0,0,0
"Venezuela (Bolivarian Republic of)","2024-05-17",0,0,0,0,0,0,0,0
"Venezuela (Bolivarian Republic of)","2024-05-18",0,0,0,0,0,0,0,0
"Venezuela (Bolivarian Republic of)","2024-05-19",0,0,0,0,0,0,0,0
"Venezuela (Bolivarian Republic of)","2024-05-20",0,0,0,0,0,0,0,0
"Venezuela (Bolivarian Republic of)","2024-05-21",0,0,0,0,0,0,0,0
"Venezuela (Bolivarian Republic of)","2024-05-22",0,0,0,0,0,0,0,0
"Venezuela (Bolivarian Republic of)","2024-05-23",0,0,0,0,0,0,0,0
"Venezuela (Bolivarian Republic of)","2024-05-24",0,0,0,0,0,0,0,0
"Venezuela (Bolivarian Republic of)","2024-05-25",0,0,0,0,0,0,0,0
"Venezuela (Bolivarian Republic of)","2024-05-26",0,0,0,0,0,0,0,0
"Venezuela (Bolivarian Republic of)","2024-05-27",0,0,0,0,0,0,0,0
"Venezuela (Bolivarian Republic of)","2024-05-28",0,0,0,0,0,0,0,0
"Venezuela (Bolivarian Republic of)","2024-05-29",0,0,0,0,0,0,0,0
"Venezuela (Bolivarian Republic of)","2024-05-30",0,0,0,0,0,0,0,0
"Venezuela (Bolivarian Republic of)","2024-05-31",0,0,0,0,0,0,0,0
"Venezuela (Bolivarian Republic of)","2024-06-01",0,0,0,0,0,0,0,0
"Venezuela (Bolivarian Republic of)","2024-06-02",0,0,0,0,0,0,0,0
"Venezuela (Bolivarian Republic of)","2024-06-03",0,0,0,0,0,0,0,0
"Venezuela (Bolivarian Republic of)","2024-06-04",0,0,0,0,0,0,0,0
"Venezuela (Bolivarian Republic of)","2024-06-05",0,0,0,0,0,0,0,0
"Venezuela (Bolivarian Republic of)","2024-06-06",0,0,0,0,0,0,0,0
"Venezuela (Bolivarian Republic of)","2024-06-07",0,0,0,0,0,0,0,0
"Venezuela (Bolivarian Republic of)","2024-06-08",0,0,0,0,0,0,0,0
"Venezuela (Bolivarian Republic of)","2024-06-09",0,0,0,0,0,0,0,0
"Venezuela (Bolivarian Republic of)","2024-06-10",0,0,0,0,0,0,0,0
"Venezuela (Bolivarian Republic of)","2024-06-11",0,0,0,0,0,0,0,0
"Venezuela (Bolivarian Republic of)","2024-06-12",0,0,0,0,0,0,0,0
"Venezuela (Bolivarian Republic of)","2024-06-13",0,0,0,0,0,0,0,0
"Venezuela (Bolivarian Republic of)","2024-06-14",0,0,0,0,0,0,0,0
"Venezuela (Bolivarian Republic of)","2024-06-15",0,0,0,0,0,0,0,0
"Venezuela (Bolivarian Republic of)","2024-06-16",0,0,0,0,0,0,0,0
"Venezuela (Bolivarian Republic of)","2024-06-17",0,0,0,0,0,0,0,0
"Venezuela (Bolivarian Republic of)","2024-06-18",0,0,0,0,0,0,0,0
"Venezuela (Bolivarian Republic of)","2024-06-19",0,0,0,0,0,0,0,0
"Venezuela (Bolivarian Republic of)","2024-06-20",0,0,0,0,0,0,0,0
"Venezuela (Bolivarian Republic of)","2024-06-21",0,0,0,0,0,0,0,0
"Venezuela (Bolivarian Republic of)","2024-06-22",0,0,0,0,0,0,0,0
"Venezuela (Bolivarian Republic of)","2024-06-23",0,0,0,0,0,0,0,0
"Venezuela (Bolivarian Republic of)","2024-06-24",0,0,0,0,0,0,0,0
"Venezuela (Bolivarian Republic of)","2024-06-25",0,0,0,0,0,0,0,0
"Venezuela (Bolivarian Republic of)","2024-06-26",0,0,0,0,0,0,0,0
"Venezuela (Bolivarian Republic of)","2024-06-27",0,0,0,0,0,0,0,0
"Venezuela (Bolivarian Republic of)","2024-06-28",0,0,0,0,0,0,0,0
"Venezuela (Bolivarian Republic of)","2024-06-29",0,0,0,0,0,0,0,0
"Venezuela (Bolivarian Republic of)","2024-06-30",0,0,0,0,0,0,0,0
"Venezuela (Bolivarian Republic of)","2024-07-01",0,0,0,0,0,0,0,0
"Venezuela (Bolivarian Republic of)","2024-07-02",0,0,0,0,0,0,0,0
"Venezuela (Bolivarian Republic of)","2024-07-03",0,0,0,0,0,0,0,0
"Venezuela (Bolivarian Republic of)","2024-07-04",0,0,0,0,0,0,0,0
"Venezuela (Bolivarian Republic of)","2024-07-05",0,0,0,0,0,0,0,0
"Venezuela (Bolivarian Republic of)","2024-07-06",0,0,0,0,0,0,0,0
"Venezuela (Bolivarian Republic of)","2024-07-07",0,0,0,0,0,0,0,0
"Venezuela (Bolivarian Republic of)","2024-07-08",0,0,0,0,0,0,0,0
"Venezuela (Bolivarian Republic of)","2024-07-09",0,0,0,0,0,0,0,0
"Venezuela (Bolivarian Republic of)","2024-07-10",0,0,0,0,0,0,0,0
"Venezuela (Bolivarian Republic of)","2024-07-11",0,0,0,0,0,0,0,0
"Venezuela (Bolivarian Republic of)","2024-07-12",0,0,0,0,0,0,0,0
"Venezuela (Bolivarian Republic of)","2024-07-13",0,0,0,0,0,0,0,0
"Venezuela (Bolivarian Republic of)","2024-07-14",0,0,0,0,0,0,0,0
"Venezuela (Bolivarian Republic of)","2024-07-15",0,0,0,0,0,0,0,0
"Venezuela (Bolivarian Republic of)","2024-07-16",0,0,0,0,0,0,0,0
"Venezuela (Bolivarian Republic of)","2024-07-17",0,0,0,0,0,0,0,0
"Venezuela (Bolivarian Republic of)","2024-07-18",0,0,0,0,0,0,0,0
"Venezuela (Bolivarian Republic of)","2024-07-19",0,0,0,0,0,0,0,0
"Venezuela (Bolivarian Republic of)","2024-07-20",0,0,0,0,0,0,0,0
"Venezuela (Bolivarian Republic of)","2024-07-21",0,0,0,0,0,0,0,0
"Venezuela (Bolivarian Republic of)","2024-07-22",0,0,0,0,0,0,0,0
"Venezuela (Bolivarian Republic of)","2024-07-23",0,0,0,0,0,0,0,0
"Venezuela (Bolivarian Republic of)","2024-07-24",0,0,0,0,0,0,0,0
"Venezuela (Bolivarian Republic of)","2024-07-25",0,0,0,0,0,0,0,0
"Venezuela (Bolivarian Republic of)","2024-07-26",0,0,0,0,0,0,0,0
"Venezuela (Bolivarian Republic of)","2024-07-27",0,0,0,0,0,0,0,0
"Venezuela (Bolivarian Republic of)","2024-07-28",0,0,0,0,0,0,0,0
"Venezuela (Bolivarian Republic of)","2024-07-29",0,0,0,0,0,0,0,0
"Venezuela (Bolivarian Republic of)","2024-07-30",0,0,0,0,0,0,0,0
"Venezuela (Bolivarian Republic of)","2024-07-31",0,0,0,0,0,0,0,0
"Venezuela (Bolivarian Republic of)","2024-08-01",0,0,0,0,0,0,0,0
"Venezuela (Bolivarian Republic of)","2024-08-02",0,0,0,0,0,0,0,0
"Venezuela (Bolivarian Republic of)","2024-08-03",0,0,0,0,0,0,0,0
"Venezuela (Bolivarian Republic of)","2024-08-04",0,0,0,0,0,0,0,0
"Venezuela (Bolivarian Republic of)","2024-08-05",0,0,0,0,0,0,0,0
"Venezuela (Bolivarian Republic of)","2024-08-06",0,0,0,0,0,0,0,0
"Venezuela (Bolivarian Republic of)","2024-08-07",0,0,0,0,0,0,0,0
"Venezuela (Bolivarian Republic of)","2024-08-08",0,0,0,0,0,0,0,0
"Venezuela (Bolivarian Republic of)","2024-08-09",0,0,0,0,0,0,0,0
"Venezuela (Bolivarian Republic of)","2024-08-10",0,0,0,0,0,0,0,0
"Venezuela (Bolivarian Republic of)","2024-08-11",0,0,0,0,0,0,0,0
"Venezuela (Bolivarian Republic of)","2024-08-12",0,0,0,0,0,0,0,0
"Venezuela (Bolivarian Republic of)","2024-08-13",0,0,0,0,0,0,0,0
"Venezuela (Bolivarian Republic of)","2024-08-14",0,0,0,0,0,0,0,0
"Venezuela (Bolivarian Republic of)","2024-08-15",0,0,0,0,0,0,0,0
"Venezuela (Bolivarian Republic of)","2024-08-16",0,0,0,0,0,0,0,0
"Venezuela (Bolivarian Republic of)","2024-08-17",0,0,0,0,0,0,0,0
"Venezuela (Bolivarian Republic of)","2024-08-18",0,0,0,0,0,0,0,0
"Venezuela (Bolivarian Republic of)","2024-08-19",0,0,0,0,0,0,0,0
"Venezuela (Bolivarian Republic of)","2024-08-20",0,0,0,0,0,0,0,0
"Venezuela (Bolivarian Republic of)","2024-08-21",0,0,0,0,0,0,0,0
"Venezuela (Bolivarian Republic of)","2024-08-22",0,0,0,0,0,0,0,0
"Venezuela (Bolivarian Republic of)","2024-08-23",0,0,0,0,0,0,0,0
"Venezuela (Bolivarian Republic of)","2024-08-24",0,0,0,0,0,0,0,0
"Venezuela (Bolivarian Republic of)","2024-08-25",0,0,0,0,0,0,0,0
"Venezuela (Bolivarian Republic of)","2024-08-26",0,0,0,0,0,0,0,0
"Venezuela (Bolivarian Republic of)","2024-08-27",0,0,0,0,0,0,0,0
"Venezuela (Bolivarian Republic of)","2024-08-28",0,0,0,0,0,0,0,0
"Venezuela (Bolivarian Republic of)","2024-08-29",0,0,0,0,0,0,0,0
"Venezuela (Bolivarian Republic of)","2024-08-30",0,0,0,0,0,0,0,0
"Venezuela (Bolivarian Republic of)","2024-08-31",0,0,0,0,0,0,0,0
"Venezuela (Bolivarian Republic of)","2024-09-01",0,0,0,0,0,0,0,0
"Venezuela (Bolivarian Republic of)","2024-09-02",0,0,0,0,0,0,0,0
"Venezuela (Bolivarian Republic of)","2024-09-03",0,0,0,0,0,0,0,0
"Venezuela (Bolivarian Republic of)","2024-09-04",0,0,0,0,0,0,0,0
"Venezuela (Bolivarian Republic of)","2024-09-05",0,0,0,0,0,0,0,0
"Venezuela (Bolivarian Republic of)","2024-09-06",0,0,0,0,0,0,0,0
"Venezuela (Bolivarian Republic of)","2024-09-07",0,0,0,0,0,0,0,0
"Venezuela (Bolivarian Republic of)","2024-09-08",0,0,0,0,0,0,0,0
"Venezuela (Bolivarian Republic of)","2024-09-09",0,0,0,0,0,0,0,0
"Venezuela (Bolivarian Republic of)","2024-09-10",0,0,0,0,0,0,0,0
"Venezuela (Bolivarian Republic of)","2024-09-11",0,0,0,0,0,0,0,0
"Venezuela (Bolivarian Republic of)","2024-09-12",0,0,0,0,0,0,0,0
"Venezuela (Bolivarian Republic of)","2024-09-13",0,0,0,0,0,0,0,0
"Venezuela (Bolivarian Republic of)","2024-09-14",0,0,0,0,0,0,0,0
"Venezuela (Bolivarian Republic of)","2024-09-15",0,0,0,0,0,0,0,0
"Venezuela (Bolivarian Republic of)","2024-09-16",0,0,0,0,0,0,0,0
"Venezuela (Bolivarian Republic of)","2024-09-17",0,0,0,0,0,0,0,0
"Venezuela (Bolivarian Republic of)","2024-09-18",0,0,0,0,0,0,0,0
"Venezuela (Bolivarian Republic of)","2024-09-19",0,0,0,0,0,0,0,0
"Venezuela (Bolivarian Republic of)","2024-09-20",0,0,0,0,0,0,0,0
"Venezuela (Bolivarian Republic of)","2024-09-21",0,0,0,0,0,0,0,0
"Venezuela (Bolivarian Republic of)","2024-09-22",0,0,0,0,0,0,0,0
"Venezuela (Bolivarian Republic of)","2024-09-23",0,0,0,0,0,0,0,0
"Venezuela (Bolivarian Republic of)","2024-09-24",0,0,0,0,0,0,0,0
"Venezuela (Bolivarian Republic of)","2024-09-25",0,0,0,0,0,0,0,0
"Venezuela (Bolivarian Republic of)","2024-09-26",0,0,0,0,0,0,0,0
"Venezuela (Bolivarian Republic of)","2024-09-27",0,0,0,0,0,0,0,0
"Venezuela (Bolivarian Republic of)","2024-09-28",0,0,0,0,0,0,0,0
"Venezuela (Bolivarian Republic of)","2024-09-29",0,0,0,0,0,0,0,0
"Venezuela (Bolivarian Republic of)","2024-09-30",0,0,0,0,0,0,0,0
"Venezuela (Bolivarian Republic of)","2024-10-01",0,0,0,0,0,0,0,0
"Venezuela (Bolivarian Republic of)","2024-10-02",0,0,0,0,0,0,0,0
"Venezuela (Bolivarian Republic of)","2024-10-03",0,0,0,0,0,0,0,0
"Venezuela (Bolivarian Republic of)","2024-10-04",0,0,0,0,0,0,0,0
"Venezuela (Bolivarian Republic of)","2024-10-05",0,0,0,0,0,0,0,0
"Venezuela (Bolivarian Republic of)","2024-10-06",0,0,0,0,0,0,0,0
"Venezuela (Bolivarian Republic of)","2024-10-07",0,0,0,0,0,0,0,0
"Venezuela (Bolivarian Republic of)","2024-10-08",0,0,0,0,0,0,0,0
"Venezuela (Bolivarian Republic of)","2024-10-09",0,0,0,0,0,0,0,0
"Venezuela (Bolivarian Republic of)","2024-10-10",0,0,0,0,0,0,0,0
"Venezuela (Bolivarian Republic of)","2024-10-11",0,0,0,0,0,0,0,0
"Venezuela (Bolivarian Republic of)","2024-10-12",0,0,0,0,0,0,0,0
"Venezuela (Bolivarian Republic of)","2024-10-13",0,0,0,0,0,0,0,0
"Venezuela (Bolivarian Republic of)","2024-10-14",0,0,0,0,0,0,0,0
"Venezuela (Bolivarian Republic of)","2024-10-15",0,0,0,0,0,0,0,0
"Venezuela (Bolivarian Republic of)","2024-10-16",0,0,0,0,0,0,0,0
"Venezuela (Bolivarian Republic of)","2024-10-17",0,0,0,0,0,0,0,0
"Venezuela (Bolivarian Republic of)","2024-10-18",0,0,0,0,0,0,0,0
"Venezuela (Bolivarian Republic of)","2024-10-19",0,0,0,0,0,0,0,0
"Venezuela (Bolivarian Republic of)","2024-10-20",0,0,0,0,0,0,0,0
"Venezuela (Bolivarian Republic of)","2024-10-21",0,0,0,0,0,0,0,0
"Venezuela (Bolivarian Republic of)","2024-10-22",0,0,0,0,0,0,0,0
"Venezuela (Bolivarian Republic of)","2024-10-23",0,0,0,0,0,0,0,0
"Venezuela (Bolivarian Republic of)","2024-10-24",0,0,0,0,0,0,0,0
"Venezuela (Bolivarian Republic of)","2024-10-25",0,0,0,0,0,0,0,0
"Venezuela (Bolivarian Republic of)","2024-10-26",0,0,0,0,0,0,0,0
"Venezuela (Bolivarian Republic of)","2024-10-27",0,0,0,0,0,0,0,0
"Venezuela (Bolivarian Republic of)","2024-10-28",0,0,0,0,0,0,0,0
"Venezuela (Bolivarian Republic of)","2024-10-29",0,0,0,0,0,0,0,0
"Venezuela (Bolivarian Republic of)","2024-10-30",0,0,0,0,0,0,0,0
"Venezuela (Bolivarian Republic of)","2024-10-31",0,0,0,0,0,0,0,0
"Venezuela (Bolivarian Republic of)","2024-11-01",0,0,0,0,0,0,0,0
"Venezuela (Bolivarian Republic of)","2024-11-02",0,0,0,0,0,0,0,0
"Venezuela (Bolivarian Republic of)","2024-11-03",0,0,0,0,0,0,0,0
"Venezuela (Bolivarian Republic of)","2024-11-04",0,0,0,0,0,0,0,0
"Venezuela (Bolivarian Republic of)","2024-11-05",0,0,0,0,0,0,0,0
"Venezuela (Bolivarian Republic of)","2024-11-06",0,0,0,0,0,0,0,0
"Venezuela (Bolivarian Republic of)","2024-11-07",0,0,0,0,0,0,0,0
"Venezuela (Bolivarian Republic of)","2024-11-08",0,0,0,0,0,0,0,0
"Venezuela (Bolivarian Republic of)","2024-11-09",0,0,0,0,0,0,0,0
"Venezuela (Bolivarian Republic of)","2024-11-10",0,0,0,0,0,0,0,0
"Venezuela (Bolivarian Republic of)","2024-11-11",0,0,0,0,0,0,0,0
"Venezuela (Bolivarian Republic of)","2024-11-12",0,0,0,0,0,0,0,0
"Venezuela (Bolivarian Republic of)","2024-11-13",0,0,0,0,0,0,0,0
"Venezuela (Bolivarian Republic of)","2024-11-14",0,0,0,0,0,0,0,0
"Venezuela (Bolivarian Republic of)","2024-11-15",0,0,0,0,0,0,0,0
"Venezuela (Bolivarian Republic of)","2024-11-16",0,0,0,0,0,0,0,0
"Venezuela (Bolivarian Republic of)","2024-11-17",0,0,0,0,0,0,0,0
"Venezuela (Bolivarian Republic of)","2024-11-18",0,0,0,0,0,0,0,0
"Venezuela (Bolivarian Republic of)","2024-11-19",0,0,0,0,0,0,0,0
"Venezuela (Bolivarian Republic of)","2024-11-20",0,0,0,0,0,0,0,0
"Venezuela (Bolivarian Republic of)","2024-11-21",0,0,0,0,0,0,0,0
"Venezuela (Bolivarian Republic of)","2024-11-22",0,0,0,0,0,0,0,0
"Venezuela (Bolivarian Republic of)","2024-11-23",0,0,0,0,0,0,0,0
"Venezuela (Bolivarian Republic of)","2024-11-24",0,0,0,0,0,0,0,0
"Venezuela (Bolivarian Republic of)","2024-11-25",0,0,0,0,0,0,0,0
"Venezuela (Bolivarian Republic of)","2024-11-26",0,0,0,0,0,0,0,0
"Venezuela (Bolivarian Republic of)","2024-11-27",0,0,0,0,0,0,0,0
"Venezuela (Bolivarian Republic of)","2024-11-28",0,0,0,0,0,0,0,0
"Venezuela (Bolivarian Republic of)","2024-11-29",0,0,0,0,0,0,0,0
"Venezuela (Bolivarian Republic of)","2024-11-30",0,0,0,0,0,0,0,0
"Venezuela (Bolivarian Republic of)","2024-12-01",0,0,0,0,0,0,0,0
"Venezuela (Bolivarian Republic of)","2024-12-02",0,0,0,0,0,0,0,0
"Venezuela (Bolivarian Republic of)","2024-12-03",0,0,0,0,0,0,0,0
"Venezuela (Bolivarian Republic of)","2024-12-04",0,0,0,0,0,0,0,0
"Venezuela (Bolivarian Republic of)","2024-12-05",0,0,0,0,0,0,0,0
"Venezuela (Bolivarian Republic of)","2024-12-06",0,0,0,0,0,0,0,0
"Venezuela (Bolivarian Republic of)","2024-12-07",0,0,0,0,0,0,0,0
"Venezuela (Bolivarian Republic of)","2024-12-08",0,0,0,0,0,0,0,0
"Venezuela (Bolivarian Republic of)","2024-12-09",0,0,0,0,0,0,0,0
"Venezuela (Bolivarian Republic of)","2024-12-10",0,0,0,0,0,0,0,0
"Venezuela (Bolivarian Republic of)","2024-12-11",0,0,0,0,0,0,0,0
"Venezuela (Bolivarian Republic of)","2024-12-12",0,0,0,0,0,0,0,0
"Venezuela (Bolivarian Republic of)","2024-12-13",0,0,0,0,0,0,0,0
"Venezuela (Bolivarian Republic of)","2024-12-14",0,0,0,0,0,0,0,0
"Venezuela (Bolivarian Republic of)","2024-12-15",0,0,0,0,0,0,0,0
"Venezuela (Bolivarian Republic of)","2024-12-16",0,0,0,0,0,0,0,0
"Venezuela (Bolivarian Republic of)","2024-12-17",0,0,0,0,0,0,0,0
"Venezuela (Bolivarian Republic of)","2024-12-18",0,0,0,0,0,0,0,0
"Venezuela (Bolivarian Republic of)","2024-12-19",0,0,0,0,0,0,0,0
"Venezuela (Bolivarian Republic of)","2024-12-20",0,0,0,0,0,0,0,0
"Venezuela (Bolivarian Republic of)","2024-12-21",0,0,0,0,0,0,0,0
"Venezuela (Bolivarian Republic of)","2024-12-22",0,0,0,0,0,0,0,0
"Venezuela (Bolivarian Republic of)","2024-12-23",0,0,0,0,0,0,0,0
"Venezuela (Bolivarian Republic of)","2024-12-24",0,0,0,0,0,0,0,0
"Venezuela (Bolivarian Republic of)","2024-12-25",0,0,0,0,0,0,0,0
"Venezuela (Bolivarian Republic of)","2024-12-26",0,0,0,0,0,0,0,0
"Venezuela (Bolivarian Republic of)","2024-12-27",0,0,0,0,0,0,0,0
"Venezuela (Bolivarian Republic of)","2024-12-28",0,0,0,0,0,0,0,0
"Venezuela (Bolivarian Republic of)","2024-12-29",0,0,0,0,0,0,0,0
"Venezuela (Bolivarian Republic of)","2024-12-30",0,0,0,0,0,0,0,0
"Venezuela (Bolivarian Republic of)","2024-12-31",0,0,0,0,0,0,0,0
"Venezuela (Bolivarian Republic of)","2025-01-01",0,0,0,0,0,0,0,0
"Venezuela (Bolivarian Republic of)","2025-01-02",0,0,0,0,0,0,0,0
"Venezuela (Bolivarian Republic of)","2025-01-03",0,0,0,0,0,0,0,0
"Venezuela (Bolivarian Republic of)","2025-01-04",0,0,0,0,0,0,0,0
"Venezuela (Bolivarian Republic of)","2025-01-05",0,0,0,0,0,0,0,0
"Venezuela (Bolivarian Republic of)","2025-01-06",0,0,0,0,0,0,0,0
"Venezuela (Bolivarian Republic of)","2025-01-07",0,0,0,0,0,0,0,0
"Venezuela (Bolivarian Republic of)","2025-01-08",0,0,0,0,0,0,0,0
"Venezuela (Bolivarian Republic of)","2025-01-09",0,0,0,0,0,0,0,0
"Venezuela (Bolivarian Republic of)","2025-01-10",0,0,0,0,0,0,0,0
"Venezuela (Bolivarian Republic of)","2025-01-11",0,0,0,0,0,0,0,0
"Venezuela (Bolivarian Republic of)","2025-01-12",0,0,0,0,0,0,0,0
"Venezuela (Bolivarian Republic of)","2025-01-13",0,0,0,0,0,0,0,0
"Viet Nam","2024-01-01",0,0,0,0,0,0,0,0
"Viet Nam","2024-01-02",0,0,0,0,0,0,0,0
"Viet Nam","2024-01-03",0,0,0,0,0,0,0,0
"Viet Nam","2024-01-04",0,0,0,0,0,0,0,0
"Viet Nam","2024-01-05",0,0,0,0,0,0,0,0
"Viet Nam","2024-01-06",0,0,0,0,0,0,0,0
"Viet Nam","2024-01-07",0,0,0,0,0,0,0,0
"Viet Nam","2024-01-08",0,0,0,0,0,0,0,0
"Viet Nam","2024-01-09",0,0,0,0,0,0,0,0
"Viet Nam","2024-01-10",0,14,14,0,14,14,0,0
"Viet Nam","2024-01-11",0,0,14,0,0,14,0,0
"Viet Nam","2024-01-12",0,0,14,0,0,14,0,0
"Viet Nam","2024-01-13",0,0,14,0,1,15,0,0
"Viet Nam","2024-01-14",0,0,14,0,0,15,0,0
"Viet Nam","2024-01-15",0,0,14,0,0,15,0,0
"Viet Nam","2024-01-16",0,0,14,0,0,15,0,0
"Viet Nam","2024-01-17",0,0,14,0,0,15,0,0
"Viet Nam","2024-01-18",0,0,14,0,1,16,0,0
"Viet Nam","2024-01-19",0,0,14,0,0,16,0,0
"Viet Nam","2024-01-20",0,2,16,0,0,16,0,0
"Viet Nam","2024-01-21",0,0,16,0,1,17,0,0
"Viet Nam","2024-01-22",0,0,16,0,1,18,0,0
"Viet Nam","2024-01-23",0,0,16,0,2,20,0,0
"Viet Nam","2024-01-24",0,5,21,0,1,21,0,0
"Viet Nam","2024-01-25",0,0,21,0,0,21,0,0
"Viet Nam","2024-01-26",0,0,21,0,1,22,0,0
"Viet Nam","2024-01-27",0,0,21,0,0,22,0,0
"Viet Nam","2024-01-28",0,0,21,0,0,22,0,0
"Viet Nam","2024-01-29",0,0,21,0,1,23,0,0
"Viet Nam","2024-01-30",0,0,21,0,0,23,0,0
"Viet Nam","2024-01-31",0,0,21,0,0,23,0,0
"Viet Nam","2024-02-01",0,0,21,0,0,23,0,0
"Viet Nam","2024-02-02",0,0,21,0,1,24,0,0
"Viet Nam","2024-02-03",0,0,21,0,0,24,0,0
"Viet Nam","2024-02-04",0,0,21,0,0,24,0,0
"Viet Nam","2024-02-05",0,0,21,0,1,25,0,0
"Viet Nam","2024-02-06",0,0,21,0,0,25,0,0
"Viet Nam","2024-02-07",0,0,21,0,0,25,0,0
"Viet Nam","2024-02-08",0,0,21,0,1,26,0,0
"Viet Nam","2024-02-09",0,5,26,0,0,26,0,0
"Viet Nam","2024-02-10",0,0,26,0,0,26,0,0
"Viet Nam","2024-02-11",0,0,26,0,1,27,0,0
"Viet Nam","2024-02-12",0,0,26,0,0,27,0,0
"Viet Nam","2024-02-13",0,0,26,0,1,28,0,0
"Viet Nam","2024-02-14",0,0,26,0,0,28,0,0
"Viet Nam","2024-02-15",0,0,26,0,0,28,0,0
"Viet Nam","2024-02-16",0,0,26,0,1,29,0,0
"Viet Nam","2024-02-17",0,0,26,0,0,29,0,0
"Viet Nam","2024-02-18",0,0,26,0,0,29,0,0
"Viet Nam","2024-02-19",0,0,26,0,1,30,0,0
"Viet Nam","2024-02-20",0,0,26,0,0,30,0,0
"Viet Nam","2024-02-21",0,0,26,0,1,31,0,0
"Viet Nam","2024-02-22",0,0,26,0,0,31,0,0
"Viet Nam","2024-02-23",0,0,26,0,0,31,0,0
"Viet Nam","2024-02-24",0,0,26,0,1,32,0,0
"Viet Nam","2024-02-25",0,0,26,0,0,32,0,0
"Viet Nam","2024-02-26",0,0,26,0,1,33,0,0
"Viet Nam","2024-02-27",0,0,26,0,0,33,0,0
"Viet Nam","2024-02-28",0,0,26,0,0,33,0,0
"Viet Nam","2024-02-29",0,0,26,0,1,34,0,0
"Viet Nam","2024-03-01",0,0,26,0,0,34,0,0
"Viet Nam","2024-03-02",0,0,26,0,0,34,0,0
"Viet Nam","2024-03-03",0,0,26,0,1,35,0,0
"Viet Nam","2024-03-04",0,0,26,0,0,35,0,0
"Viet Nam","2024-03-05",0,0,26,0,1,36,0,0
"Viet Nam","2024-03-06",0,10,36,0,0,36,0,0
"Viet Nam","2024-03-07",0,0,36,0,1,37,0,0
"Viet Nam","2024-03-08",0,0,36,0,0,37,0,0
"Viet Nam","2024-03-09",0,0,36,0,1,38,0,0
"Viet Nam","2024-03-10",0,0,36,0,0,38,0,0
"Viet Nam","2024-03-11",0,0,36,0,1,39,0,0
"Viet Nam","2024-03-12",0,0,36,0,1,40,0,0
"Viet Nam","2024-03-13",0,0,36,0,0,40,0,0
"Viet Nam","2024-03-14",0,0,36,0,1,41,0,0
"Viet Nam","2024-03-15",0,0,36,0,0,41,0,0
"Viet Nam","2024-03-16",0,0,36,0,1,42,0,0
"Viet Nam","2024-03-17",0,0,36,0,1,43,0,0
"Viet Nam","2024-03-18",0,0,36,0,0,43,0,0
"Viet Nam","2024-03-19",0,0,36,0,1,44,0,0
"Viet Nam","2024-03-20",0,0,36,0,0,44,0,0
"Viet Nam","2024-03-21",0,0,36,0,1,45,0,0
"Viet Nam","2024-03-22",0,0,36,0,1,46,0,0
"Viet Nam","2024-03-23",0,0,36,0,0,46,0,0
"Viet Nam","2024-03-24",0,0,36,0,1,47,0,0
"Viet Nam","2024-03-25",0,0,36,0,0,47,0,0
"Viet Nam","2024-03-26",0,12,48,0,1,48,0,0
"Viet Nam","2024-03-27",0,0,48,0,1,49,0,0
"Viet Nam","2024-03-28",0,0,48,0,0,49,0,0
"Viet Nam","2024-03-29",0,0,48,0,1,50,0,0
"Viet Nam","2024-03-30",0,0,48,0,0,50,0,0
"Viet Nam","2024-03-31",0,0,48,0,1,51,0,0
"Viet Nam","2024-04-01",0,0,48,0,0,51,0,0
"Viet Nam","2024-04-02",0,0,48,0,1,52,0,0
"Viet Nam","2024-04-03",0,0,48,0,0,52,0,0
"Viet Nam","2024-04-04",0,0,48,0,1,53,0,0
"Viet Nam","2024-04-05",0,0,48,0,0,53,0,0
"Viet Nam","2024-04-06",0,0,48,0,1,54,0,0
"Viet Nam","2024-04-07",0,0,48,0,0,54,0,0
"Viet Nam","2024-04-08",0,0,48,0,1,55,0,0
"Viet Nam","2024-04-09",0,0,48,0,0,55,0,0
"Viet Nam","2024-04-10",0,0,48,0,1,56,0,0
"Viet Nam","2024-04-11",0,0,48,0,1,57,0,0
"Viet Nam","2024-04-12",0,0,48,0,0,57,0,0
"Viet Nam","2024-04-13",0,0,48,0,1,58,0,0
"Viet Nam","2024-04-14",0,0,48,0,0,58,0,0
"Viet Nam","2024-04-15",0,0,48,0,1,59,0,0
"Viet Nam","2024-04-16",0,0,48,0,0,59,0,0
"Viet Nam","2024-04-17",0,0,48,0,1,60,0,0
"Viet Nam","2024-04-18",0,0,48,0,0,60,0,0
"Viet Nam","2024-04-19",0,0,48,0,1,61,0,0
"Viet Nam","2024-04-20",0,0,48,0,0,61,0,0
"Viet Nam","2024-04-21",0,0,48,0,1,62,0,0
"Viet Nam","2024-04-22",0,0,48,0,0,62,0,0
"Viet Nam","2024-04-23",0,0,48,0,1,63,0,0
"Viet Nam","2024-04-24",0,0,48,0,0,63,0,0
"Viet Nam","2024-04-25",0,0,48,0,1,64,0,0
"Viet Nam","2024-04-26",0,0,48,0,1,65,0,0
"Viet Nam","2024-04-27",0,0,48,0,0,65,0,0
"Viet Nam","2024-04-28",0,0,48,0,1,66,0,0
"Viet Nam","2024-04-29",0,0,48,0,0,66,0,0
"Viet Nam","2024-04-30",0,0,48,0,1,67,0,0
"Viet Nam","2024-05-01",0,0,48,0,0,67,0,0
"Viet Nam","2024-05-02",0,0,48,0,1,68,0,0
"Viet Nam","2024-05-03",0,0,48,0,0,68,0,0
"Viet Nam","2024-05-04",0,0,48,0,1,69,0,0
"Viet Nam","2024-05-05",0,0,48,0,0,69,0,0
"Viet Nam","2024-05-06",0,0,48,0,1,70,0,0
"Viet Nam","2024-05-07",0,0,48,0,0,70,0,0
"Viet Nam","2024-05-08",0,0,48,0,1,71,0,0
"Viet Nam","2024-05-09",0,0,48,0,0,71,0,0
"Viet Nam","2024-05-10",0,24,72,0,1,72,0,0
"Viet Nam","2024-05-11",0,0,72,0,0,72,0,0
"Viet Nam","2024-05-12",0,0,72,0,0,72,0,0
"Viet Nam","2024-05-13",0,0,72,0,0,72,0,0
"Viet Nam","2024-05-14",0,0,72,0,1,73,0,0
"Viet Nam","2024-05-15",0,0,72,0,0,73,0,0
"Viet Nam","2024-05-16",0,0,72,0,0,73,0,0
"Viet Nam","2024-05-17",0,0,72,0,0,73,0,0
"Viet Nam","2024-05-18",0,0,72,0,0,73,0,0
"Viet Nam","2024-05-19",0,0,72,0,0,73,0,0
"Viet Nam","2024-05-20",0,0,72,0,0,73,0,0
"Viet Nam","2024-05-21",0,0,72,0,1,74,0,0
"Viet Nam","2024-05-22",0,0,72,0,0,74,0,0
"Viet Nam","2024-05-23",0,0,72,0,0,74,0,0
"Viet Nam","2024-05-24",0,0,72,0,0,74,0,0
"Viet Nam","2024-05-25",0,0,72,0,0,74,0,0
"Viet Nam","2024-05-26",0,0,72,0,0,74,0,0
"Viet Nam","2024-05-27",0,0,72,0,0,74,0,0
"Viet Nam","2024-05-28",0,0,72,0,1,75,0,0
"Viet Nam","2024-05-29",0,0,72,0,0,75,0,0
"Viet Nam","2024-05-30",0,0,72,0,0,75,0,0
"Viet Nam","2024-05-31",0,3,75,0,0,75,0,0
"Viet Nam","2024-06-01",0,0,75,0,0,75,0,0
"Viet Nam","2024-06-02",0,0,75,0,0,75,0,0
"Viet Nam","2024-06-03",0,0,75,0,1,76,0,0
"Viet Nam","2024-06-04",0,0,75,0,0,76,0,0
"Viet Nam","2024-06-05",0,0,75,0,0,76,0,0
"Viet Nam","2024-06-06",0,0,75,0,0,76,0,0
"Viet Nam","2024-06-07",0,0,75,0,1,77,0,0
"Viet Nam","2024-06-08",0,0,75,0,0,77,0,0
"Viet Nam","2024-06-09",0,0,75,0,0,77,0,0
"Viet Nam","2024-06-10",0,0,75,0,0,77,0,0
"Viet Nam","2024-06-11",0,0,75,0,0,77,0,0
"Viet Nam","2024-06-12",0,0,75,0,1,78,0,0
"Viet Nam","2024-06-13",0,0,75,0,0,78,0,0
"Viet Nam","2024-06-14",0,0,75,0,0,78,0,0
"Viet Nam","2024-06-15",0,0,75,0,0,78,0,0
"Viet Nam","2024-06-16",0,0,75,0,0,78,0,0
"Viet Nam","2024-06-17",0,0,75,0,1,79,0,0
"Viet Nam","2024-06-18",0,0,75,0,0,79,0,0
"Viet Nam","2024-06-19",0,0,75,0,0,79,0,0
"Viet Nam","2024-06-20",0,0,75,0,0,79,0,0
"Viet Nam","2024-06-21",0,0,75,0,0,79,0,0
"Viet Nam","2024-06-22",0,0,75,0,1,80,0,0
"Viet Nam","2024-06-23",0,0,75,0,0,80,0,0
"Viet Nam","2024-06-24",0,0,75,0,0,80,0,0
"Viet Nam","2024-06-25",0,0,75,0,0,80,0,0
"Viet Nam","2024-06-26",0,0,75,0,1,81,0,0
"Viet Nam","2024-06-27",0,0,75,0,0,81,0,0
"Viet Nam","2024-06-28",0,6,81,0,0,81,0,0
"Viet Nam","2024-06-29",0,0,81,0,0,81,0,0
"Viet Nam","2024-06-30",0,0,81,0,0,81,0,0
"Viet Nam","2024-07-01",0,0,81,0,0,81,0,0
"Viet Nam","2024-07-02",0,0,81,0,0,81,0,0
"Viet Nam","2024-07-03",0,0,81,0,0,81,0,0
"Viet Nam","2024-07-04",0,0,81,0,0,81,0,0
"Viet Nam","2024-07-05",0,0,81,0,0,81,0,0
"Viet Nam","2024-07-06",0,0,81,0,0,81,0,0
"Viet Nam","2024-07-07",0,0,81,0,0,81,0,0
"Viet Nam","2024-07-08",0,0,81,0,1,82,0,0
"Viet Nam","2024-07-09",0,0,81,0,0,82,0,0
"Viet Nam","2024-07-10",0,0,81,0,0,82,0,0
"Viet Nam","2024-07-11",0,0,81,0,0,82,0,0
"Viet Nam","2024-07-12",0,0,81,0,0,82,0,0
"Viet Nam","2024-07-13",0,0,81,0,0,82,0,0
"Viet Nam","2024-07-14",0,0,81,0,0,82,0,0
"Viet Nam","2024-07-15",0,0,81,0,0,82,0,0
"Viet Nam","2024-07-16",0,1,82,0,0,82,0,0
"Viet Nam","2024-07-17",0,0,82,0,0,82,0,0
"Viet Nam","2024-07-18",0,0,82,0,0,82,0,0
"Viet Nam","2024-07-19",0,0,82,0,0,82,0,0
"Viet Nam","2024-07-20",0,0,82,0,0,82,0,0
"Viet Nam","2024-07-21",0,0,82,0,0,82,0,0
"Viet Nam","2024-07-22",0,0,82,0,0,82,0,0
"Viet Nam","2024-07-23",0,0,82,0,0,82,0,0
"Viet Nam","2024-07-24",0,0,82,0,0,82,0,0
"Viet Nam","2024-07-25",0,0,82,0,0,82,0,0
"Viet Nam","2024-07-26",0,0,82,0,0,82,0,0
"Viet Nam","2024-07-27",0,0,82,0,0,82,0,0
"Viet Nam","2024-07-28",0,0,82,0,0,82,0,0
"Viet Nam","2024-07-29",0,0,82,0,0,82,0,0
"Viet Nam","2024-07-30",0,0,82,0,0,82,0,0
"Viet Nam","2024-07-31",0,0,82,0,0,82,0,0
"Viet Nam","2024-08-01",0,0,82,0,0,82,0,0
"Viet Nam","2024-08-02",0,0,82,0,0,82,0,0
"Viet Nam","2024-08-03",0,0,82,0,0,82,0,0
"Viet Nam","2024-08-04",0,0,82,0,0,82,0,0
"Viet Nam","2024-08-05",0,0,82,0,0,82,0,0
"Viet Nam","2024-08-06",0,0,82,0,0,82,0,0
"Viet Nam","2024-08-07",0,0,82,0,0,82,0,0
"Viet Nam","2024-08-08",0,0,82,0,0,82,0,0
"Viet Nam","2024-08-09",0,0,82,0,0,82,0,0
"Viet Nam","2024-08-10",0,0,82,0,0,82,0,0
"Viet Nam","2024-08-11",0,0,82,0,0,82,0,0
"Viet Nam","2024-08-12",0,0,82,0,0,82,0,0
"Viet Nam","2024-08-13",0,0,82,0,1,83,0,0
"Viet Nam","2024-08-14",0,0,82,0,0,83,0,0
"Viet Nam","2024-08-15",0,0,82,0,0,83,0,0
"Viet Nam","2024-08-16",0,0,82,0,0,83,0,0
"Viet Nam","2024-08-17",0,0,82,0,0,83,0,0
"Viet Nam","2024-08-18",0,0,82,0,0,83,0,0
"Viet Nam","2024-08-19",0,0,82,0,0,83,0,0
"Viet Nam","2024-08-20",0,0,82,0,0,83,0,0
"Viet Nam","2024-08-21",0,0,82,0,0,83,0,0
"Viet Nam","2024-08-22",0,0,82,0,0,83,0,0
"Viet Nam","2024-08-23",0,0,82,0,0,83,0,0
"Viet Nam","2024-08-24",0,0,82,0,0,83,0,0
"Viet Nam","2024-08-25",0,0,82,0,0,83,0,0
"Viet Nam","2024-08-26",0,0,82,0,0,83,0,0
"Viet Nam","2024-08-27",0,0,82,0,0,83,0,0
"Viet Nam","2024-08-28",0,0,82,0,0,83,0,0
"Viet Nam","2024-08-29",0,0,82,0,0,83,0,0
"Viet Nam","2024-08-30",0,0,82,0,0,83,0,0
"Viet Nam","2024-08-31",0,0,82,0,0,83,0,0
"Viet Nam","2024-09-01",0,0,82,0,0,83,0,0
"Viet Nam","2024-09-02",0,0,82,0,0,83,0,0
"Viet Nam","2024-09-03",0,0,82,0,0,83,0,0
"Viet Nam","2024-09-04",0,0,82,0,0,83,0,0
"Viet Nam","2024-09-05",0,0,82,0,0,83,0,0
"Viet Nam","2024-09-06",0,0,82,0,0,83,0,0
"Viet Nam","2024-09-07",0,0,82,0,0,83,0,0
"Viet Nam","2024-09-08",0,0,82,0,0,83,0,0
"Viet Nam","2024-09-09",0,0,82,0,0,83,0,0
"Viet Nam","2024-09-10",0,0,82,0,0,83,0,0
"Viet Nam","2024-09-11",0,0,82,0,0,83,0,0
"Viet Nam","2024-09-12",0,0,82,0,0,83,0,0
"Viet Nam","2024-09-13",0,0,82,0,0,83,0,0
"Viet Nam","2024-09-14",0,0,82,0,0,83,0,0
"Viet Nam","2024-09-15",0,0,82,0,0,83,0,0
"Viet Nam","2024-09-16",0,0,82,0,0,83,0,0
"Viet Nam","2024-09-17",0,0,82,0,0,83,0,0
"Viet Nam","2024-09-18",0,0,82,0,0,83,0,0
"Viet Nam","2024-09-19",0,0,82,0,0,83,0,0
"Viet Nam","2024-09-20",0,0,82,0,0,83,0,0
"Viet Nam","2024-09-21",0,0,82,0,0,83,0,0
"Viet Nam","2024-09-22",0,0,82,0,0,83,0,0
"Viet Nam","2024-09-23",0,0,82,0,0,83,0,0
"Viet Nam","2024-09-24",0,0,82,0,0,83,0,0
"Viet Nam","2024-09-25",0,0,82,0,0,83,0,0
"Viet Nam","2024-09-26",0,0,82,0,0,83,0,0
"Viet Nam","2024-09-27",0,0,82,0,0,83,0,0
"Viet Nam","2024-09-28",0,0,82,0,0,83,0,0
"Viet Nam","2024-09-29",0,0,82,0,0,83,0,0
"Viet Nam","2024-09-30",0,0,82,0,0,83,0,0
"Viet Nam","2024-10-01",0,0,82,0,0,83,0,0
"Viet Nam","2024-10-02",0,0,82,0,0,83,0,0
"Viet Nam","2024-10-03",0,0,82,0,0,83,0,0
"Viet Nam","2024-10-04",0,0,82,0,0,83,0,0
"Viet Nam","2024-10-05",0,0,82,0,1,84,0,0
"Viet Nam","2024-10-06",0,0,82,0,0,84,0,0
"Viet Nam","2024-10-07",0,0,82,0,0,84,0,0
"Viet Nam","2024-10-08",0,0,82,0,0,84,0,0
"Viet Nam","2024-10-09",0,0,82,0,0,84,0,0
"Viet Nam","2024-10-10",0,0,82,0,0,84,0,0
"Viet Nam","2024-10-11",0,0,82,0,0,84,0,0
"Viet Nam","2024-10-12",0,0,82,0,0,84,0,0
"Viet Nam","2024-10-13",0,0,82,0,0,84,0,0
"Viet Nam","2024-10-14",0,0,82,0,0,84,0,0
"Viet Nam","2024-10-15",0,0,82,0,0,84,0,0
"Viet Nam","2024-10-16",0,0,82,0,0,84,0,0
"Viet Nam","2024-10-17",0,0,82,0,0,84,0,0
"Viet Nam","2024-10-18",0,0,82,0,0,84,0,0
"Viet Nam","2024-10-19",0,0,82,0,0,84,0,0
"Viet Nam","2024-10-20",0,0,82,0,0,84,0,0
"Viet Nam","2024-10-21",0,0,82,0,0,84,0,0
"Viet Nam","2024-10-22",0,0,82,0,0,84,0,0
"Viet Nam","2024-10-23",0,0,82,0,0,84,0,0
"Viet Nam","2024-10-24",0,0,82,0,0,84,0,0
"Viet Nam","2024-10-25",0,0,82,0,0,84,0,0
"Viet Nam","2024-10-26",0,0,82,0,0,84,0,0
"Viet Nam","2024-10-27",0,0,82,0,0,84,0,0
"Viet Nam","2024-10-28",0,0,82,0,0,84,0,0
"Viet Nam","2024-10-29",0,0,82,0,0,84,0,0
"Viet Nam","2024-10-30",0,0,82,0,0,84,0,0
"Viet Nam","2024-10-31",0,0,82,0,0,84,0,0
"Viet Nam","2024-11-01",0,2,84,0,0,84,0,0
"Viet Nam","2024-11-02",0,0,84,0,0,84,0,0
"Viet Nam","2024-11-03",0,0,84,0,0,84,0,0
"Viet Nam","2024-11-04",0,0,84,0,0,84,0,0
"Viet Nam","2024-11-05",0,0,84,0,1,85,0,0
"Viet Nam","2024-11-06",0,0,84,0,0,85,0,0
"Viet Nam","2024-11-07",0,0,84,0,0,85,0,0
"Viet Nam","2024-11-08",0,0,84,0,0,85,0,0
"Viet Nam","2024-11-09",0,0,84,0,0,85,0,0
"Viet Nam","2024-11-10",0,0,84,0,0,85,0,0
"Viet Nam","2024-11-11",0,0,84,0,1,86,0,0
"Viet Nam","2024-11-12",0,0,84,0,0,86,0,0
"Viet Nam","2024-11-13",0,0,84,0,0,86,0,0
"Viet Nam","2024-11-14",0,0,84,0,0,86,0,0
"Viet Nam","2024-11-15",0,0,84,0,0,86,0,0
"Viet Nam","2024-11-16",0,0,84,0,0,86,0,0
"Viet Nam","2024-11-17",0,0,84,0,1,87,0,0
"Viet Nam","2024-11-18",0,0,84,0,0,87,0,0
"Viet Nam","2024-11-19",0,0,84,0,0,87,0,0
"Viet Nam","2024-11-20",0,0,84,0,0,87,0,0
"Viet Nam","2024-11-21",0,0,84,0,0,87,0,0
"Viet Nam","2024-11-22",0,0,84,0,0,87,0,0
"Viet Nam","2024-11-23",0,0,84,0,1,88,0,0
"Viet Nam","2024-11-24",0,0,84,0,0,88,0,0
"Viet Nam","2024-11-25",0,0,84,0,0,88,0,0
"Viet Nam","2024-11-26",0,4,88,0,0,88,0,0
"Viet Nam","2024-11-27",0,0,88,0,0,88,0,0
"Viet Nam","2024-11-28",0,0,88,0,0,88,0,0
"Viet Nam","2024-11-29",0,0,88,0,0,88,0,0
"Viet Nam","2024-11-30",0,0,88,0,0,88,0,0
"Viet Nam","2024-12-01",0,0,88,0,0,88,0,0
"Viet Nam","2024-12-02",0,0,88,0,0,88,0,0
"Viet Nam","2024-12-03",0,0,88,0,0,88,0,0
"Viet Nam","2024-12-04",0,0,88,0,0,88,0,0
"Viet Nam","2024-12-05",0,0,88,0,0,88,0,0
"Viet Nam","2024-12-06",0,0,88,0,0,88,0,0
"Viet Nam","2024-12-07",0,0,88,0,0,88,0,0
"Viet Nam","2024-12-08",0,0,88,0,0,88,0,0
"Viet Nam","2024-12-09",0,0,88,0,0,88,0,0
"Viet Nam","2024-12-10",0,0,88,0,0,88,0,0
"Viet Nam","2024-12-11",0,0,88,0,0,88,0,0
"Viet Nam","2024-12-12",0,0,88,0,0,88,0,0
"Viet Nam","2024-12-13",0,0,88,0,0,88,0,0
"Viet Nam","2024-12-14",0,0,88,0,0,88,0,0
"Viet Nam","2024-12-15",0,0,88,0,0,88,0,0
"Viet Nam","2024-12-16",0,0,88,0,0,88,0,0
"Viet Nam","2024-12-17",0,0,88,0,0,88,0,0
"Viet Nam","2024-12-18",0,0,88,0,0,88,0,0
"Viet Nam","2024-12-19",0,0,88,0,0,88,0,0
"Viet Nam","2024-12-20",0,0,88,0,0,88,0,0
"Viet Nam","2024-12-21",0,0,88,0,0,88,0,0
"Viet Nam","2024-12-22",0,0,88,0,0,88,0,0
"Viet Nam","2024-12-23",0,0,88,0,0,88,0,0
"Viet Nam","2024-12-24",0,0,88,0,0,88,0,0
"Viet Nam","2024-12-25",0,0,88,0,0,88,0,0
"Viet Nam","2024-12-26",0,0,88,0,0,88,0,0
"Viet Nam","2024-12-27",0,0,88,0,0,88,0,0
"Viet Nam","2024-12-28",0,0,88,0,0,88,0,0
"Viet Nam","2024-12-29",0,0,88,0,0,88,0,0
"Viet Nam","2024-12-30",0,0,88,0,0,88,0,0
"Viet Nam","2024-12-31",0,0,88,0,0,88,0,0
"Viet Nam","2025-01-01",0,0,88,0,0,88,0,0
"Viet Nam","2025-01-02",0,0,88,0,0,88,0,0
"Viet Nam","2025-01-03",0,0,88,0,0,88,0,0
"Viet Nam","2025-01-04",0,0,88,0,0,88,0,0
"Viet Nam","2025-01-05",0,0,88,0,0,88,0,0
"Viet Nam","2025-01-06",0,0,88,0,0,88,0,0
"Viet Nam","2025-01-07",0,0,88,0,0,88,0,0
"Viet Nam","2025-01-08",0,0,88,0,0,88,0,0
"Viet Nam","2025-01-09",0,0,88,0,0,88,0,0
"Viet Nam","2025-01-10",0,0,88,0,0,88,0,0
"Viet Nam","2025-01-11",0,0,88,0,0,88,0,0
"Viet Nam","2025-01-12",0,0,88,0,0,88,0,0
"Viet Nam","2025-01-13",0,0,88,0,0,88,0,0
"World","2024-01-01",0,0,0,0,0,0,0,0
"World","2024-01-02",0,111,111,0,111,111,0,0
"World","2024-01-03",0,0,111,0,1,112,0,0
"World","2024-01-04",0,2,113,0,1,113,0,0
"World","2024-01-05",0,1,114,0,1,114,0,0
"World","2024-01-06",0,0,114,0,28,142,0,0
"World","2024-01-07",0,57,171,0,29,171,0,0
"World","2024-01-08",0,0,171,0,54,225,0,0
"World","2024-01-09",0,109,280,0,55,280,0,0
"World","2024-01-10",0,14,294,0,14,294,0,0
"World","2024-01-11",0,1,295,0,1,295,0,0
"World","2024-01-12",0,1,296,0,1,296,0,0
"World","2024-01-13",0,0,296,0,39,335,0,0
"World","2024-01-14",0,78,374,0,39,374,0,0
"World","2024-01-15",0,0,374,0,66,440,0,0
"World","2024-01-16",0,133,507,0,67,507,0,0
"World","2024-01-17",0,1,508,0,1,508,0,0
"World","2024-01-18",0,0,508,0,1,509,0,0
"World","2024-01-19",0,2,510,0,1,510,0,0
"World","2024-01-20",0,2,512,0,2,512,0,0
"World","2024-01-21",0,90,602,0,90,602,0,0
"World","2024-01-22",0,0,602,0,46,648,0,0
"World","2024-01-23",0,92,694,0,46,694,0,0
"World","2024-01-24",0,6,700,0,6,700,0,0
"World","2024-01-25",0,0,700,0,20,720,0,0
"World","2024-01-26",0,0,700,0,20,740,0,0
"World","2024-01-27",0,0,700,0,19,759,0,0
"World","2024-01-28",0,79,779,0,20,779,0,0
"World","2024-01-29",0,0,779,0,67,846,0,0
"World","2024-01-30",0,134,913,0,67,913,0,0
"World","2024-01-31",0,303,1216,0,303,1216,0,0
"World","2024-02-01",0,0,1216,0,2,1218,0,0
"World","2024-02-02",0,5,1221,0,3,1221,0,0
"World","2024-02-03",0,0,1221,0,32,1253,0,0
"World","2024-02-04",0,63,1284,0,31,1284,0,0
"World","2024-02-05",0,3,1287,0,3,1287,0,0
"World","2024-02-06",0,103,1390,0,103,1390,0,0
"World","2024-02-07",0,0,1390,0,2,1392,0,0
"World","2024-02-08",0,0,1390,0,1,1393,0,0
"World","2024-02-09",0,5,1395,0,2,1395,0,0
"World","2024-02-10",0,0,1395,0,32,1427,0,0
"World","2024-02-11",0,65,1460,0,33,1460,0,0
"World","2024-02-12",0,0,1460,0,52,1512,0,0
"World","2024-02-13",0,103,1563,0,51,1563,0,0
"World","2024-02-14",0,0,1563,0,0,1563,0,0
"World","2024-02-15",0,1,1564,0,1,1564,0,0
"World","2024-02-16",0,1,1565,0,1,1565,0,0
"World","2024-02-17",0,0,1565,0,38,1603,0,0
"World","2024-02-18",0,76,1641,0,38,1641,0,0
"World","2024-02-19",0,0,1641,0,56,1697,0,0
"World","2024-02-20",0,111,1752,0,55,1752,0,0
"World","2024-02-21",0,0,1752,0,3,1755,0,0
"World","2024-02-22",0,0,1752,0,4,1759,0,0
"World","2024-02-23",0,10,1762,0,3,1762,0,0
"World","2024-02-24",0,0,1762,0,23,1785,0,0
"World","2024-02-25",0,46,1808,0,23,1808,0,0
"World","2024-02-26",0,0,1808,0,59,1867,0,0
"World","2024-02-27",0,118,1926,0,59,1926,0,0
"World","2024-02-28",0,15,1941,0,15,1941,0,0
"World","2024-02-29",0,309,2250,0,309,2250,0,0
"World","2024-03-01",0,4,2254,0,4,2254,0,0
"World","2024-03-02",0,1,2255,0,1,2255,0,0
"World","2024-03-03",0,81,2336,0,81,2336,0,0
"World","2024-03-04",0,0,2336,0,52,2388,0,0
"World","2024-03-05",0,104,2440,0,52,2440,0,0
"World","2024-03-06",0,10,2450,0,10,2450,0,0
"World","2024-03-07",0,0,2450,0,2,2452,0,0
"World","2024-03-08",0,3,2453,0,1,2453,0,0
"World","2024-03-09",0,0,2453,0,34,2487,0,0
"World","2024-03-10",0,69,2522,0,35,2522,0,0
"World","2024-03-11",0,0,2522,0,56,2578,0,0
"World","2024-03-12",0,111,2633,0,55,2633,0,0
"World","2024-03-13",0,0,2633,0,0,2633,0,0
"World","2024-03-14",0,1,2634,0,1,2634,0,0
"World","2024-03-15",0,3,2637,0,3,2637,0,0
"World","2024-03-16",0,0,2637,0,37,2674,0,0
"World","2024-03-17",0,74,2711,0,37,2711,0,0
"World","2024-03-18",0,0,2711,0,44,2755,0,0
"World","2024-03-19",0,89,2800,0,45,2800,0,0
"World","2024-03-20",0,0,2800,0,0,2800,0,0
"World","2024-03-21",0,0,2800,0,1,2801,0,0
"World","2024-03-22",0,1,2801,0,0,2801,0,0
"World","2024-03-23",0,0,2801,0,34,2835,0,0
"World","2024-03-24",0,69,2870,0,35,2870,0,0
"World","2024-03-25",0,0,2870,0,54,2924,0,0
"World","2024-03-26",0,109,2979,0,55,2979,0,0
"World","2024-03-27",0,0,2979,0,55,3034,0,0
"World","2024-03-28",0,0,2979,0,55,3089,0,0
"World","2024-03-29",0,0,2979,0,55,3144,0,0
"World","2024-03-30",0,0,2979,0,55,3199,0,0
"World","2024-03-31",0,275,3254,0,55,3254,0,0
"World","2024-04-01",0,6,3260,0,6,3260,0,0
"World","2024-04-02",0,83,3343,0,83,3343,0,0
"World","2024-04-03",0,0,3343,0,1,3344,0,0
"World","2024-04-04",0,0,3343,0,1,3345,0,0
"World","2024-04-05",0,3,3346,0,1,3346,0,0
"World","2024-04-06",0,0,3346,0,44,3390,0,0
"World","2024-04-07",0,88,3434,0,44,3434,0,0
"World","2024-04-08",0,0,3434,0,48,3482,0,0
"World","2024-04-09",0,97,3531,0,49,3531,0,0
"World","2024-04-10",0,0,3531,0,1,3532,0,0
"World","2024-04-11",0,0,3531,0,0,3532,0,0
"World","2024-04-12",0,2,3533,0,1,3533,0,0
"World","2024-04-13",0,0,3533,0,68,3601,0,0
"World","2024-04-14",0,137,3670,0,69,3670,0,0
"World","2024-04-15",0,0,3670,0,52,3722,0,0
"World","2024-04-16",0,104,3774,0,52,3774,0,0
"World","2024-04-17",0,0,3774,0,0,3774,0,0
"World","2024-04-18",0,0,3774,0,1,3775,0,0
"World","2024-04-19",0,1,3775,0,0,3775,0,0
"World","2024-04-20",0,1,3776,0,1,3776,0,0
"World","2024-04-21",0,148,3924,0,148,3924,0,0
"World","2024-04-22",0,0,3924,0,60,3984,0,0
"World","2024-04-23",0,119,4043,0,59,4043,0,0
"World","2024-04-24",0,0,4043,0,1,4044,0,0
"World","2024-04-25",0,0,4043,0,0,4044,0,0
"World","2024-04-26",0,2,4045,0,1,4045,0,0
"World","2024-04-27",0,1,4046,0,1,4046,0,0
"World","2024-04-28",0,170,4216,0,170,4216,0,0
"World","2024-04-29",0,0,4216,0,130,4346,0,0
"World","2024-04-30",0,259,4475,0,129,4475,0,0
"World","2024-05-01",0,0,4475,0,50,4525,0,0
"World","2024-05-02",0,0,4475,0,50,4575,0,0
"World","2024-05-03",0,0,4475,0,49,4624,0,0
"World","2024-05-04",0,0,4475,0,50,4674,0,0
"World","2024-05-05",0,249,4724,0,50,4724,0,0
"World","2024-05-06",0,0,4724,0,40,4764,0,0
"World","2024-05-07",0,80,4804,0,40,4804,0,0
"World","2024-05-08",0,0,4804,0,0,4804,0,0
"World","2024-05-09",0,1,4805,0,1,4805,0,0
"World","2024-05-10",0,25,4830,0,25,4830,0,0
"World","2024-05-11",0,0,4830,0,88,4918,0,0
"World","2024-05-12",0,177,5007,0,89,5007,0,0
"World","2024-05-13",0,0,5007,0,43,5050,0,0
"World","2024-05-14",0,86,5093,0,43,5093,0,0
"World","2024-05-15",0,0,5093,0,40,5133,0,0
"World","2024-05-16",0,0,5093,0,41,5174,0,0
"World","2024-05-17",0,0,5093,0,40,5214,0,0
"World","2024-05-18",0,0,5093,0,41,5255,0,0
"World","2024-05-19",0,202,5295,0,40,5295,0,0
"World","2024-05-20",0,0,5295,0,37,5332,0,0
"World","2024-05-21",0,74,5369,0,37,5369,0,0
"World","2024-05-22",0,1,5370,0,1,5370,0,0
"World","2024-05-23",0,0,5370,0,2,5372,0,0
"World","2024-05-24",0,4,5374,0,2,5374,0,0
"World","2024-05-25",0,0,5374,0,107,5481,0,0
"World","2024-05-26",0,214,5588,0,107,5588,0,0
"World","2024-05-27",0,1,5589,0,1,5589,0,0
"World","2024-05-28",0,92,5681,0,92,5681,0,0
"World","2024-05-29",0,0,5681,0,24,5705,0,0
"World","2024-05-30",0,49,5730,0,25,5730,0,0
"World","2024-05-31",0,215,5945,0,215,5945,0,0
"World","2024-06-01",0,0,5945,0,128,6073,0,0
"World","2024-06-02",0,257,6202,0,129,6202,0,0
"World","2024-06-03",0,0,6202,0,42,6244,0,0
"World","2024-06-04",0,85,6287,0,43,6287,0,0
"World","2024-06-05",0,0,6287,0,46,6333,0,0
"World","2024-06-06",0,0,6287,0,46,6379,0,0
"World","2024-06-07",0,0,6287,0,45,6424,0,0
"World","2024-06-08",0,0,6287,0,46,6470,0,0
"World","2024-06-09",0,229,6516,0,46,6516,0,0
"World","2024-06-10",0,0,6516,0,48,6564,0,0
"World","2024-06-11",0,97,6613,0,49,6613,0,0
"World","2024-06-12",0,0,6613,0,77,6690,0,0
"World","2024-06-13",0,0,6613,0,77,6767,0,0
"World","2024-06-14",0,0,6613,0,76,6843,0,0
"World","2024-06-15",0,0,6613,0,77,6920,0,0
"World","2024-06-16",0,384,6997,0,77,6997,0,0
"World","2024-06-17",0,0,6997,0,33,7030,0,0
"World","2024-06-18",0,66,7063,0,33,7063,0,0
"World","2024-06-19",0,0,7063,0,68,7131,0,0
"World","2024-06-20",0,0,7063,0,69,7200,0,0
"World","2024-06-21",0,0,7063,0,68,7268,0,0
"World","2024-06-22",0,0,7063,0,69,7337,0,0
"World","2024-06-23",0,342,7405,0,68,7405,0,0
"World","2024-06-24",0,4,7409,0,4,7409,0,0
"World","2024-06-25",0,80,7489,0,80,7489,0,0
"World","2024-06-26",0,0,7489,0,2,7491,0,0
"World","2024-06-27",0,0,7489,0,3,7494,0,0
"World","2024-06-28",0,7,7496,0,2,7496,0,0
"World","2024-06-29",0,0,7496,0,346,7842,0,0
"World","2024-06-30",0,693,8189,0,347,8189,0,0
"World","2024-07-01",0,2,8191,0,2,8191,0,0
"World","2024-07-02",0,91,8282,0,91,8282,0,0
"World","2024-07-03",0,0,8282,0,85,8367,0,0
"World","2024-07-04",0,0,8282,0,85,8452,0,0
"World","2024-07-05",0,0,8282,0,84,8536,0,0
"World","2024-07-06",0,0,8282,0,85,8621,0,0
"World","2024-07-07",0,424,8706,0,85,8706,0,0
"World","2024-07-08",0,2,8708,0,2,8708,0,0
"World","2024-07-09",0,93,8801,0,93,8801,0,0
"World","2024-07-10",0,0,8801,0,1,8802,0,0
"World","2024-07-11",0,0,8801,0,0,8802,0,0
"World","2024-07-12",0,2,8803,0,1,8803,0,0
"World","2024-07-13",0,1,8804,0,1,8804,0,0
"World","2024-07-14",0,337,9141,0,337,9141,0,0
"World","2024-07-15",0,14,9155,0,14,9155,0,0
"World","2024-07-16",0,116,9271,0,116,9271,0,0
"World","2024-07-17",0,0,9271,0,105,9376,0,0
"World","2024-07-18",0,0,9271,0,105,9481,0,0
"World","2024-07-19",0,0,9271,0,106,9587,0,0
"World","2024-07-20",0,0,9271,0,105,9692,0,0
"World","2024-07-21",0,526,9797,0,105,9797,0,0
"World","2024-07-22",0,21,9818,0,21,9818,0,0
"World","2024-07-23",0,98,9916,0,98,9916,0,0
"World","2024-07-24",0,0,9916,0,5,9921,0,0
"World","2024-07-25",0,0,9916,0,5,9926,0,0
"World","2024-07-26",0,0,9916,0,6,9932,0,0
"World","2024-07-27",0,21,9937,0,5,9937,0,0
"World","2024-07-28",0,413,10350,0,413,10350,0,0
"World","2024-07-29",0,0,10350,0,90,10440,0,0
"World","2024-07-30",0,180,10530,0,90,10530,0,0
"World","2024-07-31",0,188,10718,0,188,10718,0,0
"World","2024-08-01",0,0,10718,0,3,10721,0,0
"World","2024-08-02",0,6,10724,0,3,10724,0,0
"World","2024-08-03",0,0,10724,0,134,10858,0,0
"World","2024-08-04",0,268,10992,0,134,10992,0,0
"World","2024-08-05",0,1,10993,0,1,10993,0,0
"World","2024-08-06",0,146,11139,0,146,11139,0,0
"World","2024-08-07",0,0,11139,0,59,11198,0,0
"World","2024-08-08",0,0,11139,0,59,11257,0,0
"World","2024-08-09",0,0,11139,0,60,11317,0,0
"World","2024-08-10",0,0,11139,0,59,11376,0,0
"World","2024-08-11",0,296,11435,0,59,11435,0,0
"World","2024-08-12",0,0,11435,0,83,11518,0,0
"World","2024-08-13",0,166,11601,0,83,11601,0,0
"World","2024-08-14",0,1,11602,0,1,11602,0,0
"World","2024-08-15",0,2,11604,0,2,11604,0,0
"World","2024-08-16",0,0,11604,0,98,11702,0,0
"World","2024-08-17",0,0,11604,0,98,11800,0,0
"World","2024-08-18",0,294,11898,0,98,11898,0,0
"World","2024-08-19",0,1,11899,0,1,11899,0,0
"World","2024-08-20",0,180,12079,0,180,12079,0,0
"World","2024-08-21",0,75,12154,0,75,12154,0,0
"World","2024-08-22",0,2,12156,0,2,12156,0,0
"World","2024-08-23",0,1,12157,0,1,12157,0,0
"World","2024-08-24",0,0,12157,0,156,12313,0,0
"World","2024-08-25",0,313,12470,0,157,12470,0,0
"World","2024-08-26",0,0,12470,0,92,12562,0,0
"World","2024-08-27",0,185,12655,0,93,12655,0,0
"World","2024-08-28",0,4,12659,0,4,12659,0,0
"World","2024-08-29",0,70,12729,0,70,12729,0,0
"World","2024-08-30",0,0,12729,0,226,12955,0,0
"World","2024-08-31",0,451,13180,0,225,13180,0,0
"World","2024-09-01",0,442,13622,0,442,13622,0,0
"World","2024-09-02",0,1,13623,0,1,13623,0,0
"World","2024-09-03",0,187,13810,0,187,13810,0,0
"World","2024-09-04",0,0,13810,0,88,13898,0,0
"World","2024-09-05",0,0,13810,0,89,13987,0,0
"World","2024-09-06",0,0,13810,0,88,14075,0,0
"World","2024-09-07",0,0,13810,0,89,14164,0,0
"World","2024-09-08",0,442,14252,0,88,14252,0,0
"World","2024-09-09",0,0,14252,0,80,14332,0,0
"World","2024-09-10",0,161,14413,0,81,14413,0,0
"World","2024-09-11",0,0,14413,0,0,14413,0,0
"World","2024-09-12",0,1,14414,0,1,14414,0,0
"World","2024-09-13",0,0,14414,0,199,14613,0,0
"World","2024-09-14",0,0,14414,0,199,14812,0,0
"World","2024-09-15",0,597,15011,0,199,15011,0,0
"World","2024-09-16",0,0,15011,0,74,15085,0,0
"World","2024-09-17",0,149,15160,0,75,15160,0,0
"World","2024-09-18",0,1,15161,0,1,15161,0,0
"World","2024-09-19",0,0,15161,0,137,15298,0,0
"World","2024-09-20",0,0,15161,0,137,15435,0,0
"World","2024-09-21",0,0,15161,0,138,15573,0,0
"World","2024-09-22",0,549,15710,0,137,15710,0,0
"World","2024-09-23",0,3,15713,0,3,15713,0,0
"World","2024-09-24",0,149,15862,0,149,15862,0,0
"World","2024-09-25",0,0,15862,0,8,15870,0,0
"World","2024-09-26",0,15,15877,0,7,15877,0,0
"World","2024-09-27",0,0,15877,0,2,15879,0,0
"World","2024-09-28",0,3,15880,0,1,15880,0,0
"World","2024-09-29",0,468,16348,0,468,16348,0,0
"World","2024-09-30",0,227,16575,0,227,16575,0,0
"World","2024-10-01",0,154,16729,0,154,16729,0,0
"World","2024-10-02",0,1,16730,0,1,16730,0,0
"World","2024-10-03",0,2,16732,0,2,16732,0,0
"World","2024-10-04",0,1,16733,0,1,16733,0,0
"World","2024-10-05",0,0,16733,0,208,16941,0,0
"World","2024-10-06",0,417,17150,0,209,17150,0,0
"World","2024-10-07",0,23,17173,0,23,17173,0,0
"World","2024-10-08",0,132,17305,0,132,17305,0,0
"World","2024-10-09",0,0,17305,0,1,17306,0,0
"World","2024-10-10",0,2,17307,0,1,17307,0,0
"World","2024-10-11",0,2,17309,0,2,17309,0,0
"World","2024-10-12",0,1,17310,0,1,17310,0,0
"World","2024-10-13",0,549,17859,0,549,17859,0,0
"World","2024-10-14",0,0,17859,0,54,17913,0,0
"World","2024-10-15",0,107,17966,0,53,17966,0,0
"World","2024-10-16",0,0,17966,0,1,17967,0,0
"World","2024-10-17",0,0,17966,0,0,17967,0,0
"World","2024-10-18",0,2,17968,0,1,17968,0,0
"World","2024-10-19",0,0,17968,0,285,18253,0,0
"World","2024-10-20",0,570,18538,0,285,18538,0,0
"World","2024-10-21",0,46,18584,0,46,18584,0,0
"World","2024-10-22",0,122,18706,0,122,18706,0,0
"World","2024-10-23",0,2,18708,0,2,18708,0,0
"World","2024-10-24",0,0,18708,0,1,18709,0,0
"World","2024-10-25",0,0,18708,0,1,18710,0,0
"World","2024-10-26",0,3,18711,0,1,18711,0,0
"World","2024-10-27",0,666,19377,0,666,19377,0,0
"World","2024-10-28",0,0,19377,0,46,19423,0,0
"World","2024-10-29",0,93,19470,0,47,19470,0,0
"World","2024-10-30",0,3,19473,0,3,19473,0,0
"World","2024-10-31",0,243,19716,0,243,19716,0,0
"World","2024-11-01",0,2,19718,0,2,19718,0,0
"World","2024-11-02",0,0,19718,0,262,19980,0,0
"World","2024-11-03",0,523,20241,0,261,20241,0,0
"World","2024-11-04",0,1,20242,0,1,20242,0,0
"World","2024-11-05",0,90,20332,0,90,20332,0,0
"World","2024-11-06",0,3,20335,0,3,20335,0,0
"World","2024-11-07",0,0,20335,0,156,20491,0,0
"World","2024-11-08",0,0,20335,0,156,20647,0,0
"World","2024-11-09",0,0,20335,0,156,20803,0,0
"World","2024-11-10",0,624,20959,0,156,20959,0,0
"World","2024-11-11",0,0,20959,0,34,20993,0,0
"World","2024-11-12",0,67,21026,0,33,21026,0,0
"World","2024-11-13",0,0,21026,0,2,21028,0,0
"World","2024-11-14",0,0,21026,0,3,21031,0,0
"World","2024-11-15",0,7,21033,0,2,21033,0,0
"World","2024-11-16",0,0,21033,0,208,21241,0,0
"World","2024-11-17",0,415,21448,0,207,21448,0,0
"World","2024-11-18",0,0,21448,0,20,21468,0,0
"World","2024-11-19",0,41,21489,0,21,21489,0,0
"World","2024-11-20",0,1,21490,0,1,21490,0,0
"World","2024-11-21",0,38,21528,0,38,21528,0,0
"World","2024-11-22",0,0,21528,0,127,21655,0,0
"World","2024-11-23",0,0,21528,0,128,21783,0,0
"World","2024-11-24",0,382,21910,0,127,21910,0,0
"World","2024-11-25",0,0,21910,0,6,21916,0,0
"World","2024-11-26",0,13,21923,0,7,21923,0,0
"World","2024-11-27",0,121,22044,0,121,22044,0,0
"World","2024-11-28",0,0,22044,0,0,22044,0,0
"World","2024-11-29",0,1,22045,0,1,22045,0,0
"World","2024-11-30",0,397,22442,0,397,22442,0,0
"World","2024-12-01",0,113,22555,0,113,22555,0,0
"World","2024-12-02",0,0,22555,0,1,22556,0,0
"World","2024-12-03",0,2,22557,0,1,22557,0,0
"World","2024-12-04",0,0,22557,0,2,22559,0,0
"World","2024-12-05",0,3,22560,0,1,22560,0,0
"World","2024-12-06",0,0,22560,0,101,22661,0,0
"World","2024-12-07",0,0,22560,0,100,22761,0,0
"World","2024-12-08",0,302,22862,0,101,22862,0,0
"World","2024-12-09",0,27,22889,0,27,22889,0,0
"World","2024-12-10",0,1,22890,0,1,22890,0,0
"World","2024-12-11",0,0,22890,0,64,22954,0,0
"World","2024-12-12",0,127,23017,0,63,23017,0,0
"World","2024-12-13",0,102,23119,0,102,23119,0,0
"World","2024-12-14",0,0,23119,0,14,23133,0,0
"World","2024-12-15",0,27,23146,0,13,23146,0,0
"World","2024-12-16",0,0,23146,0,0,23146,0,0
"World","2024-12-17",0,0,23146,0,0,23146,0,0
"World","2024-12-18",0,0,23146,0,0,23146,0,0
"World","2024-12-19",0,0,23146,0,0,23146,0,0
"World","2024-12-20",0,0,23146,0,0,23146,0,0
"World","2024-12-21",0,0,23146,0,0,23146,0,0
"World","2024-12-22",0,0,23146,0,0,23146,0,0
"World","2024-12-23",0,0,23146,0,0,23146,0,0
"World","2024-12-24",0,0,23146,0,0,23146,0,0
"World","2024-12-25",0,0,23146,0,0,23146,0,0
"World","2024-12-26",0,0,23146,0,0,23146,0,0
"World","2024-12-27",0,0,23146,0,0,23146,0,0
"World","2024-12-28",0,0,23146,0,0,23146,0,0
"World","2024-12-29",0,0,23146,0,0,23146,0,0
"World","2024-12-30",0,0,23146,0,0,23146,0,0
"World","2024-12-31",0,0,23146,0,0,23146,0,0
"World","2025-01-01",0,0,23146,0,0,23146,0,0
"World","2025-01-02",0,0,23146,0,0,23146,0,0
"World","2025-01-03",0,0,23146,0,0,23146,0,0
"World","2025-01-04",0,0,23146,0,0,23146,0,0
"World","2025-01-05",0,0,23146,0,0,23146,0,0
"World","2025-01-06",0,0,23146,0,0,23146,0,0
"World","2025-01-07",0,0,23146,0,0,23146,0,0
"World","2025-01-08",0,0,23146,0,0,23146,0,0
"World","2025-01-09",0,0,23146,0,0,23146,0,0
"World","2025-01-10",0,0,23146,0,0,23146,0,0
"World","2025-01-11",0,0,23146,0,0,23146,0,0
"World","2025-01-12",0,0,23146,0,0,23146,0,0
"World","2025-01-13",0,0,23146,0,0,23146,0,0
"Zambia","2024-01-01",0,0,0,0,0,0,0,0
"Zambia","2024-01-02",0,0,0,0,0,0,0,0
"Zambia","2024-01-03",0,0,0,0,0,0,0,0
"Zambia","2024-01-04",0,0,0,0,0,0,0,0
"Zambia","2024-01-05",0,0,0,0,0,0,0,0
"Zambia","2024-01-06",0,0,0,0,0,0,0,0
"Zambia","2024-01-07",0,0,0,0,0,0,0,0
"Zambia","2024-01-08",0,0,0,0,0,0,0,0
"Zambia","2024-01-09",0,0,0,0,0,0,0,0
"Zambia","2024-01-10",0,0,0,0,0,0,0,0
"Zambia","2024-01-11",0,0,0,0,0,0,0,0
"Zambia","2024-01-12",0,0,0,0,0,0,0,0
"Zambia","2024-01-13",0,0,0,0,0,0,0,0
"Zambia","2024-01-14",0,0,0,0,0,0,0,0
"Zambia","2024-01-15",0,0,0,0,0,0,0,0
"Zambia","2024-01-16",0,0,0,0,0,0,0,0
"Zambia","2024-01-17",0,0,0,0,0,0,0,0
"Zambia","2024-01-18",0,0,0,0,0,0,0,0
"Zambia","2024-01-19",0,0,0,0,0,0,0,0
"Zambia","2024-01-20",0,0,0,0,0,0,0,0
"Zambia","2024-01-21",0,0,0,0,0,0,0,0
"Zambia","2024-01-22",0,0,0,0,0,0,0,0
"Zambia","2024-01-23",0,0,0,0,0,0,0,0
"Zambia","2024-01-24",0,0,0,0,0,0,0,0
"Zambia","2024-01-25",0,0,0,0,0,0,0,0
"Zambia","2024-01-26",0,0,0,0,0,0,0,0
"Zambia","2024-01-27",0,0,0,0,0,0,0,0
"Zambia","2024-01-28",0,0,0,0,0,0,0,0
"Zambia","2024-01-29",0,0,0,0,0,0,0,0
"Zambia","2024-01-30",0,0,0,0,0,0,0,0
"Zambia","2024-01-31",0,0,0,0,0,0,0,0
"Zambia","2024-02-01",0,0,0,0,0,0,0,0
"Zambia","2024-02-02",0,0,0,0,0,0,0,0
"Zambia","2024-02-03",0,0,0,0,0,0,0,0
"Zambia","2024-02-04",0,0,0,0,0,0,0,0
"Zambia","2024-02-05",0,0,0,0,0,0,0,0
"Zambia","2024-02-06",0,0,0,0,0,0,0,0
"Zambia","2024-02-07",0,0,0,0,0,0,0,0
"Zambia","2024-02-08",0,0,0,0,0,0,0,0
"Zambia","2024-02-09",0,0,0,0,0,0,0,0
"Zambia","2024-02-10",0,0,0,0,0,0,0,0
"Zambia","2024-02-11",0,0,0,0,0,0,0,0
"Zambia","2024-02-12",0,0,0,0,0,0,0,0
"Zambia","2024-02-13",0,0,0,0,0,0,0,0
"Zambia","2024-02-14",0,0,0,0,0,0,0,0
"Zambia","2024-02-15",0,0,0,0,0,0,0,0
"Zambia","2024-02-16",0,0,0,0,0,0,0,0
"Zambia","2024-02-17",0,0,0,0,0,0,0,0
"Zambia","2024-02-18",0,0,0,0,0,0,0,0
"Zambia","2024-02-19",0,0,0,0,0,0,0,0
"Zambia","2024-02-20",0,0,0,0,0,0,0,0
"Zambia","2024-02-21",0,0,0,0,0,0,0,0
"Zambia","2024-02-22",0,0,0,0,0,0,0,0
"Zambia","2024-02-23",0,0,0,0,0,0,0,0
"Zambia","2024-02-24",0,0,0,0,0,0,0,0
"Zambia","2024-02-25",0,0,0,0,0,0,0,0
"Zambia","2024-02-26",0,0,0,0,0,0,0,0
"Zambia","2024-02-27",0,0,0,0,0,0,0,0
"Zambia","2024-02-28",0,0,0,0,0,0,0,0
"Zambia","2024-02-29",0,0,0,0,0,0,0,0
"Zambia","2024-03-01",0,0,0,0,0,0,0,0
"Zambia","2024-03-02",0,0,0,0,0,0,0,0
"Zambia","2024-03-03",0,0,0,0,0,0,0,0
"Zambia","2024-03-04",0,0,0,0,0,0,0,0
"Zambia","2024-03-05",0,0,0,0,0,0,0,0
"Zambia","2024-03-06",0,0,0,0,0,0,0,0
"Zambia","2024-03-07",0,0,0,0,0,0,0,0
"Zambia","2024-03-08",0,0,0,0,0,0,0,0
"Zambia","2024-03-09",0,0,0,0,0,0,0,0
"Zambia","2024-03-10",0,0,0,0,0,0,0,0
"Zambia","2024-03-11",0,0,0,0,0,0,0,0
"Zambia","2024-03-12",0,0,0,0,0,0,0,0
"Zambia","2024-03-13",0,0,0,0,0,0,0,0
"Zambia","2024-03-14",0,0,0,0,0,0,0,0
"Zambia","2024-03-15",0,0,0,0,0,0,0,0
"Zambia","2024-03-16",0,0,0,0,0,0,0,0
"Zambia","2024-03-17",0,0,0,0,0,0,0,0
"Zambia","2024-03-18",0,0,0,0,0,0,0,0
"Zambia","2024-03-19",0,0,0,0,0,0,0,0
"Zambia","2024-03-20",0,0,0,0,0,0,0,0
"Zambia","2024-03-21",0,0,0,0,0,0,0,0
"Zambia","2024-03-22",0,0,0,0,0,0,0,0
"Zambia","2024-03-23",0,0,0,0,0,0,0,0
"Zambia","2024-03-24",0,0,0,0,0,0,0,0
"Zambia","2024-03-25",0,0,0,0,0,0,0,0
"Zambia","2024-03-26",0,0,0,0,0,0,0,0
"Zambia","2024-03-27",0,0,0,0,0,0,0,0
"Zambia","2024-03-28",0,0,0,0,0,0,0,0
"Zambia","2024-03-29",0,0,0,0,0,0,0,0
"Zambia","2024-03-30",0,0,0,0,0,0,0,0
"Zambia","2024-03-31",0,0,0,0,0,0,0,0
"Zambia","2024-04-01",0,0,0,0,0,0,0,0
"Zambia","2024-04-02",0,0,0,0,0,0,0,0
"Zambia","2024-04-03",0,0,0,0,0,0,0,0
"Zambia","2024-04-04",0,0,0,0,0,0,0,0
"Zambia","2024-04-05",0,0,0,0,0,0,0,0
"Zambia","2024-04-06",0,0,0,0,0,0,0,0
"Zambia","2024-04-07",0,0,0,0,0,0,0,0
"Zambia","2024-04-08",0,0,0,0,0,0,0,0
"Zambia","2024-04-09",0,0,0,0,0,0,0,0
"Zambia","2024-04-10",0,0,0,0,0,0,0,0
"Zambia","2024-04-11",0,0,0,0,0,0,0,0
"Zambia","2024-04-12",0,0,0,0,0,0,0,0
"Zambia","2024-04-13",0,0,0,0,0,0,0,0
"Zambia","2024-04-14",0,0,0,0,0,0,0,0
"Zambia","2024-04-15",0,0,0,0,0,0,0,0
"Zambia","2024-04-16",0,0,0,0,0,0,0,0
"Zambia","2024-04-17",0,0,0,0,0,0,0,0
"Zambia","2024-04-18",0,0,0,0,0,0,0,0
"Zambia","2024-04-19",0,0,0,0,0,0,0,0
"Zambia","2024-04-20",0,0,0,0,0,0,0,0
"Zambia","2024-04-21",0,0,0,0,0,0,0,0
"Zambia","2024-04-22",0,0,0,0,0,0,0,0
"Zambia","2024-04-23",0,0,0,0,0,0,0,0
"Zambia","2024-04-24",0,0,0,0,0,0,0,0
"Zambia","2024-04-25",0,0,0,0,0,0,0,0
"Zambia","2024-04-26",0,0,0,0,0,0,0,0
"Zambia","2024-04-27",0,0,0,0,0,0,0,0
"Zambia","2024-04-28",0,0,0,0,0,0,0,0
"Zambia","2024-04-29",0,0,0,0,0,0,0,0
"Zambia","2024-04-30",0,0,0,0,0,0,0,0
"Zambia","2024-05-01",0,0,0,0,0,0,0,0
"Zambia","2024-05-02",0,0,0,0,0,0,0,0
"Zambia","2024-05-03",0,0,0,0,0,0,0,0
"Zambia","2024-05-04",0,0,0,0,0,0,0,0
"Zambia","2024-05-05",0,0,0,0,0,0,0,0
"Zambia","2024-05-06",0,0,0,0,0,0,0,0
"Zambia","2024-05-07",0,0,0,0,0,0,0,0
"Zambia","2024-05-08",0,0,0,0,0,0,0,0
"Zambia","2024-05-09",0,0,0,0,0,0,0,0
"Zambia","2024-05-10",0,0,0,0,0,0,0,0
"Zambia","2024-05-11",0,0,0,0,0,0,0,0
"Zambia","2024-05-12",0,0,0,0,0,0,0,0
"Zambia","2024-05-13",0,0,0,0,0,0,0,0
"Zambia","2024-05-14",0,0,0,0,0,0,0,0
"Zambia","2024-05-15",0,0,0,0,0,0,0,0
"Zambia","2024-05-16",0,0,0,0,0,0,0,0
"Zambia","2024-05-17",0,0,0,0,0,0,0,0
"Zambia","2024-05-18",0,0,0,0,0,0,0,0
"Zambia","2024-05-19",0,0,0,0,0,0,0,0
"Zambia","2024-05-20",0,0,0,0,0,0,0,0
"Zambia","2024-05-21",0,0,0,0,0,0,0,0
"Zambia","2024-05-22",0,0,0,0,0,0,0,0
"Zambia","2024-05-23",0,0,0,0,0,0,0,0
"Zambia","2024-05-24",0,0,0,0,0,0,0,0
"Zambia","2024-05-25",0,0,0,0,0,0,0,0
"Zambia","2024-05-26",0,0,0,0,0,0,0,0
"Zambia","2024-05-27",0,0,0,0,0,0,0,0
"Zambia","2024-05-28",0,0,0,0,0,0,0,0
"Zambia","2024-05-29",0,0,0,0,0,0,0,0
"Zambia","2024-05-30",0,0,0,0,0,0,0,0
"Zambia","2024-05-31",0,0,0,0,0,0,0,0
"Zambia","2024-06-01",0,0,0,0,0,0,0,0
"Zambia","2024-06-02",0,0,0,0,0,0,0,0
"Zambia","2024-06-03",0,0,0,0,0,0,0,0
"Zambia","2024-06-04",0,0,0,0,0,0,0,0
"Zambia","2024-06-05",0,0,0,0,0,0,0,0
"Zambia","2024-06-06",0,0,0,0,0,0,0,0
"Zambia","2024-06-07",0,0,0,0,0,0,0,0
"Zambia","2024-06-08",0,0,0,0,0,0,0,0
"Zambia","2024-06-09",0,0,0,0,0,0,0,0
"Zambia","2024-06-10",0,0,0,0,0,0,0,0
"Zambia","2024-06-11",0,0,0,0,0,0,0,0
"Zambia","2024-06-12",0,0,0,0,0,0,0,0
"Zambia","2024-06-13",0,0,0,0,0,0,0,0
"Zambia","2024-06-14",0,0,0,0,0,0,0,0
"Zambia","2024-06-15",0,0,0,0,0,0,0,0
"Zambia","2024-06-16",0,0,0,0,0,0,0,0
"Zambia","2024-06-17",0,0,0,0,0,0,0,0
"Zambia","2024-06-18",0,0,0,0,0,0,0,0
"Zambia","2024-06-19",0,0,0,0,0,0,0,0
"Zambia","2024-06-20",0,0,0,0,0,0,0,0
"Zambia","2024-06-21",0,0,0,0,0,0,0,0
"Zambia","2024-06-22",0,0,0,0,0,0,0,0
"Zambia","2024-06-23",0,0,0,0,0,0,0,0
"Zambia","2024-06-24",0,0,0,0,0,0,0,0
"Zambia","2024-06-25",0,0,0,0,0,0,0,0
"Zambia","2024-06-26",0,0,0,0,0,0,0,0
"Zambia","2024-06-27",0,0,0,0,0,0,0,0
"Zambia","2024-06-28",0,0,0,0,0,0,0,0
"Zambia","2024-06-29",0,0,0,0,0,0,0,0
"Zambia","2024-06-30",0,0,0,0,0,0,0,0
"Zambia","2024-07-01",0,0,0,0,0,0,0,0
"Zambia","2024-07-02",0,0,0,0,0,0,0,0
"Zambia","2024-07-03",0,0,0,0,0,0,0,0
"Zambia","2024-07-04",0,0,0,0,0,0,0,0
"Zambia","2024-07-05",0,0,0,0,0,0,0,0
"Zambia","2024-07-06",0,0,0,0,0,0,0,0
"Zambia","2024-07-07",0,0,0,0,0,0,0,0
"Zambia","2024-07-08",0,0,0,0,0,0,0,0
"Zambia","2024-07-09",0,0,0,0,0,0,0,0
"Zambia","2024-07-10",0,0,0,0,0,0,0,0
"Zambia","2024-07-11",0,0,0,0,0,0,0,0
"Zambia","2024-07-12",0,0,0,0,0,0,0,0
"Zambia","2024-07-13",0,0,0,0,0,0,0,0
"Zambia","2024-07-14",0,0,0,0,0,0,0,0
"Zambia","2024-07-15",0,0,0,0,0,0,0,0
"Zambia","2024-07-16",0,0,0,0,0,0,0,0
"Zambia","2024-07-17",0,0,0,0,0,0,0,0
"Zambia","2024-07-18",0,0,0,0,0,0,0,0
"Zambia","2024-07-19",0,0,0,0,0,0,0,0
"Zambia","2024-07-20",0,0,0,0,0,0,0,0
"Zambia","2024-07-21",0,0,0,0,0,0,0,0
"Zambia","2024-07-22",0,0,0,0,0,0,0,0
"Zambia","2024-07-23",0,0,0,0,0,0,0,0
"Zambia","2024-07-24",0,0,0,0,0,0,0,0
"Zambia","2024-07-25",0,0,0,0,0,0,0,0
"Zambia","2024-07-26",0,0,0,0,0,0,0,0
"Zambia","2024-07-27",0,0,0,0,0,0,0,0
"Zambia","2024-07-28",0,0,0,0,0,0,0,0
"Zambia","2024-07-29",0,0,0,0,0,0,0,0
"Zambia","2024-07-30",0,0,0,0,0,0,0,0
"Zambia","2024-07-31",0,0,0,0,0,0,0,0
"Zambia","2024-08-01",0,0,0,0,0,0,0,0
"Zambia","2024-08-02",0,0,0,0,0,0,0,0
"Zambia","2024-08-03",0,0,0,0,0,0,0,0
"Zambia","2024-08-04",0,0,0,0,0,0,0,0
"Zambia","2024-08-05",0,0,0,0,0,0,0,0
"Zambia","2024-08-06",0,0,0,0,0,0,0,0
"Zambia","2024-08-07",0,0,0,0,0,0,0,0
"Zambia","2024-08-08",0,0,0,0,0,0,0,0
"Zambia","2024-08-09",0,0,0,0,0,0,0,0
"Zambia","2024-08-10",0,0,0,0,0,0,0,0
"Zambia","2024-08-11",0,0,0,0,0,0,0,0
"Zambia","2024-08-12",0,0,0,0,0,0,0,0
"Zambia","2024-08-13",0,0,0,0,0,0,0,0
"Zambia","2024-08-14",0,0,0,0,0,0,0,0
"Zambia","2024-08-15",0,0,0,0,0,0,0,0
"Zambia","2024-08-16",0,0,0,0,0,0,0,0
"Zambia","2024-08-17",0,0,0,0,0,0,0,0
"Zambia","2024-08-18",0,0,0,0,0,0,0,0
"Zambia","2024-08-19",0,0,0,0,0,0,0,0
"Zambia","2024-08-20",0,0,0,0,0,0,0,0
"Zambia","2024-08-21",0,0,0,0,0,0,0,0
"Zambia","2024-08-22",0,0,0,0,0,0,0,0
"Zambia","2024-08-23",0,0,0,0,0,0,0,0
"Zambia","2024-08-24",0,0,0,0,0,0,0,0
"Zambia","2024-08-25",0,0,0,0,0,0,0,0
"Zambia","2024-08-26",0,0,0,0,0,0,0,0
"Zambia","2024-08-27",0,0,0,0,0,0,0,0
"Zambia","2024-08-28",0,0,0,0,0,0,0,0
"Zambia","2024-08-29",0,0,0,0,0,0,0,0
"Zambia","2024-08-30",0,0,0,0,0,0,0,0
"Zambia","2024-08-31",0,0,0,0,0,0,0,0
"Zambia","2024-09-01",0,0,0,0,0,0,0,0
"Zambia","2024-09-02",0,0,0,0,0,0,0,0
"Zambia","2024-09-03",0,0,0,0,0,0,0,0
"Zambia","2024-09-04",0,0,0,0,0,0,0,0
"Zambia","2024-09-05",0,0,0,0,0,0,0,0
"Zambia","2024-09-06",0,0,0,0,0,0,0,0
"Zambia","2024-09-07",0,0,0,0,0,0,0,0
"Zambia","2024-09-08",0,0,0,0,0,0,0,0
"Zambia","2024-09-09",0,0,0,0,0,0,0,0
"Zambia","2024-09-10",0,0,0,0,0,0,0,0
"Zambia","2024-09-11",0,0,0,0,0,0,0,0
"Zambia","2024-09-12",0,0,0,0,0,0,0,0
"Zambia","2024-09-13",0,0,0,0,0,0,0,0
"Zambia","2024-09-14",0,0,0,0,0,0,0,0
"Zambia","2024-09-15",0,0,0,0,0,0,0,0
"Zambia","2024-09-16",0,0,0,0,0,0,0,0
"Zambia","2024-09-17",0,0,0,0,0,0,0,0
"Zambia","2024-09-18",0,0,0,0,0,0,0,0
"Zambia","2024-09-19",0,0,0,0,0,0,0,0
"Zambia","2024-09-20",0,0,0,0,0,0,0,0
"Zambia","2024-09-21",0,0,0,0,0,0,0,0
"Zambia","2024-09-22",0,0,0,0,0,0,0,0
"Zambia","2024-09-23",0,0,0,0,0,0,0,0
"Zambia","2024-09-24",0,0,0,0,0,0,0,0
"Zambia","2024-09-25",0,0,0,0,0,0,0,0
"Zambia","2024-09-26",0,0,0,0,0,0,0,0
"Zambia","2024-09-27",0,0,0,0,0,0,0,0
"Zambia","2024-09-28",0,0,0,0,0,0,0,0
"Zambia","2024-09-29",0,0,0,0,0,0,0,0
"Zambia","2024-09-30",0,0,0,0,0,0,0,0
"Zambia","2024-10-01",0,0,0,0,0,0,0,0
"Zambia","2024-10-02",0,0,0,0,0,0,0,0
"Zambia","2024-10-03",0,0,0,0,0,0,0,0
"Zambia","2024-10-04",0,0,0,0,0,0,0,0
"Zambia","2024-10-05",0,0,0,0,0,0,0,0
"Zambia","2024-10-06",0,0,0,0,0,0,0,0
"Zambia","2024-10-07",0,0,0,0,0,0,0,0
"Zambia","2024-10-08",0,0,0,0,0,0,0,0
"Zambia","2024-10-09",0,0,0,0,0,0,0,0
"Zambia","2024-10-10",0,0,0,0,0,0,0,0
"Zambia","2024-10-11",0,0,0,0,0,0,0,0
"Zambia","2024-10-12",0,1,1,0,1,1,0,0
"Zambia","2024-10-13",0,0,1,0,0,1,0,0
"Zambia","2024-10-14",0,0,1,0,0,1,0,0
"Zambia","2024-10-15",0,0,1,0,0,1,0,0
"Zambia","2024-10-16",0,0,1,0,0,1,0,0
"Zambia","2024-10-17",0,0,1,0,0,1,0,0
"Zambia","2024-10-18",0,0,1,0,0,1,0,0
"Zambia","2024-10-19",0,0,1,0,0,1,0,0
"Zambia","2024-10-20",0,0,1,0,0,1,0,0
"Zambia","2024-10-21",0,0,1,0,0,1,0,0
"Zambia","2024-10-22",0,0,1,0,0,1,0,0
"Zambia","2024-10-23",0,0,1,0,0,1,0,0
"Zambia","2024-10-24",0,0,1,0,0,1,0,0
"Zambia","2024-10-25",0,0,1,0,0,1,0,0
"Zambia","2024-10-26",0,0,1,0,0,1,0,0
"Zambia","2024-10-27",0,0,1,0,0,1,0,0
"Zambia","2024-10-28",0,0,1,0,0,1,0,0
"Zambia","2024-10-29",0,0,1,0,0,1,0,0
"Zambia","2024-10-30",0,0,1,0,0,1,0,0
"Zambia","2024-10-31",0,0,1,0,0,1,0,0
"Zambia","2024-11-01",0,0,1,0,0,1,0,0
"Zambia","2024-11-02",0,0,1,0,0,1,0,0
"Zambia","2024-11-03",0,0,1,0,0,1,0,0
"Zambia","2024-11-04",0,0,1,0,0,1,0,0
"Zambia","2024-11-05",0,0,1,0,0,1,0,0
"Zambia","2024-11-06",0,0,1,0,0,1,0,0
"Zambia","2024-11-07",0,0,1,0,0,1,0,0
"Zambia","2024-11-08",0,0,1,0,0,1,0,0
"Zambia","2024-11-09",0,0,1,0,0,1,0,0
"Zambia","2024-11-10",0,0,1,0,0,1,0,0
"Zambia","2024-11-11",0,0,1,0,0,1,0,0
"Zambia","2024-11-12",0,0,1,0,0,1,0,0
"Zambia","2024-11-13",0,0,1,0,0,1,0,0
"Zambia","2024-11-14",0,0,1,0,0,1,0,0
"Zambia","2024-11-15",0,0,1,0,0,1,0,0
"Zambia","2024-11-16",0,0,1,0,0,1,0,0
"Zambia","2024-11-17",0,0,1,0,0,1,0,0
"Zambia","2024-11-18",0,0,1,0,0,1,0,0
"Zambia","2024-11-19",0,0,1,0,0,1,0,0
"Zambia","2024-11-20",0,0,1,0,0,1,0,0
"Zambia","2024-11-21",0,0,1,0,0,1,0,0
"Zambia","2024-11-22",0,0,1,0,0,1,0,0
"Zambia","2024-11-23",0,0,1,0,0,1,0,0
"Zambia","2024-11-24",0,0,1,0,0,1,0,0
"Zambia","2024-11-25",0,0,1,0,0,1,0,0
"Zambia","2024-11-26",0,0,1,0,0,1,0,0
"Zambia","2024-11-27",0,0,1,0,0,1,0,0
"Zambia","2024-11-28",0,0,1,0,0,1,0,0
"Zambia","2024-11-29",0,0,1,0,0,1,0,0
"Zambia","2024-11-30",0,0,1,0,0,1,0,0
"Zambia","2024-12-01",0,0,1,0,0,1,0,0
"Zambia","2024-12-02",0,0,1,0,0,1,0,0
"Zambia","2024-12-03",0,0,1,0,0,1,0,0
"Zambia","2024-12-04",0,0,1,0,0,1,0,0
"Zambia","2024-12-05",0,0,1,0,0,1,0,0
"Zambia","2024-12-06",0,0,1,0,0,1,0,0
"Zambia","2024-12-07",0,0,1,0,0,1,0,0
"Zambia","2024-12-08",0,0,1,0,0,1,0,0
"Zambia","2024-12-09",0,0,1,0,0,1,0,0
"Zambia","2024-12-10",0,0,1,0,0,1,0,0
"Zambia","2024-12-11",0,0,1,0,0,1,0,0
"Zambia","2024-12-12",0,0,1,0,0,1,0,0
"Zambia","2024-12-13",0,0,1,0,0,1,0,0
"Zambia","2024-12-14",0,0,1,0,0,1,0,0
"Zambia","2024-12-15",0,0,1,0,0,1,0,0
"Zambia","2024-12-16",0,0,1,0,0,1,0,0
"Zambia","2024-12-17",0,0,1,0,0,1,0,0
"Zambia","2024-12-18",0,0,1,0,0,1,0,0
"Zambia","2024-12-19",0,0,1,0,0,1,0,0
"Zambia","2024-12-20",0,0,1,0,0,1,0,0
"Zambia","2024-12-21",0,0,1,0,0,1,0,0
"Zambia","2024-12-22",0,0,1,0,0,1,0,0
"Zambia","2024-12-23",0,0,1,0,0,1,0,0
"Zambia","2024-12-24",0,0,1,0,0,1,0,0
"Zambia","2024-12-25",0,0,1,0,0,1,0,0
"Zambia","2024-12-26",0,0,1,0,0,1,0,0
"Zambia","2024-12-27",0,0,1,0,0,1,0,0
"Zambia","2024-12-28",0,0,1,0,0,1,0,0
"Zambia","2024-12-29",0,0,1,0,0,1,0,0
"Zambia","2024-12-30",0,0,1,0,0,1,0,0
"Zambia","2024-12-31",0,0,1,0,0,1,0,0
"Zambia","2025-01-01",0,0,1,0,0,1,0,0
"Zambia","2025-01-02",0,0,1,0,0,1,0,0
"Zambia","2025-01-03",0,0,1,0,0,1,0,0
"Zambia","2025-01-04",0,0,1,0,0,1,0,0
"Zambia","2025-01-05",0,0,1,0,0,1,0,0
"Zambia","2025-01-06",0,0,1,0,0,1,0,0
"Zambia","2025-01-07",0,0,1,0,0,1,0,0
"Zambia","2025-01-08",0,0,1,0,0,1,0,0
"Zambia","2025-01-09",0,0,1,0,0,1,0,0
"Zambia","2025-01-10",0,0,1,0,0,1,0,0
"Zambia","2025-01-11",0,0,1,0,0,1,0,0
"Zambia","2025-01-12",0,0,1,0,0,1,0,0
"Zambia","2025-01-13",0,0,1,0,0,1,0,0
"Zimbabwe","2024-01-01",0,0,0,0,0,0,0,0
"Zimbabwe","2024-01-02",0,0,0,0,0,0,0,0
"Zimbabwe","2024-01-03",0,0,0,0,0,0,0,0
"Zimbabwe","2024-01-04",0,0,0,0,0,0,0,0
"Zimbabwe","2024-01-05",0,0,0,0,0,0,0,0
"Zimbabwe","2024-01-06",0,0,0,0,0,0,0,0
"Zimbabwe","2024-01-07",0,0,0,0,0,0,0,0
"Zimbabwe","2024-01-08",0,0,0,0,0,0,0,0
"Zimbabwe","2024-01-09",0,0,0,0,0,0,0,0
"Zimbabwe","2024-01-10",0,0,0,0,0,0,0,0
"Zimbabwe","2024-01-11",0,0,0,0,0,0,0,0
"Zimbabwe","2024-01-12",0,0,0,0,0,0,0,0
"Zimbabwe","2024-01-13",0,0,0,0,0,0,0,0
"Zimbabwe","2024-01-14",0,0,0,0,0,0,0,0
"Zimbabwe","2024-01-15",0,0,0,0,0,0,0,0
"Zimbabwe","2024-01-16",0,0,0,0,0,0,0,0
"Zimbabwe","2024-01-17",0,0,0,0,0,0,0,0
"Zimbabwe","2024-01-18",0,0,0,0,0,0,0,0
"Zimbabwe","2024-01-19",0,0,0,0,0,0,0,0
"Zimbabwe","2024-01-20",0,0,0,0,0,0,0,0
"Zimbabwe","2024-01-21",0,0,0,0,0,0,0,0
"Zimbabwe","2024-01-22",0,0,0,0,0,0,0,0
"Zimbabwe","2024-01-23",0,0,0,0,0,0,0,0
"Zimbabwe","2024-01-24",0,0,0,0,0,0,0,0
"Zimbabwe","2024-01-25",0,0,0,0,0,0,0,0
"Zimbabwe","2024-01-26",0,0,0,0,0,0,0,0
"Zimbabwe","2024-01-27",0,0,0,0,0,0,0,0
"Zimbabwe","2024-01-28",0,0,0,0,0,0,0,0
"Zimbabwe","2024-01-29",0,0,0,0,0,0,0,0
"Zimbabwe","2024-01-30",0,0,0,0,0,0,0,0
"Zimbabwe","2024-01-31",0,0,0,0,0,0,0,0
"Zimbabwe","2024-02-01",0,0,0,0,0,0,0,0
"Zimbabwe","2024-02-02",0,0,0,0,0,0,0,0
"Zimbabwe","2024-02-03",0,0,0,0,0,0,0,0
"Zimbabwe","2024-02-04",0,0,0,0,0,0,0,0
"Zimbabwe","2024-02-05",0,0,0,0,0,0,0,0
"Zimbabwe","2024-02-06",0,0,0,0,0,0,0,0
"Zimbabwe","2024-02-07",0,0,0,0,0,0,0,0
"Zimbabwe","2024-02-08",0,0,0,0,0,0,0,0
"Zimbabwe","2024-02-09",0,0,0,0,0,0,0,0
"Zimbabwe","2024-02-10",0,0,0,0,0,0,0,0
"Zimbabwe","2024-02-11",0,0,0,0,0,0,0,0
"Zimbabwe","2024-02-12",0,0,0,0,0,0,0,0
"Zimbabwe","2024-02-13",0,0,0,0,0,0,0,0
"Zimbabwe","2024-02-14",0,0,0,0,0,0,0,0
"Zimbabwe","2024-02-15",0,0,0,0,0,0,0,0
"Zimbabwe","2024-02-16",0,0,0,0,0,0,0,0
"Zimbabwe","2024-02-17",0,0,0,0,0,0,0,0
"Zimbabwe","2024-02-18",0,0,0,0,0,0,0,0
"Zimbabwe","2024-02-19",0,0,0,0,0,0,0,0
"Zimbabwe","2024-02-20",0,0,0,0,0,0,0,0
"Zimbabwe","2024-02-21",0,0,0,0,0,0,0,0
"Zimbabwe","2024-02-22",0,0,0,0,0,0,0,0
"Zimbabwe","2024-02-23",0,0,0,0,0,0,0,0
"Zimbabwe","2024-02-24",0,0,0,0,0,0,0,0
"Zimbabwe","2024-02-25",0,0,0,0,0,0,0,0
"Zimbabwe","2024-02-26",0,0,0,0,0,0,0,0
"Zimbabwe","2024-02-27",0,0,0,0,0,0,0,0
"Zimbabwe","2024-02-28",0,0,0,0,0,0,0,0
"Zimbabwe","2024-02-29",0,0,0,0,0,0,0,0
"Zimbabwe","2024-03-01",0,0,0,0,0,0,0,0
"Zimbabwe","2024-03-02",0,0,0,0,0,0,0,0
"Zimbabwe","2024-03-03",0,0,0,0,0,0,0,0
"Zimbabwe","2024-03-04",0,0,0,0,0,0,0,0
"Zimbabwe","2024-03-05",0,0,0,0,0,0,0,0
"Zimbabwe","2024-03-06",0,0,0,0,0,0,0,0
"Zimbabwe","2024-03-07",0,0,0,0,0,0,0,0
"Zimbabwe","2024-03-08",0,0,0,0,0,0,0,0
"Zimbabwe","2024-03-09",0,0,0,0,0,0,0,0
"Zimbabwe","2024-03-10",0,0,0,0,0,0,0,0
"Zimbabwe","2024-03-11",0,0,0,0,0,0,0,0
"Zimbabwe","2024-03-12",0,0,0,0,0,0,0,0
"Zimbabwe","2024-03-13",0,0,0,0,0,0,0,0
"Zimbabwe","2024-03-14",0,0,0,0,0,0,0,0
"Zimbabwe","2024-03-15",0,0,0,0,0,0,0,0
"Zimbabwe","2024-03-16",0,0,0,0,0,0,0,0
"Zimbabwe","2024-03-17",0,0,0,0,0,0,0,0
"Zimbabwe","2024-03-18",0,0,0,0,0,0,0,0
"Zimbabwe","2024-03-19",0,0,0,0,0,0,0,0
"Zimbabwe","2024-03-20",0,0,0,0,0,0,0,0
"Zimbabwe","2024-03-21",0,0,0,0,0,0,0,0
"Zimbabwe","2024-03-22",0,0,0,0,0,0,0,0
"Zimbabwe","2024-03-23",0,0,0,0,0,0,0,0
"Zimbabwe","2024-03-24",0,0,0,0,0,0,0,0
"Zimbabwe","2024-03-25",0,0,0,0,0,0,0,0
"Zimbabwe","2024-03-26",0,0,0,0,0,0,0,0
"Zimbabwe","2024-03-27",0,0,0,0,0,0,0,0
"Zimbabwe","2024-03-28",0,0,0,0,0,0,0,0
"Zimbabwe","2024-03-29",0,0,0,0,0,0,0,0
"Zimbabwe","2024-03-30",0,0,0,0,0,0,0,0
"Zimbabwe","2024-03-31",0,0,0,0,0,0,0,0
"Zimbabwe","2024-04-01",0,0,0,0,0,0,0,0
"Zimbabwe","2024-04-02",0,0,0,0,0,0,0,0
"Zimbabwe","2024-04-03",0,0,0,0,0,0,0,0
"Zimbabwe","2024-04-04",0,0,0,0,0,0,0,0
"Zimbabwe","2024-04-05",0,0,0,0,0,0,0,0
"Zimbabwe","2024-04-06",0,0,0,0,0,0,0,0
"Zimbabwe","2024-04-07",0,0,0,0,0,0,0,0
"Zimbabwe","2024-04-08",0,0,0,0,0,0,0,0
"Zimbabwe","2024-04-09",0,0,0,0,0,0,0,0
"Zimbabwe","2024-04-10",0,0,0,0,0,0,0,0
"Zimbabwe","2024-04-11",0,0,0,0,0,0,0,0
"Zimbabwe","2024-04-12",0,0,0,0,0,0,0,0
"Zimbabwe","2024-04-13",0,0,0,0,0,0,0,0
"Zimbabwe","2024-04-14",0,0,0,0,0,0,0,0
"Zimbabwe","2024-04-15",0,0,0,0,0,0,0,0
"Zimbabwe","2024-04-16",0,0,0,0,0,0,0,0
"Zimbabwe","2024-04-17",0,0,0,0,0,0,0,0
"Zimbabwe","2024-04-18",0,0,0,0,0,0,0,0
"Zimbabwe","2024-04-19",0,0,0,0,0,0,0,0
"Zimbabwe","2024-04-20",0,0,0,0,0,0,0,0
"Zimbabwe","2024-04-21",0,0,0,0,0,0,0,0
"Zimbabwe","2024-04-22",0,0,0,0,0,0,0,0
"Zimbabwe","2024-04-23",0,0,0,0,0,0,0,0
"Zimbabwe","2024-04-24",0,0,0,0,0,0,0,0
"Zimbabwe","2024-04-25",0,0,0,0,0,0,0,0
"Zimbabwe","2024-04-26",0,0,0,0,0,0,0,0
"Zimbabwe","2024-04-27",0,0,0,0,0,0,0,0
"Zimbabwe","2024-04-28",0,0,0,0,0,0,0,0
"Zimbabwe","2024-04-29",0,0,0,0,0,0,0,0
"Zimbabwe","2024-04-30",0,0,0,0,0,0,0,0
"Zimbabwe","2024-05-01",0,0,0,0,0,0,0,0
"Zimbabwe","2024-05-02",0,0,0,0,0,0,0,0
"Zimbabwe","2024-05-03",0,0,0,0,0,0,0,0
"Zimbabwe","2024-05-04",0,0,0,0,0,0,0,0
"Zimbabwe","2024-05-05",0,0,0,0,0,0,0,0
"Zimbabwe","2024-05-06",0,0,0,0,0,0,0,0
"Zimbabwe","2024-05-07",0,0,0,0,0,0,0,0
"Zimbabwe","2024-05-08",0,0,0,0,0,0,0,0
"Zimbabwe","2024-05-09",0,0,0,0,0,0,0,0
"Zimbabwe","2024-05-10",0,0,0,0,0,0,0,0
"Zimbabwe","2024-05-11",0,0,0,0,0,0,0,0
"Zimbabwe","2024-05-12",0,0,0,0,0,0,0,0
"Zimbabwe","2024-05-13",0,0,0,0,0,0,0,0
"Zimbabwe","2024-05-14",0,0,0,0,0,0,0,0
"Zimbabwe","2024-05-15",0,0,0,0,0,0,0,0
"Zimbabwe","2024-05-16",0,0,0,0,0,0,0,0
"Zimbabwe","2024-05-17",0,0,0,0,0,0,0,0
"Zimbabwe","2024-05-18",0,0,0,0,0,0,0,0
"Zimbabwe","2024-05-19",0,0,0,0,0,0,0,0
"Zimbabwe","2024-05-20",0,0,0,0,0,0,0,0
"Zimbabwe","2024-05-21",0,0,0,0,0,0,0,0
"Zimbabwe","2024-05-22",0,0,0,0,0,0,0,0
"Zimbabwe","2024-05-23",0,0,0,0,0,0,0,0
"Zimbabwe","2024-05-24",0,0,0,0,0,0,0,0
"Zimbabwe","2024-05-25",0,0,0,0,0,0,0,0
"Zimbabwe","2024-05-26",0,0,0,0,0,0,0,0
"Zimbabwe","2024-05-27",0,0,0,0,0,0,0,0
"Zimbabwe","2024-05-28",0,0,0,0,0,0,0,0
"Zimbabwe","2024-05-29",0,0,0,0,0,0,0,0
"Zimbabwe","2024-05-30",0,0,0,0,0,0,0,0
"Zimbabwe","2024-05-31",0,0,0,0,0,0,0,0
"Zimbabwe","2024-06-01",0,0,0,0,0,0,0,0
"Zimbabwe","2024-06-02",0,0,0,0,0,0,0,0
"Zimbabwe","2024-06-03",0,0,0,0,0,0,0,0
"Zimbabwe","2024-06-04",0,0,0,0,0,0,0,0
"Zimbabwe","2024-06-05",0,0,0,0,0,0,0,0
"Zimbabwe","2024-06-06",0,0,0,0,0,0,0,0
"Zimbabwe","2024-06-07",0,0,0,0,0,0,0,0
"Zimbabwe","2024-06-08",0,0,0,0,0,0,0,0
"Zimbabwe","2024-06-09",0,0,0,0,0,0,0,0
"Zimbabwe","2024-06-10",0,0,0,0,0,0,0,0
"Zimbabwe","2024-06-11",0,0,0,0,0,0,0,0
"Zimbabwe","2024-06-12",0,0,0,0,0,0,0,0
"Zimbabwe","2024-06-13",0,0,0,0,0,0,0,0
"Zimbabwe","2024-06-14",0,0,0,0,0,0,0,0
"Zimbabwe","2024-06-15",0,0,0,0,0,0,0,0
"Zimbabwe","2024-06-16",0,0,0,0,0,0,0,0
"Zimbabwe","2024-06-17",0,0,0,0,0,0,0,0
"Zimbabwe","2024-06-18",0,0,0,0,0,0,0,0
"Zimbabwe","2024-06-19",0,0,0,0,0,0,0,0
"Zimbabwe","2024-06-20",0,0,0,0,0,0,0,0
"Zimbabwe","2024-06-21",0,0,0,0,0,0,0,0
"Zimbabwe","2024-06-22",0,0,0,0,0,0,0,0
"Zimbabwe","2024-06-23",0,0,0,0,0,0,0,0
"Zimbabwe","2024-06-24",0,0,0,0,0,0,0,0
"Zimbabwe","2024-06-25",0,0,0,0,0,0,0,0
"Zimbabwe","2024-06-26",0,0,0,0,0,0,0,0
"Zimbabwe","2024-06-27",0,0,0,0,0,0,0,0
"Zimbabwe","2024-06-28",0,0,0,0,0,0,0,0
"Zimbabwe","2024-06-29",0,0,0,0,0,0,0,0
"Zimbabwe","2024-06-30",0,0,0,0,0,0,0,0
"Zimbabwe","2024-07-01",0,0,0,0,0,0,0,0
"Zimbabwe","2024-07-02",0,0,0,0,0,0,0,0
"Zimbabwe","2024-07-03",0,0,0,0,0,0,0,0
"Zimbabwe","2024-07-04",0,0,0,0,0,0,0,0
"Zimbabwe","2024-07-05",0,0,0,0,0,0,0,0
"Zimbabwe","2024-07-06",0,0,0,0,0,0,0,0
"Zimbabwe","2024-07-07",0,0,0,0,0,0,0,0
"Zimbabwe","2024-07-08",0,0,0,0,0,0,0,0
"Zimbabwe","2024-07-09",0,0,0,0,0,0,0,0
"Zimbabwe","2024-07-10",0,0,0,0,0,0,0,0
"Zimbabwe","2024-07-11",0,0,0,0,0,0,0,0
"Zimbabwe","2024-07-12",0,0,0,0,0,0,0,0
"Zimbabwe","2024-07-13",0,0,0,0,0,0,0,0
"Zimbabwe","2024-07-14",0,0,0,0,0,0,0,0
"Zimbabwe","2024-07-15",0,0,0,0,0,0,0,0
"Zimbabwe","2024-07-16",0,0,0,0,0,0,0,0
"Zimbabwe","2024-07-17",0,0,0,0,0,0,0,0
"Zimbabwe","2024-07-18",0,0,0,0,0,0,0,0
"Zimbabwe","2024-07-19",0,0,0,0,0,0,0,0
"Zimbabwe","2024-07-20",0,0,0,0,0,0,0,0
"Zimbabwe","2024-07-21",0,0,0,0,0,0,0,0
"Zimbabwe","2024-07-22",0,0,0,0,0,0,0,0
"Zimbabwe","2024-07-23",0,0,0,0,0,0,0,0
"Zimbabwe","2024-07-24",0,0,0,0,0,0,0,0
"Zimbabwe","2024-07-25",0,0,0,0,0,0,0,0
"Zimbabwe","2024-07-26",0,0,0,0,0,0,0,0
"Zimbabwe","2024-07-27",0,0,0,0,0,0,0,0
"Zimbabwe","2024-07-28",0,0,0,0,0,0,0,0
"Zimbabwe","2024-07-29",0,0,0,0,0,0,0,0
"Zimbabwe","2024-07-30",0,0,0,0,0,0,0,0
"Zimbabwe","2024-07-31",0,0,0,0,0,0,0,0
"Zimbabwe","2024-08-01",0,0,0,0,0,0,0,0
"Zimbabwe","2024-08-02",0,0,0,0,0,0,0,0
"Zimbabwe","2024-08-03",0,0,0,0,0,0,0,0
"Zimbabwe","2024-08-04",0,0,0,0,0,0,0,0
"Zimbabwe","2024-08-05",0,0,0,0,0,0,0,0
"Zimbabwe","2024-08-06",0,0,0,0,0,0,0,0
"Zimbabwe","2024-08-07",0,0,0,0,0,0,0,0
"Zimbabwe","2024-08-08",0,0,0,0,0,0,0,0
"Zimbabwe","2024-08-09",0,0,0,0,0,0,0,0
"Zimbabwe","2024-08-10",0,0,0,0,0,0,0,0
"Zimbabwe","2024-08-11",0,0,0,0,0,0,0,0
"Zimbabwe","2024-08-12",0,0,0,0,0,0,0,0
"Zimbabwe","2024-08-13",0,0,0,0,0,0,0,0
"Zimbabwe","2024-08-14",0,0,0,0,0,0,0,0
"Zimbabwe","2024-08-15",0,0,0,0,0,0,0,0
"Zimbabwe","2024-08-16",0,0,0,0,0,0,0,0
"Zimbabwe","2024-08-17",0,0,0,0,0,0,0,0
"Zimbabwe","2024-08-18",0,0,0,0,0,0,0,0
"Zimbabwe","2024-08-19",0,0,0,0,0,0,0,0
"Zimbabwe","2024-08-20",0,0,0,0,0,0,0,0
"Zimbabwe","2024-08-21",0,0,0,0,0,0,0,0
"Zimbabwe","2024-08-22",0,0,0,0,0,0,0,0
"Zimbabwe","2024-08-23",0,0,0,0,0,0,0,0
"Zimbabwe","2024-08-24",0,0,0,0,0,0,0,0
"Zimbabwe","2024-08-25",0,0,0,0,0,0,0,0
"Zimbabwe","2024-08-26",0,0,0,0,0,0,0,0
"Zimbabwe","2024-08-27",0,0,0,0,0,0,0,0
"Zimbabwe","2024-08-28",0,0,0,0,0,0,0,0
"Zimbabwe","2024-08-29",0,0,0,0,0,0,0,0
"Zimbabwe","2024-08-30",0,0,0,0,0,0,0,0
"Zimbabwe","2024-08-31",0,0,0,0,0,0,0,0
"Zimbabwe","2024-09-01",0,0,0,0,0,0,0,0
"Zimbabwe","2024-09-02",0,0,0,0,0,0,0,0
"Zimbabwe","2024-09-03",0,0,0,0,0,0,0,0
"Zimbabwe","2024-09-04",0,0,0,0,0,0,0,0
"Zimbabwe","2024-09-05",0,0,0,0,0,0,0,0
"Zimbabwe","2024-09-06",0,0,0,0,0,0,0,0
"Zimbabwe","2024-09-07",0,0,0,0,0,0,0,0
"Zimbabwe","2024-09-08",0,0,0,0,0,0,0,0
"Zimbabwe","2024-09-09",0,0,0,0,0,0,0,0
"Zimbabwe","2024-09-10",0,0,0,0,0,0,0,0
"Zimbabwe","2024-09-11",0,0,0,0,0,0,0,0
"Zimbabwe","2024-09-12",0,0,0,0,0,0,0,0
"Zimbabwe","2024-09-13",0,0,0,0,0,0,0,0
"Zimbabwe","2024-09-14",0,0,0,0,0,0,0,0
"Zimbabwe","2024-09-15",0,0,0,0,0,0,0,0
"Zimbabwe","2024-09-16",0,0,0,0,0,0,0,0
"Zimbabwe","2024-09-17",0,0,0,0,0,0,0,0
"Zimbabwe","2024-09-18",0,0,0,0,0,0,0,0
"Zimbabwe","2024-09-19",0,0,0,0,0,0,0,0
"Zimbabwe","2024-09-20",0,0,0,0,0,0,0,0
"Zimbabwe","2024-09-21",0,0,0,0,0,0,0,0
"Zimbabwe","2024-09-22",0,0,0,0,0,0,0,0
"Zimbabwe","2024-09-23",0,0,0,0,0,0,0,0
"Zimbabwe","2024-09-24",0,0,0,0,0,0,0,0
"Zimbabwe","2024-09-25",0,0,0,0,0,0,0,0
"Zimbabwe","2024-09-26",0,0,0,0,0,0,0,0
"Zimbabwe","2024-09-27",0,0,0,0,0,0,0,0
"Zimbabwe","2024-09-28",0,0,0,0,0,0,0,0
"Zimbabwe","2024-09-29",0,0,0,0,0,0,0,0
"Zimbabwe","2024-09-30",0,0,0,0,0,0,0,0
"Zimbabwe","2024-10-01",0,0,0,0,0,0,0,0
"Zimbabwe","2024-10-02",0,0,0,0,0,0,0,0
"Zimbabwe","2024-10-03",0,0,0,0,0,0,0,0
"Zimbabwe","2024-10-04",0,0,0,0,0,0,0,0
"Zimbabwe","2024-10-05",0,0,0,0,0,0,0,0
"Zimbabwe","2024-10-06",0,0,0,0,0,0,0,0
"Zimbabwe","2024-10-07",0,0,0,0,0,0,0,0
"Zimbabwe","2024-10-08",0,0,0,0,0,0,0,0
"Zimbabwe","2024-10-09",0,0,0,0,0,0,0,0
"Zimbabwe","2024-10-10",0,0,0,0,0,0,0,0
"Zimbabwe","2024-10-11",0,0,0,0,0,0,0,0
"Zimbabwe","2024-10-12",0,0,0,0,0,0,0,0
"Zimbabwe","2024-10-13",0,2,2,0,2,2,0,0
"Zimbabwe","2024-10-14",0,0,2,0,0,2,0,0
"Zimbabwe","2024-10-15",0,0,2,0,0,2,0,0
"Zimbabwe","2024-10-16",0,0,2,0,0,2,0,0
"Zimbabwe","2024-10-17",0,0,2,0,0,2,0,0
"Zimbabwe","2024-10-18",0,0,2,0,0,2,0,0
"Zimbabwe","2024-10-19",0,0,2,0,0,2,0,0
"Zimbabwe","2024-10-20",0,0,2,0,0,2,0,0
"Zimbabwe","2024-10-21",0,0,2,0,0,2,0,0
"Zimbabwe","2024-10-22",0,0,2,0,0,2,0,0
"Zimbabwe","2024-10-23",0,0,2,0,0,2,0,0
"Zimbabwe","2024-10-24",0,0,2,0,0,2,0,0
"Zimbabwe","2024-10-25",0,0,2,0,0,2,0,0
"Zimbabwe","2024-10-26",0,0,2,0,0,2,0,0
"Zimbabwe","2024-10-27",0,0,2,0,0,2,0,0
"Zimbabwe","2024-10-28",0,0,2,0,0,2,0,0
"Zimbabwe","2024-10-29",0,0,2,0,0,2,0,0
"Zimbabwe","2024-10-30",0,0,2,0,0,2,0,0
"Zimbabwe","2024-10-31",0,0,2,0,0,2,0,0
"Zimbabwe","2024-11-01",0,0,2,0,0,2,0,0
"Zimbabwe","2024-11-02",0,0,2,0,0,2,0,0
"Zimbabwe","2024-11-03",0,0,2,0,0,2,0,0
"Zimbabwe","2024-11-04",0,0,2,0,0,2,0,0
"Zimbabwe","2024-11-05",0,0,2,0,0,2,0,0
"Zimbabwe","2024-11-06",0,0,2,0,0,2,0,0
"Zimbabwe","2024-11-07",0,0,2,0,0,2,0,0
"Zimbabwe","2024-11-08",0,0,2,0,0,2,0,0
"Zimbabwe","2024-11-09",0,0,2,0,0,2,0,0
"Zimbabwe","2024-11-10",0,0,2,0,0,2,0,0
"Zimbabwe","2024-11-11",0,0,2,0,0,2,0,0
"Zimbabwe","2024-11-12",0,0,2,0,0,2,0,0
"Zimbabwe","2024-11-13",0,0,2,0,0,2,0,0
"Zimbabwe","2024-11-14",0,0,2,0,0,2,0,0
"Zimbabwe","2024-11-15",0,0,2,0,0,2,0,0
"Zimbabwe","2024-11-16",0,0,2,0,0,2,0,0
"Zimbabwe","2024-11-17",0,0,2,0,0,2,0,0
"Zimbabwe","2024-11-18",0,0,2,0,0,2,0,0
"Zimbabwe","2024-11-19",0,0,2,0,0,2,0,0
"Zimbabwe","2024-11-20",0,0,2,0,0,2,0,0
"Zimbabwe","2024-11-21",0,0,2,0,0,2,0,0
"Zimbabwe","2024-11-22",0,0,2,0,0,2,0,0
"Zimbabwe","2024-11-23",0,0,2,0,0,2,0,0
"Zimbabwe","2024-11-24",0,0,2,0,0,2,0,0
"Zimbabwe","2024-11-25",0,0,2,0,0,2,0,0
"Zimbabwe","2024-11-26",0,0,2,0,0,2,0,0
"Zimbabwe","2024-11-27",0,0,2,0,0,2,0,0
"Zimbabwe","2024-11-28",0,0,2,0,0,2,0,0
"Zimbabwe","2024-11-29",0,0,2,0,0,2,0,0
"Zimbabwe","2024-11-30",0,0,2,0,0,2,0,0
"Zimbabwe","2024-12-01",0,0,2,0,0,2,0,0
"Zimbabwe","2024-12-02",0,0,2,0,0,2,0,0
"Zimbabwe","2024-12-03",0,0,2,0,0,2,0,0
"Zimbabwe","2024-12-04",0,0,2,0,0,2,0,0
"Zimbabwe","2024-12-05",0,0,2,0,0,2,0,0
"Zimbabwe","2024-12-06",0,0,2,0,0,2,0,0
"Zimbabwe","2024-12-07",0,0,2,0,0,2,0,0
"Zimbabwe","2024-12-08",0,0,2,0,0,2,0,0
"Zimbabwe","2024-12-09",0,0,2,0,0,2,0,0
"Zimbabwe","2024-12-10",0,0,2,0,0,2,0,0
"Zimbabwe","2024-12-11",0,0,2,0,0,2,0,0
"Zimbabwe","2024-12-12",0,0,2,0,0,2,0,0
"Zimbabwe","2024-12-13",0,0,2,0,0,2,0,0
"Zimbabwe","2024-12-14",0,0,2,0,0,2,0,0
"Zimbabwe","2024-12-15",0,0,2,0,0,2,0,0
"Zimbabwe","2024-12-16",0,0,2,0,0,2,0,0
"Zimbabwe","2024-12-17",0,0,2,0,0,2,0,0
"Zimbabwe","2024-12-18",0,0,2,0,0,2,0,0
"Zimbabwe","2024-12-19",0,0,2,0,0,2,0,0
"Zimbabwe","2024-12-20",0,0,2,0,0,2,0,0
"Zimbabwe","2024-12-21",0,0,2,0,0,2,0,0
"Zimbabwe","2024-12-22",0,0,2,0,0,2,0,0
"Zimbabwe","2024-12-23",0,0,2,0,0,2,0,0
"Zimbabwe","2024-12-24",0,0,2,0,0,2,0,0
"Zimbabwe","2024-12-25",0,0,2,0,0,2,0,0
"Zimbabwe","2024-12-26",0,0,2,0,0,2,0,0
"Zimbabwe","2024-12-27",0,0,2,0,0,2,0,0
"Zimbabwe","2024-12-28",0,0,2,0,0,2,0,0
"Zimbabwe","2024-12-29",0,0,2,0,0,2,0,0
"Zimbabwe","2024-12-30",0,0,2,0,0,2,0,0
"Zimbabwe","2024-12-31",0,0,2,0,0,2,0,0
"Zimbabwe","2025-01-01",0,0,2,0,0,2,0,0
"Zimbabwe","2025-01-02",0,0,2,0,0,2,0,0
"Zimbabwe","2025-01-03",0,0,2,0,0,2,0,0
"Zimbabwe","2025-01-04",0,0,2,0,0,2,0,0
"Zimbabwe","2025-01-05",0,0,2,0,0,2,0,0
"Zimbabwe","2025-01-06",0,0,2,0,0,2,0,0
"Zimbabwe","2025-01-07",0,0,2,0,0,2,0,0
"Zimbabwe","2025-01-08",0,0,2,0,0,2,0,0
"Zimbabwe","2025-01-09",0,0,2,0,0,2,0,0
"Zimbabwe","2025-01-10",0,0,2,0,0,2,0,0
"Zimbabwe","2025-01-11",0,0,2,0,0,2,0,0
"Zimbabwe","2025-01-12",0,0,2,0,0,2,0,0
"Zimbabwe","2025-01-13",0,0,2,0,0,2,0,0
