"location","date","new_suspected_cases_calc_owd","new_confirmed_cases_calc_owd","cum_confirmed_cases_calc_owd","cum_suspected_cases_calc_owd","all_new_confirmed_cases_owd","all_cum_confirmed_cases_owd","all_new_suspected_cases_owd","all_cum_suspected_cases_owd"
"Africa","2024-01-01",0,0,0,0,0,0,0,0
"Africa","2024-01-02",0,0,0,0,0,0,0,0
"Africa","2024-01-03",0,0,0,0,0,0,0,0
"Africa","2024-01-04",0,0,0,0,0,0,0,0
"Africa","2024-01-05",0,0,0,0,0,0,0,0
"Africa","2024-01-06",0,0,0,0,0,0,0,0
"Africa","2024-01-07",0,37,37,0,37,37,0,0
"Africa","2024-01-08",0,0,37,0,0,37,0,0
"Africa","2024-01-09",0,1,38,0,1,38,0,0
"Africa","2024-01-10",0,0,38,0,8,46,0,0
"Africa","2024-01-11",0,0,38,0,7,53,0,0
"Africa","2024-01-12",0,0,38,0,8,61,0,0
"Africa","2024-01-13",0,0,38,0,7,68,0,0
"Africa","2024-01-14",0,38,76,0,8,76,0,0
"Africa","2024-01-15",0,0,76,0,11,87,0,0
"Africa","2024-01-16",0,0,76,0,11,98,0,0
"Africa","2024-01-17",0,0,76,0,11,109,0,0
"Africa","2024-01-18",0,0,76,0,11,120,0,0
"Africa","2024-01-19",0,0,76,0,11,131,0,0
"Africa","2024-01-20",0,0,76,0,11,142,0,0
"Africa","2024-01-21",0,77,153,0,11,153,0,0
"Africa","2024-01-22",0,0,153,0,7,160,0,0
"Africa","2024-01-23",0,0,153,0,7,167,0,0
"Africa","2024-01-24",0,0,153,0,7,174,0,0
"Africa","2024-01-25",0,0,153,0,7,181,0,0
"Africa","2024-01-26",0,0,153,0,7,188,0,0
"Africa","2024-01-27",0,0,153,0,7,195,0,0
"Africa","2024-01-28",0,49,202,0,7,202,0,0
"Africa","2024-01-29",0,0,202,0,6,208,0,0
"Africa","2024-01-30",0,0,202,0,5,213,0,0
"Africa","2024-01-31",0,0,202,0,6,219,0,0
"Africa","2024-02-01",0,0,202,0,6,225,0,0
"Africa","2024-02-02",0,0,202,0,6,231,0,0
"Africa","2024-02-03",0,0,202,0,5,236,0,0
"Africa","2024-02-04",0,40,242,0,6,242,0,0
"Africa","2024-02-05",0,0,242,0,7,249,0,0
"Africa","2024-02-06",0,0,242,0,6,255,0,0
"Africa","2024-02-07",0,0,242,0,7,262,0,0
"Africa","2024-02-08",0,0,242,0,7,269,0,0
"Africa","2024-02-09",0,0,242,0,7,276,0,0
"Africa","2024-02-10",0,0,242,0,6,282,0,0
"Africa","2024-02-11",0,47,289,0,7,289,0,0
"Africa","2024-02-12",0,0,289,0,7,296,0,0
"Africa","2024-02-13",0,0,289,0,6,302,0,0
"Africa","2024-02-14",0,0,289,0,7,309,0,0
"Africa","2024-02-15",0,0,289,0,7,316,0,0
"Africa","2024-02-16",0,0,289,0,7,323,0,0
"Africa","2024-02-17",0,0,289,0,6,329,0,0
"Africa","2024-02-18",0,47,336,0,7,336,0,0
"Africa","2024-02-19",0,0,336,0,5,341,0,0
"Africa","2024-02-20",0,0,336,0,6,347,0,0
"Africa","2024-02-21",0,0,336,0,5,352,0,0
"Africa","2024-02-22",0,0,336,0,6,358,0,0
"Africa","2024-02-23",0,0,336,0,5,363,0,0
"Africa","2024-02-24",0,0,336,0,6,369,0,0
"Africa","2024-02-25",0,38,374,0,5,374,0,0
"Africa","2024-02-26",0,0,374,0,8,382,0,0
"Africa","2024-02-27",0,0,374,0,7,389,0,0
"Africa","2024-02-28",0,0,374,0,8,397,0,0
"Africa","2024-02-29",0,0,374,0,7,404,0,0
"Africa","2024-03-01",0,0,374,0,8,412,0,0
"Africa","2024-03-02",0,0,374,0,7,419,0,0
"Africa","2024-03-03",0,53,427,0,8,427,0,0
"Africa","2024-03-04",0,0,427,0,7,434,0,0
"Africa","2024-03-05",0,0,427,0,8,442,0,0
"Africa","2024-03-06",0,0,427,0,7,449,0,0
"Africa","2024-03-07",0,0,427,0,7,456,0,0
"Africa","2024-03-08",0,0,427,0,7,463,0,0
"Africa","2024-03-09",0,0,427,0,8,471,0,0
"Africa","2024-03-10",0,51,478,0,7,478,0,0
"Africa","2024-03-11",0,0,478,0,0,478,0,0
"Africa","2024-03-12",0,0,478,0,0,478,0,0
"Africa","2024-03-13",0,0,478,0,1,479,0,0
"Africa","2024-03-14",0,0,478,0,0,479,0,0
"Africa","2024-03-15",0,1,479,0,0,479,0,0
"Africa","2024-03-16",0,0,479,0,27,506,0,0
"Africa","2024-03-17",0,54,533,0,27,533,0,0
"Africa","2024-03-18",0,0,533,0,8,541,0,0
"Africa","2024-03-19",0,0,533,0,8,549,0,0
"Africa","2024-03-20",0,0,533,0,8,557,0,0
"Africa","2024-03-21",0,0,533,0,7,564,0,0
"Africa","2024-03-22",0,0,533,0,8,572,0,0
"Africa","2024-03-23",0,0,533,0,8,580,0,0
"Africa","2024-03-24",0,55,588,0,8,588,0,0
"Africa","2024-03-25",0,0,588,0,8,596,0,0
"Africa","2024-03-26",0,0,588,0,7,603,0,0
"Africa","2024-03-27",0,0,588,0,8,611,0,0
"Africa","2024-03-28",0,0,588,0,8,619,0,0
"Africa","2024-03-29",0,0,588,0,8,627,0,0
"Africa","2024-03-30",0,0,588,0,7,634,0,0
"Africa","2024-03-31",0,54,642,0,8,642,0,0
"Africa","2024-04-01",0,0,642,0,9,651,0,0
"Africa","2024-04-02",0,0,642,0,9,660,0,0
"Africa","2024-04-03",0,0,642,0,9,669,0,0
"Africa","2024-04-04",0,0,642,0,8,677,0,0
"Africa","2024-04-05",0,0,642,0,9,686,0,0
"Africa","2024-04-06",0,0,642,0,9,695,0,0
"Africa","2024-04-07",0,62,704,0,9,704,0,0
"Africa","2024-04-08",0,0,704,0,12,716,0,0
"Africa","2024-04-09",0,0,704,0,11,727,0,0
"Africa","2024-04-10",0,0,704,0,12,739,0,0
"Africa","2024-04-11",0,0,704,0,12,751,0,0
"Africa","2024-04-12",0,0,704,0,12,763,0,0
"Africa","2024-04-13",0,0,704,0,11,774,0,0
"Africa","2024-04-14",0,82,786,0,12,786,0,0
"Africa","2024-04-15",0,0,786,0,9,795,0,0
"Africa","2024-04-16",0,0,786,0,9,804,0,0
"Africa","2024-04-17",0,0,786,0,9,813,0,0
"Africa","2024-04-18",0,0,786,0,10,823,0,0
"Africa","2024-04-19",0,0,786,0,9,832,0,0
"Africa","2024-04-20",0,0,786,0,9,841,0,0
"Africa","2024-04-21",0,64,850,0,9,850,0,0
"Africa","2024-04-22",0,0,850,0,15,865,0,0
"Africa","2024-04-23",0,0,850,0,16,881,0,0
"Africa","2024-04-24",0,0,850,0,15,896,0,0
"Africa","2024-04-25",0,0,850,0,16,912,0,0
"Africa","2024-04-26",0,0,850,0,15,927,0,0
"Africa","2024-04-27",0,0,850,0,16,943,0,0
"Africa","2024-04-28",0,108,958,0,15,958,0,0
"Africa","2024-04-29",0,0,958,0,19,977,0,0
"Africa","2024-04-30",0,0,958,0,19,996,0,0
"Africa","2024-05-01",0,0,958,0,19,1015,0,0
"Africa","2024-05-02",0,0,958,0,18,1033,0,0
"Africa","2024-05-03",0,0,958,0,19,1052,0,0
"Africa","2024-05-04",0,0,958,0,19,1071,0,0
"Africa","2024-05-05",0,132,1090,0,19,1090,0,0
"Africa","2024-05-06",0,0,1090,0,13,1103,0,0
"Africa","2024-05-07",0,0,1090,0,14,1117,0,0
"Africa","2024-05-08",0,0,1090,0,13,1130,0,0
"Africa","2024-05-09",0,0,1090,0,13,1143,0,0
"Africa","2024-05-10",0,0,1090,0,13,1156,0,0
"Africa","2024-05-11",0,0,1090,0,14,1170,0,0
"Africa","2024-05-12",0,93,1183,0,13,1183,0,0
"Africa","2024-05-13",0,0,1183,0,15,1198,0,0
"Africa","2024-05-14",0,0,1183,0,14,1212,0,0
"Africa","2024-05-15",0,0,1183,0,15,1227,0,0
"Africa","2024-05-16",0,0,1183,0,15,1242,0,0
"Africa","2024-05-17",0,0,1183,0,15,1257,0,0
"Africa","2024-05-18",0,0,1183,0,14,1271,0,0
"Africa","2024-05-19",0,103,1286,0,15,1286,0,0
"Africa","2024-05-20",0,0,1286,0,13,1299,0,0
"Africa","2024-05-21",0,0,1286,0,14,1313,0,0
"Africa","2024-05-22",0,0,1286,0,13,1326,0,0
"Africa","2024-05-23",0,0,1286,0,14,1340,0,0
"Africa","2024-05-24",0,0,1286,0,13,1353,0,0
"Africa","2024-05-25",0,0,1286,0,14,1367,0,0
"Africa","2024-05-26",0,94,1380,0,13,1380,0,0
"Africa","2024-05-27",0,0,1380,0,15,1395,0,0
"Africa","2024-05-28",0,0,1380,0,16,1411,0,0
"Africa","2024-05-29",0,0,1380,0,15,1426,0,0
"Africa","2024-05-30",0,0,1380,0,16,1442,0,0
"Africa","2024-05-31",0,0,1380,0,15,1457,0,0
"Africa","2024-06-01",0,0,1380,0,16,1473,0,0
"Africa","2024-06-02",0,108,1488,0,15,1488,0,0
"Africa","2024-06-03",0,0,1488,0,22,1510,0,0
"Africa","2024-06-04",0,0,1488,0,21,1531,0,0
"Africa","2024-06-05",0,0,1488,0,22,1553,0,0
"Africa","2024-06-06",0,0,1488,0,21,1574,0,0
"Africa","2024-06-07",0,0,1488,0,22,1596,0,0
"Africa","2024-06-08",0,0,1488,0,21,1617,0,0
"Africa","2024-06-09",0,151,1639,0,22,1639,0,0
"Africa","2024-06-10",0,0,1639,0,29,1668,0,0
"Africa","2024-06-11",0,0,1639,0,29,1697,0,0
"Africa","2024-06-12",0,0,1639,0,29,1726,0,0
"Africa","2024-06-13",0,0,1639,0,30,1756,0,0
"Africa","2024-06-14",0,0,1639,0,29,1785,0,0
"Africa","2024-06-15",0,0,1639,0,29,1814,0,0
"Africa","2024-06-16",0,204,1843,0,29,1843,0,0
"Africa","2024-06-17",0,0,1843,0,27,1870,0,0
"Africa","2024-06-18",0,0,1843,0,26,1896,0,0
"Africa","2024-06-19",0,0,1843,0,27,1923,0,0
"Africa","2024-06-20",0,0,1843,0,27,1950,0,0
"Africa","2024-06-21",0,0,1843,0,27,1977,0,0
"Africa","2024-06-22",0,0,1843,0,26,2003,0,0
"Africa","2024-06-23",0,187,2030,0,27,2030,0,0
"Africa","2024-06-24",0,0,2030,0,27,2057,0,0
"Africa","2024-06-25",0,0,2030,0,26,2083,0,0
"Africa","2024-06-26",0,0,2030,0,27,2110,0,0
"Africa","2024-06-27",0,0,2030,0,26,2136,0,0
"Africa","2024-06-28",0,0,2030,0,27,2163,0,0
"Africa","2024-06-29",0,0,2030,0,26,2189,0,0
"Africa","2024-06-30",0,186,2216,0,27,2216,0,0
"Africa","2024-07-01",0,0,2216,0,24,2240,0,0
"Africa","2024-07-02",0,0,2216,0,25,2265,0,0
"Africa","2024-07-03",0,0,2216,0,24,2289,0,0
"Africa","2024-07-04",0,0,2216,0,24,2313,0,0
"Africa","2024-07-05",0,0,2216,0,24,2337,0,0
"Africa","2024-07-06",0,0,2216,0,25,2362,0,0
"Africa","2024-07-07",0,170,2386,0,24,2386,0,0
"Africa","2024-07-08",0,0,2386,0,33,2419,0,0
"Africa","2024-07-09",0,0,2386,0,34,2453,0,0
"Africa","2024-07-10",0,0,2386,0,33,2486,0,0
"Africa","2024-07-11",0,0,2386,0,34,2520,0,0
"Africa","2024-07-12",0,0,2386,0,33,2553,0,0
"Africa","2024-07-13",0,0,2386,0,34,2587,0,0
"Africa","2024-07-14",0,234,2620,0,33,2620,0,0
"Africa","2024-07-15",0,0,2620,0,36,2656,0,0
"Africa","2024-07-16",0,0,2620,0,37,2693,0,0
"Africa","2024-07-17",0,0,2620,0,36,2729,0,0
"Africa","2024-07-18",0,0,2620,0,36,2765,0,0
"Africa","2024-07-19",0,0,2620,0,36,2801,0,0
"Africa","2024-07-20",0,0,2620,0,37,2838,0,0
"Africa","2024-07-21",0,254,2874,0,36,2874,0,0
"Africa","2024-07-22",0,0,2874,0,37,2911,0,0
"Africa","2024-07-23",0,0,2874,0,36,2947,0,0
"Africa","2024-07-24",0,0,2874,0,37,2984,0,0
"Africa","2024-07-25",0,0,2874,0,37,3021,0,0
"Africa","2024-07-26",0,0,2874,0,37,3058,0,0
"Africa","2024-07-27",0,0,2874,0,36,3094,0,0
"Africa","2024-07-28",0,257,3131,0,37,3131,0,0
"Africa","2024-07-29",0,0,3131,0,25,3156,0,0
"Africa","2024-07-30",0,0,3131,0,25,3181,0,0
"Africa","2024-07-31",0,0,3131,0,25,3206,0,0
"Africa","2024-08-01",0,0,3131,0,24,3230,0,0
"Africa","2024-08-02",0,0,3131,0,25,3255,0,0
"Africa","2024-08-03",0,0,3131,0,25,3280,0,0
"Africa","2024-08-04",0,174,3305,0,25,3305,0,0
"Africa","2024-08-05",0,0,3305,0,35,3340,0,0
"Africa","2024-08-06",0,0,3305,0,35,3375,0,0
"Africa","2024-08-07",0,0,3305,0,35,3410,0,0
"Africa","2024-08-08",0,0,3305,0,35,3445,0,0
"Africa","2024-08-09",0,0,3305,0,35,3480,0,0
"Africa","2024-08-10",0,0,3305,0,35,3515,0,0
"Africa","2024-08-11",0,245,3550,0,35,3550,0,0
"Africa","2024-08-12",0,0,3550,0,36,3586,0,0
"Africa","2024-08-13",0,0,3550,0,36,3622,0,0
"Africa","2024-08-14",0,0,3550,0,36,3658,0,0
"Africa","2024-08-15",0,0,3550,0,37,3695,0,0
"Africa","2024-08-16",0,0,3550,0,36,3731,0,0
"Africa","2024-08-17",0,0,3550,0,36,3767,0,0
"Africa","2024-08-18",0,253,3803,0,36,3803,0,0
"Africa","2024-08-19",0,0,3803,0,41,3844,0,0
"Africa","2024-08-20",0,0,3803,0,41,3885,0,0
"Africa","2024-08-21",0,0,3803,0,41,3926,0,0
"Africa","2024-08-22",0,0,3803,0,40,3966,0,0
"Africa","2024-08-23",0,0,3803,0,41,4007,0,0
"Africa","2024-08-24",0,0,3803,0,41,4048,0,0
"Africa","2024-08-25",0,286,4089,0,41,4089,0,0
"Africa","2024-08-26",0,0,4089,0,45,4134,0,0
"Africa","2024-08-27",0,0,4089,0,45,4179,0,0
"Africa","2024-08-28",0,0,4089,0,45,4224,0,0
"Africa","2024-08-29",0,0,4089,0,45,4269,0,0
"Africa","2024-08-30",0,0,4089,0,45,4314,0,0
"Africa","2024-08-31",0,0,4089,0,45,4359,0,0
"Africa","2024-09-01",0,315,4404,0,45,4404,0,0
"Africa","2024-09-02",0,0,4404,0,47,4451,0,0
"Africa","2024-09-03",0,0,4404,0,48,4499,0,0
"Africa","2024-09-04",0,0,4404,0,47,4546,0,0
"Africa","2024-09-05",0,0,4404,0,48,4594,0,0
"Africa","2024-09-06",0,0,4404,0,47,4641,0,0
"Africa","2024-09-07",0,0,4404,0,48,4689,0,0
"Africa","2024-09-08",0,332,4736,0,47,4736,0,0
"Africa","2024-09-09",0,0,4736,0,0,4736,0,0
"Africa","2024-09-10",0,0,4736,0,0,4736,0,0
"Africa","2024-09-11",0,0,4736,0,1,4737,0,0
"Africa","2024-09-12",0,1,4737,0,0,4737,0,0
"Africa","2024-09-13",0,0,4737,0,141,4878,0,0
"Africa","2024-09-14",0,0,4737,0,140,5018,0,0
"Africa","2024-09-15",0,422,5159,0,141,5159,0,0
"Africa","2024-09-16",0,0,5159,0,67,5226,0,0
"Africa","2024-09-17",0,0,5159,0,67,5293,0,0
"Africa","2024-09-18",0,0,5159,0,67,5360,0,0
"Africa","2024-09-19",0,0,5159,0,68,5428,0,0
"Africa","2024-09-20",0,0,5159,0,67,5495,0,0
"Africa","2024-09-21",0,0,5159,0,67,5562,0,0
"Africa","2024-09-22",0,470,5629,0,67,5629,0,0
"Africa","2024-09-23",0,0,5629,0,0,5629,0,0
"Africa","2024-09-24",0,0,5629,0,1,5630,0,0
"Africa","2024-09-25",0,0,5629,0,1,5631,0,0
"Africa","2024-09-26",0,0,5629,0,0,5631,0,0
"Africa","2024-09-27",0,0,5629,0,0,5631,0,0
"Africa","2024-09-28",0,3,5632,0,1,5632,0,0
"Africa","2024-09-29",0,420,6052,0,420,6052,0,0
"Africa","2024-09-30",0,0,6052,0,0,6052,0,0
"Africa","2024-10-01",0,0,6052,0,0,6052,0,0
"Africa","2024-10-02",0,0,6052,0,1,6053,0,0
"Africa","2024-10-03",0,1,6053,0,0,6053,0,0
"Africa","2024-10-04",0,0,6053,0,142,6195,0,0
"Africa","2024-10-05",0,0,6053,0,142,6337,0,0
"Africa","2024-10-06",0,426,6479,0,142,6479,0,0
"Africa","2024-10-07",0,0,6479,0,0,6479,0,0
"Africa","2024-10-08",0,0,6479,0,0,6479,0,0
"Africa","2024-10-09",0,0,6479,0,0,6479,0,0
"Africa","2024-10-10",0,0,6479,0,1,6480,0,0
"Africa","2024-10-11",0,0,6479,0,0,6480,0,0
"Africa","2024-10-12",0,1,6480,0,0,6480,0,0
"Africa","2024-10-13",0,498,6978,0,498,6978,0,0
"Africa","2024-10-14",0,0,6978,0,77,7055,0,0
"Africa","2024-10-15",0,0,6978,0,77,7132,0,0
"Africa","2024-10-16",0,0,6978,0,77,7209,0,0
"Africa","2024-10-17",0,0,6978,0,76,7285,0,0
"Africa","2024-10-18",0,0,6978,0,77,7362,0,0
"Africa","2024-10-19",0,0,6978,0,77,7439,0,0
"Africa","2024-10-20",0,538,7516,0,77,7516,0,0
"Africa","2024-10-21",0,0,7516,0,0,7516,0,0
"Africa","2024-10-22",0,0,7516,0,1,7517,0,0
"Africa","2024-10-23",0,0,7516,0,1,7518,0,0
"Africa","2024-10-24",0,0,7516,0,0,7518,0,0
"Africa","2024-10-25",0,0,7516,0,0,7518,0,0
"Africa","2024-10-26",0,3,7519,0,1,7519,0,0
"Africa","2024-10-27",0,612,8131,0,612,8131,0,0
"Africa","2024-10-28",0,0,8131,0,1,8132,0,0
"Africa","2024-10-29",0,0,8131,0,2,8134,0,0
"Africa","2024-10-30",0,4,8135,0,1,8135,0,0
"Africa","2024-10-31",0,0,8135,0,167,8302,0,0
"Africa","2024-11-01",0,0,8135,0,167,8469,0,0
"Africa","2024-11-02",0,0,8135,0,168,8637,0,0
"Africa","2024-11-03",0,669,8804,0,167,8804,0,0
"Africa","2024-11-04",0,0,8804,0,104,8908,0,0
"Africa","2024-11-05",0,0,8804,0,104,9012,0,0
"Africa","2024-11-06",0,0,8804,0,104,9116,0,0
"Africa","2024-11-07",0,0,8804,0,104,9220,0,0
"Africa","2024-11-08",0,0,8804,0,104,9324,0,0
"Africa","2024-11-09",0,0,8804,0,104,9428,0,0
"Africa","2024-11-10",0,728,9532,0,104,9532,0,0
"Africa","2024-11-11",0,0,9532,0,110,9642,0,0
"Africa","2024-11-12",0,0,9532,0,110,9752,0,0
"Africa","2024-11-13",0,0,9532,0,110,9862,0,0
"Africa","2024-11-14",0,0,9532,0,111,9973,0,0
"Africa","2024-11-15",0,0,9532,0,110,10083,0,0
"Africa","2024-11-16",0,0,9532,0,110,10193,0,0
"Africa","2024-11-17",0,771,10303,0,110,10303,0,0
"Africa","2024-11-18",0,0,10303,0,0,10303,0,0
"Africa","2024-11-19",0,0,10303,0,1,10304,0,0
"Africa","2024-11-20",0,1,10304,0,0,10304,0,0
"Africa","2024-11-21",0,0,10304,0,179,10483,0,0
"Africa","2024-11-22",0,0,10304,0,179,10662,0,0
"Africa","2024-11-23",0,0,10304,0,179,10841,0,0
"Africa","2024-11-24",0,716,11020,0,179,11020,0,0
"Africa","2024-11-25",0,0,11020,0,1,11021,0,0
"Africa","2024-11-26",0,0,11020,0,1,11022,0,0
"Africa","2024-11-27",0,0,11020,0,2,11024,0,0
"Africa","2024-11-28",0,0,11020,0,1,11025,0,0
"Africa","2024-11-29",0,0,11020,0,1,11026,0,0
"Africa","2024-11-30",0,7,11027,0,1,11027,0,0
"Africa","2024-12-01",0,693,11720,0,693,11720,0,0
"Africa","2024-12-02",0,0,11720,0,96,11816,0,0
"Africa","2024-12-03",0,0,11720,0,95,11911,0,0
"Africa","2024-12-04",0,0,11720,0,96,12007,0,0
"Africa","2024-12-05",0,0,11720,0,95,12102,0,0
"Africa","2024-12-06",0,0,11720,0,96,12198,0,0
"Africa","2024-12-07",0,0,11720,0,95,12293,0,0
"Africa","2024-12-08",0,669,12389,0,96,12389,0,0
"Africa","2024-12-09",0,0,12389,0,83,12472,0,0
"Africa","2024-12-10",0,0,12389,0,82,12554,0,0
"Africa","2024-12-11",0,0,12389,0,83,12637,0,0
"Africa","2024-12-12",0,0,12389,0,82,12719,0,0
"Africa","2024-12-13",0,0,12389,0,83,12802,0,0
"Africa","2024-12-14",0,0,12389,0,82,12884,0,0
"Africa","2024-12-15",0,578,12967,0,83,12967,0,0
"Africa","2024-12-16",0,0,12967,0,75,13042,0,0
"Africa","2024-12-17",0,0,12967,0,75,13117,0,0
"Africa","2024-12-18",0,0,12967,0,75,13192,0,0
"Africa","2024-12-19",0,0,12967,0,76,13268,0,0
"Africa","2024-12-20",0,0,12967,0,75,13343,0,0
"Africa","2024-12-21",0,0,12967,0,75,13418,0,0
"Africa","2024-12-22",0,526,13493,0,75,13493,0,0
"Africa","2024-12-23",0,0,13493,0,60,13553,0,0
"Africa","2024-12-24",0,0,13493,0,59,13612,0,0
"Africa","2024-12-25",0,0,13493,0,60,13672,0,0
"Africa","2024-12-26",0,0,13493,0,60,13732,0,0
"Africa","2024-12-27",0,0,13493,0,60,13792,0,0
"Africa","2024-12-28",0,0,13493,0,59,13851,0,0
"Africa","2024-12-29",0,418,13911,0,60,13911,0,0
"Africa","2024-12-30",0,0,13911,0,128,14039,0,0
"Africa","2024-12-31",0,0,13911,0,128,14167,0,0
"Africa","2025-01-01",0,0,13911,0,128,14295,0,0
"Africa","2025-01-02",0,0,13911,0,128,14423,0,0
"Africa","2025-01-03",0,0,13911,0,128,14551,0,0
"Africa","2025-01-04",0,0,13911,0,128,14679,0,0
"Africa","2025-01-05",0,896,14807,0,128,14807,0,0
"Africa","2025-01-06",0,0,14807,0,151,14958,0,0
"Africa","2025-01-07",0,0,14807,0,152,15110,0,0
"Africa","2025-01-08",0,0,14807,0,151,15261,0,0
"Africa","2025-01-09",0,0,14807,0,151,15412,0,0
"Africa","2025-01-10",0,0,14807,0,151,15563,0,0
"Africa","2025-01-11",0,0,14807,0,152,15715,0,0
"Africa","2025-01-12",0,1059,15866,0,151,15866,0,0
"Africa","2025-01-13",0,0,15866,0,128,15994,0,0
"Africa","2025-01-14",0,0,15866,0,129,16123,0,0
"Africa","2025-01-15",0,0,15866,0,128,16251,0,0
"Africa","2025-01-16",0,0,15866,0,128,16379,0,0
"Africa","2025-01-17",0,0,15866,0,128,16507,0,0
"Africa","2025-01-18",0,0,15866,0,129,16636,0,0
"Africa","2025-01-19",0,898,16764,0,128,16764,0,0
"Africa","2025-01-20",0,0,16764,0,109,16873,0,0
"Africa","2025-01-21",0,0,16764,0,108,16981,0,0
"Africa","2025-01-22",0,0,16764,0,109,17090,0,0
"Africa","2025-01-23",0,0,16764,0,108,17198,0,0
"Africa","2025-01-24",0,0,16764,0,109,17307,0,0
"Africa","2025-01-25",0,0,16764,0,108,17415,0,0
"Africa","2025-01-26",0,760,17524,0,109,17524,0,0
"Africa","2025-01-27",0,0,17524,0,44,17568,0,0
"Africa","2025-01-28",0,0,17524,0,43,17611,0,0
"Africa","2025-01-29",0,0,17524,0,44,17655,0,0
"Africa","2025-01-30",0,0,17524,0,44,17699,0,0
"Africa","2025-01-31",0,0,17524,0,44,17743,0,0
"Africa","2025-02-01",0,0,17524,0,43,17786,0,0
"Africa","2025-02-02",0,306,17830,0,44,17830,0,0
"Africa","2025-02-03",0,0,17830,0,0,17830,0,0
"Africa","2025-02-04",0,0,17830,0,1,17831,0,0
"Africa","2025-02-05",0,0,17830,0,0,17831,0,0
"Africa","2025-02-06",0,0,17830,0,1,17832,0,0
"Africa","2025-02-07",0,2,17832,0,0,17832,0,0
"Africa","2025-02-08",0,0,17832,0,156,17988,0,0
"Africa","2025-02-09",0,311,18143,0,155,18143,0,0
"Africa","2025-02-10",0,0,18143,0,50,18193,0,0
"Africa","2025-02-11",0,100,18243,0,50,18243,0,0
"Africa","2025-02-12",0,0,18243,0,1,18244,0,0
"Africa","2025-02-13",0,2,18245,0,1,18245,0,0
"Africa","2025-02-14",0,0,18245,0,13,18258,0,0
"Africa","2025-02-15",0,0,18245,0,14,18272,0,0
"Africa","2025-02-16",0,40,18285,0,13,18285,0,0
"Africa","2025-02-17",0,0,18285,0,0,18285,0,0
"Africa","2025-02-18",0,0,18285,0,0,18285,0,0
"Africa","2025-02-19",0,0,18285,0,0,18285,0,0
"Africa","2025-02-20",0,0,18285,0,0,18285,0,0
"Africa","2025-02-21",0,0,18285,0,0,18285,0,0
"Africa","2025-02-22",0,0,18285,0,0,18285,0,0
"Africa","2025-02-23",0,0,18285,0,0,18285,0,0
"Africa","2025-02-24",0,0,18285,0,0,18285,0,0
"Africa","2025-02-25",0,0,18285,0,0,18285,0,0
"Africa","2025-02-26",0,0,18285,0,0,18285,0,0
"Africa","2025-02-27",0,0,18285,0,0,18285,0,0
"Africa","2025-02-28",0,0,18285,0,0,18285,0,0
"Africa","2025-03-01",0,0,18285,0,0,18285,0,0
"Africa","2025-03-02",0,0,18285,0,0,18285,0,0
"Africa","2025-03-03",0,0,18285,0,0,18285,0,0
"Andorra","2024-01-01",0,0,0,0,0,0,0,0
"Andorra","2024-01-02",0,0,0,0,0,0,0,0
"Andorra","2024-01-03",0,0,0,0,0,0,0,0
"Andorra","2024-01-04",0,0,0,0,0,0,0,0
"Andorra","2024-01-05",0,0,0,0,0,0,0,0
"Andorra","2024-01-06",0,0,0,0,0,0,0,0
"Andorra","2024-01-07",0,0,0,0,0,0,0,0
"Andorra","2024-01-08",0,0,0,0,0,0,0,0
"Andorra","2024-01-09",0,0,0,0,0,0,0,0
"Andorra","2024-01-10",0,0,0,0,0,0,0,0
"Andorra","2024-01-11",0,0,0,0,0,0,0,0
"Andorra","2024-01-12",0,0,0,0,0,0,0,0
"Andorra","2024-01-13",0,0,0,0,0,0,0,0
"Andorra","2024-01-14",0,0,0,0,0,0,0,0
"Andorra","2024-01-15",0,0,0,0,0,0,0,0
"Andorra","2024-01-16",0,0,0,0,0,0,0,0
"Andorra","2024-01-17",0,0,0,0,0,0,0,0
"Andorra","2024-01-18",0,0,0,0,0,0,0,0
"Andorra","2024-01-19",0,0,0,0,0,0,0,0
"Andorra","2024-01-20",0,0,0,0,0,0,0,0
"Andorra","2024-01-21",0,0,0,0,0,0,0,0
"Andorra","2024-01-22",0,0,0,0,0,0,0,0
"Andorra","2024-01-23",0,0,0,0,0,0,0,0
"Andorra","2024-01-24",0,0,0,0,0,0,0,0
"Andorra","2024-01-25",0,0,0,0,0,0,0,0
"Andorra","2024-01-26",0,0,0,0,0,0,0,0
"Andorra","2024-01-27",0,0,0,0,0,0,0,0
"Andorra","2024-01-28",0,0,0,0,0,0,0,0
"Andorra","2024-01-29",0,0,0,0,0,0,0,0
"Andorra","2024-01-30",0,0,0,0,0,0,0,0
"Andorra","2024-01-31",0,0,0,0,0,0,0,0
"Andorra","2024-02-01",0,0,0,0,0,0,0,0
"Andorra","2024-02-02",0,0,0,0,0,0,0,0
"Andorra","2024-02-03",0,0,0,0,0,0,0,0
"Andorra","2024-02-04",0,0,0,0,0,0,0,0
"Andorra","2024-02-05",0,0,0,0,0,0,0,0
"Andorra","2024-02-06",0,0,0,0,0,0,0,0
"Andorra","2024-02-07",0,0,0,0,0,0,0,0
"Andorra","2024-02-08",0,0,0,0,0,0,0,0
"Andorra","2024-02-09",0,0,0,0,0,0,0,0
"Andorra","2024-02-10",0,0,0,0,0,0,0,0
"Andorra","2024-02-11",0,0,0,0,0,0,0,0
"Andorra","2024-02-12",0,0,0,0,0,0,0,0
"Andorra","2024-02-13",0,0,0,0,0,0,0,0
"Andorra","2024-02-14",0,0,0,0,0,0,0,0
"Andorra","2024-02-15",0,0,0,0,0,0,0,0
"Andorra","2024-02-16",0,0,0,0,0,0,0,0
"Andorra","2024-02-17",0,0,0,0,0,0,0,0
"Andorra","2024-02-18",0,0,0,0,0,0,0,0
"Andorra","2024-02-19",0,0,0,0,0,0,0,0
"Andorra","2024-02-20",0,0,0,0,0,0,0,0
"Andorra","2024-02-21",0,0,0,0,0,0,0,0
"Andorra","2024-02-22",0,0,0,0,0,0,0,0
"Andorra","2024-02-23",0,0,0,0,0,0,0,0
"Andorra","2024-02-24",0,0,0,0,0,0,0,0
"Andorra","2024-02-25",0,0,0,0,0,0,0,0
"Andorra","2024-02-26",0,0,0,0,0,0,0,0
"Andorra","2024-02-27",0,0,0,0,0,0,0,0
"Andorra","2024-02-28",0,0,0,0,0,0,0,0
"Andorra","2024-02-29",0,0,0,0,0,0,0,0
"Andorra","2024-03-01",0,0,0,0,0,0,0,0
"Andorra","2024-03-02",0,0,0,0,0,0,0,0
"Andorra","2024-03-03",0,0,0,0,0,0,0,0
"Andorra","2024-03-04",0,0,0,0,0,0,0,0
"Andorra","2024-03-05",0,0,0,0,0,0,0,0
"Andorra","2024-03-06",0,0,0,0,0,0,0,0
"Andorra","2024-03-07",0,0,0,0,0,0,0,0
"Andorra","2024-03-08",0,0,0,0,0,0,0,0
"Andorra","2024-03-09",0,0,0,0,0,0,0,0
"Andorra","2024-03-10",0,0,0,0,0,0,0,0
"Andorra","2024-03-11",0,0,0,0,0,0,0,0
"Andorra","2024-03-12",0,0,0,0,0,0,0,0
"Andorra","2024-03-13",0,0,0,0,0,0,0,0
"Andorra","2024-03-14",0,0,0,0,0,0,0,0
"Andorra","2024-03-15",0,0,0,0,0,0,0,0
"Andorra","2024-03-16",0,0,0,0,0,0,0,0
"Andorra","2024-03-17",0,0,0,0,0,0,0,0
"Andorra","2024-03-18",0,0,0,0,0,0,0,0
"Andorra","2024-03-19",0,0,0,0,0,0,0,0
"Andorra","2024-03-20",0,0,0,0,0,0,0,0
"Andorra","2024-03-21",0,0,0,0,0,0,0,0
"Andorra","2024-03-22",0,0,0,0,0,0,0,0
"Andorra","2024-03-23",0,0,0,0,0,0,0,0
"Andorra","2024-03-24",0,0,0,0,0,0,0,0
"Andorra","2024-03-25",0,0,0,0,0,0,0,0
"Andorra","2024-03-26",0,0,0,0,0,0,0,0
"Andorra","2024-03-27",0,0,0,0,0,0,0,0
"Andorra","2024-03-28",0,0,0,0,0,0,0,0
"Andorra","2024-03-29",0,0,0,0,0,0,0,0
"Andorra","2024-03-30",0,0,0,0,0,0,0,0
"Andorra","2024-03-31",0,0,0,0,0,0,0,0
"Andorra","2024-04-01",0,0,0,0,0,0,0,0
"Andorra","2024-04-02",0,0,0,0,0,0,0,0
"Andorra","2024-04-03",0,0,0,0,0,0,0,0
"Andorra","2024-04-04",0,0,0,0,0,0,0,0
"Andorra","2024-04-05",0,0,0,0,0,0,0,0
"Andorra","2024-04-06",0,0,0,0,0,0,0,0
"Andorra","2024-04-07",0,0,0,0,0,0,0,0
"Andorra","2024-04-08",0,0,0,0,0,0,0,0
"Andorra","2024-04-09",0,0,0,0,0,0,0,0
"Andorra","2024-04-10",0,0,0,0,0,0,0,0
"Andorra","2024-04-11",0,0,0,0,0,0,0,0
"Andorra","2024-04-12",0,0,0,0,0,0,0,0
"Andorra","2024-04-13",0,0,0,0,0,0,0,0
"Andorra","2024-04-14",0,0,0,0,0,0,0,0
"Andorra","2024-04-15",0,0,0,0,0,0,0,0
"Andorra","2024-04-16",0,0,0,0,0,0,0,0
"Andorra","2024-04-17",0,0,0,0,0,0,0,0
"Andorra","2024-04-18",0,0,0,0,0,0,0,0
"Andorra","2024-04-19",0,0,0,0,0,0,0,0
"Andorra","2024-04-20",0,0,0,0,0,0,0,0
"Andorra","2024-04-21",0,0,0,0,0,0,0,0
"Andorra","2024-04-22",0,0,0,0,0,0,0,0
"Andorra","2024-04-23",0,0,0,0,0,0,0,0
"Andorra","2024-04-24",0,0,0,0,0,0,0,0
"Andorra","2024-04-25",0,0,0,0,0,0,0,0
"Andorra","2024-04-26",0,0,0,0,0,0,0,0
"Andorra","2024-04-27",0,0,0,0,0,0,0,0
"Andorra","2024-04-28",0,0,0,0,0,0,0,0
"Andorra","2024-04-29",0,0,0,0,0,0,0,0
"Andorra","2024-04-30",0,0,0,0,0,0,0,0
"Andorra","2024-05-01",0,0,0,0,0,0,0,0
"Andorra","2024-05-02",0,0,0,0,0,0,0,0
"Andorra","2024-05-03",0,0,0,0,0,0,0,0
"Andorra","2024-05-04",0,0,0,0,0,0,0,0
"Andorra","2024-05-05",0,0,0,0,0,0,0,0
"Andorra","2024-05-06",0,0,0,0,0,0,0,0
"Andorra","2024-05-07",0,0,0,0,0,0,0,0
"Andorra","2024-05-08",0,0,0,0,0,0,0,0
"Andorra","2024-05-09",0,0,0,0,0,0,0,0
"Andorra","2024-05-10",0,0,0,0,0,0,0,0
"Andorra","2024-05-11",0,0,0,0,0,0,0,0
"Andorra","2024-05-12",0,0,0,0,0,0,0,0
"Andorra","2024-05-13",0,0,0,0,0,0,0,0
"Andorra","2024-05-14",0,0,0,0,0,0,0,0
"Andorra","2024-05-15",0,0,0,0,0,0,0,0
"Andorra","2024-05-16",0,0,0,0,0,0,0,0
"Andorra","2024-05-17",0,0,0,0,0,0,0,0
"Andorra","2024-05-18",0,0,0,0,0,0,0,0
"Andorra","2024-05-19",0,0,0,0,0,0,0,0
"Andorra","2024-05-20",0,0,0,0,0,0,0,0
"Andorra","2024-05-21",0,0,0,0,0,0,0,0
"Andorra","2024-05-22",0,0,0,0,0,0,0,0
"Andorra","2024-05-23",0,0,0,0,0,0,0,0
"Andorra","2024-05-24",0,0,0,0,0,0,0,0
"Andorra","2024-05-25",0,0,0,0,0,0,0,0
"Andorra","2024-05-26",0,0,0,0,0,0,0,0
"Andorra","2024-05-27",0,0,0,0,0,0,0,0
"Andorra","2024-05-28",0,0,0,0,0,0,0,0
"Andorra","2024-05-29",0,0,0,0,0,0,0,0
"Andorra","2024-05-30",0,0,0,0,0,0,0,0
"Andorra","2024-05-31",0,0,0,0,0,0,0,0
"Andorra","2024-06-01",0,0,0,0,0,0,0,0
"Andorra","2024-06-02",0,0,0,0,0,0,0,0
"Andorra","2024-06-03",0,0,0,0,0,0,0,0
"Andorra","2024-06-04",0,0,0,0,0,0,0,0
"Andorra","2024-06-05",0,0,0,0,0,0,0,0
"Andorra","2024-06-06",0,0,0,0,0,0,0,0
"Andorra","2024-06-07",0,0,0,0,0,0,0,0
"Andorra","2024-06-08",0,0,0,0,0,0,0,0
"Andorra","2024-06-09",0,0,0,0,0,0,0,0
"Andorra","2024-06-10",0,0,0,0,0,0,0,0
"Andorra","2024-06-11",0,0,0,0,0,0,0,0
"Andorra","2024-06-12",0,0,0,0,0,0,0,0
"Andorra","2024-06-13",0,0,0,0,0,0,0,0
"Andorra","2024-06-14",0,0,0,0,0,0,0,0
"Andorra","2024-06-15",0,0,0,0,0,0,0,0
"Andorra","2024-06-16",0,0,0,0,0,0,0,0
"Andorra","2024-06-17",0,0,0,0,0,0,0,0
"Andorra","2024-06-18",0,0,0,0,0,0,0,0
"Andorra","2024-06-19",0,0,0,0,0,0,0,0
"Andorra","2024-06-20",0,0,0,0,0,0,0,0
"Andorra","2024-06-21",0,0,0,0,0,0,0,0
"Andorra","2024-06-22",0,0,0,0,0,0,0,0
"Andorra","2024-06-23",0,0,0,0,0,0,0,0
"Andorra","2024-06-24",0,0,0,0,0,0,0,0
"Andorra","2024-06-25",0,0,0,0,0,0,0,0
"Andorra","2024-06-26",0,0,0,0,0,0,0,0
"Andorra","2024-06-27",0,0,0,0,0,0,0,0
"Andorra","2024-06-28",0,0,0,0,0,0,0,0
"Andorra","2024-06-29",0,0,0,0,0,0,0,0
"Andorra","2024-06-30",0,0,0,0,0,0,0,0
"Andorra","2024-07-01",0,0,0,0,0,0,0,0
"Andorra","2024-07-02",0,0,0,0,0,0,0,0
"Andorra","2024-07-03",0,0,0,0,0,0,0,0
"Andorra","2024-07-04",0,0,0,0,0,0,0,0
"Andorra","2024-07-05",0,0,0,0,0,0,0,0
"Andorra","2024-07-06",0,0,0,0,0,0,0,0
"Andorra","2024-07-07",0,0,0,0,0,0,0,0
"Andorra","2024-07-08",0,0,0,0,0,0,0,0
"Andorra","2024-07-09",0,0,0,0,0,0,0,0
"Andorra","2024-07-10",0,0,0,0,0,0,0,0
"Andorra","2024-07-11",0,0,0,0,0,0,0,0
"Andorra","2024-07-12",0,0,0,0,0,0,0,0
"Andorra","2024-07-13",0,0,0,0,0,0,0,0
"Andorra","2024-07-14",0,0,0,0,0,0,0,0
"Andorra","2024-07-15",0,0,0,0,0,0,0,0
"Andorra","2024-07-16",0,0,0,0,0,0,0,0
"Andorra","2024-07-17",0,0,0,0,0,0,0,0
"Andorra","2024-07-18",0,0,0,0,0,0,0,0
"Andorra","2024-07-19",0,0,0,0,0,0,0,0
"Andorra","2024-07-20",0,0,0,0,0,0,0,0
"Andorra","2024-07-21",0,0,0,0,0,0,0,0
"Andorra","2024-07-22",0,0,0,0,0,0,0,0
"Andorra","2024-07-23",0,0,0,0,0,0,0,0
"Andorra","2024-07-24",0,0,0,0,0,0,0,0
"Andorra","2024-07-25",0,0,0,0,0,0,0,0
"Andorra","2024-07-26",0,0,0,0,0,0,0,0
"Andorra","2024-07-27",0,0,0,0,0,0,0,0
"Andorra","2024-07-28",0,0,0,0,0,0,0,0
"Andorra","2024-07-29",0,0,0,0,0,0,0,0
"Andorra","2024-07-30",0,0,0,0,0,0,0,0
"Andorra","2024-07-31",0,0,0,0,0,0,0,0
"Andorra","2024-08-01",0,0,0,0,0,0,0,0
"Andorra","2024-08-02",0,0,0,0,0,0,0,0
"Andorra","2024-08-03",0,0,0,0,0,0,0,0
"Andorra","2024-08-04",0,0,0,0,0,0,0,0
"Andorra","2024-08-05",0,0,0,0,0,0,0,0
"Andorra","2024-08-06",0,0,0,0,0,0,0,0
"Andorra","2024-08-07",0,0,0,0,0,0,0,0
"Andorra","2024-08-08",0,0,0,0,0,0,0,0
"Andorra","2024-08-09",0,0,0,0,0,0,0,0
"Andorra","2024-08-10",0,0,0,0,0,0,0,0
"Andorra","2024-08-11",0,0,0,0,0,0,0,0
"Andorra","2024-08-12",0,0,0,0,0,0,0,0
"Andorra","2024-08-13",0,0,0,0,0,0,0,0
"Andorra","2024-08-14",0,0,0,0,0,0,0,0
"Andorra","2024-08-15",0,0,0,0,0,0,0,0
"Andorra","2024-08-16",0,0,0,0,0,0,0,0
"Andorra","2024-08-17",0,0,0,0,0,0,0,0
"Andorra","2024-08-18",0,0,0,0,0,0,0,0
"Andorra","2024-08-19",0,0,0,0,0,0,0,0
"Andorra","2024-08-20",0,0,0,0,0,0,0,0
"Andorra","2024-08-21",0,0,0,0,0,0,0,0
"Andorra","2024-08-22",0,0,0,0,0,0,0,0
"Andorra","2024-08-23",0,0,0,0,0,0,0,0
"Andorra","2024-08-24",0,0,0,0,0,0,0,0
"Andorra","2024-08-25",0,0,0,0,0,0,0,0
"Andorra","2024-08-26",0,0,0,0,0,0,0,0
"Andorra","2024-08-27",0,0,0,0,0,0,0,0
"Andorra","2024-08-28",0,0,0,0,0,0,0,0
"Andorra","2024-08-29",0,0,0,0,0,0,0,0
"Andorra","2024-08-30",0,0,0,0,0,0,0,0
"Andorra","2024-08-31",0,0,0,0,0,0,0,0
"Andorra","2024-09-01",0,0,0,0,0,0,0,0
"Andorra","2024-09-02",0,0,0,0,0,0,0,0
"Andorra","2024-09-03",0,0,0,0,0,0,0,0
"Andorra","2024-09-04",0,0,0,0,0,0,0,0
"Andorra","2024-09-05",0,0,0,0,0,0,0,0
"Andorra","2024-09-06",0,0,0,0,0,0,0,0
"Andorra","2024-09-07",0,0,0,0,0,0,0,0
"Andorra","2024-09-08",0,0,0,0,0,0,0,0
"Andorra","2024-09-09",0,0,0,0,0,0,0,0
"Andorra","2024-09-10",0,0,0,0,0,0,0,0
"Andorra","2024-09-11",0,0,0,0,0,0,0,0
"Andorra","2024-09-12",0,0,0,0,0,0,0,0
"Andorra","2024-09-13",0,0,0,0,0,0,0,0
"Andorra","2024-09-14",0,0,0,0,0,0,0,0
"Andorra","2024-09-15",0,0,0,0,0,0,0,0
"Andorra","2024-09-16",0,0,0,0,0,0,0,0
"Andorra","2024-09-17",0,0,0,0,0,0,0,0
"Andorra","2024-09-18",0,0,0,0,0,0,0,0
"Andorra","2024-09-19",0,0,0,0,0,0,0,0
"Andorra","2024-09-20",0,0,0,0,0,0,0,0
"Andorra","2024-09-21",0,0,0,0,0,0,0,0
"Andorra","2024-09-22",0,0,0,0,0,0,0,0
"Andorra","2024-09-23",0,0,0,0,0,0,0,0
"Andorra","2024-09-24",0,0,0,0,0,0,0,0
"Andorra","2024-09-25",0,0,0,0,0,0,0,0
"Andorra","2024-09-26",0,0,0,0,0,0,0,0
"Andorra","2024-09-27",0,0,0,0,0,0,0,0
"Andorra","2024-09-28",0,0,0,0,0,0,0,0
"Andorra","2024-09-29",0,0,0,0,0,0,0,0
"Andorra","2024-09-30",0,0,0,0,0,0,0,0
"Andorra","2024-10-01",0,0,0,0,0,0,0,0
"Andorra","2024-10-02",0,0,0,0,0,0,0,0
"Andorra","2024-10-03",0,0,0,0,0,0,0,0
"Andorra","2024-10-04",0,0,0,0,0,0,0,0
"Andorra","2024-10-05",0,0,0,0,0,0,0,0
"Andorra","2024-10-06",0,0,0,0,0,0,0,0
"Andorra","2024-10-07",0,0,0,0,0,0,0,0
"Andorra","2024-10-08",0,0,0,0,0,0,0,0
"Andorra","2024-10-09",0,0,0,0,0,0,0,0
"Andorra","2024-10-10",0,0,0,0,0,0,0,0
"Andorra","2024-10-11",0,0,0,0,0,0,0,0
"Andorra","2024-10-12",0,0,0,0,0,0,0,0
"Andorra","2024-10-13",0,0,0,0,0,0,0,0
"Andorra","2024-10-14",0,0,0,0,0,0,0,0
"Andorra","2024-10-15",0,0,0,0,0,0,0,0
"Andorra","2024-10-16",0,0,0,0,0,0,0,0
"Andorra","2024-10-17",0,0,0,0,0,0,0,0
"Andorra","2024-10-18",0,0,0,0,0,0,0,0
"Andorra","2024-10-19",0,0,0,0,0,0,0,0
"Andorra","2024-10-20",0,0,0,0,0,0,0,0
"Andorra","2024-10-21",0,0,0,0,0,0,0,0
"Andorra","2024-10-22",0,0,0,0,0,0,0,0
"Andorra","2024-10-23",0,0,0,0,0,0,0,0
"Andorra","2024-10-24",0,0,0,0,0,0,0,0
"Andorra","2024-10-25",0,0,0,0,0,0,0,0
"Andorra","2024-10-26",0,0,0,0,0,0,0,0
"Andorra","2024-10-27",0,0,0,0,0,0,0,0
"Andorra","2024-10-28",0,0,0,0,0,0,0,0
"Andorra","2024-10-29",0,0,0,0,0,0,0,0
"Andorra","2024-10-30",0,0,0,0,0,0,0,0
"Andorra","2024-10-31",0,0,0,0,0,0,0,0
"Andorra","2024-11-01",0,0,0,0,0,0,0,0
"Andorra","2024-11-02",0,0,0,0,0,0,0,0
"Andorra","2024-11-03",0,0,0,0,0,0,0,0
"Andorra","2024-11-04",0,0,0,0,0,0,0,0
"Andorra","2024-11-05",0,0,0,0,0,0,0,0
"Andorra","2024-11-06",0,0,0,0,0,0,0,0
"Andorra","2024-11-07",0,0,0,0,0,0,0,0
"Andorra","2024-11-08",0,0,0,0,0,0,0,0
"Andorra","2024-11-09",0,0,0,0,0,0,0,0
"Andorra","2024-11-10",0,0,0,0,0,0,0,0
"Andorra","2024-11-11",0,0,0,0,0,0,0,0
"Andorra","2024-11-12",0,0,0,0,0,0,0,0
"Andorra","2024-11-13",0,0,0,0,0,0,0,0
"Andorra","2024-11-14",0,0,0,0,0,0,0,0
"Andorra","2024-11-15",0,0,0,0,0,0,0,0
"Andorra","2024-11-16",0,0,0,0,0,0,0,0
"Andorra","2024-11-17",0,0,0,0,0,0,0,0
"Andorra","2024-11-18",0,0,0,0,0,0,0,0
"Andorra","2024-11-19",0,0,0,0,0,0,0,0
"Andorra","2024-11-20",0,0,0,0,0,0,0,0
"Andorra","2024-11-21",0,0,0,0,0,0,0,0
"Andorra","2024-11-22",0,0,0,0,0,0,0,0
"Andorra","2024-11-23",0,0,0,0,0,0,0,0
"Andorra","2024-11-24",0,0,0,0,0,0,0,0
"Andorra","2024-11-25",0,0,0,0,0,0,0,0
"Andorra","2024-11-26",0,0,0,0,0,0,0,0
"Andorra","2024-11-27",0,0,0,0,0,0,0,0
"Andorra","2024-11-28",0,0,0,0,0,0,0,0
"Andorra","2024-11-29",0,0,0,0,0,0,0,0
"Andorra","2024-11-30",0,0,0,0,0,0,0,0
"Andorra","2024-12-01",0,0,0,0,0,0,0,0
"Andorra","2024-12-02",0,0,0,0,0,0,0,0
"Andorra","2024-12-03",0,0,0,0,0,0,0,0
"Andorra","2024-12-04",0,0,0,0,0,0,0,0
"Andorra","2024-12-05",0,0,0,0,0,0,0,0
"Andorra","2024-12-06",0,0,0,0,0,0,0,0
"Andorra","2024-12-07",0,0,0,0,0,0,0,0
"Andorra","2024-12-08",0,0,0,0,0,0,0,0
"Andorra","2024-12-09",0,0,0,0,0,0,0,0
"Andorra","2024-12-10",0,0,0,0,0,0,0,0
"Andorra","2024-12-11",0,0,0,0,0,0,0,0
"Andorra","2024-12-12",0,0,0,0,0,0,0,0
"Andorra","2024-12-13",0,0,0,0,0,0,0,0
"Andorra","2024-12-14",0,0,0,0,0,0,0,0
"Andorra","2024-12-15",0,0,0,0,0,0,0,0
"Andorra","2024-12-16",0,0,0,0,0,0,0,0
"Andorra","2024-12-17",0,0,0,0,0,0,0,0
"Andorra","2024-12-18",0,0,0,0,0,0,0,0
"Andorra","2024-12-19",0,0,0,0,0,0,0,0
"Andorra","2024-12-20",0,0,0,0,0,0,0,0
"Andorra","2024-12-21",0,0,0,0,0,0,0,0
"Andorra","2024-12-22",0,0,0,0,0,0,0,0
"Andorra","2024-12-23",0,0,0,0,0,0,0,0
"Andorra","2024-12-24",0,0,0,0,0,0,0,0
"Andorra","2024-12-25",0,0,0,0,0,0,0,0
"Andorra","2024-12-26",0,0,0,0,0,0,0,0
"Andorra","2024-12-27",0,0,0,0,0,0,0,0
"Andorra","2024-12-28",0,0,0,0,0,0,0,0
"Andorra","2024-12-29",0,0,0,0,0,0,0,0
"Andorra","2024-12-30",0,0,0,0,0,0,0,0
"Andorra","2024-12-31",0,0,0,0,0,0,0,0
"Andorra","2025-01-01",0,0,0,0,0,0,0,0
"Andorra","2025-01-02",0,0,0,0,0,0,0,0
"Andorra","2025-01-03",0,0,0,0,0,0,0,0
"Andorra","2025-01-04",0,0,0,0,0,0,0,0
"Andorra","2025-01-05",0,0,0,0,0,0,0,0
"Andorra","2025-01-06",0,0,0,0,0,0,0,0
"Andorra","2025-01-07",0,0,0,0,0,0,0,0
"Andorra","2025-01-08",0,0,0,0,0,0,0,0
"Andorra","2025-01-09",0,0,0,0,0,0,0,0
"Andorra","2025-01-10",0,0,0,0,0,0,0,0
"Andorra","2025-01-11",0,0,0,0,0,0,0,0
"Andorra","2025-01-12",0,0,0,0,0,0,0,0
"Andorra","2025-01-13",0,0,0,0,0,0,0,0
"Andorra","2025-01-14",0,0,0,0,0,0,0,0
"Andorra","2025-01-15",0,0,0,0,0,0,0,0
"Andorra","2025-01-16",0,0,0,0,0,0,0,0
"Andorra","2025-01-17",0,0,0,0,0,0,0,0
"Andorra","2025-01-18",0,0,0,0,0,0,0,0
"Andorra","2025-01-19",0,0,0,0,0,0,0,0
"Andorra","2025-01-20",0,0,0,0,0,0,0,0
"Andorra","2025-01-21",0,0,0,0,0,0,0,0
"Andorra","2025-01-22",0,0,0,0,0,0,0,0
"Andorra","2025-01-23",0,0,0,0,0,0,0,0
"Andorra","2025-01-24",0,0,0,0,0,0,0,0
"Andorra","2025-01-25",0,0,0,0,0,0,0,0
"Andorra","2025-01-26",0,0,0,0,0,0,0,0
"Andorra","2025-01-27",0,0,0,0,0,0,0,0
"Andorra","2025-01-28",0,0,0,0,0,0,0,0
"Andorra","2025-01-29",0,0,0,0,0,0,0,0
"Andorra","2025-01-30",0,0,0,0,0,0,0,0
"Andorra","2025-01-31",0,0,0,0,0,0,0,0
"Andorra","2025-02-01",0,0,0,0,0,0,0,0
"Andorra","2025-02-02",0,0,0,0,0,0,0,0
"Andorra","2025-02-03",0,0,0,0,0,0,0,0
"Andorra","2025-02-04",0,0,0,0,0,0,0,0
"Andorra","2025-02-05",0,0,0,0,0,0,0,0
"Andorra","2025-02-06",0,0,0,0,0,0,0,0
"Andorra","2025-02-07",0,0,0,0,0,0,0,0
"Andorra","2025-02-08",0,0,0,0,0,0,0,0
"Andorra","2025-02-09",0,0,0,0,0,0,0,0
"Andorra","2025-02-10",0,0,0,0,0,0,0,0
"Andorra","2025-02-11",0,0,0,0,0,0,0,0
"Andorra","2025-02-12",0,0,0,0,0,0,0,0
"Andorra","2025-02-13",0,0,0,0,0,0,0,0
"Andorra","2025-02-14",0,0,0,0,0,0,0,0
"Andorra","2025-02-15",0,0,0,0,0,0,0,0
"Andorra","2025-02-16",0,0,0,0,0,0,0,0
"Andorra","2025-02-17",0,0,0,0,0,0,0,0
"Andorra","2025-02-18",0,0,0,0,0,0,0,0
"Andorra","2025-02-19",0,0,0,0,0,0,0,0
"Andorra","2025-02-20",0,0,0,0,0,0,0,0
"Andorra","2025-02-21",0,0,0,0,0,0,0,0
"Andorra","2025-02-22",0,0,0,0,0,0,0,0
"Andorra","2025-02-23",0,0,0,0,0,0,0,0
"Andorra","2025-02-24",0,0,0,0,0,0,0,0
"Andorra","2025-02-25",0,0,0,0,0,0,0,0
"Andorra","2025-02-26",0,0,0,0,0,0,0,0
"Andorra","2025-02-27",0,0,0,0,0,0,0,0
"Andorra","2025-02-28",0,0,0,0,0,0,0,0
"Andorra","2025-03-01",0,0,0,0,0,0,0,0
"Andorra","2025-03-02",0,0,0,0,0,0,0,0
"Andorra","2025-03-03",0,0,0,0,0,0,0,0
"Angola","2024-01-01",0,0,0,0,0,0,0,0
"Angola","2024-01-02",0,0,0,0,0,0,0,0
"Angola","2024-01-03",0,0,0,0,0,0,0,0
"Angola","2024-01-04",0,0,0,0,0,0,0,0
"Angola","2024-01-05",0,0,0,0,0,0,0,0
"Angola","2024-01-06",0,0,0,0,0,0,0,0
"Angola","2024-01-07",0,0,0,0,0,0,0,0
"Angola","2024-01-08",0,0,0,0,0,0,0,0
"Angola","2024-01-09",0,0,0,0,0,0,0,0
"Angola","2024-01-10",0,0,0,0,0,0,0,0
"Angola","2024-01-11",0,0,0,0,0,0,0,0
"Angola","2024-01-12",0,0,0,0,0,0,0,0
"Angola","2024-01-13",0,0,0,0,0,0,0,0
"Angola","2024-01-14",0,0,0,0,0,0,0,0
"Angola","2024-01-15",0,0,0,0,0,0,0,0
"Angola","2024-01-16",0,0,0,0,0,0,0,0
"Angola","2024-01-17",0,0,0,0,0,0,0,0
"Angola","2024-01-18",0,0,0,0,0,0,0,0
"Angola","2024-01-19",0,0,0,0,0,0,0,0
"Angola","2024-01-20",0,0,0,0,0,0,0,0
"Angola","2024-01-21",0,0,0,0,0,0,0,0
"Angola","2024-01-22",0,0,0,0,0,0,0,0
"Angola","2024-01-23",0,0,0,0,0,0,0,0
"Angola","2024-01-24",0,0,0,0,0,0,0,0
"Angola","2024-01-25",0,0,0,0,0,0,0,0
"Angola","2024-01-26",0,0,0,0,0,0,0,0
"Angola","2024-01-27",0,0,0,0,0,0,0,0
"Angola","2024-01-28",0,0,0,0,0,0,0,0
"Angola","2024-01-29",0,0,0,0,0,0,0,0
"Angola","2024-01-30",0,0,0,0,0,0,0,0
"Angola","2024-01-31",0,0,0,0,0,0,0,0
"Angola","2024-02-01",0,0,0,0,0,0,0,0
"Angola","2024-02-02",0,0,0,0,0,0,0,0
"Angola","2024-02-03",0,0,0,0,0,0,0,0
"Angola","2024-02-04",0,0,0,0,0,0,0,0
"Angola","2024-02-05",0,0,0,0,0,0,0,0
"Angola","2024-02-06",0,0,0,0,0,0,0,0
"Angola","2024-02-07",0,0,0,0,0,0,0,0
"Angola","2024-02-08",0,0,0,0,0,0,0,0
"Angola","2024-02-09",0,0,0,0,0,0,0,0
"Angola","2024-02-10",0,0,0,0,0,0,0,0
"Angola","2024-02-11",0,0,0,0,0,0,0,0
"Angola","2024-02-12",0,0,0,0,0,0,0,0
"Angola","2024-02-13",0,0,0,0,0,0,0,0
"Angola","2024-02-14",0,0,0,0,0,0,0,0
"Angola","2024-02-15",0,0,0,0,0,0,0,0
"Angola","2024-02-16",0,0,0,0,0,0,0,0
"Angola","2024-02-17",0,0,0,0,0,0,0,0
"Angola","2024-02-18",0,0,0,0,0,0,0,0
"Angola","2024-02-19",0,0,0,0,0,0,0,0
"Angola","2024-02-20",0,0,0,0,0,0,0,0
"Angola","2024-02-21",0,0,0,0,0,0,0,0
"Angola","2024-02-22",0,0,0,0,0,0,0,0
"Angola","2024-02-23",0,0,0,0,0,0,0,0
"Angola","2024-02-24",0,0,0,0,0,0,0,0
"Angola","2024-02-25",0,0,0,0,0,0,0,0
"Angola","2024-02-26",0,0,0,0,0,0,0,0
"Angola","2024-02-27",0,0,0,0,0,0,0,0
"Angola","2024-02-28",0,0,0,0,0,0,0,0
"Angola","2024-02-29",0,0,0,0,0,0,0,0
"Angola","2024-03-01",0,0,0,0,0,0,0,0
"Angola","2024-03-02",0,0,0,0,0,0,0,0
"Angola","2024-03-03",0,0,0,0,0,0,0,0
"Angola","2024-03-04",0,0,0,0,0,0,0,0
"Angola","2024-03-05",0,0,0,0,0,0,0,0
"Angola","2024-03-06",0,0,0,0,0,0,0,0
"Angola","2024-03-07",0,0,0,0,0,0,0,0
"Angola","2024-03-08",0,0,0,0,0,0,0,0
"Angola","2024-03-09",0,0,0,0,0,0,0,0
"Angola","2024-03-10",0,0,0,0,0,0,0,0
"Angola","2024-03-11",0,0,0,0,0,0,0,0
"Angola","2024-03-12",0,0,0,0,0,0,0,0
"Angola","2024-03-13",0,0,0,0,0,0,0,0
"Angola","2024-03-14",0,0,0,0,0,0,0,0
"Angola","2024-03-15",0,0,0,0,0,0,0,0
"Angola","2024-03-16",0,0,0,0,0,0,0,0
"Angola","2024-03-17",0,0,0,0,0,0,0,0
"Angola","2024-03-18",0,0,0,0,0,0,0,0
"Angola","2024-03-19",0,0,0,0,0,0,0,0
"Angola","2024-03-20",0,0,0,0,0,0,0,0
"Angola","2024-03-21",0,0,0,0,0,0,0,0
"Angola","2024-03-22",0,0,0,0,0,0,0,0
"Angola","2024-03-23",0,0,0,0,0,0,0,0
"Angola","2024-03-24",0,0,0,0,0,0,0,0
"Angola","2024-03-25",0,0,0,0,0,0,0,0
"Angola","2024-03-26",0,0,0,0,0,0,0,0
"Angola","2024-03-27",0,0,0,0,0,0,0,0
"Angola","2024-03-28",0,0,0,0,0,0,0,0
"Angola","2024-03-29",0,0,0,0,0,0,0,0
"Angola","2024-03-30",0,0,0,0,0,0,0,0
"Angola","2024-03-31",0,0,0,0,0,0,0,0
"Angola","2024-04-01",0,0,0,0,0,0,0,0
"Angola","2024-04-02",0,0,0,0,0,0,0,0
"Angola","2024-04-03",0,0,0,0,0,0,0,0
"Angola","2024-04-04",0,0,0,0,0,0,0,0
"Angola","2024-04-05",0,0,0,0,0,0,0,0
"Angola","2024-04-06",0,0,0,0,0,0,0,0
"Angola","2024-04-07",0,0,0,0,0,0,0,0
"Angola","2024-04-08",0,0,0,0,0,0,0,0
"Angola","2024-04-09",0,0,0,0,0,0,0,0
"Angola","2024-04-10",0,0,0,0,0,0,0,0
"Angola","2024-04-11",0,0,0,0,0,0,0,0
"Angola","2024-04-12",0,0,0,0,0,0,0,0
"Angola","2024-04-13",0,0,0,0,0,0,0,0
"Angola","2024-04-14",0,0,0,0,0,0,0,0
"Angola","2024-04-15",0,0,0,0,0,0,0,0
"Angola","2024-04-16",0,0,0,0,0,0,0,0
"Angola","2024-04-17",0,0,0,0,0,0,0,0
"Angola","2024-04-18",0,0,0,0,0,0,0,0
"Angola","2024-04-19",0,0,0,0,0,0,0,0
"Angola","2024-04-20",0,0,0,0,0,0,0,0
"Angola","2024-04-21",0,0,0,0,0,0,0,0
"Angola","2024-04-22",0,0,0,0,0,0,0,0
"Angola","2024-04-23",0,0,0,0,0,0,0,0
"Angola","2024-04-24",0,0,0,0,0,0,0,0
"Angola","2024-04-25",0,0,0,0,0,0,0,0
"Angola","2024-04-26",0,0,0,0,0,0,0,0
"Angola","2024-04-27",0,0,0,0,0,0,0,0
"Angola","2024-04-28",0,0,0,0,0,0,0,0
"Angola","2024-04-29",0,0,0,0,0,0,0,0
"Angola","2024-04-30",0,0,0,0,0,0,0,0
"Angola","2024-05-01",0,0,0,0,0,0,0,0
"Angola","2024-05-02",0,0,0,0,0,0,0,0
"Angola","2024-05-03",0,0,0,0,0,0,0,0
"Angola","2024-05-04",0,0,0,0,0,0,0,0
"Angola","2024-05-05",0,0,0,0,0,0,0,0
"Angola","2024-05-06",0,0,0,0,0,0,0,0
"Angola","2024-05-07",0,0,0,0,0,0,0,0
"Angola","2024-05-08",0,0,0,0,0,0,0,0
"Angola","2024-05-09",0,0,0,0,0,0,0,0
"Angola","2024-05-10",0,0,0,0,0,0,0,0
"Angola","2024-05-11",0,0,0,0,0,0,0,0
"Angola","2024-05-12",0,0,0,0,0,0,0,0
"Angola","2024-05-13",0,0,0,0,0,0,0,0
"Angola","2024-05-14",0,0,0,0,0,0,0,0
"Angola","2024-05-15",0,0,0,0,0,0,0,0
"Angola","2024-05-16",0,0,0,0,0,0,0,0
"Angola","2024-05-17",0,0,0,0,0,0,0,0
"Angola","2024-05-18",0,0,0,0,0,0,0,0
"Angola","2024-05-19",0,0,0,0,0,0,0,0
"Angola","2024-05-20",0,0,0,0,0,0,0,0
"Angola","2024-05-21",0,0,0,0,0,0,0,0
"Angola","2024-05-22",0,0,0,0,0,0,0,0
"Angola","2024-05-23",0,0,0,0,0,0,0,0
"Angola","2024-05-24",0,0,0,0,0,0,0,0
"Angola","2024-05-25",0,0,0,0,0,0,0,0
"Angola","2024-05-26",0,0,0,0,0,0,0,0
"Angola","2024-05-27",0,0,0,0,0,0,0,0
"Angola","2024-05-28",0,0,0,0,0,0,0,0
"Angola","2024-05-29",0,0,0,0,0,0,0,0
"Angola","2024-05-30",0,0,0,0,0,0,0,0
"Angola","2024-05-31",0,0,0,0,0,0,0,0
"Angola","2024-06-01",0,0,0,0,0,0,0,0
"Angola","2024-06-02",0,0,0,0,0,0,0,0
"Angola","2024-06-03",0,0,0,0,0,0,0,0
"Angola","2024-06-04",0,0,0,0,0,0,0,0
"Angola","2024-06-05",0,0,0,0,0,0,0,0
"Angola","2024-06-06",0,0,0,0,0,0,0,0
"Angola","2024-06-07",0,0,0,0,0,0,0,0
"Angola","2024-06-08",0,0,0,0,0,0,0,0
"Angola","2024-06-09",0,0,0,0,0,0,0,0
"Angola","2024-06-10",0,0,0,0,0,0,0,0
"Angola","2024-06-11",0,0,0,0,0,0,0,0
"Angola","2024-06-12",0,0,0,0,0,0,0,0
"Angola","2024-06-13",0,0,0,0,0,0,0,0
"Angola","2024-06-14",0,0,0,0,0,0,0,0
"Angola","2024-06-15",0,0,0,0,0,0,0,0
"Angola","2024-06-16",0,0,0,0,0,0,0,0
"Angola","2024-06-17",0,0,0,0,0,0,0,0
"Angola","2024-06-18",0,0,0,0,0,0,0,0
"Angola","2024-06-19",0,0,0,0,0,0,0,0
"Angola","2024-06-20",0,0,0,0,0,0,0,0
"Angola","2024-06-21",0,0,0,0,0,0,0,0
"Angola","2024-06-22",0,0,0,0,0,0,0,0
"Angola","2024-06-23",0,0,0,0,0,0,0,0
"Angola","2024-06-24",0,0,0,0,0,0,0,0
"Angola","2024-06-25",0,0,0,0,0,0,0,0
"Angola","2024-06-26",0,0,0,0,0,0,0,0
"Angola","2024-06-27",0,0,0,0,0,0,0,0
"Angola","2024-06-28",0,0,0,0,0,0,0,0
"Angola","2024-06-29",0,0,0,0,0,0,0,0
"Angola","2024-06-30",0,0,0,0,0,0,0,0
"Angola","2024-07-01",0,0,0,0,0,0,0,0
"Angola","2024-07-02",0,0,0,0,0,0,0,0
"Angola","2024-07-03",0,0,0,0,0,0,0,0
"Angola","2024-07-04",0,0,0,0,0,0,0,0
"Angola","2024-07-05",0,0,0,0,0,0,0,0
"Angola","2024-07-06",0,0,0,0,0,0,0,0
"Angola","2024-07-07",0,0,0,0,0,0,0,0
"Angola","2024-07-08",0,0,0,0,0,0,0,0
"Angola","2024-07-09",0,0,0,0,0,0,0,0
"Angola","2024-07-10",0,0,0,0,0,0,0,0
"Angola","2024-07-11",0,0,0,0,0,0,0,0
"Angola","2024-07-12",0,0,0,0,0,0,0,0
"Angola","2024-07-13",0,0,0,0,0,0,0,0
"Angola","2024-07-14",0,0,0,0,0,0,0,0
"Angola","2024-07-15",0,0,0,0,0,0,0,0
"Angola","2024-07-16",0,0,0,0,0,0,0,0
"Angola","2024-07-17",0,0,0,0,0,0,0,0
"Angola","2024-07-18",0,0,0,0,0,0,0,0
"Angola","2024-07-19",0,0,0,0,0,0,0,0
"Angola","2024-07-20",0,0,0,0,0,0,0,0
"Angola","2024-07-21",0,0,0,0,0,0,0,0
"Angola","2024-07-22",0,0,0,0,0,0,0,0
"Angola","2024-07-23",0,0,0,0,0,0,0,0
"Angola","2024-07-24",0,0,0,0,0,0,0,0
"Angola","2024-07-25",0,0,0,0,0,0,0,0
"Angola","2024-07-26",0,0,0,0,0,0,0,0
"Angola","2024-07-27",0,0,0,0,0,0,0,0
"Angola","2024-07-28",0,0,0,0,0,0,0,0
"Angola","2024-07-29",0,0,0,0,0,0,0,0
"Angola","2024-07-30",0,0,0,0,0,0,0,0
"Angola","2024-07-31",0,0,0,0,0,0,0,0
"Angola","2024-08-01",0,0,0,0,0,0,0,0
"Angola","2024-08-02",0,0,0,0,0,0,0,0
"Angola","2024-08-03",0,0,0,0,0,0,0,0
"Angola","2024-08-04",0,0,0,0,0,0,0,0
"Angola","2024-08-05",0,0,0,0,0,0,0,0
"Angola","2024-08-06",0,0,0,0,0,0,0,0
"Angola","2024-08-07",0,0,0,0,0,0,0,0
"Angola","2024-08-08",0,0,0,0,0,0,0,0
"Angola","2024-08-09",0,0,0,0,0,0,0,0
"Angola","2024-08-10",0,0,0,0,0,0,0,0
"Angola","2024-08-11",0,0,0,0,0,0,0,0
"Angola","2024-08-12",0,0,0,0,0,0,0,0
"Angola","2024-08-13",0,0,0,0,0,0,0,0
"Angola","2024-08-14",0,0,0,0,0,0,0,0
"Angola","2024-08-15",0,0,0,0,0,0,0,0
"Angola","2024-08-16",0,0,0,0,0,0,0,0
"Angola","2024-08-17",0,0,0,0,0,0,0,0
"Angola","2024-08-18",0,0,0,0,0,0,0,0
"Angola","2024-08-19",0,0,0,0,0,0,0,0
"Angola","2024-08-20",0,0,0,0,0,0,0,0
"Angola","2024-08-21",0,0,0,0,0,0,0,0
"Angola","2024-08-22",0,0,0,0,0,0,0,0
"Angola","2024-08-23",0,0,0,0,0,0,0,0
"Angola","2024-08-24",0,0,0,0,0,0,0,0
"Angola","2024-08-25",0,0,0,0,0,0,0,0
"Angola","2024-08-26",0,0,0,0,0,0,0,0
"Angola","2024-08-27",0,0,0,0,0,0,0,0
"Angola","2024-08-28",0,0,0,0,0,0,0,0
"Angola","2024-08-29",0,0,0,0,0,0,0,0
"Angola","2024-08-30",0,0,0,0,0,0,0,0
"Angola","2024-08-31",0,0,0,0,0,0,0,0
"Angola","2024-09-01",0,0,0,0,0,0,0,0
"Angola","2024-09-02",0,0,0,0,0,0,0,0
"Angola","2024-09-03",0,0,0,0,0,0,0,0
"Angola","2024-09-04",0,0,0,0,0,0,0,0
"Angola","2024-09-05",0,0,0,0,0,0,0,0
"Angola","2024-09-06",0,0,0,0,0,0,0,0
"Angola","2024-09-07",0,0,0,0,0,0,0,0
"Angola","2024-09-08",0,0,0,0,0,0,0,0
"Angola","2024-09-09",0,0,0,0,0,0,0,0
"Angola","2024-09-10",0,0,0,0,0,0,0,0
"Angola","2024-09-11",0,0,0,0,0,0,0,0
"Angola","2024-09-12",0,0,0,0,0,0,0,0
"Angola","2024-09-13",0,0,0,0,0,0,0,0
"Angola","2024-09-14",0,0,0,0,0,0,0,0
"Angola","2024-09-15",0,0,0,0,0,0,0,0
"Angola","2024-09-16",0,0,0,0,0,0,0,0
"Angola","2024-09-17",0,0,0,0,0,0,0,0
"Angola","2024-09-18",0,0,0,0,0,0,0,0
"Angola","2024-09-19",0,0,0,0,0,0,0,0
"Angola","2024-09-20",0,0,0,0,0,0,0,0
"Angola","2024-09-21",0,0,0,0,0,0,0,0
"Angola","2024-09-22",0,0,0,0,0,0,0,0
"Angola","2024-09-23",0,0,0,0,0,0,0,0
"Angola","2024-09-24",0,0,0,0,0,0,0,0
"Angola","2024-09-25",0,0,0,0,0,0,0,0
"Angola","2024-09-26",0,0,0,0,0,0,0,0
"Angola","2024-09-27",0,0,0,0,0,0,0,0
"Angola","2024-09-28",0,0,0,0,0,0,0,0
"Angola","2024-09-29",0,0,0,0,0,0,0,0
"Angola","2024-09-30",0,0,0,0,0,0,0,0
"Angola","2024-10-01",0,0,0,0,0,0,0,0
"Angola","2024-10-02",0,0,0,0,0,0,0,0
"Angola","2024-10-03",0,0,0,0,0,0,0,0
"Angola","2024-10-04",0,0,0,0,0,0,0,0
"Angola","2024-10-05",0,0,0,0,0,0,0,0
"Angola","2024-10-06",0,0,0,0,0,0,0,0
"Angola","2024-10-07",0,0,0,0,0,0,0,0
"Angola","2024-10-08",0,0,0,0,0,0,0,0
"Angola","2024-10-09",0,0,0,0,0,0,0,0
"Angola","2024-10-10",0,0,0,0,0,0,0,0
"Angola","2024-10-11",0,0,0,0,0,0,0,0
"Angola","2024-10-12",0,0,0,0,0,0,0,0
"Angola","2024-10-13",0,0,0,0,0,0,0,0
"Angola","2024-10-14",0,0,0,0,0,0,0,0
"Angola","2024-10-15",0,0,0,0,0,0,0,0
"Angola","2024-10-16",0,0,0,0,0,0,0,0
"Angola","2024-10-17",0,0,0,0,0,0,0,0
"Angola","2024-10-18",0,0,0,0,0,0,0,0
"Angola","2024-10-19",0,0,0,0,0,0,0,0
"Angola","2024-10-20",0,0,0,0,0,0,0,0
"Angola","2024-10-21",0,0,0,0,0,0,0,0
"Angola","2024-10-22",0,0,0,0,0,0,0,0
"Angola","2024-10-23",0,0,0,0,0,0,0,0
"Angola","2024-10-24",0,0,0,0,0,0,0,0
"Angola","2024-10-25",0,0,0,0,0,0,0,0
"Angola","2024-10-26",0,0,0,0,0,0,0,0
"Angola","2024-10-27",0,0,0,0,0,0,0,0
"Angola","2024-10-28",0,0,0,0,0,0,0,0
"Angola","2024-10-29",0,0,0,0,0,0,0,0
"Angola","2024-10-30",0,0,0,0,0,0,0,0
"Angola","2024-10-31",0,0,0,0,0,0,0,0
"Angola","2024-11-01",0,0,0,0,0,0,0,0
"Angola","2024-11-02",0,0,0,0,0,0,0,0
"Angola","2024-11-03",0,0,0,0,0,0,0,0
"Angola","2024-11-04",0,0,0,0,0,0,0,0
"Angola","2024-11-05",0,0,0,0,0,0,0,0
"Angola","2024-11-06",0,0,0,0,0,0,0,0
"Angola","2024-11-07",0,0,0,0,0,0,0,0
"Angola","2024-11-08",0,0,0,0,0,0,0,0
"Angola","2024-11-09",0,0,0,0,0,0,0,0
"Angola","2024-11-10",0,0,0,0,0,0,0,0
"Angola","2024-11-11",0,0,0,0,0,0,0,0
"Angola","2024-11-12",0,0,0,0,0,0,0,0
"Angola","2024-11-13",0,0,0,0,0,0,0,0
"Angola","2024-11-14",0,0,0,0,0,0,0,0
"Angola","2024-11-15",0,0,0,0,0,0,0,0
"Angola","2024-11-16",0,0,0,0,0,0,0,0
"Angola","2024-11-17",0,1,1,0,1,1,0,0
"Angola","2024-11-18",0,0,1,0,0,1,0,0
"Angola","2024-11-19",0,0,1,0,1,2,0,0
"Angola","2024-11-20",0,1,2,0,0,2,0,0
"Angola","2024-11-21",0,0,2,0,0,2,0,0
"Angola","2024-11-22",0,0,2,0,0,2,0,0
"Angola","2024-11-23",0,0,2,0,0,2,0,0
"Angola","2024-11-24",0,0,2,0,0,2,0,0
"Angola","2024-11-25",0,0,2,0,0,2,0,0
"Angola","2024-11-26",0,0,2,0,1,3,0,0
"Angola","2024-11-27",0,0,2,0,0,3,0,0
"Angola","2024-11-28",0,0,2,0,0,3,0,0
"Angola","2024-11-29",0,0,2,0,0,3,0,0
"Angola","2024-11-30",0,0,2,0,0,3,0,0
"Angola","2024-12-01",0,1,3,0,0,3,0,0
"Angola","2024-12-02",0,0,3,0,0,3,0,0
"Angola","2024-12-03",0,0,3,0,0,3,0,0
"Angola","2024-12-04",0,0,3,0,0,3,0,0
"Angola","2024-12-05",0,0,3,0,1,4,0,0
"Angola","2024-12-06",0,0,3,0,0,4,0,0
"Angola","2024-12-07",0,0,3,0,0,4,0,0
"Angola","2024-12-08",0,1,4,0,0,4,0,0
"Angola","2024-12-09",0,0,4,0,0,4,0,0
"Angola","2024-12-10",0,0,4,0,0,4,0,0
"Angola","2024-12-11",0,0,4,0,0,4,0,0
"Angola","2024-12-12",0,0,4,0,0,4,0,0
"Angola","2024-12-13",0,0,4,0,0,4,0,0
"Angola","2024-12-14",0,0,4,0,0,4,0,0
"Angola","2024-12-15",0,0,4,0,0,4,0,0
"Angola","2024-12-16",0,0,4,0,0,4,0,0
"Angola","2024-12-17",0,0,4,0,0,4,0,0
"Angola","2024-12-18",0,0,4,0,0,4,0,0
"Angola","2024-12-19",0,0,4,0,0,4,0,0
"Angola","2024-12-20",0,0,4,0,0,4,0,0
"Angola","2024-12-21",0,0,4,0,0,4,0,0
"Angola","2024-12-22",0,0,4,0,0,4,0,0
"Angola","2024-12-23",0,0,4,0,0,4,0,0
"Angola","2024-12-24",0,0,4,0,0,4,0,0
"Angola","2024-12-25",0,0,4,0,0,4,0,0
"Angola","2024-12-26",0,0,4,0,0,4,0,0
"Angola","2024-12-27",0,0,4,0,0,4,0,0
"Angola","2024-12-28",0,0,4,0,0,4,0,0
"Angola","2024-12-29",0,0,4,0,0,4,0,0
"Angola","2024-12-30",0,0,4,0,0,4,0,0
"Angola","2024-12-31",0,0,4,0,0,4,0,0
"Angola","2025-01-01",0,0,4,0,0,4,0,0
"Angola","2025-01-02",0,0,4,0,0,4,0,0
"Angola","2025-01-03",0,0,4,0,0,4,0,0
"Angola","2025-01-04",0,0,4,0,0,4,0,0
"Angola","2025-01-05",0,0,4,0,0,4,0,0
"Angola","2025-01-06",0,0,4,0,0,4,0,0
"Angola","2025-01-07",0,0,4,0,0,4,0,0
"Angola","2025-01-08",0,0,4,0,0,4,0,0
"Angola","2025-01-09",0,0,4,0,0,4,0,0
"Angola","2025-01-10",0,0,4,0,0,4,0,0
"Angola","2025-01-11",0,0,4,0,0,4,0,0
"Angola","2025-01-12",0,0,4,0,0,4,0,0
"Angola","2025-01-13",0,0,4,0,0,4,0,0
"Angola","2025-01-14",0,0,4,0,0,4,0,0
"Angola","2025-01-15",0,0,4,0,0,4,0,0
"Angola","2025-01-16",0,0,4,0,0,4,0,0
"Angola","2025-01-17",0,0,4,0,0,4,0,0
"Angola","2025-01-18",0,0,4,0,0,4,0,0
"Angola","2025-01-19",0,0,4,0,0,4,0,0
"Angola","2025-01-20",0,0,4,0,0,4,0,0
"Angola","2025-01-21",0,0,4,0,0,4,0,0
"Angola","2025-01-22",0,0,4,0,0,4,0,0
"Angola","2025-01-23",0,0,4,0,0,4,0,0
"Angola","2025-01-24",0,0,4,0,0,4,0,0
"Angola","2025-01-25",0,0,4,0,0,4,0,0
"Angola","2025-01-26",0,0,4,0,0,4,0,0
"Angola","2025-01-27",0,0,4,0,0,4,0,0
"Angola","2025-01-28",0,0,4,0,0,4,0,0
"Angola","2025-01-29",0,0,4,0,0,4,0,0
"Angola","2025-01-30",0,0,4,0,0,4,0,0
"Angola","2025-01-31",0,0,4,0,0,4,0,0
"Angola","2025-02-01",0,0,4,0,0,4,0,0
"Angola","2025-02-02",0,0,4,0,0,4,0,0
"Angola","2025-02-03",0,0,4,0,0,4,0,0
"Angola","2025-02-04",0,0,4,0,0,4,0,0
"Angola","2025-02-05",0,0,4,0,0,4,0,0
"Angola","2025-02-06",0,0,4,0,0,4,0,0
"Angola","2025-02-07",0,0,4,0,0,4,0,0
"Angola","2025-02-08",0,0,4,0,0,4,0,0
"Angola","2025-02-09",0,0,4,0,0,4,0,0
"Angola","2025-02-10",0,0,4,0,0,4,0,0
"Angola","2025-02-11",0,0,4,0,0,4,0,0
"Angola","2025-02-12",0,0,4,0,0,4,0,0
"Angola","2025-02-13",0,0,4,0,0,4,0,0
"Angola","2025-02-14",0,0,4,0,0,4,0,0
"Angola","2025-02-15",0,0,4,0,0,4,0,0
"Angola","2025-02-16",0,0,4,0,0,4,0,0
"Angola","2025-02-17",0,0,4,0,0,4,0,0
"Angola","2025-02-18",0,0,4,0,0,4,0,0
"Angola","2025-02-19",0,0,4,0,0,4,0,0
"Angola","2025-02-20",0,0,4,0,0,4,0,0
"Angola","2025-02-21",0,0,4,0,0,4,0,0
"Angola","2025-02-22",0,0,4,0,0,4,0,0
"Angola","2025-02-23",0,0,4,0,0,4,0,0
"Angola","2025-02-24",0,0,4,0,0,4,0,0
"Angola","2025-02-25",0,0,4,0,0,4,0,0
"Angola","2025-02-26",0,0,4,0,0,4,0,0
"Angola","2025-02-27",0,0,4,0,0,4,0,0
"Angola","2025-02-28",0,0,4,0,0,4,0,0
"Angola","2025-03-01",0,0,4,0,0,4,0,0
"Angola","2025-03-02",0,0,4,0,0,4,0,0
"Angola","2025-03-03",0,0,4,0,0,4,0,0
"Argentina","2024-01-01",0,0,0,0,0,0,0,0
"Argentina","2024-01-02",0,0,0,0,0,0,0,0
"Argentina","2024-01-03",0,0,0,0,0,0,0,0
"Argentina","2024-01-04",0,0,0,0,0,0,0,0
"Argentina","2024-01-05",0,0,0,0,0,0,0,0
"Argentina","2024-01-06",0,0,0,0,0,0,0,0
"Argentina","2024-01-07",0,0,0,0,0,0,0,0
"Argentina","2024-01-08",0,0,0,0,0,0,0,0
"Argentina","2024-01-09",0,0,0,0,0,0,0,0
"Argentina","2024-01-10",0,0,0,0,0,0,0,0
"Argentina","2024-01-11",0,0,0,0,0,0,0,0
"Argentina","2024-01-12",0,0,0,0,0,0,0,0
"Argentina","2024-01-13",0,0,0,0,0,0,0,0
"Argentina","2024-01-14",0,0,0,0,0,0,0,0
"Argentina","2024-01-15",0,0,0,0,0,0,0,0
"Argentina","2024-01-16",0,0,0,0,0,0,0,0
"Argentina","2024-01-17",0,0,0,0,0,0,0,0
"Argentina","2024-01-18",0,0,0,0,0,0,0,0
"Argentina","2024-01-19",0,0,0,0,0,0,0,0
"Argentina","2024-01-20",0,0,0,0,0,0,0,0
"Argentina","2024-01-21",0,0,0,0,0,0,0,0
"Argentina","2024-01-22",0,0,0,0,0,0,0,0
"Argentina","2024-01-23",0,1,1,0,1,1,0,0
"Argentina","2024-01-24",0,0,1,0,0,1,0,0
"Argentina","2024-01-25",0,0,1,0,0,1,0,0
"Argentina","2024-01-26",0,0,1,0,0,1,0,0
"Argentina","2024-01-27",0,0,1,0,0,1,0,0
"Argentina","2024-01-28",0,0,1,0,0,1,0,0
"Argentina","2024-01-29",0,0,1,0,0,1,0,0
"Argentina","2024-01-30",0,0,1,0,0,1,0,0
"Argentina","2024-01-31",0,0,1,0,0,1,0,0
"Argentina","2024-02-01",0,0,1,0,0,1,0,0
"Argentina","2024-02-02",0,0,1,0,0,1,0,0
"Argentina","2024-02-03",0,0,1,0,0,1,0,0
"Argentina","2024-02-04",0,0,1,0,0,1,0,0
"Argentina","2024-02-05",0,0,1,0,0,1,0,0
"Argentina","2024-02-06",0,0,1,0,0,1,0,0
"Argentina","2024-02-07",0,0,1,0,0,1,0,0
"Argentina","2024-02-08",0,0,1,0,0,1,0,0
"Argentina","2024-02-09",0,0,1,0,0,1,0,0
"Argentina","2024-02-10",0,0,1,0,0,1,0,0
"Argentina","2024-02-11",0,0,1,0,0,1,0,0
"Argentina","2024-02-12",0,0,1,0,0,1,0,0
"Argentina","2024-02-13",0,0,1,0,0,1,0,0
"Argentina","2024-02-14",0,0,1,0,0,1,0,0
"Argentina","2024-02-15",0,0,1,0,0,1,0,0
"Argentina","2024-02-16",0,0,1,0,0,1,0,0
"Argentina","2024-02-17",0,0,1,0,0,1,0,0
"Argentina","2024-02-18",0,0,1,0,0,1,0,0
"Argentina","2024-02-19",0,0,1,0,0,1,0,0
"Argentina","2024-02-20",0,0,1,0,0,1,0,0
"Argentina","2024-02-21",0,0,1,0,0,1,0,0
"Argentina","2024-02-22",0,0,1,0,0,1,0,0
"Argentina","2024-02-23",0,0,1,0,0,1,0,0
"Argentina","2024-02-24",0,0,1,0,0,1,0,0
"Argentina","2024-02-25",0,0,1,0,0,1,0,0
"Argentina","2024-02-26",0,0,1,0,0,1,0,0
"Argentina","2024-02-27",0,0,1,0,0,1,0,0
"Argentina","2024-02-28",0,0,1,0,0,1,0,0
"Argentina","2024-02-29",0,0,1,0,0,1,0,0
"Argentina","2024-03-01",0,0,1,0,0,1,0,0
"Argentina","2024-03-02",0,0,1,0,0,1,0,0
"Argentina","2024-03-03",0,0,1,0,0,1,0,0
"Argentina","2024-03-04",0,0,1,0,1,2,0,0
"Argentina","2024-03-05",0,0,1,0,0,2,0,0
"Argentina","2024-03-06",0,0,1,0,0,2,0,0
"Argentina","2024-03-07",0,0,1,0,0,2,0,0
"Argentina","2024-03-08",0,0,1,0,0,2,0,0
"Argentina","2024-03-09",0,0,1,0,0,2,0,0
"Argentina","2024-03-10",0,0,1,0,0,2,0,0
"Argentina","2024-03-11",0,0,1,0,0,2,0,0
"Argentina","2024-03-12",0,0,1,0,0,2,0,0
"Argentina","2024-03-13",0,0,1,0,0,2,0,0
"Argentina","2024-03-14",0,0,1,0,0,2,0,0
"Argentina","2024-03-15",0,0,1,0,0,2,0,0
"Argentina","2024-03-16",0,0,1,0,0,2,0,0
"Argentina","2024-03-17",0,0,1,0,0,2,0,0
"Argentina","2024-03-18",0,0,1,0,0,2,0,0
"Argentina","2024-03-19",0,0,1,0,0,2,0,0
"Argentina","2024-03-20",0,0,1,0,0,2,0,0
"Argentina","2024-03-21",0,0,1,0,0,2,0,0
"Argentina","2024-03-22",0,0,1,0,0,2,0,0
"Argentina","2024-03-23",0,0,1,0,0,2,0,0
"Argentina","2024-03-24",0,0,1,0,0,2,0,0
"Argentina","2024-03-25",0,0,1,0,0,2,0,0
"Argentina","2024-03-26",0,0,1,0,0,2,0,0
"Argentina","2024-03-27",0,0,1,0,0,2,0,0
"Argentina","2024-03-28",0,0,1,0,0,2,0,0
"Argentina","2024-03-29",0,0,1,0,0,2,0,0
"Argentina","2024-03-30",0,0,1,0,0,2,0,0
"Argentina","2024-03-31",0,0,1,0,0,2,0,0
"Argentina","2024-04-01",0,0,1,0,0,2,0,0
"Argentina","2024-04-02",0,0,1,0,0,2,0,0
"Argentina","2024-04-03",0,0,1,0,0,2,0,0
"Argentina","2024-04-04",0,0,1,0,0,2,0,0
"Argentina","2024-04-05",0,0,1,0,0,2,0,0
"Argentina","2024-04-06",0,0,1,0,0,2,0,0
"Argentina","2024-04-07",0,0,1,0,0,2,0,0
"Argentina","2024-04-08",0,0,1,0,0,2,0,0
"Argentina","2024-04-09",0,0,1,0,0,2,0,0
"Argentina","2024-04-10",0,0,1,0,0,2,0,0
"Argentina","2024-04-11",0,0,1,0,0,2,0,0
"Argentina","2024-04-12",0,0,1,0,0,2,0,0
"Argentina","2024-04-13",0,0,1,0,0,2,0,0
"Argentina","2024-04-14",0,0,1,0,0,2,0,0
"Argentina","2024-04-15",0,0,1,0,0,2,0,0
"Argentina","2024-04-16",0,0,1,0,0,2,0,0
"Argentina","2024-04-17",0,0,1,0,0,2,0,0
"Argentina","2024-04-18",0,0,1,0,0,2,0,0
"Argentina","2024-04-19",0,0,1,0,0,2,0,0
"Argentina","2024-04-20",0,0,1,0,0,2,0,0
"Argentina","2024-04-21",0,0,1,0,0,2,0,0
"Argentina","2024-04-22",0,0,1,0,0,2,0,0
"Argentina","2024-04-23",0,0,1,0,0,2,0,0
"Argentina","2024-04-24",0,0,1,0,0,2,0,0
"Argentina","2024-04-25",0,0,1,0,0,2,0,0
"Argentina","2024-04-26",0,0,1,0,0,2,0,0
"Argentina","2024-04-27",0,0,1,0,0,2,0,0
"Argentina","2024-04-28",0,0,1,0,0,2,0,0
"Argentina","2024-04-29",0,0,1,0,0,2,0,0
"Argentina","2024-04-30",0,0,1,0,0,2,0,0
"Argentina","2024-05-01",0,0,1,0,0,2,0,0
"Argentina","2024-05-02",0,0,1,0,0,2,0,0
"Argentina","2024-05-03",0,0,1,0,0,2,0,0
"Argentina","2024-05-04",0,0,1,0,0,2,0,0
"Argentina","2024-05-05",0,0,1,0,0,2,0,0
"Argentina","2024-05-06",0,0,1,0,0,2,0,0
"Argentina","2024-05-07",0,0,1,0,0,2,0,0
"Argentina","2024-05-08",0,0,1,0,0,2,0,0
"Argentina","2024-05-09",0,0,1,0,0,2,0,0
"Argentina","2024-05-10",0,0,1,0,0,2,0,0
"Argentina","2024-05-11",0,0,1,0,0,2,0,0
"Argentina","2024-05-12",0,0,1,0,0,2,0,0
"Argentina","2024-05-13",0,0,1,0,0,2,0,0
"Argentina","2024-05-14",0,0,1,0,0,2,0,0
"Argentina","2024-05-15",0,0,1,0,0,2,0,0
"Argentina","2024-05-16",0,0,1,0,0,2,0,0
"Argentina","2024-05-17",0,0,1,0,0,2,0,0
"Argentina","2024-05-18",0,0,1,0,0,2,0,0
"Argentina","2024-05-19",0,0,1,0,0,2,0,0
"Argentina","2024-05-20",0,0,1,0,0,2,0,0
"Argentina","2024-05-21",0,0,1,0,0,2,0,0
"Argentina","2024-05-22",0,0,1,0,0,2,0,0
"Argentina","2024-05-23",0,0,1,0,1,3,0,0
"Argentina","2024-05-24",0,0,1,0,0,3,0,0
"Argentina","2024-05-25",0,0,1,0,0,3,0,0
"Argentina","2024-05-26",0,0,1,0,0,3,0,0
"Argentina","2024-05-27",0,0,1,0,0,3,0,0
"Argentina","2024-05-28",0,0,1,0,0,3,0,0
"Argentina","2024-05-29",0,0,1,0,0,3,0,0
"Argentina","2024-05-30",0,0,1,0,0,3,0,0
"Argentina","2024-05-31",0,0,1,0,0,3,0,0
"Argentina","2024-06-01",0,0,1,0,0,3,0,0
"Argentina","2024-06-02",0,0,1,0,0,3,0,0
"Argentina","2024-06-03",0,0,1,0,0,3,0,0
"Argentina","2024-06-04",0,0,1,0,0,3,0,0
"Argentina","2024-06-05",0,0,1,0,0,3,0,0
"Argentina","2024-06-06",0,0,1,0,0,3,0,0
"Argentina","2024-06-07",0,0,1,0,0,3,0,0
"Argentina","2024-06-08",0,0,1,0,0,3,0,0
"Argentina","2024-06-09",0,0,1,0,0,3,0,0
"Argentina","2024-06-10",0,0,1,0,0,3,0,0
"Argentina","2024-06-11",0,0,1,0,0,3,0,0
"Argentina","2024-06-12",0,0,1,0,0,3,0,0
"Argentina","2024-06-13",0,0,1,0,0,3,0,0
"Argentina","2024-06-14",0,0,1,0,0,3,0,0
"Argentina","2024-06-15",0,0,1,0,0,3,0,0
"Argentina","2024-06-16",0,0,1,0,0,3,0,0
"Argentina","2024-06-17",0,0,1,0,0,3,0,0
"Argentina","2024-06-18",0,0,1,0,0,3,0,0
"Argentina","2024-06-19",0,0,1,0,0,3,0,0
"Argentina","2024-06-20",0,0,1,0,0,3,0,0
"Argentina","2024-06-21",0,0,1,0,0,3,0,0
"Argentina","2024-06-22",0,0,1,0,0,3,0,0
"Argentina","2024-06-23",0,0,1,0,0,3,0,0
"Argentina","2024-06-24",0,0,1,0,0,3,0,0
"Argentina","2024-06-25",0,0,1,0,0,3,0,0
"Argentina","2024-06-26",0,0,1,0,0,3,0,0
"Argentina","2024-06-27",0,0,1,0,0,3,0,0
"Argentina","2024-06-28",0,0,1,0,0,3,0,0
"Argentina","2024-06-29",0,0,1,0,0,3,0,0
"Argentina","2024-06-30",0,0,1,0,0,3,0,0
"Argentina","2024-07-01",0,0,1,0,0,3,0,0
"Argentina","2024-07-02",0,2,3,0,0,3,0,0
"Argentina","2024-07-03",0,0,3,0,0,3,0,0
"Argentina","2024-07-04",0,0,3,0,0,3,0,0
"Argentina","2024-07-05",0,0,3,0,0,3,0,0
"Argentina","2024-07-06",0,0,3,0,0,3,0,0
"Argentina","2024-07-07",0,0,3,0,0,3,0,0
"Argentina","2024-07-08",0,0,3,0,0,3,0,0
"Argentina","2024-07-09",0,0,3,0,0,3,0,0
"Argentina","2024-07-10",0,0,3,0,0,3,0,0
"Argentina","2024-07-11",0,0,3,0,0,3,0,0
"Argentina","2024-07-12",0,0,3,0,0,3,0,0
"Argentina","2024-07-13",0,0,3,0,1,4,0,0
"Argentina","2024-07-14",0,0,3,0,0,4,0,0
"Argentina","2024-07-15",0,0,3,0,0,4,0,0
"Argentina","2024-07-16",0,0,3,0,0,4,0,0
"Argentina","2024-07-17",0,0,3,0,0,4,0,0
"Argentina","2024-07-18",0,0,3,0,0,4,0,0
"Argentina","2024-07-19",0,0,3,0,0,4,0,0
"Argentina","2024-07-20",0,0,3,0,0,4,0,0
"Argentina","2024-07-21",0,0,3,0,0,4,0,0
"Argentina","2024-07-22",0,0,3,0,0,4,0,0
"Argentina","2024-07-23",0,1,4,0,0,4,0,0
"Argentina","2024-07-24",0,0,4,0,0,4,0,0
"Argentina","2024-07-25",0,0,4,0,1,5,0,0
"Argentina","2024-07-26",0,0,4,0,0,5,0,0
"Argentina","2024-07-27",0,0,4,0,0,5,0,0
"Argentina","2024-07-28",0,0,4,0,0,5,0,0
"Argentina","2024-07-29",0,0,4,0,1,6,0,0
"Argentina","2024-07-30",0,2,6,0,0,6,0,0
"Argentina","2024-07-31",0,0,6,0,0,6,0,0
"Argentina","2024-08-01",0,0,6,0,1,7,0,0
"Argentina","2024-08-02",0,0,6,0,0,7,0,0
"Argentina","2024-08-03",0,0,6,0,1,8,0,0
"Argentina","2024-08-04",0,0,6,0,0,8,0,0
"Argentina","2024-08-05",0,0,6,0,1,9,0,0
"Argentina","2024-08-06",0,3,9,0,0,9,0,0
"Argentina","2024-08-07",0,0,9,0,1,10,0,0
"Argentina","2024-08-08",0,0,9,0,0,10,0,0
"Argentina","2024-08-09",0,0,9,0,1,11,0,0
"Argentina","2024-08-10",0,0,9,0,0,11,0,0
"Argentina","2024-08-11",0,0,9,0,1,12,0,0
"Argentina","2024-08-12",0,0,9,0,0,12,0,0
"Argentina","2024-08-13",0,4,13,0,1,13,0,0
"Argentina","2024-08-14",0,0,13,0,2,15,0,0
"Argentina","2024-08-15",0,0,13,0,1,16,0,0
"Argentina","2024-08-16",0,0,13,0,2,18,0,0
"Argentina","2024-08-17",0,0,13,0,2,20,0,0
"Argentina","2024-08-18",0,0,13,0,2,22,0,0
"Argentina","2024-08-19",0,0,13,0,1,23,0,0
"Argentina","2024-08-20",0,12,25,0,2,25,0,0
"Argentina","2024-08-21",0,0,25,0,1,26,0,0
"Argentina","2024-08-22",0,0,25,0,1,27,0,0
"Argentina","2024-08-23",0,0,25,0,1,28,0,0
"Argentina","2024-08-24",0,0,25,0,1,29,0,0
"Argentina","2024-08-25",0,0,25,0,1,30,0,0
"Argentina","2024-08-26",0,0,25,0,1,31,0,0
"Argentina","2024-08-27",0,7,32,0,1,32,0,0
"Argentina","2024-08-28",0,0,32,0,2,34,0,0
"Argentina","2024-08-29",0,0,32,0,2,36,0,0
"Argentina","2024-08-30",0,0,32,0,2,38,0,0
"Argentina","2024-08-31",0,0,32,0,1,39,0,0
"Argentina","2024-09-01",0,0,32,0,2,41,0,0
"Argentina","2024-09-02",0,0,32,0,2,43,0,0
"Argentina","2024-09-03",0,13,45,0,2,45,0,0
"Argentina","2024-09-04",0,0,45,0,1,46,0,0
"Argentina","2024-09-05",0,0,45,0,2,48,0,0
"Argentina","2024-09-06",0,0,45,0,1,49,0,0
"Argentina","2024-09-07",0,0,45,0,1,50,0,0
"Argentina","2024-09-08",0,0,45,0,1,51,0,0
"Argentina","2024-09-09",0,0,45,0,2,53,0,0
"Argentina","2024-09-10",0,9,54,0,1,54,0,0
"Argentina","2024-09-11",0,0,54,0,2,56,0,0
"Argentina","2024-09-12",0,0,54,0,2,58,0,0
"Argentina","2024-09-13",0,0,54,0,2,60,0,0
"Argentina","2024-09-14",0,0,54,0,1,61,0,0
"Argentina","2024-09-15",0,0,54,0,2,63,0,0
"Argentina","2024-09-16",0,0,54,0,2,65,0,0
"Argentina","2024-09-17",0,13,67,0,2,67,0,0
"Argentina","2024-09-18",0,0,67,0,1,68,0,0
"Argentina","2024-09-19",0,0,67,0,0,68,0,0
"Argentina","2024-09-20",0,0,67,0,1,69,0,0
"Argentina","2024-09-21",0,0,67,0,1,70,0,0
"Argentina","2024-09-22",0,0,67,0,1,71,0,0
"Argentina","2024-09-23",0,0,67,0,0,71,0,0
"Argentina","2024-09-24",0,5,72,0,1,72,0,0
"Argentina","2024-09-25",0,0,72,0,1,73,0,0
"Argentina","2024-09-26",0,0,72,0,1,74,0,0
"Argentina","2024-09-27",0,0,72,0,1,75,0,0
"Argentina","2024-09-28",0,0,72,0,1,76,0,0
"Argentina","2024-09-29",0,0,72,0,1,77,0,0
"Argentina","2024-09-30",0,0,72,0,1,78,0,0
"Argentina","2024-10-01",0,7,79,0,1,79,0,0
"Argentina","2024-10-02",0,0,79,0,0,79,0,0
"Argentina","2024-10-03",0,0,79,0,1,80,0,0
"Argentina","2024-10-04",0,0,79,0,0,80,0,0
"Argentina","2024-10-05",0,0,79,0,1,81,0,0
"Argentina","2024-10-06",0,0,79,0,0,81,0,0
"Argentina","2024-10-07",0,0,79,0,1,82,0,0
"Argentina","2024-10-08",0,3,82,0,0,82,0,0
"Argentina","2024-10-09",0,0,82,0,0,82,0,0
"Argentina","2024-10-10",0,0,82,0,1,83,0,0
"Argentina","2024-10-11",0,0,82,0,0,83,0,0
"Argentina","2024-10-12",0,0,82,0,0,83,0,0
"Argentina","2024-10-13",0,0,82,0,0,83,0,0
"Argentina","2024-10-14",0,0,82,0,1,84,0,0
"Argentina","2024-10-15",0,2,84,0,0,84,0,0
"Argentina","2024-10-16",0,0,84,0,0,84,0,0
"Argentina","2024-10-17",0,0,84,0,0,84,0,0
"Argentina","2024-10-18",0,0,84,0,0,84,0,0
"Argentina","2024-10-19",0,0,84,0,1,85,0,0
"Argentina","2024-10-20",0,0,84,0,0,85,0,0
"Argentina","2024-10-21",0,0,84,0,0,85,0,0
"Argentina","2024-10-22",0,1,85,0,0,85,0,0
"Argentina","2024-10-23",0,0,85,0,0,85,0,0
"Argentina","2024-10-24",0,0,85,0,1,86,0,0
"Argentina","2024-10-25",0,0,85,0,0,86,0,0
"Argentina","2024-10-26",0,0,85,0,0,86,0,0
"Argentina","2024-10-27",0,0,85,0,0,86,0,0
"Argentina","2024-10-28",0,0,85,0,1,87,0,0
"Argentina","2024-10-29",0,2,87,0,0,87,0,0
"Argentina","2024-10-30",0,0,87,0,0,87,0,0
"Argentina","2024-10-31",0,0,87,0,1,88,0,0
"Argentina","2024-11-01",0,0,87,0,0,88,0,0
"Argentina","2024-11-02",0,0,87,0,0,88,0,0
"Argentina","2024-11-03",0,0,87,0,0,88,0,0
"Argentina","2024-11-04",0,0,87,0,1,89,0,0
"Argentina","2024-11-05",0,2,89,0,0,89,0,0
"Argentina","2024-11-06",0,0,89,0,1,90,0,0
"Argentina","2024-11-07",0,0,89,0,1,91,0,0
"Argentina","2024-11-08",0,0,89,0,1,92,0,0
"Argentina","2024-11-09",0,0,89,0,2,94,0,0
"Argentina","2024-11-10",0,0,89,0,1,95,0,0
"Argentina","2024-11-11",0,0,89,0,1,96,0,0
"Argentina","2024-11-12",0,8,97,0,1,97,0,0
"Argentina","2024-11-13",0,0,97,0,0,97,0,0
"Argentina","2024-11-14",0,0,97,0,1,98,0,0
"Argentina","2024-11-15",0,0,97,0,0,98,0,0
"Argentina","2024-11-16",0,0,97,0,1,99,0,0
"Argentina","2024-11-17",0,0,97,0,0,99,0,0
"Argentina","2024-11-18",0,0,97,0,1,100,0,0
"Argentina","2024-11-19",0,3,100,0,0,100,0,0
"Argentina","2024-11-20",0,0,100,0,0,100,0,0
"Argentina","2024-11-21",0,0,100,0,1,101,0,0
"Argentina","2024-11-22",0,0,100,0,0,101,0,0
"Argentina","2024-11-23",0,0,100,0,0,101,0,0
"Argentina","2024-11-24",0,0,100,0,0,101,0,0
"Argentina","2024-11-25",0,0,100,0,1,102,0,0
"Argentina","2024-11-26",0,2,102,0,0,102,0,0
"Argentina","2024-11-27",0,0,102,0,0,102,0,0
"Argentina","2024-11-28",0,0,102,0,0,102,0,0
"Argentina","2024-11-29",0,0,102,0,0,102,0,0
"Argentina","2024-11-30",0,0,102,0,0,102,0,0
"Argentina","2024-12-01",0,0,102,0,0,102,0,0
"Argentina","2024-12-02",0,0,102,0,0,102,0,0
"Argentina","2024-12-03",0,0,102,0,0,102,0,0
"Argentina","2024-12-04",0,0,102,0,1,103,0,0
"Argentina","2024-12-05",0,0,102,0,0,103,0,0
"Argentina","2024-12-06",0,0,102,0,0,103,0,0
"Argentina","2024-12-07",0,0,102,0,0,103,0,0
"Argentina","2024-12-08",0,0,102,0,0,103,0,0
"Argentina","2024-12-09",0,0,102,0,0,103,0,0
"Argentina","2024-12-10",0,1,103,0,0,103,0,0
"Argentina","2024-12-11",0,0,103,0,0,103,0,0
"Argentina","2024-12-12",0,0,103,0,1,104,0,0
"Argentina","2024-12-13",0,0,103,0,0,104,0,0
"Argentina","2024-12-14",0,0,103,0,0,104,0,0
"Argentina","2024-12-15",0,0,103,0,0,104,0,0
"Argentina","2024-12-16",0,0,103,0,1,105,0,0
"Argentina","2024-12-17",0,2,105,0,0,105,0,0
"Argentina","2024-12-18",0,0,105,0,0,105,0,0
"Argentina","2024-12-19",0,0,105,0,1,106,0,0
"Argentina","2024-12-20",0,0,105,0,0,106,0,0
"Argentina","2024-12-21",0,0,105,0,0,106,0,0
"Argentina","2024-12-22",0,0,105,0,0,106,0,0
"Argentina","2024-12-23",0,0,105,0,1,107,0,0
"Argentina","2024-12-24",0,2,107,0,0,107,0,0
"Argentina","2024-12-25",0,0,107,0,0,107,0,0
"Argentina","2024-12-26",0,0,107,0,1,108,0,0
"Argentina","2024-12-27",0,0,107,0,0,108,0,0
"Argentina","2024-12-28",0,0,107,0,1,109,0,0
"Argentina","2024-12-29",0,0,107,0,0,109,0,0
"Argentina","2024-12-30",0,0,107,0,1,110,0,0
"Argentina","2024-12-31",0,3,110,0,0,110,0,0
"Argentina","2025-01-01",0,0,110,0,0,110,0,0
"Argentina","2025-01-02",0,0,110,0,0,110,0,0
"Argentina","2025-01-03",0,0,110,0,0,110,0,0
"Argentina","2025-01-04",0,0,110,0,0,110,0,0
"Argentina","2025-01-05",0,0,110,0,0,110,0,0
"Argentina","2025-01-06",0,0,110,0,0,110,0,0
"Argentina","2025-01-07",0,0,110,0,0,110,0,0
"Argentina","2025-01-08",0,0,110,0,0,110,0,0
"Argentina","2025-01-09",0,0,110,0,0,110,0,0
"Argentina","2025-01-10",0,0,110,0,0,110,0,0
"Argentina","2025-01-11",0,0,110,0,0,110,0,0
"Argentina","2025-01-12",0,0,110,0,0,110,0,0
"Argentina","2025-01-13",0,0,110,0,0,110,0,0
"Argentina","2025-01-14",0,0,110,0,0,110,0,0
"Argentina","2025-01-15",0,0,110,0,0,110,0,0
"Argentina","2025-01-16",0,0,110,0,0,110,0,0
"Argentina","2025-01-17",0,0,110,0,0,110,0,0
"Argentina","2025-01-18",0,0,110,0,0,110,0,0
"Argentina","2025-01-19",0,0,110,0,0,110,0,0
"Argentina","2025-01-20",0,0,110,0,0,110,0,0
"Argentina","2025-01-21",0,0,110,0,0,110,0,0
"Argentina","2025-01-22",0,0,110,0,0,110,0,0
"Argentina","2025-01-23",0,0,110,0,0,110,0,0
"Argentina","2025-01-24",0,0,110,0,0,110,0,0
"Argentina","2025-01-25",0,0,110,0,0,110,0,0
"Argentina","2025-01-26",0,0,110,0,0,110,0,0
"Argentina","2025-01-27",0,0,110,0,0,110,0,0
"Argentina","2025-01-28",0,0,110,0,0,110,0,0
"Argentina","2025-01-29",0,0,110,0,0,110,0,0
"Argentina","2025-01-30",0,0,110,0,0,110,0,0
"Argentina","2025-01-31",0,0,110,0,0,110,0,0
"Argentina","2025-02-01",0,0,110,0,0,110,0,0
"Argentina","2025-02-02",0,0,110,0,0,110,0,0
"Argentina","2025-02-03",0,0,110,0,0,110,0,0
"Argentina","2025-02-04",0,0,110,0,0,110,0,0
"Argentina","2025-02-05",0,0,110,0,0,110,0,0
"Argentina","2025-02-06",0,0,110,0,0,110,0,0
"Argentina","2025-02-07",0,0,110,0,0,110,0,0
"Argentina","2025-02-08",0,0,110,0,0,110,0,0
"Argentina","2025-02-09",0,0,110,0,0,110,0,0
"Argentina","2025-02-10",0,0,110,0,0,110,0,0
"Argentina","2025-02-11",0,0,110,0,0,110,0,0
"Argentina","2025-02-12",0,0,110,0,0,110,0,0
"Argentina","2025-02-13",0,0,110,0,0,110,0,0
"Argentina","2025-02-14",0,0,110,0,0,110,0,0
"Argentina","2025-02-15",0,0,110,0,0,110,0,0
"Argentina","2025-02-16",0,0,110,0,0,110,0,0
"Argentina","2025-02-17",0,0,110,0,0,110,0,0
"Argentina","2025-02-18",0,0,110,0,0,110,0,0
"Argentina","2025-02-19",0,0,110,0,0,110,0,0
"Argentina","2025-02-20",0,0,110,0,0,110,0,0
"Argentina","2025-02-21",0,0,110,0,0,110,0,0
"Argentina","2025-02-22",0,0,110,0,0,110,0,0
"Argentina","2025-02-23",0,0,110,0,0,110,0,0
"Argentina","2025-02-24",0,0,110,0,0,110,0,0
"Argentina","2025-02-25",0,0,110,0,0,110,0,0
"Argentina","2025-02-26",0,0,110,0,0,110,0,0
"Argentina","2025-02-27",0,0,110,0,0,110,0,0
"Argentina","2025-02-28",0,0,110,0,0,110,0,0
"Argentina","2025-03-01",0,0,110,0,0,110,0,0
"Argentina","2025-03-02",0,0,110,0,0,110,0,0
"Argentina","2025-03-03",0,0,110,0,0,110,0,0
"Aruba","2024-01-01",0,0,0,0,0,0,0,0
"Aruba","2024-01-02",0,0,0,0,0,0,0,0
"Aruba","2024-01-03",0,0,0,0,0,0,0,0
"Aruba","2024-01-04",0,0,0,0,0,0,0,0
"Aruba","2024-01-05",0,0,0,0,0,0,0,0
"Aruba","2024-01-06",0,0,0,0,0,0,0,0
"Aruba","2024-01-07",0,0,0,0,0,0,0,0
"Aruba","2024-01-08",0,0,0,0,0,0,0,0
"Aruba","2024-01-09",0,0,0,0,0,0,0,0
"Aruba","2024-01-10",0,0,0,0,0,0,0,0
"Aruba","2024-01-11",0,0,0,0,0,0,0,0
"Aruba","2024-01-12",0,0,0,0,0,0,0,0
"Aruba","2024-01-13",0,0,0,0,0,0,0,0
"Aruba","2024-01-14",0,0,0,0,0,0,0,0
"Aruba","2024-01-15",0,0,0,0,0,0,0,0
"Aruba","2024-01-16",0,0,0,0,0,0,0,0
"Aruba","2024-01-17",0,0,0,0,0,0,0,0
"Aruba","2024-01-18",0,0,0,0,0,0,0,0
"Aruba","2024-01-19",0,0,0,0,0,0,0,0
"Aruba","2024-01-20",0,0,0,0,0,0,0,0
"Aruba","2024-01-21",0,0,0,0,0,0,0,0
"Aruba","2024-01-22",0,0,0,0,0,0,0,0
"Aruba","2024-01-23",0,0,0,0,0,0,0,0
"Aruba","2024-01-24",0,0,0,0,0,0,0,0
"Aruba","2024-01-25",0,0,0,0,0,0,0,0
"Aruba","2024-01-26",0,0,0,0,0,0,0,0
"Aruba","2024-01-27",0,0,0,0,0,0,0,0
"Aruba","2024-01-28",0,0,0,0,0,0,0,0
"Aruba","2024-01-29",0,0,0,0,0,0,0,0
"Aruba","2024-01-30",0,0,0,0,0,0,0,0
"Aruba","2024-01-31",0,0,0,0,0,0,0,0
"Aruba","2024-02-01",0,0,0,0,0,0,0,0
"Aruba","2024-02-02",0,0,0,0,0,0,0,0
"Aruba","2024-02-03",0,0,0,0,0,0,0,0
"Aruba","2024-02-04",0,0,0,0,0,0,0,0
"Aruba","2024-02-05",0,0,0,0,0,0,0,0
"Aruba","2024-02-06",0,0,0,0,0,0,0,0
"Aruba","2024-02-07",0,0,0,0,0,0,0,0
"Aruba","2024-02-08",0,0,0,0,0,0,0,0
"Aruba","2024-02-09",0,0,0,0,0,0,0,0
"Aruba","2024-02-10",0,0,0,0,0,0,0,0
"Aruba","2024-02-11",0,0,0,0,0,0,0,0
"Aruba","2024-02-12",0,0,0,0,0,0,0,0
"Aruba","2024-02-13",0,0,0,0,0,0,0,0
"Aruba","2024-02-14",0,0,0,0,0,0,0,0
"Aruba","2024-02-15",0,0,0,0,0,0,0,0
"Aruba","2024-02-16",0,0,0,0,0,0,0,0
"Aruba","2024-02-17",0,0,0,0,0,0,0,0
"Aruba","2024-02-18",0,0,0,0,0,0,0,0
"Aruba","2024-02-19",0,0,0,0,0,0,0,0
"Aruba","2024-02-20",0,0,0,0,0,0,0,0
"Aruba","2024-02-21",0,0,0,0,0,0,0,0
"Aruba","2024-02-22",0,0,0,0,0,0,0,0
"Aruba","2024-02-23",0,0,0,0,0,0,0,0
"Aruba","2024-02-24",0,0,0,0,0,0,0,0
"Aruba","2024-02-25",0,0,0,0,0,0,0,0
"Aruba","2024-02-26",0,0,0,0,0,0,0,0
"Aruba","2024-02-27",0,0,0,0,0,0,0,0
"Aruba","2024-02-28",0,0,0,0,0,0,0,0
"Aruba","2024-02-29",0,0,0,0,0,0,0,0
"Aruba","2024-03-01",0,0,0,0,0,0,0,0
"Aruba","2024-03-02",0,0,0,0,0,0,0,0
"Aruba","2024-03-03",0,0,0,0,0,0,0,0
"Aruba","2024-03-04",0,0,0,0,0,0,0,0
"Aruba","2024-03-05",0,0,0,0,0,0,0,0
"Aruba","2024-03-06",0,0,0,0,0,0,0,0
"Aruba","2024-03-07",0,0,0,0,0,0,0,0
"Aruba","2024-03-08",0,0,0,0,0,0,0,0
"Aruba","2024-03-09",0,0,0,0,0,0,0,0
"Aruba","2024-03-10",0,0,0,0,0,0,0,0
"Aruba","2024-03-11",0,0,0,0,0,0,0,0
"Aruba","2024-03-12",0,0,0,0,0,0,0,0
"Aruba","2024-03-13",0,0,0,0,0,0,0,0
"Aruba","2024-03-14",0,0,0,0,0,0,0,0
"Aruba","2024-03-15",0,0,0,0,0,0,0,0
"Aruba","2024-03-16",0,0,0,0,0,0,0,0
"Aruba","2024-03-17",0,0,0,0,0,0,0,0
"Aruba","2024-03-18",0,0,0,0,0,0,0,0
"Aruba","2024-03-19",0,0,0,0,0,0,0,0
"Aruba","2024-03-20",0,0,0,0,0,0,0,0
"Aruba","2024-03-21",0,0,0,0,0,0,0,0
"Aruba","2024-03-22",0,0,0,0,0,0,0,0
"Aruba","2024-03-23",0,0,0,0,0,0,0,0
"Aruba","2024-03-24",0,0,0,0,0,0,0,0
"Aruba","2024-03-25",0,0,0,0,0,0,0,0
"Aruba","2024-03-26",0,0,0,0,0,0,0,0
"Aruba","2024-03-27",0,0,0,0,0,0,0,0
"Aruba","2024-03-28",0,0,0,0,0,0,0,0
"Aruba","2024-03-29",0,0,0,0,0,0,0,0
"Aruba","2024-03-30",0,0,0,0,0,0,0,0
"Aruba","2024-03-31",0,0,0,0,0,0,0,0
"Aruba","2024-04-01",0,0,0,0,0,0,0,0
"Aruba","2024-04-02",0,0,0,0,0,0,0,0
"Aruba","2024-04-03",0,0,0,0,0,0,0,0
"Aruba","2024-04-04",0,0,0,0,0,0,0,0
"Aruba","2024-04-05",0,0,0,0,0,0,0,0
"Aruba","2024-04-06",0,0,0,0,0,0,0,0
"Aruba","2024-04-07",0,0,0,0,0,0,0,0
"Aruba","2024-04-08",0,0,0,0,0,0,0,0
"Aruba","2024-04-09",0,0,0,0,0,0,0,0
"Aruba","2024-04-10",0,0,0,0,0,0,0,0
"Aruba","2024-04-11",0,0,0,0,0,0,0,0
"Aruba","2024-04-12",0,0,0,0,0,0,0,0
"Aruba","2024-04-13",0,0,0,0,0,0,0,0
"Aruba","2024-04-14",0,0,0,0,0,0,0,0
"Aruba","2024-04-15",0,0,0,0,0,0,0,0
"Aruba","2024-04-16",0,0,0,0,0,0,0,0
"Aruba","2024-04-17",0,0,0,0,0,0,0,0
"Aruba","2024-04-18",0,0,0,0,0,0,0,0
"Aruba","2024-04-19",0,0,0,0,0,0,0,0
"Aruba","2024-04-20",0,0,0,0,0,0,0,0
"Aruba","2024-04-21",0,0,0,0,0,0,0,0
"Aruba","2024-04-22",0,0,0,0,0,0,0,0
"Aruba","2024-04-23",0,0,0,0,0,0,0,0
"Aruba","2024-04-24",0,0,0,0,0,0,0,0
"Aruba","2024-04-25",0,0,0,0,0,0,0,0
"Aruba","2024-04-26",0,0,0,0,0,0,0,0
"Aruba","2024-04-27",0,0,0,0,0,0,0,0
"Aruba","2024-04-28",0,0,0,0,0,0,0,0
"Aruba","2024-04-29",0,0,0,0,0,0,0,0
"Aruba","2024-04-30",0,0,0,0,0,0,0,0
"Aruba","2024-05-01",0,0,0,0,0,0,0,0
"Aruba","2024-05-02",0,0,0,0,0,0,0,0
"Aruba","2024-05-03",0,0,0,0,0,0,0,0
"Aruba","2024-05-04",0,0,0,0,0,0,0,0
"Aruba","2024-05-05",0,0,0,0,0,0,0,0
"Aruba","2024-05-06",0,0,0,0,0,0,0,0
"Aruba","2024-05-07",0,0,0,0,0,0,0,0
"Aruba","2024-05-08",0,0,0,0,0,0,0,0
"Aruba","2024-05-09",0,0,0,0,0,0,0,0
"Aruba","2024-05-10",0,0,0,0,0,0,0,0
"Aruba","2024-05-11",0,0,0,0,0,0,0,0
"Aruba","2024-05-12",0,0,0,0,0,0,0,0
"Aruba","2024-05-13",0,0,0,0,0,0,0,0
"Aruba","2024-05-14",0,0,0,0,0,0,0,0
"Aruba","2024-05-15",0,0,0,0,0,0,0,0
"Aruba","2024-05-16",0,0,0,0,0,0,0,0
"Aruba","2024-05-17",0,0,0,0,0,0,0,0
"Aruba","2024-05-18",0,0,0,0,0,0,0,0
"Aruba","2024-05-19",0,0,0,0,0,0,0,0
"Aruba","2024-05-20",0,0,0,0,0,0,0,0
"Aruba","2024-05-21",0,0,0,0,0,0,0,0
"Aruba","2024-05-22",0,0,0,0,0,0,0,0
"Aruba","2024-05-23",0,0,0,0,0,0,0,0
"Aruba","2024-05-24",0,0,0,0,0,0,0,0
"Aruba","2024-05-25",0,0,0,0,0,0,0,0
"Aruba","2024-05-26",0,0,0,0,0,0,0,0
"Aruba","2024-05-27",0,0,0,0,0,0,0,0
"Aruba","2024-05-28",0,0,0,0,0,0,0,0
"Aruba","2024-05-29",0,0,0,0,0,0,0,0
"Aruba","2024-05-30",0,0,0,0,0,0,0,0
"Aruba","2024-05-31",0,0,0,0,0,0,0,0
"Aruba","2024-06-01",0,0,0,0,0,0,0,0
"Aruba","2024-06-02",0,0,0,0,0,0,0,0
"Aruba","2024-06-03",0,0,0,0,0,0,0,0
"Aruba","2024-06-04",0,0,0,0,0,0,0,0
"Aruba","2024-06-05",0,0,0,0,0,0,0,0
"Aruba","2024-06-06",0,0,0,0,0,0,0,0
"Aruba","2024-06-07",0,0,0,0,0,0,0,0
"Aruba","2024-06-08",0,0,0,0,0,0,0,0
"Aruba","2024-06-09",0,0,0,0,0,0,0,0
"Aruba","2024-06-10",0,0,0,0,0,0,0,0
"Aruba","2024-06-11",0,0,0,0,0,0,0,0
"Aruba","2024-06-12",0,0,0,0,0,0,0,0
"Aruba","2024-06-13",0,0,0,0,0,0,0,0
"Aruba","2024-06-14",0,0,0,0,0,0,0,0
"Aruba","2024-06-15",0,0,0,0,0,0,0,0
"Aruba","2024-06-16",0,0,0,0,0,0,0,0
"Aruba","2024-06-17",0,0,0,0,0,0,0,0
"Aruba","2024-06-18",0,0,0,0,0,0,0,0
"Aruba","2024-06-19",0,0,0,0,0,0,0,0
"Aruba","2024-06-20",0,0,0,0,0,0,0,0
"Aruba","2024-06-21",0,0,0,0,0,0,0,0
"Aruba","2024-06-22",0,0,0,0,0,0,0,0
"Aruba","2024-06-23",0,0,0,0,0,0,0,0
"Aruba","2024-06-24",0,0,0,0,0,0,0,0
"Aruba","2024-06-25",0,0,0,0,0,0,0,0
"Aruba","2024-06-26",0,0,0,0,0,0,0,0
"Aruba","2024-06-27",0,0,0,0,0,0,0,0
"Aruba","2024-06-28",0,0,0,0,0,0,0,0
"Aruba","2024-06-29",0,0,0,0,0,0,0,0
"Aruba","2024-06-30",0,0,0,0,0,0,0,0
"Aruba","2024-07-01",0,0,0,0,0,0,0,0
"Aruba","2024-07-02",0,0,0,0,0,0,0,0
"Aruba","2024-07-03",0,0,0,0,0,0,0,0
"Aruba","2024-07-04",0,0,0,0,0,0,0,0
"Aruba","2024-07-05",0,0,0,0,0,0,0,0
"Aruba","2024-07-06",0,0,0,0,0,0,0,0
"Aruba","2024-07-07",0,0,0,0,0,0,0,0
"Aruba","2024-07-08",0,0,0,0,0,0,0,0
"Aruba","2024-07-09",0,0,0,0,0,0,0,0
"Aruba","2024-07-10",0,0,0,0,0,0,0,0
"Aruba","2024-07-11",0,0,0,0,0,0,0,0
"Aruba","2024-07-12",0,0,0,0,0,0,0,0
"Aruba","2024-07-13",0,0,0,0,0,0,0,0
"Aruba","2024-07-14",0,0,0,0,0,0,0,0
"Aruba","2024-07-15",0,0,0,0,0,0,0,0
"Aruba","2024-07-16",0,0,0,0,0,0,0,0
"Aruba","2024-07-17",0,0,0,0,0,0,0,0
"Aruba","2024-07-18",0,0,0,0,0,0,0,0
"Aruba","2024-07-19",0,0,0,0,0,0,0,0
"Aruba","2024-07-20",0,0,0,0,0,0,0,0
"Aruba","2024-07-21",0,0,0,0,0,0,0,0
"Aruba","2024-07-22",0,0,0,0,0,0,0,0
"Aruba","2024-07-23",0,0,0,0,0,0,0,0
"Aruba","2024-07-24",0,0,0,0,0,0,0,0
"Aruba","2024-07-25",0,0,0,0,0,0,0,0
"Aruba","2024-07-26",0,0,0,0,0,0,0,0
"Aruba","2024-07-27",0,0,0,0,0,0,0,0
"Aruba","2024-07-28",0,0,0,0,0,0,0,0
"Aruba","2024-07-29",0,0,0,0,0,0,0,0
"Aruba","2024-07-30",0,0,0,0,0,0,0,0
"Aruba","2024-07-31",0,0,0,0,0,0,0,0
"Aruba","2024-08-01",0,0,0,0,0,0,0,0
"Aruba","2024-08-02",0,0,0,0,0,0,0,0
"Aruba","2024-08-03",0,0,0,0,0,0,0,0
"Aruba","2024-08-04",0,0,0,0,0,0,0,0
"Aruba","2024-08-05",0,0,0,0,0,0,0,0
"Aruba","2024-08-06",0,0,0,0,0,0,0,0
"Aruba","2024-08-07",0,0,0,0,0,0,0,0
"Aruba","2024-08-08",0,0,0,0,0,0,0,0
"Aruba","2024-08-09",0,0,0,0,0,0,0,0
"Aruba","2024-08-10",0,0,0,0,0,0,0,0
"Aruba","2024-08-11",0,0,0,0,0,0,0,0
"Aruba","2024-08-12",0,0,0,0,0,0,0,0
"Aruba","2024-08-13",0,0,0,0,0,0,0,0
"Aruba","2024-08-14",0,0,0,0,0,0,0,0
"Aruba","2024-08-15",0,0,0,0,0,0,0,0
"Aruba","2024-08-16",0,0,0,0,0,0,0,0
"Aruba","2024-08-17",0,0,0,0,0,0,0,0
"Aruba","2024-08-18",0,0,0,0,0,0,0,0
"Aruba","2024-08-19",0,0,0,0,0,0,0,0
"Aruba","2024-08-20",0,0,0,0,0,0,0,0
"Aruba","2024-08-21",0,0,0,0,0,0,0,0
"Aruba","2024-08-22",0,0,0,0,0,0,0,0
"Aruba","2024-08-23",0,0,0,0,0,0,0,0
"Aruba","2024-08-24",0,0,0,0,0,0,0,0
"Aruba","2024-08-25",0,0,0,0,0,0,0,0
"Aruba","2024-08-26",0,0,0,0,0,0,0,0
"Aruba","2024-08-27",0,0,0,0,0,0,0,0
"Aruba","2024-08-28",0,0,0,0,0,0,0,0
"Aruba","2024-08-29",0,0,0,0,0,0,0,0
"Aruba","2024-08-30",0,0,0,0,0,0,0,0
"Aruba","2024-08-31",0,0,0,0,0,0,0,0
"Aruba","2024-09-01",0,0,0,0,0,0,0,0
"Aruba","2024-09-02",0,0,0,0,0,0,0,0
"Aruba","2024-09-03",0,0,0,0,0,0,0,0
"Aruba","2024-09-04",0,0,0,0,0,0,0,0
"Aruba","2024-09-05",0,0,0,0,0,0,0,0
"Aruba","2024-09-06",0,0,0,0,0,0,0,0
"Aruba","2024-09-07",0,0,0,0,0,0,0,0
"Aruba","2024-09-08",0,0,0,0,0,0,0,0
"Aruba","2024-09-09",0,0,0,0,0,0,0,0
"Aruba","2024-09-10",0,0,0,0,0,0,0,0
"Aruba","2024-09-11",0,0,0,0,0,0,0,0
"Aruba","2024-09-12",0,0,0,0,0,0,0,0
"Aruba","2024-09-13",0,0,0,0,0,0,0,0
"Aruba","2024-09-14",0,0,0,0,0,0,0,0
"Aruba","2024-09-15",0,0,0,0,0,0,0,0
"Aruba","2024-09-16",0,0,0,0,0,0,0,0
"Aruba","2024-09-17",0,0,0,0,0,0,0,0
"Aruba","2024-09-18",0,0,0,0,0,0,0,0
"Aruba","2024-09-19",0,0,0,0,0,0,0,0
"Aruba","2024-09-20",0,0,0,0,0,0,0,0
"Aruba","2024-09-21",0,0,0,0,0,0,0,0
"Aruba","2024-09-22",0,0,0,0,0,0,0,0
"Aruba","2024-09-23",0,0,0,0,0,0,0,0
"Aruba","2024-09-24",0,0,0,0,0,0,0,0
"Aruba","2024-09-25",0,0,0,0,0,0,0,0
"Aruba","2024-09-26",0,0,0,0,0,0,0,0
"Aruba","2024-09-27",0,0,0,0,0,0,0,0
"Aruba","2024-09-28",0,0,0,0,0,0,0,0
"Aruba","2024-09-29",0,0,0,0,0,0,0,0
"Aruba","2024-09-30",0,0,0,0,0,0,0,0
"Aruba","2024-10-01",0,0,0,0,0,0,0,0
"Aruba","2024-10-02",0,0,0,0,0,0,0,0
"Aruba","2024-10-03",0,0,0,0,0,0,0,0
"Aruba","2024-10-04",0,0,0,0,0,0,0,0
"Aruba","2024-10-05",0,0,0,0,0,0,0,0
"Aruba","2024-10-06",0,0,0,0,0,0,0,0
"Aruba","2024-10-07",0,0,0,0,0,0,0,0
"Aruba","2024-10-08",0,0,0,0,0,0,0,0
"Aruba","2024-10-09",0,0,0,0,0,0,0,0
"Aruba","2024-10-10",0,0,0,0,0,0,0,0
"Aruba","2024-10-11",0,0,0,0,0,0,0,0
"Aruba","2024-10-12",0,0,0,0,0,0,0,0
"Aruba","2024-10-13",0,0,0,0,0,0,0,0
"Aruba","2024-10-14",0,0,0,0,0,0,0,0
"Aruba","2024-10-15",0,0,0,0,0,0,0,0
"Aruba","2024-10-16",0,0,0,0,0,0,0,0
"Aruba","2024-10-17",0,0,0,0,0,0,0,0
"Aruba","2024-10-18",0,0,0,0,0,0,0,0
"Aruba","2024-10-19",0,0,0,0,0,0,0,0
"Aruba","2024-10-20",0,0,0,0,0,0,0,0
"Aruba","2024-10-21",0,0,0,0,0,0,0,0
"Aruba","2024-10-22",0,0,0,0,0,0,0,0
"Aruba","2024-10-23",0,0,0,0,0,0,0,0
"Aruba","2024-10-24",0,0,0,0,0,0,0,0
"Aruba","2024-10-25",0,0,0,0,0,0,0,0
"Aruba","2024-10-26",0,0,0,0,0,0,0,0
"Aruba","2024-10-27",0,0,0,0,0,0,0,0
"Aruba","2024-10-28",0,0,0,0,0,0,0,0
"Aruba","2024-10-29",0,0,0,0,0,0,0,0
"Aruba","2024-10-30",0,0,0,0,0,0,0,0
"Aruba","2024-10-31",0,0,0,0,0,0,0,0
"Aruba","2024-11-01",0,0,0,0,0,0,0,0
"Aruba","2024-11-02",0,0,0,0,0,0,0,0
"Aruba","2024-11-03",0,0,0,0,0,0,0,0
"Aruba","2024-11-04",0,0,0,0,0,0,0,0
"Aruba","2024-11-05",0,0,0,0,0,0,0,0
"Aruba","2024-11-06",0,0,0,0,0,0,0,0
"Aruba","2024-11-07",0,0,0,0,0,0,0,0
"Aruba","2024-11-08",0,0,0,0,0,0,0,0
"Aruba","2024-11-09",0,0,0,0,0,0,0,0
"Aruba","2024-11-10",0,0,0,0,0,0,0,0
"Aruba","2024-11-11",0,0,0,0,0,0,0,0
"Aruba","2024-11-12",0,0,0,0,0,0,0,0
"Aruba","2024-11-13",0,0,0,0,0,0,0,0
"Aruba","2024-11-14",0,0,0,0,0,0,0,0
"Aruba","2024-11-15",0,0,0,0,0,0,0,0
"Aruba","2024-11-16",0,0,0,0,0,0,0,0
"Aruba","2024-11-17",0,0,0,0,0,0,0,0
"Aruba","2024-11-18",0,0,0,0,0,0,0,0
"Aruba","2024-11-19",0,0,0,0,0,0,0,0
"Aruba","2024-11-20",0,0,0,0,0,0,0,0
"Aruba","2024-11-21",0,0,0,0,0,0,0,0
"Aruba","2024-11-22",0,0,0,0,0,0,0,0
"Aruba","2024-11-23",0,0,0,0,0,0,0,0
"Aruba","2024-11-24",0,0,0,0,0,0,0,0
"Aruba","2024-11-25",0,0,0,0,0,0,0,0
"Aruba","2024-11-26",0,0,0,0,0,0,0,0
"Aruba","2024-11-27",0,0,0,0,0,0,0,0
"Aruba","2024-11-28",0,0,0,0,0,0,0,0
"Aruba","2024-11-29",0,0,0,0,0,0,0,0
"Aruba","2024-11-30",0,0,0,0,0,0,0,0
"Aruba","2024-12-01",0,0,0,0,0,0,0,0
"Aruba","2024-12-02",0,0,0,0,0,0,0,0
"Aruba","2024-12-03",0,0,0,0,0,0,0,0
"Aruba","2024-12-04",0,0,0,0,0,0,0,0
"Aruba","2024-12-05",0,0,0,0,0,0,0,0
"Aruba","2024-12-06",0,0,0,0,0,0,0,0
"Aruba","2024-12-07",0,0,0,0,0,0,0,0
"Aruba","2024-12-08",0,0,0,0,0,0,0,0
"Aruba","2024-12-09",0,0,0,0,0,0,0,0
"Aruba","2024-12-10",0,0,0,0,0,0,0,0
"Aruba","2024-12-11",0,0,0,0,0,0,0,0
"Aruba","2024-12-12",0,0,0,0,0,0,0,0
"Aruba","2024-12-13",0,0,0,0,0,0,0,0
"Aruba","2024-12-14",0,0,0,0,0,0,0,0
"Aruba","2024-12-15",0,0,0,0,0,0,0,0
"Aruba","2024-12-16",0,0,0,0,0,0,0,0
"Aruba","2024-12-17",0,0,0,0,0,0,0,0
"Aruba","2024-12-18",0,0,0,0,0,0,0,0
"Aruba","2024-12-19",0,0,0,0,0,0,0,0
"Aruba","2024-12-20",0,0,0,0,0,0,0,0
"Aruba","2024-12-21",0,0,0,0,0,0,0,0
"Aruba","2024-12-22",0,0,0,0,0,0,0,0
"Aruba","2024-12-23",0,0,0,0,0,0,0,0
"Aruba","2024-12-24",0,0,0,0,0,0,0,0
"Aruba","2024-12-25",0,0,0,0,0,0,0,0
"Aruba","2024-12-26",0,0,0,0,0,0,0,0
"Aruba","2024-12-27",0,0,0,0,0,0,0,0
"Aruba","2024-12-28",0,0,0,0,0,0,0,0
"Aruba","2024-12-29",0,0,0,0,0,0,0,0
"Aruba","2024-12-30",0,0,0,0,0,0,0,0
"Aruba","2024-12-31",0,0,0,0,0,0,0,0
"Aruba","2025-01-01",0,0,0,0,0,0,0,0
"Aruba","2025-01-02",0,0,0,0,0,0,0,0
"Aruba","2025-01-03",0,0,0,0,0,0,0,0
"Aruba","2025-01-04",0,0,0,0,0,0,0,0
"Aruba","2025-01-05",0,0,0,0,0,0,0,0
"Aruba","2025-01-06",0,0,0,0,0,0,0,0
"Aruba","2025-01-07",0,0,0,0,0,0,0,0
"Aruba","2025-01-08",0,0,0,0,0,0,0,0
"Aruba","2025-01-09",0,0,0,0,0,0,0,0
"Aruba","2025-01-10",0,0,0,0,0,0,0,0
"Aruba","2025-01-11",0,0,0,0,0,0,0,0
"Aruba","2025-01-12",0,0,0,0,0,0,0,0
"Aruba","2025-01-13",0,0,0,0,0,0,0,0
"Aruba","2025-01-14",0,0,0,0,0,0,0,0
"Aruba","2025-01-15",0,0,0,0,0,0,0,0
"Aruba","2025-01-16",0,0,0,0,0,0,0,0
"Aruba","2025-01-17",0,0,0,0,0,0,0,0
"Aruba","2025-01-18",0,0,0,0,0,0,0,0
"Aruba","2025-01-19",0,0,0,0,0,0,0,0
"Aruba","2025-01-20",0,0,0,0,0,0,0,0
"Aruba","2025-01-21",0,0,0,0,0,0,0,0
"Aruba","2025-01-22",0,0,0,0,0,0,0,0
"Aruba","2025-01-23",0,0,0,0,0,0,0,0
"Aruba","2025-01-24",0,0,0,0,0,0,0,0
"Aruba","2025-01-25",0,0,0,0,0,0,0,0
"Aruba","2025-01-26",0,0,0,0,0,0,0,0
"Aruba","2025-01-27",0,0,0,0,0,0,0,0
"Aruba","2025-01-28",0,0,0,0,0,0,0,0
"Aruba","2025-01-29",0,0,0,0,0,0,0,0
"Aruba","2025-01-30",0,0,0,0,0,0,0,0
"Aruba","2025-01-31",0,0,0,0,0,0,0,0
"Aruba","2025-02-01",0,0,0,0,0,0,0,0
"Aruba","2025-02-02",0,0,0,0,0,0,0,0
"Aruba","2025-02-03",0,0,0,0,0,0,0,0
"Aruba","2025-02-04",0,0,0,0,0,0,0,0
"Aruba","2025-02-05",0,0,0,0,0,0,0,0
"Aruba","2025-02-06",0,0,0,0,0,0,0,0
"Aruba","2025-02-07",0,0,0,0,0,0,0,0
"Aruba","2025-02-08",0,0,0,0,0,0,0,0
"Aruba","2025-02-09",0,0,0,0,0,0,0,0
"Aruba","2025-02-10",0,0,0,0,0,0,0,0
"Aruba","2025-02-11",0,0,0,0,0,0,0,0
"Aruba","2025-02-12",0,0,0,0,0,0,0,0
"Aruba","2025-02-13",0,0,0,0,0,0,0,0
"Aruba","2025-02-14",0,0,0,0,0,0,0,0
"Aruba","2025-02-15",0,0,0,0,0,0,0,0
"Aruba","2025-02-16",0,0,0,0,0,0,0,0
"Aruba","2025-02-17",0,0,0,0,0,0,0,0
"Aruba","2025-02-18",0,0,0,0,0,0,0,0
"Aruba","2025-02-19",0,0,0,0,0,0,0,0
"Aruba","2025-02-20",0,0,0,0,0,0,0,0
"Aruba","2025-02-21",0,0,0,0,0,0,0,0
"Aruba","2025-02-22",0,0,0,0,0,0,0,0
"Aruba","2025-02-23",0,0,0,0,0,0,0,0
"Aruba","2025-02-24",0,0,0,0,0,0,0,0
"Aruba","2025-02-25",0,0,0,0,0,0,0,0
"Aruba","2025-02-26",0,0,0,0,0,0,0,0
"Aruba","2025-02-27",0,0,0,0,0,0,0,0
"Aruba","2025-02-28",0,0,0,0,0,0,0,0
"Aruba","2025-03-01",0,0,0,0,0,0,0,0
"Aruba","2025-03-02",0,0,0,0,0,0,0,0
"Aruba","2025-03-03",0,0,0,0,0,0,0,0
"Asia","2024-01-01",0,0,0,0,0,0,0,0
"Asia","2024-01-02",0,0,0,0,0,0,0,0
"Asia","2024-01-03",0,0,0,0,0,0,0,0
"Asia","2024-01-04",0,2,2,0,2,2,0,0
"Asia","2024-01-05",0,1,3,0,1,3,0,0
"Asia","2024-01-06",0,0,3,0,0,3,0,0
"Asia","2024-01-07",0,0,3,0,0,3,0,0
"Asia","2024-01-08",0,0,3,0,1,4,0,0
"Asia","2024-01-09",0,1,4,0,0,4,0,0
"Asia","2024-01-10",0,14,18,0,14,18,0,0
"Asia","2024-01-11",0,1,19,0,1,19,0,0
"Asia","2024-01-12",0,1,20,0,1,20,0,0
"Asia","2024-01-13",0,0,20,0,0,20,0,0
"Asia","2024-01-14",0,0,20,0,0,20,0,0
"Asia","2024-01-15",0,0,20,0,1,21,0,0
"Asia","2024-01-16",0,0,20,0,0,21,0,0
"Asia","2024-01-17",0,1,21,0,0,21,0,0
"Asia","2024-01-18",0,0,21,0,1,22,0,0
"Asia","2024-01-19",0,2,23,0,1,23,0,0
"Asia","2024-01-20",0,2,25,0,2,25,0,0
"Asia","2024-01-21",0,0,25,0,2,27,0,0
"Asia","2024-01-22",0,0,25,0,1,28,0,0
"Asia","2024-01-23",0,0,25,0,1,29,0,0
"Asia","2024-01-24",0,6,31,0,2,31,0,0
"Asia","2024-01-25",0,0,31,0,22,53,0,0
"Asia","2024-01-26",0,0,31,0,23,76,0,0
"Asia","2024-01-27",0,0,31,0,22,98,0,0
"Asia","2024-01-28",0,0,31,0,22,120,0,0
"Asia","2024-01-29",0,0,31,0,22,142,0,0
"Asia","2024-01-30",0,0,31,0,23,165,0,0
"Asia","2024-01-31",0,156,187,0,22,187,0,0
"Asia","2024-02-01",0,0,187,0,2,189,0,0
"Asia","2024-02-02",0,5,192,0,3,192,0,0
"Asia","2024-02-03",0,0,192,0,1,193,0,0
"Asia","2024-02-04",0,0,192,0,1,194,0,0
"Asia","2024-02-05",0,3,195,0,1,195,0,0
"Asia","2024-02-06",0,0,195,0,1,196,0,0
"Asia","2024-02-07",0,0,195,0,1,197,0,0
"Asia","2024-02-08",0,0,195,0,2,199,0,0
"Asia","2024-02-09",0,5,200,0,1,200,0,0
"Asia","2024-02-10",0,0,200,0,0,200,0,0
"Asia","2024-02-11",0,0,200,0,0,200,0,0
"Asia","2024-02-12",0,0,200,0,0,200,0,0
"Asia","2024-02-13",0,0,200,0,1,201,0,0
"Asia","2024-02-14",0,0,200,0,0,201,0,0
"Asia","2024-02-15",0,1,201,0,0,201,0,0
"Asia","2024-02-16",0,1,202,0,1,202,0,0
"Asia","2024-02-17",0,0,202,0,1,203,0,0
"Asia","2024-02-18",0,0,202,0,2,205,0,0
"Asia","2024-02-19",0,0,202,0,1,206,0,0
"Asia","2024-02-20",0,0,202,0,2,208,0,0
"Asia","2024-02-21",0,0,202,0,1,209,0,0
"Asia","2024-02-22",0,0,202,0,2,211,0,0
"Asia","2024-02-23",0,10,212,0,1,212,0,0
"Asia","2024-02-24",0,0,212,0,3,215,0,0
"Asia","2024-02-25",0,0,212,0,3,218,0,0
"Asia","2024-02-26",0,0,212,0,3,221,0,0
"Asia","2024-02-27",0,0,212,0,3,224,0,0
"Asia","2024-02-28",0,15,227,0,3,227,0,0
"Asia","2024-02-29",0,114,341,0,114,341,0,0
"Asia","2024-03-01",0,4,345,0,4,345,0,0
"Asia","2024-03-02",0,1,346,0,1,346,0,0
"Asia","2024-03-03",0,0,346,0,2,348,0,0
"Asia","2024-03-04",0,0,346,0,3,351,0,0
"Asia","2024-03-05",0,0,346,0,3,354,0,0
"Asia","2024-03-06",0,10,356,0,2,356,0,0
"Asia","2024-03-07",0,0,356,0,2,358,0,0
"Asia","2024-03-08",0,3,359,0,1,359,0,0
"Asia","2024-03-09",0,0,359,0,0,359,0,0
"Asia","2024-03-10",0,0,359,0,0,359,0,0
"Asia","2024-03-11",0,0,359,0,0,359,0,0
"Asia","2024-03-12",0,0,359,0,1,360,0,0
"Asia","2024-03-13",0,0,359,0,0,360,0,0
"Asia","2024-03-14",0,1,360,0,0,360,0,0
"Asia","2024-03-15",0,2,362,0,2,362,0,0
"Asia","2024-03-16",0,0,362,0,0,362,0,0
"Asia","2024-03-17",0,0,362,0,0,362,0,0
"Asia","2024-03-18",0,0,362,0,0,362,0,0
"Asia","2024-03-19",0,0,362,0,1,363,0,0
"Asia","2024-03-20",0,0,362,0,0,363,0,0
"Asia","2024-03-21",0,0,362,0,0,363,0,0
"Asia","2024-03-22",0,1,363,0,0,363,0,0
"Asia","2024-03-23",0,0,363,0,3,366,0,0
"Asia","2024-03-24",0,0,363,0,3,369,0,0
"Asia","2024-03-25",0,0,363,0,3,372,0,0
"Asia","2024-03-26",0,12,375,0,3,375,0,0
"Asia","2024-03-27",0,0,375,0,17,392,0,0
"Asia","2024-03-28",0,0,375,0,16,408,0,0
"Asia","2024-03-29",0,0,375,0,17,425,0,0
"Asia","2024-03-30",0,0,375,0,16,441,0,0
"Asia","2024-03-31",0,83,458,0,17,458,0,0
"Asia","2024-04-01",0,6,464,0,6,464,0,0
"Asia","2024-04-02",0,1,465,0,1,465,0,0
"Asia","2024-04-03",0,0,465,0,1,466,0,0
"Asia","2024-04-04",0,0,465,0,1,467,0,0
"Asia","2024-04-05",0,3,468,0,1,468,0,0
"Asia","2024-04-06",0,0,468,0,0,468,0,0
"Asia","2024-04-07",0,0,468,0,0,468,0,0
"Asia","2024-04-08",0,0,468,0,1,469,0,0
"Asia","2024-04-09",0,1,469,0,0,469,0,0
"Asia","2024-04-10",0,0,469,0,1,470,0,0
"Asia","2024-04-11",0,0,469,0,0,470,0,0
"Asia","2024-04-12",0,2,471,0,1,471,0,0
"Asia","2024-04-13",0,0,471,0,0,471,0,0
"Asia","2024-04-14",0,0,471,0,0,471,0,0
"Asia","2024-04-15",0,0,471,0,0,471,0,0
"Asia","2024-04-16",0,0,471,0,1,472,0,0
"Asia","2024-04-17",0,0,471,0,0,472,0,0
"Asia","2024-04-18",0,0,471,0,0,472,0,0
"Asia","2024-04-19",0,1,472,0,0,472,0,0
"Asia","2024-04-20",0,1,473,0,1,473,0,0
"Asia","2024-04-21",0,0,473,0,0,473,0,0
"Asia","2024-04-22",0,0,473,0,1,474,0,0
"Asia","2024-04-23",0,0,473,0,0,474,0,0
"Asia","2024-04-24",0,0,473,0,0,474,0,0
"Asia","2024-04-25",0,0,473,0,1,475,0,0
"Asia","2024-04-26",0,2,475,0,0,475,0,0
"Asia","2024-04-27",0,1,476,0,1,476,0,0
"Asia","2024-04-28",0,0,476,0,22,498,0,0
"Asia","2024-04-29",0,0,476,0,22,520,0,0
"Asia","2024-04-30",0,66,542,0,22,542,0,0
"Asia","2024-05-01",0,0,542,0,0,542,0,0
"Asia","2024-05-02",0,0,542,0,0,542,0,0
"Asia","2024-05-03",0,0,542,0,0,542,0,0
"Asia","2024-05-04",0,0,542,0,1,543,0,0
"Asia","2024-05-05",0,0,542,0,0,543,0,0
"Asia","2024-05-06",0,0,542,0,0,543,0,0
"Asia","2024-05-07",0,1,543,0,0,543,0,0
"Asia","2024-05-08",0,0,543,0,8,551,0,0
"Asia","2024-05-09",0,0,543,0,9,560,0,0
"Asia","2024-05-10",0,25,568,0,8,568,0,0
"Asia","2024-05-11",0,0,568,0,0,568,0,0
"Asia","2024-05-12",0,0,568,0,0,568,0,0
"Asia","2024-05-13",0,0,568,0,1,569,0,0
"Asia","2024-05-14",0,1,569,0,0,569,0,0
"Asia","2024-05-15",0,0,569,0,0,569,0,0
"Asia","2024-05-16",0,0,569,0,0,569,0,0
"Asia","2024-05-17",0,0,569,0,0,569,0,0
"Asia","2024-05-18",0,0,569,0,0,569,0,0
"Asia","2024-05-19",0,0,569,0,1,570,0,0
"Asia","2024-05-20",0,0,569,0,0,570,0,0
"Asia","2024-05-21",0,0,569,0,0,570,0,0
"Asia","2024-05-22",0,1,570,0,0,570,0,0
"Asia","2024-05-23",0,0,570,0,2,572,0,0
"Asia","2024-05-24",0,4,574,0,2,574,0,0
"Asia","2024-05-25",0,0,574,0,0,574,0,0
"Asia","2024-05-26",0,0,574,0,1,575,0,0
"Asia","2024-05-27",0,1,575,0,0,575,0,0
"Asia","2024-05-28",0,0,575,0,16,591,0,0
"Asia","2024-05-29",0,0,575,0,17,608,0,0
"Asia","2024-05-30",0,49,624,0,16,624,0,0
"Asia","2024-05-31",0,59,683,0,59,683,0,0
"Asia","2024-06-01",0,0,683,0,0,683,0,0
"Asia","2024-06-02",0,0,683,0,0,683,0,0
"Asia","2024-06-03",0,0,683,0,0,683,0,0
"Asia","2024-06-04",0,0,683,0,1,684,0,0
"Asia","2024-06-05",0,0,683,0,0,684,0,0
"Asia","2024-06-06",0,0,683,0,0,684,0,0
"Asia","2024-06-07",0,0,683,0,0,684,0,0
"Asia","2024-06-08",0,0,683,0,0,684,0,0
"Asia","2024-06-09",0,0,683,0,1,685,0,0
"Asia","2024-06-10",0,0,683,0,0,685,0,0
"Asia","2024-06-11",0,0,683,0,0,685,0,0
"Asia","2024-06-12",0,0,683,0,0,685,0,0
"Asia","2024-06-13",0,0,683,0,0,685,0,0
"Asia","2024-06-14",0,0,683,0,0,685,0,0
"Asia","2024-06-15",0,0,683,0,0,685,0,0
"Asia","2024-06-16",0,0,683,0,1,686,0,0
"Asia","2024-06-17",0,0,683,0,0,686,0,0
"Asia","2024-06-18",0,0,683,0,0,686,0,0
"Asia","2024-06-19",0,0,683,0,0,686,0,0
"Asia","2024-06-20",0,0,683,0,0,686,0,0
"Asia","2024-06-21",0,0,683,0,1,687,0,0
"Asia","2024-06-22",0,0,683,0,0,687,0,0
"Asia","2024-06-23",0,0,683,0,0,687,0,0
"Asia","2024-06-24",0,4,687,0,0,687,0,0
"Asia","2024-06-25",0,6,693,0,6,693,0,0
"Asia","2024-06-26",0,0,693,0,2,695,0,0
"Asia","2024-06-27",0,0,693,0,3,698,0,0
"Asia","2024-06-28",0,7,700,0,2,700,0,0
"Asia","2024-06-29",0,0,700,0,35,735,0,0
"Asia","2024-06-30",0,70,770,0,35,770,0,0
"Asia","2024-07-01",0,0,770,0,0,770,0,0
"Asia","2024-07-02",0,0,770,0,0,770,0,0
"Asia","2024-07-03",0,0,770,0,1,771,0,0
"Asia","2024-07-04",0,0,770,0,0,771,0,0
"Asia","2024-07-05",0,0,770,0,0,771,0,0
"Asia","2024-07-06",0,0,770,0,1,772,0,0
"Asia","2024-07-07",0,0,770,0,0,772,0,0
"Asia","2024-07-08",0,2,772,0,0,772,0,0
"Asia","2024-07-09",0,0,772,0,0,772,0,0
"Asia","2024-07-10",0,0,772,0,1,773,0,0
"Asia","2024-07-11",0,0,772,0,1,774,0,0
"Asia","2024-07-12",0,2,774,0,0,774,0,0
"Asia","2024-07-13",0,1,775,0,1,775,0,0
"Asia","2024-07-14",0,0,775,0,2,777,0,0
"Asia","2024-07-15",0,0,775,0,3,780,0,0
"Asia","2024-07-16",0,7,782,0,2,782,0,0
"Asia","2024-07-17",0,0,782,0,1,783,0,0
"Asia","2024-07-18",0,0,782,0,1,784,0,0
"Asia","2024-07-19",0,0,782,0,0,784,0,0
"Asia","2024-07-20",0,0,782,0,1,785,0,0
"Asia","2024-07-21",0,0,782,0,1,786,0,0
"Asia","2024-07-22",0,0,782,0,0,786,0,0
"Asia","2024-07-23",0,0,782,0,1,787,0,0
"Asia","2024-07-24",0,0,782,0,1,788,0,0
"Asia","2024-07-25",0,0,782,0,1,789,0,0
"Asia","2024-07-26",0,0,782,0,1,790,0,0
"Asia","2024-07-27",0,0,782,0,0,790,0,0
"Asia","2024-07-28",0,9,791,0,1,791,0,0
"Asia","2024-07-29",0,0,791,0,20,811,0,0
"Asia","2024-07-30",0,39,830,0,19,830,0,0
"Asia","2024-07-31",0,27,857,0,27,857,0,0
"Asia","2024-08-01",0,0,857,0,3,860,0,0
"Asia","2024-08-02",0,6,863,0,3,863,0,0
"Asia","2024-08-03",0,0,863,0,0,863,0,0
"Asia","2024-08-04",0,0,863,0,1,864,0,0
"Asia","2024-08-05",0,1,864,0,0,864,0,0
"Asia","2024-08-06",0,2,866,0,2,866,0,0
"Asia","2024-08-07",0,0,866,0,1,867,0,0
"Asia","2024-08-08",0,0,866,0,0,867,0,0
"Asia","2024-08-09",0,0,866,0,1,868,0,0
"Asia","2024-08-10",0,0,866,0,1,869,0,0
"Asia","2024-08-11",0,0,866,0,1,870,0,0
"Asia","2024-08-12",0,0,866,0,0,870,0,0
"Asia","2024-08-13",0,5,871,0,1,871,0,0
"Asia","2024-08-14",0,1,872,0,1,872,0,0
"Asia","2024-08-15",0,2,874,0,2,874,0,0
"Asia","2024-08-16",0,0,874,0,0,874,0,0
"Asia","2024-08-17",0,0,874,0,0,874,0,0
"Asia","2024-08-18",0,0,874,0,1,875,0,0
"Asia","2024-08-19",0,1,875,0,0,875,0,0
"Asia","2024-08-20",0,4,879,0,4,879,0,0
"Asia","2024-08-21",0,1,880,0,1,880,0,0
"Asia","2024-08-22",0,2,882,0,2,882,0,0
"Asia","2024-08-23",0,1,883,0,1,883,0,0
"Asia","2024-08-24",0,0,883,0,0,883,0,0
"Asia","2024-08-25",0,0,883,0,0,883,0,0
"Asia","2024-08-26",0,0,883,0,1,884,0,0
"Asia","2024-08-27",0,1,884,0,0,884,0,0
"Asia","2024-08-28",0,4,888,0,4,888,0,0
"Asia","2024-08-29",0,0,888,0,0,888,0,0
"Asia","2024-08-30",0,1,889,0,1,889,0,0
"Asia","2024-08-31",0,69,958,0,69,958,0,0
"Asia","2024-09-01",0,4,962,0,4,962,0,0
"Asia","2024-09-02",0,1,963,0,1,963,0,0
"Asia","2024-09-03",0,0,963,0,0,963,0,0
"Asia","2024-09-04",0,0,963,0,0,963,0,0
"Asia","2024-09-05",0,0,963,0,0,963,0,0
"Asia","2024-09-06",0,0,963,0,1,964,0,0
"Asia","2024-09-07",0,0,963,0,0,964,0,0
"Asia","2024-09-08",0,1,964,0,0,964,0,0
"Asia","2024-09-09",0,0,964,0,0,964,0,0
"Asia","2024-09-10",0,1,965,0,1,965,0,0
"Asia","2024-09-11",0,0,965,0,3,968,0,0
"Asia","2024-09-12",0,0,965,0,2,970,0,0
"Asia","2024-09-13",0,0,965,0,3,973,0,0
"Asia","2024-09-14",0,0,965,0,2,975,0,0
"Asia","2024-09-15",0,13,978,0,3,978,0,0
"Asia","2024-09-16",0,0,978,0,0,978,0,0
"Asia","2024-09-17",0,0,978,0,1,979,0,0
"Asia","2024-09-18",0,1,979,0,0,979,0,0
"Asia","2024-09-19",0,0,979,0,1,980,0,0
"Asia","2024-09-20",0,0,979,0,0,980,0,0
"Asia","2024-09-21",0,0,979,0,1,981,0,0
"Asia","2024-09-22",0,0,979,0,0,981,0,0
"Asia","2024-09-23",0,3,982,0,1,982,0,0
"Asia","2024-09-24",0,0,982,0,5,987,0,0
"Asia","2024-09-25",0,0,982,0,5,992,0,0
"Asia","2024-09-26",0,15,997,0,5,997,0,0
"Asia","2024-09-27",0,0,997,0,2,999,0,0
"Asia","2024-09-28",0,0,997,0,2,1001,0,0
"Asia","2024-09-29",0,6,1003,0,2,1003,0,0
"Asia","2024-09-30",0,66,1069,0,66,1069,0,0
"Asia","2024-10-01",0,6,1075,0,6,1075,0,0
"Asia","2024-10-02",0,1,1076,0,1,1076,0,0
"Asia","2024-10-03",0,1,1077,0,1,1077,0,0
"Asia","2024-10-04",0,1,1078,0,1,1078,0,0
"Asia","2024-10-05",0,0,1078,0,0,1078,0,0
"Asia","2024-10-06",0,0,1078,0,1,1079,0,0
"Asia","2024-10-07",0,0,1078,0,0,1079,0,0
"Asia","2024-10-08",0,0,1078,0,0,1079,0,0
"Asia","2024-10-09",0,0,1078,0,1,1080,0,0
"Asia","2024-10-10",0,2,1080,0,0,1080,0,0
"Asia","2024-10-11",0,2,1082,0,2,1082,0,0
"Asia","2024-10-12",0,0,1082,0,0,1082,0,0
"Asia","2024-10-13",0,0,1082,0,1,1083,0,0
"Asia","2024-10-14",0,0,1082,0,0,1083,0,0
"Asia","2024-10-15",0,0,1082,0,0,1083,0,0
"Asia","2024-10-16",0,0,1082,0,0,1083,0,0
"Asia","2024-10-17",0,0,1082,0,1,1084,0,0
"Asia","2024-10-18",0,2,1084,0,0,1084,0,0
"Asia","2024-10-19",0,0,1084,0,0,1084,0,0
"Asia","2024-10-20",0,0,1084,0,1,1085,0,0
"Asia","2024-10-21",0,0,1084,0,0,1085,0,0
"Asia","2024-10-22",0,0,1084,0,1,1086,0,0
"Asia","2024-10-23",0,2,1086,0,0,1086,0,0
"Asia","2024-10-24",0,0,1086,0,1,1087,0,0
"Asia","2024-10-25",0,0,1086,0,0,1087,0,0
"Asia","2024-10-26",0,0,1086,0,1,1088,0,0
"Asia","2024-10-27",0,0,1086,0,1,1089,0,0
"Asia","2024-10-28",0,0,1086,0,0,1089,0,0
"Asia","2024-10-29",0,4,1090,0,1,1090,0,0
"Asia","2024-10-30",0,1,1091,0,1,1091,0,0
"Asia","2024-10-31",0,52,1143,0,52,1143,0,0
"Asia","2024-11-01",0,2,1145,0,2,1145,0,0
"Asia","2024-11-02",0,0,1145,0,1,1146,0,0
"Asia","2024-11-03",0,0,1145,0,0,1146,0,0
"Asia","2024-11-04",0,0,1145,0,1,1147,0,0
"Asia","2024-11-05",0,0,1145,0,0,1147,0,0
"Asia","2024-11-06",0,3,1148,0,1,1148,0,0
"Asia","2024-11-07",0,0,1148,0,1,1149,0,0
"Asia","2024-11-08",0,0,1148,0,1,1150,0,0
"Asia","2024-11-09",0,0,1148,0,0,1150,0,0
"Asia","2024-11-10",0,0,1148,0,1,1151,0,0
"Asia","2024-11-11",0,0,1148,0,1,1152,0,0
"Asia","2024-11-12",0,0,1148,0,1,1153,0,0
"Asia","2024-11-13",0,0,1148,0,0,1153,0,0
"Asia","2024-11-14",0,0,1148,0,1,1154,0,0
"Asia","2024-11-15",0,7,1155,0,1,1155,0,0
"Asia","2024-11-16",0,0,1155,0,0,1155,0,0
"Asia","2024-11-17",0,0,1155,0,0,1155,0,0
"Asia","2024-11-18",0,0,1155,0,1,1156,0,0
"Asia","2024-11-19",0,1,1156,0,0,1156,0,0
"Asia","2024-11-20",0,0,1156,0,1,1157,0,0
"Asia","2024-11-21",0,0,1156,0,0,1157,0,0
"Asia","2024-11-22",0,0,1156,0,1,1158,0,0
"Asia","2024-11-23",0,0,1156,0,0,1158,0,0
"Asia","2024-11-24",0,0,1156,0,1,1159,0,0
"Asia","2024-11-25",0,0,1156,0,0,1159,0,0
"Asia","2024-11-26",0,4,1160,0,1,1160,0,0
"Asia","2024-11-27",0,24,1184,0,24,1184,0,0
"Asia","2024-11-28",0,0,1184,0,0,1184,0,0
"Asia","2024-11-29",0,1,1185,0,1,1185,0,0
"Asia","2024-11-30",0,23,1208,0,23,1208,0,0
"Asia","2024-12-01",0,0,1208,0,1,1209,0,0
"Asia","2024-12-02",0,0,1208,0,0,1209,0,0
"Asia","2024-12-03",0,2,1210,0,1,1210,0,0
"Asia","2024-12-04",0,0,1210,0,0,1210,0,0
"Asia","2024-12-05",0,0,1210,0,0,1210,0,0
"Asia","2024-12-06",0,0,1210,0,0,1210,0,0
"Asia","2024-12-07",0,0,1210,0,1,1211,0,0
"Asia","2024-12-08",0,0,1210,0,0,1211,0,0
"Asia","2024-12-09",0,1,1211,0,0,1211,0,0
"Asia","2024-12-10",0,1,1212,0,1,1212,0,0
"Asia","2024-12-11",0,0,1212,0,0,1212,0,0
"Asia","2024-12-12",0,0,1212,0,1,1213,0,0
"Asia","2024-12-13",0,0,1212,0,0,1213,0,0
"Asia","2024-12-14",0,0,1212,0,0,1213,0,0
"Asia","2024-12-15",0,0,1212,0,0,1213,0,0
"Asia","2024-12-16",0,0,1212,0,1,1214,0,0
"Asia","2024-12-17",0,2,1214,0,0,1214,0,0
"Asia","2024-12-18",0,0,1214,0,0,1214,0,0
"Asia","2024-12-19",0,0,1214,0,0,1214,0,0
"Asia","2024-12-20",0,0,1214,0,0,1214,0,0
"Asia","2024-12-21",0,0,1214,0,1,1215,0,0
"Asia","2024-12-22",0,0,1214,0,0,1215,0,0
"Asia","2024-12-23",0,0,1214,0,0,1215,0,0
"Asia","2024-12-24",0,1,1215,0,0,1215,0,0
"Asia","2024-12-25",0,0,1215,0,4,1219,0,0
"Asia","2024-12-26",0,7,1222,0,3,1222,0,0
"Asia","2024-12-27",0,1,1223,0,1,1223,0,0
"Asia","2024-12-28",0,0,1223,0,7,1230,0,0
"Asia","2024-12-29",0,0,1223,0,7,1237,0,0
"Asia","2024-12-30",0,0,1223,0,6,1243,0,0
"Asia","2024-12-31",0,27,1250,0,7,1250,0,0
"Asia","2025-01-01",0,0,1250,0,0,1250,0,0
"Asia","2025-01-02",0,0,1250,0,1,1251,0,0
"Asia","2025-01-03",0,1,1251,0,0,1251,0,0
"Asia","2025-01-04",0,0,1251,0,7,1258,0,0
"Asia","2025-01-05",0,0,1251,0,6,1264,0,0
"Asia","2025-01-06",0,0,1251,0,7,1271,0,0
"Asia","2025-01-07",0,0,1251,0,6,1277,0,0
"Asia","2025-01-08",0,33,1284,0,7,1284,0,0
"Asia","2025-01-09",0,0,1284,0,14,1298,0,0
"Asia","2025-01-10",0,27,1311,0,13,1311,0,0
"Asia","2025-01-11",0,0,1311,0,0,1311,0,0
"Asia","2025-01-12",0,0,1311,0,0,1311,0,0
"Asia","2025-01-13",0,0,1311,0,0,1311,0,0
"Asia","2025-01-14",0,0,1311,0,1,1312,0,0
"Asia","2025-01-15",0,0,1311,0,0,1312,0,0
"Asia","2025-01-16",0,0,1311,0,0,1312,0,0
"Asia","2025-01-17",0,1,1312,0,0,1312,0,0
"Asia","2025-01-18",0,0,1312,0,0,1312,0,0
"Asia","2025-01-19",0,0,1312,0,1,1313,0,0
"Asia","2025-01-20",0,0,1312,0,1,1314,0,0
"Asia","2025-01-21",0,2,1314,0,0,1314,0,0
"Asia","2025-01-22",0,0,1314,0,0,1314,0,0
"Asia","2025-01-23",0,0,1314,0,1,1315,0,0
"Asia","2025-01-24",0,1,1315,0,0,1315,0,0
"Asia","2025-01-25",0,2,1317,0,2,1317,0,0
"Asia","2025-01-26",0,0,1317,0,0,1317,0,0
"Asia","2025-01-27",0,0,1317,0,0,1317,0,0
"Asia","2025-01-28",0,0,1317,0,1,1318,0,0
"Asia","2025-01-29",0,1,1318,0,0,1318,0,0
"Asia","2025-01-30",0,0,1318,0,21,1339,0,0
"Asia","2025-01-31",0,42,1360,0,21,1360,0,0
"Asia","2025-02-01",0,0,1360,0,0,1360,0,0
"Asia","2025-02-02",0,0,1360,0,0,1360,0,0
"Asia","2025-02-03",0,0,1360,0,1,1361,0,0
"Asia","2025-02-04",0,0,1360,0,0,1361,0,0
"Asia","2025-02-05",0,1,1361,0,0,1361,0,0
"Asia","2025-02-06",0,1,1362,0,1,1362,0,0
"Asia","2025-02-07",0,2,1364,0,2,1364,0,0
"Asia","2025-02-08",0,0,1364,0,0,1364,0,0
"Asia","2025-02-09",0,0,1364,0,0,1364,0,0
"Asia","2025-02-10",0,0,1364,0,1,1365,0,0
"Asia","2025-02-11",0,0,1364,0,0,1365,0,0
"Asia","2025-02-12",0,1,1365,0,0,1365,0,0
"Asia","2025-02-13",0,0,1365,0,0,1365,0,0
"Asia","2025-02-14",0,0,1365,0,0,1365,0,0
"Asia","2025-02-15",0,0,1365,0,0,1365,0,0
"Asia","2025-02-16",0,0,1365,0,0,1365,0,0
"Asia","2025-02-17",0,0,1365,0,0,1365,0,0
"Asia","2025-02-18",0,0,1365,0,0,1365,0,0
"Asia","2025-02-19",0,0,1365,0,0,1365,0,0
"Asia","2025-02-20",0,0,1365,0,0,1365,0,0
"Asia","2025-02-21",0,0,1365,0,0,1365,0,0
"Asia","2025-02-22",0,0,1365,0,0,1365,0,0
"Asia","2025-02-23",0,0,1365,0,0,1365,0,0
"Asia","2025-02-24",0,0,1365,0,0,1365,0,0
"Asia","2025-02-25",0,0,1365,0,0,1365,0,0
"Asia","2025-02-26",0,0,1365,0,0,1365,0,0
"Asia","2025-02-27",0,0,1365,0,0,1365,0,0
"Asia","2025-02-28",0,0,1365,0,0,1365,0,0
"Asia","2025-03-01",0,0,1365,0,0,1365,0,0
"Asia","2025-03-02",0,0,1365,0,0,1365,0,0
"Asia","2025-03-03",0,0,1365,0,0,1365,0,0
"Australia","2024-01-01",0,0,0,0,0,0,0,0
"Australia","2024-01-02",0,0,0,0,0,0,0,0
"Australia","2024-01-03",0,0,0,0,0,0,0,0
"Australia","2024-01-04",0,0,0,0,0,0,0,0
"Australia","2024-01-05",0,0,0,0,0,0,0,0
"Australia","2024-01-06",0,0,0,0,0,0,0,0
"Australia","2024-01-07",0,0,0,0,0,0,0,0
"Australia","2024-01-08",0,0,0,0,0,0,0,0
"Australia","2024-01-09",0,0,0,0,0,0,0,0
"Australia","2024-01-10",0,0,0,0,0,0,0,0
"Australia","2024-01-11",0,0,0,0,0,0,0,0
"Australia","2024-01-12",0,0,0,0,0,0,0,0
"Australia","2024-01-13",0,0,0,0,0,0,0,0
"Australia","2024-01-14",0,0,0,0,0,0,0,0
"Australia","2024-01-15",0,0,0,0,0,0,0,0
"Australia","2024-01-16",0,0,0,0,0,0,0,0
"Australia","2024-01-17",0,0,0,0,0,0,0,0
"Australia","2024-01-18",0,0,0,0,0,0,0,0
"Australia","2024-01-19",0,0,0,0,0,0,0,0
"Australia","2024-01-20",0,0,0,0,0,0,0,0
"Australia","2024-01-21",0,0,0,0,0,0,0,0
"Australia","2024-01-22",0,0,0,0,0,0,0,0
"Australia","2024-01-23",0,0,0,0,0,0,0,0
"Australia","2024-01-24",0,0,0,0,0,0,0,0
"Australia","2024-01-25",0,0,0,0,0,0,0,0
"Australia","2024-01-26",0,0,0,0,0,0,0,0
"Australia","2024-01-27",0,0,0,0,0,0,0,0
"Australia","2024-01-28",0,0,0,0,0,0,0,0
"Australia","2024-01-29",0,0,0,0,0,0,0,0
"Australia","2024-01-30",0,0,0,0,0,0,0,0
"Australia","2024-01-31",0,6,6,0,6,6,0,0
"Australia","2024-02-01",0,0,6,0,0,6,0,0
"Australia","2024-02-02",0,0,6,0,0,6,0,0
"Australia","2024-02-03",0,0,6,0,0,6,0,0
"Australia","2024-02-04",0,0,6,0,0,6,0,0
"Australia","2024-02-05",0,0,6,0,0,6,0,0
"Australia","2024-02-06",0,0,6,0,0,6,0,0
"Australia","2024-02-07",0,0,6,0,0,6,0,0
"Australia","2024-02-08",0,0,6,0,0,6,0,0
"Australia","2024-02-09",0,0,6,0,0,6,0,0
"Australia","2024-02-10",0,0,6,0,1,7,0,0
"Australia","2024-02-11",0,0,6,0,0,7,0,0
"Australia","2024-02-12",0,0,6,0,0,7,0,0
"Australia","2024-02-13",0,0,6,0,0,7,0,0
"Australia","2024-02-14",0,0,6,0,0,7,0,0
"Australia","2024-02-15",0,0,6,0,0,7,0,0
"Australia","2024-02-16",0,0,6,0,0,7,0,0
"Australia","2024-02-17",0,0,6,0,0,7,0,0
"Australia","2024-02-18",0,0,6,0,0,7,0,0
"Australia","2024-02-19",0,0,6,0,0,7,0,0
"Australia","2024-02-20",0,0,6,0,0,7,0,0
"Australia","2024-02-21",0,0,6,0,0,7,0,0
"Australia","2024-02-22",0,0,6,0,0,7,0,0
"Australia","2024-02-23",0,0,6,0,0,7,0,0
"Australia","2024-02-24",0,0,6,0,0,7,0,0
"Australia","2024-02-25",0,0,6,0,0,7,0,0
"Australia","2024-02-26",0,0,6,0,0,7,0,0
"Australia","2024-02-27",0,0,6,0,1,8,0,0
"Australia","2024-02-28",0,0,6,0,0,8,0,0
"Australia","2024-02-29",0,0,6,0,0,8,0,0
"Australia","2024-03-01",0,0,6,0,0,8,0,0
"Australia","2024-03-02",0,0,6,0,0,8,0,0
"Australia","2024-03-03",0,0,6,0,0,8,0,0
"Australia","2024-03-04",0,0,6,0,0,8,0,0
"Australia","2024-03-05",0,0,6,0,0,8,0,0
"Australia","2024-03-06",0,0,6,0,0,8,0,0
"Australia","2024-03-07",0,0,6,0,0,8,0,0
"Australia","2024-03-08",0,0,6,0,0,8,0,0
"Australia","2024-03-09",0,0,6,0,0,8,0,0
"Australia","2024-03-10",0,0,6,0,0,8,0,0
"Australia","2024-03-11",0,0,6,0,0,8,0,0
"Australia","2024-03-12",0,0,6,0,0,8,0,0
"Australia","2024-03-13",0,0,6,0,0,8,0,0
"Australia","2024-03-14",0,0,6,0,0,8,0,0
"Australia","2024-03-15",0,0,6,0,0,8,0,0
"Australia","2024-03-16",0,0,6,0,0,8,0,0
"Australia","2024-03-17",0,0,6,0,1,9,0,0
"Australia","2024-03-18",0,0,6,0,0,9,0,0
"Australia","2024-03-19",0,0,6,0,0,9,0,0
"Australia","2024-03-20",0,0,6,0,0,9,0,0
"Australia","2024-03-21",0,0,6,0,0,9,0,0
"Australia","2024-03-22",0,0,6,0,0,9,0,0
"Australia","2024-03-23",0,0,6,0,0,9,0,0
"Australia","2024-03-24",0,0,6,0,0,9,0,0
"Australia","2024-03-25",0,0,6,0,0,9,0,0
"Australia","2024-03-26",0,0,6,0,0,9,0,0
"Australia","2024-03-27",0,0,6,0,0,9,0,0
"Australia","2024-03-28",0,0,6,0,0,9,0,0
"Australia","2024-03-29",0,0,6,0,0,9,0,0
"Australia","2024-03-30",0,0,6,0,0,9,0,0
"Australia","2024-03-31",0,0,6,0,0,9,0,0
"Australia","2024-04-01",0,0,6,0,0,9,0,0
"Australia","2024-04-02",0,0,6,0,0,9,0,0
"Australia","2024-04-03",0,0,6,0,1,10,0,0
"Australia","2024-04-04",0,0,6,0,0,10,0,0
"Australia","2024-04-05",0,0,6,0,0,10,0,0
"Australia","2024-04-06",0,0,6,0,0,10,0,0
"Australia","2024-04-07",0,0,6,0,0,10,0,0
"Australia","2024-04-08",0,0,6,0,0,10,0,0
"Australia","2024-04-09",0,0,6,0,0,10,0,0
"Australia","2024-04-10",0,0,6,0,0,10,0,0
"Australia","2024-04-11",0,0,6,0,0,10,0,0
"Australia","2024-04-12",0,0,6,0,0,10,0,0
"Australia","2024-04-13",0,0,6,0,0,10,0,0
"Australia","2024-04-14",0,0,6,0,0,10,0,0
"Australia","2024-04-15",0,0,6,0,0,10,0,0
"Australia","2024-04-16",0,0,6,0,0,10,0,0
"Australia","2024-04-17",0,0,6,0,0,10,0,0
"Australia","2024-04-18",0,0,6,0,0,10,0,0
"Australia","2024-04-19",0,0,6,0,0,10,0,0
"Australia","2024-04-20",0,0,6,0,0,10,0,0
"Australia","2024-04-21",0,0,6,0,0,10,0,0
"Australia","2024-04-22",0,0,6,0,1,11,0,0
"Australia","2024-04-23",0,0,6,0,0,11,0,0
"Australia","2024-04-24",0,0,6,0,0,11,0,0
"Australia","2024-04-25",0,0,6,0,0,11,0,0
"Australia","2024-04-26",0,0,6,0,0,11,0,0
"Australia","2024-04-27",0,0,6,0,0,11,0,0
"Australia","2024-04-28",0,0,6,0,0,11,0,0
"Australia","2024-04-29",0,0,6,0,0,11,0,0
"Australia","2024-04-30",0,5,11,0,0,11,0,0
"Australia","2024-05-01",0,0,11,0,1,12,0,0
"Australia","2024-05-02",0,0,11,0,1,13,0,0
"Australia","2024-05-03",0,0,11,0,1,14,0,0
"Australia","2024-05-04",0,0,11,0,1,15,0,0
"Australia","2024-05-05",0,0,11,0,1,16,0,0
"Australia","2024-05-06",0,0,11,0,1,17,0,0
"Australia","2024-05-07",0,0,11,0,1,18,0,0
"Australia","2024-05-08",0,0,11,0,2,20,0,0
"Australia","2024-05-09",0,0,11,0,1,21,0,0
"Australia","2024-05-10",0,0,11,0,1,22,0,0
"Australia","2024-05-11",0,0,11,0,1,23,0,0
"Australia","2024-05-12",0,0,11,0,1,24,0,0
"Australia","2024-05-13",0,0,11,0,1,25,0,0
"Australia","2024-05-14",0,0,11,0,1,26,0,0
"Australia","2024-05-15",0,0,11,0,1,27,0,0
"Australia","2024-05-16",0,0,11,0,1,28,0,0
"Australia","2024-05-17",0,0,11,0,1,29,0,0
"Australia","2024-05-18",0,0,11,0,1,30,0,0
"Australia","2024-05-19",0,0,11,0,1,31,0,0
"Australia","2024-05-20",0,0,11,0,1,32,0,0
"Australia","2024-05-21",0,0,11,0,1,33,0,0
"Australia","2024-05-22",0,0,11,0,1,34,0,0
"Australia","2024-05-23",0,0,11,0,1,35,0,0
"Australia","2024-05-24",0,0,11,0,2,37,0,0
"Australia","2024-05-25",0,0,11,0,1,38,0,0
"Australia","2024-05-26",0,0,11,0,1,39,0,0
"Australia","2024-05-27",0,0,11,0,1,40,0,0
"Australia","2024-05-28",0,0,11,0,1,41,0,0
"Australia","2024-05-29",0,0,11,0,1,42,0,0
"Australia","2024-05-30",0,0,11,0,1,43,0,0
"Australia","2024-05-31",0,33,44,0,1,44,0,0
"Australia","2024-06-01",0,0,44,0,2,46,0,0
"Australia","2024-06-02",0,0,44,0,2,48,0,0
"Australia","2024-06-03",0,0,44,0,2,50,0,0
"Australia","2024-06-04",0,0,44,0,3,53,0,0
"Australia","2024-06-05",0,0,44,0,2,55,0,0
"Australia","2024-06-06",0,0,44,0,2,57,0,0
"Australia","2024-06-07",0,0,44,0,2,59,0,0
"Australia","2024-06-08",0,0,44,0,2,61,0,0
"Australia","2024-06-09",0,0,44,0,2,63,0,0
"Australia","2024-06-10",0,0,44,0,2,65,0,0
"Australia","2024-06-11",0,0,44,0,2,67,0,0
"Australia","2024-06-12",0,0,44,0,3,70,0,0
"Australia","2024-06-13",0,0,44,0,2,72,0,0
"Australia","2024-06-14",0,0,44,0,2,74,0,0
"Australia","2024-06-15",0,0,44,0,2,76,0,0
"Australia","2024-06-16",0,0,44,0,2,78,0,0
"Australia","2024-06-17",0,0,44,0,2,80,0,0
"Australia","2024-06-18",0,0,44,0,2,82,0,0
"Australia","2024-06-19",0,0,44,0,3,85,0,0
"Australia","2024-06-20",0,0,44,0,2,87,0,0
"Australia","2024-06-21",0,0,44,0,2,89,0,0
"Australia","2024-06-22",0,0,44,0,2,91,0,0
"Australia","2024-06-23",0,0,44,0,2,93,0,0
"Australia","2024-06-24",0,0,44,0,2,95,0,0
"Australia","2024-06-25",0,0,44,0,2,97,0,0
"Australia","2024-06-26",0,0,44,0,2,99,0,0
"Australia","2024-06-27",0,0,44,0,3,102,0,0
"Australia","2024-06-28",0,0,44,0,2,104,0,0
"Australia","2024-06-29",0,0,44,0,2,106,0,0
"Australia","2024-06-30",0,64,108,0,2,108,0,0
"Australia","2024-07-01",0,0,108,0,1,109,0,0
"Australia","2024-07-02",0,0,108,0,1,110,0,0
"Australia","2024-07-03",0,0,108,0,1,111,0,0
"Australia","2024-07-04",0,0,108,0,1,112,0,0
"Australia","2024-07-05",0,0,108,0,1,113,0,0
"Australia","2024-07-06",0,0,108,0,1,114,0,0
"Australia","2024-07-07",0,0,108,0,1,115,0,0
"Australia","2024-07-08",0,0,108,0,0,115,0,0
"Australia","2024-07-09",0,0,108,0,1,116,0,0
"Australia","2024-07-10",0,0,108,0,1,117,0,0
"Australia","2024-07-11",0,0,108,0,1,118,0,0
"Australia","2024-07-12",0,0,108,0,1,119,0,0
"Australia","2024-07-13",0,0,108,0,1,120,0,0
"Australia","2024-07-14",0,0,108,0,1,121,0,0
"Australia","2024-07-15",0,14,122,0,1,122,0,0
"Australia","2024-07-16",0,0,122,0,3,125,0,0
"Australia","2024-07-17",0,0,122,0,3,128,0,0
"Australia","2024-07-18",0,0,122,0,3,131,0,0
"Australia","2024-07-19",0,0,122,0,3,134,0,0
"Australia","2024-07-20",0,0,122,0,3,137,0,0
"Australia","2024-07-21",0,0,122,0,3,140,0,0
"Australia","2024-07-22",0,21,143,0,3,143,0,0
"Australia","2024-07-23",0,0,143,0,4,147,0,0
"Australia","2024-07-24",0,0,143,0,4,151,0,0
"Australia","2024-07-25",0,0,143,0,5,156,0,0
"Australia","2024-07-26",0,0,143,0,4,160,0,0
"Australia","2024-07-27",0,21,164,0,4,164,0,0
"Australia","2024-07-28",0,0,164,0,11,175,0,0
"Australia","2024-07-29",0,0,164,0,10,185,0,0
"Australia","2024-07-30",0,32,196,0,11,196,0,0
"Australia","2024-07-31",0,13,209,0,13,209,0,0
"Australia","2024-08-01",0,0,209,0,4,213,0,0
"Australia","2024-08-02",0,0,209,0,3,216,0,0
"Australia","2024-08-03",0,0,209,0,4,220,0,0
"Australia","2024-08-04",0,0,209,0,3,223,0,0
"Australia","2024-08-05",0,0,209,0,4,227,0,0
"Australia","2024-08-06",0,0,209,0,3,230,0,0
"Australia","2024-08-07",0,0,209,0,4,234,0,0
"Australia","2024-08-08",0,0,209,0,3,237,0,0
"Australia","2024-08-09",0,0,209,0,4,241,0,0
"Australia","2024-08-10",0,0,209,0,3,244,0,0
"Australia","2024-08-11",0,0,209,0,4,248,0,0
"Australia","2024-08-12",0,0,209,0,3,251,0,0
"Australia","2024-08-13",0,0,209,0,4,255,0,0
"Australia","2024-08-14",0,0,209,0,3,258,0,0
"Australia","2024-08-15",0,0,209,0,4,262,0,0
"Australia","2024-08-16",0,0,209,0,3,265,0,0
"Australia","2024-08-17",0,0,209,0,4,269,0,0
"Australia","2024-08-18",0,0,209,0,3,272,0,0
"Australia","2024-08-19",0,0,209,0,4,276,0,0
"Australia","2024-08-20",0,0,209,0,3,279,0,0
"Australia","2024-08-21",0,74,283,0,4,283,0,0
"Australia","2024-08-22",0,0,283,0,9,292,0,0
"Australia","2024-08-23",0,0,283,0,9,301,0,0
"Australia","2024-08-24",0,0,283,0,8,309,0,0
"Australia","2024-08-25",0,0,283,0,9,318,0,0
"Australia","2024-08-26",0,0,283,0,9,327,0,0
"Australia","2024-08-27",0,0,283,0,8,335,0,0
"Australia","2024-08-28",0,0,283,0,9,344,0,0
"Australia","2024-08-29",0,70,353,0,9,353,0,0
"Australia","2024-08-30",0,0,353,0,50,403,0,0
"Australia","2024-08-31",0,101,454,0,51,454,0,0
"Australia","2024-09-01",0,0,454,0,4,458,0,0
"Australia","2024-09-02",0,0,454,0,5,463,0,0
"Australia","2024-09-03",0,0,454,0,4,467,0,0
"Australia","2024-09-04",0,0,454,0,5,472,0,0
"Australia","2024-09-05",0,0,454,0,4,476,0,0
"Australia","2024-09-06",0,0,454,0,4,480,0,0
"Australia","2024-09-07",0,0,454,0,5,485,0,0
"Australia","2024-09-08",0,35,489,0,4,489,0,0
"Australia","2024-09-09",0,0,489,0,12,501,0,0
"Australia","2024-09-10",0,0,489,0,12,513,0,0
"Australia","2024-09-11",0,0,489,0,12,525,0,0
"Australia","2024-09-12",0,0,489,0,12,537,0,0
"Australia","2024-09-13",0,0,489,0,12,549,0,0
"Australia","2024-09-14",0,0,489,0,12,561,0,0
"Australia","2024-09-15",0,84,573,0,12,573,0,0
"Australia","2024-09-16",0,0,573,0,13,586,0,0
"Australia","2024-09-17",0,0,573,0,13,599,0,0
"Australia","2024-09-18",0,0,573,0,13,612,0,0
"Australia","2024-09-19",0,0,573,0,14,626,0,0
"Australia","2024-09-20",0,0,573,0,13,639,0,0
"Australia","2024-09-21",0,0,573,0,13,652,0,0
"Australia","2024-09-22",0,92,665,0,13,665,0,0
"Australia","2024-09-23",0,0,665,0,13,678,0,0
"Australia","2024-09-24",0,0,665,0,13,691,0,0
"Australia","2024-09-25",0,0,665,0,13,704,0,0
"Australia","2024-09-26",0,0,665,0,13,717,0,0
"Australia","2024-09-27",0,0,665,0,13,730,0,0
"Australia","2024-09-28",0,0,665,0,13,743,0,0
"Australia","2024-09-29",0,91,756,0,13,756,0,0
"Australia","2024-09-30",0,0,756,0,10,766,0,0
"Australia","2024-10-01",0,0,756,0,11,777,0,0
"Australia","2024-10-02",0,0,756,0,10,787,0,0
"Australia","2024-10-03",0,0,756,0,10,797,0,0
"Australia","2024-10-04",0,0,756,0,10,807,0,0
"Australia","2024-10-05",0,0,756,0,11,818,0,0
"Australia","2024-10-06",0,72,828,0,10,828,0,0
"Australia","2024-10-07",0,23,851,0,23,851,0,0
"Australia","2024-10-08",0,0,851,0,9,860,0,0
"Australia","2024-10-09",0,0,851,0,9,869,0,0
"Australia","2024-10-10",0,0,851,0,9,878,0,0
"Australia","2024-10-11",0,0,851,0,9,887,0,0
"Australia","2024-10-12",0,0,851,0,9,896,0,0
"Australia","2024-10-13",0,54,905,0,9,905,0,0
"Australia","2024-10-14",0,0,905,0,11,916,0,0
"Australia","2024-10-15",0,0,905,0,12,928,0,0
"Australia","2024-10-16",0,0,905,0,11,939,0,0
"Australia","2024-10-17",0,0,905,0,11,950,0,0
"Australia","2024-10-18",0,0,905,0,11,961,0,0
"Australia","2024-10-19",0,0,905,0,12,973,0,0
"Australia","2024-10-20",0,79,984,0,11,984,0,0
"Australia","2024-10-21",0,0,984,0,10,994,0,0
"Australia","2024-10-22",0,0,984,0,9,1003,0,0
"Australia","2024-10-23",0,0,984,0,10,1013,0,0
"Australia","2024-10-24",0,0,984,0,10,1023,0,0
"Australia","2024-10-25",0,0,984,0,10,1033,0,0
"Australia","2024-10-26",0,0,984,0,9,1042,0,0
"Australia","2024-10-27",0,68,1052,0,10,1052,0,0
"Australia","2024-10-28",0,0,1052,0,11,1063,0,0
"Australia","2024-10-29",0,0,1052,0,12,1075,0,0
"Australia","2024-10-30",0,0,1052,0,11,1086,0,0
"Australia","2024-10-31",0,0,1052,0,11,1097,0,0
"Australia","2024-11-01",0,0,1052,0,11,1108,0,0
"Australia","2024-11-02",0,0,1052,0,12,1120,0,0
"Australia","2024-11-03",0,79,1131,0,11,1131,0,0
"Australia","2024-11-04",0,0,1131,0,8,1139,0,0
"Australia","2024-11-05",0,0,1131,0,8,1147,0,0
"Australia","2024-11-06",0,0,1131,0,8,1155,0,0
"Australia","2024-11-07",0,0,1131,0,9,1164,0,0
"Australia","2024-11-08",0,0,1131,0,8,1172,0,0
"Australia","2024-11-09",0,0,1131,0,8,1180,0,0
"Australia","2024-11-10",0,57,1188,0,8,1188,0,0
"Australia","2024-11-11",0,0,1188,0,7,1195,0,0
"Australia","2024-11-12",0,0,1188,0,7,1202,0,0
"Australia","2024-11-13",0,0,1188,0,7,1209,0,0
"Australia","2024-11-14",0,0,1188,0,7,1216,0,0
"Australia","2024-11-15",0,0,1188,0,7,1223,0,0
"Australia","2024-11-16",0,0,1188,0,7,1230,0,0
"Australia","2024-11-17",0,49,1237,0,7,1237,0,0
"Australia","2024-11-18",0,0,1237,0,4,1241,0,0
"Australia","2024-11-19",0,0,1237,0,4,1245,0,0
"Australia","2024-11-20",0,0,1237,0,4,1249,0,0
"Australia","2024-11-21",0,0,1237,0,5,1254,0,0
"Australia","2024-11-22",0,0,1237,0,4,1258,0,0
"Australia","2024-11-23",0,0,1237,0,4,1262,0,0
"Australia","2024-11-24",0,29,1266,0,4,1266,0,0
"Australia","2024-11-25",0,0,1266,0,5,1271,0,0
"Australia","2024-11-26",0,0,1266,0,5,1276,0,0
"Australia","2024-11-27",0,0,1266,0,5,1281,0,0
"Australia","2024-11-28",0,0,1266,0,4,1285,0,0
"Australia","2024-11-29",0,0,1266,0,5,1290,0,0
"Australia","2024-11-30",0,0,1266,0,5,1295,0,0
"Australia","2024-12-01",0,34,1300,0,5,1300,0,0
"Australia","2024-12-02",0,0,1300,0,3,1303,0,0
"Australia","2024-12-03",0,0,1300,0,3,1306,0,0
"Australia","2024-12-04",0,0,1300,0,4,1310,0,0
"Australia","2024-12-05",0,0,1300,0,3,1313,0,0
"Australia","2024-12-06",0,0,1300,0,3,1316,0,0
"Australia","2024-12-07",0,0,1300,0,4,1320,0,0
"Australia","2024-12-08",0,0,1300,0,3,1323,0,0
"Australia","2024-12-09",0,26,1326,0,3,1326,0,0
"Australia","2024-12-10",0,0,1326,0,4,1330,0,0
"Australia","2024-12-11",0,0,1326,0,5,1335,0,0
"Australia","2024-12-12",0,0,1326,0,4,1339,0,0
"Australia","2024-12-13",0,0,1326,0,4,1343,0,0
"Australia","2024-12-14",0,0,1326,0,5,1348,0,0
"Australia","2024-12-15",0,26,1352,0,4,1352,0,0
"Australia","2024-12-16",0,0,1352,0,3,1355,0,0
"Australia","2024-12-17",0,0,1352,0,2,1357,0,0
"Australia","2024-12-18",0,0,1352,0,3,1360,0,0
"Australia","2024-12-19",0,0,1352,0,3,1363,0,0
"Australia","2024-12-20",0,0,1352,0,3,1366,0,0
"Australia","2024-12-21",0,0,1352,0,2,1368,0,0
"Australia","2024-12-22",0,19,1371,0,3,1371,0,0
"Australia","2024-12-23",0,0,1371,0,2,1373,0,0
"Australia","2024-12-24",0,0,1371,0,2,1375,0,0
"Australia","2024-12-25",0,0,1371,0,2,1377,0,0
"Australia","2024-12-26",0,0,1371,0,1,1378,0,0
"Australia","2024-12-27",0,0,1371,0,2,1380,0,0
"Australia","2024-12-28",0,0,1371,0,2,1382,0,0
"Australia","2024-12-29",0,13,1384,0,2,1384,0,0
"Australia","2024-12-30",0,0,1384,0,2,1386,0,0
"Australia","2024-12-31",0,0,1384,0,1,1387,0,0
"Australia","2025-01-01",0,0,1384,0,2,1389,0,0
"Australia","2025-01-02",0,0,1384,0,2,1391,0,0
"Australia","2025-01-03",0,0,1384,0,2,1393,0,0
"Australia","2025-01-04",0,0,1384,0,1,1394,0,0
"Australia","2025-01-05",0,12,1396,0,2,1396,0,0
"Australia","2025-01-06",0,0,1396,0,4,1400,0,0
"Australia","2025-01-07",0,0,1396,0,4,1404,0,0
"Australia","2025-01-08",0,0,1396,0,4,1408,0,0
"Australia","2025-01-09",0,0,1396,0,3,1411,0,0
"Australia","2025-01-10",0,0,1396,0,4,1415,0,0
"Australia","2025-01-11",0,0,1396,0,4,1419,0,0
"Australia","2025-01-12",0,27,1423,0,4,1423,0,0
"Australia","2025-01-13",0,0,1423,0,5,1428,0,0
"Australia","2025-01-14",0,0,1423,0,4,1432,0,0
"Australia","2025-01-15",0,0,1423,0,5,1437,0,0
"Australia","2025-01-16",0,0,1423,0,4,1441,0,0
"Australia","2025-01-17",0,0,1423,0,5,1446,0,0
"Australia","2025-01-18",0,0,1423,0,4,1450,0,0
"Australia","2025-01-19",0,32,1455,0,5,1455,0,0
"Australia","2025-01-20",0,0,1455,0,3,1458,0,0
"Australia","2025-01-21",0,0,1455,0,2,1460,0,0
"Australia","2025-01-22",0,0,1455,0,3,1463,0,0
"Australia","2025-01-23",0,0,1455,0,3,1466,0,0
"Australia","2025-01-24",0,0,1455,0,3,1469,0,0
"Australia","2025-01-25",0,0,1455,0,2,1471,0,0
"Australia","2025-01-26",0,19,1474,0,3,1474,0,0
"Australia","2025-01-27",0,0,1474,0,1,1475,0,0
"Australia","2025-01-28",0,0,1474,0,2,1477,0,0
"Australia","2025-01-29",0,0,1474,0,1,1478,0,0
"Australia","2025-01-30",0,0,1474,0,1,1479,0,0
"Australia","2025-01-31",0,0,1474,0,1,1480,0,0
"Australia","2025-02-01",0,0,1474,0,2,1482,0,0
"Australia","2025-02-02",0,9,1483,0,1,1483,0,0
"Australia","2025-02-03",0,0,1483,0,2,1485,0,0
"Australia","2025-02-04",0,0,1483,0,2,1487,0,0
"Australia","2025-02-05",0,0,1483,0,2,1489,0,0
"Australia","2025-02-06",0,0,1483,0,2,1491,0,0
"Australia","2025-02-07",0,0,1483,0,2,1493,0,0
"Australia","2025-02-08",0,0,1483,0,2,1495,0,0
"Australia","2025-02-09",0,14,1497,0,2,1497,0,0
"Australia","2025-02-10",0,0,1497,0,2,1499,0,0
"Australia","2025-02-11",0,0,1497,0,2,1501,0,0
"Australia","2025-02-12",0,0,1497,0,2,1503,0,0
"Australia","2025-02-13",0,0,1497,0,2,1505,0,0
"Australia","2025-02-14",0,0,1497,0,2,1507,0,0
"Australia","2025-02-15",0,0,1497,0,2,1509,0,0
"Australia","2025-02-16",0,14,1511,0,2,1511,0,0
"Australia","2025-02-17",0,0,1511,0,0,1511,0,0
"Australia","2025-02-18",0,0,1511,0,0,1511,0,0
"Australia","2025-02-19",0,0,1511,0,0,1511,0,0
"Australia","2025-02-20",0,0,1511,0,0,1511,0,0
"Australia","2025-02-21",0,0,1511,0,0,1511,0,0
"Australia","2025-02-22",0,0,1511,0,0,1511,0,0
"Australia","2025-02-23",0,0,1511,0,0,1511,0,0
"Australia","2025-02-24",0,0,1511,0,0,1511,0,0
"Australia","2025-02-25",0,0,1511,0,0,1511,0,0
"Australia","2025-02-26",0,0,1511,0,0,1511,0,0
"Australia","2025-02-27",0,0,1511,0,0,1511,0,0
"Australia","2025-02-28",0,0,1511,0,0,1511,0,0
"Australia","2025-03-01",0,0,1511,0,0,1511,0,0
"Australia","2025-03-02",0,0,1511,0,0,1511,0,0
"Australia","2025-03-03",0,0,1511,0,0,1511,0,0
"Austria","2024-01-01",0,0,0,0,0,0,0,0
"Austria","2024-01-02",0,0,0,0,0,0,0,0
"Austria","2024-01-03",0,0,0,0,0,0,0,0
"Austria","2024-01-04",0,0,0,0,0,0,0,0
"Austria","2024-01-05",0,0,0,0,0,0,0,0
"Austria","2024-01-06",0,0,0,0,0,0,0,0
"Austria","2024-01-07",0,0,0,0,0,0,0,0
"Austria","2024-01-08",0,0,0,0,0,0,0,0
"Austria","2024-01-09",0,0,0,0,0,0,0,0
"Austria","2024-01-10",0,0,0,0,0,0,0,0
"Austria","2024-01-11",0,0,0,0,0,0,0,0
"Austria","2024-01-12",0,0,0,0,0,0,0,0
"Austria","2024-01-13",0,0,0,0,0,0,0,0
"Austria","2024-01-14",0,0,0,0,0,0,0,0
"Austria","2024-01-15",0,0,0,0,0,0,0,0
"Austria","2024-01-16",0,0,0,0,0,0,0,0
"Austria","2024-01-17",0,0,0,0,0,0,0,0
"Austria","2024-01-18",0,0,0,0,0,0,0,0
"Austria","2024-01-19",0,0,0,0,0,0,0,0
"Austria","2024-01-20",0,0,0,0,0,0,0,0
"Austria","2024-01-21",0,0,0,0,0,0,0,0
"Austria","2024-01-22",0,0,0,0,0,0,0,0
"Austria","2024-01-23",0,0,0,0,0,0,0,0
"Austria","2024-01-24",0,0,0,0,0,0,0,0
"Austria","2024-01-25",0,0,0,0,0,0,0,0
"Austria","2024-01-26",0,0,0,0,0,0,0,0
"Austria","2024-01-27",0,0,0,0,0,0,0,0
"Austria","2024-01-28",0,0,0,0,0,0,0,0
"Austria","2024-01-29",0,0,0,0,0,0,0,0
"Austria","2024-01-30",0,0,0,0,0,0,0,0
"Austria","2024-01-31",0,3,3,0,3,3,0,0
"Austria","2024-02-01",0,0,3,0,0,3,0,0
"Austria","2024-02-02",0,0,3,0,0,3,0,0
"Austria","2024-02-03",0,0,3,0,0,3,0,0
"Austria","2024-02-04",0,0,3,0,1,4,0,0
"Austria","2024-02-05",0,0,3,0,0,4,0,0
"Austria","2024-02-06",0,0,3,0,0,4,0,0
"Austria","2024-02-07",0,0,3,0,0,4,0,0
"Austria","2024-02-08",0,0,3,0,0,4,0,0
"Austria","2024-02-09",0,0,3,0,0,4,0,0
"Austria","2024-02-10",0,0,3,0,0,4,0,0
"Austria","2024-02-11",0,0,3,0,1,5,0,0
"Austria","2024-02-12",0,0,3,0,0,5,0,0
"Austria","2024-02-13",0,0,3,0,0,5,0,0
"Austria","2024-02-14",0,0,3,0,0,5,0,0
"Austria","2024-02-15",0,0,3,0,0,5,0,0
"Austria","2024-02-16",0,0,3,0,0,5,0,0
"Austria","2024-02-17",0,0,3,0,0,5,0,0
"Austria","2024-02-18",0,0,3,0,0,5,0,0
"Austria","2024-02-19",0,0,3,0,1,6,0,0
"Austria","2024-02-20",0,0,3,0,0,6,0,0
"Austria","2024-02-21",0,0,3,0,0,6,0,0
"Austria","2024-02-22",0,0,3,0,0,6,0,0
"Austria","2024-02-23",0,0,3,0,0,6,0,0
"Austria","2024-02-24",0,0,3,0,0,6,0,0
"Austria","2024-02-25",0,0,3,0,0,6,0,0
"Austria","2024-02-26",0,0,3,0,1,7,0,0
"Austria","2024-02-27",0,0,3,0,0,7,0,0
"Austria","2024-02-28",0,0,3,0,0,7,0,0
"Austria","2024-02-29",0,4,7,0,0,7,0,0
"Austria","2024-03-01",0,0,7,0,0,7,0,0
"Austria","2024-03-02",0,0,7,0,0,7,0,0
"Austria","2024-03-03",0,0,7,0,0,7,0,0
"Austria","2024-03-04",0,0,7,0,0,7,0,0
"Austria","2024-03-05",0,0,7,0,0,7,0,0
"Austria","2024-03-06",0,0,7,0,0,7,0,0
"Austria","2024-03-07",0,0,7,0,0,7,0,0
"Austria","2024-03-08",0,0,7,0,0,7,0,0
"Austria","2024-03-09",0,0,7,0,0,7,0,0
"Austria","2024-03-10",0,0,7,0,0,7,0,0
"Austria","2024-03-11",0,0,7,0,0,7,0,0
"Austria","2024-03-12",0,0,7,0,0,7,0,0
"Austria","2024-03-13",0,0,7,0,0,7,0,0
"Austria","2024-03-14",0,0,7,0,0,7,0,0
"Austria","2024-03-15",0,0,7,0,0,7,0,0
"Austria","2024-03-16",0,0,7,0,0,7,0,0
"Austria","2024-03-17",0,0,7,0,0,7,0,0
"Austria","2024-03-18",0,0,7,0,0,7,0,0
"Austria","2024-03-19",0,0,7,0,0,7,0,0
"Austria","2024-03-20",0,0,7,0,0,7,0,0
"Austria","2024-03-21",0,0,7,0,0,7,0,0
"Austria","2024-03-22",0,0,7,0,0,7,0,0
"Austria","2024-03-23",0,0,7,0,0,7,0,0
"Austria","2024-03-24",0,0,7,0,0,7,0,0
"Austria","2024-03-25",0,0,7,0,0,7,0,0
"Austria","2024-03-26",0,0,7,0,0,7,0,0
"Austria","2024-03-27",0,0,7,0,0,7,0,0
"Austria","2024-03-28",0,0,7,0,0,7,0,0
"Austria","2024-03-29",0,0,7,0,0,7,0,0
"Austria","2024-03-30",0,0,7,0,0,7,0,0
"Austria","2024-03-31",0,0,7,0,1,8,0,0
"Austria","2024-04-01",0,0,7,0,0,8,0,0
"Austria","2024-04-02",0,0,7,0,0,8,0,0
"Austria","2024-04-03",0,0,7,0,0,8,0,0
"Austria","2024-04-04",0,0,7,0,0,8,0,0
"Austria","2024-04-05",0,0,7,0,0,8,0,0
"Austria","2024-04-06",0,0,7,0,0,8,0,0
"Austria","2024-04-07",0,0,7,0,0,8,0,0
"Austria","2024-04-08",0,0,7,0,0,8,0,0
"Austria","2024-04-09",0,0,7,0,0,8,0,0
"Austria","2024-04-10",0,0,7,0,0,8,0,0
"Austria","2024-04-11",0,0,7,0,0,8,0,0
"Austria","2024-04-12",0,0,7,0,0,8,0,0
"Austria","2024-04-13",0,0,7,0,0,8,0,0
"Austria","2024-04-14",0,0,7,0,0,8,0,0
"Austria","2024-04-15",0,0,7,0,0,8,0,0
"Austria","2024-04-16",0,0,7,0,0,8,0,0
"Austria","2024-04-17",0,0,7,0,0,8,0,0
"Austria","2024-04-18",0,0,7,0,0,8,0,0
"Austria","2024-04-19",0,0,7,0,0,8,0,0
"Austria","2024-04-20",0,0,7,0,0,8,0,0
"Austria","2024-04-21",0,0,7,0,0,8,0,0
"Austria","2024-04-22",0,0,7,0,0,8,0,0
"Austria","2024-04-23",0,0,7,0,0,8,0,0
"Austria","2024-04-24",0,0,7,0,0,8,0,0
"Austria","2024-04-25",0,0,7,0,0,8,0,0
"Austria","2024-04-26",0,0,7,0,0,8,0,0
"Austria","2024-04-27",0,0,7,0,0,8,0,0
"Austria","2024-04-28",0,0,7,0,0,8,0,0
"Austria","2024-04-29",0,0,7,0,0,8,0,0
"Austria","2024-04-30",0,1,8,0,0,8,0,0
"Austria","2024-05-01",0,0,8,0,0,8,0,0
"Austria","2024-05-02",0,0,8,0,0,8,0,0
"Austria","2024-05-03",0,0,8,0,0,8,0,0
"Austria","2024-05-04",0,0,8,0,0,8,0,0
"Austria","2024-05-05",0,0,8,0,0,8,0,0
"Austria","2024-05-06",0,0,8,0,0,8,0,0
"Austria","2024-05-07",0,0,8,0,0,8,0,0
"Austria","2024-05-08",0,0,8,0,1,9,0,0
"Austria","2024-05-09",0,0,8,0,0,9,0,0
"Austria","2024-05-10",0,0,8,0,0,9,0,0
"Austria","2024-05-11",0,0,8,0,0,9,0,0
"Austria","2024-05-12",0,0,8,0,0,9,0,0
"Austria","2024-05-13",0,0,8,0,0,9,0,0
"Austria","2024-05-14",0,0,8,0,0,9,0,0
"Austria","2024-05-15",0,0,8,0,0,9,0,0
"Austria","2024-05-16",0,0,8,0,0,9,0,0
"Austria","2024-05-17",0,0,8,0,0,9,0,0
"Austria","2024-05-18",0,0,8,0,0,9,0,0
"Austria","2024-05-19",0,0,8,0,0,9,0,0
"Austria","2024-05-20",0,0,8,0,0,9,0,0
"Austria","2024-05-21",0,0,8,0,0,9,0,0
"Austria","2024-05-22",0,0,8,0,0,9,0,0
"Austria","2024-05-23",0,0,8,0,0,9,0,0
"Austria","2024-05-24",0,0,8,0,1,10,0,0
"Austria","2024-05-25",0,0,8,0,0,10,0,0
"Austria","2024-05-26",0,0,8,0,0,10,0,0
"Austria","2024-05-27",0,0,8,0,0,10,0,0
"Austria","2024-05-28",0,0,8,0,0,10,0,0
"Austria","2024-05-29",0,0,8,0,0,10,0,0
"Austria","2024-05-30",0,0,8,0,0,10,0,0
"Austria","2024-05-31",0,2,10,0,0,10,0,0
"Austria","2024-06-01",0,0,10,0,0,10,0,0
"Austria","2024-06-02",0,0,10,0,0,10,0,0
"Austria","2024-06-03",0,0,10,0,0,10,0,0
"Austria","2024-06-04",0,0,10,0,0,10,0,0
"Austria","2024-06-05",0,0,10,0,0,10,0,0
"Austria","2024-06-06",0,0,10,0,0,10,0,0
"Austria","2024-06-07",0,0,10,0,0,10,0,0
"Austria","2024-06-08",0,0,10,0,0,10,0,0
"Austria","2024-06-09",0,0,10,0,0,10,0,0
"Austria","2024-06-10",0,0,10,0,0,10,0,0
"Austria","2024-06-11",0,0,10,0,0,10,0,0
"Austria","2024-06-12",0,0,10,0,0,10,0,0
"Austria","2024-06-13",0,0,10,0,0,10,0,0
"Austria","2024-06-14",0,0,10,0,0,10,0,0
"Austria","2024-06-15",0,0,10,0,0,10,0,0
"Austria","2024-06-16",0,0,10,0,0,10,0,0
"Austria","2024-06-17",0,0,10,0,0,10,0,0
"Austria","2024-06-18",0,0,10,0,0,10,0,0
"Austria","2024-06-19",0,0,10,0,0,10,0,0
"Austria","2024-06-20",0,0,10,0,0,10,0,0
"Austria","2024-06-21",0,0,10,0,0,10,0,0
"Austria","2024-06-22",0,0,10,0,0,10,0,0
"Austria","2024-06-23",0,0,10,0,0,10,0,0
"Austria","2024-06-24",0,0,10,0,1,11,0,0
"Austria","2024-06-25",0,0,10,0,0,11,0,0
"Austria","2024-06-26",0,0,10,0,0,11,0,0
"Austria","2024-06-27",0,0,10,0,0,11,0,0
"Austria","2024-06-28",0,0,10,0,0,11,0,0
"Austria","2024-06-29",0,0,10,0,0,11,0,0
"Austria","2024-06-30",0,0,10,0,0,11,0,0
"Austria","2024-07-01",0,0,10,0,0,11,0,0
"Austria","2024-07-02",0,0,10,0,0,11,0,0
"Austria","2024-07-03",0,0,10,0,0,11,0,0
"Austria","2024-07-04",0,0,10,0,0,11,0,0
"Austria","2024-07-05",0,0,10,0,0,11,0,0
"Austria","2024-07-06",0,0,10,0,0,11,0,0
"Austria","2024-07-07",0,0,10,0,0,11,0,0
"Austria","2024-07-08",0,0,10,0,0,11,0,0
"Austria","2024-07-09",0,0,10,0,0,11,0,0
"Austria","2024-07-10",0,0,10,0,0,11,0,0
"Austria","2024-07-11",0,0,10,0,0,11,0,0
"Austria","2024-07-12",0,0,10,0,0,11,0,0
"Austria","2024-07-13",0,0,10,0,0,11,0,0
"Austria","2024-07-14",0,0,10,0,0,11,0,0
"Austria","2024-07-15",0,0,10,0,0,11,0,0
"Austria","2024-07-16",0,0,10,0,0,11,0,0
"Austria","2024-07-17",0,0,10,0,0,11,0,0
"Austria","2024-07-18",0,0,10,0,0,11,0,0
"Austria","2024-07-19",0,0,10,0,0,11,0,0
"Austria","2024-07-20",0,0,10,0,0,11,0,0
"Austria","2024-07-21",0,0,10,0,0,11,0,0
"Austria","2024-07-22",0,0,10,0,0,11,0,0
"Austria","2024-07-23",0,0,10,0,0,11,0,0
"Austria","2024-07-24",0,0,10,0,0,11,0,0
"Austria","2024-07-25",0,0,10,0,0,11,0,0
"Austria","2024-07-26",0,0,10,0,0,11,0,0
"Austria","2024-07-27",0,0,10,0,0,11,0,0
"Austria","2024-07-28",0,0,10,0,0,11,0,0
"Austria","2024-07-29",0,0,10,0,0,11,0,0
"Austria","2024-07-30",0,0,10,0,0,11,0,0
"Austria","2024-07-31",0,0,10,0,0,11,0,0
"Austria","2024-08-01",0,0,10,0,0,11,0,0
"Austria","2024-08-02",0,0,10,0,0,11,0,0
"Austria","2024-08-03",0,0,10,0,0,11,0,0
"Austria","2024-08-04",0,0,10,0,0,11,0,0
"Austria","2024-08-05",0,0,10,0,0,11,0,0
"Austria","2024-08-06",0,0,10,0,0,11,0,0
"Austria","2024-08-07",0,0,10,0,0,11,0,0
"Austria","2024-08-08",0,0,10,0,1,12,0,0
"Austria","2024-08-09",0,0,10,0,0,12,0,0
"Austria","2024-08-10",0,0,10,0,0,12,0,0
"Austria","2024-08-11",0,0,10,0,0,12,0,0
"Austria","2024-08-12",0,0,10,0,0,12,0,0
"Austria","2024-08-13",0,0,10,0,0,12,0,0
"Austria","2024-08-14",0,0,10,0,0,12,0,0
"Austria","2024-08-15",0,0,10,0,0,12,0,0
"Austria","2024-08-16",0,0,10,0,0,12,0,0
"Austria","2024-08-17",0,0,10,0,0,12,0,0
"Austria","2024-08-18",0,0,10,0,0,12,0,0
"Austria","2024-08-19",0,0,10,0,0,12,0,0
"Austria","2024-08-20",0,0,10,0,0,12,0,0
"Austria","2024-08-21",0,0,10,0,0,12,0,0
"Austria","2024-08-22",0,0,10,0,0,12,0,0
"Austria","2024-08-23",0,0,10,0,0,12,0,0
"Austria","2024-08-24",0,0,10,0,0,12,0,0
"Austria","2024-08-25",0,0,10,0,0,12,0,0
"Austria","2024-08-26",0,0,10,0,0,12,0,0
"Austria","2024-08-27",0,0,10,0,0,12,0,0
"Austria","2024-08-28",0,0,10,0,0,12,0,0
"Austria","2024-08-29",0,0,10,0,0,12,0,0
"Austria","2024-08-30",0,0,10,0,0,12,0,0
"Austria","2024-08-31",0,2,12,0,0,12,0,0
"Austria","2024-09-01",0,0,12,0,0,12,0,0
"Austria","2024-09-02",0,0,12,0,0,12,0,0
"Austria","2024-09-03",0,0,12,0,0,12,0,0
"Austria","2024-09-04",0,0,12,0,0,12,0,0
"Austria","2024-09-05",0,0,12,0,0,12,0,0
"Austria","2024-09-06",0,0,12,0,1,13,0,0
"Austria","2024-09-07",0,0,12,0,0,13,0,0
"Austria","2024-09-08",0,0,12,0,0,13,0,0
"Austria","2024-09-09",0,0,12,0,0,13,0,0
"Austria","2024-09-10",0,0,12,0,0,13,0,0
"Austria","2024-09-11",0,0,12,0,0,13,0,0
"Austria","2024-09-12",0,0,12,0,0,13,0,0
"Austria","2024-09-13",0,0,12,0,0,13,0,0
"Austria","2024-09-14",0,0,12,0,0,13,0,0
"Austria","2024-09-15",0,0,12,0,1,14,0,0
"Austria","2024-09-16",0,0,12,0,0,14,0,0
"Austria","2024-09-17",0,0,12,0,0,14,0,0
"Austria","2024-09-18",0,0,12,0,0,14,0,0
"Austria","2024-09-19",0,0,12,0,0,14,0,0
"Austria","2024-09-20",0,0,12,0,0,14,0,0
"Austria","2024-09-21",0,0,12,0,0,14,0,0
"Austria","2024-09-22",0,0,12,0,0,14,0,0
"Austria","2024-09-23",0,0,12,0,0,14,0,0
"Austria","2024-09-24",0,0,12,0,0,14,0,0
"Austria","2024-09-25",0,0,12,0,0,14,0,0
"Austria","2024-09-26",0,0,12,0,1,15,0,0
"Austria","2024-09-27",0,0,12,0,0,15,0,0
"Austria","2024-09-28",0,0,12,0,0,15,0,0
"Austria","2024-09-29",0,0,12,0,0,15,0,0
"Austria","2024-09-30",0,3,15,0,0,15,0,0
"Austria","2024-10-01",0,0,15,0,0,15,0,0
"Austria","2024-10-02",0,0,15,0,0,15,0,0
"Austria","2024-10-03",0,0,15,0,0,15,0,0
"Austria","2024-10-04",0,0,15,0,0,15,0,0
"Austria","2024-10-05",0,0,15,0,0,15,0,0
"Austria","2024-10-06",0,0,15,0,1,16,0,0
"Austria","2024-10-07",0,0,15,0,0,16,0,0
"Austria","2024-10-08",0,0,15,0,0,16,0,0
"Austria","2024-10-09",0,0,15,0,0,16,0,0
"Austria","2024-10-10",0,0,15,0,0,16,0,0
"Austria","2024-10-11",0,0,15,0,0,16,0,0
"Austria","2024-10-12",0,0,15,0,0,16,0,0
"Austria","2024-10-13",0,0,15,0,0,16,0,0
"Austria","2024-10-14",0,0,15,0,0,16,0,0
"Austria","2024-10-15",0,0,15,0,0,16,0,0
"Austria","2024-10-16",0,0,15,0,1,17,0,0
"Austria","2024-10-17",0,0,15,0,0,17,0,0
"Austria","2024-10-18",0,0,15,0,0,17,0,0
"Austria","2024-10-19",0,0,15,0,0,17,0,0
"Austria","2024-10-20",0,0,15,0,0,17,0,0
"Austria","2024-10-21",0,0,15,0,0,17,0,0
"Austria","2024-10-22",0,0,15,0,0,17,0,0
"Austria","2024-10-23",0,0,15,0,0,17,0,0
"Austria","2024-10-24",0,0,15,0,0,17,0,0
"Austria","2024-10-25",0,0,15,0,0,17,0,0
"Austria","2024-10-26",0,0,15,0,1,18,0,0
"Austria","2024-10-27",0,0,15,0,0,18,0,0
"Austria","2024-10-28",0,0,15,0,0,18,0,0
"Austria","2024-10-29",0,0,15,0,0,18,0,0
"Austria","2024-10-30",0,0,15,0,0,18,0,0
"Austria","2024-10-31",0,3,18,0,0,18,0,0
"Austria","2024-11-01",0,0,18,0,0,18,0,0
"Austria","2024-11-02",0,0,18,0,0,18,0,0
"Austria","2024-11-03",0,0,18,0,1,19,0,0
"Austria","2024-11-04",0,0,18,0,0,19,0,0
"Austria","2024-11-05",0,0,18,0,0,19,0,0
"Austria","2024-11-06",0,0,18,0,0,19,0,0
"Austria","2024-11-07",0,0,18,0,1,20,0,0
"Austria","2024-11-08",0,0,18,0,0,20,0,0
"Austria","2024-11-09",0,0,18,0,0,20,0,0
"Austria","2024-11-10",0,0,18,0,0,20,0,0
"Austria","2024-11-11",0,0,18,0,1,21,0,0
"Austria","2024-11-12",0,0,18,0,0,21,0,0
"Austria","2024-11-13",0,0,18,0,0,21,0,0
"Austria","2024-11-14",0,0,18,0,0,21,0,0
"Austria","2024-11-15",0,0,18,0,1,22,0,0
"Austria","2024-11-16",0,0,18,0,0,22,0,0
"Austria","2024-11-17",0,0,18,0,0,22,0,0
"Austria","2024-11-18",0,0,18,0,0,22,0,0
"Austria","2024-11-19",0,0,18,0,0,22,0,0
"Austria","2024-11-20",0,0,18,0,1,23,0,0
"Austria","2024-11-21",0,0,18,0,0,23,0,0
"Austria","2024-11-22",0,0,18,0,0,23,0,0
"Austria","2024-11-23",0,0,18,0,0,23,0,0
"Austria","2024-11-24",0,0,18,0,1,24,0,0
"Austria","2024-11-25",0,0,18,0,0,24,0,0
"Austria","2024-11-26",0,0,18,0,0,24,0,0
"Austria","2024-11-27",0,0,18,0,0,24,0,0
"Austria","2024-11-28",0,0,18,0,1,25,0,0
"Austria","2024-11-29",0,0,18,0,0,25,0,0
"Austria","2024-11-30",0,7,25,0,0,25,0,0
"Austria","2024-12-01",0,0,25,0,0,25,0,0
"Austria","2024-12-02",0,0,25,0,0,25,0,0
"Austria","2024-12-03",0,0,25,0,0,25,0,0
"Austria","2024-12-04",0,0,25,0,1,26,0,0
"Austria","2024-12-05",0,0,25,0,0,26,0,0
"Austria","2024-12-06",0,0,25,0,0,26,0,0
"Austria","2024-12-07",0,0,25,0,0,26,0,0
"Austria","2024-12-08",0,0,25,0,0,26,0,0
"Austria","2024-12-09",0,0,25,0,0,26,0,0
"Austria","2024-12-10",0,0,25,0,0,26,0,0
"Austria","2024-12-11",0,0,25,0,0,26,0,0
"Austria","2024-12-12",0,0,25,0,1,27,0,0
"Austria","2024-12-13",0,0,25,0,0,27,0,0
"Austria","2024-12-14",0,0,25,0,0,27,0,0
"Austria","2024-12-15",0,0,25,0,0,27,0,0
"Austria","2024-12-16",0,0,25,0,0,27,0,0
"Austria","2024-12-17",0,0,25,0,0,27,0,0
"Austria","2024-12-18",0,0,25,0,0,27,0,0
"Austria","2024-12-19",0,0,25,0,0,27,0,0
"Austria","2024-12-20",0,0,25,0,1,28,0,0
"Austria","2024-12-21",0,0,25,0,0,28,0,0
"Austria","2024-12-22",0,0,25,0,0,28,0,0
"Austria","2024-12-23",0,0,25,0,0,28,0,0
"Austria","2024-12-24",0,0,25,0,0,28,0,0
"Austria","2024-12-25",0,0,25,0,0,28,0,0
"Austria","2024-12-26",0,0,25,0,0,28,0,0
"Austria","2024-12-27",0,0,25,0,0,28,0,0
"Austria","2024-12-28",0,0,25,0,1,29,0,0
"Austria","2024-12-29",0,0,25,0,0,29,0,0
"Austria","2024-12-30",0,0,25,0,0,29,0,0
"Austria","2024-12-31",0,4,29,0,0,29,0,0
"Austria","2025-01-01",0,0,29,0,0,29,0,0
"Austria","2025-01-02",0,0,29,0,0,29,0,0
"Austria","2025-01-03",0,0,29,0,0,29,0,0
"Austria","2025-01-04",0,0,29,0,0,29,0,0
"Austria","2025-01-05",0,0,29,0,0,29,0,0
"Austria","2025-01-06",0,0,29,0,1,30,0,0
"Austria","2025-01-07",0,0,29,0,0,30,0,0
"Austria","2025-01-08",0,0,29,0,0,30,0,0
"Austria","2025-01-09",0,0,29,0,0,30,0,0
"Austria","2025-01-10",0,1,30,0,0,30,0,0
"Austria","2025-01-11",0,0,30,0,0,30,0,0
"Austria","2025-01-12",0,0,30,0,0,30,0,0
"Austria","2025-01-13",0,0,30,0,0,30,0,0
"Austria","2025-01-14",0,0,30,0,0,30,0,0
"Austria","2025-01-15",0,0,30,0,0,30,0,0
"Austria","2025-01-16",0,0,30,0,0,30,0,0
"Austria","2025-01-17",0,0,30,0,0,30,0,0
"Austria","2025-01-18",0,0,30,0,0,30,0,0
"Austria","2025-01-19",0,0,30,0,0,30,0,0
"Austria","2025-01-20",0,0,30,0,0,30,0,0
"Austria","2025-01-21",0,0,30,0,0,30,0,0
"Austria","2025-01-22",0,0,30,0,0,30,0,0
"Austria","2025-01-23",0,0,30,0,0,30,0,0
"Austria","2025-01-24",0,0,30,0,0,30,0,0
"Austria","2025-01-25",0,0,30,0,0,30,0,0
"Austria","2025-01-26",0,0,30,0,0,30,0,0
"Austria","2025-01-27",0,0,30,0,0,30,0,0
"Austria","2025-01-28",0,0,30,0,0,30,0,0
"Austria","2025-01-29",0,0,30,0,0,30,0,0
"Austria","2025-01-30",0,0,30,0,0,30,0,0
"Austria","2025-01-31",0,0,30,0,0,30,0,0
"Austria","2025-02-01",0,0,30,0,0,30,0,0
"Austria","2025-02-02",0,0,30,0,0,30,0,0
"Austria","2025-02-03",0,0,30,0,0,30,0,0
"Austria","2025-02-04",0,0,30,0,0,30,0,0
"Austria","2025-02-05",0,0,30,0,0,30,0,0
"Austria","2025-02-06",0,0,30,0,0,30,0,0
"Austria","2025-02-07",0,0,30,0,0,30,0,0
"Austria","2025-02-08",0,0,30,0,0,30,0,0
"Austria","2025-02-09",0,0,30,0,0,30,0,0
"Austria","2025-02-10",0,0,30,0,0,30,0,0
"Austria","2025-02-11",0,0,30,0,0,30,0,0
"Austria","2025-02-12",0,0,30,0,0,30,0,0
"Austria","2025-02-13",0,0,30,0,0,30,0,0
"Austria","2025-02-14",0,0,30,0,0,30,0,0
"Austria","2025-02-15",0,0,30,0,0,30,0,0
"Austria","2025-02-16",0,0,30,0,0,30,0,0
"Austria","2025-02-17",0,0,30,0,0,30,0,0
"Austria","2025-02-18",0,0,30,0,0,30,0,0
"Austria","2025-02-19",0,0,30,0,0,30,0,0
"Austria","2025-02-20",0,0,30,0,0,30,0,0
"Austria","2025-02-21",0,0,30,0,0,30,0,0
"Austria","2025-02-22",0,0,30,0,0,30,0,0
"Austria","2025-02-23",0,0,30,0,0,30,0,0
"Austria","2025-02-24",0,0,30,0,0,30,0,0
"Austria","2025-02-25",0,0,30,0,0,30,0,0
"Austria","2025-02-26",0,0,30,0,0,30,0,0
"Austria","2025-02-27",0,0,30,0,0,30,0,0
"Austria","2025-02-28",0,0,30,0,0,30,0,0
"Austria","2025-03-01",0,0,30,0,0,30,0,0
"Austria","2025-03-02",0,0,30,0,0,30,0,0
"Austria","2025-03-03",0,0,30,0,0,30,0,0
"Azerbaijan","2024-01-01",0,0,0,0,0,0,0,0
"Azerbaijan","2024-01-02",0,0,0,0,0,0,0,0
"Azerbaijan","2024-01-03",0,0,0,0,0,0,0,0
"Azerbaijan","2024-01-04",0,0,0,0,0,0,0,0
"Azerbaijan","2024-01-05",0,0,0,0,0,0,0,0
"Azerbaijan","2024-01-06",0,0,0,0,0,0,0,0
"Azerbaijan","2024-01-07",0,0,0,0,0,0,0,0
"Azerbaijan","2024-01-08",0,0,0,0,0,0,0,0
"Azerbaijan","2024-01-09",0,0,0,0,0,0,0,0
"Azerbaijan","2024-01-10",0,0,0,0,0,0,0,0
"Azerbaijan","2024-01-11",0,0,0,0,0,0,0,0
"Azerbaijan","2024-01-12",0,0,0,0,0,0,0,0
"Azerbaijan","2024-01-13",0,0,0,0,0,0,0,0
"Azerbaijan","2024-01-14",0,0,0,0,0,0,0,0
"Azerbaijan","2024-01-15",0,0,0,0,0,0,0,0
"Azerbaijan","2024-01-16",0,0,0,0,0,0,0,0
"Azerbaijan","2024-01-17",0,0,0,0,0,0,0,0
"Azerbaijan","2024-01-18",0,0,0,0,0,0,0,0
"Azerbaijan","2024-01-19",0,0,0,0,0,0,0,0
"Azerbaijan","2024-01-20",0,0,0,0,0,0,0,0
"Azerbaijan","2024-01-21",0,0,0,0,0,0,0,0
"Azerbaijan","2024-01-22",0,0,0,0,0,0,0,0
"Azerbaijan","2024-01-23",0,0,0,0,0,0,0,0
"Azerbaijan","2024-01-24",0,0,0,0,0,0,0,0
"Azerbaijan","2024-01-25",0,0,0,0,0,0,0,0
"Azerbaijan","2024-01-26",0,0,0,0,0,0,0,0
"Azerbaijan","2024-01-27",0,0,0,0,0,0,0,0
"Azerbaijan","2024-01-28",0,0,0,0,0,0,0,0
"Azerbaijan","2024-01-29",0,0,0,0,0,0,0,0
"Azerbaijan","2024-01-30",0,0,0,0,0,0,0,0
"Azerbaijan","2024-01-31",0,0,0,0,0,0,0,0
"Azerbaijan","2024-02-01",0,0,0,0,0,0,0,0
"Azerbaijan","2024-02-02",0,0,0,0,0,0,0,0
"Azerbaijan","2024-02-03",0,0,0,0,0,0,0,0
"Azerbaijan","2024-02-04",0,0,0,0,0,0,0,0
"Azerbaijan","2024-02-05",0,0,0,0,0,0,0,0
"Azerbaijan","2024-02-06",0,0,0,0,0,0,0,0
"Azerbaijan","2024-02-07",0,0,0,0,0,0,0,0
"Azerbaijan","2024-02-08",0,0,0,0,0,0,0,0
"Azerbaijan","2024-02-09",0,0,0,0,0,0,0,0
"Azerbaijan","2024-02-10",0,0,0,0,0,0,0,0
"Azerbaijan","2024-02-11",0,0,0,0,0,0,0,0
"Azerbaijan","2024-02-12",0,0,0,0,0,0,0,0
"Azerbaijan","2024-02-13",0,0,0,0,0,0,0,0
"Azerbaijan","2024-02-14",0,0,0,0,0,0,0,0
"Azerbaijan","2024-02-15",0,0,0,0,0,0,0,0
"Azerbaijan","2024-02-16",0,0,0,0,0,0,0,0
"Azerbaijan","2024-02-17",0,0,0,0,0,0,0,0
"Azerbaijan","2024-02-18",0,0,0,0,0,0,0,0
"Azerbaijan","2024-02-19",0,0,0,0,0,0,0,0
"Azerbaijan","2024-02-20",0,0,0,0,0,0,0,0
"Azerbaijan","2024-02-21",0,0,0,0,0,0,0,0
"Azerbaijan","2024-02-22",0,0,0,0,0,0,0,0
"Azerbaijan","2024-02-23",0,0,0,0,0,0,0,0
"Azerbaijan","2024-02-24",0,0,0,0,0,0,0,0
"Azerbaijan","2024-02-25",0,0,0,0,0,0,0,0
"Azerbaijan","2024-02-26",0,0,0,0,0,0,0,0
"Azerbaijan","2024-02-27",0,0,0,0,0,0,0,0
"Azerbaijan","2024-02-28",0,0,0,0,0,0,0,0
"Azerbaijan","2024-02-29",0,0,0,0,0,0,0,0
"Azerbaijan","2024-03-01",0,0,0,0,0,0,0,0
"Azerbaijan","2024-03-02",0,0,0,0,0,0,0,0
"Azerbaijan","2024-03-03",0,0,0,0,0,0,0,0
"Azerbaijan","2024-03-04",0,0,0,0,0,0,0,0
"Azerbaijan","2024-03-05",0,0,0,0,0,0,0,0
"Azerbaijan","2024-03-06",0,0,0,0,0,0,0,0
"Azerbaijan","2024-03-07",0,0,0,0,0,0,0,0
"Azerbaijan","2024-03-08",0,0,0,0,0,0,0,0
"Azerbaijan","2024-03-09",0,0,0,0,0,0,0,0
"Azerbaijan","2024-03-10",0,0,0,0,0,0,0,0
"Azerbaijan","2024-03-11",0,0,0,0,0,0,0,0
"Azerbaijan","2024-03-12",0,0,0,0,0,0,0,0
"Azerbaijan","2024-03-13",0,0,0,0,0,0,0,0
"Azerbaijan","2024-03-14",0,0,0,0,0,0,0,0
"Azerbaijan","2024-03-15",0,0,0,0,0,0,0,0
"Azerbaijan","2024-03-16",0,0,0,0,0,0,0,0
"Azerbaijan","2024-03-17",0,0,0,0,0,0,0,0
"Azerbaijan","2024-03-18",0,0,0,0,0,0,0,0
"Azerbaijan","2024-03-19",0,0,0,0,0,0,0,0
"Azerbaijan","2024-03-20",0,0,0,0,0,0,0,0
"Azerbaijan","2024-03-21",0,0,0,0,0,0,0,0
"Azerbaijan","2024-03-22",0,0,0,0,0,0,0,0
"Azerbaijan","2024-03-23",0,0,0,0,0,0,0,0
"Azerbaijan","2024-03-24",0,0,0,0,0,0,0,0
"Azerbaijan","2024-03-25",0,0,0,0,0,0,0,0
"Azerbaijan","2024-03-26",0,0,0,0,0,0,0,0
"Azerbaijan","2024-03-27",0,0,0,0,0,0,0,0
"Azerbaijan","2024-03-28",0,0,0,0,0,0,0,0
"Azerbaijan","2024-03-29",0,0,0,0,0,0,0,0
"Azerbaijan","2024-03-30",0,0,0,0,0,0,0,0
"Azerbaijan","2024-03-31",0,0,0,0,0,0,0,0
"Azerbaijan","2024-04-01",0,0,0,0,0,0,0,0
"Azerbaijan","2024-04-02",0,0,0,0,0,0,0,0
"Azerbaijan","2024-04-03",0,0,0,0,0,0,0,0
"Azerbaijan","2024-04-04",0,0,0,0,0,0,0,0
"Azerbaijan","2024-04-05",0,0,0,0,0,0,0,0
"Azerbaijan","2024-04-06",0,0,0,0,0,0,0,0
"Azerbaijan","2024-04-07",0,0,0,0,0,0,0,0
"Azerbaijan","2024-04-08",0,0,0,0,0,0,0,0
"Azerbaijan","2024-04-09",0,0,0,0,0,0,0,0
"Azerbaijan","2024-04-10",0,0,0,0,0,0,0,0
"Azerbaijan","2024-04-11",0,0,0,0,0,0,0,0
"Azerbaijan","2024-04-12",0,0,0,0,0,0,0,0
"Azerbaijan","2024-04-13",0,0,0,0,0,0,0,0
"Azerbaijan","2024-04-14",0,0,0,0,0,0,0,0
"Azerbaijan","2024-04-15",0,0,0,0,0,0,0,0
"Azerbaijan","2024-04-16",0,0,0,0,0,0,0,0
"Azerbaijan","2024-04-17",0,0,0,0,0,0,0,0
"Azerbaijan","2024-04-18",0,0,0,0,0,0,0,0
"Azerbaijan","2024-04-19",0,0,0,0,0,0,0,0
"Azerbaijan","2024-04-20",0,0,0,0,0,0,0,0
"Azerbaijan","2024-04-21",0,0,0,0,0,0,0,0
"Azerbaijan","2024-04-22",0,0,0,0,0,0,0,0
"Azerbaijan","2024-04-23",0,0,0,0,0,0,0,0
"Azerbaijan","2024-04-24",0,0,0,0,0,0,0,0
"Azerbaijan","2024-04-25",0,0,0,0,0,0,0,0
"Azerbaijan","2024-04-26",0,0,0,0,0,0,0,0
"Azerbaijan","2024-04-27",0,0,0,0,0,0,0,0
"Azerbaijan","2024-04-28",0,0,0,0,0,0,0,0
"Azerbaijan","2024-04-29",0,0,0,0,0,0,0,0
"Azerbaijan","2024-04-30",0,0,0,0,0,0,0,0
"Azerbaijan","2024-05-01",0,0,0,0,0,0,0,0
"Azerbaijan","2024-05-02",0,0,0,0,0,0,0,0
"Azerbaijan","2024-05-03",0,0,0,0,0,0,0,0
"Azerbaijan","2024-05-04",0,0,0,0,0,0,0,0
"Azerbaijan","2024-05-05",0,0,0,0,0,0,0,0
"Azerbaijan","2024-05-06",0,0,0,0,0,0,0,0
"Azerbaijan","2024-05-07",0,0,0,0,0,0,0,0
"Azerbaijan","2024-05-08",0,0,0,0,0,0,0,0
"Azerbaijan","2024-05-09",0,0,0,0,0,0,0,0
"Azerbaijan","2024-05-10",0,0,0,0,0,0,0,0
"Azerbaijan","2024-05-11",0,0,0,0,0,0,0,0
"Azerbaijan","2024-05-12",0,0,0,0,0,0,0,0
"Azerbaijan","2024-05-13",0,0,0,0,0,0,0,0
"Azerbaijan","2024-05-14",0,0,0,0,0,0,0,0
"Azerbaijan","2024-05-15",0,0,0,0,0,0,0,0
"Azerbaijan","2024-05-16",0,0,0,0,0,0,0,0
"Azerbaijan","2024-05-17",0,0,0,0,0,0,0,0
"Azerbaijan","2024-05-18",0,0,0,0,0,0,0,0
"Azerbaijan","2024-05-19",0,0,0,0,0,0,0,0
"Azerbaijan","2024-05-20",0,0,0,0,0,0,0,0
"Azerbaijan","2024-05-21",0,0,0,0,0,0,0,0
"Azerbaijan","2024-05-22",0,0,0,0,0,0,0,0
"Azerbaijan","2024-05-23",0,0,0,0,0,0,0,0
"Azerbaijan","2024-05-24",0,0,0,0,0,0,0,0
"Azerbaijan","2024-05-25",0,0,0,0,0,0,0,0
"Azerbaijan","2024-05-26",0,0,0,0,0,0,0,0
"Azerbaijan","2024-05-27",0,0,0,0,0,0,0,0
"Azerbaijan","2024-05-28",0,0,0,0,0,0,0,0
"Azerbaijan","2024-05-29",0,0,0,0,0,0,0,0
"Azerbaijan","2024-05-30",0,0,0,0,0,0,0,0
"Azerbaijan","2024-05-31",0,0,0,0,0,0,0,0
"Azerbaijan","2024-06-01",0,0,0,0,0,0,0,0
"Azerbaijan","2024-06-02",0,0,0,0,0,0,0,0
"Azerbaijan","2024-06-03",0,0,0,0,0,0,0,0
"Azerbaijan","2024-06-04",0,0,0,0,0,0,0,0
"Azerbaijan","2024-06-05",0,0,0,0,0,0,0,0
"Azerbaijan","2024-06-06",0,0,0,0,0,0,0,0
"Azerbaijan","2024-06-07",0,0,0,0,0,0,0,0
"Azerbaijan","2024-06-08",0,0,0,0,0,0,0,0
"Azerbaijan","2024-06-09",0,0,0,0,0,0,0,0
"Azerbaijan","2024-06-10",0,0,0,0,0,0,0,0
"Azerbaijan","2024-06-11",0,0,0,0,0,0,0,0
"Azerbaijan","2024-06-12",0,0,0,0,0,0,0,0
"Azerbaijan","2024-06-13",0,0,0,0,0,0,0,0
"Azerbaijan","2024-06-14",0,0,0,0,0,0,0,0
"Azerbaijan","2024-06-15",0,0,0,0,0,0,0,0
"Azerbaijan","2024-06-16",0,0,0,0,0,0,0,0
"Azerbaijan","2024-06-17",0,0,0,0,0,0,0,0
"Azerbaijan","2024-06-18",0,0,0,0,0,0,0,0
"Azerbaijan","2024-06-19",0,0,0,0,0,0,0,0
"Azerbaijan","2024-06-20",0,0,0,0,0,0,0,0
"Azerbaijan","2024-06-21",0,0,0,0,0,0,0,0
"Azerbaijan","2024-06-22",0,0,0,0,0,0,0,0
"Azerbaijan","2024-06-23",0,0,0,0,0,0,0,0
"Azerbaijan","2024-06-24",0,0,0,0,0,0,0,0
"Azerbaijan","2024-06-25",0,0,0,0,0,0,0,0
"Azerbaijan","2024-06-26",0,0,0,0,0,0,0,0
"Azerbaijan","2024-06-27",0,0,0,0,0,0,0,0
"Azerbaijan","2024-06-28",0,0,0,0,0,0,0,0
"Azerbaijan","2024-06-29",0,0,0,0,0,0,0,0
"Azerbaijan","2024-06-30",0,0,0,0,0,0,0,0
"Azerbaijan","2024-07-01",0,0,0,0,0,0,0,0
"Azerbaijan","2024-07-02",0,0,0,0,0,0,0,0
"Azerbaijan","2024-07-03",0,0,0,0,0,0,0,0
"Azerbaijan","2024-07-04",0,0,0,0,0,0,0,0
"Azerbaijan","2024-07-05",0,0,0,0,0,0,0,0
"Azerbaijan","2024-07-06",0,0,0,0,0,0,0,0
"Azerbaijan","2024-07-07",0,0,0,0,0,0,0,0
"Azerbaijan","2024-07-08",0,0,0,0,0,0,0,0
"Azerbaijan","2024-07-09",0,0,0,0,0,0,0,0
"Azerbaijan","2024-07-10",0,0,0,0,0,0,0,0
"Azerbaijan","2024-07-11",0,0,0,0,0,0,0,0
"Azerbaijan","2024-07-12",0,0,0,0,0,0,0,0
"Azerbaijan","2024-07-13",0,0,0,0,0,0,0,0
"Azerbaijan","2024-07-14",0,0,0,0,0,0,0,0
"Azerbaijan","2024-07-15",0,0,0,0,0,0,0,0
"Azerbaijan","2024-07-16",0,0,0,0,0,0,0,0
"Azerbaijan","2024-07-17",0,0,0,0,0,0,0,0
"Azerbaijan","2024-07-18",0,0,0,0,0,0,0,0
"Azerbaijan","2024-07-19",0,0,0,0,0,0,0,0
"Azerbaijan","2024-07-20",0,0,0,0,0,0,0,0
"Azerbaijan","2024-07-21",0,0,0,0,0,0,0,0
"Azerbaijan","2024-07-22",0,0,0,0,0,0,0,0
"Azerbaijan","2024-07-23",0,0,0,0,0,0,0,0
"Azerbaijan","2024-07-24",0,0,0,0,0,0,0,0
"Azerbaijan","2024-07-25",0,0,0,0,0,0,0,0
"Azerbaijan","2024-07-26",0,0,0,0,0,0,0,0
"Azerbaijan","2024-07-27",0,0,0,0,0,0,0,0
"Azerbaijan","2024-07-28",0,0,0,0,0,0,0,0
"Azerbaijan","2024-07-29",0,0,0,0,0,0,0,0
"Azerbaijan","2024-07-30",0,0,0,0,0,0,0,0
"Azerbaijan","2024-07-31",0,0,0,0,0,0,0,0
"Azerbaijan","2024-08-01",0,0,0,0,0,0,0,0
"Azerbaijan","2024-08-02",0,0,0,0,0,0,0,0
"Azerbaijan","2024-08-03",0,0,0,0,0,0,0,0
"Azerbaijan","2024-08-04",0,0,0,0,0,0,0,0
"Azerbaijan","2024-08-05",0,0,0,0,0,0,0,0
"Azerbaijan","2024-08-06",0,0,0,0,0,0,0,0
"Azerbaijan","2024-08-07",0,0,0,0,0,0,0,0
"Azerbaijan","2024-08-08",0,0,0,0,0,0,0,0
"Azerbaijan","2024-08-09",0,0,0,0,0,0,0,0
"Azerbaijan","2024-08-10",0,0,0,0,0,0,0,0
"Azerbaijan","2024-08-11",0,0,0,0,0,0,0,0
"Azerbaijan","2024-08-12",0,0,0,0,0,0,0,0
"Azerbaijan","2024-08-13",0,0,0,0,0,0,0,0
"Azerbaijan","2024-08-14",0,0,0,0,0,0,0,0
"Azerbaijan","2024-08-15",0,0,0,0,0,0,0,0
"Azerbaijan","2024-08-16",0,0,0,0,0,0,0,0
"Azerbaijan","2024-08-17",0,0,0,0,0,0,0,0
"Azerbaijan","2024-08-18",0,0,0,0,0,0,0,0
"Azerbaijan","2024-08-19",0,0,0,0,0,0,0,0
"Azerbaijan","2024-08-20",0,0,0,0,0,0,0,0
"Azerbaijan","2024-08-21",0,0,0,0,0,0,0,0
"Azerbaijan","2024-08-22",0,0,0,0,0,0,0,0
"Azerbaijan","2024-08-23",0,0,0,0,0,0,0,0
"Azerbaijan","2024-08-24",0,0,0,0,0,0,0,0
"Azerbaijan","2024-08-25",0,0,0,0,0,0,0,0
"Azerbaijan","2024-08-26",0,0,0,0,0,0,0,0
"Azerbaijan","2024-08-27",0,0,0,0,0,0,0,0
"Azerbaijan","2024-08-28",0,0,0,0,0,0,0,0
"Azerbaijan","2024-08-29",0,0,0,0,0,0,0,0
"Azerbaijan","2024-08-30",0,0,0,0,0,0,0,0
"Azerbaijan","2024-08-31",0,0,0,0,0,0,0,0
"Azerbaijan","2024-09-01",0,0,0,0,0,0,0,0
"Azerbaijan","2024-09-02",0,0,0,0,0,0,0,0
"Azerbaijan","2024-09-03",0,0,0,0,0,0,0,0
"Azerbaijan","2024-09-04",0,0,0,0,0,0,0,0
"Azerbaijan","2024-09-05",0,0,0,0,0,0,0,0
"Azerbaijan","2024-09-06",0,0,0,0,0,0,0,0
"Azerbaijan","2024-09-07",0,0,0,0,0,0,0,0
"Azerbaijan","2024-09-08",0,0,0,0,0,0,0,0
"Azerbaijan","2024-09-09",0,0,0,0,0,0,0,0
"Azerbaijan","2024-09-10",0,0,0,0,0,0,0,0
"Azerbaijan","2024-09-11",0,0,0,0,0,0,0,0
"Azerbaijan","2024-09-12",0,0,0,0,0,0,0,0
"Azerbaijan","2024-09-13",0,0,0,0,0,0,0,0
"Azerbaijan","2024-09-14",0,0,0,0,0,0,0,0
"Azerbaijan","2024-09-15",0,0,0,0,0,0,0,0
"Azerbaijan","2024-09-16",0,0,0,0,0,0,0,0
"Azerbaijan","2024-09-17",0,0,0,0,0,0,0,0
"Azerbaijan","2024-09-18",0,0,0,0,0,0,0,0
"Azerbaijan","2024-09-19",0,0,0,0,0,0,0,0
"Azerbaijan","2024-09-20",0,0,0,0,0,0,0,0
"Azerbaijan","2024-09-21",0,0,0,0,0,0,0,0
"Azerbaijan","2024-09-22",0,0,0,0,0,0,0,0
"Azerbaijan","2024-09-23",0,0,0,0,0,0,0,0
"Azerbaijan","2024-09-24",0,0,0,0,0,0,0,0
"Azerbaijan","2024-09-25",0,0,0,0,0,0,0,0
"Azerbaijan","2024-09-26",0,0,0,0,0,0,0,0
"Azerbaijan","2024-09-27",0,0,0,0,0,0,0,0
"Azerbaijan","2024-09-28",0,0,0,0,0,0,0,0
"Azerbaijan","2024-09-29",0,0,0,0,0,0,0,0
"Azerbaijan","2024-09-30",0,0,0,0,0,0,0,0
"Azerbaijan","2024-10-01",0,0,0,0,0,0,0,0
"Azerbaijan","2024-10-02",0,0,0,0,0,0,0,0
"Azerbaijan","2024-10-03",0,0,0,0,0,0,0,0
"Azerbaijan","2024-10-04",0,0,0,0,0,0,0,0
"Azerbaijan","2024-10-05",0,0,0,0,0,0,0,0
"Azerbaijan","2024-10-06",0,0,0,0,0,0,0,0
"Azerbaijan","2024-10-07",0,0,0,0,0,0,0,0
"Azerbaijan","2024-10-08",0,0,0,0,0,0,0,0
"Azerbaijan","2024-10-09",0,0,0,0,0,0,0,0
"Azerbaijan","2024-10-10",0,0,0,0,0,0,0,0
"Azerbaijan","2024-10-11",0,0,0,0,0,0,0,0
"Azerbaijan","2024-10-12",0,0,0,0,0,0,0,0
"Azerbaijan","2024-10-13",0,0,0,0,0,0,0,0
"Azerbaijan","2024-10-14",0,0,0,0,0,0,0,0
"Azerbaijan","2024-10-15",0,0,0,0,0,0,0,0
"Azerbaijan","2024-10-16",0,0,0,0,0,0,0,0
"Azerbaijan","2024-10-17",0,0,0,0,0,0,0,0
"Azerbaijan","2024-10-18",0,0,0,0,0,0,0,0
"Azerbaijan","2024-10-19",0,0,0,0,0,0,0,0
"Azerbaijan","2024-10-20",0,0,0,0,0,0,0,0
"Azerbaijan","2024-10-21",0,0,0,0,0,0,0,0
"Azerbaijan","2024-10-22",0,0,0,0,0,0,0,0
"Azerbaijan","2024-10-23",0,0,0,0,0,0,0,0
"Azerbaijan","2024-10-24",0,0,0,0,0,0,0,0
"Azerbaijan","2024-10-25",0,0,0,0,0,0,0,0
"Azerbaijan","2024-10-26",0,0,0,0,0,0,0,0
"Azerbaijan","2024-10-27",0,0,0,0,0,0,0,0
"Azerbaijan","2024-10-28",0,0,0,0,0,0,0,0
"Azerbaijan","2024-10-29",0,0,0,0,0,0,0,0
"Azerbaijan","2024-10-30",0,0,0,0,0,0,0,0
"Azerbaijan","2024-10-31",0,0,0,0,0,0,0,0
"Azerbaijan","2024-11-01",0,0,0,0,0,0,0,0
"Azerbaijan","2024-11-02",0,0,0,0,0,0,0,0
"Azerbaijan","2024-11-03",0,0,0,0,0,0,0,0
"Azerbaijan","2024-11-04",0,0,0,0,0,0,0,0
"Azerbaijan","2024-11-05",0,0,0,0,0,0,0,0
"Azerbaijan","2024-11-06",0,0,0,0,0,0,0,0
"Azerbaijan","2024-11-07",0,0,0,0,0,0,0,0
"Azerbaijan","2024-11-08",0,0,0,0,0,0,0,0
"Azerbaijan","2024-11-09",0,0,0,0,0,0,0,0
"Azerbaijan","2024-11-10",0,0,0,0,0,0,0,0
"Azerbaijan","2024-11-11",0,0,0,0,0,0,0,0
"Azerbaijan","2024-11-12",0,0,0,0,0,0,0,0
"Azerbaijan","2024-11-13",0,0,0,0,0,0,0,0
"Azerbaijan","2024-11-14",0,0,0,0,0,0,0,0
"Azerbaijan","2024-11-15",0,0,0,0,0,0,0,0
"Azerbaijan","2024-11-16",0,0,0,0,0,0,0,0
"Azerbaijan","2024-11-17",0,0,0,0,0,0,0,0
"Azerbaijan","2024-11-18",0,0,0,0,0,0,0,0
"Azerbaijan","2024-11-19",0,0,0,0,0,0,0,0
"Azerbaijan","2024-11-20",0,0,0,0,0,0,0,0
"Azerbaijan","2024-11-21",0,0,0,0,0,0,0,0
"Azerbaijan","2024-11-22",0,0,0,0,0,0,0,0
"Azerbaijan","2024-11-23",0,0,0,0,0,0,0,0
"Azerbaijan","2024-11-24",0,0,0,0,0,0,0,0
"Azerbaijan","2024-11-25",0,0,0,0,0,0,0,0
"Azerbaijan","2024-11-26",0,0,0,0,0,0,0,0
"Azerbaijan","2024-11-27",0,0,0,0,0,0,0,0
"Azerbaijan","2024-11-28",0,0,0,0,0,0,0,0
"Azerbaijan","2024-11-29",0,0,0,0,0,0,0,0
"Azerbaijan","2024-11-30",0,0,0,0,0,0,0,0
"Azerbaijan","2024-12-01",0,0,0,0,0,0,0,0
"Azerbaijan","2024-12-02",0,0,0,0,0,0,0,0
"Azerbaijan","2024-12-03",0,0,0,0,0,0,0,0
"Azerbaijan","2024-12-04",0,0,0,0,0,0,0,0
"Azerbaijan","2024-12-05",0,0,0,0,0,0,0,0
"Azerbaijan","2024-12-06",0,0,0,0,0,0,0,0
"Azerbaijan","2024-12-07",0,0,0,0,0,0,0,0
"Azerbaijan","2024-12-08",0,0,0,0,0,0,0,0
"Azerbaijan","2024-12-09",0,0,0,0,0,0,0,0
"Azerbaijan","2024-12-10",0,0,0,0,0,0,0,0
"Azerbaijan","2024-12-11",0,0,0,0,0,0,0,0
"Azerbaijan","2024-12-12",0,0,0,0,0,0,0,0
"Azerbaijan","2024-12-13",0,0,0,0,0,0,0,0
"Azerbaijan","2024-12-14",0,0,0,0,0,0,0,0
"Azerbaijan","2024-12-15",0,0,0,0,0,0,0,0
"Azerbaijan","2024-12-16",0,0,0,0,0,0,0,0
"Azerbaijan","2024-12-17",0,0,0,0,0,0,0,0
"Azerbaijan","2024-12-18",0,0,0,0,0,0,0,0
"Azerbaijan","2024-12-19",0,0,0,0,0,0,0,0
"Azerbaijan","2024-12-20",0,0,0,0,0,0,0,0
"Azerbaijan","2024-12-21",0,0,0,0,0,0,0,0
"Azerbaijan","2024-12-22",0,0,0,0,0,0,0,0
"Azerbaijan","2024-12-23",0,0,0,0,0,0,0,0
"Azerbaijan","2024-12-24",0,0,0,0,0,0,0,0
"Azerbaijan","2024-12-25",0,0,0,0,0,0,0,0
"Azerbaijan","2024-12-26",0,0,0,0,0,0,0,0
"Azerbaijan","2024-12-27",0,0,0,0,0,0,0,0
"Azerbaijan","2024-12-28",0,0,0,0,0,0,0,0
"Azerbaijan","2024-12-29",0,0,0,0,0,0,0,0
"Azerbaijan","2024-12-30",0,0,0,0,0,0,0,0
"Azerbaijan","2024-12-31",0,0,0,0,0,0,0,0
"Azerbaijan","2025-01-01",0,0,0,0,0,0,0,0
"Azerbaijan","2025-01-02",0,0,0,0,0,0,0,0
"Azerbaijan","2025-01-03",0,0,0,0,0,0,0,0
"Azerbaijan","2025-01-04",0,0,0,0,0,0,0,0
"Azerbaijan","2025-01-05",0,0,0,0,0,0,0,0
"Azerbaijan","2025-01-06",0,0,0,0,0,0,0,0
"Azerbaijan","2025-01-07",0,0,0,0,0,0,0,0
"Azerbaijan","2025-01-08",0,0,0,0,0,0,0,0
"Azerbaijan","2025-01-09",0,0,0,0,0,0,0,0
"Azerbaijan","2025-01-10",0,1,1,0,1,1,0,0
"Azerbaijan","2025-01-11",0,0,1,0,0,1,0,0
"Azerbaijan","2025-01-12",0,0,1,0,0,1,0,0
"Azerbaijan","2025-01-13",0,0,1,0,0,1,0,0
"Azerbaijan","2025-01-14",0,0,1,0,0,1,0,0
"Azerbaijan","2025-01-15",0,0,1,0,0,1,0,0
"Azerbaijan","2025-01-16",0,0,1,0,0,1,0,0
"Azerbaijan","2025-01-17",0,0,1,0,0,1,0,0
"Azerbaijan","2025-01-18",0,0,1,0,0,1,0,0
"Azerbaijan","2025-01-19",0,0,1,0,0,1,0,0
"Azerbaijan","2025-01-20",0,0,1,0,0,1,0,0
"Azerbaijan","2025-01-21",0,0,1,0,0,1,0,0
"Azerbaijan","2025-01-22",0,0,1,0,0,1,0,0
"Azerbaijan","2025-01-23",0,0,1,0,0,1,0,0
"Azerbaijan","2025-01-24",0,0,1,0,0,1,0,0
"Azerbaijan","2025-01-25",0,0,1,0,0,1,0,0
"Azerbaijan","2025-01-26",0,0,1,0,0,1,0,0
"Azerbaijan","2025-01-27",0,0,1,0,0,1,0,0
"Azerbaijan","2025-01-28",0,0,1,0,0,1,0,0
"Azerbaijan","2025-01-29",0,0,1,0,0,1,0,0
"Azerbaijan","2025-01-30",0,0,1,0,0,1,0,0
"Azerbaijan","2025-01-31",0,0,1,0,0,1,0,0
"Azerbaijan","2025-02-01",0,0,1,0,0,1,0,0
"Azerbaijan","2025-02-02",0,0,1,0,0,1,0,0
"Azerbaijan","2025-02-03",0,0,1,0,0,1,0,0
"Azerbaijan","2025-02-04",0,0,1,0,0,1,0,0
"Azerbaijan","2025-02-05",0,0,1,0,0,1,0,0
"Azerbaijan","2025-02-06",0,0,1,0,0,1,0,0
"Azerbaijan","2025-02-07",0,0,1,0,0,1,0,0
"Azerbaijan","2025-02-08",0,0,1,0,0,1,0,0
"Azerbaijan","2025-02-09",0,0,1,0,0,1,0,0
"Azerbaijan","2025-02-10",0,0,1,0,0,1,0,0
"Azerbaijan","2025-02-11",0,0,1,0,0,1,0,0
"Azerbaijan","2025-02-12",0,0,1,0,0,1,0,0
"Azerbaijan","2025-02-13",0,0,1,0,0,1,0,0
"Azerbaijan","2025-02-14",0,0,1,0,0,1,0,0
"Azerbaijan","2025-02-15",0,0,1,0,0,1,0,0
"Azerbaijan","2025-02-16",0,0,1,0,0,1,0,0
"Azerbaijan","2025-02-17",0,0,1,0,0,1,0,0
"Azerbaijan","2025-02-18",0,0,1,0,0,1,0,0
"Azerbaijan","2025-02-19",0,0,1,0,0,1,0,0
"Azerbaijan","2025-02-20",0,0,1,0,0,1,0,0
"Azerbaijan","2025-02-21",0,0,1,0,0,1,0,0
"Azerbaijan","2025-02-22",0,0,1,0,0,1,0,0
"Azerbaijan","2025-02-23",0,0,1,0,0,1,0,0
"Azerbaijan","2025-02-24",0,0,1,0,0,1,0,0
"Azerbaijan","2025-02-25",0,0,1,0,0,1,0,0
"Azerbaijan","2025-02-26",0,0,1,0,0,1,0,0
"Azerbaijan","2025-02-27",0,0,1,0,0,1,0,0
"Azerbaijan","2025-02-28",0,0,1,0,0,1,0,0
"Azerbaijan","2025-03-01",0,0,1,0,0,1,0,0
"Azerbaijan","2025-03-02",0,0,1,0,0,1,0,0
"Azerbaijan","2025-03-03",0,0,1,0,0,1,0,0
"Bahamas","2024-01-01",0,0,0,0,0,0,0,0
"Bahamas","2024-01-02",0,0,0,0,0,0,0,0
"Bahamas","2024-01-03",0,0,0,0,0,0,0,0
"Bahamas","2024-01-04",0,0,0,0,0,0,0,0
"Bahamas","2024-01-05",0,0,0,0,0,0,0,0
"Bahamas","2024-01-06",0,0,0,0,0,0,0,0
"Bahamas","2024-01-07",0,0,0,0,0,0,0,0
"Bahamas","2024-01-08",0,0,0,0,0,0,0,0
"Bahamas","2024-01-09",0,0,0,0,0,0,0,0
"Bahamas","2024-01-10",0,0,0,0,0,0,0,0
"Bahamas","2024-01-11",0,0,0,0,0,0,0,0
"Bahamas","2024-01-12",0,0,0,0,0,0,0,0
"Bahamas","2024-01-13",0,0,0,0,0,0,0,0
"Bahamas","2024-01-14",0,0,0,0,0,0,0,0
"Bahamas","2024-01-15",0,0,0,0,0,0,0,0
"Bahamas","2024-01-16",0,0,0,0,0,0,0,0
"Bahamas","2024-01-17",0,0,0,0,0,0,0,0
"Bahamas","2024-01-18",0,0,0,0,0,0,0,0
"Bahamas","2024-01-19",0,0,0,0,0,0,0,0
"Bahamas","2024-01-20",0,0,0,0,0,0,0,0
"Bahamas","2024-01-21",0,0,0,0,0,0,0,0
"Bahamas","2024-01-22",0,0,0,0,0,0,0,0
"Bahamas","2024-01-23",0,0,0,0,0,0,0,0
"Bahamas","2024-01-24",0,0,0,0,0,0,0,0
"Bahamas","2024-01-25",0,0,0,0,0,0,0,0
"Bahamas","2024-01-26",0,0,0,0,0,0,0,0
"Bahamas","2024-01-27",0,0,0,0,0,0,0,0
"Bahamas","2024-01-28",0,0,0,0,0,0,0,0
"Bahamas","2024-01-29",0,0,0,0,0,0,0,0
"Bahamas","2024-01-30",0,0,0,0,0,0,0,0
"Bahamas","2024-01-31",0,0,0,0,0,0,0,0
"Bahamas","2024-02-01",0,0,0,0,0,0,0,0
"Bahamas","2024-02-02",0,0,0,0,0,0,0,0
"Bahamas","2024-02-03",0,0,0,0,0,0,0,0
"Bahamas","2024-02-04",0,0,0,0,0,0,0,0
"Bahamas","2024-02-05",0,0,0,0,0,0,0,0
"Bahamas","2024-02-06",0,0,0,0,0,0,0,0
"Bahamas","2024-02-07",0,0,0,0,0,0,0,0
"Bahamas","2024-02-08",0,0,0,0,0,0,0,0
"Bahamas","2024-02-09",0,0,0,0,0,0,0,0
"Bahamas","2024-02-10",0,0,0,0,0,0,0,0
"Bahamas","2024-02-11",0,0,0,0,0,0,0,0
"Bahamas","2024-02-12",0,0,0,0,0,0,0,0
"Bahamas","2024-02-13",0,0,0,0,0,0,0,0
"Bahamas","2024-02-14",0,0,0,0,0,0,0,0
"Bahamas","2024-02-15",0,0,0,0,0,0,0,0
"Bahamas","2024-02-16",0,0,0,0,0,0,0,0
"Bahamas","2024-02-17",0,0,0,0,0,0,0,0
"Bahamas","2024-02-18",0,0,0,0,0,0,0,0
"Bahamas","2024-02-19",0,0,0,0,0,0,0,0
"Bahamas","2024-02-20",0,0,0,0,0,0,0,0
"Bahamas","2024-02-21",0,0,0,0,0,0,0,0
"Bahamas","2024-02-22",0,0,0,0,0,0,0,0
"Bahamas","2024-02-23",0,0,0,0,0,0,0,0
"Bahamas","2024-02-24",0,0,0,0,0,0,0,0
"Bahamas","2024-02-25",0,0,0,0,0,0,0,0
"Bahamas","2024-02-26",0,0,0,0,0,0,0,0
"Bahamas","2024-02-27",0,0,0,0,0,0,0,0
"Bahamas","2024-02-28",0,0,0,0,0,0,0,0
"Bahamas","2024-02-29",0,0,0,0,0,0,0,0
"Bahamas","2024-03-01",0,0,0,0,0,0,0,0
"Bahamas","2024-03-02",0,0,0,0,0,0,0,0
"Bahamas","2024-03-03",0,0,0,0,0,0,0,0
"Bahamas","2024-03-04",0,0,0,0,0,0,0,0
"Bahamas","2024-03-05",0,0,0,0,0,0,0,0
"Bahamas","2024-03-06",0,0,0,0,0,0,0,0
"Bahamas","2024-03-07",0,0,0,0,0,0,0,0
"Bahamas","2024-03-08",0,0,0,0,0,0,0,0
"Bahamas","2024-03-09",0,0,0,0,0,0,0,0
"Bahamas","2024-03-10",0,0,0,0,0,0,0,0
"Bahamas","2024-03-11",0,0,0,0,0,0,0,0
"Bahamas","2024-03-12",0,0,0,0,0,0,0,0
"Bahamas","2024-03-13",0,0,0,0,0,0,0,0
"Bahamas","2024-03-14",0,0,0,0,0,0,0,0
"Bahamas","2024-03-15",0,0,0,0,0,0,0,0
"Bahamas","2024-03-16",0,0,0,0,0,0,0,0
"Bahamas","2024-03-17",0,0,0,0,0,0,0,0
"Bahamas","2024-03-18",0,0,0,0,0,0,0,0
"Bahamas","2024-03-19",0,0,0,0,0,0,0,0
"Bahamas","2024-03-20",0,0,0,0,0,0,0,0
"Bahamas","2024-03-21",0,0,0,0,0,0,0,0
"Bahamas","2024-03-22",0,0,0,0,0,0,0,0
"Bahamas","2024-03-23",0,0,0,0,0,0,0,0
"Bahamas","2024-03-24",0,0,0,0,0,0,0,0
"Bahamas","2024-03-25",0,0,0,0,0,0,0,0
"Bahamas","2024-03-26",0,0,0,0,0,0,0,0
"Bahamas","2024-03-27",0,0,0,0,0,0,0,0
"Bahamas","2024-03-28",0,0,0,0,0,0,0,0
"Bahamas","2024-03-29",0,0,0,0,0,0,0,0
"Bahamas","2024-03-30",0,0,0,0,0,0,0,0
"Bahamas","2024-03-31",0,0,0,0,0,0,0,0
"Bahamas","2024-04-01",0,0,0,0,0,0,0,0
"Bahamas","2024-04-02",0,0,0,0,0,0,0,0
"Bahamas","2024-04-03",0,0,0,0,0,0,0,0
"Bahamas","2024-04-04",0,0,0,0,0,0,0,0
"Bahamas","2024-04-05",0,0,0,0,0,0,0,0
"Bahamas","2024-04-06",0,0,0,0,0,0,0,0
"Bahamas","2024-04-07",0,0,0,0,0,0,0,0
"Bahamas","2024-04-08",0,0,0,0,0,0,0,0
"Bahamas","2024-04-09",0,0,0,0,0,0,0,0
"Bahamas","2024-04-10",0,0,0,0,0,0,0,0
"Bahamas","2024-04-11",0,0,0,0,0,0,0,0
"Bahamas","2024-04-12",0,0,0,0,0,0,0,0
"Bahamas","2024-04-13",0,0,0,0,0,0,0,0
"Bahamas","2024-04-14",0,0,0,0,0,0,0,0
"Bahamas","2024-04-15",0,0,0,0,0,0,0,0
"Bahamas","2024-04-16",0,0,0,0,0,0,0,0
"Bahamas","2024-04-17",0,0,0,0,0,0,0,0
"Bahamas","2024-04-18",0,0,0,0,0,0,0,0
"Bahamas","2024-04-19",0,0,0,0,0,0,0,0
"Bahamas","2024-04-20",0,0,0,0,0,0,0,0
"Bahamas","2024-04-21",0,0,0,0,0,0,0,0
"Bahamas","2024-04-22",0,0,0,0,0,0,0,0
"Bahamas","2024-04-23",0,0,0,0,0,0,0,0
"Bahamas","2024-04-24",0,0,0,0,0,0,0,0
"Bahamas","2024-04-25",0,0,0,0,0,0,0,0
"Bahamas","2024-04-26",0,0,0,0,0,0,0,0
"Bahamas","2024-04-27",0,0,0,0,0,0,0,0
"Bahamas","2024-04-28",0,0,0,0,0,0,0,0
"Bahamas","2024-04-29",0,0,0,0,0,0,0,0
"Bahamas","2024-04-30",0,0,0,0,0,0,0,0
"Bahamas","2024-05-01",0,0,0,0,0,0,0,0
"Bahamas","2024-05-02",0,0,0,0,0,0,0,0
"Bahamas","2024-05-03",0,0,0,0,0,0,0,0
"Bahamas","2024-05-04",0,0,0,0,0,0,0,0
"Bahamas","2024-05-05",0,0,0,0,0,0,0,0
"Bahamas","2024-05-06",0,0,0,0,0,0,0,0
"Bahamas","2024-05-07",0,0,0,0,0,0,0,0
"Bahamas","2024-05-08",0,0,0,0,0,0,0,0
"Bahamas","2024-05-09",0,0,0,0,0,0,0,0
"Bahamas","2024-05-10",0,0,0,0,0,0,0,0
"Bahamas","2024-05-11",0,0,0,0,0,0,0,0
"Bahamas","2024-05-12",0,0,0,0,0,0,0,0
"Bahamas","2024-05-13",0,0,0,0,0,0,0,0
"Bahamas","2024-05-14",0,0,0,0,0,0,0,0
"Bahamas","2024-05-15",0,0,0,0,0,0,0,0
"Bahamas","2024-05-16",0,0,0,0,0,0,0,0
"Bahamas","2024-05-17",0,0,0,0,0,0,0,0
"Bahamas","2024-05-18",0,0,0,0,0,0,0,0
"Bahamas","2024-05-19",0,0,0,0,0,0,0,0
"Bahamas","2024-05-20",0,0,0,0,0,0,0,0
"Bahamas","2024-05-21",0,0,0,0,0,0,0,0
"Bahamas","2024-05-22",0,0,0,0,0,0,0,0
"Bahamas","2024-05-23",0,0,0,0,0,0,0,0
"Bahamas","2024-05-24",0,0,0,0,0,0,0,0
"Bahamas","2024-05-25",0,0,0,0,0,0,0,0
"Bahamas","2024-05-26",0,0,0,0,0,0,0,0
"Bahamas","2024-05-27",0,0,0,0,0,0,0,0
"Bahamas","2024-05-28",0,0,0,0,0,0,0,0
"Bahamas","2024-05-29",0,0,0,0,0,0,0,0
"Bahamas","2024-05-30",0,0,0,0,0,0,0,0
"Bahamas","2024-05-31",0,0,0,0,0,0,0,0
"Bahamas","2024-06-01",0,0,0,0,0,0,0,0
"Bahamas","2024-06-02",0,0,0,0,0,0,0,0
"Bahamas","2024-06-03",0,0,0,0,0,0,0,0
"Bahamas","2024-06-04",0,0,0,0,0,0,0,0
"Bahamas","2024-06-05",0,0,0,0,0,0,0,0
"Bahamas","2024-06-06",0,0,0,0,0,0,0,0
"Bahamas","2024-06-07",0,0,0,0,0,0,0,0
"Bahamas","2024-06-08",0,0,0,0,0,0,0,0
"Bahamas","2024-06-09",0,0,0,0,0,0,0,0
"Bahamas","2024-06-10",0,0,0,0,0,0,0,0
"Bahamas","2024-06-11",0,0,0,0,0,0,0,0
"Bahamas","2024-06-12",0,0,0,0,0,0,0,0
"Bahamas","2024-06-13",0,0,0,0,0,0,0,0
"Bahamas","2024-06-14",0,0,0,0,0,0,0,0
"Bahamas","2024-06-15",0,0,0,0,0,0,0,0
"Bahamas","2024-06-16",0,0,0,0,0,0,0,0
"Bahamas","2024-06-17",0,0,0,0,0,0,0,0
"Bahamas","2024-06-18",0,0,0,0,0,0,0,0
"Bahamas","2024-06-19",0,0,0,0,0,0,0,0
"Bahamas","2024-06-20",0,0,0,0,0,0,0,0
"Bahamas","2024-06-21",0,0,0,0,0,0,0,0
"Bahamas","2024-06-22",0,0,0,0,0,0,0,0
"Bahamas","2024-06-23",0,0,0,0,0,0,0,0
"Bahamas","2024-06-24",0,0,0,0,0,0,0,0
"Bahamas","2024-06-25",0,0,0,0,0,0,0,0
"Bahamas","2024-06-26",0,0,0,0,0,0,0,0
"Bahamas","2024-06-27",0,0,0,0,0,0,0,0
"Bahamas","2024-06-28",0,0,0,0,0,0,0,0
"Bahamas","2024-06-29",0,0,0,0,0,0,0,0
"Bahamas","2024-06-30",0,0,0,0,0,0,0,0
"Bahamas","2024-07-01",0,0,0,0,0,0,0,0
"Bahamas","2024-07-02",0,0,0,0,0,0,0,0
"Bahamas","2024-07-03",0,0,0,0,0,0,0,0
"Bahamas","2024-07-04",0,0,0,0,0,0,0,0
"Bahamas","2024-07-05",0,0,0,0,0,0,0,0
"Bahamas","2024-07-06",0,0,0,0,0,0,0,0
"Bahamas","2024-07-07",0,0,0,0,0,0,0,0
"Bahamas","2024-07-08",0,0,0,0,0,0,0,0
"Bahamas","2024-07-09",0,0,0,0,0,0,0,0
"Bahamas","2024-07-10",0,0,0,0,0,0,0,0
"Bahamas","2024-07-11",0,0,0,0,0,0,0,0
"Bahamas","2024-07-12",0,0,0,0,0,0,0,0
"Bahamas","2024-07-13",0,0,0,0,0,0,0,0
"Bahamas","2024-07-14",0,0,0,0,0,0,0,0
"Bahamas","2024-07-15",0,0,0,0,0,0,0,0
"Bahamas","2024-07-16",0,0,0,0,0,0,0,0
"Bahamas","2024-07-17",0,0,0,0,0,0,0,0
"Bahamas","2024-07-18",0,0,0,0,0,0,0,0
"Bahamas","2024-07-19",0,0,0,0,0,0,0,0
"Bahamas","2024-07-20",0,0,0,0,0,0,0,0
"Bahamas","2024-07-21",0,0,0,0,0,0,0,0
"Bahamas","2024-07-22",0,0,0,0,0,0,0,0
"Bahamas","2024-07-23",0,0,0,0,0,0,0,0
"Bahamas","2024-07-24",0,0,0,0,0,0,0,0
"Bahamas","2024-07-25",0,0,0,0,0,0,0,0
"Bahamas","2024-07-26",0,0,0,0,0,0,0,0
"Bahamas","2024-07-27",0,0,0,0,0,0,0,0
"Bahamas","2024-07-28",0,0,0,0,0,0,0,0
"Bahamas","2024-07-29",0,0,0,0,0,0,0,0
"Bahamas","2024-07-30",0,0,0,0,0,0,0,0
"Bahamas","2024-07-31",0,0,0,0,0,0,0,0
"Bahamas","2024-08-01",0,0,0,0,0,0,0,0
"Bahamas","2024-08-02",0,0,0,0,0,0,0,0
"Bahamas","2024-08-03",0,0,0,0,0,0,0,0
"Bahamas","2024-08-04",0,0,0,0,0,0,0,0
"Bahamas","2024-08-05",0,0,0,0,0,0,0,0
"Bahamas","2024-08-06",0,0,0,0,0,0,0,0
"Bahamas","2024-08-07",0,0,0,0,0,0,0,0
"Bahamas","2024-08-08",0,0,0,0,0,0,0,0
"Bahamas","2024-08-09",0,0,0,0,0,0,0,0
"Bahamas","2024-08-10",0,0,0,0,0,0,0,0
"Bahamas","2024-08-11",0,0,0,0,0,0,0,0
"Bahamas","2024-08-12",0,0,0,0,0,0,0,0
"Bahamas","2024-08-13",0,0,0,0,0,0,0,0
"Bahamas","2024-08-14",0,0,0,0,0,0,0,0
"Bahamas","2024-08-15",0,0,0,0,0,0,0,0
"Bahamas","2024-08-16",0,0,0,0,0,0,0,0
"Bahamas","2024-08-17",0,0,0,0,0,0,0,0
"Bahamas","2024-08-18",0,0,0,0,0,0,0,0
"Bahamas","2024-08-19",0,0,0,0,0,0,0,0
"Bahamas","2024-08-20",0,0,0,0,0,0,0,0
"Bahamas","2024-08-21",0,0,0,0,0,0,0,0
"Bahamas","2024-08-22",0,0,0,0,0,0,0,0
"Bahamas","2024-08-23",0,0,0,0,0,0,0,0
"Bahamas","2024-08-24",0,0,0,0,0,0,0,0
"Bahamas","2024-08-25",0,0,0,0,0,0,0,0
"Bahamas","2024-08-26",0,0,0,0,0,0,0,0
"Bahamas","2024-08-27",0,0,0,0,0,0,0,0
"Bahamas","2024-08-28",0,0,0,0,0,0,0,0
"Bahamas","2024-08-29",0,0,0,0,0,0,0,0
"Bahamas","2024-08-30",0,0,0,0,0,0,0,0
"Bahamas","2024-08-31",0,0,0,0,0,0,0,0
"Bahamas","2024-09-01",0,0,0,0,0,0,0,0
"Bahamas","2024-09-02",0,0,0,0,0,0,0,0
"Bahamas","2024-09-03",0,0,0,0,0,0,0,0
"Bahamas","2024-09-04",0,0,0,0,0,0,0,0
"Bahamas","2024-09-05",0,0,0,0,0,0,0,0
"Bahamas","2024-09-06",0,0,0,0,0,0,0,0
"Bahamas","2024-09-07",0,0,0,0,0,0,0,0
"Bahamas","2024-09-08",0,0,0,0,0,0,0,0
"Bahamas","2024-09-09",0,0,0,0,0,0,0,0
"Bahamas","2024-09-10",0,0,0,0,0,0,0,0
"Bahamas","2024-09-11",0,0,0,0,0,0,0,0
"Bahamas","2024-09-12",0,0,0,0,0,0,0,0
"Bahamas","2024-09-13",0,0,0,0,0,0,0,0
"Bahamas","2024-09-14",0,0,0,0,0,0,0,0
"Bahamas","2024-09-15",0,0,0,0,0,0,0,0
"Bahamas","2024-09-16",0,0,0,0,0,0,0,0
"Bahamas","2024-09-17",0,0,0,0,0,0,0,0
"Bahamas","2024-09-18",0,0,0,0,0,0,0,0
"Bahamas","2024-09-19",0,0,0,0,0,0,0,0
"Bahamas","2024-09-20",0,0,0,0,0,0,0,0
"Bahamas","2024-09-21",0,0,0,0,0,0,0,0
"Bahamas","2024-09-22",0,0,0,0,0,0,0,0
"Bahamas","2024-09-23",0,0,0,0,0,0,0,0
"Bahamas","2024-09-24",0,0,0,0,0,0,0,0
"Bahamas","2024-09-25",0,0,0,0,0,0,0,0
"Bahamas","2024-09-26",0,0,0,0,0,0,0,0
"Bahamas","2024-09-27",0,0,0,0,0,0,0,0
"Bahamas","2024-09-28",0,0,0,0,0,0,0,0
"Bahamas","2024-09-29",0,0,0,0,0,0,0,0
"Bahamas","2024-09-30",0,0,0,0,0,0,0,0
"Bahamas","2024-10-01",0,0,0,0,0,0,0,0
"Bahamas","2024-10-02",0,0,0,0,0,0,0,0
"Bahamas","2024-10-03",0,0,0,0,0,0,0,0
"Bahamas","2024-10-04",0,0,0,0,0,0,0,0
"Bahamas","2024-10-05",0,0,0,0,0,0,0,0
"Bahamas","2024-10-06",0,0,0,0,0,0,0,0
"Bahamas","2024-10-07",0,0,0,0,0,0,0,0
"Bahamas","2024-10-08",0,0,0,0,0,0,0,0
"Bahamas","2024-10-09",0,0,0,0,0,0,0,0
"Bahamas","2024-10-10",0,0,0,0,0,0,0,0
"Bahamas","2024-10-11",0,0,0,0,0,0,0,0
"Bahamas","2024-10-12",0,0,0,0,0,0,0,0
"Bahamas","2024-10-13",0,0,0,0,0,0,0,0
"Bahamas","2024-10-14",0,0,0,0,0,0,0,0
"Bahamas","2024-10-15",0,0,0,0,0,0,0,0
"Bahamas","2024-10-16",0,0,0,0,0,0,0,0
"Bahamas","2024-10-17",0,0,0,0,0,0,0,0
"Bahamas","2024-10-18",0,0,0,0,0,0,0,0
"Bahamas","2024-10-19",0,0,0,0,0,0,0,0
"Bahamas","2024-10-20",0,0,0,0,0,0,0,0
"Bahamas","2024-10-21",0,0,0,0,0,0,0,0
"Bahamas","2024-10-22",0,0,0,0,0,0,0,0
"Bahamas","2024-10-23",0,0,0,0,0,0,0,0
"Bahamas","2024-10-24",0,0,0,0,0,0,0,0
"Bahamas","2024-10-25",0,0,0,0,0,0,0,0
"Bahamas","2024-10-26",0,0,0,0,0,0,0,0
"Bahamas","2024-10-27",0,0,0,0,0,0,0,0
"Bahamas","2024-10-28",0,0,0,0,0,0,0,0
"Bahamas","2024-10-29",0,0,0,0,0,0,0,0
"Bahamas","2024-10-30",0,0,0,0,0,0,0,0
"Bahamas","2024-10-31",0,0,0,0,0,0,0,0
"Bahamas","2024-11-01",0,0,0,0,0,0,0,0
"Bahamas","2024-11-02",0,0,0,0,0,0,0,0
"Bahamas","2024-11-03",0,0,0,0,0,0,0,0
"Bahamas","2024-11-04",0,0,0,0,0,0,0,0
"Bahamas","2024-11-05",0,0,0,0,0,0,0,0
"Bahamas","2024-11-06",0,0,0,0,0,0,0,0
"Bahamas","2024-11-07",0,0,0,0,0,0,0,0
"Bahamas","2024-11-08",0,0,0,0,0,0,0,0
"Bahamas","2024-11-09",0,0,0,0,0,0,0,0
"Bahamas","2024-11-10",0,0,0,0,0,0,0,0
"Bahamas","2024-11-11",0,0,0,0,0,0,0,0
"Bahamas","2024-11-12",0,0,0,0,0,0,0,0
"Bahamas","2024-11-13",0,0,0,0,0,0,0,0
"Bahamas","2024-11-14",0,0,0,0,0,0,0,0
"Bahamas","2024-11-15",0,0,0,0,0,0,0,0
"Bahamas","2024-11-16",0,0,0,0,0,0,0,0
"Bahamas","2024-11-17",0,0,0,0,0,0,0,0
"Bahamas","2024-11-18",0,0,0,0,0,0,0,0
"Bahamas","2024-11-19",0,0,0,0,0,0,0,0
"Bahamas","2024-11-20",0,0,0,0,0,0,0,0
"Bahamas","2024-11-21",0,0,0,0,0,0,0,0
"Bahamas","2024-11-22",0,0,0,0,0,0,0,0
"Bahamas","2024-11-23",0,0,0,0,0,0,0,0
"Bahamas","2024-11-24",0,0,0,0,0,0,0,0
"Bahamas","2024-11-25",0,0,0,0,0,0,0,0
"Bahamas","2024-11-26",0,0,0,0,0,0,0,0
"Bahamas","2024-11-27",0,0,0,0,0,0,0,0
"Bahamas","2024-11-28",0,0,0,0,0,0,0,0
"Bahamas","2024-11-29",0,0,0,0,0,0,0,0
"Bahamas","2024-11-30",0,0,0,0,0,0,0,0
"Bahamas","2024-12-01",0,0,0,0,0,0,0,0
"Bahamas","2024-12-02",0,0,0,0,0,0,0,0
"Bahamas","2024-12-03",0,0,0,0,0,0,0,0
"Bahamas","2024-12-04",0,0,0,0,0,0,0,0
"Bahamas","2024-12-05",0,0,0,0,0,0,0,0
"Bahamas","2024-12-06",0,0,0,0,0,0,0,0
"Bahamas","2024-12-07",0,0,0,0,0,0,0,0
"Bahamas","2024-12-08",0,0,0,0,0,0,0,0
"Bahamas","2024-12-09",0,0,0,0,0,0,0,0
"Bahamas","2024-12-10",0,0,0,0,0,0,0,0
"Bahamas","2024-12-11",0,0,0,0,0,0,0,0
"Bahamas","2024-12-12",0,0,0,0,0,0,0,0
"Bahamas","2024-12-13",0,0,0,0,0,0,0,0
"Bahamas","2024-12-14",0,0,0,0,0,0,0,0
"Bahamas","2024-12-15",0,0,0,0,0,0,0,0
"Bahamas","2024-12-16",0,0,0,0,0,0,0,0
"Bahamas","2024-12-17",0,0,0,0,0,0,0,0
"Bahamas","2024-12-18",0,0,0,0,0,0,0,0
"Bahamas","2024-12-19",0,0,0,0,0,0,0,0
"Bahamas","2024-12-20",0,0,0,0,0,0,0,0
"Bahamas","2024-12-21",0,0,0,0,0,0,0,0
"Bahamas","2024-12-22",0,0,0,0,0,0,0,0
"Bahamas","2024-12-23",0,0,0,0,0,0,0,0
"Bahamas","2024-12-24",0,0,0,0,0,0,0,0
"Bahamas","2024-12-25",0,0,0,0,0,0,0,0
"Bahamas","2024-12-26",0,0,0,0,0,0,0,0
"Bahamas","2024-12-27",0,0,0,0,0,0,0,0
"Bahamas","2024-12-28",0,0,0,0,0,0,0,0
"Bahamas","2024-12-29",0,0,0,0,0,0,0,0
"Bahamas","2024-12-30",0,0,0,0,0,0,0,0
"Bahamas","2024-12-31",0,0,0,0,0,0,0,0
"Bahamas","2025-01-01",0,0,0,0,0,0,0,0
"Bahamas","2025-01-02",0,0,0,0,0,0,0,0
"Bahamas","2025-01-03",0,0,0,0,0,0,0,0
"Bahamas","2025-01-04",0,0,0,0,0,0,0,0
"Bahamas","2025-01-05",0,0,0,0,0,0,0,0
"Bahamas","2025-01-06",0,0,0,0,0,0,0,0
"Bahamas","2025-01-07",0,0,0,0,0,0,0,0
"Bahamas","2025-01-08",0,0,0,0,0,0,0,0
"Bahamas","2025-01-09",0,0,0,0,0,0,0,0
"Bahamas","2025-01-10",0,0,0,0,0,0,0,0
"Bahamas","2025-01-11",0,0,0,0,0,0,0,0
"Bahamas","2025-01-12",0,0,0,0,0,0,0,0
"Bahamas","2025-01-13",0,0,0,0,0,0,0,0
"Bahamas","2025-01-14",0,0,0,0,0,0,0,0
"Bahamas","2025-01-15",0,0,0,0,0,0,0,0
"Bahamas","2025-01-16",0,0,0,0,0,0,0,0
"Bahamas","2025-01-17",0,0,0,0,0,0,0,0
"Bahamas","2025-01-18",0,0,0,0,0,0,0,0
"Bahamas","2025-01-19",0,0,0,0,0,0,0,0
"Bahamas","2025-01-20",0,0,0,0,0,0,0,0
"Bahamas","2025-01-21",0,0,0,0,0,0,0,0
"Bahamas","2025-01-22",0,0,0,0,0,0,0,0
"Bahamas","2025-01-23",0,0,0,0,0,0,0,0
"Bahamas","2025-01-24",0,0,0,0,0,0,0,0
"Bahamas","2025-01-25",0,0,0,0,0,0,0,0
"Bahamas","2025-01-26",0,0,0,0,0,0,0,0
"Bahamas","2025-01-27",0,0,0,0,0,0,0,0
"Bahamas","2025-01-28",0,0,0,0,0,0,0,0
"Bahamas","2025-01-29",0,0,0,0,0,0,0,0
"Bahamas","2025-01-30",0,0,0,0,0,0,0,0
"Bahamas","2025-01-31",0,0,0,0,0,0,0,0
"Bahamas","2025-02-01",0,0,0,0,0,0,0,0
"Bahamas","2025-02-02",0,0,0,0,0,0,0,0
"Bahamas","2025-02-03",0,0,0,0,0,0,0,0
"Bahamas","2025-02-04",0,0,0,0,0,0,0,0
"Bahamas","2025-02-05",0,0,0,0,0,0,0,0
"Bahamas","2025-02-06",0,0,0,0,0,0,0,0
"Bahamas","2025-02-07",0,0,0,0,0,0,0,0
"Bahamas","2025-02-08",0,0,0,0,0,0,0,0
"Bahamas","2025-02-09",0,0,0,0,0,0,0,0
"Bahamas","2025-02-10",0,0,0,0,0,0,0,0
"Bahamas","2025-02-11",0,0,0,0,0,0,0,0
"Bahamas","2025-02-12",0,0,0,0,0,0,0,0
"Bahamas","2025-02-13",0,0,0,0,0,0,0,0
"Bahamas","2025-02-14",0,0,0,0,0,0,0,0
"Bahamas","2025-02-15",0,0,0,0,0,0,0,0
"Bahamas","2025-02-16",0,0,0,0,0,0,0,0
"Bahamas","2025-02-17",0,0,0,0,0,0,0,0
"Bahamas","2025-02-18",0,0,0,0,0,0,0,0
"Bahamas","2025-02-19",0,0,0,0,0,0,0,0
"Bahamas","2025-02-20",0,0,0,0,0,0,0,0
"Bahamas","2025-02-21",0,0,0,0,0,0,0,0
"Bahamas","2025-02-22",0,0,0,0,0,0,0,0
"Bahamas","2025-02-23",0,0,0,0,0,0,0,0
"Bahamas","2025-02-24",0,0,0,0,0,0,0,0
"Bahamas","2025-02-25",0,0,0,0,0,0,0,0
"Bahamas","2025-02-26",0,0,0,0,0,0,0,0
"Bahamas","2025-02-27",0,0,0,0,0,0,0,0
"Bahamas","2025-02-28",0,0,0,0,0,0,0,0
"Bahamas","2025-03-01",0,0,0,0,0,0,0,0
"Bahamas","2025-03-02",0,0,0,0,0,0,0,0
"Bahamas","2025-03-03",0,0,0,0,0,0,0,0
"Barbados","2024-01-01",0,0,0,0,0,0,0,0
"Barbados","2024-01-02",0,0,0,0,0,0,0,0
"Barbados","2024-01-03",0,0,0,0,0,0,0,0
"Barbados","2024-01-04",0,0,0,0,0,0,0,0
"Barbados","2024-01-05",0,0,0,0,0,0,0,0
"Barbados","2024-01-06",0,0,0,0,0,0,0,0
"Barbados","2024-01-07",0,0,0,0,0,0,0,0
"Barbados","2024-01-08",0,0,0,0,0,0,0,0
"Barbados","2024-01-09",0,0,0,0,0,0,0,0
"Barbados","2024-01-10",0,0,0,0,0,0,0,0
"Barbados","2024-01-11",0,0,0,0,0,0,0,0
"Barbados","2024-01-12",0,0,0,0,0,0,0,0
"Barbados","2024-01-13",0,0,0,0,0,0,0,0
"Barbados","2024-01-14",0,0,0,0,0,0,0,0
"Barbados","2024-01-15",0,0,0,0,0,0,0,0
"Barbados","2024-01-16",0,0,0,0,0,0,0,0
"Barbados","2024-01-17",0,0,0,0,0,0,0,0
"Barbados","2024-01-18",0,0,0,0,0,0,0,0
"Barbados","2024-01-19",0,0,0,0,0,0,0,0
"Barbados","2024-01-20",0,0,0,0,0,0,0,0
"Barbados","2024-01-21",0,0,0,0,0,0,0,0
"Barbados","2024-01-22",0,0,0,0,0,0,0,0
"Barbados","2024-01-23",0,0,0,0,0,0,0,0
"Barbados","2024-01-24",0,0,0,0,0,0,0,0
"Barbados","2024-01-25",0,0,0,0,0,0,0,0
"Barbados","2024-01-26",0,0,0,0,0,0,0,0
"Barbados","2024-01-27",0,0,0,0,0,0,0,0
"Barbados","2024-01-28",0,0,0,0,0,0,0,0
"Barbados","2024-01-29",0,0,0,0,0,0,0,0
"Barbados","2024-01-30",0,0,0,0,0,0,0,0
"Barbados","2024-01-31",0,0,0,0,0,0,0,0
"Barbados","2024-02-01",0,0,0,0,0,0,0,0
"Barbados","2024-02-02",0,0,0,0,0,0,0,0
"Barbados","2024-02-03",0,0,0,0,0,0,0,0
"Barbados","2024-02-04",0,0,0,0,0,0,0,0
"Barbados","2024-02-05",0,0,0,0,0,0,0,0
"Barbados","2024-02-06",0,0,0,0,0,0,0,0
"Barbados","2024-02-07",0,0,0,0,0,0,0,0
"Barbados","2024-02-08",0,0,0,0,0,0,0,0
"Barbados","2024-02-09",0,0,0,0,0,0,0,0
"Barbados","2024-02-10",0,0,0,0,0,0,0,0
"Barbados","2024-02-11",0,0,0,0,0,0,0,0
"Barbados","2024-02-12",0,0,0,0,0,0,0,0
"Barbados","2024-02-13",0,0,0,0,0,0,0,0
"Barbados","2024-02-14",0,0,0,0,0,0,0,0
"Barbados","2024-02-15",0,0,0,0,0,0,0,0
"Barbados","2024-02-16",0,0,0,0,0,0,0,0
"Barbados","2024-02-17",0,0,0,0,0,0,0,0
"Barbados","2024-02-18",0,0,0,0,0,0,0,0
"Barbados","2024-02-19",0,0,0,0,0,0,0,0
"Barbados","2024-02-20",0,0,0,0,0,0,0,0
"Barbados","2024-02-21",0,0,0,0,0,0,0,0
"Barbados","2024-02-22",0,0,0,0,0,0,0,0
"Barbados","2024-02-23",0,0,0,0,0,0,0,0
"Barbados","2024-02-24",0,0,0,0,0,0,0,0
"Barbados","2024-02-25",0,0,0,0,0,0,0,0
"Barbados","2024-02-26",0,0,0,0,0,0,0,0
"Barbados","2024-02-27",0,0,0,0,0,0,0,0
"Barbados","2024-02-28",0,0,0,0,0,0,0,0
"Barbados","2024-02-29",0,0,0,0,0,0,0,0
"Barbados","2024-03-01",0,0,0,0,0,0,0,0
"Barbados","2024-03-02",0,0,0,0,0,0,0,0
"Barbados","2024-03-03",0,0,0,0,0,0,0,0
"Barbados","2024-03-04",0,0,0,0,0,0,0,0
"Barbados","2024-03-05",0,0,0,0,0,0,0,0
"Barbados","2024-03-06",0,0,0,0,0,0,0,0
"Barbados","2024-03-07",0,0,0,0,0,0,0,0
"Barbados","2024-03-08",0,0,0,0,0,0,0,0
"Barbados","2024-03-09",0,0,0,0,0,0,0,0
"Barbados","2024-03-10",0,0,0,0,0,0,0,0
"Barbados","2024-03-11",0,0,0,0,0,0,0,0
"Barbados","2024-03-12",0,0,0,0,0,0,0,0
"Barbados","2024-03-13",0,0,0,0,0,0,0,0
"Barbados","2024-03-14",0,0,0,0,0,0,0,0
"Barbados","2024-03-15",0,0,0,0,0,0,0,0
"Barbados","2024-03-16",0,0,0,0,0,0,0,0
"Barbados","2024-03-17",0,0,0,0,0,0,0,0
"Barbados","2024-03-18",0,0,0,0,0,0,0,0
"Barbados","2024-03-19",0,0,0,0,0,0,0,0
"Barbados","2024-03-20",0,0,0,0,0,0,0,0
"Barbados","2024-03-21",0,0,0,0,0,0,0,0
"Barbados","2024-03-22",0,0,0,0,0,0,0,0
"Barbados","2024-03-23",0,0,0,0,0,0,0,0
"Barbados","2024-03-24",0,0,0,0,0,0,0,0
"Barbados","2024-03-25",0,0,0,0,0,0,0,0
"Barbados","2024-03-26",0,0,0,0,0,0,0,0
"Barbados","2024-03-27",0,0,0,0,0,0,0,0
"Barbados","2024-03-28",0,0,0,0,0,0,0,0
"Barbados","2024-03-29",0,0,0,0,0,0,0,0
"Barbados","2024-03-30",0,0,0,0,0,0,0,0
"Barbados","2024-03-31",0,0,0,0,0,0,0,0
"Barbados","2024-04-01",0,0,0,0,0,0,0,0
"Barbados","2024-04-02",0,0,0,0,0,0,0,0
"Barbados","2024-04-03",0,0,0,0,0,0,0,0
"Barbados","2024-04-04",0,0,0,0,0,0,0,0
"Barbados","2024-04-05",0,0,0,0,0,0,0,0
"Barbados","2024-04-06",0,0,0,0,0,0,0,0
"Barbados","2024-04-07",0,0,0,0,0,0,0,0
"Barbados","2024-04-08",0,0,0,0,0,0,0,0
"Barbados","2024-04-09",0,0,0,0,0,0,0,0
"Barbados","2024-04-10",0,0,0,0,0,0,0,0
"Barbados","2024-04-11",0,0,0,0,0,0,0,0
"Barbados","2024-04-12",0,0,0,0,0,0,0,0
"Barbados","2024-04-13",0,0,0,0,0,0,0,0
"Barbados","2024-04-14",0,0,0,0,0,0,0,0
"Barbados","2024-04-15",0,0,0,0,0,0,0,0
"Barbados","2024-04-16",0,0,0,0,0,0,0,0
"Barbados","2024-04-17",0,0,0,0,0,0,0,0
"Barbados","2024-04-18",0,0,0,0,0,0,0,0
"Barbados","2024-04-19",0,0,0,0,0,0,0,0
"Barbados","2024-04-20",0,0,0,0,0,0,0,0
"Barbados","2024-04-21",0,0,0,0,0,0,0,0
"Barbados","2024-04-22",0,0,0,0,0,0,0,0
"Barbados","2024-04-23",0,0,0,0,0,0,0,0
"Barbados","2024-04-24",0,0,0,0,0,0,0,0
"Barbados","2024-04-25",0,0,0,0,0,0,0,0
"Barbados","2024-04-26",0,0,0,0,0,0,0,0
"Barbados","2024-04-27",0,0,0,0,0,0,0,0
"Barbados","2024-04-28",0,0,0,0,0,0,0,0
"Barbados","2024-04-29",0,0,0,0,0,0,0,0
"Barbados","2024-04-30",0,0,0,0,0,0,0,0
"Barbados","2024-05-01",0,0,0,0,0,0,0,0
"Barbados","2024-05-02",0,0,0,0,0,0,0,0
"Barbados","2024-05-03",0,0,0,0,0,0,0,0
"Barbados","2024-05-04",0,0,0,0,0,0,0,0
"Barbados","2024-05-05",0,0,0,0,0,0,0,0
"Barbados","2024-05-06",0,0,0,0,0,0,0,0
"Barbados","2024-05-07",0,0,0,0,0,0,0,0
"Barbados","2024-05-08",0,0,0,0,0,0,0,0
"Barbados","2024-05-09",0,0,0,0,0,0,0,0
"Barbados","2024-05-10",0,0,0,0,0,0,0,0
"Barbados","2024-05-11",0,0,0,0,0,0,0,0
"Barbados","2024-05-12",0,0,0,0,0,0,0,0
"Barbados","2024-05-13",0,0,0,0,0,0,0,0
"Barbados","2024-05-14",0,0,0,0,0,0,0,0
"Barbados","2024-05-15",0,0,0,0,0,0,0,0
"Barbados","2024-05-16",0,0,0,0,0,0,0,0
"Barbados","2024-05-17",0,0,0,0,0,0,0,0
"Barbados","2024-05-18",0,0,0,0,0,0,0,0
"Barbados","2024-05-19",0,0,0,0,0,0,0,0
"Barbados","2024-05-20",0,0,0,0,0,0,0,0
"Barbados","2024-05-21",0,0,0,0,0,0,0,0
"Barbados","2024-05-22",0,0,0,0,0,0,0,0
"Barbados","2024-05-23",0,0,0,0,0,0,0,0
"Barbados","2024-05-24",0,0,0,0,0,0,0,0
"Barbados","2024-05-25",0,0,0,0,0,0,0,0
"Barbados","2024-05-26",0,0,0,0,0,0,0,0
"Barbados","2024-05-27",0,0,0,0,0,0,0,0
"Barbados","2024-05-28",0,0,0,0,0,0,0,0
"Barbados","2024-05-29",0,0,0,0,0,0,0,0
"Barbados","2024-05-30",0,0,0,0,0,0,0,0
"Barbados","2024-05-31",0,0,0,0,0,0,0,0
"Barbados","2024-06-01",0,0,0,0,0,0,0,0
"Barbados","2024-06-02",0,0,0,0,0,0,0,0
"Barbados","2024-06-03",0,0,0,0,0,0,0,0
"Barbados","2024-06-04",0,0,0,0,0,0,0,0
"Barbados","2024-06-05",0,0,0,0,0,0,0,0
"Barbados","2024-06-06",0,0,0,0,0,0,0,0
"Barbados","2024-06-07",0,0,0,0,0,0,0,0
"Barbados","2024-06-08",0,0,0,0,0,0,0,0
"Barbados","2024-06-09",0,0,0,0,0,0,0,0
"Barbados","2024-06-10",0,0,0,0,0,0,0,0
"Barbados","2024-06-11",0,0,0,0,0,0,0,0
"Barbados","2024-06-12",0,0,0,0,0,0,0,0
"Barbados","2024-06-13",0,0,0,0,0,0,0,0
"Barbados","2024-06-14",0,0,0,0,0,0,0,0
"Barbados","2024-06-15",0,0,0,0,0,0,0,0
"Barbados","2024-06-16",0,0,0,0,0,0,0,0
"Barbados","2024-06-17",0,0,0,0,0,0,0,0
"Barbados","2024-06-18",0,0,0,0,0,0,0,0
"Barbados","2024-06-19",0,0,0,0,0,0,0,0
"Barbados","2024-06-20",0,0,0,0,0,0,0,0
"Barbados","2024-06-21",0,0,0,0,0,0,0,0
"Barbados","2024-06-22",0,0,0,0,0,0,0,0
"Barbados","2024-06-23",0,0,0,0,0,0,0,0
"Barbados","2024-06-24",0,0,0,0,0,0,0,0
"Barbados","2024-06-25",0,0,0,0,0,0,0,0
"Barbados","2024-06-26",0,0,0,0,0,0,0,0
"Barbados","2024-06-27",0,0,0,0,0,0,0,0
"Barbados","2024-06-28",0,0,0,0,0,0,0,0
"Barbados","2024-06-29",0,0,0,0,0,0,0,0
"Barbados","2024-06-30",0,0,0,0,0,0,0,0
"Barbados","2024-07-01",0,0,0,0,0,0,0,0
"Barbados","2024-07-02",0,0,0,0,0,0,0,0
"Barbados","2024-07-03",0,0,0,0,0,0,0,0
"Barbados","2024-07-04",0,0,0,0,0,0,0,0
"Barbados","2024-07-05",0,0,0,0,0,0,0,0
"Barbados","2024-07-06",0,0,0,0,0,0,0,0
"Barbados","2024-07-07",0,0,0,0,0,0,0,0
"Barbados","2024-07-08",0,0,0,0,0,0,0,0
"Barbados","2024-07-09",0,0,0,0,0,0,0,0
"Barbados","2024-07-10",0,0,0,0,0,0,0,0
"Barbados","2024-07-11",0,0,0,0,0,0,0,0
"Barbados","2024-07-12",0,0,0,0,0,0,0,0
"Barbados","2024-07-13",0,0,0,0,0,0,0,0
"Barbados","2024-07-14",0,0,0,0,0,0,0,0
"Barbados","2024-07-15",0,0,0,0,0,0,0,0
"Barbados","2024-07-16",0,0,0,0,0,0,0,0
"Barbados","2024-07-17",0,0,0,0,0,0,0,0
"Barbados","2024-07-18",0,0,0,0,0,0,0,0
"Barbados","2024-07-19",0,0,0,0,0,0,0,0
"Barbados","2024-07-20",0,0,0,0,0,0,0,0
"Barbados","2024-07-21",0,0,0,0,0,0,0,0
"Barbados","2024-07-22",0,0,0,0,0,0,0,0
"Barbados","2024-07-23",0,0,0,0,0,0,0,0
"Barbados","2024-07-24",0,0,0,0,0,0,0,0
"Barbados","2024-07-25",0,0,0,0,0,0,0,0
"Barbados","2024-07-26",0,0,0,0,0,0,0,0
"Barbados","2024-07-27",0,0,0,0,0,0,0,0
"Barbados","2024-07-28",0,0,0,0,0,0,0,0
"Barbados","2024-07-29",0,0,0,0,0,0,0,0
"Barbados","2024-07-30",0,0,0,0,0,0,0,0
"Barbados","2024-07-31",0,0,0,0,0,0,0,0
"Barbados","2024-08-01",0,0,0,0,0,0,0,0
"Barbados","2024-08-02",0,0,0,0,0,0,0,0
"Barbados","2024-08-03",0,0,0,0,0,0,0,0
"Barbados","2024-08-04",0,0,0,0,0,0,0,0
"Barbados","2024-08-05",0,0,0,0,0,0,0,0
"Barbados","2024-08-06",0,0,0,0,0,0,0,0
"Barbados","2024-08-07",0,0,0,0,0,0,0,0
"Barbados","2024-08-08",0,0,0,0,0,0,0,0
"Barbados","2024-08-09",0,0,0,0,0,0,0,0
"Barbados","2024-08-10",0,0,0,0,0,0,0,0
"Barbados","2024-08-11",0,0,0,0,0,0,0,0
"Barbados","2024-08-12",0,0,0,0,0,0,0,0
"Barbados","2024-08-13",0,0,0,0,0,0,0,0
"Barbados","2024-08-14",0,0,0,0,0,0,0,0
"Barbados","2024-08-15",0,0,0,0,0,0,0,0
"Barbados","2024-08-16",0,0,0,0,0,0,0,0
"Barbados","2024-08-17",0,0,0,0,0,0,0,0
"Barbados","2024-08-18",0,0,0,0,0,0,0,0
"Barbados","2024-08-19",0,0,0,0,0,0,0,0
"Barbados","2024-08-20",0,0,0,0,0,0,0,0
"Barbados","2024-08-21",0,0,0,0,0,0,0,0
"Barbados","2024-08-22",0,0,0,0,0,0,0,0
"Barbados","2024-08-23",0,0,0,0,0,0,0,0
"Barbados","2024-08-24",0,0,0,0,0,0,0,0
"Barbados","2024-08-25",0,0,0,0,0,0,0,0
"Barbados","2024-08-26",0,0,0,0,0,0,0,0
"Barbados","2024-08-27",0,0,0,0,0,0,0,0
"Barbados","2024-08-28",0,0,0,0,0,0,0,0
"Barbados","2024-08-29",0,0,0,0,0,0,0,0
"Barbados","2024-08-30",0,0,0,0,0,0,0,0
"Barbados","2024-08-31",0,0,0,0,0,0,0,0
"Barbados","2024-09-01",0,0,0,0,0,0,0,0
"Barbados","2024-09-02",0,0,0,0,0,0,0,0
"Barbados","2024-09-03",0,0,0,0,0,0,0,0
"Barbados","2024-09-04",0,0,0,0,0,0,0,0
"Barbados","2024-09-05",0,0,0,0,0,0,0,0
"Barbados","2024-09-06",0,0,0,0,0,0,0,0
"Barbados","2024-09-07",0,0,0,0,0,0,0,0
"Barbados","2024-09-08",0,0,0,0,0,0,0,0
"Barbados","2024-09-09",0,0,0,0,0,0,0,0
"Barbados","2024-09-10",0,0,0,0,0,0,0,0
"Barbados","2024-09-11",0,0,0,0,0,0,0,0
"Barbados","2024-09-12",0,0,0,0,0,0,0,0
"Barbados","2024-09-13",0,0,0,0,0,0,0,0
"Barbados","2024-09-14",0,0,0,0,0,0,0,0
"Barbados","2024-09-15",0,0,0,0,0,0,0,0
"Barbados","2024-09-16",0,0,0,0,0,0,0,0
"Barbados","2024-09-17",0,0,0,0,0,0,0,0
"Barbados","2024-09-18",0,0,0,0,0,0,0,0
"Barbados","2024-09-19",0,0,0,0,0,0,0,0
"Barbados","2024-09-20",0,0,0,0,0,0,0,0
"Barbados","2024-09-21",0,0,0,0,0,0,0,0
"Barbados","2024-09-22",0,0,0,0,0,0,0,0
"Barbados","2024-09-23",0,0,0,0,0,0,0,0
"Barbados","2024-09-24",0,0,0,0,0,0,0,0
"Barbados","2024-09-25",0,0,0,0,0,0,0,0
"Barbados","2024-09-26",0,0,0,0,0,0,0,0
"Barbados","2024-09-27",0,0,0,0,0,0,0,0
"Barbados","2024-09-28",0,0,0,0,0,0,0,0
"Barbados","2024-09-29",0,0,0,0,0,0,0,0
"Barbados","2024-09-30",0,0,0,0,0,0,0,0
"Barbados","2024-10-01",0,0,0,0,0,0,0,0
"Barbados","2024-10-02",0,0,0,0,0,0,0,0
"Barbados","2024-10-03",0,0,0,0,0,0,0,0
"Barbados","2024-10-04",0,0,0,0,0,0,0,0
"Barbados","2024-10-05",0,0,0,0,0,0,0,0
"Barbados","2024-10-06",0,0,0,0,0,0,0,0
"Barbados","2024-10-07",0,0,0,0,0,0,0,0
"Barbados","2024-10-08",0,0,0,0,0,0,0,0
"Barbados","2024-10-09",0,0,0,0,0,0,0,0
"Barbados","2024-10-10",0,0,0,0,0,0,0,0
"Barbados","2024-10-11",0,0,0,0,0,0,0,0
"Barbados","2024-10-12",0,0,0,0,0,0,0,0
"Barbados","2024-10-13",0,0,0,0,0,0,0,0
"Barbados","2024-10-14",0,0,0,0,0,0,0,0
"Barbados","2024-10-15",0,0,0,0,0,0,0,0
"Barbados","2024-10-16",0,0,0,0,0,0,0,0
"Barbados","2024-10-17",0,0,0,0,0,0,0,0
"Barbados","2024-10-18",0,0,0,0,0,0,0,0
"Barbados","2024-10-19",0,0,0,0,0,0,0,0
"Barbados","2024-10-20",0,0,0,0,0,0,0,0
"Barbados","2024-10-21",0,0,0,0,0,0,0,0
"Barbados","2024-10-22",0,0,0,0,0,0,0,0
"Barbados","2024-10-23",0,0,0,0,0,0,0,0
"Barbados","2024-10-24",0,0,0,0,0,0,0,0
"Barbados","2024-10-25",0,0,0,0,0,0,0,0
"Barbados","2024-10-26",0,0,0,0,0,0,0,0
"Barbados","2024-10-27",0,0,0,0,0,0,0,0
"Barbados","2024-10-28",0,0,0,0,0,0,0,0
"Barbados","2024-10-29",0,0,0,0,0,0,0,0
"Barbados","2024-10-30",0,0,0,0,0,0,0,0
"Barbados","2024-10-31",0,0,0,0,0,0,0,0
"Barbados","2024-11-01",0,0,0,0,0,0,0,0
"Barbados","2024-11-02",0,0,0,0,0,0,0,0
"Barbados","2024-11-03",0,0,0,0,0,0,0,0
"Barbados","2024-11-04",0,0,0,0,0,0,0,0
"Barbados","2024-11-05",0,0,0,0,0,0,0,0
"Barbados","2024-11-06",0,0,0,0,0,0,0,0
"Barbados","2024-11-07",0,0,0,0,0,0,0,0
"Barbados","2024-11-08",0,0,0,0,0,0,0,0
"Barbados","2024-11-09",0,0,0,0,0,0,0,0
"Barbados","2024-11-10",0,0,0,0,0,0,0,0
"Barbados","2024-11-11",0,0,0,0,0,0,0,0
"Barbados","2024-11-12",0,0,0,0,0,0,0,0
"Barbados","2024-11-13",0,0,0,0,0,0,0,0
"Barbados","2024-11-14",0,0,0,0,0,0,0,0
"Barbados","2024-11-15",0,0,0,0,0,0,0,0
"Barbados","2024-11-16",0,0,0,0,0,0,0,0
"Barbados","2024-11-17",0,0,0,0,0,0,0,0
"Barbados","2024-11-18",0,0,0,0,0,0,0,0
"Barbados","2024-11-19",0,0,0,0,0,0,0,0
"Barbados","2024-11-20",0,0,0,0,0,0,0,0
"Barbados","2024-11-21",0,0,0,0,0,0,0,0
"Barbados","2024-11-22",0,0,0,0,0,0,0,0
"Barbados","2024-11-23",0,0,0,0,0,0,0,0
"Barbados","2024-11-24",0,0,0,0,0,0,0,0
"Barbados","2024-11-25",0,0,0,0,0,0,0,0
"Barbados","2024-11-26",0,0,0,0,0,0,0,0
"Barbados","2024-11-27",0,0,0,0,0,0,0,0
"Barbados","2024-11-28",0,0,0,0,0,0,0,0
"Barbados","2024-11-29",0,0,0,0,0,0,0,0
"Barbados","2024-11-30",0,0,0,0,0,0,0,0
"Barbados","2024-12-01",0,0,0,0,0,0,0,0
"Barbados","2024-12-02",0,0,0,0,0,0,0,0
"Barbados","2024-12-03",0,0,0,0,0,0,0,0
"Barbados","2024-12-04",0,0,0,0,0,0,0,0
"Barbados","2024-12-05",0,0,0,0,0,0,0,0
"Barbados","2024-12-06",0,0,0,0,0,0,0,0
"Barbados","2024-12-07",0,0,0,0,0,0,0,0
"Barbados","2024-12-08",0,0,0,0,0,0,0,0
"Barbados","2024-12-09",0,0,0,0,0,0,0,0
"Barbados","2024-12-10",0,0,0,0,0,0,0,0
"Barbados","2024-12-11",0,0,0,0,0,0,0,0
"Barbados","2024-12-12",0,0,0,0,0,0,0,0
"Barbados","2024-12-13",0,0,0,0,0,0,0,0
"Barbados","2024-12-14",0,0,0,0,0,0,0,0
"Barbados","2024-12-15",0,0,0,0,0,0,0,0
"Barbados","2024-12-16",0,0,0,0,0,0,0,0
"Barbados","2024-12-17",0,0,0,0,0,0,0,0
"Barbados","2024-12-18",0,0,0,0,0,0,0,0
"Barbados","2024-12-19",0,0,0,0,0,0,0,0
"Barbados","2024-12-20",0,0,0,0,0,0,0,0
"Barbados","2024-12-21",0,0,0,0,0,0,0,0
"Barbados","2024-12-22",0,0,0,0,0,0,0,0
"Barbados","2024-12-23",0,0,0,0,0,0,0,0
"Barbados","2024-12-24",0,0,0,0,0,0,0,0
"Barbados","2024-12-25",0,0,0,0,0,0,0,0
"Barbados","2024-12-26",0,0,0,0,0,0,0,0
"Barbados","2024-12-27",0,0,0,0,0,0,0,0
"Barbados","2024-12-28",0,0,0,0,0,0,0,0
"Barbados","2024-12-29",0,0,0,0,0,0,0,0
"Barbados","2024-12-30",0,0,0,0,0,0,0,0
"Barbados","2024-12-31",0,0,0,0,0,0,0,0
"Barbados","2025-01-01",0,0,0,0,0,0,0,0
"Barbados","2025-01-02",0,0,0,0,0,0,0,0
"Barbados","2025-01-03",0,0,0,0,0,0,0,0
"Barbados","2025-01-04",0,0,0,0,0,0,0,0
"Barbados","2025-01-05",0,0,0,0,0,0,0,0
"Barbados","2025-01-06",0,0,0,0,0,0,0,0
"Barbados","2025-01-07",0,0,0,0,0,0,0,0
"Barbados","2025-01-08",0,0,0,0,0,0,0,0
"Barbados","2025-01-09",0,0,0,0,0,0,0,0
"Barbados","2025-01-10",0,0,0,0,0,0,0,0
"Barbados","2025-01-11",0,0,0,0,0,0,0,0
"Barbados","2025-01-12",0,0,0,0,0,0,0,0
"Barbados","2025-01-13",0,0,0,0,0,0,0,0
"Barbados","2025-01-14",0,0,0,0,0,0,0,0
"Barbados","2025-01-15",0,0,0,0,0,0,0,0
"Barbados","2025-01-16",0,0,0,0,0,0,0,0
"Barbados","2025-01-17",0,0,0,0,0,0,0,0
"Barbados","2025-01-18",0,0,0,0,0,0,0,0
"Barbados","2025-01-19",0,0,0,0,0,0,0,0
"Barbados","2025-01-20",0,0,0,0,0,0,0,0
"Barbados","2025-01-21",0,0,0,0,0,0,0,0
"Barbados","2025-01-22",0,0,0,0,0,0,0,0
"Barbados","2025-01-23",0,0,0,0,0,0,0,0
"Barbados","2025-01-24",0,0,0,0,0,0,0,0
"Barbados","2025-01-25",0,0,0,0,0,0,0,0
"Barbados","2025-01-26",0,0,0,0,0,0,0,0
"Barbados","2025-01-27",0,0,0,0,0,0,0,0
"Barbados","2025-01-28",0,0,0,0,0,0,0,0
"Barbados","2025-01-29",0,0,0,0,0,0,0,0
"Barbados","2025-01-30",0,0,0,0,0,0,0,0
"Barbados","2025-01-31",0,0,0,0,0,0,0,0
"Barbados","2025-02-01",0,0,0,0,0,0,0,0
"Barbados","2025-02-02",0,0,0,0,0,0,0,0
"Barbados","2025-02-03",0,0,0,0,0,0,0,0
"Barbados","2025-02-04",0,0,0,0,0,0,0,0
"Barbados","2025-02-05",0,0,0,0,0,0,0,0
"Barbados","2025-02-06",0,0,0,0,0,0,0,0
"Barbados","2025-02-07",0,0,0,0,0,0,0,0
"Barbados","2025-02-08",0,0,0,0,0,0,0,0
"Barbados","2025-02-09",0,0,0,0,0,0,0,0
"Barbados","2025-02-10",0,0,0,0,0,0,0,0
"Barbados","2025-02-11",0,0,0,0,0,0,0,0
"Barbados","2025-02-12",0,0,0,0,0,0,0,0
"Barbados","2025-02-13",0,0,0,0,0,0,0,0
"Barbados","2025-02-14",0,0,0,0,0,0,0,0
"Barbados","2025-02-15",0,0,0,0,0,0,0,0
"Barbados","2025-02-16",0,0,0,0,0,0,0,0
"Barbados","2025-02-17",0,0,0,0,0,0,0,0
"Barbados","2025-02-18",0,0,0,0,0,0,0,0
"Barbados","2025-02-19",0,0,0,0,0,0,0,0
"Barbados","2025-02-20",0,0,0,0,0,0,0,0
"Barbados","2025-02-21",0,0,0,0,0,0,0,0
"Barbados","2025-02-22",0,0,0,0,0,0,0,0
"Barbados","2025-02-23",0,0,0,0,0,0,0,0
"Barbados","2025-02-24",0,0,0,0,0,0,0,0
"Barbados","2025-02-25",0,0,0,0,0,0,0,0
"Barbados","2025-02-26",0,0,0,0,0,0,0,0
"Barbados","2025-02-27",0,0,0,0,0,0,0,0
"Barbados","2025-02-28",0,0,0,0,0,0,0,0
"Barbados","2025-03-01",0,0,0,0,0,0,0,0
"Barbados","2025-03-02",0,0,0,0,0,0,0,0
"Barbados","2025-03-03",0,0,0,0,0,0,0,0
"Belgium","2024-01-01",0,0,0,0,0,0,0,0
"Belgium","2024-01-02",0,0,0,0,0,0,0,0
"Belgium","2024-01-03",0,0,0,0,0,0,0,0
"Belgium","2024-01-04",0,0,0,0,0,0,0,0
"Belgium","2024-01-05",0,0,0,0,0,0,0,0
"Belgium","2024-01-06",0,0,0,0,0,0,0,0
"Belgium","2024-01-07",0,0,0,0,0,0,0,0
"Belgium","2024-01-08",0,0,0,0,0,0,0,0
"Belgium","2024-01-09",0,0,0,0,0,0,0,0
"Belgium","2024-01-10",0,0,0,0,0,0,0,0
"Belgium","2024-01-11",0,0,0,0,0,0,0,0
"Belgium","2024-01-12",0,0,0,0,0,0,0,0
"Belgium","2024-01-13",0,0,0,0,0,0,0,0
"Belgium","2024-01-14",0,0,0,0,0,0,0,0
"Belgium","2024-01-15",0,0,0,0,0,0,0,0
"Belgium","2024-01-16",0,0,0,0,0,0,0,0
"Belgium","2024-01-17",0,0,0,0,0,0,0,0
"Belgium","2024-01-18",0,0,0,0,0,0,0,0
"Belgium","2024-01-19",0,0,0,0,0,0,0,0
"Belgium","2024-01-20",0,0,0,0,0,0,0,0
"Belgium","2024-01-21",0,0,0,0,0,0,0,0
"Belgium","2024-01-22",0,0,0,0,0,0,0,0
"Belgium","2024-01-23",0,0,0,0,0,0,0,0
"Belgium","2024-01-24",0,0,0,0,0,0,0,0
"Belgium","2024-01-25",0,0,0,0,0,0,0,0
"Belgium","2024-01-26",0,0,0,0,0,0,0,0
"Belgium","2024-01-27",0,0,0,0,0,0,0,0
"Belgium","2024-01-28",0,0,0,0,0,0,0,0
"Belgium","2024-01-29",0,0,0,0,0,0,0,0
"Belgium","2024-01-30",0,0,0,0,0,0,0,0
"Belgium","2024-01-31",0,3,3,0,3,3,0,0
"Belgium","2024-02-01",0,0,3,0,0,3,0,0
"Belgium","2024-02-02",0,0,3,0,0,3,0,0
"Belgium","2024-02-03",0,0,3,0,0,3,0,0
"Belgium","2024-02-04",0,0,3,0,0,3,0,0
"Belgium","2024-02-05",0,0,3,0,0,3,0,0
"Belgium","2024-02-06",0,0,3,0,0,3,0,0
"Belgium","2024-02-07",0,0,3,0,0,3,0,0
"Belgium","2024-02-08",0,0,3,0,1,4,0,0
"Belgium","2024-02-09",0,0,3,0,0,4,0,0
"Belgium","2024-02-10",0,0,3,0,0,4,0,0
"Belgium","2024-02-11",0,0,3,0,0,4,0,0
"Belgium","2024-02-12",0,0,3,0,0,4,0,0
"Belgium","2024-02-13",0,0,3,0,0,4,0,0
"Belgium","2024-02-14",0,0,3,0,0,4,0,0
"Belgium","2024-02-15",0,0,3,0,0,4,0,0
"Belgium","2024-02-16",0,0,3,0,0,4,0,0
"Belgium","2024-02-17",0,0,3,0,0,4,0,0
"Belgium","2024-02-18",0,0,3,0,0,4,0,0
"Belgium","2024-02-19",0,0,3,0,0,4,0,0
"Belgium","2024-02-20",0,0,3,0,0,4,0,0
"Belgium","2024-02-21",0,0,3,0,0,4,0,0
"Belgium","2024-02-22",0,0,3,0,1,5,0,0
"Belgium","2024-02-23",0,0,3,0,0,5,0,0
"Belgium","2024-02-24",0,0,3,0,0,5,0,0
"Belgium","2024-02-25",0,0,3,0,0,5,0,0
"Belgium","2024-02-26",0,0,3,0,0,5,0,0
"Belgium","2024-02-27",0,0,3,0,0,5,0,0
"Belgium","2024-02-28",0,0,3,0,0,5,0,0
"Belgium","2024-02-29",0,2,5,0,0,5,0,0
"Belgium","2024-03-01",0,0,5,0,0,5,0,0
"Belgium","2024-03-02",0,0,5,0,0,5,0,0
"Belgium","2024-03-03",0,0,5,0,0,5,0,0
"Belgium","2024-03-04",0,0,5,0,0,5,0,0
"Belgium","2024-03-05",0,0,5,0,0,5,0,0
"Belgium","2024-03-06",0,0,5,0,0,5,0,0
"Belgium","2024-03-07",0,0,5,0,0,5,0,0
"Belgium","2024-03-08",0,0,5,0,0,5,0,0
"Belgium","2024-03-09",0,0,5,0,0,5,0,0
"Belgium","2024-03-10",0,0,5,0,0,5,0,0
"Belgium","2024-03-11",0,0,5,0,0,5,0,0
"Belgium","2024-03-12",0,0,5,0,0,5,0,0
"Belgium","2024-03-13",0,0,5,0,0,5,0,0
"Belgium","2024-03-14",0,0,5,0,0,5,0,0
"Belgium","2024-03-15",0,0,5,0,0,5,0,0
"Belgium","2024-03-16",0,0,5,0,1,6,0,0
"Belgium","2024-03-17",0,0,5,0,0,6,0,0
"Belgium","2024-03-18",0,0,5,0,0,6,0,0
"Belgium","2024-03-19",0,0,5,0,0,6,0,0
"Belgium","2024-03-20",0,0,5,0,0,6,0,0
"Belgium","2024-03-21",0,0,5,0,0,6,0,0
"Belgium","2024-03-22",0,0,5,0,0,6,0,0
"Belgium","2024-03-23",0,0,5,0,0,6,0,0
"Belgium","2024-03-24",0,0,5,0,0,6,0,0
"Belgium","2024-03-25",0,0,5,0,0,6,0,0
"Belgium","2024-03-26",0,0,5,0,0,6,0,0
"Belgium","2024-03-27",0,0,5,0,0,6,0,0
"Belgium","2024-03-28",0,0,5,0,0,6,0,0
"Belgium","2024-03-29",0,0,5,0,0,6,0,0
"Belgium","2024-03-30",0,0,5,0,0,6,0,0
"Belgium","2024-03-31",0,1,6,0,0,6,0,0
"Belgium","2024-04-01",0,0,6,0,0,6,0,0
"Belgium","2024-04-02",0,0,6,0,0,6,0,0
"Belgium","2024-04-03",0,0,6,0,0,6,0,0
"Belgium","2024-04-04",0,0,6,0,0,6,0,0
"Belgium","2024-04-05",0,0,6,0,0,6,0,0
"Belgium","2024-04-06",0,0,6,0,1,7,0,0
"Belgium","2024-04-07",0,0,6,0,0,7,0,0
"Belgium","2024-04-08",0,0,6,0,0,7,0,0
"Belgium","2024-04-09",0,0,6,0,0,7,0,0
"Belgium","2024-04-10",0,0,6,0,0,7,0,0
"Belgium","2024-04-11",0,0,6,0,0,7,0,0
"Belgium","2024-04-12",0,0,6,0,0,7,0,0
"Belgium","2024-04-13",0,0,6,0,0,7,0,0
"Belgium","2024-04-14",0,0,6,0,0,7,0,0
"Belgium","2024-04-15",0,0,6,0,1,8,0,0
"Belgium","2024-04-16",0,0,6,0,0,8,0,0
"Belgium","2024-04-17",0,0,6,0,0,8,0,0
"Belgium","2024-04-18",0,0,6,0,0,8,0,0
"Belgium","2024-04-19",0,0,6,0,0,8,0,0
"Belgium","2024-04-20",0,0,6,0,0,8,0,0
"Belgium","2024-04-21",0,0,6,0,0,8,0,0
"Belgium","2024-04-22",0,0,6,0,0,8,0,0
"Belgium","2024-04-23",0,0,6,0,0,8,0,0
"Belgium","2024-04-24",0,0,6,0,0,8,0,0
"Belgium","2024-04-25",0,0,6,0,0,8,0,0
"Belgium","2024-04-26",0,0,6,0,1,9,0,0
"Belgium","2024-04-27",0,0,6,0,0,9,0,0
"Belgium","2024-04-28",0,0,6,0,0,9,0,0
"Belgium","2024-04-29",0,0,6,0,0,9,0,0
"Belgium","2024-04-30",0,3,9,0,0,9,0,0
"Belgium","2024-05-01",0,0,9,0,0,9,0,0
"Belgium","2024-05-02",0,0,9,0,0,9,0,0
"Belgium","2024-05-03",0,0,9,0,0,9,0,0
"Belgium","2024-05-04",0,0,9,0,0,9,0,0
"Belgium","2024-05-05",0,0,9,0,0,9,0,0
"Belgium","2024-05-06",0,0,9,0,0,9,0,0
"Belgium","2024-05-07",0,0,9,0,0,9,0,0
"Belgium","2024-05-08",0,0,9,0,0,9,0,0
"Belgium","2024-05-09",0,0,9,0,0,9,0,0
"Belgium","2024-05-10",0,0,9,0,0,9,0,0
"Belgium","2024-05-11",0,0,9,0,0,9,0,0
"Belgium","2024-05-12",0,0,9,0,0,9,0,0
"Belgium","2024-05-13",0,0,9,0,0,9,0,0
"Belgium","2024-05-14",0,0,9,0,0,9,0,0
"Belgium","2024-05-15",0,0,9,0,0,9,0,0
"Belgium","2024-05-16",0,0,9,0,0,9,0,0
"Belgium","2024-05-17",0,0,9,0,0,9,0,0
"Belgium","2024-05-18",0,0,9,0,0,9,0,0
"Belgium","2024-05-19",0,0,9,0,0,9,0,0
"Belgium","2024-05-20",0,0,9,0,0,9,0,0
"Belgium","2024-05-21",0,0,9,0,0,9,0,0
"Belgium","2024-05-22",0,0,9,0,0,9,0,0
"Belgium","2024-05-23",0,0,9,0,0,9,0,0
"Belgium","2024-05-24",0,0,9,0,0,9,0,0
"Belgium","2024-05-25",0,0,9,0,0,9,0,0
"Belgium","2024-05-26",0,0,9,0,0,9,0,0
"Belgium","2024-05-27",0,0,9,0,0,9,0,0
"Belgium","2024-05-28",0,0,9,0,0,9,0,0
"Belgium","2024-05-29",0,0,9,0,0,9,0,0
"Belgium","2024-05-30",0,0,9,0,0,9,0,0
"Belgium","2024-05-31",0,0,9,0,1,10,0,0
"Belgium","2024-06-01",0,0,9,0,0,10,0,0
"Belgium","2024-06-02",0,0,9,0,0,10,0,0
"Belgium","2024-06-03",0,0,9,0,0,10,0,0
"Belgium","2024-06-04",0,0,9,0,0,10,0,0
"Belgium","2024-06-05",0,0,9,0,0,10,0,0
"Belgium","2024-06-06",0,0,9,0,0,10,0,0
"Belgium","2024-06-07",0,0,9,0,0,10,0,0
"Belgium","2024-06-08",0,0,9,0,0,10,0,0
"Belgium","2024-06-09",0,0,9,0,0,10,0,0
"Belgium","2024-06-10",0,0,9,0,0,10,0,0
"Belgium","2024-06-11",0,0,9,0,0,10,0,0
"Belgium","2024-06-12",0,0,9,0,0,10,0,0
"Belgium","2024-06-13",0,0,9,0,0,10,0,0
"Belgium","2024-06-14",0,0,9,0,0,10,0,0
"Belgium","2024-06-15",0,0,9,0,0,10,0,0
"Belgium","2024-06-16",0,0,9,0,0,10,0,0
"Belgium","2024-06-17",0,0,9,0,0,10,0,0
"Belgium","2024-06-18",0,0,9,0,0,10,0,0
"Belgium","2024-06-19",0,0,9,0,0,10,0,0
"Belgium","2024-06-20",0,0,9,0,0,10,0,0
"Belgium","2024-06-21",0,0,9,0,0,10,0,0
"Belgium","2024-06-22",0,0,9,0,0,10,0,0
"Belgium","2024-06-23",0,0,9,0,0,10,0,0
"Belgium","2024-06-24",0,0,9,0,0,10,0,0
"Belgium","2024-06-25",0,0,9,0,0,10,0,0
"Belgium","2024-06-26",0,0,9,0,0,10,0,0
"Belgium","2024-06-27",0,0,9,0,0,10,0,0
"Belgium","2024-06-28",0,0,9,0,0,10,0,0
"Belgium","2024-06-29",0,0,9,0,0,10,0,0
"Belgium","2024-06-30",0,1,10,0,0,10,0,0
"Belgium","2024-07-01",0,0,10,0,0,10,0,0
"Belgium","2024-07-02",0,0,10,0,0,10,0,0
"Belgium","2024-07-03",0,0,10,0,0,10,0,0
"Belgium","2024-07-04",0,0,10,0,0,10,0,0
"Belgium","2024-07-05",0,0,10,0,0,10,0,0
"Belgium","2024-07-06",0,0,10,0,0,10,0,0
"Belgium","2024-07-07",0,0,10,0,0,10,0,0
"Belgium","2024-07-08",0,0,10,0,0,10,0,0
"Belgium","2024-07-09",0,0,10,0,0,10,0,0
"Belgium","2024-07-10",0,0,10,0,0,10,0,0
"Belgium","2024-07-11",0,0,10,0,0,10,0,0
"Belgium","2024-07-12",0,0,10,0,0,10,0,0
"Belgium","2024-07-13",0,0,10,0,0,10,0,0
"Belgium","2024-07-14",0,0,10,0,0,10,0,0
"Belgium","2024-07-15",0,0,10,0,0,10,0,0
"Belgium","2024-07-16",0,0,10,0,1,11,0,0
"Belgium","2024-07-17",0,0,10,0,0,11,0,0
"Belgium","2024-07-18",0,0,10,0,0,11,0,0
"Belgium","2024-07-19",0,0,10,0,0,11,0,0
"Belgium","2024-07-20",0,0,10,0,0,11,0,0
"Belgium","2024-07-21",0,0,10,0,0,11,0,0
"Belgium","2024-07-22",0,0,10,0,0,11,0,0
"Belgium","2024-07-23",0,0,10,0,0,11,0,0
"Belgium","2024-07-24",0,0,10,0,0,11,0,0
"Belgium","2024-07-25",0,0,10,0,0,11,0,0
"Belgium","2024-07-26",0,0,10,0,0,11,0,0
"Belgium","2024-07-27",0,0,10,0,0,11,0,0
"Belgium","2024-07-28",0,0,10,0,0,11,0,0
"Belgium","2024-07-29",0,0,10,0,0,11,0,0
"Belgium","2024-07-30",0,0,10,0,0,11,0,0
"Belgium","2024-07-31",0,1,11,0,0,11,0,0
"Belgium","2024-08-01",0,0,11,0,0,11,0,0
"Belgium","2024-08-02",0,0,11,0,0,11,0,0
"Belgium","2024-08-03",0,0,11,0,0,11,0,0
"Belgium","2024-08-04",0,0,11,0,0,11,0,0
"Belgium","2024-08-05",0,0,11,0,0,11,0,0
"Belgium","2024-08-06",0,0,11,0,1,12,0,0
"Belgium","2024-08-07",0,0,11,0,0,12,0,0
"Belgium","2024-08-08",0,0,11,0,0,12,0,0
"Belgium","2024-08-09",0,0,11,0,0,12,0,0
"Belgium","2024-08-10",0,0,11,0,0,12,0,0
"Belgium","2024-08-11",0,0,11,0,0,12,0,0
"Belgium","2024-08-12",0,0,11,0,0,12,0,0
"Belgium","2024-08-13",0,0,11,0,0,12,0,0
"Belgium","2024-08-14",0,0,11,0,0,12,0,0
"Belgium","2024-08-15",0,0,11,0,0,12,0,0
"Belgium","2024-08-16",0,0,11,0,1,13,0,0
"Belgium","2024-08-17",0,0,11,0,0,13,0,0
"Belgium","2024-08-18",0,0,11,0,0,13,0,0
"Belgium","2024-08-19",0,0,11,0,0,13,0,0
"Belgium","2024-08-20",0,0,11,0,0,13,0,0
"Belgium","2024-08-21",0,0,11,0,0,13,0,0
"Belgium","2024-08-22",0,0,11,0,0,13,0,0
"Belgium","2024-08-23",0,0,11,0,0,13,0,0
"Belgium","2024-08-24",0,0,11,0,0,13,0,0
"Belgium","2024-08-25",0,0,11,0,0,13,0,0
"Belgium","2024-08-26",0,0,11,0,1,14,0,0
"Belgium","2024-08-27",0,0,11,0,0,14,0,0
"Belgium","2024-08-28",0,0,11,0,0,14,0,0
"Belgium","2024-08-29",0,0,11,0,0,14,0,0
"Belgium","2024-08-30",0,0,11,0,0,14,0,0
"Belgium","2024-08-31",0,3,14,0,0,14,0,0
"Belgium","2024-09-01",0,0,14,0,0,14,0,0
"Belgium","2024-09-02",0,0,14,0,1,15,0,0
"Belgium","2024-09-03",0,0,14,0,0,15,0,0
"Belgium","2024-09-04",0,0,14,0,0,15,0,0
"Belgium","2024-09-05",0,0,14,0,0,15,0,0
"Belgium","2024-09-06",0,0,14,0,1,16,0,0
"Belgium","2024-09-07",0,0,14,0,0,16,0,0
"Belgium","2024-09-08",0,0,14,0,0,16,0,0
"Belgium","2024-09-09",0,0,14,0,0,16,0,0
"Belgium","2024-09-10",0,0,14,0,1,17,0,0
"Belgium","2024-09-11",0,0,14,0,0,17,0,0
"Belgium","2024-09-12",0,0,14,0,0,17,0,0
"Belgium","2024-09-13",0,0,14,0,0,17,0,0
"Belgium","2024-09-14",0,0,14,0,1,18,0,0
"Belgium","2024-09-15",0,0,14,0,0,18,0,0
"Belgium","2024-09-16",0,0,14,0,0,18,0,0
"Belgium","2024-09-17",0,0,14,0,1,19,0,0
"Belgium","2024-09-18",0,0,14,0,0,19,0,0
"Belgium","2024-09-19",0,0,14,0,0,19,0,0
"Belgium","2024-09-20",0,0,14,0,0,19,0,0
"Belgium","2024-09-21",0,0,14,0,1,20,0,0
"Belgium","2024-09-22",0,0,14,0,0,20,0,0
"Belgium","2024-09-23",0,0,14,0,0,20,0,0
"Belgium","2024-09-24",0,0,14,0,0,20,0,0
"Belgium","2024-09-25",0,0,14,0,1,21,0,0
"Belgium","2024-09-26",0,0,14,0,0,21,0,0
"Belgium","2024-09-27",0,0,14,0,0,21,0,0
"Belgium","2024-09-28",0,0,14,0,0,21,0,0
"Belgium","2024-09-29",0,0,14,0,1,22,0,0
"Belgium","2024-09-30",0,8,22,0,0,22,0,0
"Belgium","2024-10-01",0,0,22,0,1,23,0,0
"Belgium","2024-10-02",0,0,22,0,0,23,0,0
"Belgium","2024-10-03",0,0,22,0,1,24,0,0
"Belgium","2024-10-04",0,0,22,0,0,24,0,0
"Belgium","2024-10-05",0,0,22,0,1,25,0,0
"Belgium","2024-10-06",0,0,22,0,0,25,0,0
"Belgium","2024-10-07",0,0,22,0,1,26,0,0
"Belgium","2024-10-08",0,0,22,0,0,26,0,0
"Belgium","2024-10-09",0,0,22,0,1,27,0,0
"Belgium","2024-10-10",0,0,22,0,0,27,0,0
"Belgium","2024-10-11",0,0,22,0,1,28,0,0
"Belgium","2024-10-12",0,0,22,0,1,29,0,0
"Belgium","2024-10-13",0,0,22,0,0,29,0,0
"Belgium","2024-10-14",0,0,22,0,1,30,0,0
"Belgium","2024-10-15",0,0,22,0,0,30,0,0
"Belgium","2024-10-16",0,0,22,0,1,31,0,0
"Belgium","2024-10-17",0,0,22,0,0,31,0,0
"Belgium","2024-10-18",0,0,22,0,1,32,0,0
"Belgium","2024-10-19",0,0,22,0,0,32,0,0
"Belgium","2024-10-20",0,0,22,0,1,33,0,0
"Belgium","2024-10-21",0,0,22,0,1,34,0,0
"Belgium","2024-10-22",0,0,22,0,0,34,0,0
"Belgium","2024-10-23",0,0,22,0,1,35,0,0
"Belgium","2024-10-24",0,0,22,0,0,35,0,0
"Belgium","2024-10-25",0,0,22,0,1,36,0,0
"Belgium","2024-10-26",0,0,22,0,0,36,0,0
"Belgium","2024-10-27",0,0,22,0,1,37,0,0
"Belgium","2024-10-28",0,0,22,0,0,37,0,0
"Belgium","2024-10-29",0,0,22,0,1,38,0,0
"Belgium","2024-10-30",0,0,22,0,0,38,0,0
"Belgium","2024-10-31",0,17,39,0,1,39,0,0
"Belgium","2024-11-01",0,0,39,0,0,39,0,0
"Belgium","2024-11-02",0,0,39,0,0,39,0,0
"Belgium","2024-11-03",0,0,39,0,1,40,0,0
"Belgium","2024-11-04",0,0,39,0,0,40,0,0
"Belgium","2024-11-05",0,0,39,0,0,40,0,0
"Belgium","2024-11-06",0,0,39,0,0,40,0,0
"Belgium","2024-11-07",0,0,39,0,0,40,0,0
"Belgium","2024-11-08",0,0,39,0,1,41,0,0
"Belgium","2024-11-09",0,0,39,0,0,41,0,0
"Belgium","2024-11-10",0,0,39,0,0,41,0,0
"Belgium","2024-11-11",0,0,39,0,0,41,0,0
"Belgium","2024-11-12",0,0,39,0,0,41,0,0
"Belgium","2024-11-13",0,0,39,0,1,42,0,0
"Belgium","2024-11-14",0,0,39,0,0,42,0,0
"Belgium","2024-11-15",0,0,39,0,0,42,0,0
"Belgium","2024-11-16",0,0,39,0,0,42,0,0
"Belgium","2024-11-17",0,0,39,0,0,42,0,0
"Belgium","2024-11-18",0,0,39,0,1,43,0,0
"Belgium","2024-11-19",0,0,39,0,0,43,0,0
"Belgium","2024-11-20",0,0,39,0,0,43,0,0
"Belgium","2024-11-21",0,0,39,0,0,43,0,0
"Belgium","2024-11-22",0,0,39,0,0,43,0,0
"Belgium","2024-11-23",0,0,39,0,1,44,0,0
"Belgium","2024-11-24",0,0,39,0,0,44,0,0
"Belgium","2024-11-25",0,0,39,0,0,44,0,0
"Belgium","2024-11-26",0,0,39,0,0,44,0,0
"Belgium","2024-11-27",0,0,39,0,0,44,0,0
"Belgium","2024-11-28",0,0,39,0,1,45,0,0
"Belgium","2024-11-29",0,0,39,0,0,45,0,0
"Belgium","2024-11-30",0,6,45,0,0,45,0,0
"Belgium","2024-12-01",0,0,45,0,0,45,0,0
"Belgium","2024-12-02",0,0,45,0,0,45,0,0
"Belgium","2024-12-03",0,0,45,0,1,46,0,0
"Belgium","2024-12-04",0,0,45,0,0,46,0,0
"Belgium","2024-12-05",0,0,45,0,0,46,0,0
"Belgium","2024-12-06",0,0,45,0,0,46,0,0
"Belgium","2024-12-07",0,0,45,0,1,47,0,0
"Belgium","2024-12-08",0,0,45,0,0,47,0,0
"Belgium","2024-12-09",0,0,45,0,0,47,0,0
"Belgium","2024-12-10",0,0,45,0,0,47,0,0
"Belgium","2024-12-11",0,0,45,0,0,47,0,0
"Belgium","2024-12-12",0,0,45,0,1,48,0,0
"Belgium","2024-12-13",0,0,45,0,0,48,0,0
"Belgium","2024-12-14",0,0,45,0,0,48,0,0
"Belgium","2024-12-15",0,0,45,0,0,48,0,0
"Belgium","2024-12-16",0,0,45,0,1,49,0,0
"Belgium","2024-12-17",0,0,45,0,0,49,0,0
"Belgium","2024-12-18",0,0,45,0,0,49,0,0
"Belgium","2024-12-19",0,0,45,0,0,49,0,0
"Belgium","2024-12-20",0,0,45,0,1,50,0,0
"Belgium","2024-12-21",0,0,45,0,0,50,0,0
"Belgium","2024-12-22",0,0,45,0,0,50,0,0
"Belgium","2024-12-23",0,0,45,0,0,50,0,0
"Belgium","2024-12-24",0,0,45,0,0,50,0,0
"Belgium","2024-12-25",0,0,45,0,1,51,0,0
"Belgium","2024-12-26",0,0,45,0,0,51,0,0
"Belgium","2024-12-27",0,0,45,0,0,51,0,0
"Belgium","2024-12-28",0,0,45,0,0,51,0,0
"Belgium","2024-12-29",0,0,45,0,1,52,0,0
"Belgium","2024-12-30",0,0,45,0,0,52,0,0
"Belgium","2024-12-31",0,7,52,0,0,52,0,0
"Belgium","2025-01-01",0,0,52,0,0,52,0,0
"Belgium","2025-01-02",0,0,52,0,1,53,0,0
"Belgium","2025-01-03",0,0,52,0,0,53,0,0
"Belgium","2025-01-04",0,0,52,0,1,54,0,0
"Belgium","2025-01-05",0,0,52,0,0,54,0,0
"Belgium","2025-01-06",0,0,52,0,0,54,0,0
"Belgium","2025-01-07",0,0,52,0,1,55,0,0
"Belgium","2025-01-08",0,0,52,0,0,55,0,0
"Belgium","2025-01-09",0,0,52,0,1,56,0,0
"Belgium","2025-01-10",0,4,56,0,0,56,0,0
"Belgium","2025-01-11",0,0,56,0,0,56,0,0
"Belgium","2025-01-12",0,0,56,0,0,56,0,0
"Belgium","2025-01-13",0,0,56,0,0,56,0,0
"Belgium","2025-01-14",0,0,56,0,0,56,0,0
"Belgium","2025-01-15",0,0,56,0,0,56,0,0
"Belgium","2025-01-16",0,0,56,0,0,56,0,0
"Belgium","2025-01-17",0,0,56,0,0,56,0,0
"Belgium","2025-01-18",0,0,56,0,0,56,0,0
"Belgium","2025-01-19",0,0,56,0,0,56,0,0
"Belgium","2025-01-20",0,0,56,0,0,56,0,0
"Belgium","2025-01-21",0,0,56,0,0,56,0,0
"Belgium","2025-01-22",0,0,56,0,0,56,0,0
"Belgium","2025-01-23",0,0,56,0,0,56,0,0
"Belgium","2025-01-24",0,0,56,0,0,56,0,0
"Belgium","2025-01-25",0,0,56,0,0,56,0,0
"Belgium","2025-01-26",0,0,56,0,0,56,0,0
"Belgium","2025-01-27",0,0,56,0,0,56,0,0
"Belgium","2025-01-28",0,0,56,0,0,56,0,0
"Belgium","2025-01-29",0,0,56,0,0,56,0,0
"Belgium","2025-01-30",0,0,56,0,0,56,0,0
"Belgium","2025-01-31",0,0,56,0,0,56,0,0
"Belgium","2025-02-01",0,0,56,0,0,56,0,0
"Belgium","2025-02-02",0,0,56,0,0,56,0,0
"Belgium","2025-02-03",0,0,56,0,0,56,0,0
"Belgium","2025-02-04",0,0,56,0,0,56,0,0
"Belgium","2025-02-05",0,0,56,0,0,56,0,0
"Belgium","2025-02-06",0,0,56,0,0,56,0,0
"Belgium","2025-02-07",0,0,56,0,0,56,0,0
"Belgium","2025-02-08",0,0,56,0,0,56,0,0
"Belgium","2025-02-09",0,0,56,0,0,56,0,0
"Belgium","2025-02-10",0,0,56,0,0,56,0,0
"Belgium","2025-02-11",0,0,56,0,0,56,0,0
"Belgium","2025-02-12",0,0,56,0,0,56,0,0
"Belgium","2025-02-13",0,0,56,0,0,56,0,0
"Belgium","2025-02-14",0,0,56,0,0,56,0,0
"Belgium","2025-02-15",0,0,56,0,0,56,0,0
"Belgium","2025-02-16",0,0,56,0,0,56,0,0
"Belgium","2025-02-17",0,0,56,0,0,56,0,0
"Belgium","2025-02-18",0,0,56,0,0,56,0,0
"Belgium","2025-02-19",0,0,56,0,0,56,0,0
"Belgium","2025-02-20",0,0,56,0,0,56,0,0
"Belgium","2025-02-21",0,0,56,0,0,56,0,0
"Belgium","2025-02-22",0,0,56,0,0,56,0,0
"Belgium","2025-02-23",0,0,56,0,0,56,0,0
"Belgium","2025-02-24",0,0,56,0,0,56,0,0
"Belgium","2025-02-25",0,0,56,0,0,56,0,0
"Belgium","2025-02-26",0,0,56,0,0,56,0,0
"Belgium","2025-02-27",0,0,56,0,0,56,0,0
"Belgium","2025-02-28",0,0,56,0,0,56,0,0
"Belgium","2025-03-01",0,0,56,0,0,56,0,0
"Belgium","2025-03-02",0,0,56,0,0,56,0,0
"Belgium","2025-03-03",0,0,56,0,0,56,0,0
"Benin","2024-01-01",0,0,0,0,0,0,0,0
"Benin","2024-01-02",0,0,0,0,0,0,0,0
"Benin","2024-01-03",0,0,0,0,0,0,0,0
"Benin","2024-01-04",0,0,0,0,0,0,0,0
"Benin","2024-01-05",0,0,0,0,0,0,0,0
"Benin","2024-01-06",0,0,0,0,0,0,0,0
"Benin","2024-01-07",0,0,0,0,0,0,0,0
"Benin","2024-01-08",0,0,0,0,0,0,0,0
"Benin","2024-01-09",0,0,0,0,0,0,0,0
"Benin","2024-01-10",0,0,0,0,0,0,0,0
"Benin","2024-01-11",0,0,0,0,0,0,0,0
"Benin","2024-01-12",0,0,0,0,0,0,0,0
"Benin","2024-01-13",0,0,0,0,0,0,0,0
"Benin","2024-01-14",0,0,0,0,0,0,0,0
"Benin","2024-01-15",0,0,0,0,0,0,0,0
"Benin","2024-01-16",0,0,0,0,0,0,0,0
"Benin","2024-01-17",0,0,0,0,0,0,0,0
"Benin","2024-01-18",0,0,0,0,0,0,0,0
"Benin","2024-01-19",0,0,0,0,0,0,0,0
"Benin","2024-01-20",0,0,0,0,0,0,0,0
"Benin","2024-01-21",0,0,0,0,0,0,0,0
"Benin","2024-01-22",0,0,0,0,0,0,0,0
"Benin","2024-01-23",0,0,0,0,0,0,0,0
"Benin","2024-01-24",0,0,0,0,0,0,0,0
"Benin","2024-01-25",0,0,0,0,0,0,0,0
"Benin","2024-01-26",0,0,0,0,0,0,0,0
"Benin","2024-01-27",0,0,0,0,0,0,0,0
"Benin","2024-01-28",0,0,0,0,0,0,0,0
"Benin","2024-01-29",0,0,0,0,0,0,0,0
"Benin","2024-01-30",0,0,0,0,0,0,0,0
"Benin","2024-01-31",0,0,0,0,0,0,0,0
"Benin","2024-02-01",0,0,0,0,0,0,0,0
"Benin","2024-02-02",0,0,0,0,0,0,0,0
"Benin","2024-02-03",0,0,0,0,0,0,0,0
"Benin","2024-02-04",0,0,0,0,0,0,0,0
"Benin","2024-02-05",0,0,0,0,0,0,0,0
"Benin","2024-02-06",0,0,0,0,0,0,0,0
"Benin","2024-02-07",0,0,0,0,0,0,0,0
"Benin","2024-02-08",0,0,0,0,0,0,0,0
"Benin","2024-02-09",0,0,0,0,0,0,0,0
"Benin","2024-02-10",0,0,0,0,0,0,0,0
"Benin","2024-02-11",0,0,0,0,0,0,0,0
"Benin","2024-02-12",0,0,0,0,0,0,0,0
"Benin","2024-02-13",0,0,0,0,0,0,0,0
"Benin","2024-02-14",0,0,0,0,0,0,0,0
"Benin","2024-02-15",0,0,0,0,0,0,0,0
"Benin","2024-02-16",0,0,0,0,0,0,0,0
"Benin","2024-02-17",0,0,0,0,0,0,0,0
"Benin","2024-02-18",0,0,0,0,0,0,0,0
"Benin","2024-02-19",0,0,0,0,0,0,0,0
"Benin","2024-02-20",0,0,0,0,0,0,0,0
"Benin","2024-02-21",0,0,0,0,0,0,0,0
"Benin","2024-02-22",0,0,0,0,0,0,0,0
"Benin","2024-02-23",0,0,0,0,0,0,0,0
"Benin","2024-02-24",0,0,0,0,0,0,0,0
"Benin","2024-02-25",0,0,0,0,0,0,0,0
"Benin","2024-02-26",0,0,0,0,0,0,0,0
"Benin","2024-02-27",0,0,0,0,0,0,0,0
"Benin","2024-02-28",0,0,0,0,0,0,0,0
"Benin","2024-02-29",0,0,0,0,0,0,0,0
"Benin","2024-03-01",0,0,0,0,0,0,0,0
"Benin","2024-03-02",0,0,0,0,0,0,0,0
"Benin","2024-03-03",0,0,0,0,0,0,0,0
"Benin","2024-03-04",0,0,0,0,0,0,0,0
"Benin","2024-03-05",0,0,0,0,0,0,0,0
"Benin","2024-03-06",0,0,0,0,0,0,0,0
"Benin","2024-03-07",0,0,0,0,0,0,0,0
"Benin","2024-03-08",0,0,0,0,0,0,0,0
"Benin","2024-03-09",0,0,0,0,0,0,0,0
"Benin","2024-03-10",0,0,0,0,0,0,0,0
"Benin","2024-03-11",0,0,0,0,0,0,0,0
"Benin","2024-03-12",0,0,0,0,0,0,0,0
"Benin","2024-03-13",0,0,0,0,0,0,0,0
"Benin","2024-03-14",0,0,0,0,0,0,0,0
"Benin","2024-03-15",0,0,0,0,0,0,0,0
"Benin","2024-03-16",0,0,0,0,0,0,0,0
"Benin","2024-03-17",0,0,0,0,0,0,0,0
"Benin","2024-03-18",0,0,0,0,0,0,0,0
"Benin","2024-03-19",0,0,0,0,0,0,0,0
"Benin","2024-03-20",0,0,0,0,0,0,0,0
"Benin","2024-03-21",0,0,0,0,0,0,0,0
"Benin","2024-03-22",0,0,0,0,0,0,0,0
"Benin","2024-03-23",0,0,0,0,0,0,0,0
"Benin","2024-03-24",0,0,0,0,0,0,0,0
"Benin","2024-03-25",0,0,0,0,0,0,0,0
"Benin","2024-03-26",0,0,0,0,0,0,0,0
"Benin","2024-03-27",0,0,0,0,0,0,0,0
"Benin","2024-03-28",0,0,0,0,0,0,0,0
"Benin","2024-03-29",0,0,0,0,0,0,0,0
"Benin","2024-03-30",0,0,0,0,0,0,0,0
"Benin","2024-03-31",0,0,0,0,0,0,0,0
"Benin","2024-04-01",0,0,0,0,0,0,0,0
"Benin","2024-04-02",0,0,0,0,0,0,0,0
"Benin","2024-04-03",0,0,0,0,0,0,0,0
"Benin","2024-04-04",0,0,0,0,0,0,0,0
"Benin","2024-04-05",0,0,0,0,0,0,0,0
"Benin","2024-04-06",0,0,0,0,0,0,0,0
"Benin","2024-04-07",0,0,0,0,0,0,0,0
"Benin","2024-04-08",0,0,0,0,0,0,0,0
"Benin","2024-04-09",0,0,0,0,0,0,0,0
"Benin","2024-04-10",0,0,0,0,0,0,0,0
"Benin","2024-04-11",0,0,0,0,0,0,0,0
"Benin","2024-04-12",0,0,0,0,0,0,0,0
"Benin","2024-04-13",0,0,0,0,0,0,0,0
"Benin","2024-04-14",0,0,0,0,0,0,0,0
"Benin","2024-04-15",0,0,0,0,0,0,0,0
"Benin","2024-04-16",0,0,0,0,0,0,0,0
"Benin","2024-04-17",0,0,0,0,0,0,0,0
"Benin","2024-04-18",0,0,0,0,0,0,0,0
"Benin","2024-04-19",0,0,0,0,0,0,0,0
"Benin","2024-04-20",0,0,0,0,0,0,0,0
"Benin","2024-04-21",0,0,0,0,0,0,0,0
"Benin","2024-04-22",0,0,0,0,0,0,0,0
"Benin","2024-04-23",0,0,0,0,0,0,0,0
"Benin","2024-04-24",0,0,0,0,0,0,0,0
"Benin","2024-04-25",0,0,0,0,0,0,0,0
"Benin","2024-04-26",0,0,0,0,0,0,0,0
"Benin","2024-04-27",0,0,0,0,0,0,0,0
"Benin","2024-04-28",0,0,0,0,0,0,0,0
"Benin","2024-04-29",0,0,0,0,0,0,0,0
"Benin","2024-04-30",0,0,0,0,0,0,0,0
"Benin","2024-05-01",0,0,0,0,0,0,0,0
"Benin","2024-05-02",0,0,0,0,0,0,0,0
"Benin","2024-05-03",0,0,0,0,0,0,0,0
"Benin","2024-05-04",0,0,0,0,0,0,0,0
"Benin","2024-05-05",0,0,0,0,0,0,0,0
"Benin","2024-05-06",0,0,0,0,0,0,0,0
"Benin","2024-05-07",0,0,0,0,0,0,0,0
"Benin","2024-05-08",0,0,0,0,0,0,0,0
"Benin","2024-05-09",0,0,0,0,0,0,0,0
"Benin","2024-05-10",0,0,0,0,0,0,0,0
"Benin","2024-05-11",0,0,0,0,0,0,0,0
"Benin","2024-05-12",0,0,0,0,0,0,0,0
"Benin","2024-05-13",0,0,0,0,0,0,0,0
"Benin","2024-05-14",0,0,0,0,0,0,0,0
"Benin","2024-05-15",0,0,0,0,0,0,0,0
"Benin","2024-05-16",0,0,0,0,0,0,0,0
"Benin","2024-05-17",0,0,0,0,0,0,0,0
"Benin","2024-05-18",0,0,0,0,0,0,0,0
"Benin","2024-05-19",0,0,0,0,0,0,0,0
"Benin","2024-05-20",0,0,0,0,0,0,0,0
"Benin","2024-05-21",0,0,0,0,0,0,0,0
"Benin","2024-05-22",0,0,0,0,0,0,0,0
"Benin","2024-05-23",0,0,0,0,0,0,0,0
"Benin","2024-05-24",0,0,0,0,0,0,0,0
"Benin","2024-05-25",0,0,0,0,0,0,0,0
"Benin","2024-05-26",0,0,0,0,0,0,0,0
"Benin","2024-05-27",0,0,0,0,0,0,0,0
"Benin","2024-05-28",0,0,0,0,0,0,0,0
"Benin","2024-05-29",0,0,0,0,0,0,0,0
"Benin","2024-05-30",0,0,0,0,0,0,0,0
"Benin","2024-05-31",0,0,0,0,0,0,0,0
"Benin","2024-06-01",0,0,0,0,0,0,0,0
"Benin","2024-06-02",0,0,0,0,0,0,0,0
"Benin","2024-06-03",0,0,0,0,0,0,0,0
"Benin","2024-06-04",0,0,0,0,0,0,0,0
"Benin","2024-06-05",0,0,0,0,0,0,0,0
"Benin","2024-06-06",0,0,0,0,0,0,0,0
"Benin","2024-06-07",0,0,0,0,0,0,0,0
"Benin","2024-06-08",0,0,0,0,0,0,0,0
"Benin","2024-06-09",0,0,0,0,0,0,0,0
"Benin","2024-06-10",0,0,0,0,0,0,0,0
"Benin","2024-06-11",0,0,0,0,0,0,0,0
"Benin","2024-06-12",0,0,0,0,0,0,0,0
"Benin","2024-06-13",0,0,0,0,0,0,0,0
"Benin","2024-06-14",0,0,0,0,0,0,0,0
"Benin","2024-06-15",0,0,0,0,0,0,0,0
"Benin","2024-06-16",0,0,0,0,0,0,0,0
"Benin","2024-06-17",0,0,0,0,0,0,0,0
"Benin","2024-06-18",0,0,0,0,0,0,0,0
"Benin","2024-06-19",0,0,0,0,0,0,0,0
"Benin","2024-06-20",0,0,0,0,0,0,0,0
"Benin","2024-06-21",0,0,0,0,0,0,0,0
"Benin","2024-06-22",0,0,0,0,0,0,0,0
"Benin","2024-06-23",0,0,0,0,0,0,0,0
"Benin","2024-06-24",0,0,0,0,0,0,0,0
"Benin","2024-06-25",0,0,0,0,0,0,0,0
"Benin","2024-06-26",0,0,0,0,0,0,0,0
"Benin","2024-06-27",0,0,0,0,0,0,0,0
"Benin","2024-06-28",0,0,0,0,0,0,0,0
"Benin","2024-06-29",0,0,0,0,0,0,0,0
"Benin","2024-06-30",0,0,0,0,0,0,0,0
"Benin","2024-07-01",0,0,0,0,0,0,0,0
"Benin","2024-07-02",0,0,0,0,0,0,0,0
"Benin","2024-07-03",0,0,0,0,0,0,0,0
"Benin","2024-07-04",0,0,0,0,0,0,0,0
"Benin","2024-07-05",0,0,0,0,0,0,0,0
"Benin","2024-07-06",0,0,0,0,0,0,0,0
"Benin","2024-07-07",0,0,0,0,0,0,0,0
"Benin","2024-07-08",0,0,0,0,0,0,0,0
"Benin","2024-07-09",0,0,0,0,0,0,0,0
"Benin","2024-07-10",0,0,0,0,0,0,0,0
"Benin","2024-07-11",0,0,0,0,0,0,0,0
"Benin","2024-07-12",0,0,0,0,0,0,0,0
"Benin","2024-07-13",0,0,0,0,0,0,0,0
"Benin","2024-07-14",0,0,0,0,0,0,0,0
"Benin","2024-07-15",0,0,0,0,0,0,0,0
"Benin","2024-07-16",0,0,0,0,0,0,0,0
"Benin","2024-07-17",0,0,0,0,0,0,0,0
"Benin","2024-07-18",0,0,0,0,0,0,0,0
"Benin","2024-07-19",0,0,0,0,0,0,0,0
"Benin","2024-07-20",0,0,0,0,0,0,0,0
"Benin","2024-07-21",0,0,0,0,0,0,0,0
"Benin","2024-07-22",0,0,0,0,0,0,0,0
"Benin","2024-07-23",0,0,0,0,0,0,0,0
"Benin","2024-07-24",0,0,0,0,0,0,0,0
"Benin","2024-07-25",0,0,0,0,0,0,0,0
"Benin","2024-07-26",0,0,0,0,0,0,0,0
"Benin","2024-07-27",0,0,0,0,0,0,0,0
"Benin","2024-07-28",0,0,0,0,0,0,0,0
"Benin","2024-07-29",0,0,0,0,0,0,0,0
"Benin","2024-07-30",0,0,0,0,0,0,0,0
"Benin","2024-07-31",0,0,0,0,0,0,0,0
"Benin","2024-08-01",0,0,0,0,0,0,0,0
"Benin","2024-08-02",0,0,0,0,0,0,0,0
"Benin","2024-08-03",0,0,0,0,0,0,0,0
"Benin","2024-08-04",0,0,0,0,0,0,0,0
"Benin","2024-08-05",0,0,0,0,0,0,0,0
"Benin","2024-08-06",0,0,0,0,0,0,0,0
"Benin","2024-08-07",0,0,0,0,0,0,0,0
"Benin","2024-08-08",0,0,0,0,0,0,0,0
"Benin","2024-08-09",0,0,0,0,0,0,0,0
"Benin","2024-08-10",0,0,0,0,0,0,0,0
"Benin","2024-08-11",0,0,0,0,0,0,0,0
"Benin","2024-08-12",0,0,0,0,0,0,0,0
"Benin","2024-08-13",0,0,0,0,0,0,0,0
"Benin","2024-08-14",0,0,0,0,0,0,0,0
"Benin","2024-08-15",0,0,0,0,0,0,0,0
"Benin","2024-08-16",0,0,0,0,0,0,0,0
"Benin","2024-08-17",0,0,0,0,0,0,0,0
"Benin","2024-08-18",0,0,0,0,0,0,0,0
"Benin","2024-08-19",0,0,0,0,0,0,0,0
"Benin","2024-08-20",0,0,0,0,0,0,0,0
"Benin","2024-08-21",0,0,0,0,0,0,0,0
"Benin","2024-08-22",0,0,0,0,0,0,0,0
"Benin","2024-08-23",0,0,0,0,0,0,0,0
"Benin","2024-08-24",0,0,0,0,0,0,0,0
"Benin","2024-08-25",0,0,0,0,0,0,0,0
"Benin","2024-08-26",0,0,0,0,0,0,0,0
"Benin","2024-08-27",0,0,0,0,0,0,0,0
"Benin","2024-08-28",0,0,0,0,0,0,0,0
"Benin","2024-08-29",0,0,0,0,0,0,0,0
"Benin","2024-08-30",0,0,0,0,0,0,0,0
"Benin","2024-08-31",0,0,0,0,0,0,0,0
"Benin","2024-09-01",0,0,0,0,0,0,0,0
"Benin","2024-09-02",0,0,0,0,0,0,0,0
"Benin","2024-09-03",0,0,0,0,0,0,0,0
"Benin","2024-09-04",0,0,0,0,0,0,0,0
"Benin","2024-09-05",0,0,0,0,0,0,0,0
"Benin","2024-09-06",0,0,0,0,0,0,0,0
"Benin","2024-09-07",0,0,0,0,0,0,0,0
"Benin","2024-09-08",0,0,0,0,0,0,0,0
"Benin","2024-09-09",0,0,0,0,0,0,0,0
"Benin","2024-09-10",0,0,0,0,0,0,0,0
"Benin","2024-09-11",0,0,0,0,0,0,0,0
"Benin","2024-09-12",0,0,0,0,0,0,0,0
"Benin","2024-09-13",0,0,0,0,0,0,0,0
"Benin","2024-09-14",0,0,0,0,0,0,0,0
"Benin","2024-09-15",0,0,0,0,0,0,0,0
"Benin","2024-09-16",0,0,0,0,0,0,0,0
"Benin","2024-09-17",0,0,0,0,0,0,0,0
"Benin","2024-09-18",0,0,0,0,0,0,0,0
"Benin","2024-09-19",0,0,0,0,0,0,0,0
"Benin","2024-09-20",0,0,0,0,0,0,0,0
"Benin","2024-09-21",0,0,0,0,0,0,0,0
"Benin","2024-09-22",0,0,0,0,0,0,0,0
"Benin","2024-09-23",0,0,0,0,0,0,0,0
"Benin","2024-09-24",0,0,0,0,0,0,0,0
"Benin","2024-09-25",0,0,0,0,0,0,0,0
"Benin","2024-09-26",0,0,0,0,0,0,0,0
"Benin","2024-09-27",0,0,0,0,0,0,0,0
"Benin","2024-09-28",0,0,0,0,0,0,0,0
"Benin","2024-09-29",0,0,0,0,0,0,0,0
"Benin","2024-09-30",0,0,0,0,0,0,0,0
"Benin","2024-10-01",0,0,0,0,0,0,0,0
"Benin","2024-10-02",0,0,0,0,0,0,0,0
"Benin","2024-10-03",0,0,0,0,0,0,0,0
"Benin","2024-10-04",0,0,0,0,0,0,0,0
"Benin","2024-10-05",0,0,0,0,0,0,0,0
"Benin","2024-10-06",0,0,0,0,0,0,0,0
"Benin","2024-10-07",0,0,0,0,0,0,0,0
"Benin","2024-10-08",0,0,0,0,0,0,0,0
"Benin","2024-10-09",0,0,0,0,0,0,0,0
"Benin","2024-10-10",0,0,0,0,0,0,0,0
"Benin","2024-10-11",0,0,0,0,0,0,0,0
"Benin","2024-10-12",0,0,0,0,0,0,0,0
"Benin","2024-10-13",0,0,0,0,0,0,0,0
"Benin","2024-10-14",0,0,0,0,0,0,0,0
"Benin","2024-10-15",0,0,0,0,0,0,0,0
"Benin","2024-10-16",0,0,0,0,0,0,0,0
"Benin","2024-10-17",0,0,0,0,0,0,0,0
"Benin","2024-10-18",0,0,0,0,0,0,0,0
"Benin","2024-10-19",0,0,0,0,0,0,0,0
"Benin","2024-10-20",0,0,0,0,0,0,0,0
"Benin","2024-10-21",0,0,0,0,0,0,0,0
"Benin","2024-10-22",0,0,0,0,0,0,0,0
"Benin","2024-10-23",0,0,0,0,0,0,0,0
"Benin","2024-10-24",0,0,0,0,0,0,0,0
"Benin","2024-10-25",0,0,0,0,0,0,0,0
"Benin","2024-10-26",0,0,0,0,0,0,0,0
"Benin","2024-10-27",0,0,0,0,0,0,0,0
"Benin","2024-10-28",0,0,0,0,0,0,0,0
"Benin","2024-10-29",0,0,0,0,0,0,0,0
"Benin","2024-10-30",0,0,0,0,0,0,0,0
"Benin","2024-10-31",0,0,0,0,0,0,0,0
"Benin","2024-11-01",0,0,0,0,0,0,0,0
"Benin","2024-11-02",0,0,0,0,0,0,0,0
"Benin","2024-11-03",0,0,0,0,0,0,0,0
"Benin","2024-11-04",0,0,0,0,0,0,0,0
"Benin","2024-11-05",0,0,0,0,0,0,0,0
"Benin","2024-11-06",0,0,0,0,0,0,0,0
"Benin","2024-11-07",0,0,0,0,0,0,0,0
"Benin","2024-11-08",0,0,0,0,0,0,0,0
"Benin","2024-11-09",0,0,0,0,0,0,0,0
"Benin","2024-11-10",0,0,0,0,0,0,0,0
"Benin","2024-11-11",0,0,0,0,0,0,0,0
"Benin","2024-11-12",0,0,0,0,0,0,0,0
"Benin","2024-11-13",0,0,0,0,0,0,0,0
"Benin","2024-11-14",0,0,0,0,0,0,0,0
"Benin","2024-11-15",0,0,0,0,0,0,0,0
"Benin","2024-11-16",0,0,0,0,0,0,0,0
"Benin","2024-11-17",0,0,0,0,0,0,0,0
"Benin","2024-11-18",0,0,0,0,0,0,0,0
"Benin","2024-11-19",0,0,0,0,0,0,0,0
"Benin","2024-11-20",0,0,0,0,0,0,0,0
"Benin","2024-11-21",0,0,0,0,0,0,0,0
"Benin","2024-11-22",0,0,0,0,0,0,0,0
"Benin","2024-11-23",0,0,0,0,0,0,0,0
"Benin","2024-11-24",0,0,0,0,0,0,0,0
"Benin","2024-11-25",0,0,0,0,0,0,0,0
"Benin","2024-11-26",0,0,0,0,0,0,0,0
"Benin","2024-11-27",0,0,0,0,0,0,0,0
"Benin","2024-11-28",0,0,0,0,0,0,0,0
"Benin","2024-11-29",0,0,0,0,0,0,0,0
"Benin","2024-11-30",0,0,0,0,0,0,0,0
"Benin","2024-12-01",0,0,0,0,0,0,0,0
"Benin","2024-12-02",0,0,0,0,0,0,0,0
"Benin","2024-12-03",0,0,0,0,0,0,0,0
"Benin","2024-12-04",0,0,0,0,0,0,0,0
"Benin","2024-12-05",0,0,0,0,0,0,0,0
"Benin","2024-12-06",0,0,0,0,0,0,0,0
"Benin","2024-12-07",0,0,0,0,0,0,0,0
"Benin","2024-12-08",0,0,0,0,0,0,0,0
"Benin","2024-12-09",0,0,0,0,0,0,0,0
"Benin","2024-12-10",0,0,0,0,0,0,0,0
"Benin","2024-12-11",0,0,0,0,0,0,0,0
"Benin","2024-12-12",0,0,0,0,0,0,0,0
"Benin","2024-12-13",0,0,0,0,0,0,0,0
"Benin","2024-12-14",0,0,0,0,0,0,0,0
"Benin","2024-12-15",0,0,0,0,0,0,0,0
"Benin","2024-12-16",0,0,0,0,0,0,0,0
"Benin","2024-12-17",0,0,0,0,0,0,0,0
"Benin","2024-12-18",0,0,0,0,0,0,0,0
"Benin","2024-12-19",0,0,0,0,0,0,0,0
"Benin","2024-12-20",0,0,0,0,0,0,0,0
"Benin","2024-12-21",0,0,0,0,0,0,0,0
"Benin","2024-12-22",0,0,0,0,0,0,0,0
"Benin","2024-12-23",0,0,0,0,0,0,0,0
"Benin","2024-12-24",0,0,0,0,0,0,0,0
"Benin","2024-12-25",0,0,0,0,0,0,0,0
"Benin","2024-12-26",0,0,0,0,0,0,0,0
"Benin","2024-12-27",0,0,0,0,0,0,0,0
"Benin","2024-12-28",0,0,0,0,0,0,0,0
"Benin","2024-12-29",0,0,0,0,0,0,0,0
"Benin","2024-12-30",0,0,0,0,0,0,0,0
"Benin","2024-12-31",0,0,0,0,0,0,0,0
"Benin","2025-01-01",0,0,0,0,0,0,0,0
"Benin","2025-01-02",0,0,0,0,0,0,0,0
"Benin","2025-01-03",0,0,0,0,0,0,0,0
"Benin","2025-01-04",0,0,0,0,0,0,0,0
"Benin","2025-01-05",0,0,0,0,0,0,0,0
"Benin","2025-01-06",0,0,0,0,0,0,0,0
"Benin","2025-01-07",0,0,0,0,0,0,0,0
"Benin","2025-01-08",0,0,0,0,0,0,0,0
"Benin","2025-01-09",0,0,0,0,0,0,0,0
"Benin","2025-01-10",0,0,0,0,0,0,0,0
"Benin","2025-01-11",0,0,0,0,0,0,0,0
"Benin","2025-01-12",0,0,0,0,0,0,0,0
"Benin","2025-01-13",0,0,0,0,0,0,0,0
"Benin","2025-01-14",0,0,0,0,0,0,0,0
"Benin","2025-01-15",0,0,0,0,0,0,0,0
"Benin","2025-01-16",0,0,0,0,0,0,0,0
"Benin","2025-01-17",0,0,0,0,0,0,0,0
"Benin","2025-01-18",0,0,0,0,0,0,0,0
"Benin","2025-01-19",0,0,0,0,0,0,0,0
"Benin","2025-01-20",0,0,0,0,0,0,0,0
"Benin","2025-01-21",0,0,0,0,0,0,0,0
"Benin","2025-01-22",0,0,0,0,0,0,0,0
"Benin","2025-01-23",0,0,0,0,0,0,0,0
"Benin","2025-01-24",0,0,0,0,0,0,0,0
"Benin","2025-01-25",0,0,0,0,0,0,0,0
"Benin","2025-01-26",0,0,0,0,0,0,0,0
"Benin","2025-01-27",0,0,0,0,0,0,0,0
"Benin","2025-01-28",0,0,0,0,0,0,0,0
"Benin","2025-01-29",0,0,0,0,0,0,0,0
"Benin","2025-01-30",0,0,0,0,0,0,0,0
"Benin","2025-01-31",0,0,0,0,0,0,0,0
"Benin","2025-02-01",0,0,0,0,0,0,0,0
"Benin","2025-02-02",0,0,0,0,0,0,0,0
"Benin","2025-02-03",0,0,0,0,0,0,0,0
"Benin","2025-02-04",0,0,0,0,0,0,0,0
"Benin","2025-02-05",0,0,0,0,0,0,0,0
"Benin","2025-02-06",0,0,0,0,0,0,0,0
"Benin","2025-02-07",0,0,0,0,0,0,0,0
"Benin","2025-02-08",0,0,0,0,0,0,0,0
"Benin","2025-02-09",0,0,0,0,0,0,0,0
"Benin","2025-02-10",0,0,0,0,0,0,0,0
"Benin","2025-02-11",0,0,0,0,0,0,0,0
"Benin","2025-02-12",0,0,0,0,0,0,0,0
"Benin","2025-02-13",0,0,0,0,0,0,0,0
"Benin","2025-02-14",0,0,0,0,0,0,0,0
"Benin","2025-02-15",0,0,0,0,0,0,0,0
"Benin","2025-02-16",0,0,0,0,0,0,0,0
"Benin","2025-02-17",0,0,0,0,0,0,0,0
"Benin","2025-02-18",0,0,0,0,0,0,0,0
"Benin","2025-02-19",0,0,0,0,0,0,0,0
"Benin","2025-02-20",0,0,0,0,0,0,0,0
"Benin","2025-02-21",0,0,0,0,0,0,0,0
"Benin","2025-02-22",0,0,0,0,0,0,0,0
"Benin","2025-02-23",0,0,0,0,0,0,0,0
"Benin","2025-02-24",0,0,0,0,0,0,0,0
"Benin","2025-02-25",0,0,0,0,0,0,0,0
"Benin","2025-02-26",0,0,0,0,0,0,0,0
"Benin","2025-02-27",0,0,0,0,0,0,0,0
"Benin","2025-02-28",0,0,0,0,0,0,0,0
"Benin","2025-03-01",0,0,0,0,0,0,0,0
"Benin","2025-03-02",0,0,0,0,0,0,0,0
"Benin","2025-03-03",0,0,0,0,0,0,0,0
"Bermuda","2024-01-01",0,0,0,0,0,0,0,0
"Bermuda","2024-01-02",0,0,0,0,0,0,0,0
"Bermuda","2024-01-03",0,0,0,0,0,0,0,0
"Bermuda","2024-01-04",0,0,0,0,0,0,0,0
"Bermuda","2024-01-05",0,0,0,0,0,0,0,0
"Bermuda","2024-01-06",0,0,0,0,0,0,0,0
"Bermuda","2024-01-07",0,0,0,0,0,0,0,0
"Bermuda","2024-01-08",0,0,0,0,0,0,0,0
"Bermuda","2024-01-09",0,0,0,0,0,0,0,0
"Bermuda","2024-01-10",0,0,0,0,0,0,0,0
"Bermuda","2024-01-11",0,0,0,0,0,0,0,0
"Bermuda","2024-01-12",0,0,0,0,0,0,0,0
"Bermuda","2024-01-13",0,0,0,0,0,0,0,0
"Bermuda","2024-01-14",0,0,0,0,0,0,0,0
"Bermuda","2024-01-15",0,0,0,0,0,0,0,0
"Bermuda","2024-01-16",0,0,0,0,0,0,0,0
"Bermuda","2024-01-17",0,0,0,0,0,0,0,0
"Bermuda","2024-01-18",0,0,0,0,0,0,0,0
"Bermuda","2024-01-19",0,0,0,0,0,0,0,0
"Bermuda","2024-01-20",0,0,0,0,0,0,0,0
"Bermuda","2024-01-21",0,0,0,0,0,0,0,0
"Bermuda","2024-01-22",0,0,0,0,0,0,0,0
"Bermuda","2024-01-23",0,0,0,0,0,0,0,0
"Bermuda","2024-01-24",0,0,0,0,0,0,0,0
"Bermuda","2024-01-25",0,0,0,0,0,0,0,0
"Bermuda","2024-01-26",0,0,0,0,0,0,0,0
"Bermuda","2024-01-27",0,0,0,0,0,0,0,0
"Bermuda","2024-01-28",0,0,0,0,0,0,0,0
"Bermuda","2024-01-29",0,0,0,0,0,0,0,0
"Bermuda","2024-01-30",0,0,0,0,0,0,0,0
"Bermuda","2024-01-31",0,0,0,0,0,0,0,0
"Bermuda","2024-02-01",0,0,0,0,0,0,0,0
"Bermuda","2024-02-02",0,0,0,0,0,0,0,0
"Bermuda","2024-02-03",0,0,0,0,0,0,0,0
"Bermuda","2024-02-04",0,0,0,0,0,0,0,0
"Bermuda","2024-02-05",0,0,0,0,0,0,0,0
"Bermuda","2024-02-06",0,0,0,0,0,0,0,0
"Bermuda","2024-02-07",0,0,0,0,0,0,0,0
"Bermuda","2024-02-08",0,0,0,0,0,0,0,0
"Bermuda","2024-02-09",0,0,0,0,0,0,0,0
"Bermuda","2024-02-10",0,0,0,0,0,0,0,0
"Bermuda","2024-02-11",0,0,0,0,0,0,0,0
"Bermuda","2024-02-12",0,0,0,0,0,0,0,0
"Bermuda","2024-02-13",0,0,0,0,0,0,0,0
"Bermuda","2024-02-14",0,0,0,0,0,0,0,0
"Bermuda","2024-02-15",0,0,0,0,0,0,0,0
"Bermuda","2024-02-16",0,0,0,0,0,0,0,0
"Bermuda","2024-02-17",0,0,0,0,0,0,0,0
"Bermuda","2024-02-18",0,0,0,0,0,0,0,0
"Bermuda","2024-02-19",0,0,0,0,0,0,0,0
"Bermuda","2024-02-20",0,0,0,0,0,0,0,0
"Bermuda","2024-02-21",0,0,0,0,0,0,0,0
"Bermuda","2024-02-22",0,0,0,0,0,0,0,0
"Bermuda","2024-02-23",0,0,0,0,0,0,0,0
"Bermuda","2024-02-24",0,0,0,0,0,0,0,0
"Bermuda","2024-02-25",0,0,0,0,0,0,0,0
"Bermuda","2024-02-26",0,0,0,0,0,0,0,0
"Bermuda","2024-02-27",0,0,0,0,0,0,0,0
"Bermuda","2024-02-28",0,0,0,0,0,0,0,0
"Bermuda","2024-02-29",0,0,0,0,0,0,0,0
"Bermuda","2024-03-01",0,0,0,0,0,0,0,0
"Bermuda","2024-03-02",0,0,0,0,0,0,0,0
"Bermuda","2024-03-03",0,0,0,0,0,0,0,0
"Bermuda","2024-03-04",0,0,0,0,0,0,0,0
"Bermuda","2024-03-05",0,0,0,0,0,0,0,0
"Bermuda","2024-03-06",0,0,0,0,0,0,0,0
"Bermuda","2024-03-07",0,0,0,0,0,0,0,0
"Bermuda","2024-03-08",0,0,0,0,0,0,0,0
"Bermuda","2024-03-09",0,0,0,0,0,0,0,0
"Bermuda","2024-03-10",0,0,0,0,0,0,0,0
"Bermuda","2024-03-11",0,0,0,0,0,0,0,0
"Bermuda","2024-03-12",0,0,0,0,0,0,0,0
"Bermuda","2024-03-13",0,0,0,0,0,0,0,0
"Bermuda","2024-03-14",0,0,0,0,0,0,0,0
"Bermuda","2024-03-15",0,0,0,0,0,0,0,0
"Bermuda","2024-03-16",0,0,0,0,0,0,0,0
"Bermuda","2024-03-17",0,0,0,0,0,0,0,0
"Bermuda","2024-03-18",0,0,0,0,0,0,0,0
"Bermuda","2024-03-19",0,0,0,0,0,0,0,0
"Bermuda","2024-03-20",0,0,0,0,0,0,0,0
"Bermuda","2024-03-21",0,0,0,0,0,0,0,0
"Bermuda","2024-03-22",0,0,0,0,0,0,0,0
"Bermuda","2024-03-23",0,0,0,0,0,0,0,0
"Bermuda","2024-03-24",0,0,0,0,0,0,0,0
"Bermuda","2024-03-25",0,0,0,0,0,0,0,0
"Bermuda","2024-03-26",0,0,0,0,0,0,0,0
"Bermuda","2024-03-27",0,0,0,0,0,0,0,0
"Bermuda","2024-03-28",0,0,0,0,0,0,0,0
"Bermuda","2024-03-29",0,0,0,0,0,0,0,0
"Bermuda","2024-03-30",0,0,0,0,0,0,0,0
"Bermuda","2024-03-31",0,0,0,0,0,0,0,0
"Bermuda","2024-04-01",0,0,0,0,0,0,0,0
"Bermuda","2024-04-02",0,0,0,0,0,0,0,0
"Bermuda","2024-04-03",0,0,0,0,0,0,0,0
"Bermuda","2024-04-04",0,0,0,0,0,0,0,0
"Bermuda","2024-04-05",0,0,0,0,0,0,0,0
"Bermuda","2024-04-06",0,0,0,0,0,0,0,0
"Bermuda","2024-04-07",0,0,0,0,0,0,0,0
"Bermuda","2024-04-08",0,0,0,0,0,0,0,0
"Bermuda","2024-04-09",0,0,0,0,0,0,0,0
"Bermuda","2024-04-10",0,0,0,0,0,0,0,0
"Bermuda","2024-04-11",0,0,0,0,0,0,0,0
"Bermuda","2024-04-12",0,0,0,0,0,0,0,0
"Bermuda","2024-04-13",0,0,0,0,0,0,0,0
"Bermuda","2024-04-14",0,0,0,0,0,0,0,0
"Bermuda","2024-04-15",0,0,0,0,0,0,0,0
"Bermuda","2024-04-16",0,0,0,0,0,0,0,0
"Bermuda","2024-04-17",0,0,0,0,0,0,0,0
"Bermuda","2024-04-18",0,0,0,0,0,0,0,0
"Bermuda","2024-04-19",0,0,0,0,0,0,0,0
"Bermuda","2024-04-20",0,0,0,0,0,0,0,0
"Bermuda","2024-04-21",0,0,0,0,0,0,0,0
"Bermuda","2024-04-22",0,0,0,0,0,0,0,0
"Bermuda","2024-04-23",0,0,0,0,0,0,0,0
"Bermuda","2024-04-24",0,0,0,0,0,0,0,0
"Bermuda","2024-04-25",0,0,0,0,0,0,0,0
"Bermuda","2024-04-26",0,0,0,0,0,0,0,0
"Bermuda","2024-04-27",0,0,0,0,0,0,0,0
"Bermuda","2024-04-28",0,0,0,0,0,0,0,0
"Bermuda","2024-04-29",0,0,0,0,0,0,0,0
"Bermuda","2024-04-30",0,0,0,0,0,0,0,0
"Bermuda","2024-05-01",0,0,0,0,0,0,0,0
"Bermuda","2024-05-02",0,0,0,0,0,0,0,0
"Bermuda","2024-05-03",0,0,0,0,0,0,0,0
"Bermuda","2024-05-04",0,0,0,0,0,0,0,0
"Bermuda","2024-05-05",0,0,0,0,0,0,0,0
"Bermuda","2024-05-06",0,0,0,0,0,0,0,0
"Bermuda","2024-05-07",0,0,0,0,0,0,0,0
"Bermuda","2024-05-08",0,0,0,0,0,0,0,0
"Bermuda","2024-05-09",0,0,0,0,0,0,0,0
"Bermuda","2024-05-10",0,0,0,0,0,0,0,0
"Bermuda","2024-05-11",0,0,0,0,0,0,0,0
"Bermuda","2024-05-12",0,0,0,0,0,0,0,0
"Bermuda","2024-05-13",0,0,0,0,0,0,0,0
"Bermuda","2024-05-14",0,0,0,0,0,0,0,0
"Bermuda","2024-05-15",0,0,0,0,0,0,0,0
"Bermuda","2024-05-16",0,0,0,0,0,0,0,0
"Bermuda","2024-05-17",0,0,0,0,0,0,0,0
"Bermuda","2024-05-18",0,0,0,0,0,0,0,0
"Bermuda","2024-05-19",0,0,0,0,0,0,0,0
"Bermuda","2024-05-20",0,0,0,0,0,0,0,0
"Bermuda","2024-05-21",0,0,0,0,0,0,0,0
"Bermuda","2024-05-22",0,0,0,0,0,0,0,0
"Bermuda","2024-05-23",0,0,0,0,0,0,0,0
"Bermuda","2024-05-24",0,0,0,0,0,0,0,0
"Bermuda","2024-05-25",0,0,0,0,0,0,0,0
"Bermuda","2024-05-26",0,0,0,0,0,0,0,0
"Bermuda","2024-05-27",0,0,0,0,0,0,0,0
"Bermuda","2024-05-28",0,0,0,0,0,0,0,0
"Bermuda","2024-05-29",0,0,0,0,0,0,0,0
"Bermuda","2024-05-30",0,0,0,0,0,0,0,0
"Bermuda","2024-05-31",0,0,0,0,0,0,0,0
"Bermuda","2024-06-01",0,0,0,0,0,0,0,0
"Bermuda","2024-06-02",0,0,0,0,0,0,0,0
"Bermuda","2024-06-03",0,0,0,0,0,0,0,0
"Bermuda","2024-06-04",0,0,0,0,0,0,0,0
"Bermuda","2024-06-05",0,0,0,0,0,0,0,0
"Bermuda","2024-06-06",0,0,0,0,0,0,0,0
"Bermuda","2024-06-07",0,0,0,0,0,0,0,0
"Bermuda","2024-06-08",0,0,0,0,0,0,0,0
"Bermuda","2024-06-09",0,0,0,0,0,0,0,0
"Bermuda","2024-06-10",0,0,0,0,0,0,0,0
"Bermuda","2024-06-11",0,0,0,0,0,0,0,0
"Bermuda","2024-06-12",0,0,0,0,0,0,0,0
"Bermuda","2024-06-13",0,0,0,0,0,0,0,0
"Bermuda","2024-06-14",0,0,0,0,0,0,0,0
"Bermuda","2024-06-15",0,0,0,0,0,0,0,0
"Bermuda","2024-06-16",0,0,0,0,0,0,0,0
"Bermuda","2024-06-17",0,0,0,0,0,0,0,0
"Bermuda","2024-06-18",0,0,0,0,0,0,0,0
"Bermuda","2024-06-19",0,0,0,0,0,0,0,0
"Bermuda","2024-06-20",0,0,0,0,0,0,0,0
"Bermuda","2024-06-21",0,0,0,0,0,0,0,0
"Bermuda","2024-06-22",0,0,0,0,0,0,0,0
"Bermuda","2024-06-23",0,0,0,0,0,0,0,0
"Bermuda","2024-06-24",0,0,0,0,0,0,0,0
"Bermuda","2024-06-25",0,0,0,0,0,0,0,0
"Bermuda","2024-06-26",0,0,0,0,0,0,0,0
"Bermuda","2024-06-27",0,0,0,0,0,0,0,0
"Bermuda","2024-06-28",0,0,0,0,0,0,0,0
"Bermuda","2024-06-29",0,0,0,0,0,0,0,0
"Bermuda","2024-06-30",0,0,0,0,0,0,0,0
"Bermuda","2024-07-01",0,0,0,0,0,0,0,0
"Bermuda","2024-07-02",0,0,0,0,0,0,0,0
"Bermuda","2024-07-03",0,0,0,0,0,0,0,0
"Bermuda","2024-07-04",0,0,0,0,0,0,0,0
"Bermuda","2024-07-05",0,0,0,0,0,0,0,0
"Bermuda","2024-07-06",0,0,0,0,0,0,0,0
"Bermuda","2024-07-07",0,0,0,0,0,0,0,0
"Bermuda","2024-07-08",0,0,0,0,0,0,0,0
"Bermuda","2024-07-09",0,0,0,0,0,0,0,0
"Bermuda","2024-07-10",0,0,0,0,0,0,0,0
"Bermuda","2024-07-11",0,0,0,0,0,0,0,0
"Bermuda","2024-07-12",0,0,0,0,0,0,0,0
"Bermuda","2024-07-13",0,0,0,0,0,0,0,0
"Bermuda","2024-07-14",0,0,0,0,0,0,0,0
"Bermuda","2024-07-15",0,0,0,0,0,0,0,0
"Bermuda","2024-07-16",0,0,0,0,0,0,0,0
"Bermuda","2024-07-17",0,0,0,0,0,0,0,0
"Bermuda","2024-07-18",0,0,0,0,0,0,0,0
"Bermuda","2024-07-19",0,0,0,0,0,0,0,0
"Bermuda","2024-07-20",0,0,0,0,0,0,0,0
"Bermuda","2024-07-21",0,0,0,0,0,0,0,0
"Bermuda","2024-07-22",0,0,0,0,0,0,0,0
"Bermuda","2024-07-23",0,0,0,0,0,0,0,0
"Bermuda","2024-07-24",0,0,0,0,0,0,0,0
"Bermuda","2024-07-25",0,0,0,0,0,0,0,0
"Bermuda","2024-07-26",0,0,0,0,0,0,0,0
"Bermuda","2024-07-27",0,0,0,0,0,0,0,0
"Bermuda","2024-07-28",0,0,0,0,0,0,0,0
"Bermuda","2024-07-29",0,0,0,0,0,0,0,0
"Bermuda","2024-07-30",0,0,0,0,0,0,0,0
"Bermuda","2024-07-31",0,0,0,0,0,0,0,0
"Bermuda","2024-08-01",0,0,0,0,0,0,0,0
"Bermuda","2024-08-02",0,0,0,0,0,0,0,0
"Bermuda","2024-08-03",0,0,0,0,0,0,0,0
"Bermuda","2024-08-04",0,0,0,0,0,0,0,0
"Bermuda","2024-08-05",0,0,0,0,0,0,0,0
"Bermuda","2024-08-06",0,0,0,0,0,0,0,0
"Bermuda","2024-08-07",0,0,0,0,0,0,0,0
"Bermuda","2024-08-08",0,0,0,0,0,0,0,0
"Bermuda","2024-08-09",0,0,0,0,0,0,0,0
"Bermuda","2024-08-10",0,0,0,0,0,0,0,0
"Bermuda","2024-08-11",0,0,0,0,0,0,0,0
"Bermuda","2024-08-12",0,0,0,0,0,0,0,0
"Bermuda","2024-08-13",0,0,0,0,0,0,0,0
"Bermuda","2024-08-14",0,0,0,0,0,0,0,0
"Bermuda","2024-08-15",0,0,0,0,0,0,0,0
"Bermuda","2024-08-16",0,0,0,0,0,0,0,0
"Bermuda","2024-08-17",0,0,0,0,0,0,0,0
"Bermuda","2024-08-18",0,0,0,0,0,0,0,0
"Bermuda","2024-08-19",0,0,0,0,0,0,0,0
"Bermuda","2024-08-20",0,0,0,0,0,0,0,0
"Bermuda","2024-08-21",0,0,0,0,0,0,0,0
"Bermuda","2024-08-22",0,0,0,0,0,0,0,0
"Bermuda","2024-08-23",0,0,0,0,0,0,0,0
"Bermuda","2024-08-24",0,0,0,0,0,0,0,0
"Bermuda","2024-08-25",0,0,0,0,0,0,0,0
"Bermuda","2024-08-26",0,0,0,0,0,0,0,0
"Bermuda","2024-08-27",0,0,0,0,0,0,0,0
"Bermuda","2024-08-28",0,0,0,0,0,0,0,0
"Bermuda","2024-08-29",0,0,0,0,0,0,0,0
"Bermuda","2024-08-30",0,0,0,0,0,0,0,0
"Bermuda","2024-08-31",0,0,0,0,0,0,0,0
"Bermuda","2024-09-01",0,0,0,0,0,0,0,0
"Bermuda","2024-09-02",0,0,0,0,0,0,0,0
"Bermuda","2024-09-03",0,0,0,0,0,0,0,0
"Bermuda","2024-09-04",0,0,0,0,0,0,0,0
"Bermuda","2024-09-05",0,0,0,0,0,0,0,0
"Bermuda","2024-09-06",0,0,0,0,0,0,0,0
"Bermuda","2024-09-07",0,0,0,0,0,0,0,0
"Bermuda","2024-09-08",0,0,0,0,0,0,0,0
"Bermuda","2024-09-09",0,0,0,0,0,0,0,0
"Bermuda","2024-09-10",0,0,0,0,0,0,0,0
"Bermuda","2024-09-11",0,0,0,0,0,0,0,0
"Bermuda","2024-09-12",0,0,0,0,0,0,0,0
"Bermuda","2024-09-13",0,0,0,0,0,0,0,0
"Bermuda","2024-09-14",0,0,0,0,0,0,0,0
"Bermuda","2024-09-15",0,0,0,0,0,0,0,0
"Bermuda","2024-09-16",0,0,0,0,0,0,0,0
"Bermuda","2024-09-17",0,0,0,0,0,0,0,0
"Bermuda","2024-09-18",0,0,0,0,0,0,0,0
"Bermuda","2024-09-19",0,0,0,0,0,0,0,0
"Bermuda","2024-09-20",0,0,0,0,0,0,0,0
"Bermuda","2024-09-21",0,0,0,0,0,0,0,0
"Bermuda","2024-09-22",0,0,0,0,0,0,0,0
"Bermuda","2024-09-23",0,0,0,0,0,0,0,0
"Bermuda","2024-09-24",0,0,0,0,0,0,0,0
"Bermuda","2024-09-25",0,0,0,0,0,0,0,0
"Bermuda","2024-09-26",0,0,0,0,0,0,0,0
"Bermuda","2024-09-27",0,0,0,0,0,0,0,0
"Bermuda","2024-09-28",0,0,0,0,0,0,0,0
"Bermuda","2024-09-29",0,0,0,0,0,0,0,0
"Bermuda","2024-09-30",0,0,0,0,0,0,0,0
"Bermuda","2024-10-01",0,0,0,0,0,0,0,0
"Bermuda","2024-10-02",0,0,0,0,0,0,0,0
"Bermuda","2024-10-03",0,0,0,0,0,0,0,0
"Bermuda","2024-10-04",0,0,0,0,0,0,0,0
"Bermuda","2024-10-05",0,0,0,0,0,0,0,0
"Bermuda","2024-10-06",0,0,0,0,0,0,0,0
"Bermuda","2024-10-07",0,0,0,0,0,0,0,0
"Bermuda","2024-10-08",0,0,0,0,0,0,0,0
"Bermuda","2024-10-09",0,0,0,0,0,0,0,0
"Bermuda","2024-10-10",0,0,0,0,0,0,0,0
"Bermuda","2024-10-11",0,0,0,0,0,0,0,0
"Bermuda","2024-10-12",0,0,0,0,0,0,0,0
"Bermuda","2024-10-13",0,0,0,0,0,0,0,0
"Bermuda","2024-10-14",0,0,0,0,0,0,0,0
"Bermuda","2024-10-15",0,0,0,0,0,0,0,0
"Bermuda","2024-10-16",0,0,0,0,0,0,0,0
"Bermuda","2024-10-17",0,0,0,0,0,0,0,0
"Bermuda","2024-10-18",0,0,0,0,0,0,0,0
"Bermuda","2024-10-19",0,0,0,0,0,0,0,0
"Bermuda","2024-10-20",0,0,0,0,0,0,0,0
"Bermuda","2024-10-21",0,0,0,0,0,0,0,0
"Bermuda","2024-10-22",0,0,0,0,0,0,0,0
"Bermuda","2024-10-23",0,0,0,0,0,0,0,0
"Bermuda","2024-10-24",0,0,0,0,0,0,0,0
"Bermuda","2024-10-25",0,0,0,0,0,0,0,0
"Bermuda","2024-10-26",0,0,0,0,0,0,0,0
"Bermuda","2024-10-27",0,0,0,0,0,0,0,0
"Bermuda","2024-10-28",0,0,0,0,0,0,0,0
"Bermuda","2024-10-29",0,0,0,0,0,0,0,0
"Bermuda","2024-10-30",0,0,0,0,0,0,0,0
"Bermuda","2024-10-31",0,0,0,0,0,0,0,0
"Bermuda","2024-11-01",0,0,0,0,0,0,0,0
"Bermuda","2024-11-02",0,0,0,0,0,0,0,0
"Bermuda","2024-11-03",0,0,0,0,0,0,0,0
"Bermuda","2024-11-04",0,0,0,0,0,0,0,0
"Bermuda","2024-11-05",0,0,0,0,0,0,0,0
"Bermuda","2024-11-06",0,0,0,0,0,0,0,0
"Bermuda","2024-11-07",0,0,0,0,0,0,0,0
"Bermuda","2024-11-08",0,0,0,0,0,0,0,0
"Bermuda","2024-11-09",0,0,0,0,0,0,0,0
"Bermuda","2024-11-10",0,0,0,0,0,0,0,0
"Bermuda","2024-11-11",0,0,0,0,0,0,0,0
"Bermuda","2024-11-12",0,0,0,0,0,0,0,0
"Bermuda","2024-11-13",0,0,0,0,0,0,0,0
"Bermuda","2024-11-14",0,0,0,0,0,0,0,0
"Bermuda","2024-11-15",0,0,0,0,0,0,0,0
"Bermuda","2024-11-16",0,0,0,0,0,0,0,0
"Bermuda","2024-11-17",0,0,0,0,0,0,0,0
"Bermuda","2024-11-18",0,0,0,0,0,0,0,0
"Bermuda","2024-11-19",0,0,0,0,0,0,0,0
"Bermuda","2024-11-20",0,0,0,0,0,0,0,0
"Bermuda","2024-11-21",0,0,0,0,0,0,0,0
"Bermuda","2024-11-22",0,0,0,0,0,0,0,0
"Bermuda","2024-11-23",0,0,0,0,0,0,0,0
"Bermuda","2024-11-24",0,0,0,0,0,0,0,0
"Bermuda","2024-11-25",0,0,0,0,0,0,0,0
"Bermuda","2024-11-26",0,0,0,0,0,0,0,0
"Bermuda","2024-11-27",0,0,0,0,0,0,0,0
"Bermuda","2024-11-28",0,0,0,0,0,0,0,0
"Bermuda","2024-11-29",0,0,0,0,0,0,0,0
"Bermuda","2024-11-30",0,0,0,0,0,0,0,0
"Bermuda","2024-12-01",0,0,0,0,0,0,0,0
"Bermuda","2024-12-02",0,0,0,0,0,0,0,0
"Bermuda","2024-12-03",0,0,0,0,0,0,0,0
"Bermuda","2024-12-04",0,0,0,0,0,0,0,0
"Bermuda","2024-12-05",0,0,0,0,0,0,0,0
"Bermuda","2024-12-06",0,0,0,0,0,0,0,0
"Bermuda","2024-12-07",0,0,0,0,0,0,0,0
"Bermuda","2024-12-08",0,0,0,0,0,0,0,0
"Bermuda","2024-12-09",0,0,0,0,0,0,0,0
"Bermuda","2024-12-10",0,0,0,0,0,0,0,0
"Bermuda","2024-12-11",0,0,0,0,0,0,0,0
"Bermuda","2024-12-12",0,0,0,0,0,0,0,0
"Bermuda","2024-12-13",0,0,0,0,0,0,0,0
"Bermuda","2024-12-14",0,0,0,0,0,0,0,0
"Bermuda","2024-12-15",0,0,0,0,0,0,0,0
"Bermuda","2024-12-16",0,0,0,0,0,0,0,0
"Bermuda","2024-12-17",0,0,0,0,0,0,0,0
"Bermuda","2024-12-18",0,0,0,0,0,0,0,0
"Bermuda","2024-12-19",0,0,0,0,0,0,0,0
"Bermuda","2024-12-20",0,0,0,0,0,0,0,0
"Bermuda","2024-12-21",0,0,0,0,0,0,0,0
"Bermuda","2024-12-22",0,0,0,0,0,0,0,0
"Bermuda","2024-12-23",0,0,0,0,0,0,0,0
"Bermuda","2024-12-24",0,0,0,0,0,0,0,0
"Bermuda","2024-12-25",0,0,0,0,0,0,0,0
"Bermuda","2024-12-26",0,0,0,0,0,0,0,0
"Bermuda","2024-12-27",0,0,0,0,0,0,0,0
"Bermuda","2024-12-28",0,0,0,0,0,0,0,0
"Bermuda","2024-12-29",0,0,0,0,0,0,0,0
"Bermuda","2024-12-30",0,0,0,0,0,0,0,0
"Bermuda","2024-12-31",0,0,0,0,0,0,0,0
"Bermuda","2025-01-01",0,0,0,0,0,0,0,0
"Bermuda","2025-01-02",0,0,0,0,0,0,0,0
"Bermuda","2025-01-03",0,0,0,0,0,0,0,0
"Bermuda","2025-01-04",0,0,0,0,0,0,0,0
"Bermuda","2025-01-05",0,0,0,0,0,0,0,0
"Bermuda","2025-01-06",0,0,0,0,0,0,0,0
"Bermuda","2025-01-07",0,0,0,0,0,0,0,0
"Bermuda","2025-01-08",0,0,0,0,0,0,0,0
"Bermuda","2025-01-09",0,0,0,0,0,0,0,0
"Bermuda","2025-01-10",0,0,0,0,0,0,0,0
"Bermuda","2025-01-11",0,0,0,0,0,0,0,0
"Bermuda","2025-01-12",0,0,0,0,0,0,0,0
"Bermuda","2025-01-13",0,0,0,0,0,0,0,0
"Bermuda","2025-01-14",0,0,0,0,0,0,0,0
"Bermuda","2025-01-15",0,0,0,0,0,0,0,0
"Bermuda","2025-01-16",0,0,0,0,0,0,0,0
"Bermuda","2025-01-17",0,0,0,0,0,0,0,0
"Bermuda","2025-01-18",0,0,0,0,0,0,0,0
"Bermuda","2025-01-19",0,0,0,0,0,0,0,0
"Bermuda","2025-01-20",0,0,0,0,0,0,0,0
"Bermuda","2025-01-21",0,0,0,0,0,0,0,0
"Bermuda","2025-01-22",0,0,0,0,0,0,0,0
"Bermuda","2025-01-23",0,0,0,0,0,0,0,0
"Bermuda","2025-01-24",0,0,0,0,0,0,0,0
"Bermuda","2025-01-25",0,0,0,0,0,0,0,0
"Bermuda","2025-01-26",0,0,0,0,0,0,0,0
"Bermuda","2025-01-27",0,0,0,0,0,0,0,0
"Bermuda","2025-01-28",0,0,0,0,0,0,0,0
"Bermuda","2025-01-29",0,0,0,0,0,0,0,0
"Bermuda","2025-01-30",0,0,0,0,0,0,0,0
"Bermuda","2025-01-31",0,0,0,0,0,0,0,0
"Bermuda","2025-02-01",0,0,0,0,0,0,0,0
"Bermuda","2025-02-02",0,0,0,0,0,0,0,0
"Bermuda","2025-02-03",0,0,0,0,0,0,0,0
"Bermuda","2025-02-04",0,0,0,0,0,0,0,0
"Bermuda","2025-02-05",0,0,0,0,0,0,0,0
"Bermuda","2025-02-06",0,0,0,0,0,0,0,0
"Bermuda","2025-02-07",0,0,0,0,0,0,0,0
"Bermuda","2025-02-08",0,0,0,0,0,0,0,0
"Bermuda","2025-02-09",0,0,0,0,0,0,0,0
"Bermuda","2025-02-10",0,0,0,0,0,0,0,0
"Bermuda","2025-02-11",0,0,0,0,0,0,0,0
"Bermuda","2025-02-12",0,0,0,0,0,0,0,0
"Bermuda","2025-02-13",0,0,0,0,0,0,0,0
"Bermuda","2025-02-14",0,0,0,0,0,0,0,0
"Bermuda","2025-02-15",0,0,0,0,0,0,0,0
"Bermuda","2025-02-16",0,0,0,0,0,0,0,0
"Bermuda","2025-02-17",0,0,0,0,0,0,0,0
"Bermuda","2025-02-18",0,0,0,0,0,0,0,0
"Bermuda","2025-02-19",0,0,0,0,0,0,0,0
"Bermuda","2025-02-20",0,0,0,0,0,0,0,0
"Bermuda","2025-02-21",0,0,0,0,0,0,0,0
"Bermuda","2025-02-22",0,0,0,0,0,0,0,0
"Bermuda","2025-02-23",0,0,0,0,0,0,0,0
"Bermuda","2025-02-24",0,0,0,0,0,0,0,0
"Bermuda","2025-02-25",0,0,0,0,0,0,0,0
"Bermuda","2025-02-26",0,0,0,0,0,0,0,0
"Bermuda","2025-02-27",0,0,0,0,0,0,0,0
"Bermuda","2025-02-28",0,0,0,0,0,0,0,0
"Bermuda","2025-03-01",0,0,0,0,0,0,0,0
"Bermuda","2025-03-02",0,0,0,0,0,0,0,0
"Bermuda","2025-03-03",0,0,0,0,0,0,0,0
"Bolivia (Plurinational State of)","2024-01-01",0,0,0,0,0,0,0,0
"Bolivia (Plurinational State of)","2024-01-02",0,0,0,0,0,0,0,0
"Bolivia (Plurinational State of)","2024-01-03",0,0,0,0,0,0,0,0
"Bolivia (Plurinational State of)","2024-01-04",0,0,0,0,0,0,0,0
"Bolivia (Plurinational State of)","2024-01-05",0,0,0,0,0,0,0,0
"Bolivia (Plurinational State of)","2024-01-06",0,0,0,0,0,0,0,0
"Bolivia (Plurinational State of)","2024-01-07",0,0,0,0,0,0,0,0
"Bolivia (Plurinational State of)","2024-01-08",0,0,0,0,0,0,0,0
"Bolivia (Plurinational State of)","2024-01-09",0,0,0,0,0,0,0,0
"Bolivia (Plurinational State of)","2024-01-10",0,0,0,0,0,0,0,0
"Bolivia (Plurinational State of)","2024-01-11",0,0,0,0,0,0,0,0
"Bolivia (Plurinational State of)","2024-01-12",0,0,0,0,0,0,0,0
"Bolivia (Plurinational State of)","2024-01-13",0,0,0,0,0,0,0,0
"Bolivia (Plurinational State of)","2024-01-14",0,0,0,0,0,0,0,0
"Bolivia (Plurinational State of)","2024-01-15",0,0,0,0,0,0,0,0
"Bolivia (Plurinational State of)","2024-01-16",0,0,0,0,0,0,0,0
"Bolivia (Plurinational State of)","2024-01-17",0,0,0,0,0,0,0,0
"Bolivia (Plurinational State of)","2024-01-18",0,0,0,0,0,0,0,0
"Bolivia (Plurinational State of)","2024-01-19",0,0,0,0,0,0,0,0
"Bolivia (Plurinational State of)","2024-01-20",0,0,0,0,0,0,0,0
"Bolivia (Plurinational State of)","2024-01-21",0,0,0,0,0,0,0,0
"Bolivia (Plurinational State of)","2024-01-22",0,0,0,0,0,0,0,0
"Bolivia (Plurinational State of)","2024-01-23",0,0,0,0,0,0,0,0
"Bolivia (Plurinational State of)","2024-01-24",0,0,0,0,0,0,0,0
"Bolivia (Plurinational State of)","2024-01-25",0,0,0,0,0,0,0,0
"Bolivia (Plurinational State of)","2024-01-26",0,0,0,0,0,0,0,0
"Bolivia (Plurinational State of)","2024-01-27",0,0,0,0,0,0,0,0
"Bolivia (Plurinational State of)","2024-01-28",0,0,0,0,0,0,0,0
"Bolivia (Plurinational State of)","2024-01-29",0,0,0,0,0,0,0,0
"Bolivia (Plurinational State of)","2024-01-30",0,0,0,0,0,0,0,0
"Bolivia (Plurinational State of)","2024-01-31",0,0,0,0,0,0,0,0
"Bolivia (Plurinational State of)","2024-02-01",0,0,0,0,0,0,0,0
"Bolivia (Plurinational State of)","2024-02-02",0,0,0,0,0,0,0,0
"Bolivia (Plurinational State of)","2024-02-03",0,0,0,0,0,0,0,0
"Bolivia (Plurinational State of)","2024-02-04",0,0,0,0,0,0,0,0
"Bolivia (Plurinational State of)","2024-02-05",0,0,0,0,0,0,0,0
"Bolivia (Plurinational State of)","2024-02-06",0,1,1,0,1,1,0,0
"Bolivia (Plurinational State of)","2024-02-07",0,0,1,0,0,1,0,0
"Bolivia (Plurinational State of)","2024-02-08",0,0,1,0,0,1,0,0
"Bolivia (Plurinational State of)","2024-02-09",0,0,1,0,0,1,0,0
"Bolivia (Plurinational State of)","2024-02-10",0,0,1,0,0,1,0,0
"Bolivia (Plurinational State of)","2024-02-11",0,0,1,0,0,1,0,0
"Bolivia (Plurinational State of)","2024-02-12",0,0,1,0,0,1,0,0
"Bolivia (Plurinational State of)","2024-02-13",0,0,1,0,0,1,0,0
"Bolivia (Plurinational State of)","2024-02-14",0,0,1,0,0,1,0,0
"Bolivia (Plurinational State of)","2024-02-15",0,0,1,0,0,1,0,0
"Bolivia (Plurinational State of)","2024-02-16",0,0,1,0,0,1,0,0
"Bolivia (Plurinational State of)","2024-02-17",0,0,1,0,0,1,0,0
"Bolivia (Plurinational State of)","2024-02-18",0,0,1,0,0,1,0,0
"Bolivia (Plurinational State of)","2024-02-19",0,0,1,0,0,1,0,0
"Bolivia (Plurinational State of)","2024-02-20",0,0,1,0,0,1,0,0
"Bolivia (Plurinational State of)","2024-02-21",0,0,1,0,0,1,0,0
"Bolivia (Plurinational State of)","2024-02-22",0,0,1,0,0,1,0,0
"Bolivia (Plurinational State of)","2024-02-23",0,0,1,0,0,1,0,0
"Bolivia (Plurinational State of)","2024-02-24",0,0,1,0,0,1,0,0
"Bolivia (Plurinational State of)","2024-02-25",0,0,1,0,0,1,0,0
"Bolivia (Plurinational State of)","2024-02-26",0,0,1,0,0,1,0,0
"Bolivia (Plurinational State of)","2024-02-27",0,0,1,0,0,1,0,0
"Bolivia (Plurinational State of)","2024-02-28",0,0,1,0,0,1,0,0
"Bolivia (Plurinational State of)","2024-02-29",0,0,1,0,0,1,0,0
"Bolivia (Plurinational State of)","2024-03-01",0,0,1,0,0,1,0,0
"Bolivia (Plurinational State of)","2024-03-02",0,0,1,0,0,1,0,0
"Bolivia (Plurinational State of)","2024-03-03",0,0,1,0,0,1,0,0
"Bolivia (Plurinational State of)","2024-03-04",0,0,1,0,0,1,0,0
"Bolivia (Plurinational State of)","2024-03-05",0,0,1,0,0,1,0,0
"Bolivia (Plurinational State of)","2024-03-06",0,0,1,0,0,1,0,0
"Bolivia (Plurinational State of)","2024-03-07",0,0,1,0,0,1,0,0
"Bolivia (Plurinational State of)","2024-03-08",0,0,1,0,0,1,0,0
"Bolivia (Plurinational State of)","2024-03-09",0,0,1,0,0,1,0,0
"Bolivia (Plurinational State of)","2024-03-10",0,0,1,0,0,1,0,0
"Bolivia (Plurinational State of)","2024-03-11",0,0,1,0,0,1,0,0
"Bolivia (Plurinational State of)","2024-03-12",0,0,1,0,0,1,0,0
"Bolivia (Plurinational State of)","2024-03-13",0,0,1,0,0,1,0,0
"Bolivia (Plurinational State of)","2024-03-14",0,0,1,0,0,1,0,0
"Bolivia (Plurinational State of)","2024-03-15",0,0,1,0,0,1,0,0
"Bolivia (Plurinational State of)","2024-03-16",0,0,1,0,0,1,0,0
"Bolivia (Plurinational State of)","2024-03-17",0,0,1,0,0,1,0,0
"Bolivia (Plurinational State of)","2024-03-18",0,0,1,0,0,1,0,0
"Bolivia (Plurinational State of)","2024-03-19",0,0,1,0,0,1,0,0
"Bolivia (Plurinational State of)","2024-03-20",0,0,1,0,0,1,0,0
"Bolivia (Plurinational State of)","2024-03-21",0,0,1,0,0,1,0,0
"Bolivia (Plurinational State of)","2024-03-22",0,0,1,0,0,1,0,0
"Bolivia (Plurinational State of)","2024-03-23",0,0,1,0,0,1,0,0
"Bolivia (Plurinational State of)","2024-03-24",0,0,1,0,0,1,0,0
"Bolivia (Plurinational State of)","2024-03-25",0,0,1,0,0,1,0,0
"Bolivia (Plurinational State of)","2024-03-26",0,0,1,0,0,1,0,0
"Bolivia (Plurinational State of)","2024-03-27",0,0,1,0,0,1,0,0
"Bolivia (Plurinational State of)","2024-03-28",0,0,1,0,0,1,0,0
"Bolivia (Plurinational State of)","2024-03-29",0,0,1,0,0,1,0,0
"Bolivia (Plurinational State of)","2024-03-30",0,0,1,0,0,1,0,0
"Bolivia (Plurinational State of)","2024-03-31",0,0,1,0,0,1,0,0
"Bolivia (Plurinational State of)","2024-04-01",0,0,1,0,0,1,0,0
"Bolivia (Plurinational State of)","2024-04-02",0,0,1,0,0,1,0,0
"Bolivia (Plurinational State of)","2024-04-03",0,0,1,0,0,1,0,0
"Bolivia (Plurinational State of)","2024-04-04",0,0,1,0,0,1,0,0
"Bolivia (Plurinational State of)","2024-04-05",0,0,1,0,0,1,0,0
"Bolivia (Plurinational State of)","2024-04-06",0,0,1,0,0,1,0,0
"Bolivia (Plurinational State of)","2024-04-07",0,0,1,0,0,1,0,0
"Bolivia (Plurinational State of)","2024-04-08",0,0,1,0,0,1,0,0
"Bolivia (Plurinational State of)","2024-04-09",0,0,1,0,0,1,0,0
"Bolivia (Plurinational State of)","2024-04-10",0,0,1,0,0,1,0,0
"Bolivia (Plurinational State of)","2024-04-11",0,0,1,0,0,1,0,0
"Bolivia (Plurinational State of)","2024-04-12",0,0,1,0,0,1,0,0
"Bolivia (Plurinational State of)","2024-04-13",0,0,1,0,0,1,0,0
"Bolivia (Plurinational State of)","2024-04-14",0,0,1,0,0,1,0,0
"Bolivia (Plurinational State of)","2024-04-15",0,0,1,0,0,1,0,0
"Bolivia (Plurinational State of)","2024-04-16",0,0,1,0,0,1,0,0
"Bolivia (Plurinational State of)","2024-04-17",0,0,1,0,0,1,0,0
"Bolivia (Plurinational State of)","2024-04-18",0,0,1,0,0,1,0,0
"Bolivia (Plurinational State of)","2024-04-19",0,0,1,0,0,1,0,0
"Bolivia (Plurinational State of)","2024-04-20",0,0,1,0,0,1,0,0
"Bolivia (Plurinational State of)","2024-04-21",0,0,1,0,0,1,0,0
"Bolivia (Plurinational State of)","2024-04-22",0,0,1,0,0,1,0,0
"Bolivia (Plurinational State of)","2024-04-23",0,0,1,0,0,1,0,0
"Bolivia (Plurinational State of)","2024-04-24",0,0,1,0,0,1,0,0
"Bolivia (Plurinational State of)","2024-04-25",0,0,1,0,0,1,0,0
"Bolivia (Plurinational State of)","2024-04-26",0,0,1,0,0,1,0,0
"Bolivia (Plurinational State of)","2024-04-27",0,0,1,0,0,1,0,0
"Bolivia (Plurinational State of)","2024-04-28",0,0,1,0,0,1,0,0
"Bolivia (Plurinational State of)","2024-04-29",0,0,1,0,0,1,0,0
"Bolivia (Plurinational State of)","2024-04-30",0,0,1,0,0,1,0,0
"Bolivia (Plurinational State of)","2024-05-01",0,0,1,0,0,1,0,0
"Bolivia (Plurinational State of)","2024-05-02",0,0,1,0,0,1,0,0
"Bolivia (Plurinational State of)","2024-05-03",0,0,1,0,0,1,0,0
"Bolivia (Plurinational State of)","2024-05-04",0,0,1,0,0,1,0,0
"Bolivia (Plurinational State of)","2024-05-05",0,0,1,0,0,1,0,0
"Bolivia (Plurinational State of)","2024-05-06",0,0,1,0,0,1,0,0
"Bolivia (Plurinational State of)","2024-05-07",0,0,1,0,0,1,0,0
"Bolivia (Plurinational State of)","2024-05-08",0,0,1,0,0,1,0,0
"Bolivia (Plurinational State of)","2024-05-09",0,0,1,0,0,1,0,0
"Bolivia (Plurinational State of)","2024-05-10",0,0,1,0,0,1,0,0
"Bolivia (Plurinational State of)","2024-05-11",0,0,1,0,0,1,0,0
"Bolivia (Plurinational State of)","2024-05-12",0,0,1,0,0,1,0,0
"Bolivia (Plurinational State of)","2024-05-13",0,0,1,0,0,1,0,0
"Bolivia (Plurinational State of)","2024-05-14",0,0,1,0,0,1,0,0
"Bolivia (Plurinational State of)","2024-05-15",0,0,1,0,0,1,0,0
"Bolivia (Plurinational State of)","2024-05-16",0,0,1,0,0,1,0,0
"Bolivia (Plurinational State of)","2024-05-17",0,0,1,0,0,1,0,0
"Bolivia (Plurinational State of)","2024-05-18",0,0,1,0,0,1,0,0
"Bolivia (Plurinational State of)","2024-05-19",0,0,1,0,0,1,0,0
"Bolivia (Plurinational State of)","2024-05-20",0,0,1,0,0,1,0,0
"Bolivia (Plurinational State of)","2024-05-21",0,0,1,0,0,1,0,0
"Bolivia (Plurinational State of)","2024-05-22",0,0,1,0,0,1,0,0
"Bolivia (Plurinational State of)","2024-05-23",0,0,1,0,0,1,0,0
"Bolivia (Plurinational State of)","2024-05-24",0,0,1,0,0,1,0,0
"Bolivia (Plurinational State of)","2024-05-25",0,0,1,0,0,1,0,0
"Bolivia (Plurinational State of)","2024-05-26",0,0,1,0,0,1,0,0
"Bolivia (Plurinational State of)","2024-05-27",0,0,1,0,0,1,0,0
"Bolivia (Plurinational State of)","2024-05-28",0,0,1,0,0,1,0,0
"Bolivia (Plurinational State of)","2024-05-29",0,0,1,0,0,1,0,0
"Bolivia (Plurinational State of)","2024-05-30",0,0,1,0,0,1,0,0
"Bolivia (Plurinational State of)","2024-05-31",0,0,1,0,0,1,0,0
"Bolivia (Plurinational State of)","2024-06-01",0,0,1,0,0,1,0,0
"Bolivia (Plurinational State of)","2024-06-02",0,0,1,0,0,1,0,0
"Bolivia (Plurinational State of)","2024-06-03",0,0,1,0,0,1,0,0
"Bolivia (Plurinational State of)","2024-06-04",0,0,1,0,0,1,0,0
"Bolivia (Plurinational State of)","2024-06-05",0,0,1,0,0,1,0,0
"Bolivia (Plurinational State of)","2024-06-06",0,0,1,0,0,1,0,0
"Bolivia (Plurinational State of)","2024-06-07",0,0,1,0,0,1,0,0
"Bolivia (Plurinational State of)","2024-06-08",0,0,1,0,0,1,0,0
"Bolivia (Plurinational State of)","2024-06-09",0,0,1,0,0,1,0,0
"Bolivia (Plurinational State of)","2024-06-10",0,0,1,0,0,1,0,0
"Bolivia (Plurinational State of)","2024-06-11",0,0,1,0,0,1,0,0
"Bolivia (Plurinational State of)","2024-06-12",0,0,1,0,0,1,0,0
"Bolivia (Plurinational State of)","2024-06-13",0,0,1,0,0,1,0,0
"Bolivia (Plurinational State of)","2024-06-14",0,0,1,0,0,1,0,0
"Bolivia (Plurinational State of)","2024-06-15",0,0,1,0,0,1,0,0
"Bolivia (Plurinational State of)","2024-06-16",0,0,1,0,0,1,0,0
"Bolivia (Plurinational State of)","2024-06-17",0,0,1,0,0,1,0,0
"Bolivia (Plurinational State of)","2024-06-18",0,0,1,0,0,1,0,0
"Bolivia (Plurinational State of)","2024-06-19",0,0,1,0,0,1,0,0
"Bolivia (Plurinational State of)","2024-06-20",0,0,1,0,0,1,0,0
"Bolivia (Plurinational State of)","2024-06-21",0,0,1,0,0,1,0,0
"Bolivia (Plurinational State of)","2024-06-22",0,0,1,0,0,1,0,0
"Bolivia (Plurinational State of)","2024-06-23",0,0,1,0,0,1,0,0
"Bolivia (Plurinational State of)","2024-06-24",0,0,1,0,0,1,0,0
"Bolivia (Plurinational State of)","2024-06-25",0,0,1,0,0,1,0,0
"Bolivia (Plurinational State of)","2024-06-26",0,0,1,0,0,1,0,0
"Bolivia (Plurinational State of)","2024-06-27",0,0,1,0,0,1,0,0
"Bolivia (Plurinational State of)","2024-06-28",0,0,1,0,0,1,0,0
"Bolivia (Plurinational State of)","2024-06-29",0,0,1,0,0,1,0,0
"Bolivia (Plurinational State of)","2024-06-30",0,0,1,0,0,1,0,0
"Bolivia (Plurinational State of)","2024-07-01",0,0,1,0,0,1,0,0
"Bolivia (Plurinational State of)","2024-07-02",0,0,1,0,0,1,0,0
"Bolivia (Plurinational State of)","2024-07-03",0,0,1,0,0,1,0,0
"Bolivia (Plurinational State of)","2024-07-04",0,0,1,0,0,1,0,0
"Bolivia (Plurinational State of)","2024-07-05",0,0,1,0,0,1,0,0
"Bolivia (Plurinational State of)","2024-07-06",0,0,1,0,0,1,0,0
"Bolivia (Plurinational State of)","2024-07-07",0,0,1,0,0,1,0,0
"Bolivia (Plurinational State of)","2024-07-08",0,0,1,0,0,1,0,0
"Bolivia (Plurinational State of)","2024-07-09",0,0,1,0,0,1,0,0
"Bolivia (Plurinational State of)","2024-07-10",0,0,1,0,0,1,0,0
"Bolivia (Plurinational State of)","2024-07-11",0,0,1,0,0,1,0,0
"Bolivia (Plurinational State of)","2024-07-12",0,0,1,0,0,1,0,0
"Bolivia (Plurinational State of)","2024-07-13",0,0,1,0,0,1,0,0
"Bolivia (Plurinational State of)","2024-07-14",0,0,1,0,0,1,0,0
"Bolivia (Plurinational State of)","2024-07-15",0,0,1,0,0,1,0,0
"Bolivia (Plurinational State of)","2024-07-16",0,0,1,0,0,1,0,0
"Bolivia (Plurinational State of)","2024-07-17",0,0,1,0,0,1,0,0
"Bolivia (Plurinational State of)","2024-07-18",0,0,1,0,0,1,0,0
"Bolivia (Plurinational State of)","2024-07-19",0,0,1,0,0,1,0,0
"Bolivia (Plurinational State of)","2024-07-20",0,0,1,0,0,1,0,0
"Bolivia (Plurinational State of)","2024-07-21",0,0,1,0,0,1,0,0
"Bolivia (Plurinational State of)","2024-07-22",0,0,1,0,0,1,0,0
"Bolivia (Plurinational State of)","2024-07-23",0,0,1,0,0,1,0,0
"Bolivia (Plurinational State of)","2024-07-24",0,0,1,0,0,1,0,0
"Bolivia (Plurinational State of)","2024-07-25",0,0,1,0,0,1,0,0
"Bolivia (Plurinational State of)","2024-07-26",0,0,1,0,0,1,0,0
"Bolivia (Plurinational State of)","2024-07-27",0,0,1,0,0,1,0,0
"Bolivia (Plurinational State of)","2024-07-28",0,0,1,0,0,1,0,0
"Bolivia (Plurinational State of)","2024-07-29",0,0,1,0,0,1,0,0
"Bolivia (Plurinational State of)","2024-07-30",0,0,1,0,0,1,0,0
"Bolivia (Plurinational State of)","2024-07-31",0,0,1,0,0,1,0,0
"Bolivia (Plurinational State of)","2024-08-01",0,0,1,0,0,1,0,0
"Bolivia (Plurinational State of)","2024-08-02",0,0,1,0,0,1,0,0
"Bolivia (Plurinational State of)","2024-08-03",0,0,1,0,0,1,0,0
"Bolivia (Plurinational State of)","2024-08-04",0,0,1,0,0,1,0,0
"Bolivia (Plurinational State of)","2024-08-05",0,0,1,0,0,1,0,0
"Bolivia (Plurinational State of)","2024-08-06",0,0,1,0,0,1,0,0
"Bolivia (Plurinational State of)","2024-08-07",0,0,1,0,0,1,0,0
"Bolivia (Plurinational State of)","2024-08-08",0,0,1,0,0,1,0,0
"Bolivia (Plurinational State of)","2024-08-09",0,0,1,0,0,1,0,0
"Bolivia (Plurinational State of)","2024-08-10",0,0,1,0,0,1,0,0
"Bolivia (Plurinational State of)","2024-08-11",0,0,1,0,0,1,0,0
"Bolivia (Plurinational State of)","2024-08-12",0,0,1,0,0,1,0,0
"Bolivia (Plurinational State of)","2024-08-13",0,0,1,0,0,1,0,0
"Bolivia (Plurinational State of)","2024-08-14",0,0,1,0,0,1,0,0
"Bolivia (Plurinational State of)","2024-08-15",0,0,1,0,0,1,0,0
"Bolivia (Plurinational State of)","2024-08-16",0,0,1,0,0,1,0,0
"Bolivia (Plurinational State of)","2024-08-17",0,0,1,0,0,1,0,0
"Bolivia (Plurinational State of)","2024-08-18",0,0,1,0,0,1,0,0
"Bolivia (Plurinational State of)","2024-08-19",0,0,1,0,0,1,0,0
"Bolivia (Plurinational State of)","2024-08-20",0,0,1,0,0,1,0,0
"Bolivia (Plurinational State of)","2024-08-21",0,0,1,0,0,1,0,0
"Bolivia (Plurinational State of)","2024-08-22",0,0,1,0,0,1,0,0
"Bolivia (Plurinational State of)","2024-08-23",0,0,1,0,0,1,0,0
"Bolivia (Plurinational State of)","2024-08-24",0,0,1,0,0,1,0,0
"Bolivia (Plurinational State of)","2024-08-25",0,0,1,0,0,1,0,0
"Bolivia (Plurinational State of)","2024-08-26",0,0,1,0,0,1,0,0
"Bolivia (Plurinational State of)","2024-08-27",0,0,1,0,0,1,0,0
"Bolivia (Plurinational State of)","2024-08-28",0,0,1,0,0,1,0,0
"Bolivia (Plurinational State of)","2024-08-29",0,0,1,0,0,1,0,0
"Bolivia (Plurinational State of)","2024-08-30",0,0,1,0,0,1,0,0
"Bolivia (Plurinational State of)","2024-08-31",0,0,1,0,0,1,0,0
"Bolivia (Plurinational State of)","2024-09-01",0,0,1,0,0,1,0,0
"Bolivia (Plurinational State of)","2024-09-02",0,0,1,0,0,1,0,0
"Bolivia (Plurinational State of)","2024-09-03",0,0,1,0,0,1,0,0
"Bolivia (Plurinational State of)","2024-09-04",0,0,1,0,0,1,0,0
"Bolivia (Plurinational State of)","2024-09-05",0,0,1,0,0,1,0,0
"Bolivia (Plurinational State of)","2024-09-06",0,0,1,0,0,1,0,0
"Bolivia (Plurinational State of)","2024-09-07",0,0,1,0,0,1,0,0
"Bolivia (Plurinational State of)","2024-09-08",0,0,1,0,0,1,0,0
"Bolivia (Plurinational State of)","2024-09-09",0,0,1,0,0,1,0,0
"Bolivia (Plurinational State of)","2024-09-10",0,0,1,0,0,1,0,0
"Bolivia (Plurinational State of)","2024-09-11",0,0,1,0,0,1,0,0
"Bolivia (Plurinational State of)","2024-09-12",0,0,1,0,0,1,0,0
"Bolivia (Plurinational State of)","2024-09-13",0,0,1,0,0,1,0,0
"Bolivia (Plurinational State of)","2024-09-14",0,0,1,0,0,1,0,0
"Bolivia (Plurinational State of)","2024-09-15",0,0,1,0,0,1,0,0
"Bolivia (Plurinational State of)","2024-09-16",0,0,1,0,0,1,0,0
"Bolivia (Plurinational State of)","2024-09-17",0,0,1,0,0,1,0,0
"Bolivia (Plurinational State of)","2024-09-18",0,0,1,0,0,1,0,0
"Bolivia (Plurinational State of)","2024-09-19",0,0,1,0,0,1,0,0
"Bolivia (Plurinational State of)","2024-09-20",0,0,1,0,0,1,0,0
"Bolivia (Plurinational State of)","2024-09-21",0,0,1,0,0,1,0,0
"Bolivia (Plurinational State of)","2024-09-22",0,0,1,0,0,1,0,0
"Bolivia (Plurinational State of)","2024-09-23",0,0,1,0,0,1,0,0
"Bolivia (Plurinational State of)","2024-09-24",0,0,1,0,0,1,0,0
"Bolivia (Plurinational State of)","2024-09-25",0,0,1,0,0,1,0,0
"Bolivia (Plurinational State of)","2024-09-26",0,0,1,0,0,1,0,0
"Bolivia (Plurinational State of)","2024-09-27",0,0,1,0,0,1,0,0
"Bolivia (Plurinational State of)","2024-09-28",0,0,1,0,0,1,0,0
"Bolivia (Plurinational State of)","2024-09-29",0,0,1,0,0,1,0,0
"Bolivia (Plurinational State of)","2024-09-30",0,0,1,0,0,1,0,0
"Bolivia (Plurinational State of)","2024-10-01",0,0,1,0,0,1,0,0
"Bolivia (Plurinational State of)","2024-10-02",0,0,1,0,0,1,0,0
"Bolivia (Plurinational State of)","2024-10-03",0,0,1,0,0,1,0,0
"Bolivia (Plurinational State of)","2024-10-04",0,0,1,0,0,1,0,0
"Bolivia (Plurinational State of)","2024-10-05",0,0,1,0,0,1,0,0
"Bolivia (Plurinational State of)","2024-10-06",0,0,1,0,0,1,0,0
"Bolivia (Plurinational State of)","2024-10-07",0,0,1,0,0,1,0,0
"Bolivia (Plurinational State of)","2024-10-08",0,0,1,0,0,1,0,0
"Bolivia (Plurinational State of)","2024-10-09",0,0,1,0,0,1,0,0
"Bolivia (Plurinational State of)","2024-10-10",0,0,1,0,0,1,0,0
"Bolivia (Plurinational State of)","2024-10-11",0,0,1,0,0,1,0,0
"Bolivia (Plurinational State of)","2024-10-12",0,0,1,0,0,1,0,0
"Bolivia (Plurinational State of)","2024-10-13",0,0,1,0,0,1,0,0
"Bolivia (Plurinational State of)","2024-10-14",0,0,1,0,0,1,0,0
"Bolivia (Plurinational State of)","2024-10-15",0,0,1,0,0,1,0,0
"Bolivia (Plurinational State of)","2024-10-16",0,0,1,0,0,1,0,0
"Bolivia (Plurinational State of)","2024-10-17",0,0,1,0,0,1,0,0
"Bolivia (Plurinational State of)","2024-10-18",0,0,1,0,0,1,0,0
"Bolivia (Plurinational State of)","2024-10-19",0,0,1,0,0,1,0,0
"Bolivia (Plurinational State of)","2024-10-20",0,0,1,0,0,1,0,0
"Bolivia (Plurinational State of)","2024-10-21",0,0,1,0,0,1,0,0
"Bolivia (Plurinational State of)","2024-10-22",0,0,1,0,0,1,0,0
"Bolivia (Plurinational State of)","2024-10-23",0,0,1,0,0,1,0,0
"Bolivia (Plurinational State of)","2024-10-24",0,0,1,0,0,1,0,0
"Bolivia (Plurinational State of)","2024-10-25",0,0,1,0,0,1,0,0
"Bolivia (Plurinational State of)","2024-10-26",0,0,1,0,0,1,0,0
"Bolivia (Plurinational State of)","2024-10-27",0,0,1,0,0,1,0,0
"Bolivia (Plurinational State of)","2024-10-28",0,0,1,0,0,1,0,0
"Bolivia (Plurinational State of)","2024-10-29",0,0,1,0,0,1,0,0
"Bolivia (Plurinational State of)","2024-10-30",0,0,1,0,0,1,0,0
"Bolivia (Plurinational State of)","2024-10-31",0,0,1,0,0,1,0,0
"Bolivia (Plurinational State of)","2024-11-01",0,0,1,0,0,1,0,0
"Bolivia (Plurinational State of)","2024-11-02",0,0,1,0,0,1,0,0
"Bolivia (Plurinational State of)","2024-11-03",0,0,1,0,0,1,0,0
"Bolivia (Plurinational State of)","2024-11-04",0,0,1,0,0,1,0,0
"Bolivia (Plurinational State of)","2024-11-05",0,0,1,0,0,1,0,0
"Bolivia (Plurinational State of)","2024-11-06",0,0,1,0,0,1,0,0
"Bolivia (Plurinational State of)","2024-11-07",0,0,1,0,0,1,0,0
"Bolivia (Plurinational State of)","2024-11-08",0,0,1,0,0,1,0,0
"Bolivia (Plurinational State of)","2024-11-09",0,0,1,0,0,1,0,0
"Bolivia (Plurinational State of)","2024-11-10",0,0,1,0,0,1,0,0
"Bolivia (Plurinational State of)","2024-11-11",0,0,1,0,0,1,0,0
"Bolivia (Plurinational State of)","2024-11-12",0,0,1,0,0,1,0,0
"Bolivia (Plurinational State of)","2024-11-13",0,0,1,0,0,1,0,0
"Bolivia (Plurinational State of)","2024-11-14",0,0,1,0,0,1,0,0
"Bolivia (Plurinational State of)","2024-11-15",0,0,1,0,0,1,0,0
"Bolivia (Plurinational State of)","2024-11-16",0,0,1,0,0,1,0,0
"Bolivia (Plurinational State of)","2024-11-17",0,0,1,0,0,1,0,0
"Bolivia (Plurinational State of)","2024-11-18",0,0,1,0,0,1,0,0
"Bolivia (Plurinational State of)","2024-11-19",0,0,1,0,0,1,0,0
"Bolivia (Plurinational State of)","2024-11-20",0,0,1,0,0,1,0,0
"Bolivia (Plurinational State of)","2024-11-21",0,0,1,0,0,1,0,0
"Bolivia (Plurinational State of)","2024-11-22",0,0,1,0,0,1,0,0
"Bolivia (Plurinational State of)","2024-11-23",0,0,1,0,0,1,0,0
"Bolivia (Plurinational State of)","2024-11-24",0,0,1,0,0,1,0,0
"Bolivia (Plurinational State of)","2024-11-25",0,0,1,0,0,1,0,0
"Bolivia (Plurinational State of)","2024-11-26",0,0,1,0,0,1,0,0
"Bolivia (Plurinational State of)","2024-11-27",0,0,1,0,0,1,0,0
"Bolivia (Plurinational State of)","2024-11-28",0,0,1,0,0,1,0,0
"Bolivia (Plurinational State of)","2024-11-29",0,0,1,0,0,1,0,0
"Bolivia (Plurinational State of)","2024-11-30",0,0,1,0,0,1,0,0
"Bolivia (Plurinational State of)","2024-12-01",0,0,1,0,0,1,0,0
"Bolivia (Plurinational State of)","2024-12-02",0,0,1,0,0,1,0,0
"Bolivia (Plurinational State of)","2024-12-03",0,0,1,0,0,1,0,0
"Bolivia (Plurinational State of)","2024-12-04",0,0,1,0,0,1,0,0
"Bolivia (Plurinational State of)","2024-12-05",0,0,1,0,0,1,0,0
"Bolivia (Plurinational State of)","2024-12-06",0,0,1,0,0,1,0,0
"Bolivia (Plurinational State of)","2024-12-07",0,0,1,0,0,1,0,0
"Bolivia (Plurinational State of)","2024-12-08",0,0,1,0,0,1,0,0
"Bolivia (Plurinational State of)","2024-12-09",0,0,1,0,0,1,0,0
"Bolivia (Plurinational State of)","2024-12-10",0,0,1,0,0,1,0,0
"Bolivia (Plurinational State of)","2024-12-11",0,0,1,0,0,1,0,0
"Bolivia (Plurinational State of)","2024-12-12",0,0,1,0,0,1,0,0
"Bolivia (Plurinational State of)","2024-12-13",0,0,1,0,0,1,0,0
"Bolivia (Plurinational State of)","2024-12-14",0,0,1,0,0,1,0,0
"Bolivia (Plurinational State of)","2024-12-15",0,0,1,0,0,1,0,0
"Bolivia (Plurinational State of)","2024-12-16",0,0,1,0,0,1,0,0
"Bolivia (Plurinational State of)","2024-12-17",0,0,1,0,0,1,0,0
"Bolivia (Plurinational State of)","2024-12-18",0,0,1,0,0,1,0,0
"Bolivia (Plurinational State of)","2024-12-19",0,0,1,0,0,1,0,0
"Bolivia (Plurinational State of)","2024-12-20",0,0,1,0,0,1,0,0
"Bolivia (Plurinational State of)","2024-12-21",0,0,1,0,0,1,0,0
"Bolivia (Plurinational State of)","2024-12-22",0,0,1,0,0,1,0,0
"Bolivia (Plurinational State of)","2024-12-23",0,0,1,0,0,1,0,0
"Bolivia (Plurinational State of)","2024-12-24",0,0,1,0,0,1,0,0
"Bolivia (Plurinational State of)","2024-12-25",0,0,1,0,0,1,0,0
"Bolivia (Plurinational State of)","2024-12-26",0,0,1,0,0,1,0,0
"Bolivia (Plurinational State of)","2024-12-27",0,0,1,0,0,1,0,0
"Bolivia (Plurinational State of)","2024-12-28",0,0,1,0,0,1,0,0
"Bolivia (Plurinational State of)","2024-12-29",0,0,1,0,0,1,0,0
"Bolivia (Plurinational State of)","2024-12-30",0,0,1,0,0,1,0,0
"Bolivia (Plurinational State of)","2024-12-31",0,0,1,0,0,1,0,0
"Bolivia (Plurinational State of)","2025-01-01",0,0,1,0,0,1,0,0
"Bolivia (Plurinational State of)","2025-01-02",0,0,1,0,0,1,0,0
"Bolivia (Plurinational State of)","2025-01-03",0,0,1,0,0,1,0,0
"Bolivia (Plurinational State of)","2025-01-04",0,0,1,0,0,1,0,0
"Bolivia (Plurinational State of)","2025-01-05",0,0,1,0,0,1,0,0
"Bolivia (Plurinational State of)","2025-01-06",0,0,1,0,0,1,0,0
"Bolivia (Plurinational State of)","2025-01-07",0,0,1,0,0,1,0,0
"Bolivia (Plurinational State of)","2025-01-08",0,0,1,0,0,1,0,0
"Bolivia (Plurinational State of)","2025-01-09",0,0,1,0,0,1,0,0
"Bolivia (Plurinational State of)","2025-01-10",0,0,1,0,0,1,0,0
"Bolivia (Plurinational State of)","2025-01-11",0,0,1,0,0,1,0,0
"Bolivia (Plurinational State of)","2025-01-12",0,0,1,0,0,1,0,0
"Bolivia (Plurinational State of)","2025-01-13",0,0,1,0,0,1,0,0
"Bolivia (Plurinational State of)","2025-01-14",0,0,1,0,0,1,0,0
"Bolivia (Plurinational State of)","2025-01-15",0,0,1,0,0,1,0,0
"Bolivia (Plurinational State of)","2025-01-16",0,0,1,0,0,1,0,0
"Bolivia (Plurinational State of)","2025-01-17",0,0,1,0,0,1,0,0
"Bolivia (Plurinational State of)","2025-01-18",0,0,1,0,0,1,0,0
"Bolivia (Plurinational State of)","2025-01-19",0,0,1,0,0,1,0,0
"Bolivia (Plurinational State of)","2025-01-20",0,0,1,0,0,1,0,0
"Bolivia (Plurinational State of)","2025-01-21",0,0,1,0,0,1,0,0
"Bolivia (Plurinational State of)","2025-01-22",0,0,1,0,0,1,0,0
"Bolivia (Plurinational State of)","2025-01-23",0,0,1,0,0,1,0,0
"Bolivia (Plurinational State of)","2025-01-24",0,0,1,0,0,1,0,0
"Bolivia (Plurinational State of)","2025-01-25",0,0,1,0,0,1,0,0
"Bolivia (Plurinational State of)","2025-01-26",0,0,1,0,0,1,0,0
"Bolivia (Plurinational State of)","2025-01-27",0,0,1,0,0,1,0,0
"Bolivia (Plurinational State of)","2025-01-28",0,0,1,0,0,1,0,0
"Bolivia (Plurinational State of)","2025-01-29",0,0,1,0,0,1,0,0
"Bolivia (Plurinational State of)","2025-01-30",0,0,1,0,0,1,0,0
"Bolivia (Plurinational State of)","2025-01-31",0,0,1,0,0,1,0,0
"Bolivia (Plurinational State of)","2025-02-01",0,0,1,0,0,1,0,0
"Bolivia (Plurinational State of)","2025-02-02",0,0,1,0,0,1,0,0
"Bolivia (Plurinational State of)","2025-02-03",0,0,1,0,0,1,0,0
"Bolivia (Plurinational State of)","2025-02-04",0,0,1,0,0,1,0,0
"Bolivia (Plurinational State of)","2025-02-05",0,0,1,0,0,1,0,0
"Bolivia (Plurinational State of)","2025-02-06",0,0,1,0,0,1,0,0
"Bolivia (Plurinational State of)","2025-02-07",0,0,1,0,0,1,0,0
"Bolivia (Plurinational State of)","2025-02-08",0,0,1,0,0,1,0,0
"Bolivia (Plurinational State of)","2025-02-09",0,0,1,0,0,1,0,0
"Bolivia (Plurinational State of)","2025-02-10",0,0,1,0,0,1,0,0
"Bolivia (Plurinational State of)","2025-02-11",0,0,1,0,0,1,0,0
"Bolivia (Plurinational State of)","2025-02-12",0,0,1,0,0,1,0,0
"Bolivia (Plurinational State of)","2025-02-13",0,0,1,0,0,1,0,0
"Bolivia (Plurinational State of)","2025-02-14",0,0,1,0,0,1,0,0
"Bolivia (Plurinational State of)","2025-02-15",0,0,1,0,0,1,0,0
"Bolivia (Plurinational State of)","2025-02-16",0,0,1,0,0,1,0,0
"Bolivia (Plurinational State of)","2025-02-17",0,0,1,0,0,1,0,0
"Bolivia (Plurinational State of)","2025-02-18",0,0,1,0,0,1,0,0
"Bolivia (Plurinational State of)","2025-02-19",0,0,1,0,0,1,0,0
"Bolivia (Plurinational State of)","2025-02-20",0,0,1,0,0,1,0,0
"Bolivia (Plurinational State of)","2025-02-21",0,0,1,0,0,1,0,0
"Bolivia (Plurinational State of)","2025-02-22",0,0,1,0,0,1,0,0
"Bolivia (Plurinational State of)","2025-02-23",0,0,1,0,0,1,0,0
"Bolivia (Plurinational State of)","2025-02-24",0,0,1,0,0,1,0,0
"Bolivia (Plurinational State of)","2025-02-25",0,0,1,0,0,1,0,0
"Bolivia (Plurinational State of)","2025-02-26",0,0,1,0,0,1,0,0
"Bolivia (Plurinational State of)","2025-02-27",0,0,1,0,0,1,0,0
"Bolivia (Plurinational State of)","2025-02-28",0,0,1,0,0,1,0,0
"Bolivia (Plurinational State of)","2025-03-01",0,0,1,0,0,1,0,0
"Bolivia (Plurinational State of)","2025-03-02",0,0,1,0,0,1,0,0
"Bolivia (Plurinational State of)","2025-03-03",0,0,1,0,0,1,0,0
"Bosnia and Herzegovina","2024-01-01",0,0,0,0,0,0,0,0
"Bosnia and Herzegovina","2024-01-02",0,0,0,0,0,0,0,0
"Bosnia and Herzegovina","2024-01-03",0,0,0,0,0,0,0,0
"Bosnia and Herzegovina","2024-01-04",0,0,0,0,0,0,0,0
"Bosnia and Herzegovina","2024-01-05",0,0,0,0,0,0,0,0
"Bosnia and Herzegovina","2024-01-06",0,0,0,0,0,0,0,0
"Bosnia and Herzegovina","2024-01-07",0,0,0,0,0,0,0,0
"Bosnia and Herzegovina","2024-01-08",0,0,0,0,0,0,0,0
"Bosnia and Herzegovina","2024-01-09",0,0,0,0,0,0,0,0
"Bosnia and Herzegovina","2024-01-10",0,0,0,0,0,0,0,0
"Bosnia and Herzegovina","2024-01-11",0,0,0,0,0,0,0,0
"Bosnia and Herzegovina","2024-01-12",0,0,0,0,0,0,0,0
"Bosnia and Herzegovina","2024-01-13",0,0,0,0,0,0,0,0
"Bosnia and Herzegovina","2024-01-14",0,0,0,0,0,0,0,0
"Bosnia and Herzegovina","2024-01-15",0,0,0,0,0,0,0,0
"Bosnia and Herzegovina","2024-01-16",0,0,0,0,0,0,0,0
"Bosnia and Herzegovina","2024-01-17",0,0,0,0,0,0,0,0
"Bosnia and Herzegovina","2024-01-18",0,0,0,0,0,0,0,0
"Bosnia and Herzegovina","2024-01-19",0,0,0,0,0,0,0,0
"Bosnia and Herzegovina","2024-01-20",0,0,0,0,0,0,0,0
"Bosnia and Herzegovina","2024-01-21",0,0,0,0,0,0,0,0
"Bosnia and Herzegovina","2024-01-22",0,0,0,0,0,0,0,0
"Bosnia and Herzegovina","2024-01-23",0,0,0,0,0,0,0,0
"Bosnia and Herzegovina","2024-01-24",0,0,0,0,0,0,0,0
"Bosnia and Herzegovina","2024-01-25",0,0,0,0,0,0,0,0
"Bosnia and Herzegovina","2024-01-26",0,0,0,0,0,0,0,0
"Bosnia and Herzegovina","2024-01-27",0,0,0,0,0,0,0,0
"Bosnia and Herzegovina","2024-01-28",0,0,0,0,0,0,0,0
"Bosnia and Herzegovina","2024-01-29",0,0,0,0,0,0,0,0
"Bosnia and Herzegovina","2024-01-30",0,0,0,0,0,0,0,0
"Bosnia and Herzegovina","2024-01-31",0,0,0,0,0,0,0,0
"Bosnia and Herzegovina","2024-02-01",0,0,0,0,0,0,0,0
"Bosnia and Herzegovina","2024-02-02",0,0,0,0,0,0,0,0
"Bosnia and Herzegovina","2024-02-03",0,0,0,0,0,0,0,0
"Bosnia and Herzegovina","2024-02-04",0,0,0,0,0,0,0,0
"Bosnia and Herzegovina","2024-02-05",0,0,0,0,0,0,0,0
"Bosnia and Herzegovina","2024-02-06",0,0,0,0,0,0,0,0
"Bosnia and Herzegovina","2024-02-07",0,0,0,0,0,0,0,0
"Bosnia and Herzegovina","2024-02-08",0,0,0,0,0,0,0,0
"Bosnia and Herzegovina","2024-02-09",0,0,0,0,0,0,0,0
"Bosnia and Herzegovina","2024-02-10",0,0,0,0,0,0,0,0
"Bosnia and Herzegovina","2024-02-11",0,0,0,0,0,0,0,0
"Bosnia and Herzegovina","2024-02-12",0,0,0,0,0,0,0,0
"Bosnia and Herzegovina","2024-02-13",0,0,0,0,0,0,0,0
"Bosnia and Herzegovina","2024-02-14",0,0,0,0,0,0,0,0
"Bosnia and Herzegovina","2024-02-15",0,0,0,0,0,0,0,0
"Bosnia and Herzegovina","2024-02-16",0,0,0,0,0,0,0,0
"Bosnia and Herzegovina","2024-02-17",0,0,0,0,0,0,0,0
"Bosnia and Herzegovina","2024-02-18",0,0,0,0,0,0,0,0
"Bosnia and Herzegovina","2024-02-19",0,0,0,0,0,0,0,0
"Bosnia and Herzegovina","2024-02-20",0,0,0,0,0,0,0,0
"Bosnia and Herzegovina","2024-02-21",0,0,0,0,0,0,0,0
"Bosnia and Herzegovina","2024-02-22",0,0,0,0,0,0,0,0
"Bosnia and Herzegovina","2024-02-23",0,0,0,0,0,0,0,0
"Bosnia and Herzegovina","2024-02-24",0,0,0,0,0,0,0,0
"Bosnia and Herzegovina","2024-02-25",0,0,0,0,0,0,0,0
"Bosnia and Herzegovina","2024-02-26",0,0,0,0,0,0,0,0
"Bosnia and Herzegovina","2024-02-27",0,0,0,0,0,0,0,0
"Bosnia and Herzegovina","2024-02-28",0,0,0,0,0,0,0,0
"Bosnia and Herzegovina","2024-02-29",0,0,0,0,0,0,0,0
"Bosnia and Herzegovina","2024-03-01",0,0,0,0,0,0,0,0
"Bosnia and Herzegovina","2024-03-02",0,0,0,0,0,0,0,0
"Bosnia and Herzegovina","2024-03-03",0,0,0,0,0,0,0,0
"Bosnia and Herzegovina","2024-03-04",0,0,0,0,0,0,0,0
"Bosnia and Herzegovina","2024-03-05",0,0,0,0,0,0,0,0
"Bosnia and Herzegovina","2024-03-06",0,0,0,0,0,0,0,0
"Bosnia and Herzegovina","2024-03-07",0,0,0,0,0,0,0,0
"Bosnia and Herzegovina","2024-03-08",0,0,0,0,0,0,0,0
"Bosnia and Herzegovina","2024-03-09",0,0,0,0,0,0,0,0
"Bosnia and Herzegovina","2024-03-10",0,0,0,0,0,0,0,0
"Bosnia and Herzegovina","2024-03-11",0,0,0,0,0,0,0,0
"Bosnia and Herzegovina","2024-03-12",0,0,0,0,0,0,0,0
"Bosnia and Herzegovina","2024-03-13",0,0,0,0,0,0,0,0
"Bosnia and Herzegovina","2024-03-14",0,0,0,0,0,0,0,0
"Bosnia and Herzegovina","2024-03-15",0,0,0,0,0,0,0,0
"Bosnia and Herzegovina","2024-03-16",0,0,0,0,0,0,0,0
"Bosnia and Herzegovina","2024-03-17",0,0,0,0,0,0,0,0
"Bosnia and Herzegovina","2024-03-18",0,0,0,0,0,0,0,0
"Bosnia and Herzegovina","2024-03-19",0,0,0,0,0,0,0,0
"Bosnia and Herzegovina","2024-03-20",0,0,0,0,0,0,0,0
"Bosnia and Herzegovina","2024-03-21",0,0,0,0,0,0,0,0
"Bosnia and Herzegovina","2024-03-22",0,0,0,0,0,0,0,0
"Bosnia and Herzegovina","2024-03-23",0,0,0,0,0,0,0,0
"Bosnia and Herzegovina","2024-03-24",0,0,0,0,0,0,0,0
"Bosnia and Herzegovina","2024-03-25",0,0,0,0,0,0,0,0
"Bosnia and Herzegovina","2024-03-26",0,0,0,0,0,0,0,0
"Bosnia and Herzegovina","2024-03-27",0,0,0,0,0,0,0,0
"Bosnia and Herzegovina","2024-03-28",0,0,0,0,0,0,0,0
"Bosnia and Herzegovina","2024-03-29",0,0,0,0,0,0,0,0
"Bosnia and Herzegovina","2024-03-30",0,0,0,0,0,0,0,0
"Bosnia and Herzegovina","2024-03-31",0,0,0,0,0,0,0,0
"Bosnia and Herzegovina","2024-04-01",0,0,0,0,0,0,0,0
"Bosnia and Herzegovina","2024-04-02",0,0,0,0,0,0,0,0
"Bosnia and Herzegovina","2024-04-03",0,0,0,0,0,0,0,0
"Bosnia and Herzegovina","2024-04-04",0,0,0,0,0,0,0,0
"Bosnia and Herzegovina","2024-04-05",0,0,0,0,0,0,0,0
"Bosnia and Herzegovina","2024-04-06",0,0,0,0,0,0,0,0
"Bosnia and Herzegovina","2024-04-07",0,0,0,0,0,0,0,0
"Bosnia and Herzegovina","2024-04-08",0,0,0,0,0,0,0,0
"Bosnia and Herzegovina","2024-04-09",0,0,0,0,0,0,0,0
"Bosnia and Herzegovina","2024-04-10",0,0,0,0,0,0,0,0
"Bosnia and Herzegovina","2024-04-11",0,0,0,0,0,0,0,0
"Bosnia and Herzegovina","2024-04-12",0,0,0,0,0,0,0,0
"Bosnia and Herzegovina","2024-04-13",0,0,0,0,0,0,0,0
"Bosnia and Herzegovina","2024-04-14",0,0,0,0,0,0,0,0
"Bosnia and Herzegovina","2024-04-15",0,0,0,0,0,0,0,0
"Bosnia and Herzegovina","2024-04-16",0,0,0,0,0,0,0,0
"Bosnia and Herzegovina","2024-04-17",0,0,0,0,0,0,0,0
"Bosnia and Herzegovina","2024-04-18",0,0,0,0,0,0,0,0
"Bosnia and Herzegovina","2024-04-19",0,0,0,0,0,0,0,0
"Bosnia and Herzegovina","2024-04-20",0,0,0,0,0,0,0,0
"Bosnia and Herzegovina","2024-04-21",0,0,0,0,0,0,0,0
"Bosnia and Herzegovina","2024-04-22",0,0,0,0,0,0,0,0
"Bosnia and Herzegovina","2024-04-23",0,0,0,0,0,0,0,0
"Bosnia and Herzegovina","2024-04-24",0,0,0,0,0,0,0,0
"Bosnia and Herzegovina","2024-04-25",0,0,0,0,0,0,0,0
"Bosnia and Herzegovina","2024-04-26",0,0,0,0,0,0,0,0
"Bosnia and Herzegovina","2024-04-27",0,0,0,0,0,0,0,0
"Bosnia and Herzegovina","2024-04-28",0,0,0,0,0,0,0,0
"Bosnia and Herzegovina","2024-04-29",0,0,0,0,0,0,0,0
"Bosnia and Herzegovina","2024-04-30",0,0,0,0,0,0,0,0
"Bosnia and Herzegovina","2024-05-01",0,0,0,0,0,0,0,0
"Bosnia and Herzegovina","2024-05-02",0,0,0,0,0,0,0,0
"Bosnia and Herzegovina","2024-05-03",0,0,0,0,0,0,0,0
"Bosnia and Herzegovina","2024-05-04",0,0,0,0,0,0,0,0
"Bosnia and Herzegovina","2024-05-05",0,0,0,0,0,0,0,0
"Bosnia and Herzegovina","2024-05-06",0,0,0,0,0,0,0,0
"Bosnia and Herzegovina","2024-05-07",0,0,0,0,0,0,0,0
"Bosnia and Herzegovina","2024-05-08",0,0,0,0,0,0,0,0
"Bosnia and Herzegovina","2024-05-09",0,0,0,0,0,0,0,0
"Bosnia and Herzegovina","2024-05-10",0,0,0,0,0,0,0,0
"Bosnia and Herzegovina","2024-05-11",0,0,0,0,0,0,0,0
"Bosnia and Herzegovina","2024-05-12",0,0,0,0,0,0,0,0
"Bosnia and Herzegovina","2024-05-13",0,0,0,0,0,0,0,0
"Bosnia and Herzegovina","2024-05-14",0,0,0,0,0,0,0,0
"Bosnia and Herzegovina","2024-05-15",0,0,0,0,0,0,0,0
"Bosnia and Herzegovina","2024-05-16",0,0,0,0,0,0,0,0
"Bosnia and Herzegovina","2024-05-17",0,0,0,0,0,0,0,0
"Bosnia and Herzegovina","2024-05-18",0,0,0,0,0,0,0,0
"Bosnia and Herzegovina","2024-05-19",0,0,0,0,0,0,0,0
"Bosnia and Herzegovina","2024-05-20",0,0,0,0,0,0,0,0
"Bosnia and Herzegovina","2024-05-21",0,0,0,0,0,0,0,0
"Bosnia and Herzegovina","2024-05-22",0,0,0,0,0,0,0,0
"Bosnia and Herzegovina","2024-05-23",0,0,0,0,0,0,0,0
"Bosnia and Herzegovina","2024-05-24",0,0,0,0,0,0,0,0
"Bosnia and Herzegovina","2024-05-25",0,0,0,0,0,0,0,0
"Bosnia and Herzegovina","2024-05-26",0,0,0,0,0,0,0,0
"Bosnia and Herzegovina","2024-05-27",0,0,0,0,0,0,0,0
"Bosnia and Herzegovina","2024-05-28",0,0,0,0,0,0,0,0
"Bosnia and Herzegovina","2024-05-29",0,0,0,0,0,0,0,0
"Bosnia and Herzegovina","2024-05-30",0,0,0,0,0,0,0,0
"Bosnia and Herzegovina","2024-05-31",0,0,0,0,0,0,0,0
"Bosnia and Herzegovina","2024-06-01",0,0,0,0,0,0,0,0
"Bosnia and Herzegovina","2024-06-02",0,0,0,0,0,0,0,0
"Bosnia and Herzegovina","2024-06-03",0,0,0,0,0,0,0,0
"Bosnia and Herzegovina","2024-06-04",0,0,0,0,0,0,0,0
"Bosnia and Herzegovina","2024-06-05",0,0,0,0,0,0,0,0
"Bosnia and Herzegovina","2024-06-06",0,0,0,0,0,0,0,0
"Bosnia and Herzegovina","2024-06-07",0,0,0,0,0,0,0,0
"Bosnia and Herzegovina","2024-06-08",0,0,0,0,0,0,0,0
"Bosnia and Herzegovina","2024-06-09",0,0,0,0,0,0,0,0
"Bosnia and Herzegovina","2024-06-10",0,0,0,0,0,0,0,0
"Bosnia and Herzegovina","2024-06-11",0,0,0,0,0,0,0,0
"Bosnia and Herzegovina","2024-06-12",0,0,0,0,0,0,0,0
"Bosnia and Herzegovina","2024-06-13",0,0,0,0,0,0,0,0
"Bosnia and Herzegovina","2024-06-14",0,0,0,0,0,0,0,0
"Bosnia and Herzegovina","2024-06-15",0,0,0,0,0,0,0,0
"Bosnia and Herzegovina","2024-06-16",0,0,0,0,0,0,0,0
"Bosnia and Herzegovina","2024-06-17",0,0,0,0,0,0,0,0
"Bosnia and Herzegovina","2024-06-18",0,0,0,0,0,0,0,0
"Bosnia and Herzegovina","2024-06-19",0,0,0,0,0,0,0,0
"Bosnia and Herzegovina","2024-06-20",0,0,0,0,0,0,0,0
"Bosnia and Herzegovina","2024-06-21",0,0,0,0,0,0,0,0
"Bosnia and Herzegovina","2024-06-22",0,0,0,0,0,0,0,0
"Bosnia and Herzegovina","2024-06-23",0,0,0,0,0,0,0,0
"Bosnia and Herzegovina","2024-06-24",0,0,0,0,0,0,0,0
"Bosnia and Herzegovina","2024-06-25",0,0,0,0,0,0,0,0
"Bosnia and Herzegovina","2024-06-26",0,0,0,0,0,0,0,0
"Bosnia and Herzegovina","2024-06-27",0,0,0,0,0,0,0,0
"Bosnia and Herzegovina","2024-06-28",0,0,0,0,0,0,0,0
"Bosnia and Herzegovina","2024-06-29",0,0,0,0,0,0,0,0
"Bosnia and Herzegovina","2024-06-30",0,0,0,0,0,0,0,0
"Bosnia and Herzegovina","2024-07-01",0,0,0,0,0,0,0,0
"Bosnia and Herzegovina","2024-07-02",0,0,0,0,0,0,0,0
"Bosnia and Herzegovina","2024-07-03",0,0,0,0,0,0,0,0
"Bosnia and Herzegovina","2024-07-04",0,0,0,0,0,0,0,0
"Bosnia and Herzegovina","2024-07-05",0,0,0,0,0,0,0,0
"Bosnia and Herzegovina","2024-07-06",0,0,0,0,0,0,0,0
"Bosnia and Herzegovina","2024-07-07",0,0,0,0,0,0,0,0
"Bosnia and Herzegovina","2024-07-08",0,0,0,0,0,0,0,0
"Bosnia and Herzegovina","2024-07-09",0,0,0,0,0,0,0,0
"Bosnia and Herzegovina","2024-07-10",0,0,0,0,0,0,0,0
"Bosnia and Herzegovina","2024-07-11",0,0,0,0,0,0,0,0
"Bosnia and Herzegovina","2024-07-12",0,0,0,0,0,0,0,0
"Bosnia and Herzegovina","2024-07-13",0,0,0,0,0,0,0,0
"Bosnia and Herzegovina","2024-07-14",0,0,0,0,0,0,0,0
"Bosnia and Herzegovina","2024-07-15",0,0,0,0,0,0,0,0
"Bosnia and Herzegovina","2024-07-16",0,0,0,0,0,0,0,0
"Bosnia and Herzegovina","2024-07-17",0,0,0,0,0,0,0,0
"Bosnia and Herzegovina","2024-07-18",0,0,0,0,0,0,0,0
"Bosnia and Herzegovina","2024-07-19",0,0,0,0,0,0,0,0
"Bosnia and Herzegovina","2024-07-20",0,0,0,0,0,0,0,0
"Bosnia and Herzegovina","2024-07-21",0,0,0,0,0,0,0,0
"Bosnia and Herzegovina","2024-07-22",0,0,0,0,0,0,0,0
"Bosnia and Herzegovina","2024-07-23",0,0,0,0,0,0,0,0
"Bosnia and Herzegovina","2024-07-24",0,0,0,0,0,0,0,0
"Bosnia and Herzegovina","2024-07-25",0,0,0,0,0,0,0,0
"Bosnia and Herzegovina","2024-07-26",0,0,0,0,0,0,0,0
"Bosnia and Herzegovina","2024-07-27",0,0,0,0,0,0,0,0
"Bosnia and Herzegovina","2024-07-28",0,0,0,0,0,0,0,0
"Bosnia and Herzegovina","2024-07-29",0,0,0,0,0,0,0,0
"Bosnia and Herzegovina","2024-07-30",0,0,0,0,0,0,0,0
"Bosnia and Herzegovina","2024-07-31",0,0,0,0,0,0,0,0
"Bosnia and Herzegovina","2024-08-01",0,0,0,0,0,0,0,0
"Bosnia and Herzegovina","2024-08-02",0,0,0,0,0,0,0,0
"Bosnia and Herzegovina","2024-08-03",0,0,0,0,0,0,0,0
"Bosnia and Herzegovina","2024-08-04",0,0,0,0,0,0,0,0
"Bosnia and Herzegovina","2024-08-05",0,0,0,0,0,0,0,0
"Bosnia and Herzegovina","2024-08-06",0,0,0,0,0,0,0,0
"Bosnia and Herzegovina","2024-08-07",0,0,0,0,0,0,0,0
"Bosnia and Herzegovina","2024-08-08",0,0,0,0,0,0,0,0
"Bosnia and Herzegovina","2024-08-09",0,0,0,0,0,0,0,0
"Bosnia and Herzegovina","2024-08-10",0,0,0,0,0,0,0,0
"Bosnia and Herzegovina","2024-08-11",0,0,0,0,0,0,0,0
"Bosnia and Herzegovina","2024-08-12",0,0,0,0,0,0,0,0
"Bosnia and Herzegovina","2024-08-13",0,0,0,0,0,0,0,0
"Bosnia and Herzegovina","2024-08-14",0,0,0,0,0,0,0,0
"Bosnia and Herzegovina","2024-08-15",0,0,0,0,0,0,0,0
"Bosnia and Herzegovina","2024-08-16",0,0,0,0,0,0,0,0
"Bosnia and Herzegovina","2024-08-17",0,0,0,0,0,0,0,0
"Bosnia and Herzegovina","2024-08-18",0,0,0,0,0,0,0,0
"Bosnia and Herzegovina","2024-08-19",0,0,0,0,0,0,0,0
"Bosnia and Herzegovina","2024-08-20",0,0,0,0,0,0,0,0
"Bosnia and Herzegovina","2024-08-21",0,0,0,0,0,0,0,0
"Bosnia and Herzegovina","2024-08-22",0,0,0,0,0,0,0,0
"Bosnia and Herzegovina","2024-08-23",0,0,0,0,0,0,0,0
"Bosnia and Herzegovina","2024-08-24",0,0,0,0,0,0,0,0
"Bosnia and Herzegovina","2024-08-25",0,0,0,0,0,0,0,0
"Bosnia and Herzegovina","2024-08-26",0,0,0,0,0,0,0,0
"Bosnia and Herzegovina","2024-08-27",0,0,0,0,0,0,0,0
"Bosnia and Herzegovina","2024-08-28",0,0,0,0,0,0,0,0
"Bosnia and Herzegovina","2024-08-29",0,0,0,0,0,0,0,0
"Bosnia and Herzegovina","2024-08-30",0,0,0,0,0,0,0,0
"Bosnia and Herzegovina","2024-08-31",0,0,0,0,0,0,0,0
"Bosnia and Herzegovina","2024-09-01",0,0,0,0,0,0,0,0
"Bosnia and Herzegovina","2024-09-02",0,0,0,0,0,0,0,0
"Bosnia and Herzegovina","2024-09-03",0,0,0,0,0,0,0,0
"Bosnia and Herzegovina","2024-09-04",0,0,0,0,0,0,0,0
"Bosnia and Herzegovina","2024-09-05",0,0,0,0,0,0,0,0
"Bosnia and Herzegovina","2024-09-06",0,0,0,0,0,0,0,0
"Bosnia and Herzegovina","2024-09-07",0,0,0,0,0,0,0,0
"Bosnia and Herzegovina","2024-09-08",0,0,0,0,0,0,0,0
"Bosnia and Herzegovina","2024-09-09",0,0,0,0,0,0,0,0
"Bosnia and Herzegovina","2024-09-10",0,0,0,0,0,0,0,0
"Bosnia and Herzegovina","2024-09-11",0,0,0,0,0,0,0,0
"Bosnia and Herzegovina","2024-09-12",0,0,0,0,0,0,0,0
"Bosnia and Herzegovina","2024-09-13",0,0,0,0,0,0,0,0
"Bosnia and Herzegovina","2024-09-14",0,0,0,0,0,0,0,0
"Bosnia and Herzegovina","2024-09-15",0,0,0,0,0,0,0,0
"Bosnia and Herzegovina","2024-09-16",0,0,0,0,0,0,0,0
"Bosnia and Herzegovina","2024-09-17",0,0,0,0,0,0,0,0
"Bosnia and Herzegovina","2024-09-18",0,0,0,0,0,0,0,0
"Bosnia and Herzegovina","2024-09-19",0,0,0,0,0,0,0,0
"Bosnia and Herzegovina","2024-09-20",0,0,0,0,0,0,0,0
"Bosnia and Herzegovina","2024-09-21",0,0,0,0,0,0,0,0
"Bosnia and Herzegovina","2024-09-22",0,0,0,0,0,0,0,0
"Bosnia and Herzegovina","2024-09-23",0,0,0,0,0,0,0,0
"Bosnia and Herzegovina","2024-09-24",0,0,0,0,0,0,0,0
"Bosnia and Herzegovina","2024-09-25",0,0,0,0,0,0,0,0
"Bosnia and Herzegovina","2024-09-26",0,0,0,0,0,0,0,0
"Bosnia and Herzegovina","2024-09-27",0,0,0,0,0,0,0,0
"Bosnia and Herzegovina","2024-09-28",0,0,0,0,0,0,0,0
"Bosnia and Herzegovina","2024-09-29",0,0,0,0,0,0,0,0
"Bosnia and Herzegovina","2024-09-30",0,0,0,0,0,0,0,0
"Bosnia and Herzegovina","2024-10-01",0,0,0,0,0,0,0,0
"Bosnia and Herzegovina","2024-10-02",0,0,0,0,0,0,0,0
"Bosnia and Herzegovina","2024-10-03",0,0,0,0,0,0,0,0
"Bosnia and Herzegovina","2024-10-04",0,0,0,0,0,0,0,0
"Bosnia and Herzegovina","2024-10-05",0,0,0,0,0,0,0,0
"Bosnia and Herzegovina","2024-10-06",0,0,0,0,0,0,0,0
"Bosnia and Herzegovina","2024-10-07",0,0,0,0,0,0,0,0
"Bosnia and Herzegovina","2024-10-08",0,0,0,0,0,0,0,0
"Bosnia and Herzegovina","2024-10-09",0,0,0,0,0,0,0,0
"Bosnia and Herzegovina","2024-10-10",0,0,0,0,0,0,0,0
"Bosnia and Herzegovina","2024-10-11",0,0,0,0,0,0,0,0
"Bosnia and Herzegovina","2024-10-12",0,0,0,0,0,0,0,0
"Bosnia and Herzegovina","2024-10-13",0,0,0,0,0,0,0,0
"Bosnia and Herzegovina","2024-10-14",0,0,0,0,0,0,0,0
"Bosnia and Herzegovina","2024-10-15",0,0,0,0,0,0,0,0
"Bosnia and Herzegovina","2024-10-16",0,0,0,0,0,0,0,0
"Bosnia and Herzegovina","2024-10-17",0,0,0,0,0,0,0,0
"Bosnia and Herzegovina","2024-10-18",0,0,0,0,0,0,0,0
"Bosnia and Herzegovina","2024-10-19",0,0,0,0,0,0,0,0
"Bosnia and Herzegovina","2024-10-20",0,0,0,0,0,0,0,0
"Bosnia and Herzegovina","2024-10-21",0,0,0,0,0,0,0,0
"Bosnia and Herzegovina","2024-10-22",0,0,0,0,0,0,0,0
"Bosnia and Herzegovina","2024-10-23",0,0,0,0,0,0,0,0
"Bosnia and Herzegovina","2024-10-24",0,0,0,0,0,0,0,0
"Bosnia and Herzegovina","2024-10-25",0,0,0,0,0,0,0,0
"Bosnia and Herzegovina","2024-10-26",0,0,0,0,0,0,0,0
"Bosnia and Herzegovina","2024-10-27",0,0,0,0,0,0,0,0
"Bosnia and Herzegovina","2024-10-28",0,0,0,0,0,0,0,0
"Bosnia and Herzegovina","2024-10-29",0,0,0,0,0,0,0,0
"Bosnia and Herzegovina","2024-10-30",0,0,0,0,0,0,0,0
"Bosnia and Herzegovina","2024-10-31",0,0,0,0,0,0,0,0
"Bosnia and Herzegovina","2024-11-01",0,0,0,0,0,0,0,0
"Bosnia and Herzegovina","2024-11-02",0,0,0,0,0,0,0,0
"Bosnia and Herzegovina","2024-11-03",0,0,0,0,0,0,0,0
"Bosnia and Herzegovina","2024-11-04",0,0,0,0,0,0,0,0
"Bosnia and Herzegovina","2024-11-05",0,0,0,0,0,0,0,0
"Bosnia and Herzegovina","2024-11-06",0,0,0,0,0,0,0,0
"Bosnia and Herzegovina","2024-11-07",0,0,0,0,0,0,0,0
"Bosnia and Herzegovina","2024-11-08",0,0,0,0,0,0,0,0
"Bosnia and Herzegovina","2024-11-09",0,0,0,0,0,0,0,0
"Bosnia and Herzegovina","2024-11-10",0,0,0,0,0,0,0,0
"Bosnia and Herzegovina","2024-11-11",0,0,0,0,0,0,0,0
"Bosnia and Herzegovina","2024-11-12",0,0,0,0,0,0,0,0
"Bosnia and Herzegovina","2024-11-13",0,0,0,0,0,0,0,0
"Bosnia and Herzegovina","2024-11-14",0,0,0,0,0,0,0,0
"Bosnia and Herzegovina","2024-11-15",0,0,0,0,0,0,0,0
"Bosnia and Herzegovina","2024-11-16",0,0,0,0,0,0,0,0
"Bosnia and Herzegovina","2024-11-17",0,0,0,0,0,0,0,0
"Bosnia and Herzegovina","2024-11-18",0,0,0,0,0,0,0,0
"Bosnia and Herzegovina","2024-11-19",0,0,0,0,0,0,0,0
"Bosnia and Herzegovina","2024-11-20",0,0,0,0,0,0,0,0
"Bosnia and Herzegovina","2024-11-21",0,0,0,0,0,0,0,0
"Bosnia and Herzegovina","2024-11-22",0,0,0,0,0,0,0,0
"Bosnia and Herzegovina","2024-11-23",0,0,0,0,0,0,0,0
"Bosnia and Herzegovina","2024-11-24",0,0,0,0,0,0,0,0
"Bosnia and Herzegovina","2024-11-25",0,0,0,0,0,0,0,0
"Bosnia and Herzegovina","2024-11-26",0,0,0,0,0,0,0,0
"Bosnia and Herzegovina","2024-11-27",0,0,0,0,0,0,0,0
"Bosnia and Herzegovina","2024-11-28",0,0,0,0,0,0,0,0
"Bosnia and Herzegovina","2024-11-29",0,0,0,0,0,0,0,0
"Bosnia and Herzegovina","2024-11-30",0,0,0,0,0,0,0,0
"Bosnia and Herzegovina","2024-12-01",0,0,0,0,0,0,0,0
"Bosnia and Herzegovina","2024-12-02",0,0,0,0,0,0,0,0
"Bosnia and Herzegovina","2024-12-03",0,0,0,0,0,0,0,0
"Bosnia and Herzegovina","2024-12-04",0,0,0,0,0,0,0,0
"Bosnia and Herzegovina","2024-12-05",0,0,0,0,0,0,0,0
"Bosnia and Herzegovina","2024-12-06",0,0,0,0,0,0,0,0
"Bosnia and Herzegovina","2024-12-07",0,0,0,0,0,0,0,0
"Bosnia and Herzegovina","2024-12-08",0,0,0,0,0,0,0,0
"Bosnia and Herzegovina","2024-12-09",0,0,0,0,0,0,0,0
"Bosnia and Herzegovina","2024-12-10",0,0,0,0,0,0,0,0
"Bosnia and Herzegovina","2024-12-11",0,0,0,0,0,0,0,0
"Bosnia and Herzegovina","2024-12-12",0,0,0,0,0,0,0,0
"Bosnia and Herzegovina","2024-12-13",0,0,0,0,0,0,0,0
"Bosnia and Herzegovina","2024-12-14",0,0,0,0,0,0,0,0
"Bosnia and Herzegovina","2024-12-15",0,0,0,0,0,0,0,0
"Bosnia and Herzegovina","2024-12-16",0,0,0,0,0,0,0,0
"Bosnia and Herzegovina","2024-12-17",0,0,0,0,0,0,0,0
"Bosnia and Herzegovina","2024-12-18",0,0,0,0,0,0,0,0
"Bosnia and Herzegovina","2024-12-19",0,0,0,0,0,0,0,0
"Bosnia and Herzegovina","2024-12-20",0,0,0,0,0,0,0,0
"Bosnia and Herzegovina","2024-12-21",0,0,0,0,0,0,0,0
"Bosnia and Herzegovina","2024-12-22",0,0,0,0,0,0,0,0
"Bosnia and Herzegovina","2024-12-23",0,0,0,0,0,0,0,0
"Bosnia and Herzegovina","2024-12-24",0,0,0,0,0,0,0,0
"Bosnia and Herzegovina","2024-12-25",0,0,0,0,0,0,0,0
"Bosnia and Herzegovina","2024-12-26",0,0,0,0,0,0,0,0
"Bosnia and Herzegovina","2024-12-27",0,0,0,0,0,0,0,0
"Bosnia and Herzegovina","2024-12-28",0,0,0,0,0,0,0,0
"Bosnia and Herzegovina","2024-12-29",0,0,0,0,0,0,0,0
"Bosnia and Herzegovina","2024-12-30",0,0,0,0,0,0,0,0
"Bosnia and Herzegovina","2024-12-31",0,0,0,0,0,0,0,0
"Bosnia and Herzegovina","2025-01-01",0,0,0,0,0,0,0,0
"Bosnia and Herzegovina","2025-01-02",0,0,0,0,0,0,0,0
"Bosnia and Herzegovina","2025-01-03",0,0,0,0,0,0,0,0
"Bosnia and Herzegovina","2025-01-04",0,0,0,0,0,0,0,0
"Bosnia and Herzegovina","2025-01-05",0,0,0,0,0,0,0,0
"Bosnia and Herzegovina","2025-01-06",0,0,0,0,0,0,0,0
"Bosnia and Herzegovina","2025-01-07",0,0,0,0,0,0,0,0
"Bosnia and Herzegovina","2025-01-08",0,0,0,0,0,0,0,0
"Bosnia and Herzegovina","2025-01-09",0,0,0,0,0,0,0,0
"Bosnia and Herzegovina","2025-01-10",0,0,0,0,0,0,0,0
"Bosnia and Herzegovina","2025-01-11",0,0,0,0,0,0,0,0
"Bosnia and Herzegovina","2025-01-12",0,0,0,0,0,0,0,0
"Bosnia and Herzegovina","2025-01-13",0,0,0,0,0,0,0,0
"Bosnia and Herzegovina","2025-01-14",0,0,0,0,0,0,0,0
"Bosnia and Herzegovina","2025-01-15",0,0,0,0,0,0,0,0
"Bosnia and Herzegovina","2025-01-16",0,0,0,0,0,0,0,0
"Bosnia and Herzegovina","2025-01-17",0,0,0,0,0,0,0,0
"Bosnia and Herzegovina","2025-01-18",0,0,0,0,0,0,0,0
"Bosnia and Herzegovina","2025-01-19",0,0,0,0,0,0,0,0
"Bosnia and Herzegovina","2025-01-20",0,0,0,0,0,0,0,0
"Bosnia and Herzegovina","2025-01-21",0,0,0,0,0,0,0,0
"Bosnia and Herzegovina","2025-01-22",0,0,0,0,0,0,0,0
"Bosnia and Herzegovina","2025-01-23",0,0,0,0,0,0,0,0
"Bosnia and Herzegovina","2025-01-24",0,0,0,0,0,0,0,0
"Bosnia and Herzegovina","2025-01-25",0,0,0,0,0,0,0,0
"Bosnia and Herzegovina","2025-01-26",0,0,0,0,0,0,0,0
"Bosnia and Herzegovina","2025-01-27",0,0,0,0,0,0,0,0
"Bosnia and Herzegovina","2025-01-28",0,0,0,0,0,0,0,0
"Bosnia and Herzegovina","2025-01-29",0,0,0,0,0,0,0,0
"Bosnia and Herzegovina","2025-01-30",0,0,0,0,0,0,0,0
"Bosnia and Herzegovina","2025-01-31",0,0,0,0,0,0,0,0
"Bosnia and Herzegovina","2025-02-01",0,0,0,0,0,0,0,0
"Bosnia and Herzegovina","2025-02-02",0,0,0,0,0,0,0,0
"Bosnia and Herzegovina","2025-02-03",0,0,0,0,0,0,0,0
"Bosnia and Herzegovina","2025-02-04",0,0,0,0,0,0,0,0
"Bosnia and Herzegovina","2025-02-05",0,0,0,0,0,0,0,0
"Bosnia and Herzegovina","2025-02-06",0,0,0,0,0,0,0,0
"Bosnia and Herzegovina","2025-02-07",0,0,0,0,0,0,0,0
"Bosnia and Herzegovina","2025-02-08",0,0,0,0,0,0,0,0
"Bosnia and Herzegovina","2025-02-09",0,0,0,0,0,0,0,0
"Bosnia and Herzegovina","2025-02-10",0,0,0,0,0,0,0,0
"Bosnia and Herzegovina","2025-02-11",0,0,0,0,0,0,0,0
"Bosnia and Herzegovina","2025-02-12",0,0,0,0,0,0,0,0
"Bosnia and Herzegovina","2025-02-13",0,0,0,0,0,0,0,0
"Bosnia and Herzegovina","2025-02-14",0,0,0,0,0,0,0,0
"Bosnia and Herzegovina","2025-02-15",0,0,0,0,0,0,0,0
"Bosnia and Herzegovina","2025-02-16",0,0,0,0,0,0,0,0
"Bosnia and Herzegovina","2025-02-17",0,0,0,0,0,0,0,0
"Bosnia and Herzegovina","2025-02-18",0,0,0,0,0,0,0,0
"Bosnia and Herzegovina","2025-02-19",0,0,0,0,0,0,0,0
"Bosnia and Herzegovina","2025-02-20",0,0,0,0,0,0,0,0
"Bosnia and Herzegovina","2025-02-21",0,0,0,0,0,0,0,0
"Bosnia and Herzegovina","2025-02-22",0,0,0,0,0,0,0,0
"Bosnia and Herzegovina","2025-02-23",0,0,0,0,0,0,0,0
"Bosnia and Herzegovina","2025-02-24",0,0,0,0,0,0,0,0
"Bosnia and Herzegovina","2025-02-25",0,0,0,0,0,0,0,0
"Bosnia and Herzegovina","2025-02-26",0,0,0,0,0,0,0,0
"Bosnia and Herzegovina","2025-02-27",0,0,0,0,0,0,0,0
"Bosnia and Herzegovina","2025-02-28",0,0,0,0,0,0,0,0
"Bosnia and Herzegovina","2025-03-01",0,0,0,0,0,0,0,0
"Bosnia and Herzegovina","2025-03-02",0,0,0,0,0,0,0,0
"Bosnia and Herzegovina","2025-03-03",0,0,0,0,0,0,0,0
"Brazil","2024-01-01",0,0,0,0,0,0,0,0
"Brazil","2024-01-02",0,56,56,0,56,56,0,0
"Brazil","2024-01-03",0,0,56,0,6,62,0,0
"Brazil","2024-01-04",0,0,56,0,6,68,0,0
"Brazil","2024-01-05",0,0,56,0,6,74,0,0
"Brazil","2024-01-06",0,0,56,0,6,80,0,0
"Brazil","2024-01-07",0,0,56,0,6,86,0,0
"Brazil","2024-01-08",0,0,56,0,6,92,0,0
"Brazil","2024-01-09",0,42,98,0,6,98,0,0
"Brazil","2024-01-10",0,0,98,0,6,104,0,0
"Brazil","2024-01-11",0,0,98,0,6,110,0,0
"Brazil","2024-01-12",0,0,98,0,6,116,0,0
"Brazil","2024-01-13",0,0,98,0,6,122,0,0
"Brazil","2024-01-14",0,0,98,0,6,128,0,0
"Brazil","2024-01-15",0,0,98,0,6,134,0,0
"Brazil","2024-01-16",0,42,140,0,6,140,0,0
"Brazil","2024-01-17",0,0,140,0,5,145,0,0
"Brazil","2024-01-18",0,0,140,0,4,149,0,0
"Brazil","2024-01-19",0,0,140,0,5,154,0,0
"Brazil","2024-01-20",0,0,140,0,5,159,0,0
"Brazil","2024-01-21",0,0,140,0,5,164,0,0
"Brazil","2024-01-22",0,0,140,0,4,168,0,0
"Brazil","2024-01-23",0,33,173,0,5,173,0,0
"Brazil","2024-01-24",0,0,173,0,5,178,0,0
"Brazil","2024-01-25",0,0,173,0,5,183,0,0
"Brazil","2024-01-26",0,0,173,0,5,188,0,0
"Brazil","2024-01-27",0,0,173,0,4,192,0,0
"Brazil","2024-01-28",0,0,173,0,5,197,0,0
"Brazil","2024-01-29",0,0,173,0,5,202,0,0
"Brazil","2024-01-30",0,34,207,0,5,207,0,0
"Brazil","2024-01-31",0,0,207,0,4,211,0,0
"Brazil","2024-02-01",0,0,207,0,5,216,0,0
"Brazil","2024-02-02",0,0,207,0,4,220,0,0
"Brazil","2024-02-03",0,0,207,0,5,225,0,0
"Brazil","2024-02-04",0,0,207,0,4,229,0,0
"Brazil","2024-02-05",0,0,207,0,5,234,0,0
"Brazil","2024-02-06",0,31,238,0,4,238,0,0
"Brazil","2024-02-07",0,0,238,0,5,243,0,0
"Brazil","2024-02-08",0,0,238,0,4,247,0,0
"Brazil","2024-02-09",0,0,238,0,5,252,0,0
"Brazil","2024-02-10",0,0,238,0,5,257,0,0
"Brazil","2024-02-11",0,0,238,0,5,262,0,0
"Brazil","2024-02-12",0,0,238,0,4,266,0,0
"Brazil","2024-02-13",0,33,271,0,5,271,0,0
"Brazil","2024-02-14",0,0,271,0,5,276,0,0
"Brazil","2024-02-15",0,0,271,0,6,282,0,0
"Brazil","2024-02-16",0,0,271,0,5,287,0,0
"Brazil","2024-02-17",0,0,271,0,5,292,0,0
"Brazil","2024-02-18",0,0,271,0,5,297,0,0
"Brazil","2024-02-19",0,0,271,0,6,303,0,0
"Brazil","2024-02-20",0,37,308,0,5,308,0,0
"Brazil","2024-02-21",0,0,308,0,4,312,0,0
"Brazil","2024-02-22",0,0,308,0,4,316,0,0
"Brazil","2024-02-23",0,0,308,0,4,320,0,0
"Brazil","2024-02-24",0,0,308,0,3,323,0,0
"Brazil","2024-02-25",0,0,308,0,4,327,0,0
"Brazil","2024-02-26",0,0,308,0,4,331,0,0
"Brazil","2024-02-27",0,27,335,0,4,335,0,0
"Brazil","2024-02-28",0,0,335,0,3,338,0,0
"Brazil","2024-02-29",0,0,335,0,3,341,0,0
"Brazil","2024-03-01",0,0,335,0,3,344,0,0
"Brazil","2024-03-02",0,0,335,0,3,347,0,0
"Brazil","2024-03-03",0,0,335,0,3,350,0,0
"Brazil","2024-03-04",0,0,335,0,3,353,0,0
"Brazil","2024-03-05",0,21,356,0,3,356,0,0
"Brazil","2024-03-06",0,0,356,0,3,359,0,0
"Brazil","2024-03-07",0,0,356,0,3,362,0,0
"Brazil","2024-03-08",0,0,356,0,3,365,0,0
"Brazil","2024-03-09",0,0,356,0,4,369,0,0
"Brazil","2024-03-10",0,0,356,0,3,372,0,0
"Brazil","2024-03-11",0,0,356,0,3,375,0,0
"Brazil","2024-03-12",0,22,378,0,3,378,0,0
"Brazil","2024-03-13",0,0,378,0,3,381,0,0
"Brazil","2024-03-14",0,0,378,0,4,385,0,0
"Brazil","2024-03-15",0,0,378,0,3,388,0,0
"Brazil","2024-03-16",0,0,378,0,3,391,0,0
"Brazil","2024-03-17",0,0,378,0,3,394,0,0
"Brazil","2024-03-18",0,0,378,0,4,398,0,0
"Brazil","2024-03-19",0,23,401,0,3,401,0,0
"Brazil","2024-03-20",0,0,401,0,3,404,0,0
"Brazil","2024-03-21",0,0,401,0,3,407,0,0
"Brazil","2024-03-22",0,0,401,0,3,410,0,0
"Brazil","2024-03-23",0,0,401,0,4,414,0,0
"Brazil","2024-03-24",0,0,401,0,3,417,0,0
"Brazil","2024-03-25",0,0,401,0,3,420,0,0
"Brazil","2024-03-26",0,22,423,0,3,423,0,0
"Brazil","2024-03-27",0,0,423,0,4,427,0,0
"Brazil","2024-03-28",0,0,423,0,3,430,0,0
"Brazil","2024-03-29",0,0,423,0,4,434,0,0
"Brazil","2024-03-30",0,0,423,0,3,437,0,0
"Brazil","2024-03-31",0,0,423,0,4,441,0,0
"Brazil","2024-04-01",0,0,423,0,3,444,0,0
"Brazil","2024-04-02",0,25,448,0,4,448,0,0
"Brazil","2024-04-03",0,0,448,0,3,451,0,0
"Brazil","2024-04-04",0,0,448,0,2,453,0,0
"Brazil","2024-04-05",0,0,448,0,3,456,0,0
"Brazil","2024-04-06",0,0,448,0,2,458,0,0
"Brazil","2024-04-07",0,0,448,0,3,461,0,0
"Brazil","2024-04-08",0,0,448,0,2,463,0,0
"Brazil","2024-04-09",0,18,466,0,3,466,0,0
"Brazil","2024-04-10",0,0,466,0,2,468,0,0
"Brazil","2024-04-11",0,0,466,0,1,469,0,0
"Brazil","2024-04-12",0,0,466,0,2,471,0,0
"Brazil","2024-04-13",0,0,466,0,1,472,0,0
"Brazil","2024-04-14",0,0,466,0,2,474,0,0
"Brazil","2024-04-15",0,0,466,0,1,475,0,0
"Brazil","2024-04-16",0,11,477,0,2,477,0,0
"Brazil","2024-04-17",0,0,477,0,3,480,0,0
"Brazil","2024-04-18",0,0,477,0,2,482,0,0
"Brazil","2024-04-19",0,0,477,0,3,485,0,0
"Brazil","2024-04-20",0,0,477,0,3,488,0,0
"Brazil","2024-04-21",0,0,477,0,3,491,0,0
"Brazil","2024-04-22",0,0,477,0,2,493,0,0
"Brazil","2024-04-23",0,19,496,0,3,496,0,0
"Brazil","2024-04-24",0,0,496,0,3,499,0,0
"Brazil","2024-04-25",0,0,496,0,3,502,0,0
"Brazil","2024-04-26",0,0,496,0,3,505,0,0
"Brazil","2024-04-27",0,0,496,0,2,507,0,0
"Brazil","2024-04-28",0,0,496,0,3,510,0,0
"Brazil","2024-04-29",0,0,496,0,3,513,0,0
"Brazil","2024-04-30",0,20,516,0,3,516,0,0
"Brazil","2024-05-01",0,0,516,0,2,518,0,0
"Brazil","2024-05-02",0,0,516,0,3,521,0,0
"Brazil","2024-05-03",0,0,516,0,2,523,0,0
"Brazil","2024-05-04",0,0,516,0,3,526,0,0
"Brazil","2024-05-05",0,0,516,0,2,528,0,0
"Brazil","2024-05-06",0,0,516,0,3,531,0,0
"Brazil","2024-05-07",0,17,533,0,2,533,0,0
"Brazil","2024-05-08",0,0,533,0,3,536,0,0
"Brazil","2024-05-09",0,0,533,0,2,538,0,0
"Brazil","2024-05-10",0,0,533,0,3,541,0,0
"Brazil","2024-05-11",0,0,533,0,2,543,0,0
"Brazil","2024-05-12",0,0,533,0,3,546,0,0
"Brazil","2024-05-13",0,0,533,0,2,548,0,0
"Brazil","2024-05-14",0,18,551,0,3,551,0,0
"Brazil","2024-05-15",0,0,551,0,1,552,0,0
"Brazil","2024-05-16",0,0,551,0,1,553,0,0
"Brazil","2024-05-17",0,0,551,0,1,554,0,0
"Brazil","2024-05-18",0,0,551,0,1,555,0,0
"Brazil","2024-05-19",0,0,551,0,1,556,0,0
"Brazil","2024-05-20",0,0,551,0,1,557,0,0
"Brazil","2024-05-21",0,7,558,0,1,558,0,0
"Brazil","2024-05-22",0,0,558,0,2,560,0,0
"Brazil","2024-05-23",0,0,558,0,2,562,0,0
"Brazil","2024-05-24",0,0,558,0,2,564,0,0
"Brazil","2024-05-25",0,0,558,0,3,567,0,0
"Brazil","2024-05-26",0,0,558,0,2,569,0,0
"Brazil","2024-05-27",0,0,558,0,2,571,0,0
"Brazil","2024-05-28",0,15,573,0,2,573,0,0
"Brazil","2024-05-29",0,0,573,0,2,575,0,0
"Brazil","2024-05-30",0,0,573,0,2,577,0,0
"Brazil","2024-05-31",0,0,573,0,2,579,0,0
"Brazil","2024-06-01",0,0,573,0,1,580,0,0
"Brazil","2024-06-02",0,0,573,0,2,582,0,0
"Brazil","2024-06-03",0,0,573,0,2,584,0,0
"Brazil","2024-06-04",0,13,586,0,2,586,0,0
"Brazil","2024-06-05",0,0,586,0,1,587,0,0
"Brazil","2024-06-06",0,0,586,0,1,588,0,0
"Brazil","2024-06-07",0,0,586,0,1,589,0,0
"Brazil","2024-06-08",0,0,586,0,2,591,0,0
"Brazil","2024-06-09",0,0,586,0,1,592,0,0
"Brazil","2024-06-10",0,0,586,0,1,593,0,0
"Brazil","2024-06-11",0,8,594,0,1,594,0,0
"Brazil","2024-06-12",0,0,594,0,1,595,0,0
"Brazil","2024-06-13",0,0,594,0,1,596,0,0
"Brazil","2024-06-14",0,0,594,0,1,597,0,0
"Brazil","2024-06-15",0,0,594,0,1,598,0,0
"Brazil","2024-06-16",0,0,594,0,1,599,0,0
"Brazil","2024-06-17",0,0,594,0,1,600,0,0
"Brazil","2024-06-18",0,7,601,0,1,601,0,0
"Brazil","2024-06-19",0,0,601,0,2,603,0,0
"Brazil","2024-06-20",0,0,601,0,2,605,0,0
"Brazil","2024-06-21",0,0,601,0,2,607,0,0
"Brazil","2024-06-22",0,0,601,0,3,610,0,0
"Brazil","2024-06-23",0,0,601,0,2,612,0,0
"Brazil","2024-06-24",0,0,601,0,2,614,0,0
"Brazil","2024-06-25",0,15,616,0,2,616,0,0
"Brazil","2024-06-26",0,0,616,0,2,618,0,0
"Brazil","2024-06-27",0,0,616,0,2,620,0,0
"Brazil","2024-06-28",0,0,616,0,2,622,0,0
"Brazil","2024-06-29",0,0,616,0,3,625,0,0
"Brazil","2024-06-30",0,0,616,0,2,627,0,0
"Brazil","2024-07-01",0,0,616,0,2,629,0,0
"Brazil","2024-07-02",0,15,631,0,2,631,0,0
"Brazil","2024-07-03",0,0,631,0,3,634,0,0
"Brazil","2024-07-04",0,0,631,0,3,637,0,0
"Brazil","2024-07-05",0,0,631,0,3,640,0,0
"Brazil","2024-07-06",0,0,631,0,4,644,0,0
"Brazil","2024-07-07",0,0,631,0,3,647,0,0
"Brazil","2024-07-08",0,0,631,0,3,650,0,0
"Brazil","2024-07-09",0,22,653,0,3,653,0,0
"Brazil","2024-07-10",0,0,653,0,4,657,0,0
"Brazil","2024-07-11",0,0,653,0,3,660,0,0
"Brazil","2024-07-12",0,0,653,0,4,664,0,0
"Brazil","2024-07-13",0,0,653,0,3,667,0,0
"Brazil","2024-07-14",0,0,653,0,4,671,0,0
"Brazil","2024-07-15",0,0,653,0,3,674,0,0
"Brazil","2024-07-16",0,25,678,0,4,678,0,0
"Brazil","2024-07-17",0,0,678,0,5,683,0,0
"Brazil","2024-07-18",0,0,678,0,4,687,0,0
"Brazil","2024-07-19",0,0,678,0,5,692,0,0
"Brazil","2024-07-20",0,0,678,0,4,696,0,0
"Brazil","2024-07-21",0,0,678,0,5,701,0,0
"Brazil","2024-07-22",0,0,678,0,4,705,0,0
"Brazil","2024-07-23",0,32,710,0,5,710,0,0
"Brazil","2024-07-24",0,0,710,0,5,715,0,0
"Brazil","2024-07-25",0,0,710,0,5,720,0,0
"Brazil","2024-07-26",0,0,710,0,5,725,0,0
"Brazil","2024-07-27",0,0,710,0,5,730,0,0
"Brazil","2024-07-28",0,0,710,0,5,735,0,0
"Brazil","2024-07-29",0,0,710,0,5,740,0,0
"Brazil","2024-07-30",0,35,745,0,5,745,0,0
"Brazil","2024-07-31",0,0,745,0,8,753,0,0
"Brazil","2024-08-01",0,0,745,0,9,762,0,0
"Brazil","2024-08-02",0,0,745,0,8,770,0,0
"Brazil","2024-08-03",0,0,745,0,8,778,0,0
"Brazil","2024-08-04",0,0,745,0,8,786,0,0
"Brazil","2024-08-05",0,0,745,0,9,795,0,0
"Brazil","2024-08-06",0,58,803,0,8,803,0,0
"Brazil","2024-08-07",0,0,803,0,9,812,0,0
"Brazil","2024-08-08",0,0,803,0,10,822,0,0
"Brazil","2024-08-09",0,0,803,0,9,831,0,0
"Brazil","2024-08-10",0,0,803,0,9,840,0,0
"Brazil","2024-08-11",0,0,803,0,9,849,0,0
"Brazil","2024-08-12",0,0,803,0,10,859,0,0
"Brazil","2024-08-13",0,65,868,0,9,868,0,0
"Brazil","2024-08-14",0,0,868,0,12,880,0,0
"Brazil","2024-08-15",0,0,868,0,13,893,0,0
"Brazil","2024-08-16",0,0,868,0,12,905,0,0
"Brazil","2024-08-17",0,0,868,0,12,917,0,0
"Brazil","2024-08-18",0,0,868,0,12,929,0,0
"Brazil","2024-08-19",0,0,868,0,13,942,0,0
"Brazil","2024-08-20",0,86,954,0,12,954,0,0
"Brazil","2024-08-21",0,0,954,0,12,966,0,0
"Brazil","2024-08-22",0,0,954,0,11,977,0,0
"Brazil","2024-08-23",0,0,954,0,12,989,0,0
"Brazil","2024-08-24",0,0,954,0,11,1000,0,0
"Brazil","2024-08-25",0,0,954,0,12,1012,0,0
"Brazil","2024-08-26",0,0,954,0,11,1023,0,0
"Brazil","2024-08-27",0,81,1035,0,12,1035,0,0
"Brazil","2024-08-28",0,0,1035,0,13,1048,0,0
"Brazil","2024-08-29",0,0,1035,0,12,1060,0,0
"Brazil","2024-08-30",0,0,1035,0,13,1073,0,0
"Brazil","2024-08-31",0,0,1035,0,13,1086,0,0
"Brazil","2024-09-01",0,0,1035,0,13,1099,0,0
"Brazil","2024-09-02",0,0,1035,0,12,1111,0,0
"Brazil","2024-09-03",0,89,1124,0,13,1124,0,0
"Brazil","2024-09-04",0,0,1124,0,9,1133,0,0
"Brazil","2024-09-05",0,0,1124,0,8,1141,0,0
"Brazil","2024-09-06",0,0,1124,0,9,1150,0,0
"Brazil","2024-09-07",0,0,1124,0,8,1158,0,0
"Brazil","2024-09-08",0,0,1124,0,9,1167,0,0
"Brazil","2024-09-09",0,0,1124,0,8,1175,0,0
"Brazil","2024-09-10",0,60,1184,0,9,1184,0,0
"Brazil","2024-09-11",0,0,1184,0,9,1193,0,0
"Brazil","2024-09-12",0,0,1184,0,8,1201,0,0
"Brazil","2024-09-13",0,0,1184,0,9,1210,0,0
"Brazil","2024-09-14",0,0,1184,0,8,1218,0,0
"Brazil","2024-09-15",0,0,1184,0,9,1227,0,0
"Brazil","2024-09-16",0,0,1184,0,8,1235,0,0
"Brazil","2024-09-17",0,60,1244,0,9,1244,0,0
"Brazil","2024-09-18",0,0,1244,0,9,1253,0,0
"Brazil","2024-09-19",0,0,1244,0,8,1261,0,0
"Brazil","2024-09-20",0,0,1244,0,9,1270,0,0
"Brazil","2024-09-21",0,0,1244,0,9,1279,0,0
"Brazil","2024-09-22",0,0,1244,0,9,1288,0,0
"Brazil","2024-09-23",0,0,1244,0,8,1296,0,0
"Brazil","2024-09-24",0,61,1305,0,9,1305,0,0
"Brazil","2024-09-25",0,0,1305,0,11,1316,0,0
"Brazil","2024-09-26",0,0,1305,0,12,1328,0,0
"Brazil","2024-09-27",0,0,1305,0,11,1339,0,0
"Brazil","2024-09-28",0,0,1305,0,11,1350,0,0
"Brazil","2024-09-29",0,0,1305,0,11,1361,0,0
"Brazil","2024-09-30",0,0,1305,0,12,1373,0,0
"Brazil","2024-10-01",0,79,1384,0,11,1384,0,0
"Brazil","2024-10-02",0,0,1384,0,10,1394,0,0
"Brazil","2024-10-03",0,0,1384,0,10,1404,0,0
"Brazil","2024-10-04",0,0,1384,0,10,1414,0,0
"Brazil","2024-10-05",0,0,1384,0,11,1425,0,0
"Brazil","2024-10-06",0,0,1384,0,10,1435,0,0
"Brazil","2024-10-07",0,0,1384,0,10,1445,0,0
"Brazil","2024-10-08",0,71,1455,0,10,1455,0,0
"Brazil","2024-10-09",0,0,1455,0,9,1464,0,0
"Brazil","2024-10-10",0,0,1455,0,8,1472,0,0
"Brazil","2024-10-11",0,0,1455,0,9,1481,0,0
"Brazil","2024-10-12",0,0,1455,0,9,1490,0,0
"Brazil","2024-10-13",0,0,1455,0,9,1499,0,0
"Brazil","2024-10-14",0,0,1455,0,8,1507,0,0
"Brazil","2024-10-15",0,61,1516,0,9,1516,0,0
"Brazil","2024-10-16",0,0,1516,0,11,1527,0,0
"Brazil","2024-10-17",0,0,1516,0,10,1537,0,0
"Brazil","2024-10-18",0,0,1516,0,11,1548,0,0
"Brazil","2024-10-19",0,0,1516,0,11,1559,0,0
"Brazil","2024-10-20",0,0,1516,0,11,1570,0,0
"Brazil","2024-10-21",0,0,1516,0,10,1580,0,0
"Brazil","2024-10-22",0,75,1591,0,11,1591,0,0
"Brazil","2024-10-23",0,0,1591,0,9,1600,0,0
"Brazil","2024-10-24",0,0,1591,0,9,1609,0,0
"Brazil","2024-10-25",0,0,1591,0,9,1618,0,0
"Brazil","2024-10-26",0,0,1591,0,9,1627,0,0
"Brazil","2024-10-27",0,0,1591,0,9,1636,0,0
"Brazil","2024-10-28",0,0,1591,0,9,1645,0,0
"Brazil","2024-10-29",0,63,1654,0,9,1654,0,0
"Brazil","2024-10-30",0,0,1654,0,10,1664,0,0
"Brazil","2024-10-31",0,0,1654,0,9,1673,0,0
"Brazil","2024-11-01",0,0,1654,0,10,1683,0,0
"Brazil","2024-11-02",0,0,1654,0,9,1692,0,0
"Brazil","2024-11-03",0,0,1654,0,10,1702,0,0
"Brazil","2024-11-04",0,0,1654,0,9,1711,0,0
"Brazil","2024-11-05",0,67,1721,0,10,1721,0,0
"Brazil","2024-11-06",0,0,1721,0,7,1728,0,0
"Brazil","2024-11-07",0,0,1721,0,7,1735,0,0
"Brazil","2024-11-08",0,0,1721,0,7,1742,0,0
"Brazil","2024-11-09",0,0,1721,0,6,1748,0,0
"Brazil","2024-11-10",0,0,1721,0,7,1755,0,0
"Brazil","2024-11-11",0,0,1721,0,7,1762,0,0
"Brazil","2024-11-12",0,48,1769,0,7,1769,0,0
"Brazil","2024-11-13",0,0,1769,0,7,1776,0,0
"Brazil","2024-11-14",0,0,1769,0,8,1784,0,0
"Brazil","2024-11-15",0,0,1769,0,7,1791,0,0
"Brazil","2024-11-16",0,0,1769,0,8,1799,0,0
"Brazil","2024-11-17",0,0,1769,0,7,1806,0,0
"Brazil","2024-11-18",0,0,1769,0,8,1814,0,0
"Brazil","2024-11-19",0,52,1821,0,7,1821,0,0
"Brazil","2024-11-20",0,0,1821,0,7,1828,0,0
"Brazil","2024-11-21",0,0,1821,0,8,1836,0,0
"Brazil","2024-11-22",0,0,1821,0,7,1843,0,0
"Brazil","2024-11-23",0,0,1821,0,7,1850,0,0
"Brazil","2024-11-24",0,0,1821,0,7,1857,0,0
"Brazil","2024-11-25",0,0,1821,0,8,1865,0,0
"Brazil","2024-11-26",0,51,1872,0,7,1872,0,0
"Brazil","2024-11-27",0,0,1872,0,6,1878,0,0
"Brazil","2024-11-28",0,0,1872,0,7,1885,0,0
"Brazil","2024-11-29",0,0,1872,0,6,1891,0,0
"Brazil","2024-11-30",0,0,1872,0,7,1898,0,0
"Brazil","2024-12-01",0,0,1872,0,6,1904,0,0
"Brazil","2024-12-02",0,0,1872,0,7,1911,0,0
"Brazil","2024-12-03",0,45,1917,0,6,1917,0,0
"Brazil","2024-12-04",0,0,1917,0,5,1922,0,0
"Brazil","2024-12-05",0,0,1917,0,4,1926,0,0
"Brazil","2024-12-06",0,0,1917,0,5,1931,0,0
"Brazil","2024-12-07",0,0,1917,0,5,1936,0,0
"Brazil","2024-12-08",0,0,1917,0,5,1941,0,0
"Brazil","2024-12-09",0,0,1917,0,4,1945,0,0
"Brazil","2024-12-10",0,33,1950,0,5,1950,0,0
"Brazil","2024-12-11",0,0,1950,0,3,1953,0,0
"Brazil","2024-12-12",0,0,1950,0,4,1957,0,0
"Brazil","2024-12-13",0,0,1950,0,3,1960,0,0
"Brazil","2024-12-14",0,0,1950,0,4,1964,0,0
"Brazil","2024-12-15",0,0,1950,0,3,1967,0,0
"Brazil","2024-12-16",0,0,1950,0,4,1971,0,0
"Brazil","2024-12-17",0,24,1974,0,3,1974,0,0
"Brazil","2024-12-18",0,0,1974,0,3,1977,0,0
"Brazil","2024-12-19",0,0,1974,0,4,1981,0,0
"Brazil","2024-12-20",0,0,1974,0,3,1984,0,0
"Brazil","2024-12-21",0,0,1974,0,4,1988,0,0
"Brazil","2024-12-22",0,0,1974,0,3,1991,0,0
"Brazil","2024-12-23",0,0,1974,0,4,1995,0,0
"Brazil","2024-12-24",0,24,1998,0,3,1998,0,0
"Brazil","2024-12-25",0,0,1998,0,3,2001,0,0
"Brazil","2024-12-26",0,0,1998,0,3,2004,0,0
"Brazil","2024-12-27",0,0,1998,0,3,2007,0,0
"Brazil","2024-12-28",0,0,1998,0,3,2010,0,0
"Brazil","2024-12-29",0,0,1998,0,3,2013,0,0
"Brazil","2024-12-30",0,0,1998,0,3,2016,0,0
"Brazil","2024-12-31",0,21,2019,0,3,2019,0,0
"Brazil","2025-01-01",0,0,2019,0,2,2021,0,0
"Brazil","2025-01-02",0,0,2019,0,3,2024,0,0
"Brazil","2025-01-03",0,0,2019,0,2,2026,0,0
"Brazil","2025-01-04",0,0,2019,0,3,2029,0,0
"Brazil","2025-01-05",0,0,2019,0,2,2031,0,0
"Brazil","2025-01-06",0,0,2019,0,3,2034,0,0
"Brazil","2025-01-07",0,17,2036,0,2,2036,0,0
"Brazil","2025-01-08",0,0,2036,0,3,2039,0,0
"Brazil","2025-01-09",0,0,2036,0,2,2041,0,0
"Brazil","2025-01-10",0,0,2036,0,3,2044,0,0
"Brazil","2025-01-11",0,0,2036,0,3,2047,0,0
"Brazil","2025-01-12",0,0,2036,0,3,2050,0,0
"Brazil","2025-01-13",0,0,2036,0,2,2052,0,0
"Brazil","2025-01-14",0,19,2055,0,3,2055,0,0
"Brazil","2025-01-15",0,0,2055,0,4,2059,0,0
"Brazil","2025-01-16",0,0,2055,0,3,2062,0,0
"Brazil","2025-01-17",0,0,2055,0,4,2066,0,0
"Brazil","2025-01-18",0,0,2055,0,3,2069,0,0
"Brazil","2025-01-19",0,0,2055,0,4,2073,0,0
"Brazil","2025-01-20",0,0,2055,0,3,2076,0,0
"Brazil","2025-01-21",0,25,2080,0,4,2080,0,0
"Brazil","2025-01-22",0,0,2080,0,0,2080,0,0
"Brazil","2025-01-23",0,0,2080,0,1,2081,0,0
"Brazil","2025-01-24",0,0,2080,0,0,2081,0,0
"Brazil","2025-01-25",0,0,2080,0,0,2081,0,0
"Brazil","2025-01-26",0,0,2080,0,0,2081,0,0
"Brazil","2025-01-27",0,0,2080,0,1,2082,0,0
"Brazil","2025-01-28",0,2,2082,0,0,2082,0,0
"Brazil","2025-01-29",0,0,2082,0,0,2082,0,0
"Brazil","2025-01-30",0,0,2082,0,0,2082,0,0
"Brazil","2025-01-31",0,0,2082,0,0,2082,0,0
"Brazil","2025-02-01",0,0,2082,0,0,2082,0,0
"Brazil","2025-02-02",0,0,2082,0,0,2082,0,0
"Brazil","2025-02-03",0,0,2082,0,0,2082,0,0
"Brazil","2025-02-04",0,0,2082,0,0,2082,0,0
"Brazil","2025-02-05",0,0,2082,0,0,2082,0,0
"Brazil","2025-02-06",0,0,2082,0,0,2082,0,0
"Brazil","2025-02-07",0,0,2082,0,0,2082,0,0
"Brazil","2025-02-08",0,0,2082,0,0,2082,0,0
"Brazil","2025-02-09",0,0,2082,0,0,2082,0,0
"Brazil","2025-02-10",0,0,2082,0,0,2082,0,0
"Brazil","2025-02-11",0,0,2082,0,0,2082,0,0
"Brazil","2025-02-12",0,0,2082,0,0,2082,0,0
"Brazil","2025-02-13",0,0,2082,0,0,2082,0,0
"Brazil","2025-02-14",0,0,2082,0,0,2082,0,0
"Brazil","2025-02-15",0,0,2082,0,0,2082,0,0
"Brazil","2025-02-16",0,0,2082,0,0,2082,0,0
"Brazil","2025-02-17",0,0,2082,0,0,2082,0,0
"Brazil","2025-02-18",0,0,2082,0,0,2082,0,0
"Brazil","2025-02-19",0,0,2082,0,0,2082,0,0
"Brazil","2025-02-20",0,0,2082,0,0,2082,0,0
"Brazil","2025-02-21",0,0,2082,0,0,2082,0,0
"Brazil","2025-02-22",0,0,2082,0,0,2082,0,0
"Brazil","2025-02-23",0,0,2082,0,0,2082,0,0
"Brazil","2025-02-24",0,0,2082,0,0,2082,0,0
"Brazil","2025-02-25",0,0,2082,0,0,2082,0,0
"Brazil","2025-02-26",0,0,2082,0,0,2082,0,0
"Brazil","2025-02-27",0,0,2082,0,0,2082,0,0
"Brazil","2025-02-28",0,0,2082,0,0,2082,0,0
"Brazil","2025-03-01",0,0,2082,0,0,2082,0,0
"Brazil","2025-03-02",0,0,2082,0,0,2082,0,0
"Brazil","2025-03-03",0,0,2082,0,0,2082,0,0
"Bulgaria","2024-01-01",0,0,0,0,0,0,0,0
"Bulgaria","2024-01-02",0,0,0,0,0,0,0,0
"Bulgaria","2024-01-03",0,0,0,0,0,0,0,0
"Bulgaria","2024-01-04",0,0,0,0,0,0,0,0
"Bulgaria","2024-01-05",0,0,0,0,0,0,0,0
"Bulgaria","2024-01-06",0,0,0,0,0,0,0,0
"Bulgaria","2024-01-07",0,0,0,0,0,0,0,0
"Bulgaria","2024-01-08",0,0,0,0,0,0,0,0
"Bulgaria","2024-01-09",0,0,0,0,0,0,0,0
"Bulgaria","2024-01-10",0,0,0,0,0,0,0,0
"Bulgaria","2024-01-11",0,0,0,0,0,0,0,0
"Bulgaria","2024-01-12",0,0,0,0,0,0,0,0
"Bulgaria","2024-01-13",0,0,0,0,0,0,0,0
"Bulgaria","2024-01-14",0,0,0,0,0,0,0,0
"Bulgaria","2024-01-15",0,0,0,0,0,0,0,0
"Bulgaria","2024-01-16",0,0,0,0,0,0,0,0
"Bulgaria","2024-01-17",0,0,0,0,0,0,0,0
"Bulgaria","2024-01-18",0,0,0,0,0,0,0,0
"Bulgaria","2024-01-19",0,0,0,0,0,0,0,0
"Bulgaria","2024-01-20",0,0,0,0,0,0,0,0
"Bulgaria","2024-01-21",0,0,0,0,0,0,0,0
"Bulgaria","2024-01-22",0,0,0,0,0,0,0,0
"Bulgaria","2024-01-23",0,0,0,0,0,0,0,0
"Bulgaria","2024-01-24",0,0,0,0,0,0,0,0
"Bulgaria","2024-01-25",0,0,0,0,0,0,0,0
"Bulgaria","2024-01-26",0,0,0,0,0,0,0,0
"Bulgaria","2024-01-27",0,0,0,0,0,0,0,0
"Bulgaria","2024-01-28",0,0,0,0,0,0,0,0
"Bulgaria","2024-01-29",0,0,0,0,0,0,0,0
"Bulgaria","2024-01-30",0,0,0,0,0,0,0,0
"Bulgaria","2024-01-31",0,0,0,0,0,0,0,0
"Bulgaria","2024-02-01",0,0,0,0,0,0,0,0
"Bulgaria","2024-02-02",0,0,0,0,0,0,0,0
"Bulgaria","2024-02-03",0,0,0,0,0,0,0,0
"Bulgaria","2024-02-04",0,0,0,0,0,0,0,0
"Bulgaria","2024-02-05",0,0,0,0,0,0,0,0
"Bulgaria","2024-02-06",0,0,0,0,0,0,0,0
"Bulgaria","2024-02-07",0,0,0,0,0,0,0,0
"Bulgaria","2024-02-08",0,0,0,0,0,0,0,0
"Bulgaria","2024-02-09",0,0,0,0,0,0,0,0
"Bulgaria","2024-02-10",0,0,0,0,0,0,0,0
"Bulgaria","2024-02-11",0,0,0,0,0,0,0,0
"Bulgaria","2024-02-12",0,0,0,0,0,0,0,0
"Bulgaria","2024-02-13",0,0,0,0,0,0,0,0
"Bulgaria","2024-02-14",0,0,0,0,0,0,0,0
"Bulgaria","2024-02-15",0,0,0,0,0,0,0,0
"Bulgaria","2024-02-16",0,0,0,0,0,0,0,0
"Bulgaria","2024-02-17",0,0,0,0,0,0,0,0
"Bulgaria","2024-02-18",0,0,0,0,0,0,0,0
"Bulgaria","2024-02-19",0,0,0,0,0,0,0,0
"Bulgaria","2024-02-20",0,0,0,0,0,0,0,0
"Bulgaria","2024-02-21",0,0,0,0,0,0,0,0
"Bulgaria","2024-02-22",0,0,0,0,0,0,0,0
"Bulgaria","2024-02-23",0,0,0,0,0,0,0,0
"Bulgaria","2024-02-24",0,0,0,0,0,0,0,0
"Bulgaria","2024-02-25",0,0,0,0,0,0,0,0
"Bulgaria","2024-02-26",0,0,0,0,0,0,0,0
"Bulgaria","2024-02-27",0,0,0,0,0,0,0,0
"Bulgaria","2024-02-28",0,0,0,0,0,0,0,0
"Bulgaria","2024-02-29",0,0,0,0,0,0,0,0
"Bulgaria","2024-03-01",0,0,0,0,0,0,0,0
"Bulgaria","2024-03-02",0,0,0,0,0,0,0,0
"Bulgaria","2024-03-03",0,0,0,0,0,0,0,0
"Bulgaria","2024-03-04",0,0,0,0,0,0,0,0
"Bulgaria","2024-03-05",0,0,0,0,0,0,0,0
"Bulgaria","2024-03-06",0,0,0,0,0,0,0,0
"Bulgaria","2024-03-07",0,0,0,0,0,0,0,0
"Bulgaria","2024-03-08",0,0,0,0,0,0,0,0
"Bulgaria","2024-03-09",0,0,0,0,0,0,0,0
"Bulgaria","2024-03-10",0,0,0,0,0,0,0,0
"Bulgaria","2024-03-11",0,0,0,0,0,0,0,0
"Bulgaria","2024-03-12",0,0,0,0,0,0,0,0
"Bulgaria","2024-03-13",0,0,0,0,0,0,0,0
"Bulgaria","2024-03-14",0,0,0,0,0,0,0,0
"Bulgaria","2024-03-15",0,0,0,0,0,0,0,0
"Bulgaria","2024-03-16",0,0,0,0,0,0,0,0
"Bulgaria","2024-03-17",0,0,0,0,0,0,0,0
"Bulgaria","2024-03-18",0,0,0,0,0,0,0,0
"Bulgaria","2024-03-19",0,0,0,0,0,0,0,0
"Bulgaria","2024-03-20",0,0,0,0,0,0,0,0
"Bulgaria","2024-03-21",0,0,0,0,0,0,0,0
"Bulgaria","2024-03-22",0,0,0,0,0,0,0,0
"Bulgaria","2024-03-23",0,0,0,0,0,0,0,0
"Bulgaria","2024-03-24",0,0,0,0,0,0,0,0
"Bulgaria","2024-03-25",0,0,0,0,0,0,0,0
"Bulgaria","2024-03-26",0,0,0,0,0,0,0,0
"Bulgaria","2024-03-27",0,0,0,0,0,0,0,0
"Bulgaria","2024-03-28",0,0,0,0,0,0,0,0
"Bulgaria","2024-03-29",0,0,0,0,0,0,0,0
"Bulgaria","2024-03-30",0,0,0,0,0,0,0,0
"Bulgaria","2024-03-31",0,0,0,0,0,0,0,0
"Bulgaria","2024-04-01",0,0,0,0,0,0,0,0
"Bulgaria","2024-04-02",0,0,0,0,0,0,0,0
"Bulgaria","2024-04-03",0,0,0,0,0,0,0,0
"Bulgaria","2024-04-04",0,0,0,0,0,0,0,0
"Bulgaria","2024-04-05",0,0,0,0,0,0,0,0
"Bulgaria","2024-04-06",0,0,0,0,0,0,0,0
"Bulgaria","2024-04-07",0,0,0,0,0,0,0,0
"Bulgaria","2024-04-08",0,0,0,0,0,0,0,0
"Bulgaria","2024-04-09",0,0,0,0,0,0,0,0
"Bulgaria","2024-04-10",0,0,0,0,0,0,0,0
"Bulgaria","2024-04-11",0,0,0,0,0,0,0,0
"Bulgaria","2024-04-12",0,0,0,0,0,0,0,0
"Bulgaria","2024-04-13",0,0,0,0,0,0,0,0
"Bulgaria","2024-04-14",0,0,0,0,0,0,0,0
"Bulgaria","2024-04-15",0,0,0,0,0,0,0,0
"Bulgaria","2024-04-16",0,0,0,0,0,0,0,0
"Bulgaria","2024-04-17",0,0,0,0,0,0,0,0
"Bulgaria","2024-04-18",0,0,0,0,0,0,0,0
"Bulgaria","2024-04-19",0,0,0,0,0,0,0,0
"Bulgaria","2024-04-20",0,0,0,0,0,0,0,0
"Bulgaria","2024-04-21",0,0,0,0,0,0,0,0
"Bulgaria","2024-04-22",0,0,0,0,0,0,0,0
"Bulgaria","2024-04-23",0,0,0,0,0,0,0,0
"Bulgaria","2024-04-24",0,0,0,0,0,0,0,0
"Bulgaria","2024-04-25",0,0,0,0,0,0,0,0
"Bulgaria","2024-04-26",0,0,0,0,0,0,0,0
"Bulgaria","2024-04-27",0,0,0,0,0,0,0,0
"Bulgaria","2024-04-28",0,0,0,0,0,0,0,0
"Bulgaria","2024-04-29",0,0,0,0,0,0,0,0
"Bulgaria","2024-04-30",0,0,0,0,0,0,0,0
"Bulgaria","2024-05-01",0,0,0,0,0,0,0,0
"Bulgaria","2024-05-02",0,0,0,0,0,0,0,0
"Bulgaria","2024-05-03",0,0,0,0,0,0,0,0
"Bulgaria","2024-05-04",0,0,0,0,0,0,0,0
"Bulgaria","2024-05-05",0,0,0,0,0,0,0,0
"Bulgaria","2024-05-06",0,0,0,0,0,0,0,0
"Bulgaria","2024-05-07",0,0,0,0,0,0,0,0
"Bulgaria","2024-05-08",0,0,0,0,0,0,0,0
"Bulgaria","2024-05-09",0,0,0,0,0,0,0,0
"Bulgaria","2024-05-10",0,0,0,0,0,0,0,0
"Bulgaria","2024-05-11",0,0,0,0,0,0,0,0
"Bulgaria","2024-05-12",0,0,0,0,0,0,0,0
"Bulgaria","2024-05-13",0,0,0,0,0,0,0,0
"Bulgaria","2024-05-14",0,0,0,0,0,0,0,0
"Bulgaria","2024-05-15",0,0,0,0,0,0,0,0
"Bulgaria","2024-05-16",0,0,0,0,0,0,0,0
"Bulgaria","2024-05-17",0,0,0,0,0,0,0,0
"Bulgaria","2024-05-18",0,0,0,0,0,0,0,0
"Bulgaria","2024-05-19",0,0,0,0,0,0,0,0
"Bulgaria","2024-05-20",0,0,0,0,0,0,0,0
"Bulgaria","2024-05-21",0,0,0,0,0,0,0,0
"Bulgaria","2024-05-22",0,0,0,0,0,0,0,0
"Bulgaria","2024-05-23",0,0,0,0,0,0,0,0
"Bulgaria","2024-05-24",0,0,0,0,0,0,0,0
"Bulgaria","2024-05-25",0,0,0,0,0,0,0,0
"Bulgaria","2024-05-26",0,0,0,0,0,0,0,0
"Bulgaria","2024-05-27",0,0,0,0,0,0,0,0
"Bulgaria","2024-05-28",0,0,0,0,0,0,0,0
"Bulgaria","2024-05-29",0,0,0,0,0,0,0,0
"Bulgaria","2024-05-30",0,0,0,0,0,0,0,0
"Bulgaria","2024-05-31",0,1,1,0,1,1,0,0
"Bulgaria","2024-06-01",0,0,1,0,0,1,0,0
"Bulgaria","2024-06-02",0,0,1,0,0,1,0,0
"Bulgaria","2024-06-03",0,0,1,0,0,1,0,0
"Bulgaria","2024-06-04",0,0,1,0,0,1,0,0
"Bulgaria","2024-06-05",0,0,1,0,0,1,0,0
"Bulgaria","2024-06-06",0,0,1,0,0,1,0,0
"Bulgaria","2024-06-07",0,0,1,0,0,1,0,0
"Bulgaria","2024-06-08",0,0,1,0,0,1,0,0
"Bulgaria","2024-06-09",0,0,1,0,0,1,0,0
"Bulgaria","2024-06-10",0,0,1,0,0,1,0,0
"Bulgaria","2024-06-11",0,0,1,0,0,1,0,0
"Bulgaria","2024-06-12",0,0,1,0,0,1,0,0
"Bulgaria","2024-06-13",0,0,1,0,0,1,0,0
"Bulgaria","2024-06-14",0,0,1,0,0,1,0,0
"Bulgaria","2024-06-15",0,0,1,0,0,1,0,0
"Bulgaria","2024-06-16",0,0,1,0,0,1,0,0
"Bulgaria","2024-06-17",0,0,1,0,0,1,0,0
"Bulgaria","2024-06-18",0,0,1,0,0,1,0,0
"Bulgaria","2024-06-19",0,0,1,0,0,1,0,0
"Bulgaria","2024-06-20",0,0,1,0,0,1,0,0
"Bulgaria","2024-06-21",0,0,1,0,0,1,0,0
"Bulgaria","2024-06-22",0,0,1,0,0,1,0,0
"Bulgaria","2024-06-23",0,0,1,0,0,1,0,0
"Bulgaria","2024-06-24",0,0,1,0,0,1,0,0
"Bulgaria","2024-06-25",0,0,1,0,0,1,0,0
"Bulgaria","2024-06-26",0,0,1,0,0,1,0,0
"Bulgaria","2024-06-27",0,0,1,0,0,1,0,0
"Bulgaria","2024-06-28",0,0,1,0,0,1,0,0
"Bulgaria","2024-06-29",0,0,1,0,0,1,0,0
"Bulgaria","2024-06-30",0,0,1,0,0,1,0,0
"Bulgaria","2024-07-01",0,0,1,0,0,1,0,0
"Bulgaria","2024-07-02",0,0,1,0,0,1,0,0
"Bulgaria","2024-07-03",0,0,1,0,0,1,0,0
"Bulgaria","2024-07-04",0,0,1,0,0,1,0,0
"Bulgaria","2024-07-05",0,0,1,0,0,1,0,0
"Bulgaria","2024-07-06",0,0,1,0,0,1,0,0
"Bulgaria","2024-07-07",0,0,1,0,0,1,0,0
"Bulgaria","2024-07-08",0,0,1,0,0,1,0,0
"Bulgaria","2024-07-09",0,0,1,0,0,1,0,0
"Bulgaria","2024-07-10",0,0,1,0,0,1,0,0
"Bulgaria","2024-07-11",0,0,1,0,0,1,0,0
"Bulgaria","2024-07-12",0,0,1,0,0,1,0,0
"Bulgaria","2024-07-13",0,0,1,0,0,1,0,0
"Bulgaria","2024-07-14",0,0,1,0,0,1,0,0
"Bulgaria","2024-07-15",0,0,1,0,0,1,0,0
"Bulgaria","2024-07-16",0,0,1,0,0,1,0,0
"Bulgaria","2024-07-17",0,0,1,0,0,1,0,0
"Bulgaria","2024-07-18",0,0,1,0,0,1,0,0
"Bulgaria","2024-07-19",0,0,1,0,0,1,0,0
"Bulgaria","2024-07-20",0,0,1,0,0,1,0,0
"Bulgaria","2024-07-21",0,0,1,0,0,1,0,0
"Bulgaria","2024-07-22",0,0,1,0,0,1,0,0
"Bulgaria","2024-07-23",0,0,1,0,0,1,0,0
"Bulgaria","2024-07-24",0,0,1,0,0,1,0,0
"Bulgaria","2024-07-25",0,0,1,0,0,1,0,0
"Bulgaria","2024-07-26",0,0,1,0,0,1,0,0
"Bulgaria","2024-07-27",0,0,1,0,0,1,0,0
"Bulgaria","2024-07-28",0,0,1,0,0,1,0,0
"Bulgaria","2024-07-29",0,0,1,0,0,1,0,0
"Bulgaria","2024-07-30",0,0,1,0,0,1,0,0
"Bulgaria","2024-07-31",0,0,1,0,0,1,0,0
"Bulgaria","2024-08-01",0,0,1,0,0,1,0,0
"Bulgaria","2024-08-02",0,0,1,0,0,1,0,0
"Bulgaria","2024-08-03",0,0,1,0,0,1,0,0
"Bulgaria","2024-08-04",0,0,1,0,0,1,0,0
"Bulgaria","2024-08-05",0,0,1,0,0,1,0,0
"Bulgaria","2024-08-06",0,0,1,0,0,1,0,0
"Bulgaria","2024-08-07",0,0,1,0,0,1,0,0
"Bulgaria","2024-08-08",0,0,1,0,0,1,0,0
"Bulgaria","2024-08-09",0,0,1,0,0,1,0,0
"Bulgaria","2024-08-10",0,0,1,0,0,1,0,0
"Bulgaria","2024-08-11",0,0,1,0,0,1,0,0
"Bulgaria","2024-08-12",0,0,1,0,0,1,0,0
"Bulgaria","2024-08-13",0,0,1,0,0,1,0,0
"Bulgaria","2024-08-14",0,0,1,0,0,1,0,0
"Bulgaria","2024-08-15",0,0,1,0,0,1,0,0
"Bulgaria","2024-08-16",0,0,1,0,0,1,0,0
"Bulgaria","2024-08-17",0,0,1,0,0,1,0,0
"Bulgaria","2024-08-18",0,0,1,0,0,1,0,0
"Bulgaria","2024-08-19",0,0,1,0,0,1,0,0
"Bulgaria","2024-08-20",0,0,1,0,0,1,0,0
"Bulgaria","2024-08-21",0,0,1,0,0,1,0,0
"Bulgaria","2024-08-22",0,0,1,0,0,1,0,0
"Bulgaria","2024-08-23",0,0,1,0,0,1,0,0
"Bulgaria","2024-08-24",0,0,1,0,0,1,0,0
"Bulgaria","2024-08-25",0,0,1,0,0,1,0,0
"Bulgaria","2024-08-26",0,0,1,0,0,1,0,0
"Bulgaria","2024-08-27",0,0,1,0,0,1,0,0
"Bulgaria","2024-08-28",0,0,1,0,0,1,0,0
"Bulgaria","2024-08-29",0,0,1,0,0,1,0,0
"Bulgaria","2024-08-30",0,0,1,0,0,1,0,0
"Bulgaria","2024-08-31",0,0,1,0,1,2,0,0
"Bulgaria","2024-09-01",0,0,1,0,0,2,0,0
"Bulgaria","2024-09-02",0,0,1,0,0,2,0,0
"Bulgaria","2024-09-03",0,0,1,0,0,2,0,0
"Bulgaria","2024-09-04",0,0,1,0,0,2,0,0
"Bulgaria","2024-09-05",0,0,1,0,0,2,0,0
"Bulgaria","2024-09-06",0,0,1,0,0,2,0,0
"Bulgaria","2024-09-07",0,0,1,0,0,2,0,0
"Bulgaria","2024-09-08",0,0,1,0,0,2,0,0
"Bulgaria","2024-09-09",0,0,1,0,0,2,0,0
"Bulgaria","2024-09-10",0,0,1,0,0,2,0,0
"Bulgaria","2024-09-11",0,0,1,0,0,2,0,0
"Bulgaria","2024-09-12",0,0,1,0,0,2,0,0
"Bulgaria","2024-09-13",0,0,1,0,0,2,0,0
"Bulgaria","2024-09-14",0,0,1,0,0,2,0,0
"Bulgaria","2024-09-15",0,0,1,0,0,2,0,0
"Bulgaria","2024-09-16",0,0,1,0,0,2,0,0
"Bulgaria","2024-09-17",0,0,1,0,0,2,0,0
"Bulgaria","2024-09-18",0,0,1,0,0,2,0,0
"Bulgaria","2024-09-19",0,0,1,0,0,2,0,0
"Bulgaria","2024-09-20",0,0,1,0,0,2,0,0
"Bulgaria","2024-09-21",0,0,1,0,0,2,0,0
"Bulgaria","2024-09-22",0,0,1,0,0,2,0,0
"Bulgaria","2024-09-23",0,0,1,0,0,2,0,0
"Bulgaria","2024-09-24",0,0,1,0,0,2,0,0
"Bulgaria","2024-09-25",0,0,1,0,0,2,0,0
"Bulgaria","2024-09-26",0,0,1,0,0,2,0,0
"Bulgaria","2024-09-27",0,0,1,0,0,2,0,0
"Bulgaria","2024-09-28",0,0,1,0,0,2,0,0
"Bulgaria","2024-09-29",0,0,1,0,0,2,0,0
"Bulgaria","2024-09-30",0,0,1,0,0,2,0,0
"Bulgaria","2024-10-01",0,0,1,0,0,2,0,0
"Bulgaria","2024-10-02",0,0,1,0,0,2,0,0
"Bulgaria","2024-10-03",0,0,1,0,0,2,0,0
"Bulgaria","2024-10-04",0,0,1,0,0,2,0,0
"Bulgaria","2024-10-05",0,0,1,0,0,2,0,0
"Bulgaria","2024-10-06",0,0,1,0,0,2,0,0
"Bulgaria","2024-10-07",0,0,1,0,0,2,0,0
"Bulgaria","2024-10-08",0,0,1,0,0,2,0,0
"Bulgaria","2024-10-09",0,0,1,0,0,2,0,0
"Bulgaria","2024-10-10",0,0,1,0,0,2,0,0
"Bulgaria","2024-10-11",0,0,1,0,0,2,0,0
"Bulgaria","2024-10-12",0,0,1,0,0,2,0,0
"Bulgaria","2024-10-13",0,0,1,0,0,2,0,0
"Bulgaria","2024-10-14",0,0,1,0,0,2,0,0
"Bulgaria","2024-10-15",0,0,1,0,0,2,0,0
"Bulgaria","2024-10-16",0,0,1,0,0,2,0,0
"Bulgaria","2024-10-17",0,0,1,0,0,2,0,0
"Bulgaria","2024-10-18",0,0,1,0,0,2,0,0
"Bulgaria","2024-10-19",0,0,1,0,0,2,0,0
"Bulgaria","2024-10-20",0,0,1,0,0,2,0,0
"Bulgaria","2024-10-21",0,0,1,0,0,2,0,0
"Bulgaria","2024-10-22",0,0,1,0,0,2,0,0
"Bulgaria","2024-10-23",0,0,1,0,0,2,0,0
"Bulgaria","2024-10-24",0,0,1,0,0,2,0,0
"Bulgaria","2024-10-25",0,0,1,0,0,2,0,0
"Bulgaria","2024-10-26",0,0,1,0,0,2,0,0
"Bulgaria","2024-10-27",0,0,1,0,0,2,0,0
"Bulgaria","2024-10-28",0,0,1,0,0,2,0,0
"Bulgaria","2024-10-29",0,0,1,0,0,2,0,0
"Bulgaria","2024-10-30",0,0,1,0,0,2,0,0
"Bulgaria","2024-10-31",0,0,1,0,0,2,0,0
"Bulgaria","2024-11-01",0,0,1,0,0,2,0,0
"Bulgaria","2024-11-02",0,0,1,0,0,2,0,0
"Bulgaria","2024-11-03",0,0,1,0,0,2,0,0
"Bulgaria","2024-11-04",0,0,1,0,0,2,0,0
"Bulgaria","2024-11-05",0,0,1,0,0,2,0,0
"Bulgaria","2024-11-06",0,0,1,0,0,2,0,0
"Bulgaria","2024-11-07",0,0,1,0,0,2,0,0
"Bulgaria","2024-11-08",0,0,1,0,0,2,0,0
"Bulgaria","2024-11-09",0,0,1,0,0,2,0,0
"Bulgaria","2024-11-10",0,0,1,0,0,2,0,0
"Bulgaria","2024-11-11",0,0,1,0,0,2,0,0
"Bulgaria","2024-11-12",0,0,1,0,0,2,0,0
"Bulgaria","2024-11-13",0,0,1,0,0,2,0,0
"Bulgaria","2024-11-14",0,0,1,0,0,2,0,0
"Bulgaria","2024-11-15",0,0,1,0,0,2,0,0
"Bulgaria","2024-11-16",0,0,1,0,0,2,0,0
"Bulgaria","2024-11-17",0,0,1,0,0,2,0,0
"Bulgaria","2024-11-18",0,0,1,0,0,2,0,0
"Bulgaria","2024-11-19",0,0,1,0,0,2,0,0
"Bulgaria","2024-11-20",0,0,1,0,0,2,0,0
"Bulgaria","2024-11-21",0,0,1,0,0,2,0,0
"Bulgaria","2024-11-22",0,0,1,0,0,2,0,0
"Bulgaria","2024-11-23",0,0,1,0,0,2,0,0
"Bulgaria","2024-11-24",0,0,1,0,0,2,0,0
"Bulgaria","2024-11-25",0,0,1,0,0,2,0,0
"Bulgaria","2024-11-26",0,0,1,0,0,2,0,0
"Bulgaria","2024-11-27",0,0,1,0,0,2,0,0
"Bulgaria","2024-11-28",0,0,1,0,0,2,0,0
"Bulgaria","2024-11-29",0,0,1,0,0,2,0,0
"Bulgaria","2024-11-30",0,1,2,0,0,2,0,0
"Bulgaria","2024-12-01",0,0,2,0,0,2,0,0
"Bulgaria","2024-12-02",0,0,2,0,0,2,0,0
"Bulgaria","2024-12-03",0,0,2,0,0,2,0,0
"Bulgaria","2024-12-04",0,0,2,0,0,2,0,0
"Bulgaria","2024-12-05",0,0,2,0,0,2,0,0
"Bulgaria","2024-12-06",0,0,2,0,0,2,0,0
"Bulgaria","2024-12-07",0,0,2,0,0,2,0,0
"Bulgaria","2024-12-08",0,0,2,0,1,3,0,0
"Bulgaria","2024-12-09",0,0,2,0,0,3,0,0
"Bulgaria","2024-12-10",0,0,2,0,0,3,0,0
"Bulgaria","2024-12-11",0,0,2,0,0,3,0,0
"Bulgaria","2024-12-12",0,0,2,0,0,3,0,0
"Bulgaria","2024-12-13",0,0,2,0,0,3,0,0
"Bulgaria","2024-12-14",0,0,2,0,0,3,0,0
"Bulgaria","2024-12-15",0,0,2,0,0,3,0,0
"Bulgaria","2024-12-16",0,0,2,0,0,3,0,0
"Bulgaria","2024-12-17",0,0,2,0,0,3,0,0
"Bulgaria","2024-12-18",0,0,2,0,0,3,0,0
"Bulgaria","2024-12-19",0,0,2,0,0,3,0,0
"Bulgaria","2024-12-20",0,0,2,0,0,3,0,0
"Bulgaria","2024-12-21",0,0,2,0,0,3,0,0
"Bulgaria","2024-12-22",0,0,2,0,0,3,0,0
"Bulgaria","2024-12-23",0,0,2,0,0,3,0,0
"Bulgaria","2024-12-24",0,0,2,0,1,4,0,0
"Bulgaria","2024-12-25",0,0,2,0,0,4,0,0
"Bulgaria","2024-12-26",0,0,2,0,0,4,0,0
"Bulgaria","2024-12-27",0,0,2,0,0,4,0,0
"Bulgaria","2024-12-28",0,0,2,0,0,4,0,0
"Bulgaria","2024-12-29",0,0,2,0,0,4,0,0
"Bulgaria","2024-12-30",0,0,2,0,0,4,0,0
"Bulgaria","2024-12-31",0,2,4,0,0,4,0,0
"Bulgaria","2025-01-01",0,0,4,0,0,4,0,0
"Bulgaria","2025-01-02",0,0,4,0,0,4,0,0
"Bulgaria","2025-01-03",0,0,4,0,0,4,0,0
"Bulgaria","2025-01-04",0,0,4,0,0,4,0,0
"Bulgaria","2025-01-05",0,0,4,0,0,4,0,0
"Bulgaria","2025-01-06",0,0,4,0,1,5,0,0
"Bulgaria","2025-01-07",0,0,4,0,0,5,0,0
"Bulgaria","2025-01-08",0,0,4,0,0,5,0,0
"Bulgaria","2025-01-09",0,0,4,0,0,5,0,0
"Bulgaria","2025-01-10",0,1,5,0,0,5,0,0
"Bulgaria","2025-01-11",0,0,5,0,0,5,0,0
"Bulgaria","2025-01-12",0,0,5,0,0,5,0,0
"Bulgaria","2025-01-13",0,0,5,0,0,5,0,0
"Bulgaria","2025-01-14",0,0,5,0,0,5,0,0
"Bulgaria","2025-01-15",0,0,5,0,0,5,0,0
"Bulgaria","2025-01-16",0,0,5,0,0,5,0,0
"Bulgaria","2025-01-17",0,0,5,0,0,5,0,0
"Bulgaria","2025-01-18",0,0,5,0,0,5,0,0
"Bulgaria","2025-01-19",0,0,5,0,0,5,0,0
"Bulgaria","2025-01-20",0,0,5,0,0,5,0,0
"Bulgaria","2025-01-21",0,0,5,0,0,5,0,0
"Bulgaria","2025-01-22",0,0,5,0,0,5,0,0
"Bulgaria","2025-01-23",0,0,5,0,0,5,0,0
"Bulgaria","2025-01-24",0,0,5,0,0,5,0,0
"Bulgaria","2025-01-25",0,0,5,0,0,5,0,0
"Bulgaria","2025-01-26",0,0,5,0,0,5,0,0
"Bulgaria","2025-01-27",0,0,5,0,0,5,0,0
"Bulgaria","2025-01-28",0,0,5,0,0,5,0,0
"Bulgaria","2025-01-29",0,0,5,0,0,5,0,0
"Bulgaria","2025-01-30",0,0,5,0,0,5,0,0
"Bulgaria","2025-01-31",0,0,5,0,0,5,0,0
"Bulgaria","2025-02-01",0,0,5,0,0,5,0,0
"Bulgaria","2025-02-02",0,0,5,0,0,5,0,0
"Bulgaria","2025-02-03",0,0,5,0,0,5,0,0
"Bulgaria","2025-02-04",0,0,5,0,0,5,0,0
"Bulgaria","2025-02-05",0,0,5,0,0,5,0,0
"Bulgaria","2025-02-06",0,0,5,0,0,5,0,0
"Bulgaria","2025-02-07",0,0,5,0,0,5,0,0
"Bulgaria","2025-02-08",0,0,5,0,0,5,0,0
"Bulgaria","2025-02-09",0,0,5,0,0,5,0,0
"Bulgaria","2025-02-10",0,0,5,0,0,5,0,0
"Bulgaria","2025-02-11",0,0,5,0,0,5,0,0
"Bulgaria","2025-02-12",0,0,5,0,0,5,0,0
"Bulgaria","2025-02-13",0,0,5,0,0,5,0,0
"Bulgaria","2025-02-14",0,0,5,0,0,5,0,0
"Bulgaria","2025-02-15",0,0,5,0,0,5,0,0
"Bulgaria","2025-02-16",0,0,5,0,0,5,0,0
"Bulgaria","2025-02-17",0,0,5,0,0,5,0,0
"Bulgaria","2025-02-18",0,0,5,0,0,5,0,0
"Bulgaria","2025-02-19",0,0,5,0,0,5,0,0
"Bulgaria","2025-02-20",0,0,5,0,0,5,0,0
"Bulgaria","2025-02-21",0,0,5,0,0,5,0,0
"Bulgaria","2025-02-22",0,0,5,0,0,5,0,0
"Bulgaria","2025-02-23",0,0,5,0,0,5,0,0
"Bulgaria","2025-02-24",0,0,5,0,0,5,0,0
"Bulgaria","2025-02-25",0,0,5,0,0,5,0,0
"Bulgaria","2025-02-26",0,0,5,0,0,5,0,0
"Bulgaria","2025-02-27",0,0,5,0,0,5,0,0
"Bulgaria","2025-02-28",0,0,5,0,0,5,0,0
"Bulgaria","2025-03-01",0,0,5,0,0,5,0,0
"Bulgaria","2025-03-02",0,0,5,0,0,5,0,0
"Bulgaria","2025-03-03",0,0,5,0,0,5,0,0
"Burundi","2024-01-01",0,0,0,0,0,0,0,0
"Burundi","2024-01-02",0,0,0,0,0,0,0,0
"Burundi","2024-01-03",0,0,0,0,0,0,0,0
"Burundi","2024-01-04",0,0,0,0,0,0,0,0
"Burundi","2024-01-05",0,0,0,0,0,0,0,0
"Burundi","2024-01-06",0,0,0,0,0,0,0,0
"Burundi","2024-01-07",0,0,0,0,0,0,0,0
"Burundi","2024-01-08",0,0,0,0,0,0,0,0
"Burundi","2024-01-09",0,0,0,0,0,0,0,0
"Burundi","2024-01-10",0,0,0,0,0,0,0,0
"Burundi","2024-01-11",0,0,0,0,0,0,0,0
"Burundi","2024-01-12",0,0,0,0,0,0,0,0
"Burundi","2024-01-13",0,0,0,0,0,0,0,0
"Burundi","2024-01-14",0,0,0,0,0,0,0,0
"Burundi","2024-01-15",0,0,0,0,0,0,0,0
"Burundi","2024-01-16",0,0,0,0,0,0,0,0
"Burundi","2024-01-17",0,0,0,0,0,0,0,0
"Burundi","2024-01-18",0,0,0,0,0,0,0,0
"Burundi","2024-01-19",0,0,0,0,0,0,0,0
"Burundi","2024-01-20",0,0,0,0,0,0,0,0
"Burundi","2024-01-21",0,0,0,0,0,0,0,0
"Burundi","2024-01-22",0,0,0,0,0,0,0,0
"Burundi","2024-01-23",0,0,0,0,0,0,0,0
"Burundi","2024-01-24",0,0,0,0,0,0,0,0
"Burundi","2024-01-25",0,0,0,0,0,0,0,0
"Burundi","2024-01-26",0,0,0,0,0,0,0,0
"Burundi","2024-01-27",0,0,0,0,0,0,0,0
"Burundi","2024-01-28",0,0,0,0,0,0,0,0
"Burundi","2024-01-29",0,0,0,0,0,0,0,0
"Burundi","2024-01-30",0,0,0,0,0,0,0,0
"Burundi","2024-01-31",0,0,0,0,0,0,0,0
"Burundi","2024-02-01",0,0,0,0,0,0,0,0
"Burundi","2024-02-02",0,0,0,0,0,0,0,0
"Burundi","2024-02-03",0,0,0,0,0,0,0,0
"Burundi","2024-02-04",0,0,0,0,0,0,0,0
"Burundi","2024-02-05",0,0,0,0,0,0,0,0
"Burundi","2024-02-06",0,0,0,0,0,0,0,0
"Burundi","2024-02-07",0,0,0,0,0,0,0,0
"Burundi","2024-02-08",0,0,0,0,0,0,0,0
"Burundi","2024-02-09",0,0,0,0,0,0,0,0
"Burundi","2024-02-10",0,0,0,0,0,0,0,0
"Burundi","2024-02-11",0,0,0,0,0,0,0,0
"Burundi","2024-02-12",0,0,0,0,0,0,0,0
"Burundi","2024-02-13",0,0,0,0,0,0,0,0
"Burundi","2024-02-14",0,0,0,0,0,0,0,0
"Burundi","2024-02-15",0,0,0,0,0,0,0,0
"Burundi","2024-02-16",0,0,0,0,0,0,0,0
"Burundi","2024-02-17",0,0,0,0,0,0,0,0
"Burundi","2024-02-18",0,0,0,0,0,0,0,0
"Burundi","2024-02-19",0,0,0,0,0,0,0,0
"Burundi","2024-02-20",0,0,0,0,0,0,0,0
"Burundi","2024-02-21",0,0,0,0,0,0,0,0
"Burundi","2024-02-22",0,0,0,0,0,0,0,0
"Burundi","2024-02-23",0,0,0,0,0,0,0,0
"Burundi","2024-02-24",0,0,0,0,0,0,0,0
"Burundi","2024-02-25",0,0,0,0,0,0,0,0
"Burundi","2024-02-26",0,0,0,0,0,0,0,0
"Burundi","2024-02-27",0,0,0,0,0,0,0,0
"Burundi","2024-02-28",0,0,0,0,0,0,0,0
"Burundi","2024-02-29",0,0,0,0,0,0,0,0
"Burundi","2024-03-01",0,0,0,0,0,0,0,0
"Burundi","2024-03-02",0,0,0,0,0,0,0,0
"Burundi","2024-03-03",0,0,0,0,0,0,0,0
"Burundi","2024-03-04",0,0,0,0,0,0,0,0
"Burundi","2024-03-05",0,0,0,0,0,0,0,0
"Burundi","2024-03-06",0,0,0,0,0,0,0,0
"Burundi","2024-03-07",0,0,0,0,0,0,0,0
"Burundi","2024-03-08",0,0,0,0,0,0,0,0
"Burundi","2024-03-09",0,0,0,0,0,0,0,0
"Burundi","2024-03-10",0,0,0,0,0,0,0,0
"Burundi","2024-03-11",0,0,0,0,0,0,0,0
"Burundi","2024-03-12",0,0,0,0,0,0,0,0
"Burundi","2024-03-13",0,0,0,0,0,0,0,0
"Burundi","2024-03-14",0,0,0,0,0,0,0,0
"Burundi","2024-03-15",0,0,0,0,0,0,0,0
"Burundi","2024-03-16",0,0,0,0,0,0,0,0
"Burundi","2024-03-17",0,0,0,0,0,0,0,0
"Burundi","2024-03-18",0,0,0,0,0,0,0,0
"Burundi","2024-03-19",0,0,0,0,0,0,0,0
"Burundi","2024-03-20",0,0,0,0,0,0,0,0
"Burundi","2024-03-21",0,0,0,0,0,0,0,0
"Burundi","2024-03-22",0,0,0,0,0,0,0,0
"Burundi","2024-03-23",0,0,0,0,0,0,0,0
"Burundi","2024-03-24",0,0,0,0,0,0,0,0
"Burundi","2024-03-25",0,0,0,0,0,0,0,0
"Burundi","2024-03-26",0,0,0,0,0,0,0,0
"Burundi","2024-03-27",0,0,0,0,0,0,0,0
"Burundi","2024-03-28",0,0,0,0,0,0,0,0
"Burundi","2024-03-29",0,0,0,0,0,0,0,0
"Burundi","2024-03-30",0,0,0,0,0,0,0,0
"Burundi","2024-03-31",0,0,0,0,0,0,0,0
"Burundi","2024-04-01",0,0,0,0,0,0,0,0
"Burundi","2024-04-02",0,0,0,0,0,0,0,0
"Burundi","2024-04-03",0,0,0,0,0,0,0,0
"Burundi","2024-04-04",0,0,0,0,0,0,0,0
"Burundi","2024-04-05",0,0,0,0,0,0,0,0
"Burundi","2024-04-06",0,0,0,0,0,0,0,0
"Burundi","2024-04-07",0,0,0,0,0,0,0,0
"Burundi","2024-04-08",0,0,0,0,0,0,0,0
"Burundi","2024-04-09",0,0,0,0,0,0,0,0
"Burundi","2024-04-10",0,0,0,0,0,0,0,0
"Burundi","2024-04-11",0,0,0,0,0,0,0,0
"Burundi","2024-04-12",0,0,0,0,0,0,0,0
"Burundi","2024-04-13",0,0,0,0,0,0,0,0
"Burundi","2024-04-14",0,0,0,0,0,0,0,0
"Burundi","2024-04-15",0,0,0,0,0,0,0,0
"Burundi","2024-04-16",0,0,0,0,0,0,0,0
"Burundi","2024-04-17",0,0,0,0,0,0,0,0
"Burundi","2024-04-18",0,0,0,0,0,0,0,0
"Burundi","2024-04-19",0,0,0,0,0,0,0,0
"Burundi","2024-04-20",0,0,0,0,0,0,0,0
"Burundi","2024-04-21",0,0,0,0,0,0,0,0
"Burundi","2024-04-22",0,0,0,0,0,0,0,0
"Burundi","2024-04-23",0,0,0,0,0,0,0,0
"Burundi","2024-04-24",0,0,0,0,0,0,0,0
"Burundi","2024-04-25",0,0,0,0,0,0,0,0
"Burundi","2024-04-26",0,0,0,0,0,0,0,0
"Burundi","2024-04-27",0,0,0,0,0,0,0,0
"Burundi","2024-04-28",0,0,0,0,0,0,0,0
"Burundi","2024-04-29",0,0,0,0,0,0,0,0
"Burundi","2024-04-30",0,0,0,0,0,0,0,0
"Burundi","2024-05-01",0,0,0,0,0,0,0,0
"Burundi","2024-05-02",0,0,0,0,0,0,0,0
"Burundi","2024-05-03",0,0,0,0,0,0,0,0
"Burundi","2024-05-04",0,0,0,0,0,0,0,0
"Burundi","2024-05-05",0,0,0,0,0,0,0,0
"Burundi","2024-05-06",0,0,0,0,0,0,0,0
"Burundi","2024-05-07",0,0,0,0,0,0,0,0
"Burundi","2024-05-08",0,0,0,0,0,0,0,0
"Burundi","2024-05-09",0,0,0,0,0,0,0,0
"Burundi","2024-05-10",0,0,0,0,0,0,0,0
"Burundi","2024-05-11",0,0,0,0,0,0,0,0
"Burundi","2024-05-12",0,0,0,0,0,0,0,0
"Burundi","2024-05-13",0,0,0,0,0,0,0,0
"Burundi","2024-05-14",0,0,0,0,0,0,0,0
"Burundi","2024-05-15",0,0,0,0,0,0,0,0
"Burundi","2024-05-16",0,0,0,0,0,0,0,0
"Burundi","2024-05-17",0,0,0,0,0,0,0,0
"Burundi","2024-05-18",0,0,0,0,0,0,0,0
"Burundi","2024-05-19",0,0,0,0,0,0,0,0
"Burundi","2024-05-20",0,0,0,0,0,0,0,0
"Burundi","2024-05-21",0,0,0,0,0,0,0,0
"Burundi","2024-05-22",0,0,0,0,0,0,0,0
"Burundi","2024-05-23",0,0,0,0,0,0,0,0
"Burundi","2024-05-24",0,0,0,0,0,0,0,0
"Burundi","2024-05-25",0,0,0,0,0,0,0,0
"Burundi","2024-05-26",0,0,0,0,0,0,0,0
"Burundi","2024-05-27",0,0,0,0,0,0,0,0
"Burundi","2024-05-28",0,0,0,0,0,0,0,0
"Burundi","2024-05-29",0,0,0,0,0,0,0,0
"Burundi","2024-05-30",0,0,0,0,0,0,0,0
"Burundi","2024-05-31",0,0,0,0,0,0,0,0
"Burundi","2024-06-01",0,0,0,0,0,0,0,0
"Burundi","2024-06-02",0,0,0,0,0,0,0,0
"Burundi","2024-06-03",0,0,0,0,0,0,0,0
"Burundi","2024-06-04",0,0,0,0,0,0,0,0
"Burundi","2024-06-05",0,0,0,0,0,0,0,0
"Burundi","2024-06-06",0,0,0,0,0,0,0,0
"Burundi","2024-06-07",0,0,0,0,0,0,0,0
"Burundi","2024-06-08",0,0,0,0,0,0,0,0
"Burundi","2024-06-09",0,0,0,0,0,0,0,0
"Burundi","2024-06-10",0,0,0,0,0,0,0,0
"Burundi","2024-06-11",0,0,0,0,0,0,0,0
"Burundi","2024-06-12",0,0,0,0,0,0,0,0
"Burundi","2024-06-13",0,0,0,0,0,0,0,0
"Burundi","2024-06-14",0,0,0,0,0,0,0,0
"Burundi","2024-06-15",0,0,0,0,0,0,0,0
"Burundi","2024-06-16",0,0,0,0,0,0,0,0
"Burundi","2024-06-17",0,0,0,0,0,0,0,0
"Burundi","2024-06-18",0,0,0,0,0,0,0,0
"Burundi","2024-06-19",0,0,0,0,0,0,0,0
"Burundi","2024-06-20",0,0,0,0,0,0,0,0
"Burundi","2024-06-21",0,0,0,0,0,0,0,0
"Burundi","2024-06-22",0,0,0,0,0,0,0,0
"Burundi","2024-06-23",0,0,0,0,0,0,0,0
"Burundi","2024-06-24",0,0,0,0,0,0,0,0
"Burundi","2024-06-25",0,0,0,0,0,0,0,0
"Burundi","2024-06-26",0,0,0,0,0,0,0,0
"Burundi","2024-06-27",0,0,0,0,0,0,0,0
"Burundi","2024-06-28",0,0,0,0,0,0,0,0
"Burundi","2024-06-29",0,0,0,0,0,0,0,0
"Burundi","2024-06-30",0,0,0,0,0,0,0,0
"Burundi","2024-07-01",0,0,0,0,0,0,0,0
"Burundi","2024-07-02",0,0,0,0,0,0,0,0
"Burundi","2024-07-03",0,0,0,0,0,0,0,0
"Burundi","2024-07-04",0,0,0,0,0,0,0,0
"Burundi","2024-07-05",0,0,0,0,0,0,0,0
"Burundi","2024-07-06",0,0,0,0,0,0,0,0
"Burundi","2024-07-07",0,0,0,0,0,0,0,0
"Burundi","2024-07-08",0,0,0,0,0,0,0,0
"Burundi","2024-07-09",0,0,0,0,0,0,0,0
"Burundi","2024-07-10",0,0,0,0,0,0,0,0
"Burundi","2024-07-11",0,0,0,0,0,0,0,0
"Burundi","2024-07-12",0,0,0,0,0,0,0,0
"Burundi","2024-07-13",0,0,0,0,0,0,0,0
"Burundi","2024-07-14",0,0,0,0,0,0,0,0
"Burundi","2024-07-15",0,0,0,0,0,0,0,0
"Burundi","2024-07-16",0,0,0,0,0,0,0,0
"Burundi","2024-07-17",0,0,0,0,0,0,0,0
"Burundi","2024-07-18",0,0,0,0,0,0,0,0
"Burundi","2024-07-19",5,0,0,5,0,0,5,5
"Burundi","2024-07-20",0,0,0,5,0,0,3,8
"Burundi","2024-07-21",0,0,0,5,0,0,4,12
"Burundi","2024-07-22",0,0,0,5,0,0,3,15
"Burundi","2024-07-23",0,0,0,5,0,0,3,18
"Burundi","2024-07-24",0,0,0,5,0,0,3,21
"Burundi","2024-07-25",0,0,0,5,0,0,4,25
"Burundi","2024-07-26",0,0,0,5,0,0,3,28
"Burundi","2024-07-27",0,0,0,5,0,0,3,31
"Burundi","2024-07-28",0,9,9,5,9,9,3,34
"Burundi","2024-07-29",0,0,9,5,4,13,4,38
"Burundi","2024-07-30",0,0,9,5,5,18,3,41
"Burundi","2024-07-31",0,0,9,5,4,22,3,44
"Burundi","2024-08-01",0,0,9,5,5,27,3,47
"Burundi","2024-08-02",0,0,9,5,4,31,4,51
"Burundi","2024-08-03",49,0,9,54,5,36,3,54
"Burundi","2024-08-04",0,31,40,54,4,40,10,64
"Burundi","2024-08-05",0,0,40,54,6,46,10,74
"Burundi","2024-08-06",0,0,40,54,6,52,10,84
"Burundi","2024-08-07",0,0,40,54,6,58,10,94
"Burundi","2024-08-08",0,0,40,54,7,65,10,104
"Burundi","2024-08-09",60,0,40,114,6,71,10,114
"Burundi","2024-08-10",0,0,40,114,6,77,19,133
"Burundi","2024-08-11",0,43,83,114,6,83,19,152
"Burundi","2024-08-12",0,0,83,114,10,93,19,171
"Burundi","2024-08-13",0,0,83,114,10,103,20,191
"Burundi","2024-08-14",0,0,83,114,10,113,19,210
"Burundi","2024-08-15",0,0,83,114,10,123,19,229
"Burundi","2024-08-16",134,0,83,248,10,133,19,248
"Burundi","2024-08-17",0,0,83,248,10,143,24,272
"Burundi","2024-08-18",0,70,153,248,10,153,23,295
"Burundi","2024-08-19",0,0,153,248,11,164,24,319
"Burundi","2024-08-20",0,0,153,248,11,175,24,343
"Burundi","2024-08-21",0,0,153,248,11,186,23,366
"Burundi","2024-08-22",0,0,153,248,12,198,24,390
"Burundi","2024-08-23",0,0,153,248,11,209,24,414
"Burundi","2024-08-24",0,0,153,248,11,220,23,437
"Burundi","2024-08-25",213,78,231,461,11,231,24,461
"Burundi","2024-08-26",0,0,231,461,14,245,39,500
"Burundi","2024-08-27",0,0,231,461,14,259,40,540
"Burundi","2024-08-28",0,0,231,461,14,273,39,579
"Burundi","2024-08-29",0,0,231,461,13,286,39,618
"Burundi","2024-08-30",0,0,231,461,14,300,40,658
"Burundi","2024-08-31",236,0,231,697,14,314,39,697
"Burundi","2024-09-01",0,97,328,697,14,328,8,705
"Burundi","2024-09-02",0,0,328,697,8,336,8,713
"Burundi","2024-09-03",0,0,328,697,8,344,8,721
"Burundi","2024-09-04",0,0,328,697,8,352,8,729
"Burundi","2024-09-05",0,0,328,697,9,361,7,736
"Burundi","2024-09-06",0,0,328,697,8,369,8,744
"Burundi","2024-09-07",0,0,328,697,8,377,8,752
"Burundi","2024-09-08",63,57,385,760,8,385,8,760
"Burundi","2024-09-09",0,0,385,760,26,411,40,800
"Burundi","2024-09-10",0,0,385,760,25,436,40,840
"Burundi","2024-09-11",0,0,385,760,26,462,40,880
"Burundi","2024-09-12",0,0,385,760,25,487,40,920
"Burundi","2024-09-13",0,0,385,760,26,513,41,961
"Burundi","2024-09-14",0,0,385,760,25,538,40,1001
"Burundi","2024-09-15",0,179,564,760,26,564,40,1041
"Burundi","2024-09-16",321,0,564,1081,19,583,40,1081
"Burundi","2024-09-17",0,0,564,1081,19,602,37,1118
"Burundi","2024-09-18",0,0,564,1081,19,621,37,1155
"Burundi","2024-09-19",0,0,564,1081,18,639,37,1192
"Burundi","2024-09-20",0,0,564,1081,19,658,37,1229
"Burundi","2024-09-21",0,0,564,1081,19,677,37,1266
"Burundi","2024-09-22",0,132,696,1081,19,696,37,1303
"Burundi","2024-09-23",259,0,696,1340,22,718,37,1340
"Burundi","2024-09-24",0,0,696,1340,23,741,10,1350
"Burundi","2024-09-25",0,0,696,1340,22,763,10,1360
"Burundi","2024-09-26",0,0,696,1340,23,786,9,1369
"Burundi","2024-09-27",0,0,696,1340,22,808,10,1379
"Burundi","2024-09-28",0,0,696,1340,23,831,10,1389
"Burundi","2024-09-29",0,157,853,1340,22,853,10,1399
"Burundi","2024-09-30",0,0,853,1340,19,872,10,1409
"Burundi","2024-10-01",0,0,853,1340,19,891,9,1418
"Burundi","2024-10-02",0,0,853,1340,19,910,10,1428
"Burundi","2024-10-03",0,0,853,1340,20,930,10,1438
"Burundi","2024-10-04",0,0,853,1340,19,949,10,1448
"Burundi","2024-10-05",0,0,853,1340,19,968,9,1457
"Burundi","2024-10-06",0,134,987,1340,19,987,10,1467
"Burundi","2024-10-07",0,0,987,1340,26,1013,10,1477
"Burundi","2024-10-08",0,0,987,1340,26,1039,10,1487
"Burundi","2024-10-09",0,0,987,1340,26,1065,10,1497
"Burundi","2024-10-10",0,0,987,1340,27,1092,9,1506
"Burundi","2024-10-11",0,0,987,1340,26,1118,10,1516
"Burundi","2024-10-12",186,0,987,1526,26,1144,10,1526
"Burundi","2024-10-13",98,183,1170,1624,26,1170,98,1624
"Burundi","2024-10-14",0,0,1170,1624,17,1187,16,1640
"Burundi","2024-10-15",0,0,1170,1624,16,1203,17,1657
"Burundi","2024-10-16",0,0,1170,1624,17,1220,16,1673
"Burundi","2024-10-17",0,0,1170,1624,17,1237,17,1690
"Burundi","2024-10-18",0,0,1170,1624,17,1254,16,1706
"Burundi","2024-10-19",0,0,1170,1624,16,1270,17,1723
"Burundi","2024-10-20",115,117,1287,1739,17,1287,16,1739
"Burundi","2024-10-21",0,0,1287,1739,32,1319,16,1755
"Burundi","2024-10-22",0,0,1287,1739,31,1350,16,1771
"Burundi","2024-10-23",0,0,1287,1739,32,1382,16,1787
"Burundi","2024-10-24",0,0,1287,1739,32,1414,17,1804
"Burundi","2024-10-25",0,0,1287,1739,32,1446,16,1820
"Burundi","2024-10-26",0,0,1287,1739,31,1477,16,1836
"Burundi","2024-10-27",113,222,1509,1852,32,1509,16,1852
"Burundi","2024-10-28",0,0,1509,1852,30,1539,14,1866
"Burundi","2024-10-29",0,0,1509,1852,30,1569,15,1881
"Burundi","2024-10-30",0,0,1509,1852,30,1599,14,1895
"Burundi","2024-10-31",0,0,1509,1852,29,1628,15,1910
"Burundi","2024-11-01",0,0,1509,1852,30,1658,14,1924
"Burundi","2024-11-02",0,0,1509,1852,30,1688,15,1939
"Burundi","2024-11-03",101,209,1718,1953,30,1718,14,1953
"Burundi","2024-11-04",0,0,1718,1953,21,1739,11,1964
"Burundi","2024-11-05",0,0,1718,1953,20,1759,11,1975
"Burundi","2024-11-06",0,0,1718,1953,21,1780,10,1985
"Burundi","2024-11-07",0,0,1718,1953,21,1801,11,1996
"Burundi","2024-11-08",0,0,1718,1953,21,1822,11,2007
"Burundi","2024-11-09",0,0,1718,1953,20,1842,11,2018
"Burundi","2024-11-10",0,145,1863,1953,21,1863,11,2029
"Burundi","2024-11-11",0,0,1863,1953,27,1890,10,2039
"Burundi","2024-11-12",0,0,1863,1953,26,1916,11,2050
"Burundi","2024-11-13",108,0,1863,2061,27,1943,11,2061
"Burundi","2024-11-14",0,0,1863,2061,27,1970,0,2061
"Burundi","2024-11-15",0,0,1863,2061,27,1997,0,2061
"Burundi","2024-11-16",0,0,1863,2061,26,2023,0,2061
"Burundi","2024-11-17",0,187,2050,2061,27,2050,0,2061
"Burundi","2024-11-18",0,0,2050,2061,27,2077,0,2061
"Burundi","2024-11-19",0,0,2050,2061,26,2103,0,2061
"Burundi","2024-11-20",0,0,2050,2061,27,2130,0,2061
"Burundi","2024-11-21",0,0,2050,2061,27,2157,0,2061
"Burundi","2024-11-22",0,0,2050,2061,27,2184,0,2061
"Burundi","2024-11-23",0,0,2050,2061,26,2210,0,2061
"Burundi","2024-11-24",0,187,2237,2061,27,2237,0,2061
"Burundi","2024-11-25",0,0,2237,2061,24,2261,0,2061
"Burundi","2024-11-26",0,0,2237,2061,23,2284,0,2061
"Burundi","2024-11-27",0,0,2237,2061,24,2308,0,2061
"Burundi","2024-11-28",0,0,2237,2061,23,2331,0,2061
"Burundi","2024-11-29",0,0,2237,2061,24,2355,0,2061
"Burundi","2024-11-30",0,0,2237,2061,23,2378,0,2061
"Burundi","2024-12-01",0,165,2402,2061,24,2402,0,2061
"Burundi","2024-12-02",0,0,2402,2061,21,2423,0,2061
"Burundi","2024-12-03",0,0,2402,2061,20,2443,0,2061
"Burundi","2024-12-04",0,0,2402,2061,21,2464,0,2061
"Burundi","2024-12-05",0,0,2402,2061,20,2484,0,2061
"Burundi","2024-12-06",0,0,2402,2061,21,2505,0,2061
"Burundi","2024-12-07",0,0,2402,2061,20,2525,0,2061
"Burundi","2024-12-08",0,144,2546,2061,21,2546,0,2061
"Burundi","2024-12-09",0,0,2546,2061,24,2570,0,2061
"Burundi","2024-12-10",0,0,2546,2061,25,2595,0,2061
"Burundi","2024-12-11",0,0,2546,2061,24,2619,0,2061
"Burundi","2024-12-12",0,0,2546,2061,25,2644,0,2061
"Burundi","2024-12-13",0,0,2546,2061,24,2668,0,2061
"Burundi","2024-12-14",0,0,2546,2061,25,2693,0,2061
"Burundi","2024-12-15",0,171,2717,2061,24,2717,0,2061
"Burundi","2024-12-16",0,0,2717,2061,21,2738,0,2061
"Burundi","2024-12-17",0,0,2717,2061,20,2758,0,2061
"Burundi","2024-12-18",0,0,2717,2061,21,2779,0,2061
"Burundi","2024-12-19",0,0,2717,2061,20,2799,0,2061
"Burundi","2024-12-20",0,0,2717,2061,21,2820,0,2061
"Burundi","2024-12-21",0,0,2717,2061,20,2840,0,2061
"Burundi","2024-12-22",0,144,2861,2061,21,2861,0,2061
"Burundi","2024-12-23",0,0,2861,2061,12,2873,0,2061
"Burundi","2024-12-24",0,0,2861,2061,12,2885,0,2061
"Burundi","2024-12-25",0,0,2861,2061,12,2897,0,2061
"Burundi","2024-12-26",0,0,2861,2061,13,2910,0,2061
"Burundi","2024-12-27",0,0,2861,2061,12,2922,0,2061
"Burundi","2024-12-28",0,0,2861,2061,12,2934,0,2061
"Burundi","2024-12-29",0,85,2946,2061,12,2946,0,2061
"Burundi","2024-12-30",0,0,2946,2061,13,2959,0,2061
"Burundi","2024-12-31",0,0,2946,2061,12,2971,0,2061
"Burundi","2025-01-01",0,0,2946,2061,13,2984,0,2061
"Burundi","2025-01-02",0,0,2946,2061,13,2997,0,2061
"Burundi","2025-01-03",0,0,2946,2061,13,3010,0,2061
"Burundi","2025-01-04",0,0,2946,2061,12,3022,0,2061
"Burundi","2025-01-05",0,89,3035,2061,13,3035,0,2061
"Burundi","2025-01-06",0,0,3035,2061,12,3047,0,2061
"Burundi","2025-01-07",0,0,3035,2061,11,3058,0,2061
"Burundi","2025-01-08",0,0,3035,2061,12,3070,0,2061
"Burundi","2025-01-09",0,0,3035,2061,11,3081,0,2061
"Burundi","2025-01-10",0,0,3035,2061,12,3093,0,2061
"Burundi","2025-01-11",0,0,3035,2061,11,3104,0,2061
"Burundi","2025-01-12",0,81,3116,2061,12,3116,0,2061
"Burundi","2025-01-13",0,0,3116,2061,17,3133,0,2061
"Burundi","2025-01-14",0,0,3116,2061,17,3150,0,2061
"Burundi","2025-01-15",0,0,3116,2061,17,3167,0,2061
"Burundi","2025-01-16",0,0,3116,2061,18,3185,0,2061
"Burundi","2025-01-17",0,0,3116,2061,17,3202,0,2061
"Burundi","2025-01-18",0,0,3116,2061,17,3219,0,2061
"Burundi","2025-01-19",0,120,3236,2061,17,3236,0,2061
"Burundi","2025-01-20",0,0,3236,2061,7,3243,0,2061
"Burundi","2025-01-21",0,0,3236,2061,8,3251,0,2061
"Burundi","2025-01-22",0,0,3236,2061,7,3258,0,2061
"Burundi","2025-01-23",0,0,3236,2061,8,3266,0,2061
"Burundi","2025-01-24",0,0,3236,2061,7,3273,0,2061
"Burundi","2025-01-25",0,0,3236,2061,8,3281,0,2061
"Burundi","2025-01-26",0,52,3288,2061,7,3288,0,2061
"Burundi","2025-01-27",0,0,3288,2061,10,3298,0,2061
"Burundi","2025-01-28",0,0,3288,2061,10,3308,0,2061
"Burundi","2025-01-29",0,0,3288,2061,10,3318,0,2061
"Burundi","2025-01-30",0,0,3288,2061,11,3329,0,2061
"Burundi","2025-01-31",0,0,3288,2061,10,3339,0,2061
"Burundi","2025-02-01",0,0,3288,2061,10,3349,0,2061
"Burundi","2025-02-02",0,71,3359,2061,10,3359,0,2061
"Burundi","2025-02-03",0,0,3359,2061,10,3369,0,2061
"Burundi","2025-02-04",0,0,3359,2061,10,3379,0,2061
"Burundi","2025-02-05",0,0,3359,2061,10,3389,0,2061
"Burundi","2025-02-06",0,0,3359,2061,9,3398,0,2061
"Burundi","2025-02-07",0,0,3359,2061,10,3408,0,2061
"Burundi","2025-02-08",0,0,3359,2061,10,3418,0,2061
"Burundi","2025-02-09",0,69,3428,2061,10,3428,0,2061
"Burundi","2025-02-10",0,0,3428,2061,5,3433,0,2061
"Burundi","2025-02-11",0,0,3428,2061,5,3438,0,2061
"Burundi","2025-02-12",0,0,3428,2061,5,3443,0,2061
"Burundi","2025-02-13",0,0,3428,2061,5,3448,0,2061
"Burundi","2025-02-14",0,0,3428,2061,5,3453,0,2061
"Burundi","2025-02-15",0,0,3428,2061,5,3458,0,2061
"Burundi","2025-02-16",0,35,3463,2061,5,3463,0,2061
"Burundi","2025-02-17",0,0,3463,2061,0,3463,0,2061
"Burundi","2025-02-18",0,0,3463,2061,0,3463,0,2061
"Burundi","2025-02-19",0,0,3463,2061,0,3463,0,2061
"Burundi","2025-02-20",0,0,3463,2061,0,3463,0,2061
"Burundi","2025-02-21",0,0,3463,2061,0,3463,0,2061
"Burundi","2025-02-22",0,0,3463,2061,0,3463,0,2061
"Burundi","2025-02-23",0,0,3463,2061,0,3463,0,2061
"Burundi","2025-02-24",0,0,3463,2061,0,3463,0,2061
"Burundi","2025-02-25",0,0,3463,2061,0,3463,0,2061
"Burundi","2025-02-26",0,0,3463,2061,0,3463,0,2061
"Burundi","2025-02-27",0,0,3463,2061,0,3463,0,2061
"Burundi","2025-02-28",0,0,3463,2061,0,3463,0,2061
"Burundi","2025-03-01",0,0,3463,2061,0,3463,0,2061
"Burundi","2025-03-02",0,0,3463,2061,0,3463,0,2061
"Burundi","2025-03-03",0,0,3463,2061,0,3463,0,2061
"Cambodia","2024-01-01",0,0,0,0,0,0,0,0
"Cambodia","2024-01-02",0,0,0,0,0,0,0,0
"Cambodia","2024-01-03",0,0,0,0,0,0,0,0
"Cambodia","2024-01-04",0,2,2,0,2,2,0,0
"Cambodia","2024-01-05",0,0,2,0,0,2,0,0
"Cambodia","2024-01-06",0,0,2,0,0,2,0,0
"Cambodia","2024-01-07",0,0,2,0,0,2,0,0
"Cambodia","2024-01-08",0,0,2,0,0,2,0,0
"Cambodia","2024-01-09",0,0,2,0,0,2,0,0
"Cambodia","2024-01-10",0,0,2,0,0,2,0,0
"Cambodia","2024-01-11",0,0,2,0,0,2,0,0
"Cambodia","2024-01-12",0,0,2,0,0,2,0,0
"Cambodia","2024-01-13",0,0,2,0,0,2,0,0
"Cambodia","2024-01-14",0,0,2,0,0,2,0,0
"Cambodia","2024-01-15",0,0,2,0,0,2,0,0
"Cambodia","2024-01-16",0,0,2,0,0,2,0,0
"Cambodia","2024-01-17",0,0,2,0,0,2,0,0
"Cambodia","2024-01-18",0,0,2,0,0,2,0,0
"Cambodia","2024-01-19",0,0,2,0,1,3,0,0
"Cambodia","2024-01-20",0,0,2,0,0,3,0,0
"Cambodia","2024-01-21",0,0,2,0,0,3,0,0
"Cambodia","2024-01-22",0,0,2,0,0,3,0,0
"Cambodia","2024-01-23",0,0,2,0,0,3,0,0
"Cambodia","2024-01-24",0,0,2,0,0,3,0,0
"Cambodia","2024-01-25",0,0,2,0,0,3,0,0
"Cambodia","2024-01-26",0,0,2,0,0,3,0,0
"Cambodia","2024-01-27",0,0,2,0,0,3,0,0
"Cambodia","2024-01-28",0,0,2,0,0,3,0,0
"Cambodia","2024-01-29",0,0,2,0,0,3,0,0
"Cambodia","2024-01-30",0,0,2,0,0,3,0,0
"Cambodia","2024-01-31",0,0,2,0,0,3,0,0
"Cambodia","2024-02-01",0,0,2,0,0,3,0,0
"Cambodia","2024-02-02",0,1,3,0,0,3,0,0
"Cambodia","2024-02-03",0,0,3,0,0,3,0,0
"Cambodia","2024-02-04",0,0,3,0,1,4,0,0
"Cambodia","2024-02-05",0,0,3,0,0,4,0,0
"Cambodia","2024-02-06",0,0,3,0,1,5,0,0
"Cambodia","2024-02-07",0,0,3,0,0,5,0,0
"Cambodia","2024-02-08",0,0,3,0,1,6,0,0
"Cambodia","2024-02-09",0,0,3,0,0,6,0,0
"Cambodia","2024-02-10",0,0,3,0,0,6,0,0
"Cambodia","2024-02-11",0,0,3,0,1,7,0,0
"Cambodia","2024-02-12",0,0,3,0,0,7,0,0
"Cambodia","2024-02-13",0,0,3,0,1,8,0,0
"Cambodia","2024-02-14",0,0,3,0,0,8,0,0
"Cambodia","2024-02-15",0,0,3,0,1,9,0,0
"Cambodia","2024-02-16",0,0,3,0,0,9,0,0
"Cambodia","2024-02-17",0,0,3,0,0,9,0,0
"Cambodia","2024-02-18",0,0,3,0,1,10,0,0
"Cambodia","2024-02-19",0,0,3,0,0,10,0,0
"Cambodia","2024-02-20",0,0,3,0,1,11,0,0
"Cambodia","2024-02-21",0,0,3,0,0,11,0,0
"Cambodia","2024-02-22",0,0,3,0,1,12,0,0
"Cambodia","2024-02-23",0,9,12,0,0,12,0,0
"Cambodia","2024-02-24",0,0,12,0,0,12,0,0
"Cambodia","2024-02-25",0,0,12,0,0,12,0,0
"Cambodia","2024-02-26",0,0,12,0,0,12,0,0
"Cambodia","2024-02-27",0,0,12,0,0,12,0,0
"Cambodia","2024-02-28",0,0,12,0,0,12,0,0
"Cambodia","2024-02-29",0,0,12,0,0,12,0,0
"Cambodia","2024-03-01",0,0,12,0,0,12,0,0
"Cambodia","2024-03-02",0,0,12,0,0,12,0,0
"Cambodia","2024-03-03",0,0,12,0,0,12,0,0
"Cambodia","2024-03-04",0,0,12,0,0,12,0,0
"Cambodia","2024-03-05",0,0,12,0,0,12,0,0
"Cambodia","2024-03-06",0,0,12,0,0,12,0,0
"Cambodia","2024-03-07",0,0,12,0,0,12,0,0
"Cambodia","2024-03-08",0,0,12,0,0,12,0,0
"Cambodia","2024-03-09",0,0,12,0,0,12,0,0
"Cambodia","2024-03-10",0,0,12,0,0,12,0,0
"Cambodia","2024-03-11",0,0,12,0,0,12,0,0
"Cambodia","2024-03-12",0,0,12,0,0,12,0,0
"Cambodia","2024-03-13",0,0,12,0,0,12,0,0
"Cambodia","2024-03-14",0,0,12,0,0,12,0,0
"Cambodia","2024-03-15",0,0,12,0,0,12,0,0
"Cambodia","2024-03-16",0,0,12,0,0,12,0,0
"Cambodia","2024-03-17",0,0,12,0,0,12,0,0
"Cambodia","2024-03-18",0,0,12,0,0,12,0,0
"Cambodia","2024-03-19",0,0,12,0,0,12,0,0
"Cambodia","2024-03-20",0,0,12,0,0,12,0,0
"Cambodia","2024-03-21",0,0,12,0,0,12,0,0
"Cambodia","2024-03-22",0,0,12,0,0,12,0,0
"Cambodia","2024-03-23",0,0,12,0,0,12,0,0
"Cambodia","2024-03-24",0,0,12,0,0,12,0,0
"Cambodia","2024-03-25",0,0,12,0,0,12,0,0
"Cambodia","2024-03-26",0,0,12,0,0,12,0,0
"Cambodia","2024-03-27",0,0,12,0,0,12,0,0
"Cambodia","2024-03-28",0,0,12,0,0,12,0,0
"Cambodia","2024-03-29",0,0,12,0,0,12,0,0
"Cambodia","2024-03-30",0,0,12,0,0,12,0,0
"Cambodia","2024-03-31",0,0,12,0,0,12,0,0
"Cambodia","2024-04-01",0,0,12,0,0,12,0,0
"Cambodia","2024-04-02",0,0,12,0,0,12,0,0
"Cambodia","2024-04-03",0,0,12,0,0,12,0,0
"Cambodia","2024-04-04",0,0,12,0,0,12,0,0
"Cambodia","2024-04-05",0,0,12,0,0,12,0,0
"Cambodia","2024-04-06",0,0,12,0,0,12,0,0
"Cambodia","2024-04-07",0,0,12,0,0,12,0,0
"Cambodia","2024-04-08",0,0,12,0,0,12,0,0
"Cambodia","2024-04-09",0,0,12,0,0,12,0,0
"Cambodia","2024-04-10",0,0,12,0,0,12,0,0
"Cambodia","2024-04-11",0,0,12,0,0,12,0,0
"Cambodia","2024-04-12",0,0,12,0,0,12,0,0
"Cambodia","2024-04-13",0,0,12,0,0,12,0,0
"Cambodia","2024-04-14",0,0,12,0,0,12,0,0
"Cambodia","2024-04-15",0,0,12,0,0,12,0,0
"Cambodia","2024-04-16",0,0,12,0,0,12,0,0
"Cambodia","2024-04-17",0,0,12,0,0,12,0,0
"Cambodia","2024-04-18",0,0,12,0,0,12,0,0
"Cambodia","2024-04-19",0,0,12,0,0,12,0,0
"Cambodia","2024-04-20",0,0,12,0,0,12,0,0
"Cambodia","2024-04-21",0,0,12,0,0,12,0,0
"Cambodia","2024-04-22",0,0,12,0,0,12,0,0
"Cambodia","2024-04-23",0,0,12,0,0,12,0,0
"Cambodia","2024-04-24",0,0,12,0,0,12,0,0
"Cambodia","2024-04-25",0,0,12,0,0,12,0,0
"Cambodia","2024-04-26",0,0,12,0,0,12,0,0
"Cambodia","2024-04-27",0,0,12,0,0,12,0,0
"Cambodia","2024-04-28",0,0,12,0,0,12,0,0
"Cambodia","2024-04-29",0,0,12,0,0,12,0,0
"Cambodia","2024-04-30",0,0,12,0,0,12,0,0
"Cambodia","2024-05-01",0,0,12,0,0,12,0,0
"Cambodia","2024-05-02",0,0,12,0,0,12,0,0
"Cambodia","2024-05-03",0,0,12,0,0,12,0,0
"Cambodia","2024-05-04",0,0,12,0,0,12,0,0
"Cambodia","2024-05-05",0,0,12,0,0,12,0,0
"Cambodia","2024-05-06",0,0,12,0,0,12,0,0
"Cambodia","2024-05-07",0,0,12,0,0,12,0,0
"Cambodia","2024-05-08",0,0,12,0,0,12,0,0
"Cambodia","2024-05-09",0,0,12,0,0,12,0,0
"Cambodia","2024-05-10",0,0,12,0,0,12,0,0
"Cambodia","2024-05-11",0,0,12,0,0,12,0,0
"Cambodia","2024-05-12",0,0,12,0,0,12,0,0
"Cambodia","2024-05-13",0,0,12,0,0,12,0,0
"Cambodia","2024-05-14",0,0,12,0,0,12,0,0
"Cambodia","2024-05-15",0,0,12,0,0,12,0,0
"Cambodia","2024-05-16",0,0,12,0,0,12,0,0
"Cambodia","2024-05-17",0,0,12,0,0,12,0,0
"Cambodia","2024-05-18",0,0,12,0,0,12,0,0
"Cambodia","2024-05-19",0,0,12,0,0,12,0,0
"Cambodia","2024-05-20",0,0,12,0,0,12,0,0
"Cambodia","2024-05-21",0,0,12,0,0,12,0,0
"Cambodia","2024-05-22",0,0,12,0,0,12,0,0
"Cambodia","2024-05-23",0,0,12,0,0,12,0,0
"Cambodia","2024-05-24",0,0,12,0,0,12,0,0
"Cambodia","2024-05-25",0,0,12,0,0,12,0,0
"Cambodia","2024-05-26",0,0,12,0,0,12,0,0
"Cambodia","2024-05-27",0,0,12,0,0,12,0,0
"Cambodia","2024-05-28",0,0,12,0,0,12,0,0
"Cambodia","2024-05-29",0,0,12,0,0,12,0,0
"Cambodia","2024-05-30",0,0,12,0,0,12,0,0
"Cambodia","2024-05-31",0,0,12,0,0,12,0,0
"Cambodia","2024-06-01",0,0,12,0,0,12,0,0
"Cambodia","2024-06-02",0,0,12,0,0,12,0,0
"Cambodia","2024-06-03",0,0,12,0,0,12,0,0
"Cambodia","2024-06-04",0,0,12,0,0,12,0,0
"Cambodia","2024-06-05",0,0,12,0,0,12,0,0
"Cambodia","2024-06-06",0,0,12,0,0,12,0,0
"Cambodia","2024-06-07",0,0,12,0,0,12,0,0
"Cambodia","2024-06-08",0,0,12,0,0,12,0,0
"Cambodia","2024-06-09",0,0,12,0,0,12,0,0
"Cambodia","2024-06-10",0,0,12,0,0,12,0,0
"Cambodia","2024-06-11",0,0,12,0,0,12,0,0
"Cambodia","2024-06-12",0,0,12,0,0,12,0,0
"Cambodia","2024-06-13",0,0,12,0,0,12,0,0
"Cambodia","2024-06-14",0,0,12,0,0,12,0,0
"Cambodia","2024-06-15",0,0,12,0,0,12,0,0
"Cambodia","2024-06-16",0,0,12,0,0,12,0,0
"Cambodia","2024-06-17",0,0,12,0,0,12,0,0
"Cambodia","2024-06-18",0,0,12,0,0,12,0,0
"Cambodia","2024-06-19",0,0,12,0,0,12,0,0
"Cambodia","2024-06-20",0,0,12,0,0,12,0,0
"Cambodia","2024-06-21",0,0,12,0,0,12,0,0
"Cambodia","2024-06-22",0,0,12,0,0,12,0,0
"Cambodia","2024-06-23",0,0,12,0,0,12,0,0
"Cambodia","2024-06-24",0,0,12,0,0,12,0,0
"Cambodia","2024-06-25",0,0,12,0,0,12,0,0
"Cambodia","2024-06-26",0,0,12,0,0,12,0,0
"Cambodia","2024-06-27",0,0,12,0,0,12,0,0
"Cambodia","2024-06-28",0,0,12,0,0,12,0,0
"Cambodia","2024-06-29",0,0,12,0,0,12,0,0
"Cambodia","2024-06-30",0,0,12,0,0,12,0,0
"Cambodia","2024-07-01",0,0,12,0,0,12,0,0
"Cambodia","2024-07-02",0,0,12,0,0,12,0,0
"Cambodia","2024-07-03",0,0,12,0,0,12,0,0
"Cambodia","2024-07-04",0,0,12,0,0,12,0,0
"Cambodia","2024-07-05",0,0,12,0,0,12,0,0
"Cambodia","2024-07-06",0,0,12,0,0,12,0,0
"Cambodia","2024-07-07",0,0,12,0,0,12,0,0
"Cambodia","2024-07-08",0,0,12,0,0,12,0,0
"Cambodia","2024-07-09",0,0,12,0,0,12,0,0
"Cambodia","2024-07-10",0,0,12,0,0,12,0,0
"Cambodia","2024-07-11",0,0,12,0,0,12,0,0
"Cambodia","2024-07-12",0,0,12,0,0,12,0,0
"Cambodia","2024-07-13",0,0,12,0,0,12,0,0
"Cambodia","2024-07-14",0,0,12,0,0,12,0,0
"Cambodia","2024-07-15",0,0,12,0,0,12,0,0
"Cambodia","2024-07-16",0,0,12,0,0,12,0,0
"Cambodia","2024-07-17",0,0,12,0,0,12,0,0
"Cambodia","2024-07-18",0,0,12,0,0,12,0,0
"Cambodia","2024-07-19",0,0,12,0,0,12,0,0
"Cambodia","2024-07-20",0,0,12,0,0,12,0,0
"Cambodia","2024-07-21",0,0,12,0,0,12,0,0
"Cambodia","2024-07-22",0,0,12,0,0,12,0,0
"Cambodia","2024-07-23",0,0,12,0,0,12,0,0
"Cambodia","2024-07-24",0,0,12,0,0,12,0,0
"Cambodia","2024-07-25",0,0,12,0,0,12,0,0
"Cambodia","2024-07-26",0,0,12,0,0,12,0,0
"Cambodia","2024-07-27",0,0,12,0,0,12,0,0
"Cambodia","2024-07-28",0,0,12,0,0,12,0,0
"Cambodia","2024-07-29",0,0,12,0,0,12,0,0
"Cambodia","2024-07-30",0,0,12,0,0,12,0,0
"Cambodia","2024-07-31",0,0,12,0,0,12,0,0
"Cambodia","2024-08-01",0,0,12,0,0,12,0,0
"Cambodia","2024-08-02",0,0,12,0,0,12,0,0
"Cambodia","2024-08-03",0,0,12,0,0,12,0,0
"Cambodia","2024-08-04",0,0,12,0,0,12,0,0
"Cambodia","2024-08-05",0,0,12,0,0,12,0,0
"Cambodia","2024-08-06",0,0,12,0,0,12,0,0
"Cambodia","2024-08-07",0,0,12,0,0,12,0,0
"Cambodia","2024-08-08",0,0,12,0,0,12,0,0
"Cambodia","2024-08-09",0,0,12,0,0,12,0,0
"Cambodia","2024-08-10",0,0,12,0,0,12,0,0
"Cambodia","2024-08-11",0,0,12,0,0,12,0,0
"Cambodia","2024-08-12",0,0,12,0,0,12,0,0
"Cambodia","2024-08-13",0,0,12,0,0,12,0,0
"Cambodia","2024-08-14",0,0,12,0,0,12,0,0
"Cambodia","2024-08-15",0,0,12,0,0,12,0,0
"Cambodia","2024-08-16",0,0,12,0,0,12,0,0
"Cambodia","2024-08-17",0,0,12,0,0,12,0,0
"Cambodia","2024-08-18",0,0,12,0,0,12,0,0
"Cambodia","2024-08-19",0,0,12,0,0,12,0,0
"Cambodia","2024-08-20",0,0,12,0,0,12,0,0
"Cambodia","2024-08-21",0,0,12,0,0,12,0,0
"Cambodia","2024-08-22",0,0,12,0,0,12,0,0
"Cambodia","2024-08-23",0,0,12,0,0,12,0,0
"Cambodia","2024-08-24",0,0,12,0,0,12,0,0
"Cambodia","2024-08-25",0,0,12,0,0,12,0,0
"Cambodia","2024-08-26",0,0,12,0,0,12,0,0
"Cambodia","2024-08-27",0,0,12,0,0,12,0,0
"Cambodia","2024-08-28",0,0,12,0,0,12,0,0
"Cambodia","2024-08-29",0,0,12,0,0,12,0,0
"Cambodia","2024-08-30",0,0,12,0,0,12,0,0
"Cambodia","2024-08-31",0,0,12,0,0,12,0,0
"Cambodia","2024-09-01",0,0,12,0,0,12,0,0
"Cambodia","2024-09-02",0,0,12,0,0,12,0,0
"Cambodia","2024-09-03",0,0,12,0,0,12,0,0
"Cambodia","2024-09-04",0,0,12,0,0,12,0,0
"Cambodia","2024-09-05",0,0,12,0,0,12,0,0
"Cambodia","2024-09-06",0,0,12,0,0,12,0,0
"Cambodia","2024-09-07",0,0,12,0,0,12,0,0
"Cambodia","2024-09-08",0,0,12,0,0,12,0,0
"Cambodia","2024-09-09",0,0,12,0,0,12,0,0
"Cambodia","2024-09-10",0,0,12,0,0,12,0,0
"Cambodia","2024-09-11",0,0,12,0,0,12,0,0
"Cambodia","2024-09-12",0,0,12,0,0,12,0,0
"Cambodia","2024-09-13",0,0,12,0,0,12,0,0
"Cambodia","2024-09-14",0,0,12,0,0,12,0,0
"Cambodia","2024-09-15",0,0,12,0,0,12,0,0
"Cambodia","2024-09-16",0,0,12,0,0,12,0,0
"Cambodia","2024-09-17",0,0,12,0,0,12,0,0
"Cambodia","2024-09-18",0,0,12,0,0,12,0,0
"Cambodia","2024-09-19",0,0,12,0,0,12,0,0
"Cambodia","2024-09-20",0,0,12,0,0,12,0,0
"Cambodia","2024-09-21",0,0,12,0,0,12,0,0
"Cambodia","2024-09-22",0,0,12,0,0,12,0,0
"Cambodia","2024-09-23",0,0,12,0,0,12,0,0
"Cambodia","2024-09-24",0,0,12,0,0,12,0,0
"Cambodia","2024-09-25",0,0,12,0,0,12,0,0
"Cambodia","2024-09-26",0,0,12,0,0,12,0,0
"Cambodia","2024-09-27",0,0,12,0,0,12,0,0
"Cambodia","2024-09-28",0,0,12,0,0,12,0,0
"Cambodia","2024-09-29",0,0,12,0,0,12,0,0
"Cambodia","2024-09-30",0,0,12,0,0,12,0,0
"Cambodia","2024-10-01",0,0,12,0,0,12,0,0
"Cambodia","2024-10-02",0,0,12,0,0,12,0,0
"Cambodia","2024-10-03",0,0,12,0,0,12,0,0
"Cambodia","2024-10-04",0,0,12,0,0,12,0,0
"Cambodia","2024-10-05",0,0,12,0,0,12,0,0
"Cambodia","2024-10-06",0,0,12,0,0,12,0,0
"Cambodia","2024-10-07",0,0,12,0,0,12,0,0
"Cambodia","2024-10-08",0,0,12,0,0,12,0,0
"Cambodia","2024-10-09",0,0,12,0,0,12,0,0
"Cambodia","2024-10-10",0,0,12,0,0,12,0,0
"Cambodia","2024-10-11",0,0,12,0,0,12,0,0
"Cambodia","2024-10-12",0,0,12,0,0,12,0,0
"Cambodia","2024-10-13",0,0,12,0,0,12,0,0
"Cambodia","2024-10-14",0,0,12,0,0,12,0,0
"Cambodia","2024-10-15",0,0,12,0,0,12,0,0
"Cambodia","2024-10-16",0,0,12,0,0,12,0,0
"Cambodia","2024-10-17",0,0,12,0,0,12,0,0
"Cambodia","2024-10-18",0,0,12,0,0,12,0,0
"Cambodia","2024-10-19",0,0,12,0,0,12,0,0
"Cambodia","2024-10-20",0,0,12,0,0,12,0,0
"Cambodia","2024-10-21",0,0,12,0,0,12,0,0
"Cambodia","2024-10-22",0,0,12,0,0,12,0,0
"Cambodia","2024-10-23",0,0,12,0,0,12,0,0
"Cambodia","2024-10-24",0,0,12,0,0,12,0,0
"Cambodia","2024-10-25",0,0,12,0,0,12,0,0
"Cambodia","2024-10-26",0,0,12,0,0,12,0,0
"Cambodia","2024-10-27",0,0,12,0,0,12,0,0
"Cambodia","2024-10-28",0,0,12,0,0,12,0,0
"Cambodia","2024-10-29",0,0,12,0,0,12,0,0
"Cambodia","2024-10-30",0,0,12,0,0,12,0,0
"Cambodia","2024-10-31",0,0,12,0,0,12,0,0
"Cambodia","2024-11-01",0,0,12,0,0,12,0,0
"Cambodia","2024-11-02",0,0,12,0,0,12,0,0
"Cambodia","2024-11-03",0,0,12,0,0,12,0,0
"Cambodia","2024-11-04",0,0,12,0,0,12,0,0
"Cambodia","2024-11-05",0,0,12,0,0,12,0,0
"Cambodia","2024-11-06",0,0,12,0,0,12,0,0
"Cambodia","2024-11-07",0,0,12,0,0,12,0,0
"Cambodia","2024-11-08",0,0,12,0,0,12,0,0
"Cambodia","2024-11-09",0,0,12,0,0,12,0,0
"Cambodia","2024-11-10",0,0,12,0,0,12,0,0
"Cambodia","2024-11-11",0,0,12,0,0,12,0,0
"Cambodia","2024-11-12",0,0,12,0,0,12,0,0
"Cambodia","2024-11-13",0,0,12,0,0,12,0,0
"Cambodia","2024-11-14",0,0,12,0,0,12,0,0
"Cambodia","2024-11-15",0,0,12,0,0,12,0,0
"Cambodia","2024-11-16",0,0,12,0,0,12,0,0
"Cambodia","2024-11-17",0,0,12,0,0,12,0,0
"Cambodia","2024-11-18",0,0,12,0,0,12,0,0
"Cambodia","2024-11-19",0,0,12,0,0,12,0,0
"Cambodia","2024-11-20",0,0,12,0,0,12,0,0
"Cambodia","2024-11-21",0,0,12,0,0,12,0,0
"Cambodia","2024-11-22",0,0,12,0,0,12,0,0
"Cambodia","2024-11-23",0,0,12,0,0,12,0,0
"Cambodia","2024-11-24",0,0,12,0,0,12,0,0
"Cambodia","2024-11-25",0,0,12,0,0,12,0,0
"Cambodia","2024-11-26",0,0,12,0,0,12,0,0
"Cambodia","2024-11-27",0,0,12,0,0,12,0,0
"Cambodia","2024-11-28",0,0,12,0,0,12,0,0
"Cambodia","2024-11-29",0,0,12,0,0,12,0,0
"Cambodia","2024-11-30",0,0,12,0,0,12,0,0
"Cambodia","2024-12-01",0,0,12,0,0,12,0,0
"Cambodia","2024-12-02",0,0,12,0,0,12,0,0
"Cambodia","2024-12-03",0,0,12,0,0,12,0,0
"Cambodia","2024-12-04",0,0,12,0,0,12,0,0
"Cambodia","2024-12-05",0,0,12,0,0,12,0,0
"Cambodia","2024-12-06",0,0,12,0,0,12,0,0
"Cambodia","2024-12-07",0,0,12,0,0,12,0,0
"Cambodia","2024-12-08",0,0,12,0,0,12,0,0
"Cambodia","2024-12-09",0,0,12,0,0,12,0,0
"Cambodia","2024-12-10",0,0,12,0,0,12,0,0
"Cambodia","2024-12-11",0,0,12,0,0,12,0,0
"Cambodia","2024-12-12",0,0,12,0,0,12,0,0
"Cambodia","2024-12-13",0,0,12,0,0,12,0,0
"Cambodia","2024-12-14",0,0,12,0,0,12,0,0
"Cambodia","2024-12-15",0,0,12,0,0,12,0,0
"Cambodia","2024-12-16",0,0,12,0,0,12,0,0
"Cambodia","2024-12-17",0,0,12,0,0,12,0,0
"Cambodia","2024-12-18",0,0,12,0,0,12,0,0
"Cambodia","2024-12-19",0,0,12,0,0,12,0,0
"Cambodia","2024-12-20",0,0,12,0,0,12,0,0
"Cambodia","2024-12-21",0,0,12,0,0,12,0,0
"Cambodia","2024-12-22",0,0,12,0,0,12,0,0
"Cambodia","2024-12-23",0,0,12,0,0,12,0,0
"Cambodia","2024-12-24",0,0,12,0,0,12,0,0
"Cambodia","2024-12-25",0,0,12,0,0,12,0,0
"Cambodia","2024-12-26",0,0,12,0,0,12,0,0
"Cambodia","2024-12-27",0,0,12,0,0,12,0,0
"Cambodia","2024-12-28",0,0,12,0,0,12,0,0
"Cambodia","2024-12-29",0,0,12,0,0,12,0,0
"Cambodia","2024-12-30",0,0,12,0,0,12,0,0
"Cambodia","2024-12-31",0,0,12,0,0,12,0,0
"Cambodia","2025-01-01",0,0,12,0,0,12,0,0
"Cambodia","2025-01-02",0,0,12,0,0,12,0,0
"Cambodia","2025-01-03",0,0,12,0,0,12,0,0
"Cambodia","2025-01-04",0,0,12,0,0,12,0,0
"Cambodia","2025-01-05",0,0,12,0,0,12,0,0
"Cambodia","2025-01-06",0,0,12,0,0,12,0,0
"Cambodia","2025-01-07",0,0,12,0,0,12,0,0
"Cambodia","2025-01-08",0,0,12,0,0,12,0,0
"Cambodia","2025-01-09",0,0,12,0,0,12,0,0
"Cambodia","2025-01-10",0,0,12,0,0,12,0,0
"Cambodia","2025-01-11",0,0,12,0,0,12,0,0
"Cambodia","2025-01-12",0,0,12,0,0,12,0,0
"Cambodia","2025-01-13",0,0,12,0,0,12,0,0
"Cambodia","2025-01-14",0,0,12,0,0,12,0,0
"Cambodia","2025-01-15",0,0,12,0,0,12,0,0
"Cambodia","2025-01-16",0,0,12,0,0,12,0,0
"Cambodia","2025-01-17",0,0,12,0,0,12,0,0
"Cambodia","2025-01-18",0,0,12,0,0,12,0,0
"Cambodia","2025-01-19",0,0,12,0,0,12,0,0
"Cambodia","2025-01-20",0,0,12,0,0,12,0,0
"Cambodia","2025-01-21",0,0,12,0,0,12,0,0
"Cambodia","2025-01-22",0,0,12,0,0,12,0,0
"Cambodia","2025-01-23",0,0,12,0,0,12,0,0
"Cambodia","2025-01-24",0,0,12,0,0,12,0,0
"Cambodia","2025-01-25",0,0,12,0,0,12,0,0
"Cambodia","2025-01-26",0,0,12,0,0,12,0,0
"Cambodia","2025-01-27",0,0,12,0,0,12,0,0
"Cambodia","2025-01-28",0,0,12,0,0,12,0,0
"Cambodia","2025-01-29",0,0,12,0,0,12,0,0
"Cambodia","2025-01-30",0,0,12,0,0,12,0,0
"Cambodia","2025-01-31",0,0,12,0,0,12,0,0
"Cambodia","2025-02-01",0,0,12,0,0,12,0,0
"Cambodia","2025-02-02",0,0,12,0,0,12,0,0
"Cambodia","2025-02-03",0,0,12,0,0,12,0,0
"Cambodia","2025-02-04",0,0,12,0,0,12,0,0
"Cambodia","2025-02-05",0,0,12,0,0,12,0,0
"Cambodia","2025-02-06",0,0,12,0,0,12,0,0
"Cambodia","2025-02-07",0,0,12,0,0,12,0,0
"Cambodia","2025-02-08",0,0,12,0,0,12,0,0
"Cambodia","2025-02-09",0,0,12,0,0,12,0,0
"Cambodia","2025-02-10",0,0,12,0,0,12,0,0
"Cambodia","2025-02-11",0,0,12,0,0,12,0,0
"Cambodia","2025-02-12",0,0,12,0,0,12,0,0
"Cambodia","2025-02-13",0,0,12,0,0,12,0,0
"Cambodia","2025-02-14",0,0,12,0,0,12,0,0
"Cambodia","2025-02-15",0,0,12,0,0,12,0,0
"Cambodia","2025-02-16",0,0,12,0,0,12,0,0
"Cambodia","2025-02-17",0,0,12,0,0,12,0,0
"Cambodia","2025-02-18",0,0,12,0,0,12,0,0
"Cambodia","2025-02-19",0,0,12,0,0,12,0,0
"Cambodia","2025-02-20",0,0,12,0,0,12,0,0
"Cambodia","2025-02-21",0,0,12,0,0,12,0,0
"Cambodia","2025-02-22",0,0,12,0,0,12,0,0
"Cambodia","2025-02-23",0,0,12,0,0,12,0,0
"Cambodia","2025-02-24",0,0,12,0,0,12,0,0
"Cambodia","2025-02-25",0,0,12,0,0,12,0,0
"Cambodia","2025-02-26",0,0,12,0,0,12,0,0
"Cambodia","2025-02-27",0,0,12,0,0,12,0,0
"Cambodia","2025-02-28",0,0,12,0,0,12,0,0
"Cambodia","2025-03-01",0,0,12,0,0,12,0,0
"Cambodia","2025-03-02",0,0,12,0,0,12,0,0
"Cambodia","2025-03-03",0,0,12,0,0,12,0,0
"Cameroon","2024-01-01",0,0,0,0,0,0,0,0
"Cameroon","2024-01-02",0,0,0,0,0,0,0,0
"Cameroon","2024-01-03",0,0,0,0,0,0,0,0
"Cameroon","2024-01-04",0,0,0,0,0,0,0,0
"Cameroon","2024-01-05",0,0,0,0,0,0,0,0
"Cameroon","2024-01-06",0,0,0,0,0,0,0,0
"Cameroon","2024-01-07",0,0,0,0,0,0,0,0
"Cameroon","2024-01-08",0,0,0,0,0,0,0,0
"Cameroon","2024-01-09",0,0,0,0,0,0,0,0
"Cameroon","2024-01-10",0,0,0,0,0,0,0,0
"Cameroon","2024-01-11",0,0,0,0,0,0,0,0
"Cameroon","2024-01-12",0,0,0,0,0,0,0,0
"Cameroon","2024-01-13",0,0,0,0,0,0,0,0
"Cameroon","2024-01-14",0,2,2,0,2,2,0,0
"Cameroon","2024-01-15",0,0,2,0,0,2,0,0
"Cameroon","2024-01-16",0,0,2,0,0,2,0,0
"Cameroon","2024-01-17",0,0,2,0,0,2,0,0
"Cameroon","2024-01-18",0,0,2,0,0,2,0,0
"Cameroon","2024-01-19",0,0,2,0,0,2,0,0
"Cameroon","2024-01-20",0,0,2,0,0,2,0,0
"Cameroon","2024-01-21",0,0,2,0,0,2,0,0
"Cameroon","2024-01-22",0,0,2,0,0,2,0,0
"Cameroon","2024-01-23",0,0,2,0,0,2,0,0
"Cameroon","2024-01-24",0,0,2,0,0,2,0,0
"Cameroon","2024-01-25",0,0,2,0,0,2,0,0
"Cameroon","2024-01-26",0,0,2,0,0,2,0,0
"Cameroon","2024-01-27",0,0,2,0,0,2,0,0
"Cameroon","2024-01-28",0,0,2,0,0,2,0,0
"Cameroon","2024-01-29",0,0,2,0,0,2,0,0
"Cameroon","2024-01-30",0,0,2,0,0,2,0,0
"Cameroon","2024-01-31",0,0,2,0,0,2,0,0
"Cameroon","2024-02-01",0,0,2,0,0,2,0,0
"Cameroon","2024-02-02",0,0,2,0,0,2,0,0
"Cameroon","2024-02-03",0,0,2,0,0,2,0,0
"Cameroon","2024-02-04",0,0,2,0,0,2,0,0
"Cameroon","2024-02-05",0,0,2,0,0,2,0,0
"Cameroon","2024-02-06",0,0,2,0,0,2,0,0
"Cameroon","2024-02-07",0,0,2,0,0,2,0,0
"Cameroon","2024-02-08",0,0,2,0,0,2,0,0
"Cameroon","2024-02-09",0,0,2,0,0,2,0,0
"Cameroon","2024-02-10",0,0,2,0,0,2,0,0
"Cameroon","2024-02-11",0,0,2,0,0,2,0,0
"Cameroon","2024-02-12",0,0,2,0,0,2,0,0
"Cameroon","2024-02-13",0,0,2,0,0,2,0,0
"Cameroon","2024-02-14",0,0,2,0,0,2,0,0
"Cameroon","2024-02-15",0,0,2,0,0,2,0,0
"Cameroon","2024-02-16",0,0,2,0,0,2,0,0
"Cameroon","2024-02-17",0,0,2,0,0,2,0,0
"Cameroon","2024-02-18",0,0,2,0,0,2,0,0
"Cameroon","2024-02-19",0,0,2,0,0,2,0,0
"Cameroon","2024-02-20",0,0,2,0,0,2,0,0
"Cameroon","2024-02-21",0,0,2,0,0,2,0,0
"Cameroon","2024-02-22",0,0,2,0,0,2,0,0
"Cameroon","2024-02-23",0,0,2,0,0,2,0,0
"Cameroon","2024-02-24",0,0,2,0,0,2,0,0
"Cameroon","2024-02-25",0,0,2,0,0,2,0,0
"Cameroon","2024-02-26",0,0,2,0,1,3,0,0
"Cameroon","2024-02-27",0,0,2,0,0,3,0,0
"Cameroon","2024-02-28",0,0,2,0,0,3,0,0
"Cameroon","2024-02-29",0,0,2,0,0,3,0,0
"Cameroon","2024-03-01",0,0,2,0,0,3,0,0
"Cameroon","2024-03-02",0,0,2,0,0,3,0,0
"Cameroon","2024-03-03",0,0,2,0,0,3,0,0
"Cameroon","2024-03-04",0,0,2,0,0,3,0,0
"Cameroon","2024-03-05",0,0,2,0,0,3,0,0
"Cameroon","2024-03-06",0,0,2,0,0,3,0,0
"Cameroon","2024-03-07",0,0,2,0,0,3,0,0
"Cameroon","2024-03-08",0,0,2,0,0,3,0,0
"Cameroon","2024-03-09",0,0,2,0,0,3,0,0
"Cameroon","2024-03-10",0,0,2,0,0,3,0,0
"Cameroon","2024-03-11",0,0,2,0,0,3,0,0
"Cameroon","2024-03-12",0,0,2,0,0,3,0,0
"Cameroon","2024-03-13",0,0,2,0,0,3,0,0
"Cameroon","2024-03-14",0,0,2,0,0,3,0,0
"Cameroon","2024-03-15",0,0,2,0,0,3,0,0
"Cameroon","2024-03-16",0,0,2,0,0,3,0,0
"Cameroon","2024-03-17",0,0,2,0,0,3,0,0
"Cameroon","2024-03-18",0,0,2,0,0,3,0,0
"Cameroon","2024-03-19",0,0,2,0,0,3,0,0
"Cameroon","2024-03-20",0,0,2,0,0,3,0,0
"Cameroon","2024-03-21",0,0,2,0,0,3,0,0
"Cameroon","2024-03-22",0,0,2,0,0,3,0,0
"Cameroon","2024-03-23",0,0,2,0,0,3,0,0
"Cameroon","2024-03-24",0,0,2,0,0,3,0,0
"Cameroon","2024-03-25",0,0,2,0,0,3,0,0
"Cameroon","2024-03-26",0,0,2,0,0,3,0,0
"Cameroon","2024-03-27",0,0,2,0,0,3,0,0
"Cameroon","2024-03-28",0,0,2,0,0,3,0,0
"Cameroon","2024-03-29",0,0,2,0,0,3,0,0
"Cameroon","2024-03-30",0,0,2,0,0,3,0,0
"Cameroon","2024-03-31",0,0,2,0,0,3,0,0
"Cameroon","2024-04-01",0,0,2,0,0,3,0,0
"Cameroon","2024-04-02",0,0,2,0,0,3,0,0
"Cameroon","2024-04-03",0,0,2,0,0,3,0,0
"Cameroon","2024-04-04",0,0,2,0,0,3,0,0
"Cameroon","2024-04-05",0,0,2,0,0,3,0,0
"Cameroon","2024-04-06",0,0,2,0,0,3,0,0
"Cameroon","2024-04-07",0,1,3,0,0,3,0,0
"Cameroon","2024-04-08",0,0,3,0,0,3,0,0
"Cameroon","2024-04-09",0,0,3,0,1,4,0,0
"Cameroon","2024-04-10",0,0,3,0,0,4,0,0
"Cameroon","2024-04-11",0,0,3,0,0,4,0,0
"Cameroon","2024-04-12",0,0,3,0,0,4,0,0
"Cameroon","2024-04-13",0,0,3,0,1,5,0,0
"Cameroon","2024-04-14",0,2,5,0,0,5,0,0
"Cameroon","2024-04-15",0,0,5,0,0,5,0,0
"Cameroon","2024-04-16",0,0,5,0,0,5,0,0
"Cameroon","2024-04-17",0,0,5,0,0,5,0,0
"Cameroon","2024-04-18",0,0,5,0,0,5,0,0
"Cameroon","2024-04-19",0,0,5,0,0,5,0,0
"Cameroon","2024-04-20",0,0,5,0,0,5,0,0
"Cameroon","2024-04-21",0,0,5,0,0,5,0,0
"Cameroon","2024-04-22",0,0,5,0,0,5,0,0
"Cameroon","2024-04-23",0,0,5,0,0,5,0,0
"Cameroon","2024-04-24",0,0,5,0,0,5,0,0
"Cameroon","2024-04-25",0,0,5,0,0,5,0,0
"Cameroon","2024-04-26",0,0,5,0,0,5,0,0
"Cameroon","2024-04-27",0,0,5,0,0,5,0,0
"Cameroon","2024-04-28",0,0,5,0,0,5,0,0
"Cameroon","2024-04-29",0,0,5,0,0,5,0,0
"Cameroon","2024-04-30",0,0,5,0,0,5,0,0
"Cameroon","2024-05-01",0,0,5,0,0,5,0,0
"Cameroon","2024-05-02",0,0,5,0,0,5,0,0
"Cameroon","2024-05-03",0,0,5,0,0,5,0,0
"Cameroon","2024-05-04",0,0,5,0,0,5,0,0
"Cameroon","2024-05-05",0,0,5,0,0,5,0,0
"Cameroon","2024-05-06",0,0,5,0,0,5,0,0
"Cameroon","2024-05-07",0,0,5,0,0,5,0,0
"Cameroon","2024-05-08",0,0,5,0,0,5,0,0
"Cameroon","2024-05-09",0,0,5,0,0,5,0,0
"Cameroon","2024-05-10",0,0,5,0,0,5,0,0
"Cameroon","2024-05-11",0,0,5,0,0,5,0,0
"Cameroon","2024-05-12",0,0,5,0,0,5,0,0
"Cameroon","2024-05-13",0,0,5,0,0,5,0,0
"Cameroon","2024-05-14",0,0,5,0,0,5,0,0
"Cameroon","2024-05-15",0,0,5,0,0,5,0,0
"Cameroon","2024-05-16",0,0,5,0,0,5,0,0
"Cameroon","2024-05-17",0,0,5,0,0,5,0,0
"Cameroon","2024-05-18",0,0,5,0,0,5,0,0
"Cameroon","2024-05-19",0,0,5,0,0,5,0,0
"Cameroon","2024-05-20",0,0,5,0,0,5,0,0
"Cameroon","2024-05-21",0,0,5,0,0,5,0,0
"Cameroon","2024-05-22",0,0,5,0,0,5,0,0
"Cameroon","2024-05-23",0,0,5,0,0,5,0,0
"Cameroon","2024-05-24",0,0,5,0,0,5,0,0
"Cameroon","2024-05-25",0,0,5,0,0,5,0,0
"Cameroon","2024-05-26",0,0,5,0,0,5,0,0
"Cameroon","2024-05-27",0,0,5,0,0,5,0,0
"Cameroon","2024-05-28",0,0,5,0,0,5,0,0
"Cameroon","2024-05-29",0,0,5,0,0,5,0,0
"Cameroon","2024-05-30",0,0,5,0,0,5,0,0
"Cameroon","2024-05-31",0,0,5,0,0,5,0,0
"Cameroon","2024-06-01",0,0,5,0,0,5,0,0
"Cameroon","2024-06-02",0,0,5,0,0,5,0,0
"Cameroon","2024-06-03",0,0,5,0,0,5,0,0
"Cameroon","2024-06-04",0,0,5,0,0,5,0,0
"Cameroon","2024-06-05",0,0,5,0,0,5,0,0
"Cameroon","2024-06-06",0,0,5,0,0,5,0,0
"Cameroon","2024-06-07",0,0,5,0,0,5,0,0
"Cameroon","2024-06-08",0,0,5,0,0,5,0,0
"Cameroon","2024-06-09",0,0,5,0,0,5,0,0
"Cameroon","2024-06-10",0,0,5,0,0,5,0,0
"Cameroon","2024-06-11",0,0,5,0,0,5,0,0
"Cameroon","2024-06-12",0,0,5,0,0,5,0,0
"Cameroon","2024-06-13",0,0,5,0,0,5,0,0
"Cameroon","2024-06-14",0,0,5,0,0,5,0,0
"Cameroon","2024-06-15",0,0,5,0,0,5,0,0
"Cameroon","2024-06-16",0,0,5,0,0,5,0,0
"Cameroon","2024-06-17",0,0,5,0,0,5,0,0
"Cameroon","2024-06-18",0,0,5,0,0,5,0,0
"Cameroon","2024-06-19",0,0,5,0,0,5,0,0
"Cameroon","2024-06-20",0,0,5,0,0,5,0,0
"Cameroon","2024-06-21",0,0,5,0,0,5,0,0
"Cameroon","2024-06-22",0,0,5,0,0,5,0,0
"Cameroon","2024-06-23",0,0,5,0,0,5,0,0
"Cameroon","2024-06-24",0,0,5,0,1,6,0,0
"Cameroon","2024-06-25",0,0,5,0,0,6,0,0
"Cameroon","2024-06-26",0,0,5,0,0,6,0,0
"Cameroon","2024-06-27",0,0,5,0,0,6,0,0
"Cameroon","2024-06-28",0,0,5,0,0,6,0,0
"Cameroon","2024-06-29",0,0,5,0,0,6,0,0
"Cameroon","2024-06-30",0,0,5,0,0,6,0,0
"Cameroon","2024-07-01",0,0,5,0,0,6,0,0
"Cameroon","2024-07-02",0,0,5,0,0,6,0,0
"Cameroon","2024-07-03",0,0,5,0,0,6,0,0
"Cameroon","2024-07-04",0,0,5,0,0,6,0,0
"Cameroon","2024-07-05",0,0,5,0,0,6,0,0
"Cameroon","2024-07-06",0,0,5,0,0,6,0,0
"Cameroon","2024-07-07",0,0,5,0,0,6,0,0
"Cameroon","2024-07-08",0,0,5,0,0,6,0,0
"Cameroon","2024-07-09",0,0,5,0,0,6,0,0
"Cameroon","2024-07-10",0,0,5,0,0,6,0,0
"Cameroon","2024-07-11",0,0,5,0,0,6,0,0
"Cameroon","2024-07-12",0,0,5,0,0,6,0,0
"Cameroon","2024-07-13",0,0,5,0,0,6,0,0
"Cameroon","2024-07-14",0,0,5,0,0,6,0,0
"Cameroon","2024-07-15",0,0,5,0,0,6,0,0
"Cameroon","2024-07-16",0,0,5,0,0,6,0,0
"Cameroon","2024-07-17",0,0,5,0,0,6,0,0
"Cameroon","2024-07-18",0,0,5,0,0,6,0,0
"Cameroon","2024-07-19",0,0,5,0,0,6,0,0
"Cameroon","2024-07-20",0,0,5,0,0,6,0,0
"Cameroon","2024-07-21",0,0,5,0,0,6,0,0
"Cameroon","2024-07-22",0,0,5,0,0,6,0,0
"Cameroon","2024-07-23",0,0,5,0,0,6,0,0
"Cameroon","2024-07-24",0,0,5,0,0,6,0,0
"Cameroon","2024-07-25",0,0,5,0,0,6,0,0
"Cameroon","2024-07-26",0,0,5,0,0,6,0,0
"Cameroon","2024-07-27",0,0,5,0,0,6,0,0
"Cameroon","2024-07-28",0,0,5,0,0,6,0,0
"Cameroon","2024-07-29",0,0,5,0,0,6,0,0
"Cameroon","2024-07-30",0,0,5,0,0,6,0,0
"Cameroon","2024-07-31",0,0,5,0,0,6,0,0
"Cameroon","2024-08-01",0,0,5,0,0,6,0,0
"Cameroon","2024-08-02",0,0,5,0,0,6,0,0
"Cameroon","2024-08-03",0,0,5,0,0,6,0,0
"Cameroon","2024-08-04",0,0,5,0,0,6,0,0
"Cameroon","2024-08-05",0,0,5,0,0,6,0,0
"Cameroon","2024-08-06",0,0,5,0,0,6,0,0
"Cameroon","2024-08-07",0,0,5,0,0,6,0,0
"Cameroon","2024-08-08",0,0,5,0,0,6,0,0
"Cameroon","2024-08-09",0,0,5,0,0,6,0,0
"Cameroon","2024-08-10",0,0,5,0,0,6,0,0
"Cameroon","2024-08-11",0,0,5,0,0,6,0,0
"Cameroon","2024-08-12",0,0,5,0,0,6,0,0
"Cameroon","2024-08-13",0,0,5,0,0,6,0,0
"Cameroon","2024-08-14",0,0,5,0,0,6,0,0
"Cameroon","2024-08-15",0,0,5,0,0,6,0,0
"Cameroon","2024-08-16",30,0,5,30,0,6,30,30
"Cameroon","2024-08-17",0,0,5,30,0,6,0,30
"Cameroon","2024-08-18",0,0,5,30,0,6,1,31
"Cameroon","2024-08-19",0,0,5,30,0,6,0,31
"Cameroon","2024-08-20",0,0,5,30,0,6,0,31
"Cameroon","2024-08-21",0,0,5,30,0,6,1,32
"Cameroon","2024-08-22",0,0,5,30,0,6,0,32
"Cameroon","2024-08-23",0,0,5,30,0,6,0,32
"Cameroon","2024-08-24",0,0,5,30,0,6,0,32
"Cameroon","2024-08-25",0,0,5,30,0,6,1,33
"Cameroon","2024-08-26",0,0,5,30,0,6,0,33
"Cameroon","2024-08-27",0,0,5,30,0,6,0,33
"Cameroon","2024-08-28",0,0,5,30,0,6,1,34
"Cameroon","2024-08-29",0,0,5,30,0,6,0,34
"Cameroon","2024-08-30",0,0,5,30,0,6,0,34
"Cameroon","2024-08-31",0,0,5,30,0,6,1,35
"Cameroon","2024-09-01",0,1,6,30,0,6,0,35
"Cameroon","2024-09-02",0,0,6,30,0,6,0,35
"Cameroon","2024-09-03",0,0,6,30,0,6,0,35
"Cameroon","2024-09-04",0,0,6,30,0,6,1,36
"Cameroon","2024-09-05",0,0,6,30,0,6,0,36
"Cameroon","2024-09-06",0,0,6,30,0,6,0,36
"Cameroon","2024-09-07",0,0,6,30,0,6,1,37
"Cameroon","2024-09-08",7,0,6,37,0,6,0,37
"Cameroon","2024-09-09",0,0,6,37,0,6,1,38
"Cameroon","2024-09-10",0,0,6,37,0,6,1,39
"Cameroon","2024-09-11",0,0,6,37,0,6,0,39
"Cameroon","2024-09-12",3,0,6,40,0,6,1,40
"Cameroon","2024-09-13",0,0,6,40,0,6,2,42
"Cameroon","2024-09-14",0,0,6,40,1,7,2,44
"Cameroon","2024-09-15",0,0,6,40,0,7,2,46
"Cameroon","2024-09-16",0,0,6,40,0,7,2,48
"Cameroon","2024-09-17",0,0,6,40,0,7,2,50
"Cameroon","2024-09-18",0,0,6,40,0,7,2,52
"Cameroon","2024-09-19",0,0,6,40,0,7,2,54
"Cameroon","2024-09-20",0,0,6,40,0,7,2,56
"Cameroon","2024-09-21",0,0,6,40,0,7,2,58
"Cameroon","2024-09-22",0,0,6,40,0,7,1,59
"Cameroon","2024-09-23",0,0,6,40,0,7,2,61
"Cameroon","2024-09-24",0,0,6,40,0,7,2,63
"Cameroon","2024-09-25",0,0,6,40,0,7,2,65
"Cameroon","2024-09-26",0,0,6,40,0,7,2,67
"Cameroon","2024-09-27",0,0,6,40,0,7,2,69
"Cameroon","2024-09-28",0,0,6,40,0,7,2,71
"Cameroon","2024-09-29",0,0,6,40,0,7,2,73
"Cameroon","2024-09-30",35,0,6,75,0,7,2,75
"Cameroon","2024-10-01",0,0,6,75,0,7,1,76
"Cameroon","2024-10-02",0,0,6,75,0,7,2,78
"Cameroon","2024-10-03",0,0,6,75,0,7,1,79
"Cameroon","2024-10-04",0,0,6,75,0,7,1,80
"Cameroon","2024-10-05",0,0,6,75,0,7,2,82
"Cameroon","2024-10-06",8,0,6,83,0,7,1,83
"Cameroon","2024-10-07",0,0,6,83,0,7,2,85
"Cameroon","2024-10-08",0,0,6,83,0,7,1,86
"Cameroon","2024-10-09",0,0,6,83,0,7,1,87
"Cameroon","2024-10-10",0,0,6,83,1,8,2,89
"Cameroon","2024-10-11",0,0,6,83,0,8,2,91
"Cameroon","2024-10-12",9,0,6,92,0,8,1,92
"Cameroon","2024-10-13",2,0,6,94,0,8,2,94
"Cameroon","2024-10-14",0,0,6,94,0,8,0,94
"Cameroon","2024-10-15",0,0,6,94,0,8,1,95
"Cameroon","2024-10-16",0,0,6,94,0,8,0,95
"Cameroon","2024-10-17",0,0,6,94,0,8,1,96
"Cameroon","2024-10-18",0,0,6,94,0,8,0,96
"Cameroon","2024-10-19",0,0,6,94,0,8,1,97
"Cameroon","2024-10-20",3,0,6,97,0,8,0,97
"Cameroon","2024-10-21",0,0,6,97,0,8,0,97
"Cameroon","2024-10-22",0,0,6,97,0,8,1,98
"Cameroon","2024-10-23",0,0,6,97,0,8,0,98
"Cameroon","2024-10-24",0,0,6,97,0,8,0,98
"Cameroon","2024-10-25",0,0,6,97,0,8,0,98
"Cameroon","2024-10-26",0,0,6,97,0,8,1,99
"Cameroon","2024-10-27",2,0,6,99,0,8,0,99
"Cameroon","2024-10-28",0,0,6,99,0,8,1,100
"Cameroon","2024-10-29",0,0,6,99,0,8,0,100
"Cameroon","2024-10-30",0,0,6,99,0,8,1,101
"Cameroon","2024-10-31",0,0,6,99,0,8,0,101
"Cameroon","2024-11-01",0,0,6,99,0,8,1,102
"Cameroon","2024-11-02",0,0,6,99,0,8,0,102
"Cameroon","2024-11-03",4,0,6,103,0,8,1,103
"Cameroon","2024-11-04",0,0,6,103,0,8,0,103
"Cameroon","2024-11-05",0,0,6,103,1,9,0,103
"Cameroon","2024-11-06",0,0,6,103,0,9,0,103
"Cameroon","2024-11-07",0,0,6,103,0,9,0,103
"Cameroon","2024-11-08",0,0,6,103,0,9,0,103
"Cameroon","2024-11-09",0,0,6,103,0,9,0,103
"Cameroon","2024-11-10",0,0,6,103,0,9,0,103
"Cameroon","2024-11-11",0,0,6,103,0,9,0,103
"Cameroon","2024-11-12",0,0,6,103,0,9,0,103
"Cameroon","2024-11-13",0,0,6,103,0,9,0,103
"Cameroon","2024-11-14",0,0,6,103,0,9,0,103
"Cameroon","2024-11-15",0,0,6,103,0,9,0,103
"Cameroon","2024-11-16",0,0,6,103,0,9,0,103
"Cameroon","2024-11-17",0,3,9,103,0,9,0,103
"Cameroon","2024-11-18",0,0,9,103,0,9,0,103
"Cameroon","2024-11-19",0,0,9,103,0,9,0,103
"Cameroon","2024-11-20",0,0,9,103,0,9,0,103
"Cameroon","2024-11-21",0,0,9,103,0,9,0,103
"Cameroon","2024-11-22",0,0,9,103,0,9,0,103
"Cameroon","2024-11-23",0,0,9,103,0,9,0,103
"Cameroon","2024-11-24",0,0,9,103,0,9,0,103
"Cameroon","2024-11-25",0,0,9,103,0,9,0,103
"Cameroon","2024-11-26",0,0,9,103,0,9,0,103
"Cameroon","2024-11-27",0,0,9,103,0,9,0,103
"Cameroon","2024-11-28",0,0,9,103,0,9,0,103
"Cameroon","2024-11-29",0,0,9,103,0,9,0,103
"Cameroon","2024-11-30",0,0,9,103,0,9,0,103
"Cameroon","2024-12-01",0,0,9,103,0,9,0,103
"Cameroon","2024-12-02",0,0,9,103,0,9,0,103
"Cameroon","2024-12-03",0,0,9,103,0,9,0,103
"Cameroon","2024-12-04",0,0,9,103,0,9,0,103
"Cameroon","2024-12-05",0,0,9,103,0,9,0,103
"Cameroon","2024-12-06",0,0,9,103,0,9,0,103
"Cameroon","2024-12-07",0,0,9,103,0,9,0,103
"Cameroon","2024-12-08",0,0,9,103,0,9,0,103
"Cameroon","2024-12-09",0,0,9,103,0,9,0,103
"Cameroon","2024-12-10",0,0,9,103,0,9,0,103
"Cameroon","2024-12-11",0,0,9,103,0,9,0,103
"Cameroon","2024-12-12",0,0,9,103,0,9,0,103
"Cameroon","2024-12-13",0,0,9,103,0,9,0,103
"Cameroon","2024-12-14",0,0,9,103,0,9,0,103
"Cameroon","2024-12-15",0,0,9,103,0,9,0,103
"Cameroon","2024-12-16",0,0,9,103,0,9,0,103
"Cameroon","2024-12-17",0,0,9,103,0,9,0,103
"Cameroon","2024-12-18",0,0,9,103,0,9,0,103
"Cameroon","2024-12-19",0,0,9,103,0,9,0,103
"Cameroon","2024-12-20",0,0,9,103,0,9,0,103
"Cameroon","2024-12-21",0,0,9,103,0,9,0,103
"Cameroon","2024-12-22",0,0,9,103,0,9,0,103
"Cameroon","2024-12-23",0,0,9,103,0,9,0,103
"Cameroon","2024-12-24",0,0,9,103,0,9,0,103
"Cameroon","2024-12-25",0,0,9,103,0,9,0,103
"Cameroon","2024-12-26",0,0,9,103,0,9,0,103
"Cameroon","2024-12-27",0,0,9,103,0,9,0,103
"Cameroon","2024-12-28",0,0,9,103,0,9,0,103
"Cameroon","2024-12-29",0,0,9,103,0,9,0,103
"Cameroon","2024-12-30",0,0,9,103,0,9,0,103
"Cameroon","2024-12-31",0,0,9,103,0,9,0,103
"Cameroon","2025-01-01",0,0,9,103,0,9,0,103
"Cameroon","2025-01-02",0,0,9,103,0,9,0,103
"Cameroon","2025-01-03",0,0,9,103,0,9,0,103
"Cameroon","2025-01-04",0,0,9,103,0,9,0,103
"Cameroon","2025-01-05",0,0,9,103,0,9,0,103
"Cameroon","2025-01-06",0,0,9,103,0,9,0,103
"Cameroon","2025-01-07",0,0,9,103,0,9,0,103
"Cameroon","2025-01-08",0,0,9,103,0,9,0,103
"Cameroon","2025-01-09",0,0,9,103,0,9,0,103
"Cameroon","2025-01-10",0,0,9,103,0,9,0,103
"Cameroon","2025-01-11",0,0,9,103,0,9,0,103
"Cameroon","2025-01-12",0,0,9,103,0,9,0,103
"Cameroon","2025-01-13",0,0,9,103,0,9,0,103
"Cameroon","2025-01-14",0,0,9,103,0,9,0,103
"Cameroon","2025-01-15",0,0,9,103,0,9,0,103
"Cameroon","2025-01-16",0,0,9,103,0,9,0,103
"Cameroon","2025-01-17",0,0,9,103,0,9,0,103
"Cameroon","2025-01-18",0,0,9,103,0,9,0,103
"Cameroon","2025-01-19",0,0,9,103,0,9,0,103
"Cameroon","2025-01-20",0,0,9,103,0,9,0,103
"Cameroon","2025-01-21",0,0,9,103,0,9,0,103
"Cameroon","2025-01-22",0,0,9,103,0,9,0,103
"Cameroon","2025-01-23",0,0,9,103,0,9,0,103
"Cameroon","2025-01-24",0,0,9,103,0,9,0,103
"Cameroon","2025-01-25",0,0,9,103,0,9,0,103
"Cameroon","2025-01-26",0,0,9,103,0,9,0,103
"Cameroon","2025-01-27",0,0,9,103,0,9,0,103
"Cameroon","2025-01-28",0,0,9,103,0,9,0,103
"Cameroon","2025-01-29",0,0,9,103,0,9,0,103
"Cameroon","2025-01-30",0,0,9,103,0,9,0,103
"Cameroon","2025-01-31",0,0,9,103,0,9,0,103
"Cameroon","2025-02-01",0,0,9,103,0,9,0,103
"Cameroon","2025-02-02",0,0,9,103,0,9,0,103
"Cameroon","2025-02-03",0,0,9,103,0,9,0,103
"Cameroon","2025-02-04",0,0,9,103,0,9,0,103
"Cameroon","2025-02-05",0,0,9,103,0,9,0,103
"Cameroon","2025-02-06",0,0,9,103,0,9,0,103
"Cameroon","2025-02-07",0,0,9,103,0,9,0,103
"Cameroon","2025-02-08",0,0,9,103,0,9,0,103
"Cameroon","2025-02-09",0,0,9,103,0,9,0,103
"Cameroon","2025-02-10",0,0,9,103,0,9,0,103
"Cameroon","2025-02-11",0,0,9,103,0,9,0,103
"Cameroon","2025-02-12",0,0,9,103,0,9,0,103
"Cameroon","2025-02-13",0,0,9,103,0,9,0,103
"Cameroon","2025-02-14",0,0,9,103,0,9,0,103
"Cameroon","2025-02-15",0,0,9,103,0,9,0,103
"Cameroon","2025-02-16",0,0,9,103,0,9,0,103
"Cameroon","2025-02-17",0,0,9,103,0,9,0,103
"Cameroon","2025-02-18",0,0,9,103,0,9,0,103
"Cameroon","2025-02-19",0,0,9,103,0,9,0,103
"Cameroon","2025-02-20",0,0,9,103,0,9,0,103
"Cameroon","2025-02-21",0,0,9,103,0,9,0,103
"Cameroon","2025-02-22",0,0,9,103,0,9,0,103
"Cameroon","2025-02-23",0,0,9,103,0,9,0,103
"Cameroon","2025-02-24",0,0,9,103,0,9,0,103
"Cameroon","2025-02-25",0,0,9,103,0,9,0,103
"Cameroon","2025-02-26",0,0,9,103,0,9,0,103
"Cameroon","2025-02-27",0,0,9,103,0,9,0,103
"Cameroon","2025-02-28",0,0,9,103,0,9,0,103
"Cameroon","2025-03-01",0,0,9,103,0,9,0,103
"Cameroon","2025-03-02",0,0,9,103,0,9,0,103
"Cameroon","2025-03-03",0,0,9,103,0,9,0,103
"Canada","2024-01-01",0,0,0,0,0,0,0,0
"Canada","2024-01-02",0,0,0,0,0,0,0,0
"Canada","2024-01-03",0,0,0,0,0,0,0,0
"Canada","2024-01-04",0,0,0,0,0,0,0,0
"Canada","2024-01-05",0,0,0,0,0,0,0,0
"Canada","2024-01-06",0,0,0,0,0,0,0,0
"Canada","2024-01-07",0,0,0,0,0,0,0,0
"Canada","2024-01-08",0,0,0,0,0,0,0,0
"Canada","2024-01-09",0,1,1,0,1,1,0,0
"Canada","2024-01-10",0,0,1,0,0,1,0,0
"Canada","2024-01-11",0,0,1,0,0,1,0,0
"Canada","2024-01-12",0,0,1,0,1,2,0,0
"Canada","2024-01-13",0,0,1,0,0,2,0,0
"Canada","2024-01-14",0,0,1,0,0,2,0,0
"Canada","2024-01-15",0,0,1,0,0,2,0,0
"Canada","2024-01-16",0,0,1,0,1,3,0,0
"Canada","2024-01-17",0,0,1,0,0,3,0,0
"Canada","2024-01-18",0,0,1,0,0,3,0,0
"Canada","2024-01-19",0,0,1,0,0,3,0,0
"Canada","2024-01-20",0,0,1,0,0,3,0,0
"Canada","2024-01-21",0,0,1,0,1,4,0,0
"Canada","2024-01-22",0,0,1,0,0,4,0,0
"Canada","2024-01-23",0,3,4,0,0,4,0,0
"Canada","2024-01-24",0,0,4,0,1,5,0,0
"Canada","2024-01-25",0,0,4,0,0,5,0,0
"Canada","2024-01-26",0,0,4,0,1,6,0,0
"Canada","2024-01-27",0,0,4,0,0,6,0,0
"Canada","2024-01-28",0,0,4,0,1,7,0,0
"Canada","2024-01-29",0,0,4,0,0,7,0,0
"Canada","2024-01-30",0,4,8,0,1,8,0,0
"Canada","2024-01-31",0,0,8,0,1,9,0,0
"Canada","2024-02-01",0,0,8,0,1,10,0,0
"Canada","2024-02-02",0,0,8,0,1,11,0,0
"Canada","2024-02-03",0,0,8,0,1,12,0,0
"Canada","2024-02-04",0,0,8,0,1,13,0,0
"Canada","2024-02-05",0,0,8,0,1,14,0,0
"Canada","2024-02-06",0,7,15,0,1,15,0,0
"Canada","2024-02-07",0,0,15,0,1,16,0,0
"Canada","2024-02-08",0,0,15,0,1,17,0,0
"Canada","2024-02-09",0,0,15,0,1,18,0,0
"Canada","2024-02-10",0,0,15,0,2,20,0,0
"Canada","2024-02-11",0,0,15,0,1,21,0,0
"Canada","2024-02-12",0,0,15,0,1,22,0,0
"Canada","2024-02-13",0,8,23,0,1,23,0,0
"Canada","2024-02-14",0,0,23,0,1,24,0,0
"Canada","2024-02-15",0,0,23,0,1,25,0,0
"Canada","2024-02-16",0,0,23,0,1,26,0,0
"Canada","2024-02-17",0,0,23,0,2,28,0,0
"Canada","2024-02-18",0,0,23,0,1,29,0,0
"Canada","2024-02-19",0,0,23,0,1,30,0,0
"Canada","2024-02-20",0,8,31,0,1,31,0,0
"Canada","2024-02-21",0,0,31,0,0,31,0,0
"Canada","2024-02-22",0,0,31,0,0,31,0,0
"Canada","2024-02-23",0,0,31,0,0,31,0,0
"Canada","2024-02-24",0,0,31,0,1,32,0,0
"Canada","2024-02-25",0,0,31,0,0,32,0,0
"Canada","2024-02-26",0,0,31,0,0,32,0,0
"Canada","2024-02-27",0,1,32,0,0,32,0,0
"Canada","2024-02-28",0,0,32,0,1,33,0,0
"Canada","2024-02-29",0,0,32,0,1,34,0,0
"Canada","2024-03-01",0,0,32,0,1,35,0,0
"Canada","2024-03-02",0,0,32,0,0,35,0,0
"Canada","2024-03-03",0,0,32,0,1,36,0,0
"Canada","2024-03-04",0,0,32,0,1,37,0,0
"Canada","2024-03-05",0,6,38,0,1,38,0,0
"Canada","2024-03-06",0,0,38,0,0,38,0,0
"Canada","2024-03-07",0,0,38,0,0,38,0,0
"Canada","2024-03-08",0,0,38,0,0,38,0,0
"Canada","2024-03-09",0,0,38,0,1,39,0,0
"Canada","2024-03-10",0,0,38,0,0,39,0,0
"Canada","2024-03-11",0,0,38,0,0,39,0,0
"Canada","2024-03-12",0,0,38,0,0,39,0,0
"Canada","2024-03-13",0,0,38,0,0,39,0,0
"Canada","2024-03-14",0,0,38,0,0,39,0,0
"Canada","2024-03-15",0,0,38,0,0,39,0,0
"Canada","2024-03-16",0,0,38,0,1,40,0,0
"Canada","2024-03-17",0,0,38,0,0,40,0,0
"Canada","2024-03-18",0,0,38,0,0,40,0,0
"Canada","2024-03-19",0,2,40,0,0,40,0,0
"Canada","2024-03-20",0,0,40,0,1,41,0,0
"Canada","2024-03-21",0,0,40,0,0,41,0,0
"Canada","2024-03-22",0,0,40,0,1,42,0,0
"Canada","2024-03-23",0,0,40,0,0,42,0,0
"Canada","2024-03-24",0,0,40,0,1,43,0,0
"Canada","2024-03-25",0,0,40,0,0,43,0,0
"Canada","2024-03-26",0,4,44,0,1,44,0,0
"Canada","2024-03-27",0,0,44,0,1,45,0,0
"Canada","2024-03-28",0,0,44,0,0,45,0,0
"Canada","2024-03-29",0,0,44,0,1,46,0,0
"Canada","2024-03-30",0,0,44,0,0,46,0,0
"Canada","2024-03-31",0,0,44,0,1,47,0,0
"Canada","2024-04-01",0,0,44,0,0,47,0,0
"Canada","2024-04-02",0,4,48,0,1,48,0,0
"Canada","2024-04-03",0,0,48,0,1,49,0,0
"Canada","2024-04-04",0,0,48,0,0,49,0,0
"Canada","2024-04-05",0,0,48,0,1,50,0,0
"Canada","2024-04-06",0,0,48,0,0,50,0,0
"Canada","2024-04-07",0,0,48,0,1,51,0,0
"Canada","2024-04-08",0,0,48,0,0,51,0,0
"Canada","2024-04-09",0,4,52,0,1,52,0,0
"Canada","2024-04-10",0,0,52,0,0,52,0,0
"Canada","2024-04-11",0,0,52,0,1,53,0,0
"Canada","2024-04-12",0,0,52,0,0,53,0,0
"Canada","2024-04-13",0,0,52,0,1,54,0,0
"Canada","2024-04-14",0,0,52,0,0,54,0,0
"Canada","2024-04-15",0,0,52,0,1,55,0,0
"Canada","2024-04-16",0,3,55,0,0,55,0,0
"Canada","2024-04-17",0,0,55,0,0,55,0,0
"Canada","2024-04-18",0,0,55,0,0,55,0,0
"Canada","2024-04-19",0,0,55,0,0,55,0,0
"Canada","2024-04-20",0,0,55,0,1,56,0,0
"Canada","2024-04-21",0,0,55,0,0,56,0,0
"Canada","2024-04-22",0,0,55,0,0,56,0,0
"Canada","2024-04-23",0,1,56,0,0,56,0,0
"Canada","2024-04-24",0,0,56,0,0,56,0,0
"Canada","2024-04-25",0,0,56,0,1,57,0,0
"Canada","2024-04-26",0,0,56,0,0,57,0,0
"Canada","2024-04-27",0,0,56,0,0,57,0,0
"Canada","2024-04-28",0,0,56,0,0,57,0,0
"Canada","2024-04-29",0,0,56,0,1,58,0,0
"Canada","2024-04-30",0,2,58,0,0,58,0,0
"Canada","2024-05-01",0,0,58,0,1,59,0,0
"Canada","2024-05-02",0,0,58,0,0,59,0,0
"Canada","2024-05-03",0,0,58,0,1,60,0,0
"Canada","2024-05-04",0,0,58,0,0,60,0,0
"Canada","2024-05-05",0,0,58,0,1,61,0,0
"Canada","2024-05-06",0,0,58,0,0,61,0,0
"Canada","2024-05-07",0,4,62,0,1,62,0,0
"Canada","2024-05-08",0,0,62,0,1,63,0,0
"Canada","2024-05-09",0,0,62,0,1,64,0,0
"Canada","2024-05-10",0,0,62,0,1,65,0,0
"Canada","2024-05-11",0,0,62,0,2,67,0,0
"Canada","2024-05-12",0,0,62,0,1,68,0,0
"Canada","2024-05-13",0,0,62,0,1,69,0,0
"Canada","2024-05-14",0,8,70,0,1,70,0,0
"Canada","2024-05-15",0,0,70,0,0,70,0,0
"Canada","2024-05-16",0,0,70,0,1,71,0,0
"Canada","2024-05-17",0,0,70,0,0,71,0,0
"Canada","2024-05-18",0,0,70,0,1,72,0,0
"Canada","2024-05-19",0,0,70,0,0,72,0,0
"Canada","2024-05-20",0,0,70,0,1,73,0,0
"Canada","2024-05-21",0,3,73,0,0,73,0,0
"Canada","2024-05-22",0,0,73,0,1,74,0,0
"Canada","2024-05-23",0,0,73,0,1,75,0,0
"Canada","2024-05-24",0,0,73,0,1,76,0,0
"Canada","2024-05-25",0,0,73,0,1,77,0,0
"Canada","2024-05-26",0,0,73,0,1,78,0,0
"Canada","2024-05-27",0,0,73,0,1,79,0,0
"Canada","2024-05-28",0,7,80,0,1,80,0,0
"Canada","2024-05-29",0,0,80,0,1,81,0,0
"Canada","2024-05-30",0,0,80,0,1,82,0,0
"Canada","2024-05-31",0,0,80,0,1,83,0,0
"Canada","2024-06-01",0,0,80,0,2,85,0,0
"Canada","2024-06-02",0,0,80,0,1,86,0,0
"Canada","2024-06-03",0,0,80,0,1,87,0,0
"Canada","2024-06-04",0,8,88,0,1,88,0,0
"Canada","2024-06-05",0,0,88,0,1,89,0,0
"Canada","2024-06-06",0,0,88,0,1,90,0,0
"Canada","2024-06-07",0,0,88,0,1,91,0,0
"Canada","2024-06-08",0,0,88,0,2,93,0,0
"Canada","2024-06-09",0,0,88,0,1,94,0,0
"Canada","2024-06-10",0,0,88,0,1,95,0,0
"Canada","2024-06-11",0,8,96,0,1,96,0,0
"Canada","2024-06-12",0,0,96,0,0,96,0,0
"Canada","2024-06-13",0,0,96,0,1,97,0,0
"Canada","2024-06-14",0,0,96,0,0,97,0,0
"Canada","2024-06-15",0,0,96,0,0,97,0,0
"Canada","2024-06-16",0,0,96,0,0,97,0,0
"Canada","2024-06-17",0,0,96,0,1,98,0,0
"Canada","2024-06-18",0,2,98,0,0,98,0,0
"Canada","2024-06-19",0,0,98,0,2,100,0,0
"Canada","2024-06-20",0,0,98,0,1,101,0,0
"Canada","2024-06-21",0,0,98,0,2,103,0,0
"Canada","2024-06-22",0,0,98,0,1,104,0,0
"Canada","2024-06-23",0,0,98,0,2,106,0,0
"Canada","2024-06-24",0,0,98,0,1,107,0,0
"Canada","2024-06-25",0,11,109,0,2,109,0,0
"Canada","2024-06-26",0,0,109,0,2,111,0,0
"Canada","2024-06-27",0,0,109,0,1,112,0,0
"Canada","2024-06-28",0,0,109,0,2,114,0,0
"Canada","2024-06-29",0,0,109,0,2,116,0,0
"Canada","2024-06-30",0,0,109,0,2,118,0,0
"Canada","2024-07-01",0,0,109,0,1,119,0,0
"Canada","2024-07-02",0,12,121,0,2,121,0,0
"Canada","2024-07-03",0,0,121,0,2,123,0,0
"Canada","2024-07-04",0,0,121,0,1,124,0,0
"Canada","2024-07-05",0,0,121,0,2,126,0,0
"Canada","2024-07-06",0,0,121,0,1,127,0,0
"Canada","2024-07-07",0,0,121,0,2,129,0,0
"Canada","2024-07-08",0,0,121,0,1,130,0,0
"Canada","2024-07-09",0,11,132,0,2,132,0,0
"Canada","2024-07-10",0,0,132,0,2,134,0,0
"Canada","2024-07-11",0,0,132,0,2,136,0,0
"Canada","2024-07-12",0,0,132,0,2,138,0,0
"Canada","2024-07-13",0,0,132,0,2,140,0,0
"Canada","2024-07-14",0,0,132,0,2,142,0,0
"Canada","2024-07-15",0,0,132,0,2,144,0,0
"Canada","2024-07-16",0,14,146,0,2,146,0,0
"Canada","2024-07-17",0,0,146,0,3,149,0,0
"Canada","2024-07-18",0,0,146,0,2,151,0,0
"Canada","2024-07-19",0,0,146,0,3,154,0,0
"Canada","2024-07-20",0,0,146,0,3,157,0,0
"Canada","2024-07-21",0,0,146,0,3,160,0,0
"Canada","2024-07-22",0,0,146,0,2,162,0,0
"Canada","2024-07-23",0,19,165,0,3,165,0,0
"Canada","2024-07-24",0,0,165,0,2,167,0,0
"Canada","2024-07-25",0,0,165,0,2,169,0,0
"Canada","2024-07-26",0,0,165,0,2,171,0,0
"Canada","2024-07-27",0,0,165,0,2,173,0,0
"Canada","2024-07-28",0,0,165,0,2,175,0,0
"Canada","2024-07-29",0,0,165,0,2,177,0,0
"Canada","2024-07-30",0,14,179,0,2,179,0,0
"Canada","2024-07-31",0,0,179,0,3,182,0,0
"Canada","2024-08-01",0,0,179,0,3,185,0,0
"Canada","2024-08-02",0,0,179,0,3,188,0,0
"Canada","2024-08-03",0,0,179,0,3,191,0,0
"Canada","2024-08-04",0,0,179,0,3,194,0,0
"Canada","2024-08-05",0,0,179,0,3,197,0,0
"Canada","2024-08-06",0,21,200,0,3,200,0,0
"Canada","2024-08-07",0,0,200,0,2,202,0,0
"Canada","2024-08-08",0,0,200,0,3,205,0,0
"Canada","2024-08-09",0,0,200,0,2,207,0,0
"Canada","2024-08-10",0,0,200,0,3,210,0,0
"Canada","2024-08-11",0,0,200,0,2,212,0,0
"Canada","2024-08-12",0,0,200,0,3,215,0,0
"Canada","2024-08-13",0,17,217,0,2,217,0,0
"Canada","2024-08-14",0,0,217,0,1,218,0,0
"Canada","2024-08-15",0,0,217,0,1,219,0,0
"Canada","2024-08-16",0,0,217,0,1,220,0,0
"Canada","2024-08-17",0,0,217,0,1,221,0,0
"Canada","2024-08-18",0,0,217,0,1,222,0,0
"Canada","2024-08-19",0,0,217,0,1,223,0,0
"Canada","2024-08-20",0,7,224,0,1,224,0,0
"Canada","2024-08-21",0,0,224,0,3,227,0,0
"Canada","2024-08-22",0,0,224,0,2,229,0,0
"Canada","2024-08-23",0,0,224,0,3,232,0,0
"Canada","2024-08-24",0,0,224,0,3,235,0,0
"Canada","2024-08-25",0,0,224,0,3,238,0,0
"Canada","2024-08-26",0,0,224,0,2,240,0,0
"Canada","2024-08-27",0,19,243,0,3,243,0,0
"Canada","2024-08-28",0,0,243,0,2,245,0,0
"Canada","2024-08-29",0,0,243,0,3,248,0,0
"Canada","2024-08-30",0,0,243,0,2,250,0,0
"Canada","2024-08-31",0,0,243,0,2,252,0,0
"Canada","2024-09-01",0,0,243,0,2,254,0,0
"Canada","2024-09-02",0,0,243,0,3,257,0,0
"Canada","2024-09-03",0,16,259,0,2,259,0,0
"Canada","2024-09-04",0,0,259,0,3,262,0,0
"Canada","2024-09-05",0,0,259,0,2,264,0,0
"Canada","2024-09-06",0,0,259,0,3,267,0,0
"Canada","2024-09-07",0,0,259,0,2,269,0,0
"Canada","2024-09-08",0,0,259,0,3,272,0,0
"Canada","2024-09-09",0,0,259,0,2,274,0,0
"Canada","2024-09-10",0,18,277,0,3,277,0,0
"Canada","2024-09-11",0,0,277,0,2,279,0,0
"Canada","2024-09-12",0,0,277,0,3,282,0,0
"Canada","2024-09-13",0,0,277,0,2,284,0,0
"Canada","2024-09-14",0,0,277,0,3,287,0,0
"Canada","2024-09-15",0,0,277,0,2,289,0,0
"Canada","2024-09-16",0,0,277,0,3,292,0,0
"Canada","2024-09-17",0,17,294,0,2,294,0,0
"Canada","2024-09-18",0,0,294,0,2,296,0,0
"Canada","2024-09-19",0,0,294,0,3,299,0,0
"Canada","2024-09-20",0,0,294,0,2,301,0,0
"Canada","2024-09-21",0,0,294,0,2,303,0,0
"Canada","2024-09-22",0,0,294,0,2,305,0,0
"Canada","2024-09-23",0,0,294,0,3,308,0,0
"Canada","2024-09-24",0,16,310,0,2,310,0,0
"Canada","2024-09-25",0,0,310,0,2,312,0,0
"Canada","2024-09-26",0,0,310,0,3,315,0,0
"Canada","2024-09-27",0,0,310,0,2,317,0,0
"Canada","2024-09-28",0,0,310,0,2,319,0,0
"Canada","2024-09-29",0,0,310,0,2,321,0,0
"Canada","2024-09-30",0,0,310,0,3,324,0,0
"Canada","2024-10-01",0,16,326,0,2,326,0,0
"Canada","2024-10-02",0,0,326,0,2,328,0,0
"Canada","2024-10-03",0,0,326,0,1,329,0,0
"Canada","2024-10-04",0,0,326,0,2,331,0,0
"Canada","2024-10-05",0,0,326,0,1,332,0,0
"Canada","2024-10-06",0,0,326,0,2,334,0,0
"Canada","2024-10-07",0,0,326,0,1,335,0,0
"Canada","2024-10-08",0,11,337,0,2,337,0,0
"Canada","2024-10-09",0,0,337,0,2,339,0,0
"Canada","2024-10-10",0,0,337,0,1,340,0,0
"Canada","2024-10-11",0,0,337,0,2,342,0,0
"Canada","2024-10-12",0,0,337,0,2,344,0,0
"Canada","2024-10-13",0,0,337,0,2,346,0,0
"Canada","2024-10-14",0,0,337,0,1,347,0,0
"Canada","2024-10-15",0,12,349,0,2,349,0,0
"Canada","2024-10-16",0,0,349,0,2,351,0,0
"Canada","2024-10-17",0,0,349,0,2,353,0,0
"Canada","2024-10-18",0,0,349,0,2,355,0,0
"Canada","2024-10-19",0,0,349,0,1,356,0,0
"Canada","2024-10-20",0,0,349,0,2,358,0,0
"Canada","2024-10-21",0,0,349,0,2,360,0,0
"Canada","2024-10-22",0,13,362,0,2,362,0,0
"Canada","2024-10-23",0,0,362,0,2,364,0,0
"Canada","2024-10-24",0,0,362,0,2,366,0,0
"Canada","2024-10-25",0,0,362,0,2,368,0,0
"Canada","2024-10-26",0,0,362,0,3,371,0,0
"Canada","2024-10-27",0,0,362,0,2,373,0,0
"Canada","2024-10-28",0,0,362,0,2,375,0,0
"Canada","2024-10-29",0,15,377,0,2,377,0,0
"Canada","2024-10-30",0,0,377,0,2,379,0,0
"Canada","2024-10-31",0,0,377,0,1,380,0,0
"Canada","2024-11-01",0,0,377,0,2,382,0,0
"Canada","2024-11-02",0,0,377,0,1,383,0,0
"Canada","2024-11-03",0,0,377,0,2,385,0,0
"Canada","2024-11-04",0,0,377,0,1,386,0,0
"Canada","2024-11-05",0,11,388,0,2,388,0,0
"Canada","2024-11-06",0,0,388,0,2,390,0,0
"Canada","2024-11-07",0,0,388,0,1,391,0,0
"Canada","2024-11-08",0,0,388,0,2,393,0,0
"Canada","2024-11-09",0,0,388,0,1,394,0,0
"Canada","2024-11-10",0,0,388,0,2,396,0,0
"Canada","2024-11-11",0,0,388,0,1,397,0,0
"Canada","2024-11-12",0,11,399,0,2,399,0,0
"Canada","2024-11-13",0,0,399,0,1,400,0,0
"Canada","2024-11-14",0,0,399,0,2,402,0,0
"Canada","2024-11-15",0,0,399,0,1,403,0,0
"Canada","2024-11-16",0,0,399,0,1,404,0,0
"Canada","2024-11-17",0,0,399,0,1,405,0,0
"Canada","2024-11-18",0,0,399,0,2,407,0,0
"Canada","2024-11-19",0,9,408,0,1,408,0,0
"Canada","2024-11-20",0,0,408,0,2,410,0,0
"Canada","2024-11-21",0,0,408,0,1,411,0,0
"Canada","2024-11-22",0,0,408,0,2,413,0,0
"Canada","2024-11-23",0,0,408,0,2,415,0,0
"Canada","2024-11-24",0,0,408,0,2,417,0,0
"Canada","2024-11-25",0,0,408,0,1,418,0,0
"Canada","2024-11-26",0,12,420,0,2,420,0,0
"Canada","2024-11-27",0,0,420,0,2,422,0,0
"Canada","2024-11-28",0,0,420,0,1,423,0,0
"Canada","2024-11-29",0,0,420,0,2,425,0,0
"Canada","2024-11-30",0,0,420,0,2,427,0,0
"Canada","2024-12-01",0,0,420,0,2,429,0,0
"Canada","2024-12-02",0,0,420,0,1,430,0,0
"Canada","2024-12-03",0,12,432,0,2,432,0,0
"Canada","2024-12-04",0,0,432,0,2,434,0,0
"Canada","2024-12-05",0,0,432,0,1,435,0,0
"Canada","2024-12-06",0,0,432,0,2,437,0,0
"Canada","2024-12-07",0,0,432,0,1,438,0,0
"Canada","2024-12-08",0,0,432,0,2,440,0,0
"Canada","2024-12-09",0,0,432,0,1,441,0,0
"Canada","2024-12-10",0,11,443,0,2,443,0,0
"Canada","2024-12-11",0,0,443,0,0,443,0,0
"Canada","2024-12-12",0,0,443,0,1,444,0,0
"Canada","2024-12-13",0,0,443,0,0,444,0,0
"Canada","2024-12-14",0,0,443,0,0,444,0,0
"Canada","2024-12-15",0,0,443,0,0,444,0,0
"Canada","2024-12-16",0,0,443,0,1,445,0,0
"Canada","2024-12-17",0,2,445,0,0,445,0,0
"Canada","2024-12-18",0,0,445,0,1,446,0,0
"Canada","2024-12-19",0,0,445,0,0,446,0,0
"Canada","2024-12-20",0,0,445,0,1,447,0,0
"Canada","2024-12-21",0,0,445,0,1,448,0,0
"Canada","2024-12-22",0,0,445,0,1,449,0,0
"Canada","2024-12-23",0,0,445,0,0,449,0,0
"Canada","2024-12-24",0,5,450,0,1,450,0,0
"Canada","2024-12-25",0,0,450,0,0,450,0,0
"Canada","2024-12-26",0,0,450,0,1,451,0,0
"Canada","2024-12-27",0,0,450,0,0,451,0,0
"Canada","2024-12-28",0,0,450,0,0,451,0,0
"Canada","2024-12-29",0,0,450,0,0,451,0,0
"Canada","2024-12-30",0,0,450,0,1,452,0,0
"Canada","2024-12-31",0,2,452,0,0,452,0,0
"Canada","2025-01-01",0,0,452,0,0,452,0,0
"Canada","2025-01-02",0,0,452,0,0,452,0,0
"Canada","2025-01-03",0,0,452,0,0,452,0,0
"Canada","2025-01-04",0,0,452,0,1,453,0,0
"Canada","2025-01-05",0,0,452,0,0,453,0,0
"Canada","2025-01-06",0,0,452,0,0,453,0,0
"Canada","2025-01-07",0,1,453,0,0,453,0,0
"Canada","2025-01-08",0,0,453,0,0,453,0,0
"Canada","2025-01-09",0,0,453,0,0,453,0,0
"Canada","2025-01-10",0,0,453,0,0,453,0,0
"Canada","2025-01-11",0,0,453,0,0,453,0,0
"Canada","2025-01-12",0,0,453,0,0,453,0,0
"Canada","2025-01-13",0,0,453,0,0,453,0,0
"Canada","2025-01-14",0,0,453,0,0,453,0,0
"Canada","2025-01-15",0,0,453,0,0,453,0,0
"Canada","2025-01-16",0,0,453,0,0,453,0,0
"Canada","2025-01-17",0,0,453,0,0,453,0,0
"Canada","2025-01-18",0,0,453,0,0,453,0,0
"Canada","2025-01-19",0,0,453,0,0,453,0,0
"Canada","2025-01-20",0,0,453,0,0,453,0,0
"Canada","2025-01-21",0,0,453,0,0,453,0,0
"Canada","2025-01-22",0,0,453,0,0,453,0,0
"Canada","2025-01-23",0,0,453,0,0,453,0,0
"Canada","2025-01-24",0,0,453,0,0,453,0,0
"Canada","2025-01-25",0,0,453,0,0,453,0,0
"Canada","2025-01-26",0,0,453,0,0,453,0,0
"Canada","2025-01-27",0,0,453,0,0,453,0,0
"Canada","2025-01-28",0,0,453,0,0,453,0,0
"Canada","2025-01-29",0,0,453,0,0,453,0,0
"Canada","2025-01-30",0,0,453,0,0,453,0,0
"Canada","2025-01-31",0,0,453,0,0,453,0,0
"Canada","2025-02-01",0,0,453,0,0,453,0,0
"Canada","2025-02-02",0,0,453,0,0,453,0,0
"Canada","2025-02-03",0,0,453,0,0,453,0,0
"Canada","2025-02-04",0,0,453,0,0,453,0,0
"Canada","2025-02-05",0,0,453,0,0,453,0,0
"Canada","2025-02-06",0,0,453,0,0,453,0,0
"Canada","2025-02-07",0,0,453,0,0,453,0,0
"Canada","2025-02-08",0,0,453,0,0,453,0,0
"Canada","2025-02-09",0,0,453,0,0,453,0,0
"Canada","2025-02-10",0,0,453,0,0,453,0,0
"Canada","2025-02-11",0,0,453,0,0,453,0,0
"Canada","2025-02-12",0,0,453,0,0,453,0,0
"Canada","2025-02-13",0,0,453,0,0,453,0,0
"Canada","2025-02-14",0,0,453,0,0,453,0,0
"Canada","2025-02-15",0,0,453,0,0,453,0,0
"Canada","2025-02-16",0,0,453,0,0,453,0,0
"Canada","2025-02-17",0,0,453,0,0,453,0,0
"Canada","2025-02-18",0,0,453,0,0,453,0,0
"Canada","2025-02-19",0,0,453,0,0,453,0,0
"Canada","2025-02-20",0,0,453,0,0,453,0,0
"Canada","2025-02-21",0,0,453,0,0,453,0,0
"Canada","2025-02-22",0,0,453,0,0,453,0,0
"Canada","2025-02-23",0,0,453,0,0,453,0,0
"Canada","2025-02-24",0,0,453,0,0,453,0,0
"Canada","2025-02-25",0,0,453,0,0,453,0,0
"Canada","2025-02-26",0,0,453,0,0,453,0,0
"Canada","2025-02-27",0,0,453,0,0,453,0,0
"Canada","2025-02-28",0,0,453,0,0,453,0,0
"Canada","2025-03-01",0,0,453,0,0,453,0,0
"Canada","2025-03-02",0,0,453,0,0,453,0,0
"Canada","2025-03-03",0,0,453,0,0,453,0,0
"Central African Republic","2024-01-01",0,0,0,0,0,0,0,0
"Central African Republic","2024-01-02",0,0,0,0,0,0,0,0
"Central African Republic","2024-01-03",0,0,0,0,0,0,0,0
"Central African Republic","2024-01-04",0,0,0,0,0,0,0,0
"Central African Republic","2024-01-05",0,0,0,0,0,0,0,0
"Central African Republic","2024-01-06",0,0,0,0,0,0,0,0
"Central African Republic","2024-01-07",0,0,0,0,0,0,0,0
"Central African Republic","2024-01-08",0,0,0,0,0,0,0,0
"Central African Republic","2024-01-09",0,0,0,0,0,0,0,0
"Central African Republic","2024-01-10",0,0,0,0,0,0,0,0
"Central African Republic","2024-01-11",0,0,0,0,0,0,0,0
"Central African Republic","2024-01-12",0,0,0,0,0,0,0,0
"Central African Republic","2024-01-13",0,0,0,0,0,0,0,0
"Central African Republic","2024-01-14",0,4,4,0,4,4,0,0
"Central African Republic","2024-01-15",0,0,4,0,0,4,0,0
"Central African Republic","2024-01-16",0,0,4,0,0,4,0,0
"Central African Republic","2024-01-17",0,0,4,0,0,4,0,0
"Central African Republic","2024-01-18",0,0,4,0,0,4,0,0
"Central African Republic","2024-01-19",0,0,4,0,0,4,0,0
"Central African Republic","2024-01-20",0,0,4,0,0,4,0,0
"Central African Republic","2024-01-21",0,0,4,0,0,4,0,0
"Central African Republic","2024-01-22",0,0,4,0,1,5,0,0
"Central African Republic","2024-01-23",0,0,4,0,0,5,0,0
"Central African Republic","2024-01-24",0,0,4,0,0,5,0,0
"Central African Republic","2024-01-25",0,0,4,0,0,5,0,0
"Central African Republic","2024-01-26",0,0,4,0,0,5,0,0
"Central African Republic","2024-01-27",0,0,4,0,0,5,0,0
"Central African Republic","2024-01-28",0,1,5,0,0,5,0,0
"Central African Republic","2024-01-29",0,0,5,0,0,5,0,0
"Central African Republic","2024-01-30",0,0,5,0,0,5,0,0
"Central African Republic","2024-01-31",0,0,5,0,1,6,0,0
"Central African Republic","2024-02-01",0,0,5,0,0,6,0,0
"Central African Republic","2024-02-02",0,0,5,0,0,6,0,0
"Central African Republic","2024-02-03",0,0,5,0,0,6,0,0
"Central African Republic","2024-02-04",0,0,5,0,1,7,0,0
"Central African Republic","2024-02-05",0,0,5,0,0,7,0,0
"Central African Republic","2024-02-06",0,0,5,0,0,7,0,0
"Central African Republic","2024-02-07",0,0,5,0,0,7,0,0
"Central African Republic","2024-02-08",0,0,5,0,0,7,0,0
"Central African Republic","2024-02-09",0,0,5,0,1,8,0,0
"Central African Republic","2024-02-10",0,0,5,0,0,8,0,0
"Central African Republic","2024-02-11",0,3,8,0,0,8,0,0
"Central African Republic","2024-02-12",0,0,8,0,1,9,0,0
"Central African Republic","2024-02-13",0,0,8,0,0,9,0,0
"Central African Republic","2024-02-14",0,0,8,0,1,10,0,0
"Central African Republic","2024-02-15",0,0,8,0,0,10,0,0
"Central African Republic","2024-02-16",0,0,8,0,1,11,0,0
"Central African Republic","2024-02-17",0,0,8,0,0,11,0,0
"Central African Republic","2024-02-18",0,4,12,0,1,12,0,0
"Central African Republic","2024-02-19",0,0,12,0,0,12,0,0
"Central African Republic","2024-02-20",0,0,12,0,0,12,0,0
"Central African Republic","2024-02-21",0,0,12,0,0,12,0,0
"Central African Republic","2024-02-22",0,0,12,0,1,13,0,0
"Central African Republic","2024-02-23",0,0,12,0,0,13,0,0
"Central African Republic","2024-02-24",0,0,12,0,0,13,0,0
"Central African Republic","2024-02-25",0,0,12,0,0,13,0,0
"Central African Republic","2024-02-26",0,0,12,0,0,13,0,0
"Central African Republic","2024-02-27",0,0,12,0,0,13,0,0
"Central African Republic","2024-02-28",0,0,12,0,0,13,0,0
"Central African Republic","2024-02-29",0,0,12,0,1,14,0,0
"Central African Republic","2024-03-01",0,0,12,0,0,14,0,0
"Central African Republic","2024-03-02",0,0,12,0,0,14,0,0
"Central African Republic","2024-03-03",0,0,12,0,0,14,0,0
"Central African Republic","2024-03-04",0,0,12,0,0,14,0,0
"Central African Republic","2024-03-05",0,0,12,0,0,14,0,0
"Central African Republic","2024-03-06",0,0,12,0,0,14,0,0
"Central African Republic","2024-03-07",0,0,12,0,1,15,0,0
"Central African Republic","2024-03-08",0,0,12,0,0,15,0,0
"Central African Republic","2024-03-09",0,0,12,0,0,15,0,0
"Central African Republic","2024-03-10",0,0,12,0,0,15,0,0
"Central African Republic","2024-03-11",0,0,12,0,0,15,0,0
"Central African Republic","2024-03-12",0,0,12,0,0,15,0,0
"Central African Republic","2024-03-13",0,0,12,0,0,15,0,0
"Central African Republic","2024-03-14",0,0,12,0,1,16,0,0
"Central African Republic","2024-03-15",0,0,12,0,0,16,0,0
"Central African Republic","2024-03-16",0,0,12,0,0,16,0,0
"Central African Republic","2024-03-17",45,4,16,45,0,16,45,45
"Central African Republic","2024-03-18",0,0,16,45,0,16,0,45
"Central African Republic","2024-03-19",0,0,16,45,1,17,1,46
"Central African Republic","2024-03-20",0,0,16,45,0,17,0,46
"Central African Republic","2024-03-21",0,0,16,45,0,17,0,46
"Central African Republic","2024-03-22",0,0,16,45,0,17,0,46
"Central African Republic","2024-03-23",0,0,16,45,1,18,1,47
"Central African Republic","2024-03-24",2,2,18,47,0,18,0,47
"Central African Republic","2024-03-25",0,0,18,47,0,18,1,48
"Central African Republic","2024-03-26",0,0,18,47,0,18,1,49
"Central African Republic","2024-03-27",0,0,18,47,0,18,2,51
"Central African Republic","2024-03-28",0,0,18,47,1,19,1,52
"Central African Republic","2024-03-29",0,0,18,47,0,19,1,53
"Central African Republic","2024-03-30",0,0,18,47,0,19,1,54
"Central African Republic","2024-03-31",0,1,19,47,0,19,2,56
"Central African Republic","2024-04-01",0,0,19,47,0,19,1,57
"Central African Republic","2024-04-02",0,0,19,47,0,19,1,58
"Central African Republic","2024-04-03",0,0,19,47,0,19,1,59
"Central African Republic","2024-04-04",0,0,19,47,0,19,2,61
"Central African Republic","2024-04-05",0,0,19,47,0,19,1,62
"Central African Republic","2024-04-06",0,0,19,47,0,19,1,63
"Central African Republic","2024-04-07",0,0,19,47,0,19,1,64
"Central African Republic","2024-04-08",0,0,19,47,0,19,2,66
"Central African Republic","2024-04-09",0,0,19,47,0,19,1,67
"Central African Republic","2024-04-10",0,0,19,47,0,19,1,68
"Central African Republic","2024-04-11",0,0,19,47,0,19,1,69
"Central African Republic","2024-04-12",0,0,19,47,0,19,2,71
"Central African Republic","2024-04-13",0,0,19,47,0,19,1,72
"Central African Republic","2024-04-14",26,0,19,73,0,19,1,73
"Central African Republic","2024-04-15",0,0,19,73,0,19,0,73
"Central African Republic","2024-04-16",0,0,19,73,0,19,1,74
"Central African Republic","2024-04-17",0,0,19,73,0,19,0,74
"Central African Republic","2024-04-18",0,0,19,73,0,19,1,75
"Central African Republic","2024-04-19",0,0,19,73,0,19,0,75
"Central African Republic","2024-04-20",0,0,19,73,0,19,1,76
"Central African Republic","2024-04-21",0,0,19,73,0,19,0,76
"Central African Republic","2024-04-22",0,0,19,73,0,19,1,77
"Central African Republic","2024-04-23",0,0,19,73,0,19,0,77
"Central African Republic","2024-04-24",0,0,19,73,0,19,0,77
"Central African Republic","2024-04-25",0,0,19,73,0,19,1,78
"Central African Republic","2024-04-26",0,0,19,73,0,19,0,78
"Central African Republic","2024-04-27",0,0,19,73,0,19,1,79
"Central African Republic","2024-04-28",0,0,19,73,0,19,0,79
"Central African Republic","2024-04-29",0,0,19,73,0,19,1,80
"Central African Republic","2024-04-30",0,0,19,73,0,19,0,80
"Central African Republic","2024-05-01",0,0,19,73,0,19,1,81
"Central African Republic","2024-05-02",0,0,19,73,0,19,0,81
"Central African Republic","2024-05-03",0,0,19,73,0,19,0,81
"Central African Republic","2024-05-04",0,0,19,73,0,19,1,82
"Central African Republic","2024-05-05",0,0,19,73,0,19,0,82
"Central African Republic","2024-05-06",0,0,19,73,1,20,1,83
"Central African Republic","2024-05-07",0,0,19,73,0,20,0,83
"Central African Republic","2024-05-08",0,0,19,73,0,20,1,84
"Central African Republic","2024-05-09",0,0,19,73,0,20,0,84
"Central African Republic","2024-05-10",0,0,19,73,0,20,0,84
"Central African Republic","2024-05-11",0,0,19,73,0,20,1,85
"Central African Republic","2024-05-12",0,0,19,73,0,20,0,85
"Central African Republic","2024-05-13",0,0,19,73,0,20,1,86
"Central African Republic","2024-05-14",0,0,19,73,0,20,0,86
"Central African Republic","2024-05-15",0,0,19,73,0,20,1,87
"Central African Republic","2024-05-16",0,0,19,73,0,20,0,87
"Central African Republic","2024-05-17",0,0,19,73,0,20,1,88
"Central African Republic","2024-05-18",15,0,19,88,0,20,0,88
"Central African Republic","2024-05-19",0,0,19,88,0,20,0,88
"Central African Republic","2024-05-20",0,0,19,88,0,20,0,88
"Central African Republic","2024-05-21",0,0,19,88,0,20,0,88
"Central African Republic","2024-05-22",0,0,19,88,0,20,1,89
"Central African Republic","2024-05-23",0,0,19,88,0,20,0,89
"Central African Republic","2024-05-24",0,0,19,88,0,20,0,89
"Central African Republic","2024-05-25",1,0,19,89,0,20,0,89
"Central African Republic","2024-05-26",0,0,19,89,0,20,4,93
"Central African Republic","2024-05-27",0,0,19,89,0,20,3,96
"Central African Republic","2024-05-28",0,0,19,89,0,20,3,99
"Central African Republic","2024-05-29",0,0,19,89,0,20,4,103
"Central African Republic","2024-05-30",0,0,19,89,0,20,4,107
"Central African Republic","2024-05-31",0,0,19,89,0,20,3,110
"Central African Republic","2024-06-01",0,0,19,89,0,20,3,113
"Central African Republic","2024-06-02",0,0,19,89,0,20,4,117
"Central African Republic","2024-06-03",0,0,19,89,0,20,4,121
"Central African Republic","2024-06-04",0,0,19,89,0,20,3,124
"Central African Republic","2024-06-05",0,0,19,89,0,20,3,127
"Central African Republic","2024-06-06",0,0,19,89,0,20,4,131
"Central African Republic","2024-06-07",0,0,19,89,0,20,4,135
"Central African Republic","2024-06-08",0,0,19,89,0,20,3,138
"Central African Republic","2024-06-09",0,1,20,89,0,20,3,141
"Central African Republic","2024-06-10",0,0,20,89,0,20,4,145
"Central African Republic","2024-06-11",0,0,20,89,0,20,4,149
"Central African Republic","2024-06-12",0,0,20,89,0,20,3,152
"Central African Republic","2024-06-13",0,0,20,89,1,21,3,155
"Central African Republic","2024-06-14",0,0,20,89,0,21,4,159
"Central African Republic","2024-06-15",0,0,20,89,0,21,4,163
"Central African Republic","2024-06-16",77,1,21,166,0,21,3,166
"Central African Republic","2024-06-17",0,0,21,166,0,21,0,166
"Central African Republic","2024-06-18",0,0,21,166,1,22,1,167
"Central African Republic","2024-06-19",0,0,21,166,0,22,0,167
"Central African Republic","2024-06-20",0,0,21,166,0,22,1,168
"Central African Republic","2024-06-21",0,0,21,166,0,22,0,168
"Central African Republic","2024-06-22",0,0,21,166,1,23,1,169
"Central African Republic","2024-06-23",0,2,23,166,0,23,0,169
"Central African Republic","2024-06-24",0,0,23,166,0,23,1,170
"Central African Republic","2024-06-25",0,0,23,166,0,23,0,170
"Central African Republic","2024-06-26",0,0,23,166,0,23,1,171
"Central African Republic","2024-06-27",0,0,23,166,1,24,0,171
"Central African Republic","2024-06-28",0,0,23,166,0,24,0,171
"Central African Republic","2024-06-29",0,0,23,166,0,24,1,172
"Central African Republic","2024-06-30",0,1,24,166,0,24,0,172
"Central African Republic","2024-07-01",0,0,24,166,0,24,1,173
"Central African Republic","2024-07-02",0,0,24,166,0,24,0,173
"Central African Republic","2024-07-03",0,0,24,166,0,24,1,174
"Central African Republic","2024-07-04",0,0,24,166,1,25,0,174
"Central African Republic","2024-07-05",0,0,24,166,0,25,1,175
"Central African Republic","2024-07-06",0,0,24,166,0,25,0,175
"Central African Republic","2024-07-07",0,1,25,166,0,25,1,176
"Central African Republic","2024-07-08",0,0,25,166,0,25,0,176
"Central African Republic","2024-07-09",0,0,25,166,0,25,0,176
"Central African Republic","2024-07-10",0,0,25,166,0,25,1,177
"Central African Republic","2024-07-11",0,0,25,166,1,26,0,177
"Central African Republic","2024-07-12",0,0,25,166,0,26,1,178
"Central African Republic","2024-07-13",0,0,25,166,0,26,0,178
"Central African Republic","2024-07-14",0,1,26,166,0,26,1,179
"Central African Republic","2024-07-15",0,0,26,166,1,27,0,179
"Central African Republic","2024-07-16",0,0,26,166,0,27,1,180
"Central African Republic","2024-07-17",0,0,26,166,1,28,0,180
"Central African Republic","2024-07-18",0,0,26,166,0,28,0,180
"Central African Republic","2024-07-19",0,0,26,166,1,29,1,181
"Central African Republic","2024-07-20",0,0,26,166,0,29,0,181
"Central African Republic","2024-07-21",0,4,30,166,1,30,1,182
"Central African Republic","2024-07-22",0,0,30,166,1,31,0,182
"Central African Republic","2024-07-23",0,0,30,166,2,33,1,183
"Central African Republic","2024-07-24",0,0,30,166,1,34,0,183
"Central African Republic","2024-07-25",0,0,30,166,1,35,1,184
"Central African Republic","2024-07-26",0,0,30,166,1,36,0,184
"Central African Republic","2024-07-27",0,0,30,166,2,38,1,185
"Central African Republic","2024-07-28",19,9,39,185,1,39,0,185
"Central African Republic","2024-07-29",0,0,39,185,0,39,2,187
"Central African Republic","2024-07-30",0,0,39,185,1,40,1,188
"Central African Republic","2024-07-31",0,0,39,185,0,40,2,190
"Central African Republic","2024-08-01",0,0,39,185,1,41,2,192
"Central African Republic","2024-08-02",0,0,39,185,0,41,1,193
"Central African Republic","2024-08-03",10,0,39,195,1,42,2,195
"Central African Republic","2024-08-04",0,3,42,195,0,42,5,200
"Central African Republic","2024-08-05",0,0,42,195,0,42,4,204
"Central African Republic","2024-08-06",0,0,42,195,1,43,5,209
"Central African Republic","2024-08-07",0,0,42,195,0,43,5,214
"Central African Republic","2024-08-08",0,0,42,195,0,43,4,218
"Central African Republic","2024-08-09",28,0,42,223,0,43,5,223
"Central African Republic","2024-08-10",0,0,42,223,1,44,1,224
"Central African Republic","2024-08-11",0,2,44,223,0,44,0,224
"Central African Republic","2024-08-12",0,0,44,223,0,44,1,225
"Central African Republic","2024-08-13",0,0,44,223,1,45,1,226
"Central African Republic","2024-08-14",0,0,44,223,0,45,0,226
"Central African Republic","2024-08-15",0,0,44,223,0,45,1,227
"Central African Republic","2024-08-16",0,0,44,223,0,45,1,228
"Central African Republic","2024-08-17",0,0,44,223,1,46,0,228
"Central African Republic","2024-08-18",0,2,46,223,0,46,1,229
"Central African Republic","2024-08-19",0,0,46,223,0,46,1,230
"Central African Republic","2024-08-20",0,0,46,223,1,47,0,230
"Central African Republic","2024-08-21",0,0,46,223,0,47,1,231
"Central African Republic","2024-08-22",0,0,46,223,1,48,1,232
"Central African Republic","2024-08-23",0,0,46,223,0,48,0,232
"Central African Republic","2024-08-24",0,0,46,223,1,49,1,233
"Central African Republic","2024-08-25",0,3,49,223,0,49,1,234
"Central African Republic","2024-08-26",0,0,49,223,0,49,0,234
"Central African Republic","2024-08-27",0,0,49,223,0,49,1,235
"Central African Republic","2024-08-28",0,0,49,223,0,49,1,236
"Central African Republic","2024-08-29",0,0,49,223,1,50,0,236
"Central African Republic","2024-08-30",0,0,49,223,0,50,1,237
"Central African Republic","2024-08-31",0,0,49,223,0,50,1,238
"Central African Republic","2024-09-01",0,1,50,223,0,50,0,238
"Central African Republic","2024-09-02",0,0,50,223,0,50,1,239
"Central African Republic","2024-09-03",0,0,50,223,1,51,1,240
"Central African Republic","2024-09-04",0,0,50,223,0,51,0,240
"Central African Republic","2024-09-05",0,0,50,223,0,51,1,241
"Central African Republic","2024-09-06",0,0,50,223,0,51,1,242
"Central African Republic","2024-09-07",0,0,50,223,1,52,0,242
"Central African Republic","2024-09-08",20,2,52,243,0,52,1,243
"Central African Republic","2024-09-09",0,0,52,243,0,52,1,244
"Central African Republic","2024-09-10",0,0,52,243,1,53,1,245
"Central African Republic","2024-09-11",0,0,52,243,0,53,0,245
"Central African Republic","2024-09-12",0,0,52,243,0,53,1,246
"Central African Republic","2024-09-13",0,0,52,243,0,53,1,247
"Central African Republic","2024-09-14",0,0,52,243,1,54,1,248
"Central African Republic","2024-09-15",0,2,54,243,0,54,1,249
"Central African Republic","2024-09-16",0,0,54,243,0,54,0,249
"Central African Republic","2024-09-17",0,0,54,243,1,55,1,250
"Central African Republic","2024-09-18",0,0,54,243,0,55,1,251
"Central African Republic","2024-09-19",0,0,54,243,0,55,1,252
"Central African Republic","2024-09-20",0,0,54,243,0,55,1,253
"Central African Republic","2024-09-21",0,0,54,243,1,56,0,253
"Central African Republic","2024-09-22",0,2,56,243,0,56,1,254
"Central African Republic","2024-09-23",12,0,56,255,0,56,1,255
"Central African Republic","2024-09-24",0,0,56,255,0,56,2,257
"Central African Republic","2024-09-25",0,0,56,255,0,56,2,259
"Central African Republic","2024-09-26",0,0,56,255,1,57,2,261
"Central African Republic","2024-09-27",0,0,56,255,0,57,2,263
"Central African Republic","2024-09-28",0,0,56,255,0,57,2,265
"Central African Republic","2024-09-29",0,0,56,255,0,57,2,267
"Central African Republic","2024-09-30",14,0,56,269,0,57,2,269
"Central African Republic","2024-10-01",0,0,56,269,0,57,2,271
"Central African Republic","2024-10-02",0,0,56,269,0,57,1,272
"Central African Republic","2024-10-03",0,0,56,269,1,58,2,274
"Central African Republic","2024-10-04",0,0,56,269,0,58,2,276
"Central African Republic","2024-10-05",0,0,56,269,0,58,1,277
"Central African Republic","2024-10-06",10,2,58,279,0,58,2,279
"Central African Republic","2024-10-07",0,0,58,279,1,59,3,282
"Central African Republic","2024-10-08",0,0,58,279,0,59,3,285
"Central African Republic","2024-10-09",0,0,58,279,1,60,2,287
"Central African Republic","2024-10-10",0,0,58,279,0,60,3,290
"Central African Republic","2024-10-11",0,0,58,279,1,61,3,293
"Central African Republic","2024-10-12",0,0,58,279,0,61,3,296
"Central African Republic","2024-10-13",0,4,62,279,1,62,3,299
"Central African Republic","2024-10-14",0,0,62,279,0,62,2,301
"Central African Republic","2024-10-15",0,0,62,279,1,63,3,304
"Central African Republic","2024-10-16",0,0,62,279,0,63,3,307
"Central African Republic","2024-10-17",0,0,62,279,0,63,3,310
"Central African Republic","2024-10-18",0,0,62,279,0,63,2,312
"Central African Republic","2024-10-19",0,0,62,279,1,64,3,315
"Central African Republic","2024-10-20",39,2,64,318,0,64,3,318
"Central African Republic","2024-10-21",0,0,64,318,0,64,1,319
"Central African Republic","2024-10-22",0,0,64,318,1,65,0,319
"Central African Republic","2024-10-23",0,0,64,318,1,66,1,320
"Central African Republic","2024-10-24",0,0,64,318,0,66,1,321
"Central African Republic","2024-10-25",0,0,64,318,0,66,1,322
"Central African Republic","2024-10-26",0,3,67,318,1,67,0,322
"Central African Republic","2024-10-27",5,0,67,323,1,68,1,323
"Central African Republic","2024-10-28",0,0,67,323,0,68,0,323
"Central African Republic","2024-10-29",0,0,67,323,1,69,1,324
"Central African Republic","2024-10-30",0,0,67,323,0,69,0,324
"Central African Republic","2024-10-31",0,0,67,323,1,70,0,324
"Central African Republic","2024-11-01",0,0,67,323,1,71,1,325
"Central African Republic","2024-11-02",0,0,67,323,0,71,0,325
"Central African Republic","2024-11-03",0,5,72,323,1,72,0,325
"Central African Republic","2024-11-04",0,0,72,323,0,72,1,326
"Central African Republic","2024-11-05",0,0,72,323,1,73,0,326
"Central African Republic","2024-11-06",0,0,72,323,0,73,1,327
"Central African Republic","2024-11-07",0,0,72,323,1,74,0,327
"Central African Republic","2024-11-08",0,0,72,323,0,74,0,327
"Central African Republic","2024-11-09",0,0,72,323,1,75,1,328
"Central African Republic","2024-11-10",0,3,75,323,0,75,0,328
"Central African Republic","2024-11-11",0,0,75,323,1,76,0,328
"Central African Republic","2024-11-12",0,0,75,323,1,77,1,329
"Central African Republic","2024-11-13",6,0,75,329,1,78,0,329
"Central African Republic","2024-11-14",0,0,75,329,1,79,0,329
"Central African Republic","2024-11-15",0,0,75,329,1,80,0,329
"Central African Republic","2024-11-16",0,0,75,329,1,81,0,329
"Central African Republic","2024-11-17",0,7,82,329,1,82,0,329
"Central African Republic","2024-11-18",0,0,82,329,1,83,0,329
"Central African Republic","2024-11-19",0,0,82,329,0,83,0,329
"Central African Republic","2024-11-20",0,0,82,329,1,84,0,329
"Central African Republic","2024-11-21",0,0,82,329,0,84,0,329
"Central African Republic","2024-11-22",0,0,82,329,1,85,0,329
"Central African Republic","2024-11-23",0,0,82,329,0,85,0,329
"Central African Republic","2024-11-24",0,4,86,329,1,86,0,329
"Central African Republic","2024-11-25",0,0,86,329,0,86,0,329
"Central African Republic","2024-11-26",0,0,86,329,0,86,0,329
"Central African Republic","2024-11-27",0,0,86,329,0,86,0,329
"Central African Republic","2024-11-28",0,0,86,329,1,87,0,329
"Central African Republic","2024-11-29",0,0,86,329,0,87,0,329
"Central African Republic","2024-11-30",0,0,86,329,0,87,0,329
"Central African Republic","2024-12-01",0,1,87,329,0,87,0,329
"Central African Republic","2024-12-02",0,0,87,329,0,87,0,329
"Central African Republic","2024-12-03",0,0,87,329,0,87,0,329
"Central African Republic","2024-12-04",0,0,87,329,0,87,0,329
"Central African Republic","2024-12-05",0,0,87,329,1,88,0,329
"Central African Republic","2024-12-06",0,0,87,329,0,88,0,329
"Central African Republic","2024-12-07",0,0,87,329,0,88,0,329
"Central African Republic","2024-12-08",0,1,88,329,0,88,0,329
"Central African Republic","2024-12-09",0,0,88,329,0,88,0,329
"Central African Republic","2024-12-10",0,0,88,329,1,89,0,329
"Central African Republic","2024-12-11",0,0,88,329,0,89,0,329
"Central African Republic","2024-12-12",0,0,88,329,0,89,0,329
"Central African Republic","2024-12-13",0,0,88,329,0,89,0,329
"Central African Republic","2024-12-14",0,0,88,329,1,90,0,329
"Central African Republic","2024-12-15",0,2,90,329,0,90,0,329
"Central African Republic","2024-12-16",0,0,90,329,0,90,0,329
"Central African Republic","2024-12-17",0,0,90,329,0,90,0,329
"Central African Republic","2024-12-18",0,0,90,329,0,90,0,329
"Central African Republic","2024-12-19",0,0,90,329,1,91,0,329
"Central African Republic","2024-12-20",0,0,90,329,0,91,0,329
"Central African Republic","2024-12-21",0,0,90,329,0,91,0,329
"Central African Republic","2024-12-22",0,0,90,329,0,91,0,329
"Central African Republic","2024-12-23",0,0,90,329,0,91,0,329
"Central African Republic","2024-12-24",0,0,90,329,0,91,0,329
"Central African Republic","2024-12-25",0,0,90,329,0,91,0,329
"Central African Republic","2024-12-26",0,0,90,329,1,92,0,329
"Central African Republic","2024-12-27",0,0,90,329,0,92,0,329
"Central African Republic","2024-12-28",0,0,90,329,0,92,0,329
"Central African Republic","2024-12-29",0,2,92,329,0,92,0,329
"Central African Republic","2024-12-30",0,0,92,329,1,93,0,329
"Central African Republic","2024-12-31",0,0,92,329,0,93,0,329
"Central African Republic","2025-01-01",0,0,92,329,1,94,0,329
"Central African Republic","2025-01-02",0,0,92,329,0,94,0,329
"Central African Republic","2025-01-03",0,0,92,329,1,95,0,329
"Central African Republic","2025-01-04",0,0,92,329,0,95,0,329
"Central African Republic","2025-01-05",0,4,96,329,1,96,0,329
"Central African Republic","2025-01-06",0,0,96,329,0,96,0,329
"Central African Republic","2025-01-07",0,0,96,329,0,96,0,329
"Central African Republic","2025-01-08",0,0,96,329,0,96,0,329
"Central African Republic","2025-01-09",0,0,96,329,1,97,0,329
"Central African Republic","2025-01-10",0,0,96,329,0,97,0,329
"Central African Republic","2025-01-11",0,0,96,329,0,97,0,329
"Central African Republic","2025-01-12",0,1,97,329,0,97,0,329
"Central African Republic","2025-01-13",0,0,97,329,0,97,0,329
"Central African Republic","2025-01-14",0,0,97,329,0,97,0,329
"Central African Republic","2025-01-15",0,0,97,329,0,97,0,329
"Central African Republic","2025-01-16",0,0,97,329,1,98,0,329
"Central African Republic","2025-01-17",0,0,97,329,0,98,0,329
"Central African Republic","2025-01-18",0,0,97,329,0,98,0,329
"Central African Republic","2025-01-19",0,1,98,329,0,98,0,329
"Central African Republic","2025-01-20",0,0,98,329,0,98,0,329
"Central African Republic","2025-01-21",0,0,98,329,0,98,0,329
"Central African Republic","2025-01-22",0,0,98,329,0,98,0,329
"Central African Republic","2025-01-23",0,0,98,329,0,98,0,329
"Central African Republic","2025-01-24",0,0,98,329,0,98,0,329
"Central African Republic","2025-01-25",0,0,98,329,0,98,0,329
"Central African Republic","2025-01-26",0,0,98,329,0,98,0,329
"Central African Republic","2025-01-27",0,0,98,329,1,99,0,329
"Central African Republic","2025-01-28",0,0,98,329,0,99,0,329
"Central African Republic","2025-01-29",0,0,98,329,0,99,0,329
"Central African Republic","2025-01-30",0,0,98,329,0,99,0,329
"Central African Republic","2025-01-31",0,0,98,329,0,99,0,329
"Central African Republic","2025-02-01",0,0,98,329,0,99,0,329
"Central African Republic","2025-02-02",0,1,99,329,0,99,0,329
"Central African Republic","2025-02-03",0,0,99,329,0,99,0,329
"Central African Republic","2025-02-04",0,0,99,329,0,99,0,329
"Central African Republic","2025-02-05",0,0,99,329,0,99,0,329
"Central African Republic","2025-02-06",0,0,99,329,0,99,0,329
"Central African Republic","2025-02-07",0,0,99,329,0,99,0,329
"Central African Republic","2025-02-08",0,0,99,329,0,99,0,329
"Central African Republic","2025-02-09",0,0,99,329,0,99,0,329
"Central African Republic","2025-02-10",0,0,99,329,0,99,0,329
"Central African Republic","2025-02-11",0,0,99,329,0,99,0,329
"Central African Republic","2025-02-12",0,0,99,329,0,99,0,329
"Central African Republic","2025-02-13",0,0,99,329,0,99,0,329
"Central African Republic","2025-02-14",0,0,99,329,0,99,0,329
"Central African Republic","2025-02-15",0,0,99,329,0,99,0,329
"Central African Republic","2025-02-16",0,0,99,329,0,99,0,329
"Central African Republic","2025-02-17",0,0,99,329,0,99,0,329
"Central African Republic","2025-02-18",0,0,99,329,0,99,0,329
"Central African Republic","2025-02-19",0,0,99,329,0,99,0,329
"Central African Republic","2025-02-20",0,0,99,329,0,99,0,329
"Central African Republic","2025-02-21",0,0,99,329,0,99,0,329
"Central African Republic","2025-02-22",0,0,99,329,0,99,0,329
"Central African Republic","2025-02-23",0,0,99,329,0,99,0,329
"Central African Republic","2025-02-24",0,0,99,329,0,99,0,329
"Central African Republic","2025-02-25",0,0,99,329,0,99,0,329
"Central African Republic","2025-02-26",0,0,99,329,0,99,0,329
"Central African Republic","2025-02-27",0,0,99,329,0,99,0,329
"Central African Republic","2025-02-28",0,0,99,329,0,99,0,329
"Central African Republic","2025-03-01",0,0,99,329,0,99,0,329
"Central African Republic","2025-03-02",0,0,99,329,0,99,0,329
"Central African Republic","2025-03-03",0,0,99,329,0,99,0,329
"Chile","2024-01-01",0,0,0,0,0,0,0,0
"Chile","2024-01-02",0,1,1,0,1,1,0,0
"Chile","2024-01-03",0,0,1,0,0,1,0,0
"Chile","2024-01-04",0,0,1,0,0,1,0,0
"Chile","2024-01-05",0,0,1,0,0,1,0,0
"Chile","2024-01-06",0,0,1,0,0,1,0,0
"Chile","2024-01-07",0,0,1,0,0,1,0,0
"Chile","2024-01-08",0,0,1,0,0,1,0,0
"Chile","2024-01-09",0,0,1,0,0,1,0,0
"Chile","2024-01-10",0,0,1,0,0,1,0,0
"Chile","2024-01-11",0,0,1,0,0,1,0,0
"Chile","2024-01-12",0,0,1,0,0,1,0,0
"Chile","2024-01-13",0,0,1,0,0,1,0,0
"Chile","2024-01-14",0,0,1,0,0,1,0,0
"Chile","2024-01-15",0,0,1,0,0,1,0,0
"Chile","2024-01-16",0,0,1,0,0,1,0,0
"Chile","2024-01-17",0,0,1,0,0,1,0,0
"Chile","2024-01-18",0,0,1,0,0,1,0,0
"Chile","2024-01-19",0,0,1,0,0,1,0,0
"Chile","2024-01-20",0,0,1,0,1,2,0,0
"Chile","2024-01-21",0,0,1,0,0,2,0,0
"Chile","2024-01-22",0,0,1,0,0,2,0,0
"Chile","2024-01-23",0,0,1,0,0,2,0,0
"Chile","2024-01-24",0,0,1,0,0,2,0,0
"Chile","2024-01-25",0,0,1,0,0,2,0,0
"Chile","2024-01-26",0,0,1,0,0,2,0,0
"Chile","2024-01-27",0,0,1,0,0,2,0,0
"Chile","2024-01-28",0,0,1,0,0,2,0,0
"Chile","2024-01-29",0,0,1,0,0,2,0,0
"Chile","2024-01-30",0,0,1,0,0,2,0,0
"Chile","2024-01-31",0,0,1,0,0,2,0,0
"Chile","2024-02-01",0,0,1,0,0,2,0,0
"Chile","2024-02-02",0,0,1,0,0,2,0,0
"Chile","2024-02-03",0,0,1,0,0,2,0,0
"Chile","2024-02-04",0,0,1,0,0,2,0,0
"Chile","2024-02-05",0,0,1,0,0,2,0,0
"Chile","2024-02-06",0,1,2,0,0,2,0,0
"Chile","2024-02-07",0,0,2,0,0,2,0,0
"Chile","2024-02-08",0,0,2,0,0,2,0,0
"Chile","2024-02-09",0,0,2,0,0,2,0,0
"Chile","2024-02-10",0,0,2,0,0,2,0,0
"Chile","2024-02-11",0,0,2,0,0,2,0,0
"Chile","2024-02-12",0,0,2,0,0,2,0,0
"Chile","2024-02-13",0,0,2,0,0,2,0,0
"Chile","2024-02-14",0,0,2,0,1,3,0,0
"Chile","2024-02-15",0,0,2,0,0,3,0,0
"Chile","2024-02-16",0,0,2,0,0,3,0,0
"Chile","2024-02-17",0,0,2,0,0,3,0,0
"Chile","2024-02-18",0,0,2,0,0,3,0,0
"Chile","2024-02-19",0,0,2,0,0,3,0,0
"Chile","2024-02-20",0,1,3,0,0,3,0,0
"Chile","2024-02-21",0,0,3,0,0,3,0,0
"Chile","2024-02-22",0,0,3,0,0,3,0,0
"Chile","2024-02-23",0,0,3,0,0,3,0,0
"Chile","2024-02-24",0,0,3,0,1,4,0,0
"Chile","2024-02-25",0,0,3,0,0,4,0,0
"Chile","2024-02-26",0,0,3,0,0,4,0,0
"Chile","2024-02-27",0,1,4,0,0,4,0,0
"Chile","2024-02-28",0,0,4,0,0,4,0,0
"Chile","2024-02-29",0,0,4,0,1,5,0,0
"Chile","2024-03-01",0,0,4,0,0,5,0,0
"Chile","2024-03-02",0,0,4,0,0,5,0,0
"Chile","2024-03-03",0,0,4,0,0,5,0,0
"Chile","2024-03-04",0,0,4,0,1,6,0,0
"Chile","2024-03-05",0,2,6,0,0,6,0,0
"Chile","2024-03-06",0,0,6,0,0,6,0,0
"Chile","2024-03-07",0,0,6,0,0,6,0,0
"Chile","2024-03-08",0,0,6,0,0,6,0,0
"Chile","2024-03-09",0,0,6,0,0,6,0,0
"Chile","2024-03-10",0,0,6,0,0,6,0,0
"Chile","2024-03-11",0,0,6,0,0,6,0,0
"Chile","2024-03-12",0,0,6,0,0,6,0,0
"Chile","2024-03-13",0,0,6,0,0,6,0,0
"Chile","2024-03-14",0,0,6,0,0,6,0,0
"Chile","2024-03-15",0,0,6,0,0,6,0,0
"Chile","2024-03-16",0,0,6,0,0,6,0,0
"Chile","2024-03-17",0,0,6,0,0,6,0,0
"Chile","2024-03-18",0,0,6,0,0,6,0,0
"Chile","2024-03-19",0,0,6,0,0,6,0,0
"Chile","2024-03-20",0,0,6,0,0,6,0,0
"Chile","2024-03-21",0,0,6,0,0,6,0,0
"Chile","2024-03-22",0,0,6,0,0,6,0,0
"Chile","2024-03-23",0,0,6,0,0,6,0,0
"Chile","2024-03-24",0,0,6,0,0,6,0,0
"Chile","2024-03-25",0,0,6,0,0,6,0,0
"Chile","2024-03-26",0,0,6,0,0,6,0,0
"Chile","2024-03-27",0,0,6,0,0,6,0,0
"Chile","2024-03-28",0,0,6,0,0,6,0,0
"Chile","2024-03-29",0,0,6,0,0,6,0,0
"Chile","2024-03-30",0,0,6,0,0,6,0,0
"Chile","2024-03-31",0,0,6,0,0,6,0,0
"Chile","2024-04-01",0,0,6,0,0,6,0,0
"Chile","2024-04-02",0,0,6,0,0,6,0,0
"Chile","2024-04-03",0,0,6,0,0,6,0,0
"Chile","2024-04-04",0,0,6,0,0,6,0,0
"Chile","2024-04-05",0,0,6,0,0,6,0,0
"Chile","2024-04-06",0,0,6,0,0,6,0,0
"Chile","2024-04-07",0,0,6,0,0,6,0,0
"Chile","2024-04-08",0,0,6,0,0,6,0,0
"Chile","2024-04-09",0,0,6,0,0,6,0,0
"Chile","2024-04-10",0,0,6,0,0,6,0,0
"Chile","2024-04-11",0,0,6,0,0,6,0,0
"Chile","2024-04-12",0,0,6,0,0,6,0,0
"Chile","2024-04-13",0,0,6,0,0,6,0,0
"Chile","2024-04-14",0,0,6,0,0,6,0,0
"Chile","2024-04-15",0,0,6,0,0,6,0,0
"Chile","2024-04-16",0,0,6,0,0,6,0,0
"Chile","2024-04-17",0,0,6,0,0,6,0,0
"Chile","2024-04-18",0,0,6,0,0,6,0,0
"Chile","2024-04-19",0,0,6,0,0,6,0,0
"Chile","2024-04-20",0,0,6,0,0,6,0,0
"Chile","2024-04-21",0,0,6,0,0,6,0,0
"Chile","2024-04-22",0,0,6,0,0,6,0,0
"Chile","2024-04-23",0,0,6,0,0,6,0,0
"Chile","2024-04-24",0,0,6,0,0,6,0,0
"Chile","2024-04-25",0,0,6,0,0,6,0,0
"Chile","2024-04-26",0,0,6,0,0,6,0,0
"Chile","2024-04-27",0,0,6,0,0,6,0,0
"Chile","2024-04-28",0,0,6,0,0,6,0,0
"Chile","2024-04-29",0,0,6,0,0,6,0,0
"Chile","2024-04-30",0,0,6,0,0,6,0,0
"Chile","2024-05-01",0,0,6,0,0,6,0,0
"Chile","2024-05-02",0,0,6,0,0,6,0,0
"Chile","2024-05-03",0,0,6,0,0,6,0,0
"Chile","2024-05-04",0,0,6,0,0,6,0,0
"Chile","2024-05-05",0,0,6,0,0,6,0,0
"Chile","2024-05-06",0,0,6,0,0,6,0,0
"Chile","2024-05-07",0,0,6,0,0,6,0,0
"Chile","2024-05-08",0,0,6,0,0,6,0,0
"Chile","2024-05-09",0,0,6,0,0,6,0,0
"Chile","2024-05-10",0,0,6,0,0,6,0,0
"Chile","2024-05-11",0,0,6,0,0,6,0,0
"Chile","2024-05-12",0,0,6,0,0,6,0,0
"Chile","2024-05-13",0,0,6,0,0,6,0,0
"Chile","2024-05-14",0,0,6,0,0,6,0,0
"Chile","2024-05-15",0,0,6,0,1,7,0,0
"Chile","2024-05-16",0,0,6,0,0,7,0,0
"Chile","2024-05-17",0,0,6,0,0,7,0,0
"Chile","2024-05-18",0,0,6,0,0,7,0,0
"Chile","2024-05-19",0,0,6,0,0,7,0,0
"Chile","2024-05-20",0,0,6,0,0,7,0,0
"Chile","2024-05-21",0,0,6,0,0,7,0,0
"Chile","2024-05-22",0,0,6,0,0,7,0,0
"Chile","2024-05-23",0,0,6,0,0,7,0,0
"Chile","2024-05-24",0,0,6,0,0,7,0,0
"Chile","2024-05-25",0,0,6,0,0,7,0,0
"Chile","2024-05-26",0,0,6,0,0,7,0,0
"Chile","2024-05-27",0,0,6,0,0,7,0,0
"Chile","2024-05-28",0,0,6,0,0,7,0,0
"Chile","2024-05-29",0,0,6,0,0,7,0,0
"Chile","2024-05-30",0,0,6,0,0,7,0,0
"Chile","2024-05-31",0,0,6,0,0,7,0,0
"Chile","2024-06-01",0,0,6,0,0,7,0,0
"Chile","2024-06-02",0,0,6,0,0,7,0,0
"Chile","2024-06-03",0,0,6,0,0,7,0,0
"Chile","2024-06-04",0,0,6,0,0,7,0,0
"Chile","2024-06-05",0,0,6,0,0,7,0,0
"Chile","2024-06-06",0,0,6,0,0,7,0,0
"Chile","2024-06-07",0,0,6,0,0,7,0,0
"Chile","2024-06-08",0,0,6,0,0,7,0,0
"Chile","2024-06-09",0,0,6,0,0,7,0,0
"Chile","2024-06-10",0,0,6,0,0,7,0,0
"Chile","2024-06-11",0,0,6,0,0,7,0,0
"Chile","2024-06-12",0,0,6,0,0,7,0,0
"Chile","2024-06-13",0,0,6,0,0,7,0,0
"Chile","2024-06-14",0,0,6,0,0,7,0,0
"Chile","2024-06-15",0,0,6,0,0,7,0,0
"Chile","2024-06-16",0,0,6,0,0,7,0,0
"Chile","2024-06-17",0,0,6,0,0,7,0,0
"Chile","2024-06-18",0,0,6,0,0,7,0,0
"Chile","2024-06-19",0,0,6,0,0,7,0,0
"Chile","2024-06-20",0,0,6,0,0,7,0,0
"Chile","2024-06-21",0,0,6,0,0,7,0,0
"Chile","2024-06-22",0,0,6,0,0,7,0,0
"Chile","2024-06-23",0,0,6,0,0,7,0,0
"Chile","2024-06-24",0,0,6,0,0,7,0,0
"Chile","2024-06-25",0,0,6,0,0,7,0,0
"Chile","2024-06-26",0,0,6,0,0,7,0,0
"Chile","2024-06-27",0,0,6,0,0,7,0,0
"Chile","2024-06-28",0,0,6,0,0,7,0,0
"Chile","2024-06-29",0,0,6,0,0,7,0,0
"Chile","2024-06-30",0,0,6,0,0,7,0,0
"Chile","2024-07-01",0,0,6,0,0,7,0,0
"Chile","2024-07-02",0,0,6,0,0,7,0,0
"Chile","2024-07-03",0,0,6,0,0,7,0,0
"Chile","2024-07-04",0,0,6,0,0,7,0,0
"Chile","2024-07-05",0,0,6,0,0,7,0,0
"Chile","2024-07-06",0,0,6,0,0,7,0,0
"Chile","2024-07-07",0,0,6,0,0,7,0,0
"Chile","2024-07-08",0,0,6,0,0,7,0,0
"Chile","2024-07-09",0,0,6,0,0,7,0,0
"Chile","2024-07-10",0,0,6,0,0,7,0,0
"Chile","2024-07-11",0,0,6,0,0,7,0,0
"Chile","2024-07-12",0,0,6,0,0,7,0,0
"Chile","2024-07-13",0,0,6,0,0,7,0,0
"Chile","2024-07-14",0,0,6,0,0,7,0,0
"Chile","2024-07-15",0,0,6,0,0,7,0,0
"Chile","2024-07-16",0,0,6,0,0,7,0,0
"Chile","2024-07-17",0,0,6,0,0,7,0,0
"Chile","2024-07-18",0,0,6,0,0,7,0,0
"Chile","2024-07-19",0,0,6,0,0,7,0,0
"Chile","2024-07-20",0,0,6,0,0,7,0,0
"Chile","2024-07-21",0,0,6,0,0,7,0,0
"Chile","2024-07-22",0,0,6,0,0,7,0,0
"Chile","2024-07-23",0,1,7,0,0,7,0,0
"Chile","2024-07-24",0,0,7,0,0,7,0,0
"Chile","2024-07-25",0,0,7,0,0,7,0,0
"Chile","2024-07-26",0,0,7,0,0,7,0,0
"Chile","2024-07-27",0,0,7,0,0,7,0,0
"Chile","2024-07-28",0,0,7,0,0,7,0,0
"Chile","2024-07-29",0,0,7,0,0,7,0,0
"Chile","2024-07-30",0,0,7,0,0,7,0,0
"Chile","2024-07-31",0,0,7,0,0,7,0,0
"Chile","2024-08-01",0,0,7,0,0,7,0,0
"Chile","2024-08-02",0,0,7,0,0,7,0,0
"Chile","2024-08-03",0,0,7,0,0,7,0,0
"Chile","2024-08-04",0,0,7,0,0,7,0,0
"Chile","2024-08-05",0,0,7,0,0,7,0,0
"Chile","2024-08-06",0,0,7,0,0,7,0,0
"Chile","2024-08-07",0,0,7,0,0,7,0,0
"Chile","2024-08-08",0,0,7,0,0,7,0,0
"Chile","2024-08-09",0,0,7,0,0,7,0,0
"Chile","2024-08-10",0,0,7,0,1,8,0,0
"Chile","2024-08-11",0,0,7,0,0,8,0,0
"Chile","2024-08-12",0,0,7,0,0,8,0,0
"Chile","2024-08-13",0,0,7,0,0,8,0,0
"Chile","2024-08-14",0,0,7,0,0,8,0,0
"Chile","2024-08-15",0,0,7,0,0,8,0,0
"Chile","2024-08-16",0,0,7,0,0,8,0,0
"Chile","2024-08-17",0,0,7,0,0,8,0,0
"Chile","2024-08-18",0,0,7,0,0,8,0,0
"Chile","2024-08-19",0,0,7,0,0,8,0,0
"Chile","2024-08-20",0,0,7,0,0,8,0,0
"Chile","2024-08-21",0,0,7,0,0,8,0,0
"Chile","2024-08-22",0,0,7,0,0,8,0,0
"Chile","2024-08-23",0,0,7,0,0,8,0,0
"Chile","2024-08-24",0,0,7,0,0,8,0,0
"Chile","2024-08-25",0,0,7,0,0,8,0,0
"Chile","2024-08-26",0,0,7,0,0,8,0,0
"Chile","2024-08-27",0,1,8,0,0,8,0,0
"Chile","2024-08-28",0,0,8,0,0,8,0,0
"Chile","2024-08-29",0,0,8,0,0,8,0,0
"Chile","2024-08-30",0,0,8,0,0,8,0,0
"Chile","2024-08-31",0,0,8,0,1,9,0,0
"Chile","2024-09-01",0,0,8,0,0,9,0,0
"Chile","2024-09-02",0,0,8,0,0,9,0,0
"Chile","2024-09-03",0,1,9,0,0,9,0,0
"Chile","2024-09-04",0,0,9,0,0,9,0,0
"Chile","2024-09-05",0,0,9,0,0,9,0,0
"Chile","2024-09-06",0,0,9,0,0,9,0,0
"Chile","2024-09-07",0,0,9,0,0,9,0,0
"Chile","2024-09-08",0,0,9,0,0,9,0,0
"Chile","2024-09-09",0,0,9,0,0,9,0,0
"Chile","2024-09-10",0,0,9,0,0,9,0,0
"Chile","2024-09-11",0,0,9,0,0,9,0,0
"Chile","2024-09-12",0,0,9,0,0,9,0,0
"Chile","2024-09-13",0,0,9,0,0,9,0,0
"Chile","2024-09-14",0,0,9,0,1,10,0,0
"Chile","2024-09-15",0,0,9,0,0,10,0,0
"Chile","2024-09-16",0,0,9,0,0,10,0,0
"Chile","2024-09-17",0,0,9,0,0,10,0,0
"Chile","2024-09-18",0,0,9,0,0,10,0,0
"Chile","2024-09-19",0,0,9,0,0,10,0,0
"Chile","2024-09-20",0,0,9,0,0,10,0,0
"Chile","2024-09-21",0,0,9,0,0,10,0,0
"Chile","2024-09-22",0,0,9,0,0,10,0,0
"Chile","2024-09-23",0,0,9,0,0,10,0,0
"Chile","2024-09-24",0,1,10,0,0,10,0,0
"Chile","2024-09-25",0,0,10,0,0,10,0,0
"Chile","2024-09-26",0,0,10,0,1,11,0,0
"Chile","2024-09-27",0,0,10,0,0,11,0,0
"Chile","2024-09-28",0,0,10,0,0,11,0,0
"Chile","2024-09-29",0,0,10,0,0,11,0,0
"Chile","2024-09-30",0,0,10,0,1,12,0,0
"Chile","2024-10-01",0,2,12,0,0,12,0,0
"Chile","2024-10-02",0,0,12,0,0,12,0,0
"Chile","2024-10-03",0,0,12,0,0,12,0,0
"Chile","2024-10-04",0,0,12,0,0,12,0,0
"Chile","2024-10-05",0,0,12,0,1,13,0,0
"Chile","2024-10-06",0,0,12,0,0,13,0,0
"Chile","2024-10-07",0,0,12,0,0,13,0,0
"Chile","2024-10-08",0,1,13,0,0,13,0,0
"Chile","2024-10-09",0,0,13,0,0,13,0,0
"Chile","2024-10-10",0,0,13,0,0,13,0,0
"Chile","2024-10-11",0,0,13,0,1,14,0,0
"Chile","2024-10-12",0,0,13,0,0,14,0,0
"Chile","2024-10-13",0,0,13,0,0,14,0,0
"Chile","2024-10-14",0,0,13,0,0,14,0,0
"Chile","2024-10-15",0,0,13,0,1,15,0,0
"Chile","2024-10-16",0,0,13,0,0,15,0,0
"Chile","2024-10-17",0,0,13,0,0,15,0,0
"Chile","2024-10-18",0,0,13,0,0,15,0,0
"Chile","2024-10-19",0,0,13,0,0,15,0,0
"Chile","2024-10-20",0,0,13,0,1,16,0,0
"Chile","2024-10-21",0,0,13,0,0,16,0,0
"Chile","2024-10-22",0,3,16,0,0,16,0,0
"Chile","2024-10-23",0,0,16,0,0,16,0,0
"Chile","2024-10-24",0,0,16,0,1,17,0,0
"Chile","2024-10-25",0,0,16,0,0,17,0,0
"Chile","2024-10-26",0,0,16,0,1,18,0,0
"Chile","2024-10-27",0,0,16,0,0,18,0,0
"Chile","2024-10-28",0,0,16,0,1,19,0,0
"Chile","2024-10-29",0,3,19,0,0,19,0,0
"Chile","2024-10-30",0,0,19,0,1,20,0,0
"Chile","2024-10-31",0,0,19,0,0,20,0,0
"Chile","2024-11-01",0,0,19,0,1,21,0,0
"Chile","2024-11-02",0,0,19,0,1,22,0,0
"Chile","2024-11-03",0,0,19,0,1,23,0,0
"Chile","2024-11-04",0,0,19,0,0,23,0,0
"Chile","2024-11-05",0,5,24,0,1,24,0,0
"Chile","2024-11-06",0,0,24,0,0,24,0,0
"Chile","2024-11-07",0,0,24,0,1,25,0,0
"Chile","2024-11-08",0,0,24,0,0,25,0,0
"Chile","2024-11-09",0,0,24,0,0,25,0,0
"Chile","2024-11-10",0,0,24,0,0,25,0,0
"Chile","2024-11-11",0,0,24,0,1,26,0,0
"Chile","2024-11-12",0,2,26,0,0,26,0,0
"Chile","2024-11-13",0,0,26,0,0,26,0,0
"Chile","2024-11-14",0,0,26,0,0,26,0,0
"Chile","2024-11-15",0,0,26,0,0,26,0,0
"Chile","2024-11-16",0,0,26,0,1,27,0,0
"Chile","2024-11-17",0,0,26,0,0,27,0,0
"Chile","2024-11-18",0,0,26,0,0,27,0,0
"Chile","2024-11-19",0,1,27,0,0,27,0,0
"Chile","2024-11-20",0,0,27,0,0,27,0,0
"Chile","2024-11-21",0,0,27,0,1,28,0,0
"Chile","2024-11-22",0,0,27,0,0,28,0,0
"Chile","2024-11-23",0,0,27,0,0,28,0,0
"Chile","2024-11-24",0,0,27,0,0,28,0,0
"Chile","2024-11-25",0,0,27,0,1,29,0,0
"Chile","2024-11-26",0,0,27,0,0,29,0,0
"Chile","2024-11-27",0,0,27,0,0,29,0,0
"Chile","2024-11-28",0,0,27,0,1,30,0,0
"Chile","2024-11-29",0,0,27,0,0,30,0,0
"Chile","2024-11-30",0,0,27,0,0,30,0,0
"Chile","2024-12-01",0,0,27,0,0,30,0,0
"Chile","2024-12-02",0,0,27,0,1,31,0,0
"Chile","2024-12-03",0,4,31,0,0,31,0,0
"Chile","2024-12-04",0,0,31,0,0,31,0,0
"Chile","2024-12-05",0,0,31,0,1,32,0,0
"Chile","2024-12-06",0,0,31,0,0,32,0,0
"Chile","2024-12-07",0,0,31,0,1,33,0,0
"Chile","2024-12-08",0,0,31,0,0,33,0,0
"Chile","2024-12-09",0,0,31,0,1,34,0,0
"Chile","2024-12-10",0,3,34,0,0,34,0,0
"Chile","2024-12-11",0,0,34,0,1,35,0,0
"Chile","2024-12-12",0,0,34,0,0,35,0,0
"Chile","2024-12-13",0,0,34,0,1,36,0,0
"Chile","2024-12-14",0,0,34,0,0,36,0,0
"Chile","2024-12-15",0,0,34,0,1,37,0,0
"Chile","2024-12-16",0,0,34,0,0,37,0,0
"Chile","2024-12-17",0,4,38,0,1,38,0,0
"Chile","2024-12-18",0,0,38,0,0,38,0,0
"Chile","2024-12-19",0,0,38,0,1,39,0,0
"Chile","2024-12-20",0,0,38,0,0,39,0,0
"Chile","2024-12-21",0,0,38,0,1,40,0,0
"Chile","2024-12-22",0,0,38,0,0,40,0,0
"Chile","2024-12-23",0,0,38,0,1,41,0,0
"Chile","2024-12-24",0,3,41,0,0,41,0,0
"Chile","2024-12-25",0,0,41,0,0,41,0,0
"Chile","2024-12-26",0,0,41,0,1,42,0,0
"Chile","2024-12-27",0,0,41,0,0,42,0,0
"Chile","2024-12-28",0,0,41,0,0,42,0,0
"Chile","2024-12-29",0,0,41,0,0,42,0,0
"Chile","2024-12-30",0,0,41,0,1,43,0,0
"Chile","2024-12-31",0,2,43,0,0,43,0,0
"Chile","2025-01-01",0,0,43,0,0,43,0,0
"Chile","2025-01-02",0,0,43,0,1,44,0,0
"Chile","2025-01-03",0,0,43,0,0,44,0,0
"Chile","2025-01-04",0,0,43,0,0,44,0,0
"Chile","2025-01-05",0,0,43,0,0,44,0,0
"Chile","2025-01-06",0,0,43,0,1,45,0,0
"Chile","2025-01-07",0,2,45,0,0,45,0,0
"Chile","2025-01-08",0,0,45,0,0,45,0,0
"Chile","2025-01-09",0,0,45,0,1,46,0,0
"Chile","2025-01-10",0,0,45,0,0,46,0,0
"Chile","2025-01-11",0,0,45,0,0,46,0,0
"Chile","2025-01-12",0,0,45,0,0,46,0,0
"Chile","2025-01-13",0,0,45,0,1,47,0,0
"Chile","2025-01-14",0,0,45,0,0,47,0,0
"Chile","2025-01-15",0,0,45,0,0,47,0,0
"Chile","2025-01-16",0,0,45,0,1,48,0,0
"Chile","2025-01-17",0,0,45,0,0,48,0,0
"Chile","2025-01-18",0,0,45,0,0,48,0,0
"Chile","2025-01-19",0,0,45,0,0,48,0,0
"Chile","2025-01-20",0,0,45,0,1,49,0,0
"Chile","2025-01-21",0,4,49,0,0,49,0,0
"Chile","2025-01-22",0,0,49,0,1,50,0,0
"Chile","2025-01-23",0,0,49,0,0,50,0,0
"Chile","2025-01-24",0,0,49,0,1,51,0,0
"Chile","2025-01-25",0,0,49,0,1,52,0,0
"Chile","2025-01-26",0,0,49,0,1,53,0,0
"Chile","2025-01-27",0,0,49,0,0,53,0,0
"Chile","2025-01-28",0,5,54,0,1,54,0,0
"Chile","2025-01-29",0,0,54,0,0,54,0,0
"Chile","2025-01-30",0,0,54,0,0,54,0,0
"Chile","2025-01-31",0,0,54,0,0,54,0,0
"Chile","2025-02-01",0,0,54,0,0,54,0,0
"Chile","2025-02-02",0,0,54,0,0,54,0,0
"Chile","2025-02-03",0,0,54,0,0,54,0,0
"Chile","2025-02-04",0,0,54,0,0,54,0,0
"Chile","2025-02-05",0,0,54,0,0,54,0,0
"Chile","2025-02-06",0,0,54,0,0,54,0,0
"Chile","2025-02-07",0,0,54,0,0,54,0,0
"Chile","2025-02-08",0,0,54,0,0,54,0,0
"Chile","2025-02-09",0,0,54,0,0,54,0,0
"Chile","2025-02-10",0,0,54,0,0,54,0,0
"Chile","2025-02-11",0,0,54,0,0,54,0,0
"Chile","2025-02-12",0,0,54,0,0,54,0,0
"Chile","2025-02-13",0,0,54,0,0,54,0,0
"Chile","2025-02-14",0,0,54,0,0,54,0,0
"Chile","2025-02-15",0,0,54,0,0,54,0,0
"Chile","2025-02-16",0,0,54,0,0,54,0,0
"Chile","2025-02-17",0,0,54,0,0,54,0,0
"Chile","2025-02-18",0,0,54,0,0,54,0,0
"Chile","2025-02-19",0,0,54,0,0,54,0,0
"Chile","2025-02-20",0,0,54,0,0,54,0,0
"Chile","2025-02-21",0,0,54,0,0,54,0,0
"Chile","2025-02-22",0,0,54,0,0,54,0,0
"Chile","2025-02-23",0,0,54,0,0,54,0,0
"Chile","2025-02-24",0,0,54,0,0,54,0,0
"Chile","2025-02-25",0,0,54,0,0,54,0,0
"Chile","2025-02-26",0,0,54,0,0,54,0,0
"Chile","2025-02-27",0,0,54,0,0,54,0,0
"Chile","2025-02-28",0,0,54,0,0,54,0,0
"Chile","2025-03-01",0,0,54,0,0,54,0,0
"Chile","2025-03-02",0,0,54,0,0,54,0,0
"Chile","2025-03-03",0,0,54,0,0,54,0,0
"China","2024-01-01",0,0,0,0,0,0,0,0
"China","2024-01-02",0,0,0,0,0,0,0,0
"China","2024-01-03",0,0,0,0,0,0,0,0
"China","2024-01-04",0,0,0,0,0,0,0,0
"China","2024-01-05",0,0,0,0,0,0,0,0
"China","2024-01-06",0,0,0,0,0,0,0,0
"China","2024-01-07",0,0,0,0,0,0,0,0
"China","2024-01-08",0,0,0,0,0,0,0,0
"China","2024-01-09",0,0,0,0,0,0,0,0
"China","2024-01-10",0,0,0,0,0,0,0,0
"China","2024-01-11",0,0,0,0,0,0,0,0
"China","2024-01-12",0,1,1,0,1,1,0,0
"China","2024-01-13",0,0,1,0,0,1,0,0
"China","2024-01-14",0,0,1,0,0,1,0,0
"China","2024-01-15",0,0,1,0,1,2,0,0
"China","2024-01-16",0,0,1,0,0,2,0,0
"China","2024-01-17",0,1,2,0,0,2,0,0
"China","2024-01-18",0,0,2,0,0,2,0,0
"China","2024-01-19",0,0,2,0,0,2,0,0
"China","2024-01-20",0,0,2,0,0,2,0,0
"China","2024-01-21",0,0,2,0,1,3,0,0
"China","2024-01-22",0,0,2,0,0,3,0,0
"China","2024-01-23",0,0,2,0,0,3,0,0
"China","2024-01-24",0,1,3,0,0,3,0,0
"China","2024-01-25",0,0,3,0,14,17,0,0
"China","2024-01-26",0,0,3,0,14,31,0,0
"China","2024-01-27",0,0,3,0,14,45,0,0
"China","2024-01-28",0,0,3,0,13,58,0,0
"China","2024-01-29",0,0,3,0,14,72,0,0
"China","2024-01-30",0,0,3,0,14,86,0,0
"China","2024-01-31",0,97,100,0,14,100,0,0
"China","2024-02-01",0,0,100,0,0,100,0,0
"China","2024-02-02",0,1,101,0,1,101,0,0
"China","2024-02-03",0,0,101,0,0,101,0,0
"China","2024-02-04",0,0,101,0,0,101,0,0
"China","2024-02-05",0,0,101,0,0,101,0,0
"China","2024-02-06",0,0,101,0,0,101,0,0
"China","2024-02-07",0,0,101,0,0,101,0,0
"China","2024-02-08",0,0,101,0,0,101,0,0
"China","2024-02-09",0,0,101,0,1,102,0,0
"China","2024-02-10",0,0,101,0,0,102,0,0
"China","2024-02-11",0,0,101,0,0,102,0,0
"China","2024-02-12",0,0,101,0,0,102,0,0
"China","2024-02-13",0,0,101,0,0,102,0,0
"China","2024-02-14",0,0,101,0,0,102,0,0
"China","2024-02-15",0,1,102,0,0,102,0,0
"China","2024-02-16",0,0,102,0,0,102,0,0
"China","2024-02-17",0,0,102,0,0,102,0,0
"China","2024-02-18",0,0,102,0,0,102,0,0
"China","2024-02-19",0,0,102,0,0,102,0,0
"China","2024-02-20",0,0,102,0,1,103,0,0
"China","2024-02-21",0,0,102,0,0,103,0,0
"China","2024-02-22",0,0,102,0,0,103,0,0
"China","2024-02-23",0,1,103,0,0,103,0,0
"China","2024-02-24",0,0,103,0,12,115,0,0
"China","2024-02-25",0,0,103,0,11,126,0,0
"China","2024-02-26",0,0,103,0,12,138,0,0
"China","2024-02-27",0,0,103,0,12,150,0,0
"China","2024-02-28",0,0,103,0,11,161,0,0
"China","2024-02-29",0,70,173,0,12,173,0,0
"China","2024-03-01",0,3,176,0,3,176,0,0
"China","2024-03-02",0,0,176,0,2,178,0,0
"China","2024-03-03",0,0,176,0,1,179,0,0
"China","2024-03-04",0,0,176,0,2,181,0,0
"China","2024-03-05",0,0,176,0,2,183,0,0
"China","2024-03-06",0,0,176,0,1,184,0,0
"China","2024-03-07",0,0,176,0,2,186,0,0
"China","2024-03-08",0,0,176,0,2,188,0,0
"China","2024-03-09",0,0,176,0,2,190,0,0
"China","2024-03-10",0,0,176,0,1,191,0,0
"China","2024-03-11",0,0,176,0,2,193,0,0
"China","2024-03-12",0,0,176,0,2,195,0,0
"China","2024-03-13",0,0,176,0,1,196,0,0
"China","2024-03-14",0,0,176,0,2,198,0,0
"China","2024-03-15",0,0,176,0,2,200,0,0
"China","2024-03-16",0,0,176,0,2,202,0,0
"China","2024-03-17",0,0,176,0,1,203,0,0
"China","2024-03-18",0,0,176,0,2,205,0,0
"China","2024-03-19",0,0,176,0,2,207,0,0
"China","2024-03-20",0,0,176,0,1,208,0,0
"China","2024-03-21",0,0,176,0,2,210,0,0
"China","2024-03-22",0,0,176,0,2,212,0,0
"China","2024-03-23",0,0,176,0,1,213,0,0
"China","2024-03-24",0,0,176,0,2,215,0,0
"China","2024-03-25",0,0,176,0,2,217,0,0
"China","2024-03-26",0,0,176,0,1,218,0,0
"China","2024-03-27",0,0,176,0,2,220,0,0
"China","2024-03-28",0,0,176,0,2,222,0,0
"China","2024-03-29",0,0,176,0,2,224,0,0
"China","2024-03-30",0,0,176,0,1,225,0,0
"China","2024-03-31",0,51,227,0,2,227,0,0
"China","2024-04-01",0,0,227,0,0,227,0,0
"China","2024-04-02",0,0,227,0,0,227,0,0
"China","2024-04-03",0,0,227,0,1,228,0,0
"China","2024-04-04",0,0,227,0,0,228,0,0
"China","2024-04-05",0,1,228,0,0,228,0,0
"China","2024-04-06",0,0,228,0,0,228,0,0
"China","2024-04-07",0,0,228,0,0,228,0,0
"China","2024-04-08",0,0,228,0,0,228,0,0
"China","2024-04-09",0,0,228,0,1,229,0,0
"China","2024-04-10",0,0,228,0,0,229,0,0
"China","2024-04-11",0,0,228,0,0,229,0,0
"China","2024-04-12",0,1,229,0,0,229,0,0
"China","2024-04-13",0,0,229,0,0,229,0,0
"China","2024-04-14",0,0,229,0,0,229,0,0
"China","2024-04-15",0,0,229,0,0,229,0,0
"China","2024-04-16",0,0,229,0,0,229,0,0
"China","2024-04-17",0,0,229,0,0,229,0,0
"China","2024-04-18",0,0,229,0,0,229,0,0
"China","2024-04-19",0,0,229,0,0,229,0,0
"China","2024-04-20",0,0,229,0,1,230,0,0
"China","2024-04-21",0,0,229,0,0,230,0,0
"China","2024-04-22",0,0,229,0,0,230,0,0
"China","2024-04-23",0,0,229,0,0,230,0,0
"China","2024-04-24",0,0,229,0,0,230,0,0
"China","2024-04-25",0,0,229,0,0,230,0,0
"China","2024-04-26",0,1,230,0,0,230,0,0
"China","2024-04-27",0,0,230,0,10,240,0,0
"China","2024-04-28",0,0,230,0,10,250,0,0
"China","2024-04-29",0,0,230,0,9,259,0,0
"China","2024-04-30",0,39,269,0,10,269,0,0
"China","2024-05-01",0,0,269,0,0,269,0,0
"China","2024-05-02",0,0,269,0,0,269,0,0
"China","2024-05-03",0,0,269,0,0,269,0,0
"China","2024-05-04",0,0,269,0,1,270,0,0
"China","2024-05-05",0,0,269,0,0,270,0,0
"China","2024-05-06",0,0,269,0,0,270,0,0
"China","2024-05-07",0,1,270,0,0,270,0,0
"China","2024-05-08",0,0,270,0,0,270,0,0
"China","2024-05-09",0,0,270,0,0,270,0,0
"China","2024-05-10",0,0,270,0,0,270,0,0
"China","2024-05-11",0,0,270,0,1,271,0,0
"China","2024-05-12",0,0,270,0,0,271,0,0
"China","2024-05-13",0,0,270,0,0,271,0,0
"China","2024-05-14",0,1,271,0,0,271,0,0
"China","2024-05-15",0,0,271,0,0,271,0,0
"China","2024-05-16",0,0,271,0,0,271,0,0
"China","2024-05-17",0,0,271,0,0,271,0,0
"China","2024-05-18",0,0,271,0,0,271,0,0
"China","2024-05-19",0,0,271,0,1,272,0,0
"China","2024-05-20",0,0,271,0,0,272,0,0
"China","2024-05-21",0,0,271,0,0,272,0,0
"China","2024-05-22",0,1,272,0,0,272,0,0
"China","2024-05-23",0,0,272,0,2,274,0,0
"China","2024-05-24",0,3,275,0,1,275,0,0
"China","2024-05-25",0,0,275,0,0,275,0,0
"China","2024-05-26",0,0,275,0,1,276,0,0
"China","2024-05-27",0,1,276,0,0,276,0,0
"China","2024-05-28",0,0,276,0,16,292,0,0
"China","2024-05-29",0,0,276,0,17,309,0,0
"China","2024-05-30",0,49,325,0,16,325,0,0
"China","2024-05-31",0,1,326,0,1,326,0,0
"China","2024-06-01",0,0,326,0,0,326,0,0
"China","2024-06-02",0,0,326,0,0,326,0,0
"China","2024-06-03",0,0,326,0,0,326,0,0
"China","2024-06-04",0,0,326,0,1,327,0,0
"China","2024-06-05",0,0,326,0,0,327,0,0
"China","2024-06-06",0,0,326,0,0,327,0,0
"China","2024-06-07",0,0,326,0,0,327,0,0
"China","2024-06-08",0,0,326,0,0,327,0,0
"China","2024-06-09",0,0,326,0,1,328,0,0
"China","2024-06-10",0,0,326,0,0,328,0,0
"China","2024-06-11",0,0,326,0,0,328,0,0
"China","2024-06-12",0,0,326,0,0,328,0,0
"China","2024-06-13",0,0,326,0,0,328,0,0
"China","2024-06-14",0,0,326,0,0,328,0,0
"China","2024-06-15",0,0,326,0,0,328,0,0
"China","2024-06-16",0,0,326,0,1,329,0,0
"China","2024-06-17",0,0,326,0,0,329,0,0
"China","2024-06-18",0,0,326,0,0,329,0,0
"China","2024-06-19",0,0,326,0,0,329,0,0
"China","2024-06-20",0,0,326,0,0,329,0,0
"China","2024-06-21",0,0,326,0,1,330,0,0
"China","2024-06-22",0,0,326,0,0,330,0,0
"China","2024-06-23",0,0,326,0,0,330,0,0
"China","2024-06-24",0,4,330,0,0,330,0,0
"China","2024-06-25",0,3,333,0,3,333,0,0
"China","2024-06-26",0,0,333,0,10,343,0,0
"China","2024-06-27",0,0,333,0,10,353,0,0
"China","2024-06-28",0,0,333,0,11,364,0,0
"China","2024-06-29",0,0,333,0,10,374,0,0
"China","2024-06-30",0,51,384,0,10,384,0,0
"China","2024-07-01",0,0,384,0,0,384,0,0
"China","2024-07-02",0,0,384,0,0,384,0,0
"China","2024-07-03",0,0,384,0,1,385,0,0
"China","2024-07-04",0,0,384,0,0,385,0,0
"China","2024-07-05",0,0,384,0,0,385,0,0
"China","2024-07-06",0,0,384,0,1,386,0,0
"China","2024-07-07",0,0,384,0,0,386,0,0
"China","2024-07-08",0,2,386,0,0,386,0,0
"China","2024-07-09",0,0,386,0,1,387,0,0
"China","2024-07-10",0,0,386,0,1,388,0,0
"China","2024-07-11",0,0,386,0,0,388,0,0
"China","2024-07-12",0,0,386,0,1,389,0,0
"China","2024-07-13",0,0,386,0,1,390,0,0
"China","2024-07-14",0,0,386,0,0,390,0,0
"China","2024-07-15",0,0,386,0,1,391,0,0
"China","2024-07-16",0,6,392,0,1,392,0,0
"China","2024-07-17",0,0,392,0,1,393,0,0
"China","2024-07-18",0,0,392,0,1,394,0,0
"China","2024-07-19",0,0,392,0,0,394,0,0
"China","2024-07-20",0,0,392,0,1,395,0,0
"China","2024-07-21",0,0,392,0,1,396,0,0
"China","2024-07-22",0,0,392,0,0,396,0,0
"China","2024-07-23",0,0,392,0,1,397,0,0
"China","2024-07-24",0,0,392,0,1,398,0,0
"China","2024-07-25",0,0,392,0,1,399,0,0
"China","2024-07-26",0,0,392,0,1,400,0,0
"China","2024-07-27",0,0,392,0,0,400,0,0
"China","2024-07-28",0,9,401,0,1,401,0,0
"China","2024-07-29",0,0,401,0,20,421,0,0
"China","2024-07-30",0,39,440,0,19,440,0,0
"China","2024-07-31",0,0,440,0,1,441,0,0
"China","2024-08-01",0,0,440,0,0,441,0,0
"China","2024-08-02",0,2,442,0,1,442,0,0
"China","2024-08-03",0,0,442,0,0,442,0,0
"China","2024-08-04",0,0,442,0,1,443,0,0
"China","2024-08-05",0,0,442,0,1,444,0,0
"China","2024-08-06",0,2,444,0,0,444,0,0
"China","2024-08-07",0,0,444,0,1,445,0,0
"China","2024-08-08",0,0,444,0,0,445,0,0
"China","2024-08-09",0,0,444,0,1,446,0,0
"China","2024-08-10",0,0,444,0,1,447,0,0
"China","2024-08-11",0,0,444,0,1,448,0,0
"China","2024-08-12",0,0,444,0,0,448,0,0
"China","2024-08-13",0,5,449,0,1,449,0,0
"China","2024-08-14",0,0,449,0,1,450,0,0
"China","2024-08-15",0,0,449,0,0,450,0,0
"China","2024-08-16",0,0,449,0,1,451,0,0
"China","2024-08-17",0,0,449,0,0,451,0,0
"China","2024-08-18",0,0,449,0,1,452,0,0
"China","2024-08-19",0,0,449,0,0,452,0,0
"China","2024-08-20",0,4,453,0,1,453,0,0
"China","2024-08-21",0,0,453,0,0,453,0,0
"China","2024-08-22",0,0,453,0,0,453,0,0
"China","2024-08-23",0,0,453,0,0,453,0,0
"China","2024-08-24",0,0,453,0,1,454,0,0
"China","2024-08-25",0,0,453,0,0,454,0,0
"China","2024-08-26",0,0,453,0,0,454,0,0
"China","2024-08-27",0,1,454,0,0,454,0,0
"China","2024-08-28",0,0,454,0,12,466,0,0
"China","2024-08-29",0,0,454,0,12,478,0,0
"China","2024-08-30",0,0,454,0,13,491,0,0
"China","2024-08-31",0,49,503,0,12,503,0,0
"China","2024-09-01",0,0,503,0,1,504,0,0
"China","2024-09-02",0,0,503,0,0,504,0,0
"China","2024-09-03",0,0,503,0,1,505,0,0
"China","2024-09-04",0,0,503,0,1,506,0,0
"China","2024-09-05",0,0,503,0,0,506,0,0
"China","2024-09-06",0,0,503,0,1,507,0,0
"China","2024-09-07",0,0,503,0,1,508,0,0
"China","2024-09-08",0,0,503,0,0,508,0,0
"China","2024-09-09",0,0,503,0,1,509,0,0
"China","2024-09-10",0,0,503,0,1,510,0,0
"China","2024-09-11",0,0,503,0,0,510,0,0
"China","2024-09-12",0,0,503,0,1,511,0,0
"China","2024-09-13",0,0,503,0,1,512,0,0
"China","2024-09-14",0,0,503,0,0,512,0,0
"China","2024-09-15",0,10,513,0,1,513,0,0
"China","2024-09-16",0,0,513,0,0,513,0,0
"China","2024-09-17",0,0,513,0,1,514,0,0
"China","2024-09-18",0,0,513,0,0,514,0,0
"China","2024-09-19",0,0,513,0,1,515,0,0
"China","2024-09-20",0,0,513,0,0,515,0,0
"China","2024-09-21",0,0,513,0,0,515,0,0
"China","2024-09-22",0,0,513,0,1,516,0,0
"China","2024-09-23",0,3,516,0,0,516,0,0
"China","2024-09-24",0,0,516,0,1,517,0,0
"China","2024-09-25",0,0,516,0,1,518,0,0
"China","2024-09-26",0,0,516,0,1,519,0,0
"China","2024-09-27",0,0,516,0,1,520,0,0
"China","2024-09-28",0,0,516,0,1,521,0,0
"China","2024-09-29",0,6,522,0,1,522,0,0
"China","2024-09-30",0,46,568,0,46,568,0,0
"China","2024-10-01",0,6,574,0,6,574,0,0
"China","2024-10-02",0,0,574,0,0,574,0,0
"China","2024-10-03",0,1,575,0,1,575,0,0
"China","2024-10-04",0,0,575,0,0,575,0,0
"China","2024-10-05",0,0,575,0,1,576,0,0
"China","2024-10-06",0,0,575,0,0,576,0,0
"China","2024-10-07",0,0,575,0,0,576,0,0
"China","2024-10-08",0,0,575,0,0,576,0,0
"China","2024-10-09",0,0,575,0,1,577,0,0
"China","2024-10-10",0,2,577,0,0,577,0,0
"China","2024-10-11",0,0,577,0,0,577,0,0
"China","2024-10-12",0,0,577,0,0,577,0,0
"China","2024-10-13",0,0,577,0,0,577,0,0
"China","2024-10-14",0,0,577,0,1,578,0,0
"China","2024-10-15",0,0,577,0,0,578,0,0
"China","2024-10-16",0,0,577,0,0,578,0,0
"China","2024-10-17",0,0,577,0,0,578,0,0
"China","2024-10-18",0,0,577,0,0,578,0,0
"China","2024-10-19",0,0,577,0,0,578,0,0
"China","2024-10-20",0,0,577,0,1,579,0,0
"China","2024-10-21",0,0,577,0,0,579,0,0
"China","2024-10-22",0,0,577,0,0,579,0,0
"China","2024-10-23",0,2,579,0,0,579,0,0
"China","2024-10-24",0,0,579,0,1,580,0,0
"China","2024-10-25",0,0,579,0,0,580,0,0
"China","2024-10-26",0,0,579,0,1,581,0,0
"China","2024-10-27",0,0,579,0,1,582,0,0
"China","2024-10-28",0,0,579,0,0,582,0,0
"China","2024-10-29",0,4,583,0,1,583,0,0
"China","2024-10-30",0,0,583,0,19,602,0,0
"China","2024-10-31",0,38,621,0,19,621,0,0
"China","2024-11-01",0,0,621,0,0,621,0,0
"China","2024-11-02",0,0,621,0,1,622,0,0
"China","2024-11-03",0,0,621,0,1,623,0,0
"China","2024-11-04",0,0,621,0,0,623,0,0
"China","2024-11-05",0,0,621,0,0,623,0,0
"China","2024-11-06",0,3,624,0,1,624,0,0
"China","2024-11-07",0,0,624,0,0,624,0,0
"China","2024-11-08",0,0,624,0,1,625,0,0
"China","2024-11-09",0,0,624,0,0,625,0,0
"China","2024-11-10",0,0,624,0,0,625,0,0
"China","2024-11-11",0,0,624,0,1,626,0,0
"China","2024-11-12",0,0,624,0,0,626,0,0
"China","2024-11-13",0,0,624,0,0,626,0,0
"China","2024-11-14",0,0,624,0,1,627,0,0
"China","2024-11-15",0,3,627,0,0,627,0,0
"China","2024-11-16",0,0,627,0,0,627,0,0
"China","2024-11-17",0,0,627,0,0,627,0,0
"China","2024-11-18",0,0,627,0,1,628,0,0
"China","2024-11-19",0,1,628,0,0,628,0,0
"China","2024-11-20",0,0,628,0,1,629,0,0
"China","2024-11-21",0,0,628,0,2,631,0,0
"China","2024-11-22",0,0,628,0,1,632,0,0
"China","2024-11-23",0,0,628,0,2,634,0,0
"China","2024-11-24",0,0,628,0,1,635,0,0
"China","2024-11-25",0,0,628,0,2,637,0,0
"China","2024-11-26",0,0,628,0,1,638,0,0
"China","2024-11-27",0,0,628,0,2,640,0,0
"China","2024-11-28",0,0,628,0,1,641,0,0
"China","2024-11-29",0,0,628,0,2,643,0,0
"China","2024-11-30",0,16,644,0,1,644,0,0
"China","2024-12-01",0,0,644,0,1,645,0,0
"China","2024-12-02",0,0,644,0,0,645,0,0
"China","2024-12-03",0,2,646,0,1,646,0,0
"China","2024-12-04",0,0,646,0,0,646,0,0
"China","2024-12-05",0,0,646,0,0,646,0,0
"China","2024-12-06",0,0,646,0,0,646,0,0
"China","2024-12-07",0,0,646,0,1,647,0,0
"China","2024-12-08",0,0,646,0,0,647,0,0
"China","2024-12-09",0,0,646,0,0,647,0,0
"China","2024-12-10",0,1,647,0,0,647,0,0
"China","2024-12-11",0,0,647,0,0,647,0,0
"China","2024-12-12",0,0,647,0,1,648,0,0
"China","2024-12-13",0,0,647,0,0,648,0,0
"China","2024-12-14",0,0,647,0,0,648,0,0
"China","2024-12-15",0,0,647,0,0,648,0,0
"China","2024-12-16",0,0,647,0,1,649,0,0
"China","2024-12-17",0,2,649,0,0,649,0,0
"China","2024-12-18",0,0,649,0,0,649,0,0
"China","2024-12-19",0,0,649,0,0,649,0,0
"China","2024-12-20",0,0,649,0,0,649,0,0
"China","2024-12-21",0,0,649,0,1,650,0,0
"China","2024-12-22",0,0,649,0,0,650,0,0
"China","2024-12-23",0,0,649,0,0,650,0,0
"China","2024-12-24",0,1,650,0,0,650,0,0
"China","2024-12-25",0,0,650,0,0,650,0,0
"China","2024-12-26",0,0,650,0,0,650,0,0
"China","2024-12-27",0,0,650,0,0,650,0,0
"China","2024-12-28",0,0,650,0,1,651,0,0
"China","2024-12-29",0,0,650,0,0,651,0,0
"China","2024-12-30",0,0,650,0,0,651,0,0
"China","2024-12-31",0,1,651,0,0,651,0,0
"China","2025-01-01",0,0,651,0,4,655,0,0
"China","2025-01-02",0,0,651,0,4,659,0,0
"China","2025-01-03",0,0,651,0,4,663,0,0
"China","2025-01-04",0,0,651,0,4,667,0,0
"China","2025-01-05",0,0,651,0,5,672,0,0
"China","2025-01-06",0,0,651,0,4,676,0,0
"China","2025-01-07",0,0,651,0,4,680,0,0
"China","2025-01-08",0,33,684,0,4,684,0,0
"China","2025-01-09",0,0,684,0,0,684,0,0
"China","2025-01-10",0,0,684,0,0,684,0,0
"China","2025-01-11",0,0,684,0,0,684,0,0
"China","2025-01-12",0,0,684,0,1,685,0,0
"China","2025-01-13",0,0,684,0,0,685,0,0
"China","2025-01-14",0,0,684,0,0,685,0,0
"China","2025-01-15",0,0,684,0,0,685,0,0
"China","2025-01-16",0,0,684,0,0,685,0,0
"China","2025-01-17",0,0,684,0,0,685,0,0
"China","2025-01-18",0,0,684,0,1,686,0,0
"China","2025-01-19",0,0,684,0,0,686,0,0
"China","2025-01-20",0,0,684,0,0,686,0,0
"China","2025-01-21",0,2,686,0,0,686,0,0
"China","2025-01-22",0,0,686,0,3,689,0,0
"China","2025-01-23",0,0,686,0,4,693,0,0
"China","2025-01-24",0,0,686,0,3,696,0,0
"China","2025-01-25",0,0,686,0,4,700,0,0
"China","2025-01-26",0,0,686,0,3,703,0,0
"China","2025-01-27",0,0,686,0,3,706,0,0
"China","2025-01-28",0,0,686,0,4,710,0,0
"China","2025-01-29",0,0,686,0,3,713,0,0
"China","2025-01-30",0,0,686,0,4,717,0,0
"China","2025-01-31",0,34,720,0,3,720,0,0
"China","2025-02-01",0,0,720,0,0,720,0,0
"China","2025-02-02",0,0,720,0,0,720,0,0
"China","2025-02-03",0,0,720,0,0,720,0,0
"China","2025-02-04",0,0,720,0,1,721,0,0
"China","2025-02-05",0,0,720,0,0,721,0,0
"China","2025-02-06",0,0,720,0,0,721,0,0
"China","2025-02-07",0,1,721,0,0,721,0,0
"China","2025-02-08",0,0,721,0,0,721,0,0
"China","2025-02-09",0,0,721,0,0,721,0,0
"China","2025-02-10",0,0,721,0,0,721,0,0
"China","2025-02-11",0,0,721,0,0,721,0,0
"China","2025-02-12",0,0,721,0,0,721,0,0
"China","2025-02-13",0,0,721,0,0,721,0,0
"China","2025-02-14",0,0,721,0,0,721,0,0
"China","2025-02-15",0,0,721,0,0,721,0,0
"China","2025-02-16",0,0,721,0,0,721,0,0
"China","2025-02-17",0,0,721,0,0,721,0,0
"China","2025-02-18",0,0,721,0,0,721,0,0
"China","2025-02-19",0,0,721,0,0,721,0,0
"China","2025-02-20",0,0,721,0,0,721,0,0
"China","2025-02-21",0,0,721,0,0,721,0,0
"China","2025-02-22",0,0,721,0,0,721,0,0
"China","2025-02-23",0,0,721,0,0,721,0,0
"China","2025-02-24",0,0,721,0,0,721,0,0
"China","2025-02-25",0,0,721,0,0,721,0,0
"China","2025-02-26",0,0,721,0,0,721,0,0
"China","2025-02-27",0,0,721,0,0,721,0,0
"China","2025-02-28",0,0,721,0,0,721,0,0
"China","2025-03-01",0,0,721,0,0,721,0,0
"China","2025-03-02",0,0,721,0,0,721,0,0
"China","2025-03-03",0,0,721,0,0,721,0,0
"Colombia","2024-01-01",0,0,0,0,0,0,0,0
"Colombia","2024-01-02",0,10,10,0,10,10,0,0
"Colombia","2024-01-03",0,0,10,0,1,11,0,0
"Colombia","2024-01-04",0,0,10,0,1,12,0,0
"Colombia","2024-01-05",0,0,10,0,1,13,0,0
"Colombia","2024-01-06",0,0,10,0,2,15,0,0
"Colombia","2024-01-07",0,0,10,0,1,16,0,0
"Colombia","2024-01-08",0,0,10,0,1,17,0,0
"Colombia","2024-01-09",0,8,18,0,1,18,0,0
"Colombia","2024-01-10",0,0,18,0,1,19,0,0
"Colombia","2024-01-11",0,0,18,0,1,20,0,0
"Colombia","2024-01-12",0,0,18,0,1,21,0,0
"Colombia","2024-01-13",0,0,18,0,2,23,0,0
"Colombia","2024-01-14",0,0,18,0,1,24,0,0
"Colombia","2024-01-15",0,0,18,0,1,25,0,0
"Colombia","2024-01-16",0,8,26,0,1,26,0,0
"Colombia","2024-01-17",0,0,26,0,1,27,0,0
"Colombia","2024-01-18",0,0,26,0,1,28,0,0
"Colombia","2024-01-19",0,0,26,0,1,29,0,0
"Colombia","2024-01-20",0,0,26,0,0,29,0,0
"Colombia","2024-01-21",0,0,26,0,1,30,0,0
"Colombia","2024-01-22",0,0,26,0,1,31,0,0
"Colombia","2024-01-23",0,6,32,0,1,32,0,0
"Colombia","2024-01-24",0,0,32,0,1,33,0,0
"Colombia","2024-01-25",0,0,32,0,1,34,0,0
"Colombia","2024-01-26",0,0,32,0,1,35,0,0
"Colombia","2024-01-27",0,0,32,0,2,37,0,0
"Colombia","2024-01-28",0,0,32,0,1,38,0,0
"Colombia","2024-01-29",0,0,32,0,1,39,0,0
"Colombia","2024-01-30",0,8,40,0,1,40,0,0
"Colombia","2024-01-31",0,0,40,0,0,40,0,0
"Colombia","2024-02-01",0,0,40,0,0,40,0,0
"Colombia","2024-02-02",0,0,40,0,0,40,0,0
"Colombia","2024-02-03",0,0,40,0,1,41,0,0
"Colombia","2024-02-04",0,0,40,0,0,41,0,0
"Colombia","2024-02-05",0,0,40,0,0,41,0,0
"Colombia","2024-02-06",0,1,41,0,0,41,0,0
"Colombia","2024-02-07",0,0,41,0,0,41,0,0
"Colombia","2024-02-08",0,0,41,0,0,41,0,0
"Colombia","2024-02-09",0,0,41,0,0,41,0,0
"Colombia","2024-02-10",0,0,41,0,1,42,0,0
"Colombia","2024-02-11",0,0,41,0,0,42,0,0
"Colombia","2024-02-12",0,0,41,0,0,42,0,0
"Colombia","2024-02-13",0,1,42,0,0,42,0,0
"Colombia","2024-02-14",0,0,42,0,1,43,0,0
"Colombia","2024-02-15",0,0,42,0,0,43,0,0
"Colombia","2024-02-16",0,0,42,0,1,44,0,0
"Colombia","2024-02-17",0,0,42,0,0,44,0,0
"Colombia","2024-02-18",0,0,42,0,1,45,0,0
"Colombia","2024-02-19",0,0,42,0,0,45,0,0
"Colombia","2024-02-20",0,4,46,0,1,46,0,0
"Colombia","2024-02-21",0,0,46,0,1,47,0,0
"Colombia","2024-02-22",0,0,46,0,2,49,0,0
"Colombia","2024-02-23",0,0,46,0,1,50,0,0
"Colombia","2024-02-24",0,0,46,0,1,51,0,0
"Colombia","2024-02-25",0,0,46,0,1,52,0,0
"Colombia","2024-02-26",0,0,46,0,2,54,0,0
"Colombia","2024-02-27",0,9,55,0,1,55,0,0
"Colombia","2024-02-28",0,0,55,0,0,55,0,0
"Colombia","2024-02-29",0,0,55,0,1,56,0,0
"Colombia","2024-03-01",0,0,55,0,0,56,0,0
"Colombia","2024-03-02",0,0,55,0,1,57,0,0
"Colombia","2024-03-03",0,0,55,0,0,57,0,0
"Colombia","2024-03-04",0,0,55,0,1,58,0,0
"Colombia","2024-03-05",0,3,58,0,0,58,0,0
"Colombia","2024-03-06",0,0,58,0,1,59,0,0
"Colombia","2024-03-07",0,0,58,0,0,59,0,0
"Colombia","2024-03-08",0,0,58,0,1,60,0,0
"Colombia","2024-03-09",0,0,58,0,0,60,0,0
"Colombia","2024-03-10",0,0,58,0,1,61,0,0
"Colombia","2024-03-11",0,0,58,0,0,61,0,0
"Colombia","2024-03-12",0,4,62,0,1,62,0,0
"Colombia","2024-03-13",0,0,62,0,1,63,0,0
"Colombia","2024-03-14",0,0,62,0,0,63,0,0
"Colombia","2024-03-15",0,0,62,0,1,64,0,0
"Colombia","2024-03-16",0,0,62,0,0,64,0,0
"Colombia","2024-03-17",0,0,62,0,1,65,0,0
"Colombia","2024-03-18",0,0,62,0,0,65,0,0
"Colombia","2024-03-19",0,4,66,0,1,66,0,0
"Colombia","2024-03-20",0,0,66,0,0,66,0,0
"Colombia","2024-03-21",0,0,66,0,1,67,0,0
"Colombia","2024-03-22",0,0,66,0,0,67,0,0
"Colombia","2024-03-23",0,0,66,0,0,67,0,0
"Colombia","2024-03-24",0,0,66,0,0,67,0,0
"Colombia","2024-03-25",0,0,66,0,1,68,0,0
"Colombia","2024-03-26",0,2,68,0,0,68,0,0
"Colombia","2024-03-27",0,0,68,0,1,69,0,0
"Colombia","2024-03-28",0,0,68,0,0,69,0,0
"Colombia","2024-03-29",0,0,68,0,1,70,0,0
"Colombia","2024-03-30",0,0,68,0,1,71,0,0
"Colombia","2024-03-31",0,0,68,0,1,72,0,0
"Colombia","2024-04-01",0,0,68,0,0,72,0,0
"Colombia","2024-04-02",0,5,73,0,1,73,0,0
"Colombia","2024-04-03",0,0,73,0,1,74,0,0
"Colombia","2024-04-04",0,0,73,0,0,74,0,0
"Colombia","2024-04-05",0,0,73,0,1,75,0,0
"Colombia","2024-04-06",0,0,73,0,1,76,0,0
"Colombia","2024-04-07",0,0,73,0,1,77,0,0
"Colombia","2024-04-08",0,0,73,0,0,77,0,0
"Colombia","2024-04-09",0,5,78,0,1,78,0,0
"Colombia","2024-04-10",0,0,78,0,0,78,0,0
"Colombia","2024-04-11",0,0,78,0,1,79,0,0
"Colombia","2024-04-12",0,0,78,0,0,79,0,0
"Colombia","2024-04-13",0,0,78,0,1,80,0,0
"Colombia","2024-04-14",0,0,78,0,0,80,0,0
"Colombia","2024-04-15",0,0,78,0,1,81,0,0
"Colombia","2024-04-16",0,3,81,0,0,81,0,0
"Colombia","2024-04-17",0,0,81,0,1,82,0,0
"Colombia","2024-04-18",0,0,81,0,2,84,0,0
"Colombia","2024-04-19",0,0,81,0,1,85,0,0
"Colombia","2024-04-20",0,0,81,0,1,86,0,0
"Colombia","2024-04-21",0,0,81,0,1,87,0,0
"Colombia","2024-04-22",0,0,81,0,2,89,0,0
"Colombia","2024-04-23",0,9,90,0,1,90,0,0
"Colombia","2024-04-24",0,0,90,0,0,90,0,0
"Colombia","2024-04-25",0,0,90,0,1,91,0,0
"Colombia","2024-04-26",0,0,90,0,0,91,0,0
"Colombia","2024-04-27",0,0,90,0,0,91,0,0
"Colombia","2024-04-28",0,0,90,0,0,91,0,0
"Colombia","2024-04-29",0,0,90,0,1,92,0,0
"Colombia","2024-04-30",0,2,92,0,0,92,0,0
"Colombia","2024-05-01",0,0,92,0,0,92,0,0
"Colombia","2024-05-02",0,0,92,0,0,92,0,0
"Colombia","2024-05-03",0,0,92,0,0,92,0,0
"Colombia","2024-05-04",0,0,92,0,1,93,0,0
"Colombia","2024-05-05",0,0,92,0,0,93,0,0
"Colombia","2024-05-06",0,0,92,0,0,93,0,0
"Colombia","2024-05-07",0,0,92,0,0,93,0,0
"Colombia","2024-05-08",0,0,92,0,0,93,0,0
"Colombia","2024-05-09",0,0,92,0,0,93,0,0
"Colombia","2024-05-10",0,0,92,0,0,93,0,0
"Colombia","2024-05-11",0,0,92,0,1,94,0,0
"Colombia","2024-05-12",0,0,92,0,0,94,0,0
"Colombia","2024-05-13",0,0,92,0,0,94,0,0
"Colombia","2024-05-14",0,2,94,0,0,94,0,0
"Colombia","2024-05-15",0,0,94,0,0,94,0,0
"Colombia","2024-05-16",0,0,94,0,1,95,0,0
"Colombia","2024-05-17",0,0,94,0,0,95,0,0
"Colombia","2024-05-18",0,0,94,0,0,95,0,0
"Colombia","2024-05-19",0,0,94,0,0,95,0,0
"Colombia","2024-05-20",0,0,94,0,1,96,0,0
"Colombia","2024-05-21",0,2,96,0,0,96,0,0
"Colombia","2024-05-22",0,0,96,0,0,96,0,0
"Colombia","2024-05-23",0,0,96,0,0,96,0,0
"Colombia","2024-05-24",0,0,96,0,0,96,0,0
"Colombia","2024-05-25",0,0,96,0,1,97,0,0
"Colombia","2024-05-26",0,0,96,0,0,97,0,0
"Colombia","2024-05-27",0,0,96,0,0,97,0,0
"Colombia","2024-05-28",0,0,96,0,0,97,0,0
"Colombia","2024-05-29",0,0,96,0,0,97,0,0
"Colombia","2024-05-30",0,0,96,0,0,97,0,0
"Colombia","2024-05-31",0,0,96,0,0,97,0,0
"Colombia","2024-06-01",0,0,96,0,1,98,0,0
"Colombia","2024-06-02",0,0,96,0,0,98,0,0
"Colombia","2024-06-03",0,0,96,0,0,98,0,0
"Colombia","2024-06-04",0,2,98,0,0,98,0,0
"Colombia","2024-06-05",0,0,98,0,1,99,0,0
"Colombia","2024-06-06",0,0,98,0,0,99,0,0
"Colombia","2024-06-07",0,0,98,0,1,100,0,0
"Colombia","2024-06-08",0,0,98,0,0,100,0,0
"Colombia","2024-06-09",0,0,98,0,1,101,0,0
"Colombia","2024-06-10",0,0,98,0,0,101,0,0
"Colombia","2024-06-11",0,4,102,0,1,102,0,0
"Colombia","2024-06-12",0,0,102,0,0,102,0,0
"Colombia","2024-06-13",0,0,102,0,1,103,0,0
"Colombia","2024-06-14",0,0,102,0,0,103,0,0
"Colombia","2024-06-15",0,0,102,0,0,103,0,0
"Colombia","2024-06-16",0,0,102,0,0,103,0,0
"Colombia","2024-06-17",0,0,102,0,1,104,0,0
"Colombia","2024-06-18",0,2,104,0,0,104,0,0
"Colombia","2024-06-19",0,0,104,0,0,104,0,0
"Colombia","2024-06-20",0,0,104,0,1,105,0,0
"Colombia","2024-06-21",0,0,104,0,0,105,0,0
"Colombia","2024-06-22",0,0,104,0,0,105,0,0
"Colombia","2024-06-23",0,0,104,0,0,105,0,0
"Colombia","2024-06-24",0,0,104,0,1,106,0,0
"Colombia","2024-06-25",0,0,104,0,0,106,0,0
"Colombia","2024-06-26",0,0,104,0,0,106,0,0
"Colombia","2024-06-27",0,0,104,0,1,107,0,0
"Colombia","2024-06-28",0,0,104,0,0,107,0,0
"Colombia","2024-06-29",0,0,104,0,0,107,0,0
"Colombia","2024-06-30",0,0,104,0,0,107,0,0
"Colombia","2024-07-01",0,0,104,0,1,108,0,0
"Colombia","2024-07-02",0,4,108,0,0,108,0,0
"Colombia","2024-07-03",0,0,108,0,0,108,0,0
"Colombia","2024-07-04",0,0,108,0,1,109,0,0
"Colombia","2024-07-05",0,0,108,0,0,109,0,0
"Colombia","2024-07-06",0,0,108,0,0,109,0,0
"Colombia","2024-07-07",0,0,108,0,0,109,0,0
"Colombia","2024-07-08",0,0,108,0,1,110,0,0
"Colombia","2024-07-09",0,2,110,0,0,110,0,0
"Colombia","2024-07-10",0,0,110,0,0,110,0,0
"Colombia","2024-07-11",0,0,110,0,1,111,0,0
"Colombia","2024-07-12",0,0,110,0,0,111,0,0
"Colombia","2024-07-13",0,0,110,0,1,112,0,0
"Colombia","2024-07-14",0,0,110,0,0,112,0,0
"Colombia","2024-07-15",0,0,110,0,1,113,0,0
"Colombia","2024-07-16",0,3,113,0,0,113,0,0
"Colombia","2024-07-17",0,0,113,0,0,113,0,0
"Colombia","2024-07-18",0,0,113,0,0,113,0,0
"Colombia","2024-07-19",0,0,113,0,0,113,0,0
"Colombia","2024-07-20",0,0,113,0,0,113,0,0
"Colombia","2024-07-21",0,0,113,0,0,113,0,0
"Colombia","2024-07-22",0,0,113,0,0,113,0,0
"Colombia","2024-07-23",0,0,113,0,0,113,0,0
"Colombia","2024-07-24",0,0,113,0,1,114,0,0
"Colombia","2024-07-25",0,0,113,0,0,114,0,0
"Colombia","2024-07-26",0,0,113,0,0,114,0,0
"Colombia","2024-07-27",0,0,113,0,0,114,0,0
"Colombia","2024-07-28",0,0,113,0,0,114,0,0
"Colombia","2024-07-29",0,0,113,0,0,114,0,0
"Colombia","2024-07-30",0,1,114,0,0,114,0,0
"Colombia","2024-07-31",0,0,114,0,0,114,0,0
"Colombia","2024-08-01",0,0,114,0,1,115,0,0
"Colombia","2024-08-02",0,0,114,0,0,115,0,0
"Colombia","2024-08-03",0,0,114,0,0,115,0,0
"Colombia","2024-08-04",0,0,114,0,0,115,0,0
"Colombia","2024-08-05",0,0,114,0,1,116,0,0
"Colombia","2024-08-06",0,2,116,0,0,116,0,0
"Colombia","2024-08-07",0,0,116,0,0,116,0,0
"Colombia","2024-08-08",0,0,116,0,0,116,0,0
"Colombia","2024-08-09",0,0,116,0,0,116,0,0
"Colombia","2024-08-10",0,0,116,0,1,117,0,0
"Colombia","2024-08-11",0,0,116,0,0,117,0,0
"Colombia","2024-08-12",0,0,116,0,0,117,0,0
"Colombia","2024-08-13",0,0,116,0,0,117,0,0
"Colombia","2024-08-14",0,0,116,0,0,117,0,0
"Colombia","2024-08-15",0,0,116,0,0,117,0,0
"Colombia","2024-08-16",0,0,116,0,0,117,0,0
"Colombia","2024-08-17",0,0,116,0,1,118,0,0
"Colombia","2024-08-18",0,0,116,0,0,118,0,0
"Colombia","2024-08-19",0,0,116,0,0,118,0,0
"Colombia","2024-08-20",0,2,118,0,0,118,0,0
"Colombia","2024-08-21",0,0,118,0,0,118,0,0
"Colombia","2024-08-22",0,0,118,0,1,119,0,0
"Colombia","2024-08-23",0,0,118,0,0,119,0,0
"Colombia","2024-08-24",0,0,118,0,1,120,0,0
"Colombia","2024-08-25",0,0,118,0,0,120,0,0
"Colombia","2024-08-26",0,0,118,0,1,121,0,0
"Colombia","2024-08-27",0,3,121,0,0,121,0,0
"Colombia","2024-08-28",0,0,121,0,0,121,0,0
"Colombia","2024-08-29",0,0,121,0,0,121,0,0
"Colombia","2024-08-30",0,0,121,0,0,121,0,0
"Colombia","2024-08-31",0,0,121,0,0,121,0,0
"Colombia","2024-09-01",0,0,121,0,0,121,0,0
"Colombia","2024-09-02",0,0,121,0,1,122,0,0
"Colombia","2024-09-03",0,0,121,0,0,122,0,0
"Colombia","2024-09-04",0,0,121,0,0,122,0,0
"Colombia","2024-09-05",0,0,121,0,0,122,0,0
"Colombia","2024-09-06",0,0,121,0,0,122,0,0
"Colombia","2024-09-07",0,0,121,0,0,122,0,0
"Colombia","2024-09-08",0,0,121,0,0,122,0,0
"Colombia","2024-09-09",0,0,121,0,0,122,0,0
"Colombia","2024-09-10",0,0,121,0,0,122,0,0
"Colombia","2024-09-11",0,0,121,0,0,122,0,0
"Colombia","2024-09-12",0,0,121,0,1,123,0,0
"Colombia","2024-09-13",0,0,121,0,0,123,0,0
"Colombia","2024-09-14",0,0,121,0,0,123,0,0
"Colombia","2024-09-15",0,0,121,0,0,123,0,0
"Colombia","2024-09-16",0,0,121,0,0,123,0,0
"Colombia","2024-09-17",0,2,123,0,0,123,0,0
"Colombia","2024-09-18",0,0,123,0,0,123,0,0
"Colombia","2024-09-19",0,0,123,0,0,123,0,0
"Colombia","2024-09-20",0,0,123,0,0,123,0,0
"Colombia","2024-09-21",0,0,123,0,1,124,0,0
"Colombia","2024-09-22",0,0,123,0,0,124,0,0
"Colombia","2024-09-23",0,0,123,0,0,124,0,0
"Colombia","2024-09-24",0,1,124,0,0,124,0,0
"Colombia","2024-09-25",0,0,124,0,0,124,0,0
"Colombia","2024-09-26",0,0,124,0,0,124,0,0
"Colombia","2024-09-27",0,0,124,0,1,125,0,0
"Colombia","2024-09-28",0,0,124,0,0,125,0,0
"Colombia","2024-09-29",0,0,124,0,0,125,0,0
"Colombia","2024-09-30",0,0,124,0,0,125,0,0
"Colombia","2024-10-01",0,0,124,0,1,126,0,0
"Colombia","2024-10-02",0,0,124,0,0,126,0,0
"Colombia","2024-10-03",0,0,124,0,0,126,0,0
"Colombia","2024-10-04",0,0,124,0,0,126,0,0
"Colombia","2024-10-05",0,0,124,0,0,126,0,0
"Colombia","2024-10-06",0,0,124,0,1,127,0,0
"Colombia","2024-10-07",0,0,124,0,0,127,0,0
"Colombia","2024-10-08",0,3,127,0,0,127,0,0
"Colombia","2024-10-09",0,0,127,0,1,128,0,0
"Colombia","2024-10-10",0,0,127,0,0,128,0,0
"Colombia","2024-10-11",0,0,127,0,1,129,0,0
"Colombia","2024-10-12",0,0,127,0,0,129,0,0
"Colombia","2024-10-13",0,0,127,0,1,130,0,0
"Colombia","2024-10-14",0,0,127,0,0,130,0,0
"Colombia","2024-10-15",0,4,131,0,1,131,0,0
"Colombia","2024-10-16",0,0,131,0,0,131,0,0
"Colombia","2024-10-17",0,0,131,0,0,131,0,0
"Colombia","2024-10-18",0,0,131,0,0,131,0,0
"Colombia","2024-10-19",0,0,131,0,1,132,0,0
"Colombia","2024-10-20",0,0,131,0,0,132,0,0
"Colombia","2024-10-21",0,0,131,0,0,132,0,0
"Colombia","2024-10-22",0,1,132,0,0,132,0,0
"Colombia","2024-10-23",0,0,132,0,0,132,0,0
"Colombia","2024-10-24",0,0,132,0,0,132,0,0
"Colombia","2024-10-25",0,0,132,0,1,133,0,0
"Colombia","2024-10-26",0,0,132,0,0,133,0,0
"Colombia","2024-10-27",0,0,132,0,0,133,0,0
"Colombia","2024-10-28",0,0,132,0,0,133,0,0
"Colombia","2024-10-29",0,0,132,0,1,134,0,0
"Colombia","2024-10-30",0,0,132,0,0,134,0,0
"Colombia","2024-10-31",0,0,132,0,0,134,0,0
"Colombia","2024-11-01",0,0,132,0,0,134,0,0
"Colombia","2024-11-02",0,0,132,0,0,134,0,0
"Colombia","2024-11-03",0,0,132,0,1,135,0,0
"Colombia","2024-11-04",0,0,132,0,0,135,0,0
"Colombia","2024-11-05",0,3,135,0,0,135,0,0
"Colombia","2024-11-06",0,0,135,0,0,135,0,0
"Colombia","2024-11-07",0,0,135,0,0,135,0,0
"Colombia","2024-11-08",0,0,135,0,0,135,0,0
"Colombia","2024-11-09",0,0,135,0,0,135,0,0
"Colombia","2024-11-10",0,0,135,0,0,135,0,0
"Colombia","2024-11-11",0,0,135,0,0,135,0,0
"Colombia","2024-11-12",0,0,135,0,0,135,0,0
"Colombia","2024-11-13",0,0,135,0,1,136,0,0
"Colombia","2024-11-14",0,0,135,0,0,136,0,0
"Colombia","2024-11-15",0,0,135,0,0,136,0,0
"Colombia","2024-11-16",0,0,135,0,0,136,0,0
"Colombia","2024-11-17",0,0,135,0,0,136,0,0
"Colombia","2024-11-18",0,0,135,0,0,136,0,0
"Colombia","2024-11-19",0,1,136,0,0,136,0,0
"Colombia","2024-11-20",0,0,136,0,0,136,0,0
"Colombia","2024-11-21",0,0,136,0,0,136,0,0
"Colombia","2024-11-22",0,0,136,0,0,136,0,0
"Colombia","2024-11-23",0,0,136,0,1,137,0,0
"Colombia","2024-11-24",0,0,136,0,0,137,0,0
"Colombia","2024-11-25",0,0,136,0,0,137,0,0
"Colombia","2024-11-26",0,1,137,0,0,137,0,0
"Colombia","2024-11-27",0,0,137,0,0,137,0,0
"Colombia","2024-11-28",0,0,137,0,0,137,0,0
"Colombia","2024-11-29",0,0,137,0,0,137,0,0
"Colombia","2024-11-30",0,0,137,0,0,137,0,0
"Colombia","2024-12-01",0,0,137,0,0,137,0,0
"Colombia","2024-12-02",0,0,137,0,0,137,0,0
"Colombia","2024-12-03",0,0,137,0,0,137,0,0
"Colombia","2024-12-04",0,0,137,0,0,137,0,0
"Colombia","2024-12-05",0,0,137,0,0,137,0,0
"Colombia","2024-12-06",0,0,137,0,0,137,0,0
"Colombia","2024-12-07",0,0,137,0,0,137,0,0
"Colombia","2024-12-08",0,0,137,0,0,137,0,0
"Colombia","2024-12-09",0,0,137,0,0,137,0,0
"Colombia","2024-12-10",0,0,137,0,0,137,0,0
"Colombia","2024-12-11",0,0,137,0,0,137,0,0
"Colombia","2024-12-12",0,0,137,0,0,137,0,0
"Colombia","2024-12-13",0,0,137,0,0,137,0,0
"Colombia","2024-12-14",0,0,137,0,0,137,0,0
"Colombia","2024-12-15",0,0,137,0,0,137,0,0
"Colombia","2024-12-16",0,0,137,0,0,137,0,0
"Colombia","2024-12-17",0,0,137,0,0,137,0,0
"Colombia","2024-12-18",0,0,137,0,0,137,0,0
"Colombia","2024-12-19",0,0,137,0,0,137,0,0
"Colombia","2024-12-20",0,0,137,0,0,137,0,0
"Colombia","2024-12-21",0,0,137,0,0,137,0,0
"Colombia","2024-12-22",0,0,137,0,0,137,0,0
"Colombia","2024-12-23",0,0,137,0,0,137,0,0
"Colombia","2024-12-24",0,0,137,0,0,137,0,0
"Colombia","2024-12-25",0,0,137,0,0,137,0,0
"Colombia","2024-12-26",0,0,137,0,0,137,0,0
"Colombia","2024-12-27",0,0,137,0,0,137,0,0
"Colombia","2024-12-28",0,0,137,0,0,137,0,0
"Colombia","2024-12-29",0,0,137,0,0,137,0,0
"Colombia","2024-12-30",0,0,137,0,0,137,0,0
"Colombia","2024-12-31",0,0,137,0,0,137,0,0
"Colombia","2025-01-01",0,0,137,0,0,137,0,0
"Colombia","2025-01-02",0,0,137,0,0,137,0,0
"Colombia","2025-01-03",0,0,137,0,0,137,0,0
"Colombia","2025-01-04",0,0,137,0,0,137,0,0
"Colombia","2025-01-05",0,0,137,0,0,137,0,0
"Colombia","2025-01-06",0,0,137,0,0,137,0,0
"Colombia","2025-01-07",0,0,137,0,0,137,0,0
"Colombia","2025-01-08",0,0,137,0,0,137,0,0
"Colombia","2025-01-09",0,0,137,0,0,137,0,0
"Colombia","2025-01-10",0,0,137,0,0,137,0,0
"Colombia","2025-01-11",0,0,137,0,0,137,0,0
"Colombia","2025-01-12",0,0,137,0,0,137,0,0
"Colombia","2025-01-13",0,0,137,0,0,137,0,0
"Colombia","2025-01-14",0,0,137,0,0,137,0,0
"Colombia","2025-01-15",0,0,137,0,0,137,0,0
"Colombia","2025-01-16",0,0,137,0,0,137,0,0
"Colombia","2025-01-17",0,0,137,0,0,137,0,0
"Colombia","2025-01-18",0,0,137,0,0,137,0,0
"Colombia","2025-01-19",0,0,137,0,0,137,0,0
"Colombia","2025-01-20",0,0,137,0,0,137,0,0
"Colombia","2025-01-21",0,0,137,0,0,137,0,0
"Colombia","2025-01-22",0,0,137,0,0,137,0,0
"Colombia","2025-01-23",0,0,137,0,0,137,0,0
"Colombia","2025-01-24",0,0,137,0,0,137,0,0
"Colombia","2025-01-25",0,0,137,0,0,137,0,0
"Colombia","2025-01-26",0,0,137,0,0,137,0,0
"Colombia","2025-01-27",0,0,137,0,0,137,0,0
"Colombia","2025-01-28",0,0,137,0,0,137,0,0
"Colombia","2025-01-29",0,0,137,0,0,137,0,0
"Colombia","2025-01-30",0,0,137,0,0,137,0,0
"Colombia","2025-01-31",0,0,137,0,0,137,0,0
"Colombia","2025-02-01",0,0,137,0,0,137,0,0
"Colombia","2025-02-02",0,0,137,0,0,137,0,0
"Colombia","2025-02-03",0,0,137,0,0,137,0,0
"Colombia","2025-02-04",0,0,137,0,0,137,0,0
"Colombia","2025-02-05",0,0,137,0,0,137,0,0
"Colombia","2025-02-06",0,0,137,0,0,137,0,0
"Colombia","2025-02-07",0,0,137,0,0,137,0,0
"Colombia","2025-02-08",0,0,137,0,0,137,0,0
"Colombia","2025-02-09",0,0,137,0,0,137,0,0
"Colombia","2025-02-10",0,0,137,0,0,137,0,0
"Colombia","2025-02-11",0,0,137,0,0,137,0,0
"Colombia","2025-02-12",0,0,137,0,0,137,0,0
"Colombia","2025-02-13",0,0,137,0,0,137,0,0
"Colombia","2025-02-14",0,0,137,0,0,137,0,0
"Colombia","2025-02-15",0,0,137,0,0,137,0,0
"Colombia","2025-02-16",0,0,137,0,0,137,0,0
"Colombia","2025-02-17",0,0,137,0,0,137,0,0
"Colombia","2025-02-18",0,0,137,0,0,137,0,0
"Colombia","2025-02-19",0,0,137,0,0,137,0,0
"Colombia","2025-02-20",0,0,137,0,0,137,0,0
"Colombia","2025-02-21",0,0,137,0,0,137,0,0
"Colombia","2025-02-22",0,0,137,0,0,137,0,0
"Colombia","2025-02-23",0,0,137,0,0,137,0,0
"Colombia","2025-02-24",0,0,137,0,0,137,0,0
"Colombia","2025-02-25",0,0,137,0,0,137,0,0
"Colombia","2025-02-26",0,0,137,0,0,137,0,0
"Colombia","2025-02-27",0,0,137,0,0,137,0,0
"Colombia","2025-02-28",0,0,137,0,0,137,0,0
"Colombia","2025-03-01",0,0,137,0,0,137,0,0
"Colombia","2025-03-02",0,0,137,0,0,137,0,0
"Colombia","2025-03-03",0,0,137,0,0,137,0,0
"Congo","2024-01-01",0,0,0,0,0,0,0,0
"Congo","2024-01-02",0,0,0,0,0,0,0,0
"Congo","2024-01-03",0,0,0,0,0,0,0,0
"Congo","2024-01-04",0,0,0,0,0,0,0,0
"Congo","2024-01-05",0,0,0,0,0,0,0,0
"Congo","2024-01-06",0,0,0,0,0,0,0,0
"Congo","2024-01-07",0,0,0,0,0,0,0,0
"Congo","2024-01-08",0,0,0,0,0,0,0,0
"Congo","2024-01-09",0,0,0,0,0,0,0,0
"Congo","2024-01-10",0,0,0,0,0,0,0,0
"Congo","2024-01-11",0,0,0,0,0,0,0,0
"Congo","2024-01-12",0,0,0,0,0,0,0,0
"Congo","2024-01-13",0,0,0,0,0,0,0,0
"Congo","2024-01-14",0,1,1,0,1,1,0,0
"Congo","2024-01-15",0,0,1,0,0,1,0,0
"Congo","2024-01-16",0,0,1,0,0,1,0,0
"Congo","2024-01-17",0,0,1,0,0,1,0,0
"Congo","2024-01-18",0,0,1,0,1,2,0,0
"Congo","2024-01-19",0,0,1,0,0,2,0,0
"Congo","2024-01-20",0,0,1,0,0,2,0,0
"Congo","2024-01-21",0,1,2,0,0,2,0,0
"Congo","2024-01-22",0,0,2,0,0,2,0,0
"Congo","2024-01-23",0,0,2,0,1,3,0,0
"Congo","2024-01-24",0,0,2,0,0,3,0,0
"Congo","2024-01-25",0,0,2,0,0,3,0,0
"Congo","2024-01-26",0,0,2,0,0,3,0,0
"Congo","2024-01-27",0,0,2,0,1,4,0,0
"Congo","2024-01-28",0,2,4,0,0,4,0,0
"Congo","2024-01-29",0,0,4,0,0,4,0,0
"Congo","2024-01-30",0,0,4,0,0,4,0,0
"Congo","2024-01-31",0,0,4,0,1,5,0,0
"Congo","2024-02-01",0,0,4,0,0,5,0,0
"Congo","2024-02-02",0,0,4,0,0,5,0,0
"Congo","2024-02-03",0,0,4,0,0,5,0,0
"Congo","2024-02-04",0,0,4,0,1,6,0,0
"Congo","2024-02-05",0,0,4,0,0,6,0,0
"Congo","2024-02-06",0,0,4,0,0,6,0,0
"Congo","2024-02-07",0,0,4,0,0,6,0,0
"Congo","2024-02-08",0,0,4,0,1,7,0,0
"Congo","2024-02-09",0,0,4,0,0,7,0,0
"Congo","2024-02-10",0,0,4,0,0,7,0,0
"Congo","2024-02-11",0,0,4,0,0,7,0,0
"Congo","2024-02-12",0,0,4,0,1,8,0,0
"Congo","2024-02-13",0,0,4,0,0,8,0,0
"Congo","2024-02-14",0,0,4,0,0,8,0,0
"Congo","2024-02-15",0,0,4,0,0,8,0,0
"Congo","2024-02-16",0,0,4,0,1,9,0,0
"Congo","2024-02-17",0,0,4,0,0,9,0,0
"Congo","2024-02-18",0,5,9,0,0,9,0,0
"Congo","2024-02-19",0,0,9,0,0,9,0,0
"Congo","2024-02-20",0,0,9,0,1,10,0,0
"Congo","2024-02-21",0,0,9,0,0,10,0,0
"Congo","2024-02-22",0,0,9,0,0,10,0,0
"Congo","2024-02-23",0,0,9,0,0,10,0,0
"Congo","2024-02-24",0,0,9,0,1,11,0,0
"Congo","2024-02-25",0,2,11,0,0,11,0,0
"Congo","2024-02-26",0,0,11,0,1,12,0,0
"Congo","2024-02-27",0,0,11,0,0,12,0,0
"Congo","2024-02-28",0,0,11,0,1,13,0,0
"Congo","2024-02-29",0,0,11,0,0,13,0,0
"Congo","2024-03-01",0,0,11,0,1,14,0,0
"Congo","2024-03-02",0,0,11,0,0,14,0,0
"Congo","2024-03-03",0,0,11,0,1,15,0,0
"Congo","2024-03-04",0,0,11,0,1,16,0,0
"Congo","2024-03-05",0,0,11,0,0,16,0,0
"Congo","2024-03-06",0,0,11,0,1,17,0,0
"Congo","2024-03-07",0,0,11,0,0,17,0,0
"Congo","2024-03-08",0,0,11,0,1,18,0,0
"Congo","2024-03-09",0,0,11,0,0,18,0,0
"Congo","2024-03-10",0,8,19,0,1,19,0,0
"Congo","2024-03-11",0,0,19,0,0,19,0,0
"Congo","2024-03-12",0,0,19,0,0,19,0,0
"Congo","2024-03-13",0,0,19,0,0,19,0,0
"Congo","2024-03-14",0,0,19,0,0,19,0,0
"Congo","2024-03-15",0,0,19,0,0,19,0,0
"Congo","2024-03-16",0,0,19,0,0,19,0,0
"Congo","2024-03-17",24,0,19,24,0,19,24,24
"Congo","2024-03-18",0,0,19,24,0,19,1,25
"Congo","2024-03-19",0,0,19,24,0,19,1,26
"Congo","2024-03-20",0,0,19,24,0,19,1,27
"Congo","2024-03-21",0,0,19,24,0,19,0,27
"Congo","2024-03-22",0,0,19,24,0,19,1,28
"Congo","2024-03-23",0,0,19,24,0,19,1,29
"Congo","2024-03-24",0,0,19,24,0,19,1,30
"Congo","2024-03-25",0,0,19,24,0,19,1,31
"Congo","2024-03-26",0,0,19,24,0,19,1,32
"Congo","2024-03-27",0,0,19,24,0,19,0,32
"Congo","2024-03-28",0,0,19,24,0,19,1,33
"Congo","2024-03-29",0,0,19,24,0,19,1,34
"Congo","2024-03-30",0,0,19,24,0,19,1,35
"Congo","2024-03-31",0,0,19,24,0,19,1,36
"Congo","2024-04-01",0,0,19,24,0,19,1,37
"Congo","2024-04-02",0,0,19,24,0,19,1,38
"Congo","2024-04-03",0,0,19,24,0,19,0,38
"Congo","2024-04-04",0,0,19,24,0,19,1,39
"Congo","2024-04-05",0,0,19,24,0,19,1,40
"Congo","2024-04-06",17,0,19,41,0,19,1,41
"Congo","2024-04-07",0,0,19,41,0,19,0,41
"Congo","2024-04-08",0,0,19,41,0,19,1,42
"Congo","2024-04-09",0,0,19,41,0,19,1,43
"Congo","2024-04-10",0,0,19,41,0,19,0,43
"Congo","2024-04-11",0,0,19,41,0,19,0,43
"Congo","2024-04-12",0,0,19,41,0,19,1,44
"Congo","2024-04-13",0,0,19,41,0,19,1,45
"Congo","2024-04-14",0,0,19,41,0,19,0,45
"Congo","2024-04-15",0,0,19,41,0,19,0,45
"Congo","2024-04-16",0,0,19,41,0,19,1,46
"Congo","2024-04-17",0,0,19,41,0,19,1,47
"Congo","2024-04-18",0,0,19,41,1,20,0,47
"Congo","2024-04-19",0,0,19,41,0,20,0,47
"Congo","2024-04-20",0,0,19,41,0,20,1,48
"Congo","2024-04-21",0,0,19,41,0,20,1,49
"Congo","2024-04-22",0,0,19,41,0,20,0,49
"Congo","2024-04-23",0,0,19,41,0,20,0,49
"Congo","2024-04-24",0,0,19,41,0,20,1,50
"Congo","2024-04-25",0,0,19,41,0,20,1,51
"Congo","2024-04-26",0,0,19,41,0,20,0,51
"Congo","2024-04-27",0,0,19,41,0,20,0,51
"Congo","2024-04-28",0,0,19,41,0,20,1,52
"Congo","2024-04-29",0,0,19,41,0,20,1,53
"Congo","2024-04-30",0,0,19,41,0,20,0,53
"Congo","2024-05-01",0,0,19,41,0,20,0,53
"Congo","2024-05-02",0,0,19,41,0,20,1,54
"Congo","2024-05-03",0,0,19,41,0,20,1,55
"Congo","2024-05-04",0,0,19,41,0,20,0,55
"Congo","2024-05-05",0,0,19,41,0,20,0,55
"Congo","2024-05-06",0,0,19,41,0,20,1,56
"Congo","2024-05-07",0,0,19,41,0,20,1,57
"Congo","2024-05-08",0,0,19,41,0,20,0,57
"Congo","2024-05-09",0,0,19,41,0,20,0,57
"Congo","2024-05-10",0,0,19,41,0,20,1,58
"Congo","2024-05-11",0,0,19,41,0,20,1,59
"Congo","2024-05-12",18,0,19,59,0,20,0,59
"Congo","2024-05-13",0,0,19,59,0,20,2,61
"Congo","2024-05-14",0,0,19,59,0,20,1,62
"Congo","2024-05-15",0,0,19,59,0,20,1,63
"Congo","2024-05-16",0,0,19,59,0,20,2,65
"Congo","2024-05-17",0,0,19,59,0,20,2,67
"Congo","2024-05-18",9,0,19,68,0,20,1,68
"Congo","2024-05-19",0,0,19,68,0,20,2,70
"Congo","2024-05-20",0,0,19,68,0,20,1,71
"Congo","2024-05-21",0,0,19,68,0,20,2,73
"Congo","2024-05-22",0,0,19,68,0,20,1,74
"Congo","2024-05-23",0,0,19,68,0,20,2,76
"Congo","2024-05-24",0,0,19,68,0,20,1,77
"Congo","2024-05-25",0,0,19,68,0,20,2,79
"Congo","2024-05-26",0,0,19,68,0,20,2,81
"Congo","2024-05-27",0,0,19,68,0,20,1,82
"Congo","2024-05-28",0,0,19,68,0,20,2,84
"Congo","2024-05-29",0,0,19,68,0,20,1,85
"Congo","2024-05-30",0,0,19,68,0,20,2,87
"Congo","2024-05-31",0,0,19,68,0,20,1,88
"Congo","2024-06-01",22,0,19,90,0,20,2,90
"Congo","2024-06-02",0,0,19,90,0,20,1,91
"Congo","2024-06-03",0,0,19,90,0,20,1,92
"Congo","2024-06-04",0,0,19,90,0,20,1,93
"Congo","2024-06-05",0,0,19,90,0,20,2,95
"Congo","2024-06-06",0,0,19,90,0,20,1,96
"Congo","2024-06-07",0,0,19,90,0,20,1,97
"Congo","2024-06-08",0,0,19,90,0,20,1,98
"Congo","2024-06-09",0,0,19,90,0,20,1,99
"Congo","2024-06-10",0,0,19,90,0,20,1,100
"Congo","2024-06-11",0,0,19,90,0,20,1,101
"Congo","2024-06-12",0,0,19,90,0,20,2,103
"Congo","2024-06-13",0,0,19,90,0,20,1,104
"Congo","2024-06-14",0,0,19,90,0,20,1,105
"Congo","2024-06-15",0,0,19,90,0,20,1,106
"Congo","2024-06-16",0,0,19,90,0,20,1,107
"Congo","2024-06-17",0,0,19,90,0,20,1,108
"Congo","2024-06-18",0,0,19,90,0,20,1,109
"Congo","2024-06-19",0,0,19,90,0,20,2,111
"Congo","2024-06-20",0,0,19,90,0,20,1,112
"Congo","2024-06-21",0,0,19,90,0,20,1,113
"Congo","2024-06-22",24,0,19,114,0,20,1,114
"Congo","2024-06-23",0,0,19,114,0,20,2,116
"Congo","2024-06-24",0,0,19,114,0,20,1,117
"Congo","2024-06-25",0,0,19,114,0,20,2,119
"Congo","2024-06-26",0,0,19,114,0,20,1,120
"Congo","2024-06-27",0,0,19,114,0,20,2,122
"Congo","2024-06-28",0,0,19,114,0,20,2,124
"Congo","2024-06-29",0,0,19,114,0,20,1,125
"Congo","2024-06-30",13,0,19,127,0,20,2,127
"Congo","2024-07-01",0,0,19,127,0,20,0,127
"Congo","2024-07-02",0,0,19,127,0,20,1,128
"Congo","2024-07-03",0,0,19,127,0,20,0,128
"Congo","2024-07-04",0,0,19,127,1,21,0,128
"Congo","2024-07-05",0,0,19,127,0,21,1,129
"Congo","2024-07-06",0,0,19,127,0,21,0,129
"Congo","2024-07-07",0,0,19,127,0,21,0,129
"Congo","2024-07-08",0,0,19,127,0,21,1,130
"Congo","2024-07-09",0,0,19,127,0,21,0,130
"Congo","2024-07-10",0,0,19,127,0,21,1,131
"Congo","2024-07-11",0,0,19,127,0,21,0,131
"Congo","2024-07-12",0,0,19,127,0,21,0,131
"Congo","2024-07-13",0,0,19,127,0,21,1,132
"Congo","2024-07-14",0,0,19,127,0,21,0,132
"Congo","2024-07-15",0,0,19,127,0,21,0,132
"Congo","2024-07-16",0,0,19,127,0,21,1,133
"Congo","2024-07-17",0,0,19,127,0,21,0,133
"Congo","2024-07-18",0,0,19,127,0,21,0,133
"Congo","2024-07-19",0,0,19,127,0,21,1,134
"Congo","2024-07-20",0,0,19,127,0,21,0,134
"Congo","2024-07-21",0,0,19,127,0,21,0,134
"Congo","2024-07-22",0,0,19,127,0,21,1,135
"Congo","2024-07-23",0,0,19,127,0,21,0,135
"Congo","2024-07-24",0,0,19,127,0,21,0,135
"Congo","2024-07-25",0,0,19,127,0,21,1,136
"Congo","2024-07-26",0,0,19,127,0,21,0,136
"Congo","2024-07-27",0,0,19,127,0,21,0,136
"Congo","2024-07-28",0,0,19,127,0,21,1,137
"Congo","2024-07-29",0,0,19,127,0,21,0,137
"Congo","2024-07-30",0,0,19,127,0,21,0,137
"Congo","2024-07-31",0,0,19,127,0,21,1,138
"Congo","2024-08-01",0,0,19,127,0,21,0,138
"Congo","2024-08-02",0,0,19,127,0,21,1,139
"Congo","2024-08-03",0,0,19,127,0,21,0,139
"Congo","2024-08-04",0,0,19,127,0,21,0,139
"Congo","2024-08-05",0,0,19,127,0,21,1,140
"Congo","2024-08-06",0,0,19,127,0,21,0,140
"Congo","2024-08-07",0,0,19,127,0,21,0,140
"Congo","2024-08-08",0,0,19,127,0,21,1,141
"Congo","2024-08-09",14,0,19,141,0,21,0,141
"Congo","2024-08-10",0,0,19,141,0,21,1,142
"Congo","2024-08-11",0,2,21,141,0,21,0,142
"Congo","2024-08-12",0,0,21,141,0,21,1,143
"Congo","2024-08-13",0,0,21,141,0,21,0,143
"Congo","2024-08-14",0,0,21,141,0,21,1,144
"Congo","2024-08-15",0,0,21,141,0,21,0,144
"Congo","2024-08-16",0,0,21,141,0,21,1,145
"Congo","2024-08-17",0,0,21,141,0,21,1,146
"Congo","2024-08-18",0,0,21,141,0,21,0,146
"Congo","2024-08-19",0,0,21,141,0,21,1,147
"Congo","2024-08-20",0,0,21,141,0,21,0,147
"Congo","2024-08-21",0,0,21,141,0,21,1,148
"Congo","2024-08-22",0,0,21,141,0,21,1,149
"Congo","2024-08-23",0,0,21,141,0,21,0,149
"Congo","2024-08-24",0,0,21,141,0,21,1,150
"Congo","2024-08-25",0,0,21,141,0,21,0,150
"Congo","2024-08-26",0,0,21,141,0,21,1,151
"Congo","2024-08-27",0,0,21,141,0,21,0,151
"Congo","2024-08-28",0,0,21,141,0,21,1,152
"Congo","2024-08-29",0,0,21,141,0,21,1,153
"Congo","2024-08-30",0,0,21,141,0,21,0,153
"Congo","2024-08-31",0,0,21,141,0,21,1,154
"Congo","2024-09-01",0,0,21,141,0,21,0,154
"Congo","2024-09-02",0,0,21,141,0,21,1,155
"Congo","2024-09-03",0,0,21,141,0,21,0,155
"Congo","2024-09-04",0,0,21,141,0,21,1,156
"Congo","2024-09-05",0,0,21,141,1,22,1,157
"Congo","2024-09-06",0,0,21,141,0,22,0,157
"Congo","2024-09-07",0,0,21,141,0,22,1,158
"Congo","2024-09-08",0,0,21,141,0,22,0,158
"Congo","2024-09-09",0,0,21,141,0,22,1,159
"Congo","2024-09-10",0,0,21,141,0,22,1,160
"Congo","2024-09-11",0,0,21,141,0,22,0,160
"Congo","2024-09-12",0,0,21,141,0,22,1,161
"Congo","2024-09-13",0,0,21,141,0,22,0,161
"Congo","2024-09-14",0,0,21,141,0,22,1,162
"Congo","2024-09-15",0,0,21,141,0,22,0,162
"Congo","2024-09-16",22,0,21,163,0,22,1,163
"Congo","2024-09-17",0,0,21,163,0,22,1,164
"Congo","2024-09-18",0,0,21,163,0,22,1,165
"Congo","2024-09-19",0,0,21,163,0,22,1,166
"Congo","2024-09-20",0,0,21,163,0,22,1,167
"Congo","2024-09-21",0,0,21,163,0,22,1,168
"Congo","2024-09-22",0,0,21,163,0,22,1,169
"Congo","2024-09-23",0,0,21,163,0,22,1,170
"Congo","2024-09-24",0,0,21,163,0,22,1,171
"Congo","2024-09-25",0,0,21,163,0,22,1,172
"Congo","2024-09-26",0,0,21,163,0,22,1,173
"Congo","2024-09-27",0,0,21,163,0,22,1,174
"Congo","2024-09-28",0,0,21,163,0,22,1,175
"Congo","2024-09-29",0,1,22,163,0,22,1,176
"Congo","2024-09-30",14,0,22,177,0,22,1,177
"Congo","2024-10-01",0,0,22,177,0,22,2,179
"Congo","2024-10-02",0,0,22,177,0,22,1,180
"Congo","2024-10-03",0,0,22,177,0,22,1,181
"Congo","2024-10-04",0,0,22,177,0,22,2,183
"Congo","2024-10-05",0,0,22,177,0,22,2,185
"Congo","2024-10-06",0,0,22,177,0,22,1,186
"Congo","2024-10-07",0,0,22,177,0,22,1,187
"Congo","2024-10-08",0,0,22,177,0,22,2,189
"Congo","2024-10-09",0,0,22,177,0,22,2,191
"Congo","2024-10-10",0,0,22,177,0,22,1,192
"Congo","2024-10-11",0,0,22,177,0,22,1,193
"Congo","2024-10-12",0,0,22,177,0,22,2,195
"Congo","2024-10-13",0,0,22,177,0,22,2,197
"Congo","2024-10-14",0,0,22,177,0,22,1,198
"Congo","2024-10-15",0,0,22,177,0,22,1,199
"Congo","2024-10-16",0,0,22,177,0,22,2,201
"Congo","2024-10-17",0,0,22,177,0,22,2,203
"Congo","2024-10-18",0,0,22,177,0,22,1,204
"Congo","2024-10-19",0,0,22,177,0,22,1,205
"Congo","2024-10-20",30,0,22,207,0,22,2,207
"Congo","2024-10-21",0,0,22,207,0,22,1,208
"Congo","2024-10-22",0,0,22,207,0,22,1,209
"Congo","2024-10-23",0,0,22,207,0,22,1,210
"Congo","2024-10-24",0,0,22,207,0,22,1,211
"Congo","2024-10-25",0,0,22,207,0,22,1,212
"Congo","2024-10-26",0,0,22,207,0,22,1,213
"Congo","2024-10-27",7,0,22,214,0,22,1,214
"Congo","2024-10-28",0,0,22,214,0,22,1,215
"Congo","2024-10-29",0,0,22,214,0,22,0,215
"Congo","2024-10-30",0,0,22,214,0,22,1,216
"Congo","2024-10-31",0,0,22,214,1,23,1,217
"Congo","2024-11-01",0,0,22,214,0,23,1,218
"Congo","2024-11-02",0,0,22,214,0,23,0,218
"Congo","2024-11-03",5,0,22,219,0,23,1,219
"Congo","2024-11-04",0,0,22,219,0,23,0,219
"Congo","2024-11-05",0,0,22,219,0,23,0,219
"Congo","2024-11-06",0,0,22,219,0,23,0,219
"Congo","2024-11-07",0,0,22,219,0,23,0,219
"Congo","2024-11-08",0,0,22,219,0,23,0,219
"Congo","2024-11-09",0,0,22,219,0,23,0,219
"Congo","2024-11-10",0,0,22,219,0,23,0,219
"Congo","2024-11-11",0,0,22,219,0,23,0,219
"Congo","2024-11-12",0,0,22,219,0,23,0,219
"Congo","2024-11-13",0,0,22,219,0,23,0,219
"Congo","2024-11-14",0,0,22,219,0,23,0,219
"Congo","2024-11-15",0,0,22,219,0,23,0,219
"Congo","2024-11-16",0,0,22,219,0,23,0,219
"Congo","2024-11-17",0,0,22,219,0,23,0,219
"Congo","2024-11-18",0,0,22,219,0,23,0,219
"Congo","2024-11-19",0,0,22,219,0,23,0,219
"Congo","2024-11-20",0,0,22,219,0,23,0,219
"Congo","2024-11-21",0,0,22,219,0,23,0,219
"Congo","2024-11-22",0,0,22,219,0,23,0,219
"Congo","2024-11-23",0,0,22,219,0,23,0,219
"Congo","2024-11-24",0,0,22,219,0,23,0,219
"Congo","2024-11-25",0,0,22,219,0,23,0,219
"Congo","2024-11-26",0,0,22,219,0,23,0,219
"Congo","2024-11-27",0,0,22,219,0,23,0,219
"Congo","2024-11-28",0,0,22,219,0,23,0,219
"Congo","2024-11-29",0,0,22,219,0,23,0,219
"Congo","2024-11-30",0,0,22,219,0,23,0,219
"Congo","2024-12-01",0,1,23,219,0,23,0,219
"Congo","2024-12-02",0,0,23,219,0,23,0,219
"Congo","2024-12-03",0,0,23,219,0,23,0,219
"Congo","2024-12-04",0,0,23,219,0,23,0,219
"Congo","2024-12-05",0,0,23,219,0,23,0,219
"Congo","2024-12-06",0,0,23,219,0,23,0,219
"Congo","2024-12-07",0,0,23,219,0,23,0,219
"Congo","2024-12-08",0,0,23,219,0,23,0,219
"Congo","2024-12-09",0,0,23,219,0,23,0,219
"Congo","2024-12-10",0,0,23,219,0,23,0,219
"Congo","2024-12-11",0,0,23,219,0,23,0,219
"Congo","2024-12-12",0,0,23,219,0,23,0,219
"Congo","2024-12-13",0,0,23,219,0,23,0,219
"Congo","2024-12-14",0,0,23,219,0,23,0,219
"Congo","2024-12-15",0,0,23,219,0,23,0,219
"Congo","2024-12-16",0,0,23,219,1,24,0,219
"Congo","2024-12-17",0,0,23,219,0,24,0,219
"Congo","2024-12-18",0,0,23,219,0,24,0,219
"Congo","2024-12-19",0,0,23,219,0,24,0,219
"Congo","2024-12-20",0,0,23,219,0,24,0,219
"Congo","2024-12-21",0,0,23,219,0,24,0,219
"Congo","2024-12-22",0,0,23,219,0,24,0,219
"Congo","2024-12-23",0,0,23,219,0,24,0,219
"Congo","2024-12-24",0,0,23,219,0,24,0,219
"Congo","2024-12-25",0,0,23,219,0,24,0,219
"Congo","2024-12-26",0,0,23,219,0,24,0,219
"Congo","2024-12-27",0,0,23,219,0,24,0,219
"Congo","2024-12-28",0,0,23,219,0,24,0,219
"Congo","2024-12-29",0,1,24,219,0,24,0,219
"Congo","2024-12-30",0,0,24,219,0,24,0,219
"Congo","2024-12-31",0,0,24,219,0,24,0,219
"Congo","2025-01-01",0,0,24,219,0,24,0,219
"Congo","2025-01-02",0,0,24,219,0,24,0,219
"Congo","2025-01-03",0,0,24,219,0,24,0,219
"Congo","2025-01-04",0,0,24,219,0,24,0,219
"Congo","2025-01-05",0,0,24,219,0,24,0,219
"Congo","2025-01-06",0,0,24,219,1,25,0,219
"Congo","2025-01-07",0,0,24,219,0,25,0,219
"Congo","2025-01-08",0,0,24,219,0,25,0,219
"Congo","2025-01-09",0,0,24,219,0,25,0,219
"Congo","2025-01-10",0,0,24,219,0,25,0,219
"Congo","2025-01-11",0,0,24,219,0,25,0,219
"Congo","2025-01-12",0,1,25,219,0,25,0,219
"Congo","2025-01-13",0,0,25,219,0,25,0,219
"Congo","2025-01-14",0,0,25,219,0,25,0,219
"Congo","2025-01-15",0,0,25,219,0,25,0,219
"Congo","2025-01-16",0,0,25,219,1,26,0,219
"Congo","2025-01-17",0,0,25,219,0,26,0,219
"Congo","2025-01-18",0,0,25,219,0,26,0,219
"Congo","2025-01-19",0,1,26,219,0,26,0,219
"Congo","2025-01-20",0,0,26,219,0,26,0,219
"Congo","2025-01-21",0,0,26,219,1,27,0,219
"Congo","2025-01-22",0,0,26,219,0,27,0,219
"Congo","2025-01-23",0,0,26,219,1,28,0,219
"Congo","2025-01-24",0,0,26,219,0,28,0,219
"Congo","2025-01-25",0,0,26,219,1,29,0,219
"Congo","2025-01-26",0,3,29,219,0,29,0,219
"Congo","2025-01-27",0,0,29,219,1,30,0,219
"Congo","2025-01-28",0,0,29,219,0,30,0,219
"Congo","2025-01-29",0,0,29,219,1,31,0,219
"Congo","2025-01-30",0,0,29,219,0,31,0,219
"Congo","2025-01-31",0,0,29,219,1,32,0,219
"Congo","2025-02-01",0,0,29,219,0,32,0,219
"Congo","2025-02-02",0,4,33,219,1,33,0,219
"Congo","2025-02-03",0,0,33,219,0,33,0,219
"Congo","2025-02-04",0,0,33,219,0,33,0,219
"Congo","2025-02-05",0,0,33,219,0,33,0,219
"Congo","2025-02-06",0,0,33,219,0,33,0,219
"Congo","2025-02-07",0,0,33,219,0,33,0,219
"Congo","2025-02-08",0,0,33,219,0,33,0,219
"Congo","2025-02-09",0,0,33,219,0,33,0,219
"Congo","2025-02-10",0,0,33,219,0,33,0,219
"Congo","2025-02-11",0,0,33,219,0,33,0,219
"Congo","2025-02-12",0,0,33,219,0,33,0,219
"Congo","2025-02-13",0,0,33,219,0,33,0,219
"Congo","2025-02-14",0,0,33,219,0,33,0,219
"Congo","2025-02-15",0,0,33,219,0,33,0,219
"Congo","2025-02-16",0,0,33,219,0,33,0,219
"Congo","2025-02-17",0,0,33,219,0,33,0,219
"Congo","2025-02-18",0,0,33,219,0,33,0,219
"Congo","2025-02-19",0,0,33,219,0,33,0,219
"Congo","2025-02-20",0,0,33,219,0,33,0,219
"Congo","2025-02-21",0,0,33,219,0,33,0,219
"Congo","2025-02-22",0,0,33,219,0,33,0,219
"Congo","2025-02-23",0,0,33,219,0,33,0,219
"Congo","2025-02-24",0,0,33,219,0,33,0,219
"Congo","2025-02-25",0,0,33,219,0,33,0,219
"Congo","2025-02-26",0,0,33,219,0,33,0,219
"Congo","2025-02-27",0,0,33,219,0,33,0,219
"Congo","2025-02-28",0,0,33,219,0,33,0,219
"Congo","2025-03-01",0,0,33,219,0,33,0,219
"Congo","2025-03-02",0,0,33,219,0,33,0,219
"Congo","2025-03-03",0,0,33,219,0,33,0,219
"Costa Rica","2024-01-01",0,0,0,0,0,0,0,0
"Costa Rica","2024-01-02",0,0,0,0,0,0,0,0
"Costa Rica","2024-01-03",0,0,0,0,0,0,0,0
"Costa Rica","2024-01-04",0,0,0,0,0,0,0,0
"Costa Rica","2024-01-05",0,0,0,0,0,0,0,0
"Costa Rica","2024-01-06",0,0,0,0,0,0,0,0
"Costa Rica","2024-01-07",0,0,0,0,0,0,0,0
"Costa Rica","2024-01-08",0,0,0,0,0,0,0,0
"Costa Rica","2024-01-09",0,0,0,0,0,0,0,0
"Costa Rica","2024-01-10",0,0,0,0,0,0,0,0
"Costa Rica","2024-01-11",0,0,0,0,0,0,0,0
"Costa Rica","2024-01-12",0,0,0,0,0,0,0,0
"Costa Rica","2024-01-13",0,0,0,0,0,0,0,0
"Costa Rica","2024-01-14",0,0,0,0,0,0,0,0
"Costa Rica","2024-01-15",0,0,0,0,0,0,0,0
"Costa Rica","2024-01-16",0,0,0,0,0,0,0,0
"Costa Rica","2024-01-17",0,0,0,0,0,0,0,0
"Costa Rica","2024-01-18",0,0,0,0,0,0,0,0
"Costa Rica","2024-01-19",0,0,0,0,0,0,0,0
"Costa Rica","2024-01-20",0,0,0,0,0,0,0,0
"Costa Rica","2024-01-21",0,0,0,0,0,0,0,0
"Costa Rica","2024-01-22",0,0,0,0,0,0,0,0
"Costa Rica","2024-01-23",0,0,0,0,0,0,0,0
"Costa Rica","2024-01-24",0,0,0,0,0,0,0,0
"Costa Rica","2024-01-25",0,0,0,0,0,0,0,0
"Costa Rica","2024-01-26",0,0,0,0,0,0,0,0
"Costa Rica","2024-01-27",0,0,0,0,0,0,0,0
"Costa Rica","2024-01-28",0,0,0,0,0,0,0,0
"Costa Rica","2024-01-29",0,0,0,0,0,0,0,0
"Costa Rica","2024-01-30",0,0,0,0,0,0,0,0
"Costa Rica","2024-01-31",0,0,0,0,0,0,0,0
"Costa Rica","2024-02-01",0,0,0,0,0,0,0,0
"Costa Rica","2024-02-02",0,0,0,0,0,0,0,0
"Costa Rica","2024-02-03",0,0,0,0,0,0,0,0
"Costa Rica","2024-02-04",0,0,0,0,0,0,0,0
"Costa Rica","2024-02-05",0,0,0,0,0,0,0,0
"Costa Rica","2024-02-06",0,0,0,0,0,0,0,0
"Costa Rica","2024-02-07",0,0,0,0,0,0,0,0
"Costa Rica","2024-02-08",0,0,0,0,0,0,0,0
"Costa Rica","2024-02-09",0,0,0,0,0,0,0,0
"Costa Rica","2024-02-10",0,0,0,0,0,0,0,0
"Costa Rica","2024-02-11",0,0,0,0,0,0,0,0
"Costa Rica","2024-02-12",0,0,0,0,0,0,0,0
"Costa Rica","2024-02-13",0,0,0,0,0,0,0,0
"Costa Rica","2024-02-14",0,0,0,0,0,0,0,0
"Costa Rica","2024-02-15",0,0,0,0,0,0,0,0
"Costa Rica","2024-02-16",0,0,0,0,0,0,0,0
"Costa Rica","2024-02-17",0,0,0,0,0,0,0,0
"Costa Rica","2024-02-18",0,0,0,0,0,0,0,0
"Costa Rica","2024-02-19",0,0,0,0,0,0,0,0
"Costa Rica","2024-02-20",0,0,0,0,0,0,0,0
"Costa Rica","2024-02-21",0,0,0,0,0,0,0,0
"Costa Rica","2024-02-22",0,0,0,0,0,0,0,0
"Costa Rica","2024-02-23",0,0,0,0,0,0,0,0
"Costa Rica","2024-02-24",0,0,0,0,0,0,0,0
"Costa Rica","2024-02-25",0,0,0,0,0,0,0,0
"Costa Rica","2024-02-26",0,0,0,0,0,0,0,0
"Costa Rica","2024-02-27",0,0,0,0,0,0,0,0
"Costa Rica","2024-02-28",0,0,0,0,0,0,0,0
"Costa Rica","2024-02-29",0,0,0,0,0,0,0,0
"Costa Rica","2024-03-01",0,0,0,0,0,0,0,0
"Costa Rica","2024-03-02",0,0,0,0,0,0,0,0
"Costa Rica","2024-03-03",0,0,0,0,0,0,0,0
"Costa Rica","2024-03-04",0,0,0,0,0,0,0,0
"Costa Rica","2024-03-05",0,1,1,0,1,1,0,0
"Costa Rica","2024-03-06",0,0,1,0,0,1,0,0
"Costa Rica","2024-03-07",0,0,1,0,0,1,0,0
"Costa Rica","2024-03-08",0,0,1,0,0,1,0,0
"Costa Rica","2024-03-09",0,0,1,0,0,1,0,0
"Costa Rica","2024-03-10",0,0,1,0,0,1,0,0
"Costa Rica","2024-03-11",0,0,1,0,0,1,0,0
"Costa Rica","2024-03-12",0,0,1,0,0,1,0,0
"Costa Rica","2024-03-13",0,0,1,0,0,1,0,0
"Costa Rica","2024-03-14",0,0,1,0,0,1,0,0
"Costa Rica","2024-03-15",0,0,1,0,0,1,0,0
"Costa Rica","2024-03-16",0,0,1,0,0,1,0,0
"Costa Rica","2024-03-17",0,0,1,0,0,1,0,0
"Costa Rica","2024-03-18",0,0,1,0,0,1,0,0
"Costa Rica","2024-03-19",0,0,1,0,0,1,0,0
"Costa Rica","2024-03-20",0,0,1,0,0,1,0,0
"Costa Rica","2024-03-21",0,0,1,0,0,1,0,0
"Costa Rica","2024-03-22",0,0,1,0,0,1,0,0
"Costa Rica","2024-03-23",0,0,1,0,0,1,0,0
"Costa Rica","2024-03-24",0,0,1,0,0,1,0,0
"Costa Rica","2024-03-25",0,0,1,0,0,1,0,0
"Costa Rica","2024-03-26",0,0,1,0,0,1,0,0
"Costa Rica","2024-03-27",0,0,1,0,0,1,0,0
"Costa Rica","2024-03-28",0,0,1,0,0,1,0,0
"Costa Rica","2024-03-29",0,0,1,0,0,1,0,0
"Costa Rica","2024-03-30",0,0,1,0,0,1,0,0
"Costa Rica","2024-03-31",0,0,1,0,0,1,0,0
"Costa Rica","2024-04-01",0,0,1,0,0,1,0,0
"Costa Rica","2024-04-02",0,0,1,0,0,1,0,0
"Costa Rica","2024-04-03",0,0,1,0,0,1,0,0
"Costa Rica","2024-04-04",0,0,1,0,0,1,0,0
"Costa Rica","2024-04-05",0,0,1,0,0,1,0,0
"Costa Rica","2024-04-06",0,0,1,0,0,1,0,0
"Costa Rica","2024-04-07",0,0,1,0,0,1,0,0
"Costa Rica","2024-04-08",0,0,1,0,0,1,0,0
"Costa Rica","2024-04-09",0,0,1,0,0,1,0,0
"Costa Rica","2024-04-10",0,0,1,0,0,1,0,0
"Costa Rica","2024-04-11",0,0,1,0,0,1,0,0
"Costa Rica","2024-04-12",0,0,1,0,0,1,0,0
"Costa Rica","2024-04-13",0,0,1,0,0,1,0,0
"Costa Rica","2024-04-14",0,0,1,0,0,1,0,0
"Costa Rica","2024-04-15",0,0,1,0,0,1,0,0
"Costa Rica","2024-04-16",0,0,1,0,0,1,0,0
"Costa Rica","2024-04-17",0,0,1,0,0,1,0,0
"Costa Rica","2024-04-18",0,0,1,0,0,1,0,0
"Costa Rica","2024-04-19",0,0,1,0,0,1,0,0
"Costa Rica","2024-04-20",0,0,1,0,0,1,0,0
"Costa Rica","2024-04-21",0,0,1,0,0,1,0,0
"Costa Rica","2024-04-22",0,0,1,0,0,1,0,0
"Costa Rica","2024-04-23",0,0,1,0,0,1,0,0
"Costa Rica","2024-04-24",0,0,1,0,0,1,0,0
"Costa Rica","2024-04-25",0,0,1,0,0,1,0,0
"Costa Rica","2024-04-26",0,0,1,0,0,1,0,0
"Costa Rica","2024-04-27",0,0,1,0,0,1,0,0
"Costa Rica","2024-04-28",0,0,1,0,0,1,0,0
"Costa Rica","2024-04-29",0,0,1,0,0,1,0,0
"Costa Rica","2024-04-30",0,0,1,0,0,1,0,0
"Costa Rica","2024-05-01",0,0,1,0,0,1,0,0
"Costa Rica","2024-05-02",0,0,1,0,0,1,0,0
"Costa Rica","2024-05-03",0,0,1,0,0,1,0,0
"Costa Rica","2024-05-04",0,0,1,0,0,1,0,0
"Costa Rica","2024-05-05",0,0,1,0,0,1,0,0
"Costa Rica","2024-05-06",0,0,1,0,0,1,0,0
"Costa Rica","2024-05-07",0,0,1,0,0,1,0,0
"Costa Rica","2024-05-08",0,0,1,0,0,1,0,0
"Costa Rica","2024-05-09",0,0,1,0,0,1,0,0
"Costa Rica","2024-05-10",0,0,1,0,0,1,0,0
"Costa Rica","2024-05-11",0,0,1,0,0,1,0,0
"Costa Rica","2024-05-12",0,0,1,0,0,1,0,0
"Costa Rica","2024-05-13",0,0,1,0,0,1,0,0
"Costa Rica","2024-05-14",0,0,1,0,0,1,0,0
"Costa Rica","2024-05-15",0,0,1,0,0,1,0,0
"Costa Rica","2024-05-16",0,0,1,0,0,1,0,0
"Costa Rica","2024-05-17",0,0,1,0,0,1,0,0
"Costa Rica","2024-05-18",0,0,1,0,0,1,0,0
"Costa Rica","2024-05-19",0,0,1,0,0,1,0,0
"Costa Rica","2024-05-20",0,0,1,0,0,1,0,0
"Costa Rica","2024-05-21",0,0,1,0,0,1,0,0
"Costa Rica","2024-05-22",0,0,1,0,0,1,0,0
"Costa Rica","2024-05-23",0,0,1,0,0,1,0,0
"Costa Rica","2024-05-24",0,0,1,0,0,1,0,0
"Costa Rica","2024-05-25",0,0,1,0,0,1,0,0
"Costa Rica","2024-05-26",0,0,1,0,0,1,0,0
"Costa Rica","2024-05-27",0,0,1,0,0,1,0,0
"Costa Rica","2024-05-28",0,0,1,0,0,1,0,0
"Costa Rica","2024-05-29",0,0,1,0,0,1,0,0
"Costa Rica","2024-05-30",0,0,1,0,0,1,0,0
"Costa Rica","2024-05-31",0,0,1,0,0,1,0,0
"Costa Rica","2024-06-01",0,0,1,0,0,1,0,0
"Costa Rica","2024-06-02",0,0,1,0,0,1,0,0
"Costa Rica","2024-06-03",0,0,1,0,0,1,0,0
"Costa Rica","2024-06-04",0,0,1,0,0,1,0,0
"Costa Rica","2024-06-05",0,0,1,0,0,1,0,0
"Costa Rica","2024-06-06",0,0,1,0,0,1,0,0
"Costa Rica","2024-06-07",0,0,1,0,0,1,0,0
"Costa Rica","2024-06-08",0,0,1,0,0,1,0,0
"Costa Rica","2024-06-09",0,0,1,0,0,1,0,0
"Costa Rica","2024-06-10",0,0,1,0,0,1,0,0
"Costa Rica","2024-06-11",0,0,1,0,0,1,0,0
"Costa Rica","2024-06-12",0,0,1,0,0,1,0,0
"Costa Rica","2024-06-13",0,0,1,0,0,1,0,0
"Costa Rica","2024-06-14",0,0,1,0,0,1,0,0
"Costa Rica","2024-06-15",0,0,1,0,0,1,0,0
"Costa Rica","2024-06-16",0,0,1,0,0,1,0,0
"Costa Rica","2024-06-17",0,0,1,0,0,1,0,0
"Costa Rica","2024-06-18",0,0,1,0,0,1,0,0
"Costa Rica","2024-06-19",0,0,1,0,0,1,0,0
"Costa Rica","2024-06-20",0,0,1,0,0,1,0,0
"Costa Rica","2024-06-21",0,0,1,0,0,1,0,0
"Costa Rica","2024-06-22",0,0,1,0,0,1,0,0
"Costa Rica","2024-06-23",0,0,1,0,0,1,0,0
"Costa Rica","2024-06-24",0,0,1,0,0,1,0,0
"Costa Rica","2024-06-25",0,0,1,0,0,1,0,0
"Costa Rica","2024-06-26",0,0,1,0,0,1,0,0
"Costa Rica","2024-06-27",0,0,1,0,0,1,0,0
"Costa Rica","2024-06-28",0,0,1,0,0,1,0,0
"Costa Rica","2024-06-29",0,0,1,0,0,1,0,0
"Costa Rica","2024-06-30",0,0,1,0,0,1,0,0
"Costa Rica","2024-07-01",0,0,1,0,0,1,0,0
"Costa Rica","2024-07-02",0,0,1,0,0,1,0,0
"Costa Rica","2024-07-03",0,0,1,0,0,1,0,0
"Costa Rica","2024-07-04",0,0,1,0,0,1,0,0
"Costa Rica","2024-07-05",0,0,1,0,0,1,0,0
"Costa Rica","2024-07-06",0,0,1,0,0,1,0,0
"Costa Rica","2024-07-07",0,0,1,0,0,1,0,0
"Costa Rica","2024-07-08",0,0,1,0,0,1,0,0
"Costa Rica","2024-07-09",0,0,1,0,0,1,0,0
"Costa Rica","2024-07-10",0,0,1,0,0,1,0,0
"Costa Rica","2024-07-11",0,0,1,0,0,1,0,0
"Costa Rica","2024-07-12",0,0,1,0,0,1,0,0
"Costa Rica","2024-07-13",0,0,1,0,0,1,0,0
"Costa Rica","2024-07-14",0,0,1,0,0,1,0,0
"Costa Rica","2024-07-15",0,0,1,0,0,1,0,0
"Costa Rica","2024-07-16",0,0,1,0,0,1,0,0
"Costa Rica","2024-07-17",0,0,1,0,0,1,0,0
"Costa Rica","2024-07-18",0,0,1,0,0,1,0,0
"Costa Rica","2024-07-19",0,0,1,0,0,1,0,0
"Costa Rica","2024-07-20",0,0,1,0,0,1,0,0
"Costa Rica","2024-07-21",0,0,1,0,0,1,0,0
"Costa Rica","2024-07-22",0,0,1,0,0,1,0,0
"Costa Rica","2024-07-23",0,0,1,0,0,1,0,0
"Costa Rica","2024-07-24",0,0,1,0,0,1,0,0
"Costa Rica","2024-07-25",0,0,1,0,0,1,0,0
"Costa Rica","2024-07-26",0,0,1,0,0,1,0,0
"Costa Rica","2024-07-27",0,0,1,0,0,1,0,0
"Costa Rica","2024-07-28",0,0,1,0,0,1,0,0
"Costa Rica","2024-07-29",0,0,1,0,0,1,0,0
"Costa Rica","2024-07-30",0,0,1,0,0,1,0,0
"Costa Rica","2024-07-31",0,0,1,0,0,1,0,0
"Costa Rica","2024-08-01",0,0,1,0,0,1,0,0
"Costa Rica","2024-08-02",0,0,1,0,0,1,0,0
"Costa Rica","2024-08-03",0,0,1,0,0,1,0,0
"Costa Rica","2024-08-04",0,0,1,0,0,1,0,0
"Costa Rica","2024-08-05",0,0,1,0,0,1,0,0
"Costa Rica","2024-08-06",0,0,1,0,0,1,0,0
"Costa Rica","2024-08-07",0,0,1,0,0,1,0,0
"Costa Rica","2024-08-08",0,0,1,0,0,1,0,0
"Costa Rica","2024-08-09",0,0,1,0,0,1,0,0
"Costa Rica","2024-08-10",0,0,1,0,0,1,0,0
"Costa Rica","2024-08-11",0,0,1,0,0,1,0,0
"Costa Rica","2024-08-12",0,0,1,0,0,1,0,0
"Costa Rica","2024-08-13",0,0,1,0,0,1,0,0
"Costa Rica","2024-08-14",0,0,1,0,0,1,0,0
"Costa Rica","2024-08-15",0,0,1,0,0,1,0,0
"Costa Rica","2024-08-16",0,0,1,0,0,1,0,0
"Costa Rica","2024-08-17",0,0,1,0,0,1,0,0
"Costa Rica","2024-08-18",0,0,1,0,0,1,0,0
"Costa Rica","2024-08-19",0,0,1,0,0,1,0,0
"Costa Rica","2024-08-20",0,0,1,0,0,1,0,0
"Costa Rica","2024-08-21",0,0,1,0,0,1,0,0
"Costa Rica","2024-08-22",0,0,1,0,0,1,0,0
"Costa Rica","2024-08-23",0,0,1,0,0,1,0,0
"Costa Rica","2024-08-24",0,0,1,0,0,1,0,0
"Costa Rica","2024-08-25",0,0,1,0,0,1,0,0
"Costa Rica","2024-08-26",0,0,1,0,0,1,0,0
"Costa Rica","2024-08-27",0,0,1,0,0,1,0,0
"Costa Rica","2024-08-28",0,0,1,0,0,1,0,0
"Costa Rica","2024-08-29",0,0,1,0,0,1,0,0
"Costa Rica","2024-08-30",0,0,1,0,0,1,0,0
"Costa Rica","2024-08-31",0,0,1,0,0,1,0,0
"Costa Rica","2024-09-01",0,0,1,0,0,1,0,0
"Costa Rica","2024-09-02",0,0,1,0,0,1,0,0
"Costa Rica","2024-09-03",0,0,1,0,0,1,0,0
"Costa Rica","2024-09-04",0,0,1,0,0,1,0,0
"Costa Rica","2024-09-05",0,0,1,0,0,1,0,0
"Costa Rica","2024-09-06",0,0,1,0,0,1,0,0
"Costa Rica","2024-09-07",0,0,1,0,0,1,0,0
"Costa Rica","2024-09-08",0,0,1,0,0,1,0,0
"Costa Rica","2024-09-09",0,0,1,0,0,1,0,0
"Costa Rica","2024-09-10",0,0,1,0,0,1,0,0
"Costa Rica","2024-09-11",0,0,1,0,0,1,0,0
"Costa Rica","2024-09-12",0,0,1,0,0,1,0,0
"Costa Rica","2024-09-13",0,0,1,0,0,1,0,0
"Costa Rica","2024-09-14",0,0,1,0,0,1,0,0
"Costa Rica","2024-09-15",0,0,1,0,0,1,0,0
"Costa Rica","2024-09-16",0,0,1,0,0,1,0,0
"Costa Rica","2024-09-17",0,0,1,0,0,1,0,0
"Costa Rica","2024-09-18",0,0,1,0,0,1,0,0
"Costa Rica","2024-09-19",0,0,1,0,0,1,0,0
"Costa Rica","2024-09-20",0,0,1,0,0,1,0,0
"Costa Rica","2024-09-21",0,0,1,0,0,1,0,0
"Costa Rica","2024-09-22",0,0,1,0,0,1,0,0
"Costa Rica","2024-09-23",0,0,1,0,0,1,0,0
"Costa Rica","2024-09-24",0,0,1,0,0,1,0,0
"Costa Rica","2024-09-25",0,0,1,0,0,1,0,0
"Costa Rica","2024-09-26",0,0,1,0,0,1,0,0
"Costa Rica","2024-09-27",0,0,1,0,0,1,0,0
"Costa Rica","2024-09-28",0,0,1,0,0,1,0,0
"Costa Rica","2024-09-29",0,0,1,0,0,1,0,0
"Costa Rica","2024-09-30",0,0,1,0,0,1,0,0
"Costa Rica","2024-10-01",0,0,1,0,0,1,0,0
"Costa Rica","2024-10-02",0,0,1,0,0,1,0,0
"Costa Rica","2024-10-03",0,0,1,0,0,1,0,0
"Costa Rica","2024-10-04",0,0,1,0,0,1,0,0
"Costa Rica","2024-10-05",0,0,1,0,0,1,0,0
"Costa Rica","2024-10-06",0,0,1,0,0,1,0,0
"Costa Rica","2024-10-07",0,0,1,0,0,1,0,0
"Costa Rica","2024-10-08",0,0,1,0,0,1,0,0
"Costa Rica","2024-10-09",0,0,1,0,0,1,0,0
"Costa Rica","2024-10-10",0,0,1,0,0,1,0,0
"Costa Rica","2024-10-11",0,0,1,0,0,1,0,0
"Costa Rica","2024-10-12",0,0,1,0,0,1,0,0
"Costa Rica","2024-10-13",0,0,1,0,0,1,0,0
"Costa Rica","2024-10-14",0,0,1,0,0,1,0,0
"Costa Rica","2024-10-15",0,0,1,0,0,1,0,0
"Costa Rica","2024-10-16",0,0,1,0,0,1,0,0
"Costa Rica","2024-10-17",0,0,1,0,0,1,0,0
"Costa Rica","2024-10-18",0,0,1,0,0,1,0,0
"Costa Rica","2024-10-19",0,0,1,0,0,1,0,0
"Costa Rica","2024-10-20",0,0,1,0,0,1,0,0
"Costa Rica","2024-10-21",0,0,1,0,0,1,0,0
"Costa Rica","2024-10-22",0,0,1,0,0,1,0,0
"Costa Rica","2024-10-23",0,0,1,0,0,1,0,0
"Costa Rica","2024-10-24",0,0,1,0,0,1,0,0
"Costa Rica","2024-10-25",0,0,1,0,0,1,0,0
"Costa Rica","2024-10-26",0,0,1,0,0,1,0,0
"Costa Rica","2024-10-27",0,0,1,0,0,1,0,0
"Costa Rica","2024-10-28",0,0,1,0,0,1,0,0
"Costa Rica","2024-10-29",0,0,1,0,0,1,0,0
"Costa Rica","2024-10-30",0,0,1,0,0,1,0,0
"Costa Rica","2024-10-31",0,0,1,0,0,1,0,0
"Costa Rica","2024-11-01",0,0,1,0,0,1,0,0
"Costa Rica","2024-11-02",0,0,1,0,0,1,0,0
"Costa Rica","2024-11-03",0,0,1,0,0,1,0,0
"Costa Rica","2024-11-04",0,0,1,0,0,1,0,0
"Costa Rica","2024-11-05",0,0,1,0,0,1,0,0
"Costa Rica","2024-11-06",0,0,1,0,0,1,0,0
"Costa Rica","2024-11-07",0,0,1,0,0,1,0,0
"Costa Rica","2024-11-08",0,0,1,0,0,1,0,0
"Costa Rica","2024-11-09",0,0,1,0,0,1,0,0
"Costa Rica","2024-11-10",0,0,1,0,0,1,0,0
"Costa Rica","2024-11-11",0,0,1,0,0,1,0,0
"Costa Rica","2024-11-12",0,0,1,0,0,1,0,0
"Costa Rica","2024-11-13",0,0,1,0,0,1,0,0
"Costa Rica","2024-11-14",0,0,1,0,0,1,0,0
"Costa Rica","2024-11-15",0,0,1,0,0,1,0,0
"Costa Rica","2024-11-16",0,0,1,0,0,1,0,0
"Costa Rica","2024-11-17",0,0,1,0,0,1,0,0
"Costa Rica","2024-11-18",0,0,1,0,0,1,0,0
"Costa Rica","2024-11-19",0,0,1,0,0,1,0,0
"Costa Rica","2024-11-20",0,0,1,0,0,1,0,0
"Costa Rica","2024-11-21",0,0,1,0,0,1,0,0
"Costa Rica","2024-11-22",0,0,1,0,0,1,0,0
"Costa Rica","2024-11-23",0,0,1,0,0,1,0,0
"Costa Rica","2024-11-24",0,0,1,0,0,1,0,0
"Costa Rica","2024-11-25",0,0,1,0,0,1,0,0
"Costa Rica","2024-11-26",0,0,1,0,0,1,0,0
"Costa Rica","2024-11-27",0,0,1,0,0,1,0,0
"Costa Rica","2024-11-28",0,0,1,0,0,1,0,0
"Costa Rica","2024-11-29",0,0,1,0,0,1,0,0
"Costa Rica","2024-11-30",0,0,1,0,0,1,0,0
"Costa Rica","2024-12-01",0,0,1,0,0,1,0,0
"Costa Rica","2024-12-02",0,0,1,0,0,1,0,0
"Costa Rica","2024-12-03",0,0,1,0,0,1,0,0
"Costa Rica","2024-12-04",0,0,1,0,0,1,0,0
"Costa Rica","2024-12-05",0,0,1,0,0,1,0,0
"Costa Rica","2024-12-06",0,0,1,0,0,1,0,0
"Costa Rica","2024-12-07",0,0,1,0,0,1,0,0
"Costa Rica","2024-12-08",0,0,1,0,0,1,0,0
"Costa Rica","2024-12-09",0,0,1,0,0,1,0,0
"Costa Rica","2024-12-10",0,0,1,0,0,1,0,0
"Costa Rica","2024-12-11",0,0,1,0,0,1,0,0
"Costa Rica","2024-12-12",0,0,1,0,0,1,0,0
"Costa Rica","2024-12-13",0,0,1,0,0,1,0,0
"Costa Rica","2024-12-14",0,0,1,0,0,1,0,0
"Costa Rica","2024-12-15",0,0,1,0,0,1,0,0
"Costa Rica","2024-12-16",0,0,1,0,0,1,0,0
"Costa Rica","2024-12-17",0,0,1,0,0,1,0,0
"Costa Rica","2024-12-18",0,0,1,0,0,1,0,0
"Costa Rica","2024-12-19",0,0,1,0,0,1,0,0
"Costa Rica","2024-12-20",0,0,1,0,0,1,0,0
"Costa Rica","2024-12-21",0,0,1,0,0,1,0,0
"Costa Rica","2024-12-22",0,0,1,0,0,1,0,0
"Costa Rica","2024-12-23",0,0,1,0,0,1,0,0
"Costa Rica","2024-12-24",0,0,1,0,0,1,0,0
"Costa Rica","2024-12-25",0,0,1,0,0,1,0,0
"Costa Rica","2024-12-26",0,0,1,0,0,1,0,0
"Costa Rica","2024-12-27",0,0,1,0,0,1,0,0
"Costa Rica","2024-12-28",0,0,1,0,0,1,0,0
"Costa Rica","2024-12-29",0,0,1,0,0,1,0,0
"Costa Rica","2024-12-30",0,0,1,0,0,1,0,0
"Costa Rica","2024-12-31",0,0,1,0,0,1,0,0
"Costa Rica","2025-01-01",0,0,1,0,0,1,0,0
"Costa Rica","2025-01-02",0,0,1,0,0,1,0,0
"Costa Rica","2025-01-03",0,0,1,0,0,1,0,0
"Costa Rica","2025-01-04",0,0,1,0,0,1,0,0
"Costa Rica","2025-01-05",0,0,1,0,0,1,0,0
"Costa Rica","2025-01-06",0,0,1,0,0,1,0,0
"Costa Rica","2025-01-07",0,0,1,0,0,1,0,0
"Costa Rica","2025-01-08",0,0,1,0,0,1,0,0
"Costa Rica","2025-01-09",0,0,1,0,0,1,0,0
"Costa Rica","2025-01-10",0,0,1,0,0,1,0,0
"Costa Rica","2025-01-11",0,0,1,0,0,1,0,0
"Costa Rica","2025-01-12",0,0,1,0,0,1,0,0
"Costa Rica","2025-01-13",0,0,1,0,0,1,0,0
"Costa Rica","2025-01-14",0,0,1,0,0,1,0,0
"Costa Rica","2025-01-15",0,0,1,0,0,1,0,0
"Costa Rica","2025-01-16",0,0,1,0,0,1,0,0
"Costa Rica","2025-01-17",0,0,1,0,0,1,0,0
"Costa Rica","2025-01-18",0,0,1,0,0,1,0,0
"Costa Rica","2025-01-19",0,0,1,0,0,1,0,0
"Costa Rica","2025-01-20",0,0,1,0,0,1,0,0
"Costa Rica","2025-01-21",0,0,1,0,0,1,0,0
"Costa Rica","2025-01-22",0,0,1,0,0,1,0,0
"Costa Rica","2025-01-23",0,0,1,0,0,1,0,0
"Costa Rica","2025-01-24",0,0,1,0,0,1,0,0
"Costa Rica","2025-01-25",0,0,1,0,0,1,0,0
"Costa Rica","2025-01-26",0,0,1,0,0,1,0,0
"Costa Rica","2025-01-27",0,0,1,0,0,1,0,0
"Costa Rica","2025-01-28",0,0,1,0,0,1,0,0
"Costa Rica","2025-01-29",0,0,1,0,0,1,0,0
"Costa Rica","2025-01-30",0,0,1,0,0,1,0,0
"Costa Rica","2025-01-31",0,0,1,0,0,1,0,0
"Costa Rica","2025-02-01",0,0,1,0,0,1,0,0
"Costa Rica","2025-02-02",0,0,1,0,0,1,0,0
"Costa Rica","2025-02-03",0,0,1,0,0,1,0,0
"Costa Rica","2025-02-04",0,0,1,0,0,1,0,0
"Costa Rica","2025-02-05",0,0,1,0,0,1,0,0
"Costa Rica","2025-02-06",0,0,1,0,0,1,0,0
"Costa Rica","2025-02-07",0,0,1,0,0,1,0,0
"Costa Rica","2025-02-08",0,0,1,0,0,1,0,0
"Costa Rica","2025-02-09",0,0,1,0,0,1,0,0
"Costa Rica","2025-02-10",0,0,1,0,0,1,0,0
"Costa Rica","2025-02-11",0,0,1,0,0,1,0,0
"Costa Rica","2025-02-12",0,0,1,0,0,1,0,0
"Costa Rica","2025-02-13",0,0,1,0,0,1,0,0
"Costa Rica","2025-02-14",0,0,1,0,0,1,0,0
"Costa Rica","2025-02-15",0,0,1,0,0,1,0,0
"Costa Rica","2025-02-16",0,0,1,0,0,1,0,0
"Costa Rica","2025-02-17",0,0,1,0,0,1,0,0
"Costa Rica","2025-02-18",0,0,1,0,0,1,0,0
"Costa Rica","2025-02-19",0,0,1,0,0,1,0,0
"Costa Rica","2025-02-20",0,0,1,0,0,1,0,0
"Costa Rica","2025-02-21",0,0,1,0,0,1,0,0
"Costa Rica","2025-02-22",0,0,1,0,0,1,0,0
"Costa Rica","2025-02-23",0,0,1,0,0,1,0,0
"Costa Rica","2025-02-24",0,0,1,0,0,1,0,0
"Costa Rica","2025-02-25",0,0,1,0,0,1,0,0
"Costa Rica","2025-02-26",0,0,1,0,0,1,0,0
"Costa Rica","2025-02-27",0,0,1,0,0,1,0,0
"Costa Rica","2025-02-28",0,0,1,0,0,1,0,0
"Costa Rica","2025-03-01",0,0,1,0,0,1,0,0
"Costa Rica","2025-03-02",0,0,1,0,0,1,0,0
"Costa Rica","2025-03-03",0,0,1,0,0,1,0,0
"Côte d’Ivoire","2024-01-01",0,0,0,0,0,0,0,0
"Côte d’Ivoire","2024-01-02",0,0,0,0,0,0,0,0
"Côte d’Ivoire","2024-01-03",0,0,0,0,0,0,0,0
"Côte d’Ivoire","2024-01-04",0,0,0,0,0,0,0,0
"Côte d’Ivoire","2024-01-05",0,0,0,0,0,0,0,0
"Côte d’Ivoire","2024-01-06",0,0,0,0,0,0,0,0
"Côte d’Ivoire","2024-01-07",0,0,0,0,0,0,0,0
"Côte d’Ivoire","2024-01-08",0,0,0,0,0,0,0,0
"Côte d’Ivoire","2024-01-09",0,0,0,0,0,0,0,0
"Côte d’Ivoire","2024-01-10",0,0,0,0,0,0,0,0
"Côte d’Ivoire","2024-01-11",0,0,0,0,0,0,0,0
"Côte d’Ivoire","2024-01-12",0,0,0,0,0,0,0,0
"Côte d’Ivoire","2024-01-13",0,0,0,0,0,0,0,0
"Côte d’Ivoire","2024-01-14",0,0,0,0,0,0,0,0
"Côte d’Ivoire","2024-01-15",0,0,0,0,0,0,0,0
"Côte d’Ivoire","2024-01-16",0,0,0,0,0,0,0,0
"Côte d’Ivoire","2024-01-17",0,0,0,0,0,0,0,0
"Côte d’Ivoire","2024-01-18",0,0,0,0,0,0,0,0
"Côte d’Ivoire","2024-01-19",0,0,0,0,0,0,0,0
"Côte d’Ivoire","2024-01-20",0,0,0,0,0,0,0,0
"Côte d’Ivoire","2024-01-21",0,0,0,0,0,0,0,0
"Côte d’Ivoire","2024-01-22",0,0,0,0,0,0,0,0
"Côte d’Ivoire","2024-01-23",0,0,0,0,0,0,0,0
"Côte d’Ivoire","2024-01-24",0,0,0,0,0,0,0,0
"Côte d’Ivoire","2024-01-25",0,0,0,0,0,0,0,0
"Côte d’Ivoire","2024-01-26",0,0,0,0,0,0,0,0
"Côte d’Ivoire","2024-01-27",0,0,0,0,0,0,0,0
"Côte d’Ivoire","2024-01-28",0,0,0,0,0,0,0,0
"Côte d’Ivoire","2024-01-29",0,0,0,0,0,0,0,0
"Côte d’Ivoire","2024-01-30",0,0,0,0,0,0,0,0
"Côte d’Ivoire","2024-01-31",0,0,0,0,0,0,0,0
"Côte d’Ivoire","2024-02-01",0,0,0,0,0,0,0,0
"Côte d’Ivoire","2024-02-02",0,0,0,0,0,0,0,0
"Côte d’Ivoire","2024-02-03",0,0,0,0,0,0,0,0
"Côte d’Ivoire","2024-02-04",0,0,0,0,0,0,0,0
"Côte d’Ivoire","2024-02-05",0,0,0,0,0,0,0,0
"Côte d’Ivoire","2024-02-06",0,0,0,0,0,0,0,0
"Côte d’Ivoire","2024-02-07",0,0,0,0,0,0,0,0
"Côte d’Ivoire","2024-02-08",0,0,0,0,0,0,0,0
"Côte d’Ivoire","2024-02-09",0,0,0,0,0,0,0,0
"Côte d’Ivoire","2024-02-10",0,0,0,0,0,0,0,0
"Côte d’Ivoire","2024-02-11",0,0,0,0,0,0,0,0
"Côte d’Ivoire","2024-02-12",0,0,0,0,0,0,0,0
"Côte d’Ivoire","2024-02-13",0,0,0,0,0,0,0,0
"Côte d’Ivoire","2024-02-14",0,0,0,0,0,0,0,0
"Côte d’Ivoire","2024-02-15",0,0,0,0,0,0,0,0
"Côte d’Ivoire","2024-02-16",0,0,0,0,0,0,0,0
"Côte d’Ivoire","2024-02-17",0,0,0,0,0,0,0,0
"Côte d’Ivoire","2024-02-18",0,0,0,0,0,0,0,0
"Côte d’Ivoire","2024-02-19",0,0,0,0,0,0,0,0
"Côte d’Ivoire","2024-02-20",0,0,0,0,0,0,0,0
"Côte d’Ivoire","2024-02-21",0,0,0,0,0,0,0,0
"Côte d’Ivoire","2024-02-22",0,0,0,0,0,0,0,0
"Côte d’Ivoire","2024-02-23",0,0,0,0,0,0,0,0
"Côte d’Ivoire","2024-02-24",0,0,0,0,0,0,0,0
"Côte d’Ivoire","2024-02-25",0,0,0,0,0,0,0,0
"Côte d’Ivoire","2024-02-26",0,0,0,0,0,0,0,0
"Côte d’Ivoire","2024-02-27",0,0,0,0,0,0,0,0
"Côte d’Ivoire","2024-02-28",0,0,0,0,0,0,0,0
"Côte d’Ivoire","2024-02-29",0,0,0,0,0,0,0,0
"Côte d’Ivoire","2024-03-01",0,0,0,0,0,0,0,0
"Côte d’Ivoire","2024-03-02",0,0,0,0,0,0,0,0
"Côte d’Ivoire","2024-03-03",0,0,0,0,0,0,0,0
"Côte d’Ivoire","2024-03-04",0,0,0,0,0,0,0,0
"Côte d’Ivoire","2024-03-05",0,0,0,0,0,0,0,0
"Côte d’Ivoire","2024-03-06",0,0,0,0,0,0,0,0
"Côte d’Ivoire","2024-03-07",0,0,0,0,0,0,0,0
"Côte d’Ivoire","2024-03-08",0,0,0,0,0,0,0,0
"Côte d’Ivoire","2024-03-09",0,0,0,0,0,0,0,0
"Côte d’Ivoire","2024-03-10",0,0,0,0,0,0,0,0
"Côte d’Ivoire","2024-03-11",0,0,0,0,0,0,0,0
"Côte d’Ivoire","2024-03-12",0,0,0,0,0,0,0,0
"Côte d’Ivoire","2024-03-13",0,0,0,0,0,0,0,0
"Côte d’Ivoire","2024-03-14",0,0,0,0,0,0,0,0
"Côte d’Ivoire","2024-03-15",0,0,0,0,0,0,0,0
"Côte d’Ivoire","2024-03-16",0,0,0,0,0,0,0,0
"Côte d’Ivoire","2024-03-17",0,0,0,0,0,0,0,0
"Côte d’Ivoire","2024-03-18",0,0,0,0,0,0,0,0
"Côte d’Ivoire","2024-03-19",0,0,0,0,0,0,0,0
"Côte d’Ivoire","2024-03-20",0,0,0,0,0,0,0,0
"Côte d’Ivoire","2024-03-21",0,0,0,0,0,0,0,0
"Côte d’Ivoire","2024-03-22",0,0,0,0,0,0,0,0
"Côte d’Ivoire","2024-03-23",0,0,0,0,0,0,0,0
"Côte d’Ivoire","2024-03-24",0,0,0,0,0,0,0,0
"Côte d’Ivoire","2024-03-25",0,0,0,0,0,0,0,0
"Côte d’Ivoire","2024-03-26",0,0,0,0,0,0,0,0
"Côte d’Ivoire","2024-03-27",0,0,0,0,0,0,0,0
"Côte d’Ivoire","2024-03-28",0,0,0,0,0,0,0,0
"Côte d’Ivoire","2024-03-29",0,0,0,0,0,0,0,0
"Côte d’Ivoire","2024-03-30",0,0,0,0,0,0,0,0
"Côte d’Ivoire","2024-03-31",0,0,0,0,0,0,0,0
"Côte d’Ivoire","2024-04-01",0,0,0,0,0,0,0,0
"Côte d’Ivoire","2024-04-02",0,0,0,0,0,0,0,0
"Côte d’Ivoire","2024-04-03",0,0,0,0,0,0,0,0
"Côte d’Ivoire","2024-04-04",0,0,0,0,0,0,0,0
"Côte d’Ivoire","2024-04-05",0,0,0,0,0,0,0,0
"Côte d’Ivoire","2024-04-06",0,0,0,0,0,0,0,0
"Côte d’Ivoire","2024-04-07",0,0,0,0,0,0,0,0
"Côte d’Ivoire","2024-04-08",0,0,0,0,0,0,0,0
"Côte d’Ivoire","2024-04-09",0,0,0,0,0,0,0,0
"Côte d’Ivoire","2024-04-10",0,0,0,0,0,0,0,0
"Côte d’Ivoire","2024-04-11",0,0,0,0,0,0,0,0
"Côte d’Ivoire","2024-04-12",0,0,0,0,0,0,0,0
"Côte d’Ivoire","2024-04-13",0,0,0,0,0,0,0,0
"Côte d’Ivoire","2024-04-14",0,0,0,0,0,0,0,0
"Côte d’Ivoire","2024-04-15",0,0,0,0,0,0,0,0
"Côte d’Ivoire","2024-04-16",0,0,0,0,0,0,0,0
"Côte d’Ivoire","2024-04-17",0,0,0,0,0,0,0,0
"Côte d’Ivoire","2024-04-18",0,0,0,0,0,0,0,0
"Côte d’Ivoire","2024-04-19",0,0,0,0,0,0,0,0
"Côte d’Ivoire","2024-04-20",0,0,0,0,0,0,0,0
"Côte d’Ivoire","2024-04-21",0,0,0,0,0,0,0,0
"Côte d’Ivoire","2024-04-22",0,0,0,0,0,0,0,0
"Côte d’Ivoire","2024-04-23",0,0,0,0,0,0,0,0
"Côte d’Ivoire","2024-04-24",0,0,0,0,0,0,0,0
"Côte d’Ivoire","2024-04-25",0,0,0,0,0,0,0,0
"Côte d’Ivoire","2024-04-26",0,0,0,0,0,0,0,0
"Côte d’Ivoire","2024-04-27",0,0,0,0,0,0,0,0
"Côte d’Ivoire","2024-04-28",0,0,0,0,0,0,0,0
"Côte d’Ivoire","2024-04-29",0,0,0,0,0,0,0,0
"Côte d’Ivoire","2024-04-30",0,0,0,0,0,0,0,0
"Côte d’Ivoire","2024-05-01",0,0,0,0,0,0,0,0
"Côte d’Ivoire","2024-05-02",0,0,0,0,0,0,0,0
"Côte d’Ivoire","2024-05-03",0,0,0,0,0,0,0,0
"Côte d’Ivoire","2024-05-04",0,0,0,0,0,0,0,0
"Côte d’Ivoire","2024-05-05",0,0,0,0,0,0,0,0
"Côte d’Ivoire","2024-05-06",0,0,0,0,0,0,0,0
"Côte d’Ivoire","2024-05-07",0,0,0,0,0,0,0,0
"Côte d’Ivoire","2024-05-08",0,0,0,0,0,0,0,0
"Côte d’Ivoire","2024-05-09",0,0,0,0,0,0,0,0
"Côte d’Ivoire","2024-05-10",0,0,0,0,0,0,0,0
"Côte d’Ivoire","2024-05-11",0,0,0,0,0,0,0,0
"Côte d’Ivoire","2024-05-12",0,0,0,0,0,0,0,0
"Côte d’Ivoire","2024-05-13",0,0,0,0,0,0,0,0
"Côte d’Ivoire","2024-05-14",0,0,0,0,0,0,0,0
"Côte d’Ivoire","2024-05-15",0,0,0,0,0,0,0,0
"Côte d’Ivoire","2024-05-16",0,0,0,0,0,0,0,0
"Côte d’Ivoire","2024-05-17",0,0,0,0,0,0,0,0
"Côte d’Ivoire","2024-05-18",0,0,0,0,0,0,0,0
"Côte d’Ivoire","2024-05-19",0,0,0,0,0,0,0,0
"Côte d’Ivoire","2024-05-20",0,0,0,0,0,0,0,0
"Côte d’Ivoire","2024-05-21",0,0,0,0,0,0,0,0
"Côte d’Ivoire","2024-05-22",0,0,0,0,0,0,0,0
"Côte d’Ivoire","2024-05-23",0,0,0,0,0,0,0,0
"Côte d’Ivoire","2024-05-24",0,0,0,0,0,0,0,0
"Côte d’Ivoire","2024-05-25",0,0,0,0,0,0,0,0
"Côte d’Ivoire","2024-05-26",0,0,0,0,0,0,0,0
"Côte d’Ivoire","2024-05-27",0,0,0,0,0,0,0,0
"Côte d’Ivoire","2024-05-28",0,0,0,0,0,0,0,0
"Côte d’Ivoire","2024-05-29",0,0,0,0,0,0,0,0
"Côte d’Ivoire","2024-05-30",0,0,0,0,0,0,0,0
"Côte d’Ivoire","2024-05-31",0,0,0,0,0,0,0,0
"Côte d’Ivoire","2024-06-01",0,0,0,0,0,0,0,0
"Côte d’Ivoire","2024-06-02",0,0,0,0,0,0,0,0
"Côte d’Ivoire","2024-06-03",0,0,0,0,0,0,0,0
"Côte d’Ivoire","2024-06-04",0,0,0,0,0,0,0,0
"Côte d’Ivoire","2024-06-05",0,0,0,0,0,0,0,0
"Côte d’Ivoire","2024-06-06",0,0,0,0,0,0,0,0
"Côte d’Ivoire","2024-06-07",0,0,0,0,0,0,0,0
"Côte d’Ivoire","2024-06-08",0,0,0,0,0,0,0,0
"Côte d’Ivoire","2024-06-09",0,0,0,0,0,0,0,0
"Côte d’Ivoire","2024-06-10",0,0,0,0,0,0,0,0
"Côte d’Ivoire","2024-06-11",0,0,0,0,0,0,0,0
"Côte d’Ivoire","2024-06-12",0,0,0,0,0,0,0,0
"Côte d’Ivoire","2024-06-13",0,0,0,0,0,0,0,0
"Côte d’Ivoire","2024-06-14",0,0,0,0,0,0,0,0
"Côte d’Ivoire","2024-06-15",0,0,0,0,0,0,0,0
"Côte d’Ivoire","2024-06-16",0,0,0,0,0,0,0,0
"Côte d’Ivoire","2024-06-17",0,0,0,0,0,0,0,0
"Côte d’Ivoire","2024-06-18",0,0,0,0,0,0,0,0
"Côte d’Ivoire","2024-06-19",0,0,0,0,0,0,0,0
"Côte d’Ivoire","2024-06-20",0,0,0,0,0,0,0,0
"Côte d’Ivoire","2024-06-21",0,0,0,0,0,0,0,0
"Côte d’Ivoire","2024-06-22",0,0,0,0,0,0,0,0
"Côte d’Ivoire","2024-06-23",0,0,0,0,0,0,0,0
"Côte d’Ivoire","2024-06-24",0,0,0,0,0,0,0,0
"Côte d’Ivoire","2024-06-25",0,0,0,0,0,0,0,0
"Côte d’Ivoire","2024-06-26",0,0,0,0,0,0,0,0
"Côte d’Ivoire","2024-06-27",0,0,0,0,0,0,0,0
"Côte d’Ivoire","2024-06-28",0,0,0,0,0,0,0,0
"Côte d’Ivoire","2024-06-29",0,0,0,0,0,0,0,0
"Côte d’Ivoire","2024-06-30",0,0,0,0,0,0,0,0
"Côte d’Ivoire","2024-07-01",0,0,0,0,0,0,0,0
"Côte d’Ivoire","2024-07-02",0,0,0,0,0,0,0,0
"Côte d’Ivoire","2024-07-03",0,0,0,0,0,0,0,0
"Côte d’Ivoire","2024-07-04",0,0,0,0,0,0,0,0
"Côte d’Ivoire","2024-07-05",0,0,0,0,0,0,0,0
"Côte d’Ivoire","2024-07-06",0,0,0,0,0,0,0,0
"Côte d’Ivoire","2024-07-07",0,1,1,0,1,1,0,0
"Côte d’Ivoire","2024-07-08",0,0,1,0,0,1,0,0
"Côte d’Ivoire","2024-07-09",0,0,1,0,0,1,0,0
"Côte d’Ivoire","2024-07-10",0,0,1,0,0,1,0,0
"Côte d’Ivoire","2024-07-11",0,0,1,0,1,2,0,0
"Côte d’Ivoire","2024-07-12",0,0,1,0,0,2,0,0
"Côte d’Ivoire","2024-07-13",0,0,1,0,0,2,0,0
"Côte d’Ivoire","2024-07-14",0,1,2,0,0,2,0,0
"Côte d’Ivoire","2024-07-15",0,0,2,0,0,2,0,0
"Côte d’Ivoire","2024-07-16",0,0,2,0,1,3,0,0
"Côte d’Ivoire","2024-07-17",0,0,2,0,0,3,0,0
"Côte d’Ivoire","2024-07-18",0,0,2,0,1,4,0,0
"Côte d’Ivoire","2024-07-19",0,0,2,0,0,4,0,0
"Côte d’Ivoire","2024-07-20",0,0,2,0,1,5,0,0
"Côte d’Ivoire","2024-07-21",0,3,5,0,0,5,0,0
"Côte d’Ivoire","2024-07-22",0,0,5,0,1,6,0,0
"Côte d’Ivoire","2024-07-23",0,0,5,0,0,6,0,0
"Côte d’Ivoire","2024-07-24",0,0,5,0,1,7,0,0
"Côte d’Ivoire","2024-07-25",0,0,5,0,0,7,0,0
"Côte d’Ivoire","2024-07-26",0,0,5,0,1,8,0,0
"Côte d’Ivoire","2024-07-27",0,0,5,0,0,8,0,0
"Côte d’Ivoire","2024-07-28",0,4,9,0,1,9,0,0
"Côte d’Ivoire","2024-07-29",0,0,9,0,1,10,0,0
"Côte d’Ivoire","2024-07-30",0,0,9,0,0,10,0,0
"Côte d’Ivoire","2024-07-31",0,0,9,0,1,11,0,0
"Côte d’Ivoire","2024-08-01",0,0,9,0,0,11,0,0
"Côte d’Ivoire","2024-08-02",0,0,9,0,1,12,0,0
"Côte d’Ivoire","2024-08-03",0,0,9,0,0,12,0,0
"Côte d’Ivoire","2024-08-04",0,4,13,0,1,13,0,0
"Côte d’Ivoire","2024-08-05",0,0,13,0,1,14,0,0
"Côte d’Ivoire","2024-08-06",0,0,13,0,1,15,0,0
"Côte d’Ivoire","2024-08-07",0,0,13,0,1,16,0,0
"Côte d’Ivoire","2024-08-08",0,0,13,0,0,16,0,0
"Côte d’Ivoire","2024-08-09",0,0,13,0,1,17,0,0
"Côte d’Ivoire","2024-08-10",0,0,13,0,1,18,0,0
"Côte d’Ivoire","2024-08-11",0,6,19,0,1,19,0,0
"Côte d’Ivoire","2024-08-12",0,0,19,0,2,21,0,0
"Côte d’Ivoire","2024-08-13",0,0,19,0,1,22,0,0
"Côte d’Ivoire","2024-08-14",0,0,19,0,2,24,0,0
"Côte d’Ivoire","2024-08-15",0,0,19,0,2,26,0,0
"Côte d’Ivoire","2024-08-16",0,0,19,0,2,28,0,0
"Côte d’Ivoire","2024-08-17",0,0,19,0,1,29,0,0
"Côte d’Ivoire","2024-08-18",0,12,31,0,2,31,0,0
"Côte d’Ivoire","2024-08-19",0,0,31,0,1,32,0,0
"Côte d’Ivoire","2024-08-20",0,0,31,0,1,33,0,0
"Côte d’Ivoire","2024-08-21",0,0,31,0,1,34,0,0
"Côte d’Ivoire","2024-08-22",0,0,31,0,1,35,0,0
"Côte d’Ivoire","2024-08-23",0,0,31,0,1,36,0,0
"Côte d’Ivoire","2024-08-24",0,0,31,0,1,37,0,0
"Côte d’Ivoire","2024-08-25",0,7,38,0,1,38,0,0
"Côte d’Ivoire","2024-08-26",0,0,38,0,1,39,0,0
"Côte d’Ivoire","2024-08-27",0,0,38,0,0,39,0,0
"Côte d’Ivoire","2024-08-28",0,0,38,0,1,40,0,0
"Côte d’Ivoire","2024-08-29",0,0,38,0,1,41,0,0
"Côte d’Ivoire","2024-08-30",0,0,38,0,1,42,0,0
"Côte d’Ivoire","2024-08-31",0,0,38,0,0,42,0,0
"Côte d’Ivoire","2024-09-01",0,5,43,0,1,43,0,0
"Côte d’Ivoire","2024-09-02",0,0,43,0,1,44,0,0
"Côte d’Ivoire","2024-09-03",0,0,43,0,0,44,0,0
"Côte d’Ivoire","2024-09-04",0,0,43,0,1,45,0,0
"Côte d’Ivoire","2024-09-05",0,0,43,0,0,45,0,0
"Côte d’Ivoire","2024-09-06",0,0,43,0,1,46,0,0
"Côte d’Ivoire","2024-09-07",0,0,43,0,0,46,0,0
"Côte d’Ivoire","2024-09-08",138,4,47,138,1,47,138,138
"Côte d’Ivoire","2024-09-09",0,0,47,138,1,48,6,144
"Côte d’Ivoire","2024-09-10",0,0,47,138,2,50,7,151
"Côte d’Ivoire","2024-09-11",0,0,47,138,1,51,6,157
"Côte d’Ivoire","2024-09-12",0,0,47,138,2,53,7,164
"Côte d’Ivoire","2024-09-13",0,0,47,138,1,54,6,170
"Côte d’Ivoire","2024-09-14",0,0,47,138,2,56,6,176
"Côte d’Ivoire","2024-09-15",0,10,57,138,1,57,7,183
"Côte d’Ivoire","2024-09-16",51,0,57,189,1,58,6,189
"Côte d’Ivoire","2024-09-17",0,0,57,189,1,59,2,191
"Côte d’Ivoire","2024-09-18",0,0,57,189,1,60,3,194
"Côte d’Ivoire","2024-09-19",0,0,57,189,1,61,2,196
"Côte d’Ivoire","2024-09-20",0,0,57,189,1,62,3,199
"Côte d’Ivoire","2024-09-21",0,0,57,189,1,63,2,201
"Côte d’Ivoire","2024-09-22",0,7,64,189,1,64,2,203
"Côte d’Ivoire","2024-09-23",0,0,64,189,1,65,3,206
"Côte d’Ivoire","2024-09-24",0,0,64,189,0,65,2,208
"Côte d’Ivoire","2024-09-25",0,0,64,189,1,66,3,211
"Côte d’Ivoire","2024-09-26",0,0,64,189,0,66,2,213
"Côte d’Ivoire","2024-09-27",0,0,64,189,1,67,2,215
"Côte d’Ivoire","2024-09-28",0,0,64,189,0,67,3,218
"Côte d’Ivoire","2024-09-29",0,4,68,189,1,68,2,220
"Côte d’Ivoire","2024-09-30",0,0,68,189,1,69,3,223
"Côte d’Ivoire","2024-10-01",0,0,68,189,1,70,2,225
"Côte d’Ivoire","2024-10-02",0,0,68,189,1,71,2,227
"Côte d’Ivoire","2024-10-03",0,0,68,189,0,71,3,230
"Côte d’Ivoire","2024-10-04",0,0,68,189,1,72,2,232
"Côte d’Ivoire","2024-10-05",0,0,68,189,1,73,3,235
"Côte d’Ivoire","2024-10-06",48,6,74,237,1,74,2,237
"Côte d’Ivoire","2024-10-07",0,0,74,237,1,75,5,242
"Côte d’Ivoire","2024-10-08",0,0,74,237,0,75,6,248
"Côte d’Ivoire","2024-10-09",0,0,74,237,1,76,5,253
"Côte d’Ivoire","2024-10-10",0,0,74,237,0,76,5,258
"Côte d’Ivoire","2024-10-11",0,0,74,237,1,77,6,264
"Côte d’Ivoire","2024-10-12",32,0,74,269,0,77,5,269
"Côte d’Ivoire","2024-10-13",0,4,78,269,1,78,3,272
"Côte d’Ivoire","2024-10-14",0,0,78,269,1,79,3,275
"Côte d’Ivoire","2024-10-15",0,0,78,269,0,79,2,277
"Côte d’Ivoire","2024-10-16",0,0,78,269,1,80,3,280
"Côte d’Ivoire","2024-10-17",0,0,78,269,1,81,3,283
"Côte d’Ivoire","2024-10-18",0,0,78,269,1,82,3,286
"Côte d’Ivoire","2024-10-19",0,0,78,269,0,82,3,289
"Côte d’Ivoire","2024-10-20",0,5,83,269,1,83,2,291
"Côte d’Ivoire","2024-10-21",0,0,83,269,1,84,3,294
"Côte d’Ivoire","2024-10-22",0,0,83,269,0,84,3,297
"Côte d’Ivoire","2024-10-23",0,0,83,269,1,85,3,300
"Côte d’Ivoire","2024-10-24",0,0,83,269,0,85,3,303
"Côte d’Ivoire","2024-10-25",0,0,83,269,1,86,2,305
"Côte d’Ivoire","2024-10-26",0,0,83,269,0,86,3,308
"Côte d’Ivoire","2024-10-27",42,4,87,311,1,87,3,311
"Côte d’Ivoire","2024-10-28",0,0,87,311,1,88,0,311
"Côte d’Ivoire","2024-10-29",0,0,87,311,2,90,0,311
"Côte d’Ivoire","2024-10-30",0,4,91,311,1,91,0,311
"Côte d’Ivoire","2024-10-31",0,0,91,311,0,91,0,311
"Côte d’Ivoire","2024-11-01",0,0,91,311,0,91,0,311
"Côte d’Ivoire","2024-11-02",0,0,91,311,1,92,0,311
"Côte d’Ivoire","2024-11-03",0,1,92,311,0,92,0,311
"Côte d’Ivoire","2024-11-04",0,0,92,311,1,93,0,311
"Côte d’Ivoire","2024-11-05",0,0,92,311,0,93,0,311
"Côte d’Ivoire","2024-11-06",0,0,92,311,1,94,0,311
"Côte d’Ivoire","2024-11-07",0,0,92,311,0,94,0,311
"Côte d’Ivoire","2024-11-08",0,0,92,311,1,95,0,311
"Côte d’Ivoire","2024-11-09",0,0,92,311,0,95,0,311
"Côte d’Ivoire","2024-11-10",0,4,96,311,1,96,0,311
"Côte d’Ivoire","2024-11-11",0,0,96,311,1,97,0,311
"Côte d’Ivoire","2024-11-12",0,0,96,311,0,97,0,311
"Côte d’Ivoire","2024-11-13",0,0,96,311,1,98,0,311
"Côte d’Ivoire","2024-11-14",0,0,96,311,1,99,0,311
"Côte d’Ivoire","2024-11-15",0,0,96,311,1,100,0,311
"Côte d’Ivoire","2024-11-16",0,0,96,311,0,100,0,311
"Côte d’Ivoire","2024-11-17",0,5,101,311,1,101,0,311
"Côte d’Ivoire","2024-11-18",0,0,101,311,0,101,0,311
"Côte d’Ivoire","2024-11-19",0,0,101,311,1,102,0,311
"Côte d’Ivoire","2024-11-20",0,0,101,311,0,102,0,311
"Côte d’Ivoire","2024-11-21",0,0,101,311,0,102,0,311
"Côte d’Ivoire","2024-11-22",0,0,101,311,0,102,0,311
"Côte d’Ivoire","2024-11-23",0,0,101,311,1,103,0,311
"Côte d’Ivoire","2024-11-24",0,2,103,311,0,103,0,311
"Côte d’Ivoire","2024-11-25",0,0,103,311,1,104,0,311
"Côte d’Ivoire","2024-11-26",0,0,103,311,0,104,0,311
"Côte d’Ivoire","2024-11-27",0,0,103,311,1,105,0,311
"Côte d’Ivoire","2024-11-28",0,0,103,311,0,105,0,311
"Côte d’Ivoire","2024-11-29",0,0,103,311,1,106,0,311
"Côte d’Ivoire","2024-11-30",0,0,103,311,0,106,0,311
"Côte d’Ivoire","2024-12-01",0,4,107,311,1,107,0,311
"Côte d’Ivoire","2024-12-02",0,0,107,311,0,107,0,311
"Côte d’Ivoire","2024-12-03",0,0,107,311,0,107,0,311
"Côte d’Ivoire","2024-12-04",0,0,107,311,0,107,0,311
"Côte d’Ivoire","2024-12-05",0,0,107,311,0,107,0,311
"Côte d’Ivoire","2024-12-06",0,0,107,311,0,107,0,311
"Côte d’Ivoire","2024-12-07",0,0,107,311,0,107,0,311
"Côte d’Ivoire","2024-12-08",0,0,107,311,0,107,0,311
"Côte d’Ivoire","2024-12-09",0,0,107,311,0,107,0,311
"Côte d’Ivoire","2024-12-10",0,0,107,311,0,107,0,311
"Côte d’Ivoire","2024-12-11",0,0,107,311,0,107,0,311
"Côte d’Ivoire","2024-12-12",0,0,107,311,0,107,0,311
"Côte d’Ivoire","2024-12-13",0,0,107,311,0,107,0,311
"Côte d’Ivoire","2024-12-14",0,0,107,311,0,107,0,311
"Côte d’Ivoire","2024-12-15",0,0,107,311,0,107,0,311
"Côte d’Ivoire","2024-12-16",0,0,107,311,0,107,0,311
"Côte d’Ivoire","2024-12-17",0,0,107,311,0,107,0,311
"Côte d’Ivoire","2024-12-18",0,0,107,311,0,107,0,311
"Côte d’Ivoire","2024-12-19",0,0,107,311,0,107,0,311
"Côte d’Ivoire","2024-12-20",0,0,107,311,0,107,0,311
"Côte d’Ivoire","2024-12-21",0,0,107,311,0,107,0,311
"Côte d’Ivoire","2024-12-22",0,0,107,311,0,107,0,311
"Côte d’Ivoire","2024-12-23",0,0,107,311,0,107,0,311
"Côte d’Ivoire","2024-12-24",0,0,107,311,0,107,0,311
"Côte d’Ivoire","2024-12-25",0,0,107,311,0,107,0,311
"Côte d’Ivoire","2024-12-26",0,0,107,311,1,108,0,311
"Côte d’Ivoire","2024-12-27",0,0,107,311,0,108,0,311
"Côte d’Ivoire","2024-12-28",0,0,107,311,0,108,0,311
"Côte d’Ivoire","2024-12-29",0,0,107,311,0,108,0,311
"Côte d’Ivoire","2024-12-30",0,0,107,311,0,108,0,311
"Côte d’Ivoire","2024-12-31",0,0,107,311,0,108,0,311
"Côte d’Ivoire","2025-01-01",0,0,107,311,0,108,0,311
"Côte d’Ivoire","2025-01-02",0,0,107,311,0,108,0,311
"Côte d’Ivoire","2025-01-03",0,0,107,311,0,108,0,311
"Côte d’Ivoire","2025-01-04",0,0,107,311,0,108,0,311
"Côte d’Ivoire","2025-01-05",0,0,107,311,0,108,0,311
"Côte d’Ivoire","2025-01-06",0,0,107,311,0,108,0,311
"Côte d’Ivoire","2025-01-07",0,0,107,311,0,108,0,311
"Côte d’Ivoire","2025-01-08",0,0,107,311,0,108,0,311
"Côte d’Ivoire","2025-01-09",0,0,107,311,0,108,0,311
"Côte d’Ivoire","2025-01-10",0,0,107,311,0,108,0,311
"Côte d’Ivoire","2025-01-11",0,0,107,311,0,108,0,311
"Côte d’Ivoire","2025-01-12",0,0,107,311,0,108,0,311
"Côte d’Ivoire","2025-01-13",0,0,107,311,0,108,0,311
"Côte d’Ivoire","2025-01-14",0,0,107,311,0,108,0,311
"Côte d’Ivoire","2025-01-15",0,0,107,311,0,108,0,311
"Côte d’Ivoire","2025-01-16",0,0,107,311,0,108,0,311
"Côte d’Ivoire","2025-01-17",0,0,107,311,0,108,0,311
"Côte d’Ivoire","2025-01-18",0,0,107,311,0,108,0,311
"Côte d’Ivoire","2025-01-19",0,1,108,311,0,108,0,311
"Côte d’Ivoire","2025-01-20",0,0,108,311,0,108,0,311
"Côte d’Ivoire","2025-01-21",0,0,108,311,0,108,0,311
"Côte d’Ivoire","2025-01-22",0,0,108,311,0,108,0,311
"Côte d’Ivoire","2025-01-23",0,0,108,311,1,109,0,311
"Côte d’Ivoire","2025-01-24",0,0,108,311,0,109,0,311
"Côte d’Ivoire","2025-01-25",0,0,108,311,0,109,0,311
"Côte d’Ivoire","2025-01-26",0,1,109,311,0,109,0,311
"Côte d’Ivoire","2025-01-27",0,0,109,311,0,109,0,311
"Côte d’Ivoire","2025-01-28",0,0,109,311,0,109,0,311
"Côte d’Ivoire","2025-01-29",0,0,109,311,0,109,0,311
"Côte d’Ivoire","2025-01-30",0,0,109,311,1,110,0,311
"Côte d’Ivoire","2025-01-31",0,0,109,311,0,110,0,311
"Côte d’Ivoire","2025-02-01",0,0,109,311,0,110,0,311
"Côte d’Ivoire","2025-02-02",0,1,110,311,0,110,0,311
"Côte d’Ivoire","2025-02-03",0,0,110,311,0,110,0,311
"Côte d’Ivoire","2025-02-04",0,0,110,311,0,110,0,311
"Côte d’Ivoire","2025-02-05",0,0,110,311,0,110,0,311
"Côte d’Ivoire","2025-02-06",0,0,110,311,0,110,0,311
"Côte d’Ivoire","2025-02-07",0,0,110,311,0,110,0,311
"Côte d’Ivoire","2025-02-08",0,0,110,311,0,110,0,311
"Côte d’Ivoire","2025-02-09",0,0,110,311,0,110,0,311
"Côte d’Ivoire","2025-02-10",0,0,110,311,0,110,0,311
"Côte d’Ivoire","2025-02-11",0,0,110,311,0,110,0,311
"Côte d’Ivoire","2025-02-12",0,0,110,311,0,110,0,311
"Côte d’Ivoire","2025-02-13",0,0,110,311,0,110,0,311
"Côte d’Ivoire","2025-02-14",0,0,110,311,0,110,0,311
"Côte d’Ivoire","2025-02-15",0,0,110,311,0,110,0,311
"Côte d’Ivoire","2025-02-16",0,0,110,311,0,110,0,311
"Côte d’Ivoire","2025-02-17",0,0,110,311,0,110,0,311
"Côte d’Ivoire","2025-02-18",0,0,110,311,0,110,0,311
"Côte d’Ivoire","2025-02-19",0,0,110,311,0,110,0,311
"Côte d’Ivoire","2025-02-20",0,0,110,311,0,110,0,311
"Côte d’Ivoire","2025-02-21",0,0,110,311,0,110,0,311
"Côte d’Ivoire","2025-02-22",0,0,110,311,0,110,0,311
"Côte d’Ivoire","2025-02-23",0,0,110,311,0,110,0,311
"Côte d’Ivoire","2025-02-24",0,0,110,311,0,110,0,311
"Côte d’Ivoire","2025-02-25",0,0,110,311,0,110,0,311
"Côte d’Ivoire","2025-02-26",0,0,110,311,0,110,0,311
"Côte d’Ivoire","2025-02-27",0,0,110,311,0,110,0,311
"Côte d’Ivoire","2025-02-28",0,0,110,311,0,110,0,311
"Côte d’Ivoire","2025-03-01",0,0,110,311,0,110,0,311
"Côte d’Ivoire","2025-03-02",0,0,110,311,0,110,0,311
"Côte d’Ivoire","2025-03-03",0,0,110,311,0,110,0,311
"Croatia","2024-01-01",0,0,0,0,0,0,0,0
"Croatia","2024-01-02",0,0,0,0,0,0,0,0
"Croatia","2024-01-03",0,0,0,0,0,0,0,0
"Croatia","2024-01-04",0,0,0,0,0,0,0,0
"Croatia","2024-01-05",0,0,0,0,0,0,0,0
"Croatia","2024-01-06",0,0,0,0,0,0,0,0
"Croatia","2024-01-07",0,0,0,0,0,0,0,0
"Croatia","2024-01-08",0,0,0,0,0,0,0,0
"Croatia","2024-01-09",0,0,0,0,0,0,0,0
"Croatia","2024-01-10",0,0,0,0,0,0,0,0
"Croatia","2024-01-11",0,0,0,0,0,0,0,0
"Croatia","2024-01-12",0,0,0,0,0,0,0,0
"Croatia","2024-01-13",0,0,0,0,0,0,0,0
"Croatia","2024-01-14",0,0,0,0,0,0,0,0
"Croatia","2024-01-15",0,0,0,0,0,0,0,0
"Croatia","2024-01-16",0,0,0,0,0,0,0,0
"Croatia","2024-01-17",0,0,0,0,0,0,0,0
"Croatia","2024-01-18",0,0,0,0,0,0,0,0
"Croatia","2024-01-19",0,0,0,0,0,0,0,0
"Croatia","2024-01-20",0,0,0,0,0,0,0,0
"Croatia","2024-01-21",0,0,0,0,0,0,0,0
"Croatia","2024-01-22",0,0,0,0,0,0,0,0
"Croatia","2024-01-23",0,0,0,0,0,0,0,0
"Croatia","2024-01-24",0,0,0,0,0,0,0,0
"Croatia","2024-01-25",0,0,0,0,0,0,0,0
"Croatia","2024-01-26",0,0,0,0,0,0,0,0
"Croatia","2024-01-27",0,0,0,0,0,0,0,0
"Croatia","2024-01-28",0,0,0,0,0,0,0,0
"Croatia","2024-01-29",0,0,0,0,0,0,0,0
"Croatia","2024-01-30",0,0,0,0,0,0,0,0
"Croatia","2024-01-31",0,0,0,0,0,0,0,0
"Croatia","2024-02-01",0,0,0,0,0,0,0,0
"Croatia","2024-02-02",0,0,0,0,0,0,0,0
"Croatia","2024-02-03",0,0,0,0,0,0,0,0
"Croatia","2024-02-04",0,0,0,0,0,0,0,0
"Croatia","2024-02-05",0,0,0,0,0,0,0,0
"Croatia","2024-02-06",0,0,0,0,0,0,0,0
"Croatia","2024-02-07",0,0,0,0,0,0,0,0
"Croatia","2024-02-08",0,0,0,0,0,0,0,0
"Croatia","2024-02-09",0,0,0,0,0,0,0,0
"Croatia","2024-02-10",0,0,0,0,0,0,0,0
"Croatia","2024-02-11",0,0,0,0,0,0,0,0
"Croatia","2024-02-12",0,0,0,0,0,0,0,0
"Croatia","2024-02-13",0,0,0,0,0,0,0,0
"Croatia","2024-02-14",0,0,0,0,0,0,0,0
"Croatia","2024-02-15",0,0,0,0,0,0,0,0
"Croatia","2024-02-16",0,0,0,0,0,0,0,0
"Croatia","2024-02-17",0,0,0,0,0,0,0,0
"Croatia","2024-02-18",0,0,0,0,0,0,0,0
"Croatia","2024-02-19",0,0,0,0,0,0,0,0
"Croatia","2024-02-20",0,0,0,0,0,0,0,0
"Croatia","2024-02-21",0,0,0,0,0,0,0,0
"Croatia","2024-02-22",0,0,0,0,0,0,0,0
"Croatia","2024-02-23",0,0,0,0,0,0,0,0
"Croatia","2024-02-24",0,0,0,0,0,0,0,0
"Croatia","2024-02-25",0,0,0,0,0,0,0,0
"Croatia","2024-02-26",0,0,0,0,0,0,0,0
"Croatia","2024-02-27",0,0,0,0,0,0,0,0
"Croatia","2024-02-28",0,0,0,0,0,0,0,0
"Croatia","2024-02-29",0,0,0,0,0,0,0,0
"Croatia","2024-03-01",0,0,0,0,0,0,0,0
"Croatia","2024-03-02",0,0,0,0,0,0,0,0
"Croatia","2024-03-03",0,0,0,0,0,0,0,0
"Croatia","2024-03-04",0,0,0,0,0,0,0,0
"Croatia","2024-03-05",0,0,0,0,0,0,0,0
"Croatia","2024-03-06",0,0,0,0,0,0,0,0
"Croatia","2024-03-07",0,0,0,0,0,0,0,0
"Croatia","2024-03-08",0,0,0,0,0,0,0,0
"Croatia","2024-03-09",0,0,0,0,0,0,0,0
"Croatia","2024-03-10",0,0,0,0,0,0,0,0
"Croatia","2024-03-11",0,0,0,0,0,0,0,0
"Croatia","2024-03-12",0,0,0,0,0,0,0,0
"Croatia","2024-03-13",0,0,0,0,0,0,0,0
"Croatia","2024-03-14",0,0,0,0,0,0,0,0
"Croatia","2024-03-15",0,0,0,0,0,0,0,0
"Croatia","2024-03-16",0,0,0,0,0,0,0,0
"Croatia","2024-03-17",0,0,0,0,0,0,0,0
"Croatia","2024-03-18",0,0,0,0,0,0,0,0
"Croatia","2024-03-19",0,0,0,0,0,0,0,0
"Croatia","2024-03-20",0,0,0,0,0,0,0,0
"Croatia","2024-03-21",0,0,0,0,0,0,0,0
"Croatia","2024-03-22",0,0,0,0,0,0,0,0
"Croatia","2024-03-23",0,0,0,0,0,0,0,0
"Croatia","2024-03-24",0,0,0,0,0,0,0,0
"Croatia","2024-03-25",0,0,0,0,0,0,0,0
"Croatia","2024-03-26",0,0,0,0,0,0,0,0
"Croatia","2024-03-27",0,0,0,0,0,0,0,0
"Croatia","2024-03-28",0,0,0,0,0,0,0,0
"Croatia","2024-03-29",0,0,0,0,0,0,0,0
"Croatia","2024-03-30",0,0,0,0,0,0,0,0
"Croatia","2024-03-31",0,0,0,0,0,0,0,0
"Croatia","2024-04-01",0,0,0,0,0,0,0,0
"Croatia","2024-04-02",0,0,0,0,0,0,0,0
"Croatia","2024-04-03",0,0,0,0,0,0,0,0
"Croatia","2024-04-04",0,0,0,0,0,0,0,0
"Croatia","2024-04-05",0,0,0,0,0,0,0,0
"Croatia","2024-04-06",0,0,0,0,0,0,0,0
"Croatia","2024-04-07",0,0,0,0,0,0,0,0
"Croatia","2024-04-08",0,0,0,0,0,0,0,0
"Croatia","2024-04-09",0,0,0,0,0,0,0,0
"Croatia","2024-04-10",0,0,0,0,0,0,0,0
"Croatia","2024-04-11",0,0,0,0,0,0,0,0
"Croatia","2024-04-12",0,0,0,0,0,0,0,0
"Croatia","2024-04-13",0,0,0,0,0,0,0,0
"Croatia","2024-04-14",0,0,0,0,0,0,0,0
"Croatia","2024-04-15",0,0,0,0,0,0,0,0
"Croatia","2024-04-16",0,0,0,0,0,0,0,0
"Croatia","2024-04-17",0,0,0,0,0,0,0,0
"Croatia","2024-04-18",0,0,0,0,0,0,0,0
"Croatia","2024-04-19",0,0,0,0,0,0,0,0
"Croatia","2024-04-20",0,0,0,0,0,0,0,0
"Croatia","2024-04-21",0,0,0,0,0,0,0,0
"Croatia","2024-04-22",0,0,0,0,0,0,0,0
"Croatia","2024-04-23",0,0,0,0,0,0,0,0
"Croatia","2024-04-24",0,0,0,0,0,0,0,0
"Croatia","2024-04-25",0,0,0,0,0,0,0,0
"Croatia","2024-04-26",0,0,0,0,0,0,0,0
"Croatia","2024-04-27",0,0,0,0,0,0,0,0
"Croatia","2024-04-28",0,0,0,0,0,0,0,0
"Croatia","2024-04-29",0,0,0,0,0,0,0,0
"Croatia","2024-04-30",0,1,1,0,1,1,0,0
"Croatia","2024-05-01",0,0,1,0,0,1,0,0
"Croatia","2024-05-02",0,0,1,0,0,1,0,0
"Croatia","2024-05-03",0,0,1,0,0,1,0,0
"Croatia","2024-05-04",0,0,1,0,0,1,0,0
"Croatia","2024-05-05",0,0,1,0,0,1,0,0
"Croatia","2024-05-06",0,0,1,0,0,1,0,0
"Croatia","2024-05-07",0,0,1,0,0,1,0,0
"Croatia","2024-05-08",0,0,1,0,0,1,0,0
"Croatia","2024-05-09",0,0,1,0,0,1,0,0
"Croatia","2024-05-10",0,0,1,0,0,1,0,0
"Croatia","2024-05-11",0,0,1,0,0,1,0,0
"Croatia","2024-05-12",0,0,1,0,0,1,0,0
"Croatia","2024-05-13",0,0,1,0,0,1,0,0
"Croatia","2024-05-14",0,0,1,0,0,1,0,0
"Croatia","2024-05-15",0,0,1,0,0,1,0,0
"Croatia","2024-05-16",0,0,1,0,0,1,0,0
"Croatia","2024-05-17",0,0,1,0,0,1,0,0
"Croatia","2024-05-18",0,0,1,0,0,1,0,0
"Croatia","2024-05-19",0,0,1,0,0,1,0,0
"Croatia","2024-05-20",0,0,1,0,0,1,0,0
"Croatia","2024-05-21",0,0,1,0,0,1,0,0
"Croatia","2024-05-22",0,0,1,0,0,1,0,0
"Croatia","2024-05-23",0,0,1,0,0,1,0,0
"Croatia","2024-05-24",0,0,1,0,0,1,0,0
"Croatia","2024-05-25",0,0,1,0,0,1,0,0
"Croatia","2024-05-26",0,0,1,0,0,1,0,0
"Croatia","2024-05-27",0,0,1,0,0,1,0,0
"Croatia","2024-05-28",0,0,1,0,0,1,0,0
"Croatia","2024-05-29",0,0,1,0,0,1,0,0
"Croatia","2024-05-30",0,0,1,0,0,1,0,0
"Croatia","2024-05-31",0,0,1,0,0,1,0,0
"Croatia","2024-06-01",0,0,1,0,0,1,0,0
"Croatia","2024-06-02",0,0,1,0,0,1,0,0
"Croatia","2024-06-03",0,0,1,0,0,1,0,0
"Croatia","2024-06-04",0,0,1,0,0,1,0,0
"Croatia","2024-06-05",0,0,1,0,0,1,0,0
"Croatia","2024-06-06",0,0,1,0,0,1,0,0
"Croatia","2024-06-07",0,0,1,0,0,1,0,0
"Croatia","2024-06-08",0,0,1,0,0,1,0,0
"Croatia","2024-06-09",0,0,1,0,0,1,0,0
"Croatia","2024-06-10",0,0,1,0,0,1,0,0
"Croatia","2024-06-11",0,0,1,0,0,1,0,0
"Croatia","2024-06-12",0,0,1,0,0,1,0,0
"Croatia","2024-06-13",0,0,1,0,0,1,0,0
"Croatia","2024-06-14",0,0,1,0,0,1,0,0
"Croatia","2024-06-15",0,0,1,0,0,1,0,0
"Croatia","2024-06-16",0,0,1,0,0,1,0,0
"Croatia","2024-06-17",0,0,1,0,0,1,0,0
"Croatia","2024-06-18",0,0,1,0,0,1,0,0
"Croatia","2024-06-19",0,0,1,0,0,1,0,0
"Croatia","2024-06-20",0,0,1,0,0,1,0,0
"Croatia","2024-06-21",0,0,1,0,0,1,0,0
"Croatia","2024-06-22",0,0,1,0,0,1,0,0
"Croatia","2024-06-23",0,0,1,0,0,1,0,0
"Croatia","2024-06-24",0,0,1,0,0,1,0,0
"Croatia","2024-06-25",0,0,1,0,0,1,0,0
"Croatia","2024-06-26",0,0,1,0,0,1,0,0
"Croatia","2024-06-27",0,0,1,0,0,1,0,0
"Croatia","2024-06-28",0,0,1,0,0,1,0,0
"Croatia","2024-06-29",0,0,1,0,0,1,0,0
"Croatia","2024-06-30",0,0,1,0,0,1,0,0
"Croatia","2024-07-01",0,0,1,0,0,1,0,0
"Croatia","2024-07-02",0,0,1,0,0,1,0,0
"Croatia","2024-07-03",0,0,1,0,0,1,0,0
"Croatia","2024-07-04",0,0,1,0,0,1,0,0
"Croatia","2024-07-05",0,0,1,0,0,1,0,0
"Croatia","2024-07-06",0,0,1,0,0,1,0,0
"Croatia","2024-07-07",0,0,1,0,0,1,0,0
"Croatia","2024-07-08",0,0,1,0,0,1,0,0
"Croatia","2024-07-09",0,0,1,0,0,1,0,0
"Croatia","2024-07-10",0,0,1,0,0,1,0,0
"Croatia","2024-07-11",0,0,1,0,0,1,0,0
"Croatia","2024-07-12",0,0,1,0,0,1,0,0
"Croatia","2024-07-13",0,0,1,0,0,1,0,0
"Croatia","2024-07-14",0,0,1,0,0,1,0,0
"Croatia","2024-07-15",0,0,1,0,0,1,0,0
"Croatia","2024-07-16",0,0,1,0,0,1,0,0
"Croatia","2024-07-17",0,0,1,0,0,1,0,0
"Croatia","2024-07-18",0,0,1,0,0,1,0,0
"Croatia","2024-07-19",0,0,1,0,0,1,0,0
"Croatia","2024-07-20",0,0,1,0,0,1,0,0
"Croatia","2024-07-21",0,0,1,0,0,1,0,0
"Croatia","2024-07-22",0,0,1,0,0,1,0,0
"Croatia","2024-07-23",0,0,1,0,0,1,0,0
"Croatia","2024-07-24",0,0,1,0,0,1,0,0
"Croatia","2024-07-25",0,0,1,0,0,1,0,0
"Croatia","2024-07-26",0,0,1,0,0,1,0,0
"Croatia","2024-07-27",0,0,1,0,0,1,0,0
"Croatia","2024-07-28",0,0,1,0,0,1,0,0
"Croatia","2024-07-29",0,0,1,0,0,1,0,0
"Croatia","2024-07-30",0,0,1,0,0,1,0,0
"Croatia","2024-07-31",0,0,1,0,0,1,0,0
"Croatia","2024-08-01",0,0,1,0,0,1,0,0
"Croatia","2024-08-02",0,0,1,0,0,1,0,0
"Croatia","2024-08-03",0,0,1,0,0,1,0,0
"Croatia","2024-08-04",0,0,1,0,0,1,0,0
"Croatia","2024-08-05",0,0,1,0,0,1,0,0
"Croatia","2024-08-06",0,0,1,0,0,1,0,0
"Croatia","2024-08-07",0,0,1,0,0,1,0,0
"Croatia","2024-08-08",0,0,1,0,0,1,0,0
"Croatia","2024-08-09",0,0,1,0,0,1,0,0
"Croatia","2024-08-10",0,0,1,0,0,1,0,0
"Croatia","2024-08-11",0,0,1,0,0,1,0,0
"Croatia","2024-08-12",0,0,1,0,0,1,0,0
"Croatia","2024-08-13",0,0,1,0,0,1,0,0
"Croatia","2024-08-14",0,0,1,0,0,1,0,0
"Croatia","2024-08-15",0,0,1,0,0,1,0,0
"Croatia","2024-08-16",0,0,1,0,1,2,0,0
"Croatia","2024-08-17",0,0,1,0,0,2,0,0
"Croatia","2024-08-18",0,0,1,0,0,2,0,0
"Croatia","2024-08-19",0,0,1,0,0,2,0,0
"Croatia","2024-08-20",0,0,1,0,0,2,0,0
"Croatia","2024-08-21",0,0,1,0,0,2,0,0
"Croatia","2024-08-22",0,0,1,0,0,2,0,0
"Croatia","2024-08-23",0,0,1,0,0,2,0,0
"Croatia","2024-08-24",0,0,1,0,0,2,0,0
"Croatia","2024-08-25",0,0,1,0,0,2,0,0
"Croatia","2024-08-26",0,0,1,0,0,2,0,0
"Croatia","2024-08-27",0,0,1,0,0,2,0,0
"Croatia","2024-08-28",0,0,1,0,0,2,0,0
"Croatia","2024-08-29",0,0,1,0,0,2,0,0
"Croatia","2024-08-30",0,0,1,0,0,2,0,0
"Croatia","2024-08-31",0,0,1,0,0,2,0,0
"Croatia","2024-09-01",0,0,1,0,0,2,0,0
"Croatia","2024-09-02",0,0,1,0,0,2,0,0
"Croatia","2024-09-03",0,0,1,0,0,2,0,0
"Croatia","2024-09-04",0,0,1,0,0,2,0,0
"Croatia","2024-09-05",0,0,1,0,0,2,0,0
"Croatia","2024-09-06",0,0,1,0,0,2,0,0
"Croatia","2024-09-07",0,0,1,0,0,2,0,0
"Croatia","2024-09-08",0,0,1,0,0,2,0,0
"Croatia","2024-09-09",0,0,1,0,0,2,0,0
"Croatia","2024-09-10",0,0,1,0,0,2,0,0
"Croatia","2024-09-11",0,0,1,0,0,2,0,0
"Croatia","2024-09-12",0,0,1,0,0,2,0,0
"Croatia","2024-09-13",0,0,1,0,0,2,0,0
"Croatia","2024-09-14",0,0,1,0,0,2,0,0
"Croatia","2024-09-15",0,0,1,0,0,2,0,0
"Croatia","2024-09-16",0,0,1,0,0,2,0,0
"Croatia","2024-09-17",0,0,1,0,0,2,0,0
"Croatia","2024-09-18",0,0,1,0,0,2,0,0
"Croatia","2024-09-19",0,0,1,0,0,2,0,0
"Croatia","2024-09-20",0,0,1,0,0,2,0,0
"Croatia","2024-09-21",0,0,1,0,0,2,0,0
"Croatia","2024-09-22",0,0,1,0,0,2,0,0
"Croatia","2024-09-23",0,0,1,0,0,2,0,0
"Croatia","2024-09-24",0,0,1,0,0,2,0,0
"Croatia","2024-09-25",0,0,1,0,0,2,0,0
"Croatia","2024-09-26",0,0,1,0,0,2,0,0
"Croatia","2024-09-27",0,0,1,0,0,2,0,0
"Croatia","2024-09-28",0,0,1,0,0,2,0,0
"Croatia","2024-09-29",0,0,1,0,0,2,0,0
"Croatia","2024-09-30",0,0,1,0,0,2,0,0
"Croatia","2024-10-01",0,0,1,0,0,2,0,0
"Croatia","2024-10-02",0,0,1,0,0,2,0,0
"Croatia","2024-10-03",0,0,1,0,0,2,0,0
"Croatia","2024-10-04",0,0,1,0,0,2,0,0
"Croatia","2024-10-05",0,0,1,0,0,2,0,0
"Croatia","2024-10-06",0,0,1,0,0,2,0,0
"Croatia","2024-10-07",0,0,1,0,0,2,0,0
"Croatia","2024-10-08",0,0,1,0,0,2,0,0
"Croatia","2024-10-09",0,0,1,0,0,2,0,0
"Croatia","2024-10-10",0,0,1,0,0,2,0,0
"Croatia","2024-10-11",0,0,1,0,0,2,0,0
"Croatia","2024-10-12",0,0,1,0,0,2,0,0
"Croatia","2024-10-13",0,0,1,0,0,2,0,0
"Croatia","2024-10-14",0,0,1,0,0,2,0,0
"Croatia","2024-10-15",0,0,1,0,0,2,0,0
"Croatia","2024-10-16",0,0,1,0,0,2,0,0
"Croatia","2024-10-17",0,0,1,0,0,2,0,0
"Croatia","2024-10-18",0,0,1,0,0,2,0,0
"Croatia","2024-10-19",0,0,1,0,0,2,0,0
"Croatia","2024-10-20",0,0,1,0,0,2,0,0
"Croatia","2024-10-21",0,0,1,0,0,2,0,0
"Croatia","2024-10-22",0,0,1,0,0,2,0,0
"Croatia","2024-10-23",0,0,1,0,0,2,0,0
"Croatia","2024-10-24",0,0,1,0,0,2,0,0
"Croatia","2024-10-25",0,0,1,0,0,2,0,0
"Croatia","2024-10-26",0,0,1,0,0,2,0,0
"Croatia","2024-10-27",0,0,1,0,0,2,0,0
"Croatia","2024-10-28",0,0,1,0,0,2,0,0
"Croatia","2024-10-29",0,0,1,0,0,2,0,0
"Croatia","2024-10-30",0,0,1,0,0,2,0,0
"Croatia","2024-10-31",0,0,1,0,0,2,0,0
"Croatia","2024-11-01",0,0,1,0,0,2,0,0
"Croatia","2024-11-02",0,0,1,0,0,2,0,0
"Croatia","2024-11-03",0,0,1,0,0,2,0,0
"Croatia","2024-11-04",0,0,1,0,0,2,0,0
"Croatia","2024-11-05",0,0,1,0,0,2,0,0
"Croatia","2024-11-06",0,0,1,0,0,2,0,0
"Croatia","2024-11-07",0,0,1,0,0,2,0,0
"Croatia","2024-11-08",0,0,1,0,0,2,0,0
"Croatia","2024-11-09",0,0,1,0,0,2,0,0
"Croatia","2024-11-10",0,0,1,0,0,2,0,0
"Croatia","2024-11-11",0,0,1,0,0,2,0,0
"Croatia","2024-11-12",0,0,1,0,0,2,0,0
"Croatia","2024-11-13",0,0,1,0,0,2,0,0
"Croatia","2024-11-14",0,0,1,0,0,2,0,0
"Croatia","2024-11-15",0,0,1,0,0,2,0,0
"Croatia","2024-11-16",0,0,1,0,0,2,0,0
"Croatia","2024-11-17",0,0,1,0,0,2,0,0
"Croatia","2024-11-18",0,0,1,0,0,2,0,0
"Croatia","2024-11-19",0,0,1,0,0,2,0,0
"Croatia","2024-11-20",0,0,1,0,0,2,0,0
"Croatia","2024-11-21",0,0,1,0,0,2,0,0
"Croatia","2024-11-22",0,0,1,0,0,2,0,0
"Croatia","2024-11-23",0,0,1,0,0,2,0,0
"Croatia","2024-11-24",0,0,1,0,0,2,0,0
"Croatia","2024-11-25",0,0,1,0,0,2,0,0
"Croatia","2024-11-26",0,0,1,0,0,2,0,0
"Croatia","2024-11-27",0,0,1,0,0,2,0,0
"Croatia","2024-11-28",0,0,1,0,0,2,0,0
"Croatia","2024-11-29",0,0,1,0,0,2,0,0
"Croatia","2024-11-30",0,1,2,0,0,2,0,0
"Croatia","2024-12-01",0,0,2,0,0,2,0,0
"Croatia","2024-12-02",0,0,2,0,0,2,0,0
"Croatia","2024-12-03",0,0,2,0,0,2,0,0
"Croatia","2024-12-04",0,0,2,0,0,2,0,0
"Croatia","2024-12-05",0,0,2,0,0,2,0,0
"Croatia","2024-12-06",0,0,2,0,0,2,0,0
"Croatia","2024-12-07",0,0,2,0,0,2,0,0
"Croatia","2024-12-08",0,0,2,0,0,2,0,0
"Croatia","2024-12-09",0,0,2,0,0,2,0,0
"Croatia","2024-12-10",0,0,2,0,0,2,0,0
"Croatia","2024-12-11",0,0,2,0,1,3,0,0
"Croatia","2024-12-12",0,0,2,0,0,3,0,0
"Croatia","2024-12-13",0,0,2,0,0,3,0,0
"Croatia","2024-12-14",0,0,2,0,0,3,0,0
"Croatia","2024-12-15",0,0,2,0,0,3,0,0
"Croatia","2024-12-16",0,0,2,0,0,3,0,0
"Croatia","2024-12-17",0,0,2,0,0,3,0,0
"Croatia","2024-12-18",0,0,2,0,0,3,0,0
"Croatia","2024-12-19",0,0,2,0,0,3,0,0
"Croatia","2024-12-20",0,0,2,0,0,3,0,0
"Croatia","2024-12-21",0,0,2,0,0,3,0,0
"Croatia","2024-12-22",0,0,2,0,0,3,0,0
"Croatia","2024-12-23",0,0,2,0,0,3,0,0
"Croatia","2024-12-24",0,0,2,0,0,3,0,0
"Croatia","2024-12-25",0,0,2,0,0,3,0,0
"Croatia","2024-12-26",0,0,2,0,0,3,0,0
"Croatia","2024-12-27",0,0,2,0,0,3,0,0
"Croatia","2024-12-28",0,0,2,0,0,3,0,0
"Croatia","2024-12-29",0,0,2,0,0,3,0,0
"Croatia","2024-12-30",0,0,2,0,0,3,0,0
"Croatia","2024-12-31",0,0,2,0,1,4,0,0
"Croatia","2025-01-01",0,0,2,0,0,4,0,0
"Croatia","2025-01-02",0,0,2,0,0,4,0,0
"Croatia","2025-01-03",0,0,2,0,0,4,0,0
"Croatia","2025-01-04",0,0,2,0,0,4,0,0
"Croatia","2025-01-05",0,0,2,0,0,4,0,0
"Croatia","2025-01-06",0,0,2,0,0,4,0,0
"Croatia","2025-01-07",0,0,2,0,0,4,0,0
"Croatia","2025-01-08",0,0,2,0,0,4,0,0
"Croatia","2025-01-09",0,0,2,0,0,4,0,0
"Croatia","2025-01-10",0,2,4,0,0,4,0,0
"Croatia","2025-01-11",0,0,4,0,0,4,0,0
"Croatia","2025-01-12",0,0,4,0,0,4,0,0
"Croatia","2025-01-13",0,0,4,0,0,4,0,0
"Croatia","2025-01-14",0,0,4,0,0,4,0,0
"Croatia","2025-01-15",0,0,4,0,0,4,0,0
"Croatia","2025-01-16",0,0,4,0,0,4,0,0
"Croatia","2025-01-17",0,0,4,0,0,4,0,0
"Croatia","2025-01-18",0,0,4,0,0,4,0,0
"Croatia","2025-01-19",0,0,4,0,0,4,0,0
"Croatia","2025-01-20",0,0,4,0,0,4,0,0
"Croatia","2025-01-21",0,0,4,0,0,4,0,0
"Croatia","2025-01-22",0,0,4,0,0,4,0,0
"Croatia","2025-01-23",0,0,4,0,0,4,0,0
"Croatia","2025-01-24",0,0,4,0,0,4,0,0
"Croatia","2025-01-25",0,0,4,0,0,4,0,0
"Croatia","2025-01-26",0,0,4,0,0,4,0,0
"Croatia","2025-01-27",0,0,4,0,0,4,0,0
"Croatia","2025-01-28",0,0,4,0,0,4,0,0
"Croatia","2025-01-29",0,0,4,0,0,4,0,0
"Croatia","2025-01-30",0,0,4,0,0,4,0,0
"Croatia","2025-01-31",0,0,4,0,0,4,0,0
"Croatia","2025-02-01",0,0,4,0,0,4,0,0
"Croatia","2025-02-02",0,0,4,0,0,4,0,0
"Croatia","2025-02-03",0,0,4,0,0,4,0,0
"Croatia","2025-02-04",0,0,4,0,0,4,0,0
"Croatia","2025-02-05",0,0,4,0,0,4,0,0
"Croatia","2025-02-06",0,0,4,0,0,4,0,0
"Croatia","2025-02-07",0,0,4,0,0,4,0,0
"Croatia","2025-02-08",0,0,4,0,0,4,0,0
"Croatia","2025-02-09",0,0,4,0,0,4,0,0
"Croatia","2025-02-10",0,0,4,0,0,4,0,0
"Croatia","2025-02-11",0,0,4,0,0,4,0,0
"Croatia","2025-02-12",0,0,4,0,0,4,0,0
"Croatia","2025-02-13",0,0,4,0,0,4,0,0
"Croatia","2025-02-14",0,0,4,0,0,4,0,0
"Croatia","2025-02-15",0,0,4,0,0,4,0,0
"Croatia","2025-02-16",0,0,4,0,0,4,0,0
"Croatia","2025-02-17",0,0,4,0,0,4,0,0
"Croatia","2025-02-18",0,0,4,0,0,4,0,0
"Croatia","2025-02-19",0,0,4,0,0,4,0,0
"Croatia","2025-02-20",0,0,4,0,0,4,0,0
"Croatia","2025-02-21",0,0,4,0,0,4,0,0
"Croatia","2025-02-22",0,0,4,0,0,4,0,0
"Croatia","2025-02-23",0,0,4,0,0,4,0,0
"Croatia","2025-02-24",0,0,4,0,0,4,0,0
"Croatia","2025-02-25",0,0,4,0,0,4,0,0
"Croatia","2025-02-26",0,0,4,0,0,4,0,0
"Croatia","2025-02-27",0,0,4,0,0,4,0,0
"Croatia","2025-02-28",0,0,4,0,0,4,0,0
"Croatia","2025-03-01",0,0,4,0,0,4,0,0
"Croatia","2025-03-02",0,0,4,0,0,4,0,0
"Croatia","2025-03-03",0,0,4,0,0,4,0,0
"Cuba","2024-01-01",0,0,0,0,0,0,0,0
"Cuba","2024-01-02",0,0,0,0,0,0,0,0
"Cuba","2024-01-03",0,0,0,0,0,0,0,0
"Cuba","2024-01-04",0,0,0,0,0,0,0,0
"Cuba","2024-01-05",0,0,0,0,0,0,0,0
"Cuba","2024-01-06",0,0,0,0,0,0,0,0
"Cuba","2024-01-07",0,0,0,0,0,0,0,0
"Cuba","2024-01-08",0,0,0,0,0,0,0,0
"Cuba","2024-01-09",0,0,0,0,0,0,0,0
"Cuba","2024-01-10",0,0,0,0,0,0,0,0
"Cuba","2024-01-11",0,0,0,0,0,0,0,0
"Cuba","2024-01-12",0,0,0,0,0,0,0,0
"Cuba","2024-01-13",0,0,0,0,0,0,0,0
"Cuba","2024-01-14",0,0,0,0,0,0,0,0
"Cuba","2024-01-15",0,0,0,0,0,0,0,0
"Cuba","2024-01-16",0,0,0,0,0,0,0,0
"Cuba","2024-01-17",0,0,0,0,0,0,0,0
"Cuba","2024-01-18",0,0,0,0,0,0,0,0
"Cuba","2024-01-19",0,0,0,0,0,0,0,0
"Cuba","2024-01-20",0,0,0,0,0,0,0,0
"Cuba","2024-01-21",0,0,0,0,0,0,0,0
"Cuba","2024-01-22",0,0,0,0,0,0,0,0
"Cuba","2024-01-23",0,0,0,0,0,0,0,0
"Cuba","2024-01-24",0,0,0,0,0,0,0,0
"Cuba","2024-01-25",0,0,0,0,0,0,0,0
"Cuba","2024-01-26",0,0,0,0,0,0,0,0
"Cuba","2024-01-27",0,0,0,0,0,0,0,0
"Cuba","2024-01-28",0,0,0,0,0,0,0,0
"Cuba","2024-01-29",0,0,0,0,0,0,0,0
"Cuba","2024-01-30",0,0,0,0,0,0,0,0
"Cuba","2024-01-31",0,0,0,0,0,0,0,0
"Cuba","2024-02-01",0,0,0,0,0,0,0,0
"Cuba","2024-02-02",0,0,0,0,0,0,0,0
"Cuba","2024-02-03",0,0,0,0,0,0,0,0
"Cuba","2024-02-04",0,0,0,0,0,0,0,0
"Cuba","2024-02-05",0,0,0,0,0,0,0,0
"Cuba","2024-02-06",0,0,0,0,0,0,0,0
"Cuba","2024-02-07",0,0,0,0,0,0,0,0
"Cuba","2024-02-08",0,0,0,0,0,0,0,0
"Cuba","2024-02-09",0,0,0,0,0,0,0,0
"Cuba","2024-02-10",0,0,0,0,0,0,0,0
"Cuba","2024-02-11",0,0,0,0,0,0,0,0
"Cuba","2024-02-12",0,0,0,0,0,0,0,0
"Cuba","2024-02-13",0,0,0,0,0,0,0,0
"Cuba","2024-02-14",0,0,0,0,0,0,0,0
"Cuba","2024-02-15",0,0,0,0,0,0,0,0
"Cuba","2024-02-16",0,0,0,0,0,0,0,0
"Cuba","2024-02-17",0,0,0,0,0,0,0,0
"Cuba","2024-02-18",0,0,0,0,0,0,0,0
"Cuba","2024-02-19",0,0,0,0,0,0,0,0
"Cuba","2024-02-20",0,0,0,0,0,0,0,0
"Cuba","2024-02-21",0,0,0,0,0,0,0,0
"Cuba","2024-02-22",0,0,0,0,0,0,0,0
"Cuba","2024-02-23",0,0,0,0,0,0,0,0
"Cuba","2024-02-24",0,0,0,0,0,0,0,0
"Cuba","2024-02-25",0,0,0,0,0,0,0,0
"Cuba","2024-02-26",0,0,0,0,0,0,0,0
"Cuba","2024-02-27",0,0,0,0,0,0,0,0
"Cuba","2024-02-28",0,0,0,0,0,0,0,0
"Cuba","2024-02-29",0,0,0,0,0,0,0,0
"Cuba","2024-03-01",0,0,0,0,0,0,0,0
"Cuba","2024-03-02",0,0,0,0,0,0,0,0
"Cuba","2024-03-03",0,0,0,0,0,0,0,0
"Cuba","2024-03-04",0,0,0,0,0,0,0,0
"Cuba","2024-03-05",0,0,0,0,0,0,0,0
"Cuba","2024-03-06",0,0,0,0,0,0,0,0
"Cuba","2024-03-07",0,0,0,0,0,0,0,0
"Cuba","2024-03-08",0,0,0,0,0,0,0,0
"Cuba","2024-03-09",0,0,0,0,0,0,0,0
"Cuba","2024-03-10",0,0,0,0,0,0,0,0
"Cuba","2024-03-11",0,0,0,0,0,0,0,0
"Cuba","2024-03-12",0,0,0,0,0,0,0,0
"Cuba","2024-03-13",0,0,0,0,0,0,0,0
"Cuba","2024-03-14",0,0,0,0,0,0,0,0
"Cuba","2024-03-15",0,0,0,0,0,0,0,0
"Cuba","2024-03-16",0,0,0,0,0,0,0,0
"Cuba","2024-03-17",0,0,0,0,0,0,0,0
"Cuba","2024-03-18",0,0,0,0,0,0,0,0
"Cuba","2024-03-19",0,0,0,0,0,0,0,0
"Cuba","2024-03-20",0,0,0,0,0,0,0,0
"Cuba","2024-03-21",0,0,0,0,0,0,0,0
"Cuba","2024-03-22",0,0,0,0,0,0,0,0
"Cuba","2024-03-23",0,0,0,0,0,0,0,0
"Cuba","2024-03-24",0,0,0,0,0,0,0,0
"Cuba","2024-03-25",0,0,0,0,0,0,0,0
"Cuba","2024-03-26",0,0,0,0,0,0,0,0
"Cuba","2024-03-27",0,0,0,0,0,0,0,0
"Cuba","2024-03-28",0,0,0,0,0,0,0,0
"Cuba","2024-03-29",0,0,0,0,0,0,0,0
"Cuba","2024-03-30",0,0,0,0,0,0,0,0
"Cuba","2024-03-31",0,0,0,0,0,0,0,0
"Cuba","2024-04-01",0,0,0,0,0,0,0,0
"Cuba","2024-04-02",0,0,0,0,0,0,0,0
"Cuba","2024-04-03",0,0,0,0,0,0,0,0
"Cuba","2024-04-04",0,0,0,0,0,0,0,0
"Cuba","2024-04-05",0,0,0,0,0,0,0,0
"Cuba","2024-04-06",0,0,0,0,0,0,0,0
"Cuba","2024-04-07",0,0,0,0,0,0,0,0
"Cuba","2024-04-08",0,0,0,0,0,0,0,0
"Cuba","2024-04-09",0,0,0,0,0,0,0,0
"Cuba","2024-04-10",0,0,0,0,0,0,0,0
"Cuba","2024-04-11",0,0,0,0,0,0,0,0
"Cuba","2024-04-12",0,0,0,0,0,0,0,0
"Cuba","2024-04-13",0,0,0,0,0,0,0,0
"Cuba","2024-04-14",0,0,0,0,0,0,0,0
"Cuba","2024-04-15",0,0,0,0,0,0,0,0
"Cuba","2024-04-16",0,0,0,0,0,0,0,0
"Cuba","2024-04-17",0,0,0,0,0,0,0,0
"Cuba","2024-04-18",0,0,0,0,0,0,0,0
"Cuba","2024-04-19",0,0,0,0,0,0,0,0
"Cuba","2024-04-20",0,0,0,0,0,0,0,0
"Cuba","2024-04-21",0,0,0,0,0,0,0,0
"Cuba","2024-04-22",0,0,0,0,0,0,0,0
"Cuba","2024-04-23",0,0,0,0,0,0,0,0
"Cuba","2024-04-24",0,0,0,0,0,0,0,0
"Cuba","2024-04-25",0,0,0,0,0,0,0,0
"Cuba","2024-04-26",0,0,0,0,0,0,0,0
"Cuba","2024-04-27",0,0,0,0,0,0,0,0
"Cuba","2024-04-28",0,0,0,0,0,0,0,0
"Cuba","2024-04-29",0,0,0,0,0,0,0,0
"Cuba","2024-04-30",0,0,0,0,0,0,0,0
"Cuba","2024-05-01",0,0,0,0,0,0,0,0
"Cuba","2024-05-02",0,0,0,0,0,0,0,0
"Cuba","2024-05-03",0,0,0,0,0,0,0,0
"Cuba","2024-05-04",0,0,0,0,0,0,0,0
"Cuba","2024-05-05",0,0,0,0,0,0,0,0
"Cuba","2024-05-06",0,0,0,0,0,0,0,0
"Cuba","2024-05-07",0,0,0,0,0,0,0,0
"Cuba","2024-05-08",0,0,0,0,0,0,0,0
"Cuba","2024-05-09",0,0,0,0,0,0,0,0
"Cuba","2024-05-10",0,0,0,0,0,0,0,0
"Cuba","2024-05-11",0,0,0,0,0,0,0,0
"Cuba","2024-05-12",0,0,0,0,0,0,0,0
"Cuba","2024-05-13",0,0,0,0,0,0,0,0
"Cuba","2024-05-14",0,0,0,0,0,0,0,0
"Cuba","2024-05-15",0,0,0,0,0,0,0,0
"Cuba","2024-05-16",0,0,0,0,0,0,0,0
"Cuba","2024-05-17",0,0,0,0,0,0,0,0
"Cuba","2024-05-18",0,0,0,0,0,0,0,0
"Cuba","2024-05-19",0,0,0,0,0,0,0,0
"Cuba","2024-05-20",0,0,0,0,0,0,0,0
"Cuba","2024-05-21",0,0,0,0,0,0,0,0
"Cuba","2024-05-22",0,0,0,0,0,0,0,0
"Cuba","2024-05-23",0,0,0,0,0,0,0,0
"Cuba","2024-05-24",0,0,0,0,0,0,0,0
"Cuba","2024-05-25",0,0,0,0,0,0,0,0
"Cuba","2024-05-26",0,0,0,0,0,0,0,0
"Cuba","2024-05-27",0,0,0,0,0,0,0,0
"Cuba","2024-05-28",0,0,0,0,0,0,0,0
"Cuba","2024-05-29",0,0,0,0,0,0,0,0
"Cuba","2024-05-30",0,0,0,0,0,0,0,0
"Cuba","2024-05-31",0,0,0,0,0,0,0,0
"Cuba","2024-06-01",0,0,0,0,0,0,0,0
"Cuba","2024-06-02",0,0,0,0,0,0,0,0
"Cuba","2024-06-03",0,0,0,0,0,0,0,0
"Cuba","2024-06-04",0,0,0,0,0,0,0,0
"Cuba","2024-06-05",0,0,0,0,0,0,0,0
"Cuba","2024-06-06",0,0,0,0,0,0,0,0
"Cuba","2024-06-07",0,0,0,0,0,0,0,0
"Cuba","2024-06-08",0,0,0,0,0,0,0,0
"Cuba","2024-06-09",0,0,0,0,0,0,0,0
"Cuba","2024-06-10",0,0,0,0,0,0,0,0
"Cuba","2024-06-11",0,0,0,0,0,0,0,0
"Cuba","2024-06-12",0,0,0,0,0,0,0,0
"Cuba","2024-06-13",0,0,0,0,0,0,0,0
"Cuba","2024-06-14",0,0,0,0,0,0,0,0
"Cuba","2024-06-15",0,0,0,0,0,0,0,0
"Cuba","2024-06-16",0,0,0,0,0,0,0,0
"Cuba","2024-06-17",0,0,0,0,0,0,0,0
"Cuba","2024-06-18",0,0,0,0,0,0,0,0
"Cuba","2024-06-19",0,0,0,0,0,0,0,0
"Cuba","2024-06-20",0,0,0,0,0,0,0,0
"Cuba","2024-06-21",0,0,0,0,0,0,0,0
"Cuba","2024-06-22",0,0,0,0,0,0,0,0
"Cuba","2024-06-23",0,0,0,0,0,0,0,0
"Cuba","2024-06-24",0,0,0,0,0,0,0,0
"Cuba","2024-06-25",0,0,0,0,0,0,0,0
"Cuba","2024-06-26",0,0,0,0,0,0,0,0
"Cuba","2024-06-27",0,0,0,0,0,0,0,0
"Cuba","2024-06-28",0,0,0,0,0,0,0,0
"Cuba","2024-06-29",0,0,0,0,0,0,0,0
"Cuba","2024-06-30",0,0,0,0,0,0,0,0
"Cuba","2024-07-01",0,0,0,0,0,0,0,0
"Cuba","2024-07-02",0,0,0,0,0,0,0,0
"Cuba","2024-07-03",0,0,0,0,0,0,0,0
"Cuba","2024-07-04",0,0,0,0,0,0,0,0
"Cuba","2024-07-05",0,0,0,0,0,0,0,0
"Cuba","2024-07-06",0,0,0,0,0,0,0,0
"Cuba","2024-07-07",0,0,0,0,0,0,0,0
"Cuba","2024-07-08",0,0,0,0,0,0,0,0
"Cuba","2024-07-09",0,0,0,0,0,0,0,0
"Cuba","2024-07-10",0,0,0,0,0,0,0,0
"Cuba","2024-07-11",0,0,0,0,0,0,0,0
"Cuba","2024-07-12",0,0,0,0,0,0,0,0
"Cuba","2024-07-13",0,0,0,0,0,0,0,0
"Cuba","2024-07-14",0,0,0,0,0,0,0,0
"Cuba","2024-07-15",0,0,0,0,0,0,0,0
"Cuba","2024-07-16",0,0,0,0,0,0,0,0
"Cuba","2024-07-17",0,0,0,0,0,0,0,0
"Cuba","2024-07-18",0,0,0,0,0,0,0,0
"Cuba","2024-07-19",0,0,0,0,0,0,0,0
"Cuba","2024-07-20",0,0,0,0,0,0,0,0
"Cuba","2024-07-21",0,0,0,0,0,0,0,0
"Cuba","2024-07-22",0,0,0,0,0,0,0,0
"Cuba","2024-07-23",0,0,0,0,0,0,0,0
"Cuba","2024-07-24",0,0,0,0,0,0,0,0
"Cuba","2024-07-25",0,0,0,0,0,0,0,0
"Cuba","2024-07-26",0,0,0,0,0,0,0,0
"Cuba","2024-07-27",0,0,0,0,0,0,0,0
"Cuba","2024-07-28",0,0,0,0,0,0,0,0
"Cuba","2024-07-29",0,0,0,0,0,0,0,0
"Cuba","2024-07-30",0,0,0,0,0,0,0,0
"Cuba","2024-07-31",0,0,0,0,0,0,0,0
"Cuba","2024-08-01",0,0,0,0,0,0,0,0
"Cuba","2024-08-02",0,0,0,0,0,0,0,0
"Cuba","2024-08-03",0,0,0,0,0,0,0,0
"Cuba","2024-08-04",0,0,0,0,0,0,0,0
"Cuba","2024-08-05",0,0,0,0,0,0,0,0
"Cuba","2024-08-06",0,0,0,0,0,0,0,0
"Cuba","2024-08-07",0,0,0,0,0,0,0,0
"Cuba","2024-08-08",0,0,0,0,0,0,0,0
"Cuba","2024-08-09",0,0,0,0,0,0,0,0
"Cuba","2024-08-10",0,0,0,0,0,0,0,0
"Cuba","2024-08-11",0,0,0,0,0,0,0,0
"Cuba","2024-08-12",0,0,0,0,0,0,0,0
"Cuba","2024-08-13",0,0,0,0,0,0,0,0
"Cuba","2024-08-14",0,0,0,0,0,0,0,0
"Cuba","2024-08-15",0,0,0,0,0,0,0,0
"Cuba","2024-08-16",0,0,0,0,0,0,0,0
"Cuba","2024-08-17",0,0,0,0,0,0,0,0
"Cuba","2024-08-18",0,0,0,0,0,0,0,0
"Cuba","2024-08-19",0,0,0,0,0,0,0,0
"Cuba","2024-08-20",0,0,0,0,0,0,0,0
"Cuba","2024-08-21",0,0,0,0,0,0,0,0
"Cuba","2024-08-22",0,0,0,0,0,0,0,0
"Cuba","2024-08-23",0,0,0,0,0,0,0,0
"Cuba","2024-08-24",0,0,0,0,0,0,0,0
"Cuba","2024-08-25",0,0,0,0,0,0,0,0
"Cuba","2024-08-26",0,0,0,0,0,0,0,0
"Cuba","2024-08-27",0,0,0,0,0,0,0,0
"Cuba","2024-08-28",0,0,0,0,0,0,0,0
"Cuba","2024-08-29",0,0,0,0,0,0,0,0
"Cuba","2024-08-30",0,0,0,0,0,0,0,0
"Cuba","2024-08-31",0,0,0,0,0,0,0,0
"Cuba","2024-09-01",0,0,0,0,0,0,0,0
"Cuba","2024-09-02",0,0,0,0,0,0,0,0
"Cuba","2024-09-03",0,0,0,0,0,0,0,0
"Cuba","2024-09-04",0,0,0,0,0,0,0,0
"Cuba","2024-09-05",0,0,0,0,0,0,0,0
"Cuba","2024-09-06",0,0,0,0,0,0,0,0
"Cuba","2024-09-07",0,0,0,0,0,0,0,0
"Cuba","2024-09-08",0,0,0,0,0,0,0,0
"Cuba","2024-09-09",0,0,0,0,0,0,0,0
"Cuba","2024-09-10",0,0,0,0,0,0,0,0
"Cuba","2024-09-11",0,0,0,0,0,0,0,0
"Cuba","2024-09-12",0,0,0,0,0,0,0,0
"Cuba","2024-09-13",0,0,0,0,0,0,0,0
"Cuba","2024-09-14",0,0,0,0,0,0,0,0
"Cuba","2024-09-15",0,0,0,0,0,0,0,0
"Cuba","2024-09-16",0,0,0,0,0,0,0,0
"Cuba","2024-09-17",0,0,0,0,0,0,0,0
"Cuba","2024-09-18",0,0,0,0,0,0,0,0
"Cuba","2024-09-19",0,0,0,0,0,0,0,0
"Cuba","2024-09-20",0,0,0,0,0,0,0,0
"Cuba","2024-09-21",0,0,0,0,0,0,0,0
"Cuba","2024-09-22",0,0,0,0,0,0,0,0
"Cuba","2024-09-23",0,0,0,0,0,0,0,0
"Cuba","2024-09-24",0,0,0,0,0,0,0,0
"Cuba","2024-09-25",0,0,0,0,0,0,0,0
"Cuba","2024-09-26",0,0,0,0,0,0,0,0
"Cuba","2024-09-27",0,0,0,0,0,0,0,0
"Cuba","2024-09-28",0,0,0,0,0,0,0,0
"Cuba","2024-09-29",0,0,0,0,0,0,0,0
"Cuba","2024-09-30",0,0,0,0,0,0,0,0
"Cuba","2024-10-01",0,0,0,0,0,0,0,0
"Cuba","2024-10-02",0,0,0,0,0,0,0,0
"Cuba","2024-10-03",0,0,0,0,0,0,0,0
"Cuba","2024-10-04",0,0,0,0,0,0,0,0
"Cuba","2024-10-05",0,0,0,0,0,0,0,0
"Cuba","2024-10-06",0,0,0,0,0,0,0,0
"Cuba","2024-10-07",0,0,0,0,0,0,0,0
"Cuba","2024-10-08",0,0,0,0,0,0,0,0
"Cuba","2024-10-09",0,0,0,0,0,0,0,0
"Cuba","2024-10-10",0,0,0,0,0,0,0,0
"Cuba","2024-10-11",0,0,0,0,0,0,0,0
"Cuba","2024-10-12",0,0,0,0,0,0,0,0
"Cuba","2024-10-13",0,0,0,0,0,0,0,0
"Cuba","2024-10-14",0,0,0,0,0,0,0,0
"Cuba","2024-10-15",0,0,0,0,0,0,0,0
"Cuba","2024-10-16",0,0,0,0,0,0,0,0
"Cuba","2024-10-17",0,0,0,0,0,0,0,0
"Cuba","2024-10-18",0,0,0,0,0,0,0,0
"Cuba","2024-10-19",0,0,0,0,0,0,0,0
"Cuba","2024-10-20",0,0,0,0,0,0,0,0
"Cuba","2024-10-21",0,0,0,0,0,0,0,0
"Cuba","2024-10-22",0,0,0,0,0,0,0,0
"Cuba","2024-10-23",0,0,0,0,0,0,0,0
"Cuba","2024-10-24",0,0,0,0,0,0,0,0
"Cuba","2024-10-25",0,0,0,0,0,0,0,0
"Cuba","2024-10-26",0,0,0,0,0,0,0,0
"Cuba","2024-10-27",0,0,0,0,0,0,0,0
"Cuba","2024-10-28",0,0,0,0,0,0,0,0
"Cuba","2024-10-29",0,0,0,0,0,0,0,0
"Cuba","2024-10-30",0,0,0,0,0,0,0,0
"Cuba","2024-10-31",0,0,0,0,0,0,0,0
"Cuba","2024-11-01",0,0,0,0,0,0,0,0
"Cuba","2024-11-02",0,0,0,0,0,0,0,0
"Cuba","2024-11-03",0,0,0,0,0,0,0,0
"Cuba","2024-11-04",0,0,0,0,0,0,0,0
"Cuba","2024-11-05",0,0,0,0,0,0,0,0
"Cuba","2024-11-06",0,0,0,0,0,0,0,0
"Cuba","2024-11-07",0,0,0,0,0,0,0,0
"Cuba","2024-11-08",0,0,0,0,0,0,0,0
"Cuba","2024-11-09",0,0,0,0,0,0,0,0
"Cuba","2024-11-10",0,0,0,0,0,0,0,0
"Cuba","2024-11-11",0,0,0,0,0,0,0,0
"Cuba","2024-11-12",0,0,0,0,0,0,0,0
"Cuba","2024-11-13",0,0,0,0,0,0,0,0
"Cuba","2024-11-14",0,0,0,0,0,0,0,0
"Cuba","2024-11-15",0,0,0,0,0,0,0,0
"Cuba","2024-11-16",0,0,0,0,0,0,0,0
"Cuba","2024-11-17",0,0,0,0,0,0,0,0
"Cuba","2024-11-18",0,0,0,0,0,0,0,0
"Cuba","2024-11-19",0,0,0,0,0,0,0,0
"Cuba","2024-11-20",0,0,0,0,0,0,0,0
"Cuba","2024-11-21",0,0,0,0,0,0,0,0
"Cuba","2024-11-22",0,0,0,0,0,0,0,0
"Cuba","2024-11-23",0,0,0,0,0,0,0,0
"Cuba","2024-11-24",0,0,0,0,0,0,0,0
"Cuba","2024-11-25",0,0,0,0,0,0,0,0
"Cuba","2024-11-26",0,0,0,0,0,0,0,0
"Cuba","2024-11-27",0,0,0,0,0,0,0,0
"Cuba","2024-11-28",0,0,0,0,0,0,0,0
"Cuba","2024-11-29",0,0,0,0,0,0,0,0
"Cuba","2024-11-30",0,0,0,0,0,0,0,0
"Cuba","2024-12-01",0,0,0,0,0,0,0,0
"Cuba","2024-12-02",0,0,0,0,0,0,0,0
"Cuba","2024-12-03",0,0,0,0,0,0,0,0
"Cuba","2024-12-04",0,0,0,0,0,0,0,0
"Cuba","2024-12-05",0,0,0,0,0,0,0,0
"Cuba","2024-12-06",0,0,0,0,0,0,0,0
"Cuba","2024-12-07",0,0,0,0,0,0,0,0
"Cuba","2024-12-08",0,0,0,0,0,0,0,0
"Cuba","2024-12-09",0,0,0,0,0,0,0,0
"Cuba","2024-12-10",0,0,0,0,0,0,0,0
"Cuba","2024-12-11",0,0,0,0,0,0,0,0
"Cuba","2024-12-12",0,0,0,0,0,0,0,0
"Cuba","2024-12-13",0,0,0,0,0,0,0,0
"Cuba","2024-12-14",0,0,0,0,0,0,0,0
"Cuba","2024-12-15",0,0,0,0,0,0,0,0
"Cuba","2024-12-16",0,0,0,0,0,0,0,0
"Cuba","2024-12-17",0,0,0,0,0,0,0,0
"Cuba","2024-12-18",0,0,0,0,0,0,0,0
"Cuba","2024-12-19",0,0,0,0,0,0,0,0
"Cuba","2024-12-20",0,0,0,0,0,0,0,0
"Cuba","2024-12-21",0,0,0,0,0,0,0,0
"Cuba","2024-12-22",0,0,0,0,0,0,0,0
"Cuba","2024-12-23",0,0,0,0,0,0,0,0
"Cuba","2024-12-24",0,0,0,0,0,0,0,0
"Cuba","2024-12-25",0,0,0,0,0,0,0,0
"Cuba","2024-12-26",0,0,0,0,0,0,0,0
"Cuba","2024-12-27",0,0,0,0,0,0,0,0
"Cuba","2024-12-28",0,0,0,0,0,0,0,0
"Cuba","2024-12-29",0,0,0,0,0,0,0,0
"Cuba","2024-12-30",0,0,0,0,0,0,0,0
"Cuba","2024-12-31",0,0,0,0,0,0,0,0
"Cuba","2025-01-01",0,0,0,0,0,0,0,0
"Cuba","2025-01-02",0,0,0,0,0,0,0,0
"Cuba","2025-01-03",0,0,0,0,0,0,0,0
"Cuba","2025-01-04",0,0,0,0,0,0,0,0
"Cuba","2025-01-05",0,0,0,0,0,0,0,0
"Cuba","2025-01-06",0,0,0,0,0,0,0,0
"Cuba","2025-01-07",0,0,0,0,0,0,0,0
"Cuba","2025-01-08",0,0,0,0,0,0,0,0
"Cuba","2025-01-09",0,0,0,0,0,0,0,0
"Cuba","2025-01-10",0,0,0,0,0,0,0,0
"Cuba","2025-01-11",0,0,0,0,0,0,0,0
"Cuba","2025-01-12",0,0,0,0,0,0,0,0
"Cuba","2025-01-13",0,0,0,0,0,0,0,0
"Cuba","2025-01-14",0,0,0,0,0,0,0,0
"Cuba","2025-01-15",0,0,0,0,0,0,0,0
"Cuba","2025-01-16",0,0,0,0,0,0,0,0
"Cuba","2025-01-17",0,0,0,0,0,0,0,0
"Cuba","2025-01-18",0,0,0,0,0,0,0,0
"Cuba","2025-01-19",0,0,0,0,0,0,0,0
"Cuba","2025-01-20",0,0,0,0,0,0,0,0
"Cuba","2025-01-21",0,0,0,0,0,0,0,0
"Cuba","2025-01-22",0,0,0,0,0,0,0,0
"Cuba","2025-01-23",0,0,0,0,0,0,0,0
"Cuba","2025-01-24",0,0,0,0,0,0,0,0
"Cuba","2025-01-25",0,0,0,0,0,0,0,0
"Cuba","2025-01-26",0,0,0,0,0,0,0,0
"Cuba","2025-01-27",0,0,0,0,0,0,0,0
"Cuba","2025-01-28",0,0,0,0,0,0,0,0
"Cuba","2025-01-29",0,0,0,0,0,0,0,0
"Cuba","2025-01-30",0,0,0,0,0,0,0,0
"Cuba","2025-01-31",0,0,0,0,0,0,0,0
"Cuba","2025-02-01",0,0,0,0,0,0,0,0
"Cuba","2025-02-02",0,0,0,0,0,0,0,0
"Cuba","2025-02-03",0,0,0,0,0,0,0,0
"Cuba","2025-02-04",0,0,0,0,0,0,0,0
"Cuba","2025-02-05",0,0,0,0,0,0,0,0
"Cuba","2025-02-06",0,0,0,0,0,0,0,0
"Cuba","2025-02-07",0,0,0,0,0,0,0,0
"Cuba","2025-02-08",0,0,0,0,0,0,0,0
"Cuba","2025-02-09",0,0,0,0,0,0,0,0
"Cuba","2025-02-10",0,0,0,0,0,0,0,0
"Cuba","2025-02-11",0,0,0,0,0,0,0,0
"Cuba","2025-02-12",0,0,0,0,0,0,0,0
"Cuba","2025-02-13",0,0,0,0,0,0,0,0
"Cuba","2025-02-14",0,0,0,0,0,0,0,0
"Cuba","2025-02-15",0,0,0,0,0,0,0,0
"Cuba","2025-02-16",0,0,0,0,0,0,0,0
"Cuba","2025-02-17",0,0,0,0,0,0,0,0
"Cuba","2025-02-18",0,0,0,0,0,0,0,0
"Cuba","2025-02-19",0,0,0,0,0,0,0,0
"Cuba","2025-02-20",0,0,0,0,0,0,0,0
"Cuba","2025-02-21",0,0,0,0,0,0,0,0
"Cuba","2025-02-22",0,0,0,0,0,0,0,0
"Cuba","2025-02-23",0,0,0,0,0,0,0,0
"Cuba","2025-02-24",0,0,0,0,0,0,0,0
"Cuba","2025-02-25",0,0,0,0,0,0,0,0
"Cuba","2025-02-26",0,0,0,0,0,0,0,0
"Cuba","2025-02-27",0,0,0,0,0,0,0,0
"Cuba","2025-02-28",0,0,0,0,0,0,0,0
"Cuba","2025-03-01",0,0,0,0,0,0,0,0
"Cuba","2025-03-02",0,0,0,0,0,0,0,0
"Cuba","2025-03-03",0,0,0,0,0,0,0,0
"Curaçao","2024-01-01",0,0,0,0,0,0,0,0
"Curaçao","2024-01-02",0,0,0,0,0,0,0,0
"Curaçao","2024-01-03",0,0,0,0,0,0,0,0
"Curaçao","2024-01-04",0,0,0,0,0,0,0,0
"Curaçao","2024-01-05",0,0,0,0,0,0,0,0
"Curaçao","2024-01-06",0,0,0,0,0,0,0,0
"Curaçao","2024-01-07",0,0,0,0,0,0,0,0
"Curaçao","2024-01-08",0,0,0,0,0,0,0,0
"Curaçao","2024-01-09",0,0,0,0,0,0,0,0
"Curaçao","2024-01-10",0,0,0,0,0,0,0,0
"Curaçao","2024-01-11",0,0,0,0,0,0,0,0
"Curaçao","2024-01-12",0,0,0,0,0,0,0,0
"Curaçao","2024-01-13",0,0,0,0,0,0,0,0
"Curaçao","2024-01-14",0,0,0,0,0,0,0,0
"Curaçao","2024-01-15",0,0,0,0,0,0,0,0
"Curaçao","2024-01-16",0,0,0,0,0,0,0,0
"Curaçao","2024-01-17",0,0,0,0,0,0,0,0
"Curaçao","2024-01-18",0,0,0,0,0,0,0,0
"Curaçao","2024-01-19",0,0,0,0,0,0,0,0
"Curaçao","2024-01-20",0,0,0,0,0,0,0,0
"Curaçao","2024-01-21",0,0,0,0,0,0,0,0
"Curaçao","2024-01-22",0,0,0,0,0,0,0,0
"Curaçao","2024-01-23",0,0,0,0,0,0,0,0
"Curaçao","2024-01-24",0,0,0,0,0,0,0,0
"Curaçao","2024-01-25",0,0,0,0,0,0,0,0
"Curaçao","2024-01-26",0,0,0,0,0,0,0,0
"Curaçao","2024-01-27",0,0,0,0,0,0,0,0
"Curaçao","2024-01-28",0,0,0,0,0,0,0,0
"Curaçao","2024-01-29",0,0,0,0,0,0,0,0
"Curaçao","2024-01-30",0,0,0,0,0,0,0,0
"Curaçao","2024-01-31",0,0,0,0,0,0,0,0
"Curaçao","2024-02-01",0,0,0,0,0,0,0,0
"Curaçao","2024-02-02",0,0,0,0,0,0,0,0
"Curaçao","2024-02-03",0,0,0,0,0,0,0,0
"Curaçao","2024-02-04",0,0,0,0,0,0,0,0
"Curaçao","2024-02-05",0,0,0,0,0,0,0,0
"Curaçao","2024-02-06",0,0,0,0,0,0,0,0
"Curaçao","2024-02-07",0,0,0,0,0,0,0,0
"Curaçao","2024-02-08",0,0,0,0,0,0,0,0
"Curaçao","2024-02-09",0,0,0,0,0,0,0,0
"Curaçao","2024-02-10",0,0,0,0,0,0,0,0
"Curaçao","2024-02-11",0,0,0,0,0,0,0,0
"Curaçao","2024-02-12",0,0,0,0,0,0,0,0
"Curaçao","2024-02-13",0,0,0,0,0,0,0,0
"Curaçao","2024-02-14",0,0,0,0,0,0,0,0
"Curaçao","2024-02-15",0,0,0,0,0,0,0,0
"Curaçao","2024-02-16",0,0,0,0,0,0,0,0
"Curaçao","2024-02-17",0,0,0,0,0,0,0,0
"Curaçao","2024-02-18",0,0,0,0,0,0,0,0
"Curaçao","2024-02-19",0,0,0,0,0,0,0,0
"Curaçao","2024-02-20",0,0,0,0,0,0,0,0
"Curaçao","2024-02-21",0,0,0,0,0,0,0,0
"Curaçao","2024-02-22",0,0,0,0,0,0,0,0
"Curaçao","2024-02-23",0,0,0,0,0,0,0,0
"Curaçao","2024-02-24",0,0,0,0,0,0,0,0
"Curaçao","2024-02-25",0,0,0,0,0,0,0,0
"Curaçao","2024-02-26",0,0,0,0,0,0,0,0
"Curaçao","2024-02-27",0,0,0,0,0,0,0,0
"Curaçao","2024-02-28",0,0,0,0,0,0,0,0
"Curaçao","2024-02-29",0,0,0,0,0,0,0,0
"Curaçao","2024-03-01",0,0,0,0,0,0,0,0
"Curaçao","2024-03-02",0,0,0,0,0,0,0,0
"Curaçao","2024-03-03",0,0,0,0,0,0,0,0
"Curaçao","2024-03-04",0,0,0,0,0,0,0,0
"Curaçao","2024-03-05",0,0,0,0,0,0,0,0
"Curaçao","2024-03-06",0,0,0,0,0,0,0,0
"Curaçao","2024-03-07",0,0,0,0,0,0,0,0
"Curaçao","2024-03-08",0,0,0,0,0,0,0,0
"Curaçao","2024-03-09",0,0,0,0,0,0,0,0
"Curaçao","2024-03-10",0,0,0,0,0,0,0,0
"Curaçao","2024-03-11",0,0,0,0,0,0,0,0
"Curaçao","2024-03-12",0,0,0,0,0,0,0,0
"Curaçao","2024-03-13",0,0,0,0,0,0,0,0
"Curaçao","2024-03-14",0,0,0,0,0,0,0,0
"Curaçao","2024-03-15",0,0,0,0,0,0,0,0
"Curaçao","2024-03-16",0,0,0,0,0,0,0,0
"Curaçao","2024-03-17",0,0,0,0,0,0,0,0
"Curaçao","2024-03-18",0,0,0,0,0,0,0,0
"Curaçao","2024-03-19",0,0,0,0,0,0,0,0
"Curaçao","2024-03-20",0,0,0,0,0,0,0,0
"Curaçao","2024-03-21",0,0,0,0,0,0,0,0
"Curaçao","2024-03-22",0,0,0,0,0,0,0,0
"Curaçao","2024-03-23",0,0,0,0,0,0,0,0
"Curaçao","2024-03-24",0,0,0,0,0,0,0,0
"Curaçao","2024-03-25",0,0,0,0,0,0,0,0
"Curaçao","2024-03-26",0,0,0,0,0,0,0,0
"Curaçao","2024-03-27",0,0,0,0,0,0,0,0
"Curaçao","2024-03-28",0,0,0,0,0,0,0,0
"Curaçao","2024-03-29",0,0,0,0,0,0,0,0
"Curaçao","2024-03-30",0,0,0,0,0,0,0,0
"Curaçao","2024-03-31",0,0,0,0,0,0,0,0
"Curaçao","2024-04-01",0,0,0,0,0,0,0,0
"Curaçao","2024-04-02",0,0,0,0,0,0,0,0
"Curaçao","2024-04-03",0,0,0,0,0,0,0,0
"Curaçao","2024-04-04",0,0,0,0,0,0,0,0
"Curaçao","2024-04-05",0,0,0,0,0,0,0,0
"Curaçao","2024-04-06",0,0,0,0,0,0,0,0
"Curaçao","2024-04-07",0,0,0,0,0,0,0,0
"Curaçao","2024-04-08",0,0,0,0,0,0,0,0
"Curaçao","2024-04-09",0,0,0,0,0,0,0,0
"Curaçao","2024-04-10",0,0,0,0,0,0,0,0
"Curaçao","2024-04-11",0,0,0,0,0,0,0,0
"Curaçao","2024-04-12",0,0,0,0,0,0,0,0
"Curaçao","2024-04-13",0,0,0,0,0,0,0,0
"Curaçao","2024-04-14",0,0,0,0,0,0,0,0
"Curaçao","2024-04-15",0,0,0,0,0,0,0,0
"Curaçao","2024-04-16",0,0,0,0,0,0,0,0
"Curaçao","2024-04-17",0,0,0,0,0,0,0,0
"Curaçao","2024-04-18",0,0,0,0,0,0,0,0
"Curaçao","2024-04-19",0,0,0,0,0,0,0,0
"Curaçao","2024-04-20",0,0,0,0,0,0,0,0
"Curaçao","2024-04-21",0,0,0,0,0,0,0,0
"Curaçao","2024-04-22",0,0,0,0,0,0,0,0
"Curaçao","2024-04-23",0,0,0,0,0,0,0,0
"Curaçao","2024-04-24",0,0,0,0,0,0,0,0
"Curaçao","2024-04-25",0,0,0,0,0,0,0,0
"Curaçao","2024-04-26",0,0,0,0,0,0,0,0
"Curaçao","2024-04-27",0,0,0,0,0,0,0,0
"Curaçao","2024-04-28",0,0,0,0,0,0,0,0
"Curaçao","2024-04-29",0,0,0,0,0,0,0,0
"Curaçao","2024-04-30",0,0,0,0,0,0,0,0
"Curaçao","2024-05-01",0,0,0,0,0,0,0,0
"Curaçao","2024-05-02",0,0,0,0,0,0,0,0
"Curaçao","2024-05-03",0,0,0,0,0,0,0,0
"Curaçao","2024-05-04",0,0,0,0,0,0,0,0
"Curaçao","2024-05-05",0,0,0,0,0,0,0,0
"Curaçao","2024-05-06",0,0,0,0,0,0,0,0
"Curaçao","2024-05-07",0,0,0,0,0,0,0,0
"Curaçao","2024-05-08",0,0,0,0,0,0,0,0
"Curaçao","2024-05-09",0,0,0,0,0,0,0,0
"Curaçao","2024-05-10",0,0,0,0,0,0,0,0
"Curaçao","2024-05-11",0,0,0,0,0,0,0,0
"Curaçao","2024-05-12",0,0,0,0,0,0,0,0
"Curaçao","2024-05-13",0,0,0,0,0,0,0,0
"Curaçao","2024-05-14",0,0,0,0,0,0,0,0
"Curaçao","2024-05-15",0,0,0,0,0,0,0,0
"Curaçao","2024-05-16",0,0,0,0,0,0,0,0
"Curaçao","2024-05-17",0,0,0,0,0,0,0,0
"Curaçao","2024-05-18",0,0,0,0,0,0,0,0
"Curaçao","2024-05-19",0,0,0,0,0,0,0,0
"Curaçao","2024-05-20",0,0,0,0,0,0,0,0
"Curaçao","2024-05-21",0,0,0,0,0,0,0,0
"Curaçao","2024-05-22",0,0,0,0,0,0,0,0
"Curaçao","2024-05-23",0,0,0,0,0,0,0,0
"Curaçao","2024-05-24",0,0,0,0,0,0,0,0
"Curaçao","2024-05-25",0,0,0,0,0,0,0,0
"Curaçao","2024-05-26",0,0,0,0,0,0,0,0
"Curaçao","2024-05-27",0,0,0,0,0,0,0,0
"Curaçao","2024-05-28",0,0,0,0,0,0,0,0
"Curaçao","2024-05-29",0,0,0,0,0,0,0,0
"Curaçao","2024-05-30",0,0,0,0,0,0,0,0
"Curaçao","2024-05-31",0,0,0,0,0,0,0,0
"Curaçao","2024-06-01",0,0,0,0,0,0,0,0
"Curaçao","2024-06-02",0,0,0,0,0,0,0,0
"Curaçao","2024-06-03",0,0,0,0,0,0,0,0
"Curaçao","2024-06-04",0,0,0,0,0,0,0,0
"Curaçao","2024-06-05",0,0,0,0,0,0,0,0
"Curaçao","2024-06-06",0,0,0,0,0,0,0,0
"Curaçao","2024-06-07",0,0,0,0,0,0,0,0
"Curaçao","2024-06-08",0,0,0,0,0,0,0,0
"Curaçao","2024-06-09",0,0,0,0,0,0,0,0
"Curaçao","2024-06-10",0,0,0,0,0,0,0,0
"Curaçao","2024-06-11",0,0,0,0,0,0,0,0
"Curaçao","2024-06-12",0,0,0,0,0,0,0,0
"Curaçao","2024-06-13",0,0,0,0,0,0,0,0
"Curaçao","2024-06-14",0,0,0,0,0,0,0,0
"Curaçao","2024-06-15",0,0,0,0,0,0,0,0
"Curaçao","2024-06-16",0,0,0,0,0,0,0,0
"Curaçao","2024-06-17",0,0,0,0,0,0,0,0
"Curaçao","2024-06-18",0,0,0,0,0,0,0,0
"Curaçao","2024-06-19",0,0,0,0,0,0,0,0
"Curaçao","2024-06-20",0,0,0,0,0,0,0,0
"Curaçao","2024-06-21",0,0,0,0,0,0,0,0
"Curaçao","2024-06-22",0,0,0,0,0,0,0,0
"Curaçao","2024-06-23",0,0,0,0,0,0,0,0
"Curaçao","2024-06-24",0,0,0,0,0,0,0,0
"Curaçao","2024-06-25",0,0,0,0,0,0,0,0
"Curaçao","2024-06-26",0,0,0,0,0,0,0,0
"Curaçao","2024-06-27",0,0,0,0,0,0,0,0
"Curaçao","2024-06-28",0,0,0,0,0,0,0,0
"Curaçao","2024-06-29",0,0,0,0,0,0,0,0
"Curaçao","2024-06-30",0,0,0,0,0,0,0,0
"Curaçao","2024-07-01",0,0,0,0,0,0,0,0
"Curaçao","2024-07-02",0,0,0,0,0,0,0,0
"Curaçao","2024-07-03",0,0,0,0,0,0,0,0
"Curaçao","2024-07-04",0,0,0,0,0,0,0,0
"Curaçao","2024-07-05",0,0,0,0,0,0,0,0
"Curaçao","2024-07-06",0,0,0,0,0,0,0,0
"Curaçao","2024-07-07",0,0,0,0,0,0,0,0
"Curaçao","2024-07-08",0,0,0,0,0,0,0,0
"Curaçao","2024-07-09",0,0,0,0,0,0,0,0
"Curaçao","2024-07-10",0,0,0,0,0,0,0,0
"Curaçao","2024-07-11",0,0,0,0,0,0,0,0
"Curaçao","2024-07-12",0,0,0,0,0,0,0,0
"Curaçao","2024-07-13",0,0,0,0,0,0,0,0
"Curaçao","2024-07-14",0,0,0,0,0,0,0,0
"Curaçao","2024-07-15",0,0,0,0,0,0,0,0
"Curaçao","2024-07-16",0,0,0,0,0,0,0,0
"Curaçao","2024-07-17",0,0,0,0,0,0,0,0
"Curaçao","2024-07-18",0,0,0,0,0,0,0,0
"Curaçao","2024-07-19",0,0,0,0,0,0,0,0
"Curaçao","2024-07-20",0,0,0,0,0,0,0,0
"Curaçao","2024-07-21",0,0,0,0,0,0,0,0
"Curaçao","2024-07-22",0,0,0,0,0,0,0,0
"Curaçao","2024-07-23",0,0,0,0,0,0,0,0
"Curaçao","2024-07-24",0,0,0,0,0,0,0,0
"Curaçao","2024-07-25",0,0,0,0,0,0,0,0
"Curaçao","2024-07-26",0,0,0,0,0,0,0,0
"Curaçao","2024-07-27",0,0,0,0,0,0,0,0
"Curaçao","2024-07-28",0,0,0,0,0,0,0,0
"Curaçao","2024-07-29",0,0,0,0,0,0,0,0
"Curaçao","2024-07-30",0,0,0,0,0,0,0,0
"Curaçao","2024-07-31",0,0,0,0,0,0,0,0
"Curaçao","2024-08-01",0,0,0,0,0,0,0,0
"Curaçao","2024-08-02",0,0,0,0,0,0,0,0
"Curaçao","2024-08-03",0,0,0,0,0,0,0,0
"Curaçao","2024-08-04",0,0,0,0,0,0,0,0
"Curaçao","2024-08-05",0,0,0,0,0,0,0,0
"Curaçao","2024-08-06",0,0,0,0,0,0,0,0
"Curaçao","2024-08-07",0,0,0,0,0,0,0,0
"Curaçao","2024-08-08",0,0,0,0,0,0,0,0
"Curaçao","2024-08-09",0,0,0,0,0,0,0,0
"Curaçao","2024-08-10",0,0,0,0,0,0,0,0
"Curaçao","2024-08-11",0,0,0,0,0,0,0,0
"Curaçao","2024-08-12",0,0,0,0,0,0,0,0
"Curaçao","2024-08-13",0,0,0,0,0,0,0,0
"Curaçao","2024-08-14",0,0,0,0,0,0,0,0
"Curaçao","2024-08-15",0,0,0,0,0,0,0,0
"Curaçao","2024-08-16",0,0,0,0,0,0,0,0
"Curaçao","2024-08-17",0,0,0,0,0,0,0,0
"Curaçao","2024-08-18",0,0,0,0,0,0,0,0
"Curaçao","2024-08-19",0,0,0,0,0,0,0,0
"Curaçao","2024-08-20",0,0,0,0,0,0,0,0
"Curaçao","2024-08-21",0,0,0,0,0,0,0,0
"Curaçao","2024-08-22",0,0,0,0,0,0,0,0
"Curaçao","2024-08-23",0,0,0,0,0,0,0,0
"Curaçao","2024-08-24",0,0,0,0,0,0,0,0
"Curaçao","2024-08-25",0,0,0,0,0,0,0,0
"Curaçao","2024-08-26",0,0,0,0,0,0,0,0
"Curaçao","2024-08-27",0,0,0,0,0,0,0,0
"Curaçao","2024-08-28",0,0,0,0,0,0,0,0
"Curaçao","2024-08-29",0,0,0,0,0,0,0,0
"Curaçao","2024-08-30",0,0,0,0,0,0,0,0
"Curaçao","2024-08-31",0,0,0,0,0,0,0,0
"Curaçao","2024-09-01",0,0,0,0,0,0,0,0
"Curaçao","2024-09-02",0,0,0,0,0,0,0,0
"Curaçao","2024-09-03",0,0,0,0,0,0,0,0
"Curaçao","2024-09-04",0,0,0,0,0,0,0,0
"Curaçao","2024-09-05",0,0,0,0,0,0,0,0
"Curaçao","2024-09-06",0,0,0,0,0,0,0,0
"Curaçao","2024-09-07",0,0,0,0,0,0,0,0
"Curaçao","2024-09-08",0,0,0,0,0,0,0,0
"Curaçao","2024-09-09",0,0,0,0,0,0,0,0
"Curaçao","2024-09-10",0,0,0,0,0,0,0,0
"Curaçao","2024-09-11",0,0,0,0,0,0,0,0
"Curaçao","2024-09-12",0,0,0,0,0,0,0,0
"Curaçao","2024-09-13",0,0,0,0,0,0,0,0
"Curaçao","2024-09-14",0,0,0,0,0,0,0,0
"Curaçao","2024-09-15",0,0,0,0,0,0,0,0
"Curaçao","2024-09-16",0,0,0,0,0,0,0,0
"Curaçao","2024-09-17",0,0,0,0,0,0,0,0
"Curaçao","2024-09-18",0,0,0,0,0,0,0,0
"Curaçao","2024-09-19",0,0,0,0,0,0,0,0
"Curaçao","2024-09-20",0,0,0,0,0,0,0,0
"Curaçao","2024-09-21",0,0,0,0,0,0,0,0
"Curaçao","2024-09-22",0,0,0,0,0,0,0,0
"Curaçao","2024-09-23",0,0,0,0,0,0,0,0
"Curaçao","2024-09-24",0,0,0,0,0,0,0,0
"Curaçao","2024-09-25",0,0,0,0,0,0,0,0
"Curaçao","2024-09-26",0,0,0,0,0,0,0,0
"Curaçao","2024-09-27",0,0,0,0,0,0,0,0
"Curaçao","2024-09-28",0,0,0,0,0,0,0,0
"Curaçao","2024-09-29",0,0,0,0,0,0,0,0
"Curaçao","2024-09-30",0,0,0,0,0,0,0,0
"Curaçao","2024-10-01",0,0,0,0,0,0,0,0
"Curaçao","2024-10-02",0,0,0,0,0,0,0,0
"Curaçao","2024-10-03",0,0,0,0,0,0,0,0
"Curaçao","2024-10-04",0,0,0,0,0,0,0,0
"Curaçao","2024-10-05",0,0,0,0,0,0,0,0
"Curaçao","2024-10-06",0,0,0,0,0,0,0,0
"Curaçao","2024-10-07",0,0,0,0,0,0,0,0
"Curaçao","2024-10-08",0,0,0,0,0,0,0,0
"Curaçao","2024-10-09",0,0,0,0,0,0,0,0
"Curaçao","2024-10-10",0,0,0,0,0,0,0,0
"Curaçao","2024-10-11",0,0,0,0,0,0,0,0
"Curaçao","2024-10-12",0,0,0,0,0,0,0,0
"Curaçao","2024-10-13",0,0,0,0,0,0,0,0
"Curaçao","2024-10-14",0,0,0,0,0,0,0,0
"Curaçao","2024-10-15",0,0,0,0,0,0,0,0
"Curaçao","2024-10-16",0,0,0,0,0,0,0,0
"Curaçao","2024-10-17",0,0,0,0,0,0,0,0
"Curaçao","2024-10-18",0,0,0,0,0,0,0,0
"Curaçao","2024-10-19",0,0,0,0,0,0,0,0
"Curaçao","2024-10-20",0,0,0,0,0,0,0,0
"Curaçao","2024-10-21",0,0,0,0,0,0,0,0
"Curaçao","2024-10-22",0,0,0,0,0,0,0,0
"Curaçao","2024-10-23",0,0,0,0,0,0,0,0
"Curaçao","2024-10-24",0,0,0,0,0,0,0,0
"Curaçao","2024-10-25",0,0,0,0,0,0,0,0
"Curaçao","2024-10-26",0,0,0,0,0,0,0,0
"Curaçao","2024-10-27",0,0,0,0,0,0,0,0
"Curaçao","2024-10-28",0,0,0,0,0,0,0,0
"Curaçao","2024-10-29",0,0,0,0,0,0,0,0
"Curaçao","2024-10-30",0,0,0,0,0,0,0,0
"Curaçao","2024-10-31",0,0,0,0,0,0,0,0
"Curaçao","2024-11-01",0,0,0,0,0,0,0,0
"Curaçao","2024-11-02",0,0,0,0,0,0,0,0
"Curaçao","2024-11-03",0,0,0,0,0,0,0,0
"Curaçao","2024-11-04",0,0,0,0,0,0,0,0
"Curaçao","2024-11-05",0,0,0,0,0,0,0,0
"Curaçao","2024-11-06",0,0,0,0,0,0,0,0
"Curaçao","2024-11-07",0,0,0,0,0,0,0,0
"Curaçao","2024-11-08",0,0,0,0,0,0,0,0
"Curaçao","2024-11-09",0,0,0,0,0,0,0,0
"Curaçao","2024-11-10",0,0,0,0,0,0,0,0
"Curaçao","2024-11-11",0,0,0,0,0,0,0,0
"Curaçao","2024-11-12",0,0,0,0,0,0,0,0
"Curaçao","2024-11-13",0,0,0,0,0,0,0,0
"Curaçao","2024-11-14",0,0,0,0,0,0,0,0
"Curaçao","2024-11-15",0,0,0,0,0,0,0,0
"Curaçao","2024-11-16",0,0,0,0,0,0,0,0
"Curaçao","2024-11-17",0,0,0,0,0,0,0,0
"Curaçao","2024-11-18",0,0,0,0,0,0,0,0
"Curaçao","2024-11-19",0,0,0,0,0,0,0,0
"Curaçao","2024-11-20",0,0,0,0,0,0,0,0
"Curaçao","2024-11-21",0,0,0,0,0,0,0,0
"Curaçao","2024-11-22",0,0,0,0,0,0,0,0
"Curaçao","2024-11-23",0,0,0,0,0,0,0,0
"Curaçao","2024-11-24",0,0,0,0,0,0,0,0
"Curaçao","2024-11-25",0,0,0,0,0,0,0,0
"Curaçao","2024-11-26",0,0,0,0,0,0,0,0
"Curaçao","2024-11-27",0,0,0,0,0,0,0,0
"Curaçao","2024-11-28",0,0,0,0,0,0,0,0
"Curaçao","2024-11-29",0,0,0,0,0,0,0,0
"Curaçao","2024-11-30",0,0,0,0,0,0,0,0
"Curaçao","2024-12-01",0,0,0,0,0,0,0,0
"Curaçao","2024-12-02",0,0,0,0,0,0,0,0
"Curaçao","2024-12-03",0,0,0,0,0,0,0,0
"Curaçao","2024-12-04",0,0,0,0,0,0,0,0
"Curaçao","2024-12-05",0,0,0,0,0,0,0,0
"Curaçao","2024-12-06",0,0,0,0,0,0,0,0
"Curaçao","2024-12-07",0,0,0,0,0,0,0,0
"Curaçao","2024-12-08",0,0,0,0,0,0,0,0
"Curaçao","2024-12-09",0,0,0,0,0,0,0,0
"Curaçao","2024-12-10",0,0,0,0,0,0,0,0
"Curaçao","2024-12-11",0,0,0,0,0,0,0,0
"Curaçao","2024-12-12",0,0,0,0,0,0,0,0
"Curaçao","2024-12-13",0,0,0,0,0,0,0,0
"Curaçao","2024-12-14",0,0,0,0,0,0,0,0
"Curaçao","2024-12-15",0,0,0,0,0,0,0,0
"Curaçao","2024-12-16",0,0,0,0,0,0,0,0
"Curaçao","2024-12-17",0,0,0,0,0,0,0,0
"Curaçao","2024-12-18",0,0,0,0,0,0,0,0
"Curaçao","2024-12-19",0,0,0,0,0,0,0,0
"Curaçao","2024-12-20",0,0,0,0,0,0,0,0
"Curaçao","2024-12-21",0,0,0,0,0,0,0,0
"Curaçao","2024-12-22",0,0,0,0,0,0,0,0
"Curaçao","2024-12-23",0,0,0,0,0,0,0,0
"Curaçao","2024-12-24",0,0,0,0,0,0,0,0
"Curaçao","2024-12-25",0,0,0,0,0,0,0,0
"Curaçao","2024-12-26",0,0,0,0,0,0,0,0
"Curaçao","2024-12-27",0,0,0,0,0,0,0,0
"Curaçao","2024-12-28",0,0,0,0,0,0,0,0
"Curaçao","2024-12-29",0,0,0,0,0,0,0,0
"Curaçao","2024-12-30",0,0,0,0,0,0,0,0
"Curaçao","2024-12-31",0,0,0,0,0,0,0,0
"Curaçao","2025-01-01",0,0,0,0,0,0,0,0
"Curaçao","2025-01-02",0,0,0,0,0,0,0,0
"Curaçao","2025-01-03",0,0,0,0,0,0,0,0
"Curaçao","2025-01-04",0,0,0,0,0,0,0,0
"Curaçao","2025-01-05",0,0,0,0,0,0,0,0
"Curaçao","2025-01-06",0,0,0,0,0,0,0,0
"Curaçao","2025-01-07",0,0,0,0,0,0,0,0
"Curaçao","2025-01-08",0,0,0,0,0,0,0,0
"Curaçao","2025-01-09",0,0,0,0,0,0,0,0
"Curaçao","2025-01-10",0,0,0,0,0,0,0,0
"Curaçao","2025-01-11",0,0,0,0,0,0,0,0
"Curaçao","2025-01-12",0,0,0,0,0,0,0,0
"Curaçao","2025-01-13",0,0,0,0,0,0,0,0
"Curaçao","2025-01-14",0,0,0,0,0,0,0,0
"Curaçao","2025-01-15",0,0,0,0,0,0,0,0
"Curaçao","2025-01-16",0,0,0,0,0,0,0,0
"Curaçao","2025-01-17",0,0,0,0,0,0,0,0
"Curaçao","2025-01-18",0,0,0,0,0,0,0,0
"Curaçao","2025-01-19",0,0,0,0,0,0,0,0
"Curaçao","2025-01-20",0,0,0,0,0,0,0,0
"Curaçao","2025-01-21",0,0,0,0,0,0,0,0
"Curaçao","2025-01-22",0,0,0,0,0,0,0,0
"Curaçao","2025-01-23",0,0,0,0,0,0,0,0
"Curaçao","2025-01-24",0,0,0,0,0,0,0,0
"Curaçao","2025-01-25",0,0,0,0,0,0,0,0
"Curaçao","2025-01-26",0,0,0,0,0,0,0,0
"Curaçao","2025-01-27",0,0,0,0,0,0,0,0
"Curaçao","2025-01-28",0,0,0,0,0,0,0,0
"Curaçao","2025-01-29",0,0,0,0,0,0,0,0
"Curaçao","2025-01-30",0,0,0,0,0,0,0,0
"Curaçao","2025-01-31",0,0,0,0,0,0,0,0
"Curaçao","2025-02-01",0,0,0,0,0,0,0,0
"Curaçao","2025-02-02",0,0,0,0,0,0,0,0
"Curaçao","2025-02-03",0,0,0,0,0,0,0,0
"Curaçao","2025-02-04",0,0,0,0,0,0,0,0
"Curaçao","2025-02-05",0,0,0,0,0,0,0,0
"Curaçao","2025-02-06",0,0,0,0,0,0,0,0
"Curaçao","2025-02-07",0,0,0,0,0,0,0,0
"Curaçao","2025-02-08",0,0,0,0,0,0,0,0
"Curaçao","2025-02-09",0,0,0,0,0,0,0,0
"Curaçao","2025-02-10",0,0,0,0,0,0,0,0
"Curaçao","2025-02-11",0,0,0,0,0,0,0,0
"Curaçao","2025-02-12",0,0,0,0,0,0,0,0
"Curaçao","2025-02-13",0,0,0,0,0,0,0,0
"Curaçao","2025-02-14",0,0,0,0,0,0,0,0
"Curaçao","2025-02-15",0,0,0,0,0,0,0,0
"Curaçao","2025-02-16",0,0,0,0,0,0,0,0
"Curaçao","2025-02-17",0,0,0,0,0,0,0,0
"Curaçao","2025-02-18",0,0,0,0,0,0,0,0
"Curaçao","2025-02-19",0,0,0,0,0,0,0,0
"Curaçao","2025-02-20",0,0,0,0,0,0,0,0
"Curaçao","2025-02-21",0,0,0,0,0,0,0,0
"Curaçao","2025-02-22",0,0,0,0,0,0,0,0
"Curaçao","2025-02-23",0,0,0,0,0,0,0,0
"Curaçao","2025-02-24",0,0,0,0,0,0,0,0
"Curaçao","2025-02-25",0,0,0,0,0,0,0,0
"Curaçao","2025-02-26",0,0,0,0,0,0,0,0
"Curaçao","2025-02-27",0,0,0,0,0,0,0,0
"Curaçao","2025-02-28",0,0,0,0,0,0,0,0
"Curaçao","2025-03-01",0,0,0,0,0,0,0,0
"Curaçao","2025-03-02",0,0,0,0,0,0,0,0
"Curaçao","2025-03-03",0,0,0,0,0,0,0,0
"Cyprus","2024-01-01",0,0,0,0,0,0,0,0
"Cyprus","2024-01-02",0,0,0,0,0,0,0,0
"Cyprus","2024-01-03",0,0,0,0,0,0,0,0
"Cyprus","2024-01-04",0,0,0,0,0,0,0,0
"Cyprus","2024-01-05",0,0,0,0,0,0,0,0
"Cyprus","2024-01-06",0,0,0,0,0,0,0,0
"Cyprus","2024-01-07",0,0,0,0,0,0,0,0
"Cyprus","2024-01-08",0,0,0,0,0,0,0,0
"Cyprus","2024-01-09",0,0,0,0,0,0,0,0
"Cyprus","2024-01-10",0,0,0,0,0,0,0,0
"Cyprus","2024-01-11",0,0,0,0,0,0,0,0
"Cyprus","2024-01-12",0,0,0,0,0,0,0,0
"Cyprus","2024-01-13",0,0,0,0,0,0,0,0
"Cyprus","2024-01-14",0,0,0,0,0,0,0,0
"Cyprus","2024-01-15",0,0,0,0,0,0,0,0
"Cyprus","2024-01-16",0,0,0,0,0,0,0,0
"Cyprus","2024-01-17",0,0,0,0,0,0,0,0
"Cyprus","2024-01-18",0,0,0,0,0,0,0,0
"Cyprus","2024-01-19",0,0,0,0,0,0,0,0
"Cyprus","2024-01-20",0,0,0,0,0,0,0,0
"Cyprus","2024-01-21",0,0,0,0,0,0,0,0
"Cyprus","2024-01-22",0,0,0,0,0,0,0,0
"Cyprus","2024-01-23",0,0,0,0,0,0,0,0
"Cyprus","2024-01-24",0,0,0,0,0,0,0,0
"Cyprus","2024-01-25",0,0,0,0,0,0,0,0
"Cyprus","2024-01-26",0,0,0,0,0,0,0,0
"Cyprus","2024-01-27",0,0,0,0,0,0,0,0
"Cyprus","2024-01-28",0,0,0,0,0,0,0,0
"Cyprus","2024-01-29",0,0,0,0,0,0,0,0
"Cyprus","2024-01-30",0,0,0,0,0,0,0,0
"Cyprus","2024-01-31",0,0,0,0,0,0,0,0
"Cyprus","2024-02-01",0,0,0,0,0,0,0,0
"Cyprus","2024-02-02",0,0,0,0,0,0,0,0
"Cyprus","2024-02-03",0,0,0,0,0,0,0,0
"Cyprus","2024-02-04",0,0,0,0,0,0,0,0
"Cyprus","2024-02-05",0,0,0,0,0,0,0,0
"Cyprus","2024-02-06",0,0,0,0,0,0,0,0
"Cyprus","2024-02-07",0,0,0,0,0,0,0,0
"Cyprus","2024-02-08",0,0,0,0,0,0,0,0
"Cyprus","2024-02-09",0,0,0,0,0,0,0,0
"Cyprus","2024-02-10",0,0,0,0,0,0,0,0
"Cyprus","2024-02-11",0,0,0,0,0,0,0,0
"Cyprus","2024-02-12",0,0,0,0,0,0,0,0
"Cyprus","2024-02-13",0,0,0,0,0,0,0,0
"Cyprus","2024-02-14",0,0,0,0,0,0,0,0
"Cyprus","2024-02-15",0,0,0,0,0,0,0,0
"Cyprus","2024-02-16",0,0,0,0,0,0,0,0
"Cyprus","2024-02-17",0,0,0,0,0,0,0,0
"Cyprus","2024-02-18",0,0,0,0,0,0,0,0
"Cyprus","2024-02-19",0,0,0,0,0,0,0,0
"Cyprus","2024-02-20",0,0,0,0,0,0,0,0
"Cyprus","2024-02-21",0,0,0,0,0,0,0,0
"Cyprus","2024-02-22",0,0,0,0,0,0,0,0
"Cyprus","2024-02-23",0,0,0,0,0,0,0,0
"Cyprus","2024-02-24",0,0,0,0,0,0,0,0
"Cyprus","2024-02-25",0,0,0,0,0,0,0,0
"Cyprus","2024-02-26",0,0,0,0,0,0,0,0
"Cyprus","2024-02-27",0,0,0,0,0,0,0,0
"Cyprus","2024-02-28",0,0,0,0,0,0,0,0
"Cyprus","2024-02-29",0,0,0,0,0,0,0,0
"Cyprus","2024-03-01",0,0,0,0,0,0,0,0
"Cyprus","2024-03-02",0,0,0,0,0,0,0,0
"Cyprus","2024-03-03",0,0,0,0,0,0,0,0
"Cyprus","2024-03-04",0,0,0,0,0,0,0,0
"Cyprus","2024-03-05",0,0,0,0,0,0,0,0
"Cyprus","2024-03-06",0,0,0,0,0,0,0,0
"Cyprus","2024-03-07",0,0,0,0,0,0,0,0
"Cyprus","2024-03-08",0,0,0,0,0,0,0,0
"Cyprus","2024-03-09",0,0,0,0,0,0,0,0
"Cyprus","2024-03-10",0,0,0,0,0,0,0,0
"Cyprus","2024-03-11",0,0,0,0,0,0,0,0
"Cyprus","2024-03-12",0,0,0,0,0,0,0,0
"Cyprus","2024-03-13",0,0,0,0,0,0,0,0
"Cyprus","2024-03-14",0,0,0,0,0,0,0,0
"Cyprus","2024-03-15",0,0,0,0,0,0,0,0
"Cyprus","2024-03-16",0,0,0,0,0,0,0,0
"Cyprus","2024-03-17",0,0,0,0,0,0,0,0
"Cyprus","2024-03-18",0,0,0,0,0,0,0,0
"Cyprus","2024-03-19",0,0,0,0,0,0,0,0
"Cyprus","2024-03-20",0,0,0,0,0,0,0,0
"Cyprus","2024-03-21",0,0,0,0,0,0,0,0
"Cyprus","2024-03-22",0,0,0,0,0,0,0,0
"Cyprus","2024-03-23",0,0,0,0,0,0,0,0
"Cyprus","2024-03-24",0,0,0,0,0,0,0,0
"Cyprus","2024-03-25",0,0,0,0,0,0,0,0
"Cyprus","2024-03-26",0,0,0,0,0,0,0,0
"Cyprus","2024-03-27",0,0,0,0,0,0,0,0
"Cyprus","2024-03-28",0,0,0,0,0,0,0,0
"Cyprus","2024-03-29",0,0,0,0,0,0,0,0
"Cyprus","2024-03-30",0,0,0,0,0,0,0,0
"Cyprus","2024-03-31",0,0,0,0,0,0,0,0
"Cyprus","2024-04-01",0,0,0,0,0,0,0,0
"Cyprus","2024-04-02",0,0,0,0,0,0,0,0
"Cyprus","2024-04-03",0,0,0,0,0,0,0,0
"Cyprus","2024-04-04",0,0,0,0,0,0,0,0
"Cyprus","2024-04-05",0,0,0,0,0,0,0,0
"Cyprus","2024-04-06",0,0,0,0,0,0,0,0
"Cyprus","2024-04-07",0,0,0,0,0,0,0,0
"Cyprus","2024-04-08",0,0,0,0,0,0,0,0
"Cyprus","2024-04-09",0,0,0,0,0,0,0,0
"Cyprus","2024-04-10",0,0,0,0,0,0,0,0
"Cyprus","2024-04-11",0,0,0,0,0,0,0,0
"Cyprus","2024-04-12",0,0,0,0,0,0,0,0
"Cyprus","2024-04-13",0,0,0,0,0,0,0,0
"Cyprus","2024-04-14",0,0,0,0,0,0,0,0
"Cyprus","2024-04-15",0,0,0,0,0,0,0,0
"Cyprus","2024-04-16",0,0,0,0,0,0,0,0
"Cyprus","2024-04-17",0,0,0,0,0,0,0,0
"Cyprus","2024-04-18",0,0,0,0,0,0,0,0
"Cyprus","2024-04-19",0,0,0,0,0,0,0,0
"Cyprus","2024-04-20",0,0,0,0,0,0,0,0
"Cyprus","2024-04-21",0,0,0,0,0,0,0,0
"Cyprus","2024-04-22",0,0,0,0,0,0,0,0
"Cyprus","2024-04-23",0,0,0,0,0,0,0,0
"Cyprus","2024-04-24",0,0,0,0,0,0,0,0
"Cyprus","2024-04-25",0,0,0,0,0,0,0,0
"Cyprus","2024-04-26",0,0,0,0,0,0,0,0
"Cyprus","2024-04-27",0,0,0,0,0,0,0,0
"Cyprus","2024-04-28",0,0,0,0,0,0,0,0
"Cyprus","2024-04-29",0,0,0,0,0,0,0,0
"Cyprus","2024-04-30",0,0,0,0,0,0,0,0
"Cyprus","2024-05-01",0,0,0,0,0,0,0,0
"Cyprus","2024-05-02",0,0,0,0,0,0,0,0
"Cyprus","2024-05-03",0,0,0,0,0,0,0,0
"Cyprus","2024-05-04",0,0,0,0,0,0,0,0
"Cyprus","2024-05-05",0,0,0,0,0,0,0,0
"Cyprus","2024-05-06",0,0,0,0,0,0,0,0
"Cyprus","2024-05-07",0,0,0,0,0,0,0,0
"Cyprus","2024-05-08",0,0,0,0,0,0,0,0
"Cyprus","2024-05-09",0,0,0,0,0,0,0,0
"Cyprus","2024-05-10",0,0,0,0,0,0,0,0
"Cyprus","2024-05-11",0,0,0,0,0,0,0,0
"Cyprus","2024-05-12",0,0,0,0,0,0,0,0
"Cyprus","2024-05-13",0,0,0,0,0,0,0,0
"Cyprus","2024-05-14",0,0,0,0,0,0,0,0
"Cyprus","2024-05-15",0,0,0,0,0,0,0,0
"Cyprus","2024-05-16",0,0,0,0,0,0,0,0
"Cyprus","2024-05-17",0,0,0,0,0,0,0,0
"Cyprus","2024-05-18",0,0,0,0,0,0,0,0
"Cyprus","2024-05-19",0,0,0,0,0,0,0,0
"Cyprus","2024-05-20",0,0,0,0,0,0,0,0
"Cyprus","2024-05-21",0,0,0,0,0,0,0,0
"Cyprus","2024-05-22",0,0,0,0,0,0,0,0
"Cyprus","2024-05-23",0,0,0,0,0,0,0,0
"Cyprus","2024-05-24",0,0,0,0,0,0,0,0
"Cyprus","2024-05-25",0,0,0,0,0,0,0,0
"Cyprus","2024-05-26",0,0,0,0,0,0,0,0
"Cyprus","2024-05-27",0,0,0,0,0,0,0,0
"Cyprus","2024-05-28",0,0,0,0,0,0,0,0
"Cyprus","2024-05-29",0,0,0,0,0,0,0,0
"Cyprus","2024-05-30",0,0,0,0,0,0,0,0
"Cyprus","2024-05-31",0,0,0,0,0,0,0,0
"Cyprus","2024-06-01",0,0,0,0,0,0,0,0
"Cyprus","2024-06-02",0,0,0,0,0,0,0,0
"Cyprus","2024-06-03",0,0,0,0,0,0,0,0
"Cyprus","2024-06-04",0,0,0,0,0,0,0,0
"Cyprus","2024-06-05",0,0,0,0,0,0,0,0
"Cyprus","2024-06-06",0,0,0,0,0,0,0,0
"Cyprus","2024-06-07",0,0,0,0,0,0,0,0
"Cyprus","2024-06-08",0,0,0,0,0,0,0,0
"Cyprus","2024-06-09",0,0,0,0,0,0,0,0
"Cyprus","2024-06-10",0,0,0,0,0,0,0,0
"Cyprus","2024-06-11",0,0,0,0,0,0,0,0
"Cyprus","2024-06-12",0,0,0,0,0,0,0,0
"Cyprus","2024-06-13",0,0,0,0,0,0,0,0
"Cyprus","2024-06-14",0,0,0,0,0,0,0,0
"Cyprus","2024-06-15",0,0,0,0,0,0,0,0
"Cyprus","2024-06-16",0,0,0,0,0,0,0,0
"Cyprus","2024-06-17",0,0,0,0,0,0,0,0
"Cyprus","2024-06-18",0,0,0,0,0,0,0,0
"Cyprus","2024-06-19",0,0,0,0,0,0,0,0
"Cyprus","2024-06-20",0,0,0,0,0,0,0,0
"Cyprus","2024-06-21",0,0,0,0,0,0,0,0
"Cyprus","2024-06-22",0,0,0,0,0,0,0,0
"Cyprus","2024-06-23",0,0,0,0,0,0,0,0
"Cyprus","2024-06-24",0,0,0,0,0,0,0,0
"Cyprus","2024-06-25",0,0,0,0,0,0,0,0
"Cyprus","2024-06-26",0,0,0,0,0,0,0,0
"Cyprus","2024-06-27",0,0,0,0,0,0,0,0
"Cyprus","2024-06-28",0,0,0,0,0,0,0,0
"Cyprus","2024-06-29",0,0,0,0,0,0,0,0
"Cyprus","2024-06-30",0,0,0,0,0,0,0,0
"Cyprus","2024-07-01",0,0,0,0,0,0,0,0
"Cyprus","2024-07-02",0,0,0,0,0,0,0,0
"Cyprus","2024-07-03",0,0,0,0,0,0,0,0
"Cyprus","2024-07-04",0,0,0,0,0,0,0,0
"Cyprus","2024-07-05",0,0,0,0,0,0,0,0
"Cyprus","2024-07-06",0,0,0,0,0,0,0,0
"Cyprus","2024-07-07",0,0,0,0,0,0,0,0
"Cyprus","2024-07-08",0,0,0,0,0,0,0,0
"Cyprus","2024-07-09",0,0,0,0,0,0,0,0
"Cyprus","2024-07-10",0,0,0,0,0,0,0,0
"Cyprus","2024-07-11",0,0,0,0,0,0,0,0
"Cyprus","2024-07-12",0,0,0,0,0,0,0,0
"Cyprus","2024-07-13",0,0,0,0,0,0,0,0
"Cyprus","2024-07-14",0,0,0,0,0,0,0,0
"Cyprus","2024-07-15",0,0,0,0,0,0,0,0
"Cyprus","2024-07-16",0,0,0,0,0,0,0,0
"Cyprus","2024-07-17",0,0,0,0,0,0,0,0
"Cyprus","2024-07-18",0,0,0,0,0,0,0,0
"Cyprus","2024-07-19",0,0,0,0,0,0,0,0
"Cyprus","2024-07-20",0,0,0,0,0,0,0,0
"Cyprus","2024-07-21",0,0,0,0,0,0,0,0
"Cyprus","2024-07-22",0,0,0,0,0,0,0,0
"Cyprus","2024-07-23",0,0,0,0,0,0,0,0
"Cyprus","2024-07-24",0,0,0,0,0,0,0,0
"Cyprus","2024-07-25",0,0,0,0,0,0,0,0
"Cyprus","2024-07-26",0,0,0,0,0,0,0,0
"Cyprus","2024-07-27",0,0,0,0,0,0,0,0
"Cyprus","2024-07-28",0,0,0,0,0,0,0,0
"Cyprus","2024-07-29",0,0,0,0,0,0,0,0
"Cyprus","2024-07-30",0,0,0,0,0,0,0,0
"Cyprus","2024-07-31",0,0,0,0,0,0,0,0
"Cyprus","2024-08-01",0,0,0,0,0,0,0,0
"Cyprus","2024-08-02",0,0,0,0,0,0,0,0
"Cyprus","2024-08-03",0,0,0,0,0,0,0,0
"Cyprus","2024-08-04",0,0,0,0,0,0,0,0
"Cyprus","2024-08-05",0,0,0,0,0,0,0,0
"Cyprus","2024-08-06",0,0,0,0,0,0,0,0
"Cyprus","2024-08-07",0,0,0,0,0,0,0,0
"Cyprus","2024-08-08",0,0,0,0,0,0,0,0
"Cyprus","2024-08-09",0,0,0,0,0,0,0,0
"Cyprus","2024-08-10",0,0,0,0,0,0,0,0
"Cyprus","2024-08-11",0,0,0,0,0,0,0,0
"Cyprus","2024-08-12",0,0,0,0,0,0,0,0
"Cyprus","2024-08-13",0,0,0,0,0,0,0,0
"Cyprus","2024-08-14",0,0,0,0,0,0,0,0
"Cyprus","2024-08-15",0,0,0,0,0,0,0,0
"Cyprus","2024-08-16",0,0,0,0,0,0,0,0
"Cyprus","2024-08-17",0,0,0,0,0,0,0,0
"Cyprus","2024-08-18",0,0,0,0,0,0,0,0
"Cyprus","2024-08-19",0,0,0,0,0,0,0,0
"Cyprus","2024-08-20",0,0,0,0,0,0,0,0
"Cyprus","2024-08-21",0,0,0,0,0,0,0,0
"Cyprus","2024-08-22",0,0,0,0,0,0,0,0
"Cyprus","2024-08-23",0,0,0,0,0,0,0,0
"Cyprus","2024-08-24",0,0,0,0,0,0,0,0
"Cyprus","2024-08-25",0,0,0,0,0,0,0,0
"Cyprus","2024-08-26",0,0,0,0,0,0,0,0
"Cyprus","2024-08-27",0,0,0,0,0,0,0,0
"Cyprus","2024-08-28",0,0,0,0,0,0,0,0
"Cyprus","2024-08-29",0,0,0,0,0,0,0,0
"Cyprus","2024-08-30",0,0,0,0,0,0,0,0
"Cyprus","2024-08-31",0,0,0,0,0,0,0,0
"Cyprus","2024-09-01",0,0,0,0,0,0,0,0
"Cyprus","2024-09-02",0,0,0,0,0,0,0,0
"Cyprus","2024-09-03",0,0,0,0,0,0,0,0
"Cyprus","2024-09-04",0,0,0,0,0,0,0,0
"Cyprus","2024-09-05",0,0,0,0,0,0,0,0
"Cyprus","2024-09-06",0,0,0,0,0,0,0,0
"Cyprus","2024-09-07",0,0,0,0,0,0,0,0
"Cyprus","2024-09-08",0,0,0,0,0,0,0,0
"Cyprus","2024-09-09",0,0,0,0,0,0,0,0
"Cyprus","2024-09-10",0,0,0,0,0,0,0,0
"Cyprus","2024-09-11",0,0,0,0,0,0,0,0
"Cyprus","2024-09-12",0,0,0,0,0,0,0,0
"Cyprus","2024-09-13",0,0,0,0,0,0,0,0
"Cyprus","2024-09-14",0,0,0,0,0,0,0,0
"Cyprus","2024-09-15",0,0,0,0,0,0,0,0
"Cyprus","2024-09-16",0,0,0,0,0,0,0,0
"Cyprus","2024-09-17",0,0,0,0,0,0,0,0
"Cyprus","2024-09-18",0,0,0,0,0,0,0,0
"Cyprus","2024-09-19",0,0,0,0,0,0,0,0
"Cyprus","2024-09-20",0,0,0,0,0,0,0,0
"Cyprus","2024-09-21",0,0,0,0,0,0,0,0
"Cyprus","2024-09-22",0,0,0,0,0,0,0,0
"Cyprus","2024-09-23",0,0,0,0,0,0,0,0
"Cyprus","2024-09-24",0,0,0,0,0,0,0,0
"Cyprus","2024-09-25",0,0,0,0,0,0,0,0
"Cyprus","2024-09-26",0,0,0,0,0,0,0,0
"Cyprus","2024-09-27",0,0,0,0,0,0,0,0
"Cyprus","2024-09-28",0,0,0,0,0,0,0,0
"Cyprus","2024-09-29",0,0,0,0,0,0,0,0
"Cyprus","2024-09-30",0,0,0,0,0,0,0,0
"Cyprus","2024-10-01",0,0,0,0,0,0,0,0
"Cyprus","2024-10-02",0,0,0,0,0,0,0,0
"Cyprus","2024-10-03",0,0,0,0,0,0,0,0
"Cyprus","2024-10-04",0,0,0,0,0,0,0,0
"Cyprus","2024-10-05",0,0,0,0,0,0,0,0
"Cyprus","2024-10-06",0,0,0,0,0,0,0,0
"Cyprus","2024-10-07",0,0,0,0,0,0,0,0
"Cyprus","2024-10-08",0,0,0,0,0,0,0,0
"Cyprus","2024-10-09",0,0,0,0,0,0,0,0
"Cyprus","2024-10-10",0,0,0,0,0,0,0,0
"Cyprus","2024-10-11",0,0,0,0,0,0,0,0
"Cyprus","2024-10-12",0,0,0,0,0,0,0,0
"Cyprus","2024-10-13",0,0,0,0,0,0,0,0
"Cyprus","2024-10-14",0,0,0,0,0,0,0,0
"Cyprus","2024-10-15",0,0,0,0,0,0,0,0
"Cyprus","2024-10-16",0,0,0,0,0,0,0,0
"Cyprus","2024-10-17",0,0,0,0,0,0,0,0
"Cyprus","2024-10-18",0,0,0,0,0,0,0,0
"Cyprus","2024-10-19",0,0,0,0,0,0,0,0
"Cyprus","2024-10-20",0,0,0,0,0,0,0,0
"Cyprus","2024-10-21",0,0,0,0,0,0,0,0
"Cyprus","2024-10-22",0,0,0,0,0,0,0,0
"Cyprus","2024-10-23",0,0,0,0,0,0,0,0
"Cyprus","2024-10-24",0,0,0,0,0,0,0,0
"Cyprus","2024-10-25",0,0,0,0,0,0,0,0
"Cyprus","2024-10-26",0,0,0,0,0,0,0,0
"Cyprus","2024-10-27",0,0,0,0,0,0,0,0
"Cyprus","2024-10-28",0,0,0,0,0,0,0,0
"Cyprus","2024-10-29",0,0,0,0,0,0,0,0
"Cyprus","2024-10-30",0,0,0,0,0,0,0,0
"Cyprus","2024-10-31",0,0,0,0,0,0,0,0
"Cyprus","2024-11-01",0,0,0,0,0,0,0,0
"Cyprus","2024-11-02",0,0,0,0,0,0,0,0
"Cyprus","2024-11-03",0,0,0,0,0,0,0,0
"Cyprus","2024-11-04",0,0,0,0,0,0,0,0
"Cyprus","2024-11-05",0,0,0,0,0,0,0,0
"Cyprus","2024-11-06",0,0,0,0,0,0,0,0
"Cyprus","2024-11-07",0,0,0,0,0,0,0,0
"Cyprus","2024-11-08",0,0,0,0,0,0,0,0
"Cyprus","2024-11-09",0,0,0,0,0,0,0,0
"Cyprus","2024-11-10",0,0,0,0,0,0,0,0
"Cyprus","2024-11-11",0,0,0,0,0,0,0,0
"Cyprus","2024-11-12",0,0,0,0,0,0,0,0
"Cyprus","2024-11-13",0,0,0,0,0,0,0,0
"Cyprus","2024-11-14",0,0,0,0,0,0,0,0
"Cyprus","2024-11-15",0,0,0,0,0,0,0,0
"Cyprus","2024-11-16",0,0,0,0,0,0,0,0
"Cyprus","2024-11-17",0,0,0,0,0,0,0,0
"Cyprus","2024-11-18",0,0,0,0,0,0,0,0
"Cyprus","2024-11-19",0,0,0,0,0,0,0,0
"Cyprus","2024-11-20",0,0,0,0,0,0,0,0
"Cyprus","2024-11-21",0,0,0,0,0,0,0,0
"Cyprus","2024-11-22",0,0,0,0,0,0,0,0
"Cyprus","2024-11-23",0,0,0,0,0,0,0,0
"Cyprus","2024-11-24",0,0,0,0,0,0,0,0
"Cyprus","2024-11-25",0,0,0,0,0,0,0,0
"Cyprus","2024-11-26",0,0,0,0,0,0,0,0
"Cyprus","2024-11-27",0,0,0,0,0,0,0,0
"Cyprus","2024-11-28",0,0,0,0,0,0,0,0
"Cyprus","2024-11-29",0,0,0,0,0,0,0,0
"Cyprus","2024-11-30",0,0,0,0,0,0,0,0
"Cyprus","2024-12-01",0,0,0,0,0,0,0,0
"Cyprus","2024-12-02",0,0,0,0,0,0,0,0
"Cyprus","2024-12-03",0,0,0,0,0,0,0,0
"Cyprus","2024-12-04",0,0,0,0,0,0,0,0
"Cyprus","2024-12-05",0,0,0,0,0,0,0,0
"Cyprus","2024-12-06",0,0,0,0,0,0,0,0
"Cyprus","2024-12-07",0,0,0,0,0,0,0,0
"Cyprus","2024-12-08",0,0,0,0,0,0,0,0
"Cyprus","2024-12-09",0,0,0,0,0,0,0,0
"Cyprus","2024-12-10",0,0,0,0,0,0,0,0
"Cyprus","2024-12-11",0,0,0,0,0,0,0,0
"Cyprus","2024-12-12",0,0,0,0,0,0,0,0
"Cyprus","2024-12-13",0,0,0,0,0,0,0,0
"Cyprus","2024-12-14",0,0,0,0,0,0,0,0
"Cyprus","2024-12-15",0,0,0,0,0,0,0,0
"Cyprus","2024-12-16",0,0,0,0,0,0,0,0
"Cyprus","2024-12-17",0,0,0,0,0,0,0,0
"Cyprus","2024-12-18",0,0,0,0,0,0,0,0
"Cyprus","2024-12-19",0,0,0,0,0,0,0,0
"Cyprus","2024-12-20",0,0,0,0,0,0,0,0
"Cyprus","2024-12-21",0,0,0,0,0,0,0,0
"Cyprus","2024-12-22",0,0,0,0,0,0,0,0
"Cyprus","2024-12-23",0,0,0,0,0,0,0,0
"Cyprus","2024-12-24",0,0,0,0,0,0,0,0
"Cyprus","2024-12-25",0,0,0,0,0,0,0,0
"Cyprus","2024-12-26",0,0,0,0,0,0,0,0
"Cyprus","2024-12-27",0,0,0,0,0,0,0,0
"Cyprus","2024-12-28",0,0,0,0,0,0,0,0
"Cyprus","2024-12-29",0,0,0,0,0,0,0,0
"Cyprus","2024-12-30",0,0,0,0,0,0,0,0
"Cyprus","2024-12-31",0,1,1,0,1,1,0,0
"Cyprus","2025-01-01",0,0,1,0,0,1,0,0
"Cyprus","2025-01-02",0,0,1,0,0,1,0,0
"Cyprus","2025-01-03",0,0,1,0,0,1,0,0
"Cyprus","2025-01-04",0,0,1,0,0,1,0,0
"Cyprus","2025-01-05",0,0,1,0,0,1,0,0
"Cyprus","2025-01-06",0,0,1,0,0,1,0,0
"Cyprus","2025-01-07",0,0,1,0,0,1,0,0
"Cyprus","2025-01-08",0,0,1,0,0,1,0,0
"Cyprus","2025-01-09",0,0,1,0,0,1,0,0
"Cyprus","2025-01-10",0,0,1,0,0,1,0,0
"Cyprus","2025-01-11",0,0,1,0,0,1,0,0
"Cyprus","2025-01-12",0,0,1,0,0,1,0,0
"Cyprus","2025-01-13",0,0,1,0,0,1,0,0
"Cyprus","2025-01-14",0,0,1,0,0,1,0,0
"Cyprus","2025-01-15",0,0,1,0,0,1,0,0
"Cyprus","2025-01-16",0,0,1,0,0,1,0,0
"Cyprus","2025-01-17",0,0,1,0,0,1,0,0
"Cyprus","2025-01-18",0,0,1,0,0,1,0,0
"Cyprus","2025-01-19",0,0,1,0,0,1,0,0
"Cyprus","2025-01-20",0,0,1,0,0,1,0,0
"Cyprus","2025-01-21",0,0,1,0,0,1,0,0
"Cyprus","2025-01-22",0,0,1,0,0,1,0,0
"Cyprus","2025-01-23",0,0,1,0,0,1,0,0
"Cyprus","2025-01-24",0,0,1,0,0,1,0,0
"Cyprus","2025-01-25",0,0,1,0,0,1,0,0
"Cyprus","2025-01-26",0,0,1,0,0,1,0,0
"Cyprus","2025-01-27",0,0,1,0,0,1,0,0
"Cyprus","2025-01-28",0,0,1,0,0,1,0,0
"Cyprus","2025-01-29",0,0,1,0,0,1,0,0
"Cyprus","2025-01-30",0,0,1,0,0,1,0,0
"Cyprus","2025-01-31",0,0,1,0,0,1,0,0
"Cyprus","2025-02-01",0,0,1,0,0,1,0,0
"Cyprus","2025-02-02",0,0,1,0,0,1,0,0
"Cyprus","2025-02-03",0,0,1,0,0,1,0,0
"Cyprus","2025-02-04",0,0,1,0,0,1,0,0
"Cyprus","2025-02-05",0,0,1,0,0,1,0,0
"Cyprus","2025-02-06",0,0,1,0,0,1,0,0
"Cyprus","2025-02-07",0,0,1,0,0,1,0,0
"Cyprus","2025-02-08",0,0,1,0,0,1,0,0
"Cyprus","2025-02-09",0,0,1,0,0,1,0,0
"Cyprus","2025-02-10",0,0,1,0,0,1,0,0
"Cyprus","2025-02-11",0,0,1,0,0,1,0,0
"Cyprus","2025-02-12",0,0,1,0,0,1,0,0
"Cyprus","2025-02-13",0,0,1,0,0,1,0,0
"Cyprus","2025-02-14",0,0,1,0,0,1,0,0
"Cyprus","2025-02-15",0,0,1,0,0,1,0,0
"Cyprus","2025-02-16",0,0,1,0,0,1,0,0
"Cyprus","2025-02-17",0,0,1,0,0,1,0,0
"Cyprus","2025-02-18",0,0,1,0,0,1,0,0
"Cyprus","2025-02-19",0,0,1,0,0,1,0,0
"Cyprus","2025-02-20",0,0,1,0,0,1,0,0
"Cyprus","2025-02-21",0,0,1,0,0,1,0,0
"Cyprus","2025-02-22",0,0,1,0,0,1,0,0
"Cyprus","2025-02-23",0,0,1,0,0,1,0,0
"Cyprus","2025-02-24",0,0,1,0,0,1,0,0
"Cyprus","2025-02-25",0,0,1,0,0,1,0,0
"Cyprus","2025-02-26",0,0,1,0,0,1,0,0
"Cyprus","2025-02-27",0,0,1,0,0,1,0,0
"Cyprus","2025-02-28",0,0,1,0,0,1,0,0
"Cyprus","2025-03-01",0,0,1,0,0,1,0,0
"Cyprus","2025-03-02",0,0,1,0,0,1,0,0
"Cyprus","2025-03-03",0,0,1,0,0,1,0,0
"Czechia","2024-01-01",0,0,0,0,0,0,0,0
"Czechia","2024-01-02",0,0,0,0,0,0,0,0
"Czechia","2024-01-03",0,0,0,0,0,0,0,0
"Czechia","2024-01-04",0,0,0,0,0,0,0,0
"Czechia","2024-01-05",0,0,0,0,0,0,0,0
"Czechia","2024-01-06",0,0,0,0,0,0,0,0
"Czechia","2024-01-07",0,0,0,0,0,0,0,0
"Czechia","2024-01-08",0,0,0,0,0,0,0,0
"Czechia","2024-01-09",0,0,0,0,0,0,0,0
"Czechia","2024-01-10",0,0,0,0,0,0,0,0
"Czechia","2024-01-11",0,0,0,0,0,0,0,0
"Czechia","2024-01-12",0,0,0,0,0,0,0,0
"Czechia","2024-01-13",0,0,0,0,0,0,0,0
"Czechia","2024-01-14",0,0,0,0,0,0,0,0
"Czechia","2024-01-15",0,0,0,0,0,0,0,0
"Czechia","2024-01-16",0,0,0,0,0,0,0,0
"Czechia","2024-01-17",0,0,0,0,0,0,0,0
"Czechia","2024-01-18",0,0,0,0,0,0,0,0
"Czechia","2024-01-19",0,0,0,0,0,0,0,0
"Czechia","2024-01-20",0,0,0,0,0,0,0,0
"Czechia","2024-01-21",0,0,0,0,0,0,0,0
"Czechia","2024-01-22",0,0,0,0,0,0,0,0
"Czechia","2024-01-23",0,0,0,0,0,0,0,0
"Czechia","2024-01-24",0,0,0,0,0,0,0,0
"Czechia","2024-01-25",0,0,0,0,0,0,0,0
"Czechia","2024-01-26",0,0,0,0,0,0,0,0
"Czechia","2024-01-27",0,0,0,0,0,0,0,0
"Czechia","2024-01-28",0,0,0,0,0,0,0,0
"Czechia","2024-01-29",0,0,0,0,0,0,0,0
"Czechia","2024-01-30",0,0,0,0,0,0,0,0
"Czechia","2024-01-31",0,1,1,0,1,1,0,0
"Czechia","2024-02-01",0,0,1,0,0,1,0,0
"Czechia","2024-02-02",0,0,1,0,0,1,0,0
"Czechia","2024-02-03",0,0,1,0,1,2,0,0
"Czechia","2024-02-04",0,0,1,0,0,2,0,0
"Czechia","2024-02-05",0,0,1,0,0,2,0,0
"Czechia","2024-02-06",0,0,1,0,0,2,0,0
"Czechia","2024-02-07",0,0,1,0,0,2,0,0
"Czechia","2024-02-08",0,0,1,0,1,3,0,0
"Czechia","2024-02-09",0,0,1,0,0,3,0,0
"Czechia","2024-02-10",0,0,1,0,0,3,0,0
"Czechia","2024-02-11",0,0,1,0,0,3,0,0
"Czechia","2024-02-12",0,0,1,0,0,3,0,0
"Czechia","2024-02-13",0,0,1,0,1,4,0,0
"Czechia","2024-02-14",0,0,1,0,0,4,0,0
"Czechia","2024-02-15",0,0,1,0,0,4,0,0
"Czechia","2024-02-16",0,0,1,0,0,4,0,0
"Czechia","2024-02-17",0,0,1,0,1,5,0,0
"Czechia","2024-02-18",0,0,1,0,0,5,0,0
"Czechia","2024-02-19",0,0,1,0,0,5,0,0
"Czechia","2024-02-20",0,0,1,0,0,5,0,0
"Czechia","2024-02-21",0,0,1,0,0,5,0,0
"Czechia","2024-02-22",0,0,1,0,1,6,0,0
"Czechia","2024-02-23",0,0,1,0,0,6,0,0
"Czechia","2024-02-24",0,0,1,0,0,6,0,0
"Czechia","2024-02-25",0,0,1,0,0,6,0,0
"Czechia","2024-02-26",0,0,1,0,0,6,0,0
"Czechia","2024-02-27",0,0,1,0,1,7,0,0
"Czechia","2024-02-28",0,0,1,0,0,7,0,0
"Czechia","2024-02-29",0,6,7,0,0,7,0,0
"Czechia","2024-03-01",0,0,7,0,0,7,0,0
"Czechia","2024-03-02",0,0,7,0,0,7,0,0
"Czechia","2024-03-03",0,0,7,0,0,7,0,0
"Czechia","2024-03-04",0,0,7,0,0,7,0,0
"Czechia","2024-03-05",0,0,7,0,0,7,0,0
"Czechia","2024-03-06",0,0,7,0,0,7,0,0
"Czechia","2024-03-07",0,0,7,0,0,7,0,0
"Czechia","2024-03-08",0,0,7,0,0,7,0,0
"Czechia","2024-03-09",0,0,7,0,0,7,0,0
"Czechia","2024-03-10",0,0,7,0,0,7,0,0
"Czechia","2024-03-11",0,0,7,0,1,8,0,0
"Czechia","2024-03-12",0,0,7,0,0,8,0,0
"Czechia","2024-03-13",0,0,7,0,0,8,0,0
"Czechia","2024-03-14",0,0,7,0,0,8,0,0
"Czechia","2024-03-15",0,0,7,0,0,8,0,0
"Czechia","2024-03-16",0,0,7,0,0,8,0,0
"Czechia","2024-03-17",0,0,7,0,0,8,0,0
"Czechia","2024-03-18",0,0,7,0,0,8,0,0
"Czechia","2024-03-19",0,0,7,0,0,8,0,0
"Czechia","2024-03-20",0,0,7,0,0,8,0,0
"Czechia","2024-03-21",0,0,7,0,0,8,0,0
"Czechia","2024-03-22",0,0,7,0,0,8,0,0
"Czechia","2024-03-23",0,0,7,0,0,8,0,0
"Czechia","2024-03-24",0,0,7,0,0,8,0,0
"Czechia","2024-03-25",0,0,7,0,0,8,0,0
"Czechia","2024-03-26",0,0,7,0,0,8,0,0
"Czechia","2024-03-27",0,0,7,0,0,8,0,0
"Czechia","2024-03-28",0,0,7,0,0,8,0,0
"Czechia","2024-03-29",0,0,7,0,0,8,0,0
"Czechia","2024-03-30",0,0,7,0,0,8,0,0
"Czechia","2024-03-31",0,0,7,0,1,9,0,0
"Czechia","2024-04-01",0,0,7,0,0,9,0,0
"Czechia","2024-04-02",0,0,7,0,0,9,0,0
"Czechia","2024-04-03",0,0,7,0,0,9,0,0
"Czechia","2024-04-04",0,0,7,0,0,9,0,0
"Czechia","2024-04-05",0,0,7,0,0,9,0,0
"Czechia","2024-04-06",0,0,7,0,0,9,0,0
"Czechia","2024-04-07",0,0,7,0,0,9,0,0
"Czechia","2024-04-08",0,0,7,0,0,9,0,0
"Czechia","2024-04-09",0,0,7,0,0,9,0,0
"Czechia","2024-04-10",0,0,7,0,0,9,0,0
"Czechia","2024-04-11",0,0,7,0,0,9,0,0
"Czechia","2024-04-12",0,0,7,0,0,9,0,0
"Czechia","2024-04-13",0,0,7,0,0,9,0,0
"Czechia","2024-04-14",0,0,7,0,0,9,0,0
"Czechia","2024-04-15",0,0,7,0,0,9,0,0
"Czechia","2024-04-16",0,0,7,0,0,9,0,0
"Czechia","2024-04-17",0,0,7,0,0,9,0,0
"Czechia","2024-04-18",0,0,7,0,0,9,0,0
"Czechia","2024-04-19",0,0,7,0,0,9,0,0
"Czechia","2024-04-20",0,0,7,0,1,10,0,0
"Czechia","2024-04-21",0,0,7,0,0,10,0,0
"Czechia","2024-04-22",0,0,7,0,0,10,0,0
"Czechia","2024-04-23",0,0,7,0,0,10,0,0
"Czechia","2024-04-24",0,0,7,0,0,10,0,0
"Czechia","2024-04-25",0,0,7,0,0,10,0,0
"Czechia","2024-04-26",0,0,7,0,0,10,0,0
"Czechia","2024-04-27",0,0,7,0,0,10,0,0
"Czechia","2024-04-28",0,0,7,0,0,10,0,0
"Czechia","2024-04-29",0,0,7,0,0,10,0,0
"Czechia","2024-04-30",0,3,10,0,0,10,0,0
"Czechia","2024-05-01",0,0,10,0,0,10,0,0
"Czechia","2024-05-02",0,0,10,0,0,10,0,0
"Czechia","2024-05-03",0,0,10,0,0,10,0,0
"Czechia","2024-05-04",0,0,10,0,0,10,0,0
"Czechia","2024-05-05",0,0,10,0,0,10,0,0
"Czechia","2024-05-06",0,0,10,0,0,10,0,0
"Czechia","2024-05-07",0,0,10,0,0,10,0,0
"Czechia","2024-05-08",0,0,10,0,0,10,0,0
"Czechia","2024-05-09",0,0,10,0,0,10,0,0
"Czechia","2024-05-10",0,0,10,0,0,10,0,0
"Czechia","2024-05-11",0,0,10,0,0,10,0,0
"Czechia","2024-05-12",0,0,10,0,0,10,0,0
"Czechia","2024-05-13",0,0,10,0,0,10,0,0
"Czechia","2024-05-14",0,0,10,0,0,10,0,0
"Czechia","2024-05-15",0,0,10,0,0,10,0,0
"Czechia","2024-05-16",0,0,10,0,1,11,0,0
"Czechia","2024-05-17",0,0,10,0,0,11,0,0
"Czechia","2024-05-18",0,0,10,0,0,11,0,0
"Czechia","2024-05-19",0,0,10,0,0,11,0,0
"Czechia","2024-05-20",0,0,10,0,0,11,0,0
"Czechia","2024-05-21",0,0,10,0,0,11,0,0
"Czechia","2024-05-22",0,0,10,0,0,11,0,0
"Czechia","2024-05-23",0,0,10,0,0,11,0,0
"Czechia","2024-05-24",0,0,10,0,0,11,0,0
"Czechia","2024-05-25",0,0,10,0,0,11,0,0
"Czechia","2024-05-26",0,0,10,0,0,11,0,0
"Czechia","2024-05-27",0,0,10,0,0,11,0,0
"Czechia","2024-05-28",0,0,10,0,0,11,0,0
"Czechia","2024-05-29",0,0,10,0,0,11,0,0
"Czechia","2024-05-30",0,0,10,0,0,11,0,0
"Czechia","2024-05-31",0,1,11,0,0,11,0,0
"Czechia","2024-06-01",0,0,11,0,0,11,0,0
"Czechia","2024-06-02",0,0,11,0,0,11,0,0
"Czechia","2024-06-03",0,0,11,0,0,11,0,0
"Czechia","2024-06-04",0,0,11,0,0,11,0,0
"Czechia","2024-06-05",0,0,11,0,0,11,0,0
"Czechia","2024-06-06",0,0,11,0,0,11,0,0
"Czechia","2024-06-07",0,0,11,0,0,11,0,0
"Czechia","2024-06-08",0,0,11,0,0,11,0,0
"Czechia","2024-06-09",0,0,11,0,0,11,0,0
"Czechia","2024-06-10",0,0,11,0,0,11,0,0
"Czechia","2024-06-11",0,0,11,0,0,11,0,0
"Czechia","2024-06-12",0,0,11,0,0,11,0,0
"Czechia","2024-06-13",0,0,11,0,0,11,0,0
"Czechia","2024-06-14",0,0,11,0,0,11,0,0
"Czechia","2024-06-15",0,0,11,0,0,11,0,0
"Czechia","2024-06-16",0,0,11,0,1,12,0,0
"Czechia","2024-06-17",0,0,11,0,0,12,0,0
"Czechia","2024-06-18",0,0,11,0,0,12,0,0
"Czechia","2024-06-19",0,0,11,0,0,12,0,0
"Czechia","2024-06-20",0,0,11,0,0,12,0,0
"Czechia","2024-06-21",0,0,11,0,0,12,0,0
"Czechia","2024-06-22",0,0,11,0,0,12,0,0
"Czechia","2024-06-23",0,0,11,0,0,12,0,0
"Czechia","2024-06-24",0,0,11,0,0,12,0,0
"Czechia","2024-06-25",0,0,11,0,0,12,0,0
"Czechia","2024-06-26",0,0,11,0,0,12,0,0
"Czechia","2024-06-27",0,0,11,0,0,12,0,0
"Czechia","2024-06-28",0,0,11,0,0,12,0,0
"Czechia","2024-06-29",0,0,11,0,0,12,0,0
"Czechia","2024-06-30",0,0,11,0,0,12,0,0
"Czechia","2024-07-01",0,0,11,0,0,12,0,0
"Czechia","2024-07-02",0,0,11,0,0,12,0,0
"Czechia","2024-07-03",0,0,11,0,0,12,0,0
"Czechia","2024-07-04",0,0,11,0,0,12,0,0
"Czechia","2024-07-05",0,0,11,0,0,12,0,0
"Czechia","2024-07-06",0,0,11,0,0,12,0,0
"Czechia","2024-07-07",0,0,11,0,0,12,0,0
"Czechia","2024-07-08",0,0,11,0,0,12,0,0
"Czechia","2024-07-09",0,0,11,0,0,12,0,0
"Czechia","2024-07-10",0,0,11,0,0,12,0,0
"Czechia","2024-07-11",0,0,11,0,0,12,0,0
"Czechia","2024-07-12",0,0,11,0,0,12,0,0
"Czechia","2024-07-13",0,0,11,0,0,12,0,0
"Czechia","2024-07-14",0,0,11,0,0,12,0,0
"Czechia","2024-07-15",0,0,11,0,0,12,0,0
"Czechia","2024-07-16",0,0,11,0,1,13,0,0
"Czechia","2024-07-17",0,0,11,0,0,13,0,0
"Czechia","2024-07-18",0,0,11,0,0,13,0,0
"Czechia","2024-07-19",0,0,11,0,0,13,0,0
"Czechia","2024-07-20",0,0,11,0,0,13,0,0
"Czechia","2024-07-21",0,0,11,0,0,13,0,0
"Czechia","2024-07-22",0,0,11,0,0,13,0,0
"Czechia","2024-07-23",0,0,11,0,0,13,0,0
"Czechia","2024-07-24",0,0,11,0,0,13,0,0
"Czechia","2024-07-25",0,0,11,0,0,13,0,0
"Czechia","2024-07-26",0,0,11,0,0,13,0,0
"Czechia","2024-07-27",0,0,11,0,0,13,0,0
"Czechia","2024-07-28",0,0,11,0,0,13,0,0
"Czechia","2024-07-29",0,0,11,0,0,13,0,0
"Czechia","2024-07-30",0,0,11,0,0,13,0,0
"Czechia","2024-07-31",0,0,11,0,0,13,0,0
"Czechia","2024-08-01",0,0,11,0,0,13,0,0
"Czechia","2024-08-02",0,0,11,0,0,13,0,0
"Czechia","2024-08-03",0,0,11,0,0,13,0,0
"Czechia","2024-08-04",0,0,11,0,0,13,0,0
"Czechia","2024-08-05",0,0,11,0,0,13,0,0
"Czechia","2024-08-06",0,0,11,0,0,13,0,0
"Czechia","2024-08-07",0,0,11,0,0,13,0,0
"Czechia","2024-08-08",0,0,11,0,0,13,0,0
"Czechia","2024-08-09",0,0,11,0,0,13,0,0
"Czechia","2024-08-10",0,0,11,0,0,13,0,0
"Czechia","2024-08-11",0,0,11,0,0,13,0,0
"Czechia","2024-08-12",0,0,11,0,0,13,0,0
"Czechia","2024-08-13",0,0,11,0,0,13,0,0
"Czechia","2024-08-14",0,0,11,0,0,13,0,0
"Czechia","2024-08-15",0,0,11,0,0,13,0,0
"Czechia","2024-08-16",0,0,11,0,1,14,0,0
"Czechia","2024-08-17",0,0,11,0,0,14,0,0
"Czechia","2024-08-18",0,0,11,0,0,14,0,0
"Czechia","2024-08-19",0,0,11,0,0,14,0,0
"Czechia","2024-08-20",0,0,11,0,0,14,0,0
"Czechia","2024-08-21",0,0,11,0,0,14,0,0
"Czechia","2024-08-22",0,0,11,0,0,14,0,0
"Czechia","2024-08-23",0,0,11,0,0,14,0,0
"Czechia","2024-08-24",0,0,11,0,0,14,0,0
"Czechia","2024-08-25",0,0,11,0,0,14,0,0
"Czechia","2024-08-26",0,0,11,0,0,14,0,0
"Czechia","2024-08-27",0,0,11,0,0,14,0,0
"Czechia","2024-08-28",0,0,11,0,0,14,0,0
"Czechia","2024-08-29",0,0,11,0,0,14,0,0
"Czechia","2024-08-30",0,0,11,0,0,14,0,0
"Czechia","2024-08-31",0,3,14,0,0,14,0,0
"Czechia","2024-09-01",0,0,14,0,0,14,0,0
"Czechia","2024-09-02",0,0,14,0,0,14,0,0
"Czechia","2024-09-03",0,0,14,0,0,14,0,0
"Czechia","2024-09-04",0,0,14,0,0,14,0,0
"Czechia","2024-09-05",0,0,14,0,0,14,0,0
"Czechia","2024-09-06",0,0,14,0,0,14,0,0
"Czechia","2024-09-07",0,0,14,0,0,14,0,0
"Czechia","2024-09-08",0,0,14,0,1,15,0,0
"Czechia","2024-09-09",0,0,14,0,0,15,0,0
"Czechia","2024-09-10",0,0,14,0,0,15,0,0
"Czechia","2024-09-11",0,0,14,0,0,15,0,0
"Czechia","2024-09-12",0,0,14,0,0,15,0,0
"Czechia","2024-09-13",0,0,14,0,0,15,0,0
"Czechia","2024-09-14",0,0,14,0,0,15,0,0
"Czechia","2024-09-15",0,0,14,0,0,15,0,0
"Czechia","2024-09-16",0,0,14,0,0,15,0,0
"Czechia","2024-09-17",0,0,14,0,0,15,0,0
"Czechia","2024-09-18",0,0,14,0,0,15,0,0
"Czechia","2024-09-19",0,0,14,0,0,15,0,0
"Czechia","2024-09-20",0,0,14,0,0,15,0,0
"Czechia","2024-09-21",0,0,14,0,0,15,0,0
"Czechia","2024-09-22",0,0,14,0,0,15,0,0
"Czechia","2024-09-23",0,0,14,0,1,16,0,0
"Czechia","2024-09-24",0,0,14,0,0,16,0,0
"Czechia","2024-09-25",0,0,14,0,0,16,0,0
"Czechia","2024-09-26",0,0,14,0,0,16,0,0
"Czechia","2024-09-27",0,0,14,0,0,16,0,0
"Czechia","2024-09-28",0,0,14,0,0,16,0,0
"Czechia","2024-09-29",0,0,14,0,0,16,0,0
"Czechia","2024-09-30",0,2,16,0,0,16,0,0
"Czechia","2024-10-01",0,0,16,0,0,16,0,0
"Czechia","2024-10-02",0,0,16,0,0,16,0,0
"Czechia","2024-10-03",0,0,16,0,0,16,0,0
"Czechia","2024-10-04",0,0,16,0,0,16,0,0
"Czechia","2024-10-05",0,0,16,0,0,16,0,0
"Czechia","2024-10-06",0,0,16,0,1,17,0,0
"Czechia","2024-10-07",0,0,16,0,0,17,0,0
"Czechia","2024-10-08",0,0,16,0,0,17,0,0
"Czechia","2024-10-09",0,0,16,0,0,17,0,0
"Czechia","2024-10-10",0,0,16,0,0,17,0,0
"Czechia","2024-10-11",0,0,16,0,0,17,0,0
"Czechia","2024-10-12",0,0,16,0,0,17,0,0
"Czechia","2024-10-13",0,0,16,0,0,17,0,0
"Czechia","2024-10-14",0,0,16,0,0,17,0,0
"Czechia","2024-10-15",0,0,16,0,0,17,0,0
"Czechia","2024-10-16",0,0,16,0,1,18,0,0
"Czechia","2024-10-17",0,0,16,0,0,18,0,0
"Czechia","2024-10-18",0,0,16,0,0,18,0,0
"Czechia","2024-10-19",0,0,16,0,0,18,0,0
"Czechia","2024-10-20",0,0,16,0,0,18,0,0
"Czechia","2024-10-21",0,0,16,0,0,18,0,0
"Czechia","2024-10-22",0,0,16,0,0,18,0,0
"Czechia","2024-10-23",0,0,16,0,0,18,0,0
"Czechia","2024-10-24",0,0,16,0,0,18,0,0
"Czechia","2024-10-25",0,0,16,0,0,18,0,0
"Czechia","2024-10-26",0,0,16,0,1,19,0,0
"Czechia","2024-10-27",0,0,16,0,0,19,0,0
"Czechia","2024-10-28",0,0,16,0,0,19,0,0
"Czechia","2024-10-29",0,0,16,0,0,19,0,0
"Czechia","2024-10-30",0,0,16,0,0,19,0,0
"Czechia","2024-10-31",0,3,19,0,0,19,0,0
"Czechia","2024-11-01",0,0,19,0,0,19,0,0
"Czechia","2024-11-02",0,0,19,0,0,19,0,0
"Czechia","2024-11-03",0,0,19,0,0,19,0,0
"Czechia","2024-11-04",0,0,19,0,0,19,0,0
"Czechia","2024-11-05",0,0,19,0,0,19,0,0
"Czechia","2024-11-06",0,0,19,0,0,19,0,0
"Czechia","2024-11-07",0,0,19,0,0,19,0,0
"Czechia","2024-11-08",0,0,19,0,1,20,0,0
"Czechia","2024-11-09",0,0,19,0,0,20,0,0
"Czechia","2024-11-10",0,0,19,0,0,20,0,0
"Czechia","2024-11-11",0,0,19,0,0,20,0,0
"Czechia","2024-11-12",0,0,19,0,0,20,0,0
"Czechia","2024-11-13",0,0,19,0,0,20,0,0
"Czechia","2024-11-14",0,0,19,0,0,20,0,0
"Czechia","2024-11-15",0,0,19,0,0,20,0,0
"Czechia","2024-11-16",0,0,19,0,0,20,0,0
"Czechia","2024-11-17",0,0,19,0,0,20,0,0
"Czechia","2024-11-18",0,0,19,0,0,20,0,0
"Czechia","2024-11-19",0,0,19,0,0,20,0,0
"Czechia","2024-11-20",0,0,19,0,0,20,0,0
"Czechia","2024-11-21",0,0,19,0,0,20,0,0
"Czechia","2024-11-22",0,0,19,0,0,20,0,0
"Czechia","2024-11-23",0,0,19,0,1,21,0,0
"Czechia","2024-11-24",0,0,19,0,0,21,0,0
"Czechia","2024-11-25",0,0,19,0,0,21,0,0
"Czechia","2024-11-26",0,0,19,0,0,21,0,0
"Czechia","2024-11-27",0,0,19,0,0,21,0,0
"Czechia","2024-11-28",0,0,19,0,0,21,0,0
"Czechia","2024-11-29",0,0,19,0,0,21,0,0
"Czechia","2024-11-30",0,2,21,0,0,21,0,0
"Czechia","2024-12-01",0,0,21,0,0,21,0,0
"Czechia","2024-12-02",0,0,21,0,0,21,0,0
"Czechia","2024-12-03",0,0,21,0,0,21,0,0
"Czechia","2024-12-04",0,0,21,0,0,21,0,0
"Czechia","2024-12-05",0,0,21,0,0,21,0,0
"Czechia","2024-12-06",0,0,21,0,0,21,0,0
"Czechia","2024-12-07",0,0,21,0,0,21,0,0
"Czechia","2024-12-08",0,0,21,0,1,22,0,0
"Czechia","2024-12-09",0,0,21,0,0,22,0,0
"Czechia","2024-12-10",0,0,21,0,0,22,0,0
"Czechia","2024-12-11",0,0,21,0,0,22,0,0
"Czechia","2024-12-12",0,0,21,0,0,22,0,0
"Czechia","2024-12-13",0,0,21,0,0,22,0,0
"Czechia","2024-12-14",0,0,21,0,0,22,0,0
"Czechia","2024-12-15",0,0,21,0,0,22,0,0
"Czechia","2024-12-16",0,0,21,0,0,22,0,0
"Czechia","2024-12-17",0,0,21,0,0,22,0,0
"Czechia","2024-12-18",0,0,21,0,0,22,0,0
"Czechia","2024-12-19",0,0,21,0,0,22,0,0
"Czechia","2024-12-20",0,0,21,0,0,22,0,0
"Czechia","2024-12-21",0,0,21,0,0,22,0,0
"Czechia","2024-12-22",0,0,21,0,0,22,0,0
"Czechia","2024-12-23",0,0,21,0,0,22,0,0
"Czechia","2024-12-24",0,0,21,0,1,23,0,0
"Czechia","2024-12-25",0,0,21,0,0,23,0,0
"Czechia","2024-12-26",0,0,21,0,0,23,0,0
"Czechia","2024-12-27",0,0,21,0,0,23,0,0
"Czechia","2024-12-28",0,0,21,0,0,23,0,0
"Czechia","2024-12-29",0,0,21,0,0,23,0,0
"Czechia","2024-12-30",0,0,21,0,0,23,0,0
"Czechia","2024-12-31",0,2,23,0,0,23,0,0
"Czechia","2025-01-01",0,0,23,0,1,24,0,0
"Czechia","2025-01-02",0,0,23,0,0,24,0,0
"Czechia","2025-01-03",0,0,23,0,1,25,0,0
"Czechia","2025-01-04",0,0,23,0,0,25,0,0
"Czechia","2025-01-05",0,0,23,0,1,26,0,0
"Czechia","2025-01-06",0,0,23,0,1,27,0,0
"Czechia","2025-01-07",0,0,23,0,0,27,0,0
"Czechia","2025-01-08",0,0,23,0,1,28,0,0
"Czechia","2025-01-09",0,0,23,0,0,28,0,0
"Czechia","2025-01-10",0,6,29,0,1,29,0,0
"Czechia","2025-01-11",0,0,29,0,0,29,0,0
"Czechia","2025-01-12",0,0,29,0,0,29,0,0
"Czechia","2025-01-13",0,0,29,0,0,29,0,0
"Czechia","2025-01-14",0,0,29,0,0,29,0,0
"Czechia","2025-01-15",0,0,29,0,0,29,0,0
"Czechia","2025-01-16",0,0,29,0,0,29,0,0
"Czechia","2025-01-17",0,0,29,0,0,29,0,0
"Czechia","2025-01-18",0,0,29,0,0,29,0,0
"Czechia","2025-01-19",0,0,29,0,0,29,0,0
"Czechia","2025-01-20",0,0,29,0,0,29,0,0
"Czechia","2025-01-21",0,0,29,0,0,29,0,0
"Czechia","2025-01-22",0,0,29,0,0,29,0,0
"Czechia","2025-01-23",0,0,29,0,0,29,0,0
"Czechia","2025-01-24",0,0,29,0,0,29,0,0
"Czechia","2025-01-25",0,0,29,0,0,29,0,0
"Czechia","2025-01-26",0,0,29,0,0,29,0,0
"Czechia","2025-01-27",0,0,29,0,0,29,0,0
"Czechia","2025-01-28",0,0,29,0,0,29,0,0
"Czechia","2025-01-29",0,0,29,0,0,29,0,0
"Czechia","2025-01-30",0,0,29,0,0,29,0,0
"Czechia","2025-01-31",0,0,29,0,0,29,0,0
"Czechia","2025-02-01",0,0,29,0,0,29,0,0
"Czechia","2025-02-02",0,0,29,0,0,29,0,0
"Czechia","2025-02-03",0,0,29,0,0,29,0,0
"Czechia","2025-02-04",0,0,29,0,0,29,0,0
"Czechia","2025-02-05",0,0,29,0,0,29,0,0
"Czechia","2025-02-06",0,0,29,0,0,29,0,0
"Czechia","2025-02-07",0,0,29,0,0,29,0,0
"Czechia","2025-02-08",0,0,29,0,0,29,0,0
"Czechia","2025-02-09",0,0,29,0,0,29,0,0
"Czechia","2025-02-10",0,0,29,0,0,29,0,0
"Czechia","2025-02-11",0,0,29,0,0,29,0,0
"Czechia","2025-02-12",0,0,29,0,0,29,0,0
"Czechia","2025-02-13",0,0,29,0,0,29,0,0
"Czechia","2025-02-14",0,0,29,0,0,29,0,0
"Czechia","2025-02-15",0,0,29,0,0,29,0,0
"Czechia","2025-02-16",0,0,29,0,0,29,0,0
"Czechia","2025-02-17",0,0,29,0,0,29,0,0
"Czechia","2025-02-18",0,0,29,0,0,29,0,0
"Czechia","2025-02-19",0,0,29,0,0,29,0,0
"Czechia","2025-02-20",0,0,29,0,0,29,0,0
"Czechia","2025-02-21",0,0,29,0,0,29,0,0
"Czechia","2025-02-22",0,0,29,0,0,29,0,0
"Czechia","2025-02-23",0,0,29,0,0,29,0,0
"Czechia","2025-02-24",0,0,29,0,0,29,0,0
"Czechia","2025-02-25",0,0,29,0,0,29,0,0
"Czechia","2025-02-26",0,0,29,0,0,29,0,0
"Czechia","2025-02-27",0,0,29,0,0,29,0,0
"Czechia","2025-02-28",0,0,29,0,0,29,0,0
"Czechia","2025-03-01",0,0,29,0,0,29,0,0
"Czechia","2025-03-02",0,0,29,0,0,29,0,0
"Czechia","2025-03-03",0,0,29,0,0,29,0,0
"Democratic Republic of the Congo","2024-01-01",0,0,0,0,0,0,0,0
"Democratic Republic of the Congo","2024-01-02",0,0,0,0,0,0,0,0
"Democratic Republic of the Congo","2024-01-03",0,0,0,0,0,0,0,0
"Democratic Republic of the Congo","2024-01-04",0,0,0,0,0,0,0,0
"Democratic Republic of the Congo","2024-01-05",0,0,0,0,0,0,0,0
"Democratic Republic of the Congo","2024-01-06",0,0,0,0,0,0,0,0
"Democratic Republic of the Congo","2024-01-07",0,37,37,0,37,37,0,0
"Democratic Republic of the Congo","2024-01-08",0,0,37,0,4,41,0,0
"Democratic Republic of the Congo","2024-01-09",0,0,37,0,5,46,0,0
"Democratic Republic of the Congo","2024-01-10",0,0,37,0,4,50,0,0
"Democratic Republic of the Congo","2024-01-11",0,0,37,0,4,54,0,0
"Democratic Republic of the Congo","2024-01-12",0,0,37,0,4,58,0,0
"Democratic Republic of the Congo","2024-01-13",0,0,37,0,5,63,0,0
"Democratic Republic of the Congo","2024-01-14",0,30,67,0,4,67,0,0
"Democratic Republic of the Congo","2024-01-15",0,0,67,0,11,78,0,0
"Democratic Republic of the Congo","2024-01-16",0,0,67,0,11,89,0,0
"Democratic Republic of the Congo","2024-01-17",0,0,67,0,11,100,0,0
"Democratic Republic of the Congo","2024-01-18",0,0,67,0,10,110,0,0
"Democratic Republic of the Congo","2024-01-19",0,0,67,0,11,121,0,0
"Democratic Republic of the Congo","2024-01-20",0,0,67,0,11,132,0,0
"Democratic Republic of the Congo","2024-01-21",0,76,143,0,11,143,0,0
"Democratic Republic of the Congo","2024-01-22",0,0,143,0,6,149,0,0
"Democratic Republic of the Congo","2024-01-23",0,0,143,0,7,156,0,0
"Democratic Republic of the Congo","2024-01-24",0,0,143,0,6,162,0,0
"Democratic Republic of the Congo","2024-01-25",0,0,143,0,6,168,0,0
"Democratic Republic of the Congo","2024-01-26",0,0,143,0,6,174,0,0
"Democratic Republic of the Congo","2024-01-27",0,0,143,0,7,181,0,0
"Democratic Republic of the Congo","2024-01-28",0,44,187,0,6,187,0,0
"Democratic Republic of the Congo","2024-01-29",0,0,187,0,6,193,0,0
"Democratic Republic of the Congo","2024-01-30",0,0,187,0,5,198,0,0
"Democratic Republic of the Congo","2024-01-31",0,0,187,0,6,204,0,0
"Democratic Republic of the Congo","2024-02-01",0,0,187,0,5,209,0,0
"Democratic Republic of the Congo","2024-02-02",0,0,187,0,6,215,0,0
"Democratic Republic of the Congo","2024-02-03",0,0,187,0,5,220,0,0
"Democratic Republic of the Congo","2024-02-04",0,39,226,0,6,226,0,0
"Democratic Republic of the Congo","2024-02-05",0,0,226,0,6,232,0,0
"Democratic Republic of the Congo","2024-02-06",0,0,226,0,6,238,0,0
"Democratic Republic of the Congo","2024-02-07",0,0,226,0,6,244,0,0
"Democratic Republic of the Congo","2024-02-08",0,0,226,0,6,250,0,0
"Democratic Republic of the Congo","2024-02-09",0,0,226,0,6,256,0,0
"Democratic Republic of the Congo","2024-02-10",1351,0,226,1351,6,262,1351,1351
"Democratic Republic of the Congo","2024-02-11",0,42,268,1351,6,268,44,1395
"Democratic Republic of the Congo","2024-02-12",0,0,268,1351,5,273,44,1439
"Democratic Republic of the Congo","2024-02-13",0,0,268,1351,5,278,45,1484
"Democratic Republic of the Congo","2024-02-14",0,0,268,1351,5,283,44,1528
"Democratic Republic of the Congo","2024-02-15",0,0,268,1351,5,288,44,1572
"Democratic Republic of the Congo","2024-02-16",0,0,268,1351,5,293,44,1616
"Democratic Republic of the Congo","2024-02-17",0,0,268,1351,5,298,45,1661
"Democratic Republic of the Congo","2024-02-18",0,35,303,1351,5,303,44,1705
"Democratic Republic of the Congo","2024-02-19",0,0,303,1351,5,308,44,1749
"Democratic Republic of the Congo","2024-02-20",0,0,303,1351,5,313,44,1793
"Democratic Republic of the Congo","2024-02-21",0,0,303,1351,5,318,44,1837
"Democratic Republic of the Congo","2024-02-22",0,0,303,1351,6,324,45,1882
"Democratic Republic of the Congo","2024-02-23",0,0,303,1351,5,329,44,1926
"Democratic Republic of the Congo","2024-02-24",0,0,303,1351,5,334,44,1970
"Democratic Republic of the Congo","2024-02-25",0,36,339,1351,5,339,44,2014
"Democratic Republic of the Congo","2024-02-26",0,0,339,1351,8,347,45,2059
"Democratic Republic of the Congo","2024-02-27",0,0,339,1351,7,354,44,2103
"Democratic Republic of the Congo","2024-02-28",0,0,339,1351,8,362,44,2147
"Democratic Republic of the Congo","2024-02-29",0,0,339,1351,7,369,44,2191
"Democratic Republic of the Congo","2024-03-01",0,0,339,1351,8,377,44,2235
"Democratic Republic of the Congo","2024-03-02",0,0,339,1351,7,384,45,2280
"Democratic Republic of the Congo","2024-03-03",0,53,392,1351,8,392,44,2324
"Democratic Republic of the Congo","2024-03-04",0,0,392,1351,5,397,44,2368
"Democratic Republic of the Congo","2024-03-05",0,0,392,1351,6,403,44,2412
"Democratic Republic of the Congo","2024-03-06",0,0,392,1351,5,408,45,2457
"Democratic Republic of the Congo","2024-03-07",0,0,392,1351,6,414,44,2501
"Democratic Republic of the Congo","2024-03-08",0,0,392,1351,5,419,44,2545
"Democratic Republic of the Congo","2024-03-09",0,0,392,1351,6,425,44,2589
"Democratic Republic of the Congo","2024-03-10",0,38,430,1351,5,430,44,2633
"Democratic Republic of the Congo","2024-03-11",0,0,430,1351,7,437,45,2678
"Democratic Republic of the Congo","2024-03-12",0,0,430,1351,7,444,44,2722
"Democratic Republic of the Congo","2024-03-13",0,0,430,1351,7,451,44,2766
"Democratic Republic of the Congo","2024-03-14",0,0,430,1351,6,457,44,2810
"Democratic Republic of the Congo","2024-03-15",0,0,430,1351,7,464,45,2855
"Democratic Republic of the Congo","2024-03-16",0,0,430,1351,7,471,44,2899
"Democratic Republic of the Congo","2024-03-17",1592,48,478,2943,7,478,44,2943
"Democratic Republic of the Congo","2024-03-18",0,0,478,2943,8,486,90,3033
"Democratic Republic of the Congo","2024-03-19",0,0,478,2943,7,493,91,3124
"Democratic Republic of the Congo","2024-03-20",0,0,478,2943,8,501,90,3214
"Democratic Republic of the Congo","2024-03-21",0,0,478,2943,7,508,91,3305
"Democratic Republic of the Congo","2024-03-22",0,0,478,2943,8,516,90,3395
"Democratic Republic of the Congo","2024-03-23",0,0,478,2943,7,523,91,3486
"Democratic Republic of the Congo","2024-03-24",633,53,531,3576,8,531,90,3576
"Democratic Republic of the Congo","2024-03-25",0,0,531,3576,7,538,119,3695
"Democratic Republic of the Congo","2024-03-26",0,0,531,3576,6,544,118,3813
"Democratic Republic of the Congo","2024-03-27",0,0,531,3576,7,551,119,3932
"Democratic Republic of the Congo","2024-03-28",0,0,531,3576,6,557,118,4050
"Democratic Republic of the Congo","2024-03-29",593,0,531,4169,7,564,119,4169
"Democratic Republic of the Congo","2024-03-30",0,0,531,4169,6,570,6,4175
"Democratic Republic of the Congo","2024-03-31",0,46,577,4169,7,577,6,4181
"Democratic Republic of the Congo","2024-04-01",0,0,577,4169,9,586,7,4188
"Democratic Republic of the Congo","2024-04-02",0,0,577,4169,8,594,6,4194
"Democratic Republic of the Congo","2024-04-03",0,0,577,4169,9,603,6,4200
"Democratic Republic of the Congo","2024-04-04",0,0,577,4169,8,611,7,4207
"Democratic Republic of the Congo","2024-04-05",0,0,577,4169,9,620,6,4213
"Democratic Republic of the Congo","2024-04-06",50,0,577,4219,8,628,6,4219
"Democratic Republic of the Congo","2024-04-07",0,60,637,4219,9,637,48,4267
"Democratic Republic of the Congo","2024-04-08",0,0,637,4219,11,648,47,4314
"Democratic Republic of the Congo","2024-04-09",0,0,637,4219,12,660,48,4362
"Democratic Republic of the Congo","2024-04-10",0,0,637,4219,11,671,47,4409
"Democratic Republic of the Congo","2024-04-11",0,0,637,4219,11,682,48,4457
"Democratic Republic of the Congo","2024-04-12",0,0,637,4219,11,693,48,4505
"Democratic Republic of the Congo","2024-04-13",0,0,637,4219,12,705,47,4552
"Democratic Republic of the Congo","2024-04-14",381,79,716,4600,11,716,48,4600
"Democratic Republic of the Congo","2024-04-15",0,0,716,4600,9,725,28,4628
"Democratic Republic of the Congo","2024-04-16",0,0,716,4600,9,734,28,4656
"Democratic Republic of the Congo","2024-04-17",0,0,716,4600,9,743,28,4684
"Democratic Republic of the Congo","2024-04-18",0,0,716,4600,10,753,27,4711
"Democratic Republic of the Congo","2024-04-19",0,0,716,4600,9,762,28,4739
"Democratic Republic of the Congo","2024-04-20",167,0,716,4767,9,771,28,4767
"Democratic Republic of the Congo","2024-04-21",0,64,780,4767,9,780,25,4792
"Democratic Republic of the Congo","2024-04-22",0,0,780,4767,15,795,25,4817
"Democratic Republic of the Congo","2024-04-23",0,0,780,4767,15,810,24,4841
"Democratic Republic of the Congo","2024-04-24",0,0,780,4767,15,825,25,4866
"Democratic Republic of the Congo","2024-04-25",0,0,780,4767,16,841,25,4891
"Democratic Republic of the Congo","2024-04-26",0,0,780,4767,15,856,24,4915
"Democratic Republic of the Congo","2024-04-27",0,0,780,4767,15,871,25,4940
"Democratic Republic of the Congo","2024-04-28",198,106,886,4965,15,886,25,4965
"Democratic Republic of the Congo","2024-04-29",0,0,886,4965,19,905,69,5034
"Democratic Republic of the Congo","2024-04-30",0,0,886,4965,18,923,68,5102
"Democratic Republic of the Congo","2024-05-01",0,0,886,4965,19,942,69,5171
"Democratic Republic of the Congo","2024-05-02",0,0,886,4965,18,960,68,5239
"Democratic Republic of the Congo","2024-05-03",0,0,886,4965,19,979,69,5308
"Democratic Republic of the Congo","2024-05-04",0,0,886,4965,18,997,68,5376
"Democratic Republic of the Congo","2024-05-05",480,130,1016,5445,19,1016,69,5445
"Democratic Republic of the Congo","2024-05-06",0,0,1016,5445,13,1029,19,5464
"Democratic Republic of the Congo","2024-05-07",0,0,1016,5445,13,1042,20,5484
"Democratic Republic of the Congo","2024-05-08",0,0,1016,5445,13,1055,19,5503
"Democratic Republic of the Congo","2024-05-09",0,0,1016,5445,14,1069,20,5523
"Democratic Republic of the Congo","2024-05-10",0,0,1016,5445,13,1082,19,5542
"Democratic Republic of the Congo","2024-05-11",0,0,1016,5445,13,1095,20,5562
"Democratic Republic of the Congo","2024-05-12",136,92,1108,5581,13,1108,19,5581
"Democratic Republic of the Congo","2024-05-13",0,0,1108,5581,15,1123,78,5659
"Democratic Republic of the Congo","2024-05-14",0,0,1108,5581,14,1137,78,5737
"Democratic Republic of the Congo","2024-05-15",0,0,1108,5581,15,1152,78,5815
"Democratic Republic of the Congo","2024-05-16",0,0,1108,5581,15,1167,78,5893
"Democratic Republic of the Congo","2024-05-17",0,0,1108,5581,15,1182,78,5971
"Democratic Republic of the Congo","2024-05-18",468,0,1108,6049,14,1196,78,6049
"Democratic Republic of the Congo","2024-05-19",0,103,1211,6049,15,1211,50,6099
"Democratic Republic of the Congo","2024-05-20",0,0,1211,6049,13,1224,49,6148
"Democratic Republic of the Congo","2024-05-21",0,0,1211,6049,13,1237,50,6198
"Democratic Republic of the Congo","2024-05-22",0,0,1211,6049,13,1250,50,6248
"Democratic Republic of the Congo","2024-05-23",0,0,1211,6049,13,1263,50,6298
"Democratic Republic of the Congo","2024-05-24",0,0,1211,6049,13,1276,49,6347
"Democratic Republic of the Congo","2024-05-25",348,0,1211,6397,13,1289,50,6397
"Democratic Republic of the Congo","2024-05-26",0,91,1302,6397,13,1302,22,6419
"Democratic Republic of the Congo","2024-05-27",0,0,1302,6397,15,1317,22,6441
"Democratic Republic of the Congo","2024-05-28",0,0,1302,6397,15,1332,22,6463
"Democratic Republic of the Congo","2024-05-29",0,0,1302,6397,15,1347,23,6486
"Democratic Republic of the Congo","2024-05-30",0,0,1302,6397,16,1363,22,6508
"Democratic Republic of the Congo","2024-05-31",0,0,1302,6397,15,1378,22,6530
"Democratic Republic of the Congo","2024-06-01",0,0,1302,6397,15,1393,22,6552
"Democratic Republic of the Congo","2024-06-02",0,106,1408,6397,15,1408,22,6574
"Democratic Republic of the Congo","2024-06-03",0,0,1408,6397,21,1429,22,6596
"Democratic Republic of the Congo","2024-06-04",0,0,1408,6397,21,1450,22,6618
"Democratic Republic of the Congo","2024-06-05",0,0,1408,6397,21,1471,22,6640
"Democratic Republic of the Congo","2024-06-06",0,0,1408,6397,21,1492,23,6663
"Democratic Republic of the Congo","2024-06-07",0,0,1408,6397,21,1513,22,6685
"Democratic Republic of the Congo","2024-06-08",0,0,1408,6397,21,1534,22,6707
"Democratic Republic of the Congo","2024-06-09",332,147,1555,6729,21,1555,22,6729
"Democratic Republic of the Congo","2024-06-10",0,0,1555,6729,28,1583,39,6768
"Democratic Republic of the Congo","2024-06-11",0,0,1555,6729,27,1610,39,6807
"Democratic Republic of the Congo","2024-06-12",0,0,1555,6729,28,1638,39,6846
"Democratic Republic of the Congo","2024-06-13",0,0,1555,6729,28,1666,39,6885
"Democratic Republic of the Congo","2024-06-14",0,0,1555,6729,28,1694,39,6924
"Democratic Republic of the Congo","2024-06-15",0,0,1555,6729,27,1721,39,6963
"Democratic Republic of the Congo","2024-06-16",273,194,1749,7002,28,1749,39,7002
"Democratic Republic of the Congo","2024-06-17",0,0,1749,7002,26,1775,100,7102
"Democratic Republic of the Congo","2024-06-18",0,0,1749,7002,25,1800,99,7201
"Democratic Republic of the Congo","2024-06-19",0,0,1749,7002,26,1826,99,7300
"Democratic Republic of the Congo","2024-06-20",0,0,1749,7002,26,1852,100,7400
"Democratic Republic of the Congo","2024-06-21",0,0,1749,7002,26,1878,100,7500
"Democratic Republic of the Congo","2024-06-22",597,0,1749,7599,25,1903,99,7599
"Democratic Republic of the Congo","2024-06-23",0,180,1929,7599,26,1929,57,7656
"Democratic Republic of the Congo","2024-06-24",0,0,1929,7599,26,1955,57,7713
"Democratic Republic of the Congo","2024-06-25",0,0,1929,7599,26,1981,58,7771
"Democratic Republic of the Congo","2024-06-26",0,0,1929,7599,26,2007,57,7828
"Democratic Republic of the Congo","2024-06-27",0,0,1929,7599,26,2033,57,7885
"Democratic Republic of the Congo","2024-06-28",0,0,1929,7599,26,2059,58,7943
"Democratic Republic of the Congo","2024-06-29",0,0,1929,7599,26,2085,57,8000
"Democratic Republic of the Congo","2024-06-30",458,182,2111,8057,26,2111,57,8057
"Democratic Republic of the Congo","2024-07-01",0,0,2111,8057,23,2134,87,8144
"Democratic Republic of the Congo","2024-07-02",0,0,2111,8057,23,2157,88,8232
"Democratic Republic of the Congo","2024-07-03",0,0,2111,8057,23,2180,87,8319
"Democratic Republic of the Congo","2024-07-04",0,0,2111,8057,23,2203,87,8406
"Democratic Republic of the Congo","2024-07-05",0,0,2111,8057,23,2226,88,8494
"Democratic Republic of the Congo","2024-07-06",524,0,2111,8581,23,2249,87,8581
"Democratic Republic of the Congo","2024-07-07",0,161,2272,8581,23,2272,75,8656
"Democratic Republic of the Congo","2024-07-08",0,0,2272,8581,32,2304,76,8732
"Democratic Republic of the Congo","2024-07-09",0,0,2272,8581,33,2337,75,8807
"Democratic Republic of the Congo","2024-07-10",0,0,2272,8581,32,2369,75,8882
"Democratic Republic of the Congo","2024-07-11",0,0,2272,8581,33,2402,76,8958
"Democratic Republic of the Congo","2024-07-12",452,0,2272,9033,32,2434,75,9033
"Democratic Republic of the Congo","2024-07-13",0,0,2272,9033,33,2467,133,9166
"Democratic Republic of the Congo","2024-07-14",0,227,2499,9033,32,2499,133,9299
"Democratic Republic of the Congo","2024-07-15",0,0,2499,9033,35,2534,133,9432
"Democratic Republic of the Congo","2024-07-16",0,0,2499,9033,35,2569,133,9565
"Democratic Republic of the Congo","2024-07-17",0,0,2499,9033,35,2604,134,9699
"Democratic Republic of the Congo","2024-07-18",0,0,2499,9033,34,2638,133,9832
"Democratic Republic of the Congo","2024-07-19",0,0,2499,9033,35,2673,133,9965
"Democratic Republic of the Congo","2024-07-20",0,0,2499,9033,35,2708,133,10098
"Democratic Republic of the Congo","2024-07-21",0,244,2743,9033,35,2743,133,10231
"Democratic Republic of the Congo","2024-07-22",0,0,2743,9033,33,2776,133,10364
"Democratic Republic of the Congo","2024-07-23",0,0,2743,9033,34,2810,133,10497
"Democratic Republic of the Congo","2024-07-24",0,0,2743,9033,33,2843,134,10631
"Democratic Republic of the Congo","2024-07-25",0,0,2743,9033,34,2877,133,10764
"Democratic Republic of the Congo","2024-07-26",0,0,2743,9033,33,2910,133,10897
"Democratic Republic of the Congo","2024-07-27",0,0,2743,9033,34,2944,133,11030
"Democratic Republic of the Congo","2024-07-28",2130,234,2977,11163,33,2977,133,11163
"Democratic Republic of the Congo","2024-07-29",0,0,2977,11163,19,2996,100,11263
"Democratic Republic of the Congo","2024-07-30",0,0,2977,11163,19,3015,100,11363
"Democratic Republic of the Congo","2024-07-31",0,0,2977,11163,19,3034,100,11463
"Democratic Republic of the Congo","2024-08-01",0,0,2977,11163,20,3054,101,11564
"Democratic Republic of the Congo","2024-08-02",0,0,2977,11163,19,3073,100,11664
"Democratic Republic of the Congo","2024-08-03",601,0,2977,11764,19,3092,100,11764
"Democratic Republic of the Congo","2024-08-04",0,134,3111,11764,19,3111,398,12162
"Democratic Republic of the Congo","2024-08-05",0,0,3111,11764,26,3137,398,12560
"Democratic Republic of the Congo","2024-08-06",0,0,3111,11764,27,3164,398,12958
"Democratic Republic of the Congo","2024-08-07",0,0,3111,11764,26,3190,397,13355
"Democratic Republic of the Congo","2024-08-08",0,0,3111,11764,27,3217,398,13753
"Democratic Republic of the Congo","2024-08-09",2387,0,3111,14151,26,3243,398,14151
"Democratic Republic of the Congo","2024-08-10",0,0,3111,14151,27,3270,112,14263
"Democratic Republic of the Congo","2024-08-11",0,185,3296,14151,26,3296,112,14375
"Democratic Republic of the Congo","2024-08-12",0,0,3296,14151,24,3320,112,14487
"Democratic Republic of the Congo","2024-08-13",0,0,3296,14151,23,3343,111,14598
"Democratic Republic of the Congo","2024-08-14",0,0,3296,14151,24,3367,112,14710
"Democratic Republic of the Congo","2024-08-15",0,0,3296,14151,23,3390,112,14822
"Democratic Republic of the Congo","2024-08-16",783,0,3296,14934,24,3414,112,14934
"Democratic Republic of the Congo","2024-08-17",0,0,3296,14934,23,3437,197,15131
"Democratic Republic of the Congo","2024-08-18",0,165,3461,14934,24,3461,197,15328
"Democratic Republic of the Congo","2024-08-19",0,0,3461,14934,26,3487,197,15525
"Democratic Republic of the Congo","2024-08-20",0,0,3461,14934,27,3514,197,15722
"Democratic Republic of the Congo","2024-08-21",0,0,3461,14934,26,3540,196,15918
"Democratic Republic of the Congo","2024-08-22",0,0,3461,14934,27,3567,197,16115
"Democratic Republic of the Congo","2024-08-23",0,0,3461,14934,26,3593,197,16312
"Democratic Republic of the Congo","2024-08-24",0,0,3461,14934,27,3620,197,16509
"Democratic Republic of the Congo","2024-08-25",1772,185,3646,16706,26,3646,197,16706
"Democratic Republic of the Congo","2024-08-26",0,0,3646,16706,28,3674,182,16888
"Democratic Republic of the Congo","2024-08-27",0,0,3646,16706,29,3703,183,17071
"Democratic Republic of the Congo","2024-08-28",0,0,3646,16706,28,3731,183,17254
"Democratic Republic of the Congo","2024-08-29",0,0,3646,16706,28,3759,182,17436
"Democratic Republic of the Congo","2024-08-30",0,0,3646,16706,28,3787,182,17618
"Democratic Republic of the Congo","2024-08-31",1095,0,3646,17801,29,3816,183,17801
"Democratic Republic of the Congo","2024-09-01",0,198,3844,17801,28,3844,333,18134
"Democratic Republic of the Congo","2024-09-02",0,0,3844,17801,36,3880,333,18467
"Democratic Republic of the Congo","2024-09-03",0,0,3844,17801,37,3917,332,18799
"Democratic Republic of the Congo","2024-09-04",0,0,3844,17801,36,3953,333,19132
"Democratic Republic of the Congo","2024-09-05",0,0,3844,17801,36,3989,333,19465
"Democratic Republic of the Congo","2024-09-06",0,0,3844,17801,36,4025,332,19797
"Democratic Republic of the Congo","2024-09-07",0,0,3844,17801,37,4062,333,20130
"Democratic Republic of the Congo","2024-09-08",2662,254,4098,20463,36,4098,333,20463
"Democratic Republic of the Congo","2024-09-09",0,0,4098,20463,31,4129,14,20477
"Democratic Republic of the Congo","2024-09-10",0,0,4098,20463,32,4161,13,20490
"Democratic Republic of the Congo","2024-09-11",0,0,4098,20463,31,4192,14,20504
"Democratic Republic of the Congo","2024-09-12",0,0,4098,20463,31,4223,14,20518
"Democratic Republic of the Congo","2024-09-13",0,0,4098,20463,31,4254,13,20531
"Democratic Republic of the Congo","2024-09-14",0,0,4098,20463,32,4286,14,20545
"Democratic Republic of the Congo","2024-09-15",0,219,4317,20463,31,4317,14,20559
"Democratic Republic of the Congo","2024-09-16",0,0,4317,20463,45,4362,13,20572
"Democratic Republic of the Congo","2024-09-17",0,0,4317,20463,44,4406,14,20586
"Democratic Republic of the Congo","2024-09-18",0,0,4317,20463,45,4451,14,20600
"Democratic Republic of the Congo","2024-09-19",0,0,4317,20463,44,4495,13,20613
"Democratic Republic of the Congo","2024-09-20",0,0,4317,20463,45,4540,14,20627
"Democratic Republic of the Congo","2024-09-21",0,0,4317,20463,44,4584,14,20641
"Democratic Republic of the Congo","2024-09-22",0,312,4629,20463,45,4629,13,20654
"Democratic Republic of the Congo","2024-09-23",205,0,4629,20668,33,4662,14,20668
"Democratic Republic of the Congo","2024-09-24",0,0,4629,20668,32,4694,144,20812
"Democratic Republic of the Congo","2024-09-25",0,0,4629,20668,33,4727,144,20956
"Democratic Republic of the Congo","2024-09-26",0,0,4629,20668,33,4760,144,21100
"Democratic Republic of the Congo","2024-09-27",0,0,4629,20668,33,4793,143,21243
"Democratic Republic of the Congo","2024-09-28",0,0,4629,20668,32,4825,144,21387
"Democratic Republic of the Congo","2024-09-29",0,229,4858,20668,33,4858,144,21531
"Democratic Republic of the Congo","2024-09-30",1007,0,4858,21675,34,4892,144,21675
"Democratic Republic of the Congo","2024-10-01",0,0,4858,21675,34,4926,415,22090
"Democratic Republic of the Congo","2024-10-02",0,0,4858,21675,34,4960,415,22505
"Democratic Republic of the Congo","2024-10-03",0,0,4858,21675,33,4993,415,22920
"Democratic Republic of the Congo","2024-10-04",0,0,4858,21675,34,5027,414,23334
"Democratic Republic of the Congo","2024-10-05",0,0,4858,21675,34,5061,415,23749
"Democratic Republic of the Congo","2024-10-06",0,237,5095,21675,34,5095,415,24164
"Democratic Republic of the Congo","2024-10-07",0,0,5095,21675,35,5130,415,24579
"Democratic Republic of the Congo","2024-10-08",0,0,5095,21675,35,5165,415,24994
"Democratic Republic of the Congo","2024-10-09",0,0,5095,21675,35,5200,415,25409
"Democratic Republic of the Congo","2024-10-10",0,0,5095,21675,36,5236,414,25823
"Democratic Republic of the Congo","2024-10-11",0,0,5095,21675,35,5271,415,26238
"Democratic Republic of the Congo","2024-10-12",0,0,5095,21675,35,5306,415,26653
"Democratic Republic of the Congo","2024-10-13",5393,246,5341,27068,35,5341,415,27068
"Democratic Republic of the Congo","2024-10-14",0,0,5341,27068,49,5390,189,27257
"Democratic Republic of the Congo","2024-10-15",0,0,5341,27068,49,5439,189,27446
"Democratic Republic of the Congo","2024-10-16",0,0,5341,27068,49,5488,189,27635
"Democratic Republic of the Congo","2024-10-17",0,0,5341,27068,49,5537,189,27824
"Democratic Republic of the Congo","2024-10-18",0,0,5341,27068,49,5586,189,28013
"Democratic Republic of the Congo","2024-10-19",0,0,5341,27068,49,5635,189,28202
"Democratic Republic of the Congo","2024-10-20",1323,343,5684,28391,49,5684,189,28391
"Democratic Republic of the Congo","2024-10-21",0,0,5684,28391,37,5721,95,28486
"Democratic Republic of the Congo","2024-10-22",0,0,5684,28391,38,5759,96,28582
"Democratic Republic of the Congo","2024-10-23",0,0,5684,28391,37,5796,95,28677
"Democratic Republic of the Congo","2024-10-24",0,0,5684,28391,37,5833,95,28772
"Democratic Republic of the Congo","2024-10-25",0,0,5684,28391,37,5870,95,28867
"Democratic Republic of the Congo","2024-10-26",0,0,5684,28391,38,5908,96,28963
"Democratic Republic of the Congo","2024-10-27",667,261,5945,29058,37,5945,95,29058
"Democratic Republic of the Congo","2024-10-28",0,0,5945,29058,49,5994,68,29126
"Democratic Republic of the Congo","2024-10-29",0,0,5945,29058,48,6042,68,29194
"Democratic Republic of the Congo","2024-10-30",0,0,5945,29058,49,6091,68,29262
"Democratic Republic of the Congo","2024-10-31",0,0,5945,29058,48,6139,67,29329
"Democratic Republic of the Congo","2024-11-01",0,0,5945,29058,49,6188,68,29397
"Democratic Republic of the Congo","2024-11-02",0,0,5945,29058,48,6236,68,29465
"Democratic Republic of the Congo","2024-11-03",475,340,6285,29533,49,6285,68,29533
"Democratic Republic of the Congo","2024-11-04",0,0,6285,29533,64,6349,268,29801
"Democratic Republic of the Congo","2024-11-05",0,0,6285,29533,63,6412,267,30068
"Democratic Republic of the Congo","2024-11-06",0,0,6285,29533,64,6476,268,30336
"Democratic Republic of the Congo","2024-11-07",0,0,6285,29533,64,6540,267,30603
"Democratic Republic of the Congo","2024-11-08",0,0,6285,29533,64,6604,268,30871
"Democratic Republic of the Congo","2024-11-09",0,0,6285,29533,63,6667,267,31138
"Democratic Republic of the Congo","2024-11-10",0,446,6731,29533,64,6731,268,31406
"Democratic Republic of the Congo","2024-11-11",0,0,6731,29533,63,6794,267,31673
"Democratic Republic of the Congo","2024-11-12",0,0,6731,29533,62,6856,268,31941
"Democratic Republic of the Congo","2024-11-13",0,0,6731,29533,63,6919,268,32209
"Democratic Republic of the Congo","2024-11-14",0,0,6731,29533,62,6981,267,32476
"Democratic Republic of the Congo","2024-11-15",0,0,6731,29533,63,7044,268,32744
"Democratic Republic of the Congo","2024-11-16",0,0,6731,29533,62,7106,267,33011
"Democratic Republic of the Congo","2024-11-17",0,438,7169,29533,63,7169,268,33279
"Democratic Republic of the Congo","2024-11-18",0,0,7169,29533,55,7224,267,33546
"Democratic Republic of the Congo","2024-11-19",0,0,7169,29533,55,7279,268,33814
"Democratic Republic of the Congo","2024-11-20",0,0,7169,29533,55,7334,267,34081
"Democratic Republic of the Congo","2024-11-21",4816,0,7169,34349,54,7388,268,34349
"Democratic Republic of the Congo","2024-11-22",0,0,7169,34349,55,7443,0,34349
"Democratic Republic of the Congo","2024-11-23",0,0,7169,34349,55,7498,0,34349
"Democratic Republic of the Congo","2024-11-24",0,384,7553,34349,55,7553,0,34349
"Democratic Republic of the Congo","2024-11-25",0,0,7553,34349,52,7605,0,34349
"Democratic Republic of the Congo","2024-11-26",0,0,7553,34349,53,7658,0,34349
"Democratic Republic of the Congo","2024-11-27",0,0,7553,34349,52,7710,0,34349
"Democratic Republic of the Congo","2024-11-28",0,0,7553,34349,52,7762,0,34349
"Democratic Republic of the Congo","2024-11-29",0,0,7553,34349,52,7814,0,34349
"Democratic Republic of the Congo","2024-11-30",0,0,7553,34349,53,7867,0,34349
"Democratic Republic of the Congo","2024-12-01",0,366,7919,34349,52,7919,0,34349
"Democratic Republic of the Congo","2024-12-02",0,0,7919,34349,51,7970,0,34349
"Democratic Republic of the Congo","2024-12-03",0,0,7919,34349,51,8021,0,34349
"Democratic Republic of the Congo","2024-12-04",0,0,7919,34349,51,8072,0,34349
"Democratic Republic of the Congo","2024-12-05",0,0,7919,34349,51,8123,0,34349
"Democratic Republic of the Congo","2024-12-06",0,0,7919,34349,51,8174,0,34349
"Democratic Republic of the Congo","2024-12-07",0,0,7919,34349,51,8225,0,34349
"Democratic Republic of the Congo","2024-12-08",0,357,8276,34349,51,8276,0,34349
"Democratic Republic of the Congo","2024-12-09",0,0,8276,34349,38,8314,0,34349
"Democratic Republic of the Congo","2024-12-10",0,0,8276,34349,39,8353,0,34349
"Democratic Republic of the Congo","2024-12-11",0,0,8276,34349,38,8391,0,34349
"Democratic Republic of the Congo","2024-12-12",0,0,8276,34349,38,8429,0,34349
"Democratic Republic of the Congo","2024-12-13",0,0,8276,34349,38,8467,0,34349
"Democratic Republic of the Congo","2024-12-14",0,0,8276,34349,39,8506,0,34349
"Democratic Republic of the Congo","2024-12-15",0,268,8544,34349,38,8544,0,34349
"Democratic Republic of the Congo","2024-12-16",0,0,8544,34349,29,8573,0,34349
"Democratic Republic of the Congo","2024-12-17",0,0,8544,34349,30,8603,0,34349
"Democratic Republic of the Congo","2024-12-18",0,0,8544,34349,29,8632,0,34349
"Democratic Republic of the Congo","2024-12-19",0,0,8544,34349,30,8662,0,34349
"Democratic Republic of the Congo","2024-12-20",0,0,8544,34349,29,8691,0,34349
"Democratic Republic of the Congo","2024-12-21",0,0,8544,34349,30,8721,0,34349
"Democratic Republic of the Congo","2024-12-22",0,206,8750,34349,29,8750,0,34349
"Democratic Republic of the Congo","2024-12-23",0,0,8750,34349,23,8773,0,34349
"Democratic Republic of the Congo","2024-12-24",0,0,8750,34349,23,8796,0,34349
"Democratic Republic of the Congo","2024-12-25",0,0,8750,34349,23,8819,0,34349
"Democratic Republic of the Congo","2024-12-26",0,0,8750,34349,23,8842,0,34349
"Democratic Republic of the Congo","2024-12-27",0,0,8750,34349,23,8865,0,34349
"Democratic Republic of the Congo","2024-12-28",0,0,8750,34349,23,8888,0,34349
"Democratic Republic of the Congo","2024-12-29",0,161,8911,34349,23,8911,0,34349
"Democratic Republic of the Congo","2024-12-30",0,0,8911,34349,73,8984,0,34349
"Democratic Republic of the Congo","2024-12-31",0,0,8911,34349,73,9057,0,34349
"Democratic Republic of the Congo","2025-01-01",0,0,8911,34349,73,9130,0,34349
"Democratic Republic of the Congo","2025-01-02",0,0,8911,34349,74,9204,0,34349
"Democratic Republic of the Congo","2025-01-03",0,0,8911,34349,73,9277,0,34349
"Democratic Republic of the Congo","2025-01-04",0,0,8911,34349,73,9350,0,34349
"Democratic Republic of the Congo","2025-01-05",0,512,9423,34349,73,9423,0,34349
"Democratic Republic of the Congo","2025-01-06",0,0,9423,34349,94,9517,0,34349
"Democratic Republic of the Congo","2025-01-07",0,0,9423,34349,94,9611,0,34349
"Democratic Republic of the Congo","2025-01-08",0,0,9423,34349,94,9705,0,34349
"Democratic Republic of the Congo","2025-01-09",0,0,9423,34349,94,9799,0,34349
"Democratic Republic of the Congo","2025-01-10",0,0,9423,34349,94,9893,0,34349
"Democratic Republic of the Congo","2025-01-11",0,0,9423,34349,94,9987,0,34349
"Democratic Republic of the Congo","2025-01-12",0,658,10081,34349,94,10081,0,34349
"Democratic Republic of the Congo","2025-01-13",0,0,10081,34349,74,10155,0,34349
"Democratic Republic of the Congo","2025-01-14",0,0,10081,34349,73,10228,0,34349
"Democratic Republic of the Congo","2025-01-15",0,0,10081,34349,74,10302,0,34349
"Democratic Republic of the Congo","2025-01-16",0,0,10081,34349,74,10376,0,34349
"Democratic Republic of the Congo","2025-01-17",0,0,10081,34349,74,10450,0,34349
"Democratic Republic of the Congo","2025-01-18",0,0,10081,34349,73,10523,0,34349
"Democratic Republic of the Congo","2025-01-19",0,516,10597,34349,74,10597,0,34349
"Democratic Republic of the Congo","2025-01-20",0,0,10597,34349,69,10666,0,34349
"Democratic Republic of the Congo","2025-01-21",0,0,10597,34349,68,10734,0,34349
"Democratic Republic of the Congo","2025-01-22",0,0,10597,34349,69,10803,0,34349
"Democratic Republic of the Congo","2025-01-23",0,0,10597,34349,69,10872,0,34349
"Democratic Republic of the Congo","2025-01-24",0,0,10597,34349,69,10941,0,34349
"Democratic Republic of the Congo","2025-01-25",0,0,10597,34349,68,11009,0,34349
"Democratic Republic of the Congo","2025-01-26",0,481,11078,34349,69,11078,0,34349
"Democratic Republic of the Congo","2025-01-27",0,0,11078,34349,0,11078,0,34349
"Democratic Republic of the Congo","2025-01-28",0,0,11078,34349,0,11078,0,34349
"Democratic Republic of the Congo","2025-01-29",0,0,11078,34349,0,11078,0,34349
"Democratic Republic of the Congo","2025-01-30",0,0,11078,34349,0,11078,0,34349
"Democratic Republic of the Congo","2025-01-31",0,0,11078,34349,0,11078,0,34349
"Democratic Republic of the Congo","2025-02-01",0,0,11078,34349,0,11078,0,34349
"Democratic Republic of the Congo","2025-02-02",0,0,11078,34349,0,11078,0,34349
"Democratic Republic of the Congo","2025-02-03",0,0,11078,34349,0,11078,0,34349
"Democratic Republic of the Congo","2025-02-04",0,0,11078,34349,0,11078,0,34349
"Democratic Republic of the Congo","2025-02-05",0,0,11078,34349,0,11078,0,34349
"Democratic Republic of the Congo","2025-02-06",0,0,11078,34349,0,11078,0,34349
"Democratic Republic of the Congo","2025-02-07",0,0,11078,34349,0,11078,0,34349
"Democratic Republic of the Congo","2025-02-08",0,0,11078,34349,0,11078,0,34349
"Democratic Republic of the Congo","2025-02-09",0,0,11078,34349,0,11078,0,34349
"Democratic Republic of the Congo","2025-02-10",0,0,11078,34349,0,11078,0,34349
"Democratic Republic of the Congo","2025-02-11",0,0,11078,34349,0,11078,0,34349
"Democratic Republic of the Congo","2025-02-12",0,0,11078,34349,0,11078,0,34349
"Democratic Republic of the Congo","2025-02-13",0,0,11078,34349,0,11078,0,34349
"Democratic Republic of the Congo","2025-02-14",0,0,11078,34349,0,11078,0,34349
"Democratic Republic of the Congo","2025-02-15",0,0,11078,34349,0,11078,0,34349
"Democratic Republic of the Congo","2025-02-16",0,0,11078,34349,0,11078,0,34349
"Democratic Republic of the Congo","2025-02-17",0,0,11078,34349,0,11078,0,34349
"Democratic Republic of the Congo","2025-02-18",0,0,11078,34349,0,11078,0,34349
"Democratic Republic of the Congo","2025-02-19",0,0,11078,34349,0,11078,0,34349
"Democratic Republic of the Congo","2025-02-20",0,0,11078,34349,0,11078,0,34349
"Democratic Republic of the Congo","2025-02-21",0,0,11078,34349,0,11078,0,34349
"Democratic Republic of the Congo","2025-02-22",0,0,11078,34349,0,11078,0,34349
"Democratic Republic of the Congo","2025-02-23",0,0,11078,34349,0,11078,0,34349
"Democratic Republic of the Congo","2025-02-24",0,0,11078,34349,0,11078,0,34349
"Democratic Republic of the Congo","2025-02-25",0,0,11078,34349,0,11078,0,34349
"Democratic Republic of the Congo","2025-02-26",0,0,11078,34349,0,11078,0,34349
"Democratic Republic of the Congo","2025-02-27",0,0,11078,34349,0,11078,0,34349
"Democratic Republic of the Congo","2025-02-28",0,0,11078,34349,0,11078,0,34349
"Democratic Republic of the Congo","2025-03-01",0,0,11078,34349,0,11078,0,34349
"Democratic Republic of the Congo","2025-03-02",0,0,11078,34349,0,11078,0,34349
"Democratic Republic of the Congo","2025-03-03",0,0,11078,34349,0,11078,0,34349
"Denmark","2024-01-01",0,0,0,0,0,0,0,0
"Denmark","2024-01-02",0,0,0,0,0,0,0,0
"Denmark","2024-01-03",0,0,0,0,0,0,0,0
"Denmark","2024-01-04",0,0,0,0,0,0,0,0
"Denmark","2024-01-05",0,0,0,0,0,0,0,0
"Denmark","2024-01-06",0,0,0,0,0,0,0,0
"Denmark","2024-01-07",0,0,0,0,0,0,0,0
"Denmark","2024-01-08",0,0,0,0,0,0,0,0
"Denmark","2024-01-09",0,0,0,0,0,0,0,0
"Denmark","2024-01-10",0,0,0,0,0,0,0,0
"Denmark","2024-01-11",0,0,0,0,0,0,0,0
"Denmark","2024-01-12",0,0,0,0,0,0,0,0
"Denmark","2024-01-13",0,0,0,0,0,0,0,0
"Denmark","2024-01-14",0,0,0,0,0,0,0,0
"Denmark","2024-01-15",0,0,0,0,0,0,0,0
"Denmark","2024-01-16",0,0,0,0,0,0,0,0
"Denmark","2024-01-17",0,0,0,0,0,0,0,0
"Denmark","2024-01-18",0,0,0,0,0,0,0,0
"Denmark","2024-01-19",0,0,0,0,0,0,0,0
"Denmark","2024-01-20",0,0,0,0,0,0,0,0
"Denmark","2024-01-21",0,0,0,0,0,0,0,0
"Denmark","2024-01-22",0,0,0,0,0,0,0,0
"Denmark","2024-01-23",0,0,0,0,0,0,0,0
"Denmark","2024-01-24",0,0,0,0,0,0,0,0
"Denmark","2024-01-25",0,0,0,0,0,0,0,0
"Denmark","2024-01-26",0,0,0,0,0,0,0,0
"Denmark","2024-01-27",0,0,0,0,0,0,0,0
"Denmark","2024-01-28",0,0,0,0,0,0,0,0
"Denmark","2024-01-29",0,0,0,0,0,0,0,0
"Denmark","2024-01-30",0,0,0,0,0,0,0,0
"Denmark","2024-01-31",0,0,0,0,0,0,0,0
"Denmark","2024-02-01",0,0,0,0,0,0,0,0
"Denmark","2024-02-02",0,0,0,0,0,0,0,0
"Denmark","2024-02-03",0,0,0,0,0,0,0,0
"Denmark","2024-02-04",0,0,0,0,0,0,0,0
"Denmark","2024-02-05",0,0,0,0,0,0,0,0
"Denmark","2024-02-06",0,0,0,0,0,0,0,0
"Denmark","2024-02-07",0,0,0,0,0,0,0,0
"Denmark","2024-02-08",0,0,0,0,0,0,0,0
"Denmark","2024-02-09",0,0,0,0,0,0,0,0
"Denmark","2024-02-10",0,0,0,0,0,0,0,0
"Denmark","2024-02-11",0,0,0,0,0,0,0,0
"Denmark","2024-02-12",0,0,0,0,0,0,0,0
"Denmark","2024-02-13",0,0,0,0,0,0,0,0
"Denmark","2024-02-14",0,0,0,0,0,0,0,0
"Denmark","2024-02-15",0,0,0,0,0,0,0,0
"Denmark","2024-02-16",0,0,0,0,0,0,0,0
"Denmark","2024-02-17",0,0,0,0,0,0,0,0
"Denmark","2024-02-18",0,0,0,0,0,0,0,0
"Denmark","2024-02-19",0,0,0,0,0,0,0,0
"Denmark","2024-02-20",0,0,0,0,0,0,0,0
"Denmark","2024-02-21",0,0,0,0,0,0,0,0
"Denmark","2024-02-22",0,0,0,0,0,0,0,0
"Denmark","2024-02-23",0,0,0,0,0,0,0,0
"Denmark","2024-02-24",0,0,0,0,0,0,0,0
"Denmark","2024-02-25",0,0,0,0,0,0,0,0
"Denmark","2024-02-26",0,0,0,0,0,0,0,0
"Denmark","2024-02-27",0,0,0,0,0,0,0,0
"Denmark","2024-02-28",0,0,0,0,0,0,0,0
"Denmark","2024-02-29",0,0,0,0,0,0,0,0
"Denmark","2024-03-01",0,0,0,0,0,0,0,0
"Denmark","2024-03-02",0,0,0,0,0,0,0,0
"Denmark","2024-03-03",0,0,0,0,0,0,0,0
"Denmark","2024-03-04",0,0,0,0,0,0,0,0
"Denmark","2024-03-05",0,0,0,0,0,0,0,0
"Denmark","2024-03-06",0,0,0,0,0,0,0,0
"Denmark","2024-03-07",0,0,0,0,0,0,0,0
"Denmark","2024-03-08",0,0,0,0,0,0,0,0
"Denmark","2024-03-09",0,0,0,0,0,0,0,0
"Denmark","2024-03-10",0,0,0,0,0,0,0,0
"Denmark","2024-03-11",0,0,0,0,0,0,0,0
"Denmark","2024-03-12",0,0,0,0,0,0,0,0
"Denmark","2024-03-13",0,0,0,0,0,0,0,0
"Denmark","2024-03-14",0,0,0,0,0,0,0,0
"Denmark","2024-03-15",0,0,0,0,0,0,0,0
"Denmark","2024-03-16",0,0,0,0,0,0,0,0
"Denmark","2024-03-17",0,0,0,0,0,0,0,0
"Denmark","2024-03-18",0,0,0,0,0,0,0,0
"Denmark","2024-03-19",0,0,0,0,0,0,0,0
"Denmark","2024-03-20",0,0,0,0,0,0,0,0
"Denmark","2024-03-21",0,0,0,0,0,0,0,0
"Denmark","2024-03-22",0,0,0,0,0,0,0,0
"Denmark","2024-03-23",0,0,0,0,0,0,0,0
"Denmark","2024-03-24",0,0,0,0,0,0,0,0
"Denmark","2024-03-25",0,0,0,0,0,0,0,0
"Denmark","2024-03-26",0,0,0,0,0,0,0,0
"Denmark","2024-03-27",0,0,0,0,0,0,0,0
"Denmark","2024-03-28",0,0,0,0,0,0,0,0
"Denmark","2024-03-29",0,0,0,0,0,0,0,0
"Denmark","2024-03-30",0,0,0,0,0,0,0,0
"Denmark","2024-03-31",0,0,0,0,0,0,0,0
"Denmark","2024-04-01",0,0,0,0,0,0,0,0
"Denmark","2024-04-02",0,0,0,0,0,0,0,0
"Denmark","2024-04-03",0,0,0,0,0,0,0,0
"Denmark","2024-04-04",0,0,0,0,0,0,0,0
"Denmark","2024-04-05",0,0,0,0,0,0,0,0
"Denmark","2024-04-06",0,0,0,0,0,0,0,0
"Denmark","2024-04-07",0,0,0,0,0,0,0,0
"Denmark","2024-04-08",0,0,0,0,0,0,0,0
"Denmark","2024-04-09",0,0,0,0,0,0,0,0
"Denmark","2024-04-10",0,0,0,0,0,0,0,0
"Denmark","2024-04-11",0,0,0,0,0,0,0,0
"Denmark","2024-04-12",0,0,0,0,0,0,0,0
"Denmark","2024-04-13",0,0,0,0,0,0,0,0
"Denmark","2024-04-14",0,0,0,0,0,0,0,0
"Denmark","2024-04-15",0,0,0,0,0,0,0,0
"Denmark","2024-04-16",0,0,0,0,0,0,0,0
"Denmark","2024-04-17",0,0,0,0,0,0,0,0
"Denmark","2024-04-18",0,0,0,0,0,0,0,0
"Denmark","2024-04-19",0,0,0,0,0,0,0,0
"Denmark","2024-04-20",0,0,0,0,0,0,0,0
"Denmark","2024-04-21",0,0,0,0,0,0,0,0
"Denmark","2024-04-22",0,0,0,0,0,0,0,0
"Denmark","2024-04-23",0,0,0,0,0,0,0,0
"Denmark","2024-04-24",0,0,0,0,0,0,0,0
"Denmark","2024-04-25",0,0,0,0,0,0,0,0
"Denmark","2024-04-26",0,0,0,0,0,0,0,0
"Denmark","2024-04-27",0,0,0,0,0,0,0,0
"Denmark","2024-04-28",0,0,0,0,0,0,0,0
"Denmark","2024-04-29",0,0,0,0,0,0,0,0
"Denmark","2024-04-30",0,0,0,0,0,0,0,0
"Denmark","2024-05-01",0,0,0,0,0,0,0,0
"Denmark","2024-05-02",0,0,0,0,0,0,0,0
"Denmark","2024-05-03",0,0,0,0,0,0,0,0
"Denmark","2024-05-04",0,0,0,0,0,0,0,0
"Denmark","2024-05-05",0,0,0,0,0,0,0,0
"Denmark","2024-05-06",0,0,0,0,0,0,0,0
"Denmark","2024-05-07",0,0,0,0,0,0,0,0
"Denmark","2024-05-08",0,0,0,0,0,0,0,0
"Denmark","2024-05-09",0,0,0,0,0,0,0,0
"Denmark","2024-05-10",0,0,0,0,0,0,0,0
"Denmark","2024-05-11",0,0,0,0,0,0,0,0
"Denmark","2024-05-12",0,0,0,0,0,0,0,0
"Denmark","2024-05-13",0,0,0,0,0,0,0,0
"Denmark","2024-05-14",0,0,0,0,0,0,0,0
"Denmark","2024-05-15",0,0,0,0,0,0,0,0
"Denmark","2024-05-16",0,0,0,0,0,0,0,0
"Denmark","2024-05-17",0,0,0,0,0,0,0,0
"Denmark","2024-05-18",0,0,0,0,0,0,0,0
"Denmark","2024-05-19",0,0,0,0,0,0,0,0
"Denmark","2024-05-20",0,0,0,0,0,0,0,0
"Denmark","2024-05-21",0,0,0,0,0,0,0,0
"Denmark","2024-05-22",0,0,0,0,0,0,0,0
"Denmark","2024-05-23",0,0,0,0,0,0,0,0
"Denmark","2024-05-24",0,0,0,0,0,0,0,0
"Denmark","2024-05-25",0,0,0,0,0,0,0,0
"Denmark","2024-05-26",0,0,0,0,0,0,0,0
"Denmark","2024-05-27",0,0,0,0,0,0,0,0
"Denmark","2024-05-28",0,0,0,0,0,0,0,0
"Denmark","2024-05-29",0,0,0,0,0,0,0,0
"Denmark","2024-05-30",0,0,0,0,0,0,0,0
"Denmark","2024-05-31",0,0,0,0,0,0,0,0
"Denmark","2024-06-01",0,0,0,0,0,0,0,0
"Denmark","2024-06-02",0,0,0,0,0,0,0,0
"Denmark","2024-06-03",0,0,0,0,0,0,0,0
"Denmark","2024-06-04",0,0,0,0,0,0,0,0
"Denmark","2024-06-05",0,0,0,0,0,0,0,0
"Denmark","2024-06-06",0,0,0,0,0,0,0,0
"Denmark","2024-06-07",0,0,0,0,0,0,0,0
"Denmark","2024-06-08",0,0,0,0,0,0,0,0
"Denmark","2024-06-09",0,0,0,0,0,0,0,0
"Denmark","2024-06-10",0,0,0,0,0,0,0,0
"Denmark","2024-06-11",0,0,0,0,0,0,0,0
"Denmark","2024-06-12",0,0,0,0,0,0,0,0
"Denmark","2024-06-13",0,0,0,0,0,0,0,0
"Denmark","2024-06-14",0,0,0,0,0,0,0,0
"Denmark","2024-06-15",0,0,0,0,0,0,0,0
"Denmark","2024-06-16",0,0,0,0,0,0,0,0
"Denmark","2024-06-17",0,0,0,0,0,0,0,0
"Denmark","2024-06-18",0,0,0,0,0,0,0,0
"Denmark","2024-06-19",0,0,0,0,0,0,0,0
"Denmark","2024-06-20",0,0,0,0,0,0,0,0
"Denmark","2024-06-21",0,0,0,0,0,0,0,0
"Denmark","2024-06-22",0,0,0,0,0,0,0,0
"Denmark","2024-06-23",0,0,0,0,0,0,0,0
"Denmark","2024-06-24",0,0,0,0,0,0,0,0
"Denmark","2024-06-25",0,0,0,0,0,0,0,0
"Denmark","2024-06-26",0,0,0,0,0,0,0,0
"Denmark","2024-06-27",0,0,0,0,0,0,0,0
"Denmark","2024-06-28",0,0,0,0,0,0,0,0
"Denmark","2024-06-29",0,0,0,0,0,0,0,0
"Denmark","2024-06-30",0,0,0,0,0,0,0,0
"Denmark","2024-07-01",0,0,0,0,0,0,0,0
"Denmark","2024-07-02",0,0,0,0,0,0,0,0
"Denmark","2024-07-03",0,0,0,0,0,0,0,0
"Denmark","2024-07-04",0,0,0,0,0,0,0,0
"Denmark","2024-07-05",0,0,0,0,0,0,0,0
"Denmark","2024-07-06",0,0,0,0,0,0,0,0
"Denmark","2024-07-07",0,0,0,0,0,0,0,0
"Denmark","2024-07-08",0,0,0,0,0,0,0,0
"Denmark","2024-07-09",0,0,0,0,0,0,0,0
"Denmark","2024-07-10",0,0,0,0,0,0,0,0
"Denmark","2024-07-11",0,0,0,0,0,0,0,0
"Denmark","2024-07-12",0,0,0,0,0,0,0,0
"Denmark","2024-07-13",0,0,0,0,0,0,0,0
"Denmark","2024-07-14",0,0,0,0,0,0,0,0
"Denmark","2024-07-15",0,0,0,0,0,0,0,0
"Denmark","2024-07-16",0,0,0,0,0,0,0,0
"Denmark","2024-07-17",0,0,0,0,0,0,0,0
"Denmark","2024-07-18",0,0,0,0,0,0,0,0
"Denmark","2024-07-19",0,0,0,0,0,0,0,0
"Denmark","2024-07-20",0,0,0,0,0,0,0,0
"Denmark","2024-07-21",0,0,0,0,0,0,0,0
"Denmark","2024-07-22",0,0,0,0,0,0,0,0
"Denmark","2024-07-23",0,0,0,0,0,0,0,0
"Denmark","2024-07-24",0,0,0,0,0,0,0,0
"Denmark","2024-07-25",0,0,0,0,0,0,0,0
"Denmark","2024-07-26",0,0,0,0,0,0,0,0
"Denmark","2024-07-27",0,0,0,0,0,0,0,0
"Denmark","2024-07-28",0,0,0,0,0,0,0,0
"Denmark","2024-07-29",0,0,0,0,0,0,0,0
"Denmark","2024-07-30",0,0,0,0,0,0,0,0
"Denmark","2024-07-31",0,5,5,0,5,5,0,0
"Denmark","2024-08-01",0,0,5,0,0,5,0,0
"Denmark","2024-08-02",0,0,5,0,0,5,0,0
"Denmark","2024-08-03",0,0,5,0,0,5,0,0
"Denmark","2024-08-04",0,0,5,0,0,5,0,0
"Denmark","2024-08-05",0,0,5,0,0,5,0,0
"Denmark","2024-08-06",0,0,5,0,0,5,0,0
"Denmark","2024-08-07",0,0,5,0,0,5,0,0
"Denmark","2024-08-08",0,0,5,0,0,5,0,0
"Denmark","2024-08-09",0,0,5,0,0,5,0,0
"Denmark","2024-08-10",0,0,5,0,0,5,0,0
"Denmark","2024-08-11",0,0,5,0,0,5,0,0
"Denmark","2024-08-12",0,0,5,0,0,5,0,0
"Denmark","2024-08-13",0,0,5,0,0,5,0,0
"Denmark","2024-08-14",0,0,5,0,0,5,0,0
"Denmark","2024-08-15",0,0,5,0,0,5,0,0
"Denmark","2024-08-16",0,0,5,0,1,6,0,0
"Denmark","2024-08-17",0,0,5,0,0,6,0,0
"Denmark","2024-08-18",0,0,5,0,0,6,0,0
"Denmark","2024-08-19",0,0,5,0,0,6,0,0
"Denmark","2024-08-20",0,0,5,0,0,6,0,0
"Denmark","2024-08-21",0,0,5,0,0,6,0,0
"Denmark","2024-08-22",0,0,5,0,0,6,0,0
"Denmark","2024-08-23",0,0,5,0,0,6,0,0
"Denmark","2024-08-24",0,0,5,0,0,6,0,0
"Denmark","2024-08-25",0,0,5,0,0,6,0,0
"Denmark","2024-08-26",0,0,5,0,0,6,0,0
"Denmark","2024-08-27",0,0,5,0,0,6,0,0
"Denmark","2024-08-28",0,0,5,0,0,6,0,0
"Denmark","2024-08-29",0,0,5,0,0,6,0,0
"Denmark","2024-08-30",0,0,5,0,0,6,0,0
"Denmark","2024-08-31",0,1,6,0,0,6,0,0
"Denmark","2024-09-01",0,0,6,0,0,6,0,0
"Denmark","2024-09-02",0,0,6,0,0,6,0,0
"Denmark","2024-09-03",0,0,6,0,0,6,0,0
"Denmark","2024-09-04",0,0,6,0,1,7,0,0
"Denmark","2024-09-05",0,0,6,0,0,7,0,0
"Denmark","2024-09-06",0,0,6,0,0,7,0,0
"Denmark","2024-09-07",0,0,6,0,0,7,0,0
"Denmark","2024-09-08",0,0,6,0,0,7,0,0
"Denmark","2024-09-09",0,0,6,0,1,8,0,0
"Denmark","2024-09-10",0,0,6,0,0,8,0,0
"Denmark","2024-09-11",0,0,6,0,0,8,0,0
"Denmark","2024-09-12",0,0,6,0,0,8,0,0
"Denmark","2024-09-13",0,0,6,0,0,8,0,0
"Denmark","2024-09-14",0,0,6,0,0,8,0,0
"Denmark","2024-09-15",0,0,6,0,0,8,0,0
"Denmark","2024-09-16",0,0,6,0,1,9,0,0
"Denmark","2024-09-17",0,0,6,0,0,9,0,0
"Denmark","2024-09-18",0,0,6,0,0,9,0,0
"Denmark","2024-09-19",0,0,6,0,0,9,0,0
"Denmark","2024-09-20",0,0,6,0,0,9,0,0
"Denmark","2024-09-21",0,0,6,0,1,10,0,0
"Denmark","2024-09-22",0,0,6,0,0,10,0,0
"Denmark","2024-09-23",0,0,6,0,0,10,0,0
"Denmark","2024-09-24",0,0,6,0,0,10,0,0
"Denmark","2024-09-25",0,0,6,0,0,10,0,0
"Denmark","2024-09-26",0,0,6,0,0,10,0,0
"Denmark","2024-09-27",0,0,6,0,0,10,0,0
"Denmark","2024-09-28",0,0,6,0,1,11,0,0
"Denmark","2024-09-29",0,0,6,0,0,11,0,0
"Denmark","2024-09-30",0,5,11,0,0,11,0,0
"Denmark","2024-10-01",0,0,11,0,0,11,0,0
"Denmark","2024-10-02",0,0,11,0,0,11,0,0
"Denmark","2024-10-03",0,0,11,0,0,11,0,0
"Denmark","2024-10-04",0,0,11,0,0,11,0,0
"Denmark","2024-10-05",0,0,11,0,0,11,0,0
"Denmark","2024-10-06",0,0,11,0,0,11,0,0
"Denmark","2024-10-07",0,0,11,0,0,11,0,0
"Denmark","2024-10-08",0,0,11,0,0,11,0,0
"Denmark","2024-10-09",0,0,11,0,0,11,0,0
"Denmark","2024-10-10",0,0,11,0,0,11,0,0
"Denmark","2024-10-11",0,0,11,0,0,11,0,0
"Denmark","2024-10-12",0,0,11,0,0,11,0,0
"Denmark","2024-10-13",0,0,11,0,0,11,0,0
"Denmark","2024-10-14",0,0,11,0,0,11,0,0
"Denmark","2024-10-15",0,0,11,0,0,11,0,0
"Denmark","2024-10-16",0,0,11,0,0,11,0,0
"Denmark","2024-10-17",0,0,11,0,0,11,0,0
"Denmark","2024-10-18",0,0,11,0,0,11,0,0
"Denmark","2024-10-19",0,0,11,0,0,11,0,0
"Denmark","2024-10-20",0,0,11,0,0,11,0,0
"Denmark","2024-10-21",0,0,11,0,0,11,0,0
"Denmark","2024-10-22",0,0,11,0,0,11,0,0
"Denmark","2024-10-23",0,0,11,0,0,11,0,0
"Denmark","2024-10-24",0,0,11,0,1,12,0,0
"Denmark","2024-10-25",0,0,11,0,0,12,0,0
"Denmark","2024-10-26",0,0,11,0,0,12,0,0
"Denmark","2024-10-27",0,0,11,0,0,12,0,0
"Denmark","2024-10-28",0,0,11,0,0,12,0,0
"Denmark","2024-10-29",0,0,11,0,0,12,0,0
"Denmark","2024-10-30",0,0,11,0,0,12,0,0
"Denmark","2024-10-31",0,0,11,0,0,12,0,0
"Denmark","2024-11-01",0,0,11,0,0,12,0,0
"Denmark","2024-11-02",0,0,11,0,0,12,0,0
"Denmark","2024-11-03",0,0,11,0,0,12,0,0
"Denmark","2024-11-04",0,0,11,0,0,12,0,0
"Denmark","2024-11-05",0,0,11,0,0,12,0,0
"Denmark","2024-11-06",0,0,11,0,0,12,0,0
"Denmark","2024-11-07",0,0,11,0,0,12,0,0
"Denmark","2024-11-08",0,0,11,0,0,12,0,0
"Denmark","2024-11-09",0,0,11,0,0,12,0,0
"Denmark","2024-11-10",0,0,11,0,0,12,0,0
"Denmark","2024-11-11",0,0,11,0,0,12,0,0
"Denmark","2024-11-12",0,0,11,0,0,12,0,0
"Denmark","2024-11-13",0,0,11,0,0,12,0,0
"Denmark","2024-11-14",0,0,11,0,0,12,0,0
"Denmark","2024-11-15",0,0,11,0,0,12,0,0
"Denmark","2024-11-16",0,0,11,0,0,12,0,0
"Denmark","2024-11-17",0,0,11,0,0,12,0,0
"Denmark","2024-11-18",0,0,11,0,0,12,0,0
"Denmark","2024-11-19",0,0,11,0,0,12,0,0
"Denmark","2024-11-20",0,0,11,0,0,12,0,0
"Denmark","2024-11-21",0,0,11,0,0,12,0,0
"Denmark","2024-11-22",0,0,11,0,0,12,0,0
"Denmark","2024-11-23",0,0,11,0,0,12,0,0
"Denmark","2024-11-24",0,0,11,0,0,12,0,0
"Denmark","2024-11-25",0,0,11,0,0,12,0,0
"Denmark","2024-11-26",0,0,11,0,0,12,0,0
"Denmark","2024-11-27",0,0,11,0,0,12,0,0
"Denmark","2024-11-28",0,0,11,0,0,12,0,0
"Denmark","2024-11-29",0,0,11,0,0,12,0,0
"Denmark","2024-11-30",0,0,11,0,0,12,0,0
"Denmark","2024-12-01",0,0,11,0,0,12,0,0
"Denmark","2024-12-02",0,0,11,0,0,12,0,0
"Denmark","2024-12-03",0,0,11,0,0,12,0,0
"Denmark","2024-12-04",0,0,11,0,0,12,0,0
"Denmark","2024-12-05",0,0,11,0,0,12,0,0
"Denmark","2024-12-06",0,0,11,0,0,12,0,0
"Denmark","2024-12-07",0,0,11,0,0,12,0,0
"Denmark","2024-12-08",0,0,11,0,1,13,0,0
"Denmark","2024-12-09",0,0,11,0,0,13,0,0
"Denmark","2024-12-10",0,0,11,0,0,13,0,0
"Denmark","2024-12-11",0,0,11,0,0,13,0,0
"Denmark","2024-12-12",0,0,11,0,0,13,0,0
"Denmark","2024-12-13",0,0,11,0,0,13,0,0
"Denmark","2024-12-14",0,0,11,0,0,13,0,0
"Denmark","2024-12-15",0,0,11,0,0,13,0,0
"Denmark","2024-12-16",0,0,11,0,0,13,0,0
"Denmark","2024-12-17",0,0,11,0,0,13,0,0
"Denmark","2024-12-18",0,0,11,0,0,13,0,0
"Denmark","2024-12-19",0,0,11,0,0,13,0,0
"Denmark","2024-12-20",0,0,11,0,0,13,0,0
"Denmark","2024-12-21",0,0,11,0,0,13,0,0
"Denmark","2024-12-22",0,0,11,0,0,13,0,0
"Denmark","2024-12-23",0,0,11,0,0,13,0,0
"Denmark","2024-12-24",0,0,11,0,0,13,0,0
"Denmark","2024-12-25",0,0,11,0,0,13,0,0
"Denmark","2024-12-26",0,0,11,0,0,13,0,0
"Denmark","2024-12-27",0,0,11,0,0,13,0,0
"Denmark","2024-12-28",0,0,11,0,0,13,0,0
"Denmark","2024-12-29",0,0,11,0,0,13,0,0
"Denmark","2024-12-30",0,0,11,0,0,13,0,0
"Denmark","2024-12-31",0,2,13,0,0,13,0,0
"Denmark","2025-01-01",0,0,13,0,0,13,0,0
"Denmark","2025-01-02",0,0,13,0,1,14,0,0
"Denmark","2025-01-03",0,0,13,0,1,15,0,0
"Denmark","2025-01-04",0,0,13,0,0,15,0,0
"Denmark","2025-01-05",0,0,13,0,0,15,0,0
"Denmark","2025-01-06",0,0,13,0,1,16,0,0
"Denmark","2025-01-07",0,0,13,0,1,17,0,0
"Denmark","2025-01-08",0,0,13,0,0,17,0,0
"Denmark","2025-01-09",0,0,13,0,0,17,0,0
"Denmark","2025-01-10",0,5,18,0,1,18,0,0
"Denmark","2025-01-11",0,0,18,0,0,18,0,0
"Denmark","2025-01-12",0,0,18,0,0,18,0,0
"Denmark","2025-01-13",0,0,18,0,0,18,0,0
"Denmark","2025-01-14",0,0,18,0,0,18,0,0
"Denmark","2025-01-15",0,0,18,0,0,18,0,0
"Denmark","2025-01-16",0,0,18,0,0,18,0,0
"Denmark","2025-01-17",0,0,18,0,0,18,0,0
"Denmark","2025-01-18",0,0,18,0,0,18,0,0
"Denmark","2025-01-19",0,0,18,0,0,18,0,0
"Denmark","2025-01-20",0,0,18,0,0,18,0,0
"Denmark","2025-01-21",0,0,18,0,0,18,0,0
"Denmark","2025-01-22",0,0,18,0,0,18,0,0
"Denmark","2025-01-23",0,0,18,0,0,18,0,0
"Denmark","2025-01-24",0,0,18,0,0,18,0,0
"Denmark","2025-01-25",0,0,18,0,0,18,0,0
"Denmark","2025-01-26",0,0,18,0,0,18,0,0
"Denmark","2025-01-27",0,0,18,0,0,18,0,0
"Denmark","2025-01-28",0,0,18,0,0,18,0,0
"Denmark","2025-01-29",0,0,18,0,0,18,0,0
"Denmark","2025-01-30",0,0,18,0,0,18,0,0
"Denmark","2025-01-31",0,0,18,0,0,18,0,0
"Denmark","2025-02-01",0,0,18,0,0,18,0,0
"Denmark","2025-02-02",0,0,18,0,0,18,0,0
"Denmark","2025-02-03",0,0,18,0,0,18,0,0
"Denmark","2025-02-04",0,0,18,0,0,18,0,0
"Denmark","2025-02-05",0,0,18,0,0,18,0,0
"Denmark","2025-02-06",0,0,18,0,0,18,0,0
"Denmark","2025-02-07",0,0,18,0,0,18,0,0
"Denmark","2025-02-08",0,0,18,0,0,18,0,0
"Denmark","2025-02-09",0,0,18,0,0,18,0,0
"Denmark","2025-02-10",0,0,18,0,0,18,0,0
"Denmark","2025-02-11",0,0,18,0,0,18,0,0
"Denmark","2025-02-12",0,0,18,0,0,18,0,0
"Denmark","2025-02-13",0,0,18,0,0,18,0,0
"Denmark","2025-02-14",0,0,18,0,0,18,0,0
"Denmark","2025-02-15",0,0,18,0,0,18,0,0
"Denmark","2025-02-16",0,0,18,0,0,18,0,0
"Denmark","2025-02-17",0,0,18,0,0,18,0,0
"Denmark","2025-02-18",0,0,18,0,0,18,0,0
"Denmark","2025-02-19",0,0,18,0,0,18,0,0
"Denmark","2025-02-20",0,0,18,0,0,18,0,0
"Denmark","2025-02-21",0,0,18,0,0,18,0,0
"Denmark","2025-02-22",0,0,18,0,0,18,0,0
"Denmark","2025-02-23",0,0,18,0,0,18,0,0
"Denmark","2025-02-24",0,0,18,0,0,18,0,0
"Denmark","2025-02-25",0,0,18,0,0,18,0,0
"Denmark","2025-02-26",0,0,18,0,0,18,0,0
"Denmark","2025-02-27",0,0,18,0,0,18,0,0
"Denmark","2025-02-28",0,0,18,0,0,18,0,0
"Denmark","2025-03-01",0,0,18,0,0,18,0,0
"Denmark","2025-03-02",0,0,18,0,0,18,0,0
"Denmark","2025-03-03",0,0,18,0,0,18,0,0
"Dominican Republic","2024-01-01",0,0,0,0,0,0,0,0
"Dominican Republic","2024-01-02",0,0,0,0,0,0,0,0
"Dominican Republic","2024-01-03",0,0,0,0,0,0,0,0
"Dominican Republic","2024-01-04",0,0,0,0,0,0,0,0
"Dominican Republic","2024-01-05",0,0,0,0,0,0,0,0
"Dominican Republic","2024-01-06",0,0,0,0,0,0,0,0
"Dominican Republic","2024-01-07",0,0,0,0,0,0,0,0
"Dominican Republic","2024-01-08",0,0,0,0,0,0,0,0
"Dominican Republic","2024-01-09",0,0,0,0,0,0,0,0
"Dominican Republic","2024-01-10",0,0,0,0,0,0,0,0
"Dominican Republic","2024-01-11",0,0,0,0,0,0,0,0
"Dominican Republic","2024-01-12",0,0,0,0,0,0,0,0
"Dominican Republic","2024-01-13",0,0,0,0,0,0,0,0
"Dominican Republic","2024-01-14",0,0,0,0,0,0,0,0
"Dominican Republic","2024-01-15",0,0,0,0,0,0,0,0
"Dominican Republic","2024-01-16",0,0,0,0,0,0,0,0
"Dominican Republic","2024-01-17",0,0,0,0,0,0,0,0
"Dominican Republic","2024-01-18",0,0,0,0,0,0,0,0
"Dominican Republic","2024-01-19",0,0,0,0,0,0,0,0
"Dominican Republic","2024-01-20",0,0,0,0,0,0,0,0
"Dominican Republic","2024-01-21",0,0,0,0,0,0,0,0
"Dominican Republic","2024-01-22",0,0,0,0,0,0,0,0
"Dominican Republic","2024-01-23",0,0,0,0,0,0,0,0
"Dominican Republic","2024-01-24",0,0,0,0,0,0,0,0
"Dominican Republic","2024-01-25",0,0,0,0,0,0,0,0
"Dominican Republic","2024-01-26",0,0,0,0,0,0,0,0
"Dominican Republic","2024-01-27",0,0,0,0,0,0,0,0
"Dominican Republic","2024-01-28",0,0,0,0,0,0,0,0
"Dominican Republic","2024-01-29",0,0,0,0,0,0,0,0
"Dominican Republic","2024-01-30",0,0,0,0,0,0,0,0
"Dominican Republic","2024-01-31",0,0,0,0,0,0,0,0
"Dominican Republic","2024-02-01",0,0,0,0,0,0,0,0
"Dominican Republic","2024-02-02",0,0,0,0,0,0,0,0
"Dominican Republic","2024-02-03",0,0,0,0,0,0,0,0
"Dominican Republic","2024-02-04",0,0,0,0,0,0,0,0
"Dominican Republic","2024-02-05",0,0,0,0,0,0,0,0
"Dominican Republic","2024-02-06",0,0,0,0,0,0,0,0
"Dominican Republic","2024-02-07",0,0,0,0,0,0,0,0
"Dominican Republic","2024-02-08",0,0,0,0,0,0,0,0
"Dominican Republic","2024-02-09",0,0,0,0,0,0,0,0
"Dominican Republic","2024-02-10",0,0,0,0,0,0,0,0
"Dominican Republic","2024-02-11",0,0,0,0,0,0,0,0
"Dominican Republic","2024-02-12",0,0,0,0,0,0,0,0
"Dominican Republic","2024-02-13",0,0,0,0,0,0,0,0
"Dominican Republic","2024-02-14",0,0,0,0,0,0,0,0
"Dominican Republic","2024-02-15",0,0,0,0,0,0,0,0
"Dominican Republic","2024-02-16",0,0,0,0,0,0,0,0
"Dominican Republic","2024-02-17",0,0,0,0,0,0,0,0
"Dominican Republic","2024-02-18",0,0,0,0,0,0,0,0
"Dominican Republic","2024-02-19",0,0,0,0,0,0,0,0
"Dominican Republic","2024-02-20",0,2,2,0,2,2,0,0
"Dominican Republic","2024-02-21",0,0,2,0,0,2,0,0
"Dominican Republic","2024-02-22",0,0,2,0,1,3,0,0
"Dominican Republic","2024-02-23",0,0,2,0,0,3,0,0
"Dominican Republic","2024-02-24",0,0,2,0,0,3,0,0
"Dominican Republic","2024-02-25",0,0,2,0,0,3,0,0
"Dominican Republic","2024-02-26",0,0,2,0,1,4,0,0
"Dominican Republic","2024-02-27",0,2,4,0,0,4,0,0
"Dominican Republic","2024-02-28",0,0,4,0,0,4,0,0
"Dominican Republic","2024-02-29",0,0,4,0,0,4,0,0
"Dominican Republic","2024-03-01",0,0,4,0,0,4,0,0
"Dominican Republic","2024-03-02",0,0,4,0,0,4,0,0
"Dominican Republic","2024-03-03",0,0,4,0,0,4,0,0
"Dominican Republic","2024-03-04",0,0,4,0,0,4,0,0
"Dominican Republic","2024-03-05",0,0,4,0,0,4,0,0
"Dominican Republic","2024-03-06",0,0,4,0,1,5,0,0
"Dominican Republic","2024-03-07",0,0,4,0,0,5,0,0
"Dominican Republic","2024-03-08",0,0,4,0,0,5,0,0
"Dominican Republic","2024-03-09",0,0,4,0,0,5,0,0
"Dominican Republic","2024-03-10",0,0,4,0,0,5,0,0
"Dominican Republic","2024-03-11",0,0,4,0,0,5,0,0
"Dominican Republic","2024-03-12",0,1,5,0,0,5,0,0
"Dominican Republic","2024-03-13",0,0,5,0,0,5,0,0
"Dominican Republic","2024-03-14",0,0,5,0,0,5,0,0
"Dominican Republic","2024-03-15",0,0,5,0,0,5,0,0
"Dominican Republic","2024-03-16",0,0,5,0,1,6,0,0
"Dominican Republic","2024-03-17",0,0,5,0,0,6,0,0
"Dominican Republic","2024-03-18",0,0,5,0,0,6,0,0
"Dominican Republic","2024-03-19",0,1,6,0,0,6,0,0
"Dominican Republic","2024-03-20",0,0,6,0,0,6,0,0
"Dominican Republic","2024-03-21",0,0,6,0,0,6,0,0
"Dominican Republic","2024-03-22",0,0,6,0,0,6,0,0
"Dominican Republic","2024-03-23",0,0,6,0,0,6,0,0
"Dominican Republic","2024-03-24",0,0,6,0,0,6,0,0
"Dominican Republic","2024-03-25",0,0,6,0,0,6,0,0
"Dominican Republic","2024-03-26",0,0,6,0,0,6,0,0
"Dominican Republic","2024-03-27",0,0,6,0,0,6,0,0
"Dominican Republic","2024-03-28",0,0,6,0,0,6,0,0
"Dominican Republic","2024-03-29",0,0,6,0,0,6,0,0
"Dominican Republic","2024-03-30",0,0,6,0,0,6,0,0
"Dominican Republic","2024-03-31",0,0,6,0,0,6,0,0
"Dominican Republic","2024-04-01",0,0,6,0,0,6,0,0
"Dominican Republic","2024-04-02",0,0,6,0,0,6,0,0
"Dominican Republic","2024-04-03",0,0,6,0,1,7,0,0
"Dominican Republic","2024-04-04",0,0,6,0,0,7,0,0
"Dominican Republic","2024-04-05",0,0,6,0,0,7,0,0
"Dominican Republic","2024-04-06",0,0,6,0,0,7,0,0
"Dominican Republic","2024-04-07",0,0,6,0,0,7,0,0
"Dominican Republic","2024-04-08",0,0,6,0,0,7,0,0
"Dominican Republic","2024-04-09",0,0,6,0,0,7,0,0
"Dominican Republic","2024-04-10",0,0,6,0,0,7,0,0
"Dominican Republic","2024-04-11",0,0,6,0,0,7,0,0
"Dominican Republic","2024-04-12",0,0,6,0,0,7,0,0
"Dominican Republic","2024-04-13",0,0,6,0,0,7,0,0
"Dominican Republic","2024-04-14",0,0,6,0,0,7,0,0
"Dominican Republic","2024-04-15",0,0,6,0,0,7,0,0
"Dominican Republic","2024-04-16",0,1,7,0,0,7,0,0
"Dominican Republic","2024-04-17",0,0,7,0,0,7,0,0
"Dominican Republic","2024-04-18",0,0,7,0,0,7,0,0
"Dominican Republic","2024-04-19",0,0,7,0,0,7,0,0
"Dominican Republic","2024-04-20",0,0,7,0,1,8,0,0
"Dominican Republic","2024-04-21",0,0,7,0,0,8,0,0
"Dominican Republic","2024-04-22",0,0,7,0,0,8,0,0
"Dominican Republic","2024-04-23",0,1,8,0,0,8,0,0
"Dominican Republic","2024-04-24",0,0,8,0,0,8,0,0
"Dominican Republic","2024-04-25",0,0,8,0,0,8,0,0
"Dominican Republic","2024-04-26",0,0,8,0,0,8,0,0
"Dominican Republic","2024-04-27",0,0,8,0,0,8,0,0
"Dominican Republic","2024-04-28",0,0,8,0,0,8,0,0
"Dominican Republic","2024-04-29",0,0,8,0,0,8,0,0
"Dominican Republic","2024-04-30",0,0,8,0,0,8,0,0
"Dominican Republic","2024-05-01",0,0,8,0,0,8,0,0
"Dominican Republic","2024-05-02",0,0,8,0,0,8,0,0
"Dominican Republic","2024-05-03",0,0,8,0,0,8,0,0
"Dominican Republic","2024-05-04",0,0,8,0,0,8,0,0
"Dominican Republic","2024-05-05",0,0,8,0,0,8,0,0
"Dominican Republic","2024-05-06",0,0,8,0,0,8,0,0
"Dominican Republic","2024-05-07",0,0,8,0,0,8,0,0
"Dominican Republic","2024-05-08",0,0,8,0,0,8,0,0
"Dominican Republic","2024-05-09",0,0,8,0,0,8,0,0
"Dominican Republic","2024-05-10",0,0,8,0,0,8,0,0
"Dominican Republic","2024-05-11",0,0,8,0,0,8,0,0
"Dominican Republic","2024-05-12",0,0,8,0,0,8,0,0
"Dominican Republic","2024-05-13",0,0,8,0,0,8,0,0
"Dominican Republic","2024-05-14",0,0,8,0,0,8,0,0
"Dominican Republic","2024-05-15",0,0,8,0,0,8,0,0
"Dominican Republic","2024-05-16",0,0,8,0,0,8,0,0
"Dominican Republic","2024-05-17",0,0,8,0,0,8,0,0
"Dominican Republic","2024-05-18",0,0,8,0,0,8,0,0
"Dominican Republic","2024-05-19",0,0,8,0,0,8,0,0
"Dominican Republic","2024-05-20",0,0,8,0,0,8,0,0
"Dominican Republic","2024-05-21",0,0,8,0,0,8,0,0
"Dominican Republic","2024-05-22",0,0,8,0,0,8,0,0
"Dominican Republic","2024-05-23",0,0,8,0,0,8,0,0
"Dominican Republic","2024-05-24",0,0,8,0,0,8,0,0
"Dominican Republic","2024-05-25",0,0,8,0,0,8,0,0
"Dominican Republic","2024-05-26",0,0,8,0,0,8,0,0
"Dominican Republic","2024-05-27",0,0,8,0,0,8,0,0
"Dominican Republic","2024-05-28",0,0,8,0,0,8,0,0
"Dominican Republic","2024-05-29",0,0,8,0,0,8,0,0
"Dominican Republic","2024-05-30",0,0,8,0,0,8,0,0
"Dominican Republic","2024-05-31",0,0,8,0,0,8,0,0
"Dominican Republic","2024-06-01",0,0,8,0,0,8,0,0
"Dominican Republic","2024-06-02",0,0,8,0,0,8,0,0
"Dominican Republic","2024-06-03",0,0,8,0,0,8,0,0
"Dominican Republic","2024-06-04",0,0,8,0,0,8,0,0
"Dominican Republic","2024-06-05",0,0,8,0,0,8,0,0
"Dominican Republic","2024-06-06",0,0,8,0,0,8,0,0
"Dominican Republic","2024-06-07",0,0,8,0,0,8,0,0
"Dominican Republic","2024-06-08",0,0,8,0,0,8,0,0
"Dominican Republic","2024-06-09",0,0,8,0,0,8,0,0
"Dominican Republic","2024-06-10",0,0,8,0,0,8,0,0
"Dominican Republic","2024-06-11",0,0,8,0,0,8,0,0
"Dominican Republic","2024-06-12",0,0,8,0,0,8,0,0
"Dominican Republic","2024-06-13",0,0,8,0,0,8,0,0
"Dominican Republic","2024-06-14",0,0,8,0,0,8,0,0
"Dominican Republic","2024-06-15",0,0,8,0,0,8,0,0
"Dominican Republic","2024-06-16",0,0,8,0,0,8,0,0
"Dominican Republic","2024-06-17",0,0,8,0,0,8,0,0
"Dominican Republic","2024-06-18",0,0,8,0,0,8,0,0
"Dominican Republic","2024-06-19",0,0,8,0,0,8,0,0
"Dominican Republic","2024-06-20",0,0,8,0,0,8,0,0
"Dominican Republic","2024-06-21",0,0,8,0,0,8,0,0
"Dominican Republic","2024-06-22",0,0,8,0,0,8,0,0
"Dominican Republic","2024-06-23",0,0,8,0,0,8,0,0
"Dominican Republic","2024-06-24",0,0,8,0,0,8,0,0
"Dominican Republic","2024-06-25",0,0,8,0,0,8,0,0
"Dominican Republic","2024-06-26",0,0,8,0,0,8,0,0
"Dominican Republic","2024-06-27",0,0,8,0,0,8,0,0
"Dominican Republic","2024-06-28",0,0,8,0,0,8,0,0
"Dominican Republic","2024-06-29",0,0,8,0,0,8,0,0
"Dominican Republic","2024-06-30",0,0,8,0,0,8,0,0
"Dominican Republic","2024-07-01",0,0,8,0,0,8,0,0
"Dominican Republic","2024-07-02",0,0,8,0,0,8,0,0
"Dominican Republic","2024-07-03",0,0,8,0,0,8,0,0
"Dominican Republic","2024-07-04",0,0,8,0,0,8,0,0
"Dominican Republic","2024-07-05",0,0,8,0,0,8,0,0
"Dominican Republic","2024-07-06",0,0,8,0,0,8,0,0
"Dominican Republic","2024-07-07",0,0,8,0,0,8,0,0
"Dominican Republic","2024-07-08",0,0,8,0,0,8,0,0
"Dominican Republic","2024-07-09",0,0,8,0,0,8,0,0
"Dominican Republic","2024-07-10",0,0,8,0,0,8,0,0
"Dominican Republic","2024-07-11",0,0,8,0,0,8,0,0
"Dominican Republic","2024-07-12",0,0,8,0,0,8,0,0
"Dominican Republic","2024-07-13",0,0,8,0,0,8,0,0
"Dominican Republic","2024-07-14",0,0,8,0,0,8,0,0
"Dominican Republic","2024-07-15",0,0,8,0,0,8,0,0
"Dominican Republic","2024-07-16",0,0,8,0,0,8,0,0
"Dominican Republic","2024-07-17",0,0,8,0,0,8,0,0
"Dominican Republic","2024-07-18",0,0,8,0,0,8,0,0
"Dominican Republic","2024-07-19",0,0,8,0,0,8,0,0
"Dominican Republic","2024-07-20",0,0,8,0,0,8,0,0
"Dominican Republic","2024-07-21",0,0,8,0,0,8,0,0
"Dominican Republic","2024-07-22",0,0,8,0,0,8,0,0
"Dominican Republic","2024-07-23",0,0,8,0,0,8,0,0
"Dominican Republic","2024-07-24",0,0,8,0,0,8,0,0
"Dominican Republic","2024-07-25",0,0,8,0,0,8,0,0
"Dominican Republic","2024-07-26",0,0,8,0,0,8,0,0
"Dominican Republic","2024-07-27",0,0,8,0,0,8,0,0
"Dominican Republic","2024-07-28",0,0,8,0,0,8,0,0
"Dominican Republic","2024-07-29",0,0,8,0,0,8,0,0
"Dominican Republic","2024-07-30",0,0,8,0,0,8,0,0
"Dominican Republic","2024-07-31",0,0,8,0,0,8,0,0
"Dominican Republic","2024-08-01",0,0,8,0,0,8,0,0
"Dominican Republic","2024-08-02",0,0,8,0,0,8,0,0
"Dominican Republic","2024-08-03",0,0,8,0,0,8,0,0
"Dominican Republic","2024-08-04",0,0,8,0,0,8,0,0
"Dominican Republic","2024-08-05",0,0,8,0,0,8,0,0
"Dominican Republic","2024-08-06",0,0,8,0,0,8,0,0
"Dominican Republic","2024-08-07",0,0,8,0,0,8,0,0
"Dominican Republic","2024-08-08",0,0,8,0,0,8,0,0
"Dominican Republic","2024-08-09",0,0,8,0,0,8,0,0
"Dominican Republic","2024-08-10",0,0,8,0,0,8,0,0
"Dominican Republic","2024-08-11",0,0,8,0,0,8,0,0
"Dominican Republic","2024-08-12",0,0,8,0,0,8,0,0
"Dominican Republic","2024-08-13",0,0,8,0,0,8,0,0
"Dominican Republic","2024-08-14",0,0,8,0,0,8,0,0
"Dominican Republic","2024-08-15",0,0,8,0,0,8,0,0
"Dominican Republic","2024-08-16",0,0,8,0,0,8,0,0
"Dominican Republic","2024-08-17",0,0,8,0,0,8,0,0
"Dominican Republic","2024-08-18",0,0,8,0,0,8,0,0
"Dominican Republic","2024-08-19",0,0,8,0,0,8,0,0
"Dominican Republic","2024-08-20",0,0,8,0,0,8,0,0
"Dominican Republic","2024-08-21",0,0,8,0,0,8,0,0
"Dominican Republic","2024-08-22",0,0,8,0,0,8,0,0
"Dominican Republic","2024-08-23",0,0,8,0,0,8,0,0
"Dominican Republic","2024-08-24",0,0,8,0,0,8,0,0
"Dominican Republic","2024-08-25",0,0,8,0,0,8,0,0
"Dominican Republic","2024-08-26",0,0,8,0,0,8,0,0
"Dominican Republic","2024-08-27",0,0,8,0,0,8,0,0
"Dominican Republic","2024-08-28",0,0,8,0,0,8,0,0
"Dominican Republic","2024-08-29",0,0,8,0,0,8,0,0
"Dominican Republic","2024-08-30",0,0,8,0,0,8,0,0
"Dominican Republic","2024-08-31",0,0,8,0,0,8,0,0
"Dominican Republic","2024-09-01",0,0,8,0,0,8,0,0
"Dominican Republic","2024-09-02",0,0,8,0,0,8,0,0
"Dominican Republic","2024-09-03",0,0,8,0,0,8,0,0
"Dominican Republic","2024-09-04",0,0,8,0,0,8,0,0
"Dominican Republic","2024-09-05",0,0,8,0,0,8,0,0
"Dominican Republic","2024-09-06",0,0,8,0,0,8,0,0
"Dominican Republic","2024-09-07",0,0,8,0,0,8,0,0
"Dominican Republic","2024-09-08",0,0,8,0,0,8,0,0
"Dominican Republic","2024-09-09",0,0,8,0,0,8,0,0
"Dominican Republic","2024-09-10",0,0,8,0,0,8,0,0
"Dominican Republic","2024-09-11",0,0,8,0,0,8,0,0
"Dominican Republic","2024-09-12",0,0,8,0,0,8,0,0
"Dominican Republic","2024-09-13",0,0,8,0,0,8,0,0
"Dominican Republic","2024-09-14",0,0,8,0,0,8,0,0
"Dominican Republic","2024-09-15",0,0,8,0,0,8,0,0
"Dominican Republic","2024-09-16",0,0,8,0,0,8,0,0
"Dominican Republic","2024-09-17",0,0,8,0,0,8,0,0
"Dominican Republic","2024-09-18",0,0,8,0,0,8,0,0
"Dominican Republic","2024-09-19",0,0,8,0,0,8,0,0
"Dominican Republic","2024-09-20",0,0,8,0,0,8,0,0
"Dominican Republic","2024-09-21",0,0,8,0,0,8,0,0
"Dominican Republic","2024-09-22",0,0,8,0,0,8,0,0
"Dominican Republic","2024-09-23",0,0,8,0,0,8,0,0
"Dominican Republic","2024-09-24",0,0,8,0,0,8,0,0
"Dominican Republic","2024-09-25",0,0,8,0,0,8,0,0
"Dominican Republic","2024-09-26",0,0,8,0,0,8,0,0
"Dominican Republic","2024-09-27",0,0,8,0,0,8,0,0
"Dominican Republic","2024-09-28",0,0,8,0,0,8,0,0
"Dominican Republic","2024-09-29",0,0,8,0,0,8,0,0
"Dominican Republic","2024-09-30",0,0,8,0,0,8,0,0
"Dominican Republic","2024-10-01",0,0,8,0,0,8,0,0
"Dominican Republic","2024-10-02",0,0,8,0,0,8,0,0
"Dominican Republic","2024-10-03",0,0,8,0,0,8,0,0
"Dominican Republic","2024-10-04",0,0,8,0,0,8,0,0
"Dominican Republic","2024-10-05",0,0,8,0,0,8,0,0
"Dominican Republic","2024-10-06",0,0,8,0,0,8,0,0
"Dominican Republic","2024-10-07",0,0,8,0,0,8,0,0
"Dominican Republic","2024-10-08",0,0,8,0,0,8,0,0
"Dominican Republic","2024-10-09",0,0,8,0,0,8,0,0
"Dominican Republic","2024-10-10",0,0,8,0,0,8,0,0
"Dominican Republic","2024-10-11",0,0,8,0,0,8,0,0
"Dominican Republic","2024-10-12",0,0,8,0,0,8,0,0
"Dominican Republic","2024-10-13",0,0,8,0,0,8,0,0
"Dominican Republic","2024-10-14",0,0,8,0,0,8,0,0
"Dominican Republic","2024-10-15",0,0,8,0,0,8,0,0
"Dominican Republic","2024-10-16",0,0,8,0,0,8,0,0
"Dominican Republic","2024-10-17",0,0,8,0,0,8,0,0
"Dominican Republic","2024-10-18",0,0,8,0,0,8,0,0
"Dominican Republic","2024-10-19",0,0,8,0,0,8,0,0
"Dominican Republic","2024-10-20",0,0,8,0,0,8,0,0
"Dominican Republic","2024-10-21",0,0,8,0,0,8,0,0
"Dominican Republic","2024-10-22",0,0,8,0,0,8,0,0
"Dominican Republic","2024-10-23",0,0,8,0,0,8,0,0
"Dominican Republic","2024-10-24",0,0,8,0,0,8,0,0
"Dominican Republic","2024-10-25",0,0,8,0,0,8,0,0
"Dominican Republic","2024-10-26",0,0,8,0,0,8,0,0
"Dominican Republic","2024-10-27",0,0,8,0,0,8,0,0
"Dominican Republic","2024-10-28",0,0,8,0,0,8,0,0
"Dominican Republic","2024-10-29",0,0,8,0,0,8,0,0
"Dominican Republic","2024-10-30",0,0,8,0,0,8,0,0
"Dominican Republic","2024-10-31",0,0,8,0,0,8,0,0
"Dominican Republic","2024-11-01",0,0,8,0,0,8,0,0
"Dominican Republic","2024-11-02",0,0,8,0,0,8,0,0
"Dominican Republic","2024-11-03",0,0,8,0,0,8,0,0
"Dominican Republic","2024-11-04",0,0,8,0,0,8,0,0
"Dominican Republic","2024-11-05",0,0,8,0,0,8,0,0
"Dominican Republic","2024-11-06",0,0,8,0,0,8,0,0
"Dominican Republic","2024-11-07",0,0,8,0,0,8,0,0
"Dominican Republic","2024-11-08",0,0,8,0,0,8,0,0
"Dominican Republic","2024-11-09",0,0,8,0,0,8,0,0
"Dominican Republic","2024-11-10",0,0,8,0,0,8,0,0
"Dominican Republic","2024-11-11",0,0,8,0,0,8,0,0
"Dominican Republic","2024-11-12",0,0,8,0,0,8,0,0
"Dominican Republic","2024-11-13",0,0,8,0,0,8,0,0
"Dominican Republic","2024-11-14",0,0,8,0,0,8,0,0
"Dominican Republic","2024-11-15",0,0,8,0,0,8,0,0
"Dominican Republic","2024-11-16",0,0,8,0,0,8,0,0
"Dominican Republic","2024-11-17",0,0,8,0,0,8,0,0
"Dominican Republic","2024-11-18",0,0,8,0,0,8,0,0
"Dominican Republic","2024-11-19",0,0,8,0,0,8,0,0
"Dominican Republic","2024-11-20",0,0,8,0,0,8,0,0
"Dominican Republic","2024-11-21",0,0,8,0,0,8,0,0
"Dominican Republic","2024-11-22",0,0,8,0,0,8,0,0
"Dominican Republic","2024-11-23",0,0,8,0,0,8,0,0
"Dominican Republic","2024-11-24",0,0,8,0,0,8,0,0
"Dominican Republic","2024-11-25",0,0,8,0,0,8,0,0
"Dominican Republic","2024-11-26",0,0,8,0,0,8,0,0
"Dominican Republic","2024-11-27",0,0,8,0,0,8,0,0
"Dominican Republic","2024-11-28",0,0,8,0,0,8,0,0
"Dominican Republic","2024-11-29",0,0,8,0,0,8,0,0
"Dominican Republic","2024-11-30",0,0,8,0,0,8,0,0
"Dominican Republic","2024-12-01",0,0,8,0,0,8,0,0
"Dominican Republic","2024-12-02",0,0,8,0,0,8,0,0
"Dominican Republic","2024-12-03",0,0,8,0,0,8,0,0
"Dominican Republic","2024-12-04",0,0,8,0,0,8,0,0
"Dominican Republic","2024-12-05",0,0,8,0,0,8,0,0
"Dominican Republic","2024-12-06",0,0,8,0,0,8,0,0
"Dominican Republic","2024-12-07",0,0,8,0,0,8,0,0
"Dominican Republic","2024-12-08",0,0,8,0,0,8,0,0
"Dominican Republic","2024-12-09",0,0,8,0,0,8,0,0
"Dominican Republic","2024-12-10",0,0,8,0,0,8,0,0
"Dominican Republic","2024-12-11",0,0,8,0,0,8,0,0
"Dominican Republic","2024-12-12",0,0,8,0,0,8,0,0
"Dominican Republic","2024-12-13",0,0,8,0,0,8,0,0
"Dominican Republic","2024-12-14",0,0,8,0,0,8,0,0
"Dominican Republic","2024-12-15",0,0,8,0,0,8,0,0
"Dominican Republic","2024-12-16",0,0,8,0,0,8,0,0
"Dominican Republic","2024-12-17",0,0,8,0,0,8,0,0
"Dominican Republic","2024-12-18",0,0,8,0,0,8,0,0
"Dominican Republic","2024-12-19",0,0,8,0,0,8,0,0
"Dominican Republic","2024-12-20",0,0,8,0,0,8,0,0
"Dominican Republic","2024-12-21",0,0,8,0,0,8,0,0
"Dominican Republic","2024-12-22",0,0,8,0,0,8,0,0
"Dominican Republic","2024-12-23",0,0,8,0,0,8,0,0
"Dominican Republic","2024-12-24",0,0,8,0,0,8,0,0
"Dominican Republic","2024-12-25",0,0,8,0,0,8,0,0
"Dominican Republic","2024-12-26",0,0,8,0,0,8,0,0
"Dominican Republic","2024-12-27",0,0,8,0,0,8,0,0
"Dominican Republic","2024-12-28",0,0,8,0,0,8,0,0
"Dominican Republic","2024-12-29",0,0,8,0,0,8,0,0
"Dominican Republic","2024-12-30",0,0,8,0,0,8,0,0
"Dominican Republic","2024-12-31",0,0,8,0,0,8,0,0
"Dominican Republic","2025-01-01",0,0,8,0,0,8,0,0
"Dominican Republic","2025-01-02",0,0,8,0,0,8,0,0
"Dominican Republic","2025-01-03",0,0,8,0,0,8,0,0
"Dominican Republic","2025-01-04",0,0,8,0,0,8,0,0
"Dominican Republic","2025-01-05",0,0,8,0,0,8,0,0
"Dominican Republic","2025-01-06",0,0,8,0,0,8,0,0
"Dominican Republic","2025-01-07",0,0,8,0,0,8,0,0
"Dominican Republic","2025-01-08",0,0,8,0,0,8,0,0
"Dominican Republic","2025-01-09",0,0,8,0,0,8,0,0
"Dominican Republic","2025-01-10",0,0,8,0,0,8,0,0
"Dominican Republic","2025-01-11",0,0,8,0,0,8,0,0
"Dominican Republic","2025-01-12",0,0,8,0,0,8,0,0
"Dominican Republic","2025-01-13",0,0,8,0,0,8,0,0
"Dominican Republic","2025-01-14",0,0,8,0,0,8,0,0
"Dominican Republic","2025-01-15",0,0,8,0,0,8,0,0
"Dominican Republic","2025-01-16",0,0,8,0,0,8,0,0
"Dominican Republic","2025-01-17",0,0,8,0,0,8,0,0
"Dominican Republic","2025-01-18",0,0,8,0,0,8,0,0
"Dominican Republic","2025-01-19",0,0,8,0,0,8,0,0
"Dominican Republic","2025-01-20",0,0,8,0,0,8,0,0
"Dominican Republic","2025-01-21",0,0,8,0,0,8,0,0
"Dominican Republic","2025-01-22",0,0,8,0,0,8,0,0
"Dominican Republic","2025-01-23",0,0,8,0,0,8,0,0
"Dominican Republic","2025-01-24",0,0,8,0,0,8,0,0
"Dominican Republic","2025-01-25",0,0,8,0,0,8,0,0
"Dominican Republic","2025-01-26",0,0,8,0,0,8,0,0
"Dominican Republic","2025-01-27",0,0,8,0,0,8,0,0
"Dominican Republic","2025-01-28",0,0,8,0,0,8,0,0
"Dominican Republic","2025-01-29",0,0,8,0,0,8,0,0
"Dominican Republic","2025-01-30",0,0,8,0,0,8,0,0
"Dominican Republic","2025-01-31",0,0,8,0,0,8,0,0
"Dominican Republic","2025-02-01",0,0,8,0,0,8,0,0
"Dominican Republic","2025-02-02",0,0,8,0,0,8,0,0
"Dominican Republic","2025-02-03",0,0,8,0,0,8,0,0
"Dominican Republic","2025-02-04",0,0,8,0,0,8,0,0
"Dominican Republic","2025-02-05",0,0,8,0,0,8,0,0
"Dominican Republic","2025-02-06",0,0,8,0,0,8,0,0
"Dominican Republic","2025-02-07",0,0,8,0,0,8,0,0
"Dominican Republic","2025-02-08",0,0,8,0,0,8,0,0
"Dominican Republic","2025-02-09",0,0,8,0,0,8,0,0
"Dominican Republic","2025-02-10",0,0,8,0,0,8,0,0
"Dominican Republic","2025-02-11",0,0,8,0,0,8,0,0
"Dominican Republic","2025-02-12",0,0,8,0,0,8,0,0
"Dominican Republic","2025-02-13",0,0,8,0,0,8,0,0
"Dominican Republic","2025-02-14",0,0,8,0,0,8,0,0
"Dominican Republic","2025-02-15",0,0,8,0,0,8,0,0
"Dominican Republic","2025-02-16",0,0,8,0,0,8,0,0
"Dominican Republic","2025-02-17",0,0,8,0,0,8,0,0
"Dominican Republic","2025-02-18",0,0,8,0,0,8,0,0
"Dominican Republic","2025-02-19",0,0,8,0,0,8,0,0
"Dominican Republic","2025-02-20",0,0,8,0,0,8,0,0
"Dominican Republic","2025-02-21",0,0,8,0,0,8,0,0
"Dominican Republic","2025-02-22",0,0,8,0,0,8,0,0
"Dominican Republic","2025-02-23",0,0,8,0,0,8,0,0
"Dominican Republic","2025-02-24",0,0,8,0,0,8,0,0
"Dominican Republic","2025-02-25",0,0,8,0,0,8,0,0
"Dominican Republic","2025-02-26",0,0,8,0,0,8,0,0
"Dominican Republic","2025-02-27",0,0,8,0,0,8,0,0
"Dominican Republic","2025-02-28",0,0,8,0,0,8,0,0
"Dominican Republic","2025-03-01",0,0,8,0,0,8,0,0
"Dominican Republic","2025-03-02",0,0,8,0,0,8,0,0
"Dominican Republic","2025-03-03",0,0,8,0,0,8,0,0
"Ecuador","2024-01-01",0,0,0,0,0,0,0,0
"Ecuador","2024-01-02",0,0,0,0,0,0,0,0
"Ecuador","2024-01-03",0,0,0,0,0,0,0,0
"Ecuador","2024-01-04",0,0,0,0,0,0,0,0
"Ecuador","2024-01-05",0,0,0,0,0,0,0,0
"Ecuador","2024-01-06",0,0,0,0,0,0,0,0
"Ecuador","2024-01-07",0,0,0,0,0,0,0,0
"Ecuador","2024-01-08",0,0,0,0,0,0,0,0
"Ecuador","2024-01-09",0,0,0,0,0,0,0,0
"Ecuador","2024-01-10",0,0,0,0,0,0,0,0
"Ecuador","2024-01-11",0,0,0,0,0,0,0,0
"Ecuador","2024-01-12",0,0,0,0,0,0,0,0
"Ecuador","2024-01-13",0,0,0,0,0,0,0,0
"Ecuador","2024-01-14",0,0,0,0,0,0,0,0
"Ecuador","2024-01-15",0,0,0,0,0,0,0,0
"Ecuador","2024-01-16",0,0,0,0,0,0,0,0
"Ecuador","2024-01-17",0,0,0,0,0,0,0,0
"Ecuador","2024-01-18",0,0,0,0,0,0,0,0
"Ecuador","2024-01-19",0,0,0,0,0,0,0,0
"Ecuador","2024-01-20",0,0,0,0,0,0,0,0
"Ecuador","2024-01-21",0,0,0,0,0,0,0,0
"Ecuador","2024-01-22",0,0,0,0,0,0,0,0
"Ecuador","2024-01-23",0,0,0,0,0,0,0,0
"Ecuador","2024-01-24",0,0,0,0,0,0,0,0
"Ecuador","2024-01-25",0,0,0,0,0,0,0,0
"Ecuador","2024-01-26",0,0,0,0,0,0,0,0
"Ecuador","2024-01-27",0,0,0,0,0,0,0,0
"Ecuador","2024-01-28",0,0,0,0,0,0,0,0
"Ecuador","2024-01-29",0,0,0,0,0,0,0,0
"Ecuador","2024-01-30",0,0,0,0,0,0,0,0
"Ecuador","2024-01-31",0,0,0,0,0,0,0,0
"Ecuador","2024-02-01",0,0,0,0,0,0,0,0
"Ecuador","2024-02-02",0,0,0,0,0,0,0,0
"Ecuador","2024-02-03",0,0,0,0,0,0,0,0
"Ecuador","2024-02-04",0,0,0,0,0,0,0,0
"Ecuador","2024-02-05",0,0,0,0,0,0,0,0
"Ecuador","2024-02-06",0,1,1,0,1,1,0,0
"Ecuador","2024-02-07",0,0,1,0,0,1,0,0
"Ecuador","2024-02-08",0,0,1,0,0,1,0,0
"Ecuador","2024-02-09",0,0,1,0,0,1,0,0
"Ecuador","2024-02-10",0,0,1,0,0,1,0,0
"Ecuador","2024-02-11",0,0,1,0,0,1,0,0
"Ecuador","2024-02-12",0,0,1,0,0,1,0,0
"Ecuador","2024-02-13",0,0,1,0,0,1,0,0
"Ecuador","2024-02-14",0,0,1,0,0,1,0,0
"Ecuador","2024-02-15",0,0,1,0,0,1,0,0
"Ecuador","2024-02-16",0,0,1,0,0,1,0,0
"Ecuador","2024-02-17",0,0,1,0,0,1,0,0
"Ecuador","2024-02-18",0,0,1,0,0,1,0,0
"Ecuador","2024-02-19",0,0,1,0,0,1,0,0
"Ecuador","2024-02-20",0,0,1,0,0,1,0,0
"Ecuador","2024-02-21",0,0,1,0,0,1,0,0
"Ecuador","2024-02-22",0,0,1,0,0,1,0,0
"Ecuador","2024-02-23",0,0,1,0,0,1,0,0
"Ecuador","2024-02-24",0,0,1,0,1,2,0,0
"Ecuador","2024-02-25",0,0,1,0,0,2,0,0
"Ecuador","2024-02-26",0,0,1,0,0,2,0,0
"Ecuador","2024-02-27",0,0,1,0,0,2,0,0
"Ecuador","2024-02-28",0,0,1,0,0,2,0,0
"Ecuador","2024-02-29",0,0,1,0,0,2,0,0
"Ecuador","2024-03-01",0,0,1,0,0,2,0,0
"Ecuador","2024-03-02",0,0,1,0,0,2,0,0
"Ecuador","2024-03-03",0,0,1,0,0,2,0,0
"Ecuador","2024-03-04",0,0,1,0,0,2,0,0
"Ecuador","2024-03-05",0,0,1,0,0,2,0,0
"Ecuador","2024-03-06",0,0,1,0,0,2,0,0
"Ecuador","2024-03-07",0,0,1,0,0,2,0,0
"Ecuador","2024-03-08",0,0,1,0,0,2,0,0
"Ecuador","2024-03-09",0,0,1,0,0,2,0,0
"Ecuador","2024-03-10",0,0,1,0,0,2,0,0
"Ecuador","2024-03-11",0,0,1,0,0,2,0,0
"Ecuador","2024-03-12",0,1,2,0,0,2,0,0
"Ecuador","2024-03-13",0,0,2,0,0,2,0,0
"Ecuador","2024-03-14",0,0,2,0,0,2,0,0
"Ecuador","2024-03-15",0,0,2,0,0,2,0,0
"Ecuador","2024-03-16",0,0,2,0,0,2,0,0
"Ecuador","2024-03-17",0,0,2,0,0,2,0,0
"Ecuador","2024-03-18",0,0,2,0,0,2,0,0
"Ecuador","2024-03-19",0,0,2,0,0,2,0,0
"Ecuador","2024-03-20",0,0,2,0,0,2,0,0
"Ecuador","2024-03-21",0,0,2,0,0,2,0,0
"Ecuador","2024-03-22",0,0,2,0,0,2,0,0
"Ecuador","2024-03-23",0,0,2,0,0,2,0,0
"Ecuador","2024-03-24",0,0,2,0,0,2,0,0
"Ecuador","2024-03-25",0,0,2,0,0,2,0,0
"Ecuador","2024-03-26",0,0,2,0,0,2,0,0
"Ecuador","2024-03-27",0,0,2,0,0,2,0,0
"Ecuador","2024-03-28",0,0,2,0,0,2,0,0
"Ecuador","2024-03-29",0,0,2,0,0,2,0,0
"Ecuador","2024-03-30",0,0,2,0,0,2,0,0
"Ecuador","2024-03-31",0,0,2,0,0,2,0,0
"Ecuador","2024-04-01",0,0,2,0,0,2,0,0
"Ecuador","2024-04-02",0,0,2,0,0,2,0,0
"Ecuador","2024-04-03",0,0,2,0,1,3,0,0
"Ecuador","2024-04-04",0,0,2,0,0,3,0,0
"Ecuador","2024-04-05",0,0,2,0,0,3,0,0
"Ecuador","2024-04-06",0,0,2,0,0,3,0,0
"Ecuador","2024-04-07",0,0,2,0,0,3,0,0
"Ecuador","2024-04-08",0,0,2,0,0,3,0,0
"Ecuador","2024-04-09",0,0,2,0,0,3,0,0
"Ecuador","2024-04-10",0,0,2,0,0,3,0,0
"Ecuador","2024-04-11",0,0,2,0,0,3,0,0
"Ecuador","2024-04-12",0,0,2,0,0,3,0,0
"Ecuador","2024-04-13",0,0,2,0,0,3,0,0
"Ecuador","2024-04-14",0,0,2,0,0,3,0,0
"Ecuador","2024-04-15",0,0,2,0,0,3,0,0
"Ecuador","2024-04-16",0,0,2,0,0,3,0,0
"Ecuador","2024-04-17",0,0,2,0,0,3,0,0
"Ecuador","2024-04-18",0,0,2,0,0,3,0,0
"Ecuador","2024-04-19",0,0,2,0,0,3,0,0
"Ecuador","2024-04-20",0,0,2,0,0,3,0,0
"Ecuador","2024-04-21",0,0,2,0,0,3,0,0
"Ecuador","2024-04-22",0,0,2,0,0,3,0,0
"Ecuador","2024-04-23",0,1,3,0,0,3,0,0
"Ecuador","2024-04-24",0,0,3,0,0,3,0,0
"Ecuador","2024-04-25",0,0,3,0,0,3,0,0
"Ecuador","2024-04-26",0,0,3,0,0,3,0,0
"Ecuador","2024-04-27",0,0,3,0,0,3,0,0
"Ecuador","2024-04-28",0,0,3,0,0,3,0,0
"Ecuador","2024-04-29",0,0,3,0,0,3,0,0
"Ecuador","2024-04-30",0,0,3,0,0,3,0,0
"Ecuador","2024-05-01",0,0,3,0,1,4,0,0
"Ecuador","2024-05-02",0,0,3,0,0,4,0,0
"Ecuador","2024-05-03",0,0,3,0,0,4,0,0
"Ecuador","2024-05-04",0,0,3,0,0,4,0,0
"Ecuador","2024-05-05",0,0,3,0,0,4,0,0
"Ecuador","2024-05-06",0,0,3,0,0,4,0,0
"Ecuador","2024-05-07",0,1,4,0,0,4,0,0
"Ecuador","2024-05-08",0,0,4,0,0,4,0,0
"Ecuador","2024-05-09",0,0,4,0,0,4,0,0
"Ecuador","2024-05-10",0,0,4,0,0,4,0,0
"Ecuador","2024-05-11",0,0,4,0,0,4,0,0
"Ecuador","2024-05-12",0,0,4,0,0,4,0,0
"Ecuador","2024-05-13",0,0,4,0,0,4,0,0
"Ecuador","2024-05-14",0,0,4,0,0,4,0,0
"Ecuador","2024-05-15",0,0,4,0,0,4,0,0
"Ecuador","2024-05-16",0,0,4,0,0,4,0,0
"Ecuador","2024-05-17",0,0,4,0,0,4,0,0
"Ecuador","2024-05-18",0,0,4,0,0,4,0,0
"Ecuador","2024-05-19",0,0,4,0,0,4,0,0
"Ecuador","2024-05-20",0,0,4,0,0,4,0,0
"Ecuador","2024-05-21",0,0,4,0,0,4,0,0
"Ecuador","2024-05-22",0,0,4,0,0,4,0,0
"Ecuador","2024-05-23",0,0,4,0,0,4,0,0
"Ecuador","2024-05-24",0,0,4,0,0,4,0,0
"Ecuador","2024-05-25",0,0,4,0,0,4,0,0
"Ecuador","2024-05-26",0,0,4,0,0,4,0,0
"Ecuador","2024-05-27",0,0,4,0,0,4,0,0
"Ecuador","2024-05-28",0,0,4,0,0,4,0,0
"Ecuador","2024-05-29",0,0,4,0,0,4,0,0
"Ecuador","2024-05-30",0,0,4,0,0,4,0,0
"Ecuador","2024-05-31",0,0,4,0,0,4,0,0
"Ecuador","2024-06-01",0,0,4,0,0,4,0,0
"Ecuador","2024-06-02",0,0,4,0,0,4,0,0
"Ecuador","2024-06-03",0,0,4,0,0,4,0,0
"Ecuador","2024-06-04",0,0,4,0,0,4,0,0
"Ecuador","2024-06-05",0,0,4,0,0,4,0,0
"Ecuador","2024-06-06",0,0,4,0,0,4,0,0
"Ecuador","2024-06-07",0,0,4,0,0,4,0,0
"Ecuador","2024-06-08",0,0,4,0,0,4,0,0
"Ecuador","2024-06-09",0,0,4,0,0,4,0,0
"Ecuador","2024-06-10",0,0,4,0,0,4,0,0
"Ecuador","2024-06-11",0,0,4,0,0,4,0,0
"Ecuador","2024-06-12",0,0,4,0,0,4,0,0
"Ecuador","2024-06-13",0,0,4,0,0,4,0,0
"Ecuador","2024-06-14",0,0,4,0,0,4,0,0
"Ecuador","2024-06-15",0,0,4,0,0,4,0,0
"Ecuador","2024-06-16",0,0,4,0,0,4,0,0
"Ecuador","2024-06-17",0,0,4,0,0,4,0,0
"Ecuador","2024-06-18",0,0,4,0,0,4,0,0
"Ecuador","2024-06-19",0,0,4,0,1,5,0,0
"Ecuador","2024-06-20",0,0,4,0,0,5,0,0
"Ecuador","2024-06-21",0,0,4,0,0,5,0,0
"Ecuador","2024-06-22",0,0,4,0,0,5,0,0
"Ecuador","2024-06-23",0,0,4,0,0,5,0,0
"Ecuador","2024-06-24",0,0,4,0,0,5,0,0
"Ecuador","2024-06-25",0,0,4,0,0,5,0,0
"Ecuador","2024-06-26",0,0,4,0,0,5,0,0
"Ecuador","2024-06-27",0,0,4,0,0,5,0,0
"Ecuador","2024-06-28",0,0,4,0,0,5,0,0
"Ecuador","2024-06-29",0,0,4,0,0,5,0,0
"Ecuador","2024-06-30",0,0,4,0,0,5,0,0
"Ecuador","2024-07-01",0,0,4,0,0,5,0,0
"Ecuador","2024-07-02",0,0,4,0,0,5,0,0
"Ecuador","2024-07-03",0,0,4,0,0,5,0,0
"Ecuador","2024-07-04",0,0,4,0,0,5,0,0
"Ecuador","2024-07-05",0,0,4,0,0,5,0,0
"Ecuador","2024-07-06",0,0,4,0,0,5,0,0
"Ecuador","2024-07-07",0,0,4,0,0,5,0,0
"Ecuador","2024-07-08",0,0,4,0,0,5,0,0
"Ecuador","2024-07-09",0,0,4,0,0,5,0,0
"Ecuador","2024-07-10",0,0,4,0,0,5,0,0
"Ecuador","2024-07-11",0,0,4,0,0,5,0,0
"Ecuador","2024-07-12",0,0,4,0,0,5,0,0
"Ecuador","2024-07-13",0,0,4,0,0,5,0,0
"Ecuador","2024-07-14",0,0,4,0,0,5,0,0
"Ecuador","2024-07-15",0,0,4,0,0,5,0,0
"Ecuador","2024-07-16",0,0,4,0,0,5,0,0
"Ecuador","2024-07-17",0,0,4,0,0,5,0,0
"Ecuador","2024-07-18",0,0,4,0,0,5,0,0
"Ecuador","2024-07-19",0,0,4,0,0,5,0,0
"Ecuador","2024-07-20",0,0,4,0,0,5,0,0
"Ecuador","2024-07-21",0,0,4,0,0,5,0,0
"Ecuador","2024-07-22",0,0,4,0,0,5,0,0
"Ecuador","2024-07-23",0,0,4,0,0,5,0,0
"Ecuador","2024-07-24",0,0,4,0,0,5,0,0
"Ecuador","2024-07-25",0,0,4,0,0,5,0,0
"Ecuador","2024-07-26",0,0,4,0,0,5,0,0
"Ecuador","2024-07-27",0,0,4,0,0,5,0,0
"Ecuador","2024-07-28",0,0,4,0,0,5,0,0
"Ecuador","2024-07-29",0,0,4,0,0,5,0,0
"Ecuador","2024-07-30",0,1,5,0,0,5,0,0
"Ecuador","2024-07-31",0,0,5,0,0,5,0,0
"Ecuador","2024-08-01",0,0,5,0,0,5,0,0
"Ecuador","2024-08-02",0,0,5,0,0,5,0,0
"Ecuador","2024-08-03",0,0,5,0,1,6,0,0
"Ecuador","2024-08-04",0,0,5,0,0,6,0,0
"Ecuador","2024-08-05",0,0,5,0,0,6,0,0
"Ecuador","2024-08-06",0,1,6,0,0,6,0,0
"Ecuador","2024-08-07",0,0,6,0,0,6,0,0
"Ecuador","2024-08-08",0,0,6,0,0,6,0,0
"Ecuador","2024-08-09",0,0,6,0,0,6,0,0
"Ecuador","2024-08-10",0,0,6,0,1,7,0,0
"Ecuador","2024-08-11",0,0,6,0,0,7,0,0
"Ecuador","2024-08-12",0,0,6,0,0,7,0,0
"Ecuador","2024-08-13",0,1,7,0,0,7,0,0
"Ecuador","2024-08-14",0,0,7,0,0,7,0,0
"Ecuador","2024-08-15",0,0,7,0,0,7,0,0
"Ecuador","2024-08-16",0,0,7,0,0,7,0,0
"Ecuador","2024-08-17",0,0,7,0,1,8,0,0
"Ecuador","2024-08-18",0,0,7,0,0,8,0,0
"Ecuador","2024-08-19",0,0,7,0,0,8,0,0
"Ecuador","2024-08-20",0,1,8,0,0,8,0,0
"Ecuador","2024-08-21",0,0,8,0,1,9,0,0
"Ecuador","2024-08-22",0,0,8,0,0,9,0,0
"Ecuador","2024-08-23",0,0,8,0,1,10,0,0
"Ecuador","2024-08-24",0,0,8,0,1,11,0,0
"Ecuador","2024-08-25",0,0,8,0,1,12,0,0
"Ecuador","2024-08-26",0,0,8,0,0,12,0,0
"Ecuador","2024-08-27",0,5,13,0,1,13,0,0
"Ecuador","2024-08-28",0,0,13,0,0,13,0,0
"Ecuador","2024-08-29",0,0,13,0,0,13,0,0
"Ecuador","2024-08-30",0,0,13,0,1,14,0,0
"Ecuador","2024-08-31",0,0,13,0,0,14,0,0
"Ecuador","2024-09-01",0,0,13,0,0,14,0,0
"Ecuador","2024-09-02",0,0,13,0,0,14,0,0
"Ecuador","2024-09-03",0,0,13,0,1,15,0,0
"Ecuador","2024-09-04",0,0,13,0,0,15,0,0
"Ecuador","2024-09-05",0,0,13,0,0,15,0,0
"Ecuador","2024-09-06",0,0,13,0,0,15,0,0
"Ecuador","2024-09-07",0,0,13,0,0,15,0,0
"Ecuador","2024-09-08",0,0,13,0,1,16,0,0
"Ecuador","2024-09-09",0,0,13,0,0,16,0,0
"Ecuador","2024-09-10",0,3,16,0,0,16,0,0
"Ecuador","2024-09-11",0,0,16,0,1,17,0,0
"Ecuador","2024-09-12",0,0,16,0,0,17,0,0
"Ecuador","2024-09-13",0,0,16,0,1,18,0,0
"Ecuador","2024-09-14",0,0,16,0,0,18,0,0
"Ecuador","2024-09-15",0,0,16,0,1,19,0,0
"Ecuador","2024-09-16",0,0,16,0,0,19,0,0
"Ecuador","2024-09-17",0,4,20,0,1,20,0,0
"Ecuador","2024-09-18",0,0,20,0,0,20,0,0
"Ecuador","2024-09-19",0,0,20,0,1,21,0,0
"Ecuador","2024-09-20",0,0,20,0,0,21,0,0
"Ecuador","2024-09-21",0,0,20,0,1,22,0,0
"Ecuador","2024-09-22",0,0,20,0,0,22,0,0
"Ecuador","2024-09-23",0,0,20,0,1,23,0,0
"Ecuador","2024-09-24",0,3,23,0,0,23,0,0
"Ecuador","2024-09-25",0,0,23,0,0,23,0,0
"Ecuador","2024-09-26",0,0,23,0,0,23,0,0
"Ecuador","2024-09-27",0,0,23,0,0,23,0,0
"Ecuador","2024-09-28",0,0,23,0,1,24,0,0
"Ecuador","2024-09-29",0,0,23,0,0,24,0,0
"Ecuador","2024-09-30",0,0,23,0,0,24,0,0
"Ecuador","2024-10-01",0,1,24,0,0,24,0,0
"Ecuador","2024-10-02",0,0,24,0,0,24,0,0
"Ecuador","2024-10-03",0,0,24,0,0,24,0,0
"Ecuador","2024-10-04",0,0,24,0,0,24,0,0
"Ecuador","2024-10-05",0,0,24,0,0,24,0,0
"Ecuador","2024-10-06",0,0,24,0,0,24,0,0
"Ecuador","2024-10-07",0,0,24,0,0,24,0,0
"Ecuador","2024-10-08",0,0,24,0,0,24,0,0
"Ecuador","2024-10-09",0,0,24,0,0,24,0,0
"Ecuador","2024-10-10",0,0,24,0,0,24,0,0
"Ecuador","2024-10-11",0,0,24,0,0,24,0,0
"Ecuador","2024-10-12",0,0,24,0,1,25,0,0
"Ecuador","2024-10-13",0,0,24,0,0,25,0,0
"Ecuador","2024-10-14",0,0,24,0,0,25,0,0
"Ecuador","2024-10-15",0,0,24,0,0,25,0,0
"Ecuador","2024-10-16",0,0,24,0,0,25,0,0
"Ecuador","2024-10-17",0,0,24,0,0,25,0,0
"Ecuador","2024-10-18",0,0,24,0,0,25,0,0
"Ecuador","2024-10-19",0,0,24,0,0,25,0,0
"Ecuador","2024-10-20",0,0,24,0,0,25,0,0
"Ecuador","2024-10-21",0,0,24,0,0,25,0,0
"Ecuador","2024-10-22",0,1,25,0,0,25,0,0
"Ecuador","2024-10-23",0,0,25,0,1,26,0,0
"Ecuador","2024-10-24",0,0,25,0,0,26,0,0
"Ecuador","2024-10-25",0,0,25,0,1,27,0,0
"Ecuador","2024-10-26",0,0,25,0,0,27,0,0
"Ecuador","2024-10-27",0,0,25,0,1,28,0,0
"Ecuador","2024-10-28",0,0,25,0,0,28,0,0
"Ecuador","2024-10-29",0,4,29,0,1,29,0,0
"Ecuador","2024-10-30",0,0,29,0,0,29,0,0
"Ecuador","2024-10-31",0,0,29,0,1,30,0,0
"Ecuador","2024-11-01",0,0,29,0,0,30,0,0
"Ecuador","2024-11-02",0,0,29,0,0,30,0,0
"Ecuador","2024-11-03",0,0,29,0,0,30,0,0
"Ecuador","2024-11-04",0,0,29,0,1,31,0,0
"Ecuador","2024-11-05",0,2,31,0,0,31,0,0
"Ecuador","2024-11-06",0,0,31,0,0,31,0,0
"Ecuador","2024-11-07",0,0,31,0,0,31,0,0
"Ecuador","2024-11-08",0,0,31,0,0,31,0,0
"Ecuador","2024-11-09",0,0,31,0,0,31,0,0
"Ecuador","2024-11-10",0,0,31,0,0,31,0,0
"Ecuador","2024-11-11",0,0,31,0,0,31,0,0
"Ecuador","2024-11-12",0,0,31,0,0,31,0,0
"Ecuador","2024-11-13",0,0,31,0,0,31,0,0
"Ecuador","2024-11-14",0,0,31,0,0,31,0,0
"Ecuador","2024-11-15",0,0,31,0,0,31,0,0
"Ecuador","2024-11-16",0,0,31,0,0,31,0,0
"Ecuador","2024-11-17",0,0,31,0,0,31,0,0
"Ecuador","2024-11-18",0,0,31,0,0,31,0,0
"Ecuador","2024-11-19",0,0,31,0,0,31,0,0
"Ecuador","2024-11-20",0,0,31,0,0,31,0,0
"Ecuador","2024-11-21",0,0,31,0,0,31,0,0
"Ecuador","2024-11-22",0,0,31,0,0,31,0,0
"Ecuador","2024-11-23",0,0,31,0,0,31,0,0
"Ecuador","2024-11-24",0,0,31,0,0,31,0,0
"Ecuador","2024-11-25",0,0,31,0,0,31,0,0
"Ecuador","2024-11-26",0,0,31,0,0,31,0,0
"Ecuador","2024-11-27",0,0,31,0,0,31,0,0
"Ecuador","2024-11-28",0,0,31,0,0,31,0,0
"Ecuador","2024-11-29",0,0,31,0,0,31,0,0
"Ecuador","2024-11-30",0,0,31,0,0,31,0,0
"Ecuador","2024-12-01",0,0,31,0,0,31,0,0
"Ecuador","2024-12-02",0,0,31,0,0,31,0,0
"Ecuador","2024-12-03",0,0,31,0,0,31,0,0
"Ecuador","2024-12-04",0,0,31,0,0,31,0,0
"Ecuador","2024-12-05",0,0,31,0,0,31,0,0
"Ecuador","2024-12-06",0,0,31,0,0,31,0,0
"Ecuador","2024-12-07",0,0,31,0,0,31,0,0
"Ecuador","2024-12-08",0,0,31,0,0,31,0,0
"Ecuador","2024-12-09",0,0,31,0,0,31,0,0
"Ecuador","2024-12-10",0,0,31,0,0,31,0,0
"Ecuador","2024-12-11",0,0,31,0,0,31,0,0
"Ecuador","2024-12-12",0,0,31,0,0,31,0,0
"Ecuador","2024-12-13",0,0,31,0,0,31,0,0
"Ecuador","2024-12-14",0,0,31,0,0,31,0,0
"Ecuador","2024-12-15",0,0,31,0,0,31,0,0
"Ecuador","2024-12-16",0,0,31,0,0,31,0,0
"Ecuador","2024-12-17",0,0,31,0,0,31,0,0
"Ecuador","2024-12-18",0,0,31,0,0,31,0,0
"Ecuador","2024-12-19",0,0,31,0,0,31,0,0
"Ecuador","2024-12-20",0,0,31,0,0,31,0,0
"Ecuador","2024-12-21",0,0,31,0,0,31,0,0
"Ecuador","2024-12-22",0,0,31,0,0,31,0,0
"Ecuador","2024-12-23",0,0,31,0,0,31,0,0
"Ecuador","2024-12-24",0,0,31,0,0,31,0,0
"Ecuador","2024-12-25",0,0,31,0,0,31,0,0
"Ecuador","2024-12-26",0,0,31,0,0,31,0,0
"Ecuador","2024-12-27",0,0,31,0,0,31,0,0
"Ecuador","2024-12-28",0,0,31,0,0,31,0,0
"Ecuador","2024-12-29",0,0,31,0,0,31,0,0
"Ecuador","2024-12-30",0,0,31,0,0,31,0,0
"Ecuador","2024-12-31",0,0,31,0,0,31,0,0
"Ecuador","2025-01-01",0,0,31,0,0,31,0,0
"Ecuador","2025-01-02",0,0,31,0,0,31,0,0
"Ecuador","2025-01-03",0,0,31,0,0,31,0,0
"Ecuador","2025-01-04",0,0,31,0,0,31,0,0
"Ecuador","2025-01-05",0,0,31,0,0,31,0,0
"Ecuador","2025-01-06",0,0,31,0,0,31,0,0
"Ecuador","2025-01-07",0,0,31,0,0,31,0,0
"Ecuador","2025-01-08",0,0,31,0,0,31,0,0
"Ecuador","2025-01-09",0,0,31,0,0,31,0,0
"Ecuador","2025-01-10",0,0,31,0,0,31,0,0
"Ecuador","2025-01-11",0,0,31,0,0,31,0,0
"Ecuador","2025-01-12",0,0,31,0,0,31,0,0
"Ecuador","2025-01-13",0,0,31,0,0,31,0,0
"Ecuador","2025-01-14",0,0,31,0,0,31,0,0
"Ecuador","2025-01-15",0,0,31,0,0,31,0,0
"Ecuador","2025-01-16",0,0,31,0,0,31,0,0
"Ecuador","2025-01-17",0,0,31,0,0,31,0,0
"Ecuador","2025-01-18",0,0,31,0,0,31,0,0
"Ecuador","2025-01-19",0,0,31,0,0,31,0,0
"Ecuador","2025-01-20",0,0,31,0,0,31,0,0
"Ecuador","2025-01-21",0,0,31,0,0,31,0,0
"Ecuador","2025-01-22",0,0,31,0,0,31,0,0
"Ecuador","2025-01-23",0,0,31,0,0,31,0,0
"Ecuador","2025-01-24",0,0,31,0,0,31,0,0
"Ecuador","2025-01-25",0,0,31,0,0,31,0,0
"Ecuador","2025-01-26",0,0,31,0,0,31,0,0
"Ecuador","2025-01-27",0,0,31,0,0,31,0,0
"Ecuador","2025-01-28",0,0,31,0,0,31,0,0
"Ecuador","2025-01-29",0,0,31,0,0,31,0,0
"Ecuador","2025-01-30",0,0,31,0,0,31,0,0
"Ecuador","2025-01-31",0,0,31,0,0,31,0,0
"Ecuador","2025-02-01",0,0,31,0,0,31,0,0
"Ecuador","2025-02-02",0,0,31,0,0,31,0,0
"Ecuador","2025-02-03",0,0,31,0,0,31,0,0
"Ecuador","2025-02-04",0,0,31,0,0,31,0,0
"Ecuador","2025-02-05",0,0,31,0,0,31,0,0
"Ecuador","2025-02-06",0,0,31,0,0,31,0,0
"Ecuador","2025-02-07",0,0,31,0,0,31,0,0
"Ecuador","2025-02-08",0,0,31,0,0,31,0,0
"Ecuador","2025-02-09",0,0,31,0,0,31,0,0
"Ecuador","2025-02-10",0,0,31,0,0,31,0,0
"Ecuador","2025-02-11",0,0,31,0,0,31,0,0
"Ecuador","2025-02-12",0,0,31,0,0,31,0,0
"Ecuador","2025-02-13",0,0,31,0,0,31,0,0
"Ecuador","2025-02-14",0,0,31,0,0,31,0,0
"Ecuador","2025-02-15",0,0,31,0,0,31,0,0
"Ecuador","2025-02-16",0,0,31,0,0,31,0,0
"Ecuador","2025-02-17",0,0,31,0,0,31,0,0
"Ecuador","2025-02-18",0,0,31,0,0,31,0,0
"Ecuador","2025-02-19",0,0,31,0,0,31,0,0
"Ecuador","2025-02-20",0,0,31,0,0,31,0,0
"Ecuador","2025-02-21",0,0,31,0,0,31,0,0
"Ecuador","2025-02-22",0,0,31,0,0,31,0,0
"Ecuador","2025-02-23",0,0,31,0,0,31,0,0
"Ecuador","2025-02-24",0,0,31,0,0,31,0,0
"Ecuador","2025-02-25",0,0,31,0,0,31,0,0
"Ecuador","2025-02-26",0,0,31,0,0,31,0,0
"Ecuador","2025-02-27",0,0,31,0,0,31,0,0
"Ecuador","2025-02-28",0,0,31,0,0,31,0,0
"Ecuador","2025-03-01",0,0,31,0,0,31,0,0
"Ecuador","2025-03-02",0,0,31,0,0,31,0,0
"Ecuador","2025-03-03",0,0,31,0,0,31,0,0
"El Salvador","2024-01-01",0,0,0,0,0,0,0,0
"El Salvador","2024-01-02",0,0,0,0,0,0,0,0
"El Salvador","2024-01-03",0,0,0,0,0,0,0,0
"El Salvador","2024-01-04",0,0,0,0,0,0,0,0
"El Salvador","2024-01-05",0,0,0,0,0,0,0,0
"El Salvador","2024-01-06",0,0,0,0,0,0,0,0
"El Salvador","2024-01-07",0,0,0,0,0,0,0,0
"El Salvador","2024-01-08",0,0,0,0,0,0,0,0
"El Salvador","2024-01-09",0,0,0,0,0,0,0,0
"El Salvador","2024-01-10",0,0,0,0,0,0,0,0
"El Salvador","2024-01-11",0,0,0,0,0,0,0,0
"El Salvador","2024-01-12",0,0,0,0,0,0,0,0
"El Salvador","2024-01-13",0,0,0,0,0,0,0,0
"El Salvador","2024-01-14",0,0,0,0,0,0,0,0
"El Salvador","2024-01-15",0,0,0,0,0,0,0,0
"El Salvador","2024-01-16",0,0,0,0,0,0,0,0
"El Salvador","2024-01-17",0,0,0,0,0,0,0,0
"El Salvador","2024-01-18",0,0,0,0,0,0,0,0
"El Salvador","2024-01-19",0,0,0,0,0,0,0,0
"El Salvador","2024-01-20",0,0,0,0,0,0,0,0
"El Salvador","2024-01-21",0,0,0,0,0,0,0,0
"El Salvador","2024-01-22",0,0,0,0,0,0,0,0
"El Salvador","2024-01-23",0,0,0,0,0,0,0,0
"El Salvador","2024-01-24",0,0,0,0,0,0,0,0
"El Salvador","2024-01-25",0,0,0,0,0,0,0,0
"El Salvador","2024-01-26",0,0,0,0,0,0,0,0
"El Salvador","2024-01-27",0,0,0,0,0,0,0,0
"El Salvador","2024-01-28",0,0,0,0,0,0,0,0
"El Salvador","2024-01-29",0,0,0,0,0,0,0,0
"El Salvador","2024-01-30",0,0,0,0,0,0,0,0
"El Salvador","2024-01-31",0,0,0,0,0,0,0,0
"El Salvador","2024-02-01",0,0,0,0,0,0,0,0
"El Salvador","2024-02-02",0,0,0,0,0,0,0,0
"El Salvador","2024-02-03",0,0,0,0,0,0,0,0
"El Salvador","2024-02-04",0,0,0,0,0,0,0,0
"El Salvador","2024-02-05",0,0,0,0,0,0,0,0
"El Salvador","2024-02-06",0,0,0,0,0,0,0,0
"El Salvador","2024-02-07",0,0,0,0,0,0,0,0
"El Salvador","2024-02-08",0,0,0,0,0,0,0,0
"El Salvador","2024-02-09",0,0,0,0,0,0,0,0
"El Salvador","2024-02-10",0,0,0,0,0,0,0,0
"El Salvador","2024-02-11",0,0,0,0,0,0,0,0
"El Salvador","2024-02-12",0,0,0,0,0,0,0,0
"El Salvador","2024-02-13",0,0,0,0,0,0,0,0
"El Salvador","2024-02-14",0,0,0,0,0,0,0,0
"El Salvador","2024-02-15",0,0,0,0,0,0,0,0
"El Salvador","2024-02-16",0,0,0,0,0,0,0,0
"El Salvador","2024-02-17",0,0,0,0,0,0,0,0
"El Salvador","2024-02-18",0,0,0,0,0,0,0,0
"El Salvador","2024-02-19",0,0,0,0,0,0,0,0
"El Salvador","2024-02-20",0,0,0,0,0,0,0,0
"El Salvador","2024-02-21",0,0,0,0,0,0,0,0
"El Salvador","2024-02-22",0,0,0,0,0,0,0,0
"El Salvador","2024-02-23",0,0,0,0,0,0,0,0
"El Salvador","2024-02-24",0,0,0,0,0,0,0,0
"El Salvador","2024-02-25",0,0,0,0,0,0,0,0
"El Salvador","2024-02-26",0,0,0,0,0,0,0,0
"El Salvador","2024-02-27",0,0,0,0,0,0,0,0
"El Salvador","2024-02-28",0,0,0,0,0,0,0,0
"El Salvador","2024-02-29",0,0,0,0,0,0,0,0
"El Salvador","2024-03-01",0,0,0,0,0,0,0,0
"El Salvador","2024-03-02",0,0,0,0,0,0,0,0
"El Salvador","2024-03-03",0,0,0,0,0,0,0,0
"El Salvador","2024-03-04",0,0,0,0,0,0,0,0
"El Salvador","2024-03-05",0,0,0,0,0,0,0,0
"El Salvador","2024-03-06",0,0,0,0,0,0,0,0
"El Salvador","2024-03-07",0,0,0,0,0,0,0,0
"El Salvador","2024-03-08",0,0,0,0,0,0,0,0
"El Salvador","2024-03-09",0,0,0,0,0,0,0,0
"El Salvador","2024-03-10",0,0,0,0,0,0,0,0
"El Salvador","2024-03-11",0,0,0,0,0,0,0,0
"El Salvador","2024-03-12",0,0,0,0,0,0,0,0
"El Salvador","2024-03-13",0,0,0,0,0,0,0,0
"El Salvador","2024-03-14",0,0,0,0,0,0,0,0
"El Salvador","2024-03-15",0,0,0,0,0,0,0,0
"El Salvador","2024-03-16",0,0,0,0,0,0,0,0
"El Salvador","2024-03-17",0,0,0,0,0,0,0,0
"El Salvador","2024-03-18",0,0,0,0,0,0,0,0
"El Salvador","2024-03-19",0,0,0,0,0,0,0,0
"El Salvador","2024-03-20",0,0,0,0,0,0,0,0
"El Salvador","2024-03-21",0,0,0,0,0,0,0,0
"El Salvador","2024-03-22",0,0,0,0,0,0,0,0
"El Salvador","2024-03-23",0,0,0,0,0,0,0,0
"El Salvador","2024-03-24",0,0,0,0,0,0,0,0
"El Salvador","2024-03-25",0,0,0,0,0,0,0,0
"El Salvador","2024-03-26",0,0,0,0,0,0,0,0
"El Salvador","2024-03-27",0,0,0,0,0,0,0,0
"El Salvador","2024-03-28",0,0,0,0,0,0,0,0
"El Salvador","2024-03-29",0,0,0,0,0,0,0,0
"El Salvador","2024-03-30",0,0,0,0,0,0,0,0
"El Salvador","2024-03-31",0,0,0,0,0,0,0,0
"El Salvador","2024-04-01",0,0,0,0,0,0,0,0
"El Salvador","2024-04-02",0,0,0,0,0,0,0,0
"El Salvador","2024-04-03",0,0,0,0,0,0,0,0
"El Salvador","2024-04-04",0,0,0,0,0,0,0,0
"El Salvador","2024-04-05",0,0,0,0,0,0,0,0
"El Salvador","2024-04-06",0,0,0,0,0,0,0,0
"El Salvador","2024-04-07",0,0,0,0,0,0,0,0
"El Salvador","2024-04-08",0,0,0,0,0,0,0,0
"El Salvador","2024-04-09",0,0,0,0,0,0,0,0
"El Salvador","2024-04-10",0,0,0,0,0,0,0,0
"El Salvador","2024-04-11",0,0,0,0,0,0,0,0
"El Salvador","2024-04-12",0,0,0,0,0,0,0,0
"El Salvador","2024-04-13",0,0,0,0,0,0,0,0
"El Salvador","2024-04-14",0,0,0,0,0,0,0,0
"El Salvador","2024-04-15",0,0,0,0,0,0,0,0
"El Salvador","2024-04-16",0,0,0,0,0,0,0,0
"El Salvador","2024-04-17",0,0,0,0,0,0,0,0
"El Salvador","2024-04-18",0,0,0,0,0,0,0,0
"El Salvador","2024-04-19",0,0,0,0,0,0,0,0
"El Salvador","2024-04-20",0,0,0,0,0,0,0,0
"El Salvador","2024-04-21",0,0,0,0,0,0,0,0
"El Salvador","2024-04-22",0,0,0,0,0,0,0,0
"El Salvador","2024-04-23",0,0,0,0,0,0,0,0
"El Salvador","2024-04-24",0,0,0,0,0,0,0,0
"El Salvador","2024-04-25",0,0,0,0,0,0,0,0
"El Salvador","2024-04-26",0,0,0,0,0,0,0,0
"El Salvador","2024-04-27",0,0,0,0,0,0,0,0
"El Salvador","2024-04-28",0,0,0,0,0,0,0,0
"El Salvador","2024-04-29",0,0,0,0,0,0,0,0
"El Salvador","2024-04-30",0,0,0,0,0,0,0,0
"El Salvador","2024-05-01",0,0,0,0,0,0,0,0
"El Salvador","2024-05-02",0,0,0,0,0,0,0,0
"El Salvador","2024-05-03",0,0,0,0,0,0,0,0
"El Salvador","2024-05-04",0,0,0,0,0,0,0,0
"El Salvador","2024-05-05",0,0,0,0,0,0,0,0
"El Salvador","2024-05-06",0,0,0,0,0,0,0,0
"El Salvador","2024-05-07",0,0,0,0,0,0,0,0
"El Salvador","2024-05-08",0,0,0,0,0,0,0,0
"El Salvador","2024-05-09",0,0,0,0,0,0,0,0
"El Salvador","2024-05-10",0,0,0,0,0,0,0,0
"El Salvador","2024-05-11",0,0,0,0,0,0,0,0
"El Salvador","2024-05-12",0,0,0,0,0,0,0,0
"El Salvador","2024-05-13",0,0,0,0,0,0,0,0
"El Salvador","2024-05-14",0,0,0,0,0,0,0,0
"El Salvador","2024-05-15",0,0,0,0,0,0,0,0
"El Salvador","2024-05-16",0,0,0,0,0,0,0,0
"El Salvador","2024-05-17",0,0,0,0,0,0,0,0
"El Salvador","2024-05-18",0,0,0,0,0,0,0,0
"El Salvador","2024-05-19",0,0,0,0,0,0,0,0
"El Salvador","2024-05-20",0,0,0,0,0,0,0,0
"El Salvador","2024-05-21",0,0,0,0,0,0,0,0
"El Salvador","2024-05-22",0,0,0,0,0,0,0,0
"El Salvador","2024-05-23",0,0,0,0,0,0,0,0
"El Salvador","2024-05-24",0,0,0,0,0,0,0,0
"El Salvador","2024-05-25",0,0,0,0,0,0,0,0
"El Salvador","2024-05-26",0,0,0,0,0,0,0,0
"El Salvador","2024-05-27",0,0,0,0,0,0,0,0
"El Salvador","2024-05-28",0,0,0,0,0,0,0,0
"El Salvador","2024-05-29",0,0,0,0,0,0,0,0
"El Salvador","2024-05-30",0,0,0,0,0,0,0,0
"El Salvador","2024-05-31",0,0,0,0,0,0,0,0
"El Salvador","2024-06-01",0,0,0,0,0,0,0,0
"El Salvador","2024-06-02",0,0,0,0,0,0,0,0
"El Salvador","2024-06-03",0,0,0,0,0,0,0,0
"El Salvador","2024-06-04",0,0,0,0,0,0,0,0
"El Salvador","2024-06-05",0,0,0,0,0,0,0,0
"El Salvador","2024-06-06",0,0,0,0,0,0,0,0
"El Salvador","2024-06-07",0,0,0,0,0,0,0,0
"El Salvador","2024-06-08",0,0,0,0,0,0,0,0
"El Salvador","2024-06-09",0,0,0,0,0,0,0,0
"El Salvador","2024-06-10",0,0,0,0,0,0,0,0
"El Salvador","2024-06-11",0,0,0,0,0,0,0,0
"El Salvador","2024-06-12",0,0,0,0,0,0,0,0
"El Salvador","2024-06-13",0,0,0,0,0,0,0,0
"El Salvador","2024-06-14",0,0,0,0,0,0,0,0
"El Salvador","2024-06-15",0,0,0,0,0,0,0,0
"El Salvador","2024-06-16",0,0,0,0,0,0,0,0
"El Salvador","2024-06-17",0,0,0,0,0,0,0,0
"El Salvador","2024-06-18",0,0,0,0,0,0,0,0
"El Salvador","2024-06-19",0,0,0,0,0,0,0,0
"El Salvador","2024-06-20",0,0,0,0,0,0,0,0
"El Salvador","2024-06-21",0,0,0,0,0,0,0,0
"El Salvador","2024-06-22",0,0,0,0,0,0,0,0
"El Salvador","2024-06-23",0,0,0,0,0,0,0,0
"El Salvador","2024-06-24",0,0,0,0,0,0,0,0
"El Salvador","2024-06-25",0,0,0,0,0,0,0,0
"El Salvador","2024-06-26",0,0,0,0,0,0,0,0
"El Salvador","2024-06-27",0,0,0,0,0,0,0,0
"El Salvador","2024-06-28",0,0,0,0,0,0,0,0
"El Salvador","2024-06-29",0,0,0,0,0,0,0,0
"El Salvador","2024-06-30",0,0,0,0,0,0,0,0
"El Salvador","2024-07-01",0,0,0,0,0,0,0,0
"El Salvador","2024-07-02",0,0,0,0,0,0,0,0
"El Salvador","2024-07-03",0,0,0,0,0,0,0,0
"El Salvador","2024-07-04",0,0,0,0,0,0,0,0
"El Salvador","2024-07-05",0,0,0,0,0,0,0,0
"El Salvador","2024-07-06",0,0,0,0,0,0,0,0
"El Salvador","2024-07-07",0,0,0,0,0,0,0,0
"El Salvador","2024-07-08",0,0,0,0,0,0,0,0
"El Salvador","2024-07-09",0,0,0,0,0,0,0,0
"El Salvador","2024-07-10",0,0,0,0,0,0,0,0
"El Salvador","2024-07-11",0,0,0,0,0,0,0,0
"El Salvador","2024-07-12",0,0,0,0,0,0,0,0
"El Salvador","2024-07-13",0,0,0,0,0,0,0,0
"El Salvador","2024-07-14",0,0,0,0,0,0,0,0
"El Salvador","2024-07-15",0,0,0,0,0,0,0,0
"El Salvador","2024-07-16",0,0,0,0,0,0,0,0
"El Salvador","2024-07-17",0,0,0,0,0,0,0,0
"El Salvador","2024-07-18",0,0,0,0,0,0,0,0
"El Salvador","2024-07-19",0,0,0,0,0,0,0,0
"El Salvador","2024-07-20",0,0,0,0,0,0,0,0
"El Salvador","2024-07-21",0,0,0,0,0,0,0,0
"El Salvador","2024-07-22",0,0,0,0,0,0,0,0
"El Salvador","2024-07-23",0,0,0,0,0,0,0,0
"El Salvador","2024-07-24",0,0,0,0,0,0,0,0
"El Salvador","2024-07-25",0,0,0,0,0,0,0,0
"El Salvador","2024-07-26",0,0,0,0,0,0,0,0
"El Salvador","2024-07-27",0,0,0,0,0,0,0,0
"El Salvador","2024-07-28",0,0,0,0,0,0,0,0
"El Salvador","2024-07-29",0,0,0,0,0,0,0,0
"El Salvador","2024-07-30",0,0,0,0,0,0,0,0
"El Salvador","2024-07-31",0,0,0,0,0,0,0,0
"El Salvador","2024-08-01",0,0,0,0,0,0,0,0
"El Salvador","2024-08-02",0,0,0,0,0,0,0,0
"El Salvador","2024-08-03",0,0,0,0,0,0,0,0
"El Salvador","2024-08-04",0,0,0,0,0,0,0,0
"El Salvador","2024-08-05",0,0,0,0,0,0,0,0
"El Salvador","2024-08-06",0,0,0,0,0,0,0,0
"El Salvador","2024-08-07",0,0,0,0,0,0,0,0
"El Salvador","2024-08-08",0,0,0,0,0,0,0,0
"El Salvador","2024-08-09",0,0,0,0,0,0,0,0
"El Salvador","2024-08-10",0,0,0,0,0,0,0,0
"El Salvador","2024-08-11",0,0,0,0,0,0,0,0
"El Salvador","2024-08-12",0,0,0,0,0,0,0,0
"El Salvador","2024-08-13",0,0,0,0,0,0,0,0
"El Salvador","2024-08-14",0,0,0,0,0,0,0,0
"El Salvador","2024-08-15",0,0,0,0,0,0,0,0
"El Salvador","2024-08-16",0,0,0,0,0,0,0,0
"El Salvador","2024-08-17",0,0,0,0,0,0,0,0
"El Salvador","2024-08-18",0,0,0,0,0,0,0,0
"El Salvador","2024-08-19",0,0,0,0,0,0,0,0
"El Salvador","2024-08-20",0,0,0,0,0,0,0,0
"El Salvador","2024-08-21",0,0,0,0,0,0,0,0
"El Salvador","2024-08-22",0,0,0,0,0,0,0,0
"El Salvador","2024-08-23",0,0,0,0,0,0,0,0
"El Salvador","2024-08-24",0,0,0,0,0,0,0,0
"El Salvador","2024-08-25",0,0,0,0,0,0,0,0
"El Salvador","2024-08-26",0,0,0,0,0,0,0,0
"El Salvador","2024-08-27",0,0,0,0,0,0,0,0
"El Salvador","2024-08-28",0,0,0,0,0,0,0,0
"El Salvador","2024-08-29",0,0,0,0,0,0,0,0
"El Salvador","2024-08-30",0,0,0,0,0,0,0,0
"El Salvador","2024-08-31",0,0,0,0,0,0,0,0
"El Salvador","2024-09-01",0,0,0,0,0,0,0,0
"El Salvador","2024-09-02",0,0,0,0,0,0,0,0
"El Salvador","2024-09-03",0,0,0,0,0,0,0,0
"El Salvador","2024-09-04",0,0,0,0,0,0,0,0
"El Salvador","2024-09-05",0,0,0,0,0,0,0,0
"El Salvador","2024-09-06",0,0,0,0,0,0,0,0
"El Salvador","2024-09-07",0,0,0,0,0,0,0,0
"El Salvador","2024-09-08",0,0,0,0,0,0,0,0
"El Salvador","2024-09-09",0,0,0,0,0,0,0,0
"El Salvador","2024-09-10",0,0,0,0,0,0,0,0
"El Salvador","2024-09-11",0,0,0,0,0,0,0,0
"El Salvador","2024-09-12",0,0,0,0,0,0,0,0
"El Salvador","2024-09-13",0,0,0,0,0,0,0,0
"El Salvador","2024-09-14",0,0,0,0,0,0,0,0
"El Salvador","2024-09-15",0,0,0,0,0,0,0,0
"El Salvador","2024-09-16",0,0,0,0,0,0,0,0
"El Salvador","2024-09-17",0,0,0,0,0,0,0,0
"El Salvador","2024-09-18",0,0,0,0,0,0,0,0
"El Salvador","2024-09-19",0,0,0,0,0,0,0,0
"El Salvador","2024-09-20",0,0,0,0,0,0,0,0
"El Salvador","2024-09-21",0,0,0,0,0,0,0,0
"El Salvador","2024-09-22",0,0,0,0,0,0,0,0
"El Salvador","2024-09-23",0,0,0,0,0,0,0,0
"El Salvador","2024-09-24",0,0,0,0,0,0,0,0
"El Salvador","2024-09-25",0,0,0,0,0,0,0,0
"El Salvador","2024-09-26",0,0,0,0,0,0,0,0
"El Salvador","2024-09-27",0,0,0,0,0,0,0,0
"El Salvador","2024-09-28",0,0,0,0,0,0,0,0
"El Salvador","2024-09-29",0,0,0,0,0,0,0,0
"El Salvador","2024-09-30",0,0,0,0,0,0,0,0
"El Salvador","2024-10-01",0,0,0,0,0,0,0,0
"El Salvador","2024-10-02",0,0,0,0,0,0,0,0
"El Salvador","2024-10-03",0,0,0,0,0,0,0,0
"El Salvador","2024-10-04",0,0,0,0,0,0,0,0
"El Salvador","2024-10-05",0,0,0,0,0,0,0,0
"El Salvador","2024-10-06",0,0,0,0,0,0,0,0
"El Salvador","2024-10-07",0,0,0,0,0,0,0,0
"El Salvador","2024-10-08",0,0,0,0,0,0,0,0
"El Salvador","2024-10-09",0,0,0,0,0,0,0,0
"El Salvador","2024-10-10",0,0,0,0,0,0,0,0
"El Salvador","2024-10-11",0,0,0,0,0,0,0,0
"El Salvador","2024-10-12",0,0,0,0,0,0,0,0
"El Salvador","2024-10-13",0,0,0,0,0,0,0,0
"El Salvador","2024-10-14",0,0,0,0,0,0,0,0
"El Salvador","2024-10-15",0,0,0,0,0,0,0,0
"El Salvador","2024-10-16",0,0,0,0,0,0,0,0
"El Salvador","2024-10-17",0,0,0,0,0,0,0,0
"El Salvador","2024-10-18",0,0,0,0,0,0,0,0
"El Salvador","2024-10-19",0,0,0,0,0,0,0,0
"El Salvador","2024-10-20",0,0,0,0,0,0,0,0
"El Salvador","2024-10-21",0,0,0,0,0,0,0,0
"El Salvador","2024-10-22",0,0,0,0,0,0,0,0
"El Salvador","2024-10-23",0,0,0,0,0,0,0,0
"El Salvador","2024-10-24",0,0,0,0,0,0,0,0
"El Salvador","2024-10-25",0,0,0,0,0,0,0,0
"El Salvador","2024-10-26",0,0,0,0,0,0,0,0
"El Salvador","2024-10-27",0,0,0,0,0,0,0,0
"El Salvador","2024-10-28",0,0,0,0,0,0,0,0
"El Salvador","2024-10-29",0,0,0,0,0,0,0,0
"El Salvador","2024-10-30",0,0,0,0,0,0,0,0
"El Salvador","2024-10-31",0,0,0,0,0,0,0,0
"El Salvador","2024-11-01",0,0,0,0,0,0,0,0
"El Salvador","2024-11-02",0,0,0,0,0,0,0,0
"El Salvador","2024-11-03",0,0,0,0,0,0,0,0
"El Salvador","2024-11-04",0,0,0,0,0,0,0,0
"El Salvador","2024-11-05",0,0,0,0,0,0,0,0
"El Salvador","2024-11-06",0,0,0,0,0,0,0,0
"El Salvador","2024-11-07",0,0,0,0,0,0,0,0
"El Salvador","2024-11-08",0,0,0,0,0,0,0,0
"El Salvador","2024-11-09",0,0,0,0,0,0,0,0
"El Salvador","2024-11-10",0,0,0,0,0,0,0,0
"El Salvador","2024-11-11",0,0,0,0,0,0,0,0
"El Salvador","2024-11-12",0,0,0,0,0,0,0,0
"El Salvador","2024-11-13",0,0,0,0,0,0,0,0
"El Salvador","2024-11-14",0,0,0,0,0,0,0,0
"El Salvador","2024-11-15",0,0,0,0,0,0,0,0
"El Salvador","2024-11-16",0,0,0,0,0,0,0,0
"El Salvador","2024-11-17",0,0,0,0,0,0,0,0
"El Salvador","2024-11-18",0,0,0,0,0,0,0,0
"El Salvador","2024-11-19",0,0,0,0,0,0,0,0
"El Salvador","2024-11-20",0,0,0,0,0,0,0,0
"El Salvador","2024-11-21",0,0,0,0,0,0,0,0
"El Salvador","2024-11-22",0,0,0,0,0,0,0,0
"El Salvador","2024-11-23",0,0,0,0,0,0,0,0
"El Salvador","2024-11-24",0,0,0,0,0,0,0,0
"El Salvador","2024-11-25",0,0,0,0,0,0,0,0
"El Salvador","2024-11-26",0,0,0,0,0,0,0,0
"El Salvador","2024-11-27",0,0,0,0,0,0,0,0
"El Salvador","2024-11-28",0,0,0,0,0,0,0,0
"El Salvador","2024-11-29",0,0,0,0,0,0,0,0
"El Salvador","2024-11-30",0,0,0,0,0,0,0,0
"El Salvador","2024-12-01",0,0,0,0,0,0,0,0
"El Salvador","2024-12-02",0,0,0,0,0,0,0,0
"El Salvador","2024-12-03",0,0,0,0,0,0,0,0
"El Salvador","2024-12-04",0,0,0,0,0,0,0,0
"El Salvador","2024-12-05",0,0,0,0,0,0,0,0
"El Salvador","2024-12-06",0,0,0,0,0,0,0,0
"El Salvador","2024-12-07",0,0,0,0,0,0,0,0
"El Salvador","2024-12-08",0,0,0,0,0,0,0,0
"El Salvador","2024-12-09",0,0,0,0,0,0,0,0
"El Salvador","2024-12-10",0,0,0,0,0,0,0,0
"El Salvador","2024-12-11",0,0,0,0,0,0,0,0
"El Salvador","2024-12-12",0,0,0,0,0,0,0,0
"El Salvador","2024-12-13",0,0,0,0,0,0,0,0
"El Salvador","2024-12-14",0,0,0,0,0,0,0,0
"El Salvador","2024-12-15",0,0,0,0,0,0,0,0
"El Salvador","2024-12-16",0,0,0,0,0,0,0,0
"El Salvador","2024-12-17",0,0,0,0,0,0,0,0
"El Salvador","2024-12-18",0,0,0,0,0,0,0,0
"El Salvador","2024-12-19",0,0,0,0,0,0,0,0
"El Salvador","2024-12-20",0,0,0,0,0,0,0,0
"El Salvador","2024-12-21",0,0,0,0,0,0,0,0
"El Salvador","2024-12-22",0,0,0,0,0,0,0,0
"El Salvador","2024-12-23",0,0,0,0,0,0,0,0
"El Salvador","2024-12-24",0,0,0,0,0,0,0,0
"El Salvador","2024-12-25",0,0,0,0,0,0,0,0
"El Salvador","2024-12-26",0,0,0,0,0,0,0,0
"El Salvador","2024-12-27",0,0,0,0,0,0,0,0
"El Salvador","2024-12-28",0,0,0,0,0,0,0,0
"El Salvador","2024-12-29",0,0,0,0,0,0,0,0
"El Salvador","2024-12-30",0,0,0,0,0,0,0,0
"El Salvador","2024-12-31",0,0,0,0,0,0,0,0
"El Salvador","2025-01-01",0,0,0,0,0,0,0,0
"El Salvador","2025-01-02",0,0,0,0,0,0,0,0
"El Salvador","2025-01-03",0,0,0,0,0,0,0,0
"El Salvador","2025-01-04",0,0,0,0,0,0,0,0
"El Salvador","2025-01-05",0,0,0,0,0,0,0,0
"El Salvador","2025-01-06",0,0,0,0,0,0,0,0
"El Salvador","2025-01-07",0,0,0,0,0,0,0,0
"El Salvador","2025-01-08",0,0,0,0,0,0,0,0
"El Salvador","2025-01-09",0,0,0,0,0,0,0,0
"El Salvador","2025-01-10",0,0,0,0,0,0,0,0
"El Salvador","2025-01-11",0,0,0,0,0,0,0,0
"El Salvador","2025-01-12",0,0,0,0,0,0,0,0
"El Salvador","2025-01-13",0,0,0,0,0,0,0,0
"El Salvador","2025-01-14",0,0,0,0,0,0,0,0
"El Salvador","2025-01-15",0,0,0,0,0,0,0,0
"El Salvador","2025-01-16",0,0,0,0,0,0,0,0
"El Salvador","2025-01-17",0,0,0,0,0,0,0,0
"El Salvador","2025-01-18",0,0,0,0,0,0,0,0
"El Salvador","2025-01-19",0,0,0,0,0,0,0,0
"El Salvador","2025-01-20",0,0,0,0,0,0,0,0
"El Salvador","2025-01-21",0,0,0,0,0,0,0,0
"El Salvador","2025-01-22",0,0,0,0,0,0,0,0
"El Salvador","2025-01-23",0,0,0,0,0,0,0,0
"El Salvador","2025-01-24",0,0,0,0,0,0,0,0
"El Salvador","2025-01-25",0,0,0,0,0,0,0,0
"El Salvador","2025-01-26",0,0,0,0,0,0,0,0
"El Salvador","2025-01-27",0,0,0,0,0,0,0,0
"El Salvador","2025-01-28",0,0,0,0,0,0,0,0
"El Salvador","2025-01-29",0,0,0,0,0,0,0,0
"El Salvador","2025-01-30",0,0,0,0,0,0,0,0
"El Salvador","2025-01-31",0,0,0,0,0,0,0,0
"El Salvador","2025-02-01",0,0,0,0,0,0,0,0
"El Salvador","2025-02-02",0,0,0,0,0,0,0,0
"El Salvador","2025-02-03",0,0,0,0,0,0,0,0
"El Salvador","2025-02-04",0,0,0,0,0,0,0,0
"El Salvador","2025-02-05",0,0,0,0,0,0,0,0
"El Salvador","2025-02-06",0,0,0,0,0,0,0,0
"El Salvador","2025-02-07",0,0,0,0,0,0,0,0
"El Salvador","2025-02-08",0,0,0,0,0,0,0,0
"El Salvador","2025-02-09",0,0,0,0,0,0,0,0
"El Salvador","2025-02-10",0,0,0,0,0,0,0,0
"El Salvador","2025-02-11",0,0,0,0,0,0,0,0
"El Salvador","2025-02-12",0,0,0,0,0,0,0,0
"El Salvador","2025-02-13",0,0,0,0,0,0,0,0
"El Salvador","2025-02-14",0,0,0,0,0,0,0,0
"El Salvador","2025-02-15",0,0,0,0,0,0,0,0
"El Salvador","2025-02-16",0,0,0,0,0,0,0,0
"El Salvador","2025-02-17",0,0,0,0,0,0,0,0
"El Salvador","2025-02-18",0,0,0,0,0,0,0,0
"El Salvador","2025-02-19",0,0,0,0,0,0,0,0
"El Salvador","2025-02-20",0,0,0,0,0,0,0,0
"El Salvador","2025-02-21",0,0,0,0,0,0,0,0
"El Salvador","2025-02-22",0,0,0,0,0,0,0,0
"El Salvador","2025-02-23",0,0,0,0,0,0,0,0
"El Salvador","2025-02-24",0,0,0,0,0,0,0,0
"El Salvador","2025-02-25",0,0,0,0,0,0,0,0
"El Salvador","2025-02-26",0,0,0,0,0,0,0,0
"El Salvador","2025-02-27",0,0,0,0,0,0,0,0
"El Salvador","2025-02-28",0,0,0,0,0,0,0,0
"El Salvador","2025-03-01",0,0,0,0,0,0,0,0
"El Salvador","2025-03-02",0,0,0,0,0,0,0,0
"El Salvador","2025-03-03",0,0,0,0,0,0,0,0
"Estonia","2024-01-01",0,0,0,0,0,0,0,0
"Estonia","2024-01-02",0,0,0,0,0,0,0,0
"Estonia","2024-01-03",0,0,0,0,0,0,0,0
"Estonia","2024-01-04",0,0,0,0,0,0,0,0
"Estonia","2024-01-05",0,0,0,0,0,0,0,0
"Estonia","2024-01-06",0,0,0,0,0,0,0,0
"Estonia","2024-01-07",0,0,0,0,0,0,0,0
"Estonia","2024-01-08",0,0,0,0,0,0,0,0
"Estonia","2024-01-09",0,0,0,0,0,0,0,0
"Estonia","2024-01-10",0,0,0,0,0,0,0,0
"Estonia","2024-01-11",0,0,0,0,0,0,0,0
"Estonia","2024-01-12",0,0,0,0,0,0,0,0
"Estonia","2024-01-13",0,0,0,0,0,0,0,0
"Estonia","2024-01-14",0,0,0,0,0,0,0,0
"Estonia","2024-01-15",0,0,0,0,0,0,0,0
"Estonia","2024-01-16",0,0,0,0,0,0,0,0
"Estonia","2024-01-17",0,0,0,0,0,0,0,0
"Estonia","2024-01-18",0,0,0,0,0,0,0,0
"Estonia","2024-01-19",0,0,0,0,0,0,0,0
"Estonia","2024-01-20",0,0,0,0,0,0,0,0
"Estonia","2024-01-21",0,0,0,0,0,0,0,0
"Estonia","2024-01-22",0,0,0,0,0,0,0,0
"Estonia","2024-01-23",0,0,0,0,0,0,0,0
"Estonia","2024-01-24",0,0,0,0,0,0,0,0
"Estonia","2024-01-25",0,0,0,0,0,0,0,0
"Estonia","2024-01-26",0,0,0,0,0,0,0,0
"Estonia","2024-01-27",0,0,0,0,0,0,0,0
"Estonia","2024-01-28",0,0,0,0,0,0,0,0
"Estonia","2024-01-29",0,0,0,0,0,0,0,0
"Estonia","2024-01-30",0,0,0,0,0,0,0,0
"Estonia","2024-01-31",0,0,0,0,0,0,0,0
"Estonia","2024-02-01",0,0,0,0,0,0,0,0
"Estonia","2024-02-02",0,0,0,0,0,0,0,0
"Estonia","2024-02-03",0,0,0,0,0,0,0,0
"Estonia","2024-02-04",0,0,0,0,0,0,0,0
"Estonia","2024-02-05",0,0,0,0,0,0,0,0
"Estonia","2024-02-06",0,0,0,0,0,0,0,0
"Estonia","2024-02-07",0,0,0,0,0,0,0,0
"Estonia","2024-02-08",0,0,0,0,0,0,0,0
"Estonia","2024-02-09",0,0,0,0,0,0,0,0
"Estonia","2024-02-10",0,0,0,0,0,0,0,0
"Estonia","2024-02-11",0,0,0,0,0,0,0,0
"Estonia","2024-02-12",0,0,0,0,0,0,0,0
"Estonia","2024-02-13",0,0,0,0,0,0,0,0
"Estonia","2024-02-14",0,0,0,0,0,0,0,0
"Estonia","2024-02-15",0,0,0,0,0,0,0,0
"Estonia","2024-02-16",0,0,0,0,0,0,0,0
"Estonia","2024-02-17",0,0,0,0,0,0,0,0
"Estonia","2024-02-18",0,0,0,0,0,0,0,0
"Estonia","2024-02-19",0,0,0,0,0,0,0,0
"Estonia","2024-02-20",0,0,0,0,0,0,0,0
"Estonia","2024-02-21",0,0,0,0,0,0,0,0
"Estonia","2024-02-22",0,0,0,0,0,0,0,0
"Estonia","2024-02-23",0,0,0,0,0,0,0,0
"Estonia","2024-02-24",0,0,0,0,0,0,0,0
"Estonia","2024-02-25",0,0,0,0,0,0,0,0
"Estonia","2024-02-26",0,0,0,0,0,0,0,0
"Estonia","2024-02-27",0,0,0,0,0,0,0,0
"Estonia","2024-02-28",0,0,0,0,0,0,0,0
"Estonia","2024-02-29",0,0,0,0,0,0,0,0
"Estonia","2024-03-01",0,0,0,0,0,0,0,0
"Estonia","2024-03-02",0,0,0,0,0,0,0,0
"Estonia","2024-03-03",0,0,0,0,0,0,0,0
"Estonia","2024-03-04",0,0,0,0,0,0,0,0
"Estonia","2024-03-05",0,0,0,0,0,0,0,0
"Estonia","2024-03-06",0,0,0,0,0,0,0,0
"Estonia","2024-03-07",0,0,0,0,0,0,0,0
"Estonia","2024-03-08",0,0,0,0,0,0,0,0
"Estonia","2024-03-09",0,0,0,0,0,0,0,0
"Estonia","2024-03-10",0,0,0,0,0,0,0,0
"Estonia","2024-03-11",0,0,0,0,0,0,0,0
"Estonia","2024-03-12",0,0,0,0,0,0,0,0
"Estonia","2024-03-13",0,0,0,0,0,0,0,0
"Estonia","2024-03-14",0,0,0,0,0,0,0,0
"Estonia","2024-03-15",0,0,0,0,0,0,0,0
"Estonia","2024-03-16",0,0,0,0,0,0,0,0
"Estonia","2024-03-17",0,0,0,0,0,0,0,0
"Estonia","2024-03-18",0,0,0,0,0,0,0,0
"Estonia","2024-03-19",0,0,0,0,0,0,0,0
"Estonia","2024-03-20",0,0,0,0,0,0,0,0
"Estonia","2024-03-21",0,0,0,0,0,0,0,0
"Estonia","2024-03-22",0,0,0,0,0,0,0,0
"Estonia","2024-03-23",0,0,0,0,0,0,0,0
"Estonia","2024-03-24",0,0,0,0,0,0,0,0
"Estonia","2024-03-25",0,0,0,0,0,0,0,0
"Estonia","2024-03-26",0,0,0,0,0,0,0,0
"Estonia","2024-03-27",0,0,0,0,0,0,0,0
"Estonia","2024-03-28",0,0,0,0,0,0,0,0
"Estonia","2024-03-29",0,0,0,0,0,0,0,0
"Estonia","2024-03-30",0,0,0,0,0,0,0,0
"Estonia","2024-03-31",0,0,0,0,0,0,0,0
"Estonia","2024-04-01",0,0,0,0,0,0,0,0
"Estonia","2024-04-02",0,0,0,0,0,0,0,0
"Estonia","2024-04-03",0,0,0,0,0,0,0,0
"Estonia","2024-04-04",0,0,0,0,0,0,0,0
"Estonia","2024-04-05",0,0,0,0,0,0,0,0
"Estonia","2024-04-06",0,0,0,0,0,0,0,0
"Estonia","2024-04-07",0,0,0,0,0,0,0,0
"Estonia","2024-04-08",0,0,0,0,0,0,0,0
"Estonia","2024-04-09",0,0,0,0,0,0,0,0
"Estonia","2024-04-10",0,0,0,0,0,0,0,0
"Estonia","2024-04-11",0,0,0,0,0,0,0,0
"Estonia","2024-04-12",0,0,0,0,0,0,0,0
"Estonia","2024-04-13",0,0,0,0,0,0,0,0
"Estonia","2024-04-14",0,0,0,0,0,0,0,0
"Estonia","2024-04-15",0,0,0,0,0,0,0,0
"Estonia","2024-04-16",0,0,0,0,0,0,0,0
"Estonia","2024-04-17",0,0,0,0,0,0,0,0
"Estonia","2024-04-18",0,0,0,0,0,0,0,0
"Estonia","2024-04-19",0,0,0,0,0,0,0,0
"Estonia","2024-04-20",0,0,0,0,0,0,0,0
"Estonia","2024-04-21",0,0,0,0,0,0,0,0
"Estonia","2024-04-22",0,0,0,0,0,0,0,0
"Estonia","2024-04-23",0,0,0,0,0,0,0,0
"Estonia","2024-04-24",0,0,0,0,0,0,0,0
"Estonia","2024-04-25",0,0,0,0,0,0,0,0
"Estonia","2024-04-26",0,0,0,0,0,0,0,0
"Estonia","2024-04-27",0,0,0,0,0,0,0,0
"Estonia","2024-04-28",0,0,0,0,0,0,0,0
"Estonia","2024-04-29",0,0,0,0,0,0,0,0
"Estonia","2024-04-30",0,0,0,0,0,0,0,0
"Estonia","2024-05-01",0,0,0,0,0,0,0,0
"Estonia","2024-05-02",0,0,0,0,0,0,0,0
"Estonia","2024-05-03",0,0,0,0,0,0,0,0
"Estonia","2024-05-04",0,0,0,0,0,0,0,0
"Estonia","2024-05-05",0,0,0,0,0,0,0,0
"Estonia","2024-05-06",0,0,0,0,0,0,0,0
"Estonia","2024-05-07",0,0,0,0,0,0,0,0
"Estonia","2024-05-08",0,0,0,0,0,0,0,0
"Estonia","2024-05-09",0,0,0,0,0,0,0,0
"Estonia","2024-05-10",0,0,0,0,0,0,0,0
"Estonia","2024-05-11",0,0,0,0,0,0,0,0
"Estonia","2024-05-12",0,0,0,0,0,0,0,0
"Estonia","2024-05-13",0,0,0,0,0,0,0,0
"Estonia","2024-05-14",0,0,0,0,0,0,0,0
"Estonia","2024-05-15",0,0,0,0,0,0,0,0
"Estonia","2024-05-16",0,0,0,0,0,0,0,0
"Estonia","2024-05-17",0,0,0,0,0,0,0,0
"Estonia","2024-05-18",0,0,0,0,0,0,0,0
"Estonia","2024-05-19",0,0,0,0,0,0,0,0
"Estonia","2024-05-20",0,0,0,0,0,0,0,0
"Estonia","2024-05-21",0,0,0,0,0,0,0,0
"Estonia","2024-05-22",0,0,0,0,0,0,0,0
"Estonia","2024-05-23",0,0,0,0,0,0,0,0
"Estonia","2024-05-24",0,0,0,0,0,0,0,0
"Estonia","2024-05-25",0,0,0,0,0,0,0,0
"Estonia","2024-05-26",0,0,0,0,0,0,0,0
"Estonia","2024-05-27",0,0,0,0,0,0,0,0
"Estonia","2024-05-28",0,0,0,0,0,0,0,0
"Estonia","2024-05-29",0,0,0,0,0,0,0,0
"Estonia","2024-05-30",0,0,0,0,0,0,0,0
"Estonia","2024-05-31",0,0,0,0,0,0,0,0
"Estonia","2024-06-01",0,0,0,0,0,0,0,0
"Estonia","2024-06-02",0,0,0,0,0,0,0,0
"Estonia","2024-06-03",0,0,0,0,0,0,0,0
"Estonia","2024-06-04",0,0,0,0,0,0,0,0
"Estonia","2024-06-05",0,0,0,0,0,0,0,0
"Estonia","2024-06-06",0,0,0,0,0,0,0,0
"Estonia","2024-06-07",0,0,0,0,0,0,0,0
"Estonia","2024-06-08",0,0,0,0,0,0,0,0
"Estonia","2024-06-09",0,0,0,0,0,0,0,0
"Estonia","2024-06-10",0,0,0,0,0,0,0,0
"Estonia","2024-06-11",0,0,0,0,0,0,0,0
"Estonia","2024-06-12",0,0,0,0,0,0,0,0
"Estonia","2024-06-13",0,0,0,0,0,0,0,0
"Estonia","2024-06-14",0,0,0,0,0,0,0,0
"Estonia","2024-06-15",0,0,0,0,0,0,0,0
"Estonia","2024-06-16",0,0,0,0,0,0,0,0
"Estonia","2024-06-17",0,0,0,0,0,0,0,0
"Estonia","2024-06-18",0,0,0,0,0,0,0,0
"Estonia","2024-06-19",0,0,0,0,0,0,0,0
"Estonia","2024-06-20",0,0,0,0,0,0,0,0
"Estonia","2024-06-21",0,0,0,0,0,0,0,0
"Estonia","2024-06-22",0,0,0,0,0,0,0,0
"Estonia","2024-06-23",0,0,0,0,0,0,0,0
"Estonia","2024-06-24",0,0,0,0,0,0,0,0
"Estonia","2024-06-25",0,0,0,0,0,0,0,0
"Estonia","2024-06-26",0,0,0,0,0,0,0,0
"Estonia","2024-06-27",0,0,0,0,0,0,0,0
"Estonia","2024-06-28",0,0,0,0,0,0,0,0
"Estonia","2024-06-29",0,0,0,0,0,0,0,0
"Estonia","2024-06-30",0,0,0,0,0,0,0,0
"Estonia","2024-07-01",0,0,0,0,0,0,0,0
"Estonia","2024-07-02",0,0,0,0,0,0,0,0
"Estonia","2024-07-03",0,0,0,0,0,0,0,0
"Estonia","2024-07-04",0,0,0,0,0,0,0,0
"Estonia","2024-07-05",0,0,0,0,0,0,0,0
"Estonia","2024-07-06",0,0,0,0,0,0,0,0
"Estonia","2024-07-07",0,0,0,0,0,0,0,0
"Estonia","2024-07-08",0,0,0,0,0,0,0,0
"Estonia","2024-07-09",0,0,0,0,0,0,0,0
"Estonia","2024-07-10",0,0,0,0,0,0,0,0
"Estonia","2024-07-11",0,0,0,0,0,0,0,0
"Estonia","2024-07-12",0,0,0,0,0,0,0,0
"Estonia","2024-07-13",0,0,0,0,0,0,0,0
"Estonia","2024-07-14",0,0,0,0,0,0,0,0
"Estonia","2024-07-15",0,0,0,0,0,0,0,0
"Estonia","2024-07-16",0,0,0,0,0,0,0,0
"Estonia","2024-07-17",0,0,0,0,0,0,0,0
"Estonia","2024-07-18",0,0,0,0,0,0,0,0
"Estonia","2024-07-19",0,0,0,0,0,0,0,0
"Estonia","2024-07-20",0,0,0,0,0,0,0,0
"Estonia","2024-07-21",0,0,0,0,0,0,0,0
"Estonia","2024-07-22",0,0,0,0,0,0,0,0
"Estonia","2024-07-23",0,0,0,0,0,0,0,0
"Estonia","2024-07-24",0,0,0,0,0,0,0,0
"Estonia","2024-07-25",0,0,0,0,0,0,0,0
"Estonia","2024-07-26",0,0,0,0,0,0,0,0
"Estonia","2024-07-27",0,0,0,0,0,0,0,0
"Estonia","2024-07-28",0,0,0,0,0,0,0,0
"Estonia","2024-07-29",0,0,0,0,0,0,0,0
"Estonia","2024-07-30",0,0,0,0,0,0,0,0
"Estonia","2024-07-31",0,0,0,0,0,0,0,0
"Estonia","2024-08-01",0,0,0,0,0,0,0,0
"Estonia","2024-08-02",0,0,0,0,0,0,0,0
"Estonia","2024-08-03",0,0,0,0,0,0,0,0
"Estonia","2024-08-04",0,0,0,0,0,0,0,0
"Estonia","2024-08-05",0,0,0,0,0,0,0,0
"Estonia","2024-08-06",0,0,0,0,0,0,0,0
"Estonia","2024-08-07",0,0,0,0,0,0,0,0
"Estonia","2024-08-08",0,0,0,0,0,0,0,0
"Estonia","2024-08-09",0,0,0,0,0,0,0,0
"Estonia","2024-08-10",0,0,0,0,0,0,0,0
"Estonia","2024-08-11",0,0,0,0,0,0,0,0
"Estonia","2024-08-12",0,0,0,0,0,0,0,0
"Estonia","2024-08-13",0,0,0,0,0,0,0,0
"Estonia","2024-08-14",0,0,0,0,0,0,0,0
"Estonia","2024-08-15",0,0,0,0,0,0,0,0
"Estonia","2024-08-16",0,0,0,0,0,0,0,0
"Estonia","2024-08-17",0,0,0,0,0,0,0,0
"Estonia","2024-08-18",0,0,0,0,0,0,0,0
"Estonia","2024-08-19",0,0,0,0,0,0,0,0
"Estonia","2024-08-20",0,0,0,0,0,0,0,0
"Estonia","2024-08-21",0,0,0,0,0,0,0,0
"Estonia","2024-08-22",0,0,0,0,0,0,0,0
"Estonia","2024-08-23",0,0,0,0,0,0,0,0
"Estonia","2024-08-24",0,0,0,0,0,0,0,0
"Estonia","2024-08-25",0,0,0,0,0,0,0,0
"Estonia","2024-08-26",0,0,0,0,0,0,0,0
"Estonia","2024-08-27",0,0,0,0,0,0,0,0
"Estonia","2024-08-28",0,0,0,0,0,0,0,0
"Estonia","2024-08-29",0,0,0,0,0,0,0,0
"Estonia","2024-08-30",0,0,0,0,0,0,0,0
"Estonia","2024-08-31",0,0,0,0,0,0,0,0
"Estonia","2024-09-01",0,0,0,0,0,0,0,0
"Estonia","2024-09-02",0,0,0,0,0,0,0,0
"Estonia","2024-09-03",0,0,0,0,0,0,0,0
"Estonia","2024-09-04",0,0,0,0,0,0,0,0
"Estonia","2024-09-05",0,0,0,0,0,0,0,0
"Estonia","2024-09-06",0,0,0,0,0,0,0,0
"Estonia","2024-09-07",0,0,0,0,0,0,0,0
"Estonia","2024-09-08",0,0,0,0,0,0,0,0
"Estonia","2024-09-09",0,0,0,0,0,0,0,0
"Estonia","2024-09-10",0,0,0,0,0,0,0,0
"Estonia","2024-09-11",0,0,0,0,0,0,0,0
"Estonia","2024-09-12",0,0,0,0,0,0,0,0
"Estonia","2024-09-13",0,0,0,0,0,0,0,0
"Estonia","2024-09-14",0,0,0,0,0,0,0,0
"Estonia","2024-09-15",0,0,0,0,0,0,0,0
"Estonia","2024-09-16",0,0,0,0,0,0,0,0
"Estonia","2024-09-17",0,0,0,0,0,0,0,0
"Estonia","2024-09-18",0,0,0,0,0,0,0,0
"Estonia","2024-09-19",0,0,0,0,0,0,0,0
"Estonia","2024-09-20",0,0,0,0,0,0,0,0
"Estonia","2024-09-21",0,0,0,0,0,0,0,0
"Estonia","2024-09-22",0,0,0,0,0,0,0,0
"Estonia","2024-09-23",0,0,0,0,0,0,0,0
"Estonia","2024-09-24",0,0,0,0,0,0,0,0
"Estonia","2024-09-25",0,0,0,0,0,0,0,0
"Estonia","2024-09-26",0,0,0,0,0,0,0,0
"Estonia","2024-09-27",0,0,0,0,0,0,0,0
"Estonia","2024-09-28",0,0,0,0,0,0,0,0
"Estonia","2024-09-29",0,0,0,0,0,0,0,0
"Estonia","2024-09-30",0,0,0,0,0,0,0,0
"Estonia","2024-10-01",0,0,0,0,0,0,0,0
"Estonia","2024-10-02",0,0,0,0,0,0,0,0
"Estonia","2024-10-03",0,0,0,0,0,0,0,0
"Estonia","2024-10-04",0,0,0,0,0,0,0,0
"Estonia","2024-10-05",0,0,0,0,0,0,0,0
"Estonia","2024-10-06",0,0,0,0,0,0,0,0
"Estonia","2024-10-07",0,0,0,0,0,0,0,0
"Estonia","2024-10-08",0,0,0,0,0,0,0,0
"Estonia","2024-10-09",0,0,0,0,0,0,0,0
"Estonia","2024-10-10",0,0,0,0,0,0,0,0
"Estonia","2024-10-11",0,0,0,0,0,0,0,0
"Estonia","2024-10-12",0,0,0,0,0,0,0,0
"Estonia","2024-10-13",0,0,0,0,0,0,0,0
"Estonia","2024-10-14",0,0,0,0,0,0,0,0
"Estonia","2024-10-15",0,0,0,0,0,0,0,0
"Estonia","2024-10-16",0,0,0,0,0,0,0,0
"Estonia","2024-10-17",0,0,0,0,0,0,0,0
"Estonia","2024-10-18",0,0,0,0,0,0,0,0
"Estonia","2024-10-19",0,0,0,0,0,0,0,0
"Estonia","2024-10-20",0,0,0,0,0,0,0,0
"Estonia","2024-10-21",0,0,0,0,0,0,0,0
"Estonia","2024-10-22",0,0,0,0,0,0,0,0
"Estonia","2024-10-23",0,0,0,0,0,0,0,0
"Estonia","2024-10-24",0,0,0,0,0,0,0,0
"Estonia","2024-10-25",0,0,0,0,0,0,0,0
"Estonia","2024-10-26",0,0,0,0,0,0,0,0
"Estonia","2024-10-27",0,0,0,0,0,0,0,0
"Estonia","2024-10-28",0,0,0,0,0,0,0,0
"Estonia","2024-10-29",0,0,0,0,0,0,0,0
"Estonia","2024-10-30",0,0,0,0,0,0,0,0
"Estonia","2024-10-31",0,0,0,0,0,0,0,0
"Estonia","2024-11-01",0,0,0,0,0,0,0,0
"Estonia","2024-11-02",0,0,0,0,0,0,0,0
"Estonia","2024-11-03",0,0,0,0,0,0,0,0
"Estonia","2024-11-04",0,0,0,0,0,0,0,0
"Estonia","2024-11-05",0,0,0,0,0,0,0,0
"Estonia","2024-11-06",0,0,0,0,0,0,0,0
"Estonia","2024-11-07",0,0,0,0,0,0,0,0
"Estonia","2024-11-08",0,0,0,0,0,0,0,0
"Estonia","2024-11-09",0,0,0,0,0,0,0,0
"Estonia","2024-11-10",0,0,0,0,0,0,0,0
"Estonia","2024-11-11",0,0,0,0,0,0,0,0
"Estonia","2024-11-12",0,0,0,0,0,0,0,0
"Estonia","2024-11-13",0,0,0,0,0,0,0,0
"Estonia","2024-11-14",0,0,0,0,0,0,0,0
"Estonia","2024-11-15",0,0,0,0,0,0,0,0
"Estonia","2024-11-16",0,0,0,0,0,0,0,0
"Estonia","2024-11-17",0,0,0,0,0,0,0,0
"Estonia","2024-11-18",0,0,0,0,0,0,0,0
"Estonia","2024-11-19",0,0,0,0,0,0,0,0
"Estonia","2024-11-20",0,0,0,0,0,0,0,0
"Estonia","2024-11-21",0,0,0,0,0,0,0,0
"Estonia","2024-11-22",0,0,0,0,0,0,0,0
"Estonia","2024-11-23",0,0,0,0,0,0,0,0
"Estonia","2024-11-24",0,0,0,0,0,0,0,0
"Estonia","2024-11-25",0,0,0,0,0,0,0,0
"Estonia","2024-11-26",0,0,0,0,0,0,0,0
"Estonia","2024-11-27",0,0,0,0,0,0,0,0
"Estonia","2024-11-28",0,0,0,0,0,0,0,0
"Estonia","2024-11-29",0,0,0,0,0,0,0,0
"Estonia","2024-11-30",0,0,0,0,0,0,0,0
"Estonia","2024-12-01",0,0,0,0,0,0,0,0
"Estonia","2024-12-02",0,0,0,0,0,0,0,0
"Estonia","2024-12-03",0,0,0,0,0,0,0,0
"Estonia","2024-12-04",0,0,0,0,0,0,0,0
"Estonia","2024-12-05",0,0,0,0,0,0,0,0
"Estonia","2024-12-06",0,0,0,0,0,0,0,0
"Estonia","2024-12-07",0,0,0,0,0,0,0,0
"Estonia","2024-12-08",0,0,0,0,0,0,0,0
"Estonia","2024-12-09",0,0,0,0,0,0,0,0
"Estonia","2024-12-10",0,0,0,0,0,0,0,0
"Estonia","2024-12-11",0,0,0,0,0,0,0,0
"Estonia","2024-12-12",0,0,0,0,0,0,0,0
"Estonia","2024-12-13",0,0,0,0,0,0,0,0
"Estonia","2024-12-14",0,0,0,0,0,0,0,0
"Estonia","2024-12-15",0,0,0,0,0,0,0,0
"Estonia","2024-12-16",0,0,0,0,0,0,0,0
"Estonia","2024-12-17",0,0,0,0,0,0,0,0
"Estonia","2024-12-18",0,0,0,0,0,0,0,0
"Estonia","2024-12-19",0,0,0,0,0,0,0,0
"Estonia","2024-12-20",0,0,0,0,0,0,0,0
"Estonia","2024-12-21",0,0,0,0,0,0,0,0
"Estonia","2024-12-22",0,0,0,0,0,0,0,0
"Estonia","2024-12-23",0,0,0,0,0,0,0,0
"Estonia","2024-12-24",0,0,0,0,0,0,0,0
"Estonia","2024-12-25",0,0,0,0,0,0,0,0
"Estonia","2024-12-26",0,0,0,0,0,0,0,0
"Estonia","2024-12-27",0,0,0,0,0,0,0,0
"Estonia","2024-12-28",0,0,0,0,0,0,0,0
"Estonia","2024-12-29",0,0,0,0,0,0,0,0
"Estonia","2024-12-30",0,0,0,0,0,0,0,0
"Estonia","2024-12-31",0,0,0,0,0,0,0,0
"Estonia","2025-01-01",0,0,0,0,0,0,0,0
"Estonia","2025-01-02",0,0,0,0,0,0,0,0
"Estonia","2025-01-03",0,0,0,0,0,0,0,0
"Estonia","2025-01-04",0,0,0,0,0,0,0,0
"Estonia","2025-01-05",0,0,0,0,0,0,0,0
"Estonia","2025-01-06",0,0,0,0,0,0,0,0
"Estonia","2025-01-07",0,0,0,0,0,0,0,0
"Estonia","2025-01-08",0,0,0,0,0,0,0,0
"Estonia","2025-01-09",0,0,0,0,0,0,0,0
"Estonia","2025-01-10",0,0,0,0,0,0,0,0
"Estonia","2025-01-11",0,0,0,0,0,0,0,0
"Estonia","2025-01-12",0,0,0,0,0,0,0,0
"Estonia","2025-01-13",0,0,0,0,0,0,0,0
"Estonia","2025-01-14",0,0,0,0,0,0,0,0
"Estonia","2025-01-15",0,0,0,0,0,0,0,0
"Estonia","2025-01-16",0,0,0,0,0,0,0,0
"Estonia","2025-01-17",0,0,0,0,0,0,0,0
"Estonia","2025-01-18",0,0,0,0,0,0,0,0
"Estonia","2025-01-19",0,0,0,0,0,0,0,0
"Estonia","2025-01-20",0,0,0,0,0,0,0,0
"Estonia","2025-01-21",0,0,0,0,0,0,0,0
"Estonia","2025-01-22",0,0,0,0,0,0,0,0
"Estonia","2025-01-23",0,0,0,0,0,0,0,0
"Estonia","2025-01-24",0,0,0,0,0,0,0,0
"Estonia","2025-01-25",0,0,0,0,0,0,0,0
"Estonia","2025-01-26",0,0,0,0,0,0,0,0
"Estonia","2025-01-27",0,0,0,0,0,0,0,0
"Estonia","2025-01-28",0,0,0,0,0,0,0,0
"Estonia","2025-01-29",0,0,0,0,0,0,0,0
"Estonia","2025-01-30",0,0,0,0,0,0,0,0
"Estonia","2025-01-31",0,0,0,0,0,0,0,0
"Estonia","2025-02-01",0,0,0,0,0,0,0,0
"Estonia","2025-02-02",0,0,0,0,0,0,0,0
"Estonia","2025-02-03",0,0,0,0,0,0,0,0
"Estonia","2025-02-04",0,0,0,0,0,0,0,0
"Estonia","2025-02-05",0,0,0,0,0,0,0,0
"Estonia","2025-02-06",0,0,0,0,0,0,0,0
"Estonia","2025-02-07",0,0,0,0,0,0,0,0
"Estonia","2025-02-08",0,0,0,0,0,0,0,0
"Estonia","2025-02-09",0,0,0,0,0,0,0,0
"Estonia","2025-02-10",0,0,0,0,0,0,0,0
"Estonia","2025-02-11",0,0,0,0,0,0,0,0
"Estonia","2025-02-12",0,0,0,0,0,0,0,0
"Estonia","2025-02-13",0,0,0,0,0,0,0,0
"Estonia","2025-02-14",0,0,0,0,0,0,0,0
"Estonia","2025-02-15",0,0,0,0,0,0,0,0
"Estonia","2025-02-16",0,0,0,0,0,0,0,0
"Estonia","2025-02-17",0,0,0,0,0,0,0,0
"Estonia","2025-02-18",0,0,0,0,0,0,0,0
"Estonia","2025-02-19",0,0,0,0,0,0,0,0
"Estonia","2025-02-20",0,0,0,0,0,0,0,0
"Estonia","2025-02-21",0,0,0,0,0,0,0,0
"Estonia","2025-02-22",0,0,0,0,0,0,0,0
"Estonia","2025-02-23",0,0,0,0,0,0,0,0
"Estonia","2025-02-24",0,0,0,0,0,0,0,0
"Estonia","2025-02-25",0,0,0,0,0,0,0,0
"Estonia","2025-02-26",0,0,0,0,0,0,0,0
"Estonia","2025-02-27",0,0,0,0,0,0,0,0
"Estonia","2025-02-28",0,0,0,0,0,0,0,0
"Estonia","2025-03-01",0,0,0,0,0,0,0,0
"Estonia","2025-03-02",0,0,0,0,0,0,0,0
"Estonia","2025-03-03",0,0,0,0,0,0,0,0
"Europe","2024-01-01",0,0,0,0,0,0,0,0
"Europe","2024-01-02",0,0,0,0,0,0,0,0
"Europe","2024-01-03",0,0,0,0,0,0,0,0
"Europe","2024-01-04",0,0,0,0,0,0,0,0
"Europe","2024-01-05",0,0,0,0,0,0,0,0
"Europe","2024-01-06",0,0,0,0,0,0,0,0
"Europe","2024-01-07",0,0,0,0,0,0,0,0
"Europe","2024-01-08",0,0,0,0,0,0,0,0
"Europe","2024-01-09",0,0,0,0,0,0,0,0
"Europe","2024-01-10",0,0,0,0,0,0,0,0
"Europe","2024-01-11",0,0,0,0,0,0,0,0
"Europe","2024-01-12",0,0,0,0,0,0,0,0
"Europe","2024-01-13",0,0,0,0,0,0,0,0
"Europe","2024-01-14",0,0,0,0,0,0,0,0
"Europe","2024-01-15",0,0,0,0,0,0,0,0
"Europe","2024-01-16",0,0,0,0,0,0,0,0
"Europe","2024-01-17",0,0,0,0,0,0,0,0
"Europe","2024-01-18",0,0,0,0,0,0,0,0
"Europe","2024-01-19",0,0,0,0,0,0,0,0
"Europe","2024-01-20",0,0,0,0,0,0,0,0
"Europe","2024-01-21",0,0,0,0,0,0,0,0
"Europe","2024-01-22",0,0,0,0,0,0,0,0
"Europe","2024-01-23",0,0,0,0,0,0,0,0
"Europe","2024-01-24",0,0,0,0,0,0,0,0
"Europe","2024-01-25",0,0,0,0,0,0,0,0
"Europe","2024-01-26",0,0,0,0,0,0,0,0
"Europe","2024-01-27",0,0,0,0,0,0,0,0
"Europe","2024-01-28",0,0,0,0,0,0,0,0
"Europe","2024-01-29",0,0,0,0,0,0,0,0
"Europe","2024-01-30",0,0,0,0,0,0,0,0
"Europe","2024-01-31",0,141,141,0,141,141,0,0
"Europe","2024-02-01",0,0,141,0,7,148,0,0
"Europe","2024-02-02",0,0,141,0,6,154,0,0
"Europe","2024-02-03",0,0,141,0,7,161,0,0
"Europe","2024-02-04",0,0,141,0,7,168,0,0
"Europe","2024-02-05",0,0,141,0,7,175,0,0
"Europe","2024-02-06",0,0,141,0,6,181,0,0
"Europe","2024-02-07",0,0,141,0,7,188,0,0
"Europe","2024-02-08",0,0,141,0,7,195,0,0
"Europe","2024-02-09",0,0,141,0,7,202,0,0
"Europe","2024-02-10",0,0,141,0,6,208,0,0
"Europe","2024-02-11",0,0,141,0,7,215,0,0
"Europe","2024-02-12",0,0,141,0,7,222,0,0
"Europe","2024-02-13",0,0,141,0,6,228,0,0
"Europe","2024-02-14",0,0,141,0,7,235,0,0
"Europe","2024-02-15",0,0,141,0,7,242,0,0
"Europe","2024-02-16",0,0,141,0,7,249,0,0
"Europe","2024-02-17",0,0,141,0,6,255,0,0
"Europe","2024-02-18",0,0,141,0,7,262,0,0
"Europe","2024-02-19",0,0,141,0,7,269,0,0
"Europe","2024-02-20",0,0,141,0,6,275,0,0
"Europe","2024-02-21",0,0,141,0,7,282,0,0
"Europe","2024-02-22",0,0,141,0,7,289,0,0
"Europe","2024-02-23",0,0,141,0,7,296,0,0
"Europe","2024-02-24",0,0,141,0,6,302,0,0
"Europe","2024-02-25",0,0,141,0,7,309,0,0
"Europe","2024-02-26",0,0,141,0,7,316,0,0
"Europe","2024-02-27",0,0,141,0,7,323,0,0
"Europe","2024-02-28",0,0,141,0,6,329,0,0
"Europe","2024-02-29",0,195,336,0,7,336,0,0
"Europe","2024-03-01",0,0,336,0,4,340,0,0
"Europe","2024-03-02",0,0,336,0,4,344,0,0
"Europe","2024-03-03",0,0,336,0,4,348,0,0
"Europe","2024-03-04",0,0,336,0,4,352,0,0
"Europe","2024-03-05",0,0,336,0,4,356,0,0
"Europe","2024-03-06",0,0,336,0,4,360,0,0
"Europe","2024-03-07",0,0,336,0,4,364,0,0
"Europe","2024-03-08",0,0,336,0,4,368,0,0
"Europe","2024-03-09",0,0,336,0,4,372,0,0
"Europe","2024-03-10",0,0,336,0,4,376,0,0
"Europe","2024-03-11",0,0,336,0,4,380,0,0
"Europe","2024-03-12",0,0,336,0,4,384,0,0
"Europe","2024-03-13",0,0,336,0,4,388,0,0
"Europe","2024-03-14",0,0,336,0,4,392,0,0
"Europe","2024-03-15",0,0,336,0,4,396,0,0
"Europe","2024-03-16",0,0,336,0,3,399,0,0
"Europe","2024-03-17",0,0,336,0,4,403,0,0
"Europe","2024-03-18",0,0,336,0,4,407,0,0
"Europe","2024-03-19",0,0,336,0,4,411,0,0
"Europe","2024-03-20",0,0,336,0,4,415,0,0
"Europe","2024-03-21",0,0,336,0,4,419,0,0
"Europe","2024-03-22",0,0,336,0,4,423,0,0
"Europe","2024-03-23",0,0,336,0,4,427,0,0
"Europe","2024-03-24",0,0,336,0,4,431,0,0
"Europe","2024-03-25",0,0,336,0,4,435,0,0
"Europe","2024-03-26",0,0,336,0,4,439,0,0
"Europe","2024-03-27",0,0,336,0,4,443,0,0
"Europe","2024-03-28",0,0,336,0,4,447,0,0
"Europe","2024-03-29",0,0,336,0,4,451,0,0
"Europe","2024-03-30",0,0,336,0,4,455,0,0
"Europe","2024-03-31",0,123,459,0,4,459,0,0
"Europe","2024-04-01",0,0,459,0,4,463,0,0
"Europe","2024-04-02",0,0,459,0,3,466,0,0
"Europe","2024-04-03",0,0,459,0,4,470,0,0
"Europe","2024-04-04",0,0,459,0,3,473,0,0
"Europe","2024-04-05",0,0,459,0,4,477,0,0
"Europe","2024-04-06",0,0,459,0,4,481,0,0
"Europe","2024-04-07",0,0,459,0,3,484,0,0
"Europe","2024-04-08",0,0,459,0,4,488,0,0
"Europe","2024-04-09",0,0,459,0,3,491,0,0
"Europe","2024-04-10",0,0,459,0,4,495,0,0
"Europe","2024-04-11",0,0,459,0,4,499,0,0
"Europe","2024-04-12",0,0,459,0,3,502,0,0
"Europe","2024-04-13",0,0,459,0,4,506,0,0
"Europe","2024-04-14",0,0,459,0,3,509,0,0
"Europe","2024-04-15",0,0,459,0,4,513,0,0
"Europe","2024-04-16",0,0,459,0,4,517,0,0
"Europe","2024-04-17",0,0,459,0,3,520,0,0
"Europe","2024-04-18",0,0,459,0,4,524,0,0
"Europe","2024-04-19",0,0,459,0,3,527,0,0
"Europe","2024-04-20",0,0,459,0,4,531,0,0
"Europe","2024-04-21",0,0,459,0,4,535,0,0
"Europe","2024-04-22",0,0,459,0,3,538,0,0
"Europe","2024-04-23",0,0,459,0,4,542,0,0
"Europe","2024-04-24",0,0,459,0,3,545,0,0
"Europe","2024-04-25",0,0,459,0,4,549,0,0
"Europe","2024-04-26",0,0,459,0,4,553,0,0
"Europe","2024-04-27",0,0,459,0,3,556,0,0
"Europe","2024-04-28",0,0,459,0,4,560,0,0
"Europe","2024-04-29",0,0,459,0,3,563,0,0
"Europe","2024-04-30",0,108,567,0,4,567,0,0
"Europe","2024-05-01",0,0,567,0,4,571,0,0
"Europe","2024-05-02",0,0,567,0,4,575,0,0
"Europe","2024-05-03",0,0,567,0,4,579,0,0
"Europe","2024-05-04",0,0,567,0,4,583,0,0
"Europe","2024-05-05",0,0,567,0,4,587,0,0
"Europe","2024-05-06",0,0,567,0,4,591,0,0
"Europe","2024-05-07",0,0,567,0,4,595,0,0
"Europe","2024-05-08",0,0,567,0,4,599,0,0
"Europe","2024-05-09",0,0,567,0,4,603,0,0
"Europe","2024-05-10",0,0,567,0,4,607,0,0
"Europe","2024-05-11",0,0,567,0,4,611,0,0
"Europe","2024-05-12",0,0,567,0,4,615,0,0
"Europe","2024-05-13",0,0,567,0,4,619,0,0
"Europe","2024-05-14",0,0,567,0,4,623,0,0
"Europe","2024-05-15",0,0,567,0,4,627,0,0
"Europe","2024-05-16",0,0,567,0,3,630,0,0
"Europe","2024-05-17",0,0,567,0,4,634,0,0
"Europe","2024-05-18",0,0,567,0,4,638,0,0
"Europe","2024-05-19",0,0,567,0,4,642,0,0
"Europe","2024-05-20",0,0,567,0,4,646,0,0
"Europe","2024-05-21",0,0,567,0,4,650,0,0
"Europe","2024-05-22",0,0,567,0,4,654,0,0
"Europe","2024-05-23",0,0,567,0,4,658,0,0
"Europe","2024-05-24",0,0,567,0,4,662,0,0
"Europe","2024-05-25",0,0,567,0,4,666,0,0
"Europe","2024-05-26",0,0,567,0,4,670,0,0
"Europe","2024-05-27",0,0,567,0,4,674,0,0
"Europe","2024-05-28",0,0,567,0,4,678,0,0
"Europe","2024-05-29",0,0,567,0,4,682,0,0
"Europe","2024-05-30",0,0,567,0,4,686,0,0
"Europe","2024-05-31",0,123,690,0,4,690,0,0
"Europe","2024-06-01",0,0,690,0,3,693,0,0
"Europe","2024-06-02",0,0,690,0,4,697,0,0
"Europe","2024-06-03",0,0,690,0,3,700,0,0
"Europe","2024-06-04",0,0,690,0,3,703,0,0
"Europe","2024-06-05",0,0,690,0,3,706,0,0
"Europe","2024-06-06",0,0,690,0,4,710,0,0
"Europe","2024-06-07",0,0,690,0,3,713,0,0
"Europe","2024-06-08",0,0,690,0,3,716,0,0
"Europe","2024-06-09",0,0,690,0,3,719,0,0
"Europe","2024-06-10",0,0,690,0,4,723,0,0
"Europe","2024-06-11",0,0,690,0,3,726,0,0
"Europe","2024-06-12",0,0,690,0,3,729,0,0
"Europe","2024-06-13",0,0,690,0,3,732,0,0
"Europe","2024-06-14",0,0,690,0,4,736,0,0
"Europe","2024-06-15",0,0,690,0,3,739,0,0
"Europe","2024-06-16",0,0,690,0,3,742,0,0
"Europe","2024-06-17",0,0,690,0,4,746,0,0
"Europe","2024-06-18",0,0,690,0,3,749,0,0
"Europe","2024-06-19",0,0,690,0,3,752,0,0
"Europe","2024-06-20",0,0,690,0,3,755,0,0
"Europe","2024-06-21",0,0,690,0,4,759,0,0
"Europe","2024-06-22",0,0,690,0,3,762,0,0
"Europe","2024-06-23",0,0,690,0,3,765,0,0
"Europe","2024-06-24",0,0,690,0,3,768,0,0
"Europe","2024-06-25",0,0,690,0,4,772,0,0
"Europe","2024-06-26",0,0,690,0,3,775,0,0
"Europe","2024-06-27",0,0,690,0,3,778,0,0
"Europe","2024-06-28",0,0,690,0,3,781,0,0
"Europe","2024-06-29",0,0,690,0,4,785,0,0
"Europe","2024-06-30",0,98,788,0,3,788,0,0
"Europe","2024-07-01",0,0,788,0,5,793,0,0
"Europe","2024-07-02",0,0,788,0,5,798,0,0
"Europe","2024-07-03",0,0,788,0,4,802,0,0
"Europe","2024-07-04",0,0,788,0,5,807,0,0
"Europe","2024-07-05",0,0,788,0,5,812,0,0
"Europe","2024-07-06",0,0,788,0,5,817,0,0
"Europe","2024-07-07",0,0,788,0,4,821,0,0
"Europe","2024-07-08",0,0,788,0,5,826,0,0
"Europe","2024-07-09",0,0,788,0,5,831,0,0
"Europe","2024-07-10",0,0,788,0,5,836,0,0
"Europe","2024-07-11",0,0,788,0,5,841,0,0
"Europe","2024-07-12",0,0,788,0,4,845,0,0
"Europe","2024-07-13",0,0,788,0,5,850,0,0
"Europe","2024-07-14",0,0,788,0,5,855,0,0
"Europe","2024-07-15",0,0,788,0,5,860,0,0
"Europe","2024-07-16",0,0,788,0,4,864,0,0
"Europe","2024-07-17",0,0,788,0,5,869,0,0
"Europe","2024-07-18",0,0,788,0,5,874,0,0
"Europe","2024-07-19",0,0,788,0,5,879,0,0
"Europe","2024-07-20",0,0,788,0,4,883,0,0
"Europe","2024-07-21",0,0,788,0,5,888,0,0
"Europe","2024-07-22",0,0,788,0,5,893,0,0
"Europe","2024-07-23",0,0,788,0,5,898,0,0
"Europe","2024-07-24",0,0,788,0,5,903,0,0
"Europe","2024-07-25",0,0,788,0,4,907,0,0
"Europe","2024-07-26",0,0,788,0,5,912,0,0
"Europe","2024-07-27",0,0,788,0,5,917,0,0
"Europe","2024-07-28",0,0,788,0,5,922,0,0
"Europe","2024-07-29",0,0,788,0,4,926,0,0
"Europe","2024-07-30",0,0,788,0,5,931,0,0
"Europe","2024-07-31",0,148,936,0,5,936,0,0
"Europe","2024-08-01",0,0,936,0,9,945,0,0
"Europe","2024-08-02",0,0,936,0,9,954,0,0
"Europe","2024-08-03",0,0,936,0,9,963,0,0
"Europe","2024-08-04",0,0,936,0,9,972,0,0
"Europe","2024-08-05",0,0,936,0,9,981,0,0
"Europe","2024-08-06",0,0,936,0,9,990,0,0
"Europe","2024-08-07",0,0,936,0,9,999,0,0
"Europe","2024-08-08",0,0,936,0,10,1009,0,0
"Europe","2024-08-09",0,0,936,0,9,1018,0,0
"Europe","2024-08-10",0,0,936,0,9,1027,0,0
"Europe","2024-08-11",0,0,936,0,9,1036,0,0
"Europe","2024-08-12",0,0,936,0,9,1045,0,0
"Europe","2024-08-13",0,0,936,0,9,1054,0,0
"Europe","2024-08-14",0,0,936,0,9,1063,0,0
"Europe","2024-08-15",0,0,936,0,9,1072,0,0
"Europe","2024-08-16",0,0,936,0,9,1081,0,0
"Europe","2024-08-17",0,0,936,0,9,1090,0,0
"Europe","2024-08-18",0,0,936,0,9,1099,0,0
"Europe","2024-08-19",0,0,936,0,9,1108,0,0
"Europe","2024-08-20",0,0,936,0,9,1117,0,0
"Europe","2024-08-21",0,0,936,0,9,1126,0,0
"Europe","2024-08-22",0,0,936,0,9,1135,0,0
"Europe","2024-08-23",0,0,936,0,9,1144,0,0
"Europe","2024-08-24",0,0,936,0,10,1154,0,0
"Europe","2024-08-25",0,0,936,0,9,1163,0,0
"Europe","2024-08-26",0,0,936,0,9,1172,0,0
"Europe","2024-08-27",0,0,936,0,9,1181,0,0
"Europe","2024-08-28",0,0,936,0,9,1190,0,0
"Europe","2024-08-29",0,0,936,0,9,1199,0,0
"Europe","2024-08-30",0,0,936,0,9,1208,0,0
"Europe","2024-08-31",0,281,1217,0,9,1217,0,0
"Europe","2024-09-01",0,0,1217,0,6,1223,0,0
"Europe","2024-09-02",0,0,1217,0,7,1230,0,0
"Europe","2024-09-03",0,0,1217,0,6,1236,0,0
"Europe","2024-09-04",0,0,1217,0,6,1242,0,0
"Europe","2024-09-05",0,0,1217,0,7,1249,0,0
"Europe","2024-09-06",0,0,1217,0,6,1255,0,0
"Europe","2024-09-07",0,0,1217,0,7,1262,0,0
"Europe","2024-09-08",0,0,1217,0,6,1268,0,0
"Europe","2024-09-09",0,0,1217,0,6,1274,0,0
"Europe","2024-09-10",0,0,1217,0,7,1281,0,0
"Europe","2024-09-11",0,0,1217,0,6,1287,0,0
"Europe","2024-09-12",0,0,1217,0,6,1293,0,0
"Europe","2024-09-13",0,0,1217,0,7,1300,0,0
"Europe","2024-09-14",0,0,1217,0,6,1306,0,0
"Europe","2024-09-15",0,0,1217,0,7,1313,0,0
"Europe","2024-09-16",0,0,1217,0,6,1319,0,0
"Europe","2024-09-17",0,0,1217,0,6,1325,0,0
"Europe","2024-09-18",0,0,1217,0,7,1332,0,0
"Europe","2024-09-19",0,0,1217,0,6,1338,0,0
"Europe","2024-09-20",0,0,1217,0,6,1344,0,0
"Europe","2024-09-21",0,0,1217,0,7,1351,0,0
"Europe","2024-09-22",0,0,1217,0,6,1357,0,0
"Europe","2024-09-23",0,0,1217,0,6,1363,0,0
"Europe","2024-09-24",0,0,1217,0,7,1370,0,0
"Europe","2024-09-25",0,0,1217,0,6,1376,0,0
"Europe","2024-09-26",0,0,1217,0,7,1383,0,0
"Europe","2024-09-27",0,0,1217,0,6,1389,0,0
"Europe","2024-09-28",0,0,1217,0,6,1395,0,0
"Europe","2024-09-29",0,0,1217,0,7,1402,0,0
"Europe","2024-09-30",0,191,1408,0,6,1408,0,0
"Europe","2024-10-01",0,0,1408,0,8,1416,0,0
"Europe","2024-10-02",0,0,1408,0,7,1423,0,0
"Europe","2024-10-03",0,0,1408,0,8,1431,0,0
"Europe","2024-10-04",0,0,1408,0,7,1438,0,0
"Europe","2024-10-05",0,0,1408,0,8,1446,0,0
"Europe","2024-10-06",0,0,1408,0,7,1453,0,0
"Europe","2024-10-07",0,0,1408,0,8,1461,0,0
"Europe","2024-10-08",0,0,1408,0,7,1468,0,0
"Europe","2024-10-09",0,0,1408,0,8,1476,0,0
"Europe","2024-10-10",0,0,1408,0,7,1483,0,0
"Europe","2024-10-11",0,0,1408,0,8,1491,0,0
"Europe","2024-10-12",0,0,1408,0,8,1499,0,0
"Europe","2024-10-13",0,0,1408,0,7,1506,0,0
"Europe","2024-10-14",0,0,1408,0,8,1514,0,0
"Europe","2024-10-15",0,0,1408,0,7,1521,0,0
"Europe","2024-10-16",0,0,1408,0,8,1529,0,0
"Europe","2024-10-17",0,0,1408,0,7,1536,0,0
"Europe","2024-10-18",0,0,1408,0,8,1544,0,0
"Europe","2024-10-19",0,0,1408,0,7,1551,0,0
"Europe","2024-10-20",0,0,1408,0,8,1559,0,0
"Europe","2024-10-21",0,0,1408,0,8,1567,0,0
"Europe","2024-10-22",0,0,1408,0,7,1574,0,0
"Europe","2024-10-23",0,0,1408,0,8,1582,0,0
"Europe","2024-10-24",0,0,1408,0,7,1589,0,0
"Europe","2024-10-25",0,0,1408,0,8,1597,0,0
"Europe","2024-10-26",0,0,1408,0,7,1604,0,0
"Europe","2024-10-27",0,0,1408,0,8,1612,0,0
"Europe","2024-10-28",0,0,1408,0,7,1619,0,0
"Europe","2024-10-29",0,0,1408,0,8,1627,0,0
"Europe","2024-10-30",0,0,1408,0,7,1634,0,0
"Europe","2024-10-31",0,234,1642,0,8,1642,0,0
"Europe","2024-11-01",0,0,1642,0,9,1651,0,0
"Europe","2024-11-02",0,0,1642,0,9,1660,0,0
"Europe","2024-11-03",0,0,1642,0,10,1670,0,0
"Europe","2024-11-04",0,0,1642,0,9,1679,0,0
"Europe","2024-11-05",0,0,1642,0,9,1688,0,0
"Europe","2024-11-06",0,0,1642,0,9,1697,0,0
"Europe","2024-11-07",0,0,1642,0,10,1707,0,0
"Europe","2024-11-08",0,0,1642,0,9,1716,0,0
"Europe","2024-11-09",0,0,1642,0,9,1725,0,0
"Europe","2024-11-10",0,0,1642,0,9,1734,0,0
"Europe","2024-11-11",0,0,1642,0,10,1744,0,0
"Europe","2024-11-12",0,0,1642,0,9,1753,0,0
"Europe","2024-11-13",0,0,1642,0,9,1762,0,0
"Europe","2024-11-14",0,0,1642,0,9,1771,0,0
"Europe","2024-11-15",0,0,1642,0,9,1780,0,0
"Europe","2024-11-16",0,0,1642,0,10,1790,0,0
"Europe","2024-11-17",0,0,1642,0,9,1799,0,0
"Europe","2024-11-18",0,0,1642,0,9,1808,0,0
"Europe","2024-11-19",0,0,1642,0,9,1817,0,0
"Europe","2024-11-20",0,0,1642,0,10,1827,0,0
"Europe","2024-11-21",0,0,1642,0,9,1836,0,0
"Europe","2024-11-22",0,0,1642,0,9,1845,0,0
"Europe","2024-11-23",0,0,1642,0,9,1854,0,0
"Europe","2024-11-24",0,0,1642,0,10,1864,0,0
"Europe","2024-11-25",0,0,1642,0,9,1873,0,0
"Europe","2024-11-26",0,0,1642,0,9,1882,0,0
"Europe","2024-11-27",0,0,1642,0,9,1891,0,0
"Europe","2024-11-28",0,0,1642,0,10,1901,0,0
"Europe","2024-11-29",0,0,1642,0,9,1910,0,0
"Europe","2024-11-30",0,277,1919,0,9,1919,0,0
"Europe","2024-12-01",0,0,1919,0,7,1926,0,0
"Europe","2024-12-02",0,0,1919,0,6,1932,0,0
"Europe","2024-12-03",0,0,1919,0,7,1939,0,0
"Europe","2024-12-04",0,0,1919,0,6,1945,0,0
"Europe","2024-12-05",0,0,1919,0,7,1952,0,0
"Europe","2024-12-06",0,0,1919,0,6,1958,0,0
"Europe","2024-12-07",0,0,1919,0,7,1965,0,0
"Europe","2024-12-08",0,0,1919,0,6,1971,0,0
"Europe","2024-12-09",0,0,1919,0,7,1978,0,0
"Europe","2024-12-10",0,0,1919,0,6,1984,0,0
"Europe","2024-12-11",0,0,1919,0,7,1991,0,0
"Europe","2024-12-12",0,0,1919,0,6,1997,0,0
"Europe","2024-12-13",0,0,1919,0,7,2004,0,0
"Europe","2024-12-14",0,0,1919,0,6,2010,0,0
"Europe","2024-12-15",0,0,1919,0,7,2017,0,0
"Europe","2024-12-16",0,0,1919,0,6,2023,0,0
"Europe","2024-12-17",0,0,1919,0,7,2030,0,0
"Europe","2024-12-18",0,0,1919,0,6,2036,0,0
"Europe","2024-12-19",0,0,1919,0,7,2043,0,0
"Europe","2024-12-20",0,0,1919,0,6,2049,0,0
"Europe","2024-12-21",0,0,1919,0,7,2056,0,0
"Europe","2024-12-22",0,0,1919,0,6,2062,0,0
"Europe","2024-12-23",0,0,1919,0,7,2069,0,0
"Europe","2024-12-24",0,0,1919,0,6,2075,0,0
"Europe","2024-12-25",0,0,1919,0,7,2082,0,0
"Europe","2024-12-26",0,0,1919,0,6,2088,0,0
"Europe","2024-12-27",0,0,1919,0,7,2095,0,0
"Europe","2024-12-28",0,0,1919,0,6,2101,0,0
"Europe","2024-12-29",0,0,1919,0,7,2108,0,0
"Europe","2024-12-30",0,0,1919,0,6,2114,0,0
"Europe","2024-12-31",0,202,2121,0,7,2121,0,0
"Europe","2025-01-01",0,0,2121,0,22,2143,0,0
"Europe","2025-01-02",0,0,2121,0,21,2164,0,0
"Europe","2025-01-03",0,0,2121,0,22,2186,0,0
"Europe","2025-01-04",0,0,2121,0,22,2208,0,0
"Europe","2025-01-05",0,0,2121,0,21,2229,0,0
"Europe","2025-01-06",0,0,2121,0,22,2251,0,0
"Europe","2025-01-07",0,0,2121,0,22,2273,0,0
"Europe","2025-01-08",0,0,2121,0,22,2295,0,0
"Europe","2025-01-09",0,0,2121,0,21,2316,0,0
"Europe","2025-01-10",0,217,2338,0,22,2338,0,0
"Europe","2025-01-11",0,0,2338,0,0,2338,0,0
"Europe","2025-01-12",0,0,2338,0,0,2338,0,0
"Europe","2025-01-13",0,0,2338,0,0,2338,0,0
"Europe","2025-01-14",0,0,2338,0,0,2338,0,0
"Europe","2025-01-15",0,0,2338,0,0,2338,0,0
"Europe","2025-01-16",0,0,2338,0,0,2338,0,0
"Europe","2025-01-17",0,0,2338,0,0,2338,0,0
"Europe","2025-01-18",0,0,2338,0,0,2338,0,0
"Europe","2025-01-19",0,0,2338,0,0,2338,0,0
"Europe","2025-01-20",0,0,2338,0,0,2338,0,0
"Europe","2025-01-21",0,0,2338,0,0,2338,0,0
"Europe","2025-01-22",0,0,2338,0,0,2338,0,0
"Europe","2025-01-23",0,0,2338,0,0,2338,0,0
"Europe","2025-01-24",0,0,2338,0,0,2338,0,0
"Europe","2025-01-25",0,0,2338,0,0,2338,0,0
"Europe","2025-01-26",0,0,2338,0,0,2338,0,0
"Europe","2025-01-27",0,0,2338,0,0,2338,0,0
"Europe","2025-01-28",0,0,2338,0,0,2338,0,0
"Europe","2025-01-29",0,0,2338,0,0,2338,0,0
"Europe","2025-01-30",0,0,2338,0,0,2338,0,0
"Europe","2025-01-31",0,0,2338,0,0,2338,0,0
"Europe","2025-02-01",0,0,2338,0,0,2338,0,0
"Europe","2025-02-02",0,0,2338,0,0,2338,0,0
"Europe","2025-02-03",0,0,2338,0,0,2338,0,0
"Europe","2025-02-04",0,0,2338,0,0,2338,0,0
"Europe","2025-02-05",0,0,2338,0,0,2338,0,0
"Europe","2025-02-06",0,0,2338,0,0,2338,0,0
"Europe","2025-02-07",0,0,2338,0,0,2338,0,0
"Europe","2025-02-08",0,0,2338,0,0,2338,0,0
"Europe","2025-02-09",0,0,2338,0,0,2338,0,0
"Europe","2025-02-10",0,0,2338,0,0,2338,0,0
"Europe","2025-02-11",0,0,2338,0,0,2338,0,0
"Europe","2025-02-12",0,0,2338,0,0,2338,0,0
"Europe","2025-02-13",0,0,2338,0,0,2338,0,0
"Europe","2025-02-14",0,0,2338,0,0,2338,0,0
"Europe","2025-02-15",0,0,2338,0,0,2338,0,0
"Europe","2025-02-16",0,0,2338,0,0,2338,0,0
"Europe","2025-02-17",0,0,2338,0,0,2338,0,0
"Europe","2025-02-18",0,0,2338,0,0,2338,0,0
"Europe","2025-02-19",0,0,2338,0,0,2338,0,0
"Europe","2025-02-20",0,0,2338,0,0,2338,0,0
"Europe","2025-02-21",0,0,2338,0,0,2338,0,0
"Europe","2025-02-22",0,0,2338,0,0,2338,0,0
"Europe","2025-02-23",0,0,2338,0,0,2338,0,0
"Europe","2025-02-24",0,0,2338,0,0,2338,0,0
"Europe","2025-02-25",0,0,2338,0,0,2338,0,0
"Europe","2025-02-26",0,0,2338,0,0,2338,0,0
"Europe","2025-02-27",0,0,2338,0,0,2338,0,0
"Europe","2025-02-28",0,0,2338,0,0,2338,0,0
"Europe","2025-03-01",0,0,2338,0,0,2338,0,0
"Europe","2025-03-02",0,0,2338,0,0,2338,0,0
"Europe","2025-03-03",0,0,2338,0,0,2338,0,0
"Finland","2024-01-01",0,0,0,0,0,0,0,0
"Finland","2024-01-02",0,0,0,0,0,0,0,0
"Finland","2024-01-03",0,0,0,0,0,0,0,0
"Finland","2024-01-04",0,0,0,0,0,0,0,0
"Finland","2024-01-05",0,0,0,0,0,0,0,0
"Finland","2024-01-06",0,0,0,0,0,0,0,0
"Finland","2024-01-07",0,0,0,0,0,0,0,0
"Finland","2024-01-08",0,0,0,0,0,0,0,0
"Finland","2024-01-09",0,0,0,0,0,0,0,0
"Finland","2024-01-10",0,0,0,0,0,0,0,0
"Finland","2024-01-11",0,0,0,0,0,0,0,0
"Finland","2024-01-12",0,0,0,0,0,0,0,0
"Finland","2024-01-13",0,0,0,0,0,0,0,0
"Finland","2024-01-14",0,0,0,0,0,0,0,0
"Finland","2024-01-15",0,0,0,0,0,0,0,0
"Finland","2024-01-16",0,0,0,0,0,0,0,0
"Finland","2024-01-17",0,0,0,0,0,0,0,0
"Finland","2024-01-18",0,0,0,0,0,0,0,0
"Finland","2024-01-19",0,0,0,0,0,0,0,0
"Finland","2024-01-20",0,0,0,0,0,0,0,0
"Finland","2024-01-21",0,0,0,0,0,0,0,0
"Finland","2024-01-22",0,0,0,0,0,0,0,0
"Finland","2024-01-23",0,0,0,0,0,0,0,0
"Finland","2024-01-24",0,0,0,0,0,0,0,0
"Finland","2024-01-25",0,0,0,0,0,0,0,0
"Finland","2024-01-26",0,0,0,0,0,0,0,0
"Finland","2024-01-27",0,0,0,0,0,0,0,0
"Finland","2024-01-28",0,0,0,0,0,0,0,0
"Finland","2024-01-29",0,0,0,0,0,0,0,0
"Finland","2024-01-30",0,0,0,0,0,0,0,0
"Finland","2024-01-31",0,0,0,0,0,0,0,0
"Finland","2024-02-01",0,0,0,0,0,0,0,0
"Finland","2024-02-02",0,0,0,0,0,0,0,0
"Finland","2024-02-03",0,0,0,0,0,0,0,0
"Finland","2024-02-04",0,0,0,0,0,0,0,0
"Finland","2024-02-05",0,0,0,0,0,0,0,0
"Finland","2024-02-06",0,0,0,0,0,0,0,0
"Finland","2024-02-07",0,0,0,0,0,0,0,0
"Finland","2024-02-08",0,0,0,0,0,0,0,0
"Finland","2024-02-09",0,0,0,0,0,0,0,0
"Finland","2024-02-10",0,0,0,0,0,0,0,0
"Finland","2024-02-11",0,0,0,0,0,0,0,0
"Finland","2024-02-12",0,0,0,0,0,0,0,0
"Finland","2024-02-13",0,0,0,0,0,0,0,0
"Finland","2024-02-14",0,0,0,0,0,0,0,0
"Finland","2024-02-15",0,0,0,0,0,0,0,0
"Finland","2024-02-16",0,0,0,0,0,0,0,0
"Finland","2024-02-17",0,0,0,0,0,0,0,0
"Finland","2024-02-18",0,0,0,0,0,0,0,0
"Finland","2024-02-19",0,0,0,0,0,0,0,0
"Finland","2024-02-20",0,0,0,0,0,0,0,0
"Finland","2024-02-21",0,0,0,0,0,0,0,0
"Finland","2024-02-22",0,0,0,0,0,0,0,0
"Finland","2024-02-23",0,0,0,0,0,0,0,0
"Finland","2024-02-24",0,0,0,0,0,0,0,0
"Finland","2024-02-25",0,0,0,0,0,0,0,0
"Finland","2024-02-26",0,0,0,0,0,0,0,0
"Finland","2024-02-27",0,0,0,0,0,0,0,0
"Finland","2024-02-28",0,0,0,0,0,0,0,0
"Finland","2024-02-29",0,1,1,0,1,1,0,0
"Finland","2024-03-01",0,0,1,0,0,1,0,0
"Finland","2024-03-02",0,0,1,0,0,1,0,0
"Finland","2024-03-03",0,0,1,0,0,1,0,0
"Finland","2024-03-04",0,0,1,0,0,1,0,0
"Finland","2024-03-05",0,0,1,0,0,1,0,0
"Finland","2024-03-06",0,0,1,0,0,1,0,0
"Finland","2024-03-07",0,0,1,0,0,1,0,0
"Finland","2024-03-08",0,0,1,0,0,1,0,0
"Finland","2024-03-09",0,0,1,0,0,1,0,0
"Finland","2024-03-10",0,0,1,0,0,1,0,0
"Finland","2024-03-11",0,0,1,0,0,1,0,0
"Finland","2024-03-12",0,0,1,0,0,1,0,0
"Finland","2024-03-13",0,0,1,0,0,1,0,0
"Finland","2024-03-14",0,0,1,0,0,1,0,0
"Finland","2024-03-15",0,0,1,0,0,1,0,0
"Finland","2024-03-16",0,0,1,0,0,1,0,0
"Finland","2024-03-17",0,0,1,0,0,1,0,0
"Finland","2024-03-18",0,0,1,0,0,1,0,0
"Finland","2024-03-19",0,0,1,0,0,1,0,0
"Finland","2024-03-20",0,0,1,0,0,1,0,0
"Finland","2024-03-21",0,0,1,0,0,1,0,0
"Finland","2024-03-22",0,0,1,0,0,1,0,0
"Finland","2024-03-23",0,0,1,0,0,1,0,0
"Finland","2024-03-24",0,0,1,0,0,1,0,0
"Finland","2024-03-25",0,0,1,0,0,1,0,0
"Finland","2024-03-26",0,0,1,0,0,1,0,0
"Finland","2024-03-27",0,0,1,0,0,1,0,0
"Finland","2024-03-28",0,0,1,0,0,1,0,0
"Finland","2024-03-29",0,0,1,0,0,1,0,0
"Finland","2024-03-30",0,0,1,0,0,1,0,0
"Finland","2024-03-31",0,0,1,0,0,1,0,0
"Finland","2024-04-01",0,0,1,0,0,1,0,0
"Finland","2024-04-02",0,0,1,0,0,1,0,0
"Finland","2024-04-03",0,0,1,0,0,1,0,0
"Finland","2024-04-04",0,0,1,0,0,1,0,0
"Finland","2024-04-05",0,0,1,0,0,1,0,0
"Finland","2024-04-06",0,0,1,0,0,1,0,0
"Finland","2024-04-07",0,0,1,0,0,1,0,0
"Finland","2024-04-08",0,0,1,0,0,1,0,0
"Finland","2024-04-09",0,0,1,0,0,1,0,0
"Finland","2024-04-10",0,0,1,0,0,1,0,0
"Finland","2024-04-11",0,0,1,0,0,1,0,0
"Finland","2024-04-12",0,0,1,0,0,1,0,0
"Finland","2024-04-13",0,0,1,0,0,1,0,0
"Finland","2024-04-14",0,0,1,0,0,1,0,0
"Finland","2024-04-15",0,0,1,0,0,1,0,0
"Finland","2024-04-16",0,0,1,0,0,1,0,0
"Finland","2024-04-17",0,0,1,0,0,1,0,0
"Finland","2024-04-18",0,0,1,0,0,1,0,0
"Finland","2024-04-19",0,0,1,0,0,1,0,0
"Finland","2024-04-20",0,0,1,0,0,1,0,0
"Finland","2024-04-21",0,0,1,0,0,1,0,0
"Finland","2024-04-22",0,0,1,0,0,1,0,0
"Finland","2024-04-23",0,0,1,0,0,1,0,0
"Finland","2024-04-24",0,0,1,0,0,1,0,0
"Finland","2024-04-25",0,0,1,0,0,1,0,0
"Finland","2024-04-26",0,0,1,0,0,1,0,0
"Finland","2024-04-27",0,0,1,0,0,1,0,0
"Finland","2024-04-28",0,0,1,0,0,1,0,0
"Finland","2024-04-29",0,0,1,0,0,1,0,0
"Finland","2024-04-30",0,0,1,0,0,1,0,0
"Finland","2024-05-01",0,0,1,0,0,1,0,0
"Finland","2024-05-02",0,0,1,0,0,1,0,0
"Finland","2024-05-03",0,0,1,0,0,1,0,0
"Finland","2024-05-04",0,0,1,0,0,1,0,0
"Finland","2024-05-05",0,0,1,0,0,1,0,0
"Finland","2024-05-06",0,0,1,0,0,1,0,0
"Finland","2024-05-07",0,0,1,0,0,1,0,0
"Finland","2024-05-08",0,0,1,0,0,1,0,0
"Finland","2024-05-09",0,0,1,0,0,1,0,0
"Finland","2024-05-10",0,0,1,0,0,1,0,0
"Finland","2024-05-11",0,0,1,0,0,1,0,0
"Finland","2024-05-12",0,0,1,0,0,1,0,0
"Finland","2024-05-13",0,0,1,0,0,1,0,0
"Finland","2024-05-14",0,0,1,0,0,1,0,0
"Finland","2024-05-15",0,0,1,0,0,1,0,0
"Finland","2024-05-16",0,0,1,0,0,1,0,0
"Finland","2024-05-17",0,0,1,0,0,1,0,0
"Finland","2024-05-18",0,0,1,0,0,1,0,0
"Finland","2024-05-19",0,0,1,0,0,1,0,0
"Finland","2024-05-20",0,0,1,0,0,1,0,0
"Finland","2024-05-21",0,0,1,0,0,1,0,0
"Finland","2024-05-22",0,0,1,0,0,1,0,0
"Finland","2024-05-23",0,0,1,0,0,1,0,0
"Finland","2024-05-24",0,0,1,0,0,1,0,0
"Finland","2024-05-25",0,0,1,0,0,1,0,0
"Finland","2024-05-26",0,0,1,0,0,1,0,0
"Finland","2024-05-27",0,0,1,0,0,1,0,0
"Finland","2024-05-28",0,0,1,0,0,1,0,0
"Finland","2024-05-29",0,0,1,0,0,1,0,0
"Finland","2024-05-30",0,0,1,0,0,1,0,0
"Finland","2024-05-31",0,0,1,0,0,1,0,0
"Finland","2024-06-01",0,0,1,0,0,1,0,0
"Finland","2024-06-02",0,0,1,0,0,1,0,0
"Finland","2024-06-03",0,0,1,0,0,1,0,0
"Finland","2024-06-04",0,0,1,0,0,1,0,0
"Finland","2024-06-05",0,0,1,0,0,1,0,0
"Finland","2024-06-06",0,0,1,0,0,1,0,0
"Finland","2024-06-07",0,0,1,0,0,1,0,0
"Finland","2024-06-08",0,0,1,0,0,1,0,0
"Finland","2024-06-09",0,0,1,0,0,1,0,0
"Finland","2024-06-10",0,0,1,0,0,1,0,0
"Finland","2024-06-11",0,0,1,0,0,1,0,0
"Finland","2024-06-12",0,0,1,0,0,1,0,0
"Finland","2024-06-13",0,0,1,0,0,1,0,0
"Finland","2024-06-14",0,0,1,0,0,1,0,0
"Finland","2024-06-15",0,0,1,0,0,1,0,0
"Finland","2024-06-16",0,0,1,0,0,1,0,0
"Finland","2024-06-17",0,0,1,0,0,1,0,0
"Finland","2024-06-18",0,0,1,0,0,1,0,0
"Finland","2024-06-19",0,0,1,0,0,1,0,0
"Finland","2024-06-20",0,0,1,0,0,1,0,0
"Finland","2024-06-21",0,0,1,0,0,1,0,0
"Finland","2024-06-22",0,0,1,0,0,1,0,0
"Finland","2024-06-23",0,0,1,0,0,1,0,0
"Finland","2024-06-24",0,0,1,0,0,1,0,0
"Finland","2024-06-25",0,0,1,0,0,1,0,0
"Finland","2024-06-26",0,0,1,0,0,1,0,0
"Finland","2024-06-27",0,0,1,0,0,1,0,0
"Finland","2024-06-28",0,0,1,0,0,1,0,0
"Finland","2024-06-29",0,0,1,0,0,1,0,0
"Finland","2024-06-30",0,0,1,0,0,1,0,0
"Finland","2024-07-01",0,0,1,0,0,1,0,0
"Finland","2024-07-02",0,0,1,0,0,1,0,0
"Finland","2024-07-03",0,0,1,0,0,1,0,0
"Finland","2024-07-04",0,0,1,0,0,1,0,0
"Finland","2024-07-05",0,0,1,0,0,1,0,0
"Finland","2024-07-06",0,0,1,0,0,1,0,0
"Finland","2024-07-07",0,0,1,0,0,1,0,0
"Finland","2024-07-08",0,0,1,0,0,1,0,0
"Finland","2024-07-09",0,0,1,0,0,1,0,0
"Finland","2024-07-10",0,0,1,0,0,1,0,0
"Finland","2024-07-11",0,0,1,0,0,1,0,0
"Finland","2024-07-12",0,0,1,0,0,1,0,0
"Finland","2024-07-13",0,0,1,0,0,1,0,0
"Finland","2024-07-14",0,0,1,0,0,1,0,0
"Finland","2024-07-15",0,0,1,0,0,1,0,0
"Finland","2024-07-16",0,0,1,0,0,1,0,0
"Finland","2024-07-17",0,0,1,0,0,1,0,0
"Finland","2024-07-18",0,0,1,0,0,1,0,0
"Finland","2024-07-19",0,0,1,0,0,1,0,0
"Finland","2024-07-20",0,0,1,0,0,1,0,0
"Finland","2024-07-21",0,0,1,0,0,1,0,0
"Finland","2024-07-22",0,0,1,0,0,1,0,0
"Finland","2024-07-23",0,0,1,0,0,1,0,0
"Finland","2024-07-24",0,0,1,0,0,1,0,0
"Finland","2024-07-25",0,0,1,0,0,1,0,0
"Finland","2024-07-26",0,0,1,0,0,1,0,0
"Finland","2024-07-27",0,0,1,0,0,1,0,0
"Finland","2024-07-28",0,0,1,0,0,1,0,0
"Finland","2024-07-29",0,0,1,0,0,1,0,0
"Finland","2024-07-30",0,0,1,0,0,1,0,0
"Finland","2024-07-31",0,0,1,0,0,1,0,0
"Finland","2024-08-01",0,0,1,0,0,1,0,0
"Finland","2024-08-02",0,0,1,0,0,1,0,0
"Finland","2024-08-03",0,0,1,0,0,1,0,0
"Finland","2024-08-04",0,0,1,0,0,1,0,0
"Finland","2024-08-05",0,0,1,0,0,1,0,0
"Finland","2024-08-06",0,0,1,0,0,1,0,0
"Finland","2024-08-07",0,0,1,0,0,1,0,0
"Finland","2024-08-08",0,0,1,0,0,1,0,0
"Finland","2024-08-09",0,0,1,0,0,1,0,0
"Finland","2024-08-10",0,0,1,0,0,1,0,0
"Finland","2024-08-11",0,0,1,0,0,1,0,0
"Finland","2024-08-12",0,0,1,0,0,1,0,0
"Finland","2024-08-13",0,0,1,0,0,1,0,0
"Finland","2024-08-14",0,0,1,0,0,1,0,0
"Finland","2024-08-15",0,0,1,0,0,1,0,0
"Finland","2024-08-16",0,0,1,0,0,1,0,0
"Finland","2024-08-17",0,0,1,0,0,1,0,0
"Finland","2024-08-18",0,0,1,0,0,1,0,0
"Finland","2024-08-19",0,0,1,0,0,1,0,0
"Finland","2024-08-20",0,0,1,0,0,1,0,0
"Finland","2024-08-21",0,0,1,0,0,1,0,0
"Finland","2024-08-22",0,0,1,0,0,1,0,0
"Finland","2024-08-23",0,0,1,0,0,1,0,0
"Finland","2024-08-24",0,0,1,0,0,1,0,0
"Finland","2024-08-25",0,0,1,0,0,1,0,0
"Finland","2024-08-26",0,0,1,0,0,1,0,0
"Finland","2024-08-27",0,0,1,0,0,1,0,0
"Finland","2024-08-28",0,0,1,0,0,1,0,0
"Finland","2024-08-29",0,0,1,0,0,1,0,0
"Finland","2024-08-30",0,0,1,0,0,1,0,0
"Finland","2024-08-31",0,0,1,0,0,1,0,0
"Finland","2024-09-01",0,0,1,0,0,1,0,0
"Finland","2024-09-02",0,0,1,0,0,1,0,0
"Finland","2024-09-03",0,0,1,0,0,1,0,0
"Finland","2024-09-04",0,0,1,0,0,1,0,0
"Finland","2024-09-05",0,0,1,0,0,1,0,0
"Finland","2024-09-06",0,0,1,0,0,1,0,0
"Finland","2024-09-07",0,0,1,0,0,1,0,0
"Finland","2024-09-08",0,0,1,0,0,1,0,0
"Finland","2024-09-09",0,0,1,0,0,1,0,0
"Finland","2024-09-10",0,0,1,0,0,1,0,0
"Finland","2024-09-11",0,0,1,0,0,1,0,0
"Finland","2024-09-12",0,0,1,0,0,1,0,0
"Finland","2024-09-13",0,0,1,0,0,1,0,0
"Finland","2024-09-14",0,0,1,0,0,1,0,0
"Finland","2024-09-15",0,0,1,0,0,1,0,0
"Finland","2024-09-16",0,0,1,0,0,1,0,0
"Finland","2024-09-17",0,0,1,0,0,1,0,0
"Finland","2024-09-18",0,0,1,0,0,1,0,0
"Finland","2024-09-19",0,0,1,0,0,1,0,0
"Finland","2024-09-20",0,0,1,0,0,1,0,0
"Finland","2024-09-21",0,0,1,0,0,1,0,0
"Finland","2024-09-22",0,0,1,0,0,1,0,0
"Finland","2024-09-23",0,0,1,0,0,1,0,0
"Finland","2024-09-24",0,0,1,0,0,1,0,0
"Finland","2024-09-25",0,0,1,0,0,1,0,0
"Finland","2024-09-26",0,0,1,0,0,1,0,0
"Finland","2024-09-27",0,0,1,0,0,1,0,0
"Finland","2024-09-28",0,0,1,0,0,1,0,0
"Finland","2024-09-29",0,0,1,0,0,1,0,0
"Finland","2024-09-30",0,0,1,0,0,1,0,0
"Finland","2024-10-01",0,0,1,0,0,1,0,0
"Finland","2024-10-02",0,0,1,0,0,1,0,0
"Finland","2024-10-03",0,0,1,0,0,1,0,0
"Finland","2024-10-04",0,0,1,0,0,1,0,0
"Finland","2024-10-05",0,0,1,0,0,1,0,0
"Finland","2024-10-06",0,0,1,0,0,1,0,0
"Finland","2024-10-07",0,0,1,0,0,1,0,0
"Finland","2024-10-08",0,0,1,0,0,1,0,0
"Finland","2024-10-09",0,0,1,0,0,1,0,0
"Finland","2024-10-10",0,0,1,0,0,1,0,0
"Finland","2024-10-11",0,0,1,0,0,1,0,0
"Finland","2024-10-12",0,0,1,0,0,1,0,0
"Finland","2024-10-13",0,0,1,0,0,1,0,0
"Finland","2024-10-14",0,0,1,0,0,1,0,0
"Finland","2024-10-15",0,0,1,0,0,1,0,0
"Finland","2024-10-16",0,0,1,0,0,1,0,0
"Finland","2024-10-17",0,0,1,0,0,1,0,0
"Finland","2024-10-18",0,0,1,0,0,1,0,0
"Finland","2024-10-19",0,0,1,0,0,1,0,0
"Finland","2024-10-20",0,0,1,0,0,1,0,0
"Finland","2024-10-21",0,0,1,0,0,1,0,0
"Finland","2024-10-22",0,0,1,0,0,1,0,0
"Finland","2024-10-23",0,0,1,0,0,1,0,0
"Finland","2024-10-24",0,0,1,0,0,1,0,0
"Finland","2024-10-25",0,0,1,0,0,1,0,0
"Finland","2024-10-26",0,0,1,0,0,1,0,0
"Finland","2024-10-27",0,0,1,0,0,1,0,0
"Finland","2024-10-28",0,0,1,0,0,1,0,0
"Finland","2024-10-29",0,0,1,0,0,1,0,0
"Finland","2024-10-30",0,0,1,0,0,1,0,0
"Finland","2024-10-31",0,0,1,0,0,1,0,0
"Finland","2024-11-01",0,0,1,0,0,1,0,0
"Finland","2024-11-02",0,0,1,0,0,1,0,0
"Finland","2024-11-03",0,0,1,0,0,1,0,0
"Finland","2024-11-04",0,0,1,0,0,1,0,0
"Finland","2024-11-05",0,0,1,0,0,1,0,0
"Finland","2024-11-06",0,0,1,0,0,1,0,0
"Finland","2024-11-07",0,0,1,0,0,1,0,0
"Finland","2024-11-08",0,0,1,0,0,1,0,0
"Finland","2024-11-09",0,0,1,0,0,1,0,0
"Finland","2024-11-10",0,0,1,0,0,1,0,0
"Finland","2024-11-11",0,0,1,0,0,1,0,0
"Finland","2024-11-12",0,0,1,0,0,1,0,0
"Finland","2024-11-13",0,0,1,0,0,1,0,0
"Finland","2024-11-14",0,0,1,0,0,1,0,0
"Finland","2024-11-15",0,0,1,0,0,1,0,0
"Finland","2024-11-16",0,0,1,0,0,1,0,0
"Finland","2024-11-17",0,0,1,0,0,1,0,0
"Finland","2024-11-18",0,0,1,0,0,1,0,0
"Finland","2024-11-19",0,0,1,0,0,1,0,0
"Finland","2024-11-20",0,0,1,0,0,1,0,0
"Finland","2024-11-21",0,0,1,0,0,1,0,0
"Finland","2024-11-22",0,0,1,0,0,1,0,0
"Finland","2024-11-23",0,0,1,0,0,1,0,0
"Finland","2024-11-24",0,0,1,0,0,1,0,0
"Finland","2024-11-25",0,0,1,0,0,1,0,0
"Finland","2024-11-26",0,0,1,0,0,1,0,0
"Finland","2024-11-27",0,0,1,0,0,1,0,0
"Finland","2024-11-28",0,0,1,0,0,1,0,0
"Finland","2024-11-29",0,0,1,0,0,1,0,0
"Finland","2024-11-30",0,0,1,0,0,1,0,0
"Finland","2024-12-01",0,0,1,0,0,1,0,0
"Finland","2024-12-02",0,0,1,0,0,1,0,0
"Finland","2024-12-03",0,0,1,0,0,1,0,0
"Finland","2024-12-04",0,0,1,0,0,1,0,0
"Finland","2024-12-05",0,0,1,0,0,1,0,0
"Finland","2024-12-06",0,0,1,0,0,1,0,0
"Finland","2024-12-07",0,0,1,0,0,1,0,0
"Finland","2024-12-08",0,0,1,0,0,1,0,0
"Finland","2024-12-09",0,0,1,0,0,1,0,0
"Finland","2024-12-10",0,0,1,0,0,1,0,0
"Finland","2024-12-11",0,0,1,0,0,1,0,0
"Finland","2024-12-12",0,0,1,0,0,1,0,0
"Finland","2024-12-13",0,0,1,0,0,1,0,0
"Finland","2024-12-14",0,0,1,0,0,1,0,0
"Finland","2024-12-15",0,0,1,0,0,1,0,0
"Finland","2024-12-16",0,0,1,0,0,1,0,0
"Finland","2024-12-17",0,0,1,0,0,1,0,0
"Finland","2024-12-18",0,0,1,0,0,1,0,0
"Finland","2024-12-19",0,0,1,0,0,1,0,0
"Finland","2024-12-20",0,0,1,0,0,1,0,0
"Finland","2024-12-21",0,0,1,0,0,1,0,0
"Finland","2024-12-22",0,0,1,0,0,1,0,0
"Finland","2024-12-23",0,0,1,0,0,1,0,0
"Finland","2024-12-24",0,0,1,0,0,1,0,0
"Finland","2024-12-25",0,0,1,0,0,1,0,0
"Finland","2024-12-26",0,0,1,0,0,1,0,0
"Finland","2024-12-27",0,0,1,0,0,1,0,0
"Finland","2024-12-28",0,0,1,0,0,1,0,0
"Finland","2024-12-29",0,0,1,0,0,1,0,0
"Finland","2024-12-30",0,0,1,0,0,1,0,0
"Finland","2024-12-31",0,0,1,0,0,1,0,0
"Finland","2025-01-01",0,0,1,0,0,1,0,0
"Finland","2025-01-02",0,0,1,0,0,1,0,0
"Finland","2025-01-03",0,0,1,0,0,1,0,0
"Finland","2025-01-04",0,0,1,0,0,1,0,0
"Finland","2025-01-05",0,0,1,0,0,1,0,0
"Finland","2025-01-06",0,0,1,0,0,1,0,0
"Finland","2025-01-07",0,0,1,0,0,1,0,0
"Finland","2025-01-08",0,0,1,0,0,1,0,0
"Finland","2025-01-09",0,0,1,0,0,1,0,0
"Finland","2025-01-10",0,0,1,0,0,1,0,0
"Finland","2025-01-11",0,0,1,0,0,1,0,0
"Finland","2025-01-12",0,0,1,0,0,1,0,0
"Finland","2025-01-13",0,0,1,0,0,1,0,0
"Finland","2025-01-14",0,0,1,0,0,1,0,0
"Finland","2025-01-15",0,0,1,0,0,1,0,0
"Finland","2025-01-16",0,0,1,0,0,1,0,0
"Finland","2025-01-17",0,0,1,0,0,1,0,0
"Finland","2025-01-18",0,0,1,0,0,1,0,0
"Finland","2025-01-19",0,0,1,0,0,1,0,0
"Finland","2025-01-20",0,0,1,0,0,1,0,0
"Finland","2025-01-21",0,0,1,0,0,1,0,0
"Finland","2025-01-22",0,0,1,0,0,1,0,0
"Finland","2025-01-23",0,0,1,0,0,1,0,0
"Finland","2025-01-24",0,0,1,0,0,1,0,0
"Finland","2025-01-25",0,0,1,0,0,1,0,0
"Finland","2025-01-26",0,0,1,0,0,1,0,0
"Finland","2025-01-27",0,0,1,0,0,1,0,0
"Finland","2025-01-28",0,0,1,0,0,1,0,0
"Finland","2025-01-29",0,0,1,0,0,1,0,0
"Finland","2025-01-30",0,0,1,0,0,1,0,0
"Finland","2025-01-31",0,0,1,0,0,1,0,0
"Finland","2025-02-01",0,0,1,0,0,1,0,0
"Finland","2025-02-02",0,0,1,0,0,1,0,0
"Finland","2025-02-03",0,0,1,0,0,1,0,0
"Finland","2025-02-04",0,0,1,0,0,1,0,0
"Finland","2025-02-05",0,0,1,0,0,1,0,0
"Finland","2025-02-06",0,0,1,0,0,1,0,0
"Finland","2025-02-07",0,0,1,0,0,1,0,0
"Finland","2025-02-08",0,0,1,0,0,1,0,0
"Finland","2025-02-09",0,0,1,0,0,1,0,0
"Finland","2025-02-10",0,0,1,0,0,1,0,0
"Finland","2025-02-11",0,0,1,0,0,1,0,0
"Finland","2025-02-12",0,0,1,0,0,1,0,0
"Finland","2025-02-13",0,0,1,0,0,1,0,0
"Finland","2025-02-14",0,0,1,0,0,1,0,0
"Finland","2025-02-15",0,0,1,0,0,1,0,0
"Finland","2025-02-16",0,0,1,0,0,1,0,0
"Finland","2025-02-17",0,0,1,0,0,1,0,0
"Finland","2025-02-18",0,0,1,0,0,1,0,0
"Finland","2025-02-19",0,0,1,0,0,1,0,0
"Finland","2025-02-20",0,0,1,0,0,1,0,0
"Finland","2025-02-21",0,0,1,0,0,1,0,0
"Finland","2025-02-22",0,0,1,0,0,1,0,0
"Finland","2025-02-23",0,0,1,0,0,1,0,0
"Finland","2025-02-24",0,0,1,0,0,1,0,0
"Finland","2025-02-25",0,0,1,0,0,1,0,0
"Finland","2025-02-26",0,0,1,0,0,1,0,0
"Finland","2025-02-27",0,0,1,0,0,1,0,0
"Finland","2025-02-28",0,0,1,0,0,1,0,0
"Finland","2025-03-01",0,0,1,0,0,1,0,0
"Finland","2025-03-02",0,0,1,0,0,1,0,0
"Finland","2025-03-03",0,0,1,0,0,1,0,0
"France","2024-01-01",0,0,0,0,0,0,0,0
"France","2024-01-02",0,0,0,0,0,0,0,0
"France","2024-01-03",0,0,0,0,0,0,0,0
"France","2024-01-04",0,0,0,0,0,0,0,0
"France","2024-01-05",0,0,0,0,0,0,0,0
"France","2024-01-06",0,0,0,0,0,0,0,0
"France","2024-01-07",0,0,0,0,0,0,0,0
"France","2024-01-08",0,0,0,0,0,0,0,0
"France","2024-01-09",0,0,0,0,0,0,0,0
"France","2024-01-10",0,0,0,0,0,0,0,0
"France","2024-01-11",0,0,0,0,0,0,0,0
"France","2024-01-12",0,0,0,0,0,0,0,0
"France","2024-01-13",0,0,0,0,0,0,0,0
"France","2024-01-14",0,0,0,0,0,0,0,0
"France","2024-01-15",0,0,0,0,0,0,0,0
"France","2024-01-16",0,0,0,0,0,0,0,0
"France","2024-01-17",0,0,0,0,0,0,0,0
"France","2024-01-18",0,0,0,0,0,0,0,0
"France","2024-01-19",0,0,0,0,0,0,0,0
"France","2024-01-20",0,0,0,0,0,0,0,0
"France","2024-01-21",0,0,0,0,0,0,0,0
"France","2024-01-22",0,0,0,0,0,0,0,0
"France","2024-01-23",0,0,0,0,0,0,0,0
"France","2024-01-24",0,0,0,0,0,0,0,0
"France","2024-01-25",0,0,0,0,0,0,0,0
"France","2024-01-26",0,0,0,0,0,0,0,0
"France","2024-01-27",0,0,0,0,0,0,0,0
"France","2024-01-28",0,0,0,0,0,0,0,0
"France","2024-01-29",0,0,0,0,0,0,0,0
"France","2024-01-30",0,0,0,0,0,0,0,0
"France","2024-01-31",0,8,8,0,8,8,0,0
"France","2024-02-01",0,0,8,0,1,9,0,0
"France","2024-02-02",0,0,8,0,0,9,0,0
"France","2024-02-03",0,0,8,0,1,10,0,0
"France","2024-02-04",0,0,8,0,0,10,0,0
"France","2024-02-05",0,0,8,0,1,11,0,0
"France","2024-02-06",0,0,8,0,0,11,0,0
"France","2024-02-07",0,0,8,0,1,12,0,0
"France","2024-02-08",0,0,8,0,0,12,0,0
"France","2024-02-09",0,0,8,0,1,13,0,0
"France","2024-02-10",0,0,8,0,1,14,0,0
"France","2024-02-11",0,0,8,0,0,14,0,0
"France","2024-02-12",0,0,8,0,1,15,0,0
"France","2024-02-13",0,0,8,0,0,15,0,0
"France","2024-02-14",0,0,8,0,1,16,0,0
"France","2024-02-15",0,0,8,0,0,16,0,0
"France","2024-02-16",0,0,8,0,1,17,0,0
"France","2024-02-17",0,0,8,0,0,17,0,0
"France","2024-02-18",0,0,8,0,1,18,0,0
"France","2024-02-19",0,0,8,0,0,18,0,0
"France","2024-02-20",0,0,8,0,1,19,0,0
"France","2024-02-21",0,0,8,0,1,20,0,0
"France","2024-02-22",0,0,8,0,0,20,0,0
"France","2024-02-23",0,0,8,0,1,21,0,0
"France","2024-02-24",0,0,8,0,0,21,0,0
"France","2024-02-25",0,0,8,0,1,22,0,0
"France","2024-02-26",0,0,8,0,0,22,0,0
"France","2024-02-27",0,0,8,0,1,23,0,0
"France","2024-02-28",0,0,8,0,0,23,0,0
"France","2024-02-29",0,16,24,0,1,24,0,0
"France","2024-03-01",0,0,24,0,0,24,0,0
"France","2024-03-02",0,0,24,0,1,25,0,0
"France","2024-03-03",0,0,24,0,0,25,0,0
"France","2024-03-04",0,0,24,0,0,25,0,0
"France","2024-03-05",0,0,24,0,1,26,0,0
"France","2024-03-06",0,0,24,0,0,26,0,0
"France","2024-03-07",0,0,24,0,0,26,0,0
"France","2024-03-08",0,0,24,0,1,27,0,0
"France","2024-03-09",0,0,24,0,0,27,0,0
"France","2024-03-10",0,0,24,0,1,28,0,0
"France","2024-03-11",0,0,24,0,0,28,0,0
"France","2024-03-12",0,0,24,0,0,28,0,0
"France","2024-03-13",0,0,24,0,1,29,0,0
"France","2024-03-14",0,0,24,0,0,29,0,0
"France","2024-03-15",0,0,24,0,0,29,0,0
"France","2024-03-16",0,0,24,0,1,30,0,0
"France","2024-03-17",0,0,24,0,0,30,0,0
"France","2024-03-18",0,0,24,0,0,30,0,0
"France","2024-03-19",0,0,24,0,1,31,0,0
"France","2024-03-20",0,0,24,0,0,31,0,0
"France","2024-03-21",0,0,24,0,0,31,0,0
"France","2024-03-22",0,0,24,0,1,32,0,0
"France","2024-03-23",0,0,24,0,0,32,0,0
"France","2024-03-24",0,0,24,0,1,33,0,0
"France","2024-03-25",0,0,24,0,0,33,0,0
"France","2024-03-26",0,0,24,0,0,33,0,0
"France","2024-03-27",0,0,24,0,1,34,0,0
"France","2024-03-28",0,0,24,0,0,34,0,0
"France","2024-03-29",0,0,24,0,0,34,0,0
"France","2024-03-30",0,0,24,0,1,35,0,0
"France","2024-03-31",0,11,35,0,0,35,0,0
"France","2024-04-01",0,0,35,0,0,35,0,0
"France","2024-04-02",0,0,35,0,1,36,0,0
"France","2024-04-03",0,0,35,0,0,36,0,0
"France","2024-04-04",0,0,35,0,1,37,0,0
"France","2024-04-05",0,0,35,0,0,37,0,0
"France","2024-04-06",0,0,35,0,0,37,0,0
"France","2024-04-07",0,0,35,0,1,38,0,0
"France","2024-04-08",0,0,35,0,0,38,0,0
"France","2024-04-09",0,0,35,0,1,39,0,0
"France","2024-04-10",0,0,35,0,0,39,0,0
"France","2024-04-11",0,0,35,0,0,39,0,0
"France","2024-04-12",0,0,35,0,1,40,0,0
"France","2024-04-13",0,0,35,0,0,40,0,0
"France","2024-04-14",0,0,35,0,1,41,0,0
"France","2024-04-15",0,0,35,0,0,41,0,0
"France","2024-04-16",0,0,35,0,0,41,0,0
"France","2024-04-17",0,0,35,0,1,42,0,0
"France","2024-04-18",0,0,35,0,0,42,0,0
"France","2024-04-19",0,0,35,0,1,43,0,0
"France","2024-04-20",0,0,35,0,0,43,0,0
"France","2024-04-21",0,0,35,0,0,43,0,0
"France","2024-04-22",0,0,35,0,1,44,0,0
"France","2024-04-23",0,0,35,0,0,44,0,0
"France","2024-04-24",0,0,35,0,1,45,0,0
"France","2024-04-25",0,0,35,0,0,45,0,0
"France","2024-04-26",0,0,35,0,0,45,0,0
"France","2024-04-27",0,0,35,0,1,46,0,0
"France","2024-04-28",0,0,35,0,0,46,0,0
"France","2024-04-29",0,0,35,0,1,47,0,0
"France","2024-04-30",0,12,47,0,0,47,0,0
"France","2024-05-01",0,0,47,0,1,48,0,0
"France","2024-05-02",0,0,47,0,1,49,0,0
"France","2024-05-03",0,0,47,0,1,50,0,0
"France","2024-05-04",0,0,47,0,1,51,0,0
"France","2024-05-05",0,0,47,0,1,52,0,0
"France","2024-05-06",0,0,47,0,1,53,0,0
"France","2024-05-07",0,0,47,0,1,54,0,0
"France","2024-05-08",0,0,47,0,1,55,0,0
"France","2024-05-09",0,0,47,0,1,56,0,0
"France","2024-05-10",0,0,47,0,1,57,0,0
"France","2024-05-11",0,0,47,0,1,58,0,0
"France","2024-05-12",0,0,47,0,1,59,0,0
"France","2024-05-13",0,0,47,0,1,60,0,0
"France","2024-05-14",0,0,47,0,1,61,0,0
"France","2024-05-15",0,0,47,0,1,62,0,0
"France","2024-05-16",0,0,47,0,1,63,0,0
"France","2024-05-17",0,0,47,0,1,64,0,0
"France","2024-05-18",0,0,47,0,1,65,0,0
"France","2024-05-19",0,0,47,0,1,66,0,0
"France","2024-05-20",0,0,47,0,1,67,0,0
"France","2024-05-21",0,0,47,0,1,68,0,0
"France","2024-05-22",0,0,47,0,1,69,0,0
"France","2024-05-23",0,0,47,0,1,70,0,0
"France","2024-05-24",0,0,47,0,1,71,0,0
"France","2024-05-25",0,0,47,0,1,72,0,0
"France","2024-05-26",0,0,47,0,1,73,0,0
"France","2024-05-27",0,0,47,0,1,74,0,0
"France","2024-05-28",0,0,47,0,1,75,0,0
"France","2024-05-29",0,0,47,0,1,76,0,0
"France","2024-05-30",0,0,47,0,1,77,0,0
"France","2024-05-31",0,31,78,0,1,78,0,0
"France","2024-06-01",0,0,78,0,1,79,0,0
"France","2024-06-02",0,0,78,0,1,80,0,0
"France","2024-06-03",0,0,78,0,0,80,0,0
"France","2024-06-04",0,0,78,0,1,81,0,0
"France","2024-06-05",0,0,78,0,1,82,0,0
"France","2024-06-06",0,0,78,0,1,83,0,0
"France","2024-06-07",0,0,78,0,0,83,0,0
"France","2024-06-08",0,0,78,0,1,84,0,0
"France","2024-06-09",0,0,78,0,1,85,0,0
"France","2024-06-10",0,0,78,0,1,86,0,0
"France","2024-06-11",0,0,78,0,0,86,0,0
"France","2024-06-12",0,0,78,0,1,87,0,0
"France","2024-06-13",0,0,78,0,1,88,0,0
"France","2024-06-14",0,0,78,0,1,89,0,0
"France","2024-06-15",0,0,78,0,1,90,0,0
"France","2024-06-16",0,0,78,0,0,90,0,0
"France","2024-06-17",0,0,78,0,1,91,0,0
"France","2024-06-18",0,0,78,0,1,92,0,0
"France","2024-06-19",0,0,78,0,1,93,0,0
"France","2024-06-20",0,0,78,0,0,93,0,0
"France","2024-06-21",0,0,78,0,1,94,0,0
"France","2024-06-22",0,0,78,0,1,95,0,0
"France","2024-06-23",0,0,78,0,1,96,0,0
"France","2024-06-24",0,0,78,0,0,96,0,0
"France","2024-06-25",0,0,78,0,1,97,0,0
"France","2024-06-26",0,0,78,0,1,98,0,0
"France","2024-06-27",0,0,78,0,1,99,0,0
"France","2024-06-28",0,0,78,0,0,99,0,0
"France","2024-06-29",0,0,78,0,1,100,0,0
"France","2024-06-30",0,23,101,0,1,101,0,0
"France","2024-07-01",0,0,101,0,0,101,0,0
"France","2024-07-02",0,0,101,0,1,102,0,0
"France","2024-07-03",0,0,101,0,0,102,0,0
"France","2024-07-04",0,0,101,0,0,102,0,0
"France","2024-07-05",0,0,101,0,1,103,0,0
"France","2024-07-06",0,0,101,0,0,103,0,0
"France","2024-07-07",0,0,101,0,0,103,0,0
"France","2024-07-08",0,0,101,0,1,104,0,0
"France","2024-07-09",0,0,101,0,0,104,0,0
"France","2024-07-10",0,0,101,0,1,105,0,0
"France","2024-07-11",0,0,101,0,0,105,0,0
"France","2024-07-12",0,0,101,0,0,105,0,0
"France","2024-07-13",0,0,101,0,1,106,0,0
"France","2024-07-14",0,0,101,0,0,106,0,0
"France","2024-07-15",0,0,101,0,0,106,0,0
"France","2024-07-16",0,0,101,0,1,107,0,0
"France","2024-07-17",0,0,101,0,0,107,0,0
"France","2024-07-18",0,0,101,0,0,107,0,0
"France","2024-07-19",0,0,101,0,1,108,0,0
"France","2024-07-20",0,0,101,0,0,108,0,0
"France","2024-07-21",0,0,101,0,0,108,0,0
"France","2024-07-22",0,0,101,0,1,109,0,0
"France","2024-07-23",0,0,101,0,0,109,0,0
"France","2024-07-24",0,0,101,0,1,110,0,0
"France","2024-07-25",0,0,101,0,0,110,0,0
"France","2024-07-26",0,0,101,0,0,110,0,0
"France","2024-07-27",0,0,101,0,1,111,0,0
"France","2024-07-28",0,0,101,0,0,111,0,0
"France","2024-07-29",0,0,101,0,0,111,0,0
"France","2024-07-30",0,0,101,0,1,112,0,0
"France","2024-07-31",0,11,112,0,0,112,0,0
"France","2024-08-01",0,0,112,0,1,113,0,0
"France","2024-08-02",0,0,112,0,1,114,0,0
"France","2024-08-03",0,0,112,0,0,114,0,0
"France","2024-08-04",0,0,112,0,1,115,0,0
"France","2024-08-05",0,0,112,0,1,116,0,0
"France","2024-08-06",0,0,112,0,1,117,0,0
"France","2024-08-07",0,0,112,0,0,117,0,0
"France","2024-08-08",0,0,112,0,1,118,0,0
"France","2024-08-09",0,0,112,0,1,119,0,0
"France","2024-08-10",0,0,112,0,1,120,0,0
"France","2024-08-11",0,0,112,0,1,121,0,0
"France","2024-08-12",0,0,112,0,0,121,0,0
"France","2024-08-13",0,0,112,0,1,122,0,0
"France","2024-08-14",0,0,112,0,1,123,0,0
"France","2024-08-15",0,0,112,0,1,124,0,0
"France","2024-08-16",0,0,112,0,0,124,0,0
"France","2024-08-17",0,0,112,0,1,125,0,0
"France","2024-08-18",0,0,112,0,1,126,0,0
"France","2024-08-19",0,0,112,0,1,127,0,0
"France","2024-08-20",0,0,112,0,0,127,0,0
"France","2024-08-21",0,0,112,0,1,128,0,0
"France","2024-08-22",0,0,112,0,1,129,0,0
"France","2024-08-23",0,0,112,0,1,130,0,0
"France","2024-08-24",0,0,112,0,1,131,0,0
"France","2024-08-25",0,0,112,0,0,131,0,0
"France","2024-08-26",0,0,112,0,1,132,0,0
"France","2024-08-27",0,0,112,0,1,133,0,0
"France","2024-08-28",0,0,112,0,1,134,0,0
"France","2024-08-29",0,0,112,0,0,134,0,0
"France","2024-08-30",0,0,112,0,1,135,0,0
"France","2024-08-31",0,24,136,0,1,136,0,0
"France","2024-09-01",0,0,136,0,1,137,0,0
"France","2024-09-02",0,0,136,0,1,138,0,0
"France","2024-09-03",0,0,136,0,1,139,0,0
"France","2024-09-04",0,0,136,0,1,140,0,0
"France","2024-09-05",0,0,136,0,0,140,0,0
"France","2024-09-06",0,0,136,0,1,141,0,0
"France","2024-09-07",0,0,136,0,1,142,0,0
"France","2024-09-08",0,0,136,0,1,143,0,0
"France","2024-09-09",0,0,136,0,1,144,0,0
"France","2024-09-10",0,0,136,0,1,145,0,0
"France","2024-09-11",0,0,136,0,1,146,0,0
"France","2024-09-12",0,0,136,0,1,147,0,0
"France","2024-09-13",0,0,136,0,1,148,0,0
"France","2024-09-14",0,0,136,0,1,149,0,0
"France","2024-09-15",0,0,136,0,1,150,0,0
"France","2024-09-16",0,0,136,0,0,150,0,0
"France","2024-09-17",0,0,136,0,1,151,0,0
"France","2024-09-18",0,0,136,0,1,152,0,0
"France","2024-09-19",0,0,136,0,1,153,0,0
"France","2024-09-20",0,0,136,0,1,154,0,0
"France","2024-09-21",0,0,136,0,1,155,0,0
"France","2024-09-22",0,0,136,0,1,156,0,0
"France","2024-09-23",0,0,136,0,1,157,0,0
"France","2024-09-24",0,0,136,0,1,158,0,0
"France","2024-09-25",0,0,136,0,0,158,0,0
"France","2024-09-26",0,0,136,0,1,159,0,0
"France","2024-09-27",0,0,136,0,1,160,0,0
"France","2024-09-28",0,0,136,0,1,161,0,0
"France","2024-09-29",0,0,136,0,1,162,0,0
"France","2024-09-30",0,27,163,0,1,163,0,0
"France","2024-10-01",0,0,163,0,1,164,0,0
"France","2024-10-02",0,0,163,0,1,165,0,0
"France","2024-10-03",0,0,163,0,1,166,0,0
"France","2024-10-04",0,0,163,0,1,167,0,0
"France","2024-10-05",0,0,163,0,1,168,0,0
"France","2024-10-06",0,0,163,0,1,169,0,0
"France","2024-10-07",0,0,163,0,1,170,0,0
"France","2024-10-08",0,0,163,0,0,170,0,0
"France","2024-10-09",0,0,163,0,1,171,0,0
"France","2024-10-10",0,0,163,0,1,172,0,0
"France","2024-10-11",0,0,163,0,1,173,0,0
"France","2024-10-12",0,0,163,0,1,174,0,0
"France","2024-10-13",0,0,163,0,1,175,0,0
"France","2024-10-14",0,0,163,0,1,176,0,0
"France","2024-10-15",0,0,163,0,1,177,0,0
"France","2024-10-16",0,0,163,0,1,178,0,0
"France","2024-10-17",0,0,163,0,1,179,0,0
"France","2024-10-18",0,0,163,0,1,180,0,0
"France","2024-10-19",0,0,163,0,1,181,0,0
"France","2024-10-20",0,0,163,0,1,182,0,0
"France","2024-10-21",0,0,163,0,1,183,0,0
"France","2024-10-22",0,0,163,0,1,184,0,0
"France","2024-10-23",0,0,163,0,1,185,0,0
"France","2024-10-24",0,0,163,0,0,185,0,0
"France","2024-10-25",0,0,163,0,1,186,0,0
"France","2024-10-26",0,0,163,0,1,187,0,0
"France","2024-10-27",0,0,163,0,1,188,0,0
"France","2024-10-28",0,0,163,0,1,189,0,0
"France","2024-10-29",0,0,163,0,1,190,0,0
"France","2024-10-30",0,0,163,0,1,191,0,0
"France","2024-10-31",0,29,192,0,1,192,0,0
"France","2024-11-01",0,0,192,0,0,192,0,0
"France","2024-11-02",0,0,192,0,1,193,0,0
"France","2024-11-03",0,0,192,0,0,193,0,0
"France","2024-11-04",0,0,192,0,0,193,0,0
"France","2024-11-05",0,0,192,0,0,193,0,0
"France","2024-11-06",0,0,192,0,1,194,0,0
"France","2024-11-07",0,0,192,0,0,194,0,0
"France","2024-11-08",0,0,192,0,0,194,0,0
"France","2024-11-09",0,0,192,0,0,194,0,0
"France","2024-11-10",0,0,192,0,1,195,0,0
"France","2024-11-11",0,0,192,0,0,195,0,0
"France","2024-11-12",0,0,192,0,0,195,0,0
"France","2024-11-13",0,0,192,0,0,195,0,0
"France","2024-11-14",0,0,192,0,1,196,0,0
"France","2024-11-15",0,0,192,0,0,196,0,0
"France","2024-11-16",0,0,192,0,0,196,0,0
"France","2024-11-17",0,0,192,0,1,197,0,0
"France","2024-11-18",0,0,192,0,0,197,0,0
"France","2024-11-19",0,0,192,0,0,197,0,0
"France","2024-11-20",0,0,192,0,0,197,0,0
"France","2024-11-21",0,0,192,0,1,198,0,0
"France","2024-11-22",0,0,192,0,0,198,0,0
"France","2024-11-23",0,0,192,0,0,198,0,0
"France","2024-11-24",0,0,192,0,0,198,0,0
"France","2024-11-25",0,0,192,0,1,199,0,0
"France","2024-11-26",0,0,192,0,0,199,0,0
"France","2024-11-27",0,0,192,0,0,199,0,0
"France","2024-11-28",0,0,192,0,0,199,0,0
"France","2024-11-29",0,0,192,0,1,200,0,0
"France","2024-11-30",0,8,200,0,0,200,0,0
"France","2024-12-01",0,0,200,0,0,200,0,0
"France","2024-12-02",0,0,200,0,1,201,0,0
"France","2024-12-03",0,0,200,0,0,201,0,0
"France","2024-12-04",0,0,200,0,1,202,0,0
"France","2024-12-05",0,0,200,0,0,202,0,0
"France","2024-12-06",0,0,200,0,0,202,0,0
"France","2024-12-07",0,0,200,0,1,203,0,0
"France","2024-12-08",0,0,200,0,0,203,0,0
"France","2024-12-09",0,0,200,0,0,203,0,0
"France","2024-12-10",0,0,200,0,1,204,0,0
"France","2024-12-11",0,0,200,0,0,204,0,0
"France","2024-12-12",0,0,200,0,1,205,0,0
"France","2024-12-13",0,0,200,0,0,205,0,0
"France","2024-12-14",0,0,200,0,0,205,0,0
"France","2024-12-15",0,0,200,0,1,206,0,0
"France","2024-12-16",0,0,200,0,0,206,0,0
"France","2024-12-17",0,0,200,0,1,207,0,0
"France","2024-12-18",0,0,200,0,0,207,0,0
"France","2024-12-19",0,0,200,0,0,207,0,0
"France","2024-12-20",0,0,200,0,1,208,0,0
"France","2024-12-21",0,0,200,0,0,208,0,0
"France","2024-12-22",0,0,200,0,1,209,0,0
"France","2024-12-23",0,0,200,0,0,209,0,0
"France","2024-12-24",0,0,200,0,0,209,0,0
"France","2024-12-25",0,0,200,0,1,210,0,0
"France","2024-12-26",0,0,200,0,0,210,0,0
"France","2024-12-27",0,0,200,0,0,210,0,0
"France","2024-12-28",0,0,200,0,1,211,0,0
"France","2024-12-29",0,0,200,0,0,211,0,0
"France","2024-12-30",0,0,200,0,1,212,0,0
"France","2024-12-31",0,12,212,0,0,212,0,0
"France","2025-01-01",0,0,212,0,1,213,0,0
"France","2025-01-02",0,0,212,0,1,214,0,0
"France","2025-01-03",0,0,212,0,1,215,0,0
"France","2025-01-04",0,0,212,0,1,216,0,0
"France","2025-01-05",0,0,212,0,0,216,0,0
"France","2025-01-06",0,0,212,0,1,217,0,0
"France","2025-01-07",0,0,212,0,1,218,0,0
"France","2025-01-08",0,0,212,0,1,219,0,0
"France","2025-01-09",0,0,212,0,1,220,0,0
"France","2025-01-10",0,9,221,0,1,221,0,0
"France","2025-01-11",0,0,221,0,0,221,0,0
"France","2025-01-12",0,0,221,0,0,221,0,0
"France","2025-01-13",0,0,221,0,0,221,0,0
"France","2025-01-14",0,0,221,0,0,221,0,0
"France","2025-01-15",0,0,221,0,0,221,0,0
"France","2025-01-16",0,0,221,0,0,221,0,0
"France","2025-01-17",0,0,221,0,0,221,0,0
"France","2025-01-18",0,0,221,0,0,221,0,0
"France","2025-01-19",0,0,221,0,0,221,0,0
"France","2025-01-20",0,0,221,0,0,221,0,0
"France","2025-01-21",0,0,221,0,0,221,0,0
"France","2025-01-22",0,0,221,0,0,221,0,0
"France","2025-01-23",0,0,221,0,0,221,0,0
"France","2025-01-24",0,0,221,0,0,221,0,0
"France","2025-01-25",0,0,221,0,0,221,0,0
"France","2025-01-26",0,0,221,0,0,221,0,0
"France","2025-01-27",0,0,221,0,0,221,0,0
"France","2025-01-28",0,0,221,0,0,221,0,0
"France","2025-01-29",0,0,221,0,0,221,0,0
"France","2025-01-30",0,0,221,0,0,221,0,0
"France","2025-01-31",0,0,221,0,0,221,0,0
"France","2025-02-01",0,0,221,0,0,221,0,0
"France","2025-02-02",0,0,221,0,0,221,0,0
"France","2025-02-03",0,0,221,0,0,221,0,0
"France","2025-02-04",0,0,221,0,0,221,0,0
"France","2025-02-05",0,0,221,0,0,221,0,0
"France","2025-02-06",0,0,221,0,0,221,0,0
"France","2025-02-07",0,0,221,0,0,221,0,0
"France","2025-02-08",0,0,221,0,0,221,0,0
"France","2025-02-09",0,0,221,0,0,221,0,0
"France","2025-02-10",0,0,221,0,0,221,0,0
"France","2025-02-11",0,0,221,0,0,221,0,0
"France","2025-02-12",0,0,221,0,0,221,0,0
"France","2025-02-13",0,0,221,0,0,221,0,0
"France","2025-02-14",0,0,221,0,0,221,0,0
"France","2025-02-15",0,0,221,0,0,221,0,0
"France","2025-02-16",0,0,221,0,0,221,0,0
"France","2025-02-17",0,0,221,0,0,221,0,0
"France","2025-02-18",0,0,221,0,0,221,0,0
"France","2025-02-19",0,0,221,0,0,221,0,0
"France","2025-02-20",0,0,221,0,0,221,0,0
"France","2025-02-21",0,0,221,0,0,221,0,0
"France","2025-02-22",0,0,221,0,0,221,0,0
"France","2025-02-23",0,0,221,0,0,221,0,0
"France","2025-02-24",0,0,221,0,0,221,0,0
"France","2025-02-25",0,0,221,0,0,221,0,0
"France","2025-02-26",0,0,221,0,0,221,0,0
"France","2025-02-27",0,0,221,0,0,221,0,0
"France","2025-02-28",0,0,221,0,0,221,0,0
"France","2025-03-01",0,0,221,0,0,221,0,0
"France","2025-03-02",0,0,221,0,0,221,0,0
"France","2025-03-03",0,0,221,0,0,221,0,0
"Gabon","2024-01-01",0,0,0,0,0,0,0,0
"Gabon","2024-01-02",0,0,0,0,0,0,0,0
"Gabon","2024-01-03",0,0,0,0,0,0,0,0
"Gabon","2024-01-04",0,0,0,0,0,0,0,0
"Gabon","2024-01-05",0,0,0,0,0,0,0,0
"Gabon","2024-01-06",0,0,0,0,0,0,0,0
"Gabon","2024-01-07",0,0,0,0,0,0,0,0
"Gabon","2024-01-08",0,0,0,0,0,0,0,0
"Gabon","2024-01-09",0,0,0,0,0,0,0,0
"Gabon","2024-01-10",0,0,0,0,0,0,0,0
"Gabon","2024-01-11",0,0,0,0,0,0,0,0
"Gabon","2024-01-12",0,0,0,0,0,0,0,0
"Gabon","2024-01-13",0,0,0,0,0,0,0,0
"Gabon","2024-01-14",0,0,0,0,0,0,0,0
"Gabon","2024-01-15",0,0,0,0,0,0,0,0
"Gabon","2024-01-16",0,0,0,0,0,0,0,0
"Gabon","2024-01-17",0,0,0,0,0,0,0,0
"Gabon","2024-01-18",0,0,0,0,0,0,0,0
"Gabon","2024-01-19",0,0,0,0,0,0,0,0
"Gabon","2024-01-20",0,0,0,0,0,0,0,0
"Gabon","2024-01-21",0,0,0,0,0,0,0,0
"Gabon","2024-01-22",0,0,0,0,0,0,0,0
"Gabon","2024-01-23",0,0,0,0,0,0,0,0
"Gabon","2024-01-24",0,0,0,0,0,0,0,0
"Gabon","2024-01-25",0,0,0,0,0,0,0,0
"Gabon","2024-01-26",0,0,0,0,0,0,0,0
"Gabon","2024-01-27",0,0,0,0,0,0,0,0
"Gabon","2024-01-28",0,0,0,0,0,0,0,0
"Gabon","2024-01-29",0,0,0,0,0,0,0,0
"Gabon","2024-01-30",0,0,0,0,0,0,0,0
"Gabon","2024-01-31",0,0,0,0,0,0,0,0
"Gabon","2024-02-01",0,0,0,0,0,0,0,0
"Gabon","2024-02-02",0,0,0,0,0,0,0,0
"Gabon","2024-02-03",0,0,0,0,0,0,0,0
"Gabon","2024-02-04",0,0,0,0,0,0,0,0
"Gabon","2024-02-05",0,0,0,0,0,0,0,0
"Gabon","2024-02-06",0,0,0,0,0,0,0,0
"Gabon","2024-02-07",0,0,0,0,0,0,0,0
"Gabon","2024-02-08",0,0,0,0,0,0,0,0
"Gabon","2024-02-09",0,0,0,0,0,0,0,0
"Gabon","2024-02-10",0,0,0,0,0,0,0,0
"Gabon","2024-02-11",0,0,0,0,0,0,0,0
"Gabon","2024-02-12",0,0,0,0,0,0,0,0
"Gabon","2024-02-13",0,0,0,0,0,0,0,0
"Gabon","2024-02-14",0,0,0,0,0,0,0,0
"Gabon","2024-02-15",0,0,0,0,0,0,0,0
"Gabon","2024-02-16",0,0,0,0,0,0,0,0
"Gabon","2024-02-17",0,0,0,0,0,0,0,0
"Gabon","2024-02-18",0,0,0,0,0,0,0,0
"Gabon","2024-02-19",0,0,0,0,0,0,0,0
"Gabon","2024-02-20",0,0,0,0,0,0,0,0
"Gabon","2024-02-21",0,0,0,0,0,0,0,0
"Gabon","2024-02-22",0,0,0,0,0,0,0,0
"Gabon","2024-02-23",0,0,0,0,0,0,0,0
"Gabon","2024-02-24",0,0,0,0,0,0,0,0
"Gabon","2024-02-25",0,0,0,0,0,0,0,0
"Gabon","2024-02-26",0,0,0,0,0,0,0,0
"Gabon","2024-02-27",0,0,0,0,0,0,0,0
"Gabon","2024-02-28",0,0,0,0,0,0,0,0
"Gabon","2024-02-29",0,0,0,0,0,0,0,0
"Gabon","2024-03-01",0,0,0,0,0,0,0,0
"Gabon","2024-03-02",0,0,0,0,0,0,0,0
"Gabon","2024-03-03",0,0,0,0,0,0,0,0
"Gabon","2024-03-04",0,0,0,0,0,0,0,0
"Gabon","2024-03-05",0,0,0,0,0,0,0,0
"Gabon","2024-03-06",0,0,0,0,0,0,0,0
"Gabon","2024-03-07",0,0,0,0,0,0,0,0
"Gabon","2024-03-08",0,0,0,0,0,0,0,0
"Gabon","2024-03-09",0,0,0,0,0,0,0,0
"Gabon","2024-03-10",0,0,0,0,0,0,0,0
"Gabon","2024-03-11",0,0,0,0,0,0,0,0
"Gabon","2024-03-12",0,0,0,0,0,0,0,0
"Gabon","2024-03-13",0,0,0,0,0,0,0,0
"Gabon","2024-03-14",0,0,0,0,0,0,0,0
"Gabon","2024-03-15",0,0,0,0,0,0,0,0
"Gabon","2024-03-16",0,0,0,0,0,0,0,0
"Gabon","2024-03-17",0,0,0,0,0,0,0,0
"Gabon","2024-03-18",0,0,0,0,0,0,0,0
"Gabon","2024-03-19",0,0,0,0,0,0,0,0
"Gabon","2024-03-20",0,0,0,0,0,0,0,0
"Gabon","2024-03-21",0,0,0,0,0,0,0,0
"Gabon","2024-03-22",0,0,0,0,0,0,0,0
"Gabon","2024-03-23",0,0,0,0,0,0,0,0
"Gabon","2024-03-24",0,0,0,0,0,0,0,0
"Gabon","2024-03-25",0,0,0,0,0,0,0,0
"Gabon","2024-03-26",0,0,0,0,0,0,0,0
"Gabon","2024-03-27",0,0,0,0,0,0,0,0
"Gabon","2024-03-28",0,0,0,0,0,0,0,0
"Gabon","2024-03-29",0,0,0,0,0,0,0,0
"Gabon","2024-03-30",0,0,0,0,0,0,0,0
"Gabon","2024-03-31",0,0,0,0,0,0,0,0
"Gabon","2024-04-01",0,0,0,0,0,0,0,0
"Gabon","2024-04-02",0,0,0,0,0,0,0,0
"Gabon","2024-04-03",0,0,0,0,0,0,0,0
"Gabon","2024-04-04",0,0,0,0,0,0,0,0
"Gabon","2024-04-05",0,0,0,0,0,0,0,0
"Gabon","2024-04-06",0,0,0,0,0,0,0,0
"Gabon","2024-04-07",0,0,0,0,0,0,0,0
"Gabon","2024-04-08",0,0,0,0,0,0,0,0
"Gabon","2024-04-09",0,0,0,0,0,0,0,0
"Gabon","2024-04-10",0,0,0,0,0,0,0,0
"Gabon","2024-04-11",0,0,0,0,0,0,0,0
"Gabon","2024-04-12",0,0,0,0,0,0,0,0
"Gabon","2024-04-13",0,0,0,0,0,0,0,0
"Gabon","2024-04-14",0,0,0,0,0,0,0,0
"Gabon","2024-04-15",0,0,0,0,0,0,0,0
"Gabon","2024-04-16",0,0,0,0,0,0,0,0
"Gabon","2024-04-17",0,0,0,0,0,0,0,0
"Gabon","2024-04-18",0,0,0,0,0,0,0,0
"Gabon","2024-04-19",0,0,0,0,0,0,0,0
"Gabon","2024-04-20",0,0,0,0,0,0,0,0
"Gabon","2024-04-21",0,0,0,0,0,0,0,0
"Gabon","2024-04-22",0,0,0,0,0,0,0,0
"Gabon","2024-04-23",0,0,0,0,0,0,0,0
"Gabon","2024-04-24",0,0,0,0,0,0,0,0
"Gabon","2024-04-25",0,0,0,0,0,0,0,0
"Gabon","2024-04-26",0,0,0,0,0,0,0,0
"Gabon","2024-04-27",0,0,0,0,0,0,0,0
"Gabon","2024-04-28",0,0,0,0,0,0,0,0
"Gabon","2024-04-29",0,0,0,0,0,0,0,0
"Gabon","2024-04-30",0,0,0,0,0,0,0,0
"Gabon","2024-05-01",0,0,0,0,0,0,0,0
"Gabon","2024-05-02",0,0,0,0,0,0,0,0
"Gabon","2024-05-03",0,0,0,0,0,0,0,0
"Gabon","2024-05-04",0,0,0,0,0,0,0,0
"Gabon","2024-05-05",0,0,0,0,0,0,0,0
"Gabon","2024-05-06",0,0,0,0,0,0,0,0
"Gabon","2024-05-07",0,0,0,0,0,0,0,0
"Gabon","2024-05-08",0,0,0,0,0,0,0,0
"Gabon","2024-05-09",0,0,0,0,0,0,0,0
"Gabon","2024-05-10",0,0,0,0,0,0,0,0
"Gabon","2024-05-11",0,0,0,0,0,0,0,0
"Gabon","2024-05-12",0,0,0,0,0,0,0,0
"Gabon","2024-05-13",0,0,0,0,0,0,0,0
"Gabon","2024-05-14",0,0,0,0,0,0,0,0
"Gabon","2024-05-15",0,0,0,0,0,0,0,0
"Gabon","2024-05-16",0,0,0,0,0,0,0,0
"Gabon","2024-05-17",0,0,0,0,0,0,0,0
"Gabon","2024-05-18",0,0,0,0,0,0,0,0
"Gabon","2024-05-19",0,0,0,0,0,0,0,0
"Gabon","2024-05-20",0,0,0,0,0,0,0,0
"Gabon","2024-05-21",0,0,0,0,0,0,0,0
"Gabon","2024-05-22",0,0,0,0,0,0,0,0
"Gabon","2024-05-23",0,0,0,0,0,0,0,0
"Gabon","2024-05-24",0,0,0,0,0,0,0,0
"Gabon","2024-05-25",0,0,0,0,0,0,0,0
"Gabon","2024-05-26",0,0,0,0,0,0,0,0
"Gabon","2024-05-27",0,0,0,0,0,0,0,0
"Gabon","2024-05-28",0,0,0,0,0,0,0,0
"Gabon","2024-05-29",0,0,0,0,0,0,0,0
"Gabon","2024-05-30",0,0,0,0,0,0,0,0
"Gabon","2024-05-31",0,0,0,0,0,0,0,0
"Gabon","2024-06-01",0,0,0,0,0,0,0,0
"Gabon","2024-06-02",0,0,0,0,0,0,0,0
"Gabon","2024-06-03",0,0,0,0,0,0,0,0
"Gabon","2024-06-04",0,0,0,0,0,0,0,0
"Gabon","2024-06-05",0,0,0,0,0,0,0,0
"Gabon","2024-06-06",0,0,0,0,0,0,0,0
"Gabon","2024-06-07",0,0,0,0,0,0,0,0
"Gabon","2024-06-08",0,0,0,0,0,0,0,0
"Gabon","2024-06-09",0,0,0,0,0,0,0,0
"Gabon","2024-06-10",0,0,0,0,0,0,0,0
"Gabon","2024-06-11",0,0,0,0,0,0,0,0
"Gabon","2024-06-12",0,0,0,0,0,0,0,0
"Gabon","2024-06-13",0,0,0,0,0,0,0,0
"Gabon","2024-06-14",0,0,0,0,0,0,0,0
"Gabon","2024-06-15",0,0,0,0,0,0,0,0
"Gabon","2024-06-16",0,0,0,0,0,0,0,0
"Gabon","2024-06-17",0,0,0,0,0,0,0,0
"Gabon","2024-06-18",0,0,0,0,0,0,0,0
"Gabon","2024-06-19",0,0,0,0,0,0,0,0
"Gabon","2024-06-20",0,0,0,0,0,0,0,0
"Gabon","2024-06-21",0,0,0,0,0,0,0,0
"Gabon","2024-06-22",0,0,0,0,0,0,0,0
"Gabon","2024-06-23",0,0,0,0,0,0,0,0
"Gabon","2024-06-24",0,0,0,0,0,0,0,0
"Gabon","2024-06-25",0,0,0,0,0,0,0,0
"Gabon","2024-06-26",0,0,0,0,0,0,0,0
"Gabon","2024-06-27",0,0,0,0,0,0,0,0
"Gabon","2024-06-28",0,0,0,0,0,0,0,0
"Gabon","2024-06-29",0,0,0,0,0,0,0,0
"Gabon","2024-06-30",0,0,0,0,0,0,0,0
"Gabon","2024-07-01",0,0,0,0,0,0,0,0
"Gabon","2024-07-02",0,0,0,0,0,0,0,0
"Gabon","2024-07-03",0,0,0,0,0,0,0,0
"Gabon","2024-07-04",0,0,0,0,0,0,0,0
"Gabon","2024-07-05",0,0,0,0,0,0,0,0
"Gabon","2024-07-06",0,0,0,0,0,0,0,0
"Gabon","2024-07-07",0,0,0,0,0,0,0,0
"Gabon","2024-07-08",0,0,0,0,0,0,0,0
"Gabon","2024-07-09",0,0,0,0,0,0,0,0
"Gabon","2024-07-10",0,0,0,0,0,0,0,0
"Gabon","2024-07-11",0,0,0,0,0,0,0,0
"Gabon","2024-07-12",0,0,0,0,0,0,0,0
"Gabon","2024-07-13",0,0,0,0,0,0,0,0
"Gabon","2024-07-14",0,0,0,0,0,0,0,0
"Gabon","2024-07-15",0,0,0,0,0,0,0,0
"Gabon","2024-07-16",0,0,0,0,0,0,0,0
"Gabon","2024-07-17",0,0,0,0,0,0,0,0
"Gabon","2024-07-18",0,0,0,0,0,0,0,0
"Gabon","2024-07-19",0,0,0,0,0,0,0,0
"Gabon","2024-07-20",0,0,0,0,0,0,0,0
"Gabon","2024-07-21",0,0,0,0,0,0,0,0
"Gabon","2024-07-22",0,0,0,0,0,0,0,0
"Gabon","2024-07-23",0,0,0,0,0,0,0,0
"Gabon","2024-07-24",0,0,0,0,0,0,0,0
"Gabon","2024-07-25",0,0,0,0,0,0,0,0
"Gabon","2024-07-26",0,0,0,0,0,0,0,0
"Gabon","2024-07-27",0,0,0,0,0,0,0,0
"Gabon","2024-07-28",0,0,0,0,0,0,0,0
"Gabon","2024-07-29",0,0,0,0,0,0,0,0
"Gabon","2024-07-30",0,0,0,0,0,0,0,0
"Gabon","2024-07-31",0,0,0,0,0,0,0,0
"Gabon","2024-08-01",0,0,0,0,0,0,0,0
"Gabon","2024-08-02",0,0,0,0,0,0,0,0
"Gabon","2024-08-03",0,0,0,0,0,0,0,0
"Gabon","2024-08-04",0,0,0,0,0,0,0,0
"Gabon","2024-08-05",0,0,0,0,0,0,0,0
"Gabon","2024-08-06",0,0,0,0,0,0,0,0
"Gabon","2024-08-07",0,0,0,0,0,0,0,0
"Gabon","2024-08-08",0,0,0,0,0,0,0,0
"Gabon","2024-08-09",0,0,0,0,0,0,0,0
"Gabon","2024-08-10",0,0,0,0,0,0,0,0
"Gabon","2024-08-11",0,0,0,0,0,0,0,0
"Gabon","2024-08-12",0,0,0,0,0,0,0,0
"Gabon","2024-08-13",0,0,0,0,0,0,0,0
"Gabon","2024-08-14",0,0,0,0,0,0,0,0
"Gabon","2024-08-15",0,0,0,0,0,0,0,0
"Gabon","2024-08-16",0,0,0,0,0,0,0,0
"Gabon","2024-08-17",0,0,0,0,0,0,0,0
"Gabon","2024-08-18",0,0,0,0,0,0,0,0
"Gabon","2024-08-19",0,0,0,0,0,0,0,0
"Gabon","2024-08-20",0,0,0,0,0,0,0,0
"Gabon","2024-08-21",0,0,0,0,0,0,0,0
"Gabon","2024-08-22",0,0,0,0,0,0,0,0
"Gabon","2024-08-23",0,0,0,0,0,0,0,0
"Gabon","2024-08-24",0,0,0,0,0,0,0,0
"Gabon","2024-08-25",0,1,1,0,1,1,0,0
"Gabon","2024-08-26",0,0,1,0,0,1,0,0
"Gabon","2024-08-27",0,0,1,0,0,1,0,0
"Gabon","2024-08-28",0,0,1,0,0,1,0,0
"Gabon","2024-08-29",0,0,1,0,1,2,0,0
"Gabon","2024-08-30",0,0,1,0,0,2,0,0
"Gabon","2024-08-31",0,0,1,0,0,2,0,0
"Gabon","2024-09-01",0,1,2,0,0,2,0,0
"Gabon","2024-09-02",0,0,2,0,0,2,0,0
"Gabon","2024-09-03",0,0,2,0,0,2,0,0
"Gabon","2024-09-04",0,0,2,0,0,2,0,0
"Gabon","2024-09-05",0,0,2,0,0,2,0,0
"Gabon","2024-09-06",0,0,2,0,0,2,0,0
"Gabon","2024-09-07",0,0,2,0,0,2,0,0
"Gabon","2024-09-08",4,0,2,4,0,2,4,4
"Gabon","2024-09-09",0,0,2,4,0,2,0,4
"Gabon","2024-09-10",0,0,2,4,0,2,0,4
"Gabon","2024-09-11",0,0,2,4,0,2,0,4
"Gabon","2024-09-12",0,0,2,4,0,2,1,5
"Gabon","2024-09-13",0,0,2,4,0,2,0,5
"Gabon","2024-09-14",0,0,2,4,0,2,0,5
"Gabon","2024-09-15",0,0,2,4,0,2,0,5
"Gabon","2024-09-16",0,0,2,4,0,2,0,5
"Gabon","2024-09-17",0,0,2,4,0,2,0,5
"Gabon","2024-09-18",0,0,2,4,0,2,0,5
"Gabon","2024-09-19",0,0,2,4,0,2,1,6
"Gabon","2024-09-20",0,0,2,4,0,2,0,6
"Gabon","2024-09-21",0,0,2,4,0,2,0,6
"Gabon","2024-09-22",0,0,2,4,0,2,0,6
"Gabon","2024-09-23",0,0,2,4,0,2,0,6
"Gabon","2024-09-24",0,0,2,4,0,2,0,6
"Gabon","2024-09-25",0,0,2,4,0,2,0,6
"Gabon","2024-09-26",0,0,2,4,0,2,0,6
"Gabon","2024-09-27",0,0,2,4,0,2,1,7
"Gabon","2024-09-28",0,0,2,4,0,2,0,7
"Gabon","2024-09-29",0,0,2,4,0,2,0,7
"Gabon","2024-09-30",3,0,2,7,0,2,0,7
"Gabon","2024-10-01",0,0,2,7,0,2,0,7
"Gabon","2024-10-02",0,0,2,7,0,2,1,8
"Gabon","2024-10-03",0,0,2,7,0,2,0,8
"Gabon","2024-10-04",0,0,2,7,0,2,0,8
"Gabon","2024-10-05",0,0,2,7,0,2,1,9
"Gabon","2024-10-06",2,0,2,9,0,2,0,9
"Gabon","2024-10-07",0,0,2,9,0,2,0,9
"Gabon","2024-10-08",0,0,2,9,0,2,0,9
"Gabon","2024-10-09",0,0,2,9,0,2,0,9
"Gabon","2024-10-10",0,0,2,9,0,2,0,9
"Gabon","2024-10-11",0,0,2,9,0,2,0,9
"Gabon","2024-10-12",0,0,2,9,0,2,0,9
"Gabon","2024-10-13",0,0,2,9,0,2,0,9
"Gabon","2024-10-14",0,0,2,9,0,2,1,10
"Gabon","2024-10-15",0,0,2,9,0,2,0,10
"Gabon","2024-10-16",0,0,2,9,0,2,0,10
"Gabon","2024-10-17",0,0,2,9,0,2,0,10
"Gabon","2024-10-18",0,0,2,9,0,2,0,10
"Gabon","2024-10-19",0,0,2,9,0,2,0,10
"Gabon","2024-10-20",1,0,2,10,0,2,0,10
"Gabon","2024-10-21",3,0,2,13,0,2,3,13
"Gabon","2024-10-22",0,0,2,13,0,2,0,13
"Gabon","2024-10-23",0,0,2,13,0,2,0,13
"Gabon","2024-10-24",0,0,2,13,0,2,0,13
"Gabon","2024-10-25",0,0,2,13,0,2,0,13
"Gabon","2024-10-26",0,0,2,13,0,2,0,13
"Gabon","2024-10-27",0,0,2,13,0,2,0,13
"Gabon","2024-10-28",0,0,2,13,0,2,0,13
"Gabon","2024-10-29",0,0,2,13,0,2,0,13
"Gabon","2024-10-30",0,0,2,13,0,2,0,13
"Gabon","2024-10-31",0,0,2,13,0,2,0,13
"Gabon","2024-11-01",0,0,2,13,0,2,0,13
"Gabon","2024-11-02",0,0,2,13,0,2,0,13
"Gabon","2024-11-03",0,0,2,13,0,2,0,13
"Gabon","2024-11-04",0,0,2,13,0,2,0,13
"Gabon","2024-11-05",0,0,2,13,0,2,0,13
"Gabon","2024-11-06",0,0,2,13,0,2,0,13
"Gabon","2024-11-07",0,0,2,13,0,2,0,13
"Gabon","2024-11-08",0,0,2,13,0,2,0,13
"Gabon","2024-11-09",0,0,2,13,0,2,0,13
"Gabon","2024-11-10",0,0,2,13,0,2,0,13
"Gabon","2024-11-11",0,0,2,13,0,2,0,13
"Gabon","2024-11-12",0,0,2,13,0,2,0,13
"Gabon","2024-11-13",0,0,2,13,0,2,0,13
"Gabon","2024-11-14",0,0,2,13,0,2,0,13
"Gabon","2024-11-15",0,0,2,13,0,2,0,13
"Gabon","2024-11-16",0,0,2,13,0,2,0,13
"Gabon","2024-11-17",0,0,2,13,0,2,0,13
"Gabon","2024-11-18",0,0,2,13,0,2,0,13
"Gabon","2024-11-19",0,0,2,13,0,2,0,13
"Gabon","2024-11-20",0,0,2,13,0,2,0,13
"Gabon","2024-11-21",0,0,2,13,0,2,0,13
"Gabon","2024-11-22",0,0,2,13,0,2,0,13
"Gabon","2024-11-23",0,0,2,13,0,2,0,13
"Gabon","2024-11-24",0,0,2,13,0,2,0,13
"Gabon","2024-11-25",0,0,2,13,0,2,0,13
"Gabon","2024-11-26",0,0,2,13,0,2,0,13
"Gabon","2024-11-27",0,0,2,13,0,2,0,13
"Gabon","2024-11-28",0,0,2,13,0,2,0,13
"Gabon","2024-11-29",0,0,2,13,0,2,0,13
"Gabon","2024-11-30",0,0,2,13,0,2,0,13
"Gabon","2024-12-01",0,0,2,13,0,2,0,13
"Gabon","2024-12-02",0,0,2,13,0,2,0,13
"Gabon","2024-12-03",0,0,2,13,0,2,0,13
"Gabon","2024-12-04",0,0,2,13,0,2,0,13
"Gabon","2024-12-05",0,0,2,13,0,2,0,13
"Gabon","2024-12-06",0,0,2,13,0,2,0,13
"Gabon","2024-12-07",0,0,2,13,0,2,0,13
"Gabon","2024-12-08",0,0,2,13,0,2,0,13
"Gabon","2024-12-09",0,0,2,13,0,2,0,13
"Gabon","2024-12-10",0,0,2,13,0,2,0,13
"Gabon","2024-12-11",0,0,2,13,0,2,0,13
"Gabon","2024-12-12",0,0,2,13,0,2,0,13
"Gabon","2024-12-13",0,0,2,13,0,2,0,13
"Gabon","2024-12-14",0,0,2,13,0,2,0,13
"Gabon","2024-12-15",0,0,2,13,0,2,0,13
"Gabon","2024-12-16",0,0,2,13,0,2,0,13
"Gabon","2024-12-17",0,0,2,13,0,2,0,13
"Gabon","2024-12-18",0,0,2,13,0,2,0,13
"Gabon","2024-12-19",0,0,2,13,0,2,0,13
"Gabon","2024-12-20",0,0,2,13,0,2,0,13
"Gabon","2024-12-21",0,0,2,13,0,2,0,13
"Gabon","2024-12-22",0,0,2,13,0,2,0,13
"Gabon","2024-12-23",0,0,2,13,0,2,0,13
"Gabon","2024-12-24",0,0,2,13,0,2,0,13
"Gabon","2024-12-25",0,0,2,13,0,2,0,13
"Gabon","2024-12-26",0,0,2,13,0,2,0,13
"Gabon","2024-12-27",0,0,2,13,0,2,0,13
"Gabon","2024-12-28",0,0,2,13,0,2,0,13
"Gabon","2024-12-29",0,0,2,13,0,2,0,13
"Gabon","2024-12-30",0,0,2,13,0,2,0,13
"Gabon","2024-12-31",0,0,2,13,0,2,0,13
"Gabon","2025-01-01",0,0,2,13,0,2,0,13
"Gabon","2025-01-02",0,0,2,13,0,2,0,13
"Gabon","2025-01-03",0,0,2,13,0,2,0,13
"Gabon","2025-01-04",0,0,2,13,0,2,0,13
"Gabon","2025-01-05",0,0,2,13,0,2,0,13
"Gabon","2025-01-06",0,0,2,13,0,2,0,13
"Gabon","2025-01-07",0,0,2,13,0,2,0,13
"Gabon","2025-01-08",0,0,2,13,0,2,0,13
"Gabon","2025-01-09",0,0,2,13,0,2,0,13
"Gabon","2025-01-10",0,0,2,13,0,2,0,13
"Gabon","2025-01-11",0,0,2,13,0,2,0,13
"Gabon","2025-01-12",0,0,2,13,0,2,0,13
"Gabon","2025-01-13",0,0,2,13,0,2,0,13
"Gabon","2025-01-14",0,0,2,13,0,2,0,13
"Gabon","2025-01-15",0,0,2,13,0,2,0,13
"Gabon","2025-01-16",0,0,2,13,0,2,0,13
"Gabon","2025-01-17",0,0,2,13,0,2,0,13
"Gabon","2025-01-18",0,0,2,13,0,2,0,13
"Gabon","2025-01-19",0,0,2,13,0,2,0,13
"Gabon","2025-01-20",0,0,2,13,0,2,0,13
"Gabon","2025-01-21",0,0,2,13,0,2,0,13
"Gabon","2025-01-22",0,0,2,13,0,2,0,13
"Gabon","2025-01-23",0,0,2,13,0,2,0,13
"Gabon","2025-01-24",0,0,2,13,0,2,0,13
"Gabon","2025-01-25",0,0,2,13,0,2,0,13
"Gabon","2025-01-26",0,0,2,13,0,2,0,13
"Gabon","2025-01-27",0,0,2,13,0,2,0,13
"Gabon","2025-01-28",0,0,2,13,0,2,0,13
"Gabon","2025-01-29",0,0,2,13,0,2,0,13
"Gabon","2025-01-30",0,0,2,13,0,2,0,13
"Gabon","2025-01-31",0,0,2,13,0,2,0,13
"Gabon","2025-02-01",0,0,2,13,0,2,0,13
"Gabon","2025-02-02",0,0,2,13,0,2,0,13
"Gabon","2025-02-03",0,0,2,13,0,2,0,13
"Gabon","2025-02-04",0,0,2,13,0,2,0,13
"Gabon","2025-02-05",0,0,2,13,0,2,0,13
"Gabon","2025-02-06",0,0,2,13,0,2,0,13
"Gabon","2025-02-07",0,0,2,13,0,2,0,13
"Gabon","2025-02-08",0,0,2,13,0,2,0,13
"Gabon","2025-02-09",0,0,2,13,0,2,0,13
"Gabon","2025-02-10",0,0,2,13,0,2,0,13
"Gabon","2025-02-11",0,0,2,13,0,2,0,13
"Gabon","2025-02-12",0,0,2,13,0,2,0,13
"Gabon","2025-02-13",0,0,2,13,0,2,0,13
"Gabon","2025-02-14",0,0,2,13,0,2,0,13
"Gabon","2025-02-15",0,0,2,13,0,2,0,13
"Gabon","2025-02-16",0,0,2,13,0,2,0,13
"Gabon","2025-02-17",0,0,2,13,0,2,0,13
"Gabon","2025-02-18",0,0,2,13,0,2,0,13
"Gabon","2025-02-19",0,0,2,13,0,2,0,13
"Gabon","2025-02-20",0,0,2,13,0,2,0,13
"Gabon","2025-02-21",0,0,2,13,0,2,0,13
"Gabon","2025-02-22",0,0,2,13,0,2,0,13
"Gabon","2025-02-23",0,0,2,13,0,2,0,13
"Gabon","2025-02-24",0,0,2,13,0,2,0,13
"Gabon","2025-02-25",0,0,2,13,0,2,0,13
"Gabon","2025-02-26",0,0,2,13,0,2,0,13
"Gabon","2025-02-27",0,0,2,13,0,2,0,13
"Gabon","2025-02-28",0,0,2,13,0,2,0,13
"Gabon","2025-03-01",0,0,2,13,0,2,0,13
"Gabon","2025-03-02",0,0,2,13,0,2,0,13
"Gabon","2025-03-03",0,0,2,13,0,2,0,13
"Georgia","2024-01-01",0,0,0,0,0,0,0,0
"Georgia","2024-01-02",0,0,0,0,0,0,0,0
"Georgia","2024-01-03",0,0,0,0,0,0,0,0
"Georgia","2024-01-04",0,0,0,0,0,0,0,0
"Georgia","2024-01-05",0,0,0,0,0,0,0,0
"Georgia","2024-01-06",0,0,0,0,0,0,0,0
"Georgia","2024-01-07",0,0,0,0,0,0,0,0
"Georgia","2024-01-08",0,0,0,0,0,0,0,0
"Georgia","2024-01-09",0,0,0,0,0,0,0,0
"Georgia","2024-01-10",0,0,0,0,0,0,0,0
"Georgia","2024-01-11",0,0,0,0,0,0,0,0
"Georgia","2024-01-12",0,0,0,0,0,0,0,0
"Georgia","2024-01-13",0,0,0,0,0,0,0,0
"Georgia","2024-01-14",0,0,0,0,0,0,0,0
"Georgia","2024-01-15",0,0,0,0,0,0,0,0
"Georgia","2024-01-16",0,0,0,0,0,0,0,0
"Georgia","2024-01-17",0,0,0,0,0,0,0,0
"Georgia","2024-01-18",0,0,0,0,0,0,0,0
"Georgia","2024-01-19",0,0,0,0,0,0,0,0
"Georgia","2024-01-20",0,0,0,0,0,0,0,0
"Georgia","2024-01-21",0,0,0,0,0,0,0,0
"Georgia","2024-01-22",0,0,0,0,0,0,0,0
"Georgia","2024-01-23",0,0,0,0,0,0,0,0
"Georgia","2024-01-24",0,0,0,0,0,0,0,0
"Georgia","2024-01-25",0,0,0,0,0,0,0,0
"Georgia","2024-01-26",0,0,0,0,0,0,0,0
"Georgia","2024-01-27",0,0,0,0,0,0,0,0
"Georgia","2024-01-28",0,0,0,0,0,0,0,0
"Georgia","2024-01-29",0,0,0,0,0,0,0,0
"Georgia","2024-01-30",0,0,0,0,0,0,0,0
"Georgia","2024-01-31",0,0,0,0,0,0,0,0
"Georgia","2024-02-01",0,0,0,0,0,0,0,0
"Georgia","2024-02-02",0,0,0,0,0,0,0,0
"Georgia","2024-02-03",0,0,0,0,0,0,0,0
"Georgia","2024-02-04",0,0,0,0,0,0,0,0
"Georgia","2024-02-05",0,0,0,0,0,0,0,0
"Georgia","2024-02-06",0,0,0,0,0,0,0,0
"Georgia","2024-02-07",0,0,0,0,0,0,0,0
"Georgia","2024-02-08",0,0,0,0,0,0,0,0
"Georgia","2024-02-09",0,0,0,0,0,0,0,0
"Georgia","2024-02-10",0,0,0,0,0,0,0,0
"Georgia","2024-02-11",0,0,0,0,0,0,0,0
"Georgia","2024-02-12",0,0,0,0,0,0,0,0
"Georgia","2024-02-13",0,0,0,0,0,0,0,0
"Georgia","2024-02-14",0,0,0,0,0,0,0,0
"Georgia","2024-02-15",0,0,0,0,0,0,0,0
"Georgia","2024-02-16",0,0,0,0,0,0,0,0
"Georgia","2024-02-17",0,0,0,0,0,0,0,0
"Georgia","2024-02-18",0,0,0,0,0,0,0,0
"Georgia","2024-02-19",0,0,0,0,0,0,0,0
"Georgia","2024-02-20",0,0,0,0,0,0,0,0
"Georgia","2024-02-21",0,0,0,0,0,0,0,0
"Georgia","2024-02-22",0,0,0,0,0,0,0,0
"Georgia","2024-02-23",0,0,0,0,0,0,0,0
"Georgia","2024-02-24",0,0,0,0,0,0,0,0
"Georgia","2024-02-25",0,0,0,0,0,0,0,0
"Georgia","2024-02-26",0,0,0,0,0,0,0,0
"Georgia","2024-02-27",0,0,0,0,0,0,0,0
"Georgia","2024-02-28",0,0,0,0,0,0,0,0
"Georgia","2024-02-29",0,0,0,0,0,0,0,0
"Georgia","2024-03-01",0,0,0,0,0,0,0,0
"Georgia","2024-03-02",0,0,0,0,0,0,0,0
"Georgia","2024-03-03",0,0,0,0,0,0,0,0
"Georgia","2024-03-04",0,0,0,0,0,0,0,0
"Georgia","2024-03-05",0,0,0,0,0,0,0,0
"Georgia","2024-03-06",0,0,0,0,0,0,0,0
"Georgia","2024-03-07",0,0,0,0,0,0,0,0
"Georgia","2024-03-08",0,0,0,0,0,0,0,0
"Georgia","2024-03-09",0,0,0,0,0,0,0,0
"Georgia","2024-03-10",0,0,0,0,0,0,0,0
"Georgia","2024-03-11",0,0,0,0,0,0,0,0
"Georgia","2024-03-12",0,0,0,0,0,0,0,0
"Georgia","2024-03-13",0,0,0,0,0,0,0,0
"Georgia","2024-03-14",0,0,0,0,0,0,0,0
"Georgia","2024-03-15",0,0,0,0,0,0,0,0
"Georgia","2024-03-16",0,0,0,0,0,0,0,0
"Georgia","2024-03-17",0,0,0,0,0,0,0,0
"Georgia","2024-03-18",0,0,0,0,0,0,0,0
"Georgia","2024-03-19",0,0,0,0,0,0,0,0
"Georgia","2024-03-20",0,0,0,0,0,0,0,0
"Georgia","2024-03-21",0,0,0,0,0,0,0,0
"Georgia","2024-03-22",0,0,0,0,0,0,0,0
"Georgia","2024-03-23",0,0,0,0,0,0,0,0
"Georgia","2024-03-24",0,0,0,0,0,0,0,0
"Georgia","2024-03-25",0,0,0,0,0,0,0,0
"Georgia","2024-03-26",0,0,0,0,0,0,0,0
"Georgia","2024-03-27",0,0,0,0,0,0,0,0
"Georgia","2024-03-28",0,0,0,0,0,0,0,0
"Georgia","2024-03-29",0,0,0,0,0,0,0,0
"Georgia","2024-03-30",0,0,0,0,0,0,0,0
"Georgia","2024-03-31",0,0,0,0,0,0,0,0
"Georgia","2024-04-01",0,0,0,0,0,0,0,0
"Georgia","2024-04-02",0,0,0,0,0,0,0,0
"Georgia","2024-04-03",0,0,0,0,0,0,0,0
"Georgia","2024-04-04",0,0,0,0,0,0,0,0
"Georgia","2024-04-05",0,0,0,0,0,0,0,0
"Georgia","2024-04-06",0,0,0,0,0,0,0,0
"Georgia","2024-04-07",0,0,0,0,0,0,0,0
"Georgia","2024-04-08",0,0,0,0,0,0,0,0
"Georgia","2024-04-09",0,0,0,0,0,0,0,0
"Georgia","2024-04-10",0,0,0,0,0,0,0,0
"Georgia","2024-04-11",0,0,0,0,0,0,0,0
"Georgia","2024-04-12",0,0,0,0,0,0,0,0
"Georgia","2024-04-13",0,0,0,0,0,0,0,0
"Georgia","2024-04-14",0,0,0,0,0,0,0,0
"Georgia","2024-04-15",0,0,0,0,0,0,0,0
"Georgia","2024-04-16",0,0,0,0,0,0,0,0
"Georgia","2024-04-17",0,0,0,0,0,0,0,0
"Georgia","2024-04-18",0,0,0,0,0,0,0,0
"Georgia","2024-04-19",0,0,0,0,0,0,0,0
"Georgia","2024-04-20",0,0,0,0,0,0,0,0
"Georgia","2024-04-21",0,0,0,0,0,0,0,0
"Georgia","2024-04-22",0,0,0,0,0,0,0,0
"Georgia","2024-04-23",0,0,0,0,0,0,0,0
"Georgia","2024-04-24",0,0,0,0,0,0,0,0
"Georgia","2024-04-25",0,0,0,0,0,0,0,0
"Georgia","2024-04-26",0,0,0,0,0,0,0,0
"Georgia","2024-04-27",0,0,0,0,0,0,0,0
"Georgia","2024-04-28",0,0,0,0,0,0,0,0
"Georgia","2024-04-29",0,0,0,0,0,0,0,0
"Georgia","2024-04-30",0,0,0,0,0,0,0,0
"Georgia","2024-05-01",0,0,0,0,0,0,0,0
"Georgia","2024-05-02",0,0,0,0,0,0,0,0
"Georgia","2024-05-03",0,0,0,0,0,0,0,0
"Georgia","2024-05-04",0,0,0,0,0,0,0,0
"Georgia","2024-05-05",0,0,0,0,0,0,0,0
"Georgia","2024-05-06",0,0,0,0,0,0,0,0
"Georgia","2024-05-07",0,0,0,0,0,0,0,0
"Georgia","2024-05-08",0,0,0,0,0,0,0,0
"Georgia","2024-05-09",0,0,0,0,0,0,0,0
"Georgia","2024-05-10",0,0,0,0,0,0,0,0
"Georgia","2024-05-11",0,0,0,0,0,0,0,0
"Georgia","2024-05-12",0,0,0,0,0,0,0,0
"Georgia","2024-05-13",0,0,0,0,0,0,0,0
"Georgia","2024-05-14",0,0,0,0,0,0,0,0
"Georgia","2024-05-15",0,0,0,0,0,0,0,0
"Georgia","2024-05-16",0,0,0,0,0,0,0,0
"Georgia","2024-05-17",0,0,0,0,0,0,0,0
"Georgia","2024-05-18",0,0,0,0,0,0,0,0
"Georgia","2024-05-19",0,0,0,0,0,0,0,0
"Georgia","2024-05-20",0,0,0,0,0,0,0,0
"Georgia","2024-05-21",0,0,0,0,0,0,0,0
"Georgia","2024-05-22",0,0,0,0,0,0,0,0
"Georgia","2024-05-23",0,0,0,0,0,0,0,0
"Georgia","2024-05-24",0,0,0,0,0,0,0,0
"Georgia","2024-05-25",0,0,0,0,0,0,0,0
"Georgia","2024-05-26",0,0,0,0,0,0,0,0
"Georgia","2024-05-27",0,0,0,0,0,0,0,0
"Georgia","2024-05-28",0,0,0,0,0,0,0,0
"Georgia","2024-05-29",0,0,0,0,0,0,0,0
"Georgia","2024-05-30",0,0,0,0,0,0,0,0
"Georgia","2024-05-31",0,0,0,0,0,0,0,0
"Georgia","2024-06-01",0,0,0,0,0,0,0,0
"Georgia","2024-06-02",0,0,0,0,0,0,0,0
"Georgia","2024-06-03",0,0,0,0,0,0,0,0
"Georgia","2024-06-04",0,0,0,0,0,0,0,0
"Georgia","2024-06-05",0,0,0,0,0,0,0,0
"Georgia","2024-06-06",0,0,0,0,0,0,0,0
"Georgia","2024-06-07",0,0,0,0,0,0,0,0
"Georgia","2024-06-08",0,0,0,0,0,0,0,0
"Georgia","2024-06-09",0,0,0,0,0,0,0,0
"Georgia","2024-06-10",0,0,0,0,0,0,0,0
"Georgia","2024-06-11",0,0,0,0,0,0,0,0
"Georgia","2024-06-12",0,0,0,0,0,0,0,0
"Georgia","2024-06-13",0,0,0,0,0,0,0,0
"Georgia","2024-06-14",0,0,0,0,0,0,0,0
"Georgia","2024-06-15",0,0,0,0,0,0,0,0
"Georgia","2024-06-16",0,0,0,0,0,0,0,0
"Georgia","2024-06-17",0,0,0,0,0,0,0,0
"Georgia","2024-06-18",0,0,0,0,0,0,0,0
"Georgia","2024-06-19",0,0,0,0,0,0,0,0
"Georgia","2024-06-20",0,0,0,0,0,0,0,0
"Georgia","2024-06-21",0,0,0,0,0,0,0,0
"Georgia","2024-06-22",0,0,0,0,0,0,0,0
"Georgia","2024-06-23",0,0,0,0,0,0,0,0
"Georgia","2024-06-24",0,0,0,0,0,0,0,0
"Georgia","2024-06-25",0,0,0,0,0,0,0,0
"Georgia","2024-06-26",0,0,0,0,0,0,0,0
"Georgia","2024-06-27",0,0,0,0,0,0,0,0
"Georgia","2024-06-28",0,0,0,0,0,0,0,0
"Georgia","2024-06-29",0,0,0,0,0,0,0,0
"Georgia","2024-06-30",0,0,0,0,0,0,0,0
"Georgia","2024-07-01",0,0,0,0,0,0,0,0
"Georgia","2024-07-02",0,0,0,0,0,0,0,0
"Georgia","2024-07-03",0,0,0,0,0,0,0,0
"Georgia","2024-07-04",0,0,0,0,0,0,0,0
"Georgia","2024-07-05",0,0,0,0,0,0,0,0
"Georgia","2024-07-06",0,0,0,0,0,0,0,0
"Georgia","2024-07-07",0,0,0,0,0,0,0,0
"Georgia","2024-07-08",0,0,0,0,0,0,0,0
"Georgia","2024-07-09",0,0,0,0,0,0,0,0
"Georgia","2024-07-10",0,0,0,0,0,0,0,0
"Georgia","2024-07-11",0,0,0,0,0,0,0,0
"Georgia","2024-07-12",0,0,0,0,0,0,0,0
"Georgia","2024-07-13",0,0,0,0,0,0,0,0
"Georgia","2024-07-14",0,0,0,0,0,0,0,0
"Georgia","2024-07-15",0,0,0,0,0,0,0,0
"Georgia","2024-07-16",0,0,0,0,0,0,0,0
"Georgia","2024-07-17",0,0,0,0,0,0,0,0
"Georgia","2024-07-18",0,0,0,0,0,0,0,0
"Georgia","2024-07-19",0,0,0,0,0,0,0,0
"Georgia","2024-07-20",0,0,0,0,0,0,0,0
"Georgia","2024-07-21",0,0,0,0,0,0,0,0
"Georgia","2024-07-22",0,0,0,0,0,0,0,0
"Georgia","2024-07-23",0,0,0,0,0,0,0,0
"Georgia","2024-07-24",0,0,0,0,0,0,0,0
"Georgia","2024-07-25",0,0,0,0,0,0,0,0
"Georgia","2024-07-26",0,0,0,0,0,0,0,0
"Georgia","2024-07-27",0,0,0,0,0,0,0,0
"Georgia","2024-07-28",0,0,0,0,0,0,0,0
"Georgia","2024-07-29",0,0,0,0,0,0,0,0
"Georgia","2024-07-30",0,0,0,0,0,0,0,0
"Georgia","2024-07-31",0,0,0,0,0,0,0,0
"Georgia","2024-08-01",0,0,0,0,0,0,0,0
"Georgia","2024-08-02",0,0,0,0,0,0,0,0
"Georgia","2024-08-03",0,0,0,0,0,0,0,0
"Georgia","2024-08-04",0,0,0,0,0,0,0,0
"Georgia","2024-08-05",0,0,0,0,0,0,0,0
"Georgia","2024-08-06",0,0,0,0,0,0,0,0
"Georgia","2024-08-07",0,0,0,0,0,0,0,0
"Georgia","2024-08-08",0,0,0,0,0,0,0,0
"Georgia","2024-08-09",0,0,0,0,0,0,0,0
"Georgia","2024-08-10",0,0,0,0,0,0,0,0
"Georgia","2024-08-11",0,0,0,0,0,0,0,0
"Georgia","2024-08-12",0,0,0,0,0,0,0,0
"Georgia","2024-08-13",0,0,0,0,0,0,0,0
"Georgia","2024-08-14",0,0,0,0,0,0,0,0
"Georgia","2024-08-15",0,0,0,0,0,0,0,0
"Georgia","2024-08-16",0,0,0,0,0,0,0,0
"Georgia","2024-08-17",0,0,0,0,0,0,0,0
"Georgia","2024-08-18",0,0,0,0,0,0,0,0
"Georgia","2024-08-19",0,0,0,0,0,0,0,0
"Georgia","2024-08-20",0,0,0,0,0,0,0,0
"Georgia","2024-08-21",0,0,0,0,0,0,0,0
"Georgia","2024-08-22",0,0,0,0,0,0,0,0
"Georgia","2024-08-23",0,0,0,0,0,0,0,0
"Georgia","2024-08-24",0,0,0,0,0,0,0,0
"Georgia","2024-08-25",0,0,0,0,0,0,0,0
"Georgia","2024-08-26",0,0,0,0,0,0,0,0
"Georgia","2024-08-27",0,0,0,0,0,0,0,0
"Georgia","2024-08-28",0,0,0,0,0,0,0,0
"Georgia","2024-08-29",0,0,0,0,0,0,0,0
"Georgia","2024-08-30",0,0,0,0,0,0,0,0
"Georgia","2024-08-31",0,0,0,0,0,0,0,0
"Georgia","2024-09-01",0,0,0,0,0,0,0,0
"Georgia","2024-09-02",0,0,0,0,0,0,0,0
"Georgia","2024-09-03",0,0,0,0,0,0,0,0
"Georgia","2024-09-04",0,0,0,0,0,0,0,0
"Georgia","2024-09-05",0,0,0,0,0,0,0,0
"Georgia","2024-09-06",0,0,0,0,0,0,0,0
"Georgia","2024-09-07",0,0,0,0,0,0,0,0
"Georgia","2024-09-08",0,0,0,0,0,0,0,0
"Georgia","2024-09-09",0,0,0,0,0,0,0,0
"Georgia","2024-09-10",0,0,0,0,0,0,0,0
"Georgia","2024-09-11",0,0,0,0,0,0,0,0
"Georgia","2024-09-12",0,0,0,0,0,0,0,0
"Georgia","2024-09-13",0,0,0,0,0,0,0,0
"Georgia","2024-09-14",0,0,0,0,0,0,0,0
"Georgia","2024-09-15",0,0,0,0,0,0,0,0
"Georgia","2024-09-16",0,0,0,0,0,0,0,0
"Georgia","2024-09-17",0,0,0,0,0,0,0,0
"Georgia","2024-09-18",0,0,0,0,0,0,0,0
"Georgia","2024-09-19",0,0,0,0,0,0,0,0
"Georgia","2024-09-20",0,0,0,0,0,0,0,0
"Georgia","2024-09-21",0,0,0,0,0,0,0,0
"Georgia","2024-09-22",0,0,0,0,0,0,0,0
"Georgia","2024-09-23",0,0,0,0,0,0,0,0
"Georgia","2024-09-24",0,0,0,0,0,0,0,0
"Georgia","2024-09-25",0,0,0,0,0,0,0,0
"Georgia","2024-09-26",0,0,0,0,0,0,0,0
"Georgia","2024-09-27",0,0,0,0,0,0,0,0
"Georgia","2024-09-28",0,0,0,0,0,0,0,0
"Georgia","2024-09-29",0,0,0,0,0,0,0,0
"Georgia","2024-09-30",0,0,0,0,0,0,0,0
"Georgia","2024-10-01",0,0,0,0,0,0,0,0
"Georgia","2024-10-02",0,0,0,0,0,0,0,0
"Georgia","2024-10-03",0,0,0,0,0,0,0,0
"Georgia","2024-10-04",0,0,0,0,0,0,0,0
"Georgia","2024-10-05",0,0,0,0,0,0,0,0
"Georgia","2024-10-06",0,0,0,0,0,0,0,0
"Georgia","2024-10-07",0,0,0,0,0,0,0,0
"Georgia","2024-10-08",0,0,0,0,0,0,0,0
"Georgia","2024-10-09",0,0,0,0,0,0,0,0
"Georgia","2024-10-10",0,0,0,0,0,0,0,0
"Georgia","2024-10-11",0,0,0,0,0,0,0,0
"Georgia","2024-10-12",0,0,0,0,0,0,0,0
"Georgia","2024-10-13",0,0,0,0,0,0,0,0
"Georgia","2024-10-14",0,0,0,0,0,0,0,0
"Georgia","2024-10-15",0,0,0,0,0,0,0,0
"Georgia","2024-10-16",0,0,0,0,0,0,0,0
"Georgia","2024-10-17",0,0,0,0,0,0,0,0
"Georgia","2024-10-18",0,0,0,0,0,0,0,0
"Georgia","2024-10-19",0,0,0,0,0,0,0,0
"Georgia","2024-10-20",0,0,0,0,0,0,0,0
"Georgia","2024-10-21",0,0,0,0,0,0,0,0
"Georgia","2024-10-22",0,0,0,0,0,0,0,0
"Georgia","2024-10-23",0,0,0,0,0,0,0,0
"Georgia","2024-10-24",0,0,0,0,0,0,0,0
"Georgia","2024-10-25",0,0,0,0,0,0,0,0
"Georgia","2024-10-26",0,0,0,0,0,0,0,0
"Georgia","2024-10-27",0,0,0,0,0,0,0,0
"Georgia","2024-10-28",0,0,0,0,0,0,0,0
"Georgia","2024-10-29",0,0,0,0,0,0,0,0
"Georgia","2024-10-30",0,0,0,0,0,0,0,0
"Georgia","2024-10-31",0,0,0,0,0,0,0,0
"Georgia","2024-11-01",0,0,0,0,0,0,0,0
"Georgia","2024-11-02",0,0,0,0,0,0,0,0
"Georgia","2024-11-03",0,0,0,0,0,0,0,0
"Georgia","2024-11-04",0,0,0,0,0,0,0,0
"Georgia","2024-11-05",0,0,0,0,0,0,0,0
"Georgia","2024-11-06",0,0,0,0,0,0,0,0
"Georgia","2024-11-07",0,0,0,0,0,0,0,0
"Georgia","2024-11-08",0,0,0,0,0,0,0,0
"Georgia","2024-11-09",0,0,0,0,0,0,0,0
"Georgia","2024-11-10",0,0,0,0,0,0,0,0
"Georgia","2024-11-11",0,0,0,0,0,0,0,0
"Georgia","2024-11-12",0,0,0,0,0,0,0,0
"Georgia","2024-11-13",0,0,0,0,0,0,0,0
"Georgia","2024-11-14",0,0,0,0,0,0,0,0
"Georgia","2024-11-15",0,0,0,0,0,0,0,0
"Georgia","2024-11-16",0,0,0,0,0,0,0,0
"Georgia","2024-11-17",0,0,0,0,0,0,0,0
"Georgia","2024-11-18",0,0,0,0,0,0,0,0
"Georgia","2024-11-19",0,0,0,0,0,0,0,0
"Georgia","2024-11-20",0,0,0,0,0,0,0,0
"Georgia","2024-11-21",0,0,0,0,0,0,0,0
"Georgia","2024-11-22",0,0,0,0,0,0,0,0
"Georgia","2024-11-23",0,0,0,0,0,0,0,0
"Georgia","2024-11-24",0,0,0,0,0,0,0,0
"Georgia","2024-11-25",0,0,0,0,0,0,0,0
"Georgia","2024-11-26",0,0,0,0,0,0,0,0
"Georgia","2024-11-27",0,0,0,0,0,0,0,0
"Georgia","2024-11-28",0,0,0,0,0,0,0,0
"Georgia","2024-11-29",0,0,0,0,0,0,0,0
"Georgia","2024-11-30",0,0,0,0,0,0,0,0
"Georgia","2024-12-01",0,0,0,0,0,0,0,0
"Georgia","2024-12-02",0,0,0,0,0,0,0,0
"Georgia","2024-12-03",0,0,0,0,0,0,0,0
"Georgia","2024-12-04",0,0,0,0,0,0,0,0
"Georgia","2024-12-05",0,0,0,0,0,0,0,0
"Georgia","2024-12-06",0,0,0,0,0,0,0,0
"Georgia","2024-12-07",0,0,0,0,0,0,0,0
"Georgia","2024-12-08",0,0,0,0,0,0,0,0
"Georgia","2024-12-09",0,0,0,0,0,0,0,0
"Georgia","2024-12-10",0,0,0,0,0,0,0,0
"Georgia","2024-12-11",0,0,0,0,0,0,0,0
"Georgia","2024-12-12",0,0,0,0,0,0,0,0
"Georgia","2024-12-13",0,0,0,0,0,0,0,0
"Georgia","2024-12-14",0,0,0,0,0,0,0,0
"Georgia","2024-12-15",0,0,0,0,0,0,0,0
"Georgia","2024-12-16",0,0,0,0,0,0,0,0
"Georgia","2024-12-17",0,0,0,0,0,0,0,0
"Georgia","2024-12-18",0,0,0,0,0,0,0,0
"Georgia","2024-12-19",0,0,0,0,0,0,0,0
"Georgia","2024-12-20",0,0,0,0,0,0,0,0
"Georgia","2024-12-21",0,0,0,0,0,0,0,0
"Georgia","2024-12-22",0,0,0,0,0,0,0,0
"Georgia","2024-12-23",0,0,0,0,0,0,0,0
"Georgia","2024-12-24",0,0,0,0,0,0,0,0
"Georgia","2024-12-25",0,0,0,0,0,0,0,0
"Georgia","2024-12-26",0,0,0,0,0,0,0,0
"Georgia","2024-12-27",0,0,0,0,0,0,0,0
"Georgia","2024-12-28",0,0,0,0,0,0,0,0
"Georgia","2024-12-29",0,0,0,0,0,0,0,0
"Georgia","2024-12-30",0,0,0,0,0,0,0,0
"Georgia","2024-12-31",0,0,0,0,0,0,0,0
"Georgia","2025-01-01",0,0,0,0,0,0,0,0
"Georgia","2025-01-02",0,0,0,0,0,0,0,0
"Georgia","2025-01-03",0,0,0,0,0,0,0,0
"Georgia","2025-01-04",0,0,0,0,0,0,0,0
"Georgia","2025-01-05",0,0,0,0,0,0,0,0
"Georgia","2025-01-06",0,0,0,0,0,0,0,0
"Georgia","2025-01-07",0,0,0,0,0,0,0,0
"Georgia","2025-01-08",0,0,0,0,0,0,0,0
"Georgia","2025-01-09",0,0,0,0,0,0,0,0
"Georgia","2025-01-10",0,0,0,0,0,0,0,0
"Georgia","2025-01-11",0,0,0,0,0,0,0,0
"Georgia","2025-01-12",0,0,0,0,0,0,0,0
"Georgia","2025-01-13",0,0,0,0,0,0,0,0
"Georgia","2025-01-14",0,0,0,0,0,0,0,0
"Georgia","2025-01-15",0,0,0,0,0,0,0,0
"Georgia","2025-01-16",0,0,0,0,0,0,0,0
"Georgia","2025-01-17",0,0,0,0,0,0,0,0
"Georgia","2025-01-18",0,0,0,0,0,0,0,0
"Georgia","2025-01-19",0,0,0,0,0,0,0,0
"Georgia","2025-01-20",0,0,0,0,0,0,0,0
"Georgia","2025-01-21",0,0,0,0,0,0,0,0
"Georgia","2025-01-22",0,0,0,0,0,0,0,0
"Georgia","2025-01-23",0,0,0,0,0,0,0,0
"Georgia","2025-01-24",0,0,0,0,0,0,0,0
"Georgia","2025-01-25",0,0,0,0,0,0,0,0
"Georgia","2025-01-26",0,0,0,0,0,0,0,0
"Georgia","2025-01-27",0,0,0,0,0,0,0,0
"Georgia","2025-01-28",0,0,0,0,0,0,0,0
"Georgia","2025-01-29",0,0,0,0,0,0,0,0
"Georgia","2025-01-30",0,0,0,0,0,0,0,0
"Georgia","2025-01-31",0,0,0,0,0,0,0,0
"Georgia","2025-02-01",0,0,0,0,0,0,0,0
"Georgia","2025-02-02",0,0,0,0,0,0,0,0
"Georgia","2025-02-03",0,0,0,0,0,0,0,0
"Georgia","2025-02-04",0,0,0,0,0,0,0,0
"Georgia","2025-02-05",0,0,0,0,0,0,0,0
"Georgia","2025-02-06",0,0,0,0,0,0,0,0
"Georgia","2025-02-07",0,0,0,0,0,0,0,0
"Georgia","2025-02-08",0,0,0,0,0,0,0,0
"Georgia","2025-02-09",0,0,0,0,0,0,0,0
"Georgia","2025-02-10",0,0,0,0,0,0,0,0
"Georgia","2025-02-11",0,0,0,0,0,0,0,0
"Georgia","2025-02-12",0,0,0,0,0,0,0,0
"Georgia","2025-02-13",0,0,0,0,0,0,0,0
"Georgia","2025-02-14",0,0,0,0,0,0,0,0
"Georgia","2025-02-15",0,0,0,0,0,0,0,0
"Georgia","2025-02-16",0,0,0,0,0,0,0,0
"Georgia","2025-02-17",0,0,0,0,0,0,0,0
"Georgia","2025-02-18",0,0,0,0,0,0,0,0
"Georgia","2025-02-19",0,0,0,0,0,0,0,0
"Georgia","2025-02-20",0,0,0,0,0,0,0,0
"Georgia","2025-02-21",0,0,0,0,0,0,0,0
"Georgia","2025-02-22",0,0,0,0,0,0,0,0
"Georgia","2025-02-23",0,0,0,0,0,0,0,0
"Georgia","2025-02-24",0,0,0,0,0,0,0,0
"Georgia","2025-02-25",0,0,0,0,0,0,0,0
"Georgia","2025-02-26",0,0,0,0,0,0,0,0
"Georgia","2025-02-27",0,0,0,0,0,0,0,0
"Georgia","2025-02-28",0,0,0,0,0,0,0,0
"Georgia","2025-03-01",0,0,0,0,0,0,0,0
"Georgia","2025-03-02",0,0,0,0,0,0,0,0
"Georgia","2025-03-03",0,0,0,0,0,0,0,0
"Germany","2024-01-01",0,0,0,0,0,0,0,0
"Germany","2024-01-02",0,0,0,0,0,0,0,0
"Germany","2024-01-03",0,0,0,0,0,0,0,0
"Germany","2024-01-04",0,0,0,0,0,0,0,0
"Germany","2024-01-05",0,0,0,0,0,0,0,0
"Germany","2024-01-06",0,0,0,0,0,0,0,0
"Germany","2024-01-07",0,0,0,0,0,0,0,0
"Germany","2024-01-08",0,0,0,0,0,0,0,0
"Germany","2024-01-09",0,0,0,0,0,0,0,0
"Germany","2024-01-10",0,0,0,0,0,0,0,0
"Germany","2024-01-11",0,0,0,0,0,0,0,0
"Germany","2024-01-12",0,0,0,0,0,0,0,0
"Germany","2024-01-13",0,0,0,0,0,0,0,0
"Germany","2024-01-14",0,0,0,0,0,0,0,0
"Germany","2024-01-15",0,0,0,0,0,0,0,0
"Germany","2024-01-16",0,0,0,0,0,0,0,0
"Germany","2024-01-17",0,0,0,0,0,0,0,0
"Germany","2024-01-18",0,0,0,0,0,0,0,0
"Germany","2024-01-19",0,0,0,0,0,0,0,0
"Germany","2024-01-20",0,0,0,0,0,0,0,0
"Germany","2024-01-21",0,0,0,0,0,0,0,0
"Germany","2024-01-22",0,0,0,0,0,0,0,0
"Germany","2024-01-23",0,0,0,0,0,0,0,0
"Germany","2024-01-24",0,0,0,0,0,0,0,0
"Germany","2024-01-25",0,0,0,0,0,0,0,0
"Germany","2024-01-26",0,0,0,0,0,0,0,0
"Germany","2024-01-27",0,0,0,0,0,0,0,0
"Germany","2024-01-28",0,0,0,0,0,0,0,0
"Germany","2024-01-29",0,0,0,0,0,0,0,0
"Germany","2024-01-30",0,0,0,0,0,0,0,0
"Germany","2024-01-31",0,7,7,0,7,7,0,0
"Germany","2024-02-01",0,0,7,0,0,7,0,0
"Germany","2024-02-02",0,0,7,0,1,8,0,0
"Germany","2024-02-03",0,0,7,0,0,8,0,0
"Germany","2024-02-04",0,0,7,0,0,8,0,0
"Germany","2024-02-05",0,0,7,0,1,9,0,0
"Germany","2024-02-06",0,0,7,0,0,9,0,0
"Germany","2024-02-07",0,0,7,0,0,9,0,0
"Germany","2024-02-08",0,0,7,0,0,9,0,0
"Germany","2024-02-09",0,0,7,0,1,10,0,0
"Germany","2024-02-10",0,0,7,0,0,10,0,0
"Germany","2024-02-11",0,0,7,0,0,10,0,0
"Germany","2024-02-12",0,0,7,0,1,11,0,0
"Germany","2024-02-13",0,0,7,0,0,11,0,0
"Germany","2024-02-14",0,0,7,0,0,11,0,0
"Germany","2024-02-15",0,0,7,0,1,12,0,0
"Germany","2024-02-16",0,0,7,0,0,12,0,0
"Germany","2024-02-17",0,0,7,0,0,12,0,0
"Germany","2024-02-18",0,0,7,0,1,13,0,0
"Germany","2024-02-19",0,0,7,0,0,13,0,0
"Germany","2024-02-20",0,0,7,0,0,13,0,0
"Germany","2024-02-21",0,0,7,0,1,14,0,0
"Germany","2024-02-22",0,0,7,0,0,14,0,0
"Germany","2024-02-23",0,0,7,0,0,14,0,0
"Germany","2024-02-24",0,0,7,0,0,14,0,0
"Germany","2024-02-25",0,0,7,0,1,15,0,0
"Germany","2024-02-26",0,0,7,0,0,15,0,0
"Germany","2024-02-27",0,0,7,0,0,15,0,0
"Germany","2024-02-28",0,0,7,0,1,16,0,0
"Germany","2024-02-29",0,9,16,0,0,16,0,0
"Germany","2024-03-01",0,0,16,0,0,16,0,0
"Germany","2024-03-02",0,0,16,0,1,17,0,0
"Germany","2024-03-03",0,0,16,0,0,17,0,0
"Germany","2024-03-04",0,0,16,0,1,18,0,0
"Germany","2024-03-05",0,0,16,0,0,18,0,0
"Germany","2024-03-06",0,0,16,0,1,19,0,0
"Germany","2024-03-07",0,0,16,0,0,19,0,0
"Germany","2024-03-08",0,0,16,0,1,20,0,0
"Germany","2024-03-09",0,0,16,0,0,20,0,0
"Germany","2024-03-10",0,0,16,0,1,21,0,0
"Germany","2024-03-11",0,0,16,0,0,21,0,0
"Germany","2024-03-12",0,0,16,0,0,21,0,0
"Germany","2024-03-13",0,0,16,0,1,22,0,0
"Germany","2024-03-14",0,0,16,0,0,22,0,0
"Germany","2024-03-15",0,0,16,0,1,23,0,0
"Germany","2024-03-16",0,0,16,0,0,23,0,0
"Germany","2024-03-17",0,0,16,0,1,24,0,0
"Germany","2024-03-18",0,0,16,0,0,24,0,0
"Germany","2024-03-19",0,0,16,0,1,25,0,0
"Germany","2024-03-20",0,0,16,0,0,25,0,0
"Germany","2024-03-21",0,0,16,0,0,25,0,0
"Germany","2024-03-22",0,0,16,0,1,26,0,0
"Germany","2024-03-23",0,0,16,0,0,26,0,0
"Germany","2024-03-24",0,0,16,0,1,27,0,0
"Germany","2024-03-25",0,0,16,0,0,27,0,0
"Germany","2024-03-26",0,0,16,0,1,28,0,0
"Germany","2024-03-27",0,0,16,0,0,28,0,0
"Germany","2024-03-28",0,0,16,0,1,29,0,0
"Germany","2024-03-29",0,0,16,0,0,29,0,0
"Germany","2024-03-30",0,0,16,0,1,30,0,0
"Germany","2024-03-31",0,14,30,0,0,30,0,0
"Germany","2024-04-01",0,0,30,0,0,30,0,0
"Germany","2024-04-02",0,0,30,0,1,31,0,0
"Germany","2024-04-03",0,0,30,0,0,31,0,0
"Germany","2024-04-04",0,0,30,0,0,31,0,0
"Germany","2024-04-05",0,0,30,0,1,32,0,0
"Germany","2024-04-06",0,0,30,0,0,32,0,0
"Germany","2024-04-07",0,0,30,0,1,33,0,0
"Germany","2024-04-08",0,0,30,0,0,33,0,0
"Germany","2024-04-09",0,0,30,0,0,33,0,0
"Germany","2024-04-10",0,0,30,0,1,34,0,0
"Germany","2024-04-11",0,0,30,0,0,34,0,0
"Germany","2024-04-12",0,0,30,0,0,34,0,0
"Germany","2024-04-13",0,0,30,0,1,35,0,0
"Germany","2024-04-14",0,0,30,0,0,35,0,0
"Germany","2024-04-15",0,0,30,0,1,36,0,0
"Germany","2024-04-16",0,0,30,0,0,36,0,0
"Germany","2024-04-17",0,0,30,0,0,36,0,0
"Germany","2024-04-18",0,0,30,0,1,37,0,0
"Germany","2024-04-19",0,0,30,0,0,37,0,0
"Germany","2024-04-20",0,0,30,0,0,37,0,0
"Germany","2024-04-21",0,0,30,0,1,38,0,0
"Germany","2024-04-22",0,0,30,0,0,38,0,0
"Germany","2024-04-23",0,0,30,0,0,38,0,0
"Germany","2024-04-24",0,0,30,0,1,39,0,0
"Germany","2024-04-25",0,0,30,0,0,39,0,0
"Germany","2024-04-26",0,0,30,0,1,40,0,0
"Germany","2024-04-27",0,0,30,0,0,40,0,0
"Germany","2024-04-28",0,0,30,0,0,40,0,0
"Germany","2024-04-29",0,0,30,0,1,41,0,0
"Germany","2024-04-30",0,11,41,0,0,41,0,0
"Germany","2024-05-01",0,0,41,0,0,41,0,0
"Germany","2024-05-02",0,0,41,0,0,41,0,0
"Germany","2024-05-03",0,0,41,0,1,42,0,0
"Germany","2024-05-04",0,0,41,0,0,42,0,0
"Germany","2024-05-05",0,0,41,0,0,42,0,0
"Germany","2024-05-06",0,0,41,0,0,42,0,0
"Germany","2024-05-07",0,0,41,0,0,42,0,0
"Germany","2024-05-08",0,0,41,0,1,43,0,0
"Germany","2024-05-09",0,0,41,0,0,43,0,0
"Germany","2024-05-10",0,0,41,0,0,43,0,0
"Germany","2024-05-11",0,0,41,0,0,43,0,0
"Germany","2024-05-12",0,0,41,0,0,43,0,0
"Germany","2024-05-13",0,0,41,0,1,44,0,0
"Germany","2024-05-14",0,0,41,0,0,44,0,0
"Germany","2024-05-15",0,0,41,0,0,44,0,0
"Germany","2024-05-16",0,0,41,0,0,44,0,0
"Germany","2024-05-17",0,0,41,0,0,44,0,0
"Germany","2024-05-18",0,0,41,0,0,44,0,0
"Germany","2024-05-19",0,0,41,0,1,45,0,0
"Germany","2024-05-20",0,0,41,0,0,45,0,0
"Germany","2024-05-21",0,0,41,0,0,45,0,0
"Germany","2024-05-22",0,0,41,0,0,45,0,0
"Germany","2024-05-23",0,0,41,0,0,45,0,0
"Germany","2024-05-24",0,0,41,0,1,46,0,0
"Germany","2024-05-25",0,0,41,0,0,46,0,0
"Germany","2024-05-26",0,0,41,0,0,46,0,0
"Germany","2024-05-27",0,0,41,0,0,46,0,0
"Germany","2024-05-28",0,0,41,0,0,46,0,0
"Germany","2024-05-29",0,0,41,0,1,47,0,0
"Germany","2024-05-30",0,0,41,0,0,47,0,0
"Germany","2024-05-31",0,6,47,0,0,47,0,0
"Germany","2024-06-01",0,0,47,0,0,47,0,0
"Germany","2024-06-02",0,0,47,0,1,48,0,0
"Germany","2024-06-03",0,0,47,0,0,48,0,0
"Germany","2024-06-04",0,0,47,0,0,48,0,0
"Germany","2024-06-05",0,0,47,0,1,49,0,0
"Germany","2024-06-06",0,0,47,0,0,49,0,0
"Germany","2024-06-07",0,0,47,0,0,49,0,0
"Germany","2024-06-08",0,0,47,0,1,50,0,0
"Germany","2024-06-09",0,0,47,0,0,50,0,0
"Germany","2024-06-10",0,0,47,0,0,50,0,0
"Germany","2024-06-11",0,0,47,0,1,51,0,0
"Germany","2024-06-12",0,0,47,0,0,51,0,0
"Germany","2024-06-13",0,0,47,0,0,51,0,0
"Germany","2024-06-14",0,0,47,0,1,52,0,0
"Germany","2024-06-15",0,0,47,0,0,52,0,0
"Germany","2024-06-16",0,0,47,0,0,52,0,0
"Germany","2024-06-17",0,0,47,0,1,53,0,0
"Germany","2024-06-18",0,0,47,0,0,53,0,0
"Germany","2024-06-19",0,0,47,0,0,53,0,0
"Germany","2024-06-20",0,0,47,0,1,54,0,0
"Germany","2024-06-21",0,0,47,0,0,54,0,0
"Germany","2024-06-22",0,0,47,0,0,54,0,0
"Germany","2024-06-23",0,0,47,0,1,55,0,0
"Germany","2024-06-24",0,0,47,0,0,55,0,0
"Germany","2024-06-25",0,0,47,0,0,55,0,0
"Germany","2024-06-26",0,0,47,0,1,56,0,0
"Germany","2024-06-27",0,0,47,0,0,56,0,0
"Germany","2024-06-28",0,0,47,0,0,56,0,0
"Germany","2024-06-29",0,0,47,0,1,57,0,0
"Germany","2024-06-30",0,10,57,0,0,57,0,0
"Germany","2024-07-01",0,0,57,0,1,58,0,0
"Germany","2024-07-02",0,0,57,0,1,59,0,0
"Germany","2024-07-03",0,0,57,0,1,60,0,0
"Germany","2024-07-04",0,0,57,0,1,61,0,0
"Germany","2024-07-05",0,0,57,0,1,62,0,0
"Germany","2024-07-06",0,0,57,0,1,63,0,0
"Germany","2024-07-07",0,0,57,0,1,64,0,0
"Germany","2024-07-08",0,0,57,0,0,64,0,0
"Germany","2024-07-09",0,0,57,0,1,65,0,0
"Germany","2024-07-10",0,0,57,0,1,66,0,0
"Germany","2024-07-11",0,0,57,0,1,67,0,0
"Germany","2024-07-12",0,0,57,0,1,68,0,0
"Germany","2024-07-13",0,0,57,0,1,69,0,0
"Germany","2024-07-14",0,0,57,0,1,70,0,0
"Germany","2024-07-15",0,0,57,0,1,71,0,0
"Germany","2024-07-16",0,0,57,0,1,72,0,0
"Germany","2024-07-17",0,0,57,0,1,73,0,0
"Germany","2024-07-18",0,0,57,0,1,74,0,0
"Germany","2024-07-19",0,0,57,0,1,75,0,0
"Germany","2024-07-20",0,0,57,0,1,76,0,0
"Germany","2024-07-21",0,0,57,0,1,77,0,0
"Germany","2024-07-22",0,0,57,0,1,78,0,0
"Germany","2024-07-23",0,0,57,0,1,79,0,0
"Germany","2024-07-24",0,0,57,0,0,79,0,0
"Germany","2024-07-25",0,0,57,0,1,80,0,0
"Germany","2024-07-26",0,0,57,0,1,81,0,0
"Germany","2024-07-27",0,0,57,0,1,82,0,0
"Germany","2024-07-28",0,0,57,0,1,83,0,0
"Germany","2024-07-29",0,0,57,0,1,84,0,0
"Germany","2024-07-30",0,0,57,0,1,85,0,0
"Germany","2024-07-31",0,29,86,0,1,86,0,0
"Germany","2024-08-01",0,0,86,0,1,87,0,0
"Germany","2024-08-02",0,0,86,0,0,87,0,0
"Germany","2024-08-03",0,0,86,0,1,88,0,0
"Germany","2024-08-04",0,0,86,0,1,89,0,0
"Germany","2024-08-05",0,0,86,0,1,90,0,0
"Germany","2024-08-06",0,0,86,0,0,90,0,0
"Germany","2024-08-07",0,0,86,0,1,91,0,0
"Germany","2024-08-08",0,0,86,0,1,92,0,0
"Germany","2024-08-09",0,0,86,0,1,93,0,0
"Germany","2024-08-10",0,0,86,0,0,93,0,0
"Germany","2024-08-11",0,0,86,0,1,94,0,0
"Germany","2024-08-12",0,0,86,0,1,95,0,0
"Germany","2024-08-13",0,0,86,0,1,96,0,0
"Germany","2024-08-14",0,0,86,0,0,96,0,0
"Germany","2024-08-15",0,0,86,0,1,97,0,0
"Germany","2024-08-16",0,0,86,0,1,98,0,0
"Germany","2024-08-17",0,0,86,0,1,99,0,0
"Germany","2024-08-18",0,0,86,0,0,99,0,0
"Germany","2024-08-19",0,0,86,0,1,100,0,0
"Germany","2024-08-20",0,0,86,0,1,101,0,0
"Germany","2024-08-21",0,0,86,0,1,102,0,0
"Germany","2024-08-22",0,0,86,0,0,102,0,0
"Germany","2024-08-23",0,0,86,0,1,103,0,0
"Germany","2024-08-24",0,0,86,0,1,104,0,0
"Germany","2024-08-25",0,0,86,0,1,105,0,0
"Germany","2024-08-26",0,0,86,0,0,105,0,0
"Germany","2024-08-27",0,0,86,0,1,106,0,0
"Germany","2024-08-28",0,0,86,0,1,107,0,0
"Germany","2024-08-29",0,0,86,0,1,108,0,0
"Germany","2024-08-30",0,0,86,0,0,108,0,0
"Germany","2024-08-31",0,23,109,0,1,109,0,0
"Germany","2024-09-01",0,0,109,0,1,110,0,0
"Germany","2024-09-02",0,0,109,0,1,111,0,0
"Germany","2024-09-03",0,0,109,0,0,111,0,0
"Germany","2024-09-04",0,0,109,0,1,112,0,0
"Germany","2024-09-05",0,0,109,0,1,113,0,0
"Germany","2024-09-06",0,0,109,0,1,114,0,0
"Germany","2024-09-07",0,0,109,0,0,114,0,0
"Germany","2024-09-08",0,0,109,0,1,115,0,0
"Germany","2024-09-09",0,0,109,0,1,116,0,0
"Germany","2024-09-10",0,0,109,0,1,117,0,0
"Germany","2024-09-11",0,0,109,0,0,117,0,0
"Germany","2024-09-12",0,0,109,0,1,118,0,0
"Germany","2024-09-13",0,0,109,0,1,119,0,0
"Germany","2024-09-14",0,0,109,0,1,120,0,0
"Germany","2024-09-15",0,0,109,0,1,121,0,0
"Germany","2024-09-16",0,0,109,0,0,121,0,0
"Germany","2024-09-17",0,0,109,0,1,122,0,0
"Germany","2024-09-18",0,0,109,0,1,123,0,0
"Germany","2024-09-19",0,0,109,0,1,124,0,0
"Germany","2024-09-20",0,0,109,0,0,124,0,0
"Germany","2024-09-21",0,0,109,0,1,125,0,0
"Germany","2024-09-22",0,0,109,0,1,126,0,0
"Germany","2024-09-23",0,0,109,0,1,127,0,0
"Germany","2024-09-24",0,0,109,0,0,127,0,0
"Germany","2024-09-25",0,0,109,0,1,128,0,0
"Germany","2024-09-26",0,0,109,0,1,129,0,0
"Germany","2024-09-27",0,0,109,0,1,130,0,0
"Germany","2024-09-28",0,0,109,0,0,130,0,0
"Germany","2024-09-29",0,0,109,0,1,131,0,0
"Germany","2024-09-30",0,23,132,0,1,132,0,0
"Germany","2024-10-01",0,0,132,0,2,134,0,0
"Germany","2024-10-02",0,0,132,0,1,135,0,0
"Germany","2024-10-03",0,0,132,0,2,137,0,0
"Germany","2024-10-04",0,0,132,0,1,138,0,0
"Germany","2024-10-05",0,0,132,0,2,140,0,0
"Germany","2024-10-06",0,0,132,0,1,141,0,0
"Germany","2024-10-07",0,0,132,0,2,143,0,0
"Germany","2024-10-08",0,0,132,0,1,144,0,0
"Germany","2024-10-09",0,0,132,0,2,146,0,0
"Germany","2024-10-10",0,0,132,0,1,147,0,0
"Germany","2024-10-11",0,0,132,0,2,149,0,0
"Germany","2024-10-12",0,0,132,0,2,151,0,0
"Germany","2024-10-13",0,0,132,0,1,152,0,0
"Germany","2024-10-14",0,0,132,0,2,154,0,0
"Germany","2024-10-15",0,0,132,0,1,155,0,0
"Germany","2024-10-16",0,0,132,0,2,157,0,0
"Germany","2024-10-17",0,0,132,0,1,158,0,0
"Germany","2024-10-18",0,0,132,0,2,160,0,0
"Germany","2024-10-19",0,0,132,0,1,161,0,0
"Germany","2024-10-20",0,0,132,0,2,163,0,0
"Germany","2024-10-21",0,0,132,0,2,165,0,0
"Germany","2024-10-22",0,0,132,0,1,166,0,0
"Germany","2024-10-23",0,0,132,0,2,168,0,0
"Germany","2024-10-24",0,0,132,0,1,169,0,0
"Germany","2024-10-25",0,0,132,0,2,171,0,0
"Germany","2024-10-26",0,0,132,0,1,172,0,0
"Germany","2024-10-27",0,0,132,0,2,174,0,0
"Germany","2024-10-28",0,0,132,0,1,175,0,0
"Germany","2024-10-29",0,0,132,0,2,177,0,0
"Germany","2024-10-30",0,0,132,0,1,178,0,0
"Germany","2024-10-31",0,48,180,0,2,180,0,0
"Germany","2024-11-01",0,0,180,0,2,182,0,0
"Germany","2024-11-02",0,0,180,0,2,184,0,0
"Germany","2024-11-03",0,0,180,0,2,186,0,0
"Germany","2024-11-04",0,0,180,0,2,188,0,0
"Germany","2024-11-05",0,0,180,0,2,190,0,0
"Germany","2024-11-06",0,0,180,0,2,192,0,0
"Germany","2024-11-07",0,0,180,0,2,194,0,0
"Germany","2024-11-08",0,0,180,0,2,196,0,0
"Germany","2024-11-09",0,0,180,0,2,198,0,0
"Germany","2024-11-10",0,0,180,0,2,200,0,0
"Germany","2024-11-11",0,0,180,0,2,202,0,0
"Germany","2024-11-12",0,0,180,0,2,204,0,0
"Germany","2024-11-13",0,0,180,0,2,206,0,0
"Germany","2024-11-14",0,0,180,0,2,208,0,0
"Germany","2024-11-15",0,0,180,0,2,210,0,0
"Germany","2024-11-16",0,0,180,0,2,212,0,0
"Germany","2024-11-17",0,0,180,0,2,214,0,0
"Germany","2024-11-18",0,0,180,0,2,216,0,0
"Germany","2024-11-19",0,0,180,0,2,218,0,0
"Germany","2024-11-20",0,0,180,0,2,220,0,0
"Germany","2024-11-21",0,0,180,0,2,222,0,0
"Germany","2024-11-22",0,0,180,0,2,224,0,0
"Germany","2024-11-23",0,0,180,0,2,226,0,0
"Germany","2024-11-24",0,0,180,0,2,228,0,0
"Germany","2024-11-25",0,0,180,0,2,230,0,0
"Germany","2024-11-26",0,0,180,0,2,232,0,0
"Germany","2024-11-27",0,0,180,0,2,234,0,0
"Germany","2024-11-28",0,0,180,0,2,236,0,0
"Germany","2024-11-29",0,0,180,0,2,238,0,0
"Germany","2024-11-30",0,60,240,0,2,240,0,0
"Germany","2024-12-01",0,0,240,0,2,242,0,0
"Germany","2024-12-02",0,0,240,0,1,243,0,0
"Germany","2024-12-03",0,0,240,0,2,245,0,0
"Germany","2024-12-04",0,0,240,0,1,246,0,0
"Germany","2024-12-05",0,0,240,0,2,248,0,0
"Germany","2024-12-06",0,0,240,0,2,250,0,0
"Germany","2024-12-07",0,0,240,0,1,251,0,0
"Germany","2024-12-08",0,0,240,0,2,253,0,0
"Germany","2024-12-09",0,0,240,0,2,255,0,0
"Germany","2024-12-10",0,0,240,0,1,256,0,0
"Germany","2024-12-11",0,0,240,0,2,258,0,0
"Germany","2024-12-12",0,0,240,0,1,259,0,0
"Germany","2024-12-13",0,0,240,0,2,261,0,0
"Germany","2024-12-14",0,0,240,0,2,263,0,0
"Germany","2024-12-15",0,0,240,0,1,264,0,0
"Germany","2024-12-16",0,0,240,0,2,266,0,0
"Germany","2024-12-17",0,0,240,0,1,267,0,0
"Germany","2024-12-18",0,0,240,0,2,269,0,0
"Germany","2024-12-19",0,0,240,0,2,271,0,0
"Germany","2024-12-20",0,0,240,0,1,272,0,0
"Germany","2024-12-21",0,0,240,0,2,274,0,0
"Germany","2024-12-22",0,0,240,0,1,275,0,0
"Germany","2024-12-23",0,0,240,0,2,277,0,0
"Germany","2024-12-24",0,0,240,0,2,279,0,0
"Germany","2024-12-25",0,0,240,0,1,280,0,0
"Germany","2024-12-26",0,0,240,0,2,282,0,0
"Germany","2024-12-27",0,0,240,0,2,284,0,0
"Germany","2024-12-28",0,0,240,0,1,285,0,0
"Germany","2024-12-29",0,0,240,0,2,287,0,0
"Germany","2024-12-30",0,0,240,0,1,288,0,0
"Germany","2024-12-31",0,50,290,0,2,290,0,0
"Germany","2025-01-01",0,0,290,0,5,295,0,0
"Germany","2025-01-02",0,0,290,0,5,300,0,0
"Germany","2025-01-03",0,0,290,0,5,305,0,0
"Germany","2025-01-04",0,0,290,0,5,310,0,0
"Germany","2025-01-05",0,0,290,0,4,314,0,0
"Germany","2025-01-06",0,0,290,0,5,319,0,0
"Germany","2025-01-07",0,0,290,0,5,324,0,0
"Germany","2025-01-08",0,0,290,0,5,329,0,0
"Germany","2025-01-09",0,0,290,0,5,334,0,0
"Germany","2025-01-10",0,49,339,0,5,339,0,0
"Germany","2025-01-11",0,0,339,0,0,339,0,0
"Germany","2025-01-12",0,0,339,0,0,339,0,0
"Germany","2025-01-13",0,0,339,0,0,339,0,0
"Germany","2025-01-14",0,0,339,0,0,339,0,0
"Germany","2025-01-15",0,0,339,0,0,339,0,0
"Germany","2025-01-16",0,0,339,0,0,339,0,0
"Germany","2025-01-17",0,0,339,0,0,339,0,0
"Germany","2025-01-18",0,0,339,0,0,339,0,0
"Germany","2025-01-19",0,0,339,0,0,339,0,0
"Germany","2025-01-20",0,0,339,0,0,339,0,0
"Germany","2025-01-21",0,0,339,0,0,339,0,0
"Germany","2025-01-22",0,0,339,0,0,339,0,0
"Germany","2025-01-23",0,0,339,0,0,339,0,0
"Germany","2025-01-24",0,0,339,0,0,339,0,0
"Germany","2025-01-25",0,0,339,0,0,339,0,0
"Germany","2025-01-26",0,0,339,0,0,339,0,0
"Germany","2025-01-27",0,0,339,0,0,339,0,0
"Germany","2025-01-28",0,0,339,0,0,339,0,0
"Germany","2025-01-29",0,0,339,0,0,339,0,0
"Germany","2025-01-30",0,0,339,0,0,339,0,0
"Germany","2025-01-31",0,0,339,0,0,339,0,0
"Germany","2025-02-01",0,0,339,0,0,339,0,0
"Germany","2025-02-02",0,0,339,0,0,339,0,0
"Germany","2025-02-03",0,0,339,0,0,339,0,0
"Germany","2025-02-04",0,0,339,0,0,339,0,0
"Germany","2025-02-05",0,0,339,0,0,339,0,0
"Germany","2025-02-06",0,0,339,0,0,339,0,0
"Germany","2025-02-07",0,0,339,0,0,339,0,0
"Germany","2025-02-08",0,0,339,0,0,339,0,0
"Germany","2025-02-09",0,0,339,0,0,339,0,0
"Germany","2025-02-10",0,0,339,0,0,339,0,0
"Germany","2025-02-11",0,0,339,0,0,339,0,0
"Germany","2025-02-12",0,0,339,0,0,339,0,0
"Germany","2025-02-13",0,0,339,0,0,339,0,0
"Germany","2025-02-14",0,0,339,0,0,339,0,0
"Germany","2025-02-15",0,0,339,0,0,339,0,0
"Germany","2025-02-16",0,0,339,0,0,339,0,0
"Germany","2025-02-17",0,0,339,0,0,339,0,0
"Germany","2025-02-18",0,0,339,0,0,339,0,0
"Germany","2025-02-19",0,0,339,0,0,339,0,0
"Germany","2025-02-20",0,0,339,0,0,339,0,0
"Germany","2025-02-21",0,0,339,0,0,339,0,0
"Germany","2025-02-22",0,0,339,0,0,339,0,0
"Germany","2025-02-23",0,0,339,0,0,339,0,0
"Germany","2025-02-24",0,0,339,0,0,339,0,0
"Germany","2025-02-25",0,0,339,0,0,339,0,0
"Germany","2025-02-26",0,0,339,0,0,339,0,0
"Germany","2025-02-27",0,0,339,0,0,339,0,0
"Germany","2025-02-28",0,0,339,0,0,339,0,0
"Germany","2025-03-01",0,0,339,0,0,339,0,0
"Germany","2025-03-02",0,0,339,0,0,339,0,0
"Germany","2025-03-03",0,0,339,0,0,339,0,0
"Ghana","2024-01-01",0,0,0,0,0,0,0,0
"Ghana","2024-01-02",0,0,0,0,0,0,0,0
"Ghana","2024-01-03",0,0,0,0,0,0,0,0
"Ghana","2024-01-04",0,0,0,0,0,0,0,0
"Ghana","2024-01-05",0,0,0,0,0,0,0,0
"Ghana","2024-01-06",0,0,0,0,0,0,0,0
"Ghana","2024-01-07",0,0,0,0,0,0,0,0
"Ghana","2024-01-08",0,0,0,0,0,0,0,0
"Ghana","2024-01-09",0,0,0,0,0,0,0,0
"Ghana","2024-01-10",0,0,0,0,0,0,0,0
"Ghana","2024-01-11",0,0,0,0,0,0,0,0
"Ghana","2024-01-12",0,0,0,0,0,0,0,0
"Ghana","2024-01-13",0,0,0,0,0,0,0,0
"Ghana","2024-01-14",0,0,0,0,0,0,0,0
"Ghana","2024-01-15",0,0,0,0,0,0,0,0
"Ghana","2024-01-16",0,0,0,0,0,0,0,0
"Ghana","2024-01-17",0,0,0,0,0,0,0,0
"Ghana","2024-01-18",0,0,0,0,0,0,0,0
"Ghana","2024-01-19",0,0,0,0,0,0,0,0
"Ghana","2024-01-20",0,0,0,0,0,0,0,0
"Ghana","2024-01-21",0,0,0,0,0,0,0,0
"Ghana","2024-01-22",0,0,0,0,0,0,0,0
"Ghana","2024-01-23",0,0,0,0,0,0,0,0
"Ghana","2024-01-24",0,0,0,0,0,0,0,0
"Ghana","2024-01-25",0,0,0,0,0,0,0,0
"Ghana","2024-01-26",0,0,0,0,0,0,0,0
"Ghana","2024-01-27",0,0,0,0,0,0,0,0
"Ghana","2024-01-28",0,0,0,0,0,0,0,0
"Ghana","2024-01-29",0,0,0,0,0,0,0,0
"Ghana","2024-01-30",0,0,0,0,0,0,0,0
"Ghana","2024-01-31",0,0,0,0,0,0,0,0
"Ghana","2024-02-01",0,0,0,0,0,0,0,0
"Ghana","2024-02-02",0,0,0,0,0,0,0,0
"Ghana","2024-02-03",0,0,0,0,0,0,0,0
"Ghana","2024-02-04",0,0,0,0,0,0,0,0
"Ghana","2024-02-05",0,0,0,0,0,0,0,0
"Ghana","2024-02-06",0,0,0,0,0,0,0,0
"Ghana","2024-02-07",0,0,0,0,0,0,0,0
"Ghana","2024-02-08",0,0,0,0,0,0,0,0
"Ghana","2024-02-09",0,0,0,0,0,0,0,0
"Ghana","2024-02-10",0,0,0,0,0,0,0,0
"Ghana","2024-02-11",0,0,0,0,0,0,0,0
"Ghana","2024-02-12",0,0,0,0,0,0,0,0
"Ghana","2024-02-13",0,0,0,0,0,0,0,0
"Ghana","2024-02-14",0,0,0,0,0,0,0,0
"Ghana","2024-02-15",0,0,0,0,0,0,0,0
"Ghana","2024-02-16",0,0,0,0,0,0,0,0
"Ghana","2024-02-17",0,0,0,0,0,0,0,0
"Ghana","2024-02-18",0,0,0,0,0,0,0,0
"Ghana","2024-02-19",0,0,0,0,0,0,0,0
"Ghana","2024-02-20",0,0,0,0,0,0,0,0
"Ghana","2024-02-21",0,0,0,0,0,0,0,0
"Ghana","2024-02-22",0,0,0,0,0,0,0,0
"Ghana","2024-02-23",0,0,0,0,0,0,0,0
"Ghana","2024-02-24",0,0,0,0,0,0,0,0
"Ghana","2024-02-25",0,0,0,0,0,0,0,0
"Ghana","2024-02-26",0,0,0,0,0,0,0,0
"Ghana","2024-02-27",0,0,0,0,0,0,0,0
"Ghana","2024-02-28",0,0,0,0,0,0,0,0
"Ghana","2024-02-29",0,0,0,0,0,0,0,0
"Ghana","2024-03-01",0,0,0,0,0,0,0,0
"Ghana","2024-03-02",0,0,0,0,0,0,0,0
"Ghana","2024-03-03",0,0,0,0,0,0,0,0
"Ghana","2024-03-04",0,0,0,0,0,0,0,0
"Ghana","2024-03-05",0,0,0,0,0,0,0,0
"Ghana","2024-03-06",0,0,0,0,0,0,0,0
"Ghana","2024-03-07",0,0,0,0,0,0,0,0
"Ghana","2024-03-08",0,0,0,0,0,0,0,0
"Ghana","2024-03-09",0,0,0,0,0,0,0,0
"Ghana","2024-03-10",0,0,0,0,0,0,0,0
"Ghana","2024-03-11",0,0,0,0,0,0,0,0
"Ghana","2024-03-12",0,0,0,0,0,0,0,0
"Ghana","2024-03-13",0,0,0,0,0,0,0,0
"Ghana","2024-03-14",0,0,0,0,0,0,0,0
"Ghana","2024-03-15",0,0,0,0,0,0,0,0
"Ghana","2024-03-16",0,0,0,0,0,0,0,0
"Ghana","2024-03-17",0,0,0,0,0,0,0,0
"Ghana","2024-03-18",0,0,0,0,0,0,0,0
"Ghana","2024-03-19",0,0,0,0,0,0,0,0
"Ghana","2024-03-20",0,0,0,0,0,0,0,0
"Ghana","2024-03-21",0,0,0,0,0,0,0,0
"Ghana","2024-03-22",0,0,0,0,0,0,0,0
"Ghana","2024-03-23",0,0,0,0,0,0,0,0
"Ghana","2024-03-24",0,0,0,0,0,0,0,0
"Ghana","2024-03-25",0,0,0,0,0,0,0,0
"Ghana","2024-03-26",0,0,0,0,0,0,0,0
"Ghana","2024-03-27",0,0,0,0,0,0,0,0
"Ghana","2024-03-28",0,0,0,0,0,0,0,0
"Ghana","2024-03-29",0,0,0,0,0,0,0,0
"Ghana","2024-03-30",0,0,0,0,0,0,0,0
"Ghana","2024-03-31",0,0,0,0,0,0,0,0
"Ghana","2024-04-01",0,0,0,0,0,0,0,0
"Ghana","2024-04-02",0,0,0,0,0,0,0,0
"Ghana","2024-04-03",0,0,0,0,0,0,0,0
"Ghana","2024-04-04",0,0,0,0,0,0,0,0
"Ghana","2024-04-05",0,0,0,0,0,0,0,0
"Ghana","2024-04-06",0,0,0,0,0,0,0,0
"Ghana","2024-04-07",0,0,0,0,0,0,0,0
"Ghana","2024-04-08",0,0,0,0,0,0,0,0
"Ghana","2024-04-09",0,0,0,0,0,0,0,0
"Ghana","2024-04-10",0,0,0,0,0,0,0,0
"Ghana","2024-04-11",0,0,0,0,0,0,0,0
"Ghana","2024-04-12",0,0,0,0,0,0,0,0
"Ghana","2024-04-13",0,0,0,0,0,0,0,0
"Ghana","2024-04-14",0,0,0,0,0,0,0,0
"Ghana","2024-04-15",0,0,0,0,0,0,0,0
"Ghana","2024-04-16",0,0,0,0,0,0,0,0
"Ghana","2024-04-17",0,0,0,0,0,0,0,0
"Ghana","2024-04-18",0,0,0,0,0,0,0,0
"Ghana","2024-04-19",0,0,0,0,0,0,0,0
"Ghana","2024-04-20",0,0,0,0,0,0,0,0
"Ghana","2024-04-21",0,0,0,0,0,0,0,0
"Ghana","2024-04-22",0,0,0,0,0,0,0,0
"Ghana","2024-04-23",0,0,0,0,0,0,0,0
"Ghana","2024-04-24",0,0,0,0,0,0,0,0
"Ghana","2024-04-25",0,0,0,0,0,0,0,0
"Ghana","2024-04-26",0,0,0,0,0,0,0,0
"Ghana","2024-04-27",0,0,0,0,0,0,0,0
"Ghana","2024-04-28",0,0,0,0,0,0,0,0
"Ghana","2024-04-29",0,0,0,0,0,0,0,0
"Ghana","2024-04-30",0,0,0,0,0,0,0,0
"Ghana","2024-05-01",0,0,0,0,0,0,0,0
"Ghana","2024-05-02",0,0,0,0,0,0,0,0
"Ghana","2024-05-03",0,0,0,0,0,0,0,0
"Ghana","2024-05-04",0,0,0,0,0,0,0,0
"Ghana","2024-05-05",0,0,0,0,0,0,0,0
"Ghana","2024-05-06",0,0,0,0,0,0,0,0
"Ghana","2024-05-07",0,0,0,0,0,0,0,0
"Ghana","2024-05-08",0,0,0,0,0,0,0,0
"Ghana","2024-05-09",0,0,0,0,0,0,0,0
"Ghana","2024-05-10",0,0,0,0,0,0,0,0
"Ghana","2024-05-11",0,0,0,0,0,0,0,0
"Ghana","2024-05-12",0,0,0,0,0,0,0,0
"Ghana","2024-05-13",0,0,0,0,0,0,0,0
"Ghana","2024-05-14",0,0,0,0,0,0,0,0
"Ghana","2024-05-15",0,0,0,0,0,0,0,0
"Ghana","2024-05-16",0,0,0,0,0,0,0,0
"Ghana","2024-05-17",0,0,0,0,0,0,0,0
"Ghana","2024-05-18",0,0,0,0,0,0,0,0
"Ghana","2024-05-19",0,0,0,0,0,0,0,0
"Ghana","2024-05-20",0,0,0,0,0,0,0,0
"Ghana","2024-05-21",0,0,0,0,0,0,0,0
"Ghana","2024-05-22",0,0,0,0,0,0,0,0
"Ghana","2024-05-23",0,0,0,0,0,0,0,0
"Ghana","2024-05-24",0,0,0,0,0,0,0,0
"Ghana","2024-05-25",0,0,0,0,0,0,0,0
"Ghana","2024-05-26",0,0,0,0,0,0,0,0
"Ghana","2024-05-27",0,0,0,0,0,0,0,0
"Ghana","2024-05-28",0,0,0,0,0,0,0,0
"Ghana","2024-05-29",0,0,0,0,0,0,0,0
"Ghana","2024-05-30",0,0,0,0,0,0,0,0
"Ghana","2024-05-31",0,0,0,0,0,0,0,0
"Ghana","2024-06-01",0,0,0,0,0,0,0,0
"Ghana","2024-06-02",0,0,0,0,0,0,0,0
"Ghana","2024-06-03",0,0,0,0,0,0,0,0
"Ghana","2024-06-04",0,0,0,0,0,0,0,0
"Ghana","2024-06-05",0,0,0,0,0,0,0,0
"Ghana","2024-06-06",0,0,0,0,0,0,0,0
"Ghana","2024-06-07",0,0,0,0,0,0,0,0
"Ghana","2024-06-08",0,0,0,0,0,0,0,0
"Ghana","2024-06-09",0,0,0,0,0,0,0,0
"Ghana","2024-06-10",0,0,0,0,0,0,0,0
"Ghana","2024-06-11",0,0,0,0,0,0,0,0
"Ghana","2024-06-12",0,0,0,0,0,0,0,0
"Ghana","2024-06-13",0,0,0,0,0,0,0,0
"Ghana","2024-06-14",0,0,0,0,0,0,0,0
"Ghana","2024-06-15",0,0,0,0,0,0,0,0
"Ghana","2024-06-16",0,0,0,0,0,0,0,0
"Ghana","2024-06-17",0,0,0,0,0,0,0,0
"Ghana","2024-06-18",0,0,0,0,0,0,0,0
"Ghana","2024-06-19",0,0,0,0,0,0,0,0
"Ghana","2024-06-20",0,0,0,0,0,0,0,0
"Ghana","2024-06-21",0,0,0,0,0,0,0,0
"Ghana","2024-06-22",0,0,0,0,0,0,0,0
"Ghana","2024-06-23",0,0,0,0,0,0,0,0
"Ghana","2024-06-24",0,0,0,0,0,0,0,0
"Ghana","2024-06-25",0,0,0,0,0,0,0,0
"Ghana","2024-06-26",0,0,0,0,0,0,0,0
"Ghana","2024-06-27",0,0,0,0,0,0,0,0
"Ghana","2024-06-28",0,0,0,0,0,0,0,0
"Ghana","2024-06-29",0,0,0,0,0,0,0,0
"Ghana","2024-06-30",0,0,0,0,0,0,0,0
"Ghana","2024-07-01",0,0,0,0,0,0,0,0
"Ghana","2024-07-02",0,0,0,0,0,0,0,0
"Ghana","2024-07-03",0,0,0,0,0,0,0,0
"Ghana","2024-07-04",0,0,0,0,0,0,0,0
"Ghana","2024-07-05",0,0,0,0,0,0,0,0
"Ghana","2024-07-06",0,0,0,0,0,0,0,0
"Ghana","2024-07-07",0,0,0,0,0,0,0,0
"Ghana","2024-07-08",0,0,0,0,0,0,0,0
"Ghana","2024-07-09",0,0,0,0,0,0,0,0
"Ghana","2024-07-10",0,0,0,0,0,0,0,0
"Ghana","2024-07-11",0,0,0,0,0,0,0,0
"Ghana","2024-07-12",0,0,0,0,0,0,0,0
"Ghana","2024-07-13",0,0,0,0,0,0,0,0
"Ghana","2024-07-14",0,0,0,0,0,0,0,0
"Ghana","2024-07-15",0,0,0,0,0,0,0,0
"Ghana","2024-07-16",0,0,0,0,0,0,0,0
"Ghana","2024-07-17",0,0,0,0,0,0,0,0
"Ghana","2024-07-18",0,0,0,0,0,0,0,0
"Ghana","2024-07-19",0,0,0,0,0,0,0,0
"Ghana","2024-07-20",0,0,0,0,0,0,0,0
"Ghana","2024-07-21",0,0,0,0,0,0,0,0
"Ghana","2024-07-22",0,0,0,0,0,0,0,0
"Ghana","2024-07-23",0,0,0,0,0,0,0,0
"Ghana","2024-07-24",0,0,0,0,0,0,0,0
"Ghana","2024-07-25",0,0,0,0,0,0,0,0
"Ghana","2024-07-26",0,0,0,0,0,0,0,0
"Ghana","2024-07-27",0,0,0,0,0,0,0,0
"Ghana","2024-07-28",0,0,0,0,0,0,0,0
"Ghana","2024-07-29",0,0,0,0,0,0,0,0
"Ghana","2024-07-30",0,0,0,0,0,0,0,0
"Ghana","2024-07-31",0,0,0,0,0,0,0,0
"Ghana","2024-08-01",0,0,0,0,0,0,0,0
"Ghana","2024-08-02",0,0,0,0,0,0,0,0
"Ghana","2024-08-03",0,0,0,0,0,0,0,0
"Ghana","2024-08-04",0,0,0,0,0,0,0,0
"Ghana","2024-08-05",0,0,0,0,0,0,0,0
"Ghana","2024-08-06",0,0,0,0,0,0,0,0
"Ghana","2024-08-07",0,0,0,0,0,0,0,0
"Ghana","2024-08-08",0,0,0,0,0,0,0,0
"Ghana","2024-08-09",0,0,0,0,0,0,0,0
"Ghana","2024-08-10",0,0,0,0,0,0,0,0
"Ghana","2024-08-11",0,0,0,0,0,0,0,0
"Ghana","2024-08-12",0,0,0,0,0,0,0,0
"Ghana","2024-08-13",0,0,0,0,0,0,0,0
"Ghana","2024-08-14",0,0,0,0,0,0,0,0
"Ghana","2024-08-15",0,0,0,0,0,0,0,0
"Ghana","2024-08-16",0,0,0,0,0,0,0,0
"Ghana","2024-08-17",0,0,0,0,0,0,0,0
"Ghana","2024-08-18",0,0,0,0,0,0,0,0
"Ghana","2024-08-19",0,0,0,0,0,0,0,0
"Ghana","2024-08-20",0,0,0,0,0,0,0,0
"Ghana","2024-08-21",0,0,0,0,0,0,0,0
"Ghana","2024-08-22",0,0,0,0,0,0,0,0
"Ghana","2024-08-23",0,0,0,0,0,0,0,0
"Ghana","2024-08-24",0,0,0,0,0,0,0,0
"Ghana","2024-08-25",0,0,0,0,0,0,0,0
"Ghana","2024-08-26",0,0,0,0,0,0,0,0
"Ghana","2024-08-27",0,0,0,0,0,0,0,0
"Ghana","2024-08-28",0,0,0,0,0,0,0,0
"Ghana","2024-08-29",0,0,0,0,0,0,0,0
"Ghana","2024-08-30",0,0,0,0,0,0,0,0
"Ghana","2024-08-31",0,0,0,0,0,0,0,0
"Ghana","2024-09-01",0,0,0,0,0,0,0,0
"Ghana","2024-09-02",0,0,0,0,0,0,0,0
"Ghana","2024-09-03",0,0,0,0,0,0,0,0
"Ghana","2024-09-04",0,0,0,0,0,0,0,0
"Ghana","2024-09-05",0,0,0,0,0,0,0,0
"Ghana","2024-09-06",0,0,0,0,0,0,0,0
"Ghana","2024-09-07",0,0,0,0,0,0,0,0
"Ghana","2024-09-08",0,0,0,0,0,0,0,0
"Ghana","2024-09-09",0,0,0,0,0,0,0,0
"Ghana","2024-09-10",0,0,0,0,0,0,0,0
"Ghana","2024-09-11",0,0,0,0,0,0,0,0
"Ghana","2024-09-12",0,0,0,0,0,0,0,0
"Ghana","2024-09-13",0,0,0,0,0,0,0,0
"Ghana","2024-09-14",0,0,0,0,0,0,0,0
"Ghana","2024-09-15",0,0,0,0,0,0,0,0
"Ghana","2024-09-16",0,0,0,0,0,0,0,0
"Ghana","2024-09-17",0,0,0,0,0,0,0,0
"Ghana","2024-09-18",0,0,0,0,0,0,0,0
"Ghana","2024-09-19",0,0,0,0,0,0,0,0
"Ghana","2024-09-20",0,0,0,0,0,0,0,0
"Ghana","2024-09-21",0,0,0,0,0,0,0,0
"Ghana","2024-09-22",0,1,1,0,1,1,0,0
"Ghana","2024-09-23",0,0,1,0,0,1,0,0
"Ghana","2024-09-24",0,0,1,0,0,1,0,0
"Ghana","2024-09-25",0,0,1,0,0,1,0,0
"Ghana","2024-09-26",0,0,1,0,1,2,0,0
"Ghana","2024-09-27",0,0,1,0,0,2,0,0
"Ghana","2024-09-28",0,0,1,0,0,2,0,0
"Ghana","2024-09-29",0,1,2,0,0,2,0,0
"Ghana","2024-09-30",0,0,2,0,0,2,0,0
"Ghana","2024-10-01",0,0,2,0,0,2,0,0
"Ghana","2024-10-02",0,0,2,0,0,2,0,0
"Ghana","2024-10-03",0,0,2,0,0,2,0,0
"Ghana","2024-10-04",0,0,2,0,0,2,0,0
"Ghana","2024-10-05",0,0,2,0,0,2,0,0
"Ghana","2024-10-06",0,0,2,0,0,2,0,0
"Ghana","2024-10-07",0,0,2,0,0,2,0,0
"Ghana","2024-10-08",0,0,2,0,0,2,0,0
"Ghana","2024-10-09",0,0,2,0,0,2,0,0
"Ghana","2024-10-10",0,0,2,0,0,2,0,0
"Ghana","2024-10-11",0,0,2,0,0,2,0,0
"Ghana","2024-10-12",0,0,2,0,0,2,0,0
"Ghana","2024-10-13",0,0,2,0,0,2,0,0
"Ghana","2024-10-14",0,0,2,0,1,3,0,0
"Ghana","2024-10-15",0,0,2,0,0,3,0,0
"Ghana","2024-10-16",0,0,2,0,0,3,0,0
"Ghana","2024-10-17",0,0,2,0,0,3,0,0
"Ghana","2024-10-18",0,0,2,0,0,3,0,0
"Ghana","2024-10-19",0,0,2,0,0,3,0,0
"Ghana","2024-10-20",0,0,2,0,0,3,0,0
"Ghana","2024-10-21",0,0,2,0,0,3,0,0
"Ghana","2024-10-22",0,0,2,0,0,3,0,0
"Ghana","2024-10-23",0,0,2,0,0,3,0,0
"Ghana","2024-10-24",0,0,2,0,0,3,0,0
"Ghana","2024-10-25",0,0,2,0,0,3,0,0
"Ghana","2024-10-26",0,0,2,0,0,3,0,0
"Ghana","2024-10-27",0,1,3,0,0,3,0,0
"Ghana","2024-10-28",0,0,3,0,0,3,0,0
"Ghana","2024-10-29",0,0,3,0,0,3,0,0
"Ghana","2024-10-30",0,0,3,0,0,3,0,0
"Ghana","2024-10-31",0,0,3,0,0,3,0,0
"Ghana","2024-11-01",0,0,3,0,0,3,0,0
"Ghana","2024-11-02",0,0,3,0,0,3,0,0
"Ghana","2024-11-03",0,0,3,0,0,3,0,0
"Ghana","2024-11-04",0,0,3,0,0,3,0,0
"Ghana","2024-11-05",0,0,3,0,0,3,0,0
"Ghana","2024-11-06",0,0,3,0,0,3,0,0
"Ghana","2024-11-07",0,0,3,0,1,4,0,0
"Ghana","2024-11-08",0,0,3,0,0,4,0,0
"Ghana","2024-11-09",0,0,3,0,0,4,0,0
"Ghana","2024-11-10",0,0,3,0,0,4,0,0
"Ghana","2024-11-11",0,0,3,0,0,4,0,0
"Ghana","2024-11-12",0,0,3,0,0,4,0,0
"Ghana","2024-11-13",0,0,3,0,0,4,0,0
"Ghana","2024-11-14",0,0,3,0,0,4,0,0
"Ghana","2024-11-15",0,0,3,0,0,4,0,0
"Ghana","2024-11-16",0,0,3,0,0,4,0,0
"Ghana","2024-11-17",0,1,4,0,0,4,0,0
"Ghana","2024-11-18",0,0,4,0,0,4,0,0
"Ghana","2024-11-19",0,0,4,0,0,4,0,0
"Ghana","2024-11-20",0,0,4,0,0,4,0,0
"Ghana","2024-11-21",0,0,4,0,1,5,0,0
"Ghana","2024-11-22",0,0,4,0,0,5,0,0
"Ghana","2024-11-23",0,0,4,0,0,5,0,0
"Ghana","2024-11-24",0,1,5,0,0,5,0,0
"Ghana","2024-11-25",0,0,5,0,0,5,0,0
"Ghana","2024-11-26",0,0,5,0,0,5,0,0
"Ghana","2024-11-27",0,0,5,0,0,5,0,0
"Ghana","2024-11-28",0,0,5,0,0,5,0,0
"Ghana","2024-11-29",0,0,5,0,0,5,0,0
"Ghana","2024-11-30",0,0,5,0,0,5,0,0
"Ghana","2024-12-01",0,0,5,0,0,5,0,0
"Ghana","2024-12-02",0,0,5,0,0,5,0,0
"Ghana","2024-12-03",0,0,5,0,0,5,0,0
"Ghana","2024-12-04",0,0,5,0,0,5,0,0
"Ghana","2024-12-05",0,0,5,0,0,5,0,0
"Ghana","2024-12-06",0,0,5,0,0,5,0,0
"Ghana","2024-12-07",0,0,5,0,0,5,0,0
"Ghana","2024-12-08",0,0,5,0,0,5,0,0
"Ghana","2024-12-09",0,0,5,0,0,5,0,0
"Ghana","2024-12-10",0,0,5,0,0,5,0,0
"Ghana","2024-12-11",0,0,5,0,0,5,0,0
"Ghana","2024-12-12",0,0,5,0,0,5,0,0
"Ghana","2024-12-13",0,0,5,0,0,5,0,0
"Ghana","2024-12-14",0,0,5,0,0,5,0,0
"Ghana","2024-12-15",0,0,5,0,0,5,0,0
"Ghana","2024-12-16",0,0,5,0,0,5,0,0
"Ghana","2024-12-17",0,0,5,0,0,5,0,0
"Ghana","2024-12-18",0,0,5,0,0,5,0,0
"Ghana","2024-12-19",0,0,5,0,0,5,0,0
"Ghana","2024-12-20",0,0,5,0,0,5,0,0
"Ghana","2024-12-21",0,0,5,0,0,5,0,0
"Ghana","2024-12-22",0,0,5,0,0,5,0,0
"Ghana","2024-12-23",0,0,5,0,0,5,0,0
"Ghana","2024-12-24",0,0,5,0,0,5,0,0
"Ghana","2024-12-25",0,0,5,0,0,5,0,0
"Ghana","2024-12-26",0,0,5,0,0,5,0,0
"Ghana","2024-12-27",0,0,5,0,0,5,0,0
"Ghana","2024-12-28",0,0,5,0,0,5,0,0
"Ghana","2024-12-29",0,0,5,0,0,5,0,0
"Ghana","2024-12-30",0,0,5,0,0,5,0,0
"Ghana","2024-12-31",0,0,5,0,0,5,0,0
"Ghana","2025-01-01",0,0,5,0,0,5,0,0
"Ghana","2025-01-02",0,0,5,0,0,5,0,0
"Ghana","2025-01-03",0,0,5,0,0,5,0,0
"Ghana","2025-01-04",0,0,5,0,0,5,0,0
"Ghana","2025-01-05",0,0,5,0,0,5,0,0
"Ghana","2025-01-06",0,0,5,0,0,5,0,0
"Ghana","2025-01-07",0,0,5,0,0,5,0,0
"Ghana","2025-01-08",0,0,5,0,0,5,0,0
"Ghana","2025-01-09",0,0,5,0,0,5,0,0
"Ghana","2025-01-10",0,0,5,0,0,5,0,0
"Ghana","2025-01-11",0,0,5,0,0,5,0,0
"Ghana","2025-01-12",0,0,5,0,0,5,0,0
"Ghana","2025-01-13",0,0,5,0,0,5,0,0
"Ghana","2025-01-14",0,0,5,0,0,5,0,0
"Ghana","2025-01-15",0,0,5,0,0,5,0,0
"Ghana","2025-01-16",0,0,5,0,0,5,0,0
"Ghana","2025-01-17",0,0,5,0,0,5,0,0
"Ghana","2025-01-18",0,0,5,0,0,5,0,0
"Ghana","2025-01-19",0,0,5,0,0,5,0,0
"Ghana","2025-01-20",0,0,5,0,0,5,0,0
"Ghana","2025-01-21",0,0,5,0,0,5,0,0
"Ghana","2025-01-22",0,0,5,0,0,5,0,0
"Ghana","2025-01-23",0,0,5,0,0,5,0,0
"Ghana","2025-01-24",0,0,5,0,0,5,0,0
"Ghana","2025-01-25",0,0,5,0,0,5,0,0
"Ghana","2025-01-26",0,0,5,0,0,5,0,0
"Ghana","2025-01-27",0,0,5,0,0,5,0,0
"Ghana","2025-01-28",0,0,5,0,0,5,0,0
"Ghana","2025-01-29",0,0,5,0,0,5,0,0
"Ghana","2025-01-30",0,0,5,0,0,5,0,0
"Ghana","2025-01-31",0,0,5,0,0,5,0,0
"Ghana","2025-02-01",0,0,5,0,0,5,0,0
"Ghana","2025-02-02",0,0,5,0,0,5,0,0
"Ghana","2025-02-03",0,0,5,0,0,5,0,0
"Ghana","2025-02-04",0,0,5,0,0,5,0,0
"Ghana","2025-02-05",0,0,5,0,0,5,0,0
"Ghana","2025-02-06",0,0,5,0,0,5,0,0
"Ghana","2025-02-07",0,0,5,0,0,5,0,0
"Ghana","2025-02-08",0,0,5,0,0,5,0,0
"Ghana","2025-02-09",0,0,5,0,0,5,0,0
"Ghana","2025-02-10",0,0,5,0,0,5,0,0
"Ghana","2025-02-11",0,0,5,0,0,5,0,0
"Ghana","2025-02-12",0,0,5,0,0,5,0,0
"Ghana","2025-02-13",0,0,5,0,0,5,0,0
"Ghana","2025-02-14",0,0,5,0,0,5,0,0
"Ghana","2025-02-15",0,0,5,0,0,5,0,0
"Ghana","2025-02-16",0,0,5,0,0,5,0,0
"Ghana","2025-02-17",0,0,5,0,0,5,0,0
"Ghana","2025-02-18",0,0,5,0,0,5,0,0
"Ghana","2025-02-19",0,0,5,0,0,5,0,0
"Ghana","2025-02-20",0,0,5,0,0,5,0,0
"Ghana","2025-02-21",0,0,5,0,0,5,0,0
"Ghana","2025-02-22",0,0,5,0,0,5,0,0
"Ghana","2025-02-23",0,0,5,0,0,5,0,0
"Ghana","2025-02-24",0,0,5,0,0,5,0,0
"Ghana","2025-02-25",0,0,5,0,0,5,0,0
"Ghana","2025-02-26",0,0,5,0,0,5,0,0
"Ghana","2025-02-27",0,0,5,0,0,5,0,0
"Ghana","2025-02-28",0,0,5,0,0,5,0,0
"Ghana","2025-03-01",0,0,5,0,0,5,0,0
"Ghana","2025-03-02",0,0,5,0,0,5,0,0
"Ghana","2025-03-03",0,0,5,0,0,5,0,0
"Gibraltar","2024-01-01",0,0,0,0,0,0,0,0
"Gibraltar","2024-01-02",0,0,0,0,0,0,0,0
"Gibraltar","2024-01-03",0,0,0,0,0,0,0,0
"Gibraltar","2024-01-04",0,0,0,0,0,0,0,0
"Gibraltar","2024-01-05",0,0,0,0,0,0,0,0
"Gibraltar","2024-01-06",0,0,0,0,0,0,0,0
"Gibraltar","2024-01-07",0,0,0,0,0,0,0,0
"Gibraltar","2024-01-08",0,0,0,0,0,0,0,0
"Gibraltar","2024-01-09",0,0,0,0,0,0,0,0
"Gibraltar","2024-01-10",0,0,0,0,0,0,0,0
"Gibraltar","2024-01-11",0,0,0,0,0,0,0,0
"Gibraltar","2024-01-12",0,0,0,0,0,0,0,0
"Gibraltar","2024-01-13",0,0,0,0,0,0,0,0
"Gibraltar","2024-01-14",0,0,0,0,0,0,0,0
"Gibraltar","2024-01-15",0,0,0,0,0,0,0,0
"Gibraltar","2024-01-16",0,0,0,0,0,0,0,0
"Gibraltar","2024-01-17",0,0,0,0,0,0,0,0
"Gibraltar","2024-01-18",0,0,0,0,0,0,0,0
"Gibraltar","2024-01-19",0,0,0,0,0,0,0,0
"Gibraltar","2024-01-20",0,0,0,0,0,0,0,0
"Gibraltar","2024-01-21",0,0,0,0,0,0,0,0
"Gibraltar","2024-01-22",0,0,0,0,0,0,0,0
"Gibraltar","2024-01-23",0,0,0,0,0,0,0,0
"Gibraltar","2024-01-24",0,0,0,0,0,0,0,0
"Gibraltar","2024-01-25",0,0,0,0,0,0,0,0
"Gibraltar","2024-01-26",0,0,0,0,0,0,0,0
"Gibraltar","2024-01-27",0,0,0,0,0,0,0,0
"Gibraltar","2024-01-28",0,0,0,0,0,0,0,0
"Gibraltar","2024-01-29",0,0,0,0,0,0,0,0
"Gibraltar","2024-01-30",0,0,0,0,0,0,0,0
"Gibraltar","2024-01-31",0,0,0,0,0,0,0,0
"Gibraltar","2024-02-01",0,0,0,0,0,0,0,0
"Gibraltar","2024-02-02",0,0,0,0,0,0,0,0
"Gibraltar","2024-02-03",0,0,0,0,0,0,0,0
"Gibraltar","2024-02-04",0,0,0,0,0,0,0,0
"Gibraltar","2024-02-05",0,0,0,0,0,0,0,0
"Gibraltar","2024-02-06",0,0,0,0,0,0,0,0
"Gibraltar","2024-02-07",0,0,0,0,0,0,0,0
"Gibraltar","2024-02-08",0,0,0,0,0,0,0,0
"Gibraltar","2024-02-09",0,0,0,0,0,0,0,0
"Gibraltar","2024-02-10",0,0,0,0,0,0,0,0
"Gibraltar","2024-02-11",0,0,0,0,0,0,0,0
"Gibraltar","2024-02-12",0,0,0,0,0,0,0,0
"Gibraltar","2024-02-13",0,0,0,0,0,0,0,0
"Gibraltar","2024-02-14",0,0,0,0,0,0,0,0
"Gibraltar","2024-02-15",0,0,0,0,0,0,0,0
"Gibraltar","2024-02-16",0,0,0,0,0,0,0,0
"Gibraltar","2024-02-17",0,0,0,0,0,0,0,0
"Gibraltar","2024-02-18",0,0,0,0,0,0,0,0
"Gibraltar","2024-02-19",0,0,0,0,0,0,0,0
"Gibraltar","2024-02-20",0,0,0,0,0,0,0,0
"Gibraltar","2024-02-21",0,0,0,0,0,0,0,0
"Gibraltar","2024-02-22",0,0,0,0,0,0,0,0
"Gibraltar","2024-02-23",0,0,0,0,0,0,0,0
"Gibraltar","2024-02-24",0,0,0,0,0,0,0,0
"Gibraltar","2024-02-25",0,0,0,0,0,0,0,0
"Gibraltar","2024-02-26",0,0,0,0,0,0,0,0
"Gibraltar","2024-02-27",0,0,0,0,0,0,0,0
"Gibraltar","2024-02-28",0,0,0,0,0,0,0,0
"Gibraltar","2024-02-29",0,0,0,0,0,0,0,0
"Gibraltar","2024-03-01",0,0,0,0,0,0,0,0
"Gibraltar","2024-03-02",0,0,0,0,0,0,0,0
"Gibraltar","2024-03-03",0,0,0,0,0,0,0,0
"Gibraltar","2024-03-04",0,0,0,0,0,0,0,0
"Gibraltar","2024-03-05",0,0,0,0,0,0,0,0
"Gibraltar","2024-03-06",0,0,0,0,0,0,0,0
"Gibraltar","2024-03-07",0,0,0,0,0,0,0,0
"Gibraltar","2024-03-08",0,0,0,0,0,0,0,0
"Gibraltar","2024-03-09",0,0,0,0,0,0,0,0
"Gibraltar","2024-03-10",0,0,0,0,0,0,0,0
"Gibraltar","2024-03-11",0,0,0,0,0,0,0,0
"Gibraltar","2024-03-12",0,0,0,0,0,0,0,0
"Gibraltar","2024-03-13",0,0,0,0,0,0,0,0
"Gibraltar","2024-03-14",0,0,0,0,0,0,0,0
"Gibraltar","2024-03-15",0,0,0,0,0,0,0,0
"Gibraltar","2024-03-16",0,0,0,0,0,0,0,0
"Gibraltar","2024-03-17",0,0,0,0,0,0,0,0
"Gibraltar","2024-03-18",0,0,0,0,0,0,0,0
"Gibraltar","2024-03-19",0,0,0,0,0,0,0,0
"Gibraltar","2024-03-20",0,0,0,0,0,0,0,0
"Gibraltar","2024-03-21",0,0,0,0,0,0,0,0
"Gibraltar","2024-03-22",0,0,0,0,0,0,0,0
"Gibraltar","2024-03-23",0,0,0,0,0,0,0,0
"Gibraltar","2024-03-24",0,0,0,0,0,0,0,0
"Gibraltar","2024-03-25",0,0,0,0,0,0,0,0
"Gibraltar","2024-03-26",0,0,0,0,0,0,0,0
"Gibraltar","2024-03-27",0,0,0,0,0,0,0,0
"Gibraltar","2024-03-28",0,0,0,0,0,0,0,0
"Gibraltar","2024-03-29",0,0,0,0,0,0,0,0
"Gibraltar","2024-03-30",0,0,0,0,0,0,0,0
"Gibraltar","2024-03-31",0,0,0,0,0,0,0,0
"Gibraltar","2024-04-01",0,0,0,0,0,0,0,0
"Gibraltar","2024-04-02",0,0,0,0,0,0,0,0
"Gibraltar","2024-04-03",0,0,0,0,0,0,0,0
"Gibraltar","2024-04-04",0,0,0,0,0,0,0,0
"Gibraltar","2024-04-05",0,0,0,0,0,0,0,0
"Gibraltar","2024-04-06",0,0,0,0,0,0,0,0
"Gibraltar","2024-04-07",0,0,0,0,0,0,0,0
"Gibraltar","2024-04-08",0,0,0,0,0,0,0,0
"Gibraltar","2024-04-09",0,0,0,0,0,0,0,0
"Gibraltar","2024-04-10",0,0,0,0,0,0,0,0
"Gibraltar","2024-04-11",0,0,0,0,0,0,0,0
"Gibraltar","2024-04-12",0,0,0,0,0,0,0,0
"Gibraltar","2024-04-13",0,0,0,0,0,0,0,0
"Gibraltar","2024-04-14",0,0,0,0,0,0,0,0
"Gibraltar","2024-04-15",0,0,0,0,0,0,0,0
"Gibraltar","2024-04-16",0,0,0,0,0,0,0,0
"Gibraltar","2024-04-17",0,0,0,0,0,0,0,0
"Gibraltar","2024-04-18",0,0,0,0,0,0,0,0
"Gibraltar","2024-04-19",0,0,0,0,0,0,0,0
"Gibraltar","2024-04-20",0,0,0,0,0,0,0,0
"Gibraltar","2024-04-21",0,0,0,0,0,0,0,0
"Gibraltar","2024-04-22",0,0,0,0,0,0,0,0
"Gibraltar","2024-04-23",0,0,0,0,0,0,0,0
"Gibraltar","2024-04-24",0,0,0,0,0,0,0,0
"Gibraltar","2024-04-25",0,0,0,0,0,0,0,0
"Gibraltar","2024-04-26",0,0,0,0,0,0,0,0
"Gibraltar","2024-04-27",0,0,0,0,0,0,0,0
"Gibraltar","2024-04-28",0,0,0,0,0,0,0,0
"Gibraltar","2024-04-29",0,0,0,0,0,0,0,0
"Gibraltar","2024-04-30",0,0,0,0,0,0,0,0
"Gibraltar","2024-05-01",0,0,0,0,0,0,0,0
"Gibraltar","2024-05-02",0,0,0,0,0,0,0,0
"Gibraltar","2024-05-03",0,0,0,0,0,0,0,0
"Gibraltar","2024-05-04",0,0,0,0,0,0,0,0
"Gibraltar","2024-05-05",0,0,0,0,0,0,0,0
"Gibraltar","2024-05-06",0,0,0,0,0,0,0,0
"Gibraltar","2024-05-07",0,0,0,0,0,0,0,0
"Gibraltar","2024-05-08",0,0,0,0,0,0,0,0
"Gibraltar","2024-05-09",0,0,0,0,0,0,0,0
"Gibraltar","2024-05-10",0,0,0,0,0,0,0,0
"Gibraltar","2024-05-11",0,0,0,0,0,0,0,0
"Gibraltar","2024-05-12",0,0,0,0,0,0,0,0
"Gibraltar","2024-05-13",0,0,0,0,0,0,0,0
"Gibraltar","2024-05-14",0,0,0,0,0,0,0,0
"Gibraltar","2024-05-15",0,0,0,0,0,0,0,0
"Gibraltar","2024-05-16",0,0,0,0,0,0,0,0
"Gibraltar","2024-05-17",0,0,0,0,0,0,0,0
"Gibraltar","2024-05-18",0,0,0,0,0,0,0,0
"Gibraltar","2024-05-19",0,0,0,0,0,0,0,0
"Gibraltar","2024-05-20",0,0,0,0,0,0,0,0
"Gibraltar","2024-05-21",0,0,0,0,0,0,0,0
"Gibraltar","2024-05-22",0,0,0,0,0,0,0,0
"Gibraltar","2024-05-23",0,0,0,0,0,0,0,0
"Gibraltar","2024-05-24",0,0,0,0,0,0,0,0
"Gibraltar","2024-05-25",0,0,0,0,0,0,0,0
"Gibraltar","2024-05-26",0,0,0,0,0,0,0,0
"Gibraltar","2024-05-27",0,0,0,0,0,0,0,0
"Gibraltar","2024-05-28",0,0,0,0,0,0,0,0
"Gibraltar","2024-05-29",0,0,0,0,0,0,0,0
"Gibraltar","2024-05-30",0,0,0,0,0,0,0,0
"Gibraltar","2024-05-31",0,0,0,0,0,0,0,0
"Gibraltar","2024-06-01",0,0,0,0,0,0,0,0
"Gibraltar","2024-06-02",0,0,0,0,0,0,0,0
"Gibraltar","2024-06-03",0,0,0,0,0,0,0,0
"Gibraltar","2024-06-04",0,0,0,0,0,0,0,0
"Gibraltar","2024-06-05",0,0,0,0,0,0,0,0
"Gibraltar","2024-06-06",0,0,0,0,0,0,0,0
"Gibraltar","2024-06-07",0,0,0,0,0,0,0,0
"Gibraltar","2024-06-08",0,0,0,0,0,0,0,0
"Gibraltar","2024-06-09",0,0,0,0,0,0,0,0
"Gibraltar","2024-06-10",0,0,0,0,0,0,0,0
"Gibraltar","2024-06-11",0,0,0,0,0,0,0,0
"Gibraltar","2024-06-12",0,0,0,0,0,0,0,0
"Gibraltar","2024-06-13",0,0,0,0,0,0,0,0
"Gibraltar","2024-06-14",0,0,0,0,0,0,0,0
"Gibraltar","2024-06-15",0,0,0,0,0,0,0,0
"Gibraltar","2024-06-16",0,0,0,0,0,0,0,0
"Gibraltar","2024-06-17",0,0,0,0,0,0,0,0
"Gibraltar","2024-06-18",0,0,0,0,0,0,0,0
"Gibraltar","2024-06-19",0,0,0,0,0,0,0,0
"Gibraltar","2024-06-20",0,0,0,0,0,0,0,0
"Gibraltar","2024-06-21",0,0,0,0,0,0,0,0
"Gibraltar","2024-06-22",0,0,0,0,0,0,0,0
"Gibraltar","2024-06-23",0,0,0,0,0,0,0,0
"Gibraltar","2024-06-24",0,0,0,0,0,0,0,0
"Gibraltar","2024-06-25",0,0,0,0,0,0,0,0
"Gibraltar","2024-06-26",0,0,0,0,0,0,0,0
"Gibraltar","2024-06-27",0,0,0,0,0,0,0,0
"Gibraltar","2024-06-28",0,0,0,0,0,0,0,0
"Gibraltar","2024-06-29",0,0,0,0,0,0,0,0
"Gibraltar","2024-06-30",0,0,0,0,0,0,0,0
"Gibraltar","2024-07-01",0,0,0,0,0,0,0,0
"Gibraltar","2024-07-02",0,0,0,0,0,0,0,0
"Gibraltar","2024-07-03",0,0,0,0,0,0,0,0
"Gibraltar","2024-07-04",0,0,0,0,0,0,0,0
"Gibraltar","2024-07-05",0,0,0,0,0,0,0,0
"Gibraltar","2024-07-06",0,0,0,0,0,0,0,0
"Gibraltar","2024-07-07",0,0,0,0,0,0,0,0
"Gibraltar","2024-07-08",0,0,0,0,0,0,0,0
"Gibraltar","2024-07-09",0,0,0,0,0,0,0,0
"Gibraltar","2024-07-10",0,0,0,0,0,0,0,0
"Gibraltar","2024-07-11",0,0,0,0,0,0,0,0
"Gibraltar","2024-07-12",0,0,0,0,0,0,0,0
"Gibraltar","2024-07-13",0,0,0,0,0,0,0,0
"Gibraltar","2024-07-14",0,0,0,0,0,0,0,0
"Gibraltar","2024-07-15",0,0,0,0,0,0,0,0
"Gibraltar","2024-07-16",0,0,0,0,0,0,0,0
"Gibraltar","2024-07-17",0,0,0,0,0,0,0,0
"Gibraltar","2024-07-18",0,0,0,0,0,0,0,0
"Gibraltar","2024-07-19",0,0,0,0,0,0,0,0
"Gibraltar","2024-07-20",0,0,0,0,0,0,0,0
"Gibraltar","2024-07-21",0,0,0,0,0,0,0,0
"Gibraltar","2024-07-22",0,0,0,0,0,0,0,0
"Gibraltar","2024-07-23",0,0,0,0,0,0,0,0
"Gibraltar","2024-07-24",0,0,0,0,0,0,0,0
"Gibraltar","2024-07-25",0,0,0,0,0,0,0,0
"Gibraltar","2024-07-26",0,0,0,0,0,0,0,0
"Gibraltar","2024-07-27",0,0,0,0,0,0,0,0
"Gibraltar","2024-07-28",0,0,0,0,0,0,0,0
"Gibraltar","2024-07-29",0,0,0,0,0,0,0,0
"Gibraltar","2024-07-30",0,0,0,0,0,0,0,0
"Gibraltar","2024-07-31",0,0,0,0,0,0,0,0
"Gibraltar","2024-08-01",0,0,0,0,0,0,0,0
"Gibraltar","2024-08-02",0,0,0,0,0,0,0,0
"Gibraltar","2024-08-03",0,0,0,0,0,0,0,0
"Gibraltar","2024-08-04",0,0,0,0,0,0,0,0
"Gibraltar","2024-08-05",0,0,0,0,0,0,0,0
"Gibraltar","2024-08-06",0,0,0,0,0,0,0,0
"Gibraltar","2024-08-07",0,0,0,0,0,0,0,0
"Gibraltar","2024-08-08",0,0,0,0,0,0,0,0
"Gibraltar","2024-08-09",0,0,0,0,0,0,0,0
"Gibraltar","2024-08-10",0,0,0,0,0,0,0,0
"Gibraltar","2024-08-11",0,0,0,0,0,0,0,0
"Gibraltar","2024-08-12",0,0,0,0,0,0,0,0
"Gibraltar","2024-08-13",0,0,0,0,0,0,0,0
"Gibraltar","2024-08-14",0,0,0,0,0,0,0,0
"Gibraltar","2024-08-15",0,0,0,0,0,0,0,0
"Gibraltar","2024-08-16",0,0,0,0,0,0,0,0
"Gibraltar","2024-08-17",0,0,0,0,0,0,0,0
"Gibraltar","2024-08-18",0,0,0,0,0,0,0,0
"Gibraltar","2024-08-19",0,0,0,0,0,0,0,0
"Gibraltar","2024-08-20",0,0,0,0,0,0,0,0
"Gibraltar","2024-08-21",0,0,0,0,0,0,0,0
"Gibraltar","2024-08-22",0,0,0,0,0,0,0,0
"Gibraltar","2024-08-23",0,0,0,0,0,0,0,0
"Gibraltar","2024-08-24",0,0,0,0,0,0,0,0
"Gibraltar","2024-08-25",0,0,0,0,0,0,0,0
"Gibraltar","2024-08-26",0,0,0,0,0,0,0,0
"Gibraltar","2024-08-27",0,0,0,0,0,0,0,0
"Gibraltar","2024-08-28",0,0,0,0,0,0,0,0
"Gibraltar","2024-08-29",0,0,0,0,0,0,0,0
"Gibraltar","2024-08-30",0,0,0,0,0,0,0,0
"Gibraltar","2024-08-31",0,0,0,0,0,0,0,0
"Gibraltar","2024-09-01",0,0,0,0,0,0,0,0
"Gibraltar","2024-09-02",0,0,0,0,0,0,0,0
"Gibraltar","2024-09-03",0,0,0,0,0,0,0,0
"Gibraltar","2024-09-04",0,0,0,0,0,0,0,0
"Gibraltar","2024-09-05",0,0,0,0,0,0,0,0
"Gibraltar","2024-09-06",0,0,0,0,0,0,0,0
"Gibraltar","2024-09-07",0,0,0,0,0,0,0,0
"Gibraltar","2024-09-08",0,0,0,0,0,0,0,0
"Gibraltar","2024-09-09",0,0,0,0,0,0,0,0
"Gibraltar","2024-09-10",0,0,0,0,0,0,0,0
"Gibraltar","2024-09-11",0,0,0,0,0,0,0,0
"Gibraltar","2024-09-12",0,0,0,0,0,0,0,0
"Gibraltar","2024-09-13",0,0,0,0,0,0,0,0
"Gibraltar","2024-09-14",0,0,0,0,0,0,0,0
"Gibraltar","2024-09-15",0,0,0,0,0,0,0,0
"Gibraltar","2024-09-16",0,0,0,0,0,0,0,0
"Gibraltar","2024-09-17",0,0,0,0,0,0,0,0
"Gibraltar","2024-09-18",0,0,0,0,0,0,0,0
"Gibraltar","2024-09-19",0,0,0,0,0,0,0,0
"Gibraltar","2024-09-20",0,0,0,0,0,0,0,0
"Gibraltar","2024-09-21",0,0,0,0,0,0,0,0
"Gibraltar","2024-09-22",0,0,0,0,0,0,0,0
"Gibraltar","2024-09-23",0,0,0,0,0,0,0,0
"Gibraltar","2024-09-24",0,0,0,0,0,0,0,0
"Gibraltar","2024-09-25",0,0,0,0,0,0,0,0
"Gibraltar","2024-09-26",0,0,0,0,0,0,0,0
"Gibraltar","2024-09-27",0,0,0,0,0,0,0,0
"Gibraltar","2024-09-28",0,0,0,0,0,0,0,0
"Gibraltar","2024-09-29",0,0,0,0,0,0,0,0
"Gibraltar","2024-09-30",0,0,0,0,0,0,0,0
"Gibraltar","2024-10-01",0,0,0,0,0,0,0,0
"Gibraltar","2024-10-02",0,0,0,0,0,0,0,0
"Gibraltar","2024-10-03",0,0,0,0,0,0,0,0
"Gibraltar","2024-10-04",0,0,0,0,0,0,0,0
"Gibraltar","2024-10-05",0,0,0,0,0,0,0,0
"Gibraltar","2024-10-06",0,0,0,0,0,0,0,0
"Gibraltar","2024-10-07",0,0,0,0,0,0,0,0
"Gibraltar","2024-10-08",0,0,0,0,0,0,0,0
"Gibraltar","2024-10-09",0,0,0,0,0,0,0,0
"Gibraltar","2024-10-10",0,0,0,0,0,0,0,0
"Gibraltar","2024-10-11",0,0,0,0,0,0,0,0
"Gibraltar","2024-10-12",0,0,0,0,0,0,0,0
"Gibraltar","2024-10-13",0,0,0,0,0,0,0,0
"Gibraltar","2024-10-14",0,0,0,0,0,0,0,0
"Gibraltar","2024-10-15",0,0,0,0,0,0,0,0
"Gibraltar","2024-10-16",0,0,0,0,0,0,0,0
"Gibraltar","2024-10-17",0,0,0,0,0,0,0,0
"Gibraltar","2024-10-18",0,0,0,0,0,0,0,0
"Gibraltar","2024-10-19",0,0,0,0,0,0,0,0
"Gibraltar","2024-10-20",0,0,0,0,0,0,0,0
"Gibraltar","2024-10-21",0,0,0,0,0,0,0,0
"Gibraltar","2024-10-22",0,0,0,0,0,0,0,0
"Gibraltar","2024-10-23",0,0,0,0,0,0,0,0
"Gibraltar","2024-10-24",0,0,0,0,0,0,0,0
"Gibraltar","2024-10-25",0,0,0,0,0,0,0,0
"Gibraltar","2024-10-26",0,0,0,0,0,0,0,0
"Gibraltar","2024-10-27",0,0,0,0,0,0,0,0
"Gibraltar","2024-10-28",0,0,0,0,0,0,0,0
"Gibraltar","2024-10-29",0,0,0,0,0,0,0,0
"Gibraltar","2024-10-30",0,0,0,0,0,0,0,0
"Gibraltar","2024-10-31",0,0,0,0,0,0,0,0
"Gibraltar","2024-11-01",0,0,0,0,0,0,0,0
"Gibraltar","2024-11-02",0,0,0,0,0,0,0,0
"Gibraltar","2024-11-03",0,0,0,0,0,0,0,0
"Gibraltar","2024-11-04",0,0,0,0,0,0,0,0
"Gibraltar","2024-11-05",0,0,0,0,0,0,0,0
"Gibraltar","2024-11-06",0,0,0,0,0,0,0,0
"Gibraltar","2024-11-07",0,0,0,0,0,0,0,0
"Gibraltar","2024-11-08",0,0,0,0,0,0,0,0
"Gibraltar","2024-11-09",0,0,0,0,0,0,0,0
"Gibraltar","2024-11-10",0,0,0,0,0,0,0,0
"Gibraltar","2024-11-11",0,0,0,0,0,0,0,0
"Gibraltar","2024-11-12",0,0,0,0,0,0,0,0
"Gibraltar","2024-11-13",0,0,0,0,0,0,0,0
"Gibraltar","2024-11-14",0,0,0,0,0,0,0,0
"Gibraltar","2024-11-15",0,0,0,0,0,0,0,0
"Gibraltar","2024-11-16",0,0,0,0,0,0,0,0
"Gibraltar","2024-11-17",0,0,0,0,0,0,0,0
"Gibraltar","2024-11-18",0,0,0,0,0,0,0,0
"Gibraltar","2024-11-19",0,0,0,0,0,0,0,0
"Gibraltar","2024-11-20",0,0,0,0,0,0,0,0
"Gibraltar","2024-11-21",0,0,0,0,0,0,0,0
"Gibraltar","2024-11-22",0,0,0,0,0,0,0,0
"Gibraltar","2024-11-23",0,0,0,0,0,0,0,0
"Gibraltar","2024-11-24",0,0,0,0,0,0,0,0
"Gibraltar","2024-11-25",0,0,0,0,0,0,0,0
"Gibraltar","2024-11-26",0,0,0,0,0,0,0,0
"Gibraltar","2024-11-27",0,0,0,0,0,0,0,0
"Gibraltar","2024-11-28",0,0,0,0,0,0,0,0
"Gibraltar","2024-11-29",0,0,0,0,0,0,0,0
"Gibraltar","2024-11-30",0,0,0,0,0,0,0,0
"Gibraltar","2024-12-01",0,0,0,0,0,0,0,0
"Gibraltar","2024-12-02",0,0,0,0,0,0,0,0
"Gibraltar","2024-12-03",0,0,0,0,0,0,0,0
"Gibraltar","2024-12-04",0,0,0,0,0,0,0,0
"Gibraltar","2024-12-05",0,0,0,0,0,0,0,0
"Gibraltar","2024-12-06",0,0,0,0,0,0,0,0
"Gibraltar","2024-12-07",0,0,0,0,0,0,0,0
"Gibraltar","2024-12-08",0,0,0,0,0,0,0,0
"Gibraltar","2024-12-09",0,0,0,0,0,0,0,0
"Gibraltar","2024-12-10",0,0,0,0,0,0,0,0
"Gibraltar","2024-12-11",0,0,0,0,0,0,0,0
"Gibraltar","2024-12-12",0,0,0,0,0,0,0,0
"Gibraltar","2024-12-13",0,0,0,0,0,0,0,0
"Gibraltar","2024-12-14",0,0,0,0,0,0,0,0
"Gibraltar","2024-12-15",0,0,0,0,0,0,0,0
"Gibraltar","2024-12-16",0,0,0,0,0,0,0,0
"Gibraltar","2024-12-17",0,0,0,0,0,0,0,0
"Gibraltar","2024-12-18",0,0,0,0,0,0,0,0
"Gibraltar","2024-12-19",0,0,0,0,0,0,0,0
"Gibraltar","2024-12-20",0,0,0,0,0,0,0,0
"Gibraltar","2024-12-21",0,0,0,0,0,0,0,0
"Gibraltar","2024-12-22",0,0,0,0,0,0,0,0
"Gibraltar","2024-12-23",0,0,0,0,0,0,0,0
"Gibraltar","2024-12-24",0,0,0,0,0,0,0,0
"Gibraltar","2024-12-25",0,0,0,0,0,0,0,0
"Gibraltar","2024-12-26",0,0,0,0,0,0,0,0
"Gibraltar","2024-12-27",0,0,0,0,0,0,0,0
"Gibraltar","2024-12-28",0,0,0,0,0,0,0,0
"Gibraltar","2024-12-29",0,0,0,0,0,0,0,0
"Gibraltar","2024-12-30",0,0,0,0,0,0,0,0
"Gibraltar","2024-12-31",0,0,0,0,0,0,0,0
"Gibraltar","2025-01-01",0,0,0,0,0,0,0,0
"Gibraltar","2025-01-02",0,0,0,0,0,0,0,0
"Gibraltar","2025-01-03",0,0,0,0,0,0,0,0
"Gibraltar","2025-01-04",0,0,0,0,0,0,0,0
"Gibraltar","2025-01-05",0,0,0,0,0,0,0,0
"Gibraltar","2025-01-06",0,0,0,0,0,0,0,0
"Gibraltar","2025-01-07",0,0,0,0,0,0,0,0
"Gibraltar","2025-01-08",0,0,0,0,0,0,0,0
"Gibraltar","2025-01-09",0,0,0,0,0,0,0,0
"Gibraltar","2025-01-10",0,0,0,0,0,0,0,0
"Gibraltar","2025-01-11",0,0,0,0,0,0,0,0
"Gibraltar","2025-01-12",0,0,0,0,0,0,0,0
"Gibraltar","2025-01-13",0,0,0,0,0,0,0,0
"Gibraltar","2025-01-14",0,0,0,0,0,0,0,0
"Gibraltar","2025-01-15",0,0,0,0,0,0,0,0
"Gibraltar","2025-01-16",0,0,0,0,0,0,0,0
"Gibraltar","2025-01-17",0,0,0,0,0,0,0,0
"Gibraltar","2025-01-18",0,0,0,0,0,0,0,0
"Gibraltar","2025-01-19",0,0,0,0,0,0,0,0
"Gibraltar","2025-01-20",0,0,0,0,0,0,0,0
"Gibraltar","2025-01-21",0,0,0,0,0,0,0,0
"Gibraltar","2025-01-22",0,0,0,0,0,0,0,0
"Gibraltar","2025-01-23",0,0,0,0,0,0,0,0
"Gibraltar","2025-01-24",0,0,0,0,0,0,0,0
"Gibraltar","2025-01-25",0,0,0,0,0,0,0,0
"Gibraltar","2025-01-26",0,0,0,0,0,0,0,0
"Gibraltar","2025-01-27",0,0,0,0,0,0,0,0
"Gibraltar","2025-01-28",0,0,0,0,0,0,0,0
"Gibraltar","2025-01-29",0,0,0,0,0,0,0,0
"Gibraltar","2025-01-30",0,0,0,0,0,0,0,0
"Gibraltar","2025-01-31",0,0,0,0,0,0,0,0
"Gibraltar","2025-02-01",0,0,0,0,0,0,0,0
"Gibraltar","2025-02-02",0,0,0,0,0,0,0,0
"Gibraltar","2025-02-03",0,0,0,0,0,0,0,0
"Gibraltar","2025-02-04",0,0,0,0,0,0,0,0
"Gibraltar","2025-02-05",0,0,0,0,0,0,0,0
"Gibraltar","2025-02-06",0,0,0,0,0,0,0,0
"Gibraltar","2025-02-07",0,0,0,0,0,0,0,0
"Gibraltar","2025-02-08",0,0,0,0,0,0,0,0
"Gibraltar","2025-02-09",0,0,0,0,0,0,0,0
"Gibraltar","2025-02-10",0,0,0,0,0,0,0,0
"Gibraltar","2025-02-11",0,0,0,0,0,0,0,0
"Gibraltar","2025-02-12",0,0,0,0,0,0,0,0
"Gibraltar","2025-02-13",0,0,0,0,0,0,0,0
"Gibraltar","2025-02-14",0,0,0,0,0,0,0,0
"Gibraltar","2025-02-15",0,0,0,0,0,0,0,0
"Gibraltar","2025-02-16",0,0,0,0,0,0,0,0
"Gibraltar","2025-02-17",0,0,0,0,0,0,0,0
"Gibraltar","2025-02-18",0,0,0,0,0,0,0,0
"Gibraltar","2025-02-19",0,0,0,0,0,0,0,0
"Gibraltar","2025-02-20",0,0,0,0,0,0,0,0
"Gibraltar","2025-02-21",0,0,0,0,0,0,0,0
"Gibraltar","2025-02-22",0,0,0,0,0,0,0,0
"Gibraltar","2025-02-23",0,0,0,0,0,0,0,0
"Gibraltar","2025-02-24",0,0,0,0,0,0,0,0
"Gibraltar","2025-02-25",0,0,0,0,0,0,0,0
"Gibraltar","2025-02-26",0,0,0,0,0,0,0,0
"Gibraltar","2025-02-27",0,0,0,0,0,0,0,0
"Gibraltar","2025-02-28",0,0,0,0,0,0,0,0
"Gibraltar","2025-03-01",0,0,0,0,0,0,0,0
"Gibraltar","2025-03-02",0,0,0,0,0,0,0,0
"Gibraltar","2025-03-03",0,0,0,0,0,0,0,0
"Greece","2024-01-01",0,0,0,0,0,0,0,0
"Greece","2024-01-02",0,0,0,0,0,0,0,0
"Greece","2024-01-03",0,0,0,0,0,0,0,0
"Greece","2024-01-04",0,0,0,0,0,0,0,0
"Greece","2024-01-05",0,0,0,0,0,0,0,0
"Greece","2024-01-06",0,0,0,0,0,0,0,0
"Greece","2024-01-07",0,0,0,0,0,0,0,0
"Greece","2024-01-08",0,0,0,0,0,0,0,0
"Greece","2024-01-09",0,0,0,0,0,0,0,0
"Greece","2024-01-10",0,0,0,0,0,0,0,0
"Greece","2024-01-11",0,0,0,0,0,0,0,0
"Greece","2024-01-12",0,0,0,0,0,0,0,0
"Greece","2024-01-13",0,0,0,0,0,0,0,0
"Greece","2024-01-14",0,0,0,0,0,0,0,0
"Greece","2024-01-15",0,0,0,0,0,0,0,0
"Greece","2024-01-16",0,0,0,0,0,0,0,0
"Greece","2024-01-17",0,0,0,0,0,0,0,0
"Greece","2024-01-18",0,0,0,0,0,0,0,0
"Greece","2024-01-19",0,0,0,0,0,0,0,0
"Greece","2024-01-20",0,0,0,0,0,0,0,0
"Greece","2024-01-21",0,0,0,0,0,0,0,0
"Greece","2024-01-22",0,0,0,0,0,0,0,0
"Greece","2024-01-23",0,0,0,0,0,0,0,0
"Greece","2024-01-24",0,0,0,0,0,0,0,0
"Greece","2024-01-25",0,0,0,0,0,0,0,0
"Greece","2024-01-26",0,0,0,0,0,0,0,0
"Greece","2024-01-27",0,0,0,0,0,0,0,0
"Greece","2024-01-28",0,0,0,0,0,0,0,0
"Greece","2024-01-29",0,0,0,0,0,0,0,0
"Greece","2024-01-30",0,0,0,0,0,0,0,0
"Greece","2024-01-31",0,2,2,0,2,2,0,0
"Greece","2024-02-01",0,0,2,0,0,2,0,0
"Greece","2024-02-02",0,0,2,0,0,2,0,0
"Greece","2024-02-03",0,0,2,0,0,2,0,0
"Greece","2024-02-04",0,0,2,0,0,2,0,0
"Greece","2024-02-05",0,0,2,0,0,2,0,0
"Greece","2024-02-06",0,0,2,0,0,2,0,0
"Greece","2024-02-07",0,0,2,0,0,2,0,0
"Greece","2024-02-08",0,0,2,0,0,2,0,0
"Greece","2024-02-09",0,0,2,0,0,2,0,0
"Greece","2024-02-10",0,0,2,0,0,2,0,0
"Greece","2024-02-11",0,0,2,0,0,2,0,0
"Greece","2024-02-12",0,0,2,0,0,2,0,0
"Greece","2024-02-13",0,0,2,0,0,2,0,0
"Greece","2024-02-14",0,0,2,0,0,2,0,0
"Greece","2024-02-15",0,0,2,0,0,2,0,0
"Greece","2024-02-16",0,0,2,0,0,2,0,0
"Greece","2024-02-17",0,0,2,0,0,2,0,0
"Greece","2024-02-18",0,0,2,0,0,2,0,0
"Greece","2024-02-19",0,0,2,0,0,2,0,0
"Greece","2024-02-20",0,0,2,0,0,2,0,0
"Greece","2024-02-21",0,0,2,0,0,2,0,0
"Greece","2024-02-22",0,0,2,0,0,2,0,0
"Greece","2024-02-23",0,0,2,0,0,2,0,0
"Greece","2024-02-24",0,0,2,0,0,2,0,0
"Greece","2024-02-25",0,0,2,0,0,2,0,0
"Greece","2024-02-26",0,0,2,0,0,2,0,0
"Greece","2024-02-27",0,0,2,0,0,2,0,0
"Greece","2024-02-28",0,0,2,0,0,2,0,0
"Greece","2024-02-29",0,0,2,0,0,2,0,0
"Greece","2024-03-01",0,0,2,0,0,2,0,0
"Greece","2024-03-02",0,0,2,0,1,3,0,0
"Greece","2024-03-03",0,0,2,0,0,3,0,0
"Greece","2024-03-04",0,0,2,0,0,3,0,0
"Greece","2024-03-05",0,0,2,0,0,3,0,0
"Greece","2024-03-06",0,0,2,0,0,3,0,0
"Greece","2024-03-07",0,0,2,0,0,3,0,0
"Greece","2024-03-08",0,0,2,0,0,3,0,0
"Greece","2024-03-09",0,0,2,0,0,3,0,0
"Greece","2024-03-10",0,0,2,0,0,3,0,0
"Greece","2024-03-11",0,0,2,0,0,3,0,0
"Greece","2024-03-12",0,0,2,0,0,3,0,0
"Greece","2024-03-13",0,0,2,0,0,3,0,0
"Greece","2024-03-14",0,0,2,0,0,3,0,0
"Greece","2024-03-15",0,0,2,0,0,3,0,0
"Greece","2024-03-16",0,0,2,0,0,3,0,0
"Greece","2024-03-17",0,0,2,0,0,3,0,0
"Greece","2024-03-18",0,0,2,0,0,3,0,0
"Greece","2024-03-19",0,0,2,0,0,3,0,0
"Greece","2024-03-20",0,0,2,0,0,3,0,0
"Greece","2024-03-21",0,0,2,0,0,3,0,0
"Greece","2024-03-22",0,0,2,0,0,3,0,0
"Greece","2024-03-23",0,0,2,0,0,3,0,0
"Greece","2024-03-24",0,0,2,0,0,3,0,0
"Greece","2024-03-25",0,0,2,0,0,3,0,0
"Greece","2024-03-26",0,0,2,0,0,3,0,0
"Greece","2024-03-27",0,0,2,0,0,3,0,0
"Greece","2024-03-28",0,0,2,0,0,3,0,0
"Greece","2024-03-29",0,0,2,0,0,3,0,0
"Greece","2024-03-30",0,0,2,0,0,3,0,0
"Greece","2024-03-31",0,1,3,0,0,3,0,0
"Greece","2024-04-01",0,0,3,0,0,3,0,0
"Greece","2024-04-02",0,0,3,0,0,3,0,0
"Greece","2024-04-03",0,0,3,0,1,4,0,0
"Greece","2024-04-04",0,0,3,0,0,4,0,0
"Greece","2024-04-05",0,0,3,0,0,4,0,0
"Greece","2024-04-06",0,0,3,0,0,4,0,0
"Greece","2024-04-07",0,0,3,0,0,4,0,0
"Greece","2024-04-08",0,0,3,0,1,5,0,0
"Greece","2024-04-09",0,0,3,0,0,5,0,0
"Greece","2024-04-10",0,0,3,0,0,5,0,0
"Greece","2024-04-11",0,0,3,0,0,5,0,0
"Greece","2024-04-12",0,0,3,0,0,5,0,0
"Greece","2024-04-13",0,0,3,0,1,6,0,0
"Greece","2024-04-14",0,0,3,0,0,6,0,0
"Greece","2024-04-15",0,0,3,0,0,6,0,0
"Greece","2024-04-16",0,0,3,0,0,6,0,0
"Greece","2024-04-17",0,0,3,0,0,6,0,0
"Greece","2024-04-18",0,0,3,0,1,7,0,0
"Greece","2024-04-19",0,0,3,0,0,7,0,0
"Greece","2024-04-20",0,0,3,0,0,7,0,0
"Greece","2024-04-21",0,0,3,0,0,7,0,0
"Greece","2024-04-22",0,0,3,0,0,7,0,0
"Greece","2024-04-23",0,0,3,0,1,8,0,0
"Greece","2024-04-24",0,0,3,0,0,8,0,0
"Greece","2024-04-25",0,0,3,0,0,8,0,0
"Greece","2024-04-26",0,0,3,0,0,8,0,0
"Greece","2024-04-27",0,0,3,0,0,8,0,0
"Greece","2024-04-28",0,0,3,0,1,9,0,0
"Greece","2024-04-29",0,0,3,0,0,9,0,0
"Greece","2024-04-30",0,6,9,0,0,9,0,0
"Greece","2024-05-01",0,0,9,0,0,9,0,0
"Greece","2024-05-02",0,0,9,0,0,9,0,0
"Greece","2024-05-03",0,0,9,0,0,9,0,0
"Greece","2024-05-04",0,0,9,0,0,9,0,0
"Greece","2024-05-05",0,0,9,0,0,9,0,0
"Greece","2024-05-06",0,0,9,0,0,9,0,0
"Greece","2024-05-07",0,0,9,0,0,9,0,0
"Greece","2024-05-08",0,0,9,0,0,9,0,0
"Greece","2024-05-09",0,0,9,0,0,9,0,0
"Greece","2024-05-10",0,0,9,0,0,9,0,0
"Greece","2024-05-11",0,0,9,0,0,9,0,0
"Greece","2024-05-12",0,0,9,0,0,9,0,0
"Greece","2024-05-13",0,0,9,0,0,9,0,0
"Greece","2024-05-14",0,0,9,0,0,9,0,0
"Greece","2024-05-15",0,0,9,0,0,9,0,0
"Greece","2024-05-16",0,0,9,0,1,10,0,0
"Greece","2024-05-17",0,0,9,0,0,10,0,0
"Greece","2024-05-18",0,0,9,0,0,10,0,0
"Greece","2024-05-19",0,0,9,0,0,10,0,0
"Greece","2024-05-20",0,0,9,0,0,10,0,0
"Greece","2024-05-21",0,0,9,0,0,10,0,0
"Greece","2024-05-22",0,0,9,0,0,10,0,0
"Greece","2024-05-23",0,0,9,0,0,10,0,0
"Greece","2024-05-24",0,0,9,0,0,10,0,0
"Greece","2024-05-25",0,0,9,0,0,10,0,0
"Greece","2024-05-26",0,0,9,0,0,10,0,0
"Greece","2024-05-27",0,0,9,0,0,10,0,0
"Greece","2024-05-28",0,0,9,0,0,10,0,0
"Greece","2024-05-29",0,0,9,0,0,10,0,0
"Greece","2024-05-30",0,0,9,0,0,10,0,0
"Greece","2024-05-31",0,1,10,0,0,10,0,0
"Greece","2024-06-01",0,0,10,0,0,10,0,0
"Greece","2024-06-02",0,0,10,0,0,10,0,0
"Greece","2024-06-03",0,0,10,0,0,10,0,0
"Greece","2024-06-04",0,0,10,0,0,10,0,0
"Greece","2024-06-05",0,0,10,0,0,10,0,0
"Greece","2024-06-06",0,0,10,0,0,10,0,0
"Greece","2024-06-07",0,0,10,0,0,10,0,0
"Greece","2024-06-08",0,0,10,0,0,10,0,0
"Greece","2024-06-09",0,0,10,0,0,10,0,0
"Greece","2024-06-10",0,0,10,0,0,10,0,0
"Greece","2024-06-11",0,0,10,0,0,10,0,0
"Greece","2024-06-12",0,0,10,0,0,10,0,0
"Greece","2024-06-13",0,0,10,0,0,10,0,0
"Greece","2024-06-14",0,0,10,0,0,10,0,0
"Greece","2024-06-15",0,0,10,0,0,10,0,0
"Greece","2024-06-16",0,0,10,0,0,10,0,0
"Greece","2024-06-17",0,0,10,0,0,10,0,0
"Greece","2024-06-18",0,0,10,0,0,10,0,0
"Greece","2024-06-19",0,0,10,0,0,10,0,0
"Greece","2024-06-20",0,0,10,0,0,10,0,0
"Greece","2024-06-21",0,0,10,0,1,11,0,0
"Greece","2024-06-22",0,0,10,0,0,11,0,0
"Greece","2024-06-23",0,0,10,0,0,11,0,0
"Greece","2024-06-24",0,0,10,0,0,11,0,0
"Greece","2024-06-25",0,0,10,0,0,11,0,0
"Greece","2024-06-26",0,0,10,0,0,11,0,0
"Greece","2024-06-27",0,0,10,0,0,11,0,0
"Greece","2024-06-28",0,0,10,0,0,11,0,0
"Greece","2024-06-29",0,0,10,0,0,11,0,0
"Greece","2024-06-30",0,0,10,0,0,11,0,0
"Greece","2024-07-01",0,0,10,0,0,11,0,0
"Greece","2024-07-02",0,0,10,0,0,11,0,0
"Greece","2024-07-03",0,0,10,0,0,11,0,0
"Greece","2024-07-04",0,0,10,0,0,11,0,0
"Greece","2024-07-05",0,0,10,0,0,11,0,0
"Greece","2024-07-06",0,0,10,0,0,11,0,0
"Greece","2024-07-07",0,0,10,0,0,11,0,0
"Greece","2024-07-08",0,0,10,0,0,11,0,0
"Greece","2024-07-09",0,0,10,0,0,11,0,0
"Greece","2024-07-10",0,0,10,0,0,11,0,0
"Greece","2024-07-11",0,0,10,0,0,11,0,0
"Greece","2024-07-12",0,0,10,0,0,11,0,0
"Greece","2024-07-13",0,0,10,0,0,11,0,0
"Greece","2024-07-14",0,0,10,0,0,11,0,0
"Greece","2024-07-15",0,0,10,0,0,11,0,0
"Greece","2024-07-16",0,0,10,0,0,11,0,0
"Greece","2024-07-17",0,0,10,0,0,11,0,0
"Greece","2024-07-18",0,0,10,0,0,11,0,0
"Greece","2024-07-19",0,0,10,0,0,11,0,0
"Greece","2024-07-20",0,0,10,0,0,11,0,0
"Greece","2024-07-21",0,0,10,0,0,11,0,0
"Greece","2024-07-22",0,0,10,0,0,11,0,0
"Greece","2024-07-23",0,0,10,0,0,11,0,0
"Greece","2024-07-24",0,0,10,0,0,11,0,0
"Greece","2024-07-25",0,0,10,0,0,11,0,0
"Greece","2024-07-26",0,0,10,0,0,11,0,0
"Greece","2024-07-27",0,0,10,0,0,11,0,0
"Greece","2024-07-28",0,0,10,0,0,11,0,0
"Greece","2024-07-29",0,0,10,0,0,11,0,0
"Greece","2024-07-30",0,0,10,0,0,11,0,0
"Greece","2024-07-31",0,0,10,0,1,12,0,0
"Greece","2024-08-01",0,0,10,0,0,12,0,0
"Greece","2024-08-02",0,0,10,0,0,12,0,0
"Greece","2024-08-03",0,0,10,0,0,12,0,0
"Greece","2024-08-04",0,0,10,0,0,12,0,0
"Greece","2024-08-05",0,0,10,0,0,12,0,0
"Greece","2024-08-06",0,0,10,0,0,12,0,0
"Greece","2024-08-07",0,0,10,0,0,12,0,0
"Greece","2024-08-08",0,0,10,0,0,12,0,0
"Greece","2024-08-09",0,0,10,0,0,12,0,0
"Greece","2024-08-10",0,0,10,0,0,12,0,0
"Greece","2024-08-11",0,0,10,0,0,12,0,0
"Greece","2024-08-12",0,0,10,0,0,12,0,0
"Greece","2024-08-13",0,0,10,0,0,12,0,0
"Greece","2024-08-14",0,0,10,0,0,12,0,0
"Greece","2024-08-15",0,0,10,0,0,12,0,0
"Greece","2024-08-16",0,0,10,0,0,12,0,0
"Greece","2024-08-17",0,0,10,0,0,12,0,0
"Greece","2024-08-18",0,0,10,0,0,12,0,0
"Greece","2024-08-19",0,0,10,0,0,12,0,0
"Greece","2024-08-20",0,0,10,0,0,12,0,0
"Greece","2024-08-21",0,0,10,0,0,12,0,0
"Greece","2024-08-22",0,0,10,0,0,12,0,0
"Greece","2024-08-23",0,0,10,0,0,12,0,0
"Greece","2024-08-24",0,0,10,0,0,12,0,0
"Greece","2024-08-25",0,0,10,0,0,12,0,0
"Greece","2024-08-26",0,0,10,0,0,12,0,0
"Greece","2024-08-27",0,0,10,0,0,12,0,0
"Greece","2024-08-28",0,0,10,0,0,12,0,0
"Greece","2024-08-29",0,0,10,0,0,12,0,0
"Greece","2024-08-30",0,0,10,0,0,12,0,0
"Greece","2024-08-31",0,0,10,0,0,12,0,0
"Greece","2024-09-01",0,0,10,0,0,12,0,0
"Greece","2024-09-02",0,0,10,0,0,12,0,0
"Greece","2024-09-03",0,0,10,0,0,12,0,0
"Greece","2024-09-04",0,0,10,0,0,12,0,0
"Greece","2024-09-05",0,0,10,0,0,12,0,0
"Greece","2024-09-06",0,0,10,0,0,12,0,0
"Greece","2024-09-07",0,0,10,0,0,12,0,0
"Greece","2024-09-08",0,0,10,0,0,12,0,0
"Greece","2024-09-09",0,0,10,0,0,12,0,0
"Greece","2024-09-10",0,0,10,0,1,13,0,0
"Greece","2024-09-11",0,0,10,0,0,13,0,0
"Greece","2024-09-12",0,0,10,0,0,13,0,0
"Greece","2024-09-13",0,0,10,0,0,13,0,0
"Greece","2024-09-14",0,0,10,0,0,13,0,0
"Greece","2024-09-15",0,0,10,0,0,13,0,0
"Greece","2024-09-16",0,0,10,0,0,13,0,0
"Greece","2024-09-17",0,0,10,0,0,13,0,0
"Greece","2024-09-18",0,0,10,0,0,13,0,0
"Greece","2024-09-19",0,0,10,0,0,13,0,0
"Greece","2024-09-20",0,0,10,0,0,13,0,0
"Greece","2024-09-21",0,0,10,0,0,13,0,0
"Greece","2024-09-22",0,0,10,0,0,13,0,0
"Greece","2024-09-23",0,0,10,0,0,13,0,0
"Greece","2024-09-24",0,0,10,0,0,13,0,0
"Greece","2024-09-25",0,0,10,0,0,13,0,0
"Greece","2024-09-26",0,0,10,0,0,13,0,0
"Greece","2024-09-27",0,0,10,0,0,13,0,0
"Greece","2024-09-28",0,0,10,0,0,13,0,0
"Greece","2024-09-29",0,0,10,0,0,13,0,0
"Greece","2024-09-30",0,3,13,0,0,13,0,0
"Greece","2024-10-01",0,0,13,0,0,13,0,0
"Greece","2024-10-02",0,0,13,0,0,13,0,0
"Greece","2024-10-03",0,0,13,0,0,13,0,0
"Greece","2024-10-04",0,0,13,0,0,13,0,0
"Greece","2024-10-05",0,0,13,0,0,13,0,0
"Greece","2024-10-06",0,0,13,0,0,13,0,0
"Greece","2024-10-07",0,0,13,0,1,14,0,0
"Greece","2024-10-08",0,0,13,0,0,14,0,0
"Greece","2024-10-09",0,0,13,0,0,14,0,0
"Greece","2024-10-10",0,0,13,0,0,14,0,0
"Greece","2024-10-11",0,0,13,0,0,14,0,0
"Greece","2024-10-12",0,0,13,0,0,14,0,0
"Greece","2024-10-13",0,0,13,0,0,14,0,0
"Greece","2024-10-14",0,0,13,0,0,14,0,0
"Greece","2024-10-15",0,0,13,0,0,14,0,0
"Greece","2024-10-16",0,0,13,0,0,14,0,0
"Greece","2024-10-17",0,0,13,0,0,14,0,0
"Greece","2024-10-18",0,0,13,0,0,14,0,0
"Greece","2024-10-19",0,0,13,0,1,15,0,0
"Greece","2024-10-20",0,0,13,0,0,15,0,0
"Greece","2024-10-21",0,0,13,0,0,15,0,0
"Greece","2024-10-22",0,0,13,0,0,15,0,0
"Greece","2024-10-23",0,0,13,0,0,15,0,0
"Greece","2024-10-24",0,0,13,0,0,15,0,0
"Greece","2024-10-25",0,0,13,0,0,15,0,0
"Greece","2024-10-26",0,0,13,0,0,15,0,0
"Greece","2024-10-27",0,0,13,0,0,15,0,0
"Greece","2024-10-28",0,0,13,0,0,15,0,0
"Greece","2024-10-29",0,0,13,0,0,15,0,0
"Greece","2024-10-30",0,0,13,0,0,15,0,0
"Greece","2024-10-31",0,0,13,0,1,16,0,0
"Greece","2024-11-01",0,0,13,0,0,16,0,0
"Greece","2024-11-02",0,0,13,0,0,16,0,0
"Greece","2024-11-03",0,0,13,0,0,16,0,0
"Greece","2024-11-04",0,0,13,0,0,16,0,0
"Greece","2024-11-05",0,0,13,0,0,16,0,0
"Greece","2024-11-06",0,0,13,0,0,16,0,0
"Greece","2024-11-07",0,0,13,0,0,16,0,0
"Greece","2024-11-08",0,0,13,0,0,16,0,0
"Greece","2024-11-09",0,0,13,0,0,16,0,0
"Greece","2024-11-10",0,0,13,0,0,16,0,0
"Greece","2024-11-11",0,0,13,0,0,16,0,0
"Greece","2024-11-12",0,0,13,0,1,17,0,0
"Greece","2024-11-13",0,0,13,0,0,17,0,0
"Greece","2024-11-14",0,0,13,0,0,17,0,0
"Greece","2024-11-15",0,0,13,0,0,17,0,0
"Greece","2024-11-16",0,0,13,0,0,17,0,0
"Greece","2024-11-17",0,0,13,0,0,17,0,0
"Greece","2024-11-18",0,0,13,0,0,17,0,0
"Greece","2024-11-19",0,0,13,0,0,17,0,0
"Greece","2024-11-20",0,0,13,0,0,17,0,0
"Greece","2024-11-21",0,0,13,0,0,17,0,0
"Greece","2024-11-22",0,0,13,0,0,17,0,0
"Greece","2024-11-23",0,0,13,0,0,17,0,0
"Greece","2024-11-24",0,0,13,0,1,18,0,0
"Greece","2024-11-25",0,0,13,0,0,18,0,0
"Greece","2024-11-26",0,0,13,0,0,18,0,0
"Greece","2024-11-27",0,0,13,0,0,18,0,0
"Greece","2024-11-28",0,0,13,0,0,18,0,0
"Greece","2024-11-29",0,0,13,0,0,18,0,0
"Greece","2024-11-30",0,5,18,0,0,18,0,0
"Greece","2024-12-01",0,0,18,0,1,19,0,0
"Greece","2024-12-02",0,0,18,0,0,19,0,0
"Greece","2024-12-03",0,0,18,0,1,20,0,0
"Greece","2024-12-04",0,0,18,0,1,21,0,0
"Greece","2024-12-05",0,0,18,0,1,22,0,0
"Greece","2024-12-06",0,0,18,0,0,22,0,0
"Greece","2024-12-07",0,0,18,0,1,23,0,0
"Greece","2024-12-08",0,0,18,0,1,24,0,0
"Greece","2024-12-09",0,0,18,0,0,24,0,0
"Greece","2024-12-10",0,0,18,0,1,25,0,0
"Greece","2024-12-11",0,0,18,0,1,26,0,0
"Greece","2024-12-12",0,0,18,0,1,27,0,0
"Greece","2024-12-13",0,0,18,0,0,27,0,0
"Greece","2024-12-14",0,0,18,0,1,28,0,0
"Greece","2024-12-15",0,0,18,0,1,29,0,0
"Greece","2024-12-16",0,0,18,0,0,29,0,0
"Greece","2024-12-17",0,0,18,0,1,30,0,0
"Greece","2024-12-18",0,0,18,0,1,31,0,0
"Greece","2024-12-19",0,0,18,0,0,31,0,0
"Greece","2024-12-20",0,0,18,0,1,32,0,0
"Greece","2024-12-21",0,0,18,0,1,33,0,0
"Greece","2024-12-22",0,0,18,0,1,34,0,0
"Greece","2024-12-23",0,0,18,0,0,34,0,0
"Greece","2024-12-24",0,0,18,0,1,35,0,0
"Greece","2024-12-25",0,0,18,0,1,36,0,0
"Greece","2024-12-26",0,0,18,0,0,36,0,0
"Greece","2024-12-27",0,0,18,0,1,37,0,0
"Greece","2024-12-28",0,0,18,0,1,38,0,0
"Greece","2024-12-29",0,0,18,0,1,39,0,0
"Greece","2024-12-30",0,0,18,0,0,39,0,0
"Greece","2024-12-31",0,22,40,0,1,40,0,0
"Greece","2025-01-01",0,0,40,0,1,41,0,0
"Greece","2025-01-02",0,0,40,0,1,42,0,0
"Greece","2025-01-03",0,0,40,0,1,43,0,0
"Greece","2025-01-04",0,0,40,0,1,44,0,0
"Greece","2025-01-05",0,0,40,0,0,44,0,0
"Greece","2025-01-06",0,0,40,0,1,45,0,0
"Greece","2025-01-07",0,0,40,0,1,46,0,0
"Greece","2025-01-08",0,0,40,0,1,47,0,0
"Greece","2025-01-09",0,0,40,0,1,48,0,0
"Greece","2025-01-10",0,9,49,0,1,49,0,0
"Greece","2025-01-11",0,0,49,0,0,49,0,0
"Greece","2025-01-12",0,0,49,0,0,49,0,0
"Greece","2025-01-13",0,0,49,0,0,49,0,0
"Greece","2025-01-14",0,0,49,0,0,49,0,0
"Greece","2025-01-15",0,0,49,0,0,49,0,0
"Greece","2025-01-16",0,0,49,0,0,49,0,0
"Greece","2025-01-17",0,0,49,0,0,49,0,0
"Greece","2025-01-18",0,0,49,0,0,49,0,0
"Greece","2025-01-19",0,0,49,0,0,49,0,0
"Greece","2025-01-20",0,0,49,0,0,49,0,0
"Greece","2025-01-21",0,0,49,0,0,49,0,0
"Greece","2025-01-22",0,0,49,0,0,49,0,0
"Greece","2025-01-23",0,0,49,0,0,49,0,0
"Greece","2025-01-24",0,0,49,0,0,49,0,0
"Greece","2025-01-25",0,0,49,0,0,49,0,0
"Greece","2025-01-26",0,0,49,0,0,49,0,0
"Greece","2025-01-27",0,0,49,0,0,49,0,0
"Greece","2025-01-28",0,0,49,0,0,49,0,0
"Greece","2025-01-29",0,0,49,0,0,49,0,0
"Greece","2025-01-30",0,0,49,0,0,49,0,0
"Greece","2025-01-31",0,0,49,0,0,49,0,0
"Greece","2025-02-01",0,0,49,0,0,49,0,0
"Greece","2025-02-02",0,0,49,0,0,49,0,0
"Greece","2025-02-03",0,0,49,0,0,49,0,0
"Greece","2025-02-04",0,0,49,0,0,49,0,0
"Greece","2025-02-05",0,0,49,0,0,49,0,0
"Greece","2025-02-06",0,0,49,0,0,49,0,0
"Greece","2025-02-07",0,0,49,0,0,49,0,0
"Greece","2025-02-08",0,0,49,0,0,49,0,0
"Greece","2025-02-09",0,0,49,0,0,49,0,0
"Greece","2025-02-10",0,0,49,0,0,49,0,0
"Greece","2025-02-11",0,0,49,0,0,49,0,0
"Greece","2025-02-12",0,0,49,0,0,49,0,0
"Greece","2025-02-13",0,0,49,0,0,49,0,0
"Greece","2025-02-14",0,0,49,0,0,49,0,0
"Greece","2025-02-15",0,0,49,0,0,49,0,0
"Greece","2025-02-16",0,0,49,0,0,49,0,0
"Greece","2025-02-17",0,0,49,0,0,49,0,0
"Greece","2025-02-18",0,0,49,0,0,49,0,0
"Greece","2025-02-19",0,0,49,0,0,49,0,0
"Greece","2025-02-20",0,0,49,0,0,49,0,0
"Greece","2025-02-21",0,0,49,0,0,49,0,0
"Greece","2025-02-22",0,0,49,0,0,49,0,0
"Greece","2025-02-23",0,0,49,0,0,49,0,0
"Greece","2025-02-24",0,0,49,0,0,49,0,0
"Greece","2025-02-25",0,0,49,0,0,49,0,0
"Greece","2025-02-26",0,0,49,0,0,49,0,0
"Greece","2025-02-27",0,0,49,0,0,49,0,0
"Greece","2025-02-28",0,0,49,0,0,49,0,0
"Greece","2025-03-01",0,0,49,0,0,49,0,0
"Greece","2025-03-02",0,0,49,0,0,49,0,0
"Greece","2025-03-03",0,0,49,0,0,49,0,0
"Greenland","2024-01-01",0,0,0,0,0,0,0,0
"Greenland","2024-01-02",0,0,0,0,0,0,0,0
"Greenland","2024-01-03",0,0,0,0,0,0,0,0
"Greenland","2024-01-04",0,0,0,0,0,0,0,0
"Greenland","2024-01-05",0,0,0,0,0,0,0,0
"Greenland","2024-01-06",0,0,0,0,0,0,0,0
"Greenland","2024-01-07",0,0,0,0,0,0,0,0
"Greenland","2024-01-08",0,0,0,0,0,0,0,0
"Greenland","2024-01-09",0,0,0,0,0,0,0,0
"Greenland","2024-01-10",0,0,0,0,0,0,0,0
"Greenland","2024-01-11",0,0,0,0,0,0,0,0
"Greenland","2024-01-12",0,0,0,0,0,0,0,0
"Greenland","2024-01-13",0,0,0,0,0,0,0,0
"Greenland","2024-01-14",0,0,0,0,0,0,0,0
"Greenland","2024-01-15",0,0,0,0,0,0,0,0
"Greenland","2024-01-16",0,0,0,0,0,0,0,0
"Greenland","2024-01-17",0,0,0,0,0,0,0,0
"Greenland","2024-01-18",0,0,0,0,0,0,0,0
"Greenland","2024-01-19",0,0,0,0,0,0,0,0
"Greenland","2024-01-20",0,0,0,0,0,0,0,0
"Greenland","2024-01-21",0,0,0,0,0,0,0,0
"Greenland","2024-01-22",0,0,0,0,0,0,0,0
"Greenland","2024-01-23",0,0,0,0,0,0,0,0
"Greenland","2024-01-24",0,0,0,0,0,0,0,0
"Greenland","2024-01-25",0,0,0,0,0,0,0,0
"Greenland","2024-01-26",0,0,0,0,0,0,0,0
"Greenland","2024-01-27",0,0,0,0,0,0,0,0
"Greenland","2024-01-28",0,0,0,0,0,0,0,0
"Greenland","2024-01-29",0,0,0,0,0,0,0,0
"Greenland","2024-01-30",0,0,0,0,0,0,0,0
"Greenland","2024-01-31",0,0,0,0,0,0,0,0
"Greenland","2024-02-01",0,0,0,0,0,0,0,0
"Greenland","2024-02-02",0,0,0,0,0,0,0,0
"Greenland","2024-02-03",0,0,0,0,0,0,0,0
"Greenland","2024-02-04",0,0,0,0,0,0,0,0
"Greenland","2024-02-05",0,0,0,0,0,0,0,0
"Greenland","2024-02-06",0,0,0,0,0,0,0,0
"Greenland","2024-02-07",0,0,0,0,0,0,0,0
"Greenland","2024-02-08",0,0,0,0,0,0,0,0
"Greenland","2024-02-09",0,0,0,0,0,0,0,0
"Greenland","2024-02-10",0,0,0,0,0,0,0,0
"Greenland","2024-02-11",0,0,0,0,0,0,0,0
"Greenland","2024-02-12",0,0,0,0,0,0,0,0
"Greenland","2024-02-13",0,0,0,0,0,0,0,0
"Greenland","2024-02-14",0,0,0,0,0,0,0,0
"Greenland","2024-02-15",0,0,0,0,0,0,0,0
"Greenland","2024-02-16",0,0,0,0,0,0,0,0
"Greenland","2024-02-17",0,0,0,0,0,0,0,0
"Greenland","2024-02-18",0,0,0,0,0,0,0,0
"Greenland","2024-02-19",0,0,0,0,0,0,0,0
"Greenland","2024-02-20",0,0,0,0,0,0,0,0
"Greenland","2024-02-21",0,0,0,0,0,0,0,0
"Greenland","2024-02-22",0,0,0,0,0,0,0,0
"Greenland","2024-02-23",0,0,0,0,0,0,0,0
"Greenland","2024-02-24",0,0,0,0,0,0,0,0
"Greenland","2024-02-25",0,0,0,0,0,0,0,0
"Greenland","2024-02-26",0,0,0,0,0,0,0,0
"Greenland","2024-02-27",0,0,0,0,0,0,0,0
"Greenland","2024-02-28",0,0,0,0,0,0,0,0
"Greenland","2024-02-29",0,0,0,0,0,0,0,0
"Greenland","2024-03-01",0,0,0,0,0,0,0,0
"Greenland","2024-03-02",0,0,0,0,0,0,0,0
"Greenland","2024-03-03",0,0,0,0,0,0,0,0
"Greenland","2024-03-04",0,0,0,0,0,0,0,0
"Greenland","2024-03-05",0,0,0,0,0,0,0,0
"Greenland","2024-03-06",0,0,0,0,0,0,0,0
"Greenland","2024-03-07",0,0,0,0,0,0,0,0
"Greenland","2024-03-08",0,0,0,0,0,0,0,0
"Greenland","2024-03-09",0,0,0,0,0,0,0,0
"Greenland","2024-03-10",0,0,0,0,0,0,0,0
"Greenland","2024-03-11",0,0,0,0,0,0,0,0
"Greenland","2024-03-12",0,0,0,0,0,0,0,0
"Greenland","2024-03-13",0,0,0,0,0,0,0,0
"Greenland","2024-03-14",0,0,0,0,0,0,0,0
"Greenland","2024-03-15",0,0,0,0,0,0,0,0
"Greenland","2024-03-16",0,0,0,0,0,0,0,0
"Greenland","2024-03-17",0,0,0,0,0,0,0,0
"Greenland","2024-03-18",0,0,0,0,0,0,0,0
"Greenland","2024-03-19",0,0,0,0,0,0,0,0
"Greenland","2024-03-20",0,0,0,0,0,0,0,0
"Greenland","2024-03-21",0,0,0,0,0,0,0,0
"Greenland","2024-03-22",0,0,0,0,0,0,0,0
"Greenland","2024-03-23",0,0,0,0,0,0,0,0
"Greenland","2024-03-24",0,0,0,0,0,0,0,0
"Greenland","2024-03-25",0,0,0,0,0,0,0,0
"Greenland","2024-03-26",0,0,0,0,0,0,0,0
"Greenland","2024-03-27",0,0,0,0,0,0,0,0
"Greenland","2024-03-28",0,0,0,0,0,0,0,0
"Greenland","2024-03-29",0,0,0,0,0,0,0,0
"Greenland","2024-03-30",0,0,0,0,0,0,0,0
"Greenland","2024-03-31",0,0,0,0,0,0,0,0
"Greenland","2024-04-01",0,0,0,0,0,0,0,0
"Greenland","2024-04-02",0,0,0,0,0,0,0,0
"Greenland","2024-04-03",0,0,0,0,0,0,0,0
"Greenland","2024-04-04",0,0,0,0,0,0,0,0
"Greenland","2024-04-05",0,0,0,0,0,0,0,0
"Greenland","2024-04-06",0,0,0,0,0,0,0,0
"Greenland","2024-04-07",0,0,0,0,0,0,0,0
"Greenland","2024-04-08",0,0,0,0,0,0,0,0
"Greenland","2024-04-09",0,0,0,0,0,0,0,0
"Greenland","2024-04-10",0,0,0,0,0,0,0,0
"Greenland","2024-04-11",0,0,0,0,0,0,0,0
"Greenland","2024-04-12",0,0,0,0,0,0,0,0
"Greenland","2024-04-13",0,0,0,0,0,0,0,0
"Greenland","2024-04-14",0,0,0,0,0,0,0,0
"Greenland","2024-04-15",0,0,0,0,0,0,0,0
"Greenland","2024-04-16",0,0,0,0,0,0,0,0
"Greenland","2024-04-17",0,0,0,0,0,0,0,0
"Greenland","2024-04-18",0,0,0,0,0,0,0,0
"Greenland","2024-04-19",0,0,0,0,0,0,0,0
"Greenland","2024-04-20",0,0,0,0,0,0,0,0
"Greenland","2024-04-21",0,0,0,0,0,0,0,0
"Greenland","2024-04-22",0,0,0,0,0,0,0,0
"Greenland","2024-04-23",0,0,0,0,0,0,0,0
"Greenland","2024-04-24",0,0,0,0,0,0,0,0
"Greenland","2024-04-25",0,0,0,0,0,0,0,0
"Greenland","2024-04-26",0,0,0,0,0,0,0,0
"Greenland","2024-04-27",0,0,0,0,0,0,0,0
"Greenland","2024-04-28",0,0,0,0,0,0,0,0
"Greenland","2024-04-29",0,0,0,0,0,0,0,0
"Greenland","2024-04-30",0,0,0,0,0,0,0,0
"Greenland","2024-05-01",0,0,0,0,0,0,0,0
"Greenland","2024-05-02",0,0,0,0,0,0,0,0
"Greenland","2024-05-03",0,0,0,0,0,0,0,0
"Greenland","2024-05-04",0,0,0,0,0,0,0,0
"Greenland","2024-05-05",0,0,0,0,0,0,0,0
"Greenland","2024-05-06",0,0,0,0,0,0,0,0
"Greenland","2024-05-07",0,0,0,0,0,0,0,0
"Greenland","2024-05-08",0,0,0,0,0,0,0,0
"Greenland","2024-05-09",0,0,0,0,0,0,0,0
"Greenland","2024-05-10",0,0,0,0,0,0,0,0
"Greenland","2024-05-11",0,0,0,0,0,0,0,0
"Greenland","2024-05-12",0,0,0,0,0,0,0,0
"Greenland","2024-05-13",0,0,0,0,0,0,0,0
"Greenland","2024-05-14",0,0,0,0,0,0,0,0
"Greenland","2024-05-15",0,0,0,0,0,0,0,0
"Greenland","2024-05-16",0,0,0,0,0,0,0,0
"Greenland","2024-05-17",0,0,0,0,0,0,0,0
"Greenland","2024-05-18",0,0,0,0,0,0,0,0
"Greenland","2024-05-19",0,0,0,0,0,0,0,0
"Greenland","2024-05-20",0,0,0,0,0,0,0,0
"Greenland","2024-05-21",0,0,0,0,0,0,0,0
"Greenland","2024-05-22",0,0,0,0,0,0,0,0
"Greenland","2024-05-23",0,0,0,0,0,0,0,0
"Greenland","2024-05-24",0,0,0,0,0,0,0,0
"Greenland","2024-05-25",0,0,0,0,0,0,0,0
"Greenland","2024-05-26",0,0,0,0,0,0,0,0
"Greenland","2024-05-27",0,0,0,0,0,0,0,0
"Greenland","2024-05-28",0,0,0,0,0,0,0,0
"Greenland","2024-05-29",0,0,0,0,0,0,0,0
"Greenland","2024-05-30",0,0,0,0,0,0,0,0
"Greenland","2024-05-31",0,0,0,0,0,0,0,0
"Greenland","2024-06-01",0,0,0,0,0,0,0,0
"Greenland","2024-06-02",0,0,0,0,0,0,0,0
"Greenland","2024-06-03",0,0,0,0,0,0,0,0
"Greenland","2024-06-04",0,0,0,0,0,0,0,0
"Greenland","2024-06-05",0,0,0,0,0,0,0,0
"Greenland","2024-06-06",0,0,0,0,0,0,0,0
"Greenland","2024-06-07",0,0,0,0,0,0,0,0
"Greenland","2024-06-08",0,0,0,0,0,0,0,0
"Greenland","2024-06-09",0,0,0,0,0,0,0,0
"Greenland","2024-06-10",0,0,0,0,0,0,0,0
"Greenland","2024-06-11",0,0,0,0,0,0,0,0
"Greenland","2024-06-12",0,0,0,0,0,0,0,0
"Greenland","2024-06-13",0,0,0,0,0,0,0,0
"Greenland","2024-06-14",0,0,0,0,0,0,0,0
"Greenland","2024-06-15",0,0,0,0,0,0,0,0
"Greenland","2024-06-16",0,0,0,0,0,0,0,0
"Greenland","2024-06-17",0,0,0,0,0,0,0,0
"Greenland","2024-06-18",0,0,0,0,0,0,0,0
"Greenland","2024-06-19",0,0,0,0,0,0,0,0
"Greenland","2024-06-20",0,0,0,0,0,0,0,0
"Greenland","2024-06-21",0,0,0,0,0,0,0,0
"Greenland","2024-06-22",0,0,0,0,0,0,0,0
"Greenland","2024-06-23",0,0,0,0,0,0,0,0
"Greenland","2024-06-24",0,0,0,0,0,0,0,0
"Greenland","2024-06-25",0,0,0,0,0,0,0,0
"Greenland","2024-06-26",0,0,0,0,0,0,0,0
"Greenland","2024-06-27",0,0,0,0,0,0,0,0
"Greenland","2024-06-28",0,0,0,0,0,0,0,0
"Greenland","2024-06-29",0,0,0,0,0,0,0,0
"Greenland","2024-06-30",0,0,0,0,0,0,0,0
"Greenland","2024-07-01",0,0,0,0,0,0,0,0
"Greenland","2024-07-02",0,0,0,0,0,0,0,0
"Greenland","2024-07-03",0,0,0,0,0,0,0,0
"Greenland","2024-07-04",0,0,0,0,0,0,0,0
"Greenland","2024-07-05",0,0,0,0,0,0,0,0
"Greenland","2024-07-06",0,0,0,0,0,0,0,0
"Greenland","2024-07-07",0,0,0,0,0,0,0,0
"Greenland","2024-07-08",0,0,0,0,0,0,0,0
"Greenland","2024-07-09",0,0,0,0,0,0,0,0
"Greenland","2024-07-10",0,0,0,0,0,0,0,0
"Greenland","2024-07-11",0,0,0,0,0,0,0,0
"Greenland","2024-07-12",0,0,0,0,0,0,0,0
"Greenland","2024-07-13",0,0,0,0,0,0,0,0
"Greenland","2024-07-14",0,0,0,0,0,0,0,0
"Greenland","2024-07-15",0,0,0,0,0,0,0,0
"Greenland","2024-07-16",0,0,0,0,0,0,0,0
"Greenland","2024-07-17",0,0,0,0,0,0,0,0
"Greenland","2024-07-18",0,0,0,0,0,0,0,0
"Greenland","2024-07-19",0,0,0,0,0,0,0,0
"Greenland","2024-07-20",0,0,0,0,0,0,0,0
"Greenland","2024-07-21",0,0,0,0,0,0,0,0
"Greenland","2024-07-22",0,0,0,0,0,0,0,0
"Greenland","2024-07-23",0,0,0,0,0,0,0,0
"Greenland","2024-07-24",0,0,0,0,0,0,0,0
"Greenland","2024-07-25",0,0,0,0,0,0,0,0
"Greenland","2024-07-26",0,0,0,0,0,0,0,0
"Greenland","2024-07-27",0,0,0,0,0,0,0,0
"Greenland","2024-07-28",0,0,0,0,0,0,0,0
"Greenland","2024-07-29",0,0,0,0,0,0,0,0
"Greenland","2024-07-30",0,0,0,0,0,0,0,0
"Greenland","2024-07-31",0,0,0,0,0,0,0,0
"Greenland","2024-08-01",0,0,0,0,0,0,0,0
"Greenland","2024-08-02",0,0,0,0,0,0,0,0
"Greenland","2024-08-03",0,0,0,0,0,0,0,0
"Greenland","2024-08-04",0,0,0,0,0,0,0,0
"Greenland","2024-08-05",0,0,0,0,0,0,0,0
"Greenland","2024-08-06",0,0,0,0,0,0,0,0
"Greenland","2024-08-07",0,0,0,0,0,0,0,0
"Greenland","2024-08-08",0,0,0,0,0,0,0,0
"Greenland","2024-08-09",0,0,0,0,0,0,0,0
"Greenland","2024-08-10",0,0,0,0,0,0,0,0
"Greenland","2024-08-11",0,0,0,0,0,0,0,0
"Greenland","2024-08-12",0,0,0,0,0,0,0,0
"Greenland","2024-08-13",0,0,0,0,0,0,0,0
"Greenland","2024-08-14",0,0,0,0,0,0,0,0
"Greenland","2024-08-15",0,0,0,0,0,0,0,0
"Greenland","2024-08-16",0,0,0,0,0,0,0,0
"Greenland","2024-08-17",0,0,0,0,0,0,0,0
"Greenland","2024-08-18",0,0,0,0,0,0,0,0
"Greenland","2024-08-19",0,0,0,0,0,0,0,0
"Greenland","2024-08-20",0,0,0,0,0,0,0,0
"Greenland","2024-08-21",0,0,0,0,0,0,0,0
"Greenland","2024-08-22",0,0,0,0,0,0,0,0
"Greenland","2024-08-23",0,0,0,0,0,0,0,0
"Greenland","2024-08-24",0,0,0,0,0,0,0,0
"Greenland","2024-08-25",0,0,0,0,0,0,0,0
"Greenland","2024-08-26",0,0,0,0,0,0,0,0
"Greenland","2024-08-27",0,0,0,0,0,0,0,0
"Greenland","2024-08-28",0,0,0,0,0,0,0,0
"Greenland","2024-08-29",0,0,0,0,0,0,0,0
"Greenland","2024-08-30",0,0,0,0,0,0,0,0
"Greenland","2024-08-31",0,0,0,0,0,0,0,0
"Greenland","2024-09-01",0,0,0,0,0,0,0,0
"Greenland","2024-09-02",0,0,0,0,0,0,0,0
"Greenland","2024-09-03",0,0,0,0,0,0,0,0
"Greenland","2024-09-04",0,0,0,0,0,0,0,0
"Greenland","2024-09-05",0,0,0,0,0,0,0,0
"Greenland","2024-09-06",0,0,0,0,0,0,0,0
"Greenland","2024-09-07",0,0,0,0,0,0,0,0
"Greenland","2024-09-08",0,0,0,0,0,0,0,0
"Greenland","2024-09-09",0,0,0,0,0,0,0,0
"Greenland","2024-09-10",0,0,0,0,0,0,0,0
"Greenland","2024-09-11",0,0,0,0,0,0,0,0
"Greenland","2024-09-12",0,0,0,0,0,0,0,0
"Greenland","2024-09-13",0,0,0,0,0,0,0,0
"Greenland","2024-09-14",0,0,0,0,0,0,0,0
"Greenland","2024-09-15",0,0,0,0,0,0,0,0
"Greenland","2024-09-16",0,0,0,0,0,0,0,0
"Greenland","2024-09-17",0,0,0,0,0,0,0,0
"Greenland","2024-09-18",0,0,0,0,0,0,0,0
"Greenland","2024-09-19",0,0,0,0,0,0,0,0
"Greenland","2024-09-20",0,0,0,0,0,0,0,0
"Greenland","2024-09-21",0,0,0,0,0,0,0,0
"Greenland","2024-09-22",0,0,0,0,0,0,0,0
"Greenland","2024-09-23",0,0,0,0,0,0,0,0
"Greenland","2024-09-24",0,0,0,0,0,0,0,0
"Greenland","2024-09-25",0,0,0,0,0,0,0,0
"Greenland","2024-09-26",0,0,0,0,0,0,0,0
"Greenland","2024-09-27",0,0,0,0,0,0,0,0
"Greenland","2024-09-28",0,0,0,0,0,0,0,0
"Greenland","2024-09-29",0,0,0,0,0,0,0,0
"Greenland","2024-09-30",0,0,0,0,0,0,0,0
"Greenland","2024-10-01",0,0,0,0,0,0,0,0
"Greenland","2024-10-02",0,0,0,0,0,0,0,0
"Greenland","2024-10-03",0,0,0,0,0,0,0,0
"Greenland","2024-10-04",0,0,0,0,0,0,0,0
"Greenland","2024-10-05",0,0,0,0,0,0,0,0
"Greenland","2024-10-06",0,0,0,0,0,0,0,0
"Greenland","2024-10-07",0,0,0,0,0,0,0,0
"Greenland","2024-10-08",0,0,0,0,0,0,0,0
"Greenland","2024-10-09",0,0,0,0,0,0,0,0
"Greenland","2024-10-10",0,0,0,0,0,0,0,0
"Greenland","2024-10-11",0,0,0,0,0,0,0,0
"Greenland","2024-10-12",0,0,0,0,0,0,0,0
"Greenland","2024-10-13",0,0,0,0,0,0,0,0
"Greenland","2024-10-14",0,0,0,0,0,0,0,0
"Greenland","2024-10-15",0,0,0,0,0,0,0,0
"Greenland","2024-10-16",0,0,0,0,0,0,0,0
"Greenland","2024-10-17",0,0,0,0,0,0,0,0
"Greenland","2024-10-18",0,0,0,0,0,0,0,0
"Greenland","2024-10-19",0,0,0,0,0,0,0,0
"Greenland","2024-10-20",0,0,0,0,0,0,0,0
"Greenland","2024-10-21",0,0,0,0,0,0,0,0
"Greenland","2024-10-22",0,0,0,0,0,0,0,0
"Greenland","2024-10-23",0,0,0,0,0,0,0,0
"Greenland","2024-10-24",0,0,0,0,0,0,0,0
"Greenland","2024-10-25",0,0,0,0,0,0,0,0
"Greenland","2024-10-26",0,0,0,0,0,0,0,0
"Greenland","2024-10-27",0,0,0,0,0,0,0,0
"Greenland","2024-10-28",0,0,0,0,0,0,0,0
"Greenland","2024-10-29",0,0,0,0,0,0,0,0
"Greenland","2024-10-30",0,0,0,0,0,0,0,0
"Greenland","2024-10-31",0,0,0,0,0,0,0,0
"Greenland","2024-11-01",0,0,0,0,0,0,0,0
"Greenland","2024-11-02",0,0,0,0,0,0,0,0
"Greenland","2024-11-03",0,0,0,0,0,0,0,0
"Greenland","2024-11-04",0,0,0,0,0,0,0,0
"Greenland","2024-11-05",0,0,0,0,0,0,0,0
"Greenland","2024-11-06",0,0,0,0,0,0,0,0
"Greenland","2024-11-07",0,0,0,0,0,0,0,0
"Greenland","2024-11-08",0,0,0,0,0,0,0,0
"Greenland","2024-11-09",0,0,0,0,0,0,0,0
"Greenland","2024-11-10",0,0,0,0,0,0,0,0
"Greenland","2024-11-11",0,0,0,0,0,0,0,0
"Greenland","2024-11-12",0,0,0,0,0,0,0,0
"Greenland","2024-11-13",0,0,0,0,0,0,0,0
"Greenland","2024-11-14",0,0,0,0,0,0,0,0
"Greenland","2024-11-15",0,0,0,0,0,0,0,0
"Greenland","2024-11-16",0,0,0,0,0,0,0,0
"Greenland","2024-11-17",0,0,0,0,0,0,0,0
"Greenland","2024-11-18",0,0,0,0,0,0,0,0
"Greenland","2024-11-19",0,0,0,0,0,0,0,0
"Greenland","2024-11-20",0,0,0,0,0,0,0,0
"Greenland","2024-11-21",0,0,0,0,0,0,0,0
"Greenland","2024-11-22",0,0,0,0,0,0,0,0
"Greenland","2024-11-23",0,0,0,0,0,0,0,0
"Greenland","2024-11-24",0,0,0,0,0,0,0,0
"Greenland","2024-11-25",0,0,0,0,0,0,0,0
"Greenland","2024-11-26",0,0,0,0,0,0,0,0
"Greenland","2024-11-27",0,0,0,0,0,0,0,0
"Greenland","2024-11-28",0,0,0,0,0,0,0,0
"Greenland","2024-11-29",0,0,0,0,0,0,0,0
"Greenland","2024-11-30",0,0,0,0,0,0,0,0
"Greenland","2024-12-01",0,0,0,0,0,0,0,0
"Greenland","2024-12-02",0,0,0,0,0,0,0,0
"Greenland","2024-12-03",0,0,0,0,0,0,0,0
"Greenland","2024-12-04",0,0,0,0,0,0,0,0
"Greenland","2024-12-05",0,0,0,0,0,0,0,0
"Greenland","2024-12-06",0,0,0,0,0,0,0,0
"Greenland","2024-12-07",0,0,0,0,0,0,0,0
"Greenland","2024-12-08",0,0,0,0,0,0,0,0
"Greenland","2024-12-09",0,0,0,0,0,0,0,0
"Greenland","2024-12-10",0,0,0,0,0,0,0,0
"Greenland","2024-12-11",0,0,0,0,0,0,0,0
"Greenland","2024-12-12",0,0,0,0,0,0,0,0
"Greenland","2024-12-13",0,0,0,0,0,0,0,0
"Greenland","2024-12-14",0,0,0,0,0,0,0,0
"Greenland","2024-12-15",0,0,0,0,0,0,0,0
"Greenland","2024-12-16",0,0,0,0,0,0,0,0
"Greenland","2024-12-17",0,0,0,0,0,0,0,0
"Greenland","2024-12-18",0,0,0,0,0,0,0,0
"Greenland","2024-12-19",0,0,0,0,0,0,0,0
"Greenland","2024-12-20",0,0,0,0,0,0,0,0
"Greenland","2024-12-21",0,0,0,0,0,0,0,0
"Greenland","2024-12-22",0,0,0,0,0,0,0,0
"Greenland","2024-12-23",0,0,0,0,0,0,0,0
"Greenland","2024-12-24",0,0,0,0,0,0,0,0
"Greenland","2024-12-25",0,0,0,0,0,0,0,0
"Greenland","2024-12-26",0,0,0,0,0,0,0,0
"Greenland","2024-12-27",0,0,0,0,0,0,0,0
"Greenland","2024-12-28",0,0,0,0,0,0,0,0
"Greenland","2024-12-29",0,0,0,0,0,0,0,0
"Greenland","2024-12-30",0,0,0,0,0,0,0,0
"Greenland","2024-12-31",0,0,0,0,0,0,0,0
"Greenland","2025-01-01",0,0,0,0,0,0,0,0
"Greenland","2025-01-02",0,0,0,0,0,0,0,0
"Greenland","2025-01-03",0,0,0,0,0,0,0,0
"Greenland","2025-01-04",0,0,0,0,0,0,0,0
"Greenland","2025-01-05",0,0,0,0,0,0,0,0
"Greenland","2025-01-06",0,0,0,0,0,0,0,0
"Greenland","2025-01-07",0,0,0,0,0,0,0,0
"Greenland","2025-01-08",0,0,0,0,0,0,0,0
"Greenland","2025-01-09",0,0,0,0,0,0,0,0
"Greenland","2025-01-10",0,0,0,0,0,0,0,0
"Greenland","2025-01-11",0,0,0,0,0,0,0,0
"Greenland","2025-01-12",0,0,0,0,0,0,0,0
"Greenland","2025-01-13",0,0,0,0,0,0,0,0
"Greenland","2025-01-14",0,0,0,0,0,0,0,0
"Greenland","2025-01-15",0,0,0,0,0,0,0,0
"Greenland","2025-01-16",0,0,0,0,0,0,0,0
"Greenland","2025-01-17",0,0,0,0,0,0,0,0
"Greenland","2025-01-18",0,0,0,0,0,0,0,0
"Greenland","2025-01-19",0,0,0,0,0,0,0,0
"Greenland","2025-01-20",0,0,0,0,0,0,0,0
"Greenland","2025-01-21",0,0,0,0,0,0,0,0
"Greenland","2025-01-22",0,0,0,0,0,0,0,0
"Greenland","2025-01-23",0,0,0,0,0,0,0,0
"Greenland","2025-01-24",0,0,0,0,0,0,0,0
"Greenland","2025-01-25",0,0,0,0,0,0,0,0
"Greenland","2025-01-26",0,0,0,0,0,0,0,0
"Greenland","2025-01-27",0,0,0,0,0,0,0,0
"Greenland","2025-01-28",0,0,0,0,0,0,0,0
"Greenland","2025-01-29",0,0,0,0,0,0,0,0
"Greenland","2025-01-30",0,0,0,0,0,0,0,0
"Greenland","2025-01-31",0,0,0,0,0,0,0,0
"Greenland","2025-02-01",0,0,0,0,0,0,0,0
"Greenland","2025-02-02",0,0,0,0,0,0,0,0
"Greenland","2025-02-03",0,0,0,0,0,0,0,0
"Greenland","2025-02-04",0,0,0,0,0,0,0,0
"Greenland","2025-02-05",0,0,0,0,0,0,0,0
"Greenland","2025-02-06",0,0,0,0,0,0,0,0
"Greenland","2025-02-07",0,0,0,0,0,0,0,0
"Greenland","2025-02-08",0,0,0,0,0,0,0,0
"Greenland","2025-02-09",0,0,0,0,0,0,0,0
"Greenland","2025-02-10",0,0,0,0,0,0,0,0
"Greenland","2025-02-11",0,0,0,0,0,0,0,0
"Greenland","2025-02-12",0,0,0,0,0,0,0,0
"Greenland","2025-02-13",0,0,0,0,0,0,0,0
"Greenland","2025-02-14",0,0,0,0,0,0,0,0
"Greenland","2025-02-15",0,0,0,0,0,0,0,0
"Greenland","2025-02-16",0,0,0,0,0,0,0,0
"Greenland","2025-02-17",0,0,0,0,0,0,0,0
"Greenland","2025-02-18",0,0,0,0,0,0,0,0
"Greenland","2025-02-19",0,0,0,0,0,0,0,0
"Greenland","2025-02-20",0,0,0,0,0,0,0,0
"Greenland","2025-02-21",0,0,0,0,0,0,0,0
"Greenland","2025-02-22",0,0,0,0,0,0,0,0
"Greenland","2025-02-23",0,0,0,0,0,0,0,0
"Greenland","2025-02-24",0,0,0,0,0,0,0,0
"Greenland","2025-02-25",0,0,0,0,0,0,0,0
"Greenland","2025-02-26",0,0,0,0,0,0,0,0
"Greenland","2025-02-27",0,0,0,0,0,0,0,0
"Greenland","2025-02-28",0,0,0,0,0,0,0,0
"Greenland","2025-03-01",0,0,0,0,0,0,0,0
"Greenland","2025-03-02",0,0,0,0,0,0,0,0
"Greenland","2025-03-03",0,0,0,0,0,0,0,0
"Guadeloupe","2024-01-01",0,0,0,0,0,0,0,0
"Guadeloupe","2024-01-02",0,0,0,0,0,0,0,0
"Guadeloupe","2024-01-03",0,0,0,0,0,0,0,0
"Guadeloupe","2024-01-04",0,0,0,0,0,0,0,0
"Guadeloupe","2024-01-05",0,0,0,0,0,0,0,0
"Guadeloupe","2024-01-06",0,0,0,0,0,0,0,0
"Guadeloupe","2024-01-07",0,0,0,0,0,0,0,0
"Guadeloupe","2024-01-08",0,0,0,0,0,0,0,0
"Guadeloupe","2024-01-09",0,0,0,0,0,0,0,0
"Guadeloupe","2024-01-10",0,0,0,0,0,0,0,0
"Guadeloupe","2024-01-11",0,0,0,0,0,0,0,0
"Guadeloupe","2024-01-12",0,0,0,0,0,0,0,0
"Guadeloupe","2024-01-13",0,0,0,0,0,0,0,0
"Guadeloupe","2024-01-14",0,0,0,0,0,0,0,0
"Guadeloupe","2024-01-15",0,0,0,0,0,0,0,0
"Guadeloupe","2024-01-16",0,0,0,0,0,0,0,0
"Guadeloupe","2024-01-17",0,0,0,0,0,0,0,0
"Guadeloupe","2024-01-18",0,0,0,0,0,0,0,0
"Guadeloupe","2024-01-19",0,0,0,0,0,0,0,0
"Guadeloupe","2024-01-20",0,0,0,0,0,0,0,0
"Guadeloupe","2024-01-21",0,0,0,0,0,0,0,0
"Guadeloupe","2024-01-22",0,0,0,0,0,0,0,0
"Guadeloupe","2024-01-23",0,0,0,0,0,0,0,0
"Guadeloupe","2024-01-24",0,0,0,0,0,0,0,0
"Guadeloupe","2024-01-25",0,0,0,0,0,0,0,0
"Guadeloupe","2024-01-26",0,0,0,0,0,0,0,0
"Guadeloupe","2024-01-27",0,0,0,0,0,0,0,0
"Guadeloupe","2024-01-28",0,0,0,0,0,0,0,0
"Guadeloupe","2024-01-29",0,0,0,0,0,0,0,0
"Guadeloupe","2024-01-30",0,0,0,0,0,0,0,0
"Guadeloupe","2024-01-31",0,0,0,0,0,0,0,0
"Guadeloupe","2024-02-01",0,0,0,0,0,0,0,0
"Guadeloupe","2024-02-02",0,0,0,0,0,0,0,0
"Guadeloupe","2024-02-03",0,0,0,0,0,0,0,0
"Guadeloupe","2024-02-04",0,0,0,0,0,0,0,0
"Guadeloupe","2024-02-05",0,0,0,0,0,0,0,0
"Guadeloupe","2024-02-06",0,0,0,0,0,0,0,0
"Guadeloupe","2024-02-07",0,0,0,0,0,0,0,0
"Guadeloupe","2024-02-08",0,0,0,0,0,0,0,0
"Guadeloupe","2024-02-09",0,0,0,0,0,0,0,0
"Guadeloupe","2024-02-10",0,0,0,0,0,0,0,0
"Guadeloupe","2024-02-11",0,0,0,0,0,0,0,0
"Guadeloupe","2024-02-12",0,0,0,0,0,0,0,0
"Guadeloupe","2024-02-13",0,0,0,0,0,0,0,0
"Guadeloupe","2024-02-14",0,0,0,0,0,0,0,0
"Guadeloupe","2024-02-15",0,0,0,0,0,0,0,0
"Guadeloupe","2024-02-16",0,0,0,0,0,0,0,0
"Guadeloupe","2024-02-17",0,0,0,0,0,0,0,0
"Guadeloupe","2024-02-18",0,0,0,0,0,0,0,0
"Guadeloupe","2024-02-19",0,0,0,0,0,0,0,0
"Guadeloupe","2024-02-20",0,0,0,0,0,0,0,0
"Guadeloupe","2024-02-21",0,0,0,0,0,0,0,0
"Guadeloupe","2024-02-22",0,0,0,0,0,0,0,0
"Guadeloupe","2024-02-23",0,0,0,0,0,0,0,0
"Guadeloupe","2024-02-24",0,0,0,0,0,0,0,0
"Guadeloupe","2024-02-25",0,0,0,0,0,0,0,0
"Guadeloupe","2024-02-26",0,0,0,0,0,0,0,0
"Guadeloupe","2024-02-27",0,0,0,0,0,0,0,0
"Guadeloupe","2024-02-28",0,0,0,0,0,0,0,0
"Guadeloupe","2024-02-29",0,0,0,0,0,0,0,0
"Guadeloupe","2024-03-01",0,0,0,0,0,0,0,0
"Guadeloupe","2024-03-02",0,0,0,0,0,0,0,0
"Guadeloupe","2024-03-03",0,0,0,0,0,0,0,0
"Guadeloupe","2024-03-04",0,0,0,0,0,0,0,0
"Guadeloupe","2024-03-05",0,0,0,0,0,0,0,0
"Guadeloupe","2024-03-06",0,0,0,0,0,0,0,0
"Guadeloupe","2024-03-07",0,0,0,0,0,0,0,0
"Guadeloupe","2024-03-08",0,0,0,0,0,0,0,0
"Guadeloupe","2024-03-09",0,0,0,0,0,0,0,0
"Guadeloupe","2024-03-10",0,0,0,0,0,0,0,0
"Guadeloupe","2024-03-11",0,0,0,0,0,0,0,0
"Guadeloupe","2024-03-12",0,0,0,0,0,0,0,0
"Guadeloupe","2024-03-13",0,0,0,0,0,0,0,0
"Guadeloupe","2024-03-14",0,0,0,0,0,0,0,0
"Guadeloupe","2024-03-15",0,0,0,0,0,0,0,0
"Guadeloupe","2024-03-16",0,0,0,0,0,0,0,0
"Guadeloupe","2024-03-17",0,0,0,0,0,0,0,0
"Guadeloupe","2024-03-18",0,0,0,0,0,0,0,0
"Guadeloupe","2024-03-19",0,0,0,0,0,0,0,0
"Guadeloupe","2024-03-20",0,0,0,0,0,0,0,0
"Guadeloupe","2024-03-21",0,0,0,0,0,0,0,0
"Guadeloupe","2024-03-22",0,0,0,0,0,0,0,0
"Guadeloupe","2024-03-23",0,0,0,0,0,0,0,0
"Guadeloupe","2024-03-24",0,0,0,0,0,0,0,0
"Guadeloupe","2024-03-25",0,0,0,0,0,0,0,0
"Guadeloupe","2024-03-26",0,0,0,0,0,0,0,0
"Guadeloupe","2024-03-27",0,0,0,0,0,0,0,0
"Guadeloupe","2024-03-28",0,0,0,0,0,0,0,0
"Guadeloupe","2024-03-29",0,0,0,0,0,0,0,0
"Guadeloupe","2024-03-30",0,0,0,0,0,0,0,0
"Guadeloupe","2024-03-31",0,0,0,0,0,0,0,0
"Guadeloupe","2024-04-01",0,0,0,0,0,0,0,0
"Guadeloupe","2024-04-02",0,0,0,0,0,0,0,0
"Guadeloupe","2024-04-03",0,0,0,0,0,0,0,0
"Guadeloupe","2024-04-04",0,0,0,0,0,0,0,0
"Guadeloupe","2024-04-05",0,0,0,0,0,0,0,0
"Guadeloupe","2024-04-06",0,0,0,0,0,0,0,0
"Guadeloupe","2024-04-07",0,0,0,0,0,0,0,0
"Guadeloupe","2024-04-08",0,0,0,0,0,0,0,0
"Guadeloupe","2024-04-09",0,0,0,0,0,0,0,0
"Guadeloupe","2024-04-10",0,0,0,0,0,0,0,0
"Guadeloupe","2024-04-11",0,0,0,0,0,0,0,0
"Guadeloupe","2024-04-12",0,0,0,0,0,0,0,0
"Guadeloupe","2024-04-13",0,0,0,0,0,0,0,0
"Guadeloupe","2024-04-14",0,0,0,0,0,0,0,0
"Guadeloupe","2024-04-15",0,0,0,0,0,0,0,0
"Guadeloupe","2024-04-16",0,0,0,0,0,0,0,0
"Guadeloupe","2024-04-17",0,0,0,0,0,0,0,0
"Guadeloupe","2024-04-18",0,0,0,0,0,0,0,0
"Guadeloupe","2024-04-19",0,0,0,0,0,0,0,0
"Guadeloupe","2024-04-20",0,0,0,0,0,0,0,0
"Guadeloupe","2024-04-21",0,0,0,0,0,0,0,0
"Guadeloupe","2024-04-22",0,0,0,0,0,0,0,0
"Guadeloupe","2024-04-23",0,0,0,0,0,0,0,0
"Guadeloupe","2024-04-24",0,0,0,0,0,0,0,0
"Guadeloupe","2024-04-25",0,0,0,0,0,0,0,0
"Guadeloupe","2024-04-26",0,0,0,0,0,0,0,0
"Guadeloupe","2024-04-27",0,0,0,0,0,0,0,0
"Guadeloupe","2024-04-28",0,0,0,0,0,0,0,0
"Guadeloupe","2024-04-29",0,0,0,0,0,0,0,0
"Guadeloupe","2024-04-30",0,0,0,0,0,0,0,0
"Guadeloupe","2024-05-01",0,0,0,0,0,0,0,0
"Guadeloupe","2024-05-02",0,0,0,0,0,0,0,0
"Guadeloupe","2024-05-03",0,0,0,0,0,0,0,0
"Guadeloupe","2024-05-04",0,0,0,0,0,0,0,0
"Guadeloupe","2024-05-05",0,0,0,0,0,0,0,0
"Guadeloupe","2024-05-06",0,0,0,0,0,0,0,0
"Guadeloupe","2024-05-07",0,0,0,0,0,0,0,0
"Guadeloupe","2024-05-08",0,0,0,0,0,0,0,0
"Guadeloupe","2024-05-09",0,0,0,0,0,0,0,0
"Guadeloupe","2024-05-10",0,0,0,0,0,0,0,0
"Guadeloupe","2024-05-11",0,0,0,0,0,0,0,0
"Guadeloupe","2024-05-12",0,0,0,0,0,0,0,0
"Guadeloupe","2024-05-13",0,0,0,0,0,0,0,0
"Guadeloupe","2024-05-14",0,0,0,0,0,0,0,0
"Guadeloupe","2024-05-15",0,0,0,0,0,0,0,0
"Guadeloupe","2024-05-16",0,0,0,0,0,0,0,0
"Guadeloupe","2024-05-17",0,0,0,0,0,0,0,0
"Guadeloupe","2024-05-18",0,0,0,0,0,0,0,0
"Guadeloupe","2024-05-19",0,0,0,0,0,0,0,0
"Guadeloupe","2024-05-20",0,0,0,0,0,0,0,0
"Guadeloupe","2024-05-21",0,0,0,0,0,0,0,0
"Guadeloupe","2024-05-22",0,0,0,0,0,0,0,0
"Guadeloupe","2024-05-23",0,0,0,0,0,0,0,0
"Guadeloupe","2024-05-24",0,0,0,0,0,0,0,0
"Guadeloupe","2024-05-25",0,0,0,0,0,0,0,0
"Guadeloupe","2024-05-26",0,0,0,0,0,0,0,0
"Guadeloupe","2024-05-27",0,0,0,0,0,0,0,0
"Guadeloupe","2024-05-28",0,0,0,0,0,0,0,0
"Guadeloupe","2024-05-29",0,0,0,0,0,0,0,0
"Guadeloupe","2024-05-30",0,0,0,0,0,0,0,0
"Guadeloupe","2024-05-31",0,0,0,0,0,0,0,0
"Guadeloupe","2024-06-01",0,0,0,0,0,0,0,0
"Guadeloupe","2024-06-02",0,0,0,0,0,0,0,0
"Guadeloupe","2024-06-03",0,0,0,0,0,0,0,0
"Guadeloupe","2024-06-04",0,0,0,0,0,0,0,0
"Guadeloupe","2024-06-05",0,0,0,0,0,0,0,0
"Guadeloupe","2024-06-06",0,0,0,0,0,0,0,0
"Guadeloupe","2024-06-07",0,0,0,0,0,0,0,0
"Guadeloupe","2024-06-08",0,0,0,0,0,0,0,0
"Guadeloupe","2024-06-09",0,0,0,0,0,0,0,0
"Guadeloupe","2024-06-10",0,0,0,0,0,0,0,0
"Guadeloupe","2024-06-11",0,0,0,0,0,0,0,0
"Guadeloupe","2024-06-12",0,0,0,0,0,0,0,0
"Guadeloupe","2024-06-13",0,0,0,0,0,0,0,0
"Guadeloupe","2024-06-14",0,0,0,0,0,0,0,0
"Guadeloupe","2024-06-15",0,0,0,0,0,0,0,0
"Guadeloupe","2024-06-16",0,0,0,0,0,0,0,0
"Guadeloupe","2024-06-17",0,0,0,0,0,0,0,0
"Guadeloupe","2024-06-18",0,0,0,0,0,0,0,0
"Guadeloupe","2024-06-19",0,0,0,0,0,0,0,0
"Guadeloupe","2024-06-20",0,0,0,0,0,0,0,0
"Guadeloupe","2024-06-21",0,0,0,0,0,0,0,0
"Guadeloupe","2024-06-22",0,0,0,0,0,0,0,0
"Guadeloupe","2024-06-23",0,0,0,0,0,0,0,0
"Guadeloupe","2024-06-24",0,0,0,0,0,0,0,0
"Guadeloupe","2024-06-25",0,0,0,0,0,0,0,0
"Guadeloupe","2024-06-26",0,0,0,0,0,0,0,0
"Guadeloupe","2024-06-27",0,0,0,0,0,0,0,0
"Guadeloupe","2024-06-28",0,0,0,0,0,0,0,0
"Guadeloupe","2024-06-29",0,0,0,0,0,0,0,0
"Guadeloupe","2024-06-30",0,0,0,0,0,0,0,0
"Guadeloupe","2024-07-01",0,0,0,0,0,0,0,0
"Guadeloupe","2024-07-02",0,0,0,0,0,0,0,0
"Guadeloupe","2024-07-03",0,0,0,0,0,0,0,0
"Guadeloupe","2024-07-04",0,0,0,0,0,0,0,0
"Guadeloupe","2024-07-05",0,0,0,0,0,0,0,0
"Guadeloupe","2024-07-06",0,0,0,0,0,0,0,0
"Guadeloupe","2024-07-07",0,0,0,0,0,0,0,0
"Guadeloupe","2024-07-08",0,0,0,0,0,0,0,0
"Guadeloupe","2024-07-09",0,0,0,0,0,0,0,0
"Guadeloupe","2024-07-10",0,0,0,0,0,0,0,0
"Guadeloupe","2024-07-11",0,0,0,0,0,0,0,0
"Guadeloupe","2024-07-12",0,0,0,0,0,0,0,0
"Guadeloupe","2024-07-13",0,0,0,0,0,0,0,0
"Guadeloupe","2024-07-14",0,0,0,0,0,0,0,0
"Guadeloupe","2024-07-15",0,0,0,0,0,0,0,0
"Guadeloupe","2024-07-16",0,0,0,0,0,0,0,0
"Guadeloupe","2024-07-17",0,0,0,0,0,0,0,0
"Guadeloupe","2024-07-18",0,0,0,0,0,0,0,0
"Guadeloupe","2024-07-19",0,0,0,0,0,0,0,0
"Guadeloupe","2024-07-20",0,0,0,0,0,0,0,0
"Guadeloupe","2024-07-21",0,0,0,0,0,0,0,0
"Guadeloupe","2024-07-22",0,0,0,0,0,0,0,0
"Guadeloupe","2024-07-23",0,0,0,0,0,0,0,0
"Guadeloupe","2024-07-24",0,0,0,0,0,0,0,0
"Guadeloupe","2024-07-25",0,0,0,0,0,0,0,0
"Guadeloupe","2024-07-26",0,0,0,0,0,0,0,0
"Guadeloupe","2024-07-27",0,0,0,0,0,0,0,0
"Guadeloupe","2024-07-28",0,0,0,0,0,0,0,0
"Guadeloupe","2024-07-29",0,0,0,0,0,0,0,0
"Guadeloupe","2024-07-30",0,0,0,0,0,0,0,0
"Guadeloupe","2024-07-31",0,0,0,0,0,0,0,0
"Guadeloupe","2024-08-01",0,0,0,0,0,0,0,0
"Guadeloupe","2024-08-02",0,0,0,0,0,0,0,0
"Guadeloupe","2024-08-03",0,0,0,0,0,0,0,0
"Guadeloupe","2024-08-04",0,0,0,0,0,0,0,0
"Guadeloupe","2024-08-05",0,0,0,0,0,0,0,0
"Guadeloupe","2024-08-06",0,0,0,0,0,0,0,0
"Guadeloupe","2024-08-07",0,0,0,0,0,0,0,0
"Guadeloupe","2024-08-08",0,0,0,0,0,0,0,0
"Guadeloupe","2024-08-09",0,0,0,0,0,0,0,0
"Guadeloupe","2024-08-10",0,0,0,0,0,0,0,0
"Guadeloupe","2024-08-11",0,0,0,0,0,0,0,0
"Guadeloupe","2024-08-12",0,0,0,0,0,0,0,0
"Guadeloupe","2024-08-13",0,0,0,0,0,0,0,0
"Guadeloupe","2024-08-14",0,0,0,0,0,0,0,0
"Guadeloupe","2024-08-15",0,0,0,0,0,0,0,0
"Guadeloupe","2024-08-16",0,0,0,0,0,0,0,0
"Guadeloupe","2024-08-17",0,0,0,0,0,0,0,0
"Guadeloupe","2024-08-18",0,0,0,0,0,0,0,0
"Guadeloupe","2024-08-19",0,0,0,0,0,0,0,0
"Guadeloupe","2024-08-20",0,0,0,0,0,0,0,0
"Guadeloupe","2024-08-21",0,0,0,0,0,0,0,0
"Guadeloupe","2024-08-22",0,0,0,0,0,0,0,0
"Guadeloupe","2024-08-23",0,0,0,0,0,0,0,0
"Guadeloupe","2024-08-24",0,0,0,0,0,0,0,0
"Guadeloupe","2024-08-25",0,0,0,0,0,0,0,0
"Guadeloupe","2024-08-26",0,0,0,0,0,0,0,0
"Guadeloupe","2024-08-27",0,0,0,0,0,0,0,0
"Guadeloupe","2024-08-28",0,0,0,0,0,0,0,0
"Guadeloupe","2024-08-29",0,0,0,0,0,0,0,0
"Guadeloupe","2024-08-30",0,0,0,0,0,0,0,0
"Guadeloupe","2024-08-31",0,0,0,0,0,0,0,0
"Guadeloupe","2024-09-01",0,0,0,0,0,0,0,0
"Guadeloupe","2024-09-02",0,0,0,0,0,0,0,0
"Guadeloupe","2024-09-03",0,0,0,0,0,0,0,0
"Guadeloupe","2024-09-04",0,0,0,0,0,0,0,0
"Guadeloupe","2024-09-05",0,0,0,0,0,0,0,0
"Guadeloupe","2024-09-06",0,0,0,0,0,0,0,0
"Guadeloupe","2024-09-07",0,0,0,0,0,0,0,0
"Guadeloupe","2024-09-08",0,0,0,0,0,0,0,0
"Guadeloupe","2024-09-09",0,0,0,0,0,0,0,0
"Guadeloupe","2024-09-10",0,0,0,0,0,0,0,0
"Guadeloupe","2024-09-11",0,0,0,0,0,0,0,0
"Guadeloupe","2024-09-12",0,0,0,0,0,0,0,0
"Guadeloupe","2024-09-13",0,0,0,0,0,0,0,0
"Guadeloupe","2024-09-14",0,0,0,0,0,0,0,0
"Guadeloupe","2024-09-15",0,0,0,0,0,0,0,0
"Guadeloupe","2024-09-16",0,0,0,0,0,0,0,0
"Guadeloupe","2024-09-17",0,0,0,0,0,0,0,0
"Guadeloupe","2024-09-18",0,0,0,0,0,0,0,0
"Guadeloupe","2024-09-19",0,0,0,0,0,0,0,0
"Guadeloupe","2024-09-20",0,0,0,0,0,0,0,0
"Guadeloupe","2024-09-21",0,0,0,0,0,0,0,0
"Guadeloupe","2024-09-22",0,0,0,0,0,0,0,0
"Guadeloupe","2024-09-23",0,0,0,0,0,0,0,0
"Guadeloupe","2024-09-24",0,0,0,0,0,0,0,0
"Guadeloupe","2024-09-25",0,0,0,0,0,0,0,0
"Guadeloupe","2024-09-26",0,0,0,0,0,0,0,0
"Guadeloupe","2024-09-27",0,0,0,0,0,0,0,0
"Guadeloupe","2024-09-28",0,0,0,0,0,0,0,0
"Guadeloupe","2024-09-29",0,0,0,0,0,0,0,0
"Guadeloupe","2024-09-30",0,0,0,0,0,0,0,0
"Guadeloupe","2024-10-01",0,0,0,0,0,0,0,0
"Guadeloupe","2024-10-02",0,0,0,0,0,0,0,0
"Guadeloupe","2024-10-03",0,0,0,0,0,0,0,0
"Guadeloupe","2024-10-04",0,0,0,0,0,0,0,0
"Guadeloupe","2024-10-05",0,0,0,0,0,0,0,0
"Guadeloupe","2024-10-06",0,0,0,0,0,0,0,0
"Guadeloupe","2024-10-07",0,0,0,0,0,0,0,0
"Guadeloupe","2024-10-08",0,0,0,0,0,0,0,0
"Guadeloupe","2024-10-09",0,0,0,0,0,0,0,0
"Guadeloupe","2024-10-10",0,0,0,0,0,0,0,0
"Guadeloupe","2024-10-11",0,0,0,0,0,0,0,0
"Guadeloupe","2024-10-12",0,0,0,0,0,0,0,0
"Guadeloupe","2024-10-13",0,0,0,0,0,0,0,0
"Guadeloupe","2024-10-14",0,0,0,0,0,0,0,0
"Guadeloupe","2024-10-15",0,0,0,0,0,0,0,0
"Guadeloupe","2024-10-16",0,0,0,0,0,0,0,0
"Guadeloupe","2024-10-17",0,0,0,0,0,0,0,0
"Guadeloupe","2024-10-18",0,0,0,0,0,0,0,0
"Guadeloupe","2024-10-19",0,0,0,0,0,0,0,0
"Guadeloupe","2024-10-20",0,0,0,0,0,0,0,0
"Guadeloupe","2024-10-21",0,0,0,0,0,0,0,0
"Guadeloupe","2024-10-22",0,0,0,0,0,0,0,0
"Guadeloupe","2024-10-23",0,0,0,0,0,0,0,0
"Guadeloupe","2024-10-24",0,0,0,0,0,0,0,0
"Guadeloupe","2024-10-25",0,0,0,0,0,0,0,0
"Guadeloupe","2024-10-26",0,0,0,0,0,0,0,0
"Guadeloupe","2024-10-27",0,0,0,0,0,0,0,0
"Guadeloupe","2024-10-28",0,0,0,0,0,0,0,0
"Guadeloupe","2024-10-29",0,0,0,0,0,0,0,0
"Guadeloupe","2024-10-30",0,0,0,0,0,0,0,0
"Guadeloupe","2024-10-31",0,0,0,0,0,0,0,0
"Guadeloupe","2024-11-01",0,0,0,0,0,0,0,0
"Guadeloupe","2024-11-02",0,0,0,0,0,0,0,0
"Guadeloupe","2024-11-03",0,0,0,0,0,0,0,0
"Guadeloupe","2024-11-04",0,0,0,0,0,0,0,0
"Guadeloupe","2024-11-05",0,0,0,0,0,0,0,0
"Guadeloupe","2024-11-06",0,0,0,0,0,0,0,0
"Guadeloupe","2024-11-07",0,0,0,0,0,0,0,0
"Guadeloupe","2024-11-08",0,0,0,0,0,0,0,0
"Guadeloupe","2024-11-09",0,0,0,0,0,0,0,0
"Guadeloupe","2024-11-10",0,0,0,0,0,0,0,0
"Guadeloupe","2024-11-11",0,0,0,0,0,0,0,0
"Guadeloupe","2024-11-12",0,0,0,0,0,0,0,0
"Guadeloupe","2024-11-13",0,0,0,0,0,0,0,0
"Guadeloupe","2024-11-14",0,0,0,0,0,0,0,0
"Guadeloupe","2024-11-15",0,0,0,0,0,0,0,0
"Guadeloupe","2024-11-16",0,0,0,0,0,0,0,0
"Guadeloupe","2024-11-17",0,0,0,0,0,0,0,0
"Guadeloupe","2024-11-18",0,0,0,0,0,0,0,0
"Guadeloupe","2024-11-19",0,0,0,0,0,0,0,0
"Guadeloupe","2024-11-20",0,0,0,0,0,0,0,0
"Guadeloupe","2024-11-21",0,0,0,0,0,0,0,0
"Guadeloupe","2024-11-22",0,0,0,0,0,0,0,0
"Guadeloupe","2024-11-23",0,0,0,0,0,0,0,0
"Guadeloupe","2024-11-24",0,0,0,0,0,0,0,0
"Guadeloupe","2024-11-25",0,0,0,0,0,0,0,0
"Guadeloupe","2024-11-26",0,0,0,0,0,0,0,0
"Guadeloupe","2024-11-27",0,0,0,0,0,0,0,0
"Guadeloupe","2024-11-28",0,0,0,0,0,0,0,0
"Guadeloupe","2024-11-29",0,0,0,0,0,0,0,0
"Guadeloupe","2024-11-30",0,0,0,0,0,0,0,0
"Guadeloupe","2024-12-01",0,0,0,0,0,0,0,0
"Guadeloupe","2024-12-02",0,0,0,0,0,0,0,0
"Guadeloupe","2024-12-03",0,0,0,0,0,0,0,0
"Guadeloupe","2024-12-04",0,0,0,0,0,0,0,0
"Guadeloupe","2024-12-05",0,0,0,0,0,0,0,0
"Guadeloupe","2024-12-06",0,0,0,0,0,0,0,0
"Guadeloupe","2024-12-07",0,0,0,0,0,0,0,0
"Guadeloupe","2024-12-08",0,0,0,0,0,0,0,0
"Guadeloupe","2024-12-09",0,0,0,0,0,0,0,0
"Guadeloupe","2024-12-10",0,0,0,0,0,0,0,0
"Guadeloupe","2024-12-11",0,0,0,0,0,0,0,0
"Guadeloupe","2024-12-12",0,0,0,0,0,0,0,0
"Guadeloupe","2024-12-13",0,0,0,0,0,0,0,0
"Guadeloupe","2024-12-14",0,0,0,0,0,0,0,0
"Guadeloupe","2024-12-15",0,0,0,0,0,0,0,0
"Guadeloupe","2024-12-16",0,0,0,0,0,0,0,0
"Guadeloupe","2024-12-17",0,0,0,0,0,0,0,0
"Guadeloupe","2024-12-18",0,0,0,0,0,0,0,0
"Guadeloupe","2024-12-19",0,0,0,0,0,0,0,0
"Guadeloupe","2024-12-20",0,0,0,0,0,0,0,0
"Guadeloupe","2024-12-21",0,0,0,0,0,0,0,0
"Guadeloupe","2024-12-22",0,0,0,0,0,0,0,0
"Guadeloupe","2024-12-23",0,0,0,0,0,0,0,0
"Guadeloupe","2024-12-24",0,0,0,0,0,0,0,0
"Guadeloupe","2024-12-25",0,0,0,0,0,0,0,0
"Guadeloupe","2024-12-26",0,0,0,0,0,0,0,0
"Guadeloupe","2024-12-27",0,0,0,0,0,0,0,0
"Guadeloupe","2024-12-28",0,0,0,0,0,0,0,0
"Guadeloupe","2024-12-29",0,0,0,0,0,0,0,0
"Guadeloupe","2024-12-30",0,0,0,0,0,0,0,0
"Guadeloupe","2024-12-31",0,0,0,0,0,0,0,0
"Guadeloupe","2025-01-01",0,0,0,0,0,0,0,0
"Guadeloupe","2025-01-02",0,0,0,0,0,0,0,0
"Guadeloupe","2025-01-03",0,0,0,0,0,0,0,0
"Guadeloupe","2025-01-04",0,0,0,0,0,0,0,0
"Guadeloupe","2025-01-05",0,0,0,0,0,0,0,0
"Guadeloupe","2025-01-06",0,0,0,0,0,0,0,0
"Guadeloupe","2025-01-07",0,0,0,0,0,0,0,0
"Guadeloupe","2025-01-08",0,0,0,0,0,0,0,0
"Guadeloupe","2025-01-09",0,0,0,0,0,0,0,0
"Guadeloupe","2025-01-10",0,0,0,0,0,0,0,0
"Guadeloupe","2025-01-11",0,0,0,0,0,0,0,0
"Guadeloupe","2025-01-12",0,0,0,0,0,0,0,0
"Guadeloupe","2025-01-13",0,0,0,0,0,0,0,0
"Guadeloupe","2025-01-14",0,0,0,0,0,0,0,0
"Guadeloupe","2025-01-15",0,0,0,0,0,0,0,0
"Guadeloupe","2025-01-16",0,0,0,0,0,0,0,0
"Guadeloupe","2025-01-17",0,0,0,0,0,0,0,0
"Guadeloupe","2025-01-18",0,0,0,0,0,0,0,0
"Guadeloupe","2025-01-19",0,0,0,0,0,0,0,0
"Guadeloupe","2025-01-20",0,0,0,0,0,0,0,0
"Guadeloupe","2025-01-21",0,0,0,0,0,0,0,0
"Guadeloupe","2025-01-22",0,0,0,0,0,0,0,0
"Guadeloupe","2025-01-23",0,0,0,0,0,0,0,0
"Guadeloupe","2025-01-24",0,0,0,0,0,0,0,0
"Guadeloupe","2025-01-25",0,0,0,0,0,0,0,0
"Guadeloupe","2025-01-26",0,0,0,0,0,0,0,0
"Guadeloupe","2025-01-27",0,0,0,0,0,0,0,0
"Guadeloupe","2025-01-28",0,0,0,0,0,0,0,0
"Guadeloupe","2025-01-29",0,0,0,0,0,0,0,0
"Guadeloupe","2025-01-30",0,0,0,0,0,0,0,0
"Guadeloupe","2025-01-31",0,0,0,0,0,0,0,0
"Guadeloupe","2025-02-01",0,0,0,0,0,0,0,0
"Guadeloupe","2025-02-02",0,0,0,0,0,0,0,0
"Guadeloupe","2025-02-03",0,0,0,0,0,0,0,0
"Guadeloupe","2025-02-04",0,0,0,0,0,0,0,0
"Guadeloupe","2025-02-05",0,0,0,0,0,0,0,0
"Guadeloupe","2025-02-06",0,0,0,0,0,0,0,0
"Guadeloupe","2025-02-07",0,0,0,0,0,0,0,0
"Guadeloupe","2025-02-08",0,0,0,0,0,0,0,0
"Guadeloupe","2025-02-09",0,0,0,0,0,0,0,0
"Guadeloupe","2025-02-10",0,0,0,0,0,0,0,0
"Guadeloupe","2025-02-11",0,0,0,0,0,0,0,0
"Guadeloupe","2025-02-12",0,0,0,0,0,0,0,0
"Guadeloupe","2025-02-13",0,0,0,0,0,0,0,0
"Guadeloupe","2025-02-14",0,0,0,0,0,0,0,0
"Guadeloupe","2025-02-15",0,0,0,0,0,0,0,0
"Guadeloupe","2025-02-16",0,0,0,0,0,0,0,0
"Guadeloupe","2025-02-17",0,0,0,0,0,0,0,0
"Guadeloupe","2025-02-18",0,0,0,0,0,0,0,0
"Guadeloupe","2025-02-19",0,0,0,0,0,0,0,0
"Guadeloupe","2025-02-20",0,0,0,0,0,0,0,0
"Guadeloupe","2025-02-21",0,0,0,0,0,0,0,0
"Guadeloupe","2025-02-22",0,0,0,0,0,0,0,0
"Guadeloupe","2025-02-23",0,0,0,0,0,0,0,0
"Guadeloupe","2025-02-24",0,0,0,0,0,0,0,0
"Guadeloupe","2025-02-25",0,0,0,0,0,0,0,0
"Guadeloupe","2025-02-26",0,0,0,0,0,0,0,0
"Guadeloupe","2025-02-27",0,0,0,0,0,0,0,0
"Guadeloupe","2025-02-28",0,0,0,0,0,0,0,0
"Guadeloupe","2025-03-01",0,0,0,0,0,0,0,0
"Guadeloupe","2025-03-02",0,0,0,0,0,0,0,0
"Guadeloupe","2025-03-03",0,0,0,0,0,0,0,0
"Guatemala","2024-01-01",0,0,0,0,0,0,0,0
"Guatemala","2024-01-02",0,0,0,0,0,0,0,0
"Guatemala","2024-01-03",0,0,0,0,0,0,0,0
"Guatemala","2024-01-04",0,0,0,0,0,0,0,0
"Guatemala","2024-01-05",0,0,0,0,0,0,0,0
"Guatemala","2024-01-06",0,0,0,0,0,0,0,0
"Guatemala","2024-01-07",0,0,0,0,0,0,0,0
"Guatemala","2024-01-08",0,0,0,0,0,0,0,0
"Guatemala","2024-01-09",0,0,0,0,0,0,0,0
"Guatemala","2024-01-10",0,0,0,0,0,0,0,0
"Guatemala","2024-01-11",0,0,0,0,0,0,0,0
"Guatemala","2024-01-12",0,0,0,0,0,0,0,0
"Guatemala","2024-01-13",0,0,0,0,0,0,0,0
"Guatemala","2024-01-14",0,0,0,0,0,0,0,0
"Guatemala","2024-01-15",0,0,0,0,0,0,0,0
"Guatemala","2024-01-16",0,0,0,0,0,0,0,0
"Guatemala","2024-01-17",0,0,0,0,0,0,0,0
"Guatemala","2024-01-18",0,0,0,0,0,0,0,0
"Guatemala","2024-01-19",0,0,0,0,0,0,0,0
"Guatemala","2024-01-20",0,0,0,0,0,0,0,0
"Guatemala","2024-01-21",0,0,0,0,0,0,0,0
"Guatemala","2024-01-22",0,0,0,0,0,0,0,0
"Guatemala","2024-01-23",0,1,1,0,1,1,0,0
"Guatemala","2024-01-24",0,0,1,0,0,1,0,0
"Guatemala","2024-01-25",0,0,1,0,0,1,0,0
"Guatemala","2024-01-26",0,0,1,0,0,1,0,0
"Guatemala","2024-01-27",0,0,1,0,0,1,0,0
"Guatemala","2024-01-28",0,0,1,0,0,1,0,0
"Guatemala","2024-01-29",0,0,1,0,0,1,0,0
"Guatemala","2024-01-30",0,0,1,0,0,1,0,0
"Guatemala","2024-01-31",0,0,1,0,0,1,0,0
"Guatemala","2024-02-01",0,0,1,0,0,1,0,0
"Guatemala","2024-02-02",0,0,1,0,0,1,0,0
"Guatemala","2024-02-03",0,0,1,0,0,1,0,0
"Guatemala","2024-02-04",0,0,1,0,0,1,0,0
"Guatemala","2024-02-05",0,0,1,0,0,1,0,0
"Guatemala","2024-02-06",0,0,1,0,0,1,0,0
"Guatemala","2024-02-07",0,0,1,0,0,1,0,0
"Guatemala","2024-02-08",0,0,1,0,0,1,0,0
"Guatemala","2024-02-09",0,0,1,0,0,1,0,0
"Guatemala","2024-02-10",0,0,1,0,0,1,0,0
"Guatemala","2024-02-11",0,0,1,0,0,1,0,0
"Guatemala","2024-02-12",0,0,1,0,0,1,0,0
"Guatemala","2024-02-13",0,0,1,0,0,1,0,0
"Guatemala","2024-02-14",0,0,1,0,0,1,0,0
"Guatemala","2024-02-15",0,0,1,0,0,1,0,0
"Guatemala","2024-02-16",0,0,1,0,0,1,0,0
"Guatemala","2024-02-17",0,0,1,0,0,1,0,0
"Guatemala","2024-02-18",0,0,1,0,0,1,0,0
"Guatemala","2024-02-19",0,0,1,0,0,1,0,0
"Guatemala","2024-02-20",0,0,1,0,0,1,0,0
"Guatemala","2024-02-21",0,0,1,0,0,1,0,0
"Guatemala","2024-02-22",0,0,1,0,0,1,0,0
"Guatemala","2024-02-23",0,0,1,0,0,1,0,0
"Guatemala","2024-02-24",0,0,1,0,0,1,0,0
"Guatemala","2024-02-25",0,0,1,0,0,1,0,0
"Guatemala","2024-02-26",0,0,1,0,0,1,0,0
"Guatemala","2024-02-27",0,0,1,0,0,1,0,0
"Guatemala","2024-02-28",0,0,1,0,0,1,0,0
"Guatemala","2024-02-29",0,0,1,0,0,1,0,0
"Guatemala","2024-03-01",0,0,1,0,0,1,0,0
"Guatemala","2024-03-02",0,0,1,0,0,1,0,0
"Guatemala","2024-03-03",0,0,1,0,0,1,0,0
"Guatemala","2024-03-04",0,0,1,0,0,1,0,0
"Guatemala","2024-03-05",0,0,1,0,0,1,0,0
"Guatemala","2024-03-06",0,0,1,0,0,1,0,0
"Guatemala","2024-03-07",0,0,1,0,0,1,0,0
"Guatemala","2024-03-08",0,0,1,0,0,1,0,0
"Guatemala","2024-03-09",0,0,1,0,0,1,0,0
"Guatemala","2024-03-10",0,0,1,0,0,1,0,0
"Guatemala","2024-03-11",0,0,1,0,0,1,0,0
"Guatemala","2024-03-12",0,0,1,0,0,1,0,0
"Guatemala","2024-03-13",0,0,1,0,0,1,0,0
"Guatemala","2024-03-14",0,0,1,0,0,1,0,0
"Guatemala","2024-03-15",0,0,1,0,0,1,0,0
"Guatemala","2024-03-16",0,0,1,0,0,1,0,0
"Guatemala","2024-03-17",0,0,1,0,0,1,0,0
"Guatemala","2024-03-18",0,0,1,0,0,1,0,0
"Guatemala","2024-03-19",0,0,1,0,0,1,0,0
"Guatemala","2024-03-20",0,0,1,0,0,1,0,0
"Guatemala","2024-03-21",0,0,1,0,0,1,0,0
"Guatemala","2024-03-22",0,0,1,0,0,1,0,0
"Guatemala","2024-03-23",0,0,1,0,0,1,0,0
"Guatemala","2024-03-24",0,0,1,0,0,1,0,0
"Guatemala","2024-03-25",0,0,1,0,0,1,0,0
"Guatemala","2024-03-26",0,0,1,0,0,1,0,0
"Guatemala","2024-03-27",0,0,1,0,0,1,0,0
"Guatemala","2024-03-28",0,0,1,0,0,1,0,0
"Guatemala","2024-03-29",0,0,1,0,0,1,0,0
"Guatemala","2024-03-30",0,0,1,0,0,1,0,0
"Guatemala","2024-03-31",0,0,1,0,0,1,0,0
"Guatemala","2024-04-01",0,0,1,0,0,1,0,0
"Guatemala","2024-04-02",0,0,1,0,0,1,0,0
"Guatemala","2024-04-03",0,0,1,0,0,1,0,0
"Guatemala","2024-04-04",0,0,1,0,0,1,0,0
"Guatemala","2024-04-05",0,0,1,0,0,1,0,0
"Guatemala","2024-04-06",0,0,1,0,0,1,0,0
"Guatemala","2024-04-07",0,0,1,0,0,1,0,0
"Guatemala","2024-04-08",0,0,1,0,0,1,0,0
"Guatemala","2024-04-09",0,0,1,0,0,1,0,0
"Guatemala","2024-04-10",0,0,1,0,0,1,0,0
"Guatemala","2024-04-11",0,0,1,0,0,1,0,0
"Guatemala","2024-04-12",0,0,1,0,0,1,0,0
"Guatemala","2024-04-13",0,0,1,0,0,1,0,0
"Guatemala","2024-04-14",0,0,1,0,0,1,0,0
"Guatemala","2024-04-15",0,0,1,0,0,1,0,0
"Guatemala","2024-04-16",0,0,1,0,0,1,0,0
"Guatemala","2024-04-17",0,0,1,0,0,1,0,0
"Guatemala","2024-04-18",0,0,1,0,0,1,0,0
"Guatemala","2024-04-19",0,0,1,0,0,1,0,0
"Guatemala","2024-04-20",0,0,1,0,0,1,0,0
"Guatemala","2024-04-21",0,0,1,0,0,1,0,0
"Guatemala","2024-04-22",0,0,1,0,0,1,0,0
"Guatemala","2024-04-23",0,0,1,0,0,1,0,0
"Guatemala","2024-04-24",0,0,1,0,0,1,0,0
"Guatemala","2024-04-25",0,0,1,0,0,1,0,0
"Guatemala","2024-04-26",0,0,1,0,0,1,0,0
"Guatemala","2024-04-27",0,0,1,0,0,1,0,0
"Guatemala","2024-04-28",0,0,1,0,0,1,0,0
"Guatemala","2024-04-29",0,0,1,0,0,1,0,0
"Guatemala","2024-04-30",0,0,1,0,0,1,0,0
"Guatemala","2024-05-01",0,0,1,0,0,1,0,0
"Guatemala","2024-05-02",0,0,1,0,0,1,0,0
"Guatemala","2024-05-03",0,0,1,0,0,1,0,0
"Guatemala","2024-05-04",0,0,1,0,0,1,0,0
"Guatemala","2024-05-05",0,0,1,0,0,1,0,0
"Guatemala","2024-05-06",0,0,1,0,0,1,0,0
"Guatemala","2024-05-07",0,0,1,0,0,1,0,0
"Guatemala","2024-05-08",0,0,1,0,0,1,0,0
"Guatemala","2024-05-09",0,0,1,0,0,1,0,0
"Guatemala","2024-05-10",0,0,1,0,0,1,0,0
"Guatemala","2024-05-11",0,0,1,0,0,1,0,0
"Guatemala","2024-05-12",0,0,1,0,0,1,0,0
"Guatemala","2024-05-13",0,0,1,0,0,1,0,0
"Guatemala","2024-05-14",0,0,1,0,0,1,0,0
"Guatemala","2024-05-15",0,0,1,0,0,1,0,0
"Guatemala","2024-05-16",0,0,1,0,0,1,0,0
"Guatemala","2024-05-17",0,0,1,0,0,1,0,0
"Guatemala","2024-05-18",0,0,1,0,0,1,0,0
"Guatemala","2024-05-19",0,0,1,0,0,1,0,0
"Guatemala","2024-05-20",0,0,1,0,0,1,0,0
"Guatemala","2024-05-21",0,0,1,0,0,1,0,0
"Guatemala","2024-05-22",0,0,1,0,0,1,0,0
"Guatemala","2024-05-23",0,0,1,0,0,1,0,0
"Guatemala","2024-05-24",0,0,1,0,0,1,0,0
"Guatemala","2024-05-25",0,0,1,0,0,1,0,0
"Guatemala","2024-05-26",0,0,1,0,0,1,0,0
"Guatemala","2024-05-27",0,0,1,0,0,1,0,0
"Guatemala","2024-05-28",0,0,1,0,0,1,0,0
"Guatemala","2024-05-29",0,0,1,0,0,1,0,0
"Guatemala","2024-05-30",0,0,1,0,0,1,0,0
"Guatemala","2024-05-31",0,0,1,0,0,1,0,0
"Guatemala","2024-06-01",0,0,1,0,0,1,0,0
"Guatemala","2024-06-02",0,0,1,0,0,1,0,0
"Guatemala","2024-06-03",0,0,1,0,0,1,0,0
"Guatemala","2024-06-04",0,0,1,0,0,1,0,0
"Guatemala","2024-06-05",0,0,1,0,0,1,0,0
"Guatemala","2024-06-06",0,0,1,0,0,1,0,0
"Guatemala","2024-06-07",0,0,1,0,0,1,0,0
"Guatemala","2024-06-08",0,0,1,0,0,1,0,0
"Guatemala","2024-06-09",0,0,1,0,0,1,0,0
"Guatemala","2024-06-10",0,0,1,0,0,1,0,0
"Guatemala","2024-06-11",0,0,1,0,0,1,0,0
"Guatemala","2024-06-12",0,0,1,0,0,1,0,0
"Guatemala","2024-06-13",0,0,1,0,0,1,0,0
"Guatemala","2024-06-14",0,0,1,0,0,1,0,0
"Guatemala","2024-06-15",0,0,1,0,1,2,0,0
"Guatemala","2024-06-16",0,0,1,0,0,2,0,0
"Guatemala","2024-06-17",0,0,1,0,0,2,0,0
"Guatemala","2024-06-18",0,0,1,0,0,2,0,0
"Guatemala","2024-06-19",0,0,1,0,0,2,0,0
"Guatemala","2024-06-20",0,0,1,0,0,2,0,0
"Guatemala","2024-06-21",0,0,1,0,0,2,0,0
"Guatemala","2024-06-22",0,0,1,0,0,2,0,0
"Guatemala","2024-06-23",0,0,1,0,0,2,0,0
"Guatemala","2024-06-24",0,0,1,0,0,2,0,0
"Guatemala","2024-06-25",0,0,1,0,0,2,0,0
"Guatemala","2024-06-26",0,0,1,0,0,2,0,0
"Guatemala","2024-06-27",0,0,1,0,0,2,0,0
"Guatemala","2024-06-28",0,0,1,0,0,2,0,0
"Guatemala","2024-06-29",0,0,1,0,0,2,0,0
"Guatemala","2024-06-30",0,0,1,0,0,2,0,0
"Guatemala","2024-07-01",0,0,1,0,0,2,0,0
"Guatemala","2024-07-02",0,0,1,0,0,2,0,0
"Guatemala","2024-07-03",0,0,1,0,0,2,0,0
"Guatemala","2024-07-04",0,0,1,0,0,2,0,0
"Guatemala","2024-07-05",0,0,1,0,0,2,0,0
"Guatemala","2024-07-06",0,0,1,0,0,2,0,0
"Guatemala","2024-07-07",0,0,1,0,0,2,0,0
"Guatemala","2024-07-08",0,0,1,0,0,2,0,0
"Guatemala","2024-07-09",0,0,1,0,0,2,0,0
"Guatemala","2024-07-10",0,0,1,0,0,2,0,0
"Guatemala","2024-07-11",0,0,1,0,0,2,0,0
"Guatemala","2024-07-12",0,0,1,0,0,2,0,0
"Guatemala","2024-07-13",0,0,1,0,0,2,0,0
"Guatemala","2024-07-14",0,0,1,0,0,2,0,0
"Guatemala","2024-07-15",0,0,1,0,0,2,0,0
"Guatemala","2024-07-16",0,0,1,0,0,2,0,0
"Guatemala","2024-07-17",0,0,1,0,0,2,0,0
"Guatemala","2024-07-18",0,0,1,0,0,2,0,0
"Guatemala","2024-07-19",0,0,1,0,0,2,0,0
"Guatemala","2024-07-20",0,0,1,0,0,2,0,0
"Guatemala","2024-07-21",0,0,1,0,0,2,0,0
"Guatemala","2024-07-22",0,0,1,0,0,2,0,0
"Guatemala","2024-07-23",0,0,1,0,0,2,0,0
"Guatemala","2024-07-24",0,0,1,0,0,2,0,0
"Guatemala","2024-07-25",0,0,1,0,0,2,0,0
"Guatemala","2024-07-26",0,0,1,0,0,2,0,0
"Guatemala","2024-07-27",0,0,1,0,0,2,0,0
"Guatemala","2024-07-28",0,0,1,0,0,2,0,0
"Guatemala","2024-07-29",0,0,1,0,0,2,0,0
"Guatemala","2024-07-30",0,0,1,0,0,2,0,0
"Guatemala","2024-07-31",0,0,1,0,0,2,0,0
"Guatemala","2024-08-01",0,0,1,0,0,2,0,0
"Guatemala","2024-08-02",0,0,1,0,0,2,0,0
"Guatemala","2024-08-03",0,0,1,0,0,2,0,0
"Guatemala","2024-08-04",0,0,1,0,0,2,0,0
"Guatemala","2024-08-05",0,0,1,0,0,2,0,0
"Guatemala","2024-08-06",0,0,1,0,0,2,0,0
"Guatemala","2024-08-07",0,0,1,0,0,2,0,0
"Guatemala","2024-08-08",0,0,1,0,0,2,0,0
"Guatemala","2024-08-09",0,0,1,0,0,2,0,0
"Guatemala","2024-08-10",0,0,1,0,0,2,0,0
"Guatemala","2024-08-11",0,0,1,0,0,2,0,0
"Guatemala","2024-08-12",0,0,1,0,0,2,0,0
"Guatemala","2024-08-13",0,0,1,0,0,2,0,0
"Guatemala","2024-08-14",0,0,1,0,0,2,0,0
"Guatemala","2024-08-15",0,0,1,0,0,2,0,0
"Guatemala","2024-08-16",0,0,1,0,0,2,0,0
"Guatemala","2024-08-17",0,0,1,0,0,2,0,0
"Guatemala","2024-08-18",0,0,1,0,0,2,0,0
"Guatemala","2024-08-19",0,0,1,0,0,2,0,0
"Guatemala","2024-08-20",0,0,1,0,0,2,0,0
"Guatemala","2024-08-21",0,0,1,0,0,2,0,0
"Guatemala","2024-08-22",0,0,1,0,0,2,0,0
"Guatemala","2024-08-23",0,0,1,0,0,2,0,0
"Guatemala","2024-08-24",0,0,1,0,0,2,0,0
"Guatemala","2024-08-25",0,0,1,0,0,2,0,0
"Guatemala","2024-08-26",0,0,1,0,0,2,0,0
"Guatemala","2024-08-27",0,0,1,0,0,2,0,0
"Guatemala","2024-08-28",0,0,1,0,0,2,0,0
"Guatemala","2024-08-29",0,0,1,0,0,2,0,0
"Guatemala","2024-08-30",0,0,1,0,0,2,0,0
"Guatemala","2024-08-31",0,0,1,0,0,2,0,0
"Guatemala","2024-09-01",0,0,1,0,0,2,0,0
"Guatemala","2024-09-02",0,0,1,0,0,2,0,0
"Guatemala","2024-09-03",0,0,1,0,0,2,0,0
"Guatemala","2024-09-04",0,0,1,0,0,2,0,0
"Guatemala","2024-09-05",0,0,1,0,0,2,0,0
"Guatemala","2024-09-06",0,0,1,0,0,2,0,0
"Guatemala","2024-09-07",0,0,1,0,0,2,0,0
"Guatemala","2024-09-08",0,0,1,0,0,2,0,0
"Guatemala","2024-09-09",0,0,1,0,0,2,0,0
"Guatemala","2024-09-10",0,0,1,0,0,2,0,0
"Guatemala","2024-09-11",0,0,1,0,0,2,0,0
"Guatemala","2024-09-12",0,0,1,0,0,2,0,0
"Guatemala","2024-09-13",0,0,1,0,0,2,0,0
"Guatemala","2024-09-14",0,0,1,0,0,2,0,0
"Guatemala","2024-09-15",0,0,1,0,0,2,0,0
"Guatemala","2024-09-16",0,0,1,0,0,2,0,0
"Guatemala","2024-09-17",0,0,1,0,0,2,0,0
"Guatemala","2024-09-18",0,0,1,0,0,2,0,0
"Guatemala","2024-09-19",0,0,1,0,0,2,0,0
"Guatemala","2024-09-20",0,0,1,0,0,2,0,0
"Guatemala","2024-09-21",0,0,1,0,0,2,0,0
"Guatemala","2024-09-22",0,0,1,0,0,2,0,0
"Guatemala","2024-09-23",0,0,1,0,0,2,0,0
"Guatemala","2024-09-24",0,0,1,0,0,2,0,0
"Guatemala","2024-09-25",0,0,1,0,0,2,0,0
"Guatemala","2024-09-26",0,0,1,0,0,2,0,0
"Guatemala","2024-09-27",0,0,1,0,0,2,0,0
"Guatemala","2024-09-28",0,0,1,0,0,2,0,0
"Guatemala","2024-09-29",0,0,1,0,0,2,0,0
"Guatemala","2024-09-30",0,0,1,0,0,2,0,0
"Guatemala","2024-10-01",0,0,1,0,0,2,0,0
"Guatemala","2024-10-02",0,0,1,0,0,2,0,0
"Guatemala","2024-10-03",0,0,1,0,0,2,0,0
"Guatemala","2024-10-04",0,0,1,0,0,2,0,0
"Guatemala","2024-10-05",0,0,1,0,0,2,0,0
"Guatemala","2024-10-06",0,0,1,0,0,2,0,0
"Guatemala","2024-10-07",0,0,1,0,0,2,0,0
"Guatemala","2024-10-08",0,0,1,0,0,2,0,0
"Guatemala","2024-10-09",0,0,1,0,0,2,0,0
"Guatemala","2024-10-10",0,0,1,0,0,2,0,0
"Guatemala","2024-10-11",0,0,1,0,0,2,0,0
"Guatemala","2024-10-12",0,0,1,0,0,2,0,0
"Guatemala","2024-10-13",0,0,1,0,0,2,0,0
"Guatemala","2024-10-14",0,0,1,0,0,2,0,0
"Guatemala","2024-10-15",0,0,1,0,0,2,0,0
"Guatemala","2024-10-16",0,0,1,0,0,2,0,0
"Guatemala","2024-10-17",0,0,1,0,0,2,0,0
"Guatemala","2024-10-18",0,0,1,0,0,2,0,0
"Guatemala","2024-10-19",0,0,1,0,0,2,0,0
"Guatemala","2024-10-20",0,0,1,0,0,2,0,0
"Guatemala","2024-10-21",0,0,1,0,0,2,0,0
"Guatemala","2024-10-22",0,0,1,0,0,2,0,0
"Guatemala","2024-10-23",0,0,1,0,0,2,0,0
"Guatemala","2024-10-24",0,0,1,0,0,2,0,0
"Guatemala","2024-10-25",0,0,1,0,0,2,0,0
"Guatemala","2024-10-26",0,0,1,0,0,2,0,0
"Guatemala","2024-10-27",0,0,1,0,0,2,0,0
"Guatemala","2024-10-28",0,0,1,0,0,2,0,0
"Guatemala","2024-10-29",0,0,1,0,0,2,0,0
"Guatemala","2024-10-30",0,0,1,0,0,2,0,0
"Guatemala","2024-10-31",0,0,1,0,0,2,0,0
"Guatemala","2024-11-01",0,0,1,0,0,2,0,0
"Guatemala","2024-11-02",0,0,1,0,0,2,0,0
"Guatemala","2024-11-03",0,0,1,0,0,2,0,0
"Guatemala","2024-11-04",0,0,1,0,0,2,0,0
"Guatemala","2024-11-05",0,1,2,0,0,2,0,0
"Guatemala","2024-11-06",0,0,2,0,0,2,0,0
"Guatemala","2024-11-07",0,0,2,0,0,2,0,0
"Guatemala","2024-11-08",0,0,2,0,0,2,0,0
"Guatemala","2024-11-09",0,0,2,0,0,2,0,0
"Guatemala","2024-11-10",0,0,2,0,0,2,0,0
"Guatemala","2024-11-11",0,0,2,0,0,2,0,0
"Guatemala","2024-11-12",0,0,2,0,0,2,0,0
"Guatemala","2024-11-13",0,0,2,0,0,2,0,0
"Guatemala","2024-11-14",0,0,2,0,0,2,0,0
"Guatemala","2024-11-15",0,0,2,0,0,2,0,0
"Guatemala","2024-11-16",0,0,2,0,0,2,0,0
"Guatemala","2024-11-17",0,0,2,0,0,2,0,0
"Guatemala","2024-11-18",0,0,2,0,0,2,0,0
"Guatemala","2024-11-19",0,0,2,0,0,2,0,0
"Guatemala","2024-11-20",0,0,2,0,0,2,0,0
"Guatemala","2024-11-21",0,0,2,0,0,2,0,0
"Guatemala","2024-11-22",0,0,2,0,0,2,0,0
"Guatemala","2024-11-23",0,0,2,0,0,2,0,0
"Guatemala","2024-11-24",0,0,2,0,0,2,0,0
"Guatemala","2024-11-25",0,0,2,0,0,2,0,0
"Guatemala","2024-11-26",0,0,2,0,0,2,0,0
"Guatemala","2024-11-27",0,0,2,0,0,2,0,0
"Guatemala","2024-11-28",0,0,2,0,0,2,0,0
"Guatemala","2024-11-29",0,0,2,0,0,2,0,0
"Guatemala","2024-11-30",0,0,2,0,0,2,0,0
"Guatemala","2024-12-01",0,0,2,0,0,2,0,0
"Guatemala","2024-12-02",0,0,2,0,0,2,0,0
"Guatemala","2024-12-03",0,0,2,0,0,2,0,0
"Guatemala","2024-12-04",0,0,2,0,0,2,0,0
"Guatemala","2024-12-05",0,0,2,0,0,2,0,0
"Guatemala","2024-12-06",0,0,2,0,0,2,0,0
"Guatemala","2024-12-07",0,0,2,0,0,2,0,0
"Guatemala","2024-12-08",0,0,2,0,0,2,0,0
"Guatemala","2024-12-09",0,0,2,0,0,2,0,0
"Guatemala","2024-12-10",0,0,2,0,0,2,0,0
"Guatemala","2024-12-11",0,0,2,0,0,2,0,0
"Guatemala","2024-12-12",0,0,2,0,0,2,0,0
"Guatemala","2024-12-13",0,0,2,0,0,2,0,0
"Guatemala","2024-12-14",0,0,2,0,0,2,0,0
"Guatemala","2024-12-15",0,0,2,0,0,2,0,0
"Guatemala","2024-12-16",0,0,2,0,0,2,0,0
"Guatemala","2024-12-17",0,0,2,0,0,2,0,0
"Guatemala","2024-12-18",0,0,2,0,0,2,0,0
"Guatemala","2024-12-19",0,0,2,0,0,2,0,0
"Guatemala","2024-12-20",0,0,2,0,0,2,0,0
"Guatemala","2024-12-21",0,0,2,0,0,2,0,0
"Guatemala","2024-12-22",0,0,2,0,0,2,0,0
"Guatemala","2024-12-23",0,0,2,0,0,2,0,0
"Guatemala","2024-12-24",0,0,2,0,0,2,0,0
"Guatemala","2024-12-25",0,0,2,0,0,2,0,0
"Guatemala","2024-12-26",0,0,2,0,0,2,0,0
"Guatemala","2024-12-27",0,0,2,0,0,2,0,0
"Guatemala","2024-12-28",0,0,2,0,0,2,0,0
"Guatemala","2024-12-29",0,0,2,0,0,2,0,0
"Guatemala","2024-12-30",0,0,2,0,0,2,0,0
"Guatemala","2024-12-31",0,0,2,0,0,2,0,0
"Guatemala","2025-01-01",0,0,2,0,0,2,0,0
"Guatemala","2025-01-02",0,0,2,0,0,2,0,0
"Guatemala","2025-01-03",0,0,2,0,0,2,0,0
"Guatemala","2025-01-04",0,0,2,0,0,2,0,0
"Guatemala","2025-01-05",0,0,2,0,0,2,0,0
"Guatemala","2025-01-06",0,0,2,0,0,2,0,0
"Guatemala","2025-01-07",0,0,2,0,0,2,0,0
"Guatemala","2025-01-08",0,0,2,0,0,2,0,0
"Guatemala","2025-01-09",0,0,2,0,0,2,0,0
"Guatemala","2025-01-10",0,0,2,0,0,2,0,0
"Guatemala","2025-01-11",0,0,2,0,0,2,0,0
"Guatemala","2025-01-12",0,0,2,0,0,2,0,0
"Guatemala","2025-01-13",0,0,2,0,0,2,0,0
"Guatemala","2025-01-14",0,0,2,0,0,2,0,0
"Guatemala","2025-01-15",0,0,2,0,0,2,0,0
"Guatemala","2025-01-16",0,0,2,0,0,2,0,0
"Guatemala","2025-01-17",0,0,2,0,0,2,0,0
"Guatemala","2025-01-18",0,0,2,0,0,2,0,0
"Guatemala","2025-01-19",0,0,2,0,0,2,0,0
"Guatemala","2025-01-20",0,0,2,0,0,2,0,0
"Guatemala","2025-01-21",0,0,2,0,0,2,0,0
"Guatemala","2025-01-22",0,0,2,0,0,2,0,0
"Guatemala","2025-01-23",0,0,2,0,0,2,0,0
"Guatemala","2025-01-24",0,0,2,0,0,2,0,0
"Guatemala","2025-01-25",0,0,2,0,0,2,0,0
"Guatemala","2025-01-26",0,0,2,0,0,2,0,0
"Guatemala","2025-01-27",0,0,2,0,0,2,0,0
"Guatemala","2025-01-28",0,0,2,0,0,2,0,0
"Guatemala","2025-01-29",0,0,2,0,0,2,0,0
"Guatemala","2025-01-30",0,0,2,0,0,2,0,0
"Guatemala","2025-01-31",0,0,2,0,0,2,0,0
"Guatemala","2025-02-01",0,0,2,0,0,2,0,0
"Guatemala","2025-02-02",0,0,2,0,0,2,0,0
"Guatemala","2025-02-03",0,0,2,0,0,2,0,0
"Guatemala","2025-02-04",0,0,2,0,0,2,0,0
"Guatemala","2025-02-05",0,0,2,0,0,2,0,0
"Guatemala","2025-02-06",0,0,2,0,0,2,0,0
"Guatemala","2025-02-07",0,0,2,0,0,2,0,0
"Guatemala","2025-02-08",0,0,2,0,0,2,0,0
"Guatemala","2025-02-09",0,0,2,0,0,2,0,0
"Guatemala","2025-02-10",0,0,2,0,0,2,0,0
"Guatemala","2025-02-11",0,0,2,0,0,2,0,0
"Guatemala","2025-02-12",0,0,2,0,0,2,0,0
"Guatemala","2025-02-13",0,0,2,0,0,2,0,0
"Guatemala","2025-02-14",0,0,2,0,0,2,0,0
"Guatemala","2025-02-15",0,0,2,0,0,2,0,0
"Guatemala","2025-02-16",0,0,2,0,0,2,0,0
"Guatemala","2025-02-17",0,0,2,0,0,2,0,0
"Guatemala","2025-02-18",0,0,2,0,0,2,0,0
"Guatemala","2025-02-19",0,0,2,0,0,2,0,0
"Guatemala","2025-02-20",0,0,2,0,0,2,0,0
"Guatemala","2025-02-21",0,0,2,0,0,2,0,0
"Guatemala","2025-02-22",0,0,2,0,0,2,0,0
"Guatemala","2025-02-23",0,0,2,0,0,2,0,0
"Guatemala","2025-02-24",0,0,2,0,0,2,0,0
"Guatemala","2025-02-25",0,0,2,0,0,2,0,0
"Guatemala","2025-02-26",0,0,2,0,0,2,0,0
"Guatemala","2025-02-27",0,0,2,0,0,2,0,0
"Guatemala","2025-02-28",0,0,2,0,0,2,0,0
"Guatemala","2025-03-01",0,0,2,0,0,2,0,0
"Guatemala","2025-03-02",0,0,2,0,0,2,0,0
"Guatemala","2025-03-03",0,0,2,0,0,2,0,0
"Guinea","2024-01-01",0,0,0,0,0,0,0,0
"Guinea","2024-01-02",0,0,0,0,0,0,0,0
"Guinea","2024-01-03",0,0,0,0,0,0,0,0
"Guinea","2024-01-04",0,0,0,0,0,0,0,0
"Guinea","2024-01-05",0,0,0,0,0,0,0,0
"Guinea","2024-01-06",0,0,0,0,0,0,0,0
"Guinea","2024-01-07",0,0,0,0,0,0,0,0
"Guinea","2024-01-08",0,0,0,0,0,0,0,0
"Guinea","2024-01-09",0,1,1,0,1,1,0,0
"Guinea","2024-01-10",0,0,1,0,0,1,0,0
"Guinea","2024-01-11",0,0,1,0,0,1,0,0
"Guinea","2024-01-12",0,0,1,0,0,1,0,0
"Guinea","2024-01-13",0,0,1,0,0,1,0,0
"Guinea","2024-01-14",0,0,1,0,0,1,0,0
"Guinea","2024-01-15",0,0,1,0,0,1,0,0
"Guinea","2024-01-16",0,0,1,0,0,1,0,0
"Guinea","2024-01-17",0,0,1,0,0,1,0,0
"Guinea","2024-01-18",0,0,1,0,0,1,0,0
"Guinea","2024-01-19",0,0,1,0,0,1,0,0
"Guinea","2024-01-20",0,0,1,0,0,1,0,0
"Guinea","2024-01-21",0,0,1,0,0,1,0,0
"Guinea","2024-01-22",0,0,1,0,0,1,0,0
"Guinea","2024-01-23",0,0,1,0,0,1,0,0
"Guinea","2024-01-24",0,0,1,0,0,1,0,0
"Guinea","2024-01-25",0,0,1,0,0,1,0,0
"Guinea","2024-01-26",0,0,1,0,0,1,0,0
"Guinea","2024-01-27",0,0,1,0,0,1,0,0
"Guinea","2024-01-28",0,0,1,0,0,1,0,0
"Guinea","2024-01-29",0,0,1,0,0,1,0,0
"Guinea","2024-01-30",0,0,1,0,0,1,0,0
"Guinea","2024-01-31",0,0,1,0,0,1,0,0
"Guinea","2024-02-01",0,0,1,0,0,1,0,0
"Guinea","2024-02-02",0,0,1,0,0,1,0,0
"Guinea","2024-02-03",0,0,1,0,0,1,0,0
"Guinea","2024-02-04",0,0,1,0,0,1,0,0
"Guinea","2024-02-05",0,0,1,0,0,1,0,0
"Guinea","2024-02-06",0,0,1,0,0,1,0,0
"Guinea","2024-02-07",0,0,1,0,0,1,0,0
"Guinea","2024-02-08",0,0,1,0,0,1,0,0
"Guinea","2024-02-09",0,0,1,0,0,1,0,0
"Guinea","2024-02-10",0,0,1,0,0,1,0,0
"Guinea","2024-02-11",0,0,1,0,0,1,0,0
"Guinea","2024-02-12",0,0,1,0,0,1,0,0
"Guinea","2024-02-13",0,0,1,0,0,1,0,0
"Guinea","2024-02-14",0,0,1,0,0,1,0,0
"Guinea","2024-02-15",0,0,1,0,0,1,0,0
"Guinea","2024-02-16",0,0,1,0,0,1,0,0
"Guinea","2024-02-17",0,0,1,0,0,1,0,0
"Guinea","2024-02-18",0,0,1,0,0,1,0,0
"Guinea","2024-02-19",0,0,1,0,0,1,0,0
"Guinea","2024-02-20",0,0,1,0,0,1,0,0
"Guinea","2024-02-21",0,0,1,0,0,1,0,0
"Guinea","2024-02-22",0,0,1,0,0,1,0,0
"Guinea","2024-02-23",0,0,1,0,0,1,0,0
"Guinea","2024-02-24",0,0,1,0,0,1,0,0
"Guinea","2024-02-25",0,0,1,0,0,1,0,0
"Guinea","2024-02-26",0,0,1,0,0,1,0,0
"Guinea","2024-02-27",0,0,1,0,0,1,0,0
"Guinea","2024-02-28",0,0,1,0,0,1,0,0
"Guinea","2024-02-29",0,0,1,0,0,1,0,0
"Guinea","2024-03-01",0,0,1,0,0,1,0,0
"Guinea","2024-03-02",0,0,1,0,0,1,0,0
"Guinea","2024-03-03",0,0,1,0,0,1,0,0
"Guinea","2024-03-04",0,0,1,0,0,1,0,0
"Guinea","2024-03-05",0,0,1,0,0,1,0,0
"Guinea","2024-03-06",0,0,1,0,0,1,0,0
"Guinea","2024-03-07",0,0,1,0,0,1,0,0
"Guinea","2024-03-08",0,0,1,0,0,1,0,0
"Guinea","2024-03-09",0,0,1,0,0,1,0,0
"Guinea","2024-03-10",0,0,1,0,0,1,0,0
"Guinea","2024-03-11",0,0,1,0,0,1,0,0
"Guinea","2024-03-12",0,0,1,0,0,1,0,0
"Guinea","2024-03-13",0,0,1,0,0,1,0,0
"Guinea","2024-03-14",0,0,1,0,0,1,0,0
"Guinea","2024-03-15",0,0,1,0,0,1,0,0
"Guinea","2024-03-16",0,0,1,0,0,1,0,0
"Guinea","2024-03-17",0,0,1,0,0,1,0,0
"Guinea","2024-03-18",0,0,1,0,0,1,0,0
"Guinea","2024-03-19",0,0,1,0,0,1,0,0
"Guinea","2024-03-20",0,0,1,0,0,1,0,0
"Guinea","2024-03-21",0,0,1,0,0,1,0,0
"Guinea","2024-03-22",0,0,1,0,0,1,0,0
"Guinea","2024-03-23",0,0,1,0,0,1,0,0
"Guinea","2024-03-24",0,0,1,0,0,1,0,0
"Guinea","2024-03-25",0,0,1,0,0,1,0,0
"Guinea","2024-03-26",0,0,1,0,0,1,0,0
"Guinea","2024-03-27",0,0,1,0,0,1,0,0
"Guinea","2024-03-28",0,0,1,0,0,1,0,0
"Guinea","2024-03-29",0,0,1,0,0,1,0,0
"Guinea","2024-03-30",0,0,1,0,0,1,0,0
"Guinea","2024-03-31",0,0,1,0,0,1,0,0
"Guinea","2024-04-01",0,0,1,0,0,1,0,0
"Guinea","2024-04-02",0,0,1,0,0,1,0,0
"Guinea","2024-04-03",0,0,1,0,0,1,0,0
"Guinea","2024-04-04",0,0,1,0,0,1,0,0
"Guinea","2024-04-05",0,0,1,0,0,1,0,0
"Guinea","2024-04-06",0,0,1,0,0,1,0,0
"Guinea","2024-04-07",0,0,1,0,0,1,0,0
"Guinea","2024-04-08",0,0,1,0,0,1,0,0
"Guinea","2024-04-09",0,0,1,0,0,1,0,0
"Guinea","2024-04-10",0,0,1,0,0,1,0,0
"Guinea","2024-04-11",0,0,1,0,0,1,0,0
"Guinea","2024-04-12",0,0,1,0,0,1,0,0
"Guinea","2024-04-13",0,0,1,0,0,1,0,0
"Guinea","2024-04-14",0,0,1,0,0,1,0,0
"Guinea","2024-04-15",0,0,1,0,0,1,0,0
"Guinea","2024-04-16",0,0,1,0,0,1,0,0
"Guinea","2024-04-17",0,0,1,0,0,1,0,0
"Guinea","2024-04-18",0,0,1,0,0,1,0,0
"Guinea","2024-04-19",0,0,1,0,0,1,0,0
"Guinea","2024-04-20",0,0,1,0,0,1,0,0
"Guinea","2024-04-21",0,0,1,0,0,1,0,0
"Guinea","2024-04-22",0,0,1,0,0,1,0,0
"Guinea","2024-04-23",0,0,1,0,0,1,0,0
"Guinea","2024-04-24",0,0,1,0,0,1,0,0
"Guinea","2024-04-25",0,0,1,0,0,1,0,0
"Guinea","2024-04-26",0,0,1,0,0,1,0,0
"Guinea","2024-04-27",0,0,1,0,0,1,0,0
"Guinea","2024-04-28",0,0,1,0,0,1,0,0
"Guinea","2024-04-29",0,0,1,0,0,1,0,0
"Guinea","2024-04-30",0,0,1,0,0,1,0,0
"Guinea","2024-05-01",0,0,1,0,0,1,0,0
"Guinea","2024-05-02",0,0,1,0,0,1,0,0
"Guinea","2024-05-03",0,0,1,0,0,1,0,0
"Guinea","2024-05-04",0,0,1,0,0,1,0,0
"Guinea","2024-05-05",0,0,1,0,0,1,0,0
"Guinea","2024-05-06",0,0,1,0,0,1,0,0
"Guinea","2024-05-07",0,0,1,0,0,1,0,0
"Guinea","2024-05-08",0,0,1,0,0,1,0,0
"Guinea","2024-05-09",0,0,1,0,0,1,0,0
"Guinea","2024-05-10",0,0,1,0,0,1,0,0
"Guinea","2024-05-11",0,0,1,0,0,1,0,0
"Guinea","2024-05-12",0,0,1,0,0,1,0,0
"Guinea","2024-05-13",0,0,1,0,0,1,0,0
"Guinea","2024-05-14",0,0,1,0,0,1,0,0
"Guinea","2024-05-15",0,0,1,0,0,1,0,0
"Guinea","2024-05-16",0,0,1,0,0,1,0,0
"Guinea","2024-05-17",0,0,1,0,0,1,0,0
"Guinea","2024-05-18",0,0,1,0,0,1,0,0
"Guinea","2024-05-19",0,0,1,0,0,1,0,0
"Guinea","2024-05-20",0,0,1,0,0,1,0,0
"Guinea","2024-05-21",0,0,1,0,0,1,0,0
"Guinea","2024-05-22",0,0,1,0,0,1,0,0
"Guinea","2024-05-23",0,0,1,0,0,1,0,0
"Guinea","2024-05-24",0,0,1,0,0,1,0,0
"Guinea","2024-05-25",0,0,1,0,0,1,0,0
"Guinea","2024-05-26",0,0,1,0,0,1,0,0
"Guinea","2024-05-27",0,0,1,0,0,1,0,0
"Guinea","2024-05-28",0,0,1,0,0,1,0,0
"Guinea","2024-05-29",0,0,1,0,0,1,0,0
"Guinea","2024-05-30",0,0,1,0,0,1,0,0
"Guinea","2024-05-31",0,0,1,0,0,1,0,0
"Guinea","2024-06-01",0,0,1,0,0,1,0,0
"Guinea","2024-06-02",0,0,1,0,0,1,0,0
"Guinea","2024-06-03",0,0,1,0,0,1,0,0
"Guinea","2024-06-04",0,0,1,0,0,1,0,0
"Guinea","2024-06-05",0,0,1,0,0,1,0,0
"Guinea","2024-06-06",0,0,1,0,0,1,0,0
"Guinea","2024-06-07",0,0,1,0,0,1,0,0
"Guinea","2024-06-08",0,0,1,0,0,1,0,0
"Guinea","2024-06-09",0,0,1,0,0,1,0,0
"Guinea","2024-06-10",0,0,1,0,0,1,0,0
"Guinea","2024-06-11",0,0,1,0,0,1,0,0
"Guinea","2024-06-12",0,0,1,0,0,1,0,0
"Guinea","2024-06-13",0,0,1,0,0,1,0,0
"Guinea","2024-06-14",0,0,1,0,0,1,0,0
"Guinea","2024-06-15",0,0,1,0,0,1,0,0
"Guinea","2024-06-16",0,0,1,0,0,1,0,0
"Guinea","2024-06-17",0,0,1,0,0,1,0,0
"Guinea","2024-06-18",0,0,1,0,0,1,0,0
"Guinea","2024-06-19",0,0,1,0,0,1,0,0
"Guinea","2024-06-20",0,0,1,0,0,1,0,0
"Guinea","2024-06-21",0,0,1,0,0,1,0,0
"Guinea","2024-06-22",0,0,1,0,0,1,0,0
"Guinea","2024-06-23",0,0,1,0,0,1,0,0
"Guinea","2024-06-24",0,0,1,0,0,1,0,0
"Guinea","2024-06-25",0,0,1,0,1,2,0,0
"Guinea","2024-06-26",0,0,1,0,0,2,0,0
"Guinea","2024-06-27",0,0,1,0,0,2,0,0
"Guinea","2024-06-28",0,0,1,0,0,2,0,0
"Guinea","2024-06-29",0,0,1,0,0,2,0,0
"Guinea","2024-06-30",0,0,1,0,0,2,0,0
"Guinea","2024-07-01",0,0,1,0,0,2,0,0
"Guinea","2024-07-02",0,0,1,0,0,2,0,0
"Guinea","2024-07-03",0,0,1,0,0,2,0,0
"Guinea","2024-07-04",0,0,1,0,0,2,0,0
"Guinea","2024-07-05",0,0,1,0,0,2,0,0
"Guinea","2024-07-06",0,0,1,0,0,2,0,0
"Guinea","2024-07-07",0,0,1,0,0,2,0,0
"Guinea","2024-07-08",0,0,1,0,0,2,0,0
"Guinea","2024-07-09",0,0,1,0,0,2,0,0
"Guinea","2024-07-10",0,0,1,0,0,2,0,0
"Guinea","2024-07-11",0,0,1,0,0,2,0,0
"Guinea","2024-07-12",0,0,1,0,0,2,0,0
"Guinea","2024-07-13",0,0,1,0,0,2,0,0
"Guinea","2024-07-14",0,0,1,0,0,2,0,0
"Guinea","2024-07-15",0,0,1,0,0,2,0,0
"Guinea","2024-07-16",0,0,1,0,0,2,0,0
"Guinea","2024-07-17",0,0,1,0,0,2,0,0
"Guinea","2024-07-18",0,0,1,0,0,2,0,0
"Guinea","2024-07-19",0,0,1,0,0,2,0,0
"Guinea","2024-07-20",0,0,1,0,0,2,0,0
"Guinea","2024-07-21",0,0,1,0,0,2,0,0
"Guinea","2024-07-22",0,0,1,0,0,2,0,0
"Guinea","2024-07-23",0,0,1,0,0,2,0,0
"Guinea","2024-07-24",0,0,1,0,0,2,0,0
"Guinea","2024-07-25",0,0,1,0,0,2,0,0
"Guinea","2024-07-26",0,0,1,0,0,2,0,0
"Guinea","2024-07-27",0,0,1,0,0,2,0,0
"Guinea","2024-07-28",0,0,1,0,0,2,0,0
"Guinea","2024-07-29",0,0,1,0,0,2,0,0
"Guinea","2024-07-30",0,0,1,0,0,2,0,0
"Guinea","2024-07-31",0,0,1,0,0,2,0,0
"Guinea","2024-08-01",0,0,1,0,0,2,0,0
"Guinea","2024-08-02",0,0,1,0,0,2,0,0
"Guinea","2024-08-03",0,0,1,0,0,2,0,0
"Guinea","2024-08-04",0,0,1,0,0,2,0,0
"Guinea","2024-08-05",0,0,1,0,0,2,0,0
"Guinea","2024-08-06",0,0,1,0,0,2,0,0
"Guinea","2024-08-07",0,0,1,0,0,2,0,0
"Guinea","2024-08-08",0,0,1,0,0,2,0,0
"Guinea","2024-08-09",0,0,1,0,0,2,0,0
"Guinea","2024-08-10",0,0,1,0,0,2,0,0
"Guinea","2024-08-11",0,0,1,0,0,2,0,0
"Guinea","2024-08-12",0,0,1,0,0,2,0,0
"Guinea","2024-08-13",0,0,1,0,0,2,0,0
"Guinea","2024-08-14",0,0,1,0,0,2,0,0
"Guinea","2024-08-15",0,0,1,0,0,2,0,0
"Guinea","2024-08-16",0,0,1,0,0,2,0,0
"Guinea","2024-08-17",0,0,1,0,0,2,0,0
"Guinea","2024-08-18",0,0,1,0,0,2,0,0
"Guinea","2024-08-19",0,0,1,0,0,2,0,0
"Guinea","2024-08-20",0,0,1,0,0,2,0,0
"Guinea","2024-08-21",0,0,1,0,0,2,0,0
"Guinea","2024-08-22",0,0,1,0,0,2,0,0
"Guinea","2024-08-23",0,0,1,0,0,2,0,0
"Guinea","2024-08-24",0,0,1,0,0,2,0,0
"Guinea","2024-08-25",0,0,1,0,0,2,0,0
"Guinea","2024-08-26",0,0,1,0,0,2,0,0
"Guinea","2024-08-27",0,0,1,0,0,2,0,0
"Guinea","2024-08-28",0,0,1,0,0,2,0,0
"Guinea","2024-08-29",0,0,1,0,0,2,0,0
"Guinea","2024-08-30",0,0,1,0,0,2,0,0
"Guinea","2024-08-31",0,0,1,0,0,2,0,0
"Guinea","2024-09-01",0,0,1,0,0,2,0,0
"Guinea","2024-09-02",0,0,1,0,0,2,0,0
"Guinea","2024-09-03",0,0,1,0,0,2,0,0
"Guinea","2024-09-04",0,0,1,0,0,2,0,0
"Guinea","2024-09-05",0,0,1,0,0,2,0,0
"Guinea","2024-09-06",0,0,1,0,0,2,0,0
"Guinea","2024-09-07",0,0,1,0,0,2,0,0
"Guinea","2024-09-08",0,0,1,0,0,2,0,0
"Guinea","2024-09-09",0,0,1,0,0,2,0,0
"Guinea","2024-09-10",0,0,1,0,0,2,0,0
"Guinea","2024-09-11",0,0,1,0,0,2,0,0
"Guinea","2024-09-12",0,0,1,0,0,2,0,0
"Guinea","2024-09-13",0,0,1,0,0,2,0,0
"Guinea","2024-09-14",0,0,1,0,0,2,0,0
"Guinea","2024-09-15",0,0,1,0,0,2,0,0
"Guinea","2024-09-16",0,0,1,0,0,2,0,0
"Guinea","2024-09-17",0,0,1,0,0,2,0,0
"Guinea","2024-09-18",0,0,1,0,0,2,0,0
"Guinea","2024-09-19",0,0,1,0,0,2,0,0
"Guinea","2024-09-20",0,0,1,0,0,2,0,0
"Guinea","2024-09-21",0,0,1,0,0,2,0,0
"Guinea","2024-09-22",0,0,1,0,0,2,0,0
"Guinea","2024-09-23",0,0,1,0,0,2,0,0
"Guinea","2024-09-24",0,0,1,0,0,2,0,0
"Guinea","2024-09-25",0,0,1,0,0,2,0,0
"Guinea","2024-09-26",0,0,1,0,0,2,0,0
"Guinea","2024-09-27",0,0,1,0,0,2,0,0
"Guinea","2024-09-28",0,0,1,0,0,2,0,0
"Guinea","2024-09-29",0,0,1,0,0,2,0,0
"Guinea","2024-09-30",0,0,1,0,0,2,0,0
"Guinea","2024-10-01",0,0,1,0,0,2,0,0
"Guinea","2024-10-02",0,0,1,0,0,2,0,0
"Guinea","2024-10-03",0,0,1,0,0,2,0,0
"Guinea","2024-10-04",0,0,1,0,0,2,0,0
"Guinea","2024-10-05",0,0,1,0,0,2,0,0
"Guinea","2024-10-06",0,0,1,0,0,2,0,0
"Guinea","2024-10-07",0,0,1,0,0,2,0,0
"Guinea","2024-10-08",0,0,1,0,0,2,0,0
"Guinea","2024-10-09",0,0,1,0,0,2,0,0
"Guinea","2024-10-10",0,0,1,0,0,2,0,0
"Guinea","2024-10-11",0,0,1,0,0,2,0,0
"Guinea","2024-10-12",0,0,1,0,0,2,0,0
"Guinea","2024-10-13",0,0,1,0,0,2,0,0
"Guinea","2024-10-14",0,0,1,0,0,2,0,0
"Guinea","2024-10-15",0,0,1,0,0,2,0,0
"Guinea","2024-10-16",0,0,1,0,0,2,0,0
"Guinea","2024-10-17",0,0,1,0,0,2,0,0
"Guinea","2024-10-18",0,0,1,0,0,2,0,0
"Guinea","2024-10-19",0,0,1,0,0,2,0,0
"Guinea","2024-10-20",0,0,1,0,0,2,0,0
"Guinea","2024-10-21",0,0,1,0,0,2,0,0
"Guinea","2024-10-22",0,0,1,0,0,2,0,0
"Guinea","2024-10-23",0,0,1,0,0,2,0,0
"Guinea","2024-10-24",0,0,1,0,0,2,0,0
"Guinea","2024-10-25",0,0,1,0,0,2,0,0
"Guinea","2024-10-26",0,0,1,0,0,2,0,0
"Guinea","2024-10-27",0,0,1,0,0,2,0,0
"Guinea","2024-10-28",0,0,1,0,0,2,0,0
"Guinea","2024-10-29",0,0,1,0,0,2,0,0
"Guinea","2024-10-30",0,0,1,0,0,2,0,0
"Guinea","2024-10-31",0,0,1,0,0,2,0,0
"Guinea","2024-11-01",0,0,1,0,0,2,0,0
"Guinea","2024-11-02",0,0,1,0,0,2,0,0
"Guinea","2024-11-03",0,0,1,0,0,2,0,0
"Guinea","2024-11-04",0,0,1,0,0,2,0,0
"Guinea","2024-11-05",0,0,1,0,0,2,0,0
"Guinea","2024-11-06",0,0,1,0,0,2,0,0
"Guinea","2024-11-07",0,0,1,0,0,2,0,0
"Guinea","2024-11-08",0,0,1,0,0,2,0,0
"Guinea","2024-11-09",0,0,1,0,0,2,0,0
"Guinea","2024-11-10",0,0,1,0,0,2,0,0
"Guinea","2024-11-11",0,0,1,0,0,2,0,0
"Guinea","2024-11-12",0,0,1,0,0,2,0,0
"Guinea","2024-11-13",0,0,1,0,0,2,0,0
"Guinea","2024-11-14",0,0,1,0,0,2,0,0
"Guinea","2024-11-15",0,0,1,0,0,2,0,0
"Guinea","2024-11-16",0,0,1,0,0,2,0,0
"Guinea","2024-11-17",0,0,1,0,0,2,0,0
"Guinea","2024-11-18",0,0,1,0,0,2,0,0
"Guinea","2024-11-19",0,0,1,0,0,2,0,0
"Guinea","2024-11-20",0,0,1,0,0,2,0,0
"Guinea","2024-11-21",0,0,1,0,0,2,0,0
"Guinea","2024-11-22",0,0,1,0,0,2,0,0
"Guinea","2024-11-23",0,0,1,0,0,2,0,0
"Guinea","2024-11-24",0,0,1,0,0,2,0,0
"Guinea","2024-11-25",0,0,1,0,0,2,0,0
"Guinea","2024-11-26",0,0,1,0,0,2,0,0
"Guinea","2024-11-27",0,0,1,0,0,2,0,0
"Guinea","2024-11-28",0,0,1,0,0,2,0,0
"Guinea","2024-11-29",0,0,1,0,0,2,0,0
"Guinea","2024-11-30",0,0,1,0,0,2,0,0
"Guinea","2024-12-01",0,0,1,0,0,2,0,0
"Guinea","2024-12-02",0,0,1,0,0,2,0,0
"Guinea","2024-12-03",0,0,1,0,0,2,0,0
"Guinea","2024-12-04",0,0,1,0,0,2,0,0
"Guinea","2024-12-05",0,0,1,0,0,2,0,0
"Guinea","2024-12-06",0,0,1,0,0,2,0,0
"Guinea","2024-12-07",0,0,1,0,0,2,0,0
"Guinea","2024-12-08",0,1,2,0,0,2,0,0
"Guinea","2024-12-09",0,0,2,0,0,2,0,0
"Guinea","2024-12-10",0,0,2,0,0,2,0,0
"Guinea","2024-12-11",0,0,2,0,0,2,0,0
"Guinea","2024-12-12",0,0,2,0,0,2,0,0
"Guinea","2024-12-13",0,0,2,0,0,2,0,0
"Guinea","2024-12-14",0,0,2,0,0,2,0,0
"Guinea","2024-12-15",0,0,2,0,0,2,0,0
"Guinea","2024-12-16",0,0,2,0,0,2,0,0
"Guinea","2024-12-17",0,0,2,0,0,2,0,0
"Guinea","2024-12-18",0,0,2,0,0,2,0,0
"Guinea","2024-12-19",0,0,2,0,0,2,0,0
"Guinea","2024-12-20",0,0,2,0,0,2,0,0
"Guinea","2024-12-21",0,0,2,0,0,2,0,0
"Guinea","2024-12-22",0,0,2,0,0,2,0,0
"Guinea","2024-12-23",0,0,2,0,0,2,0,0
"Guinea","2024-12-24",0,0,2,0,0,2,0,0
"Guinea","2024-12-25",0,0,2,0,0,2,0,0
"Guinea","2024-12-26",0,0,2,0,0,2,0,0
"Guinea","2024-12-27",0,0,2,0,0,2,0,0
"Guinea","2024-12-28",0,0,2,0,0,2,0,0
"Guinea","2024-12-29",0,0,2,0,0,2,0,0
"Guinea","2024-12-30",0,0,2,0,0,2,0,0
"Guinea","2024-12-31",0,0,2,0,0,2,0,0
"Guinea","2025-01-01",0,0,2,0,0,2,0,0
"Guinea","2025-01-02",0,0,2,0,0,2,0,0
"Guinea","2025-01-03",0,0,2,0,0,2,0,0
"Guinea","2025-01-04",0,0,2,0,0,2,0,0
"Guinea","2025-01-05",0,0,2,0,0,2,0,0
"Guinea","2025-01-06",0,0,2,0,0,2,0,0
"Guinea","2025-01-07",0,0,2,0,0,2,0,0
"Guinea","2025-01-08",0,0,2,0,0,2,0,0
"Guinea","2025-01-09",0,0,2,0,0,2,0,0
"Guinea","2025-01-10",0,0,2,0,0,2,0,0
"Guinea","2025-01-11",0,0,2,0,0,2,0,0
"Guinea","2025-01-12",0,0,2,0,0,2,0,0
"Guinea","2025-01-13",0,0,2,0,0,2,0,0
"Guinea","2025-01-14",0,0,2,0,0,2,0,0
"Guinea","2025-01-15",0,0,2,0,0,2,0,0
"Guinea","2025-01-16",0,0,2,0,0,2,0,0
"Guinea","2025-01-17",0,0,2,0,0,2,0,0
"Guinea","2025-01-18",0,0,2,0,0,2,0,0
"Guinea","2025-01-19",0,0,2,0,0,2,0,0
"Guinea","2025-01-20",0,0,2,0,0,2,0,0
"Guinea","2025-01-21",0,0,2,0,0,2,0,0
"Guinea","2025-01-22",0,0,2,0,0,2,0,0
"Guinea","2025-01-23",0,0,2,0,0,2,0,0
"Guinea","2025-01-24",0,0,2,0,0,2,0,0
"Guinea","2025-01-25",0,0,2,0,0,2,0,0
"Guinea","2025-01-26",0,0,2,0,0,2,0,0
"Guinea","2025-01-27",0,0,2,0,0,2,0,0
"Guinea","2025-01-28",0,0,2,0,0,2,0,0
"Guinea","2025-01-29",0,0,2,0,0,2,0,0
"Guinea","2025-01-30",0,0,2,0,0,2,0,0
"Guinea","2025-01-31",0,0,2,0,0,2,0,0
"Guinea","2025-02-01",0,0,2,0,0,2,0,0
"Guinea","2025-02-02",0,0,2,0,0,2,0,0
"Guinea","2025-02-03",0,0,2,0,0,2,0,0
"Guinea","2025-02-04",0,0,2,0,0,2,0,0
"Guinea","2025-02-05",0,0,2,0,0,2,0,0
"Guinea","2025-02-06",0,0,2,0,0,2,0,0
"Guinea","2025-02-07",0,0,2,0,0,2,0,0
"Guinea","2025-02-08",0,0,2,0,0,2,0,0
"Guinea","2025-02-09",0,0,2,0,0,2,0,0
"Guinea","2025-02-10",0,0,2,0,0,2,0,0
"Guinea","2025-02-11",0,0,2,0,0,2,0,0
"Guinea","2025-02-12",0,0,2,0,0,2,0,0
"Guinea","2025-02-13",0,0,2,0,0,2,0,0
"Guinea","2025-02-14",0,0,2,0,0,2,0,0
"Guinea","2025-02-15",0,0,2,0,0,2,0,0
"Guinea","2025-02-16",0,0,2,0,0,2,0,0
"Guinea","2025-02-17",0,0,2,0,0,2,0,0
"Guinea","2025-02-18",0,0,2,0,0,2,0,0
"Guinea","2025-02-19",0,0,2,0,0,2,0,0
"Guinea","2025-02-20",0,0,2,0,0,2,0,0
"Guinea","2025-02-21",0,0,2,0,0,2,0,0
"Guinea","2025-02-22",0,0,2,0,0,2,0,0
"Guinea","2025-02-23",0,0,2,0,0,2,0,0
"Guinea","2025-02-24",0,0,2,0,0,2,0,0
"Guinea","2025-02-25",0,0,2,0,0,2,0,0
"Guinea","2025-02-26",0,0,2,0,0,2,0,0
"Guinea","2025-02-27",0,0,2,0,0,2,0,0
"Guinea","2025-02-28",0,0,2,0,0,2,0,0
"Guinea","2025-03-01",0,0,2,0,0,2,0,0
"Guinea","2025-03-02",0,0,2,0,0,2,0,0
"Guinea","2025-03-03",0,0,2,0,0,2,0,0
"Guyana","2024-01-01",0,0,0,0,0,0,0,0
"Guyana","2024-01-02",0,0,0,0,0,0,0,0
"Guyana","2024-01-03",0,0,0,0,0,0,0,0
"Guyana","2024-01-04",0,0,0,0,0,0,0,0
"Guyana","2024-01-05",0,0,0,0,0,0,0,0
"Guyana","2024-01-06",0,0,0,0,0,0,0,0
"Guyana","2024-01-07",0,0,0,0,0,0,0,0
"Guyana","2024-01-08",0,0,0,0,0,0,0,0
"Guyana","2024-01-09",0,0,0,0,0,0,0,0
"Guyana","2024-01-10",0,0,0,0,0,0,0,0
"Guyana","2024-01-11",0,0,0,0,0,0,0,0
"Guyana","2024-01-12",0,0,0,0,0,0,0,0
"Guyana","2024-01-13",0,0,0,0,0,0,0,0
"Guyana","2024-01-14",0,0,0,0,0,0,0,0
"Guyana","2024-01-15",0,0,0,0,0,0,0,0
"Guyana","2024-01-16",0,0,0,0,0,0,0,0
"Guyana","2024-01-17",0,0,0,0,0,0,0,0
"Guyana","2024-01-18",0,0,0,0,0,0,0,0
"Guyana","2024-01-19",0,0,0,0,0,0,0,0
"Guyana","2024-01-20",0,0,0,0,0,0,0,0
"Guyana","2024-01-21",0,0,0,0,0,0,0,0
"Guyana","2024-01-22",0,0,0,0,0,0,0,0
"Guyana","2024-01-23",0,0,0,0,0,0,0,0
"Guyana","2024-01-24",0,0,0,0,0,0,0,0
"Guyana","2024-01-25",0,0,0,0,0,0,0,0
"Guyana","2024-01-26",0,0,0,0,0,0,0,0
"Guyana","2024-01-27",0,0,0,0,0,0,0,0
"Guyana","2024-01-28",0,0,0,0,0,0,0,0
"Guyana","2024-01-29",0,0,0,0,0,0,0,0
"Guyana","2024-01-30",0,0,0,0,0,0,0,0
"Guyana","2024-01-31",0,0,0,0,0,0,0,0
"Guyana","2024-02-01",0,0,0,0,0,0,0,0
"Guyana","2024-02-02",0,0,0,0,0,0,0,0
"Guyana","2024-02-03",0,0,0,0,0,0,0,0
"Guyana","2024-02-04",0,0,0,0,0,0,0,0
"Guyana","2024-02-05",0,0,0,0,0,0,0,0
"Guyana","2024-02-06",0,0,0,0,0,0,0,0
"Guyana","2024-02-07",0,0,0,0,0,0,0,0
"Guyana","2024-02-08",0,0,0,0,0,0,0,0
"Guyana","2024-02-09",0,0,0,0,0,0,0,0
"Guyana","2024-02-10",0,0,0,0,0,0,0,0
"Guyana","2024-02-11",0,0,0,0,0,0,0,0
"Guyana","2024-02-12",0,0,0,0,0,0,0,0
"Guyana","2024-02-13",0,0,0,0,0,0,0,0
"Guyana","2024-02-14",0,0,0,0,0,0,0,0
"Guyana","2024-02-15",0,0,0,0,0,0,0,0
"Guyana","2024-02-16",0,0,0,0,0,0,0,0
"Guyana","2024-02-17",0,0,0,0,0,0,0,0
"Guyana","2024-02-18",0,0,0,0,0,0,0,0
"Guyana","2024-02-19",0,0,0,0,0,0,0,0
"Guyana","2024-02-20",0,0,0,0,0,0,0,0
"Guyana","2024-02-21",0,0,0,0,0,0,0,0
"Guyana","2024-02-22",0,0,0,0,0,0,0,0
"Guyana","2024-02-23",0,0,0,0,0,0,0,0
"Guyana","2024-02-24",0,0,0,0,0,0,0,0
"Guyana","2024-02-25",0,0,0,0,0,0,0,0
"Guyana","2024-02-26",0,0,0,0,0,0,0,0
"Guyana","2024-02-27",0,0,0,0,0,0,0,0
"Guyana","2024-02-28",0,0,0,0,0,0,0,0
"Guyana","2024-02-29",0,0,0,0,0,0,0,0
"Guyana","2024-03-01",0,0,0,0,0,0,0,0
"Guyana","2024-03-02",0,0,0,0,0,0,0,0
"Guyana","2024-03-03",0,0,0,0,0,0,0,0
"Guyana","2024-03-04",0,0,0,0,0,0,0,0
"Guyana","2024-03-05",0,0,0,0,0,0,0,0
"Guyana","2024-03-06",0,0,0,0,0,0,0,0
"Guyana","2024-03-07",0,0,0,0,0,0,0,0
"Guyana","2024-03-08",0,0,0,0,0,0,0,0
"Guyana","2024-03-09",0,0,0,0,0,0,0,0
"Guyana","2024-03-10",0,0,0,0,0,0,0,0
"Guyana","2024-03-11",0,0,0,0,0,0,0,0
"Guyana","2024-03-12",0,0,0,0,0,0,0,0
"Guyana","2024-03-13",0,0,0,0,0,0,0,0
"Guyana","2024-03-14",0,0,0,0,0,0,0,0
"Guyana","2024-03-15",0,0,0,0,0,0,0,0
"Guyana","2024-03-16",0,0,0,0,0,0,0,0
"Guyana","2024-03-17",0,0,0,0,0,0,0,0
"Guyana","2024-03-18",0,0,0,0,0,0,0,0
"Guyana","2024-03-19",0,0,0,0,0,0,0,0
"Guyana","2024-03-20",0,0,0,0,0,0,0,0
"Guyana","2024-03-21",0,0,0,0,0,0,0,0
"Guyana","2024-03-22",0,0,0,0,0,0,0,0
"Guyana","2024-03-23",0,0,0,0,0,0,0,0
"Guyana","2024-03-24",0,0,0,0,0,0,0,0
"Guyana","2024-03-25",0,0,0,0,0,0,0,0
"Guyana","2024-03-26",0,0,0,0,0,0,0,0
"Guyana","2024-03-27",0,0,0,0,0,0,0,0
"Guyana","2024-03-28",0,0,0,0,0,0,0,0
"Guyana","2024-03-29",0,0,0,0,0,0,0,0
"Guyana","2024-03-30",0,0,0,0,0,0,0,0
"Guyana","2024-03-31",0,0,0,0,0,0,0,0
"Guyana","2024-04-01",0,0,0,0,0,0,0,0
"Guyana","2024-04-02",0,0,0,0,0,0,0,0
"Guyana","2024-04-03",0,0,0,0,0,0,0,0
"Guyana","2024-04-04",0,0,0,0,0,0,0,0
"Guyana","2024-04-05",0,0,0,0,0,0,0,0
"Guyana","2024-04-06",0,0,0,0,0,0,0,0
"Guyana","2024-04-07",0,0,0,0,0,0,0,0
"Guyana","2024-04-08",0,0,0,0,0,0,0,0
"Guyana","2024-04-09",0,0,0,0,0,0,0,0
"Guyana","2024-04-10",0,0,0,0,0,0,0,0
"Guyana","2024-04-11",0,0,0,0,0,0,0,0
"Guyana","2024-04-12",0,0,0,0,0,0,0,0
"Guyana","2024-04-13",0,0,0,0,0,0,0,0
"Guyana","2024-04-14",0,0,0,0,0,0,0,0
"Guyana","2024-04-15",0,0,0,0,0,0,0,0
"Guyana","2024-04-16",0,0,0,0,0,0,0,0
"Guyana","2024-04-17",0,0,0,0,0,0,0,0
"Guyana","2024-04-18",0,0,0,0,0,0,0,0
"Guyana","2024-04-19",0,0,0,0,0,0,0,0
"Guyana","2024-04-20",0,0,0,0,0,0,0,0
"Guyana","2024-04-21",0,0,0,0,0,0,0,0
"Guyana","2024-04-22",0,0,0,0,0,0,0,0
"Guyana","2024-04-23",0,0,0,0,0,0,0,0
"Guyana","2024-04-24",0,0,0,0,0,0,0,0
"Guyana","2024-04-25",0,0,0,0,0,0,0,0
"Guyana","2024-04-26",0,0,0,0,0,0,0,0
"Guyana","2024-04-27",0,0,0,0,0,0,0,0
"Guyana","2024-04-28",0,0,0,0,0,0,0,0
"Guyana","2024-04-29",0,0,0,0,0,0,0,0
"Guyana","2024-04-30",0,0,0,0,0,0,0,0
"Guyana","2024-05-01",0,0,0,0,0,0,0,0
"Guyana","2024-05-02",0,0,0,0,0,0,0,0
"Guyana","2024-05-03",0,0,0,0,0,0,0,0
"Guyana","2024-05-04",0,0,0,0,0,0,0,0
"Guyana","2024-05-05",0,0,0,0,0,0,0,0
"Guyana","2024-05-06",0,0,0,0,0,0,0,0
"Guyana","2024-05-07",0,0,0,0,0,0,0,0
"Guyana","2024-05-08",0,0,0,0,0,0,0,0
"Guyana","2024-05-09",0,0,0,0,0,0,0,0
"Guyana","2024-05-10",0,0,0,0,0,0,0,0
"Guyana","2024-05-11",0,0,0,0,0,0,0,0
"Guyana","2024-05-12",0,0,0,0,0,0,0,0
"Guyana","2024-05-13",0,0,0,0,0,0,0,0
"Guyana","2024-05-14",0,0,0,0,0,0,0,0
"Guyana","2024-05-15",0,0,0,0,0,0,0,0
"Guyana","2024-05-16",0,0,0,0,0,0,0,0
"Guyana","2024-05-17",0,0,0,0,0,0,0,0
"Guyana","2024-05-18",0,0,0,0,0,0,0,0
"Guyana","2024-05-19",0,0,0,0,0,0,0,0
"Guyana","2024-05-20",0,0,0,0,0,0,0,0
"Guyana","2024-05-21",0,0,0,0,0,0,0,0
"Guyana","2024-05-22",0,0,0,0,0,0,0,0
"Guyana","2024-05-23",0,0,0,0,0,0,0,0
"Guyana","2024-05-24",0,0,0,0,0,0,0,0
"Guyana","2024-05-25",0,0,0,0,0,0,0,0
"Guyana","2024-05-26",0,0,0,0,0,0,0,0
"Guyana","2024-05-27",0,0,0,0,0,0,0,0
"Guyana","2024-05-28",0,0,0,0,0,0,0,0
"Guyana","2024-05-29",0,0,0,0,0,0,0,0
"Guyana","2024-05-30",0,0,0,0,0,0,0,0
"Guyana","2024-05-31",0,0,0,0,0,0,0,0
"Guyana","2024-06-01",0,0,0,0,0,0,0,0
"Guyana","2024-06-02",0,0,0,0,0,0,0,0
"Guyana","2024-06-03",0,0,0,0,0,0,0,0
"Guyana","2024-06-04",0,0,0,0,0,0,0,0
"Guyana","2024-06-05",0,0,0,0,0,0,0,0
"Guyana","2024-06-06",0,0,0,0,0,0,0,0
"Guyana","2024-06-07",0,0,0,0,0,0,0,0
"Guyana","2024-06-08",0,0,0,0,0,0,0,0
"Guyana","2024-06-09",0,0,0,0,0,0,0,0
"Guyana","2024-06-10",0,0,0,0,0,0,0,0
"Guyana","2024-06-11",0,0,0,0,0,0,0,0
"Guyana","2024-06-12",0,0,0,0,0,0,0,0
"Guyana","2024-06-13",0,0,0,0,0,0,0,0
"Guyana","2024-06-14",0,0,0,0,0,0,0,0
"Guyana","2024-06-15",0,0,0,0,0,0,0,0
"Guyana","2024-06-16",0,0,0,0,0,0,0,0
"Guyana","2024-06-17",0,0,0,0,0,0,0,0
"Guyana","2024-06-18",0,0,0,0,0,0,0,0
"Guyana","2024-06-19",0,0,0,0,0,0,0,0
"Guyana","2024-06-20",0,0,0,0,0,0,0,0
"Guyana","2024-06-21",0,0,0,0,0,0,0,0
"Guyana","2024-06-22",0,0,0,0,0,0,0,0
"Guyana","2024-06-23",0,0,0,0,0,0,0,0
"Guyana","2024-06-24",0,0,0,0,0,0,0,0
"Guyana","2024-06-25",0,0,0,0,0,0,0,0
"Guyana","2024-06-26",0,0,0,0,0,0,0,0
"Guyana","2024-06-27",0,0,0,0,0,0,0,0
"Guyana","2024-06-28",0,0,0,0,0,0,0,0
"Guyana","2024-06-29",0,0,0,0,0,0,0,0
"Guyana","2024-06-30",0,0,0,0,0,0,0,0
"Guyana","2024-07-01",0,0,0,0,0,0,0,0
"Guyana","2024-07-02",0,0,0,0,0,0,0,0
"Guyana","2024-07-03",0,0,0,0,0,0,0,0
"Guyana","2024-07-04",0,0,0,0,0,0,0,0
"Guyana","2024-07-05",0,0,0,0,0,0,0,0
"Guyana","2024-07-06",0,0,0,0,0,0,0,0
"Guyana","2024-07-07",0,0,0,0,0,0,0,0
"Guyana","2024-07-08",0,0,0,0,0,0,0,0
"Guyana","2024-07-09",0,0,0,0,0,0,0,0
"Guyana","2024-07-10",0,0,0,0,0,0,0,0
"Guyana","2024-07-11",0,0,0,0,0,0,0,0
"Guyana","2024-07-12",0,0,0,0,0,0,0,0
"Guyana","2024-07-13",0,0,0,0,0,0,0,0
"Guyana","2024-07-14",0,0,0,0,0,0,0,0
"Guyana","2024-07-15",0,0,0,0,0,0,0,0
"Guyana","2024-07-16",0,0,0,0,0,0,0,0
"Guyana","2024-07-17",0,0,0,0,0,0,0,0
"Guyana","2024-07-18",0,0,0,0,0,0,0,0
"Guyana","2024-07-19",0,0,0,0,0,0,0,0
"Guyana","2024-07-20",0,0,0,0,0,0,0,0
"Guyana","2024-07-21",0,0,0,0,0,0,0,0
"Guyana","2024-07-22",0,0,0,0,0,0,0,0
"Guyana","2024-07-23",0,0,0,0,0,0,0,0
"Guyana","2024-07-24",0,0,0,0,0,0,0,0
"Guyana","2024-07-25",0,0,0,0,0,0,0,0
"Guyana","2024-07-26",0,0,0,0,0,0,0,0
"Guyana","2024-07-27",0,0,0,0,0,0,0,0
"Guyana","2024-07-28",0,0,0,0,0,0,0,0
"Guyana","2024-07-29",0,0,0,0,0,0,0,0
"Guyana","2024-07-30",0,0,0,0,0,0,0,0
"Guyana","2024-07-31",0,0,0,0,0,0,0,0
"Guyana","2024-08-01",0,0,0,0,0,0,0,0
"Guyana","2024-08-02",0,0,0,0,0,0,0,0
"Guyana","2024-08-03",0,0,0,0,0,0,0,0
"Guyana","2024-08-04",0,0,0,0,0,0,0,0
"Guyana","2024-08-05",0,0,0,0,0,0,0,0
"Guyana","2024-08-06",0,0,0,0,0,0,0,0
"Guyana","2024-08-07",0,0,0,0,0,0,0,0
"Guyana","2024-08-08",0,0,0,0,0,0,0,0
"Guyana","2024-08-09",0,0,0,0,0,0,0,0
"Guyana","2024-08-10",0,0,0,0,0,0,0,0
"Guyana","2024-08-11",0,0,0,0,0,0,0,0
"Guyana","2024-08-12",0,0,0,0,0,0,0,0
"Guyana","2024-08-13",0,0,0,0,0,0,0,0
"Guyana","2024-08-14",0,0,0,0,0,0,0,0
"Guyana","2024-08-15",0,0,0,0,0,0,0,0
"Guyana","2024-08-16",0,0,0,0,0,0,0,0
"Guyana","2024-08-17",0,0,0,0,0,0,0,0
"Guyana","2024-08-18",0,0,0,0,0,0,0,0
"Guyana","2024-08-19",0,0,0,0,0,0,0,0
"Guyana","2024-08-20",0,0,0,0,0,0,0,0
"Guyana","2024-08-21",0,0,0,0,0,0,0,0
"Guyana","2024-08-22",0,0,0,0,0,0,0,0
"Guyana","2024-08-23",0,0,0,0,0,0,0,0
"Guyana","2024-08-24",0,0,0,0,0,0,0,0
"Guyana","2024-08-25",0,0,0,0,0,0,0,0
"Guyana","2024-08-26",0,0,0,0,0,0,0,0
"Guyana","2024-08-27",0,0,0,0,0,0,0,0
"Guyana","2024-08-28",0,0,0,0,0,0,0,0
"Guyana","2024-08-29",0,0,0,0,0,0,0,0
"Guyana","2024-08-30",0,0,0,0,0,0,0,0
"Guyana","2024-08-31",0,0,0,0,0,0,0,0
"Guyana","2024-09-01",0,0,0,0,0,0,0,0
"Guyana","2024-09-02",0,0,0,0,0,0,0,0
"Guyana","2024-09-03",0,0,0,0,0,0,0,0
"Guyana","2024-09-04",0,0,0,0,0,0,0,0
"Guyana","2024-09-05",0,0,0,0,0,0,0,0
"Guyana","2024-09-06",0,0,0,0,0,0,0,0
"Guyana","2024-09-07",0,0,0,0,0,0,0,0
"Guyana","2024-09-08",0,0,0,0,0,0,0,0
"Guyana","2024-09-09",0,0,0,0,0,0,0,0
"Guyana","2024-09-10",0,0,0,0,0,0,0,0
"Guyana","2024-09-11",0,0,0,0,0,0,0,0
"Guyana","2024-09-12",0,0,0,0,0,0,0,0
"Guyana","2024-09-13",0,0,0,0,0,0,0,0
"Guyana","2024-09-14",0,0,0,0,0,0,0,0
"Guyana","2024-09-15",0,0,0,0,0,0,0,0
"Guyana","2024-09-16",0,0,0,0,0,0,0,0
"Guyana","2024-09-17",0,0,0,0,0,0,0,0
"Guyana","2024-09-18",0,0,0,0,0,0,0,0
"Guyana","2024-09-19",0,0,0,0,0,0,0,0
"Guyana","2024-09-20",0,0,0,0,0,0,0,0
"Guyana","2024-09-21",0,0,0,0,0,0,0,0
"Guyana","2024-09-22",0,0,0,0,0,0,0,0
"Guyana","2024-09-23",0,0,0,0,0,0,0,0
"Guyana","2024-09-24",0,0,0,0,0,0,0,0
"Guyana","2024-09-25",0,0,0,0,0,0,0,0
"Guyana","2024-09-26",0,0,0,0,0,0,0,0
"Guyana","2024-09-27",0,0,0,0,0,0,0,0
"Guyana","2024-09-28",0,0,0,0,0,0,0,0
"Guyana","2024-09-29",0,0,0,0,0,0,0,0
"Guyana","2024-09-30",0,0,0,0,0,0,0,0
"Guyana","2024-10-01",0,0,0,0,0,0,0,0
"Guyana","2024-10-02",0,0,0,0,0,0,0,0
"Guyana","2024-10-03",0,0,0,0,0,0,0,0
"Guyana","2024-10-04",0,0,0,0,0,0,0,0
"Guyana","2024-10-05",0,0,0,0,0,0,0,0
"Guyana","2024-10-06",0,0,0,0,0,0,0,0
"Guyana","2024-10-07",0,0,0,0,0,0,0,0
"Guyana","2024-10-08",0,0,0,0,0,0,0,0
"Guyana","2024-10-09",0,0,0,0,0,0,0,0
"Guyana","2024-10-10",0,0,0,0,0,0,0,0
"Guyana","2024-10-11",0,0,0,0,0,0,0,0
"Guyana","2024-10-12",0,0,0,0,0,0,0,0
"Guyana","2024-10-13",0,0,0,0,0,0,0,0
"Guyana","2024-10-14",0,0,0,0,0,0,0,0
"Guyana","2024-10-15",0,0,0,0,0,0,0,0
"Guyana","2024-10-16",0,0,0,0,0,0,0,0
"Guyana","2024-10-17",0,0,0,0,0,0,0,0
"Guyana","2024-10-18",0,0,0,0,0,0,0,0
"Guyana","2024-10-19",0,0,0,0,0,0,0,0
"Guyana","2024-10-20",0,0,0,0,0,0,0,0
"Guyana","2024-10-21",0,0,0,0,0,0,0,0
"Guyana","2024-10-22",0,0,0,0,0,0,0,0
"Guyana","2024-10-23",0,0,0,0,0,0,0,0
"Guyana","2024-10-24",0,0,0,0,0,0,0,0
"Guyana","2024-10-25",0,0,0,0,0,0,0,0
"Guyana","2024-10-26",0,0,0,0,0,0,0,0
"Guyana","2024-10-27",0,0,0,0,0,0,0,0
"Guyana","2024-10-28",0,0,0,0,0,0,0,0
"Guyana","2024-10-29",0,0,0,0,0,0,0,0
"Guyana","2024-10-30",0,0,0,0,0,0,0,0
"Guyana","2024-10-31",0,0,0,0,0,0,0,0
"Guyana","2024-11-01",0,0,0,0,0,0,0,0
"Guyana","2024-11-02",0,0,0,0,0,0,0,0
"Guyana","2024-11-03",0,0,0,0,0,0,0,0
"Guyana","2024-11-04",0,0,0,0,0,0,0,0
"Guyana","2024-11-05",0,0,0,0,0,0,0,0
"Guyana","2024-11-06",0,0,0,0,0,0,0,0
"Guyana","2024-11-07",0,0,0,0,0,0,0,0
"Guyana","2024-11-08",0,0,0,0,0,0,0,0
"Guyana","2024-11-09",0,0,0,0,0,0,0,0
"Guyana","2024-11-10",0,0,0,0,0,0,0,0
"Guyana","2024-11-11",0,0,0,0,0,0,0,0
"Guyana","2024-11-12",0,0,0,0,0,0,0,0
"Guyana","2024-11-13",0,0,0,0,0,0,0,0
"Guyana","2024-11-14",0,0,0,0,0,0,0,0
"Guyana","2024-11-15",0,0,0,0,0,0,0,0
"Guyana","2024-11-16",0,0,0,0,0,0,0,0
"Guyana","2024-11-17",0,0,0,0,0,0,0,0
"Guyana","2024-11-18",0,0,0,0,0,0,0,0
"Guyana","2024-11-19",0,0,0,0,0,0,0,0
"Guyana","2024-11-20",0,0,0,0,0,0,0,0
"Guyana","2024-11-21",0,0,0,0,0,0,0,0
"Guyana","2024-11-22",0,0,0,0,0,0,0,0
"Guyana","2024-11-23",0,0,0,0,0,0,0,0
"Guyana","2024-11-24",0,0,0,0,0,0,0,0
"Guyana","2024-11-25",0,0,0,0,0,0,0,0
"Guyana","2024-11-26",0,0,0,0,0,0,0,0
"Guyana","2024-11-27",0,0,0,0,0,0,0,0
"Guyana","2024-11-28",0,0,0,0,0,0,0,0
"Guyana","2024-11-29",0,0,0,0,0,0,0,0
"Guyana","2024-11-30",0,0,0,0,0,0,0,0
"Guyana","2024-12-01",0,0,0,0,0,0,0,0
"Guyana","2024-12-02",0,0,0,0,0,0,0,0
"Guyana","2024-12-03",0,0,0,0,0,0,0,0
"Guyana","2024-12-04",0,0,0,0,0,0,0,0
"Guyana","2024-12-05",0,0,0,0,0,0,0,0
"Guyana","2024-12-06",0,0,0,0,0,0,0,0
"Guyana","2024-12-07",0,0,0,0,0,0,0,0
"Guyana","2024-12-08",0,0,0,0,0,0,0,0
"Guyana","2024-12-09",0,0,0,0,0,0,0,0
"Guyana","2024-12-10",0,0,0,0,0,0,0,0
"Guyana","2024-12-11",0,0,0,0,0,0,0,0
"Guyana","2024-12-12",0,0,0,0,0,0,0,0
"Guyana","2024-12-13",0,0,0,0,0,0,0,0
"Guyana","2024-12-14",0,0,0,0,0,0,0,0
"Guyana","2024-12-15",0,0,0,0,0,0,0,0
"Guyana","2024-12-16",0,0,0,0,0,0,0,0
"Guyana","2024-12-17",0,0,0,0,0,0,0,0
"Guyana","2024-12-18",0,0,0,0,0,0,0,0
"Guyana","2024-12-19",0,0,0,0,0,0,0,0
"Guyana","2024-12-20",0,0,0,0,0,0,0,0
"Guyana","2024-12-21",0,0,0,0,0,0,0,0
"Guyana","2024-12-22",0,0,0,0,0,0,0,0
"Guyana","2024-12-23",0,0,0,0,0,0,0,0
"Guyana","2024-12-24",0,0,0,0,0,0,0,0
"Guyana","2024-12-25",0,0,0,0,0,0,0,0
"Guyana","2024-12-26",0,0,0,0,0,0,0,0
"Guyana","2024-12-27",0,0,0,0,0,0,0,0
"Guyana","2024-12-28",0,0,0,0,0,0,0,0
"Guyana","2024-12-29",0,0,0,0,0,0,0,0
"Guyana","2024-12-30",0,0,0,0,0,0,0,0
"Guyana","2024-12-31",0,0,0,0,0,0,0,0
"Guyana","2025-01-01",0,0,0,0,0,0,0,0
"Guyana","2025-01-02",0,0,0,0,0,0,0,0
"Guyana","2025-01-03",0,0,0,0,0,0,0,0
"Guyana","2025-01-04",0,0,0,0,0,0,0,0
"Guyana","2025-01-05",0,0,0,0,0,0,0,0
"Guyana","2025-01-06",0,0,0,0,0,0,0,0
"Guyana","2025-01-07",0,0,0,0,0,0,0,0
"Guyana","2025-01-08",0,0,0,0,0,0,0,0
"Guyana","2025-01-09",0,0,0,0,0,0,0,0
"Guyana","2025-01-10",0,0,0,0,0,0,0,0
"Guyana","2025-01-11",0,0,0,0,0,0,0,0
"Guyana","2025-01-12",0,0,0,0,0,0,0,0
"Guyana","2025-01-13",0,0,0,0,0,0,0,0
"Guyana","2025-01-14",0,0,0,0,0,0,0,0
"Guyana","2025-01-15",0,0,0,0,0,0,0,0
"Guyana","2025-01-16",0,0,0,0,0,0,0,0
"Guyana","2025-01-17",0,0,0,0,0,0,0,0
"Guyana","2025-01-18",0,0,0,0,0,0,0,0
"Guyana","2025-01-19",0,0,0,0,0,0,0,0
"Guyana","2025-01-20",0,0,0,0,0,0,0,0
"Guyana","2025-01-21",0,0,0,0,0,0,0,0
"Guyana","2025-01-22",0,0,0,0,0,0,0,0
"Guyana","2025-01-23",0,0,0,0,0,0,0,0
"Guyana","2025-01-24",0,0,0,0,0,0,0,0
"Guyana","2025-01-25",0,0,0,0,0,0,0,0
"Guyana","2025-01-26",0,0,0,0,0,0,0,0
"Guyana","2025-01-27",0,0,0,0,0,0,0,0
"Guyana","2025-01-28",0,0,0,0,0,0,0,0
"Guyana","2025-01-29",0,0,0,0,0,0,0,0
"Guyana","2025-01-30",0,0,0,0,0,0,0,0
"Guyana","2025-01-31",0,0,0,0,0,0,0,0
"Guyana","2025-02-01",0,0,0,0,0,0,0,0
"Guyana","2025-02-02",0,0,0,0,0,0,0,0
"Guyana","2025-02-03",0,0,0,0,0,0,0,0
"Guyana","2025-02-04",0,0,0,0,0,0,0,0
"Guyana","2025-02-05",0,0,0,0,0,0,0,0
"Guyana","2025-02-06",0,0,0,0,0,0,0,0
"Guyana","2025-02-07",0,0,0,0,0,0,0,0
"Guyana","2025-02-08",0,0,0,0,0,0,0,0
"Guyana","2025-02-09",0,0,0,0,0,0,0,0
"Guyana","2025-02-10",0,0,0,0,0,0,0,0
"Guyana","2025-02-11",0,0,0,0,0,0,0,0
"Guyana","2025-02-12",0,0,0,0,0,0,0,0
"Guyana","2025-02-13",0,0,0,0,0,0,0,0
"Guyana","2025-02-14",0,0,0,0,0,0,0,0
"Guyana","2025-02-15",0,0,0,0,0,0,0,0
"Guyana","2025-02-16",0,0,0,0,0,0,0,0
"Guyana","2025-02-17",0,0,0,0,0,0,0,0
"Guyana","2025-02-18",0,0,0,0,0,0,0,0
"Guyana","2025-02-19",0,0,0,0,0,0,0,0
"Guyana","2025-02-20",0,0,0,0,0,0,0,0
"Guyana","2025-02-21",0,0,0,0,0,0,0,0
"Guyana","2025-02-22",0,0,0,0,0,0,0,0
"Guyana","2025-02-23",0,0,0,0,0,0,0,0
"Guyana","2025-02-24",0,0,0,0,0,0,0,0
"Guyana","2025-02-25",0,0,0,0,0,0,0,0
"Guyana","2025-02-26",0,0,0,0,0,0,0,0
"Guyana","2025-02-27",0,0,0,0,0,0,0,0
"Guyana","2025-02-28",0,0,0,0,0,0,0,0
"Guyana","2025-03-01",0,0,0,0,0,0,0,0
"Guyana","2025-03-02",0,0,0,0,0,0,0,0
"Guyana","2025-03-03",0,0,0,0,0,0,0,0
"Honduras","2024-01-01",0,0,0,0,0,0,0,0
"Honduras","2024-01-02",0,0,0,0,0,0,0,0
"Honduras","2024-01-03",0,0,0,0,0,0,0,0
"Honduras","2024-01-04",0,0,0,0,0,0,0,0
"Honduras","2024-01-05",0,0,0,0,0,0,0,0
"Honduras","2024-01-06",0,0,0,0,0,0,0,0
"Honduras","2024-01-07",0,0,0,0,0,0,0,0
"Honduras","2024-01-08",0,0,0,0,0,0,0,0
"Honduras","2024-01-09",0,0,0,0,0,0,0,0
"Honduras","2024-01-10",0,0,0,0,0,0,0,0
"Honduras","2024-01-11",0,0,0,0,0,0,0,0
"Honduras","2024-01-12",0,0,0,0,0,0,0,0
"Honduras","2024-01-13",0,0,0,0,0,0,0,0
"Honduras","2024-01-14",0,0,0,0,0,0,0,0
"Honduras","2024-01-15",0,0,0,0,0,0,0,0
"Honduras","2024-01-16",0,0,0,0,0,0,0,0
"Honduras","2024-01-17",0,0,0,0,0,0,0,0
"Honduras","2024-01-18",0,0,0,0,0,0,0,0
"Honduras","2024-01-19",0,0,0,0,0,0,0,0
"Honduras","2024-01-20",0,0,0,0,0,0,0,0
"Honduras","2024-01-21",0,0,0,0,0,0,0,0
"Honduras","2024-01-22",0,0,0,0,0,0,0,0
"Honduras","2024-01-23",0,0,0,0,0,0,0,0
"Honduras","2024-01-24",0,0,0,0,0,0,0,0
"Honduras","2024-01-25",0,0,0,0,0,0,0,0
"Honduras","2024-01-26",0,0,0,0,0,0,0,0
"Honduras","2024-01-27",0,0,0,0,0,0,0,0
"Honduras","2024-01-28",0,0,0,0,0,0,0,0
"Honduras","2024-01-29",0,0,0,0,0,0,0,0
"Honduras","2024-01-30",0,0,0,0,0,0,0,0
"Honduras","2024-01-31",0,0,0,0,0,0,0,0
"Honduras","2024-02-01",0,0,0,0,0,0,0,0
"Honduras","2024-02-02",0,0,0,0,0,0,0,0
"Honduras","2024-02-03",0,0,0,0,0,0,0,0
"Honduras","2024-02-04",0,0,0,0,0,0,0,0
"Honduras","2024-02-05",0,0,0,0,0,0,0,0
"Honduras","2024-02-06",0,0,0,0,0,0,0,0
"Honduras","2024-02-07",0,0,0,0,0,0,0,0
"Honduras","2024-02-08",0,0,0,0,0,0,0,0
"Honduras","2024-02-09",0,0,0,0,0,0,0,0
"Honduras","2024-02-10",0,0,0,0,0,0,0,0
"Honduras","2024-02-11",0,0,0,0,0,0,0,0
"Honduras","2024-02-12",0,0,0,0,0,0,0,0
"Honduras","2024-02-13",0,0,0,0,0,0,0,0
"Honduras","2024-02-14",0,0,0,0,0,0,0,0
"Honduras","2024-02-15",0,0,0,0,0,0,0,0
"Honduras","2024-02-16",0,0,0,0,0,0,0,0
"Honduras","2024-02-17",0,0,0,0,0,0,0,0
"Honduras","2024-02-18",0,0,0,0,0,0,0,0
"Honduras","2024-02-19",0,0,0,0,0,0,0,0
"Honduras","2024-02-20",0,0,0,0,0,0,0,0
"Honduras","2024-02-21",0,0,0,0,0,0,0,0
"Honduras","2024-02-22",0,0,0,0,0,0,0,0
"Honduras","2024-02-23",0,0,0,0,0,0,0,0
"Honduras","2024-02-24",0,0,0,0,0,0,0,0
"Honduras","2024-02-25",0,0,0,0,0,0,0,0
"Honduras","2024-02-26",0,0,0,0,0,0,0,0
"Honduras","2024-02-27",0,0,0,0,0,0,0,0
"Honduras","2024-02-28",0,0,0,0,0,0,0,0
"Honduras","2024-02-29",0,0,0,0,0,0,0,0
"Honduras","2024-03-01",0,0,0,0,0,0,0,0
"Honduras","2024-03-02",0,0,0,0,0,0,0,0
"Honduras","2024-03-03",0,0,0,0,0,0,0,0
"Honduras","2024-03-04",0,0,0,0,0,0,0,0
"Honduras","2024-03-05",0,0,0,0,0,0,0,0
"Honduras","2024-03-06",0,0,0,0,0,0,0,0
"Honduras","2024-03-07",0,0,0,0,0,0,0,0
"Honduras","2024-03-08",0,0,0,0,0,0,0,0
"Honduras","2024-03-09",0,0,0,0,0,0,0,0
"Honduras","2024-03-10",0,0,0,0,0,0,0,0
"Honduras","2024-03-11",0,0,0,0,0,0,0,0
"Honduras","2024-03-12",0,0,0,0,0,0,0,0
"Honduras","2024-03-13",0,0,0,0,0,0,0,0
"Honduras","2024-03-14",0,0,0,0,0,0,0,0
"Honduras","2024-03-15",0,0,0,0,0,0,0,0
"Honduras","2024-03-16",0,0,0,0,0,0,0,0
"Honduras","2024-03-17",0,0,0,0,0,0,0,0
"Honduras","2024-03-18",0,0,0,0,0,0,0,0
"Honduras","2024-03-19",0,0,0,0,0,0,0,0
"Honduras","2024-03-20",0,0,0,0,0,0,0,0
"Honduras","2024-03-21",0,0,0,0,0,0,0,0
"Honduras","2024-03-22",0,0,0,0,0,0,0,0
"Honduras","2024-03-23",0,0,0,0,0,0,0,0
"Honduras","2024-03-24",0,0,0,0,0,0,0,0
"Honduras","2024-03-25",0,0,0,0,0,0,0,0
"Honduras","2024-03-26",0,0,0,0,0,0,0,0
"Honduras","2024-03-27",0,0,0,0,0,0,0,0
"Honduras","2024-03-28",0,0,0,0,0,0,0,0
"Honduras","2024-03-29",0,0,0,0,0,0,0,0
"Honduras","2024-03-30",0,0,0,0,0,0,0,0
"Honduras","2024-03-31",0,0,0,0,0,0,0,0
"Honduras","2024-04-01",0,0,0,0,0,0,0,0
"Honduras","2024-04-02",0,0,0,0,0,0,0,0
"Honduras","2024-04-03",0,0,0,0,0,0,0,0
"Honduras","2024-04-04",0,0,0,0,0,0,0,0
"Honduras","2024-04-05",0,0,0,0,0,0,0,0
"Honduras","2024-04-06",0,0,0,0,0,0,0,0
"Honduras","2024-04-07",0,0,0,0,0,0,0,0
"Honduras","2024-04-08",0,0,0,0,0,0,0,0
"Honduras","2024-04-09",0,0,0,0,0,0,0,0
"Honduras","2024-04-10",0,0,0,0,0,0,0,0
"Honduras","2024-04-11",0,0,0,0,0,0,0,0
"Honduras","2024-04-12",0,0,0,0,0,0,0,0
"Honduras","2024-04-13",0,0,0,0,0,0,0,0
"Honduras","2024-04-14",0,0,0,0,0,0,0,0
"Honduras","2024-04-15",0,0,0,0,0,0,0,0
"Honduras","2024-04-16",0,0,0,0,0,0,0,0
"Honduras","2024-04-17",0,0,0,0,0,0,0,0
"Honduras","2024-04-18",0,0,0,0,0,0,0,0
"Honduras","2024-04-19",0,0,0,0,0,0,0,0
"Honduras","2024-04-20",0,0,0,0,0,0,0,0
"Honduras","2024-04-21",0,0,0,0,0,0,0,0
"Honduras","2024-04-22",0,0,0,0,0,0,0,0
"Honduras","2024-04-23",0,0,0,0,0,0,0,0
"Honduras","2024-04-24",0,0,0,0,0,0,0,0
"Honduras","2024-04-25",0,0,0,0,0,0,0,0
"Honduras","2024-04-26",0,0,0,0,0,0,0,0
"Honduras","2024-04-27",0,0,0,0,0,0,0,0
"Honduras","2024-04-28",0,0,0,0,0,0,0,0
"Honduras","2024-04-29",0,0,0,0,0,0,0,0
"Honduras","2024-04-30",0,0,0,0,0,0,0,0
"Honduras","2024-05-01",0,0,0,0,0,0,0,0
"Honduras","2024-05-02",0,0,0,0,0,0,0,0
"Honduras","2024-05-03",0,0,0,0,0,0,0,0
"Honduras","2024-05-04",0,0,0,0,0,0,0,0
"Honduras","2024-05-05",0,0,0,0,0,0,0,0
"Honduras","2024-05-06",0,0,0,0,0,0,0,0
"Honduras","2024-05-07",0,0,0,0,0,0,0,0
"Honduras","2024-05-08",0,0,0,0,0,0,0,0
"Honduras","2024-05-09",0,0,0,0,0,0,0,0
"Honduras","2024-05-10",0,0,0,0,0,0,0,0
"Honduras","2024-05-11",0,0,0,0,0,0,0,0
"Honduras","2024-05-12",0,0,0,0,0,0,0,0
"Honduras","2024-05-13",0,0,0,0,0,0,0,0
"Honduras","2024-05-14",0,0,0,0,0,0,0,0
"Honduras","2024-05-15",0,0,0,0,0,0,0,0
"Honduras","2024-05-16",0,0,0,0,0,0,0,0
"Honduras","2024-05-17",0,0,0,0,0,0,0,0
"Honduras","2024-05-18",0,0,0,0,0,0,0,0
"Honduras","2024-05-19",0,0,0,0,0,0,0,0
"Honduras","2024-05-20",0,0,0,0,0,0,0,0
"Honduras","2024-05-21",0,0,0,0,0,0,0,0
"Honduras","2024-05-22",0,0,0,0,0,0,0,0
"Honduras","2024-05-23",0,0,0,0,0,0,0,0
"Honduras","2024-05-24",0,0,0,0,0,0,0,0
"Honduras","2024-05-25",0,0,0,0,0,0,0,0
"Honduras","2024-05-26",0,0,0,0,0,0,0,0
"Honduras","2024-05-27",0,0,0,0,0,0,0,0
"Honduras","2024-05-28",0,0,0,0,0,0,0,0
"Honduras","2024-05-29",0,0,0,0,0,0,0,0
"Honduras","2024-05-30",0,0,0,0,0,0,0,0
"Honduras","2024-05-31",0,0,0,0,0,0,0,0
"Honduras","2024-06-01",0,0,0,0,0,0,0,0
"Honduras","2024-06-02",0,0,0,0,0,0,0,0
"Honduras","2024-06-03",0,0,0,0,0,0,0,0
"Honduras","2024-06-04",0,0,0,0,0,0,0,0
"Honduras","2024-06-05",0,0,0,0,0,0,0,0
"Honduras","2024-06-06",0,0,0,0,0,0,0,0
"Honduras","2024-06-07",0,0,0,0,0,0,0,0
"Honduras","2024-06-08",0,0,0,0,0,0,0,0
"Honduras","2024-06-09",0,0,0,0,0,0,0,0
"Honduras","2024-06-10",0,0,0,0,0,0,0,0
"Honduras","2024-06-11",0,0,0,0,0,0,0,0
"Honduras","2024-06-12",0,0,0,0,0,0,0,0
"Honduras","2024-06-13",0,0,0,0,0,0,0,0
"Honduras","2024-06-14",0,0,0,0,0,0,0,0
"Honduras","2024-06-15",0,0,0,0,0,0,0,0
"Honduras","2024-06-16",0,0,0,0,0,0,0,0
"Honduras","2024-06-17",0,0,0,0,0,0,0,0
"Honduras","2024-06-18",0,0,0,0,0,0,0,0
"Honduras","2024-06-19",0,0,0,0,0,0,0,0
"Honduras","2024-06-20",0,0,0,0,0,0,0,0
"Honduras","2024-06-21",0,0,0,0,0,0,0,0
"Honduras","2024-06-22",0,0,0,0,0,0,0,0
"Honduras","2024-06-23",0,0,0,0,0,0,0,0
"Honduras","2024-06-24",0,0,0,0,0,0,0,0
"Honduras","2024-06-25",0,0,0,0,0,0,0,0
"Honduras","2024-06-26",0,0,0,0,0,0,0,0
"Honduras","2024-06-27",0,0,0,0,0,0,0,0
"Honduras","2024-06-28",0,0,0,0,0,0,0,0
"Honduras","2024-06-29",0,0,0,0,0,0,0,0
"Honduras","2024-06-30",0,0,0,0,0,0,0,0
"Honduras","2024-07-01",0,0,0,0,0,0,0,0
"Honduras","2024-07-02",0,0,0,0,0,0,0,0
"Honduras","2024-07-03",0,0,0,0,0,0,0,0
"Honduras","2024-07-04",0,0,0,0,0,0,0,0
"Honduras","2024-07-05",0,0,0,0,0,0,0,0
"Honduras","2024-07-06",0,0,0,0,0,0,0,0
"Honduras","2024-07-07",0,0,0,0,0,0,0,0
"Honduras","2024-07-08",0,0,0,0,0,0,0,0
"Honduras","2024-07-09",0,0,0,0,0,0,0,0
"Honduras","2024-07-10",0,0,0,0,0,0,0,0
"Honduras","2024-07-11",0,0,0,0,0,0,0,0
"Honduras","2024-07-12",0,0,0,0,0,0,0,0
"Honduras","2024-07-13",0,0,0,0,0,0,0,0
"Honduras","2024-07-14",0,0,0,0,0,0,0,0
"Honduras","2024-07-15",0,0,0,0,0,0,0,0
"Honduras","2024-07-16",0,0,0,0,0,0,0,0
"Honduras","2024-07-17",0,0,0,0,0,0,0,0
"Honduras","2024-07-18",0,0,0,0,0,0,0,0
"Honduras","2024-07-19",0,0,0,0,0,0,0,0
"Honduras","2024-07-20",0,0,0,0,0,0,0,0
"Honduras","2024-07-21",0,0,0,0,0,0,0,0
"Honduras","2024-07-22",0,0,0,0,0,0,0,0
"Honduras","2024-07-23",0,0,0,0,0,0,0,0
"Honduras","2024-07-24",0,0,0,0,0,0,0,0
"Honduras","2024-07-25",0,0,0,0,0,0,0,0
"Honduras","2024-07-26",0,0,0,0,0,0,0,0
"Honduras","2024-07-27",0,0,0,0,0,0,0,0
"Honduras","2024-07-28",0,0,0,0,0,0,0,0
"Honduras","2024-07-29",0,0,0,0,0,0,0,0
"Honduras","2024-07-30",0,0,0,0,0,0,0,0
"Honduras","2024-07-31",0,0,0,0,0,0,0,0
"Honduras","2024-08-01",0,0,0,0,0,0,0,0
"Honduras","2024-08-02",0,0,0,0,0,0,0,0
"Honduras","2024-08-03",0,0,0,0,0,0,0,0
"Honduras","2024-08-04",0,0,0,0,0,0,0,0
"Honduras","2024-08-05",0,0,0,0,0,0,0,0
"Honduras","2024-08-06",0,0,0,0,0,0,0,0
"Honduras","2024-08-07",0,0,0,0,0,0,0,0
"Honduras","2024-08-08",0,0,0,0,0,0,0,0
"Honduras","2024-08-09",0,0,0,0,0,0,0,0
"Honduras","2024-08-10",0,0,0,0,0,0,0,0
"Honduras","2024-08-11",0,0,0,0,0,0,0,0
"Honduras","2024-08-12",0,0,0,0,0,0,0,0
"Honduras","2024-08-13",0,0,0,0,0,0,0,0
"Honduras","2024-08-14",0,0,0,0,0,0,0,0
"Honduras","2024-08-15",0,0,0,0,0,0,0,0
"Honduras","2024-08-16",0,0,0,0,0,0,0,0
"Honduras","2024-08-17",0,0,0,0,0,0,0,0
"Honduras","2024-08-18",0,0,0,0,0,0,0,0
"Honduras","2024-08-19",0,0,0,0,0,0,0,0
"Honduras","2024-08-20",0,0,0,0,0,0,0,0
"Honduras","2024-08-21",0,0,0,0,0,0,0,0
"Honduras","2024-08-22",0,0,0,0,0,0,0,0
"Honduras","2024-08-23",0,0,0,0,0,0,0,0
"Honduras","2024-08-24",0,0,0,0,0,0,0,0
"Honduras","2024-08-25",0,0,0,0,0,0,0,0
"Honduras","2024-08-26",0,0,0,0,0,0,0,0
"Honduras","2024-08-27",0,0,0,0,0,0,0,0
"Honduras","2024-08-28",0,0,0,0,0,0,0,0
"Honduras","2024-08-29",0,0,0,0,0,0,0,0
"Honduras","2024-08-30",0,0,0,0,0,0,0,0
"Honduras","2024-08-31",0,0,0,0,0,0,0,0
"Honduras","2024-09-01",0,0,0,0,0,0,0,0
"Honduras","2024-09-02",0,0,0,0,0,0,0,0
"Honduras","2024-09-03",0,0,0,0,0,0,0,0
"Honduras","2024-09-04",0,0,0,0,0,0,0,0
"Honduras","2024-09-05",0,0,0,0,0,0,0,0
"Honduras","2024-09-06",0,0,0,0,0,0,0,0
"Honduras","2024-09-07",0,0,0,0,0,0,0,0
"Honduras","2024-09-08",0,0,0,0,0,0,0,0
"Honduras","2024-09-09",0,0,0,0,0,0,0,0
"Honduras","2024-09-10",0,0,0,0,0,0,0,0
"Honduras","2024-09-11",0,0,0,0,0,0,0,0
"Honduras","2024-09-12",0,0,0,0,0,0,0,0
"Honduras","2024-09-13",0,0,0,0,0,0,0,0
"Honduras","2024-09-14",0,0,0,0,0,0,0,0
"Honduras","2024-09-15",0,0,0,0,0,0,0,0
"Honduras","2024-09-16",0,0,0,0,0,0,0,0
"Honduras","2024-09-17",0,0,0,0,0,0,0,0
"Honduras","2024-09-18",0,0,0,0,0,0,0,0
"Honduras","2024-09-19",0,0,0,0,0,0,0,0
"Honduras","2024-09-20",0,0,0,0,0,0,0,0
"Honduras","2024-09-21",0,0,0,0,0,0,0,0
"Honduras","2024-09-22",0,0,0,0,0,0,0,0
"Honduras","2024-09-23",0,0,0,0,0,0,0,0
"Honduras","2024-09-24",0,0,0,0,0,0,0,0
"Honduras","2024-09-25",0,0,0,0,0,0,0,0
"Honduras","2024-09-26",0,0,0,0,0,0,0,0
"Honduras","2024-09-27",0,0,0,0,0,0,0,0
"Honduras","2024-09-28",0,0,0,0,0,0,0,0
"Honduras","2024-09-29",0,0,0,0,0,0,0,0
"Honduras","2024-09-30",0,0,0,0,0,0,0,0
"Honduras","2024-10-01",0,0,0,0,0,0,0,0
"Honduras","2024-10-02",0,0,0,0,0,0,0,0
"Honduras","2024-10-03",0,0,0,0,0,0,0,0
"Honduras","2024-10-04",0,0,0,0,0,0,0,0
"Honduras","2024-10-05",0,0,0,0,0,0,0,0
"Honduras","2024-10-06",0,0,0,0,0,0,0,0
"Honduras","2024-10-07",0,0,0,0,0,0,0,0
"Honduras","2024-10-08",0,0,0,0,0,0,0,0
"Honduras","2024-10-09",0,0,0,0,0,0,0,0
"Honduras","2024-10-10",0,0,0,0,0,0,0,0
"Honduras","2024-10-11",0,0,0,0,0,0,0,0
"Honduras","2024-10-12",0,0,0,0,0,0,0,0
"Honduras","2024-10-13",0,0,0,0,0,0,0,0
"Honduras","2024-10-14",0,0,0,0,0,0,0,0
"Honduras","2024-10-15",0,0,0,0,0,0,0,0
"Honduras","2024-10-16",0,0,0,0,0,0,0,0
"Honduras","2024-10-17",0,0,0,0,0,0,0,0
"Honduras","2024-10-18",0,0,0,0,0,0,0,0
"Honduras","2024-10-19",0,0,0,0,0,0,0,0
"Honduras","2024-10-20",0,0,0,0,0,0,0,0
"Honduras","2024-10-21",0,0,0,0,0,0,0,0
"Honduras","2024-10-22",0,0,0,0,0,0,0,0
"Honduras","2024-10-23",0,0,0,0,0,0,0,0
"Honduras","2024-10-24",0,0,0,0,0,0,0,0
"Honduras","2024-10-25",0,0,0,0,0,0,0,0
"Honduras","2024-10-26",0,0,0,0,0,0,0,0
"Honduras","2024-10-27",0,0,0,0,0,0,0,0
"Honduras","2024-10-28",0,0,0,0,0,0,0,0
"Honduras","2024-10-29",0,0,0,0,0,0,0,0
"Honduras","2024-10-30",0,0,0,0,0,0,0,0
"Honduras","2024-10-31",0,0,0,0,0,0,0,0
"Honduras","2024-11-01",0,0,0,0,0,0,0,0
"Honduras","2024-11-02",0,0,0,0,0,0,0,0
"Honduras","2024-11-03",0,0,0,0,0,0,0,0
"Honduras","2024-11-04",0,0,0,0,0,0,0,0
"Honduras","2024-11-05",0,0,0,0,0,0,0,0
"Honduras","2024-11-06",0,0,0,0,0,0,0,0
"Honduras","2024-11-07",0,0,0,0,0,0,0,0
"Honduras","2024-11-08",0,0,0,0,0,0,0,0
"Honduras","2024-11-09",0,0,0,0,0,0,0,0
"Honduras","2024-11-10",0,0,0,0,0,0,0,0
"Honduras","2024-11-11",0,0,0,0,0,0,0,0
"Honduras","2024-11-12",0,0,0,0,0,0,0,0
"Honduras","2024-11-13",0,0,0,0,0,0,0,0
"Honduras","2024-11-14",0,0,0,0,0,0,0,0
"Honduras","2024-11-15",0,0,0,0,0,0,0,0
"Honduras","2024-11-16",0,0,0,0,0,0,0,0
"Honduras","2024-11-17",0,0,0,0,0,0,0,0
"Honduras","2024-11-18",0,0,0,0,0,0,0,0
"Honduras","2024-11-19",0,0,0,0,0,0,0,0
"Honduras","2024-11-20",0,0,0,0,0,0,0,0
"Honduras","2024-11-21",0,0,0,0,0,0,0,0
"Honduras","2024-11-22",0,0,0,0,0,0,0,0
"Honduras","2024-11-23",0,0,0,0,0,0,0,0
"Honduras","2024-11-24",0,0,0,0,0,0,0,0
"Honduras","2024-11-25",0,0,0,0,0,0,0,0
"Honduras","2024-11-26",0,0,0,0,0,0,0,0
"Honduras","2024-11-27",0,0,0,0,0,0,0,0
"Honduras","2024-11-28",0,0,0,0,0,0,0,0
"Honduras","2024-11-29",0,0,0,0,0,0,0,0
"Honduras","2024-11-30",0,0,0,0,0,0,0,0
"Honduras","2024-12-01",0,0,0,0,0,0,0,0
"Honduras","2024-12-02",0,0,0,0,0,0,0,0
"Honduras","2024-12-03",0,0,0,0,0,0,0,0
"Honduras","2024-12-04",0,0,0,0,0,0,0,0
"Honduras","2024-12-05",0,0,0,0,0,0,0,0
"Honduras","2024-12-06",0,0,0,0,0,0,0,0
"Honduras","2024-12-07",0,0,0,0,0,0,0,0
"Honduras","2024-12-08",0,0,0,0,0,0,0,0
"Honduras","2024-12-09",0,0,0,0,0,0,0,0
"Honduras","2024-12-10",0,0,0,0,0,0,0,0
"Honduras","2024-12-11",0,0,0,0,0,0,0,0
"Honduras","2024-12-12",0,0,0,0,0,0,0,0
"Honduras","2024-12-13",0,0,0,0,0,0,0,0
"Honduras","2024-12-14",0,0,0,0,0,0,0,0
"Honduras","2024-12-15",0,0,0,0,0,0,0,0
"Honduras","2024-12-16",0,0,0,0,0,0,0,0
"Honduras","2024-12-17",0,0,0,0,0,0,0,0
"Honduras","2024-12-18",0,0,0,0,0,0,0,0
"Honduras","2024-12-19",0,0,0,0,0,0,0,0
"Honduras","2024-12-20",0,0,0,0,0,0,0,0
"Honduras","2024-12-21",0,0,0,0,0,0,0,0
"Honduras","2024-12-22",0,0,0,0,0,0,0,0
"Honduras","2024-12-23",0,0,0,0,0,0,0,0
"Honduras","2024-12-24",0,0,0,0,0,0,0,0
"Honduras","2024-12-25",0,0,0,0,0,0,0,0
"Honduras","2024-12-26",0,0,0,0,0,0,0,0
"Honduras","2024-12-27",0,0,0,0,0,0,0,0
"Honduras","2024-12-28",0,0,0,0,0,0,0,0
"Honduras","2024-12-29",0,0,0,0,0,0,0,0
"Honduras","2024-12-30",0,0,0,0,0,0,0,0
"Honduras","2024-12-31",0,0,0,0,0,0,0,0
"Honduras","2025-01-01",0,0,0,0,0,0,0,0
"Honduras","2025-01-02",0,0,0,0,0,0,0,0
"Honduras","2025-01-03",0,0,0,0,0,0,0,0
"Honduras","2025-01-04",0,0,0,0,0,0,0,0
"Honduras","2025-01-05",0,0,0,0,0,0,0,0
"Honduras","2025-01-06",0,0,0,0,0,0,0,0
"Honduras","2025-01-07",0,0,0,0,0,0,0,0
"Honduras","2025-01-08",0,0,0,0,0,0,0,0
"Honduras","2025-01-09",0,0,0,0,0,0,0,0
"Honduras","2025-01-10",0,0,0,0,0,0,0,0
"Honduras","2025-01-11",0,0,0,0,0,0,0,0
"Honduras","2025-01-12",0,0,0,0,0,0,0,0
"Honduras","2025-01-13",0,0,0,0,0,0,0,0
"Honduras","2025-01-14",0,0,0,0,0,0,0,0
"Honduras","2025-01-15",0,0,0,0,0,0,0,0
"Honduras","2025-01-16",0,0,0,0,0,0,0,0
"Honduras","2025-01-17",0,0,0,0,0,0,0,0
"Honduras","2025-01-18",0,0,0,0,0,0,0,0
"Honduras","2025-01-19",0,0,0,0,0,0,0,0
"Honduras","2025-01-20",0,0,0,0,0,0,0,0
"Honduras","2025-01-21",0,0,0,0,0,0,0,0
"Honduras","2025-01-22",0,0,0,0,0,0,0,0
"Honduras","2025-01-23",0,0,0,0,0,0,0,0
"Honduras","2025-01-24",0,0,0,0,0,0,0,0
"Honduras","2025-01-25",0,0,0,0,0,0,0,0
"Honduras","2025-01-26",0,0,0,0,0,0,0,0
"Honduras","2025-01-27",0,0,0,0,0,0,0,0
"Honduras","2025-01-28",0,0,0,0,0,0,0,0
"Honduras","2025-01-29",0,0,0,0,0,0,0,0
"Honduras","2025-01-30",0,0,0,0,0,0,0,0
"Honduras","2025-01-31",0,0,0,0,0,0,0,0
"Honduras","2025-02-01",0,0,0,0,0,0,0,0
"Honduras","2025-02-02",0,0,0,0,0,0,0,0
"Honduras","2025-02-03",0,0,0,0,0,0,0,0
"Honduras","2025-02-04",0,0,0,0,0,0,0,0
"Honduras","2025-02-05",0,0,0,0,0,0,0,0
"Honduras","2025-02-06",0,0,0,0,0,0,0,0
"Honduras","2025-02-07",0,0,0,0,0,0,0,0
"Honduras","2025-02-08",0,0,0,0,0,0,0,0
"Honduras","2025-02-09",0,0,0,0,0,0,0,0
"Honduras","2025-02-10",0,0,0,0,0,0,0,0
"Honduras","2025-02-11",0,0,0,0,0,0,0,0
"Honduras","2025-02-12",0,0,0,0,0,0,0,0
"Honduras","2025-02-13",0,0,0,0,0,0,0,0
"Honduras","2025-02-14",0,0,0,0,0,0,0,0
"Honduras","2025-02-15",0,0,0,0,0,0,0,0
"Honduras","2025-02-16",0,0,0,0,0,0,0,0
"Honduras","2025-02-17",0,0,0,0,0,0,0,0
"Honduras","2025-02-18",0,0,0,0,0,0,0,0
"Honduras","2025-02-19",0,0,0,0,0,0,0,0
"Honduras","2025-02-20",0,0,0,0,0,0,0,0
"Honduras","2025-02-21",0,0,0,0,0,0,0,0
"Honduras","2025-02-22",0,0,0,0,0,0,0,0
"Honduras","2025-02-23",0,0,0,0,0,0,0,0
"Honduras","2025-02-24",0,0,0,0,0,0,0,0
"Honduras","2025-02-25",0,0,0,0,0,0,0,0
"Honduras","2025-02-26",0,0,0,0,0,0,0,0
"Honduras","2025-02-27",0,0,0,0,0,0,0,0
"Honduras","2025-02-28",0,0,0,0,0,0,0,0
"Honduras","2025-03-01",0,0,0,0,0,0,0,0
"Honduras","2025-03-02",0,0,0,0,0,0,0,0
"Honduras","2025-03-03",0,0,0,0,0,0,0,0
"Hungary","2024-01-01",0,0,0,0,0,0,0,0
"Hungary","2024-01-02",0,0,0,0,0,0,0,0
"Hungary","2024-01-03",0,0,0,0,0,0,0,0
"Hungary","2024-01-04",0,0,0,0,0,0,0,0
"Hungary","2024-01-05",0,0,0,0,0,0,0,0
"Hungary","2024-01-06",0,0,0,0,0,0,0,0
"Hungary","2024-01-07",0,0,0,0,0,0,0,0
"Hungary","2024-01-08",0,0,0,0,0,0,0,0
"Hungary","2024-01-09",0,0,0,0,0,0,0,0
"Hungary","2024-01-10",0,0,0,0,0,0,0,0
"Hungary","2024-01-11",0,0,0,0,0,0,0,0
"Hungary","2024-01-12",0,0,0,0,0,0,0,0
"Hungary","2024-01-13",0,0,0,0,0,0,0,0
"Hungary","2024-01-14",0,0,0,0,0,0,0,0
"Hungary","2024-01-15",0,0,0,0,0,0,0,0
"Hungary","2024-01-16",0,0,0,0,0,0,0,0
"Hungary","2024-01-17",0,0,0,0,0,0,0,0
"Hungary","2024-01-18",0,0,0,0,0,0,0,0
"Hungary","2024-01-19",0,0,0,0,0,0,0,0
"Hungary","2024-01-20",0,0,0,0,0,0,0,0
"Hungary","2024-01-21",0,0,0,0,0,0,0,0
"Hungary","2024-01-22",0,0,0,0,0,0,0,0
"Hungary","2024-01-23",0,0,0,0,0,0,0,0
"Hungary","2024-01-24",0,0,0,0,0,0,0,0
"Hungary","2024-01-25",0,0,0,0,0,0,0,0
"Hungary","2024-01-26",0,0,0,0,0,0,0,0
"Hungary","2024-01-27",0,0,0,0,0,0,0,0
"Hungary","2024-01-28",0,0,0,0,0,0,0,0
"Hungary","2024-01-29",0,0,0,0,0,0,0,0
"Hungary","2024-01-30",0,0,0,0,0,0,0,0
"Hungary","2024-01-31",0,1,1,0,1,1,0,0
"Hungary","2024-02-01",0,0,1,0,0,1,0,0
"Hungary","2024-02-02",0,0,1,0,0,1,0,0
"Hungary","2024-02-03",0,0,1,0,0,1,0,0
"Hungary","2024-02-04",0,0,1,0,0,1,0,0
"Hungary","2024-02-05",0,0,1,0,0,1,0,0
"Hungary","2024-02-06",0,0,1,0,0,1,0,0
"Hungary","2024-02-07",0,0,1,0,0,1,0,0
"Hungary","2024-02-08",0,0,1,0,0,1,0,0
"Hungary","2024-02-09",0,0,1,0,0,1,0,0
"Hungary","2024-02-10",0,0,1,0,0,1,0,0
"Hungary","2024-02-11",0,0,1,0,0,1,0,0
"Hungary","2024-02-12",0,0,1,0,0,1,0,0
"Hungary","2024-02-13",0,0,1,0,0,1,0,0
"Hungary","2024-02-14",0,0,1,0,0,1,0,0
"Hungary","2024-02-15",0,0,1,0,0,1,0,0
"Hungary","2024-02-16",0,0,1,0,0,1,0,0
"Hungary","2024-02-17",0,0,1,0,0,1,0,0
"Hungary","2024-02-18",0,0,1,0,0,1,0,0
"Hungary","2024-02-19",0,0,1,0,0,1,0,0
"Hungary","2024-02-20",0,0,1,0,0,1,0,0
"Hungary","2024-02-21",0,0,1,0,0,1,0,0
"Hungary","2024-02-22",0,0,1,0,0,1,0,0
"Hungary","2024-02-23",0,0,1,0,0,1,0,0
"Hungary","2024-02-24",0,0,1,0,0,1,0,0
"Hungary","2024-02-25",0,0,1,0,0,1,0,0
"Hungary","2024-02-26",0,0,1,0,0,1,0,0
"Hungary","2024-02-27",0,0,1,0,0,1,0,0
"Hungary","2024-02-28",0,0,1,0,0,1,0,0
"Hungary","2024-02-29",0,0,1,0,0,1,0,0
"Hungary","2024-03-01",0,0,1,0,0,1,0,0
"Hungary","2024-03-02",0,0,1,0,0,1,0,0
"Hungary","2024-03-03",0,0,1,0,0,1,0,0
"Hungary","2024-03-04",0,0,1,0,0,1,0,0
"Hungary","2024-03-05",0,0,1,0,0,1,0,0
"Hungary","2024-03-06",0,0,1,0,0,1,0,0
"Hungary","2024-03-07",0,0,1,0,0,1,0,0
"Hungary","2024-03-08",0,0,1,0,0,1,0,0
"Hungary","2024-03-09",0,0,1,0,1,2,0,0
"Hungary","2024-03-10",0,0,1,0,0,2,0,0
"Hungary","2024-03-11",0,0,1,0,0,2,0,0
"Hungary","2024-03-12",0,0,1,0,0,2,0,0
"Hungary","2024-03-13",0,0,1,0,0,2,0,0
"Hungary","2024-03-14",0,0,1,0,0,2,0,0
"Hungary","2024-03-15",0,0,1,0,0,2,0,0
"Hungary","2024-03-16",0,0,1,0,0,2,0,0
"Hungary","2024-03-17",0,0,1,0,0,2,0,0
"Hungary","2024-03-18",0,0,1,0,0,2,0,0
"Hungary","2024-03-19",0,0,1,0,0,2,0,0
"Hungary","2024-03-20",0,0,1,0,0,2,0,0
"Hungary","2024-03-21",0,0,1,0,0,2,0,0
"Hungary","2024-03-22",0,0,1,0,0,2,0,0
"Hungary","2024-03-23",0,0,1,0,0,2,0,0
"Hungary","2024-03-24",0,0,1,0,0,2,0,0
"Hungary","2024-03-25",0,0,1,0,0,2,0,0
"Hungary","2024-03-26",0,0,1,0,0,2,0,0
"Hungary","2024-03-27",0,0,1,0,0,2,0,0
"Hungary","2024-03-28",0,0,1,0,0,2,0,0
"Hungary","2024-03-29",0,0,1,0,0,2,0,0
"Hungary","2024-03-30",0,0,1,0,0,2,0,0
"Hungary","2024-03-31",0,0,1,0,0,2,0,0
"Hungary","2024-04-01",0,0,1,0,0,2,0,0
"Hungary","2024-04-02",0,0,1,0,0,2,0,0
"Hungary","2024-04-03",0,0,1,0,0,2,0,0
"Hungary","2024-04-04",0,0,1,0,0,2,0,0
"Hungary","2024-04-05",0,0,1,0,0,2,0,0
"Hungary","2024-04-06",0,0,1,0,0,2,0,0
"Hungary","2024-04-07",0,0,1,0,0,2,0,0
"Hungary","2024-04-08",0,0,1,0,0,2,0,0
"Hungary","2024-04-09",0,0,1,0,0,2,0,0
"Hungary","2024-04-10",0,0,1,0,0,2,0,0
"Hungary","2024-04-11",0,0,1,0,0,2,0,0
"Hungary","2024-04-12",0,0,1,0,0,2,0,0
"Hungary","2024-04-13",0,0,1,0,0,2,0,0
"Hungary","2024-04-14",0,0,1,0,0,2,0,0
"Hungary","2024-04-15",0,0,1,0,0,2,0,0
"Hungary","2024-04-16",0,0,1,0,0,2,0,0
"Hungary","2024-04-17",0,0,1,0,0,2,0,0
"Hungary","2024-04-18",0,0,1,0,0,2,0,0
"Hungary","2024-04-19",0,0,1,0,0,2,0,0
"Hungary","2024-04-20",0,0,1,0,0,2,0,0
"Hungary","2024-04-21",0,0,1,0,0,2,0,0
"Hungary","2024-04-22",0,0,1,0,0,2,0,0
"Hungary","2024-04-23",0,0,1,0,0,2,0,0
"Hungary","2024-04-24",0,0,1,0,0,2,0,0
"Hungary","2024-04-25",0,0,1,0,0,2,0,0
"Hungary","2024-04-26",0,0,1,0,0,2,0,0
"Hungary","2024-04-27",0,0,1,0,0,2,0,0
"Hungary","2024-04-28",0,0,1,0,0,2,0,0
"Hungary","2024-04-29",0,0,1,0,0,2,0,0
"Hungary","2024-04-30",0,0,1,0,0,2,0,0
"Hungary","2024-05-01",0,0,1,0,0,2,0,0
"Hungary","2024-05-02",0,0,1,0,0,2,0,0
"Hungary","2024-05-03",0,0,1,0,0,2,0,0
"Hungary","2024-05-04",0,0,1,0,0,2,0,0
"Hungary","2024-05-05",0,0,1,0,0,2,0,0
"Hungary","2024-05-06",0,0,1,0,0,2,0,0
"Hungary","2024-05-07",0,0,1,0,0,2,0,0
"Hungary","2024-05-08",0,0,1,0,0,2,0,0
"Hungary","2024-05-09",0,0,1,0,0,2,0,0
"Hungary","2024-05-10",0,0,1,0,0,2,0,0
"Hungary","2024-05-11",0,0,1,0,0,2,0,0
"Hungary","2024-05-12",0,0,1,0,0,2,0,0
"Hungary","2024-05-13",0,0,1,0,0,2,0,0
"Hungary","2024-05-14",0,0,1,0,0,2,0,0
"Hungary","2024-05-15",0,0,1,0,0,2,0,0
"Hungary","2024-05-16",0,0,1,0,0,2,0,0
"Hungary","2024-05-17",0,0,1,0,0,2,0,0
"Hungary","2024-05-18",0,0,1,0,0,2,0,0
"Hungary","2024-05-19",0,0,1,0,0,2,0,0
"Hungary","2024-05-20",0,0,1,0,0,2,0,0
"Hungary","2024-05-21",0,0,1,0,0,2,0,0
"Hungary","2024-05-22",0,0,1,0,0,2,0,0
"Hungary","2024-05-23",0,0,1,0,0,2,0,0
"Hungary","2024-05-24",0,0,1,0,1,3,0,0
"Hungary","2024-05-25",0,0,1,0,0,3,0,0
"Hungary","2024-05-26",0,0,1,0,0,3,0,0
"Hungary","2024-05-27",0,0,1,0,0,3,0,0
"Hungary","2024-05-28",0,0,1,0,0,3,0,0
"Hungary","2024-05-29",0,0,1,0,0,3,0,0
"Hungary","2024-05-30",0,0,1,0,0,3,0,0
"Hungary","2024-05-31",0,0,1,0,0,3,0,0
"Hungary","2024-06-01",0,0,1,0,0,3,0,0
"Hungary","2024-06-02",0,0,1,0,0,3,0,0
"Hungary","2024-06-03",0,0,1,0,0,3,0,0
"Hungary","2024-06-04",0,0,1,0,0,3,0,0
"Hungary","2024-06-05",0,0,1,0,0,3,0,0
"Hungary","2024-06-06",0,0,1,0,0,3,0,0
"Hungary","2024-06-07",0,0,1,0,0,3,0,0
"Hungary","2024-06-08",0,0,1,0,0,3,0,0
"Hungary","2024-06-09",0,0,1,0,0,3,0,0
"Hungary","2024-06-10",0,0,1,0,0,3,0,0
"Hungary","2024-06-11",0,0,1,0,0,3,0,0
"Hungary","2024-06-12",0,0,1,0,0,3,0,0
"Hungary","2024-06-13",0,0,1,0,0,3,0,0
"Hungary","2024-06-14",0,0,1,0,0,3,0,0
"Hungary","2024-06-15",0,0,1,0,0,3,0,0
"Hungary","2024-06-16",0,0,1,0,0,3,0,0
"Hungary","2024-06-17",0,0,1,0,0,3,0,0
"Hungary","2024-06-18",0,0,1,0,0,3,0,0
"Hungary","2024-06-19",0,0,1,0,0,3,0,0
"Hungary","2024-06-20",0,0,1,0,0,3,0,0
"Hungary","2024-06-21",0,0,1,0,0,3,0,0
"Hungary","2024-06-22",0,0,1,0,0,3,0,0
"Hungary","2024-06-23",0,0,1,0,0,3,0,0
"Hungary","2024-06-24",0,0,1,0,0,3,0,0
"Hungary","2024-06-25",0,0,1,0,0,3,0,0
"Hungary","2024-06-26",0,0,1,0,0,3,0,0
"Hungary","2024-06-27",0,0,1,0,0,3,0,0
"Hungary","2024-06-28",0,0,1,0,0,3,0,0
"Hungary","2024-06-29",0,0,1,0,0,3,0,0
"Hungary","2024-06-30",0,2,3,0,0,3,0,0
"Hungary","2024-07-01",0,0,3,0,0,3,0,0
"Hungary","2024-07-02",0,0,3,0,0,3,0,0
"Hungary","2024-07-03",0,0,3,0,0,3,0,0
"Hungary","2024-07-04",0,0,3,0,0,3,0,0
"Hungary","2024-07-05",0,0,3,0,0,3,0,0
"Hungary","2024-07-06",0,0,3,0,0,3,0,0
"Hungary","2024-07-07",0,0,3,0,0,3,0,0
"Hungary","2024-07-08",0,0,3,0,0,3,0,0
"Hungary","2024-07-09",0,0,3,0,0,3,0,0
"Hungary","2024-07-10",0,0,3,0,0,3,0,0
"Hungary","2024-07-11",0,0,3,0,0,3,0,0
"Hungary","2024-07-12",0,0,3,0,0,3,0,0
"Hungary","2024-07-13",0,0,3,0,0,3,0,0
"Hungary","2024-07-14",0,0,3,0,0,3,0,0
"Hungary","2024-07-15",0,0,3,0,0,3,0,0
"Hungary","2024-07-16",0,0,3,0,0,3,0,0
"Hungary","2024-07-17",0,0,3,0,0,3,0,0
"Hungary","2024-07-18",0,0,3,0,0,3,0,0
"Hungary","2024-07-19",0,0,3,0,0,3,0,0
"Hungary","2024-07-20",0,0,3,0,0,3,0,0
"Hungary","2024-07-21",0,0,3,0,0,3,0,0
"Hungary","2024-07-22",0,0,3,0,0,3,0,0
"Hungary","2024-07-23",0,0,3,0,0,3,0,0
"Hungary","2024-07-24",0,0,3,0,0,3,0,0
"Hungary","2024-07-25",0,0,3,0,0,3,0,0
"Hungary","2024-07-26",0,0,3,0,0,3,0,0
"Hungary","2024-07-27",0,0,3,0,0,3,0,0
"Hungary","2024-07-28",0,0,3,0,0,3,0,0
"Hungary","2024-07-29",0,0,3,0,0,3,0,0
"Hungary","2024-07-30",0,0,3,0,0,3,0,0
"Hungary","2024-07-31",0,0,3,0,0,3,0,0
"Hungary","2024-08-01",0,0,3,0,0,3,0,0
"Hungary","2024-08-02",0,0,3,0,0,3,0,0
"Hungary","2024-08-03",0,0,3,0,0,3,0,0
"Hungary","2024-08-04",0,0,3,0,0,3,0,0
"Hungary","2024-08-05",0,0,3,0,0,3,0,0
"Hungary","2024-08-06",0,0,3,0,0,3,0,0
"Hungary","2024-08-07",0,0,3,0,0,3,0,0
"Hungary","2024-08-08",0,0,3,0,0,3,0,0
"Hungary","2024-08-09",0,0,3,0,0,3,0,0
"Hungary","2024-08-10",0,0,3,0,0,3,0,0
"Hungary","2024-08-11",0,0,3,0,0,3,0,0
"Hungary","2024-08-12",0,0,3,0,0,3,0,0
"Hungary","2024-08-13",0,0,3,0,0,3,0,0
"Hungary","2024-08-14",0,0,3,0,0,3,0,0
"Hungary","2024-08-15",0,0,3,0,0,3,0,0
"Hungary","2024-08-16",0,0,3,0,0,3,0,0
"Hungary","2024-08-17",0,0,3,0,0,3,0,0
"Hungary","2024-08-18",0,0,3,0,0,3,0,0
"Hungary","2024-08-19",0,0,3,0,0,3,0,0
"Hungary","2024-08-20",0,0,3,0,0,3,0,0
"Hungary","2024-08-21",0,0,3,0,0,3,0,0
"Hungary","2024-08-22",0,0,3,0,0,3,0,0
"Hungary","2024-08-23",0,0,3,0,0,3,0,0
"Hungary","2024-08-24",0,0,3,0,0,3,0,0
"Hungary","2024-08-25",0,0,3,0,0,3,0,0
"Hungary","2024-08-26",0,0,3,0,0,3,0,0
"Hungary","2024-08-27",0,0,3,0,0,3,0,0
"Hungary","2024-08-28",0,0,3,0,0,3,0,0
"Hungary","2024-08-29",0,0,3,0,0,3,0,0
"Hungary","2024-08-30",0,0,3,0,0,3,0,0
"Hungary","2024-08-31",0,0,3,0,0,3,0,0
"Hungary","2024-09-01",0,0,3,0,0,3,0,0
"Hungary","2024-09-02",0,0,3,0,0,3,0,0
"Hungary","2024-09-03",0,0,3,0,0,3,0,0
"Hungary","2024-09-04",0,0,3,0,0,3,0,0
"Hungary","2024-09-05",0,0,3,0,0,3,0,0
"Hungary","2024-09-06",0,0,3,0,0,3,0,0
"Hungary","2024-09-07",0,0,3,0,0,3,0,0
"Hungary","2024-09-08",0,0,3,0,0,3,0,0
"Hungary","2024-09-09",0,0,3,0,0,3,0,0
"Hungary","2024-09-10",0,0,3,0,0,3,0,0
"Hungary","2024-09-11",0,0,3,0,0,3,0,0
"Hungary","2024-09-12",0,0,3,0,0,3,0,0
"Hungary","2024-09-13",0,0,3,0,0,3,0,0
"Hungary","2024-09-14",0,0,3,0,0,3,0,0
"Hungary","2024-09-15",0,0,3,0,0,3,0,0
"Hungary","2024-09-16",0,0,3,0,0,3,0,0
"Hungary","2024-09-17",0,0,3,0,0,3,0,0
"Hungary","2024-09-18",0,0,3,0,0,3,0,0
"Hungary","2024-09-19",0,0,3,0,0,3,0,0
"Hungary","2024-09-20",0,0,3,0,0,3,0,0
"Hungary","2024-09-21",0,0,3,0,0,3,0,0
"Hungary","2024-09-22",0,0,3,0,0,3,0,0
"Hungary","2024-09-23",0,0,3,0,0,3,0,0
"Hungary","2024-09-24",0,0,3,0,0,3,0,0
"Hungary","2024-09-25",0,0,3,0,0,3,0,0
"Hungary","2024-09-26",0,0,3,0,0,3,0,0
"Hungary","2024-09-27",0,0,3,0,0,3,0,0
"Hungary","2024-09-28",0,0,3,0,0,3,0,0
"Hungary","2024-09-29",0,0,3,0,0,3,0,0
"Hungary","2024-09-30",0,0,3,0,0,3,0,0
"Hungary","2024-10-01",0,0,3,0,0,3,0,0
"Hungary","2024-10-02",0,0,3,0,0,3,0,0
"Hungary","2024-10-03",0,0,3,0,0,3,0,0
"Hungary","2024-10-04",0,0,3,0,0,3,0,0
"Hungary","2024-10-05",0,0,3,0,0,3,0,0
"Hungary","2024-10-06",0,0,3,0,0,3,0,0
"Hungary","2024-10-07",0,0,3,0,0,3,0,0
"Hungary","2024-10-08",0,0,3,0,0,3,0,0
"Hungary","2024-10-09",0,0,3,0,0,3,0,0
"Hungary","2024-10-10",0,0,3,0,0,3,0,0
"Hungary","2024-10-11",0,0,3,0,0,3,0,0
"Hungary","2024-10-12",0,0,3,0,0,3,0,0
"Hungary","2024-10-13",0,0,3,0,0,3,0,0
"Hungary","2024-10-14",0,0,3,0,0,3,0,0
"Hungary","2024-10-15",0,0,3,0,0,3,0,0
"Hungary","2024-10-16",0,0,3,0,0,3,0,0
"Hungary","2024-10-17",0,0,3,0,0,3,0,0
"Hungary","2024-10-18",0,0,3,0,0,3,0,0
"Hungary","2024-10-19",0,0,3,0,0,3,0,0
"Hungary","2024-10-20",0,0,3,0,0,3,0,0
"Hungary","2024-10-21",0,0,3,0,0,3,0,0
"Hungary","2024-10-22",0,0,3,0,0,3,0,0
"Hungary","2024-10-23",0,0,3,0,0,3,0,0
"Hungary","2024-10-24",0,0,3,0,0,3,0,0
"Hungary","2024-10-25",0,0,3,0,0,3,0,0
"Hungary","2024-10-26",0,0,3,0,0,3,0,0
"Hungary","2024-10-27",0,0,3,0,0,3,0,0
"Hungary","2024-10-28",0,0,3,0,0,3,0,0
"Hungary","2024-10-29",0,0,3,0,0,3,0,0
"Hungary","2024-10-30",0,0,3,0,0,3,0,0
"Hungary","2024-10-31",0,0,3,0,0,3,0,0
"Hungary","2024-11-01",0,0,3,0,0,3,0,0
"Hungary","2024-11-02",0,0,3,0,0,3,0,0
"Hungary","2024-11-03",0,0,3,0,0,3,0,0
"Hungary","2024-11-04",0,0,3,0,0,3,0,0
"Hungary","2024-11-05",0,0,3,0,0,3,0,0
"Hungary","2024-11-06",0,0,3,0,0,3,0,0
"Hungary","2024-11-07",0,0,3,0,0,3,0,0
"Hungary","2024-11-08",0,0,3,0,0,3,0,0
"Hungary","2024-11-09",0,0,3,0,0,3,0,0
"Hungary","2024-11-10",0,0,3,0,0,3,0,0
"Hungary","2024-11-11",0,0,3,0,0,3,0,0
"Hungary","2024-11-12",0,0,3,0,0,3,0,0
"Hungary","2024-11-13",0,0,3,0,0,3,0,0
"Hungary","2024-11-14",0,0,3,0,0,3,0,0
"Hungary","2024-11-15",0,0,3,0,0,3,0,0
"Hungary","2024-11-16",0,0,3,0,0,3,0,0
"Hungary","2024-11-17",0,0,3,0,0,3,0,0
"Hungary","2024-11-18",0,0,3,0,0,3,0,0
"Hungary","2024-11-19",0,0,3,0,0,3,0,0
"Hungary","2024-11-20",0,0,3,0,0,3,0,0
"Hungary","2024-11-21",0,0,3,0,0,3,0,0
"Hungary","2024-11-22",0,0,3,0,0,3,0,0
"Hungary","2024-11-23",0,0,3,0,0,3,0,0
"Hungary","2024-11-24",0,0,3,0,0,3,0,0
"Hungary","2024-11-25",0,0,3,0,0,3,0,0
"Hungary","2024-11-26",0,0,3,0,0,3,0,0
"Hungary","2024-11-27",0,0,3,0,0,3,0,0
"Hungary","2024-11-28",0,0,3,0,0,3,0,0
"Hungary","2024-11-29",0,0,3,0,0,3,0,0
"Hungary","2024-11-30",0,0,3,0,0,3,0,0
"Hungary","2024-12-01",0,0,3,0,0,3,0,0
"Hungary","2024-12-02",0,0,3,0,0,3,0,0
"Hungary","2024-12-03",0,0,3,0,0,3,0,0
"Hungary","2024-12-04",0,0,3,0,0,3,0,0
"Hungary","2024-12-05",0,0,3,0,0,3,0,0
"Hungary","2024-12-06",0,0,3,0,0,3,0,0
"Hungary","2024-12-07",0,0,3,0,0,3,0,0
"Hungary","2024-12-08",0,0,3,0,0,3,0,0
"Hungary","2024-12-09",0,0,3,0,0,3,0,0
"Hungary","2024-12-10",0,0,3,0,0,3,0,0
"Hungary","2024-12-11",0,0,3,0,0,3,0,0
"Hungary","2024-12-12",0,0,3,0,0,3,0,0
"Hungary","2024-12-13",0,0,3,0,0,3,0,0
"Hungary","2024-12-14",0,0,3,0,0,3,0,0
"Hungary","2024-12-15",0,0,3,0,0,3,0,0
"Hungary","2024-12-16",0,0,3,0,0,3,0,0
"Hungary","2024-12-17",0,0,3,0,0,3,0,0
"Hungary","2024-12-18",0,0,3,0,0,3,0,0
"Hungary","2024-12-19",0,0,3,0,0,3,0,0
"Hungary","2024-12-20",0,0,3,0,0,3,0,0
"Hungary","2024-12-21",0,0,3,0,0,3,0,0
"Hungary","2024-12-22",0,0,3,0,0,3,0,0
"Hungary","2024-12-23",0,0,3,0,0,3,0,0
"Hungary","2024-12-24",0,0,3,0,0,3,0,0
"Hungary","2024-12-25",0,0,3,0,0,3,0,0
"Hungary","2024-12-26",0,0,3,0,0,3,0,0
"Hungary","2024-12-27",0,0,3,0,0,3,0,0
"Hungary","2024-12-28",0,0,3,0,0,3,0,0
"Hungary","2024-12-29",0,0,3,0,0,3,0,0
"Hungary","2024-12-30",0,0,3,0,0,3,0,0
"Hungary","2024-12-31",0,0,3,0,0,3,0,0
"Hungary","2025-01-01",0,0,3,0,0,3,0,0
"Hungary","2025-01-02",0,0,3,0,0,3,0,0
"Hungary","2025-01-03",0,0,3,0,0,3,0,0
"Hungary","2025-01-04",0,0,3,0,0,3,0,0
"Hungary","2025-01-05",0,0,3,0,0,3,0,0
"Hungary","2025-01-06",0,0,3,0,0,3,0,0
"Hungary","2025-01-07",0,0,3,0,0,3,0,0
"Hungary","2025-01-08",0,0,3,0,0,3,0,0
"Hungary","2025-01-09",0,0,3,0,0,3,0,0
"Hungary","2025-01-10",0,0,3,0,0,3,0,0
"Hungary","2025-01-11",0,0,3,0,0,3,0,0
"Hungary","2025-01-12",0,0,3,0,0,3,0,0
"Hungary","2025-01-13",0,0,3,0,0,3,0,0
"Hungary","2025-01-14",0,0,3,0,0,3,0,0
"Hungary","2025-01-15",0,0,3,0,0,3,0,0
"Hungary","2025-01-16",0,0,3,0,0,3,0,0
"Hungary","2025-01-17",0,0,3,0,0,3,0,0
"Hungary","2025-01-18",0,0,3,0,0,3,0,0
"Hungary","2025-01-19",0,0,3,0,0,3,0,0
"Hungary","2025-01-20",0,0,3,0,0,3,0,0
"Hungary","2025-01-21",0,0,3,0,0,3,0,0
"Hungary","2025-01-22",0,0,3,0,0,3,0,0
"Hungary","2025-01-23",0,0,3,0,0,3,0,0
"Hungary","2025-01-24",0,0,3,0,0,3,0,0
"Hungary","2025-01-25",0,0,3,0,0,3,0,0
"Hungary","2025-01-26",0,0,3,0,0,3,0,0
"Hungary","2025-01-27",0,0,3,0,0,3,0,0
"Hungary","2025-01-28",0,0,3,0,0,3,0,0
"Hungary","2025-01-29",0,0,3,0,0,3,0,0
"Hungary","2025-01-30",0,0,3,0,0,3,0,0
"Hungary","2025-01-31",0,0,3,0,0,3,0,0
"Hungary","2025-02-01",0,0,3,0,0,3,0,0
"Hungary","2025-02-02",0,0,3,0,0,3,0,0
"Hungary","2025-02-03",0,0,3,0,0,3,0,0
"Hungary","2025-02-04",0,0,3,0,0,3,0,0
"Hungary","2025-02-05",0,0,3,0,0,3,0,0
"Hungary","2025-02-06",0,0,3,0,0,3,0,0
"Hungary","2025-02-07",0,0,3,0,0,3,0,0
"Hungary","2025-02-08",0,0,3,0,0,3,0,0
"Hungary","2025-02-09",0,0,3,0,0,3,0,0
"Hungary","2025-02-10",0,0,3,0,0,3,0,0
"Hungary","2025-02-11",0,0,3,0,0,3,0,0
"Hungary","2025-02-12",0,0,3,0,0,3,0,0
"Hungary","2025-02-13",0,0,3,0,0,3,0,0
"Hungary","2025-02-14",0,0,3,0,0,3,0,0
"Hungary","2025-02-15",0,0,3,0,0,3,0,0
"Hungary","2025-02-16",0,0,3,0,0,3,0,0
"Hungary","2025-02-17",0,0,3,0,0,3,0,0
"Hungary","2025-02-18",0,0,3,0,0,3,0,0
"Hungary","2025-02-19",0,0,3,0,0,3,0,0
"Hungary","2025-02-20",0,0,3,0,0,3,0,0
"Hungary","2025-02-21",0,0,3,0,0,3,0,0
"Hungary","2025-02-22",0,0,3,0,0,3,0,0
"Hungary","2025-02-23",0,0,3,0,0,3,0,0
"Hungary","2025-02-24",0,0,3,0,0,3,0,0
"Hungary","2025-02-25",0,0,3,0,0,3,0,0
"Hungary","2025-02-26",0,0,3,0,0,3,0,0
"Hungary","2025-02-27",0,0,3,0,0,3,0,0
"Hungary","2025-02-28",0,0,3,0,0,3,0,0
"Hungary","2025-03-01",0,0,3,0,0,3,0,0
"Hungary","2025-03-02",0,0,3,0,0,3,0,0
"Hungary","2025-03-03",0,0,3,0,0,3,0,0
"Iceland","2024-01-01",0,0,0,0,0,0,0,0
"Iceland","2024-01-02",0,0,0,0,0,0,0,0
"Iceland","2024-01-03",0,0,0,0,0,0,0,0
"Iceland","2024-01-04",0,0,0,0,0,0,0,0
"Iceland","2024-01-05",0,0,0,0,0,0,0,0
"Iceland","2024-01-06",0,0,0,0,0,0,0,0
"Iceland","2024-01-07",0,0,0,0,0,0,0,0
"Iceland","2024-01-08",0,0,0,0,0,0,0,0
"Iceland","2024-01-09",0,0,0,0,0,0,0,0
"Iceland","2024-01-10",0,0,0,0,0,0,0,0
"Iceland","2024-01-11",0,0,0,0,0,0,0,0
"Iceland","2024-01-12",0,0,0,0,0,0,0,0
"Iceland","2024-01-13",0,0,0,0,0,0,0,0
"Iceland","2024-01-14",0,0,0,0,0,0,0,0
"Iceland","2024-01-15",0,0,0,0,0,0,0,0
"Iceland","2024-01-16",0,0,0,0,0,0,0,0
"Iceland","2024-01-17",0,0,0,0,0,0,0,0
"Iceland","2024-01-18",0,0,0,0,0,0,0,0
"Iceland","2024-01-19",0,0,0,0,0,0,0,0
"Iceland","2024-01-20",0,0,0,0,0,0,0,0
"Iceland","2024-01-21",0,0,0,0,0,0,0,0
"Iceland","2024-01-22",0,0,0,0,0,0,0,0
"Iceland","2024-01-23",0,0,0,0,0,0,0,0
"Iceland","2024-01-24",0,0,0,0,0,0,0,0
"Iceland","2024-01-25",0,0,0,0,0,0,0,0
"Iceland","2024-01-26",0,0,0,0,0,0,0,0
"Iceland","2024-01-27",0,0,0,0,0,0,0,0
"Iceland","2024-01-28",0,0,0,0,0,0,0,0
"Iceland","2024-01-29",0,0,0,0,0,0,0,0
"Iceland","2024-01-30",0,0,0,0,0,0,0,0
"Iceland","2024-01-31",0,0,0,0,0,0,0,0
"Iceland","2024-02-01",0,0,0,0,0,0,0,0
"Iceland","2024-02-02",0,0,0,0,0,0,0,0
"Iceland","2024-02-03",0,0,0,0,0,0,0,0
"Iceland","2024-02-04",0,0,0,0,0,0,0,0
"Iceland","2024-02-05",0,0,0,0,0,0,0,0
"Iceland","2024-02-06",0,0,0,0,0,0,0,0
"Iceland","2024-02-07",0,0,0,0,0,0,0,0
"Iceland","2024-02-08",0,0,0,0,0,0,0,0
"Iceland","2024-02-09",0,0,0,0,0,0,0,0
"Iceland","2024-02-10",0,0,0,0,0,0,0,0
"Iceland","2024-02-11",0,0,0,0,0,0,0,0
"Iceland","2024-02-12",0,0,0,0,0,0,0,0
"Iceland","2024-02-13",0,0,0,0,0,0,0,0
"Iceland","2024-02-14",0,0,0,0,0,0,0,0
"Iceland","2024-02-15",0,0,0,0,0,0,0,0
"Iceland","2024-02-16",0,0,0,0,0,0,0,0
"Iceland","2024-02-17",0,0,0,0,0,0,0,0
"Iceland","2024-02-18",0,0,0,0,0,0,0,0
"Iceland","2024-02-19",0,0,0,0,0,0,0,0
"Iceland","2024-02-20",0,0,0,0,0,0,0,0
"Iceland","2024-02-21",0,0,0,0,0,0,0,0
"Iceland","2024-02-22",0,0,0,0,0,0,0,0
"Iceland","2024-02-23",0,0,0,0,0,0,0,0
"Iceland","2024-02-24",0,0,0,0,0,0,0,0
"Iceland","2024-02-25",0,0,0,0,0,0,0,0
"Iceland","2024-02-26",0,0,0,0,0,0,0,0
"Iceland","2024-02-27",0,0,0,0,0,0,0,0
"Iceland","2024-02-28",0,0,0,0,0,0,0,0
"Iceland","2024-02-29",0,0,0,0,0,0,0,0
"Iceland","2024-03-01",0,0,0,0,0,0,0,0
"Iceland","2024-03-02",0,0,0,0,0,0,0,0
"Iceland","2024-03-03",0,0,0,0,0,0,0,0
"Iceland","2024-03-04",0,0,0,0,0,0,0,0
"Iceland","2024-03-05",0,0,0,0,0,0,0,0
"Iceland","2024-03-06",0,0,0,0,0,0,0,0
"Iceland","2024-03-07",0,0,0,0,0,0,0,0
"Iceland","2024-03-08",0,0,0,0,0,0,0,0
"Iceland","2024-03-09",0,0,0,0,0,0,0,0
"Iceland","2024-03-10",0,0,0,0,0,0,0,0
"Iceland","2024-03-11",0,0,0,0,0,0,0,0
"Iceland","2024-03-12",0,0,0,0,0,0,0,0
"Iceland","2024-03-13",0,0,0,0,0,0,0,0
"Iceland","2024-03-14",0,0,0,0,0,0,0,0
"Iceland","2024-03-15",0,0,0,0,0,0,0,0
"Iceland","2024-03-16",0,0,0,0,0,0,0,0
"Iceland","2024-03-17",0,0,0,0,0,0,0,0
"Iceland","2024-03-18",0,0,0,0,0,0,0,0
"Iceland","2024-03-19",0,0,0,0,0,0,0,0
"Iceland","2024-03-20",0,0,0,0,0,0,0,0
"Iceland","2024-03-21",0,0,0,0,0,0,0,0
"Iceland","2024-03-22",0,0,0,0,0,0,0,0
"Iceland","2024-03-23",0,0,0,0,0,0,0,0
"Iceland","2024-03-24",0,0,0,0,0,0,0,0
"Iceland","2024-03-25",0,0,0,0,0,0,0,0
"Iceland","2024-03-26",0,0,0,0,0,0,0,0
"Iceland","2024-03-27",0,0,0,0,0,0,0,0
"Iceland","2024-03-28",0,0,0,0,0,0,0,0
"Iceland","2024-03-29",0,0,0,0,0,0,0,0
"Iceland","2024-03-30",0,0,0,0,0,0,0,0
"Iceland","2024-03-31",0,0,0,0,0,0,0,0
"Iceland","2024-04-01",0,0,0,0,0,0,0,0
"Iceland","2024-04-02",0,0,0,0,0,0,0,0
"Iceland","2024-04-03",0,0,0,0,0,0,0,0
"Iceland","2024-04-04",0,0,0,0,0,0,0,0
"Iceland","2024-04-05",0,0,0,0,0,0,0,0
"Iceland","2024-04-06",0,0,0,0,0,0,0,0
"Iceland","2024-04-07",0,0,0,0,0,0,0,0
"Iceland","2024-04-08",0,0,0,0,0,0,0,0
"Iceland","2024-04-09",0,0,0,0,0,0,0,0
"Iceland","2024-04-10",0,0,0,0,0,0,0,0
"Iceland","2024-04-11",0,0,0,0,0,0,0,0
"Iceland","2024-04-12",0,0,0,0,0,0,0,0
"Iceland","2024-04-13",0,0,0,0,0,0,0,0
"Iceland","2024-04-14",0,0,0,0,0,0,0,0
"Iceland","2024-04-15",0,0,0,0,0,0,0,0
"Iceland","2024-04-16",0,0,0,0,0,0,0,0
"Iceland","2024-04-17",0,0,0,0,0,0,0,0
"Iceland","2024-04-18",0,0,0,0,0,0,0,0
"Iceland","2024-04-19",0,0,0,0,0,0,0,0
"Iceland","2024-04-20",0,0,0,0,0,0,0,0
"Iceland","2024-04-21",0,0,0,0,0,0,0,0
"Iceland","2024-04-22",0,0,0,0,0,0,0,0
"Iceland","2024-04-23",0,0,0,0,0,0,0,0
"Iceland","2024-04-24",0,0,0,0,0,0,0,0
"Iceland","2024-04-25",0,0,0,0,0,0,0,0
"Iceland","2024-04-26",0,0,0,0,0,0,0,0
"Iceland","2024-04-27",0,0,0,0,0,0,0,0
"Iceland","2024-04-28",0,0,0,0,0,0,0,0
"Iceland","2024-04-29",0,0,0,0,0,0,0,0
"Iceland","2024-04-30",0,0,0,0,0,0,0,0
"Iceland","2024-05-01",0,0,0,0,0,0,0,0
"Iceland","2024-05-02",0,0,0,0,0,0,0,0
"Iceland","2024-05-03",0,0,0,0,0,0,0,0
"Iceland","2024-05-04",0,0,0,0,0,0,0,0
"Iceland","2024-05-05",0,0,0,0,0,0,0,0
"Iceland","2024-05-06",0,0,0,0,0,0,0,0
"Iceland","2024-05-07",0,0,0,0,0,0,0,0
"Iceland","2024-05-08",0,0,0,0,0,0,0,0
"Iceland","2024-05-09",0,0,0,0,0,0,0,0
"Iceland","2024-05-10",0,0,0,0,0,0,0,0
"Iceland","2024-05-11",0,0,0,0,0,0,0,0
"Iceland","2024-05-12",0,0,0,0,0,0,0,0
"Iceland","2024-05-13",0,0,0,0,0,0,0,0
"Iceland","2024-05-14",0,0,0,0,0,0,0,0
"Iceland","2024-05-15",0,0,0,0,0,0,0,0
"Iceland","2024-05-16",0,0,0,0,0,0,0,0
"Iceland","2024-05-17",0,0,0,0,0,0,0,0
"Iceland","2024-05-18",0,0,0,0,0,0,0,0
"Iceland","2024-05-19",0,0,0,0,0,0,0,0
"Iceland","2024-05-20",0,0,0,0,0,0,0,0
"Iceland","2024-05-21",0,0,0,0,0,0,0,0
"Iceland","2024-05-22",0,0,0,0,0,0,0,0
"Iceland","2024-05-23",0,0,0,0,0,0,0,0
"Iceland","2024-05-24",0,0,0,0,0,0,0,0
"Iceland","2024-05-25",0,0,0,0,0,0,0,0
"Iceland","2024-05-26",0,0,0,0,0,0,0,0
"Iceland","2024-05-27",0,0,0,0,0,0,0,0
"Iceland","2024-05-28",0,0,0,0,0,0,0,0
"Iceland","2024-05-29",0,0,0,0,0,0,0,0
"Iceland","2024-05-30",0,0,0,0,0,0,0,0
"Iceland","2024-05-31",0,0,0,0,0,0,0,0
"Iceland","2024-06-01",0,0,0,0,0,0,0,0
"Iceland","2024-06-02",0,0,0,0,0,0,0,0
"Iceland","2024-06-03",0,0,0,0,0,0,0,0
"Iceland","2024-06-04",0,0,0,0,0,0,0,0
"Iceland","2024-06-05",0,0,0,0,0,0,0,0
"Iceland","2024-06-06",0,0,0,0,0,0,0,0
"Iceland","2024-06-07",0,0,0,0,0,0,0,0
"Iceland","2024-06-08",0,0,0,0,0,0,0,0
"Iceland","2024-06-09",0,0,0,0,0,0,0,0
"Iceland","2024-06-10",0,0,0,0,0,0,0,0
"Iceland","2024-06-11",0,0,0,0,0,0,0,0
"Iceland","2024-06-12",0,0,0,0,0,0,0,0
"Iceland","2024-06-13",0,0,0,0,0,0,0,0
"Iceland","2024-06-14",0,0,0,0,0,0,0,0
"Iceland","2024-06-15",0,0,0,0,0,0,0,0
"Iceland","2024-06-16",0,0,0,0,0,0,0,0
"Iceland","2024-06-17",0,0,0,0,0,0,0,0
"Iceland","2024-06-18",0,0,0,0,0,0,0,0
"Iceland","2024-06-19",0,0,0,0,0,0,0,0
"Iceland","2024-06-20",0,0,0,0,0,0,0,0
"Iceland","2024-06-21",0,0,0,0,0,0,0,0
"Iceland","2024-06-22",0,0,0,0,0,0,0,0
"Iceland","2024-06-23",0,0,0,0,0,0,0,0
"Iceland","2024-06-24",0,0,0,0,0,0,0,0
"Iceland","2024-06-25",0,0,0,0,0,0,0,0
"Iceland","2024-06-26",0,0,0,0,0,0,0,0
"Iceland","2024-06-27",0,0,0,0,0,0,0,0
"Iceland","2024-06-28",0,0,0,0,0,0,0,0
"Iceland","2024-06-29",0,0,0,0,0,0,0,0
"Iceland","2024-06-30",0,0,0,0,0,0,0,0
"Iceland","2024-07-01",0,0,0,0,0,0,0,0
"Iceland","2024-07-02",0,0,0,0,0,0,0,0
"Iceland","2024-07-03",0,0,0,0,0,0,0,0
"Iceland","2024-07-04",0,0,0,0,0,0,0,0
"Iceland","2024-07-05",0,0,0,0,0,0,0,0
"Iceland","2024-07-06",0,0,0,0,0,0,0,0
"Iceland","2024-07-07",0,0,0,0,0,0,0,0
"Iceland","2024-07-08",0,0,0,0,0,0,0,0
"Iceland","2024-07-09",0,0,0,0,0,0,0,0
"Iceland","2024-07-10",0,0,0,0,0,0,0,0
"Iceland","2024-07-11",0,0,0,0,0,0,0,0
"Iceland","2024-07-12",0,0,0,0,0,0,0,0
"Iceland","2024-07-13",0,0,0,0,0,0,0,0
"Iceland","2024-07-14",0,0,0,0,0,0,0,0
"Iceland","2024-07-15",0,0,0,0,0,0,0,0
"Iceland","2024-07-16",0,0,0,0,0,0,0,0
"Iceland","2024-07-17",0,0,0,0,0,0,0,0
"Iceland","2024-07-18",0,0,0,0,0,0,0,0
"Iceland","2024-07-19",0,0,0,0,0,0,0,0
"Iceland","2024-07-20",0,0,0,0,0,0,0,0
"Iceland","2024-07-21",0,0,0,0,0,0,0,0
"Iceland","2024-07-22",0,0,0,0,0,0,0,0
"Iceland","2024-07-23",0,0,0,0,0,0,0,0
"Iceland","2024-07-24",0,0,0,0,0,0,0,0
"Iceland","2024-07-25",0,0,0,0,0,0,0,0
"Iceland","2024-07-26",0,0,0,0,0,0,0,0
"Iceland","2024-07-27",0,0,0,0,0,0,0,0
"Iceland","2024-07-28",0,0,0,0,0,0,0,0
"Iceland","2024-07-29",0,0,0,0,0,0,0,0
"Iceland","2024-07-30",0,0,0,0,0,0,0,0
"Iceland","2024-07-31",0,0,0,0,0,0,0,0
"Iceland","2024-08-01",0,0,0,0,0,0,0,0
"Iceland","2024-08-02",0,0,0,0,0,0,0,0
"Iceland","2024-08-03",0,0,0,0,0,0,0,0
"Iceland","2024-08-04",0,0,0,0,0,0,0,0
"Iceland","2024-08-05",0,0,0,0,0,0,0,0
"Iceland","2024-08-06",0,0,0,0,0,0,0,0
"Iceland","2024-08-07",0,0,0,0,0,0,0,0
"Iceland","2024-08-08",0,0,0,0,0,0,0,0
"Iceland","2024-08-09",0,0,0,0,0,0,0,0
"Iceland","2024-08-10",0,0,0,0,0,0,0,0
"Iceland","2024-08-11",0,0,0,0,0,0,0,0
"Iceland","2024-08-12",0,0,0,0,0,0,0,0
"Iceland","2024-08-13",0,0,0,0,0,0,0,0
"Iceland","2024-08-14",0,0,0,0,0,0,0,0
"Iceland","2024-08-15",0,0,0,0,0,0,0,0
"Iceland","2024-08-16",0,0,0,0,0,0,0,0
"Iceland","2024-08-17",0,0,0,0,0,0,0,0
"Iceland","2024-08-18",0,0,0,0,0,0,0,0
"Iceland","2024-08-19",0,0,0,0,0,0,0,0
"Iceland","2024-08-20",0,0,0,0,0,0,0,0
"Iceland","2024-08-21",0,0,0,0,0,0,0,0
"Iceland","2024-08-22",0,0,0,0,0,0,0,0
"Iceland","2024-08-23",0,0,0,0,0,0,0,0
"Iceland","2024-08-24",0,0,0,0,0,0,0,0
"Iceland","2024-08-25",0,0,0,0,0,0,0,0
"Iceland","2024-08-26",0,0,0,0,0,0,0,0
"Iceland","2024-08-27",0,0,0,0,0,0,0,0
"Iceland","2024-08-28",0,0,0,0,0,0,0,0
"Iceland","2024-08-29",0,0,0,0,0,0,0,0
"Iceland","2024-08-30",0,0,0,0,0,0,0,0
"Iceland","2024-08-31",0,0,0,0,0,0,0,0
"Iceland","2024-09-01",0,0,0,0,0,0,0,0
"Iceland","2024-09-02",0,0,0,0,0,0,0,0
"Iceland","2024-09-03",0,0,0,0,0,0,0,0
"Iceland","2024-09-04",0,0,0,0,0,0,0,0
"Iceland","2024-09-05",0,0,0,0,0,0,0,0
"Iceland","2024-09-06",0,0,0,0,0,0,0,0
"Iceland","2024-09-07",0,0,0,0,0,0,0,0
"Iceland","2024-09-08",0,0,0,0,0,0,0,0
"Iceland","2024-09-09",0,0,0,0,0,0,0,0
"Iceland","2024-09-10",0,0,0,0,0,0,0,0
"Iceland","2024-09-11",0,0,0,0,0,0,0,0
"Iceland","2024-09-12",0,0,0,0,0,0,0,0
"Iceland","2024-09-13",0,0,0,0,0,0,0,0
"Iceland","2024-09-14",0,0,0,0,0,0,0,0
"Iceland","2024-09-15",0,0,0,0,0,0,0,0
"Iceland","2024-09-16",0,0,0,0,0,0,0,0
"Iceland","2024-09-17",0,0,0,0,0,0,0,0
"Iceland","2024-09-18",0,0,0,0,0,0,0,0
"Iceland","2024-09-19",0,0,0,0,0,0,0,0
"Iceland","2024-09-20",0,0,0,0,0,0,0,0
"Iceland","2024-09-21",0,0,0,0,0,0,0,0
"Iceland","2024-09-22",0,0,0,0,0,0,0,0
"Iceland","2024-09-23",0,0,0,0,0,0,0,0
"Iceland","2024-09-24",0,0,0,0,0,0,0,0
"Iceland","2024-09-25",0,0,0,0,0,0,0,0
"Iceland","2024-09-26",0,0,0,0,0,0,0,0
"Iceland","2024-09-27",0,0,0,0,0,0,0,0
"Iceland","2024-09-28",0,0,0,0,0,0,0,0
"Iceland","2024-09-29",0,0,0,0,0,0,0,0
"Iceland","2024-09-30",0,0,0,0,0,0,0,0
"Iceland","2024-10-01",0,0,0,0,0,0,0,0
"Iceland","2024-10-02",0,0,0,0,0,0,0,0
"Iceland","2024-10-03",0,0,0,0,0,0,0,0
"Iceland","2024-10-04",0,0,0,0,0,0,0,0
"Iceland","2024-10-05",0,0,0,0,0,0,0,0
"Iceland","2024-10-06",0,0,0,0,0,0,0,0
"Iceland","2024-10-07",0,0,0,0,0,0,0,0
"Iceland","2024-10-08",0,0,0,0,0,0,0,0
"Iceland","2024-10-09",0,0,0,0,0,0,0,0
"Iceland","2024-10-10",0,0,0,0,0,0,0,0
"Iceland","2024-10-11",0,0,0,0,0,0,0,0
"Iceland","2024-10-12",0,0,0,0,0,0,0,0
"Iceland","2024-10-13",0,0,0,0,0,0,0,0
"Iceland","2024-10-14",0,0,0,0,0,0,0,0
"Iceland","2024-10-15",0,0,0,0,0,0,0,0
"Iceland","2024-10-16",0,0,0,0,0,0,0,0
"Iceland","2024-10-17",0,0,0,0,0,0,0,0
"Iceland","2024-10-18",0,0,0,0,0,0,0,0
"Iceland","2024-10-19",0,0,0,0,0,0,0,0
"Iceland","2024-10-20",0,0,0,0,0,0,0,0
"Iceland","2024-10-21",0,0,0,0,0,0,0,0
"Iceland","2024-10-22",0,0,0,0,0,0,0,0
"Iceland","2024-10-23",0,0,0,0,0,0,0,0
"Iceland","2024-10-24",0,0,0,0,0,0,0,0
"Iceland","2024-10-25",0,0,0,0,0,0,0,0
"Iceland","2024-10-26",0,0,0,0,0,0,0,0
"Iceland","2024-10-27",0,0,0,0,0,0,0,0
"Iceland","2024-10-28",0,0,0,0,0,0,0,0
"Iceland","2024-10-29",0,0,0,0,0,0,0,0
"Iceland","2024-10-30",0,0,0,0,0,0,0,0
"Iceland","2024-10-31",0,0,0,0,0,0,0,0
"Iceland","2024-11-01",0,0,0,0,0,0,0,0
"Iceland","2024-11-02",0,0,0,0,0,0,0,0
"Iceland","2024-11-03",0,0,0,0,0,0,0,0
"Iceland","2024-11-04",0,0,0,0,0,0,0,0
"Iceland","2024-11-05",0,0,0,0,0,0,0,0
"Iceland","2024-11-06",0,0,0,0,0,0,0,0
"Iceland","2024-11-07",0,0,0,0,0,0,0,0
"Iceland","2024-11-08",0,0,0,0,0,0,0,0
"Iceland","2024-11-09",0,0,0,0,0,0,0,0
"Iceland","2024-11-10",0,0,0,0,0,0,0,0
"Iceland","2024-11-11",0,0,0,0,0,0,0,0
"Iceland","2024-11-12",0,0,0,0,0,0,0,0
"Iceland","2024-11-13",0,0,0,0,0,0,0,0
"Iceland","2024-11-14",0,0,0,0,0,0,0,0
"Iceland","2024-11-15",0,0,0,0,0,0,0,0
"Iceland","2024-11-16",0,0,0,0,0,0,0,0
"Iceland","2024-11-17",0,0,0,0,0,0,0,0
"Iceland","2024-11-18",0,0,0,0,0,0,0,0
"Iceland","2024-11-19",0,0,0,0,0,0,0,0
"Iceland","2024-11-20",0,0,0,0,0,0,0,0
"Iceland","2024-11-21",0,0,0,0,0,0,0,0
"Iceland","2024-11-22",0,0,0,0,0,0,0,0
"Iceland","2024-11-23",0,0,0,0,0,0,0,0
"Iceland","2024-11-24",0,0,0,0,0,0,0,0
"Iceland","2024-11-25",0,0,0,0,0,0,0,0
"Iceland","2024-11-26",0,0,0,0,0,0,0,0
"Iceland","2024-11-27",0,0,0,0,0,0,0,0
"Iceland","2024-11-28",0,0,0,0,0,0,0,0
"Iceland","2024-11-29",0,0,0,0,0,0,0,0
"Iceland","2024-11-30",0,0,0,0,0,0,0,0
"Iceland","2024-12-01",0,0,0,0,0,0,0,0
"Iceland","2024-12-02",0,0,0,0,0,0,0,0
"Iceland","2024-12-03",0,0,0,0,0,0,0,0
"Iceland","2024-12-04",0,0,0,0,0,0,0,0
"Iceland","2024-12-05",0,0,0,0,0,0,0,0
"Iceland","2024-12-06",0,0,0,0,0,0,0,0
"Iceland","2024-12-07",0,0,0,0,0,0,0,0
"Iceland","2024-12-08",0,0,0,0,0,0,0,0
"Iceland","2024-12-09",0,0,0,0,0,0,0,0
"Iceland","2024-12-10",0,0,0,0,0,0,0,0
"Iceland","2024-12-11",0,0,0,0,0,0,0,0
"Iceland","2024-12-12",0,0,0,0,0,0,0,0
"Iceland","2024-12-13",0,0,0,0,0,0,0,0
"Iceland","2024-12-14",0,0,0,0,0,0,0,0
"Iceland","2024-12-15",0,0,0,0,0,0,0,0
"Iceland","2024-12-16",0,0,0,0,0,0,0,0
"Iceland","2024-12-17",0,0,0,0,0,0,0,0
"Iceland","2024-12-18",0,0,0,0,0,0,0,0
"Iceland","2024-12-19",0,0,0,0,0,0,0,0
"Iceland","2024-12-20",0,0,0,0,0,0,0,0
"Iceland","2024-12-21",0,0,0,0,0,0,0,0
"Iceland","2024-12-22",0,0,0,0,0,0,0,0
"Iceland","2024-12-23",0,0,0,0,0,0,0,0
"Iceland","2024-12-24",0,0,0,0,0,0,0,0
"Iceland","2024-12-25",0,0,0,0,0,0,0,0
"Iceland","2024-12-26",0,0,0,0,0,0,0,0
"Iceland","2024-12-27",0,0,0,0,0,0,0,0
"Iceland","2024-12-28",0,0,0,0,0,0,0,0
"Iceland","2024-12-29",0,0,0,0,0,0,0,0
"Iceland","2024-12-30",0,0,0,0,0,0,0,0
"Iceland","2024-12-31",0,0,0,0,0,0,0,0
"Iceland","2025-01-01",0,0,0,0,0,0,0,0
"Iceland","2025-01-02",0,0,0,0,0,0,0,0
"Iceland","2025-01-03",0,0,0,0,0,0,0,0
"Iceland","2025-01-04",0,0,0,0,0,0,0,0
"Iceland","2025-01-05",0,0,0,0,0,0,0,0
"Iceland","2025-01-06",0,0,0,0,0,0,0,0
"Iceland","2025-01-07",0,0,0,0,0,0,0,0
"Iceland","2025-01-08",0,0,0,0,0,0,0,0
"Iceland","2025-01-09",0,0,0,0,0,0,0,0
"Iceland","2025-01-10",0,0,0,0,0,0,0,0
"Iceland","2025-01-11",0,0,0,0,0,0,0,0
"Iceland","2025-01-12",0,0,0,0,0,0,0,0
"Iceland","2025-01-13",0,0,0,0,0,0,0,0
"Iceland","2025-01-14",0,0,0,0,0,0,0,0
"Iceland","2025-01-15",0,0,0,0,0,0,0,0
"Iceland","2025-01-16",0,0,0,0,0,0,0,0
"Iceland","2025-01-17",0,0,0,0,0,0,0,0
"Iceland","2025-01-18",0,0,0,0,0,0,0,0
"Iceland","2025-01-19",0,0,0,0,0,0,0,0
"Iceland","2025-01-20",0,0,0,0,0,0,0,0
"Iceland","2025-01-21",0,0,0,0,0,0,0,0
"Iceland","2025-01-22",0,0,0,0,0,0,0,0
"Iceland","2025-01-23",0,0,0,0,0,0,0,0
"Iceland","2025-01-24",0,0,0,0,0,0,0,0
"Iceland","2025-01-25",0,0,0,0,0,0,0,0
"Iceland","2025-01-26",0,0,0,0,0,0,0,0
"Iceland","2025-01-27",0,0,0,0,0,0,0,0
"Iceland","2025-01-28",0,0,0,0,0,0,0,0
"Iceland","2025-01-29",0,0,0,0,0,0,0,0
"Iceland","2025-01-30",0,0,0,0,0,0,0,0
"Iceland","2025-01-31",0,0,0,0,0,0,0,0
"Iceland","2025-02-01",0,0,0,0,0,0,0,0
"Iceland","2025-02-02",0,0,0,0,0,0,0,0
"Iceland","2025-02-03",0,0,0,0,0,0,0,0
"Iceland","2025-02-04",0,0,0,0,0,0,0,0
"Iceland","2025-02-05",0,0,0,0,0,0,0,0
"Iceland","2025-02-06",0,0,0,0,0,0,0,0
"Iceland","2025-02-07",0,0,0,0,0,0,0,0
"Iceland","2025-02-08",0,0,0,0,0,0,0,0
"Iceland","2025-02-09",0,0,0,0,0,0,0,0
"Iceland","2025-02-10",0,0,0,0,0,0,0,0
"Iceland","2025-02-11",0,0,0,0,0,0,0,0
"Iceland","2025-02-12",0,0,0,0,0,0,0,0
"Iceland","2025-02-13",0,0,0,0,0,0,0,0
"Iceland","2025-02-14",0,0,0,0,0,0,0,0
"Iceland","2025-02-15",0,0,0,0,0,0,0,0
"Iceland","2025-02-16",0,0,0,0,0,0,0,0
"Iceland","2025-02-17",0,0,0,0,0,0,0,0
"Iceland","2025-02-18",0,0,0,0,0,0,0,0
"Iceland","2025-02-19",0,0,0,0,0,0,0,0
"Iceland","2025-02-20",0,0,0,0,0,0,0,0
"Iceland","2025-02-21",0,0,0,0,0,0,0,0
"Iceland","2025-02-22",0,0,0,0,0,0,0,0
"Iceland","2025-02-23",0,0,0,0,0,0,0,0
"Iceland","2025-02-24",0,0,0,0,0,0,0,0
"Iceland","2025-02-25",0,0,0,0,0,0,0,0
"Iceland","2025-02-26",0,0,0,0,0,0,0,0
"Iceland","2025-02-27",0,0,0,0,0,0,0,0
"Iceland","2025-02-28",0,0,0,0,0,0,0,0
"Iceland","2025-03-01",0,0,0,0,0,0,0,0
"Iceland","2025-03-02",0,0,0,0,0,0,0,0
"Iceland","2025-03-03",0,0,0,0,0,0,0,0
"India","2024-01-01",0,0,0,0,0,0,0,0
"India","2024-01-02",0,0,0,0,0,0,0,0
"India","2024-01-03",0,0,0,0,0,0,0,0
"India","2024-01-04",0,0,0,0,0,0,0,0
"India","2024-01-05",0,0,0,0,0,0,0,0
"India","2024-01-06",0,0,0,0,0,0,0,0
"India","2024-01-07",0,0,0,0,0,0,0,0
"India","2024-01-08",0,0,0,0,0,0,0,0
"India","2024-01-09",0,0,0,0,0,0,0,0
"India","2024-01-10",0,0,0,0,0,0,0,0
"India","2024-01-11",0,0,0,0,0,0,0,0
"India","2024-01-12",0,0,0,0,0,0,0,0
"India","2024-01-13",0,0,0,0,0,0,0,0
"India","2024-01-14",0,0,0,0,0,0,0,0
"India","2024-01-15",0,0,0,0,0,0,0,0
"India","2024-01-16",0,0,0,0,0,0,0,0
"India","2024-01-17",0,0,0,0,0,0,0,0
"India","2024-01-18",0,0,0,0,0,0,0,0
"India","2024-01-19",0,0,0,0,0,0,0,0
"India","2024-01-20",0,0,0,0,0,0,0,0
"India","2024-01-21",0,0,0,0,0,0,0,0
"India","2024-01-22",0,0,0,0,0,0,0,0
"India","2024-01-23",0,0,0,0,0,0,0,0
"India","2024-01-24",0,0,0,0,0,0,0,0
"India","2024-01-25",0,0,0,0,0,0,0,0
"India","2024-01-26",0,0,0,0,0,0,0,0
"India","2024-01-27",0,0,0,0,0,0,0,0
"India","2024-01-28",0,0,0,0,0,0,0,0
"India","2024-01-29",0,0,0,0,0,0,0,0
"India","2024-01-30",0,0,0,0,0,0,0,0
"India","2024-01-31",0,0,0,0,0,0,0,0
"India","2024-02-01",0,0,0,0,0,0,0,0
"India","2024-02-02",0,0,0,0,0,0,0,0
"India","2024-02-03",0,0,0,0,0,0,0,0
"India","2024-02-04",0,0,0,0,0,0,0,0
"India","2024-02-05",0,0,0,0,0,0,0,0
"India","2024-02-06",0,0,0,0,0,0,0,0
"India","2024-02-07",0,0,0,0,0,0,0,0
"India","2024-02-08",0,0,0,0,0,0,0,0
"India","2024-02-09",0,0,0,0,0,0,0,0
"India","2024-02-10",0,0,0,0,0,0,0,0
"India","2024-02-11",0,0,0,0,0,0,0,0
"India","2024-02-12",0,0,0,0,0,0,0,0
"India","2024-02-13",0,0,0,0,0,0,0,0
"India","2024-02-14",0,0,0,0,0,0,0,0
"India","2024-02-15",0,0,0,0,0,0,0,0
"India","2024-02-16",0,0,0,0,0,0,0,0
"India","2024-02-17",0,0,0,0,0,0,0,0
"India","2024-02-18",0,0,0,0,0,0,0,0
"India","2024-02-19",0,0,0,0,0,0,0,0
"India","2024-02-20",0,0,0,0,0,0,0,0
"India","2024-02-21",0,0,0,0,0,0,0,0
"India","2024-02-22",0,0,0,0,0,0,0,0
"India","2024-02-23",0,0,0,0,0,0,0,0
"India","2024-02-24",0,0,0,0,0,0,0,0
"India","2024-02-25",0,0,0,0,0,0,0,0
"India","2024-02-26",0,0,0,0,0,0,0,0
"India","2024-02-27",0,0,0,0,0,0,0,0
"India","2024-02-28",0,0,0,0,0,0,0,0
"India","2024-02-29",0,0,0,0,0,0,0,0
"India","2024-03-01",0,0,0,0,0,0,0,0
"India","2024-03-02",0,0,0,0,0,0,0,0
"India","2024-03-03",0,0,0,0,0,0,0,0
"India","2024-03-04",0,0,0,0,0,0,0,0
"India","2024-03-05",0,0,0,0,0,0,0,0
"India","2024-03-06",0,0,0,0,0,0,0,0
"India","2024-03-07",0,0,0,0,0,0,0,0
"India","2024-03-08",0,0,0,0,0,0,0,0
"India","2024-03-09",0,0,0,0,0,0,0,0
"India","2024-03-10",0,0,0,0,0,0,0,0
"India","2024-03-11",0,0,0,0,0,0,0,0
"India","2024-03-12",0,0,0,0,0,0,0,0
"India","2024-03-13",0,0,0,0,0,0,0,0
"India","2024-03-14",0,0,0,0,0,0,0,0
"India","2024-03-15",0,0,0,0,0,0,0,0
"India","2024-03-16",0,0,0,0,0,0,0,0
"India","2024-03-17",0,0,0,0,0,0,0,0
"India","2024-03-18",0,0,0,0,0,0,0,0
"India","2024-03-19",0,0,0,0,0,0,0,0
"India","2024-03-20",0,0,0,0,0,0,0,0
"India","2024-03-21",0,0,0,0,0,0,0,0
"India","2024-03-22",0,0,0,0,0,0,0,0
"India","2024-03-23",0,0,0,0,0,0,0,0
"India","2024-03-24",0,0,0,0,0,0,0,0
"India","2024-03-25",0,0,0,0,0,0,0,0
"India","2024-03-26",0,0,0,0,0,0,0,0
"India","2024-03-27",0,0,0,0,0,0,0,0
"India","2024-03-28",0,0,0,0,0,0,0,0
"India","2024-03-29",0,0,0,0,0,0,0,0
"India","2024-03-30",0,0,0,0,0,0,0,0
"India","2024-03-31",0,0,0,0,0,0,0,0
"India","2024-04-01",0,0,0,0,0,0,0,0
"India","2024-04-02",0,0,0,0,0,0,0,0
"India","2024-04-03",0,0,0,0,0,0,0,0
"India","2024-04-04",0,0,0,0,0,0,0,0
"India","2024-04-05",0,0,0,0,0,0,0,0
"India","2024-04-06",0,0,0,0,0,0,0,0
"India","2024-04-07",0,0,0,0,0,0,0,0
"India","2024-04-08",0,0,0,0,0,0,0,0
"India","2024-04-09",0,0,0,0,0,0,0,0
"India","2024-04-10",0,0,0,0,0,0,0,0
"India","2024-04-11",0,0,0,0,0,0,0,0
"India","2024-04-12",0,0,0,0,0,0,0,0
"India","2024-04-13",0,0,0,0,0,0,0,0
"India","2024-04-14",0,0,0,0,0,0,0,0
"India","2024-04-15",0,0,0,0,0,0,0,0
"India","2024-04-16",0,0,0,0,0,0,0,0
"India","2024-04-17",0,0,0,0,0,0,0,0
"India","2024-04-18",0,0,0,0,0,0,0,0
"India","2024-04-19",0,0,0,0,0,0,0,0
"India","2024-04-20",0,0,0,0,0,0,0,0
"India","2024-04-21",0,0,0,0,0,0,0,0
"India","2024-04-22",0,0,0,0,0,0,0,0
"India","2024-04-23",0,0,0,0,0,0,0,0
"India","2024-04-24",0,0,0,0,0,0,0,0
"India","2024-04-25",0,0,0,0,0,0,0,0
"India","2024-04-26",0,0,0,0,0,0,0,0
"India","2024-04-27",0,0,0,0,0,0,0,0
"India","2024-04-28",0,0,0,0,0,0,0,0
"India","2024-04-29",0,0,0,0,0,0,0,0
"India","2024-04-30",0,0,0,0,0,0,0,0
"India","2024-05-01",0,0,0,0,0,0,0,0
"India","2024-05-02",0,0,0,0,0,0,0,0
"India","2024-05-03",0,0,0,0,0,0,0,0
"India","2024-05-04",0,0,0,0,0,0,0,0
"India","2024-05-05",0,0,0,0,0,0,0,0
"India","2024-05-06",0,0,0,0,0,0,0,0
"India","2024-05-07",0,0,0,0,0,0,0,0
"India","2024-05-08",0,0,0,0,0,0,0,0
"India","2024-05-09",0,0,0,0,0,0,0,0
"India","2024-05-10",0,0,0,0,0,0,0,0
"India","2024-05-11",0,0,0,0,0,0,0,0
"India","2024-05-12",0,0,0,0,0,0,0,0
"India","2024-05-13",0,0,0,0,0,0,0,0
"India","2024-05-14",0,0,0,0,0,0,0,0
"India","2024-05-15",0,0,0,0,0,0,0,0
"India","2024-05-16",0,0,0,0,0,0,0,0
"India","2024-05-17",0,0,0,0,0,0,0,0
"India","2024-05-18",0,0,0,0,0,0,0,0
"India","2024-05-19",0,0,0,0,0,0,0,0
"India","2024-05-20",0,0,0,0,0,0,0,0
"India","2024-05-21",0,0,0,0,0,0,0,0
"India","2024-05-22",0,0,0,0,0,0,0,0
"India","2024-05-23",0,0,0,0,0,0,0,0
"India","2024-05-24",0,0,0,0,0,0,0,0
"India","2024-05-25",0,0,0,0,0,0,0,0
"India","2024-05-26",0,0,0,0,0,0,0,0
"India","2024-05-27",0,0,0,0,0,0,0,0
"India","2024-05-28",0,0,0,0,0,0,0,0
"India","2024-05-29",0,0,0,0,0,0,0,0
"India","2024-05-30",0,0,0,0,0,0,0,0
"India","2024-05-31",0,0,0,0,0,0,0,0
"India","2024-06-01",0,0,0,0,0,0,0,0
"India","2024-06-02",0,0,0,0,0,0,0,0
"India","2024-06-03",0,0,0,0,0,0,0,0
"India","2024-06-04",0,0,0,0,0,0,0,0
"India","2024-06-05",0,0,0,0,0,0,0,0
"India","2024-06-06",0,0,0,0,0,0,0,0
"India","2024-06-07",0,0,0,0,0,0,0,0
"India","2024-06-08",0,0,0,0,0,0,0,0
"India","2024-06-09",0,0,0,0,0,0,0,0
"India","2024-06-10",0,0,0,0,0,0,0,0
"India","2024-06-11",0,0,0,0,0,0,0,0
"India","2024-06-12",0,0,0,0,0,0,0,0
"India","2024-06-13",0,0,0,0,0,0,0,0
"India","2024-06-14",0,0,0,0,0,0,0,0
"India","2024-06-15",0,0,0,0,0,0,0,0
"India","2024-06-16",0,0,0,0,0,0,0,0
"India","2024-06-17",0,0,0,0,0,0,0,0
"India","2024-06-18",0,0,0,0,0,0,0,0
"India","2024-06-19",0,0,0,0,0,0,0,0
"India","2024-06-20",0,0,0,0,0,0,0,0
"India","2024-06-21",0,0,0,0,0,0,0,0
"India","2024-06-22",0,0,0,0,0,0,0,0
"India","2024-06-23",0,0,0,0,0,0,0,0
"India","2024-06-24",0,0,0,0,0,0,0,0
"India","2024-06-25",0,0,0,0,0,0,0,0
"India","2024-06-26",0,0,0,0,0,0,0,0
"India","2024-06-27",0,0,0,0,0,0,0,0
"India","2024-06-28",0,0,0,0,0,0,0,0
"India","2024-06-29",0,0,0,0,0,0,0,0
"India","2024-06-30",0,0,0,0,0,0,0,0
"India","2024-07-01",0,0,0,0,0,0,0,0
"India","2024-07-02",0,0,0,0,0,0,0,0
"India","2024-07-03",0,0,0,0,0,0,0,0
"India","2024-07-04",0,0,0,0,0,0,0,0
"India","2024-07-05",0,0,0,0,0,0,0,0
"India","2024-07-06",0,0,0,0,0,0,0,0
"India","2024-07-07",0,0,0,0,0,0,0,0
"India","2024-07-08",0,0,0,0,0,0,0,0
"India","2024-07-09",0,0,0,0,0,0,0,0
"India","2024-07-10",0,0,0,0,0,0,0,0
"India","2024-07-11",0,0,0,0,0,0,0,0
"India","2024-07-12",0,0,0,0,0,0,0,0
"India","2024-07-13",0,0,0,0,0,0,0,0
"India","2024-07-14",0,0,0,0,0,0,0,0
"India","2024-07-15",0,0,0,0,0,0,0,0
"India","2024-07-16",0,0,0,0,0,0,0,0
"India","2024-07-17",0,0,0,0,0,0,0,0
"India","2024-07-18",0,0,0,0,0,0,0,0
"India","2024-07-19",0,0,0,0,0,0,0,0
"India","2024-07-20",0,0,0,0,0,0,0,0
"India","2024-07-21",0,0,0,0,0,0,0,0
"India","2024-07-22",0,0,0,0,0,0,0,0
"India","2024-07-23",0,0,0,0,0,0,0,0
"India","2024-07-24",0,0,0,0,0,0,0,0
"India","2024-07-25",0,0,0,0,0,0,0,0
"India","2024-07-26",0,0,0,0,0,0,0,0
"India","2024-07-27",0,0,0,0,0,0,0,0
"India","2024-07-28",0,0,0,0,0,0,0,0
"India","2024-07-29",0,0,0,0,0,0,0,0
"India","2024-07-30",0,0,0,0,0,0,0,0
"India","2024-07-31",0,0,0,0,0,0,0,0
"India","2024-08-01",0,0,0,0,0,0,0,0
"India","2024-08-02",0,0,0,0,0,0,0,0
"India","2024-08-03",0,0,0,0,0,0,0,0
"India","2024-08-04",0,0,0,0,0,0,0,0
"India","2024-08-05",0,0,0,0,0,0,0,0
"India","2024-08-06",0,0,0,0,0,0,0,0
"India","2024-08-07",0,0,0,0,0,0,0,0
"India","2024-08-08",0,0,0,0,0,0,0,0
"India","2024-08-09",0,0,0,0,0,0,0,0
"India","2024-08-10",0,0,0,0,0,0,0,0
"India","2024-08-11",0,0,0,0,0,0,0,0
"India","2024-08-12",0,0,0,0,0,0,0,0
"India","2024-08-13",0,0,0,0,0,0,0,0
"India","2024-08-14",0,0,0,0,0,0,0,0
"India","2024-08-15",0,0,0,0,0,0,0,0
"India","2024-08-16",0,0,0,0,0,0,0,0
"India","2024-08-17",0,0,0,0,0,0,0,0
"India","2024-08-18",0,0,0,0,0,0,0,0
"India","2024-08-19",0,0,0,0,0,0,0,0
"India","2024-08-20",0,0,0,0,0,0,0,0
"India","2024-08-21",0,0,0,0,0,0,0,0
"India","2024-08-22",0,0,0,0,0,0,0,0
"India","2024-08-23",0,0,0,0,0,0,0,0
"India","2024-08-24",0,0,0,0,0,0,0,0
"India","2024-08-25",0,0,0,0,0,0,0,0
"India","2024-08-26",0,0,0,0,0,0,0,0
"India","2024-08-27",0,0,0,0,0,0,0,0
"India","2024-08-28",0,0,0,0,0,0,0,0
"India","2024-08-29",0,0,0,0,0,0,0,0
"India","2024-08-30",0,0,0,0,0,0,0,0
"India","2024-08-31",0,3,3,0,3,3,0,0
"India","2024-09-01",0,0,3,0,0,3,0,0
"India","2024-09-02",0,0,3,0,0,3,0,0
"India","2024-09-03",0,0,3,0,0,3,0,0
"India","2024-09-04",0,0,3,0,0,3,0,0
"India","2024-09-05",0,0,3,0,0,3,0,0
"India","2024-09-06",0,0,3,0,1,4,0,0
"India","2024-09-07",0,0,3,0,0,4,0,0
"India","2024-09-08",0,0,3,0,0,4,0,0
"India","2024-09-09",0,0,3,0,0,4,0,0
"India","2024-09-10",0,0,3,0,0,4,0,0
"India","2024-09-11",0,0,3,0,0,4,0,0
"India","2024-09-12",0,0,3,0,0,4,0,0
"India","2024-09-13",0,0,3,0,0,4,0,0
"India","2024-09-14",0,0,3,0,0,4,0,0
"India","2024-09-15",0,0,3,0,1,5,0,0
"India","2024-09-16",0,0,3,0,0,5,0,0
"India","2024-09-17",0,0,3,0,0,5,0,0
"India","2024-09-18",0,0,3,0,0,5,0,0
"India","2024-09-19",0,0,3,0,0,5,0,0
"India","2024-09-20",0,0,3,0,0,5,0,0
"India","2024-09-21",0,0,3,0,0,5,0,0
"India","2024-09-22",0,0,3,0,0,5,0,0
"India","2024-09-23",0,0,3,0,0,5,0,0
"India","2024-09-24",0,0,3,0,0,5,0,0
"India","2024-09-25",0,0,3,0,0,5,0,0
"India","2024-09-26",0,0,3,0,1,6,0,0
"India","2024-09-27",0,0,3,0,0,6,0,0
"India","2024-09-28",0,0,3,0,0,6,0,0
"India","2024-09-29",0,0,3,0,0,6,0,0
"India","2024-09-30",0,3,6,0,0,6,0,0
"India","2024-10-01",0,0,6,0,0,6,0,0
"India","2024-10-02",0,0,6,0,0,6,0,0
"India","2024-10-03",0,0,6,0,0,6,0,0
"India","2024-10-04",0,0,6,0,0,6,0,0
"India","2024-10-05",0,0,6,0,0,6,0,0
"India","2024-10-06",0,0,6,0,0,6,0,0
"India","2024-10-07",0,0,6,0,0,6,0,0
"India","2024-10-08",0,0,6,0,0,6,0,0
"India","2024-10-09",0,0,6,0,0,6,0,0
"India","2024-10-10",0,0,6,0,0,6,0,0
"India","2024-10-11",0,0,6,0,0,6,0,0
"India","2024-10-12",0,0,6,0,0,6,0,0
"India","2024-10-13",0,0,6,0,0,6,0,0
"India","2024-10-14",0,0,6,0,0,6,0,0
"India","2024-10-15",0,0,6,0,0,6,0,0
"India","2024-10-16",0,0,6,0,1,7,0,0
"India","2024-10-17",0,0,6,0,0,7,0,0
"India","2024-10-18",0,0,6,0,0,7,0,0
"India","2024-10-19",0,0,6,0,0,7,0,0
"India","2024-10-20",0,0,6,0,0,7,0,0
"India","2024-10-21",0,0,6,0,0,7,0,0
"India","2024-10-22",0,0,6,0,0,7,0,0
"India","2024-10-23",0,0,6,0,0,7,0,0
"India","2024-10-24",0,0,6,0,0,7,0,0
"India","2024-10-25",0,0,6,0,0,7,0,0
"India","2024-10-26",0,0,6,0,0,7,0,0
"India","2024-10-27",0,0,6,0,0,7,0,0
"India","2024-10-28",0,0,6,0,0,7,0,0
"India","2024-10-29",0,0,6,0,0,7,0,0
"India","2024-10-30",0,0,6,0,0,7,0,0
"India","2024-10-31",0,0,6,0,0,7,0,0
"India","2024-11-01",0,0,6,0,0,7,0,0
"India","2024-11-02",0,0,6,0,0,7,0,0
"India","2024-11-03",0,0,6,0,0,7,0,0
"India","2024-11-04",0,0,6,0,0,7,0,0
"India","2024-11-05",0,0,6,0,0,7,0,0
"India","2024-11-06",0,0,6,0,0,7,0,0
"India","2024-11-07",0,0,6,0,0,7,0,0
"India","2024-11-08",0,0,6,0,0,7,0,0
"India","2024-11-09",0,0,6,0,0,7,0,0
"India","2024-11-10",0,0,6,0,0,7,0,0
"India","2024-11-11",0,0,6,0,0,7,0,0
"India","2024-11-12",0,0,6,0,0,7,0,0
"India","2024-11-13",0,0,6,0,0,7,0,0
"India","2024-11-14",0,0,6,0,0,7,0,0
"India","2024-11-15",0,0,6,0,1,8,0,0
"India","2024-11-16",0,0,6,0,0,8,0,0
"India","2024-11-17",0,0,6,0,0,8,0,0
"India","2024-11-18",0,0,6,0,0,8,0,0
"India","2024-11-19",0,0,6,0,0,8,0,0
"India","2024-11-20",0,0,6,0,0,8,0,0
"India","2024-11-21",0,0,6,0,0,8,0,0
"India","2024-11-22",0,0,6,0,0,8,0,0
"India","2024-11-23",0,0,6,0,0,8,0,0
"India","2024-11-24",0,0,6,0,0,8,0,0
"India","2024-11-25",0,0,6,0,0,8,0,0
"India","2024-11-26",0,0,6,0,0,8,0,0
"India","2024-11-27",0,0,6,0,0,8,0,0
"India","2024-11-28",0,0,6,0,0,8,0,0
"India","2024-11-29",0,0,6,0,0,8,0,0
"India","2024-11-30",0,0,6,0,0,8,0,0
"India","2024-12-01",0,0,6,0,0,8,0,0
"India","2024-12-02",0,0,6,0,0,8,0,0
"India","2024-12-03",0,0,6,0,0,8,0,0
"India","2024-12-04",0,0,6,0,0,8,0,0
"India","2024-12-05",0,0,6,0,0,8,0,0
"India","2024-12-06",0,0,6,0,0,8,0,0
"India","2024-12-07",0,0,6,0,0,8,0,0
"India","2024-12-08",0,0,6,0,0,8,0,0
"India","2024-12-09",0,0,6,0,0,8,0,0
"India","2024-12-10",0,0,6,0,0,8,0,0
"India","2024-12-11",0,0,6,0,0,8,0,0
"India","2024-12-12",0,0,6,0,0,8,0,0
"India","2024-12-13",0,0,6,0,0,8,0,0
"India","2024-12-14",0,0,6,0,0,8,0,0
"India","2024-12-15",0,0,6,0,0,8,0,0
"India","2024-12-16",0,0,6,0,1,9,0,0
"India","2024-12-17",0,0,6,0,0,9,0,0
"India","2024-12-18",0,0,6,0,0,9,0,0
"India","2024-12-19",0,0,6,0,0,9,0,0
"India","2024-12-20",0,0,6,0,0,9,0,0
"India","2024-12-21",0,0,6,0,0,9,0,0
"India","2024-12-22",0,0,6,0,0,9,0,0
"India","2024-12-23",0,0,6,0,0,9,0,0
"India","2024-12-24",0,0,6,0,0,9,0,0
"India","2024-12-25",0,0,6,0,0,9,0,0
"India","2024-12-26",0,0,6,0,0,9,0,0
"India","2024-12-27",0,0,6,0,0,9,0,0
"India","2024-12-28",0,0,6,0,0,9,0,0
"India","2024-12-29",0,0,6,0,0,9,0,0
"India","2024-12-30",0,0,6,0,0,9,0,0
"India","2024-12-31",0,3,9,0,0,9,0,0
"India","2025-01-01",0,0,9,0,0,9,0,0
"India","2025-01-02",0,0,9,0,0,9,0,0
"India","2025-01-03",0,0,9,0,0,9,0,0
"India","2025-01-04",0,0,9,0,0,9,0,0
"India","2025-01-05",0,0,9,0,0,9,0,0
"India","2025-01-06",0,0,9,0,1,10,0,0
"India","2025-01-07",0,0,9,0,0,10,0,0
"India","2025-01-08",0,0,9,0,0,10,0,0
"India","2025-01-09",0,0,9,0,0,10,0,0
"India","2025-01-10",0,0,9,0,0,10,0,0
"India","2025-01-11",0,0,9,0,0,10,0,0
"India","2025-01-12",0,0,9,0,0,10,0,0
"India","2025-01-13",0,0,9,0,0,10,0,0
"India","2025-01-14",0,0,9,0,0,10,0,0
"India","2025-01-15",0,0,9,0,0,10,0,0
"India","2025-01-16",0,0,9,0,1,11,0,0
"India","2025-01-17",0,0,9,0,0,11,0,0
"India","2025-01-18",0,0,9,0,0,11,0,0
"India","2025-01-19",0,0,9,0,0,11,0,0
"India","2025-01-20",0,0,9,0,0,11,0,0
"India","2025-01-21",0,0,9,0,0,11,0,0
"India","2025-01-22",0,0,9,0,0,11,0,0
"India","2025-01-23",0,0,9,0,0,11,0,0
"India","2025-01-24",0,0,9,0,0,11,0,0
"India","2025-01-25",0,0,9,0,0,11,0,0
"India","2025-01-26",0,0,9,0,1,12,0,0
"India","2025-01-27",0,0,9,0,0,12,0,0
"India","2025-01-28",0,0,9,0,0,12,0,0
"India","2025-01-29",0,0,9,0,0,12,0,0
"India","2025-01-30",0,0,9,0,0,12,0,0
"India","2025-01-31",0,3,12,0,0,12,0,0
"India","2025-02-01",0,0,12,0,0,12,0,0
"India","2025-02-02",0,0,12,0,0,12,0,0
"India","2025-02-03",0,0,12,0,0,12,0,0
"India","2025-02-04",0,0,12,0,0,12,0,0
"India","2025-02-05",0,0,12,0,0,12,0,0
"India","2025-02-06",0,0,12,0,0,12,0,0
"India","2025-02-07",0,0,12,0,0,12,0,0
"India","2025-02-08",0,0,12,0,0,12,0,0
"India","2025-02-09",0,0,12,0,0,12,0,0
"India","2025-02-10",0,0,12,0,0,12,0,0
"India","2025-02-11",0,0,12,0,0,12,0,0
"India","2025-02-12",0,0,12,0,0,12,0,0
"India","2025-02-13",0,0,12,0,0,12,0,0
"India","2025-02-14",0,0,12,0,0,12,0,0
"India","2025-02-15",0,0,12,0,0,12,0,0
"India","2025-02-16",0,0,12,0,0,12,0,0
"India","2025-02-17",0,0,12,0,0,12,0,0
"India","2025-02-18",0,0,12,0,0,12,0,0
"India","2025-02-19",0,0,12,0,0,12,0,0
"India","2025-02-20",0,0,12,0,0,12,0,0
"India","2025-02-21",0,0,12,0,0,12,0,0
"India","2025-02-22",0,0,12,0,0,12,0,0
"India","2025-02-23",0,0,12,0,0,12,0,0
"India","2025-02-24",0,0,12,0,0,12,0,0
"India","2025-02-25",0,0,12,0,0,12,0,0
"India","2025-02-26",0,0,12,0,0,12,0,0
"India","2025-02-27",0,0,12,0,0,12,0,0
"India","2025-02-28",0,0,12,0,0,12,0,0
"India","2025-03-01",0,0,12,0,0,12,0,0
"India","2025-03-02",0,0,12,0,0,12,0,0
"India","2025-03-03",0,0,12,0,0,12,0,0
"Indonesia","2024-01-01",0,0,0,0,0,0,0,0
"Indonesia","2024-01-02",0,0,0,0,0,0,0,0
"Indonesia","2024-01-03",0,0,0,0,0,0,0,0
"Indonesia","2024-01-04",0,0,0,0,0,0,0,0
"Indonesia","2024-01-05",0,0,0,0,0,0,0,0
"Indonesia","2024-01-06",0,0,0,0,0,0,0,0
"Indonesia","2024-01-07",0,0,0,0,0,0,0,0
"Indonesia","2024-01-08",0,0,0,0,0,0,0,0
"Indonesia","2024-01-09",0,0,0,0,0,0,0,0
"Indonesia","2024-01-10",0,0,0,0,0,0,0,0
"Indonesia","2024-01-11",0,0,0,0,0,0,0,0
"Indonesia","2024-01-12",0,0,0,0,0,0,0,0
"Indonesia","2024-01-13",0,0,0,0,0,0,0,0
"Indonesia","2024-01-14",0,0,0,0,0,0,0,0
"Indonesia","2024-01-15",0,0,0,0,0,0,0,0
"Indonesia","2024-01-16",0,0,0,0,0,0,0,0
"Indonesia","2024-01-17",0,0,0,0,0,0,0,0
"Indonesia","2024-01-18",0,0,0,0,0,0,0,0
"Indonesia","2024-01-19",0,0,0,0,0,0,0,0
"Indonesia","2024-01-20",0,0,0,0,0,0,0,0
"Indonesia","2024-01-21",0,0,0,0,0,0,0,0
"Indonesia","2024-01-22",0,0,0,0,0,0,0,0
"Indonesia","2024-01-23",0,0,0,0,0,0,0,0
"Indonesia","2024-01-24",0,0,0,0,0,0,0,0
"Indonesia","2024-01-25",0,0,0,0,0,0,0,0
"Indonesia","2024-01-26",0,0,0,0,0,0,0,0
"Indonesia","2024-01-27",0,0,0,0,0,0,0,0
"Indonesia","2024-01-28",0,0,0,0,0,0,0,0
"Indonesia","2024-01-29",0,0,0,0,0,0,0,0
"Indonesia","2024-01-30",0,0,0,0,0,0,0,0
"Indonesia","2024-01-31",0,7,7,0,7,7,0,0
"Indonesia","2024-02-01",0,0,7,0,0,7,0,0
"Indonesia","2024-02-02",0,0,7,0,0,7,0,0
"Indonesia","2024-02-03",0,0,7,0,0,7,0,0
"Indonesia","2024-02-04",0,0,7,0,1,8,0,0
"Indonesia","2024-02-05",0,0,7,0,0,8,0,0
"Indonesia","2024-02-06",0,0,7,0,0,8,0,0
"Indonesia","2024-02-07",0,0,7,0,0,8,0,0
"Indonesia","2024-02-08",0,0,7,0,0,8,0,0
"Indonesia","2024-02-09",0,0,7,0,0,8,0,0
"Indonesia","2024-02-10",0,0,7,0,0,8,0,0
"Indonesia","2024-02-11",0,0,7,0,1,9,0,0
"Indonesia","2024-02-12",0,0,7,0,0,9,0,0
"Indonesia","2024-02-13",0,0,7,0,0,9,0,0
"Indonesia","2024-02-14",0,0,7,0,0,9,0,0
"Indonesia","2024-02-15",0,0,7,0,0,9,0,0
"Indonesia","2024-02-16",0,0,7,0,0,9,0,0
"Indonesia","2024-02-17",0,0,7,0,0,9,0,0
"Indonesia","2024-02-18",0,0,7,0,0,9,0,0
"Indonesia","2024-02-19",0,0,7,0,1,10,0,0
"Indonesia","2024-02-20",0,0,7,0,0,10,0,0
"Indonesia","2024-02-21",0,0,7,0,0,10,0,0
"Indonesia","2024-02-22",0,0,7,0,0,10,0,0
"Indonesia","2024-02-23",0,0,7,0,0,10,0,0
"Indonesia","2024-02-24",0,0,7,0,0,10,0,0
"Indonesia","2024-02-25",0,0,7,0,0,10,0,0
"Indonesia","2024-02-26",0,0,7,0,1,11,0,0
"Indonesia","2024-02-27",0,0,7,0,0,11,0,0
"Indonesia","2024-02-28",0,0,7,0,0,11,0,0
"Indonesia","2024-02-29",0,4,11,0,0,11,0,0
"Indonesia","2024-03-01",0,0,11,0,0,11,0,0
"Indonesia","2024-03-02",0,0,11,0,0,11,0,0
"Indonesia","2024-03-03",0,0,11,0,0,11,0,0
"Indonesia","2024-03-04",0,0,11,0,0,11,0,0
"Indonesia","2024-03-05",0,0,11,0,0,11,0,0
"Indonesia","2024-03-06",0,0,11,0,0,11,0,0
"Indonesia","2024-03-07",0,0,11,0,0,11,0,0
"Indonesia","2024-03-08",0,0,11,0,0,11,0,0
"Indonesia","2024-03-09",0,0,11,0,0,11,0,0
"Indonesia","2024-03-10",0,0,11,0,0,11,0,0
"Indonesia","2024-03-11",0,0,11,0,0,11,0,0
"Indonesia","2024-03-12",0,0,11,0,0,11,0,0
"Indonesia","2024-03-13",0,0,11,0,0,11,0,0
"Indonesia","2024-03-14",0,0,11,0,0,11,0,0
"Indonesia","2024-03-15",0,0,11,0,0,11,0,0
"Indonesia","2024-03-16",0,0,11,0,0,11,0,0
"Indonesia","2024-03-17",0,0,11,0,1,12,0,0
"Indonesia","2024-03-18",0,0,11,0,0,12,0,0
"Indonesia","2024-03-19",0,0,11,0,0,12,0,0
"Indonesia","2024-03-20",0,0,11,0,0,12,0,0
"Indonesia","2024-03-21",0,0,11,0,0,12,0,0
"Indonesia","2024-03-22",0,0,11,0,0,12,0,0
"Indonesia","2024-03-23",0,0,11,0,0,12,0,0
"Indonesia","2024-03-24",0,0,11,0,0,12,0,0
"Indonesia","2024-03-25",0,0,11,0,0,12,0,0
"Indonesia","2024-03-26",0,0,11,0,0,12,0,0
"Indonesia","2024-03-27",0,0,11,0,0,12,0,0
"Indonesia","2024-03-28",0,0,11,0,0,12,0,0
"Indonesia","2024-03-29",0,0,11,0,0,12,0,0
"Indonesia","2024-03-30",0,0,11,0,0,12,0,0
"Indonesia","2024-03-31",0,0,11,0,0,12,0,0
"Indonesia","2024-04-01",0,0,11,0,0,12,0,0
"Indonesia","2024-04-02",0,1,12,0,0,12,0,0
"Indonesia","2024-04-03",0,0,12,0,0,12,0,0
"Indonesia","2024-04-04",0,0,12,0,0,12,0,0
"Indonesia","2024-04-05",0,0,12,0,0,12,0,0
"Indonesia","2024-04-06",0,0,12,0,0,12,0,0
"Indonesia","2024-04-07",0,0,12,0,0,12,0,0
"Indonesia","2024-04-08",0,0,12,0,0,12,0,0
"Indonesia","2024-04-09",0,0,12,0,0,12,0,0
"Indonesia","2024-04-10",0,0,12,0,0,12,0,0
"Indonesia","2024-04-11",0,0,12,0,0,12,0,0
"Indonesia","2024-04-12",0,0,12,0,0,12,0,0
"Indonesia","2024-04-13",0,0,12,0,0,12,0,0
"Indonesia","2024-04-14",0,0,12,0,0,12,0,0
"Indonesia","2024-04-15",0,0,12,0,0,12,0,0
"Indonesia","2024-04-16",0,0,12,0,0,12,0,0
"Indonesia","2024-04-17",0,0,12,0,1,13,0,0
"Indonesia","2024-04-18",0,0,12,0,0,13,0,0
"Indonesia","2024-04-19",0,0,12,0,0,13,0,0
"Indonesia","2024-04-20",0,0,12,0,0,13,0,0
"Indonesia","2024-04-21",0,0,12,0,0,13,0,0
"Indonesia","2024-04-22",0,0,12,0,0,13,0,0
"Indonesia","2024-04-23",0,0,12,0,0,13,0,0
"Indonesia","2024-04-24",0,0,12,0,0,13,0,0
"Indonesia","2024-04-25",0,0,12,0,0,13,0,0
"Indonesia","2024-04-26",0,0,12,0,0,13,0,0
"Indonesia","2024-04-27",0,0,12,0,0,13,0,0
"Indonesia","2024-04-28",0,0,12,0,0,13,0,0
"Indonesia","2024-04-29",0,0,12,0,0,13,0,0
"Indonesia","2024-04-30",0,1,13,0,0,13,0,0
"Indonesia","2024-05-01",0,0,13,0,0,13,0,0
"Indonesia","2024-05-02",0,0,13,0,0,13,0,0
"Indonesia","2024-05-03",0,0,13,0,0,13,0,0
"Indonesia","2024-05-04",0,0,13,0,0,13,0,0
"Indonesia","2024-05-05",0,0,13,0,0,13,0,0
"Indonesia","2024-05-06",0,0,13,0,0,13,0,0
"Indonesia","2024-05-07",0,0,13,0,0,13,0,0
"Indonesia","2024-05-08",0,0,13,0,0,13,0,0
"Indonesia","2024-05-09",0,0,13,0,0,13,0,0
"Indonesia","2024-05-10",0,0,13,0,0,13,0,0
"Indonesia","2024-05-11",0,0,13,0,0,13,0,0
"Indonesia","2024-05-12",0,0,13,0,0,13,0,0
"Indonesia","2024-05-13",0,0,13,0,0,13,0,0
"Indonesia","2024-05-14",0,0,13,0,0,13,0,0
"Indonesia","2024-05-15",0,0,13,0,0,13,0,0
"Indonesia","2024-05-16",0,0,13,0,1,14,0,0
"Indonesia","2024-05-17",0,0,13,0,0,14,0,0
"Indonesia","2024-05-18",0,0,13,0,0,14,0,0
"Indonesia","2024-05-19",0,0,13,0,0,14,0,0
"Indonesia","2024-05-20",0,0,13,0,0,14,0,0
"Indonesia","2024-05-21",0,0,13,0,0,14,0,0
"Indonesia","2024-05-22",0,0,13,0,0,14,0,0
"Indonesia","2024-05-23",0,0,13,0,0,14,0,0
"Indonesia","2024-05-24",0,0,13,0,0,14,0,0
"Indonesia","2024-05-25",0,0,13,0,0,14,0,0
"Indonesia","2024-05-26",0,0,13,0,0,14,0,0
"Indonesia","2024-05-27",0,0,13,0,0,14,0,0
"Indonesia","2024-05-28",0,0,13,0,0,14,0,0
"Indonesia","2024-05-29",0,0,13,0,0,14,0,0
"Indonesia","2024-05-30",0,0,13,0,0,14,0,0
"Indonesia","2024-05-31",0,1,14,0,0,14,0,0
"Indonesia","2024-06-01",0,0,14,0,0,14,0,0
"Indonesia","2024-06-02",0,0,14,0,0,14,0,0
"Indonesia","2024-06-03",0,0,14,0,0,14,0,0
"Indonesia","2024-06-04",0,0,14,0,0,14,0,0
"Indonesia","2024-06-05",0,0,14,0,0,14,0,0
"Indonesia","2024-06-06",0,0,14,0,0,14,0,0
"Indonesia","2024-06-07",0,0,14,0,0,14,0,0
"Indonesia","2024-06-08",0,0,14,0,0,14,0,0
"Indonesia","2024-06-09",0,0,14,0,0,14,0,0
"Indonesia","2024-06-10",0,0,14,0,0,14,0,0
"Indonesia","2024-06-11",0,0,14,0,0,14,0,0
"Indonesia","2024-06-12",0,0,14,0,0,14,0,0
"Indonesia","2024-06-13",0,0,14,0,0,14,0,0
"Indonesia","2024-06-14",0,0,14,0,0,14,0,0
"Indonesia","2024-06-15",0,0,14,0,0,14,0,0
"Indonesia","2024-06-16",0,0,14,0,1,15,0,0
"Indonesia","2024-06-17",0,0,14,0,0,15,0,0
"Indonesia","2024-06-18",0,0,14,0,0,15,0,0
"Indonesia","2024-06-19",0,0,14,0,0,15,0,0
"Indonesia","2024-06-20",0,0,14,0,0,15,0,0
"Indonesia","2024-06-21",0,0,14,0,0,15,0,0
"Indonesia","2024-06-22",0,0,14,0,0,15,0,0
"Indonesia","2024-06-23",0,0,14,0,0,15,0,0
"Indonesia","2024-06-24",0,0,14,0,0,15,0,0
"Indonesia","2024-06-25",0,0,14,0,0,15,0,0
"Indonesia","2024-06-26",0,0,14,0,0,15,0,0
"Indonesia","2024-06-27",0,0,14,0,0,15,0,0
"Indonesia","2024-06-28",0,0,14,0,0,15,0,0
"Indonesia","2024-06-29",0,0,14,0,0,15,0,0
"Indonesia","2024-06-30",0,1,15,0,0,15,0,0
"Indonesia","2024-07-01",0,0,15,0,0,15,0,0
"Indonesia","2024-07-02",0,0,15,0,0,15,0,0
"Indonesia","2024-07-03",0,0,15,0,0,15,0,0
"Indonesia","2024-07-04",0,0,15,0,0,15,0,0
"Indonesia","2024-07-05",0,0,15,0,0,15,0,0
"Indonesia","2024-07-06",0,0,15,0,0,15,0,0
"Indonesia","2024-07-07",0,0,15,0,0,15,0,0
"Indonesia","2024-07-08",0,0,15,0,0,15,0,0
"Indonesia","2024-07-09",0,0,15,0,0,15,0,0
"Indonesia","2024-07-10",0,0,15,0,0,15,0,0
"Indonesia","2024-07-11",0,0,15,0,0,15,0,0
"Indonesia","2024-07-12",0,0,15,0,0,15,0,0
"Indonesia","2024-07-13",0,0,15,0,0,15,0,0
"Indonesia","2024-07-14",0,0,15,0,0,15,0,0
"Indonesia","2024-07-15",0,0,15,0,0,15,0,0
"Indonesia","2024-07-16",0,0,15,0,0,15,0,0
"Indonesia","2024-07-17",0,0,15,0,0,15,0,0
"Indonesia","2024-07-18",0,0,15,0,0,15,0,0
"Indonesia","2024-07-19",0,0,15,0,0,15,0,0
"Indonesia","2024-07-20",0,0,15,0,0,15,0,0
"Indonesia","2024-07-21",0,0,15,0,0,15,0,0
"Indonesia","2024-07-22",0,0,15,0,0,15,0,0
"Indonesia","2024-07-23",0,0,15,0,0,15,0,0
"Indonesia","2024-07-24",0,0,15,0,0,15,0,0
"Indonesia","2024-07-25",0,0,15,0,0,15,0,0
"Indonesia","2024-07-26",0,0,15,0,0,15,0,0
"Indonesia","2024-07-27",0,0,15,0,0,15,0,0
"Indonesia","2024-07-28",0,0,15,0,0,15,0,0
"Indonesia","2024-07-29",0,0,15,0,0,15,0,0
"Indonesia","2024-07-30",0,0,15,0,0,15,0,0
"Indonesia","2024-07-31",0,0,15,0,0,15,0,0
"Indonesia","2024-08-01",0,0,15,0,0,15,0,0
"Indonesia","2024-08-02",0,0,15,0,0,15,0,0
"Indonesia","2024-08-03",0,0,15,0,0,15,0,0
"Indonesia","2024-08-04",0,0,15,0,0,15,0,0
"Indonesia","2024-08-05",0,0,15,0,0,15,0,0
"Indonesia","2024-08-06",0,0,15,0,0,15,0,0
"Indonesia","2024-08-07",0,0,15,0,0,15,0,0
"Indonesia","2024-08-08",0,0,15,0,0,15,0,0
"Indonesia","2024-08-09",0,0,15,0,0,15,0,0
"Indonesia","2024-08-10",0,0,15,0,0,15,0,0
"Indonesia","2024-08-11",0,0,15,0,0,15,0,0
"Indonesia","2024-08-12",0,0,15,0,0,15,0,0
"Indonesia","2024-08-13",0,0,15,0,0,15,0,0
"Indonesia","2024-08-14",0,0,15,0,0,15,0,0
"Indonesia","2024-08-15",0,0,15,0,0,15,0,0
"Indonesia","2024-08-16",0,0,15,0,0,15,0,0
"Indonesia","2024-08-17",0,0,15,0,0,15,0,0
"Indonesia","2024-08-18",0,0,15,0,0,15,0,0
"Indonesia","2024-08-19",0,0,15,0,0,15,0,0
"Indonesia","2024-08-20",0,0,15,0,0,15,0,0
"Indonesia","2024-08-21",0,0,15,0,0,15,0,0
"Indonesia","2024-08-22",0,0,15,0,0,15,0,0
"Indonesia","2024-08-23",0,0,15,0,0,15,0,0
"Indonesia","2024-08-24",0,0,15,0,0,15,0,0
"Indonesia","2024-08-25",0,0,15,0,0,15,0,0
"Indonesia","2024-08-26",0,0,15,0,0,15,0,0
"Indonesia","2024-08-27",0,0,15,0,0,15,0,0
"Indonesia","2024-08-28",0,0,15,0,0,15,0,0
"Indonesia","2024-08-29",0,0,15,0,0,15,0,0
"Indonesia","2024-08-30",0,0,15,0,0,15,0,0
"Indonesia","2024-08-31",0,0,15,0,0,15,0,0
"Indonesia","2024-09-01",0,0,15,0,0,15,0,0
"Indonesia","2024-09-02",0,0,15,0,0,15,0,0
"Indonesia","2024-09-03",0,0,15,0,0,15,0,0
"Indonesia","2024-09-04",0,0,15,0,0,15,0,0
"Indonesia","2024-09-05",0,0,15,0,0,15,0,0
"Indonesia","2024-09-06",0,0,15,0,0,15,0,0
"Indonesia","2024-09-07",0,0,15,0,0,15,0,0
"Indonesia","2024-09-08",0,0,15,0,0,15,0,0
"Indonesia","2024-09-09",0,0,15,0,0,15,0,0
"Indonesia","2024-09-10",0,0,15,0,0,15,0,0
"Indonesia","2024-09-11",0,0,15,0,0,15,0,0
"Indonesia","2024-09-12",0,0,15,0,0,15,0,0
"Indonesia","2024-09-13",0,0,15,0,0,15,0,0
"Indonesia","2024-09-14",0,0,15,0,0,15,0,0
"Indonesia","2024-09-15",0,0,15,0,0,15,0,0
"Indonesia","2024-09-16",0,0,15,0,0,15,0,0
"Indonesia","2024-09-17",0,0,15,0,0,15,0,0
"Indonesia","2024-09-18",0,0,15,0,0,15,0,0
"Indonesia","2024-09-19",0,0,15,0,0,15,0,0
"Indonesia","2024-09-20",0,0,15,0,0,15,0,0
"Indonesia","2024-09-21",0,0,15,0,0,15,0,0
"Indonesia","2024-09-22",0,0,15,0,0,15,0,0
"Indonesia","2024-09-23",0,0,15,0,0,15,0,0
"Indonesia","2024-09-24",0,0,15,0,0,15,0,0
"Indonesia","2024-09-25",0,0,15,0,0,15,0,0
"Indonesia","2024-09-26",0,0,15,0,0,15,0,0
"Indonesia","2024-09-27",0,0,15,0,0,15,0,0
"Indonesia","2024-09-28",0,0,15,0,0,15,0,0
"Indonesia","2024-09-29",0,0,15,0,0,15,0,0
"Indonesia","2024-09-30",0,0,15,0,0,15,0,0
"Indonesia","2024-10-01",0,0,15,0,0,15,0,0
"Indonesia","2024-10-02",0,0,15,0,0,15,0,0
"Indonesia","2024-10-03",0,0,15,0,0,15,0,0
"Indonesia","2024-10-04",0,0,15,0,0,15,0,0
"Indonesia","2024-10-05",0,0,15,0,0,15,0,0
"Indonesia","2024-10-06",0,0,15,0,0,15,0,0
"Indonesia","2024-10-07",0,0,15,0,0,15,0,0
"Indonesia","2024-10-08",0,0,15,0,0,15,0,0
"Indonesia","2024-10-09",0,0,15,0,0,15,0,0
"Indonesia","2024-10-10",0,0,15,0,0,15,0,0
"Indonesia","2024-10-11",0,0,15,0,0,15,0,0
"Indonesia","2024-10-12",0,0,15,0,0,15,0,0
"Indonesia","2024-10-13",0,0,15,0,0,15,0,0
"Indonesia","2024-10-14",0,0,15,0,0,15,0,0
"Indonesia","2024-10-15",0,0,15,0,0,15,0,0
"Indonesia","2024-10-16",0,0,15,0,0,15,0,0
"Indonesia","2024-10-17",0,0,15,0,0,15,0,0
"Indonesia","2024-10-18",0,0,15,0,0,15,0,0
"Indonesia","2024-10-19",0,0,15,0,0,15,0,0
"Indonesia","2024-10-20",0,0,15,0,0,15,0,0
"Indonesia","2024-10-21",0,0,15,0,0,15,0,0
"Indonesia","2024-10-22",0,0,15,0,0,15,0,0
"Indonesia","2024-10-23",0,0,15,0,0,15,0,0
"Indonesia","2024-10-24",0,0,15,0,0,15,0,0
"Indonesia","2024-10-25",0,0,15,0,0,15,0,0
"Indonesia","2024-10-26",0,0,15,0,0,15,0,0
"Indonesia","2024-10-27",0,0,15,0,0,15,0,0
"Indonesia","2024-10-28",0,0,15,0,0,15,0,0
"Indonesia","2024-10-29",0,0,15,0,0,15,0,0
"Indonesia","2024-10-30",0,0,15,0,0,15,0,0
"Indonesia","2024-10-31",0,0,15,0,0,15,0,0
"Indonesia","2024-11-01",0,0,15,0,0,15,0,0
"Indonesia","2024-11-02",0,0,15,0,0,15,0,0
"Indonesia","2024-11-03",0,0,15,0,0,15,0,0
"Indonesia","2024-11-04",0,0,15,0,0,15,0,0
"Indonesia","2024-11-05",0,0,15,0,0,15,0,0
"Indonesia","2024-11-06",0,0,15,0,0,15,0,0
"Indonesia","2024-11-07",0,0,15,0,0,15,0,0
"Indonesia","2024-11-08",0,0,15,0,0,15,0,0
"Indonesia","2024-11-09",0,0,15,0,0,15,0,0
"Indonesia","2024-11-10",0,0,15,0,0,15,0,0
"Indonesia","2024-11-11",0,0,15,0,0,15,0,0
"Indonesia","2024-11-12",0,0,15,0,0,15,0,0
"Indonesia","2024-11-13",0,0,15,0,0,15,0,0
"Indonesia","2024-11-14",0,0,15,0,0,15,0,0
"Indonesia","2024-11-15",0,0,15,0,0,15,0,0
"Indonesia","2024-11-16",0,0,15,0,0,15,0,0
"Indonesia","2024-11-17",0,0,15,0,0,15,0,0
"Indonesia","2024-11-18",0,0,15,0,0,15,0,0
"Indonesia","2024-11-19",0,0,15,0,0,15,0,0
"Indonesia","2024-11-20",0,0,15,0,0,15,0,0
"Indonesia","2024-11-21",0,0,15,0,0,15,0,0
"Indonesia","2024-11-22",0,0,15,0,0,15,0,0
"Indonesia","2024-11-23",0,0,15,0,0,15,0,0
"Indonesia","2024-11-24",0,0,15,0,0,15,0,0
"Indonesia","2024-11-25",0,0,15,0,0,15,0,0
"Indonesia","2024-11-26",0,0,15,0,0,15,0,0
"Indonesia","2024-11-27",0,0,15,0,0,15,0,0
"Indonesia","2024-11-28",0,0,15,0,0,15,0,0
"Indonesia","2024-11-29",0,0,15,0,0,15,0,0
"Indonesia","2024-11-30",0,0,15,0,0,15,0,0
"Indonesia","2024-12-01",0,0,15,0,0,15,0,0
"Indonesia","2024-12-02",0,0,15,0,0,15,0,0
"Indonesia","2024-12-03",0,0,15,0,0,15,0,0
"Indonesia","2024-12-04",0,0,15,0,0,15,0,0
"Indonesia","2024-12-05",0,0,15,0,0,15,0,0
"Indonesia","2024-12-06",0,0,15,0,0,15,0,0
"Indonesia","2024-12-07",0,0,15,0,0,15,0,0
"Indonesia","2024-12-08",0,0,15,0,0,15,0,0
"Indonesia","2024-12-09",0,0,15,0,0,15,0,0
"Indonesia","2024-12-10",0,0,15,0,0,15,0,0
"Indonesia","2024-12-11",0,0,15,0,0,15,0,0
"Indonesia","2024-12-12",0,0,15,0,0,15,0,0
"Indonesia","2024-12-13",0,0,15,0,0,15,0,0
"Indonesia","2024-12-14",0,0,15,0,0,15,0,0
"Indonesia","2024-12-15",0,0,15,0,0,15,0,0
"Indonesia","2024-12-16",0,0,15,0,0,15,0,0
"Indonesia","2024-12-17",0,0,15,0,0,15,0,0
"Indonesia","2024-12-18",0,0,15,0,0,15,0,0
"Indonesia","2024-12-19",0,0,15,0,0,15,0,0
"Indonesia","2024-12-20",0,0,15,0,0,15,0,0
"Indonesia","2024-12-21",0,0,15,0,0,15,0,0
"Indonesia","2024-12-22",0,0,15,0,0,15,0,0
"Indonesia","2024-12-23",0,0,15,0,0,15,0,0
"Indonesia","2024-12-24",0,0,15,0,0,15,0,0
"Indonesia","2024-12-25",0,0,15,0,0,15,0,0
"Indonesia","2024-12-26",0,0,15,0,0,15,0,0
"Indonesia","2024-12-27",0,0,15,0,0,15,0,0
"Indonesia","2024-12-28",0,0,15,0,0,15,0,0
"Indonesia","2024-12-29",0,0,15,0,0,15,0,0
"Indonesia","2024-12-30",0,0,15,0,0,15,0,0
"Indonesia","2024-12-31",0,0,15,0,0,15,0,0
"Indonesia","2025-01-01",0,0,15,0,0,15,0,0
"Indonesia","2025-01-02",0,0,15,0,0,15,0,0
"Indonesia","2025-01-03",0,0,15,0,0,15,0,0
"Indonesia","2025-01-04",0,0,15,0,0,15,0,0
"Indonesia","2025-01-05",0,0,15,0,0,15,0,0
"Indonesia","2025-01-06",0,0,15,0,0,15,0,0
"Indonesia","2025-01-07",0,0,15,0,0,15,0,0
"Indonesia","2025-01-08",0,0,15,0,0,15,0,0
"Indonesia","2025-01-09",0,0,15,0,0,15,0,0
"Indonesia","2025-01-10",0,0,15,0,0,15,0,0
"Indonesia","2025-01-11",0,0,15,0,0,15,0,0
"Indonesia","2025-01-12",0,0,15,0,0,15,0,0
"Indonesia","2025-01-13",0,0,15,0,0,15,0,0
"Indonesia","2025-01-14",0,0,15,0,0,15,0,0
"Indonesia","2025-01-15",0,0,15,0,0,15,0,0
"Indonesia","2025-01-16",0,0,15,0,0,15,0,0
"Indonesia","2025-01-17",0,0,15,0,0,15,0,0
"Indonesia","2025-01-18",0,0,15,0,0,15,0,0
"Indonesia","2025-01-19",0,0,15,0,0,15,0,0
"Indonesia","2025-01-20",0,0,15,0,0,15,0,0
"Indonesia","2025-01-21",0,0,15,0,0,15,0,0
"Indonesia","2025-01-22",0,0,15,0,0,15,0,0
"Indonesia","2025-01-23",0,0,15,0,0,15,0,0
"Indonesia","2025-01-24",0,0,15,0,0,15,0,0
"Indonesia","2025-01-25",0,0,15,0,0,15,0,0
"Indonesia","2025-01-26",0,0,15,0,0,15,0,0
"Indonesia","2025-01-27",0,0,15,0,0,15,0,0
"Indonesia","2025-01-28",0,0,15,0,0,15,0,0
"Indonesia","2025-01-29",0,0,15,0,0,15,0,0
"Indonesia","2025-01-30",0,0,15,0,0,15,0,0
"Indonesia","2025-01-31",0,0,15,0,0,15,0,0
"Indonesia","2025-02-01",0,0,15,0,0,15,0,0
"Indonesia","2025-02-02",0,0,15,0,0,15,0,0
"Indonesia","2025-02-03",0,0,15,0,0,15,0,0
"Indonesia","2025-02-04",0,0,15,0,0,15,0,0
"Indonesia","2025-02-05",0,0,15,0,0,15,0,0
"Indonesia","2025-02-06",0,0,15,0,0,15,0,0
"Indonesia","2025-02-07",0,0,15,0,0,15,0,0
"Indonesia","2025-02-08",0,0,15,0,0,15,0,0
"Indonesia","2025-02-09",0,0,15,0,0,15,0,0
"Indonesia","2025-02-10",0,0,15,0,0,15,0,0
"Indonesia","2025-02-11",0,0,15,0,0,15,0,0
"Indonesia","2025-02-12",0,0,15,0,0,15,0,0
"Indonesia","2025-02-13",0,0,15,0,0,15,0,0
"Indonesia","2025-02-14",0,0,15,0,0,15,0,0
"Indonesia","2025-02-15",0,0,15,0,0,15,0,0
"Indonesia","2025-02-16",0,0,15,0,0,15,0,0
"Indonesia","2025-02-17",0,0,15,0,0,15,0,0
"Indonesia","2025-02-18",0,0,15,0,0,15,0,0
"Indonesia","2025-02-19",0,0,15,0,0,15,0,0
"Indonesia","2025-02-20",0,0,15,0,0,15,0,0
"Indonesia","2025-02-21",0,0,15,0,0,15,0,0
"Indonesia","2025-02-22",0,0,15,0,0,15,0,0
"Indonesia","2025-02-23",0,0,15,0,0,15,0,0
"Indonesia","2025-02-24",0,0,15,0,0,15,0,0
"Indonesia","2025-02-25",0,0,15,0,0,15,0,0
"Indonesia","2025-02-26",0,0,15,0,0,15,0,0
"Indonesia","2025-02-27",0,0,15,0,0,15,0,0
"Indonesia","2025-02-28",0,0,15,0,0,15,0,0
"Indonesia","2025-03-01",0,0,15,0,0,15,0,0
"Indonesia","2025-03-02",0,0,15,0,0,15,0,0
"Indonesia","2025-03-03",0,0,15,0,0,15,0,0
"Ireland","2024-01-01",0,0,0,0,0,0,0,0
"Ireland","2024-01-02",0,0,0,0,0,0,0,0
"Ireland","2024-01-03",0,0,0,0,0,0,0,0
"Ireland","2024-01-04",0,0,0,0,0,0,0,0
"Ireland","2024-01-05",0,0,0,0,0,0,0,0
"Ireland","2024-01-06",0,0,0,0,0,0,0,0
"Ireland","2024-01-07",0,0,0,0,0,0,0,0
"Ireland","2024-01-08",0,0,0,0,0,0,0,0
"Ireland","2024-01-09",0,0,0,0,0,0,0,0
"Ireland","2024-01-10",0,0,0,0,0,0,0,0
"Ireland","2024-01-11",0,0,0,0,0,0,0,0
"Ireland","2024-01-12",0,0,0,0,0,0,0,0
"Ireland","2024-01-13",0,0,0,0,0,0,0,0
"Ireland","2024-01-14",0,0,0,0,0,0,0,0
"Ireland","2024-01-15",0,0,0,0,0,0,0,0
"Ireland","2024-01-16",0,0,0,0,0,0,0,0
"Ireland","2024-01-17",0,0,0,0,0,0,0,0
"Ireland","2024-01-18",0,0,0,0,0,0,0,0
"Ireland","2024-01-19",0,0,0,0,0,0,0,0
"Ireland","2024-01-20",0,0,0,0,0,0,0,0
"Ireland","2024-01-21",0,0,0,0,0,0,0,0
"Ireland","2024-01-22",0,0,0,0,0,0,0,0
"Ireland","2024-01-23",0,0,0,0,0,0,0,0
"Ireland","2024-01-24",0,0,0,0,0,0,0,0
"Ireland","2024-01-25",0,0,0,0,0,0,0,0
"Ireland","2024-01-26",0,0,0,0,0,0,0,0
"Ireland","2024-01-27",0,0,0,0,0,0,0,0
"Ireland","2024-01-28",0,0,0,0,0,0,0,0
"Ireland","2024-01-29",0,0,0,0,0,0,0,0
"Ireland","2024-01-30",0,0,0,0,0,0,0,0
"Ireland","2024-01-31",0,0,0,0,0,0,0,0
"Ireland","2024-02-01",0,0,0,0,0,0,0,0
"Ireland","2024-02-02",0,0,0,0,0,0,0,0
"Ireland","2024-02-03",0,0,0,0,0,0,0,0
"Ireland","2024-02-04",0,0,0,0,0,0,0,0
"Ireland","2024-02-05",0,0,0,0,0,0,0,0
"Ireland","2024-02-06",0,0,0,0,0,0,0,0
"Ireland","2024-02-07",0,0,0,0,0,0,0,0
"Ireland","2024-02-08",0,0,0,0,0,0,0,0
"Ireland","2024-02-09",0,0,0,0,0,0,0,0
"Ireland","2024-02-10",0,0,0,0,0,0,0,0
"Ireland","2024-02-11",0,0,0,0,0,0,0,0
"Ireland","2024-02-12",0,0,0,0,0,0,0,0
"Ireland","2024-02-13",0,0,0,0,0,0,0,0
"Ireland","2024-02-14",0,0,0,0,0,0,0,0
"Ireland","2024-02-15",0,0,0,0,0,0,0,0
"Ireland","2024-02-16",0,0,0,0,0,0,0,0
"Ireland","2024-02-17",0,0,0,0,0,0,0,0
"Ireland","2024-02-18",0,0,0,0,0,0,0,0
"Ireland","2024-02-19",0,0,0,0,0,0,0,0
"Ireland","2024-02-20",0,0,0,0,0,0,0,0
"Ireland","2024-02-21",0,0,0,0,0,0,0,0
"Ireland","2024-02-22",0,0,0,0,0,0,0,0
"Ireland","2024-02-23",0,0,0,0,0,0,0,0
"Ireland","2024-02-24",0,0,0,0,0,0,0,0
"Ireland","2024-02-25",0,0,0,0,0,0,0,0
"Ireland","2024-02-26",0,0,0,0,0,0,0,0
"Ireland","2024-02-27",0,0,0,0,0,0,0,0
"Ireland","2024-02-28",0,0,0,0,0,0,0,0
"Ireland","2024-02-29",0,1,1,0,1,1,0,0
"Ireland","2024-03-01",0,0,1,0,0,1,0,0
"Ireland","2024-03-02",0,0,1,0,0,1,0,0
"Ireland","2024-03-03",0,0,1,0,0,1,0,0
"Ireland","2024-03-04",0,0,1,0,0,1,0,0
"Ireland","2024-03-05",0,0,1,0,0,1,0,0
"Ireland","2024-03-06",0,0,1,0,0,1,0,0
"Ireland","2024-03-07",0,0,1,0,0,1,0,0
"Ireland","2024-03-08",0,0,1,0,0,1,0,0
"Ireland","2024-03-09",0,0,1,0,0,1,0,0
"Ireland","2024-03-10",0,0,1,0,0,1,0,0
"Ireland","2024-03-11",0,0,1,0,0,1,0,0
"Ireland","2024-03-12",0,0,1,0,0,1,0,0
"Ireland","2024-03-13",0,0,1,0,0,1,0,0
"Ireland","2024-03-14",0,0,1,0,0,1,0,0
"Ireland","2024-03-15",0,0,1,0,0,1,0,0
"Ireland","2024-03-16",0,0,1,0,0,1,0,0
"Ireland","2024-03-17",0,0,1,0,0,1,0,0
"Ireland","2024-03-18",0,0,1,0,0,1,0,0
"Ireland","2024-03-19",0,0,1,0,0,1,0,0
"Ireland","2024-03-20",0,0,1,0,0,1,0,0
"Ireland","2024-03-21",0,0,1,0,0,1,0,0
"Ireland","2024-03-22",0,0,1,0,0,1,0,0
"Ireland","2024-03-23",0,0,1,0,0,1,0,0
"Ireland","2024-03-24",0,0,1,0,0,1,0,0
"Ireland","2024-03-25",0,0,1,0,0,1,0,0
"Ireland","2024-03-26",0,0,1,0,0,1,0,0
"Ireland","2024-03-27",0,0,1,0,0,1,0,0
"Ireland","2024-03-28",0,0,1,0,0,1,0,0
"Ireland","2024-03-29",0,0,1,0,0,1,0,0
"Ireland","2024-03-30",0,0,1,0,0,1,0,0
"Ireland","2024-03-31",0,0,1,0,1,2,0,0
"Ireland","2024-04-01",0,0,1,0,0,2,0,0
"Ireland","2024-04-02",0,0,1,0,0,2,0,0
"Ireland","2024-04-03",0,0,1,0,0,2,0,0
"Ireland","2024-04-04",0,0,1,0,0,2,0,0
"Ireland","2024-04-05",0,0,1,0,0,2,0,0
"Ireland","2024-04-06",0,0,1,0,0,2,0,0
"Ireland","2024-04-07",0,0,1,0,0,2,0,0
"Ireland","2024-04-08",0,0,1,0,0,2,0,0
"Ireland","2024-04-09",0,0,1,0,0,2,0,0
"Ireland","2024-04-10",0,0,1,0,0,2,0,0
"Ireland","2024-04-11",0,0,1,0,0,2,0,0
"Ireland","2024-04-12",0,0,1,0,0,2,0,0
"Ireland","2024-04-13",0,0,1,0,0,2,0,0
"Ireland","2024-04-14",0,0,1,0,0,2,0,0
"Ireland","2024-04-15",0,0,1,0,0,2,0,0
"Ireland","2024-04-16",0,0,1,0,0,2,0,0
"Ireland","2024-04-17",0,0,1,0,0,2,0,0
"Ireland","2024-04-18",0,0,1,0,0,2,0,0
"Ireland","2024-04-19",0,0,1,0,0,2,0,0
"Ireland","2024-04-20",0,0,1,0,0,2,0,0
"Ireland","2024-04-21",0,0,1,0,0,2,0,0
"Ireland","2024-04-22",0,0,1,0,0,2,0,0
"Ireland","2024-04-23",0,0,1,0,0,2,0,0
"Ireland","2024-04-24",0,0,1,0,0,2,0,0
"Ireland","2024-04-25",0,0,1,0,0,2,0,0
"Ireland","2024-04-26",0,0,1,0,0,2,0,0
"Ireland","2024-04-27",0,0,1,0,0,2,0,0
"Ireland","2024-04-28",0,0,1,0,0,2,0,0
"Ireland","2024-04-29",0,0,1,0,0,2,0,0
"Ireland","2024-04-30",0,1,2,0,0,2,0,0
"Ireland","2024-05-01",0,0,2,0,0,2,0,0
"Ireland","2024-05-02",0,0,2,0,0,2,0,0
"Ireland","2024-05-03",0,0,2,0,0,2,0,0
"Ireland","2024-05-04",0,0,2,0,0,2,0,0
"Ireland","2024-05-05",0,0,2,0,0,2,0,0
"Ireland","2024-05-06",0,0,2,0,0,2,0,0
"Ireland","2024-05-07",0,0,2,0,0,2,0,0
"Ireland","2024-05-08",0,0,2,0,0,2,0,0
"Ireland","2024-05-09",0,0,2,0,0,2,0,0
"Ireland","2024-05-10",0,0,2,0,0,2,0,0
"Ireland","2024-05-11",0,0,2,0,0,2,0,0
"Ireland","2024-05-12",0,0,2,0,0,2,0,0
"Ireland","2024-05-13",0,0,2,0,0,2,0,0
"Ireland","2024-05-14",0,0,2,0,0,2,0,0
"Ireland","2024-05-15",0,0,2,0,0,2,0,0
"Ireland","2024-05-16",0,0,2,0,1,3,0,0
"Ireland","2024-05-17",0,0,2,0,0,3,0,0
"Ireland","2024-05-18",0,0,2,0,0,3,0,0
"Ireland","2024-05-19",0,0,2,0,0,3,0,0
"Ireland","2024-05-20",0,0,2,0,0,3,0,0
"Ireland","2024-05-21",0,0,2,0,0,3,0,0
"Ireland","2024-05-22",0,0,2,0,0,3,0,0
"Ireland","2024-05-23",0,0,2,0,0,3,0,0
"Ireland","2024-05-24",0,0,2,0,0,3,0,0
"Ireland","2024-05-25",0,0,2,0,0,3,0,0
"Ireland","2024-05-26",0,0,2,0,0,3,0,0
"Ireland","2024-05-27",0,0,2,0,0,3,0,0
"Ireland","2024-05-28",0,0,2,0,0,3,0,0
"Ireland","2024-05-29",0,0,2,0,0,3,0,0
"Ireland","2024-05-30",0,0,2,0,0,3,0,0
"Ireland","2024-05-31",0,1,3,0,0,3,0,0
"Ireland","2024-06-01",0,0,3,0,0,3,0,0
"Ireland","2024-06-02",0,0,3,0,0,3,0,0
"Ireland","2024-06-03",0,0,3,0,0,3,0,0
"Ireland","2024-06-04",0,0,3,0,0,3,0,0
"Ireland","2024-06-05",0,0,3,0,0,3,0,0
"Ireland","2024-06-06",0,0,3,0,0,3,0,0
"Ireland","2024-06-07",0,0,3,0,0,3,0,0
"Ireland","2024-06-08",0,0,3,0,1,4,0,0
"Ireland","2024-06-09",0,0,3,0,0,4,0,0
"Ireland","2024-06-10",0,0,3,0,0,4,0,0
"Ireland","2024-06-11",0,0,3,0,0,4,0,0
"Ireland","2024-06-12",0,0,3,0,0,4,0,0
"Ireland","2024-06-13",0,0,3,0,0,4,0,0
"Ireland","2024-06-14",0,0,3,0,0,4,0,0
"Ireland","2024-06-15",0,0,3,0,0,4,0,0
"Ireland","2024-06-16",0,0,3,0,0,4,0,0
"Ireland","2024-06-17",0,0,3,0,0,4,0,0
"Ireland","2024-06-18",0,0,3,0,0,4,0,0
"Ireland","2024-06-19",0,0,3,0,0,4,0,0
"Ireland","2024-06-20",0,0,3,0,0,4,0,0
"Ireland","2024-06-21",0,0,3,0,0,4,0,0
"Ireland","2024-06-22",0,0,3,0,0,4,0,0
"Ireland","2024-06-23",0,0,3,0,1,5,0,0
"Ireland","2024-06-24",0,0,3,0,0,5,0,0
"Ireland","2024-06-25",0,0,3,0,0,5,0,0
"Ireland","2024-06-26",0,0,3,0,0,5,0,0
"Ireland","2024-06-27",0,0,3,0,0,5,0,0
"Ireland","2024-06-28",0,0,3,0,0,5,0,0
"Ireland","2024-06-29",0,0,3,0,0,5,0,0
"Ireland","2024-06-30",0,2,5,0,0,5,0,0
"Ireland","2024-07-01",0,0,5,0,0,5,0,0
"Ireland","2024-07-02",0,0,5,0,0,5,0,0
"Ireland","2024-07-03",0,0,5,0,0,5,0,0
"Ireland","2024-07-04",0,0,5,0,0,5,0,0
"Ireland","2024-07-05",0,0,5,0,0,5,0,0
"Ireland","2024-07-06",0,0,5,0,0,5,0,0
"Ireland","2024-07-07",0,0,5,0,0,5,0,0
"Ireland","2024-07-08",0,0,5,0,0,5,0,0
"Ireland","2024-07-09",0,0,5,0,0,5,0,0
"Ireland","2024-07-10",0,0,5,0,0,5,0,0
"Ireland","2024-07-11",0,0,5,0,0,5,0,0
"Ireland","2024-07-12",0,0,5,0,0,5,0,0
"Ireland","2024-07-13",0,0,5,0,0,5,0,0
"Ireland","2024-07-14",0,0,5,0,0,5,0,0
"Ireland","2024-07-15",0,0,5,0,0,5,0,0
"Ireland","2024-07-16",0,0,5,0,0,5,0,0
"Ireland","2024-07-17",0,0,5,0,0,5,0,0
"Ireland","2024-07-18",0,0,5,0,0,5,0,0
"Ireland","2024-07-19",0,0,5,0,0,5,0,0
"Ireland","2024-07-20",0,0,5,0,0,5,0,0
"Ireland","2024-07-21",0,0,5,0,0,5,0,0
"Ireland","2024-07-22",0,0,5,0,0,5,0,0
"Ireland","2024-07-23",0,0,5,0,0,5,0,0
"Ireland","2024-07-24",0,0,5,0,0,5,0,0
"Ireland","2024-07-25",0,0,5,0,0,5,0,0
"Ireland","2024-07-26",0,0,5,0,0,5,0,0
"Ireland","2024-07-27",0,0,5,0,0,5,0,0
"Ireland","2024-07-28",0,0,5,0,0,5,0,0
"Ireland","2024-07-29",0,0,5,0,0,5,0,0
"Ireland","2024-07-30",0,0,5,0,0,5,0,0
"Ireland","2024-07-31",0,0,5,0,0,5,0,0
"Ireland","2024-08-01",0,0,5,0,1,6,0,0
"Ireland","2024-08-02",0,0,5,0,0,6,0,0
"Ireland","2024-08-03",0,0,5,0,0,6,0,0
"Ireland","2024-08-04",0,0,5,0,0,6,0,0
"Ireland","2024-08-05",0,0,5,0,0,6,0,0
"Ireland","2024-08-06",0,0,5,0,0,6,0,0
"Ireland","2024-08-07",0,0,5,0,0,6,0,0
"Ireland","2024-08-08",0,0,5,0,0,6,0,0
"Ireland","2024-08-09",0,0,5,0,0,6,0,0
"Ireland","2024-08-10",0,0,5,0,0,6,0,0
"Ireland","2024-08-11",0,0,5,0,0,6,0,0
"Ireland","2024-08-12",0,0,5,0,0,6,0,0
"Ireland","2024-08-13",0,0,5,0,0,6,0,0
"Ireland","2024-08-14",0,0,5,0,0,6,0,0
"Ireland","2024-08-15",0,0,5,0,0,6,0,0
"Ireland","2024-08-16",0,0,5,0,0,6,0,0
"Ireland","2024-08-17",0,0,5,0,0,6,0,0
"Ireland","2024-08-18",0,0,5,0,0,6,0,0
"Ireland","2024-08-19",0,0,5,0,0,6,0,0
"Ireland","2024-08-20",0,0,5,0,0,6,0,0
"Ireland","2024-08-21",0,0,5,0,0,6,0,0
"Ireland","2024-08-22",0,0,5,0,0,6,0,0
"Ireland","2024-08-23",0,0,5,0,0,6,0,0
"Ireland","2024-08-24",0,0,5,0,0,6,0,0
"Ireland","2024-08-25",0,0,5,0,0,6,0,0
"Ireland","2024-08-26",0,0,5,0,0,6,0,0
"Ireland","2024-08-27",0,0,5,0,0,6,0,0
"Ireland","2024-08-28",0,0,5,0,0,6,0,0
"Ireland","2024-08-29",0,0,5,0,0,6,0,0
"Ireland","2024-08-30",0,0,5,0,0,6,0,0
"Ireland","2024-08-31",0,1,6,0,0,6,0,0
"Ireland","2024-09-01",0,0,6,0,0,6,0,0
"Ireland","2024-09-02",0,0,6,0,0,6,0,0
"Ireland","2024-09-03",0,0,6,0,0,6,0,0
"Ireland","2024-09-04",0,0,6,0,0,6,0,0
"Ireland","2024-09-05",0,0,6,0,0,6,0,0
"Ireland","2024-09-06",0,0,6,0,1,7,0,0
"Ireland","2024-09-07",0,0,6,0,0,7,0,0
"Ireland","2024-09-08",0,0,6,0,0,7,0,0
"Ireland","2024-09-09",0,0,6,0,0,7,0,0
"Ireland","2024-09-10",0,0,6,0,0,7,0,0
"Ireland","2024-09-11",0,0,6,0,0,7,0,0
"Ireland","2024-09-12",0,0,6,0,0,7,0,0
"Ireland","2024-09-13",0,0,6,0,0,7,0,0
"Ireland","2024-09-14",0,0,6,0,0,7,0,0
"Ireland","2024-09-15",0,0,6,0,1,8,0,0
"Ireland","2024-09-16",0,0,6,0,0,8,0,0
"Ireland","2024-09-17",0,0,6,0,0,8,0,0
"Ireland","2024-09-18",0,0,6,0,0,8,0,0
"Ireland","2024-09-19",0,0,6,0,0,8,0,0
"Ireland","2024-09-20",0,0,6,0,0,8,0,0
"Ireland","2024-09-21",0,0,6,0,0,8,0,0
"Ireland","2024-09-22",0,0,6,0,0,8,0,0
"Ireland","2024-09-23",0,0,6,0,0,8,0,0
"Ireland","2024-09-24",0,0,6,0,0,8,0,0
"Ireland","2024-09-25",0,0,6,0,0,8,0,0
"Ireland","2024-09-26",0,0,6,0,1,9,0,0
"Ireland","2024-09-27",0,0,6,0,0,9,0,0
"Ireland","2024-09-28",0,0,6,0,0,9,0,0
"Ireland","2024-09-29",0,0,6,0,0,9,0,0
"Ireland","2024-09-30",0,3,9,0,0,9,0,0
"Ireland","2024-10-01",0,0,9,0,0,9,0,0
"Ireland","2024-10-02",0,0,9,0,1,10,0,0
"Ireland","2024-10-03",0,0,9,0,0,10,0,0
"Ireland","2024-10-04",0,0,9,0,0,10,0,0
"Ireland","2024-10-05",0,0,9,0,0,10,0,0
"Ireland","2024-10-06",0,0,9,0,1,11,0,0
"Ireland","2024-10-07",0,0,9,0,0,11,0,0
"Ireland","2024-10-08",0,0,9,0,0,11,0,0
"Ireland","2024-10-09",0,0,9,0,0,11,0,0
"Ireland","2024-10-10",0,0,9,0,1,12,0,0
"Ireland","2024-10-11",0,0,9,0,0,12,0,0
"Ireland","2024-10-12",0,0,9,0,0,12,0,0
"Ireland","2024-10-13",0,0,9,0,0,12,0,0
"Ireland","2024-10-14",0,0,9,0,1,13,0,0
"Ireland","2024-10-15",0,0,9,0,0,13,0,0
"Ireland","2024-10-16",0,0,9,0,0,13,0,0
"Ireland","2024-10-17",0,0,9,0,0,13,0,0
"Ireland","2024-10-18",0,0,9,0,1,14,0,0
"Ireland","2024-10-19",0,0,9,0,0,14,0,0
"Ireland","2024-10-20",0,0,9,0,0,14,0,0
"Ireland","2024-10-21",0,0,9,0,0,14,0,0
"Ireland","2024-10-22",0,0,9,0,1,15,0,0
"Ireland","2024-10-23",0,0,9,0,0,15,0,0
"Ireland","2024-10-24",0,0,9,0,0,15,0,0
"Ireland","2024-10-25",0,0,9,0,0,15,0,0
"Ireland","2024-10-26",0,0,9,0,1,16,0,0
"Ireland","2024-10-27",0,0,9,0,0,16,0,0
"Ireland","2024-10-28",0,0,9,0,0,16,0,0
"Ireland","2024-10-29",0,0,9,0,0,16,0,0
"Ireland","2024-10-30",0,0,9,0,1,17,0,0
"Ireland","2024-10-31",0,8,17,0,0,17,0,0
"Ireland","2024-11-01",0,0,17,0,0,17,0,0
"Ireland","2024-11-02",0,0,17,0,0,17,0,0
"Ireland","2024-11-03",0,0,17,0,0,17,0,0
"Ireland","2024-11-04",0,0,17,0,1,18,0,0
"Ireland","2024-11-05",0,0,17,0,0,18,0,0
"Ireland","2024-11-06",0,0,17,0,0,18,0,0
"Ireland","2024-11-07",0,0,17,0,0,18,0,0
"Ireland","2024-11-08",0,0,17,0,0,18,0,0
"Ireland","2024-11-09",0,0,17,0,0,18,0,0
"Ireland","2024-11-10",0,0,17,0,0,18,0,0
"Ireland","2024-11-11",0,0,17,0,0,18,0,0
"Ireland","2024-11-12",0,0,17,0,1,19,0,0
"Ireland","2024-11-13",0,0,17,0,0,19,0,0
"Ireland","2024-11-14",0,0,17,0,0,19,0,0
"Ireland","2024-11-15",0,0,17,0,0,19,0,0
"Ireland","2024-11-16",0,0,17,0,0,19,0,0
"Ireland","2024-11-17",0,0,17,0,0,19,0,0
"Ireland","2024-11-18",0,0,17,0,0,19,0,0
"Ireland","2024-11-19",0,0,17,0,1,20,0,0
"Ireland","2024-11-20",0,0,17,0,0,20,0,0
"Ireland","2024-11-21",0,0,17,0,0,20,0,0
"Ireland","2024-11-22",0,0,17,0,0,20,0,0
"Ireland","2024-11-23",0,0,17,0,0,20,0,0
"Ireland","2024-11-24",0,0,17,0,0,20,0,0
"Ireland","2024-11-25",0,0,17,0,0,20,0,0
"Ireland","2024-11-26",0,0,17,0,0,20,0,0
"Ireland","2024-11-27",0,0,17,0,1,21,0,0
"Ireland","2024-11-28",0,0,17,0,0,21,0,0
"Ireland","2024-11-29",0,0,17,0,0,21,0,0
"Ireland","2024-11-30",0,4,21,0,0,21,0,0
"Ireland","2024-12-01",0,0,21,0,0,21,0,0
"Ireland","2024-12-02",0,0,21,0,0,21,0,0
"Ireland","2024-12-03",0,0,21,0,0,21,0,0
"Ireland","2024-12-04",0,0,21,0,1,22,0,0
"Ireland","2024-12-05",0,0,21,0,0,22,0,0
"Ireland","2024-12-06",0,0,21,0,0,22,0,0
"Ireland","2024-12-07",0,0,21,0,0,22,0,0
"Ireland","2024-12-08",0,0,21,0,0,22,0,0
"Ireland","2024-12-09",0,0,21,0,0,22,0,0
"Ireland","2024-12-10",0,0,21,0,1,23,0,0
"Ireland","2024-12-11",0,0,21,0,0,23,0,0
"Ireland","2024-12-12",0,0,21,0,0,23,0,0
"Ireland","2024-12-13",0,0,21,0,0,23,0,0
"Ireland","2024-12-14",0,0,21,0,0,23,0,0
"Ireland","2024-12-15",0,0,21,0,0,23,0,0
"Ireland","2024-12-16",0,0,21,0,1,24,0,0
"Ireland","2024-12-17",0,0,21,0,0,24,0,0
"Ireland","2024-12-18",0,0,21,0,0,24,0,0
"Ireland","2024-12-19",0,0,21,0,0,24,0,0
"Ireland","2024-12-20",0,0,21,0,0,24,0,0
"Ireland","2024-12-21",0,0,21,0,0,24,0,0
"Ireland","2024-12-22",0,0,21,0,1,25,0,0
"Ireland","2024-12-23",0,0,21,0,0,25,0,0
"Ireland","2024-12-24",0,0,21,0,0,25,0,0
"Ireland","2024-12-25",0,0,21,0,0,25,0,0
"Ireland","2024-12-26",0,0,21,0,0,25,0,0
"Ireland","2024-12-27",0,0,21,0,0,25,0,0
"Ireland","2024-12-28",0,0,21,0,1,26,0,0
"Ireland","2024-12-29",0,0,21,0,0,26,0,0
"Ireland","2024-12-30",0,0,21,0,0,26,0,0
"Ireland","2024-12-31",0,5,26,0,0,26,0,0
"Ireland","2025-01-01",0,0,26,0,1,27,0,0
"Ireland","2025-01-02",0,0,26,0,1,28,0,0
"Ireland","2025-01-03",0,0,26,0,1,29,0,0
"Ireland","2025-01-04",0,0,26,0,1,30,0,0
"Ireland","2025-01-05",0,0,26,0,0,30,0,0
"Ireland","2025-01-06",0,0,26,0,1,31,0,0
"Ireland","2025-01-07",0,0,26,0,1,32,0,0
"Ireland","2025-01-08",0,0,26,0,1,33,0,0
"Ireland","2025-01-09",0,0,26,0,1,34,0,0
"Ireland","2025-01-10",0,9,35,0,1,35,0,0
"Ireland","2025-01-11",0,0,35,0,0,35,0,0
"Ireland","2025-01-12",0,0,35,0,0,35,0,0
"Ireland","2025-01-13",0,0,35,0,0,35,0,0
"Ireland","2025-01-14",0,0,35,0,0,35,0,0
"Ireland","2025-01-15",0,0,35,0,0,35,0,0
"Ireland","2025-01-16",0,0,35,0,0,35,0,0
"Ireland","2025-01-17",0,0,35,0,0,35,0,0
"Ireland","2025-01-18",0,0,35,0,0,35,0,0
"Ireland","2025-01-19",0,0,35,0,0,35,0,0
"Ireland","2025-01-20",0,0,35,0,0,35,0,0
"Ireland","2025-01-21",0,0,35,0,0,35,0,0
"Ireland","2025-01-22",0,0,35,0,0,35,0,0
"Ireland","2025-01-23",0,0,35,0,0,35,0,0
"Ireland","2025-01-24",0,0,35,0,0,35,0,0
"Ireland","2025-01-25",0,0,35,0,0,35,0,0
"Ireland","2025-01-26",0,0,35,0,0,35,0,0
"Ireland","2025-01-27",0,0,35,0,0,35,0,0
"Ireland","2025-01-28",0,0,35,0,0,35,0,0
"Ireland","2025-01-29",0,0,35,0,0,35,0,0
"Ireland","2025-01-30",0,0,35,0,0,35,0,0
"Ireland","2025-01-31",0,0,35,0,0,35,0,0
"Ireland","2025-02-01",0,0,35,0,0,35,0,0
"Ireland","2025-02-02",0,0,35,0,0,35,0,0
"Ireland","2025-02-03",0,0,35,0,0,35,0,0
"Ireland","2025-02-04",0,0,35,0,0,35,0,0
"Ireland","2025-02-05",0,0,35,0,0,35,0,0
"Ireland","2025-02-06",0,0,35,0,0,35,0,0
"Ireland","2025-02-07",0,0,35,0,0,35,0,0
"Ireland","2025-02-08",0,0,35,0,0,35,0,0
"Ireland","2025-02-09",0,0,35,0,0,35,0,0
"Ireland","2025-02-10",0,0,35,0,0,35,0,0
"Ireland","2025-02-11",0,0,35,0,0,35,0,0
"Ireland","2025-02-12",0,0,35,0,0,35,0,0
"Ireland","2025-02-13",0,0,35,0,0,35,0,0
"Ireland","2025-02-14",0,0,35,0,0,35,0,0
"Ireland","2025-02-15",0,0,35,0,0,35,0,0
"Ireland","2025-02-16",0,0,35,0,0,35,0,0
"Ireland","2025-02-17",0,0,35,0,0,35,0,0
"Ireland","2025-02-18",0,0,35,0,0,35,0,0
"Ireland","2025-02-19",0,0,35,0,0,35,0,0
"Ireland","2025-02-20",0,0,35,0,0,35,0,0
"Ireland","2025-02-21",0,0,35,0,0,35,0,0
"Ireland","2025-02-22",0,0,35,0,0,35,0,0
"Ireland","2025-02-23",0,0,35,0,0,35,0,0
"Ireland","2025-02-24",0,0,35,0,0,35,0,0
"Ireland","2025-02-25",0,0,35,0,0,35,0,0
"Ireland","2025-02-26",0,0,35,0,0,35,0,0
"Ireland","2025-02-27",0,0,35,0,0,35,0,0
"Ireland","2025-02-28",0,0,35,0,0,35,0,0
"Ireland","2025-03-01",0,0,35,0,0,35,0,0
"Ireland","2025-03-02",0,0,35,0,0,35,0,0
"Ireland","2025-03-03",0,0,35,0,0,35,0,0
"Israel","2024-01-01",0,0,0,0,0,0,0,0
"Israel","2024-01-02",0,0,0,0,0,0,0,0
"Israel","2024-01-03",0,0,0,0,0,0,0,0
"Israel","2024-01-04",0,0,0,0,0,0,0,0
"Israel","2024-01-05",0,0,0,0,0,0,0,0
"Israel","2024-01-06",0,0,0,0,0,0,0,0
"Israel","2024-01-07",0,0,0,0,0,0,0,0
"Israel","2024-01-08",0,0,0,0,0,0,0,0
"Israel","2024-01-09",0,0,0,0,0,0,0,0
"Israel","2024-01-10",0,0,0,0,0,0,0,0
"Israel","2024-01-11",0,0,0,0,0,0,0,0
"Israel","2024-01-12",0,0,0,0,0,0,0,0
"Israel","2024-01-13",0,0,0,0,0,0,0,0
"Israel","2024-01-14",0,0,0,0,0,0,0,0
"Israel","2024-01-15",0,0,0,0,0,0,0,0
"Israel","2024-01-16",0,0,0,0,0,0,0,0
"Israel","2024-01-17",0,0,0,0,0,0,0,0
"Israel","2024-01-18",0,0,0,0,0,0,0,0
"Israel","2024-01-19",0,0,0,0,0,0,0,0
"Israel","2024-01-20",0,0,0,0,0,0,0,0
"Israel","2024-01-21",0,0,0,0,0,0,0,0
"Israel","2024-01-22",0,0,0,0,0,0,0,0
"Israel","2024-01-23",0,0,0,0,0,0,0,0
"Israel","2024-01-24",0,0,0,0,0,0,0,0
"Israel","2024-01-25",0,0,0,0,0,0,0,0
"Israel","2024-01-26",0,0,0,0,0,0,0,0
"Israel","2024-01-27",0,0,0,0,0,0,0,0
"Israel","2024-01-28",0,0,0,0,0,0,0,0
"Israel","2024-01-29",0,0,0,0,0,0,0,0
"Israel","2024-01-30",0,0,0,0,0,0,0,0
"Israel","2024-01-31",0,0,0,0,0,0,0,0
"Israel","2024-02-01",0,0,0,0,0,0,0,0
"Israel","2024-02-02",0,0,0,0,0,0,0,0
"Israel","2024-02-03",0,0,0,0,0,0,0,0
"Israel","2024-02-04",0,0,0,0,0,0,0,0
"Israel","2024-02-05",0,0,0,0,0,0,0,0
"Israel","2024-02-06",0,0,0,0,0,0,0,0
"Israel","2024-02-07",0,0,0,0,0,0,0,0
"Israel","2024-02-08",0,0,0,0,0,0,0,0
"Israel","2024-02-09",0,0,0,0,0,0,0,0
"Israel","2024-02-10",0,0,0,0,0,0,0,0
"Israel","2024-02-11",0,0,0,0,0,0,0,0
"Israel","2024-02-12",0,0,0,0,0,0,0,0
"Israel","2024-02-13",0,0,0,0,0,0,0,0
"Israel","2024-02-14",0,0,0,0,0,0,0,0
"Israel","2024-02-15",0,0,0,0,0,0,0,0
"Israel","2024-02-16",0,0,0,0,0,0,0,0
"Israel","2024-02-17",0,0,0,0,0,0,0,0
"Israel","2024-02-18",0,0,0,0,0,0,0,0
"Israel","2024-02-19",0,0,0,0,0,0,0,0
"Israel","2024-02-20",0,0,0,0,0,0,0,0
"Israel","2024-02-21",0,0,0,0,0,0,0,0
"Israel","2024-02-22",0,0,0,0,0,0,0,0
"Israel","2024-02-23",0,0,0,0,0,0,0,0
"Israel","2024-02-24",0,0,0,0,0,0,0,0
"Israel","2024-02-25",0,0,0,0,0,0,0,0
"Israel","2024-02-26",0,0,0,0,0,0,0,0
"Israel","2024-02-27",0,0,0,0,0,0,0,0
"Israel","2024-02-28",0,0,0,0,0,0,0,0
"Israel","2024-02-29",0,18,18,0,18,18,0,0
"Israel","2024-03-01",0,0,18,0,0,18,0,0
"Israel","2024-03-02",0,0,18,0,0,18,0,0
"Israel","2024-03-03",0,0,18,0,0,18,0,0
"Israel","2024-03-04",0,0,18,0,0,18,0,0
"Israel","2024-03-05",0,0,18,0,0,18,0,0
"Israel","2024-03-06",0,0,18,0,0,18,0,0
"Israel","2024-03-07",0,0,18,0,0,18,0,0
"Israel","2024-03-08",0,0,18,0,0,18,0,0
"Israel","2024-03-09",0,0,18,0,0,18,0,0
"Israel","2024-03-10",0,0,18,0,0,18,0,0
"Israel","2024-03-11",0,0,18,0,0,18,0,0
"Israel","2024-03-12",0,0,18,0,0,18,0,0
"Israel","2024-03-13",0,0,18,0,0,18,0,0
"Israel","2024-03-14",0,0,18,0,0,18,0,0
"Israel","2024-03-15",0,0,18,0,0,18,0,0
"Israel","2024-03-16",0,0,18,0,0,18,0,0
"Israel","2024-03-17",0,0,18,0,0,18,0,0
"Israel","2024-03-18",0,0,18,0,0,18,0,0
"Israel","2024-03-19",0,0,18,0,0,18,0,0
"Israel","2024-03-20",0,0,18,0,0,18,0,0
"Israel","2024-03-21",0,0,18,0,1,19,0,0
"Israel","2024-03-22",0,0,18,0,0,19,0,0
"Israel","2024-03-23",0,0,18,0,0,19,0,0
"Israel","2024-03-24",0,0,18,0,0,19,0,0
"Israel","2024-03-25",0,0,18,0,0,19,0,0
"Israel","2024-03-26",0,0,18,0,0,19,0,0
"Israel","2024-03-27",0,0,18,0,0,19,0,0
"Israel","2024-03-28",0,0,18,0,0,19,0,0
"Israel","2024-03-29",0,0,18,0,0,19,0,0
"Israel","2024-03-30",0,0,18,0,0,19,0,0
"Israel","2024-03-31",0,0,18,0,0,19,0,0
"Israel","2024-04-01",0,0,18,0,0,19,0,0
"Israel","2024-04-02",0,0,18,0,0,19,0,0
"Israel","2024-04-03",0,0,18,0,0,19,0,0
"Israel","2024-04-04",0,0,18,0,0,19,0,0
"Israel","2024-04-05",0,0,18,0,0,19,0,0
"Israel","2024-04-06",0,0,18,0,0,19,0,0
"Israel","2024-04-07",0,0,18,0,0,19,0,0
"Israel","2024-04-08",0,0,18,0,0,19,0,0
"Israel","2024-04-09",0,1,19,0,0,19,0,0
"Israel","2024-04-10",0,0,19,0,0,19,0,0
"Israel","2024-04-11",0,0,19,0,1,20,0,0
"Israel","2024-04-12",0,0,19,0,0,20,0,0
"Israel","2024-04-13",0,0,19,0,0,20,0,0
"Israel","2024-04-14",0,0,19,0,1,21,0,0
"Israel","2024-04-15",0,0,19,0,0,21,0,0
"Israel","2024-04-16",0,0,19,0,0,21,0,0
"Israel","2024-04-17",0,0,19,0,1,22,0,0
"Israel","2024-04-18",0,0,19,0,0,22,0,0
"Israel","2024-04-19",0,0,19,0,0,22,0,0
"Israel","2024-04-20",0,0,19,0,1,23,0,0
"Israel","2024-04-21",0,0,19,0,0,23,0,0
"Israel","2024-04-22",0,0,19,0,0,23,0,0
"Israel","2024-04-23",0,0,19,0,1,24,0,0
"Israel","2024-04-24",0,0,19,0,0,24,0,0
"Israel","2024-04-25",0,0,19,0,1,25,0,0
"Israel","2024-04-26",0,0,19,0,0,25,0,0
"Israel","2024-04-27",0,0,19,0,0,25,0,0
"Israel","2024-04-28",0,0,19,0,1,26,0,0
"Israel","2024-04-29",0,0,19,0,0,26,0,0
"Israel","2024-04-30",0,0,19,0,0,26,0,0
"Israel","2024-05-01",0,0,19,0,1,27,0,0
"Israel","2024-05-02",0,0,19,0,0,27,0,0
"Israel","2024-05-03",0,0,19,0,0,27,0,0
"Israel","2024-05-04",0,0,19,0,1,28,0,0
"Israel","2024-05-05",0,0,19,0,0,28,0,0
"Israel","2024-05-06",0,0,19,0,0,28,0,0
"Israel","2024-05-07",0,0,19,0,1,29,0,0
"Israel","2024-05-08",0,0,19,0,0,29,0,0
"Israel","2024-05-09",0,0,19,0,0,29,0,0
"Israel","2024-05-10",0,0,19,0,1,30,0,0
"Israel","2024-05-11",0,0,19,0,0,30,0,0
"Israel","2024-05-12",0,0,19,0,0,30,0,0
"Israel","2024-05-13",0,0,19,0,1,31,0,0
"Israel","2024-05-14",0,0,19,0,0,31,0,0
"Israel","2024-05-15",0,0,19,0,0,31,0,0
"Israel","2024-05-16",0,0,19,0,1,32,0,0
"Israel","2024-05-17",0,0,19,0,0,32,0,0
"Israel","2024-05-18",0,0,19,0,1,33,0,0
"Israel","2024-05-19",0,0,19,0,0,33,0,0
"Israel","2024-05-20",0,0,19,0,0,33,0,0
"Israel","2024-05-21",0,0,19,0,1,34,0,0
"Israel","2024-05-22",0,0,19,0,0,34,0,0
"Israel","2024-05-23",0,0,19,0,0,34,0,0
"Israel","2024-05-24",0,0,19,0,1,35,0,0
"Israel","2024-05-25",0,0,19,0,0,35,0,0
"Israel","2024-05-26",0,0,19,0,0,35,0,0
"Israel","2024-05-27",0,0,19,0,1,36,0,0
"Israel","2024-05-28",0,0,19,0,0,36,0,0
"Israel","2024-05-29",0,0,19,0,0,36,0,0
"Israel","2024-05-30",0,0,19,0,1,37,0,0
"Israel","2024-05-31",0,18,37,0,0,37,0,0
"Israel","2024-06-01",0,0,37,0,0,37,0,0
"Israel","2024-06-02",0,0,37,0,0,37,0,0
"Israel","2024-06-03",0,0,37,0,0,37,0,0
"Israel","2024-06-04",0,0,37,0,0,37,0,0
"Israel","2024-06-05",0,0,37,0,0,37,0,0
"Israel","2024-06-06",0,0,37,0,0,37,0,0
"Israel","2024-06-07",0,0,37,0,0,37,0,0
"Israel","2024-06-08",0,0,37,0,1,38,0,0
"Israel","2024-06-09",0,0,37,0,0,38,0,0
"Israel","2024-06-10",0,0,37,0,0,38,0,0
"Israel","2024-06-11",0,0,37,0,0,38,0,0
"Israel","2024-06-12",0,0,37,0,0,38,0,0
"Israel","2024-06-13",0,0,37,0,0,38,0,0
"Israel","2024-06-14",0,0,37,0,0,38,0,0
"Israel","2024-06-15",0,0,37,0,0,38,0,0
"Israel","2024-06-16",0,0,37,0,0,38,0,0
"Israel","2024-06-17",0,0,37,0,0,38,0,0
"Israel","2024-06-18",0,0,37,0,0,38,0,0
"Israel","2024-06-19",0,0,37,0,0,38,0,0
"Israel","2024-06-20",0,0,37,0,0,38,0,0
"Israel","2024-06-21",0,0,37,0,0,38,0,0
"Israel","2024-06-22",0,0,37,0,0,38,0,0
"Israel","2024-06-23",0,0,37,0,1,39,0,0
"Israel","2024-06-24",0,0,37,0,0,39,0,0
"Israel","2024-06-25",0,0,37,0,0,39,0,0
"Israel","2024-06-26",0,0,37,0,0,39,0,0
"Israel","2024-06-27",0,0,37,0,0,39,0,0
"Israel","2024-06-28",0,0,37,0,0,39,0,0
"Israel","2024-06-29",0,0,37,0,0,39,0,0
"Israel","2024-06-30",0,2,39,0,0,39,0,0
"Israel","2024-07-01",0,0,39,0,0,39,0,0
"Israel","2024-07-02",0,0,39,0,0,39,0,0
"Israel","2024-07-03",0,0,39,0,0,39,0,0
"Israel","2024-07-04",0,0,39,0,0,39,0,0
"Israel","2024-07-05",0,0,39,0,0,39,0,0
"Israel","2024-07-06",0,0,39,0,1,40,0,0
"Israel","2024-07-07",0,0,39,0,0,40,0,0
"Israel","2024-07-08",0,0,39,0,0,40,0,0
"Israel","2024-07-09",0,0,39,0,0,40,0,0
"Israel","2024-07-10",0,0,39,0,0,40,0,0
"Israel","2024-07-11",0,0,39,0,0,40,0,0
"Israel","2024-07-12",0,0,39,0,0,40,0,0
"Israel","2024-07-13",0,0,39,0,0,40,0,0
"Israel","2024-07-14",0,0,39,0,0,40,0,0
"Israel","2024-07-15",0,0,39,0,0,40,0,0
"Israel","2024-07-16",0,0,39,0,1,41,0,0
"Israel","2024-07-17",0,0,39,0,0,41,0,0
"Israel","2024-07-18",0,0,39,0,0,41,0,0
"Israel","2024-07-19",0,0,39,0,0,41,0,0
"Israel","2024-07-20",0,0,39,0,0,41,0,0
"Israel","2024-07-21",0,0,39,0,0,41,0,0
"Israel","2024-07-22",0,0,39,0,0,41,0,0
"Israel","2024-07-23",0,0,39,0,0,41,0,0
"Israel","2024-07-24",0,0,39,0,0,41,0,0
"Israel","2024-07-25",0,0,39,0,0,41,0,0
"Israel","2024-07-26",0,0,39,0,1,42,0,0
"Israel","2024-07-27",0,0,39,0,0,42,0,0
"Israel","2024-07-28",0,0,39,0,0,42,0,0
"Israel","2024-07-29",0,0,39,0,0,42,0,0
"Israel","2024-07-30",0,0,39,0,0,42,0,0
"Israel","2024-07-31",0,3,42,0,0,42,0,0
"Israel","2024-08-01",0,0,42,0,0,42,0,0
"Israel","2024-08-02",0,0,42,0,0,42,0,0
"Israel","2024-08-03",0,0,42,0,0,42,0,0
"Israel","2024-08-04",0,0,42,0,1,43,0,0
"Israel","2024-08-05",0,0,42,0,0,43,0,0
"Israel","2024-08-06",0,0,42,0,0,43,0,0
"Israel","2024-08-07",0,0,42,0,0,43,0,0
"Israel","2024-08-08",0,0,42,0,0,43,0,0
"Israel","2024-08-09",0,0,42,0,0,43,0,0
"Israel","2024-08-10",0,0,42,0,0,43,0,0
"Israel","2024-08-11",0,0,42,0,0,43,0,0
"Israel","2024-08-12",0,0,42,0,1,44,0,0
"Israel","2024-08-13",0,0,42,0,0,44,0,0
"Israel","2024-08-14",0,0,42,0,0,44,0,0
"Israel","2024-08-15",0,0,42,0,0,44,0,0
"Israel","2024-08-16",0,0,42,0,0,44,0,0
"Israel","2024-08-17",0,0,42,0,0,44,0,0
"Israel","2024-08-18",0,0,42,0,0,44,0,0
"Israel","2024-08-19",0,0,42,0,0,44,0,0
"Israel","2024-08-20",0,0,42,0,1,45,0,0
"Israel","2024-08-21",0,0,42,0,0,45,0,0
"Israel","2024-08-22",0,0,42,0,0,45,0,0
"Israel","2024-08-23",0,0,42,0,0,45,0,0
"Israel","2024-08-24",0,0,42,0,0,45,0,0
"Israel","2024-08-25",0,0,42,0,0,45,0,0
"Israel","2024-08-26",0,0,42,0,0,45,0,0
"Israel","2024-08-27",0,0,42,0,0,45,0,0
"Israel","2024-08-28",0,0,42,0,1,46,0,0
"Israel","2024-08-29",0,0,42,0,0,46,0,0
"Israel","2024-08-30",0,0,42,0,0,46,0,0
"Israel","2024-08-31",0,4,46,0,0,46,0,0
"Israel","2024-09-01",0,0,46,0,0,46,0,0
"Israel","2024-09-02",0,0,46,0,0,46,0,0
"Israel","2024-09-03",0,0,46,0,0,46,0,0
"Israel","2024-09-04",0,0,46,0,1,47,0,0
"Israel","2024-09-05",0,0,46,0,0,47,0,0
"Israel","2024-09-06",0,0,46,0,0,47,0,0
"Israel","2024-09-07",0,0,46,0,0,47,0,0
"Israel","2024-09-08",0,0,46,0,0,47,0,0
"Israel","2024-09-09",0,0,46,0,0,47,0,0
"Israel","2024-09-10",0,0,46,0,0,47,0,0
"Israel","2024-09-11",0,0,46,0,0,47,0,0
"Israel","2024-09-12",0,0,46,0,1,48,0,0
"Israel","2024-09-13",0,0,46,0,0,48,0,0
"Israel","2024-09-14",0,0,46,0,0,48,0,0
"Israel","2024-09-15",0,0,46,0,0,48,0,0
"Israel","2024-09-16",0,0,46,0,0,48,0,0
"Israel","2024-09-17",0,0,46,0,0,48,0,0
"Israel","2024-09-18",0,0,46,0,0,48,0,0
"Israel","2024-09-19",0,0,46,0,1,49,0,0
"Israel","2024-09-20",0,0,46,0,0,49,0,0
"Israel","2024-09-21",0,0,46,0,0,49,0,0
"Israel","2024-09-22",0,0,46,0,0,49,0,0
"Israel","2024-09-23",0,0,46,0,0,49,0,0
"Israel","2024-09-24",0,0,46,0,0,49,0,0
"Israel","2024-09-25",0,0,46,0,0,49,0,0
"Israel","2024-09-26",0,0,46,0,0,49,0,0
"Israel","2024-09-27",0,0,46,0,1,50,0,0
"Israel","2024-09-28",0,0,46,0,0,50,0,0
"Israel","2024-09-29",0,0,46,0,0,50,0,0
"Israel","2024-09-30",0,4,50,0,0,50,0,0
"Israel","2024-10-01",0,0,50,0,0,50,0,0
"Israel","2024-10-02",0,0,50,0,0,50,0,0
"Israel","2024-10-03",0,0,50,0,0,50,0,0
"Israel","2024-10-04",0,0,50,0,0,50,0,0
"Israel","2024-10-05",0,0,50,0,1,51,0,0
"Israel","2024-10-06",0,0,50,0,0,51,0,0
"Israel","2024-10-07",0,0,50,0,0,51,0,0
"Israel","2024-10-08",0,0,50,0,0,51,0,0
"Israel","2024-10-09",0,0,50,0,0,51,0,0
"Israel","2024-10-10",0,0,50,0,0,51,0,0
"Israel","2024-10-11",0,0,50,0,0,51,0,0
"Israel","2024-10-12",0,0,50,0,0,51,0,0
"Israel","2024-10-13",0,0,50,0,1,52,0,0
"Israel","2024-10-14",0,0,50,0,0,52,0,0
"Israel","2024-10-15",0,0,50,0,0,52,0,0
"Israel","2024-10-16",0,0,50,0,0,52,0,0
"Israel","2024-10-17",0,0,50,0,0,52,0,0
"Israel","2024-10-18",0,0,50,0,0,52,0,0
"Israel","2024-10-19",0,0,50,0,0,52,0,0
"Israel","2024-10-20",0,0,50,0,0,52,0,0
"Israel","2024-10-21",0,0,50,0,1,53,0,0
"Israel","2024-10-22",0,0,50,0,0,53,0,0
"Israel","2024-10-23",0,0,50,0,0,53,0,0
"Israel","2024-10-24",0,0,50,0,0,53,0,0
"Israel","2024-10-25",0,0,50,0,0,53,0,0
"Israel","2024-10-26",0,0,50,0,0,53,0,0
"Israel","2024-10-27",0,0,50,0,0,53,0,0
"Israel","2024-10-28",0,0,50,0,0,53,0,0
"Israel","2024-10-29",0,0,50,0,0,53,0,0
"Israel","2024-10-30",0,0,50,0,1,54,0,0
"Israel","2024-10-31",0,0,50,0,0,54,0,0
"Israel","2024-11-01",0,0,50,0,0,54,0,0
"Israel","2024-11-02",0,0,50,0,0,54,0,0
"Israel","2024-11-03",0,0,50,0,0,54,0,0
"Israel","2024-11-04",0,0,50,0,0,54,0,0
"Israel","2024-11-05",0,0,50,0,0,54,0,0
"Israel","2024-11-06",0,0,50,0,0,54,0,0
"Israel","2024-11-07",0,0,50,0,1,55,0,0
"Israel","2024-11-08",0,0,50,0,0,55,0,0
"Israel","2024-11-09",0,0,50,0,0,55,0,0
"Israel","2024-11-10",0,0,50,0,0,55,0,0
"Israel","2024-11-11",0,0,50,0,0,55,0,0
"Israel","2024-11-12",0,0,50,0,0,55,0,0
"Israel","2024-11-13",0,0,50,0,0,55,0,0
"Israel","2024-11-14",0,0,50,0,0,55,0,0
"Israel","2024-11-15",0,0,50,0,1,56,0,0
"Israel","2024-11-16",0,0,50,0,0,56,0,0
"Israel","2024-11-17",0,0,50,0,0,56,0,0
"Israel","2024-11-18",0,0,50,0,0,56,0,0
"Israel","2024-11-19",0,0,50,0,0,56,0,0
"Israel","2024-11-20",0,0,50,0,0,56,0,0
"Israel","2024-11-21",0,0,50,0,0,56,0,0
"Israel","2024-11-22",0,0,50,0,0,56,0,0
"Israel","2024-11-23",0,0,50,0,0,56,0,0
"Israel","2024-11-24",0,0,50,0,1,57,0,0
"Israel","2024-11-25",0,0,50,0,0,57,0,0
"Israel","2024-11-26",0,0,50,0,0,57,0,0
"Israel","2024-11-27",0,0,50,0,0,57,0,0
"Israel","2024-11-28",0,0,50,0,0,57,0,0
"Israel","2024-11-29",0,0,50,0,0,57,0,0
"Israel","2024-11-30",0,0,50,0,0,57,0,0
"Israel","2024-12-01",0,0,50,0,0,57,0,0
"Israel","2024-12-02",0,0,50,0,1,58,0,0
"Israel","2024-12-03",0,0,50,0,0,58,0,0
"Israel","2024-12-04",0,0,50,0,0,58,0,0
"Israel","2024-12-05",0,0,50,0,0,58,0,0
"Israel","2024-12-06",0,0,50,0,0,58,0,0
"Israel","2024-12-07",0,0,50,0,0,58,0,0
"Israel","2024-12-08",0,0,50,0,0,58,0,0
"Israel","2024-12-09",0,0,50,0,0,58,0,0
"Israel","2024-12-10",0,0,50,0,0,58,0,0
"Israel","2024-12-11",0,0,50,0,1,59,0,0
"Israel","2024-12-12",0,0,50,0,0,59,0,0
"Israel","2024-12-13",0,0,50,0,0,59,0,0
"Israel","2024-12-14",0,0,50,0,0,59,0,0
"Israel","2024-12-15",0,0,50,0,0,59,0,0
"Israel","2024-12-16",0,0,50,0,0,59,0,0
"Israel","2024-12-17",0,0,50,0,0,59,0,0
"Israel","2024-12-18",0,0,50,0,0,59,0,0
"Israel","2024-12-19",0,0,50,0,1,60,0,0
"Israel","2024-12-20",0,0,50,0,0,60,0,0
"Israel","2024-12-21",0,0,50,0,0,60,0,0
"Israel","2024-12-22",0,0,50,0,0,60,0,0
"Israel","2024-12-23",0,0,50,0,0,60,0,0
"Israel","2024-12-24",0,0,50,0,0,60,0,0
"Israel","2024-12-25",0,0,50,0,0,60,0,0
"Israel","2024-12-26",0,0,50,0,0,60,0,0
"Israel","2024-12-27",0,0,50,0,1,61,0,0
"Israel","2024-12-28",0,0,50,0,0,61,0,0
"Israel","2024-12-29",0,0,50,0,0,61,0,0
"Israel","2024-12-30",0,0,50,0,0,61,0,0
"Israel","2024-12-31",0,11,61,0,0,61,0,0
"Israel","2025-01-01",0,0,61,0,0,61,0,0
"Israel","2025-01-02",0,0,61,0,1,62,0,0
"Israel","2025-01-03",0,0,61,0,0,62,0,0
"Israel","2025-01-04",0,0,61,0,1,63,0,0
"Israel","2025-01-05",0,0,61,0,0,63,0,0
"Israel","2025-01-06",0,0,61,0,0,63,0,0
"Israel","2025-01-07",0,0,61,0,1,64,0,0
"Israel","2025-01-08",0,0,61,0,0,64,0,0
"Israel","2025-01-09",0,0,61,0,1,65,0,0
"Israel","2025-01-10",0,4,65,0,0,65,0,0
"Israel","2025-01-11",0,0,65,0,0,65,0,0
"Israel","2025-01-12",0,0,65,0,0,65,0,0
"Israel","2025-01-13",0,0,65,0,0,65,0,0
"Israel","2025-01-14",0,0,65,0,0,65,0,0
"Israel","2025-01-15",0,0,65,0,0,65,0,0
"Israel","2025-01-16",0,0,65,0,0,65,0,0
"Israel","2025-01-17",0,0,65,0,0,65,0,0
"Israel","2025-01-18",0,0,65,0,0,65,0,0
"Israel","2025-01-19",0,0,65,0,0,65,0,0
"Israel","2025-01-20",0,0,65,0,0,65,0,0
"Israel","2025-01-21",0,0,65,0,0,65,0,0
"Israel","2025-01-22",0,0,65,0,0,65,0,0
"Israel","2025-01-23",0,0,65,0,0,65,0,0
"Israel","2025-01-24",0,0,65,0,0,65,0,0
"Israel","2025-01-25",0,0,65,0,0,65,0,0
"Israel","2025-01-26",0,0,65,0,0,65,0,0
"Israel","2025-01-27",0,0,65,0,0,65,0,0
"Israel","2025-01-28",0,0,65,0,0,65,0,0
"Israel","2025-01-29",0,0,65,0,0,65,0,0
"Israel","2025-01-30",0,0,65,0,0,65,0,0
"Israel","2025-01-31",0,0,65,0,0,65,0,0
"Israel","2025-02-01",0,0,65,0,0,65,0,0
"Israel","2025-02-02",0,0,65,0,0,65,0,0
"Israel","2025-02-03",0,0,65,0,0,65,0,0
"Israel","2025-02-04",0,0,65,0,0,65,0,0
"Israel","2025-02-05",0,0,65,0,0,65,0,0
"Israel","2025-02-06",0,0,65,0,0,65,0,0
"Israel","2025-02-07",0,0,65,0,0,65,0,0
"Israel","2025-02-08",0,0,65,0,0,65,0,0
"Israel","2025-02-09",0,0,65,0,0,65,0,0
"Israel","2025-02-10",0,0,65,0,0,65,0,0
"Israel","2025-02-11",0,0,65,0,0,65,0,0
"Israel","2025-02-12",0,0,65,0,0,65,0,0
"Israel","2025-02-13",0,0,65,0,0,65,0,0
"Israel","2025-02-14",0,0,65,0,0,65,0,0
"Israel","2025-02-15",0,0,65,0,0,65,0,0
"Israel","2025-02-16",0,0,65,0,0,65,0,0
"Israel","2025-02-17",0,0,65,0,0,65,0,0
"Israel","2025-02-18",0,0,65,0,0,65,0,0
"Israel","2025-02-19",0,0,65,0,0,65,0,0
"Israel","2025-02-20",0,0,65,0,0,65,0,0
"Israel","2025-02-21",0,0,65,0,0,65,0,0
"Israel","2025-02-22",0,0,65,0,0,65,0,0
"Israel","2025-02-23",0,0,65,0,0,65,0,0
"Israel","2025-02-24",0,0,65,0,0,65,0,0
"Israel","2025-02-25",0,0,65,0,0,65,0,0
"Israel","2025-02-26",0,0,65,0,0,65,0,0
"Israel","2025-02-27",0,0,65,0,0,65,0,0
"Israel","2025-02-28",0,0,65,0,0,65,0,0
"Israel","2025-03-01",0,0,65,0,0,65,0,0
"Israel","2025-03-02",0,0,65,0,0,65,0,0
"Israel","2025-03-03",0,0,65,0,0,65,0,0
"Italy","2024-01-01",0,0,0,0,0,0,0,0
"Italy","2024-01-02",0,0,0,0,0,0,0,0
"Italy","2024-01-03",0,0,0,0,0,0,0,0
"Italy","2024-01-04",0,0,0,0,0,0,0,0
"Italy","2024-01-05",0,0,0,0,0,0,0,0
"Italy","2024-01-06",0,0,0,0,0,0,0,0
"Italy","2024-01-07",0,0,0,0,0,0,0,0
"Italy","2024-01-08",0,0,0,0,0,0,0,0
"Italy","2024-01-09",0,0,0,0,0,0,0,0
"Italy","2024-01-10",0,0,0,0,0,0,0,0
"Italy","2024-01-11",0,0,0,0,0,0,0,0
"Italy","2024-01-12",0,0,0,0,0,0,0,0
"Italy","2024-01-13",0,0,0,0,0,0,0,0
"Italy","2024-01-14",0,0,0,0,0,0,0,0
"Italy","2024-01-15",0,0,0,0,0,0,0,0
"Italy","2024-01-16",0,0,0,0,0,0,0,0
"Italy","2024-01-17",0,0,0,0,0,0,0,0
"Italy","2024-01-18",0,0,0,0,0,0,0,0
"Italy","2024-01-19",0,0,0,0,0,0,0,0
"Italy","2024-01-20",0,0,0,0,0,0,0,0
"Italy","2024-01-21",0,0,0,0,0,0,0,0
"Italy","2024-01-22",0,0,0,0,0,0,0,0
"Italy","2024-01-23",0,0,0,0,0,0,0,0
"Italy","2024-01-24",0,0,0,0,0,0,0,0
"Italy","2024-01-25",0,0,0,0,0,0,0,0
"Italy","2024-01-26",0,0,0,0,0,0,0,0
"Italy","2024-01-27",0,0,0,0,0,0,0,0
"Italy","2024-01-28",0,0,0,0,0,0,0,0
"Italy","2024-01-29",0,0,0,0,0,0,0,0
"Italy","2024-01-30",0,0,0,0,0,0,0,0
"Italy","2024-01-31",0,26,26,0,26,26,0,0
"Italy","2024-02-01",0,0,26,0,0,26,0,0
"Italy","2024-02-02",0,0,26,0,1,27,0,0
"Italy","2024-02-03",0,0,26,0,0,27,0,0
"Italy","2024-02-04",0,0,26,0,1,28,0,0
"Italy","2024-02-05",0,0,26,0,0,28,0,0
"Italy","2024-02-06",0,0,26,0,1,29,0,0
"Italy","2024-02-07",0,0,26,0,0,29,0,0
"Italy","2024-02-08",0,0,26,0,1,30,0,0
"Italy","2024-02-09",0,0,26,0,0,30,0,0
"Italy","2024-02-10",0,0,26,0,0,30,0,0
"Italy","2024-02-11",0,0,26,0,1,31,0,0
"Italy","2024-02-12",0,0,26,0,0,31,0,0
"Italy","2024-02-13",0,0,26,0,1,32,0,0
"Italy","2024-02-14",0,0,26,0,0,32,0,0
"Italy","2024-02-15",0,0,26,0,1,33,0,0
"Italy","2024-02-16",0,0,26,0,0,33,0,0
"Italy","2024-02-17",0,0,26,0,1,34,0,0
"Italy","2024-02-18",0,0,26,0,0,34,0,0
"Italy","2024-02-19",0,0,26,0,1,35,0,0
"Italy","2024-02-20",0,0,26,0,0,35,0,0
"Italy","2024-02-21",0,0,26,0,0,35,0,0
"Italy","2024-02-22",0,0,26,0,1,36,0,0
"Italy","2024-02-23",0,0,26,0,0,36,0,0
"Italy","2024-02-24",0,0,26,0,1,37,0,0
"Italy","2024-02-25",0,0,26,0,0,37,0,0
"Italy","2024-02-26",0,0,26,0,1,38,0,0
"Italy","2024-02-27",0,0,26,0,0,38,0,0
"Italy","2024-02-28",0,0,26,0,1,39,0,0
"Italy","2024-02-29",0,13,39,0,0,39,0,0
"Italy","2024-03-01",0,0,39,0,0,39,0,0
"Italy","2024-03-02",0,0,39,0,1,40,0,0
"Italy","2024-03-03",0,0,39,0,0,40,0,0
"Italy","2024-03-04",0,0,39,0,1,41,0,0
"Italy","2024-03-05",0,0,39,0,0,41,0,0
"Italy","2024-03-06",0,0,39,0,1,42,0,0
"Italy","2024-03-07",0,0,39,0,0,42,0,0
"Italy","2024-03-08",0,0,39,0,1,43,0,0
"Italy","2024-03-09",0,0,39,0,0,43,0,0
"Italy","2024-03-10",0,0,39,0,1,44,0,0
"Italy","2024-03-11",0,0,39,0,0,44,0,0
"Italy","2024-03-12",0,0,39,0,0,44,0,0
"Italy","2024-03-13",0,0,39,0,1,45,0,0
"Italy","2024-03-14",0,0,39,0,0,45,0,0
"Italy","2024-03-15",0,0,39,0,1,46,0,0
"Italy","2024-03-16",0,0,39,0,0,46,0,0
"Italy","2024-03-17",0,0,39,0,1,47,0,0
"Italy","2024-03-18",0,0,39,0,0,47,0,0
"Italy","2024-03-19",0,0,39,0,1,48,0,0
"Italy","2024-03-20",0,0,39,0,0,48,0,0
"Italy","2024-03-21",0,0,39,0,0,48,0,0
"Italy","2024-03-22",0,0,39,0,1,49,0,0
"Italy","2024-03-23",0,0,39,0,0,49,0,0
"Italy","2024-03-24",0,0,39,0,1,50,0,0
"Italy","2024-03-25",0,0,39,0,0,50,0,0
"Italy","2024-03-26",0,0,39,0,1,51,0,0
"Italy","2024-03-27",0,0,39,0,0,51,0,0
"Italy","2024-03-28",0,0,39,0,1,52,0,0
"Italy","2024-03-29",0,0,39,0,0,52,0,0
"Italy","2024-03-30",0,0,39,0,1,53,0,0
"Italy","2024-03-31",0,14,53,0,0,53,0,0
"Italy","2024-04-01",0,0,53,0,0,53,0,0
"Italy","2024-04-02",0,0,53,0,0,53,0,0
"Italy","2024-04-03",0,0,53,0,0,53,0,0
"Italy","2024-04-04",0,0,53,0,0,53,0,0
"Italy","2024-04-05",0,0,53,0,0,53,0,0
"Italy","2024-04-06",0,0,53,0,0,53,0,0
"Italy","2024-04-07",0,0,53,0,0,53,0,0
"Italy","2024-04-08",0,0,53,0,0,53,0,0
"Italy","2024-04-09",0,0,53,0,0,53,0,0
"Italy","2024-04-10",0,0,53,0,0,53,0,0
"Italy","2024-04-11",0,0,53,0,0,53,0,0
"Italy","2024-04-12",0,0,53,0,0,53,0,0
"Italy","2024-04-13",0,0,53,0,0,53,0,0
"Italy","2024-04-14",0,0,53,0,0,53,0,0
"Italy","2024-04-15",0,0,53,0,0,53,0,0
"Italy","2024-04-16",0,0,53,0,1,54,0,0
"Italy","2024-04-17",0,0,53,0,0,54,0,0
"Italy","2024-04-18",0,0,53,0,0,54,0,0
"Italy","2024-04-19",0,0,53,0,0,54,0,0
"Italy","2024-04-20",0,0,53,0,0,54,0,0
"Italy","2024-04-21",0,0,53,0,0,54,0,0
"Italy","2024-04-22",0,0,53,0,0,54,0,0
"Italy","2024-04-23",0,0,53,0,0,54,0,0
"Italy","2024-04-24",0,0,53,0,0,54,0,0
"Italy","2024-04-25",0,0,53,0,0,54,0,0
"Italy","2024-04-26",0,0,53,0,0,54,0,0
"Italy","2024-04-27",0,0,53,0,0,54,0,0
"Italy","2024-04-28",0,0,53,0,0,54,0,0
"Italy","2024-04-29",0,0,53,0,0,54,0,0
"Italy","2024-04-30",0,1,54,0,0,54,0,0
"Italy","2024-05-01",0,0,54,0,0,54,0,0
"Italy","2024-05-02",0,0,54,0,0,54,0,0
"Italy","2024-05-03",0,0,54,0,0,54,0,0
"Italy","2024-05-04",0,0,54,0,1,55,0,0
"Italy","2024-05-05",0,0,54,0,0,55,0,0
"Italy","2024-05-06",0,0,54,0,0,55,0,0
"Italy","2024-05-07",0,0,54,0,0,55,0,0
"Italy","2024-05-08",0,0,54,0,0,55,0,0
"Italy","2024-05-09",0,0,54,0,0,55,0,0
"Italy","2024-05-10",0,0,54,0,0,55,0,0
"Italy","2024-05-11",0,0,54,0,0,55,0,0
"Italy","2024-05-12",0,0,54,0,1,56,0,0
"Italy","2024-05-13",0,0,54,0,0,56,0,0
"Italy","2024-05-14",0,0,54,0,0,56,0,0
"Italy","2024-05-15",0,0,54,0,0,56,0,0
"Italy","2024-05-16",0,0,54,0,0,56,0,0
"Italy","2024-05-17",0,0,54,0,0,56,0,0
"Italy","2024-05-18",0,0,54,0,0,56,0,0
"Italy","2024-05-19",0,0,54,0,0,56,0,0
"Italy","2024-05-20",0,0,54,0,1,57,0,0
"Italy","2024-05-21",0,0,54,0,0,57,0,0
"Italy","2024-05-22",0,0,54,0,0,57,0,0
"Italy","2024-05-23",0,0,54,0,0,57,0,0
"Italy","2024-05-24",0,0,54,0,0,57,0,0
"Italy","2024-05-25",0,0,54,0,0,57,0,0
"Italy","2024-05-26",0,0,54,0,0,57,0,0
"Italy","2024-05-27",0,0,54,0,0,57,0,0
"Italy","2024-05-28",0,0,54,0,1,58,0,0
"Italy","2024-05-29",0,0,54,0,0,58,0,0
"Italy","2024-05-30",0,0,54,0,0,58,0,0
"Italy","2024-05-31",0,4,58,0,0,58,0,0
"Italy","2024-06-01",0,0,58,0,0,58,0,0
"Italy","2024-06-02",0,0,58,0,0,58,0,0
"Italy","2024-06-03",0,0,58,0,0,58,0,0
"Italy","2024-06-04",0,0,58,0,0,58,0,0
"Italy","2024-06-05",0,0,58,0,0,58,0,0
"Italy","2024-06-06",0,0,58,0,0,58,0,0
"Italy","2024-06-07",0,0,58,0,0,58,0,0
"Italy","2024-06-08",0,0,58,0,1,59,0,0
"Italy","2024-06-09",0,0,58,0,0,59,0,0
"Italy","2024-06-10",0,0,58,0,0,59,0,0
"Italy","2024-06-11",0,0,58,0,0,59,0,0
"Italy","2024-06-12",0,0,58,0,0,59,0,0
"Italy","2024-06-13",0,0,58,0,0,59,0,0
"Italy","2024-06-14",0,0,58,0,0,59,0,0
"Italy","2024-06-15",0,0,58,0,0,59,0,0
"Italy","2024-06-16",0,0,58,0,0,59,0,0
"Italy","2024-06-17",0,0,58,0,0,59,0,0
"Italy","2024-06-18",0,0,58,0,0,59,0,0
"Italy","2024-06-19",0,0,58,0,0,59,0,0
"Italy","2024-06-20",0,0,58,0,0,59,0,0
"Italy","2024-06-21",0,0,58,0,0,59,0,0
"Italy","2024-06-22",0,0,58,0,0,59,0,0
"Italy","2024-06-23",0,0,58,0,1,60,0,0
"Italy","2024-06-24",0,0,58,0,0,60,0,0
"Italy","2024-06-25",0,0,58,0,0,60,0,0
"Italy","2024-06-26",0,0,58,0,0,60,0,0
"Italy","2024-06-27",0,0,58,0,0,60,0,0
"Italy","2024-06-28",0,0,58,0,0,60,0,0
"Italy","2024-06-29",0,0,58,0,0,60,0,0
"Italy","2024-06-30",0,2,60,0,0,60,0,0
"Italy","2024-07-01",0,0,60,0,0,60,0,0
"Italy","2024-07-02",0,0,60,0,0,60,0,0
"Italy","2024-07-03",0,0,60,0,1,61,0,0
"Italy","2024-07-04",0,0,60,0,0,61,0,0
"Italy","2024-07-05",0,0,60,0,0,61,0,0
"Italy","2024-07-06",0,0,60,0,0,61,0,0
"Italy","2024-07-07",0,0,60,0,1,62,0,0
"Italy","2024-07-08",0,0,60,0,0,62,0,0
"Italy","2024-07-09",0,0,60,0,0,62,0,0
"Italy","2024-07-10",0,0,60,0,0,62,0,0
"Italy","2024-07-11",0,0,60,0,0,62,0,0
"Italy","2024-07-12",0,0,60,0,1,63,0,0
"Italy","2024-07-13",0,0,60,0,0,63,0,0
"Italy","2024-07-14",0,0,60,0,0,63,0,0
"Italy","2024-07-15",0,0,60,0,0,63,0,0
"Italy","2024-07-16",0,0,60,0,1,64,0,0
"Italy","2024-07-17",0,0,60,0,0,64,0,0
"Italy","2024-07-18",0,0,60,0,0,64,0,0
"Italy","2024-07-19",0,0,60,0,0,64,0,0
"Italy","2024-07-20",0,0,60,0,1,65,0,0
"Italy","2024-07-21",0,0,60,0,0,65,0,0
"Italy","2024-07-22",0,0,60,0,0,65,0,0
"Italy","2024-07-23",0,0,60,0,0,65,0,0
"Italy","2024-07-24",0,0,60,0,0,65,0,0
"Italy","2024-07-25",0,0,60,0,1,66,0,0
"Italy","2024-07-26",0,0,60,0,0,66,0,0
"Italy","2024-07-27",0,0,60,0,0,66,0,0
"Italy","2024-07-28",0,0,60,0,0,66,0,0
"Italy","2024-07-29",0,0,60,0,1,67,0,0
"Italy","2024-07-30",0,0,60,0,0,67,0,0
"Italy","2024-07-31",0,7,67,0,0,67,0,0
"Italy","2024-08-01",0,0,67,0,0,67,0,0
"Italy","2024-08-02",0,0,67,0,0,67,0,0
"Italy","2024-08-03",0,0,67,0,0,67,0,0
"Italy","2024-08-04",0,0,67,0,0,67,0,0
"Italy","2024-08-05",0,0,67,0,0,67,0,0
"Italy","2024-08-06",0,0,67,0,0,67,0,0
"Italy","2024-08-07",0,0,67,0,0,67,0,0
"Italy","2024-08-08",0,0,67,0,0,67,0,0
"Italy","2024-08-09",0,0,67,0,0,67,0,0
"Italy","2024-08-10",0,0,67,0,0,67,0,0
"Italy","2024-08-11",0,0,67,0,0,67,0,0
"Italy","2024-08-12",0,0,67,0,0,67,0,0
"Italy","2024-08-13",0,0,67,0,0,67,0,0
"Italy","2024-08-14",0,0,67,0,0,67,0,0
"Italy","2024-08-15",0,0,67,0,0,67,0,0
"Italy","2024-08-16",0,0,67,0,1,68,0,0
"Italy","2024-08-17",0,0,67,0,0,68,0,0
"Italy","2024-08-18",0,0,67,0,0,68,0,0
"Italy","2024-08-19",0,0,67,0,0,68,0,0
"Italy","2024-08-20",0,0,67,0,0,68,0,0
"Italy","2024-08-21",0,0,67,0,0,68,0,0
"Italy","2024-08-22",0,0,67,0,0,68,0,0
"Italy","2024-08-23",0,0,67,0,0,68,0,0
"Italy","2024-08-24",0,0,67,0,0,68,0,0
"Italy","2024-08-25",0,0,67,0,0,68,0,0
"Italy","2024-08-26",0,0,67,0,0,68,0,0
"Italy","2024-08-27",0,0,67,0,0,68,0,0
"Italy","2024-08-28",0,0,67,0,0,68,0,0
"Italy","2024-08-29",0,0,67,0,0,68,0,0
"Italy","2024-08-30",0,0,67,0,0,68,0,0
"Italy","2024-08-31",0,1,68,0,0,68,0,0
"Italy","2024-09-01",0,0,68,0,0,68,0,0
"Italy","2024-09-02",0,0,68,0,0,68,0,0
"Italy","2024-09-03",0,0,68,0,0,68,0,0
"Italy","2024-09-04",0,0,68,0,1,69,0,0
"Italy","2024-09-05",0,0,68,0,0,69,0,0
"Italy","2024-09-06",0,0,68,0,0,69,0,0
"Italy","2024-09-07",0,0,68,0,0,69,0,0
"Italy","2024-09-08",0,0,68,0,0,69,0,0
"Italy","2024-09-09",0,0,68,0,1,70,0,0
"Italy","2024-09-10",0,0,68,0,0,70,0,0
"Italy","2024-09-11",0,0,68,0,0,70,0,0
"Italy","2024-09-12",0,0,68,0,0,70,0,0
"Italy","2024-09-13",0,0,68,0,0,70,0,0
"Italy","2024-09-14",0,0,68,0,0,70,0,0
"Italy","2024-09-15",0,0,68,0,0,70,0,0
"Italy","2024-09-16",0,0,68,0,1,71,0,0
"Italy","2024-09-17",0,0,68,0,0,71,0,0
"Italy","2024-09-18",0,0,68,0,0,71,0,0
"Italy","2024-09-19",0,0,68,0,0,71,0,0
"Italy","2024-09-20",0,0,68,0,0,71,0,0
"Italy","2024-09-21",0,0,68,0,1,72,0,0
"Italy","2024-09-22",0,0,68,0,0,72,0,0
"Italy","2024-09-23",0,0,68,0,0,72,0,0
"Italy","2024-09-24",0,0,68,0,0,72,0,0
"Italy","2024-09-25",0,0,68,0,0,72,0,0
"Italy","2024-09-26",0,0,68,0,0,72,0,0
"Italy","2024-09-27",0,0,68,0,0,72,0,0
"Italy","2024-09-28",0,0,68,0,1,73,0,0
"Italy","2024-09-29",0,0,68,0,0,73,0,0
"Italy","2024-09-30",0,5,73,0,0,73,0,0
"Italy","2024-10-01",0,0,73,0,0,73,0,0
"Italy","2024-10-02",0,0,73,0,1,74,0,0
"Italy","2024-10-03",0,0,73,0,0,74,0,0
"Italy","2024-10-04",0,0,73,0,0,74,0,0
"Italy","2024-10-05",0,0,73,0,1,75,0,0
"Italy","2024-10-06",0,0,73,0,0,75,0,0
"Italy","2024-10-07",0,0,73,0,0,75,0,0
"Italy","2024-10-08",0,0,73,0,1,76,0,0
"Italy","2024-10-09",0,0,73,0,0,76,0,0
"Italy","2024-10-10",0,0,73,0,0,76,0,0
"Italy","2024-10-11",0,0,73,0,1,77,0,0
"Italy","2024-10-12",0,0,73,0,0,77,0,0
"Italy","2024-10-13",0,0,73,0,0,77,0,0
"Italy","2024-10-14",0,0,73,0,1,78,0,0
"Italy","2024-10-15",0,0,73,0,0,78,0,0
"Italy","2024-10-16",0,0,73,0,0,78,0,0
"Italy","2024-10-17",0,0,73,0,0,78,0,0
"Italy","2024-10-18",0,0,73,0,1,79,0,0
"Italy","2024-10-19",0,0,73,0,0,79,0,0
"Italy","2024-10-20",0,0,73,0,0,79,0,0
"Italy","2024-10-21",0,0,73,0,1,80,0,0
"Italy","2024-10-22",0,0,73,0,0,80,0,0
"Italy","2024-10-23",0,0,73,0,0,80,0,0
"Italy","2024-10-24",0,0,73,0,1,81,0,0
"Italy","2024-10-25",0,0,73,0,0,81,0,0
"Italy","2024-10-26",0,0,73,0,0,81,0,0
"Italy","2024-10-27",0,0,73,0,1,82,0,0
"Italy","2024-10-28",0,0,73,0,0,82,0,0
"Italy","2024-10-29",0,0,73,0,0,82,0,0
"Italy","2024-10-30",0,0,73,0,1,83,0,0
"Italy","2024-10-31",0,10,83,0,0,83,0,0
"Italy","2024-11-01",0,0,83,0,0,83,0,0
"Italy","2024-11-02",0,0,83,0,0,83,0,0
"Italy","2024-11-03",0,0,83,0,1,84,0,0
"Italy","2024-11-04",0,0,83,0,0,84,0,0
"Italy","2024-11-05",0,0,83,0,0,84,0,0
"Italy","2024-11-06",0,0,83,0,0,84,0,0
"Italy","2024-11-07",0,0,83,0,1,85,0,0
"Italy","2024-11-08",0,0,83,0,0,85,0,0
"Italy","2024-11-09",0,0,83,0,0,85,0,0
"Italy","2024-11-10",0,0,83,0,0,85,0,0
"Italy","2024-11-11",0,0,83,0,1,86,0,0
"Italy","2024-11-12",0,0,83,0,0,86,0,0
"Italy","2024-11-13",0,0,83,0,0,86,0,0
"Italy","2024-11-14",0,0,83,0,0,86,0,0
"Italy","2024-11-15",0,0,83,0,1,87,0,0
"Italy","2024-11-16",0,0,83,0,0,87,0,0
"Italy","2024-11-17",0,0,83,0,0,87,0,0
"Italy","2024-11-18",0,0,83,0,0,87,0,0
"Italy","2024-11-19",0,0,83,0,0,87,0,0
"Italy","2024-11-20",0,0,83,0,1,88,0,0
"Italy","2024-11-21",0,0,83,0,0,88,0,0
"Italy","2024-11-22",0,0,83,0,0,88,0,0
"Italy","2024-11-23",0,0,83,0,0,88,0,0
"Italy","2024-11-24",0,0,83,0,1,89,0,0
"Italy","2024-11-25",0,0,83,0,0,89,0,0
"Italy","2024-11-26",0,0,83,0,0,89,0,0
"Italy","2024-11-27",0,0,83,0,0,89,0,0
"Italy","2024-11-28",0,0,83,0,1,90,0,0
"Italy","2024-11-29",0,0,83,0,0,90,0,0
"Italy","2024-11-30",0,7,90,0,0,90,0,0
"Italy","2024-12-01",0,0,90,0,0,90,0,0
"Italy","2024-12-02",0,0,90,0,1,91,0,0
"Italy","2024-12-03",0,0,90,0,0,91,0,0
"Italy","2024-12-04",0,0,90,0,0,91,0,0
"Italy","2024-12-05",0,0,90,0,0,91,0,0
"Italy","2024-12-06",0,0,90,0,1,92,0,0
"Italy","2024-12-07",0,0,90,0,0,92,0,0
"Italy","2024-12-08",0,0,90,0,0,92,0,0
"Italy","2024-12-09",0,0,90,0,0,92,0,0
"Italy","2024-12-10",0,0,90,0,1,93,0,0
"Italy","2024-12-11",0,0,90,0,0,93,0,0
"Italy","2024-12-12",0,0,90,0,0,93,0,0
"Italy","2024-12-13",0,0,90,0,0,93,0,0
"Italy","2024-12-14",0,0,90,0,1,94,0,0
"Italy","2024-12-15",0,0,90,0,0,94,0,0
"Italy","2024-12-16",0,0,90,0,0,94,0,0
"Italy","2024-12-17",0,0,90,0,0,94,0,0
"Italy","2024-12-18",0,0,90,0,1,95,0,0
"Italy","2024-12-19",0,0,90,0,0,95,0,0
"Italy","2024-12-20",0,0,90,0,0,95,0,0
"Italy","2024-12-21",0,0,90,0,0,95,0,0
"Italy","2024-12-22",0,0,90,0,1,96,0,0
"Italy","2024-12-23",0,0,90,0,0,96,0,0
"Italy","2024-12-24",0,0,90,0,0,96,0,0
"Italy","2024-12-25",0,0,90,0,0,96,0,0
"Italy","2024-12-26",0,0,90,0,1,97,0,0
"Italy","2024-12-27",0,0,90,0,0,97,0,0
"Italy","2024-12-28",0,0,90,0,0,97,0,0
"Italy","2024-12-29",0,0,90,0,0,97,0,0
"Italy","2024-12-30",0,0,90,0,1,98,0,0
"Italy","2024-12-31",0,8,98,0,0,98,0,0
"Italy","2025-01-01",0,0,98,0,2,100,0,0
"Italy","2025-01-02",0,0,98,0,2,102,0,0
"Italy","2025-01-03",0,0,98,0,3,105,0,0
"Italy","2025-01-04",0,0,98,0,2,107,0,0
"Italy","2025-01-05",0,0,98,0,2,109,0,0
"Italy","2025-01-06",0,0,98,0,2,111,0,0
"Italy","2025-01-07",0,0,98,0,2,113,0,0
"Italy","2025-01-08",0,0,98,0,3,116,0,0
"Italy","2025-01-09",0,0,98,0,2,118,0,0
"Italy","2025-01-10",0,22,120,0,2,120,0,0
"Italy","2025-01-11",0,0,120,0,0,120,0,0
"Italy","2025-01-12",0,0,120,0,0,120,0,0
"Italy","2025-01-13",0,0,120,0,0,120,0,0
"Italy","2025-01-14",0,0,120,0,0,120,0,0
"Italy","2025-01-15",0,0,120,0,0,120,0,0
"Italy","2025-01-16",0,0,120,0,0,120,0,0
"Italy","2025-01-17",0,0,120,0,0,120,0,0
"Italy","2025-01-18",0,0,120,0,0,120,0,0
"Italy","2025-01-19",0,0,120,0,0,120,0,0
"Italy","2025-01-20",0,0,120,0,0,120,0,0
"Italy","2025-01-21",0,0,120,0,0,120,0,0
"Italy","2025-01-22",0,0,120,0,0,120,0,0
"Italy","2025-01-23",0,0,120,0,0,120,0,0
"Italy","2025-01-24",0,0,120,0,0,120,0,0
"Italy","2025-01-25",0,0,120,0,0,120,0,0
"Italy","2025-01-26",0,0,120,0,0,120,0,0
"Italy","2025-01-27",0,0,120,0,0,120,0,0
"Italy","2025-01-28",0,0,120,0,0,120,0,0
"Italy","2025-01-29",0,0,120,0,0,120,0,0
"Italy","2025-01-30",0,0,120,0,0,120,0,0
"Italy","2025-01-31",0,0,120,0,0,120,0,0
"Italy","2025-02-01",0,0,120,0,0,120,0,0
"Italy","2025-02-02",0,0,120,0,0,120,0,0
"Italy","2025-02-03",0,0,120,0,0,120,0,0
"Italy","2025-02-04",0,0,120,0,0,120,0,0
"Italy","2025-02-05",0,0,120,0,0,120,0,0
"Italy","2025-02-06",0,0,120,0,0,120,0,0
"Italy","2025-02-07",0,0,120,0,0,120,0,0
"Italy","2025-02-08",0,0,120,0,0,120,0,0
"Italy","2025-02-09",0,0,120,0,0,120,0,0
"Italy","2025-02-10",0,0,120,0,0,120,0,0
"Italy","2025-02-11",0,0,120,0,0,120,0,0
"Italy","2025-02-12",0,0,120,0,0,120,0,0
"Italy","2025-02-13",0,0,120,0,0,120,0,0
"Italy","2025-02-14",0,0,120,0,0,120,0,0
"Italy","2025-02-15",0,0,120,0,0,120,0,0
"Italy","2025-02-16",0,0,120,0,0,120,0,0
"Italy","2025-02-17",0,0,120,0,0,120,0,0
"Italy","2025-02-18",0,0,120,0,0,120,0,0
"Italy","2025-02-19",0,0,120,0,0,120,0,0
"Italy","2025-02-20",0,0,120,0,0,120,0,0
"Italy","2025-02-21",0,0,120,0,0,120,0,0
"Italy","2025-02-22",0,0,120,0,0,120,0,0
"Italy","2025-02-23",0,0,120,0,0,120,0,0
"Italy","2025-02-24",0,0,120,0,0,120,0,0
"Italy","2025-02-25",0,0,120,0,0,120,0,0
"Italy","2025-02-26",0,0,120,0,0,120,0,0
"Italy","2025-02-27",0,0,120,0,0,120,0,0
"Italy","2025-02-28",0,0,120,0,0,120,0,0
"Italy","2025-03-01",0,0,120,0,0,120,0,0
"Italy","2025-03-02",0,0,120,0,0,120,0,0
"Italy","2025-03-03",0,0,120,0,0,120,0,0
"Jamaica","2024-01-01",0,0,0,0,0,0,0,0
"Jamaica","2024-01-02",0,0,0,0,0,0,0,0
"Jamaica","2024-01-03",0,0,0,0,0,0,0,0
"Jamaica","2024-01-04",0,0,0,0,0,0,0,0
"Jamaica","2024-01-05",0,0,0,0,0,0,0,0
"Jamaica","2024-01-06",0,0,0,0,0,0,0,0
"Jamaica","2024-01-07",0,0,0,0,0,0,0,0
"Jamaica","2024-01-08",0,0,0,0,0,0,0,0
"Jamaica","2024-01-09",0,0,0,0,0,0,0,0
"Jamaica","2024-01-10",0,0,0,0,0,0,0,0
"Jamaica","2024-01-11",0,0,0,0,0,0,0,0
"Jamaica","2024-01-12",0,0,0,0,0,0,0,0
"Jamaica","2024-01-13",0,0,0,0,0,0,0,0
"Jamaica","2024-01-14",0,0,0,0,0,0,0,0
"Jamaica","2024-01-15",0,0,0,0,0,0,0,0
"Jamaica","2024-01-16",0,0,0,0,0,0,0,0
"Jamaica","2024-01-17",0,0,0,0,0,0,0,0
"Jamaica","2024-01-18",0,0,0,0,0,0,0,0
"Jamaica","2024-01-19",0,0,0,0,0,0,0,0
"Jamaica","2024-01-20",0,0,0,0,0,0,0,0
"Jamaica","2024-01-21",0,0,0,0,0,0,0,0
"Jamaica","2024-01-22",0,0,0,0,0,0,0,0
"Jamaica","2024-01-23",0,0,0,0,0,0,0,0
"Jamaica","2024-01-24",0,0,0,0,0,0,0,0
"Jamaica","2024-01-25",0,0,0,0,0,0,0,0
"Jamaica","2024-01-26",0,0,0,0,0,0,0,0
"Jamaica","2024-01-27",0,0,0,0,0,0,0,0
"Jamaica","2024-01-28",0,0,0,0,0,0,0,0
"Jamaica","2024-01-29",0,0,0,0,0,0,0,0
"Jamaica","2024-01-30",0,0,0,0,0,0,0,0
"Jamaica","2024-01-31",0,0,0,0,0,0,0,0
"Jamaica","2024-02-01",0,0,0,0,0,0,0,0
"Jamaica","2024-02-02",0,0,0,0,0,0,0,0
"Jamaica","2024-02-03",0,0,0,0,0,0,0,0
"Jamaica","2024-02-04",0,0,0,0,0,0,0,0
"Jamaica","2024-02-05",0,0,0,0,0,0,0,0
"Jamaica","2024-02-06",0,0,0,0,0,0,0,0
"Jamaica","2024-02-07",0,0,0,0,0,0,0,0
"Jamaica","2024-02-08",0,0,0,0,0,0,0,0
"Jamaica","2024-02-09",0,0,0,0,0,0,0,0
"Jamaica","2024-02-10",0,0,0,0,0,0,0,0
"Jamaica","2024-02-11",0,0,0,0,0,0,0,0
"Jamaica","2024-02-12",0,0,0,0,0,0,0,0
"Jamaica","2024-02-13",0,0,0,0,0,0,0,0
"Jamaica","2024-02-14",0,0,0,0,0,0,0,0
"Jamaica","2024-02-15",0,0,0,0,0,0,0,0
"Jamaica","2024-02-16",0,0,0,0,0,0,0,0
"Jamaica","2024-02-17",0,0,0,0,0,0,0,0
"Jamaica","2024-02-18",0,0,0,0,0,0,0,0
"Jamaica","2024-02-19",0,0,0,0,0,0,0,0
"Jamaica","2024-02-20",0,0,0,0,0,0,0,0
"Jamaica","2024-02-21",0,0,0,0,0,0,0,0
"Jamaica","2024-02-22",0,0,0,0,0,0,0,0
"Jamaica","2024-02-23",0,0,0,0,0,0,0,0
"Jamaica","2024-02-24",0,0,0,0,0,0,0,0
"Jamaica","2024-02-25",0,0,0,0,0,0,0,0
"Jamaica","2024-02-26",0,0,0,0,0,0,0,0
"Jamaica","2024-02-27",0,0,0,0,0,0,0,0
"Jamaica","2024-02-28",0,0,0,0,0,0,0,0
"Jamaica","2024-02-29",0,0,0,0,0,0,0,0
"Jamaica","2024-03-01",0,0,0,0,0,0,0,0
"Jamaica","2024-03-02",0,0,0,0,0,0,0,0
"Jamaica","2024-03-03",0,0,0,0,0,0,0,0
"Jamaica","2024-03-04",0,0,0,0,0,0,0,0
"Jamaica","2024-03-05",0,0,0,0,0,0,0,0
"Jamaica","2024-03-06",0,0,0,0,0,0,0,0
"Jamaica","2024-03-07",0,0,0,0,0,0,0,0
"Jamaica","2024-03-08",0,0,0,0,0,0,0,0
"Jamaica","2024-03-09",0,0,0,0,0,0,0,0
"Jamaica","2024-03-10",0,0,0,0,0,0,0,0
"Jamaica","2024-03-11",0,0,0,0,0,0,0,0
"Jamaica","2024-03-12",0,0,0,0,0,0,0,0
"Jamaica","2024-03-13",0,0,0,0,0,0,0,0
"Jamaica","2024-03-14",0,0,0,0,0,0,0,0
"Jamaica","2024-03-15",0,0,0,0,0,0,0,0
"Jamaica","2024-03-16",0,0,0,0,0,0,0,0
"Jamaica","2024-03-17",0,0,0,0,0,0,0,0
"Jamaica","2024-03-18",0,0,0,0,0,0,0,0
"Jamaica","2024-03-19",0,0,0,0,0,0,0,0
"Jamaica","2024-03-20",0,0,0,0,0,0,0,0
"Jamaica","2024-03-21",0,0,0,0,0,0,0,0
"Jamaica","2024-03-22",0,0,0,0,0,0,0,0
"Jamaica","2024-03-23",0,0,0,0,0,0,0,0
"Jamaica","2024-03-24",0,0,0,0,0,0,0,0
"Jamaica","2024-03-25",0,0,0,0,0,0,0,0
"Jamaica","2024-03-26",0,0,0,0,0,0,0,0
"Jamaica","2024-03-27",0,0,0,0,0,0,0,0
"Jamaica","2024-03-28",0,0,0,0,0,0,0,0
"Jamaica","2024-03-29",0,0,0,0,0,0,0,0
"Jamaica","2024-03-30",0,0,0,0,0,0,0,0
"Jamaica","2024-03-31",0,0,0,0,0,0,0,0
"Jamaica","2024-04-01",0,0,0,0,0,0,0,0
"Jamaica","2024-04-02",0,0,0,0,0,0,0,0
"Jamaica","2024-04-03",0,0,0,0,0,0,0,0
"Jamaica","2024-04-04",0,0,0,0,0,0,0,0
"Jamaica","2024-04-05",0,0,0,0,0,0,0,0
"Jamaica","2024-04-06",0,0,0,0,0,0,0,0
"Jamaica","2024-04-07",0,0,0,0,0,0,0,0
"Jamaica","2024-04-08",0,0,0,0,0,0,0,0
"Jamaica","2024-04-09",0,0,0,0,0,0,0,0
"Jamaica","2024-04-10",0,0,0,0,0,0,0,0
"Jamaica","2024-04-11",0,0,0,0,0,0,0,0
"Jamaica","2024-04-12",0,0,0,0,0,0,0,0
"Jamaica","2024-04-13",0,0,0,0,0,0,0,0
"Jamaica","2024-04-14",0,0,0,0,0,0,0,0
"Jamaica","2024-04-15",0,0,0,0,0,0,0,0
"Jamaica","2024-04-16",0,0,0,0,0,0,0,0
"Jamaica","2024-04-17",0,0,0,0,0,0,0,0
"Jamaica","2024-04-18",0,0,0,0,0,0,0,0
"Jamaica","2024-04-19",0,0,0,0,0,0,0,0
"Jamaica","2024-04-20",0,0,0,0,0,0,0,0
"Jamaica","2024-04-21",0,0,0,0,0,0,0,0
"Jamaica","2024-04-22",0,0,0,0,0,0,0,0
"Jamaica","2024-04-23",0,0,0,0,0,0,0,0
"Jamaica","2024-04-24",0,0,0,0,0,0,0,0
"Jamaica","2024-04-25",0,0,0,0,0,0,0,0
"Jamaica","2024-04-26",0,0,0,0,0,0,0,0
"Jamaica","2024-04-27",0,0,0,0,0,0,0,0
"Jamaica","2024-04-28",0,0,0,0,0,0,0,0
"Jamaica","2024-04-29",0,0,0,0,0,0,0,0
"Jamaica","2024-04-30",0,0,0,0,0,0,0,0
"Jamaica","2024-05-01",0,0,0,0,0,0,0,0
"Jamaica","2024-05-02",0,0,0,0,0,0,0,0
"Jamaica","2024-05-03",0,0,0,0,0,0,0,0
"Jamaica","2024-05-04",0,0,0,0,0,0,0,0
"Jamaica","2024-05-05",0,0,0,0,0,0,0,0
"Jamaica","2024-05-06",0,0,0,0,0,0,0,0
"Jamaica","2024-05-07",0,0,0,0,0,0,0,0
"Jamaica","2024-05-08",0,0,0,0,0,0,0,0
"Jamaica","2024-05-09",0,0,0,0,0,0,0,0
"Jamaica","2024-05-10",0,0,0,0,0,0,0,0
"Jamaica","2024-05-11",0,0,0,0,0,0,0,0
"Jamaica","2024-05-12",0,0,0,0,0,0,0,0
"Jamaica","2024-05-13",0,0,0,0,0,0,0,0
"Jamaica","2024-05-14",0,0,0,0,0,0,0,0
"Jamaica","2024-05-15",0,0,0,0,0,0,0,0
"Jamaica","2024-05-16",0,0,0,0,0,0,0,0
"Jamaica","2024-05-17",0,0,0,0,0,0,0,0
"Jamaica","2024-05-18",0,0,0,0,0,0,0,0
"Jamaica","2024-05-19",0,0,0,0,0,0,0,0
"Jamaica","2024-05-20",0,0,0,0,0,0,0,0
"Jamaica","2024-05-21",0,0,0,0,0,0,0,0
"Jamaica","2024-05-22",0,0,0,0,0,0,0,0
"Jamaica","2024-05-23",0,0,0,0,0,0,0,0
"Jamaica","2024-05-24",0,0,0,0,0,0,0,0
"Jamaica","2024-05-25",0,0,0,0,0,0,0,0
"Jamaica","2024-05-26",0,0,0,0,0,0,0,0
"Jamaica","2024-05-27",0,0,0,0,0,0,0,0
"Jamaica","2024-05-28",0,0,0,0,0,0,0,0
"Jamaica","2024-05-29",0,0,0,0,0,0,0,0
"Jamaica","2024-05-30",0,0,0,0,0,0,0,0
"Jamaica","2024-05-31",0,0,0,0,0,0,0,0
"Jamaica","2024-06-01",0,0,0,0,0,0,0,0
"Jamaica","2024-06-02",0,0,0,0,0,0,0,0
"Jamaica","2024-06-03",0,0,0,0,0,0,0,0
"Jamaica","2024-06-04",0,0,0,0,0,0,0,0
"Jamaica","2024-06-05",0,0,0,0,0,0,0,0
"Jamaica","2024-06-06",0,0,0,0,0,0,0,0
"Jamaica","2024-06-07",0,0,0,0,0,0,0,0
"Jamaica","2024-06-08",0,0,0,0,0,0,0,0
"Jamaica","2024-06-09",0,0,0,0,0,0,0,0
"Jamaica","2024-06-10",0,0,0,0,0,0,0,0
"Jamaica","2024-06-11",0,0,0,0,0,0,0,0
"Jamaica","2024-06-12",0,0,0,0,0,0,0,0
"Jamaica","2024-06-13",0,0,0,0,0,0,0,0
"Jamaica","2024-06-14",0,0,0,0,0,0,0,0
"Jamaica","2024-06-15",0,0,0,0,0,0,0,0
"Jamaica","2024-06-16",0,0,0,0,0,0,0,0
"Jamaica","2024-06-17",0,0,0,0,0,0,0,0
"Jamaica","2024-06-18",0,0,0,0,0,0,0,0
"Jamaica","2024-06-19",0,0,0,0,0,0,0,0
"Jamaica","2024-06-20",0,0,0,0,0,0,0,0
"Jamaica","2024-06-21",0,0,0,0,0,0,0,0
"Jamaica","2024-06-22",0,0,0,0,0,0,0,0
"Jamaica","2024-06-23",0,0,0,0,0,0,0,0
"Jamaica","2024-06-24",0,0,0,0,0,0,0,0
"Jamaica","2024-06-25",0,0,0,0,0,0,0,0
"Jamaica","2024-06-26",0,0,0,0,0,0,0,0
"Jamaica","2024-06-27",0,0,0,0,0,0,0,0
"Jamaica","2024-06-28",0,0,0,0,0,0,0,0
"Jamaica","2024-06-29",0,0,0,0,0,0,0,0
"Jamaica","2024-06-30",0,0,0,0,0,0,0,0
"Jamaica","2024-07-01",0,0,0,0,0,0,0,0
"Jamaica","2024-07-02",0,0,0,0,0,0,0,0
"Jamaica","2024-07-03",0,0,0,0,0,0,0,0
"Jamaica","2024-07-04",0,0,0,0,0,0,0,0
"Jamaica","2024-07-05",0,0,0,0,0,0,0,0
"Jamaica","2024-07-06",0,0,0,0,0,0,0,0
"Jamaica","2024-07-07",0,0,0,0,0,0,0,0
"Jamaica","2024-07-08",0,0,0,0,0,0,0,0
"Jamaica","2024-07-09",0,0,0,0,0,0,0,0
"Jamaica","2024-07-10",0,0,0,0,0,0,0,0
"Jamaica","2024-07-11",0,0,0,0,0,0,0,0
"Jamaica","2024-07-12",0,0,0,0,0,0,0,0
"Jamaica","2024-07-13",0,0,0,0,0,0,0,0
"Jamaica","2024-07-14",0,0,0,0,0,0,0,0
"Jamaica","2024-07-15",0,0,0,0,0,0,0,0
"Jamaica","2024-07-16",0,0,0,0,0,0,0,0
"Jamaica","2024-07-17",0,0,0,0,0,0,0,0
"Jamaica","2024-07-18",0,0,0,0,0,0,0,0
"Jamaica","2024-07-19",0,0,0,0,0,0,0,0
"Jamaica","2024-07-20",0,0,0,0,0,0,0,0
"Jamaica","2024-07-21",0,0,0,0,0,0,0,0
"Jamaica","2024-07-22",0,0,0,0,0,0,0,0
"Jamaica","2024-07-23",0,0,0,0,0,0,0,0
"Jamaica","2024-07-24",0,0,0,0,0,0,0,0
"Jamaica","2024-07-25",0,0,0,0,0,0,0,0
"Jamaica","2024-07-26",0,0,0,0,0,0,0,0
"Jamaica","2024-07-27",0,0,0,0,0,0,0,0
"Jamaica","2024-07-28",0,0,0,0,0,0,0,0
"Jamaica","2024-07-29",0,0,0,0,0,0,0,0
"Jamaica","2024-07-30",0,0,0,0,0,0,0,0
"Jamaica","2024-07-31",0,0,0,0,0,0,0,0
"Jamaica","2024-08-01",0,0,0,0,0,0,0,0
"Jamaica","2024-08-02",0,0,0,0,0,0,0,0
"Jamaica","2024-08-03",0,0,0,0,0,0,0,0
"Jamaica","2024-08-04",0,0,0,0,0,0,0,0
"Jamaica","2024-08-05",0,0,0,0,0,0,0,0
"Jamaica","2024-08-06",0,0,0,0,0,0,0,0
"Jamaica","2024-08-07",0,0,0,0,0,0,0,0
"Jamaica","2024-08-08",0,0,0,0,0,0,0,0
"Jamaica","2024-08-09",0,0,0,0,0,0,0,0
"Jamaica","2024-08-10",0,0,0,0,0,0,0,0
"Jamaica","2024-08-11",0,0,0,0,0,0,0,0
"Jamaica","2024-08-12",0,0,0,0,0,0,0,0
"Jamaica","2024-08-13",0,0,0,0,0,0,0,0
"Jamaica","2024-08-14",0,0,0,0,0,0,0,0
"Jamaica","2024-08-15",0,0,0,0,0,0,0,0
"Jamaica","2024-08-16",0,0,0,0,0,0,0,0
"Jamaica","2024-08-17",0,0,0,0,0,0,0,0
"Jamaica","2024-08-18",0,0,0,0,0,0,0,0
"Jamaica","2024-08-19",0,0,0,0,0,0,0,0
"Jamaica","2024-08-20",0,0,0,0,0,0,0,0
"Jamaica","2024-08-21",0,0,0,0,0,0,0,0
"Jamaica","2024-08-22",0,0,0,0,0,0,0,0
"Jamaica","2024-08-23",0,0,0,0,0,0,0,0
"Jamaica","2024-08-24",0,0,0,0,0,0,0,0
"Jamaica","2024-08-25",0,0,0,0,0,0,0,0
"Jamaica","2024-08-26",0,0,0,0,0,0,0,0
"Jamaica","2024-08-27",0,0,0,0,0,0,0,0
"Jamaica","2024-08-28",0,0,0,0,0,0,0,0
"Jamaica","2024-08-29",0,0,0,0,0,0,0,0
"Jamaica","2024-08-30",0,0,0,0,0,0,0,0
"Jamaica","2024-08-31",0,0,0,0,0,0,0,0
"Jamaica","2024-09-01",0,0,0,0,0,0,0,0
"Jamaica","2024-09-02",0,0,0,0,0,0,0,0
"Jamaica","2024-09-03",0,0,0,0,0,0,0,0
"Jamaica","2024-09-04",0,0,0,0,0,0,0,0
"Jamaica","2024-09-05",0,0,0,0,0,0,0,0
"Jamaica","2024-09-06",0,0,0,0,0,0,0,0
"Jamaica","2024-09-07",0,0,0,0,0,0,0,0
"Jamaica","2024-09-08",0,0,0,0,0,0,0,0
"Jamaica","2024-09-09",0,0,0,0,0,0,0,0
"Jamaica","2024-09-10",0,0,0,0,0,0,0,0
"Jamaica","2024-09-11",0,0,0,0,0,0,0,0
"Jamaica","2024-09-12",0,0,0,0,0,0,0,0
"Jamaica","2024-09-13",0,0,0,0,0,0,0,0
"Jamaica","2024-09-14",0,0,0,0,0,0,0,0
"Jamaica","2024-09-15",0,0,0,0,0,0,0,0
"Jamaica","2024-09-16",0,0,0,0,0,0,0,0
"Jamaica","2024-09-17",0,0,0,0,0,0,0,0
"Jamaica","2024-09-18",0,0,0,0,0,0,0,0
"Jamaica","2024-09-19",0,0,0,0,0,0,0,0
"Jamaica","2024-09-20",0,0,0,0,0,0,0,0
"Jamaica","2024-09-21",0,0,0,0,0,0,0,0
"Jamaica","2024-09-22",0,0,0,0,0,0,0,0
"Jamaica","2024-09-23",0,0,0,0,0,0,0,0
"Jamaica","2024-09-24",0,0,0,0,0,0,0,0
"Jamaica","2024-09-25",0,0,0,0,0,0,0,0
"Jamaica","2024-09-26",0,0,0,0,0,0,0,0
"Jamaica","2024-09-27",0,0,0,0,0,0,0,0
"Jamaica","2024-09-28",0,0,0,0,0,0,0,0
"Jamaica","2024-09-29",0,0,0,0,0,0,0,0
"Jamaica","2024-09-30",0,0,0,0,0,0,0,0
"Jamaica","2024-10-01",0,0,0,0,0,0,0,0
"Jamaica","2024-10-02",0,0,0,0,0,0,0,0
"Jamaica","2024-10-03",0,0,0,0,0,0,0,0
"Jamaica","2024-10-04",0,0,0,0,0,0,0,0
"Jamaica","2024-10-05",0,0,0,0,0,0,0,0
"Jamaica","2024-10-06",0,0,0,0,0,0,0,0
"Jamaica","2024-10-07",0,0,0,0,0,0,0,0
"Jamaica","2024-10-08",0,0,0,0,0,0,0,0
"Jamaica","2024-10-09",0,0,0,0,0,0,0,0
"Jamaica","2024-10-10",0,0,0,0,0,0,0,0
"Jamaica","2024-10-11",0,0,0,0,0,0,0,0
"Jamaica","2024-10-12",0,0,0,0,0,0,0,0
"Jamaica","2024-10-13",0,0,0,0,0,0,0,0
"Jamaica","2024-10-14",0,0,0,0,0,0,0,0
"Jamaica","2024-10-15",0,0,0,0,0,0,0,0
"Jamaica","2024-10-16",0,0,0,0,0,0,0,0
"Jamaica","2024-10-17",0,0,0,0,0,0,0,0
"Jamaica","2024-10-18",0,0,0,0,0,0,0,0
"Jamaica","2024-10-19",0,0,0,0,0,0,0,0
"Jamaica","2024-10-20",0,0,0,0,0,0,0,0
"Jamaica","2024-10-21",0,0,0,0,0,0,0,0
"Jamaica","2024-10-22",0,0,0,0,0,0,0,0
"Jamaica","2024-10-23",0,0,0,0,0,0,0,0
"Jamaica","2024-10-24",0,0,0,0,0,0,0,0
"Jamaica","2024-10-25",0,0,0,0,0,0,0,0
"Jamaica","2024-10-26",0,0,0,0,0,0,0,0
"Jamaica","2024-10-27",0,0,0,0,0,0,0,0
"Jamaica","2024-10-28",0,0,0,0,0,0,0,0
"Jamaica","2024-10-29",0,0,0,0,0,0,0,0
"Jamaica","2024-10-30",0,0,0,0,0,0,0,0
"Jamaica","2024-10-31",0,0,0,0,0,0,0,0
"Jamaica","2024-11-01",0,0,0,0,0,0,0,0
"Jamaica","2024-11-02",0,0,0,0,0,0,0,0
"Jamaica","2024-11-03",0,0,0,0,0,0,0,0
"Jamaica","2024-11-04",0,0,0,0,0,0,0,0
"Jamaica","2024-11-05",0,0,0,0,0,0,0,0
"Jamaica","2024-11-06",0,0,0,0,0,0,0,0
"Jamaica","2024-11-07",0,0,0,0,0,0,0,0
"Jamaica","2024-11-08",0,0,0,0,0,0,0,0
"Jamaica","2024-11-09",0,0,0,0,0,0,0,0
"Jamaica","2024-11-10",0,0,0,0,0,0,0,0
"Jamaica","2024-11-11",0,0,0,0,0,0,0,0
"Jamaica","2024-11-12",0,0,0,0,0,0,0,0
"Jamaica","2024-11-13",0,0,0,0,0,0,0,0
"Jamaica","2024-11-14",0,0,0,0,0,0,0,0
"Jamaica","2024-11-15",0,0,0,0,0,0,0,0
"Jamaica","2024-11-16",0,0,0,0,0,0,0,0
"Jamaica","2024-11-17",0,0,0,0,0,0,0,0
"Jamaica","2024-11-18",0,0,0,0,0,0,0,0
"Jamaica","2024-11-19",0,0,0,0,0,0,0,0
"Jamaica","2024-11-20",0,0,0,0,0,0,0,0
"Jamaica","2024-11-21",0,0,0,0,0,0,0,0
"Jamaica","2024-11-22",0,0,0,0,0,0,0,0
"Jamaica","2024-11-23",0,0,0,0,0,0,0,0
"Jamaica","2024-11-24",0,0,0,0,0,0,0,0
"Jamaica","2024-11-25",0,0,0,0,0,0,0,0
"Jamaica","2024-11-26",0,0,0,0,0,0,0,0
"Jamaica","2024-11-27",0,0,0,0,0,0,0,0
"Jamaica","2024-11-28",0,0,0,0,0,0,0,0
"Jamaica","2024-11-29",0,0,0,0,0,0,0,0
"Jamaica","2024-11-30",0,0,0,0,0,0,0,0
"Jamaica","2024-12-01",0,0,0,0,0,0,0,0
"Jamaica","2024-12-02",0,0,0,0,0,0,0,0
"Jamaica","2024-12-03",0,0,0,0,0,0,0,0
"Jamaica","2024-12-04",0,0,0,0,0,0,0,0
"Jamaica","2024-12-05",0,0,0,0,0,0,0,0
"Jamaica","2024-12-06",0,0,0,0,0,0,0,0
"Jamaica","2024-12-07",0,0,0,0,0,0,0,0
"Jamaica","2024-12-08",0,0,0,0,0,0,0,0
"Jamaica","2024-12-09",0,0,0,0,0,0,0,0
"Jamaica","2024-12-10",0,0,0,0,0,0,0,0
"Jamaica","2024-12-11",0,0,0,0,0,0,0,0
"Jamaica","2024-12-12",0,0,0,0,0,0,0,0
"Jamaica","2024-12-13",0,0,0,0,0,0,0,0
"Jamaica","2024-12-14",0,0,0,0,0,0,0,0
"Jamaica","2024-12-15",0,0,0,0,0,0,0,0
"Jamaica","2024-12-16",0,0,0,0,0,0,0,0
"Jamaica","2024-12-17",0,0,0,0,0,0,0,0
"Jamaica","2024-12-18",0,0,0,0,0,0,0,0
"Jamaica","2024-12-19",0,0,0,0,0,0,0,0
"Jamaica","2024-12-20",0,0,0,0,0,0,0,0
"Jamaica","2024-12-21",0,0,0,0,0,0,0,0
"Jamaica","2024-12-22",0,0,0,0,0,0,0,0
"Jamaica","2024-12-23",0,0,0,0,0,0,0,0
"Jamaica","2024-12-24",0,0,0,0,0,0,0,0
"Jamaica","2024-12-25",0,0,0,0,0,0,0,0
"Jamaica","2024-12-26",0,0,0,0,0,0,0,0
"Jamaica","2024-12-27",0,0,0,0,0,0,0,0
"Jamaica","2024-12-28",0,0,0,0,0,0,0,0
"Jamaica","2024-12-29",0,0,0,0,0,0,0,0
"Jamaica","2024-12-30",0,0,0,0,0,0,0,0
"Jamaica","2024-12-31",0,0,0,0,0,0,0,0
"Jamaica","2025-01-01",0,0,0,0,0,0,0,0
"Jamaica","2025-01-02",0,0,0,0,0,0,0,0
"Jamaica","2025-01-03",0,0,0,0,0,0,0,0
"Jamaica","2025-01-04",0,0,0,0,0,0,0,0
"Jamaica","2025-01-05",0,0,0,0,0,0,0,0
"Jamaica","2025-01-06",0,0,0,0,0,0,0,0
"Jamaica","2025-01-07",0,0,0,0,0,0,0,0
"Jamaica","2025-01-08",0,0,0,0,0,0,0,0
"Jamaica","2025-01-09",0,0,0,0,0,0,0,0
"Jamaica","2025-01-10",0,0,0,0,0,0,0,0
"Jamaica","2025-01-11",0,0,0,0,0,0,0,0
"Jamaica","2025-01-12",0,0,0,0,0,0,0,0
"Jamaica","2025-01-13",0,0,0,0,0,0,0,0
"Jamaica","2025-01-14",0,0,0,0,0,0,0,0
"Jamaica","2025-01-15",0,0,0,0,0,0,0,0
"Jamaica","2025-01-16",0,0,0,0,0,0,0,0
"Jamaica","2025-01-17",0,0,0,0,0,0,0,0
"Jamaica","2025-01-18",0,0,0,0,0,0,0,0
"Jamaica","2025-01-19",0,0,0,0,0,0,0,0
"Jamaica","2025-01-20",0,0,0,0,0,0,0,0
"Jamaica","2025-01-21",0,0,0,0,0,0,0,0
"Jamaica","2025-01-22",0,0,0,0,0,0,0,0
"Jamaica","2025-01-23",0,0,0,0,0,0,0,0
"Jamaica","2025-01-24",0,0,0,0,0,0,0,0
"Jamaica","2025-01-25",0,0,0,0,0,0,0,0
"Jamaica","2025-01-26",0,0,0,0,0,0,0,0
"Jamaica","2025-01-27",0,0,0,0,0,0,0,0
"Jamaica","2025-01-28",0,0,0,0,0,0,0,0
"Jamaica","2025-01-29",0,0,0,0,0,0,0,0
"Jamaica","2025-01-30",0,0,0,0,0,0,0,0
"Jamaica","2025-01-31",0,0,0,0,0,0,0,0
"Jamaica","2025-02-01",0,0,0,0,0,0,0,0
"Jamaica","2025-02-02",0,0,0,0,0,0,0,0
"Jamaica","2025-02-03",0,0,0,0,0,0,0,0
"Jamaica","2025-02-04",0,0,0,0,0,0,0,0
"Jamaica","2025-02-05",0,0,0,0,0,0,0,0
"Jamaica","2025-02-06",0,0,0,0,0,0,0,0
"Jamaica","2025-02-07",0,0,0,0,0,0,0,0
"Jamaica","2025-02-08",0,0,0,0,0,0,0,0
"Jamaica","2025-02-09",0,0,0,0,0,0,0,0
"Jamaica","2025-02-10",0,0,0,0,0,0,0,0
"Jamaica","2025-02-11",0,0,0,0,0,0,0,0
"Jamaica","2025-02-12",0,0,0,0,0,0,0,0
"Jamaica","2025-02-13",0,0,0,0,0,0,0,0
"Jamaica","2025-02-14",0,0,0,0,0,0,0,0
"Jamaica","2025-02-15",0,0,0,0,0,0,0,0
"Jamaica","2025-02-16",0,0,0,0,0,0,0,0
"Jamaica","2025-02-17",0,0,0,0,0,0,0,0
"Jamaica","2025-02-18",0,0,0,0,0,0,0,0
"Jamaica","2025-02-19",0,0,0,0,0,0,0,0
"Jamaica","2025-02-20",0,0,0,0,0,0,0,0
"Jamaica","2025-02-21",0,0,0,0,0,0,0,0
"Jamaica","2025-02-22",0,0,0,0,0,0,0,0
"Jamaica","2025-02-23",0,0,0,0,0,0,0,0
"Jamaica","2025-02-24",0,0,0,0,0,0,0,0
"Jamaica","2025-02-25",0,0,0,0,0,0,0,0
"Jamaica","2025-02-26",0,0,0,0,0,0,0,0
"Jamaica","2025-02-27",0,0,0,0,0,0,0,0
"Jamaica","2025-02-28",0,0,0,0,0,0,0,0
"Jamaica","2025-03-01",0,0,0,0,0,0,0,0
"Jamaica","2025-03-02",0,0,0,0,0,0,0,0
"Jamaica","2025-03-03",0,0,0,0,0,0,0,0
"Japan","2024-01-01",0,0,0,0,0,0,0,0
"Japan","2024-01-02",0,0,0,0,0,0,0,0
"Japan","2024-01-03",0,0,0,0,0,0,0,0
"Japan","2024-01-04",0,0,0,0,0,0,0,0
"Japan","2024-01-05",0,0,0,0,0,0,0,0
"Japan","2024-01-06",0,0,0,0,0,0,0,0
"Japan","2024-01-07",0,0,0,0,0,0,0,0
"Japan","2024-01-08",0,0,0,0,0,0,0,0
"Japan","2024-01-09",0,1,1,0,1,1,0,0
"Japan","2024-01-10",0,0,1,0,0,1,0,0
"Japan","2024-01-11",0,0,1,0,0,1,0,0
"Japan","2024-01-12",0,0,1,0,0,1,0,0
"Japan","2024-01-13",0,0,1,0,0,1,0,0
"Japan","2024-01-14",0,0,1,0,0,1,0,0
"Japan","2024-01-15",0,0,1,0,1,2,0,0
"Japan","2024-01-16",0,0,1,0,0,2,0,0
"Japan","2024-01-17",0,0,1,0,0,2,0,0
"Japan","2024-01-18",0,0,1,0,0,2,0,0
"Japan","2024-01-19",0,1,2,0,0,2,0,0
"Japan","2024-01-20",0,0,2,0,0,2,0,0
"Japan","2024-01-21",0,0,2,0,0,2,0,0
"Japan","2024-01-22",0,0,2,0,1,3,0,0
"Japan","2024-01-23",0,0,2,0,0,3,0,0
"Japan","2024-01-24",0,0,2,0,0,3,0,0
"Japan","2024-01-25",0,0,2,0,0,3,0,0
"Japan","2024-01-26",0,0,2,0,1,4,0,0
"Japan","2024-01-27",0,0,2,0,0,4,0,0
"Japan","2024-01-28",0,0,2,0,0,4,0,0
"Japan","2024-01-29",0,0,2,0,0,4,0,0
"Japan","2024-01-30",0,0,2,0,0,4,0,0
"Japan","2024-01-31",0,0,2,0,1,5,0,0
"Japan","2024-02-01",0,0,2,0,0,5,0,0
"Japan","2024-02-02",0,3,5,0,0,5,0,0
"Japan","2024-02-03",0,0,5,0,1,6,0,0
"Japan","2024-02-04",0,0,5,0,1,7,0,0
"Japan","2024-02-05",0,3,8,0,1,8,0,0
"Japan","2024-02-06",0,0,8,0,0,8,0,0
"Japan","2024-02-07",0,0,8,0,0,8,0,0
"Japan","2024-02-08",0,0,8,0,0,8,0,0
"Japan","2024-02-09",0,0,8,0,0,8,0,0
"Japan","2024-02-10",0,0,8,0,0,8,0,0
"Japan","2024-02-11",0,0,8,0,0,8,0,0
"Japan","2024-02-12",0,0,8,0,0,8,0,0
"Japan","2024-02-13",0,0,8,0,0,8,0,0
"Japan","2024-02-14",0,0,8,0,0,8,0,0
"Japan","2024-02-15",0,0,8,0,0,8,0,0
"Japan","2024-02-16",0,0,8,0,0,8,0,0
"Japan","2024-02-17",0,0,8,0,0,8,0,0
"Japan","2024-02-18",0,0,8,0,1,9,0,0
"Japan","2024-02-19",0,0,8,0,0,9,0,0
"Japan","2024-02-20",0,0,8,0,0,9,0,0
"Japan","2024-02-21",0,0,8,0,0,9,0,0
"Japan","2024-02-22",0,0,8,0,0,9,0,0
"Japan","2024-02-23",0,0,8,0,0,9,0,0
"Japan","2024-02-24",0,0,8,0,0,9,0,0
"Japan","2024-02-25",0,0,8,0,0,9,0,0
"Japan","2024-02-26",0,0,8,0,0,9,0,0
"Japan","2024-02-27",0,0,8,0,0,9,0,0
"Japan","2024-02-28",0,0,8,0,0,9,0,0
"Japan","2024-02-29",0,0,8,0,0,9,0,0
"Japan","2024-03-01",0,1,9,0,0,9,0,0
"Japan","2024-03-02",0,0,9,0,0,9,0,0
"Japan","2024-03-03",0,0,9,0,0,9,0,0
"Japan","2024-03-04",0,0,9,0,0,9,0,0
"Japan","2024-03-05",0,0,9,0,1,10,0,0
"Japan","2024-03-06",0,0,9,0,0,10,0,0
"Japan","2024-03-07",0,0,9,0,0,10,0,0
"Japan","2024-03-08",0,1,10,0,0,10,0,0
"Japan","2024-03-09",0,0,10,0,0,10,0,0
"Japan","2024-03-10",0,0,10,0,0,10,0,0
"Japan","2024-03-11",0,0,10,0,0,10,0,0
"Japan","2024-03-12",0,0,10,0,0,10,0,0
"Japan","2024-03-13",0,0,10,0,0,10,0,0
"Japan","2024-03-14",0,0,10,0,0,10,0,0
"Japan","2024-03-15",0,0,10,0,0,10,0,0
"Japan","2024-03-16",0,0,10,0,0,10,0,0
"Japan","2024-03-17",0,0,10,0,0,10,0,0
"Japan","2024-03-18",0,0,10,0,0,10,0,0
"Japan","2024-03-19",0,0,10,0,0,10,0,0
"Japan","2024-03-20",0,0,10,0,0,10,0,0
"Japan","2024-03-21",0,0,10,0,0,10,0,0
"Japan","2024-03-22",0,0,10,0,0,10,0,0
"Japan","2024-03-23",0,0,10,0,1,11,0,0
"Japan","2024-03-24",0,0,10,0,0,11,0,0
"Japan","2024-03-25",0,0,10,0,0,11,0,0
"Japan","2024-03-26",0,0,10,0,0,11,0,0
"Japan","2024-03-27",0,0,10,0,0,11,0,0
"Japan","2024-03-28",0,0,10,0,0,11,0,0
"Japan","2024-03-29",0,0,10,0,0,11,0,0
"Japan","2024-03-30",0,0,10,0,0,11,0,0
"Japan","2024-03-31",0,0,10,0,0,11,0,0
"Japan","2024-04-01",0,0,10,0,0,11,0,0
"Japan","2024-04-02",0,0,10,0,0,11,0,0
"Japan","2024-04-03",0,0,10,0,0,11,0,0
"Japan","2024-04-04",0,0,10,0,0,11,0,0
"Japan","2024-04-05",0,1,11,0,0,11,0,0
"Japan","2024-04-06",0,0,11,0,0,11,0,0
"Japan","2024-04-07",0,0,11,0,0,11,0,0
"Japan","2024-04-08",0,0,11,0,0,11,0,0
"Japan","2024-04-09",0,0,11,0,1,12,0,0
"Japan","2024-04-10",0,0,11,0,0,12,0,0
"Japan","2024-04-11",0,0,11,0,0,12,0,0
"Japan","2024-04-12",0,1,12,0,0,12,0,0
"Japan","2024-04-13",0,0,12,0,0,12,0,0
"Japan","2024-04-14",0,0,12,0,0,12,0,0
"Japan","2024-04-15",0,0,12,0,0,12,0,0
"Japan","2024-04-16",0,0,12,0,1,13,0,0
"Japan","2024-04-17",0,0,12,0,0,13,0,0
"Japan","2024-04-18",0,0,12,0,0,13,0,0
"Japan","2024-04-19",0,1,13,0,0,13,0,0
"Japan","2024-04-20",0,0,13,0,0,13,0,0
"Japan","2024-04-21",0,0,13,0,0,13,0,0
"Japan","2024-04-22",0,0,13,0,0,13,0,0
"Japan","2024-04-23",0,0,13,0,0,13,0,0
"Japan","2024-04-24",0,0,13,0,0,13,0,0
"Japan","2024-04-25",0,0,13,0,0,13,0,0
"Japan","2024-04-26",0,0,13,0,0,13,0,0
"Japan","2024-04-27",0,0,13,0,0,13,0,0
"Japan","2024-04-28",0,0,13,0,0,13,0,0
"Japan","2024-04-29",0,0,13,0,0,13,0,0
"Japan","2024-04-30",0,0,13,0,1,14,0,0
"Japan","2024-05-01",0,0,13,0,0,14,0,0
"Japan","2024-05-02",0,0,13,0,0,14,0,0
"Japan","2024-05-03",0,0,13,0,0,14,0,0
"Japan","2024-05-04",0,0,13,0,0,14,0,0
"Japan","2024-05-05",0,0,13,0,0,14,0,0
"Japan","2024-05-06",0,0,13,0,0,14,0,0
"Japan","2024-05-07",0,0,13,0,0,14,0,0
"Japan","2024-05-08",0,0,13,0,0,14,0,0
"Japan","2024-05-09",0,0,13,0,0,14,0,0
"Japan","2024-05-10",0,1,14,0,0,14,0,0
"Japan","2024-05-11",0,0,14,0,0,14,0,0
"Japan","2024-05-12",0,0,14,0,0,14,0,0
"Japan","2024-05-13",0,0,14,0,0,14,0,0
"Japan","2024-05-14",0,0,14,0,0,14,0,0
"Japan","2024-05-15",0,0,14,0,0,14,0,0
"Japan","2024-05-16",0,0,14,0,0,14,0,0
"Japan","2024-05-17",0,0,14,0,0,14,0,0
"Japan","2024-05-18",0,0,14,0,1,15,0,0
"Japan","2024-05-19",0,0,14,0,0,15,0,0
"Japan","2024-05-20",0,0,14,0,0,15,0,0
"Japan","2024-05-21",0,0,14,0,0,15,0,0
"Japan","2024-05-22",0,0,14,0,0,15,0,0
"Japan","2024-05-23",0,0,14,0,0,15,0,0
"Japan","2024-05-24",0,1,15,0,0,15,0,0
"Japan","2024-05-25",0,0,15,0,0,15,0,0
"Japan","2024-05-26",0,0,15,0,0,15,0,0
"Japan","2024-05-27",0,0,15,0,0,15,0,0
"Japan","2024-05-28",0,0,15,0,0,15,0,0
"Japan","2024-05-29",0,0,15,0,0,15,0,0
"Japan","2024-05-30",0,0,15,0,0,15,0,0
"Japan","2024-05-31",0,0,15,0,0,15,0,0
"Japan","2024-06-01",0,0,15,0,0,15,0,0
"Japan","2024-06-02",0,0,15,0,0,15,0,0
"Japan","2024-06-03",0,0,15,0,0,15,0,0
"Japan","2024-06-04",0,0,15,0,0,15,0,0
"Japan","2024-06-05",0,0,15,0,0,15,0,0
"Japan","2024-06-06",0,0,15,0,0,15,0,0
"Japan","2024-06-07",0,0,15,0,0,15,0,0
"Japan","2024-06-08",0,0,15,0,0,15,0,0
"Japan","2024-06-09",0,0,15,0,0,15,0,0
"Japan","2024-06-10",0,0,15,0,0,15,0,0
"Japan","2024-06-11",0,0,15,0,0,15,0,0
"Japan","2024-06-12",0,0,15,0,0,15,0,0
"Japan","2024-06-13",0,0,15,0,0,15,0,0
"Japan","2024-06-14",0,0,15,0,0,15,0,0
"Japan","2024-06-15",0,0,15,0,0,15,0,0
"Japan","2024-06-16",0,0,15,0,0,15,0,0
"Japan","2024-06-17",0,0,15,0,0,15,0,0
"Japan","2024-06-18",0,0,15,0,0,15,0,0
"Japan","2024-06-19",0,0,15,0,0,15,0,0
"Japan","2024-06-20",0,0,15,0,0,15,0,0
"Japan","2024-06-21",0,0,15,0,0,15,0,0
"Japan","2024-06-22",0,0,15,0,0,15,0,0
"Japan","2024-06-23",0,0,15,0,0,15,0,0
"Japan","2024-06-24",0,0,15,0,0,15,0,0
"Japan","2024-06-25",0,0,15,0,0,15,0,0
"Japan","2024-06-26",0,0,15,0,0,15,0,0
"Japan","2024-06-27",0,0,15,0,0,15,0,0
"Japan","2024-06-28",0,0,15,0,0,15,0,0
"Japan","2024-06-29",0,0,15,0,0,15,0,0
"Japan","2024-06-30",0,0,15,0,1,16,0,0
"Japan","2024-07-01",0,0,15,0,0,16,0,0
"Japan","2024-07-02",0,0,15,0,0,16,0,0
"Japan","2024-07-03",0,0,15,0,0,16,0,0
"Japan","2024-07-04",0,0,15,0,0,16,0,0
"Japan","2024-07-05",0,0,15,0,0,16,0,0
"Japan","2024-07-06",0,0,15,0,0,16,0,0
"Japan","2024-07-07",0,0,15,0,0,16,0,0
"Japan","2024-07-08",0,0,15,0,0,16,0,0
"Japan","2024-07-09",0,0,15,0,0,16,0,0
"Japan","2024-07-10",0,0,15,0,0,16,0,0
"Japan","2024-07-11",0,0,15,0,0,16,0,0
"Japan","2024-07-12",0,0,15,0,0,16,0,0
"Japan","2024-07-13",0,0,15,0,0,16,0,0
"Japan","2024-07-14",0,0,15,0,0,16,0,0
"Japan","2024-07-15",0,0,15,0,0,16,0,0
"Japan","2024-07-16",0,0,15,0,0,16,0,0
"Japan","2024-07-17",0,0,15,0,0,16,0,0
"Japan","2024-07-18",0,0,15,0,0,16,0,0
"Japan","2024-07-19",0,0,15,0,0,16,0,0
"Japan","2024-07-20",0,0,15,0,0,16,0,0
"Japan","2024-07-21",0,0,15,0,0,16,0,0
"Japan","2024-07-22",0,0,15,0,0,16,0,0
"Japan","2024-07-23",0,0,15,0,0,16,0,0
"Japan","2024-07-24",0,0,15,0,0,16,0,0
"Japan","2024-07-25",0,0,15,0,0,16,0,0
"Japan","2024-07-26",0,0,15,0,0,16,0,0
"Japan","2024-07-27",0,0,15,0,0,16,0,0
"Japan","2024-07-28",0,0,15,0,0,16,0,0
"Japan","2024-07-29",0,0,15,0,0,16,0,0
"Japan","2024-07-30",0,0,15,0,0,16,0,0
"Japan","2024-07-31",0,0,15,0,0,16,0,0
"Japan","2024-08-01",0,0,15,0,0,16,0,0
"Japan","2024-08-02",0,0,15,0,0,16,0,0
"Japan","2024-08-03",0,0,15,0,0,16,0,0
"Japan","2024-08-04",0,0,15,0,0,16,0,0
"Japan","2024-08-05",0,1,16,0,0,16,0,0
"Japan","2024-08-06",0,0,16,0,0,16,0,0
"Japan","2024-08-07",0,0,16,0,0,16,0,0
"Japan","2024-08-08",0,0,16,0,0,16,0,0
"Japan","2024-08-09",0,0,16,0,0,16,0,0
"Japan","2024-08-10",0,0,16,0,0,16,0,0
"Japan","2024-08-11",0,0,16,0,0,16,0,0
"Japan","2024-08-12",0,0,16,0,0,16,0,0
"Japan","2024-08-13",0,0,16,0,0,16,0,0
"Japan","2024-08-14",0,0,16,0,0,16,0,0
"Japan","2024-08-15",0,0,16,0,0,16,0,0
"Japan","2024-08-16",0,0,16,0,0,16,0,0
"Japan","2024-08-17",0,0,16,0,0,16,0,0
"Japan","2024-08-18",0,0,16,0,0,16,0,0
"Japan","2024-08-19",0,0,16,0,0,16,0,0
"Japan","2024-08-20",0,0,16,0,0,16,0,0
"Japan","2024-08-21",0,0,16,0,0,16,0,0
"Japan","2024-08-22",0,0,16,0,0,16,0,0
"Japan","2024-08-23",0,0,16,0,0,16,0,0
"Japan","2024-08-24",0,0,16,0,0,16,0,0
"Japan","2024-08-25",0,0,16,0,0,16,0,0
"Japan","2024-08-26",0,0,16,0,0,16,0,0
"Japan","2024-08-27",0,0,16,0,0,16,0,0
"Japan","2024-08-28",0,0,16,0,0,16,0,0
"Japan","2024-08-29",0,0,16,0,0,16,0,0
"Japan","2024-08-30",0,0,16,0,0,16,0,0
"Japan","2024-08-31",0,0,16,0,0,16,0,0
"Japan","2024-09-01",0,0,16,0,0,16,0,0
"Japan","2024-09-02",0,0,16,0,0,16,0,0
"Japan","2024-09-03",0,0,16,0,0,16,0,0
"Japan","2024-09-04",0,0,16,0,0,16,0,0
"Japan","2024-09-05",0,0,16,0,1,17,0,0
"Japan","2024-09-06",0,0,16,0,0,17,0,0
"Japan","2024-09-07",0,0,16,0,0,17,0,0
"Japan","2024-09-08",0,0,16,0,0,17,0,0
"Japan","2024-09-09",0,0,16,0,0,17,0,0
"Japan","2024-09-10",0,0,16,0,0,17,0,0
"Japan","2024-09-11",0,0,16,0,0,17,0,0
"Japan","2024-09-12",0,0,16,0,0,17,0,0
"Japan","2024-09-13",0,0,16,0,0,17,0,0
"Japan","2024-09-14",0,0,16,0,0,17,0,0
"Japan","2024-09-15",0,0,16,0,0,17,0,0
"Japan","2024-09-16",0,0,16,0,0,17,0,0
"Japan","2024-09-17",0,0,16,0,0,17,0,0
"Japan","2024-09-18",0,0,16,0,0,17,0,0
"Japan","2024-09-19",0,0,16,0,0,17,0,0
"Japan","2024-09-20",0,0,16,0,0,17,0,0
"Japan","2024-09-21",0,0,16,0,0,17,0,0
"Japan","2024-09-22",0,0,16,0,0,17,0,0
"Japan","2024-09-23",0,0,16,0,0,17,0,0
"Japan","2024-09-24",0,0,16,0,0,17,0,0
"Japan","2024-09-25",0,0,16,0,0,17,0,0
"Japan","2024-09-26",0,0,16,0,0,17,0,0
"Japan","2024-09-27",0,0,16,0,0,17,0,0
"Japan","2024-09-28",0,0,16,0,0,17,0,0
"Japan","2024-09-29",0,0,16,0,0,17,0,0
"Japan","2024-09-30",0,0,16,0,0,17,0,0
"Japan","2024-10-01",0,0,16,0,0,17,0,0
"Japan","2024-10-02",0,0,16,0,0,17,0,0
"Japan","2024-10-03",0,0,16,0,0,17,0,0
"Japan","2024-10-04",0,1,17,0,0,17,0,0
"Japan","2024-10-05",0,0,17,0,0,17,0,0
"Japan","2024-10-06",0,0,17,0,0,17,0,0
"Japan","2024-10-07",0,0,17,0,0,17,0,0
"Japan","2024-10-08",0,0,17,0,1,18,0,0
"Japan","2024-10-09",0,0,17,0,0,18,0,0
"Japan","2024-10-10",0,0,17,0,0,18,0,0
"Japan","2024-10-11",0,0,17,0,0,18,0,0
"Japan","2024-10-12",0,0,17,0,0,18,0,0
"Japan","2024-10-13",0,0,17,0,0,18,0,0
"Japan","2024-10-14",0,0,17,0,0,18,0,0
"Japan","2024-10-15",0,0,17,0,1,19,0,0
"Japan","2024-10-16",0,0,17,0,0,19,0,0
"Japan","2024-10-17",0,0,17,0,0,19,0,0
"Japan","2024-10-18",0,2,19,0,0,19,0,0
"Japan","2024-10-19",0,0,19,0,0,19,0,0
"Japan","2024-10-20",0,0,19,0,0,19,0,0
"Japan","2024-10-21",0,0,19,0,0,19,0,0
"Japan","2024-10-22",0,0,19,0,0,19,0,0
"Japan","2024-10-23",0,0,19,0,0,19,0,0
"Japan","2024-10-24",0,0,19,0,0,19,0,0
"Japan","2024-10-25",0,0,19,0,0,19,0,0
"Japan","2024-10-26",0,0,19,0,0,19,0,0
"Japan","2024-10-27",0,0,19,0,0,19,0,0
"Japan","2024-10-28",0,0,19,0,0,19,0,0
"Japan","2024-10-29",0,0,19,0,0,19,0,0
"Japan","2024-10-30",0,0,19,0,0,19,0,0
"Japan","2024-10-31",0,0,19,0,0,19,0,0
"Japan","2024-11-01",0,0,19,0,0,19,0,0
"Japan","2024-11-02",0,0,19,0,1,20,0,0
"Japan","2024-11-03",0,0,19,0,0,20,0,0
"Japan","2024-11-04",0,0,19,0,0,20,0,0
"Japan","2024-11-05",0,0,19,0,0,20,0,0
"Japan","2024-11-06",0,0,19,0,0,20,0,0
"Japan","2024-11-07",0,0,19,0,0,20,0,0
"Japan","2024-11-08",0,0,19,0,0,20,0,0
"Japan","2024-11-09",0,0,19,0,0,20,0,0
"Japan","2024-11-10",0,0,19,0,0,20,0,0
"Japan","2024-11-11",0,0,19,0,0,20,0,0
"Japan","2024-11-12",0,0,19,0,0,20,0,0
"Japan","2024-11-13",0,0,19,0,0,20,0,0
"Japan","2024-11-14",0,0,19,0,0,20,0,0
"Japan","2024-11-15",0,1,20,0,0,20,0,0
"Japan","2024-11-16",0,0,20,0,0,20,0,0
"Japan","2024-11-17",0,0,20,0,0,20,0,0
"Japan","2024-11-18",0,0,20,0,0,20,0,0
"Japan","2024-11-19",0,0,20,0,0,20,0,0
"Japan","2024-11-20",0,0,20,0,0,20,0,0
"Japan","2024-11-21",0,0,20,0,0,20,0,0
"Japan","2024-11-22",0,0,20,0,0,20,0,0
"Japan","2024-11-23",0,0,20,0,0,20,0,0
"Japan","2024-11-24",0,0,20,0,0,20,0,0
"Japan","2024-11-25",0,0,20,0,0,20,0,0
"Japan","2024-11-26",0,0,20,0,0,20,0,0
"Japan","2024-11-27",0,0,20,0,0,20,0,0
"Japan","2024-11-28",0,0,20,0,0,20,0,0
"Japan","2024-11-29",0,0,20,0,0,20,0,0
"Japan","2024-11-30",0,0,20,0,0,20,0,0
"Japan","2024-12-01",0,0,20,0,0,20,0,0
"Japan","2024-12-02",0,0,20,0,0,20,0,0
"Japan","2024-12-03",0,0,20,0,0,20,0,0
"Japan","2024-12-04",0,0,20,0,0,20,0,0
"Japan","2024-12-05",0,0,20,0,0,20,0,0
"Japan","2024-12-06",0,0,20,0,0,20,0,0
"Japan","2024-12-07",0,0,20,0,0,20,0,0
"Japan","2024-12-08",0,0,20,0,0,20,0,0
"Japan","2024-12-09",0,0,20,0,0,20,0,0
"Japan","2024-12-10",0,0,20,0,0,20,0,0
"Japan","2024-12-11",0,0,20,0,0,20,0,0
"Japan","2024-12-12",0,0,20,0,0,20,0,0
"Japan","2024-12-13",0,0,20,0,0,20,0,0
"Japan","2024-12-14",0,0,20,0,0,20,0,0
"Japan","2024-12-15",0,0,20,0,0,20,0,0
"Japan","2024-12-16",0,0,20,0,0,20,0,0
"Japan","2024-12-17",0,0,20,0,0,20,0,0
"Japan","2024-12-18",0,0,20,0,0,20,0,0
"Japan","2024-12-19",0,0,20,0,0,20,0,0
"Japan","2024-12-20",0,0,20,0,0,20,0,0
"Japan","2024-12-21",0,0,20,0,0,20,0,0
"Japan","2024-12-22",0,0,20,0,0,20,0,0
"Japan","2024-12-23",0,0,20,0,0,20,0,0
"Japan","2024-12-24",0,0,20,0,0,20,0,0
"Japan","2024-12-25",0,0,20,0,0,20,0,0
"Japan","2024-12-26",0,0,20,0,0,20,0,0
"Japan","2024-12-27",0,0,20,0,0,20,0,0
"Japan","2024-12-28",0,0,20,0,0,20,0,0
"Japan","2024-12-29",0,0,20,0,0,20,0,0
"Japan","2024-12-30",0,0,20,0,0,20,0,0
"Japan","2024-12-31",0,0,20,0,0,20,0,0
"Japan","2025-01-01",0,0,20,0,0,20,0,0
"Japan","2025-01-02",0,0,20,0,0,20,0,0
"Japan","2025-01-03",0,0,20,0,0,20,0,0
"Japan","2025-01-04",0,0,20,0,0,20,0,0
"Japan","2025-01-05",0,0,20,0,0,20,0,0
"Japan","2025-01-06",0,0,20,0,0,20,0,0
"Japan","2025-01-07",0,0,20,0,0,20,0,0
"Japan","2025-01-08",0,0,20,0,0,20,0,0
"Japan","2025-01-09",0,0,20,0,0,20,0,0
"Japan","2025-01-10",0,0,20,0,0,20,0,0
"Japan","2025-01-11",0,0,20,0,0,20,0,0
"Japan","2025-01-12",0,0,20,0,0,20,0,0
"Japan","2025-01-13",0,0,20,0,0,20,0,0
"Japan","2025-01-14",0,0,20,0,0,20,0,0
"Japan","2025-01-15",0,0,20,0,0,20,0,0
"Japan","2025-01-16",0,0,20,0,0,20,0,0
"Japan","2025-01-17",0,0,20,0,0,20,0,0
"Japan","2025-01-18",0,0,20,0,0,20,0,0
"Japan","2025-01-19",0,0,20,0,0,20,0,0
"Japan","2025-01-20",0,0,20,0,0,20,0,0
"Japan","2025-01-21",0,0,20,0,0,20,0,0
"Japan","2025-01-22",0,0,20,0,0,20,0,0
"Japan","2025-01-23",0,0,20,0,0,20,0,0
"Japan","2025-01-24",0,0,20,0,0,20,0,0
"Japan","2025-01-25",0,0,20,0,0,20,0,0
"Japan","2025-01-26",0,0,20,0,0,20,0,0
"Japan","2025-01-27",0,0,20,0,0,20,0,0
"Japan","2025-01-28",0,0,20,0,0,20,0,0
"Japan","2025-01-29",0,0,20,0,0,20,0,0
"Japan","2025-01-30",0,0,20,0,0,20,0,0
"Japan","2025-01-31",0,0,20,0,0,20,0,0
"Japan","2025-02-01",0,0,20,0,0,20,0,0
"Japan","2025-02-02",0,0,20,0,0,20,0,0
"Japan","2025-02-03",0,0,20,0,0,20,0,0
"Japan","2025-02-04",0,0,20,0,0,20,0,0
"Japan","2025-02-05",0,0,20,0,0,20,0,0
"Japan","2025-02-06",0,0,20,0,0,20,0,0
"Japan","2025-02-07",0,0,20,0,0,20,0,0
"Japan","2025-02-08",0,0,20,0,0,20,0,0
"Japan","2025-02-09",0,0,20,0,0,20,0,0
"Japan","2025-02-10",0,0,20,0,0,20,0,0
"Japan","2025-02-11",0,0,20,0,0,20,0,0
"Japan","2025-02-12",0,0,20,0,0,20,0,0
"Japan","2025-02-13",0,0,20,0,0,20,0,0
"Japan","2025-02-14",0,0,20,0,0,20,0,0
"Japan","2025-02-15",0,0,20,0,0,20,0,0
"Japan","2025-02-16",0,0,20,0,0,20,0,0
"Japan","2025-02-17",0,0,20,0,0,20,0,0
"Japan","2025-02-18",0,0,20,0,0,20,0,0
"Japan","2025-02-19",0,0,20,0,0,20,0,0
"Japan","2025-02-20",0,0,20,0,0,20,0,0
"Japan","2025-02-21",0,0,20,0,0,20,0,0
"Japan","2025-02-22",0,0,20,0,0,20,0,0
"Japan","2025-02-23",0,0,20,0,0,20,0,0
"Japan","2025-02-24",0,0,20,0,0,20,0,0
"Japan","2025-02-25",0,0,20,0,0,20,0,0
"Japan","2025-02-26",0,0,20,0,0,20,0,0
"Japan","2025-02-27",0,0,20,0,0,20,0,0
"Japan","2025-02-28",0,0,20,0,0,20,0,0
"Japan","2025-03-01",0,0,20,0,0,20,0,0
"Japan","2025-03-02",0,0,20,0,0,20,0,0
"Japan","2025-03-03",0,0,20,0,0,20,0,0
"Jordan","2024-01-01",0,0,0,0,0,0,0,0
"Jordan","2024-01-02",0,0,0,0,0,0,0,0
"Jordan","2024-01-03",0,0,0,0,0,0,0,0
"Jordan","2024-01-04",0,0,0,0,0,0,0,0
"Jordan","2024-01-05",0,0,0,0,0,0,0,0
"Jordan","2024-01-06",0,0,0,0,0,0,0,0
"Jordan","2024-01-07",0,0,0,0,0,0,0,0
"Jordan","2024-01-08",0,0,0,0,0,0,0,0
"Jordan","2024-01-09",0,0,0,0,0,0,0,0
"Jordan","2024-01-10",0,0,0,0,0,0,0,0
"Jordan","2024-01-11",0,0,0,0,0,0,0,0
"Jordan","2024-01-12",0,0,0,0,0,0,0,0
"Jordan","2024-01-13",0,0,0,0,0,0,0,0
"Jordan","2024-01-14",0,0,0,0,0,0,0,0
"Jordan","2024-01-15",0,0,0,0,0,0,0,0
"Jordan","2024-01-16",0,0,0,0,0,0,0,0
"Jordan","2024-01-17",0,0,0,0,0,0,0,0
"Jordan","2024-01-18",0,0,0,0,0,0,0,0
"Jordan","2024-01-19",0,0,0,0,0,0,0,0
"Jordan","2024-01-20",0,0,0,0,0,0,0,0
"Jordan","2024-01-21",0,0,0,0,0,0,0,0
"Jordan","2024-01-22",0,0,0,0,0,0,0,0
"Jordan","2024-01-23",0,0,0,0,0,0,0,0
"Jordan","2024-01-24",0,0,0,0,0,0,0,0
"Jordan","2024-01-25",0,0,0,0,0,0,0,0
"Jordan","2024-01-26",0,0,0,0,0,0,0,0
"Jordan","2024-01-27",0,0,0,0,0,0,0,0
"Jordan","2024-01-28",0,0,0,0,0,0,0,0
"Jordan","2024-01-29",0,0,0,0,0,0,0,0
"Jordan","2024-01-30",0,0,0,0,0,0,0,0
"Jordan","2024-01-31",0,0,0,0,0,0,0,0
"Jordan","2024-02-01",0,0,0,0,0,0,0,0
"Jordan","2024-02-02",0,0,0,0,0,0,0,0
"Jordan","2024-02-03",0,0,0,0,0,0,0,0
"Jordan","2024-02-04",0,0,0,0,0,0,0,0
"Jordan","2024-02-05",0,0,0,0,0,0,0,0
"Jordan","2024-02-06",0,0,0,0,0,0,0,0
"Jordan","2024-02-07",0,0,0,0,0,0,0,0
"Jordan","2024-02-08",0,0,0,0,0,0,0,0
"Jordan","2024-02-09",0,0,0,0,0,0,0,0
"Jordan","2024-02-10",0,0,0,0,0,0,0,0
"Jordan","2024-02-11",0,0,0,0,0,0,0,0
"Jordan","2024-02-12",0,0,0,0,0,0,0,0
"Jordan","2024-02-13",0,0,0,0,0,0,0,0
"Jordan","2024-02-14",0,0,0,0,0,0,0,0
"Jordan","2024-02-15",0,0,0,0,0,0,0,0
"Jordan","2024-02-16",0,0,0,0,0,0,0,0
"Jordan","2024-02-17",0,0,0,0,0,0,0,0
"Jordan","2024-02-18",0,0,0,0,0,0,0,0
"Jordan","2024-02-19",0,0,0,0,0,0,0,0
"Jordan","2024-02-20",0,0,0,0,0,0,0,0
"Jordan","2024-02-21",0,0,0,0,0,0,0,0
"Jordan","2024-02-22",0,0,0,0,0,0,0,0
"Jordan","2024-02-23",0,0,0,0,0,0,0,0
"Jordan","2024-02-24",0,0,0,0,0,0,0,0
"Jordan","2024-02-25",0,0,0,0,0,0,0,0
"Jordan","2024-02-26",0,0,0,0,0,0,0,0
"Jordan","2024-02-27",0,0,0,0,0,0,0,0
"Jordan","2024-02-28",0,0,0,0,0,0,0,0
"Jordan","2024-02-29",0,0,0,0,0,0,0,0
"Jordan","2024-03-01",0,0,0,0,0,0,0,0
"Jordan","2024-03-02",0,0,0,0,0,0,0,0
"Jordan","2024-03-03",0,0,0,0,0,0,0,0
"Jordan","2024-03-04",0,0,0,0,0,0,0,0
"Jordan","2024-03-05",0,0,0,0,0,0,0,0
"Jordan","2024-03-06",0,0,0,0,0,0,0,0
"Jordan","2024-03-07",0,0,0,0,0,0,0,0
"Jordan","2024-03-08",0,0,0,0,0,0,0,0
"Jordan","2024-03-09",0,0,0,0,0,0,0,0
"Jordan","2024-03-10",0,0,0,0,0,0,0,0
"Jordan","2024-03-11",0,0,0,0,0,0,0,0
"Jordan","2024-03-12",0,0,0,0,0,0,0,0
"Jordan","2024-03-13",0,0,0,0,0,0,0,0
"Jordan","2024-03-14",0,0,0,0,0,0,0,0
"Jordan","2024-03-15",0,0,0,0,0,0,0,0
"Jordan","2024-03-16",0,0,0,0,0,0,0,0
"Jordan","2024-03-17",0,0,0,0,0,0,0,0
"Jordan","2024-03-18",0,0,0,0,0,0,0,0
"Jordan","2024-03-19",0,0,0,0,0,0,0,0
"Jordan","2024-03-20",0,0,0,0,0,0,0,0
"Jordan","2024-03-21",0,0,0,0,0,0,0,0
"Jordan","2024-03-22",0,0,0,0,0,0,0,0
"Jordan","2024-03-23",0,0,0,0,0,0,0,0
"Jordan","2024-03-24",0,0,0,0,0,0,0,0
"Jordan","2024-03-25",0,0,0,0,0,0,0,0
"Jordan","2024-03-26",0,0,0,0,0,0,0,0
"Jordan","2024-03-27",0,0,0,0,0,0,0,0
"Jordan","2024-03-28",0,0,0,0,0,0,0,0
"Jordan","2024-03-29",0,0,0,0,0,0,0,0
"Jordan","2024-03-30",0,0,0,0,0,0,0,0
"Jordan","2024-03-31",0,0,0,0,0,0,0,0
"Jordan","2024-04-01",0,0,0,0,0,0,0,0
"Jordan","2024-04-02",0,0,0,0,0,0,0,0
"Jordan","2024-04-03",0,0,0,0,0,0,0,0
"Jordan","2024-04-04",0,0,0,0,0,0,0,0
"Jordan","2024-04-05",0,0,0,0,0,0,0,0
"Jordan","2024-04-06",0,0,0,0,0,0,0,0
"Jordan","2024-04-07",0,0,0,0,0,0,0,0
"Jordan","2024-04-08",0,0,0,0,0,0,0,0
"Jordan","2024-04-09",0,0,0,0,0,0,0,0
"Jordan","2024-04-10",0,0,0,0,0,0,0,0
"Jordan","2024-04-11",0,0,0,0,0,0,0,0
"Jordan","2024-04-12",0,0,0,0,0,0,0,0
"Jordan","2024-04-13",0,0,0,0,0,0,0,0
"Jordan","2024-04-14",0,0,0,0,0,0,0,0
"Jordan","2024-04-15",0,0,0,0,0,0,0,0
"Jordan","2024-04-16",0,0,0,0,0,0,0,0
"Jordan","2024-04-17",0,0,0,0,0,0,0,0
"Jordan","2024-04-18",0,0,0,0,0,0,0,0
"Jordan","2024-04-19",0,0,0,0,0,0,0,0
"Jordan","2024-04-20",0,0,0,0,0,0,0,0
"Jordan","2024-04-21",0,0,0,0,0,0,0,0
"Jordan","2024-04-22",0,0,0,0,0,0,0,0
"Jordan","2024-04-23",0,0,0,0,0,0,0,0
"Jordan","2024-04-24",0,0,0,0,0,0,0,0
"Jordan","2024-04-25",0,0,0,0,0,0,0,0
"Jordan","2024-04-26",0,0,0,0,0,0,0,0
"Jordan","2024-04-27",0,0,0,0,0,0,0,0
"Jordan","2024-04-28",0,0,0,0,0,0,0,0
"Jordan","2024-04-29",0,0,0,0,0,0,0,0
"Jordan","2024-04-30",0,0,0,0,0,0,0,0
"Jordan","2024-05-01",0,0,0,0,0,0,0,0
"Jordan","2024-05-02",0,0,0,0,0,0,0,0
"Jordan","2024-05-03",0,0,0,0,0,0,0,0
"Jordan","2024-05-04",0,0,0,0,0,0,0,0
"Jordan","2024-05-05",0,0,0,0,0,0,0,0
"Jordan","2024-05-06",0,0,0,0,0,0,0,0
"Jordan","2024-05-07",0,0,0,0,0,0,0,0
"Jordan","2024-05-08",0,0,0,0,0,0,0,0
"Jordan","2024-05-09",0,0,0,0,0,0,0,0
"Jordan","2024-05-10",0,0,0,0,0,0,0,0
"Jordan","2024-05-11",0,0,0,0,0,0,0,0
"Jordan","2024-05-12",0,0,0,0,0,0,0,0
"Jordan","2024-05-13",0,0,0,0,0,0,0,0
"Jordan","2024-05-14",0,0,0,0,0,0,0,0
"Jordan","2024-05-15",0,0,0,0,0,0,0,0
"Jordan","2024-05-16",0,0,0,0,0,0,0,0
"Jordan","2024-05-17",0,0,0,0,0,0,0,0
"Jordan","2024-05-18",0,0,0,0,0,0,0,0
"Jordan","2024-05-19",0,0,0,0,0,0,0,0
"Jordan","2024-05-20",0,0,0,0,0,0,0,0
"Jordan","2024-05-21",0,0,0,0,0,0,0,0
"Jordan","2024-05-22",0,0,0,0,0,0,0,0
"Jordan","2024-05-23",0,0,0,0,0,0,0,0
"Jordan","2024-05-24",0,0,0,0,0,0,0,0
"Jordan","2024-05-25",0,0,0,0,0,0,0,0
"Jordan","2024-05-26",0,0,0,0,0,0,0,0
"Jordan","2024-05-27",0,0,0,0,0,0,0,0
"Jordan","2024-05-28",0,0,0,0,0,0,0,0
"Jordan","2024-05-29",0,0,0,0,0,0,0,0
"Jordan","2024-05-30",0,0,0,0,0,0,0,0
"Jordan","2024-05-31",0,0,0,0,0,0,0,0
"Jordan","2024-06-01",0,0,0,0,0,0,0,0
"Jordan","2024-06-02",0,0,0,0,0,0,0,0
"Jordan","2024-06-03",0,0,0,0,0,0,0,0
"Jordan","2024-06-04",0,0,0,0,0,0,0,0
"Jordan","2024-06-05",0,0,0,0,0,0,0,0
"Jordan","2024-06-06",0,0,0,0,0,0,0,0
"Jordan","2024-06-07",0,0,0,0,0,0,0,0
"Jordan","2024-06-08",0,0,0,0,0,0,0,0
"Jordan","2024-06-09",0,0,0,0,0,0,0,0
"Jordan","2024-06-10",0,0,0,0,0,0,0,0
"Jordan","2024-06-11",0,0,0,0,0,0,0,0
"Jordan","2024-06-12",0,0,0,0,0,0,0,0
"Jordan","2024-06-13",0,0,0,0,0,0,0,0
"Jordan","2024-06-14",0,0,0,0,0,0,0,0
"Jordan","2024-06-15",0,0,0,0,0,0,0,0
"Jordan","2024-06-16",0,0,0,0,0,0,0,0
"Jordan","2024-06-17",0,0,0,0,0,0,0,0
"Jordan","2024-06-18",0,0,0,0,0,0,0,0
"Jordan","2024-06-19",0,0,0,0,0,0,0,0
"Jordan","2024-06-20",0,0,0,0,0,0,0,0
"Jordan","2024-06-21",0,0,0,0,0,0,0,0
"Jordan","2024-06-22",0,0,0,0,0,0,0,0
"Jordan","2024-06-23",0,0,0,0,0,0,0,0
"Jordan","2024-06-24",0,0,0,0,0,0,0,0
"Jordan","2024-06-25",0,0,0,0,0,0,0,0
"Jordan","2024-06-26",0,0,0,0,0,0,0,0
"Jordan","2024-06-27",0,0,0,0,0,0,0,0
"Jordan","2024-06-28",0,0,0,0,0,0,0,0
"Jordan","2024-06-29",0,0,0,0,0,0,0,0
"Jordan","2024-06-30",0,0,0,0,0,0,0,0
"Jordan","2024-07-01",0,0,0,0,0,0,0,0
"Jordan","2024-07-02",0,0,0,0,0,0,0,0
"Jordan","2024-07-03",0,0,0,0,0,0,0,0
"Jordan","2024-07-04",0,0,0,0,0,0,0,0
"Jordan","2024-07-05",0,0,0,0,0,0,0,0
"Jordan","2024-07-06",0,0,0,0,0,0,0,0
"Jordan","2024-07-07",0,0,0,0,0,0,0,0
"Jordan","2024-07-08",0,0,0,0,0,0,0,0
"Jordan","2024-07-09",0,0,0,0,0,0,0,0
"Jordan","2024-07-10",0,0,0,0,0,0,0,0
"Jordan","2024-07-11",0,0,0,0,0,0,0,0
"Jordan","2024-07-12",0,0,0,0,0,0,0,0
"Jordan","2024-07-13",0,0,0,0,0,0,0,0
"Jordan","2024-07-14",0,0,0,0,0,0,0,0
"Jordan","2024-07-15",0,0,0,0,0,0,0,0
"Jordan","2024-07-16",0,0,0,0,0,0,0,0
"Jordan","2024-07-17",0,0,0,0,0,0,0,0
"Jordan","2024-07-18",0,0,0,0,0,0,0,0
"Jordan","2024-07-19",0,0,0,0,0,0,0,0
"Jordan","2024-07-20",0,0,0,0,0,0,0,0
"Jordan","2024-07-21",0,0,0,0,0,0,0,0
"Jordan","2024-07-22",0,0,0,0,0,0,0,0
"Jordan","2024-07-23",0,0,0,0,0,0,0,0
"Jordan","2024-07-24",0,0,0,0,0,0,0,0
"Jordan","2024-07-25",0,0,0,0,0,0,0,0
"Jordan","2024-07-26",0,0,0,0,0,0,0,0
"Jordan","2024-07-27",0,0,0,0,0,0,0,0
"Jordan","2024-07-28",0,0,0,0,0,0,0,0
"Jordan","2024-07-29",0,0,0,0,0,0,0,0
"Jordan","2024-07-30",0,0,0,0,0,0,0,0
"Jordan","2024-07-31",0,0,0,0,0,0,0,0
"Jordan","2024-08-01",0,0,0,0,0,0,0,0
"Jordan","2024-08-02",0,0,0,0,0,0,0,0
"Jordan","2024-08-03",0,0,0,0,0,0,0,0
"Jordan","2024-08-04",0,0,0,0,0,0,0,0
"Jordan","2024-08-05",0,0,0,0,0,0,0,0
"Jordan","2024-08-06",0,0,0,0,0,0,0,0
"Jordan","2024-08-07",0,0,0,0,0,0,0,0
"Jordan","2024-08-08",0,0,0,0,0,0,0,0
"Jordan","2024-08-09",0,0,0,0,0,0,0,0
"Jordan","2024-08-10",0,0,0,0,0,0,0,0
"Jordan","2024-08-11",0,0,0,0,0,0,0,0
"Jordan","2024-08-12",0,0,0,0,0,0,0,0
"Jordan","2024-08-13",0,0,0,0,0,0,0,0
"Jordan","2024-08-14",0,0,0,0,0,0,0,0
"Jordan","2024-08-15",0,0,0,0,0,0,0,0
"Jordan","2024-08-16",0,0,0,0,0,0,0,0
"Jordan","2024-08-17",0,0,0,0,0,0,0,0
"Jordan","2024-08-18",0,0,0,0,0,0,0,0
"Jordan","2024-08-19",0,0,0,0,0,0,0,0
"Jordan","2024-08-20",0,0,0,0,0,0,0,0
"Jordan","2024-08-21",0,0,0,0,0,0,0,0
"Jordan","2024-08-22",0,0,0,0,0,0,0,0
"Jordan","2024-08-23",0,0,0,0,0,0,0,0
"Jordan","2024-08-24",0,0,0,0,0,0,0,0
"Jordan","2024-08-25",0,0,0,0,0,0,0,0
"Jordan","2024-08-26",0,0,0,0,0,0,0,0
"Jordan","2024-08-27",0,0,0,0,0,0,0,0
"Jordan","2024-08-28",0,0,0,0,0,0,0,0
"Jordan","2024-08-29",0,0,0,0,0,0,0,0
"Jordan","2024-08-30",0,0,0,0,0,0,0,0
"Jordan","2024-08-31",0,0,0,0,0,0,0,0
"Jordan","2024-09-01",0,0,0,0,0,0,0,0
"Jordan","2024-09-02",0,1,1,0,1,1,0,0
"Jordan","2024-09-03",0,0,1,0,0,1,0,0
"Jordan","2024-09-04",0,0,1,0,0,1,0,0
"Jordan","2024-09-05",0,0,1,0,0,1,0,0
"Jordan","2024-09-06",0,0,1,0,0,1,0,0
"Jordan","2024-09-07",0,0,1,0,0,1,0,0
"Jordan","2024-09-08",0,0,1,0,0,1,0,0
"Jordan","2024-09-09",0,0,1,0,0,1,0,0
"Jordan","2024-09-10",0,0,1,0,0,1,0,0
"Jordan","2024-09-11",0,0,1,0,0,1,0,0
"Jordan","2024-09-12",0,0,1,0,0,1,0,0
"Jordan","2024-09-13",0,0,1,0,0,1,0,0
"Jordan","2024-09-14",0,0,1,0,0,1,0,0
"Jordan","2024-09-15",0,0,1,0,0,1,0,0
"Jordan","2024-09-16",0,0,1,0,0,1,0,0
"Jordan","2024-09-17",0,0,1,0,0,1,0,0
"Jordan","2024-09-18",0,0,1,0,0,1,0,0
"Jordan","2024-09-19",0,0,1,0,0,1,0,0
"Jordan","2024-09-20",0,0,1,0,0,1,0,0
"Jordan","2024-09-21",0,0,1,0,0,1,0,0
"Jordan","2024-09-22",0,0,1,0,0,1,0,0
"Jordan","2024-09-23",0,0,1,0,0,1,0,0
"Jordan","2024-09-24",0,0,1,0,0,1,0,0
"Jordan","2024-09-25",0,0,1,0,0,1,0,0
"Jordan","2024-09-26",0,0,1,0,0,1,0,0
"Jordan","2024-09-27",0,0,1,0,0,1,0,0
"Jordan","2024-09-28",0,0,1,0,0,1,0,0
"Jordan","2024-09-29",0,0,1,0,0,1,0,0
"Jordan","2024-09-30",0,0,1,0,0,1,0,0
"Jordan","2024-10-01",0,0,1,0,0,1,0,0
"Jordan","2024-10-02",0,0,1,0,0,1,0,0
"Jordan","2024-10-03",0,0,1,0,0,1,0,0
"Jordan","2024-10-04",0,0,1,0,0,1,0,0
"Jordan","2024-10-05",0,0,1,0,0,1,0,0
"Jordan","2024-10-06",0,0,1,0,0,1,0,0
"Jordan","2024-10-07",0,0,1,0,0,1,0,0
"Jordan","2024-10-08",0,0,1,0,0,1,0,0
"Jordan","2024-10-09",0,0,1,0,0,1,0,0
"Jordan","2024-10-10",0,0,1,0,0,1,0,0
"Jordan","2024-10-11",0,0,1,0,0,1,0,0
"Jordan","2024-10-12",0,0,1,0,0,1,0,0
"Jordan","2024-10-13",0,0,1,0,0,1,0,0
"Jordan","2024-10-14",0,0,1,0,0,1,0,0
"Jordan","2024-10-15",0,0,1,0,0,1,0,0
"Jordan","2024-10-16",0,0,1,0,0,1,0,0
"Jordan","2024-10-17",0,0,1,0,0,1,0,0
"Jordan","2024-10-18",0,0,1,0,0,1,0,0
"Jordan","2024-10-19",0,0,1,0,0,1,0,0
"Jordan","2024-10-20",0,0,1,0,0,1,0,0
"Jordan","2024-10-21",0,0,1,0,0,1,0,0
"Jordan","2024-10-22",0,0,1,0,0,1,0,0
"Jordan","2024-10-23",0,0,1,0,0,1,0,0
"Jordan","2024-10-24",0,0,1,0,0,1,0,0
"Jordan","2024-10-25",0,0,1,0,0,1,0,0
"Jordan","2024-10-26",0,0,1,0,0,1,0,0
"Jordan","2024-10-27",0,0,1,0,0,1,0,0
"Jordan","2024-10-28",0,0,1,0,0,1,0,0
"Jordan","2024-10-29",0,0,1,0,0,1,0,0
"Jordan","2024-10-30",0,0,1,0,0,1,0,0
"Jordan","2024-10-31",0,0,1,0,0,1,0,0
"Jordan","2024-11-01",0,0,1,0,0,1,0,0
"Jordan","2024-11-02",0,0,1,0,0,1,0,0
"Jordan","2024-11-03",0,0,1,0,0,1,0,0
"Jordan","2024-11-04",0,0,1,0,0,1,0,0
"Jordan","2024-11-05",0,0,1,0,0,1,0,0
"Jordan","2024-11-06",0,0,1,0,0,1,0,0
"Jordan","2024-11-07",0,0,1,0,0,1,0,0
"Jordan","2024-11-08",0,0,1,0,0,1,0,0
"Jordan","2024-11-09",0,0,1,0,0,1,0,0
"Jordan","2024-11-10",0,0,1,0,0,1,0,0
"Jordan","2024-11-11",0,0,1,0,0,1,0,0
"Jordan","2024-11-12",0,0,1,0,0,1,0,0
"Jordan","2024-11-13",0,0,1,0,0,1,0,0
"Jordan","2024-11-14",0,0,1,0,0,1,0,0
"Jordan","2024-11-15",0,0,1,0,0,1,0,0
"Jordan","2024-11-16",0,0,1,0,0,1,0,0
"Jordan","2024-11-17",0,0,1,0,0,1,0,0
"Jordan","2024-11-18",0,0,1,0,0,1,0,0
"Jordan","2024-11-19",0,0,1,0,0,1,0,0
"Jordan","2024-11-20",0,0,1,0,0,1,0,0
"Jordan","2024-11-21",0,0,1,0,0,1,0,0
"Jordan","2024-11-22",0,0,1,0,0,1,0,0
"Jordan","2024-11-23",0,0,1,0,0,1,0,0
"Jordan","2024-11-24",0,0,1,0,0,1,0,0
"Jordan","2024-11-25",0,0,1,0,0,1,0,0
"Jordan","2024-11-26",0,0,1,0,0,1,0,0
"Jordan","2024-11-27",0,0,1,0,0,1,0,0
"Jordan","2024-11-28",0,0,1,0,0,1,0,0
"Jordan","2024-11-29",0,0,1,0,0,1,0,0
"Jordan","2024-11-30",0,0,1,0,0,1,0,0
"Jordan","2024-12-01",0,0,1,0,0,1,0,0
"Jordan","2024-12-02",0,0,1,0,0,1,0,0
"Jordan","2024-12-03",0,0,1,0,0,1,0,0
"Jordan","2024-12-04",0,0,1,0,0,1,0,0
"Jordan","2024-12-05",0,0,1,0,0,1,0,0
"Jordan","2024-12-06",0,0,1,0,0,1,0,0
"Jordan","2024-12-07",0,0,1,0,0,1,0,0
"Jordan","2024-12-08",0,0,1,0,0,1,0,0
"Jordan","2024-12-09",0,0,1,0,0,1,0,0
"Jordan","2024-12-10",0,0,1,0,0,1,0,0
"Jordan","2024-12-11",0,0,1,0,0,1,0,0
"Jordan","2024-12-12",0,0,1,0,0,1,0,0
"Jordan","2024-12-13",0,0,1,0,0,1,0,0
"Jordan","2024-12-14",0,0,1,0,0,1,0,0
"Jordan","2024-12-15",0,0,1,0,0,1,0,0
"Jordan","2024-12-16",0,0,1,0,0,1,0,0
"Jordan","2024-12-17",0,0,1,0,0,1,0,0
"Jordan","2024-12-18",0,0,1,0,0,1,0,0
"Jordan","2024-12-19",0,0,1,0,0,1,0,0
"Jordan","2024-12-20",0,0,1,0,0,1,0,0
"Jordan","2024-12-21",0,0,1,0,0,1,0,0
"Jordan","2024-12-22",0,0,1,0,0,1,0,0
"Jordan","2024-12-23",0,0,1,0,0,1,0,0
"Jordan","2024-12-24",0,0,1,0,0,1,0,0
"Jordan","2024-12-25",0,0,1,0,0,1,0,0
"Jordan","2024-12-26",0,0,1,0,0,1,0,0
"Jordan","2024-12-27",0,0,1,0,0,1,0,0
"Jordan","2024-12-28",0,0,1,0,0,1,0,0
"Jordan","2024-12-29",0,0,1,0,0,1,0,0
"Jordan","2024-12-30",0,0,1,0,0,1,0,0
"Jordan","2024-12-31",0,0,1,0,0,1,0,0
"Jordan","2025-01-01",0,0,1,0,0,1,0,0
"Jordan","2025-01-02",0,0,1,0,0,1,0,0
"Jordan","2025-01-03",0,0,1,0,0,1,0,0
"Jordan","2025-01-04",0,0,1,0,0,1,0,0
"Jordan","2025-01-05",0,0,1,0,0,1,0,0
"Jordan","2025-01-06",0,0,1,0,0,1,0,0
"Jordan","2025-01-07",0,0,1,0,0,1,0,0
"Jordan","2025-01-08",0,0,1,0,0,1,0,0
"Jordan","2025-01-09",0,0,1,0,0,1,0,0
"Jordan","2025-01-10",0,0,1,0,0,1,0,0
"Jordan","2025-01-11",0,0,1,0,0,1,0,0
"Jordan","2025-01-12",0,0,1,0,0,1,0,0
"Jordan","2025-01-13",0,0,1,0,0,1,0,0
"Jordan","2025-01-14",0,0,1,0,0,1,0,0
"Jordan","2025-01-15",0,0,1,0,0,1,0,0
"Jordan","2025-01-16",0,0,1,0,0,1,0,0
"Jordan","2025-01-17",0,0,1,0,0,1,0,0
"Jordan","2025-01-18",0,0,1,0,0,1,0,0
"Jordan","2025-01-19",0,0,1,0,0,1,0,0
"Jordan","2025-01-20",0,0,1,0,0,1,0,0
"Jordan","2025-01-21",0,0,1,0,0,1,0,0
"Jordan","2025-01-22",0,0,1,0,0,1,0,0
"Jordan","2025-01-23",0,0,1,0,0,1,0,0
"Jordan","2025-01-24",0,0,1,0,0,1,0,0
"Jordan","2025-01-25",0,0,1,0,0,1,0,0
"Jordan","2025-01-26",0,0,1,0,0,1,0,0
"Jordan","2025-01-27",0,0,1,0,0,1,0,0
"Jordan","2025-01-28",0,0,1,0,0,1,0,0
"Jordan","2025-01-29",0,0,1,0,0,1,0,0
"Jordan","2025-01-30",0,0,1,0,0,1,0,0
"Jordan","2025-01-31",0,0,1,0,0,1,0,0
"Jordan","2025-02-01",0,0,1,0,0,1,0,0
"Jordan","2025-02-02",0,0,1,0,0,1,0,0
"Jordan","2025-02-03",0,0,1,0,0,1,0,0
"Jordan","2025-02-04",0,0,1,0,0,1,0,0
"Jordan","2025-02-05",0,0,1,0,0,1,0,0
"Jordan","2025-02-06",0,0,1,0,0,1,0,0
"Jordan","2025-02-07",0,0,1,0,0,1,0,0
"Jordan","2025-02-08",0,0,1,0,0,1,0,0
"Jordan","2025-02-09",0,0,1,0,0,1,0,0
"Jordan","2025-02-10",0,0,1,0,0,1,0,0
"Jordan","2025-02-11",0,0,1,0,0,1,0,0
"Jordan","2025-02-12",0,0,1,0,0,1,0,0
"Jordan","2025-02-13",0,0,1,0,0,1,0,0
"Jordan","2025-02-14",0,0,1,0,0,1,0,0
"Jordan","2025-02-15",0,0,1,0,0,1,0,0
"Jordan","2025-02-16",0,0,1,0,0,1,0,0
"Jordan","2025-02-17",0,0,1,0,0,1,0,0
"Jordan","2025-02-18",0,0,1,0,0,1,0,0
"Jordan","2025-02-19",0,0,1,0,0,1,0,0
"Jordan","2025-02-20",0,0,1,0,0,1,0,0
"Jordan","2025-02-21",0,0,1,0,0,1,0,0
"Jordan","2025-02-22",0,0,1,0,0,1,0,0
"Jordan","2025-02-23",0,0,1,0,0,1,0,0
"Jordan","2025-02-24",0,0,1,0,0,1,0,0
"Jordan","2025-02-25",0,0,1,0,0,1,0,0
"Jordan","2025-02-26",0,0,1,0,0,1,0,0
"Jordan","2025-02-27",0,0,1,0,0,1,0,0
"Jordan","2025-02-28",0,0,1,0,0,1,0,0
"Jordan","2025-03-01",0,0,1,0,0,1,0,0
"Jordan","2025-03-02",0,0,1,0,0,1,0,0
"Jordan","2025-03-03",0,0,1,0,0,1,0,0
"Kenya","2024-01-01",0,0,0,0,0,0,0,0
"Kenya","2024-01-02",0,0,0,0,0,0,0,0
"Kenya","2024-01-03",0,0,0,0,0,0,0,0
"Kenya","2024-01-04",0,0,0,0,0,0,0,0
"Kenya","2024-01-05",0,0,0,0,0,0,0,0
"Kenya","2024-01-06",0,0,0,0,0,0,0,0
"Kenya","2024-01-07",0,0,0,0,0,0,0,0
"Kenya","2024-01-08",0,0,0,0,0,0,0,0
"Kenya","2024-01-09",0,0,0,0,0,0,0,0
"Kenya","2024-01-10",0,0,0,0,0,0,0,0
"Kenya","2024-01-11",0,0,0,0,0,0,0,0
"Kenya","2024-01-12",0,0,0,0,0,0,0,0
"Kenya","2024-01-13",0,0,0,0,0,0,0,0
"Kenya","2024-01-14",0,0,0,0,0,0,0,0
"Kenya","2024-01-15",0,0,0,0,0,0,0,0
"Kenya","2024-01-16",0,0,0,0,0,0,0,0
"Kenya","2024-01-17",0,0,0,0,0,0,0,0
"Kenya","2024-01-18",0,0,0,0,0,0,0,0
"Kenya","2024-01-19",0,0,0,0,0,0,0,0
"Kenya","2024-01-20",0,0,0,0,0,0,0,0
"Kenya","2024-01-21",0,0,0,0,0,0,0,0
"Kenya","2024-01-22",0,0,0,0,0,0,0,0
"Kenya","2024-01-23",0,0,0,0,0,0,0,0
"Kenya","2024-01-24",0,0,0,0,0,0,0,0
"Kenya","2024-01-25",0,0,0,0,0,0,0,0
"Kenya","2024-01-26",0,0,0,0,0,0,0,0
"Kenya","2024-01-27",0,0,0,0,0,0,0,0
"Kenya","2024-01-28",0,0,0,0,0,0,0,0
"Kenya","2024-01-29",0,0,0,0,0,0,0,0
"Kenya","2024-01-30",0,0,0,0,0,0,0,0
"Kenya","2024-01-31",0,0,0,0,0,0,0,0
"Kenya","2024-02-01",0,0,0,0,0,0,0,0
"Kenya","2024-02-02",0,0,0,0,0,0,0,0
"Kenya","2024-02-03",0,0,0,0,0,0,0,0
"Kenya","2024-02-04",0,0,0,0,0,0,0,0
"Kenya","2024-02-05",0,0,0,0,0,0,0,0
"Kenya","2024-02-06",0,0,0,0,0,0,0,0
"Kenya","2024-02-07",0,0,0,0,0,0,0,0
"Kenya","2024-02-08",0,0,0,0,0,0,0,0
"Kenya","2024-02-09",0,0,0,0,0,0,0,0
"Kenya","2024-02-10",0,0,0,0,0,0,0,0
"Kenya","2024-02-11",0,0,0,0,0,0,0,0
"Kenya","2024-02-12",0,0,0,0,0,0,0,0
"Kenya","2024-02-13",0,0,0,0,0,0,0,0
"Kenya","2024-02-14",0,0,0,0,0,0,0,0
"Kenya","2024-02-15",0,0,0,0,0,0,0,0
"Kenya","2024-02-16",0,0,0,0,0,0,0,0
"Kenya","2024-02-17",0,0,0,0,0,0,0,0
"Kenya","2024-02-18",0,0,0,0,0,0,0,0
"Kenya","2024-02-19",0,0,0,0,0,0,0,0
"Kenya","2024-02-20",0,0,0,0,0,0,0,0
"Kenya","2024-02-21",0,0,0,0,0,0,0,0
"Kenya","2024-02-22",0,0,0,0,0,0,0,0
"Kenya","2024-02-23",0,0,0,0,0,0,0,0
"Kenya","2024-02-24",0,0,0,0,0,0,0,0
"Kenya","2024-02-25",0,0,0,0,0,0,0,0
"Kenya","2024-02-26",0,0,0,0,0,0,0,0
"Kenya","2024-02-27",0,0,0,0,0,0,0,0
"Kenya","2024-02-28",0,0,0,0,0,0,0,0
"Kenya","2024-02-29",0,0,0,0,0,0,0,0
"Kenya","2024-03-01",0,0,0,0,0,0,0,0
"Kenya","2024-03-02",0,0,0,0,0,0,0,0
"Kenya","2024-03-03",0,0,0,0,0,0,0,0
"Kenya","2024-03-04",0,0,0,0,0,0,0,0
"Kenya","2024-03-05",0,0,0,0,0,0,0,0
"Kenya","2024-03-06",0,0,0,0,0,0,0,0
"Kenya","2024-03-07",0,0,0,0,0,0,0,0
"Kenya","2024-03-08",0,0,0,0,0,0,0,0
"Kenya","2024-03-09",0,0,0,0,0,0,0,0
"Kenya","2024-03-10",0,0,0,0,0,0,0,0
"Kenya","2024-03-11",0,0,0,0,0,0,0,0
"Kenya","2024-03-12",0,0,0,0,0,0,0,0
"Kenya","2024-03-13",0,0,0,0,0,0,0,0
"Kenya","2024-03-14",0,0,0,0,0,0,0,0
"Kenya","2024-03-15",0,0,0,0,0,0,0,0
"Kenya","2024-03-16",0,0,0,0,0,0,0,0
"Kenya","2024-03-17",0,0,0,0,0,0,0,0
"Kenya","2024-03-18",0,0,0,0,0,0,0,0
"Kenya","2024-03-19",0,0,0,0,0,0,0,0
"Kenya","2024-03-20",0,0,0,0,0,0,0,0
"Kenya","2024-03-21",0,0,0,0,0,0,0,0
"Kenya","2024-03-22",0,0,0,0,0,0,0,0
"Kenya","2024-03-23",0,0,0,0,0,0,0,0
"Kenya","2024-03-24",0,0,0,0,0,0,0,0
"Kenya","2024-03-25",0,0,0,0,0,0,0,0
"Kenya","2024-03-26",0,0,0,0,0,0,0,0
"Kenya","2024-03-27",0,0,0,0,0,0,0,0
"Kenya","2024-03-28",0,0,0,0,0,0,0,0
"Kenya","2024-03-29",0,0,0,0,0,0,0,0
"Kenya","2024-03-30",0,0,0,0,0,0,0,0
"Kenya","2024-03-31",0,0,0,0,0,0,0,0
"Kenya","2024-04-01",0,0,0,0,0,0,0,0
"Kenya","2024-04-02",0,0,0,0,0,0,0,0
"Kenya","2024-04-03",0,0,0,0,0,0,0,0
"Kenya","2024-04-04",0,0,0,0,0,0,0,0
"Kenya","2024-04-05",0,0,0,0,0,0,0,0
"Kenya","2024-04-06",0,0,0,0,0,0,0,0
"Kenya","2024-04-07",0,0,0,0,0,0,0,0
"Kenya","2024-04-08",0,0,0,0,0,0,0,0
"Kenya","2024-04-09",0,0,0,0,0,0,0,0
"Kenya","2024-04-10",0,0,0,0,0,0,0,0
"Kenya","2024-04-11",0,0,0,0,0,0,0,0
"Kenya","2024-04-12",0,0,0,0,0,0,0,0
"Kenya","2024-04-13",0,0,0,0,0,0,0,0
"Kenya","2024-04-14",0,0,0,0,0,0,0,0
"Kenya","2024-04-15",0,0,0,0,0,0,0,0
"Kenya","2024-04-16",0,0,0,0,0,0,0,0
"Kenya","2024-04-17",0,0,0,0,0,0,0,0
"Kenya","2024-04-18",0,0,0,0,0,0,0,0
"Kenya","2024-04-19",0,0,0,0,0,0,0,0
"Kenya","2024-04-20",0,0,0,0,0,0,0,0
"Kenya","2024-04-21",0,0,0,0,0,0,0,0
"Kenya","2024-04-22",0,0,0,0,0,0,0,0
"Kenya","2024-04-23",0,0,0,0,0,0,0,0
"Kenya","2024-04-24",0,0,0,0,0,0,0,0
"Kenya","2024-04-25",0,0,0,0,0,0,0,0
"Kenya","2024-04-26",0,0,0,0,0,0,0,0
"Kenya","2024-04-27",0,0,0,0,0,0,0,0
"Kenya","2024-04-28",0,0,0,0,0,0,0,0
"Kenya","2024-04-29",0,0,0,0,0,0,0,0
"Kenya","2024-04-30",0,0,0,0,0,0,0,0
"Kenya","2024-05-01",0,0,0,0,0,0,0,0
"Kenya","2024-05-02",0,0,0,0,0,0,0,0
"Kenya","2024-05-03",0,0,0,0,0,0,0,0
"Kenya","2024-05-04",0,0,0,0,0,0,0,0
"Kenya","2024-05-05",0,0,0,0,0,0,0,0
"Kenya","2024-05-06",0,0,0,0,0,0,0,0
"Kenya","2024-05-07",0,0,0,0,0,0,0,0
"Kenya","2024-05-08",0,0,0,0,0,0,0,0
"Kenya","2024-05-09",0,0,0,0,0,0,0,0
"Kenya","2024-05-10",0,0,0,0,0,0,0,0
"Kenya","2024-05-11",0,0,0,0,0,0,0,0
"Kenya","2024-05-12",0,0,0,0,0,0,0,0
"Kenya","2024-05-13",0,0,0,0,0,0,0,0
"Kenya","2024-05-14",0,0,0,0,0,0,0,0
"Kenya","2024-05-15",0,0,0,0,0,0,0,0
"Kenya","2024-05-16",0,0,0,0,0,0,0,0
"Kenya","2024-05-17",0,0,0,0,0,0,0,0
"Kenya","2024-05-18",0,0,0,0,0,0,0,0
"Kenya","2024-05-19",0,0,0,0,0,0,0,0
"Kenya","2024-05-20",0,0,0,0,0,0,0,0
"Kenya","2024-05-21",0,0,0,0,0,0,0,0
"Kenya","2024-05-22",0,0,0,0,0,0,0,0
"Kenya","2024-05-23",0,0,0,0,0,0,0,0
"Kenya","2024-05-24",0,0,0,0,0,0,0,0
"Kenya","2024-05-25",0,0,0,0,0,0,0,0
"Kenya","2024-05-26",0,0,0,0,0,0,0,0
"Kenya","2024-05-27",0,0,0,0,0,0,0,0
"Kenya","2024-05-28",0,0,0,0,0,0,0,0
"Kenya","2024-05-29",0,0,0,0,0,0,0,0
"Kenya","2024-05-30",0,0,0,0,0,0,0,0
"Kenya","2024-05-31",0,0,0,0,0,0,0,0
"Kenya","2024-06-01",0,0,0,0,0,0,0,0
"Kenya","2024-06-02",0,0,0,0,0,0,0,0
"Kenya","2024-06-03",0,0,0,0,0,0,0,0
"Kenya","2024-06-04",0,0,0,0,0,0,0,0
"Kenya","2024-06-05",0,0,0,0,0,0,0,0
"Kenya","2024-06-06",0,0,0,0,0,0,0,0
"Kenya","2024-06-07",0,0,0,0,0,0,0,0
"Kenya","2024-06-08",0,0,0,0,0,0,0,0
"Kenya","2024-06-09",0,0,0,0,0,0,0,0
"Kenya","2024-06-10",0,0,0,0,0,0,0,0
"Kenya","2024-06-11",0,0,0,0,0,0,0,0
"Kenya","2024-06-12",0,0,0,0,0,0,0,0
"Kenya","2024-06-13",0,0,0,0,0,0,0,0
"Kenya","2024-06-14",0,0,0,0,0,0,0,0
"Kenya","2024-06-15",0,0,0,0,0,0,0,0
"Kenya","2024-06-16",0,0,0,0,0,0,0,0
"Kenya","2024-06-17",0,0,0,0,0,0,0,0
"Kenya","2024-06-18",0,0,0,0,0,0,0,0
"Kenya","2024-06-19",0,0,0,0,0,0,0,0
"Kenya","2024-06-20",0,0,0,0,0,0,0,0
"Kenya","2024-06-21",0,0,0,0,0,0,0,0
"Kenya","2024-06-22",0,0,0,0,0,0,0,0
"Kenya","2024-06-23",0,0,0,0,0,0,0,0
"Kenya","2024-06-24",0,0,0,0,0,0,0,0
"Kenya","2024-06-25",0,0,0,0,0,0,0,0
"Kenya","2024-06-26",0,0,0,0,0,0,0,0
"Kenya","2024-06-27",0,0,0,0,0,0,0,0
"Kenya","2024-06-28",0,0,0,0,0,0,0,0
"Kenya","2024-06-29",0,0,0,0,0,0,0,0
"Kenya","2024-06-30",0,0,0,0,0,0,0,0
"Kenya","2024-07-01",0,0,0,0,0,0,0,0
"Kenya","2024-07-02",0,0,0,0,0,0,0,0
"Kenya","2024-07-03",0,0,0,0,0,0,0,0
"Kenya","2024-07-04",0,0,0,0,0,0,0,0
"Kenya","2024-07-05",0,0,0,0,0,0,0,0
"Kenya","2024-07-06",0,0,0,0,0,0,0,0
"Kenya","2024-07-07",0,0,0,0,0,0,0,0
"Kenya","2024-07-08",0,0,0,0,0,0,0,0
"Kenya","2024-07-09",0,0,0,0,0,0,0,0
"Kenya","2024-07-10",0,0,0,0,0,0,0,0
"Kenya","2024-07-11",0,0,0,0,0,0,0,0
"Kenya","2024-07-12",0,0,0,0,0,0,0,0
"Kenya","2024-07-13",0,0,0,0,0,0,0,0
"Kenya","2024-07-14",0,0,0,0,0,0,0,0
"Kenya","2024-07-15",0,0,0,0,0,0,0,0
"Kenya","2024-07-16",0,0,0,0,0,0,0,0
"Kenya","2024-07-17",0,0,0,0,0,0,0,0
"Kenya","2024-07-18",0,0,0,0,0,0,0,0
"Kenya","2024-07-19",0,0,0,0,0,0,0,0
"Kenya","2024-07-20",0,0,0,0,0,0,0,0
"Kenya","2024-07-21",0,0,0,0,0,0,0,0
"Kenya","2024-07-22",0,0,0,0,0,0,0,0
"Kenya","2024-07-23",0,0,0,0,0,0,0,0
"Kenya","2024-07-24",0,0,0,0,0,0,0,0
"Kenya","2024-07-25",0,0,0,0,0,0,0,0
"Kenya","2024-07-26",0,0,0,0,0,0,0,0
"Kenya","2024-07-27",0,0,0,0,0,0,0,0
"Kenya","2024-07-28",0,1,1,0,1,1,0,0
"Kenya","2024-07-29",0,0,1,0,0,1,0,0
"Kenya","2024-07-30",0,0,1,0,0,1,0,0
"Kenya","2024-07-31",0,0,1,0,0,1,0,0
"Kenya","2024-08-01",0,0,1,0,0,1,0,0
"Kenya","2024-08-02",0,0,1,0,0,1,0,0
"Kenya","2024-08-03",0,0,1,0,0,1,0,0
"Kenya","2024-08-04",0,0,1,0,0,1,0,0
"Kenya","2024-08-05",0,0,1,0,0,1,0,0
"Kenya","2024-08-06",0,0,1,0,0,1,0,0
"Kenya","2024-08-07",0,0,1,0,0,1,0,0
"Kenya","2024-08-08",0,0,1,0,0,1,0,0
"Kenya","2024-08-09",0,0,1,0,0,1,0,0
"Kenya","2024-08-10",0,0,1,0,0,1,0,0
"Kenya","2024-08-11",0,0,1,0,0,1,0,0
"Kenya","2024-08-12",0,0,1,0,1,2,0,0
"Kenya","2024-08-13",0,0,1,0,0,2,0,0
"Kenya","2024-08-14",0,0,1,0,0,2,0,0
"Kenya","2024-08-15",0,0,1,0,0,2,0,0
"Kenya","2024-08-16",0,0,1,0,0,2,0,0
"Kenya","2024-08-17",0,0,1,0,0,2,0,0
"Kenya","2024-08-18",0,0,1,0,0,2,0,0
"Kenya","2024-08-19",0,0,1,0,0,2,0,0
"Kenya","2024-08-20",0,0,1,0,0,2,0,0
"Kenya","2024-08-21",0,0,1,0,0,2,0,0
"Kenya","2024-08-22",0,0,1,0,0,2,0,0
"Kenya","2024-08-23",0,0,1,0,0,2,0,0
"Kenya","2024-08-24",0,0,1,0,0,2,0,0
"Kenya","2024-08-25",0,1,2,0,0,2,0,0
"Kenya","2024-08-26",0,0,2,0,0,2,0,0
"Kenya","2024-08-27",0,0,2,0,1,3,0,0
"Kenya","2024-08-28",0,0,2,0,0,3,0,0
"Kenya","2024-08-29",0,0,2,0,0,3,0,0
"Kenya","2024-08-30",0,0,2,0,0,3,0,0
"Kenya","2024-08-31",0,0,2,0,1,4,0,0
"Kenya","2024-09-01",0,2,4,0,0,4,0,0
"Kenya","2024-09-02",0,0,4,0,0,4,0,0
"Kenya","2024-09-03",0,0,4,0,0,4,0,0
"Kenya","2024-09-04",0,0,4,0,0,4,0,0
"Kenya","2024-09-05",0,0,4,0,1,5,0,0
"Kenya","2024-09-06",0,0,4,0,0,5,0,0
"Kenya","2024-09-07",0,0,4,0,0,5,0,0
"Kenya","2024-09-08",110,1,5,110,0,5,110,110
"Kenya","2024-09-09",0,0,5,110,0,5,4,114
"Kenya","2024-09-10",0,0,5,110,0,5,4,118
"Kenya","2024-09-11",0,0,5,110,0,5,4,122
"Kenya","2024-09-12",0,0,5,110,1,6,4,126
"Kenya","2024-09-13",0,0,5,110,0,6,5,131
"Kenya","2024-09-14",0,0,5,110,0,6,4,135
"Kenya","2024-09-15",0,0,5,110,0,6,4,139
"Kenya","2024-09-16",0,0,5,110,0,6,4,143
"Kenya","2024-09-17",0,0,5,110,0,6,4,147
"Kenya","2024-09-18",0,0,5,110,1,7,4,151
"Kenya","2024-09-19",0,0,5,110,0,7,4,155
"Kenya","2024-09-20",0,0,5,110,0,7,4,159
"Kenya","2024-09-21",0,0,5,110,0,7,5,164
"Kenya","2024-09-22",0,0,5,110,0,7,4,168
"Kenya","2024-09-23",0,0,5,110,0,7,4,172
"Kenya","2024-09-24",0,0,5,110,0,7,4,176
"Kenya","2024-09-25",0,0,5,110,1,8,4,180
"Kenya","2024-09-26",0,0,5,110,0,8,4,184
"Kenya","2024-09-27",0,0,5,110,0,8,4,188
"Kenya","2024-09-28",0,3,8,110,0,8,4,192
"Kenya","2024-09-29",0,0,8,110,0,8,4,196
"Kenya","2024-09-30",0,0,8,110,1,9,5,201
"Kenya","2024-10-01",0,0,8,110,1,10,4,205
"Kenya","2024-10-02",0,0,8,110,0,10,4,209
"Kenya","2024-10-03",0,0,8,110,0,10,4,213
"Kenya","2024-10-04",107,0,8,217,1,11,4,217
"Kenya","2024-10-05",0,0,8,217,1,12,1,218
"Kenya","2024-10-06",0,4,12,217,0,12,1,219
"Kenya","2024-10-07",0,0,12,217,0,12,0,219
"Kenya","2024-10-08",0,0,12,217,0,12,1,220
"Kenya","2024-10-09",0,0,12,217,0,12,1,221
"Kenya","2024-10-10",0,0,12,217,1,13,1,222
"Kenya","2024-10-11",0,0,12,217,0,13,1,223
"Kenya","2024-10-12",0,0,12,217,0,13,0,223
"Kenya","2024-10-13",0,1,13,217,0,13,1,224
"Kenya","2024-10-14",8,0,13,225,0,13,1,225
"Kenya","2024-10-15",0,0,13,225,0,13,1,226
"Kenya","2024-10-16",0,0,13,225,0,13,1,227
"Kenya","2024-10-17",0,0,13,225,1,14,0,227
"Kenya","2024-10-18",0,0,13,225,0,14,1,228
"Kenya","2024-10-19",0,0,13,225,0,14,1,229
"Kenya","2024-10-20",5,1,14,230,0,14,1,230
"Kenya","2024-10-21",0,0,14,230,0,14,0,230
"Kenya","2024-10-22",0,0,14,230,0,14,0,230
"Kenya","2024-10-23",0,0,14,230,0,14,0,230
"Kenya","2024-10-24",0,0,14,230,1,15,0,230
"Kenya","2024-10-25",0,0,14,230,0,15,0,230
"Kenya","2024-10-26",0,0,14,230,0,15,0,230
"Kenya","2024-10-27",0,0,14,230,0,15,0,230
"Kenya","2024-10-28",0,0,14,230,0,15,0,230
"Kenya","2024-10-29",0,0,14,230,0,15,0,230
"Kenya","2024-10-30",0,0,14,230,0,15,0,230
"Kenya","2024-10-31",0,0,14,230,1,16,0,230
"Kenya","2024-11-01",0,0,14,230,0,16,0,230
"Kenya","2024-11-02",0,0,14,230,0,16,0,230
"Kenya","2024-11-03",0,0,14,230,0,16,0,230
"Kenya","2024-11-04",0,0,14,230,0,16,0,230
"Kenya","2024-11-05",0,0,14,230,0,16,0,230
"Kenya","2024-11-06",0,0,14,230,0,16,0,230
"Kenya","2024-11-07",0,0,14,230,1,17,0,230
"Kenya","2024-11-08",0,0,14,230,0,17,0,230
"Kenya","2024-11-09",0,0,14,230,0,17,0,230
"Kenya","2024-11-10",0,3,17,230,0,17,0,230
"Kenya","2024-11-11",0,0,17,230,0,17,0,230
"Kenya","2024-11-12",0,0,17,230,0,17,0,230
"Kenya","2024-11-13",0,0,17,230,0,17,0,230
"Kenya","2024-11-14",0,0,17,230,1,18,0,230
"Kenya","2024-11-15",0,0,17,230,0,18,0,230
"Kenya","2024-11-16",0,0,17,230,0,18,0,230
"Kenya","2024-11-17",0,0,17,230,0,18,0,230
"Kenya","2024-11-18",0,0,17,230,0,18,0,230
"Kenya","2024-11-19",0,0,17,230,0,18,0,230
"Kenya","2024-11-20",0,0,17,230,0,18,0,230
"Kenya","2024-11-21",0,0,17,230,1,19,0,230
"Kenya","2024-11-22",0,0,17,230,0,19,0,230
"Kenya","2024-11-23",0,0,17,230,0,19,0,230
"Kenya","2024-11-24",0,2,19,230,0,19,0,230
"Kenya","2024-11-25",0,0,19,230,1,20,0,230
"Kenya","2024-11-26",0,0,19,230,0,20,0,230
"Kenya","2024-11-27",0,0,19,230,1,21,0,230
"Kenya","2024-11-28",0,0,19,230,0,21,0,230
"Kenya","2024-11-29",0,0,19,230,1,22,0,230
"Kenya","2024-11-30",0,0,19,230,0,22,0,230
"Kenya","2024-12-01",0,4,23,230,1,23,0,230
"Kenya","2024-12-02",0,0,23,230,1,24,0,230
"Kenya","2024-12-03",0,0,23,230,0,24,0,230
"Kenya","2024-12-04",0,0,23,230,1,25,0,230
"Kenya","2024-12-05",0,0,23,230,1,26,0,230
"Kenya","2024-12-06",0,0,23,230,1,27,0,230
"Kenya","2024-12-07",0,0,23,230,0,27,0,230
"Kenya","2024-12-08",0,5,28,230,1,28,0,230
"Kenya","2024-12-09",0,0,28,230,0,28,0,230
"Kenya","2024-12-10",0,0,28,230,0,28,0,230
"Kenya","2024-12-11",0,0,28,230,0,28,0,230
"Kenya","2024-12-12",0,0,28,230,1,29,0,230
"Kenya","2024-12-13",0,0,28,230,0,29,0,230
"Kenya","2024-12-14",0,0,28,230,0,29,0,230
"Kenya","2024-12-15",0,1,29,230,0,29,0,230
"Kenya","2024-12-16",0,0,29,230,0,29,0,230
"Kenya","2024-12-17",0,0,29,230,1,30,0,230
"Kenya","2024-12-18",0,0,29,230,0,30,0,230
"Kenya","2024-12-19",0,0,29,230,0,30,0,230
"Kenya","2024-12-20",0,0,29,230,0,30,0,230
"Kenya","2024-12-21",0,0,29,230,1,31,0,230
"Kenya","2024-12-22",0,0,29,230,0,31,0,230
"Kenya","2024-12-23",0,0,29,230,0,31,0,230
"Kenya","2024-12-24",0,0,29,230,1,32,0,230
"Kenya","2024-12-25",0,0,29,230,0,32,0,230
"Kenya","2024-12-26",0,0,29,230,0,32,0,230
"Kenya","2024-12-27",0,0,29,230,0,32,0,230
"Kenya","2024-12-28",0,0,29,230,1,33,0,230
"Kenya","2024-12-29",0,4,33,230,0,33,0,230
"Kenya","2024-12-30",0,0,33,230,0,33,0,230
"Kenya","2024-12-31",0,0,33,230,0,33,0,230
"Kenya","2025-01-01",0,0,33,230,0,33,0,230
"Kenya","2025-01-02",0,0,33,230,1,34,0,230
"Kenya","2025-01-03",0,0,33,230,0,34,0,230
"Kenya","2025-01-04",0,0,33,230,0,34,0,230
"Kenya","2025-01-05",0,1,34,230,0,34,0,230
"Kenya","2025-01-06",0,0,34,230,0,34,0,230
"Kenya","2025-01-07",0,0,34,230,0,34,0,230
"Kenya","2025-01-08",0,0,34,230,0,34,0,230
"Kenya","2025-01-09",0,0,34,230,1,35,0,230
"Kenya","2025-01-10",0,0,34,230,0,35,0,230
"Kenya","2025-01-11",0,0,34,230,0,35,0,230
"Kenya","2025-01-12",0,0,34,230,0,35,0,230
"Kenya","2025-01-13",0,0,34,230,0,35,0,230
"Kenya","2025-01-14",0,0,34,230,0,35,0,230
"Kenya","2025-01-15",0,0,34,230,0,35,0,230
"Kenya","2025-01-16",0,0,34,230,1,36,0,230
"Kenya","2025-01-17",0,0,34,230,0,36,0,230
"Kenya","2025-01-18",0,0,34,230,0,36,0,230
"Kenya","2025-01-19",0,2,36,230,0,36,0,230
"Kenya","2025-01-20",0,0,36,230,0,36,0,230
"Kenya","2025-01-21",0,0,36,230,0,36,0,230
"Kenya","2025-01-22",0,0,36,230,0,36,0,230
"Kenya","2025-01-23",0,0,36,230,1,37,0,230
"Kenya","2025-01-24",0,0,36,230,0,37,0,230
"Kenya","2025-01-25",0,0,36,230,0,37,0,230
"Kenya","2025-01-26",0,1,37,230,0,37,0,230
"Kenya","2025-01-27",0,0,37,230,0,37,0,230
"Kenya","2025-01-28",0,0,37,230,0,37,0,230
"Kenya","2025-01-29",0,0,37,230,0,37,0,230
"Kenya","2025-01-30",0,0,37,230,1,38,0,230
"Kenya","2025-01-31",0,0,37,230,0,38,0,230
"Kenya","2025-02-01",0,0,37,230,0,38,0,230
"Kenya","2025-02-02",0,0,37,230,0,38,0,230
"Kenya","2025-02-03",0,0,37,230,0,38,0,230
"Kenya","2025-02-04",0,0,37,230,0,38,0,230
"Kenya","2025-02-05",0,0,37,230,0,38,0,230
"Kenya","2025-02-06",0,0,37,230,1,39,0,230
"Kenya","2025-02-07",0,0,37,230,0,39,0,230
"Kenya","2025-02-08",0,0,37,230,0,39,0,230
"Kenya","2025-02-09",0,2,39,230,0,39,0,230
"Kenya","2025-02-10",0,0,39,230,0,39,0,230
"Kenya","2025-02-11",0,0,39,230,1,40,0,230
"Kenya","2025-02-12",0,0,39,230,0,40,0,230
"Kenya","2025-02-13",0,0,39,230,1,41,0,230
"Kenya","2025-02-14",0,0,39,230,0,41,0,230
"Kenya","2025-02-15",0,0,39,230,1,42,0,230
"Kenya","2025-02-16",0,3,42,230,0,42,0,230
"Kenya","2025-02-17",0,0,42,230,0,42,0,230
"Kenya","2025-02-18",0,0,42,230,0,42,0,230
"Kenya","2025-02-19",0,0,42,230,0,42,0,230
"Kenya","2025-02-20",0,0,42,230,0,42,0,230
"Kenya","2025-02-21",0,0,42,230,0,42,0,230
"Kenya","2025-02-22",0,0,42,230,0,42,0,230
"Kenya","2025-02-23",0,0,42,230,0,42,0,230
"Kenya","2025-02-24",0,0,42,230,0,42,0,230
"Kenya","2025-02-25",0,0,42,230,0,42,0,230
"Kenya","2025-02-26",0,0,42,230,0,42,0,230
"Kenya","2025-02-27",0,0,42,230,0,42,0,230
"Kenya","2025-02-28",0,0,42,230,0,42,0,230
"Kenya","2025-03-01",0,0,42,230,0,42,0,230
"Kenya","2025-03-02",0,0,42,230,0,42,0,230
"Kenya","2025-03-03",0,0,42,230,0,42,0,230
"Kosovo","2024-01-01",0,0,0,0,0,0,0,0
"Kosovo","2024-01-02",0,0,0,0,0,0,0,0
"Kosovo","2024-01-03",0,0,0,0,0,0,0,0
"Kosovo","2024-01-04",0,0,0,0,0,0,0,0
"Kosovo","2024-01-05",0,0,0,0,0,0,0,0
"Kosovo","2024-01-06",0,0,0,0,0,0,0,0
"Kosovo","2024-01-07",0,0,0,0,0,0,0,0
"Kosovo","2024-01-08",0,0,0,0,0,0,0,0
"Kosovo","2024-01-09",0,0,0,0,0,0,0,0
"Kosovo","2024-01-10",0,0,0,0,0,0,0,0
"Kosovo","2024-01-11",0,0,0,0,0,0,0,0
"Kosovo","2024-01-12",0,0,0,0,0,0,0,0
"Kosovo","2024-01-13",0,0,0,0,0,0,0,0
"Kosovo","2024-01-14",0,0,0,0,0,0,0,0
"Kosovo","2024-01-15",0,0,0,0,0,0,0,0
"Kosovo","2024-01-16",0,0,0,0,0,0,0,0
"Kosovo","2024-01-17",0,0,0,0,0,0,0,0
"Kosovo","2024-01-18",0,0,0,0,0,0,0,0
"Kosovo","2024-01-19",0,0,0,0,0,0,0,0
"Kosovo","2024-01-20",0,0,0,0,0,0,0,0
"Kosovo","2024-01-21",0,0,0,0,0,0,0,0
"Kosovo","2024-01-22",0,0,0,0,0,0,0,0
"Kosovo","2024-01-23",0,0,0,0,0,0,0,0
"Kosovo","2024-01-24",0,0,0,0,0,0,0,0
"Kosovo","2024-01-25",0,0,0,0,0,0,0,0
"Kosovo","2024-01-26",0,0,0,0,0,0,0,0
"Kosovo","2024-01-27",0,0,0,0,0,0,0,0
"Kosovo","2024-01-28",0,0,0,0,0,0,0,0
"Kosovo","2024-01-29",0,0,0,0,0,0,0,0
"Kosovo","2024-01-30",0,0,0,0,0,0,0,0
"Kosovo","2024-01-31",0,0,0,0,0,0,0,0
"Kosovo","2024-02-01",0,0,0,0,0,0,0,0
"Kosovo","2024-02-02",0,0,0,0,0,0,0,0
"Kosovo","2024-02-03",0,0,0,0,0,0,0,0
"Kosovo","2024-02-04",0,0,0,0,0,0,0,0
"Kosovo","2024-02-05",0,0,0,0,0,0,0,0
"Kosovo","2024-02-06",0,0,0,0,0,0,0,0
"Kosovo","2024-02-07",0,0,0,0,0,0,0,0
"Kosovo","2024-02-08",0,0,0,0,0,0,0,0
"Kosovo","2024-02-09",0,0,0,0,0,0,0,0
"Kosovo","2024-02-10",0,0,0,0,0,0,0,0
"Kosovo","2024-02-11",0,0,0,0,0,0,0,0
"Kosovo","2024-02-12",0,0,0,0,0,0,0,0
"Kosovo","2024-02-13",0,0,0,0,0,0,0,0
"Kosovo","2024-02-14",0,0,0,0,0,0,0,0
"Kosovo","2024-02-15",0,0,0,0,0,0,0,0
"Kosovo","2024-02-16",0,0,0,0,0,0,0,0
"Kosovo","2024-02-17",0,0,0,0,0,0,0,0
"Kosovo","2024-02-18",0,0,0,0,0,0,0,0
"Kosovo","2024-02-19",0,0,0,0,0,0,0,0
"Kosovo","2024-02-20",0,0,0,0,0,0,0,0
"Kosovo","2024-02-21",0,0,0,0,0,0,0,0
"Kosovo","2024-02-22",0,0,0,0,0,0,0,0
"Kosovo","2024-02-23",0,0,0,0,0,0,0,0
"Kosovo","2024-02-24",0,0,0,0,0,0,0,0
"Kosovo","2024-02-25",0,0,0,0,0,0,0,0
"Kosovo","2024-02-26",0,0,0,0,0,0,0,0
"Kosovo","2024-02-27",0,0,0,0,0,0,0,0
"Kosovo","2024-02-28",0,0,0,0,0,0,0,0
"Kosovo","2024-02-29",0,0,0,0,0,0,0,0
"Kosovo","2024-03-01",0,0,0,0,0,0,0,0
"Kosovo","2024-03-02",0,0,0,0,0,0,0,0
"Kosovo","2024-03-03",0,0,0,0,0,0,0,0
"Kosovo","2024-03-04",0,0,0,0,0,0,0,0
"Kosovo","2024-03-05",0,0,0,0,0,0,0,0
"Kosovo","2024-03-06",0,0,0,0,0,0,0,0
"Kosovo","2024-03-07",0,0,0,0,0,0,0,0
"Kosovo","2024-03-08",0,0,0,0,0,0,0,0
"Kosovo","2024-03-09",0,0,0,0,0,0,0,0
"Kosovo","2024-03-10",0,0,0,0,0,0,0,0
"Kosovo","2024-03-11",0,0,0,0,0,0,0,0
"Kosovo","2024-03-12",0,0,0,0,0,0,0,0
"Kosovo","2024-03-13",0,0,0,0,0,0,0,0
"Kosovo","2024-03-14",0,0,0,0,0,0,0,0
"Kosovo","2024-03-15",0,0,0,0,0,0,0,0
"Kosovo","2024-03-16",0,0,0,0,0,0,0,0
"Kosovo","2024-03-17",0,0,0,0,0,0,0,0
"Kosovo","2024-03-18",0,0,0,0,0,0,0,0
"Kosovo","2024-03-19",0,0,0,0,0,0,0,0
"Kosovo","2024-03-20",0,0,0,0,0,0,0,0
"Kosovo","2024-03-21",0,0,0,0,0,0,0,0
"Kosovo","2024-03-22",0,0,0,0,0,0,0,0
"Kosovo","2024-03-23",0,0,0,0,0,0,0,0
"Kosovo","2024-03-24",0,0,0,0,0,0,0,0
"Kosovo","2024-03-25",0,0,0,0,0,0,0,0
"Kosovo","2024-03-26",0,0,0,0,0,0,0,0
"Kosovo","2024-03-27",0,0,0,0,0,0,0,0
"Kosovo","2024-03-28",0,0,0,0,0,0,0,0
"Kosovo","2024-03-29",0,0,0,0,0,0,0,0
"Kosovo","2024-03-30",0,0,0,0,0,0,0,0
"Kosovo","2024-03-31",0,0,0,0,0,0,0,0
"Kosovo","2024-04-01",0,0,0,0,0,0,0,0
"Kosovo","2024-04-02",0,0,0,0,0,0,0,0
"Kosovo","2024-04-03",0,0,0,0,0,0,0,0
"Kosovo","2024-04-04",0,0,0,0,0,0,0,0
"Kosovo","2024-04-05",0,0,0,0,0,0,0,0
"Kosovo","2024-04-06",0,0,0,0,0,0,0,0
"Kosovo","2024-04-07",0,0,0,0,0,0,0,0
"Kosovo","2024-04-08",0,0,0,0,0,0,0,0
"Kosovo","2024-04-09",0,0,0,0,0,0,0,0
"Kosovo","2024-04-10",0,0,0,0,0,0,0,0
"Kosovo","2024-04-11",0,0,0,0,0,0,0,0
"Kosovo","2024-04-12",0,0,0,0,0,0,0,0
"Kosovo","2024-04-13",0,0,0,0,0,0,0,0
"Kosovo","2024-04-14",0,0,0,0,0,0,0,0
"Kosovo","2024-04-15",0,0,0,0,0,0,0,0
"Kosovo","2024-04-16",0,0,0,0,0,0,0,0
"Kosovo","2024-04-17",0,0,0,0,0,0,0,0
"Kosovo","2024-04-18",0,0,0,0,0,0,0,0
"Kosovo","2024-04-19",0,0,0,0,0,0,0,0
"Kosovo","2024-04-20",0,0,0,0,0,0,0,0
"Kosovo","2024-04-21",0,0,0,0,0,0,0,0
"Kosovo","2024-04-22",0,0,0,0,0,0,0,0
"Kosovo","2024-04-23",0,0,0,0,0,0,0,0
"Kosovo","2024-04-24",0,0,0,0,0,0,0,0
"Kosovo","2024-04-25",0,0,0,0,0,0,0,0
"Kosovo","2024-04-26",0,0,0,0,0,0,0,0
"Kosovo","2024-04-27",0,0,0,0,0,0,0,0
"Kosovo","2024-04-28",0,0,0,0,0,0,0,0
"Kosovo","2024-04-29",0,0,0,0,0,0,0,0
"Kosovo","2024-04-30",0,0,0,0,0,0,0,0
"Kosovo","2024-05-01",0,0,0,0,0,0,0,0
"Kosovo","2024-05-02",0,0,0,0,0,0,0,0
"Kosovo","2024-05-03",0,0,0,0,0,0,0,0
"Kosovo","2024-05-04",0,0,0,0,0,0,0,0
"Kosovo","2024-05-05",0,0,0,0,0,0,0,0
"Kosovo","2024-05-06",0,0,0,0,0,0,0,0
"Kosovo","2024-05-07",0,0,0,0,0,0,0,0
"Kosovo","2024-05-08",0,0,0,0,0,0,0,0
"Kosovo","2024-05-09",0,0,0,0,0,0,0,0
"Kosovo","2024-05-10",0,0,0,0,0,0,0,0
"Kosovo","2024-05-11",0,0,0,0,0,0,0,0
"Kosovo","2024-05-12",0,0,0,0,0,0,0,0
"Kosovo","2024-05-13",0,0,0,0,0,0,0,0
"Kosovo","2024-05-14",0,0,0,0,0,0,0,0
"Kosovo","2024-05-15",0,0,0,0,0,0,0,0
"Kosovo","2024-05-16",0,0,0,0,0,0,0,0
"Kosovo","2024-05-17",0,0,0,0,0,0,0,0
"Kosovo","2024-05-18",0,0,0,0,0,0,0,0
"Kosovo","2024-05-19",0,0,0,0,0,0,0,0
"Kosovo","2024-05-20",0,0,0,0,0,0,0,0
"Kosovo","2024-05-21",0,0,0,0,0,0,0,0
"Kosovo","2024-05-22",0,0,0,0,0,0,0,0
"Kosovo","2024-05-23",0,0,0,0,0,0,0,0
"Kosovo","2024-05-24",0,0,0,0,0,0,0,0
"Kosovo","2024-05-25",0,0,0,0,0,0,0,0
"Kosovo","2024-05-26",0,0,0,0,0,0,0,0
"Kosovo","2024-05-27",0,0,0,0,0,0,0,0
"Kosovo","2024-05-28",0,0,0,0,0,0,0,0
"Kosovo","2024-05-29",0,0,0,0,0,0,0,0
"Kosovo","2024-05-30",0,0,0,0,0,0,0,0
"Kosovo","2024-05-31",0,0,0,0,0,0,0,0
"Kosovo","2024-06-01",0,0,0,0,0,0,0,0
"Kosovo","2024-06-02",0,0,0,0,0,0,0,0
"Kosovo","2024-06-03",0,0,0,0,0,0,0,0
"Kosovo","2024-06-04",0,0,0,0,0,0,0,0
"Kosovo","2024-06-05",0,0,0,0,0,0,0,0
"Kosovo","2024-06-06",0,0,0,0,0,0,0,0
"Kosovo","2024-06-07",0,0,0,0,0,0,0,0
"Kosovo","2024-06-08",0,0,0,0,0,0,0,0
"Kosovo","2024-06-09",0,0,0,0,0,0,0,0
"Kosovo","2024-06-10",0,0,0,0,0,0,0,0
"Kosovo","2024-06-11",0,0,0,0,0,0,0,0
"Kosovo","2024-06-12",0,0,0,0,0,0,0,0
"Kosovo","2024-06-13",0,0,0,0,0,0,0,0
"Kosovo","2024-06-14",0,0,0,0,0,0,0,0
"Kosovo","2024-06-15",0,0,0,0,0,0,0,0
"Kosovo","2024-06-16",0,0,0,0,0,0,0,0
"Kosovo","2024-06-17",0,0,0,0,0,0,0,0
"Kosovo","2024-06-18",0,0,0,0,0,0,0,0
"Kosovo","2024-06-19",0,0,0,0,0,0,0,0
"Kosovo","2024-06-20",0,0,0,0,0,0,0,0
"Kosovo","2024-06-21",0,0,0,0,0,0,0,0
"Kosovo","2024-06-22",0,0,0,0,0,0,0,0
"Kosovo","2024-06-23",0,0,0,0,0,0,0,0
"Kosovo","2024-06-24",0,0,0,0,0,0,0,0
"Kosovo","2024-06-25",0,0,0,0,0,0,0,0
"Kosovo","2024-06-26",0,0,0,0,0,0,0,0
"Kosovo","2024-06-27",0,0,0,0,0,0,0,0
"Kosovo","2024-06-28",0,0,0,0,0,0,0,0
"Kosovo","2024-06-29",0,0,0,0,0,0,0,0
"Kosovo","2024-06-30",0,0,0,0,0,0,0,0
"Kosovo","2024-07-01",0,0,0,0,0,0,0,0
"Kosovo","2024-07-02",0,0,0,0,0,0,0,0
"Kosovo","2024-07-03",0,0,0,0,0,0,0,0
"Kosovo","2024-07-04",0,0,0,0,0,0,0,0
"Kosovo","2024-07-05",0,0,0,0,0,0,0,0
"Kosovo","2024-07-06",0,0,0,0,0,0,0,0
"Kosovo","2024-07-07",0,0,0,0,0,0,0,0
"Kosovo","2024-07-08",0,0,0,0,0,0,0,0
"Kosovo","2024-07-09",0,0,0,0,0,0,0,0
"Kosovo","2024-07-10",0,0,0,0,0,0,0,0
"Kosovo","2024-07-11",0,0,0,0,0,0,0,0
"Kosovo","2024-07-12",0,0,0,0,0,0,0,0
"Kosovo","2024-07-13",0,0,0,0,0,0,0,0
"Kosovo","2024-07-14",0,0,0,0,0,0,0,0
"Kosovo","2024-07-15",0,0,0,0,0,0,0,0
"Kosovo","2024-07-16",0,0,0,0,0,0,0,0
"Kosovo","2024-07-17",0,0,0,0,0,0,0,0
"Kosovo","2024-07-18",0,0,0,0,0,0,0,0
"Kosovo","2024-07-19",0,0,0,0,0,0,0,0
"Kosovo","2024-07-20",0,0,0,0,0,0,0,0
"Kosovo","2024-07-21",0,0,0,0,0,0,0,0
"Kosovo","2024-07-22",0,0,0,0,0,0,0,0
"Kosovo","2024-07-23",0,0,0,0,0,0,0,0
"Kosovo","2024-07-24",0,0,0,0,0,0,0,0
"Kosovo","2024-07-25",0,0,0,0,0,0,0,0
"Kosovo","2024-07-26",0,0,0,0,0,0,0,0
"Kosovo","2024-07-27",0,0,0,0,0,0,0,0
"Kosovo","2024-07-28",0,0,0,0,0,0,0,0
"Kosovo","2024-07-29",0,0,0,0,0,0,0,0
"Kosovo","2024-07-30",0,0,0,0,0,0,0,0
"Kosovo","2024-07-31",0,0,0,0,0,0,0,0
"Kosovo","2024-08-01",0,0,0,0,0,0,0,0
"Kosovo","2024-08-02",0,0,0,0,0,0,0,0
"Kosovo","2024-08-03",0,0,0,0,0,0,0,0
"Kosovo","2024-08-04",0,0,0,0,0,0,0,0
"Kosovo","2024-08-05",0,0,0,0,0,0,0,0
"Kosovo","2024-08-06",0,0,0,0,0,0,0,0
"Kosovo","2024-08-07",0,0,0,0,0,0,0,0
"Kosovo","2024-08-08",0,0,0,0,0,0,0,0
"Kosovo","2024-08-09",0,0,0,0,0,0,0,0
"Kosovo","2024-08-10",0,0,0,0,0,0,0,0
"Kosovo","2024-08-11",0,0,0,0,0,0,0,0
"Kosovo","2024-08-12",0,0,0,0,0,0,0,0
"Kosovo","2024-08-13",0,0,0,0,0,0,0,0
"Kosovo","2024-08-14",0,0,0,0,0,0,0,0
"Kosovo","2024-08-15",0,0,0,0,0,0,0,0
"Kosovo","2024-08-16",0,0,0,0,0,0,0,0
"Kosovo","2024-08-17",0,0,0,0,0,0,0,0
"Kosovo","2024-08-18",0,0,0,0,0,0,0,0
"Kosovo","2024-08-19",0,0,0,0,0,0,0,0
"Kosovo","2024-08-20",0,0,0,0,0,0,0,0
"Kosovo","2024-08-21",0,0,0,0,0,0,0,0
"Kosovo","2024-08-22",0,0,0,0,0,0,0,0
"Kosovo","2024-08-23",0,0,0,0,0,0,0,0
"Kosovo","2024-08-24",0,0,0,0,0,0,0,0
"Kosovo","2024-08-25",0,0,0,0,0,0,0,0
"Kosovo","2024-08-26",0,0,0,0,0,0,0,0
"Kosovo","2024-08-27",0,0,0,0,0,0,0,0
"Kosovo","2024-08-28",0,0,0,0,0,0,0,0
"Kosovo","2024-08-29",0,0,0,0,0,0,0,0
"Kosovo","2024-08-30",0,0,0,0,0,0,0,0
"Kosovo","2024-08-31",0,0,0,0,0,0,0,0
"Kosovo","2024-09-01",0,0,0,0,0,0,0,0
"Kosovo","2024-09-02",0,0,0,0,0,0,0,0
"Kosovo","2024-09-03",0,0,0,0,0,0,0,0
"Kosovo","2024-09-04",0,0,0,0,0,0,0,0
"Kosovo","2024-09-05",0,0,0,0,0,0,0,0
"Kosovo","2024-09-06",0,0,0,0,0,0,0,0
"Kosovo","2024-09-07",0,0,0,0,0,0,0,0
"Kosovo","2024-09-08",0,0,0,0,0,0,0,0
"Kosovo","2024-09-09",0,0,0,0,0,0,0,0
"Kosovo","2024-09-10",0,0,0,0,0,0,0,0
"Kosovo","2024-09-11",0,0,0,0,0,0,0,0
"Kosovo","2024-09-12",0,0,0,0,0,0,0,0
"Kosovo","2024-09-13",0,0,0,0,0,0,0,0
"Kosovo","2024-09-14",0,0,0,0,0,0,0,0
"Kosovo","2024-09-15",0,0,0,0,0,0,0,0
"Kosovo","2024-09-16",0,0,0,0,0,0,0,0
"Kosovo","2024-09-17",0,0,0,0,0,0,0,0
"Kosovo","2024-09-18",0,0,0,0,0,0,0,0
"Kosovo","2024-09-19",0,0,0,0,0,0,0,0
"Kosovo","2024-09-20",0,0,0,0,0,0,0,0
"Kosovo","2024-09-21",0,0,0,0,0,0,0,0
"Kosovo","2024-09-22",0,0,0,0,0,0,0,0
"Kosovo","2024-09-23",0,0,0,0,0,0,0,0
"Kosovo","2024-09-24",0,0,0,0,0,0,0,0
"Kosovo","2024-09-25",0,0,0,0,0,0,0,0
"Kosovo","2024-09-26",0,0,0,0,0,0,0,0
"Kosovo","2024-09-27",0,0,0,0,0,0,0,0
"Kosovo","2024-09-28",0,0,0,0,0,0,0,0
"Kosovo","2024-09-29",0,0,0,0,0,0,0,0
"Kosovo","2024-09-30",0,0,0,0,0,0,0,0
"Kosovo","2024-10-01",0,0,0,0,0,0,0,0
"Kosovo","2024-10-02",0,0,0,0,0,0,0,0
"Kosovo","2024-10-03",0,0,0,0,0,0,0,0
"Kosovo","2024-10-04",0,0,0,0,0,0,0,0
"Kosovo","2024-10-05",0,0,0,0,0,0,0,0
"Kosovo","2024-10-06",0,0,0,0,0,0,0,0
"Kosovo","2024-10-07",0,0,0,0,0,0,0,0
"Kosovo","2024-10-08",0,0,0,0,0,0,0,0
"Kosovo","2024-10-09",0,0,0,0,0,0,0,0
"Kosovo","2024-10-10",0,0,0,0,0,0,0,0
"Kosovo","2024-10-11",0,0,0,0,0,0,0,0
"Kosovo","2024-10-12",0,0,0,0,0,0,0,0
"Kosovo","2024-10-13",0,0,0,0,0,0,0,0
"Kosovo","2024-10-14",0,0,0,0,0,0,0,0
"Kosovo","2024-10-15",0,0,0,0,0,0,0,0
"Kosovo","2024-10-16",0,0,0,0,0,0,0,0
"Kosovo","2024-10-17",0,0,0,0,0,0,0,0
"Kosovo","2024-10-18",0,0,0,0,0,0,0,0
"Kosovo","2024-10-19",0,0,0,0,0,0,0,0
"Kosovo","2024-10-20",0,0,0,0,0,0,0,0
"Kosovo","2024-10-21",0,0,0,0,0,0,0,0
"Kosovo","2024-10-22",0,0,0,0,0,0,0,0
"Kosovo","2024-10-23",0,0,0,0,0,0,0,0
"Kosovo","2024-10-24",0,0,0,0,0,0,0,0
"Kosovo","2024-10-25",0,0,0,0,0,0,0,0
"Kosovo","2024-10-26",0,0,0,0,0,0,0,0
"Kosovo","2024-10-27",0,0,0,0,0,0,0,0
"Kosovo","2024-10-28",0,0,0,0,0,0,0,0
"Kosovo","2024-10-29",0,0,0,0,0,0,0,0
"Kosovo","2024-10-30",0,0,0,0,0,0,0,0
"Kosovo","2024-10-31",0,0,0,0,0,0,0,0
"Kosovo","2024-11-01",0,0,0,0,0,0,0,0
"Kosovo","2024-11-02",0,0,0,0,0,0,0,0
"Kosovo","2024-11-03",0,0,0,0,0,0,0,0
"Kosovo","2024-11-04",0,0,0,0,0,0,0,0
"Kosovo","2024-11-05",0,0,0,0,0,0,0,0
"Kosovo","2024-11-06",0,0,0,0,0,0,0,0
"Kosovo","2024-11-07",0,0,0,0,0,0,0,0
"Kosovo","2024-11-08",0,0,0,0,0,0,0,0
"Kosovo","2024-11-09",0,0,0,0,0,0,0,0
"Kosovo","2024-11-10",0,0,0,0,0,0,0,0
"Kosovo","2024-11-11",0,0,0,0,0,0,0,0
"Kosovo","2024-11-12",0,0,0,0,0,0,0,0
"Kosovo","2024-11-13",0,0,0,0,0,0,0,0
"Kosovo","2024-11-14",0,0,0,0,0,0,0,0
"Kosovo","2024-11-15",0,0,0,0,0,0,0,0
"Kosovo","2024-11-16",0,0,0,0,0,0,0,0
"Kosovo","2024-11-17",0,0,0,0,0,0,0,0
"Kosovo","2024-11-18",0,0,0,0,0,0,0,0
"Kosovo","2024-11-19",0,0,0,0,0,0,0,0
"Kosovo","2024-11-20",0,0,0,0,0,0,0,0
"Kosovo","2024-11-21",0,0,0,0,0,0,0,0
"Kosovo","2024-11-22",0,0,0,0,0,0,0,0
"Kosovo","2024-11-23",0,0,0,0,0,0,0,0
"Kosovo","2024-11-24",0,0,0,0,0,0,0,0
"Kosovo","2024-11-25",0,0,0,0,0,0,0,0
"Kosovo","2024-11-26",0,0,0,0,0,0,0,0
"Kosovo","2024-11-27",0,0,0,0,0,0,0,0
"Kosovo","2024-11-28",0,0,0,0,0,0,0,0
"Kosovo","2024-11-29",0,0,0,0,0,0,0,0
"Kosovo","2024-11-30",0,0,0,0,0,0,0,0
"Kosovo","2024-12-01",0,0,0,0,0,0,0,0
"Kosovo","2024-12-02",0,0,0,0,0,0,0,0
"Kosovo","2024-12-03",0,0,0,0,0,0,0,0
"Kosovo","2024-12-04",0,0,0,0,0,0,0,0
"Kosovo","2024-12-05",0,0,0,0,0,0,0,0
"Kosovo","2024-12-06",0,0,0,0,0,0,0,0
"Kosovo","2024-12-07",0,0,0,0,0,0,0,0
"Kosovo","2024-12-08",0,0,0,0,0,0,0,0
"Kosovo","2024-12-09",0,0,0,0,0,0,0,0
"Kosovo","2024-12-10",0,0,0,0,0,0,0,0
"Kosovo","2024-12-11",0,0,0,0,0,0,0,0
"Kosovo","2024-12-12",0,0,0,0,0,0,0,0
"Kosovo","2024-12-13",0,0,0,0,0,0,0,0
"Kosovo","2024-12-14",0,0,0,0,0,0,0,0
"Kosovo","2024-12-15",0,0,0,0,0,0,0,0
"Kosovo","2024-12-16",0,0,0,0,0,0,0,0
"Kosovo","2024-12-17",0,0,0,0,0,0,0,0
"Kosovo","2024-12-18",0,0,0,0,0,0,0,0
"Kosovo","2024-12-19",0,0,0,0,0,0,0,0
"Kosovo","2024-12-20",0,0,0,0,0,0,0,0
"Kosovo","2024-12-21",0,0,0,0,0,0,0,0
"Kosovo","2024-12-22",0,0,0,0,0,0,0,0
"Kosovo","2024-12-23",0,0,0,0,0,0,0,0
"Kosovo","2024-12-24",0,0,0,0,0,0,0,0
"Kosovo","2024-12-25",0,0,0,0,0,0,0,0
"Kosovo","2024-12-26",0,0,0,0,0,0,0,0
"Kosovo","2024-12-27",0,0,0,0,0,0,0,0
"Kosovo","2024-12-28",0,0,0,0,0,0,0,0
"Kosovo","2024-12-29",0,0,0,0,0,0,0,0
"Kosovo","2024-12-30",0,0,0,0,0,0,0,0
"Kosovo","2024-12-31",0,1,1,0,1,1,0,0
"Kosovo","2025-01-01",0,0,1,0,0,1,0,0
"Kosovo","2025-01-02",0,0,1,0,0,1,0,0
"Kosovo","2025-01-03",0,0,1,0,0,1,0,0
"Kosovo","2025-01-04",0,0,1,0,0,1,0,0
"Kosovo","2025-01-05",0,0,1,0,0,1,0,0
"Kosovo","2025-01-06",0,0,1,0,0,1,0,0
"Kosovo","2025-01-07",0,0,1,0,0,1,0,0
"Kosovo","2025-01-08",0,0,1,0,0,1,0,0
"Kosovo","2025-01-09",0,0,1,0,0,1,0,0
"Kosovo","2025-01-10",0,0,1,0,0,1,0,0
"Kosovo","2025-01-11",0,0,1,0,0,1,0,0
"Kosovo","2025-01-12",0,0,1,0,0,1,0,0
"Kosovo","2025-01-13",0,0,1,0,0,1,0,0
"Kosovo","2025-01-14",0,0,1,0,0,1,0,0
"Kosovo","2025-01-15",0,0,1,0,0,1,0,0
"Kosovo","2025-01-16",0,0,1,0,0,1,0,0
"Kosovo","2025-01-17",0,0,1,0,0,1,0,0
"Kosovo","2025-01-18",0,0,1,0,0,1,0,0
"Kosovo","2025-01-19",0,0,1,0,0,1,0,0
"Kosovo","2025-01-20",0,0,1,0,0,1,0,0
"Kosovo","2025-01-21",0,0,1,0,0,1,0,0
"Kosovo","2025-01-22",0,0,1,0,0,1,0,0
"Kosovo","2025-01-23",0,0,1,0,0,1,0,0
"Kosovo","2025-01-24",0,0,1,0,0,1,0,0
"Kosovo","2025-01-25",0,0,1,0,0,1,0,0
"Kosovo","2025-01-26",0,0,1,0,0,1,0,0
"Kosovo","2025-01-27",0,0,1,0,0,1,0,0
"Kosovo","2025-01-28",0,0,1,0,0,1,0,0
"Kosovo","2025-01-29",0,0,1,0,0,1,0,0
"Kosovo","2025-01-30",0,0,1,0,0,1,0,0
"Kosovo","2025-01-31",0,0,1,0,0,1,0,0
"Kosovo","2025-02-01",0,0,1,0,0,1,0,0
"Kosovo","2025-02-02",0,0,1,0,0,1,0,0
"Kosovo","2025-02-03",0,0,1,0,0,1,0,0
"Kosovo","2025-02-04",0,0,1,0,0,1,0,0
"Kosovo","2025-02-05",0,0,1,0,0,1,0,0
"Kosovo","2025-02-06",0,0,1,0,0,1,0,0
"Kosovo","2025-02-07",0,0,1,0,0,1,0,0
"Kosovo","2025-02-08",0,0,1,0,0,1,0,0
"Kosovo","2025-02-09",0,0,1,0,0,1,0,0
"Kosovo","2025-02-10",0,0,1,0,0,1,0,0
"Kosovo","2025-02-11",0,0,1,0,0,1,0,0
"Kosovo","2025-02-12",0,0,1,0,0,1,0,0
"Kosovo","2025-02-13",0,0,1,0,0,1,0,0
"Kosovo","2025-02-14",0,0,1,0,0,1,0,0
"Kosovo","2025-02-15",0,0,1,0,0,1,0,0
"Kosovo","2025-02-16",0,0,1,0,0,1,0,0
"Kosovo","2025-02-17",0,0,1,0,0,1,0,0
"Kosovo","2025-02-18",0,0,1,0,0,1,0,0
"Kosovo","2025-02-19",0,0,1,0,0,1,0,0
"Kosovo","2025-02-20",0,0,1,0,0,1,0,0
"Kosovo","2025-02-21",0,0,1,0,0,1,0,0
"Kosovo","2025-02-22",0,0,1,0,0,1,0,0
"Kosovo","2025-02-23",0,0,1,0,0,1,0,0
"Kosovo","2025-02-24",0,0,1,0,0,1,0,0
"Kosovo","2025-02-25",0,0,1,0,0,1,0,0
"Kosovo","2025-02-26",0,0,1,0,0,1,0,0
"Kosovo","2025-02-27",0,0,1,0,0,1,0,0
"Kosovo","2025-02-28",0,0,1,0,0,1,0,0
"Kosovo","2025-03-01",0,0,1,0,0,1,0,0
"Kosovo","2025-03-02",0,0,1,0,0,1,0,0
"Kosovo","2025-03-03",0,0,1,0,0,1,0,0
"Latvia","2024-01-01",0,0,0,0,0,0,0,0
"Latvia","2024-01-02",0,0,0,0,0,0,0,0
"Latvia","2024-01-03",0,0,0,0,0,0,0,0
"Latvia","2024-01-04",0,0,0,0,0,0,0,0
"Latvia","2024-01-05",0,0,0,0,0,0,0,0
"Latvia","2024-01-06",0,0,0,0,0,0,0,0
"Latvia","2024-01-07",0,0,0,0,0,0,0,0
"Latvia","2024-01-08",0,0,0,0,0,0,0,0
"Latvia","2024-01-09",0,0,0,0,0,0,0,0
"Latvia","2024-01-10",0,0,0,0,0,0,0,0
"Latvia","2024-01-11",0,0,0,0,0,0,0,0
"Latvia","2024-01-12",0,0,0,0,0,0,0,0
"Latvia","2024-01-13",0,0,0,0,0,0,0,0
"Latvia","2024-01-14",0,0,0,0,0,0,0,0
"Latvia","2024-01-15",0,0,0,0,0,0,0,0
"Latvia","2024-01-16",0,0,0,0,0,0,0,0
"Latvia","2024-01-17",0,0,0,0,0,0,0,0
"Latvia","2024-01-18",0,0,0,0,0,0,0,0
"Latvia","2024-01-19",0,0,0,0,0,0,0,0
"Latvia","2024-01-20",0,0,0,0,0,0,0,0
"Latvia","2024-01-21",0,0,0,0,0,0,0,0
"Latvia","2024-01-22",0,0,0,0,0,0,0,0
"Latvia","2024-01-23",0,0,0,0,0,0,0,0
"Latvia","2024-01-24",0,0,0,0,0,0,0,0
"Latvia","2024-01-25",0,0,0,0,0,0,0,0
"Latvia","2024-01-26",0,0,0,0,0,0,0,0
"Latvia","2024-01-27",0,0,0,0,0,0,0,0
"Latvia","2024-01-28",0,0,0,0,0,0,0,0
"Latvia","2024-01-29",0,0,0,0,0,0,0,0
"Latvia","2024-01-30",0,0,0,0,0,0,0,0
"Latvia","2024-01-31",0,0,0,0,0,0,0,0
"Latvia","2024-02-01",0,0,0,0,0,0,0,0
"Latvia","2024-02-02",0,0,0,0,0,0,0,0
"Latvia","2024-02-03",0,0,0,0,0,0,0,0
"Latvia","2024-02-04",0,0,0,0,0,0,0,0
"Latvia","2024-02-05",0,0,0,0,0,0,0,0
"Latvia","2024-02-06",0,0,0,0,0,0,0,0
"Latvia","2024-02-07",0,0,0,0,0,0,0,0
"Latvia","2024-02-08",0,0,0,0,0,0,0,0
"Latvia","2024-02-09",0,0,0,0,0,0,0,0
"Latvia","2024-02-10",0,0,0,0,0,0,0,0
"Latvia","2024-02-11",0,0,0,0,0,0,0,0
"Latvia","2024-02-12",0,0,0,0,0,0,0,0
"Latvia","2024-02-13",0,0,0,0,0,0,0,0
"Latvia","2024-02-14",0,0,0,0,0,0,0,0
"Latvia","2024-02-15",0,0,0,0,0,0,0,0
"Latvia","2024-02-16",0,0,0,0,0,0,0,0
"Latvia","2024-02-17",0,0,0,0,0,0,0,0
"Latvia","2024-02-18",0,0,0,0,0,0,0,0
"Latvia","2024-02-19",0,0,0,0,0,0,0,0
"Latvia","2024-02-20",0,0,0,0,0,0,0,0
"Latvia","2024-02-21",0,0,0,0,0,0,0,0
"Latvia","2024-02-22",0,0,0,0,0,0,0,0
"Latvia","2024-02-23",0,0,0,0,0,0,0,0
"Latvia","2024-02-24",0,0,0,0,0,0,0,0
"Latvia","2024-02-25",0,0,0,0,0,0,0,0
"Latvia","2024-02-26",0,0,0,0,0,0,0,0
"Latvia","2024-02-27",0,0,0,0,0,0,0,0
"Latvia","2024-02-28",0,0,0,0,0,0,0,0
"Latvia","2024-02-29",0,0,0,0,0,0,0,0
"Latvia","2024-03-01",0,0,0,0,0,0,0,0
"Latvia","2024-03-02",0,0,0,0,0,0,0,0
"Latvia","2024-03-03",0,0,0,0,0,0,0,0
"Latvia","2024-03-04",0,0,0,0,0,0,0,0
"Latvia","2024-03-05",0,0,0,0,0,0,0,0
"Latvia","2024-03-06",0,0,0,0,0,0,0,0
"Latvia","2024-03-07",0,0,0,0,0,0,0,0
"Latvia","2024-03-08",0,0,0,0,0,0,0,0
"Latvia","2024-03-09",0,0,0,0,0,0,0,0
"Latvia","2024-03-10",0,0,0,0,0,0,0,0
"Latvia","2024-03-11",0,0,0,0,0,0,0,0
"Latvia","2024-03-12",0,0,0,0,0,0,0,0
"Latvia","2024-03-13",0,0,0,0,0,0,0,0
"Latvia","2024-03-14",0,0,0,0,0,0,0,0
"Latvia","2024-03-15",0,0,0,0,0,0,0,0
"Latvia","2024-03-16",0,0,0,0,0,0,0,0
"Latvia","2024-03-17",0,0,0,0,0,0,0,0
"Latvia","2024-03-18",0,0,0,0,0,0,0,0
"Latvia","2024-03-19",0,0,0,0,0,0,0,0
"Latvia","2024-03-20",0,0,0,0,0,0,0,0
"Latvia","2024-03-21",0,0,0,0,0,0,0,0
"Latvia","2024-03-22",0,0,0,0,0,0,0,0
"Latvia","2024-03-23",0,0,0,0,0,0,0,0
"Latvia","2024-03-24",0,0,0,0,0,0,0,0
"Latvia","2024-03-25",0,0,0,0,0,0,0,0
"Latvia","2024-03-26",0,0,0,0,0,0,0,0
"Latvia","2024-03-27",0,0,0,0,0,0,0,0
"Latvia","2024-03-28",0,0,0,0,0,0,0,0
"Latvia","2024-03-29",0,0,0,0,0,0,0,0
"Latvia","2024-03-30",0,0,0,0,0,0,0,0
"Latvia","2024-03-31",0,0,0,0,0,0,0,0
"Latvia","2024-04-01",0,0,0,0,0,0,0,0
"Latvia","2024-04-02",0,0,0,0,0,0,0,0
"Latvia","2024-04-03",0,0,0,0,0,0,0,0
"Latvia","2024-04-04",0,0,0,0,0,0,0,0
"Latvia","2024-04-05",0,0,0,0,0,0,0,0
"Latvia","2024-04-06",0,0,0,0,0,0,0,0
"Latvia","2024-04-07",0,0,0,0,0,0,0,0
"Latvia","2024-04-08",0,0,0,0,0,0,0,0
"Latvia","2024-04-09",0,0,0,0,0,0,0,0
"Latvia","2024-04-10",0,0,0,0,0,0,0,0
"Latvia","2024-04-11",0,0,0,0,0,0,0,0
"Latvia","2024-04-12",0,0,0,0,0,0,0,0
"Latvia","2024-04-13",0,0,0,0,0,0,0,0
"Latvia","2024-04-14",0,0,0,0,0,0,0,0
"Latvia","2024-04-15",0,0,0,0,0,0,0,0
"Latvia","2024-04-16",0,0,0,0,0,0,0,0
"Latvia","2024-04-17",0,0,0,0,0,0,0,0
"Latvia","2024-04-18",0,0,0,0,0,0,0,0
"Latvia","2024-04-19",0,0,0,0,0,0,0,0
"Latvia","2024-04-20",0,0,0,0,0,0,0,0
"Latvia","2024-04-21",0,0,0,0,0,0,0,0
"Latvia","2024-04-22",0,0,0,0,0,0,0,0
"Latvia","2024-04-23",0,0,0,0,0,0,0,0
"Latvia","2024-04-24",0,0,0,0,0,0,0,0
"Latvia","2024-04-25",0,0,0,0,0,0,0,0
"Latvia","2024-04-26",0,0,0,0,0,0,0,0
"Latvia","2024-04-27",0,0,0,0,0,0,0,0
"Latvia","2024-04-28",0,0,0,0,0,0,0,0
"Latvia","2024-04-29",0,0,0,0,0,0,0,0
"Latvia","2024-04-30",0,0,0,0,0,0,0,0
"Latvia","2024-05-01",0,0,0,0,0,0,0,0
"Latvia","2024-05-02",0,0,0,0,0,0,0,0
"Latvia","2024-05-03",0,0,0,0,0,0,0,0
"Latvia","2024-05-04",0,0,0,0,0,0,0,0
"Latvia","2024-05-05",0,0,0,0,0,0,0,0
"Latvia","2024-05-06",0,0,0,0,0,0,0,0
"Latvia","2024-05-07",0,0,0,0,0,0,0,0
"Latvia","2024-05-08",0,0,0,0,0,0,0,0
"Latvia","2024-05-09",0,0,0,0,0,0,0,0
"Latvia","2024-05-10",0,0,0,0,0,0,0,0
"Latvia","2024-05-11",0,0,0,0,0,0,0,0
"Latvia","2024-05-12",0,0,0,0,0,0,0,0
"Latvia","2024-05-13",0,0,0,0,0,0,0,0
"Latvia","2024-05-14",0,0,0,0,0,0,0,0
"Latvia","2024-05-15",0,0,0,0,0,0,0,0
"Latvia","2024-05-16",0,0,0,0,0,0,0,0
"Latvia","2024-05-17",0,0,0,0,0,0,0,0
"Latvia","2024-05-18",0,0,0,0,0,0,0,0
"Latvia","2024-05-19",0,0,0,0,0,0,0,0
"Latvia","2024-05-20",0,0,0,0,0,0,0,0
"Latvia","2024-05-21",0,0,0,0,0,0,0,0
"Latvia","2024-05-22",0,0,0,0,0,0,0,0
"Latvia","2024-05-23",0,0,0,0,0,0,0,0
"Latvia","2024-05-24",0,0,0,0,0,0,0,0
"Latvia","2024-05-25",0,0,0,0,0,0,0,0
"Latvia","2024-05-26",0,0,0,0,0,0,0,0
"Latvia","2024-05-27",0,0,0,0,0,0,0,0
"Latvia","2024-05-28",0,0,0,0,0,0,0,0
"Latvia","2024-05-29",0,0,0,0,0,0,0,0
"Latvia","2024-05-30",0,0,0,0,0,0,0,0
"Latvia","2024-05-31",0,0,0,0,0,0,0,0
"Latvia","2024-06-01",0,0,0,0,0,0,0,0
"Latvia","2024-06-02",0,0,0,0,0,0,0,0
"Latvia","2024-06-03",0,0,0,0,0,0,0,0
"Latvia","2024-06-04",0,0,0,0,0,0,0,0
"Latvia","2024-06-05",0,0,0,0,0,0,0,0
"Latvia","2024-06-06",0,0,0,0,0,0,0,0
"Latvia","2024-06-07",0,0,0,0,0,0,0,0
"Latvia","2024-06-08",0,0,0,0,0,0,0,0
"Latvia","2024-06-09",0,0,0,0,0,0,0,0
"Latvia","2024-06-10",0,0,0,0,0,0,0,0
"Latvia","2024-06-11",0,0,0,0,0,0,0,0
"Latvia","2024-06-12",0,0,0,0,0,0,0,0
"Latvia","2024-06-13",0,0,0,0,0,0,0,0
"Latvia","2024-06-14",0,0,0,0,0,0,0,0
"Latvia","2024-06-15",0,0,0,0,0,0,0,0
"Latvia","2024-06-16",0,0,0,0,0,0,0,0
"Latvia","2024-06-17",0,0,0,0,0,0,0,0
"Latvia","2024-06-18",0,0,0,0,0,0,0,0
"Latvia","2024-06-19",0,0,0,0,0,0,0,0
"Latvia","2024-06-20",0,0,0,0,0,0,0,0
"Latvia","2024-06-21",0,0,0,0,0,0,0,0
"Latvia","2024-06-22",0,0,0,0,0,0,0,0
"Latvia","2024-06-23",0,0,0,0,0,0,0,0
"Latvia","2024-06-24",0,0,0,0,0,0,0,0
"Latvia","2024-06-25",0,0,0,0,0,0,0,0
"Latvia","2024-06-26",0,0,0,0,0,0,0,0
"Latvia","2024-06-27",0,0,0,0,0,0,0,0
"Latvia","2024-06-28",0,0,0,0,0,0,0,0
"Latvia","2024-06-29",0,0,0,0,0,0,0,0
"Latvia","2024-06-30",0,0,0,0,0,0,0,0
"Latvia","2024-07-01",0,0,0,0,0,0,0,0
"Latvia","2024-07-02",0,0,0,0,0,0,0,0
"Latvia","2024-07-03",0,0,0,0,0,0,0,0
"Latvia","2024-07-04",0,0,0,0,0,0,0,0
"Latvia","2024-07-05",0,0,0,0,0,0,0,0
"Latvia","2024-07-06",0,0,0,0,0,0,0,0
"Latvia","2024-07-07",0,0,0,0,0,0,0,0
"Latvia","2024-07-08",0,0,0,0,0,0,0,0
"Latvia","2024-07-09",0,0,0,0,0,0,0,0
"Latvia","2024-07-10",0,0,0,0,0,0,0,0
"Latvia","2024-07-11",0,0,0,0,0,0,0,0
"Latvia","2024-07-12",0,0,0,0,0,0,0,0
"Latvia","2024-07-13",0,0,0,0,0,0,0,0
"Latvia","2024-07-14",0,0,0,0,0,0,0,0
"Latvia","2024-07-15",0,0,0,0,0,0,0,0
"Latvia","2024-07-16",0,0,0,0,0,0,0,0
"Latvia","2024-07-17",0,0,0,0,0,0,0,0
"Latvia","2024-07-18",0,0,0,0,0,0,0,0
"Latvia","2024-07-19",0,0,0,0,0,0,0,0
"Latvia","2024-07-20",0,0,0,0,0,0,0,0
"Latvia","2024-07-21",0,0,0,0,0,0,0,0
"Latvia","2024-07-22",0,0,0,0,0,0,0,0
"Latvia","2024-07-23",0,0,0,0,0,0,0,0
"Latvia","2024-07-24",0,0,0,0,0,0,0,0
"Latvia","2024-07-25",0,0,0,0,0,0,0,0
"Latvia","2024-07-26",0,0,0,0,0,0,0,0
"Latvia","2024-07-27",0,0,0,0,0,0,0,0
"Latvia","2024-07-28",0,0,0,0,0,0,0,0
"Latvia","2024-07-29",0,0,0,0,0,0,0,0
"Latvia","2024-07-30",0,0,0,0,0,0,0,0
"Latvia","2024-07-31",0,0,0,0,0,0,0,0
"Latvia","2024-08-01",0,0,0,0,0,0,0,0
"Latvia","2024-08-02",0,0,0,0,0,0,0,0
"Latvia","2024-08-03",0,0,0,0,0,0,0,0
"Latvia","2024-08-04",0,0,0,0,0,0,0,0
"Latvia","2024-08-05",0,0,0,0,0,0,0,0
"Latvia","2024-08-06",0,0,0,0,0,0,0,0
"Latvia","2024-08-07",0,0,0,0,0,0,0,0
"Latvia","2024-08-08",0,0,0,0,0,0,0,0
"Latvia","2024-08-09",0,0,0,0,0,0,0,0
"Latvia","2024-08-10",0,0,0,0,0,0,0,0
"Latvia","2024-08-11",0,0,0,0,0,0,0,0
"Latvia","2024-08-12",0,0,0,0,0,0,0,0
"Latvia","2024-08-13",0,0,0,0,0,0,0,0
"Latvia","2024-08-14",0,0,0,0,0,0,0,0
"Latvia","2024-08-15",0,0,0,0,0,0,0,0
"Latvia","2024-08-16",0,0,0,0,0,0,0,0
"Latvia","2024-08-17",0,0,0,0,0,0,0,0
"Latvia","2024-08-18",0,0,0,0,0,0,0,0
"Latvia","2024-08-19",0,0,0,0,0,0,0,0
"Latvia","2024-08-20",0,0,0,0,0,0,0,0
"Latvia","2024-08-21",0,0,0,0,0,0,0,0
"Latvia","2024-08-22",0,0,0,0,0,0,0,0
"Latvia","2024-08-23",0,0,0,0,0,0,0,0
"Latvia","2024-08-24",0,0,0,0,0,0,0,0
"Latvia","2024-08-25",0,0,0,0,0,0,0,0
"Latvia","2024-08-26",0,0,0,0,0,0,0,0
"Latvia","2024-08-27",0,0,0,0,0,0,0,0
"Latvia","2024-08-28",0,0,0,0,0,0,0,0
"Latvia","2024-08-29",0,0,0,0,0,0,0,0
"Latvia","2024-08-30",0,0,0,0,0,0,0,0
"Latvia","2024-08-31",0,0,0,0,0,0,0,0
"Latvia","2024-09-01",0,0,0,0,0,0,0,0
"Latvia","2024-09-02",0,0,0,0,0,0,0,0
"Latvia","2024-09-03",0,0,0,0,0,0,0,0
"Latvia","2024-09-04",0,0,0,0,0,0,0,0
"Latvia","2024-09-05",0,0,0,0,0,0,0,0
"Latvia","2024-09-06",0,0,0,0,0,0,0,0
"Latvia","2024-09-07",0,0,0,0,0,0,0,0
"Latvia","2024-09-08",0,0,0,0,0,0,0,0
"Latvia","2024-09-09",0,0,0,0,0,0,0,0
"Latvia","2024-09-10",0,0,0,0,0,0,0,0
"Latvia","2024-09-11",0,0,0,0,0,0,0,0
"Latvia","2024-09-12",0,0,0,0,0,0,0,0
"Latvia","2024-09-13",0,0,0,0,0,0,0,0
"Latvia","2024-09-14",0,0,0,0,0,0,0,0
"Latvia","2024-09-15",0,0,0,0,0,0,0,0
"Latvia","2024-09-16",0,0,0,0,0,0,0,0
"Latvia","2024-09-17",0,0,0,0,0,0,0,0
"Latvia","2024-09-18",0,0,0,0,0,0,0,0
"Latvia","2024-09-19",0,0,0,0,0,0,0,0
"Latvia","2024-09-20",0,0,0,0,0,0,0,0
"Latvia","2024-09-21",0,0,0,0,0,0,0,0
"Latvia","2024-09-22",0,0,0,0,0,0,0,0
"Latvia","2024-09-23",0,0,0,0,0,0,0,0
"Latvia","2024-09-24",0,0,0,0,0,0,0,0
"Latvia","2024-09-25",0,0,0,0,0,0,0,0
"Latvia","2024-09-26",0,0,0,0,0,0,0,0
"Latvia","2024-09-27",0,0,0,0,0,0,0,0
"Latvia","2024-09-28",0,0,0,0,0,0,0,0
"Latvia","2024-09-29",0,0,0,0,0,0,0,0
"Latvia","2024-09-30",0,0,0,0,0,0,0,0
"Latvia","2024-10-01",0,0,0,0,0,0,0,0
"Latvia","2024-10-02",0,0,0,0,0,0,0,0
"Latvia","2024-10-03",0,0,0,0,0,0,0,0
"Latvia","2024-10-04",0,0,0,0,0,0,0,0
"Latvia","2024-10-05",0,0,0,0,0,0,0,0
"Latvia","2024-10-06",0,0,0,0,0,0,0,0
"Latvia","2024-10-07",0,0,0,0,0,0,0,0
"Latvia","2024-10-08",0,0,0,0,0,0,0,0
"Latvia","2024-10-09",0,0,0,0,0,0,0,0
"Latvia","2024-10-10",0,0,0,0,0,0,0,0
"Latvia","2024-10-11",0,0,0,0,0,0,0,0
"Latvia","2024-10-12",0,0,0,0,0,0,0,0
"Latvia","2024-10-13",0,0,0,0,0,0,0,0
"Latvia","2024-10-14",0,0,0,0,0,0,0,0
"Latvia","2024-10-15",0,0,0,0,0,0,0,0
"Latvia","2024-10-16",0,0,0,0,0,0,0,0
"Latvia","2024-10-17",0,0,0,0,0,0,0,0
"Latvia","2024-10-18",0,0,0,0,0,0,0,0
"Latvia","2024-10-19",0,0,0,0,0,0,0,0
"Latvia","2024-10-20",0,0,0,0,0,0,0,0
"Latvia","2024-10-21",0,0,0,0,0,0,0,0
"Latvia","2024-10-22",0,0,0,0,0,0,0,0
"Latvia","2024-10-23",0,0,0,0,0,0,0,0
"Latvia","2024-10-24",0,0,0,0,0,0,0,0
"Latvia","2024-10-25",0,0,0,0,0,0,0,0
"Latvia","2024-10-26",0,0,0,0,0,0,0,0
"Latvia","2024-10-27",0,0,0,0,0,0,0,0
"Latvia","2024-10-28",0,0,0,0,0,0,0,0
"Latvia","2024-10-29",0,0,0,0,0,0,0,0
"Latvia","2024-10-30",0,0,0,0,0,0,0,0
"Latvia","2024-10-31",0,0,0,0,0,0,0,0
"Latvia","2024-11-01",0,0,0,0,0,0,0,0
"Latvia","2024-11-02",0,0,0,0,0,0,0,0
"Latvia","2024-11-03",0,0,0,0,0,0,0,0
"Latvia","2024-11-04",0,0,0,0,0,0,0,0
"Latvia","2024-11-05",0,0,0,0,0,0,0,0
"Latvia","2024-11-06",0,0,0,0,0,0,0,0
"Latvia","2024-11-07",0,0,0,0,0,0,0,0
"Latvia","2024-11-08",0,0,0,0,0,0,0,0
"Latvia","2024-11-09",0,0,0,0,0,0,0,0
"Latvia","2024-11-10",0,0,0,0,0,0,0,0
"Latvia","2024-11-11",0,0,0,0,0,0,0,0
"Latvia","2024-11-12",0,0,0,0,0,0,0,0
"Latvia","2024-11-13",0,0,0,0,0,0,0,0
"Latvia","2024-11-14",0,0,0,0,0,0,0,0
"Latvia","2024-11-15",0,0,0,0,0,0,0,0
"Latvia","2024-11-16",0,0,0,0,0,0,0,0
"Latvia","2024-11-17",0,0,0,0,0,0,0,0
"Latvia","2024-11-18",0,0,0,0,0,0,0,0
"Latvia","2024-11-19",0,0,0,0,0,0,0,0
"Latvia","2024-11-20",0,0,0,0,0,0,0,0
"Latvia","2024-11-21",0,0,0,0,0,0,0,0
"Latvia","2024-11-22",0,0,0,0,0,0,0,0
"Latvia","2024-11-23",0,0,0,0,0,0,0,0
"Latvia","2024-11-24",0,0,0,0,0,0,0,0
"Latvia","2024-11-25",0,0,0,0,0,0,0,0
"Latvia","2024-11-26",0,0,0,0,0,0,0,0
"Latvia","2024-11-27",0,0,0,0,0,0,0,0
"Latvia","2024-11-28",0,0,0,0,0,0,0,0
"Latvia","2024-11-29",0,0,0,0,0,0,0,0
"Latvia","2024-11-30",0,0,0,0,0,0,0,0
"Latvia","2024-12-01",0,0,0,0,0,0,0,0
"Latvia","2024-12-02",0,0,0,0,0,0,0,0
"Latvia","2024-12-03",0,0,0,0,0,0,0,0
"Latvia","2024-12-04",0,0,0,0,0,0,0,0
"Latvia","2024-12-05",0,0,0,0,0,0,0,0
"Latvia","2024-12-06",0,0,0,0,0,0,0,0
"Latvia","2024-12-07",0,0,0,0,0,0,0,0
"Latvia","2024-12-08",0,0,0,0,0,0,0,0
"Latvia","2024-12-09",0,0,0,0,0,0,0,0
"Latvia","2024-12-10",0,0,0,0,0,0,0,0
"Latvia","2024-12-11",0,0,0,0,0,0,0,0
"Latvia","2024-12-12",0,0,0,0,0,0,0,0
"Latvia","2024-12-13",0,0,0,0,0,0,0,0
"Latvia","2024-12-14",0,0,0,0,0,0,0,0
"Latvia","2024-12-15",0,0,0,0,0,0,0,0
"Latvia","2024-12-16",0,0,0,0,0,0,0,0
"Latvia","2024-12-17",0,0,0,0,0,0,0,0
"Latvia","2024-12-18",0,0,0,0,0,0,0,0
"Latvia","2024-12-19",0,0,0,0,0,0,0,0
"Latvia","2024-12-20",0,0,0,0,0,0,0,0
"Latvia","2024-12-21",0,0,0,0,0,0,0,0
"Latvia","2024-12-22",0,0,0,0,0,0,0,0
"Latvia","2024-12-23",0,0,0,0,0,0,0,0
"Latvia","2024-12-24",0,0,0,0,0,0,0,0
"Latvia","2024-12-25",0,0,0,0,0,0,0,0
"Latvia","2024-12-26",0,0,0,0,0,0,0,0
"Latvia","2024-12-27",0,0,0,0,0,0,0,0
"Latvia","2024-12-28",0,0,0,0,0,0,0,0
"Latvia","2024-12-29",0,0,0,0,0,0,0,0
"Latvia","2024-12-30",0,0,0,0,0,0,0,0
"Latvia","2024-12-31",0,0,0,0,0,0,0,0
"Latvia","2025-01-01",0,0,0,0,0,0,0,0
"Latvia","2025-01-02",0,0,0,0,0,0,0,0
"Latvia","2025-01-03",0,0,0,0,0,0,0,0
"Latvia","2025-01-04",0,0,0,0,0,0,0,0
"Latvia","2025-01-05",0,0,0,0,0,0,0,0
"Latvia","2025-01-06",0,0,0,0,0,0,0,0
"Latvia","2025-01-07",0,0,0,0,0,0,0,0
"Latvia","2025-01-08",0,0,0,0,0,0,0,0
"Latvia","2025-01-09",0,0,0,0,0,0,0,0
"Latvia","2025-01-10",0,0,0,0,0,0,0,0
"Latvia","2025-01-11",0,0,0,0,0,0,0,0
"Latvia","2025-01-12",0,0,0,0,0,0,0,0
"Latvia","2025-01-13",0,0,0,0,0,0,0,0
"Latvia","2025-01-14",0,0,0,0,0,0,0,0
"Latvia","2025-01-15",0,0,0,0,0,0,0,0
"Latvia","2025-01-16",0,0,0,0,0,0,0,0
"Latvia","2025-01-17",0,0,0,0,0,0,0,0
"Latvia","2025-01-18",0,0,0,0,0,0,0,0
"Latvia","2025-01-19",0,0,0,0,0,0,0,0
"Latvia","2025-01-20",0,0,0,0,0,0,0,0
"Latvia","2025-01-21",0,0,0,0,0,0,0,0
"Latvia","2025-01-22",0,0,0,0,0,0,0,0
"Latvia","2025-01-23",0,0,0,0,0,0,0,0
"Latvia","2025-01-24",0,0,0,0,0,0,0,0
"Latvia","2025-01-25",0,0,0,0,0,0,0,0
"Latvia","2025-01-26",0,0,0,0,0,0,0,0
"Latvia","2025-01-27",0,0,0,0,0,0,0,0
"Latvia","2025-01-28",0,0,0,0,0,0,0,0
"Latvia","2025-01-29",0,0,0,0,0,0,0,0
"Latvia","2025-01-30",0,0,0,0,0,0,0,0
"Latvia","2025-01-31",0,0,0,0,0,0,0,0
"Latvia","2025-02-01",0,0,0,0,0,0,0,0
"Latvia","2025-02-02",0,0,0,0,0,0,0,0
"Latvia","2025-02-03",0,0,0,0,0,0,0,0
"Latvia","2025-02-04",0,0,0,0,0,0,0,0
"Latvia","2025-02-05",0,0,0,0,0,0,0,0
"Latvia","2025-02-06",0,0,0,0,0,0,0,0
"Latvia","2025-02-07",0,0,0,0,0,0,0,0
"Latvia","2025-02-08",0,0,0,0,0,0,0,0
"Latvia","2025-02-09",0,0,0,0,0,0,0,0
"Latvia","2025-02-10",0,0,0,0,0,0,0,0
"Latvia","2025-02-11",0,0,0,0,0,0,0,0
"Latvia","2025-02-12",0,0,0,0,0,0,0,0
"Latvia","2025-02-13",0,0,0,0,0,0,0,0
"Latvia","2025-02-14",0,0,0,0,0,0,0,0
"Latvia","2025-02-15",0,0,0,0,0,0,0,0
"Latvia","2025-02-16",0,0,0,0,0,0,0,0
"Latvia","2025-02-17",0,0,0,0,0,0,0,0
"Latvia","2025-02-18",0,0,0,0,0,0,0,0
"Latvia","2025-02-19",0,0,0,0,0,0,0,0
"Latvia","2025-02-20",0,0,0,0,0,0,0,0
"Latvia","2025-02-21",0,0,0,0,0,0,0,0
"Latvia","2025-02-22",0,0,0,0,0,0,0,0
"Latvia","2025-02-23",0,0,0,0,0,0,0,0
"Latvia","2025-02-24",0,0,0,0,0,0,0,0
"Latvia","2025-02-25",0,0,0,0,0,0,0,0
"Latvia","2025-02-26",0,0,0,0,0,0,0,0
"Latvia","2025-02-27",0,0,0,0,0,0,0,0
"Latvia","2025-02-28",0,0,0,0,0,0,0,0
"Latvia","2025-03-01",0,0,0,0,0,0,0,0
"Latvia","2025-03-02",0,0,0,0,0,0,0,0
"Latvia","2025-03-03",0,0,0,0,0,0,0,0
"Lebanon","2024-01-01",0,0,0,0,0,0,0,0
"Lebanon","2024-01-02",0,0,0,0,0,0,0,0
"Lebanon","2024-01-03",0,0,0,0,0,0,0,0
"Lebanon","2024-01-04",0,0,0,0,0,0,0,0
"Lebanon","2024-01-05",0,0,0,0,0,0,0,0
"Lebanon","2024-01-06",0,0,0,0,0,0,0,0
"Lebanon","2024-01-07",0,0,0,0,0,0,0,0
"Lebanon","2024-01-08",0,0,0,0,0,0,0,0
"Lebanon","2024-01-09",0,0,0,0,0,0,0,0
"Lebanon","2024-01-10",0,0,0,0,0,0,0,0
"Lebanon","2024-01-11",0,0,0,0,0,0,0,0
"Lebanon","2024-01-12",0,0,0,0,0,0,0,0
"Lebanon","2024-01-13",0,0,0,0,0,0,0,0
"Lebanon","2024-01-14",0,0,0,0,0,0,0,0
"Lebanon","2024-01-15",0,0,0,0,0,0,0,0
"Lebanon","2024-01-16",0,0,0,0,0,0,0,0
"Lebanon","2024-01-17",0,0,0,0,0,0,0,0
"Lebanon","2024-01-18",0,0,0,0,0,0,0,0
"Lebanon","2024-01-19",0,0,0,0,0,0,0,0
"Lebanon","2024-01-20",0,0,0,0,0,0,0,0
"Lebanon","2024-01-21",0,0,0,0,0,0,0,0
"Lebanon","2024-01-22",0,0,0,0,0,0,0,0
"Lebanon","2024-01-23",0,0,0,0,0,0,0,0
"Lebanon","2024-01-24",0,0,0,0,0,0,0,0
"Lebanon","2024-01-25",0,0,0,0,0,0,0,0
"Lebanon","2024-01-26",0,0,0,0,0,0,0,0
"Lebanon","2024-01-27",0,0,0,0,0,0,0,0
"Lebanon","2024-01-28",0,0,0,0,0,0,0,0
"Lebanon","2024-01-29",0,0,0,0,0,0,0,0
"Lebanon","2024-01-30",0,0,0,0,0,0,0,0
"Lebanon","2024-01-31",0,0,0,0,0,0,0,0
"Lebanon","2024-02-01",0,0,0,0,0,0,0,0
"Lebanon","2024-02-02",0,0,0,0,0,0,0,0
"Lebanon","2024-02-03",0,0,0,0,0,0,0,0
"Lebanon","2024-02-04",0,0,0,0,0,0,0,0
"Lebanon","2024-02-05",0,0,0,0,0,0,0,0
"Lebanon","2024-02-06",0,0,0,0,0,0,0,0
"Lebanon","2024-02-07",0,0,0,0,0,0,0,0
"Lebanon","2024-02-08",0,0,0,0,0,0,0,0
"Lebanon","2024-02-09",0,0,0,0,0,0,0,0
"Lebanon","2024-02-10",0,0,0,0,0,0,0,0
"Lebanon","2024-02-11",0,0,0,0,0,0,0,0
"Lebanon","2024-02-12",0,0,0,0,0,0,0,0
"Lebanon","2024-02-13",0,0,0,0,0,0,0,0
"Lebanon","2024-02-14",0,0,0,0,0,0,0,0
"Lebanon","2024-02-15",0,0,0,0,0,0,0,0
"Lebanon","2024-02-16",0,0,0,0,0,0,0,0
"Lebanon","2024-02-17",0,0,0,0,0,0,0,0
"Lebanon","2024-02-18",0,0,0,0,0,0,0,0
"Lebanon","2024-02-19",0,0,0,0,0,0,0,0
"Lebanon","2024-02-20",0,0,0,0,0,0,0,0
"Lebanon","2024-02-21",0,0,0,0,0,0,0,0
"Lebanon","2024-02-22",0,0,0,0,0,0,0,0
"Lebanon","2024-02-23",0,0,0,0,0,0,0,0
"Lebanon","2024-02-24",0,0,0,0,0,0,0,0
"Lebanon","2024-02-25",0,0,0,0,0,0,0,0
"Lebanon","2024-02-26",0,0,0,0,0,0,0,0
"Lebanon","2024-02-27",0,0,0,0,0,0,0,0
"Lebanon","2024-02-28",0,0,0,0,0,0,0,0
"Lebanon","2024-02-29",0,0,0,0,0,0,0,0
"Lebanon","2024-03-01",0,0,0,0,0,0,0,0
"Lebanon","2024-03-02",0,0,0,0,0,0,0,0
"Lebanon","2024-03-03",0,0,0,0,0,0,0,0
"Lebanon","2024-03-04",0,0,0,0,0,0,0,0
"Lebanon","2024-03-05",0,0,0,0,0,0,0,0
"Lebanon","2024-03-06",0,0,0,0,0,0,0,0
"Lebanon","2024-03-07",0,0,0,0,0,0,0,0
"Lebanon","2024-03-08",0,0,0,0,0,0,0,0
"Lebanon","2024-03-09",0,0,0,0,0,0,0,0
"Lebanon","2024-03-10",0,0,0,0,0,0,0,0
"Lebanon","2024-03-11",0,0,0,0,0,0,0,0
"Lebanon","2024-03-12",0,0,0,0,0,0,0,0
"Lebanon","2024-03-13",0,0,0,0,0,0,0,0
"Lebanon","2024-03-14",0,1,1,0,1,1,0,0
"Lebanon","2024-03-15",0,0,1,0,0,1,0,0
"Lebanon","2024-03-16",0,0,1,0,0,1,0,0
"Lebanon","2024-03-17",0,0,1,0,0,1,0,0
"Lebanon","2024-03-18",0,0,1,0,0,1,0,0
"Lebanon","2024-03-19",0,0,1,0,0,1,0,0
"Lebanon","2024-03-20",0,0,1,0,0,1,0,0
"Lebanon","2024-03-21",0,0,1,0,0,1,0,0
"Lebanon","2024-03-22",0,0,1,0,0,1,0,0
"Lebanon","2024-03-23",0,0,1,0,0,1,0,0
"Lebanon","2024-03-24",0,0,1,0,0,1,0,0
"Lebanon","2024-03-25",0,0,1,0,0,1,0,0
"Lebanon","2024-03-26",0,0,1,0,0,1,0,0
"Lebanon","2024-03-27",0,0,1,0,0,1,0,0
"Lebanon","2024-03-28",0,0,1,0,0,1,0,0
"Lebanon","2024-03-29",0,0,1,0,0,1,0,0
"Lebanon","2024-03-30",0,0,1,0,0,1,0,0
"Lebanon","2024-03-31",0,0,1,0,0,1,0,0
"Lebanon","2024-04-01",0,0,1,0,0,1,0,0
"Lebanon","2024-04-02",0,0,1,0,0,1,0,0
"Lebanon","2024-04-03",0,0,1,0,0,1,0,0
"Lebanon","2024-04-04",0,0,1,0,0,1,0,0
"Lebanon","2024-04-05",0,0,1,0,0,1,0,0
"Lebanon","2024-04-06",0,0,1,0,0,1,0,0
"Lebanon","2024-04-07",0,0,1,0,0,1,0,0
"Lebanon","2024-04-08",0,0,1,0,0,1,0,0
"Lebanon","2024-04-09",0,0,1,0,0,1,0,0
"Lebanon","2024-04-10",0,0,1,0,0,1,0,0
"Lebanon","2024-04-11",0,0,1,0,0,1,0,0
"Lebanon","2024-04-12",0,0,1,0,0,1,0,0
"Lebanon","2024-04-13",0,0,1,0,0,1,0,0
"Lebanon","2024-04-14",0,0,1,0,0,1,0,0
"Lebanon","2024-04-15",0,0,1,0,0,1,0,0
"Lebanon","2024-04-16",0,0,1,0,0,1,0,0
"Lebanon","2024-04-17",0,0,1,0,0,1,0,0
"Lebanon","2024-04-18",0,0,1,0,0,1,0,0
"Lebanon","2024-04-19",0,0,1,0,0,1,0,0
"Lebanon","2024-04-20",0,0,1,0,0,1,0,0
"Lebanon","2024-04-21",0,0,1,0,0,1,0,0
"Lebanon","2024-04-22",0,0,1,0,0,1,0,0
"Lebanon","2024-04-23",0,0,1,0,0,1,0,0
"Lebanon","2024-04-24",0,0,1,0,0,1,0,0
"Lebanon","2024-04-25",0,0,1,0,0,1,0,0
"Lebanon","2024-04-26",0,0,1,0,0,1,0,0
"Lebanon","2024-04-27",0,0,1,0,0,1,0,0
"Lebanon","2024-04-28",0,0,1,0,0,1,0,0
"Lebanon","2024-04-29",0,0,1,0,0,1,0,0
"Lebanon","2024-04-30",0,0,1,0,0,1,0,0
"Lebanon","2024-05-01",0,0,1,0,0,1,0,0
"Lebanon","2024-05-02",0,0,1,0,0,1,0,0
"Lebanon","2024-05-03",0,0,1,0,0,1,0,0
"Lebanon","2024-05-04",0,0,1,0,0,1,0,0
"Lebanon","2024-05-05",0,0,1,0,0,1,0,0
"Lebanon","2024-05-06",0,0,1,0,0,1,0,0
"Lebanon","2024-05-07",0,0,1,0,0,1,0,0
"Lebanon","2024-05-08",0,0,1,0,0,1,0,0
"Lebanon","2024-05-09",0,0,1,0,0,1,0,0
"Lebanon","2024-05-10",0,0,1,0,0,1,0,0
"Lebanon","2024-05-11",0,0,1,0,0,1,0,0
"Lebanon","2024-05-12",0,0,1,0,0,1,0,0
"Lebanon","2024-05-13",0,0,1,0,0,1,0,0
"Lebanon","2024-05-14",0,0,1,0,0,1,0,0
"Lebanon","2024-05-15",0,0,1,0,0,1,0,0
"Lebanon","2024-05-16",0,0,1,0,0,1,0,0
"Lebanon","2024-05-17",0,0,1,0,0,1,0,0
"Lebanon","2024-05-18",0,0,1,0,0,1,0,0
"Lebanon","2024-05-19",0,0,1,0,0,1,0,0
"Lebanon","2024-05-20",0,0,1,0,0,1,0,0
"Lebanon","2024-05-21",0,0,1,0,0,1,0,0
"Lebanon","2024-05-22",0,0,1,0,0,1,0,0
"Lebanon","2024-05-23",0,0,1,0,0,1,0,0
"Lebanon","2024-05-24",0,0,1,0,0,1,0,0
"Lebanon","2024-05-25",0,0,1,0,0,1,0,0
"Lebanon","2024-05-26",0,0,1,0,0,1,0,0
"Lebanon","2024-05-27",0,0,1,0,0,1,0,0
"Lebanon","2024-05-28",0,0,1,0,0,1,0,0
"Lebanon","2024-05-29",0,0,1,0,0,1,0,0
"Lebanon","2024-05-30",0,0,1,0,0,1,0,0
"Lebanon","2024-05-31",0,0,1,0,0,1,0,0
"Lebanon","2024-06-01",0,0,1,0,0,1,0,0
"Lebanon","2024-06-02",0,0,1,0,0,1,0,0
"Lebanon","2024-06-03",0,0,1,0,0,1,0,0
"Lebanon","2024-06-04",0,0,1,0,0,1,0,0
"Lebanon","2024-06-05",0,0,1,0,0,1,0,0
"Lebanon","2024-06-06",0,0,1,0,0,1,0,0
"Lebanon","2024-06-07",0,0,1,0,0,1,0,0
"Lebanon","2024-06-08",0,0,1,0,0,1,0,0
"Lebanon","2024-06-09",0,0,1,0,0,1,0,0
"Lebanon","2024-06-10",0,0,1,0,0,1,0,0
"Lebanon","2024-06-11",0,0,1,0,0,1,0,0
"Lebanon","2024-06-12",0,0,1,0,0,1,0,0
"Lebanon","2024-06-13",0,0,1,0,0,1,0,0
"Lebanon","2024-06-14",0,0,1,0,0,1,0,0
"Lebanon","2024-06-15",0,0,1,0,0,1,0,0
"Lebanon","2024-06-16",0,0,1,0,0,1,0,0
"Lebanon","2024-06-17",0,0,1,0,0,1,0,0
"Lebanon","2024-06-18",0,0,1,0,0,1,0,0
"Lebanon","2024-06-19",0,0,1,0,0,1,0,0
"Lebanon","2024-06-20",0,0,1,0,0,1,0,0
"Lebanon","2024-06-21",0,0,1,0,0,1,0,0
"Lebanon","2024-06-22",0,0,1,0,0,1,0,0
"Lebanon","2024-06-23",0,0,1,0,0,1,0,0
"Lebanon","2024-06-24",0,0,1,0,0,1,0,0
"Lebanon","2024-06-25",0,0,1,0,0,1,0,0
"Lebanon","2024-06-26",0,0,1,0,0,1,0,0
"Lebanon","2024-06-27",0,0,1,0,0,1,0,0
"Lebanon","2024-06-28",0,0,1,0,0,1,0,0
"Lebanon","2024-06-29",0,0,1,0,0,1,0,0
"Lebanon","2024-06-30",0,0,1,0,0,1,0,0
"Lebanon","2024-07-01",0,0,1,0,0,1,0,0
"Lebanon","2024-07-02",0,0,1,0,0,1,0,0
"Lebanon","2024-07-03",0,0,1,0,0,1,0,0
"Lebanon","2024-07-04",0,0,1,0,0,1,0,0
"Lebanon","2024-07-05",0,0,1,0,0,1,0,0
"Lebanon","2024-07-06",0,0,1,0,0,1,0,0
"Lebanon","2024-07-07",0,0,1,0,0,1,0,0
"Lebanon","2024-07-08",0,0,1,0,0,1,0,0
"Lebanon","2024-07-09",0,0,1,0,0,1,0,0
"Lebanon","2024-07-10",0,0,1,0,0,1,0,0
"Lebanon","2024-07-11",0,0,1,0,0,1,0,0
"Lebanon","2024-07-12",0,0,1,0,0,1,0,0
"Lebanon","2024-07-13",0,0,1,0,0,1,0,0
"Lebanon","2024-07-14",0,0,1,0,0,1,0,0
"Lebanon","2024-07-15",0,0,1,0,0,1,0,0
"Lebanon","2024-07-16",0,0,1,0,0,1,0,0
"Lebanon","2024-07-17",0,0,1,0,0,1,0,0
"Lebanon","2024-07-18",0,0,1,0,0,1,0,0
"Lebanon","2024-07-19",0,0,1,0,0,1,0,0
"Lebanon","2024-07-20",0,0,1,0,0,1,0,0
"Lebanon","2024-07-21",0,0,1,0,0,1,0,0
"Lebanon","2024-07-22",0,0,1,0,0,1,0,0
"Lebanon","2024-07-23",0,0,1,0,0,1,0,0
"Lebanon","2024-07-24",0,0,1,0,0,1,0,0
"Lebanon","2024-07-25",0,0,1,0,0,1,0,0
"Lebanon","2024-07-26",0,0,1,0,0,1,0,0
"Lebanon","2024-07-27",0,0,1,0,0,1,0,0
"Lebanon","2024-07-28",0,0,1,0,0,1,0,0
"Lebanon","2024-07-29",0,0,1,0,0,1,0,0
"Lebanon","2024-07-30",0,0,1,0,0,1,0,0
"Lebanon","2024-07-31",0,0,1,0,0,1,0,0
"Lebanon","2024-08-01",0,0,1,0,0,1,0,0
"Lebanon","2024-08-02",0,0,1,0,0,1,0,0
"Lebanon","2024-08-03",0,0,1,0,0,1,0,0
"Lebanon","2024-08-04",0,0,1,0,0,1,0,0
"Lebanon","2024-08-05",0,0,1,0,0,1,0,0
"Lebanon","2024-08-06",0,0,1,0,0,1,0,0
"Lebanon","2024-08-07",0,0,1,0,0,1,0,0
"Lebanon","2024-08-08",0,0,1,0,0,1,0,0
"Lebanon","2024-08-09",0,0,1,0,1,2,0,0
"Lebanon","2024-08-10",0,0,1,0,0,2,0,0
"Lebanon","2024-08-11",0,0,1,0,0,2,0,0
"Lebanon","2024-08-12",0,0,1,0,0,2,0,0
"Lebanon","2024-08-13",0,0,1,0,0,2,0,0
"Lebanon","2024-08-14",0,0,1,0,0,2,0,0
"Lebanon","2024-08-15",0,0,1,0,0,2,0,0
"Lebanon","2024-08-16",0,0,1,0,0,2,0,0
"Lebanon","2024-08-17",0,0,1,0,0,2,0,0
"Lebanon","2024-08-18",0,0,1,0,0,2,0,0
"Lebanon","2024-08-19",0,0,1,0,0,2,0,0
"Lebanon","2024-08-20",0,0,1,0,0,2,0,0
"Lebanon","2024-08-21",0,0,1,0,0,2,0,0
"Lebanon","2024-08-22",0,0,1,0,0,2,0,0
"Lebanon","2024-08-23",0,0,1,0,0,2,0,0
"Lebanon","2024-08-24",0,0,1,0,0,2,0,0
"Lebanon","2024-08-25",0,0,1,0,0,2,0,0
"Lebanon","2024-08-26",0,0,1,0,0,2,0,0
"Lebanon","2024-08-27",0,0,1,0,0,2,0,0
"Lebanon","2024-08-28",0,0,1,0,0,2,0,0
"Lebanon","2024-08-29",0,0,1,0,0,2,0,0
"Lebanon","2024-08-30",0,0,1,0,0,2,0,0
"Lebanon","2024-08-31",0,0,1,0,0,2,0,0
"Lebanon","2024-09-01",0,0,1,0,0,2,0,0
"Lebanon","2024-09-02",0,0,1,0,0,2,0,0
"Lebanon","2024-09-03",0,0,1,0,0,2,0,0
"Lebanon","2024-09-04",0,0,1,0,0,2,0,0
"Lebanon","2024-09-05",0,0,1,0,0,2,0,0
"Lebanon","2024-09-06",0,0,1,0,0,2,0,0
"Lebanon","2024-09-07",0,0,1,0,0,2,0,0
"Lebanon","2024-09-08",0,0,1,0,0,2,0,0
"Lebanon","2024-09-09",0,0,1,0,0,2,0,0
"Lebanon","2024-09-10",0,0,1,0,0,2,0,0
"Lebanon","2024-09-11",0,0,1,0,0,2,0,0
"Lebanon","2024-09-12",0,0,1,0,0,2,0,0
"Lebanon","2024-09-13",0,0,1,0,0,2,0,0
"Lebanon","2024-09-14",0,0,1,0,0,2,0,0
"Lebanon","2024-09-15",0,0,1,0,0,2,0,0
"Lebanon","2024-09-16",0,0,1,0,0,2,0,0
"Lebanon","2024-09-17",0,0,1,0,0,2,0,0
"Lebanon","2024-09-18",0,0,1,0,0,2,0,0
"Lebanon","2024-09-19",0,0,1,0,0,2,0,0
"Lebanon","2024-09-20",0,0,1,0,0,2,0,0
"Lebanon","2024-09-21",0,0,1,0,0,2,0,0
"Lebanon","2024-09-22",0,0,1,0,0,2,0,0
"Lebanon","2024-09-23",0,0,1,0,0,2,0,0
"Lebanon","2024-09-24",0,0,1,0,0,2,0,0
"Lebanon","2024-09-25",0,0,1,0,0,2,0,0
"Lebanon","2024-09-26",0,0,1,0,0,2,0,0
"Lebanon","2024-09-27",0,0,1,0,0,2,0,0
"Lebanon","2024-09-28",0,0,1,0,0,2,0,0
"Lebanon","2024-09-29",0,0,1,0,0,2,0,0
"Lebanon","2024-09-30",0,0,1,0,0,2,0,0
"Lebanon","2024-10-01",0,0,1,0,0,2,0,0
"Lebanon","2024-10-02",0,0,1,0,0,2,0,0
"Lebanon","2024-10-03",0,0,1,0,0,2,0,0
"Lebanon","2024-10-04",0,0,1,0,0,2,0,0
"Lebanon","2024-10-05",0,0,1,0,0,2,0,0
"Lebanon","2024-10-06",0,0,1,0,0,2,0,0
"Lebanon","2024-10-07",0,0,1,0,0,2,0,0
"Lebanon","2024-10-08",0,0,1,0,0,2,0,0
"Lebanon","2024-10-09",0,0,1,0,0,2,0,0
"Lebanon","2024-10-10",0,0,1,0,0,2,0,0
"Lebanon","2024-10-11",0,0,1,0,0,2,0,0
"Lebanon","2024-10-12",0,0,1,0,0,2,0,0
"Lebanon","2024-10-13",0,0,1,0,0,2,0,0
"Lebanon","2024-10-14",0,0,1,0,0,2,0,0
"Lebanon","2024-10-15",0,0,1,0,0,2,0,0
"Lebanon","2024-10-16",0,0,1,0,0,2,0,0
"Lebanon","2024-10-17",0,0,1,0,0,2,0,0
"Lebanon","2024-10-18",0,0,1,0,0,2,0,0
"Lebanon","2024-10-19",0,0,1,0,0,2,0,0
"Lebanon","2024-10-20",0,0,1,0,0,2,0,0
"Lebanon","2024-10-21",0,0,1,0,0,2,0,0
"Lebanon","2024-10-22",0,0,1,0,0,2,0,0
"Lebanon","2024-10-23",0,0,1,0,0,2,0,0
"Lebanon","2024-10-24",0,0,1,0,0,2,0,0
"Lebanon","2024-10-25",0,0,1,0,0,2,0,0
"Lebanon","2024-10-26",0,0,1,0,0,2,0,0
"Lebanon","2024-10-27",0,0,1,0,0,2,0,0
"Lebanon","2024-10-28",0,0,1,0,0,2,0,0
"Lebanon","2024-10-29",0,0,1,0,0,2,0,0
"Lebanon","2024-10-30",0,0,1,0,0,2,0,0
"Lebanon","2024-10-31",0,0,1,0,0,2,0,0
"Lebanon","2024-11-01",0,0,1,0,0,2,0,0
"Lebanon","2024-11-02",0,0,1,0,0,2,0,0
"Lebanon","2024-11-03",0,0,1,0,0,2,0,0
"Lebanon","2024-11-04",0,0,1,0,0,2,0,0
"Lebanon","2024-11-05",0,0,1,0,0,2,0,0
"Lebanon","2024-11-06",0,0,1,0,0,2,0,0
"Lebanon","2024-11-07",0,0,1,0,0,2,0,0
"Lebanon","2024-11-08",0,0,1,0,0,2,0,0
"Lebanon","2024-11-09",0,0,1,0,0,2,0,0
"Lebanon","2024-11-10",0,0,1,0,0,2,0,0
"Lebanon","2024-11-11",0,0,1,0,0,2,0,0
"Lebanon","2024-11-12",0,0,1,0,0,2,0,0
"Lebanon","2024-11-13",0,0,1,0,0,2,0,0
"Lebanon","2024-11-14",0,0,1,0,0,2,0,0
"Lebanon","2024-11-15",0,0,1,0,0,2,0,0
"Lebanon","2024-11-16",0,0,1,0,0,2,0,0
"Lebanon","2024-11-17",0,0,1,0,0,2,0,0
"Lebanon","2024-11-18",0,0,1,0,0,2,0,0
"Lebanon","2024-11-19",0,0,1,0,0,2,0,0
"Lebanon","2024-11-20",0,0,1,0,0,2,0,0
"Lebanon","2024-11-21",0,0,1,0,0,2,0,0
"Lebanon","2024-11-22",0,0,1,0,0,2,0,0
"Lebanon","2024-11-23",0,0,1,0,0,2,0,0
"Lebanon","2024-11-24",0,0,1,0,0,2,0,0
"Lebanon","2024-11-25",0,0,1,0,0,2,0,0
"Lebanon","2024-11-26",0,0,1,0,0,2,0,0
"Lebanon","2024-11-27",0,0,1,0,0,2,0,0
"Lebanon","2024-11-28",0,0,1,0,0,2,0,0
"Lebanon","2024-11-29",0,0,1,0,0,2,0,0
"Lebanon","2024-11-30",0,0,1,0,0,2,0,0
"Lebanon","2024-12-01",0,0,1,0,0,2,0,0
"Lebanon","2024-12-02",0,0,1,0,0,2,0,0
"Lebanon","2024-12-03",0,0,1,0,0,2,0,0
"Lebanon","2024-12-04",0,0,1,0,0,2,0,0
"Lebanon","2024-12-05",0,0,1,0,0,2,0,0
"Lebanon","2024-12-06",0,0,1,0,0,2,0,0
"Lebanon","2024-12-07",0,0,1,0,0,2,0,0
"Lebanon","2024-12-08",0,0,1,0,0,2,0,0
"Lebanon","2024-12-09",0,0,1,0,0,2,0,0
"Lebanon","2024-12-10",0,0,1,0,0,2,0,0
"Lebanon","2024-12-11",0,0,1,0,0,2,0,0
"Lebanon","2024-12-12",0,0,1,0,0,2,0,0
"Lebanon","2024-12-13",0,0,1,0,0,2,0,0
"Lebanon","2024-12-14",0,0,1,0,0,2,0,0
"Lebanon","2024-12-15",0,0,1,0,0,2,0,0
"Lebanon","2024-12-16",0,0,1,0,0,2,0,0
"Lebanon","2024-12-17",0,0,1,0,0,2,0,0
"Lebanon","2024-12-18",0,0,1,0,0,2,0,0
"Lebanon","2024-12-19",0,0,1,0,0,2,0,0
"Lebanon","2024-12-20",0,0,1,0,0,2,0,0
"Lebanon","2024-12-21",0,0,1,0,0,2,0,0
"Lebanon","2024-12-22",0,0,1,0,0,2,0,0
"Lebanon","2024-12-23",0,0,1,0,0,2,0,0
"Lebanon","2024-12-24",0,0,1,0,0,2,0,0
"Lebanon","2024-12-25",0,0,1,0,0,2,0,0
"Lebanon","2024-12-26",0,0,1,0,0,2,0,0
"Lebanon","2024-12-27",0,0,1,0,0,2,0,0
"Lebanon","2024-12-28",0,0,1,0,0,2,0,0
"Lebanon","2024-12-29",0,0,1,0,0,2,0,0
"Lebanon","2024-12-30",0,0,1,0,0,2,0,0
"Lebanon","2024-12-31",0,0,1,0,0,2,0,0
"Lebanon","2025-01-01",0,0,1,0,0,2,0,0
"Lebanon","2025-01-02",0,0,1,0,0,2,0,0
"Lebanon","2025-01-03",0,1,2,0,0,2,0,0
"Lebanon","2025-01-04",0,0,2,0,0,2,0,0
"Lebanon","2025-01-05",0,0,2,0,0,2,0,0
"Lebanon","2025-01-06",0,0,2,0,0,2,0,0
"Lebanon","2025-01-07",0,0,2,0,0,2,0,0
"Lebanon","2025-01-08",0,0,2,0,0,2,0,0
"Lebanon","2025-01-09",0,0,2,0,0,2,0,0
"Lebanon","2025-01-10",0,0,2,0,0,2,0,0
"Lebanon","2025-01-11",0,0,2,0,0,2,0,0
"Lebanon","2025-01-12",0,0,2,0,0,2,0,0
"Lebanon","2025-01-13",0,0,2,0,0,2,0,0
"Lebanon","2025-01-14",0,0,2,0,0,2,0,0
"Lebanon","2025-01-15",0,0,2,0,0,2,0,0
"Lebanon","2025-01-16",0,0,2,0,0,2,0,0
"Lebanon","2025-01-17",0,0,2,0,0,2,0,0
"Lebanon","2025-01-18",0,0,2,0,0,2,0,0
"Lebanon","2025-01-19",0,0,2,0,0,2,0,0
"Lebanon","2025-01-20",0,0,2,0,0,2,0,0
"Lebanon","2025-01-21",0,0,2,0,0,2,0,0
"Lebanon","2025-01-22",0,0,2,0,0,2,0,0
"Lebanon","2025-01-23",0,0,2,0,0,2,0,0
"Lebanon","2025-01-24",0,0,2,0,0,2,0,0
"Lebanon","2025-01-25",0,0,2,0,0,2,0,0
"Lebanon","2025-01-26",0,0,2,0,0,2,0,0
"Lebanon","2025-01-27",0,0,2,0,0,2,0,0
"Lebanon","2025-01-28",0,0,2,0,0,2,0,0
"Lebanon","2025-01-29",0,0,2,0,0,2,0,0
"Lebanon","2025-01-30",0,0,2,0,0,2,0,0
"Lebanon","2025-01-31",0,0,2,0,0,2,0,0
"Lebanon","2025-02-01",0,0,2,0,0,2,0,0
"Lebanon","2025-02-02",0,0,2,0,0,2,0,0
"Lebanon","2025-02-03",0,0,2,0,0,2,0,0
"Lebanon","2025-02-04",0,0,2,0,0,2,0,0
"Lebanon","2025-02-05",0,0,2,0,0,2,0,0
"Lebanon","2025-02-06",0,0,2,0,0,2,0,0
"Lebanon","2025-02-07",0,0,2,0,0,2,0,0
"Lebanon","2025-02-08",0,0,2,0,0,2,0,0
"Lebanon","2025-02-09",0,0,2,0,0,2,0,0
"Lebanon","2025-02-10",0,0,2,0,0,2,0,0
"Lebanon","2025-02-11",0,0,2,0,0,2,0,0
"Lebanon","2025-02-12",0,0,2,0,0,2,0,0
"Lebanon","2025-02-13",0,0,2,0,0,2,0,0
"Lebanon","2025-02-14",0,0,2,0,0,2,0,0
"Lebanon","2025-02-15",0,0,2,0,0,2,0,0
"Lebanon","2025-02-16",0,0,2,0,0,2,0,0
"Lebanon","2025-02-17",0,0,2,0,0,2,0,0
"Lebanon","2025-02-18",0,0,2,0,0,2,0,0
"Lebanon","2025-02-19",0,0,2,0,0,2,0,0
"Lebanon","2025-02-20",0,0,2,0,0,2,0,0
"Lebanon","2025-02-21",0,0,2,0,0,2,0,0
"Lebanon","2025-02-22",0,0,2,0,0,2,0,0
"Lebanon","2025-02-23",0,0,2,0,0,2,0,0
"Lebanon","2025-02-24",0,0,2,0,0,2,0,0
"Lebanon","2025-02-25",0,0,2,0,0,2,0,0
"Lebanon","2025-02-26",0,0,2,0,0,2,0,0
"Lebanon","2025-02-27",0,0,2,0,0,2,0,0
"Lebanon","2025-02-28",0,0,2,0,0,2,0,0
"Lebanon","2025-03-01",0,0,2,0,0,2,0,0
"Lebanon","2025-03-02",0,0,2,0,0,2,0,0
"Lebanon","2025-03-03",0,0,2,0,0,2,0,0
"Liberia","2024-01-01",0,0,0,0,0,0,0,0
"Liberia","2024-01-02",0,0,0,0,0,0,0,0
"Liberia","2024-01-03",0,0,0,0,0,0,0,0
"Liberia","2024-01-04",0,0,0,0,0,0,0,0
"Liberia","2024-01-05",0,0,0,0,0,0,0,0
"Liberia","2024-01-06",0,0,0,0,0,0,0,0
"Liberia","2024-01-07",0,0,0,0,0,0,0,0
"Liberia","2024-01-08",0,0,0,0,0,0,0,0
"Liberia","2024-01-09",0,0,0,0,0,0,0,0
"Liberia","2024-01-10",0,0,0,0,0,0,0,0
"Liberia","2024-01-11",0,0,0,0,0,0,0,0
"Liberia","2024-01-12",0,0,0,0,0,0,0,0
"Liberia","2024-01-13",0,0,0,0,0,0,0,0
"Liberia","2024-01-14",0,1,1,0,1,1,0,0
"Liberia","2024-01-15",0,0,1,0,0,1,0,0
"Liberia","2024-01-16",0,0,1,0,0,1,0,0
"Liberia","2024-01-17",0,0,1,0,0,1,0,0
"Liberia","2024-01-18",0,0,1,0,0,1,0,0
"Liberia","2024-01-19",0,0,1,0,0,1,0,0
"Liberia","2024-01-20",0,0,1,0,0,1,0,0
"Liberia","2024-01-21",0,0,1,0,0,1,0,0
"Liberia","2024-01-22",0,0,1,0,0,1,0,0
"Liberia","2024-01-23",0,0,1,0,0,1,0,0
"Liberia","2024-01-24",0,0,1,0,0,1,0,0
"Liberia","2024-01-25",0,0,1,0,1,2,0,0
"Liberia","2024-01-26",0,0,1,0,0,2,0,0
"Liberia","2024-01-27",0,0,1,0,0,2,0,0
"Liberia","2024-01-28",0,0,1,0,0,2,0,0
"Liberia","2024-01-29",0,0,1,0,0,2,0,0
"Liberia","2024-01-30",0,0,1,0,0,2,0,0
"Liberia","2024-01-31",0,0,1,0,0,2,0,0
"Liberia","2024-02-01",0,0,1,0,0,2,0,0
"Liberia","2024-02-02",0,0,1,0,0,2,0,0
"Liberia","2024-02-03",0,0,1,0,0,2,0,0
"Liberia","2024-02-04",0,1,2,0,0,2,0,0
"Liberia","2024-02-05",0,0,2,0,0,2,0,0
"Liberia","2024-02-06",0,0,2,0,0,2,0,0
"Liberia","2024-02-07",0,0,2,0,0,2,0,0
"Liberia","2024-02-08",0,0,2,0,0,2,0,0
"Liberia","2024-02-09",0,0,2,0,0,2,0,0
"Liberia","2024-02-10",0,0,2,0,0,2,0,0
"Liberia","2024-02-11",0,0,2,0,0,2,0,0
"Liberia","2024-02-12",0,0,2,0,1,3,0,0
"Liberia","2024-02-13",0,0,2,0,0,3,0,0
"Liberia","2024-02-14",0,0,2,0,0,3,0,0
"Liberia","2024-02-15",0,0,2,0,0,3,0,0
"Liberia","2024-02-16",0,0,2,0,0,3,0,0
"Liberia","2024-02-17",0,0,2,0,0,3,0,0
"Liberia","2024-02-18",0,1,3,0,0,3,0,0
"Liberia","2024-02-19",0,0,3,0,0,3,0,0
"Liberia","2024-02-20",0,0,3,0,0,3,0,0
"Liberia","2024-02-21",0,0,3,0,0,3,0,0
"Liberia","2024-02-22",0,0,3,0,0,3,0,0
"Liberia","2024-02-23",0,0,3,0,0,3,0,0
"Liberia","2024-02-24",0,0,3,0,0,3,0,0
"Liberia","2024-02-25",0,0,3,0,0,3,0,0
"Liberia","2024-02-26",0,0,3,0,0,3,0,0
"Liberia","2024-02-27",0,0,3,0,0,3,0,0
"Liberia","2024-02-28",0,0,3,0,0,3,0,0
"Liberia","2024-02-29",0,0,3,0,1,4,0,0
"Liberia","2024-03-01",0,0,3,0,0,4,0,0
"Liberia","2024-03-02",0,0,3,0,0,4,0,0
"Liberia","2024-03-03",0,0,3,0,0,4,0,0
"Liberia","2024-03-04",0,0,3,0,0,4,0,0
"Liberia","2024-03-05",0,0,3,0,0,4,0,0
"Liberia","2024-03-06",0,0,3,0,0,4,0,0
"Liberia","2024-03-07",0,0,3,0,0,4,0,0
"Liberia","2024-03-08",0,0,3,0,0,4,0,0
"Liberia","2024-03-09",0,0,3,0,0,4,0,0
"Liberia","2024-03-10",0,1,4,0,0,4,0,0
"Liberia","2024-03-11",0,0,4,0,0,4,0,0
"Liberia","2024-03-12",0,0,4,0,0,4,0,0
"Liberia","2024-03-13",0,0,4,0,0,4,0,0
"Liberia","2024-03-14",0,0,4,0,0,4,0,0
"Liberia","2024-03-15",0,0,4,0,0,4,0,0
"Liberia","2024-03-16",0,0,4,0,0,4,0,0
"Liberia","2024-03-17",0,0,4,0,0,4,0,0
"Liberia","2024-03-18",0,0,4,0,0,4,0,0
"Liberia","2024-03-19",0,0,4,0,0,4,0,0
"Liberia","2024-03-20",0,0,4,0,0,4,0,0
"Liberia","2024-03-21",0,0,4,0,1,5,0,0
"Liberia","2024-03-22",0,0,4,0,0,5,0,0
"Liberia","2024-03-23",0,0,4,0,0,5,0,0
"Liberia","2024-03-24",0,0,4,0,0,5,0,0
"Liberia","2024-03-25",0,0,4,0,0,5,0,0
"Liberia","2024-03-26",0,0,4,0,0,5,0,0
"Liberia","2024-03-27",0,0,4,0,0,5,0,0
"Liberia","2024-03-28",0,0,4,0,0,5,0,0
"Liberia","2024-03-29",0,0,4,0,0,5,0,0
"Liberia","2024-03-30",0,0,4,0,0,5,0,0
"Liberia","2024-03-31",0,1,5,0,0,5,0,0
"Liberia","2024-04-01",0,0,5,0,0,5,0,0
"Liberia","2024-04-02",0,0,5,0,0,5,0,0
"Liberia","2024-04-03",0,0,5,0,0,5,0,0
"Liberia","2024-04-04",0,0,5,0,0,5,0,0
"Liberia","2024-04-05",0,0,5,0,0,5,0,0
"Liberia","2024-04-06",0,0,5,0,0,5,0,0
"Liberia","2024-04-07",0,0,5,0,0,5,0,0
"Liberia","2024-04-08",0,0,5,0,0,5,0,0
"Liberia","2024-04-09",0,0,5,0,0,5,0,0
"Liberia","2024-04-10",0,0,5,0,0,5,0,0
"Liberia","2024-04-11",0,0,5,0,0,5,0,0
"Liberia","2024-04-12",0,0,5,0,0,5,0,0
"Liberia","2024-04-13",0,0,5,0,0,5,0,0
"Liberia","2024-04-14",0,0,5,0,0,5,0,0
"Liberia","2024-04-15",0,0,5,0,0,5,0,0
"Liberia","2024-04-16",0,0,5,0,0,5,0,0
"Liberia","2024-04-17",0,0,5,0,0,5,0,0
"Liberia","2024-04-18",0,0,5,0,0,5,0,0
"Liberia","2024-04-19",0,0,5,0,0,5,0,0
"Liberia","2024-04-20",0,0,5,0,0,5,0,0
"Liberia","2024-04-21",0,0,5,0,0,5,0,0
"Liberia","2024-04-22",0,0,5,0,0,5,0,0
"Liberia","2024-04-23",0,0,5,0,0,5,0,0
"Liberia","2024-04-24",0,0,5,0,0,5,0,0
"Liberia","2024-04-25",0,0,5,0,0,5,0,0
"Liberia","2024-04-26",0,0,5,0,0,5,0,0
"Liberia","2024-04-27",0,0,5,0,0,5,0,0
"Liberia","2024-04-28",0,0,5,0,0,5,0,0
"Liberia","2024-04-29",0,0,5,0,0,5,0,0
"Liberia","2024-04-30",0,0,5,0,0,5,0,0
"Liberia","2024-05-01",0,0,5,0,0,5,0,0
"Liberia","2024-05-02",0,0,5,0,0,5,0,0
"Liberia","2024-05-03",0,0,5,0,0,5,0,0
"Liberia","2024-05-04",0,0,5,0,0,5,0,0
"Liberia","2024-05-05",0,0,5,0,0,5,0,0
"Liberia","2024-05-06",0,0,5,0,0,5,0,0
"Liberia","2024-05-07",0,0,5,0,0,5,0,0
"Liberia","2024-05-08",0,0,5,0,0,5,0,0
"Liberia","2024-05-09",0,0,5,0,0,5,0,0
"Liberia","2024-05-10",0,0,5,0,0,5,0,0
"Liberia","2024-05-11",0,0,5,0,0,5,0,0
"Liberia","2024-05-12",0,0,5,0,0,5,0,0
"Liberia","2024-05-13",0,0,5,0,0,5,0,0
"Liberia","2024-05-14",0,0,5,0,0,5,0,0
"Liberia","2024-05-15",0,0,5,0,0,5,0,0
"Liberia","2024-05-16",0,0,5,0,0,5,0,0
"Liberia","2024-05-17",0,0,5,0,0,5,0,0
"Liberia","2024-05-18",0,0,5,0,0,5,0,0
"Liberia","2024-05-19",0,0,5,0,0,5,0,0
"Liberia","2024-05-20",0,0,5,0,0,5,0,0
"Liberia","2024-05-21",0,0,5,0,0,5,0,0
"Liberia","2024-05-22",0,0,5,0,0,5,0,0
"Liberia","2024-05-23",0,0,5,0,0,5,0,0
"Liberia","2024-05-24",0,0,5,0,0,5,0,0
"Liberia","2024-05-25",0,0,5,0,0,5,0,0
"Liberia","2024-05-26",0,0,5,0,0,5,0,0
"Liberia","2024-05-27",0,0,5,0,0,5,0,0
"Liberia","2024-05-28",0,0,5,0,0,5,0,0
"Liberia","2024-05-29",0,0,5,0,0,5,0,0
"Liberia","2024-05-30",0,0,5,0,0,5,0,0
"Liberia","2024-05-31",0,0,5,0,0,5,0,0
"Liberia","2024-06-01",0,0,5,0,0,5,0,0
"Liberia","2024-06-02",0,0,5,0,0,5,0,0
"Liberia","2024-06-03",0,0,5,0,0,5,0,0
"Liberia","2024-06-04",0,0,5,0,0,5,0,0
"Liberia","2024-06-05",0,0,5,0,0,5,0,0
"Liberia","2024-06-06",0,0,5,0,1,6,0,0
"Liberia","2024-06-07",0,0,5,0,0,6,0,0
"Liberia","2024-06-08",0,0,5,0,0,6,0,0
"Liberia","2024-06-09",0,0,5,0,0,6,0,0
"Liberia","2024-06-10",0,0,5,0,0,6,0,0
"Liberia","2024-06-11",0,0,5,0,0,6,0,0
"Liberia","2024-06-12",0,0,5,0,0,6,0,0
"Liberia","2024-06-13",0,0,5,0,0,6,0,0
"Liberia","2024-06-14",0,0,5,0,0,6,0,0
"Liberia","2024-06-15",0,0,5,0,0,6,0,0
"Liberia","2024-06-16",0,0,5,0,0,6,0,0
"Liberia","2024-06-17",0,0,5,0,0,6,0,0
"Liberia","2024-06-18",0,0,5,0,0,6,0,0
"Liberia","2024-06-19",0,0,5,0,0,6,0,0
"Liberia","2024-06-20",0,0,5,0,0,6,0,0
"Liberia","2024-06-21",0,0,5,0,0,6,0,0
"Liberia","2024-06-22",0,0,5,0,0,6,0,0
"Liberia","2024-06-23",0,0,5,0,0,6,0,0
"Liberia","2024-06-24",0,0,5,0,0,6,0,0
"Liberia","2024-06-25",0,0,5,0,0,6,0,0
"Liberia","2024-06-26",0,0,5,0,0,6,0,0
"Liberia","2024-06-27",0,0,5,0,0,6,0,0
"Liberia","2024-06-28",0,0,5,0,0,6,0,0
"Liberia","2024-06-29",0,0,5,0,0,6,0,0
"Liberia","2024-06-30",0,0,5,0,0,6,0,0
"Liberia","2024-07-01",0,0,5,0,0,6,0,0
"Liberia","2024-07-02",0,0,5,0,0,6,0,0
"Liberia","2024-07-03",0,0,5,0,0,6,0,0
"Liberia","2024-07-04",0,0,5,0,0,6,0,0
"Liberia","2024-07-05",0,0,5,0,0,6,0,0
"Liberia","2024-07-06",0,0,5,0,0,6,0,0
"Liberia","2024-07-07",0,0,5,0,0,6,0,0
"Liberia","2024-07-08",0,0,5,0,0,6,0,0
"Liberia","2024-07-09",0,0,5,0,0,6,0,0
"Liberia","2024-07-10",0,0,5,0,0,6,0,0
"Liberia","2024-07-11",0,0,5,0,0,6,0,0
"Liberia","2024-07-12",0,0,5,0,0,6,0,0
"Liberia","2024-07-13",0,0,5,0,0,6,0,0
"Liberia","2024-07-14",0,0,5,0,0,6,0,0
"Liberia","2024-07-15",0,0,5,0,0,6,0,0
"Liberia","2024-07-16",0,0,5,0,0,6,0,0
"Liberia","2024-07-17",0,0,5,0,0,6,0,0
"Liberia","2024-07-18",0,0,5,0,0,6,0,0
"Liberia","2024-07-19",0,0,5,0,0,6,0,0
"Liberia","2024-07-20",0,0,5,0,0,6,0,0
"Liberia","2024-07-21",0,0,5,0,0,6,0,0
"Liberia","2024-07-22",0,0,5,0,0,6,0,0
"Liberia","2024-07-23",0,0,5,0,0,6,0,0
"Liberia","2024-07-24",0,0,5,0,0,6,0,0
"Liberia","2024-07-25",0,0,5,0,0,6,0,0
"Liberia","2024-07-26",0,0,5,0,0,6,0,0
"Liberia","2024-07-27",0,0,5,0,0,6,0,0
"Liberia","2024-07-28",0,0,5,0,0,6,0,0
"Liberia","2024-07-29",0,0,5,0,0,6,0,0
"Liberia","2024-07-30",0,0,5,0,0,6,0,0
"Liberia","2024-07-31",0,0,5,0,0,6,0,0
"Liberia","2024-08-01",0,0,5,0,0,6,0,0
"Liberia","2024-08-02",0,0,5,0,0,6,0,0
"Liberia","2024-08-03",0,0,5,0,0,6,0,0
"Liberia","2024-08-04",0,0,5,0,0,6,0,0
"Liberia","2024-08-05",0,0,5,0,0,6,0,0
"Liberia","2024-08-06",0,0,5,0,0,6,0,0
"Liberia","2024-08-07",0,0,5,0,0,6,0,0
"Liberia","2024-08-08",0,0,5,0,0,6,0,0
"Liberia","2024-08-09",0,0,5,0,0,6,0,0
"Liberia","2024-08-10",0,0,5,0,0,6,0,0
"Liberia","2024-08-11",0,1,6,0,0,6,0,0
"Liberia","2024-08-12",0,0,6,0,0,6,0,0
"Liberia","2024-08-13",0,0,6,0,0,6,0,0
"Liberia","2024-08-14",0,0,6,0,0,6,0,0
"Liberia","2024-08-15",0,0,6,0,0,6,0,0
"Liberia","2024-08-16",0,0,6,0,0,6,0,0
"Liberia","2024-08-17",0,0,6,0,0,6,0,0
"Liberia","2024-08-18",0,0,6,0,0,6,0,0
"Liberia","2024-08-19",0,0,6,0,0,6,0,0
"Liberia","2024-08-20",0,0,6,0,0,6,0,0
"Liberia","2024-08-21",0,0,6,0,0,6,0,0
"Liberia","2024-08-22",0,0,6,0,1,7,0,0
"Liberia","2024-08-23",0,0,6,0,0,7,0,0
"Liberia","2024-08-24",0,0,6,0,0,7,0,0
"Liberia","2024-08-25",0,0,6,0,0,7,0,0
"Liberia","2024-08-26",0,0,6,0,0,7,0,0
"Liberia","2024-08-27",0,0,6,0,0,7,0,0
"Liberia","2024-08-28",0,0,6,0,0,7,0,0
"Liberia","2024-08-29",0,0,6,0,0,7,0,0
"Liberia","2024-08-30",0,0,6,0,0,7,0,0
"Liberia","2024-08-31",0,0,6,0,0,7,0,0
"Liberia","2024-09-01",0,1,7,0,0,7,0,0
"Liberia","2024-09-02",0,0,7,0,0,7,0,0
"Liberia","2024-09-03",0,0,7,0,1,8,0,0
"Liberia","2024-09-04",0,0,7,0,0,8,0,0
"Liberia","2024-09-05",0,0,7,0,0,8,0,0
"Liberia","2024-09-06",0,0,7,0,0,8,0,0
"Liberia","2024-09-07",0,0,7,0,1,9,0,0
"Liberia","2024-09-08",85,2,9,85,0,9,85,85
"Liberia","2024-09-09",0,0,9,85,0,9,6,91
"Liberia","2024-09-10",0,0,9,85,1,10,5,96
"Liberia","2024-09-11",0,0,9,85,0,10,6,102
"Liberia","2024-09-12",0,0,9,85,1,11,6,108
"Liberia","2024-09-13",0,0,9,85,0,11,5,113
"Liberia","2024-09-14",0,0,9,85,1,12,6,119
"Liberia","2024-09-15",0,3,12,85,0,12,6,125
"Liberia","2024-09-16",0,0,12,85,0,12,5,130
"Liberia","2024-09-17",0,0,12,85,0,12,6,136
"Liberia","2024-09-18",0,0,12,85,0,12,5,141
"Liberia","2024-09-19",0,0,12,85,1,13,6,147
"Liberia","2024-09-20",0,0,12,85,0,13,6,153
"Liberia","2024-09-21",0,0,12,85,0,13,5,158
"Liberia","2024-09-22",79,0,12,164,0,13,6,164
"Liberia","2024-09-23",0,0,12,164,0,13,1,165
"Liberia","2024-09-24",0,0,12,164,0,13,1,166
"Liberia","2024-09-25",0,0,12,164,0,13,0,166
"Liberia","2024-09-26",0,0,12,164,1,14,1,167
"Liberia","2024-09-27",0,0,12,164,0,14,1,168
"Liberia","2024-09-28",0,0,12,164,0,14,1,169
"Liberia","2024-09-29",0,2,14,164,0,14,1,170
"Liberia","2024-09-30",0,0,14,164,0,14,1,171
"Liberia","2024-10-01",0,0,14,164,1,15,0,171
"Liberia","2024-10-02",0,0,14,164,0,15,1,172
"Liberia","2024-10-03",0,0,14,164,0,15,1,173
"Liberia","2024-10-04",0,0,14,164,0,15,1,174
"Liberia","2024-10-05",0,0,14,164,1,16,1,175
"Liberia","2024-10-06",0,0,14,164,0,16,1,176
"Liberia","2024-10-07",0,0,14,164,0,16,0,176
"Liberia","2024-10-08",0,0,14,164,1,17,1,177
"Liberia","2024-10-09",0,0,14,164,0,17,1,178
"Liberia","2024-10-10",0,0,14,164,0,17,1,179
"Liberia","2024-10-11",0,0,14,164,0,17,1,180
"Liberia","2024-10-12",0,0,14,164,1,18,0,180
"Liberia","2024-10-13",0,4,18,164,0,18,1,181
"Liberia","2024-10-14",0,0,18,164,0,18,1,182
"Liberia","2024-10-15",0,0,18,164,0,18,1,183
"Liberia","2024-10-16",0,0,18,164,0,18,1,184
"Liberia","2024-10-17",0,0,18,164,1,19,1,185
"Liberia","2024-10-18",0,0,18,164,0,19,0,185
"Liberia","2024-10-19",0,0,18,164,0,19,1,186
"Liberia","2024-10-20",23,1,19,187,0,19,1,187
"Liberia","2024-10-21",47,0,19,234,0,19,47,234
"Liberia","2024-10-22",0,0,19,234,0,19,1,235
"Liberia","2024-10-23",0,0,19,234,0,19,2,237
"Liberia","2024-10-24",0,0,19,234,1,20,1,238
"Liberia","2024-10-25",0,0,19,234,0,20,1,239
"Liberia","2024-10-26",0,0,19,234,0,20,2,241
"Liberia","2024-10-27",0,1,20,234,0,20,1,242
"Liberia","2024-10-28",0,0,20,234,0,20,1,243
"Liberia","2024-10-29",0,0,20,234,1,21,1,244
"Liberia","2024-10-30",0,0,20,234,0,21,2,246
"Liberia","2024-10-31",0,0,20,234,1,22,1,247
"Liberia","2024-11-01",0,0,20,234,0,22,1,248
"Liberia","2024-11-02",0,0,20,234,1,23,2,250
"Liberia","2024-11-03",17,3,23,251,0,23,1,251
"Liberia","2024-11-04",0,0,23,251,3,26,2,253
"Liberia","2024-11-05",0,0,23,251,2,28,3,256
"Liberia","2024-11-06",0,0,23,251,3,31,2,258
"Liberia","2024-11-07",0,0,23,251,2,33,2,260
"Liberia","2024-11-08",0,0,23,251,3,36,3,263
"Liberia","2024-11-09",0,0,23,251,2,38,2,265
"Liberia","2024-11-10",0,18,41,251,3,41,2,267
"Liberia","2024-11-11",0,0,41,251,0,41,2,269
"Liberia","2024-11-12",0,0,41,251,0,41,3,272
"Liberia","2024-11-13",23,0,41,274,0,41,2,274
"Liberia","2024-11-14",0,0,41,274,1,42,0,274
"Liberia","2024-11-15",0,0,41,274,0,42,0,274
"Liberia","2024-11-16",0,0,41,274,0,42,0,274
"Liberia","2024-11-17",0,1,42,274,0,42,0,274
"Liberia","2024-11-18",0,0,42,274,1,43,0,274
"Liberia","2024-11-19",0,0,42,274,2,45,0,274
"Liberia","2024-11-20",0,0,42,274,1,46,0,274
"Liberia","2024-11-21",0,0,42,274,1,47,0,274
"Liberia","2024-11-22",0,0,42,274,1,48,0,274
"Liberia","2024-11-23",0,0,42,274,2,50,0,274
"Liberia","2024-11-24",0,9,51,274,1,51,0,274
"Liberia","2024-11-25",0,0,51,274,2,53,0,274
"Liberia","2024-11-26",0,0,51,274,1,54,0,274
"Liberia","2024-11-27",0,0,51,274,2,56,0,274
"Liberia","2024-11-28",0,0,51,274,1,57,0,274
"Liberia","2024-11-29",0,0,51,274,2,59,0,274
"Liberia","2024-11-30",0,0,51,274,1,60,0,274
"Liberia","2024-12-01",0,11,62,274,2,62,0,274
"Liberia","2024-12-02",0,0,62,274,0,62,0,274
"Liberia","2024-12-03",0,0,62,274,0,62,0,274
"Liberia","2024-12-04",0,0,62,274,0,62,0,274
"Liberia","2024-12-05",0,0,62,274,1,63,0,274
"Liberia","2024-12-06",0,0,62,274,0,63,0,274
"Liberia","2024-12-07",0,0,62,274,0,63,0,274
"Liberia","2024-12-08",0,1,63,274,0,63,0,274
"Liberia","2024-12-09",0,0,63,274,0,63,0,274
"Liberia","2024-12-10",0,0,63,274,0,63,0,274
"Liberia","2024-12-11",0,0,63,274,0,63,0,274
"Liberia","2024-12-12",0,0,63,274,0,63,0,274
"Liberia","2024-12-13",0,0,63,274,0,63,0,274
"Liberia","2024-12-14",0,0,63,274,0,63,0,274
"Liberia","2024-12-15",0,0,63,274,0,63,0,274
"Liberia","2024-12-16",0,0,63,274,0,63,0,274
"Liberia","2024-12-17",0,0,63,274,0,63,0,274
"Liberia","2024-12-18",0,0,63,274,0,63,0,274
"Liberia","2024-12-19",0,0,63,274,0,63,0,274
"Liberia","2024-12-20",0,0,63,274,0,63,0,274
"Liberia","2024-12-21",0,0,63,274,0,63,0,274
"Liberia","2024-12-22",0,0,63,274,0,63,0,274
"Liberia","2024-12-23",0,0,63,274,0,63,0,274
"Liberia","2024-12-24",0,0,63,274,0,63,0,274
"Liberia","2024-12-25",0,0,63,274,0,63,0,274
"Liberia","2024-12-26",0,0,63,274,0,63,0,274
"Liberia","2024-12-27",0,0,63,274,0,63,0,274
"Liberia","2024-12-28",0,0,63,274,0,63,0,274
"Liberia","2024-12-29",0,0,63,274,0,63,0,274
"Liberia","2024-12-30",0,0,63,274,1,64,0,274
"Liberia","2024-12-31",0,0,63,274,0,64,0,274
"Liberia","2025-01-01",0,0,63,274,0,64,0,274
"Liberia","2025-01-02",0,0,63,274,0,64,0,274
"Liberia","2025-01-03",0,0,63,274,0,64,0,274
"Liberia","2025-01-04",0,0,63,274,0,64,0,274
"Liberia","2025-01-05",0,0,63,274,0,64,0,274
"Liberia","2025-01-06",0,0,63,274,0,64,0,274
"Liberia","2025-01-07",0,0,63,274,0,64,0,274
"Liberia","2025-01-08",0,0,63,274,0,64,0,274
"Liberia","2025-01-09",0,0,63,274,0,64,0,274
"Liberia","2025-01-10",0,0,63,274,0,64,0,274
"Liberia","2025-01-11",0,0,63,274,0,64,0,274
"Liberia","2025-01-12",0,0,63,274,0,64,0,274
"Liberia","2025-01-13",0,0,63,274,0,64,0,274
"Liberia","2025-01-14",0,0,63,274,0,64,0,274
"Liberia","2025-01-15",0,0,63,274,0,64,0,274
"Liberia","2025-01-16",0,0,63,274,0,64,0,274
"Liberia","2025-01-17",0,0,63,274,0,64,0,274
"Liberia","2025-01-18",0,0,63,274,0,64,0,274
"Liberia","2025-01-19",0,1,64,274,0,64,0,274
"Liberia","2025-01-20",0,0,64,274,0,64,0,274
"Liberia","2025-01-21",0,0,64,274,1,65,0,274
"Liberia","2025-01-22",0,0,64,274,0,65,0,274
"Liberia","2025-01-23",0,0,64,274,0,65,0,274
"Liberia","2025-01-24",0,0,64,274,0,65,0,274
"Liberia","2025-01-25",0,0,64,274,1,66,0,274
"Liberia","2025-01-26",0,0,64,274,0,66,0,274
"Liberia","2025-01-27",0,0,64,274,0,66,0,274
"Liberia","2025-01-28",0,0,64,274,1,67,0,274
"Liberia","2025-01-29",0,0,64,274,0,67,0,274
"Liberia","2025-01-30",0,0,64,274,0,67,0,274
"Liberia","2025-01-31",0,0,64,274,0,67,0,274
"Liberia","2025-02-01",0,0,64,274,1,68,0,274
"Liberia","2025-02-02",0,4,68,274,0,68,0,274
"Liberia","2025-02-03",0,0,68,274,0,68,0,274
"Liberia","2025-02-04",0,0,68,274,1,69,0,274
"Liberia","2025-02-05",0,0,68,274,0,69,0,274
"Liberia","2025-02-06",0,0,68,274,0,69,0,274
"Liberia","2025-02-07",0,0,68,274,0,69,0,274
"Liberia","2025-02-08",0,0,68,274,1,70,0,274
"Liberia","2025-02-09",0,2,70,274,0,70,0,274
"Liberia","2025-02-10",0,0,70,274,0,70,0,274
"Liberia","2025-02-11",0,0,70,274,0,70,0,274
"Liberia","2025-02-12",0,0,70,274,0,70,0,274
"Liberia","2025-02-13",0,0,70,274,0,70,0,274
"Liberia","2025-02-14",0,0,70,274,0,70,0,274
"Liberia","2025-02-15",0,0,70,274,0,70,0,274
"Liberia","2025-02-16",0,0,70,274,0,70,0,274
"Liberia","2025-02-17",0,0,70,274,0,70,0,274
"Liberia","2025-02-18",0,0,70,274,0,70,0,274
"Liberia","2025-02-19",0,0,70,274,0,70,0,274
"Liberia","2025-02-20",0,0,70,274,0,70,0,274
"Liberia","2025-02-21",0,0,70,274,0,70,0,274
"Liberia","2025-02-22",0,0,70,274,0,70,0,274
"Liberia","2025-02-23",0,0,70,274,0,70,0,274
"Liberia","2025-02-24",0,0,70,274,0,70,0,274
"Liberia","2025-02-25",0,0,70,274,0,70,0,274
"Liberia","2025-02-26",0,0,70,274,0,70,0,274
"Liberia","2025-02-27",0,0,70,274,0,70,0,274
"Liberia","2025-02-28",0,0,70,274,0,70,0,274
"Liberia","2025-03-01",0,0,70,274,0,70,0,274
"Liberia","2025-03-02",0,0,70,274,0,70,0,274
"Liberia","2025-03-03",0,0,70,274,0,70,0,274
"Lithuania","2024-01-01",0,0,0,0,0,0,0,0
"Lithuania","2024-01-02",0,0,0,0,0,0,0,0
"Lithuania","2024-01-03",0,0,0,0,0,0,0,0
"Lithuania","2024-01-04",0,0,0,0,0,0,0,0
"Lithuania","2024-01-05",0,0,0,0,0,0,0,0
"Lithuania","2024-01-06",0,0,0,0,0,0,0,0
"Lithuania","2024-01-07",0,0,0,0,0,0,0,0
"Lithuania","2024-01-08",0,0,0,0,0,0,0,0
"Lithuania","2024-01-09",0,0,0,0,0,0,0,0
"Lithuania","2024-01-10",0,0,0,0,0,0,0,0
"Lithuania","2024-01-11",0,0,0,0,0,0,0,0
"Lithuania","2024-01-12",0,0,0,0,0,0,0,0
"Lithuania","2024-01-13",0,0,0,0,0,0,0,0
"Lithuania","2024-01-14",0,0,0,0,0,0,0,0
"Lithuania","2024-01-15",0,0,0,0,0,0,0,0
"Lithuania","2024-01-16",0,0,0,0,0,0,0,0
"Lithuania","2024-01-17",0,0,0,0,0,0,0,0
"Lithuania","2024-01-18",0,0,0,0,0,0,0,0
"Lithuania","2024-01-19",0,0,0,0,0,0,0,0
"Lithuania","2024-01-20",0,0,0,0,0,0,0,0
"Lithuania","2024-01-21",0,0,0,0,0,0,0,0
"Lithuania","2024-01-22",0,0,0,0,0,0,0,0
"Lithuania","2024-01-23",0,0,0,0,0,0,0,0
"Lithuania","2024-01-24",0,0,0,0,0,0,0,0
"Lithuania","2024-01-25",0,0,0,0,0,0,0,0
"Lithuania","2024-01-26",0,0,0,0,0,0,0,0
"Lithuania","2024-01-27",0,0,0,0,0,0,0,0
"Lithuania","2024-01-28",0,0,0,0,0,0,0,0
"Lithuania","2024-01-29",0,0,0,0,0,0,0,0
"Lithuania","2024-01-30",0,0,0,0,0,0,0,0
"Lithuania","2024-01-31",0,0,0,0,0,0,0,0
"Lithuania","2024-02-01",0,0,0,0,0,0,0,0
"Lithuania","2024-02-02",0,0,0,0,0,0,0,0
"Lithuania","2024-02-03",0,0,0,0,0,0,0,0
"Lithuania","2024-02-04",0,0,0,0,0,0,0,0
"Lithuania","2024-02-05",0,0,0,0,0,0,0,0
"Lithuania","2024-02-06",0,0,0,0,0,0,0,0
"Lithuania","2024-02-07",0,0,0,0,0,0,0,0
"Lithuania","2024-02-08",0,0,0,0,0,0,0,0
"Lithuania","2024-02-09",0,0,0,0,0,0,0,0
"Lithuania","2024-02-10",0,0,0,0,0,0,0,0
"Lithuania","2024-02-11",0,0,0,0,0,0,0,0
"Lithuania","2024-02-12",0,0,0,0,0,0,0,0
"Lithuania","2024-02-13",0,0,0,0,0,0,0,0
"Lithuania","2024-02-14",0,0,0,0,0,0,0,0
"Lithuania","2024-02-15",0,0,0,0,0,0,0,0
"Lithuania","2024-02-16",0,0,0,0,0,0,0,0
"Lithuania","2024-02-17",0,0,0,0,0,0,0,0
"Lithuania","2024-02-18",0,0,0,0,0,0,0,0
"Lithuania","2024-02-19",0,0,0,0,0,0,0,0
"Lithuania","2024-02-20",0,0,0,0,0,0,0,0
"Lithuania","2024-02-21",0,0,0,0,0,0,0,0
"Lithuania","2024-02-22",0,0,0,0,0,0,0,0
"Lithuania","2024-02-23",0,0,0,0,0,0,0,0
"Lithuania","2024-02-24",0,0,0,0,0,0,0,0
"Lithuania","2024-02-25",0,0,0,0,0,0,0,0
"Lithuania","2024-02-26",0,0,0,0,0,0,0,0
"Lithuania","2024-02-27",0,0,0,0,0,0,0,0
"Lithuania","2024-02-28",0,0,0,0,0,0,0,0
"Lithuania","2024-02-29",0,0,0,0,0,0,0,0
"Lithuania","2024-03-01",0,0,0,0,0,0,0,0
"Lithuania","2024-03-02",0,0,0,0,0,0,0,0
"Lithuania","2024-03-03",0,0,0,0,0,0,0,0
"Lithuania","2024-03-04",0,0,0,0,0,0,0,0
"Lithuania","2024-03-05",0,0,0,0,0,0,0,0
"Lithuania","2024-03-06",0,0,0,0,0,0,0,0
"Lithuania","2024-03-07",0,0,0,0,0,0,0,0
"Lithuania","2024-03-08",0,0,0,0,0,0,0,0
"Lithuania","2024-03-09",0,0,0,0,0,0,0,0
"Lithuania","2024-03-10",0,0,0,0,0,0,0,0
"Lithuania","2024-03-11",0,0,0,0,0,0,0,0
"Lithuania","2024-03-12",0,0,0,0,0,0,0,0
"Lithuania","2024-03-13",0,0,0,0,0,0,0,0
"Lithuania","2024-03-14",0,0,0,0,0,0,0,0
"Lithuania","2024-03-15",0,0,0,0,0,0,0,0
"Lithuania","2024-03-16",0,0,0,0,0,0,0,0
"Lithuania","2024-03-17",0,0,0,0,0,0,0,0
"Lithuania","2024-03-18",0,0,0,0,0,0,0,0
"Lithuania","2024-03-19",0,0,0,0,0,0,0,0
"Lithuania","2024-03-20",0,0,0,0,0,0,0,0
"Lithuania","2024-03-21",0,0,0,0,0,0,0,0
"Lithuania","2024-03-22",0,0,0,0,0,0,0,0
"Lithuania","2024-03-23",0,0,0,0,0,0,0,0
"Lithuania","2024-03-24",0,0,0,0,0,0,0,0
"Lithuania","2024-03-25",0,0,0,0,0,0,0,0
"Lithuania","2024-03-26",0,0,0,0,0,0,0,0
"Lithuania","2024-03-27",0,0,0,0,0,0,0,0
"Lithuania","2024-03-28",0,0,0,0,0,0,0,0
"Lithuania","2024-03-29",0,0,0,0,0,0,0,0
"Lithuania","2024-03-30",0,0,0,0,0,0,0,0
"Lithuania","2024-03-31",0,0,0,0,0,0,0,0
"Lithuania","2024-04-01",0,0,0,0,0,0,0,0
"Lithuania","2024-04-02",0,0,0,0,0,0,0,0
"Lithuania","2024-04-03",0,0,0,0,0,0,0,0
"Lithuania","2024-04-04",0,0,0,0,0,0,0,0
"Lithuania","2024-04-05",0,0,0,0,0,0,0,0
"Lithuania","2024-04-06",0,0,0,0,0,0,0,0
"Lithuania","2024-04-07",0,0,0,0,0,0,0,0
"Lithuania","2024-04-08",0,0,0,0,0,0,0,0
"Lithuania","2024-04-09",0,0,0,0,0,0,0,0
"Lithuania","2024-04-10",0,0,0,0,0,0,0,0
"Lithuania","2024-04-11",0,0,0,0,0,0,0,0
"Lithuania","2024-04-12",0,0,0,0,0,0,0,0
"Lithuania","2024-04-13",0,0,0,0,0,0,0,0
"Lithuania","2024-04-14",0,0,0,0,0,0,0,0
"Lithuania","2024-04-15",0,0,0,0,0,0,0,0
"Lithuania","2024-04-16",0,0,0,0,0,0,0,0
"Lithuania","2024-04-17",0,0,0,0,0,0,0,0
"Lithuania","2024-04-18",0,0,0,0,0,0,0,0
"Lithuania","2024-04-19",0,0,0,0,0,0,0,0
"Lithuania","2024-04-20",0,0,0,0,0,0,0,0
"Lithuania","2024-04-21",0,0,0,0,0,0,0,0
"Lithuania","2024-04-22",0,0,0,0,0,0,0,0
"Lithuania","2024-04-23",0,0,0,0,0,0,0,0
"Lithuania","2024-04-24",0,0,0,0,0,0,0,0
"Lithuania","2024-04-25",0,0,0,0,0,0,0,0
"Lithuania","2024-04-26",0,0,0,0,0,0,0,0
"Lithuania","2024-04-27",0,0,0,0,0,0,0,0
"Lithuania","2024-04-28",0,0,0,0,0,0,0,0
"Lithuania","2024-04-29",0,0,0,0,0,0,0,0
"Lithuania","2024-04-30",0,0,0,0,0,0,0,0
"Lithuania","2024-05-01",0,0,0,0,0,0,0,0
"Lithuania","2024-05-02",0,0,0,0,0,0,0,0
"Lithuania","2024-05-03",0,0,0,0,0,0,0,0
"Lithuania","2024-05-04",0,0,0,0,0,0,0,0
"Lithuania","2024-05-05",0,0,0,0,0,0,0,0
"Lithuania","2024-05-06",0,0,0,0,0,0,0,0
"Lithuania","2024-05-07",0,0,0,0,0,0,0,0
"Lithuania","2024-05-08",0,0,0,0,0,0,0,0
"Lithuania","2024-05-09",0,0,0,0,0,0,0,0
"Lithuania","2024-05-10",0,0,0,0,0,0,0,0
"Lithuania","2024-05-11",0,0,0,0,0,0,0,0
"Lithuania","2024-05-12",0,0,0,0,0,0,0,0
"Lithuania","2024-05-13",0,0,0,0,0,0,0,0
"Lithuania","2024-05-14",0,0,0,0,0,0,0,0
"Lithuania","2024-05-15",0,0,0,0,0,0,0,0
"Lithuania","2024-05-16",0,0,0,0,0,0,0,0
"Lithuania","2024-05-17",0,0,0,0,0,0,0,0
"Lithuania","2024-05-18",0,0,0,0,0,0,0,0
"Lithuania","2024-05-19",0,0,0,0,0,0,0,0
"Lithuania","2024-05-20",0,0,0,0,0,0,0,0
"Lithuania","2024-05-21",0,0,0,0,0,0,0,0
"Lithuania","2024-05-22",0,0,0,0,0,0,0,0
"Lithuania","2024-05-23",0,0,0,0,0,0,0,0
"Lithuania","2024-05-24",0,0,0,0,0,0,0,0
"Lithuania","2024-05-25",0,0,0,0,0,0,0,0
"Lithuania","2024-05-26",0,0,0,0,0,0,0,0
"Lithuania","2024-05-27",0,0,0,0,0,0,0,0
"Lithuania","2024-05-28",0,0,0,0,0,0,0,0
"Lithuania","2024-05-29",0,0,0,0,0,0,0,0
"Lithuania","2024-05-30",0,0,0,0,0,0,0,0
"Lithuania","2024-05-31",0,0,0,0,0,0,0,0
"Lithuania","2024-06-01",0,0,0,0,0,0,0,0
"Lithuania","2024-06-02",0,0,0,0,0,0,0,0
"Lithuania","2024-06-03",0,0,0,0,0,0,0,0
"Lithuania","2024-06-04",0,0,0,0,0,0,0,0
"Lithuania","2024-06-05",0,0,0,0,0,0,0,0
"Lithuania","2024-06-06",0,0,0,0,0,0,0,0
"Lithuania","2024-06-07",0,0,0,0,0,0,0,0
"Lithuania","2024-06-08",0,0,0,0,0,0,0,0
"Lithuania","2024-06-09",0,0,0,0,0,0,0,0
"Lithuania","2024-06-10",0,0,0,0,0,0,0,0
"Lithuania","2024-06-11",0,0,0,0,0,0,0,0
"Lithuania","2024-06-12",0,0,0,0,0,0,0,0
"Lithuania","2024-06-13",0,0,0,0,0,0,0,0
"Lithuania","2024-06-14",0,0,0,0,0,0,0,0
"Lithuania","2024-06-15",0,0,0,0,0,0,0,0
"Lithuania","2024-06-16",0,0,0,0,0,0,0,0
"Lithuania","2024-06-17",0,0,0,0,0,0,0,0
"Lithuania","2024-06-18",0,0,0,0,0,0,0,0
"Lithuania","2024-06-19",0,0,0,0,0,0,0,0
"Lithuania","2024-06-20",0,0,0,0,0,0,0,0
"Lithuania","2024-06-21",0,0,0,0,0,0,0,0
"Lithuania","2024-06-22",0,0,0,0,0,0,0,0
"Lithuania","2024-06-23",0,0,0,0,0,0,0,0
"Lithuania","2024-06-24",0,0,0,0,0,0,0,0
"Lithuania","2024-06-25",0,0,0,0,0,0,0,0
"Lithuania","2024-06-26",0,0,0,0,0,0,0,0
"Lithuania","2024-06-27",0,0,0,0,0,0,0,0
"Lithuania","2024-06-28",0,0,0,0,0,0,0,0
"Lithuania","2024-06-29",0,0,0,0,0,0,0,0
"Lithuania","2024-06-30",0,0,0,0,0,0,0,0
"Lithuania","2024-07-01",0,0,0,0,0,0,0,0
"Lithuania","2024-07-02",0,0,0,0,0,0,0,0
"Lithuania","2024-07-03",0,0,0,0,0,0,0,0
"Lithuania","2024-07-04",0,0,0,0,0,0,0,0
"Lithuania","2024-07-05",0,0,0,0,0,0,0,0
"Lithuania","2024-07-06",0,0,0,0,0,0,0,0
"Lithuania","2024-07-07",0,0,0,0,0,0,0,0
"Lithuania","2024-07-08",0,0,0,0,0,0,0,0
"Lithuania","2024-07-09",0,0,0,0,0,0,0,0
"Lithuania","2024-07-10",0,0,0,0,0,0,0,0
"Lithuania","2024-07-11",0,0,0,0,0,0,0,0
"Lithuania","2024-07-12",0,0,0,0,0,0,0,0
"Lithuania","2024-07-13",0,0,0,0,0,0,0,0
"Lithuania","2024-07-14",0,0,0,0,0,0,0,0
"Lithuania","2024-07-15",0,0,0,0,0,0,0,0
"Lithuania","2024-07-16",0,0,0,0,0,0,0,0
"Lithuania","2024-07-17",0,0,0,0,0,0,0,0
"Lithuania","2024-07-18",0,0,0,0,0,0,0,0
"Lithuania","2024-07-19",0,0,0,0,0,0,0,0
"Lithuania","2024-07-20",0,0,0,0,0,0,0,0
"Lithuania","2024-07-21",0,0,0,0,0,0,0,0
"Lithuania","2024-07-22",0,0,0,0,0,0,0,0
"Lithuania","2024-07-23",0,0,0,0,0,0,0,0
"Lithuania","2024-07-24",0,0,0,0,0,0,0,0
"Lithuania","2024-07-25",0,0,0,0,0,0,0,0
"Lithuania","2024-07-26",0,0,0,0,0,0,0,0
"Lithuania","2024-07-27",0,0,0,0,0,0,0,0
"Lithuania","2024-07-28",0,0,0,0,0,0,0,0
"Lithuania","2024-07-29",0,0,0,0,0,0,0,0
"Lithuania","2024-07-30",0,0,0,0,0,0,0,0
"Lithuania","2024-07-31",0,0,0,0,0,0,0,0
"Lithuania","2024-08-01",0,0,0,0,0,0,0,0
"Lithuania","2024-08-02",0,0,0,0,0,0,0,0
"Lithuania","2024-08-03",0,0,0,0,0,0,0,0
"Lithuania","2024-08-04",0,0,0,0,0,0,0,0
"Lithuania","2024-08-05",0,0,0,0,0,0,0,0
"Lithuania","2024-08-06",0,0,0,0,0,0,0,0
"Lithuania","2024-08-07",0,0,0,0,0,0,0,0
"Lithuania","2024-08-08",0,0,0,0,0,0,0,0
"Lithuania","2024-08-09",0,0,0,0,0,0,0,0
"Lithuania","2024-08-10",0,0,0,0,0,0,0,0
"Lithuania","2024-08-11",0,0,0,0,0,0,0,0
"Lithuania","2024-08-12",0,0,0,0,0,0,0,0
"Lithuania","2024-08-13",0,0,0,0,0,0,0,0
"Lithuania","2024-08-14",0,0,0,0,0,0,0,0
"Lithuania","2024-08-15",0,0,0,0,0,0,0,0
"Lithuania","2024-08-16",0,0,0,0,0,0,0,0
"Lithuania","2024-08-17",0,0,0,0,0,0,0,0
"Lithuania","2024-08-18",0,0,0,0,0,0,0,0
"Lithuania","2024-08-19",0,0,0,0,0,0,0,0
"Lithuania","2024-08-20",0,0,0,0,0,0,0,0
"Lithuania","2024-08-21",0,0,0,0,0,0,0,0
"Lithuania","2024-08-22",0,0,0,0,0,0,0,0
"Lithuania","2024-08-23",0,0,0,0,0,0,0,0
"Lithuania","2024-08-24",0,0,0,0,0,0,0,0
"Lithuania","2024-08-25",0,0,0,0,0,0,0,0
"Lithuania","2024-08-26",0,0,0,0,0,0,0,0
"Lithuania","2024-08-27",0,0,0,0,0,0,0,0
"Lithuania","2024-08-28",0,0,0,0,0,0,0,0
"Lithuania","2024-08-29",0,0,0,0,0,0,0,0
"Lithuania","2024-08-30",0,0,0,0,0,0,0,0
"Lithuania","2024-08-31",0,0,0,0,0,0,0,0
"Lithuania","2024-09-01",0,0,0,0,0,0,0,0
"Lithuania","2024-09-02",0,0,0,0,0,0,0,0
"Lithuania","2024-09-03",0,0,0,0,0,0,0,0
"Lithuania","2024-09-04",0,0,0,0,0,0,0,0
"Lithuania","2024-09-05",0,0,0,0,0,0,0,0
"Lithuania","2024-09-06",0,0,0,0,0,0,0,0
"Lithuania","2024-09-07",0,0,0,0,0,0,0,0
"Lithuania","2024-09-08",0,0,0,0,0,0,0,0
"Lithuania","2024-09-09",0,0,0,0,0,0,0,0
"Lithuania","2024-09-10",0,0,0,0,0,0,0,0
"Lithuania","2024-09-11",0,0,0,0,0,0,0,0
"Lithuania","2024-09-12",0,0,0,0,0,0,0,0
"Lithuania","2024-09-13",0,0,0,0,0,0,0,0
"Lithuania","2024-09-14",0,0,0,0,0,0,0,0
"Lithuania","2024-09-15",0,0,0,0,0,0,0,0
"Lithuania","2024-09-16",0,0,0,0,0,0,0,0
"Lithuania","2024-09-17",0,0,0,0,0,0,0,0
"Lithuania","2024-09-18",0,0,0,0,0,0,0,0
"Lithuania","2024-09-19",0,0,0,0,0,0,0,0
"Lithuania","2024-09-20",0,0,0,0,0,0,0,0
"Lithuania","2024-09-21",0,0,0,0,0,0,0,0
"Lithuania","2024-09-22",0,0,0,0,0,0,0,0
"Lithuania","2024-09-23",0,0,0,0,0,0,0,0
"Lithuania","2024-09-24",0,0,0,0,0,0,0,0
"Lithuania","2024-09-25",0,0,0,0,0,0,0,0
"Lithuania","2024-09-26",0,0,0,0,0,0,0,0
"Lithuania","2024-09-27",0,0,0,0,0,0,0,0
"Lithuania","2024-09-28",0,0,0,0,0,0,0,0
"Lithuania","2024-09-29",0,0,0,0,0,0,0,0
"Lithuania","2024-09-30",0,1,1,0,1,1,0,0
"Lithuania","2024-10-01",0,0,1,0,0,1,0,0
"Lithuania","2024-10-02",0,0,1,0,0,1,0,0
"Lithuania","2024-10-03",0,0,1,0,0,1,0,0
"Lithuania","2024-10-04",0,0,1,0,0,1,0,0
"Lithuania","2024-10-05",0,0,1,0,0,1,0,0
"Lithuania","2024-10-06",0,0,1,0,0,1,0,0
"Lithuania","2024-10-07",0,0,1,0,0,1,0,0
"Lithuania","2024-10-08",0,0,1,0,0,1,0,0
"Lithuania","2024-10-09",0,0,1,0,0,1,0,0
"Lithuania","2024-10-10",0,0,1,0,0,1,0,0
"Lithuania","2024-10-11",0,0,1,0,0,1,0,0
"Lithuania","2024-10-12",0,0,1,0,0,1,0,0
"Lithuania","2024-10-13",0,0,1,0,0,1,0,0
"Lithuania","2024-10-14",0,0,1,0,0,1,0,0
"Lithuania","2024-10-15",0,0,1,0,0,1,0,0
"Lithuania","2024-10-16",0,0,1,0,0,1,0,0
"Lithuania","2024-10-17",0,0,1,0,0,1,0,0
"Lithuania","2024-10-18",0,0,1,0,0,1,0,0
"Lithuania","2024-10-19",0,0,1,0,0,1,0,0
"Lithuania","2024-10-20",0,0,1,0,0,1,0,0
"Lithuania","2024-10-21",0,0,1,0,0,1,0,0
"Lithuania","2024-10-22",0,0,1,0,0,1,0,0
"Lithuania","2024-10-23",0,0,1,0,0,1,0,0
"Lithuania","2024-10-24",0,0,1,0,0,1,0,0
"Lithuania","2024-10-25",0,0,1,0,0,1,0,0
"Lithuania","2024-10-26",0,0,1,0,0,1,0,0
"Lithuania","2024-10-27",0,0,1,0,0,1,0,0
"Lithuania","2024-10-28",0,0,1,0,0,1,0,0
"Lithuania","2024-10-29",0,0,1,0,0,1,0,0
"Lithuania","2024-10-30",0,0,1,0,0,1,0,0
"Lithuania","2024-10-31",0,0,1,0,0,1,0,0
"Lithuania","2024-11-01",0,0,1,0,0,1,0,0
"Lithuania","2024-11-02",0,0,1,0,0,1,0,0
"Lithuania","2024-11-03",0,0,1,0,0,1,0,0
"Lithuania","2024-11-04",0,0,1,0,0,1,0,0
"Lithuania","2024-11-05",0,0,1,0,0,1,0,0
"Lithuania","2024-11-06",0,0,1,0,0,1,0,0
"Lithuania","2024-11-07",0,0,1,0,0,1,0,0
"Lithuania","2024-11-08",0,0,1,0,0,1,0,0
"Lithuania","2024-11-09",0,0,1,0,0,1,0,0
"Lithuania","2024-11-10",0,0,1,0,0,1,0,0
"Lithuania","2024-11-11",0,0,1,0,0,1,0,0
"Lithuania","2024-11-12",0,0,1,0,0,1,0,0
"Lithuania","2024-11-13",0,0,1,0,0,1,0,0
"Lithuania","2024-11-14",0,0,1,0,0,1,0,0
"Lithuania","2024-11-15",0,0,1,0,0,1,0,0
"Lithuania","2024-11-16",0,0,1,0,0,1,0,0
"Lithuania","2024-11-17",0,0,1,0,0,1,0,0
"Lithuania","2024-11-18",0,0,1,0,0,1,0,0
"Lithuania","2024-11-19",0,0,1,0,0,1,0,0
"Lithuania","2024-11-20",0,0,1,0,0,1,0,0
"Lithuania","2024-11-21",0,0,1,0,0,1,0,0
"Lithuania","2024-11-22",0,0,1,0,0,1,0,0
"Lithuania","2024-11-23",0,0,1,0,0,1,0,0
"Lithuania","2024-11-24",0,0,1,0,0,1,0,0
"Lithuania","2024-11-25",0,0,1,0,0,1,0,0
"Lithuania","2024-11-26",0,0,1,0,0,1,0,0
"Lithuania","2024-11-27",0,0,1,0,0,1,0,0
"Lithuania","2024-11-28",0,0,1,0,0,1,0,0
"Lithuania","2024-11-29",0,0,1,0,0,1,0,0
"Lithuania","2024-11-30",0,0,1,0,0,1,0,0
"Lithuania","2024-12-01",0,0,1,0,0,1,0,0
"Lithuania","2024-12-02",0,0,1,0,0,1,0,0
"Lithuania","2024-12-03",0,0,1,0,0,1,0,0
"Lithuania","2024-12-04",0,0,1,0,0,1,0,0
"Lithuania","2024-12-05",0,0,1,0,0,1,0,0
"Lithuania","2024-12-06",0,0,1,0,0,1,0,0
"Lithuania","2024-12-07",0,0,1,0,0,1,0,0
"Lithuania","2024-12-08",0,0,1,0,0,1,0,0
"Lithuania","2024-12-09",0,0,1,0,0,1,0,0
"Lithuania","2024-12-10",0,0,1,0,0,1,0,0
"Lithuania","2024-12-11",0,0,1,0,0,1,0,0
"Lithuania","2024-12-12",0,0,1,0,0,1,0,0
"Lithuania","2024-12-13",0,0,1,0,0,1,0,0
"Lithuania","2024-12-14",0,0,1,0,0,1,0,0
"Lithuania","2024-12-15",0,0,1,0,0,1,0,0
"Lithuania","2024-12-16",0,0,1,0,0,1,0,0
"Lithuania","2024-12-17",0,0,1,0,0,1,0,0
"Lithuania","2024-12-18",0,0,1,0,0,1,0,0
"Lithuania","2024-12-19",0,0,1,0,0,1,0,0
"Lithuania","2024-12-20",0,0,1,0,0,1,0,0
"Lithuania","2024-12-21",0,0,1,0,0,1,0,0
"Lithuania","2024-12-22",0,0,1,0,0,1,0,0
"Lithuania","2024-12-23",0,0,1,0,0,1,0,0
"Lithuania","2024-12-24",0,0,1,0,0,1,0,0
"Lithuania","2024-12-25",0,0,1,0,0,1,0,0
"Lithuania","2024-12-26",0,0,1,0,0,1,0,0
"Lithuania","2024-12-27",0,0,1,0,0,1,0,0
"Lithuania","2024-12-28",0,0,1,0,0,1,0,0
"Lithuania","2024-12-29",0,0,1,0,0,1,0,0
"Lithuania","2024-12-30",0,0,1,0,0,1,0,0
"Lithuania","2024-12-31",0,0,1,0,0,1,0,0
"Lithuania","2025-01-01",0,0,1,0,0,1,0,0
"Lithuania","2025-01-02",0,0,1,0,0,1,0,0
"Lithuania","2025-01-03",0,0,1,0,0,1,0,0
"Lithuania","2025-01-04",0,0,1,0,0,1,0,0
"Lithuania","2025-01-05",0,0,1,0,0,1,0,0
"Lithuania","2025-01-06",0,0,1,0,0,1,0,0
"Lithuania","2025-01-07",0,0,1,0,0,1,0,0
"Lithuania","2025-01-08",0,0,1,0,0,1,0,0
"Lithuania","2025-01-09",0,0,1,0,0,1,0,0
"Lithuania","2025-01-10",0,0,1,0,0,1,0,0
"Lithuania","2025-01-11",0,0,1,0,0,1,0,0
"Lithuania","2025-01-12",0,0,1,0,0,1,0,0
"Lithuania","2025-01-13",0,0,1,0,0,1,0,0
"Lithuania","2025-01-14",0,0,1,0,0,1,0,0
"Lithuania","2025-01-15",0,0,1,0,0,1,0,0
"Lithuania","2025-01-16",0,0,1,0,0,1,0,0
"Lithuania","2025-01-17",0,0,1,0,0,1,0,0
"Lithuania","2025-01-18",0,0,1,0,0,1,0,0
"Lithuania","2025-01-19",0,0,1,0,0,1,0,0
"Lithuania","2025-01-20",0,0,1,0,0,1,0,0
"Lithuania","2025-01-21",0,0,1,0,0,1,0,0
"Lithuania","2025-01-22",0,0,1,0,0,1,0,0
"Lithuania","2025-01-23",0,0,1,0,0,1,0,0
"Lithuania","2025-01-24",0,0,1,0,0,1,0,0
"Lithuania","2025-01-25",0,0,1,0,0,1,0,0
"Lithuania","2025-01-26",0,0,1,0,0,1,0,0
"Lithuania","2025-01-27",0,0,1,0,0,1,0,0
"Lithuania","2025-01-28",0,0,1,0,0,1,0,0
"Lithuania","2025-01-29",0,0,1,0,0,1,0,0
"Lithuania","2025-01-30",0,0,1,0,0,1,0,0
"Lithuania","2025-01-31",0,0,1,0,0,1,0,0
"Lithuania","2025-02-01",0,0,1,0,0,1,0,0
"Lithuania","2025-02-02",0,0,1,0,0,1,0,0
"Lithuania","2025-02-03",0,0,1,0,0,1,0,0
"Lithuania","2025-02-04",0,0,1,0,0,1,0,0
"Lithuania","2025-02-05",0,0,1,0,0,1,0,0
"Lithuania","2025-02-06",0,0,1,0,0,1,0,0
"Lithuania","2025-02-07",0,0,1,0,0,1,0,0
"Lithuania","2025-02-08",0,0,1,0,0,1,0,0
"Lithuania","2025-02-09",0,0,1,0,0,1,0,0
"Lithuania","2025-02-10",0,0,1,0,0,1,0,0
"Lithuania","2025-02-11",0,0,1,0,0,1,0,0
"Lithuania","2025-02-12",0,0,1,0,0,1,0,0
"Lithuania","2025-02-13",0,0,1,0,0,1,0,0
"Lithuania","2025-02-14",0,0,1,0,0,1,0,0
"Lithuania","2025-02-15",0,0,1,0,0,1,0,0
"Lithuania","2025-02-16",0,0,1,0,0,1,0,0
"Lithuania","2025-02-17",0,0,1,0,0,1,0,0
"Lithuania","2025-02-18",0,0,1,0,0,1,0,0
"Lithuania","2025-02-19",0,0,1,0,0,1,0,0
"Lithuania","2025-02-20",0,0,1,0,0,1,0,0
"Lithuania","2025-02-21",0,0,1,0,0,1,0,0
"Lithuania","2025-02-22",0,0,1,0,0,1,0,0
"Lithuania","2025-02-23",0,0,1,0,0,1,0,0
"Lithuania","2025-02-24",0,0,1,0,0,1,0,0
"Lithuania","2025-02-25",0,0,1,0,0,1,0,0
"Lithuania","2025-02-26",0,0,1,0,0,1,0,0
"Lithuania","2025-02-27",0,0,1,0,0,1,0,0
"Lithuania","2025-02-28",0,0,1,0,0,1,0,0
"Lithuania","2025-03-01",0,0,1,0,0,1,0,0
"Lithuania","2025-03-02",0,0,1,0,0,1,0,0
"Lithuania","2025-03-03",0,0,1,0,0,1,0,0
"Luxembourg","2024-01-01",0,0,0,0,0,0,0,0
"Luxembourg","2024-01-02",0,0,0,0,0,0,0,0
"Luxembourg","2024-01-03",0,0,0,0,0,0,0,0
"Luxembourg","2024-01-04",0,0,0,0,0,0,0,0
"Luxembourg","2024-01-05",0,0,0,0,0,0,0,0
"Luxembourg","2024-01-06",0,0,0,0,0,0,0,0
"Luxembourg","2024-01-07",0,0,0,0,0,0,0,0
"Luxembourg","2024-01-08",0,0,0,0,0,0,0,0
"Luxembourg","2024-01-09",0,0,0,0,0,0,0,0
"Luxembourg","2024-01-10",0,0,0,0,0,0,0,0
"Luxembourg","2024-01-11",0,0,0,0,0,0,0,0
"Luxembourg","2024-01-12",0,0,0,0,0,0,0,0
"Luxembourg","2024-01-13",0,0,0,0,0,0,0,0
"Luxembourg","2024-01-14",0,0,0,0,0,0,0,0
"Luxembourg","2024-01-15",0,0,0,0,0,0,0,0
"Luxembourg","2024-01-16",0,0,0,0,0,0,0,0
"Luxembourg","2024-01-17",0,0,0,0,0,0,0,0
"Luxembourg","2024-01-18",0,0,0,0,0,0,0,0
"Luxembourg","2024-01-19",0,0,0,0,0,0,0,0
"Luxembourg","2024-01-20",0,0,0,0,0,0,0,0
"Luxembourg","2024-01-21",0,0,0,0,0,0,0,0
"Luxembourg","2024-01-22",0,0,0,0,0,0,0,0
"Luxembourg","2024-01-23",0,0,0,0,0,0,0,0
"Luxembourg","2024-01-24",0,0,0,0,0,0,0,0
"Luxembourg","2024-01-25",0,0,0,0,0,0,0,0
"Luxembourg","2024-01-26",0,0,0,0,0,0,0,0
"Luxembourg","2024-01-27",0,0,0,0,0,0,0,0
"Luxembourg","2024-01-28",0,0,0,0,0,0,0,0
"Luxembourg","2024-01-29",0,0,0,0,0,0,0,0
"Luxembourg","2024-01-30",0,0,0,0,0,0,0,0
"Luxembourg","2024-01-31",0,0,0,0,0,0,0,0
"Luxembourg","2024-02-01",0,0,0,0,0,0,0,0
"Luxembourg","2024-02-02",0,0,0,0,0,0,0,0
"Luxembourg","2024-02-03",0,0,0,0,0,0,0,0
"Luxembourg","2024-02-04",0,0,0,0,0,0,0,0
"Luxembourg","2024-02-05",0,0,0,0,0,0,0,0
"Luxembourg","2024-02-06",0,0,0,0,0,0,0,0
"Luxembourg","2024-02-07",0,0,0,0,0,0,0,0
"Luxembourg","2024-02-08",0,0,0,0,0,0,0,0
"Luxembourg","2024-02-09",0,0,0,0,0,0,0,0
"Luxembourg","2024-02-10",0,0,0,0,0,0,0,0
"Luxembourg","2024-02-11",0,0,0,0,0,0,0,0
"Luxembourg","2024-02-12",0,0,0,0,0,0,0,0
"Luxembourg","2024-02-13",0,0,0,0,0,0,0,0
"Luxembourg","2024-02-14",0,0,0,0,0,0,0,0
"Luxembourg","2024-02-15",0,0,0,0,0,0,0,0
"Luxembourg","2024-02-16",0,0,0,0,0,0,0,0
"Luxembourg","2024-02-17",0,0,0,0,0,0,0,0
"Luxembourg","2024-02-18",0,0,0,0,0,0,0,0
"Luxembourg","2024-02-19",0,0,0,0,0,0,0,0
"Luxembourg","2024-02-20",0,0,0,0,0,0,0,0
"Luxembourg","2024-02-21",0,0,0,0,0,0,0,0
"Luxembourg","2024-02-22",0,0,0,0,0,0,0,0
"Luxembourg","2024-02-23",0,0,0,0,0,0,0,0
"Luxembourg","2024-02-24",0,0,0,0,0,0,0,0
"Luxembourg","2024-02-25",0,0,0,0,0,0,0,0
"Luxembourg","2024-02-26",0,0,0,0,0,0,0,0
"Luxembourg","2024-02-27",0,0,0,0,0,0,0,0
"Luxembourg","2024-02-28",0,0,0,0,0,0,0,0
"Luxembourg","2024-02-29",0,1,1,0,1,1,0,0
"Luxembourg","2024-03-01",0,0,1,0,0,1,0,0
"Luxembourg","2024-03-02",0,0,1,0,0,1,0,0
"Luxembourg","2024-03-03",0,0,1,0,0,1,0,0
"Luxembourg","2024-03-04",0,0,1,0,0,1,0,0
"Luxembourg","2024-03-05",0,0,1,0,0,1,0,0
"Luxembourg","2024-03-06",0,0,1,0,0,1,0,0
"Luxembourg","2024-03-07",0,0,1,0,0,1,0,0
"Luxembourg","2024-03-08",0,0,1,0,0,1,0,0
"Luxembourg","2024-03-09",0,0,1,0,0,1,0,0
"Luxembourg","2024-03-10",0,0,1,0,0,1,0,0
"Luxembourg","2024-03-11",0,0,1,0,0,1,0,0
"Luxembourg","2024-03-12",0,0,1,0,0,1,0,0
"Luxembourg","2024-03-13",0,0,1,0,0,1,0,0
"Luxembourg","2024-03-14",0,0,1,0,0,1,0,0
"Luxembourg","2024-03-15",0,0,1,0,0,1,0,0
"Luxembourg","2024-03-16",0,0,1,0,0,1,0,0
"Luxembourg","2024-03-17",0,0,1,0,0,1,0,0
"Luxembourg","2024-03-18",0,0,1,0,0,1,0,0
"Luxembourg","2024-03-19",0,0,1,0,0,1,0,0
"Luxembourg","2024-03-20",0,0,1,0,0,1,0,0
"Luxembourg","2024-03-21",0,0,1,0,0,1,0,0
"Luxembourg","2024-03-22",0,0,1,0,0,1,0,0
"Luxembourg","2024-03-23",0,0,1,0,0,1,0,0
"Luxembourg","2024-03-24",0,0,1,0,0,1,0,0
"Luxembourg","2024-03-25",0,0,1,0,0,1,0,0
"Luxembourg","2024-03-26",0,0,1,0,0,1,0,0
"Luxembourg","2024-03-27",0,0,1,0,0,1,0,0
"Luxembourg","2024-03-28",0,0,1,0,0,1,0,0
"Luxembourg","2024-03-29",0,0,1,0,0,1,0,0
"Luxembourg","2024-03-30",0,0,1,0,0,1,0,0
"Luxembourg","2024-03-31",0,0,1,0,0,1,0,0
"Luxembourg","2024-04-01",0,0,1,0,0,1,0,0
"Luxembourg","2024-04-02",0,0,1,0,0,1,0,0
"Luxembourg","2024-04-03",0,0,1,0,0,1,0,0
"Luxembourg","2024-04-04",0,0,1,0,0,1,0,0
"Luxembourg","2024-04-05",0,0,1,0,0,1,0,0
"Luxembourg","2024-04-06",0,0,1,0,0,1,0,0
"Luxembourg","2024-04-07",0,0,1,0,0,1,0,0
"Luxembourg","2024-04-08",0,0,1,0,0,1,0,0
"Luxembourg","2024-04-09",0,0,1,0,0,1,0,0
"Luxembourg","2024-04-10",0,0,1,0,0,1,0,0
"Luxembourg","2024-04-11",0,0,1,0,0,1,0,0
"Luxembourg","2024-04-12",0,0,1,0,0,1,0,0
"Luxembourg","2024-04-13",0,0,1,0,0,1,0,0
"Luxembourg","2024-04-14",0,0,1,0,0,1,0,0
"Luxembourg","2024-04-15",0,0,1,0,0,1,0,0
"Luxembourg","2024-04-16",0,0,1,0,0,1,0,0
"Luxembourg","2024-04-17",0,0,1,0,0,1,0,0
"Luxembourg","2024-04-18",0,0,1,0,0,1,0,0
"Luxembourg","2024-04-19",0,0,1,0,0,1,0,0
"Luxembourg","2024-04-20",0,0,1,0,0,1,0,0
"Luxembourg","2024-04-21",0,0,1,0,0,1,0,0
"Luxembourg","2024-04-22",0,0,1,0,0,1,0,0
"Luxembourg","2024-04-23",0,0,1,0,0,1,0,0
"Luxembourg","2024-04-24",0,0,1,0,0,1,0,0
"Luxembourg","2024-04-25",0,0,1,0,0,1,0,0
"Luxembourg","2024-04-26",0,0,1,0,0,1,0,0
"Luxembourg","2024-04-27",0,0,1,0,0,1,0,0
"Luxembourg","2024-04-28",0,0,1,0,0,1,0,0
"Luxembourg","2024-04-29",0,0,1,0,0,1,0,0
"Luxembourg","2024-04-30",0,0,1,0,0,1,0,0
"Luxembourg","2024-05-01",0,0,1,0,0,1,0,0
"Luxembourg","2024-05-02",0,0,1,0,0,1,0,0
"Luxembourg","2024-05-03",0,0,1,0,0,1,0,0
"Luxembourg","2024-05-04",0,0,1,0,0,1,0,0
"Luxembourg","2024-05-05",0,0,1,0,0,1,0,0
"Luxembourg","2024-05-06",0,0,1,0,0,1,0,0
"Luxembourg","2024-05-07",0,0,1,0,0,1,0,0
"Luxembourg","2024-05-08",0,0,1,0,0,1,0,0
"Luxembourg","2024-05-09",0,0,1,0,0,1,0,0
"Luxembourg","2024-05-10",0,0,1,0,0,1,0,0
"Luxembourg","2024-05-11",0,0,1,0,0,1,0,0
"Luxembourg","2024-05-12",0,0,1,0,0,1,0,0
"Luxembourg","2024-05-13",0,0,1,0,0,1,0,0
"Luxembourg","2024-05-14",0,0,1,0,0,1,0,0
"Luxembourg","2024-05-15",0,0,1,0,0,1,0,0
"Luxembourg","2024-05-16",0,0,1,0,0,1,0,0
"Luxembourg","2024-05-17",0,0,1,0,0,1,0,0
"Luxembourg","2024-05-18",0,0,1,0,0,1,0,0
"Luxembourg","2024-05-19",0,0,1,0,0,1,0,0
"Luxembourg","2024-05-20",0,0,1,0,0,1,0,0
"Luxembourg","2024-05-21",0,0,1,0,0,1,0,0
"Luxembourg","2024-05-22",0,0,1,0,0,1,0,0
"Luxembourg","2024-05-23",0,0,1,0,0,1,0,0
"Luxembourg","2024-05-24",0,0,1,0,0,1,0,0
"Luxembourg","2024-05-25",0,0,1,0,0,1,0,0
"Luxembourg","2024-05-26",0,0,1,0,0,1,0,0
"Luxembourg","2024-05-27",0,0,1,0,0,1,0,0
"Luxembourg","2024-05-28",0,0,1,0,0,1,0,0
"Luxembourg","2024-05-29",0,0,1,0,0,1,0,0
"Luxembourg","2024-05-30",0,0,1,0,0,1,0,0
"Luxembourg","2024-05-31",0,0,1,0,0,1,0,0
"Luxembourg","2024-06-01",0,0,1,0,0,1,0,0
"Luxembourg","2024-06-02",0,0,1,0,0,1,0,0
"Luxembourg","2024-06-03",0,0,1,0,0,1,0,0
"Luxembourg","2024-06-04",0,0,1,0,0,1,0,0
"Luxembourg","2024-06-05",0,0,1,0,0,1,0,0
"Luxembourg","2024-06-06",0,0,1,0,0,1,0,0
"Luxembourg","2024-06-07",0,0,1,0,0,1,0,0
"Luxembourg","2024-06-08",0,0,1,0,0,1,0,0
"Luxembourg","2024-06-09",0,0,1,0,0,1,0,0
"Luxembourg","2024-06-10",0,0,1,0,0,1,0,0
"Luxembourg","2024-06-11",0,0,1,0,0,1,0,0
"Luxembourg","2024-06-12",0,0,1,0,0,1,0,0
"Luxembourg","2024-06-13",0,0,1,0,0,1,0,0
"Luxembourg","2024-06-14",0,0,1,0,0,1,0,0
"Luxembourg","2024-06-15",0,0,1,0,0,1,0,0
"Luxembourg","2024-06-16",0,0,1,0,0,1,0,0
"Luxembourg","2024-06-17",0,0,1,0,0,1,0,0
"Luxembourg","2024-06-18",0,0,1,0,0,1,0,0
"Luxembourg","2024-06-19",0,0,1,0,0,1,0,0
"Luxembourg","2024-06-20",0,0,1,0,0,1,0,0
"Luxembourg","2024-06-21",0,0,1,0,0,1,0,0
"Luxembourg","2024-06-22",0,0,1,0,0,1,0,0
"Luxembourg","2024-06-23",0,0,1,0,0,1,0,0
"Luxembourg","2024-06-24",0,0,1,0,0,1,0,0
"Luxembourg","2024-06-25",0,0,1,0,0,1,0,0
"Luxembourg","2024-06-26",0,0,1,0,0,1,0,0
"Luxembourg","2024-06-27",0,0,1,0,0,1,0,0
"Luxembourg","2024-06-28",0,0,1,0,0,1,0,0
"Luxembourg","2024-06-29",0,0,1,0,0,1,0,0
"Luxembourg","2024-06-30",0,0,1,0,0,1,0,0
"Luxembourg","2024-07-01",0,0,1,0,1,2,0,0
"Luxembourg","2024-07-02",0,0,1,0,0,2,0,0
"Luxembourg","2024-07-03",0,0,1,0,0,2,0,0
"Luxembourg","2024-07-04",0,0,1,0,0,2,0,0
"Luxembourg","2024-07-05",0,0,1,0,0,2,0,0
"Luxembourg","2024-07-06",0,0,1,0,0,2,0,0
"Luxembourg","2024-07-07",0,0,1,0,0,2,0,0
"Luxembourg","2024-07-08",0,0,1,0,0,2,0,0
"Luxembourg","2024-07-09",0,0,1,0,0,2,0,0
"Luxembourg","2024-07-10",0,0,1,0,0,2,0,0
"Luxembourg","2024-07-11",0,0,1,0,0,2,0,0
"Luxembourg","2024-07-12",0,0,1,0,0,2,0,0
"Luxembourg","2024-07-13",0,0,1,0,0,2,0,0
"Luxembourg","2024-07-14",0,0,1,0,0,2,0,0
"Luxembourg","2024-07-15",0,0,1,0,0,2,0,0
"Luxembourg","2024-07-16",0,0,1,0,0,2,0,0
"Luxembourg","2024-07-17",0,0,1,0,0,2,0,0
"Luxembourg","2024-07-18",0,0,1,0,0,2,0,0
"Luxembourg","2024-07-19",0,0,1,0,0,2,0,0
"Luxembourg","2024-07-20",0,0,1,0,0,2,0,0
"Luxembourg","2024-07-21",0,0,1,0,0,2,0,0
"Luxembourg","2024-07-22",0,0,1,0,0,2,0,0
"Luxembourg","2024-07-23",0,0,1,0,0,2,0,0
"Luxembourg","2024-07-24",0,0,1,0,0,2,0,0
"Luxembourg","2024-07-25",0,0,1,0,0,2,0,0
"Luxembourg","2024-07-26",0,0,1,0,0,2,0,0
"Luxembourg","2024-07-27",0,0,1,0,0,2,0,0
"Luxembourg","2024-07-28",0,0,1,0,0,2,0,0
"Luxembourg","2024-07-29",0,0,1,0,0,2,0,0
"Luxembourg","2024-07-30",0,0,1,0,0,2,0,0
"Luxembourg","2024-07-31",0,0,1,0,0,2,0,0
"Luxembourg","2024-08-01",0,0,1,0,0,2,0,0
"Luxembourg","2024-08-02",0,0,1,0,0,2,0,0
"Luxembourg","2024-08-03",0,0,1,0,0,2,0,0
"Luxembourg","2024-08-04",0,0,1,0,0,2,0,0
"Luxembourg","2024-08-05",0,0,1,0,0,2,0,0
"Luxembourg","2024-08-06",0,0,1,0,0,2,0,0
"Luxembourg","2024-08-07",0,0,1,0,0,2,0,0
"Luxembourg","2024-08-08",0,0,1,0,0,2,0,0
"Luxembourg","2024-08-09",0,0,1,0,0,2,0,0
"Luxembourg","2024-08-10",0,0,1,0,0,2,0,0
"Luxembourg","2024-08-11",0,0,1,0,0,2,0,0
"Luxembourg","2024-08-12",0,0,1,0,0,2,0,0
"Luxembourg","2024-08-13",0,0,1,0,0,2,0,0
"Luxembourg","2024-08-14",0,0,1,0,0,2,0,0
"Luxembourg","2024-08-15",0,0,1,0,0,2,0,0
"Luxembourg","2024-08-16",0,0,1,0,0,2,0,0
"Luxembourg","2024-08-17",0,0,1,0,0,2,0,0
"Luxembourg","2024-08-18",0,0,1,0,0,2,0,0
"Luxembourg","2024-08-19",0,0,1,0,0,2,0,0
"Luxembourg","2024-08-20",0,0,1,0,0,2,0,0
"Luxembourg","2024-08-21",0,0,1,0,0,2,0,0
"Luxembourg","2024-08-22",0,0,1,0,0,2,0,0
"Luxembourg","2024-08-23",0,0,1,0,0,2,0,0
"Luxembourg","2024-08-24",0,0,1,0,0,2,0,0
"Luxembourg","2024-08-25",0,0,1,0,0,2,0,0
"Luxembourg","2024-08-26",0,0,1,0,0,2,0,0
"Luxembourg","2024-08-27",0,0,1,0,0,2,0,0
"Luxembourg","2024-08-28",0,0,1,0,0,2,0,0
"Luxembourg","2024-08-29",0,0,1,0,0,2,0,0
"Luxembourg","2024-08-30",0,0,1,0,0,2,0,0
"Luxembourg","2024-08-31",0,0,1,0,0,2,0,0
"Luxembourg","2024-09-01",0,0,1,0,0,2,0,0
"Luxembourg","2024-09-02",0,0,1,0,0,2,0,0
"Luxembourg","2024-09-03",0,0,1,0,0,2,0,0
"Luxembourg","2024-09-04",0,0,1,0,0,2,0,0
"Luxembourg","2024-09-05",0,0,1,0,0,2,0,0
"Luxembourg","2024-09-06",0,0,1,0,0,2,0,0
"Luxembourg","2024-09-07",0,0,1,0,0,2,0,0
"Luxembourg","2024-09-08",0,0,1,0,0,2,0,0
"Luxembourg","2024-09-09",0,0,1,0,0,2,0,0
"Luxembourg","2024-09-10",0,0,1,0,0,2,0,0
"Luxembourg","2024-09-11",0,0,1,0,0,2,0,0
"Luxembourg","2024-09-12",0,0,1,0,0,2,0,0
"Luxembourg","2024-09-13",0,0,1,0,0,2,0,0
"Luxembourg","2024-09-14",0,0,1,0,0,2,0,0
"Luxembourg","2024-09-15",0,0,1,0,0,2,0,0
"Luxembourg","2024-09-16",0,0,1,0,0,2,0,0
"Luxembourg","2024-09-17",0,0,1,0,0,2,0,0
"Luxembourg","2024-09-18",0,0,1,0,0,2,0,0
"Luxembourg","2024-09-19",0,0,1,0,0,2,0,0
"Luxembourg","2024-09-20",0,0,1,0,0,2,0,0
"Luxembourg","2024-09-21",0,0,1,0,0,2,0,0
"Luxembourg","2024-09-22",0,0,1,0,0,2,0,0
"Luxembourg","2024-09-23",0,0,1,0,0,2,0,0
"Luxembourg","2024-09-24",0,0,1,0,0,2,0,0
"Luxembourg","2024-09-25",0,0,1,0,0,2,0,0
"Luxembourg","2024-09-26",0,0,1,0,0,2,0,0
"Luxembourg","2024-09-27",0,0,1,0,0,2,0,0
"Luxembourg","2024-09-28",0,0,1,0,0,2,0,0
"Luxembourg","2024-09-29",0,0,1,0,0,2,0,0
"Luxembourg","2024-09-30",0,0,1,0,0,2,0,0
"Luxembourg","2024-10-01",0,0,1,0,0,2,0,0
"Luxembourg","2024-10-02",0,0,1,0,0,2,0,0
"Luxembourg","2024-10-03",0,0,1,0,0,2,0,0
"Luxembourg","2024-10-04",0,0,1,0,0,2,0,0
"Luxembourg","2024-10-05",0,0,1,0,0,2,0,0
"Luxembourg","2024-10-06",0,0,1,0,0,2,0,0
"Luxembourg","2024-10-07",0,0,1,0,0,2,0,0
"Luxembourg","2024-10-08",0,0,1,0,0,2,0,0
"Luxembourg","2024-10-09",0,0,1,0,0,2,0,0
"Luxembourg","2024-10-10",0,0,1,0,0,2,0,0
"Luxembourg","2024-10-11",0,0,1,0,0,2,0,0
"Luxembourg","2024-10-12",0,0,1,0,0,2,0,0
"Luxembourg","2024-10-13",0,0,1,0,0,2,0,0
"Luxembourg","2024-10-14",0,0,1,0,0,2,0,0
"Luxembourg","2024-10-15",0,0,1,0,0,2,0,0
"Luxembourg","2024-10-16",0,0,1,0,0,2,0,0
"Luxembourg","2024-10-17",0,0,1,0,0,2,0,0
"Luxembourg","2024-10-18",0,0,1,0,0,2,0,0
"Luxembourg","2024-10-19",0,0,1,0,0,2,0,0
"Luxembourg","2024-10-20",0,0,1,0,0,2,0,0
"Luxembourg","2024-10-21",0,0,1,0,0,2,0,0
"Luxembourg","2024-10-22",0,0,1,0,0,2,0,0
"Luxembourg","2024-10-23",0,0,1,0,0,2,0,0
"Luxembourg","2024-10-24",0,0,1,0,0,2,0,0
"Luxembourg","2024-10-25",0,0,1,0,0,2,0,0
"Luxembourg","2024-10-26",0,0,1,0,0,2,0,0
"Luxembourg","2024-10-27",0,0,1,0,0,2,0,0
"Luxembourg","2024-10-28",0,0,1,0,0,2,0,0
"Luxembourg","2024-10-29",0,0,1,0,0,2,0,0
"Luxembourg","2024-10-30",0,0,1,0,0,2,0,0
"Luxembourg","2024-10-31",0,1,2,0,0,2,0,0
"Luxembourg","2024-11-01",0,0,2,0,0,2,0,0
"Luxembourg","2024-11-02",0,0,2,0,0,2,0,0
"Luxembourg","2024-11-03",0,0,2,0,0,2,0,0
"Luxembourg","2024-11-04",0,0,2,0,0,2,0,0
"Luxembourg","2024-11-05",0,0,2,0,0,2,0,0
"Luxembourg","2024-11-06",0,0,2,0,0,2,0,0
"Luxembourg","2024-11-07",0,0,2,0,0,2,0,0
"Luxembourg","2024-11-08",0,0,2,0,0,2,0,0
"Luxembourg","2024-11-09",0,0,2,0,0,2,0,0
"Luxembourg","2024-11-10",0,0,2,0,0,2,0,0
"Luxembourg","2024-11-11",0,0,2,0,0,2,0,0
"Luxembourg","2024-11-12",0,0,2,0,0,2,0,0
"Luxembourg","2024-11-13",0,0,2,0,0,2,0,0
"Luxembourg","2024-11-14",0,0,2,0,0,2,0,0
"Luxembourg","2024-11-15",0,0,2,0,0,2,0,0
"Luxembourg","2024-11-16",0,0,2,0,0,2,0,0
"Luxembourg","2024-11-17",0,0,2,0,0,2,0,0
"Luxembourg","2024-11-18",0,0,2,0,0,2,0,0
"Luxembourg","2024-11-19",0,0,2,0,0,2,0,0
"Luxembourg","2024-11-20",0,0,2,0,0,2,0,0
"Luxembourg","2024-11-21",0,0,2,0,0,2,0,0
"Luxembourg","2024-11-22",0,0,2,0,0,2,0,0
"Luxembourg","2024-11-23",0,0,2,0,0,2,0,0
"Luxembourg","2024-11-24",0,0,2,0,0,2,0,0
"Luxembourg","2024-11-25",0,0,2,0,0,2,0,0
"Luxembourg","2024-11-26",0,0,2,0,0,2,0,0
"Luxembourg","2024-11-27",0,0,2,0,0,2,0,0
"Luxembourg","2024-11-28",0,0,2,0,0,2,0,0
"Luxembourg","2024-11-29",0,0,2,0,0,2,0,0
"Luxembourg","2024-11-30",0,0,2,0,0,2,0,0
"Luxembourg","2024-12-01",0,0,2,0,0,2,0,0
"Luxembourg","2024-12-02",0,0,2,0,0,2,0,0
"Luxembourg","2024-12-03",0,0,2,0,0,2,0,0
"Luxembourg","2024-12-04",0,0,2,0,0,2,0,0
"Luxembourg","2024-12-05",0,0,2,0,0,2,0,0
"Luxembourg","2024-12-06",0,0,2,0,0,2,0,0
"Luxembourg","2024-12-07",0,0,2,0,0,2,0,0
"Luxembourg","2024-12-08",0,0,2,0,0,2,0,0
"Luxembourg","2024-12-09",0,0,2,0,0,2,0,0
"Luxembourg","2024-12-10",0,0,2,0,0,2,0,0
"Luxembourg","2024-12-11",0,0,2,0,0,2,0,0
"Luxembourg","2024-12-12",0,0,2,0,0,2,0,0
"Luxembourg","2024-12-13",0,0,2,0,0,2,0,0
"Luxembourg","2024-12-14",0,0,2,0,0,2,0,0
"Luxembourg","2024-12-15",0,0,2,0,0,2,0,0
"Luxembourg","2024-12-16",0,0,2,0,0,2,0,0
"Luxembourg","2024-12-17",0,0,2,0,0,2,0,0
"Luxembourg","2024-12-18",0,0,2,0,0,2,0,0
"Luxembourg","2024-12-19",0,0,2,0,0,2,0,0
"Luxembourg","2024-12-20",0,0,2,0,0,2,0,0
"Luxembourg","2024-12-21",0,0,2,0,0,2,0,0
"Luxembourg","2024-12-22",0,0,2,0,0,2,0,0
"Luxembourg","2024-12-23",0,0,2,0,0,2,0,0
"Luxembourg","2024-12-24",0,0,2,0,0,2,0,0
"Luxembourg","2024-12-25",0,0,2,0,0,2,0,0
"Luxembourg","2024-12-26",0,0,2,0,0,2,0,0
"Luxembourg","2024-12-27",0,0,2,0,0,2,0,0
"Luxembourg","2024-12-28",0,0,2,0,0,2,0,0
"Luxembourg","2024-12-29",0,0,2,0,0,2,0,0
"Luxembourg","2024-12-30",0,0,2,0,0,2,0,0
"Luxembourg","2024-12-31",0,0,2,0,0,2,0,0
"Luxembourg","2025-01-01",0,0,2,0,0,2,0,0
"Luxembourg","2025-01-02",0,0,2,0,0,2,0,0
"Luxembourg","2025-01-03",0,0,2,0,0,2,0,0
"Luxembourg","2025-01-04",0,0,2,0,0,2,0,0
"Luxembourg","2025-01-05",0,0,2,0,0,2,0,0
"Luxembourg","2025-01-06",0,0,2,0,0,2,0,0
"Luxembourg","2025-01-07",0,0,2,0,0,2,0,0
"Luxembourg","2025-01-08",0,0,2,0,0,2,0,0
"Luxembourg","2025-01-09",0,0,2,0,0,2,0,0
"Luxembourg","2025-01-10",0,0,2,0,0,2,0,0
"Luxembourg","2025-01-11",0,0,2,0,0,2,0,0
"Luxembourg","2025-01-12",0,0,2,0,0,2,0,0
"Luxembourg","2025-01-13",0,0,2,0,0,2,0,0
"Luxembourg","2025-01-14",0,0,2,0,0,2,0,0
"Luxembourg","2025-01-15",0,0,2,0,0,2,0,0
"Luxembourg","2025-01-16",0,0,2,0,0,2,0,0
"Luxembourg","2025-01-17",0,0,2,0,0,2,0,0
"Luxembourg","2025-01-18",0,0,2,0,0,2,0,0
"Luxembourg","2025-01-19",0,0,2,0,0,2,0,0
"Luxembourg","2025-01-20",0,0,2,0,0,2,0,0
"Luxembourg","2025-01-21",0,0,2,0,0,2,0,0
"Luxembourg","2025-01-22",0,0,2,0,0,2,0,0
"Luxembourg","2025-01-23",0,0,2,0,0,2,0,0
"Luxembourg","2025-01-24",0,0,2,0,0,2,0,0
"Luxembourg","2025-01-25",0,0,2,0,0,2,0,0
"Luxembourg","2025-01-26",0,0,2,0,0,2,0,0
"Luxembourg","2025-01-27",0,0,2,0,0,2,0,0
"Luxembourg","2025-01-28",0,0,2,0,0,2,0,0
"Luxembourg","2025-01-29",0,0,2,0,0,2,0,0
"Luxembourg","2025-01-30",0,0,2,0,0,2,0,0
"Luxembourg","2025-01-31",0,0,2,0,0,2,0,0
"Luxembourg","2025-02-01",0,0,2,0,0,2,0,0
"Luxembourg","2025-02-02",0,0,2,0,0,2,0,0
"Luxembourg","2025-02-03",0,0,2,0,0,2,0,0
"Luxembourg","2025-02-04",0,0,2,0,0,2,0,0
"Luxembourg","2025-02-05",0,0,2,0,0,2,0,0
"Luxembourg","2025-02-06",0,0,2,0,0,2,0,0
"Luxembourg","2025-02-07",0,0,2,0,0,2,0,0
"Luxembourg","2025-02-08",0,0,2,0,0,2,0,0
"Luxembourg","2025-02-09",0,0,2,0,0,2,0,0
"Luxembourg","2025-02-10",0,0,2,0,0,2,0,0
"Luxembourg","2025-02-11",0,0,2,0,0,2,0,0
"Luxembourg","2025-02-12",0,0,2,0,0,2,0,0
"Luxembourg","2025-02-13",0,0,2,0,0,2,0,0
"Luxembourg","2025-02-14",0,0,2,0,0,2,0,0
"Luxembourg","2025-02-15",0,0,2,0,0,2,0,0
"Luxembourg","2025-02-16",0,0,2,0,0,2,0,0
"Luxembourg","2025-02-17",0,0,2,0,0,2,0,0
"Luxembourg","2025-02-18",0,0,2,0,0,2,0,0
"Luxembourg","2025-02-19",0,0,2,0,0,2,0,0
"Luxembourg","2025-02-20",0,0,2,0,0,2,0,0
"Luxembourg","2025-02-21",0,0,2,0,0,2,0,0
"Luxembourg","2025-02-22",0,0,2,0,0,2,0,0
"Luxembourg","2025-02-23",0,0,2,0,0,2,0,0
"Luxembourg","2025-02-24",0,0,2,0,0,2,0,0
"Luxembourg","2025-02-25",0,0,2,0,0,2,0,0
"Luxembourg","2025-02-26",0,0,2,0,0,2,0,0
"Luxembourg","2025-02-27",0,0,2,0,0,2,0,0
"Luxembourg","2025-02-28",0,0,2,0,0,2,0,0
"Luxembourg","2025-03-01",0,0,2,0,0,2,0,0
"Luxembourg","2025-03-02",0,0,2,0,0,2,0,0
"Luxembourg","2025-03-03",0,0,2,0,0,2,0,0
"Malaysia","2024-01-01",0,0,0,0,0,0,0,0
"Malaysia","2024-01-02",0,0,0,0,0,0,0,0
"Malaysia","2024-01-03",0,0,0,0,0,0,0,0
"Malaysia","2024-01-04",0,0,0,0,0,0,0,0
"Malaysia","2024-01-05",0,0,0,0,0,0,0,0
"Malaysia","2024-01-06",0,0,0,0,0,0,0,0
"Malaysia","2024-01-07",0,0,0,0,0,0,0,0
"Malaysia","2024-01-08",0,0,0,0,0,0,0,0
"Malaysia","2024-01-09",0,0,0,0,0,0,0,0
"Malaysia","2024-01-10",0,0,0,0,0,0,0,0
"Malaysia","2024-01-11",0,0,0,0,0,0,0,0
"Malaysia","2024-01-12",0,0,0,0,0,0,0,0
"Malaysia","2024-01-13",0,0,0,0,0,0,0,0
"Malaysia","2024-01-14",0,0,0,0,0,0,0,0
"Malaysia","2024-01-15",0,0,0,0,0,0,0,0
"Malaysia","2024-01-16",0,0,0,0,0,0,0,0
"Malaysia","2024-01-17",0,0,0,0,0,0,0,0
"Malaysia","2024-01-18",0,0,0,0,0,0,0,0
"Malaysia","2024-01-19",0,0,0,0,0,0,0,0
"Malaysia","2024-01-20",0,0,0,0,0,0,0,0
"Malaysia","2024-01-21",0,0,0,0,0,0,0,0
"Malaysia","2024-01-22",0,0,0,0,0,0,0,0
"Malaysia","2024-01-23",0,0,0,0,0,0,0,0
"Malaysia","2024-01-24",0,0,0,0,0,0,0,0
"Malaysia","2024-01-25",0,0,0,0,0,0,0,0
"Malaysia","2024-01-26",0,0,0,0,0,0,0,0
"Malaysia","2024-01-27",0,0,0,0,0,0,0,0
"Malaysia","2024-01-28",0,0,0,0,0,0,0,0
"Malaysia","2024-01-29",0,0,0,0,0,0,0,0
"Malaysia","2024-01-30",0,0,0,0,0,0,0,0
"Malaysia","2024-01-31",0,0,0,0,0,0,0,0
"Malaysia","2024-02-01",0,0,0,0,0,0,0,0
"Malaysia","2024-02-02",0,0,0,0,0,0,0,0
"Malaysia","2024-02-03",0,0,0,0,0,0,0,0
"Malaysia","2024-02-04",0,0,0,0,0,0,0,0
"Malaysia","2024-02-05",0,0,0,0,0,0,0,0
"Malaysia","2024-02-06",0,0,0,0,0,0,0,0
"Malaysia","2024-02-07",0,0,0,0,0,0,0,0
"Malaysia","2024-02-08",0,0,0,0,0,0,0,0
"Malaysia","2024-02-09",0,0,0,0,0,0,0,0
"Malaysia","2024-02-10",0,0,0,0,0,0,0,0
"Malaysia","2024-02-11",0,0,0,0,0,0,0,0
"Malaysia","2024-02-12",0,0,0,0,0,0,0,0
"Malaysia","2024-02-13",0,0,0,0,0,0,0,0
"Malaysia","2024-02-14",0,0,0,0,0,0,0,0
"Malaysia","2024-02-15",0,0,0,0,0,0,0,0
"Malaysia","2024-02-16",0,0,0,0,0,0,0,0
"Malaysia","2024-02-17",0,0,0,0,0,0,0,0
"Malaysia","2024-02-18",0,0,0,0,0,0,0,0
"Malaysia","2024-02-19",0,0,0,0,0,0,0,0
"Malaysia","2024-02-20",0,0,0,0,0,0,0,0
"Malaysia","2024-02-21",0,0,0,0,0,0,0,0
"Malaysia","2024-02-22",0,0,0,0,0,0,0,0
"Malaysia","2024-02-23",0,0,0,0,0,0,0,0
"Malaysia","2024-02-24",0,0,0,0,0,0,0,0
"Malaysia","2024-02-25",0,0,0,0,0,0,0,0
"Malaysia","2024-02-26",0,0,0,0,0,0,0,0
"Malaysia","2024-02-27",0,0,0,0,0,0,0,0
"Malaysia","2024-02-28",0,0,0,0,0,0,0,0
"Malaysia","2024-02-29",0,0,0,0,0,0,0,0
"Malaysia","2024-03-01",0,0,0,0,0,0,0,0
"Malaysia","2024-03-02",0,0,0,0,0,0,0,0
"Malaysia","2024-03-03",0,0,0,0,0,0,0,0
"Malaysia","2024-03-04",0,0,0,0,0,0,0,0
"Malaysia","2024-03-05",0,0,0,0,0,0,0,0
"Malaysia","2024-03-06",0,0,0,0,0,0,0,0
"Malaysia","2024-03-07",0,0,0,0,0,0,0,0
"Malaysia","2024-03-08",0,0,0,0,0,0,0,0
"Malaysia","2024-03-09",0,0,0,0,0,0,0,0
"Malaysia","2024-03-10",0,0,0,0,0,0,0,0
"Malaysia","2024-03-11",0,0,0,0,0,0,0,0
"Malaysia","2024-03-12",0,0,0,0,0,0,0,0
"Malaysia","2024-03-13",0,0,0,0,0,0,0,0
"Malaysia","2024-03-14",0,0,0,0,0,0,0,0
"Malaysia","2024-03-15",0,0,0,0,0,0,0,0
"Malaysia","2024-03-16",0,0,0,0,0,0,0,0
"Malaysia","2024-03-17",0,0,0,0,0,0,0,0
"Malaysia","2024-03-18",0,0,0,0,0,0,0,0
"Malaysia","2024-03-19",0,0,0,0,0,0,0,0
"Malaysia","2024-03-20",0,0,0,0,0,0,0,0
"Malaysia","2024-03-21",0,0,0,0,0,0,0,0
"Malaysia","2024-03-22",0,0,0,0,0,0,0,0
"Malaysia","2024-03-23",0,0,0,0,0,0,0,0
"Malaysia","2024-03-24",0,0,0,0,0,0,0,0
"Malaysia","2024-03-25",0,0,0,0,0,0,0,0
"Malaysia","2024-03-26",0,0,0,0,0,0,0,0
"Malaysia","2024-03-27",0,0,0,0,0,0,0,0
"Malaysia","2024-03-28",0,0,0,0,0,0,0,0
"Malaysia","2024-03-29",0,0,0,0,0,0,0,0
"Malaysia","2024-03-30",0,0,0,0,0,0,0,0
"Malaysia","2024-03-31",0,0,0,0,0,0,0,0
"Malaysia","2024-04-01",0,0,0,0,0,0,0,0
"Malaysia","2024-04-02",0,0,0,0,0,0,0,0
"Malaysia","2024-04-03",0,0,0,0,0,0,0,0
"Malaysia","2024-04-04",0,0,0,0,0,0,0,0
"Malaysia","2024-04-05",0,0,0,0,0,0,0,0
"Malaysia","2024-04-06",0,0,0,0,0,0,0,0
"Malaysia","2024-04-07",0,0,0,0,0,0,0,0
"Malaysia","2024-04-08",0,0,0,0,0,0,0,0
"Malaysia","2024-04-09",0,0,0,0,0,0,0,0
"Malaysia","2024-04-10",0,0,0,0,0,0,0,0
"Malaysia","2024-04-11",0,0,0,0,0,0,0,0
"Malaysia","2024-04-12",0,0,0,0,0,0,0,0
"Malaysia","2024-04-13",0,0,0,0,0,0,0,0
"Malaysia","2024-04-14",0,0,0,0,0,0,0,0
"Malaysia","2024-04-15",0,0,0,0,0,0,0,0
"Malaysia","2024-04-16",0,0,0,0,0,0,0,0
"Malaysia","2024-04-17",0,0,0,0,0,0,0,0
"Malaysia","2024-04-18",0,0,0,0,0,0,0,0
"Malaysia","2024-04-19",0,0,0,0,0,0,0,0
"Malaysia","2024-04-20",0,0,0,0,0,0,0,0
"Malaysia","2024-04-21",0,0,0,0,0,0,0,0
"Malaysia","2024-04-22",0,0,0,0,0,0,0,0
"Malaysia","2024-04-23",0,0,0,0,0,0,0,0
"Malaysia","2024-04-24",0,0,0,0,0,0,0,0
"Malaysia","2024-04-25",0,0,0,0,0,0,0,0
"Malaysia","2024-04-26",0,0,0,0,0,0,0,0
"Malaysia","2024-04-27",0,0,0,0,0,0,0,0
"Malaysia","2024-04-28",0,0,0,0,0,0,0,0
"Malaysia","2024-04-29",0,0,0,0,0,0,0,0
"Malaysia","2024-04-30",0,0,0,0,0,0,0,0
"Malaysia","2024-05-01",0,0,0,0,0,0,0,0
"Malaysia","2024-05-02",0,0,0,0,0,0,0,0
"Malaysia","2024-05-03",0,0,0,0,0,0,0,0
"Malaysia","2024-05-04",0,0,0,0,0,0,0,0
"Malaysia","2024-05-05",0,0,0,0,0,0,0,0
"Malaysia","2024-05-06",0,0,0,0,0,0,0,0
"Malaysia","2024-05-07",0,0,0,0,0,0,0,0
"Malaysia","2024-05-08",0,0,0,0,0,0,0,0
"Malaysia","2024-05-09",0,0,0,0,0,0,0,0
"Malaysia","2024-05-10",0,0,0,0,0,0,0,0
"Malaysia","2024-05-11",0,0,0,0,0,0,0,0
"Malaysia","2024-05-12",0,0,0,0,0,0,0,0
"Malaysia","2024-05-13",0,0,0,0,0,0,0,0
"Malaysia","2024-05-14",0,0,0,0,0,0,0,0
"Malaysia","2024-05-15",0,0,0,0,0,0,0,0
"Malaysia","2024-05-16",0,0,0,0,0,0,0,0
"Malaysia","2024-05-17",0,0,0,0,0,0,0,0
"Malaysia","2024-05-18",0,0,0,0,0,0,0,0
"Malaysia","2024-05-19",0,0,0,0,0,0,0,0
"Malaysia","2024-05-20",0,0,0,0,0,0,0,0
"Malaysia","2024-05-21",0,0,0,0,0,0,0,0
"Malaysia","2024-05-22",0,0,0,0,0,0,0,0
"Malaysia","2024-05-23",0,0,0,0,0,0,0,0
"Malaysia","2024-05-24",0,0,0,0,0,0,0,0
"Malaysia","2024-05-25",0,0,0,0,0,0,0,0
"Malaysia","2024-05-26",0,0,0,0,0,0,0,0
"Malaysia","2024-05-27",0,0,0,0,0,0,0,0
"Malaysia","2024-05-28",0,0,0,0,0,0,0,0
"Malaysia","2024-05-29",0,0,0,0,0,0,0,0
"Malaysia","2024-05-30",0,0,0,0,0,0,0,0
"Malaysia","2024-05-31",0,0,0,0,0,0,0,0
"Malaysia","2024-06-01",0,0,0,0,0,0,0,0
"Malaysia","2024-06-02",0,0,0,0,0,0,0,0
"Malaysia","2024-06-03",0,0,0,0,0,0,0,0
"Malaysia","2024-06-04",0,0,0,0,0,0,0,0
"Malaysia","2024-06-05",0,0,0,0,0,0,0,0
"Malaysia","2024-06-06",0,0,0,0,0,0,0,0
"Malaysia","2024-06-07",0,0,0,0,0,0,0,0
"Malaysia","2024-06-08",0,0,0,0,0,0,0,0
"Malaysia","2024-06-09",0,0,0,0,0,0,0,0
"Malaysia","2024-06-10",0,0,0,0,0,0,0,0
"Malaysia","2024-06-11",0,0,0,0,0,0,0,0
"Malaysia","2024-06-12",0,0,0,0,0,0,0,0
"Malaysia","2024-06-13",0,0,0,0,0,0,0,0
"Malaysia","2024-06-14",0,0,0,0,0,0,0,0
"Malaysia","2024-06-15",0,0,0,0,0,0,0,0
"Malaysia","2024-06-16",0,0,0,0,0,0,0,0
"Malaysia","2024-06-17",0,0,0,0,0,0,0,0
"Malaysia","2024-06-18",0,0,0,0,0,0,0,0
"Malaysia","2024-06-19",0,0,0,0,0,0,0,0
"Malaysia","2024-06-20",0,0,0,0,0,0,0,0
"Malaysia","2024-06-21",0,0,0,0,0,0,0,0
"Malaysia","2024-06-22",0,0,0,0,0,0,0,0
"Malaysia","2024-06-23",0,0,0,0,0,0,0,0
"Malaysia","2024-06-24",0,0,0,0,0,0,0,0
"Malaysia","2024-06-25",0,0,0,0,0,0,0,0
"Malaysia","2024-06-26",0,0,0,0,0,0,0,0
"Malaysia","2024-06-27",0,0,0,0,0,0,0,0
"Malaysia","2024-06-28",0,0,0,0,0,0,0,0
"Malaysia","2024-06-29",0,0,0,0,0,0,0,0
"Malaysia","2024-06-30",0,0,0,0,0,0,0,0
"Malaysia","2024-07-01",0,0,0,0,0,0,0,0
"Malaysia","2024-07-02",0,0,0,0,0,0,0,0
"Malaysia","2024-07-03",0,0,0,0,0,0,0,0
"Malaysia","2024-07-04",0,0,0,0,0,0,0,0
"Malaysia","2024-07-05",0,0,0,0,0,0,0,0
"Malaysia","2024-07-06",0,0,0,0,0,0,0,0
"Malaysia","2024-07-07",0,0,0,0,0,0,0,0
"Malaysia","2024-07-08",0,0,0,0,0,0,0,0
"Malaysia","2024-07-09",0,0,0,0,0,0,0,0
"Malaysia","2024-07-10",0,0,0,0,0,0,0,0
"Malaysia","2024-07-11",0,0,0,0,0,0,0,0
"Malaysia","2024-07-12",0,0,0,0,0,0,0,0
"Malaysia","2024-07-13",0,0,0,0,0,0,0,0
"Malaysia","2024-07-14",0,0,0,0,0,0,0,0
"Malaysia","2024-07-15",0,0,0,0,0,0,0,0
"Malaysia","2024-07-16",0,0,0,0,0,0,0,0
"Malaysia","2024-07-17",0,0,0,0,0,0,0,0
"Malaysia","2024-07-18",0,0,0,0,0,0,0,0
"Malaysia","2024-07-19",0,0,0,0,0,0,0,0
"Malaysia","2024-07-20",0,0,0,0,0,0,0,0
"Malaysia","2024-07-21",0,0,0,0,0,0,0,0
"Malaysia","2024-07-22",0,0,0,0,0,0,0,0
"Malaysia","2024-07-23",0,0,0,0,0,0,0,0
"Malaysia","2024-07-24",0,0,0,0,0,0,0,0
"Malaysia","2024-07-25",0,0,0,0,0,0,0,0
"Malaysia","2024-07-26",0,0,0,0,0,0,0,0
"Malaysia","2024-07-27",0,0,0,0,0,0,0,0
"Malaysia","2024-07-28",0,0,0,0,0,0,0,0
"Malaysia","2024-07-29",0,0,0,0,0,0,0,0
"Malaysia","2024-07-30",0,0,0,0,0,0,0,0
"Malaysia","2024-07-31",0,0,0,0,0,0,0,0
"Malaysia","2024-08-01",0,0,0,0,0,0,0,0
"Malaysia","2024-08-02",0,0,0,0,0,0,0,0
"Malaysia","2024-08-03",0,0,0,0,0,0,0,0
"Malaysia","2024-08-04",0,0,0,0,0,0,0,0
"Malaysia","2024-08-05",0,0,0,0,0,0,0,0
"Malaysia","2024-08-06",0,0,0,0,0,0,0,0
"Malaysia","2024-08-07",0,0,0,0,0,0,0,0
"Malaysia","2024-08-08",0,0,0,0,0,0,0,0
"Malaysia","2024-08-09",0,0,0,0,0,0,0,0
"Malaysia","2024-08-10",0,0,0,0,0,0,0,0
"Malaysia","2024-08-11",0,0,0,0,0,0,0,0
"Malaysia","2024-08-12",0,0,0,0,0,0,0,0
"Malaysia","2024-08-13",0,0,0,0,0,0,0,0
"Malaysia","2024-08-14",0,0,0,0,0,0,0,0
"Malaysia","2024-08-15",0,0,0,0,0,0,0,0
"Malaysia","2024-08-16",0,0,0,0,0,0,0,0
"Malaysia","2024-08-17",0,0,0,0,0,0,0,0
"Malaysia","2024-08-18",0,0,0,0,0,0,0,0
"Malaysia","2024-08-19",0,0,0,0,0,0,0,0
"Malaysia","2024-08-20",0,0,0,0,0,0,0,0
"Malaysia","2024-08-21",0,0,0,0,0,0,0,0
"Malaysia","2024-08-22",0,0,0,0,0,0,0,0
"Malaysia","2024-08-23",0,0,0,0,0,0,0,0
"Malaysia","2024-08-24",0,0,0,0,0,0,0,0
"Malaysia","2024-08-25",0,0,0,0,0,0,0,0
"Malaysia","2024-08-26",0,0,0,0,0,0,0,0
"Malaysia","2024-08-27",0,0,0,0,0,0,0,0
"Malaysia","2024-08-28",0,0,0,0,0,0,0,0
"Malaysia","2024-08-29",0,0,0,0,0,0,0,0
"Malaysia","2024-08-30",0,0,0,0,0,0,0,0
"Malaysia","2024-08-31",0,0,0,0,0,0,0,0
"Malaysia","2024-09-01",0,0,0,0,0,0,0,0
"Malaysia","2024-09-02",0,0,0,0,0,0,0,0
"Malaysia","2024-09-03",0,0,0,0,0,0,0,0
"Malaysia","2024-09-04",0,0,0,0,0,0,0,0
"Malaysia","2024-09-05",0,0,0,0,0,0,0,0
"Malaysia","2024-09-06",0,0,0,0,0,0,0,0
"Malaysia","2024-09-07",0,0,0,0,0,0,0,0
"Malaysia","2024-09-08",0,0,0,0,0,0,0,0
"Malaysia","2024-09-09",0,0,0,0,0,0,0,0
"Malaysia","2024-09-10",0,0,0,0,0,0,0,0
"Malaysia","2024-09-11",0,0,0,0,0,0,0,0
"Malaysia","2024-09-12",0,0,0,0,0,0,0,0
"Malaysia","2024-09-13",0,0,0,0,0,0,0,0
"Malaysia","2024-09-14",0,0,0,0,0,0,0,0
"Malaysia","2024-09-15",0,0,0,0,0,0,0,0
"Malaysia","2024-09-16",0,0,0,0,0,0,0,0
"Malaysia","2024-09-17",0,0,0,0,0,0,0,0
"Malaysia","2024-09-18",0,1,1,0,1,1,0,0
"Malaysia","2024-09-19",0,0,1,0,0,1,0,0
"Malaysia","2024-09-20",0,0,1,0,0,1,0,0
"Malaysia","2024-09-21",0,0,1,0,0,1,0,0
"Malaysia","2024-09-22",0,0,1,0,0,1,0,0
"Malaysia","2024-09-23",0,0,1,0,0,1,0,0
"Malaysia","2024-09-24",0,0,1,0,0,1,0,0
"Malaysia","2024-09-25",0,0,1,0,0,1,0,0
"Malaysia","2024-09-26",0,0,1,0,0,1,0,0
"Malaysia","2024-09-27",0,0,1,0,0,1,0,0
"Malaysia","2024-09-28",0,0,1,0,0,1,0,0
"Malaysia","2024-09-29",0,0,1,0,0,1,0,0
"Malaysia","2024-09-30",0,0,1,0,0,1,0,0
"Malaysia","2024-10-01",0,0,1,0,0,1,0,0
"Malaysia","2024-10-02",0,0,1,0,0,1,0,0
"Malaysia","2024-10-03",0,0,1,0,0,1,0,0
"Malaysia","2024-10-04",0,0,1,0,0,1,0,0
"Malaysia","2024-10-05",0,0,1,0,0,1,0,0
"Malaysia","2024-10-06",0,0,1,0,0,1,0,0
"Malaysia","2024-10-07",0,0,1,0,0,1,0,0
"Malaysia","2024-10-08",0,0,1,0,0,1,0,0
"Malaysia","2024-10-09",0,0,1,0,0,1,0,0
"Malaysia","2024-10-10",0,0,1,0,0,1,0,0
"Malaysia","2024-10-11",0,0,1,0,0,1,0,0
"Malaysia","2024-10-12",0,0,1,0,0,1,0,0
"Malaysia","2024-10-13",0,0,1,0,0,1,0,0
"Malaysia","2024-10-14",0,0,1,0,0,1,0,0
"Malaysia","2024-10-15",0,0,1,0,0,1,0,0
"Malaysia","2024-10-16",0,0,1,0,0,1,0,0
"Malaysia","2024-10-17",0,0,1,0,1,2,0,0
"Malaysia","2024-10-18",0,0,1,0,0,2,0,0
"Malaysia","2024-10-19",0,0,1,0,0,2,0,0
"Malaysia","2024-10-20",0,0,1,0,0,2,0,0
"Malaysia","2024-10-21",0,0,1,0,0,2,0,0
"Malaysia","2024-10-22",0,0,1,0,0,2,0,0
"Malaysia","2024-10-23",0,0,1,0,0,2,0,0
"Malaysia","2024-10-24",0,0,1,0,0,2,0,0
"Malaysia","2024-10-25",0,0,1,0,0,2,0,0
"Malaysia","2024-10-26",0,0,1,0,0,2,0,0
"Malaysia","2024-10-27",0,0,1,0,0,2,0,0
"Malaysia","2024-10-28",0,0,1,0,0,2,0,0
"Malaysia","2024-10-29",0,0,1,0,0,2,0,0
"Malaysia","2024-10-30",0,0,1,0,0,2,0,0
"Malaysia","2024-10-31",0,0,1,0,0,2,0,0
"Malaysia","2024-11-01",0,0,1,0,0,2,0,0
"Malaysia","2024-11-02",0,0,1,0,0,2,0,0
"Malaysia","2024-11-03",0,0,1,0,0,2,0,0
"Malaysia","2024-11-04",0,0,1,0,0,2,0,0
"Malaysia","2024-11-05",0,0,1,0,0,2,0,0
"Malaysia","2024-11-06",0,0,1,0,0,2,0,0
"Malaysia","2024-11-07",0,0,1,0,0,2,0,0
"Malaysia","2024-11-08",0,0,1,0,0,2,0,0
"Malaysia","2024-11-09",0,0,1,0,0,2,0,0
"Malaysia","2024-11-10",0,0,1,0,0,2,0,0
"Malaysia","2024-11-11",0,0,1,0,0,2,0,0
"Malaysia","2024-11-12",0,0,1,0,0,2,0,0
"Malaysia","2024-11-13",0,0,1,0,0,2,0,0
"Malaysia","2024-11-14",0,0,1,0,0,2,0,0
"Malaysia","2024-11-15",0,0,1,0,0,2,0,0
"Malaysia","2024-11-16",0,0,1,0,0,2,0,0
"Malaysia","2024-11-17",0,0,1,0,0,2,0,0
"Malaysia","2024-11-18",0,0,1,0,0,2,0,0
"Malaysia","2024-11-19",0,0,1,0,0,2,0,0
"Malaysia","2024-11-20",0,0,1,0,0,2,0,0
"Malaysia","2024-11-21",0,0,1,0,0,2,0,0
"Malaysia","2024-11-22",0,0,1,0,0,2,0,0
"Malaysia","2024-11-23",0,0,1,0,0,2,0,0
"Malaysia","2024-11-24",0,0,1,0,0,2,0,0
"Malaysia","2024-11-25",0,0,1,0,0,2,0,0
"Malaysia","2024-11-26",0,0,1,0,0,2,0,0
"Malaysia","2024-11-27",0,0,1,0,0,2,0,0
"Malaysia","2024-11-28",0,0,1,0,0,2,0,0
"Malaysia","2024-11-29",0,0,1,0,0,2,0,0
"Malaysia","2024-11-30",0,0,1,0,0,2,0,0
"Malaysia","2024-12-01",0,0,1,0,0,2,0,0
"Malaysia","2024-12-02",0,0,1,0,0,2,0,0
"Malaysia","2024-12-03",0,0,1,0,0,2,0,0
"Malaysia","2024-12-04",0,0,1,0,0,2,0,0
"Malaysia","2024-12-05",0,0,1,0,0,2,0,0
"Malaysia","2024-12-06",0,0,1,0,0,2,0,0
"Malaysia","2024-12-07",0,0,1,0,0,2,0,0
"Malaysia","2024-12-08",0,0,1,0,0,2,0,0
"Malaysia","2024-12-09",0,0,1,0,0,2,0,0
"Malaysia","2024-12-10",0,0,1,0,0,2,0,0
"Malaysia","2024-12-11",0,0,1,0,0,2,0,0
"Malaysia","2024-12-12",0,0,1,0,0,2,0,0
"Malaysia","2024-12-13",0,0,1,0,1,3,0,0
"Malaysia","2024-12-14",0,0,1,0,0,3,0,0
"Malaysia","2024-12-15",0,0,1,0,0,3,0,0
"Malaysia","2024-12-16",0,0,1,0,0,3,0,0
"Malaysia","2024-12-17",0,0,1,0,0,3,0,0
"Malaysia","2024-12-18",0,0,1,0,0,3,0,0
"Malaysia","2024-12-19",0,0,1,0,0,3,0,0
"Malaysia","2024-12-20",0,0,1,0,0,3,0,0
"Malaysia","2024-12-21",0,0,1,0,0,3,0,0
"Malaysia","2024-12-22",0,0,1,0,0,3,0,0
"Malaysia","2024-12-23",0,0,1,0,0,3,0,0
"Malaysia","2024-12-24",0,0,1,0,0,3,0,0
"Malaysia","2024-12-25",0,0,1,0,0,3,0,0
"Malaysia","2024-12-26",0,0,1,0,0,3,0,0
"Malaysia","2024-12-27",0,0,1,0,0,3,0,0
"Malaysia","2024-12-28",0,0,1,0,0,3,0,0
"Malaysia","2024-12-29",0,0,1,0,0,3,0,0
"Malaysia","2024-12-30",0,0,1,0,0,3,0,0
"Malaysia","2024-12-31",0,0,1,0,0,3,0,0
"Malaysia","2025-01-01",0,0,1,0,0,3,0,0
"Malaysia","2025-01-02",0,0,1,0,0,3,0,0
"Malaysia","2025-01-03",0,0,1,0,0,3,0,0
"Malaysia","2025-01-04",0,0,1,0,0,3,0,0
"Malaysia","2025-01-05",0,0,1,0,0,3,0,0
"Malaysia","2025-01-06",0,0,1,0,0,3,0,0
"Malaysia","2025-01-07",0,0,1,0,0,3,0,0
"Malaysia","2025-01-08",0,0,1,0,0,3,0,0
"Malaysia","2025-01-09",0,0,1,0,0,3,0,0
"Malaysia","2025-01-10",0,2,3,0,0,3,0,0
"Malaysia","2025-01-11",0,0,3,0,0,3,0,0
"Malaysia","2025-01-12",0,0,3,0,0,3,0,0
"Malaysia","2025-01-13",0,0,3,0,0,3,0,0
"Malaysia","2025-01-14",0,0,3,0,0,3,0,0
"Malaysia","2025-01-15",0,0,3,0,0,3,0,0
"Malaysia","2025-01-16",0,0,3,0,0,3,0,0
"Malaysia","2025-01-17",0,0,3,0,0,3,0,0
"Malaysia","2025-01-18",0,0,3,0,0,3,0,0
"Malaysia","2025-01-19",0,0,3,0,0,3,0,0
"Malaysia","2025-01-20",0,0,3,0,0,3,0,0
"Malaysia","2025-01-21",0,0,3,0,0,3,0,0
"Malaysia","2025-01-22",0,0,3,0,0,3,0,0
"Malaysia","2025-01-23",0,0,3,0,0,3,0,0
"Malaysia","2025-01-24",0,0,3,0,0,3,0,0
"Malaysia","2025-01-25",0,0,3,0,0,3,0,0
"Malaysia","2025-01-26",0,0,3,0,0,3,0,0
"Malaysia","2025-01-27",0,0,3,0,0,3,0,0
"Malaysia","2025-01-28",0,0,3,0,0,3,0,0
"Malaysia","2025-01-29",0,0,3,0,0,3,0,0
"Malaysia","2025-01-30",0,0,3,0,0,3,0,0
"Malaysia","2025-01-31",0,0,3,0,0,3,0,0
"Malaysia","2025-02-01",0,0,3,0,0,3,0,0
"Malaysia","2025-02-02",0,0,3,0,0,3,0,0
"Malaysia","2025-02-03",0,0,3,0,0,3,0,0
"Malaysia","2025-02-04",0,0,3,0,0,3,0,0
"Malaysia","2025-02-05",0,0,3,0,0,3,0,0
"Malaysia","2025-02-06",0,0,3,0,0,3,0,0
"Malaysia","2025-02-07",0,0,3,0,0,3,0,0
"Malaysia","2025-02-08",0,0,3,0,0,3,0,0
"Malaysia","2025-02-09",0,0,3,0,0,3,0,0
"Malaysia","2025-02-10",0,0,3,0,0,3,0,0
"Malaysia","2025-02-11",0,0,3,0,0,3,0,0
"Malaysia","2025-02-12",0,0,3,0,0,3,0,0
"Malaysia","2025-02-13",0,0,3,0,0,3,0,0
"Malaysia","2025-02-14",0,0,3,0,0,3,0,0
"Malaysia","2025-02-15",0,0,3,0,0,3,0,0
"Malaysia","2025-02-16",0,0,3,0,0,3,0,0
"Malaysia","2025-02-17",0,0,3,0,0,3,0,0
"Malaysia","2025-02-18",0,0,3,0,0,3,0,0
"Malaysia","2025-02-19",0,0,3,0,0,3,0,0
"Malaysia","2025-02-20",0,0,3,0,0,3,0,0
"Malaysia","2025-02-21",0,0,3,0,0,3,0,0
"Malaysia","2025-02-22",0,0,3,0,0,3,0,0
"Malaysia","2025-02-23",0,0,3,0,0,3,0,0
"Malaysia","2025-02-24",0,0,3,0,0,3,0,0
"Malaysia","2025-02-25",0,0,3,0,0,3,0,0
"Malaysia","2025-02-26",0,0,3,0,0,3,0,0
"Malaysia","2025-02-27",0,0,3,0,0,3,0,0
"Malaysia","2025-02-28",0,0,3,0,0,3,0,0
"Malaysia","2025-03-01",0,0,3,0,0,3,0,0
"Malaysia","2025-03-02",0,0,3,0,0,3,0,0
"Malaysia","2025-03-03",0,0,3,0,0,3,0,0
"Malta","2024-01-01",0,0,0,0,0,0,0,0
"Malta","2024-01-02",0,0,0,0,0,0,0,0
"Malta","2024-01-03",0,0,0,0,0,0,0,0
"Malta","2024-01-04",0,0,0,0,0,0,0,0
"Malta","2024-01-05",0,0,0,0,0,0,0,0
"Malta","2024-01-06",0,0,0,0,0,0,0,0
"Malta","2024-01-07",0,0,0,0,0,0,0,0
"Malta","2024-01-08",0,0,0,0,0,0,0,0
"Malta","2024-01-09",0,0,0,0,0,0,0,0
"Malta","2024-01-10",0,0,0,0,0,0,0,0
"Malta","2024-01-11",0,0,0,0,0,0,0,0
"Malta","2024-01-12",0,0,0,0,0,0,0,0
"Malta","2024-01-13",0,0,0,0,0,0,0,0
"Malta","2024-01-14",0,0,0,0,0,0,0,0
"Malta","2024-01-15",0,0,0,0,0,0,0,0
"Malta","2024-01-16",0,0,0,0,0,0,0,0
"Malta","2024-01-17",0,0,0,0,0,0,0,0
"Malta","2024-01-18",0,0,0,0,0,0,0,0
"Malta","2024-01-19",0,0,0,0,0,0,0,0
"Malta","2024-01-20",0,0,0,0,0,0,0,0
"Malta","2024-01-21",0,0,0,0,0,0,0,0
"Malta","2024-01-22",0,0,0,0,0,0,0,0
"Malta","2024-01-23",0,0,0,0,0,0,0,0
"Malta","2024-01-24",0,0,0,0,0,0,0,0
"Malta","2024-01-25",0,0,0,0,0,0,0,0
"Malta","2024-01-26",0,0,0,0,0,0,0,0
"Malta","2024-01-27",0,0,0,0,0,0,0,0
"Malta","2024-01-28",0,0,0,0,0,0,0,0
"Malta","2024-01-29",0,0,0,0,0,0,0,0
"Malta","2024-01-30",0,0,0,0,0,0,0,0
"Malta","2024-01-31",0,0,0,0,0,0,0,0
"Malta","2024-02-01",0,0,0,0,0,0,0,0
"Malta","2024-02-02",0,0,0,0,0,0,0,0
"Malta","2024-02-03",0,0,0,0,0,0,0,0
"Malta","2024-02-04",0,0,0,0,0,0,0,0
"Malta","2024-02-05",0,0,0,0,0,0,0,0
"Malta","2024-02-06",0,0,0,0,0,0,0,0
"Malta","2024-02-07",0,0,0,0,0,0,0,0
"Malta","2024-02-08",0,0,0,0,0,0,0,0
"Malta","2024-02-09",0,0,0,0,0,0,0,0
"Malta","2024-02-10",0,0,0,0,0,0,0,0
"Malta","2024-02-11",0,0,0,0,0,0,0,0
"Malta","2024-02-12",0,0,0,0,0,0,0,0
"Malta","2024-02-13",0,0,0,0,0,0,0,0
"Malta","2024-02-14",0,0,0,0,0,0,0,0
"Malta","2024-02-15",0,0,0,0,0,0,0,0
"Malta","2024-02-16",0,0,0,0,0,0,0,0
"Malta","2024-02-17",0,0,0,0,0,0,0,0
"Malta","2024-02-18",0,0,0,0,0,0,0,0
"Malta","2024-02-19",0,0,0,0,0,0,0,0
"Malta","2024-02-20",0,0,0,0,0,0,0,0
"Malta","2024-02-21",0,0,0,0,0,0,0,0
"Malta","2024-02-22",0,0,0,0,0,0,0,0
"Malta","2024-02-23",0,0,0,0,0,0,0,0
"Malta","2024-02-24",0,0,0,0,0,0,0,0
"Malta","2024-02-25",0,0,0,0,0,0,0,0
"Malta","2024-02-26",0,0,0,0,0,0,0,0
"Malta","2024-02-27",0,0,0,0,0,0,0,0
"Malta","2024-02-28",0,0,0,0,0,0,0,0
"Malta","2024-02-29",0,0,0,0,0,0,0,0
"Malta","2024-03-01",0,0,0,0,0,0,0,0
"Malta","2024-03-02",0,0,0,0,0,0,0,0
"Malta","2024-03-03",0,0,0,0,0,0,0,0
"Malta","2024-03-04",0,0,0,0,0,0,0,0
"Malta","2024-03-05",0,0,0,0,0,0,0,0
"Malta","2024-03-06",0,0,0,0,0,0,0,0
"Malta","2024-03-07",0,0,0,0,0,0,0,0
"Malta","2024-03-08",0,0,0,0,0,0,0,0
"Malta","2024-03-09",0,0,0,0,0,0,0,0
"Malta","2024-03-10",0,0,0,0,0,0,0,0
"Malta","2024-03-11",0,0,0,0,0,0,0,0
"Malta","2024-03-12",0,0,0,0,0,0,0,0
"Malta","2024-03-13",0,0,0,0,0,0,0,0
"Malta","2024-03-14",0,0,0,0,0,0,0,0
"Malta","2024-03-15",0,0,0,0,0,0,0,0
"Malta","2024-03-16",0,0,0,0,0,0,0,0
"Malta","2024-03-17",0,0,0,0,0,0,0,0
"Malta","2024-03-18",0,0,0,0,0,0,0,0
"Malta","2024-03-19",0,0,0,0,0,0,0,0
"Malta","2024-03-20",0,0,0,0,0,0,0,0
"Malta","2024-03-21",0,0,0,0,0,0,0,0
"Malta","2024-03-22",0,0,0,0,0,0,0,0
"Malta","2024-03-23",0,0,0,0,0,0,0,0
"Malta","2024-03-24",0,0,0,0,0,0,0,0
"Malta","2024-03-25",0,0,0,0,0,0,0,0
"Malta","2024-03-26",0,0,0,0,0,0,0,0
"Malta","2024-03-27",0,0,0,0,0,0,0,0
"Malta","2024-03-28",0,0,0,0,0,0,0,0
"Malta","2024-03-29",0,0,0,0,0,0,0,0
"Malta","2024-03-30",0,0,0,0,0,0,0,0
"Malta","2024-03-31",0,0,0,0,0,0,0,0
"Malta","2024-04-01",0,0,0,0,0,0,0,0
"Malta","2024-04-02",0,0,0,0,0,0,0,0
"Malta","2024-04-03",0,0,0,0,0,0,0,0
"Malta","2024-04-04",0,0,0,0,0,0,0,0
"Malta","2024-04-05",0,0,0,0,0,0,0,0
"Malta","2024-04-06",0,0,0,0,0,0,0,0
"Malta","2024-04-07",0,0,0,0,0,0,0,0
"Malta","2024-04-08",0,0,0,0,0,0,0,0
"Malta","2024-04-09",0,0,0,0,0,0,0,0
"Malta","2024-04-10",0,0,0,0,0,0,0,0
"Malta","2024-04-11",0,0,0,0,0,0,0,0
"Malta","2024-04-12",0,0,0,0,0,0,0,0
"Malta","2024-04-13",0,0,0,0,0,0,0,0
"Malta","2024-04-14",0,0,0,0,0,0,0,0
"Malta","2024-04-15",0,0,0,0,0,0,0,0
"Malta","2024-04-16",0,0,0,0,0,0,0,0
"Malta","2024-04-17",0,0,0,0,0,0,0,0
"Malta","2024-04-18",0,0,0,0,0,0,0,0
"Malta","2024-04-19",0,0,0,0,0,0,0,0
"Malta","2024-04-20",0,0,0,0,0,0,0,0
"Malta","2024-04-21",0,0,0,0,0,0,0,0
"Malta","2024-04-22",0,0,0,0,0,0,0,0
"Malta","2024-04-23",0,0,0,0,0,0,0,0
"Malta","2024-04-24",0,0,0,0,0,0,0,0
"Malta","2024-04-25",0,0,0,0,0,0,0,0
"Malta","2024-04-26",0,0,0,0,0,0,0,0
"Malta","2024-04-27",0,0,0,0,0,0,0,0
"Malta","2024-04-28",0,0,0,0,0,0,0,0
"Malta","2024-04-29",0,0,0,0,0,0,0,0
"Malta","2024-04-30",0,0,0,0,0,0,0,0
"Malta","2024-05-01",0,0,0,0,0,0,0,0
"Malta","2024-05-02",0,0,0,0,0,0,0,0
"Malta","2024-05-03",0,0,0,0,0,0,0,0
"Malta","2024-05-04",0,0,0,0,0,0,0,0
"Malta","2024-05-05",0,0,0,0,0,0,0,0
"Malta","2024-05-06",0,0,0,0,0,0,0,0
"Malta","2024-05-07",0,0,0,0,0,0,0,0
"Malta","2024-05-08",0,0,0,0,0,0,0,0
"Malta","2024-05-09",0,0,0,0,0,0,0,0
"Malta","2024-05-10",0,0,0,0,0,0,0,0
"Malta","2024-05-11",0,0,0,0,0,0,0,0
"Malta","2024-05-12",0,0,0,0,0,0,0,0
"Malta","2024-05-13",0,0,0,0,0,0,0,0
"Malta","2024-05-14",0,0,0,0,0,0,0,0
"Malta","2024-05-15",0,0,0,0,0,0,0,0
"Malta","2024-05-16",0,0,0,0,0,0,0,0
"Malta","2024-05-17",0,0,0,0,0,0,0,0
"Malta","2024-05-18",0,0,0,0,0,0,0,0
"Malta","2024-05-19",0,0,0,0,0,0,0,0
"Malta","2024-05-20",0,0,0,0,0,0,0,0
"Malta","2024-05-21",0,0,0,0,0,0,0,0
"Malta","2024-05-22",0,0,0,0,0,0,0,0
"Malta","2024-05-23",0,0,0,0,0,0,0,0
"Malta","2024-05-24",0,0,0,0,0,0,0,0
"Malta","2024-05-25",0,0,0,0,0,0,0,0
"Malta","2024-05-26",0,0,0,0,0,0,0,0
"Malta","2024-05-27",0,0,0,0,0,0,0,0
"Malta","2024-05-28",0,0,0,0,0,0,0,0
"Malta","2024-05-29",0,0,0,0,0,0,0,0
"Malta","2024-05-30",0,0,0,0,0,0,0,0
"Malta","2024-05-31",0,0,0,0,0,0,0,0
"Malta","2024-06-01",0,0,0,0,0,0,0,0
"Malta","2024-06-02",0,0,0,0,0,0,0,0
"Malta","2024-06-03",0,0,0,0,0,0,0,0
"Malta","2024-06-04",0,0,0,0,0,0,0,0
"Malta","2024-06-05",0,0,0,0,0,0,0,0
"Malta","2024-06-06",0,0,0,0,0,0,0,0
"Malta","2024-06-07",0,0,0,0,0,0,0,0
"Malta","2024-06-08",0,0,0,0,0,0,0,0
"Malta","2024-06-09",0,0,0,0,0,0,0,0
"Malta","2024-06-10",0,0,0,0,0,0,0,0
"Malta","2024-06-11",0,0,0,0,0,0,0,0
"Malta","2024-06-12",0,0,0,0,0,0,0,0
"Malta","2024-06-13",0,0,0,0,0,0,0,0
"Malta","2024-06-14",0,0,0,0,0,0,0,0
"Malta","2024-06-15",0,0,0,0,0,0,0,0
"Malta","2024-06-16",0,0,0,0,0,0,0,0
"Malta","2024-06-17",0,0,0,0,0,0,0,0
"Malta","2024-06-18",0,0,0,0,0,0,0,0
"Malta","2024-06-19",0,0,0,0,0,0,0,0
"Malta","2024-06-20",0,0,0,0,0,0,0,0
"Malta","2024-06-21",0,0,0,0,0,0,0,0
"Malta","2024-06-22",0,0,0,0,0,0,0,0
"Malta","2024-06-23",0,0,0,0,0,0,0,0
"Malta","2024-06-24",0,0,0,0,0,0,0,0
"Malta","2024-06-25",0,0,0,0,0,0,0,0
"Malta","2024-06-26",0,0,0,0,0,0,0,0
"Malta","2024-06-27",0,0,0,0,0,0,0,0
"Malta","2024-06-28",0,0,0,0,0,0,0,0
"Malta","2024-06-29",0,0,0,0,0,0,0,0
"Malta","2024-06-30",0,0,0,0,0,0,0,0
"Malta","2024-07-01",0,0,0,0,0,0,0,0
"Malta","2024-07-02",0,0,0,0,0,0,0,0
"Malta","2024-07-03",0,0,0,0,0,0,0,0
"Malta","2024-07-04",0,0,0,0,0,0,0,0
"Malta","2024-07-05",0,0,0,0,0,0,0,0
"Malta","2024-07-06",0,0,0,0,0,0,0,0
"Malta","2024-07-07",0,0,0,0,0,0,0,0
"Malta","2024-07-08",0,0,0,0,0,0,0,0
"Malta","2024-07-09",0,0,0,0,0,0,0,0
"Malta","2024-07-10",0,0,0,0,0,0,0,0
"Malta","2024-07-11",0,0,0,0,0,0,0,0
"Malta","2024-07-12",0,0,0,0,0,0,0,0
"Malta","2024-07-13",0,0,0,0,0,0,0,0
"Malta","2024-07-14",0,0,0,0,0,0,0,0
"Malta","2024-07-15",0,0,0,0,0,0,0,0
"Malta","2024-07-16",0,0,0,0,0,0,0,0
"Malta","2024-07-17",0,0,0,0,0,0,0,0
"Malta","2024-07-18",0,0,0,0,0,0,0,0
"Malta","2024-07-19",0,0,0,0,0,0,0,0
"Malta","2024-07-20",0,0,0,0,0,0,0,0
"Malta","2024-07-21",0,0,0,0,0,0,0,0
"Malta","2024-07-22",0,0,0,0,0,0,0,0
"Malta","2024-07-23",0,0,0,0,0,0,0,0
"Malta","2024-07-24",0,0,0,0,0,0,0,0
"Malta","2024-07-25",0,0,0,0,0,0,0,0
"Malta","2024-07-26",0,0,0,0,0,0,0,0
"Malta","2024-07-27",0,0,0,0,0,0,0,0
"Malta","2024-07-28",0,0,0,0,0,0,0,0
"Malta","2024-07-29",0,0,0,0,0,0,0,0
"Malta","2024-07-30",0,0,0,0,0,0,0,0
"Malta","2024-07-31",0,0,0,0,0,0,0,0
"Malta","2024-08-01",0,0,0,0,0,0,0,0
"Malta","2024-08-02",0,0,0,0,0,0,0,0
"Malta","2024-08-03",0,0,0,0,0,0,0,0
"Malta","2024-08-04",0,0,0,0,0,0,0,0
"Malta","2024-08-05",0,0,0,0,0,0,0,0
"Malta","2024-08-06",0,0,0,0,0,0,0,0
"Malta","2024-08-07",0,0,0,0,0,0,0,0
"Malta","2024-08-08",0,0,0,0,0,0,0,0
"Malta","2024-08-09",0,0,0,0,0,0,0,0
"Malta","2024-08-10",0,0,0,0,0,0,0,0
"Malta","2024-08-11",0,0,0,0,0,0,0,0
"Malta","2024-08-12",0,0,0,0,0,0,0,0
"Malta","2024-08-13",0,0,0,0,0,0,0,0
"Malta","2024-08-14",0,0,0,0,0,0,0,0
"Malta","2024-08-15",0,0,0,0,0,0,0,0
"Malta","2024-08-16",0,0,0,0,0,0,0,0
"Malta","2024-08-17",0,0,0,0,0,0,0,0
"Malta","2024-08-18",0,0,0,0,0,0,0,0
"Malta","2024-08-19",0,0,0,0,0,0,0,0
"Malta","2024-08-20",0,0,0,0,0,0,0,0
"Malta","2024-08-21",0,0,0,0,0,0,0,0
"Malta","2024-08-22",0,0,0,0,0,0,0,0
"Malta","2024-08-23",0,0,0,0,0,0,0,0
"Malta","2024-08-24",0,0,0,0,0,0,0,0
"Malta","2024-08-25",0,0,0,0,0,0,0,0
"Malta","2024-08-26",0,0,0,0,0,0,0,0
"Malta","2024-08-27",0,0,0,0,0,0,0,0
"Malta","2024-08-28",0,0,0,0,0,0,0,0
"Malta","2024-08-29",0,0,0,0,0,0,0,0
"Malta","2024-08-30",0,0,0,0,0,0,0,0
"Malta","2024-08-31",0,2,2,0,2,2,0,0
"Malta","2024-09-01",0,0,2,0,0,2,0,0
"Malta","2024-09-02",0,0,2,0,0,2,0,0
"Malta","2024-09-03",0,0,2,0,0,2,0,0
"Malta","2024-09-04",0,0,2,0,0,2,0,0
"Malta","2024-09-05",0,0,2,0,0,2,0,0
"Malta","2024-09-06",0,0,2,0,0,2,0,0
"Malta","2024-09-07",0,0,2,0,0,2,0,0
"Malta","2024-09-08",0,0,2,0,0,2,0,0
"Malta","2024-09-09",0,0,2,0,0,2,0,0
"Malta","2024-09-10",0,0,2,0,0,2,0,0
"Malta","2024-09-11",0,0,2,0,0,2,0,0
"Malta","2024-09-12",0,0,2,0,0,2,0,0
"Malta","2024-09-13",0,0,2,0,0,2,0,0
"Malta","2024-09-14",0,0,2,0,0,2,0,0
"Malta","2024-09-15",0,0,2,0,0,2,0,0
"Malta","2024-09-16",0,0,2,0,0,2,0,0
"Malta","2024-09-17",0,0,2,0,0,2,0,0
"Malta","2024-09-18",0,0,2,0,0,2,0,0
"Malta","2024-09-19",0,0,2,0,0,2,0,0
"Malta","2024-09-20",0,0,2,0,0,2,0,0
"Malta","2024-09-21",0,0,2,0,0,2,0,0
"Malta","2024-09-22",0,0,2,0,0,2,0,0
"Malta","2024-09-23",0,0,2,0,0,2,0,0
"Malta","2024-09-24",0,0,2,0,0,2,0,0
"Malta","2024-09-25",0,0,2,0,0,2,0,0
"Malta","2024-09-26",0,0,2,0,0,2,0,0
"Malta","2024-09-27",0,0,2,0,0,2,0,0
"Malta","2024-09-28",0,0,2,0,0,2,0,0
"Malta","2024-09-29",0,0,2,0,0,2,0,0
"Malta","2024-09-30",0,0,2,0,0,2,0,0
"Malta","2024-10-01",0,0,2,0,1,3,0,0
"Malta","2024-10-02",0,0,2,0,0,3,0,0
"Malta","2024-10-03",0,0,2,0,0,3,0,0
"Malta","2024-10-04",0,0,2,0,0,3,0,0
"Malta","2024-10-05",0,0,2,0,0,3,0,0
"Malta","2024-10-06",0,0,2,0,0,3,0,0
"Malta","2024-10-07",0,0,2,0,0,3,0,0
"Malta","2024-10-08",0,0,2,0,0,3,0,0
"Malta","2024-10-09",0,0,2,0,0,3,0,0
"Malta","2024-10-10",0,0,2,0,0,3,0,0
"Malta","2024-10-11",0,0,2,0,0,3,0,0
"Malta","2024-10-12",0,0,2,0,0,3,0,0
"Malta","2024-10-13",0,0,2,0,0,3,0,0
"Malta","2024-10-14",0,0,2,0,0,3,0,0
"Malta","2024-10-15",0,0,2,0,0,3,0,0
"Malta","2024-10-16",0,0,2,0,0,3,0,0
"Malta","2024-10-17",0,0,2,0,0,3,0,0
"Malta","2024-10-18",0,0,2,0,0,3,0,0
"Malta","2024-10-19",0,0,2,0,0,3,0,0
"Malta","2024-10-20",0,0,2,0,0,3,0,0
"Malta","2024-10-21",0,0,2,0,0,3,0,0
"Malta","2024-10-22",0,0,2,0,0,3,0,0
"Malta","2024-10-23",0,0,2,0,0,3,0,0
"Malta","2024-10-24",0,0,2,0,0,3,0,0
"Malta","2024-10-25",0,0,2,0,0,3,0,0
"Malta","2024-10-26",0,0,2,0,0,3,0,0
"Malta","2024-10-27",0,0,2,0,0,3,0,0
"Malta","2024-10-28",0,0,2,0,0,3,0,0
"Malta","2024-10-29",0,0,2,0,0,3,0,0
"Malta","2024-10-30",0,0,2,0,0,3,0,0
"Malta","2024-10-31",0,1,3,0,0,3,0,0
"Malta","2024-11-01",0,0,3,0,0,3,0,0
"Malta","2024-11-02",0,0,3,0,0,3,0,0
"Malta","2024-11-03",0,0,3,0,0,3,0,0
"Malta","2024-11-04",0,0,3,0,0,3,0,0
"Malta","2024-11-05",0,0,3,0,0,3,0,0
"Malta","2024-11-06",0,0,3,0,0,3,0,0
"Malta","2024-11-07",0,0,3,0,0,3,0,0
"Malta","2024-11-08",0,0,3,0,0,3,0,0
"Malta","2024-11-09",0,0,3,0,0,3,0,0
"Malta","2024-11-10",0,0,3,0,0,3,0,0
"Malta","2024-11-11",0,0,3,0,1,4,0,0
"Malta","2024-11-12",0,0,3,0,0,4,0,0
"Malta","2024-11-13",0,0,3,0,0,4,0,0
"Malta","2024-11-14",0,0,3,0,0,4,0,0
"Malta","2024-11-15",0,0,3,0,0,4,0,0
"Malta","2024-11-16",0,0,3,0,0,4,0,0
"Malta","2024-11-17",0,0,3,0,0,4,0,0
"Malta","2024-11-18",0,0,3,0,0,4,0,0
"Malta","2024-11-19",0,0,3,0,0,4,0,0
"Malta","2024-11-20",0,0,3,0,0,4,0,0
"Malta","2024-11-21",0,0,3,0,0,4,0,0
"Malta","2024-11-22",0,0,3,0,0,4,0,0
"Malta","2024-11-23",0,0,3,0,0,4,0,0
"Malta","2024-11-24",0,0,3,0,0,4,0,0
"Malta","2024-11-25",0,0,3,0,0,4,0,0
"Malta","2024-11-26",0,0,3,0,0,4,0,0
"Malta","2024-11-27",0,0,3,0,0,4,0,0
"Malta","2024-11-28",0,0,3,0,0,4,0,0
"Malta","2024-11-29",0,0,3,0,0,4,0,0
"Malta","2024-11-30",0,0,3,0,0,4,0,0
"Malta","2024-12-01",0,0,3,0,1,5,0,0
"Malta","2024-12-02",0,0,3,0,0,5,0,0
"Malta","2024-12-03",0,0,3,0,0,5,0,0
"Malta","2024-12-04",0,0,3,0,0,5,0,0
"Malta","2024-12-05",0,0,3,0,0,5,0,0
"Malta","2024-12-06",0,0,3,0,0,5,0,0
"Malta","2024-12-07",0,0,3,0,0,5,0,0
"Malta","2024-12-08",0,0,3,0,0,5,0,0
"Malta","2024-12-09",0,0,3,0,0,5,0,0
"Malta","2024-12-10",0,0,3,0,0,5,0,0
"Malta","2024-12-11",0,0,3,0,0,5,0,0
"Malta","2024-12-12",0,0,3,0,0,5,0,0
"Malta","2024-12-13",0,0,3,0,0,5,0,0
"Malta","2024-12-14",0,0,3,0,0,5,0,0
"Malta","2024-12-15",0,0,3,0,0,5,0,0
"Malta","2024-12-16",0,0,3,0,0,5,0,0
"Malta","2024-12-17",0,0,3,0,0,5,0,0
"Malta","2024-12-18",0,0,3,0,0,5,0,0
"Malta","2024-12-19",0,0,3,0,0,5,0,0
"Malta","2024-12-20",0,0,3,0,0,5,0,0
"Malta","2024-12-21",0,0,3,0,1,6,0,0
"Malta","2024-12-22",0,0,3,0,0,6,0,0
"Malta","2024-12-23",0,0,3,0,0,6,0,0
"Malta","2024-12-24",0,0,3,0,0,6,0,0
"Malta","2024-12-25",0,0,3,0,0,6,0,0
"Malta","2024-12-26",0,0,3,0,0,6,0,0
"Malta","2024-12-27",0,0,3,0,0,6,0,0
"Malta","2024-12-28",0,0,3,0,0,6,0,0
"Malta","2024-12-29",0,0,3,0,0,6,0,0
"Malta","2024-12-30",0,0,3,0,0,6,0,0
"Malta","2024-12-31",0,3,6,0,0,6,0,0
"Malta","2025-01-01",0,0,6,0,0,6,0,0
"Malta","2025-01-02",0,0,6,0,1,7,0,0
"Malta","2025-01-03",0,0,6,0,0,7,0,0
"Malta","2025-01-04",0,0,6,0,0,7,0,0
"Malta","2025-01-05",0,0,6,0,1,8,0,0
"Malta","2025-01-06",0,0,6,0,0,8,0,0
"Malta","2025-01-07",0,0,6,0,0,8,0,0
"Malta","2025-01-08",0,0,6,0,0,8,0,0
"Malta","2025-01-09",0,0,6,0,1,9,0,0
"Malta","2025-01-10",0,3,9,0,0,9,0,0
"Malta","2025-01-11",0,0,9,0,0,9,0,0
"Malta","2025-01-12",0,0,9,0,0,9,0,0
"Malta","2025-01-13",0,0,9,0,0,9,0,0
"Malta","2025-01-14",0,0,9,0,0,9,0,0
"Malta","2025-01-15",0,0,9,0,0,9,0,0
"Malta","2025-01-16",0,0,9,0,0,9,0,0
"Malta","2025-01-17",0,0,9,0,0,9,0,0
"Malta","2025-01-18",0,0,9,0,0,9,0,0
"Malta","2025-01-19",0,0,9,0,0,9,0,0
"Malta","2025-01-20",0,0,9,0,0,9,0,0
"Malta","2025-01-21",0,0,9,0,0,9,0,0
"Malta","2025-01-22",0,0,9,0,0,9,0,0
"Malta","2025-01-23",0,0,9,0,0,9,0,0
"Malta","2025-01-24",0,0,9,0,0,9,0,0
"Malta","2025-01-25",0,0,9,0,0,9,0,0
"Malta","2025-01-26",0,0,9,0,0,9,0,0
"Malta","2025-01-27",0,0,9,0,0,9,0,0
"Malta","2025-01-28",0,0,9,0,0,9,0,0
"Malta","2025-01-29",0,0,9,0,0,9,0,0
"Malta","2025-01-30",0,0,9,0,0,9,0,0
"Malta","2025-01-31",0,0,9,0,0,9,0,0
"Malta","2025-02-01",0,0,9,0,0,9,0,0
"Malta","2025-02-02",0,0,9,0,0,9,0,0
"Malta","2025-02-03",0,0,9,0,0,9,0,0
"Malta","2025-02-04",0,0,9,0,0,9,0,0
"Malta","2025-02-05",0,0,9,0,0,9,0,0
"Malta","2025-02-06",0,0,9,0,0,9,0,0
"Malta","2025-02-07",0,0,9,0,0,9,0,0
"Malta","2025-02-08",0,0,9,0,0,9,0,0
"Malta","2025-02-09",0,0,9,0,0,9,0,0
"Malta","2025-02-10",0,0,9,0,0,9,0,0
"Malta","2025-02-11",0,0,9,0,0,9,0,0
"Malta","2025-02-12",0,0,9,0,0,9,0,0
"Malta","2025-02-13",0,0,9,0,0,9,0,0
"Malta","2025-02-14",0,0,9,0,0,9,0,0
"Malta","2025-02-15",0,0,9,0,0,9,0,0
"Malta","2025-02-16",0,0,9,0,0,9,0,0
"Malta","2025-02-17",0,0,9,0,0,9,0,0
"Malta","2025-02-18",0,0,9,0,0,9,0,0
"Malta","2025-02-19",0,0,9,0,0,9,0,0
"Malta","2025-02-20",0,0,9,0,0,9,0,0
"Malta","2025-02-21",0,0,9,0,0,9,0,0
"Malta","2025-02-22",0,0,9,0,0,9,0,0
"Malta","2025-02-23",0,0,9,0,0,9,0,0
"Malta","2025-02-24",0,0,9,0,0,9,0,0
"Malta","2025-02-25",0,0,9,0,0,9,0,0
"Malta","2025-02-26",0,0,9,0,0,9,0,0
"Malta","2025-02-27",0,0,9,0,0,9,0,0
"Malta","2025-02-28",0,0,9,0,0,9,0,0
"Malta","2025-03-01",0,0,9,0,0,9,0,0
"Malta","2025-03-02",0,0,9,0,0,9,0,0
"Malta","2025-03-03",0,0,9,0,0,9,0,0
"Martinique","2024-01-01",0,0,0,0,0,0,0,0
"Martinique","2024-01-02",0,0,0,0,0,0,0,0
"Martinique","2024-01-03",0,0,0,0,0,0,0,0
"Martinique","2024-01-04",0,0,0,0,0,0,0,0
"Martinique","2024-01-05",0,0,0,0,0,0,0,0
"Martinique","2024-01-06",0,0,0,0,0,0,0,0
"Martinique","2024-01-07",0,0,0,0,0,0,0,0
"Martinique","2024-01-08",0,0,0,0,0,0,0,0
"Martinique","2024-01-09",0,0,0,0,0,0,0,0
"Martinique","2024-01-10",0,0,0,0,0,0,0,0
"Martinique","2024-01-11",0,0,0,0,0,0,0,0
"Martinique","2024-01-12",0,0,0,0,0,0,0,0
"Martinique","2024-01-13",0,0,0,0,0,0,0,0
"Martinique","2024-01-14",0,0,0,0,0,0,0,0
"Martinique","2024-01-15",0,0,0,0,0,0,0,0
"Martinique","2024-01-16",0,0,0,0,0,0,0,0
"Martinique","2024-01-17",0,0,0,0,0,0,0,0
"Martinique","2024-01-18",0,0,0,0,0,0,0,0
"Martinique","2024-01-19",0,0,0,0,0,0,0,0
"Martinique","2024-01-20",0,0,0,0,0,0,0,0
"Martinique","2024-01-21",0,0,0,0,0,0,0,0
"Martinique","2024-01-22",0,0,0,0,0,0,0,0
"Martinique","2024-01-23",0,0,0,0,0,0,0,0
"Martinique","2024-01-24",0,0,0,0,0,0,0,0
"Martinique","2024-01-25",0,0,0,0,0,0,0,0
"Martinique","2024-01-26",0,0,0,0,0,0,0,0
"Martinique","2024-01-27",0,0,0,0,0,0,0,0
"Martinique","2024-01-28",0,0,0,0,0,0,0,0
"Martinique","2024-01-29",0,0,0,0,0,0,0,0
"Martinique","2024-01-30",0,0,0,0,0,0,0,0
"Martinique","2024-01-31",0,0,0,0,0,0,0,0
"Martinique","2024-02-01",0,0,0,0,0,0,0,0
"Martinique","2024-02-02",0,0,0,0,0,0,0,0
"Martinique","2024-02-03",0,0,0,0,0,0,0,0
"Martinique","2024-02-04",0,0,0,0,0,0,0,0
"Martinique","2024-02-05",0,0,0,0,0,0,0,0
"Martinique","2024-02-06",0,0,0,0,0,0,0,0
"Martinique","2024-02-07",0,0,0,0,0,0,0,0
"Martinique","2024-02-08",0,0,0,0,0,0,0,0
"Martinique","2024-02-09",0,0,0,0,0,0,0,0
"Martinique","2024-02-10",0,0,0,0,0,0,0,0
"Martinique","2024-02-11",0,0,0,0,0,0,0,0
"Martinique","2024-02-12",0,0,0,0,0,0,0,0
"Martinique","2024-02-13",0,0,0,0,0,0,0,0
"Martinique","2024-02-14",0,0,0,0,0,0,0,0
"Martinique","2024-02-15",0,0,0,0,0,0,0,0
"Martinique","2024-02-16",0,0,0,0,0,0,0,0
"Martinique","2024-02-17",0,0,0,0,0,0,0,0
"Martinique","2024-02-18",0,0,0,0,0,0,0,0
"Martinique","2024-02-19",0,0,0,0,0,0,0,0
"Martinique","2024-02-20",0,0,0,0,0,0,0,0
"Martinique","2024-02-21",0,0,0,0,0,0,0,0
"Martinique","2024-02-22",0,0,0,0,0,0,0,0
"Martinique","2024-02-23",0,0,0,0,0,0,0,0
"Martinique","2024-02-24",0,0,0,0,0,0,0,0
"Martinique","2024-02-25",0,0,0,0,0,0,0,0
"Martinique","2024-02-26",0,0,0,0,0,0,0,0
"Martinique","2024-02-27",0,0,0,0,0,0,0,0
"Martinique","2024-02-28",0,0,0,0,0,0,0,0
"Martinique","2024-02-29",0,0,0,0,0,0,0,0
"Martinique","2024-03-01",0,0,0,0,0,0,0,0
"Martinique","2024-03-02",0,0,0,0,0,0,0,0
"Martinique","2024-03-03",0,0,0,0,0,0,0,0
"Martinique","2024-03-04",0,0,0,0,0,0,0,0
"Martinique","2024-03-05",0,0,0,0,0,0,0,0
"Martinique","2024-03-06",0,0,0,0,0,0,0,0
"Martinique","2024-03-07",0,0,0,0,0,0,0,0
"Martinique","2024-03-08",0,0,0,0,0,0,0,0
"Martinique","2024-03-09",0,0,0,0,0,0,0,0
"Martinique","2024-03-10",0,0,0,0,0,0,0,0
"Martinique","2024-03-11",0,0,0,0,0,0,0,0
"Martinique","2024-03-12",0,0,0,0,0,0,0,0
"Martinique","2024-03-13",0,0,0,0,0,0,0,0
"Martinique","2024-03-14",0,0,0,0,0,0,0,0
"Martinique","2024-03-15",0,0,0,0,0,0,0,0
"Martinique","2024-03-16",0,0,0,0,0,0,0,0
"Martinique","2024-03-17",0,0,0,0,0,0,0,0
"Martinique","2024-03-18",0,0,0,0,0,0,0,0
"Martinique","2024-03-19",0,0,0,0,0,0,0,0
"Martinique","2024-03-20",0,0,0,0,0,0,0,0
"Martinique","2024-03-21",0,0,0,0,0,0,0,0
"Martinique","2024-03-22",0,0,0,0,0,0,0,0
"Martinique","2024-03-23",0,0,0,0,0,0,0,0
"Martinique","2024-03-24",0,0,0,0,0,0,0,0
"Martinique","2024-03-25",0,0,0,0,0,0,0,0
"Martinique","2024-03-26",0,0,0,0,0,0,0,0
"Martinique","2024-03-27",0,0,0,0,0,0,0,0
"Martinique","2024-03-28",0,0,0,0,0,0,0,0
"Martinique","2024-03-29",0,0,0,0,0,0,0,0
"Martinique","2024-03-30",0,0,0,0,0,0,0,0
"Martinique","2024-03-31",0,0,0,0,0,0,0,0
"Martinique","2024-04-01",0,0,0,0,0,0,0,0
"Martinique","2024-04-02",0,0,0,0,0,0,0,0
"Martinique","2024-04-03",0,0,0,0,0,0,0,0
"Martinique","2024-04-04",0,0,0,0,0,0,0,0
"Martinique","2024-04-05",0,0,0,0,0,0,0,0
"Martinique","2024-04-06",0,0,0,0,0,0,0,0
"Martinique","2024-04-07",0,0,0,0,0,0,0,0
"Martinique","2024-04-08",0,0,0,0,0,0,0,0
"Martinique","2024-04-09",0,0,0,0,0,0,0,0
"Martinique","2024-04-10",0,0,0,0,0,0,0,0
"Martinique","2024-04-11",0,0,0,0,0,0,0,0
"Martinique","2024-04-12",0,0,0,0,0,0,0,0
"Martinique","2024-04-13",0,0,0,0,0,0,0,0
"Martinique","2024-04-14",0,0,0,0,0,0,0,0
"Martinique","2024-04-15",0,0,0,0,0,0,0,0
"Martinique","2024-04-16",0,0,0,0,0,0,0,0
"Martinique","2024-04-17",0,0,0,0,0,0,0,0
"Martinique","2024-04-18",0,0,0,0,0,0,0,0
"Martinique","2024-04-19",0,0,0,0,0,0,0,0
"Martinique","2024-04-20",0,0,0,0,0,0,0,0
"Martinique","2024-04-21",0,0,0,0,0,0,0,0
"Martinique","2024-04-22",0,0,0,0,0,0,0,0
"Martinique","2024-04-23",0,0,0,0,0,0,0,0
"Martinique","2024-04-24",0,0,0,0,0,0,0,0
"Martinique","2024-04-25",0,0,0,0,0,0,0,0
"Martinique","2024-04-26",0,0,0,0,0,0,0,0
"Martinique","2024-04-27",0,0,0,0,0,0,0,0
"Martinique","2024-04-28",0,0,0,0,0,0,0,0
"Martinique","2024-04-29",0,0,0,0,0,0,0,0
"Martinique","2024-04-30",0,0,0,0,0,0,0,0
"Martinique","2024-05-01",0,0,0,0,0,0,0,0
"Martinique","2024-05-02",0,0,0,0,0,0,0,0
"Martinique","2024-05-03",0,0,0,0,0,0,0,0
"Martinique","2024-05-04",0,0,0,0,0,0,0,0
"Martinique","2024-05-05",0,0,0,0,0,0,0,0
"Martinique","2024-05-06",0,0,0,0,0,0,0,0
"Martinique","2024-05-07",0,0,0,0,0,0,0,0
"Martinique","2024-05-08",0,0,0,0,0,0,0,0
"Martinique","2024-05-09",0,0,0,0,0,0,0,0
"Martinique","2024-05-10",0,0,0,0,0,0,0,0
"Martinique","2024-05-11",0,0,0,0,0,0,0,0
"Martinique","2024-05-12",0,0,0,0,0,0,0,0
"Martinique","2024-05-13",0,0,0,0,0,0,0,0
"Martinique","2024-05-14",0,0,0,0,0,0,0,0
"Martinique","2024-05-15",0,0,0,0,0,0,0,0
"Martinique","2024-05-16",0,0,0,0,0,0,0,0
"Martinique","2024-05-17",0,0,0,0,0,0,0,0
"Martinique","2024-05-18",0,0,0,0,0,0,0,0
"Martinique","2024-05-19",0,0,0,0,0,0,0,0
"Martinique","2024-05-20",0,0,0,0,0,0,0,0
"Martinique","2024-05-21",0,0,0,0,0,0,0,0
"Martinique","2024-05-22",0,0,0,0,0,0,0,0
"Martinique","2024-05-23",0,0,0,0,0,0,0,0
"Martinique","2024-05-24",0,0,0,0,0,0,0,0
"Martinique","2024-05-25",0,0,0,0,0,0,0,0
"Martinique","2024-05-26",0,0,0,0,0,0,0,0
"Martinique","2024-05-27",0,0,0,0,0,0,0,0
"Martinique","2024-05-28",0,0,0,0,0,0,0,0
"Martinique","2024-05-29",0,0,0,0,0,0,0,0
"Martinique","2024-05-30",0,0,0,0,0,0,0,0
"Martinique","2024-05-31",0,0,0,0,0,0,0,0
"Martinique","2024-06-01",0,0,0,0,0,0,0,0
"Martinique","2024-06-02",0,0,0,0,0,0,0,0
"Martinique","2024-06-03",0,0,0,0,0,0,0,0
"Martinique","2024-06-04",0,0,0,0,0,0,0,0
"Martinique","2024-06-05",0,0,0,0,0,0,0,0
"Martinique","2024-06-06",0,0,0,0,0,0,0,0
"Martinique","2024-06-07",0,0,0,0,0,0,0,0
"Martinique","2024-06-08",0,0,0,0,0,0,0,0
"Martinique","2024-06-09",0,0,0,0,0,0,0,0
"Martinique","2024-06-10",0,0,0,0,0,0,0,0
"Martinique","2024-06-11",0,0,0,0,0,0,0,0
"Martinique","2024-06-12",0,0,0,0,0,0,0,0
"Martinique","2024-06-13",0,0,0,0,0,0,0,0
"Martinique","2024-06-14",0,0,0,0,0,0,0,0
"Martinique","2024-06-15",0,0,0,0,0,0,0,0
"Martinique","2024-06-16",0,0,0,0,0,0,0,0
"Martinique","2024-06-17",0,0,0,0,0,0,0,0
"Martinique","2024-06-18",0,0,0,0,0,0,0,0
"Martinique","2024-06-19",0,0,0,0,0,0,0,0
"Martinique","2024-06-20",0,0,0,0,0,0,0,0
"Martinique","2024-06-21",0,0,0,0,0,0,0,0
"Martinique","2024-06-22",0,0,0,0,0,0,0,0
"Martinique","2024-06-23",0,0,0,0,0,0,0,0
"Martinique","2024-06-24",0,0,0,0,0,0,0,0
"Martinique","2024-06-25",0,0,0,0,0,0,0,0
"Martinique","2024-06-26",0,0,0,0,0,0,0,0
"Martinique","2024-06-27",0,0,0,0,0,0,0,0
"Martinique","2024-06-28",0,0,0,0,0,0,0,0
"Martinique","2024-06-29",0,0,0,0,0,0,0,0
"Martinique","2024-06-30",0,0,0,0,0,0,0,0
"Martinique","2024-07-01",0,0,0,0,0,0,0,0
"Martinique","2024-07-02",0,0,0,0,0,0,0,0
"Martinique","2024-07-03",0,0,0,0,0,0,0,0
"Martinique","2024-07-04",0,0,0,0,0,0,0,0
"Martinique","2024-07-05",0,0,0,0,0,0,0,0
"Martinique","2024-07-06",0,0,0,0,0,0,0,0
"Martinique","2024-07-07",0,0,0,0,0,0,0,0
"Martinique","2024-07-08",0,0,0,0,0,0,0,0
"Martinique","2024-07-09",0,0,0,0,0,0,0,0
"Martinique","2024-07-10",0,0,0,0,0,0,0,0
"Martinique","2024-07-11",0,0,0,0,0,0,0,0
"Martinique","2024-07-12",0,0,0,0,0,0,0,0
"Martinique","2024-07-13",0,0,0,0,0,0,0,0
"Martinique","2024-07-14",0,0,0,0,0,0,0,0
"Martinique","2024-07-15",0,0,0,0,0,0,0,0
"Martinique","2024-07-16",0,0,0,0,0,0,0,0
"Martinique","2024-07-17",0,0,0,0,0,0,0,0
"Martinique","2024-07-18",0,0,0,0,0,0,0,0
"Martinique","2024-07-19",0,0,0,0,0,0,0,0
"Martinique","2024-07-20",0,0,0,0,0,0,0,0
"Martinique","2024-07-21",0,0,0,0,0,0,0,0
"Martinique","2024-07-22",0,0,0,0,0,0,0,0
"Martinique","2024-07-23",0,0,0,0,0,0,0,0
"Martinique","2024-07-24",0,0,0,0,0,0,0,0
"Martinique","2024-07-25",0,0,0,0,0,0,0,0
"Martinique","2024-07-26",0,0,0,0,0,0,0,0
"Martinique","2024-07-27",0,0,0,0,0,0,0,0
"Martinique","2024-07-28",0,0,0,0,0,0,0,0
"Martinique","2024-07-29",0,0,0,0,0,0,0,0
"Martinique","2024-07-30",0,0,0,0,0,0,0,0
"Martinique","2024-07-31",0,0,0,0,0,0,0,0
"Martinique","2024-08-01",0,0,0,0,0,0,0,0
"Martinique","2024-08-02",0,0,0,0,0,0,0,0
"Martinique","2024-08-03",0,0,0,0,0,0,0,0
"Martinique","2024-08-04",0,0,0,0,0,0,0,0
"Martinique","2024-08-05",0,0,0,0,0,0,0,0
"Martinique","2024-08-06",0,0,0,0,0,0,0,0
"Martinique","2024-08-07",0,0,0,0,0,0,0,0
"Martinique","2024-08-08",0,0,0,0,0,0,0,0
"Martinique","2024-08-09",0,0,0,0,0,0,0,0
"Martinique","2024-08-10",0,0,0,0,0,0,0,0
"Martinique","2024-08-11",0,0,0,0,0,0,0,0
"Martinique","2024-08-12",0,0,0,0,0,0,0,0
"Martinique","2024-08-13",0,0,0,0,0,0,0,0
"Martinique","2024-08-14",0,0,0,0,0,0,0,0
"Martinique","2024-08-15",0,0,0,0,0,0,0,0
"Martinique","2024-08-16",0,0,0,0,0,0,0,0
"Martinique","2024-08-17",0,0,0,0,0,0,0,0
"Martinique","2024-08-18",0,0,0,0,0,0,0,0
"Martinique","2024-08-19",0,0,0,0,0,0,0,0
"Martinique","2024-08-20",0,0,0,0,0,0,0,0
"Martinique","2024-08-21",0,0,0,0,0,0,0,0
"Martinique","2024-08-22",0,0,0,0,0,0,0,0
"Martinique","2024-08-23",0,0,0,0,0,0,0,0
"Martinique","2024-08-24",0,0,0,0,0,0,0,0
"Martinique","2024-08-25",0,0,0,0,0,0,0,0
"Martinique","2024-08-26",0,0,0,0,0,0,0,0
"Martinique","2024-08-27",0,0,0,0,0,0,0,0
"Martinique","2024-08-28",0,0,0,0,0,0,0,0
"Martinique","2024-08-29",0,0,0,0,0,0,0,0
"Martinique","2024-08-30",0,0,0,0,0,0,0,0
"Martinique","2024-08-31",0,0,0,0,0,0,0,0
"Martinique","2024-09-01",0,0,0,0,0,0,0,0
"Martinique","2024-09-02",0,0,0,0,0,0,0,0
"Martinique","2024-09-03",0,0,0,0,0,0,0,0
"Martinique","2024-09-04",0,0,0,0,0,0,0,0
"Martinique","2024-09-05",0,0,0,0,0,0,0,0
"Martinique","2024-09-06",0,0,0,0,0,0,0,0
"Martinique","2024-09-07",0,0,0,0,0,0,0,0
"Martinique","2024-09-08",0,0,0,0,0,0,0,0
"Martinique","2024-09-09",0,0,0,0,0,0,0,0
"Martinique","2024-09-10",0,0,0,0,0,0,0,0
"Martinique","2024-09-11",0,0,0,0,0,0,0,0
"Martinique","2024-09-12",0,0,0,0,0,0,0,0
"Martinique","2024-09-13",0,0,0,0,0,0,0,0
"Martinique","2024-09-14",0,0,0,0,0,0,0,0
"Martinique","2024-09-15",0,0,0,0,0,0,0,0
"Martinique","2024-09-16",0,0,0,0,0,0,0,0
"Martinique","2024-09-17",0,0,0,0,0,0,0,0
"Martinique","2024-09-18",0,0,0,0,0,0,0,0
"Martinique","2024-09-19",0,0,0,0,0,0,0,0
"Martinique","2024-09-20",0,0,0,0,0,0,0,0
"Martinique","2024-09-21",0,0,0,0,0,0,0,0
"Martinique","2024-09-22",0,0,0,0,0,0,0,0
"Martinique","2024-09-23",0,0,0,0,0,0,0,0
"Martinique","2024-09-24",0,0,0,0,0,0,0,0
"Martinique","2024-09-25",0,0,0,0,0,0,0,0
"Martinique","2024-09-26",0,0,0,0,0,0,0,0
"Martinique","2024-09-27",0,0,0,0,0,0,0,0
"Martinique","2024-09-28",0,0,0,0,0,0,0,0
"Martinique","2024-09-29",0,0,0,0,0,0,0,0
"Martinique","2024-09-30",0,0,0,0,0,0,0,0
"Martinique","2024-10-01",0,0,0,0,0,0,0,0
"Martinique","2024-10-02",0,0,0,0,0,0,0,0
"Martinique","2024-10-03",0,0,0,0,0,0,0,0
"Martinique","2024-10-04",0,0,0,0,0,0,0,0
"Martinique","2024-10-05",0,0,0,0,0,0,0,0
"Martinique","2024-10-06",0,0,0,0,0,0,0,0
"Martinique","2024-10-07",0,0,0,0,0,0,0,0
"Martinique","2024-10-08",0,0,0,0,0,0,0,0
"Martinique","2024-10-09",0,0,0,0,0,0,0,0
"Martinique","2024-10-10",0,0,0,0,0,0,0,0
"Martinique","2024-10-11",0,0,0,0,0,0,0,0
"Martinique","2024-10-12",0,0,0,0,0,0,0,0
"Martinique","2024-10-13",0,0,0,0,0,0,0,0
"Martinique","2024-10-14",0,0,0,0,0,0,0,0
"Martinique","2024-10-15",0,0,0,0,0,0,0,0
"Martinique","2024-10-16",0,0,0,0,0,0,0,0
"Martinique","2024-10-17",0,0,0,0,0,0,0,0
"Martinique","2024-10-18",0,0,0,0,0,0,0,0
"Martinique","2024-10-19",0,0,0,0,0,0,0,0
"Martinique","2024-10-20",0,0,0,0,0,0,0,0
"Martinique","2024-10-21",0,0,0,0,0,0,0,0
"Martinique","2024-10-22",0,0,0,0,0,0,0,0
"Martinique","2024-10-23",0,0,0,0,0,0,0,0
"Martinique","2024-10-24",0,0,0,0,0,0,0,0
"Martinique","2024-10-25",0,0,0,0,0,0,0,0
"Martinique","2024-10-26",0,0,0,0,0,0,0,0
"Martinique","2024-10-27",0,0,0,0,0,0,0,0
"Martinique","2024-10-28",0,0,0,0,0,0,0,0
"Martinique","2024-10-29",0,0,0,0,0,0,0,0
"Martinique","2024-10-30",0,0,0,0,0,0,0,0
"Martinique","2024-10-31",0,0,0,0,0,0,0,0
"Martinique","2024-11-01",0,0,0,0,0,0,0,0
"Martinique","2024-11-02",0,0,0,0,0,0,0,0
"Martinique","2024-11-03",0,0,0,0,0,0,0,0
"Martinique","2024-11-04",0,0,0,0,0,0,0,0
"Martinique","2024-11-05",0,0,0,0,0,0,0,0
"Martinique","2024-11-06",0,0,0,0,0,0,0,0
"Martinique","2024-11-07",0,0,0,0,0,0,0,0
"Martinique","2024-11-08",0,0,0,0,0,0,0,0
"Martinique","2024-11-09",0,0,0,0,0,0,0,0
"Martinique","2024-11-10",0,0,0,0,0,0,0,0
"Martinique","2024-11-11",0,0,0,0,0,0,0,0
"Martinique","2024-11-12",0,0,0,0,0,0,0,0
"Martinique","2024-11-13",0,0,0,0,0,0,0,0
"Martinique","2024-11-14",0,0,0,0,0,0,0,0
"Martinique","2024-11-15",0,0,0,0,0,0,0,0
"Martinique","2024-11-16",0,0,0,0,0,0,0,0
"Martinique","2024-11-17",0,0,0,0,0,0,0,0
"Martinique","2024-11-18",0,0,0,0,0,0,0,0
"Martinique","2024-11-19",0,0,0,0,0,0,0,0
"Martinique","2024-11-20",0,0,0,0,0,0,0,0
"Martinique","2024-11-21",0,0,0,0,0,0,0,0
"Martinique","2024-11-22",0,0,0,0,0,0,0,0
"Martinique","2024-11-23",0,0,0,0,0,0,0,0
"Martinique","2024-11-24",0,0,0,0,0,0,0,0
"Martinique","2024-11-25",0,0,0,0,0,0,0,0
"Martinique","2024-11-26",0,0,0,0,0,0,0,0
"Martinique","2024-11-27",0,0,0,0,0,0,0,0
"Martinique","2024-11-28",0,0,0,0,0,0,0,0
"Martinique","2024-11-29",0,0,0,0,0,0,0,0
"Martinique","2024-11-30",0,0,0,0,0,0,0,0
"Martinique","2024-12-01",0,0,0,0,0,0,0,0
"Martinique","2024-12-02",0,0,0,0,0,0,0,0
"Martinique","2024-12-03",0,0,0,0,0,0,0,0
"Martinique","2024-12-04",0,0,0,0,0,0,0,0
"Martinique","2024-12-05",0,0,0,0,0,0,0,0
"Martinique","2024-12-06",0,0,0,0,0,0,0,0
"Martinique","2024-12-07",0,0,0,0,0,0,0,0
"Martinique","2024-12-08",0,0,0,0,0,0,0,0
"Martinique","2024-12-09",0,0,0,0,0,0,0,0
"Martinique","2024-12-10",0,0,0,0,0,0,0,0
"Martinique","2024-12-11",0,0,0,0,0,0,0,0
"Martinique","2024-12-12",0,0,0,0,0,0,0,0
"Martinique","2024-12-13",0,0,0,0,0,0,0,0
"Martinique","2024-12-14",0,0,0,0,0,0,0,0
"Martinique","2024-12-15",0,0,0,0,0,0,0,0
"Martinique","2024-12-16",0,0,0,0,0,0,0,0
"Martinique","2024-12-17",0,0,0,0,0,0,0,0
"Martinique","2024-12-18",0,0,0,0,0,0,0,0
"Martinique","2024-12-19",0,0,0,0,0,0,0,0
"Martinique","2024-12-20",0,0,0,0,0,0,0,0
"Martinique","2024-12-21",0,0,0,0,0,0,0,0
"Martinique","2024-12-22",0,0,0,0,0,0,0,0
"Martinique","2024-12-23",0,0,0,0,0,0,0,0
"Martinique","2024-12-24",0,0,0,0,0,0,0,0
"Martinique","2024-12-25",0,0,0,0,0,0,0,0
"Martinique","2024-12-26",0,0,0,0,0,0,0,0
"Martinique","2024-12-27",0,0,0,0,0,0,0,0
"Martinique","2024-12-28",0,0,0,0,0,0,0,0
"Martinique","2024-12-29",0,0,0,0,0,0,0,0
"Martinique","2024-12-30",0,0,0,0,0,0,0,0
"Martinique","2024-12-31",0,0,0,0,0,0,0,0
"Martinique","2025-01-01",0,0,0,0,0,0,0,0
"Martinique","2025-01-02",0,0,0,0,0,0,0,0
"Martinique","2025-01-03",0,0,0,0,0,0,0,0
"Martinique","2025-01-04",0,0,0,0,0,0,0,0
"Martinique","2025-01-05",0,0,0,0,0,0,0,0
"Martinique","2025-01-06",0,0,0,0,0,0,0,0
"Martinique","2025-01-07",0,0,0,0,0,0,0,0
"Martinique","2025-01-08",0,0,0,0,0,0,0,0
"Martinique","2025-01-09",0,0,0,0,0,0,0,0
"Martinique","2025-01-10",0,0,0,0,0,0,0,0
"Martinique","2025-01-11",0,0,0,0,0,0,0,0
"Martinique","2025-01-12",0,0,0,0,0,0,0,0
"Martinique","2025-01-13",0,0,0,0,0,0,0,0
"Martinique","2025-01-14",0,0,0,0,0,0,0,0
"Martinique","2025-01-15",0,0,0,0,0,0,0,0
"Martinique","2025-01-16",0,0,0,0,0,0,0,0
"Martinique","2025-01-17",0,0,0,0,0,0,0,0
"Martinique","2025-01-18",0,0,0,0,0,0,0,0
"Martinique","2025-01-19",0,0,0,0,0,0,0,0
"Martinique","2025-01-20",0,0,0,0,0,0,0,0
"Martinique","2025-01-21",0,0,0,0,0,0,0,0
"Martinique","2025-01-22",0,0,0,0,0,0,0,0
"Martinique","2025-01-23",0,0,0,0,0,0,0,0
"Martinique","2025-01-24",0,0,0,0,0,0,0,0
"Martinique","2025-01-25",0,0,0,0,0,0,0,0
"Martinique","2025-01-26",0,0,0,0,0,0,0,0
"Martinique","2025-01-27",0,0,0,0,0,0,0,0
"Martinique","2025-01-28",0,0,0,0,0,0,0,0
"Martinique","2025-01-29",0,0,0,0,0,0,0,0
"Martinique","2025-01-30",0,0,0,0,0,0,0,0
"Martinique","2025-01-31",0,0,0,0,0,0,0,0
"Martinique","2025-02-01",0,0,0,0,0,0,0,0
"Martinique","2025-02-02",0,0,0,0,0,0,0,0
"Martinique","2025-02-03",0,0,0,0,0,0,0,0
"Martinique","2025-02-04",0,0,0,0,0,0,0,0
"Martinique","2025-02-05",0,0,0,0,0,0,0,0
"Martinique","2025-02-06",0,0,0,0,0,0,0,0
"Martinique","2025-02-07",0,0,0,0,0,0,0,0
"Martinique","2025-02-08",0,0,0,0,0,0,0,0
"Martinique","2025-02-09",0,0,0,0,0,0,0,0
"Martinique","2025-02-10",0,0,0,0,0,0,0,0
"Martinique","2025-02-11",0,0,0,0,0,0,0,0
"Martinique","2025-02-12",0,0,0,0,0,0,0,0
"Martinique","2025-02-13",0,0,0,0,0,0,0,0
"Martinique","2025-02-14",0,0,0,0,0,0,0,0
"Martinique","2025-02-15",0,0,0,0,0,0,0,0
"Martinique","2025-02-16",0,0,0,0,0,0,0,0
"Martinique","2025-02-17",0,0,0,0,0,0,0,0
"Martinique","2025-02-18",0,0,0,0,0,0,0,0
"Martinique","2025-02-19",0,0,0,0,0,0,0,0
"Martinique","2025-02-20",0,0,0,0,0,0,0,0
"Martinique","2025-02-21",0,0,0,0,0,0,0,0
"Martinique","2025-02-22",0,0,0,0,0,0,0,0
"Martinique","2025-02-23",0,0,0,0,0,0,0,0
"Martinique","2025-02-24",0,0,0,0,0,0,0,0
"Martinique","2025-02-25",0,0,0,0,0,0,0,0
"Martinique","2025-02-26",0,0,0,0,0,0,0,0
"Martinique","2025-02-27",0,0,0,0,0,0,0,0
"Martinique","2025-02-28",0,0,0,0,0,0,0,0
"Martinique","2025-03-01",0,0,0,0,0,0,0,0
"Martinique","2025-03-02",0,0,0,0,0,0,0,0
"Martinique","2025-03-03",0,0,0,0,0,0,0,0
"Mauritius","2024-01-01",0,0,0,0,0,0,0,0
"Mauritius","2024-01-02",0,0,0,0,0,0,0,0
"Mauritius","2024-01-03",0,0,0,0,0,0,0,0
"Mauritius","2024-01-04",0,0,0,0,0,0,0,0
"Mauritius","2024-01-05",0,0,0,0,0,0,0,0
"Mauritius","2024-01-06",0,0,0,0,0,0,0,0
"Mauritius","2024-01-07",0,0,0,0,0,0,0,0
"Mauritius","2024-01-08",0,0,0,0,0,0,0,0
"Mauritius","2024-01-09",0,0,0,0,0,0,0,0
"Mauritius","2024-01-10",0,0,0,0,0,0,0,0
"Mauritius","2024-01-11",0,0,0,0,0,0,0,0
"Mauritius","2024-01-12",0,0,0,0,0,0,0,0
"Mauritius","2024-01-13",0,0,0,0,0,0,0,0
"Mauritius","2024-01-14",0,0,0,0,0,0,0,0
"Mauritius","2024-01-15",0,0,0,0,0,0,0,0
"Mauritius","2024-01-16",0,0,0,0,0,0,0,0
"Mauritius","2024-01-17",0,0,0,0,0,0,0,0
"Mauritius","2024-01-18",0,0,0,0,0,0,0,0
"Mauritius","2024-01-19",0,0,0,0,0,0,0,0
"Mauritius","2024-01-20",0,0,0,0,0,0,0,0
"Mauritius","2024-01-21",0,0,0,0,0,0,0,0
"Mauritius","2024-01-22",0,0,0,0,0,0,0,0
"Mauritius","2024-01-23",0,0,0,0,0,0,0,0
"Mauritius","2024-01-24",0,0,0,0,0,0,0,0
"Mauritius","2024-01-25",0,0,0,0,0,0,0,0
"Mauritius","2024-01-26",0,0,0,0,0,0,0,0
"Mauritius","2024-01-27",0,0,0,0,0,0,0,0
"Mauritius","2024-01-28",0,0,0,0,0,0,0,0
"Mauritius","2024-01-29",0,0,0,0,0,0,0,0
"Mauritius","2024-01-30",0,0,0,0,0,0,0,0
"Mauritius","2024-01-31",0,0,0,0,0,0,0,0
"Mauritius","2024-02-01",0,0,0,0,0,0,0,0
"Mauritius","2024-02-02",0,0,0,0,0,0,0,0
"Mauritius","2024-02-03",0,0,0,0,0,0,0,0
"Mauritius","2024-02-04",0,0,0,0,0,0,0,0
"Mauritius","2024-02-05",0,0,0,0,0,0,0,0
"Mauritius","2024-02-06",0,0,0,0,0,0,0,0
"Mauritius","2024-02-07",0,0,0,0,0,0,0,0
"Mauritius","2024-02-08",0,0,0,0,0,0,0,0
"Mauritius","2024-02-09",0,0,0,0,0,0,0,0
"Mauritius","2024-02-10",0,0,0,0,0,0,0,0
"Mauritius","2024-02-11",0,0,0,0,0,0,0,0
"Mauritius","2024-02-12",0,0,0,0,0,0,0,0
"Mauritius","2024-02-13",0,0,0,0,0,0,0,0
"Mauritius","2024-02-14",0,0,0,0,0,0,0,0
"Mauritius","2024-02-15",0,0,0,0,0,0,0,0
"Mauritius","2024-02-16",0,0,0,0,0,0,0,0
"Mauritius","2024-02-17",0,0,0,0,0,0,0,0
"Mauritius","2024-02-18",0,0,0,0,0,0,0,0
"Mauritius","2024-02-19",0,0,0,0,0,0,0,0
"Mauritius","2024-02-20",0,0,0,0,0,0,0,0
"Mauritius","2024-02-21",0,0,0,0,0,0,0,0
"Mauritius","2024-02-22",0,0,0,0,0,0,0,0
"Mauritius","2024-02-23",0,0,0,0,0,0,0,0
"Mauritius","2024-02-24",0,0,0,0,0,0,0,0
"Mauritius","2024-02-25",0,0,0,0,0,0,0,0
"Mauritius","2024-02-26",0,0,0,0,0,0,0,0
"Mauritius","2024-02-27",0,0,0,0,0,0,0,0
"Mauritius","2024-02-28",0,0,0,0,0,0,0,0
"Mauritius","2024-02-29",0,0,0,0,0,0,0,0
"Mauritius","2024-03-01",0,0,0,0,0,0,0,0
"Mauritius","2024-03-02",0,0,0,0,0,0,0,0
"Mauritius","2024-03-03",0,0,0,0,0,0,0,0
"Mauritius","2024-03-04",0,0,0,0,0,0,0,0
"Mauritius","2024-03-05",0,0,0,0,0,0,0,0
"Mauritius","2024-03-06",0,0,0,0,0,0,0,0
"Mauritius","2024-03-07",0,0,0,0,0,0,0,0
"Mauritius","2024-03-08",0,0,0,0,0,0,0,0
"Mauritius","2024-03-09",0,0,0,0,0,0,0,0
"Mauritius","2024-03-10",0,0,0,0,0,0,0,0
"Mauritius","2024-03-11",0,0,0,0,0,0,0,0
"Mauritius","2024-03-12",0,0,0,0,0,0,0,0
"Mauritius","2024-03-13",0,0,0,0,0,0,0,0
"Mauritius","2024-03-14",0,0,0,0,0,0,0,0
"Mauritius","2024-03-15",0,0,0,0,0,0,0,0
"Mauritius","2024-03-16",0,0,0,0,0,0,0,0
"Mauritius","2024-03-17",0,0,0,0,0,0,0,0
"Mauritius","2024-03-18",0,0,0,0,0,0,0,0
"Mauritius","2024-03-19",0,0,0,0,0,0,0,0
"Mauritius","2024-03-20",0,0,0,0,0,0,0,0
"Mauritius","2024-03-21",0,0,0,0,0,0,0,0
"Mauritius","2024-03-22",0,0,0,0,0,0,0,0
"Mauritius","2024-03-23",0,0,0,0,0,0,0,0
"Mauritius","2024-03-24",0,0,0,0,0,0,0,0
"Mauritius","2024-03-25",0,0,0,0,0,0,0,0
"Mauritius","2024-03-26",0,0,0,0,0,0,0,0
"Mauritius","2024-03-27",0,0,0,0,0,0,0,0
"Mauritius","2024-03-28",0,0,0,0,0,0,0,0
"Mauritius","2024-03-29",0,0,0,0,0,0,0,0
"Mauritius","2024-03-30",0,0,0,0,0,0,0,0
"Mauritius","2024-03-31",0,0,0,0,0,0,0,0
"Mauritius","2024-04-01",0,0,0,0,0,0,0,0
"Mauritius","2024-04-02",0,0,0,0,0,0,0,0
"Mauritius","2024-04-03",0,0,0,0,0,0,0,0
"Mauritius","2024-04-04",0,0,0,0,0,0,0,0
"Mauritius","2024-04-05",0,0,0,0,0,0,0,0
"Mauritius","2024-04-06",0,0,0,0,0,0,0,0
"Mauritius","2024-04-07",0,0,0,0,0,0,0,0
"Mauritius","2024-04-08",0,0,0,0,0,0,0,0
"Mauritius","2024-04-09",0,0,0,0,0,0,0,0
"Mauritius","2024-04-10",0,0,0,0,0,0,0,0
"Mauritius","2024-04-11",0,0,0,0,0,0,0,0
"Mauritius","2024-04-12",0,0,0,0,0,0,0,0
"Mauritius","2024-04-13",0,0,0,0,0,0,0,0
"Mauritius","2024-04-14",0,0,0,0,0,0,0,0
"Mauritius","2024-04-15",0,0,0,0,0,0,0,0
"Mauritius","2024-04-16",0,0,0,0,0,0,0,0
"Mauritius","2024-04-17",0,0,0,0,0,0,0,0
"Mauritius","2024-04-18",0,0,0,0,0,0,0,0
"Mauritius","2024-04-19",0,0,0,0,0,0,0,0
"Mauritius","2024-04-20",0,0,0,0,0,0,0,0
"Mauritius","2024-04-21",0,0,0,0,0,0,0,0
"Mauritius","2024-04-22",0,0,0,0,0,0,0,0
"Mauritius","2024-04-23",0,0,0,0,0,0,0,0
"Mauritius","2024-04-24",0,0,0,0,0,0,0,0
"Mauritius","2024-04-25",0,0,0,0,0,0,0,0
"Mauritius","2024-04-26",0,0,0,0,0,0,0,0
"Mauritius","2024-04-27",0,0,0,0,0,0,0,0
"Mauritius","2024-04-28",0,0,0,0,0,0,0,0
"Mauritius","2024-04-29",0,0,0,0,0,0,0,0
"Mauritius","2024-04-30",0,0,0,0,0,0,0,0
"Mauritius","2024-05-01",0,0,0,0,0,0,0,0
"Mauritius","2024-05-02",0,0,0,0,0,0,0,0
"Mauritius","2024-05-03",0,0,0,0,0,0,0,0
"Mauritius","2024-05-04",0,0,0,0,0,0,0,0
"Mauritius","2024-05-05",0,0,0,0,0,0,0,0
"Mauritius","2024-05-06",0,0,0,0,0,0,0,0
"Mauritius","2024-05-07",0,0,0,0,0,0,0,0
"Mauritius","2024-05-08",0,0,0,0,0,0,0,0
"Mauritius","2024-05-09",0,0,0,0,0,0,0,0
"Mauritius","2024-05-10",0,0,0,0,0,0,0,0
"Mauritius","2024-05-11",0,0,0,0,0,0,0,0
"Mauritius","2024-05-12",0,0,0,0,0,0,0,0
"Mauritius","2024-05-13",0,0,0,0,0,0,0,0
"Mauritius","2024-05-14",0,0,0,0,0,0,0,0
"Mauritius","2024-05-15",0,0,0,0,0,0,0,0
"Mauritius","2024-05-16",0,0,0,0,0,0,0,0
"Mauritius","2024-05-17",0,0,0,0,0,0,0,0
"Mauritius","2024-05-18",0,0,0,0,0,0,0,0
"Mauritius","2024-05-19",0,0,0,0,0,0,0,0
"Mauritius","2024-05-20",0,0,0,0,0,0,0,0
"Mauritius","2024-05-21",0,0,0,0,0,0,0,0
"Mauritius","2024-05-22",0,0,0,0,0,0,0,0
"Mauritius","2024-05-23",0,0,0,0,0,0,0,0
"Mauritius","2024-05-24",0,0,0,0,0,0,0,0
"Mauritius","2024-05-25",0,0,0,0,0,0,0,0
"Mauritius","2024-05-26",0,0,0,0,0,0,0,0
"Mauritius","2024-05-27",0,0,0,0,0,0,0,0
"Mauritius","2024-05-28",0,0,0,0,0,0,0,0
"Mauritius","2024-05-29",0,0,0,0,0,0,0,0
"Mauritius","2024-05-30",0,0,0,0,0,0,0,0
"Mauritius","2024-05-31",0,0,0,0,0,0,0,0
"Mauritius","2024-06-01",0,0,0,0,0,0,0,0
"Mauritius","2024-06-02",0,0,0,0,0,0,0,0
"Mauritius","2024-06-03",0,0,0,0,0,0,0,0
"Mauritius","2024-06-04",0,0,0,0,0,0,0,0
"Mauritius","2024-06-05",0,0,0,0,0,0,0,0
"Mauritius","2024-06-06",0,0,0,0,0,0,0,0
"Mauritius","2024-06-07",0,0,0,0,0,0,0,0
"Mauritius","2024-06-08",0,0,0,0,0,0,0,0
"Mauritius","2024-06-09",0,0,0,0,0,0,0,0
"Mauritius","2024-06-10",0,0,0,0,0,0,0,0
"Mauritius","2024-06-11",0,0,0,0,0,0,0,0
"Mauritius","2024-06-12",0,0,0,0,0,0,0,0
"Mauritius","2024-06-13",0,0,0,0,0,0,0,0
"Mauritius","2024-06-14",0,0,0,0,0,0,0,0
"Mauritius","2024-06-15",0,0,0,0,0,0,0,0
"Mauritius","2024-06-16",0,0,0,0,0,0,0,0
"Mauritius","2024-06-17",0,0,0,0,0,0,0,0
"Mauritius","2024-06-18",0,0,0,0,0,0,0,0
"Mauritius","2024-06-19",0,0,0,0,0,0,0,0
"Mauritius","2024-06-20",0,0,0,0,0,0,0,0
"Mauritius","2024-06-21",0,0,0,0,0,0,0,0
"Mauritius","2024-06-22",0,0,0,0,0,0,0,0
"Mauritius","2024-06-23",0,0,0,0,0,0,0,0
"Mauritius","2024-06-24",0,0,0,0,0,0,0,0
"Mauritius","2024-06-25",0,0,0,0,0,0,0,0
"Mauritius","2024-06-26",0,0,0,0,0,0,0,0
"Mauritius","2024-06-27",0,0,0,0,0,0,0,0
"Mauritius","2024-06-28",0,0,0,0,0,0,0,0
"Mauritius","2024-06-29",0,0,0,0,0,0,0,0
"Mauritius","2024-06-30",0,0,0,0,0,0,0,0
"Mauritius","2024-07-01",0,0,0,0,0,0,0,0
"Mauritius","2024-07-02",0,0,0,0,0,0,0,0
"Mauritius","2024-07-03",0,0,0,0,0,0,0,0
"Mauritius","2024-07-04",0,0,0,0,0,0,0,0
"Mauritius","2024-07-05",0,0,0,0,0,0,0,0
"Mauritius","2024-07-06",0,0,0,0,0,0,0,0
"Mauritius","2024-07-07",0,0,0,0,0,0,0,0
"Mauritius","2024-07-08",0,0,0,0,0,0,0,0
"Mauritius","2024-07-09",0,0,0,0,0,0,0,0
"Mauritius","2024-07-10",0,0,0,0,0,0,0,0
"Mauritius","2024-07-11",0,0,0,0,0,0,0,0
"Mauritius","2024-07-12",0,0,0,0,0,0,0,0
"Mauritius","2024-07-13",0,0,0,0,0,0,0,0
"Mauritius","2024-07-14",0,0,0,0,0,0,0,0
"Mauritius","2024-07-15",0,0,0,0,0,0,0,0
"Mauritius","2024-07-16",0,0,0,0,0,0,0,0
"Mauritius","2024-07-17",0,0,0,0,0,0,0,0
"Mauritius","2024-07-18",0,0,0,0,0,0,0,0
"Mauritius","2024-07-19",0,0,0,0,0,0,0,0
"Mauritius","2024-07-20",0,0,0,0,0,0,0,0
"Mauritius","2024-07-21",0,0,0,0,0,0,0,0
"Mauritius","2024-07-22",0,0,0,0,0,0,0,0
"Mauritius","2024-07-23",0,0,0,0,0,0,0,0
"Mauritius","2024-07-24",0,0,0,0,0,0,0,0
"Mauritius","2024-07-25",0,0,0,0,0,0,0,0
"Mauritius","2024-07-26",0,0,0,0,0,0,0,0
"Mauritius","2024-07-27",0,0,0,0,0,0,0,0
"Mauritius","2024-07-28",0,0,0,0,0,0,0,0
"Mauritius","2024-07-29",0,0,0,0,0,0,0,0
"Mauritius","2024-07-30",0,0,0,0,0,0,0,0
"Mauritius","2024-07-31",0,0,0,0,0,0,0,0
"Mauritius","2024-08-01",0,0,0,0,0,0,0,0
"Mauritius","2024-08-02",0,0,0,0,0,0,0,0
"Mauritius","2024-08-03",0,0,0,0,0,0,0,0
"Mauritius","2024-08-04",0,0,0,0,0,0,0,0
"Mauritius","2024-08-05",0,0,0,0,0,0,0,0
"Mauritius","2024-08-06",0,0,0,0,0,0,0,0
"Mauritius","2024-08-07",0,0,0,0,0,0,0,0
"Mauritius","2024-08-08",0,0,0,0,0,0,0,0
"Mauritius","2024-08-09",0,0,0,0,0,0,0,0
"Mauritius","2024-08-10",0,0,0,0,0,0,0,0
"Mauritius","2024-08-11",0,0,0,0,0,0,0,0
"Mauritius","2024-08-12",0,0,0,0,0,0,0,0
"Mauritius","2024-08-13",0,0,0,0,0,0,0,0
"Mauritius","2024-08-14",0,0,0,0,0,0,0,0
"Mauritius","2024-08-15",0,0,0,0,0,0,0,0
"Mauritius","2024-08-16",0,0,0,0,0,0,0,0
"Mauritius","2024-08-17",0,0,0,0,0,0,0,0
"Mauritius","2024-08-18",0,0,0,0,0,0,0,0
"Mauritius","2024-08-19",0,0,0,0,0,0,0,0
"Mauritius","2024-08-20",0,0,0,0,0,0,0,0
"Mauritius","2024-08-21",0,0,0,0,0,0,0,0
"Mauritius","2024-08-22",0,0,0,0,0,0,0,0
"Mauritius","2024-08-23",0,0,0,0,0,0,0,0
"Mauritius","2024-08-24",0,0,0,0,0,0,0,0
"Mauritius","2024-08-25",0,0,0,0,0,0,0,0
"Mauritius","2024-08-26",0,0,0,0,0,0,0,0
"Mauritius","2024-08-27",0,0,0,0,0,0,0,0
"Mauritius","2024-08-28",0,0,0,0,0,0,0,0
"Mauritius","2024-08-29",0,0,0,0,0,0,0,0
"Mauritius","2024-08-30",0,0,0,0,0,0,0,0
"Mauritius","2024-08-31",0,0,0,0,0,0,0,0
"Mauritius","2024-09-01",0,0,0,0,0,0,0,0
"Mauritius","2024-09-02",0,0,0,0,0,0,0,0
"Mauritius","2024-09-03",0,0,0,0,0,0,0,0
"Mauritius","2024-09-04",0,0,0,0,0,0,0,0
"Mauritius","2024-09-05",0,0,0,0,0,0,0,0
"Mauritius","2024-09-06",0,0,0,0,0,0,0,0
"Mauritius","2024-09-07",0,0,0,0,0,0,0,0
"Mauritius","2024-09-08",0,0,0,0,0,0,0,0
"Mauritius","2024-09-09",0,0,0,0,0,0,0,0
"Mauritius","2024-09-10",0,0,0,0,0,0,0,0
"Mauritius","2024-09-11",0,0,0,0,0,0,0,0
"Mauritius","2024-09-12",0,0,0,0,0,0,0,0
"Mauritius","2024-09-13",0,0,0,0,0,0,0,0
"Mauritius","2024-09-14",0,0,0,0,0,0,0,0
"Mauritius","2024-09-15",0,0,0,0,0,0,0,0
"Mauritius","2024-09-16",0,0,0,0,0,0,0,0
"Mauritius","2024-09-17",0,0,0,0,0,0,0,0
"Mauritius","2024-09-18",0,0,0,0,0,0,0,0
"Mauritius","2024-09-19",0,0,0,0,0,0,0,0
"Mauritius","2024-09-20",0,0,0,0,0,0,0,0
"Mauritius","2024-09-21",0,0,0,0,0,0,0,0
"Mauritius","2024-09-22",0,0,0,0,0,0,0,0
"Mauritius","2024-09-23",0,0,0,0,0,0,0,0
"Mauritius","2024-09-24",0,0,0,0,0,0,0,0
"Mauritius","2024-09-25",0,0,0,0,0,0,0,0
"Mauritius","2024-09-26",0,0,0,0,0,0,0,0
"Mauritius","2024-09-27",0,0,0,0,0,0,0,0
"Mauritius","2024-09-28",0,0,0,0,0,0,0,0
"Mauritius","2024-09-29",0,0,0,0,0,0,0,0
"Mauritius","2024-09-30",0,0,0,0,0,0,0,0
"Mauritius","2024-10-01",0,0,0,0,0,0,0,0
"Mauritius","2024-10-02",0,0,0,0,0,0,0,0
"Mauritius","2024-10-03",0,0,0,0,0,0,0,0
"Mauritius","2024-10-04",0,0,0,0,0,0,0,0
"Mauritius","2024-10-05",0,0,0,0,0,0,0,0
"Mauritius","2024-10-06",0,0,0,0,0,0,0,0
"Mauritius","2024-10-07",0,0,0,0,0,0,0,0
"Mauritius","2024-10-08",0,0,0,0,0,0,0,0
"Mauritius","2024-10-09",0,0,0,0,0,0,0,0
"Mauritius","2024-10-10",0,0,0,0,0,0,0,0
"Mauritius","2024-10-11",0,0,0,0,0,0,0,0
"Mauritius","2024-10-12",0,0,0,0,0,0,0,0
"Mauritius","2024-10-13",0,0,0,0,0,0,0,0
"Mauritius","2024-10-14",0,0,0,0,0,0,0,0
"Mauritius","2024-10-15",0,0,0,0,0,0,0,0
"Mauritius","2024-10-16",0,0,0,0,0,0,0,0
"Mauritius","2024-10-17",0,0,0,0,0,0,0,0
"Mauritius","2024-10-18",0,0,0,0,0,0,0,0
"Mauritius","2024-10-19",0,0,0,0,0,0,0,0
"Mauritius","2024-10-20",0,0,0,0,0,0,0,0
"Mauritius","2024-10-21",0,0,0,0,0,0,0,0
"Mauritius","2024-10-22",0,0,0,0,0,0,0,0
"Mauritius","2024-10-23",0,0,0,0,0,0,0,0
"Mauritius","2024-10-24",0,0,0,0,0,0,0,0
"Mauritius","2024-10-25",0,0,0,0,0,0,0,0
"Mauritius","2024-10-26",0,0,0,0,0,0,0,0
"Mauritius","2024-10-27",0,1,1,0,1,1,0,0
"Mauritius","2024-10-28",0,0,1,0,0,1,0,0
"Mauritius","2024-10-29",0,0,1,0,0,1,0,0
"Mauritius","2024-10-30",0,0,1,0,0,1,0,0
"Mauritius","2024-10-31",0,0,1,0,0,1,0,0
"Mauritius","2024-11-01",0,0,1,0,0,1,0,0
"Mauritius","2024-11-02",0,0,1,0,0,1,0,0
"Mauritius","2024-11-03",0,0,1,0,0,1,0,0
"Mauritius","2024-11-04",0,0,1,0,0,1,0,0
"Mauritius","2024-11-05",0,0,1,0,0,1,0,0
"Mauritius","2024-11-06",0,0,1,0,0,1,0,0
"Mauritius","2024-11-07",0,0,1,0,0,1,0,0
"Mauritius","2024-11-08",0,0,1,0,0,1,0,0
"Mauritius","2024-11-09",0,0,1,0,0,1,0,0
"Mauritius","2024-11-10",0,0,1,0,0,1,0,0
"Mauritius","2024-11-11",0,0,1,0,0,1,0,0
"Mauritius","2024-11-12",0,0,1,0,0,1,0,0
"Mauritius","2024-11-13",0,0,1,0,0,1,0,0
"Mauritius","2024-11-14",0,0,1,0,0,1,0,0
"Mauritius","2024-11-15",0,0,1,0,0,1,0,0
"Mauritius","2024-11-16",0,0,1,0,0,1,0,0
"Mauritius","2024-11-17",0,0,1,0,0,1,0,0
"Mauritius","2024-11-18",0,0,1,0,0,1,0,0
"Mauritius","2024-11-19",0,0,1,0,0,1,0,0
"Mauritius","2024-11-20",0,0,1,0,0,1,0,0
"Mauritius","2024-11-21",0,0,1,0,0,1,0,0
"Mauritius","2024-11-22",0,0,1,0,0,1,0,0
"Mauritius","2024-11-23",0,0,1,0,0,1,0,0
"Mauritius","2024-11-24",0,0,1,0,0,1,0,0
"Mauritius","2024-11-25",0,0,1,0,0,1,0,0
"Mauritius","2024-11-26",0,0,1,0,0,1,0,0
"Mauritius","2024-11-27",0,0,1,0,0,1,0,0
"Mauritius","2024-11-28",0,0,1,0,0,1,0,0
"Mauritius","2024-11-29",0,0,1,0,0,1,0,0
"Mauritius","2024-11-30",0,0,1,0,0,1,0,0
"Mauritius","2024-12-01",0,0,1,0,0,1,0,0
"Mauritius","2024-12-02",0,0,1,0,0,1,0,0
"Mauritius","2024-12-03",0,0,1,0,0,1,0,0
"Mauritius","2024-12-04",0,0,1,0,0,1,0,0
"Mauritius","2024-12-05",0,0,1,0,0,1,0,0
"Mauritius","2024-12-06",0,0,1,0,0,1,0,0
"Mauritius","2024-12-07",0,0,1,0,0,1,0,0
"Mauritius","2024-12-08",0,0,1,0,0,1,0,0
"Mauritius","2024-12-09",0,0,1,0,0,1,0,0
"Mauritius","2024-12-10",0,0,1,0,0,1,0,0
"Mauritius","2024-12-11",0,0,1,0,0,1,0,0
"Mauritius","2024-12-12",0,0,1,0,0,1,0,0
"Mauritius","2024-12-13",0,0,1,0,0,1,0,0
"Mauritius","2024-12-14",0,0,1,0,0,1,0,0
"Mauritius","2024-12-15",0,0,1,0,0,1,0,0
"Mauritius","2024-12-16",0,0,1,0,0,1,0,0
"Mauritius","2024-12-17",0,0,1,0,0,1,0,0
"Mauritius","2024-12-18",0,0,1,0,0,1,0,0
"Mauritius","2024-12-19",0,0,1,0,0,1,0,0
"Mauritius","2024-12-20",0,0,1,0,0,1,0,0
"Mauritius","2024-12-21",0,0,1,0,0,1,0,0
"Mauritius","2024-12-22",0,0,1,0,0,1,0,0
"Mauritius","2024-12-23",0,0,1,0,0,1,0,0
"Mauritius","2024-12-24",0,0,1,0,0,1,0,0
"Mauritius","2024-12-25",0,0,1,0,0,1,0,0
"Mauritius","2024-12-26",0,0,1,0,0,1,0,0
"Mauritius","2024-12-27",0,0,1,0,0,1,0,0
"Mauritius","2024-12-28",0,0,1,0,0,1,0,0
"Mauritius","2024-12-29",0,0,1,0,0,1,0,0
"Mauritius","2024-12-30",0,0,1,0,0,1,0,0
"Mauritius","2024-12-31",0,0,1,0,0,1,0,0
"Mauritius","2025-01-01",0,0,1,0,0,1,0,0
"Mauritius","2025-01-02",0,0,1,0,0,1,0,0
"Mauritius","2025-01-03",0,0,1,0,0,1,0,0
"Mauritius","2025-01-04",0,0,1,0,0,1,0,0
"Mauritius","2025-01-05",0,0,1,0,0,1,0,0
"Mauritius","2025-01-06",0,0,1,0,0,1,0,0
"Mauritius","2025-01-07",0,0,1,0,0,1,0,0
"Mauritius","2025-01-08",0,0,1,0,0,1,0,0
"Mauritius","2025-01-09",0,0,1,0,0,1,0,0
"Mauritius","2025-01-10",0,0,1,0,0,1,0,0
"Mauritius","2025-01-11",0,0,1,0,0,1,0,0
"Mauritius","2025-01-12",0,0,1,0,0,1,0,0
"Mauritius","2025-01-13",0,0,1,0,0,1,0,0
"Mauritius","2025-01-14",0,0,1,0,0,1,0,0
"Mauritius","2025-01-15",0,0,1,0,0,1,0,0
"Mauritius","2025-01-16",0,0,1,0,0,1,0,0
"Mauritius","2025-01-17",0,0,1,0,0,1,0,0
"Mauritius","2025-01-18",0,0,1,0,0,1,0,0
"Mauritius","2025-01-19",0,0,1,0,0,1,0,0
"Mauritius","2025-01-20",0,0,1,0,0,1,0,0
"Mauritius","2025-01-21",0,0,1,0,0,1,0,0
"Mauritius","2025-01-22",0,0,1,0,0,1,0,0
"Mauritius","2025-01-23",0,0,1,0,0,1,0,0
"Mauritius","2025-01-24",0,0,1,0,0,1,0,0
"Mauritius","2025-01-25",0,0,1,0,0,1,0,0
"Mauritius","2025-01-26",0,0,1,0,0,1,0,0
"Mauritius","2025-01-27",0,0,1,0,0,1,0,0
"Mauritius","2025-01-28",0,0,1,0,0,1,0,0
"Mauritius","2025-01-29",0,0,1,0,0,1,0,0
"Mauritius","2025-01-30",0,0,1,0,0,1,0,0
"Mauritius","2025-01-31",0,0,1,0,0,1,0,0
"Mauritius","2025-02-01",0,0,1,0,0,1,0,0
"Mauritius","2025-02-02",0,0,1,0,0,1,0,0
"Mauritius","2025-02-03",0,0,1,0,0,1,0,0
"Mauritius","2025-02-04",0,0,1,0,0,1,0,0
"Mauritius","2025-02-05",0,0,1,0,0,1,0,0
"Mauritius","2025-02-06",0,0,1,0,0,1,0,0
"Mauritius","2025-02-07",0,0,1,0,0,1,0,0
"Mauritius","2025-02-08",0,0,1,0,0,1,0,0
"Mauritius","2025-02-09",0,0,1,0,0,1,0,0
"Mauritius","2025-02-10",0,0,1,0,0,1,0,0
"Mauritius","2025-02-11",0,0,1,0,0,1,0,0
"Mauritius","2025-02-12",0,0,1,0,0,1,0,0
"Mauritius","2025-02-13",0,0,1,0,0,1,0,0
"Mauritius","2025-02-14",0,0,1,0,0,1,0,0
"Mauritius","2025-02-15",0,0,1,0,0,1,0,0
"Mauritius","2025-02-16",0,0,1,0,0,1,0,0
"Mauritius","2025-02-17",0,0,1,0,0,1,0,0
"Mauritius","2025-02-18",0,0,1,0,0,1,0,0
"Mauritius","2025-02-19",0,0,1,0,0,1,0,0
"Mauritius","2025-02-20",0,0,1,0,0,1,0,0
"Mauritius","2025-02-21",0,0,1,0,0,1,0,0
"Mauritius","2025-02-22",0,0,1,0,0,1,0,0
"Mauritius","2025-02-23",0,0,1,0,0,1,0,0
"Mauritius","2025-02-24",0,0,1,0,0,1,0,0
"Mauritius","2025-02-25",0,0,1,0,0,1,0,0
"Mauritius","2025-02-26",0,0,1,0,0,1,0,0
"Mauritius","2025-02-27",0,0,1,0,0,1,0,0
"Mauritius","2025-02-28",0,0,1,0,0,1,0,0
"Mauritius","2025-03-01",0,0,1,0,0,1,0,0
"Mauritius","2025-03-02",0,0,1,0,0,1,0,0
"Mauritius","2025-03-03",0,0,1,0,0,1,0,0
"Mexico","2024-01-01",0,0,0,0,0,0,0,0
"Mexico","2024-01-02",0,0,0,0,0,0,0,0
"Mexico","2024-01-03",0,0,0,0,0,0,0,0
"Mexico","2024-01-04",0,0,0,0,0,0,0,0
"Mexico","2024-01-05",0,0,0,0,0,0,0,0
"Mexico","2024-01-06",0,0,0,0,0,0,0,0
"Mexico","2024-01-07",0,0,0,0,0,0,0,0
"Mexico","2024-01-08",0,0,0,0,0,0,0,0
"Mexico","2024-01-09",0,0,0,0,0,0,0,0
"Mexico","2024-01-10",0,0,0,0,0,0,0,0
"Mexico","2024-01-11",0,0,0,0,0,0,0,0
"Mexico","2024-01-12",0,0,0,0,0,0,0,0
"Mexico","2024-01-13",0,0,0,0,0,0,0,0
"Mexico","2024-01-14",0,0,0,0,0,0,0,0
"Mexico","2024-01-15",0,0,0,0,0,0,0,0
"Mexico","2024-01-16",0,0,0,0,0,0,0,0
"Mexico","2024-01-17",0,0,0,0,0,0,0,0
"Mexico","2024-01-18",0,0,0,0,0,0,0,0
"Mexico","2024-01-19",0,0,0,0,0,0,0,0
"Mexico","2024-01-20",0,0,0,0,0,0,0,0
"Mexico","2024-01-21",0,0,0,0,0,0,0,0
"Mexico","2024-01-22",0,0,0,0,0,0,0,0
"Mexico","2024-01-23",0,1,1,0,1,1,0,0
"Mexico","2024-01-24",0,0,1,0,0,1,0,0
"Mexico","2024-01-25",0,0,1,0,0,1,0,0
"Mexico","2024-01-26",0,0,1,0,0,1,0,0
"Mexico","2024-01-27",0,0,1,0,1,2,0,0
"Mexico","2024-01-28",0,0,1,0,0,2,0,0
"Mexico","2024-01-29",0,0,1,0,0,2,0,0
"Mexico","2024-01-30",0,1,2,0,0,2,0,0
"Mexico","2024-01-31",0,0,2,0,0,2,0,0
"Mexico","2024-02-01",0,0,2,0,0,2,0,0
"Mexico","2024-02-02",0,0,2,0,0,2,0,0
"Mexico","2024-02-03",0,0,2,0,1,3,0,0
"Mexico","2024-02-04",0,0,2,0,0,3,0,0
"Mexico","2024-02-05",0,0,2,0,0,3,0,0
"Mexico","2024-02-06",0,0,2,0,0,3,0,0
"Mexico","2024-02-07",0,0,2,0,0,3,0,0
"Mexico","2024-02-08",0,0,2,0,0,3,0,0
"Mexico","2024-02-09",0,0,2,0,0,3,0,0
"Mexico","2024-02-10",0,0,2,0,1,4,0,0
"Mexico","2024-02-11",0,0,2,0,0,4,0,0
"Mexico","2024-02-12",0,0,2,0,0,4,0,0
"Mexico","2024-02-13",0,2,4,0,0,4,0,0
"Mexico","2024-02-14",0,0,4,0,0,4,0,0
"Mexico","2024-02-15",0,0,4,0,0,4,0,0
"Mexico","2024-02-16",0,0,4,0,0,4,0,0
"Mexico","2024-02-17",0,0,4,0,1,5,0,0
"Mexico","2024-02-18",0,0,4,0,0,5,0,0
"Mexico","2024-02-19",0,0,4,0,0,5,0,0
"Mexico","2024-02-20",0,1,5,0,0,5,0,0
"Mexico","2024-02-21",0,0,5,0,0,5,0,0
"Mexico","2024-02-22",0,0,5,0,0,5,0,0
"Mexico","2024-02-23",0,0,5,0,0,5,0,0
"Mexico","2024-02-24",0,0,5,0,0,5,0,0
"Mexico","2024-02-25",0,0,5,0,0,5,0,0
"Mexico","2024-02-26",0,0,5,0,0,5,0,0
"Mexico","2024-02-27",0,0,5,0,0,5,0,0
"Mexico","2024-02-28",0,0,5,0,0,5,0,0
"Mexico","2024-02-29",0,0,5,0,0,5,0,0
"Mexico","2024-03-01",0,0,5,0,0,5,0,0
"Mexico","2024-03-02",0,0,5,0,1,6,0,0
"Mexico","2024-03-03",0,0,5,0,0,6,0,0
"Mexico","2024-03-04",0,0,5,0,0,6,0,0
"Mexico","2024-03-05",0,0,5,0,0,6,0,0
"Mexico","2024-03-06",0,0,5,0,0,6,0,0
"Mexico","2024-03-07",0,0,5,0,0,6,0,0
"Mexico","2024-03-08",0,0,5,0,0,6,0,0
"Mexico","2024-03-09",0,0,5,0,0,6,0,0
"Mexico","2024-03-10",0,0,5,0,0,6,0,0
"Mexico","2024-03-11",0,0,5,0,0,6,0,0
"Mexico","2024-03-12",0,0,5,0,0,6,0,0
"Mexico","2024-03-13",0,0,5,0,0,6,0,0
"Mexico","2024-03-14",0,0,5,0,0,6,0,0
"Mexico","2024-03-15",0,0,5,0,0,6,0,0
"Mexico","2024-03-16",0,0,5,0,0,6,0,0
"Mexico","2024-03-17",0,0,5,0,0,6,0,0
"Mexico","2024-03-18",0,0,5,0,0,6,0,0
"Mexico","2024-03-19",0,0,5,0,0,6,0,0
"Mexico","2024-03-20",0,0,5,0,0,6,0,0
"Mexico","2024-03-21",0,0,5,0,0,6,0,0
"Mexico","2024-03-22",0,0,5,0,0,6,0,0
"Mexico","2024-03-23",0,0,5,0,1,7,0,0
"Mexico","2024-03-24",0,0,5,0,0,7,0,0
"Mexico","2024-03-25",0,0,5,0,0,7,0,0
"Mexico","2024-03-26",0,0,5,0,0,7,0,0
"Mexico","2024-03-27",0,0,5,0,0,7,0,0
"Mexico","2024-03-28",0,0,5,0,0,7,0,0
"Mexico","2024-03-29",0,0,5,0,0,7,0,0
"Mexico","2024-03-30",0,0,5,0,0,7,0,0
"Mexico","2024-03-31",0,0,5,0,0,7,0,0
"Mexico","2024-04-01",0,0,5,0,0,7,0,0
"Mexico","2024-04-02",0,2,7,0,0,7,0,0
"Mexico","2024-04-03",0,0,7,0,0,7,0,0
"Mexico","2024-04-04",0,0,7,0,1,8,0,0
"Mexico","2024-04-05",0,0,7,0,0,8,0,0
"Mexico","2024-04-06",0,0,7,0,0,8,0,0
"Mexico","2024-04-07",0,0,7,0,0,8,0,0
"Mexico","2024-04-08",0,0,7,0,1,9,0,0
"Mexico","2024-04-09",0,2,9,0,0,9,0,0
"Mexico","2024-04-10",0,0,9,0,0,9,0,0
"Mexico","2024-04-11",0,0,9,0,0,9,0,0
"Mexico","2024-04-12",0,0,9,0,0,9,0,0
"Mexico","2024-04-13",0,0,9,0,1,10,0,0
"Mexico","2024-04-14",0,0,9,0,0,10,0,0
"Mexico","2024-04-15",0,0,9,0,0,10,0,0
"Mexico","2024-04-16",0,1,10,0,0,10,0,0
"Mexico","2024-04-17",0,0,10,0,0,10,0,0
"Mexico","2024-04-18",0,0,10,0,1,11,0,0
"Mexico","2024-04-19",0,0,10,0,0,11,0,0
"Mexico","2024-04-20",0,0,10,0,0,11,0,0
"Mexico","2024-04-21",0,0,10,0,0,11,0,0
"Mexico","2024-04-22",0,0,10,0,1,12,0,0
"Mexico","2024-04-23",0,0,10,0,0,12,0,0
"Mexico","2024-04-24",0,0,10,0,0,12,0,0
"Mexico","2024-04-25",0,0,10,0,1,13,0,0
"Mexico","2024-04-26",0,0,10,0,0,13,0,0
"Mexico","2024-04-27",0,0,10,0,0,13,0,0
"Mexico","2024-04-28",0,0,10,0,0,13,0,0
"Mexico","2024-04-29",0,0,10,0,1,14,0,0
"Mexico","2024-04-30",0,4,14,0,0,14,0,0
"Mexico","2024-05-01",0,0,14,0,0,14,0,0
"Mexico","2024-05-02",0,0,14,0,0,14,0,0
"Mexico","2024-05-03",0,0,14,0,0,14,0,0
"Mexico","2024-05-04",0,0,14,0,1,15,0,0
"Mexico","2024-05-05",0,0,14,0,0,15,0,0
"Mexico","2024-05-06",0,0,14,0,0,15,0,0
"Mexico","2024-05-07",0,1,15,0,0,15,0,0
"Mexico","2024-05-08",0,0,15,0,0,15,0,0
"Mexico","2024-05-09",0,0,15,0,1,16,0,0
"Mexico","2024-05-10",0,0,15,0,0,16,0,0
"Mexico","2024-05-11",0,0,15,0,1,17,0,0
"Mexico","2024-05-12",0,0,15,0,0,17,0,0
"Mexico","2024-05-13",0,0,15,0,1,18,0,0
"Mexico","2024-05-14",0,3,18,0,0,18,0,0
"Mexico","2024-05-15",0,0,18,0,1,19,0,0
"Mexico","2024-05-16",0,0,18,0,0,19,0,0
"Mexico","2024-05-17",0,0,18,0,1,20,0,0
"Mexico","2024-05-18",0,0,18,0,0,20,0,0
"Mexico","2024-05-19",0,0,18,0,1,21,0,0
"Mexico","2024-05-20",0,0,18,0,0,21,0,0
"Mexico","2024-05-21",0,4,22,0,1,22,0,0
"Mexico","2024-05-22",0,0,22,0,0,22,0,0
"Mexico","2024-05-23",0,0,22,0,0,22,0,0
"Mexico","2024-05-24",0,0,22,0,0,22,0,0
"Mexico","2024-05-25",0,0,22,0,1,23,0,0
"Mexico","2024-05-26",0,0,22,0,0,23,0,0
"Mexico","2024-05-27",0,0,22,0,0,23,0,0
"Mexico","2024-05-28",0,1,23,0,0,23,0,0
"Mexico","2024-05-29",0,0,23,0,1,24,0,0
"Mexico","2024-05-30",0,0,23,0,1,25,0,0
"Mexico","2024-05-31",0,0,23,0,1,26,0,0
"Mexico","2024-06-01",0,0,23,0,1,27,0,0
"Mexico","2024-06-02",0,0,23,0,1,28,0,0
"Mexico","2024-06-03",0,0,23,0,1,29,0,0
"Mexico","2024-06-04",0,7,30,0,1,30,0,0
"Mexico","2024-06-05",0,0,30,0,0,30,0,0
"Mexico","2024-06-06",0,0,30,0,1,31,0,0
"Mexico","2024-06-07",0,0,30,0,0,31,0,0
"Mexico","2024-06-08",0,0,30,0,1,32,0,0
"Mexico","2024-06-09",0,0,30,0,0,32,0,0
"Mexico","2024-06-10",0,0,30,0,1,33,0,0
"Mexico","2024-06-11",0,3,33,0,0,33,0,0
"Mexico","2024-06-12",0,0,33,0,1,34,0,0
"Mexico","2024-06-13",0,0,33,0,0,34,0,0
"Mexico","2024-06-14",0,0,33,0,1,35,0,0
"Mexico","2024-06-15",0,0,33,0,0,35,0,0
"Mexico","2024-06-16",0,0,33,0,1,36,0,0
"Mexico","2024-06-17",0,0,33,0,0,36,0,0
"Mexico","2024-06-18",0,4,37,0,1,37,0,0
"Mexico","2024-06-19",0,0,37,0,0,37,0,0
"Mexico","2024-06-20",0,0,37,0,0,37,0,0
"Mexico","2024-06-21",0,0,37,0,0,37,0,0
"Mexico","2024-06-22",0,0,37,0,1,38,0,0
"Mexico","2024-06-23",0,0,37,0,0,38,0,0
"Mexico","2024-06-24",0,0,37,0,0,38,0,0
"Mexico","2024-06-25",0,1,38,0,0,38,0,0
"Mexico","2024-06-26",0,0,38,0,1,39,0,0
"Mexico","2024-06-27",0,0,38,0,0,39,0,0
"Mexico","2024-06-28",0,0,38,0,1,40,0,0
"Mexico","2024-06-29",0,0,38,0,0,40,0,0
"Mexico","2024-06-30",0,0,38,0,1,41,0,0
"Mexico","2024-07-01",0,0,38,0,0,41,0,0
"Mexico","2024-07-02",0,4,42,0,1,42,0,0
"Mexico","2024-07-03",0,0,42,0,0,42,0,0
"Mexico","2024-07-04",0,0,42,0,1,43,0,0
"Mexico","2024-07-05",0,0,42,0,0,43,0,0
"Mexico","2024-07-06",0,0,42,0,1,44,0,0
"Mexico","2024-07-07",0,0,42,0,0,44,0,0
"Mexico","2024-07-08",0,0,42,0,1,45,0,0
"Mexico","2024-07-09",0,3,45,0,0,45,0,0
"Mexico","2024-07-10",0,0,45,0,0,45,0,0
"Mexico","2024-07-11",0,0,45,0,0,45,0,0
"Mexico","2024-07-12",0,0,45,0,0,45,0,0
"Mexico","2024-07-13",0,0,45,0,1,46,0,0
"Mexico","2024-07-14",0,0,45,0,0,46,0,0
"Mexico","2024-07-15",0,0,45,0,0,46,0,0
"Mexico","2024-07-16",0,1,46,0,0,46,0,0
"Mexico","2024-07-17",0,0,46,0,0,46,0,0
"Mexico","2024-07-18",0,0,46,0,0,46,0,0
"Mexico","2024-07-19",0,0,46,0,1,47,0,0
"Mexico","2024-07-20",0,0,46,0,0,47,0,0
"Mexico","2024-07-21",0,0,46,0,0,47,0,0
"Mexico","2024-07-22",0,0,46,0,0,47,0,0
"Mexico","2024-07-23",0,0,46,0,1,48,0,0
"Mexico","2024-07-24",0,0,46,0,0,48,0,0
"Mexico","2024-07-25",0,0,46,0,0,48,0,0
"Mexico","2024-07-26",0,0,46,0,0,48,0,0
"Mexico","2024-07-27",0,0,46,0,0,48,0,0
"Mexico","2024-07-28",0,0,46,0,1,49,0,0
"Mexico","2024-07-29",0,0,46,0,0,49,0,0
"Mexico","2024-07-30",0,3,49,0,0,49,0,0
"Mexico","2024-07-31",0,0,49,0,1,50,0,0
"Mexico","2024-08-01",0,0,49,0,0,50,0,0
"Mexico","2024-08-02",0,0,49,0,1,51,0,0
"Mexico","2024-08-03",0,0,49,0,0,51,0,0
"Mexico","2024-08-04",0,0,49,0,1,52,0,0
"Mexico","2024-08-05",0,0,49,0,0,52,0,0
"Mexico","2024-08-06",0,4,53,0,1,53,0,0
"Mexico","2024-08-07",0,0,53,0,0,53,0,0
"Mexico","2024-08-08",0,0,53,0,1,54,0,0
"Mexico","2024-08-09",0,0,53,0,0,54,0,0
"Mexico","2024-08-10",0,0,53,0,0,54,0,0
"Mexico","2024-08-11",0,0,53,0,0,54,0,0
"Mexico","2024-08-12",0,0,53,0,1,55,0,0
"Mexico","2024-08-13",0,2,55,0,0,55,0,0
"Mexico","2024-08-14",0,0,55,0,1,56,0,0
"Mexico","2024-08-15",0,0,55,0,1,57,0,0
"Mexico","2024-08-16",0,0,55,0,1,58,0,0
"Mexico","2024-08-17",0,0,55,0,0,58,0,0
"Mexico","2024-08-18",0,0,55,0,1,59,0,0
"Mexico","2024-08-19",0,0,55,0,1,60,0,0
"Mexico","2024-08-20",0,6,61,0,1,61,0,0
"Mexico","2024-08-21",0,0,61,0,2,63,0,0
"Mexico","2024-08-22",0,0,61,0,1,64,0,0
"Mexico","2024-08-23",0,0,61,0,2,66,0,0
"Mexico","2024-08-24",0,0,61,0,1,67,0,0
"Mexico","2024-08-25",0,0,61,0,2,69,0,0
"Mexico","2024-08-26",0,0,61,0,1,70,0,0
"Mexico","2024-08-27",0,11,72,0,2,72,0,0
"Mexico","2024-08-28",0,0,72,0,1,73,0,0
"Mexico","2024-08-29",0,0,72,0,0,73,0,0
"Mexico","2024-08-30",0,0,72,0,1,74,0,0
"Mexico","2024-08-31",0,0,72,0,0,74,0,0
"Mexico","2024-09-01",0,0,72,0,1,75,0,0
"Mexico","2024-09-02",0,0,72,0,0,75,0,0
"Mexico","2024-09-03",0,4,76,0,1,76,0,0
"Mexico","2024-09-04",0,0,76,0,1,77,0,0
"Mexico","2024-09-05",0,0,76,0,1,78,0,0
"Mexico","2024-09-06",0,0,76,0,1,79,0,0
"Mexico","2024-09-07",0,0,76,0,1,80,0,0
"Mexico","2024-09-08",0,0,76,0,1,81,0,0
"Mexico","2024-09-09",0,0,76,0,1,82,0,0
"Mexico","2024-09-10",0,7,83,0,1,83,0,0
"Mexico","2024-09-11",0,0,83,0,0,83,0,0
"Mexico","2024-09-12",0,0,83,0,1,84,0,0
"Mexico","2024-09-13",0,0,83,0,0,84,0,0
"Mexico","2024-09-14",0,0,83,0,0,84,0,0
"Mexico","2024-09-15",0,0,83,0,0,84,0,0
"Mexico","2024-09-16",0,0,83,0,1,85,0,0
"Mexico","2024-09-17",0,2,85,0,0,85,0,0
"Mexico","2024-09-18",0,0,85,0,0,85,0,0
"Mexico","2024-09-19",0,0,85,0,1,86,0,0
"Mexico","2024-09-20",0,0,85,0,0,86,0,0
"Mexico","2024-09-21",0,0,85,0,0,86,0,0
"Mexico","2024-09-22",0,0,85,0,0,86,0,0
"Mexico","2024-09-23",0,0,85,0,1,87,0,0
"Mexico","2024-09-24",0,2,87,0,0,87,0,0
"Mexico","2024-09-25",0,0,87,0,2,89,0,0
"Mexico","2024-09-26",0,0,87,0,1,90,0,0
"Mexico","2024-09-27",0,0,87,0,2,92,0,0
"Mexico","2024-09-28",0,0,87,0,1,93,0,0
"Mexico","2024-09-29",0,0,87,0,2,95,0,0
"Mexico","2024-09-30",0,0,87,0,1,96,0,0
"Mexico","2024-10-01",0,11,98,0,2,98,0,0
"Mexico","2024-10-02",0,0,98,0,0,98,0,0
"Mexico","2024-10-03",0,0,98,0,1,99,0,0
"Mexico","2024-10-04",0,0,98,0,0,99,0,0
"Mexico","2024-10-05",0,0,98,0,1,100,0,0
"Mexico","2024-10-06",0,0,98,0,0,100,0,0
"Mexico","2024-10-07",0,0,98,0,1,101,0,0
"Mexico","2024-10-08",0,3,101,0,0,101,0,0
"Mexico","2024-10-09",0,0,101,0,0,101,0,0
"Mexico","2024-10-10",0,0,101,0,1,102,0,0
"Mexico","2024-10-11",0,0,101,0,0,102,0,0
"Mexico","2024-10-12",0,0,101,0,1,103,0,0
"Mexico","2024-10-13",0,0,101,0,0,103,0,0
"Mexico","2024-10-14",0,0,101,0,1,104,0,0
"Mexico","2024-10-15",0,3,104,0,0,104,0,0
"Mexico","2024-10-16",0,0,104,0,0,104,0,0
"Mexico","2024-10-17",0,0,104,0,1,105,0,0
"Mexico","2024-10-18",0,0,104,0,0,105,0,0
"Mexico","2024-10-19",0,0,104,0,1,106,0,0
"Mexico","2024-10-20",0,0,104,0,0,106,0,0
"Mexico","2024-10-21",0,0,104,0,1,107,0,0
"Mexico","2024-10-22",0,3,107,0,0,107,0,0
"Mexico","2024-10-23",0,0,107,0,0,107,0,0
"Mexico","2024-10-24",0,0,107,0,1,108,0,0
"Mexico","2024-10-25",0,0,107,0,0,108,0,0
"Mexico","2024-10-26",0,0,107,0,1,109,0,0
"Mexico","2024-10-27",0,0,107,0,0,109,0,0
"Mexico","2024-10-28",0,0,107,0,1,110,0,0
"Mexico","2024-10-29",0,3,110,0,0,110,0,0
"Mexico","2024-10-30",0,0,110,0,0,110,0,0
"Mexico","2024-10-31",0,0,110,0,0,110,0,0
"Mexico","2024-11-01",0,0,110,0,0,110,0,0
"Mexico","2024-11-02",0,0,110,0,1,111,0,0
"Mexico","2024-11-03",0,0,110,0,0,111,0,0
"Mexico","2024-11-04",0,0,110,0,0,111,0,0
"Mexico","2024-11-05",0,1,111,0,0,111,0,0
"Mexico","2024-11-06",0,0,111,0,0,111,0,0
"Mexico","2024-11-07",0,0,111,0,0,111,0,0
"Mexico","2024-11-08",0,0,111,0,0,111,0,0
"Mexico","2024-11-09",0,0,111,0,1,112,0,0
"Mexico","2024-11-10",0,0,111,0,0,112,0,0
"Mexico","2024-11-11",0,0,111,0,0,112,0,0
"Mexico","2024-11-12",0,1,112,0,0,112,0,0
"Mexico","2024-11-13",0,0,112,0,0,112,0,0
"Mexico","2024-11-14",0,0,112,0,0,112,0,0
"Mexico","2024-11-15",0,0,112,0,0,112,0,0
"Mexico","2024-11-16",0,0,112,0,0,112,0,0
"Mexico","2024-11-17",0,0,112,0,0,112,0,0
"Mexico","2024-11-18",0,0,112,0,0,112,0,0
"Mexico","2024-11-19",0,0,112,0,0,112,0,0
"Mexico","2024-11-20",0,0,112,0,0,112,0,0
"Mexico","2024-11-21",0,0,112,0,0,112,0,0
"Mexico","2024-11-22",0,0,112,0,0,112,0,0
"Mexico","2024-11-23",0,0,112,0,1,113,0,0
"Mexico","2024-11-24",0,0,112,0,0,113,0,0
"Mexico","2024-11-25",0,0,112,0,0,113,0,0
"Mexico","2024-11-26",0,0,112,0,0,113,0,0
"Mexico","2024-11-27",0,0,112,0,0,113,0,0
"Mexico","2024-11-28",0,0,112,0,0,113,0,0
"Mexico","2024-11-29",0,0,112,0,0,113,0,0
"Mexico","2024-11-30",0,0,112,0,0,113,0,0
"Mexico","2024-12-01",0,0,112,0,0,113,0,0
"Mexico","2024-12-02",0,0,112,0,0,113,0,0
"Mexico","2024-12-03",0,1,113,0,0,113,0,0
"Mexico","2024-12-04",0,0,113,0,0,113,0,0
"Mexico","2024-12-05",0,0,113,0,1,114,0,0
"Mexico","2024-12-06",0,0,113,0,0,114,0,0
"Mexico","2024-12-07",0,0,113,0,0,114,0,0
"Mexico","2024-12-08",0,0,113,0,0,114,0,0
"Mexico","2024-12-09",0,0,113,0,1,115,0,0
"Mexico","2024-12-10",0,2,115,0,0,115,0,0
"Mexico","2024-12-11",0,0,115,0,1,116,0,0
"Mexico","2024-12-12",0,0,115,0,0,116,0,0
"Mexico","2024-12-13",0,0,115,0,1,117,0,0
"Mexico","2024-12-14",0,0,115,0,0,117,0,0
"Mexico","2024-12-15",0,0,115,0,1,118,0,0
"Mexico","2024-12-16",0,0,115,0,0,118,0,0
"Mexico","2024-12-17",0,4,119,0,1,119,0,0
"Mexico","2024-12-18",0,0,119,0,1,120,0,0
"Mexico","2024-12-19",0,0,119,0,0,120,0,0
"Mexico","2024-12-20",0,0,119,0,1,121,0,0
"Mexico","2024-12-21",0,0,119,0,0,121,0,0
"Mexico","2024-12-22",0,0,119,0,1,122,0,0
"Mexico","2024-12-23",0,0,119,0,0,122,0,0
"Mexico","2024-12-24",0,4,123,0,1,123,0,0
"Mexico","2024-12-25",0,0,123,0,0,123,0,0
"Mexico","2024-12-26",0,0,123,0,0,123,0,0
"Mexico","2024-12-27",0,0,123,0,0,123,0,0
"Mexico","2024-12-28",0,0,123,0,0,123,0,0
"Mexico","2024-12-29",0,0,123,0,0,123,0,0
"Mexico","2024-12-30",0,0,123,0,0,123,0,0
"Mexico","2024-12-31",0,0,123,0,0,123,0,0
"Mexico","2025-01-01",0,0,123,0,0,123,0,0
"Mexico","2025-01-02",0,0,123,0,0,123,0,0
"Mexico","2025-01-03",0,0,123,0,0,123,0,0
"Mexico","2025-01-04",0,0,123,0,1,124,0,0
"Mexico","2025-01-05",0,0,123,0,0,124,0,0
"Mexico","2025-01-06",0,0,123,0,0,124,0,0
"Mexico","2025-01-07",0,0,123,0,0,124,0,0
"Mexico","2025-01-08",0,0,123,0,0,124,0,0
"Mexico","2025-01-09",0,0,123,0,0,124,0,0
"Mexico","2025-01-10",0,0,123,0,0,124,0,0
"Mexico","2025-01-11",0,0,123,0,0,124,0,0
"Mexico","2025-01-12",0,0,123,0,0,124,0,0
"Mexico","2025-01-13",0,0,123,0,0,124,0,0
"Mexico","2025-01-14",0,1,124,0,0,124,0,0
"Mexico","2025-01-15",0,0,124,0,0,124,0,0
"Mexico","2025-01-16",0,0,124,0,0,124,0,0
"Mexico","2025-01-17",0,0,124,0,0,124,0,0
"Mexico","2025-01-18",0,0,124,0,1,125,0,0
"Mexico","2025-01-19",0,0,124,0,0,125,0,0
"Mexico","2025-01-20",0,0,124,0,0,125,0,0
"Mexico","2025-01-21",0,1,125,0,0,125,0,0
"Mexico","2025-01-22",0,0,125,0,0,125,0,0
"Mexico","2025-01-23",0,0,125,0,1,126,0,0
"Mexico","2025-01-24",0,0,125,0,0,126,0,0
"Mexico","2025-01-25",0,0,125,0,1,127,0,0
"Mexico","2025-01-26",0,0,125,0,0,127,0,0
"Mexico","2025-01-27",0,0,125,0,1,128,0,0
"Mexico","2025-01-28",0,3,128,0,0,128,0,0
"Mexico","2025-01-29",0,0,128,0,0,128,0,0
"Mexico","2025-01-30",0,0,128,0,0,128,0,0
"Mexico","2025-01-31",0,0,128,0,0,128,0,0
"Mexico","2025-02-01",0,0,128,0,0,128,0,0
"Mexico","2025-02-02",0,0,128,0,0,128,0,0
"Mexico","2025-02-03",0,0,128,0,0,128,0,0
"Mexico","2025-02-04",0,0,128,0,0,128,0,0
"Mexico","2025-02-05",0,0,128,0,0,128,0,0
"Mexico","2025-02-06",0,0,128,0,0,128,0,0
"Mexico","2025-02-07",0,0,128,0,0,128,0,0
"Mexico","2025-02-08",0,0,128,0,0,128,0,0
"Mexico","2025-02-09",0,0,128,0,0,128,0,0
"Mexico","2025-02-10",0,0,128,0,0,128,0,0
"Mexico","2025-02-11",0,0,128,0,0,128,0,0
"Mexico","2025-02-12",0,0,128,0,0,128,0,0
"Mexico","2025-02-13",0,0,128,0,0,128,0,0
"Mexico","2025-02-14",0,0,128,0,0,128,0,0
"Mexico","2025-02-15",0,0,128,0,0,128,0,0
"Mexico","2025-02-16",0,0,128,0,0,128,0,0
"Mexico","2025-02-17",0,0,128,0,0,128,0,0
"Mexico","2025-02-18",0,0,128,0,0,128,0,0
"Mexico","2025-02-19",0,0,128,0,0,128,0,0
"Mexico","2025-02-20",0,0,128,0,0,128,0,0
"Mexico","2025-02-21",0,0,128,0,0,128,0,0
"Mexico","2025-02-22",0,0,128,0,0,128,0,0
"Mexico","2025-02-23",0,0,128,0,0,128,0,0
"Mexico","2025-02-24",0,0,128,0,0,128,0,0
"Mexico","2025-02-25",0,0,128,0,0,128,0,0
"Mexico","2025-02-26",0,0,128,0,0,128,0,0
"Mexico","2025-02-27",0,0,128,0,0,128,0,0
"Mexico","2025-02-28",0,0,128,0,0,128,0,0
"Mexico","2025-03-01",0,0,128,0,0,128,0,0
"Mexico","2025-03-02",0,0,128,0,0,128,0,0
"Mexico","2025-03-03",0,0,128,0,0,128,0,0
"Republic of Moldova","2024-01-01",0,0,0,0,0,0,0,0
"Republic of Moldova","2024-01-02",0,0,0,0,0,0,0,0
"Republic of Moldova","2024-01-03",0,0,0,0,0,0,0,0
"Republic of Moldova","2024-01-04",0,0,0,0,0,0,0,0
"Republic of Moldova","2024-01-05",0,0,0,0,0,0,0,0
"Republic of Moldova","2024-01-06",0,0,0,0,0,0,0,0
"Republic of Moldova","2024-01-07",0,0,0,0,0,0,0,0
"Republic of Moldova","2024-01-08",0,0,0,0,0,0,0,0
"Republic of Moldova","2024-01-09",0,0,0,0,0,0,0,0
"Republic of Moldova","2024-01-10",0,0,0,0,0,0,0,0
"Republic of Moldova","2024-01-11",0,0,0,0,0,0,0,0
"Republic of Moldova","2024-01-12",0,0,0,0,0,0,0,0
"Republic of Moldova","2024-01-13",0,0,0,0,0,0,0,0
"Republic of Moldova","2024-01-14",0,0,0,0,0,0,0,0
"Republic of Moldova","2024-01-15",0,0,0,0,0,0,0,0
"Republic of Moldova","2024-01-16",0,0,0,0,0,0,0,0
"Republic of Moldova","2024-01-17",0,0,0,0,0,0,0,0
"Republic of Moldova","2024-01-18",0,0,0,0,0,0,0,0
"Republic of Moldova","2024-01-19",0,0,0,0,0,0,0,0
"Republic of Moldova","2024-01-20",0,0,0,0,0,0,0,0
"Republic of Moldova","2024-01-21",0,0,0,0,0,0,0,0
"Republic of Moldova","2024-01-22",0,0,0,0,0,0,0,0
"Republic of Moldova","2024-01-23",0,0,0,0,0,0,0,0
"Republic of Moldova","2024-01-24",0,0,0,0,0,0,0,0
"Republic of Moldova","2024-01-25",0,0,0,0,0,0,0,0
"Republic of Moldova","2024-01-26",0,0,0,0,0,0,0,0
"Republic of Moldova","2024-01-27",0,0,0,0,0,0,0,0
"Republic of Moldova","2024-01-28",0,0,0,0,0,0,0,0
"Republic of Moldova","2024-01-29",0,0,0,0,0,0,0,0
"Republic of Moldova","2024-01-30",0,0,0,0,0,0,0,0
"Republic of Moldova","2024-01-31",0,0,0,0,0,0,0,0
"Republic of Moldova","2024-02-01",0,0,0,0,0,0,0,0
"Republic of Moldova","2024-02-02",0,0,0,0,0,0,0,0
"Republic of Moldova","2024-02-03",0,0,0,0,0,0,0,0
"Republic of Moldova","2024-02-04",0,0,0,0,0,0,0,0
"Republic of Moldova","2024-02-05",0,0,0,0,0,0,0,0
"Republic of Moldova","2024-02-06",0,0,0,0,0,0,0,0
"Republic of Moldova","2024-02-07",0,0,0,0,0,0,0,0
"Republic of Moldova","2024-02-08",0,0,0,0,0,0,0,0
"Republic of Moldova","2024-02-09",0,0,0,0,0,0,0,0
"Republic of Moldova","2024-02-10",0,0,0,0,0,0,0,0
"Republic of Moldova","2024-02-11",0,0,0,0,0,0,0,0
"Republic of Moldova","2024-02-12",0,0,0,0,0,0,0,0
"Republic of Moldova","2024-02-13",0,0,0,0,0,0,0,0
"Republic of Moldova","2024-02-14",0,0,0,0,0,0,0,0
"Republic of Moldova","2024-02-15",0,0,0,0,0,0,0,0
"Republic of Moldova","2024-02-16",0,0,0,0,0,0,0,0
"Republic of Moldova","2024-02-17",0,0,0,0,0,0,0,0
"Republic of Moldova","2024-02-18",0,0,0,0,0,0,0,0
"Republic of Moldova","2024-02-19",0,0,0,0,0,0,0,0
"Republic of Moldova","2024-02-20",0,0,0,0,0,0,0,0
"Republic of Moldova","2024-02-21",0,0,0,0,0,0,0,0
"Republic of Moldova","2024-02-22",0,0,0,0,0,0,0,0
"Republic of Moldova","2024-02-23",0,0,0,0,0,0,0,0
"Republic of Moldova","2024-02-24",0,0,0,0,0,0,0,0
"Republic of Moldova","2024-02-25",0,0,0,0,0,0,0,0
"Republic of Moldova","2024-02-26",0,0,0,0,0,0,0,0
"Republic of Moldova","2024-02-27",0,0,0,0,0,0,0,0
"Republic of Moldova","2024-02-28",0,0,0,0,0,0,0,0
"Republic of Moldova","2024-02-29",0,0,0,0,0,0,0,0
"Republic of Moldova","2024-03-01",0,0,0,0,0,0,0,0
"Republic of Moldova","2024-03-02",0,0,0,0,0,0,0,0
"Republic of Moldova","2024-03-03",0,0,0,0,0,0,0,0
"Republic of Moldova","2024-03-04",0,0,0,0,0,0,0,0
"Republic of Moldova","2024-03-05",0,0,0,0,0,0,0,0
"Republic of Moldova","2024-03-06",0,0,0,0,0,0,0,0
"Republic of Moldova","2024-03-07",0,0,0,0,0,0,0,0
"Republic of Moldova","2024-03-08",0,0,0,0,0,0,0,0
"Republic of Moldova","2024-03-09",0,0,0,0,0,0,0,0
"Republic of Moldova","2024-03-10",0,0,0,0,0,0,0,0
"Republic of Moldova","2024-03-11",0,0,0,0,0,0,0,0
"Republic of Moldova","2024-03-12",0,0,0,0,0,0,0,0
"Republic of Moldova","2024-03-13",0,0,0,0,0,0,0,0
"Republic of Moldova","2024-03-14",0,0,0,0,0,0,0,0
"Republic of Moldova","2024-03-15",0,0,0,0,0,0,0,0
"Republic of Moldova","2024-03-16",0,0,0,0,0,0,0,0
"Republic of Moldova","2024-03-17",0,0,0,0,0,0,0,0
"Republic of Moldova","2024-03-18",0,0,0,0,0,0,0,0
"Republic of Moldova","2024-03-19",0,0,0,0,0,0,0,0
"Republic of Moldova","2024-03-20",0,0,0,0,0,0,0,0
"Republic of Moldova","2024-03-21",0,0,0,0,0,0,0,0
"Republic of Moldova","2024-03-22",0,0,0,0,0,0,0,0
"Republic of Moldova","2024-03-23",0,0,0,0,0,0,0,0
"Republic of Moldova","2024-03-24",0,0,0,0,0,0,0,0
"Republic of Moldova","2024-03-25",0,0,0,0,0,0,0,0
"Republic of Moldova","2024-03-26",0,0,0,0,0,0,0,0
"Republic of Moldova","2024-03-27",0,0,0,0,0,0,0,0
"Republic of Moldova","2024-03-28",0,0,0,0,0,0,0,0
"Republic of Moldova","2024-03-29",0,0,0,0,0,0,0,0
"Republic of Moldova","2024-03-30",0,0,0,0,0,0,0,0
"Republic of Moldova","2024-03-31",0,0,0,0,0,0,0,0
"Republic of Moldova","2024-04-01",0,0,0,0,0,0,0,0
"Republic of Moldova","2024-04-02",0,0,0,0,0,0,0,0
"Republic of Moldova","2024-04-03",0,0,0,0,0,0,0,0
"Republic of Moldova","2024-04-04",0,0,0,0,0,0,0,0
"Republic of Moldova","2024-04-05",0,0,0,0,0,0,0,0
"Republic of Moldova","2024-04-06",0,0,0,0,0,0,0,0
"Republic of Moldova","2024-04-07",0,0,0,0,0,0,0,0
"Republic of Moldova","2024-04-08",0,0,0,0,0,0,0,0
"Republic of Moldova","2024-04-09",0,0,0,0,0,0,0,0
"Republic of Moldova","2024-04-10",0,0,0,0,0,0,0,0
"Republic of Moldova","2024-04-11",0,0,0,0,0,0,0,0
"Republic of Moldova","2024-04-12",0,0,0,0,0,0,0,0
"Republic of Moldova","2024-04-13",0,0,0,0,0,0,0,0
"Republic of Moldova","2024-04-14",0,0,0,0,0,0,0,0
"Republic of Moldova","2024-04-15",0,0,0,0,0,0,0,0
"Republic of Moldova","2024-04-16",0,0,0,0,0,0,0,0
"Republic of Moldova","2024-04-17",0,0,0,0,0,0,0,0
"Republic of Moldova","2024-04-18",0,0,0,0,0,0,0,0
"Republic of Moldova","2024-04-19",0,0,0,0,0,0,0,0
"Republic of Moldova","2024-04-20",0,0,0,0,0,0,0,0
"Republic of Moldova","2024-04-21",0,0,0,0,0,0,0,0
"Republic of Moldova","2024-04-22",0,0,0,0,0,0,0,0
"Republic of Moldova","2024-04-23",0,0,0,0,0,0,0,0
"Republic of Moldova","2024-04-24",0,0,0,0,0,0,0,0
"Republic of Moldova","2024-04-25",0,0,0,0,0,0,0,0
"Republic of Moldova","2024-04-26",0,0,0,0,0,0,0,0
"Republic of Moldova","2024-04-27",0,0,0,0,0,0,0,0
"Republic of Moldova","2024-04-28",0,0,0,0,0,0,0,0
"Republic of Moldova","2024-04-29",0,0,0,0,0,0,0,0
"Republic of Moldova","2024-04-30",0,0,0,0,0,0,0,0
"Republic of Moldova","2024-05-01",0,0,0,0,0,0,0,0
"Republic of Moldova","2024-05-02",0,0,0,0,0,0,0,0
"Republic of Moldova","2024-05-03",0,0,0,0,0,0,0,0
"Republic of Moldova","2024-05-04",0,0,0,0,0,0,0,0
"Republic of Moldova","2024-05-05",0,0,0,0,0,0,0,0
"Republic of Moldova","2024-05-06",0,0,0,0,0,0,0,0
"Republic of Moldova","2024-05-07",0,0,0,0,0,0,0,0
"Republic of Moldova","2024-05-08",0,0,0,0,0,0,0,0
"Republic of Moldova","2024-05-09",0,0,0,0,0,0,0,0
"Republic of Moldova","2024-05-10",0,0,0,0,0,0,0,0
"Republic of Moldova","2024-05-11",0,0,0,0,0,0,0,0
"Republic of Moldova","2024-05-12",0,0,0,0,0,0,0,0
"Republic of Moldova","2024-05-13",0,0,0,0,0,0,0,0
"Republic of Moldova","2024-05-14",0,0,0,0,0,0,0,0
"Republic of Moldova","2024-05-15",0,0,0,0,0,0,0,0
"Republic of Moldova","2024-05-16",0,0,0,0,0,0,0,0
"Republic of Moldova","2024-05-17",0,0,0,0,0,0,0,0
"Republic of Moldova","2024-05-18",0,0,0,0,0,0,0,0
"Republic of Moldova","2024-05-19",0,0,0,0,0,0,0,0
"Republic of Moldova","2024-05-20",0,0,0,0,0,0,0,0
"Republic of Moldova","2024-05-21",0,0,0,0,0,0,0,0
"Republic of Moldova","2024-05-22",0,0,0,0,0,0,0,0
"Republic of Moldova","2024-05-23",0,0,0,0,0,0,0,0
"Republic of Moldova","2024-05-24",0,0,0,0,0,0,0,0
"Republic of Moldova","2024-05-25",0,0,0,0,0,0,0,0
"Republic of Moldova","2024-05-26",0,0,0,0,0,0,0,0
"Republic of Moldova","2024-05-27",0,0,0,0,0,0,0,0
"Republic of Moldova","2024-05-28",0,0,0,0,0,0,0,0
"Republic of Moldova","2024-05-29",0,0,0,0,0,0,0,0
"Republic of Moldova","2024-05-30",0,0,0,0,0,0,0,0
"Republic of Moldova","2024-05-31",0,0,0,0,0,0,0,0
"Republic of Moldova","2024-06-01",0,0,0,0,0,0,0,0
"Republic of Moldova","2024-06-02",0,0,0,0,0,0,0,0
"Republic of Moldova","2024-06-03",0,0,0,0,0,0,0,0
"Republic of Moldova","2024-06-04",0,0,0,0,0,0,0,0
"Republic of Moldova","2024-06-05",0,0,0,0,0,0,0,0
"Republic of Moldova","2024-06-06",0,0,0,0,0,0,0,0
"Republic of Moldova","2024-06-07",0,0,0,0,0,0,0,0
"Republic of Moldova","2024-06-08",0,0,0,0,0,0,0,0
"Republic of Moldova","2024-06-09",0,0,0,0,0,0,0,0
"Republic of Moldova","2024-06-10",0,0,0,0,0,0,0,0
"Republic of Moldova","2024-06-11",0,0,0,0,0,0,0,0
"Republic of Moldova","2024-06-12",0,0,0,0,0,0,0,0
"Republic of Moldova","2024-06-13",0,0,0,0,0,0,0,0
"Republic of Moldova","2024-06-14",0,0,0,0,0,0,0,0
"Republic of Moldova","2024-06-15",0,0,0,0,0,0,0,0
"Republic of Moldova","2024-06-16",0,0,0,0,0,0,0,0
"Republic of Moldova","2024-06-17",0,0,0,0,0,0,0,0
"Republic of Moldova","2024-06-18",0,0,0,0,0,0,0,0
"Republic of Moldova","2024-06-19",0,0,0,0,0,0,0,0
"Republic of Moldova","2024-06-20",0,0,0,0,0,0,0,0
"Republic of Moldova","2024-06-21",0,0,0,0,0,0,0,0
"Republic of Moldova","2024-06-22",0,0,0,0,0,0,0,0
"Republic of Moldova","2024-06-23",0,0,0,0,0,0,0,0
"Republic of Moldova","2024-06-24",0,0,0,0,0,0,0,0
"Republic of Moldova","2024-06-25",0,0,0,0,0,0,0,0
"Republic of Moldova","2024-06-26",0,0,0,0,0,0,0,0
"Republic of Moldova","2024-06-27",0,0,0,0,0,0,0,0
"Republic of Moldova","2024-06-28",0,0,0,0,0,0,0,0
"Republic of Moldova","2024-06-29",0,0,0,0,0,0,0,0
"Republic of Moldova","2024-06-30",0,0,0,0,0,0,0,0
"Republic of Moldova","2024-07-01",0,0,0,0,0,0,0,0
"Republic of Moldova","2024-07-02",0,0,0,0,0,0,0,0
"Republic of Moldova","2024-07-03",0,0,0,0,0,0,0,0
"Republic of Moldova","2024-07-04",0,0,0,0,0,0,0,0
"Republic of Moldova","2024-07-05",0,0,0,0,0,0,0,0
"Republic of Moldova","2024-07-06",0,0,0,0,0,0,0,0
"Republic of Moldova","2024-07-07",0,0,0,0,0,0,0,0
"Republic of Moldova","2024-07-08",0,0,0,0,0,0,0,0
"Republic of Moldova","2024-07-09",0,0,0,0,0,0,0,0
"Republic of Moldova","2024-07-10",0,0,0,0,0,0,0,0
"Republic of Moldova","2024-07-11",0,0,0,0,0,0,0,0
"Republic of Moldova","2024-07-12",0,0,0,0,0,0,0,0
"Republic of Moldova","2024-07-13",0,0,0,0,0,0,0,0
"Republic of Moldova","2024-07-14",0,0,0,0,0,0,0,0
"Republic of Moldova","2024-07-15",0,0,0,0,0,0,0,0
"Republic of Moldova","2024-07-16",0,0,0,0,0,0,0,0
"Republic of Moldova","2024-07-17",0,0,0,0,0,0,0,0
"Republic of Moldova","2024-07-18",0,0,0,0,0,0,0,0
"Republic of Moldova","2024-07-19",0,0,0,0,0,0,0,0
"Republic of Moldova","2024-07-20",0,0,0,0,0,0,0,0
"Republic of Moldova","2024-07-21",0,0,0,0,0,0,0,0
"Republic of Moldova","2024-07-22",0,0,0,0,0,0,0,0
"Republic of Moldova","2024-07-23",0,0,0,0,0,0,0,0
"Republic of Moldova","2024-07-24",0,0,0,0,0,0,0,0
"Republic of Moldova","2024-07-25",0,0,0,0,0,0,0,0
"Republic of Moldova","2024-07-26",0,0,0,0,0,0,0,0
"Republic of Moldova","2024-07-27",0,0,0,0,0,0,0,0
"Republic of Moldova","2024-07-28",0,0,0,0,0,0,0,0
"Republic of Moldova","2024-07-29",0,0,0,0,0,0,0,0
"Republic of Moldova","2024-07-30",0,0,0,0,0,0,0,0
"Republic of Moldova","2024-07-31",0,0,0,0,0,0,0,0
"Republic of Moldova","2024-08-01",0,0,0,0,0,0,0,0
"Republic of Moldova","2024-08-02",0,0,0,0,0,0,0,0
"Republic of Moldova","2024-08-03",0,0,0,0,0,0,0,0
"Republic of Moldova","2024-08-04",0,0,0,0,0,0,0,0
"Republic of Moldova","2024-08-05",0,0,0,0,0,0,0,0
"Republic of Moldova","2024-08-06",0,0,0,0,0,0,0,0
"Republic of Moldova","2024-08-07",0,0,0,0,0,0,0,0
"Republic of Moldova","2024-08-08",0,0,0,0,0,0,0,0
"Republic of Moldova","2024-08-09",0,0,0,0,0,0,0,0
"Republic of Moldova","2024-08-10",0,0,0,0,0,0,0,0
"Republic of Moldova","2024-08-11",0,0,0,0,0,0,0,0
"Republic of Moldova","2024-08-12",0,0,0,0,0,0,0,0
"Republic of Moldova","2024-08-13",0,0,0,0,0,0,0,0
"Republic of Moldova","2024-08-14",0,0,0,0,0,0,0,0
"Republic of Moldova","2024-08-15",0,0,0,0,0,0,0,0
"Republic of Moldova","2024-08-16",0,0,0,0,0,0,0,0
"Republic of Moldova","2024-08-17",0,0,0,0,0,0,0,0
"Republic of Moldova","2024-08-18",0,0,0,0,0,0,0,0
"Republic of Moldova","2024-08-19",0,0,0,0,0,0,0,0
"Republic of Moldova","2024-08-20",0,0,0,0,0,0,0,0
"Republic of Moldova","2024-08-21",0,0,0,0,0,0,0,0
"Republic of Moldova","2024-08-22",0,0,0,0,0,0,0,0
"Republic of Moldova","2024-08-23",0,0,0,0,0,0,0,0
"Republic of Moldova","2024-08-24",0,0,0,0,0,0,0,0
"Republic of Moldova","2024-08-25",0,0,0,0,0,0,0,0
"Republic of Moldova","2024-08-26",0,0,0,0,0,0,0,0
"Republic of Moldova","2024-08-27",0,0,0,0,0,0,0,0
"Republic of Moldova","2024-08-28",0,0,0,0,0,0,0,0
"Republic of Moldova","2024-08-29",0,0,0,0,0,0,0,0
"Republic of Moldova","2024-08-30",0,0,0,0,0,0,0,0
"Republic of Moldova","2024-08-31",0,0,0,0,0,0,0,0
"Republic of Moldova","2024-09-01",0,0,0,0,0,0,0,0
"Republic of Moldova","2024-09-02",0,0,0,0,0,0,0,0
"Republic of Moldova","2024-09-03",0,0,0,0,0,0,0,0
"Republic of Moldova","2024-09-04",0,0,0,0,0,0,0,0
"Republic of Moldova","2024-09-05",0,0,0,0,0,0,0,0
"Republic of Moldova","2024-09-06",0,0,0,0,0,0,0,0
"Republic of Moldova","2024-09-07",0,0,0,0,0,0,0,0
"Republic of Moldova","2024-09-08",0,0,0,0,0,0,0,0
"Republic of Moldova","2024-09-09",0,0,0,0,0,0,0,0
"Republic of Moldova","2024-09-10",0,0,0,0,0,0,0,0
"Republic of Moldova","2024-09-11",0,0,0,0,0,0,0,0
"Republic of Moldova","2024-09-12",0,0,0,0,0,0,0,0
"Republic of Moldova","2024-09-13",0,0,0,0,0,0,0,0
"Republic of Moldova","2024-09-14",0,0,0,0,0,0,0,0
"Republic of Moldova","2024-09-15",0,0,0,0,0,0,0,0
"Republic of Moldova","2024-09-16",0,0,0,0,0,0,0,0
"Republic of Moldova","2024-09-17",0,0,0,0,0,0,0,0
"Republic of Moldova","2024-09-18",0,0,0,0,0,0,0,0
"Republic of Moldova","2024-09-19",0,0,0,0,0,0,0,0
"Republic of Moldova","2024-09-20",0,0,0,0,0,0,0,0
"Republic of Moldova","2024-09-21",0,0,0,0,0,0,0,0
"Republic of Moldova","2024-09-22",0,0,0,0,0,0,0,0
"Republic of Moldova","2024-09-23",0,0,0,0,0,0,0,0
"Republic of Moldova","2024-09-24",0,0,0,0,0,0,0,0
"Republic of Moldova","2024-09-25",0,0,0,0,0,0,0,0
"Republic of Moldova","2024-09-26",0,0,0,0,0,0,0,0
"Republic of Moldova","2024-09-27",0,0,0,0,0,0,0,0
"Republic of Moldova","2024-09-28",0,0,0,0,0,0,0,0
"Republic of Moldova","2024-09-29",0,0,0,0,0,0,0,0
"Republic of Moldova","2024-09-30",0,0,0,0,0,0,0,0
"Republic of Moldova","2024-10-01",0,0,0,0,0,0,0,0
"Republic of Moldova","2024-10-02",0,0,0,0,0,0,0,0
"Republic of Moldova","2024-10-03",0,0,0,0,0,0,0,0
"Republic of Moldova","2024-10-04",0,0,0,0,0,0,0,0
"Republic of Moldova","2024-10-05",0,0,0,0,0,0,0,0
"Republic of Moldova","2024-10-06",0,0,0,0,0,0,0,0
"Republic of Moldova","2024-10-07",0,0,0,0,0,0,0,0
"Republic of Moldova","2024-10-08",0,0,0,0,0,0,0,0
"Republic of Moldova","2024-10-09",0,0,0,0,0,0,0,0
"Republic of Moldova","2024-10-10",0,0,0,0,0,0,0,0
"Republic of Moldova","2024-10-11",0,0,0,0,0,0,0,0
"Republic of Moldova","2024-10-12",0,0,0,0,0,0,0,0
"Republic of Moldova","2024-10-13",0,0,0,0,0,0,0,0
"Republic of Moldova","2024-10-14",0,0,0,0,0,0,0,0
"Republic of Moldova","2024-10-15",0,0,0,0,0,0,0,0
"Republic of Moldova","2024-10-16",0,0,0,0,0,0,0,0
"Republic of Moldova","2024-10-17",0,0,0,0,0,0,0,0
"Republic of Moldova","2024-10-18",0,0,0,0,0,0,0,0
"Republic of Moldova","2024-10-19",0,0,0,0,0,0,0,0
"Republic of Moldova","2024-10-20",0,0,0,0,0,0,0,0
"Republic of Moldova","2024-10-21",0,0,0,0,0,0,0,0
"Republic of Moldova","2024-10-22",0,0,0,0,0,0,0,0
"Republic of Moldova","2024-10-23",0,0,0,0,0,0,0,0
"Republic of Moldova","2024-10-24",0,0,0,0,0,0,0,0
"Republic of Moldova","2024-10-25",0,0,0,0,0,0,0,0
"Republic of Moldova","2024-10-26",0,0,0,0,0,0,0,0
"Republic of Moldova","2024-10-27",0,0,0,0,0,0,0,0
"Republic of Moldova","2024-10-28",0,0,0,0,0,0,0,0
"Republic of Moldova","2024-10-29",0,0,0,0,0,0,0,0
"Republic of Moldova","2024-10-30",0,0,0,0,0,0,0,0
"Republic of Moldova","2024-10-31",0,0,0,0,0,0,0,0
"Republic of Moldova","2024-11-01",0,0,0,0,0,0,0,0
"Republic of Moldova","2024-11-02",0,0,0,0,0,0,0,0
"Republic of Moldova","2024-11-03",0,0,0,0,0,0,0,0
"Republic of Moldova","2024-11-04",0,0,0,0,0,0,0,0
"Republic of Moldova","2024-11-05",0,0,0,0,0,0,0,0
"Republic of Moldova","2024-11-06",0,0,0,0,0,0,0,0
"Republic of Moldova","2024-11-07",0,0,0,0,0,0,0,0
"Republic of Moldova","2024-11-08",0,0,0,0,0,0,0,0
"Republic of Moldova","2024-11-09",0,0,0,0,0,0,0,0
"Republic of Moldova","2024-11-10",0,0,0,0,0,0,0,0
"Republic of Moldova","2024-11-11",0,0,0,0,0,0,0,0
"Republic of Moldova","2024-11-12",0,0,0,0,0,0,0,0
"Republic of Moldova","2024-11-13",0,0,0,0,0,0,0,0
"Republic of Moldova","2024-11-14",0,0,0,0,0,0,0,0
"Republic of Moldova","2024-11-15",0,0,0,0,0,0,0,0
"Republic of Moldova","2024-11-16",0,0,0,0,0,0,0,0
"Republic of Moldova","2024-11-17",0,0,0,0,0,0,0,0
"Republic of Moldova","2024-11-18",0,0,0,0,0,0,0,0
"Republic of Moldova","2024-11-19",0,0,0,0,0,0,0,0
"Republic of Moldova","2024-11-20",0,0,0,0,0,0,0,0
"Republic of Moldova","2024-11-21",0,0,0,0,0,0,0,0
"Republic of Moldova","2024-11-22",0,0,0,0,0,0,0,0
"Republic of Moldova","2024-11-23",0,0,0,0,0,0,0,0
"Republic of Moldova","2024-11-24",0,0,0,0,0,0,0,0
"Republic of Moldova","2024-11-25",0,0,0,0,0,0,0,0
"Republic of Moldova","2024-11-26",0,0,0,0,0,0,0,0
"Republic of Moldova","2024-11-27",0,0,0,0,0,0,0,0
"Republic of Moldova","2024-11-28",0,0,0,0,0,0,0,0
"Republic of Moldova","2024-11-29",0,0,0,0,0,0,0,0
"Republic of Moldova","2024-11-30",0,0,0,0,0,0,0,0
"Republic of Moldova","2024-12-01",0,0,0,0,0,0,0,0
"Republic of Moldova","2024-12-02",0,0,0,0,0,0,0,0
"Republic of Moldova","2024-12-03",0,0,0,0,0,0,0,0
"Republic of Moldova","2024-12-04",0,0,0,0,0,0,0,0
"Republic of Moldova","2024-12-05",0,0,0,0,0,0,0,0
"Republic of Moldova","2024-12-06",0,0,0,0,0,0,0,0
"Republic of Moldova","2024-12-07",0,0,0,0,0,0,0,0
"Republic of Moldova","2024-12-08",0,0,0,0,0,0,0,0
"Republic of Moldova","2024-12-09",0,0,0,0,0,0,0,0
"Republic of Moldova","2024-12-10",0,0,0,0,0,0,0,0
"Republic of Moldova","2024-12-11",0,0,0,0,0,0,0,0
"Republic of Moldova","2024-12-12",0,0,0,0,0,0,0,0
"Republic of Moldova","2024-12-13",0,0,0,0,0,0,0,0
"Republic of Moldova","2024-12-14",0,0,0,0,0,0,0,0
"Republic of Moldova","2024-12-15",0,0,0,0,0,0,0,0
"Republic of Moldova","2024-12-16",0,0,0,0,0,0,0,0
"Republic of Moldova","2024-12-17",0,0,0,0,0,0,0,0
"Republic of Moldova","2024-12-18",0,0,0,0,0,0,0,0
"Republic of Moldova","2024-12-19",0,0,0,0,0,0,0,0
"Republic of Moldova","2024-12-20",0,0,0,0,0,0,0,0
"Republic of Moldova","2024-12-21",0,0,0,0,0,0,0,0
"Republic of Moldova","2024-12-22",0,0,0,0,0,0,0,0
"Republic of Moldova","2024-12-23",0,0,0,0,0,0,0,0
"Republic of Moldova","2024-12-24",0,0,0,0,0,0,0,0
"Republic of Moldova","2024-12-25",0,0,0,0,0,0,0,0
"Republic of Moldova","2024-12-26",0,0,0,0,0,0,0,0
"Republic of Moldova","2024-12-27",0,0,0,0,0,0,0,0
"Republic of Moldova","2024-12-28",0,0,0,0,0,0,0,0
"Republic of Moldova","2024-12-29",0,0,0,0,0,0,0,0
"Republic of Moldova","2024-12-30",0,0,0,0,0,0,0,0
"Republic of Moldova","2024-12-31",0,0,0,0,0,0,0,0
"Republic of Moldova","2025-01-01",0,0,0,0,0,0,0,0
"Republic of Moldova","2025-01-02",0,0,0,0,0,0,0,0
"Republic of Moldova","2025-01-03",0,0,0,0,0,0,0,0
"Republic of Moldova","2025-01-04",0,0,0,0,0,0,0,0
"Republic of Moldova","2025-01-05",0,0,0,0,0,0,0,0
"Republic of Moldova","2025-01-06",0,0,0,0,0,0,0,0
"Republic of Moldova","2025-01-07",0,0,0,0,0,0,0,0
"Republic of Moldova","2025-01-08",0,0,0,0,0,0,0,0
"Republic of Moldova","2025-01-09",0,0,0,0,0,0,0,0
"Republic of Moldova","2025-01-10",0,0,0,0,0,0,0,0
"Republic of Moldova","2025-01-11",0,0,0,0,0,0,0,0
"Republic of Moldova","2025-01-12",0,0,0,0,0,0,0,0
"Republic of Moldova","2025-01-13",0,0,0,0,0,0,0,0
"Republic of Moldova","2025-01-14",0,0,0,0,0,0,0,0
"Republic of Moldova","2025-01-15",0,0,0,0,0,0,0,0
"Republic of Moldova","2025-01-16",0,0,0,0,0,0,0,0
"Republic of Moldova","2025-01-17",0,0,0,0,0,0,0,0
"Republic of Moldova","2025-01-18",0,0,0,0,0,0,0,0
"Republic of Moldova","2025-01-19",0,0,0,0,0,0,0,0
"Republic of Moldova","2025-01-20",0,0,0,0,0,0,0,0
"Republic of Moldova","2025-01-21",0,0,0,0,0,0,0,0
"Republic of Moldova","2025-01-22",0,0,0,0,0,0,0,0
"Republic of Moldova","2025-01-23",0,0,0,0,0,0,0,0
"Republic of Moldova","2025-01-24",0,0,0,0,0,0,0,0
"Republic of Moldova","2025-01-25",0,0,0,0,0,0,0,0
"Republic of Moldova","2025-01-26",0,0,0,0,0,0,0,0
"Republic of Moldova","2025-01-27",0,0,0,0,0,0,0,0
"Republic of Moldova","2025-01-28",0,0,0,0,0,0,0,0
"Republic of Moldova","2025-01-29",0,0,0,0,0,0,0,0
"Republic of Moldova","2025-01-30",0,0,0,0,0,0,0,0
"Republic of Moldova","2025-01-31",0,0,0,0,0,0,0,0
"Republic of Moldova","2025-02-01",0,0,0,0,0,0,0,0
"Republic of Moldova","2025-02-02",0,0,0,0,0,0,0,0
"Republic of Moldova","2025-02-03",0,0,0,0,0,0,0,0
"Republic of Moldova","2025-02-04",0,0,0,0,0,0,0,0
"Republic of Moldova","2025-02-05",0,0,0,0,0,0,0,0
"Republic of Moldova","2025-02-06",0,0,0,0,0,0,0,0
"Republic of Moldova","2025-02-07",0,0,0,0,0,0,0,0
"Republic of Moldova","2025-02-08",0,0,0,0,0,0,0,0
"Republic of Moldova","2025-02-09",0,0,0,0,0,0,0,0
"Republic of Moldova","2025-02-10",0,0,0,0,0,0,0,0
"Republic of Moldova","2025-02-11",0,0,0,0,0,0,0,0
"Republic of Moldova","2025-02-12",0,0,0,0,0,0,0,0
"Republic of Moldova","2025-02-13",0,0,0,0,0,0,0,0
"Republic of Moldova","2025-02-14",0,0,0,0,0,0,0,0
"Republic of Moldova","2025-02-15",0,0,0,0,0,0,0,0
"Republic of Moldova","2025-02-16",0,0,0,0,0,0,0,0
"Republic of Moldova","2025-02-17",0,0,0,0,0,0,0,0
"Republic of Moldova","2025-02-18",0,0,0,0,0,0,0,0
"Republic of Moldova","2025-02-19",0,0,0,0,0,0,0,0
"Republic of Moldova","2025-02-20",0,0,0,0,0,0,0,0
"Republic of Moldova","2025-02-21",0,0,0,0,0,0,0,0
"Republic of Moldova","2025-02-22",0,0,0,0,0,0,0,0
"Republic of Moldova","2025-02-23",0,0,0,0,0,0,0,0
"Republic of Moldova","2025-02-24",0,0,0,0,0,0,0,0
"Republic of Moldova","2025-02-25",0,0,0,0,0,0,0,0
"Republic of Moldova","2025-02-26",0,0,0,0,0,0,0,0
"Republic of Moldova","2025-02-27",0,0,0,0,0,0,0,0
"Republic of Moldova","2025-02-28",0,0,0,0,0,0,0,0
"Republic of Moldova","2025-03-01",0,0,0,0,0,0,0,0
"Republic of Moldova","2025-03-02",0,0,0,0,0,0,0,0
"Republic of Moldova","2025-03-03",0,0,0,0,0,0,0,0
"Monaco","2024-01-01",0,0,0,0,0,0,0,0
"Monaco","2024-01-02",0,0,0,0,0,0,0,0
"Monaco","2024-01-03",0,0,0,0,0,0,0,0
"Monaco","2024-01-04",0,0,0,0,0,0,0,0
"Monaco","2024-01-05",0,0,0,0,0,0,0,0
"Monaco","2024-01-06",0,0,0,0,0,0,0,0
"Monaco","2024-01-07",0,0,0,0,0,0,0,0
"Monaco","2024-01-08",0,0,0,0,0,0,0,0
"Monaco","2024-01-09",0,0,0,0,0,0,0,0
"Monaco","2024-01-10",0,0,0,0,0,0,0,0
"Monaco","2024-01-11",0,0,0,0,0,0,0,0
"Monaco","2024-01-12",0,0,0,0,0,0,0,0
"Monaco","2024-01-13",0,0,0,0,0,0,0,0
"Monaco","2024-01-14",0,0,0,0,0,0,0,0
"Monaco","2024-01-15",0,0,0,0,0,0,0,0
"Monaco","2024-01-16",0,0,0,0,0,0,0,0
"Monaco","2024-01-17",0,0,0,0,0,0,0,0
"Monaco","2024-01-18",0,0,0,0,0,0,0,0
"Monaco","2024-01-19",0,0,0,0,0,0,0,0
"Monaco","2024-01-20",0,0,0,0,0,0,0,0
"Monaco","2024-01-21",0,0,0,0,0,0,0,0
"Monaco","2024-01-22",0,0,0,0,0,0,0,0
"Monaco","2024-01-23",0,0,0,0,0,0,0,0
"Monaco","2024-01-24",0,0,0,0,0,0,0,0
"Monaco","2024-01-25",0,0,0,0,0,0,0,0
"Monaco","2024-01-26",0,0,0,0,0,0,0,0
"Monaco","2024-01-27",0,0,0,0,0,0,0,0
"Monaco","2024-01-28",0,0,0,0,0,0,0,0
"Monaco","2024-01-29",0,0,0,0,0,0,0,0
"Monaco","2024-01-30",0,0,0,0,0,0,0,0
"Monaco","2024-01-31",0,0,0,0,0,0,0,0
"Monaco","2024-02-01",0,0,0,0,0,0,0,0
"Monaco","2024-02-02",0,0,0,0,0,0,0,0
"Monaco","2024-02-03",0,0,0,0,0,0,0,0
"Monaco","2024-02-04",0,0,0,0,0,0,0,0
"Monaco","2024-02-05",0,0,0,0,0,0,0,0
"Monaco","2024-02-06",0,0,0,0,0,0,0,0
"Monaco","2024-02-07",0,0,0,0,0,0,0,0
"Monaco","2024-02-08",0,0,0,0,0,0,0,0
"Monaco","2024-02-09",0,0,0,0,0,0,0,0
"Monaco","2024-02-10",0,0,0,0,0,0,0,0
"Monaco","2024-02-11",0,0,0,0,0,0,0,0
"Monaco","2024-02-12",0,0,0,0,0,0,0,0
"Monaco","2024-02-13",0,0,0,0,0,0,0,0
"Monaco","2024-02-14",0,0,0,0,0,0,0,0
"Monaco","2024-02-15",0,0,0,0,0,0,0,0
"Monaco","2024-02-16",0,0,0,0,0,0,0,0
"Monaco","2024-02-17",0,0,0,0,0,0,0,0
"Monaco","2024-02-18",0,0,0,0,0,0,0,0
"Monaco","2024-02-19",0,0,0,0,0,0,0,0
"Monaco","2024-02-20",0,0,0,0,0,0,0,0
"Monaco","2024-02-21",0,0,0,0,0,0,0,0
"Monaco","2024-02-22",0,0,0,0,0,0,0,0
"Monaco","2024-02-23",0,0,0,0,0,0,0,0
"Monaco","2024-02-24",0,0,0,0,0,0,0,0
"Monaco","2024-02-25",0,0,0,0,0,0,0,0
"Monaco","2024-02-26",0,0,0,0,0,0,0,0
"Monaco","2024-02-27",0,0,0,0,0,0,0,0
"Monaco","2024-02-28",0,0,0,0,0,0,0,0
"Monaco","2024-02-29",0,0,0,0,0,0,0,0
"Monaco","2024-03-01",0,0,0,0,0,0,0,0
"Monaco","2024-03-02",0,0,0,0,0,0,0,0
"Monaco","2024-03-03",0,0,0,0,0,0,0,0
"Monaco","2024-03-04",0,0,0,0,0,0,0,0
"Monaco","2024-03-05",0,0,0,0,0,0,0,0
"Monaco","2024-03-06",0,0,0,0,0,0,0,0
"Monaco","2024-03-07",0,0,0,0,0,0,0,0
"Monaco","2024-03-08",0,0,0,0,0,0,0,0
"Monaco","2024-03-09",0,0,0,0,0,0,0,0
"Monaco","2024-03-10",0,0,0,0,0,0,0,0
"Monaco","2024-03-11",0,0,0,0,0,0,0,0
"Monaco","2024-03-12",0,0,0,0,0,0,0,0
"Monaco","2024-03-13",0,0,0,0,0,0,0,0
"Monaco","2024-03-14",0,0,0,0,0,0,0,0
"Monaco","2024-03-15",0,0,0,0,0,0,0,0
"Monaco","2024-03-16",0,0,0,0,0,0,0,0
"Monaco","2024-03-17",0,0,0,0,0,0,0,0
"Monaco","2024-03-18",0,0,0,0,0,0,0,0
"Monaco","2024-03-19",0,0,0,0,0,0,0,0
"Monaco","2024-03-20",0,0,0,0,0,0,0,0
"Monaco","2024-03-21",0,0,0,0,0,0,0,0
"Monaco","2024-03-22",0,0,0,0,0,0,0,0
"Monaco","2024-03-23",0,0,0,0,0,0,0,0
"Monaco","2024-03-24",0,0,0,0,0,0,0,0
"Monaco","2024-03-25",0,0,0,0,0,0,0,0
"Monaco","2024-03-26",0,0,0,0,0,0,0,0
"Monaco","2024-03-27",0,0,0,0,0,0,0,0
"Monaco","2024-03-28",0,0,0,0,0,0,0,0
"Monaco","2024-03-29",0,0,0,0,0,0,0,0
"Monaco","2024-03-30",0,0,0,0,0,0,0,0
"Monaco","2024-03-31",0,0,0,0,0,0,0,0
"Monaco","2024-04-01",0,0,0,0,0,0,0,0
"Monaco","2024-04-02",0,0,0,0,0,0,0,0
"Monaco","2024-04-03",0,0,0,0,0,0,0,0
"Monaco","2024-04-04",0,0,0,0,0,0,0,0
"Monaco","2024-04-05",0,0,0,0,0,0,0,0
"Monaco","2024-04-06",0,0,0,0,0,0,0,0
"Monaco","2024-04-07",0,0,0,0,0,0,0,0
"Monaco","2024-04-08",0,0,0,0,0,0,0,0
"Monaco","2024-04-09",0,0,0,0,0,0,0,0
"Monaco","2024-04-10",0,0,0,0,0,0,0,0
"Monaco","2024-04-11",0,0,0,0,0,0,0,0
"Monaco","2024-04-12",0,0,0,0,0,0,0,0
"Monaco","2024-04-13",0,0,0,0,0,0,0,0
"Monaco","2024-04-14",0,0,0,0,0,0,0,0
"Monaco","2024-04-15",0,0,0,0,0,0,0,0
"Monaco","2024-04-16",0,0,0,0,0,0,0,0
"Monaco","2024-04-17",0,0,0,0,0,0,0,0
"Monaco","2024-04-18",0,0,0,0,0,0,0,0
"Monaco","2024-04-19",0,0,0,0,0,0,0,0
"Monaco","2024-04-20",0,0,0,0,0,0,0,0
"Monaco","2024-04-21",0,0,0,0,0,0,0,0
"Monaco","2024-04-22",0,0,0,0,0,0,0,0
"Monaco","2024-04-23",0,0,0,0,0,0,0,0
"Monaco","2024-04-24",0,0,0,0,0,0,0,0
"Monaco","2024-04-25",0,0,0,0,0,0,0,0
"Monaco","2024-04-26",0,0,0,0,0,0,0,0
"Monaco","2024-04-27",0,0,0,0,0,0,0,0
"Monaco","2024-04-28",0,0,0,0,0,0,0,0
"Monaco","2024-04-29",0,0,0,0,0,0,0,0
"Monaco","2024-04-30",0,0,0,0,0,0,0,0
"Monaco","2024-05-01",0,0,0,0,0,0,0,0
"Monaco","2024-05-02",0,0,0,0,0,0,0,0
"Monaco","2024-05-03",0,0,0,0,0,0,0,0
"Monaco","2024-05-04",0,0,0,0,0,0,0,0
"Monaco","2024-05-05",0,0,0,0,0,0,0,0
"Monaco","2024-05-06",0,0,0,0,0,0,0,0
"Monaco","2024-05-07",0,0,0,0,0,0,0,0
"Monaco","2024-05-08",0,0,0,0,0,0,0,0
"Monaco","2024-05-09",0,0,0,0,0,0,0,0
"Monaco","2024-05-10",0,0,0,0,0,0,0,0
"Monaco","2024-05-11",0,0,0,0,0,0,0,0
"Monaco","2024-05-12",0,0,0,0,0,0,0,0
"Monaco","2024-05-13",0,0,0,0,0,0,0,0
"Monaco","2024-05-14",0,0,0,0,0,0,0,0
"Monaco","2024-05-15",0,0,0,0,0,0,0,0
"Monaco","2024-05-16",0,0,0,0,0,0,0,0
"Monaco","2024-05-17",0,0,0,0,0,0,0,0
"Monaco","2024-05-18",0,0,0,0,0,0,0,0
"Monaco","2024-05-19",0,0,0,0,0,0,0,0
"Monaco","2024-05-20",0,0,0,0,0,0,0,0
"Monaco","2024-05-21",0,0,0,0,0,0,0,0
"Monaco","2024-05-22",0,0,0,0,0,0,0,0
"Monaco","2024-05-23",0,0,0,0,0,0,0,0
"Monaco","2024-05-24",0,0,0,0,0,0,0,0
"Monaco","2024-05-25",0,0,0,0,0,0,0,0
"Monaco","2024-05-26",0,0,0,0,0,0,0,0
"Monaco","2024-05-27",0,0,0,0,0,0,0,0
"Monaco","2024-05-28",0,0,0,0,0,0,0,0
"Monaco","2024-05-29",0,0,0,0,0,0,0,0
"Monaco","2024-05-30",0,0,0,0,0,0,0,0
"Monaco","2024-05-31",0,0,0,0,0,0,0,0
"Monaco","2024-06-01",0,0,0,0,0,0,0,0
"Monaco","2024-06-02",0,0,0,0,0,0,0,0
"Monaco","2024-06-03",0,0,0,0,0,0,0,0
"Monaco","2024-06-04",0,0,0,0,0,0,0,0
"Monaco","2024-06-05",0,0,0,0,0,0,0,0
"Monaco","2024-06-06",0,0,0,0,0,0,0,0
"Monaco","2024-06-07",0,0,0,0,0,0,0,0
"Monaco","2024-06-08",0,0,0,0,0,0,0,0
"Monaco","2024-06-09",0,0,0,0,0,0,0,0
"Monaco","2024-06-10",0,0,0,0,0,0,0,0
"Monaco","2024-06-11",0,0,0,0,0,0,0,0
"Monaco","2024-06-12",0,0,0,0,0,0,0,0
"Monaco","2024-06-13",0,0,0,0,0,0,0,0
"Monaco","2024-06-14",0,0,0,0,0,0,0,0
"Monaco","2024-06-15",0,0,0,0,0,0,0,0
"Monaco","2024-06-16",0,0,0,0,0,0,0,0
"Monaco","2024-06-17",0,0,0,0,0,0,0,0
"Monaco","2024-06-18",0,0,0,0,0,0,0,0
"Monaco","2024-06-19",0,0,0,0,0,0,0,0
"Monaco","2024-06-20",0,0,0,0,0,0,0,0
"Monaco","2024-06-21",0,0,0,0,0,0,0,0
"Monaco","2024-06-22",0,0,0,0,0,0,0,0
"Monaco","2024-06-23",0,0,0,0,0,0,0,0
"Monaco","2024-06-24",0,0,0,0,0,0,0,0
"Monaco","2024-06-25",0,0,0,0,0,0,0,0
"Monaco","2024-06-26",0,0,0,0,0,0,0,0
"Monaco","2024-06-27",0,0,0,0,0,0,0,0
"Monaco","2024-06-28",0,0,0,0,0,0,0,0
"Monaco","2024-06-29",0,0,0,0,0,0,0,0
"Monaco","2024-06-30",0,0,0,0,0,0,0,0
"Monaco","2024-07-01",0,0,0,0,0,0,0,0
"Monaco","2024-07-02",0,0,0,0,0,0,0,0
"Monaco","2024-07-03",0,0,0,0,0,0,0,0
"Monaco","2024-07-04",0,0,0,0,0,0,0,0
"Monaco","2024-07-05",0,0,0,0,0,0,0,0
"Monaco","2024-07-06",0,0,0,0,0,0,0,0
"Monaco","2024-07-07",0,0,0,0,0,0,0,0
"Monaco","2024-07-08",0,0,0,0,0,0,0,0
"Monaco","2024-07-09",0,0,0,0,0,0,0,0
"Monaco","2024-07-10",0,0,0,0,0,0,0,0
"Monaco","2024-07-11",0,0,0,0,0,0,0,0
"Monaco","2024-07-12",0,0,0,0,0,0,0,0
"Monaco","2024-07-13",0,0,0,0,0,0,0,0
"Monaco","2024-07-14",0,0,0,0,0,0,0,0
"Monaco","2024-07-15",0,0,0,0,0,0,0,0
"Monaco","2024-07-16",0,0,0,0,0,0,0,0
"Monaco","2024-07-17",0,0,0,0,0,0,0,0
"Monaco","2024-07-18",0,0,0,0,0,0,0,0
"Monaco","2024-07-19",0,0,0,0,0,0,0,0
"Monaco","2024-07-20",0,0,0,0,0,0,0,0
"Monaco","2024-07-21",0,0,0,0,0,0,0,0
"Monaco","2024-07-22",0,0,0,0,0,0,0,0
"Monaco","2024-07-23",0,0,0,0,0,0,0,0
"Monaco","2024-07-24",0,0,0,0,0,0,0,0
"Monaco","2024-07-25",0,0,0,0,0,0,0,0
"Monaco","2024-07-26",0,0,0,0,0,0,0,0
"Monaco","2024-07-27",0,0,0,0,0,0,0,0
"Monaco","2024-07-28",0,0,0,0,0,0,0,0
"Monaco","2024-07-29",0,0,0,0,0,0,0,0
"Monaco","2024-07-30",0,0,0,0,0,0,0,0
"Monaco","2024-07-31",0,0,0,0,0,0,0,0
"Monaco","2024-08-01",0,0,0,0,0,0,0,0
"Monaco","2024-08-02",0,0,0,0,0,0,0,0
"Monaco","2024-08-03",0,0,0,0,0,0,0,0
"Monaco","2024-08-04",0,0,0,0,0,0,0,0
"Monaco","2024-08-05",0,0,0,0,0,0,0,0
"Monaco","2024-08-06",0,0,0,0,0,0,0,0
"Monaco","2024-08-07",0,0,0,0,0,0,0,0
"Monaco","2024-08-08",0,0,0,0,0,0,0,0
"Monaco","2024-08-09",0,0,0,0,0,0,0,0
"Monaco","2024-08-10",0,0,0,0,0,0,0,0
"Monaco","2024-08-11",0,0,0,0,0,0,0,0
"Monaco","2024-08-12",0,0,0,0,0,0,0,0
"Monaco","2024-08-13",0,0,0,0,0,0,0,0
"Monaco","2024-08-14",0,0,0,0,0,0,0,0
"Monaco","2024-08-15",0,0,0,0,0,0,0,0
"Monaco","2024-08-16",0,0,0,0,0,0,0,0
"Monaco","2024-08-17",0,0,0,0,0,0,0,0
"Monaco","2024-08-18",0,0,0,0,0,0,0,0
"Monaco","2024-08-19",0,0,0,0,0,0,0,0
"Monaco","2024-08-20",0,0,0,0,0,0,0,0
"Monaco","2024-08-21",0,0,0,0,0,0,0,0
"Monaco","2024-08-22",0,0,0,0,0,0,0,0
"Monaco","2024-08-23",0,0,0,0,0,0,0,0
"Monaco","2024-08-24",0,0,0,0,0,0,0,0
"Monaco","2024-08-25",0,0,0,0,0,0,0,0
"Monaco","2024-08-26",0,0,0,0,0,0,0,0
"Monaco","2024-08-27",0,0,0,0,0,0,0,0
"Monaco","2024-08-28",0,0,0,0,0,0,0,0
"Monaco","2024-08-29",0,0,0,0,0,0,0,0
"Monaco","2024-08-30",0,0,0,0,0,0,0,0
"Monaco","2024-08-31",0,0,0,0,0,0,0,0
"Monaco","2024-09-01",0,0,0,0,0,0,0,0
"Monaco","2024-09-02",0,0,0,0,0,0,0,0
"Monaco","2024-09-03",0,0,0,0,0,0,0,0
"Monaco","2024-09-04",0,0,0,0,0,0,0,0
"Monaco","2024-09-05",0,0,0,0,0,0,0,0
"Monaco","2024-09-06",0,0,0,0,0,0,0,0
"Monaco","2024-09-07",0,0,0,0,0,0,0,0
"Monaco","2024-09-08",0,0,0,0,0,0,0,0
"Monaco","2024-09-09",0,0,0,0,0,0,0,0
"Monaco","2024-09-10",0,0,0,0,0,0,0,0
"Monaco","2024-09-11",0,0,0,0,0,0,0,0
"Monaco","2024-09-12",0,0,0,0,0,0,0,0
"Monaco","2024-09-13",0,0,0,0,0,0,0,0
"Monaco","2024-09-14",0,0,0,0,0,0,0,0
"Monaco","2024-09-15",0,0,0,0,0,0,0,0
"Monaco","2024-09-16",0,0,0,0,0,0,0,0
"Monaco","2024-09-17",0,0,0,0,0,0,0,0
"Monaco","2024-09-18",0,0,0,0,0,0,0,0
"Monaco","2024-09-19",0,0,0,0,0,0,0,0
"Monaco","2024-09-20",0,0,0,0,0,0,0,0
"Monaco","2024-09-21",0,0,0,0,0,0,0,0
"Monaco","2024-09-22",0,0,0,0,0,0,0,0
"Monaco","2024-09-23",0,0,0,0,0,0,0,0
"Monaco","2024-09-24",0,0,0,0,0,0,0,0
"Monaco","2024-09-25",0,0,0,0,0,0,0,0
"Monaco","2024-09-26",0,0,0,0,0,0,0,0
"Monaco","2024-09-27",0,0,0,0,0,0,0,0
"Monaco","2024-09-28",0,0,0,0,0,0,0,0
"Monaco","2024-09-29",0,0,0,0,0,0,0,0
"Monaco","2024-09-30",0,0,0,0,0,0,0,0
"Monaco","2024-10-01",0,0,0,0,0,0,0,0
"Monaco","2024-10-02",0,0,0,0,0,0,0,0
"Monaco","2024-10-03",0,0,0,0,0,0,0,0
"Monaco","2024-10-04",0,0,0,0,0,0,0,0
"Monaco","2024-10-05",0,0,0,0,0,0,0,0
"Monaco","2024-10-06",0,0,0,0,0,0,0,0
"Monaco","2024-10-07",0,0,0,0,0,0,0,0
"Monaco","2024-10-08",0,0,0,0,0,0,0,0
"Monaco","2024-10-09",0,0,0,0,0,0,0,0
"Monaco","2024-10-10",0,0,0,0,0,0,0,0
"Monaco","2024-10-11",0,0,0,0,0,0,0,0
"Monaco","2024-10-12",0,0,0,0,0,0,0,0
"Monaco","2024-10-13",0,0,0,0,0,0,0,0
"Monaco","2024-10-14",0,0,0,0,0,0,0,0
"Monaco","2024-10-15",0,0,0,0,0,0,0,0
"Monaco","2024-10-16",0,0,0,0,0,0,0,0
"Monaco","2024-10-17",0,0,0,0,0,0,0,0
"Monaco","2024-10-18",0,0,0,0,0,0,0,0
"Monaco","2024-10-19",0,0,0,0,0,0,0,0
"Monaco","2024-10-20",0,0,0,0,0,0,0,0
"Monaco","2024-10-21",0,0,0,0,0,0,0,0
"Monaco","2024-10-22",0,0,0,0,0,0,0,0
"Monaco","2024-10-23",0,0,0,0,0,0,0,0
"Monaco","2024-10-24",0,0,0,0,0,0,0,0
"Monaco","2024-10-25",0,0,0,0,0,0,0,0
"Monaco","2024-10-26",0,0,0,0,0,0,0,0
"Monaco","2024-10-27",0,0,0,0,0,0,0,0
"Monaco","2024-10-28",0,0,0,0,0,0,0,0
"Monaco","2024-10-29",0,0,0,0,0,0,0,0
"Monaco","2024-10-30",0,0,0,0,0,0,0,0
"Monaco","2024-10-31",0,0,0,0,0,0,0,0
"Monaco","2024-11-01",0,0,0,0,0,0,0,0
"Monaco","2024-11-02",0,0,0,0,0,0,0,0
"Monaco","2024-11-03",0,0,0,0,0,0,0,0
"Monaco","2024-11-04",0,0,0,0,0,0,0,0
"Monaco","2024-11-05",0,0,0,0,0,0,0,0
"Monaco","2024-11-06",0,0,0,0,0,0,0,0
"Monaco","2024-11-07",0,0,0,0,0,0,0,0
"Monaco","2024-11-08",0,0,0,0,0,0,0,0
"Monaco","2024-11-09",0,0,0,0,0,0,0,0
"Monaco","2024-11-10",0,0,0,0,0,0,0,0
"Monaco","2024-11-11",0,0,0,0,0,0,0,0
"Monaco","2024-11-12",0,0,0,0,0,0,0,0
"Monaco","2024-11-13",0,0,0,0,0,0,0,0
"Monaco","2024-11-14",0,0,0,0,0,0,0,0
"Monaco","2024-11-15",0,0,0,0,0,0,0,0
"Monaco","2024-11-16",0,0,0,0,0,0,0,0
"Monaco","2024-11-17",0,0,0,0,0,0,0,0
"Monaco","2024-11-18",0,0,0,0,0,0,0,0
"Monaco","2024-11-19",0,0,0,0,0,0,0,0
"Monaco","2024-11-20",0,0,0,0,0,0,0,0
"Monaco","2024-11-21",0,0,0,0,0,0,0,0
"Monaco","2024-11-22",0,0,0,0,0,0,0,0
"Monaco","2024-11-23",0,0,0,0,0,0,0,0
"Monaco","2024-11-24",0,0,0,0,0,0,0,0
"Monaco","2024-11-25",0,0,0,0,0,0,0,0
"Monaco","2024-11-26",0,0,0,0,0,0,0,0
"Monaco","2024-11-27",0,0,0,0,0,0,0,0
"Monaco","2024-11-28",0,0,0,0,0,0,0,0
"Monaco","2024-11-29",0,0,0,0,0,0,0,0
"Monaco","2024-11-30",0,0,0,0,0,0,0,0
"Monaco","2024-12-01",0,0,0,0,0,0,0,0
"Monaco","2024-12-02",0,0,0,0,0,0,0,0
"Monaco","2024-12-03",0,0,0,0,0,0,0,0
"Monaco","2024-12-04",0,0,0,0,0,0,0,0
"Monaco","2024-12-05",0,0,0,0,0,0,0,0
"Monaco","2024-12-06",0,0,0,0,0,0,0,0
"Monaco","2024-12-07",0,0,0,0,0,0,0,0
"Monaco","2024-12-08",0,0,0,0,0,0,0,0
"Monaco","2024-12-09",0,0,0,0,0,0,0,0
"Monaco","2024-12-10",0,0,0,0,0,0,0,0
"Monaco","2024-12-11",0,0,0,0,0,0,0,0
"Monaco","2024-12-12",0,0,0,0,0,0,0,0
"Monaco","2024-12-13",0,0,0,0,0,0,0,0
"Monaco","2024-12-14",0,0,0,0,0,0,0,0
"Monaco","2024-12-15",0,0,0,0,0,0,0,0
"Monaco","2024-12-16",0,0,0,0,0,0,0,0
"Monaco","2024-12-17",0,0,0,0,0,0,0,0
"Monaco","2024-12-18",0,0,0,0,0,0,0,0
"Monaco","2024-12-19",0,0,0,0,0,0,0,0
"Monaco","2024-12-20",0,0,0,0,0,0,0,0
"Monaco","2024-12-21",0,0,0,0,0,0,0,0
"Monaco","2024-12-22",0,0,0,0,0,0,0,0
"Monaco","2024-12-23",0,0,0,0,0,0,0,0
"Monaco","2024-12-24",0,0,0,0,0,0,0,0
"Monaco","2024-12-25",0,0,0,0,0,0,0,0
"Monaco","2024-12-26",0,0,0,0,0,0,0,0
"Monaco","2024-12-27",0,0,0,0,0,0,0,0
"Monaco","2024-12-28",0,0,0,0,0,0,0,0
"Monaco","2024-12-29",0,0,0,0,0,0,0,0
"Monaco","2024-12-30",0,0,0,0,0,0,0,0
"Monaco","2024-12-31",0,0,0,0,0,0,0,0
"Monaco","2025-01-01",0,0,0,0,0,0,0,0
"Monaco","2025-01-02",0,0,0,0,0,0,0,0
"Monaco","2025-01-03",0,0,0,0,0,0,0,0
"Monaco","2025-01-04",0,0,0,0,0,0,0,0
"Monaco","2025-01-05",0,0,0,0,0,0,0,0
"Monaco","2025-01-06",0,0,0,0,0,0,0,0
"Monaco","2025-01-07",0,0,0,0,0,0,0,0
"Monaco","2025-01-08",0,0,0,0,0,0,0,0
"Monaco","2025-01-09",0,0,0,0,0,0,0,0
"Monaco","2025-01-10",0,0,0,0,0,0,0,0
"Monaco","2025-01-11",0,0,0,0,0,0,0,0
"Monaco","2025-01-12",0,0,0,0,0,0,0,0
"Monaco","2025-01-13",0,0,0,0,0,0,0,0
"Monaco","2025-01-14",0,0,0,0,0,0,0,0
"Monaco","2025-01-15",0,0,0,0,0,0,0,0
"Monaco","2025-01-16",0,0,0,0,0,0,0,0
"Monaco","2025-01-17",0,0,0,0,0,0,0,0
"Monaco","2025-01-18",0,0,0,0,0,0,0,0
"Monaco","2025-01-19",0,0,0,0,0,0,0,0
"Monaco","2025-01-20",0,0,0,0,0,0,0,0
"Monaco","2025-01-21",0,0,0,0,0,0,0,0
"Monaco","2025-01-22",0,0,0,0,0,0,0,0
"Monaco","2025-01-23",0,0,0,0,0,0,0,0
"Monaco","2025-01-24",0,0,0,0,0,0,0,0
"Monaco","2025-01-25",0,0,0,0,0,0,0,0
"Monaco","2025-01-26",0,0,0,0,0,0,0,0
"Monaco","2025-01-27",0,0,0,0,0,0,0,0
"Monaco","2025-01-28",0,0,0,0,0,0,0,0
"Monaco","2025-01-29",0,0,0,0,0,0,0,0
"Monaco","2025-01-30",0,0,0,0,0,0,0,0
"Monaco","2025-01-31",0,0,0,0,0,0,0,0
"Monaco","2025-02-01",0,0,0,0,0,0,0,0
"Monaco","2025-02-02",0,0,0,0,0,0,0,0
"Monaco","2025-02-03",0,0,0,0,0,0,0,0
"Monaco","2025-02-04",0,0,0,0,0,0,0,0
"Monaco","2025-02-05",0,0,0,0,0,0,0,0
"Monaco","2025-02-06",0,0,0,0,0,0,0,0
"Monaco","2025-02-07",0,0,0,0,0,0,0,0
"Monaco","2025-02-08",0,0,0,0,0,0,0,0
"Monaco","2025-02-09",0,0,0,0,0,0,0,0
"Monaco","2025-02-10",0,0,0,0,0,0,0,0
"Monaco","2025-02-11",0,0,0,0,0,0,0,0
"Monaco","2025-02-12",0,0,0,0,0,0,0,0
"Monaco","2025-02-13",0,0,0,0,0,0,0,0
"Monaco","2025-02-14",0,0,0,0,0,0,0,0
"Monaco","2025-02-15",0,0,0,0,0,0,0,0
"Monaco","2025-02-16",0,0,0,0,0,0,0,0
"Monaco","2025-02-17",0,0,0,0,0,0,0,0
"Monaco","2025-02-18",0,0,0,0,0,0,0,0
"Monaco","2025-02-19",0,0,0,0,0,0,0,0
"Monaco","2025-02-20",0,0,0,0,0,0,0,0
"Monaco","2025-02-21",0,0,0,0,0,0,0,0
"Monaco","2025-02-22",0,0,0,0,0,0,0,0
"Monaco","2025-02-23",0,0,0,0,0,0,0,0
"Monaco","2025-02-24",0,0,0,0,0,0,0,0
"Monaco","2025-02-25",0,0,0,0,0,0,0,0
"Monaco","2025-02-26",0,0,0,0,0,0,0,0
"Monaco","2025-02-27",0,0,0,0,0,0,0,0
"Monaco","2025-02-28",0,0,0,0,0,0,0,0
"Monaco","2025-03-01",0,0,0,0,0,0,0,0
"Monaco","2025-03-02",0,0,0,0,0,0,0,0
"Monaco","2025-03-03",0,0,0,0,0,0,0,0
"Montenegro","2024-01-01",0,0,0,0,0,0,0,0
"Montenegro","2024-01-02",0,0,0,0,0,0,0,0
"Montenegro","2024-01-03",0,0,0,0,0,0,0,0
"Montenegro","2024-01-04",0,0,0,0,0,0,0,0
"Montenegro","2024-01-05",0,0,0,0,0,0,0,0
"Montenegro","2024-01-06",0,0,0,0,0,0,0,0
"Montenegro","2024-01-07",0,0,0,0,0,0,0,0
"Montenegro","2024-01-08",0,0,0,0,0,0,0,0
"Montenegro","2024-01-09",0,0,0,0,0,0,0,0
"Montenegro","2024-01-10",0,0,0,0,0,0,0,0
"Montenegro","2024-01-11",0,0,0,0,0,0,0,0
"Montenegro","2024-01-12",0,0,0,0,0,0,0,0
"Montenegro","2024-01-13",0,0,0,0,0,0,0,0
"Montenegro","2024-01-14",0,0,0,0,0,0,0,0
"Montenegro","2024-01-15",0,0,0,0,0,0,0,0
"Montenegro","2024-01-16",0,0,0,0,0,0,0,0
"Montenegro","2024-01-17",0,0,0,0,0,0,0,0
"Montenegro","2024-01-18",0,0,0,0,0,0,0,0
"Montenegro","2024-01-19",0,0,0,0,0,0,0,0
"Montenegro","2024-01-20",0,0,0,0,0,0,0,0
"Montenegro","2024-01-21",0,0,0,0,0,0,0,0
"Montenegro","2024-01-22",0,0,0,0,0,0,0,0
"Montenegro","2024-01-23",0,0,0,0,0,0,0,0
"Montenegro","2024-01-24",0,0,0,0,0,0,0,0
"Montenegro","2024-01-25",0,0,0,0,0,0,0,0
"Montenegro","2024-01-26",0,0,0,0,0,0,0,0
"Montenegro","2024-01-27",0,0,0,0,0,0,0,0
"Montenegro","2024-01-28",0,0,0,0,0,0,0,0
"Montenegro","2024-01-29",0,0,0,0,0,0,0,0
"Montenegro","2024-01-30",0,0,0,0,0,0,0,0
"Montenegro","2024-01-31",0,0,0,0,0,0,0,0
"Montenegro","2024-02-01",0,0,0,0,0,0,0,0
"Montenegro","2024-02-02",0,0,0,0,0,0,0,0
"Montenegro","2024-02-03",0,0,0,0,0,0,0,0
"Montenegro","2024-02-04",0,0,0,0,0,0,0,0
"Montenegro","2024-02-05",0,0,0,0,0,0,0,0
"Montenegro","2024-02-06",0,0,0,0,0,0,0,0
"Montenegro","2024-02-07",0,0,0,0,0,0,0,0
"Montenegro","2024-02-08",0,0,0,0,0,0,0,0
"Montenegro","2024-02-09",0,0,0,0,0,0,0,0
"Montenegro","2024-02-10",0,0,0,0,0,0,0,0
"Montenegro","2024-02-11",0,0,0,0,0,0,0,0
"Montenegro","2024-02-12",0,0,0,0,0,0,0,0
"Montenegro","2024-02-13",0,0,0,0,0,0,0,0
"Montenegro","2024-02-14",0,0,0,0,0,0,0,0
"Montenegro","2024-02-15",0,0,0,0,0,0,0,0
"Montenegro","2024-02-16",0,0,0,0,0,0,0,0
"Montenegro","2024-02-17",0,0,0,0,0,0,0,0
"Montenegro","2024-02-18",0,0,0,0,0,0,0,0
"Montenegro","2024-02-19",0,0,0,0,0,0,0,0
"Montenegro","2024-02-20",0,0,0,0,0,0,0,0
"Montenegro","2024-02-21",0,0,0,0,0,0,0,0
"Montenegro","2024-02-22",0,0,0,0,0,0,0,0
"Montenegro","2024-02-23",0,0,0,0,0,0,0,0
"Montenegro","2024-02-24",0,0,0,0,0,0,0,0
"Montenegro","2024-02-25",0,0,0,0,0,0,0,0
"Montenegro","2024-02-26",0,0,0,0,0,0,0,0
"Montenegro","2024-02-27",0,0,0,0,0,0,0,0
"Montenegro","2024-02-28",0,0,0,0,0,0,0,0
"Montenegro","2024-02-29",0,0,0,0,0,0,0,0
"Montenegro","2024-03-01",0,0,0,0,0,0,0,0
"Montenegro","2024-03-02",0,0,0,0,0,0,0,0
"Montenegro","2024-03-03",0,0,0,0,0,0,0,0
"Montenegro","2024-03-04",0,0,0,0,0,0,0,0
"Montenegro","2024-03-05",0,0,0,0,0,0,0,0
"Montenegro","2024-03-06",0,0,0,0,0,0,0,0
"Montenegro","2024-03-07",0,0,0,0,0,0,0,0
"Montenegro","2024-03-08",0,0,0,0,0,0,0,0
"Montenegro","2024-03-09",0,0,0,0,0,0,0,0
"Montenegro","2024-03-10",0,0,0,0,0,0,0,0
"Montenegro","2024-03-11",0,0,0,0,0,0,0,0
"Montenegro","2024-03-12",0,0,0,0,0,0,0,0
"Montenegro","2024-03-13",0,0,0,0,0,0,0,0
"Montenegro","2024-03-14",0,0,0,0,0,0,0,0
"Montenegro","2024-03-15",0,0,0,0,0,0,0,0
"Montenegro","2024-03-16",0,0,0,0,0,0,0,0
"Montenegro","2024-03-17",0,0,0,0,0,0,0,0
"Montenegro","2024-03-18",0,0,0,0,0,0,0,0
"Montenegro","2024-03-19",0,0,0,0,0,0,0,0
"Montenegro","2024-03-20",0,0,0,0,0,0,0,0
"Montenegro","2024-03-21",0,0,0,0,0,0,0,0
"Montenegro","2024-03-22",0,0,0,0,0,0,0,0
"Montenegro","2024-03-23",0,0,0,0,0,0,0,0
"Montenegro","2024-03-24",0,0,0,0,0,0,0,0
"Montenegro","2024-03-25",0,0,0,0,0,0,0,0
"Montenegro","2024-03-26",0,0,0,0,0,0,0,0
"Montenegro","2024-03-27",0,0,0,0,0,0,0,0
"Montenegro","2024-03-28",0,0,0,0,0,0,0,0
"Montenegro","2024-03-29",0,0,0,0,0,0,0,0
"Montenegro","2024-03-30",0,0,0,0,0,0,0,0
"Montenegro","2024-03-31",0,0,0,0,0,0,0,0
"Montenegro","2024-04-01",0,0,0,0,0,0,0,0
"Montenegro","2024-04-02",0,0,0,0,0,0,0,0
"Montenegro","2024-04-03",0,0,0,0,0,0,0,0
"Montenegro","2024-04-04",0,0,0,0,0,0,0,0
"Montenegro","2024-04-05",0,0,0,0,0,0,0,0
"Montenegro","2024-04-06",0,0,0,0,0,0,0,0
"Montenegro","2024-04-07",0,0,0,0,0,0,0,0
"Montenegro","2024-04-08",0,0,0,0,0,0,0,0
"Montenegro","2024-04-09",0,0,0,0,0,0,0,0
"Montenegro","2024-04-10",0,0,0,0,0,0,0,0
"Montenegro","2024-04-11",0,0,0,0,0,0,0,0
"Montenegro","2024-04-12",0,0,0,0,0,0,0,0
"Montenegro","2024-04-13",0,0,0,0,0,0,0,0
"Montenegro","2024-04-14",0,0,0,0,0,0,0,0
"Montenegro","2024-04-15",0,0,0,0,0,0,0,0
"Montenegro","2024-04-16",0,0,0,0,0,0,0,0
"Montenegro","2024-04-17",0,0,0,0,0,0,0,0
"Montenegro","2024-04-18",0,0,0,0,0,0,0,0
"Montenegro","2024-04-19",0,0,0,0,0,0,0,0
"Montenegro","2024-04-20",0,0,0,0,0,0,0,0
"Montenegro","2024-04-21",0,0,0,0,0,0,0,0
"Montenegro","2024-04-22",0,0,0,0,0,0,0,0
"Montenegro","2024-04-23",0,0,0,0,0,0,0,0
"Montenegro","2024-04-24",0,0,0,0,0,0,0,0
"Montenegro","2024-04-25",0,0,0,0,0,0,0,0
"Montenegro","2024-04-26",0,0,0,0,0,0,0,0
"Montenegro","2024-04-27",0,0,0,0,0,0,0,0
"Montenegro","2024-04-28",0,0,0,0,0,0,0,0
"Montenegro","2024-04-29",0,0,0,0,0,0,0,0
"Montenegro","2024-04-30",0,0,0,0,0,0,0,0
"Montenegro","2024-05-01",0,0,0,0,0,0,0,0
"Montenegro","2024-05-02",0,0,0,0,0,0,0,0
"Montenegro","2024-05-03",0,0,0,0,0,0,0,0
"Montenegro","2024-05-04",0,0,0,0,0,0,0,0
"Montenegro","2024-05-05",0,0,0,0,0,0,0,0
"Montenegro","2024-05-06",0,0,0,0,0,0,0,0
"Montenegro","2024-05-07",0,0,0,0,0,0,0,0
"Montenegro","2024-05-08",0,0,0,0,0,0,0,0
"Montenegro","2024-05-09",0,0,0,0,0,0,0,0
"Montenegro","2024-05-10",0,0,0,0,0,0,0,0
"Montenegro","2024-05-11",0,0,0,0,0,0,0,0
"Montenegro","2024-05-12",0,0,0,0,0,0,0,0
"Montenegro","2024-05-13",0,0,0,0,0,0,0,0
"Montenegro","2024-05-14",0,0,0,0,0,0,0,0
"Montenegro","2024-05-15",0,0,0,0,0,0,0,0
"Montenegro","2024-05-16",0,0,0,0,0,0,0,0
"Montenegro","2024-05-17",0,0,0,0,0,0,0,0
"Montenegro","2024-05-18",0,0,0,0,0,0,0,0
"Montenegro","2024-05-19",0,0,0,0,0,0,0,0
"Montenegro","2024-05-20",0,0,0,0,0,0,0,0
"Montenegro","2024-05-21",0,0,0,0,0,0,0,0
"Montenegro","2024-05-22",0,0,0,0,0,0,0,0
"Montenegro","2024-05-23",0,0,0,0,0,0,0,0
"Montenegro","2024-05-24",0,0,0,0,0,0,0,0
"Montenegro","2024-05-25",0,0,0,0,0,0,0,0
"Montenegro","2024-05-26",0,0,0,0,0,0,0,0
"Montenegro","2024-05-27",0,0,0,0,0,0,0,0
"Montenegro","2024-05-28",0,0,0,0,0,0,0,0
"Montenegro","2024-05-29",0,0,0,0,0,0,0,0
"Montenegro","2024-05-30",0,0,0,0,0,0,0,0
"Montenegro","2024-05-31",0,0,0,0,0,0,0,0
"Montenegro","2024-06-01",0,0,0,0,0,0,0,0
"Montenegro","2024-06-02",0,0,0,0,0,0,0,0
"Montenegro","2024-06-03",0,0,0,0,0,0,0,0
"Montenegro","2024-06-04",0,0,0,0,0,0,0,0
"Montenegro","2024-06-05",0,0,0,0,0,0,0,0
"Montenegro","2024-06-06",0,0,0,0,0,0,0,0
"Montenegro","2024-06-07",0,0,0,0,0,0,0,0
"Montenegro","2024-06-08",0,0,0,0,0,0,0,0
"Montenegro","2024-06-09",0,0,0,0,0,0,0,0
"Montenegro","2024-06-10",0,0,0,0,0,0,0,0
"Montenegro","2024-06-11",0,0,0,0,0,0,0,0
"Montenegro","2024-06-12",0,0,0,0,0,0,0,0
"Montenegro","2024-06-13",0,0,0,0,0,0,0,0
"Montenegro","2024-06-14",0,0,0,0,0,0,0,0
"Montenegro","2024-06-15",0,0,0,0,0,0,0,0
"Montenegro","2024-06-16",0,0,0,0,0,0,0,0
"Montenegro","2024-06-17",0,0,0,0,0,0,0,0
"Montenegro","2024-06-18",0,0,0,0,0,0,0,0
"Montenegro","2024-06-19",0,0,0,0,0,0,0,0
"Montenegro","2024-06-20",0,0,0,0,0,0,0,0
"Montenegro","2024-06-21",0,0,0,0,0,0,0,0
"Montenegro","2024-06-22",0,0,0,0,0,0,0,0
"Montenegro","2024-06-23",0,0,0,0,0,0,0,0
"Montenegro","2024-06-24",0,0,0,0,0,0,0,0
"Montenegro","2024-06-25",0,0,0,0,0,0,0,0
"Montenegro","2024-06-26",0,0,0,0,0,0,0,0
"Montenegro","2024-06-27",0,0,0,0,0,0,0,0
"Montenegro","2024-06-28",0,0,0,0,0,0,0,0
"Montenegro","2024-06-29",0,0,0,0,0,0,0,0
"Montenegro","2024-06-30",0,0,0,0,0,0,0,0
"Montenegro","2024-07-01",0,0,0,0,0,0,0,0
"Montenegro","2024-07-02",0,0,0,0,0,0,0,0
"Montenegro","2024-07-03",0,0,0,0,0,0,0,0
"Montenegro","2024-07-04",0,0,0,0,0,0,0,0
"Montenegro","2024-07-05",0,0,0,0,0,0,0,0
"Montenegro","2024-07-06",0,0,0,0,0,0,0,0
"Montenegro","2024-07-07",0,0,0,0,0,0,0,0
"Montenegro","2024-07-08",0,0,0,0,0,0,0,0
"Montenegro","2024-07-09",0,0,0,0,0,0,0,0
"Montenegro","2024-07-10",0,0,0,0,0,0,0,0
"Montenegro","2024-07-11",0,0,0,0,0,0,0,0
"Montenegro","2024-07-12",0,0,0,0,0,0,0,0
"Montenegro","2024-07-13",0,0,0,0,0,0,0,0
"Montenegro","2024-07-14",0,0,0,0,0,0,0,0
"Montenegro","2024-07-15",0,0,0,0,0,0,0,0
"Montenegro","2024-07-16",0,0,0,0,0,0,0,0
"Montenegro","2024-07-17",0,0,0,0,0,0,0,0
"Montenegro","2024-07-18",0,0,0,0,0,0,0,0
"Montenegro","2024-07-19",0,0,0,0,0,0,0,0
"Montenegro","2024-07-20",0,0,0,0,0,0,0,0
"Montenegro","2024-07-21",0,0,0,0,0,0,0,0
"Montenegro","2024-07-22",0,0,0,0,0,0,0,0
"Montenegro","2024-07-23",0,0,0,0,0,0,0,0
"Montenegro","2024-07-24",0,0,0,0,0,0,0,0
"Montenegro","2024-07-25",0,0,0,0,0,0,0,0
"Montenegro","2024-07-26",0,0,0,0,0,0,0,0
"Montenegro","2024-07-27",0,0,0,0,0,0,0,0
"Montenegro","2024-07-28",0,0,0,0,0,0,0,0
"Montenegro","2024-07-29",0,0,0,0,0,0,0,0
"Montenegro","2024-07-30",0,0,0,0,0,0,0,0
"Montenegro","2024-07-31",0,0,0,0,0,0,0,0
"Montenegro","2024-08-01",0,0,0,0,0,0,0,0
"Montenegro","2024-08-02",0,0,0,0,0,0,0,0
"Montenegro","2024-08-03",0,0,0,0,0,0,0,0
"Montenegro","2024-08-04",0,0,0,0,0,0,0,0
"Montenegro","2024-08-05",0,0,0,0,0,0,0,0
"Montenegro","2024-08-06",0,0,0,0,0,0,0,0
"Montenegro","2024-08-07",0,0,0,0,0,0,0,0
"Montenegro","2024-08-08",0,0,0,0,0,0,0,0
"Montenegro","2024-08-09",0,0,0,0,0,0,0,0
"Montenegro","2024-08-10",0,0,0,0,0,0,0,0
"Montenegro","2024-08-11",0,0,0,0,0,0,0,0
"Montenegro","2024-08-12",0,0,0,0,0,0,0,0
"Montenegro","2024-08-13",0,0,0,0,0,0,0,0
"Montenegro","2024-08-14",0,0,0,0,0,0,0,0
"Montenegro","2024-08-15",0,0,0,0,0,0,0,0
"Montenegro","2024-08-16",0,0,0,0,0,0,0,0
"Montenegro","2024-08-17",0,0,0,0,0,0,0,0
"Montenegro","2024-08-18",0,0,0,0,0,0,0,0
"Montenegro","2024-08-19",0,0,0,0,0,0,0,0
"Montenegro","2024-08-20",0,0,0,0,0,0,0,0
"Montenegro","2024-08-21",0,0,0,0,0,0,0,0
"Montenegro","2024-08-22",0,0,0,0,0,0,0,0
"Montenegro","2024-08-23",0,0,0,0,0,0,0,0
"Montenegro","2024-08-24",0,0,0,0,0,0,0,0
"Montenegro","2024-08-25",0,0,0,0,0,0,0,0
"Montenegro","2024-08-26",0,0,0,0,0,0,0,0
"Montenegro","2024-08-27",0,0,0,0,0,0,0,0
"Montenegro","2024-08-28",0,0,0,0,0,0,0,0
"Montenegro","2024-08-29",0,0,0,0,0,0,0,0
"Montenegro","2024-08-30",0,0,0,0,0,0,0,0
"Montenegro","2024-08-31",0,0,0,0,0,0,0,0
"Montenegro","2024-09-01",0,0,0,0,0,0,0,0
"Montenegro","2024-09-02",0,0,0,0,0,0,0,0
"Montenegro","2024-09-03",0,0,0,0,0,0,0,0
"Montenegro","2024-09-04",0,0,0,0,0,0,0,0
"Montenegro","2024-09-05",0,0,0,0,0,0,0,0
"Montenegro","2024-09-06",0,0,0,0,0,0,0,0
"Montenegro","2024-09-07",0,0,0,0,0,0,0,0
"Montenegro","2024-09-08",0,0,0,0,0,0,0,0
"Montenegro","2024-09-09",0,0,0,0,0,0,0,0
"Montenegro","2024-09-10",0,0,0,0,0,0,0,0
"Montenegro","2024-09-11",0,0,0,0,0,0,0,0
"Montenegro","2024-09-12",0,0,0,0,0,0,0,0
"Montenegro","2024-09-13",0,0,0,0,0,0,0,0
"Montenegro","2024-09-14",0,0,0,0,0,0,0,0
"Montenegro","2024-09-15",0,0,0,0,0,0,0,0
"Montenegro","2024-09-16",0,0,0,0,0,0,0,0
"Montenegro","2024-09-17",0,0,0,0,0,0,0,0
"Montenegro","2024-09-18",0,0,0,0,0,0,0,0
"Montenegro","2024-09-19",0,0,0,0,0,0,0,0
"Montenegro","2024-09-20",0,0,0,0,0,0,0,0
"Montenegro","2024-09-21",0,0,0,0,0,0,0,0
"Montenegro","2024-09-22",0,0,0,0,0,0,0,0
"Montenegro","2024-09-23",0,0,0,0,0,0,0,0
"Montenegro","2024-09-24",0,0,0,0,0,0,0,0
"Montenegro","2024-09-25",0,0,0,0,0,0,0,0
"Montenegro","2024-09-26",0,0,0,0,0,0,0,0
"Montenegro","2024-09-27",0,0,0,0,0,0,0,0
"Montenegro","2024-09-28",0,0,0,0,0,0,0,0
"Montenegro","2024-09-29",0,0,0,0,0,0,0,0
"Montenegro","2024-09-30",0,0,0,0,0,0,0,0
"Montenegro","2024-10-01",0,0,0,0,0,0,0,0
"Montenegro","2024-10-02",0,0,0,0,0,0,0,0
"Montenegro","2024-10-03",0,0,0,0,0,0,0,0
"Montenegro","2024-10-04",0,0,0,0,0,0,0,0
"Montenegro","2024-10-05",0,0,0,0,0,0,0,0
"Montenegro","2024-10-06",0,0,0,0,0,0,0,0
"Montenegro","2024-10-07",0,0,0,0,0,0,0,0
"Montenegro","2024-10-08",0,0,0,0,0,0,0,0
"Montenegro","2024-10-09",0,0,0,0,0,0,0,0
"Montenegro","2024-10-10",0,0,0,0,0,0,0,0
"Montenegro","2024-10-11",0,0,0,0,0,0,0,0
"Montenegro","2024-10-12",0,0,0,0,0,0,0,0
"Montenegro","2024-10-13",0,0,0,0,0,0,0,0
"Montenegro","2024-10-14",0,0,0,0,0,0,0,0
"Montenegro","2024-10-15",0,0,0,0,0,0,0,0
"Montenegro","2024-10-16",0,0,0,0,0,0,0,0
"Montenegro","2024-10-17",0,0,0,0,0,0,0,0
"Montenegro","2024-10-18",0,0,0,0,0,0,0,0
"Montenegro","2024-10-19",0,0,0,0,0,0,0,0
"Montenegro","2024-10-20",0,0,0,0,0,0,0,0
"Montenegro","2024-10-21",0,0,0,0,0,0,0,0
"Montenegro","2024-10-22",0,0,0,0,0,0,0,0
"Montenegro","2024-10-23",0,0,0,0,0,0,0,0
"Montenegro","2024-10-24",0,0,0,0,0,0,0,0
"Montenegro","2024-10-25",0,0,0,0,0,0,0,0
"Montenegro","2024-10-26",0,0,0,0,0,0,0,0
"Montenegro","2024-10-27",0,0,0,0,0,0,0,0
"Montenegro","2024-10-28",0,0,0,0,0,0,0,0
"Montenegro","2024-10-29",0,0,0,0,0,0,0,0
"Montenegro","2024-10-30",0,0,0,0,0,0,0,0
"Montenegro","2024-10-31",0,0,0,0,0,0,0,0
"Montenegro","2024-11-01",0,0,0,0,0,0,0,0
"Montenegro","2024-11-02",0,0,0,0,0,0,0,0
"Montenegro","2024-11-03",0,0,0,0,0,0,0,0
"Montenegro","2024-11-04",0,0,0,0,0,0,0,0
"Montenegro","2024-11-05",0,0,0,0,0,0,0,0
"Montenegro","2024-11-06",0,0,0,0,0,0,0,0
"Montenegro","2024-11-07",0,0,0,0,0,0,0,0
"Montenegro","2024-11-08",0,0,0,0,0,0,0,0
"Montenegro","2024-11-09",0,0,0,0,0,0,0,0
"Montenegro","2024-11-10",0,0,0,0,0,0,0,0
"Montenegro","2024-11-11",0,0,0,0,0,0,0,0
"Montenegro","2024-11-12",0,0,0,0,0,0,0,0
"Montenegro","2024-11-13",0,0,0,0,0,0,0,0
"Montenegro","2024-11-14",0,0,0,0,0,0,0,0
"Montenegro","2024-11-15",0,0,0,0,0,0,0,0
"Montenegro","2024-11-16",0,0,0,0,0,0,0,0
"Montenegro","2024-11-17",0,0,0,0,0,0,0,0
"Montenegro","2024-11-18",0,0,0,0,0,0,0,0
"Montenegro","2024-11-19",0,0,0,0,0,0,0,0
"Montenegro","2024-11-20",0,0,0,0,0,0,0,0
"Montenegro","2024-11-21",0,0,0,0,0,0,0,0
"Montenegro","2024-11-22",0,0,0,0,0,0,0,0
"Montenegro","2024-11-23",0,0,0,0,0,0,0,0
"Montenegro","2024-11-24",0,0,0,0,0,0,0,0
"Montenegro","2024-11-25",0,0,0,0,0,0,0,0
"Montenegro","2024-11-26",0,0,0,0,0,0,0,0
"Montenegro","2024-11-27",0,0,0,0,0,0,0,0
"Montenegro","2024-11-28",0,0,0,0,0,0,0,0
"Montenegro","2024-11-29",0,0,0,0,0,0,0,0
"Montenegro","2024-11-30",0,0,0,0,0,0,0,0
"Montenegro","2024-12-01",0,0,0,0,0,0,0,0
"Montenegro","2024-12-02",0,0,0,0,0,0,0,0
"Montenegro","2024-12-03",0,0,0,0,0,0,0,0
"Montenegro","2024-12-04",0,0,0,0,0,0,0,0
"Montenegro","2024-12-05",0,0,0,0,0,0,0,0
"Montenegro","2024-12-06",0,0,0,0,0,0,0,0
"Montenegro","2024-12-07",0,0,0,0,0,0,0,0
"Montenegro","2024-12-08",0,0,0,0,0,0,0,0
"Montenegro","2024-12-09",0,0,0,0,0,0,0,0
"Montenegro","2024-12-10",0,0,0,0,0,0,0,0
"Montenegro","2024-12-11",0,0,0,0,0,0,0,0
"Montenegro","2024-12-12",0,0,0,0,0,0,0,0
"Montenegro","2024-12-13",0,0,0,0,0,0,0,0
"Montenegro","2024-12-14",0,0,0,0,0,0,0,0
"Montenegro","2024-12-15",0,0,0,0,0,0,0,0
"Montenegro","2024-12-16",0,0,0,0,0,0,0,0
"Montenegro","2024-12-17",0,0,0,0,0,0,0,0
"Montenegro","2024-12-18",0,0,0,0,0,0,0,0
"Montenegro","2024-12-19",0,0,0,0,0,0,0,0
"Montenegro","2024-12-20",0,0,0,0,0,0,0,0
"Montenegro","2024-12-21",0,0,0,0,0,0,0,0
"Montenegro","2024-12-22",0,0,0,0,0,0,0,0
"Montenegro","2024-12-23",0,0,0,0,0,0,0,0
"Montenegro","2024-12-24",0,0,0,0,0,0,0,0
"Montenegro","2024-12-25",0,0,0,0,0,0,0,0
"Montenegro","2024-12-26",0,0,0,0,0,0,0,0
"Montenegro","2024-12-27",0,0,0,0,0,0,0,0
"Montenegro","2024-12-28",0,0,0,0,0,0,0,0
"Montenegro","2024-12-29",0,0,0,0,0,0,0,0
"Montenegro","2024-12-30",0,0,0,0,0,0,0,0
"Montenegro","2024-12-31",0,0,0,0,0,0,0,0
"Montenegro","2025-01-01",0,0,0,0,0,0,0,0
"Montenegro","2025-01-02",0,0,0,0,0,0,0,0
"Montenegro","2025-01-03",0,0,0,0,0,0,0,0
"Montenegro","2025-01-04",0,0,0,0,0,0,0,0
"Montenegro","2025-01-05",0,0,0,0,0,0,0,0
"Montenegro","2025-01-06",0,0,0,0,0,0,0,0
"Montenegro","2025-01-07",0,0,0,0,0,0,0,0
"Montenegro","2025-01-08",0,0,0,0,0,0,0,0
"Montenegro","2025-01-09",0,0,0,0,0,0,0,0
"Montenegro","2025-01-10",0,0,0,0,0,0,0,0
"Montenegro","2025-01-11",0,0,0,0,0,0,0,0
"Montenegro","2025-01-12",0,0,0,0,0,0,0,0
"Montenegro","2025-01-13",0,0,0,0,0,0,0,0
"Montenegro","2025-01-14",0,0,0,0,0,0,0,0
"Montenegro","2025-01-15",0,0,0,0,0,0,0,0
"Montenegro","2025-01-16",0,0,0,0,0,0,0,0
"Montenegro","2025-01-17",0,0,0,0,0,0,0,0
"Montenegro","2025-01-18",0,0,0,0,0,0,0,0
"Montenegro","2025-01-19",0,0,0,0,0,0,0,0
"Montenegro","2025-01-20",0,0,0,0,0,0,0,0
"Montenegro","2025-01-21",0,0,0,0,0,0,0,0
"Montenegro","2025-01-22",0,0,0,0,0,0,0,0
"Montenegro","2025-01-23",0,0,0,0,0,0,0,0
"Montenegro","2025-01-24",0,0,0,0,0,0,0,0
"Montenegro","2025-01-25",0,0,0,0,0,0,0,0
"Montenegro","2025-01-26",0,0,0,0,0,0,0,0
"Montenegro","2025-01-27",0,0,0,0,0,0,0,0
"Montenegro","2025-01-28",0,0,0,0,0,0,0,0
"Montenegro","2025-01-29",0,0,0,0,0,0,0,0
"Montenegro","2025-01-30",0,0,0,0,0,0,0,0
"Montenegro","2025-01-31",0,0,0,0,0,0,0,0
"Montenegro","2025-02-01",0,0,0,0,0,0,0,0
"Montenegro","2025-02-02",0,0,0,0,0,0,0,0
"Montenegro","2025-02-03",0,0,0,0,0,0,0,0
"Montenegro","2025-02-04",0,0,0,0,0,0,0,0
"Montenegro","2025-02-05",0,0,0,0,0,0,0,0
"Montenegro","2025-02-06",0,0,0,0,0,0,0,0
"Montenegro","2025-02-07",0,0,0,0,0,0,0,0
"Montenegro","2025-02-08",0,0,0,0,0,0,0,0
"Montenegro","2025-02-09",0,0,0,0,0,0,0,0
"Montenegro","2025-02-10",0,0,0,0,0,0,0,0
"Montenegro","2025-02-11",0,0,0,0,0,0,0,0
"Montenegro","2025-02-12",0,0,0,0,0,0,0,0
"Montenegro","2025-02-13",0,0,0,0,0,0,0,0
"Montenegro","2025-02-14",0,0,0,0,0,0,0,0
"Montenegro","2025-02-15",0,0,0,0,0,0,0,0
"Montenegro","2025-02-16",0,0,0,0,0,0,0,0
"Montenegro","2025-02-17",0,0,0,0,0,0,0,0
"Montenegro","2025-02-18",0,0,0,0,0,0,0,0
"Montenegro","2025-02-19",0,0,0,0,0,0,0,0
"Montenegro","2025-02-20",0,0,0,0,0,0,0,0
"Montenegro","2025-02-21",0,0,0,0,0,0,0,0
"Montenegro","2025-02-22",0,0,0,0,0,0,0,0
"Montenegro","2025-02-23",0,0,0,0,0,0,0,0
"Montenegro","2025-02-24",0,0,0,0,0,0,0,0
"Montenegro","2025-02-25",0,0,0,0,0,0,0,0
"Montenegro","2025-02-26",0,0,0,0,0,0,0,0
"Montenegro","2025-02-27",0,0,0,0,0,0,0,0
"Montenegro","2025-02-28",0,0,0,0,0,0,0,0
"Montenegro","2025-03-01",0,0,0,0,0,0,0,0
"Montenegro","2025-03-02",0,0,0,0,0,0,0,0
"Montenegro","2025-03-03",0,0,0,0,0,0,0,0
"Morocco","2024-01-01",0,0,0,0,0,0,0,0
"Morocco","2024-01-02",0,0,0,0,0,0,0,0
"Morocco","2024-01-03",0,0,0,0,0,0,0,0
"Morocco","2024-01-04",0,0,0,0,0,0,0,0
"Morocco","2024-01-05",0,0,0,0,0,0,0,0
"Morocco","2024-01-06",0,0,0,0,0,0,0,0
"Morocco","2024-01-07",0,0,0,0,0,0,0,0
"Morocco","2024-01-08",0,0,0,0,0,0,0,0
"Morocco","2024-01-09",0,0,0,0,0,0,0,0
"Morocco","2024-01-10",0,0,0,0,0,0,0,0
"Morocco","2024-01-11",0,0,0,0,0,0,0,0
"Morocco","2024-01-12",0,0,0,0,0,0,0,0
"Morocco","2024-01-13",0,0,0,0,0,0,0,0
"Morocco","2024-01-14",0,0,0,0,0,0,0,0
"Morocco","2024-01-15",0,0,0,0,0,0,0,0
"Morocco","2024-01-16",0,0,0,0,0,0,0,0
"Morocco","2024-01-17",0,0,0,0,0,0,0,0
"Morocco","2024-01-18",0,0,0,0,0,0,0,0
"Morocco","2024-01-19",0,0,0,0,0,0,0,0
"Morocco","2024-01-20",0,0,0,0,0,0,0,0
"Morocco","2024-01-21",0,0,0,0,0,0,0,0
"Morocco","2024-01-22",0,0,0,0,0,0,0,0
"Morocco","2024-01-23",0,0,0,0,0,0,0,0
"Morocco","2024-01-24",0,0,0,0,0,0,0,0
"Morocco","2024-01-25",0,0,0,0,0,0,0,0
"Morocco","2024-01-26",0,0,0,0,0,0,0,0
"Morocco","2024-01-27",0,0,0,0,0,0,0,0
"Morocco","2024-01-28",0,0,0,0,0,0,0,0
"Morocco","2024-01-29",0,0,0,0,0,0,0,0
"Morocco","2024-01-30",0,0,0,0,0,0,0,0
"Morocco","2024-01-31",0,0,0,0,0,0,0,0
"Morocco","2024-02-01",0,0,0,0,0,0,0,0
"Morocco","2024-02-02",0,0,0,0,0,0,0,0
"Morocco","2024-02-03",0,0,0,0,0,0,0,0
"Morocco","2024-02-04",0,0,0,0,0,0,0,0
"Morocco","2024-02-05",0,0,0,0,0,0,0,0
"Morocco","2024-02-06",0,0,0,0,0,0,0,0
"Morocco","2024-02-07",0,0,0,0,0,0,0,0
"Morocco","2024-02-08",0,0,0,0,0,0,0,0
"Morocco","2024-02-09",0,0,0,0,0,0,0,0
"Morocco","2024-02-10",0,0,0,0,0,0,0,0
"Morocco","2024-02-11",0,0,0,0,0,0,0,0
"Morocco","2024-02-12",0,0,0,0,0,0,0,0
"Morocco","2024-02-13",0,0,0,0,0,0,0,0
"Morocco","2024-02-14",0,0,0,0,0,0,0,0
"Morocco","2024-02-15",0,0,0,0,0,0,0,0
"Morocco","2024-02-16",0,0,0,0,0,0,0,0
"Morocco","2024-02-17",0,0,0,0,0,0,0,0
"Morocco","2024-02-18",0,0,0,0,0,0,0,0
"Morocco","2024-02-19",0,0,0,0,0,0,0,0
"Morocco","2024-02-20",0,0,0,0,0,0,0,0
"Morocco","2024-02-21",0,0,0,0,0,0,0,0
"Morocco","2024-02-22",0,0,0,0,0,0,0,0
"Morocco","2024-02-23",0,0,0,0,0,0,0,0
"Morocco","2024-02-24",0,0,0,0,0,0,0,0
"Morocco","2024-02-25",0,0,0,0,0,0,0,0
"Morocco","2024-02-26",0,0,0,0,0,0,0,0
"Morocco","2024-02-27",0,0,0,0,0,0,0,0
"Morocco","2024-02-28",0,0,0,0,0,0,0,0
"Morocco","2024-02-29",0,0,0,0,0,0,0,0
"Morocco","2024-03-01",0,0,0,0,0,0,0,0
"Morocco","2024-03-02",0,0,0,0,0,0,0,0
"Morocco","2024-03-03",0,0,0,0,0,0,0,0
"Morocco","2024-03-04",0,0,0,0,0,0,0,0
"Morocco","2024-03-05",0,0,0,0,0,0,0,0
"Morocco","2024-03-06",0,0,0,0,0,0,0,0
"Morocco","2024-03-07",0,0,0,0,0,0,0,0
"Morocco","2024-03-08",0,0,0,0,0,0,0,0
"Morocco","2024-03-09",0,0,0,0,0,0,0,0
"Morocco","2024-03-10",0,0,0,0,0,0,0,0
"Morocco","2024-03-11",0,0,0,0,0,0,0,0
"Morocco","2024-03-12",0,0,0,0,0,0,0,0
"Morocco","2024-03-13",0,0,0,0,0,0,0,0
"Morocco","2024-03-14",0,0,0,0,0,0,0,0
"Morocco","2024-03-15",0,1,1,0,1,1,0,0
"Morocco","2024-03-16",0,0,1,0,0,1,0,0
"Morocco","2024-03-17",0,0,1,0,0,1,0,0
"Morocco","2024-03-18",0,0,1,0,0,1,0,0
"Morocco","2024-03-19",0,0,1,0,0,1,0,0
"Morocco","2024-03-20",0,0,1,0,0,1,0,0
"Morocco","2024-03-21",0,0,1,0,0,1,0,0
"Morocco","2024-03-22",0,0,1,0,0,1,0,0
"Morocco","2024-03-23",0,0,1,0,0,1,0,0
"Morocco","2024-03-24",0,0,1,0,0,1,0,0
"Morocco","2024-03-25",0,0,1,0,0,1,0,0
"Morocco","2024-03-26",0,0,1,0,0,1,0,0
"Morocco","2024-03-27",0,0,1,0,0,1,0,0
"Morocco","2024-03-28",0,0,1,0,0,1,0,0
"Morocco","2024-03-29",0,0,1,0,0,1,0,0
"Morocco","2024-03-30",0,0,1,0,0,1,0,0
"Morocco","2024-03-31",0,0,1,0,0,1,0,0
"Morocco","2024-04-01",0,0,1,0,0,1,0,0
"Morocco","2024-04-02",0,0,1,0,0,1,0,0
"Morocco","2024-04-03",0,0,1,0,0,1,0,0
"Morocco","2024-04-04",0,0,1,0,0,1,0,0
"Morocco","2024-04-05",0,0,1,0,0,1,0,0
"Morocco","2024-04-06",0,0,1,0,0,1,0,0
"Morocco","2024-04-07",0,0,1,0,0,1,0,0
"Morocco","2024-04-08",0,0,1,0,0,1,0,0
"Morocco","2024-04-09",0,0,1,0,0,1,0,0
"Morocco","2024-04-10",0,0,1,0,0,1,0,0
"Morocco","2024-04-11",0,0,1,0,0,1,0,0
"Morocco","2024-04-12",0,0,1,0,0,1,0,0
"Morocco","2024-04-13",0,0,1,0,0,1,0,0
"Morocco","2024-04-14",0,0,1,0,0,1,0,0
"Morocco","2024-04-15",0,0,1,0,0,1,0,0
"Morocco","2024-04-16",0,0,1,0,0,1,0,0
"Morocco","2024-04-17",0,0,1,0,0,1,0,0
"Morocco","2024-04-18",0,0,1,0,0,1,0,0
"Morocco","2024-04-19",0,0,1,0,0,1,0,0
"Morocco","2024-04-20",0,0,1,0,0,1,0,0
"Morocco","2024-04-21",0,0,1,0,0,1,0,0
"Morocco","2024-04-22",0,0,1,0,0,1,0,0
"Morocco","2024-04-23",0,0,1,0,0,1,0,0
"Morocco","2024-04-24",0,0,1,0,0,1,0,0
"Morocco","2024-04-25",0,0,1,0,0,1,0,0
"Morocco","2024-04-26",0,0,1,0,0,1,0,0
"Morocco","2024-04-27",0,0,1,0,0,1,0,0
"Morocco","2024-04-28",0,0,1,0,0,1,0,0
"Morocco","2024-04-29",0,0,1,0,0,1,0,0
"Morocco","2024-04-30",0,0,1,0,0,1,0,0
"Morocco","2024-05-01",0,0,1,0,0,1,0,0
"Morocco","2024-05-02",0,0,1,0,0,1,0,0
"Morocco","2024-05-03",0,0,1,0,0,1,0,0
"Morocco","2024-05-04",0,0,1,0,0,1,0,0
"Morocco","2024-05-05",0,0,1,0,0,1,0,0
"Morocco","2024-05-06",0,0,1,0,0,1,0,0
"Morocco","2024-05-07",0,0,1,0,0,1,0,0
"Morocco","2024-05-08",0,0,1,0,0,1,0,0
"Morocco","2024-05-09",0,0,1,0,0,1,0,0
"Morocco","2024-05-10",0,0,1,0,0,1,0,0
"Morocco","2024-05-11",0,0,1,0,0,1,0,0
"Morocco","2024-05-12",0,0,1,0,0,1,0,0
"Morocco","2024-05-13",0,0,1,0,0,1,0,0
"Morocco","2024-05-14",0,0,1,0,0,1,0,0
"Morocco","2024-05-15",0,0,1,0,0,1,0,0
"Morocco","2024-05-16",0,0,1,0,0,1,0,0
"Morocco","2024-05-17",0,0,1,0,0,1,0,0
"Morocco","2024-05-18",0,0,1,0,0,1,0,0
"Morocco","2024-05-19",0,0,1,0,0,1,0,0
"Morocco","2024-05-20",0,0,1,0,0,1,0,0
"Morocco","2024-05-21",0,0,1,0,0,1,0,0
"Morocco","2024-05-22",0,0,1,0,0,1,0,0
"Morocco","2024-05-23",0,0,1,0,0,1,0,0
"Morocco","2024-05-24",0,0,1,0,0,1,0,0
"Morocco","2024-05-25",0,0,1,0,0,1,0,0
"Morocco","2024-05-26",0,0,1,0,0,1,0,0
"Morocco","2024-05-27",0,0,1,0,0,1,0,0
"Morocco","2024-05-28",0,0,1,0,0,1,0,0
"Morocco","2024-05-29",0,0,1,0,0,1,0,0
"Morocco","2024-05-30",0,0,1,0,0,1,0,0
"Morocco","2024-05-31",0,0,1,0,0,1,0,0
"Morocco","2024-06-01",0,0,1,0,0,1,0,0
"Morocco","2024-06-02",0,0,1,0,0,1,0,0
"Morocco","2024-06-03",0,0,1,0,0,1,0,0
"Morocco","2024-06-04",0,0,1,0,0,1,0,0
"Morocco","2024-06-05",0,0,1,0,0,1,0,0
"Morocco","2024-06-06",0,0,1,0,0,1,0,0
"Morocco","2024-06-07",0,0,1,0,0,1,0,0
"Morocco","2024-06-08",0,0,1,0,0,1,0,0
"Morocco","2024-06-09",0,0,1,0,0,1,0,0
"Morocco","2024-06-10",0,0,1,0,0,1,0,0
"Morocco","2024-06-11",0,0,1,0,0,1,0,0
"Morocco","2024-06-12",0,0,1,0,0,1,0,0
"Morocco","2024-06-13",0,0,1,0,0,1,0,0
"Morocco","2024-06-14",0,0,1,0,1,2,0,0
"Morocco","2024-06-15",0,0,1,0,0,2,0,0
"Morocco","2024-06-16",0,0,1,0,0,2,0,0
"Morocco","2024-06-17",0,0,1,0,0,2,0,0
"Morocco","2024-06-18",0,0,1,0,0,2,0,0
"Morocco","2024-06-19",0,0,1,0,0,2,0,0
"Morocco","2024-06-20",0,0,1,0,0,2,0,0
"Morocco","2024-06-21",0,0,1,0,0,2,0,0
"Morocco","2024-06-22",0,0,1,0,0,2,0,0
"Morocco","2024-06-23",0,0,1,0,0,2,0,0
"Morocco","2024-06-24",0,0,1,0,0,2,0,0
"Morocco","2024-06-25",0,0,1,0,0,2,0,0
"Morocco","2024-06-26",0,0,1,0,0,2,0,0
"Morocco","2024-06-27",0,0,1,0,0,2,0,0
"Morocco","2024-06-28",0,0,1,0,0,2,0,0
"Morocco","2024-06-29",0,0,1,0,0,2,0,0
"Morocco","2024-06-30",0,0,1,0,0,2,0,0
"Morocco","2024-07-01",0,0,1,0,0,2,0,0
"Morocco","2024-07-02",0,0,1,0,0,2,0,0
"Morocco","2024-07-03",0,0,1,0,0,2,0,0
"Morocco","2024-07-04",0,0,1,0,0,2,0,0
"Morocco","2024-07-05",0,0,1,0,0,2,0,0
"Morocco","2024-07-06",0,0,1,0,0,2,0,0
"Morocco","2024-07-07",0,0,1,0,0,2,0,0
"Morocco","2024-07-08",0,0,1,0,0,2,0,0
"Morocco","2024-07-09",0,0,1,0,0,2,0,0
"Morocco","2024-07-10",0,0,1,0,0,2,0,0
"Morocco","2024-07-11",0,0,1,0,0,2,0,0
"Morocco","2024-07-12",0,0,1,0,0,2,0,0
"Morocco","2024-07-13",0,0,1,0,0,2,0,0
"Morocco","2024-07-14",0,0,1,0,0,2,0,0
"Morocco","2024-07-15",0,0,1,0,0,2,0,0
"Morocco","2024-07-16",0,0,1,0,0,2,0,0
"Morocco","2024-07-17",0,0,1,0,0,2,0,0
"Morocco","2024-07-18",0,0,1,0,0,2,0,0
"Morocco","2024-07-19",0,0,1,0,0,2,0,0
"Morocco","2024-07-20",0,0,1,0,0,2,0,0
"Morocco","2024-07-21",0,0,1,0,0,2,0,0
"Morocco","2024-07-22",0,0,1,0,0,2,0,0
"Morocco","2024-07-23",0,0,1,0,0,2,0,0
"Morocco","2024-07-24",0,0,1,0,0,2,0,0
"Morocco","2024-07-25",0,0,1,0,0,2,0,0
"Morocco","2024-07-26",0,0,1,0,0,2,0,0
"Morocco","2024-07-27",0,0,1,0,0,2,0,0
"Morocco","2024-07-28",0,0,1,0,0,2,0,0
"Morocco","2024-07-29",0,0,1,0,0,2,0,0
"Morocco","2024-07-30",0,0,1,0,0,2,0,0
"Morocco","2024-07-31",0,0,1,0,0,2,0,0
"Morocco","2024-08-01",0,0,1,0,0,2,0,0
"Morocco","2024-08-02",0,0,1,0,0,2,0,0
"Morocco","2024-08-03",0,0,1,0,0,2,0,0
"Morocco","2024-08-04",0,0,1,0,0,2,0,0
"Morocco","2024-08-05",0,0,1,0,0,2,0,0
"Morocco","2024-08-06",0,0,1,0,0,2,0,0
"Morocco","2024-08-07",0,0,1,0,0,2,0,0
"Morocco","2024-08-08",0,0,1,0,0,2,0,0
"Morocco","2024-08-09",0,0,1,0,0,2,0,0
"Morocco","2024-08-10",0,0,1,0,0,2,0,0
"Morocco","2024-08-11",0,0,1,0,0,2,0,0
"Morocco","2024-08-12",0,0,1,0,0,2,0,0
"Morocco","2024-08-13",0,0,1,0,0,2,0,0
"Morocco","2024-08-14",0,0,1,0,0,2,0,0
"Morocco","2024-08-15",0,0,1,0,0,2,0,0
"Morocco","2024-08-16",0,0,1,0,0,2,0,0
"Morocco","2024-08-17",0,0,1,0,0,2,0,0
"Morocco","2024-08-18",0,0,1,0,0,2,0,0
"Morocco","2024-08-19",0,0,1,0,0,2,0,0
"Morocco","2024-08-20",0,0,1,0,0,2,0,0
"Morocco","2024-08-21",0,0,1,0,0,2,0,0
"Morocco","2024-08-22",0,0,1,0,0,2,0,0
"Morocco","2024-08-23",0,0,1,0,0,2,0,0
"Morocco","2024-08-24",0,0,1,0,0,2,0,0
"Morocco","2024-08-25",0,0,1,0,0,2,0,0
"Morocco","2024-08-26",0,0,1,0,0,2,0,0
"Morocco","2024-08-27",0,0,1,0,0,2,0,0
"Morocco","2024-08-28",0,0,1,0,0,2,0,0
"Morocco","2024-08-29",0,0,1,0,0,2,0,0
"Morocco","2024-08-30",0,0,1,0,0,2,0,0
"Morocco","2024-08-31",0,0,1,0,0,2,0,0
"Morocco","2024-09-01",0,0,1,0,0,2,0,0
"Morocco","2024-09-02",0,0,1,0,0,2,0,0
"Morocco","2024-09-03",0,0,1,0,0,2,0,0
"Morocco","2024-09-04",0,0,1,0,0,2,0,0
"Morocco","2024-09-05",0,0,1,0,0,2,0,0
"Morocco","2024-09-06",0,0,1,0,0,2,0,0
"Morocco","2024-09-07",0,0,1,0,0,2,0,0
"Morocco","2024-09-08",0,0,1,0,0,2,0,0
"Morocco","2024-09-09",0,0,1,0,0,2,0,0
"Morocco","2024-09-10",0,0,1,0,0,2,0,0
"Morocco","2024-09-11",0,0,1,0,0,2,0,0
"Morocco","2024-09-12",0,1,2,0,0,2,0,0
"Morocco","2024-09-13",0,0,2,0,0,2,0,0
"Morocco","2024-09-14",0,0,2,0,0,2,0,0
"Morocco","2024-09-15",0,0,2,0,0,2,0,0
"Morocco","2024-09-16",0,0,2,0,0,2,0,0
"Morocco","2024-09-17",0,0,2,0,0,2,0,0
"Morocco","2024-09-18",0,0,2,0,0,2,0,0
"Morocco","2024-09-19",0,0,2,0,0,2,0,0
"Morocco","2024-09-20",0,0,2,0,0,2,0,0
"Morocco","2024-09-21",0,0,2,0,0,2,0,0
"Morocco","2024-09-22",0,0,2,0,0,2,0,0
"Morocco","2024-09-23",0,0,2,0,1,3,0,0
"Morocco","2024-09-24",0,0,2,0,0,3,0,0
"Morocco","2024-09-25",0,0,2,0,0,3,0,0
"Morocco","2024-09-26",0,0,2,0,0,3,0,0
"Morocco","2024-09-27",0,0,2,0,0,3,0,0
"Morocco","2024-09-28",0,0,2,0,0,3,0,0
"Morocco","2024-09-29",0,0,2,0,0,3,0,0
"Morocco","2024-09-30",0,0,2,0,0,3,0,0
"Morocco","2024-10-01",0,0,2,0,0,3,0,0
"Morocco","2024-10-02",0,0,2,0,0,3,0,0
"Morocco","2024-10-03",0,1,3,0,0,3,0,0
"Morocco","2024-10-04",0,0,3,0,0,3,0,0
"Morocco","2024-10-05",0,0,3,0,0,3,0,0
"Morocco","2024-10-06",0,0,3,0,0,3,0,0
"Morocco","2024-10-07",0,0,3,0,0,3,0,0
"Morocco","2024-10-08",0,0,3,0,0,3,0,0
"Morocco","2024-10-09",0,0,3,0,0,3,0,0
"Morocco","2024-10-10",0,0,3,0,0,3,0,0
"Morocco","2024-10-11",0,0,3,0,0,3,0,0
"Morocco","2024-10-12",0,0,3,0,0,3,0,0
"Morocco","2024-10-13",0,0,3,0,0,3,0,0
"Morocco","2024-10-14",0,0,3,0,0,3,0,0
"Morocco","2024-10-15",0,0,3,0,0,3,0,0
"Morocco","2024-10-16",0,0,3,0,0,3,0,0
"Morocco","2024-10-17",0,0,3,0,0,3,0,0
"Morocco","2024-10-18",0,0,3,0,0,3,0,0
"Morocco","2024-10-19",0,0,3,0,0,3,0,0
"Morocco","2024-10-20",0,0,3,0,0,3,0,0
"Morocco","2024-10-21",0,0,3,0,0,3,0,0
"Morocco","2024-10-22",0,0,3,0,0,3,0,0
"Morocco","2024-10-23",0,0,3,0,0,3,0,0
"Morocco","2024-10-24",0,0,3,0,0,3,0,0
"Morocco","2024-10-25",0,0,3,0,0,3,0,0
"Morocco","2024-10-26",0,0,3,0,0,3,0,0
"Morocco","2024-10-27",0,0,3,0,0,3,0,0
"Morocco","2024-10-28",0,0,3,0,0,3,0,0
"Morocco","2024-10-29",0,0,3,0,0,3,0,0
"Morocco","2024-10-30",0,0,3,0,0,3,0,0
"Morocco","2024-10-31",0,0,3,0,0,3,0,0
"Morocco","2024-11-01",0,0,3,0,0,3,0,0
"Morocco","2024-11-02",0,0,3,0,0,3,0,0
"Morocco","2024-11-03",0,0,3,0,0,3,0,0
"Morocco","2024-11-04",0,0,3,0,0,3,0,0
"Morocco","2024-11-05",0,0,3,0,0,3,0,0
"Morocco","2024-11-06",0,0,3,0,0,3,0,0
"Morocco","2024-11-07",0,0,3,0,0,3,0,0
"Morocco","2024-11-08",0,0,3,0,0,3,0,0
"Morocco","2024-11-09",0,0,3,0,0,3,0,0
"Morocco","2024-11-10",0,0,3,0,0,3,0,0
"Morocco","2024-11-11",0,0,3,0,0,3,0,0
"Morocco","2024-11-12",0,0,3,0,0,3,0,0
"Morocco","2024-11-13",0,0,3,0,0,3,0,0
"Morocco","2024-11-14",0,0,3,0,0,3,0,0
"Morocco","2024-11-15",0,0,3,0,0,3,0,0
"Morocco","2024-11-16",0,0,3,0,0,3,0,0
"Morocco","2024-11-17",0,0,3,0,0,3,0,0
"Morocco","2024-11-18",0,0,3,0,0,3,0,0
"Morocco","2024-11-19",0,0,3,0,0,3,0,0
"Morocco","2024-11-20",0,0,3,0,0,3,0,0
"Morocco","2024-11-21",0,0,3,0,0,3,0,0
"Morocco","2024-11-22",0,0,3,0,0,3,0,0
"Morocco","2024-11-23",0,0,3,0,0,3,0,0
"Morocco","2024-11-24",0,0,3,0,0,3,0,0
"Morocco","2024-11-25",0,0,3,0,0,3,0,0
"Morocco","2024-11-26",0,0,3,0,0,3,0,0
"Morocco","2024-11-27",0,0,3,0,0,3,0,0
"Morocco","2024-11-28",0,0,3,0,0,3,0,0
"Morocco","2024-11-29",0,0,3,0,0,3,0,0
"Morocco","2024-11-30",0,0,3,0,0,3,0,0
"Morocco","2024-12-01",0,0,3,0,0,3,0,0
"Morocco","2024-12-02",0,0,3,0,0,3,0,0
"Morocco","2024-12-03",0,0,3,0,0,3,0,0
"Morocco","2024-12-04",0,0,3,0,0,3,0,0
"Morocco","2024-12-05",0,0,3,0,0,3,0,0
"Morocco","2024-12-06",0,0,3,0,0,3,0,0
"Morocco","2024-12-07",0,0,3,0,0,3,0,0
"Morocco","2024-12-08",0,0,3,0,0,3,0,0
"Morocco","2024-12-09",0,0,3,0,0,3,0,0
"Morocco","2024-12-10",0,0,3,0,0,3,0,0
"Morocco","2024-12-11",0,0,3,0,0,3,0,0
"Morocco","2024-12-12",0,0,3,0,0,3,0,0
"Morocco","2024-12-13",0,0,3,0,0,3,0,0
"Morocco","2024-12-14",0,0,3,0,0,3,0,0
"Morocco","2024-12-15",0,0,3,0,0,3,0,0
"Morocco","2024-12-16",0,0,3,0,0,3,0,0
"Morocco","2024-12-17",0,0,3,0,0,3,0,0
"Morocco","2024-12-18",0,0,3,0,0,3,0,0
"Morocco","2024-12-19",0,0,3,0,0,3,0,0
"Morocco","2024-12-20",0,0,3,0,0,3,0,0
"Morocco","2024-12-21",0,0,3,0,0,3,0,0
"Morocco","2024-12-22",0,0,3,0,0,3,0,0
"Morocco","2024-12-23",0,0,3,0,0,3,0,0
"Morocco","2024-12-24",0,0,3,0,0,3,0,0
"Morocco","2024-12-25",0,0,3,0,0,3,0,0
"Morocco","2024-12-26",0,0,3,0,0,3,0,0
"Morocco","2024-12-27",0,0,3,0,0,3,0,0
"Morocco","2024-12-28",0,0,3,0,0,3,0,0
"Morocco","2024-12-29",0,0,3,0,0,3,0,0
"Morocco","2024-12-30",0,0,3,0,0,3,0,0
"Morocco","2024-12-31",0,0,3,0,0,3,0,0
"Morocco","2025-01-01",0,0,3,0,0,3,0,0
"Morocco","2025-01-02",0,0,3,0,0,3,0,0
"Morocco","2025-01-03",0,0,3,0,0,3,0,0
"Morocco","2025-01-04",0,0,3,0,0,3,0,0
"Morocco","2025-01-05",0,0,3,0,0,3,0,0
"Morocco","2025-01-06",0,0,3,0,0,3,0,0
"Morocco","2025-01-07",0,0,3,0,0,3,0,0
"Morocco","2025-01-08",0,0,3,0,0,3,0,0
"Morocco","2025-01-09",0,0,3,0,0,3,0,0
"Morocco","2025-01-10",0,0,3,0,0,3,0,0
"Morocco","2025-01-11",0,0,3,0,0,3,0,0
"Morocco","2025-01-12",0,0,3,0,0,3,0,0
"Morocco","2025-01-13",0,0,3,0,0,3,0,0
"Morocco","2025-01-14",0,0,3,0,0,3,0,0
"Morocco","2025-01-15",0,0,3,0,0,3,0,0
"Morocco","2025-01-16",0,0,3,0,0,3,0,0
"Morocco","2025-01-17",0,0,3,0,0,3,0,0
"Morocco","2025-01-18",0,0,3,0,0,3,0,0
"Morocco","2025-01-19",0,0,3,0,0,3,0,0
"Morocco","2025-01-20",0,0,3,0,0,3,0,0
"Morocco","2025-01-21",0,0,3,0,0,3,0,0
"Morocco","2025-01-22",0,0,3,0,0,3,0,0
"Morocco","2025-01-23",0,0,3,0,0,3,0,0
"Morocco","2025-01-24",0,0,3,0,0,3,0,0
"Morocco","2025-01-25",0,0,3,0,0,3,0,0
"Morocco","2025-01-26",0,0,3,0,0,3,0,0
"Morocco","2025-01-27",0,0,3,0,0,3,0,0
"Morocco","2025-01-28",0,0,3,0,0,3,0,0
"Morocco","2025-01-29",0,0,3,0,0,3,0,0
"Morocco","2025-01-30",0,0,3,0,0,3,0,0
"Morocco","2025-01-31",0,0,3,0,0,3,0,0
"Morocco","2025-02-01",0,0,3,0,0,3,0,0
"Morocco","2025-02-02",0,0,3,0,0,3,0,0
"Morocco","2025-02-03",0,0,3,0,0,3,0,0
"Morocco","2025-02-04",0,0,3,0,0,3,0,0
"Morocco","2025-02-05",0,0,3,0,0,3,0,0
"Morocco","2025-02-06",0,0,3,0,0,3,0,0
"Morocco","2025-02-07",0,0,3,0,0,3,0,0
"Morocco","2025-02-08",0,0,3,0,0,3,0,0
"Morocco","2025-02-09",0,0,3,0,0,3,0,0
"Morocco","2025-02-10",0,0,3,0,0,3,0,0
"Morocco","2025-02-11",0,0,3,0,0,3,0,0
"Morocco","2025-02-12",0,0,3,0,0,3,0,0
"Morocco","2025-02-13",0,0,3,0,0,3,0,0
"Morocco","2025-02-14",0,0,3,0,0,3,0,0
"Morocco","2025-02-15",0,0,3,0,0,3,0,0
"Morocco","2025-02-16",0,0,3,0,0,3,0,0
"Morocco","2025-02-17",0,0,3,0,0,3,0,0
"Morocco","2025-02-18",0,0,3,0,0,3,0,0
"Morocco","2025-02-19",0,0,3,0,0,3,0,0
"Morocco","2025-02-20",0,0,3,0,0,3,0,0
"Morocco","2025-02-21",0,0,3,0,0,3,0,0
"Morocco","2025-02-22",0,0,3,0,0,3,0,0
"Morocco","2025-02-23",0,0,3,0,0,3,0,0
"Morocco","2025-02-24",0,0,3,0,0,3,0,0
"Morocco","2025-02-25",0,0,3,0,0,3,0,0
"Morocco","2025-02-26",0,0,3,0,0,3,0,0
"Morocco","2025-02-27",0,0,3,0,0,3,0,0
"Morocco","2025-02-28",0,0,3,0,0,3,0,0
"Morocco","2025-03-01",0,0,3,0,0,3,0,0
"Morocco","2025-03-02",0,0,3,0,0,3,0,0
"Morocco","2025-03-03",0,0,3,0,0,3,0,0
"Mozambique","2024-01-01",0,0,0,0,0,0,0,0
"Mozambique","2024-01-02",0,0,0,0,0,0,0,0
"Mozambique","2024-01-03",0,0,0,0,0,0,0,0
"Mozambique","2024-01-04",0,0,0,0,0,0,0,0
"Mozambique","2024-01-05",0,0,0,0,0,0,0,0
"Mozambique","2024-01-06",0,0,0,0,0,0,0,0
"Mozambique","2024-01-07",0,0,0,0,0,0,0,0
"Mozambique","2024-01-08",0,0,0,0,0,0,0,0
"Mozambique","2024-01-09",0,0,0,0,0,0,0,0
"Mozambique","2024-01-10",0,0,0,0,0,0,0,0
"Mozambique","2024-01-11",0,0,0,0,0,0,0,0
"Mozambique","2024-01-12",0,0,0,0,0,0,0,0
"Mozambique","2024-01-13",0,0,0,0,0,0,0,0
"Mozambique","2024-01-14",0,0,0,0,0,0,0,0
"Mozambique","2024-01-15",0,0,0,0,0,0,0,0
"Mozambique","2024-01-16",0,0,0,0,0,0,0,0
"Mozambique","2024-01-17",0,0,0,0,0,0,0,0
"Mozambique","2024-01-18",0,0,0,0,0,0,0,0
"Mozambique","2024-01-19",0,0,0,0,0,0,0,0
"Mozambique","2024-01-20",0,0,0,0,0,0,0,0
"Mozambique","2024-01-21",0,0,0,0,0,0,0,0
"Mozambique","2024-01-22",0,0,0,0,0,0,0,0
"Mozambique","2024-01-23",0,0,0,0,0,0,0,0
"Mozambique","2024-01-24",0,0,0,0,0,0,0,0
"Mozambique","2024-01-25",0,0,0,0,0,0,0,0
"Mozambique","2024-01-26",0,0,0,0,0,0,0,0
"Mozambique","2024-01-27",0,0,0,0,0,0,0,0
"Mozambique","2024-01-28",0,0,0,0,0,0,0,0
"Mozambique","2024-01-29",0,0,0,0,0,0,0,0
"Mozambique","2024-01-30",0,0,0,0,0,0,0,0
"Mozambique","2024-01-31",0,0,0,0,0,0,0,0
"Mozambique","2024-02-01",0,0,0,0,0,0,0,0
"Mozambique","2024-02-02",0,0,0,0,0,0,0,0
"Mozambique","2024-02-03",0,0,0,0,0,0,0,0
"Mozambique","2024-02-04",0,0,0,0,0,0,0,0
"Mozambique","2024-02-05",0,0,0,0,0,0,0,0
"Mozambique","2024-02-06",0,0,0,0,0,0,0,0
"Mozambique","2024-02-07",0,0,0,0,0,0,0,0
"Mozambique","2024-02-08",0,0,0,0,0,0,0,0
"Mozambique","2024-02-09",0,0,0,0,0,0,0,0
"Mozambique","2024-02-10",0,0,0,0,0,0,0,0
"Mozambique","2024-02-11",0,0,0,0,0,0,0,0
"Mozambique","2024-02-12",0,0,0,0,0,0,0,0
"Mozambique","2024-02-13",0,0,0,0,0,0,0,0
"Mozambique","2024-02-14",0,0,0,0,0,0,0,0
"Mozambique","2024-02-15",0,0,0,0,0,0,0,0
"Mozambique","2024-02-16",0,0,0,0,0,0,0,0
"Mozambique","2024-02-17",0,0,0,0,0,0,0,0
"Mozambique","2024-02-18",0,0,0,0,0,0,0,0
"Mozambique","2024-02-19",0,0,0,0,0,0,0,0
"Mozambique","2024-02-20",0,0,0,0,0,0,0,0
"Mozambique","2024-02-21",0,0,0,0,0,0,0,0
"Mozambique","2024-02-22",0,0,0,0,0,0,0,0
"Mozambique","2024-02-23",0,0,0,0,0,0,0,0
"Mozambique","2024-02-24",0,0,0,0,0,0,0,0
"Mozambique","2024-02-25",0,0,0,0,0,0,0,0
"Mozambique","2024-02-26",0,0,0,0,0,0,0,0
"Mozambique","2024-02-27",0,0,0,0,0,0,0,0
"Mozambique","2024-02-28",0,0,0,0,0,0,0,0
"Mozambique","2024-02-29",0,0,0,0,0,0,0,0
"Mozambique","2024-03-01",0,0,0,0,0,0,0,0
"Mozambique","2024-03-02",0,0,0,0,0,0,0,0
"Mozambique","2024-03-03",0,0,0,0,0,0,0,0
"Mozambique","2024-03-04",0,0,0,0,0,0,0,0
"Mozambique","2024-03-05",0,0,0,0,0,0,0,0
"Mozambique","2024-03-06",0,0,0,0,0,0,0,0
"Mozambique","2024-03-07",0,0,0,0,0,0,0,0
"Mozambique","2024-03-08",0,0,0,0,0,0,0,0
"Mozambique","2024-03-09",0,0,0,0,0,0,0,0
"Mozambique","2024-03-10",0,0,0,0,0,0,0,0
"Mozambique","2024-03-11",0,0,0,0,0,0,0,0
"Mozambique","2024-03-12",0,0,0,0,0,0,0,0
"Mozambique","2024-03-13",0,0,0,0,0,0,0,0
"Mozambique","2024-03-14",0,0,0,0,0,0,0,0
"Mozambique","2024-03-15",0,0,0,0,0,0,0,0
"Mozambique","2024-03-16",0,0,0,0,0,0,0,0
"Mozambique","2024-03-17",0,0,0,0,0,0,0,0
"Mozambique","2024-03-18",0,0,0,0,0,0,0,0
"Mozambique","2024-03-19",0,0,0,0,0,0,0,0
"Mozambique","2024-03-20",0,0,0,0,0,0,0,0
"Mozambique","2024-03-21",0,0,0,0,0,0,0,0
"Mozambique","2024-03-22",0,0,0,0,0,0,0,0
"Mozambique","2024-03-23",0,0,0,0,0,0,0,0
"Mozambique","2024-03-24",0,0,0,0,0,0,0,0
"Mozambique","2024-03-25",0,0,0,0,0,0,0,0
"Mozambique","2024-03-26",0,0,0,0,0,0,0,0
"Mozambique","2024-03-27",0,0,0,0,0,0,0,0
"Mozambique","2024-03-28",0,0,0,0,0,0,0,0
"Mozambique","2024-03-29",0,0,0,0,0,0,0,0
"Mozambique","2024-03-30",0,0,0,0,0,0,0,0
"Mozambique","2024-03-31",0,0,0,0,0,0,0,0
"Mozambique","2024-04-01",0,0,0,0,0,0,0,0
"Mozambique","2024-04-02",0,0,0,0,0,0,0,0
"Mozambique","2024-04-03",0,0,0,0,0,0,0,0
"Mozambique","2024-04-04",0,0,0,0,0,0,0,0
"Mozambique","2024-04-05",0,0,0,0,0,0,0,0
"Mozambique","2024-04-06",0,0,0,0,0,0,0,0
"Mozambique","2024-04-07",0,0,0,0,0,0,0,0
"Mozambique","2024-04-08",0,0,0,0,0,0,0,0
"Mozambique","2024-04-09",0,0,0,0,0,0,0,0
"Mozambique","2024-04-10",0,0,0,0,0,0,0,0
"Mozambique","2024-04-11",0,0,0,0,0,0,0,0
"Mozambique","2024-04-12",0,0,0,0,0,0,0,0
"Mozambique","2024-04-13",0,0,0,0,0,0,0,0
"Mozambique","2024-04-14",0,0,0,0,0,0,0,0
"Mozambique","2024-04-15",0,0,0,0,0,0,0,0
"Mozambique","2024-04-16",0,0,0,0,0,0,0,0
"Mozambique","2024-04-17",0,0,0,0,0,0,0,0
"Mozambique","2024-04-18",0,0,0,0,0,0,0,0
"Mozambique","2024-04-19",0,0,0,0,0,0,0,0
"Mozambique","2024-04-20",0,0,0,0,0,0,0,0
"Mozambique","2024-04-21",0,0,0,0,0,0,0,0
"Mozambique","2024-04-22",0,0,0,0,0,0,0,0
"Mozambique","2024-04-23",0,0,0,0,0,0,0,0
"Mozambique","2024-04-24",0,0,0,0,0,0,0,0
"Mozambique","2024-04-25",0,0,0,0,0,0,0,0
"Mozambique","2024-04-26",0,0,0,0,0,0,0,0
"Mozambique","2024-04-27",0,0,0,0,0,0,0,0
"Mozambique","2024-04-28",0,0,0,0,0,0,0,0
"Mozambique","2024-04-29",0,0,0,0,0,0,0,0
"Mozambique","2024-04-30",0,0,0,0,0,0,0,0
"Mozambique","2024-05-01",0,0,0,0,0,0,0,0
"Mozambique","2024-05-02",0,0,0,0,0,0,0,0
"Mozambique","2024-05-03",0,0,0,0,0,0,0,0
"Mozambique","2024-05-04",0,0,0,0,0,0,0,0
"Mozambique","2024-05-05",0,0,0,0,0,0,0,0
"Mozambique","2024-05-06",0,0,0,0,0,0,0,0
"Mozambique","2024-05-07",0,0,0,0,0,0,0,0
"Mozambique","2024-05-08",0,0,0,0,0,0,0,0
"Mozambique","2024-05-09",0,0,0,0,0,0,0,0
"Mozambique","2024-05-10",0,0,0,0,0,0,0,0
"Mozambique","2024-05-11",0,0,0,0,0,0,0,0
"Mozambique","2024-05-12",0,0,0,0,0,0,0,0
"Mozambique","2024-05-13",0,0,0,0,0,0,0,0
"Mozambique","2024-05-14",0,0,0,0,0,0,0,0
"Mozambique","2024-05-15",0,0,0,0,0,0,0,0
"Mozambique","2024-05-16",0,0,0,0,0,0,0,0
"Mozambique","2024-05-17",0,0,0,0,0,0,0,0
"Mozambique","2024-05-18",0,0,0,0,0,0,0,0
"Mozambique","2024-05-19",0,0,0,0,0,0,0,0
"Mozambique","2024-05-20",0,0,0,0,0,0,0,0
"Mozambique","2024-05-21",0,0,0,0,0,0,0,0
"Mozambique","2024-05-22",0,0,0,0,0,0,0,0
"Mozambique","2024-05-23",0,0,0,0,0,0,0,0
"Mozambique","2024-05-24",0,0,0,0,0,0,0,0
"Mozambique","2024-05-25",0,0,0,0,0,0,0,0
"Mozambique","2024-05-26",0,0,0,0,0,0,0,0
"Mozambique","2024-05-27",0,0,0,0,0,0,0,0
"Mozambique","2024-05-28",0,0,0,0,0,0,0,0
"Mozambique","2024-05-29",0,0,0,0,0,0,0,0
"Mozambique","2024-05-30",0,0,0,0,0,0,0,0
"Mozambique","2024-05-31",0,0,0,0,0,0,0,0
"Mozambique","2024-06-01",0,0,0,0,0,0,0,0
"Mozambique","2024-06-02",0,0,0,0,0,0,0,0
"Mozambique","2024-06-03",0,0,0,0,0,0,0,0
"Mozambique","2024-06-04",0,0,0,0,0,0,0,0
"Mozambique","2024-06-05",0,0,0,0,0,0,0,0
"Mozambique","2024-06-06",0,0,0,0,0,0,0,0
"Mozambique","2024-06-07",0,0,0,0,0,0,0,0
"Mozambique","2024-06-08",0,0,0,0,0,0,0,0
"Mozambique","2024-06-09",0,0,0,0,0,0,0,0
"Mozambique","2024-06-10",0,0,0,0,0,0,0,0
"Mozambique","2024-06-11",0,0,0,0,0,0,0,0
"Mozambique","2024-06-12",0,0,0,0,0,0,0,0
"Mozambique","2024-06-13",0,0,0,0,0,0,0,0
"Mozambique","2024-06-14",0,0,0,0,0,0,0,0
"Mozambique","2024-06-15",0,0,0,0,0,0,0,0
"Mozambique","2024-06-16",0,0,0,0,0,0,0,0
"Mozambique","2024-06-17",0,0,0,0,0,0,0,0
"Mozambique","2024-06-18",0,0,0,0,0,0,0,0
"Mozambique","2024-06-19",0,0,0,0,0,0,0,0
"Mozambique","2024-06-20",0,0,0,0,0,0,0,0
"Mozambique","2024-06-21",0,0,0,0,0,0,0,0
"Mozambique","2024-06-22",0,0,0,0,0,0,0,0
"Mozambique","2024-06-23",0,0,0,0,0,0,0,0
"Mozambique","2024-06-24",0,0,0,0,0,0,0,0
"Mozambique","2024-06-25",0,0,0,0,0,0,0,0
"Mozambique","2024-06-26",0,0,0,0,0,0,0,0
"Mozambique","2024-06-27",0,0,0,0,0,0,0,0
"Mozambique","2024-06-28",0,0,0,0,0,0,0,0
"Mozambique","2024-06-29",0,0,0,0,0,0,0,0
"Mozambique","2024-06-30",0,0,0,0,0,0,0,0
"Mozambique","2024-07-01",0,0,0,0,0,0,0,0
"Mozambique","2024-07-02",0,0,0,0,0,0,0,0
"Mozambique","2024-07-03",0,0,0,0,0,0,0,0
"Mozambique","2024-07-04",0,0,0,0,0,0,0,0
"Mozambique","2024-07-05",0,0,0,0,0,0,0,0
"Mozambique","2024-07-06",0,0,0,0,0,0,0,0
"Mozambique","2024-07-07",0,0,0,0,0,0,0,0
"Mozambique","2024-07-08",0,0,0,0,0,0,0,0
"Mozambique","2024-07-09",0,0,0,0,0,0,0,0
"Mozambique","2024-07-10",0,0,0,0,0,0,0,0
"Mozambique","2024-07-11",0,0,0,0,0,0,0,0
"Mozambique","2024-07-12",0,0,0,0,0,0,0,0
"Mozambique","2024-07-13",0,0,0,0,0,0,0,0
"Mozambique","2024-07-14",0,0,0,0,0,0,0,0
"Mozambique","2024-07-15",0,0,0,0,0,0,0,0
"Mozambique","2024-07-16",0,0,0,0,0,0,0,0
"Mozambique","2024-07-17",0,0,0,0,0,0,0,0
"Mozambique","2024-07-18",0,0,0,0,0,0,0,0
"Mozambique","2024-07-19",0,0,0,0,0,0,0,0
"Mozambique","2024-07-20",0,0,0,0,0,0,0,0
"Mozambique","2024-07-21",0,0,0,0,0,0,0,0
"Mozambique","2024-07-22",0,0,0,0,0,0,0,0
"Mozambique","2024-07-23",0,0,0,0,0,0,0,0
"Mozambique","2024-07-24",0,0,0,0,0,0,0,0
"Mozambique","2024-07-25",0,0,0,0,0,0,0,0
"Mozambique","2024-07-26",0,0,0,0,0,0,0,0
"Mozambique","2024-07-27",0,0,0,0,0,0,0,0
"Mozambique","2024-07-28",0,0,0,0,0,0,0,0
"Mozambique","2024-07-29",0,0,0,0,0,0,0,0
"Mozambique","2024-07-30",0,0,0,0,0,0,0,0
"Mozambique","2024-07-31",0,0,0,0,0,0,0,0
"Mozambique","2024-08-01",0,0,0,0,0,0,0,0
"Mozambique","2024-08-02",0,0,0,0,0,0,0,0
"Mozambique","2024-08-03",0,0,0,0,0,0,0,0
"Mozambique","2024-08-04",0,0,0,0,0,0,0,0
"Mozambique","2024-08-05",0,0,0,0,0,0,0,0
"Mozambique","2024-08-06",0,0,0,0,0,0,0,0
"Mozambique","2024-08-07",0,0,0,0,0,0,0,0
"Mozambique","2024-08-08",0,0,0,0,0,0,0,0
"Mozambique","2024-08-09",0,0,0,0,0,0,0,0
"Mozambique","2024-08-10",0,0,0,0,0,0,0,0
"Mozambique","2024-08-11",0,0,0,0,0,0,0,0
"Mozambique","2024-08-12",0,0,0,0,0,0,0,0
"Mozambique","2024-08-13",0,0,0,0,0,0,0,0
"Mozambique","2024-08-14",0,0,0,0,0,0,0,0
"Mozambique","2024-08-15",0,0,0,0,0,0,0,0
"Mozambique","2024-08-16",0,0,0,0,0,0,0,0
"Mozambique","2024-08-17",0,0,0,0,0,0,0,0
"Mozambique","2024-08-18",0,0,0,0,0,0,0,0
"Mozambique","2024-08-19",0,0,0,0,0,0,0,0
"Mozambique","2024-08-20",0,0,0,0,0,0,0,0
"Mozambique","2024-08-21",0,0,0,0,0,0,0,0
"Mozambique","2024-08-22",0,0,0,0,0,0,0,0
"Mozambique","2024-08-23",0,0,0,0,0,0,0,0
"Mozambique","2024-08-24",0,0,0,0,0,0,0,0
"Mozambique","2024-08-25",0,0,0,0,0,0,0,0
"Mozambique","2024-08-26",0,0,0,0,0,0,0,0
"Mozambique","2024-08-27",0,0,0,0,0,0,0,0
"Mozambique","2024-08-28",0,0,0,0,0,0,0,0
"Mozambique","2024-08-29",0,0,0,0,0,0,0,0
"Mozambique","2024-08-30",0,0,0,0,0,0,0,0
"Mozambique","2024-08-31",0,0,0,0,0,0,0,0
"Mozambique","2024-09-01",0,0,0,0,0,0,0,0
"Mozambique","2024-09-02",0,0,0,0,0,0,0,0
"Mozambique","2024-09-03",0,0,0,0,0,0,0,0
"Mozambique","2024-09-04",0,0,0,0,0,0,0,0
"Mozambique","2024-09-05",0,0,0,0,0,0,0,0
"Mozambique","2024-09-06",0,0,0,0,0,0,0,0
"Mozambique","2024-09-07",0,0,0,0,0,0,0,0
"Mozambique","2024-09-08",0,0,0,0,0,0,0,0
"Mozambique","2024-09-09",0,0,0,0,0,0,0,0
"Mozambique","2024-09-10",0,0,0,0,0,0,0,0
"Mozambique","2024-09-11",0,0,0,0,0,0,0,0
"Mozambique","2024-09-12",0,0,0,0,0,0,0,0
"Mozambique","2024-09-13",0,0,0,0,0,0,0,0
"Mozambique","2024-09-14",0,0,0,0,0,0,0,0
"Mozambique","2024-09-15",0,0,0,0,0,0,0,0
"Mozambique","2024-09-16",0,0,0,0,0,0,0,0
"Mozambique","2024-09-17",0,0,0,0,0,0,0,0
"Mozambique","2024-09-18",0,0,0,0,0,0,0,0
"Mozambique","2024-09-19",0,0,0,0,0,0,0,0
"Mozambique","2024-09-20",0,0,0,0,0,0,0,0
"Mozambique","2024-09-21",0,0,0,0,0,0,0,0
"Mozambique","2024-09-22",0,0,0,0,0,0,0,0
"Mozambique","2024-09-23",0,0,0,0,0,0,0,0
"Mozambique","2024-09-24",0,0,0,0,0,0,0,0
"Mozambique","2024-09-25",0,0,0,0,0,0,0,0
"Mozambique","2024-09-26",0,0,0,0,0,0,0,0
"Mozambique","2024-09-27",0,0,0,0,0,0,0,0
"Mozambique","2024-09-28",0,0,0,0,0,0,0,0
"Mozambique","2024-09-29",0,0,0,0,0,0,0,0
"Mozambique","2024-09-30",0,0,0,0,0,0,0,0
"Mozambique","2024-10-01",0,0,0,0,0,0,0,0
"Mozambique","2024-10-02",0,0,0,0,0,0,0,0
"Mozambique","2024-10-03",0,0,0,0,0,0,0,0
"Mozambique","2024-10-04",0,0,0,0,0,0,0,0
"Mozambique","2024-10-05",0,0,0,0,0,0,0,0
"Mozambique","2024-10-06",0,0,0,0,0,0,0,0
"Mozambique","2024-10-07",0,0,0,0,0,0,0,0
"Mozambique","2024-10-08",0,0,0,0,0,0,0,0
"Mozambique","2024-10-09",0,0,0,0,0,0,0,0
"Mozambique","2024-10-10",0,0,0,0,0,0,0,0
"Mozambique","2024-10-11",0,0,0,0,0,0,0,0
"Mozambique","2024-10-12",0,0,0,0,0,0,0,0
"Mozambique","2024-10-13",0,0,0,0,0,0,0,0
"Mozambique","2024-10-14",0,0,0,0,0,0,0,0
"Mozambique","2024-10-15",0,0,0,0,0,0,0,0
"Mozambique","2024-10-16",0,0,0,0,0,0,0,0
"Mozambique","2024-10-17",0,0,0,0,0,0,0,0
"Mozambique","2024-10-18",0,0,0,0,0,0,0,0
"Mozambique","2024-10-19",0,0,0,0,0,0,0,0
"Mozambique","2024-10-20",0,0,0,0,0,0,0,0
"Mozambique","2024-10-21",0,0,0,0,0,0,0,0
"Mozambique","2024-10-22",0,0,0,0,0,0,0,0
"Mozambique","2024-10-23",0,0,0,0,0,0,0,0
"Mozambique","2024-10-24",0,0,0,0,0,0,0,0
"Mozambique","2024-10-25",0,0,0,0,0,0,0,0
"Mozambique","2024-10-26",0,0,0,0,0,0,0,0
"Mozambique","2024-10-27",0,0,0,0,0,0,0,0
"Mozambique","2024-10-28",0,0,0,0,0,0,0,0
"Mozambique","2024-10-29",0,0,0,0,0,0,0,0
"Mozambique","2024-10-30",0,0,0,0,0,0,0,0
"Mozambique","2024-10-31",0,0,0,0,0,0,0,0
"Mozambique","2024-11-01",0,0,0,0,0,0,0,0
"Mozambique","2024-11-02",0,0,0,0,0,0,0,0
"Mozambique","2024-11-03",0,0,0,0,0,0,0,0
"Mozambique","2024-11-04",0,0,0,0,0,0,0,0
"Mozambique","2024-11-05",0,0,0,0,0,0,0,0
"Mozambique","2024-11-06",0,0,0,0,0,0,0,0
"Mozambique","2024-11-07",0,0,0,0,0,0,0,0
"Mozambique","2024-11-08",0,0,0,0,0,0,0,0
"Mozambique","2024-11-09",0,0,0,0,0,0,0,0
"Mozambique","2024-11-10",0,0,0,0,0,0,0,0
"Mozambique","2024-11-11",0,0,0,0,0,0,0,0
"Mozambique","2024-11-12",0,0,0,0,0,0,0,0
"Mozambique","2024-11-13",0,0,0,0,0,0,0,0
"Mozambique","2024-11-14",0,0,0,0,0,0,0,0
"Mozambique","2024-11-15",0,0,0,0,0,0,0,0
"Mozambique","2024-11-16",0,0,0,0,0,0,0,0
"Mozambique","2024-11-17",0,0,0,0,0,0,0,0
"Mozambique","2024-11-18",0,0,0,0,0,0,0,0
"Mozambique","2024-11-19",0,0,0,0,0,0,0,0
"Mozambique","2024-11-20",0,0,0,0,0,0,0,0
"Mozambique","2024-11-21",0,0,0,0,0,0,0,0
"Mozambique","2024-11-22",0,0,0,0,0,0,0,0
"Mozambique","2024-11-23",0,0,0,0,0,0,0,0
"Mozambique","2024-11-24",0,0,0,0,0,0,0,0
"Mozambique","2024-11-25",0,0,0,0,0,0,0,0
"Mozambique","2024-11-26",0,0,0,0,0,0,0,0
"Mozambique","2024-11-27",0,0,0,0,0,0,0,0
"Mozambique","2024-11-28",0,0,0,0,0,0,0,0
"Mozambique","2024-11-29",0,0,0,0,0,0,0,0
"Mozambique","2024-11-30",0,0,0,0,0,0,0,0
"Mozambique","2024-12-01",0,0,0,0,0,0,0,0
"Mozambique","2024-12-02",0,0,0,0,0,0,0,0
"Mozambique","2024-12-03",0,0,0,0,0,0,0,0
"Mozambique","2024-12-04",0,0,0,0,0,0,0,0
"Mozambique","2024-12-05",0,0,0,0,0,0,0,0
"Mozambique","2024-12-06",0,0,0,0,0,0,0,0
"Mozambique","2024-12-07",0,0,0,0,0,0,0,0
"Mozambique","2024-12-08",0,0,0,0,0,0,0,0
"Mozambique","2024-12-09",0,0,0,0,0,0,0,0
"Mozambique","2024-12-10",0,0,0,0,0,0,0,0
"Mozambique","2024-12-11",0,0,0,0,0,0,0,0
"Mozambique","2024-12-12",0,0,0,0,0,0,0,0
"Mozambique","2024-12-13",0,0,0,0,0,0,0,0
"Mozambique","2024-12-14",0,0,0,0,0,0,0,0
"Mozambique","2024-12-15",0,0,0,0,0,0,0,0
"Mozambique","2024-12-16",0,0,0,0,0,0,0,0
"Mozambique","2024-12-17",0,0,0,0,0,0,0,0
"Mozambique","2024-12-18",0,0,0,0,0,0,0,0
"Mozambique","2024-12-19",0,0,0,0,0,0,0,0
"Mozambique","2024-12-20",0,0,0,0,0,0,0,0
"Mozambique","2024-12-21",0,0,0,0,0,0,0,0
"Mozambique","2024-12-22",0,0,0,0,0,0,0,0
"Mozambique","2024-12-23",0,0,0,0,0,0,0,0
"Mozambique","2024-12-24",0,0,0,0,0,0,0,0
"Mozambique","2024-12-25",0,0,0,0,0,0,0,0
"Mozambique","2024-12-26",0,0,0,0,0,0,0,0
"Mozambique","2024-12-27",0,0,0,0,0,0,0,0
"Mozambique","2024-12-28",0,0,0,0,0,0,0,0
"Mozambique","2024-12-29",0,0,0,0,0,0,0,0
"Mozambique","2024-12-30",0,0,0,0,0,0,0,0
"Mozambique","2024-12-31",0,0,0,0,0,0,0,0
"Mozambique","2025-01-01",0,0,0,0,0,0,0,0
"Mozambique","2025-01-02",0,0,0,0,0,0,0,0
"Mozambique","2025-01-03",0,0,0,0,0,0,0,0
"Mozambique","2025-01-04",0,0,0,0,0,0,0,0
"Mozambique","2025-01-05",0,0,0,0,0,0,0,0
"Mozambique","2025-01-06",0,0,0,0,0,0,0,0
"Mozambique","2025-01-07",0,0,0,0,0,0,0,0
"Mozambique","2025-01-08",0,0,0,0,0,0,0,0
"Mozambique","2025-01-09",0,0,0,0,0,0,0,0
"Mozambique","2025-01-10",0,0,0,0,0,0,0,0
"Mozambique","2025-01-11",0,0,0,0,0,0,0,0
"Mozambique","2025-01-12",0,0,0,0,0,0,0,0
"Mozambique","2025-01-13",0,0,0,0,0,0,0,0
"Mozambique","2025-01-14",0,0,0,0,0,0,0,0
"Mozambique","2025-01-15",0,0,0,0,0,0,0,0
"Mozambique","2025-01-16",0,0,0,0,0,0,0,0
"Mozambique","2025-01-17",0,0,0,0,0,0,0,0
"Mozambique","2025-01-18",0,0,0,0,0,0,0,0
"Mozambique","2025-01-19",0,0,0,0,0,0,0,0
"Mozambique","2025-01-20",0,0,0,0,0,0,0,0
"Mozambique","2025-01-21",0,0,0,0,0,0,0,0
"Mozambique","2025-01-22",0,0,0,0,0,0,0,0
"Mozambique","2025-01-23",0,0,0,0,0,0,0,0
"Mozambique","2025-01-24",0,0,0,0,0,0,0,0
"Mozambique","2025-01-25",0,0,0,0,0,0,0,0
"Mozambique","2025-01-26",0,0,0,0,0,0,0,0
"Mozambique","2025-01-27",0,0,0,0,0,0,0,0
"Mozambique","2025-01-28",0,0,0,0,0,0,0,0
"Mozambique","2025-01-29",0,0,0,0,0,0,0,0
"Mozambique","2025-01-30",0,0,0,0,0,0,0,0
"Mozambique","2025-01-31",0,0,0,0,0,0,0,0
"Mozambique","2025-02-01",0,0,0,0,0,0,0,0
"Mozambique","2025-02-02",0,0,0,0,0,0,0,0
"Mozambique","2025-02-03",0,0,0,0,0,0,0,0
"Mozambique","2025-02-04",0,0,0,0,0,0,0,0
"Mozambique","2025-02-05",0,0,0,0,0,0,0,0
"Mozambique","2025-02-06",0,0,0,0,0,0,0,0
"Mozambique","2025-02-07",0,0,0,0,0,0,0,0
"Mozambique","2025-02-08",0,0,0,0,0,0,0,0
"Mozambique","2025-02-09",0,0,0,0,0,0,0,0
"Mozambique","2025-02-10",0,0,0,0,0,0,0,0
"Mozambique","2025-02-11",0,0,0,0,0,0,0,0
"Mozambique","2025-02-12",0,0,0,0,0,0,0,0
"Mozambique","2025-02-13",0,0,0,0,0,0,0,0
"Mozambique","2025-02-14",0,0,0,0,0,0,0,0
"Mozambique","2025-02-15",0,0,0,0,0,0,0,0
"Mozambique","2025-02-16",0,0,0,0,0,0,0,0
"Mozambique","2025-02-17",0,0,0,0,0,0,0,0
"Mozambique","2025-02-18",0,0,0,0,0,0,0,0
"Mozambique","2025-02-19",0,0,0,0,0,0,0,0
"Mozambique","2025-02-20",0,0,0,0,0,0,0,0
"Mozambique","2025-02-21",0,0,0,0,0,0,0,0
"Mozambique","2025-02-22",0,0,0,0,0,0,0,0
"Mozambique","2025-02-23",0,0,0,0,0,0,0,0
"Mozambique","2025-02-24",0,0,0,0,0,0,0,0
"Mozambique","2025-02-25",0,0,0,0,0,0,0,0
"Mozambique","2025-02-26",0,0,0,0,0,0,0,0
"Mozambique","2025-02-27",0,0,0,0,0,0,0,0
"Mozambique","2025-02-28",0,0,0,0,0,0,0,0
"Mozambique","2025-03-01",0,0,0,0,0,0,0,0
"Mozambique","2025-03-02",0,0,0,0,0,0,0,0
"Mozambique","2025-03-03",0,0,0,0,0,0,0,0
"Nepal","2024-01-01",0,0,0,0,0,0,0,0
"Nepal","2024-01-02",0,0,0,0,0,0,0,0
"Nepal","2024-01-03",0,0,0,0,0,0,0,0
"Nepal","2024-01-04",0,0,0,0,0,0,0,0
"Nepal","2024-01-05",0,0,0,0,0,0,0,0
"Nepal","2024-01-06",0,0,0,0,0,0,0,0
"Nepal","2024-01-07",0,0,0,0,0,0,0,0
"Nepal","2024-01-08",0,0,0,0,0,0,0,0
"Nepal","2024-01-09",0,0,0,0,0,0,0,0
"Nepal","2024-01-10",0,0,0,0,0,0,0,0
"Nepal","2024-01-11",0,0,0,0,0,0,0,0
"Nepal","2024-01-12",0,0,0,0,0,0,0,0
"Nepal","2024-01-13",0,0,0,0,0,0,0,0
"Nepal","2024-01-14",0,0,0,0,0,0,0,0
"Nepal","2024-01-15",0,0,0,0,0,0,0,0
"Nepal","2024-01-16",0,0,0,0,0,0,0,0
"Nepal","2024-01-17",0,0,0,0,0,0,0,0
"Nepal","2024-01-18",0,0,0,0,0,0,0,0
"Nepal","2024-01-19",0,0,0,0,0,0,0,0
"Nepal","2024-01-20",0,0,0,0,0,0,0,0
"Nepal","2024-01-21",0,0,0,0,0,0,0,0
"Nepal","2024-01-22",0,0,0,0,0,0,0,0
"Nepal","2024-01-23",0,0,0,0,0,0,0,0
"Nepal","2024-01-24",0,0,0,0,0,0,0,0
"Nepal","2024-01-25",0,0,0,0,0,0,0,0
"Nepal","2024-01-26",0,0,0,0,0,0,0,0
"Nepal","2024-01-27",0,0,0,0,0,0,0,0
"Nepal","2024-01-28",0,0,0,0,0,0,0,0
"Nepal","2024-01-29",0,0,0,0,0,0,0,0
"Nepal","2024-01-30",0,0,0,0,0,0,0,0
"Nepal","2024-01-31",0,0,0,0,0,0,0,0
"Nepal","2024-02-01",0,0,0,0,0,0,0,0
"Nepal","2024-02-02",0,0,0,0,0,0,0,0
"Nepal","2024-02-03",0,0,0,0,0,0,0,0
"Nepal","2024-02-04",0,0,0,0,0,0,0,0
"Nepal","2024-02-05",0,0,0,0,0,0,0,0
"Nepal","2024-02-06",0,0,0,0,0,0,0,0
"Nepal","2024-02-07",0,0,0,0,0,0,0,0
"Nepal","2024-02-08",0,0,0,0,0,0,0,0
"Nepal","2024-02-09",0,0,0,0,0,0,0,0
"Nepal","2024-02-10",0,0,0,0,0,0,0,0
"Nepal","2024-02-11",0,0,0,0,0,0,0,0
"Nepal","2024-02-12",0,0,0,0,0,0,0,0
"Nepal","2024-02-13",0,0,0,0,0,0,0,0
"Nepal","2024-02-14",0,0,0,0,0,0,0,0
"Nepal","2024-02-15",0,0,0,0,0,0,0,0
"Nepal","2024-02-16",0,0,0,0,0,0,0,0
"Nepal","2024-02-17",0,0,0,0,0,0,0,0
"Nepal","2024-02-18",0,0,0,0,0,0,0,0
"Nepal","2024-02-19",0,0,0,0,0,0,0,0
"Nepal","2024-02-20",0,0,0,0,0,0,0,0
"Nepal","2024-02-21",0,0,0,0,0,0,0,0
"Nepal","2024-02-22",0,0,0,0,0,0,0,0
"Nepal","2024-02-23",0,0,0,0,0,0,0,0
"Nepal","2024-02-24",0,0,0,0,0,0,0,0
"Nepal","2024-02-25",0,0,0,0,0,0,0,0
"Nepal","2024-02-26",0,0,0,0,0,0,0,0
"Nepal","2024-02-27",0,0,0,0,0,0,0,0
"Nepal","2024-02-28",0,0,0,0,0,0,0,0
"Nepal","2024-02-29",0,0,0,0,0,0,0,0
"Nepal","2024-03-01",0,0,0,0,0,0,0,0
"Nepal","2024-03-02",0,0,0,0,0,0,0,0
"Nepal","2024-03-03",0,0,0,0,0,0,0,0
"Nepal","2024-03-04",0,0,0,0,0,0,0,0
"Nepal","2024-03-05",0,0,0,0,0,0,0,0
"Nepal","2024-03-06",0,0,0,0,0,0,0,0
"Nepal","2024-03-07",0,0,0,0,0,0,0,0
"Nepal","2024-03-08",0,0,0,0,0,0,0,0
"Nepal","2024-03-09",0,0,0,0,0,0,0,0
"Nepal","2024-03-10",0,0,0,0,0,0,0,0
"Nepal","2024-03-11",0,0,0,0,0,0,0,0
"Nepal","2024-03-12",0,0,0,0,0,0,0,0
"Nepal","2024-03-13",0,0,0,0,0,0,0,0
"Nepal","2024-03-14",0,0,0,0,0,0,0,0
"Nepal","2024-03-15",0,0,0,0,0,0,0,0
"Nepal","2024-03-16",0,0,0,0,0,0,0,0
"Nepal","2024-03-17",0,0,0,0,0,0,0,0
"Nepal","2024-03-18",0,0,0,0,0,0,0,0
"Nepal","2024-03-19",0,0,0,0,0,0,0,0
"Nepal","2024-03-20",0,0,0,0,0,0,0,0
"Nepal","2024-03-21",0,0,0,0,0,0,0,0
"Nepal","2024-03-22",0,0,0,0,0,0,0,0
"Nepal","2024-03-23",0,0,0,0,0,0,0,0
"Nepal","2024-03-24",0,0,0,0,0,0,0,0
"Nepal","2024-03-25",0,0,0,0,0,0,0,0
"Nepal","2024-03-26",0,0,0,0,0,0,0,0
"Nepal","2024-03-27",0,0,0,0,0,0,0,0
"Nepal","2024-03-28",0,0,0,0,0,0,0,0
"Nepal","2024-03-29",0,0,0,0,0,0,0,0
"Nepal","2024-03-30",0,0,0,0,0,0,0,0
"Nepal","2024-03-31",0,0,0,0,0,0,0,0
"Nepal","2024-04-01",0,0,0,0,0,0,0,0
"Nepal","2024-04-02",0,0,0,0,0,0,0,0
"Nepal","2024-04-03",0,0,0,0,0,0,0,0
"Nepal","2024-04-04",0,0,0,0,0,0,0,0
"Nepal","2024-04-05",0,0,0,0,0,0,0,0
"Nepal","2024-04-06",0,0,0,0,0,0,0,0
"Nepal","2024-04-07",0,0,0,0,0,0,0,0
"Nepal","2024-04-08",0,0,0,0,0,0,0,0
"Nepal","2024-04-09",0,0,0,0,0,0,0,0
"Nepal","2024-04-10",0,0,0,0,0,0,0,0
"Nepal","2024-04-11",0,0,0,0,0,0,0,0
"Nepal","2024-04-12",0,0,0,0,0,0,0,0
"Nepal","2024-04-13",0,0,0,0,0,0,0,0
"Nepal","2024-04-14",0,0,0,0,0,0,0,0
"Nepal","2024-04-15",0,0,0,0,0,0,0,0
"Nepal","2024-04-16",0,0,0,0,0,0,0,0
"Nepal","2024-04-17",0,0,0,0,0,0,0,0
"Nepal","2024-04-18",0,0,0,0,0,0,0,0
"Nepal","2024-04-19",0,0,0,0,0,0,0,0
"Nepal","2024-04-20",0,0,0,0,0,0,0,0
"Nepal","2024-04-21",0,0,0,0,0,0,0,0
"Nepal","2024-04-22",0,0,0,0,0,0,0,0
"Nepal","2024-04-23",0,0,0,0,0,0,0,0
"Nepal","2024-04-24",0,0,0,0,0,0,0,0
"Nepal","2024-04-25",0,0,0,0,0,0,0,0
"Nepal","2024-04-26",0,0,0,0,0,0,0,0
"Nepal","2024-04-27",0,0,0,0,0,0,0,0
"Nepal","2024-04-28",0,0,0,0,0,0,0,0
"Nepal","2024-04-29",0,0,0,0,0,0,0,0
"Nepal","2024-04-30",0,0,0,0,0,0,0,0
"Nepal","2024-05-01",0,0,0,0,0,0,0,0
"Nepal","2024-05-02",0,0,0,0,0,0,0,0
"Nepal","2024-05-03",0,0,0,0,0,0,0,0
"Nepal","2024-05-04",0,0,0,0,0,0,0,0
"Nepal","2024-05-05",0,0,0,0,0,0,0,0
"Nepal","2024-05-06",0,0,0,0,0,0,0,0
"Nepal","2024-05-07",0,0,0,0,0,0,0,0
"Nepal","2024-05-08",0,0,0,0,0,0,0,0
"Nepal","2024-05-09",0,0,0,0,0,0,0,0
"Nepal","2024-05-10",0,0,0,0,0,0,0,0
"Nepal","2024-05-11",0,0,0,0,0,0,0,0
"Nepal","2024-05-12",0,0,0,0,0,0,0,0
"Nepal","2024-05-13",0,0,0,0,0,0,0,0
"Nepal","2024-05-14",0,0,0,0,0,0,0,0
"Nepal","2024-05-15",0,0,0,0,0,0,0,0
"Nepal","2024-05-16",0,0,0,0,0,0,0,0
"Nepal","2024-05-17",0,0,0,0,0,0,0,0
"Nepal","2024-05-18",0,0,0,0,0,0,0,0
"Nepal","2024-05-19",0,0,0,0,0,0,0,0
"Nepal","2024-05-20",0,0,0,0,0,0,0,0
"Nepal","2024-05-21",0,0,0,0,0,0,0,0
"Nepal","2024-05-22",0,0,0,0,0,0,0,0
"Nepal","2024-05-23",0,0,0,0,0,0,0,0
"Nepal","2024-05-24",0,0,0,0,0,0,0,0
"Nepal","2024-05-25",0,0,0,0,0,0,0,0
"Nepal","2024-05-26",0,0,0,0,0,0,0,0
"Nepal","2024-05-27",0,0,0,0,0,0,0,0
"Nepal","2024-05-28",0,0,0,0,0,0,0,0
"Nepal","2024-05-29",0,0,0,0,0,0,0,0
"Nepal","2024-05-30",0,0,0,0,0,0,0,0
"Nepal","2024-05-31",0,0,0,0,0,0,0,0
"Nepal","2024-06-01",0,0,0,0,0,0,0,0
"Nepal","2024-06-02",0,0,0,0,0,0,0,0
"Nepal","2024-06-03",0,0,0,0,0,0,0,0
"Nepal","2024-06-04",0,0,0,0,0,0,0,0
"Nepal","2024-06-05",0,0,0,0,0,0,0,0
"Nepal","2024-06-06",0,0,0,0,0,0,0,0
"Nepal","2024-06-07",0,0,0,0,0,0,0,0
"Nepal","2024-06-08",0,0,0,0,0,0,0,0
"Nepal","2024-06-09",0,0,0,0,0,0,0,0
"Nepal","2024-06-10",0,0,0,0,0,0,0,0
"Nepal","2024-06-11",0,0,0,0,0,0,0,0
"Nepal","2024-06-12",0,0,0,0,0,0,0,0
"Nepal","2024-06-13",0,0,0,0,0,0,0,0
"Nepal","2024-06-14",0,0,0,0,0,0,0,0
"Nepal","2024-06-15",0,0,0,0,0,0,0,0
"Nepal","2024-06-16",0,0,0,0,0,0,0,0
"Nepal","2024-06-17",0,0,0,0,0,0,0,0
"Nepal","2024-06-18",0,0,0,0,0,0,0,0
"Nepal","2024-06-19",0,0,0,0,0,0,0,0
"Nepal","2024-06-20",0,0,0,0,0,0,0,0
"Nepal","2024-06-21",0,0,0,0,0,0,0,0
"Nepal","2024-06-22",0,0,0,0,0,0,0,0
"Nepal","2024-06-23",0,0,0,0,0,0,0,0
"Nepal","2024-06-24",0,0,0,0,0,0,0,0
"Nepal","2024-06-25",0,0,0,0,0,0,0,0
"Nepal","2024-06-26",0,0,0,0,0,0,0,0
"Nepal","2024-06-27",0,0,0,0,0,0,0,0
"Nepal","2024-06-28",0,0,0,0,0,0,0,0
"Nepal","2024-06-29",0,0,0,0,0,0,0,0
"Nepal","2024-06-30",0,0,0,0,0,0,0,0
"Nepal","2024-07-01",0,0,0,0,0,0,0,0
"Nepal","2024-07-02",0,0,0,0,0,0,0,0
"Nepal","2024-07-03",0,0,0,0,0,0,0,0
"Nepal","2024-07-04",0,0,0,0,0,0,0,0
"Nepal","2024-07-05",0,0,0,0,0,0,0,0
"Nepal","2024-07-06",0,0,0,0,0,0,0,0
"Nepal","2024-07-07",0,0,0,0,0,0,0,0
"Nepal","2024-07-08",0,0,0,0,0,0,0,0
"Nepal","2024-07-09",0,0,0,0,0,0,0,0
"Nepal","2024-07-10",0,0,0,0,0,0,0,0
"Nepal","2024-07-11",0,0,0,0,0,0,0,0
"Nepal","2024-07-12",0,0,0,0,0,0,0,0
"Nepal","2024-07-13",0,0,0,0,0,0,0,0
"Nepal","2024-07-14",0,0,0,0,0,0,0,0
"Nepal","2024-07-15",0,0,0,0,0,0,0,0
"Nepal","2024-07-16",0,0,0,0,0,0,0,0
"Nepal","2024-07-17",0,0,0,0,0,0,0,0
"Nepal","2024-07-18",0,0,0,0,0,0,0,0
"Nepal","2024-07-19",0,0,0,0,0,0,0,0
"Nepal","2024-07-20",0,0,0,0,0,0,0,0
"Nepal","2024-07-21",0,0,0,0,0,0,0,0
"Nepal","2024-07-22",0,0,0,0,0,0,0,0
"Nepal","2024-07-23",0,0,0,0,0,0,0,0
"Nepal","2024-07-24",0,0,0,0,0,0,0,0
"Nepal","2024-07-25",0,0,0,0,0,0,0,0
"Nepal","2024-07-26",0,0,0,0,0,0,0,0
"Nepal","2024-07-27",0,0,0,0,0,0,0,0
"Nepal","2024-07-28",0,0,0,0,0,0,0,0
"Nepal","2024-07-29",0,0,0,0,0,0,0,0
"Nepal","2024-07-30",0,0,0,0,0,0,0,0
"Nepal","2024-07-31",0,0,0,0,0,0,0,0
"Nepal","2024-08-01",0,0,0,0,0,0,0,0
"Nepal","2024-08-02",0,0,0,0,0,0,0,0
"Nepal","2024-08-03",0,0,0,0,0,0,0,0
"Nepal","2024-08-04",0,0,0,0,0,0,0,0
"Nepal","2024-08-05",0,0,0,0,0,0,0,0
"Nepal","2024-08-06",0,0,0,0,0,0,0,0
"Nepal","2024-08-07",0,0,0,0,0,0,0,0
"Nepal","2024-08-08",0,0,0,0,0,0,0,0
"Nepal","2024-08-09",0,0,0,0,0,0,0,0
"Nepal","2024-08-10",0,0,0,0,0,0,0,0
"Nepal","2024-08-11",0,0,0,0,0,0,0,0
"Nepal","2024-08-12",0,0,0,0,0,0,0,0
"Nepal","2024-08-13",0,0,0,0,0,0,0,0
"Nepal","2024-08-14",0,0,0,0,0,0,0,0
"Nepal","2024-08-15",0,0,0,0,0,0,0,0
"Nepal","2024-08-16",0,0,0,0,0,0,0,0
"Nepal","2024-08-17",0,0,0,0,0,0,0,0
"Nepal","2024-08-18",0,0,0,0,0,0,0,0
"Nepal","2024-08-19",0,0,0,0,0,0,0,0
"Nepal","2024-08-20",0,0,0,0,0,0,0,0
"Nepal","2024-08-21",0,0,0,0,0,0,0,0
"Nepal","2024-08-22",0,0,0,0,0,0,0,0
"Nepal","2024-08-23",0,0,0,0,0,0,0,0
"Nepal","2024-08-24",0,0,0,0,0,0,0,0
"Nepal","2024-08-25",0,0,0,0,0,0,0,0
"Nepal","2024-08-26",0,0,0,0,0,0,0,0
"Nepal","2024-08-27",0,0,0,0,0,0,0,0
"Nepal","2024-08-28",0,0,0,0,0,0,0,0
"Nepal","2024-08-29",0,0,0,0,0,0,0,0
"Nepal","2024-08-30",0,0,0,0,0,0,0,0
"Nepal","2024-08-31",0,0,0,0,0,0,0,0
"Nepal","2024-09-01",0,0,0,0,0,0,0,0
"Nepal","2024-09-02",0,0,0,0,0,0,0,0
"Nepal","2024-09-03",0,0,0,0,0,0,0,0
"Nepal","2024-09-04",0,0,0,0,0,0,0,0
"Nepal","2024-09-05",0,0,0,0,0,0,0,0
"Nepal","2024-09-06",0,0,0,0,0,0,0,0
"Nepal","2024-09-07",0,0,0,0,0,0,0,0
"Nepal","2024-09-08",0,0,0,0,0,0,0,0
"Nepal","2024-09-09",0,0,0,0,0,0,0,0
"Nepal","2024-09-10",0,0,0,0,0,0,0,0
"Nepal","2024-09-11",0,0,0,0,0,0,0,0
"Nepal","2024-09-12",0,0,0,0,0,0,0,0
"Nepal","2024-09-13",0,0,0,0,0,0,0,0
"Nepal","2024-09-14",0,0,0,0,0,0,0,0
"Nepal","2024-09-15",0,0,0,0,0,0,0,0
"Nepal","2024-09-16",0,0,0,0,0,0,0,0
"Nepal","2024-09-17",0,0,0,0,0,0,0,0
"Nepal","2024-09-18",0,0,0,0,0,0,0,0
"Nepal","2024-09-19",0,0,0,0,0,0,0,0
"Nepal","2024-09-20",0,0,0,0,0,0,0,0
"Nepal","2024-09-21",0,0,0,0,0,0,0,0
"Nepal","2024-09-22",0,0,0,0,0,0,0,0
"Nepal","2024-09-23",0,0,0,0,0,0,0,0
"Nepal","2024-09-24",0,0,0,0,0,0,0,0
"Nepal","2024-09-25",0,0,0,0,0,0,0,0
"Nepal","2024-09-26",0,0,0,0,0,0,0,0
"Nepal","2024-09-27",0,0,0,0,0,0,0,0
"Nepal","2024-09-28",0,0,0,0,0,0,0,0
"Nepal","2024-09-29",0,0,0,0,0,0,0,0
"Nepal","2024-09-30",0,0,0,0,0,0,0,0
"Nepal","2024-10-01",0,0,0,0,0,0,0,0
"Nepal","2024-10-02",0,0,0,0,0,0,0,0
"Nepal","2024-10-03",0,0,0,0,0,0,0,0
"Nepal","2024-10-04",0,0,0,0,0,0,0,0
"Nepal","2024-10-05",0,0,0,0,0,0,0,0
"Nepal","2024-10-06",0,0,0,0,0,0,0,0
"Nepal","2024-10-07",0,0,0,0,0,0,0,0
"Nepal","2024-10-08",0,0,0,0,0,0,0,0
"Nepal","2024-10-09",0,0,0,0,0,0,0,0
"Nepal","2024-10-10",0,0,0,0,0,0,0,0
"Nepal","2024-10-11",0,0,0,0,0,0,0,0
"Nepal","2024-10-12",0,0,0,0,0,0,0,0
"Nepal","2024-10-13",0,0,0,0,0,0,0,0
"Nepal","2024-10-14",0,0,0,0,0,0,0,0
"Nepal","2024-10-15",0,0,0,0,0,0,0,0
"Nepal","2024-10-16",0,0,0,0,0,0,0,0
"Nepal","2024-10-17",0,0,0,0,0,0,0,0
"Nepal","2024-10-18",0,0,0,0,0,0,0,0
"Nepal","2024-10-19",0,0,0,0,0,0,0,0
"Nepal","2024-10-20",0,0,0,0,0,0,0,0
"Nepal","2024-10-21",0,0,0,0,0,0,0,0
"Nepal","2024-10-22",0,0,0,0,0,0,0,0
"Nepal","2024-10-23",0,0,0,0,0,0,0,0
"Nepal","2024-10-24",0,0,0,0,0,0,0,0
"Nepal","2024-10-25",0,0,0,0,0,0,0,0
"Nepal","2024-10-26",0,0,0,0,0,0,0,0
"Nepal","2024-10-27",0,0,0,0,0,0,0,0
"Nepal","2024-10-28",0,0,0,0,0,0,0,0
"Nepal","2024-10-29",0,0,0,0,0,0,0,0
"Nepal","2024-10-30",0,0,0,0,0,0,0,0
"Nepal","2024-10-31",0,0,0,0,0,0,0,0
"Nepal","2024-11-01",0,0,0,0,0,0,0,0
"Nepal","2024-11-02",0,0,0,0,0,0,0,0
"Nepal","2024-11-03",0,0,0,0,0,0,0,0
"Nepal","2024-11-04",0,0,0,0,0,0,0,0
"Nepal","2024-11-05",0,0,0,0,0,0,0,0
"Nepal","2024-11-06",0,0,0,0,0,0,0,0
"Nepal","2024-11-07",0,0,0,0,0,0,0,0
"Nepal","2024-11-08",0,0,0,0,0,0,0,0
"Nepal","2024-11-09",0,0,0,0,0,0,0,0
"Nepal","2024-11-10",0,0,0,0,0,0,0,0
"Nepal","2024-11-11",0,0,0,0,0,0,0,0
"Nepal","2024-11-12",0,0,0,0,0,0,0,0
"Nepal","2024-11-13",0,0,0,0,0,0,0,0
"Nepal","2024-11-14",0,0,0,0,0,0,0,0
"Nepal","2024-11-15",0,0,0,0,0,0,0,0
"Nepal","2024-11-16",0,0,0,0,0,0,0,0
"Nepal","2024-11-17",0,0,0,0,0,0,0,0
"Nepal","2024-11-18",0,0,0,0,0,0,0,0
"Nepal","2024-11-19",0,0,0,0,0,0,0,0
"Nepal","2024-11-20",0,0,0,0,0,0,0,0
"Nepal","2024-11-21",0,0,0,0,0,0,0,0
"Nepal","2024-11-22",0,0,0,0,0,0,0,0
"Nepal","2024-11-23",0,0,0,0,0,0,0,0
"Nepal","2024-11-24",0,0,0,0,0,0,0,0
"Nepal","2024-11-25",0,0,0,0,0,0,0,0
"Nepal","2024-11-26",0,0,0,0,0,0,0,0
"Nepal","2024-11-27",0,0,0,0,0,0,0,0
"Nepal","2024-11-28",0,0,0,0,0,0,0,0
"Nepal","2024-11-29",0,0,0,0,0,0,0,0
"Nepal","2024-11-30",0,0,0,0,0,0,0,0
"Nepal","2024-12-01",0,0,0,0,0,0,0,0
"Nepal","2024-12-02",0,0,0,0,0,0,0,0
"Nepal","2024-12-03",0,0,0,0,0,0,0,0
"Nepal","2024-12-04",0,0,0,0,0,0,0,0
"Nepal","2024-12-05",0,0,0,0,0,0,0,0
"Nepal","2024-12-06",0,0,0,0,0,0,0,0
"Nepal","2024-12-07",0,0,0,0,0,0,0,0
"Nepal","2024-12-08",0,0,0,0,0,0,0,0
"Nepal","2024-12-09",0,0,0,0,0,0,0,0
"Nepal","2024-12-10",0,0,0,0,0,0,0,0
"Nepal","2024-12-11",0,0,0,0,0,0,0,0
"Nepal","2024-12-12",0,0,0,0,0,0,0,0
"Nepal","2024-12-13",0,0,0,0,0,0,0,0
"Nepal","2024-12-14",0,0,0,0,0,0,0,0
"Nepal","2024-12-15",0,0,0,0,0,0,0,0
"Nepal","2024-12-16",0,0,0,0,0,0,0,0
"Nepal","2024-12-17",0,0,0,0,0,0,0,0
"Nepal","2024-12-18",0,0,0,0,0,0,0,0
"Nepal","2024-12-19",0,0,0,0,0,0,0,0
"Nepal","2024-12-20",0,0,0,0,0,0,0,0
"Nepal","2024-12-21",0,0,0,0,0,0,0,0
"Nepal","2024-12-22",0,0,0,0,0,0,0,0
"Nepal","2024-12-23",0,0,0,0,0,0,0,0
"Nepal","2024-12-24",0,0,0,0,0,0,0,0
"Nepal","2024-12-25",0,0,0,0,0,0,0,0
"Nepal","2024-12-26",0,0,0,0,0,0,0,0
"Nepal","2024-12-27",0,0,0,0,0,0,0,0
"Nepal","2024-12-28",0,0,0,0,0,0,0,0
"Nepal","2024-12-29",0,0,0,0,0,0,0,0
"Nepal","2024-12-30",0,0,0,0,0,0,0,0
"Nepal","2024-12-31",0,2,2,0,2,2,0,0
"Nepal","2025-01-01",0,0,2,0,0,2,0,0
"Nepal","2025-01-02",0,0,2,0,0,2,0,0
"Nepal","2025-01-03",0,0,2,0,0,2,0,0
"Nepal","2025-01-04",0,0,2,0,0,2,0,0
"Nepal","2025-01-05",0,0,2,0,0,2,0,0
"Nepal","2025-01-06",0,0,2,0,0,2,0,0
"Nepal","2025-01-07",0,0,2,0,0,2,0,0
"Nepal","2025-01-08",0,0,2,0,0,2,0,0
"Nepal","2025-01-09",0,0,2,0,0,2,0,0
"Nepal","2025-01-10",0,0,2,0,0,2,0,0
"Nepal","2025-01-11",0,0,2,0,0,2,0,0
"Nepal","2025-01-12",0,0,2,0,0,2,0,0
"Nepal","2025-01-13",0,0,2,0,0,2,0,0
"Nepal","2025-01-14",0,0,2,0,0,2,0,0
"Nepal","2025-01-15",0,0,2,0,0,2,0,0
"Nepal","2025-01-16",0,0,2,0,0,2,0,0
"Nepal","2025-01-17",0,0,2,0,0,2,0,0
"Nepal","2025-01-18",0,0,2,0,0,2,0,0
"Nepal","2025-01-19",0,0,2,0,0,2,0,0
"Nepal","2025-01-20",0,0,2,0,0,2,0,0
"Nepal","2025-01-21",0,0,2,0,0,2,0,0
"Nepal","2025-01-22",0,0,2,0,0,2,0,0
"Nepal","2025-01-23",0,0,2,0,0,2,0,0
"Nepal","2025-01-24",0,0,2,0,0,2,0,0
"Nepal","2025-01-25",0,0,2,0,0,2,0,0
"Nepal","2025-01-26",0,0,2,0,0,2,0,0
"Nepal","2025-01-27",0,0,2,0,0,2,0,0
"Nepal","2025-01-28",0,0,2,0,0,2,0,0
"Nepal","2025-01-29",0,0,2,0,0,2,0,0
"Nepal","2025-01-30",0,0,2,0,0,2,0,0
"Nepal","2025-01-31",0,0,2,0,0,2,0,0
"Nepal","2025-02-01",0,0,2,0,0,2,0,0
"Nepal","2025-02-02",0,0,2,0,0,2,0,0
"Nepal","2025-02-03",0,0,2,0,0,2,0,0
"Nepal","2025-02-04",0,0,2,0,0,2,0,0
"Nepal","2025-02-05",0,0,2,0,0,2,0,0
"Nepal","2025-02-06",0,0,2,0,0,2,0,0
"Nepal","2025-02-07",0,0,2,0,0,2,0,0
"Nepal","2025-02-08",0,0,2,0,0,2,0,0
"Nepal","2025-02-09",0,0,2,0,0,2,0,0
"Nepal","2025-02-10",0,0,2,0,0,2,0,0
"Nepal","2025-02-11",0,0,2,0,0,2,0,0
"Nepal","2025-02-12",0,0,2,0,0,2,0,0
"Nepal","2025-02-13",0,0,2,0,0,2,0,0
"Nepal","2025-02-14",0,0,2,0,0,2,0,0
"Nepal","2025-02-15",0,0,2,0,0,2,0,0
"Nepal","2025-02-16",0,0,2,0,0,2,0,0
"Nepal","2025-02-17",0,0,2,0,0,2,0,0
"Nepal","2025-02-18",0,0,2,0,0,2,0,0
"Nepal","2025-02-19",0,0,2,0,0,2,0,0
"Nepal","2025-02-20",0,0,2,0,0,2,0,0
"Nepal","2025-02-21",0,0,2,0,0,2,0,0
"Nepal","2025-02-22",0,0,2,0,0,2,0,0
"Nepal","2025-02-23",0,0,2,0,0,2,0,0
"Nepal","2025-02-24",0,0,2,0,0,2,0,0
"Nepal","2025-02-25",0,0,2,0,0,2,0,0
"Nepal","2025-02-26",0,0,2,0,0,2,0,0
"Nepal","2025-02-27",0,0,2,0,0,2,0,0
"Nepal","2025-02-28",0,0,2,0,0,2,0,0
"Nepal","2025-03-01",0,0,2,0,0,2,0,0
"Nepal","2025-03-02",0,0,2,0,0,2,0,0
"Nepal","2025-03-03",0,0,2,0,0,2,0,0
"Netherlands (Kingdom of the)","2024-01-01",0,0,0,0,0,0,0,0
"Netherlands (Kingdom of the)","2024-01-02",0,0,0,0,0,0,0,0
"Netherlands (Kingdom of the)","2024-01-03",0,0,0,0,0,0,0,0
"Netherlands (Kingdom of the)","2024-01-04",0,0,0,0,0,0,0,0
"Netherlands (Kingdom of the)","2024-01-05",0,0,0,0,0,0,0,0
"Netherlands (Kingdom of the)","2024-01-06",0,0,0,0,0,0,0,0
"Netherlands (Kingdom of the)","2024-01-07",0,0,0,0,0,0,0,0
"Netherlands (Kingdom of the)","2024-01-08",0,0,0,0,0,0,0,0
"Netherlands (Kingdom of the)","2024-01-09",0,0,0,0,0,0,0,0
"Netherlands (Kingdom of the)","2024-01-10",0,0,0,0,0,0,0,0
"Netherlands (Kingdom of the)","2024-01-11",0,0,0,0,0,0,0,0
"Netherlands (Kingdom of the)","2024-01-12",0,0,0,0,0,0,0,0
"Netherlands (Kingdom of the)","2024-01-13",0,0,0,0,0,0,0,0
"Netherlands (Kingdom of the)","2024-01-14",0,0,0,0,0,0,0,0
"Netherlands (Kingdom of the)","2024-01-15",0,0,0,0,0,0,0,0
"Netherlands (Kingdom of the)","2024-01-16",0,0,0,0,0,0,0,0
"Netherlands (Kingdom of the)","2024-01-17",0,0,0,0,0,0,0,0
"Netherlands (Kingdom of the)","2024-01-18",0,0,0,0,0,0,0,0
"Netherlands (Kingdom of the)","2024-01-19",0,0,0,0,0,0,0,0
"Netherlands (Kingdom of the)","2024-01-20",0,0,0,0,0,0,0,0
"Netherlands (Kingdom of the)","2024-01-21",0,0,0,0,0,0,0,0
"Netherlands (Kingdom of the)","2024-01-22",0,0,0,0,0,0,0,0
"Netherlands (Kingdom of the)","2024-01-23",0,0,0,0,0,0,0,0
"Netherlands (Kingdom of the)","2024-01-24",0,0,0,0,0,0,0,0
"Netherlands (Kingdom of the)","2024-01-25",0,0,0,0,0,0,0,0
"Netherlands (Kingdom of the)","2024-01-26",0,0,0,0,0,0,0,0
"Netherlands (Kingdom of the)","2024-01-27",0,0,0,0,0,0,0,0
"Netherlands (Kingdom of the)","2024-01-28",0,0,0,0,0,0,0,0
"Netherlands (Kingdom of the)","2024-01-29",0,0,0,0,0,0,0,0
"Netherlands (Kingdom of the)","2024-01-30",0,0,0,0,0,0,0,0
"Netherlands (Kingdom of the)","2024-01-31",0,5,5,0,5,5,0,0
"Netherlands (Kingdom of the)","2024-02-01",0,0,5,0,0,5,0,0
"Netherlands (Kingdom of the)","2024-02-02",0,0,5,0,0,5,0,0
"Netherlands (Kingdom of the)","2024-02-03",0,0,5,0,1,6,0,0
"Netherlands (Kingdom of the)","2024-02-04",0,0,5,0,0,6,0,0
"Netherlands (Kingdom of the)","2024-02-05",0,0,5,0,0,6,0,0
"Netherlands (Kingdom of the)","2024-02-06",0,0,5,0,0,6,0,0
"Netherlands (Kingdom of the)","2024-02-07",0,0,5,0,1,7,0,0
"Netherlands (Kingdom of the)","2024-02-08",0,0,5,0,0,7,0,0
"Netherlands (Kingdom of the)","2024-02-09",0,0,5,0,0,7,0,0
"Netherlands (Kingdom of the)","2024-02-10",0,0,5,0,0,7,0,0
"Netherlands (Kingdom of the)","2024-02-11",0,0,5,0,1,8,0,0
"Netherlands (Kingdom of the)","2024-02-12",0,0,5,0,0,8,0,0
"Netherlands (Kingdom of the)","2024-02-13",0,0,5,0,0,8,0,0
"Netherlands (Kingdom of the)","2024-02-14",0,0,5,0,0,8,0,0
"Netherlands (Kingdom of the)","2024-02-15",0,0,5,0,1,9,0,0
"Netherlands (Kingdom of the)","2024-02-16",0,0,5,0,0,9,0,0
"Netherlands (Kingdom of the)","2024-02-17",0,0,5,0,0,9,0,0
"Netherlands (Kingdom of the)","2024-02-18",0,0,5,0,0,9,0,0
"Netherlands (Kingdom of the)","2024-02-19",0,0,5,0,1,10,0,0
"Netherlands (Kingdom of the)","2024-02-20",0,0,5,0,0,10,0,0
"Netherlands (Kingdom of the)","2024-02-21",0,0,5,0,0,10,0,0
"Netherlands (Kingdom of the)","2024-02-22",0,0,5,0,0,10,0,0
"Netherlands (Kingdom of the)","2024-02-23",0,0,5,0,1,11,0,0
"Netherlands (Kingdom of the)","2024-02-24",0,0,5,0,0,11,0,0
"Netherlands (Kingdom of the)","2024-02-25",0,0,5,0,0,11,0,0
"Netherlands (Kingdom of the)","2024-02-26",0,0,5,0,0,11,0,0
"Netherlands (Kingdom of the)","2024-02-27",0,0,5,0,1,12,0,0
"Netherlands (Kingdom of the)","2024-02-28",0,0,5,0,0,12,0,0
"Netherlands (Kingdom of the)","2024-02-29",0,7,12,0,0,12,0,0
"Netherlands (Kingdom of the)","2024-03-01",0,0,12,0,0,12,0,0
"Netherlands (Kingdom of the)","2024-03-02",0,0,12,0,0,12,0,0
"Netherlands (Kingdom of the)","2024-03-03",0,0,12,0,0,12,0,0
"Netherlands (Kingdom of the)","2024-03-04",0,0,12,0,0,12,0,0
"Netherlands (Kingdom of the)","2024-03-05",0,0,12,0,0,12,0,0
"Netherlands (Kingdom of the)","2024-03-06",0,0,12,0,0,12,0,0
"Netherlands (Kingdom of the)","2024-03-07",0,0,12,0,0,12,0,0
"Netherlands (Kingdom of the)","2024-03-08",0,0,12,0,0,12,0,0
"Netherlands (Kingdom of the)","2024-03-09",0,0,12,0,0,12,0,0
"Netherlands (Kingdom of the)","2024-03-10",0,0,12,0,0,12,0,0
"Netherlands (Kingdom of the)","2024-03-11",0,0,12,0,0,12,0,0
"Netherlands (Kingdom of the)","2024-03-12",0,0,12,0,0,12,0,0
"Netherlands (Kingdom of the)","2024-03-13",0,0,12,0,0,12,0,0
"Netherlands (Kingdom of the)","2024-03-14",0,0,12,0,0,12,0,0
"Netherlands (Kingdom of the)","2024-03-15",0,0,12,0,0,12,0,0
"Netherlands (Kingdom of the)","2024-03-16",0,0,12,0,1,13,0,0
"Netherlands (Kingdom of the)","2024-03-17",0,0,12,0,0,13,0,0
"Netherlands (Kingdom of the)","2024-03-18",0,0,12,0,0,13,0,0
"Netherlands (Kingdom of the)","2024-03-19",0,0,12,0,0,13,0,0
"Netherlands (Kingdom of the)","2024-03-20",0,0,12,0,0,13,0,0
"Netherlands (Kingdom of the)","2024-03-21",0,0,12,0,0,13,0,0
"Netherlands (Kingdom of the)","2024-03-22",0,0,12,0,0,13,0,0
"Netherlands (Kingdom of the)","2024-03-23",0,0,12,0,0,13,0,0
"Netherlands (Kingdom of the)","2024-03-24",0,0,12,0,0,13,0,0
"Netherlands (Kingdom of the)","2024-03-25",0,0,12,0,0,13,0,0
"Netherlands (Kingdom of the)","2024-03-26",0,0,12,0,0,13,0,0
"Netherlands (Kingdom of the)","2024-03-27",0,0,12,0,0,13,0,0
"Netherlands (Kingdom of the)","2024-03-28",0,0,12,0,0,13,0,0
"Netherlands (Kingdom of the)","2024-03-29",0,0,12,0,0,13,0,0
"Netherlands (Kingdom of the)","2024-03-30",0,0,12,0,0,13,0,0
"Netherlands (Kingdom of the)","2024-03-31",0,0,12,0,0,13,0,0
"Netherlands (Kingdom of the)","2024-04-01",0,0,12,0,0,13,0,0
"Netherlands (Kingdom of the)","2024-04-02",0,0,12,0,0,13,0,0
"Netherlands (Kingdom of the)","2024-04-03",0,0,12,0,0,13,0,0
"Netherlands (Kingdom of the)","2024-04-04",0,0,12,0,0,13,0,0
"Netherlands (Kingdom of the)","2024-04-05",0,0,12,0,0,13,0,0
"Netherlands (Kingdom of the)","2024-04-06",0,0,12,0,0,13,0,0
"Netherlands (Kingdom of the)","2024-04-07",0,0,12,0,0,13,0,0
"Netherlands (Kingdom of the)","2024-04-08",0,0,12,0,0,13,0,0
"Netherlands (Kingdom of the)","2024-04-09",0,0,12,0,0,13,0,0
"Netherlands (Kingdom of the)","2024-04-10",0,0,12,0,0,13,0,0
"Netherlands (Kingdom of the)","2024-04-11",0,0,12,0,0,13,0,0
"Netherlands (Kingdom of the)","2024-04-12",0,0,12,0,0,13,0,0
"Netherlands (Kingdom of the)","2024-04-13",0,0,12,0,0,13,0,0
"Netherlands (Kingdom of the)","2024-04-14",0,0,12,0,0,13,0,0
"Netherlands (Kingdom of the)","2024-04-15",0,0,12,0,1,14,0,0
"Netherlands (Kingdom of the)","2024-04-16",0,0,12,0,0,14,0,0
"Netherlands (Kingdom of the)","2024-04-17",0,0,12,0,0,14,0,0
"Netherlands (Kingdom of the)","2024-04-18",0,0,12,0,0,14,0,0
"Netherlands (Kingdom of the)","2024-04-19",0,0,12,0,0,14,0,0
"Netherlands (Kingdom of the)","2024-04-20",0,0,12,0,0,14,0,0
"Netherlands (Kingdom of the)","2024-04-21",0,0,12,0,0,14,0,0
"Netherlands (Kingdom of the)","2024-04-22",0,0,12,0,0,14,0,0
"Netherlands (Kingdom of the)","2024-04-23",0,0,12,0,0,14,0,0
"Netherlands (Kingdom of the)","2024-04-24",0,0,12,0,0,14,0,0
"Netherlands (Kingdom of the)","2024-04-25",0,0,12,0,0,14,0,0
"Netherlands (Kingdom of the)","2024-04-26",0,0,12,0,0,14,0,0
"Netherlands (Kingdom of the)","2024-04-27",0,0,12,0,0,14,0,0
"Netherlands (Kingdom of the)","2024-04-28",0,0,12,0,0,14,0,0
"Netherlands (Kingdom of the)","2024-04-29",0,0,12,0,0,14,0,0
"Netherlands (Kingdom of the)","2024-04-30",0,2,14,0,0,14,0,0
"Netherlands (Kingdom of the)","2024-05-01",0,0,14,0,0,14,0,0
"Netherlands (Kingdom of the)","2024-05-02",0,0,14,0,0,14,0,0
"Netherlands (Kingdom of the)","2024-05-03",0,0,14,0,0,14,0,0
"Netherlands (Kingdom of the)","2024-05-04",0,0,14,0,0,14,0,0
"Netherlands (Kingdom of the)","2024-05-05",0,0,14,0,0,14,0,0
"Netherlands (Kingdom of the)","2024-05-06",0,0,14,0,0,14,0,0
"Netherlands (Kingdom of the)","2024-05-07",0,0,14,0,0,14,0,0
"Netherlands (Kingdom of the)","2024-05-08",0,0,14,0,0,14,0,0
"Netherlands (Kingdom of the)","2024-05-09",0,0,14,0,0,14,0,0
"Netherlands (Kingdom of the)","2024-05-10",0,0,14,0,0,14,0,0
"Netherlands (Kingdom of the)","2024-05-11",0,0,14,0,0,14,0,0
"Netherlands (Kingdom of the)","2024-05-12",0,0,14,0,0,14,0,0
"Netherlands (Kingdom of the)","2024-05-13",0,0,14,0,0,14,0,0
"Netherlands (Kingdom of the)","2024-05-14",0,0,14,0,0,14,0,0
"Netherlands (Kingdom of the)","2024-05-15",0,0,14,0,0,14,0,0
"Netherlands (Kingdom of the)","2024-05-16",0,0,14,0,1,15,0,0
"Netherlands (Kingdom of the)","2024-05-17",0,0,14,0,0,15,0,0
"Netherlands (Kingdom of the)","2024-05-18",0,0,14,0,0,15,0,0
"Netherlands (Kingdom of the)","2024-05-19",0,0,14,0,0,15,0,0
"Netherlands (Kingdom of the)","2024-05-20",0,0,14,0,0,15,0,0
"Netherlands (Kingdom of the)","2024-05-21",0,0,14,0,0,15,0,0
"Netherlands (Kingdom of the)","2024-05-22",0,0,14,0,0,15,0,0
"Netherlands (Kingdom of the)","2024-05-23",0,0,14,0,0,15,0,0
"Netherlands (Kingdom of the)","2024-05-24",0,0,14,0,0,15,0,0
"Netherlands (Kingdom of the)","2024-05-25",0,0,14,0,0,15,0,0
"Netherlands (Kingdom of the)","2024-05-26",0,0,14,0,0,15,0,0
"Netherlands (Kingdom of the)","2024-05-27",0,0,14,0,0,15,0,0
"Netherlands (Kingdom of the)","2024-05-28",0,0,14,0,0,15,0,0
"Netherlands (Kingdom of the)","2024-05-29",0,0,14,0,0,15,0,0
"Netherlands (Kingdom of the)","2024-05-30",0,0,14,0,0,15,0,0
"Netherlands (Kingdom of the)","2024-05-31",0,1,15,0,0,15,0,0
"Netherlands (Kingdom of the)","2024-06-01",0,0,15,0,0,15,0,0
"Netherlands (Kingdom of the)","2024-06-02",0,0,15,0,0,15,0,0
"Netherlands (Kingdom of the)","2024-06-03",0,0,15,0,0,15,0,0
"Netherlands (Kingdom of the)","2024-06-04",0,0,15,0,0,15,0,0
"Netherlands (Kingdom of the)","2024-06-05",0,0,15,0,0,15,0,0
"Netherlands (Kingdom of the)","2024-06-06",0,0,15,0,0,15,0,0
"Netherlands (Kingdom of the)","2024-06-07",0,0,15,0,0,15,0,0
"Netherlands (Kingdom of the)","2024-06-08",0,0,15,0,1,16,0,0
"Netherlands (Kingdom of the)","2024-06-09",0,0,15,0,0,16,0,0
"Netherlands (Kingdom of the)","2024-06-10",0,0,15,0,0,16,0,0
"Netherlands (Kingdom of the)","2024-06-11",0,0,15,0,0,16,0,0
"Netherlands (Kingdom of the)","2024-06-12",0,0,15,0,0,16,0,0
"Netherlands (Kingdom of the)","2024-06-13",0,0,15,0,0,16,0,0
"Netherlands (Kingdom of the)","2024-06-14",0,0,15,0,0,16,0,0
"Netherlands (Kingdom of the)","2024-06-15",0,0,15,0,0,16,0,0
"Netherlands (Kingdom of the)","2024-06-16",0,0,15,0,0,16,0,0
"Netherlands (Kingdom of the)","2024-06-17",0,0,15,0,0,16,0,0
"Netherlands (Kingdom of the)","2024-06-18",0,0,15,0,0,16,0,0
"Netherlands (Kingdom of the)","2024-06-19",0,0,15,0,0,16,0,0
"Netherlands (Kingdom of the)","2024-06-20",0,0,15,0,0,16,0,0
"Netherlands (Kingdom of the)","2024-06-21",0,0,15,0,0,16,0,0
"Netherlands (Kingdom of the)","2024-06-22",0,0,15,0,0,16,0,0
"Netherlands (Kingdom of the)","2024-06-23",0,0,15,0,1,17,0,0
"Netherlands (Kingdom of the)","2024-06-24",0,0,15,0,0,17,0,0
"Netherlands (Kingdom of the)","2024-06-25",0,0,15,0,0,17,0,0
"Netherlands (Kingdom of the)","2024-06-26",0,0,15,0,0,17,0,0
"Netherlands (Kingdom of the)","2024-06-27",0,0,15,0,0,17,0,0
"Netherlands (Kingdom of the)","2024-06-28",0,0,15,0,0,17,0,0
"Netherlands (Kingdom of the)","2024-06-29",0,0,15,0,0,17,0,0
"Netherlands (Kingdom of the)","2024-06-30",0,2,17,0,0,17,0,0
"Netherlands (Kingdom of the)","2024-07-01",0,0,17,0,0,17,0,0
"Netherlands (Kingdom of the)","2024-07-02",0,0,17,0,0,17,0,0
"Netherlands (Kingdom of the)","2024-07-03",0,0,17,0,0,17,0,0
"Netherlands (Kingdom of the)","2024-07-04",0,0,17,0,1,18,0,0
"Netherlands (Kingdom of the)","2024-07-05",0,0,17,0,0,18,0,0
"Netherlands (Kingdom of the)","2024-07-06",0,0,17,0,0,18,0,0
"Netherlands (Kingdom of the)","2024-07-07",0,0,17,0,0,18,0,0
"Netherlands (Kingdom of the)","2024-07-08",0,0,17,0,0,18,0,0
"Netherlands (Kingdom of the)","2024-07-09",0,0,17,0,0,18,0,0
"Netherlands (Kingdom of the)","2024-07-10",0,0,17,0,0,18,0,0
"Netherlands (Kingdom of the)","2024-07-11",0,0,17,0,0,18,0,0
"Netherlands (Kingdom of the)","2024-07-12",0,0,17,0,1,19,0,0
"Netherlands (Kingdom of the)","2024-07-13",0,0,17,0,0,19,0,0
"Netherlands (Kingdom of the)","2024-07-14",0,0,17,0,0,19,0,0
"Netherlands (Kingdom of the)","2024-07-15",0,0,17,0,0,19,0,0
"Netherlands (Kingdom of the)","2024-07-16",0,0,17,0,0,19,0,0
"Netherlands (Kingdom of the)","2024-07-17",0,0,17,0,0,19,0,0
"Netherlands (Kingdom of the)","2024-07-18",0,0,17,0,0,19,0,0
"Netherlands (Kingdom of the)","2024-07-19",0,0,17,0,0,19,0,0
"Netherlands (Kingdom of the)","2024-07-20",0,0,17,0,1,20,0,0
"Netherlands (Kingdom of the)","2024-07-21",0,0,17,0,0,20,0,0
"Netherlands (Kingdom of the)","2024-07-22",0,0,17,0,0,20,0,0
"Netherlands (Kingdom of the)","2024-07-23",0,0,17,0,0,20,0,0
"Netherlands (Kingdom of the)","2024-07-24",0,0,17,0,0,20,0,0
"Netherlands (Kingdom of the)","2024-07-25",0,0,17,0,0,20,0,0
"Netherlands (Kingdom of the)","2024-07-26",0,0,17,0,0,20,0,0
"Netherlands (Kingdom of the)","2024-07-27",0,0,17,0,0,20,0,0
"Netherlands (Kingdom of the)","2024-07-28",0,0,17,0,1,21,0,0
"Netherlands (Kingdom of the)","2024-07-29",0,0,17,0,0,21,0,0
"Netherlands (Kingdom of the)","2024-07-30",0,0,17,0,0,21,0,0
"Netherlands (Kingdom of the)","2024-07-31",0,4,21,0,0,21,0,0
"Netherlands (Kingdom of the)","2024-08-01",0,0,21,0,1,22,0,0
"Netherlands (Kingdom of the)","2024-08-02",0,0,21,0,0,22,0,0
"Netherlands (Kingdom of the)","2024-08-03",0,0,21,0,1,23,0,0
"Netherlands (Kingdom of the)","2024-08-04",0,0,21,0,0,23,0,0
"Netherlands (Kingdom of the)","2024-08-05",0,0,21,0,1,24,0,0
"Netherlands (Kingdom of the)","2024-08-06",0,0,21,0,1,25,0,0
"Netherlands (Kingdom of the)","2024-08-07",0,0,21,0,0,25,0,0
"Netherlands (Kingdom of the)","2024-08-08",0,0,21,0,1,26,0,0
"Netherlands (Kingdom of the)","2024-08-09",0,0,21,0,1,27,0,0
"Netherlands (Kingdom of the)","2024-08-10",0,0,21,0,0,27,0,0
"Netherlands (Kingdom of the)","2024-08-11",0,0,21,0,1,28,0,0
"Netherlands (Kingdom of the)","2024-08-12",0,0,21,0,0,28,0,0
"Netherlands (Kingdom of the)","2024-08-13",0,0,21,0,1,29,0,0
"Netherlands (Kingdom of the)","2024-08-14",0,0,21,0,1,30,0,0
"Netherlands (Kingdom of the)","2024-08-15",0,0,21,0,0,30,0,0
"Netherlands (Kingdom of the)","2024-08-16",0,0,21,0,1,31,0,0
"Netherlands (Kingdom of the)","2024-08-17",0,0,21,0,0,31,0,0
"Netherlands (Kingdom of the)","2024-08-18",0,0,21,0,1,32,0,0
"Netherlands (Kingdom of the)","2024-08-19",0,0,21,0,1,33,0,0
"Netherlands (Kingdom of the)","2024-08-20",0,0,21,0,0,33,0,0
"Netherlands (Kingdom of the)","2024-08-21",0,0,21,0,1,34,0,0
"Netherlands (Kingdom of the)","2024-08-22",0,0,21,0,0,34,0,0
"Netherlands (Kingdom of the)","2024-08-23",0,0,21,0,1,35,0,0
"Netherlands (Kingdom of the)","2024-08-24",0,0,21,0,1,36,0,0
"Netherlands (Kingdom of the)","2024-08-25",0,0,21,0,0,36,0,0
"Netherlands (Kingdom of the)","2024-08-26",0,0,21,0,1,37,0,0
"Netherlands (Kingdom of the)","2024-08-27",0,0,21,0,1,38,0,0
"Netherlands (Kingdom of the)","2024-08-28",0,0,21,0,0,38,0,0
"Netherlands (Kingdom of the)","2024-08-29",0,0,21,0,1,39,0,0
"Netherlands (Kingdom of the)","2024-08-30",0,0,21,0,0,39,0,0
"Netherlands (Kingdom of the)","2024-08-31",0,19,40,0,1,40,0,0
"Netherlands (Kingdom of the)","2024-09-01",0,0,40,0,1,41,0,0
"Netherlands (Kingdom of the)","2024-09-02",0,0,40,0,0,41,0,0
"Netherlands (Kingdom of the)","2024-09-03",0,0,40,0,1,42,0,0
"Netherlands (Kingdom of the)","2024-09-04",0,0,40,0,1,43,0,0
"Netherlands (Kingdom of the)","2024-09-05",0,0,40,0,1,44,0,0
"Netherlands (Kingdom of the)","2024-09-06",0,0,40,0,0,44,0,0
"Netherlands (Kingdom of the)","2024-09-07",0,0,40,0,1,45,0,0
"Netherlands (Kingdom of the)","2024-09-08",0,0,40,0,1,46,0,0
"Netherlands (Kingdom of the)","2024-09-09",0,0,40,0,1,47,0,0
"Netherlands (Kingdom of the)","2024-09-10",0,0,40,0,0,47,0,0
"Netherlands (Kingdom of the)","2024-09-11",0,0,40,0,1,48,0,0
"Netherlands (Kingdom of the)","2024-09-12",0,0,40,0,1,49,0,0
"Netherlands (Kingdom of the)","2024-09-13",0,0,40,0,1,50,0,0
"Netherlands (Kingdom of the)","2024-09-14",0,0,40,0,0,50,0,0
"Netherlands (Kingdom of the)","2024-09-15",0,0,40,0,1,51,0,0
"Netherlands (Kingdom of the)","2024-09-16",0,0,40,0,1,52,0,0
"Netherlands (Kingdom of the)","2024-09-17",0,0,40,0,0,52,0,0
"Netherlands (Kingdom of the)","2024-09-18",0,0,40,0,1,53,0,0
"Netherlands (Kingdom of the)","2024-09-19",0,0,40,0,1,54,0,0
"Netherlands (Kingdom of the)","2024-09-20",0,0,40,0,1,55,0,0
"Netherlands (Kingdom of the)","2024-09-21",0,0,40,0,0,55,0,0
"Netherlands (Kingdom of the)","2024-09-22",0,0,40,0,1,56,0,0
"Netherlands (Kingdom of the)","2024-09-23",0,0,40,0,1,57,0,0
"Netherlands (Kingdom of the)","2024-09-24",0,0,40,0,1,58,0,0
"Netherlands (Kingdom of the)","2024-09-25",0,0,40,0,0,58,0,0
"Netherlands (Kingdom of the)","2024-09-26",0,0,40,0,1,59,0,0
"Netherlands (Kingdom of the)","2024-09-27",0,0,40,0,1,60,0,0
"Netherlands (Kingdom of the)","2024-09-28",0,0,40,0,1,61,0,0
"Netherlands (Kingdom of the)","2024-09-29",0,0,40,0,0,61,0,0
"Netherlands (Kingdom of the)","2024-09-30",0,22,62,0,1,62,0,0
"Netherlands (Kingdom of the)","2024-10-01",0,0,62,0,1,63,0,0
"Netherlands (Kingdom of the)","2024-10-02",0,0,62,0,1,64,0,0
"Netherlands (Kingdom of the)","2024-10-03",0,0,62,0,0,64,0,0
"Netherlands (Kingdom of the)","2024-10-04",0,0,62,0,1,65,0,0
"Netherlands (Kingdom of the)","2024-10-05",0,0,62,0,1,66,0,0
"Netherlands (Kingdom of the)","2024-10-06",0,0,62,0,1,67,0,0
"Netherlands (Kingdom of the)","2024-10-07",0,0,62,0,1,68,0,0
"Netherlands (Kingdom of the)","2024-10-08",0,0,62,0,0,68,0,0
"Netherlands (Kingdom of the)","2024-10-09",0,0,62,0,1,69,0,0
"Netherlands (Kingdom of the)","2024-10-10",0,0,62,0,1,70,0,0
"Netherlands (Kingdom of the)","2024-10-11",0,0,62,0,1,71,0,0
"Netherlands (Kingdom of the)","2024-10-12",0,0,62,0,1,72,0,0
"Netherlands (Kingdom of the)","2024-10-13",0,0,62,0,0,72,0,0
"Netherlands (Kingdom of the)","2024-10-14",0,0,62,0,1,73,0,0
"Netherlands (Kingdom of the)","2024-10-15",0,0,62,0,1,74,0,0
"Netherlands (Kingdom of the)","2024-10-16",0,0,62,0,1,75,0,0
"Netherlands (Kingdom of the)","2024-10-17",0,0,62,0,1,76,0,0
"Netherlands (Kingdom of the)","2024-10-18",0,0,62,0,1,77,0,0
"Netherlands (Kingdom of the)","2024-10-19",0,0,62,0,0,77,0,0
"Netherlands (Kingdom of the)","2024-10-20",0,0,62,0,1,78,0,0
"Netherlands (Kingdom of the)","2024-10-21",0,0,62,0,1,79,0,0
"Netherlands (Kingdom of the)","2024-10-22",0,0,62,0,1,80,0,0
"Netherlands (Kingdom of the)","2024-10-23",0,0,62,0,1,81,0,0
"Netherlands (Kingdom of the)","2024-10-24",0,0,62,0,0,81,0,0
"Netherlands (Kingdom of the)","2024-10-25",0,0,62,0,1,82,0,0
"Netherlands (Kingdom of the)","2024-10-26",0,0,62,0,1,83,0,0
"Netherlands (Kingdom of the)","2024-10-27",0,0,62,0,1,84,0,0
"Netherlands (Kingdom of the)","2024-10-28",0,0,62,0,1,85,0,0
"Netherlands (Kingdom of the)","2024-10-29",0,0,62,0,0,85,0,0
"Netherlands (Kingdom of the)","2024-10-30",0,0,62,0,1,86,0,0
"Netherlands (Kingdom of the)","2024-10-31",0,25,87,0,1,87,0,0
"Netherlands (Kingdom of the)","2024-11-01",0,0,87,0,1,88,0,0
"Netherlands (Kingdom of the)","2024-11-02",0,0,87,0,2,90,0,0
"Netherlands (Kingdom of the)","2024-11-03",0,0,87,0,1,91,0,0
"Netherlands (Kingdom of the)","2024-11-04",0,0,87,0,1,92,0,0
"Netherlands (Kingdom of the)","2024-11-05",0,0,87,0,1,93,0,0
"Netherlands (Kingdom of the)","2024-11-06",0,0,87,0,2,95,0,0
"Netherlands (Kingdom of the)","2024-11-07",0,0,87,0,1,96,0,0
"Netherlands (Kingdom of the)","2024-11-08",0,0,87,0,1,97,0,0
"Netherlands (Kingdom of the)","2024-11-09",0,0,87,0,1,98,0,0
"Netherlands (Kingdom of the)","2024-11-10",0,0,87,0,2,100,0,0
"Netherlands (Kingdom of the)","2024-11-11",0,0,87,0,1,101,0,0
"Netherlands (Kingdom of the)","2024-11-12",0,0,87,0,1,102,0,0
"Netherlands (Kingdom of the)","2024-11-13",0,0,87,0,1,103,0,0
"Netherlands (Kingdom of the)","2024-11-14",0,0,87,0,2,105,0,0
"Netherlands (Kingdom of the)","2024-11-15",0,0,87,0,1,106,0,0
"Netherlands (Kingdom of the)","2024-11-16",0,0,87,0,1,107,0,0
"Netherlands (Kingdom of the)","2024-11-17",0,0,87,0,2,109,0,0
"Netherlands (Kingdom of the)","2024-11-18",0,0,87,0,1,110,0,0
"Netherlands (Kingdom of the)","2024-11-19",0,0,87,0,1,111,0,0
"Netherlands (Kingdom of the)","2024-11-20",0,0,87,0,1,112,0,0
"Netherlands (Kingdom of the)","2024-11-21",0,0,87,0,2,114,0,0
"Netherlands (Kingdom of the)","2024-11-22",0,0,87,0,1,115,0,0
"Netherlands (Kingdom of the)","2024-11-23",0,0,87,0,1,116,0,0
"Netherlands (Kingdom of the)","2024-11-24",0,0,87,0,1,117,0,0
"Netherlands (Kingdom of the)","2024-11-25",0,0,87,0,2,119,0,0
"Netherlands (Kingdom of the)","2024-11-26",0,0,87,0,1,120,0,0
"Netherlands (Kingdom of the)","2024-11-27",0,0,87,0,1,121,0,0
"Netherlands (Kingdom of the)","2024-11-28",0,0,87,0,1,122,0,0
"Netherlands (Kingdom of the)","2024-11-29",0,0,87,0,2,124,0,0
"Netherlands (Kingdom of the)","2024-11-30",0,38,125,0,1,125,0,0
"Netherlands (Kingdom of the)","2024-12-01",0,0,125,0,1,126,0,0
"Netherlands (Kingdom of the)","2024-12-02",0,0,125,0,0,126,0,0
"Netherlands (Kingdom of the)","2024-12-03",0,0,125,0,1,127,0,0
"Netherlands (Kingdom of the)","2024-12-04",0,0,125,0,0,127,0,0
"Netherlands (Kingdom of the)","2024-12-05",0,0,125,0,1,128,0,0
"Netherlands (Kingdom of the)","2024-12-06",0,0,125,0,0,128,0,0
"Netherlands (Kingdom of the)","2024-12-07",0,0,125,0,1,129,0,0
"Netherlands (Kingdom of the)","2024-12-08",0,0,125,0,0,129,0,0
"Netherlands (Kingdom of the)","2024-12-09",0,0,125,0,1,130,0,0
"Netherlands (Kingdom of the)","2024-12-10",0,0,125,0,0,130,0,0
"Netherlands (Kingdom of the)","2024-12-11",0,0,125,0,1,131,0,0
"Netherlands (Kingdom of the)","2024-12-12",0,0,125,0,0,131,0,0
"Netherlands (Kingdom of the)","2024-12-13",0,0,125,0,1,132,0,0
"Netherlands (Kingdom of the)","2024-12-14",0,0,125,0,0,132,0,0
"Netherlands (Kingdom of the)","2024-12-15",0,0,125,0,1,133,0,0
"Netherlands (Kingdom of the)","2024-12-16",0,0,125,0,0,133,0,0
"Netherlands (Kingdom of the)","2024-12-17",0,0,125,0,1,134,0,0
"Netherlands (Kingdom of the)","2024-12-18",0,0,125,0,0,134,0,0
"Netherlands (Kingdom of the)","2024-12-19",0,0,125,0,1,135,0,0
"Netherlands (Kingdom of the)","2024-12-20",0,0,125,0,0,135,0,0
"Netherlands (Kingdom of the)","2024-12-21",0,0,125,0,1,136,0,0
"Netherlands (Kingdom of the)","2024-12-22",0,0,125,0,0,136,0,0
"Netherlands (Kingdom of the)","2024-12-23",0,0,125,0,1,137,0,0
"Netherlands (Kingdom of the)","2024-12-24",0,0,125,0,0,137,0,0
"Netherlands (Kingdom of the)","2024-12-25",0,0,125,0,1,138,0,0
"Netherlands (Kingdom of the)","2024-12-26",0,0,125,0,0,138,0,0
"Netherlands (Kingdom of the)","2024-12-27",0,0,125,0,1,139,0,0
"Netherlands (Kingdom of the)","2024-12-28",0,0,125,0,0,139,0,0
"Netherlands (Kingdom of the)","2024-12-29",0,0,125,0,1,140,0,0
"Netherlands (Kingdom of the)","2024-12-30",0,0,125,0,0,140,0,0
"Netherlands (Kingdom of the)","2024-12-31",0,16,141,0,1,141,0,0
"Netherlands (Kingdom of the)","2025-01-01",0,0,141,0,1,142,0,0
"Netherlands (Kingdom of the)","2025-01-02",0,0,141,0,2,144,0,0
"Netherlands (Kingdom of the)","2025-01-03",0,0,141,0,1,145,0,0
"Netherlands (Kingdom of the)","2025-01-04",0,0,141,0,2,147,0,0
"Netherlands (Kingdom of the)","2025-01-05",0,0,141,0,1,148,0,0
"Netherlands (Kingdom of the)","2025-01-06",0,0,141,0,1,149,0,0
"Netherlands (Kingdom of the)","2025-01-07",0,0,141,0,2,151,0,0
"Netherlands (Kingdom of the)","2025-01-08",0,0,141,0,1,152,0,0
"Netherlands (Kingdom of the)","2025-01-09",0,0,141,0,2,154,0,0
"Netherlands (Kingdom of the)","2025-01-10",0,14,155,0,1,155,0,0
"Netherlands (Kingdom of the)","2025-01-11",0,0,155,0,0,155,0,0
"Netherlands (Kingdom of the)","2025-01-12",0,0,155,0,0,155,0,0
"Netherlands (Kingdom of the)","2025-01-13",0,0,155,0,0,155,0,0
"Netherlands (Kingdom of the)","2025-01-14",0,0,155,0,0,155,0,0
"Netherlands (Kingdom of the)","2025-01-15",0,0,155,0,0,155,0,0
"Netherlands (Kingdom of the)","2025-01-16",0,0,155,0,0,155,0,0
"Netherlands (Kingdom of the)","2025-01-17",0,0,155,0,0,155,0,0
"Netherlands (Kingdom of the)","2025-01-18",0,0,155,0,0,155,0,0
"Netherlands (Kingdom of the)","2025-01-19",0,0,155,0,0,155,0,0
"Netherlands (Kingdom of the)","2025-01-20",0,0,155,0,0,155,0,0
"Netherlands (Kingdom of the)","2025-01-21",0,0,155,0,0,155,0,0
"Netherlands (Kingdom of the)","2025-01-22",0,0,155,0,0,155,0,0
"Netherlands (Kingdom of the)","2025-01-23",0,0,155,0,0,155,0,0
"Netherlands (Kingdom of the)","2025-01-24",0,0,155,0,0,155,0,0
"Netherlands (Kingdom of the)","2025-01-25",0,0,155,0,0,155,0,0
"Netherlands (Kingdom of the)","2025-01-26",0,0,155,0,0,155,0,0
"Netherlands (Kingdom of the)","2025-01-27",0,0,155,0,0,155,0,0
"Netherlands (Kingdom of the)","2025-01-28",0,0,155,0,0,155,0,0
"Netherlands (Kingdom of the)","2025-01-29",0,0,155,0,0,155,0,0
"Netherlands (Kingdom of the)","2025-01-30",0,0,155,0,0,155,0,0
"Netherlands (Kingdom of the)","2025-01-31",0,0,155,0,0,155,0,0
"Netherlands (Kingdom of the)","2025-02-01",0,0,155,0,0,155,0,0
"Netherlands (Kingdom of the)","2025-02-02",0,0,155,0,0,155,0,0
"Netherlands (Kingdom of the)","2025-02-03",0,0,155,0,0,155,0,0
"Netherlands (Kingdom of the)","2025-02-04",0,0,155,0,0,155,0,0
"Netherlands (Kingdom of the)","2025-02-05",0,0,155,0,0,155,0,0
"Netherlands (Kingdom of the)","2025-02-06",0,0,155,0,0,155,0,0
"Netherlands (Kingdom of the)","2025-02-07",0,0,155,0,0,155,0,0
"Netherlands (Kingdom of the)","2025-02-08",0,0,155,0,0,155,0,0
"Netherlands (Kingdom of the)","2025-02-09",0,0,155,0,0,155,0,0
"Netherlands (Kingdom of the)","2025-02-10",0,0,155,0,0,155,0,0
"Netherlands (Kingdom of the)","2025-02-11",0,0,155,0,0,155,0,0
"Netherlands (Kingdom of the)","2025-02-12",0,0,155,0,0,155,0,0
"Netherlands (Kingdom of the)","2025-02-13",0,0,155,0,0,155,0,0
"Netherlands (Kingdom of the)","2025-02-14",0,0,155,0,0,155,0,0
"Netherlands (Kingdom of the)","2025-02-15",0,0,155,0,0,155,0,0
"Netherlands (Kingdom of the)","2025-02-16",0,0,155,0,0,155,0,0
"Netherlands (Kingdom of the)","2025-02-17",0,0,155,0,0,155,0,0
"Netherlands (Kingdom of the)","2025-02-18",0,0,155,0,0,155,0,0
"Netherlands (Kingdom of the)","2025-02-19",0,0,155,0,0,155,0,0
"Netherlands (Kingdom of the)","2025-02-20",0,0,155,0,0,155,0,0
"Netherlands (Kingdom of the)","2025-02-21",0,0,155,0,0,155,0,0
"Netherlands (Kingdom of the)","2025-02-22",0,0,155,0,0,155,0,0
"Netherlands (Kingdom of the)","2025-02-23",0,0,155,0,0,155,0,0
"Netherlands (Kingdom of the)","2025-02-24",0,0,155,0,0,155,0,0
"Netherlands (Kingdom of the)","2025-02-25",0,0,155,0,0,155,0,0
"Netherlands (Kingdom of the)","2025-02-26",0,0,155,0,0,155,0,0
"Netherlands (Kingdom of the)","2025-02-27",0,0,155,0,0,155,0,0
"Netherlands (Kingdom of the)","2025-02-28",0,0,155,0,0,155,0,0
"Netherlands (Kingdom of the)","2025-03-01",0,0,155,0,0,155,0,0
"Netherlands (Kingdom of the)","2025-03-02",0,0,155,0,0,155,0,0
"Netherlands (Kingdom of the)","2025-03-03",0,0,155,0,0,155,0,0
"New Zealand","2024-01-01",0,0,0,0,0,0,0,0
"New Zealand","2024-01-02",0,0,0,0,0,0,0,0
"New Zealand","2024-01-03",0,0,0,0,0,0,0,0
"New Zealand","2024-01-04",0,0,0,0,0,0,0,0
"New Zealand","2024-01-05",0,0,0,0,0,0,0,0
"New Zealand","2024-01-06",0,0,0,0,0,0,0,0
"New Zealand","2024-01-07",0,0,0,0,0,0,0,0
"New Zealand","2024-01-08",0,0,0,0,0,0,0,0
"New Zealand","2024-01-09",0,0,0,0,0,0,0,0
"New Zealand","2024-01-10",0,0,0,0,0,0,0,0
"New Zealand","2024-01-11",0,0,0,0,0,0,0,0
"New Zealand","2024-01-12",0,0,0,0,0,0,0,0
"New Zealand","2024-01-13",0,0,0,0,0,0,0,0
"New Zealand","2024-01-14",0,0,0,0,0,0,0,0
"New Zealand","2024-01-15",0,0,0,0,0,0,0,0
"New Zealand","2024-01-16",0,8,8,0,8,8,0,0
"New Zealand","2024-01-17",0,0,8,0,0,8,0,0
"New Zealand","2024-01-18",0,0,8,0,0,8,0,0
"New Zealand","2024-01-19",0,0,8,0,0,8,0,0
"New Zealand","2024-01-20",0,0,8,0,0,8,0,0
"New Zealand","2024-01-21",0,0,8,0,0,8,0,0
"New Zealand","2024-01-22",0,0,8,0,0,8,0,0
"New Zealand","2024-01-23",0,0,8,0,0,8,0,0
"New Zealand","2024-01-24",0,0,8,0,0,8,0,0
"New Zealand","2024-01-25",0,0,8,0,0,8,0,0
"New Zealand","2024-01-26",0,0,8,0,0,8,0,0
"New Zealand","2024-01-27",0,0,8,0,0,8,0,0
"New Zealand","2024-01-28",0,0,8,0,0,8,0,0
"New Zealand","2024-01-29",0,0,8,0,0,8,0,0
"New Zealand","2024-01-30",0,0,8,0,0,8,0,0
"New Zealand","2024-01-31",0,0,8,0,0,8,0,0
"New Zealand","2024-02-01",0,0,8,0,0,8,0,0
"New Zealand","2024-02-02",0,0,8,0,0,8,0,0
"New Zealand","2024-02-03",0,0,8,0,0,8,0,0
"New Zealand","2024-02-04",0,0,8,0,0,8,0,0
"New Zealand","2024-02-05",0,0,8,0,0,8,0,0
"New Zealand","2024-02-06",0,0,8,0,0,8,0,0
"New Zealand","2024-02-07",0,0,8,0,0,8,0,0
"New Zealand","2024-02-08",0,0,8,0,0,8,0,0
"New Zealand","2024-02-09",0,0,8,0,0,8,0,0
"New Zealand","2024-02-10",0,0,8,0,0,8,0,0
"New Zealand","2024-02-11",0,0,8,0,0,8,0,0
"New Zealand","2024-02-12",0,0,8,0,0,8,0,0
"New Zealand","2024-02-13",0,0,8,0,0,8,0,0
"New Zealand","2024-02-14",0,0,8,0,0,8,0,0
"New Zealand","2024-02-15",0,0,8,0,0,8,0,0
"New Zealand","2024-02-16",0,0,8,0,0,8,0,0
"New Zealand","2024-02-17",0,0,8,0,0,8,0,0
"New Zealand","2024-02-18",0,0,8,0,0,8,0,0
"New Zealand","2024-02-19",0,0,8,0,0,8,0,0
"New Zealand","2024-02-20",0,0,8,0,0,8,0,0
"New Zealand","2024-02-21",0,0,8,0,0,8,0,0
"New Zealand","2024-02-22",0,0,8,0,0,8,0,0
"New Zealand","2024-02-23",0,0,8,0,0,8,0,0
"New Zealand","2024-02-24",0,0,8,0,0,8,0,0
"New Zealand","2024-02-25",0,0,8,0,0,8,0,0
"New Zealand","2024-02-26",0,0,8,0,0,8,0,0
"New Zealand","2024-02-27",0,0,8,0,0,8,0,0
"New Zealand","2024-02-28",0,0,8,0,0,8,0,0
"New Zealand","2024-02-29",0,0,8,0,0,8,0,0
"New Zealand","2024-03-01",0,0,8,0,0,8,0,0
"New Zealand","2024-03-02",0,0,8,0,0,8,0,0
"New Zealand","2024-03-03",0,0,8,0,0,8,0,0
"New Zealand","2024-03-04",0,0,8,0,0,8,0,0
"New Zealand","2024-03-05",0,0,8,0,0,8,0,0
"New Zealand","2024-03-06",0,0,8,0,0,8,0,0
"New Zealand","2024-03-07",0,0,8,0,0,8,0,0
"New Zealand","2024-03-08",0,0,8,0,0,8,0,0
"New Zealand","2024-03-09",0,0,8,0,0,8,0,0
"New Zealand","2024-03-10",0,0,8,0,0,8,0,0
"New Zealand","2024-03-11",0,0,8,0,0,8,0,0
"New Zealand","2024-03-12",0,0,8,0,0,8,0,0
"New Zealand","2024-03-13",0,0,8,0,0,8,0,0
"New Zealand","2024-03-14",0,0,8,0,1,9,0,0
"New Zealand","2024-03-15",0,0,8,0,0,9,0,0
"New Zealand","2024-03-16",0,0,8,0,0,9,0,0
"New Zealand","2024-03-17",0,0,8,0,0,9,0,0
"New Zealand","2024-03-18",0,0,8,0,0,9,0,0
"New Zealand","2024-03-19",0,0,8,0,0,9,0,0
"New Zealand","2024-03-20",0,0,8,0,0,9,0,0
"New Zealand","2024-03-21",0,0,8,0,0,9,0,0
"New Zealand","2024-03-22",0,0,8,0,0,9,0,0
"New Zealand","2024-03-23",0,0,8,0,0,9,0,0
"New Zealand","2024-03-24",0,0,8,0,0,9,0,0
"New Zealand","2024-03-25",0,0,8,0,0,9,0,0
"New Zealand","2024-03-26",0,0,8,0,0,9,0,0
"New Zealand","2024-03-27",0,0,8,0,0,9,0,0
"New Zealand","2024-03-28",0,0,8,0,0,9,0,0
"New Zealand","2024-03-29",0,0,8,0,0,9,0,0
"New Zealand","2024-03-30",0,0,8,0,0,9,0,0
"New Zealand","2024-03-31",0,0,8,0,0,9,0,0
"New Zealand","2024-04-01",0,0,8,0,0,9,0,0
"New Zealand","2024-04-02",0,0,8,0,0,9,0,0
"New Zealand","2024-04-03",0,0,8,0,0,9,0,0
"New Zealand","2024-04-04",0,0,8,0,0,9,0,0
"New Zealand","2024-04-05",0,0,8,0,0,9,0,0
"New Zealand","2024-04-06",0,0,8,0,0,9,0,0
"New Zealand","2024-04-07",0,0,8,0,0,9,0,0
"New Zealand","2024-04-08",0,0,8,0,0,9,0,0
"New Zealand","2024-04-09",0,0,8,0,0,9,0,0
"New Zealand","2024-04-10",0,0,8,0,0,9,0,0
"New Zealand","2024-04-11",0,0,8,0,0,9,0,0
"New Zealand","2024-04-12",0,0,8,0,0,9,0,0
"New Zealand","2024-04-13",0,0,8,0,0,9,0,0
"New Zealand","2024-04-14",0,0,8,0,0,9,0,0
"New Zealand","2024-04-15",0,0,8,0,0,9,0,0
"New Zealand","2024-04-16",0,0,8,0,0,9,0,0
"New Zealand","2024-04-17",0,0,8,0,0,9,0,0
"New Zealand","2024-04-18",0,0,8,0,0,9,0,0
"New Zealand","2024-04-19",0,0,8,0,0,9,0,0
"New Zealand","2024-04-20",0,0,8,0,0,9,0,0
"New Zealand","2024-04-21",0,0,8,0,0,9,0,0
"New Zealand","2024-04-22",0,0,8,0,0,9,0,0
"New Zealand","2024-04-23",0,0,8,0,0,9,0,0
"New Zealand","2024-04-24",0,0,8,0,0,9,0,0
"New Zealand","2024-04-25",0,0,8,0,0,9,0,0
"New Zealand","2024-04-26",0,0,8,0,0,9,0,0
"New Zealand","2024-04-27",0,0,8,0,0,9,0,0
"New Zealand","2024-04-28",0,0,8,0,0,9,0,0
"New Zealand","2024-04-29",0,0,8,0,0,9,0,0
"New Zealand","2024-04-30",0,0,8,0,0,9,0,0
"New Zealand","2024-05-01",0,0,8,0,0,9,0,0
"New Zealand","2024-05-02",0,0,8,0,0,9,0,0
"New Zealand","2024-05-03",0,0,8,0,0,9,0,0
"New Zealand","2024-05-04",0,0,8,0,0,9,0,0
"New Zealand","2024-05-05",0,0,8,0,0,9,0,0
"New Zealand","2024-05-06",0,0,8,0,0,9,0,0
"New Zealand","2024-05-07",0,0,8,0,0,9,0,0
"New Zealand","2024-05-08",0,0,8,0,0,9,0,0
"New Zealand","2024-05-09",0,1,9,0,0,9,0,0
"New Zealand","2024-05-10",0,0,9,0,0,9,0,0
"New Zealand","2024-05-11",0,0,9,0,0,9,0,0
"New Zealand","2024-05-12",0,0,9,0,0,9,0,0
"New Zealand","2024-05-13",0,0,9,0,0,9,0,0
"New Zealand","2024-05-14",0,0,9,0,0,9,0,0
"New Zealand","2024-05-15",0,0,9,0,0,9,0,0
"New Zealand","2024-05-16",0,0,9,0,0,9,0,0
"New Zealand","2024-05-17",0,0,9,0,0,9,0,0
"New Zealand","2024-05-18",0,0,9,0,0,9,0,0
"New Zealand","2024-05-19",0,0,9,0,0,9,0,0
"New Zealand","2024-05-20",0,0,9,0,0,9,0,0
"New Zealand","2024-05-21",0,0,9,0,0,9,0,0
"New Zealand","2024-05-22",0,0,9,0,0,9,0,0
"New Zealand","2024-05-23",0,0,9,0,1,10,0,0
"New Zealand","2024-05-24",0,0,9,0,0,10,0,0
"New Zealand","2024-05-25",0,0,9,0,0,10,0,0
"New Zealand","2024-05-26",0,0,9,0,0,10,0,0
"New Zealand","2024-05-27",0,0,9,0,0,10,0,0
"New Zealand","2024-05-28",0,0,9,0,0,10,0,0
"New Zealand","2024-05-29",0,0,9,0,0,10,0,0
"New Zealand","2024-05-30",0,0,9,0,0,10,0,0
"New Zealand","2024-05-31",0,0,9,0,0,10,0,0
"New Zealand","2024-06-01",0,0,9,0,0,10,0,0
"New Zealand","2024-06-02",0,0,9,0,0,10,0,0
"New Zealand","2024-06-03",0,0,9,0,0,10,0,0
"New Zealand","2024-06-04",0,0,9,0,0,10,0,0
"New Zealand","2024-06-05",0,0,9,0,0,10,0,0
"New Zealand","2024-06-06",0,0,9,0,0,10,0,0
"New Zealand","2024-06-07",0,0,9,0,0,10,0,0
"New Zealand","2024-06-08",0,0,9,0,0,10,0,0
"New Zealand","2024-06-09",0,0,9,0,0,10,0,0
"New Zealand","2024-06-10",0,0,9,0,0,10,0,0
"New Zealand","2024-06-11",0,0,9,0,0,10,0,0
"New Zealand","2024-06-12",0,0,9,0,0,10,0,0
"New Zealand","2024-06-13",0,0,9,0,0,10,0,0
"New Zealand","2024-06-14",0,0,9,0,0,10,0,0
"New Zealand","2024-06-15",0,0,9,0,0,10,0,0
"New Zealand","2024-06-16",0,0,9,0,0,10,0,0
"New Zealand","2024-06-17",0,0,9,0,0,10,0,0
"New Zealand","2024-06-18",0,0,9,0,1,11,0,0
"New Zealand","2024-06-19",0,0,9,0,0,11,0,0
"New Zealand","2024-06-20",0,0,9,0,0,11,0,0
"New Zealand","2024-06-21",0,0,9,0,0,11,0,0
"New Zealand","2024-06-22",0,0,9,0,0,11,0,0
"New Zealand","2024-06-23",0,0,9,0,0,11,0,0
"New Zealand","2024-06-24",0,0,9,0,0,11,0,0
"New Zealand","2024-06-25",0,0,9,0,0,11,0,0
"New Zealand","2024-06-26",0,0,9,0,0,11,0,0
"New Zealand","2024-06-27",0,0,9,0,0,11,0,0
"New Zealand","2024-06-28",0,0,9,0,0,11,0,0
"New Zealand","2024-06-29",0,0,9,0,0,11,0,0
"New Zealand","2024-06-30",0,0,9,0,0,11,0,0
"New Zealand","2024-07-01",0,2,11,0,0,11,0,0
"New Zealand","2024-07-02",0,0,11,0,0,11,0,0
"New Zealand","2024-07-03",0,0,11,0,0,11,0,0
"New Zealand","2024-07-04",0,0,11,0,0,11,0,0
"New Zealand","2024-07-05",0,0,11,0,0,11,0,0
"New Zealand","2024-07-06",0,0,11,0,1,12,0,0
"New Zealand","2024-07-07",0,0,11,0,0,12,0,0
"New Zealand","2024-07-08",0,0,11,0,0,12,0,0
"New Zealand","2024-07-09",0,0,11,0,0,12,0,0
"New Zealand","2024-07-10",0,0,11,0,0,12,0,0
"New Zealand","2024-07-11",0,0,11,0,0,12,0,0
"New Zealand","2024-07-12",0,0,11,0,0,12,0,0
"New Zealand","2024-07-13",0,0,11,0,0,12,0,0
"New Zealand","2024-07-14",0,0,11,0,0,12,0,0
"New Zealand","2024-07-15",0,0,11,0,1,13,0,0
"New Zealand","2024-07-16",0,0,11,0,0,13,0,0
"New Zealand","2024-07-17",0,0,11,0,0,13,0,0
"New Zealand","2024-07-18",0,0,11,0,0,13,0,0
"New Zealand","2024-07-19",0,0,11,0,0,13,0,0
"New Zealand","2024-07-20",0,0,11,0,0,13,0,0
"New Zealand","2024-07-21",0,0,11,0,0,13,0,0
"New Zealand","2024-07-22",0,0,11,0,0,13,0,0
"New Zealand","2024-07-23",0,0,11,0,0,13,0,0
"New Zealand","2024-07-24",0,0,11,0,1,14,0,0
"New Zealand","2024-07-25",0,0,11,0,0,14,0,0
"New Zealand","2024-07-26",0,0,11,0,0,14,0,0
"New Zealand","2024-07-27",0,0,11,0,0,14,0,0
"New Zealand","2024-07-28",0,0,11,0,0,14,0,0
"New Zealand","2024-07-29",0,0,11,0,0,14,0,0
"New Zealand","2024-07-30",0,0,11,0,0,14,0,0
"New Zealand","2024-07-31",0,0,11,0,0,14,0,0
"New Zealand","2024-08-01",0,0,11,0,1,15,0,0
"New Zealand","2024-08-02",0,0,11,0,0,15,0,0
"New Zealand","2024-08-03",0,0,11,0,0,15,0,0
"New Zealand","2024-08-04",0,0,11,0,0,15,0,0
"New Zealand","2024-08-05",0,0,11,0,0,15,0,0
"New Zealand","2024-08-06",0,0,11,0,0,15,0,0
"New Zealand","2024-08-07",0,0,11,0,0,15,0,0
"New Zealand","2024-08-08",0,0,11,0,0,15,0,0
"New Zealand","2024-08-09",0,0,11,0,0,15,0,0
"New Zealand","2024-08-10",0,0,11,0,1,16,0,0
"New Zealand","2024-08-11",0,0,11,0,0,16,0,0
"New Zealand","2024-08-12",0,0,11,0,0,16,0,0
"New Zealand","2024-08-13",0,0,11,0,0,16,0,0
"New Zealand","2024-08-14",0,0,11,0,0,16,0,0
"New Zealand","2024-08-15",0,0,11,0,0,16,0,0
"New Zealand","2024-08-16",0,0,11,0,0,16,0,0
"New Zealand","2024-08-17",0,0,11,0,0,16,0,0
"New Zealand","2024-08-18",0,0,11,0,0,16,0,0
"New Zealand","2024-08-19",0,0,11,0,1,17,0,0
"New Zealand","2024-08-20",0,0,11,0,0,17,0,0
"New Zealand","2024-08-21",0,0,11,0,0,17,0,0
"New Zealand","2024-08-22",0,0,11,0,0,17,0,0
"New Zealand","2024-08-23",0,0,11,0,0,17,0,0
"New Zealand","2024-08-24",0,0,11,0,0,17,0,0
"New Zealand","2024-08-25",0,0,11,0,0,17,0,0
"New Zealand","2024-08-26",0,0,11,0,0,17,0,0
"New Zealand","2024-08-27",0,0,11,0,0,17,0,0
"New Zealand","2024-08-28",0,0,11,0,1,18,0,0
"New Zealand","2024-08-29",0,0,11,0,0,18,0,0
"New Zealand","2024-08-30",0,0,11,0,0,18,0,0
"New Zealand","2024-08-31",0,0,11,0,0,18,0,0
"New Zealand","2024-09-01",0,0,11,0,0,18,0,0
"New Zealand","2024-09-02",0,0,11,0,0,18,0,0
"New Zealand","2024-09-03",0,0,11,0,0,18,0,0
"New Zealand","2024-09-04",0,0,11,0,0,18,0,0
"New Zealand","2024-09-05",0,0,11,0,0,18,0,0
"New Zealand","2024-09-06",0,0,11,0,1,19,0,0
"New Zealand","2024-09-07",0,0,11,0,0,19,0,0
"New Zealand","2024-09-08",0,0,11,0,0,19,0,0
"New Zealand","2024-09-09",0,0,11,0,0,19,0,0
"New Zealand","2024-09-10",0,0,11,0,0,19,0,0
"New Zealand","2024-09-11",0,0,11,0,0,19,0,0
"New Zealand","2024-09-12",0,0,11,0,0,19,0,0
"New Zealand","2024-09-13",0,0,11,0,0,19,0,0
"New Zealand","2024-09-14",0,0,11,0,0,19,0,0
"New Zealand","2024-09-15",0,0,11,0,1,20,0,0
"New Zealand","2024-09-16",0,0,11,0,0,20,0,0
"New Zealand","2024-09-17",0,0,11,0,0,20,0,0
"New Zealand","2024-09-18",0,0,11,0,0,20,0,0
"New Zealand","2024-09-19",0,0,11,0,0,20,0,0
"New Zealand","2024-09-20",0,0,11,0,0,20,0,0
"New Zealand","2024-09-21",0,0,11,0,0,20,0,0
"New Zealand","2024-09-22",0,0,11,0,0,20,0,0
"New Zealand","2024-09-23",0,0,11,0,1,21,0,0
"New Zealand","2024-09-24",0,0,11,0,0,21,0,0
"New Zealand","2024-09-25",0,0,11,0,0,21,0,0
"New Zealand","2024-09-26",0,0,11,0,0,21,0,0
"New Zealand","2024-09-27",0,0,11,0,0,21,0,0
"New Zealand","2024-09-28",0,0,11,0,0,21,0,0
"New Zealand","2024-09-29",0,0,11,0,0,21,0,0
"New Zealand","2024-09-30",0,0,11,0,0,21,0,0
"New Zealand","2024-10-01",0,0,11,0,0,21,0,0
"New Zealand","2024-10-02",0,0,11,0,1,22,0,0
"New Zealand","2024-10-03",0,0,11,0,0,22,0,0
"New Zealand","2024-10-04",0,0,11,0,0,22,0,0
"New Zealand","2024-10-05",0,0,11,0,0,22,0,0
"New Zealand","2024-10-06",0,0,11,0,0,22,0,0
"New Zealand","2024-10-07",0,0,11,0,0,22,0,0
"New Zealand","2024-10-08",0,0,11,0,0,22,0,0
"New Zealand","2024-10-09",0,0,11,0,0,22,0,0
"New Zealand","2024-10-10",0,0,11,0,0,22,0,0
"New Zealand","2024-10-11",0,0,11,0,1,23,0,0
"New Zealand","2024-10-12",0,0,11,0,0,23,0,0
"New Zealand","2024-10-13",0,0,11,0,0,23,0,0
"New Zealand","2024-10-14",0,0,11,0,0,23,0,0
"New Zealand","2024-10-15",0,12,23,0,0,23,0,0
"New Zealand","2024-10-16",0,0,23,0,0,23,0,0
"New Zealand","2024-10-17",0,0,23,0,0,23,0,0
"New Zealand","2024-10-18",0,0,23,0,0,23,0,0
"New Zealand","2024-10-19",0,0,23,0,0,23,0,0
"New Zealand","2024-10-20",0,0,23,0,0,23,0,0
"New Zealand","2024-10-21",0,0,23,0,0,23,0,0
"New Zealand","2024-10-22",0,0,23,0,0,23,0,0
"New Zealand","2024-10-23",0,0,23,0,0,23,0,0
"New Zealand","2024-10-24",0,0,23,0,0,23,0,0
"New Zealand","2024-10-25",0,0,23,0,0,23,0,0
"New Zealand","2024-10-26",0,0,23,0,1,24,0,0
"New Zealand","2024-10-27",0,0,23,0,0,24,0,0
"New Zealand","2024-10-28",0,0,23,0,0,24,0,0
"New Zealand","2024-10-29",0,0,23,0,0,24,0,0
"New Zealand","2024-10-30",0,0,23,0,0,24,0,0
"New Zealand","2024-10-31",0,0,23,0,0,24,0,0
"New Zealand","2024-11-01",0,0,23,0,0,24,0,0
"New Zealand","2024-11-02",0,0,23,0,0,24,0,0
"New Zealand","2024-11-03",0,0,23,0,0,24,0,0
"New Zealand","2024-11-04",0,1,24,0,0,24,0,0
"New Zealand","2024-11-05",0,0,24,0,0,24,0,0
"New Zealand","2024-11-06",0,0,24,0,0,24,0,0
"New Zealand","2024-11-07",0,0,24,0,0,24,0,0
"New Zealand","2024-11-08",0,0,24,0,0,24,0,0
"New Zealand","2024-11-09",0,0,24,0,0,24,0,0
"New Zealand","2024-11-10",0,0,24,0,1,25,0,0
"New Zealand","2024-11-11",0,0,24,0,0,25,0,0
"New Zealand","2024-11-12",0,0,24,0,0,25,0,0
"New Zealand","2024-11-13",0,0,24,0,0,25,0,0
"New Zealand","2024-11-14",0,0,24,0,0,25,0,0
"New Zealand","2024-11-15",0,0,24,0,0,25,0,0
"New Zealand","2024-11-16",0,0,24,0,0,25,0,0
"New Zealand","2024-11-17",0,0,24,0,0,25,0,0
"New Zealand","2024-11-18",0,0,24,0,0,25,0,0
"New Zealand","2024-11-19",0,0,24,0,0,25,0,0
"New Zealand","2024-11-20",0,0,24,0,1,26,0,0
"New Zealand","2024-11-21",0,0,24,0,0,26,0,0
"New Zealand","2024-11-22",0,0,24,0,0,26,0,0
"New Zealand","2024-11-23",0,0,24,0,0,26,0,0
"New Zealand","2024-11-24",0,0,24,0,0,26,0,0
"New Zealand","2024-11-25",0,0,24,0,0,26,0,0
"New Zealand","2024-11-26",0,0,24,0,0,26,0,0
"New Zealand","2024-11-27",0,0,24,0,0,26,0,0
"New Zealand","2024-11-28",0,0,24,0,0,26,0,0
"New Zealand","2024-11-29",0,0,24,0,0,26,0,0
"New Zealand","2024-11-30",0,0,24,0,1,27,0,0
"New Zealand","2024-12-01",0,0,24,0,0,27,0,0
"New Zealand","2024-12-02",0,0,24,0,0,27,0,0
"New Zealand","2024-12-03",0,0,24,0,0,27,0,0
"New Zealand","2024-12-04",0,0,24,0,0,27,0,0
"New Zealand","2024-12-05",0,3,27,0,0,27,0,0
"New Zealand","2024-12-06",0,0,27,0,0,27,0,0
"New Zealand","2024-12-07",0,0,27,0,0,27,0,0
"New Zealand","2024-12-08",0,0,27,0,0,27,0,0
"New Zealand","2024-12-09",0,0,27,0,0,27,0,0
"New Zealand","2024-12-10",0,0,27,0,0,27,0,0
"New Zealand","2024-12-11",0,0,27,0,0,27,0,0
"New Zealand","2024-12-12",0,0,27,0,0,27,0,0
"New Zealand","2024-12-13",0,0,27,0,0,27,0,0
"New Zealand","2024-12-14",0,0,27,0,0,27,0,0
"New Zealand","2024-12-15",0,0,27,0,0,27,0,0
"New Zealand","2024-12-16",0,0,27,0,0,27,0,0
"New Zealand","2024-12-17",0,0,27,0,0,27,0,0
"New Zealand","2024-12-18",0,0,27,0,0,27,0,0
"New Zealand","2024-12-19",0,0,27,0,0,27,0,0
"New Zealand","2024-12-20",0,0,27,0,0,27,0,0
"New Zealand","2024-12-21",0,0,27,0,1,28,0,0
"New Zealand","2024-12-22",0,0,27,0,0,28,0,0
"New Zealand","2024-12-23",0,0,27,0,0,28,0,0
"New Zealand","2024-12-24",0,0,27,0,0,28,0,0
"New Zealand","2024-12-25",0,0,27,0,0,28,0,0
"New Zealand","2024-12-26",0,0,27,0,0,28,0,0
"New Zealand","2024-12-27",0,0,27,0,0,28,0,0
"New Zealand","2024-12-28",0,0,27,0,0,28,0,0
"New Zealand","2024-12-29",0,0,27,0,0,28,0,0
"New Zealand","2024-12-30",0,0,27,0,0,28,0,0
"New Zealand","2024-12-31",0,0,27,0,0,28,0,0
"New Zealand","2025-01-01",0,0,27,0,0,28,0,0
"New Zealand","2025-01-02",0,0,27,0,0,28,0,0
"New Zealand","2025-01-03",0,0,27,0,0,28,0,0
"New Zealand","2025-01-04",0,0,27,0,0,28,0,0
"New Zealand","2025-01-05",0,0,27,0,0,28,0,0
"New Zealand","2025-01-06",0,0,27,0,0,28,0,0
"New Zealand","2025-01-07",0,0,27,0,0,28,0,0
"New Zealand","2025-01-08",0,0,27,0,0,28,0,0
"New Zealand","2025-01-09",0,0,27,0,0,28,0,0
"New Zealand","2025-01-10",0,0,27,0,0,28,0,0
"New Zealand","2025-01-11",0,0,27,0,0,28,0,0
"New Zealand","2025-01-12",0,0,27,0,0,28,0,0
"New Zealand","2025-01-13",0,0,27,0,0,28,0,0
"New Zealand","2025-01-14",0,0,27,0,0,28,0,0
"New Zealand","2025-01-15",0,0,27,0,0,28,0,0
"New Zealand","2025-01-16",0,0,27,0,0,28,0,0
"New Zealand","2025-01-17",0,0,27,0,0,28,0,0
"New Zealand","2025-01-18",0,0,27,0,0,28,0,0
"New Zealand","2025-01-19",0,0,27,0,0,28,0,0
"New Zealand","2025-01-20",0,0,27,0,1,29,0,0
"New Zealand","2025-01-21",0,0,27,0,0,29,0,0
"New Zealand","2025-01-22",0,0,27,0,0,29,0,0
"New Zealand","2025-01-23",0,0,27,0,0,29,0,0
"New Zealand","2025-01-24",0,0,27,0,0,29,0,0
"New Zealand","2025-01-25",0,0,27,0,0,29,0,0
"New Zealand","2025-01-26",0,0,27,0,0,29,0,0
"New Zealand","2025-01-27",0,0,27,0,0,29,0,0
"New Zealand","2025-01-28",0,0,27,0,0,29,0,0
"New Zealand","2025-01-29",0,0,27,0,0,29,0,0
"New Zealand","2025-01-30",0,0,27,0,0,29,0,0
"New Zealand","2025-01-31",0,0,27,0,0,29,0,0
"New Zealand","2025-02-01",0,0,27,0,0,29,0,0
"New Zealand","2025-02-02",0,0,27,0,0,29,0,0
"New Zealand","2025-02-03",0,0,27,0,0,29,0,0
"New Zealand","2025-02-04",0,2,29,0,0,29,0,0
"New Zealand","2025-02-05",0,0,29,0,0,29,0,0
"New Zealand","2025-02-06",0,0,29,0,0,29,0,0
"New Zealand","2025-02-07",0,0,29,0,0,29,0,0
"New Zealand","2025-02-08",0,0,29,0,0,29,0,0
"New Zealand","2025-02-09",0,0,29,0,0,29,0,0
"New Zealand","2025-02-10",0,0,29,0,0,29,0,0
"New Zealand","2025-02-11",0,0,29,0,0,29,0,0
"New Zealand","2025-02-12",0,0,29,0,0,29,0,0
"New Zealand","2025-02-13",0,0,29,0,0,29,0,0
"New Zealand","2025-02-14",0,0,29,0,0,29,0,0
"New Zealand","2025-02-15",0,0,29,0,0,29,0,0
"New Zealand","2025-02-16",0,0,29,0,0,29,0,0
"New Zealand","2025-02-17",0,0,29,0,0,29,0,0
"New Zealand","2025-02-18",0,0,29,0,0,29,0,0
"New Zealand","2025-02-19",0,0,29,0,0,29,0,0
"New Zealand","2025-02-20",0,0,29,0,0,29,0,0
"New Zealand","2025-02-21",0,0,29,0,0,29,0,0
"New Zealand","2025-02-22",0,0,29,0,0,29,0,0
"New Zealand","2025-02-23",0,0,29,0,0,29,0,0
"New Zealand","2025-02-24",0,0,29,0,0,29,0,0
"New Zealand","2025-02-25",0,0,29,0,0,29,0,0
"New Zealand","2025-02-26",0,0,29,0,0,29,0,0
"New Zealand","2025-02-27",0,0,29,0,0,29,0,0
"New Zealand","2025-02-28",0,0,29,0,0,29,0,0
"New Zealand","2025-03-01",0,0,29,0,0,29,0,0
"New Zealand","2025-03-02",0,0,29,0,0,29,0,0
"New Zealand","2025-03-03",0,0,29,0,0,29,0,0
"Nigeria","2024-01-01",0,0,0,0,0,0,0,0
"Nigeria","2024-01-02",0,0,0,0,0,0,0,0
"Nigeria","2024-01-03",0,0,0,0,0,0,0,0
"Nigeria","2024-01-04",0,0,0,0,0,0,0,0
"Nigeria","2024-01-05",0,0,0,0,0,0,0,0
"Nigeria","2024-01-06",0,0,0,0,0,0,0,0
"Nigeria","2024-01-07",0,0,0,0,0,0,0,0
"Nigeria","2024-01-08",0,0,0,0,0,0,0,0
"Nigeria","2024-01-09",0,0,0,0,0,0,0,0
"Nigeria","2024-01-10",0,0,0,0,0,0,0,0
"Nigeria","2024-01-11",0,0,0,0,0,0,0,0
"Nigeria","2024-01-12",0,0,0,0,0,0,0,0
"Nigeria","2024-01-13",0,0,0,0,0,0,0,0
"Nigeria","2024-01-14",0,0,0,0,0,0,0,0
"Nigeria","2024-01-15",0,0,0,0,0,0,0,0
"Nigeria","2024-01-16",0,0,0,0,0,0,0,0
"Nigeria","2024-01-17",0,0,0,0,0,0,0,0
"Nigeria","2024-01-18",0,0,0,0,0,0,0,0
"Nigeria","2024-01-19",0,0,0,0,0,0,0,0
"Nigeria","2024-01-20",0,0,0,0,0,0,0,0
"Nigeria","2024-01-21",0,0,0,0,0,0,0,0
"Nigeria","2024-01-22",0,0,0,0,0,0,0,0
"Nigeria","2024-01-23",0,0,0,0,0,0,0,0
"Nigeria","2024-01-24",0,0,0,0,0,0,0,0
"Nigeria","2024-01-25",0,0,0,0,0,0,0,0
"Nigeria","2024-01-26",0,0,0,0,0,0,0,0
"Nigeria","2024-01-27",0,0,0,0,0,0,0,0
"Nigeria","2024-01-28",0,2,2,0,2,2,0,0
"Nigeria","2024-01-29",0,0,2,0,0,2,0,0
"Nigeria","2024-01-30",0,0,2,0,0,2,0,0
"Nigeria","2024-01-31",0,0,2,0,0,2,0,0
"Nigeria","2024-02-01",0,0,2,0,1,3,0,0
"Nigeria","2024-02-02",0,0,2,0,0,3,0,0
"Nigeria","2024-02-03",0,0,2,0,0,3,0,0
"Nigeria","2024-02-04",0,0,2,0,0,3,0,0
"Nigeria","2024-02-05",0,0,2,0,0,3,0,0
"Nigeria","2024-02-06",0,0,2,0,0,3,0,0
"Nigeria","2024-02-07",0,0,2,0,0,3,0,0
"Nigeria","2024-02-08",0,0,2,0,1,4,0,0
"Nigeria","2024-02-09",0,0,2,0,0,4,0,0
"Nigeria","2024-02-10",0,0,2,0,0,4,0,0
"Nigeria","2024-02-11",0,2,4,0,0,4,0,0
"Nigeria","2024-02-12",0,0,4,0,0,4,0,0
"Nigeria","2024-02-13",0,0,4,0,1,5,0,0
"Nigeria","2024-02-14",0,0,4,0,0,5,0,0
"Nigeria","2024-02-15",0,0,4,0,0,5,0,0
"Nigeria","2024-02-16",0,0,4,0,0,5,0,0
"Nigeria","2024-02-17",0,0,4,0,1,6,0,0
"Nigeria","2024-02-18",0,2,6,0,0,6,0,0
"Nigeria","2024-02-19",0,0,6,0,0,6,0,0
"Nigeria","2024-02-20",0,0,6,0,0,6,0,0
"Nigeria","2024-02-21",0,0,6,0,1,7,0,0
"Nigeria","2024-02-22",0,0,6,0,0,7,0,0
"Nigeria","2024-02-23",0,0,6,0,0,7,0,0
"Nigeria","2024-02-24",0,0,6,0,0,7,0,0
"Nigeria","2024-02-25",0,0,6,0,0,7,0,0
"Nigeria","2024-02-26",0,0,6,0,1,8,0,0
"Nigeria","2024-02-27",0,0,6,0,0,8,0,0
"Nigeria","2024-02-28",0,0,6,0,0,8,0,0
"Nigeria","2024-02-29",0,0,6,0,0,8,0,0
"Nigeria","2024-03-01",0,0,6,0,0,8,0,0
"Nigeria","2024-03-02",0,0,6,0,0,8,0,0
"Nigeria","2024-03-03",0,0,6,0,1,9,0,0
"Nigeria","2024-03-04",0,0,6,0,0,9,0,0
"Nigeria","2024-03-05",0,0,6,0,0,9,0,0
"Nigeria","2024-03-06",0,0,6,0,0,9,0,0
"Nigeria","2024-03-07",0,0,6,0,0,9,0,0
"Nigeria","2024-03-08",0,0,6,0,1,10,0,0
"Nigeria","2024-03-09",0,0,6,0,0,10,0,0
"Nigeria","2024-03-10",0,4,10,0,0,10,0,0
"Nigeria","2024-03-11",0,0,10,0,0,10,0,0
"Nigeria","2024-03-12",0,0,10,0,1,11,0,0
"Nigeria","2024-03-13",0,0,10,0,0,11,0,0
"Nigeria","2024-03-14",0,0,10,0,0,11,0,0
"Nigeria","2024-03-15",0,0,10,0,0,11,0,0
"Nigeria","2024-03-16",0,0,10,0,1,12,0,0
"Nigeria","2024-03-17",0,2,12,0,0,12,0,0
"Nigeria","2024-03-18",0,0,12,0,0,12,0,0
"Nigeria","2024-03-19",0,0,12,0,1,13,0,0
"Nigeria","2024-03-20",0,0,12,0,0,13,0,0
"Nigeria","2024-03-21",0,0,12,0,1,14,0,0
"Nigeria","2024-03-22",0,0,12,0,0,14,0,0
"Nigeria","2024-03-23",0,0,12,0,1,15,0,0
"Nigeria","2024-03-24",0,0,12,0,0,15,0,0
"Nigeria","2024-03-25",0,0,12,0,0,15,0,0
"Nigeria","2024-03-26",0,0,12,0,1,16,0,0
"Nigeria","2024-03-27",0,0,12,0,0,16,0,0
"Nigeria","2024-03-28",0,0,12,0,1,17,0,0
"Nigeria","2024-03-29",0,0,12,0,0,17,0,0
"Nigeria","2024-03-30",0,0,12,0,1,18,0,0
"Nigeria","2024-03-31",0,6,18,0,0,18,0,0
"Nigeria","2024-04-01",0,0,18,0,0,18,0,0
"Nigeria","2024-04-02",0,0,18,0,0,18,0,0
"Nigeria","2024-04-03",0,0,18,0,0,18,0,0
"Nigeria","2024-04-04",0,0,18,0,1,19,0,0
"Nigeria","2024-04-05",0,0,18,0,0,19,0,0
"Nigeria","2024-04-06",0,0,18,0,0,19,0,0
"Nigeria","2024-04-07",0,1,19,0,0,19,0,0
"Nigeria","2024-04-08",0,0,19,0,0,19,0,0
"Nigeria","2024-04-09",0,0,19,0,0,19,0,0
"Nigeria","2024-04-10",0,0,19,0,0,19,0,0
"Nigeria","2024-04-11",0,0,19,0,1,20,0,0
"Nigeria","2024-04-12",0,0,19,0,0,20,0,0
"Nigeria","2024-04-13",0,0,19,0,0,20,0,0
"Nigeria","2024-04-14",0,1,20,0,0,20,0,0
"Nigeria","2024-04-15",0,0,20,0,0,20,0,0
"Nigeria","2024-04-16",0,0,20,0,0,20,0,0
"Nigeria","2024-04-17",0,0,20,0,0,20,0,0
"Nigeria","2024-04-18",0,0,20,0,1,21,0,0
"Nigeria","2024-04-19",0,0,20,0,0,21,0,0
"Nigeria","2024-04-20",0,0,20,0,0,21,0,0
"Nigeria","2024-04-21",0,0,20,0,0,21,0,0
"Nigeria","2024-04-22",0,0,20,0,0,21,0,0
"Nigeria","2024-04-23",0,0,20,0,0,21,0,0
"Nigeria","2024-04-24",0,0,20,0,0,21,0,0
"Nigeria","2024-04-25",0,0,20,0,1,22,0,0
"Nigeria","2024-04-26",0,0,20,0,0,22,0,0
"Nigeria","2024-04-27",0,0,20,0,0,22,0,0
"Nigeria","2024-04-28",0,2,22,0,0,22,0,0
"Nigeria","2024-04-29",0,0,22,0,0,22,0,0
"Nigeria","2024-04-30",0,0,22,0,1,23,0,0
"Nigeria","2024-05-01",0,0,22,0,0,23,0,0
"Nigeria","2024-05-02",0,0,22,0,0,23,0,0
"Nigeria","2024-05-03",0,0,22,0,0,23,0,0
"Nigeria","2024-05-04",0,0,22,0,1,24,0,0
"Nigeria","2024-05-05",0,2,24,0,0,24,0,0
"Nigeria","2024-05-06",0,0,24,0,0,24,0,0
"Nigeria","2024-05-07",0,0,24,0,0,24,0,0
"Nigeria","2024-05-08",0,0,24,0,0,24,0,0
"Nigeria","2024-05-09",0,0,24,0,0,24,0,0
"Nigeria","2024-05-10",0,0,24,0,0,24,0,0
"Nigeria","2024-05-11",0,0,24,0,1,25,0,0
"Nigeria","2024-05-12",0,0,24,0,0,25,0,0
"Nigeria","2024-05-13",0,0,24,0,0,25,0,0
"Nigeria","2024-05-14",0,0,24,0,0,25,0,0
"Nigeria","2024-05-15",0,0,24,0,0,25,0,0
"Nigeria","2024-05-16",0,0,24,0,0,25,0,0
"Nigeria","2024-05-17",0,0,24,0,0,25,0,0
"Nigeria","2024-05-18",0,0,24,0,0,25,0,0
"Nigeria","2024-05-19",0,0,24,0,0,25,0,0
"Nigeria","2024-05-20",0,0,24,0,0,25,0,0
"Nigeria","2024-05-21",0,0,24,0,1,26,0,0
"Nigeria","2024-05-22",0,0,24,0,0,26,0,0
"Nigeria","2024-05-23",0,0,24,0,0,26,0,0
"Nigeria","2024-05-24",0,0,24,0,0,26,0,0
"Nigeria","2024-05-25",0,0,24,0,0,26,0,0
"Nigeria","2024-05-26",0,2,26,0,0,26,0,0
"Nigeria","2024-05-27",0,0,26,0,0,26,0,0
"Nigeria","2024-05-28",0,0,26,0,0,26,0,0
"Nigeria","2024-05-29",0,0,26,0,0,26,0,0
"Nigeria","2024-05-30",0,0,26,0,1,27,0,0
"Nigeria","2024-05-31",0,0,26,0,0,27,0,0
"Nigeria","2024-06-01",0,0,26,0,0,27,0,0
"Nigeria","2024-06-02",0,1,27,0,0,27,0,0
"Nigeria","2024-06-03",0,0,27,0,0,27,0,0
"Nigeria","2024-06-04",0,0,27,0,0,27,0,0
"Nigeria","2024-06-05",0,0,27,0,0,27,0,0
"Nigeria","2024-06-06",0,0,27,0,1,28,0,0
"Nigeria","2024-06-07",0,0,27,0,0,28,0,0
"Nigeria","2024-06-08",0,0,27,0,0,28,0,0
"Nigeria","2024-06-09",0,1,28,0,0,28,0,0
"Nigeria","2024-06-10",0,0,28,0,0,28,0,0
"Nigeria","2024-06-11",0,0,28,0,1,29,0,0
"Nigeria","2024-06-12",0,0,28,0,0,29,0,0
"Nigeria","2024-06-13",0,0,28,0,0,29,0,0
"Nigeria","2024-06-14",0,0,28,0,0,29,0,0
"Nigeria","2024-06-15",0,0,28,0,1,30,0,0
"Nigeria","2024-06-16",0,2,30,0,0,30,0,0
"Nigeria","2024-06-17",0,0,30,0,0,30,0,0
"Nigeria","2024-06-18",0,0,30,0,0,30,0,0
"Nigeria","2024-06-19",0,0,30,0,0,30,0,0
"Nigeria","2024-06-20",0,0,30,0,1,31,0,0
"Nigeria","2024-06-21",0,0,30,0,0,31,0,0
"Nigeria","2024-06-22",0,0,30,0,0,31,0,0
"Nigeria","2024-06-23",0,1,31,0,0,31,0,0
"Nigeria","2024-06-24",0,0,31,0,0,31,0,0
"Nigeria","2024-06-25",0,0,31,0,1,32,0,0
"Nigeria","2024-06-26",0,0,31,0,0,32,0,0
"Nigeria","2024-06-27",0,0,31,0,1,33,0,0
"Nigeria","2024-06-28",0,0,31,0,0,33,0,0
"Nigeria","2024-06-29",0,0,31,0,1,34,0,0
"Nigeria","2024-06-30",0,3,34,0,0,34,0,0
"Nigeria","2024-07-01",0,0,34,0,0,34,0,0
"Nigeria","2024-07-02",0,0,34,0,1,35,0,0
"Nigeria","2024-07-03",0,0,34,0,0,35,0,0
"Nigeria","2024-07-04",0,0,34,0,1,36,0,0
"Nigeria","2024-07-05",0,0,34,0,0,36,0,0
"Nigeria","2024-07-06",0,0,34,0,1,37,0,0
"Nigeria","2024-07-07",0,3,37,0,0,37,0,0
"Nigeria","2024-07-08",0,0,37,0,0,37,0,0
"Nigeria","2024-07-09",0,0,37,0,0,37,0,0
"Nigeria","2024-07-10",0,0,37,0,0,37,0,0
"Nigeria","2024-07-11",0,0,37,0,0,37,0,0
"Nigeria","2024-07-12",0,0,37,0,0,37,0,0
"Nigeria","2024-07-13",0,0,37,0,0,37,0,0
"Nigeria","2024-07-14",0,0,37,0,0,37,0,0
"Nigeria","2024-07-15",0,0,37,0,1,38,0,0
"Nigeria","2024-07-16",0,0,37,0,0,38,0,0
"Nigeria","2024-07-17",0,0,37,0,0,38,0,0
"Nigeria","2024-07-18",0,0,37,0,0,38,0,0
"Nigeria","2024-07-19",0,0,37,0,0,38,0,0
"Nigeria","2024-07-20",0,0,37,0,0,38,0,0
"Nigeria","2024-07-21",0,1,38,0,0,38,0,0
"Nigeria","2024-07-22",0,0,38,0,0,38,0,0
"Nigeria","2024-07-23",0,0,38,0,0,38,0,0
"Nigeria","2024-07-24",0,0,38,0,0,38,0,0
"Nigeria","2024-07-25",0,0,38,0,0,38,0,0
"Nigeria","2024-07-26",0,0,38,0,0,38,0,0
"Nigeria","2024-07-27",0,0,38,0,1,39,0,0
"Nigeria","2024-07-28",0,0,38,0,0,39,0,0
"Nigeria","2024-07-29",0,0,38,0,0,39,0,0
"Nigeria","2024-07-30",0,0,38,0,0,39,0,0
"Nigeria","2024-07-31",0,0,38,0,0,39,0,0
"Nigeria","2024-08-01",0,0,38,0,0,39,0,0
"Nigeria","2024-08-02",0,0,38,0,0,39,0,0
"Nigeria","2024-08-03",0,0,38,0,0,39,0,0
"Nigeria","2024-08-04",0,0,38,0,0,39,0,0
"Nigeria","2024-08-05",0,0,38,0,0,39,0,0
"Nigeria","2024-08-06",0,0,38,0,1,40,0,0
"Nigeria","2024-08-07",0,0,38,0,0,40,0,0
"Nigeria","2024-08-08",0,0,38,0,0,40,0,0
"Nigeria","2024-08-09",0,0,38,0,0,40,0,0
"Nigeria","2024-08-10",0,0,38,0,0,40,0,0
"Nigeria","2024-08-11",0,2,40,0,0,40,0,0
"Nigeria","2024-08-12",0,0,40,0,0,40,0,0
"Nigeria","2024-08-13",0,0,40,0,1,41,0,0
"Nigeria","2024-08-14",0,0,40,0,0,41,0,0
"Nigeria","2024-08-15",0,0,40,0,1,42,0,0
"Nigeria","2024-08-16",0,0,40,0,0,42,0,0
"Nigeria","2024-08-17",0,0,40,0,1,43,0,0
"Nigeria","2024-08-18",802,3,43,802,0,43,802,802
"Nigeria","2024-08-19",0,0,43,802,1,44,9,811
"Nigeria","2024-08-20",0,0,43,802,2,46,10,821
"Nigeria","2024-08-21",0,0,43,802,1,47,9,830
"Nigeria","2024-08-22",0,0,43,802,2,49,9,839
"Nigeria","2024-08-23",0,0,43,802,1,50,9,848
"Nigeria","2024-08-24",0,0,43,802,2,52,10,858
"Nigeria","2024-08-25",65,10,53,867,1,53,9,867
"Nigeria","2024-08-26",0,0,53,867,1,54,8,875
"Nigeria","2024-08-27",0,0,53,867,1,55,7,882
"Nigeria","2024-08-28",0,0,53,867,1,56,8,890
"Nigeria","2024-08-29",0,0,53,867,2,58,7,897
"Nigeria","2024-08-30",0,0,53,867,1,59,8,905
"Nigeria","2024-08-31",0,0,53,867,1,60,7,912
"Nigeria","2024-09-01",53,8,61,920,1,61,8,920
"Nigeria","2024-09-02",0,0,61,920,1,62,10,930
"Nigeria","2024-09-03",0,0,61,920,2,64,11,941
"Nigeria","2024-09-04",0,0,61,920,1,65,10,951
"Nigeria","2024-09-05",0,0,61,920,1,66,10,961
"Nigeria","2024-09-06",0,0,61,920,1,67,10,971
"Nigeria","2024-09-07",0,0,61,920,2,69,11,982
"Nigeria","2024-09-08",72,9,70,992,1,70,10,992
"Nigeria","2024-09-09",0,0,70,992,1,71,9,1001
"Nigeria","2024-09-10",0,0,70,992,1,72,9,1010
"Nigeria","2024-09-11",0,0,70,992,1,73,9,1019
"Nigeria","2024-09-12",0,0,70,992,0,73,9,1028
"Nigeria","2024-09-13",0,0,70,992,1,74,9,1037
"Nigeria","2024-09-14",0,0,70,992,1,75,9,1046
"Nigeria","2024-09-15",63,6,76,1055,1,76,9,1055
"Nigeria","2024-09-16",0,0,76,1055,1,77,10,1065
"Nigeria","2024-09-17",0,0,76,1055,0,77,11,1076
"Nigeria","2024-09-18",0,0,76,1055,1,78,10,1086
"Nigeria","2024-09-19",0,0,76,1055,1,79,10,1096
"Nigeria","2024-09-20",0,0,76,1055,1,80,10,1106
"Nigeria","2024-09-21",0,0,76,1055,0,80,11,1117
"Nigeria","2024-09-22",72,5,81,1127,1,81,10,1127
"Nigeria","2024-09-23",0,0,81,1127,1,82,8,1135
"Nigeria","2024-09-24",0,0,81,1127,2,84,7,1142
"Nigeria","2024-09-25",0,0,81,1127,1,85,8,1150
"Nigeria","2024-09-26",0,0,81,1127,2,87,8,1158
"Nigeria","2024-09-27",0,0,81,1127,1,88,8,1166
"Nigeria","2024-09-28",0,0,81,1127,2,90,7,1173
"Nigeria","2024-09-29",54,10,91,1181,1,91,8,1181
"Nigeria","2024-09-30",0,0,91,1181,1,92,8,1189
"Nigeria","2024-10-01",0,0,91,1181,1,93,8,1197
"Nigeria","2024-10-02",0,0,91,1181,1,94,8,1205
"Nigeria","2024-10-03",0,0,91,1181,1,95,8,1213
"Nigeria","2024-10-04",0,0,91,1181,1,96,8,1221
"Nigeria","2024-10-05",0,0,91,1181,1,97,8,1229
"Nigeria","2024-10-06",56,7,98,1237,1,98,8,1237
"Nigeria","2024-10-07",0,0,98,1237,1,99,2,1239
"Nigeria","2024-10-08",0,0,98,1237,2,101,3,1242
"Nigeria","2024-10-09",0,0,98,1237,1,102,2,1244
"Nigeria","2024-10-10",0,0,98,1237,1,103,3,1247
"Nigeria","2024-10-11",0,0,98,1237,1,104,2,1249
"Nigeria","2024-10-12",0,0,98,1237,2,106,2,1251
"Nigeria","2024-10-13",0,9,107,1237,1,107,3,1254
"Nigeria","2024-10-14",0,0,107,1237,1,108,2,1256
"Nigeria","2024-10-15",0,0,107,1237,1,109,2,1258
"Nigeria","2024-10-16",0,0,107,1237,1,110,3,1261
"Nigeria","2024-10-17",0,0,107,1237,2,112,2,1263
"Nigeria","2024-10-18",0,0,107,1237,1,113,3,1266
"Nigeria","2024-10-19",0,0,107,1237,1,114,2,1268
"Nigeria","2024-10-20",0,8,115,1237,1,115,2,1270
"Nigeria","2024-10-21",0,0,115,1237,1,116,3,1273
"Nigeria","2024-10-22",0,0,115,1237,2,118,2,1275
"Nigeria","2024-10-23",0,0,115,1237,1,119,2,1277
"Nigeria","2024-10-24",0,0,115,1237,2,121,3,1280
"Nigeria","2024-10-25",0,0,115,1237,1,122,2,1282
"Nigeria","2024-10-26",0,0,115,1237,2,124,3,1285
"Nigeria","2024-10-27",50,10,125,1287,1,125,2,1287
"Nigeria","2024-10-28",0,0,125,1287,1,126,5,1292
"Nigeria","2024-10-29",0,0,125,1287,1,127,6,1298
"Nigeria","2024-10-30",0,0,125,1287,1,128,5,1303
"Nigeria","2024-10-31",0,0,125,1287,0,128,5,1308
"Nigeria","2024-11-01",0,0,125,1287,1,129,5,1313
"Nigeria","2024-11-02",0,0,125,1287,1,130,6,1319
"Nigeria","2024-11-03",37,6,131,1324,1,131,5,1324
"Nigeria","2024-11-04",0,0,131,1324,2,133,0,1324
"Nigeria","2024-11-05",0,0,131,1324,2,135,0,1324
"Nigeria","2024-11-06",0,0,131,1324,2,137,0,1324
"Nigeria","2024-11-07",0,0,131,1324,1,138,0,1324
"Nigeria","2024-11-08",0,0,131,1324,2,140,0,1324
"Nigeria","2024-11-09",0,0,131,1324,2,142,0,1324
"Nigeria","2024-11-10",0,13,144,1324,2,144,0,1324
"Nigeria","2024-11-11",0,0,144,1324,1,145,0,1324
"Nigeria","2024-11-12",0,0,144,1324,1,146,0,1324
"Nigeria","2024-11-13",0,0,144,1324,1,147,0,1324
"Nigeria","2024-11-14",0,0,144,1324,0,147,0,1324
"Nigeria","2024-11-15",0,0,144,1324,1,148,0,1324
"Nigeria","2024-11-16",0,0,144,1324,1,149,0,1324
"Nigeria","2024-11-17",0,6,150,1324,1,150,0,1324
"Nigeria","2024-11-18",0,0,150,1324,0,150,0,1324
"Nigeria","2024-11-19",0,0,150,1324,1,151,0,1324
"Nigeria","2024-11-20",0,0,150,1324,0,151,0,1324
"Nigeria","2024-11-21",0,0,150,1324,1,152,0,1324
"Nigeria","2024-11-22",0,0,150,1324,0,152,0,1324
"Nigeria","2024-11-23",0,0,150,1324,1,153,0,1324
"Nigeria","2024-11-24",0,3,153,1324,0,153,0,1324
"Nigeria","2024-11-25",0,0,153,1324,1,154,0,1324
"Nigeria","2024-11-26",0,0,153,1324,1,155,0,1324
"Nigeria","2024-11-27",0,0,153,1324,1,156,0,1324
"Nigeria","2024-11-28",0,0,153,1324,1,157,0,1324
"Nigeria","2024-11-29",0,0,153,1324,1,158,0,1324
"Nigeria","2024-11-30",0,0,153,1324,1,159,0,1324
"Nigeria","2024-12-01",0,7,160,1324,1,160,0,1324
"Nigeria","2024-12-02",0,0,160,1324,2,162,0,1324
"Nigeria","2024-12-03",0,0,160,1324,2,164,0,1324
"Nigeria","2024-12-04",0,0,160,1324,2,166,0,1324
"Nigeria","2024-12-05",0,0,160,1324,3,169,0,1324
"Nigeria","2024-12-06",0,0,160,1324,2,171,0,1324
"Nigeria","2024-12-07",0,0,160,1324,2,173,0,1324
"Nigeria","2024-12-08",0,15,175,1324,2,175,0,1324
"Nigeria","2024-12-09",0,0,175,1324,1,176,0,1324
"Nigeria","2024-12-10",0,0,175,1324,1,177,0,1324
"Nigeria","2024-12-11",0,0,175,1324,1,178,0,1324
"Nigeria","2024-12-12",0,0,175,1324,0,178,0,1324
"Nigeria","2024-12-13",0,0,175,1324,1,179,0,1324
"Nigeria","2024-12-14",0,0,175,1324,1,180,0,1324
"Nigeria","2024-12-15",0,6,181,1324,1,181,0,1324
"Nigeria","2024-12-16",0,0,181,1324,1,182,0,1324
"Nigeria","2024-12-17",0,0,181,1324,0,182,0,1324
"Nigeria","2024-12-18",0,0,181,1324,1,183,0,1324
"Nigeria","2024-12-19",0,0,181,1324,0,183,0,1324
"Nigeria","2024-12-20",0,0,181,1324,1,184,0,1324
"Nigeria","2024-12-21",0,0,181,1324,0,184,0,1324
"Nigeria","2024-12-22",0,4,185,1324,1,185,0,1324
"Nigeria","2024-12-23",0,0,185,1324,1,186,0,1324
"Nigeria","2024-12-24",0,0,185,1324,0,186,0,1324
"Nigeria","2024-12-25",0,0,185,1324,1,187,0,1324
"Nigeria","2024-12-26",0,0,185,1324,0,187,0,1324
"Nigeria","2024-12-27",0,0,185,1324,1,188,0,1324
"Nigeria","2024-12-28",0,0,185,1324,0,188,0,1324
"Nigeria","2024-12-29",0,4,189,1324,1,189,0,1324
"Nigeria","2024-12-30",0,0,189,1324,0,189,0,1324
"Nigeria","2024-12-31",0,0,189,1324,1,190,0,1324
"Nigeria","2025-01-01",0,0,189,1324,0,190,0,1324
"Nigeria","2025-01-02",0,0,189,1324,0,190,0,1324
"Nigeria","2025-01-03",0,0,189,1324,0,190,0,1324
"Nigeria","2025-01-04",0,0,189,1324,1,191,0,1324
"Nigeria","2025-01-05",0,2,191,1324,0,191,0,1324
"Nigeria","2025-01-06",0,0,191,1324,1,192,0,1324
"Nigeria","2025-01-07",0,0,191,1324,0,192,0,1324
"Nigeria","2025-01-08",0,0,191,1324,1,193,0,1324
"Nigeria","2025-01-09",0,0,191,1324,0,193,0,1324
"Nigeria","2025-01-10",0,0,191,1324,1,194,0,1324
"Nigeria","2025-01-11",0,0,191,1324,0,194,0,1324
"Nigeria","2025-01-12",0,4,195,1324,1,195,0,1324
"Nigeria","2025-01-13",0,0,195,1324,1,196,0,1324
"Nigeria","2025-01-14",0,0,195,1324,1,197,0,1324
"Nigeria","2025-01-15",0,0,195,1324,1,198,0,1324
"Nigeria","2025-01-16",0,0,195,1324,1,199,0,1324
"Nigeria","2025-01-17",0,0,195,1324,1,200,0,1324
"Nigeria","2025-01-18",0,0,195,1324,1,201,0,1324
"Nigeria","2025-01-19",0,7,202,1324,1,202,0,1324
"Nigeria","2025-01-20",0,0,202,1324,1,203,0,1324
"Nigeria","2025-01-21",0,0,202,1324,0,203,0,1324
"Nigeria","2025-01-22",0,0,202,1324,1,204,0,1324
"Nigeria","2025-01-23",0,0,202,1324,1,205,0,1324
"Nigeria","2025-01-24",0,0,202,1324,1,206,0,1324
"Nigeria","2025-01-25",0,0,202,1324,0,206,0,1324
"Nigeria","2025-01-26",0,5,207,1324,1,207,0,1324
"Nigeria","2025-01-27",0,0,207,1324,1,208,0,1324
"Nigeria","2025-01-28",0,0,207,1324,2,210,0,1324
"Nigeria","2025-01-29",0,0,207,1324,1,211,0,1324
"Nigeria","2025-01-30",0,0,207,1324,2,213,0,1324
"Nigeria","2025-01-31",0,0,207,1324,1,214,0,1324
"Nigeria","2025-02-01",0,0,207,1324,2,216,0,1324
"Nigeria","2025-02-02",0,10,217,1324,1,217,0,1324
"Nigeria","2025-02-03",0,0,217,1324,4,221,0,1324
"Nigeria","2025-02-04",0,0,217,1324,3,224,0,1324
"Nigeria","2025-02-05",0,0,217,1324,4,228,0,1324
"Nigeria","2025-02-06",0,0,217,1324,3,231,0,1324
"Nigeria","2025-02-07",0,0,217,1324,4,235,0,1324
"Nigeria","2025-02-08",0,0,217,1324,3,238,0,1324
"Nigeria","2025-02-09",0,25,242,1324,4,242,0,1324
"Nigeria","2025-02-10",0,0,242,1324,0,242,0,1324
"Nigeria","2025-02-11",0,0,242,1324,0,242,0,1324
"Nigeria","2025-02-12",0,0,242,1324,0,242,0,1324
"Nigeria","2025-02-13",0,0,242,1324,0,242,0,1324
"Nigeria","2025-02-14",0,0,242,1324,0,242,0,1324
"Nigeria","2025-02-15",0,0,242,1324,0,242,0,1324
"Nigeria","2025-02-16",0,0,242,1324,0,242,0,1324
"Nigeria","2025-02-17",0,0,242,1324,0,242,0,1324
"Nigeria","2025-02-18",0,0,242,1324,0,242,0,1324
"Nigeria","2025-02-19",0,0,242,1324,0,242,0,1324
"Nigeria","2025-02-20",0,0,242,1324,0,242,0,1324
"Nigeria","2025-02-21",0,0,242,1324,0,242,0,1324
"Nigeria","2025-02-22",0,0,242,1324,0,242,0,1324
"Nigeria","2025-02-23",0,0,242,1324,0,242,0,1324
"Nigeria","2025-02-24",0,0,242,1324,0,242,0,1324
"Nigeria","2025-02-25",0,0,242,1324,0,242,0,1324
"Nigeria","2025-02-26",0,0,242,1324,0,242,0,1324
"Nigeria","2025-02-27",0,0,242,1324,0,242,0,1324
"Nigeria","2025-02-28",0,0,242,1324,0,242,0,1324
"Nigeria","2025-03-01",0,0,242,1324,0,242,0,1324
"Nigeria","2025-03-02",0,0,242,1324,0,242,0,1324
"Nigeria","2025-03-03",0,0,242,1324,0,242,0,1324
"North America","2024-01-01",0,0,0,0,0,0,0,0
"North America","2024-01-02",0,52,52,0,52,52,0,0
"North America","2024-01-03",0,0,52,0,9,61,0,0
"North America","2024-01-04",0,0,52,0,8,69,0,0
"North America","2024-01-05",0,0,52,0,9,78,0,0
"North America","2024-01-06",0,0,52,0,8,86,0,0
"North America","2024-01-07",0,0,52,0,9,95,0,0
"North America","2024-01-08",0,0,52,0,8,103,0,0
"North America","2024-01-09",0,60,112,0,9,112,0,0
"North America","2024-01-10",0,0,112,0,11,123,0,0
"North America","2024-01-11",0,0,112,0,11,134,0,0
"North America","2024-01-12",0,0,112,0,11,145,0,0
"North America","2024-01-13",0,0,112,0,11,156,0,0
"North America","2024-01-14",0,0,112,0,11,167,0,0
"North America","2024-01-15",0,0,112,0,11,178,0,0
"North America","2024-01-16",0,77,189,0,11,189,0,0
"North America","2024-01-17",0,0,189,0,9,198,0,0
"North America","2024-01-18",0,0,189,0,9,207,0,0
"North America","2024-01-19",0,0,189,0,9,216,0,0
"North America","2024-01-20",0,0,189,0,8,224,0,0
"North America","2024-01-21",0,0,189,0,9,233,0,0
"North America","2024-01-22",0,0,189,0,9,242,0,0
"North America","2024-01-23",0,62,251,0,9,251,0,0
"North America","2024-01-24",0,0,251,0,14,265,0,0
"North America","2024-01-25",0,0,251,0,14,279,0,0
"North America","2024-01-26",0,0,251,0,14,293,0,0
"North America","2024-01-27",0,0,251,0,15,308,0,0
"North America","2024-01-28",0,0,251,0,14,322,0,0
"North America","2024-01-29",0,0,251,0,14,336,0,0
"North America","2024-01-30",0,99,350,0,14,350,0,0
"North America","2024-01-31",0,0,350,0,10,360,0,0
"North America","2024-02-01",0,0,350,0,10,370,0,0
"North America","2024-02-02",0,0,350,0,10,380,0,0
"North America","2024-02-03",0,0,350,0,10,390,0,0
"North America","2024-02-04",0,0,350,0,10,400,0,0
"North America","2024-02-05",0,0,350,0,10,410,0,0
"North America","2024-02-06",0,70,420,0,10,420,0,0
"North America","2024-02-07",0,0,420,0,11,431,0,0
"North America","2024-02-08",0,0,420,0,11,442,0,0
"North America","2024-02-09",0,0,420,0,11,453,0,0
"North America","2024-02-10",0,0,420,0,10,463,0,0
"North America","2024-02-11",0,0,420,0,11,474,0,0
"North America","2024-02-12",0,0,420,0,11,485,0,0
"North America","2024-02-13",0,76,496,0,11,496,0,0
"North America","2024-02-14",0,0,496,0,10,506,0,0
"North America","2024-02-15",0,0,496,0,10,516,0,0
"North America","2024-02-16",0,0,496,0,10,526,0,0
"North America","2024-02-17",0,0,496,0,11,537,0,0
"North America","2024-02-18",0,0,496,0,10,547,0,0
"North America","2024-02-19",0,0,496,0,10,557,0,0
"North America","2024-02-20",0,71,567,0,10,567,0,0
"North America","2024-02-21",0,0,567,0,12,579,0,0
"North America","2024-02-22",0,0,567,0,12,591,0,0
"North America","2024-02-23",0,0,567,0,12,603,0,0
"North America","2024-02-24",0,0,567,0,13,616,0,0
"North America","2024-02-25",0,0,567,0,12,628,0,0
"North America","2024-02-26",0,0,567,0,12,640,0,0
"North America","2024-02-27",0,85,652,0,12,652,0,0
"North America","2024-02-28",0,0,652,0,12,664,0,0
"North America","2024-02-29",0,0,652,0,12,676,0,0
"North America","2024-03-01",0,0,652,0,12,688,0,0
"North America","2024-03-02",0,0,652,0,11,699,0,0
"North America","2024-03-03",0,0,652,0,12,711,0,0
"North America","2024-03-04",0,0,652,0,12,723,0,0
"North America","2024-03-05",0,83,735,0,12,735,0,0
"North America","2024-03-06",0,0,735,0,12,747,0,0
"North America","2024-03-07",0,0,735,0,13,760,0,0
"North America","2024-03-08",0,0,735,0,12,772,0,0
"North America","2024-03-09",0,0,735,0,12,784,0,0
"North America","2024-03-10",0,0,735,0,12,796,0,0
"North America","2024-03-11",0,0,735,0,13,809,0,0
"North America","2024-03-12",0,86,821,0,12,821,0,0
"North America","2024-03-13",0,0,821,0,9,830,0,0
"North America","2024-03-14",0,0,821,0,8,838,0,0
"North America","2024-03-15",0,0,821,0,9,847,0,0
"North America","2024-03-16",0,0,821,0,9,856,0,0
"North America","2024-03-17",0,0,821,0,9,865,0,0
"North America","2024-03-18",0,0,821,0,8,873,0,0
"North America","2024-03-19",0,61,882,0,9,882,0,0
"North America","2024-03-20",0,0,882,0,10,892,0,0
"North America","2024-03-21",0,0,882,0,9,901,0,0
"North America","2024-03-22",0,0,882,0,10,911,0,0
"North America","2024-03-23",0,0,882,0,9,920,0,0
"North America","2024-03-24",0,0,882,0,10,930,0,0
"North America","2024-03-25",0,0,882,0,9,939,0,0
"North America","2024-03-26",0,67,949,0,10,949,0,0
"North America","2024-03-27",0,0,949,0,8,957,0,0
"North America","2024-03-28",0,0,949,0,8,965,0,0
"North America","2024-03-29",0,0,949,0,8,973,0,0
"North America","2024-03-30",0,0,949,0,7,980,0,0
"North America","2024-03-31",0,0,949,0,8,988,0,0
"North America","2024-04-01",0,0,949,0,8,996,0,0
"North America","2024-04-02",0,55,1004,0,8,1004,0,0
"North America","2024-04-03",0,0,1004,0,11,1015,0,0
"North America","2024-04-04",0,0,1004,0,10,1025,0,0
"North America","2024-04-05",0,0,1004,0,11,1036,0,0
"North America","2024-04-06",0,0,1004,0,10,1046,0,0
"North America","2024-04-07",0,0,1004,0,11,1057,0,0
"North America","2024-04-08",0,0,1004,0,10,1067,0,0
"North America","2024-04-09",0,74,1078,0,11,1078,0,0
"North America","2024-04-10",0,0,1078,0,12,1090,0,0
"North America","2024-04-11",0,0,1078,0,12,1102,0,0
"North America","2024-04-12",0,0,1078,0,12,1114,0,0
"North America","2024-04-13",0,0,1078,0,11,1125,0,0
"North America","2024-04-14",0,0,1078,0,12,1137,0,0
"North America","2024-04-15",0,0,1078,0,12,1149,0,0
"North America","2024-04-16",0,83,1161,0,12,1161,0,0
"North America","2024-04-17",0,0,1161,0,12,1173,0,0
"North America","2024-04-18",0,0,1161,0,11,1184,0,0
"North America","2024-04-19",0,0,1161,0,12,1196,0,0
"North America","2024-04-20",0,0,1161,0,12,1208,0,0
"North America","2024-04-21",0,0,1161,0,12,1220,0,0
"North America","2024-04-22",0,0,1161,0,11,1231,0,0
"North America","2024-04-23",0,82,1243,0,12,1243,0,0
"North America","2024-04-24",0,0,1243,0,8,1251,0,0
"North America","2024-04-25",0,0,1243,0,9,1260,0,0
"North America","2024-04-26",0,0,1243,0,8,1268,0,0
"North America","2024-04-27",0,0,1243,0,9,1277,0,0
"North America","2024-04-28",0,0,1243,0,8,1285,0,0
"North America","2024-04-29",0,0,1243,0,9,1294,0,0
"North America","2024-04-30",0,59,1302,0,8,1302,0,0
"North America","2024-05-01",0,0,1302,0,9,1311,0,0
"North America","2024-05-02",0,0,1302,0,8,1319,0,0
"North America","2024-05-03",0,0,1302,0,9,1328,0,0
"North America","2024-05-04",0,0,1302,0,9,1337,0,0
"North America","2024-05-05",0,0,1302,0,9,1346,0,0
"North America","2024-05-06",0,0,1302,0,8,1354,0,0
"North America","2024-05-07",0,61,1363,0,9,1363,0,0
"North America","2024-05-08",0,0,1363,0,9,1372,0,0
"North America","2024-05-09",0,0,1363,0,8,1380,0,0
"North America","2024-05-10",0,0,1363,0,9,1389,0,0
"North America","2024-05-11",0,0,1363,0,8,1397,0,0
"North America","2024-05-12",0,0,1363,0,9,1406,0,0
"North America","2024-05-13",0,0,1363,0,8,1414,0,0
"North America","2024-05-14",0,60,1423,0,9,1423,0,0
"North America","2024-05-15",0,0,1423,0,9,1432,0,0
"North America","2024-05-16",0,0,1423,0,10,1442,0,0
"North America","2024-05-17",0,0,1423,0,9,1451,0,0
"North America","2024-05-18",0,0,1423,0,9,1460,0,0
"North America","2024-05-19",0,0,1423,0,9,1469,0,0
"North America","2024-05-20",0,0,1423,0,10,1479,0,0
"North America","2024-05-21",0,65,1488,0,9,1488,0,0
"North America","2024-05-22",0,0,1488,0,9,1497,0,0
"North America","2024-05-23",0,0,1488,0,10,1507,0,0
"North America","2024-05-24",0,0,1488,0,9,1516,0,0
"North America","2024-05-25",0,0,1488,0,10,1526,0,0
"North America","2024-05-26",0,0,1488,0,9,1535,0,0
"North America","2024-05-27",0,0,1488,0,10,1545,0,0
"North America","2024-05-28",0,66,1554,0,9,1554,0,0
"North America","2024-05-29",0,0,1554,0,11,1565,0,0
"North America","2024-05-30",0,0,1554,0,12,1577,0,0
"North America","2024-05-31",0,0,1554,0,11,1588,0,0
"North America","2024-06-01",0,0,1554,0,11,1599,0,0
"North America","2024-06-02",0,0,1554,0,11,1610,0,0
"North America","2024-06-03",0,0,1554,0,12,1622,0,0
"North America","2024-06-04",0,79,1633,0,11,1633,0,0
"North America","2024-06-05",0,0,1633,0,12,1645,0,0
"North America","2024-06-06",0,0,1633,0,12,1657,0,0
"North America","2024-06-07",0,0,1633,0,12,1669,0,0
"North America","2024-06-08",0,0,1633,0,12,1681,0,0
"North America","2024-06-09",0,0,1633,0,12,1693,0,0
"North America","2024-06-10",0,0,1633,0,12,1705,0,0
"North America","2024-06-11",0,84,1717,0,12,1717,0,0
"North America","2024-06-12",0,0,1717,0,8,1725,0,0
"North America","2024-06-13",0,0,1717,0,8,1733,0,0
"North America","2024-06-14",0,0,1717,0,8,1741,0,0
"North America","2024-06-15",0,0,1717,0,7,1748,0,0
"North America","2024-06-16",0,0,1717,0,8,1756,0,0
"North America","2024-06-17",0,0,1717,0,8,1764,0,0
"North America","2024-06-18",0,55,1772,0,8,1772,0,0
"North America","2024-06-19",0,0,1772,0,9,1781,0,0
"North America","2024-06-20",0,0,1772,0,10,1791,0,0
"North America","2024-06-21",0,0,1772,0,9,1800,0,0
"North America","2024-06-22",0,0,1772,0,9,1809,0,0
"North America","2024-06-23",0,0,1772,0,9,1818,0,0
"North America","2024-06-24",0,0,1772,0,10,1828,0,0
"North America","2024-06-25",0,65,1837,0,9,1837,0,0
"North America","2024-06-26",0,0,1837,0,10,1847,0,0
"North America","2024-06-27",0,0,1837,0,9,1856,0,0
"North America","2024-06-28",0,0,1837,0,10,1866,0,0
"North America","2024-06-29",0,0,1837,0,10,1876,0,0
"North America","2024-06-30",0,0,1837,0,10,1886,0,0
"North America","2024-07-01",0,0,1837,0,9,1895,0,0
"North America","2024-07-02",0,68,1905,0,10,1905,0,0
"North America","2024-07-03",0,0,1905,0,11,1916,0,0
"North America","2024-07-04",0,0,1905,0,11,1927,0,0
"North America","2024-07-05",0,0,1905,0,11,1938,0,0
"North America","2024-07-06",0,0,1905,0,11,1949,0,0
"North America","2024-07-07",0,0,1905,0,11,1960,0,0
"North America","2024-07-08",0,0,1905,0,11,1971,0,0
"North America","2024-07-09",0,77,1982,0,11,1982,0,0
"North America","2024-07-10",0,0,1982,0,11,1993,0,0
"North America","2024-07-11",0,0,1982,0,12,2005,0,0
"North America","2024-07-12",0,0,1982,0,11,2016,0,0
"North America","2024-07-13",0,0,1982,0,12,2028,0,0
"North America","2024-07-14",0,0,1982,0,11,2039,0,0
"North America","2024-07-15",0,0,1982,0,12,2051,0,0
"North America","2024-07-16",0,80,2062,0,11,2062,0,0
"North America","2024-07-17",0,0,2062,0,9,2071,0,0
"North America","2024-07-18",0,0,2062,0,10,2081,0,0
"North America","2024-07-19",0,0,2062,0,9,2090,0,0
"North America","2024-07-20",0,0,2062,0,9,2099,0,0
"North America","2024-07-21",0,0,2062,0,9,2108,0,0
"North America","2024-07-22",0,0,2062,0,10,2118,0,0
"North America","2024-07-23",0,65,2127,0,9,2127,0,0
"North America","2024-07-24",0,0,2127,0,11,2138,0,0
"North America","2024-07-25",0,0,2127,0,11,2149,0,0
"North America","2024-07-26",0,0,2127,0,11,2160,0,0
"North America","2024-07-27",0,0,2127,0,11,2171,0,0
"North America","2024-07-28",0,0,2127,0,11,2182,0,0
"North America","2024-07-29",0,0,2127,0,11,2193,0,0
"North America","2024-07-30",0,77,2204,0,11,2204,0,0
"North America","2024-07-31",0,0,2204,0,12,2216,0,0
"North America","2024-08-01",0,0,2204,0,12,2228,0,0
"North America","2024-08-02",0,0,2204,0,12,2240,0,0
"North America","2024-08-03",0,0,2204,0,11,2251,0,0
"North America","2024-08-04",0,0,2204,0,12,2263,0,0
"North America","2024-08-05",0,0,2204,0,12,2275,0,0
"North America","2024-08-06",0,83,2287,0,12,2287,0,0
"North America","2024-08-07",0,0,2287,0,13,2300,0,0
"North America","2024-08-08",0,0,2287,0,14,2314,0,0
"North America","2024-08-09",0,0,2287,0,13,2327,0,0
"North America","2024-08-10",0,0,2287,0,13,2340,0,0
"North America","2024-08-11",0,0,2287,0,13,2353,0,0
"North America","2024-08-12",0,0,2287,0,14,2367,0,0
"North America","2024-08-13",0,93,2380,0,13,2380,0,0
"North America","2024-08-14",0,0,2380,0,11,2391,0,0
"North America","2024-08-15",0,0,2380,0,11,2402,0,0
"North America","2024-08-16",0,0,2380,0,11,2413,0,0
"North America","2024-08-17",0,0,2380,0,11,2424,0,0
"North America","2024-08-18",0,0,2380,0,11,2435,0,0
"North America","2024-08-19",0,0,2380,0,11,2446,0,0
"North America","2024-08-20",0,77,2457,0,11,2457,0,0
"North America","2024-08-21",0,0,2457,0,13,2470,0,0
"North America","2024-08-22",0,0,2457,0,13,2483,0,0
"North America","2024-08-23",0,0,2457,0,13,2496,0,0
"North America","2024-08-24",0,0,2457,0,14,2510,0,0
"North America","2024-08-25",0,0,2457,0,13,2523,0,0
"North America","2024-08-26",0,0,2457,0,13,2536,0,0
"North America","2024-08-27",0,92,2549,0,13,2549,0,0
"North America","2024-08-28",0,0,2549,0,12,2561,0,0
"North America","2024-08-29",0,0,2549,0,13,2574,0,0
"North America","2024-08-30",0,0,2549,0,12,2586,0,0
"North America","2024-08-31",0,0,2549,0,13,2599,0,0
"North America","2024-09-01",0,0,2549,0,12,2611,0,0
"North America","2024-09-02",0,0,2549,0,13,2624,0,0
"North America","2024-09-03",0,87,2636,0,12,2636,0,0
"North America","2024-09-04",0,0,2636,0,13,2649,0,0
"North America","2024-09-05",0,0,2636,0,13,2662,0,0
"North America","2024-09-06",0,0,2636,0,13,2675,0,0
"North America","2024-09-07",0,0,2636,0,14,2689,0,0
"North America","2024-09-08",0,0,2636,0,13,2702,0,0
"North America","2024-09-09",0,0,2636,0,13,2715,0,0
"North America","2024-09-10",0,92,2728,0,13,2728,0,0
"North America","2024-09-11",0,0,2728,0,10,2738,0,0
"North America","2024-09-12",0,0,2728,0,9,2747,0,0
"North America","2024-09-13",0,0,2728,0,10,2757,0,0
"North America","2024-09-14",0,0,2728,0,9,2766,0,0
"North America","2024-09-15",0,0,2728,0,10,2776,0,0
"North America","2024-09-16",0,0,2728,0,9,2785,0,0
"North America","2024-09-17",0,67,2795,0,10,2795,0,0
"North America","2024-09-18",0,0,2795,0,11,2806,0,0
"North America","2024-09-19",0,0,2795,0,12,2818,0,0
"North America","2024-09-20",0,0,2795,0,11,2829,0,0
"North America","2024-09-21",0,0,2795,0,11,2840,0,0
"North America","2024-09-22",0,0,2795,0,11,2851,0,0
"North America","2024-09-23",0,0,2795,0,12,2863,0,0
"North America","2024-09-24",0,79,2874,0,11,2874,0,0
"North America","2024-09-25",0,0,2874,0,10,2884,0,0
"North America","2024-09-26",0,0,2874,0,11,2895,0,0
"North America","2024-09-27",0,0,2874,0,10,2905,0,0
"North America","2024-09-28",0,0,2874,0,11,2916,0,0
"North America","2024-09-29",0,0,2874,0,10,2926,0,0
"North America","2024-09-30",0,0,2874,0,11,2937,0,0
"North America","2024-10-01",0,73,2947,0,10,2947,0,0
"North America","2024-10-02",0,0,2947,0,7,2954,0,0
"North America","2024-10-03",0,0,2947,0,8,2962,0,0
"North America","2024-10-04",0,0,2947,0,7,2969,0,0
"North America","2024-10-05",0,0,2947,0,7,2976,0,0
"North America","2024-10-06",0,0,2947,0,7,2983,0,0
"North America","2024-10-07",0,0,2947,0,8,2991,0,0
"North America","2024-10-08",0,51,2998,0,7,2998,0,0
"North America","2024-10-09",0,0,2998,0,6,3004,0,0
"North America","2024-10-10",0,0,2998,0,6,3010,0,0
"North America","2024-10-11",0,0,2998,0,6,3016,0,0
"North America","2024-10-12",0,0,2998,0,5,3021,0,0
"North America","2024-10-13",0,0,2998,0,6,3027,0,0
"North America","2024-10-14",0,0,2998,0,6,3033,0,0
"North America","2024-10-15",0,41,3039,0,6,3039,0,0
"North America","2024-10-16",0,0,3039,0,8,3047,0,0
"North America","2024-10-17",0,0,3039,0,9,3056,0,0
"North America","2024-10-18",0,0,3039,0,8,3064,0,0
"North America","2024-10-19",0,0,3039,0,9,3073,0,0
"North America","2024-10-20",0,0,3039,0,8,3081,0,0
"North America","2024-10-21",0,0,3039,0,9,3090,0,0
"North America","2024-10-22",0,59,3098,0,8,3098,0,0
"North America","2024-10-23",0,0,3098,0,8,3106,0,0
"North America","2024-10-24",0,0,3098,0,7,3113,0,0
"North America","2024-10-25",0,0,3098,0,8,3121,0,0
"North America","2024-10-26",0,0,3098,0,7,3128,0,0
"North America","2024-10-27",0,0,3098,0,8,3136,0,0
"North America","2024-10-28",0,0,3098,0,7,3143,0,0
"North America","2024-10-29",0,53,3151,0,8,3151,0,0
"North America","2024-10-30",0,0,3151,0,7,3158,0,0
"North America","2024-10-31",0,0,3151,0,8,3166,0,0
"North America","2024-11-01",0,0,3151,0,7,3173,0,0
"North America","2024-11-02",0,0,3151,0,7,3180,0,0
"North America","2024-11-03",0,0,3151,0,7,3187,0,0
"North America","2024-11-04",0,0,3151,0,8,3195,0,0
"North America","2024-11-05",0,51,3202,0,7,3202,0,0
"North America","2024-11-06",0,0,3202,0,7,3209,0,0
"North America","2024-11-07",0,0,3202,0,7,3216,0,0
"North America","2024-11-08",0,0,3202,0,7,3223,0,0
"North America","2024-11-09",0,0,3202,0,7,3230,0,0
"North America","2024-11-10",0,0,3202,0,7,3237,0,0
"North America","2024-11-11",0,0,3202,0,7,3244,0,0
"North America","2024-11-12",0,49,3251,0,7,3251,0,0
"North America","2024-11-13",0,0,3251,0,6,3257,0,0
"North America","2024-11-14",0,0,3251,0,5,3262,0,0
"North America","2024-11-15",0,0,3251,0,6,3268,0,0
"North America","2024-11-16",0,0,3251,0,5,3273,0,0
"North America","2024-11-17",0,0,3251,0,6,3279,0,0
"North America","2024-11-18",0,0,3251,0,5,3284,0,0
"North America","2024-11-19",0,39,3290,0,6,3290,0,0
"North America","2024-11-20",0,0,3290,0,5,3295,0,0
"North America","2024-11-21",0,0,3290,0,5,3300,0,0
"North America","2024-11-22",0,0,3290,0,5,3305,0,0
"North America","2024-11-23",0,0,3290,0,5,3310,0,0
"North America","2024-11-24",0,0,3290,0,5,3315,0,0
"North America","2024-11-25",0,0,3290,0,5,3320,0,0
"North America","2024-11-26",0,35,3325,0,5,3325,0,0
"North America","2024-11-27",0,0,3325,0,4,3329,0,0
"North America","2024-11-28",0,0,3325,0,5,3334,0,0
"North America","2024-11-29",0,0,3325,0,4,3338,0,0
"North America","2024-11-30",0,0,3325,0,5,3343,0,0
"North America","2024-12-01",0,0,3325,0,4,3347,0,0
"North America","2024-12-02",0,0,3325,0,5,3352,0,0
"North America","2024-12-03",0,31,3356,0,4,3356,0,0
"North America","2024-12-04",0,0,3356,0,4,3360,0,0
"North America","2024-12-05",0,0,3356,0,5,3365,0,0
"North America","2024-12-06",0,0,3356,0,4,3369,0,0
"North America","2024-12-07",0,0,3356,0,4,3373,0,0
"North America","2024-12-08",0,0,3356,0,4,3377,0,0
"North America","2024-12-09",0,0,3356,0,5,3382,0,0
"North America","2024-12-10",0,30,3386,0,4,3386,0,0
"North America","2024-12-11",0,0,3386,0,4,3390,0,0
"North America","2024-12-12",0,0,3386,0,3,3393,0,0
"North America","2024-12-13",0,0,3386,0,4,3397,0,0
"North America","2024-12-14",0,0,3386,0,4,3401,0,0
"North America","2024-12-15",0,0,3386,0,4,3405,0,0
"North America","2024-12-16",0,0,3386,0,3,3408,0,0
"North America","2024-12-17",0,26,3412,0,4,3412,0,0
"North America","2024-12-18",0,0,3412,0,4,3416,0,0
"North America","2024-12-19",0,0,3412,0,3,3419,0,0
"North America","2024-12-20",0,0,3412,0,4,3423,0,0
"North America","2024-12-21",0,0,3412,0,4,3427,0,0
"North America","2024-12-22",0,0,3412,0,4,3431,0,0
"North America","2024-12-23",0,0,3412,0,3,3434,0,0
"North America","2024-12-24",0,26,3438,0,4,3438,0,0
"North America","2024-12-25",0,0,3438,0,3,3441,0,0
"North America","2024-12-26",0,0,3438,0,3,3444,0,0
"North America","2024-12-27",0,0,3438,0,3,3447,0,0
"North America","2024-12-28",0,0,3438,0,3,3450,0,0
"North America","2024-12-29",0,0,3438,0,3,3453,0,0
"North America","2024-12-30",0,0,3438,0,3,3456,0,0
"North America","2024-12-31",0,21,3459,0,3,3459,0,0
"North America","2025-01-01",0,0,3459,0,2,3461,0,0
"North America","2025-01-02",0,0,3459,0,1,3462,0,0
"North America","2025-01-03",0,0,3459,0,2,3464,0,0
"North America","2025-01-04",0,0,3459,0,1,3465,0,0
"North America","2025-01-05",0,0,3459,0,2,3467,0,0
"North America","2025-01-06",0,0,3459,0,1,3468,0,0
"North America","2025-01-07",0,11,3470,0,2,3470,0,0
"North America","2025-01-08",0,0,3470,0,1,3471,0,0
"North America","2025-01-09",0,0,3470,0,1,3472,0,0
"North America","2025-01-10",0,0,3470,0,1,3473,0,0
"North America","2025-01-11",0,0,3470,0,1,3474,0,0
"North America","2025-01-12",0,0,3470,0,1,3475,0,0
"North America","2025-01-13",0,0,3470,0,1,3476,0,0
"North America","2025-01-14",0,7,3477,0,1,3477,0,0
"North America","2025-01-15",0,0,3477,0,0,3477,0,0
"North America","2025-01-16",0,0,3477,0,1,3478,0,0
"North America","2025-01-17",0,0,3477,0,0,3478,0,0
"North America","2025-01-18",0,0,3477,0,1,3479,0,0
"North America","2025-01-19",0,0,3477,0,0,3479,0,0
"North America","2025-01-20",0,0,3477,0,1,3480,0,0
"North America","2025-01-21",0,3,3480,0,0,3480,0,0
"North America","2025-01-22",0,0,3480,0,2,3482,0,0
"North America","2025-01-23",0,0,3480,0,2,3484,0,0
"North America","2025-01-24",0,0,3480,0,2,3486,0,0
"North America","2025-01-25",0,0,3480,0,1,3487,0,0
"North America","2025-01-26",0,0,3480,0,2,3489,0,0
"North America","2025-01-27",0,0,3480,0,2,3491,0,0
"North America","2025-01-28",0,13,3493,0,2,3493,0,0
"North America","2025-01-29",0,0,3493,0,0,3493,0,0
"North America","2025-01-30",0,0,3493,0,0,3493,0,0
"North America","2025-01-31",0,0,3493,0,0,3493,0,0
"North America","2025-02-01",0,0,3493,0,0,3493,0,0
"North America","2025-02-02",0,0,3493,0,0,3493,0,0
"North America","2025-02-03",0,0,3493,0,0,3493,0,0
"North America","2025-02-04",0,0,3493,0,0,3493,0,0
"North America","2025-02-05",0,0,3493,0,0,3493,0,0
"North America","2025-02-06",0,0,3493,0,0,3493,0,0
"North America","2025-02-07",0,0,3493,0,0,3493,0,0
"North America","2025-02-08",0,0,3493,0,0,3493,0,0
"North America","2025-02-09",0,0,3493,0,0,3493,0,0
"North America","2025-02-10",0,0,3493,0,0,3493,0,0
"North America","2025-02-11",0,0,3493,0,0,3493,0,0
"North America","2025-02-12",0,0,3493,0,0,3493,0,0
"North America","2025-02-13",0,0,3493,0,0,3493,0,0
"North America","2025-02-14",0,0,3493,0,0,3493,0,0
"North America","2025-02-15",0,0,3493,0,0,3493,0,0
"North America","2025-02-16",0,0,3493,0,0,3493,0,0
"North America","2025-02-17",0,0,3493,0,0,3493,0,0
"North America","2025-02-18",0,0,3493,0,0,3493,0,0
"North America","2025-02-19",0,0,3493,0,0,3493,0,0
"North America","2025-02-20",0,0,3493,0,0,3493,0,0
"North America","2025-02-21",0,0,3493,0,0,3493,0,0
"North America","2025-02-22",0,0,3493,0,0,3493,0,0
"North America","2025-02-23",0,0,3493,0,0,3493,0,0
"North America","2025-02-24",0,0,3493,0,0,3493,0,0
"North America","2025-02-25",0,0,3493,0,0,3493,0,0
"North America","2025-02-26",0,0,3493,0,0,3493,0,0
"North America","2025-02-27",0,0,3493,0,0,3493,0,0
"North America","2025-02-28",0,0,3493,0,0,3493,0,0
"North America","2025-03-01",0,0,3493,0,0,3493,0,0
"North America","2025-03-02",0,0,3493,0,0,3493,0,0
"North America","2025-03-03",0,0,3493,0,0,3493,0,0
"Norway","2024-01-01",0,0,0,0,0,0,0,0
"Norway","2024-01-02",0,0,0,0,0,0,0,0
"Norway","2024-01-03",0,0,0,0,0,0,0,0
"Norway","2024-01-04",0,0,0,0,0,0,0,0
"Norway","2024-01-05",0,0,0,0,0,0,0,0
"Norway","2024-01-06",0,0,0,0,0,0,0,0
"Norway","2024-01-07",0,0,0,0,0,0,0,0
"Norway","2024-01-08",0,0,0,0,0,0,0,0
"Norway","2024-01-09",0,0,0,0,0,0,0,0
"Norway","2024-01-10",0,0,0,0,0,0,0,0
"Norway","2024-01-11",0,0,0,0,0,0,0,0
"Norway","2024-01-12",0,0,0,0,0,0,0,0
"Norway","2024-01-13",0,0,0,0,0,0,0,0
"Norway","2024-01-14",0,0,0,0,0,0,0,0
"Norway","2024-01-15",0,0,0,0,0,0,0,0
"Norway","2024-01-16",0,0,0,0,0,0,0,0
"Norway","2024-01-17",0,0,0,0,0,0,0,0
"Norway","2024-01-18",0,0,0,0,0,0,0,0
"Norway","2024-01-19",0,0,0,0,0,0,0,0
"Norway","2024-01-20",0,0,0,0,0,0,0,0
"Norway","2024-01-21",0,0,0,0,0,0,0,0
"Norway","2024-01-22",0,0,0,0,0,0,0,0
"Norway","2024-01-23",0,0,0,0,0,0,0,0
"Norway","2024-01-24",0,0,0,0,0,0,0,0
"Norway","2024-01-25",0,0,0,0,0,0,0,0
"Norway","2024-01-26",0,0,0,0,0,0,0,0
"Norway","2024-01-27",0,0,0,0,0,0,0,0
"Norway","2024-01-28",0,0,0,0,0,0,0,0
"Norway","2024-01-29",0,0,0,0,0,0,0,0
"Norway","2024-01-30",0,0,0,0,0,0,0,0
"Norway","2024-01-31",0,1,1,0,1,1,0,0
"Norway","2024-02-01",0,0,1,0,0,1,0,0
"Norway","2024-02-02",0,0,1,0,0,1,0,0
"Norway","2024-02-03",0,0,1,0,0,1,0,0
"Norway","2024-02-04",0,0,1,0,0,1,0,0
"Norway","2024-02-05",0,0,1,0,0,1,0,0
"Norway","2024-02-06",0,0,1,0,0,1,0,0
"Norway","2024-02-07",0,0,1,0,0,1,0,0
"Norway","2024-02-08",0,0,1,0,0,1,0,0
"Norway","2024-02-09",0,0,1,0,0,1,0,0
"Norway","2024-02-10",0,0,1,0,0,1,0,0
"Norway","2024-02-11",0,0,1,0,0,1,0,0
"Norway","2024-02-12",0,0,1,0,0,1,0,0
"Norway","2024-02-13",0,0,1,0,0,1,0,0
"Norway","2024-02-14",0,0,1,0,0,1,0,0
"Norway","2024-02-15",0,0,1,0,0,1,0,0
"Norway","2024-02-16",0,0,1,0,0,1,0,0
"Norway","2024-02-17",0,0,1,0,0,1,0,0
"Norway","2024-02-18",0,0,1,0,0,1,0,0
"Norway","2024-02-19",0,0,1,0,0,1,0,0
"Norway","2024-02-20",0,0,1,0,0,1,0,0
"Norway","2024-02-21",0,0,1,0,0,1,0,0
"Norway","2024-02-22",0,0,1,0,0,1,0,0
"Norway","2024-02-23",0,0,1,0,0,1,0,0
"Norway","2024-02-24",0,0,1,0,0,1,0,0
"Norway","2024-02-25",0,0,1,0,0,1,0,0
"Norway","2024-02-26",0,0,1,0,0,1,0,0
"Norway","2024-02-27",0,0,1,0,0,1,0,0
"Norway","2024-02-28",0,0,1,0,0,1,0,0
"Norway","2024-02-29",0,0,1,0,0,1,0,0
"Norway","2024-03-01",0,0,1,0,0,1,0,0
"Norway","2024-03-02",0,0,1,0,0,1,0,0
"Norway","2024-03-03",0,0,1,0,0,1,0,0
"Norway","2024-03-04",0,0,1,0,0,1,0,0
"Norway","2024-03-05",0,0,1,0,0,1,0,0
"Norway","2024-03-06",0,0,1,0,0,1,0,0
"Norway","2024-03-07",0,0,1,0,0,1,0,0
"Norway","2024-03-08",0,0,1,0,0,1,0,0
"Norway","2024-03-09",0,0,1,0,0,1,0,0
"Norway","2024-03-10",0,0,1,0,0,1,0,0
"Norway","2024-03-11",0,0,1,0,0,1,0,0
"Norway","2024-03-12",0,0,1,0,0,1,0,0
"Norway","2024-03-13",0,0,1,0,0,1,0,0
"Norway","2024-03-14",0,0,1,0,0,1,0,0
"Norway","2024-03-15",0,0,1,0,0,1,0,0
"Norway","2024-03-16",0,0,1,0,0,1,0,0
"Norway","2024-03-17",0,0,1,0,1,2,0,0
"Norway","2024-03-18",0,0,1,0,0,2,0,0
"Norway","2024-03-19",0,0,1,0,0,2,0,0
"Norway","2024-03-20",0,0,1,0,0,2,0,0
"Norway","2024-03-21",0,0,1,0,0,2,0,0
"Norway","2024-03-22",0,0,1,0,0,2,0,0
"Norway","2024-03-23",0,0,1,0,0,2,0,0
"Norway","2024-03-24",0,0,1,0,0,2,0,0
"Norway","2024-03-25",0,0,1,0,0,2,0,0
"Norway","2024-03-26",0,0,1,0,0,2,0,0
"Norway","2024-03-27",0,0,1,0,0,2,0,0
"Norway","2024-03-28",0,0,1,0,0,2,0,0
"Norway","2024-03-29",0,0,1,0,0,2,0,0
"Norway","2024-03-30",0,0,1,0,0,2,0,0
"Norway","2024-03-31",0,0,1,0,0,2,0,0
"Norway","2024-04-01",0,0,1,0,0,2,0,0
"Norway","2024-04-02",0,0,1,0,0,2,0,0
"Norway","2024-04-03",0,0,1,0,0,2,0,0
"Norway","2024-04-04",0,0,1,0,0,2,0,0
"Norway","2024-04-05",0,0,1,0,0,2,0,0
"Norway","2024-04-06",0,0,1,0,0,2,0,0
"Norway","2024-04-07",0,0,1,0,0,2,0,0
"Norway","2024-04-08",0,0,1,0,0,2,0,0
"Norway","2024-04-09",0,0,1,0,0,2,0,0
"Norway","2024-04-10",0,0,1,0,0,2,0,0
"Norway","2024-04-11",0,0,1,0,0,2,0,0
"Norway","2024-04-12",0,0,1,0,0,2,0,0
"Norway","2024-04-13",0,0,1,0,0,2,0,0
"Norway","2024-04-14",0,0,1,0,0,2,0,0
"Norway","2024-04-15",0,0,1,0,0,2,0,0
"Norway","2024-04-16",0,0,1,0,0,2,0,0
"Norway","2024-04-17",0,0,1,0,0,2,0,0
"Norway","2024-04-18",0,0,1,0,0,2,0,0
"Norway","2024-04-19",0,0,1,0,0,2,0,0
"Norway","2024-04-20",0,0,1,0,0,2,0,0
"Norway","2024-04-21",0,0,1,0,0,2,0,0
"Norway","2024-04-22",0,0,1,0,0,2,0,0
"Norway","2024-04-23",0,0,1,0,0,2,0,0
"Norway","2024-04-24",0,0,1,0,0,2,0,0
"Norway","2024-04-25",0,0,1,0,0,2,0,0
"Norway","2024-04-26",0,0,1,0,0,2,0,0
"Norway","2024-04-27",0,0,1,0,0,2,0,0
"Norway","2024-04-28",0,0,1,0,0,2,0,0
"Norway","2024-04-29",0,0,1,0,0,2,0,0
"Norway","2024-04-30",0,1,2,0,0,2,0,0
"Norway","2024-05-01",0,0,2,0,0,2,0,0
"Norway","2024-05-02",0,0,2,0,0,2,0,0
"Norway","2024-05-03",0,0,2,0,0,2,0,0
"Norway","2024-05-04",0,0,2,0,0,2,0,0
"Norway","2024-05-05",0,0,2,0,0,2,0,0
"Norway","2024-05-06",0,0,2,0,0,2,0,0
"Norway","2024-05-07",0,0,2,0,0,2,0,0
"Norway","2024-05-08",0,0,2,0,0,2,0,0
"Norway","2024-05-09",0,0,2,0,0,2,0,0
"Norway","2024-05-10",0,0,2,0,0,2,0,0
"Norway","2024-05-11",0,0,2,0,0,2,0,0
"Norway","2024-05-12",0,0,2,0,0,2,0,0
"Norway","2024-05-13",0,0,2,0,0,2,0,0
"Norway","2024-05-14",0,0,2,0,0,2,0,0
"Norway","2024-05-15",0,0,2,0,0,2,0,0
"Norway","2024-05-16",0,0,2,0,0,2,0,0
"Norway","2024-05-17",0,0,2,0,0,2,0,0
"Norway","2024-05-18",0,0,2,0,0,2,0,0
"Norway","2024-05-19",0,0,2,0,0,2,0,0
"Norway","2024-05-20",0,0,2,0,0,2,0,0
"Norway","2024-05-21",0,0,2,0,0,2,0,0
"Norway","2024-05-22",0,0,2,0,0,2,0,0
"Norway","2024-05-23",0,0,2,0,0,2,0,0
"Norway","2024-05-24",0,0,2,0,0,2,0,0
"Norway","2024-05-25",0,0,2,0,0,2,0,0
"Norway","2024-05-26",0,0,2,0,0,2,0,0
"Norway","2024-05-27",0,0,2,0,0,2,0,0
"Norway","2024-05-28",0,0,2,0,0,2,0,0
"Norway","2024-05-29",0,0,2,0,0,2,0,0
"Norway","2024-05-30",0,0,2,0,0,2,0,0
"Norway","2024-05-31",0,0,2,0,0,2,0,0
"Norway","2024-06-01",0,0,2,0,0,2,0,0
"Norway","2024-06-02",0,0,2,0,0,2,0,0
"Norway","2024-06-03",0,0,2,0,0,2,0,0
"Norway","2024-06-04",0,0,2,0,0,2,0,0
"Norway","2024-06-05",0,0,2,0,0,2,0,0
"Norway","2024-06-06",0,0,2,0,0,2,0,0
"Norway","2024-06-07",0,0,2,0,0,2,0,0
"Norway","2024-06-08",0,0,2,0,0,2,0,0
"Norway","2024-06-09",0,0,2,0,0,2,0,0
"Norway","2024-06-10",0,0,2,0,0,2,0,0
"Norway","2024-06-11",0,0,2,0,0,2,0,0
"Norway","2024-06-12",0,0,2,0,0,2,0,0
"Norway","2024-06-13",0,0,2,0,0,2,0,0
"Norway","2024-06-14",0,0,2,0,0,2,0,0
"Norway","2024-06-15",0,0,2,0,0,2,0,0
"Norway","2024-06-16",0,0,2,0,1,3,0,0
"Norway","2024-06-17",0,0,2,0,0,3,0,0
"Norway","2024-06-18",0,0,2,0,0,3,0,0
"Norway","2024-06-19",0,0,2,0,0,3,0,0
"Norway","2024-06-20",0,0,2,0,0,3,0,0
"Norway","2024-06-21",0,0,2,0,0,3,0,0
"Norway","2024-06-22",0,0,2,0,0,3,0,0
"Norway","2024-06-23",0,0,2,0,0,3,0,0
"Norway","2024-06-24",0,0,2,0,0,3,0,0
"Norway","2024-06-25",0,0,2,0,0,3,0,0
"Norway","2024-06-26",0,0,2,0,0,3,0,0
"Norway","2024-06-27",0,0,2,0,0,3,0,0
"Norway","2024-06-28",0,0,2,0,0,3,0,0
"Norway","2024-06-29",0,0,2,0,0,3,0,0
"Norway","2024-06-30",0,0,2,0,0,3,0,0
"Norway","2024-07-01",0,0,2,0,0,3,0,0
"Norway","2024-07-02",0,0,2,0,0,3,0,0
"Norway","2024-07-03",0,0,2,0,0,3,0,0
"Norway","2024-07-04",0,0,2,0,0,3,0,0
"Norway","2024-07-05",0,0,2,0,0,3,0,0
"Norway","2024-07-06",0,0,2,0,0,3,0,0
"Norway","2024-07-07",0,0,2,0,0,3,0,0
"Norway","2024-07-08",0,0,2,0,0,3,0,0
"Norway","2024-07-09",0,0,2,0,0,3,0,0
"Norway","2024-07-10",0,0,2,0,0,3,0,0
"Norway","2024-07-11",0,0,2,0,0,3,0,0
"Norway","2024-07-12",0,0,2,0,0,3,0,0
"Norway","2024-07-13",0,0,2,0,0,3,0,0
"Norway","2024-07-14",0,0,2,0,0,3,0,0
"Norway","2024-07-15",0,0,2,0,0,3,0,0
"Norway","2024-07-16",0,0,2,0,0,3,0,0
"Norway","2024-07-17",0,0,2,0,0,3,0,0
"Norway","2024-07-18",0,0,2,0,0,3,0,0
"Norway","2024-07-19",0,0,2,0,0,3,0,0
"Norway","2024-07-20",0,0,2,0,0,3,0,0
"Norway","2024-07-21",0,0,2,0,0,3,0,0
"Norway","2024-07-22",0,0,2,0,0,3,0,0
"Norway","2024-07-23",0,0,2,0,0,3,0,0
"Norway","2024-07-24",0,0,2,0,0,3,0,0
"Norway","2024-07-25",0,0,2,0,0,3,0,0
"Norway","2024-07-26",0,0,2,0,0,3,0,0
"Norway","2024-07-27",0,0,2,0,0,3,0,0
"Norway","2024-07-28",0,0,2,0,0,3,0,0
"Norway","2024-07-29",0,0,2,0,0,3,0,0
"Norway","2024-07-30",0,0,2,0,0,3,0,0
"Norway","2024-07-31",0,1,3,0,0,3,0,0
"Norway","2024-08-01",0,0,3,0,0,3,0,0
"Norway","2024-08-02",0,0,3,0,0,3,0,0
"Norway","2024-08-03",0,0,3,0,0,3,0,0
"Norway","2024-08-04",0,0,3,0,0,3,0,0
"Norway","2024-08-05",0,0,3,0,0,3,0,0
"Norway","2024-08-06",0,0,3,0,0,3,0,0
"Norway","2024-08-07",0,0,3,0,0,3,0,0
"Norway","2024-08-08",0,0,3,0,1,4,0,0
"Norway","2024-08-09",0,0,3,0,0,4,0,0
"Norway","2024-08-10",0,0,3,0,0,4,0,0
"Norway","2024-08-11",0,0,3,0,0,4,0,0
"Norway","2024-08-12",0,0,3,0,0,4,0,0
"Norway","2024-08-13",0,0,3,0,0,4,0,0
"Norway","2024-08-14",0,0,3,0,0,4,0,0
"Norway","2024-08-15",0,0,3,0,0,4,0,0
"Norway","2024-08-16",0,0,3,0,0,4,0,0
"Norway","2024-08-17",0,0,3,0,0,4,0,0
"Norway","2024-08-18",0,0,3,0,0,4,0,0
"Norway","2024-08-19",0,0,3,0,0,4,0,0
"Norway","2024-08-20",0,0,3,0,0,4,0,0
"Norway","2024-08-21",0,0,3,0,0,4,0,0
"Norway","2024-08-22",0,0,3,0,0,4,0,0
"Norway","2024-08-23",0,0,3,0,0,4,0,0
"Norway","2024-08-24",0,0,3,0,1,5,0,0
"Norway","2024-08-25",0,0,3,0,0,5,0,0
"Norway","2024-08-26",0,0,3,0,0,5,0,0
"Norway","2024-08-27",0,0,3,0,0,5,0,0
"Norway","2024-08-28",0,0,3,0,0,5,0,0
"Norway","2024-08-29",0,0,3,0,0,5,0,0
"Norway","2024-08-30",0,0,3,0,0,5,0,0
"Norway","2024-08-31",0,2,5,0,0,5,0,0
"Norway","2024-09-01",0,0,5,0,0,5,0,0
"Norway","2024-09-02",0,0,5,0,0,5,0,0
"Norway","2024-09-03",0,0,5,0,0,5,0,0
"Norway","2024-09-04",0,0,5,0,0,5,0,0
"Norway","2024-09-05",0,0,5,0,1,6,0,0
"Norway","2024-09-06",0,0,5,0,0,6,0,0
"Norway","2024-09-07",0,0,5,0,0,6,0,0
"Norway","2024-09-08",0,0,5,0,0,6,0,0
"Norway","2024-09-09",0,0,5,0,0,6,0,0
"Norway","2024-09-10",0,0,5,0,0,6,0,0
"Norway","2024-09-11",0,0,5,0,0,6,0,0
"Norway","2024-09-12",0,0,5,0,0,6,0,0
"Norway","2024-09-13",0,0,5,0,0,6,0,0
"Norway","2024-09-14",0,0,5,0,1,7,0,0
"Norway","2024-09-15",0,0,5,0,0,7,0,0
"Norway","2024-09-16",0,0,5,0,0,7,0,0
"Norway","2024-09-17",0,0,5,0,0,7,0,0
"Norway","2024-09-18",0,0,5,0,0,7,0,0
"Norway","2024-09-19",0,0,5,0,0,7,0,0
"Norway","2024-09-20",0,0,5,0,0,7,0,0
"Norway","2024-09-21",0,0,5,0,0,7,0,0
"Norway","2024-09-22",0,0,5,0,1,8,0,0
"Norway","2024-09-23",0,0,5,0,0,8,0,0
"Norway","2024-09-24",0,0,5,0,0,8,0,0
"Norway","2024-09-25",0,0,5,0,0,8,0,0
"Norway","2024-09-26",0,0,5,0,0,8,0,0
"Norway","2024-09-27",0,0,5,0,0,8,0,0
"Norway","2024-09-28",0,0,5,0,0,8,0,0
"Norway","2024-09-29",0,0,5,0,0,8,0,0
"Norway","2024-09-30",0,0,5,0,0,8,0,0
"Norway","2024-10-01",0,0,5,0,1,9,0,0
"Norway","2024-10-02",0,0,5,0,0,9,0,0
"Norway","2024-10-03",0,0,5,0,0,9,0,0
"Norway","2024-10-04",0,0,5,0,0,9,0,0
"Norway","2024-10-05",0,0,5,0,0,9,0,0
"Norway","2024-10-06",0,0,5,0,0,9,0,0
"Norway","2024-10-07",0,0,5,0,0,9,0,0
"Norway","2024-10-08",0,0,5,0,0,9,0,0
"Norway","2024-10-09",0,0,5,0,0,9,0,0
"Norway","2024-10-10",0,0,5,0,1,10,0,0
"Norway","2024-10-11",0,0,5,0,0,10,0,0
"Norway","2024-10-12",0,0,5,0,0,10,0,0
"Norway","2024-10-13",0,0,5,0,0,10,0,0
"Norway","2024-10-14",0,0,5,0,0,10,0,0
"Norway","2024-10-15",0,0,5,0,0,10,0,0
"Norway","2024-10-16",0,0,5,0,0,10,0,0
"Norway","2024-10-17",0,0,5,0,0,10,0,0
"Norway","2024-10-18",0,0,5,0,1,11,0,0
"Norway","2024-10-19",0,0,5,0,0,11,0,0
"Norway","2024-10-20",0,0,5,0,0,11,0,0
"Norway","2024-10-21",0,0,5,0,0,11,0,0
"Norway","2024-10-22",0,0,5,0,0,11,0,0
"Norway","2024-10-23",0,0,5,0,0,11,0,0
"Norway","2024-10-24",0,0,5,0,0,11,0,0
"Norway","2024-10-25",0,0,5,0,0,11,0,0
"Norway","2024-10-26",0,0,5,0,0,11,0,0
"Norway","2024-10-27",0,0,5,0,1,12,0,0
"Norway","2024-10-28",0,0,5,0,0,12,0,0
"Norway","2024-10-29",0,0,5,0,0,12,0,0
"Norway","2024-10-30",0,0,5,0,0,12,0,0
"Norway","2024-10-31",0,7,12,0,0,12,0,0
"Norway","2024-11-01",0,0,12,0,0,12,0,0
"Norway","2024-11-02",0,0,12,0,0,12,0,0
"Norway","2024-11-03",0,0,12,0,0,12,0,0
"Norway","2024-11-04",0,0,12,0,0,12,0,0
"Norway","2024-11-05",0,0,12,0,0,12,0,0
"Norway","2024-11-06",0,0,12,0,1,13,0,0
"Norway","2024-11-07",0,0,12,0,0,13,0,0
"Norway","2024-11-08",0,0,12,0,0,13,0,0
"Norway","2024-11-09",0,0,12,0,0,13,0,0
"Norway","2024-11-10",0,0,12,0,0,13,0,0
"Norway","2024-11-11",0,0,12,0,0,13,0,0
"Norway","2024-11-12",0,0,12,0,0,13,0,0
"Norway","2024-11-13",0,0,12,0,0,13,0,0
"Norway","2024-11-14",0,0,12,0,0,13,0,0
"Norway","2024-11-15",0,0,12,0,1,14,0,0
"Norway","2024-11-16",0,0,12,0,0,14,0,0
"Norway","2024-11-17",0,0,12,0,0,14,0,0
"Norway","2024-11-18",0,0,12,0,0,14,0,0
"Norway","2024-11-19",0,0,12,0,0,14,0,0
"Norway","2024-11-20",0,0,12,0,0,14,0,0
"Norway","2024-11-21",0,0,12,0,0,14,0,0
"Norway","2024-11-22",0,0,12,0,0,14,0,0
"Norway","2024-11-23",0,0,12,0,0,14,0,0
"Norway","2024-11-24",0,0,12,0,0,14,0,0
"Norway","2024-11-25",0,0,12,0,0,14,0,0
"Norway","2024-11-26",0,0,12,0,1,15,0,0
"Norway","2024-11-27",0,0,12,0,0,15,0,0
"Norway","2024-11-28",0,0,12,0,0,15,0,0
"Norway","2024-11-29",0,0,12,0,0,15,0,0
"Norway","2024-11-30",0,3,15,0,0,15,0,0
"Norway","2024-12-01",0,0,15,0,0,15,0,0
"Norway","2024-12-02",0,0,15,0,0,15,0,0
"Norway","2024-12-03",0,0,15,0,0,15,0,0
"Norway","2024-12-04",0,0,15,0,0,15,0,0
"Norway","2024-12-05",0,0,15,0,0,15,0,0
"Norway","2024-12-06",0,0,15,0,0,15,0,0
"Norway","2024-12-07",0,0,15,0,0,15,0,0
"Norway","2024-12-08",0,0,15,0,0,15,0,0
"Norway","2024-12-09",0,0,15,0,0,15,0,0
"Norway","2024-12-10",0,0,15,0,0,15,0,0
"Norway","2024-12-11",0,0,15,0,1,16,0,0
"Norway","2024-12-12",0,0,15,0,0,16,0,0
"Norway","2024-12-13",0,0,15,0,0,16,0,0
"Norway","2024-12-14",0,0,15,0,0,16,0,0
"Norway","2024-12-15",0,0,15,0,0,16,0,0
"Norway","2024-12-16",0,0,15,0,0,16,0,0
"Norway","2024-12-17",0,0,15,0,0,16,0,0
"Norway","2024-12-18",0,0,15,0,0,16,0,0
"Norway","2024-12-19",0,0,15,0,0,16,0,0
"Norway","2024-12-20",0,0,15,0,0,16,0,0
"Norway","2024-12-21",0,0,15,0,0,16,0,0
"Norway","2024-12-22",0,0,15,0,0,16,0,0
"Norway","2024-12-23",0,0,15,0,0,16,0,0
"Norway","2024-12-24",0,0,15,0,0,16,0,0
"Norway","2024-12-25",0,0,15,0,0,16,0,0
"Norway","2024-12-26",0,0,15,0,0,16,0,0
"Norway","2024-12-27",0,0,15,0,0,16,0,0
"Norway","2024-12-28",0,0,15,0,0,16,0,0
"Norway","2024-12-29",0,0,15,0,0,16,0,0
"Norway","2024-12-30",0,0,15,0,0,16,0,0
"Norway","2024-12-31",0,0,15,0,1,17,0,0
"Norway","2025-01-01",0,0,15,0,0,17,0,0
"Norway","2025-01-02",0,0,15,0,0,17,0,0
"Norway","2025-01-03",0,0,15,0,0,17,0,0
"Norway","2025-01-04",0,0,15,0,0,17,0,0
"Norway","2025-01-05",0,0,15,0,0,17,0,0
"Norway","2025-01-06",0,0,15,0,0,17,0,0
"Norway","2025-01-07",0,0,15,0,0,17,0,0
"Norway","2025-01-08",0,0,15,0,0,17,0,0
"Norway","2025-01-09",0,0,15,0,0,17,0,0
"Norway","2025-01-10",0,2,17,0,0,17,0,0
"Norway","2025-01-11",0,0,17,0,0,17,0,0
"Norway","2025-01-12",0,0,17,0,0,17,0,0
"Norway","2025-01-13",0,0,17,0,0,17,0,0
"Norway","2025-01-14",0,0,17,0,0,17,0,0
"Norway","2025-01-15",0,0,17,0,0,17,0,0
"Norway","2025-01-16",0,0,17,0,0,17,0,0
"Norway","2025-01-17",0,0,17,0,0,17,0,0
"Norway","2025-01-18",0,0,17,0,0,17,0,0
"Norway","2025-01-19",0,0,17,0,0,17,0,0
"Norway","2025-01-20",0,0,17,0,0,17,0,0
"Norway","2025-01-21",0,0,17,0,0,17,0,0
"Norway","2025-01-22",0,0,17,0,0,17,0,0
"Norway","2025-01-23",0,0,17,0,0,17,0,0
"Norway","2025-01-24",0,0,17,0,0,17,0,0
"Norway","2025-01-25",0,0,17,0,0,17,0,0
"Norway","2025-01-26",0,0,17,0,0,17,0,0
"Norway","2025-01-27",0,0,17,0,0,17,0,0
"Norway","2025-01-28",0,0,17,0,0,17,0,0
"Norway","2025-01-29",0,0,17,0,0,17,0,0
"Norway","2025-01-30",0,0,17,0,0,17,0,0
"Norway","2025-01-31",0,0,17,0,0,17,0,0
"Norway","2025-02-01",0,0,17,0,0,17,0,0
"Norway","2025-02-02",0,0,17,0,0,17,0,0
"Norway","2025-02-03",0,0,17,0,0,17,0,0
"Norway","2025-02-04",0,0,17,0,0,17,0,0
"Norway","2025-02-05",0,0,17,0,0,17,0,0
"Norway","2025-02-06",0,0,17,0,0,17,0,0
"Norway","2025-02-07",0,0,17,0,0,17,0,0
"Norway","2025-02-08",0,0,17,0,0,17,0,0
"Norway","2025-02-09",0,0,17,0,0,17,0,0
"Norway","2025-02-10",0,0,17,0,0,17,0,0
"Norway","2025-02-11",0,0,17,0,0,17,0,0
"Norway","2025-02-12",0,0,17,0,0,17,0,0
"Norway","2025-02-13",0,0,17,0,0,17,0,0
"Norway","2025-02-14",0,0,17,0,0,17,0,0
"Norway","2025-02-15",0,0,17,0,0,17,0,0
"Norway","2025-02-16",0,0,17,0,0,17,0,0
"Norway","2025-02-17",0,0,17,0,0,17,0,0
"Norway","2025-02-18",0,0,17,0,0,17,0,0
"Norway","2025-02-19",0,0,17,0,0,17,0,0
"Norway","2025-02-20",0,0,17,0,0,17,0,0
"Norway","2025-02-21",0,0,17,0,0,17,0,0
"Norway","2025-02-22",0,0,17,0,0,17,0,0
"Norway","2025-02-23",0,0,17,0,0,17,0,0
"Norway","2025-02-24",0,0,17,0,0,17,0,0
"Norway","2025-02-25",0,0,17,0,0,17,0,0
"Norway","2025-02-26",0,0,17,0,0,17,0,0
"Norway","2025-02-27",0,0,17,0,0,17,0,0
"Norway","2025-02-28",0,0,17,0,0,17,0,0
"Norway","2025-03-01",0,0,17,0,0,17,0,0
"Norway","2025-03-02",0,0,17,0,0,17,0,0
"Norway","2025-03-03",0,0,17,0,0,17,0,0
"Oceania","2024-01-01",0,0,0,0,0,0,0,0
"Oceania","2024-01-02",0,0,0,0,0,0,0,0
"Oceania","2024-01-03",0,0,0,0,0,0,0,0
"Oceania","2024-01-04",0,0,0,0,0,0,0,0
"Oceania","2024-01-05",0,0,0,0,0,0,0,0
"Oceania","2024-01-06",0,0,0,0,0,0,0,0
"Oceania","2024-01-07",0,0,0,0,0,0,0,0
"Oceania","2024-01-08",0,0,0,0,0,0,0,0
"Oceania","2024-01-09",0,0,0,0,0,0,0,0
"Oceania","2024-01-10",0,0,0,0,0,0,0,0
"Oceania","2024-01-11",0,0,0,0,0,0,0,0
"Oceania","2024-01-12",0,0,0,0,0,0,0,0
"Oceania","2024-01-13",0,0,0,0,0,0,0,0
"Oceania","2024-01-14",0,0,0,0,0,0,0,0
"Oceania","2024-01-15",0,0,0,0,0,0,0,0
"Oceania","2024-01-16",0,8,8,0,8,8,0,0
"Oceania","2024-01-17",0,0,8,0,0,8,0,0
"Oceania","2024-01-18",0,0,8,0,1,9,0,0
"Oceania","2024-01-19",0,0,8,0,0,9,0,0
"Oceania","2024-01-20",0,0,8,0,1,10,0,0
"Oceania","2024-01-21",0,0,8,0,0,10,0,0
"Oceania","2024-01-22",0,0,8,0,0,10,0,0
"Oceania","2024-01-23",0,0,8,0,1,11,0,0
"Oceania","2024-01-24",0,0,8,0,0,11,0,0
"Oceania","2024-01-25",0,0,8,0,1,12,0,0
"Oceania","2024-01-26",0,0,8,0,0,12,0,0
"Oceania","2024-01-27",0,0,8,0,0,12,0,0
"Oceania","2024-01-28",0,0,8,0,1,13,0,0
"Oceania","2024-01-29",0,0,8,0,0,13,0,0
"Oceania","2024-01-30",0,0,8,0,1,14,0,0
"Oceania","2024-01-31",0,6,14,0,0,14,0,0
"Oceania","2024-02-01",0,0,14,0,0,14,0,0
"Oceania","2024-02-02",0,0,14,0,0,14,0,0
"Oceania","2024-02-03",0,0,14,0,0,14,0,0
"Oceania","2024-02-04",0,0,14,0,0,14,0,0
"Oceania","2024-02-05",0,0,14,0,0,14,0,0
"Oceania","2024-02-06",0,0,14,0,0,14,0,0
"Oceania","2024-02-07",0,0,14,0,0,14,0,0
"Oceania","2024-02-08",0,0,14,0,0,14,0,0
"Oceania","2024-02-09",0,0,14,0,0,14,0,0
"Oceania","2024-02-10",0,0,14,0,1,15,0,0
"Oceania","2024-02-11",0,0,14,0,0,15,0,0
"Oceania","2024-02-12",0,0,14,0,0,15,0,0
"Oceania","2024-02-13",0,0,14,0,0,15,0,0
"Oceania","2024-02-14",0,0,14,0,0,15,0,0
"Oceania","2024-02-15",0,0,14,0,0,15,0,0
"Oceania","2024-02-16",0,0,14,0,0,15,0,0
"Oceania","2024-02-17",0,0,14,0,0,15,0,0
"Oceania","2024-02-18",0,0,14,0,0,15,0,0
"Oceania","2024-02-19",0,0,14,0,0,15,0,0
"Oceania","2024-02-20",0,0,14,0,0,15,0,0
"Oceania","2024-02-21",0,0,14,0,0,15,0,0
"Oceania","2024-02-22",0,0,14,0,0,15,0,0
"Oceania","2024-02-23",0,0,14,0,0,15,0,0
"Oceania","2024-02-24",0,0,14,0,0,15,0,0
"Oceania","2024-02-25",0,0,14,0,0,15,0,0
"Oceania","2024-02-26",0,0,14,0,0,15,0,0
"Oceania","2024-02-27",0,0,14,0,1,16,0,0
"Oceania","2024-02-28",0,0,14,0,0,16,0,0
"Oceania","2024-02-29",0,0,14,0,0,16,0,0
"Oceania","2024-03-01",0,0,14,0,0,16,0,0
"Oceania","2024-03-02",0,0,14,0,0,16,0,0
"Oceania","2024-03-03",0,0,14,0,0,16,0,0
"Oceania","2024-03-04",0,0,14,0,0,16,0,0
"Oceania","2024-03-05",0,0,14,0,0,16,0,0
"Oceania","2024-03-06",0,0,14,0,0,16,0,0
"Oceania","2024-03-07",0,0,14,0,0,16,0,0
"Oceania","2024-03-08",0,0,14,0,0,16,0,0
"Oceania","2024-03-09",0,0,14,0,0,16,0,0
"Oceania","2024-03-10",0,0,14,0,0,16,0,0
"Oceania","2024-03-11",0,0,14,0,0,16,0,0
"Oceania","2024-03-12",0,0,14,0,0,16,0,0
"Oceania","2024-03-13",0,0,14,0,0,16,0,0
"Oceania","2024-03-14",0,0,14,0,0,16,0,0
"Oceania","2024-03-15",0,0,14,0,0,16,0,0
"Oceania","2024-03-16",0,0,14,0,0,16,0,0
"Oceania","2024-03-17",0,0,14,0,1,17,0,0
"Oceania","2024-03-18",0,0,14,0,0,17,0,0
"Oceania","2024-03-19",0,0,14,0,0,17,0,0
"Oceania","2024-03-20",0,0,14,0,0,17,0,0
"Oceania","2024-03-21",0,0,14,0,0,17,0,0
"Oceania","2024-03-22",0,0,14,0,0,17,0,0
"Oceania","2024-03-23",0,0,14,0,0,17,0,0
"Oceania","2024-03-24",0,0,14,0,0,17,0,0
"Oceania","2024-03-25",0,0,14,0,0,17,0,0
"Oceania","2024-03-26",0,0,14,0,0,17,0,0
"Oceania","2024-03-27",0,0,14,0,0,17,0,0
"Oceania","2024-03-28",0,0,14,0,0,17,0,0
"Oceania","2024-03-29",0,0,14,0,0,17,0,0
"Oceania","2024-03-30",0,0,14,0,0,17,0,0
"Oceania","2024-03-31",0,0,14,0,0,17,0,0
"Oceania","2024-04-01",0,0,14,0,0,17,0,0
"Oceania","2024-04-02",0,0,14,0,0,17,0,0
"Oceania","2024-04-03",0,0,14,0,1,18,0,0
"Oceania","2024-04-04",0,0,14,0,0,18,0,0
"Oceania","2024-04-05",0,0,14,0,0,18,0,0
"Oceania","2024-04-06",0,0,14,0,0,18,0,0
"Oceania","2024-04-07",0,0,14,0,0,18,0,0
"Oceania","2024-04-08",0,0,14,0,0,18,0,0
"Oceania","2024-04-09",0,0,14,0,0,18,0,0
"Oceania","2024-04-10",0,0,14,0,0,18,0,0
"Oceania","2024-04-11",0,0,14,0,0,18,0,0
"Oceania","2024-04-12",0,0,14,0,0,18,0,0
"Oceania","2024-04-13",0,0,14,0,0,18,0,0
"Oceania","2024-04-14",0,0,14,0,0,18,0,0
"Oceania","2024-04-15",0,0,14,0,0,18,0,0
"Oceania","2024-04-16",0,0,14,0,0,18,0,0
"Oceania","2024-04-17",0,0,14,0,0,18,0,0
"Oceania","2024-04-18",0,0,14,0,0,18,0,0
"Oceania","2024-04-19",0,0,14,0,0,18,0,0
"Oceania","2024-04-20",0,0,14,0,0,18,0,0
"Oceania","2024-04-21",0,0,14,0,0,18,0,0
"Oceania","2024-04-22",0,0,14,0,1,19,0,0
"Oceania","2024-04-23",0,0,14,0,0,19,0,0
"Oceania","2024-04-24",0,0,14,0,0,19,0,0
"Oceania","2024-04-25",0,0,14,0,0,19,0,0
"Oceania","2024-04-26",0,0,14,0,0,19,0,0
"Oceania","2024-04-27",0,0,14,0,0,19,0,0
"Oceania","2024-04-28",0,0,14,0,0,19,0,0
"Oceania","2024-04-29",0,0,14,0,0,19,0,0
"Oceania","2024-04-30",0,5,19,0,0,19,0,0
"Oceania","2024-05-01",0,0,19,0,0,19,0,0
"Oceania","2024-05-02",0,0,19,0,0,19,0,0
"Oceania","2024-05-03",0,0,19,0,0,19,0,0
"Oceania","2024-05-04",0,0,19,0,0,19,0,0
"Oceania","2024-05-05",0,0,19,0,1,20,0,0
"Oceania","2024-05-06",0,0,19,0,0,20,0,0
"Oceania","2024-05-07",0,0,19,0,0,20,0,0
"Oceania","2024-05-08",0,0,19,0,0,20,0,0
"Oceania","2024-05-09",0,1,20,0,0,20,0,0
"Oceania","2024-05-10",0,0,20,0,2,22,0,0
"Oceania","2024-05-11",0,0,20,0,1,23,0,0
"Oceania","2024-05-12",0,0,20,0,1,24,0,0
"Oceania","2024-05-13",0,0,20,0,2,26,0,0
"Oceania","2024-05-14",0,0,20,0,2,28,0,0
"Oceania","2024-05-15",0,0,20,0,1,29,0,0
"Oceania","2024-05-16",0,0,20,0,1,30,0,0
"Oceania","2024-05-17",0,0,20,0,2,32,0,0
"Oceania","2024-05-18",0,0,20,0,2,34,0,0
"Oceania","2024-05-19",0,0,20,0,1,35,0,0
"Oceania","2024-05-20",0,0,20,0,1,36,0,0
"Oceania","2024-05-21",0,0,20,0,2,38,0,0
"Oceania","2024-05-22",0,0,20,0,2,40,0,0
"Oceania","2024-05-23",0,0,20,0,1,41,0,0
"Oceania","2024-05-24",0,0,20,0,1,42,0,0
"Oceania","2024-05-25",0,0,20,0,2,44,0,0
"Oceania","2024-05-26",0,0,20,0,2,46,0,0
"Oceania","2024-05-27",0,0,20,0,1,47,0,0
"Oceania","2024-05-28",0,0,20,0,1,48,0,0
"Oceania","2024-05-29",0,0,20,0,2,50,0,0
"Oceania","2024-05-30",0,0,20,0,2,52,0,0
"Oceania","2024-05-31",0,33,53,0,1,53,0,0
"Oceania","2024-06-01",0,0,53,0,2,55,0,0
"Oceania","2024-06-02",0,0,53,0,2,57,0,0
"Oceania","2024-06-03",0,0,53,0,2,59,0,0
"Oceania","2024-06-04",0,0,53,0,3,62,0,0
"Oceania","2024-06-05",0,0,53,0,2,64,0,0
"Oceania","2024-06-06",0,0,53,0,2,66,0,0
"Oceania","2024-06-07",0,0,53,0,2,68,0,0
"Oceania","2024-06-08",0,0,53,0,2,70,0,0
"Oceania","2024-06-09",0,0,53,0,2,72,0,0
"Oceania","2024-06-10",0,0,53,0,2,74,0,0
"Oceania","2024-06-11",0,0,53,0,2,76,0,0
"Oceania","2024-06-12",0,0,53,0,3,79,0,0
"Oceania","2024-06-13",0,0,53,0,2,81,0,0
"Oceania","2024-06-14",0,0,53,0,2,83,0,0
"Oceania","2024-06-15",0,0,53,0,2,85,0,0
"Oceania","2024-06-16",0,0,53,0,2,87,0,0
"Oceania","2024-06-17",0,0,53,0,2,89,0,0
"Oceania","2024-06-18",0,0,53,0,2,91,0,0
"Oceania","2024-06-19",0,0,53,0,3,94,0,0
"Oceania","2024-06-20",0,0,53,0,2,96,0,0
"Oceania","2024-06-21",0,0,53,0,2,98,0,0
"Oceania","2024-06-22",0,0,53,0,2,100,0,0
"Oceania","2024-06-23",0,0,53,0,2,102,0,0
"Oceania","2024-06-24",0,0,53,0,2,104,0,0
"Oceania","2024-06-25",0,0,53,0,2,106,0,0
"Oceania","2024-06-26",0,0,53,0,2,108,0,0
"Oceania","2024-06-27",0,0,53,0,3,111,0,0
"Oceania","2024-06-28",0,0,53,0,2,113,0,0
"Oceania","2024-06-29",0,0,53,0,2,115,0,0
"Oceania","2024-06-30",0,64,117,0,2,117,0,0
"Oceania","2024-07-01",0,2,119,0,2,119,0,0
"Oceania","2024-07-02",0,0,119,0,1,120,0,0
"Oceania","2024-07-03",0,0,119,0,1,121,0,0
"Oceania","2024-07-04",0,0,119,0,1,122,0,0
"Oceania","2024-07-05",0,0,119,0,1,123,0,0
"Oceania","2024-07-06",0,0,119,0,1,124,0,0
"Oceania","2024-07-07",0,0,119,0,1,125,0,0
"Oceania","2024-07-08",0,0,119,0,1,126,0,0
"Oceania","2024-07-09",0,0,119,0,1,127,0,0
"Oceania","2024-07-10",0,0,119,0,1,128,0,0
"Oceania","2024-07-11",0,0,119,0,1,129,0,0
"Oceania","2024-07-12",0,0,119,0,1,130,0,0
"Oceania","2024-07-13",0,0,119,0,1,131,0,0
"Oceania","2024-07-14",0,0,119,0,1,132,0,0
"Oceania","2024-07-15",0,14,133,0,1,133,0,0
"Oceania","2024-07-16",0,0,133,0,3,136,0,0
"Oceania","2024-07-17",0,0,133,0,3,139,0,0
"Oceania","2024-07-18",0,0,133,0,3,142,0,0
"Oceania","2024-07-19",0,0,133,0,3,145,0,0
"Oceania","2024-07-20",0,0,133,0,3,148,0,0
"Oceania","2024-07-21",0,0,133,0,3,151,0,0
"Oceania","2024-07-22",0,21,154,0,3,154,0,0
"Oceania","2024-07-23",0,0,154,0,4,158,0,0
"Oceania","2024-07-24",0,0,154,0,4,162,0,0
"Oceania","2024-07-25",0,0,154,0,5,167,0,0
"Oceania","2024-07-26",0,0,154,0,4,171,0,0
"Oceania","2024-07-27",0,21,175,0,4,175,0,0
"Oceania","2024-07-28",0,0,175,0,11,186,0,0
"Oceania","2024-07-29",0,0,175,0,10,196,0,0
"Oceania","2024-07-30",0,32,207,0,11,207,0,0
"Oceania","2024-07-31",0,13,220,0,13,220,0,0
"Oceania","2024-08-01",0,0,220,0,4,224,0,0
"Oceania","2024-08-02",0,0,220,0,3,227,0,0
"Oceania","2024-08-03",0,0,220,0,4,231,0,0
"Oceania","2024-08-04",0,0,220,0,3,234,0,0
"Oceania","2024-08-05",0,0,220,0,4,238,0,0
"Oceania","2024-08-06",0,0,220,0,3,241,0,0
"Oceania","2024-08-07",0,0,220,0,4,245,0,0
"Oceania","2024-08-08",0,0,220,0,3,248,0,0
"Oceania","2024-08-09",0,0,220,0,4,252,0,0
"Oceania","2024-08-10",0,0,220,0,3,255,0,0
"Oceania","2024-08-11",0,0,220,0,4,259,0,0
"Oceania","2024-08-12",0,0,220,0,3,262,0,0
"Oceania","2024-08-13",0,0,220,0,4,266,0,0
"Oceania","2024-08-14",0,0,220,0,3,269,0,0
"Oceania","2024-08-15",0,0,220,0,4,273,0,0
"Oceania","2024-08-16",0,0,220,0,3,276,0,0
"Oceania","2024-08-17",0,0,220,0,4,280,0,0
"Oceania","2024-08-18",0,0,220,0,3,283,0,0
"Oceania","2024-08-19",0,0,220,0,4,287,0,0
"Oceania","2024-08-20",0,0,220,0,3,290,0,0
"Oceania","2024-08-21",0,74,294,0,4,294,0,0
"Oceania","2024-08-22",0,0,294,0,9,303,0,0
"Oceania","2024-08-23",0,0,294,0,9,312,0,0
"Oceania","2024-08-24",0,0,294,0,8,320,0,0
"Oceania","2024-08-25",0,0,294,0,9,329,0,0
"Oceania","2024-08-26",0,0,294,0,9,338,0,0
"Oceania","2024-08-27",0,0,294,0,8,346,0,0
"Oceania","2024-08-28",0,0,294,0,9,355,0,0
"Oceania","2024-08-29",0,70,364,0,9,364,0,0
"Oceania","2024-08-30",0,0,364,0,50,414,0,0
"Oceania","2024-08-31",0,101,465,0,51,465,0,0
"Oceania","2024-09-01",0,0,465,0,4,469,0,0
"Oceania","2024-09-02",0,0,465,0,5,474,0,0
"Oceania","2024-09-03",0,0,465,0,4,478,0,0
"Oceania","2024-09-04",0,0,465,0,5,483,0,0
"Oceania","2024-09-05",0,0,465,0,4,487,0,0
"Oceania","2024-09-06",0,0,465,0,4,491,0,0
"Oceania","2024-09-07",0,0,465,0,5,496,0,0
"Oceania","2024-09-08",0,35,500,0,4,500,0,0
"Oceania","2024-09-09",0,0,500,0,12,512,0,0
"Oceania","2024-09-10",0,0,500,0,12,524,0,0
"Oceania","2024-09-11",0,0,500,0,12,536,0,0
"Oceania","2024-09-12",0,0,500,0,12,548,0,0
"Oceania","2024-09-13",0,0,500,0,12,560,0,0
"Oceania","2024-09-14",0,0,500,0,12,572,0,0
"Oceania","2024-09-15",0,84,584,0,12,584,0,0
"Oceania","2024-09-16",0,0,584,0,13,597,0,0
"Oceania","2024-09-17",0,0,584,0,13,610,0,0
"Oceania","2024-09-18",0,0,584,0,13,623,0,0
"Oceania","2024-09-19",0,0,584,0,14,637,0,0
"Oceania","2024-09-20",0,0,584,0,13,650,0,0
"Oceania","2024-09-21",0,0,584,0,13,663,0,0
"Oceania","2024-09-22",0,92,676,0,13,676,0,0
"Oceania","2024-09-23",0,0,676,0,13,689,0,0
"Oceania","2024-09-24",0,0,676,0,13,702,0,0
"Oceania","2024-09-25",0,0,676,0,13,715,0,0
"Oceania","2024-09-26",0,0,676,0,13,728,0,0
"Oceania","2024-09-27",0,0,676,0,13,741,0,0
"Oceania","2024-09-28",0,0,676,0,13,754,0,0
"Oceania","2024-09-29",0,91,767,0,13,767,0,0
"Oceania","2024-09-30",0,0,767,0,10,777,0,0
"Oceania","2024-10-01",0,0,767,0,11,788,0,0
"Oceania","2024-10-02",0,0,767,0,10,798,0,0
"Oceania","2024-10-03",0,0,767,0,10,808,0,0
"Oceania","2024-10-04",0,0,767,0,10,818,0,0
"Oceania","2024-10-05",0,0,767,0,11,829,0,0
"Oceania","2024-10-06",0,72,839,0,10,839,0,0
"Oceania","2024-10-07",0,23,862,0,23,862,0,0
"Oceania","2024-10-08",0,0,862,0,9,871,0,0
"Oceania","2024-10-09",0,0,862,0,9,880,0,0
"Oceania","2024-10-10",0,0,862,0,9,889,0,0
"Oceania","2024-10-11",0,0,862,0,9,898,0,0
"Oceania","2024-10-12",0,0,862,0,9,907,0,0
"Oceania","2024-10-13",0,54,916,0,9,916,0,0
"Oceania","2024-10-14",0,0,916,0,6,922,0,0
"Oceania","2024-10-15",0,12,928,0,6,928,0,0
"Oceania","2024-10-16",0,0,928,0,16,944,0,0
"Oceania","2024-10-17",0,0,928,0,16,960,0,0
"Oceania","2024-10-18",0,0,928,0,15,975,0,0
"Oceania","2024-10-19",0,0,928,0,16,991,0,0
"Oceania","2024-10-20",0,79,1007,0,16,1007,0,0
"Oceania","2024-10-21",0,0,1007,0,10,1017,0,0
"Oceania","2024-10-22",0,0,1007,0,9,1026,0,0
"Oceania","2024-10-23",0,0,1007,0,10,1036,0,0
"Oceania","2024-10-24",0,0,1007,0,10,1046,0,0
"Oceania","2024-10-25",0,0,1007,0,10,1056,0,0
"Oceania","2024-10-26",0,0,1007,0,9,1065,0,0
"Oceania","2024-10-27",0,68,1075,0,10,1075,0,0
"Oceania","2024-10-28",0,0,1075,0,11,1086,0,0
"Oceania","2024-10-29",0,0,1075,0,12,1098,0,0
"Oceania","2024-10-30",0,0,1075,0,11,1109,0,0
"Oceania","2024-10-31",0,0,1075,0,11,1120,0,0
"Oceania","2024-11-01",0,0,1075,0,11,1131,0,0
"Oceania","2024-11-02",0,0,1075,0,12,1143,0,0
"Oceania","2024-11-03",0,79,1154,0,11,1154,0,0
"Oceania","2024-11-04",0,1,1155,0,1,1155,0,0
"Oceania","2024-11-05",0,0,1155,0,10,1165,0,0
"Oceania","2024-11-06",0,0,1155,0,9,1174,0,0
"Oceania","2024-11-07",0,0,1155,0,9,1183,0,0
"Oceania","2024-11-08",0,0,1155,0,10,1193,0,0
"Oceania","2024-11-09",0,0,1155,0,10,1203,0,0
"Oceania","2024-11-10",0,57,1212,0,9,1212,0,0
"Oceania","2024-11-11",0,0,1212,0,7,1219,0,0
"Oceania","2024-11-12",0,0,1212,0,7,1226,0,0
"Oceania","2024-11-13",0,0,1212,0,7,1233,0,0
"Oceania","2024-11-14",0,0,1212,0,7,1240,0,0
"Oceania","2024-11-15",0,0,1212,0,7,1247,0,0
"Oceania","2024-11-16",0,0,1212,0,7,1254,0,0
"Oceania","2024-11-17",0,49,1261,0,7,1261,0,0
"Oceania","2024-11-18",0,0,1261,0,4,1265,0,0
"Oceania","2024-11-19",0,0,1261,0,4,1269,0,0
"Oceania","2024-11-20",0,0,1261,0,4,1273,0,0
"Oceania","2024-11-21",0,0,1261,0,5,1278,0,0
"Oceania","2024-11-22",0,0,1261,0,4,1282,0,0
"Oceania","2024-11-23",0,0,1261,0,4,1286,0,0
"Oceania","2024-11-24",0,29,1290,0,4,1290,0,0
"Oceania","2024-11-25",0,0,1290,0,5,1295,0,0
"Oceania","2024-11-26",0,0,1290,0,5,1300,0,0
"Oceania","2024-11-27",0,0,1290,0,5,1305,0,0
"Oceania","2024-11-28",0,0,1290,0,4,1309,0,0
"Oceania","2024-11-29",0,0,1290,0,5,1314,0,0
"Oceania","2024-11-30",0,0,1290,0,5,1319,0,0
"Oceania","2024-12-01",0,34,1324,0,5,1324,0,0
"Oceania","2024-12-02",0,0,1324,0,1,1325,0,0
"Oceania","2024-12-03",0,0,1324,0,1,1326,0,0
"Oceania","2024-12-04",0,0,1324,0,0,1326,0,0
"Oceania","2024-12-05",0,3,1327,0,1,1327,0,0
"Oceania","2024-12-06",0,0,1327,0,6,1333,0,0
"Oceania","2024-12-07",0,0,1327,0,7,1340,0,0
"Oceania","2024-12-08",0,0,1327,0,7,1347,0,0
"Oceania","2024-12-09",0,26,1353,0,6,1353,0,0
"Oceania","2024-12-10",0,0,1353,0,4,1357,0,0
"Oceania","2024-12-11",0,0,1353,0,5,1362,0,0
"Oceania","2024-12-12",0,0,1353,0,4,1366,0,0
"Oceania","2024-12-13",0,0,1353,0,4,1370,0,0
"Oceania","2024-12-14",0,0,1353,0,5,1375,0,0
"Oceania","2024-12-15",0,26,1379,0,4,1379,0,0
"Oceania","2024-12-16",0,0,1379,0,3,1382,0,0
"Oceania","2024-12-17",0,0,1379,0,2,1384,0,0
"Oceania","2024-12-18",0,0,1379,0,3,1387,0,0
"Oceania","2024-12-19",0,0,1379,0,3,1390,0,0
"Oceania","2024-12-20",0,0,1379,0,3,1393,0,0
"Oceania","2024-12-21",0,0,1379,0,2,1395,0,0
"Oceania","2024-12-22",0,19,1398,0,3,1398,0,0
"Oceania","2024-12-23",0,0,1398,0,2,1400,0,0
"Oceania","2024-12-24",0,0,1398,0,2,1402,0,0
"Oceania","2024-12-25",0,0,1398,0,2,1404,0,0
"Oceania","2024-12-26",0,0,1398,0,1,1405,0,0
"Oceania","2024-12-27",0,0,1398,0,2,1407,0,0
"Oceania","2024-12-28",0,0,1398,0,2,1409,0,0
"Oceania","2024-12-29",0,13,1411,0,2,1411,0,0
"Oceania","2024-12-30",0,0,1411,0,2,1413,0,0
"Oceania","2024-12-31",0,0,1411,0,1,1414,0,0
"Oceania","2025-01-01",0,0,1411,0,2,1416,0,0
"Oceania","2025-01-02",0,0,1411,0,2,1418,0,0
"Oceania","2025-01-03",0,0,1411,0,2,1420,0,0
"Oceania","2025-01-04",0,0,1411,0,1,1421,0,0
"Oceania","2025-01-05",0,12,1423,0,2,1423,0,0
"Oceania","2025-01-06",0,0,1423,0,4,1427,0,0
"Oceania","2025-01-07",0,0,1423,0,4,1431,0,0
"Oceania","2025-01-08",0,0,1423,0,4,1435,0,0
"Oceania","2025-01-09",0,0,1423,0,3,1438,0,0
"Oceania","2025-01-10",0,0,1423,0,4,1442,0,0
"Oceania","2025-01-11",0,0,1423,0,4,1446,0,0
"Oceania","2025-01-12",0,27,1450,0,4,1450,0,0
"Oceania","2025-01-13",0,0,1450,0,5,1455,0,0
"Oceania","2025-01-14",0,0,1450,0,4,1459,0,0
"Oceania","2025-01-15",0,0,1450,0,5,1464,0,0
"Oceania","2025-01-16",0,0,1450,0,4,1468,0,0
"Oceania","2025-01-17",0,0,1450,0,5,1473,0,0
"Oceania","2025-01-18",0,0,1450,0,4,1477,0,0
"Oceania","2025-01-19",0,32,1482,0,5,1482,0,0
"Oceania","2025-01-20",0,0,1482,0,3,1485,0,0
"Oceania","2025-01-21",0,0,1482,0,2,1487,0,0
"Oceania","2025-01-22",0,0,1482,0,3,1490,0,0
"Oceania","2025-01-23",0,0,1482,0,3,1493,0,0
"Oceania","2025-01-24",0,0,1482,0,3,1496,0,0
"Oceania","2025-01-25",0,0,1482,0,2,1498,0,0
"Oceania","2025-01-26",0,19,1501,0,3,1501,0,0
"Oceania","2025-01-27",0,0,1501,0,1,1502,0,0
"Oceania","2025-01-28",0,0,1501,0,2,1504,0,0
"Oceania","2025-01-29",0,0,1501,0,1,1505,0,0
"Oceania","2025-01-30",0,0,1501,0,1,1506,0,0
"Oceania","2025-01-31",0,0,1501,0,1,1507,0,0
"Oceania","2025-02-01",0,0,1501,0,2,1509,0,0
"Oceania","2025-02-02",0,9,1510,0,1,1510,0,0
"Oceania","2025-02-03",0,0,1510,0,1,1511,0,0
"Oceania","2025-02-04",0,2,1512,0,1,1512,0,0
"Oceania","2025-02-05",0,0,1512,0,3,1515,0,0
"Oceania","2025-02-06",0,0,1512,0,3,1518,0,0
"Oceania","2025-02-07",0,0,1512,0,2,1520,0,0
"Oceania","2025-02-08",0,0,1512,0,3,1523,0,0
"Oceania","2025-02-09",0,14,1526,0,3,1526,0,0
"Oceania","2025-02-10",0,0,1526,0,2,1528,0,0
"Oceania","2025-02-11",0,0,1526,0,2,1530,0,0
"Oceania","2025-02-12",0,0,1526,0,2,1532,0,0
"Oceania","2025-02-13",0,0,1526,0,2,1534,0,0
"Oceania","2025-02-14",0,0,1526,0,2,1536,0,0
"Oceania","2025-02-15",0,0,1526,0,2,1538,0,0
"Oceania","2025-02-16",0,14,1540,0,2,1540,0,0
"Oceania","2025-02-17",0,0,1540,0,0,1540,0,0
"Oceania","2025-02-18",0,0,1540,0,0,1540,0,0
"Oceania","2025-02-19",0,0,1540,0,0,1540,0,0
"Oceania","2025-02-20",0,0,1540,0,0,1540,0,0
"Oceania","2025-02-21",0,0,1540,0,0,1540,0,0
"Oceania","2025-02-22",0,0,1540,0,0,1540,0,0
"Oceania","2025-02-23",0,0,1540,0,0,1540,0,0
"Oceania","2025-02-24",0,0,1540,0,0,1540,0,0
"Oceania","2025-02-25",0,0,1540,0,0,1540,0,0
"Oceania","2025-02-26",0,0,1540,0,0,1540,0,0
"Oceania","2025-02-27",0,0,1540,0,0,1540,0,0
"Oceania","2025-02-28",0,0,1540,0,0,1540,0,0
"Oceania","2025-03-01",0,0,1540,0,0,1540,0,0
"Oceania","2025-03-02",0,0,1540,0,0,1540,0,0
"Oceania","2025-03-03",0,0,1540,0,0,1540,0,0
"Oman","2024-01-01",0,0,0,0,0,0,0,0
"Oman","2024-01-02",0,0,0,0,0,0,0,0
"Oman","2024-01-03",0,0,0,0,0,0,0,0
"Oman","2024-01-04",0,0,0,0,0,0,0,0
"Oman","2024-01-05",0,0,0,0,0,0,0,0
"Oman","2024-01-06",0,0,0,0,0,0,0,0
"Oman","2024-01-07",0,0,0,0,0,0,0,0
"Oman","2024-01-08",0,0,0,0,0,0,0,0
"Oman","2024-01-09",0,0,0,0,0,0,0,0
"Oman","2024-01-10",0,0,0,0,0,0,0,0
"Oman","2024-01-11",0,0,0,0,0,0,0,0
"Oman","2024-01-12",0,0,0,0,0,0,0,0
"Oman","2024-01-13",0,0,0,0,0,0,0,0
"Oman","2024-01-14",0,0,0,0,0,0,0,0
"Oman","2024-01-15",0,0,0,0,0,0,0,0
"Oman","2024-01-16",0,0,0,0,0,0,0,0
"Oman","2024-01-17",0,0,0,0,0,0,0,0
"Oman","2024-01-18",0,0,0,0,0,0,0,0
"Oman","2024-01-19",0,0,0,0,0,0,0,0
"Oman","2024-01-20",0,0,0,0,0,0,0,0
"Oman","2024-01-21",0,0,0,0,0,0,0,0
"Oman","2024-01-22",0,0,0,0,0,0,0,0
"Oman","2024-01-23",0,0,0,0,0,0,0,0
"Oman","2024-01-24",0,0,0,0,0,0,0,0
"Oman","2024-01-25",0,0,0,0,0,0,0,0
"Oman","2024-01-26",0,0,0,0,0,0,0,0
"Oman","2024-01-27",0,0,0,0,0,0,0,0
"Oman","2024-01-28",0,0,0,0,0,0,0,0
"Oman","2024-01-29",0,0,0,0,0,0,0,0
"Oman","2024-01-30",0,0,0,0,0,0,0,0
"Oman","2024-01-31",0,0,0,0,0,0,0,0
"Oman","2024-02-01",0,0,0,0,0,0,0,0
"Oman","2024-02-02",0,0,0,0,0,0,0,0
"Oman","2024-02-03",0,0,0,0,0,0,0,0
"Oman","2024-02-04",0,0,0,0,0,0,0,0
"Oman","2024-02-05",0,0,0,0,0,0,0,0
"Oman","2024-02-06",0,0,0,0,0,0,0,0
"Oman","2024-02-07",0,0,0,0,0,0,0,0
"Oman","2024-02-08",0,0,0,0,0,0,0,0
"Oman","2024-02-09",0,0,0,0,0,0,0,0
"Oman","2024-02-10",0,0,0,0,0,0,0,0
"Oman","2024-02-11",0,0,0,0,0,0,0,0
"Oman","2024-02-12",0,0,0,0,0,0,0,0
"Oman","2024-02-13",0,0,0,0,0,0,0,0
"Oman","2024-02-14",0,0,0,0,0,0,0,0
"Oman","2024-02-15",0,0,0,0,0,0,0,0
"Oman","2024-02-16",0,0,0,0,0,0,0,0
"Oman","2024-02-17",0,0,0,0,0,0,0,0
"Oman","2024-02-18",0,0,0,0,0,0,0,0
"Oman","2024-02-19",0,0,0,0,0,0,0,0
"Oman","2024-02-20",0,0,0,0,0,0,0,0
"Oman","2024-02-21",0,0,0,0,0,0,0,0
"Oman","2024-02-22",0,0,0,0,0,0,0,0
"Oman","2024-02-23",0,0,0,0,0,0,0,0
"Oman","2024-02-24",0,0,0,0,0,0,0,0
"Oman","2024-02-25",0,0,0,0,0,0,0,0
"Oman","2024-02-26",0,0,0,0,0,0,0,0
"Oman","2024-02-27",0,0,0,0,0,0,0,0
"Oman","2024-02-28",0,0,0,0,0,0,0,0
"Oman","2024-02-29",0,0,0,0,0,0,0,0
"Oman","2024-03-01",0,0,0,0,0,0,0,0
"Oman","2024-03-02",0,0,0,0,0,0,0,0
"Oman","2024-03-03",0,0,0,0,0,0,0,0
"Oman","2024-03-04",0,0,0,0,0,0,0,0
"Oman","2024-03-05",0,0,0,0,0,0,0,0
"Oman","2024-03-06",0,0,0,0,0,0,0,0
"Oman","2024-03-07",0,0,0,0,0,0,0,0
"Oman","2024-03-08",0,0,0,0,0,0,0,0
"Oman","2024-03-09",0,0,0,0,0,0,0,0
"Oman","2024-03-10",0,0,0,0,0,0,0,0
"Oman","2024-03-11",0,0,0,0,0,0,0,0
"Oman","2024-03-12",0,0,0,0,0,0,0,0
"Oman","2024-03-13",0,0,0,0,0,0,0,0
"Oman","2024-03-14",0,0,0,0,0,0,0,0
"Oman","2024-03-15",0,0,0,0,0,0,0,0
"Oman","2024-03-16",0,0,0,0,0,0,0,0
"Oman","2024-03-17",0,0,0,0,0,0,0,0
"Oman","2024-03-18",0,0,0,0,0,0,0,0
"Oman","2024-03-19",0,0,0,0,0,0,0,0
"Oman","2024-03-20",0,0,0,0,0,0,0,0
"Oman","2024-03-21",0,0,0,0,0,0,0,0
"Oman","2024-03-22",0,0,0,0,0,0,0,0
"Oman","2024-03-23",0,0,0,0,0,0,0,0
"Oman","2024-03-24",0,0,0,0,0,0,0,0
"Oman","2024-03-25",0,0,0,0,0,0,0,0
"Oman","2024-03-26",0,0,0,0,0,0,0,0
"Oman","2024-03-27",0,0,0,0,0,0,0,0
"Oman","2024-03-28",0,0,0,0,0,0,0,0
"Oman","2024-03-29",0,0,0,0,0,0,0,0
"Oman","2024-03-30",0,0,0,0,0,0,0,0
"Oman","2024-03-31",0,0,0,0,0,0,0,0
"Oman","2024-04-01",0,0,0,0,0,0,0,0
"Oman","2024-04-02",0,0,0,0,0,0,0,0
"Oman","2024-04-03",0,0,0,0,0,0,0,0
"Oman","2024-04-04",0,0,0,0,0,0,0,0
"Oman","2024-04-05",0,0,0,0,0,0,0,0
"Oman","2024-04-06",0,0,0,0,0,0,0,0
"Oman","2024-04-07",0,0,0,0,0,0,0,0
"Oman","2024-04-08",0,0,0,0,0,0,0,0
"Oman","2024-04-09",0,0,0,0,0,0,0,0
"Oman","2024-04-10",0,0,0,0,0,0,0,0
"Oman","2024-04-11",0,0,0,0,0,0,0,0
"Oman","2024-04-12",0,0,0,0,0,0,0,0
"Oman","2024-04-13",0,0,0,0,0,0,0,0
"Oman","2024-04-14",0,0,0,0,0,0,0,0
"Oman","2024-04-15",0,0,0,0,0,0,0,0
"Oman","2024-04-16",0,0,0,0,0,0,0,0
"Oman","2024-04-17",0,0,0,0,0,0,0,0
"Oman","2024-04-18",0,0,0,0,0,0,0,0
"Oman","2024-04-19",0,0,0,0,0,0,0,0
"Oman","2024-04-20",0,0,0,0,0,0,0,0
"Oman","2024-04-21",0,0,0,0,0,0,0,0
"Oman","2024-04-22",0,0,0,0,0,0,0,0
"Oman","2024-04-23",0,0,0,0,0,0,0,0
"Oman","2024-04-24",0,0,0,0,0,0,0,0
"Oman","2024-04-25",0,0,0,0,0,0,0,0
"Oman","2024-04-26",0,0,0,0,0,0,0,0
"Oman","2024-04-27",0,0,0,0,0,0,0,0
"Oman","2024-04-28",0,0,0,0,0,0,0,0
"Oman","2024-04-29",0,0,0,0,0,0,0,0
"Oman","2024-04-30",0,0,0,0,0,0,0,0
"Oman","2024-05-01",0,0,0,0,0,0,0,0
"Oman","2024-05-02",0,0,0,0,0,0,0,0
"Oman","2024-05-03",0,0,0,0,0,0,0,0
"Oman","2024-05-04",0,0,0,0,0,0,0,0
"Oman","2024-05-05",0,0,0,0,0,0,0,0
"Oman","2024-05-06",0,0,0,0,0,0,0,0
"Oman","2024-05-07",0,0,0,0,0,0,0,0
"Oman","2024-05-08",0,0,0,0,0,0,0,0
"Oman","2024-05-09",0,0,0,0,0,0,0,0
"Oman","2024-05-10",0,0,0,0,0,0,0,0
"Oman","2024-05-11",0,0,0,0,0,0,0,0
"Oman","2024-05-12",0,0,0,0,0,0,0,0
"Oman","2024-05-13",0,0,0,0,0,0,0,0
"Oman","2024-05-14",0,0,0,0,0,0,0,0
"Oman","2024-05-15",0,0,0,0,0,0,0,0
"Oman","2024-05-16",0,0,0,0,0,0,0,0
"Oman","2024-05-17",0,0,0,0,0,0,0,0
"Oman","2024-05-18",0,0,0,0,0,0,0,0
"Oman","2024-05-19",0,0,0,0,0,0,0,0
"Oman","2024-05-20",0,0,0,0,0,0,0,0
"Oman","2024-05-21",0,0,0,0,0,0,0,0
"Oman","2024-05-22",0,0,0,0,0,0,0,0
"Oman","2024-05-23",0,0,0,0,0,0,0,0
"Oman","2024-05-24",0,0,0,0,0,0,0,0
"Oman","2024-05-25",0,0,0,0,0,0,0,0
"Oman","2024-05-26",0,0,0,0,0,0,0,0
"Oman","2024-05-27",0,0,0,0,0,0,0,0
"Oman","2024-05-28",0,0,0,0,0,0,0,0
"Oman","2024-05-29",0,0,0,0,0,0,0,0
"Oman","2024-05-30",0,0,0,0,0,0,0,0
"Oman","2024-05-31",0,0,0,0,0,0,0,0
"Oman","2024-06-01",0,0,0,0,0,0,0,0
"Oman","2024-06-02",0,0,0,0,0,0,0,0
"Oman","2024-06-03",0,0,0,0,0,0,0,0
"Oman","2024-06-04",0,0,0,0,0,0,0,0
"Oman","2024-06-05",0,0,0,0,0,0,0,0
"Oman","2024-06-06",0,0,0,0,0,0,0,0
"Oman","2024-06-07",0,0,0,0,0,0,0,0
"Oman","2024-06-08",0,0,0,0,0,0,0,0
"Oman","2024-06-09",0,0,0,0,0,0,0,0
"Oman","2024-06-10",0,0,0,0,0,0,0,0
"Oman","2024-06-11",0,0,0,0,0,0,0,0
"Oman","2024-06-12",0,0,0,0,0,0,0,0
"Oman","2024-06-13",0,0,0,0,0,0,0,0
"Oman","2024-06-14",0,0,0,0,0,0,0,0
"Oman","2024-06-15",0,0,0,0,0,0,0,0
"Oman","2024-06-16",0,0,0,0,0,0,0,0
"Oman","2024-06-17",0,0,0,0,0,0,0,0
"Oman","2024-06-18",0,0,0,0,0,0,0,0
"Oman","2024-06-19",0,0,0,0,0,0,0,0
"Oman","2024-06-20",0,0,0,0,0,0,0,0
"Oman","2024-06-21",0,0,0,0,0,0,0,0
"Oman","2024-06-22",0,0,0,0,0,0,0,0
"Oman","2024-06-23",0,0,0,0,0,0,0,0
"Oman","2024-06-24",0,0,0,0,0,0,0,0
"Oman","2024-06-25",0,0,0,0,0,0,0,0
"Oman","2024-06-26",0,0,0,0,0,0,0,0
"Oman","2024-06-27",0,0,0,0,0,0,0,0
"Oman","2024-06-28",0,0,0,0,0,0,0,0
"Oman","2024-06-29",0,0,0,0,0,0,0,0
"Oman","2024-06-30",0,0,0,0,0,0,0,0
"Oman","2024-07-01",0,0,0,0,0,0,0,0
"Oman","2024-07-02",0,0,0,0,0,0,0,0
"Oman","2024-07-03",0,0,0,0,0,0,0,0
"Oman","2024-07-04",0,0,0,0,0,0,0,0
"Oman","2024-07-05",0,0,0,0,0,0,0,0
"Oman","2024-07-06",0,0,0,0,0,0,0,0
"Oman","2024-07-07",0,0,0,0,0,0,0,0
"Oman","2024-07-08",0,0,0,0,0,0,0,0
"Oman","2024-07-09",0,0,0,0,0,0,0,0
"Oman","2024-07-10",0,0,0,0,0,0,0,0
"Oman","2024-07-11",0,0,0,0,0,0,0,0
"Oman","2024-07-12",0,0,0,0,0,0,0,0
"Oman","2024-07-13",0,0,0,0,0,0,0,0
"Oman","2024-07-14",0,0,0,0,0,0,0,0
"Oman","2024-07-15",0,0,0,0,0,0,0,0
"Oman","2024-07-16",0,0,0,0,0,0,0,0
"Oman","2024-07-17",0,0,0,0,0,0,0,0
"Oman","2024-07-18",0,0,0,0,0,0,0,0
"Oman","2024-07-19",0,0,0,0,0,0,0,0
"Oman","2024-07-20",0,0,0,0,0,0,0,0
"Oman","2024-07-21",0,0,0,0,0,0,0,0
"Oman","2024-07-22",0,0,0,0,0,0,0,0
"Oman","2024-07-23",0,0,0,0,0,0,0,0
"Oman","2024-07-24",0,0,0,0,0,0,0,0
"Oman","2024-07-25",0,0,0,0,0,0,0,0
"Oman","2024-07-26",0,0,0,0,0,0,0,0
"Oman","2024-07-27",0,0,0,0,0,0,0,0
"Oman","2024-07-28",0,0,0,0,0,0,0,0
"Oman","2024-07-29",0,0,0,0,0,0,0,0
"Oman","2024-07-30",0,0,0,0,0,0,0,0
"Oman","2024-07-31",0,0,0,0,0,0,0,0
"Oman","2024-08-01",0,0,0,0,0,0,0,0
"Oman","2024-08-02",0,0,0,0,0,0,0,0
"Oman","2024-08-03",0,0,0,0,0,0,0,0
"Oman","2024-08-04",0,0,0,0,0,0,0,0
"Oman","2024-08-05",0,0,0,0,0,0,0,0
"Oman","2024-08-06",0,0,0,0,0,0,0,0
"Oman","2024-08-07",0,0,0,0,0,0,0,0
"Oman","2024-08-08",0,0,0,0,0,0,0,0
"Oman","2024-08-09",0,0,0,0,0,0,0,0
"Oman","2024-08-10",0,0,0,0,0,0,0,0
"Oman","2024-08-11",0,0,0,0,0,0,0,0
"Oman","2024-08-12",0,0,0,0,0,0,0,0
"Oman","2024-08-13",0,0,0,0,0,0,0,0
"Oman","2024-08-14",0,0,0,0,0,0,0,0
"Oman","2024-08-15",0,0,0,0,0,0,0,0
"Oman","2024-08-16",0,0,0,0,0,0,0,0
"Oman","2024-08-17",0,0,0,0,0,0,0,0
"Oman","2024-08-18",0,0,0,0,0,0,0,0
"Oman","2024-08-19",0,0,0,0,0,0,0,0
"Oman","2024-08-20",0,0,0,0,0,0,0,0
"Oman","2024-08-21",0,0,0,0,0,0,0,0
"Oman","2024-08-22",0,0,0,0,0,0,0,0
"Oman","2024-08-23",0,0,0,0,0,0,0,0
"Oman","2024-08-24",0,0,0,0,0,0,0,0
"Oman","2024-08-25",0,0,0,0,0,0,0,0
"Oman","2024-08-26",0,0,0,0,0,0,0,0
"Oman","2024-08-27",0,0,0,0,0,0,0,0
"Oman","2024-08-28",0,0,0,0,0,0,0,0
"Oman","2024-08-29",0,0,0,0,0,0,0,0
"Oman","2024-08-30",0,0,0,0,0,0,0,0
"Oman","2024-08-31",0,0,0,0,0,0,0,0
"Oman","2024-09-01",0,0,0,0,0,0,0,0
"Oman","2024-09-02",0,0,0,0,0,0,0,0
"Oman","2024-09-03",0,0,0,0,0,0,0,0
"Oman","2024-09-04",0,0,0,0,0,0,0,0
"Oman","2024-09-05",0,0,0,0,0,0,0,0
"Oman","2024-09-06",0,0,0,0,0,0,0,0
"Oman","2024-09-07",0,0,0,0,0,0,0,0
"Oman","2024-09-08",0,0,0,0,0,0,0,0
"Oman","2024-09-09",0,0,0,0,0,0,0,0
"Oman","2024-09-10",0,0,0,0,0,0,0,0
"Oman","2024-09-11",0,0,0,0,0,0,0,0
"Oman","2024-09-12",0,0,0,0,0,0,0,0
"Oman","2024-09-13",0,0,0,0,0,0,0,0
"Oman","2024-09-14",0,0,0,0,0,0,0,0
"Oman","2024-09-15",0,0,0,0,0,0,0,0
"Oman","2024-09-16",0,0,0,0,0,0,0,0
"Oman","2024-09-17",0,0,0,0,0,0,0,0
"Oman","2024-09-18",0,0,0,0,0,0,0,0
"Oman","2024-09-19",0,0,0,0,0,0,0,0
"Oman","2024-09-20",0,0,0,0,0,0,0,0
"Oman","2024-09-21",0,0,0,0,0,0,0,0
"Oman","2024-09-22",0,0,0,0,0,0,0,0
"Oman","2024-09-23",0,0,0,0,0,0,0,0
"Oman","2024-09-24",0,0,0,0,0,0,0,0
"Oman","2024-09-25",0,0,0,0,0,0,0,0
"Oman","2024-09-26",0,0,0,0,0,0,0,0
"Oman","2024-09-27",0,0,0,0,0,0,0,0
"Oman","2024-09-28",0,0,0,0,0,0,0,0
"Oman","2024-09-29",0,0,0,0,0,0,0,0
"Oman","2024-09-30",0,0,0,0,0,0,0,0
"Oman","2024-10-01",0,0,0,0,0,0,0,0
"Oman","2024-10-02",0,1,1,0,1,1,0,0
"Oman","2024-10-03",0,0,1,0,0,1,0,0
"Oman","2024-10-04",0,0,1,0,0,1,0,0
"Oman","2024-10-05",0,0,1,0,0,1,0,0
"Oman","2024-10-06",0,0,1,0,0,1,0,0
"Oman","2024-10-07",0,0,1,0,0,1,0,0
"Oman","2024-10-08",0,0,1,0,0,1,0,0
"Oman","2024-10-09",0,0,1,0,0,1,0,0
"Oman","2024-10-10",0,0,1,0,0,1,0,0
"Oman","2024-10-11",0,0,1,0,0,1,0,0
"Oman","2024-10-12",0,0,1,0,0,1,0,0
"Oman","2024-10-13",0,0,1,0,0,1,0,0
"Oman","2024-10-14",0,0,1,0,0,1,0,0
"Oman","2024-10-15",0,0,1,0,0,1,0,0
"Oman","2024-10-16",0,0,1,0,0,1,0,0
"Oman","2024-10-17",0,0,1,0,0,1,0,0
"Oman","2024-10-18",0,0,1,0,0,1,0,0
"Oman","2024-10-19",0,0,1,0,0,1,0,0
"Oman","2024-10-20",0,0,1,0,0,1,0,0
"Oman","2024-10-21",0,0,1,0,0,1,0,0
"Oman","2024-10-22",0,0,1,0,0,1,0,0
"Oman","2024-10-23",0,0,1,0,0,1,0,0
"Oman","2024-10-24",0,0,1,0,0,1,0,0
"Oman","2024-10-25",0,0,1,0,0,1,0,0
"Oman","2024-10-26",0,0,1,0,0,1,0,0
"Oman","2024-10-27",0,0,1,0,0,1,0,0
"Oman","2024-10-28",0,0,1,0,0,1,0,0
"Oman","2024-10-29",0,0,1,0,0,1,0,0
"Oman","2024-10-30",0,0,1,0,0,1,0,0
"Oman","2024-10-31",0,0,1,0,0,1,0,0
"Oman","2024-11-01",0,0,1,0,0,1,0,0
"Oman","2024-11-02",0,0,1,0,0,1,0,0
"Oman","2024-11-03",0,0,1,0,0,1,0,0
"Oman","2024-11-04",0,0,1,0,0,1,0,0
"Oman","2024-11-05",0,0,1,0,0,1,0,0
"Oman","2024-11-06",0,0,1,0,1,2,0,0
"Oman","2024-11-07",0,0,1,0,0,2,0,0
"Oman","2024-11-08",0,0,1,0,0,2,0,0
"Oman","2024-11-09",0,0,1,0,0,2,0,0
"Oman","2024-11-10",0,0,1,0,0,2,0,0
"Oman","2024-11-11",0,0,1,0,0,2,0,0
"Oman","2024-11-12",0,0,1,0,0,2,0,0
"Oman","2024-11-13",0,0,1,0,0,2,0,0
"Oman","2024-11-14",0,0,1,0,0,2,0,0
"Oman","2024-11-15",0,0,1,0,0,2,0,0
"Oman","2024-11-16",0,0,1,0,0,2,0,0
"Oman","2024-11-17",0,0,1,0,0,2,0,0
"Oman","2024-11-18",0,0,1,0,0,2,0,0
"Oman","2024-11-19",0,0,1,0,0,2,0,0
"Oman","2024-11-20",0,0,1,0,0,2,0,0
"Oman","2024-11-21",0,0,1,0,0,2,0,0
"Oman","2024-11-22",0,0,1,0,0,2,0,0
"Oman","2024-11-23",0,0,1,0,0,2,0,0
"Oman","2024-11-24",0,0,1,0,0,2,0,0
"Oman","2024-11-25",0,0,1,0,0,2,0,0
"Oman","2024-11-26",0,0,1,0,0,2,0,0
"Oman","2024-11-27",0,0,1,0,0,2,0,0
"Oman","2024-11-28",0,0,1,0,0,2,0,0
"Oman","2024-11-29",0,0,1,0,0,2,0,0
"Oman","2024-11-30",0,0,1,0,0,2,0,0
"Oman","2024-12-01",0,0,1,0,0,2,0,0
"Oman","2024-12-02",0,0,1,0,0,2,0,0
"Oman","2024-12-03",0,0,1,0,0,2,0,0
"Oman","2024-12-04",0,0,1,0,0,2,0,0
"Oman","2024-12-05",0,0,1,0,0,2,0,0
"Oman","2024-12-06",0,0,1,0,0,2,0,0
"Oman","2024-12-07",0,0,1,0,0,2,0,0
"Oman","2024-12-08",0,0,1,0,0,2,0,0
"Oman","2024-12-09",0,1,2,0,0,2,0,0
"Oman","2024-12-10",0,0,2,0,0,2,0,0
"Oman","2024-12-11",0,0,2,0,0,2,0,0
"Oman","2024-12-12",0,0,2,0,0,2,0,0
"Oman","2024-12-13",0,0,2,0,0,2,0,0
"Oman","2024-12-14",0,0,2,0,0,2,0,0
"Oman","2024-12-15",0,0,2,0,0,2,0,0
"Oman","2024-12-16",0,0,2,0,0,2,0,0
"Oman","2024-12-17",0,0,2,0,0,2,0,0
"Oman","2024-12-18",0,0,2,0,0,2,0,0
"Oman","2024-12-19",0,0,2,0,0,2,0,0
"Oman","2024-12-20",0,0,2,0,0,2,0,0
"Oman","2024-12-21",0,0,2,0,0,2,0,0
"Oman","2024-12-22",0,0,2,0,0,2,0,0
"Oman","2024-12-23",0,0,2,0,0,2,0,0
"Oman","2024-12-24",0,0,2,0,0,2,0,0
"Oman","2024-12-25",0,0,2,0,0,2,0,0
"Oman","2024-12-26",0,0,2,0,0,2,0,0
"Oman","2024-12-27",0,0,2,0,0,2,0,0
"Oman","2024-12-28",0,0,2,0,0,2,0,0
"Oman","2024-12-29",0,0,2,0,0,2,0,0
"Oman","2024-12-30",0,0,2,0,0,2,0,0
"Oman","2024-12-31",0,0,2,0,0,2,0,0
"Oman","2025-01-01",0,0,2,0,0,2,0,0
"Oman","2025-01-02",0,0,2,0,0,2,0,0
"Oman","2025-01-03",0,0,2,0,0,2,0,0
"Oman","2025-01-04",0,0,2,0,0,2,0,0
"Oman","2025-01-05",0,0,2,0,0,2,0,0
"Oman","2025-01-06",0,0,2,0,0,2,0,0
"Oman","2025-01-07",0,0,2,0,0,2,0,0
"Oman","2025-01-08",0,0,2,0,0,2,0,0
"Oman","2025-01-09",0,0,2,0,0,2,0,0
"Oman","2025-01-10",0,0,2,0,0,2,0,0
"Oman","2025-01-11",0,0,2,0,1,3,0,0
"Oman","2025-01-12",0,0,2,0,0,3,0,0
"Oman","2025-01-13",0,0,2,0,0,3,0,0
"Oman","2025-01-14",0,0,2,0,0,3,0,0
"Oman","2025-01-15",0,0,2,0,0,3,0,0
"Oman","2025-01-16",0,0,2,0,0,3,0,0
"Oman","2025-01-17",0,0,2,0,0,3,0,0
"Oman","2025-01-18",0,0,2,0,0,3,0,0
"Oman","2025-01-19",0,0,2,0,0,3,0,0
"Oman","2025-01-20",0,0,2,0,0,3,0,0
"Oman","2025-01-21",0,0,2,0,0,3,0,0
"Oman","2025-01-22",0,0,2,0,0,3,0,0
"Oman","2025-01-23",0,0,2,0,0,3,0,0
"Oman","2025-01-24",0,0,2,0,0,3,0,0
"Oman","2025-01-25",0,0,2,0,0,3,0,0
"Oman","2025-01-26",0,0,2,0,0,3,0,0
"Oman","2025-01-27",0,0,2,0,0,3,0,0
"Oman","2025-01-28",0,0,2,0,0,3,0,0
"Oman","2025-01-29",0,0,2,0,0,3,0,0
"Oman","2025-01-30",0,0,2,0,0,3,0,0
"Oman","2025-01-31",0,0,2,0,0,3,0,0
"Oman","2025-02-01",0,0,2,0,0,3,0,0
"Oman","2025-02-02",0,0,2,0,0,3,0,0
"Oman","2025-02-03",0,0,2,0,0,3,0,0
"Oman","2025-02-04",0,0,2,0,0,3,0,0
"Oman","2025-02-05",0,0,2,0,0,3,0,0
"Oman","2025-02-06",0,0,2,0,0,3,0,0
"Oman","2025-02-07",0,0,2,0,0,3,0,0
"Oman","2025-02-08",0,0,2,0,0,3,0,0
"Oman","2025-02-09",0,0,2,0,0,3,0,0
"Oman","2025-02-10",0,0,2,0,0,3,0,0
"Oman","2025-02-11",0,0,2,0,0,3,0,0
"Oman","2025-02-12",0,1,3,0,0,3,0,0
"Oman","2025-02-13",0,0,3,0,0,3,0,0
"Oman","2025-02-14",0,0,3,0,0,3,0,0
"Oman","2025-02-15",0,0,3,0,0,3,0,0
"Oman","2025-02-16",0,0,3,0,0,3,0,0
"Oman","2025-02-17",0,0,3,0,0,3,0,0
"Oman","2025-02-18",0,0,3,0,0,3,0,0
"Oman","2025-02-19",0,0,3,0,0,3,0,0
"Oman","2025-02-20",0,0,3,0,0,3,0,0
"Oman","2025-02-21",0,0,3,0,0,3,0,0
"Oman","2025-02-22",0,0,3,0,0,3,0,0
"Oman","2025-02-23",0,0,3,0,0,3,0,0
"Oman","2025-02-24",0,0,3,0,0,3,0,0
"Oman","2025-02-25",0,0,3,0,0,3,0,0
"Oman","2025-02-26",0,0,3,0,0,3,0,0
"Oman","2025-02-27",0,0,3,0,0,3,0,0
"Oman","2025-02-28",0,0,3,0,0,3,0,0
"Oman","2025-03-01",0,0,3,0,0,3,0,0
"Oman","2025-03-02",0,0,3,0,0,3,0,0
"Oman","2025-03-03",0,0,3,0,0,3,0,0
"Pakistan","2024-01-01",0,0,0,0,0,0,0,0
"Pakistan","2024-01-02",0,0,0,0,0,0,0,0
"Pakistan","2024-01-03",0,0,0,0,0,0,0,0
"Pakistan","2024-01-04",0,0,0,0,0,0,0,0
"Pakistan","2024-01-05",0,0,0,0,0,0,0,0
"Pakistan","2024-01-06",0,0,0,0,0,0,0,0
"Pakistan","2024-01-07",0,0,0,0,0,0,0,0
"Pakistan","2024-01-08",0,0,0,0,0,0,0,0
"Pakistan","2024-01-09",0,0,0,0,0,0,0,0
"Pakistan","2024-01-10",0,0,0,0,0,0,0,0
"Pakistan","2024-01-11",0,0,0,0,0,0,0,0
"Pakistan","2024-01-12",0,0,0,0,0,0,0,0
"Pakistan","2024-01-13",0,0,0,0,0,0,0,0
"Pakistan","2024-01-14",0,0,0,0,0,0,0,0
"Pakistan","2024-01-15",0,0,0,0,0,0,0,0
"Pakistan","2024-01-16",0,0,0,0,0,0,0,0
"Pakistan","2024-01-17",0,0,0,0,0,0,0,0
"Pakistan","2024-01-18",0,0,0,0,0,0,0,0
"Pakistan","2024-01-19",0,1,1,0,1,1,0,0
"Pakistan","2024-01-20",0,0,1,0,0,1,0,0
"Pakistan","2024-01-21",0,0,1,0,0,1,0,0
"Pakistan","2024-01-22",0,0,1,0,0,1,0,0
"Pakistan","2024-01-23",0,0,1,0,0,1,0,0
"Pakistan","2024-01-24",0,0,1,0,0,1,0,0
"Pakistan","2024-01-25",0,0,1,0,0,1,0,0
"Pakistan","2024-01-26",0,0,1,0,0,1,0,0
"Pakistan","2024-01-27",0,0,1,0,0,1,0,0
"Pakistan","2024-01-28",0,0,1,0,0,1,0,0
"Pakistan","2024-01-29",0,0,1,0,0,1,0,0
"Pakistan","2024-01-30",0,0,1,0,0,1,0,0
"Pakistan","2024-01-31",0,0,1,0,0,1,0,0
"Pakistan","2024-02-01",0,0,1,0,0,1,0,0
"Pakistan","2024-02-02",0,0,1,0,0,1,0,0
"Pakistan","2024-02-03",0,0,1,0,0,1,0,0
"Pakistan","2024-02-04",0,0,1,0,0,1,0,0
"Pakistan","2024-02-05",0,0,1,0,0,1,0,0
"Pakistan","2024-02-06",0,0,1,0,0,1,0,0
"Pakistan","2024-02-07",0,0,1,0,0,1,0,0
"Pakistan","2024-02-08",0,0,1,0,0,1,0,0
"Pakistan","2024-02-09",0,0,1,0,0,1,0,0
"Pakistan","2024-02-10",0,0,1,0,0,1,0,0
"Pakistan","2024-02-11",0,0,1,0,0,1,0,0
"Pakistan","2024-02-12",0,0,1,0,0,1,0,0
"Pakistan","2024-02-13",0,0,1,0,0,1,0,0
"Pakistan","2024-02-14",0,0,1,0,0,1,0,0
"Pakistan","2024-02-15",0,0,1,0,0,1,0,0
"Pakistan","2024-02-16",0,0,1,0,0,1,0,0
"Pakistan","2024-02-17",0,0,1,0,0,1,0,0
"Pakistan","2024-02-18",0,0,1,0,0,1,0,0
"Pakistan","2024-02-19",0,0,1,0,0,1,0,0
"Pakistan","2024-02-20",0,0,1,0,0,1,0,0
"Pakistan","2024-02-21",0,0,1,0,0,1,0,0
"Pakistan","2024-02-22",0,0,1,0,0,1,0,0
"Pakistan","2024-02-23",0,0,1,0,0,1,0,0
"Pakistan","2024-02-24",0,0,1,0,0,1,0,0
"Pakistan","2024-02-25",0,0,1,0,0,1,0,0
"Pakistan","2024-02-26",0,0,1,0,0,1,0,0
"Pakistan","2024-02-27",0,0,1,0,0,1,0,0
"Pakistan","2024-02-28",0,0,1,0,0,1,0,0
"Pakistan","2024-02-29",0,0,1,0,0,1,0,0
"Pakistan","2024-03-01",0,0,1,0,0,1,0,0
"Pakistan","2024-03-02",0,0,1,0,0,1,0,0
"Pakistan","2024-03-03",0,0,1,0,0,1,0,0
"Pakistan","2024-03-04",0,0,1,0,0,1,0,0
"Pakistan","2024-03-05",0,0,1,0,0,1,0,0
"Pakistan","2024-03-06",0,0,1,0,0,1,0,0
"Pakistan","2024-03-07",0,0,1,0,0,1,0,0
"Pakistan","2024-03-08",0,0,1,0,0,1,0,0
"Pakistan","2024-03-09",0,0,1,0,0,1,0,0
"Pakistan","2024-03-10",0,0,1,0,0,1,0,0
"Pakistan","2024-03-11",0,0,1,0,0,1,0,0
"Pakistan","2024-03-12",0,0,1,0,0,1,0,0
"Pakistan","2024-03-13",0,0,1,0,0,1,0,0
"Pakistan","2024-03-14",0,0,1,0,0,1,0,0
"Pakistan","2024-03-15",0,0,1,0,0,1,0,0
"Pakistan","2024-03-16",0,0,1,0,0,1,0,0
"Pakistan","2024-03-17",0,0,1,0,0,1,0,0
"Pakistan","2024-03-18",0,0,1,0,0,1,0,0
"Pakistan","2024-03-19",0,0,1,0,0,1,0,0
"Pakistan","2024-03-20",0,0,1,0,0,1,0,0
"Pakistan","2024-03-21",0,0,1,0,0,1,0,0
"Pakistan","2024-03-22",0,0,1,0,0,1,0,0
"Pakistan","2024-03-23",0,0,1,0,0,1,0,0
"Pakistan","2024-03-24",0,0,1,0,0,1,0,0
"Pakistan","2024-03-25",0,0,1,0,0,1,0,0
"Pakistan","2024-03-26",0,0,1,0,0,1,0,0
"Pakistan","2024-03-27",0,0,1,0,0,1,0,0
"Pakistan","2024-03-28",0,0,1,0,0,1,0,0
"Pakistan","2024-03-29",0,0,1,0,0,1,0,0
"Pakistan","2024-03-30",0,0,1,0,0,1,0,0
"Pakistan","2024-03-31",0,0,1,0,0,1,0,0
"Pakistan","2024-04-01",0,0,1,0,0,1,0,0
"Pakistan","2024-04-02",0,0,1,0,0,1,0,0
"Pakistan","2024-04-03",0,0,1,0,0,1,0,0
"Pakistan","2024-04-04",0,0,1,0,0,1,0,0
"Pakistan","2024-04-05",0,0,1,0,0,1,0,0
"Pakistan","2024-04-06",0,0,1,0,0,1,0,0
"Pakistan","2024-04-07",0,0,1,0,0,1,0,0
"Pakistan","2024-04-08",0,0,1,0,0,1,0,0
"Pakistan","2024-04-09",0,0,1,0,0,1,0,0
"Pakistan","2024-04-10",0,0,1,0,0,1,0,0
"Pakistan","2024-04-11",0,0,1,0,0,1,0,0
"Pakistan","2024-04-12",0,0,1,0,0,1,0,0
"Pakistan","2024-04-13",0,0,1,0,0,1,0,0
"Pakistan","2024-04-14",0,0,1,0,0,1,0,0
"Pakistan","2024-04-15",0,0,1,0,0,1,0,0
"Pakistan","2024-04-16",0,0,1,0,0,1,0,0
"Pakistan","2024-04-17",0,0,1,0,0,1,0,0
"Pakistan","2024-04-18",0,0,1,0,0,1,0,0
"Pakistan","2024-04-19",0,0,1,0,0,1,0,0
"Pakistan","2024-04-20",0,0,1,0,0,1,0,0
"Pakistan","2024-04-21",0,0,1,0,0,1,0,0
"Pakistan","2024-04-22",0,0,1,0,0,1,0,0
"Pakistan","2024-04-23",0,0,1,0,0,1,0,0
"Pakistan","2024-04-24",0,0,1,0,0,1,0,0
"Pakistan","2024-04-25",0,0,1,0,0,1,0,0
"Pakistan","2024-04-26",0,0,1,0,0,1,0,0
"Pakistan","2024-04-27",0,0,1,0,0,1,0,0
"Pakistan","2024-04-28",0,0,1,0,0,1,0,0
"Pakistan","2024-04-29",0,0,1,0,0,1,0,0
"Pakistan","2024-04-30",0,0,1,0,0,1,0,0
"Pakistan","2024-05-01",0,0,1,0,0,1,0,0
"Pakistan","2024-05-02",0,0,1,0,0,1,0,0
"Pakistan","2024-05-03",0,0,1,0,1,2,0,0
"Pakistan","2024-05-04",0,0,1,0,0,2,0,0
"Pakistan","2024-05-05",0,0,1,0,0,2,0,0
"Pakistan","2024-05-06",0,0,1,0,0,2,0,0
"Pakistan","2024-05-07",0,0,1,0,0,2,0,0
"Pakistan","2024-05-08",0,0,1,0,0,2,0,0
"Pakistan","2024-05-09",0,0,1,0,0,2,0,0
"Pakistan","2024-05-10",0,0,1,0,0,2,0,0
"Pakistan","2024-05-11",0,0,1,0,0,2,0,0
"Pakistan","2024-05-12",0,0,1,0,0,2,0,0
"Pakistan","2024-05-13",0,0,1,0,0,2,0,0
"Pakistan","2024-05-14",0,0,1,0,0,2,0,0
"Pakistan","2024-05-15",0,0,1,0,0,2,0,0
"Pakistan","2024-05-16",0,0,1,0,0,2,0,0
"Pakistan","2024-05-17",0,0,1,0,0,2,0,0
"Pakistan","2024-05-18",0,0,1,0,0,2,0,0
"Pakistan","2024-05-19",0,0,1,0,0,2,0,0
"Pakistan","2024-05-20",0,0,1,0,0,2,0,0
"Pakistan","2024-05-21",0,0,1,0,0,2,0,0
"Pakistan","2024-05-22",0,0,1,0,0,2,0,0
"Pakistan","2024-05-23",0,0,1,0,0,2,0,0
"Pakistan","2024-05-24",0,0,1,0,0,2,0,0
"Pakistan","2024-05-25",0,0,1,0,0,2,0,0
"Pakistan","2024-05-26",0,0,1,0,0,2,0,0
"Pakistan","2024-05-27",0,0,1,0,0,2,0,0
"Pakistan","2024-05-28",0,0,1,0,0,2,0,0
"Pakistan","2024-05-29",0,0,1,0,0,2,0,0
"Pakistan","2024-05-30",0,0,1,0,0,2,0,0
"Pakistan","2024-05-31",0,0,1,0,0,2,0,0
"Pakistan","2024-06-01",0,0,1,0,0,2,0,0
"Pakistan","2024-06-02",0,0,1,0,0,2,0,0
"Pakistan","2024-06-03",0,0,1,0,0,2,0,0
"Pakistan","2024-06-04",0,0,1,0,0,2,0,0
"Pakistan","2024-06-05",0,0,1,0,0,2,0,0
"Pakistan","2024-06-06",0,0,1,0,0,2,0,0
"Pakistan","2024-06-07",0,0,1,0,0,2,0,0
"Pakistan","2024-06-08",0,0,1,0,0,2,0,0
"Pakistan","2024-06-09",0,0,1,0,0,2,0,0
"Pakistan","2024-06-10",0,0,1,0,0,2,0,0
"Pakistan","2024-06-11",0,0,1,0,0,2,0,0
"Pakistan","2024-06-12",0,0,1,0,0,2,0,0
"Pakistan","2024-06-13",0,0,1,0,0,2,0,0
"Pakistan","2024-06-14",0,0,1,0,0,2,0,0
"Pakistan","2024-06-15",0,0,1,0,0,2,0,0
"Pakistan","2024-06-16",0,0,1,0,0,2,0,0
"Pakistan","2024-06-17",0,0,1,0,0,2,0,0
"Pakistan","2024-06-18",0,0,1,0,0,2,0,0
"Pakistan","2024-06-19",0,0,1,0,0,2,0,0
"Pakistan","2024-06-20",0,0,1,0,0,2,0,0
"Pakistan","2024-06-21",0,0,1,0,0,2,0,0
"Pakistan","2024-06-22",0,0,1,0,0,2,0,0
"Pakistan","2024-06-23",0,0,1,0,0,2,0,0
"Pakistan","2024-06-24",0,0,1,0,0,2,0,0
"Pakistan","2024-06-25",0,0,1,0,0,2,0,0
"Pakistan","2024-06-26",0,0,1,0,0,2,0,0
"Pakistan","2024-06-27",0,0,1,0,0,2,0,0
"Pakistan","2024-06-28",0,0,1,0,0,2,0,0
"Pakistan","2024-06-29",0,0,1,0,0,2,0,0
"Pakistan","2024-06-30",0,0,1,0,0,2,0,0
"Pakistan","2024-07-01",0,0,1,0,0,2,0,0
"Pakistan","2024-07-02",0,0,1,0,0,2,0,0
"Pakistan","2024-07-03",0,0,1,0,0,2,0,0
"Pakistan","2024-07-04",0,0,1,0,0,2,0,0
"Pakistan","2024-07-05",0,0,1,0,0,2,0,0
"Pakistan","2024-07-06",0,0,1,0,0,2,0,0
"Pakistan","2024-07-07",0,0,1,0,0,2,0,0
"Pakistan","2024-07-08",0,0,1,0,0,2,0,0
"Pakistan","2024-07-09",0,0,1,0,0,2,0,0
"Pakistan","2024-07-10",0,0,1,0,0,2,0,0
"Pakistan","2024-07-11",0,0,1,0,0,2,0,0
"Pakistan","2024-07-12",0,0,1,0,0,2,0,0
"Pakistan","2024-07-13",0,0,1,0,0,2,0,0
"Pakistan","2024-07-14",0,0,1,0,0,2,0,0
"Pakistan","2024-07-15",0,0,1,0,0,2,0,0
"Pakistan","2024-07-16",0,0,1,0,0,2,0,0
"Pakistan","2024-07-17",0,0,1,0,0,2,0,0
"Pakistan","2024-07-18",0,0,1,0,0,2,0,0
"Pakistan","2024-07-19",0,0,1,0,0,2,0,0
"Pakistan","2024-07-20",0,0,1,0,0,2,0,0
"Pakistan","2024-07-21",0,0,1,0,0,2,0,0
"Pakistan","2024-07-22",0,0,1,0,0,2,0,0
"Pakistan","2024-07-23",0,0,1,0,0,2,0,0
"Pakistan","2024-07-24",0,0,1,0,0,2,0,0
"Pakistan","2024-07-25",0,0,1,0,0,2,0,0
"Pakistan","2024-07-26",0,0,1,0,0,2,0,0
"Pakistan","2024-07-27",0,0,1,0,0,2,0,0
"Pakistan","2024-07-28",0,0,1,0,0,2,0,0
"Pakistan","2024-07-29",0,0,1,0,0,2,0,0
"Pakistan","2024-07-30",0,0,1,0,0,2,0,0
"Pakistan","2024-07-31",0,0,1,0,0,2,0,0
"Pakistan","2024-08-01",0,0,1,0,0,2,0,0
"Pakistan","2024-08-02",0,0,1,0,0,2,0,0
"Pakistan","2024-08-03",0,0,1,0,0,2,0,0
"Pakistan","2024-08-04",0,0,1,0,0,2,0,0
"Pakistan","2024-08-05",0,0,1,0,0,2,0,0
"Pakistan","2024-08-06",0,0,1,0,0,2,0,0
"Pakistan","2024-08-07",0,0,1,0,0,2,0,0
"Pakistan","2024-08-08",0,0,1,0,0,2,0,0
"Pakistan","2024-08-09",0,0,1,0,0,2,0,0
"Pakistan","2024-08-10",0,0,1,0,0,2,0,0
"Pakistan","2024-08-11",0,0,1,0,0,2,0,0
"Pakistan","2024-08-12",0,0,1,0,0,2,0,0
"Pakistan","2024-08-13",0,0,1,0,0,2,0,0
"Pakistan","2024-08-14",0,1,2,0,0,2,0,0
"Pakistan","2024-08-15",0,0,2,0,0,2,0,0
"Pakistan","2024-08-16",0,0,2,0,0,2,0,0
"Pakistan","2024-08-17",0,0,2,0,0,2,0,0
"Pakistan","2024-08-18",0,0,2,0,0,2,0,0
"Pakistan","2024-08-19",0,0,2,0,1,3,0,0
"Pakistan","2024-08-20",0,0,2,0,0,3,0,0
"Pakistan","2024-08-21",0,0,2,0,0,3,0,0
"Pakistan","2024-08-22",0,1,3,0,0,3,0,0
"Pakistan","2024-08-23",0,0,3,0,0,3,0,0
"Pakistan","2024-08-24",0,0,3,0,0,3,0,0
"Pakistan","2024-08-25",0,0,3,0,0,3,0,0
"Pakistan","2024-08-26",0,0,3,0,0,3,0,0
"Pakistan","2024-08-27",0,0,3,0,1,4,0,0
"Pakistan","2024-08-28",0,0,3,0,0,4,0,0
"Pakistan","2024-08-29",0,0,3,0,0,4,0,0
"Pakistan","2024-08-30",0,1,4,0,0,4,0,0
"Pakistan","2024-08-31",0,0,4,0,0,4,0,0
"Pakistan","2024-09-01",0,1,5,0,1,5,0,0
"Pakistan","2024-09-02",0,0,5,0,0,5,0,0
"Pakistan","2024-09-03",0,0,5,0,0,5,0,0
"Pakistan","2024-09-04",0,0,5,0,0,5,0,0
"Pakistan","2024-09-05",0,0,5,0,0,5,0,0
"Pakistan","2024-09-06",0,0,5,0,1,6,0,0
"Pakistan","2024-09-07",0,0,5,0,0,6,0,0
"Pakistan","2024-09-08",0,0,5,0,0,6,0,0
"Pakistan","2024-09-09",0,0,5,0,0,6,0,0
"Pakistan","2024-09-10",0,1,6,0,0,6,0,0
"Pakistan","2024-09-11",0,0,6,0,0,6,0,0
"Pakistan","2024-09-12",0,0,6,0,0,6,0,0
"Pakistan","2024-09-13",0,0,6,0,1,7,0,0
"Pakistan","2024-09-14",0,0,6,0,0,7,0,0
"Pakistan","2024-09-15",0,1,7,0,0,7,0,0
"Pakistan","2024-09-16",0,0,7,0,0,7,0,0
"Pakistan","2024-09-17",0,0,7,0,0,7,0,0
"Pakistan","2024-09-18",0,0,7,0,0,7,0,0
"Pakistan","2024-09-19",0,0,7,0,0,7,0,0
"Pakistan","2024-09-20",0,0,7,0,0,7,0,0
"Pakistan","2024-09-21",0,0,7,0,0,7,0,0
"Pakistan","2024-09-22",0,0,7,0,0,7,0,0
"Pakistan","2024-09-23",0,0,7,0,0,7,0,0
"Pakistan","2024-09-24",0,0,7,0,0,7,0,0
"Pakistan","2024-09-25",0,0,7,0,0,7,0,0
"Pakistan","2024-09-26",0,0,7,0,0,7,0,0
"Pakistan","2024-09-27",0,0,7,0,0,7,0,0
"Pakistan","2024-09-28",0,0,7,0,0,7,0,0
"Pakistan","2024-09-29",0,0,7,0,0,7,0,0
"Pakistan","2024-09-30",0,0,7,0,0,7,0,0
"Pakistan","2024-10-01",0,0,7,0,0,7,0,0
"Pakistan","2024-10-02",0,0,7,0,0,7,0,0
"Pakistan","2024-10-03",0,0,7,0,0,7,0,0
"Pakistan","2024-10-04",0,0,7,0,0,7,0,0
"Pakistan","2024-10-05",0,0,7,0,0,7,0,0
"Pakistan","2024-10-06",0,0,7,0,0,7,0,0
"Pakistan","2024-10-07",0,0,7,0,0,7,0,0
"Pakistan","2024-10-08",0,0,7,0,0,7,0,0
"Pakistan","2024-10-09",0,0,7,0,0,7,0,0
"Pakistan","2024-10-10",0,0,7,0,0,7,0,0
"Pakistan","2024-10-11",0,0,7,0,0,7,0,0
"Pakistan","2024-10-12",0,0,7,0,0,7,0,0
"Pakistan","2024-10-13",0,0,7,0,0,7,0,0
"Pakistan","2024-10-14",0,0,7,0,0,7,0,0
"Pakistan","2024-10-15",0,0,7,0,0,7,0,0
"Pakistan","2024-10-16",0,0,7,0,0,7,0,0
"Pakistan","2024-10-17",0,0,7,0,0,7,0,0
"Pakistan","2024-10-18",0,0,7,0,0,7,0,0
"Pakistan","2024-10-19",0,0,7,0,0,7,0,0
"Pakistan","2024-10-20",0,0,7,0,0,7,0,0
"Pakistan","2024-10-21",0,0,7,0,0,7,0,0
"Pakistan","2024-10-22",0,0,7,0,0,7,0,0
"Pakistan","2024-10-23",0,0,7,0,1,8,0,0
"Pakistan","2024-10-24",0,0,7,0,0,8,0,0
"Pakistan","2024-10-25",0,0,7,0,0,8,0,0
"Pakistan","2024-10-26",0,0,7,0,0,8,0,0
"Pakistan","2024-10-27",0,0,7,0,0,8,0,0
"Pakistan","2024-10-28",0,0,7,0,0,8,0,0
"Pakistan","2024-10-29",0,0,7,0,0,8,0,0
"Pakistan","2024-10-30",0,0,7,0,0,8,0,0
"Pakistan","2024-10-31",0,0,7,0,0,8,0,0
"Pakistan","2024-11-01",0,0,7,0,0,8,0,0
"Pakistan","2024-11-02",0,0,7,0,0,8,0,0
"Pakistan","2024-11-03",0,0,7,0,0,8,0,0
"Pakistan","2024-11-04",0,0,7,0,0,8,0,0
"Pakistan","2024-11-05",0,0,7,0,0,8,0,0
"Pakistan","2024-11-06",0,0,7,0,0,8,0,0
"Pakistan","2024-11-07",0,0,7,0,0,8,0,0
"Pakistan","2024-11-08",0,0,7,0,0,8,0,0
"Pakistan","2024-11-09",0,0,7,0,0,8,0,0
"Pakistan","2024-11-10",0,0,7,0,0,8,0,0
"Pakistan","2024-11-11",0,0,7,0,0,8,0,0
"Pakistan","2024-11-12",0,0,7,0,0,8,0,0
"Pakistan","2024-11-13",0,0,7,0,0,8,0,0
"Pakistan","2024-11-14",0,0,7,0,0,8,0,0
"Pakistan","2024-11-15",0,0,7,0,0,8,0,0
"Pakistan","2024-11-16",0,0,7,0,0,8,0,0
"Pakistan","2024-11-17",0,0,7,0,0,8,0,0
"Pakistan","2024-11-18",0,0,7,0,0,8,0,0
"Pakistan","2024-11-19",0,0,7,0,0,8,0,0
"Pakistan","2024-11-20",0,0,7,0,0,8,0,0
"Pakistan","2024-11-21",0,0,7,0,0,8,0,0
"Pakistan","2024-11-22",0,0,7,0,0,8,0,0
"Pakistan","2024-11-23",0,0,7,0,0,8,0,0
"Pakistan","2024-11-24",0,0,7,0,0,8,0,0
"Pakistan","2024-11-25",0,0,7,0,0,8,0,0
"Pakistan","2024-11-26",0,0,7,0,0,8,0,0
"Pakistan","2024-11-27",0,0,7,0,0,8,0,0
"Pakistan","2024-11-28",0,0,7,0,0,8,0,0
"Pakistan","2024-11-29",0,1,8,0,0,8,0,0
"Pakistan","2024-11-30",0,0,8,0,0,8,0,0
"Pakistan","2024-12-01",0,0,8,0,0,8,0,0
"Pakistan","2024-12-02",0,0,8,0,0,8,0,0
"Pakistan","2024-12-03",0,0,8,0,0,8,0,0
"Pakistan","2024-12-04",0,0,8,0,0,8,0,0
"Pakistan","2024-12-05",0,0,8,0,0,8,0,0
"Pakistan","2024-12-06",0,0,8,0,0,8,0,0
"Pakistan","2024-12-07",0,0,8,0,0,8,0,0
"Pakistan","2024-12-08",0,0,8,0,0,8,0,0
"Pakistan","2024-12-09",0,0,8,0,0,8,0,0
"Pakistan","2024-12-10",0,0,8,0,0,8,0,0
"Pakistan","2024-12-11",0,0,8,0,0,8,0,0
"Pakistan","2024-12-12",0,0,8,0,0,8,0,0
"Pakistan","2024-12-13",0,0,8,0,0,8,0,0
"Pakistan","2024-12-14",0,0,8,0,0,8,0,0
"Pakistan","2024-12-15",0,0,8,0,0,8,0,0
"Pakistan","2024-12-16",0,0,8,0,0,8,0,0
"Pakistan","2024-12-17",0,0,8,0,0,8,0,0
"Pakistan","2024-12-18",0,0,8,0,0,8,0,0
"Pakistan","2024-12-19",0,0,8,0,0,8,0,0
"Pakistan","2024-12-20",0,0,8,0,0,8,0,0
"Pakistan","2024-12-21",0,0,8,0,0,8,0,0
"Pakistan","2024-12-22",0,0,8,0,0,8,0,0
"Pakistan","2024-12-23",0,0,8,0,0,8,0,0
"Pakistan","2024-12-24",0,0,8,0,0,8,0,0
"Pakistan","2024-12-25",0,0,8,0,0,8,0,0
"Pakistan","2024-12-26",0,0,8,0,0,8,0,0
"Pakistan","2024-12-27",0,0,8,0,0,8,0,0
"Pakistan","2024-12-28",0,0,8,0,0,8,0,0
"Pakistan","2024-12-29",0,0,8,0,0,8,0,0
"Pakistan","2024-12-30",0,0,8,0,1,9,0,0
"Pakistan","2024-12-31",0,0,8,0,0,9,0,0
"Pakistan","2025-01-01",0,0,8,0,0,9,0,0
"Pakistan","2025-01-02",0,0,8,0,0,9,0,0
"Pakistan","2025-01-03",0,0,8,0,0,9,0,0
"Pakistan","2025-01-04",0,0,8,0,0,9,0,0
"Pakistan","2025-01-05",0,0,8,0,0,9,0,0
"Pakistan","2025-01-06",0,0,8,0,0,9,0,0
"Pakistan","2025-01-07",0,0,8,0,0,9,0,0
"Pakistan","2025-01-08",0,0,8,0,0,9,0,0
"Pakistan","2025-01-09",0,0,8,0,0,9,0,0
"Pakistan","2025-01-10",0,0,8,0,0,9,0,0
"Pakistan","2025-01-11",0,0,8,0,0,9,0,0
"Pakistan","2025-01-12",0,0,8,0,0,9,0,0
"Pakistan","2025-01-13",0,0,8,0,0,9,0,0
"Pakistan","2025-01-14",0,0,8,0,0,9,0,0
"Pakistan","2025-01-15",0,0,8,0,0,9,0,0
"Pakistan","2025-01-16",0,0,8,0,0,9,0,0
"Pakistan","2025-01-17",0,0,8,0,0,9,0,0
"Pakistan","2025-01-18",0,0,8,0,0,9,0,0
"Pakistan","2025-01-19",0,0,8,0,0,9,0,0
"Pakistan","2025-01-20",0,0,8,0,0,9,0,0
"Pakistan","2025-01-21",0,0,8,0,0,9,0,0
"Pakistan","2025-01-22",0,0,8,0,0,9,0,0
"Pakistan","2025-01-23",0,0,8,0,0,9,0,0
"Pakistan","2025-01-24",0,0,8,0,0,9,0,0
"Pakistan","2025-01-25",0,0,8,0,0,9,0,0
"Pakistan","2025-01-26",0,0,8,0,0,9,0,0
"Pakistan","2025-01-27",0,0,8,0,0,9,0,0
"Pakistan","2025-01-28",0,0,8,0,0,9,0,0
"Pakistan","2025-01-29",0,1,9,0,0,9,0,0
"Pakistan","2025-01-30",0,0,9,0,0,9,0,0
"Pakistan","2025-01-31",0,0,9,0,0,9,0,0
"Pakistan","2025-02-01",0,0,9,0,0,9,0,0
"Pakistan","2025-02-02",0,0,9,0,0,9,0,0
"Pakistan","2025-02-03",0,0,9,0,0,9,0,0
"Pakistan","2025-02-04",0,0,9,0,0,9,0,0
"Pakistan","2025-02-05",0,0,9,0,0,9,0,0
"Pakistan","2025-02-06",0,0,9,0,0,9,0,0
"Pakistan","2025-02-07",0,0,9,0,0,9,0,0
"Pakistan","2025-02-08",0,0,9,0,0,9,0,0
"Pakistan","2025-02-09",0,0,9,0,0,9,0,0
"Pakistan","2025-02-10",0,0,9,0,0,9,0,0
"Pakistan","2025-02-11",0,0,9,0,0,9,0,0
"Pakistan","2025-02-12",0,0,9,0,0,9,0,0
"Pakistan","2025-02-13",0,0,9,0,0,9,0,0
"Pakistan","2025-02-14",0,0,9,0,0,9,0,0
"Pakistan","2025-02-15",0,0,9,0,0,9,0,0
"Pakistan","2025-02-16",0,0,9,0,0,9,0,0
"Pakistan","2025-02-17",0,0,9,0,0,9,0,0
"Pakistan","2025-02-18",0,0,9,0,0,9,0,0
"Pakistan","2025-02-19",0,0,9,0,0,9,0,0
"Pakistan","2025-02-20",0,0,9,0,0,9,0,0
"Pakistan","2025-02-21",0,0,9,0,0,9,0,0
"Pakistan","2025-02-22",0,0,9,0,0,9,0,0
"Pakistan","2025-02-23",0,0,9,0,0,9,0,0
"Pakistan","2025-02-24",0,0,9,0,0,9,0,0
"Pakistan","2025-02-25",0,0,9,0,0,9,0,0
"Pakistan","2025-02-26",0,0,9,0,0,9,0,0
"Pakistan","2025-02-27",0,0,9,0,0,9,0,0
"Pakistan","2025-02-28",0,0,9,0,0,9,0,0
"Pakistan","2025-03-01",0,0,9,0,0,9,0,0
"Pakistan","2025-03-02",0,0,9,0,0,9,0,0
"Pakistan","2025-03-03",0,0,9,0,0,9,0,0
"Panama","2024-01-01",0,0,0,0,0,0,0,0
"Panama","2024-01-02",0,0,0,0,0,0,0,0
"Panama","2024-01-03",0,0,0,0,0,0,0,0
"Panama","2024-01-04",0,0,0,0,0,0,0,0
"Panama","2024-01-05",0,0,0,0,0,0,0,0
"Panama","2024-01-06",0,0,0,0,0,0,0,0
"Panama","2024-01-07",0,0,0,0,0,0,0,0
"Panama","2024-01-08",0,0,0,0,0,0,0,0
"Panama","2024-01-09",0,0,0,0,0,0,0,0
"Panama","2024-01-10",0,0,0,0,0,0,0,0
"Panama","2024-01-11",0,0,0,0,0,0,0,0
"Panama","2024-01-12",0,0,0,0,0,0,0,0
"Panama","2024-01-13",0,0,0,0,0,0,0,0
"Panama","2024-01-14",0,0,0,0,0,0,0,0
"Panama","2024-01-15",0,0,0,0,0,0,0,0
"Panama","2024-01-16",0,1,1,0,1,1,0,0
"Panama","2024-01-17",0,0,1,0,0,1,0,0
"Panama","2024-01-18",0,0,1,0,0,1,0,0
"Panama","2024-01-19",0,0,1,0,0,1,0,0
"Panama","2024-01-20",0,0,1,0,0,1,0,0
"Panama","2024-01-21",0,0,1,0,0,1,0,0
"Panama","2024-01-22",0,0,1,0,0,1,0,0
"Panama","2024-01-23",0,0,1,0,0,1,0,0
"Panama","2024-01-24",0,0,1,0,0,1,0,0
"Panama","2024-01-25",0,0,1,0,0,1,0,0
"Panama","2024-01-26",0,0,1,0,0,1,0,0
"Panama","2024-01-27",0,0,1,0,1,2,0,0
"Panama","2024-01-28",0,0,1,0,0,2,0,0
"Panama","2024-01-29",0,0,1,0,0,2,0,0
"Panama","2024-01-30",0,0,1,0,0,2,0,0
"Panama","2024-01-31",0,0,1,0,0,2,0,0
"Panama","2024-02-01",0,0,1,0,0,2,0,0
"Panama","2024-02-02",0,0,1,0,0,2,0,0
"Panama","2024-02-03",0,0,1,0,0,2,0,0
"Panama","2024-02-04",0,0,1,0,0,2,0,0
"Panama","2024-02-05",0,0,1,0,0,2,0,0
"Panama","2024-02-06",0,1,2,0,0,2,0,0
"Panama","2024-02-07",0,0,2,0,0,2,0,0
"Panama","2024-02-08",0,0,2,0,0,2,0,0
"Panama","2024-02-09",0,0,2,0,0,2,0,0
"Panama","2024-02-10",0,0,2,0,0,2,0,0
"Panama","2024-02-11",0,0,2,0,0,2,0,0
"Panama","2024-02-12",0,0,2,0,0,2,0,0
"Panama","2024-02-13",0,0,2,0,0,2,0,0
"Panama","2024-02-14",0,0,2,0,0,2,0,0
"Panama","2024-02-15",0,0,2,0,0,2,0,0
"Panama","2024-02-16",0,0,2,0,0,2,0,0
"Panama","2024-02-17",0,0,2,0,0,2,0,0
"Panama","2024-02-18",0,0,2,0,0,2,0,0
"Panama","2024-02-19",0,0,2,0,0,2,0,0
"Panama","2024-02-20",0,0,2,0,0,2,0,0
"Panama","2024-02-21",0,0,2,0,0,2,0,0
"Panama","2024-02-22",0,0,2,0,0,2,0,0
"Panama","2024-02-23",0,0,2,0,0,2,0,0
"Panama","2024-02-24",0,0,2,0,0,2,0,0
"Panama","2024-02-25",0,0,2,0,0,2,0,0
"Panama","2024-02-26",0,0,2,0,0,2,0,0
"Panama","2024-02-27",0,0,2,0,0,2,0,0
"Panama","2024-02-28",0,0,2,0,0,2,0,0
"Panama","2024-02-29",0,0,2,0,0,2,0,0
"Panama","2024-03-01",0,0,2,0,0,2,0,0
"Panama","2024-03-02",0,0,2,0,0,2,0,0
"Panama","2024-03-03",0,0,2,0,0,2,0,0
"Panama","2024-03-04",0,0,2,0,0,2,0,0
"Panama","2024-03-05",0,0,2,0,0,2,0,0
"Panama","2024-03-06",0,0,2,0,0,2,0,0
"Panama","2024-03-07",0,0,2,0,0,2,0,0
"Panama","2024-03-08",0,0,2,0,0,2,0,0
"Panama","2024-03-09",0,0,2,0,0,2,0,0
"Panama","2024-03-10",0,0,2,0,0,2,0,0
"Panama","2024-03-11",0,0,2,0,0,2,0,0
"Panama","2024-03-12",0,0,2,0,0,2,0,0
"Panama","2024-03-13",0,0,2,0,0,2,0,0
"Panama","2024-03-14",0,0,2,0,0,2,0,0
"Panama","2024-03-15",0,0,2,0,0,2,0,0
"Panama","2024-03-16",0,0,2,0,0,2,0,0
"Panama","2024-03-17",0,0,2,0,0,2,0,0
"Panama","2024-03-18",0,0,2,0,0,2,0,0
"Panama","2024-03-19",0,0,2,0,0,2,0,0
"Panama","2024-03-20",0,0,2,0,0,2,0,0
"Panama","2024-03-21",0,0,2,0,0,2,0,0
"Panama","2024-03-22",0,0,2,0,0,2,0,0
"Panama","2024-03-23",0,0,2,0,0,2,0,0
"Panama","2024-03-24",0,0,2,0,0,2,0,0
"Panama","2024-03-25",0,0,2,0,0,2,0,0
"Panama","2024-03-26",0,0,2,0,0,2,0,0
"Panama","2024-03-27",0,0,2,0,0,2,0,0
"Panama","2024-03-28",0,0,2,0,0,2,0,0
"Panama","2024-03-29",0,0,2,0,0,2,0,0
"Panama","2024-03-30",0,0,2,0,0,2,0,0
"Panama","2024-03-31",0,0,2,0,0,2,0,0
"Panama","2024-04-01",0,0,2,0,0,2,0,0
"Panama","2024-04-02",0,0,2,0,0,2,0,0
"Panama","2024-04-03",0,0,2,0,0,2,0,0
"Panama","2024-04-04",0,0,2,0,0,2,0,0
"Panama","2024-04-05",0,0,2,0,0,2,0,0
"Panama","2024-04-06",0,0,2,0,0,2,0,0
"Panama","2024-04-07",0,0,2,0,0,2,0,0
"Panama","2024-04-08",0,0,2,0,0,2,0,0
"Panama","2024-04-09",0,0,2,0,0,2,0,0
"Panama","2024-04-10",0,0,2,0,0,2,0,0
"Panama","2024-04-11",0,0,2,0,0,2,0,0
"Panama","2024-04-12",0,0,2,0,0,2,0,0
"Panama","2024-04-13",0,0,2,0,0,2,0,0
"Panama","2024-04-14",0,0,2,0,0,2,0,0
"Panama","2024-04-15",0,0,2,0,0,2,0,0
"Panama","2024-04-16",0,0,2,0,0,2,0,0
"Panama","2024-04-17",0,0,2,0,1,3,0,0
"Panama","2024-04-18",0,0,2,0,0,3,0,0
"Panama","2024-04-19",0,0,2,0,0,3,0,0
"Panama","2024-04-20",0,0,2,0,0,3,0,0
"Panama","2024-04-21",0,0,2,0,0,3,0,0
"Panama","2024-04-22",0,0,2,0,0,3,0,0
"Panama","2024-04-23",0,0,2,0,0,3,0,0
"Panama","2024-04-24",0,0,2,0,0,3,0,0
"Panama","2024-04-25",0,0,2,0,0,3,0,0
"Panama","2024-04-26",0,0,2,0,0,3,0,0
"Panama","2024-04-27",0,0,2,0,0,3,0,0
"Panama","2024-04-28",0,0,2,0,0,3,0,0
"Panama","2024-04-29",0,0,2,0,0,3,0,0
"Panama","2024-04-30",0,0,2,0,0,3,0,0
"Panama","2024-05-01",0,0,2,0,0,3,0,0
"Panama","2024-05-02",0,0,2,0,0,3,0,0
"Panama","2024-05-03",0,0,2,0,0,3,0,0
"Panama","2024-05-04",0,0,2,0,0,3,0,0
"Panama","2024-05-05",0,0,2,0,0,3,0,0
"Panama","2024-05-06",0,0,2,0,0,3,0,0
"Panama","2024-05-07",0,0,2,0,0,3,0,0
"Panama","2024-05-08",0,0,2,0,0,3,0,0
"Panama","2024-05-09",0,0,2,0,0,3,0,0
"Panama","2024-05-10",0,0,2,0,0,3,0,0
"Panama","2024-05-11",0,0,2,0,0,3,0,0
"Panama","2024-05-12",0,0,2,0,0,3,0,0
"Panama","2024-05-13",0,0,2,0,0,3,0,0
"Panama","2024-05-14",0,0,2,0,0,3,0,0
"Panama","2024-05-15",0,0,2,0,0,3,0,0
"Panama","2024-05-16",0,0,2,0,0,3,0,0
"Panama","2024-05-17",0,0,2,0,0,3,0,0
"Panama","2024-05-18",0,0,2,0,0,3,0,0
"Panama","2024-05-19",0,0,2,0,0,3,0,0
"Panama","2024-05-20",0,0,2,0,0,3,0,0
"Panama","2024-05-21",0,0,2,0,0,3,0,0
"Panama","2024-05-22",0,0,2,0,0,3,0,0
"Panama","2024-05-23",0,0,2,0,0,3,0,0
"Panama","2024-05-24",0,0,2,0,0,3,0,0
"Panama","2024-05-25",0,0,2,0,0,3,0,0
"Panama","2024-05-26",0,0,2,0,0,3,0,0
"Panama","2024-05-27",0,0,2,0,0,3,0,0
"Panama","2024-05-28",0,0,2,0,0,3,0,0
"Panama","2024-05-29",0,0,2,0,0,3,0,0
"Panama","2024-05-30",0,0,2,0,0,3,0,0
"Panama","2024-05-31",0,0,2,0,0,3,0,0
"Panama","2024-06-01",0,0,2,0,0,3,0,0
"Panama","2024-06-02",0,0,2,0,0,3,0,0
"Panama","2024-06-03",0,0,2,0,0,3,0,0
"Panama","2024-06-04",0,0,2,0,0,3,0,0
"Panama","2024-06-05",0,0,2,0,0,3,0,0
"Panama","2024-06-06",0,0,2,0,0,3,0,0
"Panama","2024-06-07",0,0,2,0,0,3,0,0
"Panama","2024-06-08",0,0,2,0,0,3,0,0
"Panama","2024-06-09",0,0,2,0,0,3,0,0
"Panama","2024-06-10",0,0,2,0,0,3,0,0
"Panama","2024-06-11",0,0,2,0,0,3,0,0
"Panama","2024-06-12",0,0,2,0,0,3,0,0
"Panama","2024-06-13",0,0,2,0,0,3,0,0
"Panama","2024-06-14",0,0,2,0,0,3,0,0
"Panama","2024-06-15",0,0,2,0,0,3,0,0
"Panama","2024-06-16",0,0,2,0,0,3,0,0
"Panama","2024-06-17",0,0,2,0,0,3,0,0
"Panama","2024-06-18",0,0,2,0,0,3,0,0
"Panama","2024-06-19",0,0,2,0,0,3,0,0
"Panama","2024-06-20",0,0,2,0,0,3,0,0
"Panama","2024-06-21",0,0,2,0,0,3,0,0
"Panama","2024-06-22",0,0,2,0,0,3,0,0
"Panama","2024-06-23",0,0,2,0,0,3,0,0
"Panama","2024-06-24",0,0,2,0,0,3,0,0
"Panama","2024-06-25",0,1,3,0,0,3,0,0
"Panama","2024-06-26",0,0,3,0,0,3,0,0
"Panama","2024-06-27",0,0,3,0,0,3,0,0
"Panama","2024-06-28",0,0,3,0,0,3,0,0
"Panama","2024-06-29",0,0,3,0,0,3,0,0
"Panama","2024-06-30",0,0,3,0,0,3,0,0
"Panama","2024-07-01",0,0,3,0,0,3,0,0
"Panama","2024-07-02",0,0,3,0,0,3,0,0
"Panama","2024-07-03",0,0,3,0,0,3,0,0
"Panama","2024-07-04",0,0,3,0,0,3,0,0
"Panama","2024-07-05",0,0,3,0,0,3,0,0
"Panama","2024-07-06",0,0,3,0,0,3,0,0
"Panama","2024-07-07",0,0,3,0,0,3,0,0
"Panama","2024-07-08",0,0,3,0,0,3,0,0
"Panama","2024-07-09",0,0,3,0,0,3,0,0
"Panama","2024-07-10",0,0,3,0,0,3,0,0
"Panama","2024-07-11",0,0,3,0,0,3,0,0
"Panama","2024-07-12",0,0,3,0,0,3,0,0
"Panama","2024-07-13",0,0,3,0,1,4,0,0
"Panama","2024-07-14",0,0,3,0,0,4,0,0
"Panama","2024-07-15",0,0,3,0,0,4,0,0
"Panama","2024-07-16",0,0,3,0,0,4,0,0
"Panama","2024-07-17",0,0,3,0,0,4,0,0
"Panama","2024-07-18",0,0,3,0,0,4,0,0
"Panama","2024-07-19",0,0,3,0,0,4,0,0
"Panama","2024-07-20",0,0,3,0,0,4,0,0
"Panama","2024-07-21",0,0,3,0,0,4,0,0
"Panama","2024-07-22",0,0,3,0,0,4,0,0
"Panama","2024-07-23",0,0,3,0,0,4,0,0
"Panama","2024-07-24",0,0,3,0,0,4,0,0
"Panama","2024-07-25",0,0,3,0,0,4,0,0
"Panama","2024-07-26",0,0,3,0,0,4,0,0
"Panama","2024-07-27",0,0,3,0,0,4,0,0
"Panama","2024-07-28",0,0,3,0,0,4,0,0
"Panama","2024-07-29",0,0,3,0,0,4,0,0
"Panama","2024-07-30",0,1,4,0,0,4,0,0
"Panama","2024-07-31",0,0,4,0,0,4,0,0
"Panama","2024-08-01",0,0,4,0,0,4,0,0
"Panama","2024-08-02",0,0,4,0,0,4,0,0
"Panama","2024-08-03",0,0,4,0,0,4,0,0
"Panama","2024-08-04",0,0,4,0,0,4,0,0
"Panama","2024-08-05",0,0,4,0,0,4,0,0
"Panama","2024-08-06",0,0,4,0,0,4,0,0
"Panama","2024-08-07",0,0,4,0,0,4,0,0
"Panama","2024-08-08",0,0,4,0,0,4,0,0
"Panama","2024-08-09",0,0,4,0,0,4,0,0
"Panama","2024-08-10",0,0,4,0,0,4,0,0
"Panama","2024-08-11",0,0,4,0,0,4,0,0
"Panama","2024-08-12",0,0,4,0,0,4,0,0
"Panama","2024-08-13",0,0,4,0,0,4,0,0
"Panama","2024-08-14",0,0,4,0,0,4,0,0
"Panama","2024-08-15",0,0,4,0,0,4,0,0
"Panama","2024-08-16",0,0,4,0,0,4,0,0
"Panama","2024-08-17",0,0,4,0,0,4,0,0
"Panama","2024-08-18",0,0,4,0,0,4,0,0
"Panama","2024-08-19",0,0,4,0,0,4,0,0
"Panama","2024-08-20",0,0,4,0,0,4,0,0
"Panama","2024-08-21",0,0,4,0,0,4,0,0
"Panama","2024-08-22",0,0,4,0,0,4,0,0
"Panama","2024-08-23",0,0,4,0,0,4,0,0
"Panama","2024-08-24",0,0,4,0,1,5,0,0
"Panama","2024-08-25",0,0,4,0,0,5,0,0
"Panama","2024-08-26",0,0,4,0,0,5,0,0
"Panama","2024-08-27",0,0,4,0,0,5,0,0
"Panama","2024-08-28",0,0,4,0,0,5,0,0
"Panama","2024-08-29",0,0,4,0,0,5,0,0
"Panama","2024-08-30",0,0,4,0,0,5,0,0
"Panama","2024-08-31",0,0,4,0,0,5,0,0
"Panama","2024-09-01",0,0,4,0,0,5,0,0
"Panama","2024-09-02",0,0,4,0,0,5,0,0
"Panama","2024-09-03",0,0,4,0,0,5,0,0
"Panama","2024-09-04",0,0,4,0,0,5,0,0
"Panama","2024-09-05",0,0,4,0,0,5,0,0
"Panama","2024-09-06",0,0,4,0,0,5,0,0
"Panama","2024-09-07",0,0,4,0,0,5,0,0
"Panama","2024-09-08",0,0,4,0,0,5,0,0
"Panama","2024-09-09",0,0,4,0,0,5,0,0
"Panama","2024-09-10",0,0,4,0,0,5,0,0
"Panama","2024-09-11",0,0,4,0,0,5,0,0
"Panama","2024-09-12",0,0,4,0,0,5,0,0
"Panama","2024-09-13",0,0,4,0,0,5,0,0
"Panama","2024-09-14",0,0,4,0,0,5,0,0
"Panama","2024-09-15",0,0,4,0,0,5,0,0
"Panama","2024-09-16",0,0,4,0,0,5,0,0
"Panama","2024-09-17",0,1,5,0,0,5,0,0
"Panama","2024-09-18",0,0,5,0,0,5,0,0
"Panama","2024-09-19",0,0,5,0,0,5,0,0
"Panama","2024-09-20",0,0,5,0,0,5,0,0
"Panama","2024-09-21",0,0,5,0,0,5,0,0
"Panama","2024-09-22",0,0,5,0,0,5,0,0
"Panama","2024-09-23",0,0,5,0,0,5,0,0
"Panama","2024-09-24",0,0,5,0,0,5,0,0
"Panama","2024-09-25",0,0,5,0,0,5,0,0
"Panama","2024-09-26",0,0,5,0,0,5,0,0
"Panama","2024-09-27",0,0,5,0,0,5,0,0
"Panama","2024-09-28",0,0,5,0,0,5,0,0
"Panama","2024-09-29",0,0,5,0,0,5,0,0
"Panama","2024-09-30",0,0,5,0,0,5,0,0
"Panama","2024-10-01",0,0,5,0,0,5,0,0
"Panama","2024-10-02",0,0,5,0,0,5,0,0
"Panama","2024-10-03",0,0,5,0,0,5,0,0
"Panama","2024-10-04",0,0,5,0,0,5,0,0
"Panama","2024-10-05",0,0,5,0,0,5,0,0
"Panama","2024-10-06",0,0,5,0,0,5,0,0
"Panama","2024-10-07",0,0,5,0,0,5,0,0
"Panama","2024-10-08",0,0,5,0,0,5,0,0
"Panama","2024-10-09",0,0,5,0,0,5,0,0
"Panama","2024-10-10",0,0,5,0,0,5,0,0
"Panama","2024-10-11",0,0,5,0,0,5,0,0
"Panama","2024-10-12",0,0,5,0,0,5,0,0
"Panama","2024-10-13",0,0,5,0,0,5,0,0
"Panama","2024-10-14",0,0,5,0,0,5,0,0
"Panama","2024-10-15",0,0,5,0,0,5,0,0
"Panama","2024-10-16",0,0,5,0,0,5,0,0
"Panama","2024-10-17",0,0,5,0,0,5,0,0
"Panama","2024-10-18",0,0,5,0,0,5,0,0
"Panama","2024-10-19",0,0,5,0,0,5,0,0
"Panama","2024-10-20",0,0,5,0,0,5,0,0
"Panama","2024-10-21",0,0,5,0,0,5,0,0
"Panama","2024-10-22",0,0,5,0,0,5,0,0
"Panama","2024-10-23",0,0,5,0,0,5,0,0
"Panama","2024-10-24",0,0,5,0,0,5,0,0
"Panama","2024-10-25",0,0,5,0,0,5,0,0
"Panama","2024-10-26",0,0,5,0,0,5,0,0
"Panama","2024-10-27",0,0,5,0,0,5,0,0
"Panama","2024-10-28",0,0,5,0,0,5,0,0
"Panama","2024-10-29",0,0,5,0,0,5,0,0
"Panama","2024-10-30",0,0,5,0,1,6,0,0
"Panama","2024-10-31",0,0,5,0,0,6,0,0
"Panama","2024-11-01",0,0,5,0,0,6,0,0
"Panama","2024-11-02",0,0,5,0,0,6,0,0
"Panama","2024-11-03",0,0,5,0,0,6,0,0
"Panama","2024-11-04",0,0,5,0,0,6,0,0
"Panama","2024-11-05",0,0,5,0,0,6,0,0
"Panama","2024-11-06",0,0,5,0,0,6,0,0
"Panama","2024-11-07",0,0,5,0,0,6,0,0
"Panama","2024-11-08",0,0,5,0,0,6,0,0
"Panama","2024-11-09",0,0,5,0,0,6,0,0
"Panama","2024-11-10",0,0,5,0,0,6,0,0
"Panama","2024-11-11",0,0,5,0,0,6,0,0
"Panama","2024-11-12",0,0,5,0,0,6,0,0
"Panama","2024-11-13",0,0,5,0,0,6,0,0
"Panama","2024-11-14",0,0,5,0,0,6,0,0
"Panama","2024-11-15",0,0,5,0,0,6,0,0
"Panama","2024-11-16",0,0,5,0,0,6,0,0
"Panama","2024-11-17",0,0,5,0,0,6,0,0
"Panama","2024-11-18",0,0,5,0,0,6,0,0
"Panama","2024-11-19",0,0,5,0,0,6,0,0
"Panama","2024-11-20",0,0,5,0,0,6,0,0
"Panama","2024-11-21",0,0,5,0,0,6,0,0
"Panama","2024-11-22",0,0,5,0,0,6,0,0
"Panama","2024-11-23",0,0,5,0,0,6,0,0
"Panama","2024-11-24",0,0,5,0,0,6,0,0
"Panama","2024-11-25",0,0,5,0,0,6,0,0
"Panama","2024-11-26",0,0,5,0,0,6,0,0
"Panama","2024-11-27",0,0,5,0,0,6,0,0
"Panama","2024-11-28",0,0,5,0,0,6,0,0
"Panama","2024-11-29",0,0,5,0,0,6,0,0
"Panama","2024-11-30",0,0,5,0,0,6,0,0
"Panama","2024-12-01",0,0,5,0,0,6,0,0
"Panama","2024-12-02",0,0,5,0,0,6,0,0
"Panama","2024-12-03",0,0,5,0,0,6,0,0
"Panama","2024-12-04",0,0,5,0,0,6,0,0
"Panama","2024-12-05",0,0,5,0,0,6,0,0
"Panama","2024-12-06",0,0,5,0,0,6,0,0
"Panama","2024-12-07",0,0,5,0,0,6,0,0
"Panama","2024-12-08",0,0,5,0,0,6,0,0
"Panama","2024-12-09",0,0,5,0,0,6,0,0
"Panama","2024-12-10",0,1,6,0,0,6,0,0
"Panama","2024-12-11",0,0,6,0,0,6,0,0
"Panama","2024-12-12",0,0,6,0,0,6,0,0
"Panama","2024-12-13",0,0,6,0,0,6,0,0
"Panama","2024-12-14",0,0,6,0,0,6,0,0
"Panama","2024-12-15",0,0,6,0,0,6,0,0
"Panama","2024-12-16",0,0,6,0,0,6,0,0
"Panama","2024-12-17",0,0,6,0,0,6,0,0
"Panama","2024-12-18",0,0,6,0,0,6,0,0
"Panama","2024-12-19",0,0,6,0,0,6,0,0
"Panama","2024-12-20",0,0,6,0,0,6,0,0
"Panama","2024-12-21",0,0,6,0,0,6,0,0
"Panama","2024-12-22",0,0,6,0,0,6,0,0
"Panama","2024-12-23",0,0,6,0,0,6,0,0
"Panama","2024-12-24",0,0,6,0,0,6,0,0
"Panama","2024-12-25",0,0,6,0,0,6,0,0
"Panama","2024-12-26",0,0,6,0,0,6,0,0
"Panama","2024-12-27",0,0,6,0,0,6,0,0
"Panama","2024-12-28",0,0,6,0,0,6,0,0
"Panama","2024-12-29",0,0,6,0,0,6,0,0
"Panama","2024-12-30",0,0,6,0,0,6,0,0
"Panama","2024-12-31",0,0,6,0,0,6,0,0
"Panama","2025-01-01",0,0,6,0,0,6,0,0
"Panama","2025-01-02",0,0,6,0,0,6,0,0
"Panama","2025-01-03",0,0,6,0,0,6,0,0
"Panama","2025-01-04",0,0,6,0,0,6,0,0
"Panama","2025-01-05",0,0,6,0,0,6,0,0
"Panama","2025-01-06",0,0,6,0,0,6,0,0
"Panama","2025-01-07",0,0,6,0,0,6,0,0
"Panama","2025-01-08",0,0,6,0,0,6,0,0
"Panama","2025-01-09",0,0,6,0,0,6,0,0
"Panama","2025-01-10",0,0,6,0,0,6,0,0
"Panama","2025-01-11",0,0,6,0,0,6,0,0
"Panama","2025-01-12",0,0,6,0,0,6,0,0
"Panama","2025-01-13",0,0,6,0,0,6,0,0
"Panama","2025-01-14",0,0,6,0,0,6,0,0
"Panama","2025-01-15",0,0,6,0,0,6,0,0
"Panama","2025-01-16",0,0,6,0,0,6,0,0
"Panama","2025-01-17",0,0,6,0,0,6,0,0
"Panama","2025-01-18",0,0,6,0,0,6,0,0
"Panama","2025-01-19",0,0,6,0,0,6,0,0
"Panama","2025-01-20",0,0,6,0,0,6,0,0
"Panama","2025-01-21",0,0,6,0,0,6,0,0
"Panama","2025-01-22",0,0,6,0,0,6,0,0
"Panama","2025-01-23",0,0,6,0,0,6,0,0
"Panama","2025-01-24",0,0,6,0,0,6,0,0
"Panama","2025-01-25",0,0,6,0,0,6,0,0
"Panama","2025-01-26",0,0,6,0,0,6,0,0
"Panama","2025-01-27",0,0,6,0,0,6,0,0
"Panama","2025-01-28",0,0,6,0,0,6,0,0
"Panama","2025-01-29",0,0,6,0,0,6,0,0
"Panama","2025-01-30",0,0,6,0,0,6,0,0
"Panama","2025-01-31",0,0,6,0,0,6,0,0
"Panama","2025-02-01",0,0,6,0,0,6,0,0
"Panama","2025-02-02",0,0,6,0,0,6,0,0
"Panama","2025-02-03",0,0,6,0,0,6,0,0
"Panama","2025-02-04",0,0,6,0,0,6,0,0
"Panama","2025-02-05",0,0,6,0,0,6,0,0
"Panama","2025-02-06",0,0,6,0,0,6,0,0
"Panama","2025-02-07",0,0,6,0,0,6,0,0
"Panama","2025-02-08",0,0,6,0,0,6,0,0
"Panama","2025-02-09",0,0,6,0,0,6,0,0
"Panama","2025-02-10",0,0,6,0,0,6,0,0
"Panama","2025-02-11",0,0,6,0,0,6,0,0
"Panama","2025-02-12",0,0,6,0,0,6,0,0
"Panama","2025-02-13",0,0,6,0,0,6,0,0
"Panama","2025-02-14",0,0,6,0,0,6,0,0
"Panama","2025-02-15",0,0,6,0,0,6,0,0
"Panama","2025-02-16",0,0,6,0,0,6,0,0
"Panama","2025-02-17",0,0,6,0,0,6,0,0
"Panama","2025-02-18",0,0,6,0,0,6,0,0
"Panama","2025-02-19",0,0,6,0,0,6,0,0
"Panama","2025-02-20",0,0,6,0,0,6,0,0
"Panama","2025-02-21",0,0,6,0,0,6,0,0
"Panama","2025-02-22",0,0,6,0,0,6,0,0
"Panama","2025-02-23",0,0,6,0,0,6,0,0
"Panama","2025-02-24",0,0,6,0,0,6,0,0
"Panama","2025-02-25",0,0,6,0,0,6,0,0
"Panama","2025-02-26",0,0,6,0,0,6,0,0
"Panama","2025-02-27",0,0,6,0,0,6,0,0
"Panama","2025-02-28",0,0,6,0,0,6,0,0
"Panama","2025-03-01",0,0,6,0,0,6,0,0
"Panama","2025-03-02",0,0,6,0,0,6,0,0
"Panama","2025-03-03",0,0,6,0,0,6,0,0
"Paraguay","2024-01-01",0,0,0,0,0,0,0,0
"Paraguay","2024-01-02",0,0,0,0,0,0,0,0
"Paraguay","2024-01-03",0,0,0,0,0,0,0,0
"Paraguay","2024-01-04",0,0,0,0,0,0,0,0
"Paraguay","2024-01-05",0,0,0,0,0,0,0,0
"Paraguay","2024-01-06",0,0,0,0,0,0,0,0
"Paraguay","2024-01-07",0,0,0,0,0,0,0,0
"Paraguay","2024-01-08",0,0,0,0,0,0,0,0
"Paraguay","2024-01-09",0,0,0,0,0,0,0,0
"Paraguay","2024-01-10",0,0,0,0,0,0,0,0
"Paraguay","2024-01-11",0,0,0,0,0,0,0,0
"Paraguay","2024-01-12",0,0,0,0,0,0,0,0
"Paraguay","2024-01-13",0,0,0,0,0,0,0,0
"Paraguay","2024-01-14",0,0,0,0,0,0,0,0
"Paraguay","2024-01-15",0,0,0,0,0,0,0,0
"Paraguay","2024-01-16",0,0,0,0,0,0,0,0
"Paraguay","2024-01-17",0,0,0,0,0,0,0,0
"Paraguay","2024-01-18",0,0,0,0,0,0,0,0
"Paraguay","2024-01-19",0,0,0,0,0,0,0,0
"Paraguay","2024-01-20",0,0,0,0,0,0,0,0
"Paraguay","2024-01-21",0,0,0,0,0,0,0,0
"Paraguay","2024-01-22",0,0,0,0,0,0,0,0
"Paraguay","2024-01-23",0,0,0,0,0,0,0,0
"Paraguay","2024-01-24",0,0,0,0,0,0,0,0
"Paraguay","2024-01-25",0,0,0,0,0,0,0,0
"Paraguay","2024-01-26",0,0,0,0,0,0,0,0
"Paraguay","2024-01-27",0,0,0,0,0,0,0,0
"Paraguay","2024-01-28",0,0,0,0,0,0,0,0
"Paraguay","2024-01-29",0,0,0,0,0,0,0,0
"Paraguay","2024-01-30",0,0,0,0,0,0,0,0
"Paraguay","2024-01-31",0,0,0,0,0,0,0,0
"Paraguay","2024-02-01",0,0,0,0,0,0,0,0
"Paraguay","2024-02-02",0,0,0,0,0,0,0,0
"Paraguay","2024-02-03",0,0,0,0,0,0,0,0
"Paraguay","2024-02-04",0,0,0,0,0,0,0,0
"Paraguay","2024-02-05",0,0,0,0,0,0,0,0
"Paraguay","2024-02-06",0,0,0,0,0,0,0,0
"Paraguay","2024-02-07",0,0,0,0,0,0,0,0
"Paraguay","2024-02-08",0,0,0,0,0,0,0,0
"Paraguay","2024-02-09",0,0,0,0,0,0,0,0
"Paraguay","2024-02-10",0,0,0,0,0,0,0,0
"Paraguay","2024-02-11",0,0,0,0,0,0,0,0
"Paraguay","2024-02-12",0,0,0,0,0,0,0,0
"Paraguay","2024-02-13",0,0,0,0,0,0,0,0
"Paraguay","2024-02-14",0,0,0,0,0,0,0,0
"Paraguay","2024-02-15",0,0,0,0,0,0,0,0
"Paraguay","2024-02-16",0,0,0,0,0,0,0,0
"Paraguay","2024-02-17",0,0,0,0,0,0,0,0
"Paraguay","2024-02-18",0,0,0,0,0,0,0,0
"Paraguay","2024-02-19",0,0,0,0,0,0,0,0
"Paraguay","2024-02-20",0,0,0,0,0,0,0,0
"Paraguay","2024-02-21",0,0,0,0,0,0,0,0
"Paraguay","2024-02-22",0,0,0,0,0,0,0,0
"Paraguay","2024-02-23",0,0,0,0,0,0,0,0
"Paraguay","2024-02-24",0,0,0,0,0,0,0,0
"Paraguay","2024-02-25",0,0,0,0,0,0,0,0
"Paraguay","2024-02-26",0,0,0,0,0,0,0,0
"Paraguay","2024-02-27",0,0,0,0,0,0,0,0
"Paraguay","2024-02-28",0,0,0,0,0,0,0,0
"Paraguay","2024-02-29",0,0,0,0,0,0,0,0
"Paraguay","2024-03-01",0,0,0,0,0,0,0,0
"Paraguay","2024-03-02",0,0,0,0,0,0,0,0
"Paraguay","2024-03-03",0,0,0,0,0,0,0,0
"Paraguay","2024-03-04",0,0,0,0,0,0,0,0
"Paraguay","2024-03-05",0,0,0,0,0,0,0,0
"Paraguay","2024-03-06",0,0,0,0,0,0,0,0
"Paraguay","2024-03-07",0,0,0,0,0,0,0,0
"Paraguay","2024-03-08",0,0,0,0,0,0,0,0
"Paraguay","2024-03-09",0,0,0,0,0,0,0,0
"Paraguay","2024-03-10",0,0,0,0,0,0,0,0
"Paraguay","2024-03-11",0,0,0,0,0,0,0,0
"Paraguay","2024-03-12",0,0,0,0,0,0,0,0
"Paraguay","2024-03-13",0,0,0,0,0,0,0,0
"Paraguay","2024-03-14",0,0,0,0,0,0,0,0
"Paraguay","2024-03-15",0,0,0,0,0,0,0,0
"Paraguay","2024-03-16",0,0,0,0,0,0,0,0
"Paraguay","2024-03-17",0,0,0,0,0,0,0,0
"Paraguay","2024-03-18",0,0,0,0,0,0,0,0
"Paraguay","2024-03-19",0,0,0,0,0,0,0,0
"Paraguay","2024-03-20",0,0,0,0,0,0,0,0
"Paraguay","2024-03-21",0,0,0,0,0,0,0,0
"Paraguay","2024-03-22",0,0,0,0,0,0,0,0
"Paraguay","2024-03-23",0,0,0,0,0,0,0,0
"Paraguay","2024-03-24",0,0,0,0,0,0,0,0
"Paraguay","2024-03-25",0,0,0,0,0,0,0,0
"Paraguay","2024-03-26",0,0,0,0,0,0,0,0
"Paraguay","2024-03-27",0,0,0,0,0,0,0,0
"Paraguay","2024-03-28",0,0,0,0,0,0,0,0
"Paraguay","2024-03-29",0,0,0,0,0,0,0,0
"Paraguay","2024-03-30",0,0,0,0,0,0,0,0
"Paraguay","2024-03-31",0,0,0,0,0,0,0,0
"Paraguay","2024-04-01",0,0,0,0,0,0,0,0
"Paraguay","2024-04-02",0,0,0,0,0,0,0,0
"Paraguay","2024-04-03",0,0,0,0,0,0,0,0
"Paraguay","2024-04-04",0,0,0,0,0,0,0,0
"Paraguay","2024-04-05",0,0,0,0,0,0,0,0
"Paraguay","2024-04-06",0,0,0,0,0,0,0,0
"Paraguay","2024-04-07",0,0,0,0,0,0,0,0
"Paraguay","2024-04-08",0,0,0,0,0,0,0,0
"Paraguay","2024-04-09",0,0,0,0,0,0,0,0
"Paraguay","2024-04-10",0,0,0,0,0,0,0,0
"Paraguay","2024-04-11",0,0,0,0,0,0,0,0
"Paraguay","2024-04-12",0,0,0,0,0,0,0,0
"Paraguay","2024-04-13",0,0,0,0,0,0,0,0
"Paraguay","2024-04-14",0,0,0,0,0,0,0,0
"Paraguay","2024-04-15",0,0,0,0,0,0,0,0
"Paraguay","2024-04-16",0,0,0,0,0,0,0,0
"Paraguay","2024-04-17",0,0,0,0,0,0,0,0
"Paraguay","2024-04-18",0,0,0,0,0,0,0,0
"Paraguay","2024-04-19",0,0,0,0,0,0,0,0
"Paraguay","2024-04-20",0,0,0,0,0,0,0,0
"Paraguay","2024-04-21",0,0,0,0,0,0,0,0
"Paraguay","2024-04-22",0,0,0,0,0,0,0,0
"Paraguay","2024-04-23",0,0,0,0,0,0,0,0
"Paraguay","2024-04-24",0,0,0,0,0,0,0,0
"Paraguay","2024-04-25",0,0,0,0,0,0,0,0
"Paraguay","2024-04-26",0,0,0,0,0,0,0,0
"Paraguay","2024-04-27",0,0,0,0,0,0,0,0
"Paraguay","2024-04-28",0,0,0,0,0,0,0,0
"Paraguay","2024-04-29",0,0,0,0,0,0,0,0
"Paraguay","2024-04-30",0,0,0,0,0,0,0,0
"Paraguay","2024-05-01",0,0,0,0,0,0,0,0
"Paraguay","2024-05-02",0,0,0,0,0,0,0,0
"Paraguay","2024-05-03",0,0,0,0,0,0,0,0
"Paraguay","2024-05-04",0,0,0,0,0,0,0,0
"Paraguay","2024-05-05",0,0,0,0,0,0,0,0
"Paraguay","2024-05-06",0,0,0,0,0,0,0,0
"Paraguay","2024-05-07",0,0,0,0,0,0,0,0
"Paraguay","2024-05-08",0,0,0,0,0,0,0,0
"Paraguay","2024-05-09",0,0,0,0,0,0,0,0
"Paraguay","2024-05-10",0,0,0,0,0,0,0,0
"Paraguay","2024-05-11",0,0,0,0,0,0,0,0
"Paraguay","2024-05-12",0,0,0,0,0,0,0,0
"Paraguay","2024-05-13",0,0,0,0,0,0,0,0
"Paraguay","2024-05-14",0,0,0,0,0,0,0,0
"Paraguay","2024-05-15",0,0,0,0,0,0,0,0
"Paraguay","2024-05-16",0,0,0,0,0,0,0,0
"Paraguay","2024-05-17",0,0,0,0,0,0,0,0
"Paraguay","2024-05-18",0,0,0,0,0,0,0,0
"Paraguay","2024-05-19",0,0,0,0,0,0,0,0
"Paraguay","2024-05-20",0,0,0,0,0,0,0,0
"Paraguay","2024-05-21",0,0,0,0,0,0,0,0
"Paraguay","2024-05-22",0,0,0,0,0,0,0,0
"Paraguay","2024-05-23",0,0,0,0,0,0,0,0
"Paraguay","2024-05-24",0,0,0,0,0,0,0,0
"Paraguay","2024-05-25",0,0,0,0,0,0,0,0
"Paraguay","2024-05-26",0,0,0,0,0,0,0,0
"Paraguay","2024-05-27",0,0,0,0,0,0,0,0
"Paraguay","2024-05-28",0,0,0,0,0,0,0,0
"Paraguay","2024-05-29",0,0,0,0,0,0,0,0
"Paraguay","2024-05-30",0,0,0,0,0,0,0,0
"Paraguay","2024-05-31",0,0,0,0,0,0,0,0
"Paraguay","2024-06-01",0,0,0,0,0,0,0,0
"Paraguay","2024-06-02",0,0,0,0,0,0,0,0
"Paraguay","2024-06-03",0,0,0,0,0,0,0,0
"Paraguay","2024-06-04",0,0,0,0,0,0,0,0
"Paraguay","2024-06-05",0,0,0,0,0,0,0,0
"Paraguay","2024-06-06",0,0,0,0,0,0,0,0
"Paraguay","2024-06-07",0,0,0,0,0,0,0,0
"Paraguay","2024-06-08",0,0,0,0,0,0,0,0
"Paraguay","2024-06-09",0,0,0,0,0,0,0,0
"Paraguay","2024-06-10",0,0,0,0,0,0,0,0
"Paraguay","2024-06-11",0,0,0,0,0,0,0,0
"Paraguay","2024-06-12",0,0,0,0,0,0,0,0
"Paraguay","2024-06-13",0,0,0,0,0,0,0,0
"Paraguay","2024-06-14",0,0,0,0,0,0,0,0
"Paraguay","2024-06-15",0,0,0,0,0,0,0,0
"Paraguay","2024-06-16",0,0,0,0,0,0,0,0
"Paraguay","2024-06-17",0,0,0,0,0,0,0,0
"Paraguay","2024-06-18",0,0,0,0,0,0,0,0
"Paraguay","2024-06-19",0,0,0,0,0,0,0,0
"Paraguay","2024-06-20",0,0,0,0,0,0,0,0
"Paraguay","2024-06-21",0,0,0,0,0,0,0,0
"Paraguay","2024-06-22",0,0,0,0,0,0,0,0
"Paraguay","2024-06-23",0,0,0,0,0,0,0,0
"Paraguay","2024-06-24",0,0,0,0,0,0,0,0
"Paraguay","2024-06-25",0,0,0,0,0,0,0,0
"Paraguay","2024-06-26",0,0,0,0,0,0,0,0
"Paraguay","2024-06-27",0,0,0,0,0,0,0,0
"Paraguay","2024-06-28",0,0,0,0,0,0,0,0
"Paraguay","2024-06-29",0,0,0,0,0,0,0,0
"Paraguay","2024-06-30",0,0,0,0,0,0,0,0
"Paraguay","2024-07-01",0,0,0,0,0,0,0,0
"Paraguay","2024-07-02",0,0,0,0,0,0,0,0
"Paraguay","2024-07-03",0,0,0,0,0,0,0,0
"Paraguay","2024-07-04",0,0,0,0,0,0,0,0
"Paraguay","2024-07-05",0,0,0,0,0,0,0,0
"Paraguay","2024-07-06",0,0,0,0,0,0,0,0
"Paraguay","2024-07-07",0,0,0,0,0,0,0,0
"Paraguay","2024-07-08",0,0,0,0,0,0,0,0
"Paraguay","2024-07-09",0,0,0,0,0,0,0,0
"Paraguay","2024-07-10",0,0,0,0,0,0,0,0
"Paraguay","2024-07-11",0,0,0,0,0,0,0,0
"Paraguay","2024-07-12",0,0,0,0,0,0,0,0
"Paraguay","2024-07-13",0,0,0,0,0,0,0,0
"Paraguay","2024-07-14",0,0,0,0,0,0,0,0
"Paraguay","2024-07-15",0,0,0,0,0,0,0,0
"Paraguay","2024-07-16",0,0,0,0,0,0,0,0
"Paraguay","2024-07-17",0,0,0,0,0,0,0,0
"Paraguay","2024-07-18",0,0,0,0,0,0,0,0
"Paraguay","2024-07-19",0,0,0,0,0,0,0,0
"Paraguay","2024-07-20",0,0,0,0,0,0,0,0
"Paraguay","2024-07-21",0,0,0,0,0,0,0,0
"Paraguay","2024-07-22",0,0,0,0,0,0,0,0
"Paraguay","2024-07-23",0,0,0,0,0,0,0,0
"Paraguay","2024-07-24",0,0,0,0,0,0,0,0
"Paraguay","2024-07-25",0,0,0,0,0,0,0,0
"Paraguay","2024-07-26",0,0,0,0,0,0,0,0
"Paraguay","2024-07-27",0,0,0,0,0,0,0,0
"Paraguay","2024-07-28",0,0,0,0,0,0,0,0
"Paraguay","2024-07-29",0,0,0,0,0,0,0,0
"Paraguay","2024-07-30",0,0,0,0,0,0,0,0
"Paraguay","2024-07-31",0,0,0,0,0,0,0,0
"Paraguay","2024-08-01",0,0,0,0,0,0,0,0
"Paraguay","2024-08-02",0,0,0,0,0,0,0,0
"Paraguay","2024-08-03",0,0,0,0,0,0,0,0
"Paraguay","2024-08-04",0,0,0,0,0,0,0,0
"Paraguay","2024-08-05",0,0,0,0,0,0,0,0
"Paraguay","2024-08-06",0,0,0,0,0,0,0,0
"Paraguay","2024-08-07",0,0,0,0,0,0,0,0
"Paraguay","2024-08-08",0,0,0,0,0,0,0,0
"Paraguay","2024-08-09",0,0,0,0,0,0,0,0
"Paraguay","2024-08-10",0,0,0,0,0,0,0,0
"Paraguay","2024-08-11",0,0,0,0,0,0,0,0
"Paraguay","2024-08-12",0,0,0,0,0,0,0,0
"Paraguay","2024-08-13",0,0,0,0,0,0,0,0
"Paraguay","2024-08-14",0,0,0,0,0,0,0,0
"Paraguay","2024-08-15",0,0,0,0,0,0,0,0
"Paraguay","2024-08-16",0,0,0,0,0,0,0,0
"Paraguay","2024-08-17",0,0,0,0,0,0,0,0
"Paraguay","2024-08-18",0,0,0,0,0,0,0,0
"Paraguay","2024-08-19",0,0,0,0,0,0,0,0
"Paraguay","2024-08-20",0,0,0,0,0,0,0,0
"Paraguay","2024-08-21",0,0,0,0,0,0,0,0
"Paraguay","2024-08-22",0,0,0,0,0,0,0,0
"Paraguay","2024-08-23",0,0,0,0,0,0,0,0
"Paraguay","2024-08-24",0,0,0,0,0,0,0,0
"Paraguay","2024-08-25",0,0,0,0,0,0,0,0
"Paraguay","2024-08-26",0,0,0,0,0,0,0,0
"Paraguay","2024-08-27",0,0,0,0,0,0,0,0
"Paraguay","2024-08-28",0,0,0,0,0,0,0,0
"Paraguay","2024-08-29",0,0,0,0,0,0,0,0
"Paraguay","2024-08-30",0,0,0,0,0,0,0,0
"Paraguay","2024-08-31",0,0,0,0,0,0,0,0
"Paraguay","2024-09-01",0,0,0,0,0,0,0,0
"Paraguay","2024-09-02",0,0,0,0,0,0,0,0
"Paraguay","2024-09-03",0,0,0,0,0,0,0,0
"Paraguay","2024-09-04",0,0,0,0,0,0,0,0
"Paraguay","2024-09-05",0,0,0,0,0,0,0,0
"Paraguay","2024-09-06",0,0,0,0,0,0,0,0
"Paraguay","2024-09-07",0,0,0,0,0,0,0,0
"Paraguay","2024-09-08",0,0,0,0,0,0,0,0
"Paraguay","2024-09-09",0,0,0,0,0,0,0,0
"Paraguay","2024-09-10",0,0,0,0,0,0,0,0
"Paraguay","2024-09-11",0,0,0,0,0,0,0,0
"Paraguay","2024-09-12",0,0,0,0,0,0,0,0
"Paraguay","2024-09-13",0,0,0,0,0,0,0,0
"Paraguay","2024-09-14",0,0,0,0,0,0,0,0
"Paraguay","2024-09-15",0,0,0,0,0,0,0,0
"Paraguay","2024-09-16",0,0,0,0,0,0,0,0
"Paraguay","2024-09-17",0,0,0,0,0,0,0,0
"Paraguay","2024-09-18",0,0,0,0,0,0,0,0
"Paraguay","2024-09-19",0,0,0,0,0,0,0,0
"Paraguay","2024-09-20",0,0,0,0,0,0,0,0
"Paraguay","2024-09-21",0,0,0,0,0,0,0,0
"Paraguay","2024-09-22",0,0,0,0,0,0,0,0
"Paraguay","2024-09-23",0,0,0,0,0,0,0,0
"Paraguay","2024-09-24",0,0,0,0,0,0,0,0
"Paraguay","2024-09-25",0,0,0,0,0,0,0,0
"Paraguay","2024-09-26",0,0,0,0,0,0,0,0
"Paraguay","2024-09-27",0,0,0,0,0,0,0,0
"Paraguay","2024-09-28",0,0,0,0,0,0,0,0
"Paraguay","2024-09-29",0,0,0,0,0,0,0,0
"Paraguay","2024-09-30",0,0,0,0,0,0,0,0
"Paraguay","2024-10-01",0,0,0,0,0,0,0,0
"Paraguay","2024-10-02",0,0,0,0,0,0,0,0
"Paraguay","2024-10-03",0,0,0,0,0,0,0,0
"Paraguay","2024-10-04",0,0,0,0,0,0,0,0
"Paraguay","2024-10-05",0,0,0,0,0,0,0,0
"Paraguay","2024-10-06",0,0,0,0,0,0,0,0
"Paraguay","2024-10-07",0,0,0,0,0,0,0,0
"Paraguay","2024-10-08",0,0,0,0,0,0,0,0
"Paraguay","2024-10-09",0,0,0,0,0,0,0,0
"Paraguay","2024-10-10",0,0,0,0,0,0,0,0
"Paraguay","2024-10-11",0,0,0,0,0,0,0,0
"Paraguay","2024-10-12",0,0,0,0,0,0,0,0
"Paraguay","2024-10-13",0,0,0,0,0,0,0,0
"Paraguay","2024-10-14",0,0,0,0,0,0,0,0
"Paraguay","2024-10-15",0,0,0,0,0,0,0,0
"Paraguay","2024-10-16",0,0,0,0,0,0,0,0
"Paraguay","2024-10-17",0,0,0,0,0,0,0,0
"Paraguay","2024-10-18",0,0,0,0,0,0,0,0
"Paraguay","2024-10-19",0,0,0,0,0,0,0,0
"Paraguay","2024-10-20",0,0,0,0,0,0,0,0
"Paraguay","2024-10-21",0,0,0,0,0,0,0,0
"Paraguay","2024-10-22",0,0,0,0,0,0,0,0
"Paraguay","2024-10-23",0,0,0,0,0,0,0,0
"Paraguay","2024-10-24",0,0,0,0,0,0,0,0
"Paraguay","2024-10-25",0,0,0,0,0,0,0,0
"Paraguay","2024-10-26",0,0,0,0,0,0,0,0
"Paraguay","2024-10-27",0,0,0,0,0,0,0,0
"Paraguay","2024-10-28",0,0,0,0,0,0,0,0
"Paraguay","2024-10-29",0,0,0,0,0,0,0,0
"Paraguay","2024-10-30",0,0,0,0,0,0,0,0
"Paraguay","2024-10-31",0,0,0,0,0,0,0,0
"Paraguay","2024-11-01",0,0,0,0,0,0,0,0
"Paraguay","2024-11-02",0,0,0,0,0,0,0,0
"Paraguay","2024-11-03",0,0,0,0,0,0,0,0
"Paraguay","2024-11-04",0,0,0,0,0,0,0,0
"Paraguay","2024-11-05",0,0,0,0,0,0,0,0
"Paraguay","2024-11-06",0,0,0,0,0,0,0,0
"Paraguay","2024-11-07",0,0,0,0,0,0,0,0
"Paraguay","2024-11-08",0,0,0,0,0,0,0,0
"Paraguay","2024-11-09",0,0,0,0,0,0,0,0
"Paraguay","2024-11-10",0,0,0,0,0,0,0,0
"Paraguay","2024-11-11",0,0,0,0,0,0,0,0
"Paraguay","2024-11-12",0,0,0,0,0,0,0,0
"Paraguay","2024-11-13",0,0,0,0,0,0,0,0
"Paraguay","2024-11-14",0,0,0,0,0,0,0,0
"Paraguay","2024-11-15",0,0,0,0,0,0,0,0
"Paraguay","2024-11-16",0,0,0,0,0,0,0,0
"Paraguay","2024-11-17",0,0,0,0,0,0,0,0
"Paraguay","2024-11-18",0,0,0,0,0,0,0,0
"Paraguay","2024-11-19",0,0,0,0,0,0,0,0
"Paraguay","2024-11-20",0,0,0,0,0,0,0,0
"Paraguay","2024-11-21",0,0,0,0,0,0,0,0
"Paraguay","2024-11-22",0,0,0,0,0,0,0,0
"Paraguay","2024-11-23",0,0,0,0,0,0,0,0
"Paraguay","2024-11-24",0,0,0,0,0,0,0,0
"Paraguay","2024-11-25",0,0,0,0,0,0,0,0
"Paraguay","2024-11-26",0,0,0,0,0,0,0,0
"Paraguay","2024-11-27",0,0,0,0,0,0,0,0
"Paraguay","2024-11-28",0,0,0,0,0,0,0,0
"Paraguay","2024-11-29",0,0,0,0,0,0,0,0
"Paraguay","2024-11-30",0,0,0,0,0,0,0,0
"Paraguay","2024-12-01",0,0,0,0,0,0,0,0
"Paraguay","2024-12-02",0,0,0,0,0,0,0,0
"Paraguay","2024-12-03",0,0,0,0,0,0,0,0
"Paraguay","2024-12-04",0,0,0,0,0,0,0,0
"Paraguay","2024-12-05",0,0,0,0,0,0,0,0
"Paraguay","2024-12-06",0,0,0,0,0,0,0,0
"Paraguay","2024-12-07",0,0,0,0,0,0,0,0
"Paraguay","2024-12-08",0,0,0,0,0,0,0,0
"Paraguay","2024-12-09",0,0,0,0,0,0,0,0
"Paraguay","2024-12-10",0,0,0,0,0,0,0,0
"Paraguay","2024-12-11",0,0,0,0,0,0,0,0
"Paraguay","2024-12-12",0,0,0,0,0,0,0,0
"Paraguay","2024-12-13",0,0,0,0,0,0,0,0
"Paraguay","2024-12-14",0,0,0,0,0,0,0,0
"Paraguay","2024-12-15",0,0,0,0,0,0,0,0
"Paraguay","2024-12-16",0,0,0,0,0,0,0,0
"Paraguay","2024-12-17",0,0,0,0,0,0,0,0
"Paraguay","2024-12-18",0,0,0,0,0,0,0,0
"Paraguay","2024-12-19",0,0,0,0,0,0,0,0
"Paraguay","2024-12-20",0,0,0,0,0,0,0,0
"Paraguay","2024-12-21",0,0,0,0,0,0,0,0
"Paraguay","2024-12-22",0,0,0,0,0,0,0,0
"Paraguay","2024-12-23",0,0,0,0,0,0,0,0
"Paraguay","2024-12-24",0,0,0,0,0,0,0,0
"Paraguay","2024-12-25",0,0,0,0,0,0,0,0
"Paraguay","2024-12-26",0,0,0,0,0,0,0,0
"Paraguay","2024-12-27",0,0,0,0,0,0,0,0
"Paraguay","2024-12-28",0,0,0,0,0,0,0,0
"Paraguay","2024-12-29",0,0,0,0,0,0,0,0
"Paraguay","2024-12-30",0,0,0,0,0,0,0,0
"Paraguay","2024-12-31",0,0,0,0,0,0,0,0
"Paraguay","2025-01-01",0,0,0,0,0,0,0,0
"Paraguay","2025-01-02",0,0,0,0,0,0,0,0
"Paraguay","2025-01-03",0,0,0,0,0,0,0,0
"Paraguay","2025-01-04",0,0,0,0,0,0,0,0
"Paraguay","2025-01-05",0,0,0,0,0,0,0,0
"Paraguay","2025-01-06",0,0,0,0,0,0,0,0
"Paraguay","2025-01-07",0,0,0,0,0,0,0,0
"Paraguay","2025-01-08",0,0,0,0,0,0,0,0
"Paraguay","2025-01-09",0,0,0,0,0,0,0,0
"Paraguay","2025-01-10",0,0,0,0,0,0,0,0
"Paraguay","2025-01-11",0,0,0,0,0,0,0,0
"Paraguay","2025-01-12",0,0,0,0,0,0,0,0
"Paraguay","2025-01-13",0,0,0,0,0,0,0,0
"Paraguay","2025-01-14",0,0,0,0,0,0,0,0
"Paraguay","2025-01-15",0,0,0,0,0,0,0,0
"Paraguay","2025-01-16",0,0,0,0,0,0,0,0
"Paraguay","2025-01-17",0,0,0,0,0,0,0,0
"Paraguay","2025-01-18",0,0,0,0,0,0,0,0
"Paraguay","2025-01-19",0,0,0,0,0,0,0,0
"Paraguay","2025-01-20",0,0,0,0,0,0,0,0
"Paraguay","2025-01-21",0,0,0,0,0,0,0,0
"Paraguay","2025-01-22",0,0,0,0,0,0,0,0
"Paraguay","2025-01-23",0,0,0,0,0,0,0,0
"Paraguay","2025-01-24",0,0,0,0,0,0,0,0
"Paraguay","2025-01-25",0,0,0,0,0,0,0,0
"Paraguay","2025-01-26",0,0,0,0,0,0,0,0
"Paraguay","2025-01-27",0,0,0,0,0,0,0,0
"Paraguay","2025-01-28",0,0,0,0,0,0,0,0
"Paraguay","2025-01-29",0,0,0,0,0,0,0,0
"Paraguay","2025-01-30",0,0,0,0,0,0,0,0
"Paraguay","2025-01-31",0,0,0,0,0,0,0,0
"Paraguay","2025-02-01",0,0,0,0,0,0,0,0
"Paraguay","2025-02-02",0,0,0,0,0,0,0,0
"Paraguay","2025-02-03",0,0,0,0,0,0,0,0
"Paraguay","2025-02-04",0,0,0,0,0,0,0,0
"Paraguay","2025-02-05",0,0,0,0,0,0,0,0
"Paraguay","2025-02-06",0,0,0,0,0,0,0,0
"Paraguay","2025-02-07",0,0,0,0,0,0,0,0
"Paraguay","2025-02-08",0,0,0,0,0,0,0,0
"Paraguay","2025-02-09",0,0,0,0,0,0,0,0
"Paraguay","2025-02-10",0,0,0,0,0,0,0,0
"Paraguay","2025-02-11",0,0,0,0,0,0,0,0
"Paraguay","2025-02-12",0,0,0,0,0,0,0,0
"Paraguay","2025-02-13",0,0,0,0,0,0,0,0
"Paraguay","2025-02-14",0,0,0,0,0,0,0,0
"Paraguay","2025-02-15",0,0,0,0,0,0,0,0
"Paraguay","2025-02-16",0,0,0,0,0,0,0,0
"Paraguay","2025-02-17",0,0,0,0,0,0,0,0
"Paraguay","2025-02-18",0,0,0,0,0,0,0,0
"Paraguay","2025-02-19",0,0,0,0,0,0,0,0
"Paraguay","2025-02-20",0,0,0,0,0,0,0,0
"Paraguay","2025-02-21",0,0,0,0,0,0,0,0
"Paraguay","2025-02-22",0,0,0,0,0,0,0,0
"Paraguay","2025-02-23",0,0,0,0,0,0,0,0
"Paraguay","2025-02-24",0,0,0,0,0,0,0,0
"Paraguay","2025-02-25",0,0,0,0,0,0,0,0
"Paraguay","2025-02-26",0,0,0,0,0,0,0,0
"Paraguay","2025-02-27",0,0,0,0,0,0,0,0
"Paraguay","2025-02-28",0,0,0,0,0,0,0,0
"Paraguay","2025-03-01",0,0,0,0,0,0,0,0
"Paraguay","2025-03-02",0,0,0,0,0,0,0,0
"Paraguay","2025-03-03",0,0,0,0,0,0,0,0
"Peru","2024-01-01",0,0,0,0,0,0,0,0
"Peru","2024-01-02",0,2,2,0,2,2,0,0
"Peru","2024-01-03",0,0,2,0,0,2,0,0
"Peru","2024-01-04",0,0,2,0,0,2,0,0
"Peru","2024-01-05",0,0,2,0,0,2,0,0
"Peru","2024-01-06",0,0,2,0,1,3,0,0
"Peru","2024-01-07",0,0,2,0,0,3,0,0
"Peru","2024-01-08",0,0,2,0,0,3,0,0
"Peru","2024-01-09",0,1,3,0,0,3,0,0
"Peru","2024-01-10",0,0,3,0,0,3,0,0
"Peru","2024-01-11",0,0,3,0,1,4,0,0
"Peru","2024-01-12",0,0,3,0,0,4,0,0
"Peru","2024-01-13",0,0,3,0,0,4,0,0
"Peru","2024-01-14",0,0,3,0,0,4,0,0
"Peru","2024-01-15",0,0,3,0,1,5,0,0
"Peru","2024-01-16",0,2,5,0,0,5,0,0
"Peru","2024-01-17",0,0,5,0,0,5,0,0
"Peru","2024-01-18",0,0,5,0,0,5,0,0
"Peru","2024-01-19",0,0,5,0,1,6,0,0
"Peru","2024-01-20",0,0,5,0,0,6,0,0
"Peru","2024-01-21",0,0,5,0,0,6,0,0
"Peru","2024-01-22",0,0,5,0,0,6,0,0
"Peru","2024-01-23",0,0,5,0,1,7,0,0
"Peru","2024-01-24",0,0,5,0,0,7,0,0
"Peru","2024-01-25",0,0,5,0,0,7,0,0
"Peru","2024-01-26",0,0,5,0,0,7,0,0
"Peru","2024-01-27",0,0,5,0,0,7,0,0
"Peru","2024-01-28",0,0,5,0,1,8,0,0
"Peru","2024-01-29",0,0,5,0,0,8,0,0
"Peru","2024-01-30",0,3,8,0,0,8,0,0
"Peru","2024-01-31",0,0,8,0,0,8,0,0
"Peru","2024-02-01",0,0,8,0,0,8,0,0
"Peru","2024-02-02",0,0,8,0,0,8,0,0
"Peru","2024-02-03",0,0,8,0,1,9,0,0
"Peru","2024-02-04",0,0,8,0,0,9,0,0
"Peru","2024-02-05",0,0,8,0,0,9,0,0
"Peru","2024-02-06",0,1,9,0,0,9,0,0
"Peru","2024-02-07",0,0,9,0,0,9,0,0
"Peru","2024-02-08",0,0,9,0,1,10,0,0
"Peru","2024-02-09",0,0,9,0,0,10,0,0
"Peru","2024-02-10",0,0,9,0,0,10,0,0
"Peru","2024-02-11",0,0,9,0,0,10,0,0
"Peru","2024-02-12",0,0,9,0,1,11,0,0
"Peru","2024-02-13",0,2,11,0,0,11,0,0
"Peru","2024-02-14",0,0,11,0,0,11,0,0
"Peru","2024-02-15",0,0,11,0,1,12,0,0
"Peru","2024-02-16",0,0,11,0,0,12,0,0
"Peru","2024-02-17",0,0,11,0,0,12,0,0
"Peru","2024-02-18",0,0,11,0,0,12,0,0
"Peru","2024-02-19",0,0,11,0,1,13,0,0
"Peru","2024-02-20",0,2,13,0,0,13,0,0
"Peru","2024-02-21",0,0,13,0,1,14,0,0
"Peru","2024-02-22",0,0,13,0,0,14,0,0
"Peru","2024-02-23",0,0,13,0,1,15,0,0
"Peru","2024-02-24",0,0,13,0,1,16,0,0
"Peru","2024-02-25",0,0,13,0,1,17,0,0
"Peru","2024-02-26",0,0,13,0,0,17,0,0
"Peru","2024-02-27",0,5,18,0,1,18,0,0
"Peru","2024-02-28",0,0,18,0,0,18,0,0
"Peru","2024-02-29",0,0,18,0,1,19,0,0
"Peru","2024-03-01",0,0,18,0,0,19,0,0
"Peru","2024-03-02",0,0,18,0,0,19,0,0
"Peru","2024-03-03",0,0,18,0,0,19,0,0
"Peru","2024-03-04",0,0,18,0,1,20,0,0
"Peru","2024-03-05",0,2,20,0,0,20,0,0
"Peru","2024-03-06",0,0,20,0,0,20,0,0
"Peru","2024-03-07",0,0,20,0,1,21,0,0
"Peru","2024-03-08",0,0,20,0,0,21,0,0
"Peru","2024-03-09",0,0,20,0,0,21,0,0
"Peru","2024-03-10",0,0,20,0,0,21,0,0
"Peru","2024-03-11",0,0,20,0,1,22,0,0
"Peru","2024-03-12",0,2,22,0,0,22,0,0
"Peru","2024-03-13",0,0,22,0,1,23,0,0
"Peru","2024-03-14",0,0,22,0,0,23,0,0
"Peru","2024-03-15",0,0,22,0,1,24,0,0
"Peru","2024-03-16",0,0,22,0,1,25,0,0
"Peru","2024-03-17",0,0,22,0,1,26,0,0
"Peru","2024-03-18",0,0,22,0,0,26,0,0
"Peru","2024-03-19",0,5,27,0,1,27,0,0
"Peru","2024-03-20",0,0,27,0,1,28,0,0
"Peru","2024-03-21",0,0,27,0,0,28,0,0
"Peru","2024-03-22",0,0,27,0,1,29,0,0
"Peru","2024-03-23",0,0,27,0,1,30,0,0
"Peru","2024-03-24",0,0,27,0,1,31,0,0
"Peru","2024-03-25",0,0,27,0,0,31,0,0
"Peru","2024-03-26",0,5,32,0,1,32,0,0
"Peru","2024-03-27",0,0,32,0,0,32,0,0
"Peru","2024-03-28",0,0,32,0,0,32,0,0
"Peru","2024-03-29",0,0,32,0,0,32,0,0
"Peru","2024-03-30",0,0,32,0,0,32,0,0
"Peru","2024-03-31",0,0,32,0,0,32,0,0
"Peru","2024-04-01",0,0,32,0,0,32,0,0
"Peru","2024-04-02",0,0,32,0,0,32,0,0
"Peru","2024-04-03",0,0,32,0,1,33,0,0
"Peru","2024-04-04",0,0,32,0,0,33,0,0
"Peru","2024-04-05",0,0,32,0,0,33,0,0
"Peru","2024-04-06",0,0,32,0,0,33,0,0
"Peru","2024-04-07",0,0,32,0,0,33,0,0
"Peru","2024-04-08",0,0,32,0,0,33,0,0
"Peru","2024-04-09",0,1,33,0,0,33,0,0
"Peru","2024-04-10",0,0,33,0,1,34,0,0
"Peru","2024-04-11",0,0,33,0,1,35,0,0
"Peru","2024-04-12",0,0,33,0,1,36,0,0
"Peru","2024-04-13",0,0,33,0,0,36,0,0
"Peru","2024-04-14",0,0,33,0,1,37,0,0
"Peru","2024-04-15",0,0,33,0,1,38,0,0
"Peru","2024-04-16",0,6,39,0,1,39,0,0
"Peru","2024-04-17",0,0,39,0,0,39,0,0
"Peru","2024-04-18",0,0,39,0,1,40,0,0
"Peru","2024-04-19",0,0,39,0,0,40,0,0
"Peru","2024-04-20",0,0,39,0,1,41,0,0
"Peru","2024-04-21",0,0,39,0,0,41,0,0
"Peru","2024-04-22",0,0,39,0,1,42,0,0
"Peru","2024-04-23",0,3,42,0,0,42,0,0
"Peru","2024-04-24",0,0,42,0,1,43,0,0
"Peru","2024-04-25",0,0,42,0,0,43,0,0
"Peru","2024-04-26",0,0,42,0,1,44,0,0
"Peru","2024-04-27",0,0,42,0,0,44,0,0
"Peru","2024-04-28",0,0,42,0,1,45,0,0
"Peru","2024-04-29",0,0,42,0,0,45,0,0
"Peru","2024-04-30",0,4,46,0,1,46,0,0
"Peru","2024-05-01",0,0,46,0,0,46,0,0
"Peru","2024-05-02",0,0,46,0,1,47,0,0
"Peru","2024-05-03",0,0,46,0,0,47,0,0
"Peru","2024-05-04",0,0,46,0,1,48,0,0
"Peru","2024-05-05",0,0,46,0,0,48,0,0
"Peru","2024-05-06",0,0,46,0,1,49,0,0
"Peru","2024-05-07",0,3,49,0,0,49,0,0
"Peru","2024-05-08",0,0,49,0,0,49,0,0
"Peru","2024-05-09",0,0,49,0,1,50,0,0
"Peru","2024-05-10",0,0,49,0,0,50,0,0
"Peru","2024-05-11",0,0,49,0,0,50,0,0
"Peru","2024-05-12",0,0,49,0,0,50,0,0
"Peru","2024-05-13",0,0,49,0,1,51,0,0
"Peru","2024-05-14",0,2,51,0,0,51,0,0
"Peru","2024-05-15",0,0,51,0,0,51,0,0
"Peru","2024-05-16",0,0,51,0,0,51,0,0
"Peru","2024-05-17",0,0,51,0,0,51,0,0
"Peru","2024-05-18",0,0,51,0,1,52,0,0
"Peru","2024-05-19",0,0,51,0,0,52,0,0
"Peru","2024-05-20",0,0,51,0,0,52,0,0
"Peru","2024-05-21",0,1,52,0,0,52,0,0
"Peru","2024-05-22",0,0,52,0,1,53,0,0
"Peru","2024-05-23",0,0,52,0,0,53,0,0
"Peru","2024-05-24",0,0,52,0,1,54,0,0
"Peru","2024-05-25",0,0,52,0,1,55,0,0
"Peru","2024-05-26",0,0,52,0,1,56,0,0
"Peru","2024-05-27",0,0,52,0,0,56,0,0
"Peru","2024-05-28",0,5,57,0,1,57,0,0
"Peru","2024-05-29",0,0,57,0,0,57,0,0
"Peru","2024-05-30",0,0,57,0,1,58,0,0
"Peru","2024-05-31",0,0,57,0,0,58,0,0
"Peru","2024-06-01",0,0,57,0,0,58,0,0
"Peru","2024-06-02",0,0,57,0,0,58,0,0
"Peru","2024-06-03",0,0,57,0,1,59,0,0
"Peru","2024-06-04",0,2,59,0,0,59,0,0
"Peru","2024-06-05",0,0,59,0,1,60,0,0
"Peru","2024-06-06",0,0,59,0,0,60,0,0
"Peru","2024-06-07",0,0,59,0,1,61,0,0
"Peru","2024-06-08",0,0,59,0,0,61,0,0
"Peru","2024-06-09",0,0,59,0,1,62,0,0
"Peru","2024-06-10",0,0,59,0,0,62,0,0
"Peru","2024-06-11",0,4,63,0,1,63,0,0
"Peru","2024-06-12",0,0,63,0,0,63,0,0
"Peru","2024-06-13",0,0,63,0,1,64,0,0
"Peru","2024-06-14",0,0,63,0,0,64,0,0
"Peru","2024-06-15",0,0,63,0,0,64,0,0
"Peru","2024-06-16",0,0,63,0,0,64,0,0
"Peru","2024-06-17",0,0,63,0,1,65,0,0
"Peru","2024-06-18",0,2,65,0,0,65,0,0
"Peru","2024-06-19",0,0,65,0,0,65,0,0
"Peru","2024-06-20",0,0,65,0,0,65,0,0
"Peru","2024-06-21",0,0,65,0,0,65,0,0
"Peru","2024-06-22",0,0,65,0,1,66,0,0
"Peru","2024-06-23",0,0,65,0,0,66,0,0
"Peru","2024-06-24",0,0,65,0,0,66,0,0
"Peru","2024-06-25",0,1,66,0,0,66,0,0
"Peru","2024-06-26",0,0,66,0,1,67,0,0
"Peru","2024-06-27",0,0,66,0,1,68,0,0
"Peru","2024-06-28",0,0,66,0,1,69,0,0
"Peru","2024-06-29",0,0,66,0,0,69,0,0
"Peru","2024-06-30",0,0,66,0,1,70,0,0
"Peru","2024-07-01",0,0,66,0,1,71,0,0
"Peru","2024-07-02",0,6,72,0,1,72,0,0
"Peru","2024-07-03",0,0,72,0,1,73,0,0
"Peru","2024-07-04",0,0,72,0,0,73,0,0
"Peru","2024-07-05",0,0,72,0,1,74,0,0
"Peru","2024-07-06",0,0,72,0,0,74,0,0
"Peru","2024-07-07",0,0,72,0,1,75,0,0
"Peru","2024-07-08",0,0,72,0,0,75,0,0
"Peru","2024-07-09",0,4,76,0,1,76,0,0
"Peru","2024-07-10",0,0,76,0,0,76,0,0
"Peru","2024-07-11",0,0,76,0,1,77,0,0
"Peru","2024-07-12",0,0,76,0,0,77,0,0
"Peru","2024-07-13",0,0,76,0,1,78,0,0
"Peru","2024-07-14",0,0,76,0,0,78,0,0
"Peru","2024-07-15",0,0,76,0,1,79,0,0
"Peru","2024-07-16",0,3,79,0,0,79,0,0
"Peru","2024-07-17",0,0,79,0,0,79,0,0
"Peru","2024-07-18",0,0,79,0,1,80,0,0
"Peru","2024-07-19",0,0,79,0,0,80,0,0
"Peru","2024-07-20",0,0,79,0,0,80,0,0
"Peru","2024-07-21",0,0,79,0,0,80,0,0
"Peru","2024-07-22",0,0,79,0,1,81,0,0
"Peru","2024-07-23",0,2,81,0,0,81,0,0
"Peru","2024-07-24",0,0,81,0,0,81,0,0
"Peru","2024-07-25",0,0,81,0,1,82,0,0
"Peru","2024-07-26",0,0,81,0,0,82,0,0
"Peru","2024-07-27",0,0,81,0,0,82,0,0
"Peru","2024-07-28",0,0,81,0,0,82,0,0
"Peru","2024-07-29",0,0,81,0,1,83,0,0
"Peru","2024-07-30",0,2,83,0,0,83,0,0
"Peru","2024-07-31",0,0,83,0,0,83,0,0
"Peru","2024-08-01",0,0,83,0,0,83,0,0
"Peru","2024-08-02",0,0,83,0,0,83,0,0
"Peru","2024-08-03",0,0,83,0,0,83,0,0
"Peru","2024-08-04",0,0,83,0,0,83,0,0
"Peru","2024-08-05",0,0,83,0,0,83,0,0
"Peru","2024-08-06",0,0,83,0,0,83,0,0
"Peru","2024-08-07",0,0,83,0,1,84,0,0
"Peru","2024-08-08",0,0,83,0,0,84,0,0
"Peru","2024-08-09",0,0,83,0,0,84,0,0
"Peru","2024-08-10",0,0,83,0,0,84,0,0
"Peru","2024-08-11",0,0,83,0,0,84,0,0
"Peru","2024-08-12",0,0,83,0,0,84,0,0
"Peru","2024-08-13",0,1,84,0,0,84,0,0
"Peru","2024-08-14",0,0,84,0,0,84,0,0
"Peru","2024-08-15",0,0,84,0,0,84,0,0
"Peru","2024-08-16",0,0,84,0,0,84,0,0
"Peru","2024-08-17",0,0,84,0,1,85,0,0
"Peru","2024-08-18",0,0,84,0,0,85,0,0
"Peru","2024-08-19",0,0,84,0,0,85,0,0
"Peru","2024-08-20",0,1,85,0,0,85,0,0
"Peru","2024-08-21",0,0,85,0,0,85,0,0
"Peru","2024-08-22",0,0,85,0,0,85,0,0
"Peru","2024-08-23",0,0,85,0,0,85,0,0
"Peru","2024-08-24",0,0,85,0,1,86,0,0
"Peru","2024-08-25",0,0,85,0,0,86,0,0
"Peru","2024-08-26",0,0,85,0,0,86,0,0
"Peru","2024-08-27",0,1,86,0,0,86,0,0
"Peru","2024-08-28",0,0,86,0,0,86,0,0
"Peru","2024-08-29",0,0,86,0,0,86,0,0
"Peru","2024-08-30",0,0,86,0,0,86,0,0
"Peru","2024-08-31",0,0,86,0,0,86,0,0
"Peru","2024-09-01",0,0,86,0,0,86,0,0
"Peru","2024-09-02",0,0,86,0,0,86,0,0
"Peru","2024-09-03",0,0,86,0,0,86,0,0
"Peru","2024-09-04",0,0,86,0,1,87,0,0
"Peru","2024-09-05",0,0,86,0,0,87,0,0
"Peru","2024-09-06",0,0,86,0,0,87,0,0
"Peru","2024-09-07",0,0,86,0,0,87,0,0
"Peru","2024-09-08",0,0,86,0,0,87,0,0
"Peru","2024-09-09",0,0,86,0,0,87,0,0
"Peru","2024-09-10",0,1,87,0,0,87,0,0
"Peru","2024-09-11",0,0,87,0,0,87,0,0
"Peru","2024-09-12",0,0,87,0,1,88,0,0
"Peru","2024-09-13",0,0,87,0,0,88,0,0
"Peru","2024-09-14",0,0,87,0,0,88,0,0
"Peru","2024-09-15",0,0,87,0,0,88,0,0
"Peru","2024-09-16",0,0,87,0,1,89,0,0
"Peru","2024-09-17",0,2,89,0,0,89,0,0
"Peru","2024-09-18",0,0,89,0,0,89,0,0
"Peru","2024-09-19",0,0,89,0,0,89,0,0
"Peru","2024-09-20",0,0,89,0,0,89,0,0
"Peru","2024-09-21",0,0,89,0,0,89,0,0
"Peru","2024-09-22",0,0,89,0,0,89,0,0
"Peru","2024-09-23",0,0,89,0,0,89,0,0
"Peru","2024-09-24",0,0,89,0,0,89,0,0
"Peru","2024-09-25",0,0,89,0,1,90,0,0
"Peru","2024-09-26",0,0,89,0,0,90,0,0
"Peru","2024-09-27",0,0,89,0,0,90,0,0
"Peru","2024-09-28",0,0,89,0,0,90,0,0
"Peru","2024-09-29",0,0,89,0,0,90,0,0
"Peru","2024-09-30",0,0,89,0,0,90,0,0
"Peru","2024-10-01",0,1,90,0,0,90,0,0
"Peru","2024-10-02",0,0,90,0,0,90,0,0
"Peru","2024-10-03",0,0,90,0,0,90,0,0
"Peru","2024-10-04",0,0,90,0,0,90,0,0
"Peru","2024-10-05",0,0,90,0,0,90,0,0
"Peru","2024-10-06",0,0,90,0,0,90,0,0
"Peru","2024-10-07",0,0,90,0,0,90,0,0
"Peru","2024-10-08",0,0,90,0,0,90,0,0
"Peru","2024-10-09",0,0,90,0,0,90,0,0
"Peru","2024-10-10",0,0,90,0,0,90,0,0
"Peru","2024-10-11",0,0,90,0,0,90,0,0
"Peru","2024-10-12",0,0,90,0,0,90,0,0
"Peru","2024-10-13",0,0,90,0,0,90,0,0
"Peru","2024-10-14",0,0,90,0,0,90,0,0
"Peru","2024-10-15",0,0,90,0,0,90,0,0
"Peru","2024-10-16",0,0,90,0,0,90,0,0
"Peru","2024-10-17",0,0,90,0,0,90,0,0
"Peru","2024-10-18",0,0,90,0,0,90,0,0
"Peru","2024-10-19",0,0,90,0,0,90,0,0
"Peru","2024-10-20",0,0,90,0,0,90,0,0
"Peru","2024-10-21",0,0,90,0,0,90,0,0
"Peru","2024-10-22",0,0,90,0,0,90,0,0
"Peru","2024-10-23",0,0,90,0,0,90,0,0
"Peru","2024-10-24",0,0,90,0,0,90,0,0
"Peru","2024-10-25",0,0,90,0,0,90,0,0
"Peru","2024-10-26",0,0,90,0,0,90,0,0
"Peru","2024-10-27",0,0,90,0,0,90,0,0
"Peru","2024-10-28",0,0,90,0,0,90,0,0
"Peru","2024-10-29",0,0,90,0,0,90,0,0
"Peru","2024-10-30",0,0,90,0,0,90,0,0
"Peru","2024-10-31",0,0,90,0,0,90,0,0
"Peru","2024-11-01",0,0,90,0,0,90,0,0
"Peru","2024-11-02",0,0,90,0,0,90,0,0
"Peru","2024-11-03",0,0,90,0,0,90,0,0
"Peru","2024-11-04",0,0,90,0,0,90,0,0
"Peru","2024-11-05",0,0,90,0,0,90,0,0
"Peru","2024-11-06",0,0,90,0,0,90,0,0
"Peru","2024-11-07",0,0,90,0,0,90,0,0
"Peru","2024-11-08",0,0,90,0,0,90,0,0
"Peru","2024-11-09",0,0,90,0,0,90,0,0
"Peru","2024-11-10",0,0,90,0,0,90,0,0
"Peru","2024-11-11",0,0,90,0,0,90,0,0
"Peru","2024-11-12",0,0,90,0,0,90,0,0
"Peru","2024-11-13",0,0,90,0,0,90,0,0
"Peru","2024-11-14",0,0,90,0,0,90,0,0
"Peru","2024-11-15",0,0,90,0,0,90,0,0
"Peru","2024-11-16",0,0,90,0,0,90,0,0
"Peru","2024-11-17",0,0,90,0,0,90,0,0
"Peru","2024-11-18",0,0,90,0,0,90,0,0
"Peru","2024-11-19",0,0,90,0,0,90,0,0
"Peru","2024-11-20",0,0,90,0,0,90,0,0
"Peru","2024-11-21",0,0,90,0,0,90,0,0
"Peru","2024-11-22",0,0,90,0,0,90,0,0
"Peru","2024-11-23",0,0,90,0,0,90,0,0
"Peru","2024-11-24",0,0,90,0,0,90,0,0
"Peru","2024-11-25",0,0,90,0,0,90,0,0
"Peru","2024-11-26",0,0,90,0,0,90,0,0
"Peru","2024-11-27",0,0,90,0,0,90,0,0
"Peru","2024-11-28",0,0,90,0,0,90,0,0
"Peru","2024-11-29",0,0,90,0,0,90,0,0
"Peru","2024-11-30",0,0,90,0,0,90,0,0
"Peru","2024-12-01",0,0,90,0,0,90,0,0
"Peru","2024-12-02",0,0,90,0,0,90,0,0
"Peru","2024-12-03",0,0,90,0,0,90,0,0
"Peru","2024-12-04",0,0,90,0,0,90,0,0
"Peru","2024-12-05",0,0,90,0,0,90,0,0
"Peru","2024-12-06",0,0,90,0,0,90,0,0
"Peru","2024-12-07",0,0,90,0,0,90,0,0
"Peru","2024-12-08",0,0,90,0,0,90,0,0
"Peru","2024-12-09",0,0,90,0,0,90,0,0
"Peru","2024-12-10",0,0,90,0,0,90,0,0
"Peru","2024-12-11",0,0,90,0,0,90,0,0
"Peru","2024-12-12",0,0,90,0,0,90,0,0
"Peru","2024-12-13",0,0,90,0,0,90,0,0
"Peru","2024-12-14",0,0,90,0,0,90,0,0
"Peru","2024-12-15",0,0,90,0,0,90,0,0
"Peru","2024-12-16",0,0,90,0,0,90,0,0
"Peru","2024-12-17",0,0,90,0,0,90,0,0
"Peru","2024-12-18",0,0,90,0,0,90,0,0
"Peru","2024-12-19",0,0,90,0,0,90,0,0
"Peru","2024-12-20",0,0,90,0,0,90,0,0
"Peru","2024-12-21",0,0,90,0,0,90,0,0
"Peru","2024-12-22",0,0,90,0,0,90,0,0
"Peru","2024-12-23",0,0,90,0,0,90,0,0
"Peru","2024-12-24",0,0,90,0,0,90,0,0
"Peru","2024-12-25",0,0,90,0,0,90,0,0
"Peru","2024-12-26",0,0,90,0,0,90,0,0
"Peru","2024-12-27",0,0,90,0,0,90,0,0
"Peru","2024-12-28",0,0,90,0,0,90,0,0
"Peru","2024-12-29",0,0,90,0,0,90,0,0
"Peru","2024-12-30",0,0,90,0,0,90,0,0
"Peru","2024-12-31",0,0,90,0,0,90,0,0
"Peru","2025-01-01",0,0,90,0,0,90,0,0
"Peru","2025-01-02",0,0,90,0,0,90,0,0
"Peru","2025-01-03",0,0,90,0,0,90,0,0
"Peru","2025-01-04",0,0,90,0,0,90,0,0
"Peru","2025-01-05",0,0,90,0,0,90,0,0
"Peru","2025-01-06",0,0,90,0,0,90,0,0
"Peru","2025-01-07",0,0,90,0,0,90,0,0
"Peru","2025-01-08",0,0,90,0,0,90,0,0
"Peru","2025-01-09",0,0,90,0,0,90,0,0
"Peru","2025-01-10",0,0,90,0,0,90,0,0
"Peru","2025-01-11",0,0,90,0,0,90,0,0
"Peru","2025-01-12",0,0,90,0,0,90,0,0
"Peru","2025-01-13",0,0,90,0,0,90,0,0
"Peru","2025-01-14",0,0,90,0,0,90,0,0
"Peru","2025-01-15",0,0,90,0,0,90,0,0
"Peru","2025-01-16",0,0,90,0,0,90,0,0
"Peru","2025-01-17",0,0,90,0,0,90,0,0
"Peru","2025-01-18",0,0,90,0,0,90,0,0
"Peru","2025-01-19",0,0,90,0,0,90,0,0
"Peru","2025-01-20",0,0,90,0,0,90,0,0
"Peru","2025-01-21",0,0,90,0,0,90,0,0
"Peru","2025-01-22",0,0,90,0,0,90,0,0
"Peru","2025-01-23",0,0,90,0,0,90,0,0
"Peru","2025-01-24",0,0,90,0,0,90,0,0
"Peru","2025-01-25",0,0,90,0,0,90,0,0
"Peru","2025-01-26",0,0,90,0,0,90,0,0
"Peru","2025-01-27",0,0,90,0,0,90,0,0
"Peru","2025-01-28",0,0,90,0,0,90,0,0
"Peru","2025-01-29",0,0,90,0,0,90,0,0
"Peru","2025-01-30",0,0,90,0,0,90,0,0
"Peru","2025-01-31",0,0,90,0,0,90,0,0
"Peru","2025-02-01",0,0,90,0,0,90,0,0
"Peru","2025-02-02",0,0,90,0,0,90,0,0
"Peru","2025-02-03",0,0,90,0,0,90,0,0
"Peru","2025-02-04",0,0,90,0,0,90,0,0
"Peru","2025-02-05",0,0,90,0,0,90,0,0
"Peru","2025-02-06",0,0,90,0,0,90,0,0
"Peru","2025-02-07",0,0,90,0,0,90,0,0
"Peru","2025-02-08",0,0,90,0,0,90,0,0
"Peru","2025-02-09",0,0,90,0,0,90,0,0
"Peru","2025-02-10",0,0,90,0,0,90,0,0
"Peru","2025-02-11",0,0,90,0,0,90,0,0
"Peru","2025-02-12",0,0,90,0,0,90,0,0
"Peru","2025-02-13",0,0,90,0,0,90,0,0
"Peru","2025-02-14",0,0,90,0,0,90,0,0
"Peru","2025-02-15",0,0,90,0,0,90,0,0
"Peru","2025-02-16",0,0,90,0,0,90,0,0
"Peru","2025-02-17",0,0,90,0,0,90,0,0
"Peru","2025-02-18",0,0,90,0,0,90,0,0
"Peru","2025-02-19",0,0,90,0,0,90,0,0
"Peru","2025-02-20",0,0,90,0,0,90,0,0
"Peru","2025-02-21",0,0,90,0,0,90,0,0
"Peru","2025-02-22",0,0,90,0,0,90,0,0
"Peru","2025-02-23",0,0,90,0,0,90,0,0
"Peru","2025-02-24",0,0,90,0,0,90,0,0
"Peru","2025-02-25",0,0,90,0,0,90,0,0
"Peru","2025-02-26",0,0,90,0,0,90,0,0
"Peru","2025-02-27",0,0,90,0,0,90,0,0
"Peru","2025-02-28",0,0,90,0,0,90,0,0
"Peru","2025-03-01",0,0,90,0,0,90,0,0
"Peru","2025-03-02",0,0,90,0,0,90,0,0
"Peru","2025-03-03",0,0,90,0,0,90,0,0
"Philippines","2024-01-01",0,0,0,0,0,0,0,0
"Philippines","2024-01-02",0,0,0,0,0,0,0,0
"Philippines","2024-01-03",0,0,0,0,0,0,0,0
"Philippines","2024-01-04",0,0,0,0,0,0,0,0
"Philippines","2024-01-05",0,0,0,0,0,0,0,0
"Philippines","2024-01-06",0,0,0,0,0,0,0,0
"Philippines","2024-01-07",0,0,0,0,0,0,0,0
"Philippines","2024-01-08",0,0,0,0,0,0,0,0
"Philippines","2024-01-09",0,0,0,0,0,0,0,0
"Philippines","2024-01-10",0,0,0,0,0,0,0,0
"Philippines","2024-01-11",0,0,0,0,0,0,0,0
"Philippines","2024-01-12",0,0,0,0,0,0,0,0
"Philippines","2024-01-13",0,0,0,0,0,0,0,0
"Philippines","2024-01-14",0,0,0,0,0,0,0,0
"Philippines","2024-01-15",0,0,0,0,0,0,0,0
"Philippines","2024-01-16",0,0,0,0,0,0,0,0
"Philippines","2024-01-17",0,0,0,0,0,0,0,0
"Philippines","2024-01-18",0,0,0,0,0,0,0,0
"Philippines","2024-01-19",0,0,0,0,0,0,0,0
"Philippines","2024-01-20",0,0,0,0,0,0,0,0
"Philippines","2024-01-21",0,0,0,0,0,0,0,0
"Philippines","2024-01-22",0,0,0,0,0,0,0,0
"Philippines","2024-01-23",0,0,0,0,0,0,0,0
"Philippines","2024-01-24",0,0,0,0,0,0,0,0
"Philippines","2024-01-25",0,0,0,0,0,0,0,0
"Philippines","2024-01-26",0,0,0,0,0,0,0,0
"Philippines","2024-01-27",0,0,0,0,0,0,0,0
"Philippines","2024-01-28",0,0,0,0,0,0,0,0
"Philippines","2024-01-29",0,0,0,0,0,0,0,0
"Philippines","2024-01-30",0,0,0,0,0,0,0,0
"Philippines","2024-01-31",0,0,0,0,0,0,0,0
"Philippines","2024-02-01",0,0,0,0,0,0,0,0
"Philippines","2024-02-02",0,0,0,0,0,0,0,0
"Philippines","2024-02-03",0,0,0,0,0,0,0,0
"Philippines","2024-02-04",0,0,0,0,0,0,0,0
"Philippines","2024-02-05",0,0,0,0,0,0,0,0
"Philippines","2024-02-06",0,0,0,0,0,0,0,0
"Philippines","2024-02-07",0,0,0,0,0,0,0,0
"Philippines","2024-02-08",0,0,0,0,0,0,0,0
"Philippines","2024-02-09",0,0,0,0,0,0,0,0
"Philippines","2024-02-10",0,0,0,0,0,0,0,0
"Philippines","2024-02-11",0,0,0,0,0,0,0,0
"Philippines","2024-02-12",0,0,0,0,0,0,0,0
"Philippines","2024-02-13",0,0,0,0,0,0,0,0
"Philippines","2024-02-14",0,0,0,0,0,0,0,0
"Philippines","2024-02-15",0,0,0,0,0,0,0,0
"Philippines","2024-02-16",0,0,0,0,0,0,0,0
"Philippines","2024-02-17",0,0,0,0,0,0,0,0
"Philippines","2024-02-18",0,0,0,0,0,0,0,0
"Philippines","2024-02-19",0,0,0,0,0,0,0,0
"Philippines","2024-02-20",0,0,0,0,0,0,0,0
"Philippines","2024-02-21",0,0,0,0,0,0,0,0
"Philippines","2024-02-22",0,0,0,0,0,0,0,0
"Philippines","2024-02-23",0,0,0,0,0,0,0,0
"Philippines","2024-02-24",0,0,0,0,0,0,0,0
"Philippines","2024-02-25",0,0,0,0,0,0,0,0
"Philippines","2024-02-26",0,0,0,0,0,0,0,0
"Philippines","2024-02-27",0,0,0,0,0,0,0,0
"Philippines","2024-02-28",0,0,0,0,0,0,0,0
"Philippines","2024-02-29",0,0,0,0,0,0,0,0
"Philippines","2024-03-01",0,0,0,0,0,0,0,0
"Philippines","2024-03-02",0,0,0,0,0,0,0,0
"Philippines","2024-03-03",0,0,0,0,0,0,0,0
"Philippines","2024-03-04",0,0,0,0,0,0,0,0
"Philippines","2024-03-05",0,0,0,0,0,0,0,0
"Philippines","2024-03-06",0,0,0,0,0,0,0,0
"Philippines","2024-03-07",0,0,0,0,0,0,0,0
"Philippines","2024-03-08",0,0,0,0,0,0,0,0
"Philippines","2024-03-09",0,0,0,0,0,0,0,0
"Philippines","2024-03-10",0,0,0,0,0,0,0,0
"Philippines","2024-03-11",0,0,0,0,0,0,0,0
"Philippines","2024-03-12",0,0,0,0,0,0,0,0
"Philippines","2024-03-13",0,0,0,0,0,0,0,0
"Philippines","2024-03-14",0,0,0,0,0,0,0,0
"Philippines","2024-03-15",0,0,0,0,0,0,0,0
"Philippines","2024-03-16",0,0,0,0,0,0,0,0
"Philippines","2024-03-17",0,0,0,0,0,0,0,0
"Philippines","2024-03-18",0,0,0,0,0,0,0,0
"Philippines","2024-03-19",0,0,0,0,0,0,0,0
"Philippines","2024-03-20",0,0,0,0,0,0,0,0
"Philippines","2024-03-21",0,0,0,0,0,0,0,0
"Philippines","2024-03-22",0,0,0,0,0,0,0,0
"Philippines","2024-03-23",0,0,0,0,0,0,0,0
"Philippines","2024-03-24",0,0,0,0,0,0,0,0
"Philippines","2024-03-25",0,0,0,0,0,0,0,0
"Philippines","2024-03-26",0,0,0,0,0,0,0,0
"Philippines","2024-03-27",0,0,0,0,0,0,0,0
"Philippines","2024-03-28",0,0,0,0,0,0,0,0
"Philippines","2024-03-29",0,0,0,0,0,0,0,0
"Philippines","2024-03-30",0,0,0,0,0,0,0,0
"Philippines","2024-03-31",0,0,0,0,0,0,0,0
"Philippines","2024-04-01",0,0,0,0,0,0,0,0
"Philippines","2024-04-02",0,0,0,0,0,0,0,0
"Philippines","2024-04-03",0,0,0,0,0,0,0,0
"Philippines","2024-04-04",0,0,0,0,0,0,0,0
"Philippines","2024-04-05",0,0,0,0,0,0,0,0
"Philippines","2024-04-06",0,0,0,0,0,0,0,0
"Philippines","2024-04-07",0,0,0,0,0,0,0,0
"Philippines","2024-04-08",0,0,0,0,0,0,0,0
"Philippines","2024-04-09",0,0,0,0,0,0,0,0
"Philippines","2024-04-10",0,0,0,0,0,0,0,0
"Philippines","2024-04-11",0,0,0,0,0,0,0,0
"Philippines","2024-04-12",0,0,0,0,0,0,0,0
"Philippines","2024-04-13",0,0,0,0,0,0,0,0
"Philippines","2024-04-14",0,0,0,0,0,0,0,0
"Philippines","2024-04-15",0,0,0,0,0,0,0,0
"Philippines","2024-04-16",0,0,0,0,0,0,0,0
"Philippines","2024-04-17",0,0,0,0,0,0,0,0
"Philippines","2024-04-18",0,0,0,0,0,0,0,0
"Philippines","2024-04-19",0,0,0,0,0,0,0,0
"Philippines","2024-04-20",0,0,0,0,0,0,0,0
"Philippines","2024-04-21",0,0,0,0,0,0,0,0
"Philippines","2024-04-22",0,0,0,0,0,0,0,0
"Philippines","2024-04-23",0,0,0,0,0,0,0,0
"Philippines","2024-04-24",0,0,0,0,0,0,0,0
"Philippines","2024-04-25",0,0,0,0,0,0,0,0
"Philippines","2024-04-26",0,0,0,0,0,0,0,0
"Philippines","2024-04-27",0,0,0,0,0,0,0,0
"Philippines","2024-04-28",0,0,0,0,0,0,0,0
"Philippines","2024-04-29",0,0,0,0,0,0,0,0
"Philippines","2024-04-30",0,0,0,0,0,0,0,0
"Philippines","2024-05-01",0,0,0,0,0,0,0,0
"Philippines","2024-05-02",0,0,0,0,0,0,0,0
"Philippines","2024-05-03",0,0,0,0,0,0,0,0
"Philippines","2024-05-04",0,0,0,0,0,0,0,0
"Philippines","2024-05-05",0,0,0,0,0,0,0,0
"Philippines","2024-05-06",0,0,0,0,0,0,0,0
"Philippines","2024-05-07",0,0,0,0,0,0,0,0
"Philippines","2024-05-08",0,0,0,0,0,0,0,0
"Philippines","2024-05-09",0,0,0,0,0,0,0,0
"Philippines","2024-05-10",0,0,0,0,0,0,0,0
"Philippines","2024-05-11",0,0,0,0,0,0,0,0
"Philippines","2024-05-12",0,0,0,0,0,0,0,0
"Philippines","2024-05-13",0,0,0,0,0,0,0,0
"Philippines","2024-05-14",0,0,0,0,0,0,0,0
"Philippines","2024-05-15",0,0,0,0,0,0,0,0
"Philippines","2024-05-16",0,0,0,0,0,0,0,0
"Philippines","2024-05-17",0,0,0,0,0,0,0,0
"Philippines","2024-05-18",0,0,0,0,0,0,0,0
"Philippines","2024-05-19",0,0,0,0,0,0,0,0
"Philippines","2024-05-20",0,0,0,0,0,0,0,0
"Philippines","2024-05-21",0,0,0,0,0,0,0,0
"Philippines","2024-05-22",0,0,0,0,0,0,0,0
"Philippines","2024-05-23",0,0,0,0,0,0,0,0
"Philippines","2024-05-24",0,0,0,0,0,0,0,0
"Philippines","2024-05-25",0,0,0,0,0,0,0,0
"Philippines","2024-05-26",0,0,0,0,0,0,0,0
"Philippines","2024-05-27",0,0,0,0,0,0,0,0
"Philippines","2024-05-28",0,0,0,0,0,0,0,0
"Philippines","2024-05-29",0,0,0,0,0,0,0,0
"Philippines","2024-05-30",0,0,0,0,0,0,0,0
"Philippines","2024-05-31",0,0,0,0,0,0,0,0
"Philippines","2024-06-01",0,0,0,0,0,0,0,0
"Philippines","2024-06-02",0,0,0,0,0,0,0,0
"Philippines","2024-06-03",0,0,0,0,0,0,0,0
"Philippines","2024-06-04",0,0,0,0,0,0,0,0
"Philippines","2024-06-05",0,0,0,0,0,0,0,0
"Philippines","2024-06-06",0,0,0,0,0,0,0,0
"Philippines","2024-06-07",0,0,0,0,0,0,0,0
"Philippines","2024-06-08",0,0,0,0,0,0,0,0
"Philippines","2024-06-09",0,0,0,0,0,0,0,0
"Philippines","2024-06-10",0,0,0,0,0,0,0,0
"Philippines","2024-06-11",0,0,0,0,0,0,0,0
"Philippines","2024-06-12",0,0,0,0,0,0,0,0
"Philippines","2024-06-13",0,0,0,0,0,0,0,0
"Philippines","2024-06-14",0,0,0,0,0,0,0,0
"Philippines","2024-06-15",0,0,0,0,0,0,0,0
"Philippines","2024-06-16",0,0,0,0,0,0,0,0
"Philippines","2024-06-17",0,0,0,0,0,0,0,0
"Philippines","2024-06-18",0,0,0,0,0,0,0,0
"Philippines","2024-06-19",0,0,0,0,0,0,0,0
"Philippines","2024-06-20",0,0,0,0,0,0,0,0
"Philippines","2024-06-21",0,0,0,0,0,0,0,0
"Philippines","2024-06-22",0,0,0,0,0,0,0,0
"Philippines","2024-06-23",0,0,0,0,0,0,0,0
"Philippines","2024-06-24",0,0,0,0,0,0,0,0
"Philippines","2024-06-25",0,0,0,0,0,0,0,0
"Philippines","2024-06-26",0,0,0,0,0,0,0,0
"Philippines","2024-06-27",0,0,0,0,0,0,0,0
"Philippines","2024-06-28",0,0,0,0,0,0,0,0
"Philippines","2024-06-29",0,0,0,0,0,0,0,0
"Philippines","2024-06-30",0,0,0,0,0,0,0,0
"Philippines","2024-07-01",0,0,0,0,0,0,0,0
"Philippines","2024-07-02",0,0,0,0,0,0,0,0
"Philippines","2024-07-03",0,0,0,0,0,0,0,0
"Philippines","2024-07-04",0,0,0,0,0,0,0,0
"Philippines","2024-07-05",0,0,0,0,0,0,0,0
"Philippines","2024-07-06",0,0,0,0,0,0,0,0
"Philippines","2024-07-07",0,0,0,0,0,0,0,0
"Philippines","2024-07-08",0,0,0,0,0,0,0,0
"Philippines","2024-07-09",0,0,0,0,0,0,0,0
"Philippines","2024-07-10",0,0,0,0,0,0,0,0
"Philippines","2024-07-11",0,0,0,0,0,0,0,0
"Philippines","2024-07-12",0,0,0,0,0,0,0,0
"Philippines","2024-07-13",0,0,0,0,0,0,0,0
"Philippines","2024-07-14",0,0,0,0,0,0,0,0
"Philippines","2024-07-15",0,0,0,0,0,0,0,0
"Philippines","2024-07-16",0,0,0,0,0,0,0,0
"Philippines","2024-07-17",0,0,0,0,0,0,0,0
"Philippines","2024-07-18",0,0,0,0,0,0,0,0
"Philippines","2024-07-19",0,0,0,0,0,0,0,0
"Philippines","2024-07-20",0,0,0,0,0,0,0,0
"Philippines","2024-07-21",0,0,0,0,0,0,0,0
"Philippines","2024-07-22",0,0,0,0,0,0,0,0
"Philippines","2024-07-23",0,0,0,0,0,0,0,0
"Philippines","2024-07-24",0,0,0,0,0,0,0,0
"Philippines","2024-07-25",0,0,0,0,0,0,0,0
"Philippines","2024-07-26",0,0,0,0,0,0,0,0
"Philippines","2024-07-27",0,0,0,0,0,0,0,0
"Philippines","2024-07-28",0,0,0,0,0,0,0,0
"Philippines","2024-07-29",0,0,0,0,0,0,0,0
"Philippines","2024-07-30",0,0,0,0,0,0,0,0
"Philippines","2024-07-31",0,0,0,0,0,0,0,0
"Philippines","2024-08-01",0,0,0,0,0,0,0,0
"Philippines","2024-08-02",0,0,0,0,0,0,0,0
"Philippines","2024-08-03",0,0,0,0,0,0,0,0
"Philippines","2024-08-04",0,0,0,0,0,0,0,0
"Philippines","2024-08-05",0,0,0,0,0,0,0,0
"Philippines","2024-08-06",0,0,0,0,0,0,0,0
"Philippines","2024-08-07",0,0,0,0,0,0,0,0
"Philippines","2024-08-08",0,0,0,0,0,0,0,0
"Philippines","2024-08-09",0,0,0,0,0,0,0,0
"Philippines","2024-08-10",0,0,0,0,0,0,0,0
"Philippines","2024-08-11",0,0,0,0,0,0,0,0
"Philippines","2024-08-12",0,0,0,0,0,0,0,0
"Philippines","2024-08-13",0,0,0,0,0,0,0,0
"Philippines","2024-08-14",0,0,0,0,0,0,0,0
"Philippines","2024-08-15",0,0,0,0,0,0,0,0
"Philippines","2024-08-16",0,0,0,0,0,0,0,0
"Philippines","2024-08-17",0,0,0,0,0,0,0,0
"Philippines","2024-08-18",0,0,0,0,0,0,0,0
"Philippines","2024-08-19",0,1,1,0,1,1,0,0
"Philippines","2024-08-20",0,0,1,0,0,1,0,0
"Philippines","2024-08-21",0,0,1,0,1,2,0,0
"Philippines","2024-08-22",0,0,1,0,0,2,0,0
"Philippines","2024-08-23",0,0,1,0,1,3,0,0
"Philippines","2024-08-24",0,0,1,0,0,3,0,0
"Philippines","2024-08-25",0,0,1,0,1,4,0,0
"Philippines","2024-08-26",0,0,1,0,0,4,0,0
"Philippines","2024-08-27",0,0,1,0,1,5,0,0
"Philippines","2024-08-28",0,4,5,0,0,5,0,0
"Philippines","2024-08-29",0,0,5,0,1,6,0,0
"Philippines","2024-08-30",0,0,5,0,1,7,0,0
"Philippines","2024-08-31",0,0,5,0,0,7,0,0
"Philippines","2024-09-01",0,3,8,0,1,8,0,0
"Philippines","2024-09-02",0,0,8,0,1,9,0,0
"Philippines","2024-09-03",0,0,8,0,0,9,0,0
"Philippines","2024-09-04",0,0,8,0,1,10,0,0
"Philippines","2024-09-05",0,0,8,0,0,10,0,0
"Philippines","2024-09-06",0,0,8,0,1,11,0,0
"Philippines","2024-09-07",0,0,8,0,1,12,0,0
"Philippines","2024-09-08",0,0,8,0,0,12,0,0
"Philippines","2024-09-09",0,0,8,0,1,13,0,0
"Philippines","2024-09-10",0,0,8,0,0,13,0,0
"Philippines","2024-09-11",0,0,8,0,1,14,0,0
"Philippines","2024-09-12",0,0,8,0,1,15,0,0
"Philippines","2024-09-13",0,0,8,0,0,15,0,0
"Philippines","2024-09-14",0,0,8,0,1,16,0,0
"Philippines","2024-09-15",0,0,8,0,0,16,0,0
"Philippines","2024-09-16",0,0,8,0,1,17,0,0
"Philippines","2024-09-17",0,0,8,0,1,18,0,0
"Philippines","2024-09-18",0,0,8,0,0,18,0,0
"Philippines","2024-09-19",0,0,8,0,1,19,0,0
"Philippines","2024-09-20",0,0,8,0,0,19,0,0
"Philippines","2024-09-21",0,0,8,0,1,20,0,0
"Philippines","2024-09-22",0,0,8,0,1,21,0,0
"Philippines","2024-09-23",0,0,8,0,0,21,0,0
"Philippines","2024-09-24",0,0,8,0,1,22,0,0
"Philippines","2024-09-25",0,0,8,0,0,22,0,0
"Philippines","2024-09-26",0,15,23,0,1,23,0,0
"Philippines","2024-09-27",0,0,23,0,0,23,0,0
"Philippines","2024-09-28",0,0,23,0,1,24,0,0
"Philippines","2024-09-29",0,0,23,0,0,24,0,0
"Philippines","2024-09-30",0,0,23,0,1,25,0,0
"Philippines","2024-10-01",0,0,23,0,0,25,0,0
"Philippines","2024-10-02",0,0,23,0,0,25,0,0
"Philippines","2024-10-03",0,0,23,0,1,26,0,0
"Philippines","2024-10-04",0,0,23,0,0,26,0,0
"Philippines","2024-10-05",0,0,23,0,0,26,0,0
"Philippines","2024-10-06",0,0,23,0,1,27,0,0
"Philippines","2024-10-07",0,0,23,0,0,27,0,0
"Philippines","2024-10-08",0,0,23,0,1,28,0,0
"Philippines","2024-10-09",0,0,23,0,0,28,0,0
"Philippines","2024-10-10",0,0,23,0,0,28,0,0
"Philippines","2024-10-11",0,0,23,0,1,29,0,0
"Philippines","2024-10-12",0,0,23,0,0,29,0,0
"Philippines","2024-10-13",0,0,23,0,1,30,0,0
"Philippines","2024-10-14",0,0,23,0,0,30,0,0
"Philippines","2024-10-15",0,0,23,0,0,30,0,0
"Philippines","2024-10-16",0,0,23,0,1,31,0,0
"Philippines","2024-10-17",0,0,23,0,0,31,0,0
"Philippines","2024-10-18",0,0,23,0,1,32,0,0
"Philippines","2024-10-19",0,0,23,0,0,32,0,0
"Philippines","2024-10-20",0,0,23,0,0,32,0,0
"Philippines","2024-10-21",0,0,23,0,1,33,0,0
"Philippines","2024-10-22",0,0,23,0,0,33,0,0
"Philippines","2024-10-23",0,0,23,0,0,33,0,0
"Philippines","2024-10-24",0,0,23,0,1,34,0,0
"Philippines","2024-10-25",0,0,23,0,0,34,0,0
"Philippines","2024-10-26",0,0,23,0,1,35,0,0
"Philippines","2024-10-27",0,0,23,0,0,35,0,0
"Philippines","2024-10-28",0,0,23,0,0,35,0,0
"Philippines","2024-10-29",0,0,23,0,1,36,0,0
"Philippines","2024-10-30",0,0,23,0,0,36,0,0
"Philippines","2024-10-31",0,0,23,0,1,37,0,0
"Philippines","2024-11-01",0,0,23,0,0,37,0,0
"Philippines","2024-11-02",0,0,23,0,0,37,0,0
"Philippines","2024-11-03",0,0,23,0,1,38,0,0
"Philippines","2024-11-04",0,0,23,0,0,38,0,0
"Philippines","2024-11-05",0,0,23,0,0,38,0,0
"Philippines","2024-11-06",0,0,23,0,1,39,0,0
"Philippines","2024-11-07",0,0,23,0,0,39,0,0
"Philippines","2024-11-08",0,0,23,0,1,40,0,0
"Philippines","2024-11-09",0,0,23,0,0,40,0,0
"Philippines","2024-11-10",0,0,23,0,0,40,0,0
"Philippines","2024-11-11",0,0,23,0,1,41,0,0
"Philippines","2024-11-12",0,0,23,0,0,41,0,0
"Philippines","2024-11-13",0,0,23,0,1,42,0,0
"Philippines","2024-11-14",0,0,23,0,0,42,0,0
"Philippines","2024-11-15",0,0,23,0,0,42,0,0
"Philippines","2024-11-16",0,0,23,0,1,43,0,0
"Philippines","2024-11-17",0,0,23,0,0,43,0,0
"Philippines","2024-11-18",0,0,23,0,1,44,0,0
"Philippines","2024-11-19",0,0,23,0,0,44,0,0
"Philippines","2024-11-20",0,0,23,0,0,44,0,0
"Philippines","2024-11-21",0,0,23,0,1,45,0,0
"Philippines","2024-11-22",0,0,23,0,0,45,0,0
"Philippines","2024-11-23",0,0,23,0,0,45,0,0
"Philippines","2024-11-24",0,0,23,0,1,46,0,0
"Philippines","2024-11-25",0,0,23,0,0,46,0,0
"Philippines","2024-11-26",0,0,23,0,1,47,0,0
"Philippines","2024-11-27",0,24,47,0,0,47,0,0
"Philippines","2024-11-28",0,0,47,0,0,47,0,0
"Philippines","2024-11-29",0,0,47,0,0,47,0,0
"Philippines","2024-11-30",0,0,47,0,1,48,0,0
"Philippines","2024-12-01",0,0,47,0,0,48,0,0
"Philippines","2024-12-02",0,0,47,0,0,48,0,0
"Philippines","2024-12-03",0,0,47,0,0,48,0,0
"Philippines","2024-12-04",0,0,47,0,1,49,0,0
"Philippines","2024-12-05",0,0,47,0,0,49,0,0
"Philippines","2024-12-06",0,0,47,0,0,49,0,0
"Philippines","2024-12-07",0,0,47,0,0,49,0,0
"Philippines","2024-12-08",0,0,47,0,1,50,0,0
"Philippines","2024-12-09",0,0,47,0,0,50,0,0
"Philippines","2024-12-10",0,0,47,0,0,50,0,0
"Philippines","2024-12-11",0,0,47,0,0,50,0,0
"Philippines","2024-12-12",0,0,47,0,1,51,0,0
"Philippines","2024-12-13",0,0,47,0,0,51,0,0
"Philippines","2024-12-14",0,0,47,0,0,51,0,0
"Philippines","2024-12-15",0,0,47,0,0,51,0,0
"Philippines","2024-12-16",0,0,47,0,1,52,0,0
"Philippines","2024-12-17",0,0,47,0,0,52,0,0
"Philippines","2024-12-18",0,0,47,0,0,52,0,0
"Philippines","2024-12-19",0,0,47,0,0,52,0,0
"Philippines","2024-12-20",0,0,47,0,1,53,0,0
"Philippines","2024-12-21",0,0,47,0,0,53,0,0
"Philippines","2024-12-22",0,0,47,0,0,53,0,0
"Philippines","2024-12-23",0,0,47,0,0,53,0,0
"Philippines","2024-12-24",0,0,47,0,1,54,0,0
"Philippines","2024-12-25",0,0,47,0,0,54,0,0
"Philippines","2024-12-26",0,7,54,0,0,54,0,0
"Philippines","2024-12-27",0,0,54,0,2,56,0,0
"Philippines","2024-12-28",0,0,54,0,2,58,0,0
"Philippines","2024-12-29",0,0,54,0,2,60,0,0
"Philippines","2024-12-30",0,0,54,0,2,62,0,0
"Philippines","2024-12-31",0,10,64,0,2,64,0,0
"Philippines","2025-01-01",0,0,64,0,0,64,0,0
"Philippines","2025-01-02",0,0,64,0,0,64,0,0
"Philippines","2025-01-03",0,0,64,0,0,64,0,0
"Philippines","2025-01-04",0,0,64,0,0,64,0,0
"Philippines","2025-01-05",0,0,64,0,0,64,0,0
"Philippines","2025-01-06",0,0,64,0,0,64,0,0
"Philippines","2025-01-07",0,0,64,0,0,64,0,0
"Philippines","2025-01-08",0,0,64,0,0,64,0,0
"Philippines","2025-01-09",0,0,64,0,0,64,0,0
"Philippines","2025-01-10",0,0,64,0,0,64,0,0
"Philippines","2025-01-11",0,0,64,0,0,64,0,0
"Philippines","2025-01-12",0,0,64,0,0,64,0,0
"Philippines","2025-01-13",0,0,64,0,0,64,0,0
"Philippines","2025-01-14",0,0,64,0,0,64,0,0
"Philippines","2025-01-15",0,0,64,0,0,64,0,0
"Philippines","2025-01-16",0,0,64,0,0,64,0,0
"Philippines","2025-01-17",0,0,64,0,0,64,0,0
"Philippines","2025-01-18",0,0,64,0,0,64,0,0
"Philippines","2025-01-19",0,0,64,0,0,64,0,0
"Philippines","2025-01-20",0,0,64,0,0,64,0,0
"Philippines","2025-01-21",0,0,64,0,0,64,0,0
"Philippines","2025-01-22",0,0,64,0,0,64,0,0
"Philippines","2025-01-23",0,0,64,0,0,64,0,0
"Philippines","2025-01-24",0,0,64,0,0,64,0,0
"Philippines","2025-01-25",0,0,64,0,0,64,0,0
"Philippines","2025-01-26",0,0,64,0,0,64,0,0
"Philippines","2025-01-27",0,0,64,0,0,64,0,0
"Philippines","2025-01-28",0,0,64,0,0,64,0,0
"Philippines","2025-01-29",0,0,64,0,0,64,0,0
"Philippines","2025-01-30",0,0,64,0,0,64,0,0
"Philippines","2025-01-31",0,0,64,0,0,64,0,0
"Philippines","2025-02-01",0,0,64,0,0,64,0,0
"Philippines","2025-02-02",0,0,64,0,0,64,0,0
"Philippines","2025-02-03",0,0,64,0,0,64,0,0
"Philippines","2025-02-04",0,0,64,0,0,64,0,0
"Philippines","2025-02-05",0,0,64,0,0,64,0,0
"Philippines","2025-02-06",0,0,64,0,0,64,0,0
"Philippines","2025-02-07",0,0,64,0,0,64,0,0
"Philippines","2025-02-08",0,0,64,0,0,64,0,0
"Philippines","2025-02-09",0,0,64,0,0,64,0,0
"Philippines","2025-02-10",0,0,64,0,0,64,0,0
"Philippines","2025-02-11",0,0,64,0,0,64,0,0
"Philippines","2025-02-12",0,0,64,0,0,64,0,0
"Philippines","2025-02-13",0,0,64,0,0,64,0,0
"Philippines","2025-02-14",0,0,64,0,0,64,0,0
"Philippines","2025-02-15",0,0,64,0,0,64,0,0
"Philippines","2025-02-16",0,0,64,0,0,64,0,0
"Philippines","2025-02-17",0,0,64,0,0,64,0,0
"Philippines","2025-02-18",0,0,64,0,0,64,0,0
"Philippines","2025-02-19",0,0,64,0,0,64,0,0
"Philippines","2025-02-20",0,0,64,0,0,64,0,0
"Philippines","2025-02-21",0,0,64,0,0,64,0,0
"Philippines","2025-02-22",0,0,64,0,0,64,0,0
"Philippines","2025-02-23",0,0,64,0,0,64,0,0
"Philippines","2025-02-24",0,0,64,0,0,64,0,0
"Philippines","2025-02-25",0,0,64,0,0,64,0,0
"Philippines","2025-02-26",0,0,64,0,0,64,0,0
"Philippines","2025-02-27",0,0,64,0,0,64,0,0
"Philippines","2025-02-28",0,0,64,0,0,64,0,0
"Philippines","2025-03-01",0,0,64,0,0,64,0,0
"Philippines","2025-03-02",0,0,64,0,0,64,0,0
"Philippines","2025-03-03",0,0,64,0,0,64,0,0
"Poland","2024-01-01",0,0,0,0,0,0,0,0
"Poland","2024-01-02",0,0,0,0,0,0,0,0
"Poland","2024-01-03",0,0,0,0,0,0,0,0
"Poland","2024-01-04",0,0,0,0,0,0,0,0
"Poland","2024-01-05",0,0,0,0,0,0,0,0
"Poland","2024-01-06",0,0,0,0,0,0,0,0
"Poland","2024-01-07",0,0,0,0,0,0,0,0
"Poland","2024-01-08",0,0,0,0,0,0,0,0
"Poland","2024-01-09",0,0,0,0,0,0,0,0
"Poland","2024-01-10",0,0,0,0,0,0,0,0
"Poland","2024-01-11",0,0,0,0,0,0,0,0
"Poland","2024-01-12",0,0,0,0,0,0,0,0
"Poland","2024-01-13",0,0,0,0,0,0,0,0
"Poland","2024-01-14",0,0,0,0,0,0,0,0
"Poland","2024-01-15",0,0,0,0,0,0,0,0
"Poland","2024-01-16",0,0,0,0,0,0,0,0
"Poland","2024-01-17",0,0,0,0,0,0,0,0
"Poland","2024-01-18",0,0,0,0,0,0,0,0
"Poland","2024-01-19",0,0,0,0,0,0,0,0
"Poland","2024-01-20",0,0,0,0,0,0,0,0
"Poland","2024-01-21",0,0,0,0,0,0,0,0
"Poland","2024-01-22",0,0,0,0,0,0,0,0
"Poland","2024-01-23",0,0,0,0,0,0,0,0
"Poland","2024-01-24",0,0,0,0,0,0,0,0
"Poland","2024-01-25",0,0,0,0,0,0,0,0
"Poland","2024-01-26",0,0,0,0,0,0,0,0
"Poland","2024-01-27",0,0,0,0,0,0,0,0
"Poland","2024-01-28",0,0,0,0,0,0,0,0
"Poland","2024-01-29",0,0,0,0,0,0,0,0
"Poland","2024-01-30",0,0,0,0,0,0,0,0
"Poland","2024-01-31",0,3,3,0,3,3,0,0
"Poland","2024-02-01",0,0,3,0,0,3,0,0
"Poland","2024-02-02",0,0,3,0,0,3,0,0
"Poland","2024-02-03",0,0,3,0,0,3,0,0
"Poland","2024-02-04",0,0,3,0,0,3,0,0
"Poland","2024-02-05",0,0,3,0,0,3,0,0
"Poland","2024-02-06",0,0,3,0,0,3,0,0
"Poland","2024-02-07",0,0,3,0,0,3,0,0
"Poland","2024-02-08",0,0,3,0,0,3,0,0
"Poland","2024-02-09",0,0,3,0,0,3,0,0
"Poland","2024-02-10",0,0,3,0,0,3,0,0
"Poland","2024-02-11",0,0,3,0,0,3,0,0
"Poland","2024-02-12",0,0,3,0,0,3,0,0
"Poland","2024-02-13",0,0,3,0,0,3,0,0
"Poland","2024-02-14",0,0,3,0,0,3,0,0
"Poland","2024-02-15",0,0,3,0,0,3,0,0
"Poland","2024-02-16",0,0,3,0,0,3,0,0
"Poland","2024-02-17",0,0,3,0,0,3,0,0
"Poland","2024-02-18",0,0,3,0,0,3,0,0
"Poland","2024-02-19",0,0,3,0,0,3,0,0
"Poland","2024-02-20",0,0,3,0,0,3,0,0
"Poland","2024-02-21",0,0,3,0,0,3,0,0
"Poland","2024-02-22",0,0,3,0,0,3,0,0
"Poland","2024-02-23",0,0,3,0,0,3,0,0
"Poland","2024-02-24",0,0,3,0,0,3,0,0
"Poland","2024-02-25",0,0,3,0,0,3,0,0
"Poland","2024-02-26",0,0,3,0,0,3,0,0
"Poland","2024-02-27",0,0,3,0,0,3,0,0
"Poland","2024-02-28",0,0,3,0,0,3,0,0
"Poland","2024-02-29",0,0,3,0,0,3,0,0
"Poland","2024-03-01",0,0,3,0,0,3,0,0
"Poland","2024-03-02",0,0,3,0,1,4,0,0
"Poland","2024-03-03",0,0,3,0,0,4,0,0
"Poland","2024-03-04",0,0,3,0,0,4,0,0
"Poland","2024-03-05",0,0,3,0,0,4,0,0
"Poland","2024-03-06",0,0,3,0,0,4,0,0
"Poland","2024-03-07",0,0,3,0,0,4,0,0
"Poland","2024-03-08",0,0,3,0,0,4,0,0
"Poland","2024-03-09",0,0,3,0,0,4,0,0
"Poland","2024-03-10",0,0,3,0,0,4,0,0
"Poland","2024-03-11",0,0,3,0,0,4,0,0
"Poland","2024-03-12",0,0,3,0,0,4,0,0
"Poland","2024-03-13",0,0,3,0,0,4,0,0
"Poland","2024-03-14",0,0,3,0,0,4,0,0
"Poland","2024-03-15",0,0,3,0,0,4,0,0
"Poland","2024-03-16",0,0,3,0,0,4,0,0
"Poland","2024-03-17",0,0,3,0,0,4,0,0
"Poland","2024-03-18",0,0,3,0,0,4,0,0
"Poland","2024-03-19",0,0,3,0,0,4,0,0
"Poland","2024-03-20",0,0,3,0,0,4,0,0
"Poland","2024-03-21",0,0,3,0,0,4,0,0
"Poland","2024-03-22",0,0,3,0,0,4,0,0
"Poland","2024-03-23",0,0,3,0,0,4,0,0
"Poland","2024-03-24",0,0,3,0,0,4,0,0
"Poland","2024-03-25",0,0,3,0,0,4,0,0
"Poland","2024-03-26",0,0,3,0,0,4,0,0
"Poland","2024-03-27",0,0,3,0,0,4,0,0
"Poland","2024-03-28",0,0,3,0,0,4,0,0
"Poland","2024-03-29",0,0,3,0,0,4,0,0
"Poland","2024-03-30",0,0,3,0,0,4,0,0
"Poland","2024-03-31",0,1,4,0,0,4,0,0
"Poland","2024-04-01",0,0,4,0,0,4,0,0
"Poland","2024-04-02",0,0,4,0,0,4,0,0
"Poland","2024-04-03",0,0,4,0,0,4,0,0
"Poland","2024-04-04",0,0,4,0,0,4,0,0
"Poland","2024-04-05",0,0,4,0,0,4,0,0
"Poland","2024-04-06",0,0,4,0,0,4,0,0
"Poland","2024-04-07",0,0,4,0,0,4,0,0
"Poland","2024-04-08",0,0,4,0,0,4,0,0
"Poland","2024-04-09",0,0,4,0,0,4,0,0
"Poland","2024-04-10",0,0,4,0,0,4,0,0
"Poland","2024-04-11",0,0,4,0,0,4,0,0
"Poland","2024-04-12",0,0,4,0,0,4,0,0
"Poland","2024-04-13",0,0,4,0,0,4,0,0
"Poland","2024-04-14",0,0,4,0,0,4,0,0
"Poland","2024-04-15",0,0,4,0,0,4,0,0
"Poland","2024-04-16",0,0,4,0,1,5,0,0
"Poland","2024-04-17",0,0,4,0,0,5,0,0
"Poland","2024-04-18",0,0,4,0,0,5,0,0
"Poland","2024-04-19",0,0,4,0,0,5,0,0
"Poland","2024-04-20",0,0,4,0,0,5,0,0
"Poland","2024-04-21",0,0,4,0,0,5,0,0
"Poland","2024-04-22",0,0,4,0,0,5,0,0
"Poland","2024-04-23",0,0,4,0,0,5,0,0
"Poland","2024-04-24",0,0,4,0,0,5,0,0
"Poland","2024-04-25",0,0,4,0,0,5,0,0
"Poland","2024-04-26",0,0,4,0,0,5,0,0
"Poland","2024-04-27",0,0,4,0,0,5,0,0
"Poland","2024-04-28",0,0,4,0,0,5,0,0
"Poland","2024-04-29",0,0,4,0,0,5,0,0
"Poland","2024-04-30",0,0,4,0,0,5,0,0
"Poland","2024-05-01",0,0,4,0,0,5,0,0
"Poland","2024-05-02",0,0,4,0,0,5,0,0
"Poland","2024-05-03",0,0,4,0,0,5,0,0
"Poland","2024-05-04",0,0,4,0,0,5,0,0
"Poland","2024-05-05",0,0,4,0,0,5,0,0
"Poland","2024-05-06",0,0,4,0,0,5,0,0
"Poland","2024-05-07",0,0,4,0,0,5,0,0
"Poland","2024-05-08",0,0,4,0,0,5,0,0
"Poland","2024-05-09",0,0,4,0,0,5,0,0
"Poland","2024-05-10",0,0,4,0,0,5,0,0
"Poland","2024-05-11",0,0,4,0,0,5,0,0
"Poland","2024-05-12",0,0,4,0,0,5,0,0
"Poland","2024-05-13",0,0,4,0,0,5,0,0
"Poland","2024-05-14",0,0,4,0,0,5,0,0
"Poland","2024-05-15",0,0,4,0,0,5,0,0
"Poland","2024-05-16",0,0,4,0,1,6,0,0
"Poland","2024-05-17",0,0,4,0,0,6,0,0
"Poland","2024-05-18",0,0,4,0,0,6,0,0
"Poland","2024-05-19",0,0,4,0,0,6,0,0
"Poland","2024-05-20",0,0,4,0,0,6,0,0
"Poland","2024-05-21",0,0,4,0,0,6,0,0
"Poland","2024-05-22",0,0,4,0,0,6,0,0
"Poland","2024-05-23",0,0,4,0,0,6,0,0
"Poland","2024-05-24",0,0,4,0,0,6,0,0
"Poland","2024-05-25",0,0,4,0,0,6,0,0
"Poland","2024-05-26",0,0,4,0,0,6,0,0
"Poland","2024-05-27",0,0,4,0,0,6,0,0
"Poland","2024-05-28",0,0,4,0,0,6,0,0
"Poland","2024-05-29",0,0,4,0,0,6,0,0
"Poland","2024-05-30",0,0,4,0,0,6,0,0
"Poland","2024-05-31",0,2,6,0,0,6,0,0
"Poland","2024-06-01",0,0,6,0,0,6,0,0
"Poland","2024-06-02",0,0,6,0,0,6,0,0
"Poland","2024-06-03",0,0,6,0,0,6,0,0
"Poland","2024-06-04",0,0,6,0,0,6,0,0
"Poland","2024-06-05",0,0,6,0,0,6,0,0
"Poland","2024-06-06",0,0,6,0,0,6,0,0
"Poland","2024-06-07",0,0,6,0,0,6,0,0
"Poland","2024-06-08",0,0,6,0,0,6,0,0
"Poland","2024-06-09",0,0,6,0,0,6,0,0
"Poland","2024-06-10",0,0,6,0,0,6,0,0
"Poland","2024-06-11",0,0,6,0,0,6,0,0
"Poland","2024-06-12",0,0,6,0,0,6,0,0
"Poland","2024-06-13",0,0,6,0,0,6,0,0
"Poland","2024-06-14",0,0,6,0,0,6,0,0
"Poland","2024-06-15",0,0,6,0,0,6,0,0
"Poland","2024-06-16",0,0,6,0,0,6,0,0
"Poland","2024-06-17",0,0,6,0,0,6,0,0
"Poland","2024-06-18",0,0,6,0,0,6,0,0
"Poland","2024-06-19",0,0,6,0,0,6,0,0
"Poland","2024-06-20",0,0,6,0,0,6,0,0
"Poland","2024-06-21",0,0,6,0,0,6,0,0
"Poland","2024-06-22",0,0,6,0,0,6,0,0
"Poland","2024-06-23",0,0,6,0,0,6,0,0
"Poland","2024-06-24",0,0,6,0,1,7,0,0
"Poland","2024-06-25",0,0,6,0,0,7,0,0
"Poland","2024-06-26",0,0,6,0,0,7,0,0
"Poland","2024-06-27",0,0,6,0,0,7,0,0
"Poland","2024-06-28",0,0,6,0,0,7,0,0
"Poland","2024-06-29",0,0,6,0,0,7,0,0
"Poland","2024-06-30",0,0,6,0,0,7,0,0
"Poland","2024-07-01",0,0,6,0,0,7,0,0
"Poland","2024-07-02",0,0,6,0,0,7,0,0
"Poland","2024-07-03",0,0,6,0,0,7,0,0
"Poland","2024-07-04",0,0,6,0,0,7,0,0
"Poland","2024-07-05",0,0,6,0,0,7,0,0
"Poland","2024-07-06",0,0,6,0,0,7,0,0
"Poland","2024-07-07",0,0,6,0,0,7,0,0
"Poland","2024-07-08",0,0,6,0,0,7,0,0
"Poland","2024-07-09",0,0,6,0,0,7,0,0
"Poland","2024-07-10",0,0,6,0,0,7,0,0
"Poland","2024-07-11",0,0,6,0,0,7,0,0
"Poland","2024-07-12",0,0,6,0,0,7,0,0
"Poland","2024-07-13",0,0,6,0,0,7,0,0
"Poland","2024-07-14",0,0,6,0,0,7,0,0
"Poland","2024-07-15",0,0,6,0,0,7,0,0
"Poland","2024-07-16",0,0,6,0,0,7,0,0
"Poland","2024-07-17",0,0,6,0,0,7,0,0
"Poland","2024-07-18",0,0,6,0,0,7,0,0
"Poland","2024-07-19",0,0,6,0,0,7,0,0
"Poland","2024-07-20",0,0,6,0,0,7,0,0
"Poland","2024-07-21",0,0,6,0,0,7,0,0
"Poland","2024-07-22",0,0,6,0,0,7,0,0
"Poland","2024-07-23",0,0,6,0,0,7,0,0
"Poland","2024-07-24",0,0,6,0,0,7,0,0
"Poland","2024-07-25",0,0,6,0,0,7,0,0
"Poland","2024-07-26",0,0,6,0,0,7,0,0
"Poland","2024-07-27",0,0,6,0,0,7,0,0
"Poland","2024-07-28",0,0,6,0,0,7,0,0
"Poland","2024-07-29",0,0,6,0,0,7,0,0
"Poland","2024-07-30",0,0,6,0,0,7,0,0
"Poland","2024-07-31",0,0,6,0,0,7,0,0
"Poland","2024-08-01",0,0,6,0,0,7,0,0
"Poland","2024-08-02",0,0,6,0,0,7,0,0
"Poland","2024-08-03",0,0,6,0,0,7,0,0
"Poland","2024-08-04",0,0,6,0,0,7,0,0
"Poland","2024-08-05",0,0,6,0,0,7,0,0
"Poland","2024-08-06",0,0,6,0,0,7,0,0
"Poland","2024-08-07",0,0,6,0,0,7,0,0
"Poland","2024-08-08",0,0,6,0,1,8,0,0
"Poland","2024-08-09",0,0,6,0,0,8,0,0
"Poland","2024-08-10",0,0,6,0,0,8,0,0
"Poland","2024-08-11",0,0,6,0,0,8,0,0
"Poland","2024-08-12",0,0,6,0,0,8,0,0
"Poland","2024-08-13",0,0,6,0,0,8,0,0
"Poland","2024-08-14",0,0,6,0,0,8,0,0
"Poland","2024-08-15",0,0,6,0,0,8,0,0
"Poland","2024-08-16",0,0,6,0,0,8,0,0
"Poland","2024-08-17",0,0,6,0,0,8,0,0
"Poland","2024-08-18",0,0,6,0,0,8,0,0
"Poland","2024-08-19",0,0,6,0,0,8,0,0
"Poland","2024-08-20",0,0,6,0,0,8,0,0
"Poland","2024-08-21",0,0,6,0,0,8,0,0
"Poland","2024-08-22",0,0,6,0,0,8,0,0
"Poland","2024-08-23",0,0,6,0,0,8,0,0
"Poland","2024-08-24",0,0,6,0,0,8,0,0
"Poland","2024-08-25",0,0,6,0,0,8,0,0
"Poland","2024-08-26",0,0,6,0,0,8,0,0
"Poland","2024-08-27",0,0,6,0,0,8,0,0
"Poland","2024-08-28",0,0,6,0,0,8,0,0
"Poland","2024-08-29",0,0,6,0,0,8,0,0
"Poland","2024-08-30",0,0,6,0,0,8,0,0
"Poland","2024-08-31",0,2,8,0,0,8,0,0
"Poland","2024-09-01",0,0,8,0,0,8,0,0
"Poland","2024-09-02",0,0,8,0,0,8,0,0
"Poland","2024-09-03",0,0,8,0,0,8,0,0
"Poland","2024-09-04",0,0,8,0,0,8,0,0
"Poland","2024-09-05",0,0,8,0,0,8,0,0
"Poland","2024-09-06",0,0,8,0,0,8,0,0
"Poland","2024-09-07",0,0,8,0,0,8,0,0
"Poland","2024-09-08",0,0,8,0,0,8,0,0
"Poland","2024-09-09",0,0,8,0,0,8,0,0
"Poland","2024-09-10",0,0,8,0,0,8,0,0
"Poland","2024-09-11",0,0,8,0,0,8,0,0
"Poland","2024-09-12",0,0,8,0,0,8,0,0
"Poland","2024-09-13",0,0,8,0,0,8,0,0
"Poland","2024-09-14",0,0,8,0,0,8,0,0
"Poland","2024-09-15",0,0,8,0,0,8,0,0
"Poland","2024-09-16",0,0,8,0,0,8,0,0
"Poland","2024-09-17",0,0,8,0,0,8,0,0
"Poland","2024-09-18",0,0,8,0,0,8,0,0
"Poland","2024-09-19",0,0,8,0,0,8,0,0
"Poland","2024-09-20",0,0,8,0,0,8,0,0
"Poland","2024-09-21",0,0,8,0,0,8,0,0
"Poland","2024-09-22",0,0,8,0,0,8,0,0
"Poland","2024-09-23",0,0,8,0,0,8,0,0
"Poland","2024-09-24",0,0,8,0,0,8,0,0
"Poland","2024-09-25",0,0,8,0,0,8,0,0
"Poland","2024-09-26",0,0,8,0,0,8,0,0
"Poland","2024-09-27",0,0,8,0,0,8,0,0
"Poland","2024-09-28",0,0,8,0,0,8,0,0
"Poland","2024-09-29",0,0,8,0,0,8,0,0
"Poland","2024-09-30",0,0,8,0,0,8,0,0
"Poland","2024-10-01",0,0,8,0,1,9,0,0
"Poland","2024-10-02",0,0,8,0,0,9,0,0
"Poland","2024-10-03",0,0,8,0,0,9,0,0
"Poland","2024-10-04",0,0,8,0,0,9,0,0
"Poland","2024-10-05",0,0,8,0,0,9,0,0
"Poland","2024-10-06",0,0,8,0,0,9,0,0
"Poland","2024-10-07",0,0,8,0,0,9,0,0
"Poland","2024-10-08",0,0,8,0,0,9,0,0
"Poland","2024-10-09",0,0,8,0,0,9,0,0
"Poland","2024-10-10",0,0,8,0,0,9,0,0
"Poland","2024-10-11",0,0,8,0,0,9,0,0
"Poland","2024-10-12",0,0,8,0,0,9,0,0
"Poland","2024-10-13",0,0,8,0,0,9,0,0
"Poland","2024-10-14",0,0,8,0,0,9,0,0
"Poland","2024-10-15",0,0,8,0,0,9,0,0
"Poland","2024-10-16",0,0,8,0,0,9,0,0
"Poland","2024-10-17",0,0,8,0,0,9,0,0
"Poland","2024-10-18",0,0,8,0,0,9,0,0
"Poland","2024-10-19",0,0,8,0,0,9,0,0
"Poland","2024-10-20",0,0,8,0,0,9,0,0
"Poland","2024-10-21",0,0,8,0,0,9,0,0
"Poland","2024-10-22",0,0,8,0,0,9,0,0
"Poland","2024-10-23",0,0,8,0,0,9,0,0
"Poland","2024-10-24",0,0,8,0,0,9,0,0
"Poland","2024-10-25",0,0,8,0,0,9,0,0
"Poland","2024-10-26",0,0,8,0,0,9,0,0
"Poland","2024-10-27",0,0,8,0,0,9,0,0
"Poland","2024-10-28",0,0,8,0,0,9,0,0
"Poland","2024-10-29",0,0,8,0,0,9,0,0
"Poland","2024-10-30",0,0,8,0,0,9,0,0
"Poland","2024-10-31",0,0,8,0,0,9,0,0
"Poland","2024-11-01",0,0,8,0,0,9,0,0
"Poland","2024-11-02",0,0,8,0,0,9,0,0
"Poland","2024-11-03",0,0,8,0,0,9,0,0
"Poland","2024-11-04",0,0,8,0,0,9,0,0
"Poland","2024-11-05",0,0,8,0,0,9,0,0
"Poland","2024-11-06",0,0,8,0,0,9,0,0
"Poland","2024-11-07",0,0,8,0,0,9,0,0
"Poland","2024-11-08",0,0,8,0,0,9,0,0
"Poland","2024-11-09",0,0,8,0,0,9,0,0
"Poland","2024-11-10",0,0,8,0,0,9,0,0
"Poland","2024-11-11",0,0,8,0,0,9,0,0
"Poland","2024-11-12",0,0,8,0,0,9,0,0
"Poland","2024-11-13",0,0,8,0,0,9,0,0
"Poland","2024-11-14",0,0,8,0,0,9,0,0
"Poland","2024-11-15",0,0,8,0,0,9,0,0
"Poland","2024-11-16",0,0,8,0,0,9,0,0
"Poland","2024-11-17",0,0,8,0,0,9,0,0
"Poland","2024-11-18",0,0,8,0,0,9,0,0
"Poland","2024-11-19",0,0,8,0,0,9,0,0
"Poland","2024-11-20",0,0,8,0,0,9,0,0
"Poland","2024-11-21",0,0,8,0,0,9,0,0
"Poland","2024-11-22",0,0,8,0,0,9,0,0
"Poland","2024-11-23",0,0,8,0,0,9,0,0
"Poland","2024-11-24",0,0,8,0,0,9,0,0
"Poland","2024-11-25",0,0,8,0,0,9,0,0
"Poland","2024-11-26",0,0,8,0,0,9,0,0
"Poland","2024-11-27",0,0,8,0,0,9,0,0
"Poland","2024-11-28",0,0,8,0,0,9,0,0
"Poland","2024-11-29",0,0,8,0,0,9,0,0
"Poland","2024-11-30",0,0,8,0,0,9,0,0
"Poland","2024-12-01",0,0,8,0,1,10,0,0
"Poland","2024-12-02",0,0,8,0,0,10,0,0
"Poland","2024-12-03",0,0,8,0,0,10,0,0
"Poland","2024-12-04",0,0,8,0,0,10,0,0
"Poland","2024-12-05",0,0,8,0,0,10,0,0
"Poland","2024-12-06",0,0,8,0,0,10,0,0
"Poland","2024-12-07",0,0,8,0,0,10,0,0
"Poland","2024-12-08",0,0,8,0,0,10,0,0
"Poland","2024-12-09",0,0,8,0,0,10,0,0
"Poland","2024-12-10",0,0,8,0,0,10,0,0
"Poland","2024-12-11",0,0,8,0,0,10,0,0
"Poland","2024-12-12",0,0,8,0,0,10,0,0
"Poland","2024-12-13",0,0,8,0,0,10,0,0
"Poland","2024-12-14",0,0,8,0,0,10,0,0
"Poland","2024-12-15",0,0,8,0,0,10,0,0
"Poland","2024-12-16",0,0,8,0,0,10,0,0
"Poland","2024-12-17",0,0,8,0,0,10,0,0
"Poland","2024-12-18",0,0,8,0,0,10,0,0
"Poland","2024-12-19",0,0,8,0,0,10,0,0
"Poland","2024-12-20",0,0,8,0,0,10,0,0
"Poland","2024-12-21",0,0,8,0,0,10,0,0
"Poland","2024-12-22",0,0,8,0,0,10,0,0
"Poland","2024-12-23",0,0,8,0,0,10,0,0
"Poland","2024-12-24",0,0,8,0,0,10,0,0
"Poland","2024-12-25",0,0,8,0,0,10,0,0
"Poland","2024-12-26",0,0,8,0,0,10,0,0
"Poland","2024-12-27",0,0,8,0,0,10,0,0
"Poland","2024-12-28",0,0,8,0,0,10,0,0
"Poland","2024-12-29",0,0,8,0,0,10,0,0
"Poland","2024-12-30",0,0,8,0,0,10,0,0
"Poland","2024-12-31",0,2,10,0,0,10,0,0
"Poland","2025-01-01",0,0,10,0,1,11,0,0
"Poland","2025-01-02",0,0,10,0,0,11,0,0
"Poland","2025-01-03",0,0,10,0,1,12,0,0
"Poland","2025-01-04",0,0,10,0,0,12,0,0
"Poland","2025-01-05",0,0,10,0,1,13,0,0
"Poland","2025-01-06",0,0,10,0,1,14,0,0
"Poland","2025-01-07",0,0,10,0,0,14,0,0
"Poland","2025-01-08",0,0,10,0,1,15,0,0
"Poland","2025-01-09",0,0,10,0,0,15,0,0
"Poland","2025-01-10",0,6,16,0,1,16,0,0
"Poland","2025-01-11",0,0,16,0,0,16,0,0
"Poland","2025-01-12",0,0,16,0,0,16,0,0
"Poland","2025-01-13",0,0,16,0,0,16,0,0
"Poland","2025-01-14",0,0,16,0,0,16,0,0
"Poland","2025-01-15",0,0,16,0,0,16,0,0
"Poland","2025-01-16",0,0,16,0,0,16,0,0
"Poland","2025-01-17",0,0,16,0,0,16,0,0
"Poland","2025-01-18",0,0,16,0,0,16,0,0
"Poland","2025-01-19",0,0,16,0,0,16,0,0
"Poland","2025-01-20",0,0,16,0,0,16,0,0
"Poland","2025-01-21",0,0,16,0,0,16,0,0
"Poland","2025-01-22",0,0,16,0,0,16,0,0
"Poland","2025-01-23",0,0,16,0,0,16,0,0
"Poland","2025-01-24",0,0,16,0,0,16,0,0
"Poland","2025-01-25",0,0,16,0,0,16,0,0
"Poland","2025-01-26",0,0,16,0,0,16,0,0
"Poland","2025-01-27",0,0,16,0,0,16,0,0
"Poland","2025-01-28",0,0,16,0,0,16,0,0
"Poland","2025-01-29",0,0,16,0,0,16,0,0
"Poland","2025-01-30",0,0,16,0,0,16,0,0
"Poland","2025-01-31",0,0,16,0,0,16,0,0
"Poland","2025-02-01",0,0,16,0,0,16,0,0
"Poland","2025-02-02",0,0,16,0,0,16,0,0
"Poland","2025-02-03",0,0,16,0,0,16,0,0
"Poland","2025-02-04",0,0,16,0,0,16,0,0
"Poland","2025-02-05",0,0,16,0,0,16,0,0
"Poland","2025-02-06",0,0,16,0,0,16,0,0
"Poland","2025-02-07",0,0,16,0,0,16,0,0
"Poland","2025-02-08",0,0,16,0,0,16,0,0
"Poland","2025-02-09",0,0,16,0,0,16,0,0
"Poland","2025-02-10",0,0,16,0,0,16,0,0
"Poland","2025-02-11",0,0,16,0,0,16,0,0
"Poland","2025-02-12",0,0,16,0,0,16,0,0
"Poland","2025-02-13",0,0,16,0,0,16,0,0
"Poland","2025-02-14",0,0,16,0,0,16,0,0
"Poland","2025-02-15",0,0,16,0,0,16,0,0
"Poland","2025-02-16",0,0,16,0,0,16,0,0
"Poland","2025-02-17",0,0,16,0,0,16,0,0
"Poland","2025-02-18",0,0,16,0,0,16,0,0
"Poland","2025-02-19",0,0,16,0,0,16,0,0
"Poland","2025-02-20",0,0,16,0,0,16,0,0
"Poland","2025-02-21",0,0,16,0,0,16,0,0
"Poland","2025-02-22",0,0,16,0,0,16,0,0
"Poland","2025-02-23",0,0,16,0,0,16,0,0
"Poland","2025-02-24",0,0,16,0,0,16,0,0
"Poland","2025-02-25",0,0,16,0,0,16,0,0
"Poland","2025-02-26",0,0,16,0,0,16,0,0
"Poland","2025-02-27",0,0,16,0,0,16,0,0
"Poland","2025-02-28",0,0,16,0,0,16,0,0
"Poland","2025-03-01",0,0,16,0,0,16,0,0
"Poland","2025-03-02",0,0,16,0,0,16,0,0
"Poland","2025-03-03",0,0,16,0,0,16,0,0
"Portugal","2024-01-01",0,0,0,0,0,0,0,0
"Portugal","2024-01-02",0,0,0,0,0,0,0,0
"Portugal","2024-01-03",0,0,0,0,0,0,0,0
"Portugal","2024-01-04",0,0,0,0,0,0,0,0
"Portugal","2024-01-05",0,0,0,0,0,0,0,0
"Portugal","2024-01-06",0,0,0,0,0,0,0,0
"Portugal","2024-01-07",0,0,0,0,0,0,0,0
"Portugal","2024-01-08",0,0,0,0,0,0,0,0
"Portugal","2024-01-09",0,0,0,0,0,0,0,0
"Portugal","2024-01-10",0,0,0,0,0,0,0,0
"Portugal","2024-01-11",0,0,0,0,0,0,0,0
"Portugal","2024-01-12",0,0,0,0,0,0,0,0
"Portugal","2024-01-13",0,0,0,0,0,0,0,0
"Portugal","2024-01-14",0,0,0,0,0,0,0,0
"Portugal","2024-01-15",0,0,0,0,0,0,0,0
"Portugal","2024-01-16",0,0,0,0,0,0,0,0
"Portugal","2024-01-17",0,0,0,0,0,0,0,0
"Portugal","2024-01-18",0,0,0,0,0,0,0,0
"Portugal","2024-01-19",0,0,0,0,0,0,0,0
"Portugal","2024-01-20",0,0,0,0,0,0,0,0
"Portugal","2024-01-21",0,0,0,0,0,0,0,0
"Portugal","2024-01-22",0,0,0,0,0,0,0,0
"Portugal","2024-01-23",0,0,0,0,0,0,0,0
"Portugal","2024-01-24",0,0,0,0,0,0,0,0
"Portugal","2024-01-25",0,0,0,0,0,0,0,0
"Portugal","2024-01-26",0,0,0,0,0,0,0,0
"Portugal","2024-01-27",0,0,0,0,0,0,0,0
"Portugal","2024-01-28",0,0,0,0,0,0,0,0
"Portugal","2024-01-29",0,0,0,0,0,0,0,0
"Portugal","2024-01-30",0,0,0,0,0,0,0,0
"Portugal","2024-01-31",0,24,24,0,24,24,0,0
"Portugal","2024-02-01",0,0,24,0,0,24,0,0
"Portugal","2024-02-02",0,0,24,0,0,24,0,0
"Portugal","2024-02-03",0,0,24,0,0,24,0,0
"Portugal","2024-02-04",0,0,24,0,1,25,0,0
"Portugal","2024-02-05",0,0,24,0,0,25,0,0
"Portugal","2024-02-06",0,0,24,0,0,25,0,0
"Portugal","2024-02-07",0,0,24,0,0,25,0,0
"Portugal","2024-02-08",0,0,24,0,0,25,0,0
"Portugal","2024-02-09",0,0,24,0,0,25,0,0
"Portugal","2024-02-10",0,0,24,0,0,25,0,0
"Portugal","2024-02-11",0,0,24,0,1,26,0,0
"Portugal","2024-02-12",0,0,24,0,0,26,0,0
"Portugal","2024-02-13",0,0,24,0,0,26,0,0
"Portugal","2024-02-14",0,0,24,0,0,26,0,0
"Portugal","2024-02-15",0,0,24,0,0,26,0,0
"Portugal","2024-02-16",0,0,24,0,0,26,0,0
"Portugal","2024-02-17",0,0,24,0,0,26,0,0
"Portugal","2024-02-18",0,0,24,0,0,26,0,0
"Portugal","2024-02-19",0,0,24,0,1,27,0,0
"Portugal","2024-02-20",0,0,24,0,0,27,0,0
"Portugal","2024-02-21",0,0,24,0,0,27,0,0
"Portugal","2024-02-22",0,0,24,0,0,27,0,0
"Portugal","2024-02-23",0,0,24,0,0,27,0,0
"Portugal","2024-02-24",0,0,24,0,0,27,0,0
"Portugal","2024-02-25",0,0,24,0,0,27,0,0
"Portugal","2024-02-26",0,0,24,0,1,28,0,0
"Portugal","2024-02-27",0,0,24,0,0,28,0,0
"Portugal","2024-02-28",0,0,24,0,0,28,0,0
"Portugal","2024-02-29",0,4,28,0,0,28,0,0
"Portugal","2024-03-01",0,0,28,0,0,28,0,0
"Portugal","2024-03-02",0,0,28,0,0,28,0,0
"Portugal","2024-03-03",0,0,28,0,0,28,0,0
"Portugal","2024-03-04",0,0,28,0,0,28,0,0
"Portugal","2024-03-05",0,0,28,0,0,28,0,0
"Portugal","2024-03-06",0,0,28,0,1,29,0,0
"Portugal","2024-03-07",0,0,28,0,0,29,0,0
"Portugal","2024-03-08",0,0,28,0,0,29,0,0
"Portugal","2024-03-09",0,0,28,0,0,29,0,0
"Portugal","2024-03-10",0,0,28,0,0,29,0,0
"Portugal","2024-03-11",0,0,28,0,0,29,0,0
"Portugal","2024-03-12",0,0,28,0,0,29,0,0
"Portugal","2024-03-13",0,0,28,0,0,29,0,0
"Portugal","2024-03-14",0,0,28,0,0,29,0,0
"Portugal","2024-03-15",0,0,28,0,0,29,0,0
"Portugal","2024-03-16",0,0,28,0,1,30,0,0
"Portugal","2024-03-17",0,0,28,0,0,30,0,0
"Portugal","2024-03-18",0,0,28,0,0,30,0,0
"Portugal","2024-03-19",0,0,28,0,0,30,0,0
"Portugal","2024-03-20",0,0,28,0,0,30,0,0
"Portugal","2024-03-21",0,0,28,0,0,30,0,0
"Portugal","2024-03-22",0,0,28,0,0,30,0,0
"Portugal","2024-03-23",0,0,28,0,0,30,0,0
"Portugal","2024-03-24",0,0,28,0,0,30,0,0
"Portugal","2024-03-25",0,0,28,0,0,30,0,0
"Portugal","2024-03-26",0,0,28,0,1,31,0,0
"Portugal","2024-03-27",0,0,28,0,0,31,0,0
"Portugal","2024-03-28",0,0,28,0,0,31,0,0
"Portugal","2024-03-29",0,0,28,0,0,31,0,0
"Portugal","2024-03-30",0,0,28,0,0,31,0,0
"Portugal","2024-03-31",0,3,31,0,0,31,0,0
"Portugal","2024-04-01",0,0,31,0,0,31,0,0
"Portugal","2024-04-02",0,0,31,0,0,31,0,0
"Portugal","2024-04-03",0,0,31,0,0,31,0,0
"Portugal","2024-04-04",0,0,31,0,0,31,0,0
"Portugal","2024-04-05",0,0,31,0,0,31,0,0
"Portugal","2024-04-06",0,0,31,0,0,31,0,0
"Portugal","2024-04-07",0,0,31,0,0,31,0,0
"Portugal","2024-04-08",0,0,31,0,0,31,0,0
"Portugal","2024-04-09",0,0,31,0,0,31,0,0
"Portugal","2024-04-10",0,0,31,0,0,31,0,0
"Portugal","2024-04-11",0,0,31,0,0,31,0,0
"Portugal","2024-04-12",0,0,31,0,0,31,0,0
"Portugal","2024-04-13",0,0,31,0,0,31,0,0
"Portugal","2024-04-14",0,0,31,0,0,31,0,0
"Portugal","2024-04-15",0,0,31,0,0,31,0,0
"Portugal","2024-04-16",0,0,31,0,0,31,0,0
"Portugal","2024-04-17",0,0,31,0,0,31,0,0
"Portugal","2024-04-18",0,0,31,0,0,31,0,0
"Portugal","2024-04-19",0,0,31,0,0,31,0,0
"Portugal","2024-04-20",0,0,31,0,0,31,0,0
"Portugal","2024-04-21",0,0,31,0,1,32,0,0
"Portugal","2024-04-22",0,0,31,0,0,32,0,0
"Portugal","2024-04-23",0,0,31,0,0,32,0,0
"Portugal","2024-04-24",0,0,31,0,0,32,0,0
"Portugal","2024-04-25",0,0,31,0,0,32,0,0
"Portugal","2024-04-26",0,0,31,0,0,32,0,0
"Portugal","2024-04-27",0,0,31,0,0,32,0,0
"Portugal","2024-04-28",0,0,31,0,0,32,0,0
"Portugal","2024-04-29",0,0,31,0,0,32,0,0
"Portugal","2024-04-30",0,0,31,0,0,32,0,0
"Portugal","2024-05-01",0,0,31,0,0,32,0,0
"Portugal","2024-05-02",0,0,31,0,0,32,0,0
"Portugal","2024-05-03",0,0,31,0,0,32,0,0
"Portugal","2024-05-04",0,0,31,0,0,32,0,0
"Portugal","2024-05-05",0,0,31,0,0,32,0,0
"Portugal","2024-05-06",0,0,31,0,0,32,0,0
"Portugal","2024-05-07",0,0,31,0,0,32,0,0
"Portugal","2024-05-08",0,0,31,0,0,32,0,0
"Portugal","2024-05-09",0,0,31,0,0,32,0,0
"Portugal","2024-05-10",0,0,31,0,0,32,0,0
"Portugal","2024-05-11",0,0,31,0,0,32,0,0
"Portugal","2024-05-12",0,0,31,0,0,32,0,0
"Portugal","2024-05-13",0,0,31,0,0,32,0,0
"Portugal","2024-05-14",0,0,31,0,0,32,0,0
"Portugal","2024-05-15",0,0,31,0,0,32,0,0
"Portugal","2024-05-16",0,0,31,0,0,32,0,0
"Portugal","2024-05-17",0,0,31,0,0,32,0,0
"Portugal","2024-05-18",0,0,31,0,0,32,0,0
"Portugal","2024-05-19",0,0,31,0,0,32,0,0
"Portugal","2024-05-20",0,0,31,0,0,32,0,0
"Portugal","2024-05-21",0,0,31,0,0,32,0,0
"Portugal","2024-05-22",0,0,31,0,0,32,0,0
"Portugal","2024-05-23",0,0,31,0,0,32,0,0
"Portugal","2024-05-24",0,0,31,0,0,32,0,0
"Portugal","2024-05-25",0,0,31,0,0,32,0,0
"Portugal","2024-05-26",0,0,31,0,0,32,0,0
"Portugal","2024-05-27",0,0,31,0,0,32,0,0
"Portugal","2024-05-28",0,0,31,0,0,32,0,0
"Portugal","2024-05-29",0,0,31,0,0,32,0,0
"Portugal","2024-05-30",0,0,31,0,0,32,0,0
"Portugal","2024-05-31",0,0,31,0,1,33,0,0
"Portugal","2024-06-01",0,0,31,0,0,33,0,0
"Portugal","2024-06-02",0,0,31,0,0,33,0,0
"Portugal","2024-06-03",0,0,31,0,0,33,0,0
"Portugal","2024-06-04",0,0,31,0,0,33,0,0
"Portugal","2024-06-05",0,0,31,0,0,33,0,0
"Portugal","2024-06-06",0,0,31,0,0,33,0,0
"Portugal","2024-06-07",0,0,31,0,0,33,0,0
"Portugal","2024-06-08",0,0,31,0,0,33,0,0
"Portugal","2024-06-09",0,0,31,0,0,33,0,0
"Portugal","2024-06-10",0,0,31,0,0,33,0,0
"Portugal","2024-06-11",0,0,31,0,0,33,0,0
"Portugal","2024-06-12",0,0,31,0,0,33,0,0
"Portugal","2024-06-13",0,0,31,0,0,33,0,0
"Portugal","2024-06-14",0,0,31,0,0,33,0,0
"Portugal","2024-06-15",0,0,31,0,0,33,0,0
"Portugal","2024-06-16",0,0,31,0,0,33,0,0
"Portugal","2024-06-17",0,0,31,0,0,33,0,0
"Portugal","2024-06-18",0,0,31,0,0,33,0,0
"Portugal","2024-06-19",0,0,31,0,0,33,0,0
"Portugal","2024-06-20",0,0,31,0,0,33,0,0
"Portugal","2024-06-21",0,0,31,0,0,33,0,0
"Portugal","2024-06-22",0,0,31,0,0,33,0,0
"Portugal","2024-06-23",0,0,31,0,0,33,0,0
"Portugal","2024-06-24",0,0,31,0,0,33,0,0
"Portugal","2024-06-25",0,0,31,0,0,33,0,0
"Portugal","2024-06-26",0,0,31,0,0,33,0,0
"Portugal","2024-06-27",0,0,31,0,0,33,0,0
"Portugal","2024-06-28",0,0,31,0,0,33,0,0
"Portugal","2024-06-29",0,0,31,0,0,33,0,0
"Portugal","2024-06-30",0,0,31,0,0,33,0,0
"Portugal","2024-07-01",0,0,31,0,0,33,0,0
"Portugal","2024-07-02",0,0,31,0,0,33,0,0
"Portugal","2024-07-03",0,0,31,0,0,33,0,0
"Portugal","2024-07-04",0,0,31,0,0,33,0,0
"Portugal","2024-07-05",0,0,31,0,0,33,0,0
"Portugal","2024-07-06",0,0,31,0,0,33,0,0
"Portugal","2024-07-07",0,0,31,0,0,33,0,0
"Portugal","2024-07-08",0,0,31,0,0,33,0,0
"Portugal","2024-07-09",0,0,31,0,0,33,0,0
"Portugal","2024-07-10",0,0,31,0,0,33,0,0
"Portugal","2024-07-11",0,0,31,0,1,34,0,0
"Portugal","2024-07-12",0,0,31,0,0,34,0,0
"Portugal","2024-07-13",0,0,31,0,0,34,0,0
"Portugal","2024-07-14",0,0,31,0,0,34,0,0
"Portugal","2024-07-15",0,0,31,0,0,34,0,0
"Portugal","2024-07-16",0,0,31,0,0,34,0,0
"Portugal","2024-07-17",0,0,31,0,0,34,0,0
"Portugal","2024-07-18",0,0,31,0,0,34,0,0
"Portugal","2024-07-19",0,0,31,0,0,34,0,0
"Portugal","2024-07-20",0,0,31,0,0,34,0,0
"Portugal","2024-07-21",0,0,31,0,0,34,0,0
"Portugal","2024-07-22",0,0,31,0,0,34,0,0
"Portugal","2024-07-23",0,0,31,0,0,34,0,0
"Portugal","2024-07-24",0,0,31,0,0,34,0,0
"Portugal","2024-07-25",0,0,31,0,0,34,0,0
"Portugal","2024-07-26",0,0,31,0,0,34,0,0
"Portugal","2024-07-27",0,0,31,0,0,34,0,0
"Portugal","2024-07-28",0,0,31,0,0,34,0,0
"Portugal","2024-07-29",0,0,31,0,0,34,0,0
"Portugal","2024-07-30",0,0,31,0,0,34,0,0
"Portugal","2024-07-31",0,3,34,0,0,34,0,0
"Portugal","2024-08-01",0,0,34,0,0,34,0,0
"Portugal","2024-08-02",0,0,34,0,1,35,0,0
"Portugal","2024-08-03",0,0,34,0,0,35,0,0
"Portugal","2024-08-04",0,0,34,0,0,35,0,0
"Portugal","2024-08-05",0,0,34,0,1,36,0,0
"Portugal","2024-08-06",0,0,34,0,0,36,0,0
"Portugal","2024-08-07",0,0,34,0,0,36,0,0
"Portugal","2024-08-08",0,0,34,0,1,37,0,0
"Portugal","2024-08-09",0,0,34,0,0,37,0,0
"Portugal","2024-08-10",0,0,34,0,0,37,0,0
"Portugal","2024-08-11",0,0,34,0,1,38,0,0
"Portugal","2024-08-12",0,0,34,0,0,38,0,0
"Portugal","2024-08-13",0,0,34,0,0,38,0,0
"Portugal","2024-08-14",0,0,34,0,1,39,0,0
"Portugal","2024-08-15",0,0,34,0,0,39,0,0
"Portugal","2024-08-16",0,0,34,0,0,39,0,0
"Portugal","2024-08-17",0,0,34,0,0,39,0,0
"Portugal","2024-08-18",0,0,34,0,1,40,0,0
"Portugal","2024-08-19",0,0,34,0,0,40,0,0
"Portugal","2024-08-20",0,0,34,0,0,40,0,0
"Portugal","2024-08-21",0,0,34,0,1,41,0,0
"Portugal","2024-08-22",0,0,34,0,0,41,0,0
"Portugal","2024-08-23",0,0,34,0,0,41,0,0
"Portugal","2024-08-24",0,0,34,0,1,42,0,0
"Portugal","2024-08-25",0,0,34,0,0,42,0,0
"Portugal","2024-08-26",0,0,34,0,0,42,0,0
"Portugal","2024-08-27",0,0,34,0,1,43,0,0
"Portugal","2024-08-28",0,0,34,0,0,43,0,0
"Portugal","2024-08-29",0,0,34,0,0,43,0,0
"Portugal","2024-08-30",0,0,34,0,1,44,0,0
"Portugal","2024-08-31",0,10,44,0,0,44,0,0
"Portugal","2024-09-01",0,0,44,0,0,44,0,0
"Portugal","2024-09-02",0,0,44,0,0,44,0,0
"Portugal","2024-09-03",0,0,44,0,0,44,0,0
"Portugal","2024-09-04",0,0,44,0,0,44,0,0
"Portugal","2024-09-05",0,0,44,0,0,44,0,0
"Portugal","2024-09-06",0,0,44,0,0,44,0,0
"Portugal","2024-09-07",0,0,44,0,0,44,0,0
"Portugal","2024-09-08",0,0,44,0,0,44,0,0
"Portugal","2024-09-09",0,0,44,0,0,44,0,0
"Portugal","2024-09-10",0,0,44,0,0,44,0,0
"Portugal","2024-09-11",0,0,44,0,0,44,0,0
"Portugal","2024-09-12",0,0,44,0,0,44,0,0
"Portugal","2024-09-13",0,0,44,0,0,44,0,0
"Portugal","2024-09-14",0,0,44,0,0,44,0,0
"Portugal","2024-09-15",0,0,44,0,0,44,0,0
"Portugal","2024-09-16",0,0,44,0,1,45,0,0
"Portugal","2024-09-17",0,0,44,0,0,45,0,0
"Portugal","2024-09-18",0,0,44,0,0,45,0,0
"Portugal","2024-09-19",0,0,44,0,0,45,0,0
"Portugal","2024-09-20",0,0,44,0,0,45,0,0
"Portugal","2024-09-21",0,0,44,0,0,45,0,0
"Portugal","2024-09-22",0,0,44,0,0,45,0,0
"Portugal","2024-09-23",0,0,44,0,0,45,0,0
"Portugal","2024-09-24",0,0,44,0,0,45,0,0
"Portugal","2024-09-25",0,0,44,0,0,45,0,0
"Portugal","2024-09-26",0,0,44,0,0,45,0,0
"Portugal","2024-09-27",0,0,44,0,0,45,0,0
"Portugal","2024-09-28",0,0,44,0,0,45,0,0
"Portugal","2024-09-29",0,0,44,0,0,45,0,0
"Portugal","2024-09-30",0,1,45,0,0,45,0,0
"Portugal","2024-10-01",0,0,45,0,0,45,0,0
"Portugal","2024-10-02",0,0,45,0,0,45,0,0
"Portugal","2024-10-03",0,0,45,0,0,45,0,0
"Portugal","2024-10-04",0,0,45,0,0,45,0,0
"Portugal","2024-10-05",0,0,45,0,0,45,0,0
"Portugal","2024-10-06",0,0,45,0,0,45,0,0
"Portugal","2024-10-07",0,0,45,0,0,45,0,0
"Portugal","2024-10-08",0,0,45,0,0,45,0,0
"Portugal","2024-10-09",0,0,45,0,0,45,0,0
"Portugal","2024-10-10",0,0,45,0,0,45,0,0
"Portugal","2024-10-11",0,0,45,0,0,45,0,0
"Portugal","2024-10-12",0,0,45,0,0,45,0,0
"Portugal","2024-10-13",0,0,45,0,0,45,0,0
"Portugal","2024-10-14",0,0,45,0,0,45,0,0
"Portugal","2024-10-15",0,0,45,0,0,45,0,0
"Portugal","2024-10-16",0,0,45,0,1,46,0,0
"Portugal","2024-10-17",0,0,45,0,0,46,0,0
"Portugal","2024-10-18",0,0,45,0,0,46,0,0
"Portugal","2024-10-19",0,0,45,0,0,46,0,0
"Portugal","2024-10-20",0,0,45,0,0,46,0,0
"Portugal","2024-10-21",0,0,45,0,0,46,0,0
"Portugal","2024-10-22",0,0,45,0,0,46,0,0
"Portugal","2024-10-23",0,0,45,0,0,46,0,0
"Portugal","2024-10-24",0,0,45,0,0,46,0,0
"Portugal","2024-10-25",0,0,45,0,0,46,0,0
"Portugal","2024-10-26",0,0,45,0,0,46,0,0
"Portugal","2024-10-27",0,0,45,0,0,46,0,0
"Portugal","2024-10-28",0,0,45,0,0,46,0,0
"Portugal","2024-10-29",0,0,45,0,0,46,0,0
"Portugal","2024-10-30",0,0,45,0,0,46,0,0
"Portugal","2024-10-31",0,1,46,0,0,46,0,0
"Portugal","2024-11-01",0,0,46,0,0,46,0,0
"Portugal","2024-11-02",0,0,46,0,0,46,0,0
"Portugal","2024-11-03",0,0,46,0,0,46,0,0
"Portugal","2024-11-04",0,0,46,0,0,46,0,0
"Portugal","2024-11-05",0,0,46,0,0,46,0,0
"Portugal","2024-11-06",0,0,46,0,0,46,0,0
"Portugal","2024-11-07",0,0,46,0,0,46,0,0
"Portugal","2024-11-08",0,0,46,0,0,46,0,0
"Portugal","2024-11-09",0,0,46,0,0,46,0,0
"Portugal","2024-11-10",0,0,46,0,0,46,0,0
"Portugal","2024-11-11",0,0,46,0,0,46,0,0
"Portugal","2024-11-12",0,0,46,0,0,46,0,0
"Portugal","2024-11-13",0,0,46,0,0,46,0,0
"Portugal","2024-11-14",0,0,46,0,0,46,0,0
"Portugal","2024-11-15",0,0,46,0,0,46,0,0
"Portugal","2024-11-16",0,0,46,0,1,47,0,0
"Portugal","2024-11-17",0,0,46,0,0,47,0,0
"Portugal","2024-11-18",0,0,46,0,0,47,0,0
"Portugal","2024-11-19",0,0,46,0,0,47,0,0
"Portugal","2024-11-20",0,0,46,0,0,47,0,0
"Portugal","2024-11-21",0,0,46,0,0,47,0,0
"Portugal","2024-11-22",0,0,46,0,0,47,0,0
"Portugal","2024-11-23",0,0,46,0,0,47,0,0
"Portugal","2024-11-24",0,0,46,0,0,47,0,0
"Portugal","2024-11-25",0,0,46,0,0,47,0,0
"Portugal","2024-11-26",0,0,46,0,0,47,0,0
"Portugal","2024-11-27",0,0,46,0,0,47,0,0
"Portugal","2024-11-28",0,0,46,0,0,47,0,0
"Portugal","2024-11-29",0,0,46,0,0,47,0,0
"Portugal","2024-11-30",0,0,46,0,0,47,0,0
"Portugal","2024-12-01",0,0,46,0,0,47,0,0
"Portugal","2024-12-02",0,0,46,0,0,47,0,0
"Portugal","2024-12-03",0,0,46,0,0,47,0,0
"Portugal","2024-12-04",0,0,46,0,0,47,0,0
"Portugal","2024-12-05",0,0,46,0,0,47,0,0
"Portugal","2024-12-06",0,0,46,0,0,47,0,0
"Portugal","2024-12-07",0,0,46,0,0,47,0,0
"Portugal","2024-12-08",0,0,46,0,0,47,0,0
"Portugal","2024-12-09",0,0,46,0,0,47,0,0
"Portugal","2024-12-10",0,0,46,0,0,47,0,0
"Portugal","2024-12-11",0,0,46,0,0,47,0,0
"Portugal","2024-12-12",0,0,46,0,0,47,0,0
"Portugal","2024-12-13",0,0,46,0,0,47,0,0
"Portugal","2024-12-14",0,0,46,0,0,47,0,0
"Portugal","2024-12-15",0,0,46,0,0,47,0,0
"Portugal","2024-12-16",0,0,46,0,1,48,0,0
"Portugal","2024-12-17",0,0,46,0,0,48,0,0
"Portugal","2024-12-18",0,0,46,0,0,48,0,0
"Portugal","2024-12-19",0,0,46,0,0,48,0,0
"Portugal","2024-12-20",0,0,46,0,0,48,0,0
"Portugal","2024-12-21",0,0,46,0,0,48,0,0
"Portugal","2024-12-22",0,0,46,0,0,48,0,0
"Portugal","2024-12-23",0,0,46,0,0,48,0,0
"Portugal","2024-12-24",0,0,46,0,0,48,0,0
"Portugal","2024-12-25",0,0,46,0,0,48,0,0
"Portugal","2024-12-26",0,0,46,0,0,48,0,0
"Portugal","2024-12-27",0,0,46,0,0,48,0,0
"Portugal","2024-12-28",0,0,46,0,0,48,0,0
"Portugal","2024-12-29",0,0,46,0,0,48,0,0
"Portugal","2024-12-30",0,0,46,0,0,48,0,0
"Portugal","2024-12-31",0,2,48,0,0,48,0,0
"Portugal","2025-01-01",0,0,48,0,0,48,0,0
"Portugal","2025-01-02",0,0,48,0,0,48,0,0
"Portugal","2025-01-03",0,0,48,0,1,49,0,0
"Portugal","2025-01-04",0,0,48,0,0,49,0,0
"Portugal","2025-01-05",0,0,48,0,0,49,0,0
"Portugal","2025-01-06",0,0,48,0,0,49,0,0
"Portugal","2025-01-07",0,0,48,0,0,49,0,0
"Portugal","2025-01-08",0,0,48,0,1,50,0,0
"Portugal","2025-01-09",0,0,48,0,0,50,0,0
"Portugal","2025-01-10",0,2,50,0,0,50,0,0
"Portugal","2025-01-11",0,0,50,0,0,50,0,0
"Portugal","2025-01-12",0,0,50,0,0,50,0,0
"Portugal","2025-01-13",0,0,50,0,0,50,0,0
"Portugal","2025-01-14",0,0,50,0,0,50,0,0
"Portugal","2025-01-15",0,0,50,0,0,50,0,0
"Portugal","2025-01-16",0,0,50,0,0,50,0,0
"Portugal","2025-01-17",0,0,50,0,0,50,0,0
"Portugal","2025-01-18",0,0,50,0,0,50,0,0
"Portugal","2025-01-19",0,0,50,0,0,50,0,0
"Portugal","2025-01-20",0,0,50,0,0,50,0,0
"Portugal","2025-01-21",0,0,50,0,0,50,0,0
"Portugal","2025-01-22",0,0,50,0,0,50,0,0
"Portugal","2025-01-23",0,0,50,0,0,50,0,0
"Portugal","2025-01-24",0,0,50,0,0,50,0,0
"Portugal","2025-01-25",0,0,50,0,0,50,0,0
"Portugal","2025-01-26",0,0,50,0,0,50,0,0
"Portugal","2025-01-27",0,0,50,0,0,50,0,0
"Portugal","2025-01-28",0,0,50,0,0,50,0,0
"Portugal","2025-01-29",0,0,50,0,0,50,0,0
"Portugal","2025-01-30",0,0,50,0,0,50,0,0
"Portugal","2025-01-31",0,0,50,0,0,50,0,0
"Portugal","2025-02-01",0,0,50,0,0,50,0,0
"Portugal","2025-02-02",0,0,50,0,0,50,0,0
"Portugal","2025-02-03",0,0,50,0,0,50,0,0
"Portugal","2025-02-04",0,0,50,0,0,50,0,0
"Portugal","2025-02-05",0,0,50,0,0,50,0,0
"Portugal","2025-02-06",0,0,50,0,0,50,0,0
"Portugal","2025-02-07",0,0,50,0,0,50,0,0
"Portugal","2025-02-08",0,0,50,0,0,50,0,0
"Portugal","2025-02-09",0,0,50,0,0,50,0,0
"Portugal","2025-02-10",0,0,50,0,0,50,0,0
"Portugal","2025-02-11",0,0,50,0,0,50,0,0
"Portugal","2025-02-12",0,0,50,0,0,50,0,0
"Portugal","2025-02-13",0,0,50,0,0,50,0,0
"Portugal","2025-02-14",0,0,50,0,0,50,0,0
"Portugal","2025-02-15",0,0,50,0,0,50,0,0
"Portugal","2025-02-16",0,0,50,0,0,50,0,0
"Portugal","2025-02-17",0,0,50,0,0,50,0,0
"Portugal","2025-02-18",0,0,50,0,0,50,0,0
"Portugal","2025-02-19",0,0,50,0,0,50,0,0
"Portugal","2025-02-20",0,0,50,0,0,50,0,0
"Portugal","2025-02-21",0,0,50,0,0,50,0,0
"Portugal","2025-02-22",0,0,50,0,0,50,0,0
"Portugal","2025-02-23",0,0,50,0,0,50,0,0
"Portugal","2025-02-24",0,0,50,0,0,50,0,0
"Portugal","2025-02-25",0,0,50,0,0,50,0,0
"Portugal","2025-02-26",0,0,50,0,0,50,0,0
"Portugal","2025-02-27",0,0,50,0,0,50,0,0
"Portugal","2025-02-28",0,0,50,0,0,50,0,0
"Portugal","2025-03-01",0,0,50,0,0,50,0,0
"Portugal","2025-03-02",0,0,50,0,0,50,0,0
"Portugal","2025-03-03",0,0,50,0,0,50,0,0
"Qatar","2024-01-01",0,0,0,0,0,0,0,0
"Qatar","2024-01-02",0,0,0,0,0,0,0,0
"Qatar","2024-01-03",0,0,0,0,0,0,0,0
"Qatar","2024-01-04",0,0,0,0,0,0,0,0
"Qatar","2024-01-05",0,0,0,0,0,0,0,0
"Qatar","2024-01-06",0,0,0,0,0,0,0,0
"Qatar","2024-01-07",0,0,0,0,0,0,0,0
"Qatar","2024-01-08",0,0,0,0,0,0,0,0
"Qatar","2024-01-09",0,0,0,0,0,0,0,0
"Qatar","2024-01-10",0,0,0,0,0,0,0,0
"Qatar","2024-01-11",0,0,0,0,0,0,0,0
"Qatar","2024-01-12",0,0,0,0,0,0,0,0
"Qatar","2024-01-13",0,0,0,0,0,0,0,0
"Qatar","2024-01-14",0,0,0,0,0,0,0,0
"Qatar","2024-01-15",0,0,0,0,0,0,0,0
"Qatar","2024-01-16",0,0,0,0,0,0,0,0
"Qatar","2024-01-17",0,0,0,0,0,0,0,0
"Qatar","2024-01-18",0,0,0,0,0,0,0,0
"Qatar","2024-01-19",0,0,0,0,0,0,0,0
"Qatar","2024-01-20",0,0,0,0,0,0,0,0
"Qatar","2024-01-21",0,0,0,0,0,0,0,0
"Qatar","2024-01-22",0,0,0,0,0,0,0,0
"Qatar","2024-01-23",0,0,0,0,0,0,0,0
"Qatar","2024-01-24",0,0,0,0,0,0,0,0
"Qatar","2024-01-25",0,0,0,0,0,0,0,0
"Qatar","2024-01-26",0,0,0,0,0,0,0,0
"Qatar","2024-01-27",0,0,0,0,0,0,0,0
"Qatar","2024-01-28",0,0,0,0,0,0,0,0
"Qatar","2024-01-29",0,0,0,0,0,0,0,0
"Qatar","2024-01-30",0,0,0,0,0,0,0,0
"Qatar","2024-01-31",0,0,0,0,0,0,0,0
"Qatar","2024-02-01",0,0,0,0,0,0,0,0
"Qatar","2024-02-02",0,0,0,0,0,0,0,0
"Qatar","2024-02-03",0,0,0,0,0,0,0,0
"Qatar","2024-02-04",0,0,0,0,0,0,0,0
"Qatar","2024-02-05",0,0,0,0,0,0,0,0
"Qatar","2024-02-06",0,0,0,0,0,0,0,0
"Qatar","2024-02-07",0,0,0,0,0,0,0,0
"Qatar","2024-02-08",0,0,0,0,0,0,0,0
"Qatar","2024-02-09",0,0,0,0,0,0,0,0
"Qatar","2024-02-10",0,0,0,0,0,0,0,0
"Qatar","2024-02-11",0,0,0,0,0,0,0,0
"Qatar","2024-02-12",0,0,0,0,0,0,0,0
"Qatar","2024-02-13",0,0,0,0,0,0,0,0
"Qatar","2024-02-14",0,0,0,0,0,0,0,0
"Qatar","2024-02-15",0,0,0,0,0,0,0,0
"Qatar","2024-02-16",0,0,0,0,0,0,0,0
"Qatar","2024-02-17",0,0,0,0,0,0,0,0
"Qatar","2024-02-18",0,0,0,0,0,0,0,0
"Qatar","2024-02-19",0,0,0,0,0,0,0,0
"Qatar","2024-02-20",0,0,0,0,0,0,0,0
"Qatar","2024-02-21",0,0,0,0,0,0,0,0
"Qatar","2024-02-22",0,0,0,0,0,0,0,0
"Qatar","2024-02-23",0,0,0,0,0,0,0,0
"Qatar","2024-02-24",0,0,0,0,0,0,0,0
"Qatar","2024-02-25",0,0,0,0,0,0,0,0
"Qatar","2024-02-26",0,0,0,0,0,0,0,0
"Qatar","2024-02-27",0,0,0,0,0,0,0,0
"Qatar","2024-02-28",0,0,0,0,0,0,0,0
"Qatar","2024-02-29",0,0,0,0,0,0,0,0
"Qatar","2024-03-01",0,0,0,0,0,0,0,0
"Qatar","2024-03-02",0,0,0,0,0,0,0,0
"Qatar","2024-03-03",0,0,0,0,0,0,0,0
"Qatar","2024-03-04",0,0,0,0,0,0,0,0
"Qatar","2024-03-05",0,0,0,0,0,0,0,0
"Qatar","2024-03-06",0,0,0,0,0,0,0,0
"Qatar","2024-03-07",0,0,0,0,0,0,0,0
"Qatar","2024-03-08",0,0,0,0,0,0,0,0
"Qatar","2024-03-09",0,0,0,0,0,0,0,0
"Qatar","2024-03-10",0,0,0,0,0,0,0,0
"Qatar","2024-03-11",0,0,0,0,0,0,0,0
"Qatar","2024-03-12",0,0,0,0,0,0,0,0
"Qatar","2024-03-13",0,0,0,0,0,0,0,0
"Qatar","2024-03-14",0,0,0,0,0,0,0,0
"Qatar","2024-03-15",0,0,0,0,0,0,0,0
"Qatar","2024-03-16",0,0,0,0,0,0,0,0
"Qatar","2024-03-17",0,0,0,0,0,0,0,0
"Qatar","2024-03-18",0,0,0,0,0,0,0,0
"Qatar","2024-03-19",0,0,0,0,0,0,0,0
"Qatar","2024-03-20",0,0,0,0,0,0,0,0
"Qatar","2024-03-21",0,0,0,0,0,0,0,0
"Qatar","2024-03-22",0,0,0,0,0,0,0,0
"Qatar","2024-03-23",0,0,0,0,0,0,0,0
"Qatar","2024-03-24",0,0,0,0,0,0,0,0
"Qatar","2024-03-25",0,0,0,0,0,0,0,0
"Qatar","2024-03-26",0,0,0,0,0,0,0,0
"Qatar","2024-03-27",0,0,0,0,0,0,0,0
"Qatar","2024-03-28",0,0,0,0,0,0,0,0
"Qatar","2024-03-29",0,0,0,0,0,0,0,0
"Qatar","2024-03-30",0,0,0,0,0,0,0,0
"Qatar","2024-03-31",0,0,0,0,0,0,0,0
"Qatar","2024-04-01",0,0,0,0,0,0,0,0
"Qatar","2024-04-02",0,0,0,0,0,0,0,0
"Qatar","2024-04-03",0,0,0,0,0,0,0,0
"Qatar","2024-04-04",0,0,0,0,0,0,0,0
"Qatar","2024-04-05",0,0,0,0,0,0,0,0
"Qatar","2024-04-06",0,0,0,0,0,0,0,0
"Qatar","2024-04-07",0,0,0,0,0,0,0,0
"Qatar","2024-04-08",0,0,0,0,0,0,0,0
"Qatar","2024-04-09",0,0,0,0,0,0,0,0
"Qatar","2024-04-10",0,0,0,0,0,0,0,0
"Qatar","2024-04-11",0,0,0,0,0,0,0,0
"Qatar","2024-04-12",0,0,0,0,0,0,0,0
"Qatar","2024-04-13",0,0,0,0,0,0,0,0
"Qatar","2024-04-14",0,0,0,0,0,0,0,0
"Qatar","2024-04-15",0,0,0,0,0,0,0,0
"Qatar","2024-04-16",0,0,0,0,0,0,0,0
"Qatar","2024-04-17",0,0,0,0,0,0,0,0
"Qatar","2024-04-18",0,0,0,0,0,0,0,0
"Qatar","2024-04-19",0,0,0,0,0,0,0,0
"Qatar","2024-04-20",0,0,0,0,0,0,0,0
"Qatar","2024-04-21",0,0,0,0,0,0,0,0
"Qatar","2024-04-22",0,0,0,0,0,0,0,0
"Qatar","2024-04-23",0,0,0,0,0,0,0,0
"Qatar","2024-04-24",0,0,0,0,0,0,0,0
"Qatar","2024-04-25",0,0,0,0,0,0,0,0
"Qatar","2024-04-26",0,0,0,0,0,0,0,0
"Qatar","2024-04-27",0,0,0,0,0,0,0,0
"Qatar","2024-04-28",0,0,0,0,0,0,0,0
"Qatar","2024-04-29",0,0,0,0,0,0,0,0
"Qatar","2024-04-30",0,0,0,0,0,0,0,0
"Qatar","2024-05-01",0,0,0,0,0,0,0,0
"Qatar","2024-05-02",0,0,0,0,0,0,0,0
"Qatar","2024-05-03",0,0,0,0,0,0,0,0
"Qatar","2024-05-04",0,0,0,0,0,0,0,0
"Qatar","2024-05-05",0,0,0,0,0,0,0,0
"Qatar","2024-05-06",0,0,0,0,0,0,0,0
"Qatar","2024-05-07",0,0,0,0,0,0,0,0
"Qatar","2024-05-08",0,0,0,0,0,0,0,0
"Qatar","2024-05-09",0,0,0,0,0,0,0,0
"Qatar","2024-05-10",0,0,0,0,0,0,0,0
"Qatar","2024-05-11",0,0,0,0,0,0,0,0
"Qatar","2024-05-12",0,0,0,0,0,0,0,0
"Qatar","2024-05-13",0,0,0,0,0,0,0,0
"Qatar","2024-05-14",0,0,0,0,0,0,0,0
"Qatar","2024-05-15",0,0,0,0,0,0,0,0
"Qatar","2024-05-16",0,0,0,0,0,0,0,0
"Qatar","2024-05-17",0,0,0,0,0,0,0,0
"Qatar","2024-05-18",0,0,0,0,0,0,0,0
"Qatar","2024-05-19",0,0,0,0,0,0,0,0
"Qatar","2024-05-20",0,0,0,0,0,0,0,0
"Qatar","2024-05-21",0,0,0,0,0,0,0,0
"Qatar","2024-05-22",0,0,0,0,0,0,0,0
"Qatar","2024-05-23",0,0,0,0,0,0,0,0
"Qatar","2024-05-24",0,0,0,0,0,0,0,0
"Qatar","2024-05-25",0,0,0,0,0,0,0,0
"Qatar","2024-05-26",0,0,0,0,0,0,0,0
"Qatar","2024-05-27",0,0,0,0,0,0,0,0
"Qatar","2024-05-28",0,0,0,0,0,0,0,0
"Qatar","2024-05-29",0,0,0,0,0,0,0,0
"Qatar","2024-05-30",0,0,0,0,0,0,0,0
"Qatar","2024-05-31",0,0,0,0,0,0,0,0
"Qatar","2024-06-01",0,0,0,0,0,0,0,0
"Qatar","2024-06-02",0,0,0,0,0,0,0,0
"Qatar","2024-06-03",0,0,0,0,0,0,0,0
"Qatar","2024-06-04",0,0,0,0,0,0,0,0
"Qatar","2024-06-05",0,0,0,0,0,0,0,0
"Qatar","2024-06-06",0,0,0,0,0,0,0,0
"Qatar","2024-06-07",0,0,0,0,0,0,0,0
"Qatar","2024-06-08",0,0,0,0,0,0,0,0
"Qatar","2024-06-09",0,0,0,0,0,0,0,0
"Qatar","2024-06-10",0,0,0,0,0,0,0,0
"Qatar","2024-06-11",0,0,0,0,0,0,0,0
"Qatar","2024-06-12",0,0,0,0,0,0,0,0
"Qatar","2024-06-13",0,0,0,0,0,0,0,0
"Qatar","2024-06-14",0,0,0,0,0,0,0,0
"Qatar","2024-06-15",0,0,0,0,0,0,0,0
"Qatar","2024-06-16",0,0,0,0,0,0,0,0
"Qatar","2024-06-17",0,0,0,0,0,0,0,0
"Qatar","2024-06-18",0,0,0,0,0,0,0,0
"Qatar","2024-06-19",0,0,0,0,0,0,0,0
"Qatar","2024-06-20",0,0,0,0,0,0,0,0
"Qatar","2024-06-21",0,0,0,0,0,0,0,0
"Qatar","2024-06-22",0,0,0,0,0,0,0,0
"Qatar","2024-06-23",0,0,0,0,0,0,0,0
"Qatar","2024-06-24",0,0,0,0,0,0,0,0
"Qatar","2024-06-25",0,0,0,0,0,0,0,0
"Qatar","2024-06-26",0,0,0,0,0,0,0,0
"Qatar","2024-06-27",0,0,0,0,0,0,0,0
"Qatar","2024-06-28",0,0,0,0,0,0,0,0
"Qatar","2024-06-29",0,0,0,0,0,0,0,0
"Qatar","2024-06-30",0,0,0,0,0,0,0,0
"Qatar","2024-07-01",0,0,0,0,0,0,0,0
"Qatar","2024-07-02",0,0,0,0,0,0,0,0
"Qatar","2024-07-03",0,0,0,0,0,0,0,0
"Qatar","2024-07-04",0,0,0,0,0,0,0,0
"Qatar","2024-07-05",0,0,0,0,0,0,0,0
"Qatar","2024-07-06",0,0,0,0,0,0,0,0
"Qatar","2024-07-07",0,0,0,0,0,0,0,0
"Qatar","2024-07-08",0,0,0,0,0,0,0,0
"Qatar","2024-07-09",0,0,0,0,0,0,0,0
"Qatar","2024-07-10",0,0,0,0,0,0,0,0
"Qatar","2024-07-11",0,0,0,0,0,0,0,0
"Qatar","2024-07-12",0,0,0,0,0,0,0,0
"Qatar","2024-07-13",0,0,0,0,0,0,0,0
"Qatar","2024-07-14",0,0,0,0,0,0,0,0
"Qatar","2024-07-15",0,0,0,0,0,0,0,0
"Qatar","2024-07-16",0,0,0,0,0,0,0,0
"Qatar","2024-07-17",0,0,0,0,0,0,0,0
"Qatar","2024-07-18",0,0,0,0,0,0,0,0
"Qatar","2024-07-19",0,0,0,0,0,0,0,0
"Qatar","2024-07-20",0,0,0,0,0,0,0,0
"Qatar","2024-07-21",0,0,0,0,0,0,0,0
"Qatar","2024-07-22",0,0,0,0,0,0,0,0
"Qatar","2024-07-23",0,0,0,0,0,0,0,0
"Qatar","2024-07-24",0,0,0,0,0,0,0,0
"Qatar","2024-07-25",0,0,0,0,0,0,0,0
"Qatar","2024-07-26",0,0,0,0,0,0,0,0
"Qatar","2024-07-27",0,0,0,0,0,0,0,0
"Qatar","2024-07-28",0,0,0,0,0,0,0,0
"Qatar","2024-07-29",0,0,0,0,0,0,0,0
"Qatar","2024-07-30",0,0,0,0,0,0,0,0
"Qatar","2024-07-31",0,0,0,0,0,0,0,0
"Qatar","2024-08-01",0,0,0,0,0,0,0,0
"Qatar","2024-08-02",0,0,0,0,0,0,0,0
"Qatar","2024-08-03",0,0,0,0,0,0,0,0
"Qatar","2024-08-04",0,0,0,0,0,0,0,0
"Qatar","2024-08-05",0,0,0,0,0,0,0,0
"Qatar","2024-08-06",0,0,0,0,0,0,0,0
"Qatar","2024-08-07",0,0,0,0,0,0,0,0
"Qatar","2024-08-08",0,0,0,0,0,0,0,0
"Qatar","2024-08-09",0,0,0,0,0,0,0,0
"Qatar","2024-08-10",0,0,0,0,0,0,0,0
"Qatar","2024-08-11",0,0,0,0,0,0,0,0
"Qatar","2024-08-12",0,0,0,0,0,0,0,0
"Qatar","2024-08-13",0,0,0,0,0,0,0,0
"Qatar","2024-08-14",0,0,0,0,0,0,0,0
"Qatar","2024-08-15",0,0,0,0,0,0,0,0
"Qatar","2024-08-16",0,0,0,0,0,0,0,0
"Qatar","2024-08-17",0,0,0,0,0,0,0,0
"Qatar","2024-08-18",0,0,0,0,0,0,0,0
"Qatar","2024-08-19",0,0,0,0,0,0,0,0
"Qatar","2024-08-20",0,0,0,0,0,0,0,0
"Qatar","2024-08-21",0,0,0,0,0,0,0,0
"Qatar","2024-08-22",0,0,0,0,0,0,0,0
"Qatar","2024-08-23",0,0,0,0,0,0,0,0
"Qatar","2024-08-24",0,0,0,0,0,0,0,0
"Qatar","2024-08-25",0,0,0,0,0,0,0,0
"Qatar","2024-08-26",0,0,0,0,0,0,0,0
"Qatar","2024-08-27",0,0,0,0,0,0,0,0
"Qatar","2024-08-28",0,0,0,0,0,0,0,0
"Qatar","2024-08-29",0,0,0,0,0,0,0,0
"Qatar","2024-08-30",0,0,0,0,0,0,0,0
"Qatar","2024-08-31",0,0,0,0,0,0,0,0
"Qatar","2024-09-01",0,0,0,0,0,0,0,0
"Qatar","2024-09-02",0,0,0,0,0,0,0,0
"Qatar","2024-09-03",0,0,0,0,0,0,0,0
"Qatar","2024-09-04",0,0,0,0,0,0,0,0
"Qatar","2024-09-05",0,0,0,0,0,0,0,0
"Qatar","2024-09-06",0,0,0,0,0,0,0,0
"Qatar","2024-09-07",0,0,0,0,0,0,0,0
"Qatar","2024-09-08",0,0,0,0,0,0,0,0
"Qatar","2024-09-09",0,0,0,0,0,0,0,0
"Qatar","2024-09-10",0,0,0,0,0,0,0,0
"Qatar","2024-09-11",0,0,0,0,0,0,0,0
"Qatar","2024-09-12",0,0,0,0,0,0,0,0
"Qatar","2024-09-13",0,0,0,0,0,0,0,0
"Qatar","2024-09-14",0,0,0,0,0,0,0,0
"Qatar","2024-09-15",0,0,0,0,0,0,0,0
"Qatar","2024-09-16",0,0,0,0,0,0,0,0
"Qatar","2024-09-17",0,0,0,0,0,0,0,0
"Qatar","2024-09-18",0,0,0,0,0,0,0,0
"Qatar","2024-09-19",0,0,0,0,0,0,0,0
"Qatar","2024-09-20",0,0,0,0,0,0,0,0
"Qatar","2024-09-21",0,0,0,0,0,0,0,0
"Qatar","2024-09-22",0,0,0,0,0,0,0,0
"Qatar","2024-09-23",0,0,0,0,0,0,0,0
"Qatar","2024-09-24",0,0,0,0,0,0,0,0
"Qatar","2024-09-25",0,0,0,0,0,0,0,0
"Qatar","2024-09-26",0,0,0,0,0,0,0,0
"Qatar","2024-09-27",0,0,0,0,0,0,0,0
"Qatar","2024-09-28",0,0,0,0,0,0,0,0
"Qatar","2024-09-29",0,0,0,0,0,0,0,0
"Qatar","2024-09-30",0,0,0,0,0,0,0,0
"Qatar","2024-10-01",0,0,0,0,0,0,0,0
"Qatar","2024-10-02",0,0,0,0,0,0,0,0
"Qatar","2024-10-03",0,0,0,0,0,0,0,0
"Qatar","2024-10-04",0,0,0,0,0,0,0,0
"Qatar","2024-10-05",0,0,0,0,0,0,0,0
"Qatar","2024-10-06",0,0,0,0,0,0,0,0
"Qatar","2024-10-07",0,0,0,0,0,0,0,0
"Qatar","2024-10-08",0,0,0,0,0,0,0,0
"Qatar","2024-10-09",0,0,0,0,0,0,0,0
"Qatar","2024-10-10",0,0,0,0,0,0,0,0
"Qatar","2024-10-11",0,0,0,0,0,0,0,0
"Qatar","2024-10-12",0,0,0,0,0,0,0,0
"Qatar","2024-10-13",0,0,0,0,0,0,0,0
"Qatar","2024-10-14",0,0,0,0,0,0,0,0
"Qatar","2024-10-15",0,0,0,0,0,0,0,0
"Qatar","2024-10-16",0,0,0,0,0,0,0,0
"Qatar","2024-10-17",0,0,0,0,0,0,0,0
"Qatar","2024-10-18",0,0,0,0,0,0,0,0
"Qatar","2024-10-19",0,0,0,0,0,0,0,0
"Qatar","2024-10-20",0,0,0,0,0,0,0,0
"Qatar","2024-10-21",0,0,0,0,0,0,0,0
"Qatar","2024-10-22",0,0,0,0,0,0,0,0
"Qatar","2024-10-23",0,0,0,0,0,0,0,0
"Qatar","2024-10-24",0,0,0,0,0,0,0,0
"Qatar","2024-10-25",0,0,0,0,0,0,0,0
"Qatar","2024-10-26",0,0,0,0,0,0,0,0
"Qatar","2024-10-27",0,0,0,0,0,0,0,0
"Qatar","2024-10-28",0,0,0,0,0,0,0,0
"Qatar","2024-10-29",0,0,0,0,0,0,0,0
"Qatar","2024-10-30",0,0,0,0,0,0,0,0
"Qatar","2024-10-31",0,0,0,0,0,0,0,0
"Qatar","2024-11-01",0,0,0,0,0,0,0,0
"Qatar","2024-11-02",0,0,0,0,0,0,0,0
"Qatar","2024-11-03",0,0,0,0,0,0,0,0
"Qatar","2024-11-04",0,0,0,0,0,0,0,0
"Qatar","2024-11-05",0,0,0,0,0,0,0,0
"Qatar","2024-11-06",0,0,0,0,0,0,0,0
"Qatar","2024-11-07",0,0,0,0,0,0,0,0
"Qatar","2024-11-08",0,0,0,0,0,0,0,0
"Qatar","2024-11-09",0,0,0,0,0,0,0,0
"Qatar","2024-11-10",0,0,0,0,0,0,0,0
"Qatar","2024-11-11",0,0,0,0,0,0,0,0
"Qatar","2024-11-12",0,0,0,0,0,0,0,0
"Qatar","2024-11-13",0,0,0,0,0,0,0,0
"Qatar","2024-11-14",0,0,0,0,0,0,0,0
"Qatar","2024-11-15",0,0,0,0,0,0,0,0
"Qatar","2024-11-16",0,0,0,0,0,0,0,0
"Qatar","2024-11-17",0,0,0,0,0,0,0,0
"Qatar","2024-11-18",0,0,0,0,0,0,0,0
"Qatar","2024-11-19",0,0,0,0,0,0,0,0
"Qatar","2024-11-20",0,0,0,0,0,0,0,0
"Qatar","2024-11-21",0,0,0,0,0,0,0,0
"Qatar","2024-11-22",0,0,0,0,0,0,0,0
"Qatar","2024-11-23",0,0,0,0,0,0,0,0
"Qatar","2024-11-24",0,0,0,0,0,0,0,0
"Qatar","2024-11-25",0,0,0,0,0,0,0,0
"Qatar","2024-11-26",0,0,0,0,0,0,0,0
"Qatar","2024-11-27",0,0,0,0,0,0,0,0
"Qatar","2024-11-28",0,0,0,0,0,0,0,0
"Qatar","2024-11-29",0,0,0,0,0,0,0,0
"Qatar","2024-11-30",0,0,0,0,0,0,0,0
"Qatar","2024-12-01",0,0,0,0,0,0,0,0
"Qatar","2024-12-02",0,0,0,0,0,0,0,0
"Qatar","2024-12-03",0,0,0,0,0,0,0,0
"Qatar","2024-12-04",0,0,0,0,0,0,0,0
"Qatar","2024-12-05",0,0,0,0,0,0,0,0
"Qatar","2024-12-06",0,0,0,0,0,0,0,0
"Qatar","2024-12-07",0,0,0,0,0,0,0,0
"Qatar","2024-12-08",0,0,0,0,0,0,0,0
"Qatar","2024-12-09",0,0,0,0,0,0,0,0
"Qatar","2024-12-10",0,0,0,0,0,0,0,0
"Qatar","2024-12-11",0,0,0,0,0,0,0,0
"Qatar","2024-12-12",0,0,0,0,0,0,0,0
"Qatar","2024-12-13",0,0,0,0,0,0,0,0
"Qatar","2024-12-14",0,0,0,0,0,0,0,0
"Qatar","2024-12-15",0,0,0,0,0,0,0,0
"Qatar","2024-12-16",0,0,0,0,0,0,0,0
"Qatar","2024-12-17",0,0,0,0,0,0,0,0
"Qatar","2024-12-18",0,0,0,0,0,0,0,0
"Qatar","2024-12-19",0,0,0,0,0,0,0,0
"Qatar","2024-12-20",0,0,0,0,0,0,0,0
"Qatar","2024-12-21",0,0,0,0,0,0,0,0
"Qatar","2024-12-22",0,0,0,0,0,0,0,0
"Qatar","2024-12-23",0,0,0,0,0,0,0,0
"Qatar","2024-12-24",0,0,0,0,0,0,0,0
"Qatar","2024-12-25",0,0,0,0,0,0,0,0
"Qatar","2024-12-26",0,0,0,0,0,0,0,0
"Qatar","2024-12-27",0,0,0,0,0,0,0,0
"Qatar","2024-12-28",0,0,0,0,0,0,0,0
"Qatar","2024-12-29",0,0,0,0,0,0,0,0
"Qatar","2024-12-30",0,0,0,0,0,0,0,0
"Qatar","2024-12-31",0,0,0,0,0,0,0,0
"Qatar","2025-01-01",0,0,0,0,0,0,0,0
"Qatar","2025-01-02",0,0,0,0,0,0,0,0
"Qatar","2025-01-03",0,0,0,0,0,0,0,0
"Qatar","2025-01-04",0,0,0,0,0,0,0,0
"Qatar","2025-01-05",0,0,0,0,0,0,0,0
"Qatar","2025-01-06",0,0,0,0,0,0,0,0
"Qatar","2025-01-07",0,0,0,0,0,0,0,0
"Qatar","2025-01-08",0,0,0,0,0,0,0,0
"Qatar","2025-01-09",0,0,0,0,0,0,0,0
"Qatar","2025-01-10",0,0,0,0,0,0,0,0
"Qatar","2025-01-11",0,0,0,0,0,0,0,0
"Qatar","2025-01-12",0,0,0,0,0,0,0,0
"Qatar","2025-01-13",0,0,0,0,0,0,0,0
"Qatar","2025-01-14",0,0,0,0,0,0,0,0
"Qatar","2025-01-15",0,0,0,0,0,0,0,0
"Qatar","2025-01-16",0,0,0,0,0,0,0,0
"Qatar","2025-01-17",0,0,0,0,0,0,0,0
"Qatar","2025-01-18",0,0,0,0,0,0,0,0
"Qatar","2025-01-19",0,0,0,0,0,0,0,0
"Qatar","2025-01-20",0,0,0,0,0,0,0,0
"Qatar","2025-01-21",0,0,0,0,0,0,0,0
"Qatar","2025-01-22",0,0,0,0,0,0,0,0
"Qatar","2025-01-23",0,0,0,0,0,0,0,0
"Qatar","2025-01-24",0,0,0,0,0,0,0,0
"Qatar","2025-01-25",0,0,0,0,0,0,0,0
"Qatar","2025-01-26",0,0,0,0,0,0,0,0
"Qatar","2025-01-27",0,0,0,0,0,0,0,0
"Qatar","2025-01-28",0,0,0,0,0,0,0,0
"Qatar","2025-01-29",0,0,0,0,0,0,0,0
"Qatar","2025-01-30",0,0,0,0,0,0,0,0
"Qatar","2025-01-31",0,0,0,0,0,0,0,0
"Qatar","2025-02-01",0,0,0,0,0,0,0,0
"Qatar","2025-02-02",0,0,0,0,0,0,0,0
"Qatar","2025-02-03",0,0,0,0,0,0,0,0
"Qatar","2025-02-04",0,0,0,0,0,0,0,0
"Qatar","2025-02-05",0,1,1,0,1,1,0,0
"Qatar","2025-02-06",0,1,2,0,1,2,0,0
"Qatar","2025-02-07",0,0,2,0,0,2,0,0
"Qatar","2025-02-08",0,0,2,0,0,2,0,0
"Qatar","2025-02-09",0,0,2,0,0,2,0,0
"Qatar","2025-02-10",0,0,2,0,0,2,0,0
"Qatar","2025-02-11",0,0,2,0,0,2,0,0
"Qatar","2025-02-12",0,0,2,0,0,2,0,0
"Qatar","2025-02-13",0,0,2,0,0,2,0,0
"Qatar","2025-02-14",0,0,2,0,0,2,0,0
"Qatar","2025-02-15",0,0,2,0,0,2,0,0
"Qatar","2025-02-16",0,0,2,0,0,2,0,0
"Qatar","2025-02-17",0,0,2,0,0,2,0,0
"Qatar","2025-02-18",0,0,2,0,0,2,0,0
"Qatar","2025-02-19",0,0,2,0,0,2,0,0
"Qatar","2025-02-20",0,0,2,0,0,2,0,0
"Qatar","2025-02-21",0,0,2,0,0,2,0,0
"Qatar","2025-02-22",0,0,2,0,0,2,0,0
"Qatar","2025-02-23",0,0,2,0,0,2,0,0
"Qatar","2025-02-24",0,0,2,0,0,2,0,0
"Qatar","2025-02-25",0,0,2,0,0,2,0,0
"Qatar","2025-02-26",0,0,2,0,0,2,0,0
"Qatar","2025-02-27",0,0,2,0,0,2,0,0
"Qatar","2025-02-28",0,0,2,0,0,2,0,0
"Qatar","2025-03-01",0,0,2,0,0,2,0,0
"Qatar","2025-03-02",0,0,2,0,0,2,0,0
"Qatar","2025-03-03",0,0,2,0,0,2,0,0
"Romania","2024-01-01",0,0,0,0,0,0,0,0
"Romania","2024-01-02",0,0,0,0,0,0,0,0
"Romania","2024-01-03",0,0,0,0,0,0,0,0
"Romania","2024-01-04",0,0,0,0,0,0,0,0
"Romania","2024-01-05",0,0,0,0,0,0,0,0
"Romania","2024-01-06",0,0,0,0,0,0,0,0
"Romania","2024-01-07",0,0,0,0,0,0,0,0
"Romania","2024-01-08",0,0,0,0,0,0,0,0
"Romania","2024-01-09",0,0,0,0,0,0,0,0
"Romania","2024-01-10",0,0,0,0,0,0,0,0
"Romania","2024-01-11",0,0,0,0,0,0,0,0
"Romania","2024-01-12",0,0,0,0,0,0,0,0
"Romania","2024-01-13",0,0,0,0,0,0,0,0
"Romania","2024-01-14",0,0,0,0,0,0,0,0
"Romania","2024-01-15",0,0,0,0,0,0,0,0
"Romania","2024-01-16",0,0,0,0,0,0,0,0
"Romania","2024-01-17",0,0,0,0,0,0,0,0
"Romania","2024-01-18",0,0,0,0,0,0,0,0
"Romania","2024-01-19",0,0,0,0,0,0,0,0
"Romania","2024-01-20",0,0,0,0,0,0,0,0
"Romania","2024-01-21",0,0,0,0,0,0,0,0
"Romania","2024-01-22",0,0,0,0,0,0,0,0
"Romania","2024-01-23",0,0,0,0,0,0,0,0
"Romania","2024-01-24",0,0,0,0,0,0,0,0
"Romania","2024-01-25",0,0,0,0,0,0,0,0
"Romania","2024-01-26",0,0,0,0,0,0,0,0
"Romania","2024-01-27",0,0,0,0,0,0,0,0
"Romania","2024-01-28",0,0,0,0,0,0,0,0
"Romania","2024-01-29",0,0,0,0,0,0,0,0
"Romania","2024-01-30",0,0,0,0,0,0,0,0
"Romania","2024-01-31",0,0,0,0,0,0,0,0
"Romania","2024-02-01",0,0,0,0,0,0,0,0
"Romania","2024-02-02",0,0,0,0,0,0,0,0
"Romania","2024-02-03",0,0,0,0,0,0,0,0
"Romania","2024-02-04",0,0,0,0,0,0,0,0
"Romania","2024-02-05",0,0,0,0,0,0,0,0
"Romania","2024-02-06",0,0,0,0,0,0,0,0
"Romania","2024-02-07",0,0,0,0,0,0,0,0
"Romania","2024-02-08",0,0,0,0,0,0,0,0
"Romania","2024-02-09",0,0,0,0,0,0,0,0
"Romania","2024-02-10",0,0,0,0,0,0,0,0
"Romania","2024-02-11",0,0,0,0,0,0,0,0
"Romania","2024-02-12",0,0,0,0,0,0,0,0
"Romania","2024-02-13",0,0,0,0,0,0,0,0
"Romania","2024-02-14",0,0,0,0,0,0,0,0
"Romania","2024-02-15",0,0,0,0,0,0,0,0
"Romania","2024-02-16",0,0,0,0,0,0,0,0
"Romania","2024-02-17",0,0,0,0,0,0,0,0
"Romania","2024-02-18",0,0,0,0,0,0,0,0
"Romania","2024-02-19",0,0,0,0,0,0,0,0
"Romania","2024-02-20",0,0,0,0,0,0,0,0
"Romania","2024-02-21",0,0,0,0,0,0,0,0
"Romania","2024-02-22",0,0,0,0,0,0,0,0
"Romania","2024-02-23",0,0,0,0,0,0,0,0
"Romania","2024-02-24",0,0,0,0,0,0,0,0
"Romania","2024-02-25",0,0,0,0,0,0,0,0
"Romania","2024-02-26",0,0,0,0,0,0,0,0
"Romania","2024-02-27",0,0,0,0,0,0,0,0
"Romania","2024-02-28",0,0,0,0,0,0,0,0
"Romania","2024-02-29",0,0,0,0,0,0,0,0
"Romania","2024-03-01",0,0,0,0,0,0,0,0
"Romania","2024-03-02",0,0,0,0,0,0,0,0
"Romania","2024-03-03",0,0,0,0,0,0,0,0
"Romania","2024-03-04",0,0,0,0,0,0,0,0
"Romania","2024-03-05",0,0,0,0,0,0,0,0
"Romania","2024-03-06",0,0,0,0,0,0,0,0
"Romania","2024-03-07",0,0,0,0,0,0,0,0
"Romania","2024-03-08",0,0,0,0,0,0,0,0
"Romania","2024-03-09",0,0,0,0,0,0,0,0
"Romania","2024-03-10",0,0,0,0,0,0,0,0
"Romania","2024-03-11",0,0,0,0,0,0,0,0
"Romania","2024-03-12",0,0,0,0,0,0,0,0
"Romania","2024-03-13",0,0,0,0,0,0,0,0
"Romania","2024-03-14",0,0,0,0,0,0,0,0
"Romania","2024-03-15",0,0,0,0,0,0,0,0
"Romania","2024-03-16",0,0,0,0,0,0,0,0
"Romania","2024-03-17",0,0,0,0,0,0,0,0
"Romania","2024-03-18",0,0,0,0,0,0,0,0
"Romania","2024-03-19",0,0,0,0,0,0,0,0
"Romania","2024-03-20",0,0,0,0,0,0,0,0
"Romania","2024-03-21",0,0,0,0,0,0,0,0
"Romania","2024-03-22",0,0,0,0,0,0,0,0
"Romania","2024-03-23",0,0,0,0,0,0,0,0
"Romania","2024-03-24",0,0,0,0,0,0,0,0
"Romania","2024-03-25",0,0,0,0,0,0,0,0
"Romania","2024-03-26",0,0,0,0,0,0,0,0
"Romania","2024-03-27",0,0,0,0,0,0,0,0
"Romania","2024-03-28",0,0,0,0,0,0,0,0
"Romania","2024-03-29",0,0,0,0,0,0,0,0
"Romania","2024-03-30",0,0,0,0,0,0,0,0
"Romania","2024-03-31",0,0,0,0,0,0,0,0
"Romania","2024-04-01",0,0,0,0,0,0,0,0
"Romania","2024-04-02",0,0,0,0,0,0,0,0
"Romania","2024-04-03",0,0,0,0,0,0,0,0
"Romania","2024-04-04",0,0,0,0,0,0,0,0
"Romania","2024-04-05",0,0,0,0,0,0,0,0
"Romania","2024-04-06",0,0,0,0,0,0,0,0
"Romania","2024-04-07",0,0,0,0,0,0,0,0
"Romania","2024-04-08",0,0,0,0,0,0,0,0
"Romania","2024-04-09",0,0,0,0,0,0,0,0
"Romania","2024-04-10",0,0,0,0,0,0,0,0
"Romania","2024-04-11",0,0,0,0,0,0,0,0
"Romania","2024-04-12",0,0,0,0,0,0,0,0
"Romania","2024-04-13",0,0,0,0,0,0,0,0
"Romania","2024-04-14",0,0,0,0,0,0,0,0
"Romania","2024-04-15",0,0,0,0,0,0,0,0
"Romania","2024-04-16",0,0,0,0,0,0,0,0
"Romania","2024-04-17",0,0,0,0,0,0,0,0
"Romania","2024-04-18",0,0,0,0,0,0,0,0
"Romania","2024-04-19",0,0,0,0,0,0,0,0
"Romania","2024-04-20",0,0,0,0,0,0,0,0
"Romania","2024-04-21",0,0,0,0,0,0,0,0
"Romania","2024-04-22",0,0,0,0,0,0,0,0
"Romania","2024-04-23",0,0,0,0,0,0,0,0
"Romania","2024-04-24",0,0,0,0,0,0,0,0
"Romania","2024-04-25",0,0,0,0,0,0,0,0
"Romania","2024-04-26",0,0,0,0,0,0,0,0
"Romania","2024-04-27",0,0,0,0,0,0,0,0
"Romania","2024-04-28",0,0,0,0,0,0,0,0
"Romania","2024-04-29",0,0,0,0,0,0,0,0
"Romania","2024-04-30",0,0,0,0,0,0,0,0
"Romania","2024-05-01",0,0,0,0,0,0,0,0
"Romania","2024-05-02",0,0,0,0,0,0,0,0
"Romania","2024-05-03",0,0,0,0,0,0,0,0
"Romania","2024-05-04",0,0,0,0,0,0,0,0
"Romania","2024-05-05",0,0,0,0,0,0,0,0
"Romania","2024-05-06",0,0,0,0,0,0,0,0
"Romania","2024-05-07",0,0,0,0,0,0,0,0
"Romania","2024-05-08",0,0,0,0,0,0,0,0
"Romania","2024-05-09",0,0,0,0,0,0,0,0
"Romania","2024-05-10",0,0,0,0,0,0,0,0
"Romania","2024-05-11",0,0,0,0,0,0,0,0
"Romania","2024-05-12",0,0,0,0,0,0,0,0
"Romania","2024-05-13",0,0,0,0,0,0,0,0
"Romania","2024-05-14",0,0,0,0,0,0,0,0
"Romania","2024-05-15",0,0,0,0,0,0,0,0
"Romania","2024-05-16",0,0,0,0,0,0,0,0
"Romania","2024-05-17",0,0,0,0,0,0,0,0
"Romania","2024-05-18",0,0,0,0,0,0,0,0
"Romania","2024-05-19",0,0,0,0,0,0,0,0
"Romania","2024-05-20",0,0,0,0,0,0,0,0
"Romania","2024-05-21",0,0,0,0,0,0,0,0
"Romania","2024-05-22",0,0,0,0,0,0,0,0
"Romania","2024-05-23",0,0,0,0,0,0,0,0
"Romania","2024-05-24",0,0,0,0,0,0,0,0
"Romania","2024-05-25",0,0,0,0,0,0,0,0
"Romania","2024-05-26",0,0,0,0,0,0,0,0
"Romania","2024-05-27",0,0,0,0,0,0,0,0
"Romania","2024-05-28",0,0,0,0,0,0,0,0
"Romania","2024-05-29",0,0,0,0,0,0,0,0
"Romania","2024-05-30",0,0,0,0,0,0,0,0
"Romania","2024-05-31",0,0,0,0,0,0,0,0
"Romania","2024-06-01",0,0,0,0,0,0,0,0
"Romania","2024-06-02",0,0,0,0,0,0,0,0
"Romania","2024-06-03",0,0,0,0,0,0,0,0
"Romania","2024-06-04",0,0,0,0,0,0,0,0
"Romania","2024-06-05",0,0,0,0,0,0,0,0
"Romania","2024-06-06",0,0,0,0,0,0,0,0
"Romania","2024-06-07",0,0,0,0,0,0,0,0
"Romania","2024-06-08",0,0,0,0,0,0,0,0
"Romania","2024-06-09",0,0,0,0,0,0,0,0
"Romania","2024-06-10",0,0,0,0,0,0,0,0
"Romania","2024-06-11",0,0,0,0,0,0,0,0
"Romania","2024-06-12",0,0,0,0,0,0,0,0
"Romania","2024-06-13",0,0,0,0,0,0,0,0
"Romania","2024-06-14",0,0,0,0,0,0,0,0
"Romania","2024-06-15",0,0,0,0,0,0,0,0
"Romania","2024-06-16",0,0,0,0,0,0,0,0
"Romania","2024-06-17",0,0,0,0,0,0,0,0
"Romania","2024-06-18",0,0,0,0,0,0,0,0
"Romania","2024-06-19",0,0,0,0,0,0,0,0
"Romania","2024-06-20",0,0,0,0,0,0,0,0
"Romania","2024-06-21",0,0,0,0,0,0,0,0
"Romania","2024-06-22",0,0,0,0,0,0,0,0
"Romania","2024-06-23",0,0,0,0,0,0,0,0
"Romania","2024-06-24",0,0,0,0,0,0,0,0
"Romania","2024-06-25",0,0,0,0,0,0,0,0
"Romania","2024-06-26",0,0,0,0,0,0,0,0
"Romania","2024-06-27",0,0,0,0,0,0,0,0
"Romania","2024-06-28",0,0,0,0,0,0,0,0
"Romania","2024-06-29",0,0,0,0,0,0,0,0
"Romania","2024-06-30",0,0,0,0,0,0,0,0
"Romania","2024-07-01",0,0,0,0,0,0,0,0
"Romania","2024-07-02",0,0,0,0,0,0,0,0
"Romania","2024-07-03",0,0,0,0,0,0,0,0
"Romania","2024-07-04",0,0,0,0,0,0,0,0
"Romania","2024-07-05",0,0,0,0,0,0,0,0
"Romania","2024-07-06",0,0,0,0,0,0,0,0
"Romania","2024-07-07",0,0,0,0,0,0,0,0
"Romania","2024-07-08",0,0,0,0,0,0,0,0
"Romania","2024-07-09",0,0,0,0,0,0,0,0
"Romania","2024-07-10",0,0,0,0,0,0,0,0
"Romania","2024-07-11",0,0,0,0,0,0,0,0
"Romania","2024-07-12",0,0,0,0,0,0,0,0
"Romania","2024-07-13",0,0,0,0,0,0,0,0
"Romania","2024-07-14",0,0,0,0,0,0,0,0
"Romania","2024-07-15",0,0,0,0,0,0,0,0
"Romania","2024-07-16",0,0,0,0,0,0,0,0
"Romania","2024-07-17",0,0,0,0,0,0,0,0
"Romania","2024-07-18",0,0,0,0,0,0,0,0
"Romania","2024-07-19",0,0,0,0,0,0,0,0
"Romania","2024-07-20",0,0,0,0,0,0,0,0
"Romania","2024-07-21",0,0,0,0,0,0,0,0
"Romania","2024-07-22",0,0,0,0,0,0,0,0
"Romania","2024-07-23",0,0,0,0,0,0,0,0
"Romania","2024-07-24",0,0,0,0,0,0,0,0
"Romania","2024-07-25",0,0,0,0,0,0,0,0
"Romania","2024-07-26",0,0,0,0,0,0,0,0
"Romania","2024-07-27",0,0,0,0,0,0,0,0
"Romania","2024-07-28",0,0,0,0,0,0,0,0
"Romania","2024-07-29",0,0,0,0,0,0,0,0
"Romania","2024-07-30",0,0,0,0,0,0,0,0
"Romania","2024-07-31",0,0,0,0,0,0,0,0
"Romania","2024-08-01",0,0,0,0,0,0,0,0
"Romania","2024-08-02",0,0,0,0,0,0,0,0
"Romania","2024-08-03",0,0,0,0,0,0,0,0
"Romania","2024-08-04",0,0,0,0,0,0,0,0
"Romania","2024-08-05",0,0,0,0,0,0,0,0
"Romania","2024-08-06",0,0,0,0,0,0,0,0
"Romania","2024-08-07",0,0,0,0,0,0,0,0
"Romania","2024-08-08",0,0,0,0,0,0,0,0
"Romania","2024-08-09",0,0,0,0,0,0,0,0
"Romania","2024-08-10",0,0,0,0,0,0,0,0
"Romania","2024-08-11",0,0,0,0,0,0,0,0
"Romania","2024-08-12",0,0,0,0,0,0,0,0
"Romania","2024-08-13",0,0,0,0,0,0,0,0
"Romania","2024-08-14",0,0,0,0,0,0,0,0
"Romania","2024-08-15",0,0,0,0,0,0,0,0
"Romania","2024-08-16",0,0,0,0,0,0,0,0
"Romania","2024-08-17",0,0,0,0,0,0,0,0
"Romania","2024-08-18",0,0,0,0,0,0,0,0
"Romania","2024-08-19",0,0,0,0,0,0,0,0
"Romania","2024-08-20",0,0,0,0,0,0,0,0
"Romania","2024-08-21",0,0,0,0,0,0,0,0
"Romania","2024-08-22",0,0,0,0,0,0,0,0
"Romania","2024-08-23",0,0,0,0,0,0,0,0
"Romania","2024-08-24",0,0,0,0,0,0,0,0
"Romania","2024-08-25",0,0,0,0,0,0,0,0
"Romania","2024-08-26",0,0,0,0,0,0,0,0
"Romania","2024-08-27",0,0,0,0,0,0,0,0
"Romania","2024-08-28",0,0,0,0,0,0,0,0
"Romania","2024-08-29",0,0,0,0,0,0,0,0
"Romania","2024-08-30",0,0,0,0,0,0,0,0
"Romania","2024-08-31",0,1,1,0,1,1,0,0
"Romania","2024-09-01",0,0,1,0,0,1,0,0
"Romania","2024-09-02",0,0,1,0,0,1,0,0
"Romania","2024-09-03",0,0,1,0,0,1,0,0
"Romania","2024-09-04",0,0,1,0,0,1,0,0
"Romania","2024-09-05",0,0,1,0,0,1,0,0
"Romania","2024-09-06",0,0,1,0,0,1,0,0
"Romania","2024-09-07",0,0,1,0,0,1,0,0
"Romania","2024-09-08",0,0,1,0,0,1,0,0
"Romania","2024-09-09",0,0,1,0,0,1,0,0
"Romania","2024-09-10",0,0,1,0,0,1,0,0
"Romania","2024-09-11",0,0,1,0,0,1,0,0
"Romania","2024-09-12",0,0,1,0,0,1,0,0
"Romania","2024-09-13",0,0,1,0,0,1,0,0
"Romania","2024-09-14",0,0,1,0,0,1,0,0
"Romania","2024-09-15",0,0,1,0,0,1,0,0
"Romania","2024-09-16",0,0,1,0,0,1,0,0
"Romania","2024-09-17",0,0,1,0,0,1,0,0
"Romania","2024-09-18",0,0,1,0,0,1,0,0
"Romania","2024-09-19",0,0,1,0,0,1,0,0
"Romania","2024-09-20",0,0,1,0,0,1,0,0
"Romania","2024-09-21",0,0,1,0,0,1,0,0
"Romania","2024-09-22",0,0,1,0,0,1,0,0
"Romania","2024-09-23",0,0,1,0,0,1,0,0
"Romania","2024-09-24",0,0,1,0,0,1,0,0
"Romania","2024-09-25",0,0,1,0,0,1,0,0
"Romania","2024-09-26",0,0,1,0,0,1,0,0
"Romania","2024-09-27",0,0,1,0,0,1,0,0
"Romania","2024-09-28",0,0,1,0,0,1,0,0
"Romania","2024-09-29",0,0,1,0,0,1,0,0
"Romania","2024-09-30",0,0,1,0,0,1,0,0
"Romania","2024-10-01",0,0,1,0,0,1,0,0
"Romania","2024-10-02",0,0,1,0,0,1,0,0
"Romania","2024-10-03",0,0,1,0,0,1,0,0
"Romania","2024-10-04",0,0,1,0,0,1,0,0
"Romania","2024-10-05",0,0,1,0,0,1,0,0
"Romania","2024-10-06",0,0,1,0,0,1,0,0
"Romania","2024-10-07",0,0,1,0,0,1,0,0
"Romania","2024-10-08",0,0,1,0,0,1,0,0
"Romania","2024-10-09",0,0,1,0,0,1,0,0
"Romania","2024-10-10",0,0,1,0,0,1,0,0
"Romania","2024-10-11",0,0,1,0,0,1,0,0
"Romania","2024-10-12",0,0,1,0,0,1,0,0
"Romania","2024-10-13",0,0,1,0,0,1,0,0
"Romania","2024-10-14",0,0,1,0,0,1,0,0
"Romania","2024-10-15",0,0,1,0,0,1,0,0
"Romania","2024-10-16",0,0,1,0,0,1,0,0
"Romania","2024-10-17",0,0,1,0,0,1,0,0
"Romania","2024-10-18",0,0,1,0,0,1,0,0
"Romania","2024-10-19",0,0,1,0,0,1,0,0
"Romania","2024-10-20",0,0,1,0,0,1,0,0
"Romania","2024-10-21",0,0,1,0,0,1,0,0
"Romania","2024-10-22",0,0,1,0,0,1,0,0
"Romania","2024-10-23",0,0,1,0,0,1,0,0
"Romania","2024-10-24",0,0,1,0,0,1,0,0
"Romania","2024-10-25",0,0,1,0,0,1,0,0
"Romania","2024-10-26",0,0,1,0,0,1,0,0
"Romania","2024-10-27",0,0,1,0,0,1,0,0
"Romania","2024-10-28",0,0,1,0,0,1,0,0
"Romania","2024-10-29",0,0,1,0,0,1,0,0
"Romania","2024-10-30",0,0,1,0,0,1,0,0
"Romania","2024-10-31",0,0,1,0,0,1,0,0
"Romania","2024-11-01",0,0,1,0,0,1,0,0
"Romania","2024-11-02",0,0,1,0,0,1,0,0
"Romania","2024-11-03",0,0,1,0,0,1,0,0
"Romania","2024-11-04",0,0,1,0,0,1,0,0
"Romania","2024-11-05",0,0,1,0,0,1,0,0
"Romania","2024-11-06",0,0,1,0,1,2,0,0
"Romania","2024-11-07",0,0,1,0,0,2,0,0
"Romania","2024-11-08",0,0,1,0,0,2,0,0
"Romania","2024-11-09",0,0,1,0,0,2,0,0
"Romania","2024-11-10",0,0,1,0,0,2,0,0
"Romania","2024-11-11",0,0,1,0,0,2,0,0
"Romania","2024-11-12",0,0,1,0,0,2,0,0
"Romania","2024-11-13",0,0,1,0,0,2,0,0
"Romania","2024-11-14",0,0,1,0,0,2,0,0
"Romania","2024-11-15",0,0,1,0,0,2,0,0
"Romania","2024-11-16",0,0,1,0,0,2,0,0
"Romania","2024-11-17",0,0,1,0,0,2,0,0
"Romania","2024-11-18",0,0,1,0,0,2,0,0
"Romania","2024-11-19",0,0,1,0,0,2,0,0
"Romania","2024-11-20",0,0,1,0,0,2,0,0
"Romania","2024-11-21",0,0,1,0,0,2,0,0
"Romania","2024-11-22",0,0,1,0,0,2,0,0
"Romania","2024-11-23",0,0,1,0,0,2,0,0
"Romania","2024-11-24",0,0,1,0,0,2,0,0
"Romania","2024-11-25",0,0,1,0,0,2,0,0
"Romania","2024-11-26",0,0,1,0,0,2,0,0
"Romania","2024-11-27",0,0,1,0,0,2,0,0
"Romania","2024-11-28",0,0,1,0,0,2,0,0
"Romania","2024-11-29",0,0,1,0,0,2,0,0
"Romania","2024-11-30",0,0,1,0,0,2,0,0
"Romania","2024-12-01",0,0,1,0,0,2,0,0
"Romania","2024-12-02",0,0,1,0,0,2,0,0
"Romania","2024-12-03",0,0,1,0,0,2,0,0
"Romania","2024-12-04",0,0,1,0,0,2,0,0
"Romania","2024-12-05",0,0,1,0,0,2,0,0
"Romania","2024-12-06",0,0,1,0,0,2,0,0
"Romania","2024-12-07",0,0,1,0,0,2,0,0
"Romania","2024-12-08",0,0,1,0,0,2,0,0
"Romania","2024-12-09",0,0,1,0,0,2,0,0
"Romania","2024-12-10",0,0,1,0,0,2,0,0
"Romania","2024-12-11",0,0,1,0,0,2,0,0
"Romania","2024-12-12",0,0,1,0,0,2,0,0
"Romania","2024-12-13",0,0,1,0,0,2,0,0
"Romania","2024-12-14",0,0,1,0,0,2,0,0
"Romania","2024-12-15",0,0,1,0,0,2,0,0
"Romania","2024-12-16",0,0,1,0,0,2,0,0
"Romania","2024-12-17",0,0,1,0,0,2,0,0
"Romania","2024-12-18",0,0,1,0,0,2,0,0
"Romania","2024-12-19",0,0,1,0,0,2,0,0
"Romania","2024-12-20",0,0,1,0,0,2,0,0
"Romania","2024-12-21",0,0,1,0,0,2,0,0
"Romania","2024-12-22",0,0,1,0,0,2,0,0
"Romania","2024-12-23",0,0,1,0,0,2,0,0
"Romania","2024-12-24",0,0,1,0,0,2,0,0
"Romania","2024-12-25",0,0,1,0,0,2,0,0
"Romania","2024-12-26",0,0,1,0,0,2,0,0
"Romania","2024-12-27",0,0,1,0,0,2,0,0
"Romania","2024-12-28",0,0,1,0,0,2,0,0
"Romania","2024-12-29",0,0,1,0,0,2,0,0
"Romania","2024-12-30",0,0,1,0,0,2,0,0
"Romania","2024-12-31",0,0,1,0,0,2,0,0
"Romania","2025-01-01",0,0,1,0,0,2,0,0
"Romania","2025-01-02",0,0,1,0,0,2,0,0
"Romania","2025-01-03",0,0,1,0,0,2,0,0
"Romania","2025-01-04",0,0,1,0,0,2,0,0
"Romania","2025-01-05",0,0,1,0,0,2,0,0
"Romania","2025-01-06",0,0,1,0,0,2,0,0
"Romania","2025-01-07",0,0,1,0,0,2,0,0
"Romania","2025-01-08",0,0,1,0,0,2,0,0
"Romania","2025-01-09",0,0,1,0,0,2,0,0
"Romania","2025-01-10",0,1,2,0,0,2,0,0
"Romania","2025-01-11",0,0,2,0,0,2,0,0
"Romania","2025-01-12",0,0,2,0,0,2,0,0
"Romania","2025-01-13",0,0,2,0,0,2,0,0
"Romania","2025-01-14",0,0,2,0,0,2,0,0
"Romania","2025-01-15",0,0,2,0,0,2,0,0
"Romania","2025-01-16",0,0,2,0,0,2,0,0
"Romania","2025-01-17",0,0,2,0,0,2,0,0
"Romania","2025-01-18",0,0,2,0,0,2,0,0
"Romania","2025-01-19",0,0,2,0,0,2,0,0
"Romania","2025-01-20",0,0,2,0,0,2,0,0
"Romania","2025-01-21",0,0,2,0,0,2,0,0
"Romania","2025-01-22",0,0,2,0,0,2,0,0
"Romania","2025-01-23",0,0,2,0,0,2,0,0
"Romania","2025-01-24",0,0,2,0,0,2,0,0
"Romania","2025-01-25",0,0,2,0,0,2,0,0
"Romania","2025-01-26",0,0,2,0,0,2,0,0
"Romania","2025-01-27",0,0,2,0,0,2,0,0
"Romania","2025-01-28",0,0,2,0,0,2,0,0
"Romania","2025-01-29",0,0,2,0,0,2,0,0
"Romania","2025-01-30",0,0,2,0,0,2,0,0
"Romania","2025-01-31",0,0,2,0,0,2,0,0
"Romania","2025-02-01",0,0,2,0,0,2,0,0
"Romania","2025-02-02",0,0,2,0,0,2,0,0
"Romania","2025-02-03",0,0,2,0,0,2,0,0
"Romania","2025-02-04",0,0,2,0,0,2,0,0
"Romania","2025-02-05",0,0,2,0,0,2,0,0
"Romania","2025-02-06",0,0,2,0,0,2,0,0
"Romania","2025-02-07",0,0,2,0,0,2,0,0
"Romania","2025-02-08",0,0,2,0,0,2,0,0
"Romania","2025-02-09",0,0,2,0,0,2,0,0
"Romania","2025-02-10",0,0,2,0,0,2,0,0
"Romania","2025-02-11",0,0,2,0,0,2,0,0
"Romania","2025-02-12",0,0,2,0,0,2,0,0
"Romania","2025-02-13",0,0,2,0,0,2,0,0
"Romania","2025-02-14",0,0,2,0,0,2,0,0
"Romania","2025-02-15",0,0,2,0,0,2,0,0
"Romania","2025-02-16",0,0,2,0,0,2,0,0
"Romania","2025-02-17",0,0,2,0,0,2,0,0
"Romania","2025-02-18",0,0,2,0,0,2,0,0
"Romania","2025-02-19",0,0,2,0,0,2,0,0
"Romania","2025-02-20",0,0,2,0,0,2,0,0
"Romania","2025-02-21",0,0,2,0,0,2,0,0
"Romania","2025-02-22",0,0,2,0,0,2,0,0
"Romania","2025-02-23",0,0,2,0,0,2,0,0
"Romania","2025-02-24",0,0,2,0,0,2,0,0
"Romania","2025-02-25",0,0,2,0,0,2,0,0
"Romania","2025-02-26",0,0,2,0,0,2,0,0
"Romania","2025-02-27",0,0,2,0,0,2,0,0
"Romania","2025-02-28",0,0,2,0,0,2,0,0
"Romania","2025-03-01",0,0,2,0,0,2,0,0
"Romania","2025-03-02",0,0,2,0,0,2,0,0
"Romania","2025-03-03",0,0,2,0,0,2,0,0
"Russian Federation","2024-01-01",0,0,0,0,0,0,0,0
"Russian Federation","2024-01-02",0,0,0,0,0,0,0,0
"Russian Federation","2024-01-03",0,0,0,0,0,0,0,0
"Russian Federation","2024-01-04",0,0,0,0,0,0,0,0
"Russian Federation","2024-01-05",0,0,0,0,0,0,0,0
"Russian Federation","2024-01-06",0,0,0,0,0,0,0,0
"Russian Federation","2024-01-07",0,0,0,0,0,0,0,0
"Russian Federation","2024-01-08",0,0,0,0,0,0,0,0
"Russian Federation","2024-01-09",0,0,0,0,0,0,0,0
"Russian Federation","2024-01-10",0,0,0,0,0,0,0,0
"Russian Federation","2024-01-11",0,0,0,0,0,0,0,0
"Russian Federation","2024-01-12",0,0,0,0,0,0,0,0
"Russian Federation","2024-01-13",0,0,0,0,0,0,0,0
"Russian Federation","2024-01-14",0,0,0,0,0,0,0,0
"Russian Federation","2024-01-15",0,0,0,0,0,0,0,0
"Russian Federation","2024-01-16",0,0,0,0,0,0,0,0
"Russian Federation","2024-01-17",0,0,0,0,0,0,0,0
"Russian Federation","2024-01-18",0,0,0,0,0,0,0,0
"Russian Federation","2024-01-19",0,0,0,0,0,0,0,0
"Russian Federation","2024-01-20",0,0,0,0,0,0,0,0
"Russian Federation","2024-01-21",0,0,0,0,0,0,0,0
"Russian Federation","2024-01-22",0,0,0,0,0,0,0,0
"Russian Federation","2024-01-23",0,0,0,0,0,0,0,0
"Russian Federation","2024-01-24",0,0,0,0,0,0,0,0
"Russian Federation","2024-01-25",0,0,0,0,0,0,0,0
"Russian Federation","2024-01-26",0,0,0,0,0,0,0,0
"Russian Federation","2024-01-27",0,0,0,0,0,0,0,0
"Russian Federation","2024-01-28",0,0,0,0,0,0,0,0
"Russian Federation","2024-01-29",0,0,0,0,0,0,0,0
"Russian Federation","2024-01-30",0,0,0,0,0,0,0,0
"Russian Federation","2024-01-31",0,2,2,0,2,2,0,0
"Russian Federation","2024-02-01",0,0,2,0,0,2,0,0
"Russian Federation","2024-02-02",0,0,2,0,0,2,0,0
"Russian Federation","2024-02-03",0,0,2,0,0,2,0,0
"Russian Federation","2024-02-04",0,0,2,0,0,2,0,0
"Russian Federation","2024-02-05",0,0,2,0,0,2,0,0
"Russian Federation","2024-02-06",0,0,2,0,0,2,0,0
"Russian Federation","2024-02-07",0,0,2,0,0,2,0,0
"Russian Federation","2024-02-08",0,0,2,0,0,2,0,0
"Russian Federation","2024-02-09",0,0,2,0,0,2,0,0
"Russian Federation","2024-02-10",0,0,2,0,0,2,0,0
"Russian Federation","2024-02-11",0,0,2,0,0,2,0,0
"Russian Federation","2024-02-12",0,0,2,0,0,2,0,0
"Russian Federation","2024-02-13",0,0,2,0,0,2,0,0
"Russian Federation","2024-02-14",0,0,2,0,0,2,0,0
"Russian Federation","2024-02-15",0,0,2,0,0,2,0,0
"Russian Federation","2024-02-16",0,0,2,0,0,2,0,0
"Russian Federation","2024-02-17",0,0,2,0,0,2,0,0
"Russian Federation","2024-02-18",0,0,2,0,0,2,0,0
"Russian Federation","2024-02-19",0,0,2,0,0,2,0,0
"Russian Federation","2024-02-20",0,0,2,0,0,2,0,0
"Russian Federation","2024-02-21",0,0,2,0,0,2,0,0
"Russian Federation","2024-02-22",0,0,2,0,0,2,0,0
"Russian Federation","2024-02-23",0,0,2,0,0,2,0,0
"Russian Federation","2024-02-24",0,0,2,0,0,2,0,0
"Russian Federation","2024-02-25",0,0,2,0,0,2,0,0
"Russian Federation","2024-02-26",0,0,2,0,0,2,0,0
"Russian Federation","2024-02-27",0,0,2,0,0,2,0,0
"Russian Federation","2024-02-28",0,0,2,0,0,2,0,0
"Russian Federation","2024-02-29",0,0,2,0,0,2,0,0
"Russian Federation","2024-03-01",0,0,2,0,0,2,0,0
"Russian Federation","2024-03-02",0,0,2,0,0,2,0,0
"Russian Federation","2024-03-03",0,0,2,0,0,2,0,0
"Russian Federation","2024-03-04",0,0,2,0,0,2,0,0
"Russian Federation","2024-03-05",0,0,2,0,0,2,0,0
"Russian Federation","2024-03-06",0,0,2,0,0,2,0,0
"Russian Federation","2024-03-07",0,0,2,0,0,2,0,0
"Russian Federation","2024-03-08",0,0,2,0,0,2,0,0
"Russian Federation","2024-03-09",0,0,2,0,0,2,0,0
"Russian Federation","2024-03-10",0,0,2,0,0,2,0,0
"Russian Federation","2024-03-11",0,0,2,0,0,2,0,0
"Russian Federation","2024-03-12",0,0,2,0,0,2,0,0
"Russian Federation","2024-03-13",0,0,2,0,0,2,0,0
"Russian Federation","2024-03-14",0,0,2,0,0,2,0,0
"Russian Federation","2024-03-15",0,0,2,0,0,2,0,0
"Russian Federation","2024-03-16",0,0,2,0,0,2,0,0
"Russian Federation","2024-03-17",0,0,2,0,0,2,0,0
"Russian Federation","2024-03-18",0,0,2,0,0,2,0,0
"Russian Federation","2024-03-19",0,0,2,0,0,2,0,0
"Russian Federation","2024-03-20",0,0,2,0,0,2,0,0
"Russian Federation","2024-03-21",0,0,2,0,0,2,0,0
"Russian Federation","2024-03-22",0,0,2,0,0,2,0,0
"Russian Federation","2024-03-23",0,0,2,0,0,2,0,0
"Russian Federation","2024-03-24",0,0,2,0,0,2,0,0
"Russian Federation","2024-03-25",0,0,2,0,0,2,0,0
"Russian Federation","2024-03-26",0,0,2,0,0,2,0,0
"Russian Federation","2024-03-27",0,0,2,0,0,2,0,0
"Russian Federation","2024-03-28",0,0,2,0,0,2,0,0
"Russian Federation","2024-03-29",0,0,2,0,0,2,0,0
"Russian Federation","2024-03-30",0,0,2,0,0,2,0,0
"Russian Federation","2024-03-31",0,0,2,0,0,2,0,0
"Russian Federation","2024-04-01",0,0,2,0,0,2,0,0
"Russian Federation","2024-04-02",0,0,2,0,0,2,0,0
"Russian Federation","2024-04-03",0,0,2,0,0,2,0,0
"Russian Federation","2024-04-04",0,0,2,0,0,2,0,0
"Russian Federation","2024-04-05",0,0,2,0,0,2,0,0
"Russian Federation","2024-04-06",0,0,2,0,0,2,0,0
"Russian Federation","2024-04-07",0,0,2,0,0,2,0,0
"Russian Federation","2024-04-08",0,0,2,0,0,2,0,0
"Russian Federation","2024-04-09",0,0,2,0,0,2,0,0
"Russian Federation","2024-04-10",0,0,2,0,0,2,0,0
"Russian Federation","2024-04-11",0,0,2,0,0,2,0,0
"Russian Federation","2024-04-12",0,0,2,0,0,2,0,0
"Russian Federation","2024-04-13",0,0,2,0,0,2,0,0
"Russian Federation","2024-04-14",0,0,2,0,0,2,0,0
"Russian Federation","2024-04-15",0,0,2,0,0,2,0,0
"Russian Federation","2024-04-16",0,0,2,0,0,2,0,0
"Russian Federation","2024-04-17",0,0,2,0,0,2,0,0
"Russian Federation","2024-04-18",0,0,2,0,0,2,0,0
"Russian Federation","2024-04-19",0,0,2,0,0,2,0,0
"Russian Federation","2024-04-20",0,0,2,0,0,2,0,0
"Russian Federation","2024-04-21",0,0,2,0,0,2,0,0
"Russian Federation","2024-04-22",0,0,2,0,0,2,0,0
"Russian Federation","2024-04-23",0,0,2,0,0,2,0,0
"Russian Federation","2024-04-24",0,0,2,0,0,2,0,0
"Russian Federation","2024-04-25",0,0,2,0,0,2,0,0
"Russian Federation","2024-04-26",0,0,2,0,0,2,0,0
"Russian Federation","2024-04-27",0,0,2,0,0,2,0,0
"Russian Federation","2024-04-28",0,0,2,0,0,2,0,0
"Russian Federation","2024-04-29",0,0,2,0,0,2,0,0
"Russian Federation","2024-04-30",0,0,2,0,0,2,0,0
"Russian Federation","2024-05-01",0,0,2,0,0,2,0,0
"Russian Federation","2024-05-02",0,0,2,0,0,2,0,0
"Russian Federation","2024-05-03",0,0,2,0,0,2,0,0
"Russian Federation","2024-05-04",0,0,2,0,0,2,0,0
"Russian Federation","2024-05-05",0,0,2,0,0,2,0,0
"Russian Federation","2024-05-06",0,0,2,0,0,2,0,0
"Russian Federation","2024-05-07",0,0,2,0,0,2,0,0
"Russian Federation","2024-05-08",0,0,2,0,0,2,0,0
"Russian Federation","2024-05-09",0,0,2,0,0,2,0,0
"Russian Federation","2024-05-10",0,0,2,0,0,2,0,0
"Russian Federation","2024-05-11",0,0,2,0,0,2,0,0
"Russian Federation","2024-05-12",0,0,2,0,0,2,0,0
"Russian Federation","2024-05-13",0,0,2,0,0,2,0,0
"Russian Federation","2024-05-14",0,0,2,0,0,2,0,0
"Russian Federation","2024-05-15",0,0,2,0,0,2,0,0
"Russian Federation","2024-05-16",0,0,2,0,0,2,0,0
"Russian Federation","2024-05-17",0,0,2,0,0,2,0,0
"Russian Federation","2024-05-18",0,0,2,0,0,2,0,0
"Russian Federation","2024-05-19",0,0,2,0,0,2,0,0
"Russian Federation","2024-05-20",0,0,2,0,0,2,0,0
"Russian Federation","2024-05-21",0,0,2,0,0,2,0,0
"Russian Federation","2024-05-22",0,0,2,0,0,2,0,0
"Russian Federation","2024-05-23",0,0,2,0,0,2,0,0
"Russian Federation","2024-05-24",0,0,2,0,0,2,0,0
"Russian Federation","2024-05-25",0,0,2,0,0,2,0,0
"Russian Federation","2024-05-26",0,0,2,0,0,2,0,0
"Russian Federation","2024-05-27",0,0,2,0,0,2,0,0
"Russian Federation","2024-05-28",0,0,2,0,0,2,0,0
"Russian Federation","2024-05-29",0,0,2,0,0,2,0,0
"Russian Federation","2024-05-30",0,0,2,0,0,2,0,0
"Russian Federation","2024-05-31",0,0,2,0,0,2,0,0
"Russian Federation","2024-06-01",0,0,2,0,0,2,0,0
"Russian Federation","2024-06-02",0,0,2,0,0,2,0,0
"Russian Federation","2024-06-03",0,0,2,0,0,2,0,0
"Russian Federation","2024-06-04",0,0,2,0,0,2,0,0
"Russian Federation","2024-06-05",0,0,2,0,0,2,0,0
"Russian Federation","2024-06-06",0,0,2,0,0,2,0,0
"Russian Federation","2024-06-07",0,0,2,0,0,2,0,0
"Russian Federation","2024-06-08",0,0,2,0,0,2,0,0
"Russian Federation","2024-06-09",0,0,2,0,0,2,0,0
"Russian Federation","2024-06-10",0,0,2,0,0,2,0,0
"Russian Federation","2024-06-11",0,0,2,0,0,2,0,0
"Russian Federation","2024-06-12",0,0,2,0,0,2,0,0
"Russian Federation","2024-06-13",0,0,2,0,0,2,0,0
"Russian Federation","2024-06-14",0,0,2,0,0,2,0,0
"Russian Federation","2024-06-15",0,0,2,0,0,2,0,0
"Russian Federation","2024-06-16",0,0,2,0,0,2,0,0
"Russian Federation","2024-06-17",0,0,2,0,0,2,0,0
"Russian Federation","2024-06-18",0,0,2,0,0,2,0,0
"Russian Federation","2024-06-19",0,0,2,0,0,2,0,0
"Russian Federation","2024-06-20",0,0,2,0,0,2,0,0
"Russian Federation","2024-06-21",0,0,2,0,0,2,0,0
"Russian Federation","2024-06-22",0,0,2,0,0,2,0,0
"Russian Federation","2024-06-23",0,0,2,0,0,2,0,0
"Russian Federation","2024-06-24",0,0,2,0,0,2,0,0
"Russian Federation","2024-06-25",0,0,2,0,0,2,0,0
"Russian Federation","2024-06-26",0,0,2,0,0,2,0,0
"Russian Federation","2024-06-27",0,0,2,0,0,2,0,0
"Russian Federation","2024-06-28",0,0,2,0,0,2,0,0
"Russian Federation","2024-06-29",0,0,2,0,0,2,0,0
"Russian Federation","2024-06-30",0,0,2,0,0,2,0,0
"Russian Federation","2024-07-01",0,0,2,0,0,2,0,0
"Russian Federation","2024-07-02",0,0,2,0,0,2,0,0
"Russian Federation","2024-07-03",0,0,2,0,0,2,0,0
"Russian Federation","2024-07-04",0,0,2,0,0,2,0,0
"Russian Federation","2024-07-05",0,0,2,0,0,2,0,0
"Russian Federation","2024-07-06",0,0,2,0,0,2,0,0
"Russian Federation","2024-07-07",0,0,2,0,0,2,0,0
"Russian Federation","2024-07-08",0,0,2,0,0,2,0,0
"Russian Federation","2024-07-09",0,0,2,0,0,2,0,0
"Russian Federation","2024-07-10",0,0,2,0,0,2,0,0
"Russian Federation","2024-07-11",0,0,2,0,0,2,0,0
"Russian Federation","2024-07-12",0,0,2,0,0,2,0,0
"Russian Federation","2024-07-13",0,0,2,0,0,2,0,0
"Russian Federation","2024-07-14",0,0,2,0,0,2,0,0
"Russian Federation","2024-07-15",0,0,2,0,0,2,0,0
"Russian Federation","2024-07-16",0,0,2,0,0,2,0,0
"Russian Federation","2024-07-17",0,0,2,0,0,2,0,0
"Russian Federation","2024-07-18",0,0,2,0,0,2,0,0
"Russian Federation","2024-07-19",0,0,2,0,0,2,0,0
"Russian Federation","2024-07-20",0,0,2,0,0,2,0,0
"Russian Federation","2024-07-21",0,0,2,0,0,2,0,0
"Russian Federation","2024-07-22",0,0,2,0,0,2,0,0
"Russian Federation","2024-07-23",0,0,2,0,0,2,0,0
"Russian Federation","2024-07-24",0,0,2,0,0,2,0,0
"Russian Federation","2024-07-25",0,0,2,0,0,2,0,0
"Russian Federation","2024-07-26",0,0,2,0,0,2,0,0
"Russian Federation","2024-07-27",0,0,2,0,0,2,0,0
"Russian Federation","2024-07-28",0,0,2,0,0,2,0,0
"Russian Federation","2024-07-29",0,0,2,0,0,2,0,0
"Russian Federation","2024-07-30",0,0,2,0,0,2,0,0
"Russian Federation","2024-07-31",0,0,2,0,0,2,0,0
"Russian Federation","2024-08-01",0,0,2,0,0,2,0,0
"Russian Federation","2024-08-02",0,0,2,0,0,2,0,0
"Russian Federation","2024-08-03",0,0,2,0,0,2,0,0
"Russian Federation","2024-08-04",0,0,2,0,0,2,0,0
"Russian Federation","2024-08-05",0,0,2,0,0,2,0,0
"Russian Federation","2024-08-06",0,0,2,0,0,2,0,0
"Russian Federation","2024-08-07",0,0,2,0,0,2,0,0
"Russian Federation","2024-08-08",0,0,2,0,0,2,0,0
"Russian Federation","2024-08-09",0,0,2,0,0,2,0,0
"Russian Federation","2024-08-10",0,0,2,0,0,2,0,0
"Russian Federation","2024-08-11",0,0,2,0,0,2,0,0
"Russian Federation","2024-08-12",0,0,2,0,0,2,0,0
"Russian Federation","2024-08-13",0,0,2,0,0,2,0,0
"Russian Federation","2024-08-14",0,0,2,0,0,2,0,0
"Russian Federation","2024-08-15",0,0,2,0,0,2,0,0
"Russian Federation","2024-08-16",0,0,2,0,0,2,0,0
"Russian Federation","2024-08-17",0,0,2,0,0,2,0,0
"Russian Federation","2024-08-18",0,0,2,0,0,2,0,0
"Russian Federation","2024-08-19",0,0,2,0,0,2,0,0
"Russian Federation","2024-08-20",0,0,2,0,0,2,0,0
"Russian Federation","2024-08-21",0,0,2,0,0,2,0,0
"Russian Federation","2024-08-22",0,0,2,0,0,2,0,0
"Russian Federation","2024-08-23",0,0,2,0,0,2,0,0
"Russian Federation","2024-08-24",0,0,2,0,0,2,0,0
"Russian Federation","2024-08-25",0,0,2,0,0,2,0,0
"Russian Federation","2024-08-26",0,0,2,0,0,2,0,0
"Russian Federation","2024-08-27",0,0,2,0,0,2,0,0
"Russian Federation","2024-08-28",0,0,2,0,0,2,0,0
"Russian Federation","2024-08-29",0,0,2,0,0,2,0,0
"Russian Federation","2024-08-30",0,0,2,0,0,2,0,0
"Russian Federation","2024-08-31",0,0,2,0,0,2,0,0
"Russian Federation","2024-09-01",0,0,2,0,0,2,0,0
"Russian Federation","2024-09-02",0,0,2,0,0,2,0,0
"Russian Federation","2024-09-03",0,0,2,0,0,2,0,0
"Russian Federation","2024-09-04",0,0,2,0,0,2,0,0
"Russian Federation","2024-09-05",0,0,2,0,0,2,0,0
"Russian Federation","2024-09-06",0,0,2,0,0,2,0,0
"Russian Federation","2024-09-07",0,0,2,0,0,2,0,0
"Russian Federation","2024-09-08",0,0,2,0,0,2,0,0
"Russian Federation","2024-09-09",0,0,2,0,0,2,0,0
"Russian Federation","2024-09-10",0,0,2,0,0,2,0,0
"Russian Federation","2024-09-11",0,0,2,0,0,2,0,0
"Russian Federation","2024-09-12",0,0,2,0,0,2,0,0
"Russian Federation","2024-09-13",0,0,2,0,0,2,0,0
"Russian Federation","2024-09-14",0,0,2,0,0,2,0,0
"Russian Federation","2024-09-15",0,0,2,0,0,2,0,0
"Russian Federation","2024-09-16",0,0,2,0,0,2,0,0
"Russian Federation","2024-09-17",0,0,2,0,0,2,0,0
"Russian Federation","2024-09-18",0,0,2,0,0,2,0,0
"Russian Federation","2024-09-19",0,0,2,0,0,2,0,0
"Russian Federation","2024-09-20",0,0,2,0,0,2,0,0
"Russian Federation","2024-09-21",0,0,2,0,0,2,0,0
"Russian Federation","2024-09-22",0,0,2,0,0,2,0,0
"Russian Federation","2024-09-23",0,0,2,0,0,2,0,0
"Russian Federation","2024-09-24",0,0,2,0,0,2,0,0
"Russian Federation","2024-09-25",0,0,2,0,0,2,0,0
"Russian Federation","2024-09-26",0,0,2,0,0,2,0,0
"Russian Federation","2024-09-27",0,0,2,0,0,2,0,0
"Russian Federation","2024-09-28",0,0,2,0,0,2,0,0
"Russian Federation","2024-09-29",0,0,2,0,0,2,0,0
"Russian Federation","2024-09-30",0,0,2,0,0,2,0,0
"Russian Federation","2024-10-01",0,0,2,0,0,2,0,0
"Russian Federation","2024-10-02",0,0,2,0,0,2,0,0
"Russian Federation","2024-10-03",0,0,2,0,0,2,0,0
"Russian Federation","2024-10-04",0,0,2,0,0,2,0,0
"Russian Federation","2024-10-05",0,0,2,0,0,2,0,0
"Russian Federation","2024-10-06",0,0,2,0,0,2,0,0
"Russian Federation","2024-10-07",0,0,2,0,0,2,0,0
"Russian Federation","2024-10-08",0,0,2,0,0,2,0,0
"Russian Federation","2024-10-09",0,0,2,0,0,2,0,0
"Russian Federation","2024-10-10",0,0,2,0,0,2,0,0
"Russian Federation","2024-10-11",0,0,2,0,0,2,0,0
"Russian Federation","2024-10-12",0,0,2,0,0,2,0,0
"Russian Federation","2024-10-13",0,0,2,0,0,2,0,0
"Russian Federation","2024-10-14",0,0,2,0,0,2,0,0
"Russian Federation","2024-10-15",0,0,2,0,0,2,0,0
"Russian Federation","2024-10-16",0,0,2,0,0,2,0,0
"Russian Federation","2024-10-17",0,0,2,0,0,2,0,0
"Russian Federation","2024-10-18",0,0,2,0,0,2,0,0
"Russian Federation","2024-10-19",0,0,2,0,0,2,0,0
"Russian Federation","2024-10-20",0,0,2,0,0,2,0,0
"Russian Federation","2024-10-21",0,0,2,0,0,2,0,0
"Russian Federation","2024-10-22",0,0,2,0,0,2,0,0
"Russian Federation","2024-10-23",0,0,2,0,0,2,0,0
"Russian Federation","2024-10-24",0,0,2,0,0,2,0,0
"Russian Federation","2024-10-25",0,0,2,0,0,2,0,0
"Russian Federation","2024-10-26",0,0,2,0,0,2,0,0
"Russian Federation","2024-10-27",0,0,2,0,0,2,0,0
"Russian Federation","2024-10-28",0,0,2,0,0,2,0,0
"Russian Federation","2024-10-29",0,0,2,0,0,2,0,0
"Russian Federation","2024-10-30",0,0,2,0,0,2,0,0
"Russian Federation","2024-10-31",0,0,2,0,0,2,0,0
"Russian Federation","2024-11-01",0,0,2,0,0,2,0,0
"Russian Federation","2024-11-02",0,0,2,0,0,2,0,0
"Russian Federation","2024-11-03",0,0,2,0,0,2,0,0
"Russian Federation","2024-11-04",0,0,2,0,0,2,0,0
"Russian Federation","2024-11-05",0,0,2,0,0,2,0,0
"Russian Federation","2024-11-06",0,0,2,0,0,2,0,0
"Russian Federation","2024-11-07",0,0,2,0,0,2,0,0
"Russian Federation","2024-11-08",0,0,2,0,0,2,0,0
"Russian Federation","2024-11-09",0,0,2,0,0,2,0,0
"Russian Federation","2024-11-10",0,0,2,0,0,2,0,0
"Russian Federation","2024-11-11",0,0,2,0,0,2,0,0
"Russian Federation","2024-11-12",0,0,2,0,0,2,0,0
"Russian Federation","2024-11-13",0,0,2,0,0,2,0,0
"Russian Federation","2024-11-14",0,0,2,0,0,2,0,0
"Russian Federation","2024-11-15",0,0,2,0,0,2,0,0
"Russian Federation","2024-11-16",0,0,2,0,0,2,0,0
"Russian Federation","2024-11-17",0,0,2,0,0,2,0,0
"Russian Federation","2024-11-18",0,0,2,0,0,2,0,0
"Russian Federation","2024-11-19",0,0,2,0,0,2,0,0
"Russian Federation","2024-11-20",0,0,2,0,0,2,0,0
"Russian Federation","2024-11-21",0,0,2,0,0,2,0,0
"Russian Federation","2024-11-22",0,0,2,0,0,2,0,0
"Russian Federation","2024-11-23",0,0,2,0,0,2,0,0
"Russian Federation","2024-11-24",0,0,2,0,0,2,0,0
"Russian Federation","2024-11-25",0,0,2,0,0,2,0,0
"Russian Federation","2024-11-26",0,0,2,0,0,2,0,0
"Russian Federation","2024-11-27",0,0,2,0,0,2,0,0
"Russian Federation","2024-11-28",0,0,2,0,0,2,0,0
"Russian Federation","2024-11-29",0,0,2,0,0,2,0,0
"Russian Federation","2024-11-30",0,0,2,0,0,2,0,0
"Russian Federation","2024-12-01",0,0,2,0,0,2,0,0
"Russian Federation","2024-12-02",0,0,2,0,0,2,0,0
"Russian Federation","2024-12-03",0,0,2,0,0,2,0,0
"Russian Federation","2024-12-04",0,0,2,0,0,2,0,0
"Russian Federation","2024-12-05",0,0,2,0,0,2,0,0
"Russian Federation","2024-12-06",0,0,2,0,0,2,0,0
"Russian Federation","2024-12-07",0,0,2,0,0,2,0,0
"Russian Federation","2024-12-08",0,0,2,0,0,2,0,0
"Russian Federation","2024-12-09",0,0,2,0,0,2,0,0
"Russian Federation","2024-12-10",0,0,2,0,0,2,0,0
"Russian Federation","2024-12-11",0,0,2,0,0,2,0,0
"Russian Federation","2024-12-12",0,0,2,0,0,2,0,0
"Russian Federation","2024-12-13",0,0,2,0,0,2,0,0
"Russian Federation","2024-12-14",0,0,2,0,0,2,0,0
"Russian Federation","2024-12-15",0,0,2,0,0,2,0,0
"Russian Federation","2024-12-16",0,0,2,0,0,2,0,0
"Russian Federation","2024-12-17",0,0,2,0,0,2,0,0
"Russian Federation","2024-12-18",0,0,2,0,0,2,0,0
"Russian Federation","2024-12-19",0,0,2,0,0,2,0,0
"Russian Federation","2024-12-20",0,0,2,0,0,2,0,0
"Russian Federation","2024-12-21",0,0,2,0,0,2,0,0
"Russian Federation","2024-12-22",0,0,2,0,0,2,0,0
"Russian Federation","2024-12-23",0,0,2,0,0,2,0,0
"Russian Federation","2024-12-24",0,0,2,0,0,2,0,0
"Russian Federation","2024-12-25",0,0,2,0,0,2,0,0
"Russian Federation","2024-12-26",0,0,2,0,0,2,0,0
"Russian Federation","2024-12-27",0,0,2,0,0,2,0,0
"Russian Federation","2024-12-28",0,0,2,0,0,2,0,0
"Russian Federation","2024-12-29",0,0,2,0,0,2,0,0
"Russian Federation","2024-12-30",0,0,2,0,0,2,0,0
"Russian Federation","2024-12-31",0,0,2,0,0,2,0,0
"Russian Federation","2025-01-01",0,0,2,0,0,2,0,0
"Russian Federation","2025-01-02",0,0,2,0,0,2,0,0
"Russian Federation","2025-01-03",0,0,2,0,0,2,0,0
"Russian Federation","2025-01-04",0,0,2,0,0,2,0,0
"Russian Federation","2025-01-05",0,0,2,0,0,2,0,0
"Russian Federation","2025-01-06",0,0,2,0,0,2,0,0
"Russian Federation","2025-01-07",0,0,2,0,0,2,0,0
"Russian Federation","2025-01-08",0,0,2,0,0,2,0,0
"Russian Federation","2025-01-09",0,0,2,0,0,2,0,0
"Russian Federation","2025-01-10",0,0,2,0,0,2,0,0
"Russian Federation","2025-01-11",0,0,2,0,0,2,0,0
"Russian Federation","2025-01-12",0,0,2,0,0,2,0,0
"Russian Federation","2025-01-13",0,0,2,0,0,2,0,0
"Russian Federation","2025-01-14",0,0,2,0,0,2,0,0
"Russian Federation","2025-01-15",0,0,2,0,0,2,0,0
"Russian Federation","2025-01-16",0,0,2,0,0,2,0,0
"Russian Federation","2025-01-17",0,0,2,0,0,2,0,0
"Russian Federation","2025-01-18",0,0,2,0,0,2,0,0
"Russian Federation","2025-01-19",0,0,2,0,0,2,0,0
"Russian Federation","2025-01-20",0,0,2,0,0,2,0,0
"Russian Federation","2025-01-21",0,0,2,0,0,2,0,0
"Russian Federation","2025-01-22",0,0,2,0,0,2,0,0
"Russian Federation","2025-01-23",0,0,2,0,0,2,0,0
"Russian Federation","2025-01-24",0,0,2,0,0,2,0,0
"Russian Federation","2025-01-25",0,0,2,0,0,2,0,0
"Russian Federation","2025-01-26",0,0,2,0,0,2,0,0
"Russian Federation","2025-01-27",0,0,2,0,0,2,0,0
"Russian Federation","2025-01-28",0,0,2,0,0,2,0,0
"Russian Federation","2025-01-29",0,0,2,0,0,2,0,0
"Russian Federation","2025-01-30",0,0,2,0,0,2,0,0
"Russian Federation","2025-01-31",0,0,2,0,0,2,0,0
"Russian Federation","2025-02-01",0,0,2,0,0,2,0,0
"Russian Federation","2025-02-02",0,0,2,0,0,2,0,0
"Russian Federation","2025-02-03",0,0,2,0,0,2,0,0
"Russian Federation","2025-02-04",0,0,2,0,0,2,0,0
"Russian Federation","2025-02-05",0,0,2,0,0,2,0,0
"Russian Federation","2025-02-06",0,0,2,0,0,2,0,0
"Russian Federation","2025-02-07",0,0,2,0,0,2,0,0
"Russian Federation","2025-02-08",0,0,2,0,0,2,0,0
"Russian Federation","2025-02-09",0,0,2,0,0,2,0,0
"Russian Federation","2025-02-10",0,0,2,0,0,2,0,0
"Russian Federation","2025-02-11",0,0,2,0,0,2,0,0
"Russian Federation","2025-02-12",0,0,2,0,0,2,0,0
"Russian Federation","2025-02-13",0,0,2,0,0,2,0,0
"Russian Federation","2025-02-14",0,0,2,0,0,2,0,0
"Russian Federation","2025-02-15",0,0,2,0,0,2,0,0
"Russian Federation","2025-02-16",0,0,2,0,0,2,0,0
"Russian Federation","2025-02-17",0,0,2,0,0,2,0,0
"Russian Federation","2025-02-18",0,0,2,0,0,2,0,0
"Russian Federation","2025-02-19",0,0,2,0,0,2,0,0
"Russian Federation","2025-02-20",0,0,2,0,0,2,0,0
"Russian Federation","2025-02-21",0,0,2,0,0,2,0,0
"Russian Federation","2025-02-22",0,0,2,0,0,2,0,0
"Russian Federation","2025-02-23",0,0,2,0,0,2,0,0
"Russian Federation","2025-02-24",0,0,2,0,0,2,0,0
"Russian Federation","2025-02-25",0,0,2,0,0,2,0,0
"Russian Federation","2025-02-26",0,0,2,0,0,2,0,0
"Russian Federation","2025-02-27",0,0,2,0,0,2,0,0
"Russian Federation","2025-02-28",0,0,2,0,0,2,0,0
"Russian Federation","2025-03-01",0,0,2,0,0,2,0,0
"Russian Federation","2025-03-02",0,0,2,0,0,2,0,0
"Russian Federation","2025-03-03",0,0,2,0,0,2,0,0
"Rwanda","2024-01-01",0,0,0,0,0,0,0,0
"Rwanda","2024-01-02",0,0,0,0,0,0,0,0
"Rwanda","2024-01-03",0,0,0,0,0,0,0,0
"Rwanda","2024-01-04",0,0,0,0,0,0,0,0
"Rwanda","2024-01-05",0,0,0,0,0,0,0,0
"Rwanda","2024-01-06",0,0,0,0,0,0,0,0
"Rwanda","2024-01-07",0,0,0,0,0,0,0,0
"Rwanda","2024-01-08",0,0,0,0,0,0,0,0
"Rwanda","2024-01-09",0,0,0,0,0,0,0,0
"Rwanda","2024-01-10",0,0,0,0,0,0,0,0
"Rwanda","2024-01-11",0,0,0,0,0,0,0,0
"Rwanda","2024-01-12",0,0,0,0,0,0,0,0
"Rwanda","2024-01-13",0,0,0,0,0,0,0,0
"Rwanda","2024-01-14",0,0,0,0,0,0,0,0
"Rwanda","2024-01-15",0,0,0,0,0,0,0,0
"Rwanda","2024-01-16",0,0,0,0,0,0,0,0
"Rwanda","2024-01-17",0,0,0,0,0,0,0,0
"Rwanda","2024-01-18",0,0,0,0,0,0,0,0
"Rwanda","2024-01-19",0,0,0,0,0,0,0,0
"Rwanda","2024-01-20",0,0,0,0,0,0,0,0
"Rwanda","2024-01-21",0,0,0,0,0,0,0,0
"Rwanda","2024-01-22",0,0,0,0,0,0,0,0
"Rwanda","2024-01-23",0,0,0,0,0,0,0,0
"Rwanda","2024-01-24",0,0,0,0,0,0,0,0
"Rwanda","2024-01-25",0,0,0,0,0,0,0,0
"Rwanda","2024-01-26",0,0,0,0,0,0,0,0
"Rwanda","2024-01-27",0,0,0,0,0,0,0,0
"Rwanda","2024-01-28",0,0,0,0,0,0,0,0
"Rwanda","2024-01-29",0,0,0,0,0,0,0,0
"Rwanda","2024-01-30",0,0,0,0,0,0,0,0
"Rwanda","2024-01-31",0,0,0,0,0,0,0,0
"Rwanda","2024-02-01",0,0,0,0,0,0,0,0
"Rwanda","2024-02-02",0,0,0,0,0,0,0,0
"Rwanda","2024-02-03",0,0,0,0,0,0,0,0
"Rwanda","2024-02-04",0,0,0,0,0,0,0,0
"Rwanda","2024-02-05",0,0,0,0,0,0,0,0
"Rwanda","2024-02-06",0,0,0,0,0,0,0,0
"Rwanda","2024-02-07",0,0,0,0,0,0,0,0
"Rwanda","2024-02-08",0,0,0,0,0,0,0,0
"Rwanda","2024-02-09",0,0,0,0,0,0,0,0
"Rwanda","2024-02-10",0,0,0,0,0,0,0,0
"Rwanda","2024-02-11",0,0,0,0,0,0,0,0
"Rwanda","2024-02-12",0,0,0,0,0,0,0,0
"Rwanda","2024-02-13",0,0,0,0,0,0,0,0
"Rwanda","2024-02-14",0,0,0,0,0,0,0,0
"Rwanda","2024-02-15",0,0,0,0,0,0,0,0
"Rwanda","2024-02-16",0,0,0,0,0,0,0,0
"Rwanda","2024-02-17",0,0,0,0,0,0,0,0
"Rwanda","2024-02-18",0,0,0,0,0,0,0,0
"Rwanda","2024-02-19",0,0,0,0,0,0,0,0
"Rwanda","2024-02-20",0,0,0,0,0,0,0,0
"Rwanda","2024-02-21",0,0,0,0,0,0,0,0
"Rwanda","2024-02-22",0,0,0,0,0,0,0,0
"Rwanda","2024-02-23",0,0,0,0,0,0,0,0
"Rwanda","2024-02-24",0,0,0,0,0,0,0,0
"Rwanda","2024-02-25",0,0,0,0,0,0,0,0
"Rwanda","2024-02-26",0,0,0,0,0,0,0,0
"Rwanda","2024-02-27",0,0,0,0,0,0,0,0
"Rwanda","2024-02-28",0,0,0,0,0,0,0,0
"Rwanda","2024-02-29",0,0,0,0,0,0,0,0
"Rwanda","2024-03-01",0,0,0,0,0,0,0,0
"Rwanda","2024-03-02",0,0,0,0,0,0,0,0
"Rwanda","2024-03-03",0,0,0,0,0,0,0,0
"Rwanda","2024-03-04",0,0,0,0,0,0,0,0
"Rwanda","2024-03-05",0,0,0,0,0,0,0,0
"Rwanda","2024-03-06",0,0,0,0,0,0,0,0
"Rwanda","2024-03-07",0,0,0,0,0,0,0,0
"Rwanda","2024-03-08",0,0,0,0,0,0,0,0
"Rwanda","2024-03-09",0,0,0,0,0,0,0,0
"Rwanda","2024-03-10",0,0,0,0,0,0,0,0
"Rwanda","2024-03-11",0,0,0,0,0,0,0,0
"Rwanda","2024-03-12",0,0,0,0,0,0,0,0
"Rwanda","2024-03-13",0,0,0,0,0,0,0,0
"Rwanda","2024-03-14",0,0,0,0,0,0,0,0
"Rwanda","2024-03-15",0,0,0,0,0,0,0,0
"Rwanda","2024-03-16",0,0,0,0,0,0,0,0
"Rwanda","2024-03-17",0,0,0,0,0,0,0,0
"Rwanda","2024-03-18",0,0,0,0,0,0,0,0
"Rwanda","2024-03-19",0,0,0,0,0,0,0,0
"Rwanda","2024-03-20",0,0,0,0,0,0,0,0
"Rwanda","2024-03-21",0,0,0,0,0,0,0,0
"Rwanda","2024-03-22",0,0,0,0,0,0,0,0
"Rwanda","2024-03-23",0,0,0,0,0,0,0,0
"Rwanda","2024-03-24",0,0,0,0,0,0,0,0
"Rwanda","2024-03-25",0,0,0,0,0,0,0,0
"Rwanda","2024-03-26",0,0,0,0,0,0,0,0
"Rwanda","2024-03-27",0,0,0,0,0,0,0,0
"Rwanda","2024-03-28",0,0,0,0,0,0,0,0
"Rwanda","2024-03-29",0,0,0,0,0,0,0,0
"Rwanda","2024-03-30",0,0,0,0,0,0,0,0
"Rwanda","2024-03-31",0,0,0,0,0,0,0,0
"Rwanda","2024-04-01",0,0,0,0,0,0,0,0
"Rwanda","2024-04-02",0,0,0,0,0,0,0,0
"Rwanda","2024-04-03",0,0,0,0,0,0,0,0
"Rwanda","2024-04-04",0,0,0,0,0,0,0,0
"Rwanda","2024-04-05",0,0,0,0,0,0,0,0
"Rwanda","2024-04-06",0,0,0,0,0,0,0,0
"Rwanda","2024-04-07",0,0,0,0,0,0,0,0
"Rwanda","2024-04-08",0,0,0,0,0,0,0,0
"Rwanda","2024-04-09",0,0,0,0,0,0,0,0
"Rwanda","2024-04-10",0,0,0,0,0,0,0,0
"Rwanda","2024-04-11",0,0,0,0,0,0,0,0
"Rwanda","2024-04-12",0,0,0,0,0,0,0,0
"Rwanda","2024-04-13",0,0,0,0,0,0,0,0
"Rwanda","2024-04-14",0,0,0,0,0,0,0,0
"Rwanda","2024-04-15",0,0,0,0,0,0,0,0
"Rwanda","2024-04-16",0,0,0,0,0,0,0,0
"Rwanda","2024-04-17",0,0,0,0,0,0,0,0
"Rwanda","2024-04-18",0,0,0,0,0,0,0,0
"Rwanda","2024-04-19",0,0,0,0,0,0,0,0
"Rwanda","2024-04-20",0,0,0,0,0,0,0,0
"Rwanda","2024-04-21",0,0,0,0,0,0,0,0
"Rwanda","2024-04-22",0,0,0,0,0,0,0,0
"Rwanda","2024-04-23",0,0,0,0,0,0,0,0
"Rwanda","2024-04-24",0,0,0,0,0,0,0,0
"Rwanda","2024-04-25",0,0,0,0,0,0,0,0
"Rwanda","2024-04-26",0,0,0,0,0,0,0,0
"Rwanda","2024-04-27",0,0,0,0,0,0,0,0
"Rwanda","2024-04-28",0,0,0,0,0,0,0,0
"Rwanda","2024-04-29",0,0,0,0,0,0,0,0
"Rwanda","2024-04-30",0,0,0,0,0,0,0,0
"Rwanda","2024-05-01",0,0,0,0,0,0,0,0
"Rwanda","2024-05-02",0,0,0,0,0,0,0,0
"Rwanda","2024-05-03",0,0,0,0,0,0,0,0
"Rwanda","2024-05-04",0,0,0,0,0,0,0,0
"Rwanda","2024-05-05",0,0,0,0,0,0,0,0
"Rwanda","2024-05-06",0,0,0,0,0,0,0,0
"Rwanda","2024-05-07",0,0,0,0,0,0,0,0
"Rwanda","2024-05-08",0,0,0,0,0,0,0,0
"Rwanda","2024-05-09",0,0,0,0,0,0,0,0
"Rwanda","2024-05-10",0,0,0,0,0,0,0,0
"Rwanda","2024-05-11",0,0,0,0,0,0,0,0
"Rwanda","2024-05-12",0,0,0,0,0,0,0,0
"Rwanda","2024-05-13",0,0,0,0,0,0,0,0
"Rwanda","2024-05-14",0,0,0,0,0,0,0,0
"Rwanda","2024-05-15",0,0,0,0,0,0,0,0
"Rwanda","2024-05-16",0,0,0,0,0,0,0,0
"Rwanda","2024-05-17",0,0,0,0,0,0,0,0
"Rwanda","2024-05-18",0,0,0,0,0,0,0,0
"Rwanda","2024-05-19",0,0,0,0,0,0,0,0
"Rwanda","2024-05-20",0,0,0,0,0,0,0,0
"Rwanda","2024-05-21",0,0,0,0,0,0,0,0
"Rwanda","2024-05-22",0,0,0,0,0,0,0,0
"Rwanda","2024-05-23",0,0,0,0,0,0,0,0
"Rwanda","2024-05-24",0,0,0,0,0,0,0,0
"Rwanda","2024-05-25",0,0,0,0,0,0,0,0
"Rwanda","2024-05-26",0,0,0,0,0,0,0,0
"Rwanda","2024-05-27",0,0,0,0,0,0,0,0
"Rwanda","2024-05-28",0,0,0,0,0,0,0,0
"Rwanda","2024-05-29",0,0,0,0,0,0,0,0
"Rwanda","2024-05-30",0,0,0,0,0,0,0,0
"Rwanda","2024-05-31",0,0,0,0,0,0,0,0
"Rwanda","2024-06-01",0,0,0,0,0,0,0,0
"Rwanda","2024-06-02",0,0,0,0,0,0,0,0
"Rwanda","2024-06-03",0,0,0,0,0,0,0,0
"Rwanda","2024-06-04",0,0,0,0,0,0,0,0
"Rwanda","2024-06-05",0,0,0,0,0,0,0,0
"Rwanda","2024-06-06",0,0,0,0,0,0,0,0
"Rwanda","2024-06-07",0,0,0,0,0,0,0,0
"Rwanda","2024-06-08",0,0,0,0,0,0,0,0
"Rwanda","2024-06-09",0,0,0,0,0,0,0,0
"Rwanda","2024-06-10",0,0,0,0,0,0,0,0
"Rwanda","2024-06-11",0,0,0,0,0,0,0,0
"Rwanda","2024-06-12",0,0,0,0,0,0,0,0
"Rwanda","2024-06-13",0,0,0,0,0,0,0,0
"Rwanda","2024-06-14",0,0,0,0,0,0,0,0
"Rwanda","2024-06-15",0,0,0,0,0,0,0,0
"Rwanda","2024-06-16",0,0,0,0,0,0,0,0
"Rwanda","2024-06-17",0,0,0,0,0,0,0,0
"Rwanda","2024-06-18",0,0,0,0,0,0,0,0
"Rwanda","2024-06-19",0,0,0,0,0,0,0,0
"Rwanda","2024-06-20",0,0,0,0,0,0,0,0
"Rwanda","2024-06-21",0,0,0,0,0,0,0,0
"Rwanda","2024-06-22",0,0,0,0,0,0,0,0
"Rwanda","2024-06-23",0,0,0,0,0,0,0,0
"Rwanda","2024-06-24",0,0,0,0,0,0,0,0
"Rwanda","2024-06-25",0,0,0,0,0,0,0,0
"Rwanda","2024-06-26",0,0,0,0,0,0,0,0
"Rwanda","2024-06-27",0,0,0,0,0,0,0,0
"Rwanda","2024-06-28",0,0,0,0,0,0,0,0
"Rwanda","2024-06-29",0,0,0,0,0,0,0,0
"Rwanda","2024-06-30",0,0,0,0,0,0,0,0
"Rwanda","2024-07-01",0,0,0,0,0,0,0,0
"Rwanda","2024-07-02",0,0,0,0,0,0,0,0
"Rwanda","2024-07-03",0,0,0,0,0,0,0,0
"Rwanda","2024-07-04",0,0,0,0,0,0,0,0
"Rwanda","2024-07-05",0,0,0,0,0,0,0,0
"Rwanda","2024-07-06",0,0,0,0,0,0,0,0
"Rwanda","2024-07-07",0,0,0,0,0,0,0,0
"Rwanda","2024-07-08",0,0,0,0,0,0,0,0
"Rwanda","2024-07-09",0,0,0,0,0,0,0,0
"Rwanda","2024-07-10",0,0,0,0,0,0,0,0
"Rwanda","2024-07-11",0,0,0,0,0,0,0,0
"Rwanda","2024-07-12",0,0,0,0,0,0,0,0
"Rwanda","2024-07-13",0,0,0,0,0,0,0,0
"Rwanda","2024-07-14",8,0,0,8,0,0,8,8
"Rwanda","2024-07-15",0,0,0,8,0,0,1,9
"Rwanda","2024-07-16",0,0,0,8,0,0,1,10
"Rwanda","2024-07-17",0,0,0,8,0,0,1,11
"Rwanda","2024-07-18",0,0,0,8,0,0,1,12
"Rwanda","2024-07-19",0,0,0,8,0,0,1,13
"Rwanda","2024-07-20",0,0,0,8,0,0,1,14
"Rwanda","2024-07-21",0,2,2,8,2,2,2,16
"Rwanda","2024-07-22",0,0,2,8,0,2,1,17
"Rwanda","2024-07-23",0,0,2,8,0,2,1,18
"Rwanda","2024-07-24",0,0,2,8,0,2,1,19
"Rwanda","2024-07-25",0,0,2,8,0,2,1,20
"Rwanda","2024-07-26",0,0,2,8,0,2,1,21
"Rwanda","2024-07-27",0,0,2,8,1,3,1,22
"Rwanda","2024-07-28",15,0,2,23,0,3,1,23
"Rwanda","2024-07-29",0,0,2,23,0,3,30,53
"Rwanda","2024-07-30",0,0,2,23,0,3,29,82
"Rwanda","2024-07-31",0,0,2,23,0,3,30,112
"Rwanda","2024-08-01",0,0,2,23,0,3,30,142
"Rwanda","2024-08-02",0,0,2,23,0,3,30,172
"Rwanda","2024-08-03",0,0,2,23,0,3,29,201
"Rwanda","2024-08-04",208,0,2,231,0,3,30,231
"Rwanda","2024-08-05",0,0,2,231,0,3,24,255
"Rwanda","2024-08-06",0,0,2,231,1,4,25,280
"Rwanda","2024-08-07",0,0,2,231,0,4,24,304
"Rwanda","2024-08-08",0,0,2,231,0,4,24,328
"Rwanda","2024-08-09",0,0,2,231,0,4,24,352
"Rwanda","2024-08-10",0,0,2,231,0,4,25,377
"Rwanda","2024-08-11",170,2,4,401,0,4,24,401
"Rwanda","2024-08-12",0,0,4,401,0,4,20,421
"Rwanda","2024-08-13",0,0,4,401,0,4,19,440
"Rwanda","2024-08-14",0,0,4,401,0,4,20,460
"Rwanda","2024-08-15",0,0,4,401,0,4,20,480
"Rwanda","2024-08-16",0,0,4,401,0,4,20,500
"Rwanda","2024-08-17",0,0,4,401,0,4,19,519
"Rwanda","2024-08-18",138,0,4,539,0,4,20,539
"Rwanda","2024-08-19",0,0,4,539,0,4,30,569
"Rwanda","2024-08-20",0,0,4,539,1,5,30,599
"Rwanda","2024-08-21",0,0,4,539,0,5,30,629
"Rwanda","2024-08-22",0,0,4,539,0,5,29,658
"Rwanda","2024-08-23",0,0,4,539,0,5,30,688
"Rwanda","2024-08-24",0,0,4,539,0,5,30,718
"Rwanda","2024-08-25",209,0,4,748,0,5,30,748
"Rwanda","2024-08-26",0,0,4,748,0,5,53,801
"Rwanda","2024-08-27",0,0,4,748,0,5,52,853
"Rwanda","2024-08-28",0,0,4,748,0,5,53,906
"Rwanda","2024-08-29",0,0,4,748,0,5,52,958
"Rwanda","2024-08-30",0,0,4,748,0,5,53,1011
"Rwanda","2024-08-31",0,0,4,748,0,5,52,1063
"Rwanda","2024-09-01",368,0,4,1116,0,5,53,1116
"Rwanda","2024-09-02",0,0,4,1116,0,5,38,1154
"Rwanda","2024-09-03",0,0,4,1116,0,5,37,1191
"Rwanda","2024-09-04",0,0,4,1116,0,5,38,1229
"Rwanda","2024-09-05",0,0,4,1116,0,5,37,1266
"Rwanda","2024-09-06",0,0,4,1116,0,5,38,1304
"Rwanda","2024-09-07",0,0,4,1116,1,6,37,1341
"Rwanda","2024-09-08",263,0,4,1379,0,6,38,1379
"Rwanda","2024-09-09",0,0,4,1379,0,6,51,1430
"Rwanda","2024-09-10",0,0,4,1379,0,6,52,1482
"Rwanda","2024-09-11",0,0,4,1379,0,6,51,1533
"Rwanda","2024-09-12",0,0,4,1379,0,6,52,1585
"Rwanda","2024-09-13",0,0,4,1379,0,6,51,1636
"Rwanda","2024-09-14",0,0,4,1379,0,6,52,1688
"Rwanda","2024-09-15",360,2,6,1739,0,6,51,1739
"Rwanda","2024-09-16",0,0,6,1739,0,6,72,1811
"Rwanda","2024-09-17",0,0,6,1739,0,6,73,1884
"Rwanda","2024-09-18",0,0,6,1739,1,7,72,1956
"Rwanda","2024-09-19",0,0,6,1739,0,7,72,2028
"Rwanda","2024-09-20",0,0,6,1739,0,7,72,2100
"Rwanda","2024-09-21",0,0,6,1739,0,7,73,2173
"Rwanda","2024-09-22",506,0,6,2245,0,7,72,2245
"Rwanda","2024-09-23",0,0,6,2245,1,8,78,2323
"Rwanda","2024-09-24",0,0,6,2245,0,8,77,2400
"Rwanda","2024-09-25",0,0,6,2245,0,8,78,2478
"Rwanda","2024-09-26",0,0,6,2245,0,8,78,2556
"Rwanda","2024-09-27",0,0,6,2245,0,8,78,2634
"Rwanda","2024-09-28",0,0,6,2245,0,8,77,2711
"Rwanda","2024-09-29",544,0,6,2789,1,9,78,2789
"Rwanda","2024-09-30",0,0,6,2789,0,9,1,2790
"Rwanda","2024-10-01",0,0,6,2789,0,9,2,2792
"Rwanda","2024-10-02",0,0,6,2789,0,9,1,2793
"Rwanda","2024-10-03",0,0,6,2789,0,9,1,2794
"Rwanda","2024-10-04",0,0,6,2789,1,10,1,2795
"Rwanda","2024-10-05",0,0,6,2789,0,10,2,2797
"Rwanda","2024-10-06",9,4,10,2798,0,10,1,2798
"Rwanda","2024-10-07",0,0,10,2798,1,11,76,2874
"Rwanda","2024-10-08",0,0,10,2798,0,11,76,2950
"Rwanda","2024-10-09",0,0,10,2798,1,12,76,3026
"Rwanda","2024-10-10",0,0,10,2798,0,12,75,3101
"Rwanda","2024-10-11",0,0,10,2798,1,13,76,3177
"Rwanda","2024-10-12",0,0,10,2798,0,13,76,3253
"Rwanda","2024-10-13",531,4,14,3329,1,14,76,3329
"Rwanda","2024-10-14",0,0,14,3329,1,15,25,3354
"Rwanda","2024-10-15",0,0,14,3329,1,16,26,3380
"Rwanda","2024-10-16",0,0,14,3329,1,17,25,3405
"Rwanda","2024-10-17",0,0,14,3329,2,19,26,3431
"Rwanda","2024-10-18",0,0,14,3329,1,20,25,3456
"Rwanda","2024-10-19",0,0,14,3329,1,21,26,3482
"Rwanda","2024-10-20",178,8,22,3507,1,22,25,3507
"Rwanda","2024-10-21",0,0,22,3507,1,23,27,3534
"Rwanda","2024-10-22",0,0,22,3507,0,23,27,3561
"Rwanda","2024-10-23",0,0,22,3507,1,24,27,3588
"Rwanda","2024-10-24",0,0,22,3507,0,24,28,3616
"Rwanda","2024-10-25",0,0,22,3507,1,25,27,3643
"Rwanda","2024-10-26",0,0,22,3507,0,25,27,3670
"Rwanda","2024-10-27",190,4,26,3697,1,26,27,3697
"Rwanda","2024-10-28",0,0,26,3697,1,27,33,3730
"Rwanda","2024-10-29",0,0,26,3697,1,28,32,3762
"Rwanda","2024-10-30",0,0,26,3697,0,28,33,3795
"Rwanda","2024-10-31",0,0,26,3697,1,29,32,3827
"Rwanda","2024-11-01",0,0,26,3697,1,30,33,3860
"Rwanda","2024-11-02",0,0,26,3697,1,31,32,3892
"Rwanda","2024-11-03",228,0,26,3925,1,32,33,3925
"Rwanda","2024-11-04",0,0,26,3925,0,32,22,3947
"Rwanda","2024-11-05",0,0,26,3925,1,33,22,3969
"Rwanda","2024-11-06",0,0,26,3925,1,34,22,3991
"Rwanda","2024-11-07",0,0,26,3925,1,35,21,4012
"Rwanda","2024-11-08",0,0,26,3925,0,35,22,4034
"Rwanda","2024-11-09",0,0,26,3925,1,36,22,4056
"Rwanda","2024-11-10",153,11,37,4078,1,37,22,4078
"Rwanda","2024-11-11",0,0,37,4078,2,39,0,4078
"Rwanda","2024-11-12",0,0,37,4078,2,41,0,4078
"Rwanda","2024-11-13",0,0,37,4078,2,43,0,4078
"Rwanda","2024-11-14",0,0,37,4078,3,46,0,4078
"Rwanda","2024-11-15",0,0,37,4078,2,48,0,4078
"Rwanda","2024-11-16",0,0,37,4078,2,50,0,4078
"Rwanda","2024-11-17",0,15,52,4078,2,52,0,4078
"Rwanda","2024-11-18",0,0,52,4078,1,53,0,4078
"Rwanda","2024-11-19",0,0,52,4078,0,53,0,4078
"Rwanda","2024-11-20",0,0,52,4078,1,54,0,4078
"Rwanda","2024-11-21",0,0,52,4078,0,54,0,4078
"Rwanda","2024-11-22",0,0,52,4078,1,55,0,4078
"Rwanda","2024-11-23",0,0,52,4078,0,55,0,4078
"Rwanda","2024-11-24",0,0,52,4078,1,56,0,4078
"Rwanda","2024-11-25",0,0,52,4078,0,56,0,4078
"Rwanda","2024-11-26",0,0,52,4078,1,57,0,4078
"Rwanda","2024-11-27",0,0,52,4078,0,57,0,4078
"Rwanda","2024-11-28",0,0,52,4078,1,58,0,4078
"Rwanda","2024-11-29",0,0,52,4078,0,58,0,4078
"Rwanda","2024-11-30",0,7,59,4078,1,59,0,4078
"Rwanda","2024-12-01",0,0,59,4078,1,60,0,4078
"Rwanda","2024-12-02",0,0,59,4078,1,61,0,4078
"Rwanda","2024-12-03",0,0,59,4078,2,63,0,4078
"Rwanda","2024-12-04",0,0,59,4078,1,64,0,4078
"Rwanda","2024-12-05",0,0,59,4078,1,65,0,4078
"Rwanda","2024-12-06",0,0,59,4078,2,67,0,4078
"Rwanda","2024-12-07",0,0,59,4078,1,68,0,4078
"Rwanda","2024-12-08",0,10,69,4078,1,69,0,4078
"Rwanda","2024-12-09",0,0,69,4078,1,70,0,4078
"Rwanda","2024-12-10",0,0,69,4078,0,70,0,4078
"Rwanda","2024-12-11",0,0,69,4078,1,71,0,4078
"Rwanda","2024-12-12",0,0,69,4078,1,72,0,4078
"Rwanda","2024-12-13",0,0,69,4078,1,73,0,4078
"Rwanda","2024-12-14",0,0,69,4078,0,73,0,4078
"Rwanda","2024-12-15",0,5,74,4078,1,74,0,4078
"Rwanda","2024-12-16",0,0,74,4078,1,75,0,4078
"Rwanda","2024-12-17",0,0,74,4078,0,75,0,4078
"Rwanda","2024-12-18",0,0,74,4078,1,76,0,4078
"Rwanda","2024-12-19",0,0,74,4078,0,76,0,4078
"Rwanda","2024-12-20",0,0,74,4078,1,77,0,4078
"Rwanda","2024-12-21",0,0,74,4078,0,77,0,4078
"Rwanda","2024-12-22",0,4,78,4078,1,78,0,4078
"Rwanda","2024-12-23",0,0,78,4078,1,79,0,4078
"Rwanda","2024-12-24",0,0,78,4078,0,79,0,4078
"Rwanda","2024-12-25",0,0,78,4078,1,80,0,4078
"Rwanda","2024-12-26",0,0,78,4078,0,80,0,4078
"Rwanda","2024-12-27",0,0,78,4078,1,81,0,4078
"Rwanda","2024-12-28",0,0,78,4078,0,81,0,4078
"Rwanda","2024-12-29",0,4,82,4078,1,82,0,4078
"Rwanda","2024-12-30",0,0,82,4078,1,83,0,4078
"Rwanda","2024-12-31",0,0,82,4078,0,83,0,4078
"Rwanda","2025-01-01",0,0,82,4078,1,84,0,4078
"Rwanda","2025-01-02",0,0,82,4078,1,85,0,4078
"Rwanda","2025-01-03",0,0,82,4078,1,86,0,4078
"Rwanda","2025-01-04",0,0,82,4078,0,86,0,4078
"Rwanda","2025-01-05",0,5,87,4078,1,87,0,4078
"Rwanda","2025-01-06",0,0,87,4078,0,87,0,4078
"Rwanda","2025-01-07",0,0,87,4078,1,88,0,4078
"Rwanda","2025-01-08",0,0,87,4078,0,88,0,4078
"Rwanda","2025-01-09",0,0,87,4078,1,89,0,4078
"Rwanda","2025-01-10",0,0,87,4078,0,89,0,4078
"Rwanda","2025-01-11",0,0,87,4078,1,90,0,4078
"Rwanda","2025-01-12",0,3,90,4078,0,90,0,4078
"Rwanda","2025-01-13",0,0,90,4078,1,91,0,4078
"Rwanda","2025-01-14",0,0,90,4078,0,91,0,4078
"Rwanda","2025-01-15",0,0,90,4078,1,92,0,4078
"Rwanda","2025-01-16",0,0,90,4078,0,92,0,4078
"Rwanda","2025-01-17",0,0,90,4078,1,93,0,4078
"Rwanda","2025-01-18",0,0,90,4078,0,93,0,4078
"Rwanda","2025-01-19",0,4,94,4078,1,94,0,4078
"Rwanda","2025-01-20",0,0,94,4078,1,95,0,4078
"Rwanda","2025-01-21",0,0,94,4078,0,95,0,4078
"Rwanda","2025-01-22",0,0,94,4078,1,96,0,4078
"Rwanda","2025-01-23",0,0,94,4078,1,97,0,4078
"Rwanda","2025-01-24",0,0,94,4078,1,98,0,4078
"Rwanda","2025-01-25",0,0,94,4078,0,98,0,4078
"Rwanda","2025-01-26",0,5,99,4078,1,99,0,4078
"Rwanda","2025-01-27",0,0,99,4078,0,99,0,4078
"Rwanda","2025-01-28",0,0,99,4078,1,100,0,4078
"Rwanda","2025-01-29",0,0,99,4078,0,100,0,4078
"Rwanda","2025-01-30",0,0,99,4078,1,101,0,4078
"Rwanda","2025-01-31",0,0,99,4078,0,101,0,4078
"Rwanda","2025-02-01",0,0,99,4078,1,102,0,4078
"Rwanda","2025-02-02",0,3,102,4078,0,102,0,4078
"Rwanda","2025-02-03",0,0,102,4078,0,102,0,4078
"Rwanda","2025-02-04",0,0,102,4078,0,102,0,4078
"Rwanda","2025-02-05",0,0,102,4078,0,102,0,4078
"Rwanda","2025-02-06",0,0,102,4078,0,102,0,4078
"Rwanda","2025-02-07",0,0,102,4078,0,102,0,4078
"Rwanda","2025-02-08",0,0,102,4078,0,102,0,4078
"Rwanda","2025-02-09",0,0,102,4078,0,102,0,4078
"Rwanda","2025-02-10",0,0,102,4078,0,102,0,4078
"Rwanda","2025-02-11",0,0,102,4078,0,102,0,4078
"Rwanda","2025-02-12",0,0,102,4078,0,102,0,4078
"Rwanda","2025-02-13",0,0,102,4078,0,102,0,4078
"Rwanda","2025-02-14",0,0,102,4078,0,102,0,4078
"Rwanda","2025-02-15",0,0,102,4078,0,102,0,4078
"Rwanda","2025-02-16",0,0,102,4078,0,102,0,4078
"Rwanda","2025-02-17",0,0,102,4078,0,102,0,4078
"Rwanda","2025-02-18",0,0,102,4078,0,102,0,4078
"Rwanda","2025-02-19",0,0,102,4078,0,102,0,4078
"Rwanda","2025-02-20",0,0,102,4078,0,102,0,4078
"Rwanda","2025-02-21",0,0,102,4078,0,102,0,4078
"Rwanda","2025-02-22",0,0,102,4078,0,102,0,4078
"Rwanda","2025-02-23",0,0,102,4078,0,102,0,4078
"Rwanda","2025-02-24",0,0,102,4078,0,102,0,4078
"Rwanda","2025-02-25",0,0,102,4078,0,102,0,4078
"Rwanda","2025-02-26",0,0,102,4078,0,102,0,4078
"Rwanda","2025-02-27",0,0,102,4078,0,102,0,4078
"Rwanda","2025-02-28",0,0,102,4078,0,102,0,4078
"Rwanda","2025-03-01",0,0,102,4078,0,102,0,4078
"Rwanda","2025-03-02",0,0,102,4078,0,102,0,4078
"Rwanda","2025-03-03",0,0,102,4078,0,102,0,4078
"Saint Martin (French Part)","2024-01-01",0,0,0,0,0,0,0,0
"Saint Martin (French Part)","2024-01-02",0,0,0,0,0,0,0,0
"Saint Martin (French Part)","2024-01-03",0,0,0,0,0,0,0,0
"Saint Martin (French Part)","2024-01-04",0,0,0,0,0,0,0,0
"Saint Martin (French Part)","2024-01-05",0,0,0,0,0,0,0,0
"Saint Martin (French Part)","2024-01-06",0,0,0,0,0,0,0,0
"Saint Martin (French Part)","2024-01-07",0,0,0,0,0,0,0,0
"Saint Martin (French Part)","2024-01-08",0,0,0,0,0,0,0,0
"Saint Martin (French Part)","2024-01-09",0,0,0,0,0,0,0,0
"Saint Martin (French Part)","2024-01-10",0,0,0,0,0,0,0,0
"Saint Martin (French Part)","2024-01-11",0,0,0,0,0,0,0,0
"Saint Martin (French Part)","2024-01-12",0,0,0,0,0,0,0,0
"Saint Martin (French Part)","2024-01-13",0,0,0,0,0,0,0,0
"Saint Martin (French Part)","2024-01-14",0,0,0,0,0,0,0,0
"Saint Martin (French Part)","2024-01-15",0,0,0,0,0,0,0,0
"Saint Martin (French Part)","2024-01-16",0,0,0,0,0,0,0,0
"Saint Martin (French Part)","2024-01-17",0,0,0,0,0,0,0,0
"Saint Martin (French Part)","2024-01-18",0,0,0,0,0,0,0,0
"Saint Martin (French Part)","2024-01-19",0,0,0,0,0,0,0,0
"Saint Martin (French Part)","2024-01-20",0,0,0,0,0,0,0,0
"Saint Martin (French Part)","2024-01-21",0,0,0,0,0,0,0,0
"Saint Martin (French Part)","2024-01-22",0,0,0,0,0,0,0,0
"Saint Martin (French Part)","2024-01-23",0,0,0,0,0,0,0,0
"Saint Martin (French Part)","2024-01-24",0,0,0,0,0,0,0,0
"Saint Martin (French Part)","2024-01-25",0,0,0,0,0,0,0,0
"Saint Martin (French Part)","2024-01-26",0,0,0,0,0,0,0,0
"Saint Martin (French Part)","2024-01-27",0,0,0,0,0,0,0,0
"Saint Martin (French Part)","2024-01-28",0,0,0,0,0,0,0,0
"Saint Martin (French Part)","2024-01-29",0,0,0,0,0,0,0,0
"Saint Martin (French Part)","2024-01-30",0,0,0,0,0,0,0,0
"Saint Martin (French Part)","2024-01-31",0,0,0,0,0,0,0,0
"Saint Martin (French Part)","2024-02-01",0,0,0,0,0,0,0,0
"Saint Martin (French Part)","2024-02-02",0,0,0,0,0,0,0,0
"Saint Martin (French Part)","2024-02-03",0,0,0,0,0,0,0,0
"Saint Martin (French Part)","2024-02-04",0,0,0,0,0,0,0,0
"Saint Martin (French Part)","2024-02-05",0,0,0,0,0,0,0,0
"Saint Martin (French Part)","2024-02-06",0,0,0,0,0,0,0,0
"Saint Martin (French Part)","2024-02-07",0,0,0,0,0,0,0,0
"Saint Martin (French Part)","2024-02-08",0,0,0,0,0,0,0,0
"Saint Martin (French Part)","2024-02-09",0,0,0,0,0,0,0,0
"Saint Martin (French Part)","2024-02-10",0,0,0,0,0,0,0,0
"Saint Martin (French Part)","2024-02-11",0,0,0,0,0,0,0,0
"Saint Martin (French Part)","2024-02-12",0,0,0,0,0,0,0,0
"Saint Martin (French Part)","2024-02-13",0,0,0,0,0,0,0,0
"Saint Martin (French Part)","2024-02-14",0,0,0,0,0,0,0,0
"Saint Martin (French Part)","2024-02-15",0,0,0,0,0,0,0,0
"Saint Martin (French Part)","2024-02-16",0,0,0,0,0,0,0,0
"Saint Martin (French Part)","2024-02-17",0,0,0,0,0,0,0,0
"Saint Martin (French Part)","2024-02-18",0,0,0,0,0,0,0,0
"Saint Martin (French Part)","2024-02-19",0,0,0,0,0,0,0,0
"Saint Martin (French Part)","2024-02-20",0,0,0,0,0,0,0,0
"Saint Martin (French Part)","2024-02-21",0,0,0,0,0,0,0,0
"Saint Martin (French Part)","2024-02-22",0,0,0,0,0,0,0,0
"Saint Martin (French Part)","2024-02-23",0,0,0,0,0,0,0,0
"Saint Martin (French Part)","2024-02-24",0,0,0,0,0,0,0,0
"Saint Martin (French Part)","2024-02-25",0,0,0,0,0,0,0,0
"Saint Martin (French Part)","2024-02-26",0,0,0,0,0,0,0,0
"Saint Martin (French Part)","2024-02-27",0,0,0,0,0,0,0,0
"Saint Martin (French Part)","2024-02-28",0,0,0,0,0,0,0,0
"Saint Martin (French Part)","2024-02-29",0,0,0,0,0,0,0,0
"Saint Martin (French Part)","2024-03-01",0,0,0,0,0,0,0,0
"Saint Martin (French Part)","2024-03-02",0,0,0,0,0,0,0,0
"Saint Martin (French Part)","2024-03-03",0,0,0,0,0,0,0,0
"Saint Martin (French Part)","2024-03-04",0,0,0,0,0,0,0,0
"Saint Martin (French Part)","2024-03-05",0,0,0,0,0,0,0,0
"Saint Martin (French Part)","2024-03-06",0,0,0,0,0,0,0,0
"Saint Martin (French Part)","2024-03-07",0,0,0,0,0,0,0,0
"Saint Martin (French Part)","2024-03-08",0,0,0,0,0,0,0,0
"Saint Martin (French Part)","2024-03-09",0,0,0,0,0,0,0,0
"Saint Martin (French Part)","2024-03-10",0,0,0,0,0,0,0,0
"Saint Martin (French Part)","2024-03-11",0,0,0,0,0,0,0,0
"Saint Martin (French Part)","2024-03-12",0,0,0,0,0,0,0,0
"Saint Martin (French Part)","2024-03-13",0,0,0,0,0,0,0,0
"Saint Martin (French Part)","2024-03-14",0,0,0,0,0,0,0,0
"Saint Martin (French Part)","2024-03-15",0,0,0,0,0,0,0,0
"Saint Martin (French Part)","2024-03-16",0,0,0,0,0,0,0,0
"Saint Martin (French Part)","2024-03-17",0,0,0,0,0,0,0,0
"Saint Martin (French Part)","2024-03-18",0,0,0,0,0,0,0,0
"Saint Martin (French Part)","2024-03-19",0,0,0,0,0,0,0,0
"Saint Martin (French Part)","2024-03-20",0,0,0,0,0,0,0,0
"Saint Martin (French Part)","2024-03-21",0,0,0,0,0,0,0,0
"Saint Martin (French Part)","2024-03-22",0,0,0,0,0,0,0,0
"Saint Martin (French Part)","2024-03-23",0,0,0,0,0,0,0,0
"Saint Martin (French Part)","2024-03-24",0,0,0,0,0,0,0,0
"Saint Martin (French Part)","2024-03-25",0,0,0,0,0,0,0,0
"Saint Martin (French Part)","2024-03-26",0,0,0,0,0,0,0,0
"Saint Martin (French Part)","2024-03-27",0,0,0,0,0,0,0,0
"Saint Martin (French Part)","2024-03-28",0,0,0,0,0,0,0,0
"Saint Martin (French Part)","2024-03-29",0,0,0,0,0,0,0,0
"Saint Martin (French Part)","2024-03-30",0,0,0,0,0,0,0,0
"Saint Martin (French Part)","2024-03-31",0,0,0,0,0,0,0,0
"Saint Martin (French Part)","2024-04-01",0,0,0,0,0,0,0,0
"Saint Martin (French Part)","2024-04-02",0,0,0,0,0,0,0,0
"Saint Martin (French Part)","2024-04-03",0,0,0,0,0,0,0,0
"Saint Martin (French Part)","2024-04-04",0,0,0,0,0,0,0,0
"Saint Martin (French Part)","2024-04-05",0,0,0,0,0,0,0,0
"Saint Martin (French Part)","2024-04-06",0,0,0,0,0,0,0,0
"Saint Martin (French Part)","2024-04-07",0,0,0,0,0,0,0,0
"Saint Martin (French Part)","2024-04-08",0,0,0,0,0,0,0,0
"Saint Martin (French Part)","2024-04-09",0,0,0,0,0,0,0,0
"Saint Martin (French Part)","2024-04-10",0,0,0,0,0,0,0,0
"Saint Martin (French Part)","2024-04-11",0,0,0,0,0,0,0,0
"Saint Martin (French Part)","2024-04-12",0,0,0,0,0,0,0,0
"Saint Martin (French Part)","2024-04-13",0,0,0,0,0,0,0,0
"Saint Martin (French Part)","2024-04-14",0,0,0,0,0,0,0,0
"Saint Martin (French Part)","2024-04-15",0,0,0,0,0,0,0,0
"Saint Martin (French Part)","2024-04-16",0,0,0,0,0,0,0,0
"Saint Martin (French Part)","2024-04-17",0,0,0,0,0,0,0,0
"Saint Martin (French Part)","2024-04-18",0,0,0,0,0,0,0,0
"Saint Martin (French Part)","2024-04-19",0,0,0,0,0,0,0,0
"Saint Martin (French Part)","2024-04-20",0,0,0,0,0,0,0,0
"Saint Martin (French Part)","2024-04-21",0,0,0,0,0,0,0,0
"Saint Martin (French Part)","2024-04-22",0,0,0,0,0,0,0,0
"Saint Martin (French Part)","2024-04-23",0,0,0,0,0,0,0,0
"Saint Martin (French Part)","2024-04-24",0,0,0,0,0,0,0,0
"Saint Martin (French Part)","2024-04-25",0,0,0,0,0,0,0,0
"Saint Martin (French Part)","2024-04-26",0,0,0,0,0,0,0,0
"Saint Martin (French Part)","2024-04-27",0,0,0,0,0,0,0,0
"Saint Martin (French Part)","2024-04-28",0,0,0,0,0,0,0,0
"Saint Martin (French Part)","2024-04-29",0,0,0,0,0,0,0,0
"Saint Martin (French Part)","2024-04-30",0,0,0,0,0,0,0,0
"Saint Martin (French Part)","2024-05-01",0,0,0,0,0,0,0,0
"Saint Martin (French Part)","2024-05-02",0,0,0,0,0,0,0,0
"Saint Martin (French Part)","2024-05-03",0,0,0,0,0,0,0,0
"Saint Martin (French Part)","2024-05-04",0,0,0,0,0,0,0,0
"Saint Martin (French Part)","2024-05-05",0,0,0,0,0,0,0,0
"Saint Martin (French Part)","2024-05-06",0,0,0,0,0,0,0,0
"Saint Martin (French Part)","2024-05-07",0,0,0,0,0,0,0,0
"Saint Martin (French Part)","2024-05-08",0,0,0,0,0,0,0,0
"Saint Martin (French Part)","2024-05-09",0,0,0,0,0,0,0,0
"Saint Martin (French Part)","2024-05-10",0,0,0,0,0,0,0,0
"Saint Martin (French Part)","2024-05-11",0,0,0,0,0,0,0,0
"Saint Martin (French Part)","2024-05-12",0,0,0,0,0,0,0,0
"Saint Martin (French Part)","2024-05-13",0,0,0,0,0,0,0,0
"Saint Martin (French Part)","2024-05-14",0,0,0,0,0,0,0,0
"Saint Martin (French Part)","2024-05-15",0,0,0,0,0,0,0,0
"Saint Martin (French Part)","2024-05-16",0,0,0,0,0,0,0,0
"Saint Martin (French Part)","2024-05-17",0,0,0,0,0,0,0,0
"Saint Martin (French Part)","2024-05-18",0,0,0,0,0,0,0,0
"Saint Martin (French Part)","2024-05-19",0,0,0,0,0,0,0,0
"Saint Martin (French Part)","2024-05-20",0,0,0,0,0,0,0,0
"Saint Martin (French Part)","2024-05-21",0,0,0,0,0,0,0,0
"Saint Martin (French Part)","2024-05-22",0,0,0,0,0,0,0,0
"Saint Martin (French Part)","2024-05-23",0,0,0,0,0,0,0,0
"Saint Martin (French Part)","2024-05-24",0,0,0,0,0,0,0,0
"Saint Martin (French Part)","2024-05-25",0,0,0,0,0,0,0,0
"Saint Martin (French Part)","2024-05-26",0,0,0,0,0,0,0,0
"Saint Martin (French Part)","2024-05-27",0,0,0,0,0,0,0,0
"Saint Martin (French Part)","2024-05-28",0,0,0,0,0,0,0,0
"Saint Martin (French Part)","2024-05-29",0,0,0,0,0,0,0,0
"Saint Martin (French Part)","2024-05-30",0,0,0,0,0,0,0,0
"Saint Martin (French Part)","2024-05-31",0,0,0,0,0,0,0,0
"Saint Martin (French Part)","2024-06-01",0,0,0,0,0,0,0,0
"Saint Martin (French Part)","2024-06-02",0,0,0,0,0,0,0,0
"Saint Martin (French Part)","2024-06-03",0,0,0,0,0,0,0,0
"Saint Martin (French Part)","2024-06-04",0,0,0,0,0,0,0,0
"Saint Martin (French Part)","2024-06-05",0,0,0,0,0,0,0,0
"Saint Martin (French Part)","2024-06-06",0,0,0,0,0,0,0,0
"Saint Martin (French Part)","2024-06-07",0,0,0,0,0,0,0,0
"Saint Martin (French Part)","2024-06-08",0,0,0,0,0,0,0,0
"Saint Martin (French Part)","2024-06-09",0,0,0,0,0,0,0,0
"Saint Martin (French Part)","2024-06-10",0,0,0,0,0,0,0,0
"Saint Martin (French Part)","2024-06-11",0,0,0,0,0,0,0,0
"Saint Martin (French Part)","2024-06-12",0,0,0,0,0,0,0,0
"Saint Martin (French Part)","2024-06-13",0,0,0,0,0,0,0,0
"Saint Martin (French Part)","2024-06-14",0,0,0,0,0,0,0,0
"Saint Martin (French Part)","2024-06-15",0,0,0,0,0,0,0,0
"Saint Martin (French Part)","2024-06-16",0,0,0,0,0,0,0,0
"Saint Martin (French Part)","2024-06-17",0,0,0,0,0,0,0,0
"Saint Martin (French Part)","2024-06-18",0,0,0,0,0,0,0,0
"Saint Martin (French Part)","2024-06-19",0,0,0,0,0,0,0,0
"Saint Martin (French Part)","2024-06-20",0,0,0,0,0,0,0,0
"Saint Martin (French Part)","2024-06-21",0,0,0,0,0,0,0,0
"Saint Martin (French Part)","2024-06-22",0,0,0,0,0,0,0,0
"Saint Martin (French Part)","2024-06-23",0,0,0,0,0,0,0,0
"Saint Martin (French Part)","2024-06-24",0,0,0,0,0,0,0,0
"Saint Martin (French Part)","2024-06-25",0,0,0,0,0,0,0,0
"Saint Martin (French Part)","2024-06-26",0,0,0,0,0,0,0,0
"Saint Martin (French Part)","2024-06-27",0,0,0,0,0,0,0,0
"Saint Martin (French Part)","2024-06-28",0,0,0,0,0,0,0,0
"Saint Martin (French Part)","2024-06-29",0,0,0,0,0,0,0,0
"Saint Martin (French Part)","2024-06-30",0,0,0,0,0,0,0,0
"Saint Martin (French Part)","2024-07-01",0,0,0,0,0,0,0,0
"Saint Martin (French Part)","2024-07-02",0,0,0,0,0,0,0,0
"Saint Martin (French Part)","2024-07-03",0,0,0,0,0,0,0,0
"Saint Martin (French Part)","2024-07-04",0,0,0,0,0,0,0,0
"Saint Martin (French Part)","2024-07-05",0,0,0,0,0,0,0,0
"Saint Martin (French Part)","2024-07-06",0,0,0,0,0,0,0,0
"Saint Martin (French Part)","2024-07-07",0,0,0,0,0,0,0,0
"Saint Martin (French Part)","2024-07-08",0,0,0,0,0,0,0,0
"Saint Martin (French Part)","2024-07-09",0,0,0,0,0,0,0,0
"Saint Martin (French Part)","2024-07-10",0,0,0,0,0,0,0,0
"Saint Martin (French Part)","2024-07-11",0,0,0,0,0,0,0,0
"Saint Martin (French Part)","2024-07-12",0,0,0,0,0,0,0,0
"Saint Martin (French Part)","2024-07-13",0,0,0,0,0,0,0,0
"Saint Martin (French Part)","2024-07-14",0,0,0,0,0,0,0,0
"Saint Martin (French Part)","2024-07-15",0,0,0,0,0,0,0,0
"Saint Martin (French Part)","2024-07-16",0,0,0,0,0,0,0,0
"Saint Martin (French Part)","2024-07-17",0,0,0,0,0,0,0,0
"Saint Martin (French Part)","2024-07-18",0,0,0,0,0,0,0,0
"Saint Martin (French Part)","2024-07-19",0,0,0,0,0,0,0,0
"Saint Martin (French Part)","2024-07-20",0,0,0,0,0,0,0,0
"Saint Martin (French Part)","2024-07-21",0,0,0,0,0,0,0,0
"Saint Martin (French Part)","2024-07-22",0,0,0,0,0,0,0,0
"Saint Martin (French Part)","2024-07-23",0,0,0,0,0,0,0,0
"Saint Martin (French Part)","2024-07-24",0,0,0,0,0,0,0,0
"Saint Martin (French Part)","2024-07-25",0,0,0,0,0,0,0,0
"Saint Martin (French Part)","2024-07-26",0,0,0,0,0,0,0,0
"Saint Martin (French Part)","2024-07-27",0,0,0,0,0,0,0,0
"Saint Martin (French Part)","2024-07-28",0,0,0,0,0,0,0,0
"Saint Martin (French Part)","2024-07-29",0,0,0,0,0,0,0,0
"Saint Martin (French Part)","2024-07-30",0,0,0,0,0,0,0,0
"Saint Martin (French Part)","2024-07-31",0,0,0,0,0,0,0,0
"Saint Martin (French Part)","2024-08-01",0,0,0,0,0,0,0,0
"Saint Martin (French Part)","2024-08-02",0,0,0,0,0,0,0,0
"Saint Martin (French Part)","2024-08-03",0,0,0,0,0,0,0,0
"Saint Martin (French Part)","2024-08-04",0,0,0,0,0,0,0,0
"Saint Martin (French Part)","2024-08-05",0,0,0,0,0,0,0,0
"Saint Martin (French Part)","2024-08-06",0,0,0,0,0,0,0,0
"Saint Martin (French Part)","2024-08-07",0,0,0,0,0,0,0,0
"Saint Martin (French Part)","2024-08-08",0,0,0,0,0,0,0,0
"Saint Martin (French Part)","2024-08-09",0,0,0,0,0,0,0,0
"Saint Martin (French Part)","2024-08-10",0,0,0,0,0,0,0,0
"Saint Martin (French Part)","2024-08-11",0,0,0,0,0,0,0,0
"Saint Martin (French Part)","2024-08-12",0,0,0,0,0,0,0,0
"Saint Martin (French Part)","2024-08-13",0,0,0,0,0,0,0,0
"Saint Martin (French Part)","2024-08-14",0,0,0,0,0,0,0,0
"Saint Martin (French Part)","2024-08-15",0,0,0,0,0,0,0,0
"Saint Martin (French Part)","2024-08-16",0,0,0,0,0,0,0,0
"Saint Martin (French Part)","2024-08-17",0,0,0,0,0,0,0,0
"Saint Martin (French Part)","2024-08-18",0,0,0,0,0,0,0,0
"Saint Martin (French Part)","2024-08-19",0,0,0,0,0,0,0,0
"Saint Martin (French Part)","2024-08-20",0,0,0,0,0,0,0,0
"Saint Martin (French Part)","2024-08-21",0,0,0,0,0,0,0,0
"Saint Martin (French Part)","2024-08-22",0,0,0,0,0,0,0,0
"Saint Martin (French Part)","2024-08-23",0,0,0,0,0,0,0,0
"Saint Martin (French Part)","2024-08-24",0,0,0,0,0,0,0,0
"Saint Martin (French Part)","2024-08-25",0,0,0,0,0,0,0,0
"Saint Martin (French Part)","2024-08-26",0,0,0,0,0,0,0,0
"Saint Martin (French Part)","2024-08-27",0,0,0,0,0,0,0,0
"Saint Martin (French Part)","2024-08-28",0,0,0,0,0,0,0,0
"Saint Martin (French Part)","2024-08-29",0,0,0,0,0,0,0,0
"Saint Martin (French Part)","2024-08-30",0,0,0,0,0,0,0,0
"Saint Martin (French Part)","2024-08-31",0,0,0,0,0,0,0,0
"Saint Martin (French Part)","2024-09-01",0,0,0,0,0,0,0,0
"Saint Martin (French Part)","2024-09-02",0,0,0,0,0,0,0,0
"Saint Martin (French Part)","2024-09-03",0,0,0,0,0,0,0,0
"Saint Martin (French Part)","2024-09-04",0,0,0,0,0,0,0,0
"Saint Martin (French Part)","2024-09-05",0,0,0,0,0,0,0,0
"Saint Martin (French Part)","2024-09-06",0,0,0,0,0,0,0,0
"Saint Martin (French Part)","2024-09-07",0,0,0,0,0,0,0,0
"Saint Martin (French Part)","2024-09-08",0,0,0,0,0,0,0,0
"Saint Martin (French Part)","2024-09-09",0,0,0,0,0,0,0,0
"Saint Martin (French Part)","2024-09-10",0,0,0,0,0,0,0,0
"Saint Martin (French Part)","2024-09-11",0,0,0,0,0,0,0,0
"Saint Martin (French Part)","2024-09-12",0,0,0,0,0,0,0,0
"Saint Martin (French Part)","2024-09-13",0,0,0,0,0,0,0,0
"Saint Martin (French Part)","2024-09-14",0,0,0,0,0,0,0,0
"Saint Martin (French Part)","2024-09-15",0,0,0,0,0,0,0,0
"Saint Martin (French Part)","2024-09-16",0,0,0,0,0,0,0,0
"Saint Martin (French Part)","2024-09-17",0,0,0,0,0,0,0,0
"Saint Martin (French Part)","2024-09-18",0,0,0,0,0,0,0,0
"Saint Martin (French Part)","2024-09-19",0,0,0,0,0,0,0,0
"Saint Martin (French Part)","2024-09-20",0,0,0,0,0,0,0,0
"Saint Martin (French Part)","2024-09-21",0,0,0,0,0,0,0,0
"Saint Martin (French Part)","2024-09-22",0,0,0,0,0,0,0,0
"Saint Martin (French Part)","2024-09-23",0,0,0,0,0,0,0,0
"Saint Martin (French Part)","2024-09-24",0,0,0,0,0,0,0,0
"Saint Martin (French Part)","2024-09-25",0,0,0,0,0,0,0,0
"Saint Martin (French Part)","2024-09-26",0,0,0,0,0,0,0,0
"Saint Martin (French Part)","2024-09-27",0,0,0,0,0,0,0,0
"Saint Martin (French Part)","2024-09-28",0,0,0,0,0,0,0,0
"Saint Martin (French Part)","2024-09-29",0,0,0,0,0,0,0,0
"Saint Martin (French Part)","2024-09-30",0,0,0,0,0,0,0,0
"Saint Martin (French Part)","2024-10-01",0,0,0,0,0,0,0,0
"Saint Martin (French Part)","2024-10-02",0,0,0,0,0,0,0,0
"Saint Martin (French Part)","2024-10-03",0,0,0,0,0,0,0,0
"Saint Martin (French Part)","2024-10-04",0,0,0,0,0,0,0,0
"Saint Martin (French Part)","2024-10-05",0,0,0,0,0,0,0,0
"Saint Martin (French Part)","2024-10-06",0,0,0,0,0,0,0,0
"Saint Martin (French Part)","2024-10-07",0,0,0,0,0,0,0,0
"Saint Martin (French Part)","2024-10-08",0,0,0,0,0,0,0,0
"Saint Martin (French Part)","2024-10-09",0,0,0,0,0,0,0,0
"Saint Martin (French Part)","2024-10-10",0,0,0,0,0,0,0,0
"Saint Martin (French Part)","2024-10-11",0,0,0,0,0,0,0,0
"Saint Martin (French Part)","2024-10-12",0,0,0,0,0,0,0,0
"Saint Martin (French Part)","2024-10-13",0,0,0,0,0,0,0,0
"Saint Martin (French Part)","2024-10-14",0,0,0,0,0,0,0,0
"Saint Martin (French Part)","2024-10-15",0,0,0,0,0,0,0,0
"Saint Martin (French Part)","2024-10-16",0,0,0,0,0,0,0,0
"Saint Martin (French Part)","2024-10-17",0,0,0,0,0,0,0,0
"Saint Martin (French Part)","2024-10-18",0,0,0,0,0,0,0,0
"Saint Martin (French Part)","2024-10-19",0,0,0,0,0,0,0,0
"Saint Martin (French Part)","2024-10-20",0,0,0,0,0,0,0,0
"Saint Martin (French Part)","2024-10-21",0,0,0,0,0,0,0,0
"Saint Martin (French Part)","2024-10-22",0,0,0,0,0,0,0,0
"Saint Martin (French Part)","2024-10-23",0,0,0,0,0,0,0,0
"Saint Martin (French Part)","2024-10-24",0,0,0,0,0,0,0,0
"Saint Martin (French Part)","2024-10-25",0,0,0,0,0,0,0,0
"Saint Martin (French Part)","2024-10-26",0,0,0,0,0,0,0,0
"Saint Martin (French Part)","2024-10-27",0,0,0,0,0,0,0,0
"Saint Martin (French Part)","2024-10-28",0,0,0,0,0,0,0,0
"Saint Martin (French Part)","2024-10-29",0,0,0,0,0,0,0,0
"Saint Martin (French Part)","2024-10-30",0,0,0,0,0,0,0,0
"Saint Martin (French Part)","2024-10-31",0,0,0,0,0,0,0,0
"Saint Martin (French Part)","2024-11-01",0,0,0,0,0,0,0,0
"Saint Martin (French Part)","2024-11-02",0,0,0,0,0,0,0,0
"Saint Martin (French Part)","2024-11-03",0,0,0,0,0,0,0,0
"Saint Martin (French Part)","2024-11-04",0,0,0,0,0,0,0,0
"Saint Martin (French Part)","2024-11-05",0,0,0,0,0,0,0,0
"Saint Martin (French Part)","2024-11-06",0,0,0,0,0,0,0,0
"Saint Martin (French Part)","2024-11-07",0,0,0,0,0,0,0,0
"Saint Martin (French Part)","2024-11-08",0,0,0,0,0,0,0,0
"Saint Martin (French Part)","2024-11-09",0,0,0,0,0,0,0,0
"Saint Martin (French Part)","2024-11-10",0,0,0,0,0,0,0,0
"Saint Martin (French Part)","2024-11-11",0,0,0,0,0,0,0,0
"Saint Martin (French Part)","2024-11-12",0,0,0,0,0,0,0,0
"Saint Martin (French Part)","2024-11-13",0,0,0,0,0,0,0,0
"Saint Martin (French Part)","2024-11-14",0,0,0,0,0,0,0,0
"Saint Martin (French Part)","2024-11-15",0,0,0,0,0,0,0,0
"Saint Martin (French Part)","2024-11-16",0,0,0,0,0,0,0,0
"Saint Martin (French Part)","2024-11-17",0,0,0,0,0,0,0,0
"Saint Martin (French Part)","2024-11-18",0,0,0,0,0,0,0,0
"Saint Martin (French Part)","2024-11-19",0,0,0,0,0,0,0,0
"Saint Martin (French Part)","2024-11-20",0,0,0,0,0,0,0,0
"Saint Martin (French Part)","2024-11-21",0,0,0,0,0,0,0,0
"Saint Martin (French Part)","2024-11-22",0,0,0,0,0,0,0,0
"Saint Martin (French Part)","2024-11-23",0,0,0,0,0,0,0,0
"Saint Martin (French Part)","2024-11-24",0,0,0,0,0,0,0,0
"Saint Martin (French Part)","2024-11-25",0,0,0,0,0,0,0,0
"Saint Martin (French Part)","2024-11-26",0,0,0,0,0,0,0,0
"Saint Martin (French Part)","2024-11-27",0,0,0,0,0,0,0,0
"Saint Martin (French Part)","2024-11-28",0,0,0,0,0,0,0,0
"Saint Martin (French Part)","2024-11-29",0,0,0,0,0,0,0,0
"Saint Martin (French Part)","2024-11-30",0,0,0,0,0,0,0,0
"Saint Martin (French Part)","2024-12-01",0,0,0,0,0,0,0,0
"Saint Martin (French Part)","2024-12-02",0,0,0,0,0,0,0,0
"Saint Martin (French Part)","2024-12-03",0,0,0,0,0,0,0,0
"Saint Martin (French Part)","2024-12-04",0,0,0,0,0,0,0,0
"Saint Martin (French Part)","2024-12-05",0,0,0,0,0,0,0,0
"Saint Martin (French Part)","2024-12-06",0,0,0,0,0,0,0,0
"Saint Martin (French Part)","2024-12-07",0,0,0,0,0,0,0,0
"Saint Martin (French Part)","2024-12-08",0,0,0,0,0,0,0,0
"Saint Martin (French Part)","2024-12-09",0,0,0,0,0,0,0,0
"Saint Martin (French Part)","2024-12-10",0,0,0,0,0,0,0,0
"Saint Martin (French Part)","2024-12-11",0,0,0,0,0,0,0,0
"Saint Martin (French Part)","2024-12-12",0,0,0,0,0,0,0,0
"Saint Martin (French Part)","2024-12-13",0,0,0,0,0,0,0,0
"Saint Martin (French Part)","2024-12-14",0,0,0,0,0,0,0,0
"Saint Martin (French Part)","2024-12-15",0,0,0,0,0,0,0,0
"Saint Martin (French Part)","2024-12-16",0,0,0,0,0,0,0,0
"Saint Martin (French Part)","2024-12-17",0,0,0,0,0,0,0,0
"Saint Martin (French Part)","2024-12-18",0,0,0,0,0,0,0,0
"Saint Martin (French Part)","2024-12-19",0,0,0,0,0,0,0,0
"Saint Martin (French Part)","2024-12-20",0,0,0,0,0,0,0,0
"Saint Martin (French Part)","2024-12-21",0,0,0,0,0,0,0,0
"Saint Martin (French Part)","2024-12-22",0,0,0,0,0,0,0,0
"Saint Martin (French Part)","2024-12-23",0,0,0,0,0,0,0,0
"Saint Martin (French Part)","2024-12-24",0,0,0,0,0,0,0,0
"Saint Martin (French Part)","2024-12-25",0,0,0,0,0,0,0,0
"Saint Martin (French Part)","2024-12-26",0,0,0,0,0,0,0,0
"Saint Martin (French Part)","2024-12-27",0,0,0,0,0,0,0,0
"Saint Martin (French Part)","2024-12-28",0,0,0,0,0,0,0,0
"Saint Martin (French Part)","2024-12-29",0,0,0,0,0,0,0,0
"Saint Martin (French Part)","2024-12-30",0,0,0,0,0,0,0,0
"Saint Martin (French Part)","2024-12-31",0,0,0,0,0,0,0,0
"Saint Martin (French Part)","2025-01-01",0,0,0,0,0,0,0,0
"Saint Martin (French Part)","2025-01-02",0,0,0,0,0,0,0,0
"Saint Martin (French Part)","2025-01-03",0,0,0,0,0,0,0,0
"Saint Martin (French Part)","2025-01-04",0,0,0,0,0,0,0,0
"Saint Martin (French Part)","2025-01-05",0,0,0,0,0,0,0,0
"Saint Martin (French Part)","2025-01-06",0,0,0,0,0,0,0,0
"Saint Martin (French Part)","2025-01-07",0,0,0,0,0,0,0,0
"Saint Martin (French Part)","2025-01-08",0,0,0,0,0,0,0,0
"Saint Martin (French Part)","2025-01-09",0,0,0,0,0,0,0,0
"Saint Martin (French Part)","2025-01-10",0,0,0,0,0,0,0,0
"Saint Martin (French Part)","2025-01-11",0,0,0,0,0,0,0,0
"Saint Martin (French Part)","2025-01-12",0,0,0,0,0,0,0,0
"Saint Martin (French Part)","2025-01-13",0,0,0,0,0,0,0,0
"Saint Martin (French Part)","2025-01-14",0,0,0,0,0,0,0,0
"Saint Martin (French Part)","2025-01-15",0,0,0,0,0,0,0,0
"Saint Martin (French Part)","2025-01-16",0,0,0,0,0,0,0,0
"Saint Martin (French Part)","2025-01-17",0,0,0,0,0,0,0,0
"Saint Martin (French Part)","2025-01-18",0,0,0,0,0,0,0,0
"Saint Martin (French Part)","2025-01-19",0,0,0,0,0,0,0,0
"Saint Martin (French Part)","2025-01-20",0,0,0,0,0,0,0,0
"Saint Martin (French Part)","2025-01-21",0,0,0,0,0,0,0,0
"Saint Martin (French Part)","2025-01-22",0,0,0,0,0,0,0,0
"Saint Martin (French Part)","2025-01-23",0,0,0,0,0,0,0,0
"Saint Martin (French Part)","2025-01-24",0,0,0,0,0,0,0,0
"Saint Martin (French Part)","2025-01-25",0,0,0,0,0,0,0,0
"Saint Martin (French Part)","2025-01-26",0,0,0,0,0,0,0,0
"Saint Martin (French Part)","2025-01-27",0,0,0,0,0,0,0,0
"Saint Martin (French Part)","2025-01-28",0,0,0,0,0,0,0,0
"Saint Martin (French Part)","2025-01-29",0,0,0,0,0,0,0,0
"Saint Martin (French Part)","2025-01-30",0,0,0,0,0,0,0,0
"Saint Martin (French Part)","2025-01-31",0,0,0,0,0,0,0,0
"Saint Martin (French Part)","2025-02-01",0,0,0,0,0,0,0,0
"Saint Martin (French Part)","2025-02-02",0,0,0,0,0,0,0,0
"Saint Martin (French Part)","2025-02-03",0,0,0,0,0,0,0,0
"Saint Martin (French Part)","2025-02-04",0,0,0,0,0,0,0,0
"Saint Martin (French Part)","2025-02-05",0,0,0,0,0,0,0,0
"Saint Martin (French Part)","2025-02-06",0,0,0,0,0,0,0,0
"Saint Martin (French Part)","2025-02-07",0,0,0,0,0,0,0,0
"Saint Martin (French Part)","2025-02-08",0,0,0,0,0,0,0,0
"Saint Martin (French Part)","2025-02-09",0,0,0,0,0,0,0,0
"Saint Martin (French Part)","2025-02-10",0,0,0,0,0,0,0,0
"Saint Martin (French Part)","2025-02-11",0,0,0,0,0,0,0,0
"Saint Martin (French Part)","2025-02-12",0,0,0,0,0,0,0,0
"Saint Martin (French Part)","2025-02-13",0,0,0,0,0,0,0,0
"Saint Martin (French Part)","2025-02-14",0,0,0,0,0,0,0,0
"Saint Martin (French Part)","2025-02-15",0,0,0,0,0,0,0,0
"Saint Martin (French Part)","2025-02-16",0,0,0,0,0,0,0,0
"Saint Martin (French Part)","2025-02-17",0,0,0,0,0,0,0,0
"Saint Martin (French Part)","2025-02-18",0,0,0,0,0,0,0,0
"Saint Martin (French Part)","2025-02-19",0,0,0,0,0,0,0,0
"Saint Martin (French Part)","2025-02-20",0,0,0,0,0,0,0,0
"Saint Martin (French Part)","2025-02-21",0,0,0,0,0,0,0,0
"Saint Martin (French Part)","2025-02-22",0,0,0,0,0,0,0,0
"Saint Martin (French Part)","2025-02-23",0,0,0,0,0,0,0,0
"Saint Martin (French Part)","2025-02-24",0,0,0,0,0,0,0,0
"Saint Martin (French Part)","2025-02-25",0,0,0,0,0,0,0,0
"Saint Martin (French Part)","2025-02-26",0,0,0,0,0,0,0,0
"Saint Martin (French Part)","2025-02-27",0,0,0,0,0,0,0,0
"Saint Martin (French Part)","2025-02-28",0,0,0,0,0,0,0,0
"Saint Martin (French Part)","2025-03-01",0,0,0,0,0,0,0,0
"Saint Martin (French Part)","2025-03-02",0,0,0,0,0,0,0,0
"Saint Martin (French Part)","2025-03-03",0,0,0,0,0,0,0,0
"San Marino","2024-01-01",0,0,0,0,0,0,0,0
"San Marino","2024-01-02",0,0,0,0,0,0,0,0
"San Marino","2024-01-03",0,0,0,0,0,0,0,0
"San Marino","2024-01-04",0,0,0,0,0,0,0,0
"San Marino","2024-01-05",0,0,0,0,0,0,0,0
"San Marino","2024-01-06",0,0,0,0,0,0,0,0
"San Marino","2024-01-07",0,0,0,0,0,0,0,0
"San Marino","2024-01-08",0,0,0,0,0,0,0,0
"San Marino","2024-01-09",0,0,0,0,0,0,0,0
"San Marino","2024-01-10",0,0,0,0,0,0,0,0
"San Marino","2024-01-11",0,0,0,0,0,0,0,0
"San Marino","2024-01-12",0,0,0,0,0,0,0,0
"San Marino","2024-01-13",0,0,0,0,0,0,0,0
"San Marino","2024-01-14",0,0,0,0,0,0,0,0
"San Marino","2024-01-15",0,0,0,0,0,0,0,0
"San Marino","2024-01-16",0,0,0,0,0,0,0,0
"San Marino","2024-01-17",0,0,0,0,0,0,0,0
"San Marino","2024-01-18",0,0,0,0,0,0,0,0
"San Marino","2024-01-19",0,0,0,0,0,0,0,0
"San Marino","2024-01-20",0,0,0,0,0,0,0,0
"San Marino","2024-01-21",0,0,0,0,0,0,0,0
"San Marino","2024-01-22",0,0,0,0,0,0,0,0
"San Marino","2024-01-23",0,0,0,0,0,0,0,0
"San Marino","2024-01-24",0,0,0,0,0,0,0,0
"San Marino","2024-01-25",0,0,0,0,0,0,0,0
"San Marino","2024-01-26",0,0,0,0,0,0,0,0
"San Marino","2024-01-27",0,0,0,0,0,0,0,0
"San Marino","2024-01-28",0,0,0,0,0,0,0,0
"San Marino","2024-01-29",0,0,0,0,0,0,0,0
"San Marino","2024-01-30",0,0,0,0,0,0,0,0
"San Marino","2024-01-31",0,0,0,0,0,0,0,0
"San Marino","2024-02-01",0,0,0,0,0,0,0,0
"San Marino","2024-02-02",0,0,0,0,0,0,0,0
"San Marino","2024-02-03",0,0,0,0,0,0,0,0
"San Marino","2024-02-04",0,0,0,0,0,0,0,0
"San Marino","2024-02-05",0,0,0,0,0,0,0,0
"San Marino","2024-02-06",0,0,0,0,0,0,0,0
"San Marino","2024-02-07",0,0,0,0,0,0,0,0
"San Marino","2024-02-08",0,0,0,0,0,0,0,0
"San Marino","2024-02-09",0,0,0,0,0,0,0,0
"San Marino","2024-02-10",0,0,0,0,0,0,0,0
"San Marino","2024-02-11",0,0,0,0,0,0,0,0
"San Marino","2024-02-12",0,0,0,0,0,0,0,0
"San Marino","2024-02-13",0,0,0,0,0,0,0,0
"San Marino","2024-02-14",0,0,0,0,0,0,0,0
"San Marino","2024-02-15",0,0,0,0,0,0,0,0
"San Marino","2024-02-16",0,0,0,0,0,0,0,0
"San Marino","2024-02-17",0,0,0,0,0,0,0,0
"San Marino","2024-02-18",0,0,0,0,0,0,0,0
"San Marino","2024-02-19",0,0,0,0,0,0,0,0
"San Marino","2024-02-20",0,0,0,0,0,0,0,0
"San Marino","2024-02-21",0,0,0,0,0,0,0,0
"San Marino","2024-02-22",0,0,0,0,0,0,0,0
"San Marino","2024-02-23",0,0,0,0,0,0,0,0
"San Marino","2024-02-24",0,0,0,0,0,0,0,0
"San Marino","2024-02-25",0,0,0,0,0,0,0,0
"San Marino","2024-02-26",0,0,0,0,0,0,0,0
"San Marino","2024-02-27",0,0,0,0,0,0,0,0
"San Marino","2024-02-28",0,0,0,0,0,0,0,0
"San Marino","2024-02-29",0,0,0,0,0,0,0,0
"San Marino","2024-03-01",0,0,0,0,0,0,0,0
"San Marino","2024-03-02",0,0,0,0,0,0,0,0
"San Marino","2024-03-03",0,0,0,0,0,0,0,0
"San Marino","2024-03-04",0,0,0,0,0,0,0,0
"San Marino","2024-03-05",0,0,0,0,0,0,0,0
"San Marino","2024-03-06",0,0,0,0,0,0,0,0
"San Marino","2024-03-07",0,0,0,0,0,0,0,0
"San Marino","2024-03-08",0,0,0,0,0,0,0,0
"San Marino","2024-03-09",0,0,0,0,0,0,0,0
"San Marino","2024-03-10",0,0,0,0,0,0,0,0
"San Marino","2024-03-11",0,0,0,0,0,0,0,0
"San Marino","2024-03-12",0,0,0,0,0,0,0,0
"San Marino","2024-03-13",0,0,0,0,0,0,0,0
"San Marino","2024-03-14",0,0,0,0,0,0,0,0
"San Marino","2024-03-15",0,0,0,0,0,0,0,0
"San Marino","2024-03-16",0,0,0,0,0,0,0,0
"San Marino","2024-03-17",0,0,0,0,0,0,0,0
"San Marino","2024-03-18",0,0,0,0,0,0,0,0
"San Marino","2024-03-19",0,0,0,0,0,0,0,0
"San Marino","2024-03-20",0,0,0,0,0,0,0,0
"San Marino","2024-03-21",0,0,0,0,0,0,0,0
"San Marino","2024-03-22",0,0,0,0,0,0,0,0
"San Marino","2024-03-23",0,0,0,0,0,0,0,0
"San Marino","2024-03-24",0,0,0,0,0,0,0,0
"San Marino","2024-03-25",0,0,0,0,0,0,0,0
"San Marino","2024-03-26",0,0,0,0,0,0,0,0
"San Marino","2024-03-27",0,0,0,0,0,0,0,0
"San Marino","2024-03-28",0,0,0,0,0,0,0,0
"San Marino","2024-03-29",0,0,0,0,0,0,0,0
"San Marino","2024-03-30",0,0,0,0,0,0,0,0
"San Marino","2024-03-31",0,0,0,0,0,0,0,0
"San Marino","2024-04-01",0,0,0,0,0,0,0,0
"San Marino","2024-04-02",0,0,0,0,0,0,0,0
"San Marino","2024-04-03",0,0,0,0,0,0,0,0
"San Marino","2024-04-04",0,0,0,0,0,0,0,0
"San Marino","2024-04-05",0,0,0,0,0,0,0,0
"San Marino","2024-04-06",0,0,0,0,0,0,0,0
"San Marino","2024-04-07",0,0,0,0,0,0,0,0
"San Marino","2024-04-08",0,0,0,0,0,0,0,0
"San Marino","2024-04-09",0,0,0,0,0,0,0,0
"San Marino","2024-04-10",0,0,0,0,0,0,0,0
"San Marino","2024-04-11",0,0,0,0,0,0,0,0
"San Marino","2024-04-12",0,0,0,0,0,0,0,0
"San Marino","2024-04-13",0,0,0,0,0,0,0,0
"San Marino","2024-04-14",0,0,0,0,0,0,0,0
"San Marino","2024-04-15",0,0,0,0,0,0,0,0
"San Marino","2024-04-16",0,0,0,0,0,0,0,0
"San Marino","2024-04-17",0,0,0,0,0,0,0,0
"San Marino","2024-04-18",0,0,0,0,0,0,0,0
"San Marino","2024-04-19",0,0,0,0,0,0,0,0
"San Marino","2024-04-20",0,0,0,0,0,0,0,0
"San Marino","2024-04-21",0,0,0,0,0,0,0,0
"San Marino","2024-04-22",0,0,0,0,0,0,0,0
"San Marino","2024-04-23",0,0,0,0,0,0,0,0
"San Marino","2024-04-24",0,0,0,0,0,0,0,0
"San Marino","2024-04-25",0,0,0,0,0,0,0,0
"San Marino","2024-04-26",0,0,0,0,0,0,0,0
"San Marino","2024-04-27",0,0,0,0,0,0,0,0
"San Marino","2024-04-28",0,0,0,0,0,0,0,0
"San Marino","2024-04-29",0,0,0,0,0,0,0,0
"San Marino","2024-04-30",0,0,0,0,0,0,0,0
"San Marino","2024-05-01",0,0,0,0,0,0,0,0
"San Marino","2024-05-02",0,0,0,0,0,0,0,0
"San Marino","2024-05-03",0,0,0,0,0,0,0,0
"San Marino","2024-05-04",0,0,0,0,0,0,0,0
"San Marino","2024-05-05",0,0,0,0,0,0,0,0
"San Marino","2024-05-06",0,0,0,0,0,0,0,0
"San Marino","2024-05-07",0,0,0,0,0,0,0,0
"San Marino","2024-05-08",0,0,0,0,0,0,0,0
"San Marino","2024-05-09",0,0,0,0,0,0,0,0
"San Marino","2024-05-10",0,0,0,0,0,0,0,0
"San Marino","2024-05-11",0,0,0,0,0,0,0,0
"San Marino","2024-05-12",0,0,0,0,0,0,0,0
"San Marino","2024-05-13",0,0,0,0,0,0,0,0
"San Marino","2024-05-14",0,0,0,0,0,0,0,0
"San Marino","2024-05-15",0,0,0,0,0,0,0,0
"San Marino","2024-05-16",0,0,0,0,0,0,0,0
"San Marino","2024-05-17",0,0,0,0,0,0,0,0
"San Marino","2024-05-18",0,0,0,0,0,0,0,0
"San Marino","2024-05-19",0,0,0,0,0,0,0,0
"San Marino","2024-05-20",0,0,0,0,0,0,0,0
"San Marino","2024-05-21",0,0,0,0,0,0,0,0
"San Marino","2024-05-22",0,0,0,0,0,0,0,0
"San Marino","2024-05-23",0,0,0,0,0,0,0,0
"San Marino","2024-05-24",0,0,0,0,0,0,0,0
"San Marino","2024-05-25",0,0,0,0,0,0,0,0
"San Marino","2024-05-26",0,0,0,0,0,0,0,0
"San Marino","2024-05-27",0,0,0,0,0,0,0,0
"San Marino","2024-05-28",0,0,0,0,0,0,0,0
"San Marino","2024-05-29",0,0,0,0,0,0,0,0
"San Marino","2024-05-30",0,0,0,0,0,0,0,0
"San Marino","2024-05-31",0,0,0,0,0,0,0,0
"San Marino","2024-06-01",0,0,0,0,0,0,0,0
"San Marino","2024-06-02",0,0,0,0,0,0,0,0
"San Marino","2024-06-03",0,0,0,0,0,0,0,0
"San Marino","2024-06-04",0,0,0,0,0,0,0,0
"San Marino","2024-06-05",0,0,0,0,0,0,0,0
"San Marino","2024-06-06",0,0,0,0,0,0,0,0
"San Marino","2024-06-07",0,0,0,0,0,0,0,0
"San Marino","2024-06-08",0,0,0,0,0,0,0,0
"San Marino","2024-06-09",0,0,0,0,0,0,0,0
"San Marino","2024-06-10",0,0,0,0,0,0,0,0
"San Marino","2024-06-11",0,0,0,0,0,0,0,0
"San Marino","2024-06-12",0,0,0,0,0,0,0,0
"San Marino","2024-06-13",0,0,0,0,0,0,0,0
"San Marino","2024-06-14",0,0,0,0,0,0,0,0
"San Marino","2024-06-15",0,0,0,0,0,0,0,0
"San Marino","2024-06-16",0,0,0,0,0,0,0,0
"San Marino","2024-06-17",0,0,0,0,0,0,0,0
"San Marino","2024-06-18",0,0,0,0,0,0,0,0
"San Marino","2024-06-19",0,0,0,0,0,0,0,0
"San Marino","2024-06-20",0,0,0,0,0,0,0,0
"San Marino","2024-06-21",0,0,0,0,0,0,0,0
"San Marino","2024-06-22",0,0,0,0,0,0,0,0
"San Marino","2024-06-23",0,0,0,0,0,0,0,0
"San Marino","2024-06-24",0,0,0,0,0,0,0,0
"San Marino","2024-06-25",0,0,0,0,0,0,0,0
"San Marino","2024-06-26",0,0,0,0,0,0,0,0
"San Marino","2024-06-27",0,0,0,0,0,0,0,0
"San Marino","2024-06-28",0,0,0,0,0,0,0,0
"San Marino","2024-06-29",0,0,0,0,0,0,0,0
"San Marino","2024-06-30",0,0,0,0,0,0,0,0
"San Marino","2024-07-01",0,0,0,0,0,0,0,0
"San Marino","2024-07-02",0,0,0,0,0,0,0,0
"San Marino","2024-07-03",0,0,0,0,0,0,0,0
"San Marino","2024-07-04",0,0,0,0,0,0,0,0
"San Marino","2024-07-05",0,0,0,0,0,0,0,0
"San Marino","2024-07-06",0,0,0,0,0,0,0,0
"San Marino","2024-07-07",0,0,0,0,0,0,0,0
"San Marino","2024-07-08",0,0,0,0,0,0,0,0
"San Marino","2024-07-09",0,0,0,0,0,0,0,0
"San Marino","2024-07-10",0,0,0,0,0,0,0,0
"San Marino","2024-07-11",0,0,0,0,0,0,0,0
"San Marino","2024-07-12",0,0,0,0,0,0,0,0
"San Marino","2024-07-13",0,0,0,0,0,0,0,0
"San Marino","2024-07-14",0,0,0,0,0,0,0,0
"San Marino","2024-07-15",0,0,0,0,0,0,0,0
"San Marino","2024-07-16",0,0,0,0,0,0,0,0
"San Marino","2024-07-17",0,0,0,0,0,0,0,0
"San Marino","2024-07-18",0,0,0,0,0,0,0,0
"San Marino","2024-07-19",0,0,0,0,0,0,0,0
"San Marino","2024-07-20",0,0,0,0,0,0,0,0
"San Marino","2024-07-21",0,0,0,0,0,0,0,0
"San Marino","2024-07-22",0,0,0,0,0,0,0,0
"San Marino","2024-07-23",0,0,0,0,0,0,0,0
"San Marino","2024-07-24",0,0,0,0,0,0,0,0
"San Marino","2024-07-25",0,0,0,0,0,0,0,0
"San Marino","2024-07-26",0,0,0,0,0,0,0,0
"San Marino","2024-07-27",0,0,0,0,0,0,0,0
"San Marino","2024-07-28",0,0,0,0,0,0,0,0
"San Marino","2024-07-29",0,0,0,0,0,0,0,0
"San Marino","2024-07-30",0,0,0,0,0,0,0,0
"San Marino","2024-07-31",0,0,0,0,0,0,0,0
"San Marino","2024-08-01",0,0,0,0,0,0,0,0
"San Marino","2024-08-02",0,0,0,0,0,0,0,0
"San Marino","2024-08-03",0,0,0,0,0,0,0,0
"San Marino","2024-08-04",0,0,0,0,0,0,0,0
"San Marino","2024-08-05",0,0,0,0,0,0,0,0
"San Marino","2024-08-06",0,0,0,0,0,0,0,0
"San Marino","2024-08-07",0,0,0,0,0,0,0,0
"San Marino","2024-08-08",0,0,0,0,0,0,0,0
"San Marino","2024-08-09",0,0,0,0,0,0,0,0
"San Marino","2024-08-10",0,0,0,0,0,0,0,0
"San Marino","2024-08-11",0,0,0,0,0,0,0,0
"San Marino","2024-08-12",0,0,0,0,0,0,0,0
"San Marino","2024-08-13",0,0,0,0,0,0,0,0
"San Marino","2024-08-14",0,0,0,0,0,0,0,0
"San Marino","2024-08-15",0,0,0,0,0,0,0,0
"San Marino","2024-08-16",0,0,0,0,0,0,0,0
"San Marino","2024-08-17",0,0,0,0,0,0,0,0
"San Marino","2024-08-18",0,0,0,0,0,0,0,0
"San Marino","2024-08-19",0,0,0,0,0,0,0,0
"San Marino","2024-08-20",0,0,0,0,0,0,0,0
"San Marino","2024-08-21",0,0,0,0,0,0,0,0
"San Marino","2024-08-22",0,0,0,0,0,0,0,0
"San Marino","2024-08-23",0,0,0,0,0,0,0,0
"San Marino","2024-08-24",0,0,0,0,0,0,0,0
"San Marino","2024-08-25",0,0,0,0,0,0,0,0
"San Marino","2024-08-26",0,0,0,0,0,0,0,0
"San Marino","2024-08-27",0,0,0,0,0,0,0,0
"San Marino","2024-08-28",0,0,0,0,0,0,0,0
"San Marino","2024-08-29",0,0,0,0,0,0,0,0
"San Marino","2024-08-30",0,0,0,0,0,0,0,0
"San Marino","2024-08-31",0,0,0,0,0,0,0,0
"San Marino","2024-09-01",0,0,0,0,0,0,0,0
"San Marino","2024-09-02",0,0,0,0,0,0,0,0
"San Marino","2024-09-03",0,0,0,0,0,0,0,0
"San Marino","2024-09-04",0,0,0,0,0,0,0,0
"San Marino","2024-09-05",0,0,0,0,0,0,0,0
"San Marino","2024-09-06",0,0,0,0,0,0,0,0
"San Marino","2024-09-07",0,0,0,0,0,0,0,0
"San Marino","2024-09-08",0,0,0,0,0,0,0,0
"San Marino","2024-09-09",0,0,0,0,0,0,0,0
"San Marino","2024-09-10",0,0,0,0,0,0,0,0
"San Marino","2024-09-11",0,0,0,0,0,0,0,0
"San Marino","2024-09-12",0,0,0,0,0,0,0,0
"San Marino","2024-09-13",0,0,0,0,0,0,0,0
"San Marino","2024-09-14",0,0,0,0,0,0,0,0
"San Marino","2024-09-15",0,0,0,0,0,0,0,0
"San Marino","2024-09-16",0,0,0,0,0,0,0,0
"San Marino","2024-09-17",0,0,0,0,0,0,0,0
"San Marino","2024-09-18",0,0,0,0,0,0,0,0
"San Marino","2024-09-19",0,0,0,0,0,0,0,0
"San Marino","2024-09-20",0,0,0,0,0,0,0,0
"San Marino","2024-09-21",0,0,0,0,0,0,0,0
"San Marino","2024-09-22",0,0,0,0,0,0,0,0
"San Marino","2024-09-23",0,0,0,0,0,0,0,0
"San Marino","2024-09-24",0,0,0,0,0,0,0,0
"San Marino","2024-09-25",0,0,0,0,0,0,0,0
"San Marino","2024-09-26",0,0,0,0,0,0,0,0
"San Marino","2024-09-27",0,0,0,0,0,0,0,0
"San Marino","2024-09-28",0,0,0,0,0,0,0,0
"San Marino","2024-09-29",0,0,0,0,0,0,0,0
"San Marino","2024-09-30",0,0,0,0,0,0,0,0
"San Marino","2024-10-01",0,0,0,0,0,0,0,0
"San Marino","2024-10-02",0,0,0,0,0,0,0,0
"San Marino","2024-10-03",0,0,0,0,0,0,0,0
"San Marino","2024-10-04",0,0,0,0,0,0,0,0
"San Marino","2024-10-05",0,0,0,0,0,0,0,0
"San Marino","2024-10-06",0,0,0,0,0,0,0,0
"San Marino","2024-10-07",0,0,0,0,0,0,0,0
"San Marino","2024-10-08",0,0,0,0,0,0,0,0
"San Marino","2024-10-09",0,0,0,0,0,0,0,0
"San Marino","2024-10-10",0,0,0,0,0,0,0,0
"San Marino","2024-10-11",0,0,0,0,0,0,0,0
"San Marino","2024-10-12",0,0,0,0,0,0,0,0
"San Marino","2024-10-13",0,0,0,0,0,0,0,0
"San Marino","2024-10-14",0,0,0,0,0,0,0,0
"San Marino","2024-10-15",0,0,0,0,0,0,0,0
"San Marino","2024-10-16",0,0,0,0,0,0,0,0
"San Marino","2024-10-17",0,0,0,0,0,0,0,0
"San Marino","2024-10-18",0,0,0,0,0,0,0,0
"San Marino","2024-10-19",0,0,0,0,0,0,0,0
"San Marino","2024-10-20",0,0,0,0,0,0,0,0
"San Marino","2024-10-21",0,0,0,0,0,0,0,0
"San Marino","2024-10-22",0,0,0,0,0,0,0,0
"San Marino","2024-10-23",0,0,0,0,0,0,0,0
"San Marino","2024-10-24",0,0,0,0,0,0,0,0
"San Marino","2024-10-25",0,0,0,0,0,0,0,0
"San Marino","2024-10-26",0,0,0,0,0,0,0,0
"San Marino","2024-10-27",0,0,0,0,0,0,0,0
"San Marino","2024-10-28",0,0,0,0,0,0,0,0
"San Marino","2024-10-29",0,0,0,0,0,0,0,0
"San Marino","2024-10-30",0,0,0,0,0,0,0,0
"San Marino","2024-10-31",0,0,0,0,0,0,0,0
"San Marino","2024-11-01",0,0,0,0,0,0,0,0
"San Marino","2024-11-02",0,0,0,0,0,0,0,0
"San Marino","2024-11-03",0,0,0,0,0,0,0,0
"San Marino","2024-11-04",0,0,0,0,0,0,0,0
"San Marino","2024-11-05",0,0,0,0,0,0,0,0
"San Marino","2024-11-06",0,0,0,0,0,0,0,0
"San Marino","2024-11-07",0,0,0,0,0,0,0,0
"San Marino","2024-11-08",0,0,0,0,0,0,0,0
"San Marino","2024-11-09",0,0,0,0,0,0,0,0
"San Marino","2024-11-10",0,0,0,0,0,0,0,0
"San Marino","2024-11-11",0,0,0,0,0,0,0,0
"San Marino","2024-11-12",0,0,0,0,0,0,0,0
"San Marino","2024-11-13",0,0,0,0,0,0,0,0
"San Marino","2024-11-14",0,0,0,0,0,0,0,0
"San Marino","2024-11-15",0,0,0,0,0,0,0,0
"San Marino","2024-11-16",0,0,0,0,0,0,0,0
"San Marino","2024-11-17",0,0,0,0,0,0,0,0
"San Marino","2024-11-18",0,0,0,0,0,0,0,0
"San Marino","2024-11-19",0,0,0,0,0,0,0,0
"San Marino","2024-11-20",0,0,0,0,0,0,0,0
"San Marino","2024-11-21",0,0,0,0,0,0,0,0
"San Marino","2024-11-22",0,0,0,0,0,0,0,0
"San Marino","2024-11-23",0,0,0,0,0,0,0,0
"San Marino","2024-11-24",0,0,0,0,0,0,0,0
"San Marino","2024-11-25",0,0,0,0,0,0,0,0
"San Marino","2024-11-26",0,0,0,0,0,0,0,0
"San Marino","2024-11-27",0,0,0,0,0,0,0,0
"San Marino","2024-11-28",0,0,0,0,0,0,0,0
"San Marino","2024-11-29",0,0,0,0,0,0,0,0
"San Marino","2024-11-30",0,0,0,0,0,0,0,0
"San Marino","2024-12-01",0,0,0,0,0,0,0,0
"San Marino","2024-12-02",0,0,0,0,0,0,0,0
"San Marino","2024-12-03",0,0,0,0,0,0,0,0
"San Marino","2024-12-04",0,0,0,0,0,0,0,0
"San Marino","2024-12-05",0,0,0,0,0,0,0,0
"San Marino","2024-12-06",0,0,0,0,0,0,0,0
"San Marino","2024-12-07",0,0,0,0,0,0,0,0
"San Marino","2024-12-08",0,0,0,0,0,0,0,0
"San Marino","2024-12-09",0,0,0,0,0,0,0,0
"San Marino","2024-12-10",0,0,0,0,0,0,0,0
"San Marino","2024-12-11",0,0,0,0,0,0,0,0
"San Marino","2024-12-12",0,0,0,0,0,0,0,0
"San Marino","2024-12-13",0,0,0,0,0,0,0,0
"San Marino","2024-12-14",0,0,0,0,0,0,0,0
"San Marino","2024-12-15",0,0,0,0,0,0,0,0
"San Marino","2024-12-16",0,0,0,0,0,0,0,0
"San Marino","2024-12-17",0,0,0,0,0,0,0,0
"San Marino","2024-12-18",0,0,0,0,0,0,0,0
"San Marino","2024-12-19",0,0,0,0,0,0,0,0
"San Marino","2024-12-20",0,0,0,0,0,0,0,0
"San Marino","2024-12-21",0,0,0,0,0,0,0,0
"San Marino","2024-12-22",0,0,0,0,0,0,0,0
"San Marino","2024-12-23",0,0,0,0,0,0,0,0
"San Marino","2024-12-24",0,0,0,0,0,0,0,0
"San Marino","2024-12-25",0,0,0,0,0,0,0,0
"San Marino","2024-12-26",0,0,0,0,0,0,0,0
"San Marino","2024-12-27",0,0,0,0,0,0,0,0
"San Marino","2024-12-28",0,0,0,0,0,0,0,0
"San Marino","2024-12-29",0,0,0,0,0,0,0,0
"San Marino","2024-12-30",0,0,0,0,0,0,0,0
"San Marino","2024-12-31",0,0,0,0,0,0,0,0
"San Marino","2025-01-01",0,0,0,0,0,0,0,0
"San Marino","2025-01-02",0,0,0,0,0,0,0,0
"San Marino","2025-01-03",0,0,0,0,0,0,0,0
"San Marino","2025-01-04",0,0,0,0,0,0,0,0
"San Marino","2025-01-05",0,0,0,0,0,0,0,0
"San Marino","2025-01-06",0,0,0,0,0,0,0,0
"San Marino","2025-01-07",0,0,0,0,0,0,0,0
"San Marino","2025-01-08",0,0,0,0,0,0,0,0
"San Marino","2025-01-09",0,0,0,0,0,0,0,0
"San Marino","2025-01-10",0,0,0,0,0,0,0,0
"San Marino","2025-01-11",0,0,0,0,0,0,0,0
"San Marino","2025-01-12",0,0,0,0,0,0,0,0
"San Marino","2025-01-13",0,0,0,0,0,0,0,0
"San Marino","2025-01-14",0,0,0,0,0,0,0,0
"San Marino","2025-01-15",0,0,0,0,0,0,0,0
"San Marino","2025-01-16",0,0,0,0,0,0,0,0
"San Marino","2025-01-17",0,0,0,0,0,0,0,0
"San Marino","2025-01-18",0,0,0,0,0,0,0,0
"San Marino","2025-01-19",0,0,0,0,0,0,0,0
"San Marino","2025-01-20",0,0,0,0,0,0,0,0
"San Marino","2025-01-21",0,0,0,0,0,0,0,0
"San Marino","2025-01-22",0,0,0,0,0,0,0,0
"San Marino","2025-01-23",0,0,0,0,0,0,0,0
"San Marino","2025-01-24",0,0,0,0,0,0,0,0
"San Marino","2025-01-25",0,0,0,0,0,0,0,0
"San Marino","2025-01-26",0,0,0,0,0,0,0,0
"San Marino","2025-01-27",0,0,0,0,0,0,0,0
"San Marino","2025-01-28",0,0,0,0,0,0,0,0
"San Marino","2025-01-29",0,0,0,0,0,0,0,0
"San Marino","2025-01-30",0,0,0,0,0,0,0,0
"San Marino","2025-01-31",0,0,0,0,0,0,0,0
"San Marino","2025-02-01",0,0,0,0,0,0,0,0
"San Marino","2025-02-02",0,0,0,0,0,0,0,0
"San Marino","2025-02-03",0,0,0,0,0,0,0,0
"San Marino","2025-02-04",0,0,0,0,0,0,0,0
"San Marino","2025-02-05",0,0,0,0,0,0,0,0
"San Marino","2025-02-06",0,0,0,0,0,0,0,0
"San Marino","2025-02-07",0,0,0,0,0,0,0,0
"San Marino","2025-02-08",0,0,0,0,0,0,0,0
"San Marino","2025-02-09",0,0,0,0,0,0,0,0
"San Marino","2025-02-10",0,0,0,0,0,0,0,0
"San Marino","2025-02-11",0,0,0,0,0,0,0,0
"San Marino","2025-02-12",0,0,0,0,0,0,0,0
"San Marino","2025-02-13",0,0,0,0,0,0,0,0
"San Marino","2025-02-14",0,0,0,0,0,0,0,0
"San Marino","2025-02-15",0,0,0,0,0,0,0,0
"San Marino","2025-02-16",0,0,0,0,0,0,0,0
"San Marino","2025-02-17",0,0,0,0,0,0,0,0
"San Marino","2025-02-18",0,0,0,0,0,0,0,0
"San Marino","2025-02-19",0,0,0,0,0,0,0,0
"San Marino","2025-02-20",0,0,0,0,0,0,0,0
"San Marino","2025-02-21",0,0,0,0,0,0,0,0
"San Marino","2025-02-22",0,0,0,0,0,0,0,0
"San Marino","2025-02-23",0,0,0,0,0,0,0,0
"San Marino","2025-02-24",0,0,0,0,0,0,0,0
"San Marino","2025-02-25",0,0,0,0,0,0,0,0
"San Marino","2025-02-26",0,0,0,0,0,0,0,0
"San Marino","2025-02-27",0,0,0,0,0,0,0,0
"San Marino","2025-02-28",0,0,0,0,0,0,0,0
"San Marino","2025-03-01",0,0,0,0,0,0,0,0
"San Marino","2025-03-02",0,0,0,0,0,0,0,0
"San Marino","2025-03-03",0,0,0,0,0,0,0,0
"Saudi Arabia","2024-01-01",0,0,0,0,0,0,0,0
"Saudi Arabia","2024-01-02",0,0,0,0,0,0,0,0
"Saudi Arabia","2024-01-03",0,0,0,0,0,0,0,0
"Saudi Arabia","2024-01-04",0,0,0,0,0,0,0,0
"Saudi Arabia","2024-01-05",0,0,0,0,0,0,0,0
"Saudi Arabia","2024-01-06",0,0,0,0,0,0,0,0
"Saudi Arabia","2024-01-07",0,0,0,0,0,0,0,0
"Saudi Arabia","2024-01-08",0,0,0,0,0,0,0,0
"Saudi Arabia","2024-01-09",0,0,0,0,0,0,0,0
"Saudi Arabia","2024-01-10",0,0,0,0,0,0,0,0
"Saudi Arabia","2024-01-11",0,0,0,0,0,0,0,0
"Saudi Arabia","2024-01-12",0,0,0,0,0,0,0,0
"Saudi Arabia","2024-01-13",0,0,0,0,0,0,0,0
"Saudi Arabia","2024-01-14",0,0,0,0,0,0,0,0
"Saudi Arabia","2024-01-15",0,0,0,0,0,0,0,0
"Saudi Arabia","2024-01-16",0,0,0,0,0,0,0,0
"Saudi Arabia","2024-01-17",0,0,0,0,0,0,0,0
"Saudi Arabia","2024-01-18",0,0,0,0,0,0,0,0
"Saudi Arabia","2024-01-19",0,0,0,0,0,0,0,0
"Saudi Arabia","2024-01-20",0,0,0,0,0,0,0,0
"Saudi Arabia","2024-01-21",0,0,0,0,0,0,0,0
"Saudi Arabia","2024-01-22",0,0,0,0,0,0,0,0
"Saudi Arabia","2024-01-23",0,0,0,0,0,0,0,0
"Saudi Arabia","2024-01-24",0,0,0,0,0,0,0,0
"Saudi Arabia","2024-01-25",0,0,0,0,0,0,0,0
"Saudi Arabia","2024-01-26",0,0,0,0,0,0,0,0
"Saudi Arabia","2024-01-27",0,0,0,0,0,0,0,0
"Saudi Arabia","2024-01-28",0,0,0,0,0,0,0,0
"Saudi Arabia","2024-01-29",0,0,0,0,0,0,0,0
"Saudi Arabia","2024-01-30",0,0,0,0,0,0,0,0
"Saudi Arabia","2024-01-31",0,16,16,0,16,16,0,0
"Saudi Arabia","2024-02-01",0,0,16,0,1,17,0,0
"Saudi Arabia","2024-02-02",0,0,16,0,0,17,0,0
"Saudi Arabia","2024-02-03",0,0,16,0,1,18,0,0
"Saudi Arabia","2024-02-04",0,0,16,0,0,18,0,0
"Saudi Arabia","2024-02-05",0,0,16,0,1,19,0,0
"Saudi Arabia","2024-02-06",0,0,16,0,0,19,0,0
"Saudi Arabia","2024-02-07",0,0,16,0,1,20,0,0
"Saudi Arabia","2024-02-08",0,0,16,0,0,20,0,0
"Saudi Arabia","2024-02-09",0,0,16,0,1,21,0,0
"Saudi Arabia","2024-02-10",0,0,16,0,0,21,0,0
"Saudi Arabia","2024-02-11",0,0,16,0,1,22,0,0
"Saudi Arabia","2024-02-12",0,0,16,0,0,22,0,0
"Saudi Arabia","2024-02-13",0,0,16,0,1,23,0,0
"Saudi Arabia","2024-02-14",0,0,16,0,1,24,0,0
"Saudi Arabia","2024-02-15",0,0,16,0,0,24,0,0
"Saudi Arabia","2024-02-16",0,0,16,0,1,25,0,0
"Saudi Arabia","2024-02-17",0,0,16,0,0,25,0,0
"Saudi Arabia","2024-02-18",0,0,16,0,1,26,0,0
"Saudi Arabia","2024-02-19",0,0,16,0,0,26,0,0
"Saudi Arabia","2024-02-20",0,0,16,0,1,27,0,0
"Saudi Arabia","2024-02-21",0,0,16,0,0,27,0,0
"Saudi Arabia","2024-02-22",0,0,16,0,1,28,0,0
"Saudi Arabia","2024-02-23",0,0,16,0,0,28,0,0
"Saudi Arabia","2024-02-24",0,0,16,0,1,29,0,0
"Saudi Arabia","2024-02-25",0,0,16,0,0,29,0,0
"Saudi Arabia","2024-02-26",0,0,16,0,1,30,0,0
"Saudi Arabia","2024-02-27",0,0,16,0,0,30,0,0
"Saudi Arabia","2024-02-28",0,15,31,0,1,31,0,0
"Saudi Arabia","2024-02-29",0,0,31,0,1,32,0,0
"Saudi Arabia","2024-03-01",0,0,31,0,0,32,0,0
"Saudi Arabia","2024-03-02",0,0,31,0,1,33,0,0
"Saudi Arabia","2024-03-03",0,0,31,0,0,33,0,0
"Saudi Arabia","2024-03-04",0,0,31,0,1,34,0,0
"Saudi Arabia","2024-03-05",0,0,31,0,1,35,0,0
"Saudi Arabia","2024-03-06",0,0,31,0,0,35,0,0
"Saudi Arabia","2024-03-07",0,0,31,0,1,36,0,0
"Saudi Arabia","2024-03-08",0,0,31,0,1,37,0,0
"Saudi Arabia","2024-03-09",0,0,31,0,0,37,0,0
"Saudi Arabia","2024-03-10",0,0,31,0,1,38,0,0
"Saudi Arabia","2024-03-11",0,0,31,0,1,39,0,0
"Saudi Arabia","2024-03-12",0,0,31,0,0,39,0,0
"Saudi Arabia","2024-03-13",0,0,31,0,1,40,0,0
"Saudi Arabia","2024-03-14",0,0,31,0,0,40,0,0
"Saudi Arabia","2024-03-15",0,0,31,0,1,41,0,0
"Saudi Arabia","2024-03-16",0,0,31,0,1,42,0,0
"Saudi Arabia","2024-03-17",0,0,31,0,0,42,0,0
"Saudi Arabia","2024-03-18",0,0,31,0,1,43,0,0
"Saudi Arabia","2024-03-19",0,0,31,0,0,43,0,0
"Saudi Arabia","2024-03-20",0,0,31,0,1,44,0,0
"Saudi Arabia","2024-03-21",0,0,31,0,1,45,0,0
"Saudi Arabia","2024-03-22",0,0,31,0,0,45,0,0
"Saudi Arabia","2024-03-23",0,0,31,0,1,46,0,0
"Saudi Arabia","2024-03-24",0,0,31,0,1,47,0,0
"Saudi Arabia","2024-03-25",0,0,31,0,0,47,0,0
"Saudi Arabia","2024-03-26",0,0,31,0,1,48,0,0
"Saudi Arabia","2024-03-27",0,0,31,0,1,49,0,0
"Saudi Arabia","2024-03-28",0,0,31,0,0,49,0,0
"Saudi Arabia","2024-03-29",0,0,31,0,1,50,0,0
"Saudi Arabia","2024-03-30",0,0,31,0,0,50,0,0
"Saudi Arabia","2024-03-31",0,20,51,0,1,51,0,0
"Saudi Arabia","2024-04-01",0,0,51,0,0,51,0,0
"Saudi Arabia","2024-04-02",0,0,51,0,1,52,0,0
"Saudi Arabia","2024-04-03",0,0,51,0,0,52,0,0
"Saudi Arabia","2024-04-04",0,0,51,0,1,53,0,0
"Saudi Arabia","2024-04-05",0,0,51,0,0,53,0,0
"Saudi Arabia","2024-04-06",0,0,51,0,1,54,0,0
"Saudi Arabia","2024-04-07",0,0,51,0,0,54,0,0
"Saudi Arabia","2024-04-08",0,0,51,0,0,54,0,0
"Saudi Arabia","2024-04-09",0,0,51,0,1,55,0,0
"Saudi Arabia","2024-04-10",0,0,51,0,0,55,0,0
"Saudi Arabia","2024-04-11",0,0,51,0,1,56,0,0
"Saudi Arabia","2024-04-12",0,0,51,0,0,56,0,0
"Saudi Arabia","2024-04-13",0,0,51,0,1,57,0,0
"Saudi Arabia","2024-04-14",0,0,51,0,0,57,0,0
"Saudi Arabia","2024-04-15",0,0,51,0,0,57,0,0
"Saudi Arabia","2024-04-16",0,0,51,0,1,58,0,0
"Saudi Arabia","2024-04-17",0,0,51,0,0,58,0,0
"Saudi Arabia","2024-04-18",0,0,51,0,1,59,0,0
"Saudi Arabia","2024-04-19",0,0,51,0,0,59,0,0
"Saudi Arabia","2024-04-20",0,0,51,0,1,60,0,0
"Saudi Arabia","2024-04-21",0,0,51,0,0,60,0,0
"Saudi Arabia","2024-04-22",0,0,51,0,1,61,0,0
"Saudi Arabia","2024-04-23",0,0,51,0,0,61,0,0
"Saudi Arabia","2024-04-24",0,0,51,0,0,61,0,0
"Saudi Arabia","2024-04-25",0,0,51,0,1,62,0,0
"Saudi Arabia","2024-04-26",0,0,51,0,0,62,0,0
"Saudi Arabia","2024-04-27",0,0,51,0,1,63,0,0
"Saudi Arabia","2024-04-28",0,0,51,0,0,63,0,0
"Saudi Arabia","2024-04-29",0,0,51,0,1,64,0,0
"Saudi Arabia","2024-04-30",0,13,64,0,0,64,0,0
"Saudi Arabia","2024-05-01",0,0,64,0,0,64,0,0
"Saudi Arabia","2024-05-02",0,0,64,0,1,65,0,0
"Saudi Arabia","2024-05-03",0,0,64,0,0,65,0,0
"Saudi Arabia","2024-05-04",0,0,64,0,1,66,0,0
"Saudi Arabia","2024-05-05",0,0,64,0,0,66,0,0
"Saudi Arabia","2024-05-06",0,0,64,0,1,67,0,0
"Saudi Arabia","2024-05-07",0,0,64,0,0,67,0,0
"Saudi Arabia","2024-05-08",0,0,64,0,1,68,0,0
"Saudi Arabia","2024-05-09",0,0,64,0,0,68,0,0
"Saudi Arabia","2024-05-10",0,0,64,0,1,69,0,0
"Saudi Arabia","2024-05-11",0,0,64,0,0,69,0,0
"Saudi Arabia","2024-05-12",0,0,64,0,1,70,0,0
"Saudi Arabia","2024-05-13",0,0,64,0,0,70,0,0
"Saudi Arabia","2024-05-14",0,0,64,0,1,71,0,0
"Saudi Arabia","2024-05-15",0,0,64,0,0,71,0,0
"Saudi Arabia","2024-05-16",0,0,64,0,1,72,0,0
"Saudi Arabia","2024-05-17",0,0,64,0,0,72,0,0
"Saudi Arabia","2024-05-18",0,0,64,0,1,73,0,0
"Saudi Arabia","2024-05-19",0,0,64,0,0,73,0,0
"Saudi Arabia","2024-05-20",0,0,64,0,1,74,0,0
"Saudi Arabia","2024-05-21",0,0,64,0,0,74,0,0
"Saudi Arabia","2024-05-22",0,0,64,0,1,75,0,0
"Saudi Arabia","2024-05-23",0,0,64,0,0,75,0,0
"Saudi Arabia","2024-05-24",0,0,64,0,1,76,0,0
"Saudi Arabia","2024-05-25",0,0,64,0,0,76,0,0
"Saudi Arabia","2024-05-26",0,0,64,0,1,77,0,0
"Saudi Arabia","2024-05-27",0,0,64,0,0,77,0,0
"Saudi Arabia","2024-05-28",0,0,64,0,1,78,0,0
"Saudi Arabia","2024-05-29",0,0,64,0,0,78,0,0
"Saudi Arabia","2024-05-30",0,0,64,0,1,79,0,0
"Saudi Arabia","2024-05-31",0,15,79,0,0,79,0,0
"Saudi Arabia","2024-06-01",0,0,79,0,0,79,0,0
"Saudi Arabia","2024-06-02",0,0,79,0,0,79,0,0
"Saudi Arabia","2024-06-03",0,0,79,0,1,80,0,0
"Saudi Arabia","2024-06-04",0,0,79,0,0,80,0,0
"Saudi Arabia","2024-06-05",0,0,79,0,0,80,0,0
"Saudi Arabia","2024-06-06",0,0,79,0,0,80,0,0
"Saudi Arabia","2024-06-07",0,0,79,0,0,80,0,0
"Saudi Arabia","2024-06-08",0,0,79,0,1,81,0,0
"Saudi Arabia","2024-06-09",0,0,79,0,0,81,0,0
"Saudi Arabia","2024-06-10",0,0,79,0,0,81,0,0
"Saudi Arabia","2024-06-11",0,0,79,0,0,81,0,0
"Saudi Arabia","2024-06-12",0,0,79,0,0,81,0,0
"Saudi Arabia","2024-06-13",0,0,79,0,1,82,0,0
"Saudi Arabia","2024-06-14",0,0,79,0,0,82,0,0
"Saudi Arabia","2024-06-15",0,0,79,0,0,82,0,0
"Saudi Arabia","2024-06-16",0,0,79,0,0,82,0,0
"Saudi Arabia","2024-06-17",0,0,79,0,0,82,0,0
"Saudi Arabia","2024-06-18",0,0,79,0,1,83,0,0
"Saudi Arabia","2024-06-19",0,0,79,0,0,83,0,0
"Saudi Arabia","2024-06-20",0,0,79,0,0,83,0,0
"Saudi Arabia","2024-06-21",0,0,79,0,0,83,0,0
"Saudi Arabia","2024-06-22",0,0,79,0,0,83,0,0
"Saudi Arabia","2024-06-23",0,0,79,0,1,84,0,0
"Saudi Arabia","2024-06-24",0,0,79,0,0,84,0,0
"Saudi Arabia","2024-06-25",0,0,79,0,0,84,0,0
"Saudi Arabia","2024-06-26",0,0,79,0,0,84,0,0
"Saudi Arabia","2024-06-27",0,0,79,0,0,84,0,0
"Saudi Arabia","2024-06-28",0,0,79,0,1,85,0,0
"Saudi Arabia","2024-06-29",0,0,79,0,0,85,0,0
"Saudi Arabia","2024-06-30",0,6,85,0,0,85,0,0
"Saudi Arabia","2024-07-01",0,0,85,0,0,85,0,0
"Saudi Arabia","2024-07-02",0,0,85,0,1,86,0,0
"Saudi Arabia","2024-07-03",0,0,85,0,0,86,0,0
"Saudi Arabia","2024-07-04",0,0,85,0,0,86,0,0
"Saudi Arabia","2024-07-05",0,0,85,0,0,86,0,0
"Saudi Arabia","2024-07-06",0,0,85,0,1,87,0,0
"Saudi Arabia","2024-07-07",0,0,85,0,0,87,0,0
"Saudi Arabia","2024-07-08",0,0,85,0,0,87,0,0
"Saudi Arabia","2024-07-09",0,0,85,0,1,88,0,0
"Saudi Arabia","2024-07-10",0,0,85,0,0,88,0,0
"Saudi Arabia","2024-07-11",0,0,85,0,0,88,0,0
"Saudi Arabia","2024-07-12",0,0,85,0,0,88,0,0
"Saudi Arabia","2024-07-13",0,0,85,0,1,89,0,0
"Saudi Arabia","2024-07-14",0,0,85,0,0,89,0,0
"Saudi Arabia","2024-07-15",0,0,85,0,0,89,0,0
"Saudi Arabia","2024-07-16",0,0,85,0,1,90,0,0
"Saudi Arabia","2024-07-17",0,0,85,0,0,90,0,0
"Saudi Arabia","2024-07-18",0,0,85,0,0,90,0,0
"Saudi Arabia","2024-07-19",0,0,85,0,1,91,0,0
"Saudi Arabia","2024-07-20",0,0,85,0,0,91,0,0
"Saudi Arabia","2024-07-21",0,0,85,0,0,91,0,0
"Saudi Arabia","2024-07-22",0,0,85,0,0,91,0,0
"Saudi Arabia","2024-07-23",0,0,85,0,1,92,0,0
"Saudi Arabia","2024-07-24",0,0,85,0,0,92,0,0
"Saudi Arabia","2024-07-25",0,0,85,0,0,92,0,0
"Saudi Arabia","2024-07-26",0,0,85,0,1,93,0,0
"Saudi Arabia","2024-07-27",0,0,85,0,0,93,0,0
"Saudi Arabia","2024-07-28",0,0,85,0,0,93,0,0
"Saudi Arabia","2024-07-29",0,0,85,0,0,93,0,0
"Saudi Arabia","2024-07-30",0,0,85,0,1,94,0,0
"Saudi Arabia","2024-07-31",0,9,94,0,0,94,0,0
"Saudi Arabia","2024-08-01",0,0,94,0,0,94,0,0
"Saudi Arabia","2024-08-02",0,0,94,0,0,94,0,0
"Saudi Arabia","2024-08-03",0,0,94,0,0,94,0,0
"Saudi Arabia","2024-08-04",0,0,94,0,0,94,0,0
"Saudi Arabia","2024-08-05",0,0,94,0,0,94,0,0
"Saudi Arabia","2024-08-06",0,0,94,0,0,94,0,0
"Saudi Arabia","2024-08-07",0,0,94,0,0,94,0,0
"Saudi Arabia","2024-08-08",0,0,94,0,0,94,0,0
"Saudi Arabia","2024-08-09",0,0,94,0,0,94,0,0
"Saudi Arabia","2024-08-10",0,0,94,0,0,94,0,0
"Saudi Arabia","2024-08-11",0,0,94,0,1,95,0,0
"Saudi Arabia","2024-08-12",0,0,94,0,0,95,0,0
"Saudi Arabia","2024-08-13",0,0,94,0,0,95,0,0
"Saudi Arabia","2024-08-14",0,0,94,0,0,95,0,0
"Saudi Arabia","2024-08-15",0,0,94,0,0,95,0,0
"Saudi Arabia","2024-08-16",0,0,94,0,0,95,0,0
"Saudi Arabia","2024-08-17",0,0,94,0,0,95,0,0
"Saudi Arabia","2024-08-18",0,0,94,0,0,95,0,0
"Saudi Arabia","2024-08-19",0,0,94,0,0,95,0,0
"Saudi Arabia","2024-08-20",0,0,94,0,0,95,0,0
"Saudi Arabia","2024-08-21",0,1,95,0,0,95,0,0
"Saudi Arabia","2024-08-22",0,0,95,0,0,95,0,0
"Saudi Arabia","2024-08-23",0,0,95,0,0,95,0,0
"Saudi Arabia","2024-08-24",0,0,95,0,0,95,0,0
"Saudi Arabia","2024-08-25",0,0,95,0,0,95,0,0
"Saudi Arabia","2024-08-26",0,0,95,0,0,95,0,0
"Saudi Arabia","2024-08-27",0,0,95,0,0,95,0,0
"Saudi Arabia","2024-08-28",0,0,95,0,0,95,0,0
"Saudi Arabia","2024-08-29",0,0,95,0,0,95,0,0
"Saudi Arabia","2024-08-30",0,0,95,0,0,95,0,0
"Saudi Arabia","2024-08-31",0,0,95,0,0,95,0,0
"Saudi Arabia","2024-09-01",0,0,95,0,0,95,0,0
"Saudi Arabia","2024-09-02",0,0,95,0,0,95,0,0
"Saudi Arabia","2024-09-03",0,0,95,0,0,95,0,0
"Saudi Arabia","2024-09-04",0,0,95,0,0,95,0,0
"Saudi Arabia","2024-09-05",0,0,95,0,0,95,0,0
"Saudi Arabia","2024-09-06",0,0,95,0,0,95,0,0
"Saudi Arabia","2024-09-07",0,0,95,0,0,95,0,0
"Saudi Arabia","2024-09-08",0,0,95,0,0,95,0,0
"Saudi Arabia","2024-09-09",0,0,95,0,0,95,0,0
"Saudi Arabia","2024-09-10",0,0,95,0,0,95,0,0
"Saudi Arabia","2024-09-11",0,0,95,0,0,95,0,0
"Saudi Arabia","2024-09-12",0,0,95,0,0,95,0,0
"Saudi Arabia","2024-09-13",0,0,95,0,0,95,0,0
"Saudi Arabia","2024-09-14",0,0,95,0,0,95,0,0
"Saudi Arabia","2024-09-15",0,0,95,0,0,95,0,0
"Saudi Arabia","2024-09-16",0,0,95,0,0,95,0,0
"Saudi Arabia","2024-09-17",0,0,95,0,0,95,0,0
"Saudi Arabia","2024-09-18",0,0,95,0,0,95,0,0
"Saudi Arabia","2024-09-19",0,0,95,0,0,95,0,0
"Saudi Arabia","2024-09-20",0,0,95,0,0,95,0,0
"Saudi Arabia","2024-09-21",0,0,95,0,0,95,0,0
"Saudi Arabia","2024-09-22",0,0,95,0,0,95,0,0
"Saudi Arabia","2024-09-23",0,0,95,0,0,95,0,0
"Saudi Arabia","2024-09-24",0,0,95,0,0,95,0,0
"Saudi Arabia","2024-09-25",0,0,95,0,0,95,0,0
"Saudi Arabia","2024-09-26",0,0,95,0,0,95,0,0
"Saudi Arabia","2024-09-27",0,0,95,0,0,95,0,0
"Saudi Arabia","2024-09-28",0,0,95,0,0,95,0,0
"Saudi Arabia","2024-09-29",0,0,95,0,0,95,0,0
"Saudi Arabia","2024-09-30",0,0,95,0,0,95,0,0
"Saudi Arabia","2024-10-01",0,0,95,0,0,95,0,0
"Saudi Arabia","2024-10-02",0,0,95,0,0,95,0,0
"Saudi Arabia","2024-10-03",0,0,95,0,0,95,0,0
"Saudi Arabia","2024-10-04",0,0,95,0,0,95,0,0
"Saudi Arabia","2024-10-05",0,0,95,0,0,95,0,0
"Saudi Arabia","2024-10-06",0,0,95,0,0,95,0,0
"Saudi Arabia","2024-10-07",0,0,95,0,0,95,0,0
"Saudi Arabia","2024-10-08",0,0,95,0,0,95,0,0
"Saudi Arabia","2024-10-09",0,0,95,0,0,95,0,0
"Saudi Arabia","2024-10-10",0,0,95,0,0,95,0,0
"Saudi Arabia","2024-10-11",0,0,95,0,0,95,0,0
"Saudi Arabia","2024-10-12",0,0,95,0,0,95,0,0
"Saudi Arabia","2024-10-13",0,0,95,0,0,95,0,0
"Saudi Arabia","2024-10-14",0,0,95,0,0,95,0,0
"Saudi Arabia","2024-10-15",0,0,95,0,0,95,0,0
"Saudi Arabia","2024-10-16",0,0,95,0,0,95,0,0
"Saudi Arabia","2024-10-17",0,0,95,0,0,95,0,0
"Saudi Arabia","2024-10-18",0,0,95,0,0,95,0,0
"Saudi Arabia","2024-10-19",0,0,95,0,0,95,0,0
"Saudi Arabia","2024-10-20",0,0,95,0,0,95,0,0
"Saudi Arabia","2024-10-21",0,0,95,0,0,95,0,0
"Saudi Arabia","2024-10-22",0,0,95,0,0,95,0,0
"Saudi Arabia","2024-10-23",0,0,95,0,0,95,0,0
"Saudi Arabia","2024-10-24",0,0,95,0,0,95,0,0
"Saudi Arabia","2024-10-25",0,0,95,0,0,95,0,0
"Saudi Arabia","2024-10-26",0,0,95,0,0,95,0,0
"Saudi Arabia","2024-10-27",0,0,95,0,0,95,0,0
"Saudi Arabia","2024-10-28",0,0,95,0,0,95,0,0
"Saudi Arabia","2024-10-29",0,0,95,0,0,95,0,0
"Saudi Arabia","2024-10-30",0,0,95,0,0,95,0,0
"Saudi Arabia","2024-10-31",0,0,95,0,0,95,0,0
"Saudi Arabia","2024-11-01",0,0,95,0,0,95,0,0
"Saudi Arabia","2024-11-02",0,0,95,0,0,95,0,0
"Saudi Arabia","2024-11-03",0,0,95,0,0,95,0,0
"Saudi Arabia","2024-11-04",0,0,95,0,0,95,0,0
"Saudi Arabia","2024-11-05",0,0,95,0,0,95,0,0
"Saudi Arabia","2024-11-06",0,0,95,0,0,95,0,0
"Saudi Arabia","2024-11-07",0,0,95,0,0,95,0,0
"Saudi Arabia","2024-11-08",0,0,95,0,0,95,0,0
"Saudi Arabia","2024-11-09",0,0,95,0,0,95,0,0
"Saudi Arabia","2024-11-10",0,0,95,0,0,95,0,0
"Saudi Arabia","2024-11-11",0,0,95,0,0,95,0,0
"Saudi Arabia","2024-11-12",0,0,95,0,0,95,0,0
"Saudi Arabia","2024-11-13",0,0,95,0,0,95,0,0
"Saudi Arabia","2024-11-14",0,0,95,0,0,95,0,0
"Saudi Arabia","2024-11-15",0,0,95,0,0,95,0,0
"Saudi Arabia","2024-11-16",0,0,95,0,0,95,0,0
"Saudi Arabia","2024-11-17",0,0,95,0,0,95,0,0
"Saudi Arabia","2024-11-18",0,0,95,0,0,95,0,0
"Saudi Arabia","2024-11-19",0,0,95,0,0,95,0,0
"Saudi Arabia","2024-11-20",0,0,95,0,0,95,0,0
"Saudi Arabia","2024-11-21",0,0,95,0,0,95,0,0
"Saudi Arabia","2024-11-22",0,0,95,0,0,95,0,0
"Saudi Arabia","2024-11-23",0,0,95,0,0,95,0,0
"Saudi Arabia","2024-11-24",0,0,95,0,0,95,0,0
"Saudi Arabia","2024-11-25",0,0,95,0,0,95,0,0
"Saudi Arabia","2024-11-26",0,0,95,0,0,95,0,0
"Saudi Arabia","2024-11-27",0,0,95,0,0,95,0,0
"Saudi Arabia","2024-11-28",0,0,95,0,0,95,0,0
"Saudi Arabia","2024-11-29",0,0,95,0,0,95,0,0
"Saudi Arabia","2024-11-30",0,0,95,0,0,95,0,0
"Saudi Arabia","2024-12-01",0,0,95,0,0,95,0,0
"Saudi Arabia","2024-12-02",0,0,95,0,0,95,0,0
"Saudi Arabia","2024-12-03",0,0,95,0,0,95,0,0
"Saudi Arabia","2024-12-04",0,0,95,0,0,95,0,0
"Saudi Arabia","2024-12-05",0,0,95,0,0,95,0,0
"Saudi Arabia","2024-12-06",0,0,95,0,0,95,0,0
"Saudi Arabia","2024-12-07",0,0,95,0,0,95,0,0
"Saudi Arabia","2024-12-08",0,0,95,0,0,95,0,0
"Saudi Arabia","2024-12-09",0,0,95,0,0,95,0,0
"Saudi Arabia","2024-12-10",0,0,95,0,0,95,0,0
"Saudi Arabia","2024-12-11",0,0,95,0,0,95,0,0
"Saudi Arabia","2024-12-12",0,0,95,0,0,95,0,0
"Saudi Arabia","2024-12-13",0,0,95,0,0,95,0,0
"Saudi Arabia","2024-12-14",0,0,95,0,0,95,0,0
"Saudi Arabia","2024-12-15",0,0,95,0,0,95,0,0
"Saudi Arabia","2024-12-16",0,0,95,0,0,95,0,0
"Saudi Arabia","2024-12-17",0,0,95,0,0,95,0,0
"Saudi Arabia","2024-12-18",0,0,95,0,0,95,0,0
"Saudi Arabia","2024-12-19",0,0,95,0,0,95,0,0
"Saudi Arabia","2024-12-20",0,0,95,0,0,95,0,0
"Saudi Arabia","2024-12-21",0,0,95,0,0,95,0,0
"Saudi Arabia","2024-12-22",0,0,95,0,0,95,0,0
"Saudi Arabia","2024-12-23",0,0,95,0,0,95,0,0
"Saudi Arabia","2024-12-24",0,0,95,0,0,95,0,0
"Saudi Arabia","2024-12-25",0,0,95,0,0,95,0,0
"Saudi Arabia","2024-12-26",0,0,95,0,0,95,0,0
"Saudi Arabia","2024-12-27",0,0,95,0,0,95,0,0
"Saudi Arabia","2024-12-28",0,0,95,0,0,95,0,0
"Saudi Arabia","2024-12-29",0,0,95,0,0,95,0,0
"Saudi Arabia","2024-12-30",0,0,95,0,0,95,0,0
"Saudi Arabia","2024-12-31",0,0,95,0,0,95,0,0
"Saudi Arabia","2025-01-01",0,0,95,0,0,95,0,0
"Saudi Arabia","2025-01-02",0,0,95,0,0,95,0,0
"Saudi Arabia","2025-01-03",0,0,95,0,0,95,0,0
"Saudi Arabia","2025-01-04",0,0,95,0,0,95,0,0
"Saudi Arabia","2025-01-05",0,0,95,0,0,95,0,0
"Saudi Arabia","2025-01-06",0,0,95,0,0,95,0,0
"Saudi Arabia","2025-01-07",0,0,95,0,0,95,0,0
"Saudi Arabia","2025-01-08",0,0,95,0,0,95,0,0
"Saudi Arabia","2025-01-09",0,0,95,0,0,95,0,0
"Saudi Arabia","2025-01-10",0,0,95,0,0,95,0,0
"Saudi Arabia","2025-01-11",0,0,95,0,0,95,0,0
"Saudi Arabia","2025-01-12",0,0,95,0,0,95,0,0
"Saudi Arabia","2025-01-13",0,0,95,0,0,95,0,0
"Saudi Arabia","2025-01-14",0,0,95,0,0,95,0,0
"Saudi Arabia","2025-01-15",0,0,95,0,0,95,0,0
"Saudi Arabia","2025-01-16",0,0,95,0,0,95,0,0
"Saudi Arabia","2025-01-17",0,0,95,0,0,95,0,0
"Saudi Arabia","2025-01-18",0,0,95,0,0,95,0,0
"Saudi Arabia","2025-01-19",0,0,95,0,0,95,0,0
"Saudi Arabia","2025-01-20",0,0,95,0,0,95,0,0
"Saudi Arabia","2025-01-21",0,0,95,0,0,95,0,0
"Saudi Arabia","2025-01-22",0,0,95,0,0,95,0,0
"Saudi Arabia","2025-01-23",0,0,95,0,0,95,0,0
"Saudi Arabia","2025-01-24",0,0,95,0,0,95,0,0
"Saudi Arabia","2025-01-25",0,0,95,0,0,95,0,0
"Saudi Arabia","2025-01-26",0,0,95,0,0,95,0,0
"Saudi Arabia","2025-01-27",0,0,95,0,0,95,0,0
"Saudi Arabia","2025-01-28",0,0,95,0,0,95,0,0
"Saudi Arabia","2025-01-29",0,0,95,0,0,95,0,0
"Saudi Arabia","2025-01-30",0,0,95,0,0,95,0,0
"Saudi Arabia","2025-01-31",0,0,95,0,0,95,0,0
"Saudi Arabia","2025-02-01",0,0,95,0,0,95,0,0
"Saudi Arabia","2025-02-02",0,0,95,0,0,95,0,0
"Saudi Arabia","2025-02-03",0,0,95,0,0,95,0,0
"Saudi Arabia","2025-02-04",0,0,95,0,0,95,0,0
"Saudi Arabia","2025-02-05",0,0,95,0,0,95,0,0
"Saudi Arabia","2025-02-06",0,0,95,0,0,95,0,0
"Saudi Arabia","2025-02-07",0,0,95,0,0,95,0,0
"Saudi Arabia","2025-02-08",0,0,95,0,0,95,0,0
"Saudi Arabia","2025-02-09",0,0,95,0,0,95,0,0
"Saudi Arabia","2025-02-10",0,0,95,0,0,95,0,0
"Saudi Arabia","2025-02-11",0,0,95,0,0,95,0,0
"Saudi Arabia","2025-02-12",0,0,95,0,0,95,0,0
"Saudi Arabia","2025-02-13",0,0,95,0,0,95,0,0
"Saudi Arabia","2025-02-14",0,0,95,0,0,95,0,0
"Saudi Arabia","2025-02-15",0,0,95,0,0,95,0,0
"Saudi Arabia","2025-02-16",0,0,95,0,0,95,0,0
"Saudi Arabia","2025-02-17",0,0,95,0,0,95,0,0
"Saudi Arabia","2025-02-18",0,0,95,0,0,95,0,0
"Saudi Arabia","2025-02-19",0,0,95,0,0,95,0,0
"Saudi Arabia","2025-02-20",0,0,95,0,0,95,0,0
"Saudi Arabia","2025-02-21",0,0,95,0,0,95,0,0
"Saudi Arabia","2025-02-22",0,0,95,0,0,95,0,0
"Saudi Arabia","2025-02-23",0,0,95,0,0,95,0,0
"Saudi Arabia","2025-02-24",0,0,95,0,0,95,0,0
"Saudi Arabia","2025-02-25",0,0,95,0,0,95,0,0
"Saudi Arabia","2025-02-26",0,0,95,0,0,95,0,0
"Saudi Arabia","2025-02-27",0,0,95,0,0,95,0,0
"Saudi Arabia","2025-02-28",0,0,95,0,0,95,0,0
"Saudi Arabia","2025-03-01",0,0,95,0,0,95,0,0
"Saudi Arabia","2025-03-02",0,0,95,0,0,95,0,0
"Saudi Arabia","2025-03-03",0,0,95,0,0,95,0,0
"Serbia","2024-01-01",0,0,0,0,0,0,0,0
"Serbia","2024-01-02",0,0,0,0,0,0,0,0
"Serbia","2024-01-03",0,0,0,0,0,0,0,0
"Serbia","2024-01-04",0,0,0,0,0,0,0,0
"Serbia","2024-01-05",0,0,0,0,0,0,0,0
"Serbia","2024-01-06",0,0,0,0,0,0,0,0
"Serbia","2024-01-07",0,0,0,0,0,0,0,0
"Serbia","2024-01-08",0,0,0,0,0,0,0,0
"Serbia","2024-01-09",0,0,0,0,0,0,0,0
"Serbia","2024-01-10",0,0,0,0,0,0,0,0
"Serbia","2024-01-11",0,0,0,0,0,0,0,0
"Serbia","2024-01-12",0,0,0,0,0,0,0,0
"Serbia","2024-01-13",0,0,0,0,0,0,0,0
"Serbia","2024-01-14",0,0,0,0,0,0,0,0
"Serbia","2024-01-15",0,0,0,0,0,0,0,0
"Serbia","2024-01-16",0,0,0,0,0,0,0,0
"Serbia","2024-01-17",0,0,0,0,0,0,0,0
"Serbia","2024-01-18",0,0,0,0,0,0,0,0
"Serbia","2024-01-19",0,0,0,0,0,0,0,0
"Serbia","2024-01-20",0,0,0,0,0,0,0,0
"Serbia","2024-01-21",0,0,0,0,0,0,0,0
"Serbia","2024-01-22",0,0,0,0,0,0,0,0
"Serbia","2024-01-23",0,0,0,0,0,0,0,0
"Serbia","2024-01-24",0,0,0,0,0,0,0,0
"Serbia","2024-01-25",0,0,0,0,0,0,0,0
"Serbia","2024-01-26",0,0,0,0,0,0,0,0
"Serbia","2024-01-27",0,0,0,0,0,0,0,0
"Serbia","2024-01-28",0,0,0,0,0,0,0,0
"Serbia","2024-01-29",0,0,0,0,0,0,0,0
"Serbia","2024-01-30",0,0,0,0,0,0,0,0
"Serbia","2024-01-31",0,0,0,0,0,0,0,0
"Serbia","2024-02-01",0,0,0,0,0,0,0,0
"Serbia","2024-02-02",0,0,0,0,0,0,0,0
"Serbia","2024-02-03",0,0,0,0,0,0,0,0
"Serbia","2024-02-04",0,0,0,0,0,0,0,0
"Serbia","2024-02-05",0,0,0,0,0,0,0,0
"Serbia","2024-02-06",0,0,0,0,0,0,0,0
"Serbia","2024-02-07",0,0,0,0,0,0,0,0
"Serbia","2024-02-08",0,0,0,0,0,0,0,0
"Serbia","2024-02-09",0,0,0,0,0,0,0,0
"Serbia","2024-02-10",0,0,0,0,0,0,0,0
"Serbia","2024-02-11",0,0,0,0,0,0,0,0
"Serbia","2024-02-12",0,0,0,0,0,0,0,0
"Serbia","2024-02-13",0,0,0,0,0,0,0,0
"Serbia","2024-02-14",0,0,0,0,0,0,0,0
"Serbia","2024-02-15",0,0,0,0,0,0,0,0
"Serbia","2024-02-16",0,0,0,0,0,0,0,0
"Serbia","2024-02-17",0,0,0,0,0,0,0,0
"Serbia","2024-02-18",0,0,0,0,0,0,0,0
"Serbia","2024-02-19",0,0,0,0,0,0,0,0
"Serbia","2024-02-20",0,0,0,0,0,0,0,0
"Serbia","2024-02-21",0,0,0,0,0,0,0,0
"Serbia","2024-02-22",0,0,0,0,0,0,0,0
"Serbia","2024-02-23",0,0,0,0,0,0,0,0
"Serbia","2024-02-24",0,0,0,0,0,0,0,0
"Serbia","2024-02-25",0,0,0,0,0,0,0,0
"Serbia","2024-02-26",0,0,0,0,0,0,0,0
"Serbia","2024-02-27",0,0,0,0,0,0,0,0
"Serbia","2024-02-28",0,0,0,0,0,0,0,0
"Serbia","2024-02-29",0,0,0,0,0,0,0,0
"Serbia","2024-03-01",0,0,0,0,0,0,0,0
"Serbia","2024-03-02",0,0,0,0,0,0,0,0
"Serbia","2024-03-03",0,0,0,0,0,0,0,0
"Serbia","2024-03-04",0,0,0,0,0,0,0,0
"Serbia","2024-03-05",0,0,0,0,0,0,0,0
"Serbia","2024-03-06",0,0,0,0,0,0,0,0
"Serbia","2024-03-07",0,0,0,0,0,0,0,0
"Serbia","2024-03-08",0,0,0,0,0,0,0,0
"Serbia","2024-03-09",0,0,0,0,0,0,0,0
"Serbia","2024-03-10",0,0,0,0,0,0,0,0
"Serbia","2024-03-11",0,0,0,0,0,0,0,0
"Serbia","2024-03-12",0,0,0,0,0,0,0,0
"Serbia","2024-03-13",0,0,0,0,0,0,0,0
"Serbia","2024-03-14",0,0,0,0,0,0,0,0
"Serbia","2024-03-15",0,0,0,0,0,0,0,0
"Serbia","2024-03-16",0,0,0,0,0,0,0,0
"Serbia","2024-03-17",0,0,0,0,0,0,0,0
"Serbia","2024-03-18",0,0,0,0,0,0,0,0
"Serbia","2024-03-19",0,0,0,0,0,0,0,0
"Serbia","2024-03-20",0,0,0,0,0,0,0,0
"Serbia","2024-03-21",0,0,0,0,0,0,0,0
"Serbia","2024-03-22",0,0,0,0,0,0,0,0
"Serbia","2024-03-23",0,0,0,0,0,0,0,0
"Serbia","2024-03-24",0,0,0,0,0,0,0,0
"Serbia","2024-03-25",0,0,0,0,0,0,0,0
"Serbia","2024-03-26",0,0,0,0,0,0,0,0
"Serbia","2024-03-27",0,0,0,0,0,0,0,0
"Serbia","2024-03-28",0,0,0,0,0,0,0,0
"Serbia","2024-03-29",0,0,0,0,0,0,0,0
"Serbia","2024-03-30",0,0,0,0,0,0,0,0
"Serbia","2024-03-31",0,0,0,0,0,0,0,0
"Serbia","2024-04-01",0,0,0,0,0,0,0,0
"Serbia","2024-04-02",0,0,0,0,0,0,0,0
"Serbia","2024-04-03",0,0,0,0,0,0,0,0
"Serbia","2024-04-04",0,0,0,0,0,0,0,0
"Serbia","2024-04-05",0,0,0,0,0,0,0,0
"Serbia","2024-04-06",0,0,0,0,0,0,0,0
"Serbia","2024-04-07",0,0,0,0,0,0,0,0
"Serbia","2024-04-08",0,0,0,0,0,0,0,0
"Serbia","2024-04-09",0,0,0,0,0,0,0,0
"Serbia","2024-04-10",0,0,0,0,0,0,0,0
"Serbia","2024-04-11",0,0,0,0,0,0,0,0
"Serbia","2024-04-12",0,0,0,0,0,0,0,0
"Serbia","2024-04-13",0,0,0,0,0,0,0,0
"Serbia","2024-04-14",0,0,0,0,0,0,0,0
"Serbia","2024-04-15",0,0,0,0,0,0,0,0
"Serbia","2024-04-16",0,0,0,0,0,0,0,0
"Serbia","2024-04-17",0,0,0,0,0,0,0,0
"Serbia","2024-04-18",0,0,0,0,0,0,0,0
"Serbia","2024-04-19",0,0,0,0,0,0,0,0
"Serbia","2024-04-20",0,0,0,0,0,0,0,0
"Serbia","2024-04-21",0,0,0,0,0,0,0,0
"Serbia","2024-04-22",0,0,0,0,0,0,0,0
"Serbia","2024-04-23",0,0,0,0,0,0,0,0
"Serbia","2024-04-24",0,0,0,0,0,0,0,0
"Serbia","2024-04-25",0,0,0,0,0,0,0,0
"Serbia","2024-04-26",0,0,0,0,0,0,0,0
"Serbia","2024-04-27",0,0,0,0,0,0,0,0
"Serbia","2024-04-28",0,0,0,0,0,0,0,0
"Serbia","2024-04-29",0,0,0,0,0,0,0,0
"Serbia","2024-04-30",0,0,0,0,0,0,0,0
"Serbia","2024-05-01",0,0,0,0,0,0,0,0
"Serbia","2024-05-02",0,0,0,0,0,0,0,0
"Serbia","2024-05-03",0,0,0,0,0,0,0,0
"Serbia","2024-05-04",0,0,0,0,0,0,0,0
"Serbia","2024-05-05",0,0,0,0,0,0,0,0
"Serbia","2024-05-06",0,0,0,0,0,0,0,0
"Serbia","2024-05-07",0,0,0,0,0,0,0,0
"Serbia","2024-05-08",0,0,0,0,0,0,0,0
"Serbia","2024-05-09",0,0,0,0,0,0,0,0
"Serbia","2024-05-10",0,0,0,0,0,0,0,0
"Serbia","2024-05-11",0,0,0,0,0,0,0,0
"Serbia","2024-05-12",0,0,0,0,0,0,0,0
"Serbia","2024-05-13",0,0,0,0,0,0,0,0
"Serbia","2024-05-14",0,0,0,0,0,0,0,0
"Serbia","2024-05-15",0,0,0,0,0,0,0,0
"Serbia","2024-05-16",0,0,0,0,0,0,0,0
"Serbia","2024-05-17",0,0,0,0,0,0,0,0
"Serbia","2024-05-18",0,0,0,0,0,0,0,0
"Serbia","2024-05-19",0,0,0,0,0,0,0,0
"Serbia","2024-05-20",0,0,0,0,0,0,0,0
"Serbia","2024-05-21",0,0,0,0,0,0,0,0
"Serbia","2024-05-22",0,0,0,0,0,0,0,0
"Serbia","2024-05-23",0,0,0,0,0,0,0,0
"Serbia","2024-05-24",0,0,0,0,0,0,0,0
"Serbia","2024-05-25",0,0,0,0,0,0,0,0
"Serbia","2024-05-26",0,0,0,0,0,0,0,0
"Serbia","2024-05-27",0,0,0,0,0,0,0,0
"Serbia","2024-05-28",0,0,0,0,0,0,0,0
"Serbia","2024-05-29",0,0,0,0,0,0,0,0
"Serbia","2024-05-30",0,0,0,0,0,0,0,0
"Serbia","2024-05-31",0,0,0,0,0,0,0,0
"Serbia","2024-06-01",0,0,0,0,0,0,0,0
"Serbia","2024-06-02",0,0,0,0,0,0,0,0
"Serbia","2024-06-03",0,0,0,0,0,0,0,0
"Serbia","2024-06-04",0,0,0,0,0,0,0,0
"Serbia","2024-06-05",0,0,0,0,0,0,0,0
"Serbia","2024-06-06",0,0,0,0,0,0,0,0
"Serbia","2024-06-07",0,0,0,0,0,0,0,0
"Serbia","2024-06-08",0,0,0,0,0,0,0,0
"Serbia","2024-06-09",0,0,0,0,0,0,0,0
"Serbia","2024-06-10",0,0,0,0,0,0,0,0
"Serbia","2024-06-11",0,0,0,0,0,0,0,0
"Serbia","2024-06-12",0,0,0,0,0,0,0,0
"Serbia","2024-06-13",0,0,0,0,0,0,0,0
"Serbia","2024-06-14",0,0,0,0,0,0,0,0
"Serbia","2024-06-15",0,0,0,0,0,0,0,0
"Serbia","2024-06-16",0,0,0,0,0,0,0,0
"Serbia","2024-06-17",0,0,0,0,0,0,0,0
"Serbia","2024-06-18",0,0,0,0,0,0,0,0
"Serbia","2024-06-19",0,0,0,0,0,0,0,0
"Serbia","2024-06-20",0,0,0,0,0,0,0,0
"Serbia","2024-06-21",0,0,0,0,0,0,0,0
"Serbia","2024-06-22",0,0,0,0,0,0,0,0
"Serbia","2024-06-23",0,0,0,0,0,0,0,0
"Serbia","2024-06-24",0,0,0,0,0,0,0,0
"Serbia","2024-06-25",0,0,0,0,0,0,0,0
"Serbia","2024-06-26",0,0,0,0,0,0,0,0
"Serbia","2024-06-27",0,0,0,0,0,0,0,0
"Serbia","2024-06-28",0,0,0,0,0,0,0,0
"Serbia","2024-06-29",0,0,0,0,0,0,0,0
"Serbia","2024-06-30",0,0,0,0,0,0,0,0
"Serbia","2024-07-01",0,0,0,0,0,0,0,0
"Serbia","2024-07-02",0,0,0,0,0,0,0,0
"Serbia","2024-07-03",0,0,0,0,0,0,0,0
"Serbia","2024-07-04",0,0,0,0,0,0,0,0
"Serbia","2024-07-05",0,0,0,0,0,0,0,0
"Serbia","2024-07-06",0,0,0,0,0,0,0,0
"Serbia","2024-07-07",0,0,0,0,0,0,0,0
"Serbia","2024-07-08",0,0,0,0,0,0,0,0
"Serbia","2024-07-09",0,0,0,0,0,0,0,0
"Serbia","2024-07-10",0,0,0,0,0,0,0,0
"Serbia","2024-07-11",0,0,0,0,0,0,0,0
"Serbia","2024-07-12",0,0,0,0,0,0,0,0
"Serbia","2024-07-13",0,0,0,0,0,0,0,0
"Serbia","2024-07-14",0,0,0,0,0,0,0,0
"Serbia","2024-07-15",0,0,0,0,0,0,0,0
"Serbia","2024-07-16",0,0,0,0,0,0,0,0
"Serbia","2024-07-17",0,0,0,0,0,0,0,0
"Serbia","2024-07-18",0,0,0,0,0,0,0,0
"Serbia","2024-07-19",0,0,0,0,0,0,0,0
"Serbia","2024-07-20",0,0,0,0,0,0,0,0
"Serbia","2024-07-21",0,0,0,0,0,0,0,0
"Serbia","2024-07-22",0,0,0,0,0,0,0,0
"Serbia","2024-07-23",0,0,0,0,0,0,0,0
"Serbia","2024-07-24",0,0,0,0,0,0,0,0
"Serbia","2024-07-25",0,0,0,0,0,0,0,0
"Serbia","2024-07-26",0,0,0,0,0,0,0,0
"Serbia","2024-07-27",0,0,0,0,0,0,0,0
"Serbia","2024-07-28",0,0,0,0,0,0,0,0
"Serbia","2024-07-29",0,0,0,0,0,0,0,0
"Serbia","2024-07-30",0,0,0,0,0,0,0,0
"Serbia","2024-07-31",0,0,0,0,0,0,0,0
"Serbia","2024-08-01",0,0,0,0,0,0,0,0
"Serbia","2024-08-02",0,0,0,0,0,0,0,0
"Serbia","2024-08-03",0,0,0,0,0,0,0,0
"Serbia","2024-08-04",0,0,0,0,0,0,0,0
"Serbia","2024-08-05",0,0,0,0,0,0,0,0
"Serbia","2024-08-06",0,0,0,0,0,0,0,0
"Serbia","2024-08-07",0,0,0,0,0,0,0,0
"Serbia","2024-08-08",0,0,0,0,0,0,0,0
"Serbia","2024-08-09",0,0,0,0,0,0,0,0
"Serbia","2024-08-10",0,0,0,0,0,0,0,0
"Serbia","2024-08-11",0,0,0,0,0,0,0,0
"Serbia","2024-08-12",0,0,0,0,0,0,0,0
"Serbia","2024-08-13",0,0,0,0,0,0,0,0
"Serbia","2024-08-14",0,0,0,0,0,0,0,0
"Serbia","2024-08-15",0,0,0,0,0,0,0,0
"Serbia","2024-08-16",0,0,0,0,0,0,0,0
"Serbia","2024-08-17",0,0,0,0,0,0,0,0
"Serbia","2024-08-18",0,0,0,0,0,0,0,0
"Serbia","2024-08-19",0,0,0,0,0,0,0,0
"Serbia","2024-08-20",0,0,0,0,0,0,0,0
"Serbia","2024-08-21",0,0,0,0,0,0,0,0
"Serbia","2024-08-22",0,0,0,0,0,0,0,0
"Serbia","2024-08-23",0,0,0,0,0,0,0,0
"Serbia","2024-08-24",0,0,0,0,0,0,0,0
"Serbia","2024-08-25",0,0,0,0,0,0,0,0
"Serbia","2024-08-26",0,0,0,0,0,0,0,0
"Serbia","2024-08-27",0,0,0,0,0,0,0,0
"Serbia","2024-08-28",0,0,0,0,0,0,0,0
"Serbia","2024-08-29",0,0,0,0,0,0,0,0
"Serbia","2024-08-30",0,0,0,0,0,0,0,0
"Serbia","2024-08-31",0,0,0,0,0,0,0,0
"Serbia","2024-09-01",0,0,0,0,0,0,0,0
"Serbia","2024-09-02",0,0,0,0,0,0,0,0
"Serbia","2024-09-03",0,0,0,0,0,0,0,0
"Serbia","2024-09-04",0,0,0,0,0,0,0,0
"Serbia","2024-09-05",0,0,0,0,0,0,0,0
"Serbia","2024-09-06",0,0,0,0,0,0,0,0
"Serbia","2024-09-07",0,0,0,0,0,0,0,0
"Serbia","2024-09-08",0,0,0,0,0,0,0,0
"Serbia","2024-09-09",0,0,0,0,0,0,0,0
"Serbia","2024-09-10",0,0,0,0,0,0,0,0
"Serbia","2024-09-11",0,0,0,0,0,0,0,0
"Serbia","2024-09-12",0,0,0,0,0,0,0,0
"Serbia","2024-09-13",0,0,0,0,0,0,0,0
"Serbia","2024-09-14",0,0,0,0,0,0,0,0
"Serbia","2024-09-15",0,0,0,0,0,0,0,0
"Serbia","2024-09-16",0,0,0,0,0,0,0,0
"Serbia","2024-09-17",0,0,0,0,0,0,0,0
"Serbia","2024-09-18",0,0,0,0,0,0,0,0
"Serbia","2024-09-19",0,0,0,0,0,0,0,0
"Serbia","2024-09-20",0,0,0,0,0,0,0,0
"Serbia","2024-09-21",0,0,0,0,0,0,0,0
"Serbia","2024-09-22",0,0,0,0,0,0,0,0
"Serbia","2024-09-23",0,0,0,0,0,0,0,0
"Serbia","2024-09-24",0,0,0,0,0,0,0,0
"Serbia","2024-09-25",0,0,0,0,0,0,0,0
"Serbia","2024-09-26",0,0,0,0,0,0,0,0
"Serbia","2024-09-27",0,0,0,0,0,0,0,0
"Serbia","2024-09-28",0,0,0,0,0,0,0,0
"Serbia","2024-09-29",0,0,0,0,0,0,0,0
"Serbia","2024-09-30",0,0,0,0,0,0,0,0
"Serbia","2024-10-01",0,0,0,0,0,0,0,0
"Serbia","2024-10-02",0,0,0,0,0,0,0,0
"Serbia","2024-10-03",0,0,0,0,0,0,0,0
"Serbia","2024-10-04",0,0,0,0,0,0,0,0
"Serbia","2024-10-05",0,0,0,0,0,0,0,0
"Serbia","2024-10-06",0,0,0,0,0,0,0,0
"Serbia","2024-10-07",0,0,0,0,0,0,0,0
"Serbia","2024-10-08",0,0,0,0,0,0,0,0
"Serbia","2024-10-09",0,0,0,0,0,0,0,0
"Serbia","2024-10-10",0,0,0,0,0,0,0,0
"Serbia","2024-10-11",0,0,0,0,0,0,0,0
"Serbia","2024-10-12",0,0,0,0,0,0,0,0
"Serbia","2024-10-13",0,0,0,0,0,0,0,0
"Serbia","2024-10-14",0,0,0,0,0,0,0,0
"Serbia","2024-10-15",0,0,0,0,0,0,0,0
"Serbia","2024-10-16",0,0,0,0,0,0,0,0
"Serbia","2024-10-17",0,0,0,0,0,0,0,0
"Serbia","2024-10-18",0,0,0,0,0,0,0,0
"Serbia","2024-10-19",0,0,0,0,0,0,0,0
"Serbia","2024-10-20",0,0,0,0,0,0,0,0
"Serbia","2024-10-21",0,0,0,0,0,0,0,0
"Serbia","2024-10-22",0,0,0,0,0,0,0,0
"Serbia","2024-10-23",0,0,0,0,0,0,0,0
"Serbia","2024-10-24",0,0,0,0,0,0,0,0
"Serbia","2024-10-25",0,0,0,0,0,0,0,0
"Serbia","2024-10-26",0,0,0,0,0,0,0,0
"Serbia","2024-10-27",0,0,0,0,0,0,0,0
"Serbia","2024-10-28",0,0,0,0,0,0,0,0
"Serbia","2024-10-29",0,0,0,0,0,0,0,0
"Serbia","2024-10-30",0,0,0,0,0,0,0,0
"Serbia","2024-10-31",0,0,0,0,0,0,0,0
"Serbia","2024-11-01",0,0,0,0,0,0,0,0
"Serbia","2024-11-02",0,0,0,0,0,0,0,0
"Serbia","2024-11-03",0,0,0,0,0,0,0,0
"Serbia","2024-11-04",0,0,0,0,0,0,0,0
"Serbia","2024-11-05",0,0,0,0,0,0,0,0
"Serbia","2024-11-06",0,0,0,0,0,0,0,0
"Serbia","2024-11-07",0,0,0,0,0,0,0,0
"Serbia","2024-11-08",0,0,0,0,0,0,0,0
"Serbia","2024-11-09",0,0,0,0,0,0,0,0
"Serbia","2024-11-10",0,0,0,0,0,0,0,0
"Serbia","2024-11-11",0,0,0,0,0,0,0,0
"Serbia","2024-11-12",0,0,0,0,0,0,0,0
"Serbia","2024-11-13",0,0,0,0,0,0,0,0
"Serbia","2024-11-14",0,0,0,0,0,0,0,0
"Serbia","2024-11-15",0,0,0,0,0,0,0,0
"Serbia","2024-11-16",0,0,0,0,0,0,0,0
"Serbia","2024-11-17",0,0,0,0,0,0,0,0
"Serbia","2024-11-18",0,0,0,0,0,0,0,0
"Serbia","2024-11-19",0,0,0,0,0,0,0,0
"Serbia","2024-11-20",0,0,0,0,0,0,0,0
"Serbia","2024-11-21",0,0,0,0,0,0,0,0
"Serbia","2024-11-22",0,0,0,0,0,0,0,0
"Serbia","2024-11-23",0,0,0,0,0,0,0,0
"Serbia","2024-11-24",0,0,0,0,0,0,0,0
"Serbia","2024-11-25",0,0,0,0,0,0,0,0
"Serbia","2024-11-26",0,0,0,0,0,0,0,0
"Serbia","2024-11-27",0,0,0,0,0,0,0,0
"Serbia","2024-11-28",0,0,0,0,0,0,0,0
"Serbia","2024-11-29",0,0,0,0,0,0,0,0
"Serbia","2024-11-30",0,0,0,0,0,0,0,0
"Serbia","2024-12-01",0,0,0,0,0,0,0,0
"Serbia","2024-12-02",0,0,0,0,0,0,0,0
"Serbia","2024-12-03",0,0,0,0,0,0,0,0
"Serbia","2024-12-04",0,0,0,0,0,0,0,0
"Serbia","2024-12-05",0,0,0,0,0,0,0,0
"Serbia","2024-12-06",0,0,0,0,0,0,0,0
"Serbia","2024-12-07",0,0,0,0,0,0,0,0
"Serbia","2024-12-08",0,0,0,0,0,0,0,0
"Serbia","2024-12-09",0,0,0,0,0,0,0,0
"Serbia","2024-12-10",0,0,0,0,0,0,0,0
"Serbia","2024-12-11",0,0,0,0,0,0,0,0
"Serbia","2024-12-12",0,0,0,0,0,0,0,0
"Serbia","2024-12-13",0,0,0,0,0,0,0,0
"Serbia","2024-12-14",0,0,0,0,0,0,0,0
"Serbia","2024-12-15",0,0,0,0,0,0,0,0
"Serbia","2024-12-16",0,0,0,0,0,0,0,0
"Serbia","2024-12-17",0,0,0,0,0,0,0,0
"Serbia","2024-12-18",0,0,0,0,0,0,0,0
"Serbia","2024-12-19",0,0,0,0,0,0,0,0
"Serbia","2024-12-20",0,0,0,0,0,0,0,0
"Serbia","2024-12-21",0,0,0,0,0,0,0,0
"Serbia","2024-12-22",0,0,0,0,0,0,0,0
"Serbia","2024-12-23",0,0,0,0,0,0,0,0
"Serbia","2024-12-24",0,0,0,0,0,0,0,0
"Serbia","2024-12-25",0,0,0,0,0,0,0,0
"Serbia","2024-12-26",0,0,0,0,0,0,0,0
"Serbia","2024-12-27",0,0,0,0,0,0,0,0
"Serbia","2024-12-28",0,0,0,0,0,0,0,0
"Serbia","2024-12-29",0,0,0,0,0,0,0,0
"Serbia","2024-12-30",0,0,0,0,0,0,0,0
"Serbia","2024-12-31",0,0,0,0,0,0,0,0
"Serbia","2025-01-01",0,0,0,0,0,0,0,0
"Serbia","2025-01-02",0,0,0,0,0,0,0,0
"Serbia","2025-01-03",0,0,0,0,0,0,0,0
"Serbia","2025-01-04",0,0,0,0,0,0,0,0
"Serbia","2025-01-05",0,0,0,0,0,0,0,0
"Serbia","2025-01-06",0,0,0,0,0,0,0,0
"Serbia","2025-01-07",0,0,0,0,0,0,0,0
"Serbia","2025-01-08",0,0,0,0,0,0,0,0
"Serbia","2025-01-09",0,0,0,0,0,0,0,0
"Serbia","2025-01-10",0,0,0,0,0,0,0,0
"Serbia","2025-01-11",0,0,0,0,0,0,0,0
"Serbia","2025-01-12",0,0,0,0,0,0,0,0
"Serbia","2025-01-13",0,0,0,0,0,0,0,0
"Serbia","2025-01-14",0,0,0,0,0,0,0,0
"Serbia","2025-01-15",0,0,0,0,0,0,0,0
"Serbia","2025-01-16",0,0,0,0,0,0,0,0
"Serbia","2025-01-17",0,0,0,0,0,0,0,0
"Serbia","2025-01-18",0,0,0,0,0,0,0,0
"Serbia","2025-01-19",0,0,0,0,0,0,0,0
"Serbia","2025-01-20",0,0,0,0,0,0,0,0
"Serbia","2025-01-21",0,0,0,0,0,0,0,0
"Serbia","2025-01-22",0,0,0,0,0,0,0,0
"Serbia","2025-01-23",0,0,0,0,0,0,0,0
"Serbia","2025-01-24",0,0,0,0,0,0,0,0
"Serbia","2025-01-25",0,0,0,0,0,0,0,0
"Serbia","2025-01-26",0,0,0,0,0,0,0,0
"Serbia","2025-01-27",0,0,0,0,0,0,0,0
"Serbia","2025-01-28",0,0,0,0,0,0,0,0
"Serbia","2025-01-29",0,0,0,0,0,0,0,0
"Serbia","2025-01-30",0,0,0,0,0,0,0,0
"Serbia","2025-01-31",0,0,0,0,0,0,0,0
"Serbia","2025-02-01",0,0,0,0,0,0,0,0
"Serbia","2025-02-02",0,0,0,0,0,0,0,0
"Serbia","2025-02-03",0,0,0,0,0,0,0,0
"Serbia","2025-02-04",0,0,0,0,0,0,0,0
"Serbia","2025-02-05",0,0,0,0,0,0,0,0
"Serbia","2025-02-06",0,0,0,0,0,0,0,0
"Serbia","2025-02-07",0,0,0,0,0,0,0,0
"Serbia","2025-02-08",0,0,0,0,0,0,0,0
"Serbia","2025-02-09",0,0,0,0,0,0,0,0
"Serbia","2025-02-10",0,0,0,0,0,0,0,0
"Serbia","2025-02-11",0,0,0,0,0,0,0,0
"Serbia","2025-02-12",0,0,0,0,0,0,0,0
"Serbia","2025-02-13",0,0,0,0,0,0,0,0
"Serbia","2025-02-14",0,0,0,0,0,0,0,0
"Serbia","2025-02-15",0,0,0,0,0,0,0,0
"Serbia","2025-02-16",0,0,0,0,0,0,0,0
"Serbia","2025-02-17",0,0,0,0,0,0,0,0
"Serbia","2025-02-18",0,0,0,0,0,0,0,0
"Serbia","2025-02-19",0,0,0,0,0,0,0,0
"Serbia","2025-02-20",0,0,0,0,0,0,0,0
"Serbia","2025-02-21",0,0,0,0,0,0,0,0
"Serbia","2025-02-22",0,0,0,0,0,0,0,0
"Serbia","2025-02-23",0,0,0,0,0,0,0,0
"Serbia","2025-02-24",0,0,0,0,0,0,0,0
"Serbia","2025-02-25",0,0,0,0,0,0,0,0
"Serbia","2025-02-26",0,0,0,0,0,0,0,0
"Serbia","2025-02-27",0,0,0,0,0,0,0,0
"Serbia","2025-02-28",0,0,0,0,0,0,0,0
"Serbia","2025-03-01",0,0,0,0,0,0,0,0
"Serbia","2025-03-02",0,0,0,0,0,0,0,0
"Serbia","2025-03-03",0,0,0,0,0,0,0,0
"Sierra Leone","2024-01-01",0,0,0,0,0,0,0,0
"Sierra Leone","2024-01-02",0,0,0,0,0,0,0,0
"Sierra Leone","2024-01-03",0,0,0,0,0,0,0,0
"Sierra Leone","2024-01-04",0,0,0,0,0,0,0,0
"Sierra Leone","2024-01-05",0,0,0,0,0,0,0,0
"Sierra Leone","2024-01-06",0,0,0,0,0,0,0,0
"Sierra Leone","2024-01-07",0,0,0,0,0,0,0,0
"Sierra Leone","2024-01-08",0,0,0,0,0,0,0,0
"Sierra Leone","2024-01-09",0,0,0,0,0,0,0,0
"Sierra Leone","2024-01-10",0,0,0,0,0,0,0,0
"Sierra Leone","2024-01-11",0,0,0,0,0,0,0,0
"Sierra Leone","2024-01-12",0,0,0,0,0,0,0,0
"Sierra Leone","2024-01-13",0,0,0,0,0,0,0,0
"Sierra Leone","2024-01-14",0,0,0,0,0,0,0,0
"Sierra Leone","2024-01-15",0,0,0,0,0,0,0,0
"Sierra Leone","2024-01-16",0,0,0,0,0,0,0,0
"Sierra Leone","2024-01-17",0,0,0,0,0,0,0,0
"Sierra Leone","2024-01-18",0,0,0,0,0,0,0,0
"Sierra Leone","2024-01-19",0,0,0,0,0,0,0,0
"Sierra Leone","2024-01-20",0,0,0,0,0,0,0,0
"Sierra Leone","2024-01-21",0,0,0,0,0,0,0,0
"Sierra Leone","2024-01-22",0,0,0,0,0,0,0,0
"Sierra Leone","2024-01-23",0,0,0,0,0,0,0,0
"Sierra Leone","2024-01-24",0,0,0,0,0,0,0,0
"Sierra Leone","2024-01-25",0,0,0,0,0,0,0,0
"Sierra Leone","2024-01-26",0,0,0,0,0,0,0,0
"Sierra Leone","2024-01-27",0,0,0,0,0,0,0,0
"Sierra Leone","2024-01-28",0,0,0,0,0,0,0,0
"Sierra Leone","2024-01-29",0,0,0,0,0,0,0,0
"Sierra Leone","2024-01-30",0,0,0,0,0,0,0,0
"Sierra Leone","2024-01-31",0,0,0,0,0,0,0,0
"Sierra Leone","2024-02-01",0,0,0,0,0,0,0,0
"Sierra Leone","2024-02-02",0,0,0,0,0,0,0,0
"Sierra Leone","2024-02-03",0,0,0,0,0,0,0,0
"Sierra Leone","2024-02-04",0,0,0,0,0,0,0,0
"Sierra Leone","2024-02-05",0,0,0,0,0,0,0,0
"Sierra Leone","2024-02-06",0,0,0,0,0,0,0,0
"Sierra Leone","2024-02-07",0,0,0,0,0,0,0,0
"Sierra Leone","2024-02-08",0,0,0,0,0,0,0,0
"Sierra Leone","2024-02-09",0,0,0,0,0,0,0,0
"Sierra Leone","2024-02-10",0,0,0,0,0,0,0,0
"Sierra Leone","2024-02-11",0,0,0,0,0,0,0,0
"Sierra Leone","2024-02-12",0,0,0,0,0,0,0,0
"Sierra Leone","2024-02-13",0,0,0,0,0,0,0,0
"Sierra Leone","2024-02-14",0,0,0,0,0,0,0,0
"Sierra Leone","2024-02-15",0,0,0,0,0,0,0,0
"Sierra Leone","2024-02-16",0,0,0,0,0,0,0,0
"Sierra Leone","2024-02-17",0,0,0,0,0,0,0,0
"Sierra Leone","2024-02-18",0,0,0,0,0,0,0,0
"Sierra Leone","2024-02-19",0,0,0,0,0,0,0,0
"Sierra Leone","2024-02-20",0,0,0,0,0,0,0,0
"Sierra Leone","2024-02-21",0,0,0,0,0,0,0,0
"Sierra Leone","2024-02-22",0,0,0,0,0,0,0,0
"Sierra Leone","2024-02-23",0,0,0,0,0,0,0,0
"Sierra Leone","2024-02-24",0,0,0,0,0,0,0,0
"Sierra Leone","2024-02-25",0,0,0,0,0,0,0,0
"Sierra Leone","2024-02-26",0,0,0,0,0,0,0,0
"Sierra Leone","2024-02-27",0,0,0,0,0,0,0,0
"Sierra Leone","2024-02-28",0,0,0,0,0,0,0,0
"Sierra Leone","2024-02-29",0,0,0,0,0,0,0,0
"Sierra Leone","2024-03-01",0,0,0,0,0,0,0,0
"Sierra Leone","2024-03-02",0,0,0,0,0,0,0,0
"Sierra Leone","2024-03-03",0,0,0,0,0,0,0,0
"Sierra Leone","2024-03-04",0,0,0,0,0,0,0,0
"Sierra Leone","2024-03-05",0,0,0,0,0,0,0,0
"Sierra Leone","2024-03-06",0,0,0,0,0,0,0,0
"Sierra Leone","2024-03-07",0,0,0,0,0,0,0,0
"Sierra Leone","2024-03-08",0,0,0,0,0,0,0,0
"Sierra Leone","2024-03-09",0,0,0,0,0,0,0,0
"Sierra Leone","2024-03-10",0,0,0,0,0,0,0,0
"Sierra Leone","2024-03-11",0,0,0,0,0,0,0,0
"Sierra Leone","2024-03-12",0,0,0,0,0,0,0,0
"Sierra Leone","2024-03-13",0,0,0,0,0,0,0,0
"Sierra Leone","2024-03-14",0,0,0,0,0,0,0,0
"Sierra Leone","2024-03-15",0,0,0,0,0,0,0,0
"Sierra Leone","2024-03-16",0,0,0,0,0,0,0,0
"Sierra Leone","2024-03-17",0,0,0,0,0,0,0,0
"Sierra Leone","2024-03-18",0,0,0,0,0,0,0,0
"Sierra Leone","2024-03-19",0,0,0,0,0,0,0,0
"Sierra Leone","2024-03-20",0,0,0,0,0,0,0,0
"Sierra Leone","2024-03-21",0,0,0,0,0,0,0,0
"Sierra Leone","2024-03-22",0,0,0,0,0,0,0,0
"Sierra Leone","2024-03-23",0,0,0,0,0,0,0,0
"Sierra Leone","2024-03-24",0,0,0,0,0,0,0,0
"Sierra Leone","2024-03-25",0,0,0,0,0,0,0,0
"Sierra Leone","2024-03-26",0,0,0,0,0,0,0,0
"Sierra Leone","2024-03-27",0,0,0,0,0,0,0,0
"Sierra Leone","2024-03-28",0,0,0,0,0,0,0,0
"Sierra Leone","2024-03-29",0,0,0,0,0,0,0,0
"Sierra Leone","2024-03-30",0,0,0,0,0,0,0,0
"Sierra Leone","2024-03-31",0,0,0,0,0,0,0,0
"Sierra Leone","2024-04-01",0,0,0,0,0,0,0,0
"Sierra Leone","2024-04-02",0,0,0,0,0,0,0,0
"Sierra Leone","2024-04-03",0,0,0,0,0,0,0,0
"Sierra Leone","2024-04-04",0,0,0,0,0,0,0,0
"Sierra Leone","2024-04-05",0,0,0,0,0,0,0,0
"Sierra Leone","2024-04-06",0,0,0,0,0,0,0,0
"Sierra Leone","2024-04-07",0,0,0,0,0,0,0,0
"Sierra Leone","2024-04-08",0,0,0,0,0,0,0,0
"Sierra Leone","2024-04-09",0,0,0,0,0,0,0,0
"Sierra Leone","2024-04-10",0,0,0,0,0,0,0,0
"Sierra Leone","2024-04-11",0,0,0,0,0,0,0,0
"Sierra Leone","2024-04-12",0,0,0,0,0,0,0,0
"Sierra Leone","2024-04-13",0,0,0,0,0,0,0,0
"Sierra Leone","2024-04-14",0,0,0,0,0,0,0,0
"Sierra Leone","2024-04-15",0,0,0,0,0,0,0,0
"Sierra Leone","2024-04-16",0,0,0,0,0,0,0,0
"Sierra Leone","2024-04-17",0,0,0,0,0,0,0,0
"Sierra Leone","2024-04-18",0,0,0,0,0,0,0,0
"Sierra Leone","2024-04-19",0,0,0,0,0,0,0,0
"Sierra Leone","2024-04-20",0,0,0,0,0,0,0,0
"Sierra Leone","2024-04-21",0,0,0,0,0,0,0,0
"Sierra Leone","2024-04-22",0,0,0,0,0,0,0,0
"Sierra Leone","2024-04-23",0,0,0,0,0,0,0,0
"Sierra Leone","2024-04-24",0,0,0,0,0,0,0,0
"Sierra Leone","2024-04-25",0,0,0,0,0,0,0,0
"Sierra Leone","2024-04-26",0,0,0,0,0,0,0,0
"Sierra Leone","2024-04-27",0,0,0,0,0,0,0,0
"Sierra Leone","2024-04-28",0,0,0,0,0,0,0,0
"Sierra Leone","2024-04-29",0,0,0,0,0,0,0,0
"Sierra Leone","2024-04-30",0,0,0,0,0,0,0,0
"Sierra Leone","2024-05-01",0,0,0,0,0,0,0,0
"Sierra Leone","2024-05-02",0,0,0,0,0,0,0,0
"Sierra Leone","2024-05-03",0,0,0,0,0,0,0,0
"Sierra Leone","2024-05-04",0,0,0,0,0,0,0,0
"Sierra Leone","2024-05-05",0,0,0,0,0,0,0,0
"Sierra Leone","2024-05-06",0,0,0,0,0,0,0,0
"Sierra Leone","2024-05-07",0,0,0,0,0,0,0,0
"Sierra Leone","2024-05-08",0,0,0,0,0,0,0,0
"Sierra Leone","2024-05-09",0,0,0,0,0,0,0,0
"Sierra Leone","2024-05-10",0,0,0,0,0,0,0,0
"Sierra Leone","2024-05-11",0,0,0,0,0,0,0,0
"Sierra Leone","2024-05-12",0,0,0,0,0,0,0,0
"Sierra Leone","2024-05-13",0,0,0,0,0,0,0,0
"Sierra Leone","2024-05-14",0,0,0,0,0,0,0,0
"Sierra Leone","2024-05-15",0,0,0,0,0,0,0,0
"Sierra Leone","2024-05-16",0,0,0,0,0,0,0,0
"Sierra Leone","2024-05-17",0,0,0,0,0,0,0,0
"Sierra Leone","2024-05-18",0,0,0,0,0,0,0,0
"Sierra Leone","2024-05-19",0,0,0,0,0,0,0,0
"Sierra Leone","2024-05-20",0,0,0,0,0,0,0,0
"Sierra Leone","2024-05-21",0,0,0,0,0,0,0,0
"Sierra Leone","2024-05-22",0,0,0,0,0,0,0,0
"Sierra Leone","2024-05-23",0,0,0,0,0,0,0,0
"Sierra Leone","2024-05-24",0,0,0,0,0,0,0,0
"Sierra Leone","2024-05-25",0,0,0,0,0,0,0,0
"Sierra Leone","2024-05-26",0,0,0,0,0,0,0,0
"Sierra Leone","2024-05-27",0,0,0,0,0,0,0,0
"Sierra Leone","2024-05-28",0,0,0,0,0,0,0,0
"Sierra Leone","2024-05-29",0,0,0,0,0,0,0,0
"Sierra Leone","2024-05-30",0,0,0,0,0,0,0,0
"Sierra Leone","2024-05-31",0,0,0,0,0,0,0,0
"Sierra Leone","2024-06-01",0,0,0,0,0,0,0,0
"Sierra Leone","2024-06-02",0,0,0,0,0,0,0,0
"Sierra Leone","2024-06-03",0,0,0,0,0,0,0,0
"Sierra Leone","2024-06-04",0,0,0,0,0,0,0,0
"Sierra Leone","2024-06-05",0,0,0,0,0,0,0,0
"Sierra Leone","2024-06-06",0,0,0,0,0,0,0,0
"Sierra Leone","2024-06-07",0,0,0,0,0,0,0,0
"Sierra Leone","2024-06-08",0,0,0,0,0,0,0,0
"Sierra Leone","2024-06-09",0,0,0,0,0,0,0,0
"Sierra Leone","2024-06-10",0,0,0,0,0,0,0,0
"Sierra Leone","2024-06-11",0,0,0,0,0,0,0,0
"Sierra Leone","2024-06-12",0,0,0,0,0,0,0,0
"Sierra Leone","2024-06-13",0,0,0,0,0,0,0,0
"Sierra Leone","2024-06-14",0,0,0,0,0,0,0,0
"Sierra Leone","2024-06-15",0,0,0,0,0,0,0,0
"Sierra Leone","2024-06-16",0,0,0,0,0,0,0,0
"Sierra Leone","2024-06-17",0,0,0,0,0,0,0,0
"Sierra Leone","2024-06-18",0,0,0,0,0,0,0,0
"Sierra Leone","2024-06-19",0,0,0,0,0,0,0,0
"Sierra Leone","2024-06-20",0,0,0,0,0,0,0,0
"Sierra Leone","2024-06-21",0,0,0,0,0,0,0,0
"Sierra Leone","2024-06-22",0,0,0,0,0,0,0,0
"Sierra Leone","2024-06-23",0,0,0,0,0,0,0,0
"Sierra Leone","2024-06-24",0,0,0,0,0,0,0,0
"Sierra Leone","2024-06-25",0,0,0,0,0,0,0,0
"Sierra Leone","2024-06-26",0,0,0,0,0,0,0,0
"Sierra Leone","2024-06-27",0,0,0,0,0,0,0,0
"Sierra Leone","2024-06-28",0,0,0,0,0,0,0,0
"Sierra Leone","2024-06-29",0,0,0,0,0,0,0,0
"Sierra Leone","2024-06-30",0,0,0,0,0,0,0,0
"Sierra Leone","2024-07-01",0,0,0,0,0,0,0,0
"Sierra Leone","2024-07-02",0,0,0,0,0,0,0,0
"Sierra Leone","2024-07-03",0,0,0,0,0,0,0,0
"Sierra Leone","2024-07-04",0,0,0,0,0,0,0,0
"Sierra Leone","2024-07-05",0,0,0,0,0,0,0,0
"Sierra Leone","2024-07-06",0,0,0,0,0,0,0,0
"Sierra Leone","2024-07-07",0,0,0,0,0,0,0,0
"Sierra Leone","2024-07-08",0,0,0,0,0,0,0,0
"Sierra Leone","2024-07-09",0,0,0,0,0,0,0,0
"Sierra Leone","2024-07-10",0,0,0,0,0,0,0,0
"Sierra Leone","2024-07-11",0,0,0,0,0,0,0,0
"Sierra Leone","2024-07-12",0,0,0,0,0,0,0,0
"Sierra Leone","2024-07-13",0,0,0,0,0,0,0,0
"Sierra Leone","2024-07-14",0,0,0,0,0,0,0,0
"Sierra Leone","2024-07-15",0,0,0,0,0,0,0,0
"Sierra Leone","2024-07-16",0,0,0,0,0,0,0,0
"Sierra Leone","2024-07-17",0,0,0,0,0,0,0,0
"Sierra Leone","2024-07-18",0,0,0,0,0,0,0,0
"Sierra Leone","2024-07-19",0,0,0,0,0,0,0,0
"Sierra Leone","2024-07-20",0,0,0,0,0,0,0,0
"Sierra Leone","2024-07-21",0,0,0,0,0,0,0,0
"Sierra Leone","2024-07-22",0,0,0,0,0,0,0,0
"Sierra Leone","2024-07-23",0,0,0,0,0,0,0,0
"Sierra Leone","2024-07-24",0,0,0,0,0,0,0,0
"Sierra Leone","2024-07-25",0,0,0,0,0,0,0,0
"Sierra Leone","2024-07-26",0,0,0,0,0,0,0,0
"Sierra Leone","2024-07-27",0,0,0,0,0,0,0,0
"Sierra Leone","2024-07-28",0,0,0,0,0,0,0,0
"Sierra Leone","2024-07-29",0,0,0,0,0,0,0,0
"Sierra Leone","2024-07-30",0,0,0,0,0,0,0,0
"Sierra Leone","2024-07-31",0,0,0,0,0,0,0,0
"Sierra Leone","2024-08-01",0,0,0,0,0,0,0,0
"Sierra Leone","2024-08-02",0,0,0,0,0,0,0,0
"Sierra Leone","2024-08-03",0,0,0,0,0,0,0,0
"Sierra Leone","2024-08-04",0,0,0,0,0,0,0,0
"Sierra Leone","2024-08-05",0,0,0,0,0,0,0,0
"Sierra Leone","2024-08-06",0,0,0,0,0,0,0,0
"Sierra Leone","2024-08-07",0,0,0,0,0,0,0,0
"Sierra Leone","2024-08-08",0,0,0,0,0,0,0,0
"Sierra Leone","2024-08-09",0,0,0,0,0,0,0,0
"Sierra Leone","2024-08-10",0,0,0,0,0,0,0,0
"Sierra Leone","2024-08-11",0,0,0,0,0,0,0,0
"Sierra Leone","2024-08-12",0,0,0,0,0,0,0,0
"Sierra Leone","2024-08-13",0,0,0,0,0,0,0,0
"Sierra Leone","2024-08-14",0,0,0,0,0,0,0,0
"Sierra Leone","2024-08-15",0,0,0,0,0,0,0,0
"Sierra Leone","2024-08-16",0,0,0,0,0,0,0,0
"Sierra Leone","2024-08-17",0,0,0,0,0,0,0,0
"Sierra Leone","2024-08-18",0,0,0,0,0,0,0,0
"Sierra Leone","2024-08-19",0,0,0,0,0,0,0,0
"Sierra Leone","2024-08-20",0,0,0,0,0,0,0,0
"Sierra Leone","2024-08-21",0,0,0,0,0,0,0,0
"Sierra Leone","2024-08-22",0,0,0,0,0,0,0,0
"Sierra Leone","2024-08-23",0,0,0,0,0,0,0,0
"Sierra Leone","2024-08-24",0,0,0,0,0,0,0,0
"Sierra Leone","2024-08-25",0,0,0,0,0,0,0,0
"Sierra Leone","2024-08-26",0,0,0,0,0,0,0,0
"Sierra Leone","2024-08-27",0,0,0,0,0,0,0,0
"Sierra Leone","2024-08-28",0,0,0,0,0,0,0,0
"Sierra Leone","2024-08-29",0,0,0,0,0,0,0,0
"Sierra Leone","2024-08-30",0,0,0,0,0,0,0,0
"Sierra Leone","2024-08-31",0,0,0,0,0,0,0,0
"Sierra Leone","2024-09-01",0,0,0,0,0,0,0,0
"Sierra Leone","2024-09-02",0,0,0,0,0,0,0,0
"Sierra Leone","2024-09-03",0,0,0,0,0,0,0,0
"Sierra Leone","2024-09-04",0,0,0,0,0,0,0,0
"Sierra Leone","2024-09-05",0,0,0,0,0,0,0,0
"Sierra Leone","2024-09-06",0,0,0,0,0,0,0,0
"Sierra Leone","2024-09-07",0,0,0,0,0,0,0,0
"Sierra Leone","2024-09-08",0,0,0,0,0,0,0,0
"Sierra Leone","2024-09-09",0,0,0,0,0,0,0,0
"Sierra Leone","2024-09-10",0,0,0,0,0,0,0,0
"Sierra Leone","2024-09-11",0,0,0,0,0,0,0,0
"Sierra Leone","2024-09-12",0,0,0,0,0,0,0,0
"Sierra Leone","2024-09-13",0,0,0,0,0,0,0,0
"Sierra Leone","2024-09-14",0,0,0,0,0,0,0,0
"Sierra Leone","2024-09-15",0,0,0,0,0,0,0,0
"Sierra Leone","2024-09-16",0,0,0,0,0,0,0,0
"Sierra Leone","2024-09-17",0,0,0,0,0,0,0,0
"Sierra Leone","2024-09-18",0,0,0,0,0,0,0,0
"Sierra Leone","2024-09-19",0,0,0,0,0,0,0,0
"Sierra Leone","2024-09-20",0,0,0,0,0,0,0,0
"Sierra Leone","2024-09-21",0,0,0,0,0,0,0,0
"Sierra Leone","2024-09-22",0,0,0,0,0,0,0,0
"Sierra Leone","2024-09-23",0,0,0,0,0,0,0,0
"Sierra Leone","2024-09-24",0,0,0,0,0,0,0,0
"Sierra Leone","2024-09-25",0,0,0,0,0,0,0,0
"Sierra Leone","2024-09-26",0,0,0,0,0,0,0,0
"Sierra Leone","2024-09-27",0,0,0,0,0,0,0,0
"Sierra Leone","2024-09-28",0,0,0,0,0,0,0,0
"Sierra Leone","2024-09-29",0,0,0,0,0,0,0,0
"Sierra Leone","2024-09-30",0,0,0,0,0,0,0,0
"Sierra Leone","2024-10-01",0,0,0,0,0,0,0,0
"Sierra Leone","2024-10-02",0,0,0,0,0,0,0,0
"Sierra Leone","2024-10-03",0,0,0,0,0,0,0,0
"Sierra Leone","2024-10-04",0,0,0,0,0,0,0,0
"Sierra Leone","2024-10-05",0,0,0,0,0,0,0,0
"Sierra Leone","2024-10-06",0,0,0,0,0,0,0,0
"Sierra Leone","2024-10-07",0,0,0,0,0,0,0,0
"Sierra Leone","2024-10-08",0,0,0,0,0,0,0,0
"Sierra Leone","2024-10-09",0,0,0,0,0,0,0,0
"Sierra Leone","2024-10-10",0,0,0,0,0,0,0,0
"Sierra Leone","2024-10-11",0,0,0,0,0,0,0,0
"Sierra Leone","2024-10-12",0,0,0,0,0,0,0,0
"Sierra Leone","2024-10-13",0,0,0,0,0,0,0,0
"Sierra Leone","2024-10-14",0,0,0,0,0,0,0,0
"Sierra Leone","2024-10-15",0,0,0,0,0,0,0,0
"Sierra Leone","2024-10-16",0,0,0,0,0,0,0,0
"Sierra Leone","2024-10-17",0,0,0,0,0,0,0,0
"Sierra Leone","2024-10-18",0,0,0,0,0,0,0,0
"Sierra Leone","2024-10-19",0,0,0,0,0,0,0,0
"Sierra Leone","2024-10-20",0,0,0,0,0,0,0,0
"Sierra Leone","2024-10-21",0,0,0,0,0,0,0,0
"Sierra Leone","2024-10-22",0,0,0,0,0,0,0,0
"Sierra Leone","2024-10-23",0,0,0,0,0,0,0,0
"Sierra Leone","2024-10-24",0,0,0,0,0,0,0,0
"Sierra Leone","2024-10-25",0,0,0,0,0,0,0,0
"Sierra Leone","2024-10-26",0,0,0,0,0,0,0,0
"Sierra Leone","2024-10-27",0,0,0,0,0,0,0,0
"Sierra Leone","2024-10-28",0,0,0,0,0,0,0,0
"Sierra Leone","2024-10-29",0,0,0,0,0,0,0,0
"Sierra Leone","2024-10-30",0,0,0,0,0,0,0,0
"Sierra Leone","2024-10-31",0,0,0,0,0,0,0,0
"Sierra Leone","2024-11-01",0,0,0,0,0,0,0,0
"Sierra Leone","2024-11-02",0,0,0,0,0,0,0,0
"Sierra Leone","2024-11-03",0,0,0,0,0,0,0,0
"Sierra Leone","2024-11-04",0,0,0,0,0,0,0,0
"Sierra Leone","2024-11-05",0,0,0,0,0,0,0,0
"Sierra Leone","2024-11-06",0,0,0,0,0,0,0,0
"Sierra Leone","2024-11-07",0,0,0,0,0,0,0,0
"Sierra Leone","2024-11-08",0,0,0,0,0,0,0,0
"Sierra Leone","2024-11-09",0,0,0,0,0,0,0,0
"Sierra Leone","2024-11-10",0,0,0,0,0,0,0,0
"Sierra Leone","2024-11-11",0,0,0,0,0,0,0,0
"Sierra Leone","2024-11-12",0,0,0,0,0,0,0,0
"Sierra Leone","2024-11-13",0,0,0,0,0,0,0,0
"Sierra Leone","2024-11-14",0,0,0,0,0,0,0,0
"Sierra Leone","2024-11-15",0,0,0,0,0,0,0,0
"Sierra Leone","2024-11-16",0,0,0,0,0,0,0,0
"Sierra Leone","2024-11-17",0,0,0,0,0,0,0,0
"Sierra Leone","2024-11-18",0,0,0,0,0,0,0,0
"Sierra Leone","2024-11-19",0,0,0,0,0,0,0,0
"Sierra Leone","2024-11-20",0,0,0,0,0,0,0,0
"Sierra Leone","2024-11-21",0,0,0,0,0,0,0,0
"Sierra Leone","2024-11-22",0,0,0,0,0,0,0,0
"Sierra Leone","2024-11-23",0,0,0,0,0,0,0,0
"Sierra Leone","2024-11-24",0,0,0,0,0,0,0,0
"Sierra Leone","2024-11-25",0,0,0,0,0,0,0,0
"Sierra Leone","2024-11-26",0,0,0,0,0,0,0,0
"Sierra Leone","2024-11-27",0,0,0,0,0,0,0,0
"Sierra Leone","2024-11-28",0,0,0,0,0,0,0,0
"Sierra Leone","2024-11-29",0,0,0,0,0,0,0,0
"Sierra Leone","2024-11-30",0,0,0,0,0,0,0,0
"Sierra Leone","2024-12-01",0,0,0,0,0,0,0,0
"Sierra Leone","2024-12-02",0,0,0,0,0,0,0,0
"Sierra Leone","2024-12-03",0,0,0,0,0,0,0,0
"Sierra Leone","2024-12-04",0,0,0,0,0,0,0,0
"Sierra Leone","2024-12-05",0,0,0,0,0,0,0,0
"Sierra Leone","2024-12-06",0,0,0,0,0,0,0,0
"Sierra Leone","2024-12-07",0,0,0,0,0,0,0,0
"Sierra Leone","2024-12-08",0,0,0,0,0,0,0,0
"Sierra Leone","2024-12-09",0,0,0,0,0,0,0,0
"Sierra Leone","2024-12-10",0,0,0,0,0,0,0,0
"Sierra Leone","2024-12-11",0,0,0,0,0,0,0,0
"Sierra Leone","2024-12-12",0,0,0,0,0,0,0,0
"Sierra Leone","2024-12-13",0,0,0,0,0,0,0,0
"Sierra Leone","2024-12-14",0,0,0,0,0,0,0,0
"Sierra Leone","2024-12-15",0,0,0,0,0,0,0,0
"Sierra Leone","2024-12-16",0,0,0,0,0,0,0,0
"Sierra Leone","2024-12-17",0,0,0,0,0,0,0,0
"Sierra Leone","2024-12-18",0,0,0,0,0,0,0,0
"Sierra Leone","2024-12-19",0,0,0,0,0,0,0,0
"Sierra Leone","2024-12-20",0,0,0,0,0,0,0,0
"Sierra Leone","2024-12-21",0,0,0,0,0,0,0,0
"Sierra Leone","2024-12-22",0,0,0,0,0,0,0,0
"Sierra Leone","2024-12-23",0,0,0,0,0,0,0,0
"Sierra Leone","2024-12-24",0,0,0,0,0,0,0,0
"Sierra Leone","2024-12-25",0,0,0,0,0,0,0,0
"Sierra Leone","2024-12-26",0,0,0,0,0,0,0,0
"Sierra Leone","2024-12-27",0,0,0,0,0,0,0,0
"Sierra Leone","2024-12-28",0,0,0,0,0,0,0,0
"Sierra Leone","2024-12-29",0,0,0,0,0,0,0,0
"Sierra Leone","2024-12-30",0,0,0,0,0,0,0,0
"Sierra Leone","2024-12-31",0,0,0,0,0,0,0,0
"Sierra Leone","2025-01-01",0,0,0,0,0,0,0,0
"Sierra Leone","2025-01-02",0,0,0,0,0,0,0,0
"Sierra Leone","2025-01-03",0,0,0,0,0,0,0,0
"Sierra Leone","2025-01-04",0,0,0,0,0,0,0,0
"Sierra Leone","2025-01-05",0,0,0,0,0,0,0,0
"Sierra Leone","2025-01-06",0,0,0,0,0,0,0,0
"Sierra Leone","2025-01-07",0,0,0,0,0,0,0,0
"Sierra Leone","2025-01-08",0,0,0,0,0,0,0,0
"Sierra Leone","2025-01-09",0,0,0,0,0,0,0,0
"Sierra Leone","2025-01-10",0,0,0,0,0,0,0,0
"Sierra Leone","2025-01-11",0,0,0,0,0,0,0,0
"Sierra Leone","2025-01-12",0,2,2,0,2,2,0,0
"Sierra Leone","2025-01-13",0,0,2,0,1,3,0,0
"Sierra Leone","2025-01-14",0,0,2,0,1,4,0,0
"Sierra Leone","2025-01-15",0,0,2,0,1,5,0,0
"Sierra Leone","2025-01-16",0,0,2,0,0,5,0,0
"Sierra Leone","2025-01-17",0,0,2,0,1,6,0,0
"Sierra Leone","2025-01-18",0,0,2,0,1,7,0,0
"Sierra Leone","2025-01-19",0,6,8,0,1,8,0,0
"Sierra Leone","2025-01-20",0,0,8,0,1,9,0,0
"Sierra Leone","2025-01-21",0,0,8,0,1,10,0,0
"Sierra Leone","2025-01-22",0,0,8,0,1,11,0,0
"Sierra Leone","2025-01-23",0,0,8,0,2,13,0,0
"Sierra Leone","2025-01-24",0,0,8,0,1,14,0,0
"Sierra Leone","2025-01-25",0,0,8,0,1,15,0,0
"Sierra Leone","2025-01-26",0,8,16,0,1,16,0,0
"Sierra Leone","2025-01-27",0,0,16,0,0,16,0,0
"Sierra Leone","2025-01-28",0,0,16,0,0,16,0,0
"Sierra Leone","2025-01-29",0,0,16,0,0,16,0,0
"Sierra Leone","2025-01-30",0,0,16,0,1,17,0,0
"Sierra Leone","2025-01-31",0,0,16,0,0,17,0,0
"Sierra Leone","2025-02-01",0,0,16,0,0,17,0,0
"Sierra Leone","2025-02-02",0,1,17,0,0,17,0,0
"Sierra Leone","2025-02-03",0,0,17,0,0,17,0,0
"Sierra Leone","2025-02-04",0,0,17,0,1,18,0,0
"Sierra Leone","2025-02-05",0,0,17,0,0,18,0,0
"Sierra Leone","2025-02-06",0,0,17,0,1,19,0,0
"Sierra Leone","2025-02-07",0,0,17,0,0,19,0,0
"Sierra Leone","2025-02-08",0,0,17,0,1,20,0,0
"Sierra Leone","2025-02-09",0,3,20,0,0,20,0,0
"Sierra Leone","2025-02-10",0,0,20,0,0,20,0,0
"Sierra Leone","2025-02-11",0,0,20,0,1,21,0,0
"Sierra Leone","2025-02-12",0,0,20,0,1,22,0,0
"Sierra Leone","2025-02-13",0,2,22,0,0,22,0,0
"Sierra Leone","2025-02-14",0,0,22,0,0,22,0,0
"Sierra Leone","2025-02-15",0,0,22,0,0,22,0,0
"Sierra Leone","2025-02-16",0,0,22,0,0,22,0,0
"Sierra Leone","2025-02-17",0,0,22,0,0,22,0,0
"Sierra Leone","2025-02-18",0,0,22,0,0,22,0,0
"Sierra Leone","2025-02-19",0,0,22,0,0,22,0,0
"Sierra Leone","2025-02-20",0,0,22,0,0,22,0,0
"Sierra Leone","2025-02-21",0,0,22,0,0,22,0,0
"Sierra Leone","2025-02-22",0,0,22,0,0,22,0,0
"Sierra Leone","2025-02-23",0,0,22,0,0,22,0,0
"Sierra Leone","2025-02-24",0,0,22,0,0,22,0,0
"Sierra Leone","2025-02-25",0,0,22,0,0,22,0,0
"Sierra Leone","2025-02-26",0,0,22,0,0,22,0,0
"Sierra Leone","2025-02-27",0,0,22,0,0,22,0,0
"Sierra Leone","2025-02-28",0,0,22,0,0,22,0,0
"Sierra Leone","2025-03-01",0,0,22,0,0,22,0,0
"Sierra Leone","2025-03-02",0,0,22,0,0,22,0,0
"Sierra Leone","2025-03-03",0,0,22,0,0,22,0,0
"Singapore","2024-01-01",0,0,0,0,0,0,0,0
"Singapore","2024-01-02",0,0,0,0,0,0,0,0
"Singapore","2024-01-03",0,0,0,0,0,0,0,0
"Singapore","2024-01-04",0,0,0,0,0,0,0,0
"Singapore","2024-01-05",0,1,1,0,1,1,0,0
"Singapore","2024-01-06",0,0,1,0,0,1,0,0
"Singapore","2024-01-07",0,0,1,0,0,1,0,0
"Singapore","2024-01-08",0,0,1,0,0,1,0,0
"Singapore","2024-01-09",0,0,1,0,0,1,0,0
"Singapore","2024-01-10",0,0,1,0,0,1,0,0
"Singapore","2024-01-11",0,0,1,0,0,1,0,0
"Singapore","2024-01-12",0,0,1,0,0,1,0,0
"Singapore","2024-01-13",0,0,1,0,0,1,0,0
"Singapore","2024-01-14",0,0,1,0,0,1,0,0
"Singapore","2024-01-15",0,0,1,0,0,1,0,0
"Singapore","2024-01-16",0,0,1,0,0,1,0,0
"Singapore","2024-01-17",0,0,1,0,0,1,0,0
"Singapore","2024-01-18",0,0,1,0,0,1,0,0
"Singapore","2024-01-19",0,0,1,0,0,1,0,0
"Singapore","2024-01-20",0,0,1,0,0,1,0,0
"Singapore","2024-01-21",0,0,1,0,0,1,0,0
"Singapore","2024-01-22",0,0,1,0,0,1,0,0
"Singapore","2024-01-23",0,0,1,0,0,1,0,0
"Singapore","2024-01-24",0,0,1,0,0,1,0,0
"Singapore","2024-01-25",0,0,1,0,0,1,0,0
"Singapore","2024-01-26",0,0,1,0,0,1,0,0
"Singapore","2024-01-27",0,0,1,0,1,2,0,0
"Singapore","2024-01-28",0,0,1,0,0,2,0,0
"Singapore","2024-01-29",0,0,1,0,0,2,0,0
"Singapore","2024-01-30",0,0,1,0,0,2,0,0
"Singapore","2024-01-31",0,0,1,0,0,2,0,0
"Singapore","2024-02-01",0,0,1,0,0,2,0,0
"Singapore","2024-02-02",0,0,1,0,0,2,0,0
"Singapore","2024-02-03",0,0,1,0,0,2,0,0
"Singapore","2024-02-04",0,0,1,0,0,2,0,0
"Singapore","2024-02-05",0,0,1,0,0,2,0,0
"Singapore","2024-02-06",0,0,1,0,0,2,0,0
"Singapore","2024-02-07",0,0,1,0,0,2,0,0
"Singapore","2024-02-08",0,0,1,0,0,2,0,0
"Singapore","2024-02-09",0,0,1,0,0,2,0,0
"Singapore","2024-02-10",0,0,1,0,0,2,0,0
"Singapore","2024-02-11",0,0,1,0,0,2,0,0
"Singapore","2024-02-12",0,0,1,0,0,2,0,0
"Singapore","2024-02-13",0,0,1,0,0,2,0,0
"Singapore","2024-02-14",0,0,1,0,0,2,0,0
"Singapore","2024-02-15",0,0,1,0,0,2,0,0
"Singapore","2024-02-16",0,1,2,0,0,2,0,0
"Singapore","2024-02-17",0,0,2,0,0,2,0,0
"Singapore","2024-02-18",0,0,2,0,0,2,0,0
"Singapore","2024-02-19",0,0,2,0,0,2,0,0
"Singapore","2024-02-20",0,0,2,0,0,2,0,0
"Singapore","2024-02-21",0,0,2,0,0,2,0,0
"Singapore","2024-02-22",0,0,2,0,1,3,0,0
"Singapore","2024-02-23",0,0,2,0,0,3,0,0
"Singapore","2024-02-24",0,0,2,0,0,3,0,0
"Singapore","2024-02-25",0,0,2,0,0,3,0,0
"Singapore","2024-02-26",0,0,2,0,0,3,0,0
"Singapore","2024-02-27",0,0,2,0,0,3,0,0
"Singapore","2024-02-28",0,0,2,0,0,3,0,0
"Singapore","2024-02-29",0,0,2,0,0,3,0,0
"Singapore","2024-03-01",0,0,2,0,0,3,0,0
"Singapore","2024-03-02",0,0,2,0,0,3,0,0
"Singapore","2024-03-03",0,0,2,0,1,4,0,0
"Singapore","2024-03-04",0,0,2,0,0,4,0,0
"Singapore","2024-03-05",0,0,2,0,0,4,0,0
"Singapore","2024-03-06",0,0,2,0,0,4,0,0
"Singapore","2024-03-07",0,0,2,0,0,4,0,0
"Singapore","2024-03-08",0,2,4,0,0,4,0,0
"Singapore","2024-03-09",0,0,4,0,0,4,0,0
"Singapore","2024-03-10",0,0,4,0,1,5,0,0
"Singapore","2024-03-11",0,0,4,0,0,5,0,0
"Singapore","2024-03-12",0,0,4,0,0,5,0,0
"Singapore","2024-03-13",0,0,4,0,0,5,0,0
"Singapore","2024-03-14",0,0,4,0,1,6,0,0
"Singapore","2024-03-15",0,2,6,0,0,6,0,0
"Singapore","2024-03-16",0,0,6,0,0,6,0,0
"Singapore","2024-03-17",0,0,6,0,0,6,0,0
"Singapore","2024-03-18",0,0,6,0,0,6,0,0
"Singapore","2024-03-19",0,0,6,0,1,7,0,0
"Singapore","2024-03-20",0,0,6,0,0,7,0,0
"Singapore","2024-03-21",0,0,6,0,0,7,0,0
"Singapore","2024-03-22",0,1,7,0,0,7,0,0
"Singapore","2024-03-23",0,0,7,0,0,7,0,0
"Singapore","2024-03-24",0,0,7,0,0,7,0,0
"Singapore","2024-03-25",0,0,7,0,0,7,0,0
"Singapore","2024-03-26",0,0,7,0,0,7,0,0
"Singapore","2024-03-27",0,0,7,0,0,7,0,0
"Singapore","2024-03-28",0,0,7,0,0,7,0,0
"Singapore","2024-03-29",0,0,7,0,0,7,0,0
"Singapore","2024-03-30",0,0,7,0,1,8,0,0
"Singapore","2024-03-31",0,0,7,0,0,8,0,0
"Singapore","2024-04-01",0,0,7,0,0,8,0,0
"Singapore","2024-04-02",0,0,7,0,0,8,0,0
"Singapore","2024-04-03",0,0,7,0,0,8,0,0
"Singapore","2024-04-04",0,0,7,0,0,8,0,0
"Singapore","2024-04-05",0,1,8,0,0,8,0,0
"Singapore","2024-04-06",0,0,8,0,0,8,0,0
"Singapore","2024-04-07",0,0,8,0,0,8,0,0
"Singapore","2024-04-08",0,0,8,0,0,8,0,0
"Singapore","2024-04-09",0,0,8,0,0,8,0,0
"Singapore","2024-04-10",0,0,8,0,0,8,0,0
"Singapore","2024-04-11",0,0,8,0,0,8,0,0
"Singapore","2024-04-12",0,0,8,0,0,8,0,0
"Singapore","2024-04-13",0,0,8,0,0,8,0,0
"Singapore","2024-04-14",0,0,8,0,0,8,0,0
"Singapore","2024-04-15",0,0,8,0,0,8,0,0
"Singapore","2024-04-16",0,0,8,0,1,9,0,0
"Singapore","2024-04-17",0,0,8,0,0,9,0,0
"Singapore","2024-04-18",0,0,8,0,0,9,0,0
"Singapore","2024-04-19",0,0,8,0,0,9,0,0
"Singapore","2024-04-20",0,0,8,0,0,9,0,0
"Singapore","2024-04-21",0,0,8,0,0,9,0,0
"Singapore","2024-04-22",0,0,8,0,0,9,0,0
"Singapore","2024-04-23",0,0,8,0,0,9,0,0
"Singapore","2024-04-24",0,0,8,0,0,9,0,0
"Singapore","2024-04-25",0,0,8,0,0,9,0,0
"Singapore","2024-04-26",0,1,9,0,0,9,0,0
"Singapore","2024-04-27",0,0,9,0,0,9,0,0
"Singapore","2024-04-28",0,0,9,0,0,9,0,0
"Singapore","2024-04-29",0,0,9,0,0,9,0,0
"Singapore","2024-04-30",0,0,9,0,0,9,0,0
"Singapore","2024-05-01",0,0,9,0,0,9,0,0
"Singapore","2024-05-02",0,0,9,0,0,9,0,0
"Singapore","2024-05-03",0,0,9,0,0,9,0,0
"Singapore","2024-05-04",0,0,9,0,0,9,0,0
"Singapore","2024-05-05",0,0,9,0,0,9,0,0
"Singapore","2024-05-06",0,0,9,0,0,9,0,0
"Singapore","2024-05-07",0,0,9,0,0,9,0,0
"Singapore","2024-05-08",0,0,9,0,0,9,0,0
"Singapore","2024-05-09",0,0,9,0,0,9,0,0
"Singapore","2024-05-10",0,0,9,0,0,9,0,0
"Singapore","2024-05-11",0,0,9,0,0,9,0,0
"Singapore","2024-05-12",0,0,9,0,0,9,0,0
"Singapore","2024-05-13",0,0,9,0,0,9,0,0
"Singapore","2024-05-14",0,0,9,0,0,9,0,0
"Singapore","2024-05-15",0,0,9,0,0,9,0,0
"Singapore","2024-05-16",0,0,9,0,0,9,0,0
"Singapore","2024-05-17",0,0,9,0,0,9,0,0
"Singapore","2024-05-18",0,0,9,0,0,9,0,0
"Singapore","2024-05-19",0,0,9,0,0,9,0,0
"Singapore","2024-05-20",0,0,9,0,0,9,0,0
"Singapore","2024-05-21",0,0,9,0,0,9,0,0
"Singapore","2024-05-22",0,0,9,0,0,9,0,0
"Singapore","2024-05-23",0,0,9,0,0,9,0,0
"Singapore","2024-05-24",0,0,9,0,0,9,0,0
"Singapore","2024-05-25",0,0,9,0,0,9,0,0
"Singapore","2024-05-26",0,0,9,0,0,9,0,0
"Singapore","2024-05-27",0,0,9,0,1,10,0,0
"Singapore","2024-05-28",0,0,9,0,0,10,0,0
"Singapore","2024-05-29",0,0,9,0,0,10,0,0
"Singapore","2024-05-30",0,0,9,0,0,10,0,0
"Singapore","2024-05-31",0,0,9,0,0,10,0,0
"Singapore","2024-06-01",0,0,9,0,0,10,0,0
"Singapore","2024-06-02",0,0,9,0,0,10,0,0
"Singapore","2024-06-03",0,0,9,0,0,10,0,0
"Singapore","2024-06-04",0,0,9,0,0,10,0,0
"Singapore","2024-06-05",0,0,9,0,0,10,0,0
"Singapore","2024-06-06",0,0,9,0,0,10,0,0
"Singapore","2024-06-07",0,0,9,0,0,10,0,0
"Singapore","2024-06-08",0,0,9,0,0,10,0,0
"Singapore","2024-06-09",0,0,9,0,0,10,0,0
"Singapore","2024-06-10",0,0,9,0,0,10,0,0
"Singapore","2024-06-11",0,0,9,0,0,10,0,0
"Singapore","2024-06-12",0,0,9,0,0,10,0,0
"Singapore","2024-06-13",0,0,9,0,0,10,0,0
"Singapore","2024-06-14",0,0,9,0,0,10,0,0
"Singapore","2024-06-15",0,0,9,0,0,10,0,0
"Singapore","2024-06-16",0,0,9,0,0,10,0,0
"Singapore","2024-06-17",0,0,9,0,0,10,0,0
"Singapore","2024-06-18",0,0,9,0,0,10,0,0
"Singapore","2024-06-19",0,0,9,0,0,10,0,0
"Singapore","2024-06-20",0,0,9,0,0,10,0,0
"Singapore","2024-06-21",0,0,9,0,0,10,0,0
"Singapore","2024-06-22",0,0,9,0,0,10,0,0
"Singapore","2024-06-23",0,0,9,0,0,10,0,0
"Singapore","2024-06-24",0,0,9,0,0,10,0,0
"Singapore","2024-06-25",0,1,10,0,0,10,0,0
"Singapore","2024-06-26",0,0,10,0,0,10,0,0
"Singapore","2024-06-27",0,0,10,0,0,10,0,0
"Singapore","2024-06-28",0,0,10,0,0,10,0,0
"Singapore","2024-06-29",0,0,10,0,0,10,0,0
"Singapore","2024-06-30",0,0,10,0,0,10,0,0
"Singapore","2024-07-01",0,0,10,0,0,10,0,0
"Singapore","2024-07-02",0,0,10,0,0,10,0,0
"Singapore","2024-07-03",0,0,10,0,0,10,0,0
"Singapore","2024-07-04",0,0,10,0,0,10,0,0
"Singapore","2024-07-05",0,0,10,0,1,11,0,0
"Singapore","2024-07-06",0,0,10,0,0,11,0,0
"Singapore","2024-07-07",0,0,10,0,0,11,0,0
"Singapore","2024-07-08",0,0,10,0,0,11,0,0
"Singapore","2024-07-09",0,0,10,0,0,11,0,0
"Singapore","2024-07-10",0,0,10,0,0,11,0,0
"Singapore","2024-07-11",0,0,10,0,0,11,0,0
"Singapore","2024-07-12",0,0,10,0,0,11,0,0
"Singapore","2024-07-13",0,1,11,0,0,11,0,0
"Singapore","2024-07-14",0,0,11,0,0,11,0,0
"Singapore","2024-07-15",0,0,11,0,0,11,0,0
"Singapore","2024-07-16",0,0,11,0,0,11,0,0
"Singapore","2024-07-17",0,0,11,0,0,11,0,0
"Singapore","2024-07-18",0,0,11,0,0,11,0,0
"Singapore","2024-07-19",0,0,11,0,0,11,0,0
"Singapore","2024-07-20",0,0,11,0,0,11,0,0
"Singapore","2024-07-21",0,0,11,0,0,11,0,0
"Singapore","2024-07-22",0,0,11,0,1,12,0,0
"Singapore","2024-07-23",0,0,11,0,0,12,0,0
"Singapore","2024-07-24",0,0,11,0,0,12,0,0
"Singapore","2024-07-25",0,0,11,0,0,12,0,0
"Singapore","2024-07-26",0,0,11,0,0,12,0,0
"Singapore","2024-07-27",0,0,11,0,0,12,0,0
"Singapore","2024-07-28",0,0,11,0,0,12,0,0
"Singapore","2024-07-29",0,0,11,0,0,12,0,0
"Singapore","2024-07-30",0,0,11,0,0,12,0,0
"Singapore","2024-07-31",0,0,11,0,0,12,0,0
"Singapore","2024-08-01",0,0,11,0,0,12,0,0
"Singapore","2024-08-02",0,0,11,0,0,12,0,0
"Singapore","2024-08-03",0,0,11,0,0,12,0,0
"Singapore","2024-08-04",0,0,11,0,0,12,0,0
"Singapore","2024-08-05",0,0,11,0,0,12,0,0
"Singapore","2024-08-06",0,0,11,0,0,12,0,0
"Singapore","2024-08-07",0,0,11,0,1,13,0,0
"Singapore","2024-08-08",0,0,11,0,0,13,0,0
"Singapore","2024-08-09",0,0,11,0,0,13,0,0
"Singapore","2024-08-10",0,0,11,0,0,13,0,0
"Singapore","2024-08-11",0,0,11,0,0,13,0,0
"Singapore","2024-08-12",0,0,11,0,0,13,0,0
"Singapore","2024-08-13",0,0,11,0,0,13,0,0
"Singapore","2024-08-14",0,0,11,0,0,13,0,0
"Singapore","2024-08-15",0,2,13,0,0,13,0,0
"Singapore","2024-08-16",0,0,13,0,0,13,0,0
"Singapore","2024-08-17",0,0,13,0,0,13,0,0
"Singapore","2024-08-18",0,0,13,0,0,13,0,0
"Singapore","2024-08-19",0,0,13,0,0,13,0,0
"Singapore","2024-08-20",0,0,13,0,1,14,0,0
"Singapore","2024-08-21",0,0,13,0,0,14,0,0
"Singapore","2024-08-22",0,0,13,0,0,14,0,0
"Singapore","2024-08-23",0,1,14,0,0,14,0,0
"Singapore","2024-08-24",0,0,14,0,0,14,0,0
"Singapore","2024-08-25",0,0,14,0,0,14,0,0
"Singapore","2024-08-26",0,0,14,0,0,14,0,0
"Singapore","2024-08-27",0,0,14,0,0,14,0,0
"Singapore","2024-08-28",0,0,14,0,0,14,0,0
"Singapore","2024-08-29",0,0,14,0,0,14,0,0
"Singapore","2024-08-30",0,0,14,0,0,14,0,0
"Singapore","2024-08-31",0,0,14,0,0,14,0,0
"Singapore","2024-09-01",0,0,14,0,1,15,0,0
"Singapore","2024-09-02",0,0,14,0,0,15,0,0
"Singapore","2024-09-03",0,0,14,0,0,15,0,0
"Singapore","2024-09-04",0,0,14,0,0,15,0,0
"Singapore","2024-09-05",0,0,14,0,0,15,0,0
"Singapore","2024-09-06",0,0,14,0,0,15,0,0
"Singapore","2024-09-07",0,0,14,0,0,15,0,0
"Singapore","2024-09-08",0,1,15,0,0,15,0,0
"Singapore","2024-09-09",0,0,15,0,0,15,0,0
"Singapore","2024-09-10",0,0,15,0,0,15,0,0
"Singapore","2024-09-11",0,0,15,0,0,15,0,0
"Singapore","2024-09-12",0,0,15,0,0,15,0,0
"Singapore","2024-09-13",0,0,15,0,0,15,0,0
"Singapore","2024-09-14",0,0,15,0,0,15,0,0
"Singapore","2024-09-15",0,0,15,0,0,15,0,0
"Singapore","2024-09-16",0,0,15,0,0,15,0,0
"Singapore","2024-09-17",0,0,15,0,1,16,0,0
"Singapore","2024-09-18",0,0,15,0,0,16,0,0
"Singapore","2024-09-19",0,0,15,0,0,16,0,0
"Singapore","2024-09-20",0,0,15,0,0,16,0,0
"Singapore","2024-09-21",0,0,15,0,0,16,0,0
"Singapore","2024-09-22",0,0,15,0,0,16,0,0
"Singapore","2024-09-23",0,0,15,0,0,16,0,0
"Singapore","2024-09-24",0,0,15,0,0,16,0,0
"Singapore","2024-09-25",0,0,15,0,0,16,0,0
"Singapore","2024-09-26",0,0,15,0,0,16,0,0
"Singapore","2024-09-27",0,0,15,0,0,16,0,0
"Singapore","2024-09-28",0,0,15,0,0,16,0,0
"Singapore","2024-09-29",0,0,15,0,0,16,0,0
"Singapore","2024-09-30",0,0,15,0,0,16,0,0
"Singapore","2024-10-01",0,0,15,0,0,16,0,0
"Singapore","2024-10-02",0,0,15,0,0,16,0,0
"Singapore","2024-10-03",0,0,15,0,1,17,0,0
"Singapore","2024-10-04",0,0,15,0,0,17,0,0
"Singapore","2024-10-05",0,0,15,0,0,17,0,0
"Singapore","2024-10-06",0,0,15,0,0,17,0,0
"Singapore","2024-10-07",0,0,15,0,0,17,0,0
"Singapore","2024-10-08",0,0,15,0,0,17,0,0
"Singapore","2024-10-09",0,0,15,0,0,17,0,0
"Singapore","2024-10-10",0,0,15,0,0,17,0,0
"Singapore","2024-10-11",0,2,17,0,0,17,0,0
"Singapore","2024-10-12",0,0,17,0,0,17,0,0
"Singapore","2024-10-13",0,0,17,0,0,17,0,0
"Singapore","2024-10-14",0,0,17,0,0,17,0,0
"Singapore","2024-10-15",0,0,17,0,0,17,0,0
"Singapore","2024-10-16",0,0,17,0,0,17,0,0
"Singapore","2024-10-17",0,0,17,0,0,17,0,0
"Singapore","2024-10-18",0,0,17,0,0,17,0,0
"Singapore","2024-10-19",0,0,17,0,0,17,0,0
"Singapore","2024-10-20",0,0,17,0,0,17,0,0
"Singapore","2024-10-21",0,0,17,0,0,17,0,0
"Singapore","2024-10-22",0,0,17,0,0,17,0,0
"Singapore","2024-10-23",0,0,17,0,0,17,0,0
"Singapore","2024-10-24",0,0,17,0,0,17,0,0
"Singapore","2024-10-25",0,0,17,0,0,17,0,0
"Singapore","2024-10-26",0,0,17,0,0,17,0,0
"Singapore","2024-10-27",0,0,17,0,0,17,0,0
"Singapore","2024-10-28",0,0,17,0,0,17,0,0
"Singapore","2024-10-29",0,0,17,0,0,17,0,0
"Singapore","2024-10-30",0,0,17,0,0,17,0,0
"Singapore","2024-10-31",0,0,17,0,0,17,0,0
"Singapore","2024-11-01",0,0,17,0,0,17,0,0
"Singapore","2024-11-02",0,0,17,0,0,17,0,0
"Singapore","2024-11-03",0,0,17,0,0,17,0,0
"Singapore","2024-11-04",0,0,17,0,0,17,0,0
"Singapore","2024-11-05",0,0,17,0,0,17,0,0
"Singapore","2024-11-06",0,0,17,0,0,17,0,0
"Singapore","2024-11-07",0,0,17,0,0,17,0,0
"Singapore","2024-11-08",0,0,17,0,0,17,0,0
"Singapore","2024-11-09",0,0,17,0,0,17,0,0
"Singapore","2024-11-10",0,0,17,0,0,17,0,0
"Singapore","2024-11-11",0,0,17,0,0,17,0,0
"Singapore","2024-11-12",0,0,17,0,0,17,0,0
"Singapore","2024-11-13",0,0,17,0,0,17,0,0
"Singapore","2024-11-14",0,0,17,0,0,17,0,0
"Singapore","2024-11-15",0,0,17,0,0,17,0,0
"Singapore","2024-11-16",0,0,17,0,0,17,0,0
"Singapore","2024-11-17",0,0,17,0,0,17,0,0
"Singapore","2024-11-18",0,0,17,0,0,17,0,0
"Singapore","2024-11-19",0,0,17,0,1,18,0,0
"Singapore","2024-11-20",0,0,17,0,0,18,0,0
"Singapore","2024-11-21",0,0,17,0,0,18,0,0
"Singapore","2024-11-22",0,0,17,0,0,18,0,0
"Singapore","2024-11-23",0,0,17,0,0,18,0,0
"Singapore","2024-11-24",0,0,17,0,0,18,0,0
"Singapore","2024-11-25",0,0,17,0,0,18,0,0
"Singapore","2024-11-26",0,0,17,0,0,18,0,0
"Singapore","2024-11-27",0,0,17,0,0,18,0,0
"Singapore","2024-11-28",0,0,17,0,0,18,0,0
"Singapore","2024-11-29",0,0,17,0,0,18,0,0
"Singapore","2024-11-30",0,0,17,0,0,18,0,0
"Singapore","2024-12-01",0,0,17,0,0,18,0,0
"Singapore","2024-12-02",0,0,17,0,0,18,0,0
"Singapore","2024-12-03",0,0,17,0,0,18,0,0
"Singapore","2024-12-04",0,0,17,0,0,18,0,0
"Singapore","2024-12-05",0,0,17,0,0,18,0,0
"Singapore","2024-12-06",0,0,17,0,0,18,0,0
"Singapore","2024-12-07",0,0,17,0,0,18,0,0
"Singapore","2024-12-08",0,0,17,0,0,18,0,0
"Singapore","2024-12-09",0,0,17,0,0,18,0,0
"Singapore","2024-12-10",0,0,17,0,0,18,0,0
"Singapore","2024-12-11",0,0,17,0,0,18,0,0
"Singapore","2024-12-12",0,0,17,0,0,18,0,0
"Singapore","2024-12-13",0,0,17,0,0,18,0,0
"Singapore","2024-12-14",0,0,17,0,0,18,0,0
"Singapore","2024-12-15",0,0,17,0,0,18,0,0
"Singapore","2024-12-16",0,0,17,0,0,18,0,0
"Singapore","2024-12-17",0,0,17,0,0,18,0,0
"Singapore","2024-12-18",0,0,17,0,0,18,0,0
"Singapore","2024-12-19",0,0,17,0,0,18,0,0
"Singapore","2024-12-20",0,0,17,0,0,18,0,0
"Singapore","2024-12-21",0,0,17,0,0,18,0,0
"Singapore","2024-12-22",0,0,17,0,0,18,0,0
"Singapore","2024-12-23",0,0,17,0,0,18,0,0
"Singapore","2024-12-24",0,0,17,0,0,18,0,0
"Singapore","2024-12-25",0,0,17,0,0,18,0,0
"Singapore","2024-12-26",0,0,17,0,0,18,0,0
"Singapore","2024-12-27",0,1,18,0,0,18,0,0
"Singapore","2024-12-28",0,0,18,0,0,18,0,0
"Singapore","2024-12-29",0,0,18,0,0,18,0,0
"Singapore","2024-12-30",0,0,18,0,0,18,0,0
"Singapore","2024-12-31",0,0,18,0,0,18,0,0
"Singapore","2025-01-01",0,0,18,0,0,18,0,0
"Singapore","2025-01-02",0,0,18,0,0,18,0,0
"Singapore","2025-01-03",0,0,18,0,0,18,0,0
"Singapore","2025-01-04",0,0,18,0,0,18,0,0
"Singapore","2025-01-05",0,0,18,0,0,18,0,0
"Singapore","2025-01-06",0,0,18,0,0,18,0,0
"Singapore","2025-01-07",0,0,18,0,0,18,0,0
"Singapore","2025-01-08",0,0,18,0,0,18,0,0
"Singapore","2025-01-09",0,0,18,0,0,18,0,0
"Singapore","2025-01-10",0,0,18,0,0,18,0,0
"Singapore","2025-01-11",0,0,18,0,1,19,0,0
"Singapore","2025-01-12",0,0,18,0,0,19,0,0
"Singapore","2025-01-13",0,0,18,0,0,19,0,0
"Singapore","2025-01-14",0,0,18,0,0,19,0,0
"Singapore","2025-01-15",0,0,18,0,0,19,0,0
"Singapore","2025-01-16",0,0,18,0,0,19,0,0
"Singapore","2025-01-17",0,0,18,0,0,19,0,0
"Singapore","2025-01-18",0,0,18,0,0,19,0,0
"Singapore","2025-01-19",0,0,18,0,0,19,0,0
"Singapore","2025-01-20",0,0,18,0,0,19,0,0
"Singapore","2025-01-21",0,0,18,0,0,19,0,0
"Singapore","2025-01-22",0,0,18,0,0,19,0,0
"Singapore","2025-01-23",0,0,18,0,0,19,0,0
"Singapore","2025-01-24",0,1,19,0,0,19,0,0
"Singapore","2025-01-25",0,0,19,0,0,19,0,0
"Singapore","2025-01-26",0,0,19,0,0,19,0,0
"Singapore","2025-01-27",0,0,19,0,0,19,0,0
"Singapore","2025-01-28",0,0,19,0,0,19,0,0
"Singapore","2025-01-29",0,0,19,0,0,19,0,0
"Singapore","2025-01-30",0,0,19,0,0,19,0,0
"Singapore","2025-01-31",0,0,19,0,0,19,0,0
"Singapore","2025-02-01",0,0,19,0,1,20,0,0
"Singapore","2025-02-02",0,0,19,0,0,20,0,0
"Singapore","2025-02-03",0,0,19,0,0,20,0,0
"Singapore","2025-02-04",0,0,19,0,0,20,0,0
"Singapore","2025-02-05",0,0,19,0,0,20,0,0
"Singapore","2025-02-06",0,0,19,0,0,20,0,0
"Singapore","2025-02-07",0,1,20,0,0,20,0,0
"Singapore","2025-02-08",0,0,20,0,0,20,0,0
"Singapore","2025-02-09",0,0,20,0,0,20,0,0
"Singapore","2025-02-10",0,0,20,0,0,20,0,0
"Singapore","2025-02-11",0,0,20,0,0,20,0,0
"Singapore","2025-02-12",0,0,20,0,0,20,0,0
"Singapore","2025-02-13",0,0,20,0,0,20,0,0
"Singapore","2025-02-14",0,0,20,0,0,20,0,0
"Singapore","2025-02-15",0,0,20,0,0,20,0,0
"Singapore","2025-02-16",0,0,20,0,0,20,0,0
"Singapore","2025-02-17",0,0,20,0,0,20,0,0
"Singapore","2025-02-18",0,0,20,0,0,20,0,0
"Singapore","2025-02-19",0,0,20,0,0,20,0,0
"Singapore","2025-02-20",0,0,20,0,0,20,0,0
"Singapore","2025-02-21",0,0,20,0,0,20,0,0
"Singapore","2025-02-22",0,0,20,0,0,20,0,0
"Singapore","2025-02-23",0,0,20,0,0,20,0,0
"Singapore","2025-02-24",0,0,20,0,0,20,0,0
"Singapore","2025-02-25",0,0,20,0,0,20,0,0
"Singapore","2025-02-26",0,0,20,0,0,20,0,0
"Singapore","2025-02-27",0,0,20,0,0,20,0,0
"Singapore","2025-02-28",0,0,20,0,0,20,0,0
"Singapore","2025-03-01",0,0,20,0,0,20,0,0
"Singapore","2025-03-02",0,0,20,0,0,20,0,0
"Singapore","2025-03-03",0,0,20,0,0,20,0,0
"Slovakia","2024-01-01",0,0,0,0,0,0,0,0
"Slovakia","2024-01-02",0,0,0,0,0,0,0,0
"Slovakia","2024-01-03",0,0,0,0,0,0,0,0
"Slovakia","2024-01-04",0,0,0,0,0,0,0,0
"Slovakia","2024-01-05",0,0,0,0,0,0,0,0
"Slovakia","2024-01-06",0,0,0,0,0,0,0,0
"Slovakia","2024-01-07",0,0,0,0,0,0,0,0
"Slovakia","2024-01-08",0,0,0,0,0,0,0,0
"Slovakia","2024-01-09",0,0,0,0,0,0,0,0
"Slovakia","2024-01-10",0,0,0,0,0,0,0,0
"Slovakia","2024-01-11",0,0,0,0,0,0,0,0
"Slovakia","2024-01-12",0,0,0,0,0,0,0,0
"Slovakia","2024-01-13",0,0,0,0,0,0,0,0
"Slovakia","2024-01-14",0,0,0,0,0,0,0,0
"Slovakia","2024-01-15",0,0,0,0,0,0,0,0
"Slovakia","2024-01-16",0,0,0,0,0,0,0,0
"Slovakia","2024-01-17",0,0,0,0,0,0,0,0
"Slovakia","2024-01-18",0,0,0,0,0,0,0,0
"Slovakia","2024-01-19",0,0,0,0,0,0,0,0
"Slovakia","2024-01-20",0,0,0,0,0,0,0,0
"Slovakia","2024-01-21",0,0,0,0,0,0,0,0
"Slovakia","2024-01-22",0,0,0,0,0,0,0,0
"Slovakia","2024-01-23",0,0,0,0,0,0,0,0
"Slovakia","2024-01-24",0,0,0,0,0,0,0,0
"Slovakia","2024-01-25",0,0,0,0,0,0,0,0
"Slovakia","2024-01-26",0,0,0,0,0,0,0,0
"Slovakia","2024-01-27",0,0,0,0,0,0,0,0
"Slovakia","2024-01-28",0,0,0,0,0,0,0,0
"Slovakia","2024-01-29",0,0,0,0,0,0,0,0
"Slovakia","2024-01-30",0,0,0,0,0,0,0,0
"Slovakia","2024-01-31",0,2,2,0,2,2,0,0
"Slovakia","2024-02-01",0,0,2,0,0,2,0,0
"Slovakia","2024-02-02",0,0,2,0,0,2,0,0
"Slovakia","2024-02-03",0,0,2,0,0,2,0,0
"Slovakia","2024-02-04",0,0,2,0,0,2,0,0
"Slovakia","2024-02-05",0,0,2,0,0,2,0,0
"Slovakia","2024-02-06",0,0,2,0,0,2,0,0
"Slovakia","2024-02-07",0,0,2,0,0,2,0,0
"Slovakia","2024-02-08",0,0,2,0,0,2,0,0
"Slovakia","2024-02-09",0,0,2,0,0,2,0,0
"Slovakia","2024-02-10",0,0,2,0,0,2,0,0
"Slovakia","2024-02-11",0,0,2,0,0,2,0,0
"Slovakia","2024-02-12",0,0,2,0,0,2,0,0
"Slovakia","2024-02-13",0,0,2,0,0,2,0,0
"Slovakia","2024-02-14",0,0,2,0,0,2,0,0
"Slovakia","2024-02-15",0,0,2,0,0,2,0,0
"Slovakia","2024-02-16",0,0,2,0,0,2,0,0
"Slovakia","2024-02-17",0,0,2,0,0,2,0,0
"Slovakia","2024-02-18",0,0,2,0,0,2,0,0
"Slovakia","2024-02-19",0,0,2,0,0,2,0,0
"Slovakia","2024-02-20",0,0,2,0,0,2,0,0
"Slovakia","2024-02-21",0,0,2,0,0,2,0,0
"Slovakia","2024-02-22",0,0,2,0,0,2,0,0
"Slovakia","2024-02-23",0,0,2,0,0,2,0,0
"Slovakia","2024-02-24",0,0,2,0,0,2,0,0
"Slovakia","2024-02-25",0,0,2,0,0,2,0,0
"Slovakia","2024-02-26",0,0,2,0,0,2,0,0
"Slovakia","2024-02-27",0,0,2,0,0,2,0,0
"Slovakia","2024-02-28",0,0,2,0,0,2,0,0
"Slovakia","2024-02-29",0,0,2,0,0,2,0,0
"Slovakia","2024-03-01",0,0,2,0,0,2,0,0
"Slovakia","2024-03-02",0,0,2,0,0,2,0,0
"Slovakia","2024-03-03",0,0,2,0,0,2,0,0
"Slovakia","2024-03-04",0,0,2,0,0,2,0,0
"Slovakia","2024-03-05",0,0,2,0,0,2,0,0
"Slovakia","2024-03-06",0,0,2,0,0,2,0,0
"Slovakia","2024-03-07",0,0,2,0,0,2,0,0
"Slovakia","2024-03-08",0,0,2,0,0,2,0,0
"Slovakia","2024-03-09",0,0,2,0,0,2,0,0
"Slovakia","2024-03-10",0,0,2,0,0,2,0,0
"Slovakia","2024-03-11",0,0,2,0,0,2,0,0
"Slovakia","2024-03-12",0,0,2,0,0,2,0,0
"Slovakia","2024-03-13",0,0,2,0,0,2,0,0
"Slovakia","2024-03-14",0,0,2,0,0,2,0,0
"Slovakia","2024-03-15",0,0,2,0,0,2,0,0
"Slovakia","2024-03-16",0,0,2,0,0,2,0,0
"Slovakia","2024-03-17",0,0,2,0,0,2,0,0
"Slovakia","2024-03-18",0,0,2,0,0,2,0,0
"Slovakia","2024-03-19",0,0,2,0,0,2,0,0
"Slovakia","2024-03-20",0,0,2,0,0,2,0,0
"Slovakia","2024-03-21",0,0,2,0,0,2,0,0
"Slovakia","2024-03-22",0,0,2,0,0,2,0,0
"Slovakia","2024-03-23",0,0,2,0,0,2,0,0
"Slovakia","2024-03-24",0,0,2,0,0,2,0,0
"Slovakia","2024-03-25",0,0,2,0,0,2,0,0
"Slovakia","2024-03-26",0,0,2,0,0,2,0,0
"Slovakia","2024-03-27",0,0,2,0,0,2,0,0
"Slovakia","2024-03-28",0,0,2,0,0,2,0,0
"Slovakia","2024-03-29",0,0,2,0,0,2,0,0
"Slovakia","2024-03-30",0,0,2,0,0,2,0,0
"Slovakia","2024-03-31",0,0,2,0,0,2,0,0
"Slovakia","2024-04-01",0,0,2,0,0,2,0,0
"Slovakia","2024-04-02",0,0,2,0,0,2,0,0
"Slovakia","2024-04-03",0,0,2,0,0,2,0,0
"Slovakia","2024-04-04",0,0,2,0,0,2,0,0
"Slovakia","2024-04-05",0,0,2,0,0,2,0,0
"Slovakia","2024-04-06",0,0,2,0,0,2,0,0
"Slovakia","2024-04-07",0,0,2,0,0,2,0,0
"Slovakia","2024-04-08",0,0,2,0,0,2,0,0
"Slovakia","2024-04-09",0,0,2,0,0,2,0,0
"Slovakia","2024-04-10",0,0,2,0,0,2,0,0
"Slovakia","2024-04-11",0,0,2,0,0,2,0,0
"Slovakia","2024-04-12",0,0,2,0,0,2,0,0
"Slovakia","2024-04-13",0,0,2,0,0,2,0,0
"Slovakia","2024-04-14",0,0,2,0,0,2,0,0
"Slovakia","2024-04-15",0,0,2,0,0,2,0,0
"Slovakia","2024-04-16",0,0,2,0,0,2,0,0
"Slovakia","2024-04-17",0,0,2,0,1,3,0,0
"Slovakia","2024-04-18",0,0,2,0,0,3,0,0
"Slovakia","2024-04-19",0,0,2,0,0,3,0,0
"Slovakia","2024-04-20",0,0,2,0,0,3,0,0
"Slovakia","2024-04-21",0,0,2,0,0,3,0,0
"Slovakia","2024-04-22",0,0,2,0,0,3,0,0
"Slovakia","2024-04-23",0,0,2,0,0,3,0,0
"Slovakia","2024-04-24",0,0,2,0,0,3,0,0
"Slovakia","2024-04-25",0,0,2,0,0,3,0,0
"Slovakia","2024-04-26",0,0,2,0,0,3,0,0
"Slovakia","2024-04-27",0,0,2,0,0,3,0,0
"Slovakia","2024-04-28",0,0,2,0,0,3,0,0
"Slovakia","2024-04-29",0,0,2,0,0,3,0,0
"Slovakia","2024-04-30",0,0,2,0,0,3,0,0
"Slovakia","2024-05-01",0,0,2,0,0,3,0,0
"Slovakia","2024-05-02",0,0,2,0,0,3,0,0
"Slovakia","2024-05-03",0,0,2,0,0,3,0,0
"Slovakia","2024-05-04",0,0,2,0,0,3,0,0
"Slovakia","2024-05-05",0,0,2,0,0,3,0,0
"Slovakia","2024-05-06",0,0,2,0,0,3,0,0
"Slovakia","2024-05-07",0,0,2,0,0,3,0,0
"Slovakia","2024-05-08",0,0,2,0,0,3,0,0
"Slovakia","2024-05-09",0,0,2,0,0,3,0,0
"Slovakia","2024-05-10",0,0,2,0,0,3,0,0
"Slovakia","2024-05-11",0,0,2,0,0,3,0,0
"Slovakia","2024-05-12",0,0,2,0,0,3,0,0
"Slovakia","2024-05-13",0,0,2,0,0,3,0,0
"Slovakia","2024-05-14",0,0,2,0,0,3,0,0
"Slovakia","2024-05-15",0,0,2,0,0,3,0,0
"Slovakia","2024-05-16",0,0,2,0,0,3,0,0
"Slovakia","2024-05-17",0,0,2,0,0,3,0,0
"Slovakia","2024-05-18",0,0,2,0,0,3,0,0
"Slovakia","2024-05-19",0,0,2,0,0,3,0,0
"Slovakia","2024-05-20",0,0,2,0,0,3,0,0
"Slovakia","2024-05-21",0,0,2,0,0,3,0,0
"Slovakia","2024-05-22",0,0,2,0,0,3,0,0
"Slovakia","2024-05-23",0,0,2,0,0,3,0,0
"Slovakia","2024-05-24",0,0,2,0,0,3,0,0
"Slovakia","2024-05-25",0,0,2,0,0,3,0,0
"Slovakia","2024-05-26",0,0,2,0,0,3,0,0
"Slovakia","2024-05-27",0,0,2,0,0,3,0,0
"Slovakia","2024-05-28",0,0,2,0,0,3,0,0
"Slovakia","2024-05-29",0,0,2,0,0,3,0,0
"Slovakia","2024-05-30",0,0,2,0,0,3,0,0
"Slovakia","2024-05-31",0,0,2,0,0,3,0,0
"Slovakia","2024-06-01",0,0,2,0,0,3,0,0
"Slovakia","2024-06-02",0,0,2,0,0,3,0,0
"Slovakia","2024-06-03",0,0,2,0,0,3,0,0
"Slovakia","2024-06-04",0,0,2,0,0,3,0,0
"Slovakia","2024-06-05",0,0,2,0,0,3,0,0
"Slovakia","2024-06-06",0,0,2,0,0,3,0,0
"Slovakia","2024-06-07",0,0,2,0,0,3,0,0
"Slovakia","2024-06-08",0,0,2,0,0,3,0,0
"Slovakia","2024-06-09",0,0,2,0,0,3,0,0
"Slovakia","2024-06-10",0,0,2,0,0,3,0,0
"Slovakia","2024-06-11",0,0,2,0,0,3,0,0
"Slovakia","2024-06-12",0,0,2,0,0,3,0,0
"Slovakia","2024-06-13",0,0,2,0,0,3,0,0
"Slovakia","2024-06-14",0,0,2,0,0,3,0,0
"Slovakia","2024-06-15",0,0,2,0,0,3,0,0
"Slovakia","2024-06-16",0,0,2,0,0,3,0,0
"Slovakia","2024-06-17",0,0,2,0,0,3,0,0
"Slovakia","2024-06-18",0,0,2,0,0,3,0,0
"Slovakia","2024-06-19",0,0,2,0,0,3,0,0
"Slovakia","2024-06-20",0,0,2,0,0,3,0,0
"Slovakia","2024-06-21",0,0,2,0,0,3,0,0
"Slovakia","2024-06-22",0,0,2,0,0,3,0,0
"Slovakia","2024-06-23",0,0,2,0,0,3,0,0
"Slovakia","2024-06-24",0,0,2,0,0,3,0,0
"Slovakia","2024-06-25",0,0,2,0,0,3,0,0
"Slovakia","2024-06-26",0,0,2,0,0,3,0,0
"Slovakia","2024-06-27",0,0,2,0,0,3,0,0
"Slovakia","2024-06-28",0,0,2,0,0,3,0,0
"Slovakia","2024-06-29",0,0,2,0,0,3,0,0
"Slovakia","2024-06-30",0,0,2,0,0,3,0,0
"Slovakia","2024-07-01",0,0,2,0,0,3,0,0
"Slovakia","2024-07-02",0,0,2,0,0,3,0,0
"Slovakia","2024-07-03",0,0,2,0,0,3,0,0
"Slovakia","2024-07-04",0,0,2,0,0,3,0,0
"Slovakia","2024-07-05",0,0,2,0,0,3,0,0
"Slovakia","2024-07-06",0,0,2,0,0,3,0,0
"Slovakia","2024-07-07",0,0,2,0,0,3,0,0
"Slovakia","2024-07-08",0,0,2,0,0,3,0,0
"Slovakia","2024-07-09",0,0,2,0,0,3,0,0
"Slovakia","2024-07-10",0,0,2,0,0,3,0,0
"Slovakia","2024-07-11",0,0,2,0,0,3,0,0
"Slovakia","2024-07-12",0,0,2,0,0,3,0,0
"Slovakia","2024-07-13",0,0,2,0,0,3,0,0
"Slovakia","2024-07-14",0,0,2,0,0,3,0,0
"Slovakia","2024-07-15",0,0,2,0,0,3,0,0
"Slovakia","2024-07-16",0,0,2,0,0,3,0,0
"Slovakia","2024-07-17",0,0,2,0,0,3,0,0
"Slovakia","2024-07-18",0,0,2,0,0,3,0,0
"Slovakia","2024-07-19",0,0,2,0,0,3,0,0
"Slovakia","2024-07-20",0,0,2,0,0,3,0,0
"Slovakia","2024-07-21",0,0,2,0,0,3,0,0
"Slovakia","2024-07-22",0,0,2,0,0,3,0,0
"Slovakia","2024-07-23",0,0,2,0,0,3,0,0
"Slovakia","2024-07-24",0,0,2,0,0,3,0,0
"Slovakia","2024-07-25",0,0,2,0,0,3,0,0
"Slovakia","2024-07-26",0,0,2,0,0,3,0,0
"Slovakia","2024-07-27",0,0,2,0,0,3,0,0
"Slovakia","2024-07-28",0,0,2,0,0,3,0,0
"Slovakia","2024-07-29",0,0,2,0,0,3,0,0
"Slovakia","2024-07-30",0,0,2,0,0,3,0,0
"Slovakia","2024-07-31",0,0,2,0,0,3,0,0
"Slovakia","2024-08-01",0,0,2,0,0,3,0,0
"Slovakia","2024-08-02",0,0,2,0,0,3,0,0
"Slovakia","2024-08-03",0,0,2,0,0,3,0,0
"Slovakia","2024-08-04",0,0,2,0,0,3,0,0
"Slovakia","2024-08-05",0,0,2,0,0,3,0,0
"Slovakia","2024-08-06",0,0,2,0,0,3,0,0
"Slovakia","2024-08-07",0,0,2,0,0,3,0,0
"Slovakia","2024-08-08",0,0,2,0,0,3,0,0
"Slovakia","2024-08-09",0,0,2,0,0,3,0,0
"Slovakia","2024-08-10",0,0,2,0,0,3,0,0
"Slovakia","2024-08-11",0,0,2,0,0,3,0,0
"Slovakia","2024-08-12",0,0,2,0,0,3,0,0
"Slovakia","2024-08-13",0,0,2,0,0,3,0,0
"Slovakia","2024-08-14",0,0,2,0,0,3,0,0
"Slovakia","2024-08-15",0,0,2,0,0,3,0,0
"Slovakia","2024-08-16",0,0,2,0,0,3,0,0
"Slovakia","2024-08-17",0,0,2,0,0,3,0,0
"Slovakia","2024-08-18",0,0,2,0,0,3,0,0
"Slovakia","2024-08-19",0,0,2,0,0,3,0,0
"Slovakia","2024-08-20",0,0,2,0,0,3,0,0
"Slovakia","2024-08-21",0,0,2,0,0,3,0,0
"Slovakia","2024-08-22",0,0,2,0,0,3,0,0
"Slovakia","2024-08-23",0,0,2,0,0,3,0,0
"Slovakia","2024-08-24",0,0,2,0,0,3,0,0
"Slovakia","2024-08-25",0,0,2,0,0,3,0,0
"Slovakia","2024-08-26",0,0,2,0,0,3,0,0
"Slovakia","2024-08-27",0,0,2,0,0,3,0,0
"Slovakia","2024-08-28",0,0,2,0,0,3,0,0
"Slovakia","2024-08-29",0,0,2,0,0,3,0,0
"Slovakia","2024-08-30",0,0,2,0,0,3,0,0
"Slovakia","2024-08-31",0,0,2,0,0,3,0,0
"Slovakia","2024-09-01",0,0,2,0,0,3,0,0
"Slovakia","2024-09-02",0,0,2,0,0,3,0,0
"Slovakia","2024-09-03",0,0,2,0,0,3,0,0
"Slovakia","2024-09-04",0,0,2,0,0,3,0,0
"Slovakia","2024-09-05",0,0,2,0,0,3,0,0
"Slovakia","2024-09-06",0,0,2,0,0,3,0,0
"Slovakia","2024-09-07",0,0,2,0,0,3,0,0
"Slovakia","2024-09-08",0,0,2,0,0,3,0,0
"Slovakia","2024-09-09",0,0,2,0,0,3,0,0
"Slovakia","2024-09-10",0,0,2,0,0,3,0,0
"Slovakia","2024-09-11",0,0,2,0,0,3,0,0
"Slovakia","2024-09-12",0,0,2,0,0,3,0,0
"Slovakia","2024-09-13",0,0,2,0,0,3,0,0
"Slovakia","2024-09-14",0,0,2,0,0,3,0,0
"Slovakia","2024-09-15",0,0,2,0,1,4,0,0
"Slovakia","2024-09-16",0,0,2,0,0,4,0,0
"Slovakia","2024-09-17",0,0,2,0,0,4,0,0
"Slovakia","2024-09-18",0,0,2,0,0,4,0,0
"Slovakia","2024-09-19",0,0,2,0,0,4,0,0
"Slovakia","2024-09-20",0,0,2,0,0,4,0,0
"Slovakia","2024-09-21",0,0,2,0,0,4,0,0
"Slovakia","2024-09-22",0,0,2,0,0,4,0,0
"Slovakia","2024-09-23",0,0,2,0,0,4,0,0
"Slovakia","2024-09-24",0,0,2,0,0,4,0,0
"Slovakia","2024-09-25",0,0,2,0,0,4,0,0
"Slovakia","2024-09-26",0,0,2,0,0,4,0,0
"Slovakia","2024-09-27",0,0,2,0,0,4,0,0
"Slovakia","2024-09-28",0,0,2,0,0,4,0,0
"Slovakia","2024-09-29",0,0,2,0,0,4,0,0
"Slovakia","2024-09-30",0,0,2,0,0,4,0,0
"Slovakia","2024-10-01",0,0,2,0,0,4,0,0
"Slovakia","2024-10-02",0,0,2,0,0,4,0,0
"Slovakia","2024-10-03",0,0,2,0,0,4,0,0
"Slovakia","2024-10-04",0,0,2,0,0,4,0,0
"Slovakia","2024-10-05",0,0,2,0,0,4,0,0
"Slovakia","2024-10-06",0,0,2,0,0,4,0,0
"Slovakia","2024-10-07",0,0,2,0,0,4,0,0
"Slovakia","2024-10-08",0,0,2,0,0,4,0,0
"Slovakia","2024-10-09",0,0,2,0,0,4,0,0
"Slovakia","2024-10-10",0,0,2,0,0,4,0,0
"Slovakia","2024-10-11",0,0,2,0,0,4,0,0
"Slovakia","2024-10-12",0,0,2,0,0,4,0,0
"Slovakia","2024-10-13",0,0,2,0,0,4,0,0
"Slovakia","2024-10-14",0,0,2,0,0,4,0,0
"Slovakia","2024-10-15",0,0,2,0,0,4,0,0
"Slovakia","2024-10-16",0,0,2,0,0,4,0,0
"Slovakia","2024-10-17",0,0,2,0,0,4,0,0
"Slovakia","2024-10-18",0,0,2,0,0,4,0,0
"Slovakia","2024-10-19",0,0,2,0,0,4,0,0
"Slovakia","2024-10-20",0,0,2,0,0,4,0,0
"Slovakia","2024-10-21",0,0,2,0,0,4,0,0
"Slovakia","2024-10-22",0,0,2,0,0,4,0,0
"Slovakia","2024-10-23",0,0,2,0,0,4,0,0
"Slovakia","2024-10-24",0,0,2,0,0,4,0,0
"Slovakia","2024-10-25",0,0,2,0,0,4,0,0
"Slovakia","2024-10-26",0,0,2,0,0,4,0,0
"Slovakia","2024-10-27",0,0,2,0,0,4,0,0
"Slovakia","2024-10-28",0,0,2,0,0,4,0,0
"Slovakia","2024-10-29",0,0,2,0,0,4,0,0
"Slovakia","2024-10-30",0,0,2,0,0,4,0,0
"Slovakia","2024-10-31",0,0,2,0,0,4,0,0
"Slovakia","2024-11-01",0,0,2,0,0,4,0,0
"Slovakia","2024-11-02",0,0,2,0,0,4,0,0
"Slovakia","2024-11-03",0,0,2,0,0,4,0,0
"Slovakia","2024-11-04",0,0,2,0,0,4,0,0
"Slovakia","2024-11-05",0,0,2,0,0,4,0,0
"Slovakia","2024-11-06",0,0,2,0,0,4,0,0
"Slovakia","2024-11-07",0,0,2,0,0,4,0,0
"Slovakia","2024-11-08",0,0,2,0,0,4,0,0
"Slovakia","2024-11-09",0,0,2,0,0,4,0,0
"Slovakia","2024-11-10",0,0,2,0,0,4,0,0
"Slovakia","2024-11-11",0,0,2,0,0,4,0,0
"Slovakia","2024-11-12",0,0,2,0,0,4,0,0
"Slovakia","2024-11-13",0,0,2,0,0,4,0,0
"Slovakia","2024-11-14",0,0,2,0,0,4,0,0
"Slovakia","2024-11-15",0,0,2,0,0,4,0,0
"Slovakia","2024-11-16",0,0,2,0,0,4,0,0
"Slovakia","2024-11-17",0,0,2,0,0,4,0,0
"Slovakia","2024-11-18",0,0,2,0,0,4,0,0
"Slovakia","2024-11-19",0,0,2,0,0,4,0,0
"Slovakia","2024-11-20",0,0,2,0,0,4,0,0
"Slovakia","2024-11-21",0,0,2,0,0,4,0,0
"Slovakia","2024-11-22",0,0,2,0,0,4,0,0
"Slovakia","2024-11-23",0,0,2,0,0,4,0,0
"Slovakia","2024-11-24",0,0,2,0,0,4,0,0
"Slovakia","2024-11-25",0,0,2,0,0,4,0,0
"Slovakia","2024-11-26",0,0,2,0,0,4,0,0
"Slovakia","2024-11-27",0,0,2,0,0,4,0,0
"Slovakia","2024-11-28",0,0,2,0,0,4,0,0
"Slovakia","2024-11-29",0,0,2,0,0,4,0,0
"Slovakia","2024-11-30",0,2,4,0,0,4,0,0
"Slovakia","2024-12-01",0,0,4,0,0,4,0,0
"Slovakia","2024-12-02",0,0,4,0,0,4,0,0
"Slovakia","2024-12-03",0,0,4,0,0,4,0,0
"Slovakia","2024-12-04",0,0,4,0,0,4,0,0
"Slovakia","2024-12-05",0,0,4,0,0,4,0,0
"Slovakia","2024-12-06",0,0,4,0,0,4,0,0
"Slovakia","2024-12-07",0,0,4,0,0,4,0,0
"Slovakia","2024-12-08",0,0,4,0,0,4,0,0
"Slovakia","2024-12-09",0,0,4,0,0,4,0,0
"Slovakia","2024-12-10",0,0,4,0,0,4,0,0
"Slovakia","2024-12-11",0,0,4,0,0,4,0,0
"Slovakia","2024-12-12",0,0,4,0,0,4,0,0
"Slovakia","2024-12-13",0,0,4,0,0,4,0,0
"Slovakia","2024-12-14",0,0,4,0,0,4,0,0
"Slovakia","2024-12-15",0,0,4,0,0,4,0,0
"Slovakia","2024-12-16",0,0,4,0,0,4,0,0
"Slovakia","2024-12-17",0,0,4,0,0,4,0,0
"Slovakia","2024-12-18",0,0,4,0,0,4,0,0
"Slovakia","2024-12-19",0,0,4,0,0,4,0,0
"Slovakia","2024-12-20",0,0,4,0,0,4,0,0
"Slovakia","2024-12-21",0,0,4,0,1,5,0,0
"Slovakia","2024-12-22",0,0,4,0,0,5,0,0
"Slovakia","2024-12-23",0,0,4,0,0,5,0,0
"Slovakia","2024-12-24",0,0,4,0,0,5,0,0
"Slovakia","2024-12-25",0,0,4,0,0,5,0,0
"Slovakia","2024-12-26",0,0,4,0,0,5,0,0
"Slovakia","2024-12-27",0,0,4,0,0,5,0,0
"Slovakia","2024-12-28",0,0,4,0,0,5,0,0
"Slovakia","2024-12-29",0,0,4,0,0,5,0,0
"Slovakia","2024-12-30",0,0,4,0,0,5,0,0
"Slovakia","2024-12-31",0,0,4,0,0,5,0,0
"Slovakia","2025-01-01",0,0,4,0,0,5,0,0
"Slovakia","2025-01-02",0,0,4,0,0,5,0,0
"Slovakia","2025-01-03",0,0,4,0,0,5,0,0
"Slovakia","2025-01-04",0,0,4,0,0,5,0,0
"Slovakia","2025-01-05",0,0,4,0,0,5,0,0
"Slovakia","2025-01-06",0,0,4,0,0,5,0,0
"Slovakia","2025-01-07",0,0,4,0,0,5,0,0
"Slovakia","2025-01-08",0,0,4,0,0,5,0,0
"Slovakia","2025-01-09",0,0,4,0,0,5,0,0
"Slovakia","2025-01-10",0,1,5,0,0,5,0,0
"Slovakia","2025-01-11",0,0,5,0,0,5,0,0
"Slovakia","2025-01-12",0,0,5,0,0,5,0,0
"Slovakia","2025-01-13",0,0,5,0,0,5,0,0
"Slovakia","2025-01-14",0,0,5,0,0,5,0,0
"Slovakia","2025-01-15",0,0,5,0,0,5,0,0
"Slovakia","2025-01-16",0,0,5,0,0,5,0,0
"Slovakia","2025-01-17",0,0,5,0,0,5,0,0
"Slovakia","2025-01-18",0,0,5,0,0,5,0,0
"Slovakia","2025-01-19",0,0,5,0,0,5,0,0
"Slovakia","2025-01-20",0,0,5,0,0,5,0,0
"Slovakia","2025-01-21",0,0,5,0,0,5,0,0
"Slovakia","2025-01-22",0,0,5,0,0,5,0,0
"Slovakia","2025-01-23",0,0,5,0,0,5,0,0
"Slovakia","2025-01-24",0,0,5,0,0,5,0,0
"Slovakia","2025-01-25",0,0,5,0,0,5,0,0
"Slovakia","2025-01-26",0,0,5,0,0,5,0,0
"Slovakia","2025-01-27",0,0,5,0,0,5,0,0
"Slovakia","2025-01-28",0,0,5,0,0,5,0,0
"Slovakia","2025-01-29",0,0,5,0,0,5,0,0
"Slovakia","2025-01-30",0,0,5,0,0,5,0,0
"Slovakia","2025-01-31",0,0,5,0,0,5,0,0
"Slovakia","2025-02-01",0,0,5,0,0,5,0,0
"Slovakia","2025-02-02",0,0,5,0,0,5,0,0
"Slovakia","2025-02-03",0,0,5,0,0,5,0,0
"Slovakia","2025-02-04",0,0,5,0,0,5,0,0
"Slovakia","2025-02-05",0,0,5,0,0,5,0,0
"Slovakia","2025-02-06",0,0,5,0,0,5,0,0
"Slovakia","2025-02-07",0,0,5,0,0,5,0,0
"Slovakia","2025-02-08",0,0,5,0,0,5,0,0
"Slovakia","2025-02-09",0,0,5,0,0,5,0,0
"Slovakia","2025-02-10",0,0,5,0,0,5,0,0
"Slovakia","2025-02-11",0,0,5,0,0,5,0,0
"Slovakia","2025-02-12",0,0,5,0,0,5,0,0
"Slovakia","2025-02-13",0,0,5,0,0,5,0,0
"Slovakia","2025-02-14",0,0,5,0,0,5,0,0
"Slovakia","2025-02-15",0,0,5,0,0,5,0,0
"Slovakia","2025-02-16",0,0,5,0,0,5,0,0
"Slovakia","2025-02-17",0,0,5,0,0,5,0,0
"Slovakia","2025-02-18",0,0,5,0,0,5,0,0
"Slovakia","2025-02-19",0,0,5,0,0,5,0,0
"Slovakia","2025-02-20",0,0,5,0,0,5,0,0
"Slovakia","2025-02-21",0,0,5,0,0,5,0,0
"Slovakia","2025-02-22",0,0,5,0,0,5,0,0
"Slovakia","2025-02-23",0,0,5,0,0,5,0,0
"Slovakia","2025-02-24",0,0,5,0,0,5,0,0
"Slovakia","2025-02-25",0,0,5,0,0,5,0,0
"Slovakia","2025-02-26",0,0,5,0,0,5,0,0
"Slovakia","2025-02-27",0,0,5,0,0,5,0,0
"Slovakia","2025-02-28",0,0,5,0,0,5,0,0
"Slovakia","2025-03-01",0,0,5,0,0,5,0,0
"Slovakia","2025-03-02",0,0,5,0,0,5,0,0
"Slovakia","2025-03-03",0,0,5,0,0,5,0,0
"Slovenia","2024-01-01",0,0,0,0,0,0,0,0
"Slovenia","2024-01-02",0,0,0,0,0,0,0,0
"Slovenia","2024-01-03",0,0,0,0,0,0,0,0
"Slovenia","2024-01-04",0,0,0,0,0,0,0,0
"Slovenia","2024-01-05",0,0,0,0,0,0,0,0
"Slovenia","2024-01-06",0,0,0,0,0,0,0,0
"Slovenia","2024-01-07",0,0,0,0,0,0,0,0
"Slovenia","2024-01-08",0,0,0,0,0,0,0,0
"Slovenia","2024-01-09",0,0,0,0,0,0,0,0
"Slovenia","2024-01-10",0,0,0,0,0,0,0,0
"Slovenia","2024-01-11",0,0,0,0,0,0,0,0
"Slovenia","2024-01-12",0,0,0,0,0,0,0,0
"Slovenia","2024-01-13",0,0,0,0,0,0,0,0
"Slovenia","2024-01-14",0,0,0,0,0,0,0,0
"Slovenia","2024-01-15",0,0,0,0,0,0,0,0
"Slovenia","2024-01-16",0,0,0,0,0,0,0,0
"Slovenia","2024-01-17",0,0,0,0,0,0,0,0
"Slovenia","2024-01-18",0,0,0,0,0,0,0,0
"Slovenia","2024-01-19",0,0,0,0,0,0,0,0
"Slovenia","2024-01-20",0,0,0,0,0,0,0,0
"Slovenia","2024-01-21",0,0,0,0,0,0,0,0
"Slovenia","2024-01-22",0,0,0,0,0,0,0,0
"Slovenia","2024-01-23",0,0,0,0,0,0,0,0
"Slovenia","2024-01-24",0,0,0,0,0,0,0,0
"Slovenia","2024-01-25",0,0,0,0,0,0,0,0
"Slovenia","2024-01-26",0,0,0,0,0,0,0,0
"Slovenia","2024-01-27",0,0,0,0,0,0,0,0
"Slovenia","2024-01-28",0,0,0,0,0,0,0,0
"Slovenia","2024-01-29",0,0,0,0,0,0,0,0
"Slovenia","2024-01-30",0,0,0,0,0,0,0,0
"Slovenia","2024-01-31",0,0,0,0,0,0,0,0
"Slovenia","2024-02-01",0,0,0,0,0,0,0,0
"Slovenia","2024-02-02",0,0,0,0,0,0,0,0
"Slovenia","2024-02-03",0,0,0,0,0,0,0,0
"Slovenia","2024-02-04",0,0,0,0,0,0,0,0
"Slovenia","2024-02-05",0,0,0,0,0,0,0,0
"Slovenia","2024-02-06",0,0,0,0,0,0,0,0
"Slovenia","2024-02-07",0,0,0,0,0,0,0,0
"Slovenia","2024-02-08",0,0,0,0,0,0,0,0
"Slovenia","2024-02-09",0,0,0,0,0,0,0,0
"Slovenia","2024-02-10",0,0,0,0,0,0,0,0
"Slovenia","2024-02-11",0,0,0,0,0,0,0,0
"Slovenia","2024-02-12",0,0,0,0,0,0,0,0
"Slovenia","2024-02-13",0,0,0,0,0,0,0,0
"Slovenia","2024-02-14",0,0,0,0,0,0,0,0
"Slovenia","2024-02-15",0,0,0,0,0,0,0,0
"Slovenia","2024-02-16",0,0,0,0,0,0,0,0
"Slovenia","2024-02-17",0,0,0,0,0,0,0,0
"Slovenia","2024-02-18",0,0,0,0,0,0,0,0
"Slovenia","2024-02-19",0,0,0,0,0,0,0,0
"Slovenia","2024-02-20",0,0,0,0,0,0,0,0
"Slovenia","2024-02-21",0,0,0,0,0,0,0,0
"Slovenia","2024-02-22",0,0,0,0,0,0,0,0
"Slovenia","2024-02-23",0,0,0,0,0,0,0,0
"Slovenia","2024-02-24",0,0,0,0,0,0,0,0
"Slovenia","2024-02-25",0,0,0,0,0,0,0,0
"Slovenia","2024-02-26",0,0,0,0,0,0,0,0
"Slovenia","2024-02-27",0,0,0,0,0,0,0,0
"Slovenia","2024-02-28",0,0,0,0,0,0,0,0
"Slovenia","2024-02-29",0,0,0,0,0,0,0,0
"Slovenia","2024-03-01",0,0,0,0,0,0,0,0
"Slovenia","2024-03-02",0,0,0,0,0,0,0,0
"Slovenia","2024-03-03",0,0,0,0,0,0,0,0
"Slovenia","2024-03-04",0,0,0,0,0,0,0,0
"Slovenia","2024-03-05",0,0,0,0,0,0,0,0
"Slovenia","2024-03-06",0,0,0,0,0,0,0,0
"Slovenia","2024-03-07",0,0,0,0,0,0,0,0
"Slovenia","2024-03-08",0,0,0,0,0,0,0,0
"Slovenia","2024-03-09",0,0,0,0,0,0,0,0
"Slovenia","2024-03-10",0,0,0,0,0,0,0,0
"Slovenia","2024-03-11",0,0,0,0,0,0,0,0
"Slovenia","2024-03-12",0,0,0,0,0,0,0,0
"Slovenia","2024-03-13",0,0,0,0,0,0,0,0
"Slovenia","2024-03-14",0,0,0,0,0,0,0,0
"Slovenia","2024-03-15",0,0,0,0,0,0,0,0
"Slovenia","2024-03-16",0,0,0,0,0,0,0,0
"Slovenia","2024-03-17",0,0,0,0,0,0,0,0
"Slovenia","2024-03-18",0,0,0,0,0,0,0,0
"Slovenia","2024-03-19",0,0,0,0,0,0,0,0
"Slovenia","2024-03-20",0,0,0,0,0,0,0,0
"Slovenia","2024-03-21",0,0,0,0,0,0,0,0
"Slovenia","2024-03-22",0,0,0,0,0,0,0,0
"Slovenia","2024-03-23",0,0,0,0,0,0,0,0
"Slovenia","2024-03-24",0,0,0,0,0,0,0,0
"Slovenia","2024-03-25",0,0,0,0,0,0,0,0
"Slovenia","2024-03-26",0,0,0,0,0,0,0,0
"Slovenia","2024-03-27",0,0,0,0,0,0,0,0
"Slovenia","2024-03-28",0,0,0,0,0,0,0,0
"Slovenia","2024-03-29",0,0,0,0,0,0,0,0
"Slovenia","2024-03-30",0,0,0,0,0,0,0,0
"Slovenia","2024-03-31",0,0,0,0,0,0,0,0
"Slovenia","2024-04-01",0,0,0,0,0,0,0,0
"Slovenia","2024-04-02",0,0,0,0,0,0,0,0
"Slovenia","2024-04-03",0,0,0,0,0,0,0,0
"Slovenia","2024-04-04",0,0,0,0,0,0,0,0
"Slovenia","2024-04-05",0,0,0,0,0,0,0,0
"Slovenia","2024-04-06",0,0,0,0,0,0,0,0
"Slovenia","2024-04-07",0,0,0,0,0,0,0,0
"Slovenia","2024-04-08",0,0,0,0,0,0,0,0
"Slovenia","2024-04-09",0,0,0,0,0,0,0,0
"Slovenia","2024-04-10",0,0,0,0,0,0,0,0
"Slovenia","2024-04-11",0,0,0,0,0,0,0,0
"Slovenia","2024-04-12",0,0,0,0,0,0,0,0
"Slovenia","2024-04-13",0,0,0,0,0,0,0,0
"Slovenia","2024-04-14",0,0,0,0,0,0,0,0
"Slovenia","2024-04-15",0,0,0,0,0,0,0,0
"Slovenia","2024-04-16",0,0,0,0,0,0,0,0
"Slovenia","2024-04-17",0,0,0,0,0,0,0,0
"Slovenia","2024-04-18",0,0,0,0,0,0,0,0
"Slovenia","2024-04-19",0,0,0,0,0,0,0,0
"Slovenia","2024-04-20",0,0,0,0,0,0,0,0
"Slovenia","2024-04-21",0,0,0,0,0,0,0,0
"Slovenia","2024-04-22",0,0,0,0,0,0,0,0
"Slovenia","2024-04-23",0,0,0,0,0,0,0,0
"Slovenia","2024-04-24",0,0,0,0,0,0,0,0
"Slovenia","2024-04-25",0,0,0,0,0,0,0,0
"Slovenia","2024-04-26",0,0,0,0,0,0,0,0
"Slovenia","2024-04-27",0,0,0,0,0,0,0,0
"Slovenia","2024-04-28",0,0,0,0,0,0,0,0
"Slovenia","2024-04-29",0,0,0,0,0,0,0,0
"Slovenia","2024-04-30",0,0,0,0,0,0,0,0
"Slovenia","2024-05-01",0,0,0,0,0,0,0,0
"Slovenia","2024-05-02",0,0,0,0,0,0,0,0
"Slovenia","2024-05-03",0,0,0,0,0,0,0,0
"Slovenia","2024-05-04",0,0,0,0,0,0,0,0
"Slovenia","2024-05-05",0,0,0,0,0,0,0,0
"Slovenia","2024-05-06",0,0,0,0,0,0,0,0
"Slovenia","2024-05-07",0,0,0,0,0,0,0,0
"Slovenia","2024-05-08",0,0,0,0,0,0,0,0
"Slovenia","2024-05-09",0,0,0,0,0,0,0,0
"Slovenia","2024-05-10",0,0,0,0,0,0,0,0
"Slovenia","2024-05-11",0,0,0,0,0,0,0,0
"Slovenia","2024-05-12",0,0,0,0,0,0,0,0
"Slovenia","2024-05-13",0,0,0,0,0,0,0,0
"Slovenia","2024-05-14",0,0,0,0,0,0,0,0
"Slovenia","2024-05-15",0,0,0,0,0,0,0,0
"Slovenia","2024-05-16",0,0,0,0,0,0,0,0
"Slovenia","2024-05-17",0,0,0,0,0,0,0,0
"Slovenia","2024-05-18",0,0,0,0,0,0,0,0
"Slovenia","2024-05-19",0,0,0,0,0,0,0,0
"Slovenia","2024-05-20",0,0,0,0,0,0,0,0
"Slovenia","2024-05-21",0,0,0,0,0,0,0,0
"Slovenia","2024-05-22",0,0,0,0,0,0,0,0
"Slovenia","2024-05-23",0,0,0,0,0,0,0,0
"Slovenia","2024-05-24",0,0,0,0,0,0,0,0
"Slovenia","2024-05-25",0,0,0,0,0,0,0,0
"Slovenia","2024-05-26",0,0,0,0,0,0,0,0
"Slovenia","2024-05-27",0,0,0,0,0,0,0,0
"Slovenia","2024-05-28",0,0,0,0,0,0,0,0
"Slovenia","2024-05-29",0,0,0,0,0,0,0,0
"Slovenia","2024-05-30",0,0,0,0,0,0,0,0
"Slovenia","2024-05-31",0,0,0,0,0,0,0,0
"Slovenia","2024-06-01",0,0,0,0,0,0,0,0
"Slovenia","2024-06-02",0,0,0,0,0,0,0,0
"Slovenia","2024-06-03",0,0,0,0,0,0,0,0
"Slovenia","2024-06-04",0,0,0,0,0,0,0,0
"Slovenia","2024-06-05",0,0,0,0,0,0,0,0
"Slovenia","2024-06-06",0,0,0,0,0,0,0,0
"Slovenia","2024-06-07",0,0,0,0,0,0,0,0
"Slovenia","2024-06-08",0,0,0,0,0,0,0,0
"Slovenia","2024-06-09",0,0,0,0,0,0,0,0
"Slovenia","2024-06-10",0,0,0,0,0,0,0,0
"Slovenia","2024-06-11",0,0,0,0,0,0,0,0
"Slovenia","2024-06-12",0,0,0,0,0,0,0,0
"Slovenia","2024-06-13",0,0,0,0,0,0,0,0
"Slovenia","2024-06-14",0,0,0,0,0,0,0,0
"Slovenia","2024-06-15",0,0,0,0,0,0,0,0
"Slovenia","2024-06-16",0,0,0,0,0,0,0,0
"Slovenia","2024-06-17",0,0,0,0,0,0,0,0
"Slovenia","2024-06-18",0,0,0,0,0,0,0,0
"Slovenia","2024-06-19",0,0,0,0,0,0,0,0
"Slovenia","2024-06-20",0,0,0,0,0,0,0,0
"Slovenia","2024-06-21",0,0,0,0,0,0,0,0
"Slovenia","2024-06-22",0,0,0,0,0,0,0,0
"Slovenia","2024-06-23",0,0,0,0,0,0,0,0
"Slovenia","2024-06-24",0,0,0,0,0,0,0,0
"Slovenia","2024-06-25",0,0,0,0,0,0,0,0
"Slovenia","2024-06-26",0,0,0,0,0,0,0,0
"Slovenia","2024-06-27",0,0,0,0,0,0,0,0
"Slovenia","2024-06-28",0,0,0,0,0,0,0,0
"Slovenia","2024-06-29",0,0,0,0,0,0,0,0
"Slovenia","2024-06-30",0,0,0,0,0,0,0,0
"Slovenia","2024-07-01",0,0,0,0,0,0,0,0
"Slovenia","2024-07-02",0,0,0,0,0,0,0,0
"Slovenia","2024-07-03",0,0,0,0,0,0,0,0
"Slovenia","2024-07-04",0,0,0,0,0,0,0,0
"Slovenia","2024-07-05",0,0,0,0,0,0,0,0
"Slovenia","2024-07-06",0,0,0,0,0,0,0,0
"Slovenia","2024-07-07",0,0,0,0,0,0,0,0
"Slovenia","2024-07-08",0,0,0,0,0,0,0,0
"Slovenia","2024-07-09",0,0,0,0,0,0,0,0
"Slovenia","2024-07-10",0,0,0,0,0,0,0,0
"Slovenia","2024-07-11",0,0,0,0,0,0,0,0
"Slovenia","2024-07-12",0,0,0,0,0,0,0,0
"Slovenia","2024-07-13",0,0,0,0,0,0,0,0
"Slovenia","2024-07-14",0,0,0,0,0,0,0,0
"Slovenia","2024-07-15",0,0,0,0,0,0,0,0
"Slovenia","2024-07-16",0,0,0,0,0,0,0,0
"Slovenia","2024-07-17",0,0,0,0,0,0,0,0
"Slovenia","2024-07-18",0,0,0,0,0,0,0,0
"Slovenia","2024-07-19",0,0,0,0,0,0,0,0
"Slovenia","2024-07-20",0,0,0,0,0,0,0,0
"Slovenia","2024-07-21",0,0,0,0,0,0,0,0
"Slovenia","2024-07-22",0,0,0,0,0,0,0,0
"Slovenia","2024-07-23",0,0,0,0,0,0,0,0
"Slovenia","2024-07-24",0,0,0,0,0,0,0,0
"Slovenia","2024-07-25",0,0,0,0,0,0,0,0
"Slovenia","2024-07-26",0,0,0,0,0,0,0,0
"Slovenia","2024-07-27",0,0,0,0,0,0,0,0
"Slovenia","2024-07-28",0,0,0,0,0,0,0,0
"Slovenia","2024-07-29",0,0,0,0,0,0,0,0
"Slovenia","2024-07-30",0,0,0,0,0,0,0,0
"Slovenia","2024-07-31",0,0,0,0,0,0,0,0
"Slovenia","2024-08-01",0,0,0,0,0,0,0,0
"Slovenia","2024-08-02",0,0,0,0,0,0,0,0
"Slovenia","2024-08-03",0,0,0,0,0,0,0,0
"Slovenia","2024-08-04",0,0,0,0,0,0,0,0
"Slovenia","2024-08-05",0,0,0,0,0,0,0,0
"Slovenia","2024-08-06",0,0,0,0,0,0,0,0
"Slovenia","2024-08-07",0,0,0,0,0,0,0,0
"Slovenia","2024-08-08",0,0,0,0,0,0,0,0
"Slovenia","2024-08-09",0,0,0,0,0,0,0,0
"Slovenia","2024-08-10",0,0,0,0,0,0,0,0
"Slovenia","2024-08-11",0,0,0,0,0,0,0,0
"Slovenia","2024-08-12",0,0,0,0,0,0,0,0
"Slovenia","2024-08-13",0,0,0,0,0,0,0,0
"Slovenia","2024-08-14",0,0,0,0,0,0,0,0
"Slovenia","2024-08-15",0,0,0,0,0,0,0,0
"Slovenia","2024-08-16",0,0,0,0,0,0,0,0
"Slovenia","2024-08-17",0,0,0,0,0,0,0,0
"Slovenia","2024-08-18",0,0,0,0,0,0,0,0
"Slovenia","2024-08-19",0,0,0,0,0,0,0,0
"Slovenia","2024-08-20",0,0,0,0,0,0,0,0
"Slovenia","2024-08-21",0,0,0,0,0,0,0,0
"Slovenia","2024-08-22",0,0,0,0,0,0,0,0
"Slovenia","2024-08-23",0,0,0,0,0,0,0,0
"Slovenia","2024-08-24",0,0,0,0,0,0,0,0
"Slovenia","2024-08-25",0,0,0,0,0,0,0,0
"Slovenia","2024-08-26",0,0,0,0,0,0,0,0
"Slovenia","2024-08-27",0,0,0,0,0,0,0,0
"Slovenia","2024-08-28",0,0,0,0,0,0,0,0
"Slovenia","2024-08-29",0,0,0,0,0,0,0,0
"Slovenia","2024-08-30",0,0,0,0,0,0,0,0
"Slovenia","2024-08-31",0,0,0,0,0,0,0,0
"Slovenia","2024-09-01",0,0,0,0,0,0,0,0
"Slovenia","2024-09-02",0,0,0,0,0,0,0,0
"Slovenia","2024-09-03",0,0,0,0,0,0,0,0
"Slovenia","2024-09-04",0,0,0,0,0,0,0,0
"Slovenia","2024-09-05",0,0,0,0,0,0,0,0
"Slovenia","2024-09-06",0,0,0,0,0,0,0,0
"Slovenia","2024-09-07",0,0,0,0,0,0,0,0
"Slovenia","2024-09-08",0,0,0,0,0,0,0,0
"Slovenia","2024-09-09",0,0,0,0,0,0,0,0
"Slovenia","2024-09-10",0,0,0,0,0,0,0,0
"Slovenia","2024-09-11",0,0,0,0,0,0,0,0
"Slovenia","2024-09-12",0,0,0,0,0,0,0,0
"Slovenia","2024-09-13",0,0,0,0,0,0,0,0
"Slovenia","2024-09-14",0,0,0,0,0,0,0,0
"Slovenia","2024-09-15",0,0,0,0,0,0,0,0
"Slovenia","2024-09-16",0,0,0,0,0,0,0,0
"Slovenia","2024-09-17",0,0,0,0,0,0,0,0
"Slovenia","2024-09-18",0,0,0,0,0,0,0,0
"Slovenia","2024-09-19",0,0,0,0,0,0,0,0
"Slovenia","2024-09-20",0,0,0,0,0,0,0,0
"Slovenia","2024-09-21",0,0,0,0,0,0,0,0
"Slovenia","2024-09-22",0,0,0,0,0,0,0,0
"Slovenia","2024-09-23",0,0,0,0,0,0,0,0
"Slovenia","2024-09-24",0,0,0,0,0,0,0,0
"Slovenia","2024-09-25",0,0,0,0,0,0,0,0
"Slovenia","2024-09-26",0,0,0,0,0,0,0,0
"Slovenia","2024-09-27",0,0,0,0,0,0,0,0
"Slovenia","2024-09-28",0,0,0,0,0,0,0,0
"Slovenia","2024-09-29",0,0,0,0,0,0,0,0
"Slovenia","2024-09-30",0,0,0,0,0,0,0,0
"Slovenia","2024-10-01",0,0,0,0,0,0,0,0
"Slovenia","2024-10-02",0,0,0,0,0,0,0,0
"Slovenia","2024-10-03",0,0,0,0,0,0,0,0
"Slovenia","2024-10-04",0,0,0,0,0,0,0,0
"Slovenia","2024-10-05",0,0,0,0,0,0,0,0
"Slovenia","2024-10-06",0,0,0,0,0,0,0,0
"Slovenia","2024-10-07",0,0,0,0,0,0,0,0
"Slovenia","2024-10-08",0,0,0,0,0,0,0,0
"Slovenia","2024-10-09",0,0,0,0,0,0,0,0
"Slovenia","2024-10-10",0,0,0,0,0,0,0,0
"Slovenia","2024-10-11",0,0,0,0,0,0,0,0
"Slovenia","2024-10-12",0,0,0,0,0,0,0,0
"Slovenia","2024-10-13",0,0,0,0,0,0,0,0
"Slovenia","2024-10-14",0,0,0,0,0,0,0,0
"Slovenia","2024-10-15",0,0,0,0,0,0,0,0
"Slovenia","2024-10-16",0,0,0,0,0,0,0,0
"Slovenia","2024-10-17",0,0,0,0,0,0,0,0
"Slovenia","2024-10-18",0,0,0,0,0,0,0,0
"Slovenia","2024-10-19",0,0,0,0,0,0,0,0
"Slovenia","2024-10-20",0,0,0,0,0,0,0,0
"Slovenia","2024-10-21",0,0,0,0,0,0,0,0
"Slovenia","2024-10-22",0,0,0,0,0,0,0,0
"Slovenia","2024-10-23",0,0,0,0,0,0,0,0
"Slovenia","2024-10-24",0,0,0,0,0,0,0,0
"Slovenia","2024-10-25",0,0,0,0,0,0,0,0
"Slovenia","2024-10-26",0,0,0,0,0,0,0,0
"Slovenia","2024-10-27",0,0,0,0,0,0,0,0
"Slovenia","2024-10-28",0,0,0,0,0,0,0,0
"Slovenia","2024-10-29",0,0,0,0,0,0,0,0
"Slovenia","2024-10-30",0,0,0,0,0,0,0,0
"Slovenia","2024-10-31",0,0,0,0,0,0,0,0
"Slovenia","2024-11-01",0,0,0,0,0,0,0,0
"Slovenia","2024-11-02",0,0,0,0,0,0,0,0
"Slovenia","2024-11-03",0,0,0,0,0,0,0,0
"Slovenia","2024-11-04",0,0,0,0,0,0,0,0
"Slovenia","2024-11-05",0,0,0,0,0,0,0,0
"Slovenia","2024-11-06",0,0,0,0,0,0,0,0
"Slovenia","2024-11-07",0,0,0,0,0,0,0,0
"Slovenia","2024-11-08",0,0,0,0,0,0,0,0
"Slovenia","2024-11-09",0,0,0,0,0,0,0,0
"Slovenia","2024-11-10",0,0,0,0,0,0,0,0
"Slovenia","2024-11-11",0,0,0,0,0,0,0,0
"Slovenia","2024-11-12",0,0,0,0,0,0,0,0
"Slovenia","2024-11-13",0,0,0,0,0,0,0,0
"Slovenia","2024-11-14",0,0,0,0,0,0,0,0
"Slovenia","2024-11-15",0,0,0,0,0,0,0,0
"Slovenia","2024-11-16",0,0,0,0,0,0,0,0
"Slovenia","2024-11-17",0,0,0,0,0,0,0,0
"Slovenia","2024-11-18",0,0,0,0,0,0,0,0
"Slovenia","2024-11-19",0,0,0,0,0,0,0,0
"Slovenia","2024-11-20",0,0,0,0,0,0,0,0
"Slovenia","2024-11-21",0,0,0,0,0,0,0,0
"Slovenia","2024-11-22",0,0,0,0,0,0,0,0
"Slovenia","2024-11-23",0,0,0,0,0,0,0,0
"Slovenia","2024-11-24",0,0,0,0,0,0,0,0
"Slovenia","2024-11-25",0,0,0,0,0,0,0,0
"Slovenia","2024-11-26",0,0,0,0,0,0,0,0
"Slovenia","2024-11-27",0,0,0,0,0,0,0,0
"Slovenia","2024-11-28",0,0,0,0,0,0,0,0
"Slovenia","2024-11-29",0,0,0,0,0,0,0,0
"Slovenia","2024-11-30",0,0,0,0,0,0,0,0
"Slovenia","2024-12-01",0,0,0,0,0,0,0,0
"Slovenia","2024-12-02",0,0,0,0,0,0,0,0
"Slovenia","2024-12-03",0,0,0,0,0,0,0,0
"Slovenia","2024-12-04",0,0,0,0,0,0,0,0
"Slovenia","2024-12-05",0,0,0,0,0,0,0,0
"Slovenia","2024-12-06",0,0,0,0,0,0,0,0
"Slovenia","2024-12-07",0,0,0,0,0,0,0,0
"Slovenia","2024-12-08",0,0,0,0,0,0,0,0
"Slovenia","2024-12-09",0,0,0,0,0,0,0,0
"Slovenia","2024-12-10",0,0,0,0,0,0,0,0
"Slovenia","2024-12-11",0,0,0,0,0,0,0,0
"Slovenia","2024-12-12",0,0,0,0,0,0,0,0
"Slovenia","2024-12-13",0,0,0,0,0,0,0,0
"Slovenia","2024-12-14",0,0,0,0,0,0,0,0
"Slovenia","2024-12-15",0,0,0,0,0,0,0,0
"Slovenia","2024-12-16",0,0,0,0,0,0,0,0
"Slovenia","2024-12-17",0,0,0,0,0,0,0,0
"Slovenia","2024-12-18",0,0,0,0,0,0,0,0
"Slovenia","2024-12-19",0,0,0,0,0,0,0,0
"Slovenia","2024-12-20",0,0,0,0,0,0,0,0
"Slovenia","2024-12-21",0,0,0,0,0,0,0,0
"Slovenia","2024-12-22",0,0,0,0,0,0,0,0
"Slovenia","2024-12-23",0,0,0,0,0,0,0,0
"Slovenia","2024-12-24",0,0,0,0,0,0,0,0
"Slovenia","2024-12-25",0,0,0,0,0,0,0,0
"Slovenia","2024-12-26",0,0,0,0,0,0,0,0
"Slovenia","2024-12-27",0,0,0,0,0,0,0,0
"Slovenia","2024-12-28",0,0,0,0,0,0,0,0
"Slovenia","2024-12-29",0,0,0,0,0,0,0,0
"Slovenia","2024-12-30",0,0,0,0,0,0,0,0
"Slovenia","2024-12-31",0,0,0,0,0,0,0,0
"Slovenia","2025-01-01",0,0,0,0,0,0,0,0
"Slovenia","2025-01-02",0,0,0,0,0,0,0,0
"Slovenia","2025-01-03",0,0,0,0,0,0,0,0
"Slovenia","2025-01-04",0,0,0,0,0,0,0,0
"Slovenia","2025-01-05",0,0,0,0,0,0,0,0
"Slovenia","2025-01-06",0,0,0,0,0,0,0,0
"Slovenia","2025-01-07",0,0,0,0,0,0,0,0
"Slovenia","2025-01-08",0,0,0,0,0,0,0,0
"Slovenia","2025-01-09",0,0,0,0,0,0,0,0
"Slovenia","2025-01-10",0,0,0,0,0,0,0,0
"Slovenia","2025-01-11",0,0,0,0,0,0,0,0
"Slovenia","2025-01-12",0,0,0,0,0,0,0,0
"Slovenia","2025-01-13",0,0,0,0,0,0,0,0
"Slovenia","2025-01-14",0,0,0,0,0,0,0,0
"Slovenia","2025-01-15",0,0,0,0,0,0,0,0
"Slovenia","2025-01-16",0,0,0,0,0,0,0,0
"Slovenia","2025-01-17",0,0,0,0,0,0,0,0
"Slovenia","2025-01-18",0,0,0,0,0,0,0,0
"Slovenia","2025-01-19",0,0,0,0,0,0,0,0
"Slovenia","2025-01-20",0,0,0,0,0,0,0,0
"Slovenia","2025-01-21",0,0,0,0,0,0,0,0
"Slovenia","2025-01-22",0,0,0,0,0,0,0,0
"Slovenia","2025-01-23",0,0,0,0,0,0,0,0
"Slovenia","2025-01-24",0,0,0,0,0,0,0,0
"Slovenia","2025-01-25",0,0,0,0,0,0,0,0
"Slovenia","2025-01-26",0,0,0,0,0,0,0,0
"Slovenia","2025-01-27",0,0,0,0,0,0,0,0
"Slovenia","2025-01-28",0,0,0,0,0,0,0,0
"Slovenia","2025-01-29",0,0,0,0,0,0,0,0
"Slovenia","2025-01-30",0,0,0,0,0,0,0,0
"Slovenia","2025-01-31",0,0,0,0,0,0,0,0
"Slovenia","2025-02-01",0,0,0,0,0,0,0,0
"Slovenia","2025-02-02",0,0,0,0,0,0,0,0
"Slovenia","2025-02-03",0,0,0,0,0,0,0,0
"Slovenia","2025-02-04",0,0,0,0,0,0,0,0
"Slovenia","2025-02-05",0,0,0,0,0,0,0,0
"Slovenia","2025-02-06",0,0,0,0,0,0,0,0
"Slovenia","2025-02-07",0,0,0,0,0,0,0,0
"Slovenia","2025-02-08",0,0,0,0,0,0,0,0
"Slovenia","2025-02-09",0,0,0,0,0,0,0,0
"Slovenia","2025-02-10",0,0,0,0,0,0,0,0
"Slovenia","2025-02-11",0,0,0,0,0,0,0,0
"Slovenia","2025-02-12",0,0,0,0,0,0,0,0
"Slovenia","2025-02-13",0,0,0,0,0,0,0,0
"Slovenia","2025-02-14",0,0,0,0,0,0,0,0
"Slovenia","2025-02-15",0,0,0,0,0,0,0,0
"Slovenia","2025-02-16",0,0,0,0,0,0,0,0
"Slovenia","2025-02-17",0,0,0,0,0,0,0,0
"Slovenia","2025-02-18",0,0,0,0,0,0,0,0
"Slovenia","2025-02-19",0,0,0,0,0,0,0,0
"Slovenia","2025-02-20",0,0,0,0,0,0,0,0
"Slovenia","2025-02-21",0,0,0,0,0,0,0,0
"Slovenia","2025-02-22",0,0,0,0,0,0,0,0
"Slovenia","2025-02-23",0,0,0,0,0,0,0,0
"Slovenia","2025-02-24",0,0,0,0,0,0,0,0
"Slovenia","2025-02-25",0,0,0,0,0,0,0,0
"Slovenia","2025-02-26",0,0,0,0,0,0,0,0
"Slovenia","2025-02-27",0,0,0,0,0,0,0,0
"Slovenia","2025-02-28",0,0,0,0,0,0,0,0
"Slovenia","2025-03-01",0,0,0,0,0,0,0,0
"Slovenia","2025-03-02",0,0,0,0,0,0,0,0
"Slovenia","2025-03-03",0,0,0,0,0,0,0,0
"South Africa","2024-01-01",0,0,0,0,0,0,0,0
"South Africa","2024-01-02",0,0,0,0,0,0,0,0
"South Africa","2024-01-03",0,0,0,0,0,0,0,0
"South Africa","2024-01-04",0,0,0,0,0,0,0,0
"South Africa","2024-01-05",0,0,0,0,0,0,0,0
"South Africa","2024-01-06",0,0,0,0,0,0,0,0
"South Africa","2024-01-07",0,0,0,0,0,0,0,0
"South Africa","2024-01-08",0,0,0,0,0,0,0,0
"South Africa","2024-01-09",0,0,0,0,0,0,0,0
"South Africa","2024-01-10",0,0,0,0,0,0,0,0
"South Africa","2024-01-11",0,0,0,0,0,0,0,0
"South Africa","2024-01-12",0,0,0,0,0,0,0,0
"South Africa","2024-01-13",0,0,0,0,0,0,0,0
"South Africa","2024-01-14",0,0,0,0,0,0,0,0
"South Africa","2024-01-15",0,0,0,0,0,0,0,0
"South Africa","2024-01-16",0,0,0,0,0,0,0,0
"South Africa","2024-01-17",0,0,0,0,0,0,0,0
"South Africa","2024-01-18",0,0,0,0,0,0,0,0
"South Africa","2024-01-19",0,0,0,0,0,0,0,0
"South Africa","2024-01-20",0,0,0,0,0,0,0,0
"South Africa","2024-01-21",0,0,0,0,0,0,0,0
"South Africa","2024-01-22",0,0,0,0,0,0,0,0
"South Africa","2024-01-23",0,0,0,0,0,0,0,0
"South Africa","2024-01-24",0,0,0,0,0,0,0,0
"South Africa","2024-01-25",0,0,0,0,0,0,0,0
"South Africa","2024-01-26",0,0,0,0,0,0,0,0
"South Africa","2024-01-27",0,0,0,0,0,0,0,0
"South Africa","2024-01-28",0,0,0,0,0,0,0,0
"South Africa","2024-01-29",0,0,0,0,0,0,0,0
"South Africa","2024-01-30",0,0,0,0,0,0,0,0
"South Africa","2024-01-31",0,0,0,0,0,0,0,0
"South Africa","2024-02-01",0,0,0,0,0,0,0,0
"South Africa","2024-02-02",0,0,0,0,0,0,0,0
"South Africa","2024-02-03",0,0,0,0,0,0,0,0
"South Africa","2024-02-04",0,0,0,0,0,0,0,0
"South Africa","2024-02-05",0,0,0,0,0,0,0,0
"South Africa","2024-02-06",0,0,0,0,0,0,0,0
"South Africa","2024-02-07",0,0,0,0,0,0,0,0
"South Africa","2024-02-08",0,0,0,0,0,0,0,0
"South Africa","2024-02-09",0,0,0,0,0,0,0,0
"South Africa","2024-02-10",0,0,0,0,0,0,0,0
"South Africa","2024-02-11",0,0,0,0,0,0,0,0
"South Africa","2024-02-12",0,0,0,0,0,0,0,0
"South Africa","2024-02-13",0,0,0,0,0,0,0,0
"South Africa","2024-02-14",0,0,0,0,0,0,0,0
"South Africa","2024-02-15",0,0,0,0,0,0,0,0
"South Africa","2024-02-16",0,0,0,0,0,0,0,0
"South Africa","2024-02-17",0,0,0,0,0,0,0,0
"South Africa","2024-02-18",0,0,0,0,0,0,0,0
"South Africa","2024-02-19",0,0,0,0,0,0,0,0
"South Africa","2024-02-20",0,0,0,0,0,0,0,0
"South Africa","2024-02-21",0,0,0,0,0,0,0,0
"South Africa","2024-02-22",0,0,0,0,0,0,0,0
"South Africa","2024-02-23",0,0,0,0,0,0,0,0
"South Africa","2024-02-24",0,0,0,0,0,0,0,0
"South Africa","2024-02-25",0,0,0,0,0,0,0,0
"South Africa","2024-02-26",0,0,0,0,0,0,0,0
"South Africa","2024-02-27",0,0,0,0,0,0,0,0
"South Africa","2024-02-28",0,0,0,0,0,0,0,0
"South Africa","2024-02-29",0,0,0,0,0,0,0,0
"South Africa","2024-03-01",0,0,0,0,0,0,0,0
"South Africa","2024-03-02",0,0,0,0,0,0,0,0
"South Africa","2024-03-03",0,0,0,0,0,0,0,0
"South Africa","2024-03-04",0,0,0,0,0,0,0,0
"South Africa","2024-03-05",0,0,0,0,0,0,0,0
"South Africa","2024-03-06",0,0,0,0,0,0,0,0
"South Africa","2024-03-07",0,0,0,0,0,0,0,0
"South Africa","2024-03-08",0,0,0,0,0,0,0,0
"South Africa","2024-03-09",0,0,0,0,0,0,0,0
"South Africa","2024-03-10",0,0,0,0,0,0,0,0
"South Africa","2024-03-11",0,0,0,0,0,0,0,0
"South Africa","2024-03-12",0,0,0,0,0,0,0,0
"South Africa","2024-03-13",0,0,0,0,0,0,0,0
"South Africa","2024-03-14",0,0,0,0,0,0,0,0
"South Africa","2024-03-15",0,0,0,0,0,0,0,0
"South Africa","2024-03-16",0,0,0,0,0,0,0,0
"South Africa","2024-03-17",0,0,0,0,0,0,0,0
"South Africa","2024-03-18",0,0,0,0,0,0,0,0
"South Africa","2024-03-19",0,0,0,0,0,0,0,0
"South Africa","2024-03-20",0,0,0,0,0,0,0,0
"South Africa","2024-03-21",0,0,0,0,0,0,0,0
"South Africa","2024-03-22",0,0,0,0,0,0,0,0
"South Africa","2024-03-23",0,0,0,0,0,0,0,0
"South Africa","2024-03-24",0,0,0,0,0,0,0,0
"South Africa","2024-03-25",0,0,0,0,0,0,0,0
"South Africa","2024-03-26",0,0,0,0,0,0,0,0
"South Africa","2024-03-27",0,0,0,0,0,0,0,0
"South Africa","2024-03-28",0,0,0,0,0,0,0,0
"South Africa","2024-03-29",0,0,0,0,0,0,0,0
"South Africa","2024-03-30",0,0,0,0,0,0,0,0
"South Africa","2024-03-31",0,0,0,0,0,0,0,0
"South Africa","2024-04-01",0,0,0,0,0,0,0,0
"South Africa","2024-04-02",0,0,0,0,0,0,0,0
"South Africa","2024-04-03",0,0,0,0,0,0,0,0
"South Africa","2024-04-04",0,0,0,0,0,0,0,0
"South Africa","2024-04-05",0,0,0,0,0,0,0,0
"South Africa","2024-04-06",0,0,0,0,0,0,0,0
"South Africa","2024-04-07",0,0,0,0,0,0,0,0
"South Africa","2024-04-08",0,0,0,0,0,0,0,0
"South Africa","2024-04-09",0,0,0,0,0,0,0,0
"South Africa","2024-04-10",0,0,0,0,0,0,0,0
"South Africa","2024-04-11",0,0,0,0,0,0,0,0
"South Africa","2024-04-12",0,0,0,0,0,0,0,0
"South Africa","2024-04-13",0,0,0,0,0,0,0,0
"South Africa","2024-04-14",0,0,0,0,0,0,0,0
"South Africa","2024-04-15",0,0,0,0,0,0,0,0
"South Africa","2024-04-16",0,0,0,0,0,0,0,0
"South Africa","2024-04-17",0,0,0,0,0,0,0,0
"South Africa","2024-04-18",0,0,0,0,0,0,0,0
"South Africa","2024-04-19",0,0,0,0,0,0,0,0
"South Africa","2024-04-20",0,0,0,0,0,0,0,0
"South Africa","2024-04-21",0,0,0,0,0,0,0,0
"South Africa","2024-04-22",0,0,0,0,0,0,0,0
"South Africa","2024-04-23",0,0,0,0,0,0,0,0
"South Africa","2024-04-24",0,0,0,0,0,0,0,0
"South Africa","2024-04-25",0,0,0,0,0,0,0,0
"South Africa","2024-04-26",0,0,0,0,0,0,0,0
"South Africa","2024-04-27",0,0,0,0,0,0,0,0
"South Africa","2024-04-28",0,0,0,0,0,0,0,0
"South Africa","2024-04-29",0,0,0,0,0,0,0,0
"South Africa","2024-04-30",0,0,0,0,0,0,0,0
"South Africa","2024-05-01",0,0,0,0,0,0,0,0
"South Africa","2024-05-02",0,0,0,0,0,0,0,0
"South Africa","2024-05-03",0,0,0,0,0,0,0,0
"South Africa","2024-05-04",0,0,0,0,0,0,0,0
"South Africa","2024-05-05",0,0,0,0,0,0,0,0
"South Africa","2024-05-06",0,0,0,0,0,0,0,0
"South Africa","2024-05-07",0,0,0,0,0,0,0,0
"South Africa","2024-05-08",0,0,0,0,0,0,0,0
"South Africa","2024-05-09",0,0,0,0,0,0,0,0
"South Africa","2024-05-10",0,0,0,0,0,0,0,0
"South Africa","2024-05-11",0,0,0,0,0,0,0,0
"South Africa","2024-05-12",0,1,1,0,1,1,0,0
"South Africa","2024-05-13",0,0,1,0,0,1,0,0
"South Africa","2024-05-14",0,0,1,0,0,1,0,0
"South Africa","2024-05-15",0,0,1,0,0,1,0,0
"South Africa","2024-05-16",0,0,1,0,0,1,0,0
"South Africa","2024-05-17",0,0,1,0,0,1,0,0
"South Africa","2024-05-18",0,0,1,0,0,1,0,0
"South Africa","2024-05-19",0,0,1,0,0,1,0,0
"South Africa","2024-05-20",0,0,1,0,1,2,0,0
"South Africa","2024-05-21",0,0,1,0,0,2,0,0
"South Africa","2024-05-22",0,0,1,0,0,2,0,0
"South Africa","2024-05-23",0,0,1,0,0,2,0,0
"South Africa","2024-05-24",0,0,1,0,0,2,0,0
"South Africa","2024-05-25",0,0,1,0,0,2,0,0
"South Africa","2024-05-26",0,1,2,0,0,2,0,0
"South Africa","2024-05-27",0,0,2,0,0,2,0,0
"South Africa","2024-05-28",0,0,2,0,0,2,0,0
"South Africa","2024-05-29",0,0,2,0,0,2,0,0
"South Africa","2024-05-30",0,0,2,0,1,3,0,0
"South Africa","2024-05-31",0,0,2,0,0,3,0,0
"South Africa","2024-06-01",0,0,2,0,0,3,0,0
"South Africa","2024-06-02",0,1,3,0,0,3,0,0
"South Africa","2024-06-03",0,0,3,0,0,3,0,0
"South Africa","2024-06-04",0,0,3,0,1,4,0,0
"South Africa","2024-06-05",0,0,3,0,0,4,0,0
"South Africa","2024-06-06",0,0,3,0,0,4,0,0
"South Africa","2024-06-07",0,0,3,0,0,4,0,0
"South Africa","2024-06-08",0,0,3,0,1,5,0,0
"South Africa","2024-06-09",0,2,5,0,0,5,0,0
"South Africa","2024-06-10",0,0,5,0,1,6,0,0
"South Africa","2024-06-11",0,0,5,0,1,7,0,0
"South Africa","2024-06-12",0,0,5,0,1,8,0,0
"South Africa","2024-06-13",0,0,5,0,1,9,0,0
"South Africa","2024-06-14",0,0,5,0,1,10,0,0
"South Africa","2024-06-15",0,0,5,0,1,11,0,0
"South Africa","2024-06-16",0,7,12,0,1,12,0,0
"South Africa","2024-06-17",0,0,12,0,1,13,0,0
"South Africa","2024-06-18",0,0,12,0,0,13,0,0
"South Africa","2024-06-19",0,0,12,0,1,14,0,0
"South Africa","2024-06-20",0,0,12,0,0,14,0,0
"South Africa","2024-06-21",0,0,12,0,1,15,0,0
"South Africa","2024-06-22",0,0,12,0,0,15,0,0
"South Africa","2024-06-23",0,4,16,0,1,16,0,0
"South Africa","2024-06-24",0,0,16,0,0,16,0,0
"South Africa","2024-06-25",0,0,16,0,1,17,0,0
"South Africa","2024-06-26",0,0,16,0,0,17,0,0
"South Africa","2024-06-27",0,0,16,0,0,17,0,0
"South Africa","2024-06-28",0,0,16,0,0,17,0,0
"South Africa","2024-06-29",0,0,16,0,1,18,0,0
"South Africa","2024-06-30",0,0,16,0,0,18,0,0
"South Africa","2024-07-01",0,0,16,0,0,18,0,0
"South Africa","2024-07-02",0,0,16,0,1,19,0,0
"South Africa","2024-07-03",0,0,16,0,0,19,0,0
"South Africa","2024-07-04",0,0,16,0,0,19,0,0
"South Africa","2024-07-05",0,0,16,0,0,19,0,0
"South Africa","2024-07-06",0,0,16,0,1,20,0,0
"South Africa","2024-07-07",0,4,20,0,0,20,0,0
"South Africa","2024-07-08",0,0,20,0,0,20,0,0
"South Africa","2024-07-09",0,0,20,0,1,21,0,0
"South Africa","2024-07-10",0,0,20,0,0,21,0,0
"South Africa","2024-07-11",0,0,20,0,0,21,0,0
"South Africa","2024-07-12",0,0,20,0,0,21,0,0
"South Africa","2024-07-13",0,0,20,0,1,22,0,0
"South Africa","2024-07-14",0,2,22,0,0,22,0,0
"South Africa","2024-07-15",0,0,22,0,0,22,0,0
"South Africa","2024-07-16",0,0,22,0,0,22,0,0
"South Africa","2024-07-17",0,0,22,0,0,22,0,0
"South Africa","2024-07-18",0,0,22,0,0,22,0,0
"South Africa","2024-07-19",0,0,22,0,0,22,0,0
"South Africa","2024-07-20",0,0,22,0,1,23,0,0
"South Africa","2024-07-21",0,0,22,0,0,23,0,0
"South Africa","2024-07-22",0,0,22,0,0,23,0,0
"South Africa","2024-07-23",0,0,22,0,0,23,0,0
"South Africa","2024-07-24",0,0,22,0,0,23,0,0
"South Africa","2024-07-25",0,0,22,0,0,23,0,0
"South Africa","2024-07-26",0,0,22,0,0,23,0,0
"South Africa","2024-07-27",0,0,22,0,0,23,0,0
"South Africa","2024-07-28",0,0,22,0,0,23,0,0
"South Africa","2024-07-29",0,0,22,0,0,23,0,0
"South Africa","2024-07-30",0,0,22,0,1,24,0,0
"South Africa","2024-07-31",0,0,22,0,0,24,0,0
"South Africa","2024-08-01",0,0,22,0,0,24,0,0
"South Africa","2024-08-02",0,0,22,0,0,24,0,0
"South Africa","2024-08-03",0,0,22,0,0,24,0,0
"South Africa","2024-08-04",0,2,24,0,0,24,0,0
"South Africa","2024-08-05",0,0,24,0,0,24,0,0
"South Africa","2024-08-06",0,0,24,0,0,24,0,0
"South Africa","2024-08-07",0,0,24,0,0,24,0,0
"South Africa","2024-08-08",0,0,24,0,0,24,0,0
"South Africa","2024-08-09",0,0,24,0,0,24,0,0
"South Africa","2024-08-10",0,0,24,0,0,24,0,0
"South Africa","2024-08-11",0,0,24,0,0,24,0,0
"South Africa","2024-08-12",0,0,24,0,0,24,0,0
"South Africa","2024-08-13",0,0,24,0,0,24,0,0
"South Africa","2024-08-14",0,0,24,0,0,24,0,0
"South Africa","2024-08-15",0,0,24,0,0,24,0,0
"South Africa","2024-08-16",0,0,24,0,0,24,0,0
"South Africa","2024-08-17",0,0,24,0,0,24,0,0
"South Africa","2024-08-18",0,0,24,0,0,24,0,0
"South Africa","2024-08-19",0,0,24,0,0,24,0,0
"South Africa","2024-08-20",0,0,24,0,0,24,0,0
"South Africa","2024-08-21",0,0,24,0,0,24,0,0
"South Africa","2024-08-22",0,0,24,0,1,25,0,0
"South Africa","2024-08-23",0,0,24,0,0,25,0,0
"South Africa","2024-08-24",0,0,24,0,0,25,0,0
"South Africa","2024-08-25",0,0,24,0,0,25,0,0
"South Africa","2024-08-26",0,0,24,0,0,25,0,0
"South Africa","2024-08-27",0,0,24,0,0,25,0,0
"South Africa","2024-08-28",0,0,24,0,0,25,0,0
"South Africa","2024-08-29",0,0,24,0,0,25,0,0
"South Africa","2024-08-30",0,0,24,0,0,25,0,0
"South Africa","2024-08-31",0,0,24,0,0,25,0,0
"South Africa","2024-09-01",0,0,24,0,0,25,0,0
"South Africa","2024-09-02",0,0,24,0,0,25,0,0
"South Africa","2024-09-03",0,0,24,0,0,25,0,0
"South Africa","2024-09-04",0,0,24,0,0,25,0,0
"South Africa","2024-09-05",0,0,24,0,0,25,0,0
"South Africa","2024-09-06",0,0,24,0,0,25,0,0
"South Africa","2024-09-07",0,0,24,0,0,25,0,0
"South Africa","2024-09-08",0,1,25,0,0,25,0,0
"South Africa","2024-09-09",0,0,25,0,0,25,0,0
"South Africa","2024-09-10",0,0,25,0,0,25,0,0
"South Africa","2024-09-11",0,0,25,0,0,25,0,0
"South Africa","2024-09-12",0,0,25,0,0,25,0,0
"South Africa","2024-09-13",0,0,25,0,0,25,0,0
"South Africa","2024-09-14",0,0,25,0,0,25,0,0
"South Africa","2024-09-15",0,0,25,0,0,25,0,0
"South Africa","2024-09-16",0,0,25,0,0,25,0,0
"South Africa","2024-09-17",0,0,25,0,0,25,0,0
"South Africa","2024-09-18",0,0,25,0,0,25,0,0
"South Africa","2024-09-19",0,0,25,0,0,25,0,0
"South Africa","2024-09-20",0,0,25,0,0,25,0,0
"South Africa","2024-09-21",0,0,25,0,0,25,0,0
"South Africa","2024-09-22",0,0,25,0,0,25,0,0
"South Africa","2024-09-23",0,0,25,0,0,25,0,0
"South Africa","2024-09-24",0,0,25,0,0,25,0,0
"South Africa","2024-09-25",0,0,25,0,0,25,0,0
"South Africa","2024-09-26",0,0,25,0,0,25,0,0
"South Africa","2024-09-27",0,0,25,0,0,25,0,0
"South Africa","2024-09-28",0,0,25,0,0,25,0,0
"South Africa","2024-09-29",0,0,25,0,0,25,0,0
"South Africa","2024-09-30",0,0,25,0,0,25,0,0
"South Africa","2024-10-01",0,0,25,0,0,25,0,0
"South Africa","2024-10-02",0,0,25,0,0,25,0,0
"South Africa","2024-10-03",0,0,25,0,0,25,0,0
"South Africa","2024-10-04",0,0,25,0,0,25,0,0
"South Africa","2024-10-05",0,0,25,0,0,25,0,0
"South Africa","2024-10-06",0,0,25,0,0,25,0,0
"South Africa","2024-10-07",0,0,25,0,0,25,0,0
"South Africa","2024-10-08",0,0,25,0,0,25,0,0
"South Africa","2024-10-09",0,0,25,0,0,25,0,0
"South Africa","2024-10-10",0,0,25,0,0,25,0,0
"South Africa","2024-10-11",0,0,25,0,0,25,0,0
"South Africa","2024-10-12",0,0,25,0,0,25,0,0
"South Africa","2024-10-13",0,0,25,0,0,25,0,0
"South Africa","2024-10-14",0,0,25,0,0,25,0,0
"South Africa","2024-10-15",0,0,25,0,0,25,0,0
"South Africa","2024-10-16",0,0,25,0,0,25,0,0
"South Africa","2024-10-17",0,0,25,0,0,25,0,0
"South Africa","2024-10-18",0,0,25,0,0,25,0,0
"South Africa","2024-10-19",0,0,25,0,0,25,0,0
"South Africa","2024-10-20",0,0,25,0,0,25,0,0
"South Africa","2024-10-21",0,0,25,0,0,25,0,0
"South Africa","2024-10-22",0,0,25,0,0,25,0,0
"South Africa","2024-10-23",0,0,25,0,0,25,0,0
"South Africa","2024-10-24",0,0,25,0,0,25,0,0
"South Africa","2024-10-25",0,0,25,0,0,25,0,0
"South Africa","2024-10-26",0,0,25,0,0,25,0,0
"South Africa","2024-10-27",0,0,25,0,0,25,0,0
"South Africa","2024-10-28",0,0,25,0,0,25,0,0
"South Africa","2024-10-29",0,0,25,0,0,25,0,0
"South Africa","2024-10-30",0,0,25,0,0,25,0,0
"South Africa","2024-10-31",0,0,25,0,0,25,0,0
"South Africa","2024-11-01",0,0,25,0,0,25,0,0
"South Africa","2024-11-02",0,0,25,0,0,25,0,0
"South Africa","2024-11-03",0,0,25,0,0,25,0,0
"South Africa","2024-11-04",0,0,25,0,0,25,0,0
"South Africa","2024-11-05",0,0,25,0,0,25,0,0
"South Africa","2024-11-06",0,0,25,0,0,25,0,0
"South Africa","2024-11-07",0,0,25,0,0,25,0,0
"South Africa","2024-11-08",0,0,25,0,0,25,0,0
"South Africa","2024-11-09",0,0,25,0,0,25,0,0
"South Africa","2024-11-10",0,0,25,0,0,25,0,0
"South Africa","2024-11-11",0,0,25,0,0,25,0,0
"South Africa","2024-11-12",0,0,25,0,0,25,0,0
"South Africa","2024-11-13",0,0,25,0,0,25,0,0
"South Africa","2024-11-14",0,0,25,0,0,25,0,0
"South Africa","2024-11-15",0,0,25,0,0,25,0,0
"South Africa","2024-11-16",0,0,25,0,0,25,0,0
"South Africa","2024-11-17",0,0,25,0,0,25,0,0
"South Africa","2024-11-18",0,0,25,0,0,25,0,0
"South Africa","2024-11-19",0,0,25,0,0,25,0,0
"South Africa","2024-11-20",0,0,25,0,0,25,0,0
"South Africa","2024-11-21",0,0,25,0,0,25,0,0
"South Africa","2024-11-22",0,0,25,0,0,25,0,0
"South Africa","2024-11-23",0,0,25,0,0,25,0,0
"South Africa","2024-11-24",0,0,25,0,0,25,0,0
"South Africa","2024-11-25",0,0,25,0,0,25,0,0
"South Africa","2024-11-26",0,0,25,0,0,25,0,0
"South Africa","2024-11-27",0,0,25,0,0,25,0,0
"South Africa","2024-11-28",0,0,25,0,0,25,0,0
"South Africa","2024-11-29",0,0,25,0,0,25,0,0
"South Africa","2024-11-30",0,0,25,0,0,25,0,0
"South Africa","2024-12-01",0,0,25,0,0,25,0,0
"South Africa","2024-12-02",0,0,25,0,0,25,0,0
"South Africa","2024-12-03",0,0,25,0,0,25,0,0
"South Africa","2024-12-04",0,0,25,0,0,25,0,0
"South Africa","2024-12-05",0,0,25,0,0,25,0,0
"South Africa","2024-12-06",0,0,25,0,0,25,0,0
"South Africa","2024-12-07",0,0,25,0,0,25,0,0
"South Africa","2024-12-08",0,0,25,0,0,25,0,0
"South Africa","2024-12-09",0,0,25,0,0,25,0,0
"South Africa","2024-12-10",0,0,25,0,0,25,0,0
"South Africa","2024-12-11",0,0,25,0,0,25,0,0
"South Africa","2024-12-12",0,0,25,0,0,25,0,0
"South Africa","2024-12-13",0,0,25,0,0,25,0,0
"South Africa","2024-12-14",0,0,25,0,0,25,0,0
"South Africa","2024-12-15",0,0,25,0,0,25,0,0
"South Africa","2024-12-16",0,0,25,0,0,25,0,0
"South Africa","2024-12-17",0,0,25,0,0,25,0,0
"South Africa","2024-12-18",0,0,25,0,0,25,0,0
"South Africa","2024-12-19",0,0,25,0,0,25,0,0
"South Africa","2024-12-20",0,0,25,0,0,25,0,0
"South Africa","2024-12-21",0,0,25,0,0,25,0,0
"South Africa","2024-12-22",0,0,25,0,0,25,0,0
"South Africa","2024-12-23",0,0,25,0,0,25,0,0
"South Africa","2024-12-24",0,0,25,0,0,25,0,0
"South Africa","2024-12-25",0,0,25,0,0,25,0,0
"South Africa","2024-12-26",0,0,25,0,0,25,0,0
"South Africa","2024-12-27",0,0,25,0,0,25,0,0
"South Africa","2024-12-28",0,0,25,0,0,25,0,0
"South Africa","2024-12-29",0,0,25,0,0,25,0,0
"South Africa","2024-12-30",0,0,25,0,0,25,0,0
"South Africa","2024-12-31",0,0,25,0,0,25,0,0
"South Africa","2025-01-01",0,0,25,0,0,25,0,0
"South Africa","2025-01-02",0,0,25,0,0,25,0,0
"South Africa","2025-01-03",0,0,25,0,0,25,0,0
"South Africa","2025-01-04",0,0,25,0,0,25,0,0
"South Africa","2025-01-05",0,0,25,0,0,25,0,0
"South Africa","2025-01-06",0,0,25,0,0,25,0,0
"South Africa","2025-01-07",0,0,25,0,0,25,0,0
"South Africa","2025-01-08",0,0,25,0,0,25,0,0
"South Africa","2025-01-09",0,0,25,0,0,25,0,0
"South Africa","2025-01-10",0,0,25,0,0,25,0,0
"South Africa","2025-01-11",0,0,25,0,0,25,0,0
"South Africa","2025-01-12",0,0,25,0,0,25,0,0
"South Africa","2025-01-13",0,0,25,0,0,25,0,0
"South Africa","2025-01-14",0,0,25,0,0,25,0,0
"South Africa","2025-01-15",0,0,25,0,0,25,0,0
"South Africa","2025-01-16",0,0,25,0,0,25,0,0
"South Africa","2025-01-17",0,0,25,0,0,25,0,0
"South Africa","2025-01-18",0,0,25,0,0,25,0,0
"South Africa","2025-01-19",0,0,25,0,0,25,0,0
"South Africa","2025-01-20",0,0,25,0,0,25,0,0
"South Africa","2025-01-21",0,0,25,0,0,25,0,0
"South Africa","2025-01-22",0,0,25,0,0,25,0,0
"South Africa","2025-01-23",0,0,25,0,0,25,0,0
"South Africa","2025-01-24",0,0,25,0,0,25,0,0
"South Africa","2025-01-25",0,0,25,0,0,25,0,0
"South Africa","2025-01-26",0,0,25,0,0,25,0,0
"South Africa","2025-01-27",0,0,25,0,0,25,0,0
"South Africa","2025-01-28",0,0,25,0,0,25,0,0
"South Africa","2025-01-29",0,0,25,0,0,25,0,0
"South Africa","2025-01-30",0,0,25,0,0,25,0,0
"South Africa","2025-01-31",0,0,25,0,0,25,0,0
"South Africa","2025-02-01",0,0,25,0,0,25,0,0
"South Africa","2025-02-02",0,0,25,0,0,25,0,0
"South Africa","2025-02-03",0,0,25,0,0,25,0,0
"South Africa","2025-02-04",0,0,25,0,0,25,0,0
"South Africa","2025-02-05",0,0,25,0,0,25,0,0
"South Africa","2025-02-06",0,0,25,0,0,25,0,0
"South Africa","2025-02-07",0,0,25,0,0,25,0,0
"South Africa","2025-02-08",0,0,25,0,0,25,0,0
"South Africa","2025-02-09",0,0,25,0,0,25,0,0
"South Africa","2025-02-10",0,0,25,0,0,25,0,0
"South Africa","2025-02-11",0,0,25,0,0,25,0,0
"South Africa","2025-02-12",0,0,25,0,0,25,0,0
"South Africa","2025-02-13",0,0,25,0,0,25,0,0
"South Africa","2025-02-14",0,0,25,0,0,25,0,0
"South Africa","2025-02-15",0,0,25,0,0,25,0,0
"South Africa","2025-02-16",0,0,25,0,0,25,0,0
"South Africa","2025-02-17",0,0,25,0,0,25,0,0
"South Africa","2025-02-18",0,0,25,0,0,25,0,0
"South Africa","2025-02-19",0,0,25,0,0,25,0,0
"South Africa","2025-02-20",0,0,25,0,0,25,0,0
"South Africa","2025-02-21",0,0,25,0,0,25,0,0
"South Africa","2025-02-22",0,0,25,0,0,25,0,0
"South Africa","2025-02-23",0,0,25,0,0,25,0,0
"South Africa","2025-02-24",0,0,25,0,0,25,0,0
"South Africa","2025-02-25",0,0,25,0,0,25,0,0
"South Africa","2025-02-26",0,0,25,0,0,25,0,0
"South Africa","2025-02-27",0,0,25,0,0,25,0,0
"South Africa","2025-02-28",0,0,25,0,0,25,0,0
"South Africa","2025-03-01",0,0,25,0,0,25,0,0
"South Africa","2025-03-02",0,0,25,0,0,25,0,0
"South Africa","2025-03-03",0,0,25,0,0,25,0,0
"South America","2024-01-01",0,0,0,0,0,0,0,0
"South America","2024-01-02",0,69,69,0,69,69,0,0
"South America","2024-01-03",0,0,69,0,7,76,0,0
"South America","2024-01-04",0,0,69,0,8,84,0,0
"South America","2024-01-05",0,0,69,0,7,91,0,0
"South America","2024-01-06",0,0,69,0,7,98,0,0
"South America","2024-01-07",0,0,69,0,7,105,0,0
"South America","2024-01-08",0,0,69,0,8,113,0,0
"South America","2024-01-09",0,51,120,0,7,120,0,0
"South America","2024-01-10",0,0,120,0,7,127,0,0
"South America","2024-01-11",0,0,120,0,8,135,0,0
"South America","2024-01-12",0,0,120,0,7,142,0,0
"South America","2024-01-13",0,0,120,0,8,150,0,0
"South America","2024-01-14",0,0,120,0,7,157,0,0
"South America","2024-01-15",0,0,120,0,8,165,0,0
"South America","2024-01-16",0,52,172,0,7,172,0,0
"South America","2024-01-17",0,0,172,0,6,178,0,0
"South America","2024-01-18",0,0,172,0,5,183,0,0
"South America","2024-01-19",0,0,172,0,6,189,0,0
"South America","2024-01-20",0,0,172,0,6,195,0,0
"South America","2024-01-21",0,0,172,0,6,201,0,0
"South America","2024-01-22",0,0,172,0,5,206,0,0
"South America","2024-01-23",0,40,212,0,6,212,0,0
"South America","2024-01-24",0,0,212,0,6,218,0,0
"South America","2024-01-25",0,0,212,0,7,225,0,0
"South America","2024-01-26",0,0,212,0,6,231,0,0
"South America","2024-01-27",0,0,212,0,7,238,0,0
"South America","2024-01-28",0,0,212,0,6,244,0,0
"South America","2024-01-29",0,0,212,0,7,251,0,0
"South America","2024-01-30",0,45,257,0,6,257,0,0
"South America","2024-01-31",0,0,257,0,5,262,0,0
"South America","2024-02-01",0,0,257,0,5,267,0,0
"South America","2024-02-02",0,0,257,0,5,272,0,0
"South America","2024-02-03",0,0,257,0,6,278,0,0
"South America","2024-02-04",0,0,257,0,5,283,0,0
"South America","2024-02-05",0,0,257,0,5,288,0,0
"South America","2024-02-06",0,36,293,0,5,293,0,0
"South America","2024-02-07",0,0,293,0,5,298,0,0
"South America","2024-02-08",0,0,293,0,5,303,0,0
"South America","2024-02-09",0,0,293,0,5,308,0,0
"South America","2024-02-10",0,0,293,0,6,314,0,0
"South America","2024-02-11",0,0,293,0,5,319,0,0
"South America","2024-02-12",0,0,293,0,5,324,0,0
"South America","2024-02-13",0,36,329,0,5,329,0,0
"South America","2024-02-14",0,0,329,0,6,335,0,0
"South America","2024-02-15",0,0,329,0,7,342,0,0
"South America","2024-02-16",0,0,329,0,6,348,0,0
"South America","2024-02-17",0,0,329,0,6,354,0,0
"South America","2024-02-18",0,0,329,0,6,360,0,0
"South America","2024-02-19",0,0,329,0,7,367,0,0
"South America","2024-02-20",0,44,373,0,6,373,0,0
"South America","2024-02-21",0,0,373,0,6,379,0,0
"South America","2024-02-22",0,0,373,0,6,385,0,0
"South America","2024-02-23",0,0,373,0,6,391,0,0
"South America","2024-02-24",0,0,373,0,6,397,0,0
"South America","2024-02-25",0,0,373,0,6,403,0,0
"South America","2024-02-26",0,0,373,0,6,409,0,0
"South America","2024-02-27",0,42,415,0,6,415,0,0
"South America","2024-02-28",0,0,415,0,4,419,0,0
"South America","2024-02-29",0,0,415,0,4,423,0,0
"South America","2024-03-01",0,0,415,0,4,427,0,0
"South America","2024-03-02",0,0,415,0,4,431,0,0
"South America","2024-03-03",0,0,415,0,4,435,0,0
"South America","2024-03-04",0,0,415,0,4,439,0,0
"South America","2024-03-05",0,28,443,0,4,443,0,0
"South America","2024-03-06",0,0,443,0,4,447,0,0
"South America","2024-03-07",0,0,443,0,4,451,0,0
"South America","2024-03-08",0,0,443,0,4,455,0,0
"South America","2024-03-09",0,0,443,0,5,460,0,0
"South America","2024-03-10",0,0,443,0,4,464,0,0
"South America","2024-03-11",0,0,443,0,4,468,0,0
"South America","2024-03-12",0,29,472,0,4,472,0,0
"South America","2024-03-13",0,0,472,0,5,477,0,0
"South America","2024-03-14",0,0,472,0,4,481,0,0
"South America","2024-03-15",0,0,472,0,5,486,0,0
"South America","2024-03-16",0,0,472,0,4,490,0,0
"South America","2024-03-17",0,0,472,0,5,495,0,0
"South America","2024-03-18",0,0,472,0,4,499,0,0
"South America","2024-03-19",0,32,504,0,5,504,0,0
"South America","2024-03-20",0,0,504,0,4,508,0,0
"South America","2024-03-21",0,0,504,0,4,512,0,0
"South America","2024-03-22",0,0,504,0,4,516,0,0
"South America","2024-03-23",0,0,504,0,5,521,0,0
"South America","2024-03-24",0,0,504,0,4,525,0,0
"South America","2024-03-25",0,0,504,0,4,529,0,0
"South America","2024-03-26",0,29,533,0,4,533,0,0
"South America","2024-03-27",0,0,533,0,4,537,0,0
"South America","2024-03-28",0,0,533,0,5,542,0,0
"South America","2024-03-29",0,0,533,0,4,546,0,0
"South America","2024-03-30",0,0,533,0,4,550,0,0
"South America","2024-03-31",0,0,533,0,4,554,0,0
"South America","2024-04-01",0,0,533,0,5,559,0,0
"South America","2024-04-02",0,30,563,0,4,563,0,0
"South America","2024-04-03",0,0,563,0,3,566,0,0
"South America","2024-04-04",0,0,563,0,4,570,0,0
"South America","2024-04-05",0,0,563,0,3,573,0,0
"South America","2024-04-06",0,0,563,0,4,577,0,0
"South America","2024-04-07",0,0,563,0,3,580,0,0
"South America","2024-04-08",0,0,563,0,4,584,0,0
"South America","2024-04-09",0,24,587,0,3,587,0,0
"South America","2024-04-10",0,0,587,0,3,590,0,0
"South America","2024-04-11",0,0,587,0,3,593,0,0
"South America","2024-04-12",0,0,587,0,3,596,0,0
"South America","2024-04-13",0,0,587,0,2,598,0,0
"South America","2024-04-14",0,0,587,0,3,601,0,0
"South America","2024-04-15",0,0,587,0,3,604,0,0
"South America","2024-04-16",0,20,607,0,3,607,0,0
"South America","2024-04-17",0,0,607,0,5,612,0,0
"South America","2024-04-18",0,0,607,0,4,616,0,0
"South America","2024-04-19",0,0,607,0,5,621,0,0
"South America","2024-04-20",0,0,607,0,4,625,0,0
"South America","2024-04-21",0,0,607,0,5,630,0,0
"South America","2024-04-22",0,0,607,0,4,634,0,0
"South America","2024-04-23",0,32,639,0,5,639,0,0
"South America","2024-04-24",0,0,639,0,4,643,0,0
"South America","2024-04-25",0,0,639,0,3,646,0,0
"South America","2024-04-26",0,0,639,0,4,650,0,0
"South America","2024-04-27",0,0,639,0,4,654,0,0
"South America","2024-04-28",0,0,639,0,4,658,0,0
"South America","2024-04-29",0,0,639,0,3,661,0,0
"South America","2024-04-30",0,26,665,0,4,665,0,0
"South America","2024-05-01",0,0,665,0,3,668,0,0
"South America","2024-05-02",0,0,665,0,3,671,0,0
"South America","2024-05-03",0,0,665,0,3,674,0,0
"South America","2024-05-04",0,0,665,0,3,677,0,0
"South America","2024-05-05",0,0,665,0,3,680,0,0
"South America","2024-05-06",0,0,665,0,3,683,0,0
"South America","2024-05-07",0,21,686,0,3,686,0,0
"South America","2024-05-08",0,0,686,0,3,689,0,0
"South America","2024-05-09",0,0,686,0,3,692,0,0
"South America","2024-05-10",0,0,686,0,3,695,0,0
"South America","2024-05-11",0,0,686,0,4,699,0,0
"South America","2024-05-12",0,0,686,0,3,702,0,0
"South America","2024-05-13",0,0,686,0,3,705,0,0
"South America","2024-05-14",0,22,708,0,3,708,0,0
"South America","2024-05-15",0,0,708,0,1,709,0,0
"South America","2024-05-16",0,0,708,0,2,711,0,0
"South America","2024-05-17",0,0,708,0,1,712,0,0
"South America","2024-05-18",0,0,708,0,2,714,0,0
"South America","2024-05-19",0,0,708,0,1,715,0,0
"South America","2024-05-20",0,0,708,0,2,717,0,0
"South America","2024-05-21",0,10,718,0,1,718,0,0
"South America","2024-05-22",0,0,718,0,3,721,0,0
"South America","2024-05-23",0,0,718,0,3,724,0,0
"South America","2024-05-24",0,0,718,0,3,727,0,0
"South America","2024-05-25",0,0,718,0,2,729,0,0
"South America","2024-05-26",0,0,718,0,3,732,0,0
"South America","2024-05-27",0,0,718,0,3,735,0,0
"South America","2024-05-28",0,20,738,0,3,738,0,0
"South America","2024-05-29",0,0,738,0,2,740,0,0
"South America","2024-05-30",0,0,738,0,3,743,0,0
"South America","2024-05-31",0,0,738,0,2,745,0,0
"South America","2024-06-01",0,0,738,0,3,748,0,0
"South America","2024-06-02",0,0,738,0,2,750,0,0
"South America","2024-06-03",0,0,738,0,3,753,0,0
"South America","2024-06-04",0,17,755,0,2,755,0,0
"South America","2024-06-05",0,0,755,0,2,757,0,0
"South America","2024-06-06",0,0,755,0,3,760,0,0
"South America","2024-06-07",0,0,755,0,2,762,0,0
"South America","2024-06-08",0,0,755,0,2,764,0,0
"South America","2024-06-09",0,0,755,0,2,766,0,0
"South America","2024-06-10",0,0,755,0,3,769,0,0
"South America","2024-06-11",0,16,771,0,2,771,0,0
"South America","2024-06-12",0,0,771,0,2,773,0,0
"South America","2024-06-13",0,0,771,0,1,774,0,0
"South America","2024-06-14",0,0,771,0,2,776,0,0
"South America","2024-06-15",0,0,771,0,1,777,0,0
"South America","2024-06-16",0,0,771,0,2,779,0,0
"South America","2024-06-17",0,0,771,0,1,780,0,0
"South America","2024-06-18",0,11,782,0,2,782,0,0
"South America","2024-06-19",0,0,782,0,2,784,0,0
"South America","2024-06-20",0,0,782,0,3,787,0,0
"South America","2024-06-21",0,0,782,0,2,789,0,0
"South America","2024-06-22",0,0,782,0,2,791,0,0
"South America","2024-06-23",0,0,782,0,2,793,0,0
"South America","2024-06-24",0,0,782,0,3,796,0,0
"South America","2024-06-25",0,16,798,0,2,798,0,0
"South America","2024-06-26",0,0,798,0,4,802,0,0
"South America","2024-06-27",0,0,798,0,4,806,0,0
"South America","2024-06-28",0,0,798,0,4,810,0,0
"South America","2024-06-29",0,0,798,0,3,813,0,0
"South America","2024-06-30",0,0,798,0,4,817,0,0
"South America","2024-07-01",0,0,798,0,4,821,0,0
"South America","2024-07-02",0,27,825,0,4,825,0,0
"South America","2024-07-03",0,0,825,0,4,829,0,0
"South America","2024-07-04",0,0,825,0,4,833,0,0
"South America","2024-07-05",0,0,825,0,4,837,0,0
"South America","2024-07-06",0,0,825,0,4,841,0,0
"South America","2024-07-07",0,0,825,0,4,845,0,0
"South America","2024-07-08",0,0,825,0,4,849,0,0
"South America","2024-07-09",0,28,853,0,4,853,0,0
"South America","2024-07-10",0,0,853,0,4,857,0,0
"South America","2024-07-11",0,0,853,0,5,862,0,0
"South America","2024-07-12",0,0,853,0,4,866,0,0
"South America","2024-07-13",0,0,853,0,5,871,0,0
"South America","2024-07-14",0,0,853,0,4,875,0,0
"South America","2024-07-15",0,0,853,0,5,880,0,0
"South America","2024-07-16",0,31,884,0,4,884,0,0
"South America","2024-07-17",0,0,884,0,5,889,0,0
"South America","2024-07-18",0,0,884,0,5,894,0,0
"South America","2024-07-19",0,0,884,0,5,899,0,0
"South America","2024-07-20",0,0,884,0,6,905,0,0
"South America","2024-07-21",0,0,884,0,5,910,0,0
"South America","2024-07-22",0,0,884,0,5,915,0,0
"South America","2024-07-23",0,36,920,0,5,920,0,0
"South America","2024-07-24",0,0,920,0,6,926,0,0
"South America","2024-07-25",0,0,920,0,6,932,0,0
"South America","2024-07-26",0,0,920,0,6,938,0,0
"South America","2024-07-27",0,0,920,0,5,943,0,0
"South America","2024-07-28",0,0,920,0,6,949,0,0
"South America","2024-07-29",0,0,920,0,6,955,0,0
"South America","2024-07-30",0,41,961,0,6,961,0,0
"South America","2024-07-31",0,0,961,0,9,970,0,0
"South America","2024-08-01",0,0,961,0,9,979,0,0
"South America","2024-08-02",0,0,961,0,9,988,0,0
"South America","2024-08-03",0,0,961,0,10,998,0,0
"South America","2024-08-04",0,0,961,0,9,1007,0,0
"South America","2024-08-05",0,0,961,0,9,1016,0,0
"South America","2024-08-06",0,64,1025,0,9,1025,0,0
"South America","2024-08-07",0,0,1025,0,10,1035,0,0
"South America","2024-08-08",0,0,1025,0,10,1045,0,0
"South America","2024-08-09",0,0,1025,0,10,1055,0,0
"South America","2024-08-10",0,0,1025,0,11,1066,0,0
"South America","2024-08-11",0,0,1025,0,10,1076,0,0
"South America","2024-08-12",0,0,1025,0,10,1086,0,0
"South America","2024-08-13",0,71,1096,0,10,1096,0,0
"South America","2024-08-14",0,0,1096,0,15,1111,0,0
"South America","2024-08-15",0,0,1096,0,14,1125,0,0
"South America","2024-08-16",0,0,1096,0,15,1140,0,0
"South America","2024-08-17",0,0,1096,0,14,1154,0,0
"South America","2024-08-18",0,0,1096,0,15,1169,0,0
"South America","2024-08-19",0,0,1096,0,14,1183,0,0
"South America","2024-08-20",0,102,1198,0,15,1198,0,0
"South America","2024-08-21",0,0,1198,0,14,1212,0,0
"South America","2024-08-22",0,0,1198,0,14,1226,0,0
"South America","2024-08-23",0,0,1198,0,14,1240,0,0
"South America","2024-08-24",0,0,1198,0,14,1254,0,0
"South America","2024-08-25",0,0,1198,0,14,1268,0,0
"South America","2024-08-26",0,0,1198,0,14,1282,0,0
"South America","2024-08-27",0,98,1296,0,14,1296,0,0
"South America","2024-08-28",0,0,1296,0,15,1311,0,0
"South America","2024-08-29",0,0,1296,0,14,1325,0,0
"South America","2024-08-30",0,0,1296,0,15,1340,0,0
"South America","2024-08-31",0,0,1296,0,15,1355,0,0
"South America","2024-09-01",0,0,1296,0,15,1370,0,0
"South America","2024-09-02",0,0,1296,0,14,1384,0,0
"South America","2024-09-03",0,103,1399,0,15,1399,0,0
"South America","2024-09-04",0,0,1399,0,10,1409,0,0
"South America","2024-09-05",0,0,1399,0,11,1420,0,0
"South America","2024-09-06",0,0,1399,0,10,1430,0,0
"South America","2024-09-07",0,0,1399,0,11,1441,0,0
"South America","2024-09-08",0,0,1399,0,10,1451,0,0
"South America","2024-09-09",0,0,1399,0,11,1462,0,0
"South America","2024-09-10",0,73,1472,0,10,1472,0,0
"South America","2024-09-11",0,0,1472,0,12,1484,0,0
"South America","2024-09-12",0,0,1472,0,11,1495,0,0
"South America","2024-09-13",0,0,1472,0,12,1507,0,0
"South America","2024-09-14",0,0,1472,0,11,1518,0,0
"South America","2024-09-15",0,0,1472,0,12,1530,0,0
"South America","2024-09-16",0,0,1472,0,11,1541,0,0
"South America","2024-09-17",0,81,1553,0,12,1553,0,0
"South America","2024-09-18",0,0,1553,0,10,1563,0,0
"South America","2024-09-19",0,0,1553,0,11,1574,0,0
"South America","2024-09-20",0,0,1553,0,10,1584,0,0
"South America","2024-09-21",0,0,1553,0,10,1594,0,0
"South America","2024-09-22",0,0,1553,0,10,1604,0,0
"South America","2024-09-23",0,0,1553,0,11,1615,0,0
"South America","2024-09-24",0,72,1625,0,10,1625,0,0
"South America","2024-09-25",0,0,1625,0,13,1638,0,0
"South America","2024-09-26",0,0,1625,0,13,1651,0,0
"South America","2024-09-27",0,0,1625,0,13,1664,0,0
"South America","2024-09-28",0,0,1625,0,12,1676,0,0
"South America","2024-09-29",0,0,1625,0,13,1689,0,0
"South America","2024-09-30",0,0,1625,0,13,1702,0,0
"South America","2024-10-01",0,90,1715,0,13,1715,0,0
"South America","2024-10-02",0,0,1715,0,11,1726,0,0
"South America","2024-10-03",0,0,1715,0,11,1737,0,0
"South America","2024-10-04",0,0,1715,0,11,1748,0,0
"South America","2024-10-05",0,0,1715,0,12,1760,0,0
"South America","2024-10-06",0,0,1715,0,11,1771,0,0
"South America","2024-10-07",0,0,1715,0,11,1782,0,0
"South America","2024-10-08",0,78,1793,0,11,1793,0,0
"South America","2024-10-09",0,0,1793,0,10,1803,0,0
"South America","2024-10-10",0,0,1793,0,9,1812,0,0
"South America","2024-10-11",0,0,1793,0,10,1822,0,0
"South America","2024-10-12",0,0,1793,0,9,1831,0,0
"South America","2024-10-13",0,0,1793,0,10,1841,0,0
"South America","2024-10-14",0,0,1793,0,9,1850,0,0
"South America","2024-10-15",0,67,1860,0,10,1860,0,0
"South America","2024-10-16",0,0,1860,0,12,1872,0,0
"South America","2024-10-17",0,0,1860,0,11,1883,0,0
"South America","2024-10-18",0,0,1860,0,12,1895,0,0
"South America","2024-10-19",0,0,1860,0,11,1906,0,0
"South America","2024-10-20",0,0,1860,0,12,1918,0,0
"South America","2024-10-21",0,0,1860,0,11,1929,0,0
"South America","2024-10-22",0,81,1941,0,12,1941,0,0
"South America","2024-10-23",0,0,1941,0,10,1951,0,0
"South America","2024-10-24",0,0,1941,0,11,1962,0,0
"South America","2024-10-25",0,0,1941,0,10,1972,0,0
"South America","2024-10-26",0,0,1941,0,10,1982,0,0
"South America","2024-10-27",0,0,1941,0,10,1992,0,0
"South America","2024-10-28",0,0,1941,0,11,2003,0,0
"South America","2024-10-29",0,72,2013,0,10,2013,0,0
"South America","2024-10-30",0,0,2013,0,11,2024,0,0
"South America","2024-10-31",0,0,2013,0,12,2036,0,0
"South America","2024-11-01",0,0,2013,0,11,2047,0,0
"South America","2024-11-02",0,0,2013,0,11,2058,0,0
"South America","2024-11-03",0,0,2013,0,11,2069,0,0
"South America","2024-11-04",0,0,2013,0,12,2081,0,0
"South America","2024-11-05",0,79,2092,0,11,2092,0,0
"South America","2024-11-06",0,0,2092,0,8,2100,0,0
"South America","2024-11-07",0,0,2092,0,9,2109,0,0
"South America","2024-11-08",0,0,2092,0,8,2117,0,0
"South America","2024-11-09",0,0,2092,0,8,2125,0,0
"South America","2024-11-10",0,0,2092,0,8,2133,0,0
"South America","2024-11-11",0,0,2092,0,9,2142,0,0
"South America","2024-11-12",0,58,2150,0,8,2150,0,0
"South America","2024-11-13",0,0,2150,0,8,2158,0,0
"South America","2024-11-14",0,0,2150,0,8,2166,0,0
"South America","2024-11-15",0,0,2150,0,8,2174,0,0
"South America","2024-11-16",0,0,2150,0,9,2183,0,0
"South America","2024-11-17",0,0,2150,0,8,2191,0,0
"South America","2024-11-18",0,0,2150,0,8,2199,0,0
"South America","2024-11-19",0,57,2207,0,8,2207,0,0
"South America","2024-11-20",0,0,2207,0,8,2215,0,0
"South America","2024-11-21",0,0,2207,0,7,2222,0,0
"South America","2024-11-22",0,0,2207,0,8,2230,0,0
"South America","2024-11-23",0,0,2207,0,8,2238,0,0
"South America","2024-11-24",0,0,2207,0,8,2246,0,0
"South America","2024-11-25",0,0,2207,0,7,2253,0,0
"South America","2024-11-26",0,54,2261,0,8,2261,0,0
"South America","2024-11-27",0,0,2261,0,7,2268,0,0
"South America","2024-11-28",0,0,2261,0,7,2275,0,0
"South America","2024-11-29",0,0,2261,0,7,2282,0,0
"South America","2024-11-30",0,0,2261,0,7,2289,0,0
"South America","2024-12-01",0,0,2261,0,7,2296,0,0
"South America","2024-12-02",0,0,2261,0,7,2303,0,0
"South America","2024-12-03",0,49,2310,0,7,2310,0,0
"South America","2024-12-04",0,0,2310,0,5,2315,0,0
"South America","2024-12-05",0,0,2310,0,6,2321,0,0
"South America","2024-12-06",0,0,2310,0,5,2326,0,0
"South America","2024-12-07",0,0,2310,0,5,2331,0,0
"South America","2024-12-08",0,0,2310,0,5,2336,0,0
"South America","2024-12-09",0,0,2310,0,6,2342,0,0
"South America","2024-12-10",0,37,2347,0,5,2347,0,0
"South America","2024-12-11",0,0,2347,0,4,2351,0,0
"South America","2024-12-12",0,0,2347,0,5,2356,0,0
"South America","2024-12-13",0,0,2347,0,4,2360,0,0
"South America","2024-12-14",0,0,2347,0,4,2364,0,0
"South America","2024-12-15",0,0,2347,0,4,2368,0,0
"South America","2024-12-16",0,0,2347,0,5,2373,0,0
"South America","2024-12-17",0,30,2377,0,4,2377,0,0
"South America","2024-12-18",0,0,2377,0,4,2381,0,0
"South America","2024-12-19",0,0,2377,0,4,2385,0,0
"South America","2024-12-20",0,0,2377,0,4,2389,0,0
"South America","2024-12-21",0,0,2377,0,5,2394,0,0
"South America","2024-12-22",0,0,2377,0,4,2398,0,0
"South America","2024-12-23",0,0,2377,0,4,2402,0,0
"South America","2024-12-24",0,29,2406,0,4,2406,0,0
"South America","2024-12-25",0,0,2406,0,4,2410,0,0
"South America","2024-12-26",0,0,2406,0,3,2413,0,0
"South America","2024-12-27",0,0,2406,0,4,2417,0,0
"South America","2024-12-28",0,0,2406,0,4,2421,0,0
"South America","2024-12-29",0,0,2406,0,4,2425,0,0
"South America","2024-12-30",0,0,2406,0,3,2428,0,0
"South America","2024-12-31",0,26,2432,0,4,2432,0,0
"South America","2025-01-01",0,0,2432,0,3,2435,0,0
"South America","2025-01-02",0,0,2432,0,2,2437,0,0
"South America","2025-01-03",0,0,2432,0,3,2440,0,0
"South America","2025-01-04",0,0,2432,0,3,2443,0,0
"South America","2025-01-05",0,0,2432,0,3,2446,0,0
"South America","2025-01-06",0,0,2432,0,2,2448,0,0
"South America","2025-01-07",0,19,2451,0,3,2451,0,0
"South America","2025-01-08",0,0,2451,0,3,2454,0,0
"South America","2025-01-09",0,0,2451,0,2,2456,0,0
"South America","2025-01-10",0,0,2451,0,3,2459,0,0
"South America","2025-01-11",0,0,2451,0,3,2462,0,0
"South America","2025-01-12",0,0,2451,0,3,2465,0,0
"South America","2025-01-13",0,0,2451,0,2,2467,0,0
"South America","2025-01-14",0,19,2470,0,3,2470,0,0
"South America","2025-01-15",0,0,2470,0,4,2474,0,0
"South America","2025-01-16",0,0,2470,0,4,2478,0,0
"South America","2025-01-17",0,0,2470,0,4,2482,0,0
"South America","2025-01-18",0,0,2470,0,5,2487,0,0
"South America","2025-01-19",0,0,2470,0,4,2491,0,0
"South America","2025-01-20",0,0,2470,0,4,2495,0,0
"South America","2025-01-21",0,29,2499,0,4,2499,0,0
"South America","2025-01-22",0,0,2499,0,1,2500,0,0
"South America","2025-01-23",0,0,2499,0,1,2501,0,0
"South America","2025-01-24",0,0,2499,0,1,2502,0,0
"South America","2025-01-25",0,0,2499,0,1,2503,0,0
"South America","2025-01-26",0,0,2499,0,1,2504,0,0
"South America","2025-01-27",0,0,2499,0,1,2505,0,0
"South America","2025-01-28",0,7,2506,0,1,2506,0,0
"South America","2025-01-29",0,0,2506,0,0,2506,0,0
"South America","2025-01-30",0,0,2506,0,0,2506,0,0
"South America","2025-01-31",0,0,2506,0,0,2506,0,0
"South America","2025-02-01",0,0,2506,0,0,2506,0,0
"South America","2025-02-02",0,0,2506,0,0,2506,0,0
"South America","2025-02-03",0,0,2506,0,0,2506,0,0
"South America","2025-02-04",0,0,2506,0,0,2506,0,0
"South America","2025-02-05",0,0,2506,0,0,2506,0,0
"South America","2025-02-06",0,0,2506,0,0,2506,0,0
"South America","2025-02-07",0,0,2506,0,0,2506,0,0
"South America","2025-02-08",0,0,2506,0,0,2506,0,0
"South America","2025-02-09",0,0,2506,0,0,2506,0,0
"South America","2025-02-10",0,0,2506,0,0,2506,0,0
"South America","2025-02-11",0,0,2506,0,0,2506,0,0
"South America","2025-02-12",0,0,2506,0,0,2506,0,0
"South America","2025-02-13",0,0,2506,0,0,2506,0,0
"South America","2025-02-14",0,0,2506,0,0,2506,0,0
"South America","2025-02-15",0,0,2506,0,0,2506,0,0
"South America","2025-02-16",0,0,2506,0,0,2506,0,0
"South America","2025-02-17",0,0,2506,0,0,2506,0,0
"South America","2025-02-18",0,0,2506,0,0,2506,0,0
"South America","2025-02-19",0,0,2506,0,0,2506,0,0
"South America","2025-02-20",0,0,2506,0,0,2506,0,0
"South America","2025-02-21",0,0,2506,0,0,2506,0,0
"South America","2025-02-22",0,0,2506,0,0,2506,0,0
"South America","2025-02-23",0,0,2506,0,0,2506,0,0
"South America","2025-02-24",0,0,2506,0,0,2506,0,0
"South America","2025-02-25",0,0,2506,0,0,2506,0,0
"South America","2025-02-26",0,0,2506,0,0,2506,0,0
"South America","2025-02-27",0,0,2506,0,0,2506,0,0
"South America","2025-02-28",0,0,2506,0,0,2506,0,0
"South America","2025-03-01",0,0,2506,0,0,2506,0,0
"South America","2025-03-02",0,0,2506,0,0,2506,0,0
"South America","2025-03-03",0,0,2506,0,0,2506,0,0
"Republic of Korea","2024-01-01",0,0,0,0,0,0,0,0
"Republic of Korea","2024-01-02",0,0,0,0,0,0,0,0
"Republic of Korea","2024-01-03",0,0,0,0,0,0,0,0
"Republic of Korea","2024-01-04",0,0,0,0,0,0,0,0
"Republic of Korea","2024-01-05",0,0,0,0,0,0,0,0
"Republic of Korea","2024-01-06",0,0,0,0,0,0,0,0
"Republic of Korea","2024-01-07",0,0,0,0,0,0,0,0
"Republic of Korea","2024-01-08",0,0,0,0,0,0,0,0
"Republic of Korea","2024-01-09",0,0,0,0,0,0,0,0
"Republic of Korea","2024-01-10",0,0,0,0,0,0,0,0
"Republic of Korea","2024-01-11",0,0,0,0,0,0,0,0
"Republic of Korea","2024-01-12",0,0,0,0,0,0,0,0
"Republic of Korea","2024-01-13",0,0,0,0,0,0,0,0
"Republic of Korea","2024-01-14",0,0,0,0,0,0,0,0
"Republic of Korea","2024-01-15",0,0,0,0,0,0,0,0
"Republic of Korea","2024-01-16",0,0,0,0,0,0,0,0
"Republic of Korea","2024-01-17",0,0,0,0,0,0,0,0
"Republic of Korea","2024-01-18",0,0,0,0,0,0,0,0
"Republic of Korea","2024-01-19",0,0,0,0,0,0,0,0
"Republic of Korea","2024-01-20",0,0,0,0,0,0,0,0
"Republic of Korea","2024-01-21",0,0,0,0,0,0,0,0
"Republic of Korea","2024-01-22",0,0,0,0,0,0,0,0
"Republic of Korea","2024-01-23",0,0,0,0,0,0,0,0
"Republic of Korea","2024-01-24",0,0,0,0,0,0,0,0
"Republic of Korea","2024-01-25",0,0,0,0,0,0,0,0
"Republic of Korea","2024-01-26",0,0,0,0,0,0,0,0
"Republic of Korea","2024-01-27",0,0,0,0,0,0,0,0
"Republic of Korea","2024-01-28",0,0,0,0,0,0,0,0
"Republic of Korea","2024-01-29",0,0,0,0,0,0,0,0
"Republic of Korea","2024-01-30",0,0,0,0,0,0,0,0
"Republic of Korea","2024-01-31",0,0,0,0,0,0,0,0
"Republic of Korea","2024-02-01",0,0,0,0,0,0,0,0
"Republic of Korea","2024-02-02",0,0,0,0,0,0,0,0
"Republic of Korea","2024-02-03",0,0,0,0,0,0,0,0
"Republic of Korea","2024-02-04",0,0,0,0,0,0,0,0
"Republic of Korea","2024-02-05",0,0,0,0,0,0,0,0
"Republic of Korea","2024-02-06",0,0,0,0,0,0,0,0
"Republic of Korea","2024-02-07",0,0,0,0,0,0,0,0
"Republic of Korea","2024-02-08",0,0,0,0,0,0,0,0
"Republic of Korea","2024-02-09",0,0,0,0,0,0,0,0
"Republic of Korea","2024-02-10",0,0,0,0,0,0,0,0
"Republic of Korea","2024-02-11",0,0,0,0,0,0,0,0
"Republic of Korea","2024-02-12",0,0,0,0,0,0,0,0
"Republic of Korea","2024-02-13",0,0,0,0,0,0,0,0
"Republic of Korea","2024-02-14",0,0,0,0,0,0,0,0
"Republic of Korea","2024-02-15",0,0,0,0,0,0,0,0
"Republic of Korea","2024-02-16",0,0,0,0,0,0,0,0
"Republic of Korea","2024-02-17",0,0,0,0,0,0,0,0
"Republic of Korea","2024-02-18",0,0,0,0,0,0,0,0
"Republic of Korea","2024-02-19",0,0,0,0,0,0,0,0
"Republic of Korea","2024-02-20",0,0,0,0,0,0,0,0
"Republic of Korea","2024-02-21",0,0,0,0,0,0,0,0
"Republic of Korea","2024-02-22",0,0,0,0,0,0,0,0
"Republic of Korea","2024-02-23",0,0,0,0,0,0,0,0
"Republic of Korea","2024-02-24",0,0,0,0,0,0,0,0
"Republic of Korea","2024-02-25",0,0,0,0,0,0,0,0
"Republic of Korea","2024-02-26",0,0,0,0,0,0,0,0
"Republic of Korea","2024-02-27",0,0,0,0,0,0,0,0
"Republic of Korea","2024-02-28",0,0,0,0,0,0,0,0
"Republic of Korea","2024-02-29",0,0,0,0,0,0,0,0
"Republic of Korea","2024-03-01",0,0,0,0,0,0,0,0
"Republic of Korea","2024-03-02",0,0,0,0,0,0,0,0
"Republic of Korea","2024-03-03",0,0,0,0,0,0,0,0
"Republic of Korea","2024-03-04",0,0,0,0,0,0,0,0
"Republic of Korea","2024-03-05",0,0,0,0,0,0,0,0
"Republic of Korea","2024-03-06",0,0,0,0,0,0,0,0
"Republic of Korea","2024-03-07",0,0,0,0,0,0,0,0
"Republic of Korea","2024-03-08",0,0,0,0,0,0,0,0
"Republic of Korea","2024-03-09",0,0,0,0,0,0,0,0
"Republic of Korea","2024-03-10",0,0,0,0,0,0,0,0
"Republic of Korea","2024-03-11",0,0,0,0,0,0,0,0
"Republic of Korea","2024-03-12",0,0,0,0,0,0,0,0
"Republic of Korea","2024-03-13",0,0,0,0,0,0,0,0
"Republic of Korea","2024-03-14",0,0,0,0,0,0,0,0
"Republic of Korea","2024-03-15",0,0,0,0,0,0,0,0
"Republic of Korea","2024-03-16",0,0,0,0,0,0,0,0
"Republic of Korea","2024-03-17",0,0,0,0,0,0,0,0
"Republic of Korea","2024-03-18",0,0,0,0,0,0,0,0
"Republic of Korea","2024-03-19",0,0,0,0,0,0,0,0
"Republic of Korea","2024-03-20",0,0,0,0,0,0,0,0
"Republic of Korea","2024-03-21",0,0,0,0,0,0,0,0
"Republic of Korea","2024-03-22",0,0,0,0,0,0,0,0
"Republic of Korea","2024-03-23",0,0,0,0,0,0,0,0
"Republic of Korea","2024-03-24",0,0,0,0,0,0,0,0
"Republic of Korea","2024-03-25",0,0,0,0,0,0,0,0
"Republic of Korea","2024-03-26",0,0,0,0,0,0,0,0
"Republic of Korea","2024-03-27",0,0,0,0,0,0,0,0
"Republic of Korea","2024-03-28",0,0,0,0,0,0,0,0
"Republic of Korea","2024-03-29",0,0,0,0,0,0,0,0
"Republic of Korea","2024-03-30",0,0,0,0,0,0,0,0
"Republic of Korea","2024-03-31",0,0,0,0,0,0,0,0
"Republic of Korea","2024-04-01",0,0,0,0,0,0,0,0
"Republic of Korea","2024-04-02",0,0,0,0,0,0,0,0
"Republic of Korea","2024-04-03",0,0,0,0,0,0,0,0
"Republic of Korea","2024-04-04",0,0,0,0,0,0,0,0
"Republic of Korea","2024-04-05",0,0,0,0,0,0,0,0
"Republic of Korea","2024-04-06",0,0,0,0,0,0,0,0
"Republic of Korea","2024-04-07",0,0,0,0,0,0,0,0
"Republic of Korea","2024-04-08",0,0,0,0,0,0,0,0
"Republic of Korea","2024-04-09",0,0,0,0,0,0,0,0
"Republic of Korea","2024-04-10",0,0,0,0,0,0,0,0
"Republic of Korea","2024-04-11",0,0,0,0,0,0,0,0
"Republic of Korea","2024-04-12",0,0,0,0,0,0,0,0
"Republic of Korea","2024-04-13",0,0,0,0,0,0,0,0
"Republic of Korea","2024-04-14",0,0,0,0,0,0,0,0
"Republic of Korea","2024-04-15",0,0,0,0,0,0,0,0
"Republic of Korea","2024-04-16",0,0,0,0,0,0,0,0
"Republic of Korea","2024-04-17",0,0,0,0,0,0,0,0
"Republic of Korea","2024-04-18",0,0,0,0,0,0,0,0
"Republic of Korea","2024-04-19",0,0,0,0,0,0,0,0
"Republic of Korea","2024-04-20",0,0,0,0,0,0,0,0
"Republic of Korea","2024-04-21",0,0,0,0,0,0,0,0
"Republic of Korea","2024-04-22",0,0,0,0,0,0,0,0
"Republic of Korea","2024-04-23",0,0,0,0,0,0,0,0
"Republic of Korea","2024-04-24",0,0,0,0,0,0,0,0
"Republic of Korea","2024-04-25",0,0,0,0,0,0,0,0
"Republic of Korea","2024-04-26",0,0,0,0,0,0,0,0
"Republic of Korea","2024-04-27",0,1,1,0,1,1,0,0
"Republic of Korea","2024-04-28",0,0,1,0,0,1,0,0
"Republic of Korea","2024-04-29",0,0,1,0,0,1,0,0
"Republic of Korea","2024-04-30",0,0,1,0,0,1,0,0
"Republic of Korea","2024-05-01",0,0,1,0,0,1,0,0
"Republic of Korea","2024-05-02",0,0,1,0,0,1,0,0
"Republic of Korea","2024-05-03",0,0,1,0,0,1,0,0
"Republic of Korea","2024-05-04",0,0,1,0,0,1,0,0
"Republic of Korea","2024-05-05",0,0,1,0,0,1,0,0
"Republic of Korea","2024-05-06",0,0,1,0,0,1,0,0
"Republic of Korea","2024-05-07",0,0,1,0,0,1,0,0
"Republic of Korea","2024-05-08",0,0,1,0,0,1,0,0
"Republic of Korea","2024-05-09",0,0,1,0,0,1,0,0
"Republic of Korea","2024-05-10",0,0,1,0,0,1,0,0
"Republic of Korea","2024-05-11",0,0,1,0,0,1,0,0
"Republic of Korea","2024-05-12",0,0,1,0,1,2,0,0
"Republic of Korea","2024-05-13",0,0,1,0,0,2,0,0
"Republic of Korea","2024-05-14",0,0,1,0,0,2,0,0
"Republic of Korea","2024-05-15",0,0,1,0,0,2,0,0
"Republic of Korea","2024-05-16",0,0,1,0,0,2,0,0
"Republic of Korea","2024-05-17",0,0,1,0,0,2,0,0
"Republic of Korea","2024-05-18",0,0,1,0,0,2,0,0
"Republic of Korea","2024-05-19",0,0,1,0,0,2,0,0
"Republic of Korea","2024-05-20",0,0,1,0,0,2,0,0
"Republic of Korea","2024-05-21",0,0,1,0,0,2,0,0
"Republic of Korea","2024-05-22",0,0,1,0,0,2,0,0
"Republic of Korea","2024-05-23",0,0,1,0,0,2,0,0
"Republic of Korea","2024-05-24",0,0,1,0,0,2,0,0
"Republic of Korea","2024-05-25",0,0,1,0,0,2,0,0
"Republic of Korea","2024-05-26",0,0,1,0,0,2,0,0
"Republic of Korea","2024-05-27",0,0,1,0,0,2,0,0
"Republic of Korea","2024-05-28",0,0,1,0,0,2,0,0
"Republic of Korea","2024-05-29",0,0,1,0,0,2,0,0
"Republic of Korea","2024-05-30",0,0,1,0,0,2,0,0
"Republic of Korea","2024-05-31",0,0,1,0,0,2,0,0
"Republic of Korea","2024-06-01",0,0,1,0,0,2,0,0
"Republic of Korea","2024-06-02",0,0,1,0,0,2,0,0
"Republic of Korea","2024-06-03",0,0,1,0,0,2,0,0
"Republic of Korea","2024-06-04",0,0,1,0,0,2,0,0
"Republic of Korea","2024-06-05",0,0,1,0,0,2,0,0
"Republic of Korea","2024-06-06",0,0,1,0,0,2,0,0
"Republic of Korea","2024-06-07",0,0,1,0,0,2,0,0
"Republic of Korea","2024-06-08",0,0,1,0,0,2,0,0
"Republic of Korea","2024-06-09",0,0,1,0,0,2,0,0
"Republic of Korea","2024-06-10",0,0,1,0,0,2,0,0
"Republic of Korea","2024-06-11",0,0,1,0,1,3,0,0
"Republic of Korea","2024-06-12",0,0,1,0,0,3,0,0
"Republic of Korea","2024-06-13",0,0,1,0,0,3,0,0
"Republic of Korea","2024-06-14",0,0,1,0,0,3,0,0
"Republic of Korea","2024-06-15",0,0,1,0,0,3,0,0
"Republic of Korea","2024-06-16",0,0,1,0,0,3,0,0
"Republic of Korea","2024-06-17",0,0,1,0,0,3,0,0
"Republic of Korea","2024-06-18",0,0,1,0,0,3,0,0
"Republic of Korea","2024-06-19",0,0,1,0,0,3,0,0
"Republic of Korea","2024-06-20",0,0,1,0,0,3,0,0
"Republic of Korea","2024-06-21",0,0,1,0,0,3,0,0
"Republic of Korea","2024-06-22",0,0,1,0,0,3,0,0
"Republic of Korea","2024-06-23",0,0,1,0,0,3,0,0
"Republic of Korea","2024-06-24",0,0,1,0,0,3,0,0
"Republic of Korea","2024-06-25",0,2,3,0,0,3,0,0
"Republic of Korea","2024-06-26",0,0,3,0,0,3,0,0
"Republic of Korea","2024-06-27",0,0,3,0,1,4,0,0
"Republic of Korea","2024-06-28",0,1,4,0,0,4,0,0
"Republic of Korea","2024-06-29",0,0,4,0,0,4,0,0
"Republic of Korea","2024-06-30",0,0,4,0,0,4,0,0
"Republic of Korea","2024-07-01",0,0,4,0,0,4,0,0
"Republic of Korea","2024-07-02",0,0,4,0,1,5,0,0
"Republic of Korea","2024-07-03",0,0,4,0,0,5,0,0
"Republic of Korea","2024-07-04",0,0,4,0,0,5,0,0
"Republic of Korea","2024-07-05",0,0,4,0,0,5,0,0
"Republic of Korea","2024-07-06",0,0,4,0,0,5,0,0
"Republic of Korea","2024-07-07",0,0,4,0,0,5,0,0
"Republic of Korea","2024-07-08",0,0,4,0,0,5,0,0
"Republic of Korea","2024-07-09",0,0,4,0,1,6,0,0
"Republic of Korea","2024-07-10",0,0,4,0,0,6,0,0
"Republic of Korea","2024-07-11",0,0,4,0,0,6,0,0
"Republic of Korea","2024-07-12",0,2,6,0,0,6,0,0
"Republic of Korea","2024-07-13",0,0,6,0,0,6,0,0
"Republic of Korea","2024-07-14",0,0,6,0,0,6,0,0
"Republic of Korea","2024-07-15",0,0,6,0,1,7,0,0
"Republic of Korea","2024-07-16",0,0,6,0,0,7,0,0
"Republic of Korea","2024-07-17",0,0,6,0,0,7,0,0
"Republic of Korea","2024-07-18",0,0,6,0,0,7,0,0
"Republic of Korea","2024-07-19",0,0,6,0,0,7,0,0
"Republic of Korea","2024-07-20",0,0,6,0,1,8,0,0
"Republic of Korea","2024-07-21",0,0,6,0,0,8,0,0
"Republic of Korea","2024-07-22",0,0,6,0,0,8,0,0
"Republic of Korea","2024-07-23",0,0,6,0,0,8,0,0
"Republic of Korea","2024-07-24",0,0,6,0,0,8,0,0
"Republic of Korea","2024-07-25",0,0,6,0,0,8,0,0
"Republic of Korea","2024-07-26",0,0,6,0,1,9,0,0
"Republic of Korea","2024-07-27",0,0,6,0,0,9,0,0
"Republic of Korea","2024-07-28",0,0,6,0,0,9,0,0
"Republic of Korea","2024-07-29",0,0,6,0,0,9,0,0
"Republic of Korea","2024-07-30",0,0,6,0,0,9,0,0
"Republic of Korea","2024-07-31",0,0,6,0,1,10,0,0
"Republic of Korea","2024-08-01",0,0,6,0,0,10,0,0
"Republic of Korea","2024-08-02",0,4,10,0,0,10,0,0
"Republic of Korea","2024-08-03",0,0,10,0,0,10,0,0
"Republic of Korea","2024-08-04",0,0,10,0,0,10,0,0
"Republic of Korea","2024-08-05",0,0,10,0,0,10,0,0
"Republic of Korea","2024-08-06",0,0,10,0,0,10,0,0
"Republic of Korea","2024-08-07",0,0,10,0,0,10,0,0
"Republic of Korea","2024-08-08",0,0,10,0,0,10,0,0
"Republic of Korea","2024-08-09",0,0,10,0,0,10,0,0
"Republic of Korea","2024-08-10",0,0,10,0,0,10,0,0
"Republic of Korea","2024-08-11",0,0,10,0,0,10,0,0
"Republic of Korea","2024-08-12",0,0,10,0,0,10,0,0
"Republic of Korea","2024-08-13",0,0,10,0,1,11,0,0
"Republic of Korea","2024-08-14",0,0,10,0,0,11,0,0
"Republic of Korea","2024-08-15",0,0,10,0,0,11,0,0
"Republic of Korea","2024-08-16",0,0,10,0,0,11,0,0
"Republic of Korea","2024-08-17",0,0,10,0,0,11,0,0
"Republic of Korea","2024-08-18",0,0,10,0,0,11,0,0
"Republic of Korea","2024-08-19",0,0,10,0,0,11,0,0
"Republic of Korea","2024-08-20",0,0,10,0,0,11,0,0
"Republic of Korea","2024-08-21",0,0,10,0,0,11,0,0
"Republic of Korea","2024-08-22",0,1,11,0,0,11,0,0
"Republic of Korea","2024-08-23",0,0,11,0,0,11,0,0
"Republic of Korea","2024-08-24",0,0,11,0,0,11,0,0
"Republic of Korea","2024-08-25",0,0,11,0,0,11,0,0
"Republic of Korea","2024-08-26",0,0,11,0,0,11,0,0
"Republic of Korea","2024-08-27",0,0,11,0,0,11,0,0
"Republic of Korea","2024-08-28",0,0,11,0,0,11,0,0
"Republic of Korea","2024-08-29",0,0,11,0,1,12,0,0
"Republic of Korea","2024-08-30",0,0,11,0,0,12,0,0
"Republic of Korea","2024-08-31",0,0,11,0,0,12,0,0
"Republic of Korea","2024-09-01",0,0,11,0,0,12,0,0
"Republic of Korea","2024-09-02",0,0,11,0,0,12,0,0
"Republic of Korea","2024-09-03",0,0,11,0,0,12,0,0
"Republic of Korea","2024-09-04",0,0,11,0,0,12,0,0
"Republic of Korea","2024-09-05",0,0,11,0,0,12,0,0
"Republic of Korea","2024-09-06",0,0,11,0,0,12,0,0
"Republic of Korea","2024-09-07",0,0,11,0,0,12,0,0
"Republic of Korea","2024-09-08",0,0,11,0,0,12,0,0
"Republic of Korea","2024-09-09",0,0,11,0,1,13,0,0
"Republic of Korea","2024-09-10",0,0,11,0,0,13,0,0
"Republic of Korea","2024-09-11",0,0,11,0,0,13,0,0
"Republic of Korea","2024-09-12",0,0,11,0,0,13,0,0
"Republic of Korea","2024-09-13",0,0,11,0,0,13,0,0
"Republic of Korea","2024-09-14",0,0,11,0,0,13,0,0
"Republic of Korea","2024-09-15",0,2,13,0,0,13,0,0
"Republic of Korea","2024-09-16",0,0,13,0,0,13,0,0
"Republic of Korea","2024-09-17",0,0,13,0,0,13,0,0
"Republic of Korea","2024-09-18",0,0,13,0,0,13,0,0
"Republic of Korea","2024-09-19",0,0,13,0,0,13,0,0
"Republic of Korea","2024-09-20",0,0,13,0,0,13,0,0
"Republic of Korea","2024-09-21",0,0,13,0,0,13,0,0
"Republic of Korea","2024-09-22",0,0,13,0,0,13,0,0
"Republic of Korea","2024-09-23",0,0,13,0,0,13,0,0
"Republic of Korea","2024-09-24",0,0,13,0,0,13,0,0
"Republic of Korea","2024-09-25",0,0,13,0,0,13,0,0
"Republic of Korea","2024-09-26",0,0,13,0,0,13,0,0
"Republic of Korea","2024-09-27",0,0,13,0,0,13,0,0
"Republic of Korea","2024-09-28",0,0,13,0,0,13,0,0
"Republic of Korea","2024-09-29",0,0,13,0,0,13,0,0
"Republic of Korea","2024-09-30",0,0,13,0,0,13,0,0
"Republic of Korea","2024-10-01",0,0,13,0,0,13,0,0
"Republic of Korea","2024-10-02",0,0,13,0,0,13,0,0
"Republic of Korea","2024-10-03",0,0,13,0,0,13,0,0
"Republic of Korea","2024-10-04",0,0,13,0,0,13,0,0
"Republic of Korea","2024-10-05",0,0,13,0,0,13,0,0
"Republic of Korea","2024-10-06",0,0,13,0,0,13,0,0
"Republic of Korea","2024-10-07",0,0,13,0,0,13,0,0
"Republic of Korea","2024-10-08",0,0,13,0,0,13,0,0
"Republic of Korea","2024-10-09",0,0,13,0,1,14,0,0
"Republic of Korea","2024-10-10",0,0,13,0,0,14,0,0
"Republic of Korea","2024-10-11",0,0,13,0,0,14,0,0
"Republic of Korea","2024-10-12",0,0,13,0,0,14,0,0
"Republic of Korea","2024-10-13",0,0,13,0,0,14,0,0
"Republic of Korea","2024-10-14",0,0,13,0,0,14,0,0
"Republic of Korea","2024-10-15",0,0,13,0,0,14,0,0
"Republic of Korea","2024-10-16",0,0,13,0,0,14,0,0
"Republic of Korea","2024-10-17",0,0,13,0,0,14,0,0
"Republic of Korea","2024-10-18",0,0,13,0,0,14,0,0
"Republic of Korea","2024-10-19",0,0,13,0,0,14,0,0
"Republic of Korea","2024-10-20",0,0,13,0,0,14,0,0
"Republic of Korea","2024-10-21",0,0,13,0,0,14,0,0
"Republic of Korea","2024-10-22",0,0,13,0,0,14,0,0
"Republic of Korea","2024-10-23",0,0,13,0,0,14,0,0
"Republic of Korea","2024-10-24",0,0,13,0,0,14,0,0
"Republic of Korea","2024-10-25",0,0,13,0,0,14,0,0
"Republic of Korea","2024-10-26",0,0,13,0,0,14,0,0
"Republic of Korea","2024-10-27",0,0,13,0,0,14,0,0
"Republic of Korea","2024-10-28",0,0,13,0,0,14,0,0
"Republic of Korea","2024-10-29",0,0,13,0,0,14,0,0
"Republic of Korea","2024-10-30",0,0,13,0,0,14,0,0
"Republic of Korea","2024-10-31",0,1,14,0,0,14,0,0
"Republic of Korea","2024-11-01",0,0,14,0,0,14,0,0
"Republic of Korea","2024-11-02",0,0,14,0,0,14,0,0
"Republic of Korea","2024-11-03",0,0,14,0,1,15,0,0
"Republic of Korea","2024-11-04",0,0,14,0,0,15,0,0
"Republic of Korea","2024-11-05",0,0,14,0,0,15,0,0
"Republic of Korea","2024-11-06",0,0,14,0,0,15,0,0
"Republic of Korea","2024-11-07",0,0,14,0,0,15,0,0
"Republic of Korea","2024-11-08",0,0,14,0,1,16,0,0
"Republic of Korea","2024-11-09",0,0,14,0,0,16,0,0
"Republic of Korea","2024-11-10",0,0,14,0,0,16,0,0
"Republic of Korea","2024-11-11",0,0,14,0,0,16,0,0
"Republic of Korea","2024-11-12",0,0,14,0,0,16,0,0
"Republic of Korea","2024-11-13",0,0,14,0,1,17,0,0
"Republic of Korea","2024-11-14",0,0,14,0,0,17,0,0
"Republic of Korea","2024-11-15",0,3,17,0,0,17,0,0
"Republic of Korea","2024-11-16",0,0,17,0,0,17,0,0
"Republic of Korea","2024-11-17",0,0,17,0,0,17,0,0
"Republic of Korea","2024-11-18",0,0,17,0,0,17,0,0
"Republic of Korea","2024-11-19",0,0,17,0,0,17,0,0
"Republic of Korea","2024-11-20",0,0,17,0,0,17,0,0
"Republic of Korea","2024-11-21",0,0,17,0,0,17,0,0
"Republic of Korea","2024-11-22",0,0,17,0,0,17,0,0
"Republic of Korea","2024-11-23",0,0,17,0,0,17,0,0
"Republic of Korea","2024-11-24",0,0,17,0,0,17,0,0
"Republic of Korea","2024-11-25",0,0,17,0,0,17,0,0
"Republic of Korea","2024-11-26",0,0,17,0,0,17,0,0
"Republic of Korea","2024-11-27",0,0,17,0,0,17,0,0
"Republic of Korea","2024-11-28",0,0,17,0,0,17,0,0
"Republic of Korea","2024-11-29",0,0,17,0,0,17,0,0
"Republic of Korea","2024-11-30",0,0,17,0,0,17,0,0
"Republic of Korea","2024-12-01",0,0,17,0,0,17,0,0
"Republic of Korea","2024-12-02",0,0,17,0,0,17,0,0
"Republic of Korea","2024-12-03",0,0,17,0,0,17,0,0
"Republic of Korea","2024-12-04",0,0,17,0,0,17,0,0
"Republic of Korea","2024-12-05",0,0,17,0,0,17,0,0
"Republic of Korea","2024-12-06",0,0,17,0,0,17,0,0
"Republic of Korea","2024-12-07",0,0,17,0,0,17,0,0
"Republic of Korea","2024-12-08",0,0,17,0,0,17,0,0
"Republic of Korea","2024-12-09",0,0,17,0,0,17,0,0
"Republic of Korea","2024-12-10",0,0,17,0,0,17,0,0
"Republic of Korea","2024-12-11",0,0,17,0,0,17,0,0
"Republic of Korea","2024-12-12",0,0,17,0,0,17,0,0
"Republic of Korea","2024-12-13",0,0,17,0,0,17,0,0
"Republic of Korea","2024-12-14",0,0,17,0,0,17,0,0
"Republic of Korea","2024-12-15",0,0,17,0,0,17,0,0
"Republic of Korea","2024-12-16",0,0,17,0,0,17,0,0
"Republic of Korea","2024-12-17",0,0,17,0,0,17,0,0
"Republic of Korea","2024-12-18",0,0,17,0,0,17,0,0
"Republic of Korea","2024-12-19",0,0,17,0,0,17,0,0
"Republic of Korea","2024-12-20",0,0,17,0,0,17,0,0
"Republic of Korea","2024-12-21",0,0,17,0,0,17,0,0
"Republic of Korea","2024-12-22",0,0,17,0,0,17,0,0
"Republic of Korea","2024-12-23",0,0,17,0,0,17,0,0
"Republic of Korea","2024-12-24",0,0,17,0,0,17,0,0
"Republic of Korea","2024-12-25",0,0,17,0,0,17,0,0
"Republic of Korea","2024-12-26",0,0,17,0,0,17,0,0
"Republic of Korea","2024-12-27",0,0,17,0,0,17,0,0
"Republic of Korea","2024-12-28",0,0,17,0,0,17,0,0
"Republic of Korea","2024-12-29",0,0,17,0,0,17,0,0
"Republic of Korea","2024-12-30",0,0,17,0,0,17,0,0
"Republic of Korea","2024-12-31",0,0,17,0,0,17,0,0
"Republic of Korea","2025-01-01",0,0,17,0,0,17,0,0
"Republic of Korea","2025-01-02",0,0,17,0,0,17,0,0
"Republic of Korea","2025-01-03",0,0,17,0,0,17,0,0
"Republic of Korea","2025-01-04",0,0,17,0,0,17,0,0
"Republic of Korea","2025-01-05",0,0,17,0,0,17,0,0
"Republic of Korea","2025-01-06",0,0,17,0,0,17,0,0
"Republic of Korea","2025-01-07",0,0,17,0,0,17,0,0
"Republic of Korea","2025-01-08",0,0,17,0,0,17,0,0
"Republic of Korea","2025-01-09",0,0,17,0,0,17,0,0
"Republic of Korea","2025-01-10",0,0,17,0,0,17,0,0
"Republic of Korea","2025-01-11",0,0,17,0,0,17,0,0
"Republic of Korea","2025-01-12",0,0,17,0,0,17,0,0
"Republic of Korea","2025-01-13",0,0,17,0,0,17,0,0
"Republic of Korea","2025-01-14",0,0,17,0,0,17,0,0
"Republic of Korea","2025-01-15",0,0,17,0,0,17,0,0
"Republic of Korea","2025-01-16",0,0,17,0,0,17,0,0
"Republic of Korea","2025-01-17",0,0,17,0,0,17,0,0
"Republic of Korea","2025-01-18",0,0,17,0,0,17,0,0
"Republic of Korea","2025-01-19",0,0,17,0,0,17,0,0
"Republic of Korea","2025-01-20",0,0,17,0,0,17,0,0
"Republic of Korea","2025-01-21",0,0,17,0,0,17,0,0
"Republic of Korea","2025-01-22",0,0,17,0,0,17,0,0
"Republic of Korea","2025-01-23",0,0,17,0,0,17,0,0
"Republic of Korea","2025-01-24",0,0,17,0,0,17,0,0
"Republic of Korea","2025-01-25",0,0,17,0,0,17,0,0
"Republic of Korea","2025-01-26",0,0,17,0,0,17,0,0
"Republic of Korea","2025-01-27",0,0,17,0,0,17,0,0
"Republic of Korea","2025-01-28",0,0,17,0,0,17,0,0
"Republic of Korea","2025-01-29",0,0,17,0,0,17,0,0
"Republic of Korea","2025-01-30",0,0,17,0,0,17,0,0
"Republic of Korea","2025-01-31",0,0,17,0,0,17,0,0
"Republic of Korea","2025-02-01",0,0,17,0,0,17,0,0
"Republic of Korea","2025-02-02",0,0,17,0,0,17,0,0
"Republic of Korea","2025-02-03",0,0,17,0,0,17,0,0
"Republic of Korea","2025-02-04",0,0,17,0,0,17,0,0
"Republic of Korea","2025-02-05",0,0,17,0,0,17,0,0
"Republic of Korea","2025-02-06",0,0,17,0,0,17,0,0
"Republic of Korea","2025-02-07",0,0,17,0,0,17,0,0
"Republic of Korea","2025-02-08",0,0,17,0,0,17,0,0
"Republic of Korea","2025-02-09",0,0,17,0,0,17,0,0
"Republic of Korea","2025-02-10",0,0,17,0,0,17,0,0
"Republic of Korea","2025-02-11",0,0,17,0,0,17,0,0
"Republic of Korea","2025-02-12",0,0,17,0,0,17,0,0
"Republic of Korea","2025-02-13",0,0,17,0,0,17,0,0
"Republic of Korea","2025-02-14",0,0,17,0,0,17,0,0
"Republic of Korea","2025-02-15",0,0,17,0,0,17,0,0
"Republic of Korea","2025-02-16",0,0,17,0,0,17,0,0
"Republic of Korea","2025-02-17",0,0,17,0,0,17,0,0
"Republic of Korea","2025-02-18",0,0,17,0,0,17,0,0
"Republic of Korea","2025-02-19",0,0,17,0,0,17,0,0
"Republic of Korea","2025-02-20",0,0,17,0,0,17,0,0
"Republic of Korea","2025-02-21",0,0,17,0,0,17,0,0
"Republic of Korea","2025-02-22",0,0,17,0,0,17,0,0
"Republic of Korea","2025-02-23",0,0,17,0,0,17,0,0
"Republic of Korea","2025-02-24",0,0,17,0,0,17,0,0
"Republic of Korea","2025-02-25",0,0,17,0,0,17,0,0
"Republic of Korea","2025-02-26",0,0,17,0,0,17,0,0
"Republic of Korea","2025-02-27",0,0,17,0,0,17,0,0
"Republic of Korea","2025-02-28",0,0,17,0,0,17,0,0
"Republic of Korea","2025-03-01",0,0,17,0,0,17,0,0
"Republic of Korea","2025-03-02",0,0,17,0,0,17,0,0
"Republic of Korea","2025-03-03",0,0,17,0,0,17,0,0
"South Sudan","2024-01-01",0,0,0,0,0,0,0,0
"South Sudan","2024-01-02",0,0,0,0,0,0,0,0
"South Sudan","2024-01-03",0,0,0,0,0,0,0,0
"South Sudan","2024-01-04",0,0,0,0,0,0,0,0
"South Sudan","2024-01-05",0,0,0,0,0,0,0,0
"South Sudan","2024-01-06",0,0,0,0,0,0,0,0
"South Sudan","2024-01-07",0,0,0,0,0,0,0,0
"South Sudan","2024-01-08",0,0,0,0,0,0,0,0
"South Sudan","2024-01-09",0,0,0,0,0,0,0,0
"South Sudan","2024-01-10",0,0,0,0,0,0,0,0
"South Sudan","2024-01-11",0,0,0,0,0,0,0,0
"South Sudan","2024-01-12",0,0,0,0,0,0,0,0
"South Sudan","2024-01-13",0,0,0,0,0,0,0,0
"South Sudan","2024-01-14",0,0,0,0,0,0,0,0
"South Sudan","2024-01-15",0,0,0,0,0,0,0,0
"South Sudan","2024-01-16",0,0,0,0,0,0,0,0
"South Sudan","2024-01-17",0,0,0,0,0,0,0,0
"South Sudan","2024-01-18",0,0,0,0,0,0,0,0
"South Sudan","2024-01-19",0,0,0,0,0,0,0,0
"South Sudan","2024-01-20",0,0,0,0,0,0,0,0
"South Sudan","2024-01-21",0,0,0,0,0,0,0,0
"South Sudan","2024-01-22",0,0,0,0,0,0,0,0
"South Sudan","2024-01-23",0,0,0,0,0,0,0,0
"South Sudan","2024-01-24",0,0,0,0,0,0,0,0
"South Sudan","2024-01-25",0,0,0,0,0,0,0,0
"South Sudan","2024-01-26",0,0,0,0,0,0,0,0
"South Sudan","2024-01-27",0,0,0,0,0,0,0,0
"South Sudan","2024-01-28",0,0,0,0,0,0,0,0
"South Sudan","2024-01-29",0,0,0,0,0,0,0,0
"South Sudan","2024-01-30",0,0,0,0,0,0,0,0
"South Sudan","2024-01-31",0,0,0,0,0,0,0,0
"South Sudan","2024-02-01",0,0,0,0,0,0,0,0
"South Sudan","2024-02-02",0,0,0,0,0,0,0,0
"South Sudan","2024-02-03",0,0,0,0,0,0,0,0
"South Sudan","2024-02-04",0,0,0,0,0,0,0,0
"South Sudan","2024-02-05",0,0,0,0,0,0,0,0
"South Sudan","2024-02-06",0,0,0,0,0,0,0,0
"South Sudan","2024-02-07",0,0,0,0,0,0,0,0
"South Sudan","2024-02-08",0,0,0,0,0,0,0,0
"South Sudan","2024-02-09",0,0,0,0,0,0,0,0
"South Sudan","2024-02-10",0,0,0,0,0,0,0,0
"South Sudan","2024-02-11",0,0,0,0,0,0,0,0
"South Sudan","2024-02-12",0,0,0,0,0,0,0,0
"South Sudan","2024-02-13",0,0,0,0,0,0,0,0
"South Sudan","2024-02-14",0,0,0,0,0,0,0,0
"South Sudan","2024-02-15",0,0,0,0,0,0,0,0
"South Sudan","2024-02-16",0,0,0,0,0,0,0,0
"South Sudan","2024-02-17",0,0,0,0,0,0,0,0
"South Sudan","2024-02-18",0,0,0,0,0,0,0,0
"South Sudan","2024-02-19",0,0,0,0,0,0,0,0
"South Sudan","2024-02-20",0,0,0,0,0,0,0,0
"South Sudan","2024-02-21",0,0,0,0,0,0,0,0
"South Sudan","2024-02-22",0,0,0,0,0,0,0,0
"South Sudan","2024-02-23",0,0,0,0,0,0,0,0
"South Sudan","2024-02-24",0,0,0,0,0,0,0,0
"South Sudan","2024-02-25",0,0,0,0,0,0,0,0
"South Sudan","2024-02-26",0,0,0,0,0,0,0,0
"South Sudan","2024-02-27",0,0,0,0,0,0,0,0
"South Sudan","2024-02-28",0,0,0,0,0,0,0,0
"South Sudan","2024-02-29",0,0,0,0,0,0,0,0
"South Sudan","2024-03-01",0,0,0,0,0,0,0,0
"South Sudan","2024-03-02",0,0,0,0,0,0,0,0
"South Sudan","2024-03-03",0,0,0,0,0,0,0,0
"South Sudan","2024-03-04",0,0,0,0,0,0,0,0
"South Sudan","2024-03-05",0,0,0,0,0,0,0,0
"South Sudan","2024-03-06",0,0,0,0,0,0,0,0
"South Sudan","2024-03-07",0,0,0,0,0,0,0,0
"South Sudan","2024-03-08",0,0,0,0,0,0,0,0
"South Sudan","2024-03-09",0,0,0,0,0,0,0,0
"South Sudan","2024-03-10",0,0,0,0,0,0,0,0
"South Sudan","2024-03-11",0,0,0,0,0,0,0,0
"South Sudan","2024-03-12",0,0,0,0,0,0,0,0
"South Sudan","2024-03-13",0,0,0,0,0,0,0,0
"South Sudan","2024-03-14",0,0,0,0,0,0,0,0
"South Sudan","2024-03-15",0,0,0,0,0,0,0,0
"South Sudan","2024-03-16",0,0,0,0,0,0,0,0
"South Sudan","2024-03-17",0,0,0,0,0,0,0,0
"South Sudan","2024-03-18",0,0,0,0,0,0,0,0
"South Sudan","2024-03-19",0,0,0,0,0,0,0,0
"South Sudan","2024-03-20",0,0,0,0,0,0,0,0
"South Sudan","2024-03-21",0,0,0,0,0,0,0,0
"South Sudan","2024-03-22",0,0,0,0,0,0,0,0
"South Sudan","2024-03-23",0,0,0,0,0,0,0,0
"South Sudan","2024-03-24",0,0,0,0,0,0,0,0
"South Sudan","2024-03-25",0,0,0,0,0,0,0,0
"South Sudan","2024-03-26",0,0,0,0,0,0,0,0
"South Sudan","2024-03-27",0,0,0,0,0,0,0,0
"South Sudan","2024-03-28",0,0,0,0,0,0,0,0
"South Sudan","2024-03-29",0,0,0,0,0,0,0,0
"South Sudan","2024-03-30",0,0,0,0,0,0,0,0
"South Sudan","2024-03-31",0,0,0,0,0,0,0,0
"South Sudan","2024-04-01",0,0,0,0,0,0,0,0
"South Sudan","2024-04-02",0,0,0,0,0,0,0,0
"South Sudan","2024-04-03",0,0,0,0,0,0,0,0
"South Sudan","2024-04-04",0,0,0,0,0,0,0,0
"South Sudan","2024-04-05",0,0,0,0,0,0,0,0
"South Sudan","2024-04-06",0,0,0,0,0,0,0,0
"South Sudan","2024-04-07",0,0,0,0,0,0,0,0
"South Sudan","2024-04-08",0,0,0,0,0,0,0,0
"South Sudan","2024-04-09",0,0,0,0,0,0,0,0
"South Sudan","2024-04-10",0,0,0,0,0,0,0,0
"South Sudan","2024-04-11",0,0,0,0,0,0,0,0
"South Sudan","2024-04-12",0,0,0,0,0,0,0,0
"South Sudan","2024-04-13",0,0,0,0,0,0,0,0
"South Sudan","2024-04-14",0,0,0,0,0,0,0,0
"South Sudan","2024-04-15",0,0,0,0,0,0,0,0
"South Sudan","2024-04-16",0,0,0,0,0,0,0,0
"South Sudan","2024-04-17",0,0,0,0,0,0,0,0
"South Sudan","2024-04-18",0,0,0,0,0,0,0,0
"South Sudan","2024-04-19",0,0,0,0,0,0,0,0
"South Sudan","2024-04-20",0,0,0,0,0,0,0,0
"South Sudan","2024-04-21",0,0,0,0,0,0,0,0
"South Sudan","2024-04-22",0,0,0,0,0,0,0,0
"South Sudan","2024-04-23",0,0,0,0,0,0,0,0
"South Sudan","2024-04-24",0,0,0,0,0,0,0,0
"South Sudan","2024-04-25",0,0,0,0,0,0,0,0
"South Sudan","2024-04-26",0,0,0,0,0,0,0,0
"South Sudan","2024-04-27",0,0,0,0,0,0,0,0
"South Sudan","2024-04-28",0,0,0,0,0,0,0,0
"South Sudan","2024-04-29",0,0,0,0,0,0,0,0
"South Sudan","2024-04-30",0,0,0,0,0,0,0,0
"South Sudan","2024-05-01",0,0,0,0,0,0,0,0
"South Sudan","2024-05-02",0,0,0,0,0,0,0,0
"South Sudan","2024-05-03",0,0,0,0,0,0,0,0
"South Sudan","2024-05-04",0,0,0,0,0,0,0,0
"South Sudan","2024-05-05",0,0,0,0,0,0,0,0
"South Sudan","2024-05-06",0,0,0,0,0,0,0,0
"South Sudan","2024-05-07",0,0,0,0,0,0,0,0
"South Sudan","2024-05-08",0,0,0,0,0,0,0,0
"South Sudan","2024-05-09",0,0,0,0,0,0,0,0
"South Sudan","2024-05-10",0,0,0,0,0,0,0,0
"South Sudan","2024-05-11",0,0,0,0,0,0,0,0
"South Sudan","2024-05-12",0,0,0,0,0,0,0,0
"South Sudan","2024-05-13",0,0,0,0,0,0,0,0
"South Sudan","2024-05-14",0,0,0,0,0,0,0,0
"South Sudan","2024-05-15",0,0,0,0,0,0,0,0
"South Sudan","2024-05-16",0,0,0,0,0,0,0,0
"South Sudan","2024-05-17",0,0,0,0,0,0,0,0
"South Sudan","2024-05-18",0,0,0,0,0,0,0,0
"South Sudan","2024-05-19",0,0,0,0,0,0,0,0
"South Sudan","2024-05-20",0,0,0,0,0,0,0,0
"South Sudan","2024-05-21",0,0,0,0,0,0,0,0
"South Sudan","2024-05-22",0,0,0,0,0,0,0,0
"South Sudan","2024-05-23",0,0,0,0,0,0,0,0
"South Sudan","2024-05-24",0,0,0,0,0,0,0,0
"South Sudan","2024-05-25",0,0,0,0,0,0,0,0
"South Sudan","2024-05-26",0,0,0,0,0,0,0,0
"South Sudan","2024-05-27",0,0,0,0,0,0,0,0
"South Sudan","2024-05-28",0,0,0,0,0,0,0,0
"South Sudan","2024-05-29",0,0,0,0,0,0,0,0
"South Sudan","2024-05-30",0,0,0,0,0,0,0,0
"South Sudan","2024-05-31",0,0,0,0,0,0,0,0
"South Sudan","2024-06-01",0,0,0,0,0,0,0,0
"South Sudan","2024-06-02",0,0,0,0,0,0,0,0
"South Sudan","2024-06-03",0,0,0,0,0,0,0,0
"South Sudan","2024-06-04",0,0,0,0,0,0,0,0
"South Sudan","2024-06-05",0,0,0,0,0,0,0,0
"South Sudan","2024-06-06",0,0,0,0,0,0,0,0
"South Sudan","2024-06-07",0,0,0,0,0,0,0,0
"South Sudan","2024-06-08",0,0,0,0,0,0,0,0
"South Sudan","2024-06-09",0,0,0,0,0,0,0,0
"South Sudan","2024-06-10",0,0,0,0,0,0,0,0
"South Sudan","2024-06-11",0,0,0,0,0,0,0,0
"South Sudan","2024-06-12",0,0,0,0,0,0,0,0
"South Sudan","2024-06-13",0,0,0,0,0,0,0,0
"South Sudan","2024-06-14",0,0,0,0,0,0,0,0
"South Sudan","2024-06-15",0,0,0,0,0,0,0,0
"South Sudan","2024-06-16",0,0,0,0,0,0,0,0
"South Sudan","2024-06-17",0,0,0,0,0,0,0,0
"South Sudan","2024-06-18",0,0,0,0,0,0,0,0
"South Sudan","2024-06-19",0,0,0,0,0,0,0,0
"South Sudan","2024-06-20",0,0,0,0,0,0,0,0
"South Sudan","2024-06-21",0,0,0,0,0,0,0,0
"South Sudan","2024-06-22",0,0,0,0,0,0,0,0
"South Sudan","2024-06-23",0,0,0,0,0,0,0,0
"South Sudan","2024-06-24",0,0,0,0,0,0,0,0
"South Sudan","2024-06-25",0,0,0,0,0,0,0,0
"South Sudan","2024-06-26",0,0,0,0,0,0,0,0
"South Sudan","2024-06-27",0,0,0,0,0,0,0,0
"South Sudan","2024-06-28",0,0,0,0,0,0,0,0
"South Sudan","2024-06-29",0,0,0,0,0,0,0,0
"South Sudan","2024-06-30",0,0,0,0,0,0,0,0
"South Sudan","2024-07-01",0,0,0,0,0,0,0,0
"South Sudan","2024-07-02",0,0,0,0,0,0,0,0
"South Sudan","2024-07-03",0,0,0,0,0,0,0,0
"South Sudan","2024-07-04",0,0,0,0,0,0,0,0
"South Sudan","2024-07-05",0,0,0,0,0,0,0,0
"South Sudan","2024-07-06",0,0,0,0,0,0,0,0
"South Sudan","2024-07-07",0,0,0,0,0,0,0,0
"South Sudan","2024-07-08",0,0,0,0,0,0,0,0
"South Sudan","2024-07-09",0,0,0,0,0,0,0,0
"South Sudan","2024-07-10",0,0,0,0,0,0,0,0
"South Sudan","2024-07-11",0,0,0,0,0,0,0,0
"South Sudan","2024-07-12",0,0,0,0,0,0,0,0
"South Sudan","2024-07-13",0,0,0,0,0,0,0,0
"South Sudan","2024-07-14",0,0,0,0,0,0,0,0
"South Sudan","2024-07-15",0,0,0,0,0,0,0,0
"South Sudan","2024-07-16",0,0,0,0,0,0,0,0
"South Sudan","2024-07-17",0,0,0,0,0,0,0,0
"South Sudan","2024-07-18",0,0,0,0,0,0,0,0
"South Sudan","2024-07-19",0,0,0,0,0,0,0,0
"South Sudan","2024-07-20",0,0,0,0,0,0,0,0
"South Sudan","2024-07-21",0,0,0,0,0,0,0,0
"South Sudan","2024-07-22",0,0,0,0,0,0,0,0
"South Sudan","2024-07-23",0,0,0,0,0,0,0,0
"South Sudan","2024-07-24",0,0,0,0,0,0,0,0
"South Sudan","2024-07-25",0,0,0,0,0,0,0,0
"South Sudan","2024-07-26",0,0,0,0,0,0,0,0
"South Sudan","2024-07-27",0,0,0,0,0,0,0,0
"South Sudan","2024-07-28",0,0,0,0,0,0,0,0
"South Sudan","2024-07-29",0,0,0,0,0,0,0,0
"South Sudan","2024-07-30",0,0,0,0,0,0,0,0
"South Sudan","2024-07-31",0,0,0,0,0,0,0,0
"South Sudan","2024-08-01",0,0,0,0,0,0,0,0
"South Sudan","2024-08-02",0,0,0,0,0,0,0,0
"South Sudan","2024-08-03",0,0,0,0,0,0,0,0
"South Sudan","2024-08-04",0,0,0,0,0,0,0,0
"South Sudan","2024-08-05",0,0,0,0,0,0,0,0
"South Sudan","2024-08-06",0,0,0,0,0,0,0,0
"South Sudan","2024-08-07",0,0,0,0,0,0,0,0
"South Sudan","2024-08-08",0,0,0,0,0,0,0,0
"South Sudan","2024-08-09",0,0,0,0,0,0,0,0
"South Sudan","2024-08-10",0,0,0,0,0,0,0,0
"South Sudan","2024-08-11",0,0,0,0,0,0,0,0
"South Sudan","2024-08-12",0,0,0,0,0,0,0,0
"South Sudan","2024-08-13",0,0,0,0,0,0,0,0
"South Sudan","2024-08-14",0,0,0,0,0,0,0,0
"South Sudan","2024-08-15",0,0,0,0,0,0,0,0
"South Sudan","2024-08-16",0,0,0,0,0,0,0,0
"South Sudan","2024-08-17",0,0,0,0,0,0,0,0
"South Sudan","2024-08-18",0,0,0,0,0,0,0,0
"South Sudan","2024-08-19",0,0,0,0,0,0,0,0
"South Sudan","2024-08-20",0,0,0,0,0,0,0,0
"South Sudan","2024-08-21",0,0,0,0,0,0,0,0
"South Sudan","2024-08-22",0,0,0,0,0,0,0,0
"South Sudan","2024-08-23",0,0,0,0,0,0,0,0
"South Sudan","2024-08-24",0,0,0,0,0,0,0,0
"South Sudan","2024-08-25",0,0,0,0,0,0,0,0
"South Sudan","2024-08-26",0,0,0,0,0,0,0,0
"South Sudan","2024-08-27",0,0,0,0,0,0,0,0
"South Sudan","2024-08-28",0,0,0,0,0,0,0,0
"South Sudan","2024-08-29",0,0,0,0,0,0,0,0
"South Sudan","2024-08-30",0,0,0,0,0,0,0,0
"South Sudan","2024-08-31",0,0,0,0,0,0,0,0
"South Sudan","2024-09-01",0,0,0,0,0,0,0,0
"South Sudan","2024-09-02",0,0,0,0,0,0,0,0
"South Sudan","2024-09-03",0,0,0,0,0,0,0,0
"South Sudan","2024-09-04",0,0,0,0,0,0,0,0
"South Sudan","2024-09-05",0,0,0,0,0,0,0,0
"South Sudan","2024-09-06",0,0,0,0,0,0,0,0
"South Sudan","2024-09-07",0,0,0,0,0,0,0,0
"South Sudan","2024-09-08",0,0,0,0,0,0,0,0
"South Sudan","2024-09-09",0,0,0,0,0,0,0,0
"South Sudan","2024-09-10",0,0,0,0,0,0,0,0
"South Sudan","2024-09-11",0,0,0,0,0,0,0,0
"South Sudan","2024-09-12",0,0,0,0,0,0,0,0
"South Sudan","2024-09-13",0,0,0,0,0,0,0,0
"South Sudan","2024-09-14",0,0,0,0,0,0,0,0
"South Sudan","2024-09-15",0,0,0,0,0,0,0,0
"South Sudan","2024-09-16",0,0,0,0,0,0,0,0
"South Sudan","2024-09-17",0,0,0,0,0,0,0,0
"South Sudan","2024-09-18",0,0,0,0,0,0,0,0
"South Sudan","2024-09-19",0,0,0,0,0,0,0,0
"South Sudan","2024-09-20",0,0,0,0,0,0,0,0
"South Sudan","2024-09-21",0,0,0,0,0,0,0,0
"South Sudan","2024-09-22",0,0,0,0,0,0,0,0
"South Sudan","2024-09-23",0,0,0,0,0,0,0,0
"South Sudan","2024-09-24",0,0,0,0,0,0,0,0
"South Sudan","2024-09-25",0,0,0,0,0,0,0,0
"South Sudan","2024-09-26",0,0,0,0,0,0,0,0
"South Sudan","2024-09-27",0,0,0,0,0,0,0,0
"South Sudan","2024-09-28",0,0,0,0,0,0,0,0
"South Sudan","2024-09-29",0,0,0,0,0,0,0,0
"South Sudan","2024-09-30",0,0,0,0,0,0,0,0
"South Sudan","2024-10-01",0,0,0,0,0,0,0,0
"South Sudan","2024-10-02",0,0,0,0,0,0,0,0
"South Sudan","2024-10-03",0,0,0,0,0,0,0,0
"South Sudan","2024-10-04",0,0,0,0,0,0,0,0
"South Sudan","2024-10-05",0,0,0,0,0,0,0,0
"South Sudan","2024-10-06",0,0,0,0,0,0,0,0
"South Sudan","2024-10-07",0,0,0,0,0,0,0,0
"South Sudan","2024-10-08",0,0,0,0,0,0,0,0
"South Sudan","2024-10-09",0,0,0,0,0,0,0,0
"South Sudan","2024-10-10",0,0,0,0,0,0,0,0
"South Sudan","2024-10-11",0,0,0,0,0,0,0,0
"South Sudan","2024-10-12",0,0,0,0,0,0,0,0
"South Sudan","2024-10-13",0,0,0,0,0,0,0,0
"South Sudan","2024-10-14",0,0,0,0,0,0,0,0
"South Sudan","2024-10-15",0,0,0,0,0,0,0,0
"South Sudan","2024-10-16",0,0,0,0,0,0,0,0
"South Sudan","2024-10-17",0,0,0,0,0,0,0,0
"South Sudan","2024-10-18",0,0,0,0,0,0,0,0
"South Sudan","2024-10-19",0,0,0,0,0,0,0,0
"South Sudan","2024-10-20",0,0,0,0,0,0,0,0
"South Sudan","2024-10-21",0,0,0,0,0,0,0,0
"South Sudan","2024-10-22",0,0,0,0,0,0,0,0
"South Sudan","2024-10-23",0,0,0,0,0,0,0,0
"South Sudan","2024-10-24",0,0,0,0,0,0,0,0
"South Sudan","2024-10-25",0,0,0,0,0,0,0,0
"South Sudan","2024-10-26",0,0,0,0,0,0,0,0
"South Sudan","2024-10-27",0,0,0,0,0,0,0,0
"South Sudan","2024-10-28",0,0,0,0,0,0,0,0
"South Sudan","2024-10-29",0,0,0,0,0,0,0,0
"South Sudan","2024-10-30",0,0,0,0,0,0,0,0
"South Sudan","2024-10-31",0,0,0,0,0,0,0,0
"South Sudan","2024-11-01",0,0,0,0,0,0,0,0
"South Sudan","2024-11-02",0,0,0,0,0,0,0,0
"South Sudan","2024-11-03",0,0,0,0,0,0,0,0
"South Sudan","2024-11-04",0,0,0,0,0,0,0,0
"South Sudan","2024-11-05",0,0,0,0,0,0,0,0
"South Sudan","2024-11-06",0,0,0,0,0,0,0,0
"South Sudan","2024-11-07",0,0,0,0,0,0,0,0
"South Sudan","2024-11-08",0,0,0,0,0,0,0,0
"South Sudan","2024-11-09",0,0,0,0,0,0,0,0
"South Sudan","2024-11-10",0,0,0,0,0,0,0,0
"South Sudan","2024-11-11",0,0,0,0,0,0,0,0
"South Sudan","2024-11-12",0,0,0,0,0,0,0,0
"South Sudan","2024-11-13",0,0,0,0,0,0,0,0
"South Sudan","2024-11-14",0,0,0,0,0,0,0,0
"South Sudan","2024-11-15",0,0,0,0,0,0,0,0
"South Sudan","2024-11-16",0,0,0,0,0,0,0,0
"South Sudan","2024-11-17",0,0,0,0,0,0,0,0
"South Sudan","2024-11-18",0,0,0,0,0,0,0,0
"South Sudan","2024-11-19",0,0,0,0,0,0,0,0
"South Sudan","2024-11-20",0,0,0,0,0,0,0,0
"South Sudan","2024-11-21",0,0,0,0,0,0,0,0
"South Sudan","2024-11-22",0,0,0,0,0,0,0,0
"South Sudan","2024-11-23",0,0,0,0,0,0,0,0
"South Sudan","2024-11-24",0,0,0,0,0,0,0,0
"South Sudan","2024-11-25",0,0,0,0,0,0,0,0
"South Sudan","2024-11-26",0,0,0,0,0,0,0,0
"South Sudan","2024-11-27",0,0,0,0,0,0,0,0
"South Sudan","2024-11-28",0,0,0,0,0,0,0,0
"South Sudan","2024-11-29",0,0,0,0,0,0,0,0
"South Sudan","2024-11-30",0,0,0,0,0,0,0,0
"South Sudan","2024-12-01",0,0,0,0,0,0,0,0
"South Sudan","2024-12-02",0,0,0,0,0,0,0,0
"South Sudan","2024-12-03",0,0,0,0,0,0,0,0
"South Sudan","2024-12-04",0,0,0,0,0,0,0,0
"South Sudan","2024-12-05",0,0,0,0,0,0,0,0
"South Sudan","2024-12-06",0,0,0,0,0,0,0,0
"South Sudan","2024-12-07",0,0,0,0,0,0,0,0
"South Sudan","2024-12-08",0,0,0,0,0,0,0,0
"South Sudan","2024-12-09",0,0,0,0,0,0,0,0
"South Sudan","2024-12-10",0,0,0,0,0,0,0,0
"South Sudan","2024-12-11",0,0,0,0,0,0,0,0
"South Sudan","2024-12-12",0,0,0,0,0,0,0,0
"South Sudan","2024-12-13",0,0,0,0,0,0,0,0
"South Sudan","2024-12-14",0,0,0,0,0,0,0,0
"South Sudan","2024-12-15",0,0,0,0,0,0,0,0
"South Sudan","2024-12-16",0,0,0,0,0,0,0,0
"South Sudan","2024-12-17",0,0,0,0,0,0,0,0
"South Sudan","2024-12-18",0,0,0,0,0,0,0,0
"South Sudan","2024-12-19",0,0,0,0,0,0,0,0
"South Sudan","2024-12-20",0,0,0,0,0,0,0,0
"South Sudan","2024-12-21",0,0,0,0,0,0,0,0
"South Sudan","2024-12-22",0,0,0,0,0,0,0,0
"South Sudan","2024-12-23",0,0,0,0,0,0,0,0
"South Sudan","2024-12-24",0,0,0,0,0,0,0,0
"South Sudan","2024-12-25",0,0,0,0,0,0,0,0
"South Sudan","2024-12-26",0,0,0,0,0,0,0,0
"South Sudan","2024-12-27",0,0,0,0,0,0,0,0
"South Sudan","2024-12-28",0,0,0,0,0,0,0,0
"South Sudan","2024-12-29",0,0,0,0,0,0,0,0
"South Sudan","2024-12-30",0,0,0,0,0,0,0,0
"South Sudan","2024-12-31",0,0,0,0,0,0,0,0
"South Sudan","2025-01-01",0,0,0,0,0,0,0,0
"South Sudan","2025-01-02",0,0,0,0,0,0,0,0
"South Sudan","2025-01-03",0,0,0,0,0,0,0,0
"South Sudan","2025-01-04",0,0,0,0,0,0,0,0
"South Sudan","2025-01-05",0,0,0,0,0,0,0,0
"South Sudan","2025-01-06",0,0,0,0,0,0,0,0
"South Sudan","2025-01-07",0,0,0,0,0,0,0,0
"South Sudan","2025-01-08",0,0,0,0,0,0,0,0
"South Sudan","2025-01-09",0,0,0,0,0,0,0,0
"South Sudan","2025-01-10",0,0,0,0,0,0,0,0
"South Sudan","2025-01-11",0,0,0,0,0,0,0,0
"South Sudan","2025-01-12",0,0,0,0,0,0,0,0
"South Sudan","2025-01-13",0,0,0,0,0,0,0,0
"South Sudan","2025-01-14",0,0,0,0,0,0,0,0
"South Sudan","2025-01-15",0,0,0,0,0,0,0,0
"South Sudan","2025-01-16",0,0,0,0,0,0,0,0
"South Sudan","2025-01-17",0,0,0,0,0,0,0,0
"South Sudan","2025-01-18",0,0,0,0,0,0,0,0
"South Sudan","2025-01-19",0,0,0,0,0,0,0,0
"South Sudan","2025-01-20",0,0,0,0,0,0,0,0
"South Sudan","2025-01-21",0,0,0,0,0,0,0,0
"South Sudan","2025-01-22",0,0,0,0,0,0,0,0
"South Sudan","2025-01-23",0,0,0,0,0,0,0,0
"South Sudan","2025-01-24",0,0,0,0,0,0,0,0
"South Sudan","2025-01-25",0,0,0,0,0,0,0,0
"South Sudan","2025-01-26",0,0,0,0,0,0,0,0
"South Sudan","2025-01-27",0,0,0,0,0,0,0,0
"South Sudan","2025-01-28",0,0,0,0,0,0,0,0
"South Sudan","2025-01-29",0,0,0,0,0,0,0,0
"South Sudan","2025-01-30",0,0,0,0,0,0,0,0
"South Sudan","2025-01-31",0,0,0,0,0,0,0,0
"South Sudan","2025-02-01",0,0,0,0,0,0,0,0
"South Sudan","2025-02-02",0,0,0,0,0,0,0,0
"South Sudan","2025-02-03",0,0,0,0,0,0,0,0
"South Sudan","2025-02-04",0,0,0,0,0,0,0,0
"South Sudan","2025-02-05",0,0,0,0,0,0,0,0
"South Sudan","2025-02-06",0,0,0,0,0,0,0,0
"South Sudan","2025-02-07",0,0,0,0,0,0,0,0
"South Sudan","2025-02-08",0,0,0,0,0,0,0,0
"South Sudan","2025-02-09",0,1,1,0,1,1,0,0
"South Sudan","2025-02-10",0,0,1,0,0,1,0,0
"South Sudan","2025-02-11",0,0,1,0,1,2,0,0
"South Sudan","2025-02-12",0,0,1,0,0,2,0,0
"South Sudan","2025-02-13",0,0,1,0,0,2,0,0
"South Sudan","2025-02-14",0,0,1,0,0,2,0,0
"South Sudan","2025-02-15",0,0,1,0,1,3,0,0
"South Sudan","2025-02-16",0,2,3,0,0,3,0,0
"South Sudan","2025-02-17",0,0,3,0,0,3,0,0
"South Sudan","2025-02-18",0,0,3,0,0,3,0,0
"South Sudan","2025-02-19",0,0,3,0,0,3,0,0
"South Sudan","2025-02-20",0,0,3,0,0,3,0,0
"South Sudan","2025-02-21",0,0,3,0,0,3,0,0
"South Sudan","2025-02-22",0,0,3,0,0,3,0,0
"South Sudan","2025-02-23",0,0,3,0,0,3,0,0
"South Sudan","2025-02-24",0,0,3,0,0,3,0,0
"South Sudan","2025-02-25",0,0,3,0,0,3,0,0
"South Sudan","2025-02-26",0,0,3,0,0,3,0,0
"South Sudan","2025-02-27",0,0,3,0,0,3,0,0
"South Sudan","2025-02-28",0,0,3,0,0,3,0,0
"South Sudan","2025-03-01",0,0,3,0,0,3,0,0
"South Sudan","2025-03-02",0,0,3,0,0,3,0,0
"South Sudan","2025-03-03",0,0,3,0,0,3,0,0
"Spain","2024-01-01",0,0,0,0,0,0,0,0
"Spain","2024-01-02",0,0,0,0,0,0,0,0
"Spain","2024-01-03",0,0,0,0,0,0,0,0
"Spain","2024-01-04",0,0,0,0,0,0,0,0
"Spain","2024-01-05",0,0,0,0,0,0,0,0
"Spain","2024-01-06",0,0,0,0,0,0,0,0
"Spain","2024-01-07",0,0,0,0,0,0,0,0
"Spain","2024-01-08",0,0,0,0,0,0,0,0
"Spain","2024-01-09",0,0,0,0,0,0,0,0
"Spain","2024-01-10",0,0,0,0,0,0,0,0
"Spain","2024-01-11",0,0,0,0,0,0,0,0
"Spain","2024-01-12",0,0,0,0,0,0,0,0
"Spain","2024-01-13",0,0,0,0,0,0,0,0
"Spain","2024-01-14",0,0,0,0,0,0,0,0
"Spain","2024-01-15",0,0,0,0,0,0,0,0
"Spain","2024-01-16",0,0,0,0,0,0,0,0
"Spain","2024-01-17",0,0,0,0,0,0,0,0
"Spain","2024-01-18",0,0,0,0,0,0,0,0
"Spain","2024-01-19",0,0,0,0,0,0,0,0
"Spain","2024-01-20",0,0,0,0,0,0,0,0
"Spain","2024-01-21",0,0,0,0,0,0,0,0
"Spain","2024-01-22",0,0,0,0,0,0,0,0
"Spain","2024-01-23",0,0,0,0,0,0,0,0
"Spain","2024-01-24",0,0,0,0,0,0,0,0
"Spain","2024-01-25",0,0,0,0,0,0,0,0
"Spain","2024-01-26",0,0,0,0,0,0,0,0
"Spain","2024-01-27",0,0,0,0,0,0,0,0
"Spain","2024-01-28",0,0,0,0,0,0,0,0
"Spain","2024-01-29",0,0,0,0,0,0,0,0
"Spain","2024-01-30",0,0,0,0,0,0,0,0
"Spain","2024-01-31",0,34,34,0,34,34,0,0
"Spain","2024-02-01",0,0,34,0,4,38,0,0
"Spain","2024-02-02",0,0,34,0,4,42,0,0
"Spain","2024-02-03",0,0,34,0,4,46,0,0
"Spain","2024-02-04",0,0,34,0,3,49,0,0
"Spain","2024-02-05",0,0,34,0,4,53,0,0
"Spain","2024-02-06",0,0,34,0,4,57,0,0
"Spain","2024-02-07",0,0,34,0,4,61,0,0
"Spain","2024-02-08",0,0,34,0,4,65,0,0
"Spain","2024-02-09",0,0,34,0,4,69,0,0
"Spain","2024-02-10",0,0,34,0,4,73,0,0
"Spain","2024-02-11",0,0,34,0,3,76,0,0
"Spain","2024-02-12",0,0,34,0,4,80,0,0
"Spain","2024-02-13",0,0,34,0,4,84,0,0
"Spain","2024-02-14",0,0,34,0,4,88,0,0
"Spain","2024-02-15",0,0,34,0,4,92,0,0
"Spain","2024-02-16",0,0,34,0,4,96,0,0
"Spain","2024-02-17",0,0,34,0,4,100,0,0
"Spain","2024-02-18",0,0,34,0,4,104,0,0
"Spain","2024-02-19",0,0,34,0,3,107,0,0
"Spain","2024-02-20",0,0,34,0,4,111,0,0
"Spain","2024-02-21",0,0,34,0,4,115,0,0
"Spain","2024-02-22",0,0,34,0,4,119,0,0
"Spain","2024-02-23",0,0,34,0,4,123,0,0
"Spain","2024-02-24",0,0,34,0,4,127,0,0
"Spain","2024-02-25",0,0,34,0,4,131,0,0
"Spain","2024-02-26",0,0,34,0,3,134,0,0
"Spain","2024-02-27",0,0,34,0,4,138,0,0
"Spain","2024-02-28",0,0,34,0,4,142,0,0
"Spain","2024-02-29",0,112,146,0,4,146,0,0
"Spain","2024-03-01",0,0,146,0,2,148,0,0
"Spain","2024-03-02",0,0,146,0,2,150,0,0
"Spain","2024-03-03",0,0,146,0,2,152,0,0
"Spain","2024-03-04",0,0,146,0,2,154,0,0
"Spain","2024-03-05",0,0,146,0,2,156,0,0
"Spain","2024-03-06",0,0,146,0,2,158,0,0
"Spain","2024-03-07",0,0,146,0,2,160,0,0
"Spain","2024-03-08",0,0,146,0,2,162,0,0
"Spain","2024-03-09",0,0,146,0,2,164,0,0
"Spain","2024-03-10",0,0,146,0,2,166,0,0
"Spain","2024-03-11",0,0,146,0,2,168,0,0
"Spain","2024-03-12",0,0,146,0,2,170,0,0
"Spain","2024-03-13",0,0,146,0,2,172,0,0
"Spain","2024-03-14",0,0,146,0,2,174,0,0
"Spain","2024-03-15",0,0,146,0,2,176,0,0
"Spain","2024-03-16",0,0,146,0,2,178,0,0
"Spain","2024-03-17",0,0,146,0,2,180,0,0
"Spain","2024-03-18",0,0,146,0,2,182,0,0
"Spain","2024-03-19",0,0,146,0,2,184,0,0
"Spain","2024-03-20",0,0,146,0,2,186,0,0
"Spain","2024-03-21",0,0,146,0,2,188,0,0
"Spain","2024-03-22",0,0,146,0,2,190,0,0
"Spain","2024-03-23",0,0,146,0,2,192,0,0
"Spain","2024-03-24",0,0,146,0,2,194,0,0
"Spain","2024-03-25",0,0,146,0,2,196,0,0
"Spain","2024-03-26",0,0,146,0,2,198,0,0
"Spain","2024-03-27",0,0,146,0,2,200,0,0
"Spain","2024-03-28",0,0,146,0,2,202,0,0
"Spain","2024-03-29",0,0,146,0,2,204,0,0
"Spain","2024-03-30",0,0,146,0,2,206,0,0
"Spain","2024-03-31",0,62,208,0,2,208,0,0
"Spain","2024-04-01",0,0,208,0,1,209,0,0
"Spain","2024-04-02",0,0,208,0,1,210,0,0
"Spain","2024-04-03",0,0,208,0,1,211,0,0
"Spain","2024-04-04",0,0,208,0,1,212,0,0
"Spain","2024-04-05",0,0,208,0,1,213,0,0
"Spain","2024-04-06",0,0,208,0,1,214,0,0
"Spain","2024-04-07",0,0,208,0,1,215,0,0
"Spain","2024-04-08",0,0,208,0,2,217,0,0
"Spain","2024-04-09",0,0,208,0,1,218,0,0
"Spain","2024-04-10",0,0,208,0,1,219,0,0
"Spain","2024-04-11",0,0,208,0,1,220,0,0
"Spain","2024-04-12",0,0,208,0,1,221,0,0
"Spain","2024-04-13",0,0,208,0,1,222,0,0
"Spain","2024-04-14",0,0,208,0,1,223,0,0
"Spain","2024-04-15",0,0,208,0,1,224,0,0
"Spain","2024-04-16",0,0,208,0,1,225,0,0
"Spain","2024-04-17",0,0,208,0,1,226,0,0
"Spain","2024-04-18",0,0,208,0,1,227,0,0
"Spain","2024-04-19",0,0,208,0,1,228,0,0
"Spain","2024-04-20",0,0,208,0,1,229,0,0
"Spain","2024-04-21",0,0,208,0,1,230,0,0
"Spain","2024-04-22",0,0,208,0,1,231,0,0
"Spain","2024-04-23",0,0,208,0,2,233,0,0
"Spain","2024-04-24",0,0,208,0,1,234,0,0
"Spain","2024-04-25",0,0,208,0,1,235,0,0
"Spain","2024-04-26",0,0,208,0,1,236,0,0
"Spain","2024-04-27",0,0,208,0,1,237,0,0
"Spain","2024-04-28",0,0,208,0,1,238,0,0
"Spain","2024-04-29",0,0,208,0,1,239,0,0
"Spain","2024-04-30",0,32,240,0,1,240,0,0
"Spain","2024-05-01",0,0,240,0,1,241,0,0
"Spain","2024-05-02",0,0,240,0,1,242,0,0
"Spain","2024-05-03",0,0,240,0,2,244,0,0
"Spain","2024-05-04",0,0,240,0,1,245,0,0
"Spain","2024-05-05",0,0,240,0,1,246,0,0
"Spain","2024-05-06",0,0,240,0,1,247,0,0
"Spain","2024-05-07",0,0,240,0,2,249,0,0
"Spain","2024-05-08",0,0,240,0,1,250,0,0
"Spain","2024-05-09",0,0,240,0,1,251,0,0
"Spain","2024-05-10",0,0,240,0,1,252,0,0
"Spain","2024-05-11",0,0,240,0,1,253,0,0
"Spain","2024-05-12",0,0,240,0,2,255,0,0
"Spain","2024-05-13",0,0,240,0,1,256,0,0
"Spain","2024-05-14",0,0,240,0,1,257,0,0
"Spain","2024-05-15",0,0,240,0,1,258,0,0
"Spain","2024-05-16",0,0,240,0,2,260,0,0
"Spain","2024-05-17",0,0,240,0,1,261,0,0
"Spain","2024-05-18",0,0,240,0,1,262,0,0
"Spain","2024-05-19",0,0,240,0,1,263,0,0
"Spain","2024-05-20",0,0,240,0,2,265,0,0
"Spain","2024-05-21",0,0,240,0,1,266,0,0
"Spain","2024-05-22",0,0,240,0,1,267,0,0
"Spain","2024-05-23",0,0,240,0,1,268,0,0
"Spain","2024-05-24",0,0,240,0,1,269,0,0
"Spain","2024-05-25",0,0,240,0,2,271,0,0
"Spain","2024-05-26",0,0,240,0,1,272,0,0
"Spain","2024-05-27",0,0,240,0,1,273,0,0
"Spain","2024-05-28",0,0,240,0,1,274,0,0
"Spain","2024-05-29",0,0,240,0,2,276,0,0
"Spain","2024-05-30",0,0,240,0,1,277,0,0
"Spain","2024-05-31",0,38,278,0,1,278,0,0
"Spain","2024-06-01",0,0,278,0,2,280,0,0
"Spain","2024-06-02",0,0,278,0,2,282,0,0
"Spain","2024-06-03",0,0,278,0,1,283,0,0
"Spain","2024-06-04",0,0,278,0,2,285,0,0
"Spain","2024-06-05",0,0,278,0,2,287,0,0
"Spain","2024-06-06",0,0,278,0,2,289,0,0
"Spain","2024-06-07",0,0,278,0,2,291,0,0
"Spain","2024-06-08",0,0,278,0,1,292,0,0
"Spain","2024-06-09",0,0,278,0,2,294,0,0
"Spain","2024-06-10",0,0,278,0,2,296,0,0
"Spain","2024-06-11",0,0,278,0,2,298,0,0
"Spain","2024-06-12",0,0,278,0,2,300,0,0
"Spain","2024-06-13",0,0,278,0,1,301,0,0
"Spain","2024-06-14",0,0,278,0,2,303,0,0
"Spain","2024-06-15",0,0,278,0,2,305,0,0
"Spain","2024-06-16",0,0,278,0,2,307,0,0
"Spain","2024-06-17",0,0,278,0,2,309,0,0
"Spain","2024-06-18",0,0,278,0,1,310,0,0
"Spain","2024-06-19",0,0,278,0,2,312,0,0
"Spain","2024-06-20",0,0,278,0,2,314,0,0
"Spain","2024-06-21",0,0,278,0,2,316,0,0
"Spain","2024-06-22",0,0,278,0,2,318,0,0
"Spain","2024-06-23",0,0,278,0,1,319,0,0
"Spain","2024-06-24",0,0,278,0,2,321,0,0
"Spain","2024-06-25",0,0,278,0,2,323,0,0
"Spain","2024-06-26",0,0,278,0,2,325,0,0
"Spain","2024-06-27",0,0,278,0,2,327,0,0
"Spain","2024-06-28",0,0,278,0,1,328,0,0
"Spain","2024-06-29",0,0,278,0,2,330,0,0
"Spain","2024-06-30",0,54,332,0,2,332,0,0
"Spain","2024-07-01",0,0,332,0,1,333,0,0
"Spain","2024-07-02",0,0,332,0,0,333,0,0
"Spain","2024-07-03",0,0,332,0,1,334,0,0
"Spain","2024-07-04",0,0,332,0,1,335,0,0
"Spain","2024-07-05",0,0,332,0,0,335,0,0
"Spain","2024-07-06",0,0,332,0,1,336,0,0
"Spain","2024-07-07",0,0,332,0,1,337,0,0
"Spain","2024-07-08",0,0,332,0,0,337,0,0
"Spain","2024-07-09",0,0,332,0,1,338,0,0
"Spain","2024-07-10",0,0,332,0,0,338,0,0
"Spain","2024-07-11",0,0,332,0,1,339,0,0
"Spain","2024-07-12",0,0,332,0,1,340,0,0
"Spain","2024-07-13",0,0,332,0,0,340,0,0
"Spain","2024-07-14",0,0,332,0,1,341,0,0
"Spain","2024-07-15",0,0,332,0,1,342,0,0
"Spain","2024-07-16",0,0,332,0,0,342,0,0
"Spain","2024-07-17",0,0,332,0,1,343,0,0
"Spain","2024-07-18",0,0,332,0,1,344,0,0
"Spain","2024-07-19",0,0,332,0,0,344,0,0
"Spain","2024-07-20",0,0,332,0,1,345,0,0
"Spain","2024-07-21",0,0,332,0,1,346,0,0
"Spain","2024-07-22",0,0,332,0,0,346,0,0
"Spain","2024-07-23",0,0,332,0,1,347,0,0
"Spain","2024-07-24",0,0,332,0,0,347,0,0
"Spain","2024-07-25",0,0,332,0,1,348,0,0
"Spain","2024-07-26",0,0,332,0,1,349,0,0
"Spain","2024-07-27",0,0,332,0,0,349,0,0
"Spain","2024-07-28",0,0,332,0,1,350,0,0
"Spain","2024-07-29",0,0,332,0,1,351,0,0
"Spain","2024-07-30",0,0,332,0,0,351,0,0
"Spain","2024-07-31",0,20,352,0,1,352,0,0
"Spain","2024-08-01",0,0,352,0,4,356,0,0
"Spain","2024-08-02",0,0,352,0,5,361,0,0
"Spain","2024-08-03",0,0,352,0,4,365,0,0
"Spain","2024-08-04",0,0,352,0,5,370,0,0
"Spain","2024-08-05",0,0,352,0,4,374,0,0
"Spain","2024-08-06",0,0,352,0,4,378,0,0
"Spain","2024-08-07",0,0,352,0,5,383,0,0
"Spain","2024-08-08",0,0,352,0,4,387,0,0
"Spain","2024-08-09",0,0,352,0,4,391,0,0
"Spain","2024-08-10",0,0,352,0,5,396,0,0
"Spain","2024-08-11",0,0,352,0,4,400,0,0
"Spain","2024-08-12",0,0,352,0,5,405,0,0
"Spain","2024-08-13",0,0,352,0,4,409,0,0
"Spain","2024-08-14",0,0,352,0,4,413,0,0
"Spain","2024-08-15",0,0,352,0,5,418,0,0
"Spain","2024-08-16",0,0,352,0,4,422,0,0
"Spain","2024-08-17",0,0,352,0,5,427,0,0
"Spain","2024-08-18",0,0,352,0,4,431,0,0
"Spain","2024-08-19",0,0,352,0,4,435,0,0
"Spain","2024-08-20",0,0,352,0,5,440,0,0
"Spain","2024-08-21",0,0,352,0,4,444,0,0
"Spain","2024-08-22",0,0,352,0,5,449,0,0
"Spain","2024-08-23",0,0,352,0,4,453,0,0
"Spain","2024-08-24",0,0,352,0,4,457,0,0
"Spain","2024-08-25",0,0,352,0,5,462,0,0
"Spain","2024-08-26",0,0,352,0,4,466,0,0
"Spain","2024-08-27",0,0,352,0,4,470,0,0
"Spain","2024-08-28",0,0,352,0,5,475,0,0
"Spain","2024-08-29",0,0,352,0,4,479,0,0
"Spain","2024-08-30",0,0,352,0,5,484,0,0
"Spain","2024-08-31",0,136,488,0,4,488,0,0
"Spain","2024-09-01",0,0,488,0,1,489,0,0
"Spain","2024-09-02",0,0,488,0,2,491,0,0
"Spain","2024-09-03",0,0,488,0,1,492,0,0
"Spain","2024-09-04",0,0,488,0,2,494,0,0
"Spain","2024-09-05",0,0,488,0,1,495,0,0
"Spain","2024-09-06",0,0,488,0,1,496,0,0
"Spain","2024-09-07",0,0,488,0,2,498,0,0
"Spain","2024-09-08",0,0,488,0,1,499,0,0
"Spain","2024-09-09",0,0,488,0,2,501,0,0
"Spain","2024-09-10",0,0,488,0,1,502,0,0
"Spain","2024-09-11",0,0,488,0,1,503,0,0
"Spain","2024-09-12",0,0,488,0,2,505,0,0
"Spain","2024-09-13",0,0,488,0,1,506,0,0
"Spain","2024-09-14",0,0,488,0,2,508,0,0
"Spain","2024-09-15",0,0,488,0,1,509,0,0
"Spain","2024-09-16",0,0,488,0,1,510,0,0
"Spain","2024-09-17",0,0,488,0,2,512,0,0
"Spain","2024-09-18",0,0,488,0,1,513,0,0
"Spain","2024-09-19",0,0,488,0,2,515,0,0
"Spain","2024-09-20",0,0,488,0,1,516,0,0
"Spain","2024-09-21",0,0,488,0,1,517,0,0
"Spain","2024-09-22",0,0,488,0,2,519,0,0
"Spain","2024-09-23",0,0,488,0,1,520,0,0
"Spain","2024-09-24",0,0,488,0,2,522,0,0
"Spain","2024-09-25",0,0,488,0,1,523,0,0
"Spain","2024-09-26",0,0,488,0,1,524,0,0
"Spain","2024-09-27",0,0,488,0,2,526,0,0
"Spain","2024-09-28",0,0,488,0,1,527,0,0
"Spain","2024-09-29",0,0,488,0,2,529,0,0
"Spain","2024-09-30",0,42,530,0,1,530,0,0
"Spain","2024-10-01",0,0,530,0,2,532,0,0
"Spain","2024-10-02",0,0,530,0,2,534,0,0
"Spain","2024-10-03",0,0,530,0,2,536,0,0
"Spain","2024-10-04",0,0,530,0,2,538,0,0
"Spain","2024-10-05",0,0,530,0,2,540,0,0
"Spain","2024-10-06",0,0,530,0,2,542,0,0
"Spain","2024-10-07",0,0,530,0,2,544,0,0
"Spain","2024-10-08",0,0,530,0,3,547,0,0
"Spain","2024-10-09",0,0,530,0,2,549,0,0
"Spain","2024-10-10",0,0,530,0,2,551,0,0
"Spain","2024-10-11",0,0,530,0,2,553,0,0
"Spain","2024-10-12",0,0,530,0,2,555,0,0
"Spain","2024-10-13",0,0,530,0,2,557,0,0
"Spain","2024-10-14",0,0,530,0,2,559,0,0
"Spain","2024-10-15",0,0,530,0,2,561,0,0
"Spain","2024-10-16",0,0,530,0,2,563,0,0
"Spain","2024-10-17",0,0,530,0,2,565,0,0
"Spain","2024-10-18",0,0,530,0,2,567,0,0
"Spain","2024-10-19",0,0,530,0,2,569,0,0
"Spain","2024-10-20",0,0,530,0,2,571,0,0
"Spain","2024-10-21",0,0,530,0,2,573,0,0
"Spain","2024-10-22",0,0,530,0,2,575,0,0
"Spain","2024-10-23",0,0,530,0,2,577,0,0
"Spain","2024-10-24",0,0,530,0,3,580,0,0
"Spain","2024-10-25",0,0,530,0,2,582,0,0
"Spain","2024-10-26",0,0,530,0,2,584,0,0
"Spain","2024-10-27",0,0,530,0,2,586,0,0
"Spain","2024-10-28",0,0,530,0,2,588,0,0
"Spain","2024-10-29",0,0,530,0,2,590,0,0
"Spain","2024-10-30",0,0,530,0,2,592,0,0
"Spain","2024-10-31",0,64,594,0,2,594,0,0
"Spain","2024-11-01",0,0,594,0,3,597,0,0
"Spain","2024-11-02",0,0,594,0,3,600,0,0
"Spain","2024-11-03",0,0,594,0,4,604,0,0
"Spain","2024-11-04",0,0,594,0,3,607,0,0
"Spain","2024-11-05",0,0,594,0,3,610,0,0
"Spain","2024-11-06",0,0,594,0,3,613,0,0
"Spain","2024-11-07",0,0,594,0,4,617,0,0
"Spain","2024-11-08",0,0,594,0,3,620,0,0
"Spain","2024-11-09",0,0,594,0,3,623,0,0
"Spain","2024-11-10",0,0,594,0,3,626,0,0
"Spain","2024-11-11",0,0,594,0,4,630,0,0
"Spain","2024-11-12",0,0,594,0,3,633,0,0
"Spain","2024-11-13",0,0,594,0,3,636,0,0
"Spain","2024-11-14",0,0,594,0,3,639,0,0
"Spain","2024-11-15",0,0,594,0,3,642,0,0
"Spain","2024-11-16",0,0,594,0,4,646,0,0
"Spain","2024-11-17",0,0,594,0,3,649,0,0
"Spain","2024-11-18",0,0,594,0,3,652,0,0
"Spain","2024-11-19",0,0,594,0,3,655,0,0
"Spain","2024-11-20",0,0,594,0,4,659,0,0
"Spain","2024-11-21",0,0,594,0,3,662,0,0
"Spain","2024-11-22",0,0,594,0,3,665,0,0
"Spain","2024-11-23",0,0,594,0,3,668,0,0
"Spain","2024-11-24",0,0,594,0,4,672,0,0
"Spain","2024-11-25",0,0,594,0,3,675,0,0
"Spain","2024-11-26",0,0,594,0,3,678,0,0
"Spain","2024-11-27",0,0,594,0,3,681,0,0
"Spain","2024-11-28",0,0,594,0,4,685,0,0
"Spain","2024-11-29",0,0,594,0,3,688,0,0
"Spain","2024-11-30",0,97,691,0,3,691,0,0
"Spain","2024-12-01",0,0,691,0,1,692,0,0
"Spain","2024-12-02",0,0,691,0,1,693,0,0
"Spain","2024-12-03",0,0,691,0,2,695,0,0
"Spain","2024-12-04",0,0,691,0,1,696,0,0
"Spain","2024-12-05",0,0,691,0,1,697,0,0
"Spain","2024-12-06",0,0,691,0,1,698,0,0
"Spain","2024-12-07",0,0,691,0,2,700,0,0
"Spain","2024-12-08",0,0,691,0,1,701,0,0
"Spain","2024-12-09",0,0,691,0,1,702,0,0
"Spain","2024-12-10",0,0,691,0,1,703,0,0
"Spain","2024-12-11",0,0,691,0,1,704,0,0
"Spain","2024-12-12",0,0,691,0,2,706,0,0
"Spain","2024-12-13",0,0,691,0,1,707,0,0
"Spain","2024-12-14",0,0,691,0,1,708,0,0
"Spain","2024-12-15",0,0,691,0,1,709,0,0
"Spain","2024-12-16",0,0,691,0,2,711,0,0
"Spain","2024-12-17",0,0,691,0,1,712,0,0
"Spain","2024-12-18",0,0,691,0,1,713,0,0
"Spain","2024-12-19",0,0,691,0,1,714,0,0
"Spain","2024-12-20",0,0,691,0,2,716,0,0
"Spain","2024-12-21",0,0,691,0,1,717,0,0
"Spain","2024-12-22",0,0,691,0,1,718,0,0
"Spain","2024-12-23",0,0,691,0,1,719,0,0
"Spain","2024-12-24",0,0,691,0,1,720,0,0
"Spain","2024-12-25",0,0,691,0,2,722,0,0
"Spain","2024-12-26",0,0,691,0,1,723,0,0
"Spain","2024-12-27",0,0,691,0,1,724,0,0
"Spain","2024-12-28",0,0,691,0,1,725,0,0
"Spain","2024-12-29",0,0,691,0,2,727,0,0
"Spain","2024-12-30",0,0,691,0,1,728,0,0
"Spain","2024-12-31",0,38,729,0,1,729,0,0
"Spain","2025-01-01",0,0,729,0,3,732,0,0
"Spain","2025-01-02",0,0,729,0,4,736,0,0
"Spain","2025-01-03",0,0,729,0,3,739,0,0
"Spain","2025-01-04",0,0,729,0,3,742,0,0
"Spain","2025-01-05",0,0,729,0,3,745,0,0
"Spain","2025-01-06",0,0,729,0,4,749,0,0
"Spain","2025-01-07",0,0,729,0,3,752,0,0
"Spain","2025-01-08",0,0,729,0,3,755,0,0
"Spain","2025-01-09",0,0,729,0,4,759,0,0
"Spain","2025-01-10",0,33,762,0,3,762,0,0
"Spain","2025-01-11",0,0,762,0,0,762,0,0
"Spain","2025-01-12",0,0,762,0,0,762,0,0
"Spain","2025-01-13",0,0,762,0,0,762,0,0
"Spain","2025-01-14",0,0,762,0,0,762,0,0
"Spain","2025-01-15",0,0,762,0,0,762,0,0
"Spain","2025-01-16",0,0,762,0,0,762,0,0
"Spain","2025-01-17",0,0,762,0,0,762,0,0
"Spain","2025-01-18",0,0,762,0,0,762,0,0
"Spain","2025-01-19",0,0,762,0,0,762,0,0
"Spain","2025-01-20",0,0,762,0,0,762,0,0
"Spain","2025-01-21",0,0,762,0,0,762,0,0
"Spain","2025-01-22",0,0,762,0,0,762,0,0
"Spain","2025-01-23",0,0,762,0,0,762,0,0
"Spain","2025-01-24",0,0,762,0,0,762,0,0
"Spain","2025-01-25",0,0,762,0,0,762,0,0
"Spain","2025-01-26",0,0,762,0,0,762,0,0
"Spain","2025-01-27",0,0,762,0,0,762,0,0
"Spain","2025-01-28",0,0,762,0,0,762,0,0
"Spain","2025-01-29",0,0,762,0,0,762,0,0
"Spain","2025-01-30",0,0,762,0,0,762,0,0
"Spain","2025-01-31",0,0,762,0,0,762,0,0
"Spain","2025-02-01",0,0,762,0,0,762,0,0
"Spain","2025-02-02",0,0,762,0,0,762,0,0
"Spain","2025-02-03",0,0,762,0,0,762,0,0
"Spain","2025-02-04",0,0,762,0,0,762,0,0
"Spain","2025-02-05",0,0,762,0,0,762,0,0
"Spain","2025-02-06",0,0,762,0,0,762,0,0
"Spain","2025-02-07",0,0,762,0,0,762,0,0
"Spain","2025-02-08",0,0,762,0,0,762,0,0
"Spain","2025-02-09",0,0,762,0,0,762,0,0
"Spain","2025-02-10",0,0,762,0,0,762,0,0
"Spain","2025-02-11",0,0,762,0,0,762,0,0
"Spain","2025-02-12",0,0,762,0,0,762,0,0
"Spain","2025-02-13",0,0,762,0,0,762,0,0
"Spain","2025-02-14",0,0,762,0,0,762,0,0
"Spain","2025-02-15",0,0,762,0,0,762,0,0
"Spain","2025-02-16",0,0,762,0,0,762,0,0
"Spain","2025-02-17",0,0,762,0,0,762,0,0
"Spain","2025-02-18",0,0,762,0,0,762,0,0
"Spain","2025-02-19",0,0,762,0,0,762,0,0
"Spain","2025-02-20",0,0,762,0,0,762,0,0
"Spain","2025-02-21",0,0,762,0,0,762,0,0
"Spain","2025-02-22",0,0,762,0,0,762,0,0
"Spain","2025-02-23",0,0,762,0,0,762,0,0
"Spain","2025-02-24",0,0,762,0,0,762,0,0
"Spain","2025-02-25",0,0,762,0,0,762,0,0
"Spain","2025-02-26",0,0,762,0,0,762,0,0
"Spain","2025-02-27",0,0,762,0,0,762,0,0
"Spain","2025-02-28",0,0,762,0,0,762,0,0
"Spain","2025-03-01",0,0,762,0,0,762,0,0
"Spain","2025-03-02",0,0,762,0,0,762,0,0
"Spain","2025-03-03",0,0,762,0,0,762,0,0
"Sri Lanka","2024-01-01",0,0,0,0,0,0,0,0
"Sri Lanka","2024-01-02",0,0,0,0,0,0,0,0
"Sri Lanka","2024-01-03",0,0,0,0,0,0,0,0
"Sri Lanka","2024-01-04",0,0,0,0,0,0,0,0
"Sri Lanka","2024-01-05",0,0,0,0,0,0,0,0
"Sri Lanka","2024-01-06",0,0,0,0,0,0,0,0
"Sri Lanka","2024-01-07",0,0,0,0,0,0,0,0
"Sri Lanka","2024-01-08",0,0,0,0,0,0,0,0
"Sri Lanka","2024-01-09",0,0,0,0,0,0,0,0
"Sri Lanka","2024-01-10",0,0,0,0,0,0,0,0
"Sri Lanka","2024-01-11",0,0,0,0,0,0,0,0
"Sri Lanka","2024-01-12",0,0,0,0,0,0,0,0
"Sri Lanka","2024-01-13",0,0,0,0,0,0,0,0
"Sri Lanka","2024-01-14",0,0,0,0,0,0,0,0
"Sri Lanka","2024-01-15",0,0,0,0,0,0,0,0
"Sri Lanka","2024-01-16",0,0,0,0,0,0,0,0
"Sri Lanka","2024-01-17",0,0,0,0,0,0,0,0
"Sri Lanka","2024-01-18",0,0,0,0,0,0,0,0
"Sri Lanka","2024-01-19",0,0,0,0,0,0,0,0
"Sri Lanka","2024-01-20",0,0,0,0,0,0,0,0
"Sri Lanka","2024-01-21",0,0,0,0,0,0,0,0
"Sri Lanka","2024-01-22",0,0,0,0,0,0,0,0
"Sri Lanka","2024-01-23",0,0,0,0,0,0,0,0
"Sri Lanka","2024-01-24",0,0,0,0,0,0,0,0
"Sri Lanka","2024-01-25",0,0,0,0,0,0,0,0
"Sri Lanka","2024-01-26",0,0,0,0,0,0,0,0
"Sri Lanka","2024-01-27",0,0,0,0,0,0,0,0
"Sri Lanka","2024-01-28",0,0,0,0,0,0,0,0
"Sri Lanka","2024-01-29",0,0,0,0,0,0,0,0
"Sri Lanka","2024-01-30",0,0,0,0,0,0,0,0
"Sri Lanka","2024-01-31",0,0,0,0,0,0,0,0
"Sri Lanka","2024-02-01",0,0,0,0,0,0,0,0
"Sri Lanka","2024-02-02",0,0,0,0,0,0,0,0
"Sri Lanka","2024-02-03",0,0,0,0,0,0,0,0
"Sri Lanka","2024-02-04",0,0,0,0,0,0,0,0
"Sri Lanka","2024-02-05",0,0,0,0,0,0,0,0
"Sri Lanka","2024-02-06",0,0,0,0,0,0,0,0
"Sri Lanka","2024-02-07",0,0,0,0,0,0,0,0
"Sri Lanka","2024-02-08",0,0,0,0,0,0,0,0
"Sri Lanka","2024-02-09",0,0,0,0,0,0,0,0
"Sri Lanka","2024-02-10",0,0,0,0,0,0,0,0
"Sri Lanka","2024-02-11",0,0,0,0,0,0,0,0
"Sri Lanka","2024-02-12",0,0,0,0,0,0,0,0
"Sri Lanka","2024-02-13",0,0,0,0,0,0,0,0
"Sri Lanka","2024-02-14",0,0,0,0,0,0,0,0
"Sri Lanka","2024-02-15",0,0,0,0,0,0,0,0
"Sri Lanka","2024-02-16",0,0,0,0,0,0,0,0
"Sri Lanka","2024-02-17",0,0,0,0,0,0,0,0
"Sri Lanka","2024-02-18",0,0,0,0,0,0,0,0
"Sri Lanka","2024-02-19",0,0,0,0,0,0,0,0
"Sri Lanka","2024-02-20",0,0,0,0,0,0,0,0
"Sri Lanka","2024-02-21",0,0,0,0,0,0,0,0
"Sri Lanka","2024-02-22",0,0,0,0,0,0,0,0
"Sri Lanka","2024-02-23",0,0,0,0,0,0,0,0
"Sri Lanka","2024-02-24",0,0,0,0,0,0,0,0
"Sri Lanka","2024-02-25",0,0,0,0,0,0,0,0
"Sri Lanka","2024-02-26",0,0,0,0,0,0,0,0
"Sri Lanka","2024-02-27",0,0,0,0,0,0,0,0
"Sri Lanka","2024-02-28",0,0,0,0,0,0,0,0
"Sri Lanka","2024-02-29",0,0,0,0,0,0,0,0
"Sri Lanka","2024-03-01",0,0,0,0,0,0,0,0
"Sri Lanka","2024-03-02",0,0,0,0,0,0,0,0
"Sri Lanka","2024-03-03",0,0,0,0,0,0,0,0
"Sri Lanka","2024-03-04",0,0,0,0,0,0,0,0
"Sri Lanka","2024-03-05",0,0,0,0,0,0,0,0
"Sri Lanka","2024-03-06",0,0,0,0,0,0,0,0
"Sri Lanka","2024-03-07",0,0,0,0,0,0,0,0
"Sri Lanka","2024-03-08",0,0,0,0,0,0,0,0
"Sri Lanka","2024-03-09",0,0,0,0,0,0,0,0
"Sri Lanka","2024-03-10",0,0,0,0,0,0,0,0
"Sri Lanka","2024-03-11",0,0,0,0,0,0,0,0
"Sri Lanka","2024-03-12",0,0,0,0,0,0,0,0
"Sri Lanka","2024-03-13",0,0,0,0,0,0,0,0
"Sri Lanka","2024-03-14",0,0,0,0,0,0,0,0
"Sri Lanka","2024-03-15",0,0,0,0,0,0,0,0
"Sri Lanka","2024-03-16",0,0,0,0,0,0,0,0
"Sri Lanka","2024-03-17",0,0,0,0,0,0,0,0
"Sri Lanka","2024-03-18",0,0,0,0,0,0,0,0
"Sri Lanka","2024-03-19",0,0,0,0,0,0,0,0
"Sri Lanka","2024-03-20",0,0,0,0,0,0,0,0
"Sri Lanka","2024-03-21",0,0,0,0,0,0,0,0
"Sri Lanka","2024-03-22",0,0,0,0,0,0,0,0
"Sri Lanka","2024-03-23",0,0,0,0,0,0,0,0
"Sri Lanka","2024-03-24",0,0,0,0,0,0,0,0
"Sri Lanka","2024-03-25",0,0,0,0,0,0,0,0
"Sri Lanka","2024-03-26",0,0,0,0,0,0,0,0
"Sri Lanka","2024-03-27",0,0,0,0,0,0,0,0
"Sri Lanka","2024-03-28",0,0,0,0,0,0,0,0
"Sri Lanka","2024-03-29",0,0,0,0,0,0,0,0
"Sri Lanka","2024-03-30",0,0,0,0,0,0,0,0
"Sri Lanka","2024-03-31",0,0,0,0,0,0,0,0
"Sri Lanka","2024-04-01",0,0,0,0,0,0,0,0
"Sri Lanka","2024-04-02",0,0,0,0,0,0,0,0
"Sri Lanka","2024-04-03",0,0,0,0,0,0,0,0
"Sri Lanka","2024-04-04",0,0,0,0,0,0,0,0
"Sri Lanka","2024-04-05",0,0,0,0,0,0,0,0
"Sri Lanka","2024-04-06",0,0,0,0,0,0,0,0
"Sri Lanka","2024-04-07",0,0,0,0,0,0,0,0
"Sri Lanka","2024-04-08",0,0,0,0,0,0,0,0
"Sri Lanka","2024-04-09",0,0,0,0,0,0,0,0
"Sri Lanka","2024-04-10",0,0,0,0,0,0,0,0
"Sri Lanka","2024-04-11",0,0,0,0,0,0,0,0
"Sri Lanka","2024-04-12",0,0,0,0,0,0,0,0
"Sri Lanka","2024-04-13",0,0,0,0,0,0,0,0
"Sri Lanka","2024-04-14",0,0,0,0,0,0,0,0
"Sri Lanka","2024-04-15",0,0,0,0,0,0,0,0
"Sri Lanka","2024-04-16",0,0,0,0,0,0,0,0
"Sri Lanka","2024-04-17",0,0,0,0,0,0,0,0
"Sri Lanka","2024-04-18",0,0,0,0,0,0,0,0
"Sri Lanka","2024-04-19",0,0,0,0,0,0,0,0
"Sri Lanka","2024-04-20",0,0,0,0,0,0,0,0
"Sri Lanka","2024-04-21",0,0,0,0,0,0,0,0
"Sri Lanka","2024-04-22",0,0,0,0,0,0,0,0
"Sri Lanka","2024-04-23",0,0,0,0,0,0,0,0
"Sri Lanka","2024-04-24",0,0,0,0,0,0,0,0
"Sri Lanka","2024-04-25",0,0,0,0,0,0,0,0
"Sri Lanka","2024-04-26",0,0,0,0,0,0,0,0
"Sri Lanka","2024-04-27",0,0,0,0,0,0,0,0
"Sri Lanka","2024-04-28",0,0,0,0,0,0,0,0
"Sri Lanka","2024-04-29",0,0,0,0,0,0,0,0
"Sri Lanka","2024-04-30",0,0,0,0,0,0,0,0
"Sri Lanka","2024-05-01",0,0,0,0,0,0,0,0
"Sri Lanka","2024-05-02",0,0,0,0,0,0,0,0
"Sri Lanka","2024-05-03",0,0,0,0,0,0,0,0
"Sri Lanka","2024-05-04",0,0,0,0,0,0,0,0
"Sri Lanka","2024-05-05",0,0,0,0,0,0,0,0
"Sri Lanka","2024-05-06",0,0,0,0,0,0,0,0
"Sri Lanka","2024-05-07",0,0,0,0,0,0,0,0
"Sri Lanka","2024-05-08",0,0,0,0,0,0,0,0
"Sri Lanka","2024-05-09",0,0,0,0,0,0,0,0
"Sri Lanka","2024-05-10",0,0,0,0,0,0,0,0
"Sri Lanka","2024-05-11",0,0,0,0,0,0,0,0
"Sri Lanka","2024-05-12",0,0,0,0,0,0,0,0
"Sri Lanka","2024-05-13",0,0,0,0,0,0,0,0
"Sri Lanka","2024-05-14",0,0,0,0,0,0,0,0
"Sri Lanka","2024-05-15",0,0,0,0,0,0,0,0
"Sri Lanka","2024-05-16",0,0,0,0,0,0,0,0
"Sri Lanka","2024-05-17",0,0,0,0,0,0,0,0
"Sri Lanka","2024-05-18",0,0,0,0,0,0,0,0
"Sri Lanka","2024-05-19",0,0,0,0,0,0,0,0
"Sri Lanka","2024-05-20",0,0,0,0,0,0,0,0
"Sri Lanka","2024-05-21",0,0,0,0,0,0,0,0
"Sri Lanka","2024-05-22",0,0,0,0,0,0,0,0
"Sri Lanka","2024-05-23",0,0,0,0,0,0,0,0
"Sri Lanka","2024-05-24",0,0,0,0,0,0,0,0
"Sri Lanka","2024-05-25",0,0,0,0,0,0,0,0
"Sri Lanka","2024-05-26",0,0,0,0,0,0,0,0
"Sri Lanka","2024-05-27",0,0,0,0,0,0,0,0
"Sri Lanka","2024-05-28",0,0,0,0,0,0,0,0
"Sri Lanka","2024-05-29",0,0,0,0,0,0,0,0
"Sri Lanka","2024-05-30",0,0,0,0,0,0,0,0
"Sri Lanka","2024-05-31",0,0,0,0,0,0,0,0
"Sri Lanka","2024-06-01",0,0,0,0,0,0,0,0
"Sri Lanka","2024-06-02",0,0,0,0,0,0,0,0
"Sri Lanka","2024-06-03",0,0,0,0,0,0,0,0
"Sri Lanka","2024-06-04",0,0,0,0,0,0,0,0
"Sri Lanka","2024-06-05",0,0,0,0,0,0,0,0
"Sri Lanka","2024-06-06",0,0,0,0,0,0,0,0
"Sri Lanka","2024-06-07",0,0,0,0,0,0,0,0
"Sri Lanka","2024-06-08",0,0,0,0,0,0,0,0
"Sri Lanka","2024-06-09",0,0,0,0,0,0,0,0
"Sri Lanka","2024-06-10",0,0,0,0,0,0,0,0
"Sri Lanka","2024-06-11",0,0,0,0,0,0,0,0
"Sri Lanka","2024-06-12",0,0,0,0,0,0,0,0
"Sri Lanka","2024-06-13",0,0,0,0,0,0,0,0
"Sri Lanka","2024-06-14",0,0,0,0,0,0,0,0
"Sri Lanka","2024-06-15",0,0,0,0,0,0,0,0
"Sri Lanka","2024-06-16",0,0,0,0,0,0,0,0
"Sri Lanka","2024-06-17",0,0,0,0,0,0,0,0
"Sri Lanka","2024-06-18",0,0,0,0,0,0,0,0
"Sri Lanka","2024-06-19",0,0,0,0,0,0,0,0
"Sri Lanka","2024-06-20",0,0,0,0,0,0,0,0
"Sri Lanka","2024-06-21",0,0,0,0,0,0,0,0
"Sri Lanka","2024-06-22",0,0,0,0,0,0,0,0
"Sri Lanka","2024-06-23",0,0,0,0,0,0,0,0
"Sri Lanka","2024-06-24",0,0,0,0,0,0,0,0
"Sri Lanka","2024-06-25",0,0,0,0,0,0,0,0
"Sri Lanka","2024-06-26",0,0,0,0,0,0,0,0
"Sri Lanka","2024-06-27",0,0,0,0,0,0,0,0
"Sri Lanka","2024-06-28",0,0,0,0,0,0,0,0
"Sri Lanka","2024-06-29",0,0,0,0,0,0,0,0
"Sri Lanka","2024-06-30",0,0,0,0,0,0,0,0
"Sri Lanka","2024-07-01",0,0,0,0,0,0,0,0
"Sri Lanka","2024-07-02",0,0,0,0,0,0,0,0
"Sri Lanka","2024-07-03",0,0,0,0,0,0,0,0
"Sri Lanka","2024-07-04",0,0,0,0,0,0,0,0
"Sri Lanka","2024-07-05",0,0,0,0,0,0,0,0
"Sri Lanka","2024-07-06",0,0,0,0,0,0,0,0
"Sri Lanka","2024-07-07",0,0,0,0,0,0,0,0
"Sri Lanka","2024-07-08",0,0,0,0,0,0,0,0
"Sri Lanka","2024-07-09",0,0,0,0,0,0,0,0
"Sri Lanka","2024-07-10",0,0,0,0,0,0,0,0
"Sri Lanka","2024-07-11",0,0,0,0,0,0,0,0
"Sri Lanka","2024-07-12",0,0,0,0,0,0,0,0
"Sri Lanka","2024-07-13",0,0,0,0,0,0,0,0
"Sri Lanka","2024-07-14",0,0,0,0,0,0,0,0
"Sri Lanka","2024-07-15",0,0,0,0,0,0,0,0
"Sri Lanka","2024-07-16",0,0,0,0,0,0,0,0
"Sri Lanka","2024-07-17",0,0,0,0,0,0,0,0
"Sri Lanka","2024-07-18",0,0,0,0,0,0,0,0
"Sri Lanka","2024-07-19",0,0,0,0,0,0,0,0
"Sri Lanka","2024-07-20",0,0,0,0,0,0,0,0
"Sri Lanka","2024-07-21",0,0,0,0,0,0,0,0
"Sri Lanka","2024-07-22",0,0,0,0,0,0,0,0
"Sri Lanka","2024-07-23",0,0,0,0,0,0,0,0
"Sri Lanka","2024-07-24",0,0,0,0,0,0,0,0
"Sri Lanka","2024-07-25",0,0,0,0,0,0,0,0
"Sri Lanka","2024-07-26",0,0,0,0,0,0,0,0
"Sri Lanka","2024-07-27",0,0,0,0,0,0,0,0
"Sri Lanka","2024-07-28",0,0,0,0,0,0,0,0
"Sri Lanka","2024-07-29",0,0,0,0,0,0,0,0
"Sri Lanka","2024-07-30",0,0,0,0,0,0,0,0
"Sri Lanka","2024-07-31",0,0,0,0,0,0,0,0
"Sri Lanka","2024-08-01",0,0,0,0,0,0,0,0
"Sri Lanka","2024-08-02",0,0,0,0,0,0,0,0
"Sri Lanka","2024-08-03",0,0,0,0,0,0,0,0
"Sri Lanka","2024-08-04",0,0,0,0,0,0,0,0
"Sri Lanka","2024-08-05",0,0,0,0,0,0,0,0
"Sri Lanka","2024-08-06",0,0,0,0,0,0,0,0
"Sri Lanka","2024-08-07",0,0,0,0,0,0,0,0
"Sri Lanka","2024-08-08",0,0,0,0,0,0,0,0
"Sri Lanka","2024-08-09",0,0,0,0,0,0,0,0
"Sri Lanka","2024-08-10",0,0,0,0,0,0,0,0
"Sri Lanka","2024-08-11",0,0,0,0,0,0,0,0
"Sri Lanka","2024-08-12",0,0,0,0,0,0,0,0
"Sri Lanka","2024-08-13",0,0,0,0,0,0,0,0
"Sri Lanka","2024-08-14",0,0,0,0,0,0,0,0
"Sri Lanka","2024-08-15",0,0,0,0,0,0,0,0
"Sri Lanka","2024-08-16",0,0,0,0,0,0,0,0
"Sri Lanka","2024-08-17",0,0,0,0,0,0,0,0
"Sri Lanka","2024-08-18",0,0,0,0,0,0,0,0
"Sri Lanka","2024-08-19",0,0,0,0,0,0,0,0
"Sri Lanka","2024-08-20",0,0,0,0,0,0,0,0
"Sri Lanka","2024-08-21",0,0,0,0,0,0,0,0
"Sri Lanka","2024-08-22",0,0,0,0,0,0,0,0
"Sri Lanka","2024-08-23",0,0,0,0,0,0,0,0
"Sri Lanka","2024-08-24",0,0,0,0,0,0,0,0
"Sri Lanka","2024-08-25",0,0,0,0,0,0,0,0
"Sri Lanka","2024-08-26",0,0,0,0,0,0,0,0
"Sri Lanka","2024-08-27",0,0,0,0,0,0,0,0
"Sri Lanka","2024-08-28",0,0,0,0,0,0,0,0
"Sri Lanka","2024-08-29",0,0,0,0,0,0,0,0
"Sri Lanka","2024-08-30",0,0,0,0,0,0,0,0
"Sri Lanka","2024-08-31",0,0,0,0,0,0,0,0
"Sri Lanka","2024-09-01",0,0,0,0,0,0,0,0
"Sri Lanka","2024-09-02",0,0,0,0,0,0,0,0
"Sri Lanka","2024-09-03",0,0,0,0,0,0,0,0
"Sri Lanka","2024-09-04",0,0,0,0,0,0,0,0
"Sri Lanka","2024-09-05",0,0,0,0,0,0,0,0
"Sri Lanka","2024-09-06",0,0,0,0,0,0,0,0
"Sri Lanka","2024-09-07",0,0,0,0,0,0,0,0
"Sri Lanka","2024-09-08",0,0,0,0,0,0,0,0
"Sri Lanka","2024-09-09",0,0,0,0,0,0,0,0
"Sri Lanka","2024-09-10",0,0,0,0,0,0,0,0
"Sri Lanka","2024-09-11",0,0,0,0,0,0,0,0
"Sri Lanka","2024-09-12",0,0,0,0,0,0,0,0
"Sri Lanka","2024-09-13",0,0,0,0,0,0,0,0
"Sri Lanka","2024-09-14",0,0,0,0,0,0,0,0
"Sri Lanka","2024-09-15",0,0,0,0,0,0,0,0
"Sri Lanka","2024-09-16",0,0,0,0,0,0,0,0
"Sri Lanka","2024-09-17",0,0,0,0,0,0,0,0
"Sri Lanka","2024-09-18",0,0,0,0,0,0,0,0
"Sri Lanka","2024-09-19",0,0,0,0,0,0,0,0
"Sri Lanka","2024-09-20",0,0,0,0,0,0,0,0
"Sri Lanka","2024-09-21",0,0,0,0,0,0,0,0
"Sri Lanka","2024-09-22",0,0,0,0,0,0,0,0
"Sri Lanka","2024-09-23",0,0,0,0,0,0,0,0
"Sri Lanka","2024-09-24",0,0,0,0,0,0,0,0
"Sri Lanka","2024-09-25",0,0,0,0,0,0,0,0
"Sri Lanka","2024-09-26",0,0,0,0,0,0,0,0
"Sri Lanka","2024-09-27",0,0,0,0,0,0,0,0
"Sri Lanka","2024-09-28",0,0,0,0,0,0,0,0
"Sri Lanka","2024-09-29",0,0,0,0,0,0,0,0
"Sri Lanka","2024-09-30",0,0,0,0,0,0,0,0
"Sri Lanka","2024-10-01",0,0,0,0,0,0,0,0
"Sri Lanka","2024-10-02",0,0,0,0,0,0,0,0
"Sri Lanka","2024-10-03",0,0,0,0,0,0,0,0
"Sri Lanka","2024-10-04",0,0,0,0,0,0,0,0
"Sri Lanka","2024-10-05",0,0,0,0,0,0,0,0
"Sri Lanka","2024-10-06",0,0,0,0,0,0,0,0
"Sri Lanka","2024-10-07",0,0,0,0,0,0,0,0
"Sri Lanka","2024-10-08",0,0,0,0,0,0,0,0
"Sri Lanka","2024-10-09",0,0,0,0,0,0,0,0
"Sri Lanka","2024-10-10",0,0,0,0,0,0,0,0
"Sri Lanka","2024-10-11",0,0,0,0,0,0,0,0
"Sri Lanka","2024-10-12",0,0,0,0,0,0,0,0
"Sri Lanka","2024-10-13",0,0,0,0,0,0,0,0
"Sri Lanka","2024-10-14",0,0,0,0,0,0,0,0
"Sri Lanka","2024-10-15",0,0,0,0,0,0,0,0
"Sri Lanka","2024-10-16",0,0,0,0,0,0,0,0
"Sri Lanka","2024-10-17",0,0,0,0,0,0,0,0
"Sri Lanka","2024-10-18",0,0,0,0,0,0,0,0
"Sri Lanka","2024-10-19",0,0,0,0,0,0,0,0
"Sri Lanka","2024-10-20",0,0,0,0,0,0,0,0
"Sri Lanka","2024-10-21",0,0,0,0,0,0,0,0
"Sri Lanka","2024-10-22",0,0,0,0,0,0,0,0
"Sri Lanka","2024-10-23",0,0,0,0,0,0,0,0
"Sri Lanka","2024-10-24",0,0,0,0,0,0,0,0
"Sri Lanka","2024-10-25",0,0,0,0,0,0,0,0
"Sri Lanka","2024-10-26",0,0,0,0,0,0,0,0
"Sri Lanka","2024-10-27",0,0,0,0,0,0,0,0
"Sri Lanka","2024-10-28",0,0,0,0,0,0,0,0
"Sri Lanka","2024-10-29",0,0,0,0,0,0,0,0
"Sri Lanka","2024-10-30",0,0,0,0,0,0,0,0
"Sri Lanka","2024-10-31",0,0,0,0,0,0,0,0
"Sri Lanka","2024-11-01",0,0,0,0,0,0,0,0
"Sri Lanka","2024-11-02",0,0,0,0,0,0,0,0
"Sri Lanka","2024-11-03",0,0,0,0,0,0,0,0
"Sri Lanka","2024-11-04",0,0,0,0,0,0,0,0
"Sri Lanka","2024-11-05",0,0,0,0,0,0,0,0
"Sri Lanka","2024-11-06",0,0,0,0,0,0,0,0
"Sri Lanka","2024-11-07",0,0,0,0,0,0,0,0
"Sri Lanka","2024-11-08",0,0,0,0,0,0,0,0
"Sri Lanka","2024-11-09",0,0,0,0,0,0,0,0
"Sri Lanka","2024-11-10",0,0,0,0,0,0,0,0
"Sri Lanka","2024-11-11",0,0,0,0,0,0,0,0
"Sri Lanka","2024-11-12",0,0,0,0,0,0,0,0
"Sri Lanka","2024-11-13",0,0,0,0,0,0,0,0
"Sri Lanka","2024-11-14",0,0,0,0,0,0,0,0
"Sri Lanka","2024-11-15",0,0,0,0,0,0,0,0
"Sri Lanka","2024-11-16",0,0,0,0,0,0,0,0
"Sri Lanka","2024-11-17",0,0,0,0,0,0,0,0
"Sri Lanka","2024-11-18",0,0,0,0,0,0,0,0
"Sri Lanka","2024-11-19",0,0,0,0,0,0,0,0
"Sri Lanka","2024-11-20",0,0,0,0,0,0,0,0
"Sri Lanka","2024-11-21",0,0,0,0,0,0,0,0
"Sri Lanka","2024-11-22",0,0,0,0,0,0,0,0
"Sri Lanka","2024-11-23",0,0,0,0,0,0,0,0
"Sri Lanka","2024-11-24",0,0,0,0,0,0,0,0
"Sri Lanka","2024-11-25",0,0,0,0,0,0,0,0
"Sri Lanka","2024-11-26",0,0,0,0,0,0,0,0
"Sri Lanka","2024-11-27",0,0,0,0,0,0,0,0
"Sri Lanka","2024-11-28",0,0,0,0,0,0,0,0
"Sri Lanka","2024-11-29",0,0,0,0,0,0,0,0
"Sri Lanka","2024-11-30",0,0,0,0,0,0,0,0
"Sri Lanka","2024-12-01",0,0,0,0,0,0,0,0
"Sri Lanka","2024-12-02",0,0,0,0,0,0,0,0
"Sri Lanka","2024-12-03",0,0,0,0,0,0,0,0
"Sri Lanka","2024-12-04",0,0,0,0,0,0,0,0
"Sri Lanka","2024-12-05",0,0,0,0,0,0,0,0
"Sri Lanka","2024-12-06",0,0,0,0,0,0,0,0
"Sri Lanka","2024-12-07",0,0,0,0,0,0,0,0
"Sri Lanka","2024-12-08",0,0,0,0,0,0,0,0
"Sri Lanka","2024-12-09",0,0,0,0,0,0,0,0
"Sri Lanka","2024-12-10",0,0,0,0,0,0,0,0
"Sri Lanka","2024-12-11",0,0,0,0,0,0,0,0
"Sri Lanka","2024-12-12",0,0,0,0,0,0,0,0
"Sri Lanka","2024-12-13",0,0,0,0,0,0,0,0
"Sri Lanka","2024-12-14",0,0,0,0,0,0,0,0
"Sri Lanka","2024-12-15",0,0,0,0,0,0,0,0
"Sri Lanka","2024-12-16",0,0,0,0,0,0,0,0
"Sri Lanka","2024-12-17",0,0,0,0,0,0,0,0
"Sri Lanka","2024-12-18",0,0,0,0,0,0,0,0
"Sri Lanka","2024-12-19",0,0,0,0,0,0,0,0
"Sri Lanka","2024-12-20",0,0,0,0,0,0,0,0
"Sri Lanka","2024-12-21",0,0,0,0,0,0,0,0
"Sri Lanka","2024-12-22",0,0,0,0,0,0,0,0
"Sri Lanka","2024-12-23",0,0,0,0,0,0,0,0
"Sri Lanka","2024-12-24",0,0,0,0,0,0,0,0
"Sri Lanka","2024-12-25",0,0,0,0,0,0,0,0
"Sri Lanka","2024-12-26",0,0,0,0,0,0,0,0
"Sri Lanka","2024-12-27",0,0,0,0,0,0,0,0
"Sri Lanka","2024-12-28",0,0,0,0,0,0,0,0
"Sri Lanka","2024-12-29",0,0,0,0,0,0,0,0
"Sri Lanka","2024-12-30",0,0,0,0,0,0,0,0
"Sri Lanka","2024-12-31",0,0,0,0,0,0,0,0
"Sri Lanka","2025-01-01",0,0,0,0,0,0,0,0
"Sri Lanka","2025-01-02",0,0,0,0,0,0,0,0
"Sri Lanka","2025-01-03",0,0,0,0,0,0,0,0
"Sri Lanka","2025-01-04",0,0,0,0,0,0,0,0
"Sri Lanka","2025-01-05",0,0,0,0,0,0,0,0
"Sri Lanka","2025-01-06",0,0,0,0,0,0,0,0
"Sri Lanka","2025-01-07",0,0,0,0,0,0,0,0
"Sri Lanka","2025-01-08",0,0,0,0,0,0,0,0
"Sri Lanka","2025-01-09",0,0,0,0,0,0,0,0
"Sri Lanka","2025-01-10",0,0,0,0,0,0,0,0
"Sri Lanka","2025-01-11",0,0,0,0,0,0,0,0
"Sri Lanka","2025-01-12",0,0,0,0,0,0,0,0
"Sri Lanka","2025-01-13",0,0,0,0,0,0,0,0
"Sri Lanka","2025-01-14",0,0,0,0,0,0,0,0
"Sri Lanka","2025-01-15",0,0,0,0,0,0,0,0
"Sri Lanka","2025-01-16",0,0,0,0,0,0,0,0
"Sri Lanka","2025-01-17",0,0,0,0,0,0,0,0
"Sri Lanka","2025-01-18",0,0,0,0,0,0,0,0
"Sri Lanka","2025-01-19",0,0,0,0,0,0,0,0
"Sri Lanka","2025-01-20",0,0,0,0,0,0,0,0
"Sri Lanka","2025-01-21",0,0,0,0,0,0,0,0
"Sri Lanka","2025-01-22",0,0,0,0,0,0,0,0
"Sri Lanka","2025-01-23",0,0,0,0,0,0,0,0
"Sri Lanka","2025-01-24",0,0,0,0,0,0,0,0
"Sri Lanka","2025-01-25",0,0,0,0,0,0,0,0
"Sri Lanka","2025-01-26",0,0,0,0,0,0,0,0
"Sri Lanka","2025-01-27",0,0,0,0,0,0,0,0
"Sri Lanka","2025-01-28",0,0,0,0,0,0,0,0
"Sri Lanka","2025-01-29",0,0,0,0,0,0,0,0
"Sri Lanka","2025-01-30",0,0,0,0,0,0,0,0
"Sri Lanka","2025-01-31",0,0,0,0,0,0,0,0
"Sri Lanka","2025-02-01",0,0,0,0,0,0,0,0
"Sri Lanka","2025-02-02",0,0,0,0,0,0,0,0
"Sri Lanka","2025-02-03",0,0,0,0,0,0,0,0
"Sri Lanka","2025-02-04",0,0,0,0,0,0,0,0
"Sri Lanka","2025-02-05",0,0,0,0,0,0,0,0
"Sri Lanka","2025-02-06",0,0,0,0,0,0,0,0
"Sri Lanka","2025-02-07",0,0,0,0,0,0,0,0
"Sri Lanka","2025-02-08",0,0,0,0,0,0,0,0
"Sri Lanka","2025-02-09",0,0,0,0,0,0,0,0
"Sri Lanka","2025-02-10",0,0,0,0,0,0,0,0
"Sri Lanka","2025-02-11",0,0,0,0,0,0,0,0
"Sri Lanka","2025-02-12",0,0,0,0,0,0,0,0
"Sri Lanka","2025-02-13",0,0,0,0,0,0,0,0
"Sri Lanka","2025-02-14",0,0,0,0,0,0,0,0
"Sri Lanka","2025-02-15",0,0,0,0,0,0,0,0
"Sri Lanka","2025-02-16",0,0,0,0,0,0,0,0
"Sri Lanka","2025-02-17",0,0,0,0,0,0,0,0
"Sri Lanka","2025-02-18",0,0,0,0,0,0,0,0
"Sri Lanka","2025-02-19",0,0,0,0,0,0,0,0
"Sri Lanka","2025-02-20",0,0,0,0,0,0,0,0
"Sri Lanka","2025-02-21",0,0,0,0,0,0,0,0
"Sri Lanka","2025-02-22",0,0,0,0,0,0,0,0
"Sri Lanka","2025-02-23",0,0,0,0,0,0,0,0
"Sri Lanka","2025-02-24",0,0,0,0,0,0,0,0
"Sri Lanka","2025-02-25",0,0,0,0,0,0,0,0
"Sri Lanka","2025-02-26",0,0,0,0,0,0,0,0
"Sri Lanka","2025-02-27",0,0,0,0,0,0,0,0
"Sri Lanka","2025-02-28",0,0,0,0,0,0,0,0
"Sri Lanka","2025-03-01",0,0,0,0,0,0,0,0
"Sri Lanka","2025-03-02",0,0,0,0,0,0,0,0
"Sri Lanka","2025-03-03",0,0,0,0,0,0,0,0
"Sweden","2024-01-01",0,0,0,0,0,0,0,0
"Sweden","2024-01-02",0,0,0,0,0,0,0,0
"Sweden","2024-01-03",0,0,0,0,0,0,0,0
"Sweden","2024-01-04",0,0,0,0,0,0,0,0
"Sweden","2024-01-05",0,0,0,0,0,0,0,0
"Sweden","2024-01-06",0,0,0,0,0,0,0,0
"Sweden","2024-01-07",0,0,0,0,0,0,0,0
"Sweden","2024-01-08",0,0,0,0,0,0,0,0
"Sweden","2024-01-09",0,0,0,0,0,0,0,0
"Sweden","2024-01-10",0,0,0,0,0,0,0,0
"Sweden","2024-01-11",0,0,0,0,0,0,0,0
"Sweden","2024-01-12",0,0,0,0,0,0,0,0
"Sweden","2024-01-13",0,0,0,0,0,0,0,0
"Sweden","2024-01-14",0,0,0,0,0,0,0,0
"Sweden","2024-01-15",0,0,0,0,0,0,0,0
"Sweden","2024-01-16",0,0,0,0,0,0,0,0
"Sweden","2024-01-17",0,0,0,0,0,0,0,0
"Sweden","2024-01-18",0,0,0,0,0,0,0,0
"Sweden","2024-01-19",0,0,0,0,0,0,0,0
"Sweden","2024-01-20",0,0,0,0,0,0,0,0
"Sweden","2024-01-21",0,0,0,0,0,0,0,0
"Sweden","2024-01-22",0,0,0,0,0,0,0,0
"Sweden","2024-01-23",0,0,0,0,0,0,0,0
"Sweden","2024-01-24",0,0,0,0,0,0,0,0
"Sweden","2024-01-25",0,0,0,0,0,0,0,0
"Sweden","2024-01-26",0,0,0,0,0,0,0,0
"Sweden","2024-01-27",0,0,0,0,0,0,0,0
"Sweden","2024-01-28",0,0,0,0,0,0,0,0
"Sweden","2024-01-29",0,0,0,0,0,0,0,0
"Sweden","2024-01-30",0,0,0,0,0,0,0,0
"Sweden","2024-01-31",0,3,3,0,3,3,0,0
"Sweden","2024-02-01",0,0,3,0,0,3,0,0
"Sweden","2024-02-02",0,0,3,0,0,3,0,0
"Sweden","2024-02-03",0,0,3,0,0,3,0,0
"Sweden","2024-02-04",0,0,3,0,0,3,0,0
"Sweden","2024-02-05",0,0,3,0,0,3,0,0
"Sweden","2024-02-06",0,0,3,0,0,3,0,0
"Sweden","2024-02-07",0,0,3,0,0,3,0,0
"Sweden","2024-02-08",0,0,3,0,1,4,0,0
"Sweden","2024-02-09",0,0,3,0,0,4,0,0
"Sweden","2024-02-10",0,0,3,0,0,4,0,0
"Sweden","2024-02-11",0,0,3,0,0,4,0,0
"Sweden","2024-02-12",0,0,3,0,0,4,0,0
"Sweden","2024-02-13",0,0,3,0,0,4,0,0
"Sweden","2024-02-14",0,0,3,0,0,4,0,0
"Sweden","2024-02-15",0,0,3,0,0,4,0,0
"Sweden","2024-02-16",0,0,3,0,0,4,0,0
"Sweden","2024-02-17",0,0,3,0,0,4,0,0
"Sweden","2024-02-18",0,0,3,0,0,4,0,0
"Sweden","2024-02-19",0,0,3,0,0,4,0,0
"Sweden","2024-02-20",0,0,3,0,0,4,0,0
"Sweden","2024-02-21",0,0,3,0,0,4,0,0
"Sweden","2024-02-22",0,0,3,0,1,5,0,0
"Sweden","2024-02-23",0,0,3,0,0,5,0,0
"Sweden","2024-02-24",0,0,3,0,0,5,0,0
"Sweden","2024-02-25",0,0,3,0,0,5,0,0
"Sweden","2024-02-26",0,0,3,0,0,5,0,0
"Sweden","2024-02-27",0,0,3,0,0,5,0,0
"Sweden","2024-02-28",0,0,3,0,0,5,0,0
"Sweden","2024-02-29",0,2,5,0,0,5,0,0
"Sweden","2024-03-01",0,0,5,0,0,5,0,0
"Sweden","2024-03-02",0,0,5,0,0,5,0,0
"Sweden","2024-03-03",0,0,5,0,1,6,0,0
"Sweden","2024-03-04",0,0,5,0,0,6,0,0
"Sweden","2024-03-05",0,0,5,0,0,6,0,0
"Sweden","2024-03-06",0,0,5,0,0,6,0,0
"Sweden","2024-03-07",0,0,5,0,1,7,0,0
"Sweden","2024-03-08",0,0,5,0,0,7,0,0
"Sweden","2024-03-09",0,0,5,0,0,7,0,0
"Sweden","2024-03-10",0,0,5,0,0,7,0,0
"Sweden","2024-03-11",0,0,5,0,1,8,0,0
"Sweden","2024-03-12",0,0,5,0,0,8,0,0
"Sweden","2024-03-13",0,0,5,0,0,8,0,0
"Sweden","2024-03-14",0,0,5,0,0,8,0,0
"Sweden","2024-03-15",0,0,5,0,0,8,0,0
"Sweden","2024-03-16",0,0,5,0,1,9,0,0
"Sweden","2024-03-17",0,0,5,0,0,9,0,0
"Sweden","2024-03-18",0,0,5,0,0,9,0,0
"Sweden","2024-03-19",0,0,5,0,0,9,0,0
"Sweden","2024-03-20",0,0,5,0,1,10,0,0
"Sweden","2024-03-21",0,0,5,0,0,10,0,0
"Sweden","2024-03-22",0,0,5,0,0,10,0,0
"Sweden","2024-03-23",0,0,5,0,0,10,0,0
"Sweden","2024-03-24",0,0,5,0,1,11,0,0
"Sweden","2024-03-25",0,0,5,0,0,11,0,0
"Sweden","2024-03-26",0,0,5,0,0,11,0,0
"Sweden","2024-03-27",0,0,5,0,0,11,0,0
"Sweden","2024-03-28",0,0,5,0,0,11,0,0
"Sweden","2024-03-29",0,0,5,0,1,12,0,0
"Sweden","2024-03-30",0,0,5,0,0,12,0,0
"Sweden","2024-03-31",0,0,5,0,0,12,0,0
"Sweden","2024-04-01",0,0,5,0,0,12,0,0
"Sweden","2024-04-02",0,0,5,0,1,13,0,0
"Sweden","2024-04-03",0,0,5,0,0,13,0,0
"Sweden","2024-04-04",0,0,5,0,0,13,0,0
"Sweden","2024-04-05",0,0,5,0,0,13,0,0
"Sweden","2024-04-06",0,0,5,0,0,13,0,0
"Sweden","2024-04-07",0,0,5,0,1,14,0,0
"Sweden","2024-04-08",0,0,5,0,0,14,0,0
"Sweden","2024-04-09",0,0,5,0,0,14,0,0
"Sweden","2024-04-10",0,0,5,0,0,14,0,0
"Sweden","2024-04-11",0,0,5,0,1,15,0,0
"Sweden","2024-04-12",0,0,5,0,0,15,0,0
"Sweden","2024-04-13",0,0,5,0,0,15,0,0
"Sweden","2024-04-14",0,0,5,0,0,15,0,0
"Sweden","2024-04-15",0,0,5,0,1,16,0,0
"Sweden","2024-04-16",0,0,5,0,0,16,0,0
"Sweden","2024-04-17",0,0,5,0,0,16,0,0
"Sweden","2024-04-18",0,0,5,0,0,16,0,0
"Sweden","2024-04-19",0,0,5,0,0,16,0,0
"Sweden","2024-04-20",0,0,5,0,1,17,0,0
"Sweden","2024-04-21",0,0,5,0,0,17,0,0
"Sweden","2024-04-22",0,0,5,0,0,17,0,0
"Sweden","2024-04-23",0,0,5,0,0,17,0,0
"Sweden","2024-04-24",0,0,5,0,1,18,0,0
"Sweden","2024-04-25",0,0,5,0,0,18,0,0
"Sweden","2024-04-26",0,0,5,0,0,18,0,0
"Sweden","2024-04-27",0,0,5,0,0,18,0,0
"Sweden","2024-04-28",0,0,5,0,1,19,0,0
"Sweden","2024-04-29",0,0,5,0,0,19,0,0
"Sweden","2024-04-30",0,14,19,0,0,19,0,0
"Sweden","2024-05-01",0,0,19,0,0,19,0,0
"Sweden","2024-05-02",0,0,19,0,1,20,0,0
"Sweden","2024-05-03",0,0,19,0,0,20,0,0
"Sweden","2024-05-04",0,0,19,0,0,20,0,0
"Sweden","2024-05-05",0,0,19,0,1,21,0,0
"Sweden","2024-05-06",0,0,19,0,0,21,0,0
"Sweden","2024-05-07",0,0,19,0,0,21,0,0
"Sweden","2024-05-08",0,0,19,0,1,22,0,0
"Sweden","2024-05-09",0,0,19,0,0,22,0,0
"Sweden","2024-05-10",0,0,19,0,1,23,0,0
"Sweden","2024-05-11",0,0,19,0,0,23,0,0
"Sweden","2024-05-12",0,0,19,0,0,23,0,0
"Sweden","2024-05-13",0,0,19,0,1,24,0,0
"Sweden","2024-05-14",0,0,19,0,0,24,0,0
"Sweden","2024-05-15",0,0,19,0,0,24,0,0
"Sweden","2024-05-16",0,0,19,0,1,25,0,0
"Sweden","2024-05-17",0,0,19,0,0,25,0,0
"Sweden","2024-05-18",0,0,19,0,0,25,0,0
"Sweden","2024-05-19",0,0,19,0,1,26,0,0
"Sweden","2024-05-20",0,0,19,0,0,26,0,0
"Sweden","2024-05-21",0,0,19,0,0,26,0,0
"Sweden","2024-05-22",0,0,19,0,1,27,0,0
"Sweden","2024-05-23",0,0,19,0,0,27,0,0
"Sweden","2024-05-24",0,0,19,0,1,28,0,0
"Sweden","2024-05-25",0,0,19,0,0,28,0,0
"Sweden","2024-05-26",0,0,19,0,0,28,0,0
"Sweden","2024-05-27",0,0,19,0,1,29,0,0
"Sweden","2024-05-28",0,0,19,0,0,29,0,0
"Sweden","2024-05-29",0,0,19,0,0,29,0,0
"Sweden","2024-05-30",0,0,19,0,1,30,0,0
"Sweden","2024-05-31",0,11,30,0,0,30,0,0
"Sweden","2024-06-01",0,0,30,0,0,30,0,0
"Sweden","2024-06-02",0,0,30,0,0,30,0,0
"Sweden","2024-06-03",0,0,30,0,0,30,0,0
"Sweden","2024-06-04",0,0,30,0,0,30,0,0
"Sweden","2024-06-05",0,0,30,0,0,30,0,0
"Sweden","2024-06-06",0,0,30,0,0,30,0,0
"Sweden","2024-06-07",0,0,30,0,0,30,0,0
"Sweden","2024-06-08",0,0,30,0,1,31,0,0
"Sweden","2024-06-09",0,0,30,0,0,31,0,0
"Sweden","2024-06-10",0,0,30,0,0,31,0,0
"Sweden","2024-06-11",0,0,30,0,0,31,0,0
"Sweden","2024-06-12",0,0,30,0,0,31,0,0
"Sweden","2024-06-13",0,0,30,0,0,31,0,0
"Sweden","2024-06-14",0,0,30,0,0,31,0,0
"Sweden","2024-06-15",0,0,30,0,0,31,0,0
"Sweden","2024-06-16",0,0,30,0,0,31,0,0
"Sweden","2024-06-17",0,0,30,0,0,31,0,0
"Sweden","2024-06-18",0,0,30,0,0,31,0,0
"Sweden","2024-06-19",0,0,30,0,0,31,0,0
"Sweden","2024-06-20",0,0,30,0,0,31,0,0
"Sweden","2024-06-21",0,0,30,0,0,31,0,0
"Sweden","2024-06-22",0,0,30,0,0,31,0,0
"Sweden","2024-06-23",0,0,30,0,1,32,0,0
"Sweden","2024-06-24",0,0,30,0,0,32,0,0
"Sweden","2024-06-25",0,0,30,0,0,32,0,0
"Sweden","2024-06-26",0,0,30,0,0,32,0,0
"Sweden","2024-06-27",0,0,30,0,0,32,0,0
"Sweden","2024-06-28",0,0,30,0,0,32,0,0
"Sweden","2024-06-29",0,0,30,0,0,32,0,0
"Sweden","2024-06-30",0,2,32,0,0,32,0,0
"Sweden","2024-07-01",0,0,32,0,0,32,0,0
"Sweden","2024-07-02",0,0,32,0,0,32,0,0
"Sweden","2024-07-03",0,0,32,0,0,32,0,0
"Sweden","2024-07-04",0,0,32,0,0,32,0,0
"Sweden","2024-07-05",0,0,32,0,0,32,0,0
"Sweden","2024-07-06",0,0,32,0,0,32,0,0
"Sweden","2024-07-07",0,0,32,0,0,32,0,0
"Sweden","2024-07-08",0,0,32,0,0,32,0,0
"Sweden","2024-07-09",0,0,32,0,0,32,0,0
"Sweden","2024-07-10",0,0,32,0,0,32,0,0
"Sweden","2024-07-11",0,0,32,0,0,32,0,0
"Sweden","2024-07-12",0,0,32,0,0,32,0,0
"Sweden","2024-07-13",0,0,32,0,0,32,0,0
"Sweden","2024-07-14",0,0,32,0,0,32,0,0
"Sweden","2024-07-15",0,0,32,0,0,32,0,0
"Sweden","2024-07-16",0,0,32,0,1,33,0,0
"Sweden","2024-07-17",0,0,32,0,0,33,0,0
"Sweden","2024-07-18",0,0,32,0,0,33,0,0
"Sweden","2024-07-19",0,0,32,0,0,33,0,0
"Sweden","2024-07-20",0,0,32,0,0,33,0,0
"Sweden","2024-07-21",0,0,32,0,0,33,0,0
"Sweden","2024-07-22",0,0,32,0,0,33,0,0
"Sweden","2024-07-23",0,0,32,0,0,33,0,0
"Sweden","2024-07-24",0,0,32,0,0,33,0,0
"Sweden","2024-07-25",0,0,32,0,0,33,0,0
"Sweden","2024-07-26",0,0,32,0,0,33,0,0
"Sweden","2024-07-27",0,0,32,0,0,33,0,0
"Sweden","2024-07-28",0,0,32,0,0,33,0,0
"Sweden","2024-07-29",0,0,32,0,0,33,0,0
"Sweden","2024-07-30",0,0,32,0,0,33,0,0
"Sweden","2024-07-31",0,1,33,0,0,33,0,0
"Sweden","2024-08-01",0,0,33,0,0,33,0,0
"Sweden","2024-08-02",0,0,33,0,0,33,0,0
"Sweden","2024-08-03",0,0,33,0,0,33,0,0
"Sweden","2024-08-04",0,0,33,0,0,33,0,0
"Sweden","2024-08-05",0,0,33,0,0,33,0,0
"Sweden","2024-08-06",0,0,33,0,0,33,0,0
"Sweden","2024-08-07",0,0,33,0,0,33,0,0
"Sweden","2024-08-08",0,0,33,0,1,34,0,0
"Sweden","2024-08-09",0,0,33,0,0,34,0,0
"Sweden","2024-08-10",0,0,33,0,0,34,0,0
"Sweden","2024-08-11",0,0,33,0,0,34,0,0
"Sweden","2024-08-12",0,0,33,0,0,34,0,0
"Sweden","2024-08-13",0,0,33,0,0,34,0,0
"Sweden","2024-08-14",0,0,33,0,0,34,0,0
"Sweden","2024-08-15",0,0,33,0,0,34,0,0
"Sweden","2024-08-16",0,0,33,0,0,34,0,0
"Sweden","2024-08-17",0,0,33,0,0,34,0,0
"Sweden","2024-08-18",0,0,33,0,0,34,0,0
"Sweden","2024-08-19",0,0,33,0,0,34,0,0
"Sweden","2024-08-20",0,0,33,0,0,34,0,0
"Sweden","2024-08-21",0,0,33,0,0,34,0,0
"Sweden","2024-08-22",0,0,33,0,0,34,0,0
"Sweden","2024-08-23",0,0,33,0,0,34,0,0
"Sweden","2024-08-24",0,0,33,0,1,35,0,0
"Sweden","2024-08-25",0,0,33,0,0,35,0,0
"Sweden","2024-08-26",0,0,33,0,0,35,0,0
"Sweden","2024-08-27",0,0,33,0,0,35,0,0
"Sweden","2024-08-28",0,0,33,0,0,35,0,0
"Sweden","2024-08-29",0,0,33,0,0,35,0,0
"Sweden","2024-08-30",0,0,33,0,0,35,0,0
"Sweden","2024-08-31",0,2,35,0,0,35,0,0
"Sweden","2024-09-01",0,0,35,0,0,35,0,0
"Sweden","2024-09-02",0,0,35,0,0,35,0,0
"Sweden","2024-09-03",0,0,35,0,0,35,0,0
"Sweden","2024-09-04",0,0,35,0,0,35,0,0
"Sweden","2024-09-05",0,0,35,0,0,35,0,0
"Sweden","2024-09-06",0,0,35,0,0,35,0,0
"Sweden","2024-09-07",0,0,35,0,0,35,0,0
"Sweden","2024-09-08",0,0,35,0,0,35,0,0
"Sweden","2024-09-09",0,0,35,0,0,35,0,0
"Sweden","2024-09-10",0,0,35,0,0,35,0,0
"Sweden","2024-09-11",0,0,35,0,1,36,0,0
"Sweden","2024-09-12",0,0,35,0,0,36,0,0
"Sweden","2024-09-13",0,0,35,0,0,36,0,0
"Sweden","2024-09-14",0,0,35,0,0,36,0,0
"Sweden","2024-09-15",0,0,35,0,0,36,0,0
"Sweden","2024-09-16",0,0,35,0,0,36,0,0
"Sweden","2024-09-17",0,0,35,0,0,36,0,0
"Sweden","2024-09-18",0,0,35,0,0,36,0,0
"Sweden","2024-09-19",0,0,35,0,0,36,0,0
"Sweden","2024-09-20",0,0,35,0,0,36,0,0
"Sweden","2024-09-21",0,0,35,0,0,36,0,0
"Sweden","2024-09-22",0,0,35,0,0,36,0,0
"Sweden","2024-09-23",0,0,35,0,0,36,0,0
"Sweden","2024-09-24",0,0,35,0,0,36,0,0
"Sweden","2024-09-25",0,0,35,0,0,36,0,0
"Sweden","2024-09-26",0,0,35,0,0,36,0,0
"Sweden","2024-09-27",0,0,35,0,0,36,0,0
"Sweden","2024-09-28",0,0,35,0,0,36,0,0
"Sweden","2024-09-29",0,0,35,0,0,36,0,0
"Sweden","2024-09-30",0,0,35,0,0,36,0,0
"Sweden","2024-10-01",0,0,35,0,1,37,0,0
"Sweden","2024-10-02",0,0,35,0,0,37,0,0
"Sweden","2024-10-03",0,0,35,0,0,37,0,0
"Sweden","2024-10-04",0,0,35,0,0,37,0,0
"Sweden","2024-10-05",0,0,35,0,0,37,0,0
"Sweden","2024-10-06",0,0,35,0,0,37,0,0
"Sweden","2024-10-07",0,0,35,0,0,37,0,0
"Sweden","2024-10-08",0,0,35,0,0,37,0,0
"Sweden","2024-10-09",0,0,35,0,0,37,0,0
"Sweden","2024-10-10",0,0,35,0,0,37,0,0
"Sweden","2024-10-11",0,0,35,0,0,37,0,0
"Sweden","2024-10-12",0,0,35,0,0,37,0,0
"Sweden","2024-10-13",0,0,35,0,0,37,0,0
"Sweden","2024-10-14",0,0,35,0,0,37,0,0
"Sweden","2024-10-15",0,0,35,0,0,37,0,0
"Sweden","2024-10-16",0,0,35,0,0,37,0,0
"Sweden","2024-10-17",0,0,35,0,0,37,0,0
"Sweden","2024-10-18",0,0,35,0,0,37,0,0
"Sweden","2024-10-19",0,0,35,0,0,37,0,0
"Sweden","2024-10-20",0,0,35,0,0,37,0,0
"Sweden","2024-10-21",0,0,35,0,1,38,0,0
"Sweden","2024-10-22",0,0,35,0,0,38,0,0
"Sweden","2024-10-23",0,0,35,0,0,38,0,0
"Sweden","2024-10-24",0,0,35,0,0,38,0,0
"Sweden","2024-10-25",0,0,35,0,0,38,0,0
"Sweden","2024-10-26",0,0,35,0,0,38,0,0
"Sweden","2024-10-27",0,0,35,0,0,38,0,0
"Sweden","2024-10-28",0,0,35,0,0,38,0,0
"Sweden","2024-10-29",0,0,35,0,0,38,0,0
"Sweden","2024-10-30",0,0,35,0,0,38,0,0
"Sweden","2024-10-31",0,3,38,0,0,38,0,0
"Sweden","2024-11-01",0,0,38,0,0,38,0,0
"Sweden","2024-11-02",0,0,38,0,0,38,0,0
"Sweden","2024-11-03",0,0,38,0,0,38,0,0
"Sweden","2024-11-04",0,0,38,0,0,38,0,0
"Sweden","2024-11-05",0,0,38,0,0,38,0,0
"Sweden","2024-11-06",0,0,38,0,0,38,0,0
"Sweden","2024-11-07",0,0,38,0,0,38,0,0
"Sweden","2024-11-08",0,0,38,0,0,38,0,0
"Sweden","2024-11-09",0,0,38,0,0,38,0,0
"Sweden","2024-11-10",0,0,38,0,0,38,0,0
"Sweden","2024-11-11",0,0,38,0,0,38,0,0
"Sweden","2024-11-12",0,0,38,0,0,38,0,0
"Sweden","2024-11-13",0,0,38,0,0,38,0,0
"Sweden","2024-11-14",0,0,38,0,0,38,0,0
"Sweden","2024-11-15",0,0,38,0,0,38,0,0
"Sweden","2024-11-16",0,0,38,0,0,38,0,0
"Sweden","2024-11-17",0,0,38,0,0,38,0,0
"Sweden","2024-11-18",0,0,38,0,0,38,0,0
"Sweden","2024-11-19",0,0,38,0,0,38,0,0
"Sweden","2024-11-20",0,0,38,0,0,38,0,0
"Sweden","2024-11-21",0,0,38,0,0,38,0,0
"Sweden","2024-11-22",0,0,38,0,0,38,0,0
"Sweden","2024-11-23",0,0,38,0,0,38,0,0
"Sweden","2024-11-24",0,0,38,0,0,38,0,0
"Sweden","2024-11-25",0,0,38,0,0,38,0,0
"Sweden","2024-11-26",0,0,38,0,0,38,0,0
"Sweden","2024-11-27",0,0,38,0,0,38,0,0
"Sweden","2024-11-28",0,0,38,0,0,38,0,0
"Sweden","2024-11-29",0,0,38,0,0,38,0,0
"Sweden","2024-11-30",0,0,38,0,0,38,0,0
"Sweden","2024-12-01",0,0,38,0,1,39,0,0
"Sweden","2024-12-02",0,0,38,0,0,39,0,0
"Sweden","2024-12-03",0,0,38,0,0,39,0,0
"Sweden","2024-12-04",0,0,38,0,0,39,0,0
"Sweden","2024-12-05",0,0,38,0,0,39,0,0
"Sweden","2024-12-06",0,0,38,0,0,39,0,0
"Sweden","2024-12-07",0,0,38,0,0,39,0,0
"Sweden","2024-12-08",0,0,38,0,0,39,0,0
"Sweden","2024-12-09",0,0,38,0,0,39,0,0
"Sweden","2024-12-10",0,0,38,0,0,39,0,0
"Sweden","2024-12-11",0,0,38,0,0,39,0,0
"Sweden","2024-12-12",0,0,38,0,0,39,0,0
"Sweden","2024-12-13",0,0,38,0,0,39,0,0
"Sweden","2024-12-14",0,0,38,0,0,39,0,0
"Sweden","2024-12-15",0,0,38,0,0,39,0,0
"Sweden","2024-12-16",0,0,38,0,0,39,0,0
"Sweden","2024-12-17",0,0,38,0,0,39,0,0
"Sweden","2024-12-18",0,0,38,0,0,39,0,0
"Sweden","2024-12-19",0,0,38,0,0,39,0,0
"Sweden","2024-12-20",0,0,38,0,0,39,0,0
"Sweden","2024-12-21",0,0,38,0,0,39,0,0
"Sweden","2024-12-22",0,0,38,0,0,39,0,0
"Sweden","2024-12-23",0,0,38,0,0,39,0,0
"Sweden","2024-12-24",0,0,38,0,0,39,0,0
"Sweden","2024-12-25",0,0,38,0,0,39,0,0
"Sweden","2024-12-26",0,0,38,0,0,39,0,0
"Sweden","2024-12-27",0,0,38,0,0,39,0,0
"Sweden","2024-12-28",0,0,38,0,0,39,0,0
"Sweden","2024-12-29",0,0,38,0,0,39,0,0
"Sweden","2024-12-30",0,0,38,0,0,39,0,0
"Sweden","2024-12-31",0,1,39,0,0,39,0,0
"Sweden","2025-01-01",0,0,39,0,2,41,0,0
"Sweden","2025-01-02",0,0,39,0,2,43,0,0
"Sweden","2025-01-03",0,0,39,0,2,45,0,0
"Sweden","2025-01-04",0,0,39,0,2,47,0,0
"Sweden","2025-01-05",0,0,39,0,2,49,0,0
"Sweden","2025-01-06",0,0,39,0,2,51,0,0
"Sweden","2025-01-07",0,0,39,0,2,53,0,0
"Sweden","2025-01-08",0,0,39,0,2,55,0,0
"Sweden","2025-01-09",0,0,39,0,2,57,0,0
"Sweden","2025-01-10",0,20,59,0,2,59,0,0
"Sweden","2025-01-11",0,0,59,0,0,59,0,0
"Sweden","2025-01-12",0,0,59,0,0,59,0,0
"Sweden","2025-01-13",0,0,59,0,0,59,0,0
"Sweden","2025-01-14",0,0,59,0,0,59,0,0
"Sweden","2025-01-15",0,0,59,0,0,59,0,0
"Sweden","2025-01-16",0,0,59,0,0,59,0,0
"Sweden","2025-01-17",0,0,59,0,0,59,0,0
"Sweden","2025-01-18",0,0,59,0,0,59,0,0
"Sweden","2025-01-19",0,0,59,0,0,59,0,0
"Sweden","2025-01-20",0,0,59,0,0,59,0,0
"Sweden","2025-01-21",0,0,59,0,0,59,0,0
"Sweden","2025-01-22",0,0,59,0,0,59,0,0
"Sweden","2025-01-23",0,0,59,0,0,59,0,0
"Sweden","2025-01-24",0,0,59,0,0,59,0,0
"Sweden","2025-01-25",0,0,59,0,0,59,0,0
"Sweden","2025-01-26",0,0,59,0,0,59,0,0
"Sweden","2025-01-27",0,0,59,0,0,59,0,0
"Sweden","2025-01-28",0,0,59,0,0,59,0,0
"Sweden","2025-01-29",0,0,59,0,0,59,0,0
"Sweden","2025-01-30",0,0,59,0,0,59,0,0
"Sweden","2025-01-31",0,0,59,0,0,59,0,0
"Sweden","2025-02-01",0,0,59,0,0,59,0,0
"Sweden","2025-02-02",0,0,59,0,0,59,0,0
"Sweden","2025-02-03",0,0,59,0,0,59,0,0
"Sweden","2025-02-04",0,0,59,0,0,59,0,0
"Sweden","2025-02-05",0,0,59,0,0,59,0,0
"Sweden","2025-02-06",0,0,59,0,0,59,0,0
"Sweden","2025-02-07",0,0,59,0,0,59,0,0
"Sweden","2025-02-08",0,0,59,0,0,59,0,0
"Sweden","2025-02-09",0,0,59,0,0,59,0,0
"Sweden","2025-02-10",0,0,59,0,0,59,0,0
"Sweden","2025-02-11",0,0,59,0,0,59,0,0
"Sweden","2025-02-12",0,0,59,0,0,59,0,0
"Sweden","2025-02-13",0,0,59,0,0,59,0,0
"Sweden","2025-02-14",0,0,59,0,0,59,0,0
"Sweden","2025-02-15",0,0,59,0,0,59,0,0
"Sweden","2025-02-16",0,0,59,0,0,59,0,0
"Sweden","2025-02-17",0,0,59,0,0,59,0,0
"Sweden","2025-02-18",0,0,59,0,0,59,0,0
"Sweden","2025-02-19",0,0,59,0,0,59,0,0
"Sweden","2025-02-20",0,0,59,0,0,59,0,0
"Sweden","2025-02-21",0,0,59,0,0,59,0,0
"Sweden","2025-02-22",0,0,59,0,0,59,0,0
"Sweden","2025-02-23",0,0,59,0,0,59,0,0
"Sweden","2025-02-24",0,0,59,0,0,59,0,0
"Sweden","2025-02-25",0,0,59,0,0,59,0,0
"Sweden","2025-02-26",0,0,59,0,0,59,0,0
"Sweden","2025-02-27",0,0,59,0,0,59,0,0
"Sweden","2025-02-28",0,0,59,0,0,59,0,0
"Sweden","2025-03-01",0,0,59,0,0,59,0,0
"Sweden","2025-03-02",0,0,59,0,0,59,0,0
"Sweden","2025-03-03",0,0,59,0,0,59,0,0
"Switzerland","2024-01-01",0,0,0,0,0,0,0,0
"Switzerland","2024-01-02",0,0,0,0,0,0,0,0
"Switzerland","2024-01-03",0,0,0,0,0,0,0,0
"Switzerland","2024-01-04",0,0,0,0,0,0,0,0
"Switzerland","2024-01-05",0,0,0,0,0,0,0,0
"Switzerland","2024-01-06",0,0,0,0,0,0,0,0
"Switzerland","2024-01-07",0,0,0,0,0,0,0,0
"Switzerland","2024-01-08",0,0,0,0,0,0,0,0
"Switzerland","2024-01-09",0,0,0,0,0,0,0,0
"Switzerland","2024-01-10",0,0,0,0,0,0,0,0
"Switzerland","2024-01-11",0,0,0,0,0,0,0,0
"Switzerland","2024-01-12",0,0,0,0,0,0,0,0
"Switzerland","2024-01-13",0,0,0,0,0,0,0,0
"Switzerland","2024-01-14",0,0,0,0,0,0,0,0
"Switzerland","2024-01-15",0,0,0,0,0,0,0,0
"Switzerland","2024-01-16",0,0,0,0,0,0,0,0
"Switzerland","2024-01-17",0,0,0,0,0,0,0,0
"Switzerland","2024-01-18",0,0,0,0,0,0,0,0
"Switzerland","2024-01-19",0,0,0,0,0,0,0,0
"Switzerland","2024-01-20",0,0,0,0,0,0,0,0
"Switzerland","2024-01-21",0,0,0,0,0,0,0,0
"Switzerland","2024-01-22",0,0,0,0,0,0,0,0
"Switzerland","2024-01-23",0,0,0,0,0,0,0,0
"Switzerland","2024-01-24",0,0,0,0,0,0,0,0
"Switzerland","2024-01-25",0,0,0,0,0,0,0,0
"Switzerland","2024-01-26",0,0,0,0,0,0,0,0
"Switzerland","2024-01-27",0,0,0,0,0,0,0,0
"Switzerland","2024-01-28",0,0,0,0,0,0,0,0
"Switzerland","2024-01-29",0,0,0,0,0,0,0,0
"Switzerland","2024-01-30",0,0,0,0,0,0,0,0
"Switzerland","2024-01-31",0,9,9,0,9,9,0,0
"Switzerland","2024-02-01",0,0,9,0,0,9,0,0
"Switzerland","2024-02-02",0,0,9,0,0,9,0,0
"Switzerland","2024-02-03",0,0,9,0,1,10,0,0
"Switzerland","2024-02-04",0,0,9,0,0,10,0,0
"Switzerland","2024-02-05",0,0,9,0,0,10,0,0
"Switzerland","2024-02-06",0,0,9,0,0,10,0,0
"Switzerland","2024-02-07",0,0,9,0,1,11,0,0
"Switzerland","2024-02-08",0,0,9,0,0,11,0,0
"Switzerland","2024-02-09",0,0,9,0,0,11,0,0
"Switzerland","2024-02-10",0,0,9,0,0,11,0,0
"Switzerland","2024-02-11",0,0,9,0,1,12,0,0
"Switzerland","2024-02-12",0,0,9,0,0,12,0,0
"Switzerland","2024-02-13",0,0,9,0,0,12,0,0
"Switzerland","2024-02-14",0,0,9,0,0,12,0,0
"Switzerland","2024-02-15",0,0,9,0,1,13,0,0
"Switzerland","2024-02-16",0,0,9,0,0,13,0,0
"Switzerland","2024-02-17",0,0,9,0,0,13,0,0
"Switzerland","2024-02-18",0,0,9,0,0,13,0,0
"Switzerland","2024-02-19",0,0,9,0,1,14,0,0
"Switzerland","2024-02-20",0,0,9,0,0,14,0,0
"Switzerland","2024-02-21",0,0,9,0,0,14,0,0
"Switzerland","2024-02-22",0,0,9,0,0,14,0,0
"Switzerland","2024-02-23",0,0,9,0,1,15,0,0
"Switzerland","2024-02-24",0,0,9,0,0,15,0,0
"Switzerland","2024-02-25",0,0,9,0,0,15,0,0
"Switzerland","2024-02-26",0,0,9,0,0,15,0,0
"Switzerland","2024-02-27",0,0,9,0,1,16,0,0
"Switzerland","2024-02-28",0,0,9,0,0,16,0,0
"Switzerland","2024-02-29",0,7,16,0,0,16,0,0
"Switzerland","2024-03-01",0,0,16,0,0,16,0,0
"Switzerland","2024-03-02",0,0,16,0,0,16,0,0
"Switzerland","2024-03-03",0,0,16,0,0,16,0,0
"Switzerland","2024-03-04",0,0,16,0,0,16,0,0
"Switzerland","2024-03-05",0,0,16,0,0,16,0,0
"Switzerland","2024-03-06",0,0,16,0,0,16,0,0
"Switzerland","2024-03-07",0,0,16,0,0,16,0,0
"Switzerland","2024-03-08",0,0,16,0,0,16,0,0
"Switzerland","2024-03-09",0,0,16,0,0,16,0,0
"Switzerland","2024-03-10",0,0,16,0,0,16,0,0
"Switzerland","2024-03-11",0,0,16,0,1,17,0,0
"Switzerland","2024-03-12",0,0,16,0,0,17,0,0
"Switzerland","2024-03-13",0,0,16,0,0,17,0,0
"Switzerland","2024-03-14",0,0,16,0,0,17,0,0
"Switzerland","2024-03-15",0,0,16,0,0,17,0,0
"Switzerland","2024-03-16",0,0,16,0,0,17,0,0
"Switzerland","2024-03-17",0,0,16,0,0,17,0,0
"Switzerland","2024-03-18",0,0,16,0,0,17,0,0
"Switzerland","2024-03-19",0,0,16,0,0,17,0,0
"Switzerland","2024-03-20",0,0,16,0,0,17,0,0
"Switzerland","2024-03-21",0,0,16,0,0,17,0,0
"Switzerland","2024-03-22",0,0,16,0,0,17,0,0
"Switzerland","2024-03-23",0,0,16,0,0,17,0,0
"Switzerland","2024-03-24",0,0,16,0,0,17,0,0
"Switzerland","2024-03-25",0,0,16,0,0,17,0,0
"Switzerland","2024-03-26",0,0,16,0,0,17,0,0
"Switzerland","2024-03-27",0,0,16,0,0,17,0,0
"Switzerland","2024-03-28",0,0,16,0,0,17,0,0
"Switzerland","2024-03-29",0,0,16,0,0,17,0,0
"Switzerland","2024-03-30",0,0,16,0,0,17,0,0
"Switzerland","2024-03-31",0,0,16,0,1,18,0,0
"Switzerland","2024-04-01",0,0,16,0,0,18,0,0
"Switzerland","2024-04-02",0,0,16,0,0,18,0,0
"Switzerland","2024-04-03",0,0,16,0,0,18,0,0
"Switzerland","2024-04-04",0,0,16,0,0,18,0,0
"Switzerland","2024-04-05",0,0,16,0,0,18,0,0
"Switzerland","2024-04-06",0,0,16,0,0,18,0,0
"Switzerland","2024-04-07",0,0,16,0,0,18,0,0
"Switzerland","2024-04-08",0,0,16,0,0,18,0,0
"Switzerland","2024-04-09",0,0,16,0,0,18,0,0
"Switzerland","2024-04-10",0,0,16,0,0,18,0,0
"Switzerland","2024-04-11",0,0,16,0,0,18,0,0
"Switzerland","2024-04-12",0,0,16,0,0,18,0,0
"Switzerland","2024-04-13",0,0,16,0,0,18,0,0
"Switzerland","2024-04-14",0,0,16,0,0,18,0,0
"Switzerland","2024-04-15",0,0,16,0,0,18,0,0
"Switzerland","2024-04-16",0,0,16,0,0,18,0,0
"Switzerland","2024-04-17",0,0,16,0,0,18,0,0
"Switzerland","2024-04-18",0,0,16,0,0,18,0,0
"Switzerland","2024-04-19",0,0,16,0,0,18,0,0
"Switzerland","2024-04-20",0,0,16,0,0,18,0,0
"Switzerland","2024-04-21",0,0,16,0,1,19,0,0
"Switzerland","2024-04-22",0,0,16,0,0,19,0,0
"Switzerland","2024-04-23",0,0,16,0,0,19,0,0
"Switzerland","2024-04-24",0,0,16,0,0,19,0,0
"Switzerland","2024-04-25",0,0,16,0,0,19,0,0
"Switzerland","2024-04-26",0,0,16,0,0,19,0,0
"Switzerland","2024-04-27",0,0,16,0,0,19,0,0
"Switzerland","2024-04-28",0,0,16,0,0,19,0,0
"Switzerland","2024-04-29",0,0,16,0,0,19,0,0
"Switzerland","2024-04-30",0,0,16,0,0,19,0,0
"Switzerland","2024-05-01",0,0,16,0,0,19,0,0
"Switzerland","2024-05-02",0,0,16,0,0,19,0,0
"Switzerland","2024-05-03",0,0,16,0,0,19,0,0
"Switzerland","2024-05-04",0,0,16,0,0,19,0,0
"Switzerland","2024-05-05",0,0,16,0,0,19,0,0
"Switzerland","2024-05-06",0,0,16,0,0,19,0,0
"Switzerland","2024-05-07",0,0,16,0,0,19,0,0
"Switzerland","2024-05-08",0,0,16,0,0,19,0,0
"Switzerland","2024-05-09",0,0,16,0,0,19,0,0
"Switzerland","2024-05-10",0,0,16,0,0,19,0,0
"Switzerland","2024-05-11",0,0,16,0,1,20,0,0
"Switzerland","2024-05-12",0,0,16,0,0,20,0,0
"Switzerland","2024-05-13",0,0,16,0,0,20,0,0
"Switzerland","2024-05-14",0,0,16,0,0,20,0,0
"Switzerland","2024-05-15",0,0,16,0,0,20,0,0
"Switzerland","2024-05-16",0,0,16,0,0,20,0,0
"Switzerland","2024-05-17",0,0,16,0,0,20,0,0
"Switzerland","2024-05-18",0,0,16,0,0,20,0,0
"Switzerland","2024-05-19",0,0,16,0,0,20,0,0
"Switzerland","2024-05-20",0,0,16,0,0,20,0,0
"Switzerland","2024-05-21",0,0,16,0,0,20,0,0
"Switzerland","2024-05-22",0,0,16,0,0,20,0,0
"Switzerland","2024-05-23",0,0,16,0,0,20,0,0
"Switzerland","2024-05-24",0,0,16,0,0,20,0,0
"Switzerland","2024-05-25",0,0,16,0,0,20,0,0
"Switzerland","2024-05-26",0,0,16,0,0,20,0,0
"Switzerland","2024-05-27",0,0,16,0,0,20,0,0
"Switzerland","2024-05-28",0,0,16,0,0,20,0,0
"Switzerland","2024-05-29",0,0,16,0,0,20,0,0
"Switzerland","2024-05-30",0,0,16,0,0,20,0,0
"Switzerland","2024-05-31",0,0,16,0,0,20,0,0
"Switzerland","2024-06-01",0,0,16,0,1,21,0,0
"Switzerland","2024-06-02",0,0,16,0,0,21,0,0
"Switzerland","2024-06-03",0,0,16,0,0,21,0,0
"Switzerland","2024-06-04",0,0,16,0,0,21,0,0
"Switzerland","2024-06-05",0,0,16,0,0,21,0,0
"Switzerland","2024-06-06",0,0,16,0,0,21,0,0
"Switzerland","2024-06-07",0,0,16,0,0,21,0,0
"Switzerland","2024-06-08",0,0,16,0,0,21,0,0
"Switzerland","2024-06-09",0,0,16,0,0,21,0,0
"Switzerland","2024-06-10",0,0,16,0,0,21,0,0
"Switzerland","2024-06-11",0,0,16,0,0,21,0,0
"Switzerland","2024-06-12",0,0,16,0,0,21,0,0
"Switzerland","2024-06-13",0,0,16,0,0,21,0,0
"Switzerland","2024-06-14",0,0,16,0,0,21,0,0
"Switzerland","2024-06-15",0,0,16,0,0,21,0,0
"Switzerland","2024-06-16",0,0,16,0,0,21,0,0
"Switzerland","2024-06-17",0,0,16,0,0,21,0,0
"Switzerland","2024-06-18",0,0,16,0,0,21,0,0
"Switzerland","2024-06-19",0,0,16,0,0,21,0,0
"Switzerland","2024-06-20",0,0,16,0,0,21,0,0
"Switzerland","2024-06-21",0,0,16,0,1,22,0,0
"Switzerland","2024-06-22",0,0,16,0,0,22,0,0
"Switzerland","2024-06-23",0,0,16,0,0,22,0,0
"Switzerland","2024-06-24",0,0,16,0,0,22,0,0
"Switzerland","2024-06-25",0,0,16,0,0,22,0,0
"Switzerland","2024-06-26",0,0,16,0,0,22,0,0
"Switzerland","2024-06-27",0,0,16,0,0,22,0,0
"Switzerland","2024-06-28",0,0,16,0,0,22,0,0
"Switzerland","2024-06-29",0,0,16,0,0,22,0,0
"Switzerland","2024-06-30",0,0,16,0,0,22,0,0
"Switzerland","2024-07-01",0,0,16,0,0,22,0,0
"Switzerland","2024-07-02",0,0,16,0,0,22,0,0
"Switzerland","2024-07-03",0,0,16,0,0,22,0,0
"Switzerland","2024-07-04",0,0,16,0,0,22,0,0
"Switzerland","2024-07-05",0,0,16,0,0,22,0,0
"Switzerland","2024-07-06",0,0,16,0,0,22,0,0
"Switzerland","2024-07-07",0,0,16,0,0,22,0,0
"Switzerland","2024-07-08",0,0,16,0,0,22,0,0
"Switzerland","2024-07-09",0,0,16,0,0,22,0,0
"Switzerland","2024-07-10",0,0,16,0,0,22,0,0
"Switzerland","2024-07-11",0,0,16,0,1,23,0,0
"Switzerland","2024-07-12",0,0,16,0,0,23,0,0
"Switzerland","2024-07-13",0,0,16,0,0,23,0,0
"Switzerland","2024-07-14",0,0,16,0,0,23,0,0
"Switzerland","2024-07-15",0,0,16,0,0,23,0,0
"Switzerland","2024-07-16",0,0,16,0,0,23,0,0
"Switzerland","2024-07-17",0,0,16,0,0,23,0,0
"Switzerland","2024-07-18",0,0,16,0,0,23,0,0
"Switzerland","2024-07-19",0,0,16,0,0,23,0,0
"Switzerland","2024-07-20",0,0,16,0,0,23,0,0
"Switzerland","2024-07-21",0,0,16,0,0,23,0,0
"Switzerland","2024-07-22",0,0,16,0,0,23,0,0
"Switzerland","2024-07-23",0,0,16,0,0,23,0,0
"Switzerland","2024-07-24",0,0,16,0,0,23,0,0
"Switzerland","2024-07-25",0,0,16,0,0,23,0,0
"Switzerland","2024-07-26",0,0,16,0,0,23,0,0
"Switzerland","2024-07-27",0,0,16,0,0,23,0,0
"Switzerland","2024-07-28",0,0,16,0,0,23,0,0
"Switzerland","2024-07-29",0,0,16,0,0,23,0,0
"Switzerland","2024-07-30",0,0,16,0,0,23,0,0
"Switzerland","2024-07-31",0,0,16,0,0,23,0,0
"Switzerland","2024-08-01",0,0,16,0,1,24,0,0
"Switzerland","2024-08-02",0,0,16,0,0,24,0,0
"Switzerland","2024-08-03",0,0,16,0,0,24,0,0
"Switzerland","2024-08-04",0,0,16,0,0,24,0,0
"Switzerland","2024-08-05",0,0,16,0,0,24,0,0
"Switzerland","2024-08-06",0,0,16,0,0,24,0,0
"Switzerland","2024-08-07",0,0,16,0,0,24,0,0
"Switzerland","2024-08-08",0,0,16,0,0,24,0,0
"Switzerland","2024-08-09",0,0,16,0,0,24,0,0
"Switzerland","2024-08-10",0,0,16,0,0,24,0,0
"Switzerland","2024-08-11",0,0,16,0,0,24,0,0
"Switzerland","2024-08-12",0,0,16,0,0,24,0,0
"Switzerland","2024-08-13",0,0,16,0,0,24,0,0
"Switzerland","2024-08-14",0,0,16,0,0,24,0,0
"Switzerland","2024-08-15",0,0,16,0,0,24,0,0
"Switzerland","2024-08-16",0,0,16,0,0,24,0,0
"Switzerland","2024-08-17",0,0,16,0,0,24,0,0
"Switzerland","2024-08-18",0,0,16,0,0,24,0,0
"Switzerland","2024-08-19",0,0,16,0,0,24,0,0
"Switzerland","2024-08-20",0,0,16,0,0,24,0,0
"Switzerland","2024-08-21",0,0,16,0,1,25,0,0
"Switzerland","2024-08-22",0,0,16,0,0,25,0,0
"Switzerland","2024-08-23",0,0,16,0,0,25,0,0
"Switzerland","2024-08-24",0,0,16,0,0,25,0,0
"Switzerland","2024-08-25",0,0,16,0,0,25,0,0
"Switzerland","2024-08-26",0,0,16,0,0,25,0,0
"Switzerland","2024-08-27",0,0,16,0,0,25,0,0
"Switzerland","2024-08-28",0,0,16,0,0,25,0,0
"Switzerland","2024-08-29",0,0,16,0,0,25,0,0
"Switzerland","2024-08-30",0,0,16,0,0,25,0,0
"Switzerland","2024-08-31",0,9,25,0,0,25,0,0
"Switzerland","2024-09-01",0,0,25,0,0,25,0,0
"Switzerland","2024-09-02",0,0,25,0,0,25,0,0
"Switzerland","2024-09-03",0,0,25,0,0,25,0,0
"Switzerland","2024-09-04",0,0,25,0,1,26,0,0
"Switzerland","2024-09-05",0,0,25,0,0,26,0,0
"Switzerland","2024-09-06",0,0,25,0,0,26,0,0
"Switzerland","2024-09-07",0,0,25,0,0,26,0,0
"Switzerland","2024-09-08",0,0,25,0,0,26,0,0
"Switzerland","2024-09-09",0,0,25,0,0,26,0,0
"Switzerland","2024-09-10",0,0,25,0,0,26,0,0
"Switzerland","2024-09-11",0,0,25,0,0,26,0,0
"Switzerland","2024-09-12",0,0,25,0,1,27,0,0
"Switzerland","2024-09-13",0,0,25,0,0,27,0,0
"Switzerland","2024-09-14",0,0,25,0,0,27,0,0
"Switzerland","2024-09-15",0,0,25,0,0,27,0,0
"Switzerland","2024-09-16",0,0,25,0,0,27,0,0
"Switzerland","2024-09-17",0,0,25,0,0,27,0,0
"Switzerland","2024-09-18",0,0,25,0,0,27,0,0
"Switzerland","2024-09-19",0,0,25,0,1,28,0,0
"Switzerland","2024-09-20",0,0,25,0,0,28,0,0
"Switzerland","2024-09-21",0,0,25,0,0,28,0,0
"Switzerland","2024-09-22",0,0,25,0,0,28,0,0
"Switzerland","2024-09-23",0,0,25,0,0,28,0,0
"Switzerland","2024-09-24",0,0,25,0,0,28,0,0
"Switzerland","2024-09-25",0,0,25,0,0,28,0,0
"Switzerland","2024-09-26",0,0,25,0,0,28,0,0
"Switzerland","2024-09-27",0,0,25,0,1,29,0,0
"Switzerland","2024-09-28",0,0,25,0,0,29,0,0
"Switzerland","2024-09-29",0,0,25,0,0,29,0,0
"Switzerland","2024-09-30",0,4,29,0,0,29,0,0
"Switzerland","2024-10-01",0,0,29,0,0,29,0,0
"Switzerland","2024-10-02",0,0,29,0,0,29,0,0
"Switzerland","2024-10-03",0,0,29,0,0,29,0,0
"Switzerland","2024-10-04",0,0,29,0,1,30,0,0
"Switzerland","2024-10-05",0,0,29,0,0,30,0,0
"Switzerland","2024-10-06",0,0,29,0,0,30,0,0
"Switzerland","2024-10-07",0,0,29,0,0,30,0,0
"Switzerland","2024-10-08",0,0,29,0,0,30,0,0
"Switzerland","2024-10-09",0,0,29,0,0,30,0,0
"Switzerland","2024-10-10",0,0,29,0,0,30,0,0
"Switzerland","2024-10-11",0,0,29,0,0,30,0,0
"Switzerland","2024-10-12",0,0,29,0,1,31,0,0
"Switzerland","2024-10-13",0,0,29,0,0,31,0,0
"Switzerland","2024-10-14",0,0,29,0,0,31,0,0
"Switzerland","2024-10-15",0,0,29,0,0,31,0,0
"Switzerland","2024-10-16",0,0,29,0,0,31,0,0
"Switzerland","2024-10-17",0,0,29,0,0,31,0,0
"Switzerland","2024-10-18",0,0,29,0,0,31,0,0
"Switzerland","2024-10-19",0,0,29,0,0,31,0,0
"Switzerland","2024-10-20",0,0,29,0,1,32,0,0
"Switzerland","2024-10-21",0,0,29,0,0,32,0,0
"Switzerland","2024-10-22",0,0,29,0,0,32,0,0
"Switzerland","2024-10-23",0,0,29,0,0,32,0,0
"Switzerland","2024-10-24",0,0,29,0,0,32,0,0
"Switzerland","2024-10-25",0,0,29,0,0,32,0,0
"Switzerland","2024-10-26",0,0,29,0,0,32,0,0
"Switzerland","2024-10-27",0,0,29,0,0,32,0,0
"Switzerland","2024-10-28",0,0,29,0,1,33,0,0
"Switzerland","2024-10-29",0,0,29,0,0,33,0,0
"Switzerland","2024-10-30",0,0,29,0,0,33,0,0
"Switzerland","2024-10-31",0,4,33,0,0,33,0,0
"Switzerland","2024-11-01",0,0,33,0,0,33,0,0
"Switzerland","2024-11-02",0,0,33,0,0,33,0,0
"Switzerland","2024-11-03",0,0,33,0,0,33,0,0
"Switzerland","2024-11-04",0,0,33,0,0,33,0,0
"Switzerland","2024-11-05",0,0,33,0,0,33,0,0
"Switzerland","2024-11-06",0,0,33,0,0,33,0,0
"Switzerland","2024-11-07",0,0,33,0,0,33,0,0
"Switzerland","2024-11-08",0,0,33,0,1,34,0,0
"Switzerland","2024-11-09",0,0,33,0,0,34,0,0
"Switzerland","2024-11-10",0,0,33,0,0,34,0,0
"Switzerland","2024-11-11",0,0,33,0,0,34,0,0
"Switzerland","2024-11-12",0,0,33,0,0,34,0,0
"Switzerland","2024-11-13",0,0,33,0,0,34,0,0
"Switzerland","2024-11-14",0,0,33,0,0,34,0,0
"Switzerland","2024-11-15",0,0,33,0,0,34,0,0
"Switzerland","2024-11-16",0,0,33,0,0,34,0,0
"Switzerland","2024-11-17",0,0,33,0,0,34,0,0
"Switzerland","2024-11-18",0,0,33,0,0,34,0,0
"Switzerland","2024-11-19",0,0,33,0,0,34,0,0
"Switzerland","2024-11-20",0,0,33,0,0,34,0,0
"Switzerland","2024-11-21",0,0,33,0,0,34,0,0
"Switzerland","2024-11-22",0,0,33,0,0,34,0,0
"Switzerland","2024-11-23",0,0,33,0,1,35,0,0
"Switzerland","2024-11-24",0,0,33,0,0,35,0,0
"Switzerland","2024-11-25",0,0,33,0,0,35,0,0
"Switzerland","2024-11-26",0,0,33,0,0,35,0,0
"Switzerland","2024-11-27",0,0,33,0,0,35,0,0
"Switzerland","2024-11-28",0,0,33,0,0,35,0,0
"Switzerland","2024-11-29",0,0,33,0,0,35,0,0
"Switzerland","2024-11-30",0,0,33,0,0,35,0,0
"Switzerland","2024-12-01",0,0,33,0,0,35,0,0
"Switzerland","2024-12-02",0,0,33,0,0,35,0,0
"Switzerland","2024-12-03",0,0,33,0,0,35,0,0
"Switzerland","2024-12-04",0,0,33,0,0,35,0,0
"Switzerland","2024-12-05",0,0,33,0,0,35,0,0
"Switzerland","2024-12-06",0,0,33,0,0,35,0,0
"Switzerland","2024-12-07",0,0,33,0,0,35,0,0
"Switzerland","2024-12-08",0,0,33,0,0,35,0,0
"Switzerland","2024-12-09",0,0,33,0,1,36,0,0
"Switzerland","2024-12-10",0,0,33,0,0,36,0,0
"Switzerland","2024-12-11",0,0,33,0,0,36,0,0
"Switzerland","2024-12-12",0,0,33,0,0,36,0,0
"Switzerland","2024-12-13",0,0,33,0,0,36,0,0
"Switzerland","2024-12-14",0,0,33,0,0,36,0,0
"Switzerland","2024-12-15",0,0,33,0,0,36,0,0
"Switzerland","2024-12-16",0,0,33,0,0,36,0,0
"Switzerland","2024-12-17",0,0,33,0,0,36,0,0
"Switzerland","2024-12-18",0,0,33,0,0,36,0,0
"Switzerland","2024-12-19",0,0,33,0,0,36,0,0
"Switzerland","2024-12-20",0,0,33,0,0,36,0,0
"Switzerland","2024-12-21",0,0,33,0,0,36,0,0
"Switzerland","2024-12-22",0,0,33,0,0,36,0,0
"Switzerland","2024-12-23",0,0,33,0,0,36,0,0
"Switzerland","2024-12-24",0,0,33,0,1,37,0,0
"Switzerland","2024-12-25",0,0,33,0,0,37,0,0
"Switzerland","2024-12-26",0,0,33,0,0,37,0,0
"Switzerland","2024-12-27",0,0,33,0,0,37,0,0
"Switzerland","2024-12-28",0,0,33,0,0,37,0,0
"Switzerland","2024-12-29",0,0,33,0,0,37,0,0
"Switzerland","2024-12-30",0,0,33,0,0,37,0,0
"Switzerland","2024-12-31",0,4,37,0,0,37,0,0
"Switzerland","2025-01-01",0,0,37,0,0,37,0,0
"Switzerland","2025-01-02",0,0,37,0,0,37,0,0
"Switzerland","2025-01-03",0,0,37,0,0,37,0,0
"Switzerland","2025-01-04",0,0,37,0,0,37,0,0
"Switzerland","2025-01-05",0,0,37,0,0,37,0,0
"Switzerland","2025-01-06",0,0,37,0,0,37,0,0
"Switzerland","2025-01-07",0,0,37,0,0,37,0,0
"Switzerland","2025-01-08",0,0,37,0,0,37,0,0
"Switzerland","2025-01-09",0,0,37,0,0,37,0,0
"Switzerland","2025-01-10",0,0,37,0,0,37,0,0
"Switzerland","2025-01-11",0,0,37,0,0,37,0,0
"Switzerland","2025-01-12",0,0,37,0,0,37,0,0
"Switzerland","2025-01-13",0,0,37,0,0,37,0,0
"Switzerland","2025-01-14",0,0,37,0,0,37,0,0
"Switzerland","2025-01-15",0,0,37,0,0,37,0,0
"Switzerland","2025-01-16",0,0,37,0,0,37,0,0
"Switzerland","2025-01-17",0,0,37,0,0,37,0,0
"Switzerland","2025-01-18",0,0,37,0,0,37,0,0
"Switzerland","2025-01-19",0,0,37,0,0,37,0,0
"Switzerland","2025-01-20",0,0,37,0,0,37,0,0
"Switzerland","2025-01-21",0,0,37,0,0,37,0,0
"Switzerland","2025-01-22",0,0,37,0,0,37,0,0
"Switzerland","2025-01-23",0,0,37,0,0,37,0,0
"Switzerland","2025-01-24",0,0,37,0,0,37,0,0
"Switzerland","2025-01-25",0,0,37,0,0,37,0,0
"Switzerland","2025-01-26",0,0,37,0,0,37,0,0
"Switzerland","2025-01-27",0,0,37,0,0,37,0,0
"Switzerland","2025-01-28",0,0,37,0,0,37,0,0
"Switzerland","2025-01-29",0,0,37,0,0,37,0,0
"Switzerland","2025-01-30",0,0,37,0,0,37,0,0
"Switzerland","2025-01-31",0,0,37,0,0,37,0,0
"Switzerland","2025-02-01",0,0,37,0,0,37,0,0
"Switzerland","2025-02-02",0,0,37,0,0,37,0,0
"Switzerland","2025-02-03",0,0,37,0,0,37,0,0
"Switzerland","2025-02-04",0,0,37,0,0,37,0,0
"Switzerland","2025-02-05",0,0,37,0,0,37,0,0
"Switzerland","2025-02-06",0,0,37,0,0,37,0,0
"Switzerland","2025-02-07",0,0,37,0,0,37,0,0
"Switzerland","2025-02-08",0,0,37,0,0,37,0,0
"Switzerland","2025-02-09",0,0,37,0,0,37,0,0
"Switzerland","2025-02-10",0,0,37,0,0,37,0,0
"Switzerland","2025-02-11",0,0,37,0,0,37,0,0
"Switzerland","2025-02-12",0,0,37,0,0,37,0,0
"Switzerland","2025-02-13",0,0,37,0,0,37,0,0
"Switzerland","2025-02-14",0,0,37,0,0,37,0,0
"Switzerland","2025-02-15",0,0,37,0,0,37,0,0
"Switzerland","2025-02-16",0,0,37,0,0,37,0,0
"Switzerland","2025-02-17",0,0,37,0,0,37,0,0
"Switzerland","2025-02-18",0,0,37,0,0,37,0,0
"Switzerland","2025-02-19",0,0,37,0,0,37,0,0
"Switzerland","2025-02-20",0,0,37,0,0,37,0,0
"Switzerland","2025-02-21",0,0,37,0,0,37,0,0
"Switzerland","2025-02-22",0,0,37,0,0,37,0,0
"Switzerland","2025-02-23",0,0,37,0,0,37,0,0
"Switzerland","2025-02-24",0,0,37,0,0,37,0,0
"Switzerland","2025-02-25",0,0,37,0,0,37,0,0
"Switzerland","2025-02-26",0,0,37,0,0,37,0,0
"Switzerland","2025-02-27",0,0,37,0,0,37,0,0
"Switzerland","2025-02-28",0,0,37,0,0,37,0,0
"Switzerland","2025-03-01",0,0,37,0,0,37,0,0
"Switzerland","2025-03-02",0,0,37,0,0,37,0,0
"Switzerland","2025-03-03",0,0,37,0,0,37,0,0
"Thailand","2024-01-01",0,0,0,0,0,0,0,0
"Thailand","2024-01-02",0,0,0,0,0,0,0,0
"Thailand","2024-01-03",0,0,0,0,0,0,0,0
"Thailand","2024-01-04",0,0,0,0,0,0,0,0
"Thailand","2024-01-05",0,0,0,0,0,0,0,0
"Thailand","2024-01-06",0,0,0,0,0,0,0,0
"Thailand","2024-01-07",0,0,0,0,0,0,0,0
"Thailand","2024-01-08",0,0,0,0,0,0,0,0
"Thailand","2024-01-09",0,0,0,0,0,0,0,0
"Thailand","2024-01-10",0,0,0,0,0,0,0,0
"Thailand","2024-01-11",0,0,0,0,0,0,0,0
"Thailand","2024-01-12",0,0,0,0,0,0,0,0
"Thailand","2024-01-13",0,0,0,0,0,0,0,0
"Thailand","2024-01-14",0,0,0,0,0,0,0,0
"Thailand","2024-01-15",0,0,0,0,0,0,0,0
"Thailand","2024-01-16",0,0,0,0,0,0,0,0
"Thailand","2024-01-17",0,0,0,0,0,0,0,0
"Thailand","2024-01-18",0,0,0,0,0,0,0,0
"Thailand","2024-01-19",0,0,0,0,0,0,0,0
"Thailand","2024-01-20",0,0,0,0,0,0,0,0
"Thailand","2024-01-21",0,0,0,0,0,0,0,0
"Thailand","2024-01-22",0,0,0,0,0,0,0,0
"Thailand","2024-01-23",0,0,0,0,0,0,0,0
"Thailand","2024-01-24",0,0,0,0,0,0,0,0
"Thailand","2024-01-25",0,0,0,0,0,0,0,0
"Thailand","2024-01-26",0,0,0,0,0,0,0,0
"Thailand","2024-01-27",0,0,0,0,0,0,0,0
"Thailand","2024-01-28",0,0,0,0,0,0,0,0
"Thailand","2024-01-29",0,0,0,0,0,0,0,0
"Thailand","2024-01-30",0,0,0,0,0,0,0,0
"Thailand","2024-01-31",0,36,36,0,36,36,0,0
"Thailand","2024-02-01",0,0,36,0,1,37,0,0
"Thailand","2024-02-02",0,0,36,0,1,38,0,0
"Thailand","2024-02-03",0,0,36,0,0,38,0,0
"Thailand","2024-02-04",0,0,36,0,1,39,0,0
"Thailand","2024-02-05",0,0,36,0,1,40,0,0
"Thailand","2024-02-06",0,0,36,0,1,41,0,0
"Thailand","2024-02-07",0,0,36,0,0,41,0,0
"Thailand","2024-02-08",0,0,36,0,1,42,0,0
"Thailand","2024-02-09",0,0,36,0,1,43,0,0
"Thailand","2024-02-10",0,0,36,0,1,44,0,0
"Thailand","2024-02-11",0,0,36,0,0,44,0,0
"Thailand","2024-02-12",0,0,36,0,1,45,0,0
"Thailand","2024-02-13",0,0,36,0,1,46,0,0
"Thailand","2024-02-14",0,0,36,0,1,47,0,0
"Thailand","2024-02-15",0,0,36,0,0,47,0,0
"Thailand","2024-02-16",0,0,36,0,1,48,0,0
"Thailand","2024-02-17",0,0,36,0,1,49,0,0
"Thailand","2024-02-18",0,0,36,0,1,50,0,0
"Thailand","2024-02-19",0,0,36,0,0,50,0,0
"Thailand","2024-02-20",0,0,36,0,1,51,0,0
"Thailand","2024-02-21",0,0,36,0,1,52,0,0
"Thailand","2024-02-22",0,0,36,0,1,53,0,0
"Thailand","2024-02-23",0,0,36,0,0,53,0,0
"Thailand","2024-02-24",0,0,36,0,1,54,0,0
"Thailand","2024-02-25",0,0,36,0,1,55,0,0
"Thailand","2024-02-26",0,0,36,0,1,56,0,0
"Thailand","2024-02-27",0,0,36,0,0,56,0,0
"Thailand","2024-02-28",0,0,36,0,1,57,0,0
"Thailand","2024-02-29",0,22,58,0,1,58,0,0
"Thailand","2024-03-01",0,0,58,0,0,58,0,0
"Thailand","2024-03-02",0,0,58,0,1,59,0,0
"Thailand","2024-03-03",0,0,58,0,0,59,0,0
"Thailand","2024-03-04",0,0,58,0,1,60,0,0
"Thailand","2024-03-05",0,0,58,0,0,60,0,0
"Thailand","2024-03-06",0,0,58,0,0,60,0,0
"Thailand","2024-03-07",0,0,58,0,1,61,0,0
"Thailand","2024-03-08",0,0,58,0,0,61,0,0
"Thailand","2024-03-09",0,0,58,0,0,61,0,0
"Thailand","2024-03-10",0,0,58,0,1,62,0,0
"Thailand","2024-03-11",0,0,58,0,0,62,0,0
"Thailand","2024-03-12",0,0,58,0,1,63,0,0
"Thailand","2024-03-13",0,0,58,0,0,63,0,0
"Thailand","2024-03-14",0,0,58,0,0,63,0,0
"Thailand","2024-03-15",0,0,58,0,1,64,0,0
"Thailand","2024-03-16",0,0,58,0,0,64,0,0
"Thailand","2024-03-17",0,0,58,0,1,65,0,0
"Thailand","2024-03-18",0,0,58,0,0,65,0,0
"Thailand","2024-03-19",0,0,58,0,0,65,0,0
"Thailand","2024-03-20",0,0,58,0,1,66,0,0
"Thailand","2024-03-21",0,0,58,0,0,66,0,0
"Thailand","2024-03-22",0,0,58,0,1,67,0,0
"Thailand","2024-03-23",0,0,58,0,0,67,0,0
"Thailand","2024-03-24",0,0,58,0,0,67,0,0
"Thailand","2024-03-25",0,0,58,0,1,68,0,0
"Thailand","2024-03-26",0,0,58,0,0,68,0,0
"Thailand","2024-03-27",0,0,58,0,0,68,0,0
"Thailand","2024-03-28",0,0,58,0,1,69,0,0
"Thailand","2024-03-29",0,0,58,0,0,69,0,0
"Thailand","2024-03-30",0,0,58,0,1,70,0,0
"Thailand","2024-03-31",0,12,70,0,0,70,0,0
"Thailand","2024-04-01",0,6,76,0,6,76,0,0
"Thailand","2024-04-02",0,0,76,0,0,76,0,0
"Thailand","2024-04-03",0,0,76,0,1,77,0,0
"Thailand","2024-04-04",0,0,76,0,0,77,0,0
"Thailand","2024-04-05",0,0,76,0,1,78,0,0
"Thailand","2024-04-06",0,0,76,0,0,78,0,0
"Thailand","2024-04-07",0,0,76,0,1,79,0,0
"Thailand","2024-04-08",0,0,76,0,0,79,0,0
"Thailand","2024-04-09",0,0,76,0,1,80,0,0
"Thailand","2024-04-10",0,0,76,0,0,80,0,0
"Thailand","2024-04-11",0,0,76,0,0,80,0,0
"Thailand","2024-04-12",0,0,76,0,1,81,0,0
"Thailand","2024-04-13",0,0,76,0,0,81,0,0
"Thailand","2024-04-14",0,0,76,0,1,82,0,0
"Thailand","2024-04-15",0,0,76,0,0,82,0,0
"Thailand","2024-04-16",0,0,76,0,1,83,0,0
"Thailand","2024-04-17",0,0,76,0,0,83,0,0
"Thailand","2024-04-18",0,0,76,0,1,84,0,0
"Thailand","2024-04-19",0,0,76,0,0,84,0,0
"Thailand","2024-04-20",0,0,76,0,1,85,0,0
"Thailand","2024-04-21",0,0,76,0,0,85,0,0
"Thailand","2024-04-22",0,0,76,0,0,85,0,0
"Thailand","2024-04-23",0,0,76,0,1,86,0,0
"Thailand","2024-04-24",0,0,76,0,0,86,0,0
"Thailand","2024-04-25",0,0,76,0,1,87,0,0
"Thailand","2024-04-26",0,0,76,0,0,87,0,0
"Thailand","2024-04-27",0,0,76,0,1,88,0,0
"Thailand","2024-04-28",0,0,76,0,0,88,0,0
"Thailand","2024-04-29",0,0,76,0,1,89,0,0
"Thailand","2024-04-30",0,13,89,0,0,89,0,0
"Thailand","2024-05-01",0,0,89,0,1,90,0,0
"Thailand","2024-05-02",0,0,89,0,0,90,0,0
"Thailand","2024-05-03",0,0,89,0,1,91,0,0
"Thailand","2024-05-04",0,0,89,0,1,92,0,0
"Thailand","2024-05-05",0,0,89,0,0,92,0,0
"Thailand","2024-05-06",0,0,89,0,1,93,0,0
"Thailand","2024-05-07",0,0,89,0,1,94,0,0
"Thailand","2024-05-08",0,0,89,0,0,94,0,0
"Thailand","2024-05-09",0,0,89,0,1,95,0,0
"Thailand","2024-05-10",0,0,89,0,1,96,0,0
"Thailand","2024-05-11",0,0,89,0,0,96,0,0
"Thailand","2024-05-12",0,0,89,0,1,97,0,0
"Thailand","2024-05-13",0,0,89,0,1,98,0,0
"Thailand","2024-05-14",0,0,89,0,0,98,0,0
"Thailand","2024-05-15",0,0,89,0,1,99,0,0
"Thailand","2024-05-16",0,0,89,0,1,100,0,0
"Thailand","2024-05-17",0,0,89,0,1,101,0,0
"Thailand","2024-05-18",0,0,89,0,0,101,0,0
"Thailand","2024-05-19",0,0,89,0,1,102,0,0
"Thailand","2024-05-20",0,0,89,0,1,103,0,0
"Thailand","2024-05-21",0,0,89,0,0,103,0,0
"Thailand","2024-05-22",0,0,89,0,1,104,0,0
"Thailand","2024-05-23",0,0,89,0,1,105,0,0
"Thailand","2024-05-24",0,0,89,0,0,105,0,0
"Thailand","2024-05-25",0,0,89,0,1,106,0,0
"Thailand","2024-05-26",0,0,89,0,1,107,0,0
"Thailand","2024-05-27",0,0,89,0,0,107,0,0
"Thailand","2024-05-28",0,0,89,0,1,108,0,0
"Thailand","2024-05-29",0,0,89,0,1,109,0,0
"Thailand","2024-05-30",0,0,89,0,0,109,0,0
"Thailand","2024-05-31",0,21,110,0,1,110,0,0
"Thailand","2024-06-01",0,0,110,0,0,110,0,0
"Thailand","2024-06-02",0,0,110,0,1,111,0,0
"Thailand","2024-06-03",0,0,110,0,0,111,0,0
"Thailand","2024-06-04",0,0,110,0,0,111,0,0
"Thailand","2024-06-05",0,0,110,0,1,112,0,0
"Thailand","2024-06-06",0,0,110,0,0,112,0,0
"Thailand","2024-06-07",0,0,110,0,0,112,0,0
"Thailand","2024-06-08",0,0,110,0,1,113,0,0
"Thailand","2024-06-09",0,0,110,0,0,113,0,0
"Thailand","2024-06-10",0,0,110,0,0,113,0,0
"Thailand","2024-06-11",0,0,110,0,1,114,0,0
"Thailand","2024-06-12",0,0,110,0,0,114,0,0
"Thailand","2024-06-13",0,0,110,0,0,114,0,0
"Thailand","2024-06-14",0,0,110,0,1,115,0,0
"Thailand","2024-06-15",0,0,110,0,0,115,0,0
"Thailand","2024-06-16",0,0,110,0,0,115,0,0
"Thailand","2024-06-17",0,0,110,0,1,116,0,0
"Thailand","2024-06-18",0,0,110,0,0,116,0,0
"Thailand","2024-06-19",0,0,110,0,0,116,0,0
"Thailand","2024-06-20",0,0,110,0,1,117,0,0
"Thailand","2024-06-21",0,0,110,0,0,117,0,0
"Thailand","2024-06-22",0,0,110,0,0,117,0,0
"Thailand","2024-06-23",0,0,110,0,1,118,0,0
"Thailand","2024-06-24",0,0,110,0,0,118,0,0
"Thailand","2024-06-25",0,0,110,0,0,118,0,0
"Thailand","2024-06-26",0,0,110,0,1,119,0,0
"Thailand","2024-06-27",0,0,110,0,0,119,0,0
"Thailand","2024-06-28",0,0,110,0,0,119,0,0
"Thailand","2024-06-29",0,0,110,0,1,120,0,0
"Thailand","2024-06-30",0,10,120,0,0,120,0,0
"Thailand","2024-07-01",0,0,120,0,0,120,0,0
"Thailand","2024-07-02",0,0,120,0,1,121,0,0
"Thailand","2024-07-03",0,0,120,0,0,121,0,0
"Thailand","2024-07-04",0,0,120,0,1,122,0,0
"Thailand","2024-07-05",0,0,120,0,0,122,0,0
"Thailand","2024-07-06",0,0,120,0,1,123,0,0
"Thailand","2024-07-07",0,0,120,0,0,123,0,0
"Thailand","2024-07-08",0,0,120,0,1,124,0,0
"Thailand","2024-07-09",0,0,120,0,0,124,0,0
"Thailand","2024-07-10",0,0,120,0,1,125,0,0
"Thailand","2024-07-11",0,0,120,0,0,125,0,0
"Thailand","2024-07-12",0,0,120,0,1,126,0,0
"Thailand","2024-07-13",0,0,120,0,0,126,0,0
"Thailand","2024-07-14",0,0,120,0,1,127,0,0
"Thailand","2024-07-15",0,0,120,0,0,127,0,0
"Thailand","2024-07-16",0,0,120,0,1,128,0,0
"Thailand","2024-07-17",0,0,120,0,0,128,0,0
"Thailand","2024-07-18",0,0,120,0,1,129,0,0
"Thailand","2024-07-19",0,0,120,0,0,129,0,0
"Thailand","2024-07-20",0,0,120,0,1,130,0,0
"Thailand","2024-07-21",0,0,120,0,0,130,0,0
"Thailand","2024-07-22",0,0,120,0,1,131,0,0
"Thailand","2024-07-23",0,0,120,0,0,131,0,0
"Thailand","2024-07-24",0,0,120,0,1,132,0,0
"Thailand","2024-07-25",0,0,120,0,0,132,0,0
"Thailand","2024-07-26",0,0,120,0,1,133,0,0
"Thailand","2024-07-27",0,0,120,0,0,133,0,0
"Thailand","2024-07-28",0,0,120,0,1,134,0,0
"Thailand","2024-07-29",0,0,120,0,0,134,0,0
"Thailand","2024-07-30",0,0,120,0,1,135,0,0
"Thailand","2024-07-31",0,15,135,0,0,135,0,0
"Thailand","2024-08-01",0,0,135,0,0,135,0,0
"Thailand","2024-08-02",0,0,135,0,1,136,0,0
"Thailand","2024-08-03",0,0,135,0,0,136,0,0
"Thailand","2024-08-04",0,0,135,0,1,137,0,0
"Thailand","2024-08-05",0,0,135,0,0,137,0,0
"Thailand","2024-08-06",0,0,135,0,1,138,0,0
"Thailand","2024-08-07",0,0,135,0,0,138,0,0
"Thailand","2024-08-08",0,0,135,0,0,138,0,0
"Thailand","2024-08-09",0,0,135,0,1,139,0,0
"Thailand","2024-08-10",0,0,135,0,0,139,0,0
"Thailand","2024-08-11",0,0,135,0,1,140,0,0
"Thailand","2024-08-12",0,0,135,0,0,140,0,0
"Thailand","2024-08-13",0,0,135,0,0,140,0,0
"Thailand","2024-08-14",0,0,135,0,1,141,0,0
"Thailand","2024-08-15",0,0,135,0,0,141,0,0
"Thailand","2024-08-16",0,0,135,0,1,142,0,0
"Thailand","2024-08-17",0,0,135,0,0,142,0,0
"Thailand","2024-08-18",0,0,135,0,1,143,0,0
"Thailand","2024-08-19",0,0,135,0,0,143,0,0
"Thailand","2024-08-20",0,0,135,0,0,143,0,0
"Thailand","2024-08-21",0,0,135,0,1,144,0,0
"Thailand","2024-08-22",0,0,135,0,0,144,0,0
"Thailand","2024-08-23",0,0,135,0,1,145,0,0
"Thailand","2024-08-24",0,0,135,0,0,145,0,0
"Thailand","2024-08-25",0,0,135,0,0,145,0,0
"Thailand","2024-08-26",0,0,135,0,1,146,0,0
"Thailand","2024-08-27",0,0,135,0,0,146,0,0
"Thailand","2024-08-28",0,0,135,0,1,147,0,0
"Thailand","2024-08-29",0,0,135,0,0,147,0,0
"Thailand","2024-08-30",0,0,135,0,1,148,0,0
"Thailand","2024-08-31",0,13,148,0,0,148,0,0
"Thailand","2024-09-01",0,0,148,0,0,148,0,0
"Thailand","2024-09-02",0,0,148,0,1,149,0,0
"Thailand","2024-09-03",0,0,148,0,0,149,0,0
"Thailand","2024-09-04",0,0,148,0,1,150,0,0
"Thailand","2024-09-05",0,0,148,0,0,150,0,0
"Thailand","2024-09-06",0,0,148,0,0,150,0,0
"Thailand","2024-09-07",0,0,148,0,1,151,0,0
"Thailand","2024-09-08",0,0,148,0,0,151,0,0
"Thailand","2024-09-09",0,0,148,0,1,152,0,0
"Thailand","2024-09-10",0,0,148,0,0,152,0,0
"Thailand","2024-09-11",0,0,148,0,0,152,0,0
"Thailand","2024-09-12",0,0,148,0,1,153,0,0
"Thailand","2024-09-13",0,0,148,0,0,153,0,0
"Thailand","2024-09-14",0,0,148,0,1,154,0,0
"Thailand","2024-09-15",0,0,148,0,0,154,0,0
"Thailand","2024-09-16",0,0,148,0,0,154,0,0
"Thailand","2024-09-17",0,0,148,0,1,155,0,0
"Thailand","2024-09-18",0,0,148,0,0,155,0,0
"Thailand","2024-09-19",0,0,148,0,1,156,0,0
"Thailand","2024-09-20",0,0,148,0,0,156,0,0
"Thailand","2024-09-21",0,0,148,0,0,156,0,0
"Thailand","2024-09-22",0,0,148,0,1,157,0,0
"Thailand","2024-09-23",0,0,148,0,0,157,0,0
"Thailand","2024-09-24",0,0,148,0,1,158,0,0
"Thailand","2024-09-25",0,0,148,0,0,158,0,0
"Thailand","2024-09-26",0,0,148,0,0,158,0,0
"Thailand","2024-09-27",0,0,148,0,1,159,0,0
"Thailand","2024-09-28",0,0,148,0,0,159,0,0
"Thailand","2024-09-29",0,0,148,0,1,160,0,0
"Thailand","2024-09-30",0,12,160,0,0,160,0,0
"Thailand","2024-10-01",0,0,160,0,0,160,0,0
"Thailand","2024-10-02",0,0,160,0,1,161,0,0
"Thailand","2024-10-03",0,0,160,0,0,161,0,0
"Thailand","2024-10-04",0,0,160,0,1,162,0,0
"Thailand","2024-10-05",0,0,160,0,0,162,0,0
"Thailand","2024-10-06",0,0,160,0,1,163,0,0
"Thailand","2024-10-07",0,0,160,0,0,163,0,0
"Thailand","2024-10-08",0,0,160,0,0,163,0,0
"Thailand","2024-10-09",0,0,160,0,1,164,0,0
"Thailand","2024-10-10",0,0,160,0,0,164,0,0
"Thailand","2024-10-11",0,0,160,0,1,165,0,0
"Thailand","2024-10-12",0,0,160,0,0,165,0,0
"Thailand","2024-10-13",0,0,160,0,0,165,0,0
"Thailand","2024-10-14",0,0,160,0,1,166,0,0
"Thailand","2024-10-15",0,0,160,0,0,166,0,0
"Thailand","2024-10-16",0,0,160,0,1,167,0,0
"Thailand","2024-10-17",0,0,160,0,0,167,0,0
"Thailand","2024-10-18",0,0,160,0,1,168,0,0
"Thailand","2024-10-19",0,0,160,0,0,168,0,0
"Thailand","2024-10-20",0,0,160,0,0,168,0,0
"Thailand","2024-10-21",0,0,160,0,1,169,0,0
"Thailand","2024-10-22",0,0,160,0,0,169,0,0
"Thailand","2024-10-23",0,0,160,0,1,170,0,0
"Thailand","2024-10-24",0,0,160,0,0,170,0,0
"Thailand","2024-10-25",0,0,160,0,0,170,0,0
"Thailand","2024-10-26",0,0,160,0,1,171,0,0
"Thailand","2024-10-27",0,0,160,0,0,171,0,0
"Thailand","2024-10-28",0,0,160,0,1,172,0,0
"Thailand","2024-10-29",0,0,160,0,0,172,0,0
"Thailand","2024-10-30",0,0,160,0,1,173,0,0
"Thailand","2024-10-31",0,13,173,0,0,173,0,0
"Thailand","2024-11-01",0,0,173,0,0,173,0,0
"Thailand","2024-11-02",0,0,173,0,0,173,0,0
"Thailand","2024-11-03",0,0,173,0,1,174,0,0
"Thailand","2024-11-04",0,0,173,0,0,174,0,0
"Thailand","2024-11-05",0,0,173,0,0,174,0,0
"Thailand","2024-11-06",0,0,173,0,0,174,0,0
"Thailand","2024-11-07",0,0,173,0,1,175,0,0
"Thailand","2024-11-08",0,0,173,0,0,175,0,0
"Thailand","2024-11-09",0,0,173,0,0,175,0,0
"Thailand","2024-11-10",0,0,173,0,0,175,0,0
"Thailand","2024-11-11",0,0,173,0,1,176,0,0
"Thailand","2024-11-12",0,0,173,0,0,176,0,0
"Thailand","2024-11-13",0,0,173,0,0,176,0,0
"Thailand","2024-11-14",0,0,173,0,0,176,0,0
"Thailand","2024-11-15",0,0,173,0,1,177,0,0
"Thailand","2024-11-16",0,0,173,0,0,177,0,0
"Thailand","2024-11-17",0,0,173,0,0,177,0,0
"Thailand","2024-11-18",0,0,173,0,0,177,0,0
"Thailand","2024-11-19",0,0,173,0,0,177,0,0
"Thailand","2024-11-20",0,0,173,0,1,178,0,0
"Thailand","2024-11-21",0,0,173,0,0,178,0,0
"Thailand","2024-11-22",0,0,173,0,0,178,0,0
"Thailand","2024-11-23",0,0,173,0,0,178,0,0
"Thailand","2024-11-24",0,0,173,0,1,179,0,0
"Thailand","2024-11-25",0,0,173,0,0,179,0,0
"Thailand","2024-11-26",0,0,173,0,0,179,0,0
"Thailand","2024-11-27",0,0,173,0,0,179,0,0
"Thailand","2024-11-28",0,0,173,0,1,180,0,0
"Thailand","2024-11-29",0,0,173,0,0,180,0,0
"Thailand","2024-11-30",0,7,180,0,0,180,0,0
"Thailand","2024-12-01",0,0,180,0,0,180,0,0
"Thailand","2024-12-02",0,0,180,0,0,180,0,0
"Thailand","2024-12-03",0,0,180,0,0,180,0,0
"Thailand","2024-12-04",0,0,180,0,0,180,0,0
"Thailand","2024-12-05",0,0,180,0,0,180,0,0
"Thailand","2024-12-06",0,0,180,0,0,180,0,0
"Thailand","2024-12-07",0,0,180,0,1,181,0,0
"Thailand","2024-12-08",0,0,180,0,0,181,0,0
"Thailand","2024-12-09",0,0,180,0,0,181,0,0
"Thailand","2024-12-10",0,0,180,0,0,181,0,0
"Thailand","2024-12-11",0,0,180,0,0,181,0,0
"Thailand","2024-12-12",0,0,180,0,0,181,0,0
"Thailand","2024-12-13",0,0,180,0,0,181,0,0
"Thailand","2024-12-14",0,0,180,0,0,181,0,0
"Thailand","2024-12-15",0,0,180,0,0,181,0,0
"Thailand","2024-12-16",0,0,180,0,0,181,0,0
"Thailand","2024-12-17",0,0,180,0,0,181,0,0
"Thailand","2024-12-18",0,0,180,0,0,181,0,0
"Thailand","2024-12-19",0,0,180,0,1,182,0,0
"Thailand","2024-12-20",0,0,180,0,0,182,0,0
"Thailand","2024-12-21",0,0,180,0,0,182,0,0
"Thailand","2024-12-22",0,0,180,0,0,182,0,0
"Thailand","2024-12-23",0,0,180,0,0,182,0,0
"Thailand","2024-12-24",0,0,180,0,0,182,0,0
"Thailand","2024-12-25",0,0,180,0,0,182,0,0
"Thailand","2024-12-26",0,0,180,0,0,182,0,0
"Thailand","2024-12-27",0,0,180,0,0,182,0,0
"Thailand","2024-12-28",0,0,180,0,0,182,0,0
"Thailand","2024-12-29",0,0,180,0,0,182,0,0
"Thailand","2024-12-30",0,0,180,0,0,182,0,0
"Thailand","2024-12-31",0,0,180,0,0,182,0,0
"Thailand","2025-01-01",0,0,180,0,1,183,0,0
"Thailand","2025-01-02",0,0,180,0,0,183,0,0
"Thailand","2025-01-03",0,0,180,0,0,183,0,0
"Thailand","2025-01-04",0,0,180,0,0,183,0,0
"Thailand","2025-01-05",0,0,180,0,0,183,0,0
"Thailand","2025-01-06",0,0,180,0,0,183,0,0
"Thailand","2025-01-07",0,0,180,0,0,183,0,0
"Thailand","2025-01-08",0,0,180,0,0,183,0,0
"Thailand","2025-01-09",0,0,180,0,0,183,0,0
"Thailand","2025-01-10",0,0,180,0,0,183,0,0
"Thailand","2025-01-11",0,0,180,0,0,183,0,0
"Thailand","2025-01-12",0,0,180,0,0,183,0,0
"Thailand","2025-01-13",0,0,180,0,1,184,0,0
"Thailand","2025-01-14",0,0,180,0,0,184,0,0
"Thailand","2025-01-15",0,0,180,0,0,184,0,0
"Thailand","2025-01-16",0,0,180,0,0,184,0,0
"Thailand","2025-01-17",0,0,180,0,0,184,0,0
"Thailand","2025-01-18",0,0,180,0,0,184,0,0
"Thailand","2025-01-19",0,0,180,0,0,184,0,0
"Thailand","2025-01-20",0,0,180,0,0,184,0,0
"Thailand","2025-01-21",0,0,180,0,0,184,0,0
"Thailand","2025-01-22",0,0,180,0,0,184,0,0
"Thailand","2025-01-23",0,0,180,0,0,184,0,0
"Thailand","2025-01-24",0,0,180,0,0,184,0,0
"Thailand","2025-01-25",0,0,180,0,1,185,0,0
"Thailand","2025-01-26",0,0,180,0,0,185,0,0
"Thailand","2025-01-27",0,0,180,0,0,185,0,0
"Thailand","2025-01-28",0,0,180,0,0,185,0,0
"Thailand","2025-01-29",0,0,180,0,0,185,0,0
"Thailand","2025-01-30",0,0,180,0,0,185,0,0
"Thailand","2025-01-31",0,5,185,0,0,185,0,0
"Thailand","2025-02-01",0,0,185,0,0,185,0,0
"Thailand","2025-02-02",0,0,185,0,0,185,0,0
"Thailand","2025-02-03",0,0,185,0,0,185,0,0
"Thailand","2025-02-04",0,0,185,0,0,185,0,0
"Thailand","2025-02-05",0,0,185,0,0,185,0,0
"Thailand","2025-02-06",0,0,185,0,0,185,0,0
"Thailand","2025-02-07",0,0,185,0,0,185,0,0
"Thailand","2025-02-08",0,0,185,0,0,185,0,0
"Thailand","2025-02-09",0,0,185,0,0,185,0,0
"Thailand","2025-02-10",0,0,185,0,0,185,0,0
"Thailand","2025-02-11",0,0,185,0,0,185,0,0
"Thailand","2025-02-12",0,0,185,0,0,185,0,0
"Thailand","2025-02-13",0,0,185,0,0,185,0,0
"Thailand","2025-02-14",0,0,185,0,0,185,0,0
"Thailand","2025-02-15",0,0,185,0,0,185,0,0
"Thailand","2025-02-16",0,0,185,0,0,185,0,0
"Thailand","2025-02-17",0,0,185,0,0,185,0,0
"Thailand","2025-02-18",0,0,185,0,0,185,0,0
"Thailand","2025-02-19",0,0,185,0,0,185,0,0
"Thailand","2025-02-20",0,0,185,0,0,185,0,0
"Thailand","2025-02-21",0,0,185,0,0,185,0,0
"Thailand","2025-02-22",0,0,185,0,0,185,0,0
"Thailand","2025-02-23",0,0,185,0,0,185,0,0
"Thailand","2025-02-24",0,0,185,0,0,185,0,0
"Thailand","2025-02-25",0,0,185,0,0,185,0,0
"Thailand","2025-02-26",0,0,185,0,0,185,0,0
"Thailand","2025-02-27",0,0,185,0,0,185,0,0
"Thailand","2025-02-28",0,0,185,0,0,185,0,0
"Thailand","2025-03-01",0,0,185,0,0,185,0,0
"Thailand","2025-03-02",0,0,185,0,0,185,0,0
"Thailand","2025-03-03",0,0,185,0,0,185,0,0
"Trinidad and Tobago","2024-01-01",0,0,0,0,0,0,0,0
"Trinidad and Tobago","2024-01-02",0,0,0,0,0,0,0,0
"Trinidad and Tobago","2024-01-03",0,0,0,0,0,0,0,0
"Trinidad and Tobago","2024-01-04",0,0,0,0,0,0,0,0
"Trinidad and Tobago","2024-01-05",0,0,0,0,0,0,0,0
"Trinidad and Tobago","2024-01-06",0,0,0,0,0,0,0,0
"Trinidad and Tobago","2024-01-07",0,0,0,0,0,0,0,0
"Trinidad and Tobago","2024-01-08",0,0,0,0,0,0,0,0
"Trinidad and Tobago","2024-01-09",0,0,0,0,0,0,0,0
"Trinidad and Tobago","2024-01-10",0,0,0,0,0,0,0,0
"Trinidad and Tobago","2024-01-11",0,0,0,0,0,0,0,0
"Trinidad and Tobago","2024-01-12",0,0,0,0,0,0,0,0
"Trinidad and Tobago","2024-01-13",0,0,0,0,0,0,0,0
"Trinidad and Tobago","2024-01-14",0,0,0,0,0,0,0,0
"Trinidad and Tobago","2024-01-15",0,0,0,0,0,0,0,0
"Trinidad and Tobago","2024-01-16",0,0,0,0,0,0,0,0
"Trinidad and Tobago","2024-01-17",0,0,0,0,0,0,0,0
"Trinidad and Tobago","2024-01-18",0,0,0,0,0,0,0,0
"Trinidad and Tobago","2024-01-19",0,0,0,0,0,0,0,0
"Trinidad and Tobago","2024-01-20",0,0,0,0,0,0,0,0
"Trinidad and Tobago","2024-01-21",0,0,0,0,0,0,0,0
"Trinidad and Tobago","2024-01-22",0,0,0,0,0,0,0,0
"Trinidad and Tobago","2024-01-23",0,0,0,0,0,0,0,0
"Trinidad and Tobago","2024-01-24",0,0,0,0,0,0,0,0
"Trinidad and Tobago","2024-01-25",0,0,0,0,0,0,0,0
"Trinidad and Tobago","2024-01-26",0,0,0,0,0,0,0,0
"Trinidad and Tobago","2024-01-27",0,0,0,0,0,0,0,0
"Trinidad and Tobago","2024-01-28",0,0,0,0,0,0,0,0
"Trinidad and Tobago","2024-01-29",0,0,0,0,0,0,0,0
"Trinidad and Tobago","2024-01-30",0,0,0,0,0,0,0,0
"Trinidad and Tobago","2024-01-31",0,0,0,0,0,0,0,0
"Trinidad and Tobago","2024-02-01",0,0,0,0,0,0,0,0
"Trinidad and Tobago","2024-02-02",0,0,0,0,0,0,0,0
"Trinidad and Tobago","2024-02-03",0,0,0,0,0,0,0,0
"Trinidad and Tobago","2024-02-04",0,0,0,0,0,0,0,0
"Trinidad and Tobago","2024-02-05",0,0,0,0,0,0,0,0
"Trinidad and Tobago","2024-02-06",0,0,0,0,0,0,0,0
"Trinidad and Tobago","2024-02-07",0,0,0,0,0,0,0,0
"Trinidad and Tobago","2024-02-08",0,0,0,0,0,0,0,0
"Trinidad and Tobago","2024-02-09",0,0,0,0,0,0,0,0
"Trinidad and Tobago","2024-02-10",0,0,0,0,0,0,0,0
"Trinidad and Tobago","2024-02-11",0,0,0,0,0,0,0,0
"Trinidad and Tobago","2024-02-12",0,0,0,0,0,0,0,0
"Trinidad and Tobago","2024-02-13",0,0,0,0,0,0,0,0
"Trinidad and Tobago","2024-02-14",0,0,0,0,0,0,0,0
"Trinidad and Tobago","2024-02-15",0,0,0,0,0,0,0,0
"Trinidad and Tobago","2024-02-16",0,0,0,0,0,0,0,0
"Trinidad and Tobago","2024-02-17",0,0,0,0,0,0,0,0
"Trinidad and Tobago","2024-02-18",0,0,0,0,0,0,0,0
"Trinidad and Tobago","2024-02-19",0,0,0,0,0,0,0,0
"Trinidad and Tobago","2024-02-20",0,0,0,0,0,0,0,0
"Trinidad and Tobago","2024-02-21",0,0,0,0,0,0,0,0
"Trinidad and Tobago","2024-02-22",0,0,0,0,0,0,0,0
"Trinidad and Tobago","2024-02-23",0,0,0,0,0,0,0,0
"Trinidad and Tobago","2024-02-24",0,0,0,0,0,0,0,0
"Trinidad and Tobago","2024-02-25",0,0,0,0,0,0,0,0
"Trinidad and Tobago","2024-02-26",0,0,0,0,0,0,0,0
"Trinidad and Tobago","2024-02-27",0,0,0,0,0,0,0,0
"Trinidad and Tobago","2024-02-28",0,0,0,0,0,0,0,0
"Trinidad and Tobago","2024-02-29",0,0,0,0,0,0,0,0
"Trinidad and Tobago","2024-03-01",0,0,0,0,0,0,0,0
"Trinidad and Tobago","2024-03-02",0,0,0,0,0,0,0,0
"Trinidad and Tobago","2024-03-03",0,0,0,0,0,0,0,0
"Trinidad and Tobago","2024-03-04",0,0,0,0,0,0,0,0
"Trinidad and Tobago","2024-03-05",0,0,0,0,0,0,0,0
"Trinidad and Tobago","2024-03-06",0,0,0,0,0,0,0,0
"Trinidad and Tobago","2024-03-07",0,0,0,0,0,0,0,0
"Trinidad and Tobago","2024-03-08",0,0,0,0,0,0,0,0
"Trinidad and Tobago","2024-03-09",0,0,0,0,0,0,0,0
"Trinidad and Tobago","2024-03-10",0,0,0,0,0,0,0,0
"Trinidad and Tobago","2024-03-11",0,0,0,0,0,0,0,0
"Trinidad and Tobago","2024-03-12",0,0,0,0,0,0,0,0
"Trinidad and Tobago","2024-03-13",0,0,0,0,0,0,0,0
"Trinidad and Tobago","2024-03-14",0,0,0,0,0,0,0,0
"Trinidad and Tobago","2024-03-15",0,0,0,0,0,0,0,0
"Trinidad and Tobago","2024-03-16",0,0,0,0,0,0,0,0
"Trinidad and Tobago","2024-03-17",0,0,0,0,0,0,0,0
"Trinidad and Tobago","2024-03-18",0,0,0,0,0,0,0,0
"Trinidad and Tobago","2024-03-19",0,0,0,0,0,0,0,0
"Trinidad and Tobago","2024-03-20",0,0,0,0,0,0,0,0
"Trinidad and Tobago","2024-03-21",0,0,0,0,0,0,0,0
"Trinidad and Tobago","2024-03-22",0,0,0,0,0,0,0,0
"Trinidad and Tobago","2024-03-23",0,0,0,0,0,0,0,0
"Trinidad and Tobago","2024-03-24",0,0,0,0,0,0,0,0
"Trinidad and Tobago","2024-03-25",0,0,0,0,0,0,0,0
"Trinidad and Tobago","2024-03-26",0,0,0,0,0,0,0,0
"Trinidad and Tobago","2024-03-27",0,0,0,0,0,0,0,0
"Trinidad and Tobago","2024-03-28",0,0,0,0,0,0,0,0
"Trinidad and Tobago","2024-03-29",0,0,0,0,0,0,0,0
"Trinidad and Tobago","2024-03-30",0,0,0,0,0,0,0,0
"Trinidad and Tobago","2024-03-31",0,0,0,0,0,0,0,0
"Trinidad and Tobago","2024-04-01",0,0,0,0,0,0,0,0
"Trinidad and Tobago","2024-04-02",0,0,0,0,0,0,0,0
"Trinidad and Tobago","2024-04-03",0,0,0,0,0,0,0,0
"Trinidad and Tobago","2024-04-04",0,0,0,0,0,0,0,0
"Trinidad and Tobago","2024-04-05",0,0,0,0,0,0,0,0
"Trinidad and Tobago","2024-04-06",0,0,0,0,0,0,0,0
"Trinidad and Tobago","2024-04-07",0,0,0,0,0,0,0,0
"Trinidad and Tobago","2024-04-08",0,0,0,0,0,0,0,0
"Trinidad and Tobago","2024-04-09",0,0,0,0,0,0,0,0
"Trinidad and Tobago","2024-04-10",0,0,0,0,0,0,0,0
"Trinidad and Tobago","2024-04-11",0,0,0,0,0,0,0,0
"Trinidad and Tobago","2024-04-12",0,0,0,0,0,0,0,0
"Trinidad and Tobago","2024-04-13",0,0,0,0,0,0,0,0
"Trinidad and Tobago","2024-04-14",0,0,0,0,0,0,0,0
"Trinidad and Tobago","2024-04-15",0,0,0,0,0,0,0,0
"Trinidad and Tobago","2024-04-16",0,0,0,0,0,0,0,0
"Trinidad and Tobago","2024-04-17",0,0,0,0,0,0,0,0
"Trinidad and Tobago","2024-04-18",0,0,0,0,0,0,0,0
"Trinidad and Tobago","2024-04-19",0,0,0,0,0,0,0,0
"Trinidad and Tobago","2024-04-20",0,0,0,0,0,0,0,0
"Trinidad and Tobago","2024-04-21",0,0,0,0,0,0,0,0
"Trinidad and Tobago","2024-04-22",0,0,0,0,0,0,0,0
"Trinidad and Tobago","2024-04-23",0,0,0,0,0,0,0,0
"Trinidad and Tobago","2024-04-24",0,0,0,0,0,0,0,0
"Trinidad and Tobago","2024-04-25",0,0,0,0,0,0,0,0
"Trinidad and Tobago","2024-04-26",0,0,0,0,0,0,0,0
"Trinidad and Tobago","2024-04-27",0,0,0,0,0,0,0,0
"Trinidad and Tobago","2024-04-28",0,0,0,0,0,0,0,0
"Trinidad and Tobago","2024-04-29",0,0,0,0,0,0,0,0
"Trinidad and Tobago","2024-04-30",0,0,0,0,0,0,0,0
"Trinidad and Tobago","2024-05-01",0,0,0,0,0,0,0,0
"Trinidad and Tobago","2024-05-02",0,0,0,0,0,0,0,0
"Trinidad and Tobago","2024-05-03",0,0,0,0,0,0,0,0
"Trinidad and Tobago","2024-05-04",0,0,0,0,0,0,0,0
"Trinidad and Tobago","2024-05-05",0,0,0,0,0,0,0,0
"Trinidad and Tobago","2024-05-06",0,0,0,0,0,0,0,0
"Trinidad and Tobago","2024-05-07",0,0,0,0,0,0,0,0
"Trinidad and Tobago","2024-05-08",0,0,0,0,0,0,0,0
"Trinidad and Tobago","2024-05-09",0,0,0,0,0,0,0,0
"Trinidad and Tobago","2024-05-10",0,0,0,0,0,0,0,0
"Trinidad and Tobago","2024-05-11",0,0,0,0,0,0,0,0
"Trinidad and Tobago","2024-05-12",0,0,0,0,0,0,0,0
"Trinidad and Tobago","2024-05-13",0,0,0,0,0,0,0,0
"Trinidad and Tobago","2024-05-14",0,0,0,0,0,0,0,0
"Trinidad and Tobago","2024-05-15",0,0,0,0,0,0,0,0
"Trinidad and Tobago","2024-05-16",0,0,0,0,0,0,0,0
"Trinidad and Tobago","2024-05-17",0,0,0,0,0,0,0,0
"Trinidad and Tobago","2024-05-18",0,0,0,0,0,0,0,0
"Trinidad and Tobago","2024-05-19",0,0,0,0,0,0,0,0
"Trinidad and Tobago","2024-05-20",0,0,0,0,0,0,0,0
"Trinidad and Tobago","2024-05-21",0,0,0,0,0,0,0,0
"Trinidad and Tobago","2024-05-22",0,0,0,0,0,0,0,0
"Trinidad and Tobago","2024-05-23",0,0,0,0,0,0,0,0
"Trinidad and Tobago","2024-05-24",0,0,0,0,0,0,0,0
"Trinidad and Tobago","2024-05-25",0,0,0,0,0,0,0,0
"Trinidad and Tobago","2024-05-26",0,0,0,0,0,0,0,0
"Trinidad and Tobago","2024-05-27",0,0,0,0,0,0,0,0
"Trinidad and Tobago","2024-05-28",0,0,0,0,0,0,0,0
"Trinidad and Tobago","2024-05-29",0,0,0,0,0,0,0,0
"Trinidad and Tobago","2024-05-30",0,0,0,0,0,0,0,0
"Trinidad and Tobago","2024-05-31",0,0,0,0,0,0,0,0
"Trinidad and Tobago","2024-06-01",0,0,0,0,0,0,0,0
"Trinidad and Tobago","2024-06-02",0,0,0,0,0,0,0,0
"Trinidad and Tobago","2024-06-03",0,0,0,0,0,0,0,0
"Trinidad and Tobago","2024-06-04",0,0,0,0,0,0,0,0
"Trinidad and Tobago","2024-06-05",0,0,0,0,0,0,0,0
"Trinidad and Tobago","2024-06-06",0,0,0,0,0,0,0,0
"Trinidad and Tobago","2024-06-07",0,0,0,0,0,0,0,0
"Trinidad and Tobago","2024-06-08",0,0,0,0,0,0,0,0
"Trinidad and Tobago","2024-06-09",0,0,0,0,0,0,0,0
"Trinidad and Tobago","2024-06-10",0,0,0,0,0,0,0,0
"Trinidad and Tobago","2024-06-11",0,0,0,0,0,0,0,0
"Trinidad and Tobago","2024-06-12",0,0,0,0,0,0,0,0
"Trinidad and Tobago","2024-06-13",0,0,0,0,0,0,0,0
"Trinidad and Tobago","2024-06-14",0,0,0,0,0,0,0,0
"Trinidad and Tobago","2024-06-15",0,0,0,0,0,0,0,0
"Trinidad and Tobago","2024-06-16",0,0,0,0,0,0,0,0
"Trinidad and Tobago","2024-06-17",0,0,0,0,0,0,0,0
"Trinidad and Tobago","2024-06-18",0,0,0,0,0,0,0,0
"Trinidad and Tobago","2024-06-19",0,0,0,0,0,0,0,0
"Trinidad and Tobago","2024-06-20",0,0,0,0,0,0,0,0
"Trinidad and Tobago","2024-06-21",0,0,0,0,0,0,0,0
"Trinidad and Tobago","2024-06-22",0,0,0,0,0,0,0,0
"Trinidad and Tobago","2024-06-23",0,0,0,0,0,0,0,0
"Trinidad and Tobago","2024-06-24",0,0,0,0,0,0,0,0
"Trinidad and Tobago","2024-06-25",0,0,0,0,0,0,0,0
"Trinidad and Tobago","2024-06-26",0,0,0,0,0,0,0,0
"Trinidad and Tobago","2024-06-27",0,0,0,0,0,0,0,0
"Trinidad and Tobago","2024-06-28",0,0,0,0,0,0,0,0
"Trinidad and Tobago","2024-06-29",0,0,0,0,0,0,0,0
"Trinidad and Tobago","2024-06-30",0,0,0,0,0,0,0,0
"Trinidad and Tobago","2024-07-01",0,0,0,0,0,0,0,0
"Trinidad and Tobago","2024-07-02",0,0,0,0,0,0,0,0
"Trinidad and Tobago","2024-07-03",0,0,0,0,0,0,0,0
"Trinidad and Tobago","2024-07-04",0,0,0,0,0,0,0,0
"Trinidad and Tobago","2024-07-05",0,0,0,0,0,0,0,0
"Trinidad and Tobago","2024-07-06",0,0,0,0,0,0,0,0
"Trinidad and Tobago","2024-07-07",0,0,0,0,0,0,0,0
"Trinidad and Tobago","2024-07-08",0,0,0,0,0,0,0,0
"Trinidad and Tobago","2024-07-09",0,0,0,0,0,0,0,0
"Trinidad and Tobago","2024-07-10",0,0,0,0,0,0,0,0
"Trinidad and Tobago","2024-07-11",0,0,0,0,0,0,0,0
"Trinidad and Tobago","2024-07-12",0,0,0,0,0,0,0,0
"Trinidad and Tobago","2024-07-13",0,0,0,0,0,0,0,0
"Trinidad and Tobago","2024-07-14",0,0,0,0,0,0,0,0
"Trinidad and Tobago","2024-07-15",0,0,0,0,0,0,0,0
"Trinidad and Tobago","2024-07-16",0,0,0,0,0,0,0,0
"Trinidad and Tobago","2024-07-17",0,0,0,0,0,0,0,0
"Trinidad and Tobago","2024-07-18",0,0,0,0,0,0,0,0
"Trinidad and Tobago","2024-07-19",0,0,0,0,0,0,0,0
"Trinidad and Tobago","2024-07-20",0,0,0,0,0,0,0,0
"Trinidad and Tobago","2024-07-21",0,0,0,0,0,0,0,0
"Trinidad and Tobago","2024-07-22",0,0,0,0,0,0,0,0
"Trinidad and Tobago","2024-07-23",0,0,0,0,0,0,0,0
"Trinidad and Tobago","2024-07-24",0,0,0,0,0,0,0,0
"Trinidad and Tobago","2024-07-25",0,0,0,0,0,0,0,0
"Trinidad and Tobago","2024-07-26",0,0,0,0,0,0,0,0
"Trinidad and Tobago","2024-07-27",0,0,0,0,0,0,0,0
"Trinidad and Tobago","2024-07-28",0,0,0,0,0,0,0,0
"Trinidad and Tobago","2024-07-29",0,0,0,0,0,0,0,0
"Trinidad and Tobago","2024-07-30",0,0,0,0,0,0,0,0
"Trinidad and Tobago","2024-07-31",0,0,0,0,0,0,0,0
"Trinidad and Tobago","2024-08-01",0,0,0,0,0,0,0,0
"Trinidad and Tobago","2024-08-02",0,0,0,0,0,0,0,0
"Trinidad and Tobago","2024-08-03",0,0,0,0,0,0,0,0
"Trinidad and Tobago","2024-08-04",0,0,0,0,0,0,0,0
"Trinidad and Tobago","2024-08-05",0,0,0,0,0,0,0,0
"Trinidad and Tobago","2024-08-06",0,0,0,0,0,0,0,0
"Trinidad and Tobago","2024-08-07",0,0,0,0,0,0,0,0
"Trinidad and Tobago","2024-08-08",0,0,0,0,0,0,0,0
"Trinidad and Tobago","2024-08-09",0,0,0,0,0,0,0,0
"Trinidad and Tobago","2024-08-10",0,0,0,0,0,0,0,0
"Trinidad and Tobago","2024-08-11",0,0,0,0,0,0,0,0
"Trinidad and Tobago","2024-08-12",0,0,0,0,0,0,0,0
"Trinidad and Tobago","2024-08-13",0,0,0,0,0,0,0,0
"Trinidad and Tobago","2024-08-14",0,0,0,0,0,0,0,0
"Trinidad and Tobago","2024-08-15",0,0,0,0,0,0,0,0
"Trinidad and Tobago","2024-08-16",0,0,0,0,0,0,0,0
"Trinidad and Tobago","2024-08-17",0,0,0,0,0,0,0,0
"Trinidad and Tobago","2024-08-18",0,0,0,0,0,0,0,0
"Trinidad and Tobago","2024-08-19",0,0,0,0,0,0,0,0
"Trinidad and Tobago","2024-08-20",0,0,0,0,0,0,0,0
"Trinidad and Tobago","2024-08-21",0,0,0,0,0,0,0,0
"Trinidad and Tobago","2024-08-22",0,0,0,0,0,0,0,0
"Trinidad and Tobago","2024-08-23",0,0,0,0,0,0,0,0
"Trinidad and Tobago","2024-08-24",0,0,0,0,0,0,0,0
"Trinidad and Tobago","2024-08-25",0,0,0,0,0,0,0,0
"Trinidad and Tobago","2024-08-26",0,0,0,0,0,0,0,0
"Trinidad and Tobago","2024-08-27",0,0,0,0,0,0,0,0
"Trinidad and Tobago","2024-08-28",0,0,0,0,0,0,0,0
"Trinidad and Tobago","2024-08-29",0,0,0,0,0,0,0,0
"Trinidad and Tobago","2024-08-30",0,0,0,0,0,0,0,0
"Trinidad and Tobago","2024-08-31",0,0,0,0,0,0,0,0
"Trinidad and Tobago","2024-09-01",0,0,0,0,0,0,0,0
"Trinidad and Tobago","2024-09-02",0,0,0,0,0,0,0,0
"Trinidad and Tobago","2024-09-03",0,0,0,0,0,0,0,0
"Trinidad and Tobago","2024-09-04",0,0,0,0,0,0,0,0
"Trinidad and Tobago","2024-09-05",0,0,0,0,0,0,0,0
"Trinidad and Tobago","2024-09-06",0,0,0,0,0,0,0,0
"Trinidad and Tobago","2024-09-07",0,0,0,0,0,0,0,0
"Trinidad and Tobago","2024-09-08",0,0,0,0,0,0,0,0
"Trinidad and Tobago","2024-09-09",0,0,0,0,0,0,0,0
"Trinidad and Tobago","2024-09-10",0,0,0,0,0,0,0,0
"Trinidad and Tobago","2024-09-11",0,0,0,0,0,0,0,0
"Trinidad and Tobago","2024-09-12",0,0,0,0,0,0,0,0
"Trinidad and Tobago","2024-09-13",0,0,0,0,0,0,0,0
"Trinidad and Tobago","2024-09-14",0,0,0,0,0,0,0,0
"Trinidad and Tobago","2024-09-15",0,0,0,0,0,0,0,0
"Trinidad and Tobago","2024-09-16",0,0,0,0,0,0,0,0
"Trinidad and Tobago","2024-09-17",0,0,0,0,0,0,0,0
"Trinidad and Tobago","2024-09-18",0,0,0,0,0,0,0,0
"Trinidad and Tobago","2024-09-19",0,0,0,0,0,0,0,0
"Trinidad and Tobago","2024-09-20",0,0,0,0,0,0,0,0
"Trinidad and Tobago","2024-09-21",0,0,0,0,0,0,0,0
"Trinidad and Tobago","2024-09-22",0,0,0,0,0,0,0,0
"Trinidad and Tobago","2024-09-23",0,0,0,0,0,0,0,0
"Trinidad and Tobago","2024-09-24",0,0,0,0,0,0,0,0
"Trinidad and Tobago","2024-09-25",0,0,0,0,0,0,0,0
"Trinidad and Tobago","2024-09-26",0,0,0,0,0,0,0,0
"Trinidad and Tobago","2024-09-27",0,0,0,0,0,0,0,0
"Trinidad and Tobago","2024-09-28",0,0,0,0,0,0,0,0
"Trinidad and Tobago","2024-09-29",0,0,0,0,0,0,0,0
"Trinidad and Tobago","2024-09-30",0,0,0,0,0,0,0,0
"Trinidad and Tobago","2024-10-01",0,0,0,0,0,0,0,0
"Trinidad and Tobago","2024-10-02",0,0,0,0,0,0,0,0
"Trinidad and Tobago","2024-10-03",0,0,0,0,0,0,0,0
"Trinidad and Tobago","2024-10-04",0,0,0,0,0,0,0,0
"Trinidad and Tobago","2024-10-05",0,0,0,0,0,0,0,0
"Trinidad and Tobago","2024-10-06",0,0,0,0,0,0,0,0
"Trinidad and Tobago","2024-10-07",0,0,0,0,0,0,0,0
"Trinidad and Tobago","2024-10-08",0,0,0,0,0,0,0,0
"Trinidad and Tobago","2024-10-09",0,0,0,0,0,0,0,0
"Trinidad and Tobago","2024-10-10",0,0,0,0,0,0,0,0
"Trinidad and Tobago","2024-10-11",0,0,0,0,0,0,0,0
"Trinidad and Tobago","2024-10-12",0,0,0,0,0,0,0,0
"Trinidad and Tobago","2024-10-13",0,0,0,0,0,0,0,0
"Trinidad and Tobago","2024-10-14",0,0,0,0,0,0,0,0
"Trinidad and Tobago","2024-10-15",0,0,0,0,0,0,0,0
"Trinidad and Tobago","2024-10-16",0,0,0,0,0,0,0,0
"Trinidad and Tobago","2024-10-17",0,0,0,0,0,0,0,0
"Trinidad and Tobago","2024-10-18",0,0,0,0,0,0,0,0
"Trinidad and Tobago","2024-10-19",0,0,0,0,0,0,0,0
"Trinidad and Tobago","2024-10-20",0,0,0,0,0,0,0,0
"Trinidad and Tobago","2024-10-21",0,0,0,0,0,0,0,0
"Trinidad and Tobago","2024-10-22",0,0,0,0,0,0,0,0
"Trinidad and Tobago","2024-10-23",0,0,0,0,0,0,0,0
"Trinidad and Tobago","2024-10-24",0,0,0,0,0,0,0,0
"Trinidad and Tobago","2024-10-25",0,0,0,0,0,0,0,0
"Trinidad and Tobago","2024-10-26",0,0,0,0,0,0,0,0
"Trinidad and Tobago","2024-10-27",0,0,0,0,0,0,0,0
"Trinidad and Tobago","2024-10-28",0,0,0,0,0,0,0,0
"Trinidad and Tobago","2024-10-29",0,0,0,0,0,0,0,0
"Trinidad and Tobago","2024-10-30",0,0,0,0,0,0,0,0
"Trinidad and Tobago","2024-10-31",0,0,0,0,0,0,0,0
"Trinidad and Tobago","2024-11-01",0,0,0,0,0,0,0,0
"Trinidad and Tobago","2024-11-02",0,0,0,0,0,0,0,0
"Trinidad and Tobago","2024-11-03",0,0,0,0,0,0,0,0
"Trinidad and Tobago","2024-11-04",0,0,0,0,0,0,0,0
"Trinidad and Tobago","2024-11-05",0,0,0,0,0,0,0,0
"Trinidad and Tobago","2024-11-06",0,0,0,0,0,0,0,0
"Trinidad and Tobago","2024-11-07",0,0,0,0,0,0,0,0
"Trinidad and Tobago","2024-11-08",0,0,0,0,0,0,0,0
"Trinidad and Tobago","2024-11-09",0,0,0,0,0,0,0,0
"Trinidad and Tobago","2024-11-10",0,0,0,0,0,0,0,0
"Trinidad and Tobago","2024-11-11",0,0,0,0,0,0,0,0
"Trinidad and Tobago","2024-11-12",0,0,0,0,0,0,0,0
"Trinidad and Tobago","2024-11-13",0,0,0,0,0,0,0,0
"Trinidad and Tobago","2024-11-14",0,0,0,0,0,0,0,0
"Trinidad and Tobago","2024-11-15",0,0,0,0,0,0,0,0
"Trinidad and Tobago","2024-11-16",0,0,0,0,0,0,0,0
"Trinidad and Tobago","2024-11-17",0,0,0,0,0,0,0,0
"Trinidad and Tobago","2024-11-18",0,0,0,0,0,0,0,0
"Trinidad and Tobago","2024-11-19",0,0,0,0,0,0,0,0
"Trinidad and Tobago","2024-11-20",0,0,0,0,0,0,0,0
"Trinidad and Tobago","2024-11-21",0,0,0,0,0,0,0,0
"Trinidad and Tobago","2024-11-22",0,0,0,0,0,0,0,0
"Trinidad and Tobago","2024-11-23",0,0,0,0,0,0,0,0
"Trinidad and Tobago","2024-11-24",0,0,0,0,0,0,0,0
"Trinidad and Tobago","2024-11-25",0,0,0,0,0,0,0,0
"Trinidad and Tobago","2024-11-26",0,0,0,0,0,0,0,0
"Trinidad and Tobago","2024-11-27",0,0,0,0,0,0,0,0
"Trinidad and Tobago","2024-11-28",0,0,0,0,0,0,0,0
"Trinidad and Tobago","2024-11-29",0,0,0,0,0,0,0,0
"Trinidad and Tobago","2024-11-30",0,0,0,0,0,0,0,0
"Trinidad and Tobago","2024-12-01",0,0,0,0,0,0,0,0
"Trinidad and Tobago","2024-12-02",0,0,0,0,0,0,0,0
"Trinidad and Tobago","2024-12-03",0,0,0,0,0,0,0,0
"Trinidad and Tobago","2024-12-04",0,0,0,0,0,0,0,0
"Trinidad and Tobago","2024-12-05",0,0,0,0,0,0,0,0
"Trinidad and Tobago","2024-12-06",0,0,0,0,0,0,0,0
"Trinidad and Tobago","2024-12-07",0,0,0,0,0,0,0,0
"Trinidad and Tobago","2024-12-08",0,0,0,0,0,0,0,0
"Trinidad and Tobago","2024-12-09",0,0,0,0,0,0,0,0
"Trinidad and Tobago","2024-12-10",0,0,0,0,0,0,0,0
"Trinidad and Tobago","2024-12-11",0,0,0,0,0,0,0,0
"Trinidad and Tobago","2024-12-12",0,0,0,0,0,0,0,0
"Trinidad and Tobago","2024-12-13",0,0,0,0,0,0,0,0
"Trinidad and Tobago","2024-12-14",0,0,0,0,0,0,0,0
"Trinidad and Tobago","2024-12-15",0,0,0,0,0,0,0,0
"Trinidad and Tobago","2024-12-16",0,0,0,0,0,0,0,0
"Trinidad and Tobago","2024-12-17",0,0,0,0,0,0,0,0
"Trinidad and Tobago","2024-12-18",0,0,0,0,0,0,0,0
"Trinidad and Tobago","2024-12-19",0,0,0,0,0,0,0,0
"Trinidad and Tobago","2024-12-20",0,0,0,0,0,0,0,0
"Trinidad and Tobago","2024-12-21",0,0,0,0,0,0,0,0
"Trinidad and Tobago","2024-12-22",0,0,0,0,0,0,0,0
"Trinidad and Tobago","2024-12-23",0,0,0,0,0,0,0,0
"Trinidad and Tobago","2024-12-24",0,0,0,0,0,0,0,0
"Trinidad and Tobago","2024-12-25",0,0,0,0,0,0,0,0
"Trinidad and Tobago","2024-12-26",0,0,0,0,0,0,0,0
"Trinidad and Tobago","2024-12-27",0,0,0,0,0,0,0,0
"Trinidad and Tobago","2024-12-28",0,0,0,0,0,0,0,0
"Trinidad and Tobago","2024-12-29",0,0,0,0,0,0,0,0
"Trinidad and Tobago","2024-12-30",0,0,0,0,0,0,0,0
"Trinidad and Tobago","2024-12-31",0,0,0,0,0,0,0,0
"Trinidad and Tobago","2025-01-01",0,0,0,0,0,0,0,0
"Trinidad and Tobago","2025-01-02",0,0,0,0,0,0,0,0
"Trinidad and Tobago","2025-01-03",0,0,0,0,0,0,0,0
"Trinidad and Tobago","2025-01-04",0,0,0,0,0,0,0,0
"Trinidad and Tobago","2025-01-05",0,0,0,0,0,0,0,0
"Trinidad and Tobago","2025-01-06",0,0,0,0,0,0,0,0
"Trinidad and Tobago","2025-01-07",0,0,0,0,0,0,0,0
"Trinidad and Tobago","2025-01-08",0,0,0,0,0,0,0,0
"Trinidad and Tobago","2025-01-09",0,0,0,0,0,0,0,0
"Trinidad and Tobago","2025-01-10",0,0,0,0,0,0,0,0
"Trinidad and Tobago","2025-01-11",0,0,0,0,0,0,0,0
"Trinidad and Tobago","2025-01-12",0,0,0,0,0,0,0,0
"Trinidad and Tobago","2025-01-13",0,0,0,0,0,0,0,0
"Trinidad and Tobago","2025-01-14",0,0,0,0,0,0,0,0
"Trinidad and Tobago","2025-01-15",0,0,0,0,0,0,0,0
"Trinidad and Tobago","2025-01-16",0,0,0,0,0,0,0,0
"Trinidad and Tobago","2025-01-17",0,0,0,0,0,0,0,0
"Trinidad and Tobago","2025-01-18",0,0,0,0,0,0,0,0
"Trinidad and Tobago","2025-01-19",0,0,0,0,0,0,0,0
"Trinidad and Tobago","2025-01-20",0,0,0,0,0,0,0,0
"Trinidad and Tobago","2025-01-21",0,0,0,0,0,0,0,0
"Trinidad and Tobago","2025-01-22",0,0,0,0,0,0,0,0
"Trinidad and Tobago","2025-01-23",0,0,0,0,0,0,0,0
"Trinidad and Tobago","2025-01-24",0,0,0,0,0,0,0,0
"Trinidad and Tobago","2025-01-25",0,0,0,0,0,0,0,0
"Trinidad and Tobago","2025-01-26",0,0,0,0,0,0,0,0
"Trinidad and Tobago","2025-01-27",0,0,0,0,0,0,0,0
"Trinidad and Tobago","2025-01-28",0,0,0,0,0,0,0,0
"Trinidad and Tobago","2025-01-29",0,0,0,0,0,0,0,0
"Trinidad and Tobago","2025-01-30",0,0,0,0,0,0,0,0
"Trinidad and Tobago","2025-01-31",0,0,0,0,0,0,0,0
"Trinidad and Tobago","2025-02-01",0,0,0,0,0,0,0,0
"Trinidad and Tobago","2025-02-02",0,0,0,0,0,0,0,0
"Trinidad and Tobago","2025-02-03",0,0,0,0,0,0,0,0
"Trinidad and Tobago","2025-02-04",0,0,0,0,0,0,0,0
"Trinidad and Tobago","2025-02-05",0,0,0,0,0,0,0,0
"Trinidad and Tobago","2025-02-06",0,0,0,0,0,0,0,0
"Trinidad and Tobago","2025-02-07",0,0,0,0,0,0,0,0
"Trinidad and Tobago","2025-02-08",0,0,0,0,0,0,0,0
"Trinidad and Tobago","2025-02-09",0,0,0,0,0,0,0,0
"Trinidad and Tobago","2025-02-10",0,0,0,0,0,0,0,0
"Trinidad and Tobago","2025-02-11",0,0,0,0,0,0,0,0
"Trinidad and Tobago","2025-02-12",0,0,0,0,0,0,0,0
"Trinidad and Tobago","2025-02-13",0,0,0,0,0,0,0,0
"Trinidad and Tobago","2025-02-14",0,0,0,0,0,0,0,0
"Trinidad and Tobago","2025-02-15",0,0,0,0,0,0,0,0
"Trinidad and Tobago","2025-02-16",0,0,0,0,0,0,0,0
"Trinidad and Tobago","2025-02-17",0,0,0,0,0,0,0,0
"Trinidad and Tobago","2025-02-18",0,0,0,0,0,0,0,0
"Trinidad and Tobago","2025-02-19",0,0,0,0,0,0,0,0
"Trinidad and Tobago","2025-02-20",0,0,0,0,0,0,0,0
"Trinidad and Tobago","2025-02-21",0,0,0,0,0,0,0,0
"Trinidad and Tobago","2025-02-22",0,0,0,0,0,0,0,0
"Trinidad and Tobago","2025-02-23",0,0,0,0,0,0,0,0
"Trinidad and Tobago","2025-02-24",0,0,0,0,0,0,0,0
"Trinidad and Tobago","2025-02-25",0,0,0,0,0,0,0,0
"Trinidad and Tobago","2025-02-26",0,0,0,0,0,0,0,0
"Trinidad and Tobago","2025-02-27",0,0,0,0,0,0,0,0
"Trinidad and Tobago","2025-02-28",0,0,0,0,0,0,0,0
"Trinidad and Tobago","2025-03-01",0,0,0,0,0,0,0,0
"Trinidad and Tobago","2025-03-02",0,0,0,0,0,0,0,0
"Trinidad and Tobago","2025-03-03",0,0,0,0,0,0,0,0
"Türkiye","2024-01-01",0,0,0,0,0,0,0,0
"Türkiye","2024-01-02",0,0,0,0,0,0,0,0
"Türkiye","2024-01-03",0,0,0,0,0,0,0,0
"Türkiye","2024-01-04",0,0,0,0,0,0,0,0
"Türkiye","2024-01-05",0,0,0,0,0,0,0,0
"Türkiye","2024-01-06",0,0,0,0,0,0,0,0
"Türkiye","2024-01-07",0,0,0,0,0,0,0,0
"Türkiye","2024-01-08",0,0,0,0,0,0,0,0
"Türkiye","2024-01-09",0,0,0,0,0,0,0,0
"Türkiye","2024-01-10",0,0,0,0,0,0,0,0
"Türkiye","2024-01-11",0,0,0,0,0,0,0,0
"Türkiye","2024-01-12",0,0,0,0,0,0,0,0
"Türkiye","2024-01-13",0,0,0,0,0,0,0,0
"Türkiye","2024-01-14",0,0,0,0,0,0,0,0
"Türkiye","2024-01-15",0,0,0,0,0,0,0,0
"Türkiye","2024-01-16",0,0,0,0,0,0,0,0
"Türkiye","2024-01-17",0,0,0,0,0,0,0,0
"Türkiye","2024-01-18",0,0,0,0,0,0,0,0
"Türkiye","2024-01-19",0,0,0,0,0,0,0,0
"Türkiye","2024-01-20",0,0,0,0,0,0,0,0
"Türkiye","2024-01-21",0,0,0,0,0,0,0,0
"Türkiye","2024-01-22",0,0,0,0,0,0,0,0
"Türkiye","2024-01-23",0,0,0,0,0,0,0,0
"Türkiye","2024-01-24",0,0,0,0,0,0,0,0
"Türkiye","2024-01-25",0,0,0,0,0,0,0,0
"Türkiye","2024-01-26",0,0,0,0,0,0,0,0
"Türkiye","2024-01-27",0,0,0,0,0,0,0,0
"Türkiye","2024-01-28",0,0,0,0,0,0,0,0
"Türkiye","2024-01-29",0,0,0,0,0,0,0,0
"Türkiye","2024-01-30",0,0,0,0,0,0,0,0
"Türkiye","2024-01-31",0,0,0,0,0,0,0,0
"Türkiye","2024-02-01",0,0,0,0,0,0,0,0
"Türkiye","2024-02-02",0,0,0,0,0,0,0,0
"Türkiye","2024-02-03",0,0,0,0,0,0,0,0
"Türkiye","2024-02-04",0,0,0,0,0,0,0,0
"Türkiye","2024-02-05",0,0,0,0,0,0,0,0
"Türkiye","2024-02-06",0,0,0,0,0,0,0,0
"Türkiye","2024-02-07",0,0,0,0,0,0,0,0
"Türkiye","2024-02-08",0,0,0,0,0,0,0,0
"Türkiye","2024-02-09",0,0,0,0,0,0,0,0
"Türkiye","2024-02-10",0,0,0,0,0,0,0,0
"Türkiye","2024-02-11",0,0,0,0,0,0,0,0
"Türkiye","2024-02-12",0,0,0,0,0,0,0,0
"Türkiye","2024-02-13",0,0,0,0,0,0,0,0
"Türkiye","2024-02-14",0,0,0,0,0,0,0,0
"Türkiye","2024-02-15",0,0,0,0,0,0,0,0
"Türkiye","2024-02-16",0,0,0,0,0,0,0,0
"Türkiye","2024-02-17",0,0,0,0,0,0,0,0
"Türkiye","2024-02-18",0,0,0,0,0,0,0,0
"Türkiye","2024-02-19",0,0,0,0,0,0,0,0
"Türkiye","2024-02-20",0,0,0,0,0,0,0,0
"Türkiye","2024-02-21",0,0,0,0,0,0,0,0
"Türkiye","2024-02-22",0,0,0,0,0,0,0,0
"Türkiye","2024-02-23",0,0,0,0,0,0,0,0
"Türkiye","2024-02-24",0,0,0,0,0,0,0,0
"Türkiye","2024-02-25",0,0,0,0,0,0,0,0
"Türkiye","2024-02-26",0,0,0,0,0,0,0,0
"Türkiye","2024-02-27",0,0,0,0,0,0,0,0
"Türkiye","2024-02-28",0,0,0,0,0,0,0,0
"Türkiye","2024-02-29",0,0,0,0,0,0,0,0
"Türkiye","2024-03-01",0,0,0,0,0,0,0,0
"Türkiye","2024-03-02",0,0,0,0,0,0,0,0
"Türkiye","2024-03-03",0,0,0,0,0,0,0,0
"Türkiye","2024-03-04",0,0,0,0,0,0,0,0
"Türkiye","2024-03-05",0,0,0,0,0,0,0,0
"Türkiye","2024-03-06",0,0,0,0,0,0,0,0
"Türkiye","2024-03-07",0,0,0,0,0,0,0,0
"Türkiye","2024-03-08",0,0,0,0,0,0,0,0
"Türkiye","2024-03-09",0,0,0,0,0,0,0,0
"Türkiye","2024-03-10",0,0,0,0,0,0,0,0
"Türkiye","2024-03-11",0,0,0,0,0,0,0,0
"Türkiye","2024-03-12",0,0,0,0,0,0,0,0
"Türkiye","2024-03-13",0,0,0,0,0,0,0,0
"Türkiye","2024-03-14",0,0,0,0,0,0,0,0
"Türkiye","2024-03-15",0,0,0,0,0,0,0,0
"Türkiye","2024-03-16",0,0,0,0,0,0,0,0
"Türkiye","2024-03-17",0,0,0,0,0,0,0,0
"Türkiye","2024-03-18",0,0,0,0,0,0,0,0
"Türkiye","2024-03-19",0,0,0,0,0,0,0,0
"Türkiye","2024-03-20",0,0,0,0,0,0,0,0
"Türkiye","2024-03-21",0,0,0,0,0,0,0,0
"Türkiye","2024-03-22",0,0,0,0,0,0,0,0
"Türkiye","2024-03-23",0,0,0,0,0,0,0,0
"Türkiye","2024-03-24",0,0,0,0,0,0,0,0
"Türkiye","2024-03-25",0,0,0,0,0,0,0,0
"Türkiye","2024-03-26",0,0,0,0,0,0,0,0
"Türkiye","2024-03-27",0,0,0,0,0,0,0,0
"Türkiye","2024-03-28",0,0,0,0,0,0,0,0
"Türkiye","2024-03-29",0,0,0,0,0,0,0,0
"Türkiye","2024-03-30",0,0,0,0,0,0,0,0
"Türkiye","2024-03-31",0,0,0,0,0,0,0,0
"Türkiye","2024-04-01",0,0,0,0,0,0,0,0
"Türkiye","2024-04-02",0,0,0,0,0,0,0,0
"Türkiye","2024-04-03",0,0,0,0,0,0,0,0
"Türkiye","2024-04-04",0,0,0,0,0,0,0,0
"Türkiye","2024-04-05",0,0,0,0,0,0,0,0
"Türkiye","2024-04-06",0,0,0,0,0,0,0,0
"Türkiye","2024-04-07",0,0,0,0,0,0,0,0
"Türkiye","2024-04-08",0,0,0,0,0,0,0,0
"Türkiye","2024-04-09",0,0,0,0,0,0,0,0
"Türkiye","2024-04-10",0,0,0,0,0,0,0,0
"Türkiye","2024-04-11",0,0,0,0,0,0,0,0
"Türkiye","2024-04-12",0,0,0,0,0,0,0,0
"Türkiye","2024-04-13",0,0,0,0,0,0,0,0
"Türkiye","2024-04-14",0,0,0,0,0,0,0,0
"Türkiye","2024-04-15",0,0,0,0,0,0,0,0
"Türkiye","2024-04-16",0,0,0,0,0,0,0,0
"Türkiye","2024-04-17",0,0,0,0,0,0,0,0
"Türkiye","2024-04-18",0,0,0,0,0,0,0,0
"Türkiye","2024-04-19",0,0,0,0,0,0,0,0
"Türkiye","2024-04-20",0,0,0,0,0,0,0,0
"Türkiye","2024-04-21",0,0,0,0,0,0,0,0
"Türkiye","2024-04-22",0,0,0,0,0,0,0,0
"Türkiye","2024-04-23",0,0,0,0,0,0,0,0
"Türkiye","2024-04-24",0,0,0,0,0,0,0,0
"Türkiye","2024-04-25",0,0,0,0,0,0,0,0
"Türkiye","2024-04-26",0,0,0,0,0,0,0,0
"Türkiye","2024-04-27",0,0,0,0,0,0,0,0
"Türkiye","2024-04-28",0,0,0,0,0,0,0,0
"Türkiye","2024-04-29",0,0,0,0,0,0,0,0
"Türkiye","2024-04-30",0,0,0,0,0,0,0,0
"Türkiye","2024-05-01",0,0,0,0,0,0,0,0
"Türkiye","2024-05-02",0,0,0,0,0,0,0,0
"Türkiye","2024-05-03",0,0,0,0,0,0,0,0
"Türkiye","2024-05-04",0,0,0,0,0,0,0,0
"Türkiye","2024-05-05",0,0,0,0,0,0,0,0
"Türkiye","2024-05-06",0,0,0,0,0,0,0,0
"Türkiye","2024-05-07",0,0,0,0,0,0,0,0
"Türkiye","2024-05-08",0,0,0,0,0,0,0,0
"Türkiye","2024-05-09",0,0,0,0,0,0,0,0
"Türkiye","2024-05-10",0,0,0,0,0,0,0,0
"Türkiye","2024-05-11",0,0,0,0,0,0,0,0
"Türkiye","2024-05-12",0,0,0,0,0,0,0,0
"Türkiye","2024-05-13",0,0,0,0,0,0,0,0
"Türkiye","2024-05-14",0,0,0,0,0,0,0,0
"Türkiye","2024-05-15",0,0,0,0,0,0,0,0
"Türkiye","2024-05-16",0,0,0,0,0,0,0,0
"Türkiye","2024-05-17",0,0,0,0,0,0,0,0
"Türkiye","2024-05-18",0,0,0,0,0,0,0,0
"Türkiye","2024-05-19",0,0,0,0,0,0,0,0
"Türkiye","2024-05-20",0,0,0,0,0,0,0,0
"Türkiye","2024-05-21",0,0,0,0,0,0,0,0
"Türkiye","2024-05-22",0,0,0,0,0,0,0,0
"Türkiye","2024-05-23",0,0,0,0,0,0,0,0
"Türkiye","2024-05-24",0,0,0,0,0,0,0,0
"Türkiye","2024-05-25",0,0,0,0,0,0,0,0
"Türkiye","2024-05-26",0,0,0,0,0,0,0,0
"Türkiye","2024-05-27",0,0,0,0,0,0,0,0
"Türkiye","2024-05-28",0,0,0,0,0,0,0,0
"Türkiye","2024-05-29",0,0,0,0,0,0,0,0
"Türkiye","2024-05-30",0,0,0,0,0,0,0,0
"Türkiye","2024-05-31",0,0,0,0,0,0,0,0
"Türkiye","2024-06-01",0,0,0,0,0,0,0,0
"Türkiye","2024-06-02",0,0,0,0,0,0,0,0
"Türkiye","2024-06-03",0,0,0,0,0,0,0,0
"Türkiye","2024-06-04",0,0,0,0,0,0,0,0
"Türkiye","2024-06-05",0,0,0,0,0,0,0,0
"Türkiye","2024-06-06",0,0,0,0,0,0,0,0
"Türkiye","2024-06-07",0,0,0,0,0,0,0,0
"Türkiye","2024-06-08",0,0,0,0,0,0,0,0
"Türkiye","2024-06-09",0,0,0,0,0,0,0,0
"Türkiye","2024-06-10",0,0,0,0,0,0,0,0
"Türkiye","2024-06-11",0,0,0,0,0,0,0,0
"Türkiye","2024-06-12",0,0,0,0,0,0,0,0
"Türkiye","2024-06-13",0,0,0,0,0,0,0,0
"Türkiye","2024-06-14",0,0,0,0,0,0,0,0
"Türkiye","2024-06-15",0,0,0,0,0,0,0,0
"Türkiye","2024-06-16",0,0,0,0,0,0,0,0
"Türkiye","2024-06-17",0,0,0,0,0,0,0,0
"Türkiye","2024-06-18",0,0,0,0,0,0,0,0
"Türkiye","2024-06-19",0,0,0,0,0,0,0,0
"Türkiye","2024-06-20",0,0,0,0,0,0,0,0
"Türkiye","2024-06-21",0,0,0,0,0,0,0,0
"Türkiye","2024-06-22",0,0,0,0,0,0,0,0
"Türkiye","2024-06-23",0,0,0,0,0,0,0,0
"Türkiye","2024-06-24",0,0,0,0,0,0,0,0
"Türkiye","2024-06-25",0,0,0,0,0,0,0,0
"Türkiye","2024-06-26",0,0,0,0,0,0,0,0
"Türkiye","2024-06-27",0,0,0,0,0,0,0,0
"Türkiye","2024-06-28",0,0,0,0,0,0,0,0
"Türkiye","2024-06-29",0,0,0,0,0,0,0,0
"Türkiye","2024-06-30",0,0,0,0,0,0,0,0
"Türkiye","2024-07-01",0,0,0,0,0,0,0,0
"Türkiye","2024-07-02",0,0,0,0,0,0,0,0
"Türkiye","2024-07-03",0,0,0,0,0,0,0,0
"Türkiye","2024-07-04",0,0,0,0,0,0,0,0
"Türkiye","2024-07-05",0,0,0,0,0,0,0,0
"Türkiye","2024-07-06",0,0,0,0,0,0,0,0
"Türkiye","2024-07-07",0,0,0,0,0,0,0,0
"Türkiye","2024-07-08",0,0,0,0,0,0,0,0
"Türkiye","2024-07-09",0,0,0,0,0,0,0,0
"Türkiye","2024-07-10",0,0,0,0,0,0,0,0
"Türkiye","2024-07-11",0,0,0,0,0,0,0,0
"Türkiye","2024-07-12",0,0,0,0,0,0,0,0
"Türkiye","2024-07-13",0,0,0,0,0,0,0,0
"Türkiye","2024-07-14",0,0,0,0,0,0,0,0
"Türkiye","2024-07-15",0,0,0,0,0,0,0,0
"Türkiye","2024-07-16",0,0,0,0,0,0,0,0
"Türkiye","2024-07-17",0,0,0,0,0,0,0,0
"Türkiye","2024-07-18",0,0,0,0,0,0,0,0
"Türkiye","2024-07-19",0,0,0,0,0,0,0,0
"Türkiye","2024-07-20",0,0,0,0,0,0,0,0
"Türkiye","2024-07-21",0,0,0,0,0,0,0,0
"Türkiye","2024-07-22",0,0,0,0,0,0,0,0
"Türkiye","2024-07-23",0,0,0,0,0,0,0,0
"Türkiye","2024-07-24",0,0,0,0,0,0,0,0
"Türkiye","2024-07-25",0,0,0,0,0,0,0,0
"Türkiye","2024-07-26",0,0,0,0,0,0,0,0
"Türkiye","2024-07-27",0,0,0,0,0,0,0,0
"Türkiye","2024-07-28",0,0,0,0,0,0,0,0
"Türkiye","2024-07-29",0,0,0,0,0,0,0,0
"Türkiye","2024-07-30",0,0,0,0,0,0,0,0
"Türkiye","2024-07-31",0,0,0,0,0,0,0,0
"Türkiye","2024-08-01",0,0,0,0,0,0,0,0
"Türkiye","2024-08-02",0,0,0,0,0,0,0,0
"Türkiye","2024-08-03",0,0,0,0,0,0,0,0
"Türkiye","2024-08-04",0,0,0,0,0,0,0,0
"Türkiye","2024-08-05",0,0,0,0,0,0,0,0
"Türkiye","2024-08-06",0,0,0,0,0,0,0,0
"Türkiye","2024-08-07",0,0,0,0,0,0,0,0
"Türkiye","2024-08-08",0,0,0,0,0,0,0,0
"Türkiye","2024-08-09",0,0,0,0,0,0,0,0
"Türkiye","2024-08-10",0,0,0,0,0,0,0,0
"Türkiye","2024-08-11",0,0,0,0,0,0,0,0
"Türkiye","2024-08-12",0,0,0,0,0,0,0,0
"Türkiye","2024-08-13",0,0,0,0,0,0,0,0
"Türkiye","2024-08-14",0,0,0,0,0,0,0,0
"Türkiye","2024-08-15",0,0,0,0,0,0,0,0
"Türkiye","2024-08-16",0,0,0,0,0,0,0,0
"Türkiye","2024-08-17",0,0,0,0,0,0,0,0
"Türkiye","2024-08-18",0,0,0,0,0,0,0,0
"Türkiye","2024-08-19",0,0,0,0,0,0,0,0
"Türkiye","2024-08-20",0,0,0,0,0,0,0,0
"Türkiye","2024-08-21",0,0,0,0,0,0,0,0
"Türkiye","2024-08-22",0,0,0,0,0,0,0,0
"Türkiye","2024-08-23",0,0,0,0,0,0,0,0
"Türkiye","2024-08-24",0,0,0,0,0,0,0,0
"Türkiye","2024-08-25",0,0,0,0,0,0,0,0
"Türkiye","2024-08-26",0,0,0,0,0,0,0,0
"Türkiye","2024-08-27",0,0,0,0,0,0,0,0
"Türkiye","2024-08-28",0,0,0,0,0,0,0,0
"Türkiye","2024-08-29",0,0,0,0,0,0,0,0
"Türkiye","2024-08-30",0,0,0,0,0,0,0,0
"Türkiye","2024-08-31",0,0,0,0,0,0,0,0
"Türkiye","2024-09-01",0,0,0,0,0,0,0,0
"Türkiye","2024-09-02",0,0,0,0,0,0,0,0
"Türkiye","2024-09-03",0,0,0,0,0,0,0,0
"Türkiye","2024-09-04",0,0,0,0,0,0,0,0
"Türkiye","2024-09-05",0,0,0,0,0,0,0,0
"Türkiye","2024-09-06",0,0,0,0,0,0,0,0
"Türkiye","2024-09-07",0,0,0,0,0,0,0,0
"Türkiye","2024-09-08",0,0,0,0,0,0,0,0
"Türkiye","2024-09-09",0,0,0,0,0,0,0,0
"Türkiye","2024-09-10",0,0,0,0,0,0,0,0
"Türkiye","2024-09-11",0,0,0,0,0,0,0,0
"Türkiye","2024-09-12",0,0,0,0,0,0,0,0
"Türkiye","2024-09-13",0,0,0,0,0,0,0,0
"Türkiye","2024-09-14",0,0,0,0,0,0,0,0
"Türkiye","2024-09-15",0,0,0,0,0,0,0,0
"Türkiye","2024-09-16",0,0,0,0,0,0,0,0
"Türkiye","2024-09-17",0,0,0,0,0,0,0,0
"Türkiye","2024-09-18",0,0,0,0,0,0,0,0
"Türkiye","2024-09-19",0,0,0,0,0,0,0,0
"Türkiye","2024-09-20",0,0,0,0,0,0,0,0
"Türkiye","2024-09-21",0,0,0,0,0,0,0,0
"Türkiye","2024-09-22",0,0,0,0,0,0,0,0
"Türkiye","2024-09-23",0,0,0,0,0,0,0,0
"Türkiye","2024-09-24",0,0,0,0,0,0,0,0
"Türkiye","2024-09-25",0,0,0,0,0,0,0,0
"Türkiye","2024-09-26",0,0,0,0,0,0,0,0
"Türkiye","2024-09-27",0,0,0,0,0,0,0,0
"Türkiye","2024-09-28",0,0,0,0,0,0,0,0
"Türkiye","2024-09-29",0,0,0,0,0,0,0,0
"Türkiye","2024-09-30",0,0,0,0,0,0,0,0
"Türkiye","2024-10-01",0,0,0,0,0,0,0,0
"Türkiye","2024-10-02",0,0,0,0,0,0,0,0
"Türkiye","2024-10-03",0,0,0,0,0,0,0,0
"Türkiye","2024-10-04",0,0,0,0,0,0,0,0
"Türkiye","2024-10-05",0,0,0,0,0,0,0,0
"Türkiye","2024-10-06",0,0,0,0,0,0,0,0
"Türkiye","2024-10-07",0,0,0,0,0,0,0,0
"Türkiye","2024-10-08",0,0,0,0,0,0,0,0
"Türkiye","2024-10-09",0,0,0,0,0,0,0,0
"Türkiye","2024-10-10",0,0,0,0,0,0,0,0
"Türkiye","2024-10-11",0,0,0,0,0,0,0,0
"Türkiye","2024-10-12",0,0,0,0,0,0,0,0
"Türkiye","2024-10-13",0,0,0,0,0,0,0,0
"Türkiye","2024-10-14",0,0,0,0,0,0,0,0
"Türkiye","2024-10-15",0,0,0,0,0,0,0,0
"Türkiye","2024-10-16",0,0,0,0,0,0,0,0
"Türkiye","2024-10-17",0,0,0,0,0,0,0,0
"Türkiye","2024-10-18",0,0,0,0,0,0,0,0
"Türkiye","2024-10-19",0,0,0,0,0,0,0,0
"Türkiye","2024-10-20",0,0,0,0,0,0,0,0
"Türkiye","2024-10-21",0,0,0,0,0,0,0,0
"Türkiye","2024-10-22",0,0,0,0,0,0,0,0
"Türkiye","2024-10-23",0,0,0,0,0,0,0,0
"Türkiye","2024-10-24",0,0,0,0,0,0,0,0
"Türkiye","2024-10-25",0,0,0,0,0,0,0,0
"Türkiye","2024-10-26",0,0,0,0,0,0,0,0
"Türkiye","2024-10-27",0,0,0,0,0,0,0,0
"Türkiye","2024-10-28",0,0,0,0,0,0,0,0
"Türkiye","2024-10-29",0,0,0,0,0,0,0,0
"Türkiye","2024-10-30",0,0,0,0,0,0,0,0
"Türkiye","2024-10-31",0,0,0,0,0,0,0,0
"Türkiye","2024-11-01",0,0,0,0,0,0,0,0
"Türkiye","2024-11-02",0,0,0,0,0,0,0,0
"Türkiye","2024-11-03",0,0,0,0,0,0,0,0
"Türkiye","2024-11-04",0,0,0,0,0,0,0,0
"Türkiye","2024-11-05",0,0,0,0,0,0,0,0
"Türkiye","2024-11-06",0,0,0,0,0,0,0,0
"Türkiye","2024-11-07",0,0,0,0,0,0,0,0
"Türkiye","2024-11-08",0,0,0,0,0,0,0,0
"Türkiye","2024-11-09",0,0,0,0,0,0,0,0
"Türkiye","2024-11-10",0,0,0,0,0,0,0,0
"Türkiye","2024-11-11",0,0,0,0,0,0,0,0
"Türkiye","2024-11-12",0,0,0,0,0,0,0,0
"Türkiye","2024-11-13",0,0,0,0,0,0,0,0
"Türkiye","2024-11-14",0,0,0,0,0,0,0,0
"Türkiye","2024-11-15",0,0,0,0,0,0,0,0
"Türkiye","2024-11-16",0,0,0,0,0,0,0,0
"Türkiye","2024-11-17",0,0,0,0,0,0,0,0
"Türkiye","2024-11-18",0,0,0,0,0,0,0,0
"Türkiye","2024-11-19",0,0,0,0,0,0,0,0
"Türkiye","2024-11-20",0,0,0,0,0,0,0,0
"Türkiye","2024-11-21",0,0,0,0,0,0,0,0
"Türkiye","2024-11-22",0,0,0,0,0,0,0,0
"Türkiye","2024-11-23",0,0,0,0,0,0,0,0
"Türkiye","2024-11-24",0,0,0,0,0,0,0,0
"Türkiye","2024-11-25",0,0,0,0,0,0,0,0
"Türkiye","2024-11-26",0,0,0,0,0,0,0,0
"Türkiye","2024-11-27",0,0,0,0,0,0,0,0
"Türkiye","2024-11-28",0,0,0,0,0,0,0,0
"Türkiye","2024-11-29",0,0,0,0,0,0,0,0
"Türkiye","2024-11-30",0,0,0,0,0,0,0,0
"Türkiye","2024-12-01",0,0,0,0,0,0,0,0
"Türkiye","2024-12-02",0,0,0,0,0,0,0,0
"Türkiye","2024-12-03",0,0,0,0,0,0,0,0
"Türkiye","2024-12-04",0,0,0,0,0,0,0,0
"Türkiye","2024-12-05",0,0,0,0,0,0,0,0
"Türkiye","2024-12-06",0,0,0,0,0,0,0,0
"Türkiye","2024-12-07",0,0,0,0,0,0,0,0
"Türkiye","2024-12-08",0,0,0,0,0,0,0,0
"Türkiye","2024-12-09",0,0,0,0,0,0,0,0
"Türkiye","2024-12-10",0,0,0,0,0,0,0,0
"Türkiye","2024-12-11",0,0,0,0,0,0,0,0
"Türkiye","2024-12-12",0,0,0,0,0,0,0,0
"Türkiye","2024-12-13",0,0,0,0,0,0,0,0
"Türkiye","2024-12-14",0,0,0,0,0,0,0,0
"Türkiye","2024-12-15",0,0,0,0,0,0,0,0
"Türkiye","2024-12-16",0,0,0,0,0,0,0,0
"Türkiye","2024-12-17",0,0,0,0,0,0,0,0
"Türkiye","2024-12-18",0,0,0,0,0,0,0,0
"Türkiye","2024-12-19",0,0,0,0,0,0,0,0
"Türkiye","2024-12-20",0,0,0,0,0,0,0,0
"Türkiye","2024-12-21",0,0,0,0,0,0,0,0
"Türkiye","2024-12-22",0,0,0,0,0,0,0,0
"Türkiye","2024-12-23",0,0,0,0,0,0,0,0
"Türkiye","2024-12-24",0,0,0,0,0,0,0,0
"Türkiye","2024-12-25",0,0,0,0,0,0,0,0
"Türkiye","2024-12-26",0,0,0,0,0,0,0,0
"Türkiye","2024-12-27",0,0,0,0,0,0,0,0
"Türkiye","2024-12-28",0,0,0,0,0,0,0,0
"Türkiye","2024-12-29",0,0,0,0,0,0,0,0
"Türkiye","2024-12-30",0,0,0,0,0,0,0,0
"Türkiye","2024-12-31",0,0,0,0,0,0,0,0
"Türkiye","2025-01-01",0,0,0,0,0,0,0,0
"Türkiye","2025-01-02",0,0,0,0,0,0,0,0
"Türkiye","2025-01-03",0,0,0,0,0,0,0,0
"Türkiye","2025-01-04",0,0,0,0,0,0,0,0
"Türkiye","2025-01-05",0,0,0,0,0,0,0,0
"Türkiye","2025-01-06",0,0,0,0,0,0,0,0
"Türkiye","2025-01-07",0,0,0,0,0,0,0,0
"Türkiye","2025-01-08",0,0,0,0,0,0,0,0
"Türkiye","2025-01-09",0,0,0,0,0,0,0,0
"Türkiye","2025-01-10",0,20,20,0,20,20,0,0
"Türkiye","2025-01-11",0,0,20,0,0,20,0,0
"Türkiye","2025-01-12",0,0,20,0,0,20,0,0
"Türkiye","2025-01-13",0,0,20,0,0,20,0,0
"Türkiye","2025-01-14",0,0,20,0,0,20,0,0
"Türkiye","2025-01-15",0,0,20,0,0,20,0,0
"Türkiye","2025-01-16",0,0,20,0,0,20,0,0
"Türkiye","2025-01-17",0,0,20,0,0,20,0,0
"Türkiye","2025-01-18",0,0,20,0,0,20,0,0
"Türkiye","2025-01-19",0,0,20,0,0,20,0,0
"Türkiye","2025-01-20",0,0,20,0,0,20,0,0
"Türkiye","2025-01-21",0,0,20,0,0,20,0,0
"Türkiye","2025-01-22",0,0,20,0,0,20,0,0
"Türkiye","2025-01-23",0,0,20,0,0,20,0,0
"Türkiye","2025-01-24",0,0,20,0,0,20,0,0
"Türkiye","2025-01-25",0,0,20,0,0,20,0,0
"Türkiye","2025-01-26",0,0,20,0,0,20,0,0
"Türkiye","2025-01-27",0,0,20,0,0,20,0,0
"Türkiye","2025-01-28",0,0,20,0,0,20,0,0
"Türkiye","2025-01-29",0,0,20,0,0,20,0,0
"Türkiye","2025-01-30",0,0,20,0,0,20,0,0
"Türkiye","2025-01-31",0,0,20,0,0,20,0,0
"Türkiye","2025-02-01",0,0,20,0,0,20,0,0
"Türkiye","2025-02-02",0,0,20,0,0,20,0,0
"Türkiye","2025-02-03",0,0,20,0,0,20,0,0
"Türkiye","2025-02-04",0,0,20,0,0,20,0,0
"Türkiye","2025-02-05",0,0,20,0,0,20,0,0
"Türkiye","2025-02-06",0,0,20,0,0,20,0,0
"Türkiye","2025-02-07",0,0,20,0,0,20,0,0
"Türkiye","2025-02-08",0,0,20,0,0,20,0,0
"Türkiye","2025-02-09",0,0,20,0,0,20,0,0
"Türkiye","2025-02-10",0,0,20,0,0,20,0,0
"Türkiye","2025-02-11",0,0,20,0,0,20,0,0
"Türkiye","2025-02-12",0,0,20,0,0,20,0,0
"Türkiye","2025-02-13",0,0,20,0,0,20,0,0
"Türkiye","2025-02-14",0,0,20,0,0,20,0,0
"Türkiye","2025-02-15",0,0,20,0,0,20,0,0
"Türkiye","2025-02-16",0,0,20,0,0,20,0,0
"Türkiye","2025-02-17",0,0,20,0,0,20,0,0
"Türkiye","2025-02-18",0,0,20,0,0,20,0,0
"Türkiye","2025-02-19",0,0,20,0,0,20,0,0
"Türkiye","2025-02-20",0,0,20,0,0,20,0,0
"Türkiye","2025-02-21",0,0,20,0,0,20,0,0
"Türkiye","2025-02-22",0,0,20,0,0,20,0,0
"Türkiye","2025-02-23",0,0,20,0,0,20,0,0
"Türkiye","2025-02-24",0,0,20,0,0,20,0,0
"Türkiye","2025-02-25",0,0,20,0,0,20,0,0
"Türkiye","2025-02-26",0,0,20,0,0,20,0,0
"Türkiye","2025-02-27",0,0,20,0,0,20,0,0
"Türkiye","2025-02-28",0,0,20,0,0,20,0,0
"Türkiye","2025-03-01",0,0,20,0,0,20,0,0
"Türkiye","2025-03-02",0,0,20,0,0,20,0,0
"Türkiye","2025-03-03",0,0,20,0,0,20,0,0
"Uganda","2024-01-01",0,0,0,0,0,0,0,0
"Uganda","2024-01-02",0,0,0,0,0,0,0,0
"Uganda","2024-01-03",0,0,0,0,0,0,0,0
"Uganda","2024-01-04",0,0,0,0,0,0,0,0
"Uganda","2024-01-05",0,0,0,0,0,0,0,0
"Uganda","2024-01-06",0,0,0,0,0,0,0,0
"Uganda","2024-01-07",0,0,0,0,0,0,0,0
"Uganda","2024-01-08",0,0,0,0,0,0,0,0
"Uganda","2024-01-09",0,0,0,0,0,0,0,0
"Uganda","2024-01-10",0,0,0,0,0,0,0,0
"Uganda","2024-01-11",0,0,0,0,0,0,0,0
"Uganda","2024-01-12",0,0,0,0,0,0,0,0
"Uganda","2024-01-13",0,0,0,0,0,0,0,0
"Uganda","2024-01-14",0,0,0,0,0,0,0,0
"Uganda","2024-01-15",0,0,0,0,0,0,0,0
"Uganda","2024-01-16",0,0,0,0,0,0,0,0
"Uganda","2024-01-17",0,0,0,0,0,0,0,0
"Uganda","2024-01-18",0,0,0,0,0,0,0,0
"Uganda","2024-01-19",0,0,0,0,0,0,0,0
"Uganda","2024-01-20",0,0,0,0,0,0,0,0
"Uganda","2024-01-21",0,0,0,0,0,0,0,0
"Uganda","2024-01-22",0,0,0,0,0,0,0,0
"Uganda","2024-01-23",0,0,0,0,0,0,0,0
"Uganda","2024-01-24",0,0,0,0,0,0,0,0
"Uganda","2024-01-25",0,0,0,0,0,0,0,0
"Uganda","2024-01-26",0,0,0,0,0,0,0,0
"Uganda","2024-01-27",0,0,0,0,0,0,0,0
"Uganda","2024-01-28",0,0,0,0,0,0,0,0
"Uganda","2024-01-29",0,0,0,0,0,0,0,0
"Uganda","2024-01-30",0,0,0,0,0,0,0,0
"Uganda","2024-01-31",0,0,0,0,0,0,0,0
"Uganda","2024-02-01",0,0,0,0,0,0,0,0
"Uganda","2024-02-02",0,0,0,0,0,0,0,0
"Uganda","2024-02-03",0,0,0,0,0,0,0,0
"Uganda","2024-02-04",0,0,0,0,0,0,0,0
"Uganda","2024-02-05",0,0,0,0,0,0,0,0
"Uganda","2024-02-06",0,0,0,0,0,0,0,0
"Uganda","2024-02-07",0,0,0,0,0,0,0,0
"Uganda","2024-02-08",0,0,0,0,0,0,0,0
"Uganda","2024-02-09",0,0,0,0,0,0,0,0
"Uganda","2024-02-10",0,0,0,0,0,0,0,0
"Uganda","2024-02-11",0,0,0,0,0,0,0,0
"Uganda","2024-02-12",0,0,0,0,0,0,0,0
"Uganda","2024-02-13",0,0,0,0,0,0,0,0
"Uganda","2024-02-14",0,0,0,0,0,0,0,0
"Uganda","2024-02-15",0,0,0,0,0,0,0,0
"Uganda","2024-02-16",0,0,0,0,0,0,0,0
"Uganda","2024-02-17",0,0,0,0,0,0,0,0
"Uganda","2024-02-18",0,0,0,0,0,0,0,0
"Uganda","2024-02-19",0,0,0,0,0,0,0,0
"Uganda","2024-02-20",0,0,0,0,0,0,0,0
"Uganda","2024-02-21",0,0,0,0,0,0,0,0
"Uganda","2024-02-22",0,0,0,0,0,0,0,0
"Uganda","2024-02-23",0,0,0,0,0,0,0,0
"Uganda","2024-02-24",0,0,0,0,0,0,0,0
"Uganda","2024-02-25",0,0,0,0,0,0,0,0
"Uganda","2024-02-26",0,0,0,0,0,0,0,0
"Uganda","2024-02-27",0,0,0,0,0,0,0,0
"Uganda","2024-02-28",0,0,0,0,0,0,0,0
"Uganda","2024-02-29",0,0,0,0,0,0,0,0
"Uganda","2024-03-01",0,0,0,0,0,0,0,0
"Uganda","2024-03-02",0,0,0,0,0,0,0,0
"Uganda","2024-03-03",0,0,0,0,0,0,0,0
"Uganda","2024-03-04",0,0,0,0,0,0,0,0
"Uganda","2024-03-05",0,0,0,0,0,0,0,0
"Uganda","2024-03-06",0,0,0,0,0,0,0,0
"Uganda","2024-03-07",0,0,0,0,0,0,0,0
"Uganda","2024-03-08",0,0,0,0,0,0,0,0
"Uganda","2024-03-09",0,0,0,0,0,0,0,0
"Uganda","2024-03-10",0,0,0,0,0,0,0,0
"Uganda","2024-03-11",0,0,0,0,0,0,0,0
"Uganda","2024-03-12",0,0,0,0,0,0,0,0
"Uganda","2024-03-13",0,0,0,0,0,0,0,0
"Uganda","2024-03-14",0,0,0,0,0,0,0,0
"Uganda","2024-03-15",0,0,0,0,0,0,0,0
"Uganda","2024-03-16",0,0,0,0,0,0,0,0
"Uganda","2024-03-17",0,0,0,0,0,0,0,0
"Uganda","2024-03-18",0,0,0,0,0,0,0,0
"Uganda","2024-03-19",0,0,0,0,0,0,0,0
"Uganda","2024-03-20",0,0,0,0,0,0,0,0
"Uganda","2024-03-21",0,0,0,0,0,0,0,0
"Uganda","2024-03-22",0,0,0,0,0,0,0,0
"Uganda","2024-03-23",0,0,0,0,0,0,0,0
"Uganda","2024-03-24",0,0,0,0,0,0,0,0
"Uganda","2024-03-25",0,0,0,0,0,0,0,0
"Uganda","2024-03-26",0,0,0,0,0,0,0,0
"Uganda","2024-03-27",0,0,0,0,0,0,0,0
"Uganda","2024-03-28",0,0,0,0,0,0,0,0
"Uganda","2024-03-29",0,0,0,0,0,0,0,0
"Uganda","2024-03-30",0,0,0,0,0,0,0,0
"Uganda","2024-03-31",0,0,0,0,0,0,0,0
"Uganda","2024-04-01",0,0,0,0,0,0,0,0
"Uganda","2024-04-02",0,0,0,0,0,0,0,0
"Uganda","2024-04-03",0,0,0,0,0,0,0,0
"Uganda","2024-04-04",0,0,0,0,0,0,0,0
"Uganda","2024-04-05",0,0,0,0,0,0,0,0
"Uganda","2024-04-06",0,0,0,0,0,0,0,0
"Uganda","2024-04-07",0,0,0,0,0,0,0,0
"Uganda","2024-04-08",0,0,0,0,0,0,0,0
"Uganda","2024-04-09",0,0,0,0,0,0,0,0
"Uganda","2024-04-10",0,0,0,0,0,0,0,0
"Uganda","2024-04-11",0,0,0,0,0,0,0,0
"Uganda","2024-04-12",0,0,0,0,0,0,0,0
"Uganda","2024-04-13",0,0,0,0,0,0,0,0
"Uganda","2024-04-14",0,0,0,0,0,0,0,0
"Uganda","2024-04-15",0,0,0,0,0,0,0,0
"Uganda","2024-04-16",0,0,0,0,0,0,0,0
"Uganda","2024-04-17",0,0,0,0,0,0,0,0
"Uganda","2024-04-18",0,0,0,0,0,0,0,0
"Uganda","2024-04-19",0,0,0,0,0,0,0,0
"Uganda","2024-04-20",0,0,0,0,0,0,0,0
"Uganda","2024-04-21",0,0,0,0,0,0,0,0
"Uganda","2024-04-22",0,0,0,0,0,0,0,0
"Uganda","2024-04-23",0,0,0,0,0,0,0,0
"Uganda","2024-04-24",0,0,0,0,0,0,0,0
"Uganda","2024-04-25",0,0,0,0,0,0,0,0
"Uganda","2024-04-26",0,0,0,0,0,0,0,0
"Uganda","2024-04-27",0,0,0,0,0,0,0,0
"Uganda","2024-04-28",0,0,0,0,0,0,0,0
"Uganda","2024-04-29",0,0,0,0,0,0,0,0
"Uganda","2024-04-30",0,0,0,0,0,0,0,0
"Uganda","2024-05-01",0,0,0,0,0,0,0,0
"Uganda","2024-05-02",0,0,0,0,0,0,0,0
"Uganda","2024-05-03",0,0,0,0,0,0,0,0
"Uganda","2024-05-04",0,0,0,0,0,0,0,0
"Uganda","2024-05-05",0,0,0,0,0,0,0,0
"Uganda","2024-05-06",0,0,0,0,0,0,0,0
"Uganda","2024-05-07",0,0,0,0,0,0,0,0
"Uganda","2024-05-08",0,0,0,0,0,0,0,0
"Uganda","2024-05-09",0,0,0,0,0,0,0,0
"Uganda","2024-05-10",0,0,0,0,0,0,0,0
"Uganda","2024-05-11",0,0,0,0,0,0,0,0
"Uganda","2024-05-12",0,0,0,0,0,0,0,0
"Uganda","2024-05-13",0,0,0,0,0,0,0,0
"Uganda","2024-05-14",0,0,0,0,0,0,0,0
"Uganda","2024-05-15",0,0,0,0,0,0,0,0
"Uganda","2024-05-16",0,0,0,0,0,0,0,0
"Uganda","2024-05-17",0,0,0,0,0,0,0,0
"Uganda","2024-05-18",0,0,0,0,0,0,0,0
"Uganda","2024-05-19",0,0,0,0,0,0,0,0
"Uganda","2024-05-20",0,0,0,0,0,0,0,0
"Uganda","2024-05-21",0,0,0,0,0,0,0,0
"Uganda","2024-05-22",0,0,0,0,0,0,0,0
"Uganda","2024-05-23",0,0,0,0,0,0,0,0
"Uganda","2024-05-24",0,0,0,0,0,0,0,0
"Uganda","2024-05-25",0,0,0,0,0,0,0,0
"Uganda","2024-05-26",0,0,0,0,0,0,0,0
"Uganda","2024-05-27",0,0,0,0,0,0,0,0
"Uganda","2024-05-28",0,0,0,0,0,0,0,0
"Uganda","2024-05-29",0,0,0,0,0,0,0,0
"Uganda","2024-05-30",0,0,0,0,0,0,0,0
"Uganda","2024-05-31",0,0,0,0,0,0,0,0
"Uganda","2024-06-01",0,0,0,0,0,0,0,0
"Uganda","2024-06-02",0,0,0,0,0,0,0,0
"Uganda","2024-06-03",0,0,0,0,0,0,0,0
"Uganda","2024-06-04",0,0,0,0,0,0,0,0
"Uganda","2024-06-05",0,0,0,0,0,0,0,0
"Uganda","2024-06-06",0,0,0,0,0,0,0,0
"Uganda","2024-06-07",0,0,0,0,0,0,0,0
"Uganda","2024-06-08",0,0,0,0,0,0,0,0
"Uganda","2024-06-09",0,0,0,0,0,0,0,0
"Uganda","2024-06-10",0,0,0,0,0,0,0,0
"Uganda","2024-06-11",0,0,0,0,0,0,0,0
"Uganda","2024-06-12",0,0,0,0,0,0,0,0
"Uganda","2024-06-13",0,0,0,0,0,0,0,0
"Uganda","2024-06-14",0,0,0,0,0,0,0,0
"Uganda","2024-06-15",0,0,0,0,0,0,0,0
"Uganda","2024-06-16",0,0,0,0,0,0,0,0
"Uganda","2024-06-17",0,0,0,0,0,0,0,0
"Uganda","2024-06-18",0,0,0,0,0,0,0,0
"Uganda","2024-06-19",0,0,0,0,0,0,0,0
"Uganda","2024-06-20",0,0,0,0,0,0,0,0
"Uganda","2024-06-21",0,0,0,0,0,0,0,0
"Uganda","2024-06-22",0,0,0,0,0,0,0,0
"Uganda","2024-06-23",0,0,0,0,0,0,0,0
"Uganda","2024-06-24",0,0,0,0,0,0,0,0
"Uganda","2024-06-25",0,0,0,0,0,0,0,0
"Uganda","2024-06-26",0,0,0,0,0,0,0,0
"Uganda","2024-06-27",0,0,0,0,0,0,0,0
"Uganda","2024-06-28",0,0,0,0,0,0,0,0
"Uganda","2024-06-29",0,0,0,0,0,0,0,0
"Uganda","2024-06-30",0,0,0,0,0,0,0,0
"Uganda","2024-07-01",0,0,0,0,0,0,0,0
"Uganda","2024-07-02",0,0,0,0,0,0,0,0
"Uganda","2024-07-03",0,0,0,0,0,0,0,0
"Uganda","2024-07-04",0,0,0,0,0,0,0,0
"Uganda","2024-07-05",0,0,0,0,0,0,0,0
"Uganda","2024-07-06",0,0,0,0,0,0,0,0
"Uganda","2024-07-07",0,0,0,0,0,0,0,0
"Uganda","2024-07-08",0,0,0,0,0,0,0,0
"Uganda","2024-07-09",0,0,0,0,0,0,0,0
"Uganda","2024-07-10",0,0,0,0,0,0,0,0
"Uganda","2024-07-11",0,0,0,0,0,0,0,0
"Uganda","2024-07-12",0,0,0,0,0,0,0,0
"Uganda","2024-07-13",0,0,0,0,0,0,0,0
"Uganda","2024-07-14",0,3,3,0,3,3,0,0
"Uganda","2024-07-15",0,0,3,0,0,3,0,0
"Uganda","2024-07-16",0,0,3,0,0,3,0,0
"Uganda","2024-07-17",0,0,3,0,0,3,0,0
"Uganda","2024-07-18",0,0,3,0,0,3,0,0
"Uganda","2024-07-19",0,0,3,0,0,3,0,0
"Uganda","2024-07-20",0,0,3,0,0,3,0,0
"Uganda","2024-07-21",0,0,3,0,0,3,0,0
"Uganda","2024-07-22",0,0,3,0,1,4,0,0
"Uganda","2024-07-23",0,0,3,0,0,4,0,0
"Uganda","2024-07-24",0,0,3,0,0,4,0,0
"Uganda","2024-07-25",0,0,3,0,0,4,0,0
"Uganda","2024-07-26",0,0,3,0,0,4,0,0
"Uganda","2024-07-27",0,0,3,0,0,4,0,0
"Uganda","2024-07-28",0,0,3,0,0,4,0,0
"Uganda","2024-07-29",0,0,3,0,0,4,0,0
"Uganda","2024-07-30",0,0,3,0,0,4,0,0
"Uganda","2024-07-31",0,0,3,0,0,4,0,0
"Uganda","2024-08-01",0,0,3,0,0,4,0,0
"Uganda","2024-08-02",0,0,3,0,0,4,0,0
"Uganda","2024-08-03",0,0,3,0,0,4,0,0
"Uganda","2024-08-04",0,0,3,0,1,5,0,0
"Uganda","2024-08-05",0,0,3,0,0,5,0,0
"Uganda","2024-08-06",0,0,3,0,0,5,0,0
"Uganda","2024-08-07",0,0,3,0,0,5,0,0
"Uganda","2024-08-08",0,0,3,0,0,5,0,0
"Uganda","2024-08-09",0,0,3,0,0,5,0,0
"Uganda","2024-08-10",0,0,3,0,0,5,0,0
"Uganda","2024-08-11",0,2,5,0,0,5,0,0
"Uganda","2024-08-12",0,0,5,0,0,5,0,0
"Uganda","2024-08-13",0,0,5,0,0,5,0,0
"Uganda","2024-08-14",0,0,5,0,0,5,0,0
"Uganda","2024-08-15",0,0,5,0,1,6,0,0
"Uganda","2024-08-16",0,0,5,0,0,6,0,0
"Uganda","2024-08-17",0,0,5,0,0,6,0,0
"Uganda","2024-08-18",0,1,6,0,0,6,0,0
"Uganda","2024-08-19",0,0,6,0,0,6,0,0
"Uganda","2024-08-20",0,0,6,0,0,6,0,0
"Uganda","2024-08-21",0,0,6,0,0,6,0,0
"Uganda","2024-08-22",0,0,6,0,1,7,0,0
"Uganda","2024-08-23",0,0,6,0,0,7,0,0
"Uganda","2024-08-24",0,0,6,0,0,7,0,0
"Uganda","2024-08-25",0,1,7,0,0,7,0,0
"Uganda","2024-08-26",0,0,7,0,0,7,0,0
"Uganda","2024-08-27",0,0,7,0,0,7,0,0
"Uganda","2024-08-28",0,0,7,0,0,7,0,0
"Uganda","2024-08-29",0,0,7,0,1,8,0,0
"Uganda","2024-08-30",0,0,7,0,0,8,0,0
"Uganda","2024-08-31",0,0,7,0,0,8,0,0
"Uganda","2024-09-01",0,1,8,0,0,8,0,0
"Uganda","2024-09-02",0,0,8,0,0,8,0,0
"Uganda","2024-09-03",0,0,8,0,1,9,0,0
"Uganda","2024-09-04",0,0,8,0,0,9,0,0
"Uganda","2024-09-05",0,0,8,0,0,9,0,0
"Uganda","2024-09-06",0,0,8,0,0,9,0,0
"Uganda","2024-09-07",0,0,8,0,1,10,0,0
"Uganda","2024-09-08",0,2,10,0,0,10,0,0
"Uganda","2024-09-09",0,0,10,0,0,10,0,0
"Uganda","2024-09-10",0,0,10,0,0,10,0,0
"Uganda","2024-09-11",0,0,10,0,0,10,0,0
"Uganda","2024-09-12",0,0,10,0,1,11,0,0
"Uganda","2024-09-13",0,0,10,0,0,11,0,0
"Uganda","2024-09-14",0,0,10,0,0,11,0,0
"Uganda","2024-09-15",0,1,11,0,0,11,0,0
"Uganda","2024-09-16",0,0,11,0,2,13,0,0
"Uganda","2024-09-17",0,0,11,0,1,14,0,0
"Uganda","2024-09-18",0,0,11,0,2,16,0,0
"Uganda","2024-09-19",0,0,11,0,1,17,0,0
"Uganda","2024-09-20",0,0,11,0,2,19,0,0
"Uganda","2024-09-21",0,0,11,0,1,20,0,0
"Uganda","2024-09-22",0,11,22,0,2,22,0,0
"Uganda","2024-09-23",0,0,22,0,2,24,0,0
"Uganda","2024-09-24",0,0,22,0,3,27,0,0
"Uganda","2024-09-25",0,0,22,0,2,29,0,0
"Uganda","2024-09-26",0,0,22,0,2,31,0,0
"Uganda","2024-09-27",0,0,22,0,2,33,0,0
"Uganda","2024-09-28",0,0,22,0,3,36,0,0
"Uganda","2024-09-29",0,16,38,0,2,38,0,0
"Uganda","2024-09-30",0,0,38,0,5,43,0,0
"Uganda","2024-10-01",0,0,38,0,4,47,0,0
"Uganda","2024-10-02",0,0,38,0,5,52,0,0
"Uganda","2024-10-03",0,0,38,0,4,56,0,0
"Uganda","2024-10-04",0,0,38,0,5,61,0,0
"Uganda","2024-10-05",0,0,38,0,4,65,0,0
"Uganda","2024-10-06",0,32,70,0,5,70,0,0
"Uganda","2024-10-07",0,0,70,0,6,76,0,0
"Uganda","2024-10-08",0,0,70,0,6,82,0,0
"Uganda","2024-10-09",0,0,70,0,6,88,0,0
"Uganda","2024-10-10",0,0,70,0,5,93,0,0
"Uganda","2024-10-11",0,0,70,0,6,99,0,0
"Uganda","2024-10-12",0,0,70,0,6,105,0,0
"Uganda","2024-10-13",0,41,111,0,6,111,0,0
"Uganda","2024-10-14",0,0,111,0,8,119,0,0
"Uganda","2024-10-15",0,0,111,0,7,126,0,0
"Uganda","2024-10-16",0,0,111,0,8,134,0,0
"Uganda","2024-10-17",0,0,111,0,7,141,0,0
"Uganda","2024-10-18",0,0,111,0,8,149,0,0
"Uganda","2024-10-19",0,0,111,0,7,156,0,0
"Uganda","2024-10-20",0,53,164,0,8,164,0,0
"Uganda","2024-10-21",0,0,164,0,15,179,0,0
"Uganda","2024-10-22",0,0,164,0,16,195,0,0
"Uganda","2024-10-23",0,0,164,0,15,210,0,0
"Uganda","2024-10-24",0,0,164,0,16,226,0,0
"Uganda","2024-10-25",0,0,164,0,15,241,0,0
"Uganda","2024-10-26",0,0,164,0,16,257,0,0
"Uganda","2024-10-27",0,108,272,0,15,272,0,0
"Uganda","2024-10-28",0,0,272,0,15,287,0,0
"Uganda","2024-10-29",0,0,272,0,15,302,0,0
"Uganda","2024-10-30",0,0,272,0,15,317,0,0
"Uganda","2024-10-31",0,0,272,0,15,332,0,0
"Uganda","2024-11-01",0,0,272,0,15,347,0,0
"Uganda","2024-11-02",0,0,272,0,15,362,0,0
"Uganda","2024-11-03",0,105,377,0,15,377,0,0
"Uganda","2024-11-04",0,0,377,0,12,389,0,0
"Uganda","2024-11-05",0,0,377,0,12,401,0,0
"Uganda","2024-11-06",0,0,377,0,12,413,0,0
"Uganda","2024-11-07",0,0,377,0,13,426,0,0
"Uganda","2024-11-08",0,0,377,0,12,438,0,0
"Uganda","2024-11-09",0,0,377,0,12,450,0,0
"Uganda","2024-11-10",0,85,462,0,12,462,0,0
"Uganda","2024-11-11",0,0,462,0,15,477,0,0
"Uganda","2024-11-12",0,0,462,0,16,493,0,0
"Uganda","2024-11-13",0,0,462,0,15,508,0,0
"Uganda","2024-11-14",0,0,462,0,15,523,0,0
"Uganda","2024-11-15",0,0,462,0,15,538,0,0
"Uganda","2024-11-16",0,0,462,0,16,554,0,0
"Uganda","2024-11-17",0,107,569,0,15,569,0,0
"Uganda","2024-11-18",0,0,569,0,18,587,0,0
"Uganda","2024-11-19",0,0,569,0,17,604,0,0
"Uganda","2024-11-20",0,0,569,0,18,622,0,0
"Uganda","2024-11-21",0,0,569,0,18,640,0,0
"Uganda","2024-11-22",0,0,569,0,18,658,0,0
"Uganda","2024-11-23",0,0,569,0,17,675,0,0
"Uganda","2024-11-24",0,124,693,0,18,693,0,0
"Uganda","2024-11-25",0,0,693,0,19,712,0,0
"Uganda","2024-11-26",0,0,693,0,19,731,0,0
"Uganda","2024-11-27",0,0,693,0,19,750,0,0
"Uganda","2024-11-28",0,0,693,0,19,769,0,0
"Uganda","2024-11-29",0,0,693,0,19,788,0,0
"Uganda","2024-11-30",0,0,693,0,19,807,0,0
"Uganda","2024-12-01",0,133,826,0,19,826,0,0
"Uganda","2024-12-02",0,0,826,0,19,845,0,0
"Uganda","2024-12-03",0,0,826,0,19,864,0,0
"Uganda","2024-12-04",0,0,826,0,19,883,0,0
"Uganda","2024-12-05",0,0,826,0,20,903,0,0
"Uganda","2024-12-06",0,0,826,0,19,922,0,0
"Uganda","2024-12-07",0,0,826,0,19,941,0,0
"Uganda","2024-12-08",0,134,960,0,19,960,0,0
"Uganda","2024-12-09",0,0,960,0,18,978,0,0
"Uganda","2024-12-10",0,0,960,0,18,996,0,0
"Uganda","2024-12-11",0,0,960,0,18,1014,0,0
"Uganda","2024-12-12",0,0,960,0,17,1031,0,0
"Uganda","2024-12-13",0,0,960,0,18,1049,0,0
"Uganda","2024-12-14",0,0,960,0,18,1067,0,0
"Uganda","2024-12-15",0,125,1085,0,18,1085,0,0
"Uganda","2024-12-16",0,0,1085,0,24,1109,0,0
"Uganda","2024-12-17",0,0,1085,0,24,1133,0,0
"Uganda","2024-12-18",0,0,1085,0,24,1157,0,0
"Uganda","2024-12-19",0,0,1085,0,24,1181,0,0
"Uganda","2024-12-20",0,0,1085,0,24,1205,0,0
"Uganda","2024-12-21",0,0,1085,0,24,1229,0,0
"Uganda","2024-12-22",0,168,1253,0,24,1253,0,0
"Uganda","2024-12-23",0,0,1253,0,22,1275,0,0
"Uganda","2024-12-24",0,0,1253,0,22,1297,0,0
"Uganda","2024-12-25",0,0,1253,0,22,1319,0,0
"Uganda","2024-12-26",0,0,1253,0,23,1342,0,0
"Uganda","2024-12-27",0,0,1253,0,22,1364,0,0
"Uganda","2024-12-28",0,0,1253,0,22,1386,0,0
"Uganda","2024-12-29",0,155,1408,0,22,1408,0,0
"Uganda","2024-12-30",0,0,1408,0,40,1448,0,0
"Uganda","2024-12-31",0,0,1408,0,41,1489,0,0
"Uganda","2025-01-01",0,0,1408,0,40,1529,0,0
"Uganda","2025-01-02",0,0,1408,0,40,1569,0,0
"Uganda","2025-01-03",0,0,1408,0,40,1609,0,0
"Uganda","2025-01-04",0,0,1408,0,41,1650,0,0
"Uganda","2025-01-05",0,282,1690,0,40,1690,0,0
"Uganda","2025-01-06",0,0,1690,0,44,1734,0,0
"Uganda","2025-01-07",0,0,1690,0,44,1778,0,0
"Uganda","2025-01-08",0,0,1690,0,44,1822,0,0
"Uganda","2025-01-09",0,0,1690,0,44,1866,0,0
"Uganda","2025-01-10",0,0,1690,0,44,1910,0,0
"Uganda","2025-01-11",0,0,1690,0,44,1954,0,0
"Uganda","2025-01-12",0,308,1998,0,44,1998,0,0
"Uganda","2025-01-13",0,0,1998,0,34,2032,0,0
"Uganda","2025-01-14",0,0,1998,0,33,2065,0,0
"Uganda","2025-01-15",0,0,1998,0,34,2099,0,0
"Uganda","2025-01-16",0,0,1998,0,34,2133,0,0
"Uganda","2025-01-17",0,0,1998,0,34,2167,0,0
"Uganda","2025-01-18",0,0,1998,0,33,2200,0,0
"Uganda","2025-01-19",0,236,2234,0,34,2234,0,0
"Uganda","2025-01-20",0,0,2234,0,28,2262,0,0
"Uganda","2025-01-21",0,0,2234,0,28,2290,0,0
"Uganda","2025-01-22",0,0,2234,0,28,2318,0,0
"Uganda","2025-01-23",0,0,2234,0,28,2346,0,0
"Uganda","2025-01-24",0,0,2234,0,28,2374,0,0
"Uganda","2025-01-25",0,0,2234,0,28,2402,0,0
"Uganda","2025-01-26",0,196,2430,0,28,2430,0,0
"Uganda","2025-01-27",0,0,2430,0,30,2460,0,0
"Uganda","2025-01-28",0,0,2430,0,30,2490,0,0
"Uganda","2025-01-29",0,0,2430,0,30,2520,0,0
"Uganda","2025-01-30",0,0,2430,0,30,2550,0,0
"Uganda","2025-01-31",0,0,2430,0,30,2580,0,0
"Uganda","2025-02-01",0,0,2430,0,30,2610,0,0
"Uganda","2025-02-02",0,210,2640,0,30,2640,0,0
"Uganda","2025-02-03",0,0,2640,0,30,2670,0,0
"Uganda","2025-02-04",0,0,2640,0,30,2700,0,0
"Uganda","2025-02-05",0,0,2640,0,30,2730,0,0
"Uganda","2025-02-06",0,0,2640,0,29,2759,0,0
"Uganda","2025-02-07",0,0,2640,0,30,2789,0,0
"Uganda","2025-02-08",0,0,2640,0,30,2819,0,0
"Uganda","2025-02-09",0,209,2849,0,30,2849,0,0
"Uganda","2025-02-10",0,0,2849,0,50,2899,0,0
"Uganda","2025-02-11",0,100,2949,0,50,2949,0,0
"Uganda","2025-02-12",0,0,2949,0,0,2949,0,0
"Uganda","2025-02-13",0,0,2949,0,0,2949,0,0
"Uganda","2025-02-14",0,0,2949,0,0,2949,0,0
"Uganda","2025-02-15",0,0,2949,0,0,2949,0,0
"Uganda","2025-02-16",0,0,2949,0,0,2949,0,0
"Uganda","2025-02-17",0,0,2949,0,0,2949,0,0
"Uganda","2025-02-18",0,0,2949,0,0,2949,0,0
"Uganda","2025-02-19",0,0,2949,0,0,2949,0,0
"Uganda","2025-02-20",0,0,2949,0,0,2949,0,0
"Uganda","2025-02-21",0,0,2949,0,0,2949,0,0
"Uganda","2025-02-22",0,0,2949,0,0,2949,0,0
"Uganda","2025-02-23",0,0,2949,0,0,2949,0,0
"Uganda","2025-02-24",0,0,2949,0,0,2949,0,0
"Uganda","2025-02-25",0,0,2949,0,0,2949,0,0
"Uganda","2025-02-26",0,0,2949,0,0,2949,0,0
"Uganda","2025-02-27",0,0,2949,0,0,2949,0,0
"Uganda","2025-02-28",0,0,2949,0,0,2949,0,0
"Uganda","2025-03-01",0,0,2949,0,0,2949,0,0
"Uganda","2025-03-02",0,0,2949,0,0,2949,0,0
"Uganda","2025-03-03",0,0,2949,0,0,2949,0,0
"Ukraine","2024-01-01",0,0,0,0,0,0,0,0
"Ukraine","2024-01-02",0,0,0,0,0,0,0,0
"Ukraine","2024-01-03",0,0,0,0,0,0,0,0
"Ukraine","2024-01-04",0,0,0,0,0,0,0,0
"Ukraine","2024-01-05",0,0,0,0,0,0,0,0
"Ukraine","2024-01-06",0,0,0,0,0,0,0,0
"Ukraine","2024-01-07",0,0,0,0,0,0,0,0
"Ukraine","2024-01-08",0,0,0,0,0,0,0,0
"Ukraine","2024-01-09",0,0,0,0,0,0,0,0
"Ukraine","2024-01-10",0,0,0,0,0,0,0,0
"Ukraine","2024-01-11",0,0,0,0,0,0,0,0
"Ukraine","2024-01-12",0,0,0,0,0,0,0,0
"Ukraine","2024-01-13",0,0,0,0,0,0,0,0
"Ukraine","2024-01-14",0,0,0,0,0,0,0,0
"Ukraine","2024-01-15",0,0,0,0,0,0,0,0
"Ukraine","2024-01-16",0,0,0,0,0,0,0,0
"Ukraine","2024-01-17",0,0,0,0,0,0,0,0
"Ukraine","2024-01-18",0,0,0,0,0,0,0,0
"Ukraine","2024-01-19",0,0,0,0,0,0,0,0
"Ukraine","2024-01-20",0,0,0,0,0,0,0,0
"Ukraine","2024-01-21",0,0,0,0,0,0,0,0
"Ukraine","2024-01-22",0,0,0,0,0,0,0,0
"Ukraine","2024-01-23",0,0,0,0,0,0,0,0
"Ukraine","2024-01-24",0,0,0,0,0,0,0,0
"Ukraine","2024-01-25",0,0,0,0,0,0,0,0
"Ukraine","2024-01-26",0,0,0,0,0,0,0,0
"Ukraine","2024-01-27",0,0,0,0,0,0,0,0
"Ukraine","2024-01-28",0,0,0,0,0,0,0,0
"Ukraine","2024-01-29",0,0,0,0,0,0,0,0
"Ukraine","2024-01-30",0,0,0,0,0,0,0,0
"Ukraine","2024-01-31",0,0,0,0,0,0,0,0
"Ukraine","2024-02-01",0,0,0,0,0,0,0,0
"Ukraine","2024-02-02",0,0,0,0,0,0,0,0
"Ukraine","2024-02-03",0,0,0,0,0,0,0,0
"Ukraine","2024-02-04",0,0,0,0,0,0,0,0
"Ukraine","2024-02-05",0,0,0,0,0,0,0,0
"Ukraine","2024-02-06",0,0,0,0,0,0,0,0
"Ukraine","2024-02-07",0,0,0,0,0,0,0,0
"Ukraine","2024-02-08",0,0,0,0,0,0,0,0
"Ukraine","2024-02-09",0,0,0,0,0,0,0,0
"Ukraine","2024-02-10",0,0,0,0,0,0,0,0
"Ukraine","2024-02-11",0,0,0,0,0,0,0,0
"Ukraine","2024-02-12",0,0,0,0,0,0,0,0
"Ukraine","2024-02-13",0,0,0,0,0,0,0,0
"Ukraine","2024-02-14",0,0,0,0,0,0,0,0
"Ukraine","2024-02-15",0,0,0,0,0,0,0,0
"Ukraine","2024-02-16",0,0,0,0,0,0,0,0
"Ukraine","2024-02-17",0,0,0,0,0,0,0,0
"Ukraine","2024-02-18",0,0,0,0,0,0,0,0
"Ukraine","2024-02-19",0,0,0,0,0,0,0,0
"Ukraine","2024-02-20",0,0,0,0,0,0,0,0
"Ukraine","2024-02-21",0,0,0,0,0,0,0,0
"Ukraine","2024-02-22",0,0,0,0,0,0,0,0
"Ukraine","2024-02-23",0,0,0,0,0,0,0,0
"Ukraine","2024-02-24",0,0,0,0,0,0,0,0
"Ukraine","2024-02-25",0,0,0,0,0,0,0,0
"Ukraine","2024-02-26",0,0,0,0,0,0,0,0
"Ukraine","2024-02-27",0,0,0,0,0,0,0,0
"Ukraine","2024-02-28",0,0,0,0,0,0,0,0
"Ukraine","2024-02-29",0,0,0,0,0,0,0,0
"Ukraine","2024-03-01",0,0,0,0,0,0,0,0
"Ukraine","2024-03-02",0,0,0,0,0,0,0,0
"Ukraine","2024-03-03",0,0,0,0,0,0,0,0
"Ukraine","2024-03-04",0,0,0,0,0,0,0,0
"Ukraine","2024-03-05",0,0,0,0,0,0,0,0
"Ukraine","2024-03-06",0,0,0,0,0,0,0,0
"Ukraine","2024-03-07",0,0,0,0,0,0,0,0
"Ukraine","2024-03-08",0,0,0,0,0,0,0,0
"Ukraine","2024-03-09",0,0,0,0,0,0,0,0
"Ukraine","2024-03-10",0,0,0,0,0,0,0,0
"Ukraine","2024-03-11",0,0,0,0,0,0,0,0
"Ukraine","2024-03-12",0,0,0,0,0,0,0,0
"Ukraine","2024-03-13",0,0,0,0,0,0,0,0
"Ukraine","2024-03-14",0,0,0,0,0,0,0,0
"Ukraine","2024-03-15",0,0,0,0,0,0,0,0
"Ukraine","2024-03-16",0,0,0,0,0,0,0,0
"Ukraine","2024-03-17",0,0,0,0,0,0,0,0
"Ukraine","2024-03-18",0,0,0,0,0,0,0,0
"Ukraine","2024-03-19",0,0,0,0,0,0,0,0
"Ukraine","2024-03-20",0,0,0,0,0,0,0,0
"Ukraine","2024-03-21",0,0,0,0,0,0,0,0
"Ukraine","2024-03-22",0,0,0,0,0,0,0,0
"Ukraine","2024-03-23",0,0,0,0,0,0,0,0
"Ukraine","2024-03-24",0,0,0,0,0,0,0,0
"Ukraine","2024-03-25",0,0,0,0,0,0,0,0
"Ukraine","2024-03-26",0,0,0,0,0,0,0,0
"Ukraine","2024-03-27",0,0,0,0,0,0,0,0
"Ukraine","2024-03-28",0,0,0,0,0,0,0,0
"Ukraine","2024-03-29",0,0,0,0,0,0,0,0
"Ukraine","2024-03-30",0,0,0,0,0,0,0,0
"Ukraine","2024-03-31",0,0,0,0,0,0,0,0
"Ukraine","2024-04-01",0,0,0,0,0,0,0,0
"Ukraine","2024-04-02",0,0,0,0,0,0,0,0
"Ukraine","2024-04-03",0,0,0,0,0,0,0,0
"Ukraine","2024-04-04",0,0,0,0,0,0,0,0
"Ukraine","2024-04-05",0,0,0,0,0,0,0,0
"Ukraine","2024-04-06",0,0,0,0,0,0,0,0
"Ukraine","2024-04-07",0,0,0,0,0,0,0,0
"Ukraine","2024-04-08",0,0,0,0,0,0,0,0
"Ukraine","2024-04-09",0,0,0,0,0,0,0,0
"Ukraine","2024-04-10",0,0,0,0,0,0,0,0
"Ukraine","2024-04-11",0,0,0,0,0,0,0,0
"Ukraine","2024-04-12",0,0,0,0,0,0,0,0
"Ukraine","2024-04-13",0,0,0,0,0,0,0,0
"Ukraine","2024-04-14",0,0,0,0,0,0,0,0
"Ukraine","2024-04-15",0,0,0,0,0,0,0,0
"Ukraine","2024-04-16",0,0,0,0,0,0,0,0
"Ukraine","2024-04-17",0,0,0,0,0,0,0,0
"Ukraine","2024-04-18",0,0,0,0,0,0,0,0
"Ukraine","2024-04-19",0,0,0,0,0,0,0,0
"Ukraine","2024-04-20",0,0,0,0,0,0,0,0
"Ukraine","2024-04-21",0,0,0,0,0,0,0,0
"Ukraine","2024-04-22",0,0,0,0,0,0,0,0
"Ukraine","2024-04-23",0,0,0,0,0,0,0,0
"Ukraine","2024-04-24",0,0,0,0,0,0,0,0
"Ukraine","2024-04-25",0,0,0,0,0,0,0,0
"Ukraine","2024-04-26",0,0,0,0,0,0,0,0
"Ukraine","2024-04-27",0,0,0,0,0,0,0,0
"Ukraine","2024-04-28",0,0,0,0,0,0,0,0
"Ukraine","2024-04-29",0,0,0,0,0,0,0,0
"Ukraine","2024-04-30",0,0,0,0,0,0,0,0
"Ukraine","2024-05-01",0,0,0,0,0,0,0,0
"Ukraine","2024-05-02",0,0,0,0,0,0,0,0
"Ukraine","2024-05-03",0,0,0,0,0,0,0,0
"Ukraine","2024-05-04",0,0,0,0,0,0,0,0
"Ukraine","2024-05-05",0,0,0,0,0,0,0,0
"Ukraine","2024-05-06",0,0,0,0,0,0,0,0
"Ukraine","2024-05-07",0,0,0,0,0,0,0,0
"Ukraine","2024-05-08",0,0,0,0,0,0,0,0
"Ukraine","2024-05-09",0,0,0,0,0,0,0,0
"Ukraine","2024-05-10",0,0,0,0,0,0,0,0
"Ukraine","2024-05-11",0,0,0,0,0,0,0,0
"Ukraine","2024-05-12",0,0,0,0,0,0,0,0
"Ukraine","2024-05-13",0,0,0,0,0,0,0,0
"Ukraine","2024-05-14",0,0,0,0,0,0,0,0
"Ukraine","2024-05-15",0,0,0,0,0,0,0,0
"Ukraine","2024-05-16",0,0,0,0,0,0,0,0
"Ukraine","2024-05-17",0,0,0,0,0,0,0,0
"Ukraine","2024-05-18",0,0,0,0,0,0,0,0
"Ukraine","2024-05-19",0,0,0,0,0,0,0,0
"Ukraine","2024-05-20",0,0,0,0,0,0,0,0
"Ukraine","2024-05-21",0,0,0,0,0,0,0,0
"Ukraine","2024-05-22",0,0,0,0,0,0,0,0
"Ukraine","2024-05-23",0,0,0,0,0,0,0,0
"Ukraine","2024-05-24",0,0,0,0,0,0,0,0
"Ukraine","2024-05-25",0,0,0,0,0,0,0,0
"Ukraine","2024-05-26",0,0,0,0,0,0,0,0
"Ukraine","2024-05-27",0,0,0,0,0,0,0,0
"Ukraine","2024-05-28",0,0,0,0,0,0,0,0
"Ukraine","2024-05-29",0,0,0,0,0,0,0,0
"Ukraine","2024-05-30",0,0,0,0,0,0,0,0
"Ukraine","2024-05-31",0,0,0,0,0,0,0,0
"Ukraine","2024-06-01",0,0,0,0,0,0,0,0
"Ukraine","2024-06-02",0,0,0,0,0,0,0,0
"Ukraine","2024-06-03",0,0,0,0,0,0,0,0
"Ukraine","2024-06-04",0,0,0,0,0,0,0,0
"Ukraine","2024-06-05",0,0,0,0,0,0,0,0
"Ukraine","2024-06-06",0,0,0,0,0,0,0,0
"Ukraine","2024-06-07",0,0,0,0,0,0,0,0
"Ukraine","2024-06-08",0,0,0,0,0,0,0,0
"Ukraine","2024-06-09",0,0,0,0,0,0,0,0
"Ukraine","2024-06-10",0,0,0,0,0,0,0,0
"Ukraine","2024-06-11",0,0,0,0,0,0,0,0
"Ukraine","2024-06-12",0,0,0,0,0,0,0,0
"Ukraine","2024-06-13",0,0,0,0,0,0,0,0
"Ukraine","2024-06-14",0,0,0,0,0,0,0,0
"Ukraine","2024-06-15",0,0,0,0,0,0,0,0
"Ukraine","2024-06-16",0,0,0,0,0,0,0,0
"Ukraine","2024-06-17",0,0,0,0,0,0,0,0
"Ukraine","2024-06-18",0,0,0,0,0,0,0,0
"Ukraine","2024-06-19",0,0,0,0,0,0,0,0
"Ukraine","2024-06-20",0,0,0,0,0,0,0,0
"Ukraine","2024-06-21",0,0,0,0,0,0,0,0
"Ukraine","2024-06-22",0,0,0,0,0,0,0,0
"Ukraine","2024-06-23",0,0,0,0,0,0,0,0
"Ukraine","2024-06-24",0,0,0,0,0,0,0,0
"Ukraine","2024-06-25",0,0,0,0,0,0,0,0
"Ukraine","2024-06-26",0,0,0,0,0,0,0,0
"Ukraine","2024-06-27",0,0,0,0,0,0,0,0
"Ukraine","2024-06-28",0,0,0,0,0,0,0,0
"Ukraine","2024-06-29",0,0,0,0,0,0,0,0
"Ukraine","2024-06-30",0,0,0,0,0,0,0,0
"Ukraine","2024-07-01",0,0,0,0,0,0,0,0
"Ukraine","2024-07-02",0,0,0,0,0,0,0,0
"Ukraine","2024-07-03",0,0,0,0,0,0,0,0
"Ukraine","2024-07-04",0,0,0,0,0,0,0,0
"Ukraine","2024-07-05",0,0,0,0,0,0,0,0
"Ukraine","2024-07-06",0,0,0,0,0,0,0,0
"Ukraine","2024-07-07",0,0,0,0,0,0,0,0
"Ukraine","2024-07-08",0,0,0,0,0,0,0,0
"Ukraine","2024-07-09",0,0,0,0,0,0,0,0
"Ukraine","2024-07-10",0,0,0,0,0,0,0,0
"Ukraine","2024-07-11",0,0,0,0,0,0,0,0
"Ukraine","2024-07-12",0,0,0,0,0,0,0,0
"Ukraine","2024-07-13",0,0,0,0,0,0,0,0
"Ukraine","2024-07-14",0,0,0,0,0,0,0,0
"Ukraine","2024-07-15",0,0,0,0,0,0,0,0
"Ukraine","2024-07-16",0,0,0,0,0,0,0,0
"Ukraine","2024-07-17",0,0,0,0,0,0,0,0
"Ukraine","2024-07-18",0,0,0,0,0,0,0,0
"Ukraine","2024-07-19",0,0,0,0,0,0,0,0
"Ukraine","2024-07-20",0,0,0,0,0,0,0,0
"Ukraine","2024-07-21",0,0,0,0,0,0,0,0
"Ukraine","2024-07-22",0,0,0,0,0,0,0,0
"Ukraine","2024-07-23",0,0,0,0,0,0,0,0
"Ukraine","2024-07-24",0,0,0,0,0,0,0,0
"Ukraine","2024-07-25",0,0,0,0,0,0,0,0
"Ukraine","2024-07-26",0,0,0,0,0,0,0,0
"Ukraine","2024-07-27",0,0,0,0,0,0,0,0
"Ukraine","2024-07-28",0,0,0,0,0,0,0,0
"Ukraine","2024-07-29",0,0,0,0,0,0,0,0
"Ukraine","2024-07-30",0,0,0,0,0,0,0,0
"Ukraine","2024-07-31",0,0,0,0,0,0,0,0
"Ukraine","2024-08-01",0,0,0,0,0,0,0,0
"Ukraine","2024-08-02",0,0,0,0,0,0,0,0
"Ukraine","2024-08-03",0,0,0,0,0,0,0,0
"Ukraine","2024-08-04",0,0,0,0,0,0,0,0
"Ukraine","2024-08-05",0,0,0,0,0,0,0,0
"Ukraine","2024-08-06",0,0,0,0,0,0,0,0
"Ukraine","2024-08-07",0,0,0,0,0,0,0,0
"Ukraine","2024-08-08",0,0,0,0,0,0,0,0
"Ukraine","2024-08-09",0,0,0,0,0,0,0,0
"Ukraine","2024-08-10",0,0,0,0,0,0,0,0
"Ukraine","2024-08-11",0,0,0,0,0,0,0,0
"Ukraine","2024-08-12",0,0,0,0,0,0,0,0
"Ukraine","2024-08-13",0,0,0,0,0,0,0,0
"Ukraine","2024-08-14",0,0,0,0,0,0,0,0
"Ukraine","2024-08-15",0,0,0,0,0,0,0,0
"Ukraine","2024-08-16",0,0,0,0,0,0,0,0
"Ukraine","2024-08-17",0,0,0,0,0,0,0,0
"Ukraine","2024-08-18",0,0,0,0,0,0,0,0
"Ukraine","2024-08-19",0,0,0,0,0,0,0,0
"Ukraine","2024-08-20",0,0,0,0,0,0,0,0
"Ukraine","2024-08-21",0,0,0,0,0,0,0,0
"Ukraine","2024-08-22",0,0,0,0,0,0,0,0
"Ukraine","2024-08-23",0,0,0,0,0,0,0,0
"Ukraine","2024-08-24",0,0,0,0,0,0,0,0
"Ukraine","2024-08-25",0,0,0,0,0,0,0,0
"Ukraine","2024-08-26",0,0,0,0,0,0,0,0
"Ukraine","2024-08-27",0,0,0,0,0,0,0,0
"Ukraine","2024-08-28",0,0,0,0,0,0,0,0
"Ukraine","2024-08-29",0,0,0,0,0,0,0,0
"Ukraine","2024-08-30",0,0,0,0,0,0,0,0
"Ukraine","2024-08-31",0,0,0,0,0,0,0,0
"Ukraine","2024-09-01",0,0,0,0,0,0,0,0
"Ukraine","2024-09-02",0,0,0,0,0,0,0,0
"Ukraine","2024-09-03",0,0,0,0,0,0,0,0
"Ukraine","2024-09-04",0,0,0,0,0,0,0,0
"Ukraine","2024-09-05",0,0,0,0,0,0,0,0
"Ukraine","2024-09-06",0,0,0,0,0,0,0,0
"Ukraine","2024-09-07",0,0,0,0,0,0,0,0
"Ukraine","2024-09-08",0,0,0,0,0,0,0,0
"Ukraine","2024-09-09",0,0,0,0,0,0,0,0
"Ukraine","2024-09-10",0,0,0,0,0,0,0,0
"Ukraine","2024-09-11",0,0,0,0,0,0,0,0
"Ukraine","2024-09-12",0,0,0,0,0,0,0,0
"Ukraine","2024-09-13",0,0,0,0,0,0,0,0
"Ukraine","2024-09-14",0,0,0,0,0,0,0,0
"Ukraine","2024-09-15",0,0,0,0,0,0,0,0
"Ukraine","2024-09-16",0,0,0,0,0,0,0,0
"Ukraine","2024-09-17",0,0,0,0,0,0,0,0
"Ukraine","2024-09-18",0,0,0,0,0,0,0,0
"Ukraine","2024-09-19",0,0,0,0,0,0,0,0
"Ukraine","2024-09-20",0,0,0,0,0,0,0,0
"Ukraine","2024-09-21",0,0,0,0,0,0,0,0
"Ukraine","2024-09-22",0,0,0,0,0,0,0,0
"Ukraine","2024-09-23",0,0,0,0,0,0,0,0
"Ukraine","2024-09-24",0,0,0,0,0,0,0,0
"Ukraine","2024-09-25",0,0,0,0,0,0,0,0
"Ukraine","2024-09-26",0,0,0,0,0,0,0,0
"Ukraine","2024-09-27",0,0,0,0,0,0,0,0
"Ukraine","2024-09-28",0,0,0,0,0,0,0,0
"Ukraine","2024-09-29",0,0,0,0,0,0,0,0
"Ukraine","2024-09-30",0,0,0,0,0,0,0,0
"Ukraine","2024-10-01",0,0,0,0,0,0,0,0
"Ukraine","2024-10-02",0,0,0,0,0,0,0,0
"Ukraine","2024-10-03",0,0,0,0,0,0,0,0
"Ukraine","2024-10-04",0,0,0,0,0,0,0,0
"Ukraine","2024-10-05",0,0,0,0,0,0,0,0
"Ukraine","2024-10-06",0,0,0,0,0,0,0,0
"Ukraine","2024-10-07",0,0,0,0,0,0,0,0
"Ukraine","2024-10-08",0,0,0,0,0,0,0,0
"Ukraine","2024-10-09",0,0,0,0,0,0,0,0
"Ukraine","2024-10-10",0,0,0,0,0,0,0,0
"Ukraine","2024-10-11",0,0,0,0,0,0,0,0
"Ukraine","2024-10-12",0,0,0,0,0,0,0,0
"Ukraine","2024-10-13",0,0,0,0,0,0,0,0
"Ukraine","2024-10-14",0,0,0,0,0,0,0,0
"Ukraine","2024-10-15",0,0,0,0,0,0,0,0
"Ukraine","2024-10-16",0,0,0,0,0,0,0,0
"Ukraine","2024-10-17",0,0,0,0,0,0,0,0
"Ukraine","2024-10-18",0,0,0,0,0,0,0,0
"Ukraine","2024-10-19",0,0,0,0,0,0,0,0
"Ukraine","2024-10-20",0,0,0,0,0,0,0,0
"Ukraine","2024-10-21",0,0,0,0,0,0,0,0
"Ukraine","2024-10-22",0,0,0,0,0,0,0,0
"Ukraine","2024-10-23",0,0,0,0,0,0,0,0
"Ukraine","2024-10-24",0,0,0,0,0,0,0,0
"Ukraine","2024-10-25",0,0,0,0,0,0,0,0
"Ukraine","2024-10-26",0,0,0,0,0,0,0,0
"Ukraine","2024-10-27",0,0,0,0,0,0,0,0
"Ukraine","2024-10-28",0,0,0,0,0,0,0,0
"Ukraine","2024-10-29",0,0,0,0,0,0,0,0
"Ukraine","2024-10-30",0,0,0,0,0,0,0,0
"Ukraine","2024-10-31",0,0,0,0,0,0,0,0
"Ukraine","2024-11-01",0,0,0,0,0,0,0,0
"Ukraine","2024-11-02",0,0,0,0,0,0,0,0
"Ukraine","2024-11-03",0,0,0,0,0,0,0,0
"Ukraine","2024-11-04",0,0,0,0,0,0,0,0
"Ukraine","2024-11-05",0,0,0,0,0,0,0,0
"Ukraine","2024-11-06",0,0,0,0,0,0,0,0
"Ukraine","2024-11-07",0,0,0,0,0,0,0,0
"Ukraine","2024-11-08",0,0,0,0,0,0,0,0
"Ukraine","2024-11-09",0,0,0,0,0,0,0,0
"Ukraine","2024-11-10",0,0,0,0,0,0,0,0
"Ukraine","2024-11-11",0,0,0,0,0,0,0,0
"Ukraine","2024-11-12",0,0,0,0,0,0,0,0
"Ukraine","2024-11-13",0,0,0,0,0,0,0,0
"Ukraine","2024-11-14",0,0,0,0,0,0,0,0
"Ukraine","2024-11-15",0,0,0,0,0,0,0,0
"Ukraine","2024-11-16",0,0,0,0,0,0,0,0
"Ukraine","2024-11-17",0,0,0,0,0,0,0,0
"Ukraine","2024-11-18",0,0,0,0,0,0,0,0
"Ukraine","2024-11-19",0,0,0,0,0,0,0,0
"Ukraine","2024-11-20",0,0,0,0,0,0,0,0
"Ukraine","2024-11-21",0,0,0,0,0,0,0,0
"Ukraine","2024-11-22",0,0,0,0,0,0,0,0
"Ukraine","2024-11-23",0,0,0,0,0,0,0,0
"Ukraine","2024-11-24",0,0,0,0,0,0,0,0
"Ukraine","2024-11-25",0,0,0,0,0,0,0,0
"Ukraine","2024-11-26",0,0,0,0,0,0,0,0
"Ukraine","2024-11-27",0,0,0,0,0,0,0,0
"Ukraine","2024-11-28",0,0,0,0,0,0,0,0
"Ukraine","2024-11-29",0,0,0,0,0,0,0,0
"Ukraine","2024-11-30",0,0,0,0,0,0,0,0
"Ukraine","2024-12-01",0,0,0,0,0,0,0,0
"Ukraine","2024-12-02",0,0,0,0,0,0,0,0
"Ukraine","2024-12-03",0,0,0,0,0,0,0,0
"Ukraine","2024-12-04",0,0,0,0,0,0,0,0
"Ukraine","2024-12-05",0,0,0,0,0,0,0,0
"Ukraine","2024-12-06",0,0,0,0,0,0,0,0
"Ukraine","2024-12-07",0,0,0,0,0,0,0,0
"Ukraine","2024-12-08",0,0,0,0,0,0,0,0
"Ukraine","2024-12-09",0,0,0,0,0,0,0,0
"Ukraine","2024-12-10",0,0,0,0,0,0,0,0
"Ukraine","2024-12-11",0,0,0,0,0,0,0,0
"Ukraine","2024-12-12",0,0,0,0,0,0,0,0
"Ukraine","2024-12-13",0,0,0,0,0,0,0,0
"Ukraine","2024-12-14",0,0,0,0,0,0,0,0
"Ukraine","2024-12-15",0,0,0,0,0,0,0,0
"Ukraine","2024-12-16",0,0,0,0,0,0,0,0
"Ukraine","2024-12-17",0,0,0,0,0,0,0,0
"Ukraine","2024-12-18",0,0,0,0,0,0,0,0
"Ukraine","2024-12-19",0,0,0,0,0,0,0,0
"Ukraine","2024-12-20",0,0,0,0,0,0,0,0
"Ukraine","2024-12-21",0,0,0,0,0,0,0,0
"Ukraine","2024-12-22",0,0,0,0,0,0,0,0
"Ukraine","2024-12-23",0,0,0,0,0,0,0,0
"Ukraine","2024-12-24",0,0,0,0,0,0,0,0
"Ukraine","2024-12-25",0,0,0,0,0,0,0,0
"Ukraine","2024-12-26",0,0,0,0,0,0,0,0
"Ukraine","2024-12-27",0,0,0,0,0,0,0,0
"Ukraine","2024-12-28",0,0,0,0,0,0,0,0
"Ukraine","2024-12-29",0,0,0,0,0,0,0,0
"Ukraine","2024-12-30",0,0,0,0,0,0,0,0
"Ukraine","2024-12-31",0,0,0,0,0,0,0,0
"Ukraine","2025-01-01",0,0,0,0,0,0,0,0
"Ukraine","2025-01-02",0,0,0,0,0,0,0,0
"Ukraine","2025-01-03",0,0,0,0,0,0,0,0
"Ukraine","2025-01-04",0,0,0,0,0,0,0,0
"Ukraine","2025-01-05",0,0,0,0,0,0,0,0
"Ukraine","2025-01-06",0,0,0,0,0,0,0,0
"Ukraine","2025-01-07",0,0,0,0,0,0,0,0
"Ukraine","2025-01-08",0,0,0,0,0,0,0,0
"Ukraine","2025-01-09",0,0,0,0,0,0,0,0
"Ukraine","2025-01-10",0,0,0,0,0,0,0,0
"Ukraine","2025-01-11",0,0,0,0,0,0,0,0
"Ukraine","2025-01-12",0,0,0,0,0,0,0,0
"Ukraine","2025-01-13",0,0,0,0,0,0,0,0
"Ukraine","2025-01-14",0,0,0,0,0,0,0,0
"Ukraine","2025-01-15",0,0,0,0,0,0,0,0
"Ukraine","2025-01-16",0,0,0,0,0,0,0,0
"Ukraine","2025-01-17",0,0,0,0,0,0,0,0
"Ukraine","2025-01-18",0,0,0,0,0,0,0,0
"Ukraine","2025-01-19",0,0,0,0,0,0,0,0
"Ukraine","2025-01-20",0,0,0,0,0,0,0,0
"Ukraine","2025-01-21",0,0,0,0,0,0,0,0
"Ukraine","2025-01-22",0,0,0,0,0,0,0,0
"Ukraine","2025-01-23",0,0,0,0,0,0,0,0
"Ukraine","2025-01-24",0,0,0,0,0,0,0,0
"Ukraine","2025-01-25",0,0,0,0,0,0,0,0
"Ukraine","2025-01-26",0,0,0,0,0,0,0,0
"Ukraine","2025-01-27",0,0,0,0,0,0,0,0
"Ukraine","2025-01-28",0,0,0,0,0,0,0,0
"Ukraine","2025-01-29",0,0,0,0,0,0,0,0
"Ukraine","2025-01-30",0,0,0,0,0,0,0,0
"Ukraine","2025-01-31",0,0,0,0,0,0,0,0
"Ukraine","2025-02-01",0,0,0,0,0,0,0,0
"Ukraine","2025-02-02",0,0,0,0,0,0,0,0
"Ukraine","2025-02-03",0,0,0,0,0,0,0,0
"Ukraine","2025-02-04",0,0,0,0,0,0,0,0
"Ukraine","2025-02-05",0,0,0,0,0,0,0,0
"Ukraine","2025-02-06",0,0,0,0,0,0,0,0
"Ukraine","2025-02-07",0,0,0,0,0,0,0,0
"Ukraine","2025-02-08",0,0,0,0,0,0,0,0
"Ukraine","2025-02-09",0,0,0,0,0,0,0,0
"Ukraine","2025-02-10",0,0,0,0,0,0,0,0
"Ukraine","2025-02-11",0,0,0,0,0,0,0,0
"Ukraine","2025-02-12",0,0,0,0,0,0,0,0
"Ukraine","2025-02-13",0,0,0,0,0,0,0,0
"Ukraine","2025-02-14",0,0,0,0,0,0,0,0
"Ukraine","2025-02-15",0,0,0,0,0,0,0,0
"Ukraine","2025-02-16",0,0,0,0,0,0,0,0
"Ukraine","2025-02-17",0,0,0,0,0,0,0,0
"Ukraine","2025-02-18",0,0,0,0,0,0,0,0
"Ukraine","2025-02-19",0,0,0,0,0,0,0,0
"Ukraine","2025-02-20",0,0,0,0,0,0,0,0
"Ukraine","2025-02-21",0,0,0,0,0,0,0,0
"Ukraine","2025-02-22",0,0,0,0,0,0,0,0
"Ukraine","2025-02-23",0,0,0,0,0,0,0,0
"Ukraine","2025-02-24",0,0,0,0,0,0,0,0
"Ukraine","2025-02-25",0,0,0,0,0,0,0,0
"Ukraine","2025-02-26",0,0,0,0,0,0,0,0
"Ukraine","2025-02-27",0,0,0,0,0,0,0,0
"Ukraine","2025-02-28",0,0,0,0,0,0,0,0
"Ukraine","2025-03-01",0,0,0,0,0,0,0,0
"Ukraine","2025-03-02",0,0,0,0,0,0,0,0
"Ukraine","2025-03-03",0,0,0,0,0,0,0,0
"United Arab Emirates","2024-01-01",0,0,0,0,0,0,0,0
"United Arab Emirates","2024-01-02",0,0,0,0,0,0,0,0
"United Arab Emirates","2024-01-03",0,0,0,0,0,0,0,0
"United Arab Emirates","2024-01-04",0,0,0,0,0,0,0,0
"United Arab Emirates","2024-01-05",0,0,0,0,0,0,0,0
"United Arab Emirates","2024-01-06",0,0,0,0,0,0,0,0
"United Arab Emirates","2024-01-07",0,0,0,0,0,0,0,0
"United Arab Emirates","2024-01-08",0,0,0,0,0,0,0,0
"United Arab Emirates","2024-01-09",0,0,0,0,0,0,0,0
"United Arab Emirates","2024-01-10",0,0,0,0,0,0,0,0
"United Arab Emirates","2024-01-11",0,1,1,0,1,1,0,0
"United Arab Emirates","2024-01-12",0,0,1,0,0,1,0,0
"United Arab Emirates","2024-01-13",0,0,1,0,0,1,0,0
"United Arab Emirates","2024-01-14",0,0,1,0,0,1,0,0
"United Arab Emirates","2024-01-15",0,0,1,0,0,1,0,0
"United Arab Emirates","2024-01-16",0,0,1,0,0,1,0,0
"United Arab Emirates","2024-01-17",0,0,1,0,0,1,0,0
"United Arab Emirates","2024-01-18",0,0,1,0,0,1,0,0
"United Arab Emirates","2024-01-19",0,0,1,0,0,1,0,0
"United Arab Emirates","2024-01-20",0,0,1,0,0,1,0,0
"United Arab Emirates","2024-01-21",0,0,1,0,0,1,0,0
"United Arab Emirates","2024-01-22",0,0,1,0,0,1,0,0
"United Arab Emirates","2024-01-23",0,0,1,0,0,1,0,0
"United Arab Emirates","2024-01-24",0,0,1,0,0,1,0,0
"United Arab Emirates","2024-01-25",0,0,1,0,0,1,0,0
"United Arab Emirates","2024-01-26",0,0,1,0,0,1,0,0
"United Arab Emirates","2024-01-27",0,0,1,0,0,1,0,0
"United Arab Emirates","2024-01-28",0,0,1,0,0,1,0,0
"United Arab Emirates","2024-01-29",0,0,1,0,0,1,0,0
"United Arab Emirates","2024-01-30",0,0,1,0,0,1,0,0
"United Arab Emirates","2024-01-31",0,0,1,0,0,1,0,0
"United Arab Emirates","2024-02-01",0,0,1,0,0,1,0,0
"United Arab Emirates","2024-02-02",0,0,1,0,0,1,0,0
"United Arab Emirates","2024-02-03",0,0,1,0,0,1,0,0
"United Arab Emirates","2024-02-04",0,0,1,0,0,1,0,0
"United Arab Emirates","2024-02-05",0,0,1,0,0,1,0,0
"United Arab Emirates","2024-02-06",0,0,1,0,1,2,0,0
"United Arab Emirates","2024-02-07",0,0,1,0,0,2,0,0
"United Arab Emirates","2024-02-08",0,0,1,0,0,2,0,0
"United Arab Emirates","2024-02-09",0,0,1,0,0,2,0,0
"United Arab Emirates","2024-02-10",0,0,1,0,0,2,0,0
"United Arab Emirates","2024-02-11",0,0,1,0,0,2,0,0
"United Arab Emirates","2024-02-12",0,0,1,0,0,2,0,0
"United Arab Emirates","2024-02-13",0,0,1,0,0,2,0,0
"United Arab Emirates","2024-02-14",0,0,1,0,0,2,0,0
"United Arab Emirates","2024-02-15",0,0,1,0,0,2,0,0
"United Arab Emirates","2024-02-16",0,0,1,0,0,2,0,0
"United Arab Emirates","2024-02-17",0,0,1,0,0,2,0,0
"United Arab Emirates","2024-02-18",0,0,1,0,0,2,0,0
"United Arab Emirates","2024-02-19",0,0,1,0,0,2,0,0
"United Arab Emirates","2024-02-20",0,0,1,0,0,2,0,0
"United Arab Emirates","2024-02-21",0,0,1,0,0,2,0,0
"United Arab Emirates","2024-02-22",0,0,1,0,0,2,0,0
"United Arab Emirates","2024-02-23",0,0,1,0,0,2,0,0
"United Arab Emirates","2024-02-24",0,0,1,0,0,2,0,0
"United Arab Emirates","2024-02-25",0,0,1,0,0,2,0,0
"United Arab Emirates","2024-02-26",0,0,1,0,0,2,0,0
"United Arab Emirates","2024-02-27",0,0,1,0,0,2,0,0
"United Arab Emirates","2024-02-28",0,0,1,0,0,2,0,0
"United Arab Emirates","2024-02-29",0,0,1,0,0,2,0,0
"United Arab Emirates","2024-03-01",0,0,1,0,0,2,0,0
"United Arab Emirates","2024-03-02",0,1,2,0,0,2,0,0
"United Arab Emirates","2024-03-03",0,0,2,0,0,2,0,0
"United Arab Emirates","2024-03-04",0,0,2,0,0,2,0,0
"United Arab Emirates","2024-03-05",0,0,2,0,0,2,0,0
"United Arab Emirates","2024-03-06",0,0,2,0,0,2,0,0
"United Arab Emirates","2024-03-07",0,0,2,0,0,2,0,0
"United Arab Emirates","2024-03-08",0,0,2,0,0,2,0,0
"United Arab Emirates","2024-03-09",0,0,2,0,0,2,0,0
"United Arab Emirates","2024-03-10",0,0,2,0,0,2,0,0
"United Arab Emirates","2024-03-11",0,0,2,0,0,2,0,0
"United Arab Emirates","2024-03-12",0,0,2,0,0,2,0,0
"United Arab Emirates","2024-03-13",0,0,2,0,0,2,0,0
"United Arab Emirates","2024-03-14",0,0,2,0,0,2,0,0
"United Arab Emirates","2024-03-15",0,0,2,0,0,2,0,0
"United Arab Emirates","2024-03-16",0,0,2,0,0,2,0,0
"United Arab Emirates","2024-03-17",0,0,2,0,0,2,0,0
"United Arab Emirates","2024-03-18",0,0,2,0,0,2,0,0
"United Arab Emirates","2024-03-19",0,0,2,0,0,2,0,0
"United Arab Emirates","2024-03-20",0,0,2,0,0,2,0,0
"United Arab Emirates","2024-03-21",0,0,2,0,0,2,0,0
"United Arab Emirates","2024-03-22",0,0,2,0,0,2,0,0
"United Arab Emirates","2024-03-23",0,0,2,0,0,2,0,0
"United Arab Emirates","2024-03-24",0,0,2,0,0,2,0,0
"United Arab Emirates","2024-03-25",0,0,2,0,0,2,0,0
"United Arab Emirates","2024-03-26",0,0,2,0,0,2,0,0
"United Arab Emirates","2024-03-27",0,0,2,0,1,3,0,0
"United Arab Emirates","2024-03-28",0,0,2,0,0,3,0,0
"United Arab Emirates","2024-03-29",0,0,2,0,0,3,0,0
"United Arab Emirates","2024-03-30",0,0,2,0,0,3,0,0
"United Arab Emirates","2024-03-31",0,0,2,0,0,3,0,0
"United Arab Emirates","2024-04-01",0,0,2,0,0,3,0,0
"United Arab Emirates","2024-04-02",0,0,2,0,0,3,0,0
"United Arab Emirates","2024-04-03",0,0,2,0,0,3,0,0
"United Arab Emirates","2024-04-04",0,0,2,0,0,3,0,0
"United Arab Emirates","2024-04-05",0,0,2,0,0,3,0,0
"United Arab Emirates","2024-04-06",0,0,2,0,0,3,0,0
"United Arab Emirates","2024-04-07",0,0,2,0,0,3,0,0
"United Arab Emirates","2024-04-08",0,0,2,0,0,3,0,0
"United Arab Emirates","2024-04-09",0,0,2,0,0,3,0,0
"United Arab Emirates","2024-04-10",0,0,2,0,0,3,0,0
"United Arab Emirates","2024-04-11",0,0,2,0,0,3,0,0
"United Arab Emirates","2024-04-12",0,0,2,0,0,3,0,0
"United Arab Emirates","2024-04-13",0,0,2,0,0,3,0,0
"United Arab Emirates","2024-04-14",0,0,2,0,0,3,0,0
"United Arab Emirates","2024-04-15",0,0,2,0,0,3,0,0
"United Arab Emirates","2024-04-16",0,0,2,0,0,3,0,0
"United Arab Emirates","2024-04-17",0,0,2,0,0,3,0,0
"United Arab Emirates","2024-04-18",0,0,2,0,0,3,0,0
"United Arab Emirates","2024-04-19",0,0,2,0,0,3,0,0
"United Arab Emirates","2024-04-20",0,1,3,0,0,3,0,0
"United Arab Emirates","2024-04-21",0,0,3,0,0,3,0,0
"United Arab Emirates","2024-04-22",0,0,3,0,0,3,0,0
"United Arab Emirates","2024-04-23",0,0,3,0,0,3,0,0
"United Arab Emirates","2024-04-24",0,0,3,0,0,3,0,0
"United Arab Emirates","2024-04-25",0,0,3,0,0,3,0,0
"United Arab Emirates","2024-04-26",0,0,3,0,0,3,0,0
"United Arab Emirates","2024-04-27",0,0,3,0,0,3,0,0
"United Arab Emirates","2024-04-28",0,0,3,0,0,3,0,0
"United Arab Emirates","2024-04-29",0,0,3,0,0,3,0,0
"United Arab Emirates","2024-04-30",0,0,3,0,0,3,0,0
"United Arab Emirates","2024-05-01",0,0,3,0,0,3,0,0
"United Arab Emirates","2024-05-02",0,0,3,0,0,3,0,0
"United Arab Emirates","2024-05-03",0,0,3,0,0,3,0,0
"United Arab Emirates","2024-05-04",0,0,3,0,0,3,0,0
"United Arab Emirates","2024-05-05",0,0,3,0,0,3,0,0
"United Arab Emirates","2024-05-06",0,0,3,0,0,3,0,0
"United Arab Emirates","2024-05-07",0,0,3,0,0,3,0,0
"United Arab Emirates","2024-05-08",0,0,3,0,0,3,0,0
"United Arab Emirates","2024-05-09",0,0,3,0,0,3,0,0
"United Arab Emirates","2024-05-10",0,0,3,0,0,3,0,0
"United Arab Emirates","2024-05-11",0,0,3,0,0,3,0,0
"United Arab Emirates","2024-05-12",0,0,3,0,0,3,0,0
"United Arab Emirates","2024-05-13",0,0,3,0,0,3,0,0
"United Arab Emirates","2024-05-14",0,0,3,0,0,3,0,0
"United Arab Emirates","2024-05-15",0,0,3,0,0,3,0,0
"United Arab Emirates","2024-05-16",0,0,3,0,0,3,0,0
"United Arab Emirates","2024-05-17",0,0,3,0,0,3,0,0
"United Arab Emirates","2024-05-18",0,0,3,0,0,3,0,0
"United Arab Emirates","2024-05-19",0,0,3,0,0,3,0,0
"United Arab Emirates","2024-05-20",0,0,3,0,0,3,0,0
"United Arab Emirates","2024-05-21",0,0,3,0,0,3,0,0
"United Arab Emirates","2024-05-22",0,0,3,0,0,3,0,0
"United Arab Emirates","2024-05-23",0,0,3,0,0,3,0,0
"United Arab Emirates","2024-05-24",0,0,3,0,0,3,0,0
"United Arab Emirates","2024-05-25",0,0,3,0,0,3,0,0
"United Arab Emirates","2024-05-26",0,0,3,0,0,3,0,0
"United Arab Emirates","2024-05-27",0,0,3,0,0,3,0,0
"United Arab Emirates","2024-05-28",0,0,3,0,0,3,0,0
"United Arab Emirates","2024-05-29",0,0,3,0,0,3,0,0
"United Arab Emirates","2024-05-30",0,0,3,0,0,3,0,0
"United Arab Emirates","2024-05-31",0,0,3,0,0,3,0,0
"United Arab Emirates","2024-06-01",0,0,3,0,0,3,0,0
"United Arab Emirates","2024-06-02",0,0,3,0,0,3,0,0
"United Arab Emirates","2024-06-03",0,0,3,0,0,3,0,0
"United Arab Emirates","2024-06-04",0,0,3,0,0,3,0,0
"United Arab Emirates","2024-06-05",0,0,3,0,0,3,0,0
"United Arab Emirates","2024-06-06",0,0,3,0,0,3,0,0
"United Arab Emirates","2024-06-07",0,0,3,0,0,3,0,0
"United Arab Emirates","2024-06-08",0,0,3,0,0,3,0,0
"United Arab Emirates","2024-06-09",0,0,3,0,0,3,0,0
"United Arab Emirates","2024-06-10",0,0,3,0,0,3,0,0
"United Arab Emirates","2024-06-11",0,0,3,0,0,3,0,0
"United Arab Emirates","2024-06-12",0,0,3,0,0,3,0,0
"United Arab Emirates","2024-06-13",0,0,3,0,0,3,0,0
"United Arab Emirates","2024-06-14",0,0,3,0,0,3,0,0
"United Arab Emirates","2024-06-15",0,0,3,0,0,3,0,0
"United Arab Emirates","2024-06-16",0,0,3,0,0,3,0,0
"United Arab Emirates","2024-06-17",0,0,3,0,0,3,0,0
"United Arab Emirates","2024-06-18",0,0,3,0,0,3,0,0
"United Arab Emirates","2024-06-19",0,0,3,0,0,3,0,0
"United Arab Emirates","2024-06-20",0,0,3,0,0,3,0,0
"United Arab Emirates","2024-06-21",0,0,3,0,0,3,0,0
"United Arab Emirates","2024-06-22",0,0,3,0,0,3,0,0
"United Arab Emirates","2024-06-23",0,0,3,0,0,3,0,0
"United Arab Emirates","2024-06-24",0,0,3,0,0,3,0,0
"United Arab Emirates","2024-06-25",0,0,3,0,0,3,0,0
"United Arab Emirates","2024-06-26",0,0,3,0,0,3,0,0
"United Arab Emirates","2024-06-27",0,0,3,0,0,3,0,0
"United Arab Emirates","2024-06-28",0,0,3,0,0,3,0,0
"United Arab Emirates","2024-06-29",0,0,3,0,0,3,0,0
"United Arab Emirates","2024-06-30",0,0,3,0,0,3,0,0
"United Arab Emirates","2024-07-01",0,0,3,0,0,3,0,0
"United Arab Emirates","2024-07-02",0,0,3,0,0,3,0,0
"United Arab Emirates","2024-07-03",0,0,3,0,0,3,0,0
"United Arab Emirates","2024-07-04",0,0,3,0,0,3,0,0
"United Arab Emirates","2024-07-05",0,0,3,0,0,3,0,0
"United Arab Emirates","2024-07-06",0,0,3,0,0,3,0,0
"United Arab Emirates","2024-07-07",0,0,3,0,0,3,0,0
"United Arab Emirates","2024-07-08",0,0,3,0,0,3,0,0
"United Arab Emirates","2024-07-09",0,0,3,0,0,3,0,0
"United Arab Emirates","2024-07-10",0,0,3,0,0,3,0,0
"United Arab Emirates","2024-07-11",0,0,3,0,1,4,0,0
"United Arab Emirates","2024-07-12",0,0,3,0,0,4,0,0
"United Arab Emirates","2024-07-13",0,0,3,0,0,4,0,0
"United Arab Emirates","2024-07-14",0,0,3,0,0,4,0,0
"United Arab Emirates","2024-07-15",0,0,3,0,0,4,0,0
"United Arab Emirates","2024-07-16",0,0,3,0,0,4,0,0
"United Arab Emirates","2024-07-17",0,0,3,0,0,4,0,0
"United Arab Emirates","2024-07-18",0,0,3,0,0,4,0,0
"United Arab Emirates","2024-07-19",0,0,3,0,0,4,0,0
"United Arab Emirates","2024-07-20",0,0,3,0,0,4,0,0
"United Arab Emirates","2024-07-21",0,0,3,0,0,4,0,0
"United Arab Emirates","2024-07-22",0,0,3,0,0,4,0,0
"United Arab Emirates","2024-07-23",0,0,3,0,0,4,0,0
"United Arab Emirates","2024-07-24",0,0,3,0,0,4,0,0
"United Arab Emirates","2024-07-25",0,0,3,0,0,4,0,0
"United Arab Emirates","2024-07-26",0,0,3,0,0,4,0,0
"United Arab Emirates","2024-07-27",0,0,3,0,0,4,0,0
"United Arab Emirates","2024-07-28",0,0,3,0,0,4,0,0
"United Arab Emirates","2024-07-29",0,0,3,0,0,4,0,0
"United Arab Emirates","2024-07-30",0,0,3,0,0,4,0,0
"United Arab Emirates","2024-07-31",0,0,3,0,0,4,0,0
"United Arab Emirates","2024-08-01",0,0,3,0,0,4,0,0
"United Arab Emirates","2024-08-02",0,0,3,0,0,4,0,0
"United Arab Emirates","2024-08-03",0,0,3,0,0,4,0,0
"United Arab Emirates","2024-08-04",0,0,3,0,0,4,0,0
"United Arab Emirates","2024-08-05",0,0,3,0,0,4,0,0
"United Arab Emirates","2024-08-06",0,0,3,0,0,4,0,0
"United Arab Emirates","2024-08-07",0,0,3,0,0,4,0,0
"United Arab Emirates","2024-08-08",0,0,3,0,0,4,0,0
"United Arab Emirates","2024-08-09",0,0,3,0,0,4,0,0
"United Arab Emirates","2024-08-10",0,0,3,0,0,4,0,0
"United Arab Emirates","2024-08-11",0,0,3,0,0,4,0,0
"United Arab Emirates","2024-08-12",0,0,3,0,0,4,0,0
"United Arab Emirates","2024-08-13",0,0,3,0,0,4,0,0
"United Arab Emirates","2024-08-14",0,0,3,0,0,4,0,0
"United Arab Emirates","2024-08-15",0,0,3,0,0,4,0,0
"United Arab Emirates","2024-08-16",0,0,3,0,0,4,0,0
"United Arab Emirates","2024-08-17",0,0,3,0,0,4,0,0
"United Arab Emirates","2024-08-18",0,0,3,0,0,4,0,0
"United Arab Emirates","2024-08-19",0,0,3,0,0,4,0,0
"United Arab Emirates","2024-08-20",0,0,3,0,0,4,0,0
"United Arab Emirates","2024-08-21",0,0,3,0,0,4,0,0
"United Arab Emirates","2024-08-22",0,0,3,0,0,4,0,0
"United Arab Emirates","2024-08-23",0,0,3,0,0,4,0,0
"United Arab Emirates","2024-08-24",0,0,3,0,0,4,0,0
"United Arab Emirates","2024-08-25",0,0,3,0,0,4,0,0
"United Arab Emirates","2024-08-26",0,0,3,0,0,4,0,0
"United Arab Emirates","2024-08-27",0,0,3,0,0,4,0,0
"United Arab Emirates","2024-08-28",0,0,3,0,0,4,0,0
"United Arab Emirates","2024-08-29",0,0,3,0,0,4,0,0
"United Arab Emirates","2024-08-30",0,0,3,0,0,4,0,0
"United Arab Emirates","2024-08-31",0,0,3,0,0,4,0,0
"United Arab Emirates","2024-09-01",0,0,3,0,0,4,0,0
"United Arab Emirates","2024-09-02",0,0,3,0,0,4,0,0
"United Arab Emirates","2024-09-03",0,0,3,0,0,4,0,0
"United Arab Emirates","2024-09-04",0,0,3,0,0,4,0,0
"United Arab Emirates","2024-09-05",0,0,3,0,0,4,0,0
"United Arab Emirates","2024-09-06",0,0,3,0,0,4,0,0
"United Arab Emirates","2024-09-07",0,0,3,0,0,4,0,0
"United Arab Emirates","2024-09-08",0,0,3,0,0,4,0,0
"United Arab Emirates","2024-09-09",0,0,3,0,0,4,0,0
"United Arab Emirates","2024-09-10",0,0,3,0,0,4,0,0
"United Arab Emirates","2024-09-11",0,0,3,0,0,4,0,0
"United Arab Emirates","2024-09-12",0,0,3,0,0,4,0,0
"United Arab Emirates","2024-09-13",0,0,3,0,0,4,0,0
"United Arab Emirates","2024-09-14",0,0,3,0,0,4,0,0
"United Arab Emirates","2024-09-15",0,0,3,0,0,4,0,0
"United Arab Emirates","2024-09-16",0,0,3,0,0,4,0,0
"United Arab Emirates","2024-09-17",0,0,3,0,0,4,0,0
"United Arab Emirates","2024-09-18",0,0,3,0,0,4,0,0
"United Arab Emirates","2024-09-19",0,0,3,0,0,4,0,0
"United Arab Emirates","2024-09-20",0,0,3,0,0,4,0,0
"United Arab Emirates","2024-09-21",0,0,3,0,0,4,0,0
"United Arab Emirates","2024-09-22",0,0,3,0,0,4,0,0
"United Arab Emirates","2024-09-23",0,0,3,0,0,4,0,0
"United Arab Emirates","2024-09-24",0,0,3,0,0,4,0,0
"United Arab Emirates","2024-09-25",0,0,3,0,0,4,0,0
"United Arab Emirates","2024-09-26",0,0,3,0,0,4,0,0
"United Arab Emirates","2024-09-27",0,0,3,0,0,4,0,0
"United Arab Emirates","2024-09-28",0,0,3,0,0,4,0,0
"United Arab Emirates","2024-09-29",0,0,3,0,0,4,0,0
"United Arab Emirates","2024-09-30",0,1,4,0,0,4,0,0
"United Arab Emirates","2024-10-01",0,0,4,0,0,4,0,0
"United Arab Emirates","2024-10-02",0,0,4,0,0,4,0,0
"United Arab Emirates","2024-10-03",0,0,4,0,0,4,0,0
"United Arab Emirates","2024-10-04",0,0,4,0,0,4,0,0
"United Arab Emirates","2024-10-05",0,0,4,0,0,4,0,0
"United Arab Emirates","2024-10-06",0,0,4,0,0,4,0,0
"United Arab Emirates","2024-10-07",0,0,4,0,0,4,0,0
"United Arab Emirates","2024-10-08",0,0,4,0,0,4,0,0
"United Arab Emirates","2024-10-09",0,0,4,0,0,4,0,0
"United Arab Emirates","2024-10-10",0,0,4,0,0,4,0,0
"United Arab Emirates","2024-10-11",0,0,4,0,0,4,0,0
"United Arab Emirates","2024-10-12",0,0,4,0,0,4,0,0
"United Arab Emirates","2024-10-13",0,0,4,0,0,4,0,0
"United Arab Emirates","2024-10-14",0,0,4,0,0,4,0,0
"United Arab Emirates","2024-10-15",0,0,4,0,0,4,0,0
"United Arab Emirates","2024-10-16",0,0,4,0,1,5,0,0
"United Arab Emirates","2024-10-17",0,0,4,0,0,5,0,0
"United Arab Emirates","2024-10-18",0,0,4,0,0,5,0,0
"United Arab Emirates","2024-10-19",0,0,4,0,0,5,0,0
"United Arab Emirates","2024-10-20",0,0,4,0,0,5,0,0
"United Arab Emirates","2024-10-21",0,0,4,0,0,5,0,0
"United Arab Emirates","2024-10-22",0,0,4,0,0,5,0,0
"United Arab Emirates","2024-10-23",0,0,4,0,0,5,0,0
"United Arab Emirates","2024-10-24",0,0,4,0,0,5,0,0
"United Arab Emirates","2024-10-25",0,0,4,0,0,5,0,0
"United Arab Emirates","2024-10-26",0,0,4,0,0,5,0,0
"United Arab Emirates","2024-10-27",0,0,4,0,0,5,0,0
"United Arab Emirates","2024-10-28",0,0,4,0,0,5,0,0
"United Arab Emirates","2024-10-29",0,0,4,0,0,5,0,0
"United Arab Emirates","2024-10-30",0,1,5,0,0,5,0,0
"United Arab Emirates","2024-10-31",0,0,5,0,0,5,0,0
"United Arab Emirates","2024-11-01",0,0,5,0,0,5,0,0
"United Arab Emirates","2024-11-02",0,0,5,0,0,5,0,0
"United Arab Emirates","2024-11-03",0,0,5,0,0,5,0,0
"United Arab Emirates","2024-11-04",0,0,5,0,0,5,0,0
"United Arab Emirates","2024-11-05",0,0,5,0,0,5,0,0
"United Arab Emirates","2024-11-06",0,0,5,0,0,5,0,0
"United Arab Emirates","2024-11-07",0,0,5,0,0,5,0,0
"United Arab Emirates","2024-11-08",0,0,5,0,0,5,0,0
"United Arab Emirates","2024-11-09",0,0,5,0,0,5,0,0
"United Arab Emirates","2024-11-10",0,0,5,0,0,5,0,0
"United Arab Emirates","2024-11-11",0,0,5,0,0,5,0,0
"United Arab Emirates","2024-11-12",0,0,5,0,0,5,0,0
"United Arab Emirates","2024-11-13",0,0,5,0,0,5,0,0
"United Arab Emirates","2024-11-14",0,0,5,0,0,5,0,0
"United Arab Emirates","2024-11-15",0,0,5,0,0,5,0,0
"United Arab Emirates","2024-11-16",0,0,5,0,0,5,0,0
"United Arab Emirates","2024-11-17",0,0,5,0,0,5,0,0
"United Arab Emirates","2024-11-18",0,0,5,0,0,5,0,0
"United Arab Emirates","2024-11-19",0,0,5,0,0,5,0,0
"United Arab Emirates","2024-11-20",0,0,5,0,0,5,0,0
"United Arab Emirates","2024-11-21",0,0,5,0,0,5,0,0
"United Arab Emirates","2024-11-22",0,0,5,0,0,5,0,0
"United Arab Emirates","2024-11-23",0,0,5,0,0,5,0,0
"United Arab Emirates","2024-11-24",0,0,5,0,0,5,0,0
"United Arab Emirates","2024-11-25",0,0,5,0,0,5,0,0
"United Arab Emirates","2024-11-26",0,0,5,0,0,5,0,0
"United Arab Emirates","2024-11-27",0,0,5,0,0,5,0,0
"United Arab Emirates","2024-11-28",0,0,5,0,0,5,0,0
"United Arab Emirates","2024-11-29",0,0,5,0,0,5,0,0
"United Arab Emirates","2024-11-30",0,0,5,0,0,5,0,0
"United Arab Emirates","2024-12-01",0,0,5,0,0,5,0,0
"United Arab Emirates","2024-12-02",0,0,5,0,0,5,0,0
"United Arab Emirates","2024-12-03",0,0,5,0,0,5,0,0
"United Arab Emirates","2024-12-04",0,0,5,0,0,5,0,0
"United Arab Emirates","2024-12-05",0,0,5,0,0,5,0,0
"United Arab Emirates","2024-12-06",0,0,5,0,0,5,0,0
"United Arab Emirates","2024-12-07",0,0,5,0,0,5,0,0
"United Arab Emirates","2024-12-08",0,0,5,0,0,5,0,0
"United Arab Emirates","2024-12-09",0,0,5,0,1,6,0,0
"United Arab Emirates","2024-12-10",0,0,5,0,0,6,0,0
"United Arab Emirates","2024-12-11",0,0,5,0,0,6,0,0
"United Arab Emirates","2024-12-12",0,0,5,0,0,6,0,0
"United Arab Emirates","2024-12-13",0,0,5,0,0,6,0,0
"United Arab Emirates","2024-12-14",0,0,5,0,0,6,0,0
"United Arab Emirates","2024-12-15",0,0,5,0,0,6,0,0
"United Arab Emirates","2024-12-16",0,0,5,0,0,6,0,0
"United Arab Emirates","2024-12-17",0,0,5,0,0,6,0,0
"United Arab Emirates","2024-12-18",0,0,5,0,0,6,0,0
"United Arab Emirates","2024-12-19",0,0,5,0,0,6,0,0
"United Arab Emirates","2024-12-20",0,0,5,0,0,6,0,0
"United Arab Emirates","2024-12-21",0,0,5,0,0,6,0,0
"United Arab Emirates","2024-12-22",0,0,5,0,0,6,0,0
"United Arab Emirates","2024-12-23",0,0,5,0,0,6,0,0
"United Arab Emirates","2024-12-24",0,0,5,0,0,6,0,0
"United Arab Emirates","2024-12-25",0,0,5,0,0,6,0,0
"United Arab Emirates","2024-12-26",0,0,5,0,0,6,0,0
"United Arab Emirates","2024-12-27",0,0,5,0,0,6,0,0
"United Arab Emirates","2024-12-28",0,0,5,0,0,6,0,0
"United Arab Emirates","2024-12-29",0,0,5,0,0,6,0,0
"United Arab Emirates","2024-12-30",0,0,5,0,0,6,0,0
"United Arab Emirates","2024-12-31",0,0,5,0,0,6,0,0
"United Arab Emirates","2025-01-01",0,0,5,0,0,6,0,0
"United Arab Emirates","2025-01-02",0,0,5,0,0,6,0,0
"United Arab Emirates","2025-01-03",0,0,5,0,0,6,0,0
"United Arab Emirates","2025-01-04",0,0,5,0,0,6,0,0
"United Arab Emirates","2025-01-05",0,0,5,0,0,6,0,0
"United Arab Emirates","2025-01-06",0,0,5,0,0,6,0,0
"United Arab Emirates","2025-01-07",0,0,5,0,0,6,0,0
"United Arab Emirates","2025-01-08",0,0,5,0,0,6,0,0
"United Arab Emirates","2025-01-09",0,0,5,0,0,6,0,0
"United Arab Emirates","2025-01-10",0,0,5,0,0,6,0,0
"United Arab Emirates","2025-01-11",0,0,5,0,0,6,0,0
"United Arab Emirates","2025-01-12",0,0,5,0,0,6,0,0
"United Arab Emirates","2025-01-13",0,0,5,0,0,6,0,0
"United Arab Emirates","2025-01-14",0,0,5,0,0,6,0,0
"United Arab Emirates","2025-01-15",0,0,5,0,0,6,0,0
"United Arab Emirates","2025-01-16",0,0,5,0,0,6,0,0
"United Arab Emirates","2025-01-17",0,1,6,0,0,6,0,0
"United Arab Emirates","2025-01-18",0,0,6,0,0,6,0,0
"United Arab Emirates","2025-01-19",0,0,6,0,0,6,0,0
"United Arab Emirates","2025-01-20",0,0,6,0,0,6,0,0
"United Arab Emirates","2025-01-21",0,0,6,0,0,6,0,0
"United Arab Emirates","2025-01-22",0,0,6,0,0,6,0,0
"United Arab Emirates","2025-01-23",0,0,6,0,0,6,0,0
"United Arab Emirates","2025-01-24",0,0,6,0,0,6,0,0
"United Arab Emirates","2025-01-25",0,0,6,0,0,6,0,0
"United Arab Emirates","2025-01-26",0,0,6,0,0,6,0,0
"United Arab Emirates","2025-01-27",0,0,6,0,0,6,0,0
"United Arab Emirates","2025-01-28",0,0,6,0,0,6,0,0
"United Arab Emirates","2025-01-29",0,0,6,0,0,6,0,0
"United Arab Emirates","2025-01-30",0,0,6,0,0,6,0,0
"United Arab Emirates","2025-01-31",0,0,6,0,0,6,0,0
"United Arab Emirates","2025-02-01",0,0,6,0,0,6,0,0
"United Arab Emirates","2025-02-02",0,0,6,0,0,6,0,0
"United Arab Emirates","2025-02-03",0,0,6,0,0,6,0,0
"United Arab Emirates","2025-02-04",0,0,6,0,0,6,0,0
"United Arab Emirates","2025-02-05",0,0,6,0,0,6,0,0
"United Arab Emirates","2025-02-06",0,0,6,0,0,6,0,0
"United Arab Emirates","2025-02-07",0,0,6,0,0,6,0,0
"United Arab Emirates","2025-02-08",0,0,6,0,0,6,0,0
"United Arab Emirates","2025-02-09",0,0,6,0,0,6,0,0
"United Arab Emirates","2025-02-10",0,0,6,0,0,6,0,0
"United Arab Emirates","2025-02-11",0,0,6,0,0,6,0,0
"United Arab Emirates","2025-02-12",0,0,6,0,0,6,0,0
"United Arab Emirates","2025-02-13",0,0,6,0,0,6,0,0
"United Arab Emirates","2025-02-14",0,0,6,0,0,6,0,0
"United Arab Emirates","2025-02-15",0,0,6,0,0,6,0,0
"United Arab Emirates","2025-02-16",0,0,6,0,0,6,0,0
"United Arab Emirates","2025-02-17",0,0,6,0,0,6,0,0
"United Arab Emirates","2025-02-18",0,0,6,0,0,6,0,0
"United Arab Emirates","2025-02-19",0,0,6,0,0,6,0,0
"United Arab Emirates","2025-02-20",0,0,6,0,0,6,0,0
"United Arab Emirates","2025-02-21",0,0,6,0,0,6,0,0
"United Arab Emirates","2025-02-22",0,0,6,0,0,6,0,0
"United Arab Emirates","2025-02-23",0,0,6,0,0,6,0,0
"United Arab Emirates","2025-02-24",0,0,6,0,0,6,0,0
"United Arab Emirates","2025-02-25",0,0,6,0,0,6,0,0
"United Arab Emirates","2025-02-26",0,0,6,0,0,6,0,0
"United Arab Emirates","2025-02-27",0,0,6,0,0,6,0,0
"United Arab Emirates","2025-02-28",0,0,6,0,0,6,0,0
"United Arab Emirates","2025-03-01",0,0,6,0,0,6,0,0
"United Arab Emirates","2025-03-02",0,0,6,0,0,6,0,0
"United Arab Emirates","2025-03-03",0,0,6,0,0,6,0,0
"United Kingdom of Great Britain and Northern Ireland","2024-01-01",0,0,0,0,0,0,0,0
"United Kingdom of Great Britain and Northern Ireland","2024-01-02",0,0,0,0,0,0,0,0
"United Kingdom of Great Britain and Northern Ireland","2024-01-03",0,0,0,0,0,0,0,0
"United Kingdom of Great Britain and Northern Ireland","2024-01-04",0,0,0,0,0,0,0,0
"United Kingdom of Great Britain and Northern Ireland","2024-01-05",0,0,0,0,0,0,0,0
"United Kingdom of Great Britain and Northern Ireland","2024-01-06",0,0,0,0,0,0,0,0
"United Kingdom of Great Britain and Northern Ireland","2024-01-07",0,0,0,0,0,0,0,0
"United Kingdom of Great Britain and Northern Ireland","2024-01-08",0,0,0,0,0,0,0,0
"United Kingdom of Great Britain and Northern Ireland","2024-01-09",0,0,0,0,0,0,0,0
"United Kingdom of Great Britain and Northern Ireland","2024-01-10",0,0,0,0,0,0,0,0
"United Kingdom of Great Britain and Northern Ireland","2024-01-11",0,0,0,0,0,0,0,0
"United Kingdom of Great Britain and Northern Ireland","2024-01-12",0,0,0,0,0,0,0,0
"United Kingdom of Great Britain and Northern Ireland","2024-01-13",0,0,0,0,0,0,0,0
"United Kingdom of Great Britain and Northern Ireland","2024-01-14",0,0,0,0,0,0,0,0
"United Kingdom of Great Britain and Northern Ireland","2024-01-15",0,0,0,0,0,0,0,0
"United Kingdom of Great Britain and Northern Ireland","2024-01-16",0,0,0,0,0,0,0,0
"United Kingdom of Great Britain and Northern Ireland","2024-01-17",0,0,0,0,0,0,0,0
"United Kingdom of Great Britain and Northern Ireland","2024-01-18",0,0,0,0,0,0,0,0
"United Kingdom of Great Britain and Northern Ireland","2024-01-19",0,0,0,0,0,0,0,0
"United Kingdom of Great Britain and Northern Ireland","2024-01-20",0,0,0,0,0,0,0,0
"United Kingdom of Great Britain and Northern Ireland","2024-01-21",0,0,0,0,0,0,0,0
"United Kingdom of Great Britain and Northern Ireland","2024-01-22",0,0,0,0,0,0,0,0
"United Kingdom of Great Britain and Northern Ireland","2024-01-23",0,0,0,0,0,0,0,0
"United Kingdom of Great Britain and Northern Ireland","2024-01-24",0,0,0,0,0,0,0,0
"United Kingdom of Great Britain and Northern Ireland","2024-01-25",0,0,0,0,0,0,0,0
"United Kingdom of Great Britain and Northern Ireland","2024-01-26",0,0,0,0,0,0,0,0
"United Kingdom of Great Britain and Northern Ireland","2024-01-27",0,0,0,0,0,0,0,0
"United Kingdom of Great Britain and Northern Ireland","2024-01-28",0,0,0,0,0,0,0,0
"United Kingdom of Great Britain and Northern Ireland","2024-01-29",0,0,0,0,0,0,0,0
"United Kingdom of Great Britain and Northern Ireland","2024-01-30",0,0,0,0,0,0,0,0
"United Kingdom of Great Britain and Northern Ireland","2024-01-31",0,7,7,0,7,7,0,0
"United Kingdom of Great Britain and Northern Ireland","2024-02-01",0,0,7,0,0,7,0,0
"United Kingdom of Great Britain and Northern Ireland","2024-02-02",0,0,7,0,1,8,0,0
"United Kingdom of Great Britain and Northern Ireland","2024-02-03",0,0,7,0,0,8,0,0
"United Kingdom of Great Britain and Northern Ireland","2024-02-04",0,0,7,0,0,8,0,0
"United Kingdom of Great Britain and Northern Ireland","2024-02-05",0,0,7,0,1,9,0,0
"United Kingdom of Great Britain and Northern Ireland","2024-02-06",0,0,7,0,0,9,0,0
"United Kingdom of Great Britain and Northern Ireland","2024-02-07",0,0,7,0,0,9,0,0
"United Kingdom of Great Britain and Northern Ireland","2024-02-08",0,0,7,0,1,10,0,0
"United Kingdom of Great Britain and Northern Ireland","2024-02-09",0,0,7,0,0,10,0,0
"United Kingdom of Great Britain and Northern Ireland","2024-02-10",0,0,7,0,0,10,0,0
"United Kingdom of Great Britain and Northern Ireland","2024-02-11",0,0,7,0,1,11,0,0
"United Kingdom of Great Britain and Northern Ireland","2024-02-12",0,0,7,0,0,11,0,0
"United Kingdom of Great Britain and Northern Ireland","2024-02-13",0,0,7,0,0,11,0,0
"United Kingdom of Great Britain and Northern Ireland","2024-02-14",0,0,7,0,1,12,0,0
"United Kingdom of Great Britain and Northern Ireland","2024-02-15",0,0,7,0,0,12,0,0
"United Kingdom of Great Britain and Northern Ireland","2024-02-16",0,0,7,0,1,13,0,0
"United Kingdom of Great Britain and Northern Ireland","2024-02-17",0,0,7,0,0,13,0,0
"United Kingdom of Great Britain and Northern Ireland","2024-02-18",0,0,7,0,0,13,0,0
"United Kingdom of Great Britain and Northern Ireland","2024-02-19",0,0,7,0,1,14,0,0
"United Kingdom of Great Britain and Northern Ireland","2024-02-20",0,0,7,0,0,14,0,0
"United Kingdom of Great Britain and Northern Ireland","2024-02-21",0,0,7,0,0,14,0,0
"United Kingdom of Great Britain and Northern Ireland","2024-02-22",0,0,7,0,1,15,0,0
"United Kingdom of Great Britain and Northern Ireland","2024-02-23",0,0,7,0,0,15,0,0
"United Kingdom of Great Britain and Northern Ireland","2024-02-24",0,0,7,0,0,15,0,0
"United Kingdom of Great Britain and Northern Ireland","2024-02-25",0,0,7,0,1,16,0,0
"United Kingdom of Great Britain and Northern Ireland","2024-02-26",0,0,7,0,0,16,0,0
"United Kingdom of Great Britain and Northern Ireland","2024-02-27",0,0,7,0,0,16,0,0
"United Kingdom of Great Britain and Northern Ireland","2024-02-28",0,0,7,0,1,17,0,0
"United Kingdom of Great Britain and Northern Ireland","2024-02-29",0,10,17,0,0,17,0,0
"United Kingdom of Great Britain and Northern Ireland","2024-03-01",0,0,17,0,1,18,0,0
"United Kingdom of Great Britain and Northern Ireland","2024-03-02",0,0,17,0,0,18,0,0
"United Kingdom of Great Britain and Northern Ireland","2024-03-03",0,0,17,0,1,19,0,0
"United Kingdom of Great Britain and Northern Ireland","2024-03-04",0,0,17,0,0,19,0,0
"United Kingdom of Great Britain and Northern Ireland","2024-03-05",0,0,17,0,1,20,0,0
"United Kingdom of Great Britain and Northern Ireland","2024-03-06",0,0,17,0,0,20,0,0
"United Kingdom of Great Britain and Northern Ireland","2024-03-07",0,0,17,0,1,21,0,0
"United Kingdom of Great Britain and Northern Ireland","2024-03-08",0,0,17,0,0,21,0,0
"United Kingdom of Great Britain and Northern Ireland","2024-03-09",0,0,17,0,1,22,0,0
"United Kingdom of Great Britain and Northern Ireland","2024-03-10",0,0,17,0,0,22,0,0
"United Kingdom of Great Britain and Northern Ireland","2024-03-11",0,0,17,0,1,23,0,0
"United Kingdom of Great Britain and Northern Ireland","2024-03-12",0,0,17,0,0,23,0,0
"United Kingdom of Great Britain and Northern Ireland","2024-03-13",0,0,17,0,1,24,0,0
"United Kingdom of Great Britain and Northern Ireland","2024-03-14",0,0,17,0,0,24,0,0
"United Kingdom of Great Britain and Northern Ireland","2024-03-15",0,0,17,0,1,25,0,0
"United Kingdom of Great Britain and Northern Ireland","2024-03-16",0,0,17,0,0,25,0,0
"United Kingdom of Great Britain and Northern Ireland","2024-03-17",0,0,17,0,1,26,0,0
"United Kingdom of Great Britain and Northern Ireland","2024-03-18",0,0,17,0,0,26,0,0
"United Kingdom of Great Britain and Northern Ireland","2024-03-19",0,0,17,0,1,27,0,0
"United Kingdom of Great Britain and Northern Ireland","2024-03-20",0,0,17,0,0,27,0,0
"United Kingdom of Great Britain and Northern Ireland","2024-03-21",0,0,17,0,1,28,0,0
"United Kingdom of Great Britain and Northern Ireland","2024-03-22",0,0,17,0,0,28,0,0
"United Kingdom of Great Britain and Northern Ireland","2024-03-23",0,0,17,0,1,29,0,0
"United Kingdom of Great Britain and Northern Ireland","2024-03-24",0,0,17,0,0,29,0,0
"United Kingdom of Great Britain and Northern Ireland","2024-03-25",0,0,17,0,1,30,0,0
"United Kingdom of Great Britain and Northern Ireland","2024-03-26",0,0,17,0,0,30,0,0
"United Kingdom of Great Britain and Northern Ireland","2024-03-27",0,0,17,0,1,31,0,0
"United Kingdom of Great Britain and Northern Ireland","2024-03-28",0,0,17,0,0,31,0,0
"United Kingdom of Great Britain and Northern Ireland","2024-03-29",0,0,17,0,1,32,0,0
"United Kingdom of Great Britain and Northern Ireland","2024-03-30",0,0,17,0,0,32,0,0
"United Kingdom of Great Britain and Northern Ireland","2024-03-31",0,16,33,0,1,33,0,0
"United Kingdom of Great Britain and Northern Ireland","2024-04-01",0,0,33,0,1,34,0,0
"United Kingdom of Great Britain and Northern Ireland","2024-04-02",0,0,33,0,0,34,0,0
"United Kingdom of Great Britain and Northern Ireland","2024-04-03",0,0,33,0,1,35,0,0
"United Kingdom of Great Britain and Northern Ireland","2024-04-04",0,0,33,0,1,36,0,0
"United Kingdom of Great Britain and Northern Ireland","2024-04-05",0,0,33,0,0,36,0,0
"United Kingdom of Great Britain and Northern Ireland","2024-04-06",0,0,33,0,1,37,0,0
"United Kingdom of Great Britain and Northern Ireland","2024-04-07",0,0,33,0,1,38,0,0
"United Kingdom of Great Britain and Northern Ireland","2024-04-08",0,0,33,0,0,38,0,0
"United Kingdom of Great Britain and Northern Ireland","2024-04-09",0,0,33,0,1,39,0,0
"United Kingdom of Great Britain and Northern Ireland","2024-04-10",0,0,33,0,1,40,0,0
"United Kingdom of Great Britain and Northern Ireland","2024-04-11",0,0,33,0,0,40,0,0
"United Kingdom of Great Britain and Northern Ireland","2024-04-12",0,0,33,0,1,41,0,0
"United Kingdom of Great Britain and Northern Ireland","2024-04-13",0,0,33,0,1,42,0,0
"United Kingdom of Great Britain and Northern Ireland","2024-04-14",0,0,33,0,0,42,0,0
"United Kingdom of Great Britain and Northern Ireland","2024-04-15",0,0,33,0,1,43,0,0
"United Kingdom of Great Britain and Northern Ireland","2024-04-16",0,0,33,0,1,44,0,0
"United Kingdom of Great Britain and Northern Ireland","2024-04-17",0,0,33,0,0,44,0,0
"United Kingdom of Great Britain and Northern Ireland","2024-04-18",0,0,33,0,1,45,0,0
"United Kingdom of Great Britain and Northern Ireland","2024-04-19",0,0,33,0,1,46,0,0
"United Kingdom of Great Britain and Northern Ireland","2024-04-20",0,0,33,0,0,46,0,0
"United Kingdom of Great Britain and Northern Ireland","2024-04-21",0,0,33,0,1,47,0,0
"United Kingdom of Great Britain and Northern Ireland","2024-04-22",0,0,33,0,1,48,0,0
"United Kingdom of Great Britain and Northern Ireland","2024-04-23",0,0,33,0,0,48,0,0
"United Kingdom of Great Britain and Northern Ireland","2024-04-24",0,0,33,0,1,49,0,0
"United Kingdom of Great Britain and Northern Ireland","2024-04-25",0,0,33,0,1,50,0,0
"United Kingdom of Great Britain and Northern Ireland","2024-04-26",0,0,33,0,0,50,0,0
"United Kingdom of Great Britain and Northern Ireland","2024-04-27",0,0,33,0,1,51,0,0
"United Kingdom of Great Britain and Northern Ireland","2024-04-28",0,0,33,0,1,52,0,0
"United Kingdom of Great Britain and Northern Ireland","2024-04-29",0,0,33,0,0,52,0,0
"United Kingdom of Great Britain and Northern Ireland","2024-04-30",0,20,53,0,1,53,0,0
"United Kingdom of Great Britain and Northern Ireland","2024-05-01",0,0,53,0,1,54,0,0
"United Kingdom of Great Britain and Northern Ireland","2024-05-02",0,0,53,0,1,55,0,0
"United Kingdom of Great Britain and Northern Ireland","2024-05-03",0,0,53,0,0,55,0,0
"United Kingdom of Great Britain and Northern Ireland","2024-05-04",0,0,53,0,1,56,0,0
"United Kingdom of Great Britain and Northern Ireland","2024-05-05",0,0,53,0,1,57,0,0
"United Kingdom of Great Britain and Northern Ireland","2024-05-06",0,0,53,0,1,58,0,0
"United Kingdom of Great Britain and Northern Ireland","2024-05-07",0,0,53,0,0,58,0,0
"United Kingdom of Great Britain and Northern Ireland","2024-05-08",0,0,53,0,1,59,0,0
"United Kingdom of Great Britain and Northern Ireland","2024-05-09",0,0,53,0,1,60,0,0
"United Kingdom of Great Britain and Northern Ireland","2024-05-10",0,0,53,0,1,61,0,0
"United Kingdom of Great Britain and Northern Ireland","2024-05-11",0,0,53,0,1,62,0,0
"United Kingdom of Great Britain and Northern Ireland","2024-05-12",0,0,53,0,0,62,0,0
"United Kingdom of Great Britain and Northern Ireland","2024-05-13",0,0,53,0,1,63,0,0
"United Kingdom of Great Britain and Northern Ireland","2024-05-14",0,0,53,0,1,64,0,0
"United Kingdom of Great Britain and Northern Ireland","2024-05-15",0,0,53,0,1,65,0,0
"United Kingdom of Great Britain and Northern Ireland","2024-05-16",0,0,53,0,0,65,0,0
"United Kingdom of Great Britain and Northern Ireland","2024-05-17",0,0,53,0,1,66,0,0
"United Kingdom of Great Britain and Northern Ireland","2024-05-18",0,0,53,0,1,67,0,0
"United Kingdom of Great Britain and Northern Ireland","2024-05-19",0,0,53,0,1,68,0,0
"United Kingdom of Great Britain and Northern Ireland","2024-05-20",0,0,53,0,0,68,0,0
"United Kingdom of Great Britain and Northern Ireland","2024-05-21",0,0,53,0,1,69,0,0
"United Kingdom of Great Britain and Northern Ireland","2024-05-22",0,0,53,0,1,70,0,0
"United Kingdom of Great Britain and Northern Ireland","2024-05-23",0,0,53,0,1,71,0,0
"United Kingdom of Great Britain and Northern Ireland","2024-05-24",0,0,53,0,1,72,0,0
"United Kingdom of Great Britain and Northern Ireland","2024-05-25",0,0,53,0,0,72,0,0
"United Kingdom of Great Britain and Northern Ireland","2024-05-26",0,0,53,0,1,73,0,0
"United Kingdom of Great Britain and Northern Ireland","2024-05-27",0,0,53,0,1,74,0,0
"United Kingdom of Great Britain and Northern Ireland","2024-05-28",0,0,53,0,1,75,0,0
"United Kingdom of Great Britain and Northern Ireland","2024-05-29",0,0,53,0,0,75,0,0
"United Kingdom of Great Britain and Northern Ireland","2024-05-30",0,0,53,0,1,76,0,0
"United Kingdom of Great Britain and Northern Ireland","2024-05-31",0,24,77,0,1,77,0,0
"United Kingdom of Great Britain and Northern Ireland","2024-06-01",0,0,77,0,1,78,0,0
"United Kingdom of Great Britain and Northern Ireland","2024-06-02",0,0,77,0,1,79,0,0
"United Kingdom of Great Britain and Northern Ireland","2024-06-03",0,0,77,0,1,80,0,0
"United Kingdom of Great Britain and Northern Ireland","2024-06-04",0,0,77,0,1,81,0,0
"United Kingdom of Great Britain and Northern Ireland","2024-06-05",0,0,77,0,1,82,0,0
"United Kingdom of Great Britain and Northern Ireland","2024-06-06",0,0,77,0,1,83,0,0
"United Kingdom of Great Britain and Northern Ireland","2024-06-07",0,0,77,0,2,85,0,0
"United Kingdom of Great Britain and Northern Ireland","2024-06-08",0,0,77,0,1,86,0,0
"United Kingdom of Great Britain and Northern Ireland","2024-06-09",0,0,77,0,1,87,0,0
"United Kingdom of Great Britain and Northern Ireland","2024-06-10",0,0,77,0,1,88,0,0
"United Kingdom of Great Britain and Northern Ireland","2024-06-11",0,0,77,0,1,89,0,0
"United Kingdom of Great Britain and Northern Ireland","2024-06-12",0,0,77,0,1,90,0,0
"United Kingdom of Great Britain and Northern Ireland","2024-06-13",0,0,77,0,1,91,0,0
"United Kingdom of Great Britain and Northern Ireland","2024-06-14",0,0,77,0,1,92,0,0
"United Kingdom of Great Britain and Northern Ireland","2024-06-15",0,0,77,0,1,93,0,0
"United Kingdom of Great Britain and Northern Ireland","2024-06-16",0,0,77,0,1,94,0,0
"United Kingdom of Great Britain and Northern Ireland","2024-06-17",0,0,77,0,1,95,0,0
"United Kingdom of Great Britain and Northern Ireland","2024-06-18",0,0,77,0,1,96,0,0
"United Kingdom of Great Britain and Northern Ireland","2024-06-19",0,0,77,0,2,98,0,0
"United Kingdom of Great Britain and Northern Ireland","2024-06-20",0,0,77,0,1,99,0,0
"United Kingdom of Great Britain and Northern Ireland","2024-06-21",0,0,77,0,1,100,0,0
"United Kingdom of Great Britain and Northern Ireland","2024-06-22",0,0,77,0,1,101,0,0
"United Kingdom of Great Britain and Northern Ireland","2024-06-23",0,0,77,0,1,102,0,0
"United Kingdom of Great Britain and Northern Ireland","2024-06-24",0,0,77,0,1,103,0,0
"United Kingdom of Great Britain and Northern Ireland","2024-06-25",0,0,77,0,1,104,0,0
"United Kingdom of Great Britain and Northern Ireland","2024-06-26",0,0,77,0,1,105,0,0
"United Kingdom of Great Britain and Northern Ireland","2024-06-27",0,0,77,0,1,106,0,0
"United Kingdom of Great Britain and Northern Ireland","2024-06-28",0,0,77,0,1,107,0,0
"United Kingdom of Great Britain and Northern Ireland","2024-06-29",0,0,77,0,1,108,0,0
"United Kingdom of Great Britain and Northern Ireland","2024-06-30",0,0,77,0,1,109,0,0
"United Kingdom of Great Britain and Northern Ireland","2024-07-01",0,0,77,0,2,111,0,0
"United Kingdom of Great Britain and Northern Ireland","2024-07-02",0,0,77,0,1,112,0,0
"United Kingdom of Great Britain and Northern Ireland","2024-07-03",0,0,77,0,1,113,0,0
"United Kingdom of Great Britain and Northern Ireland","2024-07-04",0,0,77,0,1,114,0,0
"United Kingdom of Great Britain and Northern Ireland","2024-07-05",0,0,77,0,1,115,0,0
"United Kingdom of Great Britain and Northern Ireland","2024-07-06",0,0,77,0,1,116,0,0
"United Kingdom of Great Britain and Northern Ireland","2024-07-07",0,0,77,0,1,117,0,0
"United Kingdom of Great Britain and Northern Ireland","2024-07-08",0,0,77,0,1,118,0,0
"United Kingdom of Great Britain and Northern Ireland","2024-07-09",0,0,77,0,1,119,0,0
"United Kingdom of Great Britain and Northern Ireland","2024-07-10",0,0,77,0,1,120,0,0
"United Kingdom of Great Britain and Northern Ireland","2024-07-11",0,0,77,0,1,121,0,0
"United Kingdom of Great Britain and Northern Ireland","2024-07-12",0,0,77,0,1,122,0,0
"United Kingdom of Great Britain and Northern Ireland","2024-07-13",0,0,77,0,2,124,0,0
"United Kingdom of Great Britain and Northern Ireland","2024-07-14",0,0,77,0,1,125,0,0
"United Kingdom of Great Britain and Northern Ireland","2024-07-15",0,0,77,0,1,126,0,0
"United Kingdom of Great Britain and Northern Ireland","2024-07-16",0,0,77,0,1,127,0,0
"United Kingdom of Great Britain and Northern Ireland","2024-07-17",0,0,77,0,1,128,0,0
"United Kingdom of Great Britain and Northern Ireland","2024-07-18",0,0,77,0,1,129,0,0
"United Kingdom of Great Britain and Northern Ireland","2024-07-19",0,0,77,0,1,130,0,0
"United Kingdom of Great Britain and Northern Ireland","2024-07-20",0,0,77,0,1,131,0,0
"United Kingdom of Great Britain and Northern Ireland","2024-07-21",0,0,77,0,1,132,0,0
"United Kingdom of Great Britain and Northern Ireland","2024-07-22",0,0,77,0,1,133,0,0
"United Kingdom of Great Britain and Northern Ireland","2024-07-23",0,0,77,0,1,134,0,0
"United Kingdom of Great Britain and Northern Ireland","2024-07-24",0,0,77,0,1,135,0,0
"United Kingdom of Great Britain and Northern Ireland","2024-07-25",0,0,77,0,2,137,0,0
"United Kingdom of Great Britain and Northern Ireland","2024-07-26",0,0,77,0,1,138,0,0
"United Kingdom of Great Britain and Northern Ireland","2024-07-27",0,0,77,0,1,139,0,0
"United Kingdom of Great Britain and Northern Ireland","2024-07-28",0,0,77,0,1,140,0,0
"United Kingdom of Great Britain and Northern Ireland","2024-07-29",0,0,77,0,1,141,0,0
"United Kingdom of Great Britain and Northern Ireland","2024-07-30",0,0,77,0,1,142,0,0
"United Kingdom of Great Britain and Northern Ireland","2024-07-31",0,66,143,0,1,143,0,0
"United Kingdom of Great Britain and Northern Ireland","2024-08-01",0,0,143,0,1,144,0,0
"United Kingdom of Great Britain and Northern Ireland","2024-08-02",0,0,143,0,2,146,0,0
"United Kingdom of Great Britain and Northern Ireland","2024-08-03",0,0,143,0,1,147,0,0
"United Kingdom of Great Britain and Northern Ireland","2024-08-04",0,0,143,0,1,148,0,0
"United Kingdom of Great Britain and Northern Ireland","2024-08-05",0,0,143,0,1,149,0,0
"United Kingdom of Great Britain and Northern Ireland","2024-08-06",0,0,143,0,2,151,0,0
"United Kingdom of Great Britain and Northern Ireland","2024-08-07",0,0,143,0,1,152,0,0
"United Kingdom of Great Britain and Northern Ireland","2024-08-08",0,0,143,0,1,153,0,0
"United Kingdom of Great Britain and Northern Ireland","2024-08-09",0,0,143,0,2,155,0,0
"United Kingdom of Great Britain and Northern Ireland","2024-08-10",0,0,143,0,1,156,0,0
"United Kingdom of Great Britain and Northern Ireland","2024-08-11",0,0,143,0,1,157,0,0
"United Kingdom of Great Britain and Northern Ireland","2024-08-12",0,0,143,0,1,158,0,0
"United Kingdom of Great Britain and Northern Ireland","2024-08-13",0,0,143,0,2,160,0,0
"United Kingdom of Great Britain and Northern Ireland","2024-08-14",0,0,143,0,1,161,0,0
"United Kingdom of Great Britain and Northern Ireland","2024-08-15",0,0,143,0,1,162,0,0
"United Kingdom of Great Britain and Northern Ireland","2024-08-16",0,0,143,0,2,164,0,0
"United Kingdom of Great Britain and Northern Ireland","2024-08-17",0,0,143,0,1,165,0,0
"United Kingdom of Great Britain and Northern Ireland","2024-08-18",0,0,143,0,1,166,0,0
"United Kingdom of Great Britain and Northern Ireland","2024-08-19",0,0,143,0,2,168,0,0
"United Kingdom of Great Britain and Northern Ireland","2024-08-20",0,0,143,0,1,169,0,0
"United Kingdom of Great Britain and Northern Ireland","2024-08-21",0,0,143,0,1,170,0,0
"United Kingdom of Great Britain and Northern Ireland","2024-08-22",0,0,143,0,1,171,0,0
"United Kingdom of Great Britain and Northern Ireland","2024-08-23",0,0,143,0,2,173,0,0
"United Kingdom of Great Britain and Northern Ireland","2024-08-24",0,0,143,0,1,174,0,0
"United Kingdom of Great Britain and Northern Ireland","2024-08-25",0,0,143,0,1,175,0,0
"United Kingdom of Great Britain and Northern Ireland","2024-08-26",0,0,143,0,2,177,0,0
"United Kingdom of Great Britain and Northern Ireland","2024-08-27",0,0,143,0,1,178,0,0
"United Kingdom of Great Britain and Northern Ireland","2024-08-28",0,0,143,0,1,179,0,0
"United Kingdom of Great Britain and Northern Ireland","2024-08-29",0,0,143,0,1,180,0,0
"United Kingdom of Great Britain and Northern Ireland","2024-08-30",0,0,143,0,2,182,0,0
"United Kingdom of Great Britain and Northern Ireland","2024-08-31",0,40,183,0,1,183,0,0
"United Kingdom of Great Britain and Northern Ireland","2024-09-01",0,0,183,0,1,184,0,0
"United Kingdom of Great Britain and Northern Ireland","2024-09-02",0,0,183,0,2,186,0,0
"United Kingdom of Great Britain and Northern Ireland","2024-09-03",0,0,183,0,1,187,0,0
"United Kingdom of Great Britain and Northern Ireland","2024-09-04",0,0,183,0,2,189,0,0
"United Kingdom of Great Britain and Northern Ireland","2024-09-05",0,0,183,0,1,190,0,0
"United Kingdom of Great Britain and Northern Ireland","2024-09-06",0,0,183,0,1,191,0,0
"United Kingdom of Great Britain and Northern Ireland","2024-09-07",0,0,183,0,2,193,0,0
"United Kingdom of Great Britain and Northern Ireland","2024-09-08",0,0,183,0,1,194,0,0
"United Kingdom of Great Britain and Northern Ireland","2024-09-09",0,0,183,0,2,196,0,0
"United Kingdom of Great Britain and Northern Ireland","2024-09-10",0,0,183,0,1,197,0,0
"United Kingdom of Great Britain and Northern Ireland","2024-09-11",0,0,183,0,1,198,0,0
"United Kingdom of Great Britain and Northern Ireland","2024-09-12",0,0,183,0,2,200,0,0
"United Kingdom of Great Britain and Northern Ireland","2024-09-13",0,0,183,0,1,201,0,0
"United Kingdom of Great Britain and Northern Ireland","2024-09-14",0,0,183,0,2,203,0,0
"United Kingdom of Great Britain and Northern Ireland","2024-09-15",0,0,183,0,1,204,0,0
"United Kingdom of Great Britain and Northern Ireland","2024-09-16",0,0,183,0,1,205,0,0
"United Kingdom of Great Britain and Northern Ireland","2024-09-17",0,0,183,0,2,207,0,0
"United Kingdom of Great Britain and Northern Ireland","2024-09-18",0,0,183,0,1,208,0,0
"United Kingdom of Great Britain and Northern Ireland","2024-09-19",0,0,183,0,2,210,0,0
"United Kingdom of Great Britain and Northern Ireland","2024-09-20",0,0,183,0,1,211,0,0
"United Kingdom of Great Britain and Northern Ireland","2024-09-21",0,0,183,0,1,212,0,0
"United Kingdom of Great Britain and Northern Ireland","2024-09-22",0,0,183,0,2,214,0,0
"United Kingdom of Great Britain and Northern Ireland","2024-09-23",0,0,183,0,1,215,0,0
"United Kingdom of Great Britain and Northern Ireland","2024-09-24",0,0,183,0,2,217,0,0
"United Kingdom of Great Britain and Northern Ireland","2024-09-25",0,0,183,0,1,218,0,0
"United Kingdom of Great Britain and Northern Ireland","2024-09-26",0,0,183,0,1,219,0,0
"United Kingdom of Great Britain and Northern Ireland","2024-09-27",0,0,183,0,2,221,0,0
"United Kingdom of Great Britain and Northern Ireland","2024-09-28",0,0,183,0,1,222,0,0
"United Kingdom of Great Britain and Northern Ireland","2024-09-29",0,0,183,0,2,224,0,0
"United Kingdom of Great Britain and Northern Ireland","2024-09-30",0,42,225,0,1,225,0,0
"United Kingdom of Great Britain and Northern Ireland","2024-10-01",0,0,225,0,0,225,0,0
"United Kingdom of Great Britain and Northern Ireland","2024-10-02",0,0,225,0,1,226,0,0
"United Kingdom of Great Britain and Northern Ireland","2024-10-03",0,0,225,0,0,226,0,0
"United Kingdom of Great Britain and Northern Ireland","2024-10-04",0,0,225,0,0,226,0,0
"United Kingdom of Great Britain and Northern Ireland","2024-10-05",0,0,225,0,1,227,0,0
"United Kingdom of Great Britain and Northern Ireland","2024-10-06",0,0,225,0,0,227,0,0
"United Kingdom of Great Britain and Northern Ireland","2024-10-07",0,0,225,0,0,227,0,0
"United Kingdom of Great Britain and Northern Ireland","2024-10-08",0,0,225,0,1,228,0,0
"United Kingdom of Great Britain and Northern Ireland","2024-10-09",0,0,225,0,0,228,0,0
"United Kingdom of Great Britain and Northern Ireland","2024-10-10",0,0,225,0,0,228,0,0
"United Kingdom of Great Britain and Northern Ireland","2024-10-11",0,0,225,0,1,229,0,0
"United Kingdom of Great Britain and Northern Ireland","2024-10-12",0,0,225,0,0,229,0,0
"United Kingdom of Great Britain and Northern Ireland","2024-10-13",0,0,225,0,0,229,0,0
"United Kingdom of Great Britain and Northern Ireland","2024-10-14",0,0,225,0,1,230,0,0
"United Kingdom of Great Britain and Northern Ireland","2024-10-15",0,0,225,0,0,230,0,0
"United Kingdom of Great Britain and Northern Ireland","2024-10-16",0,0,225,0,0,230,0,0
"United Kingdom of Great Britain and Northern Ireland","2024-10-17",0,0,225,0,0,230,0,0
"United Kingdom of Great Britain and Northern Ireland","2024-10-18",0,0,225,0,1,231,0,0
"United Kingdom of Great Britain and Northern Ireland","2024-10-19",0,0,225,0,0,231,0,0
"United Kingdom of Great Britain and Northern Ireland","2024-10-20",0,0,225,0,0,231,0,0
"United Kingdom of Great Britain and Northern Ireland","2024-10-21",0,0,225,0,1,232,0,0
"United Kingdom of Great Britain and Northern Ireland","2024-10-22",0,0,225,0,0,232,0,0
"United Kingdom of Great Britain and Northern Ireland","2024-10-23",0,0,225,0,0,232,0,0
"United Kingdom of Great Britain and Northern Ireland","2024-10-24",0,0,225,0,1,233,0,0
"United Kingdom of Great Britain and Northern Ireland","2024-10-25",0,0,225,0,0,233,0,0
"United Kingdom of Great Britain and Northern Ireland","2024-10-26",0,0,225,0,0,233,0,0
"United Kingdom of Great Britain and Northern Ireland","2024-10-27",0,0,225,0,1,234,0,0
"United Kingdom of Great Britain and Northern Ireland","2024-10-28",0,0,225,0,0,234,0,0
"United Kingdom of Great Britain and Northern Ireland","2024-10-29",0,0,225,0,0,234,0,0
"United Kingdom of Great Britain and Northern Ireland","2024-10-30",0,0,225,0,1,235,0,0
"United Kingdom of Great Britain and Northern Ireland","2024-10-31",0,10,235,0,0,235,0,0
"United Kingdom of Great Britain and Northern Ireland","2024-11-01",0,0,235,0,1,236,0,0
"United Kingdom of Great Britain and Northern Ireland","2024-11-02",0,0,235,0,1,237,0,0
"United Kingdom of Great Britain and Northern Ireland","2024-11-03",0,0,235,0,2,239,0,0
"United Kingdom of Great Britain and Northern Ireland","2024-11-04",0,0,235,0,1,240,0,0
"United Kingdom of Great Britain and Northern Ireland","2024-11-05",0,0,235,0,1,241,0,0
"United Kingdom of Great Britain and Northern Ireland","2024-11-06",0,0,235,0,1,242,0,0
"United Kingdom of Great Britain and Northern Ireland","2024-11-07",0,0,235,0,1,243,0,0
"United Kingdom of Great Britain and Northern Ireland","2024-11-08",0,0,235,0,2,245,0,0
"United Kingdom of Great Britain and Northern Ireland","2024-11-09",0,0,235,0,1,246,0,0
"United Kingdom of Great Britain and Northern Ireland","2024-11-10",0,0,235,0,1,247,0,0
"United Kingdom of Great Britain and Northern Ireland","2024-11-11",0,0,235,0,1,248,0,0
"United Kingdom of Great Britain and Northern Ireland","2024-11-12",0,0,235,0,1,249,0,0
"United Kingdom of Great Britain and Northern Ireland","2024-11-13",0,0,235,0,2,251,0,0
"United Kingdom of Great Britain and Northern Ireland","2024-11-14",0,0,235,0,1,252,0,0
"United Kingdom of Great Britain and Northern Ireland","2024-11-15",0,0,235,0,1,253,0,0
"United Kingdom of Great Britain and Northern Ireland","2024-11-16",0,0,235,0,1,254,0,0
"United Kingdom of Great Britain and Northern Ireland","2024-11-17",0,0,235,0,1,255,0,0
"United Kingdom of Great Britain and Northern Ireland","2024-11-18",0,0,235,0,2,257,0,0
"United Kingdom of Great Britain and Northern Ireland","2024-11-19",0,0,235,0,1,258,0,0
"United Kingdom of Great Britain and Northern Ireland","2024-11-20",0,0,235,0,1,259,0,0
"United Kingdom of Great Britain and Northern Ireland","2024-11-21",0,0,235,0,1,260,0,0
"United Kingdom of Great Britain and Northern Ireland","2024-11-22",0,0,235,0,1,261,0,0
"United Kingdom of Great Britain and Northern Ireland","2024-11-23",0,0,235,0,2,263,0,0
"United Kingdom of Great Britain and Northern Ireland","2024-11-24",0,0,235,0,1,264,0,0
"United Kingdom of Great Britain and Northern Ireland","2024-11-25",0,0,235,0,1,265,0,0
"United Kingdom of Great Britain and Northern Ireland","2024-11-26",0,0,235,0,1,266,0,0
"United Kingdom of Great Britain and Northern Ireland","2024-11-27",0,0,235,0,1,267,0,0
"United Kingdom of Great Britain and Northern Ireland","2024-11-28",0,0,235,0,2,269,0,0
"United Kingdom of Great Britain and Northern Ireland","2024-11-29",0,0,235,0,1,270,0,0
"United Kingdom of Great Britain and Northern Ireland","2024-11-30",0,36,271,0,1,271,0,0
"United Kingdom of Great Britain and Northern Ireland","2024-12-01",0,0,271,0,1,272,0,0
"United Kingdom of Great Britain and Northern Ireland","2024-12-02",0,0,271,0,0,272,0,0
"United Kingdom of Great Britain and Northern Ireland","2024-12-03",0,0,271,0,1,273,0,0
"United Kingdom of Great Britain and Northern Ireland","2024-12-04",0,0,271,0,1,274,0,0
"United Kingdom of Great Britain and Northern Ireland","2024-12-05",0,0,271,0,0,274,0,0
"United Kingdom of Great Britain and Northern Ireland","2024-12-06",0,0,271,0,1,275,0,0
"United Kingdom of Great Britain and Northern Ireland","2024-12-07",0,0,271,0,1,276,0,0
"United Kingdom of Great Britain and Northern Ireland","2024-12-08",0,0,271,0,0,276,0,0
"United Kingdom of Great Britain and Northern Ireland","2024-12-09",0,0,271,0,1,277,0,0
"United Kingdom of Great Britain and Northern Ireland","2024-12-10",0,0,271,0,0,277,0,0
"United Kingdom of Great Britain and Northern Ireland","2024-12-11",0,0,271,0,1,278,0,0
"United Kingdom of Great Britain and Northern Ireland","2024-12-12",0,0,271,0,1,279,0,0
"United Kingdom of Great Britain and Northern Ireland","2024-12-13",0,0,271,0,0,279,0,0
"United Kingdom of Great Britain and Northern Ireland","2024-12-14",0,0,271,0,1,280,0,0
"United Kingdom of Great Britain and Northern Ireland","2024-12-15",0,0,271,0,1,281,0,0
"United Kingdom of Great Britain and Northern Ireland","2024-12-16",0,0,271,0,0,281,0,0
"United Kingdom of Great Britain and Northern Ireland","2024-12-17",0,0,271,0,1,282,0,0
"United Kingdom of Great Britain and Northern Ireland","2024-12-18",0,0,271,0,1,283,0,0
"United Kingdom of Great Britain and Northern Ireland","2024-12-19",0,0,271,0,0,283,0,0
"United Kingdom of Great Britain and Northern Ireland","2024-12-20",0,0,271,0,1,284,0,0
"United Kingdom of Great Britain and Northern Ireland","2024-12-21",0,0,271,0,1,285,0,0
"United Kingdom of Great Britain and Northern Ireland","2024-12-22",0,0,271,0,0,285,0,0
"United Kingdom of Great Britain and Northern Ireland","2024-12-23",0,0,271,0,1,286,0,0
"United Kingdom of Great Britain and Northern Ireland","2024-12-24",0,0,271,0,0,286,0,0
"United Kingdom of Great Britain and Northern Ireland","2024-12-25",0,0,271,0,1,287,0,0
"United Kingdom of Great Britain and Northern Ireland","2024-12-26",0,0,271,0,1,288,0,0
"United Kingdom of Great Britain and Northern Ireland","2024-12-27",0,0,271,0,0,288,0,0
"United Kingdom of Great Britain and Northern Ireland","2024-12-28",0,0,271,0,1,289,0,0
"United Kingdom of Great Britain and Northern Ireland","2024-12-29",0,0,271,0,1,290,0,0
"United Kingdom of Great Britain and Northern Ireland","2024-12-30",0,0,271,0,0,290,0,0
"United Kingdom of Great Britain and Northern Ireland","2024-12-31",0,20,291,0,1,291,0,0
"United Kingdom of Great Britain and Northern Ireland","2025-01-01",0,0,291,0,2,293,0,0
"United Kingdom of Great Britain and Northern Ireland","2025-01-02",0,0,291,0,2,295,0,0
"United Kingdom of Great Britain and Northern Ireland","2025-01-03",0,0,291,0,1,296,0,0
"United Kingdom of Great Britain and Northern Ireland","2025-01-04",0,0,291,0,2,298,0,0
"United Kingdom of Great Britain and Northern Ireland","2025-01-05",0,0,291,0,2,300,0,0
"United Kingdom of Great Britain and Northern Ireland","2025-01-06",0,0,291,0,2,302,0,0
"United Kingdom of Great Britain and Northern Ireland","2025-01-07",0,0,291,0,2,304,0,0
"United Kingdom of Great Britain and Northern Ireland","2025-01-08",0,0,291,0,1,305,0,0
"United Kingdom of Great Britain and Northern Ireland","2025-01-09",0,0,291,0,2,307,0,0
"United Kingdom of Great Britain and Northern Ireland","2025-01-10",0,18,309,0,2,309,0,0
"United Kingdom of Great Britain and Northern Ireland","2025-01-11",0,0,309,0,0,309,0,0
"United Kingdom of Great Britain and Northern Ireland","2025-01-12",0,0,309,0,0,309,0,0
"United Kingdom of Great Britain and Northern Ireland","2025-01-13",0,0,309,0,0,309,0,0
"United Kingdom of Great Britain and Northern Ireland","2025-01-14",0,0,309,0,0,309,0,0
"United Kingdom of Great Britain and Northern Ireland","2025-01-15",0,0,309,0,0,309,0,0
"United Kingdom of Great Britain and Northern Ireland","2025-01-16",0,0,309,0,0,309,0,0
"United Kingdom of Great Britain and Northern Ireland","2025-01-17",0,0,309,0,0,309,0,0
"United Kingdom of Great Britain and Northern Ireland","2025-01-18",0,0,309,0,0,309,0,0
"United Kingdom of Great Britain and Northern Ireland","2025-01-19",0,0,309,0,0,309,0,0
"United Kingdom of Great Britain and Northern Ireland","2025-01-20",0,0,309,0,0,309,0,0
"United Kingdom of Great Britain and Northern Ireland","2025-01-21",0,0,309,0,0,309,0,0
"United Kingdom of Great Britain and Northern Ireland","2025-01-22",0,0,309,0,0,309,0,0
"United Kingdom of Great Britain and Northern Ireland","2025-01-23",0,0,309,0,0,309,0,0
"United Kingdom of Great Britain and Northern Ireland","2025-01-24",0,0,309,0,0,309,0,0
"United Kingdom of Great Britain and Northern Ireland","2025-01-25",0,0,309,0,0,309,0,0
"United Kingdom of Great Britain and Northern Ireland","2025-01-26",0,0,309,0,0,309,0,0
"United Kingdom of Great Britain and Northern Ireland","2025-01-27",0,0,309,0,0,309,0,0
"United Kingdom of Great Britain and Northern Ireland","2025-01-28",0,0,309,0,0,309,0,0
"United Kingdom of Great Britain and Northern Ireland","2025-01-29",0,0,309,0,0,309,0,0
"United Kingdom of Great Britain and Northern Ireland","2025-01-30",0,0,309,0,0,309,0,0
"United Kingdom of Great Britain and Northern Ireland","2025-01-31",0,0,309,0,0,309,0,0
"United Kingdom of Great Britain and Northern Ireland","2025-02-01",0,0,309,0,0,309,0,0
"United Kingdom of Great Britain and Northern Ireland","2025-02-02",0,0,309,0,0,309,0,0
"United Kingdom of Great Britain and Northern Ireland","2025-02-03",0,0,309,0,0,309,0,0
"United Kingdom of Great Britain and Northern Ireland","2025-02-04",0,0,309,0,0,309,0,0
"United Kingdom of Great Britain and Northern Ireland","2025-02-05",0,0,309,0,0,309,0,0
"United Kingdom of Great Britain and Northern Ireland","2025-02-06",0,0,309,0,0,309,0,0
"United Kingdom of Great Britain and Northern Ireland","2025-02-07",0,0,309,0,0,309,0,0
"United Kingdom of Great Britain and Northern Ireland","2025-02-08",0,0,309,0,0,309,0,0
"United Kingdom of Great Britain and Northern Ireland","2025-02-09",0,0,309,0,0,309,0,0
"United Kingdom of Great Britain and Northern Ireland","2025-02-10",0,0,309,0,0,309,0,0
"United Kingdom of Great Britain and Northern Ireland","2025-02-11",0,0,309,0,0,309,0,0
"United Kingdom of Great Britain and Northern Ireland","2025-02-12",0,0,309,0,0,309,0,0
"United Kingdom of Great Britain and Northern Ireland","2025-02-13",0,0,309,0,0,309,0,0
"United Kingdom of Great Britain and Northern Ireland","2025-02-14",0,0,309,0,0,309,0,0
"United Kingdom of Great Britain and Northern Ireland","2025-02-15",0,0,309,0,0,309,0,0
"United Kingdom of Great Britain and Northern Ireland","2025-02-16",0,0,309,0,0,309,0,0
"United Kingdom of Great Britain and Northern Ireland","2025-02-17",0,0,309,0,0,309,0,0
"United Kingdom of Great Britain and Northern Ireland","2025-02-18",0,0,309,0,0,309,0,0
"United Kingdom of Great Britain and Northern Ireland","2025-02-19",0,0,309,0,0,309,0,0
"United Kingdom of Great Britain and Northern Ireland","2025-02-20",0,0,309,0,0,309,0,0
"United Kingdom of Great Britain and Northern Ireland","2025-02-21",0,0,309,0,0,309,0,0
"United Kingdom of Great Britain and Northern Ireland","2025-02-22",0,0,309,0,0,309,0,0
"United Kingdom of Great Britain and Northern Ireland","2025-02-23",0,0,309,0,0,309,0,0
"United Kingdom of Great Britain and Northern Ireland","2025-02-24",0,0,309,0,0,309,0,0
"United Kingdom of Great Britain and Northern Ireland","2025-02-25",0,0,309,0,0,309,0,0
"United Kingdom of Great Britain and Northern Ireland","2025-02-26",0,0,309,0,0,309,0,0
"United Kingdom of Great Britain and Northern Ireland","2025-02-27",0,0,309,0,0,309,0,0
"United Kingdom of Great Britain and Northern Ireland","2025-02-28",0,0,309,0,0,309,0,0
"United Kingdom of Great Britain and Northern Ireland","2025-03-01",0,0,309,0,0,309,0,0
"United Kingdom of Great Britain and Northern Ireland","2025-03-02",0,0,309,0,0,309,0,0
"United Kingdom of Great Britain and Northern Ireland","2025-03-03",0,0,309,0,0,309,0,0
"United States of America","2024-01-01",0,0,0,0,0,0,0,0
"United States of America","2024-01-02",0,52,52,0,52,52,0,0
"United States of America","2024-01-03",0,0,52,0,8,60,0,0
"United States of America","2024-01-04",0,0,52,0,9,69,0,0
"United States of America","2024-01-05",0,0,52,0,8,77,0,0
"United States of America","2024-01-06",0,0,52,0,9,86,0,0
"United States of America","2024-01-07",0,0,52,0,8,94,0,0
"United States of America","2024-01-08",0,0,52,0,9,103,0,0
"United States of America","2024-01-09",0,59,111,0,8,111,0,0
"United States of America","2024-01-10",0,0,111,0,11,122,0,0
"United States of America","2024-01-11",0,0,111,0,11,133,0,0
"United States of America","2024-01-12",0,0,111,0,11,144,0,0
"United States of America","2024-01-13",0,0,111,0,10,154,0,0
"United States of America","2024-01-14",0,0,111,0,11,165,0,0
"United States of America","2024-01-15",0,0,111,0,11,176,0,0
"United States of America","2024-01-16",0,76,187,0,11,187,0,0
"United States of America","2024-01-17",0,0,187,0,8,195,0,0
"United States of America","2024-01-18",0,0,187,0,8,203,0,0
"United States of America","2024-01-19",0,0,187,0,8,211,0,0
"United States of America","2024-01-20",0,0,187,0,9,220,0,0
"United States of America","2024-01-21",0,0,187,0,8,228,0,0
"United States of America","2024-01-22",0,0,187,0,8,236,0,0
"United States of America","2024-01-23",0,57,244,0,8,244,0,0
"United States of America","2024-01-24",0,0,244,0,13,257,0,0
"United States of America","2024-01-25",0,0,244,0,14,271,0,0
"United States of America","2024-01-26",0,0,244,0,13,284,0,0
"United States of America","2024-01-27",0,0,244,0,14,298,0,0
"United States of America","2024-01-28",0,0,244,0,13,311,0,0
"United States of America","2024-01-29",0,0,244,0,14,325,0,0
"United States of America","2024-01-30",0,94,338,0,13,338,0,0
"United States of America","2024-01-31",0,0,338,0,9,347,0,0
"United States of America","2024-02-01",0,0,338,0,9,356,0,0
"United States of America","2024-02-02",0,0,338,0,9,365,0,0
"United States of America","2024-02-03",0,0,338,0,8,373,0,0
"United States of America","2024-02-04",0,0,338,0,9,382,0,0
"United States of America","2024-02-05",0,0,338,0,9,391,0,0
"United States of America","2024-02-06",0,62,400,0,9,400,0,0
"United States of America","2024-02-07",0,0,400,0,9,409,0,0
"United States of America","2024-02-08",0,0,400,0,10,419,0,0
"United States of America","2024-02-09",0,0,400,0,9,428,0,0
"United States of America","2024-02-10",0,0,400,0,10,438,0,0
"United States of America","2024-02-11",0,0,400,0,9,447,0,0
"United States of America","2024-02-12",0,0,400,0,10,457,0,0
"United States of America","2024-02-13",0,66,466,0,9,466,0,0
"United States of America","2024-02-14",0,0,466,0,9,475,0,0
"United States of America","2024-02-15",0,0,466,0,8,483,0,0
"United States of America","2024-02-16",0,0,466,0,9,492,0,0
"United States of America","2024-02-17",0,0,466,0,8,500,0,0
"United States of America","2024-02-18",0,0,466,0,9,509,0,0
"United States of America","2024-02-19",0,0,466,0,8,517,0,0
"United States of America","2024-02-20",0,60,526,0,9,526,0,0
"United States of America","2024-02-21",0,0,526,0,12,538,0,0
"United States of America","2024-02-22",0,0,526,0,11,549,0,0
"United States of America","2024-02-23",0,0,526,0,12,561,0,0
"United States of America","2024-02-24",0,0,526,0,12,573,0,0
"United States of America","2024-02-25",0,0,526,0,12,585,0,0
"United States of America","2024-02-26",0,0,526,0,11,596,0,0
"United States of America","2024-02-27",0,82,608,0,12,608,0,0
"United States of America","2024-02-28",0,0,608,0,11,619,0,0
"United States of America","2024-02-29",0,0,608,0,11,630,0,0
"United States of America","2024-03-01",0,0,608,0,11,641,0,0
"United States of America","2024-03-02",0,0,608,0,10,651,0,0
"United States of America","2024-03-03",0,0,608,0,11,662,0,0
"United States of America","2024-03-04",0,0,608,0,11,673,0,0
"United States of America","2024-03-05",0,76,684,0,11,684,0,0
"United States of America","2024-03-06",0,0,684,0,12,696,0,0
"United States of America","2024-03-07",0,0,684,0,12,708,0,0
"United States of America","2024-03-08",0,0,684,0,12,720,0,0
"United States of America","2024-03-09",0,0,684,0,13,733,0,0
"United States of America","2024-03-10",0,0,684,0,12,745,0,0
"United States of America","2024-03-11",0,0,684,0,12,757,0,0
"United States of America","2024-03-12",0,85,769,0,12,769,0,0
"United States of America","2024-03-13",0,0,769,0,8,777,0,0
"United States of America","2024-03-14",0,0,769,0,9,786,0,0
"United States of America","2024-03-15",0,0,769,0,8,794,0,0
"United States of America","2024-03-16",0,0,769,0,8,802,0,0
"United States of America","2024-03-17",0,0,769,0,8,810,0,0
"United States of America","2024-03-18",0,0,769,0,9,819,0,0
"United States of America","2024-03-19",0,58,827,0,8,827,0,0
"United States of America","2024-03-20",0,0,827,0,9,836,0,0
"United States of America","2024-03-21",0,0,827,0,9,845,0,0
"United States of America","2024-03-22",0,0,827,0,9,854,0,0
"United States of America","2024-03-23",0,0,827,0,9,863,0,0
"United States of America","2024-03-24",0,0,827,0,9,872,0,0
"United States of America","2024-03-25",0,0,827,0,9,881,0,0
"United States of America","2024-03-26",0,63,890,0,9,890,0,0
"United States of America","2024-03-27",0,0,890,0,7,897,0,0
"United States of America","2024-03-28",0,0,890,0,7,904,0,0
"United States of America","2024-03-29",0,0,890,0,7,911,0,0
"United States of America","2024-03-30",0,0,890,0,7,918,0,0
"United States of America","2024-03-31",0,0,890,0,7,925,0,0
"United States of America","2024-04-01",0,0,890,0,7,932,0,0
"United States of America","2024-04-02",0,49,939,0,7,939,0,0
"United States of America","2024-04-03",0,0,939,0,10,949,0,0
"United States of America","2024-04-04",0,0,939,0,9,958,0,0
"United States of America","2024-04-05",0,0,939,0,10,968,0,0
"United States of America","2024-04-06",0,0,939,0,10,978,0,0
"United States of America","2024-04-07",0,0,939,0,10,988,0,0
"United States of America","2024-04-08",0,0,939,0,9,997,0,0
"United States of America","2024-04-09",0,68,1007,0,10,1007,0,0
"United States of America","2024-04-10",0,0,1007,0,11,1018,0,0
"United States of America","2024-04-11",0,0,1007,0,11,1029,0,0
"United States of America","2024-04-12",0,0,1007,0,11,1040,0,0
"United States of America","2024-04-13",0,0,1007,0,12,1052,0,0
"United States of America","2024-04-14",0,0,1007,0,11,1063,0,0
"United States of America","2024-04-15",0,0,1007,0,11,1074,0,0
"United States of America","2024-04-16",0,78,1085,0,11,1085,0,0
"United States of America","2024-04-17",0,0,1085,0,11,1096,0,0
"United States of America","2024-04-18",0,0,1085,0,12,1108,0,0
"United States of America","2024-04-19",0,0,1085,0,11,1119,0,0
"United States of America","2024-04-20",0,0,1085,0,12,1131,0,0
"United States of America","2024-04-21",0,0,1085,0,11,1142,0,0
"United States of America","2024-04-22",0,0,1085,0,12,1154,0,0
"United States of America","2024-04-23",0,80,1165,0,11,1165,0,0
"United States of America","2024-04-24",0,0,1165,0,8,1173,0,0
"United States of America","2024-04-25",0,0,1165,0,7,1180,0,0
"United States of America","2024-04-26",0,0,1165,0,8,1188,0,0
"United States of America","2024-04-27",0,0,1165,0,7,1195,0,0
"United States of America","2024-04-28",0,0,1165,0,8,1203,0,0
"United States of America","2024-04-29",0,0,1165,0,7,1210,0,0
"United States of America","2024-04-30",0,53,1218,0,8,1218,0,0
"United States of America","2024-05-01",0,0,1218,0,8,1226,0,0
"United States of America","2024-05-02",0,0,1218,0,8,1234,0,0
"United States of America","2024-05-03",0,0,1218,0,8,1242,0,0
"United States of America","2024-05-04",0,0,1218,0,8,1250,0,0
"United States of America","2024-05-05",0,0,1218,0,8,1258,0,0
"United States of America","2024-05-06",0,0,1218,0,8,1266,0,0
"United States of America","2024-05-07",0,56,1274,0,8,1274,0,0
"United States of America","2024-05-08",0,0,1274,0,7,1281,0,0
"United States of America","2024-05-09",0,0,1274,0,7,1288,0,0
"United States of America","2024-05-10",0,0,1274,0,7,1295,0,0
"United States of America","2024-05-11",0,0,1274,0,7,1302,0,0
"United States of America","2024-05-12",0,0,1274,0,7,1309,0,0
"United States of America","2024-05-13",0,0,1274,0,7,1316,0,0
"United States of America","2024-05-14",0,49,1323,0,7,1323,0,0
"United States of America","2024-05-15",0,0,1323,0,8,1331,0,0
"United States of America","2024-05-16",0,0,1323,0,9,1340,0,0
"United States of America","2024-05-17",0,0,1323,0,8,1348,0,0
"United States of America","2024-05-18",0,0,1323,0,8,1356,0,0
"United States of America","2024-05-19",0,0,1323,0,8,1364,0,0
"United States of America","2024-05-20",0,0,1323,0,9,1373,0,0
"United States of America","2024-05-21",0,58,1381,0,8,1381,0,0
"United States of America","2024-05-22",0,0,1381,0,8,1389,0,0
"United States of America","2024-05-23",0,0,1381,0,9,1398,0,0
"United States of America","2024-05-24",0,0,1381,0,8,1406,0,0
"United States of America","2024-05-25",0,0,1381,0,8,1414,0,0
"United States of America","2024-05-26",0,0,1381,0,8,1422,0,0
"United States of America","2024-05-27",0,0,1381,0,9,1431,0,0
"United States of America","2024-05-28",0,58,1439,0,8,1439,0,0
"United States of America","2024-05-29",0,0,1439,0,9,1448,0,0
"United States of America","2024-05-30",0,0,1439,0,9,1457,0,0
"United States of America","2024-05-31",0,0,1439,0,9,1466,0,0
"United States of America","2024-06-01",0,0,1439,0,10,1476,0,0
"United States of America","2024-06-02",0,0,1439,0,9,1485,0,0
"United States of America","2024-06-03",0,0,1439,0,9,1494,0,0
"United States of America","2024-06-04",0,64,1503,0,9,1503,0,0
"United States of America","2024-06-05",0,0,1503,0,10,1513,0,0
"United States of America","2024-06-06",0,0,1503,0,11,1524,0,0
"United States of America","2024-06-07",0,0,1503,0,10,1534,0,0
"United States of America","2024-06-08",0,0,1503,0,11,1545,0,0
"United States of America","2024-06-09",0,0,1503,0,10,1555,0,0
"United States of America","2024-06-10",0,0,1503,0,11,1566,0,0
"United States of America","2024-06-11",0,73,1576,0,10,1576,0,0
"United States of America","2024-06-12",0,0,1576,0,7,1583,0,0
"United States of America","2024-06-13",0,0,1576,0,7,1590,0,0
"United States of America","2024-06-14",0,0,1576,0,7,1597,0,0
"United States of America","2024-06-15",0,0,1576,0,7,1604,0,0
"United States of America","2024-06-16",0,0,1576,0,7,1611,0,0
"United States of America","2024-06-17",0,0,1576,0,7,1618,0,0
"United States of America","2024-06-18",0,49,1625,0,7,1625,0,0
"United States of America","2024-06-19",0,0,1625,0,7,1632,0,0
"United States of America","2024-06-20",0,0,1625,0,8,1640,0,0
"United States of America","2024-06-21",0,0,1625,0,7,1647,0,0
"United States of America","2024-06-22",0,0,1625,0,8,1655,0,0
"United States of America","2024-06-23",0,0,1625,0,7,1662,0,0
"United States of America","2024-06-24",0,0,1625,0,8,1670,0,0
"United States of America","2024-06-25",0,52,1677,0,7,1677,0,0
"United States of America","2024-06-26",0,0,1677,0,7,1684,0,0
"United States of America","2024-06-27",0,0,1677,0,8,1692,0,0
"United States of America","2024-06-28",0,0,1677,0,7,1699,0,0
"United States of America","2024-06-29",0,0,1677,0,8,1707,0,0
"United States of America","2024-06-30",0,0,1677,0,7,1714,0,0
"United States of America","2024-07-01",0,0,1677,0,8,1722,0,0
"United States of America","2024-07-02",0,52,1729,0,7,1729,0,0
"United States of America","2024-07-03",0,0,1729,0,9,1738,0,0
"United States of America","2024-07-04",0,0,1729,0,9,1747,0,0
"United States of America","2024-07-05",0,0,1729,0,9,1756,0,0
"United States of America","2024-07-06",0,0,1729,0,9,1765,0,0
"United States of America","2024-07-07",0,0,1729,0,9,1774,0,0
"United States of America","2024-07-08",0,0,1729,0,9,1783,0,0
"United States of America","2024-07-09",0,63,1792,0,9,1792,0,0
"United States of America","2024-07-10",0,0,1792,0,9,1801,0,0
"United States of America","2024-07-11",0,0,1792,0,10,1811,0,0
"United States of America","2024-07-12",0,0,1792,0,9,1820,0,0
"United States of America","2024-07-13",0,0,1792,0,9,1829,0,0
"United States of America","2024-07-14",0,0,1792,0,9,1838,0,0
"United States of America","2024-07-15",0,0,1792,0,10,1848,0,0
"United States of America","2024-07-16",0,65,1857,0,9,1857,0,0
"United States of America","2024-07-17",0,0,1857,0,7,1864,0,0
"United States of America","2024-07-18",0,0,1857,0,6,1870,0,0
"United States of America","2024-07-19",0,0,1857,0,7,1877,0,0
"United States of America","2024-07-20",0,0,1857,0,6,1883,0,0
"United States of America","2024-07-21",0,0,1857,0,7,1890,0,0
"United States of America","2024-07-22",0,0,1857,0,6,1896,0,0
"United States of America","2024-07-23",0,46,1903,0,7,1903,0,0
"United States of America","2024-07-24",0,0,1903,0,8,1911,0,0
"United States of America","2024-07-25",0,0,1903,0,9,1920,0,0
"United States of America","2024-07-26",0,0,1903,0,8,1928,0,0
"United States of America","2024-07-27",0,0,1903,0,9,1937,0,0
"United States of America","2024-07-28",0,0,1903,0,8,1945,0,0
"United States of America","2024-07-29",0,0,1903,0,9,1954,0,0
"United States of America","2024-07-30",0,59,1962,0,8,1962,0,0
"United States of America","2024-07-31",0,0,1962,0,8,1970,0,0
"United States of America","2024-08-01",0,0,1962,0,9,1979,0,0
"United States of America","2024-08-02",0,0,1962,0,8,1987,0,0
"United States of America","2024-08-03",0,0,1962,0,8,1995,0,0
"United States of America","2024-08-04",0,0,1962,0,8,2003,0,0
"United States of America","2024-08-05",0,0,1962,0,9,2012,0,0
"United States of America","2024-08-06",0,58,2020,0,8,2020,0,0
"United States of America","2024-08-07",0,0,2020,0,11,2031,0,0
"United States of America","2024-08-08",0,0,2020,0,10,2041,0,0
"United States of America","2024-08-09",0,0,2020,0,11,2052,0,0
"United States of America","2024-08-10",0,0,2020,0,10,2062,0,0
"United States of America","2024-08-11",0,0,2020,0,11,2073,0,0
"United States of America","2024-08-12",0,0,2020,0,10,2083,0,0
"United States of America","2024-08-13",0,74,2094,0,11,2094,0,0
"United States of America","2024-08-14",0,0,2094,0,9,2103,0,0
"United States of America","2024-08-15",0,0,2094,0,9,2112,0,0
"United States of America","2024-08-16",0,0,2094,0,9,2121,0,0
"United States of America","2024-08-17",0,0,2094,0,10,2131,0,0
"United States of America","2024-08-18",0,0,2094,0,9,2140,0,0
"United States of America","2024-08-19",0,0,2094,0,9,2149,0,0
"United States of America","2024-08-20",0,64,2158,0,9,2158,0,0
"United States of America","2024-08-21",0,0,2158,0,9,2167,0,0
"United States of America","2024-08-22",0,0,2158,0,9,2176,0,0
"United States of America","2024-08-23",0,0,2158,0,9,2185,0,0
"United States of America","2024-08-24",0,0,2158,0,8,2193,0,0
"United States of America","2024-08-25",0,0,2158,0,9,2202,0,0
"United States of America","2024-08-26",0,0,2158,0,9,2211,0,0
"United States of America","2024-08-27",0,62,2220,0,9,2220,0,0
"United States of America","2024-08-28",0,0,2220,0,10,2230,0,0
"United States of America","2024-08-29",0,0,2220,0,9,2239,0,0
"United States of America","2024-08-30",0,0,2220,0,10,2249,0,0
"United States of America","2024-08-31",0,0,2220,0,9,2258,0,0
"United States of America","2024-09-01",0,0,2220,0,10,2268,0,0
"United States of America","2024-09-02",0,0,2220,0,9,2277,0,0
"United States of America","2024-09-03",0,67,2287,0,10,2287,0,0
"United States of America","2024-09-04",0,0,2287,0,10,2297,0,0
"United States of America","2024-09-05",0,0,2287,0,9,2306,0,0
"United States of America","2024-09-06",0,0,2287,0,10,2316,0,0
"United States of America","2024-09-07",0,0,2287,0,9,2325,0,0
"United States of America","2024-09-08",0,0,2287,0,10,2335,0,0
"United States of America","2024-09-09",0,0,2287,0,9,2344,0,0
"United States of America","2024-09-10",0,67,2354,0,10,2354,0,0
"United States of America","2024-09-11",0,0,2354,0,7,2361,0,0
"United States of America","2024-09-12",0,0,2354,0,6,2367,0,0
"United States of America","2024-09-13",0,0,2354,0,7,2374,0,0
"United States of America","2024-09-14",0,0,2354,0,7,2381,0,0
"United States of America","2024-09-15",0,0,2354,0,7,2388,0,0
"United States of America","2024-09-16",0,0,2354,0,6,2394,0,0
"United States of America","2024-09-17",0,47,2401,0,7,2401,0,0
"United States of America","2024-09-18",0,0,2401,0,9,2410,0,0
"United States of America","2024-09-19",0,0,2401,0,8,2418,0,0
"United States of America","2024-09-20",0,0,2401,0,9,2427,0,0
"United States of America","2024-09-21",0,0,2401,0,9,2436,0,0
"United States of America","2024-09-22",0,0,2401,0,9,2445,0,0
"United States of America","2024-09-23",0,0,2401,0,8,2453,0,0
"United States of America","2024-09-24",0,61,2462,0,9,2462,0,0
"United States of America","2024-09-25",0,0,2462,0,7,2469,0,0
"United States of America","2024-09-26",0,0,2462,0,6,2475,0,0
"United States of America","2024-09-27",0,0,2462,0,7,2482,0,0
"United States of America","2024-09-28",0,0,2462,0,6,2488,0,0
"United States of America","2024-09-29",0,0,2462,0,7,2495,0,0
"United States of America","2024-09-30",0,0,2462,0,6,2501,0,0
"United States of America","2024-10-01",0,46,2508,0,7,2508,0,0
"United States of America","2024-10-02",0,0,2508,0,5,2513,0,0
"United States of America","2024-10-03",0,0,2508,0,6,2519,0,0
"United States of America","2024-10-04",0,0,2508,0,5,2524,0,0
"United States of America","2024-10-05",0,0,2508,0,5,2529,0,0
"United States of America","2024-10-06",0,0,2508,0,5,2534,0,0
"United States of America","2024-10-07",0,0,2508,0,6,2540,0,0
"United States of America","2024-10-08",0,37,2545,0,5,2545,0,0
"United States of America","2024-10-09",0,0,2545,0,4,2549,0,0
"United States of America","2024-10-10",0,0,2545,0,3,2552,0,0
"United States of America","2024-10-11",0,0,2545,0,4,2556,0,0
"United States of America","2024-10-12",0,0,2545,0,4,2560,0,0
"United States of America","2024-10-13",0,0,2545,0,4,2564,0,0
"United States of America","2024-10-14",0,0,2545,0,3,2567,0,0
"United States of America","2024-10-15",0,26,2571,0,4,2571,0,0
"United States of America","2024-10-16",0,0,2571,0,6,2577,0,0
"United States of America","2024-10-17",0,0,2571,0,6,2583,0,0
"United States of America","2024-10-18",0,0,2571,0,6,2589,0,0
"United States of America","2024-10-19",0,0,2571,0,7,2596,0,0
"United States of America","2024-10-20",0,0,2571,0,6,2602,0,0
"United States of America","2024-10-21",0,0,2571,0,6,2608,0,0
"United States of America","2024-10-22",0,43,2614,0,6,2614,0,0
"United States of America","2024-10-23",0,0,2614,0,5,2619,0,0
"United States of America","2024-10-24",0,0,2614,0,5,2624,0,0
"United States of America","2024-10-25",0,0,2614,0,5,2629,0,0
"United States of America","2024-10-26",0,0,2614,0,5,2634,0,0
"United States of America","2024-10-27",0,0,2614,0,5,2639,0,0
"United States of America","2024-10-28",0,0,2614,0,5,2644,0,0
"United States of America","2024-10-29",0,35,2649,0,5,2649,0,0
"United States of America","2024-10-30",0,0,2649,0,5,2654,0,0
"United States of America","2024-10-31",0,0,2649,0,6,2660,0,0
"United States of America","2024-11-01",0,0,2649,0,5,2665,0,0
"United States of America","2024-11-02",0,0,2649,0,6,2671,0,0
"United States of America","2024-11-03",0,0,2649,0,5,2676,0,0
"United States of America","2024-11-04",0,0,2649,0,6,2682,0,0
"United States of America","2024-11-05",0,38,2687,0,5,2687,0,0
"United States of America","2024-11-06",0,0,2687,0,5,2692,0,0
"United States of America","2024-11-07",0,0,2687,0,6,2698,0,0
"United States of America","2024-11-08",0,0,2687,0,5,2703,0,0
"United States of America","2024-11-09",0,0,2687,0,5,2708,0,0
"United States of America","2024-11-10",0,0,2687,0,5,2713,0,0
"United States of America","2024-11-11",0,0,2687,0,6,2719,0,0
"United States of America","2024-11-12",0,37,2724,0,5,2724,0,0
"United States of America","2024-11-13",0,0,2724,0,4,2728,0,0
"United States of America","2024-11-14",0,0,2724,0,5,2733,0,0
"United States of America","2024-11-15",0,0,2724,0,4,2737,0,0
"United States of America","2024-11-16",0,0,2724,0,4,2741,0,0
"United States of America","2024-11-17",0,0,2724,0,4,2745,0,0
"United States of America","2024-11-18",0,0,2724,0,5,2750,0,0
"United States of America","2024-11-19",0,30,2754,0,4,2754,0,0
"United States of America","2024-11-20",0,0,2754,0,3,2757,0,0
"United States of America","2024-11-21",0,0,2754,0,4,2761,0,0
"United States of America","2024-11-22",0,0,2754,0,3,2764,0,0
"United States of America","2024-11-23",0,0,2754,0,3,2767,0,0
"United States of America","2024-11-24",0,0,2754,0,3,2770,0,0
"United States of America","2024-11-25",0,0,2754,0,4,2774,0,0
"United States of America","2024-11-26",0,23,2777,0,3,2777,0,0
"United States of America","2024-11-27",0,0,2777,0,3,2780,0,0
"United States of America","2024-11-28",0,0,2777,0,2,2782,0,0
"United States of America","2024-11-29",0,0,2777,0,3,2785,0,0
"United States of America","2024-11-30",0,0,2777,0,2,2787,0,0
"United States of America","2024-12-01",0,0,2777,0,3,2790,0,0
"United States of America","2024-12-02",0,0,2777,0,2,2792,0,0
"United States of America","2024-12-03",0,18,2795,0,3,2795,0,0
"United States of America","2024-12-04",0,0,2795,0,2,2797,0,0
"United States of America","2024-12-05",0,0,2795,0,3,2800,0,0
"United States of America","2024-12-06",0,0,2795,0,2,2802,0,0
"United States of America","2024-12-07",0,0,2795,0,2,2804,0,0
"United States of America","2024-12-08",0,0,2795,0,2,2806,0,0
"United States of America","2024-12-09",0,0,2795,0,3,2809,0,0
"United States of America","2024-12-10",0,16,2811,0,2,2811,0,0
"United States of America","2024-12-11",0,0,2811,0,3,2814,0,0
"United States of America","2024-12-12",0,0,2811,0,3,2817,0,0
"United States of America","2024-12-13",0,0,2811,0,3,2820,0,0
"United States of America","2024-12-14",0,0,2811,0,2,2822,0,0
"United States of America","2024-12-15",0,0,2811,0,3,2825,0,0
"United States of America","2024-12-16",0,0,2811,0,3,2828,0,0
"United States of America","2024-12-17",0,20,2831,0,3,2831,0,0
"United States of America","2024-12-18",0,0,2831,0,2,2833,0,0
"United States of America","2024-12-19",0,0,2831,0,3,2836,0,0
"United States of America","2024-12-20",0,0,2831,0,2,2838,0,0
"United States of America","2024-12-21",0,0,2831,0,3,2841,0,0
"United States of America","2024-12-22",0,0,2831,0,2,2843,0,0
"United States of America","2024-12-23",0,0,2831,0,3,2846,0,0
"United States of America","2024-12-24",0,17,2848,0,2,2848,0,0
"United States of America","2024-12-25",0,0,2848,0,3,2851,0,0
"United States of America","2024-12-26",0,0,2848,0,2,2853,0,0
"United States of America","2024-12-27",0,0,2848,0,3,2856,0,0
"United States of America","2024-12-28",0,0,2848,0,3,2859,0,0
"United States of America","2024-12-29",0,0,2848,0,3,2862,0,0
"United States of America","2024-12-30",0,0,2848,0,2,2864,0,0
"United States of America","2024-12-31",0,19,2867,0,3,2867,0,0
"United States of America","2025-01-01",0,0,2867,0,1,2868,0,0
"United States of America","2025-01-02",0,0,2867,0,2,2870,0,0
"United States of America","2025-01-03",0,0,2867,0,1,2871,0,0
"United States of America","2025-01-04",0,0,2867,0,2,2873,0,0
"United States of America","2025-01-05",0,0,2867,0,1,2874,0,0
"United States of America","2025-01-06",0,0,2867,0,2,2876,0,0
"United States of America","2025-01-07",0,10,2877,0,1,2877,0,0
"United States of America","2025-01-08",0,0,2877,0,1,2878,0,0
"United States of America","2025-01-09",0,0,2877,0,1,2879,0,0
"United States of America","2025-01-10",0,0,2877,0,1,2880,0,0
"United States of America","2025-01-11",0,0,2877,0,0,2880,0,0
"United States of America","2025-01-12",0,0,2877,0,1,2881,0,0
"United States of America","2025-01-13",0,0,2877,0,1,2882,0,0
"United States of America","2025-01-14",0,6,2883,0,1,2883,0,0
"United States of America","2025-01-15",0,0,2883,0,0,2883,0,0
"United States of America","2025-01-16",0,0,2883,0,1,2884,0,0
"United States of America","2025-01-17",0,0,2883,0,0,2884,0,0
"United States of America","2025-01-18",0,0,2883,0,0,2884,0,0
"United States of America","2025-01-19",0,0,2883,0,0,2884,0,0
"United States of America","2025-01-20",0,0,2883,0,1,2885,0,0
"United States of America","2025-01-21",0,2,2885,0,0,2885,0,0
"United States of America","2025-01-22",0,0,2885,0,1,2886,0,0
"United States of America","2025-01-23",0,0,2885,0,2,2888,0,0
"United States of America","2025-01-24",0,0,2885,0,1,2889,0,0
"United States of America","2025-01-25",0,0,2885,0,2,2891,0,0
"United States of America","2025-01-26",0,0,2885,0,1,2892,0,0
"United States of America","2025-01-27",0,0,2885,0,2,2894,0,0
"United States of America","2025-01-28",0,10,2895,0,1,2895,0,0
"United States of America","2025-01-29",0,0,2895,0,0,2895,0,0
"United States of America","2025-01-30",0,0,2895,0,0,2895,0,0
"United States of America","2025-01-31",0,0,2895,0,0,2895,0,0
"United States of America","2025-02-01",0,0,2895,0,0,2895,0,0
"United States of America","2025-02-02",0,0,2895,0,0,2895,0,0
"United States of America","2025-02-03",0,0,2895,0,0,2895,0,0
"United States of America","2025-02-04",0,0,2895,0,0,2895,0,0
"United States of America","2025-02-05",0,0,2895,0,0,2895,0,0
"United States of America","2025-02-06",0,0,2895,0,0,2895,0,0
"United States of America","2025-02-07",0,0,2895,0,0,2895,0,0
"United States of America","2025-02-08",0,0,2895,0,0,2895,0,0
"United States of America","2025-02-09",0,0,2895,0,0,2895,0,0
"United States of America","2025-02-10",0,0,2895,0,0,2895,0,0
"United States of America","2025-02-11",0,0,2895,0,0,2895,0,0
"United States of America","2025-02-12",0,0,2895,0,0,2895,0,0
"United States of America","2025-02-13",0,0,2895,0,0,2895,0,0
"United States of America","2025-02-14",0,0,2895,0,0,2895,0,0
"United States of America","2025-02-15",0,0,2895,0,0,2895,0,0
"United States of America","2025-02-16",0,0,2895,0,0,2895,0,0
"United States of America","2025-02-17",0,0,2895,0,0,2895,0,0
"United States of America","2025-02-18",0,0,2895,0,0,2895,0,0
"United States of America","2025-02-19",0,0,2895,0,0,2895,0,0
"United States of America","2025-02-20",0,0,2895,0,0,2895,0,0
"United States of America","2025-02-21",0,0,2895,0,0,2895,0,0
"United States of America","2025-02-22",0,0,2895,0,0,2895,0,0
"United States of America","2025-02-23",0,0,2895,0,0,2895,0,0
"United States of America","2025-02-24",0,0,2895,0,0,2895,0,0
"United States of America","2025-02-25",0,0,2895,0,0,2895,0,0
"United States of America","2025-02-26",0,0,2895,0,0,2895,0,0
"United States of America","2025-02-27",0,0,2895,0,0,2895,0,0
"United States of America","2025-02-28",0,0,2895,0,0,2895,0,0
"United States of America","2025-03-01",0,0,2895,0,0,2895,0,0
"United States of America","2025-03-02",0,0,2895,0,0,2895,0,0
"United States of America","2025-03-03",0,0,2895,0,0,2895,0,0
"Uruguay","2024-01-01",0,0,0,0,0,0,0,0
"Uruguay","2024-01-02",0,0,0,0,0,0,0,0
"Uruguay","2024-01-03",0,0,0,0,0,0,0,0
"Uruguay","2024-01-04",0,0,0,0,0,0,0,0
"Uruguay","2024-01-05",0,0,0,0,0,0,0,0
"Uruguay","2024-01-06",0,0,0,0,0,0,0,0
"Uruguay","2024-01-07",0,0,0,0,0,0,0,0
"Uruguay","2024-01-08",0,0,0,0,0,0,0,0
"Uruguay","2024-01-09",0,0,0,0,0,0,0,0
"Uruguay","2024-01-10",0,0,0,0,0,0,0,0
"Uruguay","2024-01-11",0,0,0,0,0,0,0,0
"Uruguay","2024-01-12",0,0,0,0,0,0,0,0
"Uruguay","2024-01-13",0,0,0,0,0,0,0,0
"Uruguay","2024-01-14",0,0,0,0,0,0,0,0
"Uruguay","2024-01-15",0,0,0,0,0,0,0,0
"Uruguay","2024-01-16",0,0,0,0,0,0,0,0
"Uruguay","2024-01-17",0,0,0,0,0,0,0,0
"Uruguay","2024-01-18",0,0,0,0,0,0,0,0
"Uruguay","2024-01-19",0,0,0,0,0,0,0,0
"Uruguay","2024-01-20",0,0,0,0,0,0,0,0
"Uruguay","2024-01-21",0,0,0,0,0,0,0,0
"Uruguay","2024-01-22",0,0,0,0,0,0,0,0
"Uruguay","2024-01-23",0,0,0,0,0,0,0,0
"Uruguay","2024-01-24",0,0,0,0,0,0,0,0
"Uruguay","2024-01-25",0,0,0,0,0,0,0,0
"Uruguay","2024-01-26",0,0,0,0,0,0,0,0
"Uruguay","2024-01-27",0,0,0,0,0,0,0,0
"Uruguay","2024-01-28",0,0,0,0,0,0,0,0
"Uruguay","2024-01-29",0,0,0,0,0,0,0,0
"Uruguay","2024-01-30",0,0,0,0,0,0,0,0
"Uruguay","2024-01-31",0,0,0,0,0,0,0,0
"Uruguay","2024-02-01",0,0,0,0,0,0,0,0
"Uruguay","2024-02-02",0,0,0,0,0,0,0,0
"Uruguay","2024-02-03",0,0,0,0,0,0,0,0
"Uruguay","2024-02-04",0,0,0,0,0,0,0,0
"Uruguay","2024-02-05",0,0,0,0,0,0,0,0
"Uruguay","2024-02-06",0,0,0,0,0,0,0,0
"Uruguay","2024-02-07",0,0,0,0,0,0,0,0
"Uruguay","2024-02-08",0,0,0,0,0,0,0,0
"Uruguay","2024-02-09",0,0,0,0,0,0,0,0
"Uruguay","2024-02-10",0,0,0,0,0,0,0,0
"Uruguay","2024-02-11",0,0,0,0,0,0,0,0
"Uruguay","2024-02-12",0,0,0,0,0,0,0,0
"Uruguay","2024-02-13",0,0,0,0,0,0,0,0
"Uruguay","2024-02-14",0,0,0,0,0,0,0,0
"Uruguay","2024-02-15",0,0,0,0,0,0,0,0
"Uruguay","2024-02-16",0,0,0,0,0,0,0,0
"Uruguay","2024-02-17",0,0,0,0,0,0,0,0
"Uruguay","2024-02-18",0,0,0,0,0,0,0,0
"Uruguay","2024-02-19",0,0,0,0,0,0,0,0
"Uruguay","2024-02-20",0,0,0,0,0,0,0,0
"Uruguay","2024-02-21",0,0,0,0,0,0,0,0
"Uruguay","2024-02-22",0,0,0,0,0,0,0,0
"Uruguay","2024-02-23",0,0,0,0,0,0,0,0
"Uruguay","2024-02-24",0,0,0,0,0,0,0,0
"Uruguay","2024-02-25",0,0,0,0,0,0,0,0
"Uruguay","2024-02-26",0,0,0,0,0,0,0,0
"Uruguay","2024-02-27",0,0,0,0,0,0,0,0
"Uruguay","2024-02-28",0,0,0,0,0,0,0,0
"Uruguay","2024-02-29",0,0,0,0,0,0,0,0
"Uruguay","2024-03-01",0,0,0,0,0,0,0,0
"Uruguay","2024-03-02",0,0,0,0,0,0,0,0
"Uruguay","2024-03-03",0,0,0,0,0,0,0,0
"Uruguay","2024-03-04",0,0,0,0,0,0,0,0
"Uruguay","2024-03-05",0,0,0,0,0,0,0,0
"Uruguay","2024-03-06",0,0,0,0,0,0,0,0
"Uruguay","2024-03-07",0,0,0,0,0,0,0,0
"Uruguay","2024-03-08",0,0,0,0,0,0,0,0
"Uruguay","2024-03-09",0,0,0,0,0,0,0,0
"Uruguay","2024-03-10",0,0,0,0,0,0,0,0
"Uruguay","2024-03-11",0,0,0,0,0,0,0,0
"Uruguay","2024-03-12",0,0,0,0,0,0,0,0
"Uruguay","2024-03-13",0,0,0,0,0,0,0,0
"Uruguay","2024-03-14",0,0,0,0,0,0,0,0
"Uruguay","2024-03-15",0,0,0,0,0,0,0,0
"Uruguay","2024-03-16",0,0,0,0,0,0,0,0
"Uruguay","2024-03-17",0,0,0,0,0,0,0,0
"Uruguay","2024-03-18",0,0,0,0,0,0,0,0
"Uruguay","2024-03-19",0,0,0,0,0,0,0,0
"Uruguay","2024-03-20",0,0,0,0,0,0,0,0
"Uruguay","2024-03-21",0,0,0,0,0,0,0,0
"Uruguay","2024-03-22",0,0,0,0,0,0,0,0
"Uruguay","2024-03-23",0,0,0,0,0,0,0,0
"Uruguay","2024-03-24",0,0,0,0,0,0,0,0
"Uruguay","2024-03-25",0,0,0,0,0,0,0,0
"Uruguay","2024-03-26",0,0,0,0,0,0,0,0
"Uruguay","2024-03-27",0,0,0,0,0,0,0,0
"Uruguay","2024-03-28",0,0,0,0,0,0,0,0
"Uruguay","2024-03-29",0,0,0,0,0,0,0,0
"Uruguay","2024-03-30",0,0,0,0,0,0,0,0
"Uruguay","2024-03-31",0,0,0,0,0,0,0,0
"Uruguay","2024-04-01",0,0,0,0,0,0,0,0
"Uruguay","2024-04-02",0,0,0,0,0,0,0,0
"Uruguay","2024-04-03",0,0,0,0,0,0,0,0
"Uruguay","2024-04-04",0,0,0,0,0,0,0,0
"Uruguay","2024-04-05",0,0,0,0,0,0,0,0
"Uruguay","2024-04-06",0,0,0,0,0,0,0,0
"Uruguay","2024-04-07",0,0,0,0,0,0,0,0
"Uruguay","2024-04-08",0,0,0,0,0,0,0,0
"Uruguay","2024-04-09",0,0,0,0,0,0,0,0
"Uruguay","2024-04-10",0,0,0,0,0,0,0,0
"Uruguay","2024-04-11",0,0,0,0,0,0,0,0
"Uruguay","2024-04-12",0,0,0,0,0,0,0,0
"Uruguay","2024-04-13",0,0,0,0,0,0,0,0
"Uruguay","2024-04-14",0,0,0,0,0,0,0,0
"Uruguay","2024-04-15",0,0,0,0,0,0,0,0
"Uruguay","2024-04-16",0,0,0,0,0,0,0,0
"Uruguay","2024-04-17",0,0,0,0,0,0,0,0
"Uruguay","2024-04-18",0,0,0,0,0,0,0,0
"Uruguay","2024-04-19",0,0,0,0,0,0,0,0
"Uruguay","2024-04-20",0,0,0,0,0,0,0,0
"Uruguay","2024-04-21",0,0,0,0,0,0,0,0
"Uruguay","2024-04-22",0,0,0,0,0,0,0,0
"Uruguay","2024-04-23",0,0,0,0,0,0,0,0
"Uruguay","2024-04-24",0,0,0,0,0,0,0,0
"Uruguay","2024-04-25",0,0,0,0,0,0,0,0
"Uruguay","2024-04-26",0,0,0,0,0,0,0,0
"Uruguay","2024-04-27",0,0,0,0,0,0,0,0
"Uruguay","2024-04-28",0,0,0,0,0,0,0,0
"Uruguay","2024-04-29",0,0,0,0,0,0,0,0
"Uruguay","2024-04-30",0,0,0,0,0,0,0,0
"Uruguay","2024-05-01",0,0,0,0,0,0,0,0
"Uruguay","2024-05-02",0,0,0,0,0,0,0,0
"Uruguay","2024-05-03",0,0,0,0,0,0,0,0
"Uruguay","2024-05-04",0,0,0,0,0,0,0,0
"Uruguay","2024-05-05",0,0,0,0,0,0,0,0
"Uruguay","2024-05-06",0,0,0,0,0,0,0,0
"Uruguay","2024-05-07",0,0,0,0,0,0,0,0
"Uruguay","2024-05-08",0,0,0,0,0,0,0,0
"Uruguay","2024-05-09",0,0,0,0,0,0,0,0
"Uruguay","2024-05-10",0,0,0,0,0,0,0,0
"Uruguay","2024-05-11",0,0,0,0,0,0,0,0
"Uruguay","2024-05-12",0,0,0,0,0,0,0,0
"Uruguay","2024-05-13",0,0,0,0,0,0,0,0
"Uruguay","2024-05-14",0,0,0,0,0,0,0,0
"Uruguay","2024-05-15",0,0,0,0,0,0,0,0
"Uruguay","2024-05-16",0,0,0,0,0,0,0,0
"Uruguay","2024-05-17",0,0,0,0,0,0,0,0
"Uruguay","2024-05-18",0,0,0,0,0,0,0,0
"Uruguay","2024-05-19",0,0,0,0,0,0,0,0
"Uruguay","2024-05-20",0,0,0,0,0,0,0,0
"Uruguay","2024-05-21",0,0,0,0,0,0,0,0
"Uruguay","2024-05-22",0,0,0,0,0,0,0,0
"Uruguay","2024-05-23",0,0,0,0,0,0,0,0
"Uruguay","2024-05-24",0,0,0,0,0,0,0,0
"Uruguay","2024-05-25",0,0,0,0,0,0,0,0
"Uruguay","2024-05-26",0,0,0,0,0,0,0,0
"Uruguay","2024-05-27",0,0,0,0,0,0,0,0
"Uruguay","2024-05-28",0,0,0,0,0,0,0,0
"Uruguay","2024-05-29",0,0,0,0,0,0,0,0
"Uruguay","2024-05-30",0,0,0,0,0,0,0,0
"Uruguay","2024-05-31",0,0,0,0,0,0,0,0
"Uruguay","2024-06-01",0,0,0,0,0,0,0,0
"Uruguay","2024-06-02",0,0,0,0,0,0,0,0
"Uruguay","2024-06-03",0,0,0,0,0,0,0,0
"Uruguay","2024-06-04",0,0,0,0,0,0,0,0
"Uruguay","2024-06-05",0,0,0,0,0,0,0,0
"Uruguay","2024-06-06",0,0,0,0,0,0,0,0
"Uruguay","2024-06-07",0,0,0,0,0,0,0,0
"Uruguay","2024-06-08",0,0,0,0,0,0,0,0
"Uruguay","2024-06-09",0,0,0,0,0,0,0,0
"Uruguay","2024-06-10",0,0,0,0,0,0,0,0
"Uruguay","2024-06-11",0,0,0,0,0,0,0,0
"Uruguay","2024-06-12",0,0,0,0,0,0,0,0
"Uruguay","2024-06-13",0,0,0,0,0,0,0,0
"Uruguay","2024-06-14",0,0,0,0,0,0,0,0
"Uruguay","2024-06-15",0,0,0,0,0,0,0,0
"Uruguay","2024-06-16",0,0,0,0,0,0,0,0
"Uruguay","2024-06-17",0,0,0,0,0,0,0,0
"Uruguay","2024-06-18",0,0,0,0,0,0,0,0
"Uruguay","2024-06-19",0,0,0,0,0,0,0,0
"Uruguay","2024-06-20",0,0,0,0,0,0,0,0
"Uruguay","2024-06-21",0,0,0,0,0,0,0,0
"Uruguay","2024-06-22",0,0,0,0,0,0,0,0
"Uruguay","2024-06-23",0,0,0,0,0,0,0,0
"Uruguay","2024-06-24",0,0,0,0,0,0,0,0
"Uruguay","2024-06-25",0,0,0,0,0,0,0,0
"Uruguay","2024-06-26",0,0,0,0,0,0,0,0
"Uruguay","2024-06-27",0,0,0,0,0,0,0,0
"Uruguay","2024-06-28",0,0,0,0,0,0,0,0
"Uruguay","2024-06-29",0,0,0,0,0,0,0,0
"Uruguay","2024-06-30",0,0,0,0,0,0,0,0
"Uruguay","2024-07-01",0,0,0,0,0,0,0,0
"Uruguay","2024-07-02",0,0,0,0,0,0,0,0
"Uruguay","2024-07-03",0,0,0,0,0,0,0,0
"Uruguay","2024-07-04",0,0,0,0,0,0,0,0
"Uruguay","2024-07-05",0,0,0,0,0,0,0,0
"Uruguay","2024-07-06",0,0,0,0,0,0,0,0
"Uruguay","2024-07-07",0,0,0,0,0,0,0,0
"Uruguay","2024-07-08",0,0,0,0,0,0,0,0
"Uruguay","2024-07-09",0,0,0,0,0,0,0,0
"Uruguay","2024-07-10",0,0,0,0,0,0,0,0
"Uruguay","2024-07-11",0,0,0,0,0,0,0,0
"Uruguay","2024-07-12",0,0,0,0,0,0,0,0
"Uruguay","2024-07-13",0,0,0,0,0,0,0,0
"Uruguay","2024-07-14",0,0,0,0,0,0,0,0
"Uruguay","2024-07-15",0,0,0,0,0,0,0,0
"Uruguay","2024-07-16",0,0,0,0,0,0,0,0
"Uruguay","2024-07-17",0,0,0,0,0,0,0,0
"Uruguay","2024-07-18",0,0,0,0,0,0,0,0
"Uruguay","2024-07-19",0,0,0,0,0,0,0,0
"Uruguay","2024-07-20",0,0,0,0,0,0,0,0
"Uruguay","2024-07-21",0,0,0,0,0,0,0,0
"Uruguay","2024-07-22",0,0,0,0,0,0,0,0
"Uruguay","2024-07-23",0,0,0,0,0,0,0,0
"Uruguay","2024-07-24",0,0,0,0,0,0,0,0
"Uruguay","2024-07-25",0,0,0,0,0,0,0,0
"Uruguay","2024-07-26",0,0,0,0,0,0,0,0
"Uruguay","2024-07-27",0,0,0,0,0,0,0,0
"Uruguay","2024-07-28",0,0,0,0,0,0,0,0
"Uruguay","2024-07-29",0,0,0,0,0,0,0,0
"Uruguay","2024-07-30",0,0,0,0,0,0,0,0
"Uruguay","2024-07-31",0,0,0,0,0,0,0,0
"Uruguay","2024-08-01",0,0,0,0,0,0,0,0
"Uruguay","2024-08-02",0,0,0,0,0,0,0,0
"Uruguay","2024-08-03",0,0,0,0,0,0,0,0
"Uruguay","2024-08-04",0,0,0,0,0,0,0,0
"Uruguay","2024-08-05",0,0,0,0,0,0,0,0
"Uruguay","2024-08-06",0,0,0,0,0,0,0,0
"Uruguay","2024-08-07",0,0,0,0,0,0,0,0
"Uruguay","2024-08-08",0,0,0,0,0,0,0,0
"Uruguay","2024-08-09",0,0,0,0,0,0,0,0
"Uruguay","2024-08-10",0,0,0,0,0,0,0,0
"Uruguay","2024-08-11",0,0,0,0,0,0,0,0
"Uruguay","2024-08-12",0,0,0,0,0,0,0,0
"Uruguay","2024-08-13",0,0,0,0,0,0,0,0
"Uruguay","2024-08-14",0,0,0,0,0,0,0,0
"Uruguay","2024-08-15",0,0,0,0,0,0,0,0
"Uruguay","2024-08-16",0,0,0,0,0,0,0,0
"Uruguay","2024-08-17",0,0,0,0,0,0,0,0
"Uruguay","2024-08-18",0,0,0,0,0,0,0,0
"Uruguay","2024-08-19",0,0,0,0,0,0,0,0
"Uruguay","2024-08-20",0,0,0,0,0,0,0,0
"Uruguay","2024-08-21",0,0,0,0,0,0,0,0
"Uruguay","2024-08-22",0,0,0,0,0,0,0,0
"Uruguay","2024-08-23",0,0,0,0,0,0,0,0
"Uruguay","2024-08-24",0,0,0,0,0,0,0,0
"Uruguay","2024-08-25",0,0,0,0,0,0,0,0
"Uruguay","2024-08-26",0,0,0,0,0,0,0,0
"Uruguay","2024-08-27",0,0,0,0,0,0,0,0
"Uruguay","2024-08-28",0,0,0,0,0,0,0,0
"Uruguay","2024-08-29",0,0,0,0,0,0,0,0
"Uruguay","2024-08-30",0,0,0,0,0,0,0,0
"Uruguay","2024-08-31",0,0,0,0,0,0,0,0
"Uruguay","2024-09-01",0,0,0,0,0,0,0,0
"Uruguay","2024-09-02",0,0,0,0,0,0,0,0
"Uruguay","2024-09-03",0,0,0,0,0,0,0,0
"Uruguay","2024-09-04",0,0,0,0,0,0,0,0
"Uruguay","2024-09-05",0,0,0,0,0,0,0,0
"Uruguay","2024-09-06",0,0,0,0,0,0,0,0
"Uruguay","2024-09-07",0,0,0,0,0,0,0,0
"Uruguay","2024-09-08",0,0,0,0,0,0,0,0
"Uruguay","2024-09-09",0,0,0,0,0,0,0,0
"Uruguay","2024-09-10",0,0,0,0,0,0,0,0
"Uruguay","2024-09-11",0,0,0,0,0,0,0,0
"Uruguay","2024-09-12",0,0,0,0,0,0,0,0
"Uruguay","2024-09-13",0,0,0,0,0,0,0,0
"Uruguay","2024-09-14",0,0,0,0,0,0,0,0
"Uruguay","2024-09-15",0,0,0,0,0,0,0,0
"Uruguay","2024-09-16",0,0,0,0,0,0,0,0
"Uruguay","2024-09-17",0,0,0,0,0,0,0,0
"Uruguay","2024-09-18",0,0,0,0,0,0,0,0
"Uruguay","2024-09-19",0,0,0,0,0,0,0,0
"Uruguay","2024-09-20",0,0,0,0,0,0,0,0
"Uruguay","2024-09-21",0,0,0,0,0,0,0,0
"Uruguay","2024-09-22",0,0,0,0,0,0,0,0
"Uruguay","2024-09-23",0,0,0,0,0,0,0,0
"Uruguay","2024-09-24",0,1,1,0,1,1,0,0
"Uruguay","2024-09-25",0,0,1,0,0,1,0,0
"Uruguay","2024-09-26",0,0,1,0,0,1,0,0
"Uruguay","2024-09-27",0,0,1,0,0,1,0,0
"Uruguay","2024-09-28",0,0,1,0,0,1,0,0
"Uruguay","2024-09-29",0,0,1,0,0,1,0,0
"Uruguay","2024-09-30",0,0,1,0,0,1,0,0
"Uruguay","2024-10-01",0,0,1,0,0,1,0,0
"Uruguay","2024-10-02",0,0,1,0,0,1,0,0
"Uruguay","2024-10-03",0,0,1,0,0,1,0,0
"Uruguay","2024-10-04",0,0,1,0,0,1,0,0
"Uruguay","2024-10-05",0,0,1,0,0,1,0,0
"Uruguay","2024-10-06",0,0,1,0,0,1,0,0
"Uruguay","2024-10-07",0,0,1,0,0,1,0,0
"Uruguay","2024-10-08",0,0,1,0,0,1,0,0
"Uruguay","2024-10-09",0,0,1,0,0,1,0,0
"Uruguay","2024-10-10",0,0,1,0,0,1,0,0
"Uruguay","2024-10-11",0,0,1,0,0,1,0,0
"Uruguay","2024-10-12",0,0,1,0,0,1,0,0
"Uruguay","2024-10-13",0,0,1,0,0,1,0,0
"Uruguay","2024-10-14",0,0,1,0,0,1,0,0
"Uruguay","2024-10-15",0,0,1,0,0,1,0,0
"Uruguay","2024-10-16",0,0,1,0,0,1,0,0
"Uruguay","2024-10-17",0,0,1,0,0,1,0,0
"Uruguay","2024-10-18",0,0,1,0,0,1,0,0
"Uruguay","2024-10-19",0,0,1,0,0,1,0,0
"Uruguay","2024-10-20",0,0,1,0,0,1,0,0
"Uruguay","2024-10-21",0,0,1,0,0,1,0,0
"Uruguay","2024-10-22",0,0,1,0,0,1,0,0
"Uruguay","2024-10-23",0,0,1,0,0,1,0,0
"Uruguay","2024-10-24",0,0,1,0,0,1,0,0
"Uruguay","2024-10-25",0,0,1,0,0,1,0,0
"Uruguay","2024-10-26",0,0,1,0,0,1,0,0
"Uruguay","2024-10-27",0,0,1,0,0,1,0,0
"Uruguay","2024-10-28",0,0,1,0,0,1,0,0
"Uruguay","2024-10-29",0,0,1,0,0,1,0,0
"Uruguay","2024-10-30",0,0,1,0,0,1,0,0
"Uruguay","2024-10-31",0,0,1,0,0,1,0,0
"Uruguay","2024-11-01",0,0,1,0,0,1,0,0
"Uruguay","2024-11-02",0,0,1,0,0,1,0,0
"Uruguay","2024-11-03",0,0,1,0,0,1,0,0
"Uruguay","2024-11-04",0,0,1,0,0,1,0,0
"Uruguay","2024-11-05",0,0,1,0,0,1,0,0
"Uruguay","2024-11-06",0,0,1,0,0,1,0,0
"Uruguay","2024-11-07",0,0,1,0,0,1,0,0
"Uruguay","2024-11-08",0,0,1,0,0,1,0,0
"Uruguay","2024-11-09",0,0,1,0,0,1,0,0
"Uruguay","2024-11-10",0,0,1,0,0,1,0,0
"Uruguay","2024-11-11",0,0,1,0,0,1,0,0
"Uruguay","2024-11-12",0,0,1,0,0,1,0,0
"Uruguay","2024-11-13",0,0,1,0,0,1,0,0
"Uruguay","2024-11-14",0,0,1,0,0,1,0,0
"Uruguay","2024-11-15",0,0,1,0,0,1,0,0
"Uruguay","2024-11-16",0,0,1,0,0,1,0,0
"Uruguay","2024-11-17",0,0,1,0,0,1,0,0
"Uruguay","2024-11-18",0,0,1,0,0,1,0,0
"Uruguay","2024-11-19",0,0,1,0,0,1,0,0
"Uruguay","2024-11-20",0,0,1,0,0,1,0,0
"Uruguay","2024-11-21",0,0,1,0,0,1,0,0
"Uruguay","2024-11-22",0,0,1,0,0,1,0,0
"Uruguay","2024-11-23",0,0,1,0,0,1,0,0
"Uruguay","2024-11-24",0,0,1,0,0,1,0,0
"Uruguay","2024-11-25",0,0,1,0,0,1,0,0
"Uruguay","2024-11-26",0,0,1,0,0,1,0,0
"Uruguay","2024-11-27",0,0,1,0,0,1,0,0
"Uruguay","2024-11-28",0,0,1,0,0,1,0,0
"Uruguay","2024-11-29",0,0,1,0,0,1,0,0
"Uruguay","2024-11-30",0,0,1,0,0,1,0,0
"Uruguay","2024-12-01",0,0,1,0,0,1,0,0
"Uruguay","2024-12-02",0,0,1,0,0,1,0,0
"Uruguay","2024-12-03",0,0,1,0,0,1,0,0
"Uruguay","2024-12-04",0,0,1,0,0,1,0,0
"Uruguay","2024-12-05",0,0,1,0,0,1,0,0
"Uruguay","2024-12-06",0,0,1,0,0,1,0,0
"Uruguay","2024-12-07",0,0,1,0,0,1,0,0
"Uruguay","2024-12-08",0,0,1,0,0,1,0,0
"Uruguay","2024-12-09",0,0,1,0,0,1,0,0
"Uruguay","2024-12-10",0,0,1,0,0,1,0,0
"Uruguay","2024-12-11",0,0,1,0,0,1,0,0
"Uruguay","2024-12-12",0,0,1,0,0,1,0,0
"Uruguay","2024-12-13",0,0,1,0,0,1,0,0
"Uruguay","2024-12-14",0,0,1,0,0,1,0,0
"Uruguay","2024-12-15",0,0,1,0,0,1,0,0
"Uruguay","2024-12-16",0,0,1,0,0,1,0,0
"Uruguay","2024-12-17",0,0,1,0,0,1,0,0
"Uruguay","2024-12-18",0,0,1,0,0,1,0,0
"Uruguay","2024-12-19",0,0,1,0,0,1,0,0
"Uruguay","2024-12-20",0,0,1,0,0,1,0,0
"Uruguay","2024-12-21",0,0,1,0,0,1,0,0
"Uruguay","2024-12-22",0,0,1,0,0,1,0,0
"Uruguay","2024-12-23",0,0,1,0,0,1,0,0
"Uruguay","2024-12-24",0,0,1,0,0,1,0,0
"Uruguay","2024-12-25",0,0,1,0,0,1,0,0
"Uruguay","2024-12-26",0,0,1,0,0,1,0,0
"Uruguay","2024-12-27",0,0,1,0,0,1,0,0
"Uruguay","2024-12-28",0,0,1,0,0,1,0,0
"Uruguay","2024-12-29",0,0,1,0,0,1,0,0
"Uruguay","2024-12-30",0,0,1,0,0,1,0,0
"Uruguay","2024-12-31",0,0,1,0,0,1,0,0
"Uruguay","2025-01-01",0,0,1,0,0,1,0,0
"Uruguay","2025-01-02",0,0,1,0,0,1,0,0
"Uruguay","2025-01-03",0,0,1,0,0,1,0,0
"Uruguay","2025-01-04",0,0,1,0,0,1,0,0
"Uruguay","2025-01-05",0,0,1,0,0,1,0,0
"Uruguay","2025-01-06",0,0,1,0,0,1,0,0
"Uruguay","2025-01-07",0,0,1,0,0,1,0,0
"Uruguay","2025-01-08",0,0,1,0,0,1,0,0
"Uruguay","2025-01-09",0,0,1,0,0,1,0,0
"Uruguay","2025-01-10",0,0,1,0,0,1,0,0
"Uruguay","2025-01-11",0,0,1,0,0,1,0,0
"Uruguay","2025-01-12",0,0,1,0,0,1,0,0
"Uruguay","2025-01-13",0,0,1,0,0,1,0,0
"Uruguay","2025-01-14",0,0,1,0,0,1,0,0
"Uruguay","2025-01-15",0,0,1,0,0,1,0,0
"Uruguay","2025-01-16",0,0,1,0,0,1,0,0
"Uruguay","2025-01-17",0,0,1,0,0,1,0,0
"Uruguay","2025-01-18",0,0,1,0,0,1,0,0
"Uruguay","2025-01-19",0,0,1,0,0,1,0,0
"Uruguay","2025-01-20",0,0,1,0,0,1,0,0
"Uruguay","2025-01-21",0,0,1,0,0,1,0,0
"Uruguay","2025-01-22",0,0,1,0,0,1,0,0
"Uruguay","2025-01-23",0,0,1,0,0,1,0,0
"Uruguay","2025-01-24",0,0,1,0,0,1,0,0
"Uruguay","2025-01-25",0,0,1,0,0,1,0,0
"Uruguay","2025-01-26",0,0,1,0,0,1,0,0
"Uruguay","2025-01-27",0,0,1,0,0,1,0,0
"Uruguay","2025-01-28",0,0,1,0,0,1,0,0
"Uruguay","2025-01-29",0,0,1,0,0,1,0,0
"Uruguay","2025-01-30",0,0,1,0,0,1,0,0
"Uruguay","2025-01-31",0,0,1,0,0,1,0,0
"Uruguay","2025-02-01",0,0,1,0,0,1,0,0
"Uruguay","2025-02-02",0,0,1,0,0,1,0,0
"Uruguay","2025-02-03",0,0,1,0,0,1,0,0
"Uruguay","2025-02-04",0,0,1,0,0,1,0,0
"Uruguay","2025-02-05",0,0,1,0,0,1,0,0
"Uruguay","2025-02-06",0,0,1,0,0,1,0,0
"Uruguay","2025-02-07",0,0,1,0,0,1,0,0
"Uruguay","2025-02-08",0,0,1,0,0,1,0,0
"Uruguay","2025-02-09",0,0,1,0,0,1,0,0
"Uruguay","2025-02-10",0,0,1,0,0,1,0,0
"Uruguay","2025-02-11",0,0,1,0,0,1,0,0
"Uruguay","2025-02-12",0,0,1,0,0,1,0,0
"Uruguay","2025-02-13",0,0,1,0,0,1,0,0
"Uruguay","2025-02-14",0,0,1,0,0,1,0,0
"Uruguay","2025-02-15",0,0,1,0,0,1,0,0
"Uruguay","2025-02-16",0,0,1,0,0,1,0,0
"Uruguay","2025-02-17",0,0,1,0,0,1,0,0
"Uruguay","2025-02-18",0,0,1,0,0,1,0,0
"Uruguay","2025-02-19",0,0,1,0,0,1,0,0
"Uruguay","2025-02-20",0,0,1,0,0,1,0,0
"Uruguay","2025-02-21",0,0,1,0,0,1,0,0
"Uruguay","2025-02-22",0,0,1,0,0,1,0,0
"Uruguay","2025-02-23",0,0,1,0,0,1,0,0
"Uruguay","2025-02-24",0,0,1,0,0,1,0,0
"Uruguay","2025-02-25",0,0,1,0,0,1,0,0
"Uruguay","2025-02-26",0,0,1,0,0,1,0,0
"Uruguay","2025-02-27",0,0,1,0,0,1,0,0
"Uruguay","2025-02-28",0,0,1,0,0,1,0,0
"Uruguay","2025-03-01",0,0,1,0,0,1,0,0
"Uruguay","2025-03-02",0,0,1,0,0,1,0,0
"Uruguay","2025-03-03",0,0,1,0,0,1,0,0
"Venezuela (Bolivarian Republic of)","2024-01-01",0,0,0,0,0,0,0,0
"Venezuela (Bolivarian Republic of)","2024-01-02",0,0,0,0,0,0,0,0
"Venezuela (Bolivarian Republic of)","2024-01-03",0,0,0,0,0,0,0,0
"Venezuela (Bolivarian Republic of)","2024-01-04",0,0,0,0,0,0,0,0
"Venezuela (Bolivarian Republic of)","2024-01-05",0,0,0,0,0,0,0,0
"Venezuela (Bolivarian Republic of)","2024-01-06",0,0,0,0,0,0,0,0
"Venezuela (Bolivarian Republic of)","2024-01-07",0,0,0,0,0,0,0,0
"Venezuela (Bolivarian Republic of)","2024-01-08",0,0,0,0,0,0,0,0
"Venezuela (Bolivarian Republic of)","2024-01-09",0,0,0,0,0,0,0,0
"Venezuela (Bolivarian Republic of)","2024-01-10",0,0,0,0,0,0,0,0
"Venezuela (Bolivarian Republic of)","2024-01-11",0,0,0,0,0,0,0,0
"Venezuela (Bolivarian Republic of)","2024-01-12",0,0,0,0,0,0,0,0
"Venezuela (Bolivarian Republic of)","2024-01-13",0,0,0,0,0,0,0,0
"Venezuela (Bolivarian Republic of)","2024-01-14",0,0,0,0,0,0,0,0
"Venezuela (Bolivarian Republic of)","2024-01-15",0,0,0,0,0,0,0,0
"Venezuela (Bolivarian Republic of)","2024-01-16",0,0,0,0,0,0,0,0
"Venezuela (Bolivarian Republic of)","2024-01-17",0,0,0,0,0,0,0,0
"Venezuela (Bolivarian Republic of)","2024-01-18",0,0,0,0,0,0,0,0
"Venezuela (Bolivarian Republic of)","2024-01-19",0,0,0,0,0,0,0,0
"Venezuela (Bolivarian Republic of)","2024-01-20",0,0,0,0,0,0,0,0
"Venezuela (Bolivarian Republic of)","2024-01-21",0,0,0,0,0,0,0,0
"Venezuela (Bolivarian Republic of)","2024-01-22",0,0,0,0,0,0,0,0
"Venezuela (Bolivarian Republic of)","2024-01-23",0,0,0,0,0,0,0,0
"Venezuela (Bolivarian Republic of)","2024-01-24",0,0,0,0,0,0,0,0
"Venezuela (Bolivarian Republic of)","2024-01-25",0,0,0,0,0,0,0,0
"Venezuela (Bolivarian Republic of)","2024-01-26",0,0,0,0,0,0,0,0
"Venezuela (Bolivarian Republic of)","2024-01-27",0,0,0,0,0,0,0,0
"Venezuela (Bolivarian Republic of)","2024-01-28",0,0,0,0,0,0,0,0
"Venezuela (Bolivarian Republic of)","2024-01-29",0,0,0,0,0,0,0,0
"Venezuela (Bolivarian Republic of)","2024-01-30",0,0,0,0,0,0,0,0
"Venezuela (Bolivarian Republic of)","2024-01-31",0,0,0,0,0,0,0,0
"Venezuela (Bolivarian Republic of)","2024-02-01",0,0,0,0,0,0,0,0
"Venezuela (Bolivarian Republic of)","2024-02-02",0,0,0,0,0,0,0,0
"Venezuela (Bolivarian Republic of)","2024-02-03",0,0,0,0,0,0,0,0
"Venezuela (Bolivarian Republic of)","2024-02-04",0,0,0,0,0,0,0,0
"Venezuela (Bolivarian Republic of)","2024-02-05",0,0,0,0,0,0,0,0
"Venezuela (Bolivarian Republic of)","2024-02-06",0,0,0,0,0,0,0,0
"Venezuela (Bolivarian Republic of)","2024-02-07",0,0,0,0,0,0,0,0
"Venezuela (Bolivarian Republic of)","2024-02-08",0,0,0,0,0,0,0,0
"Venezuela (Bolivarian Republic of)","2024-02-09",0,0,0,0,0,0,0,0
"Venezuela (Bolivarian Republic of)","2024-02-10",0,0,0,0,0,0,0,0
"Venezuela (Bolivarian Republic of)","2024-02-11",0,0,0,0,0,0,0,0
"Venezuela (Bolivarian Republic of)","2024-02-12",0,0,0,0,0,0,0,0
"Venezuela (Bolivarian Republic of)","2024-02-13",0,0,0,0,0,0,0,0
"Venezuela (Bolivarian Republic of)","2024-02-14",0,0,0,0,0,0,0,0
"Venezuela (Bolivarian Republic of)","2024-02-15",0,0,0,0,0,0,0,0
"Venezuela (Bolivarian Republic of)","2024-02-16",0,0,0,0,0,0,0,0
"Venezuela (Bolivarian Republic of)","2024-02-17",0,0,0,0,0,0,0,0
"Venezuela (Bolivarian Republic of)","2024-02-18",0,0,0,0,0,0,0,0
"Venezuela (Bolivarian Republic of)","2024-02-19",0,0,0,0,0,0,0,0
"Venezuela (Bolivarian Republic of)","2024-02-20",0,0,0,0,0,0,0,0
"Venezuela (Bolivarian Republic of)","2024-02-21",0,0,0,0,0,0,0,0
"Venezuela (Bolivarian Republic of)","2024-02-22",0,0,0,0,0,0,0,0
"Venezuela (Bolivarian Republic of)","2024-02-23",0,0,0,0,0,0,0,0
"Venezuela (Bolivarian Republic of)","2024-02-24",0,0,0,0,0,0,0,0
"Venezuela (Bolivarian Republic of)","2024-02-25",0,0,0,0,0,0,0,0
"Venezuela (Bolivarian Republic of)","2024-02-26",0,0,0,0,0,0,0,0
"Venezuela (Bolivarian Republic of)","2024-02-27",0,0,0,0,0,0,0,0
"Venezuela (Bolivarian Republic of)","2024-02-28",0,0,0,0,0,0,0,0
"Venezuela (Bolivarian Republic of)","2024-02-29",0,0,0,0,0,0,0,0
"Venezuela (Bolivarian Republic of)","2024-03-01",0,0,0,0,0,0,0,0
"Venezuela (Bolivarian Republic of)","2024-03-02",0,0,0,0,0,0,0,0
"Venezuela (Bolivarian Republic of)","2024-03-03",0,0,0,0,0,0,0,0
"Venezuela (Bolivarian Republic of)","2024-03-04",0,0,0,0,0,0,0,0
"Venezuela (Bolivarian Republic of)","2024-03-05",0,0,0,0,0,0,0,0
"Venezuela (Bolivarian Republic of)","2024-03-06",0,0,0,0,0,0,0,0
"Venezuela (Bolivarian Republic of)","2024-03-07",0,0,0,0,0,0,0,0
"Venezuela (Bolivarian Republic of)","2024-03-08",0,0,0,0,0,0,0,0
"Venezuela (Bolivarian Republic of)","2024-03-09",0,0,0,0,0,0,0,0
"Venezuela (Bolivarian Republic of)","2024-03-10",0,0,0,0,0,0,0,0
"Venezuela (Bolivarian Republic of)","2024-03-11",0,0,0,0,0,0,0,0
"Venezuela (Bolivarian Republic of)","2024-03-12",0,0,0,0,0,0,0,0
"Venezuela (Bolivarian Republic of)","2024-03-13",0,0,0,0,0,0,0,0
"Venezuela (Bolivarian Republic of)","2024-03-14",0,0,0,0,0,0,0,0
"Venezuela (Bolivarian Republic of)","2024-03-15",0,0,0,0,0,0,0,0
"Venezuela (Bolivarian Republic of)","2024-03-16",0,0,0,0,0,0,0,0
"Venezuela (Bolivarian Republic of)","2024-03-17",0,0,0,0,0,0,0,0
"Venezuela (Bolivarian Republic of)","2024-03-18",0,0,0,0,0,0,0,0
"Venezuela (Bolivarian Republic of)","2024-03-19",0,0,0,0,0,0,0,0
"Venezuela (Bolivarian Republic of)","2024-03-20",0,0,0,0,0,0,0,0
"Venezuela (Bolivarian Republic of)","2024-03-21",0,0,0,0,0,0,0,0
"Venezuela (Bolivarian Republic of)","2024-03-22",0,0,0,0,0,0,0,0
"Venezuela (Bolivarian Republic of)","2024-03-23",0,0,0,0,0,0,0,0
"Venezuela (Bolivarian Republic of)","2024-03-24",0,0,0,0,0,0,0,0
"Venezuela (Bolivarian Republic of)","2024-03-25",0,0,0,0,0,0,0,0
"Venezuela (Bolivarian Republic of)","2024-03-26",0,0,0,0,0,0,0,0
"Venezuela (Bolivarian Republic of)","2024-03-27",0,0,0,0,0,0,0,0
"Venezuela (Bolivarian Republic of)","2024-03-28",0,0,0,0,0,0,0,0
"Venezuela (Bolivarian Republic of)","2024-03-29",0,0,0,0,0,0,0,0
"Venezuela (Bolivarian Republic of)","2024-03-30",0,0,0,0,0,0,0,0
"Venezuela (Bolivarian Republic of)","2024-03-31",0,0,0,0,0,0,0,0
"Venezuela (Bolivarian Republic of)","2024-04-01",0,0,0,0,0,0,0,0
"Venezuela (Bolivarian Republic of)","2024-04-02",0,0,0,0,0,0,0,0
"Venezuela (Bolivarian Republic of)","2024-04-03",0,0,0,0,0,0,0,0
"Venezuela (Bolivarian Republic of)","2024-04-04",0,0,0,0,0,0,0,0
"Venezuela (Bolivarian Republic of)","2024-04-05",0,0,0,0,0,0,0,0
"Venezuela (Bolivarian Republic of)","2024-04-06",0,0,0,0,0,0,0,0
"Venezuela (Bolivarian Republic of)","2024-04-07",0,0,0,0,0,0,0,0
"Venezuela (Bolivarian Republic of)","2024-04-08",0,0,0,0,0,0,0,0
"Venezuela (Bolivarian Republic of)","2024-04-09",0,0,0,0,0,0,0,0
"Venezuela (Bolivarian Republic of)","2024-04-10",0,0,0,0,0,0,0,0
"Venezuela (Bolivarian Republic of)","2024-04-11",0,0,0,0,0,0,0,0
"Venezuela (Bolivarian Republic of)","2024-04-12",0,0,0,0,0,0,0,0
"Venezuela (Bolivarian Republic of)","2024-04-13",0,0,0,0,0,0,0,0
"Venezuela (Bolivarian Republic of)","2024-04-14",0,0,0,0,0,0,0,0
"Venezuela (Bolivarian Republic of)","2024-04-15",0,0,0,0,0,0,0,0
"Venezuela (Bolivarian Republic of)","2024-04-16",0,0,0,0,0,0,0,0
"Venezuela (Bolivarian Republic of)","2024-04-17",0,0,0,0,0,0,0,0
"Venezuela (Bolivarian Republic of)","2024-04-18",0,0,0,0,0,0,0,0
"Venezuela (Bolivarian Republic of)","2024-04-19",0,0,0,0,0,0,0,0
"Venezuela (Bolivarian Republic of)","2024-04-20",0,0,0,0,0,0,0,0
"Venezuela (Bolivarian Republic of)","2024-04-21",0,0,0,0,0,0,0,0
"Venezuela (Bolivarian Republic of)","2024-04-22",0,0,0,0,0,0,0,0
"Venezuela (Bolivarian Republic of)","2024-04-23",0,0,0,0,0,0,0,0
"Venezuela (Bolivarian Republic of)","2024-04-24",0,0,0,0,0,0,0,0
"Venezuela (Bolivarian Republic of)","2024-04-25",0,0,0,0,0,0,0,0
"Venezuela (Bolivarian Republic of)","2024-04-26",0,0,0,0,0,0,0,0
"Venezuela (Bolivarian Republic of)","2024-04-27",0,0,0,0,0,0,0,0
"Venezuela (Bolivarian Republic of)","2024-04-28",0,0,0,0,0,0,0,0
"Venezuela (Bolivarian Republic of)","2024-04-29",0,0,0,0,0,0,0,0
"Venezuela (Bolivarian Republic of)","2024-04-30",0,0,0,0,0,0,0,0
"Venezuela (Bolivarian Republic of)","2024-05-01",0,0,0,0,0,0,0,0
"Venezuela (Bolivarian Republic of)","2024-05-02",0,0,0,0,0,0,0,0
"Venezuela (Bolivarian Republic of)","2024-05-03",0,0,0,0,0,0,0,0
"Venezuela (Bolivarian Republic of)","2024-05-04",0,0,0,0,0,0,0,0
"Venezuela (Bolivarian Republic of)","2024-05-05",0,0,0,0,0,0,0,0
"Venezuela (Bolivarian Republic of)","2024-05-06",0,0,0,0,0,0,0,0
"Venezuela (Bolivarian Republic of)","2024-05-07",0,0,0,0,0,0,0,0
"Venezuela (Bolivarian Republic of)","2024-05-08",0,0,0,0,0,0,0,0
"Venezuela (Bolivarian Republic of)","2024-05-09",0,0,0,0,0,0,0,0
"Venezuela (Bolivarian Republic of)","2024-05-10",0,0,0,0,0,0,0,0
"Venezuela (Bolivarian Republic of)","2024-05-11",0,0,0,0,0,0,0,0
"Venezuela (Bolivarian Republic of)","2024-05-12",0,0,0,0,0,0,0,0
"Venezuela (Bolivarian Republic of)","2024-05-13",0,0,0,0,0,0,0,0
"Venezuela (Bolivarian Republic of)","2024-05-14",0,0,0,0,0,0,0,0
"Venezuela (Bolivarian Republic of)","2024-05-15",0,0,0,0,0,0,0,0
"Venezuela (Bolivarian Republic of)","2024-05-16",0,0,0,0,0,0,0,0
"Venezuela (Bolivarian Republic of)","2024-05-17",0,0,0,0,0,0,0,0
"Venezuela (Bolivarian Republic of)","2024-05-18",0,0,0,0,0,0,0,0
"Venezuela (Bolivarian Republic of)","2024-05-19",0,0,0,0,0,0,0,0
"Venezuela (Bolivarian Republic of)","2024-05-20",0,0,0,0,0,0,0,0
"Venezuela (Bolivarian Republic of)","2024-05-21",0,0,0,0,0,0,0,0
"Venezuela (Bolivarian Republic of)","2024-05-22",0,0,0,0,0,0,0,0
"Venezuela (Bolivarian Republic of)","2024-05-23",0,0,0,0,0,0,0,0
"Venezuela (Bolivarian Republic of)","2024-05-24",0,0,0,0,0,0,0,0
"Venezuela (Bolivarian Republic of)","2024-05-25",0,0,0,0,0,0,0,0
"Venezuela (Bolivarian Republic of)","2024-05-26",0,0,0,0,0,0,0,0
"Venezuela (Bolivarian Republic of)","2024-05-27",0,0,0,0,0,0,0,0
"Venezuela (Bolivarian Republic of)","2024-05-28",0,0,0,0,0,0,0,0
"Venezuela (Bolivarian Republic of)","2024-05-29",0,0,0,0,0,0,0,0
"Venezuela (Bolivarian Republic of)","2024-05-30",0,0,0,0,0,0,0,0
"Venezuela (Bolivarian Republic of)","2024-05-31",0,0,0,0,0,0,0,0
"Venezuela (Bolivarian Republic of)","2024-06-01",0,0,0,0,0,0,0,0
"Venezuela (Bolivarian Republic of)","2024-06-02",0,0,0,0,0,0,0,0
"Venezuela (Bolivarian Republic of)","2024-06-03",0,0,0,0,0,0,0,0
"Venezuela (Bolivarian Republic of)","2024-06-04",0,0,0,0,0,0,0,0
"Venezuela (Bolivarian Republic of)","2024-06-05",0,0,0,0,0,0,0,0
"Venezuela (Bolivarian Republic of)","2024-06-06",0,0,0,0,0,0,0,0
"Venezuela (Bolivarian Republic of)","2024-06-07",0,0,0,0,0,0,0,0
"Venezuela (Bolivarian Republic of)","2024-06-08",0,0,0,0,0,0,0,0
"Venezuela (Bolivarian Republic of)","2024-06-09",0,0,0,0,0,0,0,0
"Venezuela (Bolivarian Republic of)","2024-06-10",0,0,0,0,0,0,0,0
"Venezuela (Bolivarian Republic of)","2024-06-11",0,0,0,0,0,0,0,0
"Venezuela (Bolivarian Republic of)","2024-06-12",0,0,0,0,0,0,0,0
"Venezuela (Bolivarian Republic of)","2024-06-13",0,0,0,0,0,0,0,0
"Venezuela (Bolivarian Republic of)","2024-06-14",0,0,0,0,0,0,0,0
"Venezuela (Bolivarian Republic of)","2024-06-15",0,0,0,0,0,0,0,0
"Venezuela (Bolivarian Republic of)","2024-06-16",0,0,0,0,0,0,0,0
"Venezuela (Bolivarian Republic of)","2024-06-17",0,0,0,0,0,0,0,0
"Venezuela (Bolivarian Republic of)","2024-06-18",0,0,0,0,0,0,0,0
"Venezuela (Bolivarian Republic of)","2024-06-19",0,0,0,0,0,0,0,0
"Venezuela (Bolivarian Republic of)","2024-06-20",0,0,0,0,0,0,0,0
"Venezuela (Bolivarian Republic of)","2024-06-21",0,0,0,0,0,0,0,0
"Venezuela (Bolivarian Republic of)","2024-06-22",0,0,0,0,0,0,0,0
"Venezuela (Bolivarian Republic of)","2024-06-23",0,0,0,0,0,0,0,0
"Venezuela (Bolivarian Republic of)","2024-06-24",0,0,0,0,0,0,0,0
"Venezuela (Bolivarian Republic of)","2024-06-25",0,0,0,0,0,0,0,0
"Venezuela (Bolivarian Republic of)","2024-06-26",0,0,0,0,0,0,0,0
"Venezuela (Bolivarian Republic of)","2024-06-27",0,0,0,0,0,0,0,0
"Venezuela (Bolivarian Republic of)","2024-06-28",0,0,0,0,0,0,0,0
"Venezuela (Bolivarian Republic of)","2024-06-29",0,0,0,0,0,0,0,0
"Venezuela (Bolivarian Republic of)","2024-06-30",0,0,0,0,0,0,0,0
"Venezuela (Bolivarian Republic of)","2024-07-01",0,0,0,0,0,0,0,0
"Venezuela (Bolivarian Republic of)","2024-07-02",0,0,0,0,0,0,0,0
"Venezuela (Bolivarian Republic of)","2024-07-03",0,0,0,0,0,0,0,0
"Venezuela (Bolivarian Republic of)","2024-07-04",0,0,0,0,0,0,0,0
"Venezuela (Bolivarian Republic of)","2024-07-05",0,0,0,0,0,0,0,0
"Venezuela (Bolivarian Republic of)","2024-07-06",0,0,0,0,0,0,0,0
"Venezuela (Bolivarian Republic of)","2024-07-07",0,0,0,0,0,0,0,0
"Venezuela (Bolivarian Republic of)","2024-07-08",0,0,0,0,0,0,0,0
"Venezuela (Bolivarian Republic of)","2024-07-09",0,0,0,0,0,0,0,0
"Venezuela (Bolivarian Republic of)","2024-07-10",0,0,0,0,0,0,0,0
"Venezuela (Bolivarian Republic of)","2024-07-11",0,0,0,0,0,0,0,0
"Venezuela (Bolivarian Republic of)","2024-07-12",0,0,0,0,0,0,0,0
"Venezuela (Bolivarian Republic of)","2024-07-13",0,0,0,0,0,0,0,0
"Venezuela (Bolivarian Republic of)","2024-07-14",0,0,0,0,0,0,0,0
"Venezuela (Bolivarian Republic of)","2024-07-15",0,0,0,0,0,0,0,0
"Venezuela (Bolivarian Republic of)","2024-07-16",0,0,0,0,0,0,0,0
"Venezuela (Bolivarian Republic of)","2024-07-17",0,0,0,0,0,0,0,0
"Venezuela (Bolivarian Republic of)","2024-07-18",0,0,0,0,0,0,0,0
"Venezuela (Bolivarian Republic of)","2024-07-19",0,0,0,0,0,0,0,0
"Venezuela (Bolivarian Republic of)","2024-07-20",0,0,0,0,0,0,0,0
"Venezuela (Bolivarian Republic of)","2024-07-21",0,0,0,0,0,0,0,0
"Venezuela (Bolivarian Republic of)","2024-07-22",0,0,0,0,0,0,0,0
"Venezuela (Bolivarian Republic of)","2024-07-23",0,0,0,0,0,0,0,0
"Venezuela (Bolivarian Republic of)","2024-07-24",0,0,0,0,0,0,0,0
"Venezuela (Bolivarian Republic of)","2024-07-25",0,0,0,0,0,0,0,0
"Venezuela (Bolivarian Republic of)","2024-07-26",0,0,0,0,0,0,0,0
"Venezuela (Bolivarian Republic of)","2024-07-27",0,0,0,0,0,0,0,0
"Venezuela (Bolivarian Republic of)","2024-07-28",0,0,0,0,0,0,0,0
"Venezuela (Bolivarian Republic of)","2024-07-29",0,0,0,0,0,0,0,0
"Venezuela (Bolivarian Republic of)","2024-07-30",0,0,0,0,0,0,0,0
"Venezuela (Bolivarian Republic of)","2024-07-31",0,0,0,0,0,0,0,0
"Venezuela (Bolivarian Republic of)","2024-08-01",0,0,0,0,0,0,0,0
"Venezuela (Bolivarian Republic of)","2024-08-02",0,0,0,0,0,0,0,0
"Venezuela (Bolivarian Republic of)","2024-08-03",0,0,0,0,0,0,0,0
"Venezuela (Bolivarian Republic of)","2024-08-04",0,0,0,0,0,0,0,0
"Venezuela (Bolivarian Republic of)","2024-08-05",0,0,0,0,0,0,0,0
"Venezuela (Bolivarian Republic of)","2024-08-06",0,0,0,0,0,0,0,0
"Venezuela (Bolivarian Republic of)","2024-08-07",0,0,0,0,0,0,0,0
"Venezuela (Bolivarian Republic of)","2024-08-08",0,0,0,0,0,0,0,0
"Venezuela (Bolivarian Republic of)","2024-08-09",0,0,0,0,0,0,0,0
"Venezuela (Bolivarian Republic of)","2024-08-10",0,0,0,0,0,0,0,0
"Venezuela (Bolivarian Republic of)","2024-08-11",0,0,0,0,0,0,0,0
"Venezuela (Bolivarian Republic of)","2024-08-12",0,0,0,0,0,0,0,0
"Venezuela (Bolivarian Republic of)","2024-08-13",0,0,0,0,0,0,0,0
"Venezuela (Bolivarian Republic of)","2024-08-14",0,0,0,0,0,0,0,0
"Venezuela (Bolivarian Republic of)","2024-08-15",0,0,0,0,0,0,0,0
"Venezuela (Bolivarian Republic of)","2024-08-16",0,0,0,0,0,0,0,0
"Venezuela (Bolivarian Republic of)","2024-08-17",0,0,0,0,0,0,0,0
"Venezuela (Bolivarian Republic of)","2024-08-18",0,0,0,0,0,0,0,0
"Venezuela (Bolivarian Republic of)","2024-08-19",0,0,0,0,0,0,0,0
"Venezuela (Bolivarian Republic of)","2024-08-20",0,0,0,0,0,0,0,0
"Venezuela (Bolivarian Republic of)","2024-08-21",0,0,0,0,0,0,0,0
"Venezuela (Bolivarian Republic of)","2024-08-22",0,0,0,0,0,0,0,0
"Venezuela (Bolivarian Republic of)","2024-08-23",0,0,0,0,0,0,0,0
"Venezuela (Bolivarian Republic of)","2024-08-24",0,0,0,0,0,0,0,0
"Venezuela (Bolivarian Republic of)","2024-08-25",0,0,0,0,0,0,0,0
"Venezuela (Bolivarian Republic of)","2024-08-26",0,0,0,0,0,0,0,0
"Venezuela (Bolivarian Republic of)","2024-08-27",0,0,0,0,0,0,0,0
"Venezuela (Bolivarian Republic of)","2024-08-28",0,0,0,0,0,0,0,0
"Venezuela (Bolivarian Republic of)","2024-08-29",0,0,0,0,0,0,0,0
"Venezuela (Bolivarian Republic of)","2024-08-30",0,0,0,0,0,0,0,0
"Venezuela (Bolivarian Republic of)","2024-08-31",0,0,0,0,0,0,0,0
"Venezuela (Bolivarian Republic of)","2024-09-01",0,0,0,0,0,0,0,0
"Venezuela (Bolivarian Republic of)","2024-09-02",0,0,0,0,0,0,0,0
"Venezuela (Bolivarian Republic of)","2024-09-03",0,0,0,0,0,0,0,0
"Venezuela (Bolivarian Republic of)","2024-09-04",0,0,0,0,0,0,0,0
"Venezuela (Bolivarian Republic of)","2024-09-05",0,0,0,0,0,0,0,0
"Venezuela (Bolivarian Republic of)","2024-09-06",0,0,0,0,0,0,0,0
"Venezuela (Bolivarian Republic of)","2024-09-07",0,0,0,0,0,0,0,0
"Venezuela (Bolivarian Republic of)","2024-09-08",0,0,0,0,0,0,0,0
"Venezuela (Bolivarian Republic of)","2024-09-09",0,0,0,0,0,0,0,0
"Venezuela (Bolivarian Republic of)","2024-09-10",0,0,0,0,0,0,0,0
"Venezuela (Bolivarian Republic of)","2024-09-11",0,0,0,0,0,0,0,0
"Venezuela (Bolivarian Republic of)","2024-09-12",0,0,0,0,0,0,0,0
"Venezuela (Bolivarian Republic of)","2024-09-13",0,0,0,0,0,0,0,0
"Venezuela (Bolivarian Republic of)","2024-09-14",0,0,0,0,0,0,0,0
"Venezuela (Bolivarian Republic of)","2024-09-15",0,0,0,0,0,0,0,0
"Venezuela (Bolivarian Republic of)","2024-09-16",0,0,0,0,0,0,0,0
"Venezuela (Bolivarian Republic of)","2024-09-17",0,0,0,0,0,0,0,0
"Venezuela (Bolivarian Republic of)","2024-09-18",0,0,0,0,0,0,0,0
"Venezuela (Bolivarian Republic of)","2024-09-19",0,0,0,0,0,0,0,0
"Venezuela (Bolivarian Republic of)","2024-09-20",0,0,0,0,0,0,0,0
"Venezuela (Bolivarian Republic of)","2024-09-21",0,0,0,0,0,0,0,0
"Venezuela (Bolivarian Republic of)","2024-09-22",0,0,0,0,0,0,0,0
"Venezuela (Bolivarian Republic of)","2024-09-23",0,0,0,0,0,0,0,0
"Venezuela (Bolivarian Republic of)","2024-09-24",0,0,0,0,0,0,0,0
"Venezuela (Bolivarian Republic of)","2024-09-25",0,0,0,0,0,0,0,0
"Venezuela (Bolivarian Republic of)","2024-09-26",0,0,0,0,0,0,0,0
"Venezuela (Bolivarian Republic of)","2024-09-27",0,0,0,0,0,0,0,0
"Venezuela (Bolivarian Republic of)","2024-09-28",0,0,0,0,0,0,0,0
"Venezuela (Bolivarian Republic of)","2024-09-29",0,0,0,0,0,0,0,0
"Venezuela (Bolivarian Republic of)","2024-09-30",0,0,0,0,0,0,0,0
"Venezuela (Bolivarian Republic of)","2024-10-01",0,0,0,0,0,0,0,0
"Venezuela (Bolivarian Republic of)","2024-10-02",0,0,0,0,0,0,0,0
"Venezuela (Bolivarian Republic of)","2024-10-03",0,0,0,0,0,0,0,0
"Venezuela (Bolivarian Republic of)","2024-10-04",0,0,0,0,0,0,0,0
"Venezuela (Bolivarian Republic of)","2024-10-05",0,0,0,0,0,0,0,0
"Venezuela (Bolivarian Republic of)","2024-10-06",0,0,0,0,0,0,0,0
"Venezuela (Bolivarian Republic of)","2024-10-07",0,0,0,0,0,0,0,0
"Venezuela (Bolivarian Republic of)","2024-10-08",0,0,0,0,0,0,0,0
"Venezuela (Bolivarian Republic of)","2024-10-09",0,0,0,0,0,0,0,0
"Venezuela (Bolivarian Republic of)","2024-10-10",0,0,0,0,0,0,0,0
"Venezuela (Bolivarian Republic of)","2024-10-11",0,0,0,0,0,0,0,0
"Venezuela (Bolivarian Republic of)","2024-10-12",0,0,0,0,0,0,0,0
"Venezuela (Bolivarian Republic of)","2024-10-13",0,0,0,0,0,0,0,0
"Venezuela (Bolivarian Republic of)","2024-10-14",0,0,0,0,0,0,0,0
"Venezuela (Bolivarian Republic of)","2024-10-15",0,0,0,0,0,0,0,0
"Venezuela (Bolivarian Republic of)","2024-10-16",0,0,0,0,0,0,0,0
"Venezuela (Bolivarian Republic of)","2024-10-17",0,0,0,0,0,0,0,0
"Venezuela (Bolivarian Republic of)","2024-10-18",0,0,0,0,0,0,0,0
"Venezuela (Bolivarian Republic of)","2024-10-19",0,0,0,0,0,0,0,0
"Venezuela (Bolivarian Republic of)","2024-10-20",0,0,0,0,0,0,0,0
"Venezuela (Bolivarian Republic of)","2024-10-21",0,0,0,0,0,0,0,0
"Venezuela (Bolivarian Republic of)","2024-10-22",0,0,0,0,0,0,0,0
"Venezuela (Bolivarian Republic of)","2024-10-23",0,0,0,0,0,0,0,0
"Venezuela (Bolivarian Republic of)","2024-10-24",0,0,0,0,0,0,0,0
"Venezuela (Bolivarian Republic of)","2024-10-25",0,0,0,0,0,0,0,0
"Venezuela (Bolivarian Republic of)","2024-10-26",0,0,0,0,0,0,0,0
"Venezuela (Bolivarian Republic of)","2024-10-27",0,0,0,0,0,0,0,0
"Venezuela (Bolivarian Republic of)","2024-10-28",0,0,0,0,0,0,0,0
"Venezuela (Bolivarian Republic of)","2024-10-29",0,0,0,0,0,0,0,0
"Venezuela (Bolivarian Republic of)","2024-10-30",0,0,0,0,0,0,0,0
"Venezuela (Bolivarian Republic of)","2024-10-31",0,0,0,0,0,0,0,0
"Venezuela (Bolivarian Republic of)","2024-11-01",0,0,0,0,0,0,0,0
"Venezuela (Bolivarian Republic of)","2024-11-02",0,0,0,0,0,0,0,0
"Venezuela (Bolivarian Republic of)","2024-11-03",0,0,0,0,0,0,0,0
"Venezuela (Bolivarian Republic of)","2024-11-04",0,0,0,0,0,0,0,0
"Venezuela (Bolivarian Republic of)","2024-11-05",0,0,0,0,0,0,0,0
"Venezuela (Bolivarian Republic of)","2024-11-06",0,0,0,0,0,0,0,0
"Venezuela (Bolivarian Republic of)","2024-11-07",0,0,0,0,0,0,0,0
"Venezuela (Bolivarian Republic of)","2024-11-08",0,0,0,0,0,0,0,0
"Venezuela (Bolivarian Republic of)","2024-11-09",0,0,0,0,0,0,0,0
"Venezuela (Bolivarian Republic of)","2024-11-10",0,0,0,0,0,0,0,0
"Venezuela (Bolivarian Republic of)","2024-11-11",0,0,0,0,0,0,0,0
"Venezuela (Bolivarian Republic of)","2024-11-12",0,0,0,0,0,0,0,0
"Venezuela (Bolivarian Republic of)","2024-11-13",0,0,0,0,0,0,0,0
"Venezuela (Bolivarian Republic of)","2024-11-14",0,0,0,0,0,0,0,0
"Venezuela (Bolivarian Republic of)","2024-11-15",0,0,0,0,0,0,0,0
"Venezuela (Bolivarian Republic of)","2024-11-16",0,0,0,0,0,0,0,0
"Venezuela (Bolivarian Republic of)","2024-11-17",0,0,0,0,0,0,0,0
"Venezuela (Bolivarian Republic of)","2024-11-18",0,0,0,0,0,0,0,0
"Venezuela (Bolivarian Republic of)","2024-11-19",0,0,0,0,0,0,0,0
"Venezuela (Bolivarian Republic of)","2024-11-20",0,0,0,0,0,0,0,0
"Venezuela (Bolivarian Republic of)","2024-11-21",0,0,0,0,0,0,0,0
"Venezuela (Bolivarian Republic of)","2024-11-22",0,0,0,0,0,0,0,0
"Venezuela (Bolivarian Republic of)","2024-11-23",0,0,0,0,0,0,0,0
"Venezuela (Bolivarian Republic of)","2024-11-24",0,0,0,0,0,0,0,0
"Venezuela (Bolivarian Republic of)","2024-11-25",0,0,0,0,0,0,0,0
"Venezuela (Bolivarian Republic of)","2024-11-26",0,0,0,0,0,0,0,0
"Venezuela (Bolivarian Republic of)","2024-11-27",0,0,0,0,0,0,0,0
"Venezuela (Bolivarian Republic of)","2024-11-28",0,0,0,0,0,0,0,0
"Venezuela (Bolivarian Republic of)","2024-11-29",0,0,0,0,0,0,0,0
"Venezuela (Bolivarian Republic of)","2024-11-30",0,0,0,0,0,0,0,0
"Venezuela (Bolivarian Republic of)","2024-12-01",0,0,0,0,0,0,0,0
"Venezuela (Bolivarian Republic of)","2024-12-02",0,0,0,0,0,0,0,0
"Venezuela (Bolivarian Republic of)","2024-12-03",0,0,0,0,0,0,0,0
"Venezuela (Bolivarian Republic of)","2024-12-04",0,0,0,0,0,0,0,0
"Venezuela (Bolivarian Republic of)","2024-12-05",0,0,0,0,0,0,0,0
"Venezuela (Bolivarian Republic of)","2024-12-06",0,0,0,0,0,0,0,0
"Venezuela (Bolivarian Republic of)","2024-12-07",0,0,0,0,0,0,0,0
"Venezuela (Bolivarian Republic of)","2024-12-08",0,0,0,0,0,0,0,0
"Venezuela (Bolivarian Republic of)","2024-12-09",0,0,0,0,0,0,0,0
"Venezuela (Bolivarian Republic of)","2024-12-10",0,0,0,0,0,0,0,0
"Venezuela (Bolivarian Republic of)","2024-12-11",0,0,0,0,0,0,0,0
"Venezuela (Bolivarian Republic of)","2024-12-12",0,0,0,0,0,0,0,0
"Venezuela (Bolivarian Republic of)","2024-12-13",0,0,0,0,0,0,0,0
"Venezuela (Bolivarian Republic of)","2024-12-14",0,0,0,0,0,0,0,0
"Venezuela (Bolivarian Republic of)","2024-12-15",0,0,0,0,0,0,0,0
"Venezuela (Bolivarian Republic of)","2024-12-16",0,0,0,0,0,0,0,0
"Venezuela (Bolivarian Republic of)","2024-12-17",0,0,0,0,0,0,0,0
"Venezuela (Bolivarian Republic of)","2024-12-18",0,0,0,0,0,0,0,0
"Venezuela (Bolivarian Republic of)","2024-12-19",0,0,0,0,0,0,0,0
"Venezuela (Bolivarian Republic of)","2024-12-20",0,0,0,0,0,0,0,0
"Venezuela (Bolivarian Republic of)","2024-12-21",0,0,0,0,0,0,0,0
"Venezuela (Bolivarian Republic of)","2024-12-22",0,0,0,0,0,0,0,0
"Venezuela (Bolivarian Republic of)","2024-12-23",0,0,0,0,0,0,0,0
"Venezuela (Bolivarian Republic of)","2024-12-24",0,0,0,0,0,0,0,0
"Venezuela (Bolivarian Republic of)","2024-12-25",0,0,0,0,0,0,0,0
"Venezuela (Bolivarian Republic of)","2024-12-26",0,0,0,0,0,0,0,0
"Venezuela (Bolivarian Republic of)","2024-12-27",0,0,0,0,0,0,0,0
"Venezuela (Bolivarian Republic of)","2024-12-28",0,0,0,0,0,0,0,0
"Venezuela (Bolivarian Republic of)","2024-12-29",0,0,0,0,0,0,0,0
"Venezuela (Bolivarian Republic of)","2024-12-30",0,0,0,0,0,0,0,0
"Venezuela (Bolivarian Republic of)","2024-12-31",0,0,0,0,0,0,0,0
"Venezuela (Bolivarian Republic of)","2025-01-01",0,0,0,0,0,0,0,0
"Venezuela (Bolivarian Republic of)","2025-01-02",0,0,0,0,0,0,0,0
"Venezuela (Bolivarian Republic of)","2025-01-03",0,0,0,0,0,0,0,0
"Venezuela (Bolivarian Republic of)","2025-01-04",0,0,0,0,0,0,0,0
"Venezuela (Bolivarian Republic of)","2025-01-05",0,0,0,0,0,0,0,0
"Venezuela (Bolivarian Republic of)","2025-01-06",0,0,0,0,0,0,0,0
"Venezuela (Bolivarian Republic of)","2025-01-07",0,0,0,0,0,0,0,0
"Venezuela (Bolivarian Republic of)","2025-01-08",0,0,0,0,0,0,0,0
"Venezuela (Bolivarian Republic of)","2025-01-09",0,0,0,0,0,0,0,0
"Venezuela (Bolivarian Republic of)","2025-01-10",0,0,0,0,0,0,0,0
"Venezuela (Bolivarian Republic of)","2025-01-11",0,0,0,0,0,0,0,0
"Venezuela (Bolivarian Republic of)","2025-01-12",0,0,0,0,0,0,0,0
"Venezuela (Bolivarian Republic of)","2025-01-13",0,0,0,0,0,0,0,0
"Venezuela (Bolivarian Republic of)","2025-01-14",0,0,0,0,0,0,0,0
"Venezuela (Bolivarian Republic of)","2025-01-15",0,0,0,0,0,0,0,0
"Venezuela (Bolivarian Republic of)","2025-01-16",0,0,0,0,0,0,0,0
"Venezuela (Bolivarian Republic of)","2025-01-17",0,0,0,0,0,0,0,0
"Venezuela (Bolivarian Republic of)","2025-01-18",0,0,0,0,0,0,0,0
"Venezuela (Bolivarian Republic of)","2025-01-19",0,0,0,0,0,0,0,0
"Venezuela (Bolivarian Republic of)","2025-01-20",0,0,0,0,0,0,0,0
"Venezuela (Bolivarian Republic of)","2025-01-21",0,0,0,0,0,0,0,0
"Venezuela (Bolivarian Republic of)","2025-01-22",0,0,0,0,0,0,0,0
"Venezuela (Bolivarian Republic of)","2025-01-23",0,0,0,0,0,0,0,0
"Venezuela (Bolivarian Republic of)","2025-01-24",0,0,0,0,0,0,0,0
"Venezuela (Bolivarian Republic of)","2025-01-25",0,0,0,0,0,0,0,0
"Venezuela (Bolivarian Republic of)","2025-01-26",0,0,0,0,0,0,0,0
"Venezuela (Bolivarian Republic of)","2025-01-27",0,0,0,0,0,0,0,0
"Venezuela (Bolivarian Republic of)","2025-01-28",0,0,0,0,0,0,0,0
"Venezuela (Bolivarian Republic of)","2025-01-29",0,0,0,0,0,0,0,0
"Venezuela (Bolivarian Republic of)","2025-01-30",0,0,0,0,0,0,0,0
"Venezuela (Bolivarian Republic of)","2025-01-31",0,0,0,0,0,0,0,0
"Venezuela (Bolivarian Republic of)","2025-02-01",0,0,0,0,0,0,0,0
"Venezuela (Bolivarian Republic of)","2025-02-02",0,0,0,0,0,0,0,0
"Venezuela (Bolivarian Republic of)","2025-02-03",0,0,0,0,0,0,0,0
"Venezuela (Bolivarian Republic of)","2025-02-04",0,0,0,0,0,0,0,0
"Venezuela (Bolivarian Republic of)","2025-02-05",0,0,0,0,0,0,0,0
"Venezuela (Bolivarian Republic of)","2025-02-06",0,0,0,0,0,0,0,0
"Venezuela (Bolivarian Republic of)","2025-02-07",0,0,0,0,0,0,0,0
"Venezuela (Bolivarian Republic of)","2025-02-08",0,0,0,0,0,0,0,0
"Venezuela (Bolivarian Republic of)","2025-02-09",0,0,0,0,0,0,0,0
"Venezuela (Bolivarian Republic of)","2025-02-10",0,0,0,0,0,0,0,0
"Venezuela (Bolivarian Republic of)","2025-02-11",0,0,0,0,0,0,0,0
"Venezuela (Bolivarian Republic of)","2025-02-12",0,0,0,0,0,0,0,0
"Venezuela (Bolivarian Republic of)","2025-02-13",0,0,0,0,0,0,0,0
"Venezuela (Bolivarian Republic of)","2025-02-14",0,0,0,0,0,0,0,0
"Venezuela (Bolivarian Republic of)","2025-02-15",0,0,0,0,0,0,0,0
"Venezuela (Bolivarian Republic of)","2025-02-16",0,0,0,0,0,0,0,0
"Venezuela (Bolivarian Republic of)","2025-02-17",0,0,0,0,0,0,0,0
"Venezuela (Bolivarian Republic of)","2025-02-18",0,0,0,0,0,0,0,0
"Venezuela (Bolivarian Republic of)","2025-02-19",0,0,0,0,0,0,0,0
"Venezuela (Bolivarian Republic of)","2025-02-20",0,0,0,0,0,0,0,0
"Venezuela (Bolivarian Republic of)","2025-02-21",0,0,0,0,0,0,0,0
"Venezuela (Bolivarian Republic of)","2025-02-22",0,0,0,0,0,0,0,0
"Venezuela (Bolivarian Republic of)","2025-02-23",0,0,0,0,0,0,0,0
"Venezuela (Bolivarian Republic of)","2025-02-24",0,0,0,0,0,0,0,0
"Venezuela (Bolivarian Republic of)","2025-02-25",0,0,0,0,0,0,0,0
"Venezuela (Bolivarian Republic of)","2025-02-26",0,0,0,0,0,0,0,0
"Venezuela (Bolivarian Republic of)","2025-02-27",0,0,0,0,0,0,0,0
"Venezuela (Bolivarian Republic of)","2025-02-28",0,0,0,0,0,0,0,0
"Venezuela (Bolivarian Republic of)","2025-03-01",0,0,0,0,0,0,0,0
"Venezuela (Bolivarian Republic of)","2025-03-02",0,0,0,0,0,0,0,0
"Venezuela (Bolivarian Republic of)","2025-03-03",0,0,0,0,0,0,0,0
"Viet Nam","2024-01-01",0,0,0,0,0,0,0,0
"Viet Nam","2024-01-02",0,0,0,0,0,0,0,0
"Viet Nam","2024-01-03",0,0,0,0,0,0,0,0
"Viet Nam","2024-01-04",0,0,0,0,0,0,0,0
"Viet Nam","2024-01-05",0,0,0,0,0,0,0,0
"Viet Nam","2024-01-06",0,0,0,0,0,0,0,0
"Viet Nam","2024-01-07",0,0,0,0,0,0,0,0
"Viet Nam","2024-01-08",0,0,0,0,0,0,0,0
"Viet Nam","2024-01-09",0,0,0,0,0,0,0,0
"Viet Nam","2024-01-10",0,14,14,0,14,14,0,0
"Viet Nam","2024-01-11",0,0,14,0,0,14,0,0
"Viet Nam","2024-01-12",0,0,14,0,0,14,0,0
"Viet Nam","2024-01-13",0,0,14,0,1,15,0,0
"Viet Nam","2024-01-14",0,0,14,0,0,15,0,0
"Viet Nam","2024-01-15",0,0,14,0,0,15,0,0
"Viet Nam","2024-01-16",0,0,14,0,0,15,0,0
"Viet Nam","2024-01-17",0,0,14,0,0,15,0,0
"Viet Nam","2024-01-18",0,0,14,0,1,16,0,0
"Viet Nam","2024-01-19",0,0,14,0,0,16,0,0
"Viet Nam","2024-01-20",0,2,16,0,0,16,0,0
"Viet Nam","2024-01-21",0,0,16,0,1,17,0,0
"Viet Nam","2024-01-22",0,0,16,0,1,18,0,0
"Viet Nam","2024-01-23",0,0,16,0,2,20,0,0
"Viet Nam","2024-01-24",0,5,21,0,1,21,0,0
"Viet Nam","2024-01-25",0,0,21,0,0,21,0,0
"Viet Nam","2024-01-26",0,0,21,0,1,22,0,0
"Viet Nam","2024-01-27",0,0,21,0,0,22,0,0
"Viet Nam","2024-01-28",0,0,21,0,0,22,0,0
"Viet Nam","2024-01-29",0,0,21,0,1,23,0,0
"Viet Nam","2024-01-30",0,0,21,0,0,23,0,0
"Viet Nam","2024-01-31",0,0,21,0,0,23,0,0
"Viet Nam","2024-02-01",0,0,21,0,0,23,0,0
"Viet Nam","2024-02-02",0,0,21,0,1,24,0,0
"Viet Nam","2024-02-03",0,0,21,0,0,24,0,0
"Viet Nam","2024-02-04",0,0,21,0,0,24,0,0
"Viet Nam","2024-02-05",0,0,21,0,1,25,0,0
"Viet Nam","2024-02-06",0,0,21,0,0,25,0,0
"Viet Nam","2024-02-07",0,0,21,0,0,25,0,0
"Viet Nam","2024-02-08",0,0,21,0,1,26,0,0
"Viet Nam","2024-02-09",0,5,26,0,0,26,0,0
"Viet Nam","2024-02-10",0,0,26,0,0,26,0,0
"Viet Nam","2024-02-11",0,0,26,0,1,27,0,0
"Viet Nam","2024-02-12",0,0,26,0,0,27,0,0
"Viet Nam","2024-02-13",0,0,26,0,1,28,0,0
"Viet Nam","2024-02-14",0,0,26,0,0,28,0,0
"Viet Nam","2024-02-15",0,0,26,0,0,28,0,0
"Viet Nam","2024-02-16",0,0,26,0,1,29,0,0
"Viet Nam","2024-02-17",0,0,26,0,0,29,0,0
"Viet Nam","2024-02-18",0,0,26,0,0,29,0,0
"Viet Nam","2024-02-19",0,0,26,0,1,30,0,0
"Viet Nam","2024-02-20",0,0,26,0,0,30,0,0
"Viet Nam","2024-02-21",0,0,26,0,1,31,0,0
"Viet Nam","2024-02-22",0,0,26,0,0,31,0,0
"Viet Nam","2024-02-23",0,0,26,0,0,31,0,0
"Viet Nam","2024-02-24",0,0,26,0,1,32,0,0
"Viet Nam","2024-02-25",0,0,26,0,0,32,0,0
"Viet Nam","2024-02-26",0,0,26,0,1,33,0,0
"Viet Nam","2024-02-27",0,0,26,0,0,33,0,0
"Viet Nam","2024-02-28",0,0,26,0,0,33,0,0
"Viet Nam","2024-02-29",0,0,26,0,1,34,0,0
"Viet Nam","2024-03-01",0,0,26,0,0,34,0,0
"Viet Nam","2024-03-02",0,0,26,0,0,34,0,0
"Viet Nam","2024-03-03",0,0,26,0,1,35,0,0
"Viet Nam","2024-03-04",0,0,26,0,0,35,0,0
"Viet Nam","2024-03-05",0,0,26,0,1,36,0,0
"Viet Nam","2024-03-06",0,10,36,0,0,36,0,0
"Viet Nam","2024-03-07",0,0,36,0,1,37,0,0
"Viet Nam","2024-03-08",0,0,36,0,0,37,0,0
"Viet Nam","2024-03-09",0,0,36,0,1,38,0,0
"Viet Nam","2024-03-10",0,0,36,0,0,38,0,0
"Viet Nam","2024-03-11",0,0,36,0,1,39,0,0
"Viet Nam","2024-03-12",0,0,36,0,1,40,0,0
"Viet Nam","2024-03-13",0,0,36,0,0,40,0,0
"Viet Nam","2024-03-14",0,0,36,0,1,41,0,0
"Viet Nam","2024-03-15",0,0,36,0,0,41,0,0
"Viet Nam","2024-03-16",0,0,36,0,1,42,0,0
"Viet Nam","2024-03-17",0,0,36,0,1,43,0,0
"Viet Nam","2024-03-18",0,0,36,0,0,43,0,0
"Viet Nam","2024-03-19",0,0,36,0,1,44,0,0
"Viet Nam","2024-03-20",0,0,36,0,0,44,0,0
"Viet Nam","2024-03-21",0,0,36,0,1,45,0,0
"Viet Nam","2024-03-22",0,0,36,0,1,46,0,0
"Viet Nam","2024-03-23",0,0,36,0,0,46,0,0
"Viet Nam","2024-03-24",0,0,36,0,1,47,0,0
"Viet Nam","2024-03-25",0,0,36,0,0,47,0,0
"Viet Nam","2024-03-26",0,12,48,0,1,48,0,0
"Viet Nam","2024-03-27",0,0,48,0,1,49,0,0
"Viet Nam","2024-03-28",0,0,48,0,0,49,0,0
"Viet Nam","2024-03-29",0,0,48,0,1,50,0,0
"Viet Nam","2024-03-30",0,0,48,0,0,50,0,0
"Viet Nam","2024-03-31",0,0,48,0,1,51,0,0
"Viet Nam","2024-04-01",0,0,48,0,0,51,0,0
"Viet Nam","2024-04-02",0,0,48,0,1,52,0,0
"Viet Nam","2024-04-03",0,0,48,0,0,52,0,0
"Viet Nam","2024-04-04",0,0,48,0,1,53,0,0
"Viet Nam","2024-04-05",0,0,48,0,0,53,0,0
"Viet Nam","2024-04-06",0,0,48,0,1,54,0,0
"Viet Nam","2024-04-07",0,0,48,0,0,54,0,0
"Viet Nam","2024-04-08",0,0,48,0,1,55,0,0
"Viet Nam","2024-04-09",0,0,48,0,0,55,0,0
"Viet Nam","2024-04-10",0,0,48,0,1,56,0,0
"Viet Nam","2024-04-11",0,0,48,0,1,57,0,0
"Viet Nam","2024-04-12",0,0,48,0,0,57,0,0
"Viet Nam","2024-04-13",0,0,48,0,1,58,0,0
"Viet Nam","2024-04-14",0,0,48,0,0,58,0,0
"Viet Nam","2024-04-15",0,0,48,0,1,59,0,0
"Viet Nam","2024-04-16",0,0,48,0,0,59,0,0
"Viet Nam","2024-04-17",0,0,48,0,1,60,0,0
"Viet Nam","2024-04-18",0,0,48,0,0,60,0,0
"Viet Nam","2024-04-19",0,0,48,0,1,61,0,0
"Viet Nam","2024-04-20",0,0,48,0,0,61,0,0
"Viet Nam","2024-04-21",0,0,48,0,1,62,0,0
"Viet Nam","2024-04-22",0,0,48,0,0,62,0,0
"Viet Nam","2024-04-23",0,0,48,0,1,63,0,0
"Viet Nam","2024-04-24",0,0,48,0,0,63,0,0
"Viet Nam","2024-04-25",0,0,48,0,1,64,0,0
"Viet Nam","2024-04-26",0,0,48,0,1,65,0,0
"Viet Nam","2024-04-27",0,0,48,0,0,65,0,0
"Viet Nam","2024-04-28",0,0,48,0,1,66,0,0
"Viet Nam","2024-04-29",0,0,48,0,0,66,0,0
"Viet Nam","2024-04-30",0,0,48,0,1,67,0,0
"Viet Nam","2024-05-01",0,0,48,0,0,67,0,0
"Viet Nam","2024-05-02",0,0,48,0,1,68,0,0
"Viet Nam","2024-05-03",0,0,48,0,0,68,0,0
"Viet Nam","2024-05-04",0,0,48,0,1,69,0,0
"Viet Nam","2024-05-05",0,0,48,0,0,69,0,0
"Viet Nam","2024-05-06",0,0,48,0,1,70,0,0
"Viet Nam","2024-05-07",0,0,48,0,0,70,0,0
"Viet Nam","2024-05-08",0,0,48,0,1,71,0,0
"Viet Nam","2024-05-09",0,0,48,0,0,71,0,0
"Viet Nam","2024-05-10",0,24,72,0,1,72,0,0
"Viet Nam","2024-05-11",0,0,72,0,0,72,0,0
"Viet Nam","2024-05-12",0,0,72,0,0,72,0,0
"Viet Nam","2024-05-13",0,0,72,0,0,72,0,0
"Viet Nam","2024-05-14",0,0,72,0,1,73,0,0
"Viet Nam","2024-05-15",0,0,72,0,0,73,0,0
"Viet Nam","2024-05-16",0,0,72,0,0,73,0,0
"Viet Nam","2024-05-17",0,0,72,0,0,73,0,0
"Viet Nam","2024-05-18",0,0,72,0,0,73,0,0
"Viet Nam","2024-05-19",0,0,72,0,0,73,0,0
"Viet Nam","2024-05-20",0,0,72,0,0,73,0,0
"Viet Nam","2024-05-21",0,0,72,0,1,74,0,0
"Viet Nam","2024-05-22",0,0,72,0,0,74,0,0
"Viet Nam","2024-05-23",0,0,72,0,0,74,0,0
"Viet Nam","2024-05-24",0,0,72,0,0,74,0,0
"Viet Nam","2024-05-25",0,0,72,0,0,74,0,0
"Viet Nam","2024-05-26",0,0,72,0,0,74,0,0
"Viet Nam","2024-05-27",0,0,72,0,0,74,0,0
"Viet Nam","2024-05-28",0,0,72,0,1,75,0,0
"Viet Nam","2024-05-29",0,0,72,0,0,75,0,0
"Viet Nam","2024-05-30",0,0,72,0,0,75,0,0
"Viet Nam","2024-05-31",0,3,75,0,0,75,0,0
"Viet Nam","2024-06-01",0,0,75,0,0,75,0,0
"Viet Nam","2024-06-02",0,0,75,0,0,75,0,0
"Viet Nam","2024-06-03",0,0,75,0,1,76,0,0
"Viet Nam","2024-06-04",0,0,75,0,0,76,0,0
"Viet Nam","2024-06-05",0,0,75,0,0,76,0,0
"Viet Nam","2024-06-06",0,0,75,0,0,76,0,0
"Viet Nam","2024-06-07",0,0,75,0,1,77,0,0
"Viet Nam","2024-06-08",0,0,75,0,0,77,0,0
"Viet Nam","2024-06-09",0,0,75,0,0,77,0,0
"Viet Nam","2024-06-10",0,0,75,0,0,77,0,0
"Viet Nam","2024-06-11",0,0,75,0,0,77,0,0
"Viet Nam","2024-06-12",0,0,75,0,1,78,0,0
"Viet Nam","2024-06-13",0,0,75,0,0,78,0,0
"Viet Nam","2024-06-14",0,0,75,0,0,78,0,0
"Viet Nam","2024-06-15",0,0,75,0,0,78,0,0
"Viet Nam","2024-06-16",0,0,75,0,0,78,0,0
"Viet Nam","2024-06-17",0,0,75,0,1,79,0,0
"Viet Nam","2024-06-18",0,0,75,0,0,79,0,0
"Viet Nam","2024-06-19",0,0,75,0,0,79,0,0
"Viet Nam","2024-06-20",0,0,75,0,0,79,0,0
"Viet Nam","2024-06-21",0,0,75,0,0,79,0,0
"Viet Nam","2024-06-22",0,0,75,0,1,80,0,0
"Viet Nam","2024-06-23",0,0,75,0,0,80,0,0
"Viet Nam","2024-06-24",0,0,75,0,0,80,0,0
"Viet Nam","2024-06-25",0,0,75,0,0,80,0,0
"Viet Nam","2024-06-26",0,0,75,0,1,81,0,0
"Viet Nam","2024-06-27",0,0,75,0,0,81,0,0
"Viet Nam","2024-06-28",0,6,81,0,0,81,0,0
"Viet Nam","2024-06-29",0,0,81,0,0,81,0,0
"Viet Nam","2024-06-30",0,0,81,0,0,81,0,0
"Viet Nam","2024-07-01",0,0,81,0,0,81,0,0
"Viet Nam","2024-07-02",0,0,81,0,0,81,0,0
"Viet Nam","2024-07-03",0,0,81,0,0,81,0,0
"Viet Nam","2024-07-04",0,0,81,0,0,81,0,0
"Viet Nam","2024-07-05",0,0,81,0,0,81,0,0
"Viet Nam","2024-07-06",0,0,81,0,0,81,0,0
"Viet Nam","2024-07-07",0,0,81,0,0,81,0,0
"Viet Nam","2024-07-08",0,0,81,0,1,82,0,0
"Viet Nam","2024-07-09",0,0,81,0,0,82,0,0
"Viet Nam","2024-07-10",0,0,81,0,0,82,0,0
"Viet Nam","2024-07-11",0,0,81,0,0,82,0,0
"Viet Nam","2024-07-12",0,0,81,0,0,82,0,0
"Viet Nam","2024-07-13",0,0,81,0,0,82,0,0
"Viet Nam","2024-07-14",0,0,81,0,0,82,0,0
"Viet Nam","2024-07-15",0,0,81,0,0,82,0,0
"Viet Nam","2024-07-16",0,1,82,0,0,82,0,0
"Viet Nam","2024-07-17",0,0,82,0,0,82,0,0
"Viet Nam","2024-07-18",0,0,82,0,0,82,0,0
"Viet Nam","2024-07-19",0,0,82,0,0,82,0,0
"Viet Nam","2024-07-20",0,0,82,0,0,82,0,0
"Viet Nam","2024-07-21",0,0,82,0,0,82,0,0
"Viet Nam","2024-07-22",0,0,82,0,0,82,0,0
"Viet Nam","2024-07-23",0,0,82,0,0,82,0,0
"Viet Nam","2024-07-24",0,0,82,0,0,82,0,0
"Viet Nam","2024-07-25",0,0,82,0,0,82,0,0
"Viet Nam","2024-07-26",0,0,82,0,0,82,0,0
"Viet Nam","2024-07-27",0,0,82,0,0,82,0,0
"Viet Nam","2024-07-28",0,0,82,0,0,82,0,0
"Viet Nam","2024-07-29",0,0,82,0,0,82,0,0
"Viet Nam","2024-07-30",0,0,82,0,0,82,0,0
"Viet Nam","2024-07-31",0,0,82,0,0,82,0,0
"Viet Nam","2024-08-01",0,0,82,0,0,82,0,0
"Viet Nam","2024-08-02",0,0,82,0,0,82,0,0
"Viet Nam","2024-08-03",0,0,82,0,0,82,0,0
"Viet Nam","2024-08-04",0,0,82,0,0,82,0,0
"Viet Nam","2024-08-05",0,0,82,0,0,82,0,0
"Viet Nam","2024-08-06",0,0,82,0,0,82,0,0
"Viet Nam","2024-08-07",0,0,82,0,0,82,0,0
"Viet Nam","2024-08-08",0,0,82,0,0,82,0,0
"Viet Nam","2024-08-09",0,0,82,0,0,82,0,0
"Viet Nam","2024-08-10",0,0,82,0,0,82,0,0
"Viet Nam","2024-08-11",0,0,82,0,0,82,0,0
"Viet Nam","2024-08-12",0,0,82,0,0,82,0,0
"Viet Nam","2024-08-13",0,0,82,0,1,83,0,0
"Viet Nam","2024-08-14",0,0,82,0,0,83,0,0
"Viet Nam","2024-08-15",0,0,82,0,0,83,0,0
"Viet Nam","2024-08-16",0,0,82,0,0,83,0,0
"Viet Nam","2024-08-17",0,0,82,0,0,83,0,0
"Viet Nam","2024-08-18",0,0,82,0,0,83,0,0
"Viet Nam","2024-08-19",0,0,82,0,0,83,0,0
"Viet Nam","2024-08-20",0,0,82,0,0,83,0,0
"Viet Nam","2024-08-21",0,0,82,0,0,83,0,0
"Viet Nam","2024-08-22",0,0,82,0,0,83,0,0
"Viet Nam","2024-08-23",0,0,82,0,0,83,0,0
"Viet Nam","2024-08-24",0,0,82,0,0,83,0,0
"Viet Nam","2024-08-25",0,0,82,0,0,83,0,0
"Viet Nam","2024-08-26",0,0,82,0,0,83,0,0
"Viet Nam","2024-08-27",0,0,82,0,0,83,0,0
"Viet Nam","2024-08-28",0,0,82,0,0,83,0,0
"Viet Nam","2024-08-29",0,0,82,0,0,83,0,0
"Viet Nam","2024-08-30",0,0,82,0,0,83,0,0
"Viet Nam","2024-08-31",0,0,82,0,0,83,0,0
"Viet Nam","2024-09-01",0,0,82,0,0,83,0,0
"Viet Nam","2024-09-02",0,0,82,0,0,83,0,0
"Viet Nam","2024-09-03",0,0,82,0,0,83,0,0
"Viet Nam","2024-09-04",0,0,82,0,0,83,0,0
"Viet Nam","2024-09-05",0,0,82,0,0,83,0,0
"Viet Nam","2024-09-06",0,0,82,0,0,83,0,0
"Viet Nam","2024-09-07",0,0,82,0,0,83,0,0
"Viet Nam","2024-09-08",0,0,82,0,0,83,0,0
"Viet Nam","2024-09-09",0,0,82,0,0,83,0,0
"Viet Nam","2024-09-10",0,0,82,0,0,83,0,0
"Viet Nam","2024-09-11",0,0,82,0,0,83,0,0
"Viet Nam","2024-09-12",0,0,82,0,0,83,0,0
"Viet Nam","2024-09-13",0,0,82,0,0,83,0,0
"Viet Nam","2024-09-14",0,0,82,0,0,83,0,0
"Viet Nam","2024-09-15",0,0,82,0,0,83,0,0
"Viet Nam","2024-09-16",0,0,82,0,0,83,0,0
"Viet Nam","2024-09-17",0,0,82,0,0,83,0,0
"Viet Nam","2024-09-18",0,0,82,0,0,83,0,0
"Viet Nam","2024-09-19",0,0,82,0,0,83,0,0
"Viet Nam","2024-09-20",0,0,82,0,0,83,0,0
"Viet Nam","2024-09-21",0,0,82,0,0,83,0,0
"Viet Nam","2024-09-22",0,0,82,0,0,83,0,0
"Viet Nam","2024-09-23",0,0,82,0,0,83,0,0
"Viet Nam","2024-09-24",0,0,82,0,0,83,0,0
"Viet Nam","2024-09-25",0,0,82,0,0,83,0,0
"Viet Nam","2024-09-26",0,0,82,0,0,83,0,0
"Viet Nam","2024-09-27",0,0,82,0,0,83,0,0
"Viet Nam","2024-09-28",0,0,82,0,0,83,0,0
"Viet Nam","2024-09-29",0,0,82,0,0,83,0,0
"Viet Nam","2024-09-30",0,0,82,0,0,83,0,0
"Viet Nam","2024-10-01",0,0,82,0,0,83,0,0
"Viet Nam","2024-10-02",0,0,82,0,0,83,0,0
"Viet Nam","2024-10-03",0,0,82,0,0,83,0,0
"Viet Nam","2024-10-04",0,0,82,0,0,83,0,0
"Viet Nam","2024-10-05",0,0,82,0,1,84,0,0
"Viet Nam","2024-10-06",0,0,82,0,0,84,0,0
"Viet Nam","2024-10-07",0,0,82,0,0,84,0,0
"Viet Nam","2024-10-08",0,0,82,0,0,84,0,0
"Viet Nam","2024-10-09",0,0,82,0,0,84,0,0
"Viet Nam","2024-10-10",0,0,82,0,0,84,0,0
"Viet Nam","2024-10-11",0,0,82,0,0,84,0,0
"Viet Nam","2024-10-12",0,0,82,0,0,84,0,0
"Viet Nam","2024-10-13",0,0,82,0,0,84,0,0
"Viet Nam","2024-10-14",0,0,82,0,0,84,0,0
"Viet Nam","2024-10-15",0,0,82,0,0,84,0,0
"Viet Nam","2024-10-16",0,0,82,0,0,84,0,0
"Viet Nam","2024-10-17",0,0,82,0,0,84,0,0
"Viet Nam","2024-10-18",0,0,82,0,0,84,0,0
"Viet Nam","2024-10-19",0,0,82,0,0,84,0,0
"Viet Nam","2024-10-20",0,0,82,0,0,84,0,0
"Viet Nam","2024-10-21",0,0,82,0,0,84,0,0
"Viet Nam","2024-10-22",0,0,82,0,0,84,0,0
"Viet Nam","2024-10-23",0,0,82,0,0,84,0,0
"Viet Nam","2024-10-24",0,0,82,0,0,84,0,0
"Viet Nam","2024-10-25",0,0,82,0,0,84,0,0
"Viet Nam","2024-10-26",0,0,82,0,0,84,0,0
"Viet Nam","2024-10-27",0,0,82,0,0,84,0,0
"Viet Nam","2024-10-28",0,0,82,0,0,84,0,0
"Viet Nam","2024-10-29",0,0,82,0,0,84,0,0
"Viet Nam","2024-10-30",0,0,82,0,0,84,0,0
"Viet Nam","2024-10-31",0,0,82,0,0,84,0,0
"Viet Nam","2024-11-01",0,2,84,0,0,84,0,0
"Viet Nam","2024-11-02",0,0,84,0,0,84,0,0
"Viet Nam","2024-11-03",0,0,84,0,0,84,0,0
"Viet Nam","2024-11-04",0,0,84,0,0,84,0,0
"Viet Nam","2024-11-05",0,0,84,0,1,85,0,0
"Viet Nam","2024-11-06",0,0,84,0,0,85,0,0
"Viet Nam","2024-11-07",0,0,84,0,0,85,0,0
"Viet Nam","2024-11-08",0,0,84,0,0,85,0,0
"Viet Nam","2024-11-09",0,0,84,0,0,85,0,0
"Viet Nam","2024-11-10",0,0,84,0,0,85,0,0
"Viet Nam","2024-11-11",0,0,84,0,1,86,0,0
"Viet Nam","2024-11-12",0,0,84,0,0,86,0,0
"Viet Nam","2024-11-13",0,0,84,0,0,86,0,0
"Viet Nam","2024-11-14",0,0,84,0,0,86,0,0
"Viet Nam","2024-11-15",0,0,84,0,0,86,0,0
"Viet Nam","2024-11-16",0,0,84,0,0,86,0,0
"Viet Nam","2024-11-17",0,0,84,0,1,87,0,0
"Viet Nam","2024-11-18",0,0,84,0,0,87,0,0
"Viet Nam","2024-11-19",0,0,84,0,0,87,0,0
"Viet Nam","2024-11-20",0,0,84,0,0,87,0,0
"Viet Nam","2024-11-21",0,0,84,0,0,87,0,0
"Viet Nam","2024-11-22",0,0,84,0,0,87,0,0
"Viet Nam","2024-11-23",0,0,84,0,1,88,0,0
"Viet Nam","2024-11-24",0,0,84,0,0,88,0,0
"Viet Nam","2024-11-25",0,0,84,0,0,88,0,0
"Viet Nam","2024-11-26",0,4,88,0,0,88,0,0
"Viet Nam","2024-11-27",0,0,88,0,0,88,0,0
"Viet Nam","2024-11-28",0,0,88,0,0,88,0,0
"Viet Nam","2024-11-29",0,0,88,0,0,88,0,0
"Viet Nam","2024-11-30",0,0,88,0,0,88,0,0
"Viet Nam","2024-12-01",0,0,88,0,0,88,0,0
"Viet Nam","2024-12-02",0,0,88,0,0,88,0,0
"Viet Nam","2024-12-03",0,0,88,0,0,88,0,0
"Viet Nam","2024-12-04",0,0,88,0,0,88,0,0
"Viet Nam","2024-12-05",0,0,88,0,0,88,0,0
"Viet Nam","2024-12-06",0,0,88,0,0,88,0,0
"Viet Nam","2024-12-07",0,0,88,0,0,88,0,0
"Viet Nam","2024-12-08",0,0,88,0,0,88,0,0
"Viet Nam","2024-12-09",0,0,88,0,0,88,0,0
"Viet Nam","2024-12-10",0,0,88,0,0,88,0,0
"Viet Nam","2024-12-11",0,0,88,0,0,88,0,0
"Viet Nam","2024-12-12",0,0,88,0,1,89,0,0
"Viet Nam","2024-12-13",0,0,88,0,0,89,0,0
"Viet Nam","2024-12-14",0,0,88,0,0,89,0,0
"Viet Nam","2024-12-15",0,0,88,0,0,89,0,0
"Viet Nam","2024-12-16",0,0,88,0,0,89,0,0
"Viet Nam","2024-12-17",0,0,88,0,0,89,0,0
"Viet Nam","2024-12-18",0,0,88,0,0,89,0,0
"Viet Nam","2024-12-19",0,0,88,0,0,89,0,0
"Viet Nam","2024-12-20",0,0,88,0,0,89,0,0
"Viet Nam","2024-12-21",0,0,88,0,0,89,0,0
"Viet Nam","2024-12-22",0,0,88,0,0,89,0,0
"Viet Nam","2024-12-23",0,0,88,0,0,89,0,0
"Viet Nam","2024-12-24",0,0,88,0,0,89,0,0
"Viet Nam","2024-12-25",0,0,88,0,0,89,0,0
"Viet Nam","2024-12-26",0,0,88,0,0,89,0,0
"Viet Nam","2024-12-27",0,0,88,0,0,89,0,0
"Viet Nam","2024-12-28",0,0,88,0,0,89,0,0
"Viet Nam","2024-12-29",0,0,88,0,0,89,0,0
"Viet Nam","2024-12-30",0,0,88,0,0,89,0,0
"Viet Nam","2024-12-31",0,0,88,0,0,89,0,0
"Viet Nam","2025-01-01",0,0,88,0,0,89,0,0
"Viet Nam","2025-01-02",0,0,88,0,0,89,0,0
"Viet Nam","2025-01-03",0,0,88,0,0,89,0,0
"Viet Nam","2025-01-04",0,0,88,0,0,89,0,0
"Viet Nam","2025-01-05",0,0,88,0,0,89,0,0
"Viet Nam","2025-01-06",0,0,88,0,0,89,0,0
"Viet Nam","2025-01-07",0,0,88,0,0,89,0,0
"Viet Nam","2025-01-08",0,0,88,0,0,89,0,0
"Viet Nam","2025-01-09",0,0,88,0,0,89,0,0
"Viet Nam","2025-01-10",0,0,88,0,1,90,0,0
"Viet Nam","2025-01-11",0,0,88,0,0,90,0,0
"Viet Nam","2025-01-12",0,0,88,0,0,90,0,0
"Viet Nam","2025-01-13",0,0,88,0,0,90,0,0
"Viet Nam","2025-01-14",0,0,88,0,0,90,0,0
"Viet Nam","2025-01-15",0,0,88,0,0,90,0,0
"Viet Nam","2025-01-16",0,0,88,0,0,90,0,0
"Viet Nam","2025-01-17",0,0,88,0,0,90,0,0
"Viet Nam","2025-01-18",0,0,88,0,0,90,0,0
"Viet Nam","2025-01-19",0,0,88,0,0,90,0,0
"Viet Nam","2025-01-20",0,0,88,0,0,90,0,0
"Viet Nam","2025-01-21",0,0,88,0,0,90,0,0
"Viet Nam","2025-01-22",0,0,88,0,0,90,0,0
"Viet Nam","2025-01-23",0,0,88,0,0,90,0,0
"Viet Nam","2025-01-24",0,0,88,0,0,90,0,0
"Viet Nam","2025-01-25",0,2,90,0,0,90,0,0
"Viet Nam","2025-01-26",0,0,90,0,0,90,0,0
"Viet Nam","2025-01-27",0,0,90,0,0,90,0,0
"Viet Nam","2025-01-28",0,0,90,0,0,90,0,0
"Viet Nam","2025-01-29",0,0,90,0,0,90,0,0
"Viet Nam","2025-01-30",0,0,90,0,0,90,0,0
"Viet Nam","2025-01-31",0,0,90,0,0,90,0,0
"Viet Nam","2025-02-01",0,0,90,0,0,90,0,0
"Viet Nam","2025-02-02",0,0,90,0,0,90,0,0
"Viet Nam","2025-02-03",0,0,90,0,0,90,0,0
"Viet Nam","2025-02-04",0,0,90,0,0,90,0,0
"Viet Nam","2025-02-05",0,0,90,0,0,90,0,0
"Viet Nam","2025-02-06",0,0,90,0,0,90,0,0
"Viet Nam","2025-02-07",0,0,90,0,0,90,0,0
"Viet Nam","2025-02-08",0,0,90,0,0,90,0,0
"Viet Nam","2025-02-09",0,0,90,0,0,90,0,0
"Viet Nam","2025-02-10",0,0,90,0,0,90,0,0
"Viet Nam","2025-02-11",0,0,90,0,0,90,0,0
"Viet Nam","2025-02-12",0,0,90,0,0,90,0,0
"Viet Nam","2025-02-13",0,0,90,0,0,90,0,0
"Viet Nam","2025-02-14",0,0,90,0,0,90,0,0
"Viet Nam","2025-02-15",0,0,90,0,0,90,0,0
"Viet Nam","2025-02-16",0,0,90,0,0,90,0,0
"Viet Nam","2025-02-17",0,0,90,0,0,90,0,0
"Viet Nam","2025-02-18",0,0,90,0,0,90,0,0
"Viet Nam","2025-02-19",0,0,90,0,0,90,0,0
"Viet Nam","2025-02-20",0,0,90,0,0,90,0,0
"Viet Nam","2025-02-21",0,0,90,0,0,90,0,0
"Viet Nam","2025-02-22",0,0,90,0,0,90,0,0
"Viet Nam","2025-02-23",0,0,90,0,0,90,0,0
"Viet Nam","2025-02-24",0,0,90,0,0,90,0,0
"Viet Nam","2025-02-25",0,0,90,0,0,90,0,0
"Viet Nam","2025-02-26",0,0,90,0,0,90,0,0
"Viet Nam","2025-02-27",0,0,90,0,0,90,0,0
"Viet Nam","2025-02-28",0,0,90,0,0,90,0,0
"Viet Nam","2025-03-01",0,0,90,0,0,90,0,0
"Viet Nam","2025-03-02",0,0,90,0,0,90,0,0
"Viet Nam","2025-03-03",0,0,90,0,0,90,0,0
"World","2024-01-01",0,0,0,0,0,0,0,0
"World","2024-01-02",0,121,121,0,121,121,0,0
"World","2024-01-03",0,0,121,0,1,122,0,0
"World","2024-01-04",0,2,123,0,1,123,0,0
"World","2024-01-05",0,1,124,0,1,124,0,0
"World","2024-01-06",0,0,124,0,18,142,0,0
"World","2024-01-07",0,37,161,0,19,161,0,0
"World","2024-01-08",0,0,161,0,56,217,0,0
"World","2024-01-09",0,113,274,0,57,274,0,0
"World","2024-01-10",0,14,288,0,14,288,0,0
"World","2024-01-11",0,1,289,0,1,289,0,0
"World","2024-01-12",0,1,290,0,1,290,0,0
"World","2024-01-13",0,0,290,0,19,309,0,0
"World","2024-01-14",0,38,328,0,19,328,0,0
"World","2024-01-15",0,0,328,0,68,396,0,0
"World","2024-01-16",0,137,465,0,69,465,0,0
"World","2024-01-17",0,1,466,0,1,466,0,0
"World","2024-01-18",0,0,466,0,1,467,0,0
"World","2024-01-19",0,2,468,0,1,468,0,0
"World","2024-01-20",0,2,470,0,2,470,0,0
"World","2024-01-21",0,77,547,0,77,547,0,0
"World","2024-01-22",0,0,547,0,51,598,0,0
"World","2024-01-23",0,102,649,0,51,649,0,0
"World","2024-01-24",0,6,655,0,6,655,0,0
"World","2024-01-25",0,0,655,0,12,667,0,0
"World","2024-01-26",0,0,655,0,12,679,0,0
"World","2024-01-27",0,0,655,0,13,692,0,0
"World","2024-01-28",0,49,704,0,12,704,0,0
"World","2024-01-29",0,0,704,0,72,776,0,0
"World","2024-01-30",0,144,848,0,72,848,0,0
"World","2024-01-31",0,303,1151,0,303,1151,0,0
"World","2024-02-01",0,0,1151,0,2,1153,0,0
"World","2024-02-02",0,5,1156,0,3,1156,0,0
"World","2024-02-03",0,0,1156,0,20,1176,0,0
"World","2024-02-04",0,40,1196,0,20,1196,0,0
"World","2024-02-05",0,3,1199,0,3,1199,0,0
"World","2024-02-06",0,106,1305,0,106,1305,0,0
"World","2024-02-07",0,0,1305,0,2,1307,0,0
"World","2024-02-08",0,0,1305,0,1,1308,0,0
"World","2024-02-09",0,5,1310,0,2,1310,0,0
"World","2024-02-10",0,0,1310,0,24,1334,0,0
"World","2024-02-11",0,47,1357,0,23,1357,0,0
"World","2024-02-12",0,0,1357,0,56,1413,0,0
"World","2024-02-13",0,112,1469,0,56,1469,0,0
"World","2024-02-14",0,0,1469,0,0,1469,0,0
"World","2024-02-15",0,1,1470,0,1,1470,0,0
"World","2024-02-16",0,1,1471,0,1,1471,0,0
"World","2024-02-17",0,0,1471,0,24,1495,0,0
"World","2024-02-18",0,47,1518,0,23,1518,0,0
"World","2024-02-19",0,0,1518,0,58,1576,0,0
"World","2024-02-20",0,115,1633,0,57,1633,0,0
"World","2024-02-21",0,0,1633,0,3,1636,0,0
"World","2024-02-22",0,0,1633,0,4,1640,0,0
"World","2024-02-23",0,10,1643,0,3,1643,0,0
"World","2024-02-24",0,0,1643,0,19,1662,0,0
"World","2024-02-25",0,38,1681,0,19,1681,0,0
"World","2024-02-26",0,0,1681,0,64,1745,0,0
"World","2024-02-27",0,127,1808,0,63,1808,0,0
"World","2024-02-28",0,15,1823,0,15,1823,0,0
"World","2024-02-29",0,309,2132,0,309,2132,0,0
"World","2024-03-01",0,4,2136,0,4,2136,0,0
"World","2024-03-02",0,1,2137,0,1,2137,0,0
"World","2024-03-03",0,53,2190,0,53,2190,0,0
"World","2024-03-04",0,0,2190,0,56,2246,0,0
"World","2024-03-05",0,111,2301,0,55,2301,0,0
"World","2024-03-06",0,10,2311,0,10,2311,0,0
"World","2024-03-07",0,0,2311,0,2,2313,0,0
"World","2024-03-08",0,3,2314,0,1,2314,0,0
"World","2024-03-09",0,0,2314,0,26,2340,0,0
"World","2024-03-10",0,51,2365,0,25,2365,0,0
"World","2024-03-11",0,0,2365,0,58,2423,0,0
"World","2024-03-12",0,115,2480,0,57,2480,0,0
"World","2024-03-13",0,0,2480,0,0,2480,0,0
"World","2024-03-14",0,1,2481,0,1,2481,0,0
"World","2024-03-15",0,3,2484,0,3,2484,0,0
"World","2024-03-16",0,0,2484,0,27,2511,0,0
"World","2024-03-17",0,54,2538,0,27,2538,0,0
"World","2024-03-18",0,0,2538,0,46,2584,0,0
"World","2024-03-19",0,93,2631,0,47,2631,0,0
"World","2024-03-20",0,0,2631,0,0,2631,0,0
"World","2024-03-21",0,0,2631,0,1,2632,0,0
"World","2024-03-22",0,1,2632,0,0,2632,0,0
"World","2024-03-23",0,0,2632,0,28,2660,0,0
"World","2024-03-24",0,55,2687,0,27,2687,0,0
"World","2024-03-25",0,0,2687,0,54,2741,0,0
"World","2024-03-26",0,108,2795,0,54,2795,0,0
"World","2024-03-27",0,0,2795,0,52,2847,0,0
"World","2024-03-28",0,0,2795,0,52,2899,0,0
"World","2024-03-29",0,0,2795,0,52,2951,0,0
"World","2024-03-30",0,0,2795,0,52,3003,0,0
"World","2024-03-31",0,260,3055,0,52,3055,0,0
"World","2024-04-01",0,6,3061,0,6,3061,0,0
"World","2024-04-02",0,86,3147,0,86,3147,0,0
"World","2024-04-03",0,0,3147,0,1,3148,0,0
"World","2024-04-04",0,0,3147,0,1,3149,0,0
"World","2024-04-05",0,3,3150,0,1,3150,0,0
"World","2024-04-06",0,0,3150,0,31,3181,0,0
"World","2024-04-07",0,62,3212,0,31,3212,0,0
"World","2024-04-08",0,0,3212,0,50,3262,0,0
"World","2024-04-09",0,99,3311,0,49,3311,0,0
"World","2024-04-10",0,0,3311,0,1,3312,0,0
"World","2024-04-11",0,0,3311,0,0,3312,0,0
"World","2024-04-12",0,2,3313,0,1,3313,0,0
"World","2024-04-13",0,0,3313,0,41,3354,0,0
"World","2024-04-14",0,82,3395,0,41,3395,0,0
"World","2024-04-15",0,0,3395,0,52,3447,0,0
"World","2024-04-16",0,103,3498,0,51,3498,0,0
"World","2024-04-17",0,0,3498,0,0,3498,0,0
"World","2024-04-18",0,0,3498,0,1,3499,0,0
"World","2024-04-19",0,1,3499,0,0,3499,0,0
"World","2024-04-20",0,1,3500,0,1,3500,0,0
"World","2024-04-21",0,64,3564,0,64,3564,0,0
"World","2024-04-22",0,0,3564,0,57,3621,0,0
"World","2024-04-23",0,114,3678,0,57,3678,0,0
"World","2024-04-24",0,0,3678,0,1,3679,0,0
"World","2024-04-25",0,0,3678,0,0,3679,0,0
"World","2024-04-26",0,2,3680,0,1,3680,0,0
"World","2024-04-27",0,1,3681,0,1,3681,0,0
"World","2024-04-28",0,108,3789,0,108,3789,0,0
"World","2024-04-29",0,0,3789,0,132,3921,0,0
"World","2024-04-30",0,264,4053,0,132,4053,0,0
"World","2024-05-01",0,0,4053,0,26,4079,0,0
"World","2024-05-02",0,0,4053,0,27,4106,0,0
"World","2024-05-03",0,0,4053,0,26,4132,0,0
"World","2024-05-04",0,0,4053,0,27,4159,0,0
"World","2024-05-05",0,132,4185,0,26,4185,0,0
"World","2024-05-06",0,0,4185,0,42,4227,0,0
"World","2024-05-07",0,83,4268,0,41,4268,0,0
"World","2024-05-08",0,0,4268,0,0,4268,0,0
"World","2024-05-09",0,1,4269,0,1,4269,0,0
"World","2024-05-10",0,25,4294,0,25,4294,0,0
"World","2024-05-11",0,0,4294,0,46,4340,0,0
"World","2024-05-12",0,93,4387,0,47,4387,0,0
"World","2024-05-13",0,0,4387,0,42,4429,0,0
"World","2024-05-14",0,83,4470,0,41,4470,0,0
"World","2024-05-15",0,0,4470,0,21,4491,0,0
"World","2024-05-16",0,0,4470,0,20,4511,0,0
"World","2024-05-17",0,0,4470,0,21,4532,0,0
"World","2024-05-18",0,0,4470,0,20,4552,0,0
"World","2024-05-19",0,103,4573,0,21,4573,0,0
"World","2024-05-20",0,0,4573,0,38,4611,0,0
"World","2024-05-21",0,75,4648,0,37,4648,0,0
"World","2024-05-22",0,1,4649,0,1,4649,0,0
"World","2024-05-23",0,0,4649,0,2,4651,0,0
"World","2024-05-24",0,4,4653,0,2,4653,0,0
"World","2024-05-25",0,0,4653,0,47,4700,0,0
"World","2024-05-26",0,94,4747,0,47,4747,0,0
"World","2024-05-27",0,1,4748,0,1,4748,0,0
"World","2024-05-28",0,86,4834,0,86,4834,0,0
"World","2024-05-29",0,0,4834,0,24,4858,0,0
"World","2024-05-30",0,49,4883,0,25,4883,0,0
"World","2024-05-31",0,215,5098,0,215,5098,0,0
"World","2024-06-01",0,0,5098,0,54,5152,0,0
"World","2024-06-02",0,108,5206,0,54,5206,0,0
"World","2024-06-03",0,0,5206,0,48,5254,0,0
"World","2024-06-04",0,96,5302,0,48,5302,0,0
"World","2024-06-05",0,0,5302,0,30,5332,0,0
"World","2024-06-06",0,0,5302,0,30,5362,0,0
"World","2024-06-07",0,0,5302,0,31,5393,0,0
"World","2024-06-08",0,0,5302,0,30,5423,0,0
"World","2024-06-09",0,151,5453,0,30,5453,0,0
"World","2024-06-10",0,0,5453,0,50,5503,0,0
"World","2024-06-11",0,100,5553,0,50,5553,0,0
"World","2024-06-12",0,0,5553,0,41,5594,0,0
"World","2024-06-13",0,0,5553,0,41,5635,0,0
"World","2024-06-14",0,0,5553,0,40,5675,0,0
"World","2024-06-15",0,0,5553,0,41,5716,0,0
"World","2024-06-16",0,204,5757,0,41,5757,0,0
"World","2024-06-17",0,0,5757,0,33,5790,0,0
"World","2024-06-18",0,66,5823,0,33,5823,0,0
"World","2024-06-19",0,0,5823,0,37,5860,0,0
"World","2024-06-20",0,0,5823,0,38,5898,0,0
"World","2024-06-21",0,0,5823,0,37,5935,0,0
"World","2024-06-22",0,0,5823,0,38,5973,0,0
"World","2024-06-23",0,187,6010,0,37,6010,0,0
"World","2024-06-24",0,4,6014,0,4,6014,0,0
"World","2024-06-25",0,87,6101,0,87,6101,0,0
"World","2024-06-26",0,0,6101,0,2,6103,0,0
"World","2024-06-27",0,0,6101,0,3,6106,0,0
"World","2024-06-28",0,7,6108,0,2,6108,0,0
"World","2024-06-29",0,0,6108,0,209,6317,0,0
"World","2024-06-30",0,418,6526,0,209,6526,0,0
"World","2024-07-01",0,2,6528,0,2,6528,0,0
"World","2024-07-02",0,95,6623,0,95,6623,0,0
"World","2024-07-03",0,0,6623,0,34,6657,0,0
"World","2024-07-04",0,0,6623,0,34,6691,0,0
"World","2024-07-05",0,0,6623,0,34,6725,0,0
"World","2024-07-06",0,0,6623,0,34,6759,0,0
"World","2024-07-07",0,170,6793,0,34,6793,0,0
"World","2024-07-08",0,2,6795,0,2,6795,0,0
"World","2024-07-09",0,105,6900,0,105,6900,0,0
"World","2024-07-10",0,0,6900,0,1,6901,0,0
"World","2024-07-11",0,0,6900,0,0,6901,0,0
"World","2024-07-12",0,2,6902,0,1,6902,0,0
"World","2024-07-13",0,1,6903,0,1,6903,0,0
"World","2024-07-14",0,234,7137,0,234,7137,0,0
"World","2024-07-15",0,14,7151,0,14,7151,0,0
"World","2024-07-16",0,118,7269,0,118,7269,0,0
"World","2024-07-17",0,0,7269,0,51,7320,0,0
"World","2024-07-18",0,0,7269,0,51,7371,0,0
"World","2024-07-19",0,0,7269,0,50,7421,0,0
"World","2024-07-20",0,0,7269,0,51,7472,0,0
"World","2024-07-21",0,254,7523,0,51,7523,0,0
"World","2024-07-22",0,21,7544,0,21,7544,0,0
"World","2024-07-23",0,101,7645,0,101,7645,0,0
"World","2024-07-24",0,0,7645,0,5,7650,0,0
"World","2024-07-25",0,0,7645,0,5,7655,0,0
"World","2024-07-26",0,0,7645,0,6,7661,0,0
"World","2024-07-27",0,21,7666,0,5,7666,0,0
"World","2024-07-28",0,266,7932,0,266,7932,0,0
"World","2024-07-29",0,0,7932,0,94,8026,0,0
"World","2024-07-30",0,189,8121,0,95,8121,0,0
"World","2024-07-31",0,188,8309,0,188,8309,0,0
"World","2024-08-01",0,0,8309,0,3,8312,0,0
"World","2024-08-02",0,6,8315,0,3,8315,0,0
"World","2024-08-03",0,0,8315,0,87,8402,0,0
"World","2024-08-04",0,174,8489,0,87,8489,0,0
"World","2024-08-05",0,1,8490,0,1,8490,0,0
"World","2024-08-06",0,149,8639,0,149,8639,0,0
"World","2024-08-07",0,0,8639,0,49,8688,0,0
"World","2024-08-08",0,0,8639,0,49,8737,0,0
"World","2024-08-09",0,0,8639,0,49,8786,0,0
"World","2024-08-10",0,0,8639,0,49,8835,0,0
"World","2024-08-11",0,245,8884,0,49,8884,0,0
"World","2024-08-12",0,0,8884,0,84,8968,0,0
"World","2024-08-13",0,169,9053,0,85,9053,0,0
"World","2024-08-14",0,1,9054,0,1,9054,0,0
"World","2024-08-15",0,2,9056,0,2,9056,0,0
"World","2024-08-16",0,0,9056,0,84,9140,0,0
"World","2024-08-17",0,0,9056,0,85,9225,0,0
"World","2024-08-18",0,253,9309,0,84,9309,0,0
"World","2024-08-19",0,1,9310,0,1,9310,0,0
"World","2024-08-20",0,183,9493,0,183,9493,0,0
"World","2024-08-21",0,75,9568,0,75,9568,0,0
"World","2024-08-22",0,2,9570,0,2,9570,0,0
"World","2024-08-23",0,1,9571,0,1,9571,0,0
"World","2024-08-24",0,0,9571,0,143,9714,0,0
"World","2024-08-25",0,286,9857,0,143,9857,0,0
"World","2024-08-26",0,0,9857,0,96,9953,0,0
"World","2024-08-27",0,191,10048,0,95,10048,0,0
"World","2024-08-28",0,4,10052,0,4,10052,0,0
"World","2024-08-29",0,70,10122,0,70,10122,0,0
"World","2024-08-30",0,1,10123,0,1,10123,0,0
"World","2024-08-31",0,451,10574,0,451,10574,0,0
"World","2024-09-01",0,319,10893,0,319,10893,0,0
"World","2024-09-02",0,1,10894,0,1,10894,0,0
"World","2024-09-03",0,190,11084,0,190,11084,0,0
"World","2024-09-04",0,0,11084,0,74,11158,0,0
"World","2024-09-05",0,0,11084,0,73,11231,0,0
"World","2024-09-06",0,0,11084,0,74,11305,0,0
"World","2024-09-07",0,0,11084,0,73,11378,0,0
"World","2024-09-08",0,368,11452,0,74,11452,0,0
"World","2024-09-09",0,0,11452,0,83,11535,0,0
"World","2024-09-10",0,166,11618,0,83,11618,0,0
"World","2024-09-11",0,0,11618,0,0,11618,0,0
"World","2024-09-12",0,1,11619,0,1,11619,0,0
"World","2024-09-13",0,0,11619,0,173,11792,0,0
"World","2024-09-14",0,0,11619,0,173,11965,0,0
"World","2024-09-15",0,519,12138,0,173,12138,0,0
"World","2024-09-16",0,0,12138,0,74,12212,0,0
"World","2024-09-17",0,148,12286,0,74,12286,0,0
"World","2024-09-18",0,1,12287,0,1,12287,0,0
"World","2024-09-19",0,0,12287,0,140,12427,0,0
"World","2024-09-20",0,0,12287,0,141,12568,0,0
"World","2024-09-21",0,0,12287,0,141,12709,0,0
"World","2024-09-22",0,562,12849,0,140,12849,0,0
"World","2024-09-23",0,3,12852,0,3,12852,0,0
"World","2024-09-24",0,151,13003,0,151,13003,0,0
"World","2024-09-25",0,0,13003,0,8,13011,0,0
"World","2024-09-26",0,15,13018,0,7,13018,0,0
"World","2024-09-27",0,0,13018,0,2,13020,0,0
"World","2024-09-28",0,3,13021,0,1,13021,0,0
"World","2024-09-29",0,517,13538,0,517,13538,0,0
"World","2024-09-30",0,257,13795,0,257,13795,0,0
"World","2024-10-01",0,169,13964,0,169,13964,0,0
"World","2024-10-02",0,1,13965,0,1,13965,0,0
"World","2024-10-03",0,2,13967,0,2,13967,0,0
"World","2024-10-04",0,1,13968,0,1,13968,0,0
"World","2024-10-05",0,0,13968,0,249,14217,0,0
"World","2024-10-06",0,498,14466,0,249,14466,0,0
"World","2024-10-07",0,23,14489,0,23,14489,0,0
"World","2024-10-08",0,129,14618,0,129,14618,0,0
"World","2024-10-09",0,0,14618,0,1,14619,0,0
"World","2024-10-10",0,2,14620,0,1,14620,0,0
"World","2024-10-11",0,2,14622,0,2,14622,0,0
"World","2024-10-12",0,1,14623,0,1,14623,0,0
"World","2024-10-13",0,552,15175,0,552,15175,0,0
"World","2024-10-14",0,0,15175,0,60,15235,0,0
"World","2024-10-15",0,120,15295,0,60,15295,0,0
"World","2024-10-16",0,0,15295,0,1,15296,0,0
"World","2024-10-17",0,0,15295,0,0,15296,0,0
"World","2024-10-18",0,2,15297,0,1,15297,0,0
"World","2024-10-19",0,0,15297,0,308,15605,0,0
"World","2024-10-20",0,617,15914,0,309,15914,0,0
"World","2024-10-21",0,0,15914,0,70,15984,0,0
"World","2024-10-22",0,140,16054,0,70,16054,0,0
"World","2024-10-23",0,2,16056,0,2,16056,0,0
"World","2024-10-24",0,0,16056,0,1,16057,0,0
"World","2024-10-25",0,0,16056,0,1,16058,0,0
"World","2024-10-26",0,3,16059,0,1,16059,0,0
"World","2024-10-27",0,680,16739,0,680,16739,0,0
"World","2024-10-28",0,0,16739,0,64,16803,0,0
"World","2024-10-29",0,129,16868,0,65,16868,0,0
"World","2024-10-30",0,5,16873,0,5,16873,0,0
"World","2024-10-31",0,286,17159,0,286,17159,0,0
"World","2024-11-01",0,2,17161,0,2,17161,0,0
"World","2024-11-02",0,0,17161,0,374,17535,0,0
"World","2024-11-03",0,748,17909,0,374,17909,0,0
"World","2024-11-04",0,1,17910,0,1,17910,0,0
"World","2024-11-05",0,130,18040,0,130,18040,0,0
"World","2024-11-06",0,3,18043,0,3,18043,0,0
"World","2024-11-07",0,0,18043,0,196,18239,0,0
"World","2024-11-08",0,0,18043,0,196,18435,0,0
"World","2024-11-09",0,0,18043,0,197,18632,0,0
"World","2024-11-10",0,785,18828,0,196,18828,0,0
"World","2024-11-11",0,0,18828,0,54,18882,0,0
"World","2024-11-12",0,107,18935,0,53,18935,0,0
"World","2024-11-13",0,0,18935,0,2,18937,0,0
"World","2024-11-14",0,0,18935,0,3,18940,0,0
"World","2024-11-15",0,7,18942,0,2,18942,0,0
"World","2024-11-16",0,0,18942,0,410,19352,0,0
"World","2024-11-17",0,820,19762,0,410,19762,0,0
"World","2024-11-18",0,0,19762,0,48,19810,0,0
"World","2024-11-19",0,97,19859,0,49,19859,0,0
"World","2024-11-20",0,1,19860,0,1,19860,0,0
"World","2024-11-21",0,0,19860,0,186,20046,0,0
"World","2024-11-22",0,0,19860,0,186,20232,0,0
"World","2024-11-23",0,0,19860,0,187,20419,0,0
"World","2024-11-24",0,745,20605,0,186,20605,0,0
"World","2024-11-25",0,0,20605,0,46,20651,0,0
"World","2024-11-26",0,93,20698,0,47,20698,0,0
"World","2024-11-27",0,24,20722,0,24,20722,0,0
"World","2024-11-28",0,0,20722,0,0,20722,0,0
"World","2024-11-29",0,1,20723,0,1,20723,0,0
"World","2024-11-30",0,307,21030,0,307,21030,0,0
"World","2024-12-01",0,727,21757,0,727,21757,0,0
"World","2024-12-02",0,0,21757,0,41,21798,0,0
"World","2024-12-03",0,82,21839,0,41,21839,0,0
"World","2024-12-04",0,0,21839,0,2,21841,0,0
"World","2024-12-05",0,3,21842,0,1,21842,0,0
"World","2024-12-06",0,0,21842,0,223,22065,0,0
"World","2024-12-07",0,0,21842,0,223,22288,0,0
"World","2024-12-08",0,669,22511,0,223,22511,0,0
"World","2024-12-09",0,27,22538,0,27,22538,0,0
"World","2024-12-10",0,68,22606,0,68,22606,0,0
"World","2024-12-11",0,0,22606,0,121,22727,0,0
"World","2024-12-12",0,0,22606,0,121,22848,0,0
"World","2024-12-13",0,0,22606,0,120,22968,0,0
"World","2024-12-14",0,0,22606,0,121,23089,0,0
"World","2024-12-15",0,604,23210,0,121,23210,0,0
"World","2024-12-16",0,0,23210,0,29,23239,0,0
"World","2024-12-17",0,58,23268,0,29,23268,0,0
"World","2024-12-18",0,0,23268,0,109,23377,0,0
"World","2024-12-19",0,0,23268,0,109,23486,0,0
"World","2024-12-20",0,0,23268,0,109,23595,0,0
"World","2024-12-21",0,0,23268,0,109,23704,0,0
"World","2024-12-22",0,545,23813,0,109,23813,0,0
"World","2024-12-23",0,0,23813,0,28,23841,0,0
"World","2024-12-24",0,56,23869,0,28,23869,0,0
"World","2024-12-25",0,0,23869,0,4,23873,0,0
"World","2024-12-26",0,7,23876,0,3,23876,0,0
"World","2024-12-27",0,1,23877,0,1,23877,0,0
"World","2024-12-28",0,0,23877,0,216,24093,0,0
"World","2024-12-29",0,431,24308,0,215,24308,0,0
"World","2024-12-30",0,0,24308,0,138,24446,0,0
"World","2024-12-31",0,276,24584,0,138,24584,0,0
"World","2025-01-01",0,0,24584,0,0,24584,0,0
"World","2025-01-02",0,0,24584,0,1,24585,0,0
"World","2025-01-03",0,1,24585,0,0,24585,0,0
"World","2025-01-04",0,0,24585,0,454,25039,0,0
"World","2025-01-05",0,908,25493,0,454,25493,0,0
"World","2025-01-06",0,0,25493,0,15,25508,0,0
"World","2025-01-07",0,30,25523,0,15,25523,0,0
"World","2025-01-08",0,33,25556,0,33,25556,0,0
"World","2025-01-09",0,0,25556,0,122,25678,0,0
"World","2025-01-10",0,244,25800,0,122,25800,0,0
"World","2025-01-11",0,0,25800,0,543,26343,0,0
"World","2025-01-12",0,1086,26886,0,543,26886,0,0
"World","2025-01-13",0,0,26886,0,13,26899,0,0
"World","2025-01-14",0,26,26912,0,13,26912,0,0
"World","2025-01-15",0,0,26912,0,0,26912,0,0
"World","2025-01-16",0,0,26912,0,1,26913,0,0
"World","2025-01-17",0,1,26913,0,0,26913,0,0
"World","2025-01-18",0,0,26913,0,465,27378,0,0
"World","2025-01-19",0,930,27843,0,465,27843,0,0
"World","2025-01-20",0,0,27843,0,17,27860,0,0
"World","2025-01-21",0,34,27877,0,17,27877,0,0
"World","2025-01-22",0,0,27877,0,0,27877,0,0
"World","2025-01-23",0,0,27877,0,1,27878,0,0
"World","2025-01-24",0,1,27878,0,0,27878,0,0
"World","2025-01-25",0,2,27880,0,2,27880,0,0
"World","2025-01-26",0,779,28659,0,779,28659,0,0
"World","2025-01-27",0,0,28659,0,10,28669,0,0
"World","2025-01-28",0,20,28679,0,10,28679,0,0
"World","2025-01-29",0,1,28680,0,1,28680,0,0
"World","2025-01-30",0,0,28680,0,21,28701,0,0
"World","2025-01-31",0,42,28722,0,21,28722,0,0
"World","2025-02-01",0,0,28722,0,158,28880,0,0
"World","2025-02-02",0,315,29037,0,157,29037,0,0
"World","2025-02-03",0,0,29037,0,1,29038,0,0
"World","2025-02-04",0,2,29039,0,1,29039,0,0
"World","2025-02-05",0,1,29040,0,1,29040,0,0
"World","2025-02-06",0,1,29041,0,1,29041,0,0
"World","2025-02-07",0,4,29045,0,4,29045,0,0
"World","2025-02-08",0,0,29045,0,162,29207,0,0
"World","2025-02-09",0,325,29370,0,163,29370,0,0
"World","2025-02-10",0,0,29370,0,50,29420,0,0
"World","2025-02-11",0,100,29470,0,50,29470,0,0
"World","2025-02-12",0,1,29471,0,1,29471,0,0
"World","2025-02-13",0,2,29473,0,2,29473,0,0
"World","2025-02-14",0,0,29473,0,18,29491,0,0
"World","2025-02-15",0,0,29473,0,18,29509,0,0
"World","2025-02-16",0,54,29527,0,18,29527,0,0
"World","2025-02-17",0,0,29527,0,0,29527,0,0
"World","2025-02-18",0,0,29527,0,0,29527,0,0
"World","2025-02-19",0,0,29527,0,0,29527,0,0
"World","2025-02-20",0,0,29527,0,0,29527,0,0
"World","2025-02-21",0,0,29527,0,0,29527,0,0
"World","2025-02-22",0,0,29527,0,0,29527,0,0
"World","2025-02-23",0,0,29527,0,0,29527,0,0
"World","2025-02-24",0,0,29527,0,0,29527,0,0
"World","2025-02-25",0,0,29527,0,0,29527,0,0
"World","2025-02-26",0,0,29527,0,0,29527,0,0
"World","2025-02-27",0,0,29527,0,0,29527,0,0
"World","2025-02-28",0,0,29527,0,0,29527,0,0
"World","2025-03-01",0,0,29527,0,0,29527,0,0
"World","2025-03-02",0,0,29527,0,0,29527,0,0
"World","2025-03-03",0,0,29527,0,0,29527,0,0
"Zambia","2024-01-01",0,0,0,0,0,0,0,0
"Zambia","2024-01-02",0,0,0,0,0,0,0,0
"Zambia","2024-01-03",0,0,0,0,0,0,0,0
"Zambia","2024-01-04",0,0,0,0,0,0,0,0
"Zambia","2024-01-05",0,0,0,0,0,0,0,0
"Zambia","2024-01-06",0,0,0,0,0,0,0,0
"Zambia","2024-01-07",0,0,0,0,0,0,0,0
"Zambia","2024-01-08",0,0,0,0,0,0,0,0
"Zambia","2024-01-09",0,0,0,0,0,0,0,0
"Zambia","2024-01-10",0,0,0,0,0,0,0,0
"Zambia","2024-01-11",0,0,0,0,0,0,0,0
"Zambia","2024-01-12",0,0,0,0,0,0,0,0
"Zambia","2024-01-13",0,0,0,0,0,0,0,0
"Zambia","2024-01-14",0,0,0,0,0,0,0,0
"Zambia","2024-01-15",0,0,0,0,0,0,0,0
"Zambia","2024-01-16",0,0,0,0,0,0,0,0
"Zambia","2024-01-17",0,0,0,0,0,0,0,0
"Zambia","2024-01-18",0,0,0,0,0,0,0,0
"Zambia","2024-01-19",0,0,0,0,0,0,0,0
"Zambia","2024-01-20",0,0,0,0,0,0,0,0
"Zambia","2024-01-21",0,0,0,0,0,0,0,0
"Zambia","2024-01-22",0,0,0,0,0,0,0,0
"Zambia","2024-01-23",0,0,0,0,0,0,0,0
"Zambia","2024-01-24",0,0,0,0,0,0,0,0
"Zambia","2024-01-25",0,0,0,0,0,0,0,0
"Zambia","2024-01-26",0,0,0,0,0,0,0,0
"Zambia","2024-01-27",0,0,0,0,0,0,0,0
"Zambia","2024-01-28",0,0,0,0,0,0,0,0
"Zambia","2024-01-29",0,0,0,0,0,0,0,0
"Zambia","2024-01-30",0,0,0,0,0,0,0,0
"Zambia","2024-01-31",0,0,0,0,0,0,0,0
"Zambia","2024-02-01",0,0,0,0,0,0,0,0
"Zambia","2024-02-02",0,0,0,0,0,0,0,0
"Zambia","2024-02-03",0,0,0,0,0,0,0,0
"Zambia","2024-02-04",0,0,0,0,0,0,0,0
"Zambia","2024-02-05",0,0,0,0,0,0,0,0
"Zambia","2024-02-06",0,0,0,0,0,0,0,0
"Zambia","2024-02-07",0,0,0,0,0,0,0,0
"Zambia","2024-02-08",0,0,0,0,0,0,0,0
"Zambia","2024-02-09",0,0,0,0,0,0,0,0
"Zambia","2024-02-10",0,0,0,0,0,0,0,0
"Zambia","2024-02-11",0,0,0,0,0,0,0,0
"Zambia","2024-02-12",0,0,0,0,0,0,0,0
"Zambia","2024-02-13",0,0,0,0,0,0,0,0
"Zambia","2024-02-14",0,0,0,0,0,0,0,0
"Zambia","2024-02-15",0,0,0,0,0,0,0,0
"Zambia","2024-02-16",0,0,0,0,0,0,0,0
"Zambia","2024-02-17",0,0,0,0,0,0,0,0
"Zambia","2024-02-18",0,0,0,0,0,0,0,0
"Zambia","2024-02-19",0,0,0,0,0,0,0,0
"Zambia","2024-02-20",0,0,0,0,0,0,0,0
"Zambia","2024-02-21",0,0,0,0,0,0,0,0
"Zambia","2024-02-22",0,0,0,0,0,0,0,0
"Zambia","2024-02-23",0,0,0,0,0,0,0,0
"Zambia","2024-02-24",0,0,0,0,0,0,0,0
"Zambia","2024-02-25",0,0,0,0,0,0,0,0
"Zambia","2024-02-26",0,0,0,0,0,0,0,0
"Zambia","2024-02-27",0,0,0,0,0,0,0,0
"Zambia","2024-02-28",0,0,0,0,0,0,0,0
"Zambia","2024-02-29",0,0,0,0,0,0,0,0
"Zambia","2024-03-01",0,0,0,0,0,0,0,0
"Zambia","2024-03-02",0,0,0,0,0,0,0,0
"Zambia","2024-03-03",0,0,0,0,0,0,0,0
"Zambia","2024-03-04",0,0,0,0,0,0,0,0
"Zambia","2024-03-05",0,0,0,0,0,0,0,0
"Zambia","2024-03-06",0,0,0,0,0,0,0,0
"Zambia","2024-03-07",0,0,0,0,0,0,0,0
"Zambia","2024-03-08",0,0,0,0,0,0,0,0
"Zambia","2024-03-09",0,0,0,0,0,0,0,0
"Zambia","2024-03-10",0,0,0,0,0,0,0,0
"Zambia","2024-03-11",0,0,0,0,0,0,0,0
"Zambia","2024-03-12",0,0,0,0,0,0,0,0
"Zambia","2024-03-13",0,0,0,0,0,0,0,0
"Zambia","2024-03-14",0,0,0,0,0,0,0,0
"Zambia","2024-03-15",0,0,0,0,0,0,0,0
"Zambia","2024-03-16",0,0,0,0,0,0,0,0
"Zambia","2024-03-17",0,0,0,0,0,0,0,0
"Zambia","2024-03-18",0,0,0,0,0,0,0,0
"Zambia","2024-03-19",0,0,0,0,0,0,0,0
"Zambia","2024-03-20",0,0,0,0,0,0,0,0
"Zambia","2024-03-21",0,0,0,0,0,0,0,0
"Zambia","2024-03-22",0,0,0,0,0,0,0,0
"Zambia","2024-03-23",0,0,0,0,0,0,0,0
"Zambia","2024-03-24",0,0,0,0,0,0,0,0
"Zambia","2024-03-25",0,0,0,0,0,0,0,0
"Zambia","2024-03-26",0,0,0,0,0,0,0,0
"Zambia","2024-03-27",0,0,0,0,0,0,0,0
"Zambia","2024-03-28",0,0,0,0,0,0,0,0
"Zambia","2024-03-29",0,0,0,0,0,0,0,0
"Zambia","2024-03-30",0,0,0,0,0,0,0,0
"Zambia","2024-03-31",0,0,0,0,0,0,0,0
"Zambia","2024-04-01",0,0,0,0,0,0,0,0
"Zambia","2024-04-02",0,0,0,0,0,0,0,0
"Zambia","2024-04-03",0,0,0,0,0,0,0,0
"Zambia","2024-04-04",0,0,0,0,0,0,0,0
"Zambia","2024-04-05",0,0,0,0,0,0,0,0
"Zambia","2024-04-06",0,0,0,0,0,0,0,0
"Zambia","2024-04-07",0,0,0,0,0,0,0,0
"Zambia","2024-04-08",0,0,0,0,0,0,0,0
"Zambia","2024-04-09",0,0,0,0,0,0,0,0
"Zambia","2024-04-10",0,0,0,0,0,0,0,0
"Zambia","2024-04-11",0,0,0,0,0,0,0,0
"Zambia","2024-04-12",0,0,0,0,0,0,0,0
"Zambia","2024-04-13",0,0,0,0,0,0,0,0
"Zambia","2024-04-14",0,0,0,0,0,0,0,0
"Zambia","2024-04-15",0,0,0,0,0,0,0,0
"Zambia","2024-04-16",0,0,0,0,0,0,0,0
"Zambia","2024-04-17",0,0,0,0,0,0,0,0
"Zambia","2024-04-18",0,0,0,0,0,0,0,0
"Zambia","2024-04-19",0,0,0,0,0,0,0,0
"Zambia","2024-04-20",0,0,0,0,0,0,0,0
"Zambia","2024-04-21",0,0,0,0,0,0,0,0
"Zambia","2024-04-22",0,0,0,0,0,0,0,0
"Zambia","2024-04-23",0,0,0,0,0,0,0,0
"Zambia","2024-04-24",0,0,0,0,0,0,0,0
"Zambia","2024-04-25",0,0,0,0,0,0,0,0
"Zambia","2024-04-26",0,0,0,0,0,0,0,0
"Zambia","2024-04-27",0,0,0,0,0,0,0,0
"Zambia","2024-04-28",0,0,0,0,0,0,0,0
"Zambia","2024-04-29",0,0,0,0,0,0,0,0
"Zambia","2024-04-30",0,0,0,0,0,0,0,0
"Zambia","2024-05-01",0,0,0,0,0,0,0,0
"Zambia","2024-05-02",0,0,0,0,0,0,0,0
"Zambia","2024-05-03",0,0,0,0,0,0,0,0
"Zambia","2024-05-04",0,0,0,0,0,0,0,0
"Zambia","2024-05-05",0,0,0,0,0,0,0,0
"Zambia","2024-05-06",0,0,0,0,0,0,0,0
"Zambia","2024-05-07",0,0,0,0,0,0,0,0
"Zambia","2024-05-08",0,0,0,0,0,0,0,0
"Zambia","2024-05-09",0,0,0,0,0,0,0,0
"Zambia","2024-05-10",0,0,0,0,0,0,0,0
"Zambia","2024-05-11",0,0,0,0,0,0,0,0
"Zambia","2024-05-12",0,0,0,0,0,0,0,0
"Zambia","2024-05-13",0,0,0,0,0,0,0,0
"Zambia","2024-05-14",0,0,0,0,0,0,0,0
"Zambia","2024-05-15",0,0,0,0,0,0,0,0
"Zambia","2024-05-16",0,0,0,0,0,0,0,0
"Zambia","2024-05-17",0,0,0,0,0,0,0,0
"Zambia","2024-05-18",0,0,0,0,0,0,0,0
"Zambia","2024-05-19",0,0,0,0,0,0,0,0
"Zambia","2024-05-20",0,0,0,0,0,0,0,0
"Zambia","2024-05-21",0,0,0,0,0,0,0,0
"Zambia","2024-05-22",0,0,0,0,0,0,0,0
"Zambia","2024-05-23",0,0,0,0,0,0,0,0
"Zambia","2024-05-24",0,0,0,0,0,0,0,0
"Zambia","2024-05-25",0,0,0,0,0,0,0,0
"Zambia","2024-05-26",0,0,0,0,0,0,0,0
"Zambia","2024-05-27",0,0,0,0,0,0,0,0
"Zambia","2024-05-28",0,0,0,0,0,0,0,0
"Zambia","2024-05-29",0,0,0,0,0,0,0,0
"Zambia","2024-05-30",0,0,0,0,0,0,0,0
"Zambia","2024-05-31",0,0,0,0,0,0,0,0
"Zambia","2024-06-01",0,0,0,0,0,0,0,0
"Zambia","2024-06-02",0,0,0,0,0,0,0,0
"Zambia","2024-06-03",0,0,0,0,0,0,0,0
"Zambia","2024-06-04",0,0,0,0,0,0,0,0
"Zambia","2024-06-05",0,0,0,0,0,0,0,0
"Zambia","2024-06-06",0,0,0,0,0,0,0,0
"Zambia","2024-06-07",0,0,0,0,0,0,0,0
"Zambia","2024-06-08",0,0,0,0,0,0,0,0
"Zambia","2024-06-09",0,0,0,0,0,0,0,0
"Zambia","2024-06-10",0,0,0,0,0,0,0,0
"Zambia","2024-06-11",0,0,0,0,0,0,0,0
"Zambia","2024-06-12",0,0,0,0,0,0,0,0
"Zambia","2024-06-13",0,0,0,0,0,0,0,0
"Zambia","2024-06-14",0,0,0,0,0,0,0,0
"Zambia","2024-06-15",0,0,0,0,0,0,0,0
"Zambia","2024-06-16",0,0,0,0,0,0,0,0
"Zambia","2024-06-17",0,0,0,0,0,0,0,0
"Zambia","2024-06-18",0,0,0,0,0,0,0,0
"Zambia","2024-06-19",0,0,0,0,0,0,0,0
"Zambia","2024-06-20",0,0,0,0,0,0,0,0
"Zambia","2024-06-21",0,0,0,0,0,0,0,0
"Zambia","2024-06-22",0,0,0,0,0,0,0,0
"Zambia","2024-06-23",0,0,0,0,0,0,0,0
"Zambia","2024-06-24",0,0,0,0,0,0,0,0
"Zambia","2024-06-25",0,0,0,0,0,0,0,0
"Zambia","2024-06-26",0,0,0,0,0,0,0,0
"Zambia","2024-06-27",0,0,0,0,0,0,0,0
"Zambia","2024-06-28",0,0,0,0,0,0,0,0
"Zambia","2024-06-29",0,0,0,0,0,0,0,0
"Zambia","2024-06-30",0,0,0,0,0,0,0,0
"Zambia","2024-07-01",0,0,0,0,0,0,0,0
"Zambia","2024-07-02",0,0,0,0,0,0,0,0
"Zambia","2024-07-03",0,0,0,0,0,0,0,0
"Zambia","2024-07-04",0,0,0,0,0,0,0,0
"Zambia","2024-07-05",0,0,0,0,0,0,0,0
"Zambia","2024-07-06",0,0,0,0,0,0,0,0
"Zambia","2024-07-07",0,0,0,0,0,0,0,0
"Zambia","2024-07-08",0,0,0,0,0,0,0,0
"Zambia","2024-07-09",0,0,0,0,0,0,0,0
"Zambia","2024-07-10",0,0,0,0,0,0,0,0
"Zambia","2024-07-11",0,0,0,0,0,0,0,0
"Zambia","2024-07-12",0,0,0,0,0,0,0,0
"Zambia","2024-07-13",0,0,0,0,0,0,0,0
"Zambia","2024-07-14",0,0,0,0,0,0,0,0
"Zambia","2024-07-15",0,0,0,0,0,0,0,0
"Zambia","2024-07-16",0,0,0,0,0,0,0,0
"Zambia","2024-07-17",0,0,0,0,0,0,0,0
"Zambia","2024-07-18",0,0,0,0,0,0,0,0
"Zambia","2024-07-19",0,0,0,0,0,0,0,0
"Zambia","2024-07-20",0,0,0,0,0,0,0,0
"Zambia","2024-07-21",0,0,0,0,0,0,0,0
"Zambia","2024-07-22",0,0,0,0,0,0,0,0
"Zambia","2024-07-23",0,0,0,0,0,0,0,0
"Zambia","2024-07-24",0,0,0,0,0,0,0,0
"Zambia","2024-07-25",0,0,0,0,0,0,0,0
"Zambia","2024-07-26",0,0,0,0,0,0,0,0
"Zambia","2024-07-27",0,0,0,0,0,0,0,0
"Zambia","2024-07-28",0,0,0,0,0,0,0,0
"Zambia","2024-07-29",0,0,0,0,0,0,0,0
"Zambia","2024-07-30",0,0,0,0,0,0,0,0
"Zambia","2024-07-31",0,0,0,0,0,0,0,0
"Zambia","2024-08-01",0,0,0,0,0,0,0,0
"Zambia","2024-08-02",0,0,0,0,0,0,0,0
"Zambia","2024-08-03",0,0,0,0,0,0,0,0
"Zambia","2024-08-04",0,0,0,0,0,0,0,0
"Zambia","2024-08-05",0,0,0,0,0,0,0,0
"Zambia","2024-08-06",0,0,0,0,0,0,0,0
"Zambia","2024-08-07",0,0,0,0,0,0,0,0
"Zambia","2024-08-08",0,0,0,0,0,0,0,0
"Zambia","2024-08-09",0,0,0,0,0,0,0,0
"Zambia","2024-08-10",0,0,0,0,0,0,0,0
"Zambia","2024-08-11",0,0,0,0,0,0,0,0
"Zambia","2024-08-12",0,0,0,0,0,0,0,0
"Zambia","2024-08-13",0,0,0,0,0,0,0,0
"Zambia","2024-08-14",0,0,0,0,0,0,0,0
"Zambia","2024-08-15",0,0,0,0,0,0,0,0
"Zambia","2024-08-16",0,0,0,0,0,0,0,0
"Zambia","2024-08-17",0,0,0,0,0,0,0,0
"Zambia","2024-08-18",0,0,0,0,0,0,0,0
"Zambia","2024-08-19",0,0,0,0,0,0,0,0
"Zambia","2024-08-20",0,0,0,0,0,0,0,0
"Zambia","2024-08-21",0,0,0,0,0,0,0,0
"Zambia","2024-08-22",0,0,0,0,0,0,0,0
"Zambia","2024-08-23",0,0,0,0,0,0,0,0
"Zambia","2024-08-24",0,0,0,0,0,0,0,0
"Zambia","2024-08-25",0,0,0,0,0,0,0,0
"Zambia","2024-08-26",0,0,0,0,0,0,0,0
"Zambia","2024-08-27",0,0,0,0,0,0,0,0
"Zambia","2024-08-28",0,0,0,0,0,0,0,0
"Zambia","2024-08-29",0,0,0,0,0,0,0,0
"Zambia","2024-08-30",0,0,0,0,0,0,0,0
"Zambia","2024-08-31",0,0,0,0,0,0,0,0
"Zambia","2024-09-01",0,0,0,0,0,0,0,0
"Zambia","2024-09-02",0,0,0,0,0,0,0,0
"Zambia","2024-09-03",0,0,0,0,0,0,0,0
"Zambia","2024-09-04",0,0,0,0,0,0,0,0
"Zambia","2024-09-05",0,0,0,0,0,0,0,0
"Zambia","2024-09-06",0,0,0,0,0,0,0,0
"Zambia","2024-09-07",0,0,0,0,0,0,0,0
"Zambia","2024-09-08",0,0,0,0,0,0,0,0
"Zambia","2024-09-09",0,0,0,0,0,0,0,0
"Zambia","2024-09-10",0,0,0,0,0,0,0,0
"Zambia","2024-09-11",0,0,0,0,0,0,0,0
"Zambia","2024-09-12",0,0,0,0,0,0,0,0
"Zambia","2024-09-13",0,0,0,0,0,0,0,0
"Zambia","2024-09-14",0,0,0,0,0,0,0,0
"Zambia","2024-09-15",0,0,0,0,0,0,0,0
"Zambia","2024-09-16",0,0,0,0,0,0,0,0
"Zambia","2024-09-17",0,0,0,0,0,0,0,0
"Zambia","2024-09-18",0,0,0,0,0,0,0,0
"Zambia","2024-09-19",0,0,0,0,0,0,0,0
"Zambia","2024-09-20",0,0,0,0,0,0,0,0
"Zambia","2024-09-21",0,0,0,0,0,0,0,0
"Zambia","2024-09-22",0,0,0,0,0,0,0,0
"Zambia","2024-09-23",0,0,0,0,0,0,0,0
"Zambia","2024-09-24",0,0,0,0,0,0,0,0
"Zambia","2024-09-25",0,0,0,0,0,0,0,0
"Zambia","2024-09-26",0,0,0,0,0,0,0,0
"Zambia","2024-09-27",0,0,0,0,0,0,0,0
"Zambia","2024-09-28",0,0,0,0,0,0,0,0
"Zambia","2024-09-29",0,0,0,0,0,0,0,0
"Zambia","2024-09-30",0,0,0,0,0,0,0,0
"Zambia","2024-10-01",0,0,0,0,0,0,0,0
"Zambia","2024-10-02",0,0,0,0,0,0,0,0
"Zambia","2024-10-03",0,0,0,0,0,0,0,0
"Zambia","2024-10-04",0,0,0,0,0,0,0,0
"Zambia","2024-10-05",0,0,0,0,0,0,0,0
"Zambia","2024-10-06",0,0,0,0,0,0,0,0
"Zambia","2024-10-07",0,0,0,0,0,0,0,0
"Zambia","2024-10-08",0,0,0,0,0,0,0,0
"Zambia","2024-10-09",0,0,0,0,0,0,0,0
"Zambia","2024-10-10",0,0,0,0,0,0,0,0
"Zambia","2024-10-11",0,0,0,0,0,0,0,0
"Zambia","2024-10-12",0,1,1,0,1,1,0,0
"Zambia","2024-10-13",0,0,1,0,0,1,0,0
"Zambia","2024-10-14",0,0,1,0,0,1,0,0
"Zambia","2024-10-15",0,0,1,0,0,1,0,0
"Zambia","2024-10-16",0,0,1,0,0,1,0,0
"Zambia","2024-10-17",0,0,1,0,0,1,0,0
"Zambia","2024-10-18",0,0,1,0,0,1,0,0
"Zambia","2024-10-19",0,0,1,0,0,1,0,0
"Zambia","2024-10-20",0,0,1,0,0,1,0,0
"Zambia","2024-10-21",0,0,1,0,0,1,0,0
"Zambia","2024-10-22",0,0,1,0,0,1,0,0
"Zambia","2024-10-23",0,0,1,0,0,1,0,0
"Zambia","2024-10-24",0,0,1,0,0,1,0,0
"Zambia","2024-10-25",0,0,1,0,0,1,0,0
"Zambia","2024-10-26",0,0,1,0,0,1,0,0
"Zambia","2024-10-27",0,0,1,0,0,1,0,0
"Zambia","2024-10-28",0,0,1,0,0,1,0,0
"Zambia","2024-10-29",0,0,1,0,0,1,0,0
"Zambia","2024-10-30",0,0,1,0,0,1,0,0
"Zambia","2024-10-31",0,0,1,0,0,1,0,0
"Zambia","2024-11-01",0,0,1,0,1,2,0,0
"Zambia","2024-11-02",0,0,1,0,0,2,0,0
"Zambia","2024-11-03",0,0,1,0,0,2,0,0
"Zambia","2024-11-04",0,0,1,0,0,2,0,0
"Zambia","2024-11-05",0,0,1,0,0,2,0,0
"Zambia","2024-11-06",0,0,1,0,0,2,0,0
"Zambia","2024-11-07",0,0,1,0,0,2,0,0
"Zambia","2024-11-08",0,0,1,0,0,2,0,0
"Zambia","2024-11-09",0,0,1,0,0,2,0,0
"Zambia","2024-11-10",0,0,1,0,0,2,0,0
"Zambia","2024-11-11",0,0,1,0,0,2,0,0
"Zambia","2024-11-12",0,0,1,0,0,2,0,0
"Zambia","2024-11-13",0,0,1,0,0,2,0,0
"Zambia","2024-11-14",0,0,1,0,0,2,0,0
"Zambia","2024-11-15",0,0,1,0,0,2,0,0
"Zambia","2024-11-16",0,0,1,0,0,2,0,0
"Zambia","2024-11-17",0,0,1,0,0,2,0,0
"Zambia","2024-11-18",0,0,1,0,0,2,0,0
"Zambia","2024-11-19",0,0,1,0,0,2,0,0
"Zambia","2024-11-20",0,0,1,0,0,2,0,0
"Zambia","2024-11-21",0,0,1,0,0,2,0,0
"Zambia","2024-11-22",0,0,1,0,0,2,0,0
"Zambia","2024-11-23",0,0,1,0,0,2,0,0
"Zambia","2024-11-24",0,0,1,0,0,2,0,0
"Zambia","2024-11-25",0,0,1,0,0,2,0,0
"Zambia","2024-11-26",0,0,1,0,0,2,0,0
"Zambia","2024-11-27",0,0,1,0,0,2,0,0
"Zambia","2024-11-28",0,0,1,0,0,2,0,0
"Zambia","2024-11-29",0,0,1,0,0,2,0,0
"Zambia","2024-11-30",0,0,1,0,0,2,0,0
"Zambia","2024-12-01",0,0,1,0,0,2,0,0
"Zambia","2024-12-02",0,0,1,0,0,2,0,0
"Zambia","2024-12-03",0,0,1,0,0,2,0,0
"Zambia","2024-12-04",0,0,1,0,0,2,0,0
"Zambia","2024-12-05",0,0,1,0,0,2,0,0
"Zambia","2024-12-06",0,0,1,0,0,2,0,0
"Zambia","2024-12-07",0,0,1,0,0,2,0,0
"Zambia","2024-12-08",0,0,1,0,0,2,0,0
"Zambia","2024-12-09",0,0,1,0,0,2,0,0
"Zambia","2024-12-10",0,0,1,0,1,3,0,0
"Zambia","2024-12-11",0,0,1,0,0,3,0,0
"Zambia","2024-12-12",0,0,1,0,0,3,0,0
"Zambia","2024-12-13",0,0,1,0,0,3,0,0
"Zambia","2024-12-14",0,0,1,0,0,3,0,0
"Zambia","2024-12-15",0,0,1,0,0,3,0,0
"Zambia","2024-12-16",0,0,1,0,0,3,0,0
"Zambia","2024-12-17",0,0,1,0,0,3,0,0
"Zambia","2024-12-18",0,0,1,0,0,3,0,0
"Zambia","2024-12-19",0,0,1,0,0,3,0,0
"Zambia","2024-12-20",0,0,1,0,0,3,0,0
"Zambia","2024-12-21",0,0,1,0,0,3,0,0
"Zambia","2024-12-22",0,0,1,0,0,3,0,0
"Zambia","2024-12-23",0,0,1,0,0,3,0,0
"Zambia","2024-12-24",0,0,1,0,0,3,0,0
"Zambia","2024-12-25",0,0,1,0,0,3,0,0
"Zambia","2024-12-26",0,0,1,0,0,3,0,0
"Zambia","2024-12-27",0,0,1,0,0,3,0,0
"Zambia","2024-12-28",0,0,1,0,0,3,0,0
"Zambia","2024-12-29",0,2,3,0,0,3,0,0
"Zambia","2024-12-30",0,0,3,0,0,3,0,0
"Zambia","2024-12-31",0,0,3,0,0,3,0,0
"Zambia","2025-01-01",0,0,3,0,0,3,0,0
"Zambia","2025-01-02",0,0,3,0,1,4,0,0
"Zambia","2025-01-03",0,0,3,0,0,4,0,0
"Zambia","2025-01-04",0,0,3,0,0,4,0,0
"Zambia","2025-01-05",0,1,4,0,0,4,0,0
"Zambia","2025-01-06",0,0,4,0,0,4,0,0
"Zambia","2025-01-07",0,0,4,0,0,4,0,0
"Zambia","2025-01-08",0,0,4,0,0,4,0,0
"Zambia","2025-01-09",0,0,4,0,1,5,0,0
"Zambia","2025-01-10",0,0,4,0,0,5,0,0
"Zambia","2025-01-11",0,0,4,0,0,5,0,0
"Zambia","2025-01-12",0,1,5,0,0,5,0,0
"Zambia","2025-01-13",0,0,5,0,0,5,0,0
"Zambia","2025-01-14",0,0,5,0,1,6,0,0
"Zambia","2025-01-15",0,0,5,0,0,6,0,0
"Zambia","2025-01-16",0,0,5,0,1,7,0,0
"Zambia","2025-01-17",0,0,5,0,0,7,0,0
"Zambia","2025-01-18",0,0,5,0,1,8,0,0
"Zambia","2025-01-19",0,3,8,0,0,8,0,0
"Zambia","2025-01-20",0,0,8,0,1,9,0,0
"Zambia","2025-01-21",0,0,8,0,1,10,0,0
"Zambia","2025-01-22",0,0,8,0,1,11,0,0
"Zambia","2025-01-23",0,0,8,0,2,13,0,0
"Zambia","2025-01-24",0,0,8,0,1,14,0,0
"Zambia","2025-01-25",0,0,8,0,1,15,0,0
"Zambia","2025-01-26",0,8,16,0,1,16,0,0
"Zambia","2025-01-27",0,0,16,0,0,16,0,0
"Zambia","2025-01-28",0,0,16,0,0,16,0,0
"Zambia","2025-01-29",0,0,16,0,0,16,0,0
"Zambia","2025-01-30",0,0,16,0,1,17,0,0
"Zambia","2025-01-31",0,0,16,0,0,17,0,0
"Zambia","2025-02-01",0,0,16,0,0,17,0,0
"Zambia","2025-02-02",0,1,17,0,0,17,0,0
"Zambia","2025-02-03",0,0,17,0,0,17,0,0
"Zambia","2025-02-04",0,0,17,0,1,18,0,0
"Zambia","2025-02-05",0,0,17,0,0,18,0,0
"Zambia","2025-02-06",0,0,17,0,1,19,0,0
"Zambia","2025-02-07",0,2,19,0,0,19,0,0
"Zambia","2025-02-08",0,0,19,0,0,19,0,0
"Zambia","2025-02-09",0,0,19,0,0,19,0,0
"Zambia","2025-02-10",0,0,19,0,0,19,0,0
"Zambia","2025-02-11",0,0,19,0,0,19,0,0
"Zambia","2025-02-12",0,0,19,0,0,19,0,0
"Zambia","2025-02-13",0,0,19,0,0,19,0,0
"Zambia","2025-02-14",0,0,19,0,0,19,0,0
"Zambia","2025-02-15",0,0,19,0,0,19,0,0
"Zambia","2025-02-16",0,0,19,0,0,19,0,0
"Zambia","2025-02-17",0,0,19,0,0,19,0,0
"Zambia","2025-02-18",0,0,19,0,0,19,0,0
"Zambia","2025-02-19",0,0,19,0,0,19,0,0
"Zambia","2025-02-20",0,0,19,0,0,19,0,0
"Zambia","2025-02-21",0,0,19,0,0,19,0,0
"Zambia","2025-02-22",0,0,19,0,0,19,0,0
"Zambia","2025-02-23",0,0,19,0,0,19,0,0
"Zambia","2025-02-24",0,0,19,0,0,19,0,0
"Zambia","2025-02-25",0,0,19,0,0,19,0,0
"Zambia","2025-02-26",0,0,19,0,0,19,0,0
"Zambia","2025-02-27",0,0,19,0,0,19,0,0
"Zambia","2025-02-28",0,0,19,0,0,19,0,0
"Zambia","2025-03-01",0,0,19,0,0,19,0,0
"Zambia","2025-03-02",0,0,19,0,0,19,0,0
"Zambia","2025-03-03",0,0,19,0,0,19,0,0
"Zimbabwe","2024-01-01",0,0,0,0,0,0,0,0
"Zimbabwe","2024-01-02",0,0,0,0,0,0,0,0
"Zimbabwe","2024-01-03",0,0,0,0,0,0,0,0
"Zimbabwe","2024-01-04",0,0,0,0,0,0,0,0
"Zimbabwe","2024-01-05",0,0,0,0,0,0,0,0
"Zimbabwe","2024-01-06",0,0,0,0,0,0,0,0
"Zimbabwe","2024-01-07",0,0,0,0,0,0,0,0
"Zimbabwe","2024-01-08",0,0,0,0,0,0,0,0
"Zimbabwe","2024-01-09",0,0,0,0,0,0,0,0
"Zimbabwe","2024-01-10",0,0,0,0,0,0,0,0
"Zimbabwe","2024-01-11",0,0,0,0,0,0,0,0
"Zimbabwe","2024-01-12",0,0,0,0,0,0,0,0
"Zimbabwe","2024-01-13",0,0,0,0,0,0,0,0
"Zimbabwe","2024-01-14",0,0,0,0,0,0,0,0
"Zimbabwe","2024-01-15",0,0,0,0,0,0,0,0
"Zimbabwe","2024-01-16",0,0,0,0,0,0,0,0
"Zimbabwe","2024-01-17",0,0,0,0,0,0,0,0
"Zimbabwe","2024-01-18",0,0,0,0,0,0,0,0
"Zimbabwe","2024-01-19",0,0,0,0,0,0,0,0
"Zimbabwe","2024-01-20",0,0,0,0,0,0,0,0
"Zimbabwe","2024-01-21",0,0,0,0,0,0,0,0
"Zimbabwe","2024-01-22",0,0,0,0,0,0,0,0
"Zimbabwe","2024-01-23",0,0,0,0,0,0,0,0
"Zimbabwe","2024-01-24",0,0,0,0,0,0,0,0
"Zimbabwe","2024-01-25",0,0,0,0,0,0,0,0
"Zimbabwe","2024-01-26",0,0,0,0,0,0,0,0
"Zimbabwe","2024-01-27",0,0,0,0,0,0,0,0
"Zimbabwe","2024-01-28",0,0,0,0,0,0,0,0
"Zimbabwe","2024-01-29",0,0,0,0,0,0,0,0
"Zimbabwe","2024-01-30",0,0,0,0,0,0,0,0
"Zimbabwe","2024-01-31",0,0,0,0,0,0,0,0
"Zimbabwe","2024-02-01",0,0,0,0,0,0,0,0
"Zimbabwe","2024-02-02",0,0,0,0,0,0,0,0
"Zimbabwe","2024-02-03",0,0,0,0,0,0,0,0
"Zimbabwe","2024-02-04",0,0,0,0,0,0,0,0
"Zimbabwe","2024-02-05",0,0,0,0,0,0,0,0
"Zimbabwe","2024-02-06",0,0,0,0,0,0,0,0
"Zimbabwe","2024-02-07",0,0,0,0,0,0,0,0
"Zimbabwe","2024-02-08",0,0,0,0,0,0,0,0
"Zimbabwe","2024-02-09",0,0,0,0,0,0,0,0
"Zimbabwe","2024-02-10",0,0,0,0,0,0,0,0
"Zimbabwe","2024-02-11",0,0,0,0,0,0,0,0
"Zimbabwe","2024-02-12",0,0,0,0,0,0,0,0
"Zimbabwe","2024-02-13",0,0,0,0,0,0,0,0
"Zimbabwe","2024-02-14",0,0,0,0,0,0,0,0
"Zimbabwe","2024-02-15",0,0,0,0,0,0,0,0
"Zimbabwe","2024-02-16",0,0,0,0,0,0,0,0
"Zimbabwe","2024-02-17",0,0,0,0,0,0,0,0
"Zimbabwe","2024-02-18",0,0,0,0,0,0,0,0
"Zimbabwe","2024-02-19",0,0,0,0,0,0,0,0
"Zimbabwe","2024-02-20",0,0,0,0,0,0,0,0
"Zimbabwe","2024-02-21",0,0,0,0,0,0,0,0
"Zimbabwe","2024-02-22",0,0,0,0,0,0,0,0
"Zimbabwe","2024-02-23",0,0,0,0,0,0,0,0
"Zimbabwe","2024-02-24",0,0,0,0,0,0,0,0
"Zimbabwe","2024-02-25",0,0,0,0,0,0,0,0
"Zimbabwe","2024-02-26",0,0,0,0,0,0,0,0
"Zimbabwe","2024-02-27",0,0,0,0,0,0,0,0
"Zimbabwe","2024-02-28",0,0,0,0,0,0,0,0
"Zimbabwe","2024-02-29",0,0,0,0,0,0,0,0
"Zimbabwe","2024-03-01",0,0,0,0,0,0,0,0
"Zimbabwe","2024-03-02",0,0,0,0,0,0,0,0
"Zimbabwe","2024-03-03",0,0,0,0,0,0,0,0
"Zimbabwe","2024-03-04",0,0,0,0,0,0,0,0
"Zimbabwe","2024-03-05",0,0,0,0,0,0,0,0
"Zimbabwe","2024-03-06",0,0,0,0,0,0,0,0
"Zimbabwe","2024-03-07",0,0,0,0,0,0,0,0
"Zimbabwe","2024-03-08",0,0,0,0,0,0,0,0
"Zimbabwe","2024-03-09",0,0,0,0,0,0,0,0
"Zimbabwe","2024-03-10",0,0,0,0,0,0,0,0
"Zimbabwe","2024-03-11",0,0,0,0,0,0,0,0
"Zimbabwe","2024-03-12",0,0,0,0,0,0,0,0
"Zimbabwe","2024-03-13",0,0,0,0,0,0,0,0
"Zimbabwe","2024-03-14",0,0,0,0,0,0,0,0
"Zimbabwe","2024-03-15",0,0,0,0,0,0,0,0
"Zimbabwe","2024-03-16",0,0,0,0,0,0,0,0
"Zimbabwe","2024-03-17",0,0,0,0,0,0,0,0
"Zimbabwe","2024-03-18",0,0,0,0,0,0,0,0
"Zimbabwe","2024-03-19",0,0,0,0,0,0,0,0
"Zimbabwe","2024-03-20",0,0,0,0,0,0,0,0
"Zimbabwe","2024-03-21",0,0,0,0,0,0,0,0
"Zimbabwe","2024-03-22",0,0,0,0,0,0,0,0
"Zimbabwe","2024-03-23",0,0,0,0,0,0,0,0
"Zimbabwe","2024-03-24",0,0,0,0,0,0,0,0
"Zimbabwe","2024-03-25",0,0,0,0,0,0,0,0
"Zimbabwe","2024-03-26",0,0,0,0,0,0,0,0
"Zimbabwe","2024-03-27",0,0,0,0,0,0,0,0
"Zimbabwe","2024-03-28",0,0,0,0,0,0,0,0
"Zimbabwe","2024-03-29",0,0,0,0,0,0,0,0
"Zimbabwe","2024-03-30",0,0,0,0,0,0,0,0
"Zimbabwe","2024-03-31",0,0,0,0,0,0,0,0
"Zimbabwe","2024-04-01",0,0,0,0,0,0,0,0
"Zimbabwe","2024-04-02",0,0,0,0,0,0,0,0
"Zimbabwe","2024-04-03",0,0,0,0,0,0,0,0
"Zimbabwe","2024-04-04",0,0,0,0,0,0,0,0
"Zimbabwe","2024-04-05",0,0,0,0,0,0,0,0
"Zimbabwe","2024-04-06",0,0,0,0,0,0,0,0
"Zimbabwe","2024-04-07",0,0,0,0,0,0,0,0
"Zimbabwe","2024-04-08",0,0,0,0,0,0,0,0
"Zimbabwe","2024-04-09",0,0,0,0,0,0,0,0
"Zimbabwe","2024-04-10",0,0,0,0,0,0,0,0
"Zimbabwe","2024-04-11",0,0,0,0,0,0,0,0
"Zimbabwe","2024-04-12",0,0,0,0,0,0,0,0
"Zimbabwe","2024-04-13",0,0,0,0,0,0,0,0
"Zimbabwe","2024-04-14",0,0,0,0,0,0,0,0
"Zimbabwe","2024-04-15",0,0,0,0,0,0,0,0
"Zimbabwe","2024-04-16",0,0,0,0,0,0,0,0
"Zimbabwe","2024-04-17",0,0,0,0,0,0,0,0
"Zimbabwe","2024-04-18",0,0,0,0,0,0,0,0
"Zimbabwe","2024-04-19",0,0,0,0,0,0,0,0
"Zimbabwe","2024-04-20",0,0,0,0,0,0,0,0
"Zimbabwe","2024-04-21",0,0,0,0,0,0,0,0
"Zimbabwe","2024-04-22",0,0,0,0,0,0,0,0
"Zimbabwe","2024-04-23",0,0,0,0,0,0,0,0
"Zimbabwe","2024-04-24",0,0,0,0,0,0,0,0
"Zimbabwe","2024-04-25",0,0,0,0,0,0,0,0
"Zimbabwe","2024-04-26",0,0,0,0,0,0,0,0
"Zimbabwe","2024-04-27",0,0,0,0,0,0,0,0
"Zimbabwe","2024-04-28",0,0,0,0,0,0,0,0
"Zimbabwe","2024-04-29",0,0,0,0,0,0,0,0
"Zimbabwe","2024-04-30",0,0,0,0,0,0,0,0
"Zimbabwe","2024-05-01",0,0,0,0,0,0,0,0
"Zimbabwe","2024-05-02",0,0,0,0,0,0,0,0
"Zimbabwe","2024-05-03",0,0,0,0,0,0,0,0
"Zimbabwe","2024-05-04",0,0,0,0,0,0,0,0
"Zimbabwe","2024-05-05",0,0,0,0,0,0,0,0
"Zimbabwe","2024-05-06",0,0,0,0,0,0,0,0
"Zimbabwe","2024-05-07",0,0,0,0,0,0,0,0
"Zimbabwe","2024-05-08",0,0,0,0,0,0,0,0
"Zimbabwe","2024-05-09",0,0,0,0,0,0,0,0
"Zimbabwe","2024-05-10",0,0,0,0,0,0,0,0
"Zimbabwe","2024-05-11",0,0,0,0,0,0,0,0
"Zimbabwe","2024-05-12",0,0,0,0,0,0,0,0
"Zimbabwe","2024-05-13",0,0,0,0,0,0,0,0
"Zimbabwe","2024-05-14",0,0,0,0,0,0,0,0
"Zimbabwe","2024-05-15",0,0,0,0,0,0,0,0
"Zimbabwe","2024-05-16",0,0,0,0,0,0,0,0
"Zimbabwe","2024-05-17",0,0,0,0,0,0,0,0
"Zimbabwe","2024-05-18",0,0,0,0,0,0,0,0
"Zimbabwe","2024-05-19",0,0,0,0,0,0,0,0
"Zimbabwe","2024-05-20",0,0,0,0,0,0,0,0
"Zimbabwe","2024-05-21",0,0,0,0,0,0,0,0
"Zimbabwe","2024-05-22",0,0,0,0,0,0,0,0
"Zimbabwe","2024-05-23",0,0,0,0,0,0,0,0
"Zimbabwe","2024-05-24",0,0,0,0,0,0,0,0
"Zimbabwe","2024-05-25",0,0,0,0,0,0,0,0
"Zimbabwe","2024-05-26",0,0,0,0,0,0,0,0
"Zimbabwe","2024-05-27",0,0,0,0,0,0,0,0
"Zimbabwe","2024-05-28",0,0,0,0,0,0,0,0
"Zimbabwe","2024-05-29",0,0,0,0,0,0,0,0
"Zimbabwe","2024-05-30",0,0,0,0,0,0,0,0
"Zimbabwe","2024-05-31",0,0,0,0,0,0,0,0
"Zimbabwe","2024-06-01",0,0,0,0,0,0,0,0
"Zimbabwe","2024-06-02",0,0,0,0,0,0,0,0
"Zimbabwe","2024-06-03",0,0,0,0,0,0,0,0
"Zimbabwe","2024-06-04",0,0,0,0,0,0,0,0
"Zimbabwe","2024-06-05",0,0,0,0,0,0,0,0
"Zimbabwe","2024-06-06",0,0,0,0,0,0,0,0
"Zimbabwe","2024-06-07",0,0,0,0,0,0,0,0
"Zimbabwe","2024-06-08",0,0,0,0,0,0,0,0
"Zimbabwe","2024-06-09",0,0,0,0,0,0,0,0
"Zimbabwe","2024-06-10",0,0,0,0,0,0,0,0
"Zimbabwe","2024-06-11",0,0,0,0,0,0,0,0
"Zimbabwe","2024-06-12",0,0,0,0,0,0,0,0
"Zimbabwe","2024-06-13",0,0,0,0,0,0,0,0
"Zimbabwe","2024-06-14",0,0,0,0,0,0,0,0
"Zimbabwe","2024-06-15",0,0,0,0,0,0,0,0
"Zimbabwe","2024-06-16",0,0,0,0,0,0,0,0
"Zimbabwe","2024-06-17",0,0,0,0,0,0,0,0
"Zimbabwe","2024-06-18",0,0,0,0,0,0,0,0
"Zimbabwe","2024-06-19",0,0,0,0,0,0,0,0
"Zimbabwe","2024-06-20",0,0,0,0,0,0,0,0
"Zimbabwe","2024-06-21",0,0,0,0,0,0,0,0
"Zimbabwe","2024-06-22",0,0,0,0,0,0,0,0
"Zimbabwe","2024-06-23",0,0,0,0,0,0,0,0
"Zimbabwe","2024-06-24",0,0,0,0,0,0,0,0
"Zimbabwe","2024-06-25",0,0,0,0,0,0,0,0
"Zimbabwe","2024-06-26",0,0,0,0,0,0,0,0
"Zimbabwe","2024-06-27",0,0,0,0,0,0,0,0
"Zimbabwe","2024-06-28",0,0,0,0,0,0,0,0
"Zimbabwe","2024-06-29",0,0,0,0,0,0,0,0
"Zimbabwe","2024-06-30",0,0,0,0,0,0,0,0
"Zimbabwe","2024-07-01",0,0,0,0,0,0,0,0
"Zimbabwe","2024-07-02",0,0,0,0,0,0,0,0
"Zimbabwe","2024-07-03",0,0,0,0,0,0,0,0
"Zimbabwe","2024-07-04",0,0,0,0,0,0,0,0
"Zimbabwe","2024-07-05",0,0,0,0,0,0,0,0
"Zimbabwe","2024-07-06",0,0,0,0,0,0,0,0
"Zimbabwe","2024-07-07",0,0,0,0,0,0,0,0
"Zimbabwe","2024-07-08",0,0,0,0,0,0,0,0
"Zimbabwe","2024-07-09",0,0,0,0,0,0,0,0
"Zimbabwe","2024-07-10",0,0,0,0,0,0,0,0
"Zimbabwe","2024-07-11",0,0,0,0,0,0,0,0
"Zimbabwe","2024-07-12",0,0,0,0,0,0,0,0
"Zimbabwe","2024-07-13",0,0,0,0,0,0,0,0
"Zimbabwe","2024-07-14",0,0,0,0,0,0,0,0
"Zimbabwe","2024-07-15",0,0,0,0,0,0,0,0
"Zimbabwe","2024-07-16",0,0,0,0,0,0,0,0
"Zimbabwe","2024-07-17",0,0,0,0,0,0,0,0
"Zimbabwe","2024-07-18",0,0,0,0,0,0,0,0
"Zimbabwe","2024-07-19",0,0,0,0,0,0,0,0
"Zimbabwe","2024-07-20",0,0,0,0,0,0,0,0
"Zimbabwe","2024-07-21",0,0,0,0,0,0,0,0
"Zimbabwe","2024-07-22",0,0,0,0,0,0,0,0
"Zimbabwe","2024-07-23",0,0,0,0,0,0,0,0
"Zimbabwe","2024-07-24",0,0,0,0,0,0,0,0
"Zimbabwe","2024-07-25",0,0,0,0,0,0,0,0
"Zimbabwe","2024-07-26",0,0,0,0,0,0,0,0
"Zimbabwe","2024-07-27",0,0,0,0,0,0,0,0
"Zimbabwe","2024-07-28",0,0,0,0,0,0,0,0
"Zimbabwe","2024-07-29",0,0,0,0,0,0,0,0
"Zimbabwe","2024-07-30",0,0,0,0,0,0,0,0
"Zimbabwe","2024-07-31",0,0,0,0,0,0,0,0
"Zimbabwe","2024-08-01",0,0,0,0,0,0,0,0
"Zimbabwe","2024-08-02",0,0,0,0,0,0,0,0
"Zimbabwe","2024-08-03",0,0,0,0,0,0,0,0
"Zimbabwe","2024-08-04",0,0,0,0,0,0,0,0
"Zimbabwe","2024-08-05",0,0,0,0,0,0,0,0
"Zimbabwe","2024-08-06",0,0,0,0,0,0,0,0
"Zimbabwe","2024-08-07",0,0,0,0,0,0,0,0
"Zimbabwe","2024-08-08",0,0,0,0,0,0,0,0
"Zimbabwe","2024-08-09",0,0,0,0,0,0,0,0
"Zimbabwe","2024-08-10",0,0,0,0,0,0,0,0
"Zimbabwe","2024-08-11",0,0,0,0,0,0,0,0
"Zimbabwe","2024-08-12",0,0,0,0,0,0,0,0
"Zimbabwe","2024-08-13",0,0,0,0,0,0,0,0
"Zimbabwe","2024-08-14",0,0,0,0,0,0,0,0
"Zimbabwe","2024-08-15",0,0,0,0,0,0,0,0
"Zimbabwe","2024-08-16",0,0,0,0,0,0,0,0
"Zimbabwe","2024-08-17",0,0,0,0,0,0,0,0
"Zimbabwe","2024-08-18",0,0,0,0,0,0,0,0
"Zimbabwe","2024-08-19",0,0,0,0,0,0,0,0
"Zimbabwe","2024-08-20",0,0,0,0,0,0,0,0
"Zimbabwe","2024-08-21",0,0,0,0,0,0,0,0
"Zimbabwe","2024-08-22",0,0,0,0,0,0,0,0
"Zimbabwe","2024-08-23",0,0,0,0,0,0,0,0
"Zimbabwe","2024-08-24",0,0,0,0,0,0,0,0
"Zimbabwe","2024-08-25",0,0,0,0,0,0,0,0
"Zimbabwe","2024-08-26",0,0,0,0,0,0,0,0
"Zimbabwe","2024-08-27",0,0,0,0,0,0,0,0
"Zimbabwe","2024-08-28",0,0,0,0,0,0,0,0
"Zimbabwe","2024-08-29",0,0,0,0,0,0,0,0
"Zimbabwe","2024-08-30",0,0,0,0,0,0,0,0
"Zimbabwe","2024-08-31",0,0,0,0,0,0,0,0
"Zimbabwe","2024-09-01",0,0,0,0,0,0,0,0
"Zimbabwe","2024-09-02",0,0,0,0,0,0,0,0
"Zimbabwe","2024-09-03",0,0,0,0,0,0,0,0
"Zimbabwe","2024-09-04",0,0,0,0,0,0,0,0
"Zimbabwe","2024-09-05",0,0,0,0,0,0,0,0
"Zimbabwe","2024-09-06",0,0,0,0,0,0,0,0
"Zimbabwe","2024-09-07",0,0,0,0,0,0,0,0
"Zimbabwe","2024-09-08",0,0,0,0,0,0,0,0
"Zimbabwe","2024-09-09",0,0,0,0,0,0,0,0
"Zimbabwe","2024-09-10",0,0,0,0,0,0,0,0
"Zimbabwe","2024-09-11",0,0,0,0,0,0,0,0
"Zimbabwe","2024-09-12",0,0,0,0,0,0,0,0
"Zimbabwe","2024-09-13",0,0,0,0,0,0,0,0
"Zimbabwe","2024-09-14",0,0,0,0,0,0,0,0
"Zimbabwe","2024-09-15",0,0,0,0,0,0,0,0
"Zimbabwe","2024-09-16",0,0,0,0,0,0,0,0
"Zimbabwe","2024-09-17",0,0,0,0,0,0,0,0
"Zimbabwe","2024-09-18",0,0,0,0,0,0,0,0
"Zimbabwe","2024-09-19",0,0,0,0,0,0,0,0
"Zimbabwe","2024-09-20",0,0,0,0,0,0,0,0
"Zimbabwe","2024-09-21",0,0,0,0,0,0,0,0
"Zimbabwe","2024-09-22",0,0,0,0,0,0,0,0
"Zimbabwe","2024-09-23",0,0,0,0,0,0,0,0
"Zimbabwe","2024-09-24",0,0,0,0,0,0,0,0
"Zimbabwe","2024-09-25",0,0,0,0,0,0,0,0
"Zimbabwe","2024-09-26",0,0,0,0,0,0,0,0
"Zimbabwe","2024-09-27",0,0,0,0,0,0,0,0
"Zimbabwe","2024-09-28",0,0,0,0,0,0,0,0
"Zimbabwe","2024-09-29",0,0,0,0,0,0,0,0
"Zimbabwe","2024-09-30",0,0,0,0,0,0,0,0
"Zimbabwe","2024-10-01",0,0,0,0,0,0,0,0
"Zimbabwe","2024-10-02",0,0,0,0,0,0,0,0
"Zimbabwe","2024-10-03",0,0,0,0,0,0,0,0
"Zimbabwe","2024-10-04",0,0,0,0,0,0,0,0
"Zimbabwe","2024-10-05",0,0,0,0,0,0,0,0
"Zimbabwe","2024-10-06",0,0,0,0,0,0,0,0
"Zimbabwe","2024-10-07",0,0,0,0,0,0,0,0
"Zimbabwe","2024-10-08",0,0,0,0,0,0,0,0
"Zimbabwe","2024-10-09",0,0,0,0,0,0,0,0
"Zimbabwe","2024-10-10",0,0,0,0,0,0,0,0
"Zimbabwe","2024-10-11",0,0,0,0,0,0,0,0
"Zimbabwe","2024-10-12",0,0,0,0,0,0,0,0
"Zimbabwe","2024-10-13",0,2,2,0,2,2,0,0
"Zimbabwe","2024-10-14",0,0,2,0,0,2,0,0
"Zimbabwe","2024-10-15",0,0,2,0,0,2,0,0
"Zimbabwe","2024-10-16",0,0,2,0,0,2,0,0
"Zimbabwe","2024-10-17",0,0,2,0,0,2,0,0
"Zimbabwe","2024-10-18",0,0,2,0,0,2,0,0
"Zimbabwe","2024-10-19",0,0,2,0,0,2,0,0
"Zimbabwe","2024-10-20",0,0,2,0,0,2,0,0
"Zimbabwe","2024-10-21",0,0,2,0,0,2,0,0
"Zimbabwe","2024-10-22",0,0,2,0,0,2,0,0
"Zimbabwe","2024-10-23",0,0,2,0,0,2,0,0
"Zimbabwe","2024-10-24",0,0,2,0,0,2,0,0
"Zimbabwe","2024-10-25",0,0,2,0,0,2,0,0
"Zimbabwe","2024-10-26",0,0,2,0,0,2,0,0
"Zimbabwe","2024-10-27",0,0,2,0,0,2,0,0
"Zimbabwe","2024-10-28",0,0,2,0,0,2,0,0
"Zimbabwe","2024-10-29",0,0,2,0,0,2,0,0
"Zimbabwe","2024-10-30",0,0,2,0,0,2,0,0
"Zimbabwe","2024-10-31",0,0,2,0,0,2,0,0
"Zimbabwe","2024-11-01",0,0,2,0,0,2,0,0
"Zimbabwe","2024-11-02",0,0,2,0,0,2,0,0
"Zimbabwe","2024-11-03",0,0,2,0,0,2,0,0
"Zimbabwe","2024-11-04",0,0,2,0,0,2,0,0
"Zimbabwe","2024-11-05",0,0,2,0,0,2,0,0
"Zimbabwe","2024-11-06",0,0,2,0,0,2,0,0
"Zimbabwe","2024-11-07",0,0,2,0,0,2,0,0
"Zimbabwe","2024-11-08",0,0,2,0,0,2,0,0
"Zimbabwe","2024-11-09",0,0,2,0,0,2,0,0
"Zimbabwe","2024-11-10",0,0,2,0,0,2,0,0
"Zimbabwe","2024-11-11",0,0,2,0,0,2,0,0
"Zimbabwe","2024-11-12",0,0,2,0,0,2,0,0
"Zimbabwe","2024-11-13",0,0,2,0,0,2,0,0
"Zimbabwe","2024-11-14",0,0,2,0,0,2,0,0
"Zimbabwe","2024-11-15",0,0,2,0,0,2,0,0
"Zimbabwe","2024-11-16",0,0,2,0,0,2,0,0
"Zimbabwe","2024-11-17",0,0,2,0,0,2,0,0
"Zimbabwe","2024-11-18",0,0,2,0,0,2,0,0
"Zimbabwe","2024-11-19",0,0,2,0,0,2,0,0
"Zimbabwe","2024-11-20",0,0,2,0,0,2,0,0
"Zimbabwe","2024-11-21",0,0,2,0,0,2,0,0
"Zimbabwe","2024-11-22",0,0,2,0,0,2,0,0
"Zimbabwe","2024-11-23",0,0,2,0,0,2,0,0
"Zimbabwe","2024-11-24",0,0,2,0,0,2,0,0
"Zimbabwe","2024-11-25",0,0,2,0,0,2,0,0
"Zimbabwe","2024-11-26",0,0,2,0,0,2,0,0
"Zimbabwe","2024-11-27",0,0,2,0,0,2,0,0
"Zimbabwe","2024-11-28",0,0,2,0,0,2,0,0
"Zimbabwe","2024-11-29",0,0,2,0,0,2,0,0
"Zimbabwe","2024-11-30",0,0,2,0,0,2,0,0
"Zimbabwe","2024-12-01",0,0,2,0,0,2,0,0
"Zimbabwe","2024-12-02",0,0,2,0,0,2,0,0
"Zimbabwe","2024-12-03",0,0,2,0,0,2,0,0
"Zimbabwe","2024-12-04",0,0,2,0,0,2,0,0
"Zimbabwe","2024-12-05",0,0,2,0,0,2,0,0
"Zimbabwe","2024-12-06",0,0,2,0,0,2,0,0
"Zimbabwe","2024-12-07",0,0,2,0,0,2,0,0
"Zimbabwe","2024-12-08",0,0,2,0,0,2,0,0
"Zimbabwe","2024-12-09",0,0,2,0,0,2,0,0
"Zimbabwe","2024-12-10",0,0,2,0,0,2,0,0
"Zimbabwe","2024-12-11",0,0,2,0,0,2,0,0
"Zimbabwe","2024-12-12",0,0,2,0,0,2,0,0
"Zimbabwe","2024-12-13",0,0,2,0,0,2,0,0
"Zimbabwe","2024-12-14",0,0,2,0,0,2,0,0
"Zimbabwe","2024-12-15",0,0,2,0,0,2,0,0
"Zimbabwe","2024-12-16",0,0,2,0,0,2,0,0
"Zimbabwe","2024-12-17",0,0,2,0,0,2,0,0
"Zimbabwe","2024-12-18",0,0,2,0,0,2,0,0
"Zimbabwe","2024-12-19",0,0,2,0,0,2,0,0
"Zimbabwe","2024-12-20",0,0,2,0,0,2,0,0
"Zimbabwe","2024-12-21",0,0,2,0,0,2,0,0
"Zimbabwe","2024-12-22",0,0,2,0,0,2,0,0
"Zimbabwe","2024-12-23",0,0,2,0,0,2,0,0
"Zimbabwe","2024-12-24",0,0,2,0,0,2,0,0
"Zimbabwe","2024-12-25",0,0,2,0,0,2,0,0
"Zimbabwe","2024-12-26",0,0,2,0,0,2,0,0
"Zimbabwe","2024-12-27",0,0,2,0,0,2,0,0
"Zimbabwe","2024-12-28",0,0,2,0,0,2,0,0
"Zimbabwe","2024-12-29",0,0,2,0,0,2,0,0
"Zimbabwe","2024-12-30",0,0,2,0,0,2,0,0
"Zimbabwe","2024-12-31",0,0,2,0,0,2,0,0
"Zimbabwe","2025-01-01",0,0,2,0,0,2,0,0
"Zimbabwe","2025-01-02",0,0,2,0,0,2,0,0
"Zimbabwe","2025-01-03",0,0,2,0,0,2,0,0
"Zimbabwe","2025-01-04",0,0,2,0,0,2,0,0
"Zimbabwe","2025-01-05",0,0,2,0,0,2,0,0
"Zimbabwe","2025-01-06",0,0,2,0,0,2,0,0
"Zimbabwe","2025-01-07",0,0,2,0,0,2,0,0
"Zimbabwe","2025-01-08",0,0,2,0,0,2,0,0
"Zimbabwe","2025-01-09",0,0,2,0,0,2,0,0
"Zimbabwe","2025-01-10",0,0,2,0,0,2,0,0
"Zimbabwe","2025-01-11",0,0,2,0,0,2,0,0
"Zimbabwe","2025-01-12",0,0,2,0,0,2,0,0
"Zimbabwe","2025-01-13",0,0,2,0,0,2,0,0
"Zimbabwe","2025-01-14",0,0,2,0,0,2,0,0
"Zimbabwe","2025-01-15",0,0,2,0,0,2,0,0
"Zimbabwe","2025-01-16",0,0,2,0,0,2,0,0
"Zimbabwe","2025-01-17",0,0,2,0,0,2,0,0
"Zimbabwe","2025-01-18",0,0,2,0,0,2,0,0
"Zimbabwe","2025-01-19",0,0,2,0,0,2,0,0
"Zimbabwe","2025-01-20",0,0,2,0,0,2,0,0
"Zimbabwe","2025-01-21",0,0,2,0,0,2,0,0
"Zimbabwe","2025-01-22",0,0,2,0,0,2,0,0
"Zimbabwe","2025-01-23",0,0,2,0,0,2,0,0
"Zimbabwe","2025-01-24",0,0,2,0,0,2,0,0
"Zimbabwe","2025-01-25",0,0,2,0,0,2,0,0
"Zimbabwe","2025-01-26",0,0,2,0,0,2,0,0
"Zimbabwe","2025-01-27",0,0,2,0,0,2,0,0
"Zimbabwe","2025-01-28",0,0,2,0,0,2,0,0
"Zimbabwe","2025-01-29",0,0,2,0,0,2,0,0
"Zimbabwe","2025-01-30",0,0,2,0,0,2,0,0
"Zimbabwe","2025-01-31",0,0,2,0,0,2,0,0
"Zimbabwe","2025-02-01",0,0,2,0,0,2,0,0
"Zimbabwe","2025-02-02",0,0,2,0,0,2,0,0
"Zimbabwe","2025-02-03",0,0,2,0,0,2,0,0
"Zimbabwe","2025-02-04",0,0,2,0,0,2,0,0
"Zimbabwe","2025-02-05",0,0,2,0,0,2,0,0
"Zimbabwe","2025-02-06",0,0,2,0,0,2,0,0
"Zimbabwe","2025-02-07",0,0,2,0,0,2,0,0
"Zimbabwe","2025-02-08",0,0,2,0,0,2,0,0
"Zimbabwe","2025-02-09",0,0,2,0,0,2,0,0
"Zimbabwe","2025-02-10",0,0,2,0,0,2,0,0
"Zimbabwe","2025-02-11",0,0,2,0,0,2,0,0
"Zimbabwe","2025-02-12",0,0,2,0,0,2,0,0
"Zimbabwe","2025-02-13",0,0,2,0,0,2,0,0
"Zimbabwe","2025-02-14",0,0,2,0,0,2,0,0
"Zimbabwe","2025-02-15",0,0,2,0,0,2,0,0
"Zimbabwe","2025-02-16",0,0,2,0,0,2,0,0
"Zimbabwe","2025-02-17",0,0,2,0,0,2,0,0
"Zimbabwe","2025-02-18",0,0,2,0,0,2,0,0
"Zimbabwe","2025-02-19",0,0,2,0,0,2,0,0
"Zimbabwe","2025-02-20",0,0,2,0,0,2,0,0
"Zimbabwe","2025-02-21",0,0,2,0,0,2,0,0
"Zimbabwe","2025-02-22",0,0,2,0,0,2,0,0
"Zimbabwe","2025-02-23",0,0,2,0,0,2,0,0
"Zimbabwe","2025-02-24",0,0,2,0,0,2,0,0
"Zimbabwe","2025-02-25",0,0,2,0,0,2,0,0
"Zimbabwe","2025-02-26",0,0,2,0,0,2,0,0
"Zimbabwe","2025-02-27",0,0,2,0,0,2,0,0
"Zimbabwe","2025-02-28",0,0,2,0,0,2,0,0
"Zimbabwe","2025-03-01",0,0,2,0,0,2,0,0
"Zimbabwe","2025-03-02",0,0,2,0,0,2,0,0
"Zimbabwe","2025-03-03",0,0,2,0,0,2,0,0
